time,subj_course_id,sec_code,sec_id,prof,available,waitlist,total,enrolled_ct
1683631654701,ANBI 133,A00,258401,Wilder; Linnea Lorene,34,0,40,6
1683631655736,ANBI 140,A00,258395,Hrvoj Mihic; Branka,18,0,25,7
1683631656772,ANSC 120,A00,258402,Bialecki; Jon Anthony,27,0,40,13
1683631657807,ANSC 144,A00,258400,Staff,12,0,40,28
1683631659876,ANSC 166,A00,258396,Parish; Steven Martin,156,0,175,19
1683631660908,ANSC 180,A00,193533,Staff,8,0,20,12
1683631661946,ANSC 188,A00,258397,Jassal; Aftab,34,0,40,6
1683631662977,ANTH 3,A01,258316,Staff,23,0,30,7
1683631664008,ANTH 5,A00,258394,Semendeferi; Ekaterini,16,0,20,4
1683631665041,ANTH 21,A01,258331,Staff,4,0,40,36
1683631666074,ANTH 103,A00,258398,Varma; Saiba,15,0,25,10
1683631667107,AWP 10,001,202034,Staff,0,0,0,0
1683631667107,AWP 10,002,202035,Staff,0,0,0,0
1683631667107,AWP 10,003,202036,Staff,0,0,0,0
1683631667107,AWP 10,004,202037,Staff,0,0,0,0
1683631667107,AWP 10,005,202038,Staff,0,0,0,0
1683631667107,AWP 10,006,202039,Staff,0,0,0,0
1683631667107,AWP 10,007,202040,Staff,0,0,0,0
1683631667107,AWP 10,008,202041,Staff,0,0,0,0
1683631667107,AWP 10,009,202042,Staff,0,0,0,0
1683631667107,AWP 10,010,202043,Staff,0,0,0,0
1683631667107,AWP 10,011,202044,Staff,0,0,0,0
1683631667107,AWP 10,012,202045,Staff,0,0,0,0
1683631667107,AWP 10,013,202046,Staff,0,0,0,0
1683631667107,AWP 10,014,202047,Staff,0,0,0,0
1683631667107,AWP 10,015,202048,Staff,0,0,0,0
1683631667107,AWP 10,016,202049,Staff,0,0,0,0
1683631667107,AWP 10,017,202050,Staff,0,0,0,0
1683631667107,AWP 10,018,202051,Staff,0,0,0,0
1683631667107,AWP 10,019,202052,Staff,0,0,0,0
1683631667107,AWP 10,020,202053,Staff,0,0,0,0
1683631667107,AWP 10,021,202054,Staff,0,0,0,0
1683631667107,AWP 10,022,202055,Staff,0,0,0,0
1683631667107,AWP 10,023,202056,Staff,0,0,0,0
1683631667107,AWP 10,024,202057,Staff,0,0,0,0
1683631667107,AWP 10,025,202058,Staff,0,0,0,0
1683631667107,AWP 10,026,202059,Staff,0,0,0,0
1683631668139,AWP 102,001,202032,Staff,0,0,0,0
1683631668139,AWP 102,002,202033,Staff,0,0,0,0
1683631669176,BENG 100,A01,254234,Taylor Amos; Alyssa C,31,0,40,9
1683631670210,BENG 196,001,270013,Engler; Adam J.,9999,0,9999,0
1683631671249,BICD 100R,A01,202018,Smith; Laurie,0,7,32,32
1683631671249,BICD 100R,A02,202019,Smith; Laurie,0,3,32,32
1683631671249,BICD 100R,A03,202020,Smith; Laurie,0,1,32,32
1683631671249,BICD 100R,A04,202021,Smith; Laurie,6,0,32,26
1683631671249,BICD 100R,A05,202022,Smith; Laurie,11,0,32,21
1683631672283,BICD 136,A01,193242,Gustafson-Brown; Cindy,0,2,32,32
1683631672283,BICD 136,A02,193244,Gustafson-Brown; Cindy,13,0,32,19
1683631673318,BIEB 102,A01,193249,Butler; Shannon Rhey,0,2,32,32
1683631673318,BIEB 102,A02,193251,Butler; Shannon Rhey,0,0,32,32
1683631673318,BIEB 102,A03,193253,Butler; Shannon Rhey,0,0,32,32
1683631673318,BIEB 102,A04,193255,Butler; Shannon Rhey,14,0,32,18
1683631673318,BIEB 102,A05,193265,Butler; Shannon Rhey,26,0,32,6
1683631673318,BIEB 102,A06,193269,Butler; Shannon Rhey,14,0,32,18
1683631675380,BIEB 150,A01,193274,Staff,0,0,32,32
1683631675380,BIEB 150,A02,193285,Staff,24,0,32,8
1683631676416,BIEB 194,A00,193286,Kurle; Carolyn M.,20,0,32,12
1683631677484,BILD 1,A01,192291,Staff,15,0,32,17
1683631677484,BILD 1,A02,192292,Staff,30,0,32,2
1683631677484,BILD 1,B01,192520,Reuther; Keefe,0,1,0,0
1683631677484,BILD 1,B02,192532,Reuther; Keefe,0,1,0,0
1683631678521,BILD 3,A01,192556,Butler; Shannon Rhey,0,0,32,32
1683631678521,BILD 3,A02,192581,Butler; Shannon Rhey,1,0,32,31
1683631678521,BILD 3,A03,192611,Butler; Shannon Rhey,21,0,32,11
1683631678521,BILD 3,A04,192612,Butler; Shannon Rhey,24,0,32,8
1683631678521,BILD 3,A05,192613,Butler; Shannon Rhey,26,0,32,6
1683631678521,BILD 3,A06,192679,Butler; Shannon Rhey,27,0,32,5
1683631678521,BILD 3,A07,192682,Butler; Shannon Rhey,20,0,32,12
1683631679554,BILD 4,A01,192836,Reuther; Keefe,0,0,24,24
1683631679554,BILD 4,A02,193044,Reuther; Keefe,4,0,24,20
1683631680588,BILD 10,A01,193142,Gustafson-Brown; Cindy,29,0,32,3
1683631680588,BILD 10,A02,193149,Gustafson-Brown; Cindy,31,0,32,1
1683631681621,BIMM 100,A01,193301,Staff,0,6,32,32
1683631681621,BIMM 100,A02,193312,Staff,0,7,32,32
1683631681621,BIMM 100,A03,193323,Staff,0,9,32,32
1683631682654,BIMM 101,A01,193329,McDonnell; Lisa Marie,0,4,24,24
1683631682654,BIMM 101,A02,193339,McDonnell; Lisa Marie,0,3,24,24
1683631682654,BIMM 101,B01,193354,McDonnell; Lisa Marie,0,4,24,24
1683631682654,BIMM 101,B02,193357,McDonnell; Lisa Marie,0,2,24,24
1683631683687,BIMM 110,A01,193377,Tat; John,0,11,32,32
1683631683687,BIMM 110,A02,193378,Tat; John,0,10,32,32
1683631684724,BIMM 120,A01,206116,Staff,0,0,32,32
1683631684724,BIMM 120,A02,206117,Staff,6,0,32,26
1683631684724,BIMM 120,A03,206121,Staff,21,0,32,11
1683631685755,BIPN 100,A01,193393,Park; Ji Young,0,14,32,32
1683631685755,BIPN 100,A02,193402,Park; Ji Young,0,14,32,32
1683631685755,BIPN 100,A03,193413,Park; Ji Young,0,14,32,32
1683631685755,BIPN 100,A04,193414,Park; Ji Young,0,13,32,32
1683631686787,BIPN 102,A01,193429,Staff,0,0,32,32
1683631686787,BIPN 102,A02,193438,Staff,18,0,32,14
1683631687818,BIPN 106,A01,193450,Reyes Gonzalez; Catalina,0,2,40,40
1683631688850,BIPN 134,A01,193465,Cooke; James Edward,0,0,32,32
1683631688850,BIPN 134,A02,193474,Cooke; James Edward,25,0,32,7
1683631688850,BIPN 134,A03,193485,Cooke; James Edward,29,0,32,3
1683631688850,BIPN 134,A04,193486,Cooke; James Edward,20,0,32,12
1683631688850,BIPN 134,A05,193491,Cooke; James Edward,31,0,32,1
1683631688850,BIPN 134,A06,193501,Cooke; James Edward,30,0,32,2
1683631688850,BIPN 134,A07,193510,Cooke; James Edward,29,0,32,3
1683631690918,BISP 194,A00,222522,Staff,14,0,32,18
1683631691953,CAT 124,A01,202407,Staff,19,0,25,6
1683631692995,CAT 125,A00,202408,Marchisotto; Jennifer Anne,2,0,20,18
1683631694031,CAT 125R,A00,202409,Smith; Lauryn Alissa,0,11,20,20
1683631694031,CAT 125R,B00,202410,Morales; Celeste Georgianna,0,11,20,20
1683631694031,CAT 125R,C00,202411,Irwin; Matthew Joseph,0,12,20,20
1683631695068,CENG 15,A01,204712,Yang; Kesong,0,1,0,0
1683631696100,CENG 114,A00,202070,Jahed Motlagh; Zeinab,5,0,20,15
1683631697134,CGS 105,A00,185477,Wesling; Megan E.,24,0,40,16
1683631698164,CGS 106,A00,185494,Staff,11,0,22,11
1683631699197,CGS 108,A00,185495,Staff,14,0,20,6
1683631700233,CGS 114,A00,185496,Staff,13,0,18,5
1683631701267,CGS 119,A00,185501,Staff,15,0,20,5
1683631702302,CGS 120,A00,185511,Staff,12,0,20,8
1683631703335,CHEM 4,A01,184675,Bussey; Thomas J,97,0,100,3
1683631704367,CHEM 6A,A01,184677,Staff,33,0,60,27
1683631705396,CHEM 6B,A01,184679,Staff,63,0,100,37
1683631706428,CHEM 6C,A01,184681,Bussey; Thomas J,0,0,50,50
1683631706428,CHEM 6C,A02,184682,Bussey; Thomas J,32,0,50,18
1683631707482,CHEM 40A,A01,184684,Albizati; Kim F.,35,0,100,65
1683631708512,CHEM 40B,A01,184686,Albizati; Kim F.,0,22,100,100
1683631709543,CHEM 41B,A01,184690,Staff,51,0,100,49
1683631710580,COGS 3,A01,184715,Boyle; Mary E. T.,0,27,40,40
1683631711609,COGS 14B,A01,185172,Staff,0,14,38,38
1683631712640,COGS 18,A01,184736,Staff,15,0,80,65
1683631713676,COGS 100,A01,184932,Staff,0,7,73,73
1683631714707,COGS 101A,A01,184935,Staff,0,39,30,30
1683631715737,COGS 101B,A01,184944,Staff,0,2,30,30
1683631716766,COGS 101C,A01,184946,Staff,0,10,30,30
1683631717797,COGS 102A,A01,184951,Johnson; Christine M.,2,0,40,38
1683631718829,COGS 107B,A01,184953,Mooshagian; Eric Frederick,0,51,40,40
1683631719860,COGS 118B,A01,184959,Gupta; Anjum,0,49,40,40
1683631720887,COGS 153,A00,184961,Staff,0,16,30,30
1683631721921,COGS 177,A00,184962,Staff,0,21,30,30
1683631722953,COGS 187A,A01,184969,Boyle; Mary E. T.,0,19,40,40
1683631723984,COMM 10,A01,185174,Staff,0,5,25,25
1683631723984,COMM 10,A02,185189,Staff,0,2,25,25
1683631723984,COMM 10,A03,269821,Staff,0,1,0,0
1683631725016,COMM 100B,A01,185475,Staff,0,1,0,2
1683631725016,COMM 100B,A02,185476,Staff,12,0,25,13
1683631726044,COMM 100C,A01,185314,Staff,1,0,25,24
1683631726044,COMM 100C,A02,185327,Staff,18,0,25,7
1683631727072,COMM 110M,A00,185349,Staff,0,0,40,40
1683631728107,COMM 113T,A00,185352,Staff,25,0,40,15
1683631729137,COMM 114I,A00,185353,Staff,31,0,40,9
1683631730170,COMM 131,A00,185354,Staff,17,0,30,13
1683631731205,CSE 8A,A50,185358,Cao; Yingjun,0,46,10,10
1683631732241,CSE 8B,A01,185362,Staff,0,48,50,50
1683631733272,CSE 11,A01,185416,Cao; Yingjun,0,91,10,10
1683631734307,CSE 20,A01,185445,Briones; Jor-el Thomas Caparas,4,0,25,21
1683631735338,CSE 21,A01,185447,Staff,9,0,50,41
1683631736373,CSE 101,A01,185451,Staff,0,13,50,50
1683631736373,CSE 101,B01,185453,Jones; Miles E,0,13,50,50
1683631738434,CSE 141,A01,185458,Eldon; John,15,0,100,85
1683631739463,CSE 141L,A01,185461,Eldon; John,7,0,100,93
1683631740494,CSE 142,A01,185463,Staff,36,0,60,24
1683631740494,CSE 142,B01,201355,Staff,0,7,60,60
1683631741523,CSE 142L,A01,185470,Staff,36,0,60,24
1683631741523,CSE 142L,B01,201417,Staff,0,6,60,60
1683631742558,CSE 190,A00,201433,Staff,32,0,49,17
1683631743594,DOC 1,A01,259136,Strom; Megan C.,7,0,15,8
1683631743594,DOC 1,A02,259137,Strom; Megan C.,14,0,15,1
1683631743594,DOC 1,A03,259138,Strom; Megan C.,14,0,15,1
1683631743594,DOC 1,A04,259139,Strom; Megan C.,14,0,15,1
1683631744630,DOC 100D,A00,259140,Pass; Natalye Joann,14,0,25,11
1683631745660,DSGN 1,A01,184749,Rill; Bryan,0,26,30,30
1683631746689,DSGN 100,A01,185168,Staff,0,2,25,25
1683631747721,ECE 5,A01,185626,Morris; Karcher William,0,11,0,0
1683631748752,ECE 101,A01,185628,Staff,14,0,70,56
1683631749783,ECE 107,A01,185635,Baghdadchi; Saharnaz,0,0,20,20
1683631749783,ECE 107,A02,185638,Baghdadchi; Saharnaz,3,0,20,17
1683631750810,ECE 148,A01,185647,Silberman; Jack,0,0,16,16
1683631751839,ECON 1,A01,185537,Crane; Meredith Helen,54,0,70,16
1683631752870,ECON 3,A01,185549,Crane; Meredith Helen,29,0,70,41
1683631753959,ECON 4,A01,203354,Anderson; John Charles,0,5,10,10
1683631754991,ECON 100A,A01,185574,Staff,0,5,40,40
1683631756019,ECON 100B,A01,185576,Staff,0,12,50,50
1683631757050,ECON 100C,A01,185589,Newhouse; Herbert S,30,0,70,40
1683631758085,ECON 105,A00,185608,Vespa; Emanuel Ignacio,19,0,35,16
1683631759117,ECON 109,A01,185610,Shishkin; Denis,9,0,35,26
1683631760150,ECON 110A,A01,185612,Staff,9,0,40,31
1683631761178,ECON 120A,A01,185615,Staff,20,0,40,20
1683631762207,ECON 120C,A01,185617,Sun; Yixiao,0,20,70,70
1683631763238,ECON 144,A00,203346,Squires; Dale E,2,0,35,33
1683631764267,ECON 171,A01,203349,Newhouse; Herbert S,0,1,35,35
1683631765298,ECON 173A,A01,185621,Toda; Alexis Akira,21,0,35,14
1683631766332,EDS 25,A01,202413,Staff,0,1,0,0
1683631766332,EDS 25,A02,202414,Staff,0,1,0,0
1683631766332,EDS 25,A03,202415,Staff,0,0,0,0
1683631766332,EDS 25,A04,202416,Staff,0,1,0,0
1683631766332,EDS 25,A05,202439,Staff,0,0,0,0
1683631766332,EDS 25,A06,202440,Staff,0,0,0,0
1683631766332,EDS 25,B01,202631,Staff,0,0,0,0
1683631766332,EDS 25,B02,202632,Staff,0,0,0,0
1683631766332,EDS 25,B03,202639,Staff,0,0,0,0
1683631766332,EDS 25,B04,202640,Staff,0,0,0,0
1683631766332,EDS 25,B05,202643,Staff,0,0,0,0
1683631766332,EDS 25,B06,202644,Staff,0,0,0,0
1683631767363,EDS 38,A01,202659,Black; Alison Michelle,24,0,25,1
1683631768392,EDS 115,A00,202652,Staff,18,0,30,12
1683631769422,EDS 125,A00,202649,Staff,13,0,30,17
1683631770454,EDS 126,A01,203332,Staff,30,0,30,0
1683631771483,EDS 139,A00,202838,Staff,16,0,25,9
1683631772514,EDS 146,A01,202655,Staff,14,0,25,11
1683631773552,ENG 15,A00,185667,Staff,0,1,0,0
1683631773552,ENG 15,B00,185672,Staff,0,0,0,0
1683631773552,ENG 15,C00,185675,Staff,0,0,0,0
1683631773552,ENG 15,D00,185682,Staff,0,0,0,0
1683631773552,ENG 15,E00,185684,Staff,0,0,0,0
1683631774581,ETHN 103,A00,185710,Staff,0,8,35,35
1683631775616,ETHN 103A,A00,199228,Man; Simeon S,0,0,9,9
1683631776650,ETHN 109,A00,185711,Staff,16,0,35,19
1683631777681,ETHN 142,A00,185726,Staff,0,4,30,30
1683631778712,ETHN 163J,A00,199229,Man; Simeon S,5,0,8,3
1683631779744,ETHN 168,A00,185727,Staff,7,0,10,3
1683631780775,ETHN 182,A00,185728,Staff,0,0,35,35
1683631781810,ETHN 183,A00,185737,Staff,9,0,18,9
1683631782843,GLBH 111,A01,209361,Burgos; Jose L.,0,0,0,0
1683631784904,HIEU 104,A00,185792,Staff,14,0,20,6
1683631785934,HIEU 115,A00,185800,Staff,0,0,20,20
1683631786964,HIEU 128,A00,185801,Staff,0,9,20,20
1683631787997,HIEU 147,A00,185802,Staff,15,0,20,5
1683631789026,HIEU 154,A00,185823,Staff,11,0,20,9
1683631790056,HILA 102,A00,185826,Staff,14,0,20,6
1683631791088,HILD 2C,A01,185778,Staff,0,13,20,20
1683631792124,HILD 7B,A01,185780,Kwak; Nancy,0,16,32,32
1683631792124,HILD 7B,A02,185781,Kwak; Nancy,0,18,32,32
1683631793157,HILD 30,A01,185791,Staff,12,0,20,8
1683631794185,HISC 119,A00,185830,Golan; Tal,0,9,20,20
1683631795215,HITO 156GS,A00,185831,Patterson; Patrick H.,0,0,0,23
1683631796248,HIUS 103,A00,185832,Man; Simeon S,0,4,20,20
1683631797278,HIUS 117,A00,185836,Kwak; Nancy,2,0,20,18
1683631798305,HIUS 125,A00,185840,Man; Simeon S,0,1,23,23
1683631799335,HIUS 149,A00,185845,Staff,1,0,20,19
1683631800364,HUM 3,A01,185882,Zavodny; Tatiana Sophia,0,7,50,50
1683631800364,HUM 3,B01,185899,Caldwell; Michael Alan,0,18,50,50
1683631801406,HUM 3GS,A00,185900,Patterson; Patrick H.,0,0,0,23
1683631802446,HUM 4,A01,185938,Zroka; Amy Liane,30,0,50,20
1683631802446,HUM 4,B01,185956,Watkins; Eric,0,4,50,50
1683631802446,HUM 4,B02,202209,Watkins; Eric,0,4,50,50
1683631802446,HUM 4,B03,202210,Watkins; Eric,0,4,50,50
1683631803480,HUM 5,A01,185958,West; Geoffrey Scott,2,0,50,48
1683631803480,HUM 5,A02,202215,West; Geoffrey Scott,0,0,50,50
1683631804513,INTL 190,A00,185959,Gagnon; Jeffrey C,0,0,0,9
1683631804513,INTL 190,B00,185960,Lettieri; Michael Joseph,0,0,0,2
1683631805540,JAPN 180,A00,254509,Staff,5,0,30,25
1683631806571,LATI 10,A01,202853,Kennemore; Amy Michelle,4,0,35,31
1683631806571,LATI 10,A02,202854,Kennemore; Amy Michelle,2,0,35,33
1683631806571,LATI 10,A03,270054,Kennemore; Amy Michelle,30,0,30,0
1683631807599,LATI 180,A00,202855,Kennemore; Amy Michelle,11,0,20,9
1683631808628,LAWS 101,A00,201767,Golan; Tal,0,7,40,40
1683631809658,LIFR 1C,A00,185961,Staff,6,0,20,14
1683631810686,LIFR 1CX,A00,185962,Staff,7,0,20,13
1683631811716,LIFR 1D,A00,185963,Staff,7,0,20,13
1683631812745,LIFR 1DX,A00,185964,Staff,7,0,20,13
1683631813776,LIGN 101,A01,186039,Staff,43,0,50,7
1683631814807,LIGN 165,A00,186040,Staff,15,0,50,35
1683631815836,LTCS 108,A00,186041,Staff,5,0,10,5
1683631816866,LTCS 119,A00,186042,Staff,15,0,20,5
1683631817896,LTCS 130,A00,186043,Wesling; Megan E.,15,0,25,10
1683631819963,LTEA 138,A00,186119,Staff,14,0,40,26
1683631820995,LTEN 124,A00,186148,Staff,6,0,25,19
1683631822028,LTEN 178,A00,186149,Staff,7,0,15,8
1683631823058,LTEN 181,A00,186150,Blanco; John D,34,0,40,6
1683631824085,LTWL 120,A00,186160,Staff,20,0,25,5
1683631825114,LTWL 165,A00,186161,Staff,22,0,25,3
1683631826139,LTWR 100,A00,186162,Staff,0,5,15,15
1683631827171,LTWR 102,A00,186163,Doller; Ben,5,0,15,10
1683631828208,MAE 8,A01,186412,Staff,0,0,0,0
1683631829242,MAE 30B,A00,186445,Bahadori; Mohammad Yousef,82,0,100,18
1683631830273,MAE 40,A00,186592,Bewley; Thomas R,10,0,50,40
1683631831303,MAE 101B,A00,186593,Bahadori; Mohammad Yousef,80,0,100,20
1683631832334,MAE 105,A00,186594,Bandaru; Prabhakar,10,0,50,40
1683631833364,MAE 107,A00,186599,Pham; Hieu Tan,0,7,120,120
1683631834395,MAE 148,A01,186660,Silberman; Jack,3,0,16,13
1683631835426,MATH 10A,A01,188095,Staff,0,5,35,35
1683631836458,MATH 10B,A01,188097,Bowers; Adam R.,0,11,30,30
1683631836458,MATH 10B,A02,188099,Bowers; Adam R.,0,11,30,30
1683631836458,MATH 10B,B01,188104,Bowers; Adam R.,0,10,30,30
1683631836458,MATH 10B,B02,188106,Bowers; Adam R.,1,9,30,29
1683631837494,MATH 10C,A01,188111,Staff,0,18,30,30
1683631837494,MATH 10C,A02,188127,Staff,0,19,30,30
1683631837494,MATH 10C,A03,188131,Staff,0,19,30,30
1683631837494,MATH 10C,B01,188218,Staff,17,0,30,13
1683631837494,MATH 10C,B02,188244,Staff,13,0,30,17
1683631837494,MATH 10C,B03,188277,Staff,14,0,30,16
1683631838530,MATH 18,A01,188344,Bach; Quang Tran,18,0,30,12
1683631838530,MATH 18,A02,188345,Bach; Quang Tran,11,0,30,19
1683631838530,MATH 18,B01,188353,Bach; Quang Tran,11,0,30,19
1683631838530,MATH 18,B02,188354,Bach; Quang Tran,19,0,30,11
1683631839563,MATH 20A,A01,188374,Staff,11,0,35,24
1683631840600,MATH 20B,A01,188382,Ohm; Ko Woon,7,0,30,23
1683631840600,MATH 20B,A02,188383,Ohm; Ko Woon,22,0,30,8
1683631840600,MATH 20B,B01,188385,Ohm; Ko Woon,7,0,30,23
1683631840600,MATH 20B,B02,188392,Ohm; Ko Woon,22,0,30,8
1683631841635,MATH 20C,A01,188394,Harel; Guershon,11,0,30,19
1683631841635,MATH 20C,A02,188395,Harel; Guershon,14,0,30,16
1683631841635,MATH 20C,B01,188404,Harel; Guershon,4,0,30,26
1683631841635,MATH 20C,B02,188405,Harel; Guershon,18,0,30,12
1683631842671,MATH 20D,A01,188414,Hammock; Frances H,0,1,30,30
1683631842671,MATH 20D,A02,188415,Hammock; Frances H,0,1,30,30
1683631842671,MATH 20D,B01,188447,Hammock; Frances H,0,1,30,30
1683631842671,MATH 20D,B02,188486,Hammock; Frances H,4,0,30,26
1683631843702,MATH 20E,A01,188649,Staff,21,0,30,9
1683631843702,MATH 20E,A02,188650,Staff,21,0,30,9
1683631843702,MATH 20E,A03,188673,Staff,0,0,30,30
1683631844732,MATH 102,A01,188675,Staff,0,36,35,35
1683631845764,MATH 103B,A01,188681,Staff,3,0,35,32
1683631845764,MATH 103B,B01,188692,Staff,5,0,35,30
1683631846796,MATH 109,A01,188695,Salehi Golsefidy; Alireza,24,0,35,11
1683631846796,MATH 109,A02,188696,Salehi Golsefidy; Alireza,25,0,35,10
1683631847827,MATH 120A,A01,188698,Eggers; John Dietrich,7,0,35,28
1683631848856,MATH 142B,A01,188736,Ioana; Adrian,0,1,30,30
1683631848856,MATH 142B,A02,188741,Ioana; Adrian,0,1,30,30
1683631848856,MATH 142B,A03,188743,Ioana; Adrian,0,1,30,30
1683631849886,MATH 168A,A01,188790,Staff,0,10,35,35
1683631850916,MATH 170A,A01,188803,Nie; Jiawang,0,2,35,35
1683631850916,MATH 170A,A02,188811,Nie; Jiawang,0,0,35,35
1683631850916,MATH 170A,A03,188814,Nie; Jiawang,0,0,35,35
1683631850916,MATH 170A,A04,188815,Nie; Jiawang,10,0,35,25
1683631851947,MATH 193B,A01,188817,Staff,0,0,35,35
1683631851947,MATH 193B,A02,188818,Staff,5,0,35,30
1683631852977,MGT 4,A01,202857,Anderson; John Charles,61,0,80,19
1683631854008,MGT 12,A00,202858,Lindenberger; Wade Douglas,40,0,90,50
1683631855038,MGT 18,A00,202859,Staff,74,0,90,16
1683631856071,MGT 18GS,A00,202860,McKay; Michael J,13,0,28,15
1683631857099,MGT 45,A00,202861,Pecore; Joseph P.,12,0,90,78
1683631858200,MGT 100,A00,202863,Yavorsky; Daniel Ryan,28,0,90,62
1683631859244,MGT 103,A00,202864,Ehrich; Kristine R,0,17,90,90
1683631860276,MGT 112,A00,202865,Ehrich; Kristine R,15,0,90,75
1683631861325,MGT 121A,A00,202868,Staff,0,20,0,0
1683631862353,MGT 131B,A00,202869,Anderson; John Charles,59,0,90,31
1683631863385,MGT 136,A00,202871,Lindenberger; Wade Douglas,83,0,90,7
1683631864412,MGT 164,A00,202873,Staff,0,66,90,91
1683631865444,MGT 164GS,A00,202874,McKay; Mary A,13,0,28,15
1683631866481,MGT 180,A00,202875,Staff,0,50,90,91
1683631867514,MMW 11R,A01,205019,Herbst; Matthew,2,0,30,28
1683631867514,MMW 11R,A02,205026,Herbst; Matthew,29,0,30,1
1683631868549,MMW 15,A01,193512,Chang; Edmond Yi-Teh,0,8,28,28
1683631868549,MMW 15,A02,193513,Chang; Edmond Yi-Teh,0,5,28,28
1683631868549,MMW 15,A03,193514,Chang; Edmond Yi-Teh,0,5,28,28
1683631868549,MMW 15,A04,193515,Chang; Edmond Yi-Teh,0,5,28,28
1683631868549,MMW 15,A05,193516,Chang; Edmond Yi-Teh,0,5,28,28
1683631868549,MMW 15,A06,193517,Chang; Edmond Yi-Teh,0,6,28,28
1683631868549,MMW 15,B01,193519,Chang; Edmond Yi-Teh,0,5,28,28
1683631868549,MMW 15,B02,193520,Chang; Edmond Yi-Teh,0,5,28,28
1683631868549,MMW 15,B03,193521,Chang; Edmond Yi-Teh,0,5,28,28
1683631868549,MMW 15,B04,193522,Chang; Edmond Yi-Teh,0,5,28,28
1683631868549,MMW 15,B05,193523,Chang; Edmond Yi-Teh,0,5,28,28
1683631868549,MMW 15,B06,193524,Chang; Edmond Yi-Teh,0,5,28,28
1683631869584,MMW 122,A01,193526,Rahimi; Babak,0,16,28,28
1683631869584,MMW 122,A02,193527,Rahimi; Babak,0,15,28,28
1683631869584,MMW 122,A03,193528,Rahimi; Babak,0,0,0,0
1683631869584,MMW 122,A04,193529,Rahimi; Babak,0,0,0,0
1683631870613,MUS 1A,A01,186663,Staff,1,20,35,34
1683631871643,MUS 4,A01,186715,Staff,0,12,35,35
1683631872669,MUS 5R,A01,186796,Dubnov; Shlomo,0,17,35,35
1683631873699,MUS 6,A01,186798,Staff,0,5,25,25
1683631874728,MUS 7,A01,186830,Staff,11,0,35,24
1683631875761,MUS 8,A01,186930,Staff,0,26,35,35
1683631876797,MUS 15,A01,186932,Staff,0,16,35,35
1683631876797,MUS 15,B01,186934,Staff,0,16,35,35
1683631877831,MUS 80,A00,186935,Staff,0,0,20,20
1683631877831,MUS 80,B00,186936,Staff,24,0,25,1
1683631878861,NANO 11,A00,204702,Lipomi; Darren John,0,0,0,0
1683631879899,NANO 15,A01,204709,Yang; Kesong,0,1,0,0
1683631880935,NANO 114,A00,202069,Jahed Motlagh; Zeinab,3,0,10,7
1683631881966,PHIL 1,A00,186955,Grush; Rick Scott,31,0,40,9
1683631883001,PHIL 10,A01,186973,Grush; Rick Scott,27,0,35,8
1683631883001,PHIL 10,A02,186974,Grush; Rick Scott,33,0,35,2
1683631884038,PHIL 13,A01,186976,Staff,3,0,35,32
1683631884038,PHIL 13,A02,186977,Staff,16,0,35,19
1683631885068,PHIL 14,A01,186979,Staff,31,0,35,4
1683631885068,PHIL 14,A02,186986,Staff,32,0,35,3
1683631886097,PHIL 28,A01,186988,Staff,16,0,30,14
1683631886097,PHIL 28,A02,186989,Staff,1,0,30,29
1683631886097,PHIL 28,A03,186990,Staff,10,0,30,20
1683631886097,PHIL 28,A04,186991,Staff,26,0,30,4
1683631887124,PHIL 120,A00,186997,Staff,23,0,40,17
1683631888152,PHIL 137,A00,187003,Staff,7,0,40,33
1683631889183,PHIL 150,A00,187015,Staff,47,0,70,23
1683631890225,PHIL 167,A00,187021,Lamey; Andy M.,34,0,40,6
1683631891251,PHIL 174,A01,202226,Staff,17,0,20,3
1683631891251,PHIL 174,A02,202235,Staff,20,0,20,0
1683631892278,PHIL 191A,A00,258918,Staff,0,0,1,1
1683631893314,PHYS 1A,A00,187028,Staff,27,0,60,33
1683631894347,PHYS 1AL,001,187036,Staff,3,0,30,27
1683631894347,PHYS 1AL,002,187049,Staff,18,0,30,12
1683631895375,PHYS 1B,A00,187058,Staff,22,0,60,38
1683631896404,PHYS 1BL,001,187064,Staff,0,1,30,30
1683631896404,PHYS 1BL,002,187070,Staff,4,0,30,26
1683631897432,PHYS 1C,A00,187082,Staff,29,0,120,91
1683631898469,PHYS 1CL,001,187088,Staff,0,9,30,30
1683631898469,PHYS 1CL,002,187089,Staff,0,1,30,30
1683631898469,PHYS 1CL,009,262693,Staff,9,0,30,21
1683631899498,PHYS 2B,A01,187097,Staff,55,0,115,60
1683631900530,PHYS 2C,A01,187099,Staff,64,0,115,51
1683631901564,PHYS 2CL,A01,187101,Staff,5,0,28,23
1683631901564,PHYS 2CL,A02,187102,Staff,15,0,28,13
1683631902597,PHYS 2D,A01,187123,Shotwell; Brian,95,0,115,20
1683631903635,PHYS 4B,A01,187133,Grinstein; Benjamin,35,0,50,15
1683631904662,POLI 10,A00,188819,Staff,0,4,50,50
1683631905694,POLI 11,A00,188827,Staff,43,0,50,7
1683631906722,POLI 13R,A00,188828,Staff,0,1,20,20
1683631907753,POLI 27,A01,188830,Elgin; Samuel Zincke,0,2,70,70
1683631908782,POLI 30,A00,188832,Desposato; Scott,30,0,50,20
1683631909812,POLI 102F,A00,188834,Staff,0,0,40,40
1683631910838,POLI 104A,A00,188852,Staff,13,0,30,17
1683631911867,POLI 104I,A00,188853,Staff,0,7,20,20
1683631912896,POLI 110B,A00,188854,Wiens; David,7,0,20,13
1683631913928,POLI 112A,A00,188855,Wiens; David,4,0,30,26
1683631914956,POLI 117R,A00,188856,Forman; Fonna,0,12,20,20
1683631915982,POLI 118,A00,188857,Ingham; Sean,8,0,20,12
1683631917010,POLI 120G,A00,188858,Staff,8,0,30,22
1683631918040,POLI 131CR,A00,188863,Hoston; Germaine,21,0,50,29
1683631919067,POLI 133,A00,188864,Nellis; Gareth Hb,44,0,50,6
1683631920093,POLI 134D,A00,188865,Desposato; Scott,27,0,30,3
1683631921123,POLI 142A,A00,188871,Gartzke; Erik,21,0,50,29
1683631922151,POLI 142K,A00,188874,Staff,38,0,50,12
1683631923178,POLI 143,A00,188940,Gartzke; Erik,16,0,30,14
1683631924211,POLI 153,A00,188943,Staff,2,0,20,18
1683631925240,POLI 160AA,A00,188944,Staff,11,0,40,29
1683631926270,POLI 170A,A00,188945,Staff,11,0,30,19
1683631928338,PSYC 1,A00,188952,Staff,36,0,90,54
1683631929367,PSYC 2,B00,188953,Staff,19,0,35,16
1683631930398,PSYC 6,A00,188970,Staff,47,0,60,13
1683631931428,PSYC 7,A00,188973,Staff,35,0,45,10
1683631932458,PSYC 60,A01,188980,Rickard; Timothy C.,42,0,60,18
1683631933488,PSYC 70,A01,189001,Steiner; Eric Tomas,23,0,45,22
1683631934517,PSYC 100,A00,189005,Lacefield; Katharine I,0,99,120,120
1683631935545,PSYC 102,A00,189008,Staff,8,0,30,22
1683631936573,PSYC 106,B00,189026,Gorman; Michael R.,27,0,60,33
1683631937600,PSYC 114,B01,189033,Winkielman; Piotr,0,31,30,30
1683631938630,PSYC 131,A00,189036,Anagnostaras; Stephan,0,43,60,60
1683631939665,PSYC 136,A00,189041,Lowe; Angela Beth,0,7,25,25
1683631940695,PSYC 137,A00,189057,Winkielman; Piotr,0,37,25,25
1683631941731,PSYC 144,A00,189107,Wixted; John T,0,10,50,50
1683631943792,PSYC 162,A00,189142,Staff,0,9,85,85
1683631944825,PSYC 172,A00,189144,Gorman; Michael R.,0,6,30,30
1683631946887,PSYC 179,A00,189146,Lacefield; Katharine I,0,86,120,120
1683631947915,PSYC 181,A00,189147,Anagnostaras; Stephan,0,44,90,90
1683631948947,PSYC 190R,A00,189148,Barner; David A.,0,23,80,80
1683631949982,PSYC 191,A00,189275,Rickard; Timothy C.,0,10,25,25
1683631951015,PSYC 193,A00,189276,Chapman; Eddie Nathaniel,0,1,0,4
1683631952050,PSYC 193L,A01,189281,Lowe; Angela Beth,10,0,20,10
1683631952050,PSYC 193L,B01,189285,Staff,28,0,35,7
1683631953083,RELI 149,A00,187137,Rahimi; Babak,7,0,40,33
1683631954117,SE 9,A01,187315,Staff,0,2,18,18
1683631955148,SE 101B,A00,187409,Staff,24,0,30,6
1683631956183,SE 110B,A00,187444,Staff,10,0,40,30
1683631957216,SE 130B,A00,187449,Staff,31,0,40,9
1683631958244,SE 150A,A00,187516,Staff,9,0,20,11
1683631959281,SE 154,A00,187528,Staff,29,0,50,21
1683631960313,SIO 3,A01,258171,Staff,35,0,40,5
1683631961346,SIO 10,A00,187144,Cook; Geoffrey W,0,6,75,75
1683631962436,SIO 45,A00,187152,Cook; Geoffrey W,0,4,100,100
1683631963469,SIO 109R,A00,194486,Staff,0,4,20,20
1683631965530,SIO 187,A01,187233,Kacev; David,12,0,40,28
1683631966561,SOCI 1,A01,258656,Thorpe; Charles Robert,28,0,30,2
1683631966561,SOCI 1,A02,258658,Thorpe; Charles Robert,30,0,30,0
1683631966561,SOCI 1,A03,258661,Thorpe; Charles Robert,25,0,25,0
1683631966561,SOCI 1,A04,258666,Thorpe; Charles Robert,22,0,25,3
1683631966561,SOCI 1,A05,258897,Thorpe; Charles Robert,22,0,25,3
1683631966561,SOCI 1,A06,258898,Thorpe; Charles Robert,25,0,25,0
1683631967591,SOCI 30,A01,258903,Pardo Guerra; Juan Pablo,14,0,30,16
1683631968621,SOCI 102,A00,258904,Staff,9,0,25,16
1683631969649,SOCI 106,A00,258905,Staff,19,0,25,6
1683631970678,SOCI 111,A00,258907,Ribas Norris; Janet Vanesa,26,0,30,4
1683631971709,SOCI 121R,A00,258908,Pardo Guerra; Juan Pablo,8,0,30,22
1683631972741,SOCI 126,A01,203330,Staff,14,0,20,6
1683631973768,SOCI 131,A00,258909,Thorpe; Charles Robert,30,0,60,30
1683631974798,SOCI 135,A00,258910,Payne; Christine Anna,0,11,30,30
1683631975829,SOCI 157,A00,258911,Staff,12,0,30,18
1683631976859,SOCI 184,A00,258912,Staff,25,0,30,5
1683631977886,SOCI 188D,A00,258913,Staff,22,0,30,8
1683631978915,SYN 2,001,187529,Staff,9,0,16,7
1683631978915,SYN 2,002,201452,Staff,0,20,16,16
1683631978915,SYN 2,003,201469,Staff,2,0,16,14
1683631979946,SYN 100,A01,187531,Staff,0,9,20,20
1683631979946,SYN 100,B01,201491,Staff,0,10,20,20
1683631980975,TDAC 1,A00,189286,Walsh; Kim C.,3,0,20,17
1683631980975,TDAC 1,B00,189287,Harting; Carla Kelso,10,0,20,10
1683631982006,TDAC 101,A00,189300,Walsh; Kim C.,16,0,20,4
1683631982006,TDAC 101,B00,189301,Harting; Carla Kelso,18,0,20,2
1683631983039,TDAC 102,A00,189304,Basso; Beatrice,14,0,20,6
1683631984070,TDAC 108,A00,189305,Staff,18,0,20,2
1683631985103,TDDE 131,A00,189310,Staff,19,0,20,1
1683631985103,TDDE 131,B00,189314,Staff,19,0,20,1
1683631985103,TDDE 131,C00,189315,Staff,48,0,50,2
1683631985103,TDDE 131,D00,189316,Staff,14,0,15,1
1683631985103,TDDE 131,E00,204841,Staff,20,0,20,0
1683631986138,TDGE 10,A00,189289,Staff,28,0,50,22
1683631986138,TDGE 10,B00,189290,Havis; Allan,0,0,50,50
1683631987170,TDGE 11,A00,189291,Fulton; Julia,0,4,50,50
1683631987170,TDGE 11,B00,189292,Staff,20,0,25,5
1683631987170,TDGE 11,C00,260270,Staff,0,0,0,0
1683631988205,TDGE 25,A00,189294,Staff,2,0,20,18
1683631989237,TDGE 124,A00,189318,Fulton; Julia,0,8,50,50
1683631990266,TDGE 125,A00,189319,Staff,13,0,25,12
1683631990266,TDGE 125,B00,189320,Staff,23,0,25,2
1683631991295,TDGE 127,A00,189322,Havis; Allan,0,0,50,50
1683631992324,TDHT 101,A00,189323,Staff,18,0,25,7
1683631992324,TDHT 101,B00,189324,Staff,25,0,25,0
1683631993352,TDHT 102,A00,189325,Staff,49,0,50,1
1683631994381,TDMV 1,A00,189295,Arcidiacono; Kristin,20,0,30,10
1683631994381,TDMV 1,B00,189296,Caligagan; Maria T.,24,0,30,6
1683631995409,TDMV 2,A00,189297,Sammartano; Tonnie,27,0,30,3
1683631995409,TDMV 2,B00,189299,Arcidiacono; Kristin,23,0,30,7
1683631996441,TDMV 3,A00,204998,Rincon; Alicia,22,0,30,8
1683631997473,TDMV 120,A00,189458,Sammartano; Tonnie,28,0,30,2
1683631998503,TDMV 138,A00,189541,Jun; Grace Shin Hae,20,0,40,20
1683631999534,TDMV 142,A00,189717,Caligagan; Tony,25,0,30,5
1683631999534,TDMV 142,B00,189718,Caligagan; Maria T.,25,0,30,5
1683632000565,TMC 2,A01,187533,Staff,25,0,25,0
1683632000565,TMC 2,A02,187534,Staff,25,0,25,0
1683632001594,USP 1,A01,187536,Kwak; Nancy,0,16,25,25
1683632002625,USP 5,A01,187538,Staff,9,0,25,16
1683632003656,USP 101,A00,199253,Staff,0,4,0,0
1683632004688,USP 124,A00,187562,Boomhower; Matthew Charles,0,0,30,30
1683632005718,USP 138,A00,187582,Staff,20,0,25,5
1683632006755,USP 152,A01,187597,Staff,3,0,25,22
1683632007786,USP 153,A00,187598,Staff,19,0,25,6
1683632019068,USP 168,A00,187607,Kwak; Nancy,2,0,5,3
1683632020097,USP 173,A00,187619,Staff,4,0,25,21
1683632021128,USP 181,A00,187638,Staff,0,4,25,25
1683632022160,VIS 103,A00,187650,Cruz; Edwin Teddy,18,0,75,57
1683632023187,VIS 110D,A00,187669,Staff,13,0,22,9
1683632024218,VIS 127C,A00,187720,Shen; Kuiyi,67,0,146,79
1683632025247,VIS 149,A00,187731,Yoldas; Pinar,0,14,22,22
1683632026276,VIS 151,A01,188091,Staff,22,0,34,12
1683632026276,VIS 151,A02,188092,Staff,11,0,34,23
1683632027310,VIS 160B,A00,188093,Stalbaum; Brett,0,1,10,10
1683632040092,WCWP 10B,A00,201720,Staff,10,0,15,5
1683632040092,WCWP 10B,B00,201722,Staff,9,0,15,6
1683632041119,WCWP 100,A00,201725,Gagnon; Jeffrey C,0,0,2,2
1683632041119,WCWP 100,B00,201727,Staff,0,4,15,15
1683632044271,ANBI 133,A00,258401,Wilder; Linnea Lorene,34,0,40,6
1683632045302,ANBI 140,A00,258395,Hrvoj Mihic; Branka,18,0,25,7
1683632046331,ANSC 120,A00,258402,Bialecki; Jon Anthony,27,0,40,13
1683632047361,ANSC 144,A00,258400,Staff,12,0,40,28
1683632049422,ANSC 166,A00,258396,Parish; Steven Martin,156,0,175,19
1683632051216,ANSC 180,A00,193533,Staff,8,0,20,12
1683632052249,ANSC 188,A00,258397,Jassal; Aftab,34,0,40,6
1683632053281,ANTH 3,A01,258316,Staff,23,0,30,7
1683632054309,ANTH 5,A00,258394,Semendeferi; Ekaterini,16,0,20,4
1683632055338,ANTH 21,A01,258331,Staff,4,0,40,36
1683632056363,ANTH 103,A00,258398,Varma; Saiba,15,0,25,10
1683632057398,AWP 10,001,202034,Staff,0,0,0,0
1683632057398,AWP 10,002,202035,Staff,0,0,0,0
1683632057398,AWP 10,003,202036,Staff,0,0,0,0
1683632057398,AWP 10,004,202037,Staff,0,0,0,0
1683632057398,AWP 10,005,202038,Staff,0,0,0,0
1683632057398,AWP 10,006,202039,Staff,0,0,0,0
1683632057398,AWP 10,007,202040,Staff,0,0,0,0
1683632057398,AWP 10,008,202041,Staff,0,0,0,0
1683632057398,AWP 10,009,202042,Staff,0,0,0,0
1683632057398,AWP 10,010,202043,Staff,0,0,0,0
1683632057398,AWP 10,011,202044,Staff,0,0,0,0
1683632057398,AWP 10,012,202045,Staff,0,0,0,0
1683632057398,AWP 10,013,202046,Staff,0,0,0,0
1683632057398,AWP 10,014,202047,Staff,0,0,0,0
1683632057398,AWP 10,015,202048,Staff,0,0,0,0
1683632057398,AWP 10,016,202049,Staff,0,0,0,0
1683632057398,AWP 10,017,202050,Staff,0,0,0,0
1683632057398,AWP 10,018,202051,Staff,0,0,0,0
1683632057398,AWP 10,019,202052,Staff,0,0,0,0
1683632057398,AWP 10,020,202053,Staff,0,0,0,0
1683632057398,AWP 10,021,202054,Staff,0,0,0,0
1683632057398,AWP 10,022,202055,Staff,0,0,0,0
1683632057398,AWP 10,023,202056,Staff,0,0,0,0
1683632057398,AWP 10,024,202057,Staff,0,0,0,0
1683632057398,AWP 10,025,202058,Staff,0,0,0,0
1683632057398,AWP 10,026,202059,Staff,0,0,0,0
1683632058427,AWP 102,001,202032,Staff,0,0,0,0
1683632058427,AWP 102,002,202033,Staff,0,0,0,0
1683632059454,BENG 100,A01,254234,Taylor Amos; Alyssa C,31,0,40,9
1683632060482,BENG 196,001,270013,Engler; Adam J.,9999,0,9999,0
1683632061512,BICD 100R,A01,202018,Smith; Laurie,0,7,32,32
1683632061512,BICD 100R,A02,202019,Smith; Laurie,0,3,32,32
1683632061512,BICD 100R,A03,202020,Smith; Laurie,0,1,32,32
1683632061512,BICD 100R,A04,202021,Smith; Laurie,6,0,32,26
1683632061512,BICD 100R,A05,202022,Smith; Laurie,11,0,32,21
1683632062546,BICD 136,A01,193242,Gustafson-Brown; Cindy,0,2,32,32
1683632062546,BICD 136,A02,193244,Gustafson-Brown; Cindy,13,0,32,19
1683632063578,BIEB 102,A01,193249,Butler; Shannon Rhey,0,2,32,32
1683632063578,BIEB 102,A02,193251,Butler; Shannon Rhey,0,0,32,32
1683632063578,BIEB 102,A03,193253,Butler; Shannon Rhey,0,0,32,32
1683632063578,BIEB 102,A04,193255,Butler; Shannon Rhey,14,0,32,18
1683632063578,BIEB 102,A05,193265,Butler; Shannon Rhey,26,0,32,6
1683632063578,BIEB 102,A06,193269,Butler; Shannon Rhey,14,0,32,18
1683632065635,BIEB 150,A01,193274,Staff,0,0,32,32
1683632065635,BIEB 150,A02,193285,Staff,24,0,32,8
1683632066666,BIEB 194,A00,193286,Kurle; Carolyn M.,20,0,32,12
1683632067700,BILD 1,A01,192291,Staff,15,0,32,17
1683632067700,BILD 1,A02,192292,Staff,30,0,32,2
1683632067700,BILD 1,B01,192520,Reuther; Keefe,0,1,0,0
1683632067700,BILD 1,B02,192532,Reuther; Keefe,0,1,0,0
1683632068730,BILD 3,A01,192556,Butler; Shannon Rhey,0,0,32,32
1683632068730,BILD 3,A02,192581,Butler; Shannon Rhey,1,0,32,31
1683632068730,BILD 3,A03,192611,Butler; Shannon Rhey,21,0,32,11
1683632068730,BILD 3,A04,192612,Butler; Shannon Rhey,24,0,32,8
1683632068730,BILD 3,A05,192613,Butler; Shannon Rhey,26,0,32,6
1683632068730,BILD 3,A06,192679,Butler; Shannon Rhey,27,0,32,5
1683632068730,BILD 3,A07,192682,Butler; Shannon Rhey,20,0,32,12
1683632069764,BILD 4,A01,192836,Reuther; Keefe,0,0,24,24
1683632069764,BILD 4,A02,193044,Reuther; Keefe,4,0,24,20
1683632070795,BILD 10,A01,193142,Gustafson-Brown; Cindy,29,0,32,3
1683632070795,BILD 10,A02,193149,Gustafson-Brown; Cindy,31,0,32,1
1683632071823,BIMM 100,A01,193301,Staff,0,6,32,32
1683632071823,BIMM 100,A02,193312,Staff,0,7,32,32
1683632071823,BIMM 100,A03,193323,Staff,0,9,32,32
1683632072859,BIMM 101,A01,193329,McDonnell; Lisa Marie,0,4,24,24
1683632072859,BIMM 101,A02,193339,McDonnell; Lisa Marie,0,3,24,24
1683632072859,BIMM 101,B01,193354,McDonnell; Lisa Marie,0,4,24,24
1683632072859,BIMM 101,B02,193357,McDonnell; Lisa Marie,0,2,24,24
1683632073893,BIMM 110,A01,193377,Tat; John,0,11,32,32
1683632073893,BIMM 110,A02,193378,Tat; John,0,10,32,32
1683632074926,BIMM 120,A01,206116,Staff,0,0,32,32
1683632074926,BIMM 120,A02,206117,Staff,6,0,32,26
1683632074926,BIMM 120,A03,206121,Staff,21,0,32,11
1683632075955,BIPN 100,A01,193393,Park; Ji Young,0,14,32,32
1683632075955,BIPN 100,A02,193402,Park; Ji Young,0,14,32,32
1683632075955,BIPN 100,A03,193413,Park; Ji Young,0,14,32,32
1683632075955,BIPN 100,A04,193414,Park; Ji Young,0,13,32,32
1683632076984,BIPN 102,A01,193429,Staff,0,0,32,32
1683632076984,BIPN 102,A02,193438,Staff,18,0,32,14
1683632078013,BIPN 106,A01,193450,Reyes Gonzalez; Catalina,0,2,40,40
1683632079047,BIPN 134,A01,193465,Cooke; James Edward,0,0,32,32
1683632079047,BIPN 134,A02,193474,Cooke; James Edward,25,0,32,7
1683632079047,BIPN 134,A03,193485,Cooke; James Edward,29,0,32,3
1683632079047,BIPN 134,A04,193486,Cooke; James Edward,20,0,32,12
1683632079047,BIPN 134,A05,193491,Cooke; James Edward,31,0,32,1
1683632079047,BIPN 134,A06,193501,Cooke; James Edward,30,0,32,2
1683632079047,BIPN 134,A07,193510,Cooke; James Edward,29,0,32,3
1683632081104,BISP 194,A00,222522,Staff,14,0,32,18
1683632082132,CAT 124,A01,202407,Staff,19,0,25,6
1683632083161,CAT 125,A00,202408,Marchisotto; Jennifer Anne,2,0,20,18
1683632084197,CAT 125R,A00,202409,Smith; Lauryn Alissa,0,11,20,20
1683632084197,CAT 125R,B00,202410,Morales; Celeste Georgianna,0,11,20,20
1683632084197,CAT 125R,C00,202411,Irwin; Matthew Joseph,0,12,20,20
1683632085230,CENG 15,A01,204712,Yang; Kesong,0,1,0,0
1683632086261,CENG 114,A00,202070,Jahed Motlagh; Zeinab,5,0,20,15
1683632087291,CGS 105,A00,185477,Wesling; Megan E.,24,0,40,16
1683632088392,CGS 106,A00,185494,Staff,11,0,22,11
1683632089417,CGS 108,A00,185495,Staff,14,0,20,6
1683632090444,CGS 114,A00,185496,Staff,13,0,18,5
1683632091472,CGS 119,A00,185501,Staff,15,0,20,5
1683632092500,CGS 120,A00,185511,Staff,12,0,20,8
1683632093529,CHEM 4,A01,184675,Bussey; Thomas J,97,0,100,3
1683632094560,CHEM 6A,A01,184677,Staff,33,0,60,27
1683632095590,CHEM 6B,A01,184679,Staff,63,0,100,37
1683632096619,CHEM 6C,A01,184681,Bussey; Thomas J,0,0,50,50
1683632096619,CHEM 6C,A02,184682,Bussey; Thomas J,32,0,50,18
1683632097648,CHEM 40A,A01,184684,Albizati; Kim F.,35,0,100,65
1683632098677,CHEM 40B,A01,184686,Albizati; Kim F.,0,22,100,100
1683632099705,CHEM 41B,A01,184690,Staff,51,0,100,49
1683632100740,COGS 3,A01,184715,Boyle; Mary E. T.,0,27,40,40
1683632101773,COGS 14B,A01,185172,Staff,0,14,38,38
1683632102802,COGS 18,A01,184736,Staff,15,0,80,65
1683632103834,COGS 100,A01,184932,Staff,0,7,73,73
1683632104862,COGS 101A,A01,184935,Staff,0,39,30,30
1683632105895,COGS 101B,A01,184944,Staff,0,2,30,30
1683632106925,COGS 101C,A01,184946,Staff,0,10,30,30
1683632107957,COGS 102A,A01,184951,Johnson; Christine M.,2,0,40,38
1683632108985,COGS 107B,A01,184953,Mooshagian; Eric Frederick,0,51,40,40
1683632110014,COGS 118B,A01,184959,Gupta; Anjum,0,49,40,40
1683632111042,COGS 153,A00,184961,Staff,0,16,30,30
1683632112071,COGS 177,A00,184962,Staff,0,21,30,30
1683632113097,COGS 187A,A01,184969,Boyle; Mary E. T.,0,19,40,40
1683632114130,COMM 10,A01,185174,Staff,0,5,25,25
1683632114130,COMM 10,A02,185189,Staff,0,2,25,25
1683632114130,COMM 10,A03,269821,Staff,0,1,0,0
1683632115157,COMM 100B,A01,185475,Staff,0,1,0,2
1683632115157,COMM 100B,A02,185476,Staff,12,0,25,13
1683632116189,COMM 100C,A01,185314,Staff,1,0,25,24
1683632116189,COMM 100C,A02,185327,Staff,18,0,25,7
1683632117217,COMM 110M,A00,185349,Staff,0,0,40,40
1683632118245,COMM 113T,A00,185352,Staff,25,0,40,15
1683632119274,COMM 114I,A00,185353,Staff,31,0,40,9
1683632120300,COMM 131,A00,185354,Staff,17,0,30,13
1683632121331,CSE 8A,A50,185358,Cao; Yingjun,0,46,10,10
1683632122358,CSE 8B,A01,185362,Staff,0,48,50,50
1683632123384,CSE 11,A01,185416,Cao; Yingjun,0,91,10,10
1683632124414,CSE 20,A01,185445,Briones; Jor-el Thomas Caparas,4,0,25,21
1683632125443,CSE 21,A01,185447,Staff,9,0,50,41
1683632126478,CSE 101,A01,185451,Staff,0,13,50,50
1683632126478,CSE 101,B01,185453,Jones; Miles E,0,13,50,50
1683632128534,CSE 141,A01,185458,Eldon; John,15,0,100,85
1683632129565,CSE 141L,A01,185461,Eldon; John,7,0,100,93
1683632130597,CSE 142,A01,185463,Staff,36,0,60,24
1683632130597,CSE 142,B01,201355,Staff,0,7,60,60
1683632131626,CSE 142L,A01,185470,Staff,36,0,60,24
1683632131626,CSE 142L,B01,201417,Staff,0,6,60,60
1683632132652,CSE 190,A00,201433,Staff,32,0,49,17
1683632133684,DOC 1,A01,259136,Strom; Megan C.,7,0,15,8
1683632133684,DOC 1,A02,259137,Strom; Megan C.,14,0,15,1
1683632133684,DOC 1,A03,259138,Strom; Megan C.,14,0,15,1
1683632133684,DOC 1,A04,259139,Strom; Megan C.,14,0,15,1
1683632134716,DOC 100D,A00,259140,Pass; Natalye Joann,14,0,25,11
1683632135750,DSGN 1,A01,184749,Rill; Bryan,0,26,30,30
1683632136779,DSGN 100,A01,185168,Staff,0,2,25,25
1683632137815,ECE 5,A01,185626,Morris; Karcher William,0,11,0,0
1683632138841,ECE 101,A01,185628,Staff,14,0,70,56
1683632139871,ECE 107,A01,185635,Baghdadchi; Saharnaz,0,0,20,20
1683632139871,ECE 107,A02,185638,Baghdadchi; Saharnaz,3,0,20,17
1683632140914,ECE 148,A01,185647,Silberman; Jack,0,0,16,16
1683632141942,ECON 1,A01,185537,Crane; Meredith Helen,54,0,70,16
1683632142970,ECON 3,A01,185549,Crane; Meredith Helen,29,0,70,41
1683632143998,ECON 4,A01,203354,Anderson; John Charles,0,5,10,10
1683632145025,ECON 100A,A01,185574,Staff,0,5,40,40
1683632146053,ECON 100B,A01,185576,Staff,0,12,50,50
1683632147085,ECON 100C,A01,185589,Newhouse; Herbert S,30,0,70,40
1683632148116,ECON 105,A00,185608,Vespa; Emanuel Ignacio,19,0,35,16
1683632149143,ECON 109,A01,185610,Shishkin; Denis,9,0,35,26
1683632150175,ECON 110A,A01,185612,Staff,9,0,40,31
1683632151208,ECON 120A,A01,185615,Staff,20,0,40,20
1683632152240,ECON 120C,A01,185617,Sun; Yixiao,0,20,70,70
1683632153275,ECON 144,A00,203346,Squires; Dale E,2,0,35,33
1683632154308,ECON 171,A01,203349,Newhouse; Herbert S,0,1,35,35
1683632155336,ECON 173A,A01,185621,Toda; Alexis Akira,21,0,35,14
1683632156372,EDS 25,A01,202413,Staff,0,1,0,0
1683632156372,EDS 25,A02,202414,Staff,0,1,0,0
1683632156372,EDS 25,A03,202415,Staff,0,0,0,0
1683632156372,EDS 25,A04,202416,Staff,0,1,0,0
1683632156372,EDS 25,A05,202439,Staff,0,0,0,0
1683632156372,EDS 25,A06,202440,Staff,0,0,0,0
1683632156372,EDS 25,B01,202631,Staff,0,0,0,0
1683632156372,EDS 25,B02,202632,Staff,0,0,0,0
1683632156372,EDS 25,B03,202639,Staff,0,0,0,0
1683632156372,EDS 25,B04,202640,Staff,0,0,0,0
1683632156372,EDS 25,B05,202643,Staff,0,0,0,0
1683632156372,EDS 25,B06,202644,Staff,0,0,0,0
1683632157404,EDS 38,A01,202659,Black; Alison Michelle,24,0,25,1
1683632158439,EDS 115,A00,202652,Staff,18,0,30,12
1683632159469,EDS 125,A00,202649,Staff,13,0,30,17
1683632160496,EDS 126,A01,203332,Staff,30,0,30,0
1683632161527,EDS 139,A00,202838,Staff,16,0,25,9
1683632162561,EDS 146,A01,202655,Staff,14,0,25,11
1683632163590,ENG 15,A00,185667,Staff,0,1,0,0
1683632163590,ENG 15,B00,185672,Staff,0,0,0,0
1683632163590,ENG 15,C00,185675,Staff,0,0,0,0
1683632163590,ENG 15,D00,185682,Staff,0,0,0,0
1683632163590,ENG 15,E00,185684,Staff,0,0,0,0
1683632164623,ETHN 103,A00,185710,Staff,0,8,35,35
1683632165653,ETHN 103A,A00,199228,Man; Simeon S,0,0,9,9
1683632166682,ETHN 109,A00,185711,Staff,16,0,35,19
1683632167707,ETHN 142,A00,185726,Staff,0,4,30,30
1683632168734,ETHN 163J,A00,199229,Man; Simeon S,5,0,8,3
1683632169761,ETHN 168,A00,185727,Staff,7,0,10,3
1683632170792,ETHN 182,A00,185728,Staff,0,0,35,35
1683632171821,ETHN 183,A00,185737,Staff,9,0,18,9
1683632172854,GLBH 111,A01,209361,Burgos; Jose L.,0,0,0,0
1683632174911,HIEU 104,A00,185792,Staff,14,0,20,6
1683632175940,HIEU 115,A00,185800,Staff,0,0,20,20
1683632176969,HIEU 128,A00,185801,Staff,0,9,20,20
1683632177997,HIEU 147,A00,185802,Staff,15,0,20,5
1683632179028,HIEU 154,A00,185823,Staff,11,0,20,9
1683632180056,HILA 102,A00,185826,Staff,14,0,20,6
1683632181089,HILD 2C,A01,185778,Staff,0,13,20,20
1683632182121,HILD 7B,A01,185780,Kwak; Nancy,0,16,32,32
1683632182121,HILD 7B,A02,185781,Kwak; Nancy,0,18,32,32
1683632183151,HILD 30,A01,185791,Staff,12,0,20,8
1683632184179,HISC 119,A00,185830,Golan; Tal,0,9,20,20
1683632185208,HITO 156GS,A00,185831,Patterson; Patrick H.,0,0,0,23
1683632186236,HIUS 103,A00,185832,Man; Simeon S,0,4,20,20
1683632187263,HIUS 117,A00,185836,Kwak; Nancy,2,0,20,18
1683632188287,HIUS 125,A00,185840,Man; Simeon S,0,1,23,23
1683632189315,HIUS 149,A00,185845,Staff,1,0,20,19
1683632190341,HUM 3,A01,185882,Zavodny; Tatiana Sophia,0,7,50,50
1683632190341,HUM 3,B01,185899,Caldwell; Michael Alan,0,18,50,50
1683632191367,HUM 3GS,A00,185900,Patterson; Patrick H.,0,0,0,23
1683632192463,HUM 4,A01,185938,Zroka; Amy Liane,30,0,50,20
1683632192463,HUM 4,B01,185956,Watkins; Eric,0,4,50,50
1683632192463,HUM 4,B02,202209,Watkins; Eric,0,4,50,50
1683632192463,HUM 4,B03,202210,Watkins; Eric,0,4,50,50
1683632193498,HUM 5,A01,185958,West; Geoffrey Scott,2,0,50,48
1683632193498,HUM 5,A02,202215,West; Geoffrey Scott,0,0,50,50
1683632194530,INTL 190,A00,185959,Gagnon; Jeffrey C,0,0,0,9
1683632194530,INTL 190,B00,185960,Lettieri; Michael Joseph,0,0,0,2
1683632195557,JAPN 180,A00,254509,Staff,5,0,30,25
1683632196587,LATI 10,A01,202853,Kennemore; Amy Michelle,4,0,35,31
1683632196587,LATI 10,A02,202854,Kennemore; Amy Michelle,2,0,35,33
1683632196587,LATI 10,A03,270054,Kennemore; Amy Michelle,30,0,30,0
1683632197615,LATI 180,A00,202855,Kennemore; Amy Michelle,11,0,20,9
1683632198644,LAWS 101,A00,201767,Golan; Tal,0,7,40,40
1683632199673,LIFR 1C,A00,185961,Staff,6,0,20,14
1683632200701,LIFR 1CX,A00,185962,Staff,7,0,20,13
1683632201732,LIFR 1D,A00,185963,Staff,7,0,20,13
1683632202763,LIFR 1DX,A00,185964,Staff,7,0,20,13
1683632203793,LIGN 101,A01,186039,Staff,43,0,50,7
1683632204825,LIGN 165,A00,186040,Staff,15,0,50,35
1683632205855,LTCS 108,A00,186041,Staff,5,0,10,5
1683632206887,LTCS 119,A00,186042,Staff,15,0,20,5
1683632207916,LTCS 130,A00,186043,Wesling; Megan E.,15,0,25,10
1683632209975,LTEA 138,A00,186119,Staff,14,0,40,26
1683632211003,LTEN 124,A00,186148,Staff,6,0,25,19
1683632212033,LTEN 178,A00,186149,Staff,7,0,15,8
1683632213065,LTEN 181,A00,186150,Blanco; John D,34,0,40,6
1683632214095,LTWL 120,A00,186160,Staff,20,0,25,5
1683632215128,LTWL 165,A00,186161,Staff,22,0,25,3
1683632216157,LTWR 100,A00,186162,Staff,0,5,15,15
1683632217188,LTWR 102,A00,186163,Doller; Ben,5,0,15,10
1683632218216,MAE 8,A01,186412,Staff,0,0,0,0
1683632219242,MAE 30B,A00,186445,Bahadori; Mohammad Yousef,82,0,100,18
1683632220268,MAE 40,A00,186592,Bewley; Thomas R,10,0,50,40
1683632221299,MAE 101B,A00,186593,Bahadori; Mohammad Yousef,80,0,100,20
1683632222327,MAE 105,A00,186594,Bandaru; Prabhakar,10,0,50,40
1683632223355,MAE 107,A00,186599,Pham; Hieu Tan,0,7,120,120
1683632224381,MAE 148,A01,186660,Silberman; Jack,3,0,16,13
1683632225410,MATH 10A,A01,188095,Staff,0,5,35,35
1683632226436,MATH 10B,A01,188097,Bowers; Adam R.,0,11,30,30
1683632226436,MATH 10B,A02,188099,Bowers; Adam R.,0,11,30,30
1683632226436,MATH 10B,B01,188104,Bowers; Adam R.,0,10,30,30
1683632226436,MATH 10B,B02,188106,Bowers; Adam R.,1,9,30,29
1683632227466,MATH 10C,A01,188111,Staff,0,18,30,30
1683632227466,MATH 10C,A02,188127,Staff,0,19,30,30
1683632227466,MATH 10C,A03,188131,Staff,0,19,30,30
1683632227466,MATH 10C,B01,188218,Staff,17,0,30,13
1683632227466,MATH 10C,B02,188244,Staff,13,0,30,17
1683632227466,MATH 10C,B03,188277,Staff,14,0,30,16
1683632228501,MATH 18,A01,188344,Bach; Quang Tran,18,0,30,12
1683632228501,MATH 18,A02,188345,Bach; Quang Tran,11,0,30,19
1683632228501,MATH 18,B01,188353,Bach; Quang Tran,11,0,30,19
1683632228501,MATH 18,B02,188354,Bach; Quang Tran,19,0,30,11
1683632229528,MATH 20A,A01,188374,Staff,11,0,35,24
1683632230557,MATH 20B,A01,188382,Ohm; Ko Woon,7,0,30,23
1683632230557,MATH 20B,A02,188383,Ohm; Ko Woon,22,0,30,8
1683632230557,MATH 20B,B01,188385,Ohm; Ko Woon,7,0,30,23
1683632230557,MATH 20B,B02,188392,Ohm; Ko Woon,22,0,30,8
1683632231585,MATH 20C,A01,188394,Harel; Guershon,11,0,30,19
1683632231585,MATH 20C,A02,188395,Harel; Guershon,14,0,30,16
1683632231585,MATH 20C,B01,188404,Harel; Guershon,4,0,30,26
1683632231585,MATH 20C,B02,188405,Harel; Guershon,18,0,30,12
1683632232614,MATH 20D,A01,188414,Hammock; Frances H,0,1,30,30
1683632232614,MATH 20D,A02,188415,Hammock; Frances H,0,1,30,30
1683632232614,MATH 20D,B01,188447,Hammock; Frances H,0,1,30,30
1683632232614,MATH 20D,B02,188486,Hammock; Frances H,4,0,30,26
1683632233646,MATH 20E,A01,188649,Staff,21,0,30,9
1683632233646,MATH 20E,A02,188650,Staff,21,0,30,9
1683632233646,MATH 20E,A03,188673,Staff,0,0,30,30
1683632234678,MATH 102,A01,188675,Staff,0,36,35,35
1683632235712,MATH 103B,A01,188681,Staff,3,0,35,32
1683632235712,MATH 103B,B01,188692,Staff,5,0,35,30
1683632236744,MATH 109,A01,188695,Salehi Golsefidy; Alireza,24,0,35,11
1683632236744,MATH 109,A02,188696,Salehi Golsefidy; Alireza,25,0,35,10
1683632237778,MATH 120A,A01,188698,Eggers; John Dietrich,7,0,35,28
1683632238811,MATH 142B,A01,188736,Ioana; Adrian,0,1,30,30
1683632238811,MATH 142B,A02,188741,Ioana; Adrian,0,1,30,30
1683632238811,MATH 142B,A03,188743,Ioana; Adrian,0,1,30,30
1683632239840,MATH 168A,A01,188790,Staff,0,10,35,35
1683632240869,MATH 170A,A01,188803,Nie; Jiawang,0,2,35,35
1683632240869,MATH 170A,A02,188811,Nie; Jiawang,0,0,35,35
1683632240869,MATH 170A,A03,188814,Nie; Jiawang,0,0,35,35
1683632240869,MATH 170A,A04,188815,Nie; Jiawang,10,0,35,25
1683632241904,MATH 193B,A01,188817,Staff,0,0,35,35
1683632241904,MATH 193B,A02,188818,Staff,5,0,35,30
1683632242939,MGT 4,A01,202857,Anderson; John Charles,61,0,80,19
1683632243971,MGT 12,A00,202858,Lindenberger; Wade Douglas,40,0,90,50
1683632244998,MGT 18,A00,202859,Staff,74,0,90,16
1683632246031,MGT 18GS,A00,202860,McKay; Michael J,13,0,28,15
1683632247056,MGT 45,A00,202861,Pecore; Joseph P.,12,0,90,78
1683632248084,MGT 100,A00,202863,Yavorsky; Daniel Ryan,28,0,90,62
1683632249113,MGT 103,A00,202864,Ehrich; Kristine R,0,17,90,90
1683632250142,MGT 112,A00,202865,Ehrich; Kristine R,15,0,90,75
1683632251171,MGT 121A,A00,202868,Staff,0,20,0,0
1683632252201,MGT 131B,A00,202869,Anderson; John Charles,59,0,90,31
1683632253234,MGT 136,A00,202871,Lindenberger; Wade Douglas,83,0,90,7
1683632254263,MGT 164,A00,202873,Staff,0,66,90,91
1683632255295,MGT 164GS,A00,202874,McKay; Mary A,13,0,28,15
1683632256326,MGT 180,A00,202875,Staff,0,50,90,91
1683632257361,MMW 11R,A01,205019,Herbst; Matthew,2,0,30,28
1683632257361,MMW 11R,A02,205026,Herbst; Matthew,29,0,30,1
1683632258391,MMW 15,A01,193512,Chang; Edmond Yi-Teh,0,8,28,28
1683632258391,MMW 15,A02,193513,Chang; Edmond Yi-Teh,0,5,28,28
1683632258391,MMW 15,A03,193514,Chang; Edmond Yi-Teh,0,5,28,28
1683632258391,MMW 15,A04,193515,Chang; Edmond Yi-Teh,0,5,28,28
1683632258391,MMW 15,A05,193516,Chang; Edmond Yi-Teh,0,5,28,28
1683632258391,MMW 15,A06,193517,Chang; Edmond Yi-Teh,0,6,28,28
1683632258391,MMW 15,B01,193519,Chang; Edmond Yi-Teh,0,5,28,28
1683632258391,MMW 15,B02,193520,Chang; Edmond Yi-Teh,0,5,28,28
1683632258391,MMW 15,B03,193521,Chang; Edmond Yi-Teh,0,5,28,28
1683632258391,MMW 15,B04,193522,Chang; Edmond Yi-Teh,0,5,28,28
1683632258391,MMW 15,B05,193523,Chang; Edmond Yi-Teh,0,5,28,28
1683632258391,MMW 15,B06,193524,Chang; Edmond Yi-Teh,0,5,28,28
1683632259418,MMW 122,A01,193526,Rahimi; Babak,0,16,28,28
1683632259418,MMW 122,A02,193527,Rahimi; Babak,0,15,28,28
1683632259418,MMW 122,A03,193528,Rahimi; Babak,0,0,0,0
1683632259418,MMW 122,A04,193529,Rahimi; Babak,0,0,0,0
1683632260446,MUS 1A,A01,186663,Staff,1,20,35,34
1683632261474,MUS 4,A01,186715,Staff,0,12,35,35
1683632262507,MUS 5R,A01,186796,Dubnov; Shlomo,0,17,35,35
1683632263539,MUS 6,A01,186798,Staff,0,5,25,25
1683632264571,MUS 7,A01,186830,Staff,11,0,35,24
1683632265598,MUS 8,A01,186930,Staff,0,26,35,35
1683632266626,MUS 15,A01,186932,Staff,0,16,35,35
1683632266626,MUS 15,B01,186934,Staff,0,17,35,35
1683632267655,MUS 80,A00,186935,Staff,0,0,20,20
1683632267655,MUS 80,B00,186936,Staff,24,0,25,1
1683632268683,NANO 11,A00,204702,Lipomi; Darren John,0,0,0,0
1683632269718,NANO 15,A01,204709,Yang; Kesong,0,1,0,0
1683632270752,NANO 114,A00,202069,Jahed Motlagh; Zeinab,3,0,10,7
1683632271785,PHIL 1,A00,186955,Grush; Rick Scott,31,0,40,9
1683632272813,PHIL 10,A01,186973,Grush; Rick Scott,27,0,35,8
1683632272813,PHIL 10,A02,186974,Grush; Rick Scott,33,0,35,2
1683632273841,PHIL 13,A01,186976,Staff,3,0,35,32
1683632273841,PHIL 13,A02,186977,Staff,16,0,35,19
1683632274868,PHIL 14,A01,186979,Staff,31,0,35,4
1683632274868,PHIL 14,A02,186986,Staff,32,0,35,3
1683632275896,PHIL 28,A01,186988,Staff,16,0,30,14
1683632275896,PHIL 28,A02,186989,Staff,1,0,30,29
1683632275896,PHIL 28,A03,186990,Staff,10,0,30,20
1683632275896,PHIL 28,A04,186991,Staff,26,0,30,4
1683632276929,PHIL 120,A00,186997,Staff,23,0,40,17
1683632277956,PHIL 137,A00,187003,Staff,7,0,40,33
1683632278986,PHIL 150,A00,187015,Staff,47,0,70,23
1683632280020,PHIL 167,A00,187021,Lamey; Andy M.,34,0,40,6
1683632281054,PHIL 174,A01,202226,Staff,17,0,20,3
1683632281054,PHIL 174,A02,202235,Staff,20,0,20,0
1683632282080,PHIL 191A,A00,258918,Staff,0,0,1,1
1683632283107,PHYS 1A,A00,187028,Staff,27,0,60,33
1683632284132,PHYS 1AL,001,187036,Staff,3,0,30,27
1683632284132,PHYS 1AL,002,187049,Staff,18,0,30,12
1683632285162,PHYS 1B,A00,187058,Staff,22,0,60,38
1683632286190,PHYS 1BL,001,187064,Staff,0,1,30,30
1683632286190,PHYS 1BL,002,187070,Staff,4,0,30,26
1683632287217,PHYS 1C,A00,187082,Staff,29,0,120,91
1683632288246,PHYS 1CL,001,187088,Staff,0,9,30,30
1683632288246,PHYS 1CL,002,187089,Staff,0,1,30,30
1683632288246,PHYS 1CL,009,262693,Staff,9,0,30,21
1683632289273,PHYS 2B,A01,187097,Staff,55,0,115,60
1683632290302,PHYS 2C,A01,187099,Staff,64,0,115,51
1683632291330,PHYS 2CL,A01,187101,Staff,5,0,28,23
1683632291330,PHYS 2CL,A02,187102,Staff,15,0,28,13
1683632292363,PHYS 2D,A01,187123,Shotwell; Brian,95,0,115,20
1683632293395,PHYS 4B,A01,187133,Grinstein; Benjamin,35,0,50,15
1683632294427,POLI 10,A00,188819,Staff,0,4,50,50
1683632295458,POLI 11,A00,188827,Staff,43,0,50,7
1683632296549,POLI 13R,A00,188828,Staff,0,1,20,20
1683632297579,POLI 27,A01,188830,Elgin; Samuel Zincke,0,2,70,70
1683632298606,POLI 30,A00,188832,Desposato; Scott,30,0,50,20
1683632299634,POLI 102F,A00,188834,Staff,0,0,40,40
1683632300664,POLI 104A,A00,188852,Staff,13,0,30,17
1683632301694,POLI 104I,A00,188853,Staff,0,7,20,20
1683632302728,POLI 110B,A00,188854,Wiens; David,7,0,20,13
1683632303755,POLI 112A,A00,188855,Wiens; David,4,0,30,26
1683632304781,POLI 117R,A00,188856,Forman; Fonna,0,12,20,20
1683632305811,POLI 118,A00,188857,Ingham; Sean,8,0,20,12
1683632306837,POLI 120G,A00,188858,Staff,8,0,30,22
1683632307865,POLI 131CR,A00,188863,Hoston; Germaine,21,0,50,29
1683632308896,POLI 133,A00,188864,Nellis; Gareth Hb,44,0,50,6
1683632309922,POLI 134D,A00,188865,Desposato; Scott,27,0,30,3
1683632310954,POLI 142A,A00,188871,Gartzke; Erik,21,0,50,29
1683632311980,POLI 142K,A00,188874,Staff,38,0,50,12
1683632313007,POLI 143,A00,188940,Gartzke; Erik,16,0,30,14
1683632314034,POLI 153,A00,188943,Staff,2,0,20,18
1683632315062,POLI 160AA,A00,188944,Staff,11,0,40,29
1683632316090,POLI 170A,A00,188945,Staff,11,0,30,19
1683632318145,PSYC 1,A00,188952,Staff,36,0,90,54
1683632319172,PSYC 2,B00,188953,Staff,19,0,35,16
1683632320202,PSYC 6,A00,188970,Staff,47,0,60,13
1683632321227,PSYC 7,A00,188973,Staff,35,0,45,10
1683632322261,PSYC 60,A01,188980,Rickard; Timothy C.,42,0,60,18
1683632323288,PSYC 70,A01,189001,Steiner; Eric Tomas,23,0,45,22
1683632324320,PSYC 100,A00,189005,Lacefield; Katharine I,0,99,120,120
1683632325349,PSYC 102,A00,189008,Staff,8,0,30,22
1683632326379,PSYC 106,B00,189026,Gorman; Michael R.,27,0,60,33
1683632327409,PSYC 114,B01,189033,Winkielman; Piotr,0,31,30,30
1683632328437,PSYC 131,A00,189036,Anagnostaras; Stephan,0,43,60,60
1683632329465,PSYC 136,A00,189041,Lowe; Angela Beth,0,7,25,25
1683632330490,PSYC 137,A00,189057,Winkielman; Piotr,0,37,25,25
1683632331516,PSYC 144,A00,189107,Wixted; John T,0,10,50,50
1683632333571,PSYC 162,A00,189142,Staff,0,9,85,85
1683632334601,PSYC 172,A00,189144,Gorman; Michael R.,0,6,30,30
1683632336664,PSYC 179,A00,189146,Lacefield; Katharine I,0,86,120,120
1683632337693,PSYC 181,A00,189147,Anagnostaras; Stephan,0,44,90,90
1683632338727,PSYC 190R,A00,189148,Barner; David A.,0,23,80,80
1683632339755,PSYC 191,A00,189275,Rickard; Timothy C.,0,10,25,25
1683632340786,PSYC 193,A00,189276,Chapman; Eddie Nathaniel,0,1,0,4
1683632341819,PSYC 193L,A01,189281,Lowe; Angela Beth,10,0,20,10
1683632341819,PSYC 193L,B01,189285,Staff,28,0,35,7
1683632342847,RELI 149,A00,187137,Rahimi; Babak,7,0,40,33
1683632343874,SE 9,A01,187315,Staff,0,2,18,18
1683632344907,SE 101B,A00,187409,Staff,24,0,30,6
1683632345937,SE 110B,A00,187444,Staff,10,0,40,30
1683632346968,SE 130B,A00,187449,Staff,31,0,40,9
1683632347998,SE 150A,A00,187516,Staff,9,0,20,11
1683632349026,SE 154,A00,187528,Staff,29,0,50,21
1683632350054,SIO 3,A01,258171,Staff,35,0,40,5
1683632351082,SIO 10,A00,187144,Cook; Geoffrey W,0,6,75,75
1683632352110,SIO 45,A00,187152,Cook; Geoffrey W,0,4,100,100
1683632353135,SIO 109R,A00,194486,Staff,0,4,20,20
1683632355195,SIO 187,A01,187233,Kacev; David,12,0,40,28
1683632356226,SOCI 1,A01,258656,Thorpe; Charles Robert,28,0,30,2
1683632356226,SOCI 1,A02,258658,Thorpe; Charles Robert,30,0,30,0
1683632356226,SOCI 1,A03,258661,Thorpe; Charles Robert,25,0,25,0
1683632356226,SOCI 1,A04,258666,Thorpe; Charles Robert,22,0,25,3
1683632356226,SOCI 1,A05,258897,Thorpe; Charles Robert,22,0,25,3
1683632356226,SOCI 1,A06,258898,Thorpe; Charles Robert,25,0,25,0
1683632357261,SOCI 30,A01,258903,Pardo Guerra; Juan Pablo,14,0,30,16
1683632358288,SOCI 102,A00,258904,Staff,9,0,25,16
1683632359314,SOCI 106,A00,258905,Staff,19,0,25,6
1683632360350,SOCI 111,A00,258907,Ribas Norris; Janet Vanesa,26,0,30,4
1683632361375,SOCI 121R,A00,258908,Pardo Guerra; Juan Pablo,8,0,30,22
1683632362406,SOCI 126,A01,203330,Staff,14,0,20,6
1683632363436,SOCI 131,A00,258909,Thorpe; Charles Robert,30,0,60,30
1683632364463,SOCI 135,A00,258910,Payne; Christine Anna,0,11,30,30
1683632365491,SOCI 157,A00,258911,Staff,12,0,30,18
1683632366518,SOCI 184,A00,258912,Staff,25,0,30,5
1683632367547,SOCI 188D,A00,258913,Staff,22,0,30,8
1683632368580,SYN 2,001,187529,Staff,9,0,16,7
1683632368580,SYN 2,002,201452,Staff,0,20,16,16
1683632368580,SYN 2,003,201469,Staff,2,0,16,14
1683632369610,SYN 100,A01,187531,Staff,0,9,20,20
1683632369610,SYN 100,B01,201491,Staff,0,10,20,20
1683632370642,TDAC 1,A00,189286,Walsh; Kim C.,3,0,20,17
1683632370642,TDAC 1,B00,189287,Harting; Carla Kelso,10,0,20,10
1683632371669,TDAC 101,A00,189300,Walsh; Kim C.,16,0,20,4
1683632371669,TDAC 101,B00,189301,Harting; Carla Kelso,18,0,20,2
1683632372701,TDAC 102,A00,189304,Basso; Beatrice,14,0,20,6
1683632373728,TDAC 108,A00,189305,Staff,18,0,20,2
1683632374761,TDDE 131,A00,189310,Staff,19,0,20,1
1683632374761,TDDE 131,B00,189314,Staff,19,0,20,1
1683632374761,TDDE 131,C00,189315,Staff,48,0,50,2
1683632374761,TDDE 131,D00,189316,Staff,14,0,15,1
1683632374761,TDDE 131,E00,204841,Staff,20,0,20,0
1683632375793,TDGE 10,A00,189289,Staff,28,0,50,22
1683632375793,TDGE 10,B00,189290,Havis; Allan,0,0,50,50
1683632376822,TDGE 11,A00,189291,Fulton; Julia,0,4,50,50
1683632376822,TDGE 11,B00,189292,Staff,20,0,25,5
1683632376822,TDGE 11,C00,260270,Staff,0,0,0,0
1683632379172,TDGE 25,A00,189294,Staff,2,0,20,18
1683632380199,TDGE 124,A00,189318,Fulton; Julia,0,8,50,50
1683632381231,TDGE 125,A00,189319,Staff,13,0,25,12
1683632381231,TDGE 125,B00,189320,Staff,23,0,25,2
1683632382261,TDGE 127,A00,189322,Havis; Allan,0,0,50,50
1683632383295,TDHT 101,A00,189323,Staff,18,0,25,7
1683632383295,TDHT 101,B00,189324,Staff,25,0,25,0
1683632384322,TDHT 102,A00,189325,Staff,49,0,50,1
1683632385350,TDMV 1,A00,189295,Arcidiacono; Kristin,20,0,30,10
1683632385350,TDMV 1,B00,189296,Caligagan; Maria T.,24,0,30,6
1683632386382,TDMV 2,A00,189297,Sammartano; Tonnie,27,0,30,3
1683632386382,TDMV 2,B00,189299,Arcidiacono; Kristin,23,0,30,7
1683632387412,TDMV 3,A00,204998,Rincon; Alicia,22,0,30,8
1683632388443,TDMV 120,A00,189458,Sammartano; Tonnie,28,0,30,2
1683632389477,TDMV 138,A00,189541,Jun; Grace Shin Hae,20,0,40,20
1683632390504,TDMV 142,A00,189717,Caligagan; Tony,25,0,30,5
1683632390504,TDMV 142,B00,189718,Caligagan; Maria T.,25,0,30,5
1683632391535,TMC 2,A01,187533,Staff,25,0,25,0
1683632391535,TMC 2,A02,187534,Staff,25,0,25,0
1683632392562,USP 1,A01,187536,Kwak; Nancy,0,16,25,25
1683632393597,USP 5,A01,187538,Staff,9,0,25,16
1683632394627,USP 101,A00,199253,Staff,0,4,0,0
1683632395660,USP 124,A00,187562,Boomhower; Matthew Charles,0,0,30,30
1683632396692,USP 138,A00,187582,Staff,20,0,25,5
1683632397720,USP 152,A01,187597,Staff,3,0,25,22
1683632398747,USP 153,A00,187598,Staff,19,0,25,6
1683632399776,USP 168,A00,187607,Kwak; Nancy,2,0,5,3
1683632400804,USP 173,A00,187619,Staff,4,0,25,21
1683632401890,USP 181,A00,187638,Staff,0,4,25,25
1683632402923,VIS 103,A00,187650,Cruz; Edwin Teddy,18,0,75,57
1683632403953,VIS 110D,A00,187669,Staff,13,0,22,9
1683632404985,VIS 127C,A00,187720,Shen; Kuiyi,67,0,146,79
1683632406017,VIS 149,A00,187731,Yoldas; Pinar,0,14,22,22
1683632407046,VIS 151,A01,188091,Staff,22,0,34,12
1683632407046,VIS 151,A02,188092,Staff,11,0,34,23
1683632408074,VIS 160B,A00,188093,Stalbaum; Brett,0,1,10,10
1683632410127,WCWP 10B,A00,201720,Staff,10,0,15,5
1683632410127,WCWP 10B,B00,201722,Staff,9,0,15,6
1683632411155,WCWP 100,A00,201725,Gagnon; Jeffrey C,0,0,2,2
1683632411155,WCWP 100,B00,201727,Staff,0,4,15,15
1683632414280,ANBI 133,A00,258401,Wilder; Linnea Lorene,34,0,40,6
1683632415311,ANBI 140,A00,258395,Hrvoj Mihic; Branka,18,0,25,7
1683632416343,ANSC 120,A00,258402,Bialecki; Jon Anthony,27,0,40,13
1683632417373,ANSC 144,A00,258400,Staff,12,0,40,28
1683632419428,ANSC 166,A00,258396,Parish; Steven Martin,156,0,175,19
1683632420454,ANSC 180,A00,193533,Staff,8,0,20,12
1683632421483,ANSC 188,A00,258397,Jassal; Aftab,34,0,40,6
1683632422511,ANTH 3,A01,258316,Staff,23,0,30,7
1683632423541,ANTH 5,A00,258394,Semendeferi; Ekaterini,16,0,20,4
1683632424573,ANTH 21,A01,258331,Staff,4,0,40,36
1683632425606,ANTH 103,A00,258398,Varma; Saiba,15,0,25,10
1683632426644,AWP 10,001,202034,Staff,0,0,0,0
1683632426644,AWP 10,002,202035,Staff,0,0,0,0
1683632426644,AWP 10,003,202036,Staff,0,0,0,0
1683632426644,AWP 10,004,202037,Staff,0,0,0,0
1683632426644,AWP 10,005,202038,Staff,0,0,0,0
1683632426644,AWP 10,006,202039,Staff,0,0,0,0
1683632426644,AWP 10,007,202040,Staff,0,0,0,0
1683632426644,AWP 10,008,202041,Staff,0,0,0,0
1683632426644,AWP 10,009,202042,Staff,0,0,0,0
1683632426644,AWP 10,010,202043,Staff,0,0,0,0
1683632426644,AWP 10,011,202044,Staff,0,0,0,0
1683632426644,AWP 10,012,202045,Staff,0,0,0,0
1683632426644,AWP 10,013,202046,Staff,0,0,0,0
1683632426644,AWP 10,014,202047,Staff,0,0,0,0
1683632426644,AWP 10,015,202048,Staff,0,0,0,0
1683632426644,AWP 10,016,202049,Staff,0,0,0,0
1683632426644,AWP 10,017,202050,Staff,0,0,0,0
1683632426644,AWP 10,018,202051,Staff,0,0,0,0
1683632426644,AWP 10,019,202052,Staff,0,0,0,0
1683632426644,AWP 10,020,202053,Staff,0,0,0,0
1683632426644,AWP 10,021,202054,Staff,0,0,0,0
1683632426644,AWP 10,022,202055,Staff,0,0,0,0
1683632426644,AWP 10,023,202056,Staff,0,0,0,0
1683632426644,AWP 10,024,202057,Staff,0,0,0,0
1683632426644,AWP 10,025,202058,Staff,0,0,0,0
1683632426644,AWP 10,026,202059,Staff,0,0,0,0
1683632427673,AWP 102,001,202032,Staff,0,0,0,0
1683632427673,AWP 102,002,202033,Staff,0,0,0,0
1683632428701,BENG 100,A01,254234,Taylor Amos; Alyssa C,31,0,40,9
1683632429729,BENG 196,001,270013,Engler; Adam J.,9999,0,9999,0
1683632430759,BICD 100R,A01,202018,Smith; Laurie,0,7,32,32
1683632430759,BICD 100R,A02,202019,Smith; Laurie,0,3,32,32
1683632430759,BICD 100R,A03,202020,Smith; Laurie,0,1,32,32
1683632430759,BICD 100R,A04,202021,Smith; Laurie,6,0,32,26
1683632430759,BICD 100R,A05,202022,Smith; Laurie,11,0,32,21
1683632431787,BICD 136,A01,193242,Gustafson-Brown; Cindy,0,2,32,32
1683632431787,BICD 136,A02,193244,Gustafson-Brown; Cindy,13,0,32,19
1683632432819,BIEB 102,A01,193249,Butler; Shannon Rhey,0,2,32,32
1683632432819,BIEB 102,A02,193251,Butler; Shannon Rhey,0,0,32,32
1683632432819,BIEB 102,A03,193253,Butler; Shannon Rhey,0,0,32,32
1683632432819,BIEB 102,A04,193255,Butler; Shannon Rhey,14,0,32,18
1683632432819,BIEB 102,A05,193265,Butler; Shannon Rhey,26,0,32,6
1683632432819,BIEB 102,A06,193269,Butler; Shannon Rhey,14,0,32,18
1683632434874,BIEB 150,A01,193274,Staff,0,0,32,32
1683632434874,BIEB 150,A02,193285,Staff,24,0,32,8
1683632435901,BIEB 194,A00,193286,Kurle; Carolyn M.,20,0,32,12
1683632436929,BILD 1,A01,192291,Staff,15,0,32,17
1683632436929,BILD 1,A02,192292,Staff,30,0,32,2
1683632436929,BILD 1,B01,192520,Reuther; Keefe,0,1,0,0
1683632436929,BILD 1,B02,192532,Reuther; Keefe,0,1,0,0
1683632437958,BILD 3,A01,192556,Butler; Shannon Rhey,0,0,32,32
1683632437958,BILD 3,A02,192581,Butler; Shannon Rhey,1,0,32,31
1683632437958,BILD 3,A03,192611,Butler; Shannon Rhey,21,0,32,11
1683632437958,BILD 3,A04,192612,Butler; Shannon Rhey,24,0,32,8
1683632437958,BILD 3,A05,192613,Butler; Shannon Rhey,26,0,32,6
1683632437958,BILD 3,A06,192679,Butler; Shannon Rhey,27,0,32,5
1683632437958,BILD 3,A07,192682,Butler; Shannon Rhey,20,0,32,12
1683632438984,BILD 4,A01,192836,Reuther; Keefe,0,0,24,24
1683632438984,BILD 4,A02,193044,Reuther; Keefe,4,0,24,20
1683632440014,BILD 10,A01,193142,Gustafson-Brown; Cindy,29,0,32,3
1683632440014,BILD 10,A02,193149,Gustafson-Brown; Cindy,31,0,32,1
1683632441039,BIMM 100,A01,193301,Staff,0,6,32,32
1683632441039,BIMM 100,A02,193312,Staff,0,7,32,32
1683632441039,BIMM 100,A03,193323,Staff,0,9,32,32
1683632442067,BIMM 101,A01,193329,McDonnell; Lisa Marie,0,4,24,24
1683632442067,BIMM 101,A02,193339,McDonnell; Lisa Marie,0,3,24,24
1683632442067,BIMM 101,B01,193354,McDonnell; Lisa Marie,0,4,24,24
1683632442067,BIMM 101,B02,193357,McDonnell; Lisa Marie,0,2,24,24
1683632443095,BIMM 110,A01,193377,Tat; John,0,11,32,32
1683632443095,BIMM 110,A02,193378,Tat; John,0,10,32,32
1683632444130,BIMM 120,A01,206116,Staff,0,0,32,32
1683632444130,BIMM 120,A02,206117,Staff,6,0,32,26
1683632444130,BIMM 120,A03,206121,Staff,21,0,32,11
1683632445163,BIPN 100,A01,193393,Park; Ji Young,0,14,32,32
1683632445163,BIPN 100,A02,193402,Park; Ji Young,0,14,32,32
1683632445163,BIPN 100,A03,193413,Park; Ji Young,0,14,32,32
1683632445163,BIPN 100,A04,193414,Park; Ji Young,0,13,32,32
1683632446191,BIPN 102,A01,193429,Staff,0,0,32,32
1683632446191,BIPN 102,A02,193438,Staff,18,0,32,14
1683632447219,BIPN 106,A01,193450,Reyes Gonzalez; Catalina,0,2,40,40
1683632448254,BIPN 134,A01,193465,Cooke; James Edward,0,0,32,32
1683632448254,BIPN 134,A02,193474,Cooke; James Edward,25,0,32,7
1683632448254,BIPN 134,A03,193485,Cooke; James Edward,29,0,32,3
1683632448254,BIPN 134,A04,193486,Cooke; James Edward,20,0,32,12
1683632448254,BIPN 134,A05,193491,Cooke; James Edward,31,0,32,1
1683632448254,BIPN 134,A06,193501,Cooke; James Edward,30,0,32,2
1683632448254,BIPN 134,A07,193510,Cooke; James Edward,29,0,32,3
1683632450314,BISP 194,A00,222522,Staff,14,0,32,18
1683632451342,CAT 124,A01,202407,Staff,19,0,25,6
1683632452370,CAT 125,A00,202408,Marchisotto; Jennifer Anne,2,0,20,18
1683632453400,CAT 125R,A00,202409,Smith; Lauryn Alissa,0,11,20,20
1683632453400,CAT 125R,B00,202410,Morales; Celeste Georgianna,0,11,20,20
1683632453400,CAT 125R,C00,202411,Irwin; Matthew Joseph,0,12,20,20
1683632454427,CENG 15,A01,204712,Yang; Kesong,0,1,0,0
1683632455452,CENG 114,A00,202070,Jahed Motlagh; Zeinab,5,0,20,15
1683632456486,CGS 105,A00,185477,Wesling; Megan E.,24,0,40,16
1683632457517,CGS 106,A00,185494,Staff,11,0,22,11
1683632458543,CGS 108,A00,185495,Staff,14,0,20,6
1683632459570,CGS 114,A00,185496,Staff,13,0,18,5
1683632460596,CGS 119,A00,185501,Staff,15,0,20,5
1683632461626,CGS 120,A00,185511,Staff,12,0,20,8
1683632462655,CHEM 4,A01,184675,Bussey; Thomas J,97,0,100,3
1683632463682,CHEM 6A,A01,184677,Staff,33,0,60,27
1683632464708,CHEM 6B,A01,184679,Staff,63,0,100,37
1683632465742,CHEM 6C,A01,184681,Bussey; Thomas J,0,0,50,50
1683632465742,CHEM 6C,A02,184682,Bussey; Thomas J,32,0,50,18
1683632466774,CHEM 40A,A01,184684,Albizati; Kim F.,35,0,100,65
1683632467801,CHEM 40B,A01,184686,Albizati; Kim F.,0,22,100,100
1683632468829,CHEM 41B,A01,184690,Staff,51,0,100,49
1683632469862,COGS 3,A01,184715,Boyle; Mary E. T.,0,27,40,40
1683632470889,COGS 14B,A01,185172,Staff,0,14,38,38
1683632471915,COGS 18,A01,184736,Staff,15,0,80,65
1683632472942,COGS 100,A01,184932,Staff,0,7,73,73
1683632473969,COGS 101A,A01,184935,Staff,0,39,30,30
1683632475003,COGS 101B,A01,184944,Staff,0,2,30,30
1683632476063,COGS 101C,A01,184946,Staff,0,10,30,30
1683632477096,COGS 102A,A01,184951,Johnson; Christine M.,2,0,40,38
1683632478125,COGS 107B,A01,184953,Mooshagian; Eric Frederick,0,51,40,40
1683632479155,COGS 118B,A01,184959,Gupta; Anjum,0,49,40,40
1683632480183,COGS 153,A00,184961,Staff,0,16,30,30
1683632481213,COGS 177,A00,184962,Staff,0,21,30,30
1683632482239,COGS 187A,A01,184969,Boyle; Mary E. T.,0,19,40,40
1683632483268,COMM 10,A01,185174,Staff,0,5,25,25
1683632483268,COMM 10,A02,185189,Staff,0,2,25,25
1683632483268,COMM 10,A03,269821,Staff,0,1,0,0
1683632484295,COMM 100B,A01,185475,Staff,0,1,0,2
1683632484295,COMM 100B,A02,185476,Staff,12,0,25,13
1683632485323,COMM 100C,A01,185314,Staff,1,0,25,24
1683632485323,COMM 100C,A02,185327,Staff,18,0,25,7
1683632486355,COMM 110M,A00,185349,Staff,0,0,40,40
1683632487385,COMM 113T,A00,185352,Staff,25,0,40,15
1683632488415,COMM 114I,A00,185353,Staff,31,0,40,9
1683632489442,COMM 131,A00,185354,Staff,17,0,30,13
1683632490473,CSE 8A,A50,185358,Cao; Yingjun,0,46,10,10
1683632491500,CSE 8B,A01,185362,Staff,0,48,50,50
1683632492526,CSE 11,A01,185416,Cao; Yingjun,0,91,10,10
1683632493559,CSE 20,A01,185445,Briones; Jor-el Thomas Caparas,4,0,25,21
1683632494586,CSE 21,A01,185447,Staff,9,0,50,41
1683632495614,CSE 101,A01,185451,Staff,0,13,50,50
1683632495614,CSE 101,B01,185453,Jones; Miles E,0,13,50,50
1683632497668,CSE 141,A01,185458,Eldon; John,15,0,100,85
1683632498699,CSE 141L,A01,185461,Eldon; John,7,0,100,93
1683632499729,CSE 142,A01,185463,Staff,36,0,60,24
1683632499729,CSE 142,B01,201355,Staff,0,7,60,60
1683632500755,CSE 142L,A01,185470,Staff,36,0,60,24
1683632500755,CSE 142L,B01,201417,Staff,0,6,60,60
1683632501787,CSE 190,A00,201433,Staff,32,0,49,17
1683632502820,DOC 1,A01,259136,Strom; Megan C.,7,0,15,8
1683632502820,DOC 1,A02,259137,Strom; Megan C.,14,0,15,1
1683632502820,DOC 1,A03,259138,Strom; Megan C.,14,0,15,1
1683632502820,DOC 1,A04,259139,Strom; Megan C.,14,0,15,1
1683632503850,DOC 100D,A00,259140,Pass; Natalye Joann,14,0,25,11
1683632504877,DSGN 1,A01,184749,Rill; Bryan,0,26,30,30
1683632505974,DSGN 100,A01,185168,Staff,0,2,25,25
1683632507007,ECE 5,A01,185626,Morris; Karcher William,0,11,0,0
1683632508038,ECE 101,A01,185628,Staff,14,0,70,56
1683632509068,ECE 107,A01,185635,Baghdadchi; Saharnaz,0,0,20,20
1683632509068,ECE 107,A02,185638,Baghdadchi; Saharnaz,3,0,20,17
1683632510094,ECE 148,A01,185647,Silberman; Jack,0,0,16,16
1683632511122,ECON 1,A01,185537,Crane; Meredith Helen,54,0,70,16
1683632512151,ECON 3,A01,185549,Crane; Meredith Helen,29,0,70,41
1683632513177,ECON 4,A01,203354,Anderson; John Charles,0,5,10,10
1683632514207,ECON 100A,A01,185574,Staff,0,5,40,40
1683632515236,ECON 100B,A01,185576,Staff,0,12,50,50
1683632516270,ECON 100C,A01,185589,Newhouse; Herbert S,30,0,70,40
1683632517300,ECON 105,A00,185608,Vespa; Emanuel Ignacio,19,0,35,16
1683632518325,ECON 109,A01,185610,Shishkin; Denis,9,0,35,26
1683632519353,ECON 110A,A01,185612,Staff,9,0,40,31
1683632520379,ECON 120A,A01,185615,Staff,20,0,40,20
1683632521406,ECON 120C,A01,185617,Sun; Yixiao,0,20,70,70
1683632522431,ECON 144,A00,203346,Squires; Dale E,2,0,35,33
1683632523462,ECON 171,A01,203349,Newhouse; Herbert S,0,1,35,35
1683632524501,ECON 173A,A01,185621,Toda; Alexis Akira,21,0,35,14
1683632525530,EDS 25,A01,202413,Staff,0,1,0,0
1683632525530,EDS 25,A02,202414,Staff,0,1,0,0
1683632525530,EDS 25,A03,202415,Staff,0,0,0,0
1683632525530,EDS 25,A04,202416,Staff,0,1,0,0
1683632525530,EDS 25,A05,202439,Staff,0,0,0,0
1683632525530,EDS 25,A06,202440,Staff,0,0,0,0
1683632525530,EDS 25,B01,202631,Staff,0,0,0,0
1683632525530,EDS 25,B02,202632,Staff,0,0,0,0
1683632525530,EDS 25,B03,202639,Staff,0,0,0,0
1683632525530,EDS 25,B04,202640,Staff,0,0,0,0
1683632525530,EDS 25,B05,202643,Staff,0,0,0,0
1683632525530,EDS 25,B06,202644,Staff,0,0,0,0
1683632526560,EDS 38,A01,202659,Black; Alison Michelle,24,0,25,1
1683632527590,EDS 115,A00,202652,Staff,18,0,30,12
1683632528626,EDS 125,A00,202649,Staff,13,0,30,17
1683632529652,EDS 126,A01,203332,Staff,30,0,30,0
1683632530679,EDS 139,A00,202838,Staff,16,0,25,9
1683632531706,EDS 146,A01,202655,Staff,14,0,25,11
1683632532733,ENG 15,A00,185667,Staff,0,1,0,0
1683632532733,ENG 15,B00,185672,Staff,0,0,0,0
1683632532733,ENG 15,C00,185675,Staff,0,0,0,0
1683632532733,ENG 15,D00,185682,Staff,0,0,0,0
1683632532733,ENG 15,E00,185684,Staff,0,0,0,0
1683632533760,ETHN 103,A00,185710,Staff,0,8,35,35
1683632534787,ETHN 103A,A00,199228,Man; Simeon S,0,0,9,9
1683632535815,ETHN 109,A00,185711,Staff,16,0,35,19
1683632536841,ETHN 142,A00,185726,Staff,0,4,30,30
1683632537875,ETHN 163J,A00,199229,Man; Simeon S,5,0,8,3
1683632538904,ETHN 168,A00,185727,Staff,7,0,10,3
1683632539934,ETHN 182,A00,185728,Staff,0,0,35,35
1683632540964,ETHN 183,A00,185737,Staff,9,0,18,9
1683632541992,GLBH 111,A01,209361,Burgos; Jose L.,0,0,0,0
1683632544050,HIEU 104,A00,185792,Staff,14,0,20,6
1683632545077,HIEU 115,A00,185800,Staff,0,0,20,20
1683632546103,HIEU 128,A00,185801,Staff,0,9,20,20
1683632547134,HIEU 147,A00,185802,Staff,15,0,20,5
1683632548165,HIEU 154,A00,185823,Staff,11,0,20,9
1683632549192,HILA 102,A00,185826,Staff,14,0,20,6
1683632550223,HILD 2C,A01,185778,Staff,0,13,20,20
1683632551249,HILD 7B,A01,185780,Kwak; Nancy,0,16,32,32
1683632551249,HILD 7B,A02,185781,Kwak; Nancy,0,18,32,32
1683632552281,HILD 30,A01,185791,Staff,12,0,20,8
1683632553309,HISC 119,A00,185830,Golan; Tal,0,9,20,20
1683632554336,HITO 156GS,A00,185831,Patterson; Patrick H.,0,0,0,23
1683632555361,HIUS 103,A00,185832,Man; Simeon S,0,4,20,20
1683632556388,HIUS 117,A00,185836,Kwak; Nancy,2,0,20,18
1683632557414,HIUS 125,A00,185840,Man; Simeon S,0,1,23,23
1683632558446,HIUS 149,A00,185845,Staff,1,0,20,19
1683632559475,HUM 3,A01,185882,Zavodny; Tatiana Sophia,0,7,50,50
1683632559475,HUM 3,B01,185899,Caldwell; Michael Alan,0,18,50,50
1683632560502,HUM 3GS,A00,185900,Patterson; Patrick H.,0,0,0,23
1683632561543,HUM 4,A01,185938,Zroka; Amy Liane,30,0,50,20
1683632561543,HUM 4,B01,185956,Watkins; Eric,0,4,50,50
1683632561543,HUM 4,B02,202209,Watkins; Eric,0,4,50,50
1683632561543,HUM 4,B03,202210,Watkins; Eric,0,4,50,50
1683632562576,HUM 5,A01,185958,West; Geoffrey Scott,2,0,50,48
1683632562576,HUM 5,A02,202215,West; Geoffrey Scott,0,0,50,50
1683632563604,INTL 190,A00,185959,Gagnon; Jeffrey C,0,0,0,9
1683632563604,INTL 190,B00,185960,Lettieri; Michael Joseph,0,0,0,2
1683632564631,JAPN 180,A00,254509,Staff,5,0,30,25
1683632565660,LATI 10,A01,202853,Kennemore; Amy Michelle,4,0,35,31
1683632565660,LATI 10,A02,202854,Kennemore; Amy Michelle,2,0,35,33
1683632565660,LATI 10,A03,270054,Kennemore; Amy Michelle,30,0,30,0
1683632566690,LATI 180,A00,202855,Kennemore; Amy Michelle,11,0,20,9
1683632567718,LAWS 101,A00,201767,Golan; Tal,0,7,40,40
1683632568747,LIFR 1C,A00,185961,Staff,6,0,20,14
1683632569778,LIFR 1CX,A00,185962,Staff,7,0,20,13
1683632570808,LIFR 1D,A00,185963,Staff,7,0,20,13
1683632571840,LIFR 1DX,A00,185964,Staff,7,0,20,13
1683632572866,LIGN 101,A01,186039,Staff,43,0,50,7
1683632573896,LIGN 165,A00,186040,Staff,15,0,50,35
1683632574926,LTCS 108,A00,186041,Staff,5,0,10,5
1683632575953,LTCS 119,A00,186042,Staff,15,0,20,5
1683632576984,LTCS 130,A00,186043,Wesling; Megan E.,15,0,25,10
1683632579041,LTEA 138,A00,186119,Staff,14,0,40,26
1683632580068,LTEN 124,A00,186148,Staff,6,0,25,19
1683632581103,LTEN 178,A00,186149,Staff,7,0,15,8
1683632582136,LTEN 181,A00,186150,Blanco; John D,34,0,40,6
1683632583162,LTWL 120,A00,186160,Staff,20,0,25,5
1683632584190,LTWL 165,A00,186161,Staff,22,0,25,3
1683632585218,LTWR 100,A00,186162,Staff,0,5,15,15
1683632586248,LTWR 102,A00,186163,Doller; Ben,5,0,15,10
1683632587277,MAE 8,A01,186412,Staff,0,0,0,0
1683632588304,MAE 30B,A00,186445,Bahadori; Mohammad Yousef,82,0,100,18
1683632589329,MAE 40,A00,186592,Bewley; Thomas R,10,0,50,40
1683632590358,MAE 101B,A00,186593,Bahadori; Mohammad Yousef,80,0,100,20
1683632591389,MAE 105,A00,186594,Bandaru; Prabhakar,10,0,50,40
1683632592414,MAE 107,A00,186599,Pham; Hieu Tan,0,7,120,120
1683632593440,MAE 148,A01,186660,Silberman; Jack,3,0,16,13
1683632594468,MATH 10A,A01,188095,Staff,0,5,35,35
1683632595498,MATH 10B,A01,188097,Bowers; Adam R.,0,11,30,30
1683632595498,MATH 10B,A02,188099,Bowers; Adam R.,0,11,30,30
1683632595498,MATH 10B,B01,188104,Bowers; Adam R.,0,10,30,30
1683632595498,MATH 10B,B02,188106,Bowers; Adam R.,1,9,30,29
1683632596528,MATH 10C,A01,188111,Staff,0,18,30,30
1683632596528,MATH 10C,A02,188127,Staff,0,19,30,30
1683632596528,MATH 10C,A03,188131,Staff,0,19,30,30
1683632596528,MATH 10C,B01,188218,Staff,17,0,30,13
1683632596528,MATH 10C,B02,188244,Staff,13,0,30,17
1683632596528,MATH 10C,B03,188277,Staff,14,0,30,16
1683632597557,MATH 18,A01,188344,Bach; Quang Tran,18,0,30,12
1683632597557,MATH 18,A02,188345,Bach; Quang Tran,11,0,30,19
1683632597557,MATH 18,B01,188353,Bach; Quang Tran,11,0,30,19
1683632597557,MATH 18,B02,188354,Bach; Quang Tran,19,0,30,11
1683632598586,MATH 20A,A01,188374,Staff,11,0,35,24
1683632599620,MATH 20B,A01,188382,Ohm; Ko Woon,7,0,30,23
1683632599620,MATH 20B,A02,188383,Ohm; Ko Woon,22,0,30,8
1683632599620,MATH 20B,B01,188385,Ohm; Ko Woon,7,0,30,23
1683632599620,MATH 20B,B02,188392,Ohm; Ko Woon,22,0,30,8
1683632600652,MATH 20C,A01,188394,Harel; Guershon,11,0,30,19
1683632600652,MATH 20C,A02,188395,Harel; Guershon,14,0,30,16
1683632600652,MATH 20C,B01,188404,Harel; Guershon,4,0,30,26
1683632600652,MATH 20C,B02,188405,Harel; Guershon,18,0,30,12
1683632601686,MATH 20D,A01,188414,Hammock; Frances H,0,1,30,30
1683632601686,MATH 20D,A02,188415,Hammock; Frances H,0,1,30,30
1683632601686,MATH 20D,B01,188447,Hammock; Frances H,0,1,30,30
1683632601686,MATH 20D,B02,188486,Hammock; Frances H,4,0,30,26
1683632602711,MATH 20E,A01,188649,Staff,21,0,30,9
1683632602711,MATH 20E,A02,188650,Staff,21,0,30,9
1683632602711,MATH 20E,A03,188673,Staff,0,0,30,30
1683632603738,MATH 102,A01,188675,Staff,0,36,35,35
1683632604766,MATH 103B,A01,188681,Staff,3,0,35,32
1683632604766,MATH 103B,B01,188692,Staff,5,0,35,30
1683632605794,MATH 109,A01,188695,Salehi Golsefidy; Alireza,24,0,35,11
1683632605794,MATH 109,A02,188696,Salehi Golsefidy; Alireza,25,0,35,10
1683632606833,MATH 120A,A01,188698,Eggers; John Dietrich,7,0,35,28
1683632607867,MATH 142B,A01,188736,Ioana; Adrian,0,1,30,30
1683632607867,MATH 142B,A02,188741,Ioana; Adrian,0,1,30,30
1683632607867,MATH 142B,A03,188743,Ioana; Adrian,0,1,30,30
1683632608898,MATH 168A,A01,188790,Staff,0,10,35,35
1683632609990,MATH 170A,A01,188803,Nie; Jiawang,0,2,35,35
1683632609990,MATH 170A,A02,188811,Nie; Jiawang,0,0,35,35
1683632609990,MATH 170A,A03,188814,Nie; Jiawang,0,0,35,35
1683632609990,MATH 170A,A04,188815,Nie; Jiawang,10,0,35,25
1683632611017,MATH 193B,A01,188817,Staff,0,0,35,35
1683632611017,MATH 193B,A02,188818,Staff,5,0,35,30
1683632612044,MGT 4,A01,202857,Anderson; John Charles,61,0,80,19
1683632613074,MGT 12,A00,202858,Lindenberger; Wade Douglas,40,0,90,50
1683632614104,MGT 18,A00,202859,Staff,74,0,90,16
1683632615134,MGT 18GS,A00,202860,McKay; Michael J,13,0,28,15
1683632616161,MGT 45,A00,202861,Pecore; Joseph P.,12,0,90,78
1683632617193,MGT 100,A00,202863,Yavorsky; Daniel Ryan,28,0,90,62
1683632618220,MGT 103,A00,202864,Ehrich; Kristine R,0,17,90,90
1683632619247,MGT 112,A00,202865,Ehrich; Kristine R,15,0,90,75
1683632620274,MGT 121A,A00,202868,Staff,0,20,0,0
1683632621300,MGT 131B,A00,202869,Anderson; John Charles,59,0,90,31
1683632622334,MGT 136,A00,202871,Lindenberger; Wade Douglas,83,0,90,7
1683632623363,MGT 164,A00,202873,Staff,0,66,90,91
1683632624394,MGT 164GS,A00,202874,McKay; Mary A,13,0,28,15
1683632625421,MGT 180,A00,202875,Staff,0,50,90,91
1683632626451,MMW 11R,A01,205019,Herbst; Matthew,2,0,30,28
1683632626451,MMW 11R,A02,205026,Herbst; Matthew,29,0,30,1
1683632627485,MMW 15,A01,193512,Chang; Edmond Yi-Teh,0,8,28,28
1683632627485,MMW 15,A02,193513,Chang; Edmond Yi-Teh,0,5,28,28
1683632627485,MMW 15,A03,193514,Chang; Edmond Yi-Teh,0,5,28,28
1683632627485,MMW 15,A04,193515,Chang; Edmond Yi-Teh,0,5,28,28
1683632627485,MMW 15,A05,193516,Chang; Edmond Yi-Teh,0,5,28,28
1683632627485,MMW 15,A06,193517,Chang; Edmond Yi-Teh,0,6,28,28
1683632627485,MMW 15,B01,193519,Chang; Edmond Yi-Teh,0,5,28,28
1683632627485,MMW 15,B02,193520,Chang; Edmond Yi-Teh,0,5,28,28
1683632627485,MMW 15,B03,193521,Chang; Edmond Yi-Teh,0,5,28,28
1683632627485,MMW 15,B04,193522,Chang; Edmond Yi-Teh,0,5,28,28
1683632627485,MMW 15,B05,193523,Chang; Edmond Yi-Teh,0,5,28,28
1683632627485,MMW 15,B06,193524,Chang; Edmond Yi-Teh,0,5,28,28
1683632628516,MMW 122,A01,193526,Rahimi; Babak,0,16,28,28
1683632628516,MMW 122,A02,193527,Rahimi; Babak,0,15,28,28
1683632628516,MMW 122,A03,193528,Rahimi; Babak,0,0,0,0
1683632628516,MMW 122,A04,193529,Rahimi; Babak,0,0,0,0
1683632629550,MUS 1A,A01,186663,Staff,1,20,35,34
1683632630576,MUS 4,A01,186715,Staff,0,12,35,35
1683632631607,MUS 5R,A01,186796,Dubnov; Shlomo,0,17,35,35
1683632632634,MUS 6,A01,186798,Staff,0,5,25,25
1683632633665,MUS 7,A01,186830,Staff,11,0,35,24
1683632634697,MUS 8,A01,186930,Staff,0,26,35,35
1683632635724,MUS 15,A01,186932,Staff,0,16,35,35
1683632635724,MUS 15,B01,186934,Staff,0,17,35,35
1683632636751,MUS 80,A00,186935,Staff,0,0,20,20
1683632636751,MUS 80,B00,186936,Staff,24,0,25,1
1683632637779,NANO 11,A00,204702,Lipomi; Darren John,0,0,0,0
1683632638812,NANO 15,A01,204709,Yang; Kesong,0,1,0,0
1683632639839,NANO 114,A00,202069,Jahed Motlagh; Zeinab,3,0,10,7
1683632640867,PHIL 1,A00,186955,Grush; Rick Scott,31,0,40,9
1683632641894,PHIL 10,A01,186973,Grush; Rick Scott,27,0,35,8
1683632641894,PHIL 10,A02,186974,Grush; Rick Scott,33,0,35,2
1683632642921,PHIL 13,A01,186976,Staff,3,0,35,32
1683632642921,PHIL 13,A02,186977,Staff,16,0,35,19
1683632643951,PHIL 14,A01,186979,Staff,31,0,35,4
1683632643951,PHIL 14,A02,186986,Staff,32,0,35,3
1683632644979,PHIL 28,A01,186988,Staff,16,0,30,14
1683632644979,PHIL 28,A02,186989,Staff,1,0,30,29
1683632644979,PHIL 28,A03,186990,Staff,10,0,30,20
1683632644979,PHIL 28,A04,186991,Staff,26,0,30,4
1683632646006,PHIL 120,A00,186997,Staff,23,0,40,17
1683632647032,PHIL 137,A00,187003,Staff,7,0,40,33
1683632648064,PHIL 150,A00,187015,Staff,47,0,70,23
1683632649091,PHIL 167,A00,187021,Lamey; Andy M.,34,0,40,6
1683632650117,PHIL 174,A01,202226,Staff,17,0,20,3
1683632650117,PHIL 174,A02,202235,Staff,20,0,20,0
1683632651147,PHIL 191A,A00,258918,Staff,0,0,1,1
1683632652177,PHYS 1A,A00,187028,Staff,27,0,60,33
1683632653206,PHYS 1AL,001,187036,Staff,3,0,30,27
1683632653206,PHYS 1AL,002,187049,Staff,18,0,30,12
1683632654234,PHYS 1B,A00,187058,Staff,22,0,60,38
1683632655265,PHYS 1BL,001,187064,Staff,0,1,30,30
1683632655265,PHYS 1BL,002,187070,Staff,4,0,30,26
1683632656292,PHYS 1C,A00,187082,Staff,29,0,120,91
1683632657353,PHYS 1CL,001,187088,Staff,0,9,30,30
1683632657353,PHYS 1CL,002,187089,Staff,0,1,30,30
1683632657353,PHYS 1CL,009,262693,Staff,9,0,30,21
1683632658379,PHYS 2B,A01,187097,Staff,55,0,115,60
1683632659405,PHYS 2C,A01,187099,Staff,64,0,115,51
1683632660432,PHYS 2CL,A01,187101,Staff,5,0,28,23
1683632660432,PHYS 2CL,A02,187102,Staff,15,0,28,13
1683632661459,PHYS 2D,A01,187123,Shotwell; Brian,95,0,115,20
1683632662490,PHYS 4B,A01,187133,Grinstein; Benjamin,35,0,50,15
1683632663520,POLI 10,A00,188819,Staff,0,4,50,50
1683632664549,POLI 11,A00,188827,Staff,43,0,50,7
1683632665578,POLI 13R,A00,188828,Staff,0,1,20,20
1683632666606,POLI 27,A01,188830,Elgin; Samuel Zincke,0,2,70,70
1683632667634,POLI 30,A00,188832,Desposato; Scott,30,0,50,20
1683632668667,POLI 102F,A00,188834,Staff,0,0,40,40
1683632669695,POLI 104A,A00,188852,Staff,13,0,30,17
1683632670722,POLI 104I,A00,188853,Staff,0,7,20,20
1683632671749,POLI 110B,A00,188854,Wiens; David,7,0,20,13
1683632672782,POLI 112A,A00,188855,Wiens; David,4,0,30,26
1683632673815,POLI 117R,A00,188856,Forman; Fonna,0,12,20,20
1683632674843,POLI 118,A00,188857,Ingham; Sean,8,0,20,12
1683632675873,POLI 120G,A00,188858,Staff,8,0,30,22
1683632676899,POLI 131CR,A00,188863,Hoston; Germaine,21,0,50,29
1683632677928,POLI 133,A00,188864,Nellis; Gareth Hb,44,0,50,6
1683632678958,POLI 134D,A00,188865,Desposato; Scott,27,0,30,3
1683632679989,POLI 142A,A00,188871,Gartzke; Erik,21,0,50,29
1683632681019,POLI 142K,A00,188874,Staff,38,0,50,12
1683632682047,POLI 143,A00,188940,Gartzke; Erik,16,0,30,14
1683632683076,POLI 153,A00,188943,Staff,2,0,20,18
1683632684101,POLI 160AA,A00,188944,Staff,11,0,40,29
1683632685133,POLI 170A,A00,188945,Staff,11,0,30,19
1683632687187,PSYC 1,A00,188952,Staff,36,0,90,54
1683632688214,PSYC 2,B00,188953,Staff,19,0,35,16
1683632689242,PSYC 6,A00,188970,Staff,47,0,60,13
1683632690281,PSYC 7,A00,188973,Staff,35,0,45,10
1683632691309,PSYC 60,A01,188980,Rickard; Timothy C.,42,0,60,18
1683632692336,PSYC 70,A01,189001,Steiner; Eric Tomas,23,0,45,22
1683632693366,PSYC 100,A00,189005,Lacefield; Katharine I,0,99,120,120
1683632694396,PSYC 102,A00,189008,Staff,8,0,30,22
1683632695423,PSYC 106,B00,189026,Gorman; Michael R.,27,0,60,33
1683632696454,PSYC 114,B01,189033,Winkielman; Piotr,0,31,30,30
1683632697488,PSYC 131,A00,189036,Anagnostaras; Stephan,0,43,60,60
1683632698521,PSYC 136,A00,189041,Lowe; Angela Beth,0,7,25,25
1683632699551,PSYC 137,A00,189057,Winkielman; Piotr,0,37,25,25
1683632700579,PSYC 144,A00,189107,Wixted; John T,0,10,50,50
1683632702640,PSYC 162,A00,189142,Staff,0,9,85,85
1683632703664,PSYC 172,A00,189144,Gorman; Michael R.,0,6,30,30
1683632705723,PSYC 179,A00,189146,Lacefield; Katharine I,0,86,120,120
1683632706750,PSYC 181,A00,189147,Anagnostaras; Stephan,0,44,90,90
1683632707775,PSYC 190R,A00,189148,Barner; David A.,0,23,80,80
1683632708804,PSYC 191,A00,189275,Rickard; Timothy C.,0,10,25,25
1683632709833,PSYC 193,A00,189276,Chapman; Eddie Nathaniel,0,1,0,4
1683632710860,PSYC 193L,A01,189281,Lowe; Angela Beth,10,0,20,10
1683632710860,PSYC 193L,B01,189285,Staff,28,0,35,7
1683632711887,RELI 149,A00,187137,Rahimi; Babak,7,0,40,33
1683632712913,SE 9,A01,187315,Staff,0,2,18,18
1683632714007,SE 101B,A00,187409,Staff,24,0,30,6
1683632715035,SE 110B,A00,187444,Staff,10,0,40,30
1683632716061,SE 130B,A00,187449,Staff,31,0,40,9
1683632717088,SE 150A,A00,187516,Staff,9,0,20,11
1683632718113,SE 154,A00,187528,Staff,29,0,50,21
1683632719141,SIO 3,A01,258171,Staff,35,0,40,5
1683632720170,SIO 10,A00,187144,Cook; Geoffrey W,0,6,75,75
1683632721198,SIO 45,A00,187152,Cook; Geoffrey W,0,4,100,100
1683632722227,SIO 109R,A00,194486,Staff,0,4,20,20
1683632724283,SIO 187,A01,187233,Kacev; David,12,0,40,28
1683632725313,SOCI 1,A01,258656,Thorpe; Charles Robert,28,0,30,2
1683632725313,SOCI 1,A02,258658,Thorpe; Charles Robert,30,0,30,0
1683632725313,SOCI 1,A03,258661,Thorpe; Charles Robert,25,0,25,0
1683632725313,SOCI 1,A04,258666,Thorpe; Charles Robert,22,0,25,3
1683632725313,SOCI 1,A05,258897,Thorpe; Charles Robert,22,0,25,3
1683632725313,SOCI 1,A06,258898,Thorpe; Charles Robert,25,0,25,0
1683632726340,SOCI 30,A01,258903,Pardo Guerra; Juan Pablo,14,0,30,16
1683632727367,SOCI 102,A00,258904,Staff,9,0,25,16
1683632728395,SOCI 106,A00,258905,Staff,19,0,25,6
1683632729422,SOCI 111,A00,258907,Ribas Norris; Janet Vanesa,26,0,30,4
1683632730449,SOCI 121R,A00,258908,Pardo Guerra; Juan Pablo,8,0,30,22
1683632731479,SOCI 126,A01,203330,Staff,14,0,20,6
1683632732509,SOCI 131,A00,258909,Thorpe; Charles Robert,30,0,60,30
1683632733535,SOCI 135,A00,258910,Payne; Christine Anna,0,11,30,30
1683632734566,SOCI 157,A00,258911,Staff,12,0,30,18
1683632735595,SOCI 184,A00,258912,Staff,25,0,30,5
1683632736625,SOCI 188D,A00,258913,Staff,22,0,30,8
1683632737653,SYN 2,001,187529,Staff,9,0,16,7
1683632737653,SYN 2,002,201452,Staff,0,20,16,16
1683632737653,SYN 2,003,201469,Staff,2,0,16,14
1683632738680,SYN 100,A01,187531,Staff,0,9,20,20
1683632738680,SYN 100,B01,201491,Staff,0,10,20,20
1683632739707,TDAC 1,A00,189286,Walsh; Kim C.,3,0,20,17
1683632739707,TDAC 1,B00,189287,Harting; Carla Kelso,10,0,20,10
1683632740734,TDAC 101,A00,189300,Walsh; Kim C.,16,0,20,4
1683632740734,TDAC 101,B00,189301,Harting; Carla Kelso,18,0,20,2
1683632741766,TDAC 102,A00,189304,Basso; Beatrice,14,0,20,6
1683632742792,TDAC 108,A00,189305,Staff,18,0,20,2
1683632743821,TDDE 131,A00,189310,Staff,19,0,20,1
1683632743821,TDDE 131,B00,189314,Staff,19,0,20,1
1683632743821,TDDE 131,C00,189315,Staff,48,0,50,2
1683632743821,TDDE 131,D00,189316,Staff,14,0,15,1
1683632743821,TDDE 131,E00,204841,Staff,20,0,20,0
1683632744848,TDGE 10,A00,189289,Staff,28,0,50,22
1683632744848,TDGE 10,B00,189290,Havis; Allan,0,0,50,50
1683632745878,TDGE 11,A00,189291,Fulton; Julia,0,4,50,50
1683632745878,TDGE 11,B00,189292,Staff,20,0,25,5
1683632745878,TDGE 11,C00,260270,Staff,0,0,0,0
1683632746905,TDGE 25,A00,189294,Staff,2,0,20,18
1683632747931,TDGE 124,A00,189318,Fulton; Julia,0,8,50,50
1683632748958,TDGE 125,A00,189319,Staff,13,0,25,12
1683632748958,TDGE 125,B00,189320,Staff,23,0,25,2
1683632749985,TDGE 127,A00,189322,Havis; Allan,0,0,50,50
1683632751010,TDHT 101,A00,189323,Staff,18,0,25,7
1683632751010,TDHT 101,B00,189324,Staff,25,0,25,0
1683632752036,TDHT 102,A00,189325,Staff,49,0,50,1
1683632753064,TDMV 1,A00,189295,Arcidiacono; Kristin,20,0,30,10
1683632753064,TDMV 1,B00,189296,Caligagan; Maria T.,24,0,30,6
1683632754091,TDMV 2,A00,189297,Sammartano; Tonnie,27,0,30,3
1683632754091,TDMV 2,B00,189299,Arcidiacono; Kristin,23,0,30,7
1683632755118,TDMV 3,A00,204998,Rincon; Alicia,22,0,30,8
1683632756148,TDMV 120,A00,189458,Sammartano; Tonnie,28,0,30,2
1683632757175,TDMV 138,A00,189541,Jun; Grace Shin Hae,20,0,40,20
1683632758199,TDMV 142,A00,189717,Caligagan; Tony,25,0,30,5
1683632758199,TDMV 142,B00,189718,Caligagan; Maria T.,25,0,30,5
1683632759227,TMC 2,A01,187533,Staff,25,0,25,0
1683632759227,TMC 2,A02,187534,Staff,25,0,25,0
1683632760253,USP 1,A01,187536,Kwak; Nancy,0,16,25,25
1683632761285,USP 5,A01,187538,Staff,9,0,25,16
1683632762315,USP 101,A00,199253,Staff,0,4,0,0
1683632763345,USP 124,A00,187562,Boomhower; Matthew Charles,0,0,30,30
1683632764377,USP 138,A00,187582,Staff,20,0,25,5
1683632765425,USP 152,A01,187597,Staff,3,0,25,22
1683632766454,USP 153,A00,187598,Staff,19,0,25,6
1683632767485,USP 168,A00,187607,Kwak; Nancy,2,0,5,3
1683632768516,USP 173,A00,187619,Staff,4,0,25,21
1683632769546,USP 181,A00,187638,Staff,0,4,25,25
1683632770578,VIS 103,A00,187650,Cruz; Edwin Teddy,18,0,75,57
1683632771607,VIS 110D,A00,187669,Staff,13,0,22,9
1683632772635,VIS 127C,A00,187720,Shen; Kuiyi,67,0,146,79
1683632773662,VIS 149,A00,187731,Yoldas; Pinar,0,14,22,22
1683632774687,VIS 151,A01,188091,Staff,22,0,34,12
1683632774687,VIS 151,A02,188092,Staff,11,0,34,23
1683632775715,VIS 160B,A00,188093,Stalbaum; Brett,0,1,10,10
1683632777767,WCWP 10B,A00,201720,Staff,10,0,15,5
1683632777767,WCWP 10B,B00,201722,Staff,9,0,15,6
1683632778794,WCWP 100,A00,201725,Gagnon; Jeffrey C,0,0,2,2
1683632778794,WCWP 100,B00,201727,Staff,0,4,15,15
1683632781949,ANBI 133,A00,258401,Wilder; Linnea Lorene,34,0,40,6
1683632782979,ANBI 140,A00,258395,Hrvoj Mihic; Branka,18,0,25,7
1683632784018,ANSC 120,A00,258402,Bialecki; Jon Anthony,27,0,40,13
1683632785045,ANSC 144,A00,258400,Staff,12,0,40,28
1683632787104,ANSC 166,A00,258396,Parish; Steven Martin,156,0,175,19
1683632788133,ANSC 180,A00,193533,Staff,8,0,20,12
1683632789165,ANSC 188,A00,258397,Jassal; Aftab,34,0,40,6
1683632790192,ANTH 3,A01,258316,Staff,23,0,30,7
1683632791219,ANTH 5,A00,258394,Semendeferi; Ekaterini,16,0,20,4
1683632792245,ANTH 21,A01,258331,Staff,4,0,40,36
1683632793275,ANTH 103,A00,258398,Varma; Saiba,15,0,25,10
1683632794305,AWP 10,001,202034,Staff,0,0,0,0
1683632794305,AWP 10,002,202035,Staff,0,0,0,0
1683632794305,AWP 10,003,202036,Staff,0,0,0,0
1683632794305,AWP 10,004,202037,Staff,0,0,0,0
1683632794305,AWP 10,005,202038,Staff,0,0,0,0
1683632794305,AWP 10,006,202039,Staff,0,0,0,0
1683632794305,AWP 10,007,202040,Staff,0,0,0,0
1683632794305,AWP 10,008,202041,Staff,0,0,0,0
1683632794305,AWP 10,009,202042,Staff,0,0,0,0
1683632794305,AWP 10,010,202043,Staff,0,0,0,0
1683632794305,AWP 10,011,202044,Staff,0,0,0,0
1683632794305,AWP 10,012,202045,Staff,0,0,0,0
1683632794305,AWP 10,013,202046,Staff,0,0,0,0
1683632794305,AWP 10,014,202047,Staff,0,0,0,0
1683632794305,AWP 10,015,202048,Staff,0,0,0,0
1683632794305,AWP 10,016,202049,Staff,0,0,0,0
1683632794305,AWP 10,017,202050,Staff,0,0,0,0
1683632794305,AWP 10,018,202051,Staff,0,0,0,0
1683632794305,AWP 10,019,202052,Staff,0,0,0,0
1683632794305,AWP 10,020,202053,Staff,0,0,0,0
1683632794305,AWP 10,021,202054,Staff,0,0,0,0
1683632794305,AWP 10,022,202055,Staff,0,0,0,0
1683632794305,AWP 10,023,202056,Staff,0,0,0,0
1683632794305,AWP 10,024,202057,Staff,0,0,0,0
1683632794305,AWP 10,025,202058,Staff,0,0,0,0
1683632794305,AWP 10,026,202059,Staff,0,0,0,0
1683632795333,AWP 102,001,202032,Staff,0,0,0,0
1683632795333,AWP 102,002,202033,Staff,0,0,0,0
1683632796361,BENG 100,A01,254234,Taylor Amos; Alyssa C,31,0,40,9
1683632797390,BENG 196,001,270013,Engler; Adam J.,9999,0,9999,0
1683632798425,BICD 100R,A01,202018,Smith; Laurie,0,7,32,32
1683632798425,BICD 100R,A02,202019,Smith; Laurie,0,3,32,32
1683632798425,BICD 100R,A03,202020,Smith; Laurie,0,1,32,32
1683632798425,BICD 100R,A04,202021,Smith; Laurie,6,0,32,26
1683632798425,BICD 100R,A05,202022,Smith; Laurie,11,0,32,21
1683632799453,BICD 136,A01,193242,Gustafson-Brown; Cindy,0,2,32,32
1683632799453,BICD 136,A02,193244,Gustafson-Brown; Cindy,13,0,32,19
1683632800483,BIEB 102,A01,193249,Butler; Shannon Rhey,0,2,32,32
1683632800483,BIEB 102,A02,193251,Butler; Shannon Rhey,0,0,32,32
1683632800483,BIEB 102,A03,193253,Butler; Shannon Rhey,0,0,32,32
1683632800483,BIEB 102,A04,193255,Butler; Shannon Rhey,14,0,32,18
1683632800483,BIEB 102,A05,193265,Butler; Shannon Rhey,26,0,32,6
1683632800483,BIEB 102,A06,193269,Butler; Shannon Rhey,14,0,32,18
1683632802539,BIEB 150,A01,193274,Staff,0,0,32,32
1683632802539,BIEB 150,A02,193285,Staff,24,0,32,8
1683632803568,BIEB 194,A00,193286,Kurle; Carolyn M.,20,0,32,12
1683632804597,BILD 1,A01,192291,Staff,15,0,32,17
1683632804597,BILD 1,A02,192292,Staff,30,0,32,2
1683632804597,BILD 1,B01,192520,Reuther; Keefe,0,1,0,0
1683632804597,BILD 1,B02,192532,Reuther; Keefe,0,1,0,0
1683632805625,BILD 3,A01,192556,Butler; Shannon Rhey,0,0,32,32
1683632805625,BILD 3,A02,192581,Butler; Shannon Rhey,1,0,32,31
1683632805625,BILD 3,A03,192611,Butler; Shannon Rhey,21,0,32,11
1683632805625,BILD 3,A04,192612,Butler; Shannon Rhey,24,0,32,8
1683632805625,BILD 3,A05,192613,Butler; Shannon Rhey,26,0,32,6
1683632805625,BILD 3,A06,192679,Butler; Shannon Rhey,27,0,32,5
1683632805625,BILD 3,A07,192682,Butler; Shannon Rhey,20,0,32,12
1683632806652,BILD 4,A01,192836,Reuther; Keefe,0,0,24,24
1683632806652,BILD 4,A02,193044,Reuther; Keefe,4,0,24,20
1683632807686,BILD 10,A01,193142,Gustafson-Brown; Cindy,29,0,32,3
1683632807686,BILD 10,A02,193149,Gustafson-Brown; Cindy,31,0,32,1
1683632808714,BIMM 100,A01,193301,Staff,0,6,32,32
1683632808714,BIMM 100,A02,193312,Staff,0,7,32,32
1683632808714,BIMM 100,A03,193323,Staff,0,9,32,32
1683632809746,BIMM 101,A01,193329,McDonnell; Lisa Marie,0,4,24,24
1683632809746,BIMM 101,A02,193339,McDonnell; Lisa Marie,0,3,24,24
1683632809746,BIMM 101,B01,193354,McDonnell; Lisa Marie,0,4,24,24
1683632809746,BIMM 101,B02,193357,McDonnell; Lisa Marie,0,2,24,24
1683632810776,BIMM 110,A01,193377,Tat; John,0,11,32,32
1683632810776,BIMM 110,A02,193378,Tat; John,0,10,32,32
1683632811803,BIMM 120,A01,206116,Staff,0,0,32,32
1683632811803,BIMM 120,A02,206117,Staff,6,0,32,26
1683632811803,BIMM 120,A03,206121,Staff,21,0,32,11
1683632812836,BIPN 100,A01,193393,Park; Ji Young,0,14,32,32
1683632812836,BIPN 100,A02,193402,Park; Ji Young,0,14,32,32
1683632812836,BIPN 100,A03,193413,Park; Ji Young,0,14,32,32
1683632812836,BIPN 100,A04,193414,Park; Ji Young,0,13,32,32
1683632813867,BIPN 102,A01,193429,Staff,0,0,32,32
1683632813867,BIPN 102,A02,193438,Staff,18,0,32,14
1683632814895,BIPN 106,A01,193450,Reyes Gonzalez; Catalina,0,2,40,40
1683632815926,BIPN 134,A01,193465,Cooke; James Edward,0,0,32,32
1683632815926,BIPN 134,A02,193474,Cooke; James Edward,25,0,32,7
1683632815926,BIPN 134,A03,193485,Cooke; James Edward,29,0,32,3
1683632815926,BIPN 134,A04,193486,Cooke; James Edward,20,0,32,12
1683632815926,BIPN 134,A05,193491,Cooke; James Edward,31,0,32,1
1683632815926,BIPN 134,A06,193501,Cooke; James Edward,30,0,32,2
1683632815926,BIPN 134,A07,193510,Cooke; James Edward,29,0,32,3
1683632818051,BISP 194,A00,222522,Staff,14,0,32,18
1683632819083,CAT 124,A01,202407,Staff,19,0,25,6
1683632820113,CAT 125,A00,202408,Marchisotto; Jennifer Anne,2,0,20,18
1683632821139,CAT 125R,A00,202409,Smith; Lauryn Alissa,0,11,20,20
1683632821139,CAT 125R,B00,202410,Morales; Celeste Georgianna,0,11,20,20
1683632821139,CAT 125R,C00,202411,Irwin; Matthew Joseph,0,12,20,20
1683632822168,CENG 15,A01,204712,Yang; Kesong,0,1,0,0
1683632823194,CENG 114,A00,202070,Jahed Motlagh; Zeinab,5,0,20,15
1683632824226,CGS 105,A00,185477,Wesling; Megan E.,24,0,40,16
1683632825257,CGS 106,A00,185494,Staff,11,0,22,11
1683632826288,CGS 108,A00,185495,Staff,14,0,20,6
1683632827314,CGS 114,A00,185496,Staff,13,0,18,5
1683632828340,CGS 119,A00,185501,Staff,15,0,20,5
1683632829370,CGS 120,A00,185511,Staff,12,0,20,8
1683632830404,CHEM 4,A01,184675,Bussey; Thomas J,97,0,100,3
1683632831434,CHEM 6A,A01,184677,Staff,33,0,60,27
1683632832461,CHEM 6B,A01,184679,Staff,63,0,100,37
1683632833487,CHEM 6C,A01,184681,Bussey; Thomas J,0,0,50,50
1683632833487,CHEM 6C,A02,184682,Bussey; Thomas J,32,0,50,18
1683632834520,CHEM 40A,A01,184684,Albizati; Kim F.,35,0,100,65
1683632835550,CHEM 40B,A01,184686,Albizati; Kim F.,0,22,100,100
1683632836579,CHEM 41B,A01,184690,Staff,51,0,100,49
1683632837606,COGS 3,A01,184715,Boyle; Mary E. T.,0,27,40,40
1683632838634,COGS 14B,A01,185172,Staff,0,14,38,38
1683632839660,COGS 18,A01,184736,Staff,15,0,80,65
1683632840688,COGS 100,A01,184932,Staff,0,7,73,73
1683632841723,COGS 101A,A01,184935,Staff,0,39,30,30
1683632842754,COGS 101B,A01,184944,Staff,0,2,30,30
1683632843781,COGS 101C,A01,184946,Staff,0,10,30,30
1683632844810,COGS 102A,A01,184951,Johnson; Christine M.,2,0,40,38
1683632845840,COGS 107B,A01,184953,Mooshagian; Eric Frederick,0,51,40,40
1683632846872,COGS 118B,A01,184959,Gupta; Anjum,0,49,40,40
1683632847902,COGS 153,A00,184961,Staff,0,16,30,30
1683632848928,COGS 177,A00,184962,Staff,0,21,30,30
1683632849958,COGS 187A,A01,184969,Boyle; Mary E. T.,0,19,40,40
1683632850989,COMM 10,A01,185174,Staff,0,5,25,25
1683632850989,COMM 10,A02,185189,Staff,0,2,25,25
1683632850989,COMM 10,A03,269821,Staff,0,1,0,0
1683632852020,COMM 100B,A01,185475,Staff,0,1,0,2
1683632852020,COMM 100B,A02,185476,Staff,12,0,25,13
1683632853047,COMM 100C,A01,185314,Staff,1,0,25,24
1683632853047,COMM 100C,A02,185327,Staff,18,0,25,7
1683632854076,COMM 110M,A00,185349,Staff,0,0,40,40
1683632855104,COMM 113T,A00,185352,Staff,25,0,40,15
1683632856130,COMM 114I,A00,185353,Staff,31,0,40,9
1683632857157,COMM 131,A00,185354,Staff,17,0,30,13
1683632858185,CSE 8A,A50,185358,Cao; Yingjun,0,46,10,10
1683632859213,CSE 8B,A01,185362,Staff,0,48,50,50
1683632860252,CSE 11,A01,185416,Cao; Yingjun,0,91,10,10
1683632861280,CSE 20,A01,185445,Briones; Jor-el Thomas Caparas,4,0,25,21
1683632862311,CSE 21,A01,185447,Staff,9,0,50,41
1683632863342,CSE 101,A01,185451,Staff,0,13,50,50
1683632863342,CSE 101,B01,185453,Jones; Miles E,0,13,50,50
1683632865401,CSE 141,A01,185458,Eldon; John,15,0,100,85
1683632866432,CSE 141L,A01,185461,Eldon; John,7,0,100,93
1683632867460,CSE 142,A01,185463,Staff,36,0,60,24
1683632867460,CSE 142,B01,201355,Staff,0,7,60,60
1683632868487,CSE 142L,A01,185470,Staff,36,0,60,24
1683632868487,CSE 142L,B01,201417,Staff,0,6,60,60
1683632869514,CSE 190,A00,201433,Staff,32,0,49,17
1683632870545,DOC 1,A01,259136,Strom; Megan C.,7,0,15,8
1683632870545,DOC 1,A02,259137,Strom; Megan C.,14,0,15,1
1683632870545,DOC 1,A03,259138,Strom; Megan C.,14,0,15,1
1683632870545,DOC 1,A04,259139,Strom; Megan C.,14,0,15,1
1683632871574,DOC 100D,A00,259140,Pass; Natalye Joann,14,0,25,11
1683632872606,DSGN 1,A01,184749,Rill; Bryan,0,26,30,30
1683632873632,DSGN 100,A01,185168,Staff,0,2,25,25
1683632874659,ECE 5,A01,185626,Morris; Karcher William,0,11,0,0
1683632875688,ECE 101,A01,185628,Staff,14,0,70,56
1683632876715,ECE 107,A01,185635,Baghdadchi; Saharnaz,0,0,20,20
1683632876715,ECE 107,A02,185638,Baghdadchi; Saharnaz,3,0,20,17
1683632877743,ECE 148,A01,185647,Silberman; Jack,0,0,16,16
1683632878773,ECON 1,A01,185537,Crane; Meredith Helen,54,0,70,16
1683632879800,ECON 3,A01,185549,Crane; Meredith Helen,29,0,70,41
1683632880826,ECON 4,A01,203354,Anderson; John Charles,0,5,10,10
1683632881856,ECON 100A,A01,185574,Staff,0,5,40,40
1683632882886,ECON 100B,A01,185576,Staff,0,12,50,50
1683632883910,ECON 100C,A01,185589,Newhouse; Herbert S,30,0,70,40
1683632884940,ECON 105,A00,185608,Vespa; Emanuel Ignacio,19,0,35,16
1683632885968,ECON 109,A01,185610,Shishkin; Denis,9,0,35,26
1683632886997,ECON 110A,A01,185612,Staff,9,0,40,31
1683632888027,ECON 120A,A01,185615,Staff,20,0,40,20
1683632889059,ECON 120C,A01,185617,Sun; Yixiao,0,20,70,70
1683632890094,ECON 144,A00,203346,Squires; Dale E,2,0,35,33
1683632891126,ECON 171,A01,203349,Newhouse; Herbert S,0,1,35,35
1683632892157,ECON 173A,A01,185621,Toda; Alexis Akira,21,0,35,14
1683632893198,EDS 25,A01,202413,Staff,0,1,0,0
1683632893198,EDS 25,A02,202414,Staff,0,1,0,0
1683632893198,EDS 25,A03,202415,Staff,0,0,0,0
1683632893198,EDS 25,A04,202416,Staff,0,1,0,0
1683632893198,EDS 25,A05,202439,Staff,0,0,0,0
1683632893198,EDS 25,A06,202440,Staff,0,0,0,0
1683632893198,EDS 25,B01,202631,Staff,0,0,0,0
1683632893198,EDS 25,B02,202632,Staff,0,0,0,0
1683632893198,EDS 25,B03,202639,Staff,0,0,0,0
1683632893198,EDS 25,B04,202640,Staff,0,0,0,0
1683632893198,EDS 25,B05,202643,Staff,0,0,0,0
1683632893198,EDS 25,B06,202644,Staff,0,0,0,0
1683632894234,EDS 38,A01,202659,Black; Alison Michelle,24,0,25,1
1683632895264,EDS 115,A00,202652,Staff,18,0,30,12
1683632896293,EDS 125,A00,202649,Staff,13,0,30,17
1683632897320,EDS 126,A01,203332,Staff,30,0,30,0
1683632898348,EDS 139,A00,202838,Staff,16,0,25,9
1683632899373,EDS 146,A01,202655,Staff,14,0,25,11
1683632900403,ENG 15,A00,185667,Staff,0,1,0,0
1683632900403,ENG 15,B00,185672,Staff,0,0,0,0
1683632900403,ENG 15,C00,185675,Staff,0,0,0,0
1683632900403,ENG 15,D00,185682,Staff,0,0,0,0
1683632900403,ENG 15,E00,185684,Staff,0,0,0,0
1683632901433,ETHN 103,A00,185710,Staff,0,8,35,35
1683632902463,ETHN 103A,A00,199228,Man; Simeon S,0,0,9,9
1683632903491,ETHN 109,A00,185711,Staff,16,0,35,19
1683632904518,ETHN 142,A00,185726,Staff,0,4,30,30
1683632905545,ETHN 163J,A00,199229,Man; Simeon S,5,0,8,3
1683632906572,ETHN 168,A00,185727,Staff,7,0,10,3
1683632907597,ETHN 182,A00,185728,Staff,0,0,35,35
1683632908625,ETHN 183,A00,185737,Staff,9,0,18,9
1683632909658,GLBH 111,A01,209361,Burgos; Jose L.,0,0,0,0
1683632911715,HIEU 104,A00,185792,Staff,14,0,20,6
1683632912740,HIEU 115,A00,185800,Staff,0,0,20,20
1683632913765,HIEU 128,A00,185801,Staff,0,9,20,20
1683632914791,HIEU 147,A00,185802,Staff,15,0,20,5
1683632915821,HIEU 154,A00,185823,Staff,11,0,20,9
1683632916849,HILA 102,A00,185826,Staff,14,0,20,6
1683632917880,HILD 2C,A01,185778,Staff,0,13,20,20
1683632918906,HILD 7B,A01,185780,Kwak; Nancy,0,16,32,32
1683632918906,HILD 7B,A02,185781,Kwak; Nancy,0,18,32,32
1683632919936,HILD 30,A01,185791,Staff,12,0,20,8
1683632920967,HISC 119,A00,185830,Golan; Tal,0,9,20,20
1683632922058,HITO 156GS,A00,185831,Patterson; Patrick H.,0,0,0,23
1683632923087,HIUS 103,A00,185832,Man; Simeon S,0,4,20,20
1683632924116,HIUS 117,A00,185836,Kwak; Nancy,2,0,20,18
1683632925145,HIUS 125,A00,185840,Man; Simeon S,0,1,23,23
1683632926173,HIUS 149,A00,185845,Staff,1,0,20,19
1683632927206,HUM 3,A01,185882,Zavodny; Tatiana Sophia,0,7,50,50
1683632927206,HUM 3,B01,185899,Caldwell; Michael Alan,0,18,50,50
1683632928232,HUM 3GS,A00,185900,Patterson; Patrick H.,0,0,0,23
1683632929259,HUM 4,A01,185938,Zroka; Amy Liane,30,0,50,20
1683632929259,HUM 4,B01,185956,Watkins; Eric,0,4,50,50
1683632929259,HUM 4,B02,202209,Watkins; Eric,0,4,50,50
1683632929259,HUM 4,B03,202210,Watkins; Eric,0,4,50,50
1683632930286,HUM 5,A01,185958,West; Geoffrey Scott,2,0,50,48
1683632930286,HUM 5,A02,202215,West; Geoffrey Scott,0,0,50,50
1683632931317,INTL 190,A00,185959,Gagnon; Jeffrey C,0,0,0,9
1683632931317,INTL 190,B00,185960,Lettieri; Michael Joseph,0,0,0,2
1683632932347,JAPN 180,A00,254509,Staff,5,0,30,25
1683632933380,LATI 10,A01,202853,Kennemore; Amy Michelle,4,0,35,31
1683632933380,LATI 10,A02,202854,Kennemore; Amy Michelle,2,0,35,33
1683632933380,LATI 10,A03,270054,Kennemore; Amy Michelle,30,0,30,0
1683632934410,LATI 180,A00,202855,Kennemore; Amy Michelle,11,0,20,9
1683632935437,LAWS 101,A00,201767,Golan; Tal,0,7,40,40
1683632936464,LIFR 1C,A00,185961,Staff,6,0,20,14
1683632937491,LIFR 1CX,A00,185962,Staff,7,0,20,13
1683632938518,LIFR 1D,A00,185963,Staff,7,0,20,13
1683632939545,LIFR 1DX,A00,185964,Staff,7,0,20,13
1683632940574,LIGN 101,A01,186039,Staff,43,0,50,7
1683632941604,LIGN 165,A00,186040,Staff,15,0,50,35
1683632942630,LTCS 108,A00,186041,Staff,5,0,10,5
1683632943657,LTCS 119,A00,186042,Staff,15,0,20,5
1683632944687,LTCS 130,A00,186043,Wesling; Megan E.,15,0,25,10
1683632946754,LTEA 138,A00,186119,Staff,14,0,40,26
1683632947782,LTEN 124,A00,186148,Staff,6,0,25,19
1683632948807,LTEN 178,A00,186149,Staff,7,0,15,8
1683632949838,LTEN 181,A00,186150,Blanco; John D,34,0,40,6
1683632950867,LTWL 120,A00,186160,Staff,20,0,25,5
1683632951895,LTWL 165,A00,186161,Staff,22,0,25,3
1683632952922,LTWR 100,A00,186162,Staff,0,5,15,15
1683632953950,LTWR 102,A00,186163,Doller; Ben,5,0,15,10
1683632954982,MAE 8,A01,186412,Staff,0,0,0,0
1683632956011,MAE 30B,A00,186445,Bahadori; Mohammad Yousef,82,0,100,18
1683632957037,MAE 40,A00,186592,Bewley; Thomas R,10,0,50,40
1683632958062,MAE 101B,A00,186593,Bahadori; Mohammad Yousef,80,0,100,20
1683632959090,MAE 105,A00,186594,Bandaru; Prabhakar,10,0,50,40
1683632960116,MAE 107,A00,186599,Pham; Hieu Tan,0,7,120,120
1683632961146,MAE 148,A01,186660,Silberman; Jack,3,0,16,13
1683632962179,MATH 10A,A01,188095,Staff,0,5,35,35
1683632963207,MATH 10B,A01,188097,Bowers; Adam R.,0,11,30,30
1683632963207,MATH 10B,A02,188099,Bowers; Adam R.,0,11,30,30
1683632963207,MATH 10B,B01,188104,Bowers; Adam R.,0,10,30,30
1683632963207,MATH 10B,B02,188106,Bowers; Adam R.,1,9,30,29
1683632964237,MATH 10C,A01,188111,Staff,0,18,30,30
1683632964237,MATH 10C,A02,188127,Staff,0,19,30,30
1683632964237,MATH 10C,A03,188131,Staff,0,19,30,30
1683632964237,MATH 10C,B01,188218,Staff,17,0,30,13
1683632964237,MATH 10C,B02,188244,Staff,13,0,30,17
1683632964237,MATH 10C,B03,188277,Staff,14,0,30,16
1683632965274,MATH 18,A01,188344,Bach; Quang Tran,18,0,30,12
1683632965274,MATH 18,A02,188345,Bach; Quang Tran,11,0,30,19
1683632965274,MATH 18,B01,188353,Bach; Quang Tran,11,0,30,19
1683632965274,MATH 18,B02,188354,Bach; Quang Tran,19,0,30,11
1683632966302,MATH 20A,A01,188374,Staff,11,0,35,24
1683632967331,MATH 20B,A01,188382,Ohm; Ko Woon,7,0,30,23
1683632967331,MATH 20B,A02,188383,Ohm; Ko Woon,22,0,30,8
1683632967331,MATH 20B,B01,188385,Ohm; Ko Woon,7,0,30,23
1683632967331,MATH 20B,B02,188392,Ohm; Ko Woon,22,0,30,8
1683632968356,MATH 20C,A01,188394,Harel; Guershon,11,0,30,19
1683632968356,MATH 20C,A02,188395,Harel; Guershon,14,0,30,16
1683632968356,MATH 20C,B01,188404,Harel; Guershon,4,0,30,26
1683632968356,MATH 20C,B02,188405,Harel; Guershon,18,0,30,12
1683632969385,MATH 20D,A01,188414,Hammock; Frances H,0,1,30,30
1683632969385,MATH 20D,A02,188415,Hammock; Frances H,0,1,30,30
1683632969385,MATH 20D,B01,188447,Hammock; Frances H,0,1,30,30
1683632969385,MATH 20D,B02,188486,Hammock; Frances H,4,0,30,26
1683632970415,MATH 20E,A01,188649,Staff,21,0,30,9
1683632970415,MATH 20E,A02,188650,Staff,21,0,30,9
1683632970415,MATH 20E,A03,188673,Staff,0,0,30,30
1683632971444,MATH 102,A01,188675,Staff,0,36,35,35
1683632972476,MATH 103B,A01,188681,Staff,3,0,35,32
1683632972476,MATH 103B,B01,188692,Staff,5,0,35,30
1683632973508,MATH 109,A01,188695,Salehi Golsefidy; Alireza,24,0,35,11
1683632973508,MATH 109,A02,188696,Salehi Golsefidy; Alireza,25,0,35,10
1683632974542,MATH 120A,A01,188698,Eggers; John Dietrich,7,0,35,28
1683632975574,MATH 142B,A01,188736,Ioana; Adrian,0,1,30,30
1683632975574,MATH 142B,A02,188741,Ioana; Adrian,0,1,30,30
1683632975574,MATH 142B,A03,188743,Ioana; Adrian,0,1,30,30
1683632976602,MATH 168A,A01,188790,Staff,0,10,35,35
1683632977635,MATH 170A,A01,188803,Nie; Jiawang,0,2,35,35
1683632977635,MATH 170A,A02,188811,Nie; Jiawang,0,0,35,35
1683632977635,MATH 170A,A03,188814,Nie; Jiawang,0,0,35,35
1683632977635,MATH 170A,A04,188815,Nie; Jiawang,10,0,35,25
1683632978663,MATH 193B,A01,188817,Staff,0,0,35,35
1683632978663,MATH 193B,A02,188818,Staff,5,0,35,30
1683632979693,MGT 4,A01,202857,Anderson; John Charles,61,0,80,19
1683632980720,MGT 12,A00,202858,Lindenberger; Wade Douglas,40,0,90,50
1683632981747,MGT 18,A00,202859,Staff,74,0,90,16
1683632982774,MGT 18GS,A00,202860,McKay; Michael J,13,0,28,15
1683632983800,MGT 45,A00,202861,Pecore; Joseph P.,12,0,90,78
1683632984831,MGT 100,A00,202863,Yavorsky; Daniel Ryan,28,0,90,62
1683632985857,MGT 103,A00,202864,Ehrich; Kristine R,0,17,90,90
1683632986886,MGT 112,A00,202865,Ehrich; Kristine R,15,0,90,75
1683632987914,MGT 121A,A00,202868,Staff,0,20,0,0
1683632988941,MGT 131B,A00,202869,Anderson; John Charles,59,0,90,31
1683632989974,MGT 136,A00,202871,Lindenberger; Wade Douglas,83,0,90,7
1683632991001,MGT 164,A00,202873,Staff,0,66,90,91
1683632992031,MGT 164GS,A00,202874,McKay; Mary A,13,0,28,15
1683632993061,MGT 180,A00,202875,Staff,0,50,90,91
1683632994095,MMW 11R,A01,205019,Herbst; Matthew,2,0,30,28
1683632994095,MMW 11R,A02,205026,Herbst; Matthew,29,0,30,1
1683632995129,MMW 15,A01,193512,Chang; Edmond Yi-Teh,0,8,28,28
1683632995129,MMW 15,A02,193513,Chang; Edmond Yi-Teh,0,5,28,28
1683632995129,MMW 15,A03,193514,Chang; Edmond Yi-Teh,0,5,28,28
1683632995129,MMW 15,A04,193515,Chang; Edmond Yi-Teh,0,5,28,28
1683632995129,MMW 15,A05,193516,Chang; Edmond Yi-Teh,0,5,28,28
1683632995129,MMW 15,A06,193517,Chang; Edmond Yi-Teh,0,6,28,28
1683632995129,MMW 15,B01,193519,Chang; Edmond Yi-Teh,0,5,28,28
1683632995129,MMW 15,B02,193520,Chang; Edmond Yi-Teh,0,5,28,28
1683632995129,MMW 15,B03,193521,Chang; Edmond Yi-Teh,0,5,28,28
1683632995129,MMW 15,B04,193522,Chang; Edmond Yi-Teh,0,5,28,28
1683632995129,MMW 15,B05,193523,Chang; Edmond Yi-Teh,0,5,28,28
1683632995129,MMW 15,B06,193524,Chang; Edmond Yi-Teh,0,5,28,28
1683632996162,MMW 122,A01,193526,Rahimi; Babak,0,16,28,28
1683632996162,MMW 122,A02,193527,Rahimi; Babak,0,15,28,28
1683632996162,MMW 122,A03,193528,Rahimi; Babak,0,0,0,0
1683632996162,MMW 122,A04,193529,Rahimi; Babak,0,0,0,0
1683632997193,MUS 1A,A01,186663,Staff,1,20,35,34
1683632998219,MUS 4,A01,186715,Staff,0,12,35,35
1683632999247,MUS 5R,A01,186796,Dubnov; Shlomo,0,17,35,35
1683633000272,MUS 6,A01,186798,Staff,0,5,25,25
1683633001299,MUS 7,A01,186830,Staff,11,0,35,24
1683633002329,MUS 8,A01,186930,Staff,0,26,35,35
1683633003359,MUS 15,A01,186932,Staff,0,16,35,35
1683633003359,MUS 15,B01,186934,Staff,0,17,35,35
1683633004390,MUS 80,A00,186935,Staff,0,0,20,20
1683633004390,MUS 80,B00,186936,Staff,24,0,25,1
1683633005417,NANO 11,A00,204702,Lipomi; Darren John,0,0,0,0
1683633006452,NANO 15,A01,204709,Yang; Kesong,0,1,0,0
1683633007479,NANO 114,A00,202069,Jahed Motlagh; Zeinab,3,0,10,7
1683633008511,PHIL 1,A00,186955,Grush; Rick Scott,31,0,40,9
1683633009540,PHIL 10,A01,186973,Grush; Rick Scott,27,0,35,8
1683633009540,PHIL 10,A02,186974,Grush; Rick Scott,33,0,35,2
1683633010567,PHIL 13,A01,186976,Staff,3,0,35,32
1683633010567,PHIL 13,A02,186977,Staff,16,0,35,19
1683633011595,PHIL 14,A01,186979,Staff,31,0,35,4
1683633011595,PHIL 14,A02,186986,Staff,32,0,35,3
1683633012621,PHIL 28,A01,186988,Staff,16,0,30,14
1683633012621,PHIL 28,A02,186989,Staff,1,0,30,29
1683633012621,PHIL 28,A03,186990,Staff,10,0,30,20
1683633012621,PHIL 28,A04,186991,Staff,26,0,30,4
1683633013648,PHIL 120,A00,186997,Staff,23,0,40,17
1683633014675,PHIL 137,A00,187003,Staff,7,0,40,33
1683633015701,PHIL 150,A00,187015,Staff,47,0,70,23
1683633016729,PHIL 167,A00,187021,Lamey; Andy M.,34,0,40,6
1683633017757,PHIL 174,A01,202226,Staff,17,0,20,3
1683633017757,PHIL 174,A02,202235,Staff,20,0,20,0
1683633018788,PHIL 191A,A00,258918,Staff,0,0,1,1
1683633019817,PHYS 1A,A00,187028,Staff,27,0,60,33
1683633020847,PHYS 1AL,001,187036,Staff,3,0,30,27
1683633020847,PHYS 1AL,002,187049,Staff,18,0,30,12
1683633021873,PHYS 1B,A00,187058,Staff,22,0,60,38
1683633022902,PHYS 1BL,001,187064,Staff,0,1,30,30
1683633022902,PHYS 1BL,002,187070,Staff,4,0,30,26
1683633023930,PHYS 1C,A00,187082,Staff,29,0,120,91
1683633024962,PHYS 1CL,001,187088,Staff,0,9,30,30
1683633024962,PHYS 1CL,002,187089,Staff,0,1,30,30
1683633024962,PHYS 1CL,009,262693,Staff,9,0,30,21
1683633026070,PHYS 2B,A01,187097,Staff,55,0,115,60
1683633027098,PHYS 2C,A01,187099,Staff,64,0,115,51
1683633028127,PHYS 2CL,A01,187101,Staff,5,0,28,23
1683633028127,PHYS 2CL,A02,187102,Staff,15,0,28,13
1683633029155,PHYS 2D,A01,187123,Shotwell; Brian,95,0,115,20
1683633030182,PHYS 4B,A01,187133,Grinstein; Benjamin,35,0,50,15
1683633031218,POLI 10,A00,188819,Staff,0,4,50,50
1683633032249,POLI 11,A00,188827,Staff,43,0,50,7
1683633033286,POLI 13R,A00,188828,Staff,0,1,20,20
1683633034318,POLI 27,A01,188830,Elgin; Samuel Zincke,0,2,70,70
1683633035346,POLI 30,A00,188832,Desposato; Scott,30,0,50,20
1683633036373,POLI 102F,A00,188834,Staff,0,0,40,40
1683633037402,POLI 104A,A00,188852,Staff,13,0,30,17
1683633038433,POLI 104I,A00,188853,Staff,0,7,20,20
1683633039464,POLI 110B,A00,188854,Wiens; David,7,0,20,13
1683633040490,POLI 112A,A00,188855,Wiens; David,4,0,30,26
1683633041517,POLI 117R,A00,188856,Forman; Fonna,0,12,20,20
1683633042543,POLI 118,A00,188857,Ingham; Sean,8,0,20,12
1683633043568,POLI 120G,A00,188858,Staff,8,0,30,22
1683633044597,POLI 131CR,A00,188863,Hoston; Germaine,21,0,50,29
1683633045627,POLI 133,A00,188864,Nellis; Gareth Hb,44,0,50,6
1683633046659,POLI 134D,A00,188865,Desposato; Scott,27,0,30,3
1683633047689,POLI 142A,A00,188871,Gartzke; Erik,21,0,50,29
1683633048718,POLI 142K,A00,188874,Staff,38,0,50,12
1683633049748,POLI 143,A00,188940,Gartzke; Erik,16,0,30,14
1683633050775,POLI 153,A00,188943,Staff,2,0,20,18
1683633051803,POLI 160AA,A00,188944,Staff,11,0,40,29
1683633052830,POLI 170A,A00,188945,Staff,11,0,30,19
1683633054891,PSYC 1,A00,188952,Staff,36,0,90,54
1683633055918,PSYC 2,B00,188953,Staff,19,0,35,16
1683633056946,PSYC 6,A00,188970,Staff,47,0,60,13
1683633057972,PSYC 7,A00,188973,Staff,35,0,45,10
1683633059001,PSYC 60,A01,188980,Rickard; Timothy C.,42,0,60,18
1683633060032,PSYC 70,A01,189001,Steiner; Eric Tomas,23,0,45,22
1683633061072,PSYC 100,A00,189005,Lacefield; Katharine I,0,99,120,120
1683633062106,PSYC 102,A00,189008,Staff,8,0,30,22
1683633063132,PSYC 106,B00,189026,Gorman; Michael R.,27,0,60,33
1683633064158,PSYC 114,B01,189033,Winkielman; Piotr,0,31,30,30
1683633065191,PSYC 131,A00,189036,Anagnostaras; Stephan,0,43,60,60
1683633066222,PSYC 136,A00,189041,Lowe; Angela Beth,0,7,25,25
1683633067248,PSYC 137,A00,189057,Winkielman; Piotr,0,37,25,25
1683633068276,PSYC 144,A00,189107,Wixted; John T,0,10,50,50
1683633070330,PSYC 162,A00,189142,Staff,0,9,85,85
1683633071357,PSYC 172,A00,189144,Gorman; Michael R.,0,6,30,30
1683633073416,PSYC 179,A00,189146,Lacefield; Katharine I,0,86,120,120
1683633074441,PSYC 181,A00,189147,Anagnostaras; Stephan,0,44,90,90
1683633075468,PSYC 190R,A00,189148,Barner; David A.,0,23,80,80
1683633076495,PSYC 191,A00,189275,Rickard; Timothy C.,0,10,25,25
1683633077523,PSYC 193,A00,189276,Chapman; Eddie Nathaniel,0,1,0,4
1683633078562,PSYC 193L,A01,189281,Lowe; Angela Beth,10,0,20,10
1683633078562,PSYC 193L,B01,189285,Staff,28,0,35,7
1683633079591,RELI 149,A00,187137,Rahimi; Babak,7,0,40,33
1683633080624,SE 9,A01,187315,Staff,0,2,18,18
1683633081651,SE 101B,A00,187409,Staff,24,0,30,6
1683633082679,SE 110B,A00,187444,Staff,10,0,40,30
1683633083706,SE 130B,A00,187449,Staff,31,0,40,9
1683633084736,SE 150A,A00,187516,Staff,9,0,20,11
1683633085764,SE 154,A00,187528,Staff,29,0,50,21
1683633086794,SIO 3,A01,258171,Staff,35,0,40,5
1683633087821,SIO 10,A00,187144,Cook; Geoffrey W,0,6,75,75
1683633088848,SIO 45,A00,187152,Cook; Geoffrey W,0,4,100,100
1683633089875,SIO 109R,A00,194486,Staff,0,4,20,20
1683633091929,SIO 187,A01,187233,Kacev; David,12,0,40,28
1683633092960,SOCI 1,A01,258656,Thorpe; Charles Robert,28,0,30,2
1683633092960,SOCI 1,A02,258658,Thorpe; Charles Robert,30,0,30,0
1683633092960,SOCI 1,A03,258661,Thorpe; Charles Robert,25,0,25,0
1683633092960,SOCI 1,A04,258666,Thorpe; Charles Robert,22,0,25,3
1683633092960,SOCI 1,A05,258897,Thorpe; Charles Robert,22,0,25,3
1683633092960,SOCI 1,A06,258898,Thorpe; Charles Robert,25,0,25,0
1683633093985,SOCI 30,A01,258903,Pardo Guerra; Juan Pablo,14,0,30,16
1683633095014,SOCI 102,A00,258904,Staff,9,0,25,16
1683633096043,SOCI 106,A00,258905,Staff,19,0,25,6
1683633097069,SOCI 111,A00,258907,Ribas Norris; Janet Vanesa,26,0,30,4
1683633098096,SOCI 121R,A00,258908,Pardo Guerra; Juan Pablo,8,0,30,22
1683633099123,SOCI 126,A01,203330,Staff,14,0,20,6
1683633100151,SOCI 131,A00,258909,Thorpe; Charles Robert,30,0,60,30
1683633101181,SOCI 135,A00,258910,Payne; Christine Anna,0,11,30,30
1683633102217,SOCI 157,A00,258911,Staff,12,0,30,18
1683633103253,SOCI 184,A00,258912,Staff,25,0,30,5
1683633104280,SOCI 188D,A00,258913,Staff,22,0,30,8
1683633105307,SYN 2,001,187529,Staff,9,0,16,7
1683633105307,SYN 2,002,201452,Staff,0,20,16,16
1683633105307,SYN 2,003,201469,Staff,2,0,16,14
1683633106334,SYN 100,A01,187531,Staff,0,9,20,20
1683633106334,SYN 100,B01,201491,Staff,0,10,20,20
1683633107362,TDAC 1,A00,189286,Walsh; Kim C.,3,0,20,17
1683633107362,TDAC 1,B00,189287,Harting; Carla Kelso,10,0,20,10
1683633108389,TDAC 101,A00,189300,Walsh; Kim C.,16,0,20,4
1683633108389,TDAC 101,B00,189301,Harting; Carla Kelso,18,0,20,2
1683633109415,TDAC 102,A00,189304,Basso; Beatrice,14,0,20,6
1683633110442,TDAC 108,A00,189305,Staff,18,0,20,2
1683633111470,TDDE 131,A00,189310,Staff,19,0,20,1
1683633111470,TDDE 131,B00,189314,Staff,19,0,20,1
1683633111470,TDDE 131,C00,189315,Staff,48,0,50,2
1683633111470,TDDE 131,D00,189316,Staff,14,0,15,1
1683633111470,TDDE 131,E00,204841,Staff,20,0,20,0
1683633112499,TDGE 10,A00,189289,Staff,28,0,50,22
1683633112499,TDGE 10,B00,189290,Havis; Allan,0,0,50,50
1683633113534,TDGE 11,A00,189291,Fulton; Julia,0,4,50,50
1683633113534,TDGE 11,B00,189292,Staff,20,0,25,5
1683633113534,TDGE 11,C00,260270,Staff,0,0,0,0
1683633114574,TDGE 25,A00,189294,Staff,2,0,20,18
1683633115599,TDGE 124,A00,189318,Fulton; Julia,0,8,50,50
1683633116627,TDGE 125,A00,189319,Staff,13,0,25,12
1683633116627,TDGE 125,B00,189320,Staff,23,0,25,2
1683633117654,TDGE 127,A00,189322,Havis; Allan,0,0,50,50
1683633118681,TDHT 101,A00,189323,Staff,18,0,25,7
1683633118681,TDHT 101,B00,189324,Staff,25,0,25,0
1683633119708,TDHT 102,A00,189325,Staff,49,0,50,1
1683633120739,TDMV 1,A00,189295,Arcidiacono; Kristin,20,0,30,10
1683633120739,TDMV 1,B00,189296,Caligagan; Maria T.,24,0,30,6
1683633121769,TDMV 2,A00,189297,Sammartano; Tonnie,27,0,30,3
1683633121769,TDMV 2,B00,189299,Arcidiacono; Kristin,23,0,30,7
1683633122796,TDMV 3,A00,204998,Rincon; Alicia,22,0,30,8
1683633123838,TDMV 120,A00,189458,Sammartano; Tonnie,28,0,30,2
1683633124871,TDMV 138,A00,189541,Jun; Grace Shin Hae,20,0,40,20
1683633125902,TDMV 142,A00,189717,Caligagan; Tony,25,0,30,5
1683633125902,TDMV 142,B00,189718,Caligagan; Maria T.,25,0,30,5
1683633126934,TMC 2,A01,187533,Staff,25,0,25,0
1683633126934,TMC 2,A02,187534,Staff,25,0,25,0
1683633127965,USP 1,A01,187536,Kwak; Nancy,0,16,25,25
1683633128992,USP 5,A01,187538,Staff,9,0,25,16
1683633130078,USP 101,A00,199253,Staff,0,4,0,0
1683633131111,USP 124,A00,187562,Boomhower; Matthew Charles,0,0,30,30
1683633132141,USP 138,A00,187582,Staff,20,0,25,5
1683633133174,USP 152,A01,187597,Staff,3,0,25,22
1683633134203,USP 153,A00,187598,Staff,19,0,25,6
1683633135235,USP 168,A00,187607,Kwak; Nancy,2,0,5,3
1683633136263,USP 173,A00,187619,Staff,4,0,25,21
1683633137293,USP 181,A00,187638,Staff,0,4,25,25
1683633138322,VIS 103,A00,187650,Cruz; Edwin Teddy,18,0,75,57
1683633139350,VIS 110D,A00,187669,Staff,13,0,22,9
1683633140377,VIS 127C,A00,187720,Shen; Kuiyi,67,0,146,79
1683633141410,VIS 149,A00,187731,Yoldas; Pinar,0,14,22,22
1683633142434,VIS 151,A01,188091,Staff,22,0,34,12
1683633142434,VIS 151,A02,188092,Staff,11,0,34,23
1683633143462,VIS 160B,A00,188093,Stalbaum; Brett,0,1,10,10
1683633145515,WCWP 10B,A00,201720,Staff,10,0,15,5
1683633145515,WCWP 10B,B00,201722,Staff,9,0,15,6
1683633146542,WCWP 100,A00,201725,Gagnon; Jeffrey C,0,0,2,2
1683633146542,WCWP 100,B00,201727,Staff,0,4,15,15
1683633149669,ANBI 133,A00,258401,Wilder; Linnea Lorene,34,0,40,6
1683633150699,ANBI 140,A00,258395,Hrvoj Mihic; Branka,18,0,25,7
1683633151729,ANSC 120,A00,258402,Bialecki; Jon Anthony,27,0,40,13
1683633152754,ANSC 144,A00,258400,Staff,12,0,40,28
1683633154811,ANSC 166,A00,258396,Parish; Steven Martin,156,0,175,19
1683633155838,ANSC 180,A00,193533,Staff,8,0,20,12
1683633156865,ANSC 188,A00,258397,Jassal; Aftab,34,0,40,6
1683633157892,ANTH 3,A01,258316,Staff,23,0,30,7
1683633158923,ANTH 5,A00,258394,Semendeferi; Ekaterini,16,0,20,4
1683633159951,ANTH 21,A01,258331,Staff,4,0,40,36
1683633160981,ANTH 103,A00,258398,Varma; Saiba,15,0,25,10
1683633162020,AWP 10,001,202034,Staff,0,0,0,0
1683633162020,AWP 10,002,202035,Staff,0,0,0,0
1683633162020,AWP 10,003,202036,Staff,0,0,0,0
1683633162020,AWP 10,004,202037,Staff,0,0,0,0
1683633162020,AWP 10,005,202038,Staff,0,0,0,0
1683633162020,AWP 10,006,202039,Staff,0,0,0,0
1683633162020,AWP 10,007,202040,Staff,0,0,0,0
1683633162020,AWP 10,008,202041,Staff,0,0,0,0
1683633162020,AWP 10,009,202042,Staff,0,0,0,0
1683633162020,AWP 10,010,202043,Staff,0,0,0,0
1683633162020,AWP 10,011,202044,Staff,0,0,0,0
1683633162020,AWP 10,012,202045,Staff,0,0,0,0
1683633162020,AWP 10,013,202046,Staff,0,0,0,0
1683633162020,AWP 10,014,202047,Staff,0,0,0,0
1683633162020,AWP 10,015,202048,Staff,0,0,0,0
1683633162020,AWP 10,016,202049,Staff,0,0,0,0
1683633162020,AWP 10,017,202050,Staff,0,0,0,0
1683633162020,AWP 10,018,202051,Staff,0,0,0,0
1683633162020,AWP 10,019,202052,Staff,0,0,0,0
1683633162020,AWP 10,020,202053,Staff,0,0,0,0
1683633162020,AWP 10,021,202054,Staff,0,0,0,0
1683633162020,AWP 10,022,202055,Staff,0,0,0,0
1683633162020,AWP 10,023,202056,Staff,0,0,0,0
1683633162020,AWP 10,024,202057,Staff,0,0,0,0
1683633162020,AWP 10,025,202058,Staff,0,0,0,0
1683633162020,AWP 10,026,202059,Staff,0,0,0,0
1683633163050,AWP 102,001,202032,Staff,0,0,0,0
1683633163050,AWP 102,002,202033,Staff,0,0,0,0
1683633164077,BENG 100,A01,254234,Taylor Amos; Alyssa C,31,0,40,9
1683633165103,BENG 196,001,270013,Engler; Adam J.,9999,0,9999,0
1683633166132,BICD 100R,A01,202018,Smith; Laurie,0,7,32,32
1683633166132,BICD 100R,A02,202019,Smith; Laurie,0,3,32,32
1683633166132,BICD 100R,A03,202020,Smith; Laurie,0,1,32,32
1683633166132,BICD 100R,A04,202021,Smith; Laurie,6,0,32,26
1683633166132,BICD 100R,A05,202022,Smith; Laurie,11,0,32,21
1683633167166,BICD 136,A01,193242,Gustafson-Brown; Cindy,0,2,32,32
1683633167166,BICD 136,A02,193244,Gustafson-Brown; Cindy,13,0,32,19
1683633168202,BIEB 102,A01,193249,Butler; Shannon Rhey,0,2,32,32
1683633168202,BIEB 102,A02,193251,Butler; Shannon Rhey,0,0,32,32
1683633168202,BIEB 102,A03,193253,Butler; Shannon Rhey,0,0,32,32
1683633168202,BIEB 102,A04,193255,Butler; Shannon Rhey,14,0,32,18
1683633168202,BIEB 102,A05,193265,Butler; Shannon Rhey,26,0,32,6
1683633168202,BIEB 102,A06,193269,Butler; Shannon Rhey,14,0,32,18
1683633170267,BIEB 150,A01,193274,Staff,0,0,32,32
1683633170267,BIEB 150,A02,193285,Staff,24,0,32,8
1683633171295,BIEB 194,A00,193286,Kurle; Carolyn M.,20,0,32,12
1683633172325,BILD 1,A01,192291,Staff,15,0,32,17
1683633172325,BILD 1,A02,192292,Staff,30,0,32,2
1683633172325,BILD 1,B01,192520,Reuther; Keefe,0,1,0,0
1683633172325,BILD 1,B02,192532,Reuther; Keefe,0,1,0,0
1683633173354,BILD 3,A01,192556,Butler; Shannon Rhey,0,0,32,32
1683633173354,BILD 3,A02,192581,Butler; Shannon Rhey,1,0,32,31
1683633173354,BILD 3,A03,192611,Butler; Shannon Rhey,21,0,32,11
1683633173354,BILD 3,A04,192612,Butler; Shannon Rhey,24,0,32,8
1683633173354,BILD 3,A05,192613,Butler; Shannon Rhey,26,0,32,6
1683633173354,BILD 3,A06,192679,Butler; Shannon Rhey,27,0,32,5
1683633173354,BILD 3,A07,192682,Butler; Shannon Rhey,20,0,32,12
1683633174383,BILD 4,A01,192836,Reuther; Keefe,0,0,24,24
1683633174383,BILD 4,A02,193044,Reuther; Keefe,4,0,24,20
1683633175408,BILD 10,A01,193142,Gustafson-Brown; Cindy,29,0,32,3
1683633175408,BILD 10,A02,193149,Gustafson-Brown; Cindy,31,0,32,1
1683633176439,BIMM 100,A01,193301,Staff,0,6,32,32
1683633176439,BIMM 100,A02,193312,Staff,0,7,32,32
1683633176439,BIMM 100,A03,193323,Staff,0,9,32,32
1683633177472,BIMM 101,A01,193329,McDonnell; Lisa Marie,0,4,24,24
1683633177472,BIMM 101,A02,193339,McDonnell; Lisa Marie,0,3,24,24
1683633177472,BIMM 101,B01,193354,McDonnell; Lisa Marie,0,4,24,24
1683633177472,BIMM 101,B02,193357,McDonnell; Lisa Marie,0,2,24,24
1683633178499,BIMM 110,A01,193377,Tat; John,0,11,32,32
1683633178499,BIMM 110,A02,193378,Tat; John,0,10,32,32
1683633179527,BIMM 120,A01,206116,Staff,0,0,32,32
1683633179527,BIMM 120,A02,206117,Staff,6,0,32,26
1683633179527,BIMM 120,A03,206121,Staff,21,0,32,11
1683633180555,BIPN 100,A01,193393,Park; Ji Young,0,14,32,32
1683633180555,BIPN 100,A02,193402,Park; Ji Young,0,14,32,32
1683633180555,BIPN 100,A03,193413,Park; Ji Young,0,14,32,32
1683633180555,BIPN 100,A04,193414,Park; Ji Young,0,13,32,32
1683633181584,BIPN 102,A01,193429,Staff,0,0,32,32
1683633181584,BIPN 102,A02,193438,Staff,18,0,32,14
1683633182611,BIPN 106,A01,193450,Reyes Gonzalez; Catalina,0,2,40,40
1683633183639,BIPN 134,A01,193465,Cooke; James Edward,0,0,32,32
1683633183639,BIPN 134,A02,193474,Cooke; James Edward,25,0,32,7
1683633183639,BIPN 134,A03,193485,Cooke; James Edward,29,0,32,3
1683633183639,BIPN 134,A04,193486,Cooke; James Edward,20,0,32,12
1683633183639,BIPN 134,A05,193491,Cooke; James Edward,31,0,32,1
1683633183639,BIPN 134,A06,193501,Cooke; James Edward,30,0,32,2
1683633183639,BIPN 134,A07,193510,Cooke; James Edward,29,0,32,3
1683633185699,BISP 194,A00,222522,Staff,14,0,32,18
1683633186729,CAT 124,A01,202407,Staff,19,0,25,6
1683633187763,CAT 125,A00,202408,Marchisotto; Jennifer Anne,2,0,20,18
1683633188793,CAT 125R,A00,202409,Smith; Lauryn Alissa,0,11,20,20
1683633188793,CAT 125R,B00,202410,Morales; Celeste Georgianna,0,11,20,20
1683633188793,CAT 125R,C00,202411,Irwin; Matthew Joseph,0,12,20,20
1683633189820,CENG 15,A01,204712,Yang; Kesong,0,1,0,0
1683633190854,CENG 114,A00,202070,Jahed Motlagh; Zeinab,5,0,20,15
1683633191883,CGS 105,A00,185477,Wesling; Megan E.,24,0,40,16
1683633192910,CGS 106,A00,185494,Staff,11,0,22,11
1683633193936,CGS 108,A00,185495,Staff,14,0,20,6
1683633194967,CGS 114,A00,185496,Staff,13,0,18,5
1683633195995,CGS 119,A00,185501,Staff,15,0,20,5
1683633197021,CGS 120,A00,185511,Staff,12,0,20,8
1683633198050,CHEM 4,A01,184675,Bussey; Thomas J,97,0,100,3
1683633199077,CHEM 6A,A01,184677,Staff,33,0,60,27
1683633200103,CHEM 6B,A01,184679,Staff,63,0,100,37
1683633201133,CHEM 6C,A01,184681,Bussey; Thomas J,0,0,50,50
1683633201133,CHEM 6C,A02,184682,Bussey; Thomas J,32,0,50,18
1683633202161,CHEM 40A,A01,184684,Albizati; Kim F.,35,0,100,65
1683633203188,CHEM 40B,A01,184686,Albizati; Kim F.,0,22,100,100
1683633204219,CHEM 41B,A01,184690,Staff,51,0,100,49
1683633205252,COGS 3,A01,184715,Boyle; Mary E. T.,0,27,40,40
1683633206283,COGS 14B,A01,185172,Staff,0,14,38,38
1683633207310,COGS 18,A01,184736,Staff,15,0,80,65
1683633208335,COGS 100,A01,184932,Staff,0,7,73,73
1683633209361,COGS 101A,A01,184935,Staff,0,39,30,30
1683633210385,COGS 101B,A01,184944,Staff,0,2,30,30
1683633211414,COGS 101C,A01,184946,Staff,0,10,30,30
1683633212444,COGS 102A,A01,184951,Johnson; Christine M.,2,0,40,38
1683633213474,COGS 107B,A01,184953,Mooshagian; Eric Frederick,0,51,40,40
1683633214499,COGS 118B,A01,184959,Gupta; Anjum,0,49,40,40
1683633215529,COGS 153,A00,184961,Staff,0,16,30,30
1683633216557,COGS 177,A00,184962,Staff,0,21,30,30
1683633217584,COGS 187A,A01,184969,Boyle; Mary E. T.,0,19,40,40
1683633218617,COMM 10,A01,185174,Staff,0,5,25,25
1683633218617,COMM 10,A02,185189,Staff,0,2,25,25
1683633218617,COMM 10,A03,269821,Staff,0,1,0,0
1683633219643,COMM 100B,A01,185475,Staff,0,1,0,2
1683633219643,COMM 100B,A02,185476,Staff,12,0,25,13
1683633220680,COMM 100C,A01,185314,Staff,1,0,25,24
1683633220680,COMM 100C,A02,185327,Staff,18,0,25,7
1683633221709,COMM 110M,A00,185349,Staff,0,0,40,40
1683633222740,COMM 113T,A00,185352,Staff,25,0,40,15
1683633223769,COMM 114I,A00,185353,Staff,31,0,40,9
1683633224798,COMM 131,A00,185354,Staff,17,0,30,13
1683633225826,CSE 8A,A50,185358,Cao; Yingjun,0,46,10,10
1683633226862,CSE 8B,A01,185362,Staff,0,48,50,50
1683633227890,CSE 11,A01,185416,Cao; Yingjun,0,91,10,10
1683633228920,CSE 20,A01,185445,Briones; Jor-el Thomas Caparas,4,0,25,21
1683633229952,CSE 21,A01,185447,Staff,9,0,50,41
1683633230986,CSE 101,A01,185451,Staff,0,13,50,50
1683633230986,CSE 101,B01,185453,Jones; Miles E,0,13,50,50
1683633233040,CSE 141,A01,185458,Eldon; John,15,0,100,85
1683633234145,CSE 141L,A01,185461,Eldon; John,7,0,100,93
1683633235172,CSE 142,A01,185463,Staff,36,0,60,24
1683633235172,CSE 142,B01,201355,Staff,0,7,60,60
1683633236203,CSE 142L,A01,185470,Staff,36,0,60,24
1683633236203,CSE 142L,B01,201417,Staff,0,6,60,60
1683633237241,CSE 190,A00,201433,Staff,32,0,49,17
1683633238272,DOC 1,A01,259136,Strom; Megan C.,7,0,15,8
1683633238272,DOC 1,A02,259137,Strom; Megan C.,14,0,15,1
1683633238272,DOC 1,A03,259138,Strom; Megan C.,14,0,15,1
1683633238272,DOC 1,A04,259139,Strom; Megan C.,14,0,15,1
1683633239300,DOC 100D,A00,259140,Pass; Natalye Joann,14,0,25,11
1683633240327,DSGN 1,A01,184749,Rill; Bryan,0,26,30,30
1683633241355,DSGN 100,A01,185168,Staff,0,2,25,25
1683633242386,ECE 5,A01,185626,Morris; Karcher William,0,11,0,0
1683633243413,ECE 101,A01,185628,Staff,14,0,70,56
1683633244440,ECE 107,A01,185635,Baghdadchi; Saharnaz,0,0,20,20
1683633244440,ECE 107,A02,185638,Baghdadchi; Saharnaz,3,0,20,17
1683633245470,ECE 148,A01,185647,Silberman; Jack,0,0,16,16
1683633246501,ECON 1,A01,185537,Crane; Meredith Helen,54,0,70,16
1683633247530,ECON 3,A01,185549,Crane; Meredith Helen,29,0,70,41
1683633248562,ECON 4,A01,203354,Anderson; John Charles,0,5,10,10
1683633249591,ECON 100A,A01,185574,Staff,0,5,40,40
1683633250622,ECON 100B,A01,185576,Staff,0,12,50,50
1683633251655,ECON 100C,A01,185589,Newhouse; Herbert S,30,0,70,40
1683633252682,ECON 105,A00,185608,Vespa; Emanuel Ignacio,19,0,35,16
1683633253707,ECON 109,A01,185610,Shishkin; Denis,9,0,35,26
1683633254733,ECON 110A,A01,185612,Staff,9,0,40,31
1683633255762,ECON 120A,A01,185615,Staff,20,0,40,20
1683633256793,ECON 120C,A01,185617,Sun; Yixiao,0,20,70,70
1683633257826,ECON 144,A00,203346,Squires; Dale E,2,0,35,33
1683633258852,ECON 171,A01,203349,Newhouse; Herbert S,0,1,35,35
1683633259879,ECON 173A,A01,185621,Toda; Alexis Akira,21,0,35,14
1683633260911,EDS 25,A01,202413,Staff,0,1,0,0
1683633260911,EDS 25,A02,202414,Staff,0,1,0,0
1683633260911,EDS 25,A03,202415,Staff,0,0,0,0
1683633260911,EDS 25,A04,202416,Staff,0,1,0,0
1683633260911,EDS 25,A05,202439,Staff,0,0,0,0
1683633260911,EDS 25,A06,202440,Staff,0,0,0,0
1683633260911,EDS 25,B01,202631,Staff,0,0,0,0
1683633260911,EDS 25,B02,202632,Staff,0,0,0,0
1683633260911,EDS 25,B03,202639,Staff,0,0,0,0
1683633260911,EDS 25,B04,202640,Staff,0,0,0,0
1683633260911,EDS 25,B05,202643,Staff,0,0,0,0
1683633260911,EDS 25,B06,202644,Staff,0,0,0,0
1683633261940,EDS 38,A01,202659,Black; Alison Michelle,24,0,25,1
1683633262970,EDS 115,A00,202652,Staff,18,0,30,12
1683633263999,EDS 125,A00,202649,Staff,13,0,30,17
1683633265026,EDS 126,A01,203332,Staff,30,0,30,0
1683633266052,EDS 139,A00,202838,Staff,16,0,25,9
1683633267079,EDS 146,A01,202655,Staff,14,0,25,11
1683633268104,ENG 15,A00,185667,Staff,0,1,0,0
1683633268104,ENG 15,B00,185672,Staff,0,0,0,0
1683633268104,ENG 15,C00,185675,Staff,0,0,0,0
1683633268104,ENG 15,D00,185682,Staff,0,0,0,0
1683633268104,ENG 15,E00,185684,Staff,0,0,0,0
1683633269136,ETHN 103,A00,185710,Staff,0,8,35,35
1683633270172,ETHN 103A,A00,199228,Man; Simeon S,0,0,9,9
1683633271200,ETHN 109,A00,185711,Staff,16,0,35,19
1683633272229,ETHN 142,A00,185726,Staff,0,4,30,30
1683633273257,ETHN 163J,A00,199229,Man; Simeon S,5,0,8,3
1683633274283,ETHN 168,A00,185727,Staff,7,0,10,3
1683633275311,ETHN 182,A00,185728,Staff,0,0,35,35
1683633276339,ETHN 183,A00,185737,Staff,9,0,18,9
1683633277369,GLBH 111,A01,209361,Burgos; Jose L.,0,0,0,0
1683633279429,HIEU 104,A00,185792,Staff,14,0,20,6
1683633280458,HIEU 115,A00,185800,Staff,0,0,20,20
1683633281490,HIEU 128,A00,185801,Staff,0,9,20,20
1683633282520,HIEU 147,A00,185802,Staff,15,0,20,5
1683633283546,HIEU 154,A00,185823,Staff,11,0,20,9
1683633284576,HILA 102,A00,185826,Staff,14,0,20,6
1683633285602,HILD 2C,A01,185778,Staff,0,13,20,20
1683633286633,HILD 7B,A01,185780,Kwak; Nancy,0,16,32,32
1683633286633,HILD 7B,A02,185781,Kwak; Nancy,0,18,32,32
1683633287664,HILD 30,A01,185791,Staff,12,0,20,8
1683633288696,HISC 119,A00,185830,Golan; Tal,0,9,20,20
1683633289723,HITO 156GS,A00,185831,Patterson; Patrick H.,0,0,0,23
1683633290752,HIUS 103,A00,185832,Man; Simeon S,0,4,20,20
1683633291787,HIUS 117,A00,185836,Kwak; Nancy,2,0,20,18
1683633292814,HIUS 125,A00,185840,Man; Simeon S,0,1,23,23
1683633293845,HIUS 149,A00,185845,Staff,1,0,20,19
1683633294881,HUM 3,A01,185882,Zavodny; Tatiana Sophia,0,7,50,50
1683633294881,HUM 3,B01,185899,Caldwell; Michael Alan,0,18,50,50
1683633295906,HUM 3GS,A00,185900,Patterson; Patrick H.,0,0,0,23
1683633296937,HUM 4,A01,185938,Zroka; Amy Liane,30,0,50,20
1683633296937,HUM 4,B01,185956,Watkins; Eric,0,4,50,50
1683633296937,HUM 4,B02,202209,Watkins; Eric,0,4,50,50
1683633296937,HUM 4,B03,202210,Watkins; Eric,0,4,50,50
1683633297965,HUM 5,A01,185958,West; Geoffrey Scott,2,0,50,48
1683633297965,HUM 5,A02,202215,West; Geoffrey Scott,0,0,50,50
1683633298994,INTL 190,A00,185959,Gagnon; Jeffrey C,0,0,0,9
1683633298994,INTL 190,B00,185960,Lettieri; Michael Joseph,0,0,0,2
1683633300021,JAPN 180,A00,254509,Staff,5,0,30,25
1683633301048,LATI 10,A01,202853,Kennemore; Amy Michelle,4,0,35,31
1683633301048,LATI 10,A02,202854,Kennemore; Amy Michelle,2,0,35,33
1683633301048,LATI 10,A03,270054,Kennemore; Amy Michelle,30,0,30,0
1683633302078,LATI 180,A00,202855,Kennemore; Amy Michelle,11,0,20,9
1683633303105,LAWS 101,A00,201767,Golan; Tal,0,7,40,40
1683633304130,LIFR 1C,A00,185961,Staff,6,0,20,14
1683633305156,LIFR 1CX,A00,185962,Staff,7,0,20,13
1683633306180,LIFR 1D,A00,185963,Staff,7,0,20,13
1683633307205,LIFR 1DX,A00,185964,Staff,7,0,20,13
1683633308234,LIGN 101,A01,186039,Staff,43,0,50,7
1683633309262,LIGN 165,A00,186040,Staff,15,0,50,35
1683633310289,LTCS 108,A00,186041,Staff,5,0,10,5
1683633311315,LTCS 119,A00,186042,Staff,15,0,20,5
1683633312346,LTCS 130,A00,186043,Wesling; Megan E.,15,0,25,10
1683633314399,LTEA 138,A00,186119,Staff,14,0,40,26
1683633315429,LTEN 124,A00,186148,Staff,6,0,25,19
1683633316457,LTEN 178,A00,186149,Staff,7,0,15,8
1683633317488,LTEN 181,A00,186150,Blanco; John D,34,0,40,6
1683633318518,LTWL 120,A00,186160,Staff,20,0,25,5
1683633319547,LTWL 165,A00,186161,Staff,22,0,25,3
1683633320572,LTWR 100,A00,186162,Staff,0,5,15,15
1683633321598,LTWR 102,A00,186163,Doller; Ben,5,0,15,10
1683633322626,MAE 8,A01,186412,Staff,0,0,0,0
1683633323658,MAE 30B,A00,186445,Bahadori; Mohammad Yousef,82,0,100,18
1683633324683,MAE 40,A00,186592,Bewley; Thomas R,10,0,50,40
1683633325709,MAE 101B,A00,186593,Bahadori; Mohammad Yousef,80,0,100,20
1683633326737,MAE 105,A00,186594,Bandaru; Prabhakar,10,0,50,40
1683633327768,MAE 107,A00,186599,Pham; Hieu Tan,0,7,120,120
1683633328801,MAE 148,A01,186660,Silberman; Jack,3,0,16,13
1683633329828,MATH 10A,A01,188095,Staff,0,5,35,35
1683633330855,MATH 10B,A01,188097,Bowers; Adam R.,0,11,30,30
1683633330855,MATH 10B,A02,188099,Bowers; Adam R.,0,11,30,30
1683633330855,MATH 10B,B01,188104,Bowers; Adam R.,0,10,30,30
1683633330855,MATH 10B,B02,188106,Bowers; Adam R.,1,9,30,29
1683633331884,MATH 10C,A01,188111,Staff,0,18,30,30
1683633331884,MATH 10C,A02,188127,Staff,0,19,30,30
1683633331884,MATH 10C,A03,188131,Staff,0,19,30,30
1683633331884,MATH 10C,B01,188218,Staff,17,0,30,13
1683633331884,MATH 10C,B02,188244,Staff,13,0,30,17
1683633331884,MATH 10C,B03,188277,Staff,14,0,30,16
1683633332917,MATH 18,A01,188344,Bach; Quang Tran,18,0,30,12
1683633332917,MATH 18,A02,188345,Bach; Quang Tran,11,0,30,19
1683633332917,MATH 18,B01,188353,Bach; Quang Tran,11,0,30,19
1683633332917,MATH 18,B02,188354,Bach; Quang Tran,19,0,30,11
1683633333950,MATH 20A,A01,188374,Staff,11,0,35,24
1683633334988,MATH 20B,A01,188382,Ohm; Ko Woon,7,0,30,23
1683633334988,MATH 20B,A02,188383,Ohm; Ko Woon,22,0,30,8
1683633334988,MATH 20B,B01,188385,Ohm; Ko Woon,7,0,30,23
1683633334988,MATH 20B,B02,188392,Ohm; Ko Woon,22,0,30,8
1683633336021,MATH 20C,A01,188394,Harel; Guershon,11,0,30,19
1683633336021,MATH 20C,A02,188395,Harel; Guershon,14,0,30,16
1683633336021,MATH 20C,B01,188404,Harel; Guershon,4,0,30,26
1683633336021,MATH 20C,B02,188405,Harel; Guershon,18,0,30,12
1683633337055,MATH 20D,A01,188414,Hammock; Frances H,0,1,30,30
1683633337055,MATH 20D,A02,188415,Hammock; Frances H,0,1,30,30
1683633337055,MATH 20D,B01,188447,Hammock; Frances H,0,1,30,30
1683633337055,MATH 20D,B02,188486,Hammock; Frances H,4,0,30,26
1683633338139,MATH 20E,A01,188649,Staff,21,0,30,9
1683633338139,MATH 20E,A02,188650,Staff,21,0,30,9
1683633338139,MATH 20E,A03,188673,Staff,0,0,30,30
1683633339168,MATH 102,A01,188675,Staff,0,36,35,35
1683633340194,MATH 103B,A01,188681,Staff,3,0,35,32
1683633340194,MATH 103B,B01,188692,Staff,5,0,35,30
1683633341221,MATH 109,A01,188695,Salehi Golsefidy; Alireza,24,0,35,11
1683633341221,MATH 109,A02,188696,Salehi Golsefidy; Alireza,25,0,35,10
1683633342248,MATH 120A,A01,188698,Eggers; John Dietrich,7,0,35,28
1683633343280,MATH 142B,A01,188736,Ioana; Adrian,0,1,30,30
1683633343280,MATH 142B,A02,188741,Ioana; Adrian,0,1,30,30
1683633343280,MATH 142B,A03,188743,Ioana; Adrian,0,1,30,30
1683633344311,MATH 168A,A01,188790,Staff,0,10,35,35
1683633345344,MATH 170A,A01,188803,Nie; Jiawang,0,2,35,35
1683633345344,MATH 170A,A02,188811,Nie; Jiawang,0,0,35,35
1683633345344,MATH 170A,A03,188814,Nie; Jiawang,0,0,35,35
1683633345344,MATH 170A,A04,188815,Nie; Jiawang,10,0,35,25
1683633346372,MATH 193B,A01,188817,Staff,0,0,35,35
1683633346372,MATH 193B,A02,188818,Staff,5,0,35,30
1683633347404,MGT 4,A01,202857,Anderson; John Charles,61,0,80,19
1683633348431,MGT 12,A00,202858,Lindenberger; Wade Douglas,40,0,90,50
1683633349462,MGT 18,A00,202859,Staff,74,0,90,16
1683633350489,MGT 18GS,A00,202860,McKay; Michael J,13,0,28,15
1683633351518,MGT 45,A00,202861,Pecore; Joseph P.,12,0,90,78
1683633352549,MGT 100,A00,202863,Yavorsky; Daniel Ryan,28,0,90,62
1683633353580,MGT 103,A00,202864,Ehrich; Kristine R,0,17,90,90
1683633354611,MGT 112,A00,202865,Ehrich; Kristine R,15,0,90,75
1683633355643,MGT 121A,A00,202868,Staff,0,20,0,0
1683633356670,MGT 131B,A00,202869,Anderson; John Charles,59,0,90,31
1683633357709,MGT 136,A00,202871,Lindenberger; Wade Douglas,83,0,90,7
1683633358736,MGT 164,A00,202873,Staff,0,66,90,91
1683633359764,MGT 164GS,A00,202874,McKay; Mary A,13,0,28,15
1683633360794,MGT 180,A00,202875,Staff,0,50,90,91
1683633361824,MMW 11R,A01,205019,Herbst; Matthew,2,0,30,28
1683633361824,MMW 11R,A02,205026,Herbst; Matthew,29,0,30,1
1683633362858,MMW 15,A01,193512,Chang; Edmond Yi-Teh,0,8,28,28
1683633362858,MMW 15,A02,193513,Chang; Edmond Yi-Teh,0,5,28,28
1683633362858,MMW 15,A03,193514,Chang; Edmond Yi-Teh,0,5,28,28
1683633362858,MMW 15,A04,193515,Chang; Edmond Yi-Teh,0,5,28,28
1683633362858,MMW 15,A05,193516,Chang; Edmond Yi-Teh,0,5,28,28
1683633362858,MMW 15,A06,193517,Chang; Edmond Yi-Teh,0,6,28,28
1683633362858,MMW 15,B01,193519,Chang; Edmond Yi-Teh,0,5,28,28
1683633362858,MMW 15,B02,193520,Chang; Edmond Yi-Teh,0,5,28,28
1683633362858,MMW 15,B03,193521,Chang; Edmond Yi-Teh,0,5,28,28
1683633362858,MMW 15,B04,193522,Chang; Edmond Yi-Teh,0,5,28,28
1683633362858,MMW 15,B05,193523,Chang; Edmond Yi-Teh,0,5,28,28
1683633362858,MMW 15,B06,193524,Chang; Edmond Yi-Teh,0,5,28,28
1683633363886,MMW 122,A01,193526,Rahimi; Babak,0,16,28,28
1683633363886,MMW 122,A02,193527,Rahimi; Babak,0,15,28,28
1683633363886,MMW 122,A03,193528,Rahimi; Babak,0,0,0,0
1683633363886,MMW 122,A04,193529,Rahimi; Babak,0,0,0,0
1683633364914,MUS 1A,A01,186663,Staff,1,20,35,34
1683633365943,MUS 4,A01,186715,Staff,0,12,35,35
1683633366970,MUS 5R,A01,186796,Dubnov; Shlomo,0,17,35,35
1683633367996,MUS 6,A01,186798,Staff,0,5,25,25
1683633369023,MUS 7,A01,186830,Staff,11,0,35,24
1683633370051,MUS 8,A01,186930,Staff,0,26,35,35
1683633371082,MUS 15,A01,186932,Staff,0,16,35,35
1683633371082,MUS 15,B01,186934,Staff,0,17,35,35
1683633372109,MUS 80,A00,186935,Staff,0,0,20,20
1683633372109,MUS 80,B00,186936,Staff,24,0,25,1
1683633373133,NANO 11,A00,204702,Lipomi; Darren John,0,0,0,0
1683633374168,NANO 15,A01,204709,Yang; Kesong,0,1,0,0
1683633375201,NANO 114,A00,202069,Jahed Motlagh; Zeinab,3,0,10,7
1683633376226,PHIL 1,A00,186955,Grush; Rick Scott,31,0,40,9
1683633377256,PHIL 10,A01,186973,Grush; Rick Scott,27,0,35,8
1683633377256,PHIL 10,A02,186974,Grush; Rick Scott,33,0,35,2
1683633378283,PHIL 13,A01,186976,Staff,3,0,35,32
1683633378283,PHIL 13,A02,186977,Staff,16,0,35,19
1683633379314,PHIL 14,A01,186979,Staff,31,0,35,4
1683633379314,PHIL 14,A02,186986,Staff,32,0,35,3
1683633380344,PHIL 28,A01,186988,Staff,16,0,30,14
1683633380344,PHIL 28,A02,186989,Staff,1,0,30,29
1683633380344,PHIL 28,A03,186990,Staff,10,0,30,20
1683633380344,PHIL 28,A04,186991,Staff,26,0,30,4
1683633381374,PHIL 120,A00,186997,Staff,23,0,40,17
1683633382399,PHIL 137,A00,187003,Staff,7,0,40,33
1683633383429,PHIL 150,A00,187015,Staff,47,0,70,23
1683633384456,PHIL 167,A00,187021,Lamey; Andy M.,34,0,40,6
1683633385484,PHIL 174,A01,202226,Staff,17,0,20,3
1683633385484,PHIL 174,A02,202235,Staff,20,0,20,0
1683633386512,PHIL 191A,A00,258918,Staff,0,0,1,1
1683633387539,PHYS 1A,A00,187028,Staff,27,0,60,33
1683633388568,PHYS 1AL,001,187036,Staff,3,0,30,27
1683633388568,PHYS 1AL,002,187049,Staff,18,0,30,12
1683633389597,PHYS 1B,A00,187058,Staff,22,0,60,38
1683633390626,PHYS 1BL,001,187064,Staff,0,1,30,30
1683633390626,PHYS 1BL,002,187070,Staff,4,0,30,26
1683633391657,PHYS 1C,A00,187082,Staff,29,0,120,91
1683633392690,PHYS 1CL,001,187088,Staff,0,9,30,30
1683633392690,PHYS 1CL,002,187089,Staff,0,1,30,30
1683633392690,PHYS 1CL,009,262693,Staff,9,0,30,21
1683633393716,PHYS 2B,A01,187097,Staff,55,0,115,60
1683633394746,PHYS 2C,A01,187099,Staff,64,0,115,51
1683633395774,PHYS 2CL,A01,187101,Staff,5,0,28,23
1683633395774,PHYS 2CL,A02,187102,Staff,15,0,28,13
1683633396802,PHYS 2D,A01,187123,Shotwell; Brian,95,0,115,20
1683633397831,PHYS 4B,A01,187133,Grinstein; Benjamin,35,0,50,15
1683633398858,POLI 10,A00,188819,Staff,0,4,50,50
1683633399888,POLI 11,A00,188827,Staff,43,0,50,7
1683633400918,POLI 13R,A00,188828,Staff,0,1,20,20
1683633401946,POLI 27,A01,188830,Elgin; Samuel Zincke,0,2,70,70
1683633402971,POLI 30,A00,188832,Desposato; Scott,30,0,50,20
1683633404004,POLI 102F,A00,188834,Staff,0,0,40,40
1683633405030,POLI 104A,A00,188852,Staff,13,0,30,17
1683633406057,POLI 104I,A00,188853,Staff,0,7,20,20
1683633407089,POLI 110B,A00,188854,Wiens; David,7,0,20,13
1683633408117,POLI 112A,A00,188855,Wiens; David,4,0,30,26
1683633409140,POLI 117R,A00,188856,Forman; Fonna,0,12,20,20
1683633410169,POLI 118,A00,188857,Ingham; Sean,8,0,20,12
1683633411195,POLI 120G,A00,188858,Staff,8,0,30,22
1683633412223,POLI 131CR,A00,188863,Hoston; Germaine,21,0,50,29
1683633413253,POLI 133,A00,188864,Nellis; Gareth Hb,44,0,50,6
1683633414283,POLI 134D,A00,188865,Desposato; Scott,27,0,30,3
1683633415310,POLI 142A,A00,188871,Gartzke; Erik,21,0,50,29
1683633416340,POLI 142K,A00,188874,Staff,38,0,50,12
1683633417371,POLI 143,A00,188940,Gartzke; Erik,16,0,30,14
1683633418396,POLI 153,A00,188943,Staff,2,0,20,18
1683633419425,POLI 160AA,A00,188944,Staff,11,0,40,29
1683633420452,POLI 170A,A00,188945,Staff,11,0,30,19
1683633422510,PSYC 1,A00,188952,Staff,36,0,90,54
1683633423540,PSYC 2,B00,188953,Staff,19,0,35,16
1683633424570,PSYC 6,A00,188970,Staff,47,0,60,13
1683633425608,PSYC 7,A00,188973,Staff,35,0,45,10
1683633426638,PSYC 60,A01,188980,Rickard; Timothy C.,42,0,60,18
1683633427670,PSYC 70,A01,189001,Steiner; Eric Tomas,23,0,45,22
1683633428700,PSYC 100,A00,189005,Lacefield; Katharine I,0,99,120,120
1683633429730,PSYC 102,A00,189008,Staff,8,0,30,22
1683633430764,PSYC 106,B00,189026,Gorman; Michael R.,27,0,60,33
1683633431790,PSYC 114,B01,189033,Winkielman; Piotr,0,31,30,30
1683633432816,PSYC 131,A00,189036,Anagnostaras; Stephan,0,43,60,60
1683633433844,PSYC 136,A00,189041,Lowe; Angela Beth,0,7,25,25
1683633434870,PSYC 137,A00,189057,Winkielman; Piotr,0,37,25,25
1683633435897,PSYC 144,A00,189107,Wixted; John T,0,10,50,50
1683633437949,PSYC 162,A00,189142,Staff,0,9,85,85
1683633438976,PSYC 172,A00,189144,Gorman; Michael R.,0,6,30,30
1683633441029,PSYC 179,A00,189146,Lacefield; Katharine I,0,86,120,120
1683633442119,PSYC 181,A00,189147,Anagnostaras; Stephan,0,44,90,90
1683633443157,PSYC 190R,A00,189148,Barner; David A.,0,23,80,80
1683633444185,PSYC 191,A00,189275,Rickard; Timothy C.,0,10,25,25
1683633445213,PSYC 193,A00,189276,Chapman; Eddie Nathaniel,0,1,0,4
1683633446245,PSYC 193L,A01,189281,Lowe; Angela Beth,10,0,20,10
1683633446245,PSYC 193L,B01,189285,Staff,28,0,35,7
1683633447276,RELI 149,A00,187137,Rahimi; Babak,7,0,40,33
1683633448301,SE 9,A01,187315,Staff,0,2,18,18
1683633449331,SE 101B,A00,187409,Staff,24,0,30,6
1683633450361,SE 110B,A00,187444,Staff,10,0,40,30
1683633451389,SE 130B,A00,187449,Staff,31,0,40,9
1683633452417,SE 150A,A00,187516,Staff,9,0,20,11
1683633453443,SE 154,A00,187528,Staff,29,0,50,21
1683633454469,SIO 3,A01,258171,Staff,35,0,40,5
1683633455495,SIO 10,A00,187144,Cook; Geoffrey W,0,6,75,75
1683633456525,SIO 45,A00,187152,Cook; Geoffrey W,0,4,100,100
1683633457554,SIO 109R,A00,194486,Staff,0,4,20,20
1683633459612,SIO 187,A01,187233,Kacev; David,12,0,40,28
1683633460648,SOCI 1,A01,258656,Thorpe; Charles Robert,28,0,30,2
1683633460648,SOCI 1,A02,258658,Thorpe; Charles Robert,30,0,30,0
1683633460648,SOCI 1,A03,258661,Thorpe; Charles Robert,25,0,25,0
1683633460648,SOCI 1,A04,258666,Thorpe; Charles Robert,22,0,25,3
1683633460648,SOCI 1,A05,258897,Thorpe; Charles Robert,22,0,25,3
1683633460648,SOCI 1,A06,258898,Thorpe; Charles Robert,25,0,25,0
1683633461674,SOCI 30,A01,258903,Pardo Guerra; Juan Pablo,14,0,30,16
1683633462701,SOCI 102,A00,258904,Staff,9,0,25,16
1683633463729,SOCI 106,A00,258905,Staff,19,0,25,6
1683633464759,SOCI 111,A00,258907,Ribas Norris; Janet Vanesa,26,0,30,4
1683633465789,SOCI 121R,A00,258908,Pardo Guerra; Juan Pablo,8,0,30,22
1683633466815,SOCI 126,A01,203330,Staff,14,0,20,6
1683633467841,SOCI 131,A00,258909,Thorpe; Charles Robert,30,0,60,30
1683633468873,SOCI 135,A00,258910,Payne; Christine Anna,0,11,30,30
1683633469902,SOCI 157,A00,258911,Staff,12,0,30,18
1683633470932,SOCI 184,A00,258912,Staff,25,0,30,5
1683633471959,SOCI 188D,A00,258913,Staff,22,0,30,8
1683633472988,SYN 2,001,187529,Staff,9,0,16,7
1683633472988,SYN 2,002,201452,Staff,0,20,16,16
1683633472988,SYN 2,003,201469,Staff,2,0,16,14
1683633474015,SYN 100,A01,187531,Staff,0,9,20,20
1683633474015,SYN 100,B01,201491,Staff,0,10,20,20
1683633475043,TDAC 1,A00,189286,Walsh; Kim C.,3,0,20,17
1683633475043,TDAC 1,B00,189287,Harting; Carla Kelso,10,0,20,10
1683633476071,TDAC 101,A00,189300,Walsh; Kim C.,16,0,20,4
1683633476071,TDAC 101,B00,189301,Harting; Carla Kelso,18,0,20,2
1683633477099,TDAC 102,A00,189304,Basso; Beatrice,14,0,20,6
1683633478123,TDAC 108,A00,189305,Staff,18,0,20,2
1683633479152,TDDE 131,A00,189310,Staff,19,0,20,1
1683633479152,TDDE 131,B00,189314,Staff,19,0,20,1
1683633479152,TDDE 131,C00,189315,Staff,48,0,50,2
1683633479152,TDDE 131,D00,189316,Staff,14,0,15,1
1683633479152,TDDE 131,E00,204841,Staff,20,0,20,0
1683633480179,TDGE 10,A00,189289,Staff,28,0,50,22
1683633480179,TDGE 10,B00,189290,Havis; Allan,0,0,50,50
1683633481206,TDGE 11,A00,189291,Fulton; Julia,0,4,50,50
1683633481206,TDGE 11,B00,189292,Staff,20,0,25,5
1683633481206,TDGE 11,C00,260270,Staff,0,0,0,0
1683633482232,TDGE 25,A00,189294,Staff,2,0,20,18
1683633483259,TDGE 124,A00,189318,Fulton; Julia,0,8,50,50
1683633484283,TDGE 125,A00,189319,Staff,13,0,25,12
1683633484283,TDGE 125,B00,189320,Staff,23,0,25,2
1683633485310,TDGE 127,A00,189322,Havis; Allan,0,0,50,50
1683633486337,TDHT 101,A00,189323,Staff,18,0,25,7
1683633486337,TDHT 101,B00,189324,Staff,25,0,25,0
1683633487366,TDHT 102,A00,189325,Staff,49,0,50,1
1683633488397,TDMV 1,A00,189295,Arcidiacono; Kristin,20,0,30,10
1683633488397,TDMV 1,B00,189296,Caligagan; Maria T.,24,0,30,6
1683633489426,TDMV 2,A00,189297,Sammartano; Tonnie,27,0,30,3
1683633489426,TDMV 2,B00,189299,Arcidiacono; Kristin,23,0,30,7
1683633490457,TDMV 3,A00,204998,Rincon; Alicia,22,0,30,8
1683633491486,TDMV 120,A00,189458,Sammartano; Tonnie,28,0,30,2
1683633492512,TDMV 138,A00,189541,Jun; Grace Shin Hae,20,0,40,20
1683633493543,TDMV 142,A00,189717,Caligagan; Tony,25,0,30,5
1683633493543,TDMV 142,B00,189718,Caligagan; Maria T.,25,0,30,5
1683633494571,TMC 2,A01,187533,Staff,25,0,25,0
1683633494571,TMC 2,A02,187534,Staff,25,0,25,0
1683633495599,USP 1,A01,187536,Kwak; Nancy,0,16,25,25
1683633496627,USP 5,A01,187538,Staff,9,0,25,16
1683633497655,USP 101,A00,199253,Staff,0,4,0,0
1683633498681,USP 124,A00,187562,Boomhower; Matthew Charles,0,0,30,30
1683633499706,USP 138,A00,187582,Staff,20,0,25,5
1683633500732,USP 152,A01,187597,Staff,3,0,25,22
1683633501760,USP 153,A00,187598,Staff,19,0,25,6
1683633502785,USP 168,A00,187607,Kwak; Nancy,2,0,5,3
1683633503816,USP 173,A00,187619,Staff,4,0,25,21
1683633504842,USP 181,A00,187638,Staff,0,4,25,25
1683633505873,VIS 103,A00,187650,Cruz; Edwin Teddy,18,0,75,57
1683633506899,VIS 110D,A00,187669,Staff,13,0,22,9
1683633507927,VIS 127C,A00,187720,Shen; Kuiyi,67,0,146,79
1683633508953,VIS 149,A00,187731,Yoldas; Pinar,0,14,22,22
1683633509984,VIS 151,A01,188091,Staff,22,0,34,12
1683633509984,VIS 151,A02,188092,Staff,11,0,34,23
1683633511010,VIS 160B,A00,188093,Stalbaum; Brett,0,1,10,10
1683633513069,WCWP 10B,A00,201720,Staff,10,0,15,5
1683633513069,WCWP 10B,B00,201722,Staff,9,0,15,6
1683633514095,WCWP 100,A00,201725,Gagnon; Jeffrey C,0,0,2,2
1683633514095,WCWP 100,B00,201727,Staff,0,4,15,15
1683633517255,ANBI 133,A00,258401,Wilder; Linnea Lorene,34,0,40,6
1683633518282,ANBI 140,A00,258395,Hrvoj Mihic; Branka,18,0,25,7
1683633519307,ANSC 120,A00,258402,Bialecki; Jon Anthony,27,0,40,13
1683633520333,ANSC 144,A00,258400,Staff,12,0,40,28
1683633522387,ANSC 166,A00,258396,Parish; Steven Martin,156,0,175,19
1683633523413,ANSC 180,A00,193533,Staff,8,0,20,12
1683633524442,ANSC 188,A00,258397,Jassal; Aftab,34,0,40,6
1683633525471,ANTH 3,A01,258316,Staff,23,0,30,7
1683633526501,ANTH 5,A00,258394,Semendeferi; Ekaterini,16,0,20,4
1683633527529,ANTH 21,A01,258331,Staff,4,0,40,36
1683633528560,ANTH 103,A00,258398,Varma; Saiba,15,0,25,10
1683633529598,AWP 10,001,202034,Staff,0,0,0,0
1683633529598,AWP 10,002,202035,Staff,0,0,0,0
1683633529598,AWP 10,003,202036,Staff,0,0,0,0
1683633529598,AWP 10,004,202037,Staff,0,0,0,0
1683633529598,AWP 10,005,202038,Staff,0,0,0,0
1683633529598,AWP 10,006,202039,Staff,0,0,0,0
1683633529598,AWP 10,007,202040,Staff,0,0,0,0
1683633529598,AWP 10,008,202041,Staff,0,0,0,0
1683633529598,AWP 10,009,202042,Staff,0,0,0,0
1683633529598,AWP 10,010,202043,Staff,0,0,0,0
1683633529598,AWP 10,011,202044,Staff,0,0,0,0
1683633529598,AWP 10,012,202045,Staff,0,0,0,0
1683633529598,AWP 10,013,202046,Staff,0,0,0,0
1683633529598,AWP 10,014,202047,Staff,0,0,0,0
1683633529598,AWP 10,015,202048,Staff,0,0,0,0
1683633529598,AWP 10,016,202049,Staff,0,0,0,0
1683633529598,AWP 10,017,202050,Staff,0,0,0,0
1683633529598,AWP 10,018,202051,Staff,0,0,0,0
1683633529598,AWP 10,019,202052,Staff,0,0,0,0
1683633529598,AWP 10,020,202053,Staff,0,0,0,0
1683633529598,AWP 10,021,202054,Staff,0,0,0,0
1683633529598,AWP 10,022,202055,Staff,0,0,0,0
1683633529598,AWP 10,023,202056,Staff,0,0,0,0
1683633529598,AWP 10,024,202057,Staff,0,0,0,0
1683633529598,AWP 10,025,202058,Staff,0,0,0,0
1683633529598,AWP 10,026,202059,Staff,0,0,0,0
1683633530626,AWP 102,001,202032,Staff,0,0,0,0
1683633530626,AWP 102,002,202033,Staff,0,0,0,0
1683633531653,BENG 100,A01,254234,Taylor Amos; Alyssa C,31,0,40,9
1683633532680,BENG 196,001,270013,Engler; Adam J.,9999,0,9999,0
1683633533710,BICD 100R,A01,202018,Smith; Laurie,0,7,32,32
1683633533710,BICD 100R,A02,202019,Smith; Laurie,0,3,32,32
1683633533710,BICD 100R,A03,202020,Smith; Laurie,0,1,32,32
1683633533710,BICD 100R,A04,202021,Smith; Laurie,6,0,32,26
1683633533710,BICD 100R,A05,202022,Smith; Laurie,11,0,32,21
1683633534738,BICD 136,A01,193242,Gustafson-Brown; Cindy,0,2,32,32
1683633534738,BICD 136,A02,193244,Gustafson-Brown; Cindy,13,0,32,19
1683633535775,BIEB 102,A01,193249,Butler; Shannon Rhey,0,2,32,32
1683633535775,BIEB 102,A02,193251,Butler; Shannon Rhey,0,0,32,32
1683633535775,BIEB 102,A03,193253,Butler; Shannon Rhey,0,0,32,32
1683633535775,BIEB 102,A04,193255,Butler; Shannon Rhey,14,0,32,18
1683633535775,BIEB 102,A05,193265,Butler; Shannon Rhey,26,0,32,6
1683633535775,BIEB 102,A06,193269,Butler; Shannon Rhey,14,0,32,18
1683633537831,BIEB 150,A01,193274,Staff,0,0,32,32
1683633537831,BIEB 150,A02,193285,Staff,24,0,32,8
1683633538862,BIEB 194,A00,193286,Kurle; Carolyn M.,20,0,32,12
1683633539897,BILD 1,A01,192291,Staff,15,0,32,17
1683633539897,BILD 1,A02,192292,Staff,30,0,32,2
1683633539897,BILD 1,B01,192520,Reuther; Keefe,0,1,0,0
1683633539897,BILD 1,B02,192532,Reuther; Keefe,0,1,0,0
1683633540930,BILD 3,A01,192556,Butler; Shannon Rhey,0,0,32,32
1683633540930,BILD 3,A02,192581,Butler; Shannon Rhey,1,0,32,31
1683633540930,BILD 3,A03,192611,Butler; Shannon Rhey,21,0,32,11
1683633540930,BILD 3,A04,192612,Butler; Shannon Rhey,24,0,32,8
1683633540930,BILD 3,A05,192613,Butler; Shannon Rhey,26,0,32,6
1683633540930,BILD 3,A06,192679,Butler; Shannon Rhey,27,0,32,5
1683633540930,BILD 3,A07,192682,Butler; Shannon Rhey,20,0,32,12
1683633541954,BILD 4,A01,192836,Reuther; Keefe,0,0,24,24
1683633541954,BILD 4,A02,193044,Reuther; Keefe,4,0,24,20
1683633542985,BILD 10,A01,193142,Gustafson-Brown; Cindy,29,0,32,3
1683633542985,BILD 10,A02,193149,Gustafson-Brown; Cindy,31,0,32,1
1683633544012,BIMM 100,A01,193301,Staff,0,6,32,32
1683633544012,BIMM 100,A02,193312,Staff,0,7,32,32
1683633544012,BIMM 100,A03,193323,Staff,0,9,32,32
1683633545045,BIMM 101,A01,193329,McDonnell; Lisa Marie,0,4,24,24
1683633545045,BIMM 101,A02,193339,McDonnell; Lisa Marie,0,3,24,24
1683633545045,BIMM 101,B01,193354,McDonnell; Lisa Marie,0,4,24,24
1683633545045,BIMM 101,B02,193357,McDonnell; Lisa Marie,0,2,24,24
1683633546131,BIMM 110,A01,193377,Tat; John,0,11,32,32
1683633546131,BIMM 110,A02,193378,Tat; John,0,10,32,32
1683633547166,BIMM 120,A01,206116,Staff,0,0,32,32
1683633547166,BIMM 120,A02,206117,Staff,6,0,32,26
1683633547166,BIMM 120,A03,206121,Staff,21,0,32,11
1683633548199,BIPN 100,A01,193393,Park; Ji Young,0,14,32,32
1683633548199,BIPN 100,A02,193402,Park; Ji Young,0,14,32,32
1683633548199,BIPN 100,A03,193413,Park; Ji Young,0,14,32,32
1683633548199,BIPN 100,A04,193414,Park; Ji Young,0,13,32,32
1683633549238,BIPN 102,A01,193429,Staff,0,0,32,32
1683633549238,BIPN 102,A02,193438,Staff,18,0,32,14
1683633550264,BIPN 106,A01,193450,Reyes Gonzalez; Catalina,0,2,40,40
1683633551292,BIPN 134,A01,193465,Cooke; James Edward,0,0,32,32
1683633551292,BIPN 134,A02,193474,Cooke; James Edward,25,0,32,7
1683633551292,BIPN 134,A03,193485,Cooke; James Edward,29,0,32,3
1683633551292,BIPN 134,A04,193486,Cooke; James Edward,20,0,32,12
1683633551292,BIPN 134,A05,193491,Cooke; James Edward,31,0,32,1
1683633551292,BIPN 134,A06,193501,Cooke; James Edward,30,0,32,2
1683633551292,BIPN 134,A07,193510,Cooke; James Edward,29,0,32,3
1683633553343,BISP 194,A00,222522,Staff,14,0,32,18
1683633554369,CAT 124,A01,202407,Staff,19,0,25,6
1683633555396,CAT 125,A00,202408,Marchisotto; Jennifer Anne,2,0,20,18
1683633556421,CAT 125R,A00,202409,Smith; Lauryn Alissa,0,11,20,20
1683633556421,CAT 125R,B00,202410,Morales; Celeste Georgianna,0,11,20,20
1683633556421,CAT 125R,C00,202411,Irwin; Matthew Joseph,0,12,20,20
1683633557455,CENG 15,A01,204712,Yang; Kesong,0,1,0,0
1683633558481,CENG 114,A00,202070,Jahed Motlagh; Zeinab,5,0,20,15
1683633559508,CGS 105,A00,185477,Wesling; Megan E.,24,0,40,16
1683633560534,CGS 106,A00,185494,Staff,11,0,22,11
1683633561562,CGS 108,A00,185495,Staff,14,0,20,6
1683633562588,CGS 114,A00,185496,Staff,13,0,18,5
1683633563617,CGS 119,A00,185501,Staff,15,0,20,5
1683633564647,CGS 120,A00,185511,Staff,12,0,20,8
1683633565683,CHEM 4,A01,184675,Bussey; Thomas J,97,0,100,3
1683633566710,CHEM 6A,A01,184677,Staff,33,0,60,27
1683633567738,CHEM 6B,A01,184679,Staff,63,0,100,37
1683633568766,CHEM 6C,A01,184681,Bussey; Thomas J,0,0,50,50
1683633568766,CHEM 6C,A02,184682,Bussey; Thomas J,32,0,50,18
1683633569793,CHEM 40A,A01,184684,Albizati; Kim F.,35,0,100,65
1683633570818,CHEM 40B,A01,184686,Albizati; Kim F.,0,22,100,100
1683633571846,CHEM 41B,A01,184690,Staff,51,0,100,49
1683633572873,COGS 3,A01,184715,Boyle; Mary E. T.,0,27,40,40
1683633573901,COGS 14B,A01,185172,Staff,0,14,38,38
1683633574926,COGS 18,A01,184736,Staff,15,0,80,65
1683633575958,COGS 100,A01,184932,Staff,0,7,73,73
1683633576987,COGS 101A,A01,184935,Staff,0,39,30,30
1683633578012,COGS 101B,A01,184944,Staff,0,2,30,30
1683633579044,COGS 101C,A01,184946,Staff,0,10,30,30
1683633580074,COGS 102A,A01,184951,Johnson; Christine M.,2,0,40,38
1683633581105,COGS 107B,A01,184953,Mooshagian; Eric Frederick,0,51,40,40
1683633582133,COGS 118B,A01,184959,Gupta; Anjum,0,49,40,40
1683633583158,COGS 153,A00,184961,Staff,0,16,30,30
1683633584183,COGS 177,A00,184962,Staff,0,21,30,30
1683633585210,COGS 187A,A01,184969,Boyle; Mary E. T.,0,19,40,40
1683633586239,COMM 10,A01,185174,Staff,0,5,25,25
1683633586239,COMM 10,A02,185189,Staff,0,2,25,25
1683633586239,COMM 10,A03,269821,Staff,0,1,0,0
1683633587270,COMM 100B,A01,185475,Staff,0,1,0,2
1683633587270,COMM 100B,A02,185476,Staff,12,0,25,13
1683633588300,COMM 100C,A01,185314,Staff,1,0,25,24
1683633588300,COMM 100C,A02,185327,Staff,18,0,25,7
1683633589331,COMM 110M,A00,185349,Staff,0,0,40,40
1683633590357,COMM 113T,A00,185352,Staff,25,0,40,15
1683633591384,COMM 114I,A00,185353,Staff,31,0,40,9
1683633592412,COMM 131,A00,185354,Staff,17,0,30,13
1683633593442,CSE 8A,A50,185358,Cao; Yingjun,0,46,10,10
1683633594469,CSE 8B,A01,185362,Staff,0,48,50,50
1683633595496,CSE 11,A01,185416,Cao; Yingjun,0,91,10,10
1683633596525,CSE 20,A01,185445,Briones; Jor-el Thomas Caparas,4,0,25,21
1683633597552,CSE 21,A01,185447,Staff,9,0,50,41
1683633598579,CSE 101,A01,185451,Staff,0,13,50,50
1683633598579,CSE 101,B01,185453,Jones; Miles E,0,13,50,50
1683633600640,CSE 141,A01,185458,Eldon; John,15,0,100,85
1683633601666,CSE 141L,A01,185461,Eldon; John,7,0,100,93
1683633602695,CSE 142,A01,185463,Staff,36,0,60,24
1683633602695,CSE 142,B01,201355,Staff,0,7,60,60
1683633603726,CSE 142L,A01,185470,Staff,36,0,60,24
1683633603726,CSE 142L,B01,201417,Staff,0,6,60,60
1683633604755,CSE 190,A00,201433,Staff,32,0,49,17
1683633605783,DOC 1,A01,259136,Strom; Megan C.,7,0,15,8
1683633605783,DOC 1,A02,259137,Strom; Megan C.,14,0,15,1
1683633605783,DOC 1,A03,259138,Strom; Megan C.,14,0,15,1
1683633605783,DOC 1,A04,259139,Strom; Megan C.,14,0,15,1
1683633606812,DOC 100D,A00,259140,Pass; Natalye Joann,14,0,25,11
1683633607839,DSGN 1,A01,184749,Rill; Bryan,0,26,30,30
1683633608866,DSGN 100,A01,185168,Staff,0,2,25,25
1683633609892,ECE 5,A01,185626,Morris; Karcher William,0,11,0,0
1683633610921,ECE 101,A01,185628,Staff,14,0,70,56
1683633611949,ECE 107,A01,185635,Baghdadchi; Saharnaz,0,0,20,20
1683633611949,ECE 107,A02,185638,Baghdadchi; Saharnaz,3,0,20,17
1683633612981,ECE 148,A01,185647,Silberman; Jack,0,0,16,16
1683633614007,ECON 1,A01,185537,Crane; Meredith Helen,54,0,70,16
1683633615034,ECON 3,A01,185549,Crane; Meredith Helen,29,0,70,41
1683633616061,ECON 4,A01,203354,Anderson; John Charles,0,5,10,10
1683633617085,ECON 100A,A01,185574,Staff,0,5,40,40
1683633618111,ECON 100B,A01,185576,Staff,0,12,50,50
1683633619135,ECON 100C,A01,185589,Newhouse; Herbert S,30,0,70,40
1683633620164,ECON 105,A00,185608,Vespa; Emanuel Ignacio,19,0,35,16
1683633621194,ECON 109,A01,185610,Shishkin; Denis,9,0,35,26
1683633622219,ECON 110A,A01,185612,Staff,9,0,40,31
1683633623251,ECON 120A,A01,185615,Staff,20,0,40,20
1683633624277,ECON 120C,A01,185617,Sun; Yixiao,0,20,70,70
1683633625303,ECON 144,A00,203346,Squires; Dale E,2,0,35,33
1683633626333,ECON 171,A01,203349,Newhouse; Herbert S,0,1,35,35
1683633627362,ECON 173A,A01,185621,Toda; Alexis Akira,21,0,35,14
1683633628388,EDS 25,A01,202413,Staff,0,1,0,0
1683633628388,EDS 25,A02,202414,Staff,0,1,0,0
1683633628388,EDS 25,A03,202415,Staff,0,0,0,0
1683633628388,EDS 25,A04,202416,Staff,0,1,0,0
1683633628388,EDS 25,A05,202439,Staff,0,0,0,0
1683633628388,EDS 25,A06,202440,Staff,0,0,0,0
1683633628388,EDS 25,B01,202631,Staff,0,0,0,0
1683633628388,EDS 25,B02,202632,Staff,0,0,0,0
1683633628388,EDS 25,B03,202639,Staff,0,0,0,0
1683633628388,EDS 25,B04,202640,Staff,0,0,0,0
1683633628388,EDS 25,B05,202643,Staff,0,0,0,0
1683633628388,EDS 25,B06,202644,Staff,0,0,0,0
1683633629417,EDS 38,A01,202659,Black; Alison Michelle,24,0,25,1
1683633630443,EDS 115,A00,202652,Staff,18,0,30,12
1683633631469,EDS 125,A00,202649,Staff,13,0,30,17
1683633632494,EDS 126,A01,203332,Staff,30,0,30,0
1683633633519,EDS 139,A00,202838,Staff,16,0,25,9
1683633634548,EDS 146,A01,202655,Staff,14,0,25,11
1683633635577,ENG 15,A00,185667,Staff,0,1,0,0
1683633635577,ENG 15,B00,185672,Staff,0,0,0,0
1683633635577,ENG 15,C00,185675,Staff,0,0,0,0
1683633635577,ENG 15,D00,185682,Staff,0,0,0,0
1683633635577,ENG 15,E00,185684,Staff,0,0,0,0
1683633636604,ETHN 103,A00,185710,Staff,0,8,35,35
1683633637633,ETHN 103A,A00,199228,Man; Simeon S,0,0,9,9
1683633638660,ETHN 109,A00,185711,Staff,16,0,35,19
1683633639692,ETHN 142,A00,185726,Staff,0,4,30,30
1683633640719,ETHN 163J,A00,199229,Man; Simeon S,5,0,8,3
1683633641746,ETHN 168,A00,185727,Staff,7,0,10,3
1683633642778,ETHN 182,A00,185728,Staff,0,0,35,35
1683633643811,ETHN 183,A00,185737,Staff,9,0,18,9
1683633644837,GLBH 111,A01,209361,Burgos; Jose L.,0,0,0,0
1683633646890,HIEU 104,A00,185792,Staff,14,0,20,6
1683633647916,HIEU 115,A00,185800,Staff,0,0,20,20
1683633648946,HIEU 128,A00,185801,Staff,0,9,20,20
1683633650035,HIEU 147,A00,185802,Staff,15,0,20,5
1683633651062,HIEU 154,A00,185823,Staff,11,0,20,9
1683633652090,HILA 102,A00,185826,Staff,14,0,20,6
1683633653117,HILD 2C,A01,185778,Staff,0,13,20,20
1683633654147,HILD 7B,A01,185780,Kwak; Nancy,0,16,32,32
1683633654147,HILD 7B,A02,185781,Kwak; Nancy,0,18,32,32
1683633655172,HILD 30,A01,185791,Staff,12,0,20,8
1683633656201,HISC 119,A00,185830,Golan; Tal,0,9,20,20
1683633657230,HITO 156GS,A00,185831,Patterson; Patrick H.,0,0,0,23
1683633658255,HIUS 103,A00,185832,Man; Simeon S,0,4,20,20
1683633659282,HIUS 117,A00,185836,Kwak; Nancy,2,0,20,18
1683633660311,HIUS 125,A00,185840,Man; Simeon S,0,1,23,23
1683633661334,HIUS 149,A00,185845,Staff,1,0,20,19
1683633662368,HUM 3,A01,185882,Zavodny; Tatiana Sophia,0,7,50,50
1683633662368,HUM 3,B01,185899,Caldwell; Michael Alan,0,18,50,50
1683633663403,HUM 3GS,A00,185900,Patterson; Patrick H.,0,0,0,23
1683633664430,HUM 4,A01,185938,Zroka; Amy Liane,30,0,50,20
1683633664430,HUM 4,B01,185956,Watkins; Eric,0,4,50,50
1683633664430,HUM 4,B02,202209,Watkins; Eric,0,4,50,50
1683633664430,HUM 4,B03,202210,Watkins; Eric,0,4,50,50
1683633665462,HUM 5,A01,185958,West; Geoffrey Scott,2,0,50,48
1683633665462,HUM 5,A02,202215,West; Geoffrey Scott,0,0,50,50
1683633666492,INTL 190,A00,185959,Gagnon; Jeffrey C,0,0,0,9
1683633666492,INTL 190,B00,185960,Lettieri; Michael Joseph,0,0,0,2
1683633667519,JAPN 180,A00,254509,Staff,5,0,30,25
1683633668553,LATI 10,A01,202853,Kennemore; Amy Michelle,4,0,35,31
1683633668553,LATI 10,A02,202854,Kennemore; Amy Michelle,2,0,35,33
1683633668553,LATI 10,A03,270054,Kennemore; Amy Michelle,30,0,30,0
1683633669579,LATI 180,A00,202855,Kennemore; Amy Michelle,11,0,20,9
1683633670609,LAWS 101,A00,201767,Golan; Tal,0,7,40,40
1683633671638,LIFR 1C,A00,185961,Staff,6,0,20,14
1683633672671,LIFR 1CX,A00,185962,Staff,7,0,20,13
1683633673703,LIFR 1D,A00,185963,Staff,7,0,20,13
1683633674730,LIFR 1DX,A00,185964,Staff,7,0,20,13
1683633675757,LIGN 101,A01,186039,Staff,43,0,50,7
1683633676784,LIGN 165,A00,186040,Staff,15,0,50,35
1683633677811,LTCS 108,A00,186041,Staff,5,0,10,5
1683633678838,LTCS 119,A00,186042,Staff,15,0,20,5
1683633679870,LTCS 130,A00,186043,Wesling; Megan E.,15,0,25,10
1683633681922,LTEA 138,A00,186119,Staff,14,0,40,26
1683633682947,LTEN 124,A00,186148,Staff,6,0,25,19
1683633683974,LTEN 178,A00,186149,Staff,7,0,15,8
1683633685000,LTEN 181,A00,186150,Blanco; John D,34,0,40,6
1683633686029,LTWL 120,A00,186160,Staff,20,0,25,5
1683633687067,LTWL 165,A00,186161,Staff,22,0,25,3
1683633688091,LTWR 100,A00,186162,Staff,0,5,15,15
1683633689119,LTWR 102,A00,186163,Doller; Ben,5,0,15,10
1683633690151,MAE 8,A01,186412,Staff,0,0,0,0
1683633691178,MAE 30B,A00,186445,Bahadori; Mohammad Yousef,82,0,100,18
1683633692207,MAE 40,A00,186592,Bewley; Thomas R,10,0,50,40
1683633693236,MAE 101B,A00,186593,Bahadori; Mohammad Yousef,80,0,100,20
1683633694266,MAE 105,A00,186594,Bandaru; Prabhakar,10,0,50,40
1683633695298,MAE 107,A00,186599,Pham; Hieu Tan,0,7,120,120
1683633696323,MAE 148,A01,186660,Silberman; Jack,3,0,16,13
1683633697350,MATH 10A,A01,188095,Staff,0,5,35,35
1683633698383,MATH 10B,A01,188097,Bowers; Adam R.,0,11,30,30
1683633698383,MATH 10B,A02,188099,Bowers; Adam R.,0,11,30,30
1683633698383,MATH 10B,B01,188104,Bowers; Adam R.,0,10,30,30
1683633698383,MATH 10B,B02,188106,Bowers; Adam R.,1,9,30,29
1683633699412,MATH 10C,A01,188111,Staff,0,18,30,30
1683633699412,MATH 10C,A02,188127,Staff,0,19,30,30
1683633699412,MATH 10C,A03,188131,Staff,0,19,30,30
1683633699412,MATH 10C,B01,188218,Staff,17,0,30,13
1683633699412,MATH 10C,B02,188244,Staff,13,0,30,17
1683633699412,MATH 10C,B03,188277,Staff,14,0,30,16
1683633700444,MATH 18,A01,188344,Bach; Quang Tran,18,0,30,12
1683633700444,MATH 18,A02,188345,Bach; Quang Tran,11,0,30,19
1683633700444,MATH 18,B01,188353,Bach; Quang Tran,11,0,30,19
1683633700444,MATH 18,B02,188354,Bach; Quang Tran,19,0,30,11
1683633701475,MATH 20A,A01,188374,Staff,11,0,35,24
1683633702506,MATH 20B,A01,188382,Ohm; Ko Woon,7,0,30,23
1683633702506,MATH 20B,A02,188383,Ohm; Ko Woon,22,0,30,8
1683633702506,MATH 20B,B01,188385,Ohm; Ko Woon,7,0,30,23
1683633702506,MATH 20B,B02,188392,Ohm; Ko Woon,22,0,30,8
1683633703534,MATH 20C,A01,188394,Harel; Guershon,11,0,30,19
1683633703534,MATH 20C,A02,188395,Harel; Guershon,14,0,30,16
1683633703534,MATH 20C,B01,188404,Harel; Guershon,4,0,30,26
1683633703534,MATH 20C,B02,188405,Harel; Guershon,18,0,30,12
1683633704567,MATH 20D,A01,188414,Hammock; Frances H,0,1,30,30
1683633704567,MATH 20D,A02,188415,Hammock; Frances H,0,1,30,30
1683633704567,MATH 20D,B01,188447,Hammock; Frances H,0,1,30,30
1683633704567,MATH 20D,B02,188486,Hammock; Frances H,4,0,30,26
1683633705594,MATH 20E,A01,188649,Staff,21,0,30,9
1683633705594,MATH 20E,A02,188650,Staff,21,0,30,9
1683633705594,MATH 20E,A03,188673,Staff,0,0,30,30
1683633706620,MATH 102,A01,188675,Staff,0,36,35,35
1683633707648,MATH 103B,A01,188681,Staff,3,0,35,32
1683633707648,MATH 103B,B01,188692,Staff,5,0,35,30
1683633708674,MATH 109,A01,188695,Salehi Golsefidy; Alireza,24,0,35,11
1683633708674,MATH 109,A02,188696,Salehi Golsefidy; Alireza,25,0,35,10
1683633709706,MATH 120A,A01,188698,Eggers; John Dietrich,7,0,35,28
1683633710732,MATH 142B,A01,188736,Ioana; Adrian,0,1,30,30
1683633710732,MATH 142B,A02,188741,Ioana; Adrian,0,1,30,30
1683633710732,MATH 142B,A03,188743,Ioana; Adrian,0,1,30,30
1683633711763,MATH 168A,A01,188790,Staff,0,10,35,35
1683633712790,MATH 170A,A01,188803,Nie; Jiawang,0,2,35,35
1683633712790,MATH 170A,A02,188811,Nie; Jiawang,0,0,35,35
1683633712790,MATH 170A,A03,188814,Nie; Jiawang,0,0,35,35
1683633712790,MATH 170A,A04,188815,Nie; Jiawang,10,0,35,25
1683633713819,MATH 193B,A01,188817,Staff,0,0,35,35
1683633713819,MATH 193B,A02,188818,Staff,5,0,35,30
1683633714850,MGT 4,A01,202857,Anderson; John Charles,61,0,80,19
1683633715879,MGT 12,A00,202858,Lindenberger; Wade Douglas,40,0,90,50
1683633716910,MGT 18,A00,202859,Staff,74,0,90,16
1683633717938,MGT 18GS,A00,202860,McKay; Michael J,13,0,28,15
1683633718964,MGT 45,A00,202861,Pecore; Joseph P.,12,0,90,78
1683633719993,MGT 100,A00,202863,Yavorsky; Daniel Ryan,28,0,90,62
1683633721024,MGT 103,A00,202864,Ehrich; Kristine R,0,17,90,90
1683633722078,MGT 112,A00,202865,Ehrich; Kristine R,15,0,90,75
1683633723110,MGT 121A,A00,202868,Staff,0,20,0,0
1683633724133,MGT 131B,A00,202869,Anderson; John Charles,59,0,90,31
1683633725163,MGT 136,A00,202871,Lindenberger; Wade Douglas,83,0,90,7
1683633726189,MGT 164,A00,202873,Staff,0,66,90,91
1683633727217,MGT 164GS,A00,202874,McKay; Mary A,13,0,28,15
1683633728241,MGT 180,A00,202875,Staff,0,50,90,91
1683633729273,MMW 11R,A01,205019,Herbst; Matthew,2,0,30,28
1683633729273,MMW 11R,A02,205026,Herbst; Matthew,29,0,30,1
1683633730302,MMW 15,A01,193512,Chang; Edmond Yi-Teh,0,8,28,28
1683633730302,MMW 15,A02,193513,Chang; Edmond Yi-Teh,0,5,28,28
1683633730302,MMW 15,A03,193514,Chang; Edmond Yi-Teh,0,5,28,28
1683633730302,MMW 15,A04,193515,Chang; Edmond Yi-Teh,0,5,28,28
1683633730302,MMW 15,A05,193516,Chang; Edmond Yi-Teh,0,5,28,28
1683633730302,MMW 15,A06,193517,Chang; Edmond Yi-Teh,0,6,28,28
1683633730302,MMW 15,B01,193519,Chang; Edmond Yi-Teh,0,5,28,28
1683633730302,MMW 15,B02,193520,Chang; Edmond Yi-Teh,0,5,28,28
1683633730302,MMW 15,B03,193521,Chang; Edmond Yi-Teh,0,5,28,28
1683633730302,MMW 15,B04,193522,Chang; Edmond Yi-Teh,0,5,28,28
1683633730302,MMW 15,B05,193523,Chang; Edmond Yi-Teh,0,5,28,28
1683633730302,MMW 15,B06,193524,Chang; Edmond Yi-Teh,0,5,28,28
1683633731331,MMW 122,A01,193526,Rahimi; Babak,0,16,28,28
1683633731331,MMW 122,A02,193527,Rahimi; Babak,0,15,28,28
1683633731331,MMW 122,A03,193528,Rahimi; Babak,0,0,0,0
1683633731331,MMW 122,A04,193529,Rahimi; Babak,0,0,0,0
1683633732357,MUS 1A,A01,186663,Staff,1,20,35,34
1683633733382,MUS 4,A01,186715,Staff,0,12,35,35
1683633734409,MUS 5R,A01,186796,Dubnov; Shlomo,0,17,35,35
1683633735437,MUS 6,A01,186798,Staff,0,5,25,25
1683633736465,MUS 7,A01,186830,Staff,11,0,35,24
1683633737495,MUS 8,A01,186930,Staff,0,26,35,35
1683633738520,MUS 15,A01,186932,Staff,0,16,35,35
1683633738520,MUS 15,B01,186934,Staff,0,17,35,35
1683633739547,MUS 80,A00,186935,Staff,0,0,20,20
1683633739547,MUS 80,B00,186936,Staff,24,0,25,1
1683633740575,NANO 11,A00,204702,Lipomi; Darren John,0,0,0,0
1683633741610,NANO 15,A01,204709,Yang; Kesong,0,1,0,0
1683633742639,NANO 114,A00,202069,Jahed Motlagh; Zeinab,3,0,10,7
1683633743674,PHIL 1,A00,186955,Grush; Rick Scott,31,0,40,9
1683633744703,PHIL 10,A01,186973,Grush; Rick Scott,27,0,35,8
1683633744703,PHIL 10,A02,186974,Grush; Rick Scott,33,0,35,2
1683633745729,PHIL 13,A01,186976,Staff,3,0,35,32
1683633745729,PHIL 13,A02,186977,Staff,16,0,35,19
1683633746755,PHIL 14,A01,186979,Staff,31,0,35,4
1683633746755,PHIL 14,A02,186986,Staff,32,0,35,3
1683633747784,PHIL 28,A01,186988,Staff,16,0,30,14
1683633747784,PHIL 28,A02,186989,Staff,1,0,30,29
1683633747784,PHIL 28,A03,186990,Staff,10,0,30,20
1683633747784,PHIL 28,A04,186991,Staff,26,0,30,4
1683633748810,PHIL 120,A00,186997,Staff,23,0,40,17
1683633749840,PHIL 137,A00,187003,Staff,7,0,40,33
1683633750870,PHIL 150,A00,187015,Staff,47,0,70,23
1683633751896,PHIL 167,A00,187021,Lamey; Andy M.,34,0,40,6
1683633752927,PHIL 174,A01,202226,Staff,17,0,20,3
1683633752927,PHIL 174,A02,202235,Staff,20,0,20,0
1683633754027,PHIL 191A,A00,258918,Staff,0,0,1,1
1683633755059,PHYS 1A,A00,187028,Staff,27,0,60,33
1683633756092,PHYS 1AL,001,187036,Staff,3,0,30,27
1683633756092,PHYS 1AL,002,187049,Staff,18,0,30,12
1683633757121,PHYS 1B,A00,187058,Staff,22,0,60,38
1683633758147,PHYS 1BL,001,187064,Staff,0,1,30,30
1683633758147,PHYS 1BL,002,187070,Staff,4,0,30,26
1683633759176,PHYS 1C,A00,187082,Staff,29,0,120,91
1683633760205,PHYS 1CL,001,187088,Staff,0,9,30,30
1683633760205,PHYS 1CL,002,187089,Staff,0,1,30,30
1683633760205,PHYS 1CL,009,262693,Staff,9,0,30,21
1683633761237,PHYS 2B,A01,187097,Staff,55,0,115,60
1683633762263,PHYS 2C,A01,187099,Staff,64,0,115,51
1683633763293,PHYS 2CL,A01,187101,Staff,5,0,28,23
1683633763293,PHYS 2CL,A02,187102,Staff,15,0,28,13
1683633764320,PHYS 2D,A01,187123,Shotwell; Brian,95,0,115,20
1683633765349,PHYS 4B,A01,187133,Grinstein; Benjamin,35,0,50,15
1683633766375,POLI 10,A00,188819,Staff,0,4,50,50
1683633767400,POLI 11,A00,188827,Staff,43,0,50,7
1683633768430,POLI 13R,A00,188828,Staff,0,1,20,20
1683633769458,POLI 27,A01,188830,Elgin; Samuel Zincke,0,2,70,70
1683633770489,POLI 30,A00,188832,Desposato; Scott,30,0,50,20
1683633771515,POLI 102F,A00,188834,Staff,0,0,40,40
1683633772541,POLI 104A,A00,188852,Staff,13,0,30,17
1683633773567,POLI 104I,A00,188853,Staff,0,7,20,20
1683633774595,POLI 110B,A00,188854,Wiens; David,7,0,20,13
1683633775620,POLI 112A,A00,188855,Wiens; David,4,0,30,26
1683633776646,POLI 117R,A00,188856,Forman; Fonna,0,12,20,20
1683633777677,POLI 118,A00,188857,Ingham; Sean,8,0,20,12
1683633778710,POLI 120G,A00,188858,Staff,8,0,30,22
1683633779736,POLI 131CR,A00,188863,Hoston; Germaine,21,0,50,29
1683633780760,POLI 133,A00,188864,Nellis; Gareth Hb,44,0,50,6
1683633781786,POLI 134D,A00,188865,Desposato; Scott,27,0,30,3
1683633782813,POLI 142A,A00,188871,Gartzke; Erik,21,0,50,29
1683633783843,POLI 142K,A00,188874,Staff,38,0,50,12
1683633784868,POLI 143,A00,188940,Gartzke; Erik,16,0,30,14
1683633785900,POLI 153,A00,188943,Staff,2,0,20,18
1683633786924,POLI 160AA,A00,188944,Staff,11,0,40,29
1683633787954,POLI 170A,A00,188945,Staff,11,0,30,19
1683633790009,PSYC 1,A00,188952,Staff,36,0,90,54
1683633791035,PSYC 2,B00,188953,Staff,19,0,35,16
1683633792060,PSYC 6,A00,188970,Staff,47,0,60,13
1683633793086,PSYC 7,A00,188973,Staff,35,0,45,10
1683633794112,PSYC 60,A01,188980,Rickard; Timothy C.,42,0,60,18
1683633795152,PSYC 70,A01,189001,Steiner; Eric Tomas,23,0,45,22
1683633796182,PSYC 100,A00,189005,Lacefield; Katharine I,0,99,120,120
1683633797208,PSYC 102,A00,189008,Staff,8,0,30,22
1683633798239,PSYC 106,B00,189026,Gorman; Michael R.,27,0,60,33
1683633799290,PSYC 114,B01,189033,Winkielman; Piotr,0,31,30,30
1683633800315,PSYC 131,A00,189036,Anagnostaras; Stephan,0,43,60,60
1683633801347,PSYC 136,A00,189041,Lowe; Angela Beth,0,7,25,25
1683633802374,PSYC 137,A00,189057,Winkielman; Piotr,0,37,25,25
1683633803400,PSYC 144,A00,189107,Wixted; John T,0,10,50,50
1683633805452,PSYC 162,A00,189142,Staff,0,9,85,85
1683633806483,PSYC 172,A00,189144,Gorman; Michael R.,0,6,30,30
1683633808544,PSYC 179,A00,189146,Lacefield; Katharine I,0,86,120,120
1683633809568,PSYC 181,A00,189147,Anagnostaras; Stephan,0,44,90,90
1683633810592,PSYC 190R,A00,189148,Barner; David A.,0,23,80,80
1683633811622,PSYC 191,A00,189275,Rickard; Timothy C.,0,10,25,25
1683633812654,PSYC 193,A00,189276,Chapman; Eddie Nathaniel,0,1,0,4
1683633813678,PSYC 193L,A01,189281,Lowe; Angela Beth,10,0,20,10
1683633813678,PSYC 193L,B01,189285,Staff,28,0,35,7
1683633814705,RELI 149,A00,187137,Rahimi; Babak,7,0,40,33
1683633815739,SE 9,A01,187315,Staff,0,2,18,18
1683633816764,SE 101B,A00,187409,Staff,24,0,30,6
1683633817795,SE 110B,A00,187444,Staff,10,0,40,30
1683633818831,SE 130B,A00,187449,Staff,31,0,40,9
1683633819862,SE 150A,A00,187516,Staff,9,0,20,11
1683633820888,SE 154,A00,187528,Staff,29,0,50,21
1683633821916,SIO 3,A01,258171,Staff,35,0,40,5
1683633822953,SIO 10,A00,187144,Cook; Geoffrey W,0,6,75,75
1683633823979,SIO 45,A00,187152,Cook; Geoffrey W,0,4,100,100
1683633825005,SIO 109R,A00,194486,Staff,0,4,20,20
1683633827062,SIO 187,A01,187233,Kacev; David,12,0,40,28
1683633828089,SOCI 1,A01,258656,Thorpe; Charles Robert,28,0,30,2
1683633828089,SOCI 1,A02,258658,Thorpe; Charles Robert,30,0,30,0
1683633828089,SOCI 1,A03,258661,Thorpe; Charles Robert,25,0,25,0
1683633828089,SOCI 1,A04,258666,Thorpe; Charles Robert,22,0,25,3
1683633828089,SOCI 1,A05,258897,Thorpe; Charles Robert,22,0,25,3
1683633828089,SOCI 1,A06,258898,Thorpe; Charles Robert,25,0,25,0
1683633829122,SOCI 30,A01,258903,Pardo Guerra; Juan Pablo,14,0,30,16
1683633830153,SOCI 102,A00,258904,Staff,9,0,25,16
1683633831178,SOCI 106,A00,258905,Staff,19,0,25,6
1683633832206,SOCI 111,A00,258907,Ribas Norris; Janet Vanesa,26,0,30,4
1683633833238,SOCI 121R,A00,258908,Pardo Guerra; Juan Pablo,8,0,30,22
1683633834263,SOCI 126,A01,203330,Staff,14,0,20,6
1683633835288,SOCI 131,A00,258909,Thorpe; Charles Robert,30,0,60,30
1683633836315,SOCI 135,A00,258910,Payne; Christine Anna,0,11,30,30
1683633837341,SOCI 157,A00,258911,Staff,12,0,30,18
1683633838365,SOCI 184,A00,258912,Staff,25,0,30,5
1683633839393,SOCI 188D,A00,258913,Staff,22,0,30,8
1683633840442,SYN 2,001,187529,Staff,9,0,16,7
1683633840442,SYN 2,002,201452,Staff,0,20,16,16
1683633840442,SYN 2,003,201469,Staff,2,0,16,14
1683633841469,SYN 100,A01,187531,Staff,0,9,20,20
1683633841469,SYN 100,B01,201491,Staff,0,10,20,20
1683633842495,TDAC 1,A00,189286,Walsh; Kim C.,3,0,20,17
1683633842495,TDAC 1,B00,189287,Harting; Carla Kelso,10,0,20,10
1683633843524,TDAC 101,A00,189300,Walsh; Kim C.,16,0,20,4
1683633843524,TDAC 101,B00,189301,Harting; Carla Kelso,18,0,20,2
1683633844560,TDAC 102,A00,189304,Basso; Beatrice,14,0,20,6
1683633845591,TDAC 108,A00,189305,Staff,18,0,20,2
1683633846622,TDDE 131,A00,189310,Staff,19,0,20,1
1683633846622,TDDE 131,B00,189314,Staff,19,0,20,1
1683633846622,TDDE 131,C00,189315,Staff,48,0,50,2
1683633846622,TDDE 131,D00,189316,Staff,14,0,15,1
1683633846622,TDDE 131,E00,204841,Staff,20,0,20,0
1683633847647,TDGE 10,A00,189289,Staff,28,0,50,22
1683633847647,TDGE 10,B00,189290,Havis; Allan,0,0,50,50
1683633848674,TDGE 11,A00,189291,Fulton; Julia,0,4,50,50
1683633848674,TDGE 11,B00,189292,Staff,20,0,25,5
1683633848674,TDGE 11,C00,260270,Staff,0,0,0,0
1683633849708,TDGE 25,A00,189294,Staff,2,0,20,18
1683633850735,TDGE 124,A00,189318,Fulton; Julia,0,8,50,50
1683633851760,TDGE 125,A00,189319,Staff,13,0,25,12
1683633851760,TDGE 125,B00,189320,Staff,23,0,25,2
1683633852786,TDGE 127,A00,189322,Havis; Allan,0,0,50,50
1683633853814,TDHT 101,A00,189323,Staff,18,0,25,7
1683633853814,TDHT 101,B00,189324,Staff,25,0,25,0
1683633854840,TDHT 102,A00,189325,Staff,49,0,50,1
1683633855866,TDMV 1,A00,189295,Arcidiacono; Kristin,20,0,30,10
1683633855866,TDMV 1,B00,189296,Caligagan; Maria T.,24,0,30,6
1683633856892,TDMV 2,A00,189297,Sammartano; Tonnie,27,0,30,3
1683633856892,TDMV 2,B00,189299,Arcidiacono; Kristin,23,0,30,7
1683633857976,TDMV 3,A00,204998,Rincon; Alicia,22,0,30,8
1683633859007,TDMV 120,A00,189458,Sammartano; Tonnie,28,0,30,2
1683633860034,TDMV 138,A00,189541,Jun; Grace Shin Hae,20,0,40,20
1683633861060,TDMV 142,A00,189717,Caligagan; Tony,25,0,30,5
1683633861060,TDMV 142,B00,189718,Caligagan; Maria T.,25,0,30,5
1683633862086,TMC 2,A01,187533,Staff,25,0,25,0
1683633862086,TMC 2,A02,187534,Staff,25,0,25,0
1683633863115,USP 1,A01,187536,Kwak; Nancy,0,16,25,25
1683633864147,USP 5,A01,187538,Staff,9,0,25,16
1683633865172,USP 101,A00,199253,Staff,0,4,0,0
1683633866204,USP 124,A00,187562,Boomhower; Matthew Charles,0,0,30,30
1683633867239,USP 138,A00,187582,Staff,20,0,25,5
1683633868263,USP 152,A01,187597,Staff,3,0,25,22
1683633869287,USP 153,A00,187598,Staff,19,0,25,6
1683633870312,USP 168,A00,187607,Kwak; Nancy,2,0,5,3
1683633871341,USP 173,A00,187619,Staff,4,0,25,21
1683633872372,USP 181,A00,187638,Staff,0,4,25,25
1683633873417,VIS 103,A00,187650,Cruz; Edwin Teddy,18,0,75,57
1683633874441,VIS 110D,A00,187669,Staff,13,0,22,9
1683633875471,VIS 127C,A00,187720,Shen; Kuiyi,67,0,146,79
1683633876496,VIS 149,A00,187731,Yoldas; Pinar,0,14,22,22
1683633877521,VIS 151,A01,188091,Staff,22,0,34,12
1683633877521,VIS 151,A02,188092,Staff,11,0,34,23
1683633878549,VIS 160B,A00,188093,Stalbaum; Brett,0,1,10,10
1683633880601,WCWP 10B,A00,201720,Staff,10,0,15,5
1683633880601,WCWP 10B,B00,201722,Staff,9,0,15,6
1683633881630,WCWP 100,A00,201725,Gagnon; Jeffrey C,0,0,2,2
1683633881630,WCWP 100,B00,201727,Staff,0,4,15,15
1683633884758,ANBI 133,A00,258401,Wilder; Linnea Lorene,34,0,40,6
1683633885784,ANBI 140,A00,258395,Hrvoj Mihic; Branka,18,0,25,7
1683633886809,ANSC 120,A00,258402,Bialecki; Jon Anthony,27,0,40,13
1683633887834,ANSC 144,A00,258400,Staff,12,0,40,28
1683633889886,ANSC 166,A00,258396,Parish; Steven Martin,156,0,175,19
1683633890930,ANSC 180,A00,193533,Staff,8,0,20,12
1683633891956,ANSC 188,A00,258397,Jassal; Aftab,34,0,40,6
1683633892986,ANTH 3,A01,258316,Staff,23,0,30,7
1683633894016,ANTH 5,A00,258394,Semendeferi; Ekaterini,16,0,20,4
1683633895044,ANTH 21,A01,258331,Staff,4,0,40,36
1683633896074,ANTH 103,A00,258398,Varma; Saiba,15,0,25,10
1683633897105,AWP 10,001,202034,Staff,0,0,0,0
1683633897105,AWP 10,002,202035,Staff,0,0,0,0
1683633897105,AWP 10,003,202036,Staff,0,0,0,0
1683633897105,AWP 10,004,202037,Staff,0,0,0,0
1683633897105,AWP 10,005,202038,Staff,0,0,0,0
1683633897105,AWP 10,006,202039,Staff,0,0,0,0
1683633897105,AWP 10,007,202040,Staff,0,0,0,0
1683633897105,AWP 10,008,202041,Staff,0,0,0,0
1683633897105,AWP 10,009,202042,Staff,0,0,0,0
1683633897105,AWP 10,010,202043,Staff,0,0,0,0
1683633897105,AWP 10,011,202044,Staff,0,0,0,0
1683633897105,AWP 10,012,202045,Staff,0,0,0,0
1683633897105,AWP 10,013,202046,Staff,0,0,0,0
1683633897105,AWP 10,014,202047,Staff,0,0,0,0
1683633897105,AWP 10,015,202048,Staff,0,0,0,0
1683633897105,AWP 10,016,202049,Staff,0,0,0,0
1683633897105,AWP 10,017,202050,Staff,0,0,0,0
1683633897105,AWP 10,018,202051,Staff,0,0,0,0
1683633897105,AWP 10,019,202052,Staff,0,0,0,0
1683633897105,AWP 10,020,202053,Staff,0,0,0,0
1683633897105,AWP 10,021,202054,Staff,0,0,0,0
1683633897105,AWP 10,022,202055,Staff,0,0,0,0
1683633897105,AWP 10,023,202056,Staff,0,0,0,0
1683633897105,AWP 10,024,202057,Staff,0,0,0,0
1683633897105,AWP 10,025,202058,Staff,0,0,0,0
1683633897105,AWP 10,026,202059,Staff,0,0,0,0
1683633898133,AWP 102,001,202032,Staff,0,0,0,0
1683633898133,AWP 102,002,202033,Staff,0,0,0,0
1683633899160,BENG 100,A01,254234,Taylor Amos; Alyssa C,31,0,40,9
1683633900185,BENG 196,001,270013,Engler; Adam J.,9999,0,9999,0
1683633901220,BICD 100R,A01,202018,Smith; Laurie,0,7,32,32
1683633901220,BICD 100R,A02,202019,Smith; Laurie,0,3,32,32
1683633901220,BICD 100R,A03,202020,Smith; Laurie,0,1,32,32
1683633901220,BICD 100R,A04,202021,Smith; Laurie,6,0,32,26
1683633901220,BICD 100R,A05,202022,Smith; Laurie,11,0,32,21
1683633902249,BICD 136,A01,193242,Gustafson-Brown; Cindy,0,2,32,32
1683633902249,BICD 136,A02,193244,Gustafson-Brown; Cindy,13,0,32,19
1683633903298,BIEB 102,A01,193249,Butler; Shannon Rhey,0,2,32,32
1683633903298,BIEB 102,A02,193251,Butler; Shannon Rhey,0,0,32,32
1683633903298,BIEB 102,A03,193253,Butler; Shannon Rhey,0,0,32,32
1683633903298,BIEB 102,A04,193255,Butler; Shannon Rhey,14,0,32,18
1683633903298,BIEB 102,A05,193265,Butler; Shannon Rhey,26,0,32,6
1683633903298,BIEB 102,A06,193269,Butler; Shannon Rhey,14,0,32,18
1683633905348,BIEB 150,A01,193274,Staff,0,0,32,32
1683633905348,BIEB 150,A02,193285,Staff,24,0,32,8
1683633906382,BIEB 194,A00,193286,Kurle; Carolyn M.,20,0,32,12
1683633907410,BILD 1,A01,192291,Staff,15,0,32,17
1683633907410,BILD 1,A02,192292,Staff,30,0,32,2
1683633907410,BILD 1,B01,192520,Reuther; Keefe,0,1,0,0
1683633907410,BILD 1,B02,192532,Reuther; Keefe,0,1,0,0
1683633908445,BILD 3,A01,192556,Butler; Shannon Rhey,0,0,32,32
1683633908445,BILD 3,A02,192581,Butler; Shannon Rhey,1,0,32,31
1683633908445,BILD 3,A03,192611,Butler; Shannon Rhey,21,0,32,11
1683633908445,BILD 3,A04,192612,Butler; Shannon Rhey,24,0,32,8
1683633908445,BILD 3,A05,192613,Butler; Shannon Rhey,26,0,32,6
1683633908445,BILD 3,A06,192679,Butler; Shannon Rhey,27,0,32,5
1683633908445,BILD 3,A07,192682,Butler; Shannon Rhey,20,0,32,12
1683633909471,BILD 4,A01,192836,Reuther; Keefe,0,0,24,24
1683633909471,BILD 4,A02,193044,Reuther; Keefe,4,0,24,20
1683633910494,BILD 10,A01,193142,Gustafson-Brown; Cindy,29,0,32,3
1683633910494,BILD 10,A02,193149,Gustafson-Brown; Cindy,31,0,32,1
1683633911519,BIMM 100,A01,193301,Staff,0,6,32,32
1683633911519,BIMM 100,A02,193312,Staff,0,7,32,32
1683633911519,BIMM 100,A03,193323,Staff,0,9,32,32
1683633912544,BIMM 101,A01,193329,McDonnell; Lisa Marie,0,4,24,24
1683633912544,BIMM 101,A02,193339,McDonnell; Lisa Marie,0,3,24,24
1683633912544,BIMM 101,B01,193354,McDonnell; Lisa Marie,0,4,24,24
1683633912544,BIMM 101,B02,193357,McDonnell; Lisa Marie,0,2,24,24
1683633913575,BIMM 110,A01,193377,Tat; John,0,11,32,32
1683633913575,BIMM 110,A02,193378,Tat; John,0,10,32,32
1683633914602,BIMM 120,A01,206116,Staff,0,0,32,32
1683633914602,BIMM 120,A02,206117,Staff,6,0,32,26
1683633914602,BIMM 120,A03,206121,Staff,21,0,32,11
1683633915634,BIPN 100,A01,193393,Park; Ji Young,0,14,32,32
1683633915634,BIPN 100,A02,193402,Park; Ji Young,0,14,32,32
1683633915634,BIPN 100,A03,193413,Park; Ji Young,0,14,32,32
1683633915634,BIPN 100,A04,193414,Park; Ji Young,0,13,32,32
1683633916663,BIPN 102,A01,193429,Staff,0,0,32,32
1683633916663,BIPN 102,A02,193438,Staff,18,0,32,14
1683633917694,BIPN 106,A01,193450,Reyes Gonzalez; Catalina,0,2,40,40
1683633918727,BIPN 134,A01,193465,Cooke; James Edward,0,0,32,32
1683633918727,BIPN 134,A02,193474,Cooke; James Edward,25,0,32,7
1683633918727,BIPN 134,A03,193485,Cooke; James Edward,29,0,32,3
1683633918727,BIPN 134,A04,193486,Cooke; James Edward,20,0,32,12
1683633918727,BIPN 134,A05,193491,Cooke; James Edward,31,0,32,1
1683633918727,BIPN 134,A06,193501,Cooke; James Edward,30,0,32,2
1683633918727,BIPN 134,A07,193510,Cooke; James Edward,29,0,32,3
1683633920780,BISP 194,A00,222522,Staff,14,0,32,18
1683633921805,CAT 124,A01,202407,Staff,19,0,25,6
1683633922831,CAT 125,A00,202408,Marchisotto; Jennifer Anne,2,0,20,18
1683633923881,CAT 125R,A00,202409,Smith; Lauryn Alissa,0,11,20,20
1683633923881,CAT 125R,B00,202410,Morales; Celeste Georgianna,0,11,20,20
1683633923881,CAT 125R,C00,202411,Irwin; Matthew Joseph,0,12,20,20
1683633924907,CENG 15,A01,204712,Yang; Kesong,0,1,0,0
1683633925939,CENG 114,A00,202070,Jahed Motlagh; Zeinab,5,0,20,15
1683633926972,CGS 105,A00,185477,Wesling; Megan E.,24,0,40,16
1683633928001,CGS 106,A00,185494,Staff,11,0,22,11
1683633929026,CGS 108,A00,185495,Staff,14,0,20,6
1683633930053,CGS 114,A00,185496,Staff,13,0,18,5
1683633931085,CGS 119,A00,185501,Staff,15,0,20,5
1683633932111,CGS 120,A00,185511,Staff,12,0,20,8
1683633933139,CHEM 4,A01,184675,Bussey; Thomas J,97,0,100,3
1683633934162,CHEM 6A,A01,184677,Staff,33,0,60,27
1683633935188,CHEM 6B,A01,184679,Staff,63,0,100,37
1683633936218,CHEM 6C,A01,184681,Bussey; Thomas J,0,0,50,50
1683633936218,CHEM 6C,A02,184682,Bussey; Thomas J,32,0,50,18
1683633937244,CHEM 40A,A01,184684,Albizati; Kim F.,35,0,100,65
1683633938269,CHEM 40B,A01,184686,Albizati; Kim F.,0,22,100,100
1683633939294,CHEM 41B,A01,184690,Staff,51,0,100,49
1683633940324,COGS 3,A01,184715,Boyle; Mary E. T.,0,27,40,40
1683633941353,COGS 14B,A01,185172,Staff,0,14,38,38
1683633942385,COGS 18,A01,184736,Staff,15,0,80,65
1683633943417,COGS 100,A01,184932,Staff,0,7,73,73
1683633944444,COGS 101A,A01,184935,Staff,0,39,30,30
1683633945473,COGS 101B,A01,184944,Staff,0,2,30,30
1683633946499,COGS 101C,A01,184946,Staff,0,10,30,30
1683633947525,COGS 102A,A01,184951,Johnson; Christine M.,2,0,40,38
1683633948551,COGS 107B,A01,184953,Mooshagian; Eric Frederick,0,51,40,40
1683633949578,COGS 118B,A01,184959,Gupta; Anjum,0,49,40,40
1683633950604,COGS 153,A00,184961,Staff,0,16,30,30
1683633951634,COGS 177,A00,184962,Staff,0,21,30,30
1683633952659,COGS 187A,A01,184969,Boyle; Mary E. T.,0,19,40,40
1683633953686,COMM 10,A01,185174,Staff,0,5,25,25
1683633953686,COMM 10,A02,185189,Staff,0,2,25,25
1683633953686,COMM 10,A03,269821,Staff,0,1,0,0
1683633954714,COMM 100B,A01,185475,Staff,0,1,0,2
1683633954714,COMM 100B,A02,185476,Staff,12,0,25,13
1683633955745,COMM 100C,A01,185314,Staff,1,0,25,24
1683633955745,COMM 100C,A02,185327,Staff,18,0,25,7
1683633956771,COMM 110M,A00,185349,Staff,0,0,40,40
1683633957795,COMM 113T,A00,185352,Staff,25,0,40,15
1683633958825,COMM 114I,A00,185353,Staff,31,0,40,9
1683633959851,COMM 131,A00,185354,Staff,17,0,30,13
1683633960878,CSE 8A,A50,185358,Cao; Yingjun,0,46,10,10
1683633961965,CSE 8B,A01,185362,Staff,0,48,50,50
1683633962996,CSE 11,A01,185416,Cao; Yingjun,0,91,10,10
1683633964021,CSE 20,A01,185445,Briones; Jor-el Thomas Caparas,4,0,25,21
1683633965048,CSE 21,A01,185447,Staff,9,0,50,41
1683633966075,CSE 101,A01,185451,Staff,0,13,50,50
1683633966075,CSE 101,B01,185453,Jones; Miles E,0,13,50,50
1683633968126,CSE 141,A01,185458,Eldon; John,15,0,100,85
1683633969162,CSE 141L,A01,185461,Eldon; John,7,0,100,93
1683633970186,CSE 142,A01,185463,Staff,36,0,60,24
1683633970186,CSE 142,B01,201355,Staff,0,7,60,60
1683633971216,CSE 142L,A01,185470,Staff,36,0,60,24
1683633971216,CSE 142L,B01,201417,Staff,0,6,60,60
1683633972241,CSE 190,A00,201433,Staff,32,0,49,17
1683633973272,DOC 1,A01,259136,Strom; Megan C.,7,0,15,8
1683633973272,DOC 1,A02,259137,Strom; Megan C.,14,0,15,1
1683633973272,DOC 1,A03,259138,Strom; Megan C.,14,0,15,1
1683633973272,DOC 1,A04,259139,Strom; Megan C.,14,0,15,1
1683633974297,DOC 100D,A00,259140,Pass; Natalye Joann,14,0,25,11
1683633975325,DSGN 1,A01,184749,Rill; Bryan,0,26,30,30
1683633976351,DSGN 100,A01,185168,Staff,0,2,25,25
1683633977384,ECE 5,A01,185626,Morris; Karcher William,0,11,0,0
1683633978409,ECE 101,A01,185628,Staff,14,0,70,56
1683633979439,ECE 107,A01,185635,Baghdadchi; Saharnaz,0,0,20,20
1683633979439,ECE 107,A02,185638,Baghdadchi; Saharnaz,3,0,20,17
1683633980470,ECE 148,A01,185647,Silberman; Jack,0,0,16,16
1683633981499,ECON 1,A01,185537,Crane; Meredith Helen,54,0,70,16
1683633982525,ECON 3,A01,185549,Crane; Meredith Helen,29,0,70,41
1683633983562,ECON 4,A01,203354,Anderson; John Charles,0,5,10,10
1683633984591,ECON 100A,A01,185574,Staff,0,5,40,40
1683633985623,ECON 100B,A01,185576,Staff,0,12,50,50
1683633986647,ECON 100C,A01,185589,Newhouse; Herbert S,30,0,70,40
1683633987674,ECON 105,A00,185608,Vespa; Emanuel Ignacio,19,0,35,16
1683633988700,ECON 109,A01,185610,Shishkin; Denis,9,0,35,26
1683633989729,ECON 110A,A01,185612,Staff,9,0,40,31
1683633990751,ECON 120A,A01,185615,Staff,20,0,40,20
1683633991775,ECON 120C,A01,185617,Sun; Yixiao,0,20,70,70
1683633992805,ECON 144,A00,203346,Squires; Dale E,2,0,35,33
1683633993829,ECON 171,A01,203349,Newhouse; Herbert S,0,1,35,35
1683633994859,ECON 173A,A01,185621,Toda; Alexis Akira,21,0,35,14
1683633995920,EDS 25,A01,202413,Staff,0,1,0,0
1683633995920,EDS 25,A02,202414,Staff,0,1,0,0
1683633995920,EDS 25,A03,202415,Staff,0,0,0,0
1683633995920,EDS 25,A04,202416,Staff,0,1,0,0
1683633995920,EDS 25,A05,202439,Staff,0,0,0,0
1683633995920,EDS 25,A06,202440,Staff,0,0,0,0
1683633995920,EDS 25,B01,202631,Staff,0,0,0,0
1683633995920,EDS 25,B02,202632,Staff,0,0,0,0
1683633995920,EDS 25,B03,202639,Staff,0,0,0,0
1683633995920,EDS 25,B04,202640,Staff,0,0,0,0
1683633995920,EDS 25,B05,202643,Staff,0,0,0,0
1683633995920,EDS 25,B06,202644,Staff,0,0,0,0
1683633996945,EDS 38,A01,202659,Black; Alison Michelle,24,0,25,1
1683633997970,EDS 115,A00,202652,Staff,18,0,30,12
1683633998998,EDS 125,A00,202649,Staff,13,0,30,17
1683634000028,EDS 126,A01,203332,Staff,30,0,30,0
1683634001062,EDS 139,A00,202838,Staff,16,0,25,9
1683634002086,EDS 146,A01,202655,Staff,14,0,25,11
1683634003113,ENG 15,A00,185667,Staff,0,1,0,0
1683634003113,ENG 15,B00,185672,Staff,0,0,0,0
1683634003113,ENG 15,C00,185675,Staff,0,0,0,0
1683634003113,ENG 15,D00,185682,Staff,0,0,0,0
1683634003113,ENG 15,E00,185684,Staff,0,0,0,0
1683634004144,ETHN 103,A00,185710,Staff,0,8,35,35
1683634005173,ETHN 103A,A00,199228,Man; Simeon S,0,0,9,9
1683634006198,ETHN 109,A00,185711,Staff,16,0,35,19
1683634007228,ETHN 142,A00,185726,Staff,0,4,30,30
1683634008255,ETHN 163J,A00,199229,Man; Simeon S,5,0,8,3
1683634009283,ETHN 168,A00,185727,Staff,7,0,10,3
1683634010311,ETHN 182,A00,185728,Staff,0,0,35,35
1683634011337,ETHN 183,A00,185737,Staff,9,0,18,9
1683634012364,GLBH 111,A01,209361,Burgos; Jose L.,0,0,0,0
1683634014418,HIEU 104,A00,185792,Staff,14,0,20,6
1683634015447,HIEU 115,A00,185800,Staff,0,0,20,20
1683634016477,HIEU 128,A00,185801,Staff,0,9,20,20
1683634017503,HIEU 147,A00,185802,Staff,15,0,20,5
1683634018530,HIEU 154,A00,185823,Staff,11,0,20,9
1683634019554,HILA 102,A00,185826,Staff,14,0,20,6
1683634020583,HILD 2C,A01,185778,Staff,0,13,20,20
1683634021611,HILD 7B,A01,185780,Kwak; Nancy,0,16,32,32
1683634021611,HILD 7B,A02,185781,Kwak; Nancy,0,18,32,32
1683634022642,HILD 30,A01,185791,Staff,12,0,20,8
1683634023669,HISC 119,A00,185830,Golan; Tal,0,9,20,20
1683634024698,HITO 156GS,A00,185831,Patterson; Patrick H.,0,0,0,23
1683634025726,HIUS 103,A00,185832,Man; Simeon S,0,4,20,20
1683634026753,HIUS 117,A00,185836,Kwak; Nancy,2,0,20,18
1683634027785,HIUS 125,A00,185840,Man; Simeon S,0,1,23,23
1683634028813,HIUS 149,A00,185845,Staff,1,0,20,19
1683634029843,HUM 3,A01,185882,Zavodny; Tatiana Sophia,0,7,50,50
1683634029843,HUM 3,B01,185899,Caldwell; Michael Alan,0,18,50,50
1683634030868,HUM 3GS,A00,185900,Patterson; Patrick H.,0,0,0,23
1683634031909,HUM 4,A01,185938,Zroka; Amy Liane,30,0,50,20
1683634031909,HUM 4,B01,185956,Watkins; Eric,0,4,50,50
1683634031909,HUM 4,B02,202209,Watkins; Eric,0,4,50,50
1683634031909,HUM 4,B03,202210,Watkins; Eric,0,4,50,50
1683634032939,HUM 5,A01,185958,West; Geoffrey Scott,2,0,50,48
1683634032939,HUM 5,A02,202215,West; Geoffrey Scott,0,0,50,50
1683634033967,INTL 190,A00,185959,Gagnon; Jeffrey C,0,0,0,9
1683634033967,INTL 190,B00,185960,Lettieri; Michael Joseph,0,0,0,2
1683634034993,JAPN 180,A00,254509,Staff,5,0,30,25
1683634036029,LATI 10,A01,202853,Kennemore; Amy Michelle,4,0,35,31
1683634036029,LATI 10,A02,202854,Kennemore; Amy Michelle,2,0,35,33
1683634036029,LATI 10,A03,270054,Kennemore; Amy Michelle,30,0,30,0
1683634037059,LATI 180,A00,202855,Kennemore; Amy Michelle,11,0,20,9
1683634038084,LAWS 101,A00,201767,Golan; Tal,0,7,40,40
1683634039110,LIFR 1C,A00,185961,Staff,6,0,20,14
1683634040134,LIFR 1CX,A00,185962,Staff,7,0,20,13
1683634041171,LIFR 1D,A00,185963,Staff,7,0,20,13
1683634042199,LIFR 1DX,A00,185964,Staff,7,0,20,13
1683634043228,LIGN 101,A01,186039,Staff,43,0,50,7
1683634044254,LIGN 165,A00,186040,Staff,15,0,50,35
1683634045281,LTCS 108,A00,186041,Staff,5,0,10,5
1683634046314,LTCS 119,A00,186042,Staff,15,0,20,5
1683634047337,LTCS 130,A00,186043,Wesling; Megan E.,15,0,25,10
1683634049390,LTEA 138,A00,186119,Staff,14,0,40,26
1683634050419,LTEN 124,A00,186148,Staff,6,0,25,19
1683634051443,LTEN 178,A00,186149,Staff,7,0,15,8
1683634052469,LTEN 181,A00,186150,Blanco; John D,34,0,40,6
1683634053498,LTWL 120,A00,186160,Staff,20,0,25,5
1683634054527,LTWL 165,A00,186161,Staff,22,0,25,3
1683634055552,LTWR 100,A00,186162,Staff,0,5,15,15
1683634056578,LTWR 102,A00,186163,Doller; Ben,5,0,15,10
1683634057604,MAE 8,A01,186412,Staff,0,0,0,0
1683634058631,MAE 30B,A00,186445,Bahadori; Mohammad Yousef,82,0,100,18
1683634059656,MAE 40,A00,186592,Bewley; Thomas R,10,0,50,40
1683634060685,MAE 101B,A00,186593,Bahadori; Mohammad Yousef,80,0,100,20
1683634061714,MAE 105,A00,186594,Bandaru; Prabhakar,10,0,50,40
1683634062739,MAE 107,A00,186599,Pham; Hieu Tan,0,7,120,120
1683634063773,MAE 148,A01,186660,Silberman; Jack,3,0,16,13
1683634064799,MATH 10A,A01,188095,Staff,0,5,35,35
1683634065886,MATH 10B,A01,188097,Bowers; Adam R.,0,11,30,30
1683634065886,MATH 10B,A02,188099,Bowers; Adam R.,0,11,30,30
1683634065886,MATH 10B,B01,188104,Bowers; Adam R.,0,10,30,30
1683634065886,MATH 10B,B02,188106,Bowers; Adam R.,1,9,30,29
1683634066914,MATH 10C,A01,188111,Staff,0,18,30,30
1683634066914,MATH 10C,A02,188127,Staff,0,19,30,30
1683634066914,MATH 10C,A03,188131,Staff,0,19,30,30
1683634066914,MATH 10C,B01,188218,Staff,17,0,30,13
1683634066914,MATH 10C,B02,188244,Staff,13,0,30,17
1683634066914,MATH 10C,B03,188277,Staff,14,0,30,16
1683634067941,MATH 18,A01,188344,Bach; Quang Tran,18,0,30,12
1683634067941,MATH 18,A02,188345,Bach; Quang Tran,11,0,30,19
1683634067941,MATH 18,B01,188353,Bach; Quang Tran,11,0,30,19
1683634067941,MATH 18,B02,188354,Bach; Quang Tran,19,0,30,11
1683634068966,MATH 20A,A01,188374,Staff,11,0,35,24
1683634069995,MATH 20B,A01,188382,Ohm; Ko Woon,7,0,30,23
1683634069995,MATH 20B,A02,188383,Ohm; Ko Woon,22,0,30,8
1683634069995,MATH 20B,B01,188385,Ohm; Ko Woon,7,0,30,23
1683634069995,MATH 20B,B02,188392,Ohm; Ko Woon,22,0,30,8
1683634071022,MATH 20C,A01,188394,Harel; Guershon,11,0,30,19
1683634071022,MATH 20C,A02,188395,Harel; Guershon,14,0,30,16
1683634071022,MATH 20C,B01,188404,Harel; Guershon,4,0,30,26
1683634071022,MATH 20C,B02,188405,Harel; Guershon,18,0,30,12
1683634072054,MATH 20D,A01,188414,Hammock; Frances H,0,1,30,30
1683634072054,MATH 20D,A02,188415,Hammock; Frances H,0,1,30,30
1683634072054,MATH 20D,B01,188447,Hammock; Frances H,0,1,30,30
1683634072054,MATH 20D,B02,188486,Hammock; Frances H,4,0,30,26
1683634073082,MATH 20E,A01,188649,Staff,21,0,30,9
1683634073082,MATH 20E,A02,188650,Staff,21,0,30,9
1683634073082,MATH 20E,A03,188673,Staff,0,0,30,30
1683634074110,MATH 102,A01,188675,Staff,0,36,35,35
1683634075134,MATH 103B,A01,188681,Staff,3,0,35,32
1683634075134,MATH 103B,B01,188692,Staff,5,0,35,30
1683634076163,MATH 109,A01,188695,Salehi Golsefidy; Alireza,24,0,35,11
1683634076163,MATH 109,A02,188696,Salehi Golsefidy; Alireza,25,0,35,10
1683634077192,MATH 120A,A01,188698,Eggers; John Dietrich,7,0,35,28
1683634078216,MATH 142B,A01,188736,Ioana; Adrian,0,1,30,30
1683634078216,MATH 142B,A02,188741,Ioana; Adrian,0,1,30,30
1683634078216,MATH 142B,A03,188743,Ioana; Adrian,0,1,30,30
1683634079242,MATH 168A,A01,188790,Staff,0,10,35,35
1683634080271,MATH 170A,A01,188803,Nie; Jiawang,0,2,35,35
1683634080271,MATH 170A,A02,188811,Nie; Jiawang,0,0,35,35
1683634080271,MATH 170A,A03,188814,Nie; Jiawang,0,0,35,35
1683634080271,MATH 170A,A04,188815,Nie; Jiawang,10,0,35,25
1683634081295,MATH 193B,A01,188817,Staff,0,0,35,35
1683634081295,MATH 193B,A02,188818,Staff,5,0,35,30
1683634082321,MGT 4,A01,202857,Anderson; John Charles,61,0,80,19
1683634083351,MGT 12,A00,202858,Lindenberger; Wade Douglas,40,0,90,50
1683634084382,MGT 18,A00,202859,Staff,74,0,90,16
1683634085408,MGT 18GS,A00,202860,McKay; Michael J,13,0,28,15
1683634086438,MGT 45,A00,202861,Pecore; Joseph P.,12,0,90,78
1683634087467,MGT 100,A00,202863,Yavorsky; Daniel Ryan,28,0,90,62
1683634088493,MGT 103,A00,202864,Ehrich; Kristine R,0,17,90,90
1683634089518,MGT 112,A00,202865,Ehrich; Kristine R,15,0,90,75
1683634090546,MGT 121A,A00,202868,Staff,0,20,0,0
1683634091571,MGT 131B,A00,202869,Anderson; John Charles,59,0,90,31
1683634092601,MGT 136,A00,202871,Lindenberger; Wade Douglas,83,0,90,7
1683634093626,MGT 164,A00,202873,Staff,0,66,90,91
1683634094651,MGT 164GS,A00,202874,McKay; Mary A,13,0,28,15
1683634095681,MGT 180,A00,202875,Staff,0,50,90,91
1683634096712,MMW 11R,A01,205019,Herbst; Matthew,2,0,30,28
1683634096712,MMW 11R,A02,205026,Herbst; Matthew,29,0,30,1
1683634097739,MMW 15,A01,193512,Chang; Edmond Yi-Teh,0,8,28,28
1683634097739,MMW 15,A02,193513,Chang; Edmond Yi-Teh,0,5,28,28
1683634097739,MMW 15,A03,193514,Chang; Edmond Yi-Teh,0,5,28,28
1683634097739,MMW 15,A04,193515,Chang; Edmond Yi-Teh,0,5,28,28
1683634097739,MMW 15,A05,193516,Chang; Edmond Yi-Teh,0,5,28,28
1683634097739,MMW 15,A06,193517,Chang; Edmond Yi-Teh,0,6,28,28
1683634097739,MMW 15,B01,193519,Chang; Edmond Yi-Teh,0,5,28,28
1683634097739,MMW 15,B02,193520,Chang; Edmond Yi-Teh,0,5,28,28
1683634097739,MMW 15,B03,193521,Chang; Edmond Yi-Teh,0,5,28,28
1683634097739,MMW 15,B04,193522,Chang; Edmond Yi-Teh,0,5,28,28
1683634097739,MMW 15,B05,193523,Chang; Edmond Yi-Teh,0,5,28,28
1683634097739,MMW 15,B06,193524,Chang; Edmond Yi-Teh,0,5,28,28
1683634098769,MMW 122,A01,193526,Rahimi; Babak,0,16,28,28
1683634098769,MMW 122,A02,193527,Rahimi; Babak,0,15,28,28
1683634098769,MMW 122,A03,193528,Rahimi; Babak,0,0,0,0
1683634098769,MMW 122,A04,193529,Rahimi; Babak,0,0,0,0
1683634099797,MUS 1A,A01,186663,Staff,1,20,35,34
1683634100826,MUS 4,A01,186715,Staff,0,12,35,35
1683634101856,MUS 5R,A01,186796,Dubnov; Shlomo,0,17,35,35
1683634102879,MUS 6,A01,186798,Staff,0,5,25,25
1683634103904,MUS 7,A01,186830,Staff,11,0,35,24
1683634104930,MUS 8,A01,186930,Staff,0,26,35,35
1683634105958,MUS 15,A01,186932,Staff,0,16,35,35
1683634105958,MUS 15,B01,186934,Staff,0,17,35,35
1683634106987,MUS 80,A00,186935,Staff,0,0,20,20
1683634106987,MUS 80,B00,186936,Staff,24,0,25,1
1683634108018,NANO 11,A00,204702,Lipomi; Darren John,0,0,0,0
1683634109045,NANO 15,A01,204709,Yang; Kesong,0,1,0,0
1683634110074,NANO 114,A00,202069,Jahed Motlagh; Zeinab,3,0,10,7
1683634111105,PHIL 1,A00,186955,Grush; Rick Scott,31,0,40,9
1683634112134,PHIL 10,A01,186973,Grush; Rick Scott,27,0,35,8
1683634112134,PHIL 10,A02,186974,Grush; Rick Scott,33,0,35,2
1683634113160,PHIL 13,A01,186976,Staff,3,0,35,32
1683634113160,PHIL 13,A02,186977,Staff,16,0,35,19
1683634114196,PHIL 14,A01,186979,Staff,31,0,35,4
1683634114196,PHIL 14,A02,186986,Staff,32,0,35,3
1683634115227,PHIL 28,A01,186988,Staff,16,0,30,14
1683634115227,PHIL 28,A02,186989,Staff,1,0,30,29
1683634115227,PHIL 28,A03,186990,Staff,10,0,30,20
1683634115227,PHIL 28,A04,186991,Staff,26,0,30,4
1683634116252,PHIL 120,A00,186997,Staff,23,0,40,17
1683634117280,PHIL 137,A00,187003,Staff,7,0,40,33
1683634118305,PHIL 150,A00,187015,Staff,47,0,70,23
1683634119347,PHIL 167,A00,187021,Lamey; Andy M.,34,0,40,6
1683634120377,PHIL 174,A01,202226,Staff,17,0,20,3
1683634120377,PHIL 174,A02,202235,Staff,20,0,20,0
1683634121404,PHIL 191A,A00,258918,Staff,0,0,1,1
1683634122432,PHYS 1A,A00,187028,Staff,27,0,60,33
1683634123461,PHYS 1AL,001,187036,Staff,3,0,30,27
1683634123461,PHYS 1AL,002,187049,Staff,18,0,30,12
1683634124490,PHYS 1B,A00,187058,Staff,22,0,60,38
1683634125516,PHYS 1BL,001,187064,Staff,0,1,30,30
1683634125516,PHYS 1BL,002,187070,Staff,4,0,30,26
1683634126545,PHYS 1C,A00,187082,Staff,29,0,120,91
1683634127572,PHYS 1CL,001,187088,Staff,0,9,30,30
1683634127572,PHYS 1CL,002,187089,Staff,0,1,30,30
1683634127572,PHYS 1CL,009,262693,Staff,9,0,30,21
1683634128598,PHYS 2B,A01,187097,Staff,55,0,115,60
1683634129626,PHYS 2C,A01,187099,Staff,64,0,115,51
1683634130652,PHYS 2CL,A01,187101,Staff,5,0,28,23
1683634130652,PHYS 2CL,A02,187102,Staff,15,0,28,13
1683634131683,PHYS 2D,A01,187123,Shotwell; Brian,95,0,115,20
1683634132707,PHYS 4B,A01,187133,Grinstein; Benjamin,35,0,50,15
1683634133734,POLI 10,A00,188819,Staff,0,4,50,50
1683634134764,POLI 11,A00,188827,Staff,43,0,50,7
1683634135792,POLI 13R,A00,188828,Staff,0,1,20,20
1683634136826,POLI 27,A01,188830,Elgin; Samuel Zincke,0,2,70,70
1683634137855,POLI 30,A00,188832,Desposato; Scott,30,0,50,20
1683634138883,POLI 102F,A00,188834,Staff,0,0,40,40
1683634139910,POLI 104A,A00,188852,Staff,13,0,30,17
1683634140938,POLI 104I,A00,188853,Staff,0,7,20,20
1683634141965,POLI 110B,A00,188854,Wiens; David,7,0,20,13
1683634142989,POLI 112A,A00,188855,Wiens; David,4,0,30,26
1683634144018,POLI 117R,A00,188856,Forman; Fonna,0,12,20,20
1683634145043,POLI 118,A00,188857,Ingham; Sean,8,0,20,12
1683634146069,POLI 120G,A00,188858,Staff,8,0,30,22
1683634147099,POLI 131CR,A00,188863,Hoston; Germaine,21,0,50,29
1683634148124,POLI 133,A00,188864,Nellis; Gareth Hb,44,0,50,6
1683634149152,POLI 134D,A00,188865,Desposato; Scott,27,0,30,3
1683634150177,POLI 142A,A00,188871,Gartzke; Erik,21,0,50,29
1683634151205,POLI 142K,A00,188874,Staff,38,0,50,12
1683634152230,POLI 143,A00,188940,Gartzke; Erik,16,0,30,14
1683634153253,POLI 153,A00,188943,Staff,2,0,20,18
1683634154278,POLI 160AA,A00,188944,Staff,11,0,40,29
1683634155308,POLI 170A,A00,188945,Staff,11,0,30,19
1683634157362,PSYC 1,A00,188952,Staff,36,0,90,54
1683634158388,PSYC 2,B00,188953,Staff,19,0,35,16
1683634159413,PSYC 6,A00,188970,Staff,47,0,60,13
1683634160447,PSYC 7,A00,188973,Staff,35,0,45,10
1683634161474,PSYC 60,A01,188980,Rickard; Timothy C.,42,0,60,18
1683634162503,PSYC 70,A01,189001,Steiner; Eric Tomas,23,0,45,22
1683634163529,PSYC 100,A00,189005,Lacefield; Katharine I,0,99,120,120
1683634164554,PSYC 102,A00,189008,Staff,8,0,30,22
1683634165583,PSYC 106,B00,189026,Gorman; Michael R.,27,0,60,33
1683634166608,PSYC 114,B01,189033,Winkielman; Piotr,0,31,30,30
1683634167633,PSYC 131,A00,189036,Anagnostaras; Stephan,0,43,60,60
1683634168660,PSYC 136,A00,189041,Lowe; Angela Beth,0,7,25,25
1683634169759,PSYC 137,A00,189057,Winkielman; Piotr,0,37,25,25
1683634170789,PSYC 144,A00,189107,Wixted; John T,0,10,50,50
1683634172849,PSYC 162,A00,189142,Staff,0,9,85,85
1683634173874,PSYC 172,A00,189144,Gorman; Michael R.,0,6,30,30
1683634175930,PSYC 179,A00,189146,Lacefield; Katharine I,0,86,120,120
1683634176958,PSYC 181,A00,189147,Anagnostaras; Stephan,0,44,90,90
1683634177984,PSYC 190R,A00,189148,Barner; David A.,0,23,80,80
1683634179009,PSYC 191,A00,189275,Rickard; Timothy C.,0,10,25,25
1683634180038,PSYC 193,A00,189276,Chapman; Eddie Nathaniel,0,1,0,4
1683634181062,PSYC 193L,A01,189281,Lowe; Angela Beth,10,0,20,10
1683634181062,PSYC 193L,B01,189285,Staff,28,0,35,7
1683634182092,RELI 149,A00,187137,Rahimi; Babak,7,0,40,33
1683634183119,SE 9,A01,187315,Staff,0,2,18,18
1683634184144,SE 101B,A00,187409,Staff,24,0,30,6
1683634185172,SE 110B,A00,187444,Staff,10,0,40,30
1683634186199,SE 130B,A00,187449,Staff,31,0,40,9
1683634187225,SE 150A,A00,187516,Staff,9,0,20,11
1683634188250,SE 154,A00,187528,Staff,29,0,50,21
1683634189276,SIO 3,A01,258171,Staff,35,0,40,5
1683634190301,SIO 10,A00,187144,Cook; Geoffrey W,0,6,75,75
1683634191325,SIO 45,A00,187152,Cook; Geoffrey W,0,4,100,100
1683634192353,SIO 109R,A00,194486,Staff,0,4,20,20
1683634194404,SIO 187,A01,187233,Kacev; David,12,0,40,28
1683634195430,SOCI 1,A01,258656,Thorpe; Charles Robert,28,0,30,2
1683634195430,SOCI 1,A02,258658,Thorpe; Charles Robert,30,0,30,0
1683634195430,SOCI 1,A03,258661,Thorpe; Charles Robert,25,0,25,0
1683634195430,SOCI 1,A04,258666,Thorpe; Charles Robert,22,0,25,3
1683634195430,SOCI 1,A05,258897,Thorpe; Charles Robert,22,0,25,3
1683634195430,SOCI 1,A06,258898,Thorpe; Charles Robert,25,0,25,0
1683634196455,SOCI 30,A01,258903,Pardo Guerra; Juan Pablo,14,0,30,16
1683634197483,SOCI 102,A00,258904,Staff,9,0,25,16
1683634198509,SOCI 106,A00,258905,Staff,19,0,25,6
1683634199534,SOCI 111,A00,258907,Ribas Norris; Janet Vanesa,26,0,30,4
1683634200560,SOCI 121R,A00,258908,Pardo Guerra; Juan Pablo,8,0,30,22
1683634201589,SOCI 126,A01,203330,Staff,14,0,20,6
1683634202614,SOCI 131,A00,258909,Thorpe; Charles Robert,30,0,60,30
1683634203643,SOCI 135,A00,258910,Payne; Christine Anna,0,11,30,30
1683634204667,SOCI 157,A00,258911,Staff,12,0,30,18
1683634205693,SOCI 184,A00,258912,Staff,25,0,30,5
1683634206729,SOCI 188D,A00,258913,Staff,22,0,30,8
1683634207755,SYN 2,001,187529,Staff,9,0,16,7
1683634207755,SYN 2,002,201452,Staff,0,20,16,16
1683634207755,SYN 2,003,201469,Staff,2,0,16,14
1683634208783,SYN 100,A01,187531,Staff,0,9,20,20
1683634208783,SYN 100,B01,201491,Staff,0,10,20,20
1683634209808,TDAC 1,A00,189286,Walsh; Kim C.,3,0,20,17
1683634209808,TDAC 1,B00,189287,Harting; Carla Kelso,10,0,20,10
1683634210837,TDAC 101,A00,189300,Walsh; Kim C.,16,0,20,4
1683634210837,TDAC 101,B00,189301,Harting; Carla Kelso,18,0,20,2
1683634211864,TDAC 102,A00,189304,Basso; Beatrice,14,0,20,6
1683634212894,TDAC 108,A00,189305,Staff,18,0,20,2
1683634213927,TDDE 131,A00,189310,Staff,19,0,20,1
1683634213927,TDDE 131,B00,189314,Staff,19,0,20,1
1683634213927,TDDE 131,C00,189315,Staff,48,0,50,2
1683634213927,TDDE 131,D00,189316,Staff,14,0,15,1
1683634213927,TDDE 131,E00,204841,Staff,20,0,20,0
1683634214952,TDGE 10,A00,189289,Staff,28,0,50,22
1683634214952,TDGE 10,B00,189290,Havis; Allan,0,0,50,50
1683634215980,TDGE 11,A00,189291,Fulton; Julia,0,4,50,50
1683634215980,TDGE 11,B00,189292,Staff,20,0,25,5
1683634215980,TDGE 11,C00,260270,Staff,0,0,0,0
1683634217007,TDGE 25,A00,189294,Staff,2,0,20,18
1683634218032,TDGE 124,A00,189318,Fulton; Julia,0,8,50,50
1683634219056,TDGE 125,A00,189319,Staff,13,0,25,12
1683634219056,TDGE 125,B00,189320,Staff,23,0,25,2
1683634220082,TDGE 127,A00,189322,Havis; Allan,0,0,50,50
1683634221112,TDHT 101,A00,189323,Staff,18,0,25,7
1683634221112,TDHT 101,B00,189324,Staff,25,0,25,0
1683634222138,TDHT 102,A00,189325,Staff,49,0,50,1
1683634223163,TDMV 1,A00,189295,Arcidiacono; Kristin,20,0,30,10
1683634223163,TDMV 1,B00,189296,Caligagan; Maria T.,24,0,30,6
1683634224196,TDMV 2,A00,189297,Sammartano; Tonnie,27,0,30,3
1683634224196,TDMV 2,B00,189299,Arcidiacono; Kristin,23,0,30,7
1683634225226,TDMV 3,A00,204998,Rincon; Alicia,22,0,30,8
1683634226254,TDMV 120,A00,189458,Sammartano; Tonnie,28,0,30,2
1683634227280,TDMV 138,A00,189541,Jun; Grace Shin Hae,20,0,40,20
1683634228305,TDMV 142,A00,189717,Caligagan; Tony,25,0,30,5
1683634228305,TDMV 142,B00,189718,Caligagan; Maria T.,25,0,30,5
1683634229342,TMC 2,A01,187533,Staff,25,0,25,0
1683634229342,TMC 2,A02,187534,Staff,25,0,25,0
1683634230367,USP 1,A01,187536,Kwak; Nancy,0,16,25,25
1683634231396,USP 5,A01,187538,Staff,9,0,25,16
1683634232421,USP 101,A00,199253,Staff,0,4,0,0
1683634233446,USP 124,A00,187562,Boomhower; Matthew Charles,0,0,30,30
1683634234476,USP 138,A00,187582,Staff,20,0,25,5
1683634235502,USP 152,A01,187597,Staff,3,0,25,22
1683634236540,USP 153,A00,187598,Staff,19,0,25,6
1683634237567,USP 168,A00,187607,Kwak; Nancy,2,0,5,3
1683634238592,USP 173,A00,187619,Staff,4,0,25,21
1683634239620,USP 181,A00,187638,Staff,0,4,25,25
1683634240647,VIS 103,A00,187650,Cruz; Edwin Teddy,18,0,75,57
1683634241672,VIS 110D,A00,187669,Staff,13,0,22,9
1683634242701,VIS 127C,A00,187720,Shen; Kuiyi,67,0,146,79
1683634243727,VIS 149,A00,187731,Yoldas; Pinar,0,14,22,22
1683634244755,VIS 151,A01,188091,Staff,22,0,34,12
1683634244755,VIS 151,A02,188092,Staff,11,0,34,23
1683634245784,VIS 160B,A00,188093,Stalbaum; Brett,0,1,10,10
1683634247841,WCWP 10B,A00,201720,Staff,10,0,15,5
1683634247841,WCWP 10B,B00,201722,Staff,9,0,15,6
1683634248866,WCWP 100,A00,201725,Gagnon; Jeffrey C,0,0,2,2
1683634248866,WCWP 100,B00,201727,Staff,0,4,15,15
1683634251987,ANBI 133,A00,258401,Wilder; Linnea Lorene,34,0,40,6
1683634253011,ANBI 140,A00,258395,Hrvoj Mihic; Branka,18,0,25,7
1683634254036,ANSC 120,A00,258402,Bialecki; Jon Anthony,27,0,40,13
1683634255066,ANSC 144,A00,258400,Staff,12,0,40,28
1683634257119,ANSC 166,A00,258396,Parish; Steven Martin,156,0,175,19
1683634258148,ANSC 180,A00,193533,Staff,8,0,20,12
1683634259173,ANSC 188,A00,258397,Jassal; Aftab,34,0,40,6
1683634260198,ANTH 3,A01,258316,Staff,23,0,30,7
1683634261225,ANTH 5,A00,258394,Semendeferi; Ekaterini,16,0,20,4
1683634262259,ANTH 21,A01,258331,Staff,4,0,40,36
1683634263284,ANTH 103,A00,258398,Varma; Saiba,15,0,25,10
1683634264315,AWP 10,001,202034,Staff,0,0,0,0
1683634264315,AWP 10,002,202035,Staff,0,0,0,0
1683634264315,AWP 10,003,202036,Staff,0,0,0,0
1683634264315,AWP 10,004,202037,Staff,0,0,0,0
1683634264315,AWP 10,005,202038,Staff,0,0,0,0
1683634264315,AWP 10,006,202039,Staff,0,0,0,0
1683634264315,AWP 10,007,202040,Staff,0,0,0,0
1683634264315,AWP 10,008,202041,Staff,0,0,0,0
1683634264315,AWP 10,009,202042,Staff,0,0,0,0
1683634264315,AWP 10,010,202043,Staff,0,0,0,0
1683634264315,AWP 10,011,202044,Staff,0,0,0,0
1683634264315,AWP 10,012,202045,Staff,0,0,0,0
1683634264315,AWP 10,013,202046,Staff,0,0,0,0
1683634264315,AWP 10,014,202047,Staff,0,0,0,0
1683634264315,AWP 10,015,202048,Staff,0,0,0,0
1683634264315,AWP 10,016,202049,Staff,0,0,0,0
1683634264315,AWP 10,017,202050,Staff,0,0,0,0
1683634264315,AWP 10,018,202051,Staff,0,0,0,0
1683634264315,AWP 10,019,202052,Staff,0,0,0,0
1683634264315,AWP 10,020,202053,Staff,0,0,0,0
1683634264315,AWP 10,021,202054,Staff,0,0,0,0
1683634264315,AWP 10,022,202055,Staff,0,0,0,0
1683634264315,AWP 10,023,202056,Staff,0,0,0,0
1683634264315,AWP 10,024,202057,Staff,0,0,0,0
1683634264315,AWP 10,025,202058,Staff,0,0,0,0
1683634264315,AWP 10,026,202059,Staff,0,0,0,0
1683634265344,AWP 102,001,202032,Staff,0,0,0,0
1683634265344,AWP 102,002,202033,Staff,0,0,0,0
1683634266371,BENG 100,A01,254234,Taylor Amos; Alyssa C,31,0,40,9
1683634267394,BENG 196,001,270013,Engler; Adam J.,9999,0,9999,0
1683634268421,BICD 100R,A01,202018,Smith; Laurie,0,7,32,32
1683634268421,BICD 100R,A02,202019,Smith; Laurie,0,3,32,32
1683634268421,BICD 100R,A03,202020,Smith; Laurie,0,1,32,32
1683634268421,BICD 100R,A04,202021,Smith; Laurie,6,0,32,26
1683634268421,BICD 100R,A05,202022,Smith; Laurie,11,0,32,21
1683634269446,BICD 136,A01,193242,Gustafson-Brown; Cindy,0,2,32,32
1683634269446,BICD 136,A02,193244,Gustafson-Brown; Cindy,13,0,32,19
1683634270479,BIEB 102,A01,193249,Butler; Shannon Rhey,0,2,32,32
1683634270479,BIEB 102,A02,193251,Butler; Shannon Rhey,0,0,32,32
1683634270479,BIEB 102,A03,193253,Butler; Shannon Rhey,0,0,32,32
1683634270479,BIEB 102,A04,193255,Butler; Shannon Rhey,14,0,32,18
1683634270479,BIEB 102,A05,193265,Butler; Shannon Rhey,26,0,32,6
1683634270479,BIEB 102,A06,193269,Butler; Shannon Rhey,14,0,32,18
1683634272534,BIEB 150,A01,193274,Staff,0,0,32,32
1683634272534,BIEB 150,A02,193285,Staff,24,0,32,8
1683634273620,BIEB 194,A00,193286,Kurle; Carolyn M.,20,0,32,12
1683634274652,BILD 1,A01,192291,Staff,15,0,32,17
1683634274652,BILD 1,A02,192292,Staff,30,0,32,2
1683634274652,BILD 1,B01,192520,Reuther; Keefe,0,1,0,0
1683634274652,BILD 1,B02,192532,Reuther; Keefe,0,1,0,0
1683634275683,BILD 3,A01,192556,Butler; Shannon Rhey,0,0,32,32
1683634275683,BILD 3,A02,192581,Butler; Shannon Rhey,1,0,32,31
1683634275683,BILD 3,A03,192611,Butler; Shannon Rhey,21,0,32,11
1683634275683,BILD 3,A04,192612,Butler; Shannon Rhey,24,0,32,8
1683634275683,BILD 3,A05,192613,Butler; Shannon Rhey,26,0,32,6
1683634275683,BILD 3,A06,192679,Butler; Shannon Rhey,27,0,32,5
1683634275683,BILD 3,A07,192682,Butler; Shannon Rhey,20,0,32,12
1683634276720,BILD 4,A01,192836,Reuther; Keefe,0,0,24,24
1683634276720,BILD 4,A02,193044,Reuther; Keefe,4,0,24,20
1683634277748,BILD 10,A01,193142,Gustafson-Brown; Cindy,29,0,32,3
1683634277748,BILD 10,A02,193149,Gustafson-Brown; Cindy,31,0,32,1
1683634278773,BIMM 100,A01,193301,Staff,0,6,32,32
1683634278773,BIMM 100,A02,193312,Staff,0,7,32,32
1683634278773,BIMM 100,A03,193323,Staff,0,9,32,32
1683634279803,BIMM 101,A01,193329,McDonnell; Lisa Marie,0,4,24,24
1683634279803,BIMM 101,A02,193339,McDonnell; Lisa Marie,0,3,24,24
1683634279803,BIMM 101,B01,193354,McDonnell; Lisa Marie,0,4,24,24
1683634279803,BIMM 101,B02,193357,McDonnell; Lisa Marie,0,2,24,24
1683634280831,BIMM 110,A01,193377,Tat; John,0,11,32,32
1683634280831,BIMM 110,A02,193378,Tat; John,0,10,32,32
1683634281857,BIMM 120,A01,206116,Staff,0,0,32,32
1683634281857,BIMM 120,A02,206117,Staff,6,0,32,26
1683634281857,BIMM 120,A03,206121,Staff,21,0,32,11
1683634282883,BIPN 100,A01,193393,Park; Ji Young,0,14,32,32
1683634282883,BIPN 100,A02,193402,Park; Ji Young,0,14,32,32
1683634282883,BIPN 100,A03,193413,Park; Ji Young,0,14,32,32
1683634282883,BIPN 100,A04,193414,Park; Ji Young,0,13,32,32
1683634283910,BIPN 102,A01,193429,Staff,0,0,32,32
1683634283910,BIPN 102,A02,193438,Staff,18,0,32,14
1683634284946,BIPN 106,A01,193450,Reyes Gonzalez; Catalina,0,2,40,40
1683634285978,BIPN 134,A01,193465,Cooke; James Edward,0,0,32,32
1683634285978,BIPN 134,A02,193474,Cooke; James Edward,25,0,32,7
1683634285978,BIPN 134,A03,193485,Cooke; James Edward,29,0,32,3
1683634285978,BIPN 134,A04,193486,Cooke; James Edward,20,0,32,12
1683634285978,BIPN 134,A05,193491,Cooke; James Edward,31,0,32,1
1683634285978,BIPN 134,A06,193501,Cooke; James Edward,30,0,32,2
1683634285978,BIPN 134,A07,193510,Cooke; James Edward,29,0,32,3
1683634288041,BISP 194,A00,222522,Staff,14,0,32,18
1683634289069,CAT 124,A01,202407,Staff,19,0,25,6
1683634290094,CAT 125,A00,202408,Marchisotto; Jennifer Anne,2,0,20,18
1683634291120,CAT 125R,A00,202409,Smith; Lauryn Alissa,0,11,20,20
1683634291120,CAT 125R,B00,202410,Morales; Celeste Georgianna,0,11,20,20
1683634291120,CAT 125R,C00,202411,Irwin; Matthew Joseph,0,12,20,20
1683634292145,CENG 15,A01,204712,Yang; Kesong,0,1,0,0
1683634293175,CENG 114,A00,202070,Jahed Motlagh; Zeinab,5,0,20,15
1683634294205,CGS 105,A00,185477,Wesling; Megan E.,24,0,40,16
1683634295231,CGS 106,A00,185494,Staff,11,0,22,11
1683634296260,CGS 108,A00,185495,Staff,14,0,20,6
1683634297286,CGS 114,A00,185496,Staff,13,0,18,5
1683634298311,CGS 119,A00,185501,Staff,15,0,20,5
1683634299336,CGS 120,A00,185511,Staff,12,0,20,8
1683634300368,CHEM 4,A01,184675,Bussey; Thomas J,97,0,100,3
1683634301393,CHEM 6A,A01,184677,Staff,33,0,60,27
1683634302418,CHEM 6B,A01,184679,Staff,63,0,100,37
1683634303448,CHEM 6C,A01,184681,Bussey; Thomas J,0,0,50,50
1683634303448,CHEM 6C,A02,184682,Bussey; Thomas J,32,0,50,18
1683634304473,CHEM 40A,A01,184684,Albizati; Kim F.,35,0,100,65
1683634305500,CHEM 40B,A01,184686,Albizati; Kim F.,0,22,100,100
1683634306526,CHEM 41B,A01,184690,Staff,51,0,100,49
1683634307551,COGS 3,A01,184715,Boyle; Mary E. T.,0,27,40,40
1683634308580,COGS 14B,A01,185172,Staff,0,14,38,38
1683634309607,COGS 18,A01,184736,Staff,15,0,80,65
1683634310631,COGS 100,A01,184932,Staff,0,7,73,73
1683634311660,COGS 101A,A01,184935,Staff,0,39,30,30
1683634312686,COGS 101B,A01,184944,Staff,0,2,30,30
1683634313714,COGS 101C,A01,184946,Staff,0,10,30,30
1683634314740,COGS 102A,A01,184951,Johnson; Christine M.,2,0,40,38
1683634315768,COGS 107B,A01,184953,Mooshagian; Eric Frederick,0,51,40,40
1683634316794,COGS 118B,A01,184959,Gupta; Anjum,0,49,40,40
1683634317818,COGS 153,A00,184961,Staff,0,16,30,30
1683634318846,COGS 177,A00,184962,Staff,0,21,30,30
1683634319871,COGS 187A,A01,184969,Boyle; Mary E. T.,0,19,40,40
1683634320897,COMM 10,A01,185174,Staff,0,5,25,25
1683634320897,COMM 10,A02,185189,Staff,0,2,25,25
1683634320897,COMM 10,A03,269821,Staff,0,1,0,0
1683634321925,COMM 100B,A01,185475,Staff,0,1,0,2
1683634321925,COMM 100B,A02,185476,Staff,12,0,25,13
1683634322954,COMM 100C,A01,185314,Staff,1,0,25,24
1683634322954,COMM 100C,A02,185327,Staff,18,0,25,7
1683634323980,COMM 110M,A00,185349,Staff,0,0,40,40
1683634325008,COMM 113T,A00,185352,Staff,25,0,40,15
1683634326033,COMM 114I,A00,185353,Staff,31,0,40,9
1683634327060,COMM 131,A00,185354,Staff,17,0,30,13
1683634328091,CSE 8A,A50,185358,Cao; Yingjun,0,46,10,10
1683634329117,CSE 8B,A01,185362,Staff,0,48,50,50
1683634330142,CSE 11,A01,185416,Cao; Yingjun,0,91,10,10
1683634331175,CSE 20,A01,185445,Briones; Jor-el Thomas Caparas,4,0,25,21
1683634332203,CSE 21,A01,185447,Staff,9,0,50,41
1683634333228,CSE 101,A01,185451,Staff,0,13,50,50
1683634333228,CSE 101,B01,185453,Jones; Miles E,0,13,50,50
1683634335280,CSE 141,A01,185458,Eldon; John,15,0,100,85
1683634336305,CSE 141L,A01,185461,Eldon; John,7,0,100,93
1683634337335,CSE 142,A01,185463,Staff,36,0,60,24
1683634337335,CSE 142,B01,201355,Staff,0,7,60,60
1683634338368,CSE 142L,A01,185470,Staff,36,0,60,24
1683634338368,CSE 142L,B01,201417,Staff,0,6,60,60
1683634339394,CSE 190,A00,201433,Staff,32,0,49,17
1683634340421,DOC 1,A01,259136,Strom; Megan C.,7,0,15,8
1683634340421,DOC 1,A02,259137,Strom; Megan C.,14,0,15,1
1683634340421,DOC 1,A03,259138,Strom; Megan C.,14,0,15,1
1683634340421,DOC 1,A04,259139,Strom; Megan C.,14,0,15,1
1683634341451,DOC 100D,A00,259140,Pass; Natalye Joann,14,0,25,11
1683634342476,DSGN 1,A01,184749,Rill; Bryan,0,26,30,30
1683634343502,DSGN 100,A01,185168,Staff,0,2,25,25
1683634344533,ECE 5,A01,185626,Morris; Karcher William,0,11,0,0
1683634345563,ECE 101,A01,185628,Staff,14,0,70,56
1683634346590,ECE 107,A01,185635,Baghdadchi; Saharnaz,0,0,20,20
1683634346590,ECE 107,A02,185638,Baghdadchi; Saharnaz,3,0,20,17
1683634347615,ECE 148,A01,185647,Silberman; Jack,0,0,16,16
1683634348645,ECON 1,A01,185537,Crane; Meredith Helen,54,0,70,16
1683634349672,ECON 3,A01,185549,Crane; Meredith Helen,29,0,70,41
1683634350698,ECON 4,A01,203354,Anderson; John Charles,0,5,10,10
1683634351725,ECON 100A,A01,185574,Staff,0,5,40,40
1683634352755,ECON 100B,A01,185576,Staff,0,12,50,50
1683634353785,ECON 100C,A01,185589,Newhouse; Herbert S,30,0,70,40
1683634354811,ECON 105,A00,185608,Vespa; Emanuel Ignacio,19,0,35,16
1683634355845,ECON 109,A01,185610,Shishkin; Denis,9,0,35,26
1683634356874,ECON 110A,A01,185612,Staff,9,0,40,31
1683634357902,ECON 120A,A01,185615,Staff,20,0,40,20
1683634358935,ECON 120C,A01,185617,Sun; Yixiao,0,20,70,70
1683634359960,ECON 144,A00,203346,Squires; Dale E,2,0,35,33
1683634360986,ECON 171,A01,203349,Newhouse; Herbert S,0,1,35,35
1683634362016,ECON 173A,A01,185621,Toda; Alexis Akira,21,0,35,14
1683634363049,EDS 25,A01,202413,Staff,0,1,0,0
1683634363049,EDS 25,A02,202414,Staff,0,1,0,0
1683634363049,EDS 25,A03,202415,Staff,0,0,0,0
1683634363049,EDS 25,A04,202416,Staff,0,1,0,0
1683634363049,EDS 25,A05,202439,Staff,0,0,0,0
1683634363049,EDS 25,A06,202440,Staff,0,0,0,0
1683634363049,EDS 25,B01,202631,Staff,0,0,0,0
1683634363049,EDS 25,B02,202632,Staff,0,0,0,0
1683634363049,EDS 25,B03,202639,Staff,0,0,0,0
1683634363049,EDS 25,B04,202640,Staff,0,0,0,0
1683634363049,EDS 25,B05,202643,Staff,0,0,0,0
1683634363049,EDS 25,B06,202644,Staff,0,0,0,0
1683634364078,EDS 38,A01,202659,Black; Alison Michelle,24,0,25,1
1683634365102,EDS 115,A00,202652,Staff,18,0,30,12
1683634366127,EDS 125,A00,202649,Staff,13,0,30,17
1683634367152,EDS 126,A01,203332,Staff,30,0,30,0
1683634368177,EDS 139,A00,202838,Staff,16,0,25,9
1683634369202,EDS 146,A01,202655,Staff,14,0,25,11
1683634370229,ENG 15,A00,185667,Staff,0,1,0,0
1683634370229,ENG 15,B00,185672,Staff,0,0,0,0
1683634370229,ENG 15,C00,185675,Staff,0,0,0,0
1683634370229,ENG 15,D00,185682,Staff,0,0,0,0
1683634370229,ENG 15,E00,185684,Staff,0,0,0,0
1683634371258,ETHN 103,A00,185710,Staff,0,8,35,35
1683634372283,ETHN 103A,A00,199228,Man; Simeon S,0,0,9,9
1683634373309,ETHN 109,A00,185711,Staff,16,0,35,19
1683634374334,ETHN 142,A00,185726,Staff,0,4,30,30
1683634375358,ETHN 163J,A00,199229,Man; Simeon S,5,0,8,3
1683634376387,ETHN 168,A00,185727,Staff,7,0,10,3
1683634377476,ETHN 182,A00,185728,Staff,0,0,35,35
1683634378504,ETHN 183,A00,185737,Staff,9,0,18,9
1683634379532,GLBH 111,A01,209361,Burgos; Jose L.,0,0,0,0
1683634381586,HIEU 104,A00,185792,Staff,14,0,20,6
1683634382614,HIEU 115,A00,185800,Staff,0,0,20,20
1683634383648,HIEU 128,A00,185801,Staff,0,9,20,20
1683634384673,HIEU 147,A00,185802,Staff,15,0,20,5
1683634385700,HIEU 154,A00,185823,Staff,11,0,20,9
1683634386724,HILA 102,A00,185826,Staff,14,0,20,6
1683634387749,HILD 2C,A01,185778,Staff,0,13,20,20
1683634388776,HILD 7B,A01,185780,Kwak; Nancy,0,16,32,32
1683634388776,HILD 7B,A02,185781,Kwak; Nancy,0,18,32,32
1683634389802,HILD 30,A01,185791,Staff,12,0,20,8
1683634390828,HISC 119,A00,185830,Golan; Tal,0,9,20,20
1683634391853,HITO 156GS,A00,185831,Patterson; Patrick H.,0,0,0,23
1683634392883,HIUS 103,A00,185832,Man; Simeon S,0,4,20,20
1683634393912,HIUS 117,A00,185836,Kwak; Nancy,2,0,20,18
1683634394949,HIUS 125,A00,185840,Man; Simeon S,0,1,23,23
1683634395977,HIUS 149,A00,185845,Staff,1,0,20,19
1683634397002,HUM 3,A01,185882,Zavodny; Tatiana Sophia,0,7,50,50
1683634397002,HUM 3,B01,185899,Caldwell; Michael Alan,0,18,50,50
1683634398029,HUM 3GS,A00,185900,Patterson; Patrick H.,0,0,0,23
1683634399058,HUM 4,A01,185938,Zroka; Amy Liane,30,0,50,20
1683634399058,HUM 4,B01,185956,Watkins; Eric,0,4,50,50
1683634399058,HUM 4,B02,202209,Watkins; Eric,0,4,50,50
1683634399058,HUM 4,B03,202210,Watkins; Eric,0,4,50,50
1683634400087,HUM 5,A01,185958,West; Geoffrey Scott,2,0,50,48
1683634400087,HUM 5,A02,202215,West; Geoffrey Scott,0,0,50,50
1683634401116,INTL 190,A00,185959,Gagnon; Jeffrey C,0,0,0,9
1683634401116,INTL 190,B00,185960,Lettieri; Michael Joseph,0,0,0,2
1683634402142,JAPN 180,A00,254509,Staff,5,0,30,25
1683634403172,LATI 10,A01,202853,Kennemore; Amy Michelle,4,0,35,31
1683634403172,LATI 10,A02,202854,Kennemore; Amy Michelle,2,0,35,33
1683634403172,LATI 10,A03,270054,Kennemore; Amy Michelle,30,0,30,0
1683634404200,LATI 180,A00,202855,Kennemore; Amy Michelle,11,0,20,9
1683634405236,LAWS 101,A00,201767,Golan; Tal,0,7,40,40
1683634406262,LIFR 1C,A00,185961,Staff,6,0,20,14
1683634407286,LIFR 1CX,A00,185962,Staff,7,0,20,13
1683634408309,LIFR 1D,A00,185963,Staff,7,0,20,13
1683634409335,LIFR 1DX,A00,185964,Staff,7,0,20,13
1683634410361,LIGN 101,A01,186039,Staff,43,0,50,7
1683634411389,LIGN 165,A00,186040,Staff,15,0,50,35
1683634412421,LTCS 108,A00,186041,Staff,5,0,10,5
1683634413450,LTCS 119,A00,186042,Staff,15,0,20,5
1683634414478,LTCS 130,A00,186043,Wesling; Megan E.,15,0,25,10
1683634416532,LTEA 138,A00,186119,Staff,14,0,40,26
1683634417562,LTEN 124,A00,186148,Staff,6,0,25,19
1683634418589,LTEN 178,A00,186149,Staff,7,0,15,8
1683634419618,LTEN 181,A00,186150,Blanco; John D,34,0,40,6
1683634420643,LTWL 120,A00,186160,Staff,20,0,25,5
1683634421668,LTWL 165,A00,186161,Staff,22,0,25,3
1683634422693,LTWR 100,A00,186162,Staff,0,5,15,15
1683634423718,LTWR 102,A00,186163,Doller; Ben,5,0,15,10
1683634424743,MAE 8,A01,186412,Staff,0,0,0,0
1683634425768,MAE 30B,A00,186445,Bahadori; Mohammad Yousef,82,0,100,18
1683634426794,MAE 40,A00,186592,Bewley; Thomas R,10,0,50,40
1683634427823,MAE 101B,A00,186593,Bahadori; Mohammad Yousef,80,0,100,20
1683634428848,MAE 105,A00,186594,Bandaru; Prabhakar,10,0,50,40
1683634429876,MAE 107,A00,186599,Pham; Hieu Tan,0,7,120,120
1683634430901,MAE 148,A01,186660,Silberman; Jack,3,0,16,13
1683634431932,MATH 10A,A01,188095,Staff,0,5,35,35
1683634432959,MATH 10B,A01,188097,Bowers; Adam R.,0,11,30,30
1683634432959,MATH 10B,A02,188099,Bowers; Adam R.,0,11,30,30
1683634432959,MATH 10B,B01,188104,Bowers; Adam R.,0,10,30,30
1683634432959,MATH 10B,B02,188106,Bowers; Adam R.,1,9,30,29
1683634433987,MATH 10C,A01,188111,Staff,0,18,30,30
1683634433987,MATH 10C,A02,188127,Staff,0,19,30,30
1683634433987,MATH 10C,A03,188131,Staff,0,19,30,30
1683634433987,MATH 10C,B01,188218,Staff,17,0,30,13
1683634433987,MATH 10C,B02,188244,Staff,13,0,30,17
1683634433987,MATH 10C,B03,188277,Staff,14,0,30,16
1683634435012,MATH 18,A01,188344,Bach; Quang Tran,18,0,30,12
1683634435012,MATH 18,A02,188345,Bach; Quang Tran,11,0,30,19
1683634435012,MATH 18,B01,188353,Bach; Quang Tran,11,0,30,19
1683634435012,MATH 18,B02,188354,Bach; Quang Tran,19,0,30,11
1683634436039,MATH 20A,A01,188374,Staff,11,0,35,24
1683634437065,MATH 20B,A01,188382,Ohm; Ko Woon,7,0,30,23
1683634437065,MATH 20B,A02,188383,Ohm; Ko Woon,22,0,30,8
1683634437065,MATH 20B,B01,188385,Ohm; Ko Woon,7,0,30,23
1683634437065,MATH 20B,B02,188392,Ohm; Ko Woon,22,0,30,8
1683634438096,MATH 20C,A01,188394,Harel; Guershon,11,0,30,19
1683634438096,MATH 20C,A02,188395,Harel; Guershon,14,0,30,16
1683634438096,MATH 20C,B01,188404,Harel; Guershon,4,0,30,26
1683634438096,MATH 20C,B02,188405,Harel; Guershon,18,0,30,12
1683634439128,MATH 20D,A01,188414,Hammock; Frances H,0,1,30,30
1683634439128,MATH 20D,A02,188415,Hammock; Frances H,0,1,30,30
1683634439128,MATH 20D,B01,188447,Hammock; Frances H,0,1,30,30
1683634439128,MATH 20D,B02,188486,Hammock; Frances H,4,0,30,26
1683634440154,MATH 20E,A01,188649,Staff,21,0,30,9
1683634440154,MATH 20E,A02,188650,Staff,21,0,30,9
1683634440154,MATH 20E,A03,188673,Staff,0,0,30,30
1683634441178,MATH 102,A01,188675,Staff,0,36,35,35
1683634442205,MATH 103B,A01,188681,Staff,3,0,35,32
1683634442205,MATH 103B,B01,188692,Staff,5,0,35,30
1683634443233,MATH 109,A01,188695,Salehi Golsefidy; Alireza,24,0,35,11
1683634443233,MATH 109,A02,188696,Salehi Golsefidy; Alireza,25,0,35,10
1683634444258,MATH 120A,A01,188698,Eggers; John Dietrich,7,0,35,28
1683634445288,MATH 142B,A01,188736,Ioana; Adrian,0,1,30,30
1683634445288,MATH 142B,A02,188741,Ioana; Adrian,0,1,30,30
1683634445288,MATH 142B,A03,188743,Ioana; Adrian,0,1,30,30
1683634446313,MATH 168A,A01,188790,Staff,0,10,35,35
1683634447353,MATH 170A,A01,188803,Nie; Jiawang,0,2,35,35
1683634447353,MATH 170A,A02,188811,Nie; Jiawang,0,0,35,35
1683634447353,MATH 170A,A03,188814,Nie; Jiawang,0,0,35,35
1683634447353,MATH 170A,A04,188815,Nie; Jiawang,10,0,35,25
1683634448384,MATH 193B,A01,188817,Staff,0,0,35,35
1683634448384,MATH 193B,A02,188818,Staff,5,0,35,30
1683634449415,MGT 4,A01,202857,Anderson; John Charles,61,0,80,19
1683634450439,MGT 12,A00,202858,Lindenberger; Wade Douglas,40,0,90,50
1683634451466,MGT 18,A00,202859,Staff,74,0,90,16
1683634452490,MGT 18GS,A00,202860,McKay; Michael J,13,0,28,15
1683634453516,MGT 45,A00,202861,Pecore; Joseph P.,12,0,90,78
1683634454545,MGT 100,A00,202863,Yavorsky; Daniel Ryan,28,0,90,62
1683634455570,MGT 103,A00,202864,Ehrich; Kristine R,0,17,90,90
1683634456596,MGT 112,A00,202865,Ehrich; Kristine R,15,0,90,75
1683634457626,MGT 121A,A00,202868,Staff,0,20,0,0
1683634458651,MGT 131B,A00,202869,Anderson; John Charles,59,0,90,31
1683634459678,MGT 136,A00,202871,Lindenberger; Wade Douglas,83,0,90,7
1683634460702,MGT 164,A00,202873,Staff,0,66,90,91
1683634461731,MGT 164GS,A00,202874,McKay; Mary A,13,0,28,15
1683634462757,MGT 180,A00,202875,Staff,0,50,90,91
1683634463786,MMW 11R,A01,205019,Herbst; Matthew,2,0,30,28
1683634463786,MMW 11R,A02,205026,Herbst; Matthew,29,0,30,1
1683634464814,MMW 15,A01,193512,Chang; Edmond Yi-Teh,0,8,28,28
1683634464814,MMW 15,A02,193513,Chang; Edmond Yi-Teh,0,5,28,28
1683634464814,MMW 15,A03,193514,Chang; Edmond Yi-Teh,0,5,28,28
1683634464814,MMW 15,A04,193515,Chang; Edmond Yi-Teh,0,5,28,28
1683634464814,MMW 15,A05,193516,Chang; Edmond Yi-Teh,0,5,28,28
1683634464814,MMW 15,A06,193517,Chang; Edmond Yi-Teh,0,6,28,28
1683634464814,MMW 15,B01,193519,Chang; Edmond Yi-Teh,0,5,28,28
1683634464814,MMW 15,B02,193520,Chang; Edmond Yi-Teh,0,5,28,28
1683634464814,MMW 15,B03,193521,Chang; Edmond Yi-Teh,0,5,28,28
1683634464814,MMW 15,B04,193522,Chang; Edmond Yi-Teh,0,5,28,28
1683634464814,MMW 15,B05,193523,Chang; Edmond Yi-Teh,0,5,28,28
1683634464814,MMW 15,B06,193524,Chang; Edmond Yi-Teh,0,5,28,28
1683634465839,MMW 122,A01,193526,Rahimi; Babak,0,16,28,28
1683634465839,MMW 122,A02,193527,Rahimi; Babak,0,15,28,28
1683634465839,MMW 122,A03,193528,Rahimi; Babak,0,0,0,0
1683634465839,MMW 122,A04,193529,Rahimi; Babak,0,0,0,0
1683634466865,MUS 1A,A01,186663,Staff,1,20,35,34
1683634467890,MUS 4,A01,186715,Staff,0,12,35,35
1683634468923,MUS 5R,A01,186796,Dubnov; Shlomo,0,17,35,35
1683634469949,MUS 6,A01,186798,Staff,0,5,25,25
1683634470977,MUS 7,A01,186830,Staff,11,0,35,24
1683634472003,MUS 8,A01,186930,Staff,0,26,35,35
1683634473031,MUS 15,A01,186932,Staff,0,16,35,35
1683634473031,MUS 15,B01,186934,Staff,0,17,35,35
1683634474058,MUS 80,A00,186935,Staff,0,0,20,20
1683634474058,MUS 80,B00,186936,Staff,24,0,25,1
1683634475089,NANO 11,A00,204702,Lipomi; Darren John,0,0,0,0
1683634476122,NANO 15,A01,204709,Yang; Kesong,0,1,0,0
1683634477153,NANO 114,A00,202069,Jahed Motlagh; Zeinab,3,0,10,7
1683634478180,PHIL 1,A00,186955,Grush; Rick Scott,31,0,40,9
1683634479208,PHIL 10,A01,186973,Grush; Rick Scott,27,0,35,8
1683634479208,PHIL 10,A02,186974,Grush; Rick Scott,33,0,35,2
1683634480234,PHIL 13,A01,186976,Staff,3,0,35,32
1683634480234,PHIL 13,A02,186977,Staff,16,0,35,19
1683634481318,PHIL 14,A01,186979,Staff,31,0,35,4
1683634481318,PHIL 14,A02,186986,Staff,32,0,35,3
1683634482344,PHIL 28,A01,186988,Staff,16,0,30,14
1683634482344,PHIL 28,A02,186989,Staff,1,0,30,29
1683634482344,PHIL 28,A03,186990,Staff,10,0,30,20
1683634482344,PHIL 28,A04,186991,Staff,26,0,30,4
1683634483371,PHIL 120,A00,186997,Staff,23,0,40,17
1683634484396,PHIL 137,A00,187003,Staff,7,0,40,33
1683634485425,PHIL 150,A00,187015,Staff,47,0,70,23
1683634486452,PHIL 167,A00,187021,Lamey; Andy M.,34,0,40,6
1683634487476,PHIL 174,A01,202226,Staff,17,0,20,3
1683634487476,PHIL 174,A02,202235,Staff,20,0,20,0
1683634488504,PHIL 191A,A00,258918,Staff,0,0,1,1
1683634489530,PHYS 1A,A00,187028,Staff,27,0,60,33
1683634490555,PHYS 1AL,001,187036,Staff,3,0,30,27
1683634490555,PHYS 1AL,002,187049,Staff,18,0,30,12
1683634491579,PHYS 1B,A00,187058,Staff,22,0,60,38
1683634492605,PHYS 1BL,001,187064,Staff,0,1,30,30
1683634492605,PHYS 1BL,002,187070,Staff,4,0,30,26
1683634493634,PHYS 1C,A00,187082,Staff,29,0,120,91
1683634494662,PHYS 1CL,001,187088,Staff,0,9,30,30
1683634494662,PHYS 1CL,002,187089,Staff,0,1,30,30
1683634494662,PHYS 1CL,009,262693,Staff,9,0,30,21
1683634495687,PHYS 2B,A01,187097,Staff,55,0,115,60
1683634496716,PHYS 2C,A01,187099,Staff,64,0,115,51
1683634497741,PHYS 2CL,A01,187101,Staff,5,0,28,23
1683634497741,PHYS 2CL,A02,187102,Staff,15,0,28,13
1683634498766,PHYS 2D,A01,187123,Shotwell; Brian,95,0,115,20
1683634499796,PHYS 4B,A01,187133,Grinstein; Benjamin,35,0,50,15
1683634500827,POLI 10,A00,188819,Staff,0,4,50,50
1683634501853,POLI 11,A00,188827,Staff,43,0,50,7
1683634502878,POLI 13R,A00,188828,Staff,0,1,20,20
1683634503905,POLI 27,A01,188830,Elgin; Samuel Zincke,0,2,70,70
1683634504931,POLI 30,A00,188832,Desposato; Scott,30,0,50,20
1683634505955,POLI 102F,A00,188834,Staff,0,0,40,40
1683634506981,POLI 104A,A00,188852,Staff,13,0,30,17
1683634508011,POLI 104I,A00,188853,Staff,0,7,20,20
1683634509035,POLI 110B,A00,188854,Wiens; David,7,0,20,13
1683634510060,POLI 112A,A00,188855,Wiens; David,4,0,30,26
1683634511096,POLI 117R,A00,188856,Forman; Fonna,0,12,20,20
1683634512125,POLI 118,A00,188857,Ingham; Sean,8,0,20,12
1683634513150,POLI 120G,A00,188858,Staff,8,0,30,22
1683634514175,POLI 131CR,A00,188863,Hoston; Germaine,21,0,50,29
1683634515206,POLI 133,A00,188864,Nellis; Gareth Hb,44,0,50,6
1683634516231,POLI 134D,A00,188865,Desposato; Scott,27,0,30,3
1683634517259,POLI 142A,A00,188871,Gartzke; Erik,21,0,50,29
1683634518288,POLI 142K,A00,188874,Staff,38,0,50,12
1683634519313,POLI 143,A00,188940,Gartzke; Erik,16,0,30,14
1683634520338,POLI 153,A00,188943,Staff,2,0,20,18
1683634521363,POLI 160AA,A00,188944,Staff,11,0,40,29
1683634522391,POLI 170A,A00,188945,Staff,11,0,30,19
1683634524448,PSYC 1,A00,188952,Staff,36,0,90,54
1683634525473,PSYC 2,B00,188953,Staff,19,0,35,16
1683634526499,PSYC 6,A00,188970,Staff,47,0,60,13
1683634527527,PSYC 7,A00,188973,Staff,35,0,45,10
1683634528558,PSYC 60,A01,188980,Rickard; Timothy C.,42,0,60,18
1683634529586,PSYC 70,A01,189001,Steiner; Eric Tomas,23,0,45,22
1683634530612,PSYC 100,A00,189005,Lacefield; Katharine I,0,99,120,120
1683634531639,PSYC 102,A00,189008,Staff,8,0,30,22
1683634532663,PSYC 106,B00,189026,Gorman; Michael R.,27,0,60,33
1683634533688,PSYC 114,B01,189033,Winkielman; Piotr,0,31,30,30
1683634534714,PSYC 131,A00,189036,Anagnostaras; Stephan,0,43,60,60
1683634535739,PSYC 136,A00,189041,Lowe; Angela Beth,0,7,25,25
1683634536770,PSYC 137,A00,189057,Winkielman; Piotr,0,37,25,25
1683634537795,PSYC 144,A00,189107,Wixted; John T,0,10,50,50
1683634539853,PSYC 162,A00,189142,Staff,0,9,85,85
1683634540882,PSYC 172,A00,189144,Gorman; Michael R.,0,6,30,30
1683634542940,PSYC 179,A00,189146,Lacefield; Katharine I,0,86,120,120
1683634543964,PSYC 181,A00,189147,Anagnostaras; Stephan,0,44,90,90
1683634544990,PSYC 190R,A00,189148,Barner; David A.,0,23,80,80
1683634546017,PSYC 191,A00,189275,Rickard; Timothy C.,0,10,25,25
1683634547044,PSYC 193,A00,189276,Chapman; Eddie Nathaniel,0,1,0,4
1683634548074,PSYC 193L,A01,189281,Lowe; Angela Beth,10,0,20,10
1683634548074,PSYC 193L,B01,189285,Staff,28,0,35,7
1683634549102,RELI 149,A00,187137,Rahimi; Babak,7,0,40,33
1683634550128,SE 9,A01,187315,Staff,0,2,18,18
1683634551157,SE 101B,A00,187409,Staff,24,0,30,6
1683634552185,SE 110B,A00,187444,Staff,10,0,40,30
1683634553215,SE 130B,A00,187449,Staff,31,0,40,9
1683634554243,SE 150A,A00,187516,Staff,9,0,20,11
1683634555268,SE 154,A00,187528,Staff,29,0,50,21
1683634556296,SIO 3,A01,258171,Staff,35,0,40,5
1683634557322,SIO 10,A00,187144,Cook; Geoffrey W,0,6,75,75
1683634558349,SIO 45,A00,187152,Cook; Geoffrey W,0,4,100,100
1683634559374,SIO 109R,A00,194486,Staff,0,4,20,20
1683634561424,SIO 187,A01,187233,Kacev; David,12,0,40,28
1683634562455,SOCI 1,A01,258656,Thorpe; Charles Robert,28,0,30,2
1683634562455,SOCI 1,A02,258658,Thorpe; Charles Robert,30,0,30,0
1683634562455,SOCI 1,A03,258661,Thorpe; Charles Robert,25,0,25,0
1683634562455,SOCI 1,A04,258666,Thorpe; Charles Robert,22,0,25,3
1683634562455,SOCI 1,A05,258897,Thorpe; Charles Robert,22,0,25,3
1683634562455,SOCI 1,A06,258898,Thorpe; Charles Robert,25,0,25,0
1683634563485,SOCI 30,A01,258903,Pardo Guerra; Juan Pablo,14,0,30,16
1683634564524,SOCI 102,A00,258904,Staff,9,0,25,16
1683634565549,SOCI 106,A00,258905,Staff,19,0,25,6
1683634566578,SOCI 111,A00,258907,Ribas Norris; Janet Vanesa,26,0,30,4
1683634567607,SOCI 121R,A00,258908,Pardo Guerra; Juan Pablo,8,0,30,22
1683634568632,SOCI 126,A01,203330,Staff,14,0,20,6
1683634569657,SOCI 131,A00,258909,Thorpe; Charles Robert,30,0,60,30
1683634570682,SOCI 135,A00,258910,Payne; Christine Anna,0,11,30,30
1683634571710,SOCI 157,A00,258911,Staff,12,0,30,18
1683634572739,SOCI 184,A00,258912,Staff,25,0,30,5
1683634573763,SOCI 188D,A00,258913,Staff,22,0,30,8
1683634574789,SYN 2,001,187529,Staff,9,0,16,7
1683634574789,SYN 2,002,201452,Staff,0,20,16,16
1683634574789,SYN 2,003,201469,Staff,2,0,16,14
1683634575820,SYN 100,A01,187531,Staff,0,9,20,20
1683634575820,SYN 100,B01,201491,Staff,0,10,20,20
1683634576846,TDAC 1,A00,189286,Walsh; Kim C.,3,0,20,17
1683634576846,TDAC 1,B00,189287,Harting; Carla Kelso,10,0,20,10
1683634577871,TDAC 101,A00,189300,Walsh; Kim C.,16,0,20,4
1683634577871,TDAC 101,B00,189301,Harting; Carla Kelso,18,0,20,2
1683634578897,TDAC 102,A00,189304,Basso; Beatrice,14,0,20,6
1683634579926,TDAC 108,A00,189305,Staff,18,0,20,2
1683634580957,TDDE 131,A00,189310,Staff,19,0,20,1
1683634580957,TDDE 131,B00,189314,Staff,19,0,20,1
1683634580957,TDDE 131,C00,189315,Staff,48,0,50,2
1683634580957,TDDE 131,D00,189316,Staff,14,0,15,1
1683634580957,TDDE 131,E00,204841,Staff,20,0,20,0
1683634581982,TDGE 10,A00,189289,Staff,28,0,50,22
1683634581982,TDGE 10,B00,189290,Havis; Allan,0,0,50,50
1683634583009,TDGE 11,A00,189291,Fulton; Julia,0,4,50,50
1683634583009,TDGE 11,B00,189292,Staff,20,0,25,5
1683634583009,TDGE 11,C00,260270,Staff,0,0,0,0
1683634584033,TDGE 25,A00,189294,Staff,2,0,20,18
1683634585120,TDGE 124,A00,189318,Fulton; Julia,0,8,50,50
1683634586145,TDGE 125,A00,189319,Staff,13,0,25,12
1683634586145,TDGE 125,B00,189320,Staff,23,0,25,2
1683634587169,TDGE 127,A00,189322,Havis; Allan,0,0,50,50
1683634588198,TDHT 101,A00,189323,Staff,18,0,25,7
1683634588198,TDHT 101,B00,189324,Staff,25,0,25,0
1683634589222,TDHT 102,A00,189325,Staff,49,0,50,1
1683634590248,TDMV 1,A00,189295,Arcidiacono; Kristin,20,0,30,10
1683634590248,TDMV 1,B00,189296,Caligagan; Maria T.,24,0,30,6
1683634591278,TDMV 2,A00,189297,Sammartano; Tonnie,27,0,30,3
1683634591278,TDMV 2,B00,189299,Arcidiacono; Kristin,23,0,30,7
1683634592304,TDMV 3,A00,204998,Rincon; Alicia,22,0,30,8
1683634593332,TDMV 120,A00,189458,Sammartano; Tonnie,28,0,30,2
1683634594359,TDMV 138,A00,189541,Jun; Grace Shin Hae,20,0,40,20
1683634595388,TDMV 142,A00,189717,Caligagan; Tony,25,0,30,5
1683634595388,TDMV 142,B00,189718,Caligagan; Maria T.,25,0,30,5
1683634596417,TMC 2,A01,187533,Staff,25,0,25,0
1683634596417,TMC 2,A02,187534,Staff,25,0,25,0
1683634597446,USP 1,A01,187536,Kwak; Nancy,0,16,25,25
1683634598471,USP 5,A01,187538,Staff,9,0,25,16
1683634599499,USP 101,A00,199253,Staff,0,4,0,0
1683634600524,USP 124,A00,187562,Boomhower; Matthew Charles,0,0,30,30
1683634601562,USP 138,A00,187582,Staff,20,0,25,5
1683634602587,USP 152,A01,187597,Staff,3,0,25,22
1683634603612,USP 153,A00,187598,Staff,19,0,25,6
1683634604637,USP 168,A00,187607,Kwak; Nancy,2,0,5,3
1683634605666,USP 173,A00,187619,Staff,4,0,25,21
1683634606692,USP 181,A00,187638,Staff,0,4,25,25
1683634607724,VIS 103,A00,187650,Cruz; Edwin Teddy,18,0,75,57
1683634608752,VIS 110D,A00,187669,Staff,13,0,22,9
1683634609778,VIS 127C,A00,187720,Shen; Kuiyi,67,0,146,79
1683634610804,VIS 149,A00,187731,Yoldas; Pinar,0,14,22,22
1683634611829,VIS 151,A01,188091,Staff,22,0,34,12
1683634611829,VIS 151,A02,188092,Staff,11,0,34,23
1683634612856,VIS 160B,A00,188093,Stalbaum; Brett,0,1,10,10
1683634614908,WCWP 10B,A00,201720,Staff,10,0,15,5
1683634614908,WCWP 10B,B00,201722,Staff,9,0,15,6
1683634615938,WCWP 100,A00,201725,Gagnon; Jeffrey C,0,0,2,2
1683634615938,WCWP 100,B00,201727,Staff,0,4,15,15
1683634619072,ANBI 133,A00,258401,Wilder; Linnea Lorene,34,0,40,6
1683634620100,ANBI 140,A00,258395,Hrvoj Mihic; Branka,18,0,25,7
1683634621139,ANSC 120,A00,258402,Bialecki; Jon Anthony,27,0,40,13
1683634622168,ANSC 144,A00,258400,Staff,12,0,40,28
1683634624231,ANSC 166,A00,258396,Parish; Steven Martin,156,0,175,19
1683634625268,ANSC 180,A00,193533,Staff,8,0,20,12
1683634626294,ANSC 188,A00,258397,Jassal; Aftab,34,0,40,6
1683634627322,ANTH 3,A01,258316,Staff,23,0,30,7
1683634628348,ANTH 5,A00,258394,Semendeferi; Ekaterini,16,0,20,4
1683634629385,ANTH 21,A01,258331,Staff,4,0,40,36
1683634630413,ANTH 103,A00,258398,Varma; Saiba,15,0,25,10
1683634631443,AWP 10,001,202034,Staff,0,0,0,0
1683634631443,AWP 10,002,202035,Staff,0,0,0,0
1683634631443,AWP 10,003,202036,Staff,0,0,0,0
1683634631443,AWP 10,004,202037,Staff,0,0,0,0
1683634631443,AWP 10,005,202038,Staff,0,0,0,0
1683634631443,AWP 10,006,202039,Staff,0,0,0,0
1683634631443,AWP 10,007,202040,Staff,0,0,0,0
1683634631443,AWP 10,008,202041,Staff,0,0,0,0
1683634631443,AWP 10,009,202042,Staff,0,0,0,0
1683634631443,AWP 10,010,202043,Staff,0,0,0,0
1683634631443,AWP 10,011,202044,Staff,0,0,0,0
1683634631443,AWP 10,012,202045,Staff,0,0,0,0
1683634631443,AWP 10,013,202046,Staff,0,0,0,0
1683634631443,AWP 10,014,202047,Staff,0,0,0,0
1683634631443,AWP 10,015,202048,Staff,0,0,0,0
1683634631443,AWP 10,016,202049,Staff,0,0,0,0
1683634631443,AWP 10,017,202050,Staff,0,0,0,0
1683634631443,AWP 10,018,202051,Staff,0,0,0,0
1683634631443,AWP 10,019,202052,Staff,0,0,0,0
1683634631443,AWP 10,020,202053,Staff,0,0,0,0
1683634631443,AWP 10,021,202054,Staff,0,0,0,0
1683634631443,AWP 10,022,202055,Staff,0,0,0,0
1683634631443,AWP 10,023,202056,Staff,0,0,0,0
1683634631443,AWP 10,024,202057,Staff,0,0,0,0
1683634631443,AWP 10,025,202058,Staff,0,0,0,0
1683634631443,AWP 10,026,202059,Staff,0,0,0,0
1683634632468,AWP 102,001,202032,Staff,0,0,0,0
1683634632468,AWP 102,002,202033,Staff,0,0,0,0
1683634633495,BENG 100,A01,254234,Taylor Amos; Alyssa C,31,0,40,9
1683634634520,BENG 196,001,270013,Engler; Adam J.,9999,0,9999,0
1683634635548,BICD 100R,A01,202018,Smith; Laurie,0,7,32,32
1683634635548,BICD 100R,A02,202019,Smith; Laurie,0,3,32,32
1683634635548,BICD 100R,A03,202020,Smith; Laurie,0,1,32,32
1683634635548,BICD 100R,A04,202021,Smith; Laurie,6,0,32,26
1683634635548,BICD 100R,A05,202022,Smith; Laurie,11,0,32,21
1683634636575,BICD 136,A01,193242,Gustafson-Brown; Cindy,0,2,32,32
1683634636575,BICD 136,A02,193244,Gustafson-Brown; Cindy,13,0,32,19
1683634637603,BIEB 102,A01,193249,Butler; Shannon Rhey,0,2,32,32
1683634637603,BIEB 102,A02,193251,Butler; Shannon Rhey,0,0,32,32
1683634637603,BIEB 102,A03,193253,Butler; Shannon Rhey,0,0,32,32
1683634637603,BIEB 102,A04,193255,Butler; Shannon Rhey,14,0,32,18
1683634637603,BIEB 102,A05,193265,Butler; Shannon Rhey,26,0,32,6
1683634637603,BIEB 102,A06,193269,Butler; Shannon Rhey,14,0,32,18
1683634639656,BIEB 150,A01,193274,Staff,0,0,32,32
1683634639656,BIEB 150,A02,193285,Staff,24,0,32,8
1683634640686,BIEB 194,A00,193286,Kurle; Carolyn M.,20,0,32,12
1683634641711,BILD 1,A01,192291,Staff,15,0,32,17
1683634641711,BILD 1,A02,192292,Staff,30,0,32,2
1683634641711,BILD 1,B01,192520,Reuther; Keefe,0,1,0,0
1683634641711,BILD 1,B02,192532,Reuther; Keefe,0,1,0,0
1683634642739,BILD 3,A01,192556,Butler; Shannon Rhey,0,0,32,32
1683634642739,BILD 3,A02,192581,Butler; Shannon Rhey,1,0,32,31
1683634642739,BILD 3,A03,192611,Butler; Shannon Rhey,21,0,32,11
1683634642739,BILD 3,A04,192612,Butler; Shannon Rhey,24,0,32,8
1683634642739,BILD 3,A05,192613,Butler; Shannon Rhey,26,0,32,6
1683634642739,BILD 3,A06,192679,Butler; Shannon Rhey,27,0,32,5
1683634642739,BILD 3,A07,192682,Butler; Shannon Rhey,20,0,32,12
1683634643764,BILD 4,A01,192836,Reuther; Keefe,0,0,24,24
1683634643764,BILD 4,A02,193044,Reuther; Keefe,4,0,24,20
1683634644790,BILD 10,A01,193142,Gustafson-Brown; Cindy,29,0,32,3
1683634644790,BILD 10,A02,193149,Gustafson-Brown; Cindy,31,0,32,1
1683634645818,BIMM 100,A01,193301,Staff,0,6,32,32
1683634645818,BIMM 100,A02,193312,Staff,0,7,32,32
1683634645818,BIMM 100,A03,193323,Staff,0,9,32,32
1683634646849,BIMM 101,A01,193329,McDonnell; Lisa Marie,0,4,24,24
1683634646849,BIMM 101,A02,193339,McDonnell; Lisa Marie,0,3,24,24
1683634646849,BIMM 101,B01,193354,McDonnell; Lisa Marie,0,4,24,24
1683634646849,BIMM 101,B02,193357,McDonnell; Lisa Marie,0,2,24,24
1683634647879,BIMM 110,A01,193377,Tat; John,0,11,32,32
1683634647879,BIMM 110,A02,193378,Tat; John,0,10,32,32
1683634648911,BIMM 120,A01,206116,Staff,0,0,32,32
1683634648911,BIMM 120,A02,206117,Staff,6,0,32,26
1683634648911,BIMM 120,A03,206121,Staff,21,0,32,11
1683634649938,BIPN 100,A01,193393,Park; Ji Young,0,14,32,32
1683634649938,BIPN 100,A02,193402,Park; Ji Young,0,14,32,32
1683634649938,BIPN 100,A03,193413,Park; Ji Young,0,14,32,32
1683634649938,BIPN 100,A04,193414,Park; Ji Young,0,13,32,32
1683634650966,BIPN 102,A01,193429,Staff,0,0,32,32
1683634650966,BIPN 102,A02,193438,Staff,18,0,32,14
1683634651996,BIPN 106,A01,193450,Reyes Gonzalez; Catalina,0,2,40,40
1683634653031,BIPN 134,A01,193465,Cooke; James Edward,0,0,32,32
1683634653031,BIPN 134,A02,193474,Cooke; James Edward,25,0,32,7
1683634653031,BIPN 134,A03,193485,Cooke; James Edward,29,0,32,3
1683634653031,BIPN 134,A04,193486,Cooke; James Edward,20,0,32,12
1683634653031,BIPN 134,A05,193491,Cooke; James Edward,31,0,32,1
1683634653031,BIPN 134,A06,193501,Cooke; James Edward,30,0,32,2
1683634653031,BIPN 134,A07,193510,Cooke; James Edward,29,0,32,3
1683634655093,BISP 194,A00,222522,Staff,14,0,32,18
1683634656118,CAT 124,A01,202407,Staff,19,0,25,6
1683634657147,CAT 125,A00,202408,Marchisotto; Jennifer Anne,2,0,20,18
1683634658174,CAT 125R,A00,202409,Smith; Lauryn Alissa,0,11,20,20
1683634658174,CAT 125R,B00,202410,Morales; Celeste Georgianna,0,11,20,20
1683634658174,CAT 125R,C00,202411,Irwin; Matthew Joseph,0,12,20,20
1683634659201,CENG 15,A01,204712,Yang; Kesong,0,1,0,0
1683634660232,CENG 114,A00,202070,Jahed Motlagh; Zeinab,5,0,20,15
1683634661262,CGS 105,A00,185477,Wesling; Megan E.,24,0,40,16
1683634662289,CGS 106,A00,185494,Staff,11,0,22,11
1683634663314,CGS 108,A00,185495,Staff,14,0,20,6
1683634664338,CGS 114,A00,185496,Staff,13,0,18,5
1683634665364,CGS 119,A00,185501,Staff,15,0,20,5
1683634666388,CGS 120,A00,185511,Staff,12,0,20,8
1683634667419,CHEM 4,A01,184675,Bussey; Thomas J,97,0,100,3
1683634668448,CHEM 6A,A01,184677,Staff,33,0,60,27
1683634669474,CHEM 6B,A01,184679,Staff,63,0,100,37
1683634670504,CHEM 6C,A01,184681,Bussey; Thomas J,0,0,50,50
1683634670504,CHEM 6C,A02,184682,Bussey; Thomas J,32,0,50,18
1683634671529,CHEM 40A,A01,184684,Albizati; Kim F.,35,0,100,65
1683634672554,CHEM 40B,A01,184686,Albizati; Kim F.,0,22,100,100
1683634673579,CHEM 41B,A01,184690,Staff,51,0,100,49
1683634674606,COGS 3,A01,184715,Boyle; Mary E. T.,0,27,40,40
1683634675631,COGS 14B,A01,185172,Staff,0,14,38,38
1683634676660,COGS 18,A01,184736,Staff,15,0,80,65
1683634677690,COGS 100,A01,184932,Staff,0,7,73,73
1683634678716,COGS 101A,A01,184935,Staff,0,39,30,30
1683634679746,COGS 101B,A01,184944,Staff,0,2,30,30
1683634680774,COGS 101C,A01,184946,Staff,0,10,30,30
1683634681803,COGS 102A,A01,184951,Johnson; Christine M.,2,0,40,38
1683634682838,COGS 107B,A01,184953,Mooshagian; Eric Frederick,0,51,40,40
1683634683864,COGS 118B,A01,184959,Gupta; Anjum,0,49,40,40
1683634684890,COGS 153,A00,184961,Staff,0,16,30,30
1683634685918,COGS 177,A00,184962,Staff,0,21,30,30
1683634686943,COGS 187A,A01,184969,Boyle; Mary E. T.,0,19,40,40
1683634687976,COMM 10,A01,185174,Staff,0,5,25,25
1683634687976,COMM 10,A02,185189,Staff,0,2,25,25
1683634687976,COMM 10,A03,269821,Staff,0,1,0,0
1683634689078,COMM 100B,A01,185475,Staff,0,1,0,2
1683634689078,COMM 100B,A02,185476,Staff,12,0,25,13
1683634690108,COMM 100C,A01,185314,Staff,1,0,25,24
1683634690108,COMM 100C,A02,185327,Staff,18,0,25,7
1683634691141,COMM 110M,A00,185349,Staff,0,0,40,40
1683634692169,COMM 113T,A00,185352,Staff,25,0,40,15
1683634693196,COMM 114I,A00,185353,Staff,31,0,40,9
1683634694225,COMM 131,A00,185354,Staff,17,0,30,13
1683634695255,CSE 8A,A50,185358,Cao; Yingjun,0,46,10,10
1683634696283,CSE 8B,A01,185362,Staff,0,48,50,50
1683634697308,CSE 11,A01,185416,Cao; Yingjun,0,91,10,10
1683634698332,CSE 20,A01,185445,Briones; Jor-el Thomas Caparas,4,0,25,21
1683634699360,CSE 21,A01,185447,Staff,9,0,50,41
1683634700386,CSE 101,A01,185451,Staff,0,13,50,50
1683634700386,CSE 101,B01,185453,Jones; Miles E,0,13,50,50
1683634702445,CSE 141,A01,185458,Eldon; John,15,0,100,85
1683634703474,CSE 141L,A01,185461,Eldon; John,7,0,100,93
1683634704504,CSE 142,A01,185463,Staff,36,0,60,24
1683634704504,CSE 142,B01,201355,Staff,0,7,60,60
1683634705532,CSE 142L,A01,185470,Staff,36,0,60,24
1683634705532,CSE 142L,B01,201417,Staff,0,6,60,60
1683634706564,CSE 190,A00,201433,Staff,32,0,49,17
1683634707591,DOC 1,A01,259136,Strom; Megan C.,7,0,15,8
1683634707591,DOC 1,A02,259137,Strom; Megan C.,14,0,15,1
1683634707591,DOC 1,A03,259138,Strom; Megan C.,14,0,15,1
1683634707591,DOC 1,A04,259139,Strom; Megan C.,14,0,15,1
1683634708616,DOC 100D,A00,259140,Pass; Natalye Joann,14,0,25,11
1683634709644,DSGN 1,A01,184749,Rill; Bryan,0,26,30,30
1683634710669,DSGN 100,A01,185168,Staff,0,2,25,25
1683634711700,ECE 5,A01,185626,Morris; Karcher William,0,11,0,0
1683634712727,ECE 101,A01,185628,Staff,14,0,70,56
1683634713752,ECE 107,A01,185635,Baghdadchi; Saharnaz,0,0,20,20
1683634713752,ECE 107,A02,185638,Baghdadchi; Saharnaz,3,0,20,17
1683634714777,ECE 148,A01,185647,Silberman; Jack,0,0,16,16
1683634715802,ECON 1,A01,185537,Crane; Meredith Helen,54,0,70,16
1683634716828,ECON 3,A01,185549,Crane; Meredith Helen,29,0,70,41
1683634717855,ECON 4,A01,203354,Anderson; John Charles,0,5,10,10
1683634718882,ECON 100A,A01,185574,Staff,0,5,40,40
1683634719907,ECON 100B,A01,185576,Staff,0,12,50,50
1683634720937,ECON 100C,A01,185589,Newhouse; Herbert S,30,0,70,40
1683634721967,ECON 105,A00,185608,Vespa; Emanuel Ignacio,19,0,35,16
1683634722993,ECON 109,A01,185610,Shishkin; Denis,9,0,35,26
1683634724017,ECON 110A,A01,185612,Staff,9,0,40,31
1683634725045,ECON 120A,A01,185615,Staff,20,0,40,20
1683634726071,ECON 120C,A01,185617,Sun; Yixiao,0,20,70,70
1683634727098,ECON 144,A00,203346,Squires; Dale E,2,0,35,33
1683634728125,ECON 171,A01,203349,Newhouse; Herbert S,0,1,35,35
1683634729150,ECON 173A,A01,185621,Toda; Alexis Akira,21,0,35,14
1683634730183,EDS 25,A01,202413,Staff,0,1,0,0
1683634730183,EDS 25,A02,202414,Staff,0,1,0,0
1683634730183,EDS 25,A03,202415,Staff,0,0,0,0
1683634730183,EDS 25,A04,202416,Staff,0,1,0,0
1683634730183,EDS 25,A05,202439,Staff,0,0,0,0
1683634730183,EDS 25,A06,202440,Staff,0,0,0,0
1683634730183,EDS 25,B01,202631,Staff,0,0,0,0
1683634730183,EDS 25,B02,202632,Staff,0,0,0,0
1683634730183,EDS 25,B03,202639,Staff,0,0,0,0
1683634730183,EDS 25,B04,202640,Staff,0,0,0,0
1683634730183,EDS 25,B05,202643,Staff,0,0,0,0
1683634730183,EDS 25,B06,202644,Staff,0,0,0,0
1683634731208,EDS 38,A01,202659,Black; Alison Michelle,24,0,25,1
1683634732235,EDS 115,A00,202652,Staff,18,0,30,12
1683634733261,EDS 125,A00,202649,Staff,13,0,30,17
1683634734291,EDS 126,A01,203332,Staff,30,0,30,0
1683634735321,EDS 139,A00,202838,Staff,16,0,25,9
1683634736348,EDS 146,A01,202655,Staff,14,0,25,11
1683634737378,ENG 15,A00,185667,Staff,0,1,0,0
1683634737378,ENG 15,B00,185672,Staff,0,0,0,0
1683634737378,ENG 15,C00,185675,Staff,0,0,0,0
1683634737378,ENG 15,D00,185682,Staff,0,0,0,0
1683634737378,ENG 15,E00,185684,Staff,0,0,0,0
1683634738402,ETHN 103,A00,185710,Staff,0,8,35,35
1683634739427,ETHN 103A,A00,199228,Man; Simeon S,0,0,9,9
1683634740456,ETHN 109,A00,185711,Staff,16,0,35,19
1683634741486,ETHN 142,A00,185726,Staff,0,4,30,30
1683634742512,ETHN 163J,A00,199229,Man; Simeon S,5,0,8,3
1683634743540,ETHN 168,A00,185727,Staff,7,0,10,3
1683634744568,ETHN 182,A00,185728,Staff,0,0,35,35
1683634745595,ETHN 183,A00,185737,Staff,9,0,18,9
1683634746621,GLBH 111,A01,209361,Burgos; Jose L.,0,0,0,0
1683634748675,HIEU 104,A00,185792,Staff,14,0,20,6
1683634749700,HIEU 115,A00,185800,Staff,0,0,20,20
1683634750725,HIEU 128,A00,185801,Staff,0,9,20,20
1683634751753,HIEU 147,A00,185802,Staff,15,0,20,5
1683634752780,HIEU 154,A00,185823,Staff,11,0,20,9
1683634753806,HILA 102,A00,185826,Staff,14,0,20,6
1683634754834,HILD 2C,A01,185778,Staff,0,13,20,20
1683634755865,HILD 7B,A01,185780,Kwak; Nancy,0,16,32,32
1683634755865,HILD 7B,A02,185781,Kwak; Nancy,0,18,32,32
1683634756892,HILD 30,A01,185791,Staff,12,0,20,8
1683634757918,HISC 119,A00,185830,Golan; Tal,0,9,20,20
1683634758947,HITO 156GS,A00,185831,Patterson; Patrick H.,0,0,0,23
1683634759974,HIUS 103,A00,185832,Man; Simeon S,0,4,20,20
1683634760999,HIUS 117,A00,185836,Kwak; Nancy,2,0,20,18
1683634762026,HIUS 125,A00,185840,Man; Simeon S,0,1,23,23
1683634763051,HIUS 149,A00,185845,Staff,1,0,20,19
1683634764077,HUM 3,A01,185882,Zavodny; Tatiana Sophia,0,7,50,50
1683634764077,HUM 3,B01,185899,Caldwell; Michael Alan,0,18,50,50
1683634765105,HUM 3GS,A00,185900,Patterson; Patrick H.,0,0,0,23
1683634766137,HUM 4,A01,185938,Zroka; Amy Liane,30,0,50,20
1683634766137,HUM 4,B01,185956,Watkins; Eric,0,4,50,50
1683634766137,HUM 4,B02,202209,Watkins; Eric,0,4,50,50
1683634766137,HUM 4,B03,202210,Watkins; Eric,0,4,50,50
1683634767164,HUM 5,A01,185958,West; Geoffrey Scott,2,0,50,48
1683634767164,HUM 5,A02,202215,West; Geoffrey Scott,0,0,50,50
1683634768189,INTL 190,A00,185959,Gagnon; Jeffrey C,0,0,0,9
1683634768189,INTL 190,B00,185960,Lettieri; Michael Joseph,0,0,0,2
1683634769218,JAPN 180,A00,254509,Staff,5,0,30,25
1683634770244,LATI 10,A01,202853,Kennemore; Amy Michelle,4,0,35,31
1683634770244,LATI 10,A02,202854,Kennemore; Amy Michelle,2,0,35,33
1683634770244,LATI 10,A03,270054,Kennemore; Amy Michelle,30,0,30,0
1683634771268,LATI 180,A00,202855,Kennemore; Amy Michelle,11,0,20,9
1683634772298,LAWS 101,A00,201767,Golan; Tal,0,7,40,40
1683634773325,LIFR 1C,A00,185961,Staff,6,0,20,14
1683634774353,LIFR 1CX,A00,185962,Staff,7,0,20,13
1683634775380,LIFR 1D,A00,185963,Staff,7,0,20,13
1683634776405,LIFR 1DX,A00,185964,Staff,7,0,20,13
1683634777429,LIGN 101,A01,186039,Staff,43,0,50,7
1683634778456,LIGN 165,A00,186040,Staff,15,0,50,35
1683634779481,LTCS 108,A00,186041,Staff,5,0,10,5
1683634780506,LTCS 119,A00,186042,Staff,15,0,20,5
1683634781532,LTCS 130,A00,186043,Wesling; Megan E.,15,0,25,10
1683634783585,LTEA 138,A00,186119,Staff,14,0,40,26
1683634784613,LTEN 124,A00,186148,Staff,6,0,25,19
1683634785638,LTEN 178,A00,186149,Staff,7,0,15,8
1683634786666,LTEN 181,A00,186150,Blanco; John D,34,0,40,6
1683634787695,LTWL 120,A00,186160,Staff,20,0,25,5
1683634788721,LTWL 165,A00,186161,Staff,22,0,25,3
1683634789759,LTWR 100,A00,186162,Staff,0,5,15,15
1683634790784,LTWR 102,A00,186163,Doller; Ben,5,0,15,10
1683634791814,MAE 8,A01,186412,Staff,0,0,0,0
1683634792904,MAE 30B,A00,186445,Bahadori; Mohammad Yousef,82,0,100,18
1683634793929,MAE 40,A00,186592,Bewley; Thomas R,10,0,50,40
1683634794957,MAE 101B,A00,186593,Bahadori; Mohammad Yousef,80,0,100,20
1683634795981,MAE 105,A00,186594,Bandaru; Prabhakar,10,0,50,40
1683634797007,MAE 107,A00,186599,Pham; Hieu Tan,0,7,120,120
1683634798036,MAE 148,A01,186660,Silberman; Jack,3,0,16,13
1683634799067,MATH 10A,A01,188095,Staff,0,5,35,35
1683634800097,MATH 10B,A01,188097,Bowers; Adam R.,0,11,30,30
1683634800097,MATH 10B,A02,188099,Bowers; Adam R.,0,11,30,30
1683634800097,MATH 10B,B01,188104,Bowers; Adam R.,0,10,30,30
1683634800097,MATH 10B,B02,188106,Bowers; Adam R.,1,9,30,29
1683634801123,MATH 10C,A01,188111,Staff,0,18,30,30
1683634801123,MATH 10C,A02,188127,Staff,0,19,30,30
1683634801123,MATH 10C,A03,188131,Staff,0,19,30,30
1683634801123,MATH 10C,B01,188218,Staff,17,0,30,13
1683634801123,MATH 10C,B02,188244,Staff,13,0,30,17
1683634801123,MATH 10C,B03,188277,Staff,14,0,30,16
1683634802154,MATH 18,A01,188344,Bach; Quang Tran,18,0,30,12
1683634802154,MATH 18,A02,188345,Bach; Quang Tran,11,0,30,19
1683634802154,MATH 18,B01,188353,Bach; Quang Tran,11,0,30,19
1683634802154,MATH 18,B02,188354,Bach; Quang Tran,19,0,30,11
1683634803186,MATH 20A,A01,188374,Staff,11,0,35,24
1683634804236,MATH 20B,A01,188382,Ohm; Ko Woon,7,0,30,23
1683634804236,MATH 20B,A02,188383,Ohm; Ko Woon,22,0,30,8
1683634804236,MATH 20B,B01,188385,Ohm; Ko Woon,7,0,30,23
1683634804236,MATH 20B,B02,188392,Ohm; Ko Woon,22,0,30,8
1683634805261,MATH 20C,A01,188394,Harel; Guershon,11,0,30,19
1683634805261,MATH 20C,A02,188395,Harel; Guershon,14,0,30,16
1683634805261,MATH 20C,B01,188404,Harel; Guershon,4,0,30,26
1683634805261,MATH 20C,B02,188405,Harel; Guershon,18,0,30,12
1683634806288,MATH 20D,A01,188414,Hammock; Frances H,0,1,30,30
1683634806288,MATH 20D,A02,188415,Hammock; Frances H,0,1,30,30
1683634806288,MATH 20D,B01,188447,Hammock; Frances H,0,1,30,30
1683634806288,MATH 20D,B02,188486,Hammock; Frances H,4,0,30,26
1683634807314,MATH 20E,A01,188649,Staff,21,0,30,9
1683634807314,MATH 20E,A02,188650,Staff,21,0,30,9
1683634807314,MATH 20E,A03,188673,Staff,0,0,30,30
1683634808343,MATH 102,A01,188675,Staff,0,36,35,35
1683634809373,MATH 103B,A01,188681,Staff,3,0,35,32
1683634809373,MATH 103B,B01,188692,Staff,5,0,35,30
1683634810402,MATH 109,A01,188695,Salehi Golsefidy; Alireza,24,0,35,11
1683634810402,MATH 109,A02,188696,Salehi Golsefidy; Alireza,25,0,35,10
1683634811431,MATH 120A,A01,188698,Eggers; John Dietrich,7,0,35,28
1683634812457,MATH 142B,A01,188736,Ioana; Adrian,0,1,30,30
1683634812457,MATH 142B,A02,188741,Ioana; Adrian,0,1,30,30
1683634812457,MATH 142B,A03,188743,Ioana; Adrian,0,1,30,30
1683634813486,MATH 168A,A01,188790,Staff,0,10,35,35
1683634814517,MATH 170A,A01,188803,Nie; Jiawang,0,2,35,35
1683634814517,MATH 170A,A02,188811,Nie; Jiawang,0,0,35,35
1683634814517,MATH 170A,A03,188814,Nie; Jiawang,0,0,35,35
1683634814517,MATH 170A,A04,188815,Nie; Jiawang,10,0,35,25
1683634815542,MATH 193B,A01,188817,Staff,0,0,35,35
1683634815542,MATH 193B,A02,188818,Staff,5,0,35,30
1683634816571,MGT 4,A01,202857,Anderson; John Charles,61,0,80,19
1683634817597,MGT 12,A00,202858,Lindenberger; Wade Douglas,40,0,90,50
1683634818626,MGT 18,A00,202859,Staff,74,0,90,16
1683634819654,MGT 18GS,A00,202860,McKay; Michael J,13,0,28,15
1683634820683,MGT 45,A00,202861,Pecore; Joseph P.,12,0,90,78
1683634821708,MGT 100,A00,202863,Yavorsky; Daniel Ryan,28,0,90,62
1683634822733,MGT 103,A00,202864,Ehrich; Kristine R,0,17,90,90
1683634823761,MGT 112,A00,202865,Ehrich; Kristine R,15,0,90,75
1683634824790,MGT 121A,A00,202868,Staff,0,20,0,0
1683634825815,MGT 131B,A00,202869,Anderson; John Charles,59,0,90,31
1683634826840,MGT 136,A00,202871,Lindenberger; Wade Douglas,83,0,90,7
1683634827868,MGT 164,A00,202873,Staff,0,66,90,91
1683634828896,MGT 164GS,A00,202874,McKay; Mary A,13,0,28,15
1683634829926,MGT 180,A00,202875,Staff,0,50,90,91
1683634830951,MMW 11R,A01,205019,Herbst; Matthew,2,0,30,28
1683634830951,MMW 11R,A02,205026,Herbst; Matthew,29,0,30,1
1683634831978,MMW 15,A01,193512,Chang; Edmond Yi-Teh,0,8,28,28
1683634831978,MMW 15,A02,193513,Chang; Edmond Yi-Teh,0,5,28,28
1683634831978,MMW 15,A03,193514,Chang; Edmond Yi-Teh,0,5,28,28
1683634831978,MMW 15,A04,193515,Chang; Edmond Yi-Teh,0,5,28,28
1683634831978,MMW 15,A05,193516,Chang; Edmond Yi-Teh,0,5,28,28
1683634831978,MMW 15,A06,193517,Chang; Edmond Yi-Teh,0,6,28,28
1683634831978,MMW 15,B01,193519,Chang; Edmond Yi-Teh,0,5,28,28
1683634831978,MMW 15,B02,193520,Chang; Edmond Yi-Teh,0,5,28,28
1683634831978,MMW 15,B03,193521,Chang; Edmond Yi-Teh,0,5,28,28
1683634831978,MMW 15,B04,193522,Chang; Edmond Yi-Teh,0,5,28,28
1683634831978,MMW 15,B05,193523,Chang; Edmond Yi-Teh,0,5,28,28
1683634831978,MMW 15,B06,193524,Chang; Edmond Yi-Teh,0,5,28,28
1683634833003,MMW 122,A01,193526,Rahimi; Babak,0,16,28,28
1683634833003,MMW 122,A02,193527,Rahimi; Babak,0,15,28,28
1683634833003,MMW 122,A03,193528,Rahimi; Babak,0,0,0,0
1683634833003,MMW 122,A04,193529,Rahimi; Babak,0,0,0,0
1683634834030,MUS 1A,A01,186663,Staff,1,20,35,34
1683634835059,MUS 4,A01,186715,Staff,0,12,35,35
1683634836087,MUS 5R,A01,186796,Dubnov; Shlomo,0,17,35,35
1683634837115,MUS 6,A01,186798,Staff,0,5,25,25
1683634838141,MUS 7,A01,186830,Staff,11,0,35,24
1683634839167,MUS 8,A01,186930,Staff,0,26,35,35
1683634840190,MUS 15,A01,186932,Staff,0,16,35,35
1683634840190,MUS 15,B01,186934,Staff,0,17,35,35
1683634841216,MUS 80,A00,186935,Staff,0,0,20,20
1683634841216,MUS 80,B00,186936,Staff,24,0,25,1
1683634842247,NANO 11,A00,204702,Lipomi; Darren John,0,0,0,0
1683634843278,NANO 15,A01,204709,Yang; Kesong,0,1,0,0
1683634844304,NANO 114,A00,202069,Jahed Motlagh; Zeinab,3,0,10,7
1683634845332,PHIL 1,A00,186955,Grush; Rick Scott,31,0,40,9
1683634846360,PHIL 10,A01,186973,Grush; Rick Scott,27,0,35,8
1683634846360,PHIL 10,A02,186974,Grush; Rick Scott,33,0,35,2
1683634847385,PHIL 13,A01,186976,Staff,3,0,35,32
1683634847385,PHIL 13,A02,186977,Staff,16,0,35,19
1683634848411,PHIL 14,A01,186979,Staff,31,0,35,4
1683634848411,PHIL 14,A02,186986,Staff,32,0,35,3
1683634849439,PHIL 28,A01,186988,Staff,16,0,30,14
1683634849439,PHIL 28,A02,186989,Staff,1,0,30,29
1683634849439,PHIL 28,A03,186990,Staff,10,0,30,20
1683634849439,PHIL 28,A04,186991,Staff,26,0,30,4
1683634850467,PHIL 120,A00,186997,Staff,23,0,40,17
1683634851492,PHIL 137,A00,187003,Staff,7,0,40,33
1683634852521,PHIL 150,A00,187015,Staff,47,0,70,23
1683634853548,PHIL 167,A00,187021,Lamey; Andy M.,34,0,40,6
1683634854573,PHIL 174,A01,202226,Staff,17,0,20,3
1683634854573,PHIL 174,A02,202235,Staff,20,0,20,0
1683634855600,PHIL 191A,A00,258918,Staff,0,0,1,1
1683634856630,PHYS 1A,A00,187028,Staff,27,0,60,33
1683634857657,PHYS 1AL,001,187036,Staff,3,0,30,27
1683634857657,PHYS 1AL,002,187049,Staff,18,0,30,12
1683634858684,PHYS 1B,A00,187058,Staff,22,0,60,38
1683634859709,PHYS 1BL,001,187064,Staff,0,1,30,30
1683634859709,PHYS 1BL,002,187070,Staff,4,0,30,26
1683634860735,PHYS 1C,A00,187082,Staff,29,0,120,91
1683634861764,PHYS 1CL,001,187088,Staff,0,9,30,30
1683634861764,PHYS 1CL,002,187089,Staff,0,1,30,30
1683634861764,PHYS 1CL,009,262693,Staff,9,0,30,21
1683634862789,PHYS 2B,A01,187097,Staff,55,0,115,60
1683634863816,PHYS 2C,A01,187099,Staff,64,0,115,51
1683634864844,PHYS 2CL,A01,187101,Staff,5,0,28,23
1683634864844,PHYS 2CL,A02,187102,Staff,15,0,28,13
1683634865873,PHYS 2D,A01,187123,Shotwell; Brian,95,0,115,20
1683634866898,PHYS 4B,A01,187133,Grinstein; Benjamin,35,0,50,15
1683634867924,POLI 10,A00,188819,Staff,0,4,50,50
1683634868949,POLI 11,A00,188827,Staff,43,0,50,7
1683634869977,POLI 13R,A00,188828,Staff,0,1,20,20
1683634871003,POLI 27,A01,188830,Elgin; Samuel Zincke,0,2,70,70
1683634872028,POLI 30,A00,188832,Desposato; Scott,30,0,50,20
1683634873057,POLI 102F,A00,188834,Staff,0,0,40,40
1683634874083,POLI 104A,A00,188852,Staff,13,0,30,17
1683634875108,POLI 104I,A00,188853,Staff,0,7,20,20
1683634876138,POLI 110B,A00,188854,Wiens; David,7,0,20,13
1683634877164,POLI 112A,A00,188855,Wiens; David,4,0,30,26
1683634878191,POLI 117R,A00,188856,Forman; Fonna,0,12,20,20
1683634879221,POLI 118,A00,188857,Ingham; Sean,8,0,20,12
1683634880248,POLI 120G,A00,188858,Staff,8,0,30,22
1683634881275,POLI 131CR,A00,188863,Hoston; Germaine,21,0,50,29
1683634882301,POLI 133,A00,188864,Nellis; Gareth Hb,44,0,50,6
1683634883327,POLI 134D,A00,188865,Desposato; Scott,27,0,30,3
1683634884357,POLI 142A,A00,188871,Gartzke; Erik,21,0,50,29
1683634885383,POLI 142K,A00,188874,Staff,38,0,50,12
1683634886406,POLI 143,A00,188940,Gartzke; Erik,16,0,30,14
1683634887432,POLI 153,A00,188943,Staff,2,0,20,18
1683634888455,POLI 160AA,A00,188944,Staff,11,0,40,29
1683634889479,POLI 170A,A00,188945,Staff,11,0,30,19
1683634891526,PSYC 1,A00,188952,Staff,36,0,90,54
1683634892550,PSYC 2,B00,188953,Staff,19,0,35,16
1683634893574,PSYC 6,A00,188970,Staff,47,0,60,13
1683634894600,PSYC 7,A00,188973,Staff,35,0,45,10
1683634895632,PSYC 60,A01,188980,Rickard; Timothy C.,42,0,60,18
1683634896735,PSYC 70,A01,189001,Steiner; Eric Tomas,23,0,45,22
1683634897759,PSYC 100,A00,189005,Lacefield; Katharine I,0,99,120,120
1683634898787,PSYC 102,A00,189008,Staff,8,0,30,22
1683634899812,PSYC 106,B00,189026,Gorman; Michael R.,27,0,60,33
1683634900837,PSYC 114,B01,189033,Winkielman; Piotr,0,31,30,30
1683634901863,PSYC 131,A00,189036,Anagnostaras; Stephan,0,43,60,60
1683634902890,PSYC 136,A00,189041,Lowe; Angela Beth,0,7,25,25
1683634903916,PSYC 137,A00,189057,Winkielman; Piotr,0,37,25,25
1683634904941,PSYC 144,A00,189107,Wixted; John T,0,10,50,50
1683634906999,PSYC 162,A00,189142,Staff,0,9,85,85
1683634908024,PSYC 172,A00,189144,Gorman; Michael R.,0,6,30,30
1683634910082,PSYC 179,A00,189146,Lacefield; Katharine I,0,86,120,120
1683634911112,PSYC 181,A00,189147,Anagnostaras; Stephan,0,44,90,90
1683634912142,PSYC 190R,A00,189148,Barner; David A.,0,23,80,80
1683634913173,PSYC 191,A00,189275,Rickard; Timothy C.,0,10,25,25
1683634914202,PSYC 193,A00,189276,Chapman; Eddie Nathaniel,0,1,0,4
1683634915233,PSYC 193L,A01,189281,Lowe; Angela Beth,10,0,20,10
1683634915233,PSYC 193L,B01,189285,Staff,28,0,35,7
1683634916259,RELI 149,A00,187137,Rahimi; Babak,7,0,40,33
1683634917288,SE 9,A01,187315,Staff,0,2,18,18
1683634918312,SE 101B,A00,187409,Staff,24,0,30,6
1683634919342,SE 110B,A00,187444,Staff,10,0,40,30
1683634920369,SE 130B,A00,187449,Staff,31,0,40,9
1683634921393,SE 150A,A00,187516,Staff,9,0,20,11
1683634922418,SE 154,A00,187528,Staff,29,0,50,21
1683634923449,SIO 3,A01,258171,Staff,35,0,40,5
1683634924475,SIO 10,A00,187144,Cook; Geoffrey W,0,6,75,75
1683634925500,SIO 45,A00,187152,Cook; Geoffrey W,0,4,100,100
1683634926528,SIO 109R,A00,194486,Staff,0,4,20,20
1683634928583,SIO 187,A01,187233,Kacev; David,12,0,40,28
1683634929615,SOCI 1,A01,258656,Thorpe; Charles Robert,28,0,30,2
1683634929615,SOCI 1,A02,258658,Thorpe; Charles Robert,30,0,30,0
1683634929615,SOCI 1,A03,258661,Thorpe; Charles Robert,25,0,25,0
1683634929615,SOCI 1,A04,258666,Thorpe; Charles Robert,22,0,25,3
1683634929615,SOCI 1,A05,258897,Thorpe; Charles Robert,22,0,25,3
1683634929615,SOCI 1,A06,258898,Thorpe; Charles Robert,25,0,25,0
1683634930645,SOCI 30,A01,258903,Pardo Guerra; Juan Pablo,14,0,30,16
1683634931671,SOCI 102,A00,258904,Staff,9,0,25,16
1683634932698,SOCI 106,A00,258905,Staff,19,0,25,6
1683634933724,SOCI 111,A00,258907,Ribas Norris; Janet Vanesa,26,0,30,4
1683634934754,SOCI 121R,A00,258908,Pardo Guerra; Juan Pablo,8,0,30,22
1683634935782,SOCI 126,A01,203330,Staff,14,0,20,6
1683634936811,SOCI 131,A00,258909,Thorpe; Charles Robert,30,0,60,30
1683634937840,SOCI 135,A00,258910,Payne; Christine Anna,0,11,30,30
1683634938867,SOCI 157,A00,258911,Staff,12,0,30,18
1683634939896,SOCI 184,A00,258912,Staff,25,0,30,5
1683634940923,SOCI 188D,A00,258913,Staff,22,0,30,8
1683634941950,SYN 2,001,187529,Staff,9,0,16,7
1683634941950,SYN 2,002,201452,Staff,0,20,16,16
1683634941950,SYN 2,003,201469,Staff,2,0,16,14
1683634942976,SYN 100,A01,187531,Staff,0,9,20,20
1683634942976,SYN 100,B01,201491,Staff,0,10,20,20
1683634944003,TDAC 1,A00,189286,Walsh; Kim C.,3,0,20,17
1683634944003,TDAC 1,B00,189287,Harting; Carla Kelso,10,0,20,10
1683634945034,TDAC 101,A00,189300,Walsh; Kim C.,16,0,20,4
1683634945034,TDAC 101,B00,189301,Harting; Carla Kelso,18,0,20,2
1683634946059,TDAC 102,A00,189304,Basso; Beatrice,14,0,20,6
1683634947084,TDAC 108,A00,189305,Staff,18,0,20,2
1683634948119,TDDE 131,A00,189310,Staff,19,0,20,1
1683634948119,TDDE 131,B00,189314,Staff,19,0,20,1
1683634948119,TDDE 131,C00,189315,Staff,48,0,50,2
1683634948119,TDDE 131,D00,189316,Staff,14,0,15,1
1683634948119,TDDE 131,E00,204841,Staff,20,0,20,0
1683634949147,TDGE 10,A00,189289,Staff,28,0,50,22
1683634949147,TDGE 10,B00,189290,Havis; Allan,0,0,50,50
1683634950175,TDGE 11,A00,189291,Fulton; Julia,0,4,50,50
1683634950175,TDGE 11,B00,189292,Staff,20,0,25,5
1683634950175,TDGE 11,C00,260270,Staff,0,0,0,0
1683634951201,TDGE 25,A00,189294,Staff,2,0,20,18
1683634952232,TDGE 124,A00,189318,Fulton; Julia,0,8,50,50
1683634953260,TDGE 125,A00,189319,Staff,13,0,25,12
1683634953260,TDGE 125,B00,189320,Staff,23,0,25,2
1683634954289,TDGE 127,A00,189322,Havis; Allan,0,0,50,50
1683634955314,TDHT 101,A00,189323,Staff,18,0,25,7
1683634955314,TDHT 101,B00,189324,Staff,25,0,25,0
1683634956339,TDHT 102,A00,189325,Staff,49,0,50,1
1683634957363,TDMV 1,A00,189295,Arcidiacono; Kristin,20,0,30,10
1683634957363,TDMV 1,B00,189296,Caligagan; Maria T.,24,0,30,6
1683634958390,TDMV 2,A00,189297,Sammartano; Tonnie,27,0,30,3
1683634958390,TDMV 2,B00,189299,Arcidiacono; Kristin,23,0,30,7
1683634959416,TDMV 3,A00,204998,Rincon; Alicia,22,0,30,8
1683634960442,TDMV 120,A00,189458,Sammartano; Tonnie,28,0,30,2
1683634961468,TDMV 138,A00,189541,Jun; Grace Shin Hae,20,0,40,20
1683634962498,TDMV 142,A00,189717,Caligagan; Tony,25,0,30,5
1683634962498,TDMV 142,B00,189718,Caligagan; Maria T.,25,0,30,5
1683634963523,TMC 2,A01,187533,Staff,25,0,25,0
1683634963523,TMC 2,A02,187534,Staff,25,0,25,0
1683634964548,USP 1,A01,187536,Kwak; Nancy,0,16,25,25
1683634965573,USP 5,A01,187538,Staff,9,0,25,16
1683634966598,USP 101,A00,199253,Staff,0,4,0,0
1683634967626,USP 124,A00,187562,Boomhower; Matthew Charles,0,0,30,30
1683634968650,USP 138,A00,187582,Staff,20,0,25,5
1683634969675,USP 152,A01,187597,Staff,3,0,25,22
1683634970700,USP 153,A00,187598,Staff,19,0,25,6
1683634971730,USP 168,A00,187607,Kwak; Nancy,2,0,5,3
1683634972758,USP 173,A00,187619,Staff,4,0,25,21
1683634973786,USP 181,A00,187638,Staff,0,4,25,25
1683634974815,VIS 103,A00,187650,Cruz; Edwin Teddy,18,0,75,57
1683634975844,VIS 110D,A00,187669,Staff,13,0,22,9
1683634976874,VIS 127C,A00,187720,Shen; Kuiyi,67,0,146,79
1683634977902,VIS 149,A00,187731,Yoldas; Pinar,0,14,22,22
1683634978931,VIS 151,A01,188091,Staff,22,0,34,12
1683634978931,VIS 151,A02,188092,Staff,11,0,34,23
1683634979956,VIS 160B,A00,188093,Stalbaum; Brett,0,1,10,10
1683634982008,WCWP 10B,A00,201720,Staff,10,0,15,5
1683634982008,WCWP 10B,B00,201722,Staff,9,0,15,6
1683634983037,WCWP 100,A00,201725,Gagnon; Jeffrey C,0,0,2,2
1683634983037,WCWP 100,B00,201727,Staff,0,4,15,15
1683634986148,ANBI 133,A00,258401,Wilder; Linnea Lorene,34,0,40,6
1683634987174,ANBI 140,A00,258395,Hrvoj Mihic; Branka,18,0,25,7
1683634988200,ANSC 120,A00,258402,Bialecki; Jon Anthony,27,0,40,13
1683634989228,ANSC 144,A00,258400,Staff,12,0,40,28
1683634991279,ANSC 166,A00,258396,Parish; Steven Martin,156,0,175,19
1683634992304,ANSC 180,A00,193533,Staff,8,0,20,12
1683634993335,ANSC 188,A00,258397,Jassal; Aftab,34,0,40,6
1683634994363,ANTH 3,A01,258316,Staff,23,0,30,7
1683634995392,ANTH 5,A00,258394,Semendeferi; Ekaterini,16,0,20,4
1683634996423,ANTH 21,A01,258331,Staff,4,0,40,36
1683634997455,ANTH 103,A00,258398,Varma; Saiba,15,0,25,10
1683634998484,AWP 10,001,202034,Staff,0,0,0,0
1683634998484,AWP 10,002,202035,Staff,0,0,0,0
1683634998484,AWP 10,003,202036,Staff,0,0,0,0
1683634998484,AWP 10,004,202037,Staff,0,0,0,0
1683634998484,AWP 10,005,202038,Staff,0,0,0,0
1683634998484,AWP 10,006,202039,Staff,0,0,0,0
1683634998484,AWP 10,007,202040,Staff,0,0,0,0
1683634998484,AWP 10,008,202041,Staff,0,0,0,0
1683634998484,AWP 10,009,202042,Staff,0,0,0,0
1683634998484,AWP 10,010,202043,Staff,0,0,0,0
1683634998484,AWP 10,011,202044,Staff,0,0,0,0
1683634998484,AWP 10,012,202045,Staff,0,0,0,0
1683634998484,AWP 10,013,202046,Staff,0,0,0,0
1683634998484,AWP 10,014,202047,Staff,0,0,0,0
1683634998484,AWP 10,015,202048,Staff,0,0,0,0
1683634998484,AWP 10,016,202049,Staff,0,0,0,0
1683634998484,AWP 10,017,202050,Staff,0,0,0,0
1683634998484,AWP 10,018,202051,Staff,0,0,0,0
1683634998484,AWP 10,019,202052,Staff,0,0,0,0
1683634998484,AWP 10,020,202053,Staff,0,0,0,0
1683634998484,AWP 10,021,202054,Staff,0,0,0,0
1683634998484,AWP 10,022,202055,Staff,0,0,0,0
1683634998484,AWP 10,023,202056,Staff,0,0,0,0
1683634998484,AWP 10,024,202057,Staff,0,0,0,0
1683634998484,AWP 10,025,202058,Staff,0,0,0,0
1683634998484,AWP 10,026,202059,Staff,0,0,0,0
1683634999513,AWP 102,001,202032,Staff,0,0,0,0
1683634999513,AWP 102,002,202033,Staff,0,0,0,0
1683635000598,BENG 100,A01,254234,Taylor Amos; Alyssa C,31,0,40,9
1683635001624,BENG 196,001,270013,Engler; Adam J.,9999,0,9999,0
1683635002649,BICD 100R,A01,202018,Smith; Laurie,0,7,32,32
1683635002649,BICD 100R,A02,202019,Smith; Laurie,0,3,32,32
1683635002649,BICD 100R,A03,202020,Smith; Laurie,0,1,32,32
1683635002649,BICD 100R,A04,202021,Smith; Laurie,6,0,32,26
1683635002649,BICD 100R,A05,202022,Smith; Laurie,11,0,32,21
1683635003675,BICD 136,A01,193242,Gustafson-Brown; Cindy,0,2,32,32
1683635003675,BICD 136,A02,193244,Gustafson-Brown; Cindy,13,0,32,19
1683635004703,BIEB 102,A01,193249,Butler; Shannon Rhey,0,2,32,32
1683635004703,BIEB 102,A02,193251,Butler; Shannon Rhey,0,0,32,32
1683635004703,BIEB 102,A03,193253,Butler; Shannon Rhey,0,0,32,32
1683635004703,BIEB 102,A04,193255,Butler; Shannon Rhey,14,0,32,18
1683635004703,BIEB 102,A05,193265,Butler; Shannon Rhey,26,0,32,6
1683635004703,BIEB 102,A06,193269,Butler; Shannon Rhey,14,0,32,18
1683635006758,BIEB 150,A01,193274,Staff,0,0,32,32
1683635006758,BIEB 150,A02,193285,Staff,24,0,32,8
1683635007783,BIEB 194,A00,193286,Kurle; Carolyn M.,20,0,32,12
1683635008809,BILD 1,A01,192291,Staff,15,0,32,17
1683635008809,BILD 1,A02,192292,Staff,30,0,32,2
1683635008809,BILD 1,B01,192520,Reuther; Keefe,0,1,0,0
1683635008809,BILD 1,B02,192532,Reuther; Keefe,0,1,0,0
1683635009840,BILD 3,A01,192556,Butler; Shannon Rhey,0,0,32,32
1683635009840,BILD 3,A02,192581,Butler; Shannon Rhey,1,0,32,31
1683635009840,BILD 3,A03,192611,Butler; Shannon Rhey,21,0,32,11
1683635009840,BILD 3,A04,192612,Butler; Shannon Rhey,24,0,32,8
1683635009840,BILD 3,A05,192613,Butler; Shannon Rhey,26,0,32,6
1683635009840,BILD 3,A06,192679,Butler; Shannon Rhey,27,0,32,5
1683635009840,BILD 3,A07,192682,Butler; Shannon Rhey,20,0,32,12
1683635010870,BILD 4,A01,192836,Reuther; Keefe,0,0,24,24
1683635010870,BILD 4,A02,193044,Reuther; Keefe,4,0,24,20
1683635011897,BILD 10,A01,193142,Gustafson-Brown; Cindy,29,0,32,3
1683635011897,BILD 10,A02,193149,Gustafson-Brown; Cindy,31,0,32,1
1683635012922,BIMM 100,A01,193301,Staff,0,6,32,32
1683635012922,BIMM 100,A02,193312,Staff,0,7,32,32
1683635012922,BIMM 100,A03,193323,Staff,0,9,32,32
1683635013949,BIMM 101,A01,193329,McDonnell; Lisa Marie,0,4,24,24
1683635013949,BIMM 101,A02,193339,McDonnell; Lisa Marie,0,3,24,24
1683635013949,BIMM 101,B01,193354,McDonnell; Lisa Marie,0,4,24,24
1683635013949,BIMM 101,B02,193357,McDonnell; Lisa Marie,0,2,24,24
1683635014974,BIMM 110,A01,193377,Tat; John,0,11,32,32
1683635014974,BIMM 110,A02,193378,Tat; John,0,10,32,32
1683635016001,BIMM 120,A01,206116,Staff,0,0,32,32
1683635016001,BIMM 120,A02,206117,Staff,6,0,32,26
1683635016001,BIMM 120,A03,206121,Staff,21,0,32,11
1683635017027,BIPN 100,A01,193393,Park; Ji Young,0,14,32,32
1683635017027,BIPN 100,A02,193402,Park; Ji Young,0,14,32,32
1683635017027,BIPN 100,A03,193413,Park; Ji Young,0,14,32,32
1683635017027,BIPN 100,A04,193414,Park; Ji Young,0,13,32,32
1683635018056,BIPN 102,A01,193429,Staff,0,0,32,32
1683635018056,BIPN 102,A02,193438,Staff,18,0,32,14
1683635019084,BIPN 106,A01,193450,Reyes Gonzalez; Catalina,0,2,40,40
1683635020115,BIPN 134,A01,193465,Cooke; James Edward,0,0,32,32
1683635020115,BIPN 134,A02,193474,Cooke; James Edward,25,0,32,7
1683635020115,BIPN 134,A03,193485,Cooke; James Edward,29,0,32,3
1683635020115,BIPN 134,A04,193486,Cooke; James Edward,20,0,32,12
1683635020115,BIPN 134,A05,193491,Cooke; James Edward,31,0,32,1
1683635020115,BIPN 134,A06,193501,Cooke; James Edward,30,0,32,2
1683635020115,BIPN 134,A07,193510,Cooke; James Edward,29,0,32,3
1683635022173,BISP 194,A00,222522,Staff,14,0,32,18
1683635023197,CAT 124,A01,202407,Staff,19,0,25,6
1683635024223,CAT 125,A00,202408,Marchisotto; Jennifer Anne,2,0,20,18
1683635025250,CAT 125R,A00,202409,Smith; Lauryn Alissa,0,11,20,20
1683635025250,CAT 125R,B00,202410,Morales; Celeste Georgianna,0,11,20,20
1683635025250,CAT 125R,C00,202411,Irwin; Matthew Joseph,0,12,20,20
1683635026278,CENG 15,A01,204712,Yang; Kesong,0,1,0,0
1683635027304,CENG 114,A00,202070,Jahed Motlagh; Zeinab,5,0,20,15
1683635028330,CGS 105,A00,185477,Wesling; Megan E.,24,0,40,16
1683635029356,CGS 106,A00,185494,Staff,11,0,22,11
1683635030380,CGS 108,A00,185495,Staff,14,0,20,6
1683635031406,CGS 114,A00,185496,Staff,13,0,18,5
1683635032431,CGS 119,A00,185501,Staff,15,0,20,5
1683635033459,CGS 120,A00,185511,Staff,12,0,20,8
1683635034492,CHEM 4,A01,184675,Bussey; Thomas J,97,0,100,3
1683635035518,CHEM 6A,A01,184677,Staff,33,0,60,27
1683635036547,CHEM 6B,A01,184679,Staff,63,0,100,37
1683635037578,CHEM 6C,A01,184681,Bussey; Thomas J,0,0,50,50
1683635037578,CHEM 6C,A02,184682,Bussey; Thomas J,32,0,50,18
1683635038604,CHEM 40A,A01,184684,Albizati; Kim F.,35,0,100,65
1683635039629,CHEM 40B,A01,184686,Albizati; Kim F.,0,22,100,100
1683635040659,CHEM 41B,A01,184690,Staff,51,0,100,49
1683635041685,COGS 3,A01,184715,Boyle; Mary E. T.,0,27,40,40
1683635042713,COGS 14B,A01,185172,Staff,0,14,38,38
1683635043738,COGS 18,A01,184736,Staff,15,0,80,65
1683635044766,COGS 100,A01,184932,Staff,0,7,73,73
1683635045791,COGS 101A,A01,184935,Staff,0,39,30,30
1683635046819,COGS 101B,A01,184944,Staff,0,2,30,30
1683635047844,COGS 101C,A01,184946,Staff,0,10,30,30
1683635048870,COGS 102A,A01,184951,Johnson; Christine M.,2,0,40,38
1683635049901,COGS 107B,A01,184953,Mooshagian; Eric Frederick,0,51,40,40
1683635050930,COGS 118B,A01,184959,Gupta; Anjum,0,49,40,40
1683635051960,COGS 153,A00,184961,Staff,0,16,30,30
1683635052990,COGS 177,A00,184962,Staff,0,21,30,30
1683635054019,COGS 187A,A01,184969,Boyle; Mary E. T.,0,19,40,40
1683635055045,COMM 10,A01,185174,Staff,0,5,25,25
1683635055045,COMM 10,A02,185189,Staff,0,2,25,25
1683635055045,COMM 10,A03,269821,Staff,0,1,0,0
1683635056075,COMM 100B,A01,185475,Staff,0,1,0,2
1683635056075,COMM 100B,A02,185476,Staff,12,0,25,13
1683635057107,COMM 100C,A01,185314,Staff,1,0,25,24
1683635057107,COMM 100C,A02,185327,Staff,18,0,25,7
1683635058132,COMM 110M,A00,185349,Staff,0,0,40,40
1683635059158,COMM 113T,A00,185352,Staff,25,0,40,15
1683635060186,COMM 114I,A00,185353,Staff,31,0,40,9
1683635061214,COMM 131,A00,185354,Staff,17,0,30,13
1683635062245,CSE 8A,A50,185358,Cao; Yingjun,0,46,10,10
1683635063275,CSE 8B,A01,185362,Staff,0,48,50,50
1683635064301,CSE 11,A01,185416,Cao; Yingjun,0,91,10,10
1683635065326,CSE 20,A01,185445,Briones; Jor-el Thomas Caparas,4,0,25,21
1683635066353,CSE 21,A01,185447,Staff,9,0,50,41
1683635067380,CSE 101,A01,185451,Staff,0,13,50,50
1683635067380,CSE 101,B01,185453,Jones; Miles E,0,13,50,50
1683635069428,CSE 141,A01,185458,Eldon; John,15,0,100,85
1683635070457,CSE 141L,A01,185461,Eldon; John,7,0,100,93
1683635071487,CSE 142,A01,185463,Staff,36,0,60,24
1683635071487,CSE 142,B01,201355,Staff,0,7,60,60
1683635072511,CSE 142L,A01,185470,Staff,36,0,60,24
1683635072511,CSE 142L,B01,201417,Staff,0,6,60,60
1683635073537,CSE 190,A00,201433,Staff,32,0,49,17
1683635074562,DOC 1,A01,259136,Strom; Megan C.,7,0,15,8
1683635074562,DOC 1,A02,259137,Strom; Megan C.,14,0,15,1
1683635074562,DOC 1,A03,259138,Strom; Megan C.,14,0,15,1
1683635074562,DOC 1,A04,259139,Strom; Megan C.,14,0,15,1
1683635075587,DOC 100D,A00,259140,Pass; Natalye Joann,14,0,25,11
1683635076613,DSGN 1,A01,184749,Rill; Bryan,0,26,30,30
1683635077640,DSGN 100,A01,185168,Staff,0,2,25,25
1683635078670,ECE 5,A01,185626,Morris; Karcher William,0,11,0,0
1683635079699,ECE 101,A01,185628,Staff,14,0,70,56
1683635080730,ECE 107,A01,185635,Baghdadchi; Saharnaz,0,0,20,20
1683635080730,ECE 107,A02,185638,Baghdadchi; Saharnaz,3,0,20,17
1683635081759,ECE 148,A01,185647,Silberman; Jack,0,0,16,16
1683635082785,ECON 1,A01,185537,Crane; Meredith Helen,54,0,70,16
1683635083811,ECON 3,A01,185549,Crane; Meredith Helen,29,0,70,41
1683635084837,ECON 4,A01,203354,Anderson; John Charles,0,5,10,10
1683635085863,ECON 100A,A01,185574,Staff,0,5,40,40
1683635086894,ECON 100B,A01,185576,Staff,0,12,50,50
1683635087920,ECON 100C,A01,185589,Newhouse; Herbert S,30,0,70,40
1683635088945,ECON 105,A00,185608,Vespa; Emanuel Ignacio,19,0,35,16
1683635089971,ECON 109,A01,185610,Shishkin; Denis,9,0,35,26
1683635090998,ECON 110A,A01,185612,Staff,9,0,40,31
1683635092022,ECON 120A,A01,185615,Staff,20,0,40,20
1683635093047,ECON 120C,A01,185617,Sun; Yixiao,0,20,70,70
1683635094073,ECON 144,A00,203346,Squires; Dale E,2,0,35,33
1683635095098,ECON 171,A01,203349,Newhouse; Herbert S,0,1,35,35
1683635096125,ECON 173A,A01,185621,Toda; Alexis Akira,21,0,35,14
1683635097154,EDS 25,A01,202413,Staff,0,1,0,0
1683635097154,EDS 25,A02,202414,Staff,0,1,0,0
1683635097154,EDS 25,A03,202415,Staff,0,0,0,0
1683635097154,EDS 25,A04,202416,Staff,0,1,0,0
1683635097154,EDS 25,A05,202439,Staff,0,0,0,0
1683635097154,EDS 25,A06,202440,Staff,0,0,0,0
1683635097154,EDS 25,B01,202631,Staff,0,0,0,0
1683635097154,EDS 25,B02,202632,Staff,0,0,0,0
1683635097154,EDS 25,B03,202639,Staff,0,0,0,0
1683635097154,EDS 25,B04,202640,Staff,0,0,0,0
1683635097154,EDS 25,B05,202643,Staff,0,0,0,0
1683635097154,EDS 25,B06,202644,Staff,0,0,0,0
1683635098185,EDS 38,A01,202659,Black; Alison Michelle,24,0,25,1
1683635099214,EDS 115,A00,202652,Staff,18,0,30,12
1683635100242,EDS 125,A00,202649,Staff,13,0,30,17
1683635101271,EDS 126,A01,203332,Staff,30,0,30,0
1683635102294,EDS 139,A00,202838,Staff,16,0,25,9
1683635103319,EDS 146,A01,202655,Staff,14,0,25,11
1683635104419,ENG 15,A00,185667,Staff,0,1,0,0
1683635104419,ENG 15,B00,185672,Staff,0,0,0,0
1683635104419,ENG 15,C00,185675,Staff,0,0,0,0
1683635104419,ENG 15,D00,185682,Staff,0,0,0,0
1683635104419,ENG 15,E00,185684,Staff,0,0,0,0
1683635105445,ETHN 103,A00,185710,Staff,0,8,35,35
1683635106475,ETHN 103A,A00,199228,Man; Simeon S,0,0,9,9
1683635107504,ETHN 109,A00,185711,Staff,16,0,35,19
1683635108528,ETHN 142,A00,185726,Staff,0,4,30,30
1683635109555,ETHN 163J,A00,199229,Man; Simeon S,5,0,8,3
1683635110581,ETHN 168,A00,185727,Staff,7,0,10,3
1683635111611,ETHN 182,A00,185728,Staff,0,0,35,35
1683635112646,ETHN 183,A00,185737,Staff,9,0,18,9
1683635113671,GLBH 111,A01,209361,Burgos; Jose L.,0,0,0,0
1683635115721,HIEU 104,A00,185792,Staff,14,0,20,6
1683635116746,HIEU 115,A00,185800,Staff,0,0,20,20
1683635117771,HIEU 128,A00,185801,Staff,0,9,20,20
1683635118796,HIEU 147,A00,185802,Staff,15,0,20,5
1683635119822,HIEU 154,A00,185823,Staff,11,0,20,9
1683635120847,HILA 102,A00,185826,Staff,14,0,20,6
1683635121878,HILD 2C,A01,185778,Staff,0,13,20,20
1683635122904,HILD 7B,A01,185780,Kwak; Nancy,0,16,32,32
1683635122904,HILD 7B,A02,185781,Kwak; Nancy,0,18,32,32
1683635123929,HILD 30,A01,185791,Staff,12,0,20,8
1683635124956,HISC 119,A00,185830,Golan; Tal,0,9,20,20
1683635125982,HITO 156GS,A00,185831,Patterson; Patrick H.,0,0,0,23
1683635127010,HIUS 103,A00,185832,Man; Simeon S,0,4,20,20
1683635128041,HIUS 117,A00,185836,Kwak; Nancy,2,0,20,18
1683635129071,HIUS 125,A00,185840,Man; Simeon S,0,1,23,23
1683635130095,HIUS 149,A00,185845,Staff,1,0,20,19
1683635131122,HUM 3,A01,185882,Zavodny; Tatiana Sophia,0,7,50,50
1683635131122,HUM 3,B01,185899,Caldwell; Michael Alan,0,18,50,50
1683635132155,HUM 3GS,A00,185900,Patterson; Patrick H.,0,0,0,23
1683635133191,HUM 4,A01,185938,Zroka; Amy Liane,30,0,50,20
1683635133191,HUM 4,B01,185956,Watkins; Eric,0,4,50,50
1683635133191,HUM 4,B02,202209,Watkins; Eric,0,4,50,50
1683635133191,HUM 4,B03,202210,Watkins; Eric,0,4,50,50
1683635134220,HUM 5,A01,185958,West; Geoffrey Scott,2,0,50,48
1683635134220,HUM 5,A02,202215,West; Geoffrey Scott,0,0,50,50
1683635135251,INTL 190,A00,185959,Gagnon; Jeffrey C,0,0,0,9
1683635135251,INTL 190,B00,185960,Lettieri; Michael Joseph,0,0,0,2
1683635136277,JAPN 180,A00,254509,Staff,5,0,30,25
1683635137305,LATI 10,A01,202853,Kennemore; Amy Michelle,4,0,35,31
1683635137305,LATI 10,A02,202854,Kennemore; Amy Michelle,2,0,35,33
1683635137305,LATI 10,A03,270054,Kennemore; Amy Michelle,30,0,30,0
1683635138330,LATI 180,A00,202855,Kennemore; Amy Michelle,11,0,20,9
1683635139362,LAWS 101,A00,201767,Golan; Tal,0,7,40,40
1683635140386,LIFR 1C,A00,185961,Staff,6,0,20,14
1683635141421,LIFR 1CX,A00,185962,Staff,7,0,20,13
1683635142448,LIFR 1D,A00,185963,Staff,7,0,20,13
1683635143478,LIFR 1DX,A00,185964,Staff,7,0,20,13
1683635144506,LIGN 101,A01,186039,Staff,43,0,50,7
1683635145533,LIGN 165,A00,186040,Staff,15,0,50,35
1683635146555,LTCS 108,A00,186041,Staff,5,0,10,5
1683635147579,LTCS 119,A00,186042,Staff,15,0,20,5
1683635148612,LTCS 130,A00,186043,Wesling; Megan E.,15,0,25,10
1683635150669,LTEA 138,A00,186119,Staff,14,0,40,26
1683635151694,LTEN 124,A00,186148,Staff,6,0,25,19
1683635152724,LTEN 178,A00,186149,Staff,7,0,15,8
1683635153754,LTEN 181,A00,186150,Blanco; John D,34,0,40,6
1683635154779,LTWL 120,A00,186160,Staff,20,0,25,5
1683635155805,LTWL 165,A00,186161,Staff,22,0,25,3
1683635156831,LTWR 100,A00,186162,Staff,0,5,15,15
1683635157858,LTWR 102,A00,186163,Doller; Ben,5,0,15,10
1683635158885,MAE 8,A01,186412,Staff,0,0,0,0
1683635159915,MAE 30B,A00,186445,Bahadori; Mohammad Yousef,82,0,100,18
1683635160945,MAE 40,A00,186592,Bewley; Thomas R,10,0,50,40
1683635161969,MAE 101B,A00,186593,Bahadori; Mohammad Yousef,80,0,100,20
1683635162995,MAE 105,A00,186594,Bandaru; Prabhakar,10,0,50,40
1683635164023,MAE 107,A00,186599,Pham; Hieu Tan,0,7,120,120
1683635165050,MAE 148,A01,186660,Silberman; Jack,3,0,16,13
1683635166081,MATH 10A,A01,188095,Staff,0,5,35,35
1683635167116,MATH 10B,A01,188097,Bowers; Adam R.,0,11,30,30
1683635167116,MATH 10B,A02,188099,Bowers; Adam R.,0,11,30,30
1683635167116,MATH 10B,B01,188104,Bowers; Adam R.,0,10,30,30
1683635167116,MATH 10B,B02,188106,Bowers; Adam R.,1,9,30,29
1683635168147,MATH 10C,A01,188111,Staff,0,18,30,30
1683635168147,MATH 10C,A02,188127,Staff,0,19,30,30
1683635168147,MATH 10C,A03,188131,Staff,0,19,30,30
1683635168147,MATH 10C,B01,188218,Staff,17,0,30,13
1683635168147,MATH 10C,B02,188244,Staff,13,0,30,17
1683635168147,MATH 10C,B03,188277,Staff,14,0,30,16
1683635169177,MATH 18,A01,188344,Bach; Quang Tran,18,0,30,12
1683635169177,MATH 18,A02,188345,Bach; Quang Tran,11,0,30,19
1683635169177,MATH 18,B01,188353,Bach; Quang Tran,11,0,30,19
1683635169177,MATH 18,B02,188354,Bach; Quang Tran,19,0,30,11
1683635170204,MATH 20A,A01,188374,Staff,11,0,35,24
1683635171247,MATH 20B,A01,188382,Ohm; Ko Woon,7,0,30,23
1683635171247,MATH 20B,A02,188383,Ohm; Ko Woon,22,0,30,8
1683635171247,MATH 20B,B01,188385,Ohm; Ko Woon,7,0,30,23
1683635171247,MATH 20B,B02,188392,Ohm; Ko Woon,22,0,30,8
1683635172279,MATH 20C,A01,188394,Harel; Guershon,11,0,30,19
1683635172279,MATH 20C,A02,188395,Harel; Guershon,14,0,30,16
1683635172279,MATH 20C,B01,188404,Harel; Guershon,4,0,30,26
1683635172279,MATH 20C,B02,188405,Harel; Guershon,18,0,30,12
1683635173320,MATH 20D,A01,188414,Hammock; Frances H,0,1,30,30
1683635173320,MATH 20D,A02,188415,Hammock; Frances H,0,1,30,30
1683635173320,MATH 20D,B01,188447,Hammock; Frances H,0,1,30,30
1683635173320,MATH 20D,B02,188486,Hammock; Frances H,4,0,30,26
1683635174349,MATH 20E,A01,188649,Staff,21,0,30,9
1683635174349,MATH 20E,A02,188650,Staff,21,0,30,9
1683635174349,MATH 20E,A03,188673,Staff,0,0,30,30
1683635175375,MATH 102,A01,188675,Staff,0,36,35,35
1683635176410,MATH 103B,A01,188681,Staff,3,0,35,32
1683635176410,MATH 103B,B01,188692,Staff,5,0,35,30
1683635177440,MATH 109,A01,188695,Salehi Golsefidy; Alireza,24,0,35,11
1683635177440,MATH 109,A02,188696,Salehi Golsefidy; Alireza,25,0,35,10
1683635178475,MATH 120A,A01,188698,Eggers; John Dietrich,7,0,35,28
1683635179506,MATH 142B,A01,188736,Ioana; Adrian,0,1,30,30
1683635179506,MATH 142B,A02,188741,Ioana; Adrian,0,1,30,30
1683635179506,MATH 142B,A03,188743,Ioana; Adrian,0,1,30,30
1683635180532,MATH 168A,A01,188790,Staff,0,10,35,35
1683635181563,MATH 170A,A01,188803,Nie; Jiawang,0,2,35,35
1683635181563,MATH 170A,A02,188811,Nie; Jiawang,0,0,35,35
1683635181563,MATH 170A,A03,188814,Nie; Jiawang,0,0,35,35
1683635181563,MATH 170A,A04,188815,Nie; Jiawang,10,0,35,25
1683635182591,MATH 193B,A01,188817,Staff,0,0,35,35
1683635182591,MATH 193B,A02,188818,Staff,5,0,35,30
1683635183622,MGT 4,A01,202857,Anderson; John Charles,61,0,80,19
1683635184653,MGT 12,A00,202858,Lindenberger; Wade Douglas,40,0,90,50
1683635185678,MGT 18,A00,202859,Staff,74,0,90,16
1683635186708,MGT 18GS,A00,202860,McKay; Michael J,13,0,28,15
1683635187741,MGT 45,A00,202861,Pecore; Joseph P.,12,0,90,78
1683635188771,MGT 100,A00,202863,Yavorsky; Daniel Ryan,28,0,90,62
1683635189800,MGT 103,A00,202864,Ehrich; Kristine R,0,17,90,90
1683635190829,MGT 112,A00,202865,Ehrich; Kristine R,15,0,90,75
1683635191857,MGT 121A,A00,202868,Staff,0,20,0,0
1683635192882,MGT 131B,A00,202869,Anderson; John Charles,59,0,90,31
1683635193909,MGT 136,A00,202871,Lindenberger; Wade Douglas,83,0,90,7
1683635194933,MGT 164,A00,202873,Staff,0,66,90,91
1683635195959,MGT 164GS,A00,202874,McKay; Mary A,13,0,28,15
1683635196989,MGT 180,A00,202875,Staff,0,50,90,91
1683635198014,MMW 11R,A01,205019,Herbst; Matthew,2,0,30,28
1683635198014,MMW 11R,A02,205026,Herbst; Matthew,29,0,30,1
1683635199046,MMW 15,A01,193512,Chang; Edmond Yi-Teh,0,8,28,28
1683635199046,MMW 15,A02,193513,Chang; Edmond Yi-Teh,0,5,28,28
1683635199046,MMW 15,A03,193514,Chang; Edmond Yi-Teh,0,5,28,28
1683635199046,MMW 15,A04,193515,Chang; Edmond Yi-Teh,0,5,28,28
1683635199046,MMW 15,A05,193516,Chang; Edmond Yi-Teh,0,5,28,28
1683635199046,MMW 15,A06,193517,Chang; Edmond Yi-Teh,0,6,28,28
1683635199046,MMW 15,B01,193519,Chang; Edmond Yi-Teh,0,5,28,28
1683635199046,MMW 15,B02,193520,Chang; Edmond Yi-Teh,0,5,28,28
1683635199046,MMW 15,B03,193521,Chang; Edmond Yi-Teh,0,5,28,28
1683635199046,MMW 15,B04,193522,Chang; Edmond Yi-Teh,0,5,28,28
1683635199046,MMW 15,B05,193523,Chang; Edmond Yi-Teh,0,5,28,28
1683635199046,MMW 15,B06,193524,Chang; Edmond Yi-Teh,0,5,28,28
1683635200072,MMW 122,A01,193526,Rahimi; Babak,0,16,28,28
1683635200072,MMW 122,A02,193527,Rahimi; Babak,0,15,28,28
1683635200072,MMW 122,A03,193528,Rahimi; Babak,0,0,0,0
1683635200072,MMW 122,A04,193529,Rahimi; Babak,0,0,0,0
1683635201103,MUS 1A,A01,186663,Staff,1,20,35,34
1683635202128,MUS 4,A01,186715,Staff,0,12,35,35
1683635203155,MUS 5R,A01,186796,Dubnov; Shlomo,0,17,35,35
1683635204183,MUS 6,A01,186798,Staff,0,5,25,25
1683635205215,MUS 7,A01,186830,Staff,11,0,35,24
1683635206243,MUS 8,A01,186930,Staff,0,26,35,35
1683635207270,MUS 15,A01,186932,Staff,0,16,35,35
1683635207270,MUS 15,B01,186934,Staff,0,17,35,35
1683635208367,MUS 80,A00,186935,Staff,0,0,20,20
1683635208367,MUS 80,B00,186936,Staff,24,0,25,1
1683635209397,NANO 11,A00,204702,Lipomi; Darren John,0,0,0,0
1683635210432,NANO 15,A01,204709,Yang; Kesong,0,1,0,0
1683635211464,NANO 114,A00,202069,Jahed Motlagh; Zeinab,3,0,10,7
1683635212494,PHIL 1,A00,186955,Grush; Rick Scott,31,0,40,9
1683635213518,PHIL 10,A01,186973,Grush; Rick Scott,27,0,35,8
1683635213518,PHIL 10,A02,186974,Grush; Rick Scott,33,0,35,2
1683635214546,PHIL 13,A01,186976,Staff,3,0,35,32
1683635214546,PHIL 13,A02,186977,Staff,16,0,35,19
1683635215571,PHIL 14,A01,186979,Staff,31,0,35,4
1683635215571,PHIL 14,A02,186986,Staff,32,0,35,3
1683635216598,PHIL 28,A01,186988,Staff,16,0,30,14
1683635216598,PHIL 28,A02,186989,Staff,1,0,30,29
1683635216598,PHIL 28,A03,186990,Staff,10,0,30,20
1683635216598,PHIL 28,A04,186991,Staff,26,0,30,4
1683635217623,PHIL 120,A00,186997,Staff,23,0,40,17
1683635218649,PHIL 137,A00,187003,Staff,7,0,40,33
1683635219679,PHIL 150,A00,187015,Staff,47,0,70,23
1683635220714,PHIL 167,A00,187021,Lamey; Andy M.,34,0,40,6
1683635221738,PHIL 174,A01,202226,Staff,17,0,20,3
1683635221738,PHIL 174,A02,202235,Staff,20,0,20,0
1683635222764,PHIL 191A,A00,258918,Staff,0,0,1,1
1683635223792,PHYS 1A,A00,187028,Staff,27,0,60,33
1683635224823,PHYS 1AL,001,187036,Staff,3,0,30,27
1683635224823,PHYS 1AL,002,187049,Staff,18,0,30,12
1683635225849,PHYS 1B,A00,187058,Staff,22,0,60,38
1683635226882,PHYS 1BL,001,187064,Staff,0,1,30,30
1683635226882,PHYS 1BL,002,187070,Staff,4,0,30,26
1683635227909,PHYS 1C,A00,187082,Staff,29,0,120,91
1683635228934,PHYS 1CL,001,187088,Staff,0,9,30,30
1683635228934,PHYS 1CL,002,187089,Staff,0,1,30,30
1683635228934,PHYS 1CL,009,262693,Staff,9,0,30,21
1683635229959,PHYS 2B,A01,187097,Staff,55,0,115,60
1683635230987,PHYS 2C,A01,187099,Staff,64,0,115,51
1683635232014,PHYS 2CL,A01,187101,Staff,5,0,28,23
1683635232014,PHYS 2CL,A02,187102,Staff,15,0,28,13
1683635233041,PHYS 2D,A01,187123,Shotwell; Brian,95,0,115,20
1683635234069,PHYS 4B,A01,187133,Grinstein; Benjamin,35,0,50,15
1683635235097,POLI 10,A00,188819,Staff,0,4,50,50
1683635236126,POLI 11,A00,188827,Staff,43,0,50,7
1683635237154,POLI 13R,A00,188828,Staff,0,1,20,20
1683635238180,POLI 27,A01,188830,Elgin; Samuel Zincke,0,2,70,70
1683635239207,POLI 30,A00,188832,Desposato; Scott,30,0,50,20
1683635240234,POLI 102F,A00,188834,Staff,0,0,40,40
1683635241262,POLI 104A,A00,188852,Staff,13,0,30,17
1683635242290,POLI 104I,A00,188853,Staff,0,7,20,20
1683635243324,POLI 110B,A00,188854,Wiens; David,7,0,20,13
1683635244354,POLI 112A,A00,188855,Wiens; David,4,0,30,26
1683635245382,POLI 117R,A00,188856,Forman; Fonna,0,12,20,20
1683635246408,POLI 118,A00,188857,Ingham; Sean,8,0,20,12
1683635247433,POLI 120G,A00,188858,Staff,8,0,30,22
1683635248460,POLI 131CR,A00,188863,Hoston; Germaine,21,0,50,29
1683635249486,POLI 133,A00,188864,Nellis; Gareth Hb,44,0,50,6
1683635250513,POLI 134D,A00,188865,Desposato; Scott,27,0,30,3
1683635251543,POLI 142A,A00,188871,Gartzke; Erik,21,0,50,29
1683635252572,POLI 142K,A00,188874,Staff,38,0,50,12
1683635253601,POLI 143,A00,188940,Gartzke; Erik,16,0,30,14
1683635254628,POLI 153,A00,188943,Staff,2,0,20,18
1683635255652,POLI 160AA,A00,188944,Staff,11,0,40,29
1683635256676,POLI 170A,A00,188945,Staff,11,0,30,19
1683635258730,PSYC 1,A00,188952,Staff,36,0,90,54
1683635259758,PSYC 2,B00,188953,Staff,19,0,35,16
1683635260785,PSYC 6,A00,188970,Staff,47,0,60,13
1683635261815,PSYC 7,A00,188973,Staff,35,0,45,10
1683635262846,PSYC 60,A01,188980,Rickard; Timothy C.,42,0,60,18
1683635263872,PSYC 70,A01,189001,Steiner; Eric Tomas,23,0,45,22
1683635264897,PSYC 100,A00,189005,Lacefield; Katharine I,0,99,120,120
1683635265927,PSYC 102,A00,189008,Staff,8,0,30,22
1683635266951,PSYC 106,B00,189026,Gorman; Michael R.,27,0,60,33
1683635267981,PSYC 114,B01,189033,Winkielman; Piotr,0,31,30,30
1683635269006,PSYC 131,A00,189036,Anagnostaras; Stephan,0,43,60,60
1683635270034,PSYC 136,A00,189041,Lowe; Angela Beth,0,7,25,25
1683635271062,PSYC 137,A00,189057,Winkielman; Piotr,0,37,25,25
1683635272090,PSYC 144,A00,189107,Wixted; John T,0,10,50,50
1683635274143,PSYC 162,A00,189142,Staff,0,9,85,85
1683635275169,PSYC 172,A00,189144,Gorman; Michael R.,0,6,30,30
1683635277218,PSYC 179,A00,189146,Lacefield; Katharine I,0,86,120,120
1683635278242,PSYC 181,A00,189147,Anagnostaras; Stephan,0,44,90,90
1683635279269,PSYC 190R,A00,189148,Barner; David A.,0,23,80,80
1683635280296,PSYC 191,A00,189275,Rickard; Timothy C.,0,10,25,25
1683635281326,PSYC 193,A00,189276,Chapman; Eddie Nathaniel,0,1,0,4
1683635282352,PSYC 193L,A01,189281,Lowe; Angela Beth,10,0,20,10
1683635282352,PSYC 193L,B01,189285,Staff,28,0,35,7
1683635283378,RELI 149,A00,187137,Rahimi; Babak,7,0,40,33
1683635284408,SE 9,A01,187315,Staff,0,2,18,18
1683635285439,SE 101B,A00,187409,Staff,24,0,30,6
1683635286469,SE 110B,A00,187444,Staff,10,0,40,30
1683635287496,SE 130B,A00,187449,Staff,31,0,40,9
1683635288522,SE 150A,A00,187516,Staff,9,0,20,11
1683635289545,SE 154,A00,187528,Staff,29,0,50,21
1683635290571,SIO 3,A01,258171,Staff,35,0,40,5
1683635291596,SIO 10,A00,187144,Cook; Geoffrey W,0,6,75,75
1683635292625,SIO 45,A00,187152,Cook; Geoffrey W,0,4,100,100
1683635293654,SIO 109R,A00,194486,Staff,0,4,20,20
1683635295709,SIO 187,A01,187233,Kacev; David,12,0,40,28
1683635296740,SOCI 1,A01,258656,Thorpe; Charles Robert,28,0,30,2
1683635296740,SOCI 1,A02,258658,Thorpe; Charles Robert,30,0,30,0
1683635296740,SOCI 1,A03,258661,Thorpe; Charles Robert,25,0,25,0
1683635296740,SOCI 1,A04,258666,Thorpe; Charles Robert,22,0,25,3
1683635296740,SOCI 1,A05,258897,Thorpe; Charles Robert,22,0,25,3
1683635296740,SOCI 1,A06,258898,Thorpe; Charles Robert,25,0,25,0
1683635297770,SOCI 30,A01,258903,Pardo Guerra; Juan Pablo,14,0,30,16
1683635298798,SOCI 102,A00,258904,Staff,9,0,25,16
1683635299826,SOCI 106,A00,258905,Staff,19,0,25,6
1683635300851,SOCI 111,A00,258907,Ribas Norris; Janet Vanesa,26,0,30,4
1683635301875,SOCI 121R,A00,258908,Pardo Guerra; Juan Pablo,8,0,30,22
1683635302901,SOCI 126,A01,203330,Staff,14,0,20,6
1683635303927,SOCI 131,A00,258909,Thorpe; Charles Robert,30,0,60,30
1683635304956,SOCI 135,A00,258910,Payne; Christine Anna,0,11,30,30
1683635305987,SOCI 157,A00,258911,Staff,12,0,30,18
1683635307015,SOCI 184,A00,258912,Staff,25,0,30,5
1683635308040,SOCI 188D,A00,258913,Staff,22,0,30,8
1683635309065,SYN 2,001,187529,Staff,9,0,16,7
1683635309065,SYN 2,002,201452,Staff,0,20,16,16
1683635309065,SYN 2,003,201469,Staff,2,0,16,14
1683635310091,SYN 100,A01,187531,Staff,0,9,20,20
1683635310091,SYN 100,B01,201491,Staff,0,10,20,20
1683635311117,TDAC 1,A00,189286,Walsh; Kim C.,3,0,20,17
1683635311117,TDAC 1,B00,189287,Harting; Carla Kelso,10,0,20,10
1683635312200,TDAC 101,A00,189300,Walsh; Kim C.,16,0,20,4
1683635312200,TDAC 101,B00,189301,Harting; Carla Kelso,18,0,20,2
1683635313226,TDAC 102,A00,189304,Basso; Beatrice,14,0,20,6
1683635314252,TDAC 108,A00,189305,Staff,18,0,20,2
1683635315280,TDDE 131,A00,189310,Staff,19,0,20,1
1683635315280,TDDE 131,B00,189314,Staff,19,0,20,1
1683635315280,TDDE 131,C00,189315,Staff,48,0,50,2
1683635315280,TDDE 131,D00,189316,Staff,14,0,15,1
1683635315280,TDDE 131,E00,204841,Staff,20,0,20,0
1683635316304,TDGE 10,A00,189289,Staff,28,0,50,22
1683635316304,TDGE 10,B00,189290,Havis; Allan,0,0,50,50
1683635317338,TDGE 11,A00,189291,Fulton; Julia,0,4,50,50
1683635317338,TDGE 11,B00,189292,Staff,20,0,25,5
1683635317338,TDGE 11,C00,260270,Staff,0,0,0,0
1683635318366,TDGE 25,A00,189294,Staff,2,0,20,18
1683635319394,TDGE 124,A00,189318,Fulton; Julia,0,8,50,50
1683635320418,TDGE 125,A00,189319,Staff,13,0,25,12
1683635320418,TDGE 125,B00,189320,Staff,23,0,25,2
1683635321448,TDGE 127,A00,189322,Havis; Allan,0,0,50,50
1683635322476,TDHT 101,A00,189323,Staff,18,0,25,7
1683635322476,TDHT 101,B00,189324,Staff,25,0,25,0
1683635323505,TDHT 102,A00,189325,Staff,49,0,50,1
1683635324535,TDMV 1,A00,189295,Arcidiacono; Kristin,20,0,30,10
1683635324535,TDMV 1,B00,189296,Caligagan; Maria T.,24,0,30,6
1683635325562,TDMV 2,A00,189297,Sammartano; Tonnie,27,0,30,3
1683635325562,TDMV 2,B00,189299,Arcidiacono; Kristin,23,0,30,7
1683635326588,TDMV 3,A00,204998,Rincon; Alicia,22,0,30,8
1683635327618,TDMV 120,A00,189458,Sammartano; Tonnie,28,0,30,2
1683635328644,TDMV 138,A00,189541,Jun; Grace Shin Hae,20,0,40,20
1683635329669,TDMV 142,A00,189717,Caligagan; Tony,25,0,30,5
1683635329669,TDMV 142,B00,189718,Caligagan; Maria T.,25,0,30,5
1683635330694,TMC 2,A01,187533,Staff,25,0,25,0
1683635330694,TMC 2,A02,187534,Staff,25,0,25,0
1683635331720,USP 1,A01,187536,Kwak; Nancy,0,16,25,25
1683635332747,USP 5,A01,187538,Staff,9,0,25,16
1683635333772,USP 101,A00,199253,Staff,0,4,0,0
1683635334804,USP 124,A00,187562,Boomhower; Matthew Charles,0,0,30,30
1683635335832,USP 138,A00,187582,Staff,20,0,25,5
1683635336857,USP 152,A01,187597,Staff,3,0,25,22
1683635337883,USP 153,A00,187598,Staff,19,0,25,6
1683635338909,USP 168,A00,187607,Kwak; Nancy,2,0,5,3
1683635339934,USP 173,A00,187619,Staff,4,0,25,21
1683635340959,USP 181,A00,187638,Staff,0,4,25,25
1683635341990,VIS 103,A00,187650,Cruz; Edwin Teddy,18,0,75,57
1683635343017,VIS 110D,A00,187669,Staff,13,0,22,9
1683635344048,VIS 127C,A00,187720,Shen; Kuiyi,67,0,146,79
1683635345074,VIS 149,A00,187731,Yoldas; Pinar,0,14,22,22
1683635346100,VIS 151,A01,188091,Staff,22,0,34,12
1683635346100,VIS 151,A02,188092,Staff,11,0,34,23
1683635347127,VIS 160B,A00,188093,Stalbaum; Brett,0,1,10,10
1683635349181,WCWP 10B,A00,201720,Staff,10,0,15,5
1683635349181,WCWP 10B,B00,201722,Staff,9,0,15,6
1683635350227,WCWP 100,A00,201725,Gagnon; Jeffrey C,0,0,2,2
1683635350227,WCWP 100,B00,201727,Staff,0,4,15,15
1683635353352,ANBI 133,A00,258401,Wilder; Linnea Lorene,34,0,40,6
1683635354376,ANBI 140,A00,258395,Hrvoj Mihic; Branka,18,0,25,7
1683635355401,ANSC 120,A00,258402,Bialecki; Jon Anthony,27,0,40,13
1683635356425,ANSC 144,A00,258400,Staff,12,0,40,28
1683635358477,ANSC 166,A00,258396,Parish; Steven Martin,156,0,175,19
1683635359507,ANSC 180,A00,193533,Staff,8,0,20,12
1683635360540,ANSC 188,A00,258397,Jassal; Aftab,34,0,40,6
1683635361566,ANTH 3,A01,258316,Staff,23,0,30,7
1683635362591,ANTH 5,A00,258394,Semendeferi; Ekaterini,16,0,20,4
1683635363620,ANTH 21,A01,258331,Staff,4,0,40,36
1683635364651,ANTH 103,A00,258398,Varma; Saiba,15,0,25,10
1683635365691,AWP 10,001,202034,Staff,0,0,0,0
1683635365691,AWP 10,002,202035,Staff,0,0,0,0
1683635365691,AWP 10,003,202036,Staff,0,0,0,0
1683635365691,AWP 10,004,202037,Staff,0,0,0,0
1683635365691,AWP 10,005,202038,Staff,0,0,0,0
1683635365691,AWP 10,006,202039,Staff,0,0,0,0
1683635365691,AWP 10,007,202040,Staff,0,0,0,0
1683635365691,AWP 10,008,202041,Staff,0,0,0,0
1683635365691,AWP 10,009,202042,Staff,0,0,0,0
1683635365691,AWP 10,010,202043,Staff,0,0,0,0
1683635365691,AWP 10,011,202044,Staff,0,0,0,0
1683635365691,AWP 10,012,202045,Staff,0,0,0,0
1683635365691,AWP 10,013,202046,Staff,0,0,0,0
1683635365691,AWP 10,014,202047,Staff,0,0,0,0
1683635365691,AWP 10,015,202048,Staff,0,0,0,0
1683635365691,AWP 10,016,202049,Staff,0,0,0,0
1683635365691,AWP 10,017,202050,Staff,0,0,0,0
1683635365691,AWP 10,018,202051,Staff,0,0,0,0
1683635365691,AWP 10,019,202052,Staff,0,0,0,0
1683635365691,AWP 10,020,202053,Staff,0,0,0,0
1683635365691,AWP 10,021,202054,Staff,0,0,0,0
1683635365691,AWP 10,022,202055,Staff,0,0,0,0
1683635365691,AWP 10,023,202056,Staff,0,0,0,0
1683635365691,AWP 10,024,202057,Staff,0,0,0,0
1683635365691,AWP 10,025,202058,Staff,0,0,0,0
1683635365691,AWP 10,026,202059,Staff,0,0,0,0
1683635366717,AWP 102,001,202032,Staff,0,0,0,0
1683635366717,AWP 102,002,202033,Staff,0,0,0,0
1683635367744,BENG 100,A01,254234,Taylor Amos; Alyssa C,31,0,40,9
1683635368780,BENG 196,001,270013,Engler; Adam J.,9999,0,9999,0
1683635369816,BICD 100R,A01,202018,Smith; Laurie,0,7,32,32
1683635369816,BICD 100R,A02,202019,Smith; Laurie,0,3,32,32
1683635369816,BICD 100R,A03,202020,Smith; Laurie,0,1,32,32
1683635369816,BICD 100R,A04,202021,Smith; Laurie,6,0,32,26
1683635369816,BICD 100R,A05,202022,Smith; Laurie,11,0,32,21
1683635370848,BICD 136,A01,193242,Gustafson-Brown; Cindy,0,2,32,32
1683635370848,BICD 136,A02,193244,Gustafson-Brown; Cindy,13,0,32,19
1683635371876,BIEB 102,A01,193249,Butler; Shannon Rhey,0,2,32,32
1683635371876,BIEB 102,A02,193251,Butler; Shannon Rhey,0,0,32,32
1683635371876,BIEB 102,A03,193253,Butler; Shannon Rhey,0,0,32,32
1683635371876,BIEB 102,A04,193255,Butler; Shannon Rhey,14,0,32,18
1683635371876,BIEB 102,A05,193265,Butler; Shannon Rhey,26,0,32,6
1683635371876,BIEB 102,A06,193269,Butler; Shannon Rhey,14,0,32,18
1683635373927,BIEB 150,A01,193274,Staff,0,0,32,32
1683635373927,BIEB 150,A02,193285,Staff,24,0,32,8
1683635374952,BIEB 194,A00,193286,Kurle; Carolyn M.,20,0,32,12
1683635375978,BILD 1,A01,192291,Staff,15,0,32,17
1683635375978,BILD 1,A02,192292,Staff,30,0,32,2
1683635375978,BILD 1,B01,192520,Reuther; Keefe,0,1,0,0
1683635375978,BILD 1,B02,192532,Reuther; Keefe,0,1,0,0
1683635377011,BILD 3,A01,192556,Butler; Shannon Rhey,0,0,32,32
1683635377011,BILD 3,A02,192581,Butler; Shannon Rhey,1,0,32,31
1683635377011,BILD 3,A03,192611,Butler; Shannon Rhey,21,0,32,11
1683635377011,BILD 3,A04,192612,Butler; Shannon Rhey,24,0,32,8
1683635377011,BILD 3,A05,192613,Butler; Shannon Rhey,26,0,32,6
1683635377011,BILD 3,A06,192679,Butler; Shannon Rhey,27,0,32,5
1683635377011,BILD 3,A07,192682,Butler; Shannon Rhey,20,0,32,12
1683635378042,BILD 4,A01,192836,Reuther; Keefe,0,0,24,24
1683635378042,BILD 4,A02,193044,Reuther; Keefe,4,0,24,20
1683635379071,BILD 10,A01,193142,Gustafson-Brown; Cindy,29,0,32,3
1683635379071,BILD 10,A02,193149,Gustafson-Brown; Cindy,31,0,32,1
1683635380102,BIMM 100,A01,193301,Staff,0,6,32,32
1683635380102,BIMM 100,A02,193312,Staff,0,7,32,32
1683635380102,BIMM 100,A03,193323,Staff,0,9,32,32
1683635381136,BIMM 101,A01,193329,McDonnell; Lisa Marie,0,4,24,24
1683635381136,BIMM 101,A02,193339,McDonnell; Lisa Marie,0,3,24,24
1683635381136,BIMM 101,B01,193354,McDonnell; Lisa Marie,0,4,24,24
1683635381136,BIMM 101,B02,193357,McDonnell; Lisa Marie,0,2,24,24
1683635382160,BIMM 110,A01,193377,Tat; John,0,11,32,32
1683635382160,BIMM 110,A02,193378,Tat; John,0,10,32,32
1683635383187,BIMM 120,A01,206116,Staff,0,0,32,32
1683635383187,BIMM 120,A02,206117,Staff,6,0,32,26
1683635383187,BIMM 120,A03,206121,Staff,21,0,32,11
1683635384212,BIPN 100,A01,193393,Park; Ji Young,0,14,32,32
1683635384212,BIPN 100,A02,193402,Park; Ji Young,0,14,32,32
1683635384212,BIPN 100,A03,193413,Park; Ji Young,0,14,32,32
1683635384212,BIPN 100,A04,193414,Park; Ji Young,0,13,32,32
1683635385239,BIPN 102,A01,193429,Staff,0,0,32,32
1683635385239,BIPN 102,A02,193438,Staff,18,0,32,14
1683635386264,BIPN 106,A01,193450,Reyes Gonzalez; Catalina,0,2,40,40
1683635387296,BIPN 134,A01,193465,Cooke; James Edward,0,0,32,32
1683635387296,BIPN 134,A02,193474,Cooke; James Edward,25,0,32,7
1683635387296,BIPN 134,A03,193485,Cooke; James Edward,29,0,32,3
1683635387296,BIPN 134,A04,193486,Cooke; James Edward,20,0,32,12
1683635387296,BIPN 134,A05,193491,Cooke; James Edward,31,0,32,1
1683635387296,BIPN 134,A06,193501,Cooke; James Edward,30,0,32,2
1683635387296,BIPN 134,A07,193510,Cooke; James Edward,29,0,32,3
1683635389347,BISP 194,A00,222522,Staff,14,0,32,18
1683635390372,CAT 124,A01,202407,Staff,19,0,25,6
1683635391399,CAT 125,A00,202408,Marchisotto; Jennifer Anne,2,0,20,18
1683635392434,CAT 125R,A00,202409,Smith; Lauryn Alissa,0,11,20,20
1683635392434,CAT 125R,B00,202410,Morales; Celeste Georgianna,0,11,20,20
1683635392434,CAT 125R,C00,202411,Irwin; Matthew Joseph,0,12,20,20
1683635393460,CENG 15,A01,204712,Yang; Kesong,0,1,0,0
1683635394486,CENG 114,A00,202070,Jahed Motlagh; Zeinab,5,0,20,15
1683635395513,CGS 105,A00,185477,Wesling; Megan E.,24,0,40,16
1683635396538,CGS 106,A00,185494,Staff,11,0,22,11
1683635397566,CGS 108,A00,185495,Staff,14,0,20,6
1683635398594,CGS 114,A00,185496,Staff,13,0,18,5
1683635399622,CGS 119,A00,185501,Staff,15,0,20,5
1683635400647,CGS 120,A00,185511,Staff,12,0,20,8
1683635401673,CHEM 4,A01,184675,Bussey; Thomas J,97,0,100,3
1683635402700,CHEM 6A,A01,184677,Staff,33,0,60,27
1683635403726,CHEM 6B,A01,184679,Staff,63,0,100,37
1683635404756,CHEM 6C,A01,184681,Bussey; Thomas J,0,0,50,50
1683635404756,CHEM 6C,A02,184682,Bussey; Thomas J,32,0,50,18
1683635405787,CHEM 40A,A01,184684,Albizati; Kim F.,35,0,100,65
1683635406817,CHEM 40B,A01,184686,Albizati; Kim F.,0,22,100,100
1683635407845,CHEM 41B,A01,184690,Staff,51,0,100,49
1683635408872,COGS 3,A01,184715,Boyle; Mary E. T.,0,27,40,40
1683635409898,COGS 14B,A01,185172,Staff,0,14,38,38
1683635410928,COGS 18,A01,184736,Staff,15,0,80,65
1683635411956,COGS 100,A01,184932,Staff,0,7,73,73
1683635412984,COGS 101A,A01,184935,Staff,0,39,30,30
1683635414012,COGS 101B,A01,184944,Staff,0,2,30,30
1683635415041,COGS 101C,A01,184946,Staff,0,10,30,30
1683635416123,COGS 102A,A01,184951,Johnson; Christine M.,2,0,40,38
1683635417153,COGS 107B,A01,184953,Mooshagian; Eric Frederick,0,51,40,40
1683635418178,COGS 118B,A01,184959,Gupta; Anjum,0,49,40,40
1683635419204,COGS 153,A00,184961,Staff,0,16,30,30
1683635420235,COGS 177,A00,184962,Staff,0,21,30,30
1683635421260,COGS 187A,A01,184969,Boyle; Mary E. T.,0,19,40,40
1683635422289,COMM 10,A01,185174,Staff,0,5,25,25
1683635422289,COMM 10,A02,185189,Staff,0,2,25,25
1683635422289,COMM 10,A03,269821,Staff,0,1,0,0
1683635423314,COMM 100B,A01,185475,Staff,0,1,0,2
1683635423314,COMM 100B,A02,185476,Staff,12,0,25,13
1683635424339,COMM 100C,A01,185314,Staff,1,0,25,24
1683635424339,COMM 100C,A02,185327,Staff,18,0,25,7
1683635425364,COMM 110M,A00,185349,Staff,0,0,40,40
1683635426390,COMM 113T,A00,185352,Staff,25,0,40,15
1683635427415,COMM 114I,A00,185353,Staff,31,0,40,9
1683635428446,COMM 131,A00,185354,Staff,17,0,30,13
1683635429475,CSE 8A,A50,185358,Cao; Yingjun,0,46,10,10
1683635430501,CSE 8B,A01,185362,Staff,0,48,50,50
1683635431532,CSE 11,A01,185416,Cao; Yingjun,0,91,10,10
1683635432562,CSE 20,A01,185445,Briones; Jor-el Thomas Caparas,4,0,25,21
1683635433592,CSE 21,A01,185447,Staff,9,0,50,41
1683635434624,CSE 101,A01,185451,Staff,0,13,50,50
1683635434624,CSE 101,B01,185453,Jones; Miles E,0,13,50,50
1683635436677,CSE 141,A01,185458,Eldon; John,15,0,100,85
1683635437701,CSE 141L,A01,185461,Eldon; John,7,0,100,93
1683635438731,CSE 142,A01,185463,Staff,36,0,60,24
1683635438731,CSE 142,B01,201355,Staff,0,7,60,60
1683635439756,CSE 142L,A01,185470,Staff,36,0,60,24
1683635439756,CSE 142L,B01,201417,Staff,0,6,60,60
1683635440781,CSE 190,A00,201433,Staff,32,0,49,17
1683635441810,DOC 1,A01,259136,Strom; Megan C.,7,0,15,8
1683635441810,DOC 1,A02,259137,Strom; Megan C.,14,0,15,1
1683635441810,DOC 1,A03,259138,Strom; Megan C.,14,0,15,1
1683635441810,DOC 1,A04,259139,Strom; Megan C.,14,0,15,1
1683635442840,DOC 100D,A00,259140,Pass; Natalye Joann,14,0,25,11
1683635443869,DSGN 1,A01,184749,Rill; Bryan,0,26,30,30
1683635444897,DSGN 100,A01,185168,Staff,0,2,25,25
1683635445923,ECE 5,A01,185626,Morris; Karcher William,0,11,0,0
1683635446951,ECE 101,A01,185628,Staff,14,0,70,56
1683635447979,ECE 107,A01,185635,Baghdadchi; Saharnaz,0,0,20,20
1683635447979,ECE 107,A02,185638,Baghdadchi; Saharnaz,3,0,20,17
1683635449010,ECE 148,A01,185647,Silberman; Jack,0,0,16,16
1683635450039,ECON 1,A01,185537,Crane; Meredith Helen,54,0,70,16
1683635451082,ECON 3,A01,185549,Crane; Meredith Helen,29,0,70,41
1683635452108,ECON 4,A01,203354,Anderson; John Charles,0,5,10,10
1683635453134,ECON 100A,A01,185574,Staff,0,5,40,40
1683635454160,ECON 100B,A01,185576,Staff,0,12,50,50
1683635455185,ECON 100C,A01,185589,Newhouse; Herbert S,30,0,70,40
1683635456210,ECON 105,A00,185608,Vespa; Emanuel Ignacio,19,0,35,16
1683635457238,ECON 109,A01,185610,Shishkin; Denis,9,0,35,26
1683635458262,ECON 110A,A01,185612,Staff,9,0,40,31
1683635459291,ECON 120A,A01,185615,Staff,20,0,40,20
1683635460317,ECON 120C,A01,185617,Sun; Yixiao,0,20,70,70
1683635461344,ECON 144,A00,203346,Squires; Dale E,2,0,35,33
1683635462374,ECON 171,A01,203349,Newhouse; Herbert S,0,1,35,35
1683635463400,ECON 173A,A01,185621,Toda; Alexis Akira,21,0,35,14
1683635464434,EDS 25,A01,202413,Staff,0,1,0,0
1683635464434,EDS 25,A02,202414,Staff,0,1,0,0
1683635464434,EDS 25,A03,202415,Staff,0,0,0,0
1683635464434,EDS 25,A04,202416,Staff,0,1,0,0
1683635464434,EDS 25,A05,202439,Staff,0,0,0,0
1683635464434,EDS 25,A06,202440,Staff,0,0,0,0
1683635464434,EDS 25,B01,202631,Staff,0,0,0,0
1683635464434,EDS 25,B02,202632,Staff,0,0,0,0
1683635464434,EDS 25,B03,202639,Staff,0,0,0,0
1683635464434,EDS 25,B04,202640,Staff,0,0,0,0
1683635464434,EDS 25,B05,202643,Staff,0,0,0,0
1683635464434,EDS 25,B06,202644,Staff,0,0,0,0
1683635465466,EDS 38,A01,202659,Black; Alison Michelle,24,0,25,1
1683635466495,EDS 115,A00,202652,Staff,18,0,30,12
1683635467526,EDS 125,A00,202649,Staff,13,0,30,17
1683635468552,EDS 126,A01,203332,Staff,30,0,30,0
1683635469580,EDS 139,A00,202838,Staff,16,0,25,9
1683635470610,EDS 146,A01,202655,Staff,14,0,25,11
1683635471636,ENG 15,A00,185667,Staff,0,1,0,0
1683635471636,ENG 15,B00,185672,Staff,0,0,0,0
1683635471636,ENG 15,C00,185675,Staff,0,0,0,0
1683635471636,ENG 15,D00,185682,Staff,0,0,0,0
1683635471636,ENG 15,E00,185684,Staff,0,0,0,0
1683635472663,ETHN 103,A00,185710,Staff,0,8,35,35
1683635473690,ETHN 103A,A00,199228,Man; Simeon S,0,0,9,9
1683635474716,ETHN 109,A00,185711,Staff,16,0,35,19
1683635475743,ETHN 142,A00,185726,Staff,0,4,30,30
1683635476769,ETHN 163J,A00,199229,Man; Simeon S,5,0,8,3
1683635477795,ETHN 168,A00,185727,Staff,7,0,10,3
1683635478820,ETHN 182,A00,185728,Staff,0,0,35,35
1683635479845,ETHN 183,A00,185737,Staff,9,0,18,9
1683635480871,GLBH 111,A01,209361,Burgos; Jose L.,0,0,0,0
1683635482929,HIEU 104,A00,185792,Staff,14,0,20,6
1683635483958,HIEU 115,A00,185800,Staff,0,0,20,20
1683635484984,HIEU 128,A00,185801,Staff,0,9,20,20
1683635486010,HIEU 147,A00,185802,Staff,15,0,20,5
1683635487036,HIEU 154,A00,185823,Staff,11,0,20,9
1683635488061,HILA 102,A00,185826,Staff,14,0,20,6
1683635489087,HILD 2C,A01,185778,Staff,0,13,20,20
1683635490114,HILD 7B,A01,185780,Kwak; Nancy,0,16,32,32
1683635490114,HILD 7B,A02,185781,Kwak; Nancy,0,18,32,32
1683635491143,HILD 30,A01,185791,Staff,12,0,20,8
1683635492169,HISC 119,A00,185830,Golan; Tal,0,9,20,20
1683635493200,HITO 156GS,A00,185831,Patterson; Patrick H.,0,0,0,23
1683635494233,HIUS 103,A00,185832,Man; Simeon S,0,4,20,20
1683635495259,HIUS 117,A00,185836,Kwak; Nancy,2,0,20,18
1683635496288,HIUS 125,A00,185840,Man; Simeon S,0,1,23,23
1683635497316,HIUS 149,A00,185845,Staff,1,0,20,19
1683635498348,HUM 3,A01,185882,Zavodny; Tatiana Sophia,0,7,50,50
1683635498348,HUM 3,B01,185899,Caldwell; Michael Alan,0,18,50,50
1683635499374,HUM 3GS,A00,185900,Patterson; Patrick H.,0,0,0,23
1683635500402,HUM 4,A01,185938,Zroka; Amy Liane,30,0,50,20
1683635500402,HUM 4,B01,185956,Watkins; Eric,0,4,50,50
1683635500402,HUM 4,B02,202209,Watkins; Eric,0,4,50,50
1683635500402,HUM 4,B03,202210,Watkins; Eric,0,4,50,50
1683635501433,HUM 5,A01,185958,West; Geoffrey Scott,2,0,50,48
1683635501433,HUM 5,A02,202215,West; Geoffrey Scott,0,0,50,50
1683635502463,INTL 190,A00,185959,Gagnon; Jeffrey C,0,0,0,9
1683635502463,INTL 190,B00,185960,Lettieri; Michael Joseph,0,0,0,2
1683635503493,JAPN 180,A00,254509,Staff,5,0,30,25
1683635504526,LATI 10,A01,202853,Kennemore; Amy Michelle,4,0,35,31
1683635504526,LATI 10,A02,202854,Kennemore; Amy Michelle,2,0,35,33
1683635504526,LATI 10,A03,270054,Kennemore; Amy Michelle,30,0,30,0
1683635505552,LATI 180,A00,202855,Kennemore; Amy Michelle,11,0,20,9
1683635506580,LAWS 101,A00,201767,Golan; Tal,0,7,40,40
1683635507611,LIFR 1C,A00,185961,Staff,6,0,20,14
1683635508638,LIFR 1CX,A00,185962,Staff,7,0,20,13
1683635509662,LIFR 1D,A00,185963,Staff,7,0,20,13
1683635510687,LIFR 1DX,A00,185964,Staff,7,0,20,13
1683635511713,LIGN 101,A01,186039,Staff,43,0,50,7
1683635512738,LIGN 165,A00,186040,Staff,15,0,50,35
1683635513764,LTCS 108,A00,186041,Staff,5,0,10,5
1683635514791,LTCS 119,A00,186042,Staff,15,0,20,5
1683635515825,LTCS 130,A00,186043,Wesling; Megan E.,15,0,25,10
1683635517877,LTEA 138,A00,186119,Staff,14,0,40,26
1683635518905,LTEN 124,A00,186148,Staff,6,0,25,19
1683635519990,LTEN 178,A00,186149,Staff,7,0,15,8
1683635521019,LTEN 181,A00,186150,Blanco; John D,34,0,40,6
1683635522044,LTWL 120,A00,186160,Staff,20,0,25,5
1683635523071,LTWL 165,A00,186161,Staff,22,0,25,3
1683635524095,LTWR 100,A00,186162,Staff,0,5,15,15
1683635525120,LTWR 102,A00,186163,Doller; Ben,5,0,15,10
1683635526150,MAE 8,A01,186412,Staff,0,0,0,0
1683635527192,MAE 30B,A00,186445,Bahadori; Mohammad Yousef,82,0,100,18
1683635528221,MAE 40,A00,186592,Bewley; Thomas R,10,0,50,40
1683635529250,MAE 101B,A00,186593,Bahadori; Mohammad Yousef,80,0,100,20
1683635530276,MAE 105,A00,186594,Bandaru; Prabhakar,10,0,50,40
1683635531300,MAE 107,A00,186599,Pham; Hieu Tan,0,7,120,120
1683635532335,MAE 148,A01,186660,Silberman; Jack,3,0,16,13
1683635533365,MATH 10A,A01,188095,Staff,0,5,35,35
1683635534397,MATH 10B,A01,188097,Bowers; Adam R.,0,11,30,30
1683635534397,MATH 10B,A02,188099,Bowers; Adam R.,0,11,30,30
1683635534397,MATH 10B,B01,188104,Bowers; Adam R.,0,10,30,30
1683635534397,MATH 10B,B02,188106,Bowers; Adam R.,1,9,30,29
1683635535430,MATH 10C,A01,188111,Staff,0,18,30,30
1683635535430,MATH 10C,A02,188127,Staff,0,19,30,30
1683635535430,MATH 10C,A03,188131,Staff,0,19,30,30
1683635535430,MATH 10C,B01,188218,Staff,17,0,30,13
1683635535430,MATH 10C,B02,188244,Staff,13,0,30,17
1683635535430,MATH 10C,B03,188277,Staff,14,0,30,16
1683635536461,MATH 18,A01,188344,Bach; Quang Tran,18,0,30,12
1683635536461,MATH 18,A02,188345,Bach; Quang Tran,11,0,30,19
1683635536461,MATH 18,B01,188353,Bach; Quang Tran,11,0,30,19
1683635536461,MATH 18,B02,188354,Bach; Quang Tran,19,0,30,11
1683635537491,MATH 20A,A01,188374,Staff,11,0,35,24
1683635538517,MATH 20B,A01,188382,Ohm; Ko Woon,7,0,30,23
1683635538517,MATH 20B,A02,188383,Ohm; Ko Woon,22,0,30,8
1683635538517,MATH 20B,B01,188385,Ohm; Ko Woon,7,0,30,23
1683635538517,MATH 20B,B02,188392,Ohm; Ko Woon,22,0,30,8
1683635539544,MATH 20C,A01,188394,Harel; Guershon,11,0,30,19
1683635539544,MATH 20C,A02,188395,Harel; Guershon,14,0,30,16
1683635539544,MATH 20C,B01,188404,Harel; Guershon,4,0,30,26
1683635539544,MATH 20C,B02,188405,Harel; Guershon,18,0,30,12
1683635540574,MATH 20D,A01,188414,Hammock; Frances H,0,1,30,30
1683635540574,MATH 20D,A02,188415,Hammock; Frances H,0,1,30,30
1683635540574,MATH 20D,B01,188447,Hammock; Frances H,0,1,30,30
1683635540574,MATH 20D,B02,188486,Hammock; Frances H,4,0,30,26
1683635541599,MATH 20E,A01,188649,Staff,21,0,30,9
1683635541599,MATH 20E,A02,188650,Staff,21,0,30,9
1683635541599,MATH 20E,A03,188673,Staff,0,0,30,30
1683635542624,MATH 102,A01,188675,Staff,0,36,35,35
1683635543651,MATH 103B,A01,188681,Staff,3,0,35,32
1683635543651,MATH 103B,B01,188692,Staff,5,0,35,30
1683635544677,MATH 109,A01,188695,Salehi Golsefidy; Alireza,24,0,35,11
1683635544677,MATH 109,A02,188696,Salehi Golsefidy; Alireza,25,0,35,10
1683635545703,MATH 120A,A01,188698,Eggers; John Dietrich,7,0,35,28
1683635546727,MATH 142B,A01,188736,Ioana; Adrian,0,1,30,30
1683635546727,MATH 142B,A02,188741,Ioana; Adrian,0,1,30,30
1683635546727,MATH 142B,A03,188743,Ioana; Adrian,0,1,30,30
1683635547757,MATH 168A,A01,188790,Staff,0,10,35,35
1683635548782,MATH 170A,A01,188803,Nie; Jiawang,0,2,35,35
1683635548782,MATH 170A,A02,188811,Nie; Jiawang,0,0,35,35
1683635548782,MATH 170A,A03,188814,Nie; Jiawang,0,0,35,35
1683635548782,MATH 170A,A04,188815,Nie; Jiawang,10,0,35,25
1683635549810,MATH 193B,A01,188817,Staff,0,0,35,35
1683635549810,MATH 193B,A02,188818,Staff,5,0,35,30
1683635550837,MGT 4,A01,202857,Anderson; John Charles,61,0,80,19
1683635551862,MGT 12,A00,202858,Lindenberger; Wade Douglas,40,0,90,50
1683635552890,MGT 18,A00,202859,Staff,74,0,90,16
1683635553922,MGT 18GS,A00,202860,McKay; Michael J,13,0,28,15
1683635554952,MGT 45,A00,202861,Pecore; Joseph P.,12,0,90,78
1683635555978,MGT 100,A00,202863,Yavorsky; Daniel Ryan,28,0,90,62
1683635557003,MGT 103,A00,202864,Ehrich; Kristine R,0,17,90,90
1683635558030,MGT 112,A00,202865,Ehrich; Kristine R,15,0,90,75
1683635559062,MGT 121A,A00,202868,Staff,0,20,0,0
1683635560087,MGT 131B,A00,202869,Anderson; John Charles,59,0,90,31
1683635561125,MGT 136,A00,202871,Lindenberger; Wade Douglas,83,0,90,7
1683635562151,MGT 164,A00,202873,Staff,0,66,90,91
1683635563179,MGT 164GS,A00,202874,McKay; Mary A,13,0,28,15
1683635564204,MGT 180,A00,202875,Staff,0,50,90,91
1683635565229,MMW 11R,A01,205019,Herbst; Matthew,2,0,30,28
1683635565229,MMW 11R,A02,205026,Herbst; Matthew,29,0,30,1
1683635566256,MMW 15,A01,193512,Chang; Edmond Yi-Teh,0,8,28,28
1683635566256,MMW 15,A02,193513,Chang; Edmond Yi-Teh,0,5,28,28
1683635566256,MMW 15,A03,193514,Chang; Edmond Yi-Teh,0,5,28,28
1683635566256,MMW 15,A04,193515,Chang; Edmond Yi-Teh,0,5,28,28
1683635566256,MMW 15,A05,193516,Chang; Edmond Yi-Teh,0,5,28,28
1683635566256,MMW 15,A06,193517,Chang; Edmond Yi-Teh,0,6,28,28
1683635566256,MMW 15,B01,193519,Chang; Edmond Yi-Teh,0,5,28,28
1683635566256,MMW 15,B02,193520,Chang; Edmond Yi-Teh,0,5,28,28
1683635566256,MMW 15,B03,193521,Chang; Edmond Yi-Teh,0,5,28,28
1683635566256,MMW 15,B04,193522,Chang; Edmond Yi-Teh,0,5,28,28
1683635566256,MMW 15,B05,193523,Chang; Edmond Yi-Teh,0,5,28,28
1683635566256,MMW 15,B06,193524,Chang; Edmond Yi-Teh,0,5,28,28
1683635567285,MMW 122,A01,193526,Rahimi; Babak,0,16,28,28
1683635567285,MMW 122,A02,193527,Rahimi; Babak,0,15,28,28
1683635567285,MMW 122,A03,193528,Rahimi; Babak,0,0,0,0
1683635567285,MMW 122,A04,193529,Rahimi; Babak,0,0,0,0
1683635568311,MUS 1A,A01,186663,Staff,1,20,35,34
1683635569336,MUS 4,A01,186715,Staff,0,12,35,35
1683635570366,MUS 5R,A01,186796,Dubnov; Shlomo,0,17,35,35
1683635571395,MUS 6,A01,186798,Staff,0,5,25,25
1683635572423,MUS 7,A01,186830,Staff,11,0,35,24
1683635573448,MUS 8,A01,186930,Staff,0,26,35,35
1683635574476,MUS 15,A01,186932,Staff,0,16,35,35
1683635574476,MUS 15,B01,186934,Staff,0,17,35,35
1683635575507,MUS 80,A00,186935,Staff,0,0,20,20
1683635575507,MUS 80,B00,186936,Staff,24,0,25,1
1683635576537,NANO 11,A00,204702,Lipomi; Darren John,0,0,0,0
1683635577563,NANO 15,A01,204709,Yang; Kesong,0,1,0,0
1683635578592,NANO 114,A00,202069,Jahed Motlagh; Zeinab,3,0,10,7
1683635579618,PHIL 1,A00,186955,Grush; Rick Scott,31,0,40,9
1683635580648,PHIL 10,A01,186973,Grush; Rick Scott,27,0,35,8
1683635580648,PHIL 10,A02,186974,Grush; Rick Scott,33,0,35,2
1683635581676,PHIL 13,A01,186976,Staff,3,0,35,32
1683635581676,PHIL 13,A02,186977,Staff,16,0,35,19
1683635582704,PHIL 14,A01,186979,Staff,31,0,35,4
1683635582704,PHIL 14,A02,186986,Staff,32,0,35,3
1683635583731,PHIL 28,A01,186988,Staff,16,0,30,14
1683635583731,PHIL 28,A02,186989,Staff,1,0,30,29
1683635583731,PHIL 28,A03,186990,Staff,10,0,30,20
1683635583731,PHIL 28,A04,186991,Staff,26,0,30,4
1683635584758,PHIL 120,A00,186997,Staff,23,0,40,17
1683635585787,PHIL 137,A00,187003,Staff,7,0,40,33
1683635586816,PHIL 150,A00,187015,Staff,47,0,70,23
1683635587842,PHIL 167,A00,187021,Lamey; Andy M.,34,0,40,6
1683635588871,PHIL 174,A01,202226,Staff,17,0,20,3
1683635588871,PHIL 174,A02,202235,Staff,20,0,20,0
1683635589896,PHIL 191A,A00,258918,Staff,0,0,1,1
1683635590922,PHYS 1A,A00,187028,Staff,27,0,60,33
1683635591951,PHYS 1AL,001,187036,Staff,3,0,30,27
1683635591951,PHYS 1AL,002,187049,Staff,18,0,30,12
1683635592979,PHYS 1B,A00,187058,Staff,22,0,60,38
1683635594015,PHYS 1BL,001,187064,Staff,0,1,30,30
1683635594015,PHYS 1BL,002,187070,Staff,4,0,30,26
1683635595043,PHYS 1C,A00,187082,Staff,29,0,120,91
1683635596074,PHYS 1CL,001,187088,Staff,0,9,30,30
1683635596074,PHYS 1CL,002,187089,Staff,0,1,30,30
1683635596074,PHYS 1CL,009,262693,Staff,9,0,30,21
1683635597103,PHYS 2B,A01,187097,Staff,55,0,115,60
1683635598135,PHYS 2C,A01,187099,Staff,64,0,115,51
1683635599160,PHYS 2CL,A01,187101,Staff,5,0,28,23
1683635599160,PHYS 2CL,A02,187102,Staff,15,0,28,13
1683635600194,PHYS 2D,A01,187123,Shotwell; Brian,95,0,115,20
1683635601225,PHYS 4B,A01,187133,Grinstein; Benjamin,35,0,50,15
1683635602253,POLI 10,A00,188819,Staff,0,4,50,50
1683635603280,POLI 11,A00,188827,Staff,43,0,50,7
1683635604308,POLI 13R,A00,188828,Staff,0,1,20,20
1683635605335,POLI 27,A01,188830,Elgin; Samuel Zincke,0,2,70,70
1683635606366,POLI 30,A00,188832,Desposato; Scott,30,0,50,20
1683635607397,POLI 102F,A00,188834,Staff,0,0,40,40
1683635608421,POLI 104A,A00,188852,Staff,13,0,30,17
1683635609446,POLI 104I,A00,188853,Staff,0,7,20,20
1683635610473,POLI 110B,A00,188854,Wiens; David,7,0,20,13
1683635611499,POLI 112A,A00,188855,Wiens; David,4,0,30,26
1683635612528,POLI 117R,A00,188856,Forman; Fonna,0,12,20,20
1683635613555,POLI 118,A00,188857,Ingham; Sean,8,0,20,12
1683635614580,POLI 120G,A00,188858,Staff,8,0,30,22
1683635615605,POLI 131CR,A00,188863,Hoston; Germaine,21,0,50,29
1683635616634,POLI 133,A00,188864,Nellis; Gareth Hb,44,0,50,6
1683635617665,POLI 134D,A00,188865,Desposato; Scott,27,0,30,3
1683635618699,POLI 142A,A00,188871,Gartzke; Erik,21,0,50,29
1683635619724,POLI 142K,A00,188874,Staff,38,0,50,12
1683635620749,POLI 143,A00,188940,Gartzke; Erik,16,0,30,14
1683635621774,POLI 153,A00,188943,Staff,2,0,20,18
1683635622800,POLI 160AA,A00,188944,Staff,11,0,40,29
1683635623880,POLI 170A,A00,188945,Staff,11,0,30,19
1683635625936,PSYC 1,A00,188952,Staff,36,0,90,54
1683635626963,PSYC 2,B00,188953,Staff,19,0,35,16
1683635627992,PSYC 6,A00,188970,Staff,47,0,60,13
1683635629022,PSYC 7,A00,188973,Staff,35,0,45,10
1683635630049,PSYC 60,A01,188980,Rickard; Timothy C.,42,0,60,18
1683635631080,PSYC 70,A01,189001,Steiner; Eric Tomas,23,0,45,22
1683635632107,PSYC 100,A00,189005,Lacefield; Katharine I,0,99,120,120
1683635633136,PSYC 102,A00,189008,Staff,8,0,30,22
1683635634166,PSYC 106,B00,189026,Gorman; Michael R.,27,0,60,33
1683635635195,PSYC 114,B01,189033,Winkielman; Piotr,0,31,30,30
1683635636225,PSYC 131,A00,189036,Anagnostaras; Stephan,0,43,60,60
1683635637251,PSYC 136,A00,189041,Lowe; Angela Beth,0,7,25,25
1683635638274,PSYC 137,A00,189057,Winkielman; Piotr,0,37,25,25
1683635639300,PSYC 144,A00,189107,Wixted; John T,0,10,50,50
1683635641352,PSYC 162,A00,189142,Staff,0,9,85,85
1683635642380,PSYC 172,A00,189144,Gorman; Michael R.,0,6,30,30
1683635644442,PSYC 179,A00,189146,Lacefield; Katharine I,0,86,120,120
1683635645467,PSYC 181,A00,189147,Anagnostaras; Stephan,0,44,90,90
1683635646499,PSYC 190R,A00,189148,Barner; David A.,0,23,80,80
1683635647528,PSYC 191,A00,189275,Rickard; Timothy C.,0,10,25,25
1683635648558,PSYC 193,A00,189276,Chapman; Eddie Nathaniel,0,1,0,4
1683635649584,PSYC 193L,A01,189281,Lowe; Angela Beth,10,0,20,10
1683635649584,PSYC 193L,B01,189285,Staff,28,0,35,7
1683635650610,RELI 149,A00,187137,Rahimi; Babak,7,0,40,33
1683635651646,SE 9,A01,187315,Staff,0,2,18,18
1683635652672,SE 101B,A00,187409,Staff,24,0,30,6
1683635653696,SE 110B,A00,187444,Staff,10,0,40,30
1683635654725,SE 130B,A00,187449,Staff,31,0,40,9
1683635655751,SE 150A,A00,187516,Staff,9,0,20,11
1683635656777,SE 154,A00,187528,Staff,29,0,50,21
1683635657807,SIO 3,A01,258171,Staff,35,0,40,5
1683635658832,SIO 10,A00,187144,Cook; Geoffrey W,0,6,75,75
1683635659861,SIO 45,A00,187152,Cook; Geoffrey W,0,4,100,100
1683635660886,SIO 109R,A00,194486,Staff,0,4,20,20
1683635662944,SIO 187,A01,187233,Kacev; David,12,0,40,28
1683635663977,SOCI 1,A01,258656,Thorpe; Charles Robert,28,0,30,2
1683635663977,SOCI 1,A02,258658,Thorpe; Charles Robert,30,0,30,0
1683635663977,SOCI 1,A03,258661,Thorpe; Charles Robert,25,0,25,0
1683635663977,SOCI 1,A04,258666,Thorpe; Charles Robert,22,0,25,3
1683635663977,SOCI 1,A05,258897,Thorpe; Charles Robert,22,0,25,3
1683635663977,SOCI 1,A06,258898,Thorpe; Charles Robert,25,0,25,0
1683635665003,SOCI 30,A01,258903,Pardo Guerra; Juan Pablo,14,0,30,16
1683635666030,SOCI 102,A00,258904,Staff,9,0,25,16
1683635667059,SOCI 106,A00,258905,Staff,19,0,25,6
1683635668083,SOCI 111,A00,258907,Ribas Norris; Janet Vanesa,26,0,30,4
1683635669109,SOCI 121R,A00,258908,Pardo Guerra; Juan Pablo,8,0,30,22
1683635670137,SOCI 126,A01,203330,Staff,14,0,20,6
1683635671162,SOCI 131,A00,258909,Thorpe; Charles Robert,30,0,60,30
1683635672187,SOCI 135,A00,258910,Payne; Christine Anna,0,11,30,30
1683635673216,SOCI 157,A00,258911,Staff,12,0,30,18
1683635674244,SOCI 184,A00,258912,Staff,25,0,30,5
1683635675273,SOCI 188D,A00,258913,Staff,22,0,30,8
1683635676298,SYN 2,001,187529,Staff,9,0,16,7
1683635676298,SYN 2,002,201452,Staff,0,20,16,16
1683635676298,SYN 2,003,201469,Staff,2,0,16,14
1683635677327,SYN 100,A01,187531,Staff,0,9,20,20
1683635677327,SYN 100,B01,201491,Staff,0,10,20,20
1683635678358,TDAC 1,A00,189286,Walsh; Kim C.,3,0,20,17
1683635678358,TDAC 1,B00,189287,Harting; Carla Kelso,10,0,20,10
1683635679388,TDAC 101,A00,189300,Walsh; Kim C.,16,0,20,4
1683635679388,TDAC 101,B00,189301,Harting; Carla Kelso,18,0,20,2
1683635680418,TDAC 102,A00,189304,Basso; Beatrice,14,0,20,6
1683635681447,TDAC 108,A00,189305,Staff,18,0,20,2
1683635682483,TDDE 131,A00,189310,Staff,19,0,20,1
1683635682483,TDDE 131,B00,189314,Staff,19,0,20,1
1683635682483,TDDE 131,C00,189315,Staff,48,0,50,2
1683635682483,TDDE 131,D00,189316,Staff,14,0,15,1
1683635682483,TDDE 131,E00,204841,Staff,20,0,20,0
1683635683508,TDGE 10,A00,189289,Staff,28,0,50,22
1683635683508,TDGE 10,B00,189290,Havis; Allan,0,0,50,50
1683635684534,TDGE 11,A00,189291,Fulton; Julia,0,4,50,50
1683635684534,TDGE 11,B00,189292,Staff,20,0,25,5
1683635684534,TDGE 11,C00,260270,Staff,0,0,0,0
1683635685559,TDGE 25,A00,189294,Staff,2,0,20,18
1683635686587,TDGE 124,A00,189318,Fulton; Julia,0,8,50,50
1683635687613,TDGE 125,A00,189319,Staff,13,0,25,12
1683635687613,TDGE 125,B00,189320,Staff,23,0,25,2
1683635688638,TDGE 127,A00,189322,Havis; Allan,0,0,50,50
1683635689664,TDHT 101,A00,189323,Staff,18,0,25,7
1683635689664,TDHT 101,B00,189324,Staff,25,0,25,0
1683635690690,TDHT 102,A00,189325,Staff,49,0,50,1
1683635691715,TDMV 1,A00,189295,Arcidiacono; Kristin,20,0,30,10
1683635691715,TDMV 1,B00,189296,Caligagan; Maria T.,24,0,30,6
1683635692740,TDMV 2,A00,189297,Sammartano; Tonnie,27,0,30,3
1683635692740,TDMV 2,B00,189299,Arcidiacono; Kristin,23,0,30,7
1683635693766,TDMV 3,A00,204998,Rincon; Alicia,22,0,30,8
1683635694792,TDMV 120,A00,189458,Sammartano; Tonnie,28,0,30,2
1683635695820,TDMV 138,A00,189541,Jun; Grace Shin Hae,20,0,40,20
1683635696851,TDMV 142,A00,189717,Caligagan; Tony,25,0,30,5
1683635696851,TDMV 142,B00,189718,Caligagan; Maria T.,25,0,30,5
1683635697879,TMC 2,A01,187533,Staff,25,0,25,0
1683635697879,TMC 2,A02,187534,Staff,25,0,25,0
1683635698906,USP 1,A01,187536,Kwak; Nancy,0,16,25,25
1683635699931,USP 5,A01,187538,Staff,9,0,25,16
1683635700958,USP 101,A00,199253,Staff,0,4,0,0
1683635701983,USP 124,A00,187562,Boomhower; Matthew Charles,0,0,30,30
1683635703017,USP 138,A00,187582,Staff,20,0,25,5
1683635704047,USP 152,A01,187597,Staff,3,0,25,22
1683635705073,USP 153,A00,187598,Staff,19,0,25,6
1683635706106,USP 168,A00,187607,Kwak; Nancy,2,0,5,3
1683635707135,USP 173,A00,187619,Staff,4,0,25,21
1683635708164,USP 181,A00,187638,Staff,0,4,25,25
1683635709190,VIS 103,A00,187650,Cruz; Edwin Teddy,18,0,75,57
1683635710219,VIS 110D,A00,187669,Staff,13,0,22,9
1683635711244,VIS 127C,A00,187720,Shen; Kuiyi,67,0,146,79
1683635712270,VIS 149,A00,187731,Yoldas; Pinar,0,14,22,22
1683635713294,VIS 151,A01,188091,Staff,22,0,34,12
1683635713294,VIS 151,A02,188092,Staff,11,0,34,23
1683635714323,VIS 160B,A00,188093,Stalbaum; Brett,0,1,10,10
1683635716376,WCWP 10B,A00,201720,Staff,10,0,15,5
1683635716376,WCWP 10B,B00,201722,Staff,9,0,15,6
1683635717403,WCWP 100,A00,201725,Gagnon; Jeffrey C,0,0,2,2
1683635717403,WCWP 100,B00,201727,Staff,0,4,15,15
1683635720576,ANBI 133,A00,258401,Wilder; Linnea Lorene,34,0,40,6
1683635721600,ANBI 140,A00,258395,Hrvoj Mihic; Branka,18,0,25,7
1683635722625,ANSC 120,A00,258402,Bialecki; Jon Anthony,27,0,40,13
1683635723650,ANSC 144,A00,258400,Staff,12,0,40,28
1683635725703,ANSC 166,A00,258396,Parish; Steven Martin,156,0,175,19
1683635726727,ANSC 180,A00,193533,Staff,8,0,20,12
1683635727814,ANSC 188,A00,258397,Jassal; Aftab,34,0,40,6
1683635728844,ANTH 3,A01,258316,Staff,23,0,30,7
1683635729870,ANTH 5,A00,258394,Semendeferi; Ekaterini,16,0,20,4
1683635730895,ANTH 21,A01,258331,Staff,4,0,40,36
1683635731922,ANTH 103,A00,258398,Varma; Saiba,15,0,25,10
1683635732952,AWP 10,001,202034,Staff,0,0,0,0
1683635732952,AWP 10,002,202035,Staff,0,0,0,0
1683635732952,AWP 10,003,202036,Staff,0,0,0,0
1683635732952,AWP 10,004,202037,Staff,0,0,0,0
1683635732952,AWP 10,005,202038,Staff,0,0,0,0
1683635732952,AWP 10,006,202039,Staff,0,0,0,0
1683635732952,AWP 10,007,202040,Staff,0,0,0,0
1683635732952,AWP 10,008,202041,Staff,0,0,0,0
1683635732952,AWP 10,009,202042,Staff,0,0,0,0
1683635732952,AWP 10,010,202043,Staff,0,0,0,0
1683635732952,AWP 10,011,202044,Staff,0,0,0,0
1683635732952,AWP 10,012,202045,Staff,0,0,0,0
1683635732952,AWP 10,013,202046,Staff,0,0,0,0
1683635732952,AWP 10,014,202047,Staff,0,0,0,0
1683635732952,AWP 10,015,202048,Staff,0,0,0,0
1683635732952,AWP 10,016,202049,Staff,0,0,0,0
1683635732952,AWP 10,017,202050,Staff,0,0,0,0
1683635732952,AWP 10,018,202051,Staff,0,0,0,0
1683635732952,AWP 10,019,202052,Staff,0,0,0,0
1683635732952,AWP 10,020,202053,Staff,0,0,0,0
1683635732952,AWP 10,021,202054,Staff,0,0,0,0
1683635732952,AWP 10,022,202055,Staff,0,0,0,0
1683635732952,AWP 10,023,202056,Staff,0,0,0,0
1683635732952,AWP 10,024,202057,Staff,0,0,0,0
1683635732952,AWP 10,025,202058,Staff,0,0,0,0
1683635732952,AWP 10,026,202059,Staff,0,0,0,0
1683635733977,AWP 102,001,202032,Staff,0,0,0,0
1683635733977,AWP 102,002,202033,Staff,0,0,0,0
1683635735004,BENG 100,A01,254234,Taylor Amos; Alyssa C,31,0,40,9
1683635736031,BENG 196,001,270013,Engler; Adam J.,9999,0,9999,0
1683635737066,BICD 100R,A01,202018,Smith; Laurie,0,7,32,32
1683635737066,BICD 100R,A02,202019,Smith; Laurie,0,3,32,32
1683635737066,BICD 100R,A03,202020,Smith; Laurie,0,1,32,32
1683635737066,BICD 100R,A04,202021,Smith; Laurie,6,0,32,26
1683635737066,BICD 100R,A05,202022,Smith; Laurie,11,0,32,21
1683635738099,BICD 136,A01,193242,Gustafson-Brown; Cindy,0,2,32,32
1683635738099,BICD 136,A02,193244,Gustafson-Brown; Cindy,13,0,32,19
1683635739133,BIEB 102,A01,193249,Butler; Shannon Rhey,0,2,32,32
1683635739133,BIEB 102,A02,193251,Butler; Shannon Rhey,0,0,32,32
1683635739133,BIEB 102,A03,193253,Butler; Shannon Rhey,0,0,32,32
1683635739133,BIEB 102,A04,193255,Butler; Shannon Rhey,14,0,32,18
1683635739133,BIEB 102,A05,193265,Butler; Shannon Rhey,26,0,32,6
1683635739133,BIEB 102,A06,193269,Butler; Shannon Rhey,14,0,32,18
1683635741188,BIEB 150,A01,193274,Staff,0,0,32,32
1683635741188,BIEB 150,A02,193285,Staff,24,0,32,8
1683635742215,BIEB 194,A00,193286,Kurle; Carolyn M.,20,0,32,12
1683635743242,BILD 1,A01,192291,Staff,15,0,32,17
1683635743242,BILD 1,A02,192292,Staff,30,0,32,2
1683635743242,BILD 1,B01,192520,Reuther; Keefe,0,1,0,0
1683635743242,BILD 1,B02,192532,Reuther; Keefe,0,1,0,0
1683635744268,BILD 3,A01,192556,Butler; Shannon Rhey,0,0,32,32
1683635744268,BILD 3,A02,192581,Butler; Shannon Rhey,1,0,32,31
1683635744268,BILD 3,A03,192611,Butler; Shannon Rhey,21,0,32,11
1683635744268,BILD 3,A04,192612,Butler; Shannon Rhey,24,0,32,8
1683635744268,BILD 3,A05,192613,Butler; Shannon Rhey,26,0,32,6
1683635744268,BILD 3,A06,192679,Butler; Shannon Rhey,27,0,32,5
1683635744268,BILD 3,A07,192682,Butler; Shannon Rhey,20,0,32,12
1683635745294,BILD 4,A01,192836,Reuther; Keefe,0,0,24,24
1683635745294,BILD 4,A02,193044,Reuther; Keefe,4,0,24,20
1683635746324,BILD 10,A01,193142,Gustafson-Brown; Cindy,29,0,32,3
1683635746324,BILD 10,A02,193149,Gustafson-Brown; Cindy,31,0,32,1
1683635747355,BIMM 100,A01,193301,Staff,0,6,32,32
1683635747355,BIMM 100,A02,193312,Staff,0,7,32,32
1683635747355,BIMM 100,A03,193323,Staff,0,9,32,32
1683635748387,BIMM 101,A01,193329,McDonnell; Lisa Marie,0,4,24,24
1683635748387,BIMM 101,A02,193339,McDonnell; Lisa Marie,0,3,24,24
1683635748387,BIMM 101,B01,193354,McDonnell; Lisa Marie,0,4,24,24
1683635748387,BIMM 101,B02,193357,McDonnell; Lisa Marie,0,2,24,24
1683635749418,BIMM 110,A01,193377,Tat; John,0,11,32,32
1683635749418,BIMM 110,A02,193378,Tat; John,0,10,32,32
1683635750456,BIMM 120,A01,206116,Staff,0,0,32,32
1683635750456,BIMM 120,A02,206117,Staff,6,0,32,26
1683635750456,BIMM 120,A03,206121,Staff,21,0,32,11
1683635751485,BIPN 100,A01,193393,Park; Ji Young,0,14,32,32
1683635751485,BIPN 100,A02,193402,Park; Ji Young,0,14,32,32
1683635751485,BIPN 100,A03,193413,Park; Ji Young,0,14,32,32
1683635751485,BIPN 100,A04,193414,Park; Ji Young,0,13,32,32
1683635752515,BIPN 102,A01,193429,Staff,0,0,32,32
1683635752515,BIPN 102,A02,193438,Staff,18,0,32,14
1683635753542,BIPN 106,A01,193450,Reyes Gonzalez; Catalina,0,2,40,40
1683635754568,BIPN 134,A01,193465,Cooke; James Edward,0,0,32,32
1683635754568,BIPN 134,A02,193474,Cooke; James Edward,25,0,32,7
1683635754568,BIPN 134,A03,193485,Cooke; James Edward,29,0,32,3
1683635754568,BIPN 134,A04,193486,Cooke; James Edward,20,0,32,12
1683635754568,BIPN 134,A05,193491,Cooke; James Edward,31,0,32,1
1683635754568,BIPN 134,A06,193501,Cooke; James Edward,30,0,32,2
1683635754568,BIPN 134,A07,193510,Cooke; James Edward,29,0,32,3
1683635756621,BISP 194,A00,222522,Staff,14,0,32,18
1683635757649,CAT 124,A01,202407,Staff,19,0,25,6
1683635758679,CAT 125,A00,202408,Marchisotto; Jennifer Anne,2,0,20,18
1683635759713,CAT 125R,A00,202409,Smith; Lauryn Alissa,0,11,20,20
1683635759713,CAT 125R,B00,202410,Morales; Celeste Georgianna,0,11,20,20
1683635759713,CAT 125R,C00,202411,Irwin; Matthew Joseph,0,12,20,20
1683635760742,CENG 15,A01,204712,Yang; Kesong,0,1,0,0
1683635761768,CENG 114,A00,202070,Jahed Motlagh; Zeinab,5,0,20,15
1683635762801,CGS 105,A00,185477,Wesling; Megan E.,24,0,40,16
1683635763829,CGS 106,A00,185494,Staff,11,0,22,11
1683635764860,CGS 108,A00,185495,Staff,14,0,20,6
1683635765886,CGS 114,A00,185496,Staff,13,0,18,5
1683635766916,CGS 119,A00,185501,Staff,15,0,20,5
1683635767947,CGS 120,A00,185511,Staff,12,0,20,8
1683635768981,CHEM 4,A01,184675,Bussey; Thomas J,97,0,100,3
1683635770010,CHEM 6A,A01,184677,Staff,33,0,60,27
1683635771040,CHEM 6B,A01,184679,Staff,63,0,100,37
1683635772071,CHEM 6C,A01,184681,Bussey; Thomas J,0,0,50,50
1683635772071,CHEM 6C,A02,184682,Bussey; Thomas J,32,0,50,18
1683635773105,CHEM 40A,A01,184684,Albizati; Kim F.,35,0,100,65
1683635774136,CHEM 40B,A01,184686,Albizati; Kim F.,0,22,100,100
1683635775163,CHEM 41B,A01,184690,Staff,51,0,100,49
1683635776193,COGS 3,A01,184715,Boyle; Mary E. T.,0,27,40,40
1683635777223,COGS 14B,A01,185172,Staff,0,14,38,38
1683635778249,COGS 18,A01,184736,Staff,15,0,80,65
1683635779275,COGS 100,A01,184932,Staff,0,7,73,73
1683635780301,COGS 101A,A01,184935,Staff,0,39,30,30
1683635781330,COGS 101B,A01,184944,Staff,0,2,30,30
1683635782359,COGS 101C,A01,184946,Staff,0,10,30,30
1683635783391,COGS 102A,A01,184951,Johnson; Christine M.,2,0,40,38
1683635784417,COGS 107B,A01,184953,Mooshagian; Eric Frederick,0,51,40,40
1683635785441,COGS 118B,A01,184959,Gupta; Anjum,0,49,40,40
1683635786470,COGS 153,A00,184961,Staff,0,16,30,30
1683635787496,COGS 177,A00,184962,Staff,0,21,30,30
1683635788523,COGS 187A,A01,184969,Boyle; Mary E. T.,0,19,40,40
1683635789548,COMM 10,A01,185174,Staff,0,5,25,25
1683635789548,COMM 10,A02,185189,Staff,0,2,25,25
1683635789548,COMM 10,A03,269821,Staff,0,1,0,0
1683635790576,COMM 100B,A01,185475,Staff,0,1,0,2
1683635790576,COMM 100B,A02,185476,Staff,12,0,25,13
1683635791601,COMM 100C,A01,185314,Staff,1,0,25,24
1683635791601,COMM 100C,A02,185327,Staff,18,0,25,7
1683635792628,COMM 110M,A00,185349,Staff,0,0,40,40
1683635793659,COMM 113T,A00,185352,Staff,25,0,40,15
1683635794684,COMM 114I,A00,185353,Staff,31,0,40,9
1683635795712,COMM 131,A00,185354,Staff,17,0,30,13
1683635796741,CSE 8A,A50,185358,Cao; Yingjun,0,46,10,10
1683635797764,CSE 8B,A01,185362,Staff,0,48,50,50
1683635798794,CSE 11,A01,185416,Cao; Yingjun,0,91,10,10
1683635799820,CSE 20,A01,185445,Briones; Jor-el Thomas Caparas,4,0,25,21
1683635800846,CSE 21,A01,185447,Staff,9,0,50,41
1683635801872,CSE 101,A01,185451,Staff,0,13,50,50
1683635801872,CSE 101,B01,185453,Jones; Miles E,0,13,50,50
1683635803928,CSE 141,A01,185458,Eldon; John,15,0,100,85
1683635804952,CSE 141L,A01,185461,Eldon; John,7,0,100,93
1683635805977,CSE 142,A01,185463,Staff,36,0,60,24
1683635805977,CSE 142,B01,201355,Staff,0,7,60,60
1683635807003,CSE 142L,A01,185470,Staff,36,0,60,24
1683635807003,CSE 142L,B01,201417,Staff,0,6,60,60
1683635808030,CSE 190,A00,201433,Staff,32,0,49,17
1683635809057,DOC 1,A01,259136,Strom; Megan C.,7,0,15,8
1683635809057,DOC 1,A02,259137,Strom; Megan C.,14,0,15,1
1683635809057,DOC 1,A03,259138,Strom; Megan C.,14,0,15,1
1683635809057,DOC 1,A04,259139,Strom; Megan C.,14,0,15,1
1683635810086,DOC 100D,A00,259140,Pass; Natalye Joann,14,0,25,11
1683635811111,DSGN 1,A01,184749,Rill; Bryan,0,26,30,30
1683635812138,DSGN 100,A01,185168,Staff,0,2,25,25
1683635813163,ECE 5,A01,185626,Morris; Karcher William,0,11,0,0
1683635814198,ECE 101,A01,185628,Staff,14,0,70,56
1683635815224,ECE 107,A01,185635,Baghdadchi; Saharnaz,0,0,20,20
1683635815224,ECE 107,A02,185638,Baghdadchi; Saharnaz,3,0,20,17
1683635816249,ECE 148,A01,185647,Silberman; Jack,0,0,16,16
1683635817275,ECON 1,A01,185537,Crane; Meredith Helen,54,0,70,16
1683635818305,ECON 3,A01,185549,Crane; Meredith Helen,29,0,70,41
1683635819343,ECON 4,A01,203354,Anderson; John Charles,0,5,10,10
1683635820368,ECON 100A,A01,185574,Staff,0,5,40,40
1683635821396,ECON 100B,A01,185576,Staff,0,12,50,50
1683635822428,ECON 100C,A01,185589,Newhouse; Herbert S,30,0,70,40
1683635823453,ECON 105,A00,185608,Vespa; Emanuel Ignacio,19,0,35,16
1683635824478,ECON 109,A01,185610,Shishkin; Denis,9,0,35,26
1683635825509,ECON 110A,A01,185612,Staff,9,0,40,31
1683635826536,ECON 120A,A01,185615,Staff,20,0,40,20
1683635827568,ECON 120C,A01,185617,Sun; Yixiao,0,20,70,70
1683635828597,ECON 144,A00,203346,Squires; Dale E,2,0,35,33
1683635829623,ECON 171,A01,203349,Newhouse; Herbert S,0,1,35,35
1683635830651,ECON 173A,A01,185621,Toda; Alexis Akira,21,0,35,14
1683635831760,EDS 25,A01,202413,Staff,0,1,0,0
1683635831760,EDS 25,A02,202414,Staff,0,1,0,0
1683635831760,EDS 25,A03,202415,Staff,0,0,0,0
1683635831760,EDS 25,A04,202416,Staff,0,1,0,0
1683635831760,EDS 25,A05,202439,Staff,0,0,0,0
1683635831760,EDS 25,A06,202440,Staff,0,0,0,0
1683635831760,EDS 25,B01,202631,Staff,0,0,0,0
1683635831760,EDS 25,B02,202632,Staff,0,0,0,0
1683635831760,EDS 25,B03,202639,Staff,0,0,0,0
1683635831760,EDS 25,B04,202640,Staff,0,0,0,0
1683635831760,EDS 25,B05,202643,Staff,0,0,0,0
1683635831760,EDS 25,B06,202644,Staff,0,0,0,0
1683635832790,EDS 38,A01,202659,Black; Alison Michelle,24,0,25,1
1683635833818,EDS 115,A00,202652,Staff,18,0,30,12
1683635834844,EDS 125,A00,202649,Staff,13,0,30,17
1683635835868,EDS 126,A01,203332,Staff,30,0,30,0
1683635836894,EDS 139,A00,202838,Staff,16,0,25,9
1683635837919,EDS 146,A01,202655,Staff,14,0,25,11
1683635838946,ENG 15,A00,185667,Staff,0,1,0,0
1683635838946,ENG 15,B00,185672,Staff,0,0,0,0
1683635838946,ENG 15,C00,185675,Staff,0,0,0,0
1683635838946,ENG 15,D00,185682,Staff,0,0,0,0
1683635838946,ENG 15,E00,185684,Staff,0,0,0,0
1683635839975,ETHN 103,A00,185710,Staff,0,8,35,35
1683635841005,ETHN 103A,A00,199228,Man; Simeon S,0,0,9,9
1683635842036,ETHN 109,A00,185711,Staff,16,0,35,19
1683635843064,ETHN 142,A00,185726,Staff,0,4,30,30
1683635844091,ETHN 163J,A00,199229,Man; Simeon S,5,0,8,3
1683635845115,ETHN 168,A00,185727,Staff,7,0,10,3
1683635846144,ETHN 182,A00,185728,Staff,0,0,35,35
1683635847168,ETHN 183,A00,185737,Staff,9,0,18,9
1683635848197,GLBH 111,A01,209361,Burgos; Jose L.,0,0,0,0
1683635850248,HIEU 104,A00,185792,Staff,14,0,20,6
1683635851279,HIEU 115,A00,185800,Staff,0,0,20,20
1683635852310,HIEU 128,A00,185801,Staff,0,9,20,20
1683635853335,HIEU 147,A00,185802,Staff,15,0,20,5
1683635854360,HIEU 154,A00,185823,Staff,11,0,20,9
1683635855386,HILA 102,A00,185826,Staff,14,0,20,6
1683635856416,HILD 2C,A01,185778,Staff,0,13,20,20
1683635857442,HILD 7B,A01,185780,Kwak; Nancy,0,16,32,32
1683635857442,HILD 7B,A02,185781,Kwak; Nancy,0,18,32,32
1683635858466,HILD 30,A01,185791,Staff,12,0,20,8
1683635859496,HISC 119,A00,185830,Golan; Tal,0,9,20,20
1683635860524,HITO 156GS,A00,185831,Patterson; Patrick H.,0,0,0,23
1683635861552,HIUS 103,A00,185832,Man; Simeon S,0,4,20,20
1683635862580,HIUS 117,A00,185836,Kwak; Nancy,2,0,20,18
1683635863614,HIUS 125,A00,185840,Man; Simeon S,0,1,23,23
1683635864645,HIUS 149,A00,185845,Staff,1,0,20,19
1683635865679,HUM 3,A01,185882,Zavodny; Tatiana Sophia,0,7,50,50
1683635865679,HUM 3,B01,185899,Caldwell; Michael Alan,0,18,50,50
1683635866708,HUM 3GS,A00,185900,Patterson; Patrick H.,0,0,0,23
1683635867741,HUM 4,A01,185938,Zroka; Amy Liane,30,0,50,20
1683635867741,HUM 4,B01,185956,Watkins; Eric,0,4,50,50
1683635867741,HUM 4,B02,202209,Watkins; Eric,0,4,50,50
1683635867741,HUM 4,B03,202210,Watkins; Eric,0,4,50,50
1683635868768,HUM 5,A01,185958,West; Geoffrey Scott,2,0,50,48
1683635868768,HUM 5,A02,202215,West; Geoffrey Scott,0,0,50,50
1683635869798,INTL 190,A00,185959,Gagnon; Jeffrey C,0,0,0,9
1683635869798,INTL 190,B00,185960,Lettieri; Michael Joseph,0,0,0,2
1683635870823,JAPN 180,A00,254509,Staff,5,0,30,25
1683635871854,LATI 10,A01,202853,Kennemore; Amy Michelle,4,0,35,31
1683635871854,LATI 10,A02,202854,Kennemore; Amy Michelle,2,0,35,33
1683635871854,LATI 10,A03,270054,Kennemore; Amy Michelle,30,0,30,0
1683635872883,LATI 180,A00,202855,Kennemore; Amy Michelle,11,0,20,9
1683635873912,LAWS 101,A00,201767,Golan; Tal,0,7,40,40
1683635874942,LIFR 1C,A00,185961,Staff,6,0,20,14
1683635875970,LIFR 1CX,A00,185962,Staff,7,0,20,13
1683635876996,LIFR 1D,A00,185963,Staff,7,0,20,13
1683635878022,LIFR 1DX,A00,185964,Staff,7,0,20,13
1683635879052,LIGN 101,A01,186039,Staff,43,0,50,7
1683635880081,LIGN 165,A00,186040,Staff,15,0,50,35
1683635881114,LTCS 108,A00,186041,Staff,5,0,10,5
1683635882142,LTCS 119,A00,186042,Staff,15,0,20,5
1683635883169,LTCS 130,A00,186043,Wesling; Megan E.,15,0,25,10
1683635885226,LTEA 138,A00,186119,Staff,14,0,40,26
1683635886251,LTEN 124,A00,186148,Staff,6,0,25,19
1683635887277,LTEN 178,A00,186149,Staff,7,0,15,8
1683635888303,LTEN 181,A00,186150,Blanco; John D,34,0,40,6
1683635889329,LTWL 120,A00,186160,Staff,20,0,25,5
1683635890356,LTWL 165,A00,186161,Staff,22,0,25,3
1683635891381,LTWR 100,A00,186162,Staff,0,5,15,15
1683635892407,LTWR 102,A00,186163,Doller; Ben,5,0,15,10
1683635893433,MAE 8,A01,186412,Staff,0,0,0,0
1683635894459,MAE 30B,A00,186445,Bahadori; Mohammad Yousef,82,0,100,18
1683635895489,MAE 40,A00,186592,Bewley; Thomas R,10,0,50,40
1683635896518,MAE 101B,A00,186593,Bahadori; Mohammad Yousef,80,0,100,20
1683635897550,MAE 105,A00,186594,Bandaru; Prabhakar,10,0,50,40
1683635898580,MAE 107,A00,186599,Pham; Hieu Tan,0,7,120,120
1683635899609,MAE 148,A01,186660,Silberman; Jack,3,0,16,13
1683635900680,MATH 10A,A01,188095,Staff,0,5,35,35
1683635901715,MATH 10B,A01,188097,Bowers; Adam R.,0,11,30,30
1683635901715,MATH 10B,A02,188099,Bowers; Adam R.,0,11,30,30
1683635901715,MATH 10B,B01,188104,Bowers; Adam R.,0,10,30,30
1683635901715,MATH 10B,B02,188106,Bowers; Adam R.,1,9,30,29
1683635902743,MATH 10C,A01,188111,Staff,0,18,30,30
1683635902743,MATH 10C,A02,188127,Staff,0,19,30,30
1683635902743,MATH 10C,A03,188131,Staff,0,19,30,30
1683635902743,MATH 10C,B01,188218,Staff,17,0,30,13
1683635902743,MATH 10C,B02,188244,Staff,13,0,30,17
1683635902743,MATH 10C,B03,188277,Staff,14,0,30,16
1683635903774,MATH 18,A01,188344,Bach; Quang Tran,18,0,30,12
1683635903774,MATH 18,A02,188345,Bach; Quang Tran,11,0,30,19
1683635903774,MATH 18,B01,188353,Bach; Quang Tran,11,0,30,19
1683635903774,MATH 18,B02,188354,Bach; Quang Tran,19,0,30,11
1683635904799,MATH 20A,A01,188374,Staff,11,0,35,24
1683635905826,MATH 20B,A01,188382,Ohm; Ko Woon,7,0,30,23
1683635905826,MATH 20B,A02,188383,Ohm; Ko Woon,22,0,30,8
1683635905826,MATH 20B,B01,188385,Ohm; Ko Woon,7,0,30,23
1683635905826,MATH 20B,B02,188392,Ohm; Ko Woon,22,0,30,8
1683635906855,MATH 20C,A01,188394,Harel; Guershon,11,0,30,19
1683635906855,MATH 20C,A02,188395,Harel; Guershon,14,0,30,16
1683635906855,MATH 20C,B01,188404,Harel; Guershon,4,0,30,26
1683635906855,MATH 20C,B02,188405,Harel; Guershon,18,0,30,12
1683635907883,MATH 20D,A01,188414,Hammock; Frances H,0,1,30,30
1683635907883,MATH 20D,A02,188415,Hammock; Frances H,0,1,30,30
1683635907883,MATH 20D,B01,188447,Hammock; Frances H,0,1,30,30
1683635907883,MATH 20D,B02,188486,Hammock; Frances H,4,0,30,26
1683635908907,MATH 20E,A01,188649,Staff,21,0,30,9
1683635908907,MATH 20E,A02,188650,Staff,21,0,30,9
1683635908907,MATH 20E,A03,188673,Staff,0,0,30,30
1683635909934,MATH 102,A01,188675,Staff,0,36,35,35
1683635910960,MATH 103B,A01,188681,Staff,3,0,35,32
1683635910960,MATH 103B,B01,188692,Staff,5,0,35,30
1683635911993,MATH 109,A01,188695,Salehi Golsefidy; Alireza,24,0,35,11
1683635911993,MATH 109,A02,188696,Salehi Golsefidy; Alireza,25,0,35,10
1683635913033,MATH 120A,A01,188698,Eggers; John Dietrich,7,0,35,28
1683635914065,MATH 142B,A01,188736,Ioana; Adrian,0,1,30,30
1683635914065,MATH 142B,A02,188741,Ioana; Adrian,0,1,30,30
1683635914065,MATH 142B,A03,188743,Ioana; Adrian,0,1,30,30
1683635915092,MATH 168A,A01,188790,Staff,0,10,35,35
1683635916119,MATH 170A,A01,188803,Nie; Jiawang,0,2,35,35
1683635916119,MATH 170A,A02,188811,Nie; Jiawang,0,0,35,35
1683635916119,MATH 170A,A03,188814,Nie; Jiawang,0,0,35,35
1683635916119,MATH 170A,A04,188815,Nie; Jiawang,10,0,35,25
1683635917145,MATH 193B,A01,188817,Staff,0,0,35,35
1683635917145,MATH 193B,A02,188818,Staff,5,0,35,30
1683635918171,MGT 4,A01,202857,Anderson; John Charles,61,0,80,19
1683635919197,MGT 12,A00,202858,Lindenberger; Wade Douglas,40,0,90,50
1683635920222,MGT 18,A00,202859,Staff,74,0,90,16
1683635921246,MGT 18GS,A00,202860,McKay; Michael J,13,0,28,15
1683635922275,MGT 45,A00,202861,Pecore; Joseph P.,12,0,90,78
1683635923306,MGT 100,A00,202863,Yavorsky; Daniel Ryan,28,0,90,62
1683635924336,MGT 103,A00,202864,Ehrich; Kristine R,0,17,90,90
1683635925360,MGT 112,A00,202865,Ehrich; Kristine R,15,0,90,75
1683635926385,MGT 121A,A00,202868,Staff,0,20,0,0
1683635927415,MGT 131B,A00,202869,Anderson; John Charles,59,0,90,31
1683635928440,MGT 136,A00,202871,Lindenberger; Wade Douglas,83,0,90,7
1683635929466,MGT 164,A00,202873,Staff,0,66,90,91
1683635930502,MGT 164GS,A00,202874,McKay; Mary A,13,0,28,15
1683635931528,MGT 180,A00,202875,Staff,0,50,90,91
1683635932554,MMW 11R,A01,205019,Herbst; Matthew,2,0,30,28
1683635932554,MMW 11R,A02,205026,Herbst; Matthew,29,0,30,1
1683635933586,MMW 15,A01,193512,Chang; Edmond Yi-Teh,0,8,28,28
1683635933586,MMW 15,A02,193513,Chang; Edmond Yi-Teh,0,5,28,28
1683635933586,MMW 15,A03,193514,Chang; Edmond Yi-Teh,0,5,28,28
1683635933586,MMW 15,A04,193515,Chang; Edmond Yi-Teh,0,5,28,28
1683635933586,MMW 15,A05,193516,Chang; Edmond Yi-Teh,0,5,28,28
1683635933586,MMW 15,A06,193517,Chang; Edmond Yi-Teh,0,6,28,28
1683635933586,MMW 15,B01,193519,Chang; Edmond Yi-Teh,0,5,28,28
1683635933586,MMW 15,B02,193520,Chang; Edmond Yi-Teh,0,5,28,28
1683635933586,MMW 15,B03,193521,Chang; Edmond Yi-Teh,0,5,28,28
1683635933586,MMW 15,B04,193522,Chang; Edmond Yi-Teh,0,5,28,28
1683635933586,MMW 15,B05,193523,Chang; Edmond Yi-Teh,0,5,28,28
1683635933586,MMW 15,B06,193524,Chang; Edmond Yi-Teh,0,5,28,28
1683635934612,MMW 122,A01,193526,Rahimi; Babak,0,16,28,28
1683635934612,MMW 122,A02,193527,Rahimi; Babak,0,15,28,28
1683635934612,MMW 122,A03,193528,Rahimi; Babak,0,0,0,0
1683635934612,MMW 122,A04,193529,Rahimi; Babak,0,0,0,0
1683635935706,MUS 1A,A01,186663,Staff,1,20,35,34
1683635936732,MUS 4,A01,186715,Staff,0,12,35,35
1683635937757,MUS 5R,A01,186796,Dubnov; Shlomo,0,17,35,35
1683635938786,MUS 6,A01,186798,Staff,0,5,25,25
1683635939814,MUS 7,A01,186830,Staff,11,0,35,24
1683635940845,MUS 8,A01,186930,Staff,0,26,35,35
1683635941871,MUS 15,A01,186932,Staff,0,16,35,35
1683635941871,MUS 15,B01,186934,Staff,0,17,35,35
1683635942899,MUS 80,A00,186935,Staff,0,0,20,20
1683635942899,MUS 80,B00,186936,Staff,24,0,25,1
1683635943926,NANO 11,A00,204702,Lipomi; Darren John,0,0,0,0
1683635944954,NANO 15,A01,204709,Yang; Kesong,0,1,0,0
1683635945987,NANO 114,A00,202069,Jahed Motlagh; Zeinab,3,0,10,7
1683635947017,PHIL 1,A00,186955,Grush; Rick Scott,31,0,40,9
1683635948048,PHIL 10,A01,186973,Grush; Rick Scott,27,0,35,8
1683635948048,PHIL 10,A02,186974,Grush; Rick Scott,33,0,35,2
1683635949074,PHIL 13,A01,186976,Staff,3,0,35,32
1683635949074,PHIL 13,A02,186977,Staff,16,0,35,19
1683635950104,PHIL 14,A01,186979,Staff,31,0,35,4
1683635950104,PHIL 14,A02,186986,Staff,32,0,35,3
1683635951135,PHIL 28,A01,186988,Staff,16,0,30,14
1683635951135,PHIL 28,A02,186989,Staff,1,0,30,29
1683635951135,PHIL 28,A03,186990,Staff,10,0,30,20
1683635951135,PHIL 28,A04,186991,Staff,26,0,30,4
1683635952164,PHIL 120,A00,186997,Staff,23,0,40,17
1683635953190,PHIL 137,A00,187003,Staff,7,0,40,33
1683635954220,PHIL 150,A00,187015,Staff,47,0,70,23
1683635955247,PHIL 167,A00,187021,Lamey; Andy M.,34,0,40,6
1683635956271,PHIL 174,A01,202226,Staff,17,0,20,3
1683635956271,PHIL 174,A02,202235,Staff,20,0,20,0
1683635957300,PHIL 191A,A00,258918,Staff,0,0,1,1
1683635958329,PHYS 1A,A00,187028,Staff,27,0,60,33
1683635959354,PHYS 1AL,001,187036,Staff,3,0,30,27
1683635959354,PHYS 1AL,002,187049,Staff,18,0,30,12
1683635960385,PHYS 1B,A00,187058,Staff,22,0,60,38
1683635961412,PHYS 1BL,001,187064,Staff,0,1,30,30
1683635961412,PHYS 1BL,002,187070,Staff,4,0,30,26
1683635962446,PHYS 1C,A00,187082,Staff,29,0,120,91
1683635963473,PHYS 1CL,001,187088,Staff,0,9,30,30
1683635963473,PHYS 1CL,002,187089,Staff,0,1,30,30
1683635963473,PHYS 1CL,009,262693,Staff,9,0,30,21
1683635964499,PHYS 2B,A01,187097,Staff,55,0,115,60
1683635965523,PHYS 2C,A01,187099,Staff,64,0,115,51
1683635966554,PHYS 2CL,A01,187101,Staff,5,0,28,23
1683635966554,PHYS 2CL,A02,187102,Staff,15,0,28,13
1683635967580,PHYS 2D,A01,187123,Shotwell; Brian,95,0,115,20
1683635968606,PHYS 4B,A01,187133,Grinstein; Benjamin,35,0,50,15
1683635969631,POLI 10,A00,188819,Staff,0,4,50,50
1683635970656,POLI 11,A00,188827,Staff,43,0,50,7
1683635971686,POLI 13R,A00,188828,Staff,0,1,20,20
1683635972718,POLI 27,A01,188830,Elgin; Samuel Zincke,0,2,70,70
1683635973752,POLI 30,A00,188832,Desposato; Scott,30,0,50,20
1683635974779,POLI 102F,A00,188834,Staff,0,0,40,40
1683635975804,POLI 104A,A00,188852,Staff,13,0,30,17
1683635976833,POLI 104I,A00,188853,Staff,0,7,20,20
1683635977858,POLI 110B,A00,188854,Wiens; David,7,0,20,13
1683635978884,POLI 112A,A00,188855,Wiens; David,4,0,30,26
1683635979910,POLI 117R,A00,188856,Forman; Fonna,0,12,20,20
1683635980937,POLI 118,A00,188857,Ingham; Sean,8,0,20,12
1683635981965,POLI 120G,A00,188858,Staff,8,0,30,22
1683635982994,POLI 131CR,A00,188863,Hoston; Germaine,21,0,50,29
1683635984019,POLI 133,A00,188864,Nellis; Gareth Hb,44,0,50,6
1683635985045,POLI 134D,A00,188865,Desposato; Scott,27,0,30,3
1683635986074,POLI 142A,A00,188871,Gartzke; Erik,21,0,50,29
1683635987103,POLI 142K,A00,188874,Staff,38,0,50,12
1683635988129,POLI 143,A00,188940,Gartzke; Erik,16,0,30,14
1683635989157,POLI 153,A00,188943,Staff,2,0,20,18
1683635990184,POLI 160AA,A00,188944,Staff,11,0,40,29
1683635991213,POLI 170A,A00,188945,Staff,11,0,30,19
1683635993265,PSYC 1,A00,188952,Staff,36,0,90,54
1683635994291,PSYC 2,B00,188953,Staff,19,0,35,16
1683635995319,PSYC 6,A00,188970,Staff,47,0,60,13
1683635996346,PSYC 7,A00,188973,Staff,35,0,45,10
1683635997375,PSYC 60,A01,188980,Rickard; Timothy C.,42,0,60,18
1683635998402,PSYC 70,A01,189001,Steiner; Eric Tomas,23,0,45,22
1683635999433,PSYC 100,A00,189005,Lacefield; Katharine I,0,99,120,120
1683636000460,PSYC 102,A00,189008,Staff,8,0,30,22
1683636001486,PSYC 106,B00,189026,Gorman; Michael R.,27,0,60,33
1683636002515,PSYC 114,B01,189033,Winkielman; Piotr,0,31,30,30
1683636003546,PSYC 131,A00,189036,Anagnostaras; Stephan,0,43,60,60
1683636004577,PSYC 136,A00,189041,Lowe; Angela Beth,0,7,25,25
1683636005602,PSYC 137,A00,189057,Winkielman; Piotr,0,37,25,25
1683636006633,PSYC 144,A00,189107,Wixted; John T,0,10,50,50
1683636008687,PSYC 162,A00,189142,Staff,0,9,85,85
1683636009716,PSYC 172,A00,189144,Gorman; Michael R.,0,6,30,30
1683636011773,PSYC 179,A00,189146,Lacefield; Katharine I,0,86,120,120
1683636012798,PSYC 181,A00,189147,Anagnostaras; Stephan,0,44,90,90
1683636013824,PSYC 190R,A00,189148,Barner; David A.,0,23,80,80
1683636014852,PSYC 191,A00,189275,Rickard; Timothy C.,0,10,25,25
1683636015880,PSYC 193,A00,189276,Chapman; Eddie Nathaniel,0,1,0,4
1683636016909,PSYC 193L,A01,189281,Lowe; Angela Beth,10,0,20,10
1683636016909,PSYC 193L,B01,189285,Staff,28,0,35,7
1683636017934,RELI 149,A00,187137,Rahimi; Babak,7,0,40,33
1683636018959,SE 9,A01,187315,Staff,0,2,18,18
1683636019987,SE 101B,A00,187409,Staff,24,0,30,6
1683636021019,SE 110B,A00,187444,Staff,10,0,40,30
1683636022047,SE 130B,A00,187449,Staff,31,0,40,9
1683636023072,SE 150A,A00,187516,Staff,9,0,20,11
1683636024097,SE 154,A00,187528,Staff,29,0,50,21
1683636025141,SIO 3,A01,258171,Staff,35,0,40,5
1683636026166,SIO 10,A00,187144,Cook; Geoffrey W,0,6,75,75
1683636027190,SIO 45,A00,187152,Cook; Geoffrey W,0,4,100,100
1683636028218,SIO 109R,A00,194486,Staff,0,4,20,20
1683636030275,SIO 187,A01,187233,Kacev; David,12,0,40,28
1683636031302,SOCI 1,A01,258656,Thorpe; Charles Robert,28,0,30,2
1683636031302,SOCI 1,A02,258658,Thorpe; Charles Robert,30,0,30,0
1683636031302,SOCI 1,A03,258661,Thorpe; Charles Robert,25,0,25,0
1683636031302,SOCI 1,A04,258666,Thorpe; Charles Robert,22,0,25,3
1683636031302,SOCI 1,A05,258897,Thorpe; Charles Robert,22,0,25,3
1683636031302,SOCI 1,A06,258898,Thorpe; Charles Robert,25,0,25,0
1683636032329,SOCI 30,A01,258903,Pardo Guerra; Juan Pablo,14,0,30,16
1683636033354,SOCI 102,A00,258904,Staff,9,0,25,16
1683636034381,SOCI 106,A00,258905,Staff,19,0,25,6
1683636035411,SOCI 111,A00,258907,Ribas Norris; Janet Vanesa,26,0,30,4
1683636036440,SOCI 121R,A00,258908,Pardo Guerra; Juan Pablo,8,0,30,22
1683636037466,SOCI 126,A01,203330,Staff,14,0,20,6
1683636038492,SOCI 131,A00,258909,Thorpe; Charles Robert,30,0,60,30
1683636039579,SOCI 135,A00,258910,Payne; Christine Anna,0,11,30,30
1683636040604,SOCI 157,A00,258911,Staff,12,0,30,18
1683636041632,SOCI 184,A00,258912,Staff,25,0,30,5
1683636042658,SOCI 188D,A00,258913,Staff,22,0,30,8
1683636043684,SYN 2,001,187529,Staff,9,0,16,7
1683636043684,SYN 2,002,201452,Staff,0,20,16,16
1683636043684,SYN 2,003,201469,Staff,2,0,16,14
1683636044710,SYN 100,A01,187531,Staff,0,9,20,20
1683636044710,SYN 100,B01,201491,Staff,0,10,20,20
1683636045742,TDAC 1,A00,189286,Walsh; Kim C.,3,0,20,17
1683636045742,TDAC 1,B00,189287,Harting; Carla Kelso,10,0,20,10
1683636046770,TDAC 101,A00,189300,Walsh; Kim C.,16,0,20,4
1683636046770,TDAC 101,B00,189301,Harting; Carla Kelso,18,0,20,2
1683636047796,TDAC 102,A00,189304,Basso; Beatrice,14,0,20,6
1683636048826,TDAC 108,A00,189305,Staff,18,0,20,2
1683636049855,TDDE 131,A00,189310,Staff,19,0,20,1
1683636049855,TDDE 131,B00,189314,Staff,19,0,20,1
1683636049855,TDDE 131,C00,189315,Staff,48,0,50,2
1683636049855,TDDE 131,D00,189316,Staff,14,0,15,1
1683636049855,TDDE 131,E00,204841,Staff,20,0,20,0
1683636050881,TDGE 10,A00,189289,Staff,28,0,50,22
1683636050881,TDGE 10,B00,189290,Havis; Allan,0,0,50,50
1683636051916,TDGE 11,A00,189291,Fulton; Julia,0,4,50,50
1683636051916,TDGE 11,B00,189292,Staff,20,0,25,5
1683636051916,TDGE 11,C00,260270,Staff,0,0,0,0
1683636052941,TDGE 25,A00,189294,Staff,2,0,20,18
1683636053966,TDGE 124,A00,189318,Fulton; Julia,0,8,50,50
1683636054992,TDGE 125,A00,189319,Staff,13,0,25,12
1683636054992,TDGE 125,B00,189320,Staff,23,0,25,2
1683636056017,TDGE 127,A00,189322,Havis; Allan,0,0,50,50
1683636057043,TDHT 101,A00,189323,Staff,18,0,25,7
1683636057043,TDHT 101,B00,189324,Staff,25,0,25,0
1683636058070,TDHT 102,A00,189325,Staff,49,0,50,1
1683636059097,TDMV 1,A00,189295,Arcidiacono; Kristin,20,0,30,10
1683636059097,TDMV 1,B00,189296,Caligagan; Maria T.,24,0,30,6
1683636060123,TDMV 2,A00,189297,Sammartano; Tonnie,27,0,30,3
1683636060123,TDMV 2,B00,189299,Arcidiacono; Kristin,23,0,30,7
1683636061150,TDMV 3,A00,204998,Rincon; Alicia,22,0,30,8
1683636062180,TDMV 120,A00,189458,Sammartano; Tonnie,28,0,30,2
1683636063210,TDMV 138,A00,189541,Jun; Grace Shin Hae,20,0,40,20
1683636064241,TDMV 142,A00,189717,Caligagan; Tony,25,0,30,5
1683636064241,TDMV 142,B00,189718,Caligagan; Maria T.,25,0,30,5
1683636065267,TMC 2,A01,187533,Staff,25,0,25,0
1683636065267,TMC 2,A02,187534,Staff,25,0,25,0
1683636066293,USP 1,A01,187536,Kwak; Nancy,0,16,25,25
1683636067321,USP 5,A01,187538,Staff,9,0,25,16
1683636068350,USP 101,A00,199253,Staff,0,4,0,0
1683636069375,USP 124,A00,187562,Boomhower; Matthew Charles,0,0,30,30
1683636070399,USP 138,A00,187582,Staff,20,0,25,5
1683636071424,USP 152,A01,187597,Staff,3,0,25,22
1683636072450,USP 153,A00,187598,Staff,19,0,25,6
1683636073482,USP 168,A00,187607,Kwak; Nancy,2,0,5,3
1683636074507,USP 173,A00,187619,Staff,4,0,25,21
1683636075532,USP 181,A00,187638,Staff,0,4,25,25
1683636076561,VIS 103,A00,187650,Cruz; Edwin Teddy,18,0,75,57
1683636077587,VIS 110D,A00,187669,Staff,13,0,22,9
1683636078611,VIS 127C,A00,187720,Shen; Kuiyi,67,0,146,79
1683636079642,VIS 149,A00,187731,Yoldas; Pinar,0,14,22,22
1683636080670,VIS 151,A01,188091,Staff,22,0,34,12
1683636080670,VIS 151,A02,188092,Staff,11,0,34,23
1683636081696,VIS 160B,A00,188093,Stalbaum; Brett,0,1,10,10
1683636083747,WCWP 10B,A00,201720,Staff,10,0,15,5
1683636083747,WCWP 10B,B00,201722,Staff,9,0,15,6
1683636084777,WCWP 100,A00,201725,Gagnon; Jeffrey C,0,0,2,2
1683636084777,WCWP 100,B00,201727,Staff,0,4,15,15
1683636087936,ANBI 133,A00,258401,Wilder; Linnea Lorene,34,0,40,6
1683636088966,ANBI 140,A00,258395,Hrvoj Mihic; Branka,18,0,25,7
1683636089998,ANSC 120,A00,258402,Bialecki; Jon Anthony,27,0,40,13
1683636091022,ANSC 144,A00,258400,Staff,12,0,40,28
1683636093075,ANSC 166,A00,258396,Parish; Steven Martin,156,0,175,19
1683636094102,ANSC 180,A00,193533,Staff,8,0,20,12
1683636095129,ANSC 188,A00,258397,Jassal; Aftab,34,0,40,6
1683636096160,ANTH 3,A01,258316,Staff,23,0,30,7
1683636097191,ANTH 5,A00,258394,Semendeferi; Ekaterini,16,0,20,4
1683636098218,ANTH 21,A01,258331,Staff,4,0,40,36
1683636099244,ANTH 103,A00,258398,Varma; Saiba,15,0,25,10
1683636100275,AWP 10,001,202034,Staff,0,0,0,0
1683636100275,AWP 10,002,202035,Staff,0,0,0,0
1683636100275,AWP 10,003,202036,Staff,0,0,0,0
1683636100275,AWP 10,004,202037,Staff,0,0,0,0
1683636100275,AWP 10,005,202038,Staff,0,0,0,0
1683636100275,AWP 10,006,202039,Staff,0,0,0,0
1683636100275,AWP 10,007,202040,Staff,0,0,0,0
1683636100275,AWP 10,008,202041,Staff,0,0,0,0
1683636100275,AWP 10,009,202042,Staff,0,0,0,0
1683636100275,AWP 10,010,202043,Staff,0,0,0,0
1683636100275,AWP 10,011,202044,Staff,0,0,0,0
1683636100275,AWP 10,012,202045,Staff,0,0,0,0
1683636100275,AWP 10,013,202046,Staff,0,0,0,0
1683636100275,AWP 10,014,202047,Staff,0,0,0,0
1683636100275,AWP 10,015,202048,Staff,0,0,0,0
1683636100275,AWP 10,016,202049,Staff,0,0,0,0
1683636100275,AWP 10,017,202050,Staff,0,0,0,0
1683636100275,AWP 10,018,202051,Staff,0,0,0,0
1683636100275,AWP 10,019,202052,Staff,0,0,0,0
1683636100275,AWP 10,020,202053,Staff,0,0,0,0
1683636100275,AWP 10,021,202054,Staff,0,0,0,0
1683636100275,AWP 10,022,202055,Staff,0,0,0,0
1683636100275,AWP 10,023,202056,Staff,0,0,0,0
1683636100275,AWP 10,024,202057,Staff,0,0,0,0
1683636100275,AWP 10,025,202058,Staff,0,0,0,0
1683636100275,AWP 10,026,202059,Staff,0,0,0,0
1683636101301,AWP 102,001,202032,Staff,0,0,0,0
1683636101301,AWP 102,002,202033,Staff,0,0,0,0
1683636102326,BENG 100,A01,254234,Taylor Amos; Alyssa C,31,0,40,9
1683636103355,BENG 196,001,270013,Engler; Adam J.,9999,0,9999,0
1683636104383,BICD 100R,A01,202018,Smith; Laurie,0,7,32,32
1683636104383,BICD 100R,A02,202019,Smith; Laurie,0,3,32,32
1683636104383,BICD 100R,A03,202020,Smith; Laurie,0,1,32,32
1683636104383,BICD 100R,A04,202021,Smith; Laurie,6,0,32,26
1683636104383,BICD 100R,A05,202022,Smith; Laurie,11,0,32,21
1683636105413,BICD 136,A01,193242,Gustafson-Brown; Cindy,0,2,32,32
1683636105413,BICD 136,A02,193244,Gustafson-Brown; Cindy,13,0,32,19
1683636106440,BIEB 102,A01,193249,Butler; Shannon Rhey,0,2,32,32
1683636106440,BIEB 102,A02,193251,Butler; Shannon Rhey,0,0,32,32
1683636106440,BIEB 102,A03,193253,Butler; Shannon Rhey,0,0,32,32
1683636106440,BIEB 102,A04,193255,Butler; Shannon Rhey,14,0,32,18
1683636106440,BIEB 102,A05,193265,Butler; Shannon Rhey,26,0,32,6
1683636106440,BIEB 102,A06,193269,Butler; Shannon Rhey,14,0,32,18
1683636108492,BIEB 150,A01,193274,Staff,0,0,32,32
1683636108492,BIEB 150,A02,193285,Staff,24,0,32,8
1683636109521,BIEB 194,A00,193286,Kurle; Carolyn M.,20,0,32,12
1683636110549,BILD 1,A01,192291,Staff,15,0,32,17
1683636110549,BILD 1,A02,192292,Staff,30,0,32,2
1683636110549,BILD 1,B01,192520,Reuther; Keefe,0,1,0,0
1683636110549,BILD 1,B02,192532,Reuther; Keefe,0,1,0,0
1683636111576,BILD 3,A01,192556,Butler; Shannon Rhey,0,0,32,32
1683636111576,BILD 3,A02,192581,Butler; Shannon Rhey,1,0,32,31
1683636111576,BILD 3,A03,192611,Butler; Shannon Rhey,21,0,32,11
1683636111576,BILD 3,A04,192612,Butler; Shannon Rhey,24,0,32,8
1683636111576,BILD 3,A05,192613,Butler; Shannon Rhey,26,0,32,6
1683636111576,BILD 3,A06,192679,Butler; Shannon Rhey,27,0,32,5
1683636111576,BILD 3,A07,192682,Butler; Shannon Rhey,20,0,32,12
1683636112603,BILD 4,A01,192836,Reuther; Keefe,0,0,24,24
1683636112603,BILD 4,A02,193044,Reuther; Keefe,4,0,24,20
1683636113630,BILD 10,A01,193142,Gustafson-Brown; Cindy,29,0,32,3
1683636113630,BILD 10,A02,193149,Gustafson-Brown; Cindy,31,0,32,1
1683636114658,BIMM 100,A01,193301,Staff,0,6,32,32
1683636114658,BIMM 100,A02,193312,Staff,0,7,32,32
1683636114658,BIMM 100,A03,193323,Staff,0,9,32,32
1683636115686,BIMM 101,A01,193329,McDonnell; Lisa Marie,0,4,24,24
1683636115686,BIMM 101,A02,193339,McDonnell; Lisa Marie,0,3,24,24
1683636115686,BIMM 101,B01,193354,McDonnell; Lisa Marie,0,4,24,24
1683636115686,BIMM 101,B02,193357,McDonnell; Lisa Marie,0,2,24,24
1683636116719,BIMM 110,A01,193377,Tat; John,0,11,32,32
1683636116719,BIMM 110,A02,193378,Tat; John,0,10,32,32
1683636117752,BIMM 120,A01,206116,Staff,0,0,32,32
1683636117752,BIMM 120,A02,206117,Staff,6,0,32,26
1683636117752,BIMM 120,A03,206121,Staff,21,0,32,11
1683636118786,BIPN 100,A01,193393,Park; Ji Young,0,14,32,32
1683636118786,BIPN 100,A02,193402,Park; Ji Young,0,14,32,32
1683636118786,BIPN 100,A03,193413,Park; Ji Young,0,14,32,32
1683636118786,BIPN 100,A04,193414,Park; Ji Young,0,13,32,32
1683636119814,BIPN 102,A01,193429,Staff,0,0,32,32
1683636119814,BIPN 102,A02,193438,Staff,18,0,32,14
1683636120844,BIPN 106,A01,193450,Reyes Gonzalez; Catalina,0,2,40,40
1683636121879,BIPN 134,A01,193465,Cooke; James Edward,0,0,32,32
1683636121879,BIPN 134,A02,193474,Cooke; James Edward,25,0,32,7
1683636121879,BIPN 134,A03,193485,Cooke; James Edward,29,0,32,3
1683636121879,BIPN 134,A04,193486,Cooke; James Edward,20,0,32,12
1683636121879,BIPN 134,A05,193491,Cooke; James Edward,31,0,32,1
1683636121879,BIPN 134,A06,193501,Cooke; James Edward,30,0,32,2
1683636121879,BIPN 134,A07,193510,Cooke; James Edward,29,0,32,3
1683636123952,BISP 194,A00,222522,Staff,14,0,32,18
1683636124977,CAT 124,A01,202407,Staff,19,0,25,6
1683636126014,CAT 125,A00,202408,Marchisotto; Jennifer Anne,2,0,20,18
1683636127042,CAT 125R,A00,202409,Smith; Lauryn Alissa,0,11,20,20
1683636127042,CAT 125R,B00,202410,Morales; Celeste Georgianna,0,11,20,20
1683636127042,CAT 125R,C00,202411,Irwin; Matthew Joseph,0,12,20,20
1683636128067,CENG 15,A01,204712,Yang; Kesong,0,1,0,0
1683636129098,CENG 114,A00,202070,Jahed Motlagh; Zeinab,5,0,20,15
1683636130126,CGS 105,A00,185477,Wesling; Megan E.,24,0,40,16
1683636131159,CGS 106,A00,185494,Staff,11,0,22,11
1683636132185,CGS 108,A00,185495,Staff,14,0,20,6
1683636133210,CGS 114,A00,185496,Staff,13,0,18,5
1683636134237,CGS 119,A00,185501,Staff,15,0,20,5
1683636135263,CGS 120,A00,185511,Staff,12,0,20,8
1683636136290,CHEM 4,A01,184675,Bussey; Thomas J,97,0,100,3
1683636137319,CHEM 6A,A01,184677,Staff,33,0,60,27
1683636138349,CHEM 6B,A01,184679,Staff,63,0,100,37
1683636139373,CHEM 6C,A01,184681,Bussey; Thomas J,0,0,50,50
1683636139373,CHEM 6C,A02,184682,Bussey; Thomas J,32,0,50,18
1683636140398,CHEM 40A,A01,184684,Albizati; Kim F.,35,0,100,65
1683636141424,CHEM 40B,A01,184686,Albizati; Kim F.,0,22,100,100
1683636142453,CHEM 41B,A01,184690,Staff,51,0,100,49
1683636143539,COGS 3,A01,184715,Boyle; Mary E. T.,0,27,40,40
1683636144566,COGS 14B,A01,185172,Staff,0,14,38,38
1683636145590,COGS 18,A01,184736,Staff,15,0,80,65
1683636146618,COGS 100,A01,184932,Staff,0,7,73,73
1683636147648,COGS 101A,A01,184935,Staff,0,39,30,30
1683636148674,COGS 101B,A01,184944,Staff,0,2,30,30
1683636149701,COGS 101C,A01,184946,Staff,0,10,30,30
1683636150742,COGS 102A,A01,184951,Johnson; Christine M.,2,0,40,38
1683636151775,COGS 107B,A01,184953,Mooshagian; Eric Frederick,0,51,40,40
1683636152802,COGS 118B,A01,184959,Gupta; Anjum,0,49,40,40
1683636153827,COGS 153,A00,184961,Staff,0,16,30,30
1683636154853,COGS 177,A00,184962,Staff,0,21,30,30
1683636155882,COGS 187A,A01,184969,Boyle; Mary E. T.,0,19,40,40
1683636156913,COMM 10,A01,185174,Staff,0,5,25,25
1683636156913,COMM 10,A02,185189,Staff,0,2,25,25
1683636156913,COMM 10,A03,269821,Staff,0,1,0,0
1683636157944,COMM 100B,A01,185475,Staff,0,1,0,2
1683636157944,COMM 100B,A02,185476,Staff,12,0,25,13
1683636158974,COMM 100C,A01,185314,Staff,1,0,25,24
1683636158974,COMM 100C,A02,185327,Staff,18,0,25,7
1683636160004,COMM 110M,A00,185349,Staff,0,0,40,40
1683636161030,COMM 113T,A00,185352,Staff,25,0,40,15
1683636162055,COMM 114I,A00,185353,Staff,31,0,40,9
1683636163082,COMM 131,A00,185354,Staff,17,0,30,13
1683636164114,CSE 8A,A50,185358,Cao; Yingjun,0,46,10,10
1683636165139,CSE 8B,A01,185362,Staff,0,48,50,50
1683636166165,CSE 11,A01,185416,Cao; Yingjun,0,91,10,10
1683636167190,CSE 20,A01,185445,Briones; Jor-el Thomas Caparas,4,0,25,21
1683636168222,CSE 21,A01,185447,Staff,9,0,50,41
1683636169253,CSE 101,A01,185451,Staff,0,13,50,50
1683636169253,CSE 101,B01,185453,Jones; Miles E,0,13,50,50
1683636171310,CSE 141,A01,185458,Eldon; John,15,0,100,85
1683636172339,CSE 141L,A01,185461,Eldon; John,7,0,100,93
1683636173366,CSE 142,A01,185463,Staff,36,0,60,24
1683636173366,CSE 142,B01,201355,Staff,0,7,60,60
1683636174391,CSE 142L,A01,185470,Staff,36,0,60,24
1683636174391,CSE 142L,B01,201417,Staff,0,6,60,60
1683636175415,CSE 190,A00,201433,Staff,32,0,49,17
1683636176443,DOC 1,A01,259136,Strom; Megan C.,7,0,15,8
1683636176443,DOC 1,A02,259137,Strom; Megan C.,14,0,15,1
1683636176443,DOC 1,A03,259138,Strom; Megan C.,14,0,15,1
1683636176443,DOC 1,A04,259139,Strom; Megan C.,14,0,15,1
1683636177469,DOC 100D,A00,259140,Pass; Natalye Joann,14,0,25,11
1683636178498,DSGN 1,A01,184749,Rill; Bryan,0,26,30,30
1683636179528,DSGN 100,A01,185168,Staff,0,2,25,25
1683636180560,ECE 5,A01,185626,Morris; Karcher William,0,11,0,0
1683636181587,ECE 101,A01,185628,Staff,14,0,70,56
1683636182614,ECE 107,A01,185635,Baghdadchi; Saharnaz,0,0,20,20
1683636182614,ECE 107,A02,185638,Baghdadchi; Saharnaz,3,0,20,17
1683636183639,ECE 148,A01,185647,Silberman; Jack,0,0,16,16
1683636184664,ECON 1,A01,185537,Crane; Meredith Helen,54,0,70,16
1683636185695,ECON 3,A01,185549,Crane; Meredith Helen,29,0,70,41
1683636186721,ECON 4,A01,203354,Anderson; John Charles,0,5,10,10
1683636187749,ECON 100A,A01,185574,Staff,0,5,40,40
1683636188777,ECON 100B,A01,185576,Staff,0,12,50,50
1683636189805,ECON 100C,A01,185589,Newhouse; Herbert S,30,0,70,40
1683636190844,ECON 105,A00,185608,Vespa; Emanuel Ignacio,19,0,35,16
1683636191872,ECON 109,A01,185610,Shishkin; Denis,9,0,35,26
1683636192898,ECON 110A,A01,185612,Staff,9,0,40,31
1683636193926,ECON 120A,A01,185615,Staff,20,0,40,20
1683636194956,ECON 120C,A01,185617,Sun; Yixiao,0,20,70,70
1683636195985,ECON 144,A00,203346,Squires; Dale E,2,0,35,33
1683636197016,ECON 171,A01,203349,Newhouse; Herbert S,0,1,35,35
1683636198049,ECON 173A,A01,185621,Toda; Alexis Akira,21,0,35,14
1683636199084,EDS 25,A01,202413,Staff,0,1,0,0
1683636199084,EDS 25,A02,202414,Staff,0,1,0,0
1683636199084,EDS 25,A03,202415,Staff,0,0,0,0
1683636199084,EDS 25,A04,202416,Staff,0,1,0,0
1683636199084,EDS 25,A05,202439,Staff,0,0,0,0
1683636199084,EDS 25,A06,202440,Staff,0,0,0,0
1683636199084,EDS 25,B01,202631,Staff,0,0,0,0
1683636199084,EDS 25,B02,202632,Staff,0,0,0,0
1683636199084,EDS 25,B03,202639,Staff,0,0,0,0
1683636199084,EDS 25,B04,202640,Staff,0,0,0,0
1683636199084,EDS 25,B05,202643,Staff,0,0,0,0
1683636199084,EDS 25,B06,202644,Staff,0,0,0,0
1683636200112,EDS 38,A01,202659,Black; Alison Michelle,24,0,25,1
1683636201139,EDS 115,A00,202652,Staff,18,0,30,12
1683636202165,EDS 125,A00,202649,Staff,13,0,30,17
1683636203192,EDS 126,A01,203332,Staff,30,0,30,0
1683636204219,EDS 139,A00,202838,Staff,16,0,25,9
1683636205245,EDS 146,A01,202655,Staff,14,0,25,11
1683636206279,ENG 15,A00,185667,Staff,0,1,0,0
1683636206279,ENG 15,B00,185672,Staff,0,0,0,0
1683636206279,ENG 15,C00,185675,Staff,0,0,0,0
1683636206279,ENG 15,D00,185682,Staff,0,0,0,0
1683636206279,ENG 15,E00,185684,Staff,0,0,0,0
1683636207310,ETHN 103,A00,185710,Staff,0,8,35,35
1683636208338,ETHN 103A,A00,199228,Man; Simeon S,0,0,9,9
1683636209365,ETHN 109,A00,185711,Staff,16,0,35,19
1683636210390,ETHN 142,A00,185726,Staff,0,4,30,30
1683636211415,ETHN 163J,A00,199229,Man; Simeon S,5,0,8,3
1683636212443,ETHN 168,A00,185727,Staff,7,0,10,3
1683636213469,ETHN 182,A00,185728,Staff,0,0,35,35
1683636214499,ETHN 183,A00,185737,Staff,9,0,18,9
1683636215529,GLBH 111,A01,209361,Burgos; Jose L.,0,0,0,0
1683636217589,HIEU 104,A00,185792,Staff,14,0,20,6
1683636218619,HIEU 115,A00,185800,Staff,0,0,20,20
1683636219645,HIEU 128,A00,185801,Staff,0,9,20,20
1683636220672,HIEU 147,A00,185802,Staff,15,0,20,5
1683636221698,HIEU 154,A00,185823,Staff,11,0,20,9
1683636222728,HILA 102,A00,185826,Staff,14,0,20,6
1683636223757,HILD 2C,A01,185778,Staff,0,13,20,20
1683636224785,HILD 7B,A01,185780,Kwak; Nancy,0,16,32,32
1683636224785,HILD 7B,A02,185781,Kwak; Nancy,0,18,32,32
1683636225815,HILD 30,A01,185791,Staff,12,0,20,8
1683636226844,HISC 119,A00,185830,Golan; Tal,0,9,20,20
1683636227877,HITO 156GS,A00,185831,Patterson; Patrick H.,0,0,0,23
1683636228906,HIUS 103,A00,185832,Man; Simeon S,0,4,20,20
1683636229932,HIUS 117,A00,185836,Kwak; Nancy,2,0,20,18
1683636230956,HIUS 125,A00,185840,Man; Simeon S,0,1,23,23
1683636231982,HIUS 149,A00,185845,Staff,1,0,20,19
1683636233009,HUM 3,A01,185882,Zavodny; Tatiana Sophia,0,7,50,50
1683636233009,HUM 3,B01,185899,Caldwell; Michael Alan,0,18,50,50
1683636234035,HUM 3GS,A00,185900,Patterson; Patrick H.,0,0,0,23
1683636235074,HUM 4,A01,185938,Zroka; Amy Liane,30,0,50,20
1683636235074,HUM 4,B01,185956,Watkins; Eric,0,4,50,50
1683636235074,HUM 4,B02,202209,Watkins; Eric,0,4,50,50
1683636235074,HUM 4,B03,202210,Watkins; Eric,0,4,50,50
1683636236104,HUM 5,A01,185958,West; Geoffrey Scott,2,0,50,48
1683636236104,HUM 5,A02,202215,West; Geoffrey Scott,0,0,50,50
1683636237135,INTL 190,A00,185959,Gagnon; Jeffrey C,0,0,0,9
1683636237135,INTL 190,B00,185960,Lettieri; Michael Joseph,0,0,0,2
1683636238159,JAPN 180,A00,254509,Staff,5,0,30,25
1683636239184,LATI 10,A01,202853,Kennemore; Amy Michelle,4,0,35,31
1683636239184,LATI 10,A02,202854,Kennemore; Amy Michelle,2,0,35,33
1683636239184,LATI 10,A03,270054,Kennemore; Amy Michelle,30,0,30,0
1683636240210,LATI 180,A00,202855,Kennemore; Amy Michelle,11,0,20,9
1683636241239,LAWS 101,A00,201767,Golan; Tal,0,7,40,40
1683636242265,LIFR 1C,A00,185961,Staff,6,0,20,14
1683636243293,LIFR 1CX,A00,185962,Staff,7,0,20,13
1683636244320,LIFR 1D,A00,185963,Staff,7,0,20,13
1683636245346,LIFR 1DX,A00,185964,Staff,7,0,20,13
1683636246375,LIGN 101,A01,186039,Staff,43,0,50,7
1683636247460,LIGN 165,A00,186040,Staff,15,0,50,35
1683636248490,LTCS 108,A00,186041,Staff,5,0,10,5
1683636249518,LTCS 119,A00,186042,Staff,15,0,20,5
1683636250547,LTCS 130,A00,186043,Wesling; Megan E.,15,0,25,10
1683636252602,LTEA 138,A00,186119,Staff,14,0,40,26
1683636253629,LTEN 124,A00,186148,Staff,5,0,25,20
1683636254655,LTEN 178,A00,186149,Staff,7,0,15,8
1683636255682,LTEN 181,A00,186150,Blanco; John D,34,0,40,6
1683636256709,LTWL 120,A00,186160,Staff,20,0,25,5
1683636257735,LTWL 165,A00,186161,Staff,22,0,25,3
1683636258763,LTWR 100,A00,186162,Staff,0,5,15,15
1683636259795,LTWR 102,A00,186163,Doller; Ben,5,0,15,10
1683636260826,MAE 8,A01,186412,Staff,0,0,0,0
1683636261851,MAE 30B,A00,186445,Bahadori; Mohammad Yousef,82,0,100,18
1683636262879,MAE 40,A00,186592,Bewley; Thomas R,10,0,50,40
1683636263904,MAE 101B,A00,186593,Bahadori; Mohammad Yousef,80,0,100,20
1683636264935,MAE 105,A00,186594,Bandaru; Prabhakar,10,0,50,40
1683636265992,MAE 107,A00,186599,Pham; Hieu Tan,0,7,120,120
1683636267023,MAE 148,A01,186660,Silberman; Jack,3,0,16,13
1683636268049,MATH 10A,A01,188095,Staff,0,5,35,35
1683636269078,MATH 10B,A01,188097,Bowers; Adam R.,0,11,30,30
1683636269078,MATH 10B,A02,188099,Bowers; Adam R.,0,11,30,30
1683636269078,MATH 10B,B01,188104,Bowers; Adam R.,0,10,30,30
1683636269078,MATH 10B,B02,188106,Bowers; Adam R.,1,9,30,29
1683636270106,MATH 10C,A01,188111,Staff,0,18,30,30
1683636270106,MATH 10C,A02,188127,Staff,0,19,30,30
1683636270106,MATH 10C,A03,188131,Staff,0,19,30,30
1683636270106,MATH 10C,B01,188218,Staff,17,0,30,13
1683636270106,MATH 10C,B02,188244,Staff,13,0,30,17
1683636270106,MATH 10C,B03,188277,Staff,14,0,30,16
1683636271132,MATH 18,A01,188344,Bach; Quang Tran,18,0,30,12
1683636271132,MATH 18,A02,188345,Bach; Quang Tran,11,0,30,19
1683636271132,MATH 18,B01,188353,Bach; Quang Tran,11,0,30,19
1683636271132,MATH 18,B02,188354,Bach; Quang Tran,19,0,30,11
1683636272158,MATH 20A,A01,188374,Staff,11,0,35,24
1683636273190,MATH 20B,A01,188382,Ohm; Ko Woon,7,0,30,23
1683636273190,MATH 20B,A02,188383,Ohm; Ko Woon,22,0,30,8
1683636273190,MATH 20B,B01,188385,Ohm; Ko Woon,7,0,30,23
1683636273190,MATH 20B,B02,188392,Ohm; Ko Woon,22,0,30,8
1683636274215,MATH 20C,A01,188394,Harel; Guershon,11,0,30,19
1683636274215,MATH 20C,A02,188395,Harel; Guershon,14,0,30,16
1683636274215,MATH 20C,B01,188404,Harel; Guershon,4,0,30,26
1683636274215,MATH 20C,B02,188405,Harel; Guershon,18,0,30,12
1683636275243,MATH 20D,A01,188414,Hammock; Frances H,0,1,30,30
1683636275243,MATH 20D,A02,188415,Hammock; Frances H,0,1,30,30
1683636275243,MATH 20D,B01,188447,Hammock; Frances H,0,1,30,30
1683636275243,MATH 20D,B02,188486,Hammock; Frances H,4,0,30,26
1683636276269,MATH 20E,A01,188649,Staff,21,0,30,9
1683636276269,MATH 20E,A02,188650,Staff,21,0,30,9
1683636276269,MATH 20E,A03,188673,Staff,0,0,30,30
1683636277295,MATH 102,A01,188675,Staff,0,36,35,35
1683636278320,MATH 103B,A01,188681,Staff,3,0,35,32
1683636278320,MATH 103B,B01,188692,Staff,5,0,35,30
1683636279345,MATH 109,A01,188695,Salehi Golsefidy; Alireza,24,0,35,11
1683636279345,MATH 109,A02,188696,Salehi Golsefidy; Alireza,25,0,35,10
1683636280377,MATH 120A,A01,188698,Eggers; John Dietrich,7,0,35,28
1683636281404,MATH 142B,A01,188736,Ioana; Adrian,0,1,30,30
1683636281404,MATH 142B,A02,188741,Ioana; Adrian,0,1,30,30
1683636281404,MATH 142B,A03,188743,Ioana; Adrian,0,1,30,30
1683636282430,MATH 168A,A01,188790,Staff,0,10,35,35
1683636283458,MATH 170A,A01,188803,Nie; Jiawang,0,2,35,35
1683636283458,MATH 170A,A02,188811,Nie; Jiawang,0,0,35,35
1683636283458,MATH 170A,A03,188814,Nie; Jiawang,0,0,35,35
1683636283458,MATH 170A,A04,188815,Nie; Jiawang,10,0,35,25
1683636284490,MATH 193B,A01,188817,Staff,0,0,35,35
1683636284490,MATH 193B,A02,188818,Staff,5,0,35,30
1683636285519,MGT 4,A01,202857,Anderson; John Charles,61,0,80,19
1683636286547,MGT 12,A00,202858,Lindenberger; Wade Douglas,40,0,90,50
1683636287573,MGT 18,A00,202859,Staff,74,0,90,16
1683636288602,MGT 18GS,A00,202860,McKay; Michael J,13,0,28,15
1683636289634,MGT 45,A00,202861,Pecore; Joseph P.,12,0,90,78
1683636290663,MGT 100,A00,202863,Yavorsky; Daniel Ryan,28,0,90,62
1683636291688,MGT 103,A00,202864,Ehrich; Kristine R,0,17,90,90
1683636292716,MGT 112,A00,202865,Ehrich; Kristine R,15,0,90,75
1683636293743,MGT 121A,A00,202868,Staff,0,20,0,0
1683636294767,MGT 131B,A00,202869,Anderson; John Charles,59,0,90,31
1683636295797,MGT 136,A00,202871,Lindenberger; Wade Douglas,83,0,90,7
1683636296822,MGT 164,A00,202873,Staff,0,66,90,91
1683636297851,MGT 164GS,A00,202874,McKay; Mary A,13,0,28,15
1683636298880,MGT 180,A00,202875,Staff,0,50,90,91
1683636299909,MMW 11R,A01,205019,Herbst; Matthew,2,0,30,28
1683636299909,MMW 11R,A02,205026,Herbst; Matthew,29,0,30,1
1683636300935,MMW 15,A01,193512,Chang; Edmond Yi-Teh,0,8,28,28
1683636300935,MMW 15,A02,193513,Chang; Edmond Yi-Teh,0,5,28,28
1683636300935,MMW 15,A03,193514,Chang; Edmond Yi-Teh,0,5,28,28
1683636300935,MMW 15,A04,193515,Chang; Edmond Yi-Teh,0,5,28,28
1683636300935,MMW 15,A05,193516,Chang; Edmond Yi-Teh,0,5,28,28
1683636300935,MMW 15,A06,193517,Chang; Edmond Yi-Teh,0,6,28,28
1683636300935,MMW 15,B01,193519,Chang; Edmond Yi-Teh,0,5,28,28
1683636300935,MMW 15,B02,193520,Chang; Edmond Yi-Teh,0,5,28,28
1683636300935,MMW 15,B03,193521,Chang; Edmond Yi-Teh,0,5,28,28
1683636300935,MMW 15,B04,193522,Chang; Edmond Yi-Teh,0,5,28,28
1683636300935,MMW 15,B05,193523,Chang; Edmond Yi-Teh,0,5,28,28
1683636300935,MMW 15,B06,193524,Chang; Edmond Yi-Teh,0,5,28,28
1683636314418,MMW 122,A01,193526,Rahimi; Babak,0,16,28,28
1683636314418,MMW 122,A02,193527,Rahimi; Babak,0,15,28,28
1683636314418,MMW 122,A03,193528,Rahimi; Babak,0,0,0,0
1683636314418,MMW 122,A04,193529,Rahimi; Babak,0,0,0,0
1683636315447,MUS 1A,A01,186663,Staff,1,20,35,34
1683636316472,MUS 4,A01,186715,Staff,0,12,35,35
1683636317498,MUS 5R,A01,186796,Dubnov; Shlomo,0,17,35,35
1683636318524,MUS 6,A01,186798,Staff,0,5,25,25
1683636319553,MUS 7,A01,186830,Staff,11,0,35,24
1683636320580,MUS 8,A01,186930,Staff,0,26,35,35
1683636321607,MUS 15,A01,186932,Staff,0,16,35,35
1683636321607,MUS 15,B01,186934,Staff,0,17,35,35
1683636322634,MUS 80,A00,186935,Staff,0,0,20,20
1683636322634,MUS 80,B00,186936,Staff,24,0,25,1
1683636323663,NANO 11,A00,204702,Lipomi; Darren John,0,0,0,0
1683636324695,NANO 15,A01,204709,Yang; Kesong,0,1,0,0
1683636337880,NANO 114,A00,202069,Jahed Motlagh; Zeinab,3,0,10,7
1683636338906,PHIL 1,A00,186955,Grush; Rick Scott,31,0,40,9
1683636339932,PHIL 10,A01,186973,Grush; Rick Scott,27,0,35,8
1683636339932,PHIL 10,A02,186974,Grush; Rick Scott,33,0,35,2
1683636340959,PHIL 13,A01,186976,Staff,3,0,35,32
1683636340959,PHIL 13,A02,186977,Staff,16,0,35,19
1683636341989,PHIL 14,A01,186979,Staff,31,0,35,4
1683636341989,PHIL 14,A02,186986,Staff,32,0,35,3
1683636343016,PHIL 28,A01,186988,Staff,16,0,30,14
1683636343016,PHIL 28,A02,186989,Staff,1,0,30,29
1683636343016,PHIL 28,A03,186990,Staff,10,0,30,20
1683636343016,PHIL 28,A04,186991,Staff,26,0,30,4
1683636344043,PHIL 120,A00,186997,Staff,23,0,40,17
1683636345070,PHIL 137,A00,187003,Staff,7,0,40,33
1683636346100,PHIL 150,A00,187015,Staff,47,0,70,23
1683636347132,PHIL 167,A00,187021,Lamey; Andy M.,34,0,40,6
1683636360526,PHIL 174,A01,202226,Staff,17,0,20,3
1683636360526,PHIL 174,A02,202235,Staff,20,0,20,0
1683636361554,PHIL 191A,A00,258918,Staff,0,0,1,1
1683636362583,PHYS 1A,A00,187028,Staff,27,0,60,33
1683636363610,PHYS 1AL,001,187036,Staff,3,0,30,27
1683636363610,PHYS 1AL,002,187049,Staff,18,0,30,12
1683636364638,PHYS 1B,A00,187058,Staff,22,0,60,38
1683636365666,PHYS 1BL,001,187064,Staff,0,1,30,30
1683636365666,PHYS 1BL,002,187070,Staff,4,0,30,26
1683636366695,PHYS 1C,A00,187082,Staff,29,0,120,91
1683636367724,PHYS 1CL,001,187088,Staff,0,9,30,30
1683636367724,PHYS 1CL,002,187089,Staff,0,1,30,30
1683636367724,PHYS 1CL,009,262693,Staff,9,0,30,21
1683636368751,PHYS 2B,A01,187097,Staff,55,0,115,60
1683636369783,PHYS 2C,A01,187099,Staff,64,0,115,51
1683636383086,PHYS 2CL,A01,187101,Staff,5,0,28,23
1683636383086,PHYS 2CL,A02,187102,Staff,15,0,28,13
1683636384113,PHYS 2D,A01,187123,Shotwell; Brian,95,0,115,20
1683636385138,PHYS 4B,A01,187133,Grinstein; Benjamin,35,0,50,15
1683636386164,POLI 10,A00,188819,Staff,0,4,50,50
1683636387189,POLI 11,A00,188827,Staff,43,0,50,7
1683636388217,POLI 13R,A00,188828,Staff,0,1,20,20
1683636389244,POLI 27,A01,188830,Elgin; Samuel Zincke,0,2,70,70
1683636390272,POLI 30,A00,188832,Desposato; Scott,30,0,50,20
1683636391298,POLI 102F,A00,188834,Staff,0,0,40,40
1683636392324,POLI 104A,A00,188852,Staff,13,0,30,17
1683636405365,POLI 104I,A00,188853,Staff,0,7,20,20
1683636406394,POLI 110B,A00,188854,Wiens; David,7,0,20,13
1683636407423,POLI 112A,A00,188855,Wiens; David,4,0,30,26
1683636408453,POLI 117R,A00,188856,Forman; Fonna,0,12,20,20
1683636409479,POLI 118,A00,188857,Ingham; Sean,8,0,20,12
1683636410505,POLI 120G,A00,188858,Staff,8,0,30,22
1683636411533,POLI 131CR,A00,188863,Hoston; Germaine,21,0,50,29
1683636412618,POLI 133,A00,188864,Nellis; Gareth Hb,44,0,50,6
1683636413645,POLI 134D,A00,188865,Desposato; Scott,27,0,30,3
1683636414675,POLI 142A,A00,188871,Gartzke; Erik,21,0,50,29
1683636427896,POLI 142K,A00,188874,Staff,38,0,50,12
1683636428922,POLI 143,A00,188940,Gartzke; Erik,16,0,30,14
1683636429946,POLI 153,A00,188943,Staff,2,0,20,18
1683636430975,POLI 160AA,A00,188944,Staff,11,0,40,29
1683636432004,POLI 170A,A00,188945,Staff,11,0,30,19
1683636434061,PSYC 1,A00,188952,Staff,36,0,90,54
1683636435086,PSYC 2,B00,188953,Staff,19,0,35,16
1683636436115,PSYC 6,A00,188970,Staff,47,0,60,13
1683636437146,PSYC 7,A00,188973,Staff,35,0,45,10
1683636450229,PSYC 60,A01,188980,Rickard; Timothy C.,42,0,60,18
1683636451254,PSYC 70,A01,189001,Steiner; Eric Tomas,23,0,45,22
1683636452280,PSYC 100,A00,189005,Lacefield; Katharine I,0,99,120,120
1683636453310,PSYC 102,A00,189008,Staff,8,0,30,22
1683636454338,PSYC 106,B00,189026,Gorman; Michael R.,27,0,60,33
1683636455369,PSYC 114,B01,189033,Winkielman; Piotr,0,31,30,30
1683636456395,PSYC 131,A00,189036,Anagnostaras; Stephan,0,43,60,60
1683636457422,PSYC 136,A00,189041,Lowe; Angela Beth,0,7,25,25
1683636458448,PSYC 137,A00,189057,Winkielman; Piotr,0,37,25,25
1683636459472,PSYC 144,A00,189107,Wixted; John T,0,10,50,50
1683636465489,PSYC 162,A00,189142,Staff,0,9,85,85
1683636466520,PSYC 172,A00,189144,Gorman; Michael R.,0,6,30,30
1683636468588,PSYC 179,A00,189146,Lacefield; Katharine I,0,86,120,120
1683636469620,PSYC 181,A00,189147,Anagnostaras; Stephan,0,44,90,90
1683636470650,PSYC 190R,A00,189148,Barner; David A.,0,23,80,80
1683636471677,PSYC 191,A00,189275,Rickard; Timothy C.,0,10,25,25
1683636472708,PSYC 193,A00,189276,Chapman; Eddie Nathaniel,0,1,0,4
1683636473739,PSYC 193L,A01,189281,Lowe; Angela Beth,10,0,20,10
1683636473739,PSYC 193L,B01,189285,Staff,28,0,35,7
1683636474769,RELI 149,A00,187137,Rahimi; Babak,7,0,40,33
1683636475800,SE 9,A01,187315,Staff,0,2,18,18
1683636476829,SE 101B,A00,187409,Staff,24,0,30,6
1683636477854,SE 110B,A00,187444,Staff,10,0,40,30
1683636478883,SE 130B,A00,187449,Staff,31,0,40,9
1683636479909,SE 150A,A00,187516,Staff,9,0,20,11
1683636480934,SE 154,A00,187528,Staff,29,0,50,21
1683636481966,SIO 3,A01,258171,Staff,35,0,40,5
1683636482995,SIO 10,A00,187144,Cook; Geoffrey W,0,6,75,75
1683636484024,SIO 45,A00,187152,Cook; Geoffrey W,0,4,100,100
1683636485051,SIO 109R,A00,194486,Staff,0,4,20,20
1683636487099,SIO 187,A01,187233,Kacev; David,12,0,40,28
1683636488130,SOCI 1,A01,258656,Thorpe; Charles Robert,28,0,30,2
1683636488130,SOCI 1,A02,258658,Thorpe; Charles Robert,30,0,30,0
1683636488130,SOCI 1,A03,258661,Thorpe; Charles Robert,25,0,25,0
1683636488130,SOCI 1,A04,258666,Thorpe; Charles Robert,22,0,25,3
1683636488130,SOCI 1,A05,258897,Thorpe; Charles Robert,22,0,25,3
1683636488130,SOCI 1,A06,258898,Thorpe; Charles Robert,25,0,25,0
1683636489160,SOCI 30,A01,258903,Pardo Guerra; Juan Pablo,14,0,30,16
1683636490196,SOCI 102,A00,258904,Staff,9,0,25,16
1683636491226,SOCI 106,A00,258905,Staff,19,0,25,6
1683636492254,SOCI 111,A00,258907,Ribas Norris; Janet Vanesa,26,0,30,4
1683636493281,SOCI 121R,A00,258908,Pardo Guerra; Juan Pablo,8,0,30,22
1683636494308,SOCI 126,A01,203330,Staff,14,0,20,6
1683636495334,SOCI 131,A00,258909,Thorpe; Charles Robert,30,0,60,30
1683636496366,SOCI 135,A00,258910,Payne; Christine Anna,0,11,30,30
1683636497392,SOCI 157,A00,258911,Staff,12,0,30,18
1683636498420,SOCI 184,A00,258912,Staff,25,0,30,5
1683636499449,SOCI 188D,A00,258913,Staff,22,0,30,8
1683636500481,SYN 2,001,187529,Staff,9,0,16,7
1683636500481,SYN 2,002,201452,Staff,0,20,16,16
1683636500481,SYN 2,003,201469,Staff,2,0,16,14
1683636501508,SYN 100,A01,187531,Staff,0,9,20,20
1683636501508,SYN 100,B01,201491,Staff,0,10,20,20
1683636502534,TDAC 1,A00,189286,Walsh; Kim C.,3,0,20,17
1683636502534,TDAC 1,B00,189287,Harting; Carla Kelso,10,0,20,10
1683636503560,TDAC 101,A00,189300,Walsh; Kim C.,16,0,20,4
1683636503560,TDAC 101,B00,189301,Harting; Carla Kelso,18,0,20,2
1683636504597,TDAC 102,A00,189304,Basso; Beatrice,14,0,20,6
1683636505626,TDAC 108,A00,189305,Staff,18,0,20,2
1683636506657,TDDE 131,A00,189310,Staff,19,0,20,1
1683636506657,TDDE 131,B00,189314,Staff,19,0,20,1
1683636506657,TDDE 131,C00,189315,Staff,48,0,50,2
1683636506657,TDDE 131,D00,189316,Staff,14,0,15,1
1683636506657,TDDE 131,E00,204841,Staff,20,0,20,0
1683636507687,TDGE 10,A00,189289,Staff,27,0,50,23
1683636507687,TDGE 10,B00,189290,Havis; Allan,0,0,50,50
1683636508713,TDGE 11,A00,189291,Fulton; Julia,0,4,50,50
1683636508713,TDGE 11,B00,189292,Staff,20,0,25,5
1683636508713,TDGE 11,C00,260270,Staff,0,0,0,0
1683636509742,TDGE 25,A00,189294,Staff,2,0,20,18
1683636510768,TDGE 124,A00,189318,Fulton; Julia,0,8,50,50
1683636511798,TDGE 125,A00,189319,Staff,13,0,25,12
1683636511798,TDGE 125,B00,189320,Staff,23,0,25,2
1683636512828,TDGE 127,A00,189322,Havis; Allan,0,0,50,50
1683636513858,TDHT 101,A00,189323,Staff,18,0,25,7
1683636513858,TDHT 101,B00,189324,Staff,25,0,25,0
1683636514886,TDHT 102,A00,189325,Staff,49,0,50,1
1683636515911,TDMV 1,A00,189295,Arcidiacono; Kristin,20,0,30,10
1683636515911,TDMV 1,B00,189296,Caligagan; Maria T.,24,0,30,6
1683636516937,TDMV 2,A00,189297,Sammartano; Tonnie,27,0,30,3
1683636516937,TDMV 2,B00,189299,Arcidiacono; Kristin,23,0,30,7
1683636517970,TDMV 3,A00,204998,Rincon; Alicia,22,0,30,8
1683636518997,TDMV 120,A00,189458,Sammartano; Tonnie,28,0,30,2
1683636520032,TDMV 138,A00,189541,Jun; Grace Shin Hae,20,0,40,20
1683636521060,TDMV 142,A00,189717,Caligagan; Tony,25,0,30,5
1683636521060,TDMV 142,B00,189718,Caligagan; Maria T.,25,0,30,5
1683636522086,TMC 2,A01,187533,Staff,25,0,25,0
1683636522086,TMC 2,A02,187534,Staff,25,0,25,0
1683636523117,USP 1,A01,187536,Kwak; Nancy,0,16,25,25
1683636524144,USP 5,A01,187538,Staff,9,0,25,16
1683636525170,USP 101,A00,199253,Staff,0,4,0,0
1683636526195,USP 124,A00,187562,Boomhower; Matthew Charles,0,0,30,30
1683636527224,USP 138,A00,187582,Staff,20,0,25,5
1683636528254,USP 152,A01,187597,Staff,3,0,25,22
1683636529283,USP 153,A00,187598,Staff,19,0,25,6
1683636530314,USP 168,A00,187607,Kwak; Nancy,2,0,5,3
1683636531344,USP 173,A00,187619,Staff,4,0,25,21
1683636532369,USP 181,A00,187638,Staff,0,4,25,25
1683636533396,VIS 103,A00,187650,Cruz; Edwin Teddy,18,0,75,57
1683636534422,VIS 110D,A00,187669,Staff,13,0,22,9
1683636535449,VIS 127C,A00,187720,Shen; Kuiyi,67,0,146,79
1683636536477,VIS 149,A00,187731,Yoldas; Pinar,0,14,22,22
1683636537508,VIS 151,A01,188091,Staff,22,0,34,12
1683636537508,VIS 151,A02,188092,Staff,11,0,34,23
1683636538538,VIS 160B,A00,188093,Stalbaum; Brett,0,1,10,10
1683636540595,WCWP 10B,A00,201720,Staff,10,0,15,5
1683636540595,WCWP 10B,B00,201722,Staff,9,0,15,6
1683636541626,WCWP 100,A00,201725,Gagnon; Jeffrey C,0,0,2,2
1683636541626,WCWP 100,B00,201727,Staff,0,4,15,15
1683636544853,ANBI 133,A00,258401,Wilder; Linnea Lorene,34,0,40,6
1683636545880,ANBI 140,A00,258395,Hrvoj Mihic; Branka,18,0,25,7
1683636546906,ANSC 120,A00,258402,Bialecki; Jon Anthony,27,0,40,13
1683636547934,ANSC 144,A00,258400,Staff,12,0,40,28
1683636549987,ANSC 166,A00,258396,Parish; Steven Martin,156,0,175,19
1683636551017,ANSC 180,A00,193533,Staff,8,0,20,12
1683636552050,ANSC 188,A00,258397,Jassal; Aftab,34,0,40,6
1683636553081,ANTH 3,A01,258316,Staff,23,0,30,7
1683636554107,ANTH 5,A00,258394,Semendeferi; Ekaterini,16,0,20,4
1683636555133,ANTH 21,A01,258331,Staff,4,0,40,36
1683636556162,ANTH 103,A00,258398,Varma; Saiba,15,0,25,10
1683636557201,AWP 10,001,202034,Staff,0,0,0,0
1683636557201,AWP 10,002,202035,Staff,0,0,0,0
1683636557201,AWP 10,003,202036,Staff,0,0,0,0
1683636557201,AWP 10,004,202037,Staff,0,0,0,0
1683636557201,AWP 10,005,202038,Staff,0,0,0,0
1683636557201,AWP 10,006,202039,Staff,0,0,0,0
1683636557201,AWP 10,007,202040,Staff,0,0,0,0
1683636557201,AWP 10,008,202041,Staff,0,0,0,0
1683636557201,AWP 10,009,202042,Staff,0,0,0,0
1683636557201,AWP 10,010,202043,Staff,0,0,0,0
1683636557201,AWP 10,011,202044,Staff,0,0,0,0
1683636557201,AWP 10,012,202045,Staff,0,0,0,0
1683636557201,AWP 10,013,202046,Staff,0,0,0,0
1683636557201,AWP 10,014,202047,Staff,0,0,0,0
1683636557201,AWP 10,015,202048,Staff,0,0,0,0
1683636557201,AWP 10,016,202049,Staff,0,0,0,0
1683636557201,AWP 10,017,202050,Staff,0,0,0,0
1683636557201,AWP 10,018,202051,Staff,0,0,0,0
1683636557201,AWP 10,019,202052,Staff,0,0,0,0
1683636557201,AWP 10,020,202053,Staff,0,0,0,0
1683636557201,AWP 10,021,202054,Staff,0,0,0,0
1683636557201,AWP 10,022,202055,Staff,0,0,0,0
1683636557201,AWP 10,023,202056,Staff,0,0,0,0
1683636557201,AWP 10,024,202057,Staff,0,0,0,0
1683636557201,AWP 10,025,202058,Staff,0,0,0,0
1683636557201,AWP 10,026,202059,Staff,0,0,0,0
1683636558231,AWP 102,001,202032,Staff,0,0,0,0
1683636558231,AWP 102,002,202033,Staff,0,0,0,0
1683636559264,BENG 100,A01,254234,Taylor Amos; Alyssa C,31,0,40,9
1683636560295,BENG 196,001,270013,Engler; Adam J.,9999,0,9999,0
1683636561328,BICD 100R,A01,202018,Smith; Laurie,0,7,32,32
1683636561328,BICD 100R,A02,202019,Smith; Laurie,0,3,32,32
1683636561328,BICD 100R,A03,202020,Smith; Laurie,0,1,32,32
1683636561328,BICD 100R,A04,202021,Smith; Laurie,6,0,32,26
1683636561328,BICD 100R,A05,202022,Smith; Laurie,11,0,32,21
1683636562359,BICD 136,A01,193242,Gustafson-Brown; Cindy,0,2,32,32
1683636562359,BICD 136,A02,193244,Gustafson-Brown; Cindy,13,0,32,19
1683636563394,BIEB 102,A01,193249,Butler; Shannon Rhey,0,2,32,32
1683636563394,BIEB 102,A02,193251,Butler; Shannon Rhey,0,0,32,32
1683636563394,BIEB 102,A03,193253,Butler; Shannon Rhey,0,0,32,32
1683636563394,BIEB 102,A04,193255,Butler; Shannon Rhey,14,0,32,18
1683636563394,BIEB 102,A05,193265,Butler; Shannon Rhey,26,0,32,6
1683636563394,BIEB 102,A06,193269,Butler; Shannon Rhey,14,0,32,18
1683636565449,BIEB 150,A01,193274,Staff,0,0,32,32
1683636565449,BIEB 150,A02,193285,Staff,24,0,32,8
1683636566476,BIEB 194,A00,193286,Kurle; Carolyn M.,20,0,32,12
1683636567503,BILD 1,A01,192291,Staff,15,0,32,17
1683636567503,BILD 1,A02,192292,Staff,30,0,32,2
1683636567503,BILD 1,B01,192520,Reuther; Keefe,0,1,0,0
1683636567503,BILD 1,B02,192532,Reuther; Keefe,0,1,0,0
1683636568532,BILD 3,A01,192556,Butler; Shannon Rhey,0,0,32,32
1683636568532,BILD 3,A02,192581,Butler; Shannon Rhey,1,0,32,31
1683636568532,BILD 3,A03,192611,Butler; Shannon Rhey,21,0,32,11
1683636568532,BILD 3,A04,192612,Butler; Shannon Rhey,24,0,32,8
1683636568532,BILD 3,A05,192613,Butler; Shannon Rhey,26,0,32,6
1683636568532,BILD 3,A06,192679,Butler; Shannon Rhey,27,0,32,5
1683636568532,BILD 3,A07,192682,Butler; Shannon Rhey,20,0,32,12
1683636569558,BILD 4,A01,192836,Reuther; Keefe,0,0,24,24
1683636569558,BILD 4,A02,193044,Reuther; Keefe,4,0,24,20
1683636570587,BILD 10,A01,193142,Gustafson-Brown; Cindy,29,0,32,3
1683636570587,BILD 10,A02,193149,Gustafson-Brown; Cindy,31,0,32,1
1683636571614,BIMM 100,A01,193301,Staff,0,6,32,32
1683636571614,BIMM 100,A02,193312,Staff,0,7,32,32
1683636571614,BIMM 100,A03,193323,Staff,0,9,32,32
1683636572640,BIMM 101,A01,193329,McDonnell; Lisa Marie,0,4,24,24
1683636572640,BIMM 101,A02,193339,McDonnell; Lisa Marie,0,3,24,24
1683636572640,BIMM 101,B01,193354,McDonnell; Lisa Marie,0,4,24,24
1683636572640,BIMM 101,B02,193357,McDonnell; Lisa Marie,0,2,24,24
1683636573672,BIMM 110,A01,193377,Tat; John,0,11,32,32
1683636573672,BIMM 110,A02,193378,Tat; John,0,10,32,32
1683636574704,BIMM 120,A01,206116,Staff,0,0,32,32
1683636574704,BIMM 120,A02,206117,Staff,6,0,32,26
1683636574704,BIMM 120,A03,206121,Staff,21,0,32,11
1683636575731,BIPN 100,A01,193393,Park; Ji Young,0,14,32,32
1683636575731,BIPN 100,A02,193402,Park; Ji Young,0,14,32,32
1683636575731,BIPN 100,A03,193413,Park; Ji Young,0,14,32,32
1683636575731,BIPN 100,A04,193414,Park; Ji Young,0,13,32,32
1683636576758,BIPN 102,A01,193429,Staff,0,0,32,32
1683636576758,BIPN 102,A02,193438,Staff,18,0,32,14
1683636577785,BIPN 106,A01,193450,Reyes Gonzalez; Catalina,0,2,40,40
1683636578813,BIPN 134,A01,193465,Cooke; James Edward,0,0,32,32
1683636578813,BIPN 134,A02,193474,Cooke; James Edward,25,0,32,7
1683636578813,BIPN 134,A03,193485,Cooke; James Edward,29,0,32,3
1683636578813,BIPN 134,A04,193486,Cooke; James Edward,20,0,32,12
1683636578813,BIPN 134,A05,193491,Cooke; James Edward,31,0,32,1
1683636578813,BIPN 134,A06,193501,Cooke; James Edward,30,0,32,2
1683636578813,BIPN 134,A07,193510,Cooke; James Edward,29,0,32,3
1683636580869,BISP 194,A00,222522,Staff,14,0,32,18
1683636581895,CAT 124,A01,202407,Staff,19,0,25,6
1683636582922,CAT 125,A00,202408,Marchisotto; Jennifer Anne,2,0,20,18
1683636583950,CAT 125R,A00,202409,Smith; Lauryn Alissa,0,11,20,20
1683636583950,CAT 125R,B00,202410,Morales; Celeste Georgianna,0,11,20,20
1683636583950,CAT 125R,C00,202411,Irwin; Matthew Joseph,0,12,20,20
1683636584982,CENG 15,A01,204712,Yang; Kesong,0,1,0,0
1683636586016,CENG 114,A00,202070,Jahed Motlagh; Zeinab,5,0,20,15
1683636587049,CGS 105,A00,185477,Wesling; Megan E.,24,0,40,16
1683636588074,CGS 106,A00,185494,Staff,11,0,22,11
1683636589103,CGS 108,A00,185495,Staff,14,0,20,6
1683636590132,CGS 114,A00,185496,Staff,13,0,18,5
1683636591167,CGS 119,A00,185501,Staff,15,0,20,5
1683636592192,CGS 120,A00,185511,Staff,12,0,20,8
1683636593222,CHEM 4,A01,184675,Bussey; Thomas J,97,0,100,3
1683636594252,CHEM 6A,A01,184677,Staff,33,0,60,27
1683636595280,CHEM 6B,A01,184679,Staff,63,0,100,37
1683636596309,CHEM 6C,A01,184681,Bussey; Thomas J,0,0,50,50
1683636596309,CHEM 6C,A02,184682,Bussey; Thomas J,32,0,50,18
1683636597336,CHEM 40A,A01,184684,Albizati; Kim F.,35,0,100,65
1683636598361,CHEM 40B,A01,184686,Albizati; Kim F.,0,22,100,100
1683636599391,CHEM 41B,A01,184690,Staff,51,0,100,49
1683636600417,COGS 3,A01,184715,Boyle; Mary E. T.,0,27,40,40
1683636601443,COGS 14B,A01,185172,Staff,0,14,38,38
1683636602473,COGS 18,A01,184736,Staff,15,0,80,65
1683636603503,COGS 100,A01,184932,Staff,0,7,73,73
1683636604533,COGS 101A,A01,184935,Staff,0,39,30,30
1683636605563,COGS 101B,A01,184944,Staff,0,2,30,30
1683636606598,COGS 101C,A01,184946,Staff,0,10,30,30
1683636607624,COGS 102A,A01,184951,Johnson; Christine M.,2,0,40,38
1683636608656,COGS 107B,A01,184953,Mooshagian; Eric Frederick,0,51,40,40
1683636609680,COGS 118B,A01,184959,Gupta; Anjum,0,49,40,40
1683636610711,COGS 153,A00,184961,Staff,0,16,30,30
1683636611737,COGS 177,A00,184962,Staff,0,21,30,30
1683636612764,COGS 187A,A01,184969,Boyle; Mary E. T.,0,19,40,40
1683636613791,COMM 10,A01,185174,Staff,0,5,25,25
1683636613791,COMM 10,A02,185189,Staff,0,2,25,25
1683636613791,COMM 10,A03,269821,Staff,0,1,0,0
1683636614821,COMM 100B,A01,185475,Staff,0,1,0,2
1683636614821,COMM 100B,A02,185476,Staff,12,0,25,13
1683636615848,COMM 100C,A01,185314,Staff,1,0,25,24
1683636615848,COMM 100C,A02,185327,Staff,18,0,25,7
1683636616877,COMM 110M,A00,185349,Staff,0,0,40,40
1683636617902,COMM 113T,A00,185352,Staff,25,0,40,15
1683636618927,COMM 114I,A00,185353,Staff,31,0,40,9
1683636619953,COMM 131,A00,185354,Staff,17,0,30,13
1683636620981,CSE 8A,A50,185358,Cao; Yingjun,0,46,10,10
1683636622007,CSE 8B,A01,185362,Staff,0,48,50,50
1683636623037,CSE 11,A01,185416,Cao; Yingjun,0,91,10,10
1683636624065,CSE 20,A01,185445,Briones; Jor-el Thomas Caparas,4,0,25,21
1683636625095,CSE 21,A01,185447,Staff,9,0,50,41
1683636626121,CSE 101,A01,185451,Staff,0,13,50,50
1683636626121,CSE 101,B01,185453,Jones; Miles E,0,13,50,50
1683636628174,CSE 141,A01,185458,Eldon; John,15,0,100,85
1683636629200,CSE 141L,A01,185461,Eldon; John,7,0,100,93
1683636630230,CSE 142,A01,185463,Staff,36,0,60,24
1683636630230,CSE 142,B01,201355,Staff,0,7,60,60
1683636631257,CSE 142L,A01,185470,Staff,36,0,60,24
1683636631257,CSE 142L,B01,201417,Staff,0,6,60,60
1683636632283,CSE 190,A00,201433,Staff,32,0,49,17
1683636633311,DOC 1,A01,259136,Strom; Megan C.,7,0,15,8
1683636633311,DOC 1,A02,259137,Strom; Megan C.,14,0,15,1
1683636633311,DOC 1,A03,259138,Strom; Megan C.,14,0,15,1
1683636633311,DOC 1,A04,259139,Strom; Megan C.,14,0,15,1
1683636634337,DOC 100D,A00,259140,Pass; Natalye Joann,14,0,25,11
1683636635368,DSGN 1,A01,184749,Rill; Bryan,0,26,30,30
1683636636394,DSGN 100,A01,185168,Staff,0,2,25,25
1683636637419,ECE 5,A01,185626,Morris; Karcher William,0,11,0,0
1683636638451,ECE 101,A01,185628,Staff,14,0,70,56
1683636639477,ECE 107,A01,185635,Baghdadchi; Saharnaz,0,0,20,20
1683636639477,ECE 107,A02,185638,Baghdadchi; Saharnaz,3,0,20,17
1683636640504,ECE 148,A01,185647,Silberman; Jack,0,0,16,16
1683636641537,ECON 1,A01,185537,Crane; Meredith Helen,54,0,70,16
1683636642562,ECON 3,A01,185549,Crane; Meredith Helen,29,0,70,41
1683636643593,ECON 4,A01,203354,Anderson; John Charles,0,5,10,10
1683636644620,ECON 100A,A01,185574,Staff,0,5,40,40
1683636645646,ECON 100B,A01,185576,Staff,0,12,50,50
1683636646678,ECON 100C,A01,185589,Newhouse; Herbert S,30,0,70,40
1683636647706,ECON 105,A00,185608,Vespa; Emanuel Ignacio,19,0,35,16
1683636648794,ECON 109,A01,185610,Shishkin; Denis,9,0,35,26
1683636649820,ECON 110A,A01,185612,Staff,9,0,40,31
1683636650845,ECON 120A,A01,185615,Staff,20,0,40,20
1683636651877,ECON 120C,A01,185617,Sun; Yixiao,0,20,70,70
1683636652903,ECON 144,A00,203346,Squires; Dale E,2,0,35,33
1683636653929,ECON 171,A01,203349,Newhouse; Herbert S,0,1,35,35
1683636654954,ECON 173A,A01,185621,Toda; Alexis Akira,21,0,35,14
1683636655998,EDS 25,A01,202413,Staff,0,1,0,0
1683636655998,EDS 25,A02,202414,Staff,0,1,0,0
1683636655998,EDS 25,A03,202415,Staff,0,0,0,0
1683636655998,EDS 25,A04,202416,Staff,0,1,0,0
1683636655998,EDS 25,A05,202439,Staff,0,0,0,0
1683636655998,EDS 25,A06,202440,Staff,0,0,0,0
1683636655998,EDS 25,B01,202631,Staff,0,0,0,0
1683636655998,EDS 25,B02,202632,Staff,0,0,0,0
1683636655998,EDS 25,B03,202639,Staff,0,0,0,0
1683636655998,EDS 25,B04,202640,Staff,0,0,0,0
1683636655998,EDS 25,B05,202643,Staff,0,0,0,0
1683636655998,EDS 25,B06,202644,Staff,0,0,0,0
1683636657024,EDS 38,A01,202659,Black; Alison Michelle,24,0,25,1
1683636658050,EDS 115,A00,202652,Staff,18,0,30,12
1683636659079,EDS 125,A00,202649,Staff,13,0,30,17
1683636660107,EDS 126,A01,203332,Staff,30,0,30,0
1683636661134,EDS 139,A00,202838,Staff,16,0,25,9
1683636662163,EDS 146,A01,202655,Staff,14,0,25,11
1683636663198,ENG 15,A00,185667,Staff,0,1,0,0
1683636663198,ENG 15,B00,185672,Staff,0,0,0,0
1683636663198,ENG 15,C00,185675,Staff,0,0,0,0
1683636663198,ENG 15,D00,185682,Staff,0,0,0,0
1683636663198,ENG 15,E00,185684,Staff,0,0,0,0
1683636664231,ETHN 103,A00,185710,Staff,0,8,35,35
1683636665258,ETHN 103A,A00,199228,Man; Simeon S,0,0,9,9
1683636666289,ETHN 109,A00,185711,Staff,16,0,35,19
1683636667315,ETHN 142,A00,185726,Staff,0,4,30,30
1683636668349,ETHN 163J,A00,199229,Man; Simeon S,5,0,8,3
1683636669378,ETHN 168,A00,185727,Staff,7,0,10,3
1683636670404,ETHN 182,A00,185728,Staff,0,0,35,35
1683636671433,ETHN 183,A00,185737,Staff,9,0,18,9
1683636672466,GLBH 111,A01,209361,Burgos; Jose L.,0,0,0,0
1683636674528,HIEU 104,A00,185792,Staff,14,0,20,6
1683636675561,HIEU 115,A00,185800,Staff,0,0,20,20
1683636676590,HIEU 128,A00,185801,Staff,0,9,20,20
1683636677616,HIEU 147,A00,185802,Staff,15,0,20,5
1683636678641,HIEU 154,A00,185823,Staff,11,0,20,9
1683636679671,HILA 102,A00,185826,Staff,14,0,20,6
1683636680700,HILD 2C,A01,185778,Staff,0,13,20,20
1683636681739,HILD 7B,A01,185780,Kwak; Nancy,0,16,32,32
1683636681739,HILD 7B,A02,185781,Kwak; Nancy,0,18,32,32
1683636682772,HILD 30,A01,185791,Staff,12,0,20,8
1683636683799,HISC 119,A00,185830,Golan; Tal,0,9,20,20
1683636684828,HITO 156GS,A00,185831,Patterson; Patrick H.,0,0,0,23
1683636685859,HIUS 103,A00,185832,Man; Simeon S,0,4,20,20
1683636686885,HIUS 117,A00,185836,Kwak; Nancy,2,0,20,18
1683636687910,HIUS 125,A00,185840,Man; Simeon S,0,1,23,23
1683636688935,HIUS 149,A00,185845,Staff,1,0,20,19
1683636689963,HUM 3,A01,185882,Zavodny; Tatiana Sophia,0,7,50,50
1683636689963,HUM 3,B01,185899,Caldwell; Michael Alan,0,18,50,50
1683636690990,HUM 3GS,A00,185900,Patterson; Patrick H.,0,0,0,23
1683636692023,HUM 4,A01,185938,Zroka; Amy Liane,30,0,50,20
1683636692023,HUM 4,B01,185956,Watkins; Eric,0,4,50,50
1683636692023,HUM 4,B02,202209,Watkins; Eric,0,4,50,50
1683636692023,HUM 4,B03,202210,Watkins; Eric,0,4,50,50
1683636693056,HUM 5,A01,185958,West; Geoffrey Scott,2,0,50,48
1683636693056,HUM 5,A02,202215,West; Geoffrey Scott,0,0,50,50
1683636694090,INTL 190,A00,185959,Gagnon; Jeffrey C,0,0,0,9
1683636694090,INTL 190,B00,185960,Lettieri; Michael Joseph,0,0,0,2
1683636695116,JAPN 180,A00,254509,Staff,5,0,30,25
1683636696144,LATI 10,A01,202853,Kennemore; Amy Michelle,4,0,35,31
1683636696144,LATI 10,A02,202854,Kennemore; Amy Michelle,2,0,35,33
1683636696144,LATI 10,A03,270054,Kennemore; Amy Michelle,30,0,30,0
1683636697169,LATI 180,A00,202855,Kennemore; Amy Michelle,11,0,20,9
1683636698194,LAWS 101,A00,201767,Golan; Tal,0,7,40,40
1683636699219,LIFR 1C,A00,185961,Staff,6,0,20,14
1683636700248,LIFR 1CX,A00,185962,Staff,7,0,20,13
1683636701277,LIFR 1D,A00,185963,Staff,7,0,20,13
1683636702302,LIFR 1DX,A00,185964,Staff,7,0,20,13
1683636703328,LIGN 101,A01,186039,Staff,43,0,50,7
1683636704352,LIGN 165,A00,186040,Staff,15,0,50,35
1683636705377,LTCS 108,A00,186041,Staff,5,0,10,5
1683636706406,LTCS 119,A00,186042,Staff,15,0,20,5
1683636707435,LTCS 130,A00,186043,Wesling; Megan E.,15,0,25,10
1683636709485,LTEA 138,A00,186119,Staff,14,0,40,26
1683636710512,LTEN 124,A00,186148,Staff,5,0,25,20
1683636711537,LTEN 178,A00,186149,Staff,7,0,15,8
1683636712563,LTEN 181,A00,186150,Blanco; John D,34,0,40,6
1683636713590,LTWL 120,A00,186160,Staff,20,0,25,5
1683636714619,LTWL 165,A00,186161,Staff,22,0,25,3
1683636715648,LTWR 100,A00,186162,Staff,0,5,15,15
1683636716683,LTWR 102,A00,186163,Doller; Ben,5,0,15,10
1683636717707,MAE 8,A01,186412,Staff,0,0,0,0
1683636718733,MAE 30B,A00,186445,Bahadori; Mohammad Yousef,82,0,100,18
1683636719761,MAE 40,A00,186592,Bewley; Thomas R,10,0,50,40
1683636720786,MAE 101B,A00,186593,Bahadori; Mohammad Yousef,80,0,100,20
1683636721817,MAE 105,A00,186594,Bandaru; Prabhakar,10,0,50,40
1683636722847,MAE 107,A00,186599,Pham; Hieu Tan,0,7,120,120
1683636723873,MAE 148,A01,186660,Silberman; Jack,3,0,16,13
1683636724900,MATH 10A,A01,188095,Staff,0,5,35,35
1683636725933,MATH 10B,A01,188097,Bowers; Adam R.,0,11,30,30
1683636725933,MATH 10B,A02,188099,Bowers; Adam R.,0,11,30,30
1683636725933,MATH 10B,B01,188104,Bowers; Adam R.,0,10,30,30
1683636725933,MATH 10B,B02,188106,Bowers; Adam R.,1,9,30,29
1683636726967,MATH 10C,A01,188111,Staff,0,18,30,30
1683636726967,MATH 10C,A02,188127,Staff,0,19,30,30
1683636726967,MATH 10C,A03,188131,Staff,0,19,30,30
1683636726967,MATH 10C,B01,188218,Staff,17,0,30,13
1683636726967,MATH 10C,B02,188244,Staff,13,0,30,17
1683636726967,MATH 10C,B03,188277,Staff,14,0,30,16
1683636728000,MATH 18,A01,188344,Bach; Quang Tran,18,0,30,12
1683636728000,MATH 18,A02,188345,Bach; Quang Tran,11,0,30,19
1683636728000,MATH 18,B01,188353,Bach; Quang Tran,11,0,30,19
1683636728000,MATH 18,B02,188354,Bach; Quang Tran,19,0,30,11
1683636729023,MATH 20A,A01,188374,Staff,11,0,35,24
1683636730058,MATH 20B,A01,188382,Ohm; Ko Woon,7,0,30,23
1683636730058,MATH 20B,A02,188383,Ohm; Ko Woon,22,0,30,8
1683636730058,MATH 20B,B01,188385,Ohm; Ko Woon,7,0,30,23
1683636730058,MATH 20B,B02,188392,Ohm; Ko Woon,22,0,30,8
1683636731085,MATH 20C,A01,188394,Harel; Guershon,11,0,30,19
1683636731085,MATH 20C,A02,188395,Harel; Guershon,14,0,30,16
1683636731085,MATH 20C,B01,188404,Harel; Guershon,4,0,30,26
1683636731085,MATH 20C,B02,188405,Harel; Guershon,18,0,30,12
1683636732112,MATH 20D,A01,188414,Hammock; Frances H,0,1,30,30
1683636732112,MATH 20D,A02,188415,Hammock; Frances H,0,1,30,30
1683636732112,MATH 20D,B01,188447,Hammock; Frances H,0,1,30,30
1683636732112,MATH 20D,B02,188486,Hammock; Frances H,4,0,30,26
1683636733137,MATH 20E,A01,188649,Staff,21,0,30,9
1683636733137,MATH 20E,A02,188650,Staff,21,0,30,9
1683636733137,MATH 20E,A03,188673,Staff,0,0,30,30
1683636734162,MATH 102,A01,188675,Staff,0,36,35,35
1683636735193,MATH 103B,A01,188681,Staff,3,0,35,32
1683636735193,MATH 103B,B01,188692,Staff,5,0,35,30
1683636736219,MATH 109,A01,188695,Salehi Golsefidy; Alireza,24,0,35,11
1683636736219,MATH 109,A02,188696,Salehi Golsefidy; Alireza,25,0,35,10
1683636737252,MATH 120A,A01,188698,Eggers; John Dietrich,7,0,35,28
1683636738285,MATH 142B,A01,188736,Ioana; Adrian,0,1,30,30
1683636738285,MATH 142B,A02,188741,Ioana; Adrian,0,1,30,30
1683636738285,MATH 142B,A03,188743,Ioana; Adrian,0,1,30,30
1683636739315,MATH 168A,A01,188790,Staff,0,10,35,35
1683636740343,MATH 170A,A01,188803,Nie; Jiawang,0,2,35,35
1683636740343,MATH 170A,A02,188811,Nie; Jiawang,0,0,35,35
1683636740343,MATH 170A,A03,188814,Nie; Jiawang,0,0,35,35
1683636740343,MATH 170A,A04,188815,Nie; Jiawang,10,0,35,25
1683636741370,MATH 193B,A01,188817,Staff,0,0,35,35
1683636741370,MATH 193B,A02,188818,Staff,5,0,35,30
1683636742396,MGT 4,A01,202857,Anderson; John Charles,61,0,80,19
1683636743423,MGT 12,A00,202858,Lindenberger; Wade Douglas,40,0,90,50
1683636744452,MGT 18,A00,202859,Staff,74,0,90,16
1683636745482,MGT 18GS,A00,202860,McKay; Michael J,13,0,28,15
1683636746509,MGT 45,A00,202861,Pecore; Joseph P.,12,0,90,78
1683636747535,MGT 100,A00,202863,Yavorsky; Daniel Ryan,28,0,90,62
1683636748561,MGT 103,A00,202864,Ehrich; Kristine R,0,17,90,90
1683636749591,MGT 112,A00,202865,Ehrich; Kristine R,15,0,90,75
1683636750618,MGT 121A,A00,202868,Staff,0,20,0,0
1683636751643,MGT 131B,A00,202869,Anderson; John Charles,59,0,90,31
1683636752725,MGT 136,A00,202871,Lindenberger; Wade Douglas,83,0,90,7
1683636753751,MGT 164,A00,202873,Staff,0,66,90,91
1683636754778,MGT 164GS,A00,202874,McKay; Mary A,13,0,28,15
1683636755802,MGT 180,A00,202875,Staff,0,50,90,91
1683636756831,MMW 11R,A01,205019,Herbst; Matthew,2,0,30,28
1683636756831,MMW 11R,A02,205026,Herbst; Matthew,29,0,30,1
1683636757859,MMW 15,A01,193512,Chang; Edmond Yi-Teh,0,8,28,28
1683636757859,MMW 15,A02,193513,Chang; Edmond Yi-Teh,0,5,28,28
1683636757859,MMW 15,A03,193514,Chang; Edmond Yi-Teh,0,5,28,28
1683636757859,MMW 15,A04,193515,Chang; Edmond Yi-Teh,0,5,28,28
1683636757859,MMW 15,A05,193516,Chang; Edmond Yi-Teh,0,5,28,28
1683636757859,MMW 15,A06,193517,Chang; Edmond Yi-Teh,0,6,28,28
1683636757859,MMW 15,B01,193519,Chang; Edmond Yi-Teh,0,5,28,28
1683636757859,MMW 15,B02,193520,Chang; Edmond Yi-Teh,0,5,28,28
1683636757859,MMW 15,B03,193521,Chang; Edmond Yi-Teh,0,5,28,28
1683636757859,MMW 15,B04,193522,Chang; Edmond Yi-Teh,0,5,28,28
1683636757859,MMW 15,B05,193523,Chang; Edmond Yi-Teh,0,5,28,28
1683636757859,MMW 15,B06,193524,Chang; Edmond Yi-Teh,0,5,28,28
1683636758891,MMW 122,A01,193526,Rahimi; Babak,0,16,28,28
1683636758891,MMW 122,A02,193527,Rahimi; Babak,0,15,28,28
1683636758891,MMW 122,A03,193528,Rahimi; Babak,0,0,0,0
1683636758891,MMW 122,A04,193529,Rahimi; Babak,0,0,0,0
1683636759917,MUS 1A,A01,186663,Staff,1,20,35,34
1683636760945,MUS 4,A01,186715,Staff,0,12,35,35
1683636761976,MUS 5R,A01,186796,Dubnov; Shlomo,0,17,35,35
1683636763008,MUS 6,A01,186798,Staff,0,5,25,25
1683636764042,MUS 7,A01,186830,Staff,11,0,35,24
1683636765066,MUS 8,A01,186930,Staff,0,26,35,35
1683636766099,MUS 15,A01,186932,Staff,0,16,35,35
1683636766099,MUS 15,B01,186934,Staff,0,17,35,35
1683636767131,MUS 80,A00,186935,Staff,0,0,20,20
1683636767131,MUS 80,B00,186936,Staff,24,0,25,1
1683636779552,NANO 11,A00,204702,Lipomi; Darren John,0,0,0,0
1683636780583,NANO 15,A01,204709,Yang; Kesong,0,1,0,0
1683636781618,NANO 114,A00,202069,Jahed Motlagh; Zeinab,3,0,10,7
1683636782647,PHIL 1,A00,186955,Grush; Rick Scott,31,0,40,9
1683636783674,PHIL 10,A01,186973,Grush; Rick Scott,27,0,35,8
1683636783674,PHIL 10,A02,186974,Grush; Rick Scott,33,0,35,2
1683636784700,PHIL 13,A01,186976,Staff,3,0,35,32
1683636784700,PHIL 13,A02,186977,Staff,16,0,35,19
1683636785731,PHIL 14,A01,186979,Staff,31,0,35,4
1683636785731,PHIL 14,A02,186986,Staff,32,0,35,3
1683636786761,PHIL 28,A01,186988,Staff,16,0,30,14
1683636786761,PHIL 28,A02,186989,Staff,1,0,30,29
1683636786761,PHIL 28,A03,186990,Staff,10,0,30,20
1683636786761,PHIL 28,A04,186991,Staff,26,0,30,4
1683636787788,PHIL 120,A00,186997,Staff,23,0,40,17
1683636788816,PHIL 137,A00,187003,Staff,7,0,40,33
1683636797852,PHIL 150,A00,187015,Staff,47,0,70,23
1683636798879,PHIL 167,A00,187021,Lamey; Andy M.,34,0,40,6
1683636799910,PHIL 174,A01,202226,Staff,17,0,20,3
1683636799910,PHIL 174,A02,202235,Staff,20,0,20,0
1683636800936,PHIL 191A,A00,258918,Staff,0,0,1,1
1683636801966,PHYS 1A,A00,187028,Staff,27,0,60,33
1683636802994,PHYS 1AL,001,187036,Staff,3,0,30,27
1683636802994,PHYS 1AL,002,187049,Staff,18,0,30,12
1683636804022,PHYS 1B,A00,187058,Staff,22,0,60,38
1683636805052,PHYS 1BL,001,187064,Staff,0,1,30,30
1683636805052,PHYS 1BL,002,187070,Staff,4,0,30,26
1683636806080,PHYS 1C,A00,187082,Staff,29,0,120,91
1683636807107,PHYS 1CL,001,187088,Staff,0,9,30,30
1683636807107,PHYS 1CL,002,187089,Staff,0,1,30,30
1683636807107,PHYS 1CL,009,262693,Staff,9,0,30,21
1683636808134,PHYS 2B,A01,187097,Staff,55,0,115,60
1683636809159,PHYS 2C,A01,187099,Staff,64,0,115,51
1683636810189,PHYS 2CL,A01,187101,Staff,5,0,28,23
1683636810189,PHYS 2CL,A02,187102,Staff,15,0,28,13
1683636811218,PHYS 2D,A01,187123,Shotwell; Brian,95,0,115,20
1683636812243,PHYS 4B,A01,187133,Grinstein; Benjamin,35,0,50,15
1683636813273,POLI 10,A00,188819,Staff,0,4,50,50
1683636814298,POLI 11,A00,188827,Staff,43,0,50,7
1683636815323,POLI 13R,A00,188828,Staff,0,1,20,20
1683636816349,POLI 27,A01,188830,Elgin; Samuel Zincke,0,2,70,70
1683636817376,POLI 30,A00,188832,Desposato; Scott,30,0,50,20
1683636818401,POLI 102F,A00,188834,Staff,0,0,40,40
1683636819428,POLI 104A,A00,188852,Staff,13,0,30,17
1683636820453,POLI 104I,A00,188853,Staff,0,7,20,20
1683636821479,POLI 110B,A00,188854,Wiens; David,7,0,20,13
1683636822508,POLI 112A,A00,188855,Wiens; David,4,0,30,26
1683636823539,POLI 117R,A00,188856,Forman; Fonna,0,12,20,20
1683636824576,POLI 118,A00,188857,Ingham; Sean,8,0,20,12
1683636825601,POLI 120G,A00,188858,Staff,8,0,30,22
1683636826627,POLI 131CR,A00,188863,Hoston; Germaine,21,0,50,29
1683636827656,POLI 133,A00,188864,Nellis; Gareth Hb,44,0,50,6
1683636828687,POLI 134D,A00,188865,Desposato; Scott,27,0,30,3
1683636829714,POLI 142A,A00,188871,Gartzke; Erik,21,0,50,29
1683636830739,POLI 142K,A00,188874,Staff,38,0,50,12
1683636831765,POLI 143,A00,188940,Gartzke; Erik,16,0,30,14
1683636832791,POLI 153,A00,188943,Staff,2,0,20,18
1683636833822,POLI 160AA,A00,188944,Staff,11,0,40,29
1683636834847,POLI 170A,A00,188945,Staff,11,0,30,19
1683636836904,PSYC 1,A00,188952,Staff,36,0,90,54
1683636837932,PSYC 2,B00,188953,Staff,19,0,35,16
1683636838958,PSYC 6,A00,188970,Staff,47,0,60,13
1683636839983,PSYC 7,A00,188973,Staff,35,0,45,10
1683636841014,PSYC 60,A01,188980,Rickard; Timothy C.,42,0,60,18
1683636842045,PSYC 70,A01,189001,Steiner; Eric Tomas,23,0,45,22
1683636843070,PSYC 100,A00,189005,Lacefield; Katharine I,0,99,120,120
1683636844095,PSYC 102,A00,189008,Staff,8,0,30,22
1683636845125,PSYC 106,B00,189026,Gorman; Michael R.,27,0,60,33
1683636846151,PSYC 114,B01,189033,Winkielman; Piotr,0,31,30,30
1683636847178,PSYC 131,A00,189036,Anagnostaras; Stephan,0,43,60,60
1683636848207,PSYC 136,A00,189041,Lowe; Angela Beth,0,7,25,25
1683636849234,PSYC 137,A00,189057,Winkielman; Piotr,0,37,25,25
1683636850262,PSYC 144,A00,189107,Wixted; John T,0,10,50,50
1683636852314,PSYC 162,A00,189142,Staff,0,9,85,85
1683636853342,PSYC 172,A00,189144,Gorman; Michael R.,0,6,30,30
1683636855394,PSYC 179,A00,189146,Lacefield; Katharine I,0,86,120,120
1683636856420,PSYC 181,A00,189147,Anagnostaras; Stephan,0,44,90,90
1683636857446,PSYC 190R,A00,189148,Barner; David A.,0,23,80,80
1683636858478,PSYC 191,A00,189275,Rickard; Timothy C.,0,10,25,25
1683636859505,PSYC 193,A00,189276,Chapman; Eddie Nathaniel,0,1,0,4
1683636860533,PSYC 193L,A01,189281,Lowe; Angela Beth,10,0,20,10
1683636860533,PSYC 193L,B01,189285,Staff,28,0,35,7
1683636861564,RELI 149,A00,187137,Rahimi; Babak,7,0,40,33
1683636862593,SE 9,A01,187315,Staff,0,2,18,18
1683636863625,SE 101B,A00,187409,Staff,24,0,30,6
1683636864651,SE 110B,A00,187444,Staff,10,0,40,30
1683636865677,SE 130B,A00,187449,Staff,31,0,40,9
1683636866703,SE 150A,A00,187516,Staff,9,0,20,11
1683636867730,SE 154,A00,187528,Staff,29,0,50,21
1683636868758,SIO 3,A01,258171,Staff,35,0,40,5
1683636869787,SIO 10,A00,187144,Cook; Geoffrey W,0,6,75,75
1683636870816,SIO 45,A00,187152,Cook; Geoffrey W,0,4,100,100
1683636871842,SIO 109R,A00,194486,Staff,0,4,20,20
1683636873891,SIO 187,A01,187233,Kacev; David,12,0,40,28
1683636874924,SOCI 1,A01,258656,Thorpe; Charles Robert,28,0,30,2
1683636874924,SOCI 1,A02,258658,Thorpe; Charles Robert,30,0,30,0
1683636874924,SOCI 1,A03,258661,Thorpe; Charles Robert,25,0,25,0
1683636874924,SOCI 1,A04,258666,Thorpe; Charles Robert,22,0,25,3
1683636874924,SOCI 1,A05,258897,Thorpe; Charles Robert,22,0,25,3
1683636874924,SOCI 1,A06,258898,Thorpe; Charles Robert,25,0,25,0
1683636876006,SOCI 30,A01,258903,Pardo Guerra; Juan Pablo,14,0,30,16
1683636877031,SOCI 102,A00,258904,Staff,9,0,25,16
1683636878057,SOCI 106,A00,258905,Staff,19,0,25,6
1683636879087,SOCI 111,A00,258907,Ribas Norris; Janet Vanesa,26,0,30,4
1683636880115,SOCI 121R,A00,258908,Pardo Guerra; Juan Pablo,8,0,30,22
1683636881142,SOCI 126,A01,203330,Staff,14,0,20,6
1683636882168,SOCI 131,A00,258909,Thorpe; Charles Robert,30,0,60,30
1683636883197,SOCI 135,A00,258910,Payne; Christine Anna,0,11,30,30
1683636884227,SOCI 157,A00,258911,Staff,12,0,30,18
1683636885255,SOCI 184,A00,258912,Staff,25,0,30,5
1683636886283,SOCI 188D,A00,258913,Staff,22,0,30,8
1683636887308,SYN 2,001,187529,Staff,9,0,16,7
1683636887308,SYN 2,002,201452,Staff,0,20,16,16
1683636887308,SYN 2,003,201469,Staff,2,0,16,14
1683636888340,SYN 100,A01,187531,Staff,0,9,20,20
1683636888340,SYN 100,B01,201491,Staff,0,10,20,20
1683636889370,TDAC 1,A00,189286,Walsh; Kim C.,3,0,20,17
1683636889370,TDAC 1,B00,189287,Harting; Carla Kelso,10,0,20,10
1683636890401,TDAC 101,A00,189300,Walsh; Kim C.,16,0,20,4
1683636890401,TDAC 101,B00,189301,Harting; Carla Kelso,18,0,20,2
1683636891430,TDAC 102,A00,189304,Basso; Beatrice,14,0,20,6
1683636892457,TDAC 108,A00,189305,Staff,18,0,20,2
1683636893489,TDDE 131,A00,189310,Staff,19,0,20,1
1683636893489,TDDE 131,B00,189314,Staff,19,0,20,1
1683636893489,TDDE 131,C00,189315,Staff,48,0,50,2
1683636893489,TDDE 131,D00,189316,Staff,14,0,15,1
1683636893489,TDDE 131,E00,204841,Staff,20,0,20,0
1683636894515,TDGE 10,A00,189289,Staff,27,0,50,23
1683636894515,TDGE 10,B00,189290,Havis; Allan,0,0,50,50
1683636895543,TDGE 11,A00,189291,Fulton; Julia,0,4,50,50
1683636895543,TDGE 11,B00,189292,Staff,20,0,25,5
1683636895543,TDGE 11,C00,260270,Staff,0,0,0,0
1683636896569,TDGE 25,A00,189294,Staff,2,0,20,18
1683636897595,TDGE 124,A00,189318,Fulton; Julia,0,8,50,50
1683636898621,TDGE 125,A00,189319,Staff,13,0,25,12
1683636898621,TDGE 125,B00,189320,Staff,23,0,25,2
1683636899650,TDGE 127,A00,189322,Havis; Allan,0,0,50,50
1683636900680,TDHT 101,A00,189323,Staff,18,0,25,7
1683636900680,TDHT 101,B00,189324,Staff,25,0,25,0
1683636901714,TDHT 102,A00,189325,Staff,49,0,50,1
1683636902738,TDMV 1,A00,189295,Arcidiacono; Kristin,20,0,30,10
1683636902738,TDMV 1,B00,189296,Caligagan; Maria T.,24,0,30,6
1683636903769,TDMV 2,A00,189297,Sammartano; Tonnie,27,0,30,3
1683636903769,TDMV 2,B00,189299,Arcidiacono; Kristin,23,0,30,7
1683636904798,TDMV 3,A00,204998,Rincon; Alicia,22,0,30,8
1683636905824,TDMV 120,A00,189458,Sammartano; Tonnie,28,0,30,2
1683636906849,TDMV 138,A00,189541,Jun; Grace Shin Hae,20,0,40,20
1683636907878,TDMV 142,A00,189717,Caligagan; Tony,25,0,30,5
1683636907878,TDMV 142,B00,189718,Caligagan; Maria T.,25,0,30,5
1683636908903,TMC 2,A01,187533,Staff,25,0,25,0
1683636908903,TMC 2,A02,187534,Staff,25,0,25,0
1683636909934,USP 1,A01,187536,Kwak; Nancy,0,16,25,25
1683636910965,USP 5,A01,187538,Staff,9,0,25,16
1683636911993,USP 101,A00,199253,Staff,0,4,0,0
1683636913019,USP 124,A00,187562,Boomhower; Matthew Charles,0,0,30,30
1683636914050,USP 138,A00,187582,Staff,20,0,25,5
1683636915075,USP 152,A01,187597,Staff,3,0,25,22
1683636916105,USP 153,A00,187598,Staff,19,0,25,6
1683636917133,USP 168,A00,187607,Kwak; Nancy,2,0,5,3
1683636918163,USP 173,A00,187619,Staff,4,0,25,21
1683636919189,USP 181,A00,187638,Staff,0,4,25,25
1683636920217,VIS 103,A00,187650,Cruz; Edwin Teddy,18,0,75,57
1683636921244,VIS 110D,A00,187669,Staff,13,0,22,9
1683636922269,VIS 127C,A00,187720,Shen; Kuiyi,67,0,146,79
1683636923295,VIS 149,A00,187731,Yoldas; Pinar,0,14,22,22
1683636924321,VIS 151,A01,188091,Staff,22,0,34,12
1683636924321,VIS 151,A02,188092,Staff,11,0,34,23
1683636925347,VIS 160B,A00,188093,Stalbaum; Brett,0,1,10,10
1683636927402,WCWP 10B,A00,201720,Staff,10,0,15,5
1683636927402,WCWP 10B,B00,201722,Staff,9,0,15,6
1683636928426,WCWP 100,A00,201725,Gagnon; Jeffrey C,0,0,2,2
1683636928426,WCWP 100,B00,201727,Staff,0,4,15,15
1683636931537,ANBI 133,A00,258401,Wilder; Linnea Lorene,34,0,40,6
1683636932566,ANBI 140,A00,258395,Hrvoj Mihic; Branka,18,0,25,7
1683636933596,ANSC 120,A00,258402,Bialecki; Jon Anthony,27,0,40,13
1683636934625,ANSC 144,A00,258400,Staff,12,0,40,28
1683636936675,ANSC 166,A00,258396,Parish; Steven Martin,156,0,175,19
1683636937701,ANSC 180,A00,193533,Staff,8,0,20,12
1683636938727,ANSC 188,A00,258397,Jassal; Aftab,34,0,40,6
1683636939753,ANTH 3,A01,258316,Staff,23,0,30,7
1683636940779,ANTH 5,A00,258394,Semendeferi; Ekaterini,16,0,20,4
1683636941809,ANTH 21,A01,258331,Staff,4,0,40,36
1683636942835,ANTH 103,A00,258398,Varma; Saiba,15,0,25,10
1683636943866,AWP 10,001,202034,Staff,0,0,0,0
1683636943866,AWP 10,002,202035,Staff,0,0,0,0
1683636943866,AWP 10,003,202036,Staff,0,0,0,0
1683636943866,AWP 10,004,202037,Staff,0,0,0,0
1683636943866,AWP 10,005,202038,Staff,0,0,0,0
1683636943866,AWP 10,006,202039,Staff,0,0,0,0
1683636943866,AWP 10,007,202040,Staff,0,0,0,0
1683636943866,AWP 10,008,202041,Staff,0,0,0,0
1683636943866,AWP 10,009,202042,Staff,0,0,0,0
1683636943866,AWP 10,010,202043,Staff,0,0,0,0
1683636943866,AWP 10,011,202044,Staff,0,0,0,0
1683636943866,AWP 10,012,202045,Staff,0,0,0,0
1683636943866,AWP 10,013,202046,Staff,0,0,0,0
1683636943866,AWP 10,014,202047,Staff,0,0,0,0
1683636943866,AWP 10,015,202048,Staff,0,0,0,0
1683636943866,AWP 10,016,202049,Staff,0,0,0,0
1683636943866,AWP 10,017,202050,Staff,0,0,0,0
1683636943866,AWP 10,018,202051,Staff,0,0,0,0
1683636943866,AWP 10,019,202052,Staff,0,0,0,0
1683636943866,AWP 10,020,202053,Staff,0,0,0,0
1683636943866,AWP 10,021,202054,Staff,0,0,0,0
1683636943866,AWP 10,022,202055,Staff,0,0,0,0
1683636943866,AWP 10,023,202056,Staff,0,0,0,0
1683636943866,AWP 10,024,202057,Staff,0,0,0,0
1683636943866,AWP 10,025,202058,Staff,0,0,0,0
1683636943866,AWP 10,026,202059,Staff,0,0,0,0
1683636944892,AWP 102,001,202032,Staff,0,0,0,0
1683636944892,AWP 102,002,202033,Staff,0,0,0,0
1683636945917,BENG 100,A01,254234,Taylor Amos; Alyssa C,31,0,40,9
1683636946940,BENG 196,001,270013,Engler; Adam J.,9999,0,9999,0
1683636947967,BICD 100R,A01,202018,Smith; Laurie,0,7,32,32
1683636947967,BICD 100R,A02,202019,Smith; Laurie,0,3,32,32
1683636947967,BICD 100R,A03,202020,Smith; Laurie,0,1,32,32
1683636947967,BICD 100R,A04,202021,Smith; Laurie,6,0,32,26
1683636947967,BICD 100R,A05,202022,Smith; Laurie,11,0,32,21
1683636948995,BICD 136,A01,193242,Gustafson-Brown; Cindy,0,2,32,32
1683636948995,BICD 136,A02,193244,Gustafson-Brown; Cindy,13,0,32,19
1683636950027,BIEB 102,A01,193249,Butler; Shannon Rhey,0,2,32,32
1683636950027,BIEB 102,A02,193251,Butler; Shannon Rhey,0,0,32,32
1683636950027,BIEB 102,A03,193253,Butler; Shannon Rhey,0,0,32,32
1683636950027,BIEB 102,A04,193255,Butler; Shannon Rhey,14,0,32,18
1683636950027,BIEB 102,A05,193265,Butler; Shannon Rhey,26,0,32,6
1683636950027,BIEB 102,A06,193269,Butler; Shannon Rhey,14,0,32,18
1683636952098,BIEB 150,A01,193274,Staff,0,0,32,32
1683636952098,BIEB 150,A02,193285,Staff,24,0,32,8
1683636953123,BIEB 194,A00,193286,Kurle; Carolyn M.,20,0,32,12
1683636954151,BILD 1,A01,192291,Staff,15,0,32,17
1683636954151,BILD 1,A02,192292,Staff,30,0,32,2
1683636954151,BILD 1,B01,192520,Reuther; Keefe,0,1,0,0
1683636954151,BILD 1,B02,192532,Reuther; Keefe,0,1,0,0
1683636955178,BILD 3,A01,192556,Butler; Shannon Rhey,0,0,32,32
1683636955178,BILD 3,A02,192581,Butler; Shannon Rhey,1,0,32,31
1683636955178,BILD 3,A03,192611,Butler; Shannon Rhey,21,0,32,11
1683636955178,BILD 3,A04,192612,Butler; Shannon Rhey,24,0,32,8
1683636955178,BILD 3,A05,192613,Butler; Shannon Rhey,26,0,32,6
1683636955178,BILD 3,A06,192679,Butler; Shannon Rhey,27,0,32,5
1683636955178,BILD 3,A07,192682,Butler; Shannon Rhey,20,0,32,12
1683636956206,BILD 4,A01,192836,Reuther; Keefe,0,0,24,24
1683636956206,BILD 4,A02,193044,Reuther; Keefe,4,0,24,20
1683636957236,BILD 10,A01,193142,Gustafson-Brown; Cindy,29,0,32,3
1683636957236,BILD 10,A02,193149,Gustafson-Brown; Cindy,31,0,32,1
1683636958264,BIMM 100,A01,193301,Staff,0,6,32,32
1683636958264,BIMM 100,A02,193312,Staff,0,7,32,32
1683636958264,BIMM 100,A03,193323,Staff,0,9,32,32
1683636959297,BIMM 101,A01,193329,McDonnell; Lisa Marie,0,4,24,24
1683636959297,BIMM 101,A02,193339,McDonnell; Lisa Marie,0,3,24,24
1683636959297,BIMM 101,B01,193354,McDonnell; Lisa Marie,0,4,24,24
1683636959297,BIMM 101,B02,193357,McDonnell; Lisa Marie,0,2,24,24
1683636960328,BIMM 110,A01,193377,Tat; John,0,11,32,32
1683636960328,BIMM 110,A02,193378,Tat; John,0,10,32,32
1683636961361,BIMM 120,A01,206116,Staff,0,0,32,32
1683636961361,BIMM 120,A02,206117,Staff,6,0,32,26
1683636961361,BIMM 120,A03,206121,Staff,21,0,32,11
1683636962389,BIPN 100,A01,193393,Park; Ji Young,0,14,32,32
1683636962389,BIPN 100,A02,193402,Park; Ji Young,0,14,32,32
1683636962389,BIPN 100,A03,193413,Park; Ji Young,0,14,32,32
1683636962389,BIPN 100,A04,193414,Park; Ji Young,0,13,32,32
1683636963417,BIPN 102,A01,193429,Staff,0,0,32,32
1683636963417,BIPN 102,A02,193438,Staff,18,0,32,14
1683636964443,BIPN 106,A01,193450,Reyes Gonzalez; Catalina,0,2,40,40
1683636965469,BIPN 134,A01,193465,Cooke; James Edward,0,0,32,32
1683636965469,BIPN 134,A02,193474,Cooke; James Edward,25,0,32,7
1683636965469,BIPN 134,A03,193485,Cooke; James Edward,29,0,32,3
1683636965469,BIPN 134,A04,193486,Cooke; James Edward,20,0,32,12
1683636965469,BIPN 134,A05,193491,Cooke; James Edward,31,0,32,1
1683636965469,BIPN 134,A06,193501,Cooke; James Edward,30,0,32,2
1683636965469,BIPN 134,A07,193510,Cooke; James Edward,29,0,32,3
1683636967522,BISP 194,A00,222522,Staff,14,0,32,18
1683636968548,CAT 124,A01,202407,Staff,19,0,25,6
1683636969573,CAT 125,A00,202408,Marchisotto; Jennifer Anne,2,0,20,18
1683636970606,CAT 125R,A00,202409,Smith; Lauryn Alissa,0,11,20,20
1683636970606,CAT 125R,B00,202410,Morales; Celeste Georgianna,0,11,20,20
1683636970606,CAT 125R,C00,202411,Irwin; Matthew Joseph,0,12,20,20
1683636971641,CENG 15,A01,204712,Yang; Kesong,0,1,0,0
1683636972672,CENG 114,A00,202070,Jahed Motlagh; Zeinab,5,0,20,15
1683636973698,CGS 105,A00,185477,Wesling; Megan E.,24,0,40,16
1683636974723,CGS 106,A00,185494,Staff,11,0,22,11
1683636975751,CGS 108,A00,185495,Staff,14,0,20,6
1683636976780,CGS 114,A00,185496,Staff,13,0,18,5
1683636977808,CGS 119,A00,185501,Staff,15,0,20,5
1683636978837,CGS 120,A00,185511,Staff,12,0,20,8
1683636979925,CHEM 4,A01,184675,Bussey; Thomas J,97,0,100,3
1683636980954,CHEM 6A,A01,184677,Staff,33,0,60,27
1683636981980,CHEM 6B,A01,184679,Staff,63,0,100,37
1683636983006,CHEM 6C,A01,184681,Bussey; Thomas J,0,0,50,50
1683636983006,CHEM 6C,A02,184682,Bussey; Thomas J,32,0,50,18
1683636984034,CHEM 40A,A01,184684,Albizati; Kim F.,35,0,100,65
1683636985059,CHEM 40B,A01,184686,Albizati; Kim F.,0,22,100,100
1683636986085,CHEM 41B,A01,184690,Staff,51,0,100,49
1683636987116,COGS 3,A01,184715,Boyle; Mary E. T.,0,27,40,40
1683636988146,COGS 14B,A01,185172,Staff,0,14,38,38
1683636989174,COGS 18,A01,184736,Staff,15,0,80,65
1683636990202,COGS 100,A01,184932,Staff,0,7,73,73
1683636991227,COGS 101A,A01,184935,Staff,0,39,30,30
1683636992254,COGS 101B,A01,184944,Staff,0,2,30,30
1683636993280,COGS 101C,A01,184946,Staff,0,10,30,30
1683636994306,COGS 102A,A01,184951,Johnson; Christine M.,2,0,40,38
1683636995334,COGS 107B,A01,184953,Mooshagian; Eric Frederick,0,51,40,40
1683636996363,COGS 118B,A01,184959,Gupta; Anjum,0,49,40,40
1683636997391,COGS 153,A00,184961,Staff,0,16,30,30
1683636998416,COGS 177,A00,184962,Staff,0,21,30,30
1683636999443,COGS 187A,A01,184969,Boyle; Mary E. T.,0,19,40,40
1683637000471,COMM 10,A01,185174,Staff,0,5,25,25
1683637000471,COMM 10,A02,185189,Staff,0,2,25,25
1683637000471,COMM 10,A03,269821,Staff,0,1,0,0
1683637001500,COMM 100B,A01,185475,Staff,0,1,0,2
1683637001500,COMM 100B,A02,185476,Staff,12,0,25,13
1683637002528,COMM 100C,A01,185314,Staff,1,0,25,24
1683637002528,COMM 100C,A02,185327,Staff,18,0,25,7
1683637003555,COMM 110M,A00,185349,Staff,0,0,40,40
1683637004582,COMM 113T,A00,185352,Staff,25,0,40,15
1683637005607,COMM 114I,A00,185353,Staff,31,0,40,9
1683637006631,COMM 131,A00,185354,Staff,17,0,30,13
1683637007657,CSE 8A,A50,185358,Cao; Yingjun,0,46,10,10
1683637008685,CSE 8B,A01,185362,Staff,0,48,50,50
1683637009712,CSE 11,A01,185416,Cao; Yingjun,0,91,10,10
1683637010739,CSE 20,A01,185445,Briones; Jor-el Thomas Caparas,4,0,25,21
1683637011765,CSE 21,A01,185447,Staff,9,0,50,41
1683637012796,CSE 101,A01,185451,Staff,0,13,50,50
1683637012796,CSE 101,B01,185453,Jones; Miles E,0,13,50,50
1683637014853,CSE 141,A01,185458,Eldon; John,15,0,100,85
1683637015886,CSE 141L,A01,185461,Eldon; John,7,0,100,93
1683637016918,CSE 142,A01,185463,Staff,36,0,60,24
1683637016918,CSE 142,B01,201355,Staff,0,7,60,60
1683637017943,CSE 142L,A01,185470,Staff,36,0,60,24
1683637017943,CSE 142L,B01,201417,Staff,0,6,60,60
1683637018968,CSE 190,A00,201433,Staff,32,0,49,17
1683637019995,DOC 1,A01,259136,Strom; Megan C.,7,0,15,8
1683637019995,DOC 1,A02,259137,Strom; Megan C.,14,0,15,1
1683637019995,DOC 1,A03,259138,Strom; Megan C.,14,0,15,1
1683637019995,DOC 1,A04,259139,Strom; Megan C.,14,0,15,1
1683637021022,DOC 100D,A00,259140,Pass; Natalye Joann,14,0,25,11
1683637022055,DSGN 1,A01,184749,Rill; Bryan,0,26,30,30
1683637023083,DSGN 100,A01,185168,Staff,0,2,25,25
1683637024115,ECE 5,A01,185626,Morris; Karcher William,0,11,0,0
1683637025140,ECE 101,A01,185628,Staff,14,0,70,56
1683637026171,ECE 107,A01,185635,Baghdadchi; Saharnaz,0,0,20,20
1683637026171,ECE 107,A02,185638,Baghdadchi; Saharnaz,3,0,20,17
1683637027199,ECE 148,A01,185647,Silberman; Jack,0,0,16,16
1683637028225,ECON 1,A01,185537,Crane; Meredith Helen,54,0,70,16
1683637029256,ECON 3,A01,185549,Crane; Meredith Helen,29,0,70,41
1683637030282,ECON 4,A01,203354,Anderson; John Charles,0,5,10,10
1683637031312,ECON 100A,A01,185574,Staff,0,5,40,40
1683637032343,ECON 100B,A01,185576,Staff,0,12,50,50
1683637033370,ECON 100C,A01,185589,Newhouse; Herbert S,30,0,70,40
1683637034395,ECON 105,A00,185608,Vespa; Emanuel Ignacio,19,0,35,16
1683637035422,ECON 109,A01,185610,Shishkin; Denis,9,0,35,26
1683637036446,ECON 110A,A01,185612,Staff,9,0,40,31
1683637037472,ECON 120A,A01,185615,Staff,20,0,40,20
1683637038501,ECON 120C,A01,185617,Sun; Yixiao,0,20,70,70
1683637039530,ECON 144,A00,203346,Squires; Dale E,2,0,35,33
1683637040559,ECON 171,A01,203349,Newhouse; Herbert S,0,1,35,35
1683637041589,ECON 173A,A01,185621,Toda; Alexis Akira,21,0,35,14
1683637042622,EDS 25,A01,202413,Staff,0,1,0,0
1683637042622,EDS 25,A02,202414,Staff,0,1,0,0
1683637042622,EDS 25,A03,202415,Staff,0,0,0,0
1683637042622,EDS 25,A04,202416,Staff,0,1,0,0
1683637042622,EDS 25,A05,202439,Staff,0,0,0,0
1683637042622,EDS 25,A06,202440,Staff,0,0,0,0
1683637042622,EDS 25,B01,202631,Staff,0,0,0,0
1683637042622,EDS 25,B02,202632,Staff,0,0,0,0
1683637042622,EDS 25,B03,202639,Staff,0,0,0,0
1683637042622,EDS 25,B04,202640,Staff,0,0,0,0
1683637042622,EDS 25,B05,202643,Staff,0,0,0,0
1683637042622,EDS 25,B06,202644,Staff,0,0,0,0
1683637043648,EDS 38,A01,202659,Black; Alison Michelle,24,0,25,1
1683637044673,EDS 115,A00,202652,Staff,18,0,30,12
1683637045701,EDS 125,A00,202649,Staff,13,0,30,17
1683637046729,EDS 126,A01,203332,Staff,30,0,30,0
1683637047757,EDS 139,A00,202838,Staff,16,0,25,9
1683637048784,EDS 146,A01,202655,Staff,14,0,25,11
1683637049814,ENG 15,A00,185667,Staff,0,1,0,0
1683637049814,ENG 15,B00,185672,Staff,0,0,0,0
1683637049814,ENG 15,C00,185675,Staff,0,0,0,0
1683637049814,ENG 15,D00,185682,Staff,0,0,0,0
1683637049814,ENG 15,E00,185684,Staff,0,0,0,0
1683637050843,ETHN 103,A00,185710,Staff,0,8,35,35
1683637051869,ETHN 103A,A00,199228,Man; Simeon S,0,0,9,9
1683637052894,ETHN 109,A00,185711,Staff,16,0,35,19
1683637053919,ETHN 142,A00,185726,Staff,0,4,30,30
1683637054943,ETHN 163J,A00,199229,Man; Simeon S,5,0,8,3
1683637055970,ETHN 168,A00,185727,Staff,7,0,10,3
1683637056995,ETHN 182,A00,185728,Staff,0,0,35,35
1683637058020,ETHN 183,A00,185737,Staff,9,0,18,9
1683637059047,GLBH 111,A01,209361,Burgos; Jose L.,0,0,0,0
1683637061098,HIEU 104,A00,185792,Staff,14,0,20,6
1683637062124,HIEU 115,A00,185800,Staff,0,0,20,20
1683637063149,HIEU 128,A00,185801,Staff,0,9,20,20
1683637064173,HIEU 147,A00,185802,Staff,15,0,20,5
1683637065202,HIEU 154,A00,185823,Staff,11,0,20,9
1683637066230,HILA 102,A00,185826,Staff,14,0,20,6
1683637067261,HILD 2C,A01,185778,Staff,0,13,20,20
1683637068290,HILD 7B,A01,185780,Kwak; Nancy,0,16,32,32
1683637068290,HILD 7B,A02,185781,Kwak; Nancy,0,18,32,32
1683637069318,HILD 30,A01,185791,Staff,12,0,20,8
1683637070347,HISC 119,A00,185830,Golan; Tal,0,9,20,20
1683637071379,HITO 156GS,A00,185831,Patterson; Patrick H.,0,0,0,23
1683637072405,HIUS 103,A00,185832,Man; Simeon S,0,4,20,20
1683637073430,HIUS 117,A00,185836,Kwak; Nancy,2,0,20,18
1683637074455,HIUS 125,A00,185840,Man; Simeon S,0,1,23,23
1683637075479,HIUS 149,A00,185845,Staff,1,0,20,19
1683637076505,HUM 3,A01,185882,Zavodny; Tatiana Sophia,0,7,50,50
1683637076505,HUM 3,B01,185899,Caldwell; Michael Alan,0,18,50,50
1683637077533,HUM 3GS,A00,185900,Patterson; Patrick H.,0,0,0,23
1683637078564,HUM 4,A01,185938,Zroka; Amy Liane,30,0,50,20
1683637078564,HUM 4,B01,185956,Watkins; Eric,0,4,50,50
1683637078564,HUM 4,B02,202209,Watkins; Eric,0,4,50,50
1683637078564,HUM 4,B03,202210,Watkins; Eric,0,4,50,50
1683637079595,HUM 5,A01,185958,West; Geoffrey Scott,2,0,50,48
1683637079595,HUM 5,A02,202215,West; Geoffrey Scott,0,0,50,50
1683637080619,INTL 190,A00,185959,Gagnon; Jeffrey C,0,0,0,9
1683637080619,INTL 190,B00,185960,Lettieri; Michael Joseph,0,0,0,2
1683637081645,JAPN 180,A00,254509,Staff,5,0,30,25
1683637082671,LATI 10,A01,202853,Kennemore; Amy Michelle,4,0,35,31
1683637082671,LATI 10,A02,202854,Kennemore; Amy Michelle,2,0,35,33
1683637082671,LATI 10,A03,270054,Kennemore; Amy Michelle,30,0,30,0
1683637083754,LATI 180,A00,202855,Kennemore; Amy Michelle,11,0,20,9
1683637084783,LAWS 101,A00,201767,Golan; Tal,0,7,40,40
1683637085814,LIFR 1C,A00,185961,Staff,6,0,20,14
1683637086843,LIFR 1CX,A00,185962,Staff,7,0,20,13
1683637087869,LIFR 1D,A00,185963,Staff,7,0,20,13
1683637088895,LIFR 1DX,A00,185964,Staff,7,0,20,13
1683637089921,LIGN 101,A01,186039,Staff,43,0,50,7
1683637090971,LIGN 165,A00,186040,Staff,15,0,50,35
1683637092001,LTCS 108,A00,186041,Staff,5,0,10,5
1683637093027,LTCS 119,A00,186042,Staff,15,0,20,5
1683637094053,LTCS 130,A00,186043,Wesling; Megan E.,15,0,25,10
1683637096108,LTEA 138,A00,186119,Staff,14,0,40,26
1683637097138,LTEN 124,A00,186148,Staff,5,0,25,20
1683637098166,LTEN 178,A00,186149,Staff,7,0,15,8
1683637099191,LTEN 181,A00,186150,Blanco; John D,34,0,40,6
1683637100220,LTWL 120,A00,186160,Staff,20,0,25,5
1683637101245,LTWL 165,A00,186161,Staff,22,0,25,3
1683637102270,LTWR 100,A00,186162,Staff,0,5,15,15
1683637103299,LTWR 102,A00,186163,Doller; Ben,5,0,15,10
1683637104331,MAE 8,A01,186412,Staff,0,0,0,0
1683637105356,MAE 30B,A00,186445,Bahadori; Mohammad Yousef,82,0,100,18
1683637106387,MAE 40,A00,186592,Bewley; Thomas R,10,0,50,40
1683637107410,MAE 101B,A00,186593,Bahadori; Mohammad Yousef,80,0,100,20
1683637108437,MAE 105,A00,186594,Bandaru; Prabhakar,10,0,50,40
1683637109467,MAE 107,A00,186599,Pham; Hieu Tan,0,7,120,120
1683637110495,MAE 148,A01,186660,Silberman; Jack,3,0,16,13
1683637111522,MATH 10A,A01,188095,Staff,0,5,35,35
1683637112554,MATH 10B,A01,188097,Bowers; Adam R.,0,11,30,30
1683637112554,MATH 10B,A02,188099,Bowers; Adam R.,0,11,30,30
1683637112554,MATH 10B,B01,188104,Bowers; Adam R.,0,10,30,30
1683637112554,MATH 10B,B02,188106,Bowers; Adam R.,1,9,30,29
1683637113581,MATH 10C,A01,188111,Staff,0,18,30,30
1683637113581,MATH 10C,A02,188127,Staff,0,19,30,30
1683637113581,MATH 10C,A03,188131,Staff,0,19,30,30
1683637113581,MATH 10C,B01,188218,Staff,17,0,30,13
1683637113581,MATH 10C,B02,188244,Staff,13,0,30,17
1683637113581,MATH 10C,B03,188277,Staff,14,0,30,16
1683637114607,MATH 18,A01,188344,Bach; Quang Tran,18,0,30,12
1683637114607,MATH 18,A02,188345,Bach; Quang Tran,11,0,30,19
1683637114607,MATH 18,B01,188353,Bach; Quang Tran,11,0,30,19
1683637114607,MATH 18,B02,188354,Bach; Quang Tran,19,0,30,11
1683637115633,MATH 20A,A01,188374,Staff,11,0,35,24
1683637116660,MATH 20B,A01,188382,Ohm; Ko Woon,7,0,30,23
1683637116660,MATH 20B,A02,188383,Ohm; Ko Woon,22,0,30,8
1683637116660,MATH 20B,B01,188385,Ohm; Ko Woon,7,0,30,23
1683637116660,MATH 20B,B02,188392,Ohm; Ko Woon,22,0,30,8
1683637117693,MATH 20C,A01,188394,Harel; Guershon,11,0,30,19
1683637117693,MATH 20C,A02,188395,Harel; Guershon,14,0,30,16
1683637117693,MATH 20C,B01,188404,Harel; Guershon,4,0,30,26
1683637117693,MATH 20C,B02,188405,Harel; Guershon,18,0,30,12
1683637118721,MATH 20D,A01,188414,Hammock; Frances H,0,1,30,30
1683637118721,MATH 20D,A02,188415,Hammock; Frances H,0,1,30,30
1683637118721,MATH 20D,B01,188447,Hammock; Frances H,0,1,30,30
1683637118721,MATH 20D,B02,188486,Hammock; Frances H,4,0,30,26
1683637119748,MATH 20E,A01,188649,Staff,21,0,30,9
1683637119748,MATH 20E,A02,188650,Staff,21,0,30,9
1683637119748,MATH 20E,A03,188673,Staff,0,0,30,30
1683637120772,MATH 102,A01,188675,Staff,0,36,35,35
1683637121805,MATH 103B,A01,188681,Staff,3,0,35,32
1683637121805,MATH 103B,B01,188692,Staff,5,0,35,30
1683637122830,MATH 109,A01,188695,Salehi Golsefidy; Alireza,24,0,35,11
1683637122830,MATH 109,A02,188696,Salehi Golsefidy; Alireza,25,0,35,10
1683637123857,MATH 120A,A01,188698,Eggers; John Dietrich,7,0,35,28
1683637124882,MATH 142B,A01,188736,Ioana; Adrian,0,1,30,30
1683637124882,MATH 142B,A02,188741,Ioana; Adrian,0,1,30,30
1683637124882,MATH 142B,A03,188743,Ioana; Adrian,0,1,30,30
1683637125906,MATH 168A,A01,188790,Staff,0,10,35,35
1683637126933,MATH 170A,A01,188803,Nie; Jiawang,0,2,35,35
1683637126933,MATH 170A,A02,188811,Nie; Jiawang,0,0,35,35
1683637126933,MATH 170A,A03,188814,Nie; Jiawang,0,0,35,35
1683637126933,MATH 170A,A04,188815,Nie; Jiawang,10,0,35,25
1683637127961,MATH 193B,A01,188817,Staff,0,0,35,35
1683637127961,MATH 193B,A02,188818,Staff,5,0,35,30
1683637128986,MGT 4,A01,202857,Anderson; John Charles,61,0,80,19
1683637130016,MGT 12,A00,202858,Lindenberger; Wade Douglas,40,0,90,50
1683637131043,MGT 18,A00,202859,Staff,74,0,90,16
1683637132076,MGT 18GS,A00,202860,McKay; Michael J,13,0,28,15
1683637133102,MGT 45,A00,202861,Pecore; Joseph P.,12,0,90,78
1683637134132,MGT 100,A00,202863,Yavorsky; Daniel Ryan,28,0,90,62
1683637135157,MGT 103,A00,202864,Ehrich; Kristine R,0,17,90,90
1683637136185,MGT 112,A00,202865,Ehrich; Kristine R,15,0,90,75
1683637137216,MGT 121A,A00,202868,Staff,0,20,0,0
1683637138243,MGT 131B,A00,202869,Anderson; John Charles,59,0,90,31
1683637139271,MGT 136,A00,202871,Lindenberger; Wade Douglas,83,0,90,7
1683637140300,MGT 164,A00,202873,Staff,0,66,90,91
1683637141326,MGT 164GS,A00,202874,McKay; Mary A,13,0,28,15
1683637142351,MGT 180,A00,202875,Staff,0,50,90,91
1683637143375,MMW 11R,A01,205019,Herbst; Matthew,2,0,30,28
1683637143375,MMW 11R,A02,205026,Herbst; Matthew,29,0,30,1
1683637144401,MMW 15,A01,193512,Chang; Edmond Yi-Teh,0,8,28,28
1683637144401,MMW 15,A02,193513,Chang; Edmond Yi-Teh,0,5,28,28
1683637144401,MMW 15,A03,193514,Chang; Edmond Yi-Teh,0,5,28,28
1683637144401,MMW 15,A04,193515,Chang; Edmond Yi-Teh,0,5,28,28
1683637144401,MMW 15,A05,193516,Chang; Edmond Yi-Teh,0,5,28,28
1683637144401,MMW 15,A06,193517,Chang; Edmond Yi-Teh,0,6,28,28
1683637144401,MMW 15,B01,193519,Chang; Edmond Yi-Teh,0,5,28,28
1683637144401,MMW 15,B02,193520,Chang; Edmond Yi-Teh,0,5,28,28
1683637144401,MMW 15,B03,193521,Chang; Edmond Yi-Teh,0,5,28,28
1683637144401,MMW 15,B04,193522,Chang; Edmond Yi-Teh,0,5,28,28
1683637144401,MMW 15,B05,193523,Chang; Edmond Yi-Teh,0,5,28,28
1683637144401,MMW 15,B06,193524,Chang; Edmond Yi-Teh,0,5,28,28
1683637145433,MMW 122,A01,193526,Rahimi; Babak,0,16,28,28
1683637145433,MMW 122,A02,193527,Rahimi; Babak,0,15,28,28
1683637145433,MMW 122,A03,193528,Rahimi; Babak,0,0,0,0
1683637145433,MMW 122,A04,193529,Rahimi; Babak,0,0,0,0
1683637146461,MUS 1A,A01,186663,Staff,1,20,35,34
1683637147485,MUS 4,A01,186715,Staff,0,12,35,35
1683637148511,MUS 5R,A01,186796,Dubnov; Shlomo,0,17,35,35
1683637149538,MUS 6,A01,186798,Staff,0,5,25,25
1683637150562,MUS 7,A01,186830,Staff,11,0,35,24
1683637151588,MUS 8,A01,186930,Staff,0,26,35,35
1683637152613,MUS 15,A01,186932,Staff,0,16,35,35
1683637152613,MUS 15,B01,186934,Staff,0,17,35,35
1683637153643,MUS 80,A00,186935,Staff,0,0,20,20
1683637153643,MUS 80,B00,186936,Staff,24,0,25,1
1683637154668,NANO 11,A00,204702,Lipomi; Darren John,0,0,0,0
1683637155693,NANO 15,A01,204709,Yang; Kesong,0,1,0,0
1683637156718,NANO 114,A00,202069,Jahed Motlagh; Zeinab,3,0,10,7
1683637157745,PHIL 1,A00,186955,Grush; Rick Scott,31,0,40,9
1683637158771,PHIL 10,A01,186973,Grush; Rick Scott,27,0,35,8
1683637158771,PHIL 10,A02,186974,Grush; Rick Scott,33,0,35,2
1683637159801,PHIL 13,A01,186976,Staff,3,0,35,32
1683637159801,PHIL 13,A02,186977,Staff,16,0,35,19
1683637160830,PHIL 14,A01,186979,Staff,31,0,35,4
1683637160830,PHIL 14,A02,186986,Staff,32,0,35,3
1683637161858,PHIL 28,A01,186988,Staff,16,0,30,14
1683637161858,PHIL 28,A02,186989,Staff,1,0,30,29
1683637161858,PHIL 28,A03,186990,Staff,10,0,30,20
1683637161858,PHIL 28,A04,186991,Staff,26,0,30,4
1683637162887,PHIL 120,A00,186997,Staff,23,0,40,17
1683637163912,PHIL 137,A00,187003,Staff,7,0,40,33
1683637164937,PHIL 150,A00,187015,Staff,47,0,70,23
1683637165963,PHIL 167,A00,187021,Lamey; Andy M.,34,0,40,6
1683637166986,PHIL 174,A01,202226,Staff,17,0,20,3
1683637166986,PHIL 174,A02,202235,Staff,20,0,20,0
1683637168012,PHIL 191A,A00,258918,Staff,0,0,1,1
1683637169039,PHYS 1A,A00,187028,Staff,27,0,60,33
1683637170068,PHYS 1AL,001,187036,Staff,3,0,30,27
1683637170068,PHYS 1AL,002,187049,Staff,18,0,30,12
1683637171094,PHYS 1B,A00,187058,Staff,22,0,60,38
1683637172119,PHYS 1BL,001,187064,Staff,0,1,30,30
1683637172119,PHYS 1BL,002,187070,Staff,4,0,30,26
1683637173149,PHYS 1C,A00,187082,Staff,29,0,120,91
1683637174175,PHYS 1CL,001,187088,Staff,0,9,30,30
1683637174175,PHYS 1CL,002,187089,Staff,0,1,30,30
1683637174175,PHYS 1CL,009,262693,Staff,9,0,30,21
1683637175200,PHYS 2B,A01,187097,Staff,55,0,115,60
1683637176226,PHYS 2C,A01,187099,Staff,64,0,115,51
1683637177254,PHYS 2CL,A01,187101,Staff,5,0,28,23
1683637177254,PHYS 2CL,A02,187102,Staff,15,0,28,13
1683637178283,PHYS 2D,A01,187123,Shotwell; Brian,95,0,115,20
1683637179312,PHYS 4B,A01,187133,Grinstein; Benjamin,35,0,50,15
1683637180336,POLI 10,A00,188819,Staff,0,4,50,50
1683637181361,POLI 11,A00,188827,Staff,43,0,50,7
1683637182387,POLI 13R,A00,188828,Staff,0,1,20,20
1683637183412,POLI 27,A01,188830,Elgin; Samuel Zincke,0,2,70,70
1683637184437,POLI 30,A00,188832,Desposato; Scott,30,0,50,20
1683637185464,POLI 102F,A00,188834,Staff,0,0,40,40
1683637186495,POLI 104A,A00,188852,Staff,13,0,30,17
1683637187574,POLI 104I,A00,188853,Staff,0,7,20,20
1683637188604,POLI 110B,A00,188854,Wiens; David,7,0,20,13
1683637189632,POLI 112A,A00,188855,Wiens; David,4,0,30,26
1683637190660,POLI 117R,A00,188856,Forman; Fonna,0,12,20,20
1683637191688,POLI 118,A00,188857,Ingham; Sean,8,0,20,12
1683637192713,POLI 120G,A00,188858,Staff,8,0,30,22
1683637193738,POLI 131CR,A00,188863,Hoston; Germaine,21,0,50,29
1683637194764,POLI 133,A00,188864,Nellis; Gareth Hb,44,0,50,6
1683637195789,POLI 134D,A00,188865,Desposato; Scott,27,0,30,3
1683637196815,POLI 142A,A00,188871,Gartzke; Erik,21,0,50,29
1683637197842,POLI 142K,A00,188874,Staff,38,0,50,12
1683637198870,POLI 143,A00,188940,Gartzke; Erik,16,0,30,14
1683637199896,POLI 153,A00,188943,Staff,2,0,20,18
1683637200924,POLI 160AA,A00,188944,Staff,11,0,40,29
1683637201965,POLI 170A,A00,188945,Staff,11,0,30,19
1683637204021,PSYC 1,A00,188952,Staff,36,0,90,54
1683637205049,PSYC 2,B00,188953,Staff,19,0,35,16
1683637206074,PSYC 6,A00,188970,Staff,47,0,60,13
1683637207101,PSYC 7,A00,188973,Staff,35,0,45,10
1683637208126,PSYC 60,A01,188980,Rickard; Timothy C.,42,0,60,18
1683637209155,PSYC 70,A01,189001,Steiner; Eric Tomas,23,0,45,22
1683637210184,PSYC 100,A00,189005,Lacefield; Katharine I,0,99,120,120
1683637211213,PSYC 102,A00,189008,Staff,8,0,30,22
1683637212237,PSYC 106,B00,189026,Gorman; Michael R.,27,0,60,33
1683637213261,PSYC 114,B01,189033,Winkielman; Piotr,0,31,30,30
1683637214291,PSYC 131,A00,189036,Anagnostaras; Stephan,0,43,60,60
1683637215320,PSYC 136,A00,189041,Lowe; Angela Beth,0,7,25,25
1683637216348,PSYC 137,A00,189057,Winkielman; Piotr,0,37,25,25
1683637217374,PSYC 144,A00,189107,Wixted; John T,0,10,50,50
1683637219433,PSYC 162,A00,189142,Staff,0,9,85,85
1683637220460,PSYC 172,A00,189144,Gorman; Michael R.,0,6,30,30
1683637222511,PSYC 179,A00,189146,Lacefield; Katharine I,0,86,120,120
1683637223540,PSYC 181,A00,189147,Anagnostaras; Stephan,0,44,90,90
1683637224565,PSYC 190R,A00,189148,Barner; David A.,0,23,80,80
1683637225591,PSYC 191,A00,189275,Rickard; Timothy C.,0,10,25,25
1683637226619,PSYC 193,A00,189276,Chapman; Eddie Nathaniel,0,1,0,4
1683637227647,PSYC 193L,A01,189281,Lowe; Angela Beth,10,0,20,10
1683637227647,PSYC 193L,B01,189285,Staff,28,0,35,7
1683637228673,RELI 149,A00,187137,Rahimi; Babak,7,0,40,33
1683637229704,SE 9,A01,187315,Staff,0,2,18,18
1683637230733,SE 101B,A00,187409,Staff,24,0,30,6
1683637231762,SE 110B,A00,187444,Staff,10,0,40,30
1683637232793,SE 130B,A00,187449,Staff,31,0,40,9
1683637233818,SE 150A,A00,187516,Staff,9,0,20,11
1683637234844,SE 154,A00,187528,Staff,29,0,50,21
1683637235871,SIO 3,A01,258171,Staff,35,0,40,5
1683637236902,SIO 10,A00,187144,Cook; Geoffrey W,0,6,75,75
1683637237925,SIO 45,A00,187152,Cook; Geoffrey W,0,4,100,100
1683637238949,SIO 109R,A00,194486,Staff,0,4,20,20
1683637241005,SIO 187,A01,187233,Kacev; David,12,0,40,28
1683637242030,SOCI 1,A01,258656,Thorpe; Charles Robert,28,0,30,2
1683637242030,SOCI 1,A02,258658,Thorpe; Charles Robert,30,0,30,0
1683637242030,SOCI 1,A03,258661,Thorpe; Charles Robert,25,0,25,0
1683637242030,SOCI 1,A04,258666,Thorpe; Charles Robert,22,0,25,3
1683637242030,SOCI 1,A05,258897,Thorpe; Charles Robert,22,0,25,3
1683637242030,SOCI 1,A06,258898,Thorpe; Charles Robert,25,0,25,0
1683637243059,SOCI 30,A01,258903,Pardo Guerra; Juan Pablo,14,0,30,16
1683637244084,SOCI 102,A00,258904,Staff,9,0,25,16
1683637245109,SOCI 106,A00,258905,Staff,19,0,25,6
1683637246134,SOCI 111,A00,258907,Ribas Norris; Janet Vanesa,26,0,30,4
1683637247159,SOCI 121R,A00,258908,Pardo Guerra; Juan Pablo,8,0,30,22
1683637248188,SOCI 126,A01,203330,Staff,14,0,20,6
1683637249217,SOCI 131,A00,258909,Thorpe; Charles Robert,30,0,60,30
1683637250246,SOCI 135,A00,258910,Payne; Christine Anna,0,11,30,30
1683637251272,SOCI 157,A00,258911,Staff,12,0,30,18
1683637252298,SOCI 184,A00,258912,Staff,25,0,30,5
1683637253325,SOCI 188D,A00,258913,Staff,22,0,30,8
1683637254355,SYN 2,001,187529,Staff,9,0,16,7
1683637254355,SYN 2,002,201452,Staff,0,20,16,16
1683637254355,SYN 2,003,201469,Staff,2,0,16,14
1683637255382,SYN 100,A01,187531,Staff,0,9,20,20
1683637255382,SYN 100,B01,201491,Staff,0,10,20,20
1683637256407,TDAC 1,A00,189286,Walsh; Kim C.,3,0,20,17
1683637256407,TDAC 1,B00,189287,Harting; Carla Kelso,10,0,20,10
1683637257432,TDAC 101,A00,189300,Walsh; Kim C.,16,0,20,4
1683637257432,TDAC 101,B00,189301,Harting; Carla Kelso,18,0,20,2
1683637258459,TDAC 102,A00,189304,Basso; Beatrice,14,0,20,6
1683637259486,TDAC 108,A00,189305,Staff,18,0,20,2
1683637260513,TDDE 131,A00,189310,Staff,19,0,20,1
1683637260513,TDDE 131,B00,189314,Staff,19,0,20,1
1683637260513,TDDE 131,C00,189315,Staff,48,0,50,2
1683637260513,TDDE 131,D00,189316,Staff,14,0,15,1
1683637260513,TDDE 131,E00,204841,Staff,20,0,20,0
1683637261540,TDGE 10,A00,189289,Staff,27,0,50,23
1683637261540,TDGE 10,B00,189290,Havis; Allan,0,0,50,50
1683637262566,TDGE 11,A00,189291,Fulton; Julia,0,4,50,50
1683637262566,TDGE 11,B00,189292,Staff,20,0,25,5
1683637262566,TDGE 11,C00,260270,Staff,0,0,0,0
1683637263598,TDGE 25,A00,189294,Staff,2,0,20,18
1683637264627,TDGE 124,A00,189318,Fulton; Julia,0,8,50,50
1683637265656,TDGE 125,A00,189319,Staff,13,0,25,12
1683637265656,TDGE 125,B00,189320,Staff,23,0,25,2
1683637266683,TDGE 127,A00,189322,Havis; Allan,0,0,50,50
1683637267712,TDHT 101,A00,189323,Staff,18,0,25,7
1683637267712,TDHT 101,B00,189324,Staff,25,0,25,0
1683637268739,TDHT 102,A00,189325,Staff,49,0,50,1
1683637269769,TDMV 1,A00,189295,Arcidiacono; Kristin,20,0,30,10
1683637269769,TDMV 1,B00,189296,Caligagan; Maria T.,24,0,30,6
1683637270796,TDMV 2,A00,189297,Sammartano; Tonnie,27,0,30,3
1683637270796,TDMV 2,B00,189299,Arcidiacono; Kristin,23,0,30,7
1683637271821,TDMV 3,A00,204998,Rincon; Alicia,22,0,30,8
1683637272851,TDMV 120,A00,189458,Sammartano; Tonnie,28,0,30,2
1683637273884,TDMV 138,A00,189541,Jun; Grace Shin Hae,20,0,40,20
1683637274913,TDMV 142,A00,189717,Caligagan; Tony,25,0,30,5
1683637274913,TDMV 142,B00,189718,Caligagan; Maria T.,25,0,30,5
1683637275940,TMC 2,A01,187533,Staff,25,0,25,0
1683637275940,TMC 2,A02,187534,Staff,25,0,25,0
1683637276965,USP 1,A01,187536,Kwak; Nancy,0,16,25,25
1683637277991,USP 5,A01,187538,Staff,9,0,25,16
1683637279017,USP 101,A00,199253,Staff,0,4,0,0
1683637280044,USP 124,A00,187562,Boomhower; Matthew Charles,0,0,30,30
1683637281069,USP 138,A00,187582,Staff,20,0,25,5
1683637282098,USP 152,A01,187597,Staff,3,0,25,22
1683637283122,USP 153,A00,187598,Staff,19,0,25,6
1683637284150,USP 168,A00,187607,Kwak; Nancy,2,0,5,3
1683637285179,USP 173,A00,187619,Staff,4,0,25,21
1683637286207,USP 181,A00,187638,Staff,0,4,25,25
1683637287232,VIS 103,A00,187650,Cruz; Edwin Teddy,18,0,75,57
1683637288259,VIS 110D,A00,187669,Staff,13,0,22,9
1683637289288,VIS 127C,A00,187720,Shen; Kuiyi,67,0,146,79
1683637290318,VIS 149,A00,187731,Yoldas; Pinar,0,14,22,22
1683637291405,VIS 151,A01,188091,Staff,22,0,34,12
1683637291405,VIS 151,A02,188092,Staff,11,0,34,23
1683637292433,VIS 160B,A00,188093,Stalbaum; Brett,0,1,10,10
1683637294485,WCWP 10B,A00,201720,Staff,10,0,15,5
1683637294485,WCWP 10B,B00,201722,Staff,9,0,15,6
1683637295509,WCWP 100,A00,201725,Gagnon; Jeffrey C,0,0,2,2
1683637295509,WCWP 100,B00,201727,Staff,0,4,15,15
1683637298649,ANBI 133,A00,258401,Wilder; Linnea Lorene,34,0,40,6
1683637299679,ANBI 140,A00,258395,Hrvoj Mihic; Branka,18,0,25,7
1683637300705,ANSC 120,A00,258402,Bialecki; Jon Anthony,27,0,40,13
1683637301729,ANSC 144,A00,258400,Staff,12,0,40,28
1683637303786,ANSC 166,A00,258396,Parish; Steven Martin,156,0,175,19
1683637304816,ANSC 180,A00,193533,Staff,8,0,20,12
1683637305841,ANSC 188,A00,258397,Jassal; Aftab,34,0,40,6
1683637306863,ANTH 3,A01,258316,Staff,23,0,30,7
1683637307893,ANTH 5,A00,258394,Semendeferi; Ekaterini,16,0,20,4
1683637308919,ANTH 21,A01,258331,Staff,4,0,40,36
1683637309948,ANTH 103,A00,258398,Varma; Saiba,15,0,25,10
1683637310985,AWP 10,001,202034,Staff,0,0,0,0
1683637310985,AWP 10,002,202035,Staff,0,0,0,0
1683637310985,AWP 10,003,202036,Staff,0,0,0,0
1683637310985,AWP 10,004,202037,Staff,0,0,0,0
1683637310985,AWP 10,005,202038,Staff,0,0,0,0
1683637310985,AWP 10,006,202039,Staff,0,0,0,0
1683637310985,AWP 10,007,202040,Staff,0,0,0,0
1683637310985,AWP 10,008,202041,Staff,0,0,0,0
1683637310985,AWP 10,009,202042,Staff,0,0,0,0
1683637310985,AWP 10,010,202043,Staff,0,0,0,0
1683637310985,AWP 10,011,202044,Staff,0,0,0,0
1683637310985,AWP 10,012,202045,Staff,0,0,0,0
1683637310985,AWP 10,013,202046,Staff,0,0,0,0
1683637310985,AWP 10,014,202047,Staff,0,0,0,0
1683637310985,AWP 10,015,202048,Staff,0,0,0,0
1683637310985,AWP 10,016,202049,Staff,0,0,0,0
1683637310985,AWP 10,017,202050,Staff,0,0,0,0
1683637310985,AWP 10,018,202051,Staff,0,0,0,0
1683637310985,AWP 10,019,202052,Staff,0,0,0,0
1683637310985,AWP 10,020,202053,Staff,0,0,0,0
1683637310985,AWP 10,021,202054,Staff,0,0,0,0
1683637310985,AWP 10,022,202055,Staff,0,0,0,0
1683637310985,AWP 10,023,202056,Staff,0,0,0,0
1683637310985,AWP 10,024,202057,Staff,0,0,0,0
1683637310985,AWP 10,025,202058,Staff,0,0,0,0
1683637310985,AWP 10,026,202059,Staff,0,0,0,0
1683637312014,AWP 102,001,202032,Staff,0,0,0,0
1683637312014,AWP 102,002,202033,Staff,0,0,0,0
1683637313041,BENG 100,A01,254234,Taylor Amos; Alyssa C,31,0,40,9
1683637314066,BENG 196,001,270013,Engler; Adam J.,9999,0,9999,0
1683637315099,BICD 100R,A01,202018,Smith; Laurie,0,7,32,32
1683637315099,BICD 100R,A02,202019,Smith; Laurie,0,3,32,32
1683637315099,BICD 100R,A03,202020,Smith; Laurie,0,1,32,32
1683637315099,BICD 100R,A04,202021,Smith; Laurie,6,0,32,26
1683637315099,BICD 100R,A05,202022,Smith; Laurie,11,0,32,21
1683637316126,BICD 136,A01,193242,Gustafson-Brown; Cindy,0,2,32,32
1683637316126,BICD 136,A02,193244,Gustafson-Brown; Cindy,13,0,32,19
1683637317154,BIEB 102,A01,193249,Butler; Shannon Rhey,0,2,32,32
1683637317154,BIEB 102,A02,193251,Butler; Shannon Rhey,0,0,32,32
1683637317154,BIEB 102,A03,193253,Butler; Shannon Rhey,0,0,32,32
1683637317154,BIEB 102,A04,193255,Butler; Shannon Rhey,14,0,32,18
1683637317154,BIEB 102,A05,193265,Butler; Shannon Rhey,26,0,32,6
1683637317154,BIEB 102,A06,193269,Butler; Shannon Rhey,14,0,32,18
1683637319213,BIEB 150,A01,193274,Staff,0,0,32,32
1683637319213,BIEB 150,A02,193285,Staff,24,0,32,8
1683637320244,BIEB 194,A00,193286,Kurle; Carolyn M.,20,0,32,12
1683637321282,BILD 1,A01,192291,Staff,15,0,32,17
1683637321282,BILD 1,A02,192292,Staff,30,0,32,2
1683637321282,BILD 1,B01,192520,Reuther; Keefe,0,1,0,0
1683637321282,BILD 1,B02,192532,Reuther; Keefe,0,1,0,0
1683637322306,BILD 3,A01,192556,Butler; Shannon Rhey,0,0,32,32
1683637322306,BILD 3,A02,192581,Butler; Shannon Rhey,1,0,32,31
1683637322306,BILD 3,A03,192611,Butler; Shannon Rhey,21,0,32,11
1683637322306,BILD 3,A04,192612,Butler; Shannon Rhey,24,0,32,8
1683637322306,BILD 3,A05,192613,Butler; Shannon Rhey,26,0,32,6
1683637322306,BILD 3,A06,192679,Butler; Shannon Rhey,27,0,32,5
1683637322306,BILD 3,A07,192682,Butler; Shannon Rhey,20,0,32,12
1683637323335,BILD 4,A01,192836,Reuther; Keefe,0,0,24,24
1683637323335,BILD 4,A02,193044,Reuther; Keefe,4,0,24,20
1683637324366,BILD 10,A01,193142,Gustafson-Brown; Cindy,29,0,32,3
1683637324366,BILD 10,A02,193149,Gustafson-Brown; Cindy,31,0,32,1
1683637325395,BIMM 100,A01,193301,Staff,0,6,32,32
1683637325395,BIMM 100,A02,193312,Staff,0,7,32,32
1683637325395,BIMM 100,A03,193323,Staff,0,9,32,32
1683637326425,BIMM 101,A01,193329,McDonnell; Lisa Marie,0,4,24,24
1683637326425,BIMM 101,A02,193339,McDonnell; Lisa Marie,0,3,24,24
1683637326425,BIMM 101,B01,193354,McDonnell; Lisa Marie,0,4,24,24
1683637326425,BIMM 101,B02,193357,McDonnell; Lisa Marie,0,2,24,24
1683637327456,BIMM 110,A01,193377,Tat; John,0,11,32,32
1683637327456,BIMM 110,A02,193378,Tat; John,0,10,32,32
1683637328483,BIMM 120,A01,206116,Staff,0,0,32,32
1683637328483,BIMM 120,A02,206117,Staff,6,0,32,26
1683637328483,BIMM 120,A03,206121,Staff,21,0,32,11
1683637329515,BIPN 100,A01,193393,Park; Ji Young,0,14,32,32
1683637329515,BIPN 100,A02,193402,Park; Ji Young,0,14,32,32
1683637329515,BIPN 100,A03,193413,Park; Ji Young,0,14,32,32
1683637329515,BIPN 100,A04,193414,Park; Ji Young,0,13,32,32
1683637330545,BIPN 102,A01,193429,Staff,0,0,32,32
1683637330545,BIPN 102,A02,193438,Staff,18,0,32,14
1683637331570,BIPN 106,A01,193450,Reyes Gonzalez; Catalina,0,2,40,40
1683637332597,BIPN 134,A01,193465,Cooke; James Edward,0,0,32,32
1683637332597,BIPN 134,A02,193474,Cooke; James Edward,25,0,32,7
1683637332597,BIPN 134,A03,193485,Cooke; James Edward,29,0,32,3
1683637332597,BIPN 134,A04,193486,Cooke; James Edward,20,0,32,12
1683637332597,BIPN 134,A05,193491,Cooke; James Edward,31,0,32,1
1683637332597,BIPN 134,A06,193501,Cooke; James Edward,30,0,32,2
1683637332597,BIPN 134,A07,193510,Cooke; James Edward,29,0,32,3
1683637334649,BISP 194,A00,222522,Staff,14,0,32,18
1683637335676,CAT 124,A01,202407,Staff,19,0,25,6
1683637336701,CAT 125,A00,202408,Marchisotto; Jennifer Anne,2,0,20,18
1683637337728,CAT 125R,A00,202409,Smith; Lauryn Alissa,0,11,20,20
1683637337728,CAT 125R,B00,202410,Morales; Celeste Georgianna,0,11,20,20
1683637337728,CAT 125R,C00,202411,Irwin; Matthew Joseph,0,12,20,20
1683637338755,CENG 15,A01,204712,Yang; Kesong,0,1,0,0
1683637339784,CENG 114,A00,202070,Jahed Motlagh; Zeinab,5,0,20,15
1683637340814,CGS 105,A00,185477,Wesling; Megan E.,24,0,40,16
1683637341838,CGS 106,A00,185494,Staff,11,0,22,11
1683637342863,CGS 108,A00,185495,Staff,14,0,20,6
1683637343888,CGS 114,A00,185496,Staff,13,0,18,5
1683637344913,CGS 119,A00,185501,Staff,15,0,20,5
1683637345943,CGS 120,A00,185511,Staff,12,0,20,8
1683637346973,CHEM 4,A01,184675,Bussey; Thomas J,97,0,100,3
1683637348004,CHEM 6A,A01,184677,Staff,33,0,60,27
1683637349031,CHEM 6B,A01,184679,Staff,63,0,100,37
1683637350059,CHEM 6C,A01,184681,Bussey; Thomas J,0,0,50,50
1683637350059,CHEM 6C,A02,184682,Bussey; Thomas J,32,0,50,18
1683637351087,CHEM 40A,A01,184684,Albizati; Kim F.,35,0,100,65
1683637352117,CHEM 40B,A01,184686,Albizati; Kim F.,0,22,100,100
1683637353143,CHEM 41B,A01,184690,Staff,51,0,100,49
1683637354168,COGS 3,A01,184715,Boyle; Mary E. T.,0,27,40,40
1683637355194,COGS 14B,A01,185172,Staff,0,14,38,38
1683637356225,COGS 18,A01,184736,Staff,15,0,80,65
1683637357261,COGS 100,A01,184932,Staff,0,7,73,73
1683637358289,COGS 101A,A01,184935,Staff,0,39,30,30
1683637359316,COGS 101B,A01,184944,Staff,0,2,30,30
1683637360345,COGS 101C,A01,184946,Staff,0,10,30,30
1683637361377,COGS 102A,A01,184951,Johnson; Christine M.,2,0,40,38
1683637362401,COGS 107B,A01,184953,Mooshagian; Eric Frederick,0,51,40,40
1683637363428,COGS 118B,A01,184959,Gupta; Anjum,0,49,40,40
1683637364454,COGS 153,A00,184961,Staff,0,16,30,30
1683637365480,COGS 177,A00,184962,Staff,0,21,30,30
1683637366506,COGS 187A,A01,184969,Boyle; Mary E. T.,0,19,40,40
1683637367533,COMM 10,A01,185174,Staff,0,5,25,25
1683637367533,COMM 10,A02,185189,Staff,0,2,25,25
1683637367533,COMM 10,A03,269821,Staff,0,1,0,0
1683637368559,COMM 100B,A01,185475,Staff,0,1,0,2
1683637368559,COMM 100B,A02,185476,Staff,12,0,25,13
1683637369585,COMM 100C,A01,185314,Staff,1,0,25,24
1683637369585,COMM 100C,A02,185327,Staff,18,0,25,7
1683637370614,COMM 110M,A00,185349,Staff,0,0,40,40
1683637371643,COMM 113T,A00,185352,Staff,25,0,40,15
1683637372672,COMM 114I,A00,185353,Staff,31,0,40,9
1683637373700,COMM 131,A00,185354,Staff,17,0,30,13
1683637374726,CSE 8A,A50,185358,Cao; Yingjun,0,46,10,10
1683637375752,CSE 8B,A01,185362,Staff,0,48,50,50
1683637376861,CSE 11,A01,185416,Cao; Yingjun,0,91,10,10
1683637377887,CSE 20,A01,185445,Briones; Jor-el Thomas Caparas,4,0,25,21
1683637378915,CSE 21,A01,185447,Staff,9,0,50,41
1683637379947,CSE 101,A01,185451,Staff,0,13,50,50
1683637379947,CSE 101,B01,185453,Jones; Miles E,0,13,50,50
1683637382006,CSE 141,A01,185458,Eldon; John,15,0,100,85
1683637383035,CSE 141L,A01,185461,Eldon; John,7,0,100,93
1683637384060,CSE 142,A01,185463,Staff,36,0,60,24
1683637384060,CSE 142,B01,201355,Staff,0,7,60,60
1683637385089,CSE 142L,A01,185470,Staff,36,0,60,24
1683637385089,CSE 142L,B01,201417,Staff,0,6,60,60
1683637386114,CSE 190,A00,201433,Staff,32,0,49,17
1683637387138,DOC 1,A01,259136,Strom; Megan C.,7,0,15,8
1683637387138,DOC 1,A02,259137,Strom; Megan C.,14,0,15,1
1683637387138,DOC 1,A03,259138,Strom; Megan C.,14,0,15,1
1683637387138,DOC 1,A04,259139,Strom; Megan C.,14,0,15,1
1683637388169,DOC 100D,A00,259140,Pass; Natalye Joann,14,0,25,11
1683637389200,DSGN 1,A01,184749,Rill; Bryan,0,26,30,30
1683637390229,DSGN 100,A01,185168,Staff,0,2,25,25
1683637391255,ECE 5,A01,185626,Morris; Karcher William,0,11,0,0
1683637392285,ECE 101,A01,185628,Staff,14,0,70,56
1683637393315,ECE 107,A01,185635,Baghdadchi; Saharnaz,0,0,20,20
1683637393315,ECE 107,A02,185638,Baghdadchi; Saharnaz,3,0,20,17
1683637394348,ECE 148,A01,185647,Silberman; Jack,0,0,16,16
1683637395456,ECON 1,A01,185537,Crane; Meredith Helen,54,0,70,16
1683637396485,ECON 3,A01,185549,Crane; Meredith Helen,29,0,70,41
1683637397516,ECON 4,A01,203354,Anderson; John Charles,0,5,10,10
1683637398545,ECON 100A,A01,185574,Staff,0,5,40,40
1683637399572,ECON 100B,A01,185576,Staff,0,12,50,50
1683637400597,ECON 100C,A01,185589,Newhouse; Herbert S,30,0,70,40
1683637401622,ECON 105,A00,185608,Vespa; Emanuel Ignacio,19,0,35,16
1683637402648,ECON 109,A01,185610,Shishkin; Denis,9,0,35,26
1683637403671,ECON 110A,A01,185612,Staff,9,0,40,31
1683637404699,ECON 120A,A01,185615,Staff,20,0,40,20
1683637405729,ECON 120C,A01,185617,Sun; Yixiao,0,20,70,70
1683637406759,ECON 144,A00,203346,Squires; Dale E,2,0,35,33
1683637407786,ECON 171,A01,203349,Newhouse; Herbert S,0,1,35,35
1683637408813,ECON 173A,A01,185621,Toda; Alexis Akira,21,0,35,14
1683637409848,EDS 25,A01,202413,Staff,0,1,0,0
1683637409848,EDS 25,A02,202414,Staff,0,1,0,0
1683637409848,EDS 25,A03,202415,Staff,0,0,0,0
1683637409848,EDS 25,A04,202416,Staff,0,1,0,0
1683637409848,EDS 25,A05,202439,Staff,0,0,0,0
1683637409848,EDS 25,A06,202440,Staff,0,0,0,0
1683637409848,EDS 25,B01,202631,Staff,0,0,0,0
1683637409848,EDS 25,B02,202632,Staff,0,0,0,0
1683637409848,EDS 25,B03,202639,Staff,0,0,0,0
1683637409848,EDS 25,B04,202640,Staff,0,0,0,0
1683637409848,EDS 25,B05,202643,Staff,0,0,0,0
1683637409848,EDS 25,B06,202644,Staff,0,0,0,0
1683637410878,EDS 38,A01,202659,Black; Alison Michelle,24,0,25,1
1683637411905,EDS 115,A00,202652,Staff,18,0,30,12
1683637412933,EDS 125,A00,202649,Staff,13,0,30,17
1683637413960,EDS 126,A01,203332,Staff,30,0,30,0
1683637414984,EDS 139,A00,202838,Staff,16,0,25,9
1683637416010,EDS 146,A01,202655,Staff,14,0,25,11
1683637417036,ENG 15,A00,185667,Staff,0,1,0,0
1683637417036,ENG 15,B00,185672,Staff,0,0,0,0
1683637417036,ENG 15,C00,185675,Staff,0,0,0,0
1683637417036,ENG 15,D00,185682,Staff,0,0,0,0
1683637417036,ENG 15,E00,185684,Staff,0,0,0,0
1683637418062,ETHN 103,A00,185710,Staff,0,8,35,35
1683637419089,ETHN 103A,A00,199228,Man; Simeon S,0,0,9,9
1683637420115,ETHN 109,A00,185711,Staff,16,0,35,19
1683637421140,ETHN 142,A00,185726,Staff,0,4,30,30
1683637422166,ETHN 163J,A00,199229,Man; Simeon S,5,0,8,3
1683637423191,ETHN 168,A00,185727,Staff,7,0,10,3
1683637424216,ETHN 182,A00,185728,Staff,0,0,35,35
1683637425241,ETHN 183,A00,185737,Staff,9,0,18,9
1683637426269,GLBH 111,A01,209361,Burgos; Jose L.,0,0,0,0
1683637428322,HIEU 104,A00,185792,Staff,14,0,20,6
1683637429345,HIEU 115,A00,185800,Staff,0,0,20,20
1683637430372,HIEU 128,A00,185801,Staff,0,9,20,20
1683637431397,HIEU 147,A00,185802,Staff,15,0,20,5
1683637432423,HIEU 154,A00,185823,Staff,11,0,20,9
1683637433452,HILA 102,A00,185826,Staff,14,0,20,6
1683637434477,HILD 2C,A01,185778,Staff,0,13,20,20
1683637435507,HILD 7B,A01,185780,Kwak; Nancy,0,16,32,32
1683637435507,HILD 7B,A02,185781,Kwak; Nancy,0,18,32,32
1683637436536,HILD 30,A01,185791,Staff,12,0,20,8
1683637437567,HISC 119,A00,185830,Golan; Tal,0,9,20,20
1683637438593,HITO 156GS,A00,185831,Patterson; Patrick H.,0,0,0,23
1683637439619,HIUS 103,A00,185832,Man; Simeon S,0,4,20,20
1683637440646,HIUS 117,A00,185836,Kwak; Nancy,2,0,20,18
1683637441672,HIUS 125,A00,185840,Man; Simeon S,0,1,23,23
1683637442698,HIUS 149,A00,185845,Staff,1,0,20,19
1683637443726,HUM 3,A01,185882,Zavodny; Tatiana Sophia,0,7,50,50
1683637443726,HUM 3,B01,185899,Caldwell; Michael Alan,0,18,50,50
1683637444756,HUM 3GS,A00,185900,Patterson; Patrick H.,0,0,0,23
1683637445787,HUM 4,A01,185938,Zroka; Amy Liane,30,0,50,20
1683637445787,HUM 4,B01,185956,Watkins; Eric,0,4,50,50
1683637445787,HUM 4,B02,202209,Watkins; Eric,0,4,50,50
1683637445787,HUM 4,B03,202210,Watkins; Eric,0,4,50,50
1683637446818,HUM 5,A01,185958,West; Geoffrey Scott,2,0,50,48
1683637446818,HUM 5,A02,202215,West; Geoffrey Scott,0,0,50,50
1683637447851,INTL 190,A00,185959,Gagnon; Jeffrey C,0,0,0,9
1683637447851,INTL 190,B00,185960,Lettieri; Michael Joseph,0,0,0,2
1683637448879,JAPN 180,A00,254509,Staff,5,0,30,25
1683637449911,LATI 10,A01,202853,Kennemore; Amy Michelle,4,0,35,31
1683637449911,LATI 10,A02,202854,Kennemore; Amy Michelle,2,0,35,33
1683637449911,LATI 10,A03,270054,Kennemore; Amy Michelle,30,0,30,0
1683637450942,LATI 180,A00,202855,Kennemore; Amy Michelle,11,0,20,9
1683637451967,LAWS 101,A00,201767,Golan; Tal,0,7,40,40
1683637452993,LIFR 1C,A00,185961,Staff,6,0,20,14
1683637454020,LIFR 1CX,A00,185962,Staff,7,0,20,13
1683637455047,LIFR 1D,A00,185963,Staff,7,0,20,13
1683637456075,LIFR 1DX,A00,185964,Staff,7,0,20,13
1683637457103,LIGN 101,A01,186039,Staff,43,0,50,7
1683637458132,LIGN 165,A00,186040,Staff,15,0,50,35
1683637459157,LTCS 108,A00,186041,Staff,5,0,10,5
1683637460181,LTCS 119,A00,186042,Staff,15,0,20,5
1683637461218,LTCS 130,A00,186043,Wesling; Megan E.,15,0,25,10
1683637463269,LTEA 138,A00,186119,Staff,14,0,40,26
1683637464297,LTEN 124,A00,186148,Staff,5,0,25,20
1683637465323,LTEN 178,A00,186149,Staff,7,0,15,8
1683637466351,LTEN 181,A00,186150,Blanco; John D,34,0,40,6
1683637467378,LTWL 120,A00,186160,Staff,20,0,25,5
1683637468403,LTWL 165,A00,186161,Staff,22,0,25,3
1683637469429,LTWR 100,A00,186162,Staff,0,5,15,15
1683637470454,LTWR 102,A00,186163,Doller; Ben,5,0,15,10
1683637471485,MAE 8,A01,186412,Staff,0,0,0,0
1683637472516,MAE 30B,A00,186445,Bahadori; Mohammad Yousef,82,0,100,18
1683637473543,MAE 40,A00,186592,Bewley; Thomas R,10,0,50,40
1683637474572,MAE 101B,A00,186593,Bahadori; Mohammad Yousef,80,0,100,20
1683637475606,MAE 105,A00,186594,Bandaru; Prabhakar,10,0,50,40
1683637476634,MAE 107,A00,186599,Pham; Hieu Tan,0,7,120,120
1683637477660,MAE 148,A01,186660,Silberman; Jack,3,0,16,13
1683637478689,MATH 10A,A01,188095,Staff,0,5,35,35
1683637479717,MATH 10B,A01,188097,Bowers; Adam R.,0,11,30,30
1683637479717,MATH 10B,A02,188099,Bowers; Adam R.,0,11,30,30
1683637479717,MATH 10B,B01,188104,Bowers; Adam R.,0,10,30,30
1683637479717,MATH 10B,B02,188106,Bowers; Adam R.,1,9,30,29
1683637480745,MATH 10C,A01,188111,Staff,0,18,30,30
1683637480745,MATH 10C,A02,188127,Staff,0,19,30,30
1683637480745,MATH 10C,A03,188131,Staff,0,19,30,30
1683637480745,MATH 10C,B01,188218,Staff,17,0,30,13
1683637480745,MATH 10C,B02,188244,Staff,13,0,30,17
1683637480745,MATH 10C,B03,188277,Staff,14,0,30,16
1683637481778,MATH 18,A01,188344,Bach; Quang Tran,18,0,30,12
1683637481778,MATH 18,A02,188345,Bach; Quang Tran,11,0,30,19
1683637481778,MATH 18,B01,188353,Bach; Quang Tran,11,0,30,19
1683637481778,MATH 18,B02,188354,Bach; Quang Tran,19,0,30,11
1683637482806,MATH 20A,A01,188374,Staff,11,0,35,24
1683637483837,MATH 20B,A01,188382,Ohm; Ko Woon,7,0,30,23
1683637483837,MATH 20B,A02,188383,Ohm; Ko Woon,22,0,30,8
1683637483837,MATH 20B,B01,188385,Ohm; Ko Woon,7,0,30,23
1683637483837,MATH 20B,B02,188392,Ohm; Ko Woon,22,0,30,8
1683637484869,MATH 20C,A01,188394,Harel; Guershon,11,0,30,19
1683637484869,MATH 20C,A02,188395,Harel; Guershon,14,0,30,16
1683637484869,MATH 20C,B01,188404,Harel; Guershon,4,0,30,26
1683637484869,MATH 20C,B02,188405,Harel; Guershon,18,0,30,12
1683637485897,MATH 20D,A01,188414,Hammock; Frances H,0,1,30,30
1683637485897,MATH 20D,A02,188415,Hammock; Frances H,0,1,30,30
1683637485897,MATH 20D,B01,188447,Hammock; Frances H,0,1,30,30
1683637485897,MATH 20D,B02,188486,Hammock; Frances H,4,0,30,26
1683637486924,MATH 20E,A01,188649,Staff,21,0,30,9
1683637486924,MATH 20E,A02,188650,Staff,21,0,30,9
1683637486924,MATH 20E,A03,188673,Staff,0,0,30,30
1683637487953,MATH 102,A01,188675,Staff,0,36,35,35
1683637488984,MATH 103B,A01,188681,Staff,3,0,35,32
1683637488984,MATH 103B,B01,188692,Staff,5,0,35,30
1683637490011,MATH 109,A01,188695,Salehi Golsefidy; Alireza,24,0,35,11
1683637490011,MATH 109,A02,188696,Salehi Golsefidy; Alireza,25,0,35,10
1683637491035,MATH 120A,A01,188698,Eggers; John Dietrich,7,0,35,28
1683637492062,MATH 142B,A01,188736,Ioana; Adrian,0,1,30,30
1683637492062,MATH 142B,A02,188741,Ioana; Adrian,0,1,30,30
1683637492062,MATH 142B,A03,188743,Ioana; Adrian,0,1,30,30
1683637493087,MATH 168A,A01,188790,Staff,0,10,35,35
1683637494114,MATH 170A,A01,188803,Nie; Jiawang,0,2,35,35
1683637494114,MATH 170A,A02,188811,Nie; Jiawang,0,0,35,35
1683637494114,MATH 170A,A03,188814,Nie; Jiawang,0,0,35,35
1683637494114,MATH 170A,A04,188815,Nie; Jiawang,10,0,35,25
1683637495139,MATH 193B,A01,188817,Staff,0,0,35,35
1683637495139,MATH 193B,A02,188818,Staff,5,0,35,30
1683637496164,MGT 4,A01,202857,Anderson; John Charles,61,0,80,19
1683637497188,MGT 12,A00,202858,Lindenberger; Wade Douglas,40,0,90,50
1683637498215,MGT 18,A00,202859,Staff,74,0,90,16
1683637499304,MGT 18GS,A00,202860,McKay; Michael J,13,0,28,15
1683637500332,MGT 45,A00,202861,Pecore; Joseph P.,12,0,90,78
1683637501358,MGT 100,A00,202863,Yavorsky; Daniel Ryan,28,0,90,62
1683637502388,MGT 103,A00,202864,Ehrich; Kristine R,0,17,90,90
1683637503418,MGT 112,A00,202865,Ehrich; Kristine R,15,0,90,75
1683637504443,MGT 121A,A00,202868,Staff,0,20,0,0
1683637505469,MGT 131B,A00,202869,Anderson; John Charles,59,0,90,31
1683637506494,MGT 136,A00,202871,Lindenberger; Wade Douglas,83,0,90,7
1683637507519,MGT 164,A00,202873,Staff,0,66,90,91
1683637508543,MGT 164GS,A00,202874,McKay; Mary A,13,0,28,15
1683637509570,MGT 180,A00,202875,Staff,0,50,90,91
1683637510600,MMW 11R,A01,205019,Herbst; Matthew,2,0,30,28
1683637510600,MMW 11R,A02,205026,Herbst; Matthew,29,0,30,1
1683637511633,MMW 15,A01,193512,Chang; Edmond Yi-Teh,0,8,28,28
1683637511633,MMW 15,A02,193513,Chang; Edmond Yi-Teh,0,5,28,28
1683637511633,MMW 15,A03,193514,Chang; Edmond Yi-Teh,0,5,28,28
1683637511633,MMW 15,A04,193515,Chang; Edmond Yi-Teh,0,5,28,28
1683637511633,MMW 15,A05,193516,Chang; Edmond Yi-Teh,0,5,28,28
1683637511633,MMW 15,A06,193517,Chang; Edmond Yi-Teh,0,6,28,28
1683637511633,MMW 15,B01,193519,Chang; Edmond Yi-Teh,0,5,28,28
1683637511633,MMW 15,B02,193520,Chang; Edmond Yi-Teh,0,5,28,28
1683637511633,MMW 15,B03,193521,Chang; Edmond Yi-Teh,0,5,28,28
1683637511633,MMW 15,B04,193522,Chang; Edmond Yi-Teh,0,5,28,28
1683637511633,MMW 15,B05,193523,Chang; Edmond Yi-Teh,0,5,28,28
1683637511633,MMW 15,B06,193524,Chang; Edmond Yi-Teh,0,5,28,28
1683637512657,MMW 122,A01,193526,Rahimi; Babak,0,16,28,28
1683637512657,MMW 122,A02,193527,Rahimi; Babak,0,15,28,28
1683637512657,MMW 122,A03,193528,Rahimi; Babak,0,0,0,0
1683637512657,MMW 122,A04,193529,Rahimi; Babak,0,0,0,0
1683637513685,MUS 1A,A01,186663,Staff,1,20,35,34
1683637514711,MUS 4,A01,186715,Staff,0,12,35,35
1683637515737,MUS 5R,A01,186796,Dubnov; Shlomo,0,17,35,35
1683637516764,MUS 6,A01,186798,Staff,0,5,25,25
1683637517790,MUS 7,A01,186830,Staff,11,0,35,24
1683637518817,MUS 8,A01,186930,Staff,0,26,35,35
1683637519841,MUS 15,A01,186932,Staff,0,16,35,35
1683637519841,MUS 15,B01,186934,Staff,0,17,35,35
1683637520871,MUS 80,A00,186935,Staff,0,0,20,20
1683637520871,MUS 80,B00,186936,Staff,24,0,25,1
1683637521898,NANO 11,A00,204702,Lipomi; Darren John,0,0,0,0
1683637522928,NANO 15,A01,204709,Yang; Kesong,0,1,0,0
1683637523961,NANO 114,A00,202069,Jahed Motlagh; Zeinab,3,0,10,7
1683637524990,PHIL 1,A00,186955,Grush; Rick Scott,31,0,40,9
1683637526018,PHIL 10,A01,186973,Grush; Rick Scott,27,0,35,8
1683637526018,PHIL 10,A02,186974,Grush; Rick Scott,33,0,35,2
1683637527044,PHIL 13,A01,186976,Staff,3,0,35,32
1683637527044,PHIL 13,A02,186977,Staff,16,0,35,19
1683637528068,PHIL 14,A01,186979,Staff,31,0,35,4
1683637528068,PHIL 14,A02,186986,Staff,32,0,35,3
1683637529095,PHIL 28,A01,186988,Staff,16,0,30,14
1683637529095,PHIL 28,A02,186989,Staff,1,0,30,29
1683637529095,PHIL 28,A03,186990,Staff,10,0,30,20
1683637529095,PHIL 28,A04,186991,Staff,26,0,30,4
1683637530124,PHIL 120,A00,186997,Staff,23,0,40,17
1683637531151,PHIL 137,A00,187003,Staff,7,0,40,33
1683637532179,PHIL 150,A00,187015,Staff,47,0,70,23
1683637533210,PHIL 167,A00,187021,Lamey; Andy M.,34,0,40,6
1683637534236,PHIL 174,A01,202226,Staff,17,0,20,3
1683637534236,PHIL 174,A02,202235,Staff,20,0,20,0
1683637535262,PHIL 191A,A00,258918,Staff,0,0,1,1
1683637536287,PHYS 1A,A00,187028,Staff,27,0,60,33
1683637537315,PHYS 1AL,001,187036,Staff,3,0,30,27
1683637537315,PHYS 1AL,002,187049,Staff,18,0,30,12
1683637538340,PHYS 1B,A00,187058,Staff,22,0,60,38
1683637539366,PHYS 1BL,001,187064,Staff,0,1,30,30
1683637539366,PHYS 1BL,002,187070,Staff,4,0,30,26
1683637540394,PHYS 1C,A00,187082,Staff,29,0,120,91
1683637541420,PHYS 1CL,001,187088,Staff,0,9,30,30
1683637541420,PHYS 1CL,002,187089,Staff,0,1,30,30
1683637541420,PHYS 1CL,009,262693,Staff,9,0,30,21
1683637542445,PHYS 2B,A01,187097,Staff,55,0,115,60
1683637543470,PHYS 2C,A01,187099,Staff,64,0,115,51
1683637544496,PHYS 2CL,A01,187101,Staff,5,0,28,23
1683637544496,PHYS 2CL,A02,187102,Staff,15,0,28,13
1683637545522,PHYS 2D,A01,187123,Shotwell; Brian,95,0,115,20
1683637546547,PHYS 4B,A01,187133,Grinstein; Benjamin,35,0,50,15
1683637547573,POLI 10,A00,188819,Staff,0,4,50,50
1683637548599,POLI 11,A00,188827,Staff,43,0,50,7
1683637549624,POLI 13R,A00,188828,Staff,0,1,20,20
1683637550651,POLI 27,A01,188830,Elgin; Samuel Zincke,0,2,70,70
1683637551677,POLI 30,A00,188832,Desposato; Scott,30,0,50,20
1683637552707,POLI 102F,A00,188834,Staff,0,0,40,40
1683637553739,POLI 104A,A00,188852,Staff,13,0,30,17
1683637554767,POLI 104I,A00,188853,Staff,0,7,20,20
1683637555806,POLI 110B,A00,188854,Wiens; David,7,0,20,13
1683637556832,POLI 112A,A00,188855,Wiens; David,4,0,30,26
1683637557860,POLI 117R,A00,188856,Forman; Fonna,0,12,20,20
1683637558886,POLI 118,A00,188857,Ingham; Sean,8,0,20,12
1683637559911,POLI 120G,A00,188858,Staff,8,0,30,22
1683637560936,POLI 131CR,A00,188863,Hoston; Germaine,21,0,50,29
1683637561961,POLI 133,A00,188864,Nellis; Gareth Hb,44,0,50,6
1683637562986,POLI 134D,A00,188865,Desposato; Scott,27,0,30,3
1683637564011,POLI 142A,A00,188871,Gartzke; Erik,21,0,50,29
1683637565037,POLI 142K,A00,188874,Staff,38,0,50,12
1683637566061,POLI 143,A00,188940,Gartzke; Erik,16,0,30,14
1683637567086,POLI 153,A00,188943,Staff,2,0,20,18
1683637568112,POLI 160AA,A00,188944,Staff,11,0,40,29
1683637569139,POLI 170A,A00,188945,Staff,11,0,30,19
1683637571194,PSYC 1,A00,188952,Staff,36,0,90,54
1683637572219,PSYC 2,B00,188953,Staff,19,0,35,16
1683637573244,PSYC 6,A00,188970,Staff,47,0,60,13
1683637574269,PSYC 7,A00,188973,Staff,35,0,45,10
1683637575304,PSYC 60,A01,188980,Rickard; Timothy C.,42,0,60,18
1683637576334,PSYC 70,A01,189001,Steiner; Eric Tomas,23,0,45,22
1683637577363,PSYC 100,A00,189005,Lacefield; Katharine I,0,99,120,120
1683637578387,PSYC 102,A00,189008,Staff,8,0,30,22
1683637579411,PSYC 106,B00,189026,Gorman; Michael R.,27,0,60,33
1683637580437,PSYC 114,B01,189033,Winkielman; Piotr,0,31,30,30
1683637581463,PSYC 131,A00,189036,Anagnostaras; Stephan,0,43,60,60
1683637582494,PSYC 136,A00,189041,Lowe; Angela Beth,0,7,25,25
1683637583522,PSYC 137,A00,189057,Winkielman; Piotr,0,37,25,25
1683637584550,PSYC 144,A00,189107,Wixted; John T,0,10,50,50
1683637586603,PSYC 162,A00,189142,Staff,0,9,85,85
1683637587629,PSYC 172,A00,189144,Gorman; Michael R.,0,6,30,30
1683637589681,PSYC 179,A00,189146,Lacefield; Katharine I,0,86,120,120
1683637590712,PSYC 181,A00,189147,Anagnostaras; Stephan,0,44,90,90
1683637591742,PSYC 190R,A00,189148,Barner; David A.,0,23,80,80
1683637592771,PSYC 191,A00,189275,Rickard; Timothy C.,0,10,25,25
1683637593803,PSYC 193,A00,189276,Chapman; Eddie Nathaniel,0,1,0,4
1683637594833,PSYC 193L,A01,189281,Lowe; Angela Beth,10,0,20,10
1683637594833,PSYC 193L,B01,189285,Staff,28,0,35,7
1683637595859,RELI 149,A00,187137,Rahimi; Babak,7,0,40,33
1683637596888,SE 9,A01,187315,Staff,0,2,18,18
1683637597913,SE 101B,A00,187409,Staff,24,0,30,6
1683637598938,SE 110B,A00,187444,Staff,10,0,40,30
1683637599966,SE 130B,A00,187449,Staff,31,0,40,9
1683637600991,SE 150A,A00,187516,Staff,9,0,20,11
1683637602016,SE 154,A00,187528,Staff,29,0,50,21
1683637603099,SIO 3,A01,258171,Staff,35,0,40,5
1683637604125,SIO 10,A00,187144,Cook; Geoffrey W,0,6,75,75
1683637605150,SIO 45,A00,187152,Cook; Geoffrey W,0,4,100,100
1683637606174,SIO 109R,A00,194486,Staff,0,4,20,20
1683637608226,SIO 187,A01,187233,Kacev; David,12,0,40,28
1683637609255,SOCI 1,A01,258656,Thorpe; Charles Robert,28,0,30,2
1683637609255,SOCI 1,A02,258658,Thorpe; Charles Robert,30,0,30,0
1683637609255,SOCI 1,A03,258661,Thorpe; Charles Robert,25,0,25,0
1683637609255,SOCI 1,A04,258666,Thorpe; Charles Robert,22,0,25,3
1683637609255,SOCI 1,A05,258897,Thorpe; Charles Robert,22,0,25,3
1683637609255,SOCI 1,A06,258898,Thorpe; Charles Robert,25,0,25,0
1683637610280,SOCI 30,A01,258903,Pardo Guerra; Juan Pablo,14,0,30,16
1683637611306,SOCI 102,A00,258904,Staff,9,0,25,16
1683637612330,SOCI 106,A00,258905,Staff,19,0,25,6
1683637613356,SOCI 111,A00,258907,Ribas Norris; Janet Vanesa,26,0,30,4
1683637614384,SOCI 121R,A00,258908,Pardo Guerra; Juan Pablo,8,0,30,22
1683637615408,SOCI 126,A01,203330,Staff,14,0,20,6
1683637616435,SOCI 131,A00,258909,Thorpe; Charles Robert,30,0,60,30
1683637617464,SOCI 135,A00,258910,Payne; Christine Anna,0,11,30,30
1683637618492,SOCI 157,A00,258911,Staff,12,0,30,18
1683637619518,SOCI 184,A00,258912,Staff,25,0,30,5
1683637620543,SOCI 188D,A00,258913,Staff,22,0,30,8
1683637621574,SYN 2,001,187529,Staff,9,0,16,7
1683637621574,SYN 2,002,201452,Staff,0,20,16,16
1683637621574,SYN 2,003,201469,Staff,2,0,16,14
1683637622600,SYN 100,A01,187531,Staff,0,9,20,20
1683637622600,SYN 100,B01,201491,Staff,0,10,20,20
1683637623627,TDAC 1,A00,189286,Walsh; Kim C.,3,0,20,17
1683637623627,TDAC 1,B00,189287,Harting; Carla Kelso,10,0,20,10
1683637624657,TDAC 101,A00,189300,Walsh; Kim C.,16,0,20,4
1683637624657,TDAC 101,B00,189301,Harting; Carla Kelso,18,0,20,2
1683637625683,TDAC 102,A00,189304,Basso; Beatrice,14,0,20,6
1683637626713,TDAC 108,A00,189305,Staff,18,0,20,2
1683637627740,TDDE 131,A00,189310,Staff,19,0,20,1
1683637627740,TDDE 131,B00,189314,Staff,19,0,20,1
1683637627740,TDDE 131,C00,189315,Staff,48,0,50,2
1683637627740,TDDE 131,D00,189316,Staff,14,0,15,1
1683637627740,TDDE 131,E00,204841,Staff,20,0,20,0
1683637628768,TDGE 10,A00,189289,Staff,27,0,50,23
1683637628768,TDGE 10,B00,189290,Havis; Allan,0,0,50,50
1683637629801,TDGE 11,A00,189291,Fulton; Julia,0,4,50,50
1683637629801,TDGE 11,B00,189292,Staff,20,0,25,5
1683637629801,TDGE 11,C00,260270,Staff,0,0,0,0
1683637630829,TDGE 25,A00,189294,Staff,2,0,20,18
1683637631857,TDGE 124,A00,189318,Fulton; Julia,0,8,50,50
1683637632881,TDGE 125,A00,189319,Staff,13,0,25,12
1683637632881,TDGE 125,B00,189320,Staff,23,0,25,2
1683637633907,TDGE 127,A00,189322,Havis; Allan,0,0,50,50
1683637634933,TDHT 101,A00,189323,Staff,18,0,25,7
1683637634933,TDHT 101,B00,189324,Staff,25,0,25,0
1683637635959,TDHT 102,A00,189325,Staff,49,0,50,1
1683637636986,TDMV 1,A00,189295,Arcidiacono; Kristin,20,0,30,10
1683637636986,TDMV 1,B00,189296,Caligagan; Maria T.,24,0,30,6
1683637638013,TDMV 2,A00,189297,Sammartano; Tonnie,27,0,30,3
1683637638013,TDMV 2,B00,189299,Arcidiacono; Kristin,23,0,30,7
1683637639041,TDMV 3,A00,204998,Rincon; Alicia,22,0,30,8
1683637640069,TDMV 120,A00,189458,Sammartano; Tonnie,28,0,30,2
1683637641097,TDMV 138,A00,189541,Jun; Grace Shin Hae,20,0,40,20
1683637642126,TDMV 142,A00,189717,Caligagan; Tony,25,0,30,5
1683637642126,TDMV 142,B00,189718,Caligagan; Maria T.,25,0,30,5
1683637643158,TMC 2,A01,187533,Staff,25,0,25,0
1683637643158,TMC 2,A02,187534,Staff,25,0,25,0
1683637644188,USP 1,A01,187536,Kwak; Nancy,0,16,25,25
1683637645212,USP 5,A01,187538,Staff,9,0,25,16
1683637646237,USP 101,A00,199253,Staff,0,4,0,0
1683637647262,USP 124,A00,187562,Boomhower; Matthew Charles,0,0,30,30
1683637648285,USP 138,A00,187582,Staff,20,0,25,5
1683637649310,USP 152,A01,187597,Staff,3,0,25,22
1683637650334,USP 153,A00,187598,Staff,19,0,25,6
1683637651361,USP 168,A00,187607,Kwak; Nancy,2,0,5,3
1683637652387,USP 173,A00,187619,Staff,4,0,25,21
1683637653412,USP 181,A00,187638,Staff,0,4,25,25
1683637654437,VIS 103,A00,187650,Cruz; Edwin Teddy,18,0,75,57
1683637655465,VIS 110D,A00,187669,Staff,13,0,22,9
1683637656494,VIS 127C,A00,187720,Shen; Kuiyi,67,0,146,79
1683637657523,VIS 149,A00,187731,Yoldas; Pinar,0,14,22,22
1683637658549,VIS 151,A01,188091,Staff,22,0,34,12
1683637658549,VIS 151,A02,188092,Staff,11,0,34,23
1683637659574,VIS 160B,A00,188093,Stalbaum; Brett,0,1,10,10
1683637661629,WCWP 10B,A00,201720,Staff,10,0,15,5
1683637661629,WCWP 10B,B00,201722,Staff,9,0,15,6
1683637662654,WCWP 100,A00,201725,Gagnon; Jeffrey C,0,0,2,2
1683637662654,WCWP 100,B00,201727,Staff,0,4,15,15
1683637665782,ANBI 133,A00,258401,Wilder; Linnea Lorene,34,0,40,6
1683637666807,ANBI 140,A00,258395,Hrvoj Mihic; Branka,18,0,25,7
1683637667834,ANSC 120,A00,258402,Bialecki; Jon Anthony,27,0,40,13
1683637668860,ANSC 144,A00,258400,Staff,12,0,40,28
1683637670909,ANSC 166,A00,258396,Parish; Steven Martin,156,0,175,19
1683637671954,ANSC 180,A00,193533,Staff,8,0,20,12
1683637672979,ANSC 188,A00,258397,Jassal; Aftab,34,0,40,6
1683637674008,ANTH 3,A01,258316,Staff,23,0,30,7
1683637675037,ANTH 5,A00,258394,Semendeferi; Ekaterini,16,0,20,4
1683637676066,ANTH 21,A01,258331,Staff,4,0,40,36
1683637677095,ANTH 103,A00,258398,Varma; Saiba,15,0,25,10
1683637678131,AWP 10,001,202034,Staff,0,0,0,0
1683637678131,AWP 10,002,202035,Staff,0,0,0,0
1683637678131,AWP 10,003,202036,Staff,0,0,0,0
1683637678131,AWP 10,004,202037,Staff,0,0,0,0
1683637678131,AWP 10,005,202038,Staff,0,0,0,0
1683637678131,AWP 10,006,202039,Staff,0,0,0,0
1683637678131,AWP 10,007,202040,Staff,0,0,0,0
1683637678131,AWP 10,008,202041,Staff,0,0,0,0
1683637678131,AWP 10,009,202042,Staff,0,0,0,0
1683637678131,AWP 10,010,202043,Staff,0,0,0,0
1683637678131,AWP 10,011,202044,Staff,0,0,0,0
1683637678131,AWP 10,012,202045,Staff,0,0,0,0
1683637678131,AWP 10,013,202046,Staff,0,0,0,0
1683637678131,AWP 10,014,202047,Staff,0,0,0,0
1683637678131,AWP 10,015,202048,Staff,0,0,0,0
1683637678131,AWP 10,016,202049,Staff,0,0,0,0
1683637678131,AWP 10,017,202050,Staff,0,0,0,0
1683637678131,AWP 10,018,202051,Staff,0,0,0,0
1683637678131,AWP 10,019,202052,Staff,0,0,0,0
1683637678131,AWP 10,020,202053,Staff,0,0,0,0
1683637678131,AWP 10,021,202054,Staff,0,0,0,0
1683637678131,AWP 10,022,202055,Staff,0,0,0,0
1683637678131,AWP 10,023,202056,Staff,0,0,0,0
1683637678131,AWP 10,024,202057,Staff,0,0,0,0
1683637678131,AWP 10,025,202058,Staff,0,0,0,0
1683637678131,AWP 10,026,202059,Staff,0,0,0,0
1683637679162,AWP 102,001,202032,Staff,0,0,0,0
1683637679162,AWP 102,002,202033,Staff,0,0,0,0
1683637680187,BENG 100,A01,254234,Taylor Amos; Alyssa C,31,0,40,9
1683637681216,BENG 196,001,270013,Engler; Adam J.,9999,0,9999,0
1683637682244,BICD 100R,A01,202018,Smith; Laurie,0,7,32,32
1683637682244,BICD 100R,A02,202019,Smith; Laurie,0,3,32,32
1683637682244,BICD 100R,A03,202020,Smith; Laurie,0,1,32,32
1683637682244,BICD 100R,A04,202021,Smith; Laurie,6,0,32,26
1683637682244,BICD 100R,A05,202022,Smith; Laurie,11,0,32,21
1683637683274,BICD 136,A01,193242,Gustafson-Brown; Cindy,0,2,32,32
1683637683274,BICD 136,A02,193244,Gustafson-Brown; Cindy,13,0,32,19
1683637684312,BIEB 102,A01,193249,Butler; Shannon Rhey,0,2,32,32
1683637684312,BIEB 102,A02,193251,Butler; Shannon Rhey,0,0,32,32
1683637684312,BIEB 102,A03,193253,Butler; Shannon Rhey,0,0,32,32
1683637684312,BIEB 102,A04,193255,Butler; Shannon Rhey,14,0,32,18
1683637684312,BIEB 102,A05,193265,Butler; Shannon Rhey,26,0,32,6
1683637684312,BIEB 102,A06,193269,Butler; Shannon Rhey,14,0,32,18
1683637686376,BIEB 150,A01,193274,Staff,0,0,32,32
1683637686376,BIEB 150,A02,193285,Staff,24,0,32,8
1683637687400,BIEB 194,A00,193286,Kurle; Carolyn M.,20,0,32,12
1683637688436,BILD 1,A01,192291,Staff,15,0,32,17
1683637688436,BILD 1,A02,192292,Staff,30,0,32,2
1683637688436,BILD 1,B01,192520,Reuther; Keefe,0,1,0,0
1683637688436,BILD 1,B02,192532,Reuther; Keefe,0,1,0,0
1683637689467,BILD 3,A01,192556,Butler; Shannon Rhey,0,0,32,32
1683637689467,BILD 3,A02,192581,Butler; Shannon Rhey,1,0,32,31
1683637689467,BILD 3,A03,192611,Butler; Shannon Rhey,21,0,32,11
1683637689467,BILD 3,A04,192612,Butler; Shannon Rhey,24,0,32,8
1683637689467,BILD 3,A05,192613,Butler; Shannon Rhey,26,0,32,6
1683637689467,BILD 3,A06,192679,Butler; Shannon Rhey,27,0,32,5
1683637689467,BILD 3,A07,192682,Butler; Shannon Rhey,20,0,32,12
1683637690501,BILD 4,A01,192836,Reuther; Keefe,0,0,24,24
1683637690501,BILD 4,A02,193044,Reuther; Keefe,4,0,24,20
1683637691529,BILD 10,A01,193142,Gustafson-Brown; Cindy,29,0,32,3
1683637691529,BILD 10,A02,193149,Gustafson-Brown; Cindy,31,0,32,1
1683637692554,BIMM 100,A01,193301,Staff,0,6,32,32
1683637692554,BIMM 100,A02,193312,Staff,0,7,32,32
1683637692554,BIMM 100,A03,193323,Staff,0,9,32,32
1683637693581,BIMM 101,A01,193329,McDonnell; Lisa Marie,0,4,24,24
1683637693581,BIMM 101,A02,193339,McDonnell; Lisa Marie,0,3,24,24
1683637693581,BIMM 101,B01,193354,McDonnell; Lisa Marie,0,4,24,24
1683637693581,BIMM 101,B02,193357,McDonnell; Lisa Marie,0,2,24,24
1683637694608,BIMM 110,A01,193377,Tat; John,0,11,32,32
1683637694608,BIMM 110,A02,193378,Tat; John,0,10,32,32
1683637695635,BIMM 120,A01,206116,Staff,0,0,32,32
1683637695635,BIMM 120,A02,206117,Staff,6,0,32,26
1683637695635,BIMM 120,A03,206121,Staff,21,0,32,11
1683637696667,BIPN 100,A01,193393,Park; Ji Young,0,14,32,32
1683637696667,BIPN 100,A02,193402,Park; Ji Young,0,14,32,32
1683637696667,BIPN 100,A03,193413,Park; Ji Young,0,14,32,32
1683637696667,BIPN 100,A04,193414,Park; Ji Young,0,13,32,32
1683637697693,BIPN 102,A01,193429,Staff,0,0,32,32
1683637697693,BIPN 102,A02,193438,Staff,18,0,32,14
1683637698719,BIPN 106,A01,193450,Reyes Gonzalez; Catalina,0,2,40,40
1683637699751,BIPN 134,A01,193465,Cooke; James Edward,0,0,32,32
1683637699751,BIPN 134,A02,193474,Cooke; James Edward,25,0,32,7
1683637699751,BIPN 134,A03,193485,Cooke; James Edward,29,0,32,3
1683637699751,BIPN 134,A04,193486,Cooke; James Edward,20,0,32,12
1683637699751,BIPN 134,A05,193491,Cooke; James Edward,31,0,32,1
1683637699751,BIPN 134,A06,193501,Cooke; James Edward,30,0,32,2
1683637699751,BIPN 134,A07,193510,Cooke; James Edward,29,0,32,3
1683637701807,BISP 194,A00,222522,Staff,14,0,32,18
1683637702832,CAT 124,A01,202407,Staff,19,0,25,6
1683637703857,CAT 125,A00,202408,Marchisotto; Jennifer Anne,2,0,20,18
1683637704886,CAT 125R,A00,202409,Smith; Lauryn Alissa,0,11,20,20
1683637704886,CAT 125R,B00,202410,Morales; Celeste Georgianna,0,11,20,20
1683637704886,CAT 125R,C00,202411,Irwin; Matthew Joseph,0,12,20,20
1683637705918,CENG 15,A01,204712,Yang; Kesong,0,1,0,0
1683637707002,CENG 114,A00,202070,Jahed Motlagh; Zeinab,5,0,20,15
1683637708032,CGS 105,A00,185477,Wesling; Megan E.,24,0,40,16
1683637709060,CGS 106,A00,185494,Staff,11,0,22,11
1683637710085,CGS 108,A00,185495,Staff,14,0,20,6
1683637711110,CGS 114,A00,185496,Staff,13,0,18,5
1683637712136,CGS 119,A00,185501,Staff,15,0,20,5
1683637713164,CGS 120,A00,185511,Staff,12,0,20,8
1683637714191,CHEM 4,A01,184675,Bussey; Thomas J,97,0,100,3
1683637715219,CHEM 6A,A01,184677,Staff,33,0,60,27
1683637716247,CHEM 6B,A01,184679,Staff,63,0,100,37
1683637717277,CHEM 6C,A01,184681,Bussey; Thomas J,0,0,50,50
1683637717277,CHEM 6C,A02,184682,Bussey; Thomas J,32,0,50,18
1683637718304,CHEM 40A,A01,184684,Albizati; Kim F.,35,0,100,65
1683637719334,CHEM 40B,A01,184686,Albizati; Kim F.,0,22,100,100
1683637720362,CHEM 41B,A01,184690,Staff,51,0,100,49
1683637721392,COGS 3,A01,184715,Boyle; Mary E. T.,0,27,40,40
1683637722421,COGS 14B,A01,185172,Staff,0,14,38,38
1683637723451,COGS 18,A01,184736,Staff,15,0,80,65
1683637724480,COGS 100,A01,184932,Staff,0,7,73,73
1683637725509,COGS 101A,A01,184935,Staff,0,39,30,30
1683637726539,COGS 101B,A01,184944,Staff,0,2,30,30
1683637727565,COGS 101C,A01,184946,Staff,0,10,30,30
1683637728595,COGS 102A,A01,184951,Johnson; Christine M.,2,0,40,38
1683637729625,COGS 107B,A01,184953,Mooshagian; Eric Frederick,0,51,40,40
1683637730653,COGS 118B,A01,184959,Gupta; Anjum,0,49,40,40
1683637731678,COGS 153,A00,184961,Staff,0,16,30,30
1683637732706,COGS 177,A00,184962,Staff,0,21,30,30
1683637733735,COGS 187A,A01,184969,Boyle; Mary E. T.,0,19,40,40
1683637734762,COMM 10,A01,185174,Staff,0,5,25,25
1683637734762,COMM 10,A02,185189,Staff,0,2,25,25
1683637734762,COMM 10,A03,269821,Staff,0,1,0,0
1683637735791,COMM 100B,A01,185475,Staff,0,1,0,2
1683637735791,COMM 100B,A02,185476,Staff,12,0,25,13
1683637736820,COMM 100C,A01,185314,Staff,1,0,25,24
1683637736820,COMM 100C,A02,185327,Staff,18,0,25,7
1683637737848,COMM 110M,A00,185349,Staff,0,0,40,40
1683637738875,COMM 113T,A00,185352,Staff,25,0,40,15
1683637739905,COMM 114I,A00,185353,Staff,31,0,40,9
1683637740929,COMM 131,A00,185354,Staff,17,0,30,13
1683637741954,CSE 8A,A50,185358,Cao; Yingjun,0,46,10,10
1683637742981,CSE 8B,A01,185362,Staff,0,48,50,50
1683637744007,CSE 11,A01,185416,Cao; Yingjun,0,91,10,10
1683637745033,CSE 20,A01,185445,Briones; Jor-el Thomas Caparas,4,0,25,21
1683637746062,CSE 21,A01,185447,Staff,9,0,50,41
1683637747093,CSE 101,A01,185451,Staff,0,13,50,50
1683637747093,CSE 101,B01,185453,Jones; Miles E,0,13,50,50
1683637749150,CSE 141,A01,185458,Eldon; John,15,0,100,85
1683637750179,CSE 141L,A01,185461,Eldon; John,7,0,100,93
1683637751209,CSE 142,A01,185463,Staff,36,0,60,24
1683637751209,CSE 142,B01,201355,Staff,0,7,60,60
1683637752235,CSE 142L,A01,185470,Staff,36,0,60,24
1683637752235,CSE 142L,B01,201417,Staff,0,6,60,60
1683637753264,CSE 190,A00,201433,Staff,32,0,49,17
1683637754296,DOC 1,A01,259136,Strom; Megan C.,7,0,15,8
1683637754296,DOC 1,A02,259137,Strom; Megan C.,14,0,15,1
1683637754296,DOC 1,A03,259138,Strom; Megan C.,14,0,15,1
1683637754296,DOC 1,A04,259139,Strom; Megan C.,14,0,15,1
1683637755326,DOC 100D,A00,259140,Pass; Natalye Joann,14,0,25,11
1683637756352,DSGN 1,A01,184749,Rill; Bryan,0,26,30,30
1683637757377,DSGN 100,A01,185168,Staff,0,2,25,25
1683637758404,ECE 5,A01,185626,Morris; Karcher William,0,11,0,0
1683637759429,ECE 101,A01,185628,Staff,14,0,70,56
1683637760458,ECE 107,A01,185635,Baghdadchi; Saharnaz,0,0,20,20
1683637760458,ECE 107,A02,185638,Baghdadchi; Saharnaz,3,0,20,17
1683637761487,ECE 148,A01,185647,Silberman; Jack,0,0,16,16
1683637762516,ECON 1,A01,185537,Crane; Meredith Helen,54,0,70,16
1683637763542,ECON 3,A01,185549,Crane; Meredith Helen,29,0,70,41
1683637764573,ECON 4,A01,203354,Anderson; John Charles,0,5,10,10
1683637765602,ECON 100A,A01,185574,Staff,0,5,40,40
1683637766629,ECON 100B,A01,185576,Staff,0,12,50,50
1683637767655,ECON 100C,A01,185589,Newhouse; Herbert S,30,0,70,40
1683637768681,ECON 105,A00,185608,Vespa; Emanuel Ignacio,19,0,35,16
1683637769708,ECON 109,A01,185610,Shishkin; Denis,9,0,35,26
1683637770733,ECON 110A,A01,185612,Staff,9,0,40,31
1683637771759,ECON 120A,A01,185615,Staff,20,0,40,20
1683637772785,ECON 120C,A01,185617,Sun; Yixiao,0,20,70,70
1683637773812,ECON 144,A00,203346,Squires; Dale E,2,0,35,33
1683637774842,ECON 171,A01,203349,Newhouse; Herbert S,0,1,35,35
1683637775872,ECON 173A,A01,185621,Toda; Alexis Akira,21,0,35,14
1683637776900,EDS 25,A01,202413,Staff,0,1,0,0
1683637776900,EDS 25,A02,202414,Staff,0,1,0,0
1683637776900,EDS 25,A03,202415,Staff,0,0,0,0
1683637776900,EDS 25,A04,202416,Staff,0,1,0,0
1683637776900,EDS 25,A05,202439,Staff,0,0,0,0
1683637776900,EDS 25,A06,202440,Staff,0,0,0,0
1683637776900,EDS 25,B01,202631,Staff,0,0,0,0
1683637776900,EDS 25,B02,202632,Staff,0,0,0,0
1683637776900,EDS 25,B03,202639,Staff,0,0,0,0
1683637776900,EDS 25,B04,202640,Staff,0,0,0,0
1683637776900,EDS 25,B05,202643,Staff,0,0,0,0
1683637776900,EDS 25,B06,202644,Staff,0,0,0,0
1683637777927,EDS 38,A01,202659,Black; Alison Michelle,24,0,25,1
1683637778953,EDS 115,A00,202652,Staff,18,0,30,12
1683637779979,EDS 125,A00,202649,Staff,13,0,30,17
1683637781009,EDS 126,A01,203332,Staff,30,0,30,0
1683637782040,EDS 139,A00,202838,Staff,16,0,25,9
1683637783065,EDS 146,A01,202655,Staff,14,0,25,11
1683637784092,ENG 15,A00,185667,Staff,0,1,0,0
1683637784092,ENG 15,B00,185672,Staff,0,0,0,0
1683637784092,ENG 15,C00,185675,Staff,0,0,0,0
1683637784092,ENG 15,D00,185682,Staff,0,0,0,0
1683637784092,ENG 15,E00,185684,Staff,0,0,0,0
1683637785121,ETHN 103,A00,185710,Staff,0,8,35,35
1683637786154,ETHN 103A,A00,199228,Man; Simeon S,0,0,9,9
1683637787183,ETHN 109,A00,185711,Staff,16,0,35,19
1683637788211,ETHN 142,A00,185726,Staff,0,4,30,30
1683637789239,ETHN 163J,A00,199229,Man; Simeon S,5,0,8,3
1683637790267,ETHN 168,A00,185727,Staff,7,0,10,3
1683637791297,ETHN 182,A00,185728,Staff,0,0,35,35
1683637792322,ETHN 183,A00,185737,Staff,9,0,18,9
1683637793349,GLBH 111,A01,209361,Burgos; Jose L.,0,0,0,0
1683637795402,HIEU 104,A00,185792,Staff,14,0,20,6
1683637796431,HIEU 115,A00,185800,Staff,0,0,20,20
1683637797459,HIEU 128,A00,185801,Staff,0,9,20,20
1683637798483,HIEU 147,A00,185802,Staff,15,0,20,5
1683637799509,HIEU 154,A00,185823,Staff,11,0,20,9
1683637800534,HILA 102,A00,185826,Staff,14,0,20,6
1683637801559,HILD 2C,A01,185778,Staff,0,13,20,20
1683637802585,HILD 7B,A01,185780,Kwak; Nancy,0,16,32,32
1683637802585,HILD 7B,A02,185781,Kwak; Nancy,0,18,32,32
1683637803613,HILD 30,A01,185791,Staff,12,0,20,8
1683637804639,HISC 119,A00,185830,Golan; Tal,0,9,20,20
1683637805665,HITO 156GS,A00,185831,Patterson; Patrick H.,0,0,0,23
1683637806692,HIUS 103,A00,185832,Man; Simeon S,0,4,20,20
1683637807717,HIUS 117,A00,185836,Kwak; Nancy,2,0,20,18
1683637808746,HIUS 125,A00,185840,Man; Simeon S,0,1,23,23
1683637809774,HIUS 149,A00,185845,Staff,1,0,20,19
1683637810858,HUM 3,A01,185882,Zavodny; Tatiana Sophia,0,7,50,50
1683637810858,HUM 3,B01,185899,Caldwell; Michael Alan,0,18,50,50
1683637811883,HUM 3GS,A00,185900,Patterson; Patrick H.,0,0,0,23
1683637812911,HUM 4,A01,185938,Zroka; Amy Liane,30,0,50,20
1683637812911,HUM 4,B01,185956,Watkins; Eric,0,4,50,50
1683637812911,HUM 4,B02,202209,Watkins; Eric,0,4,50,50
1683637812911,HUM 4,B03,202210,Watkins; Eric,0,4,50,50
1683637813938,HUM 5,A01,185958,West; Geoffrey Scott,2,0,50,48
1683637813938,HUM 5,A02,202215,West; Geoffrey Scott,0,0,50,50
1683637814965,INTL 190,A00,185959,Gagnon; Jeffrey C,0,0,0,9
1683637814965,INTL 190,B00,185960,Lettieri; Michael Joseph,0,0,0,2
1683637815995,JAPN 180,A00,254509,Staff,5,0,30,25
1683637817027,LATI 10,A01,202853,Kennemore; Amy Michelle,4,0,35,31
1683637817027,LATI 10,A02,202854,Kennemore; Amy Michelle,2,0,35,33
1683637817027,LATI 10,A03,270054,Kennemore; Amy Michelle,30,0,30,0
1683637818050,LATI 180,A00,202855,Kennemore; Amy Michelle,11,0,20,9
1683637819077,LAWS 101,A00,201767,Golan; Tal,0,7,40,40
1683637820103,LIFR 1C,A00,185961,Staff,6,0,20,14
1683637821131,LIFR 1CX,A00,185962,Staff,7,0,20,13
1683637822162,LIFR 1D,A00,185963,Staff,7,0,20,13
1683637823186,LIFR 1DX,A00,185964,Staff,7,0,20,13
1683637824214,LIGN 101,A01,186039,Staff,43,0,50,7
1683637825241,LIGN 165,A00,186040,Staff,15,0,50,35
1683637826268,LTCS 108,A00,186041,Staff,5,0,10,5
1683637827294,LTCS 119,A00,186042,Staff,15,0,20,5
1683637828321,LTCS 130,A00,186043,Wesling; Megan E.,15,0,25,10
1683637830377,LTEA 138,A00,186119,Staff,14,0,40,26
1683637831405,LTEN 124,A00,186148,Staff,5,0,25,20
1683637832433,LTEN 178,A00,186149,Staff,7,0,15,8
1683637833460,LTEN 181,A00,186150,Blanco; John D,34,0,40,6
1683637834485,LTWL 120,A00,186160,Staff,20,0,25,5
1683637835511,LTWL 165,A00,186161,Staff,22,0,25,3
1683637836541,LTWR 100,A00,186162,Staff,0,5,15,15
1683637837570,LTWR 102,A00,186163,Doller; Ben,5,0,15,10
1683637838598,MAE 8,A01,186412,Staff,0,0,0,0
1683637839627,MAE 30B,A00,186445,Bahadori; Mohammad Yousef,82,0,100,18
1683637840657,MAE 40,A00,186592,Bewley; Thomas R,10,0,50,40
1683637841686,MAE 101B,A00,186593,Bahadori; Mohammad Yousef,80,0,100,20
1683637842716,MAE 105,A00,186594,Bandaru; Prabhakar,10,0,50,40
1683637843743,MAE 107,A00,186599,Pham; Hieu Tan,0,7,120,120
1683637844767,MAE 148,A01,186660,Silberman; Jack,3,0,16,13
1683637845793,MATH 10A,A01,188095,Staff,0,5,35,35
1683637846824,MATH 10B,A01,188097,Bowers; Adam R.,0,11,30,30
1683637846824,MATH 10B,A02,188099,Bowers; Adam R.,0,11,30,30
1683637846824,MATH 10B,B01,188104,Bowers; Adam R.,0,10,30,30
1683637846824,MATH 10B,B02,188106,Bowers; Adam R.,1,9,30,29
1683637847850,MATH 10C,A01,188111,Staff,0,18,30,30
1683637847850,MATH 10C,A02,188127,Staff,0,19,30,30
1683637847850,MATH 10C,A03,188131,Staff,0,19,30,30
1683637847850,MATH 10C,B01,188218,Staff,17,0,30,13
1683637847850,MATH 10C,B02,188244,Staff,13,0,30,17
1683637847850,MATH 10C,B03,188277,Staff,14,0,30,16
1683637848876,MATH 18,A01,188344,Bach; Quang Tran,18,0,30,12
1683637848876,MATH 18,A02,188345,Bach; Quang Tran,11,0,30,19
1683637848876,MATH 18,B01,188353,Bach; Quang Tran,11,0,30,19
1683637848876,MATH 18,B02,188354,Bach; Quang Tran,19,0,30,11
1683637849905,MATH 20A,A01,188374,Staff,11,0,35,24
1683637850932,MATH 20B,A01,188382,Ohm; Ko Woon,7,0,30,23
1683637850932,MATH 20B,A02,188383,Ohm; Ko Woon,22,0,30,8
1683637850932,MATH 20B,B01,188385,Ohm; Ko Woon,7,0,30,23
1683637850932,MATH 20B,B02,188392,Ohm; Ko Woon,22,0,30,8
1683637851959,MATH 20C,A01,188394,Harel; Guershon,11,0,30,19
1683637851959,MATH 20C,A02,188395,Harel; Guershon,14,0,30,16
1683637851959,MATH 20C,B01,188404,Harel; Guershon,4,0,30,26
1683637851959,MATH 20C,B02,188405,Harel; Guershon,18,0,30,12
1683637852985,MATH 20D,A01,188414,Hammock; Frances H,0,1,30,30
1683637852985,MATH 20D,A02,188415,Hammock; Frances H,0,1,30,30
1683637852985,MATH 20D,B01,188447,Hammock; Frances H,0,1,30,30
1683637852985,MATH 20D,B02,188486,Hammock; Frances H,4,0,30,26
1683637854010,MATH 20E,A01,188649,Staff,21,0,30,9
1683637854010,MATH 20E,A02,188650,Staff,21,0,30,9
1683637854010,MATH 20E,A03,188673,Staff,0,0,30,30
1683637855035,MATH 102,A01,188675,Staff,0,36,35,35
1683637856067,MATH 103B,A01,188681,Staff,3,0,35,32
1683637856067,MATH 103B,B01,188692,Staff,5,0,35,30
1683637857094,MATH 109,A01,188695,Salehi Golsefidy; Alireza,24,0,35,11
1683637857094,MATH 109,A02,188696,Salehi Golsefidy; Alireza,25,0,35,10
1683637858121,MATH 120A,A01,188698,Eggers; John Dietrich,7,0,35,28
1683637859153,MATH 142B,A01,188736,Ioana; Adrian,0,1,30,30
1683637859153,MATH 142B,A02,188741,Ioana; Adrian,0,1,30,30
1683637859153,MATH 142B,A03,188743,Ioana; Adrian,0,1,30,30
1683637860179,MATH 168A,A01,188790,Staff,0,10,35,35
1683637861296,MATH 170A,A01,188803,Nie; Jiawang,0,2,35,35
1683637861296,MATH 170A,A02,188811,Nie; Jiawang,0,0,35,35
1683637861296,MATH 170A,A03,188814,Nie; Jiawang,0,0,35,35
1683637861296,MATH 170A,A04,188815,Nie; Jiawang,10,0,35,25
1683637862323,MATH 193B,A01,188817,Staff,0,0,35,35
1683637862323,MATH 193B,A02,188818,Staff,5,0,35,30
1683637863357,MGT 4,A01,202857,Anderson; John Charles,61,0,80,19
1683637864390,MGT 12,A00,202858,Lindenberger; Wade Douglas,40,0,90,50
1683637865419,MGT 18,A00,202859,Staff,74,0,90,16
1683637866446,MGT 18GS,A00,202860,McKay; Michael J,13,0,28,15
1683637867472,MGT 45,A00,202861,Pecore; Joseph P.,12,0,90,78
1683637868497,MGT 100,A00,202863,Yavorsky; Daniel Ryan,28,0,90,62
1683637869523,MGT 103,A00,202864,Ehrich; Kristine R,0,17,90,90
1683637870549,MGT 112,A00,202865,Ehrich; Kristine R,15,0,90,75
1683637871581,MGT 121A,A00,202868,Staff,0,20,0,0
1683637872611,MGT 131B,A00,202869,Anderson; John Charles,59,0,90,31
1683637873639,MGT 136,A00,202871,Lindenberger; Wade Douglas,83,0,90,7
1683637874670,MGT 164,A00,202873,Staff,0,66,90,91
1683637875701,MGT 164GS,A00,202874,McKay; Mary A,13,0,28,15
1683637876730,MGT 180,A00,202875,Staff,0,50,90,91
1683637877757,MMW 11R,A01,205019,Herbst; Matthew,2,0,30,28
1683637877757,MMW 11R,A02,205026,Herbst; Matthew,29,0,30,1
1683637878784,MMW 15,A01,193512,Chang; Edmond Yi-Teh,0,8,28,28
1683637878784,MMW 15,A02,193513,Chang; Edmond Yi-Teh,0,5,28,28
1683637878784,MMW 15,A03,193514,Chang; Edmond Yi-Teh,0,5,28,28
1683637878784,MMW 15,A04,193515,Chang; Edmond Yi-Teh,0,5,28,28
1683637878784,MMW 15,A05,193516,Chang; Edmond Yi-Teh,0,5,28,28
1683637878784,MMW 15,A06,193517,Chang; Edmond Yi-Teh,0,6,28,28
1683637878784,MMW 15,B01,193519,Chang; Edmond Yi-Teh,0,5,28,28
1683637878784,MMW 15,B02,193520,Chang; Edmond Yi-Teh,0,5,28,28
1683637878784,MMW 15,B03,193521,Chang; Edmond Yi-Teh,0,5,28,28
1683637878784,MMW 15,B04,193522,Chang; Edmond Yi-Teh,0,5,28,28
1683637878784,MMW 15,B05,193523,Chang; Edmond Yi-Teh,0,5,28,28
1683637878784,MMW 15,B06,193524,Chang; Edmond Yi-Teh,0,5,28,28
1683637879810,MMW 122,A01,193526,Rahimi; Babak,0,16,28,28
1683637879810,MMW 122,A02,193527,Rahimi; Babak,0,15,28,28
1683637879810,MMW 122,A03,193528,Rahimi; Babak,0,0,0,0
1683637879810,MMW 122,A04,193529,Rahimi; Babak,0,0,0,0
1683637880837,MUS 1A,A01,186663,Staff,1,20,35,34
1683637881864,MUS 4,A01,186715,Staff,0,12,35,35
1683637882892,MUS 5R,A01,186796,Dubnov; Shlomo,0,17,35,35
1683637883918,MUS 6,A01,186798,Staff,0,5,25,25
1683637884946,MUS 7,A01,186830,Staff,11,0,35,24
1683637885976,MUS 8,A01,186930,Staff,0,26,35,35
1683637887008,MUS 15,A01,186932,Staff,0,16,35,35
1683637887008,MUS 15,B01,186934,Staff,0,17,35,35
1683637888037,MUS 80,A00,186935,Staff,0,0,20,20
1683637888037,MUS 80,B00,186936,Staff,24,0,25,1
1683637889069,NANO 11,A00,204702,Lipomi; Darren John,0,0,0,0
1683637890101,NANO 15,A01,204709,Yang; Kesong,0,1,0,0
1683637891131,NANO 114,A00,202069,Jahed Motlagh; Zeinab,3,0,10,7
1683637892159,PHIL 1,A00,186955,Grush; Rick Scott,31,0,40,9
1683637893185,PHIL 10,A01,186973,Grush; Rick Scott,27,0,35,8
1683637893185,PHIL 10,A02,186974,Grush; Rick Scott,33,0,35,2
1683637894213,PHIL 13,A01,186976,Staff,3,0,35,32
1683637894213,PHIL 13,A02,186977,Staff,16,0,35,19
1683637895242,PHIL 14,A01,186979,Staff,31,0,35,4
1683637895242,PHIL 14,A02,186986,Staff,32,0,35,3
1683637896271,PHIL 28,A01,186988,Staff,16,0,30,14
1683637896271,PHIL 28,A02,186989,Staff,1,0,30,29
1683637896271,PHIL 28,A03,186990,Staff,10,0,30,20
1683637896271,PHIL 28,A04,186991,Staff,26,0,30,4
1683637897301,PHIL 120,A00,186997,Staff,23,0,40,17
1683637898329,PHIL 137,A00,187003,Staff,7,0,40,33
1683637899352,PHIL 150,A00,187015,Staff,47,0,70,23
1683637900380,PHIL 167,A00,187021,Lamey; Andy M.,34,0,40,6
1683637901407,PHIL 174,A01,202226,Staff,17,0,20,3
1683637901407,PHIL 174,A02,202235,Staff,20,0,20,0
1683637902433,PHIL 191A,A00,258918,Staff,0,0,1,1
1683637903459,PHYS 1A,A00,187028,Staff,27,0,60,33
1683637904489,PHYS 1AL,001,187036,Staff,3,0,30,27
1683637904489,PHYS 1AL,002,187049,Staff,18,0,30,12
1683637905516,PHYS 1B,A00,187058,Staff,22,0,60,38
1683637906546,PHYS 1BL,001,187064,Staff,0,1,30,30
1683637906546,PHYS 1BL,002,187070,Staff,4,0,30,26
1683637907573,PHYS 1C,A00,187082,Staff,29,0,120,91
1683637908599,PHYS 1CL,001,187088,Staff,0,9,30,30
1683637908599,PHYS 1CL,002,187089,Staff,0,1,30,30
1683637908599,PHYS 1CL,009,262693,Staff,9,0,30,21
1683637909637,PHYS 2B,A01,187097,Staff,55,0,115,60
1683637910665,PHYS 2C,A01,187099,Staff,64,0,115,51
1683637911695,PHYS 2CL,A01,187101,Staff,5,0,28,23
1683637911695,PHYS 2CL,A02,187102,Staff,15,0,28,13
1683637912727,PHYS 2D,A01,187123,Shotwell; Brian,95,0,115,20
1683637913754,PHYS 4B,A01,187133,Grinstein; Benjamin,35,0,50,15
1683637914842,POLI 10,A00,188819,Staff,0,4,50,50
1683637915869,POLI 11,A00,188827,Staff,43,0,50,7
1683637916895,POLI 13R,A00,188828,Staff,0,1,20,20
1683637917924,POLI 27,A01,188830,Elgin; Samuel Zincke,0,2,70,70
1683637918951,POLI 30,A00,188832,Desposato; Scott,30,0,50,20
1683637919978,POLI 102F,A00,188834,Staff,0,0,40,40
1683637921001,POLI 104A,A00,188852,Staff,13,0,30,17
1683637922024,POLI 104I,A00,188853,Staff,0,7,20,20
1683637923054,POLI 110B,A00,188854,Wiens; David,7,0,20,13
1683637924084,POLI 112A,A00,188855,Wiens; David,4,0,30,26
1683637925113,POLI 117R,A00,188856,Forman; Fonna,0,12,20,20
1683637926139,POLI 118,A00,188857,Ingham; Sean,8,0,20,12
1683637927168,POLI 120G,A00,188858,Staff,8,0,30,22
1683637928198,POLI 131CR,A00,188863,Hoston; Germaine,21,0,50,29
1683637929223,POLI 133,A00,188864,Nellis; Gareth Hb,44,0,50,6
1683637930247,POLI 134D,A00,188865,Desposato; Scott,27,0,30,3
1683637931273,POLI 142A,A00,188871,Gartzke; Erik,21,0,50,29
1683637932302,POLI 142K,A00,188874,Staff,38,0,50,12
1683637933329,POLI 143,A00,188940,Gartzke; Erik,16,0,30,14
1683637934360,POLI 153,A00,188943,Staff,2,0,20,18
1683637935388,POLI 160AA,A00,188944,Staff,11,0,40,29
1683637936417,POLI 170A,A00,188945,Staff,11,0,30,19
1683637938471,PSYC 1,A00,188952,Staff,36,0,90,54
1683637939500,PSYC 2,B00,188953,Staff,19,0,35,16
1683637940526,PSYC 6,A00,188970,Staff,47,0,60,13
1683637941558,PSYC 7,A00,188973,Staff,35,0,45,10
1683637942587,PSYC 60,A01,188980,Rickard; Timothy C.,42,0,60,18
1683637943617,PSYC 70,A01,189001,Steiner; Eric Tomas,23,0,45,22
1683637944647,PSYC 100,A00,189005,Lacefield; Katharine I,0,99,120,120
1683637945675,PSYC 102,A00,189008,Staff,8,0,30,22
1683637946701,PSYC 106,B00,189026,Gorman; Michael R.,27,0,60,33
1683637947727,PSYC 114,B01,189033,Winkielman; Piotr,0,31,30,30
1683637948751,PSYC 131,A00,189036,Anagnostaras; Stephan,0,43,60,60
1683637949780,PSYC 136,A00,189041,Lowe; Angela Beth,0,7,25,25
1683637950805,PSYC 137,A00,189057,Winkielman; Piotr,0,37,25,25
1683637951829,PSYC 144,A00,189107,Wixted; John T,0,10,50,50
1683637953879,PSYC 162,A00,189142,Staff,0,9,85,85
1683637954902,PSYC 172,A00,189144,Gorman; Michael R.,0,6,30,30
1683637956952,PSYC 179,A00,189146,Lacefield; Katharine I,0,86,120,120
1683637957978,PSYC 181,A00,189147,Anagnostaras; Stephan,0,44,90,90
1683637959007,PSYC 190R,A00,189148,Barner; David A.,0,23,80,80
1683637960033,PSYC 191,A00,189275,Rickard; Timothy C.,0,10,25,25
1683637961058,PSYC 193,A00,189276,Chapman; Eddie Nathaniel,0,1,0,4
1683637962083,PSYC 193L,A01,189281,Lowe; Angela Beth,10,0,20,10
1683637962083,PSYC 193L,B01,189285,Staff,28,0,35,7
1683637963112,RELI 149,A00,187137,Rahimi; Babak,7,0,40,33
1683637964140,SE 9,A01,187315,Staff,0,2,18,18
1683637965164,SE 101B,A00,187409,Staff,24,0,30,6
1683637966189,SE 110B,A00,187444,Staff,10,0,40,30
1683637967214,SE 130B,A00,187449,Staff,31,0,40,9
1683637968241,SE 150A,A00,187516,Staff,9,0,20,11
1683637969267,SE 154,A00,187528,Staff,29,0,50,21
1683637970295,SIO 3,A01,258171,Staff,35,0,40,5
1683637971324,SIO 10,A00,187144,Cook; Geoffrey W,0,6,75,75
1683637972352,SIO 45,A00,187152,Cook; Geoffrey W,0,4,100,100
1683637973381,SIO 109R,A00,194486,Staff,0,4,20,20
1683637975438,SIO 187,A01,187233,Kacev; David,12,0,40,28
1683637976474,SOCI 1,A01,258656,Thorpe; Charles Robert,28,0,30,2
1683637976474,SOCI 1,A02,258658,Thorpe; Charles Robert,30,0,30,0
1683637976474,SOCI 1,A03,258661,Thorpe; Charles Robert,25,0,25,0
1683637976474,SOCI 1,A04,258666,Thorpe; Charles Robert,22,0,25,3
1683637976474,SOCI 1,A05,258897,Thorpe; Charles Robert,22,0,25,3
1683637976474,SOCI 1,A06,258898,Thorpe; Charles Robert,25,0,25,0
1683637977499,SOCI 30,A01,258903,Pardo Guerra; Juan Pablo,14,0,30,16
1683637978531,SOCI 102,A00,258904,Staff,9,0,25,16
1683637979560,SOCI 106,A00,258905,Staff,19,0,25,6
1683637980585,SOCI 111,A00,258907,Ribas Norris; Janet Vanesa,26,0,30,4
1683637981610,SOCI 121R,A00,258908,Pardo Guerra; Juan Pablo,8,0,30,22
1683637982638,SOCI 126,A01,203330,Staff,14,0,20,6
1683637983662,SOCI 131,A00,258909,Thorpe; Charles Robert,30,0,60,30
1683637984689,SOCI 135,A00,258910,Payne; Christine Anna,0,11,30,30
1683637985717,SOCI 157,A00,258911,Staff,12,0,30,18
1683637986744,SOCI 184,A00,258912,Staff,25,0,30,5
1683637987773,SOCI 188D,A00,258913,Staff,22,0,30,8
1683637988799,SYN 2,001,187529,Staff,9,0,16,7
1683637988799,SYN 2,002,201452,Staff,0,20,16,16
1683637988799,SYN 2,003,201469,Staff,2,0,16,14
1683637989825,SYN 100,A01,187531,Staff,0,9,20,20
1683637989825,SYN 100,B01,201491,Staff,0,10,20,20
1683637990851,TDAC 1,A00,189286,Walsh; Kim C.,3,0,20,17
1683637990851,TDAC 1,B00,189287,Harting; Carla Kelso,10,0,20,10
1683637991881,TDAC 101,A00,189300,Walsh; Kim C.,16,0,20,4
1683637991881,TDAC 101,B00,189301,Harting; Carla Kelso,18,0,20,2
1683637992906,TDAC 102,A00,189304,Basso; Beatrice,14,0,20,6
1683637993932,TDAC 108,A00,189305,Staff,18,0,20,2
1683637994960,TDDE 131,A00,189310,Staff,19,0,20,1
1683637994960,TDDE 131,B00,189314,Staff,19,0,20,1
1683637994960,TDDE 131,C00,189315,Staff,48,0,50,2
1683637994960,TDDE 131,D00,189316,Staff,14,0,15,1
1683637994960,TDDE 131,E00,204841,Staff,20,0,20,0
1683637995989,TDGE 10,A00,189289,Staff,27,0,50,23
1683637995989,TDGE 10,B00,189290,Havis; Allan,0,0,50,50
1683637997016,TDGE 11,A00,189291,Fulton; Julia,0,4,50,50
1683637997016,TDGE 11,B00,189292,Staff,20,0,25,5
1683637997016,TDGE 11,C00,260270,Staff,0,0,0,0
1683637998041,TDGE 25,A00,189294,Staff,2,0,20,18
1683637999068,TDGE 124,A00,189318,Fulton; Julia,0,8,50,50
1683638000093,TDGE 125,A00,189319,Staff,13,0,25,12
1683638000093,TDGE 125,B00,189320,Staff,23,0,25,2
1683638001119,TDGE 127,A00,189322,Havis; Allan,0,0,50,50
1683638002148,TDHT 101,A00,189323,Staff,18,0,25,7
1683638002148,TDHT 101,B00,189324,Staff,25,0,25,0
1683638003178,TDHT 102,A00,189325,Staff,49,0,50,1
1683638004210,TDMV 1,A00,189295,Arcidiacono; Kristin,20,0,30,10
1683638004210,TDMV 1,B00,189296,Caligagan; Maria T.,24,0,30,6
1683638005239,TDMV 2,A00,189297,Sammartano; Tonnie,27,0,30,3
1683638005239,TDMV 2,B00,189299,Arcidiacono; Kristin,23,0,30,7
1683638006266,TDMV 3,A00,204998,Rincon; Alicia,22,0,30,8
1683638007290,TDMV 120,A00,189458,Sammartano; Tonnie,28,0,30,2
1683638008317,TDMV 138,A00,189541,Jun; Grace Shin Hae,20,0,40,20
1683638009343,TDMV 142,A00,189717,Caligagan; Tony,25,0,30,5
1683638009343,TDMV 142,B00,189718,Caligagan; Maria T.,25,0,30,5
1683638010368,TMC 2,A01,187533,Staff,25,0,25,0
1683638010368,TMC 2,A02,187534,Staff,25,0,25,0
1683638011394,USP 1,A01,187536,Kwak; Nancy,0,16,25,25
1683638012419,USP 5,A01,187538,Staff,9,0,25,16
1683638013448,USP 101,A00,199253,Staff,0,4,0,0
1683638014478,USP 124,A00,187562,Boomhower; Matthew Charles,0,0,30,30
1683638015504,USP 138,A00,187582,Staff,20,0,25,5
1683638016532,USP 152,A01,187597,Staff,3,0,25,22
1683638017557,USP 153,A00,187598,Staff,19,0,25,6
1683638018646,USP 168,A00,187607,Kwak; Nancy,2,0,5,3
1683638019671,USP 173,A00,187619,Staff,4,0,25,21
1683638020698,USP 181,A00,187638,Staff,0,4,25,25
1683638021728,VIS 103,A00,187650,Cruz; Edwin Teddy,18,0,75,57
1683638022753,VIS 110D,A00,187669,Staff,13,0,22,9
1683638023783,VIS 127C,A00,187720,Shen; Kuiyi,67,0,146,79
1683638024808,VIS 149,A00,187731,Yoldas; Pinar,0,14,22,22
1683638025837,VIS 151,A01,188091,Staff,22,0,34,12
1683638025837,VIS 151,A02,188092,Staff,11,0,34,23
1683638026867,VIS 160B,A00,188093,Stalbaum; Brett,0,1,10,10
1683638028923,WCWP 10B,A00,201720,Staff,10,0,15,5
1683638028923,WCWP 10B,B00,201722,Staff,9,0,15,6
1683638029954,WCWP 100,A00,201725,Gagnon; Jeffrey C,0,0,2,2
1683638029954,WCWP 100,B00,201727,Staff,0,4,15,15
1683638033114,ANBI 133,A00,258401,Wilder; Linnea Lorene,34,0,40,6
1683638034145,ANBI 140,A00,258395,Hrvoj Mihic; Branka,18,0,25,7
1683638035174,ANSC 120,A00,258402,Bialecki; Jon Anthony,27,0,40,13
1683638036199,ANSC 144,A00,258400,Staff,12,0,40,28
1683638038249,ANSC 166,A00,258396,Parish; Steven Martin,156,0,175,19
1683638039274,ANSC 180,A00,193533,Staff,8,0,20,12
1683638040303,ANSC 188,A00,258397,Jassal; Aftab,34,0,40,6
1683638041333,ANTH 3,A01,258316,Staff,23,0,30,7
1683638042359,ANTH 5,A00,258394,Semendeferi; Ekaterini,16,0,20,4
1683638043385,ANTH 21,A01,258331,Staff,4,0,40,36
1683638044409,ANTH 103,A00,258398,Varma; Saiba,15,0,25,10
1683638045440,AWP 10,001,202034,Staff,0,0,0,0
1683638045440,AWP 10,002,202035,Staff,0,0,0,0
1683638045440,AWP 10,003,202036,Staff,0,0,0,0
1683638045440,AWP 10,004,202037,Staff,0,0,0,0
1683638045440,AWP 10,005,202038,Staff,0,0,0,0
1683638045440,AWP 10,006,202039,Staff,0,0,0,0
1683638045440,AWP 10,007,202040,Staff,0,0,0,0
1683638045440,AWP 10,008,202041,Staff,0,0,0,0
1683638045440,AWP 10,009,202042,Staff,0,0,0,0
1683638045440,AWP 10,010,202043,Staff,0,0,0,0
1683638045440,AWP 10,011,202044,Staff,0,0,0,0
1683638045440,AWP 10,012,202045,Staff,0,0,0,0
1683638045440,AWP 10,013,202046,Staff,0,0,0,0
1683638045440,AWP 10,014,202047,Staff,0,0,0,0
1683638045440,AWP 10,015,202048,Staff,0,0,0,0
1683638045440,AWP 10,016,202049,Staff,0,0,0,0
1683638045440,AWP 10,017,202050,Staff,0,0,0,0
1683638045440,AWP 10,018,202051,Staff,0,0,0,0
1683638045440,AWP 10,019,202052,Staff,0,0,0,0
1683638045440,AWP 10,020,202053,Staff,0,0,0,0
1683638045440,AWP 10,021,202054,Staff,0,0,0,0
1683638045440,AWP 10,022,202055,Staff,0,0,0,0
1683638045440,AWP 10,023,202056,Staff,0,0,0,0
1683638045440,AWP 10,024,202057,Staff,0,0,0,0
1683638045440,AWP 10,025,202058,Staff,0,0,0,0
1683638045440,AWP 10,026,202059,Staff,0,0,0,0
1683638046466,AWP 102,001,202032,Staff,0,0,0,0
1683638046466,AWP 102,002,202033,Staff,0,0,0,0
1683638047490,BENG 100,A01,254234,Taylor Amos; Alyssa C,31,0,40,9
1683638048516,BENG 196,001,270013,Engler; Adam J.,9999,0,9999,0
1683638049544,BICD 100R,A01,202018,Smith; Laurie,0,7,32,32
1683638049544,BICD 100R,A02,202019,Smith; Laurie,0,3,32,32
1683638049544,BICD 100R,A03,202020,Smith; Laurie,0,1,32,32
1683638049544,BICD 100R,A04,202021,Smith; Laurie,6,0,32,26
1683638049544,BICD 100R,A05,202022,Smith; Laurie,11,0,32,21
1683638050577,BICD 136,A01,193242,Gustafson-Brown; Cindy,0,2,32,32
1683638050577,BICD 136,A02,193244,Gustafson-Brown; Cindy,13,0,32,19
1683638051609,BIEB 102,A01,193249,Butler; Shannon Rhey,0,2,32,32
1683638051609,BIEB 102,A02,193251,Butler; Shannon Rhey,0,0,32,32
1683638051609,BIEB 102,A03,193253,Butler; Shannon Rhey,0,0,32,32
1683638051609,BIEB 102,A04,193255,Butler; Shannon Rhey,14,0,32,18
1683638051609,BIEB 102,A05,193265,Butler; Shannon Rhey,26,0,32,6
1683638051609,BIEB 102,A06,193269,Butler; Shannon Rhey,14,0,32,18
1683638053663,BIEB 150,A01,193274,Staff,0,0,32,32
1683638053663,BIEB 150,A02,193285,Staff,24,0,32,8
1683638054690,BIEB 194,A00,193286,Kurle; Carolyn M.,20,0,32,12
1683638055718,BILD 1,A01,192291,Staff,15,0,32,17
1683638055718,BILD 1,A02,192292,Staff,30,0,32,2
1683638055718,BILD 1,B01,192520,Reuther; Keefe,0,1,0,0
1683638055718,BILD 1,B02,192532,Reuther; Keefe,0,1,0,0
1683638056743,BILD 3,A01,192556,Butler; Shannon Rhey,0,0,32,32
1683638056743,BILD 3,A02,192581,Butler; Shannon Rhey,1,0,32,31
1683638056743,BILD 3,A03,192611,Butler; Shannon Rhey,21,0,32,11
1683638056743,BILD 3,A04,192612,Butler; Shannon Rhey,24,0,32,8
1683638056743,BILD 3,A05,192613,Butler; Shannon Rhey,26,0,32,6
1683638056743,BILD 3,A06,192679,Butler; Shannon Rhey,27,0,32,5
1683638056743,BILD 3,A07,192682,Butler; Shannon Rhey,20,0,32,12
1683638057770,BILD 4,A01,192836,Reuther; Keefe,0,0,24,24
1683638057770,BILD 4,A02,193044,Reuther; Keefe,4,0,24,20
1683638058795,BILD 10,A01,193142,Gustafson-Brown; Cindy,29,0,32,3
1683638058795,BILD 10,A02,193149,Gustafson-Brown; Cindy,31,0,32,1
1683638059820,BIMM 100,A01,193301,Staff,0,6,32,32
1683638059820,BIMM 100,A02,193312,Staff,0,7,32,32
1683638059820,BIMM 100,A03,193323,Staff,0,9,32,32
1683638060847,BIMM 101,A01,193329,McDonnell; Lisa Marie,0,4,24,24
1683638060847,BIMM 101,A02,193339,McDonnell; Lisa Marie,0,3,24,24
1683638060847,BIMM 101,B01,193354,McDonnell; Lisa Marie,0,4,24,24
1683638060847,BIMM 101,B02,193357,McDonnell; Lisa Marie,0,2,24,24
1683638061875,BIMM 110,A01,193377,Tat; John,0,11,32,32
1683638061875,BIMM 110,A02,193378,Tat; John,0,10,32,32
1683638062901,BIMM 120,A01,206116,Staff,0,0,32,32
1683638062901,BIMM 120,A02,206117,Staff,6,0,32,26
1683638062901,BIMM 120,A03,206121,Staff,21,0,32,11
1683638063926,BIPN 100,A01,193393,Park; Ji Young,0,14,32,32
1683638063926,BIPN 100,A02,193402,Park; Ji Young,0,14,32,32
1683638063926,BIPN 100,A03,193413,Park; Ji Young,0,14,32,32
1683638063926,BIPN 100,A04,193414,Park; Ji Young,0,13,32,32
1683638064952,BIPN 102,A01,193429,Staff,0,0,32,32
1683638064952,BIPN 102,A02,193438,Staff,18,0,32,14
1683638065979,BIPN 106,A01,193450,Reyes Gonzalez; Catalina,0,2,40,40
1683638067004,BIPN 134,A01,193465,Cooke; James Edward,0,0,32,32
1683638067004,BIPN 134,A02,193474,Cooke; James Edward,25,0,32,7
1683638067004,BIPN 134,A03,193485,Cooke; James Edward,29,0,32,3
1683638067004,BIPN 134,A04,193486,Cooke; James Edward,20,0,32,12
1683638067004,BIPN 134,A05,193491,Cooke; James Edward,31,0,32,1
1683638067004,BIPN 134,A06,193501,Cooke; James Edward,30,0,32,2
1683638067004,BIPN 134,A07,193510,Cooke; James Edward,29,0,32,3
1683638069059,BISP 194,A00,222522,Staff,14,0,32,18
1683638070087,CAT 124,A01,202407,Staff,19,0,25,6
1683638071114,CAT 125,A00,202408,Marchisotto; Jennifer Anne,2,0,20,18
1683638072148,CAT 125R,A00,202409,Smith; Lauryn Alissa,0,11,20,20
1683638072148,CAT 125R,B00,202410,Morales; Celeste Georgianna,0,11,20,20
1683638072148,CAT 125R,C00,202411,Irwin; Matthew Joseph,0,12,20,20
1683638073180,CENG 15,A01,204712,Yang; Kesong,0,1,0,0
1683638074225,CENG 114,A00,202070,Jahed Motlagh; Zeinab,5,0,20,15
1683638075257,CGS 105,A00,185477,Wesling; Megan E.,24,0,40,16
1683638076281,CGS 106,A00,185494,Staff,11,0,22,11
1683638077305,CGS 108,A00,185495,Staff,14,0,20,6
1683638078334,CGS 114,A00,185496,Staff,13,0,18,5
1683638079362,CGS 119,A00,185501,Staff,15,0,20,5
1683638080391,CGS 120,A00,185511,Staff,12,0,20,8
1683638081422,CHEM 4,A01,184675,Bussey; Thomas J,97,0,100,3
1683638082449,CHEM 6A,A01,184677,Staff,33,0,60,27
1683638083476,CHEM 6B,A01,184679,Staff,63,0,100,37
1683638084504,CHEM 6C,A01,184681,Bussey; Thomas J,0,0,50,50
1683638084504,CHEM 6C,A02,184682,Bussey; Thomas J,32,0,50,18
1683638085541,CHEM 40A,A01,184684,Albizati; Kim F.,35,0,100,65
1683638086571,CHEM 40B,A01,184686,Albizati; Kim F.,0,22,100,100
1683638087597,CHEM 41B,A01,184690,Staff,51,0,100,49
1683638088625,COGS 3,A01,184715,Boyle; Mary E. T.,0,27,40,40
1683638089652,COGS 14B,A01,185172,Staff,0,14,38,38
1683638090678,COGS 18,A01,184736,Staff,15,0,80,65
1683638091703,COGS 100,A01,184932,Staff,0,7,73,73
1683638092729,COGS 101A,A01,184935,Staff,0,39,30,30
1683638093757,COGS 101B,A01,184944,Staff,0,2,30,30
1683638094785,COGS 101C,A01,184946,Staff,0,10,30,30
1683638095813,COGS 102A,A01,184951,Johnson; Christine M.,2,0,40,38
1683638096845,COGS 107B,A01,184953,Mooshagian; Eric Frederick,0,51,40,40
1683638097875,COGS 118B,A01,184959,Gupta; Anjum,0,49,40,40
1683638098899,COGS 153,A00,184961,Staff,0,16,30,30
1683638099923,COGS 177,A00,184962,Staff,0,21,30,30
1683638100947,COGS 187A,A01,184969,Boyle; Mary E. T.,0,19,40,40
1683638101973,COMM 10,A01,185174,Staff,0,5,25,25
1683638101973,COMM 10,A02,185189,Staff,0,2,25,25
1683638101973,COMM 10,A03,269821,Staff,0,1,0,0
1683638103000,COMM 100B,A01,185475,Staff,0,1,0,2
1683638103000,COMM 100B,A02,185476,Staff,12,0,25,13
1683638104028,COMM 100C,A01,185314,Staff,1,0,25,24
1683638104028,COMM 100C,A02,185327,Staff,18,0,25,7
1683638105055,COMM 110M,A00,185349,Staff,0,0,40,40
1683638106080,COMM 113T,A00,185352,Staff,25,0,40,15
1683638107105,COMM 114I,A00,185353,Staff,31,0,40,9
1683638108131,COMM 131,A00,185354,Staff,17,0,30,13
1683638109162,CSE 8A,A50,185358,Cao; Yingjun,0,46,10,10
1683638110187,CSE 8B,A01,185362,Staff,0,48,50,50
1683638111211,CSE 11,A01,185416,Cao; Yingjun,0,91,10,10
1683638112241,CSE 20,A01,185445,Briones; Jor-el Thomas Caparas,4,0,25,21
1683638113271,CSE 21,A01,185447,Staff,9,0,50,41
1683638114300,CSE 101,A01,185451,Staff,0,13,50,50
1683638114300,CSE 101,B01,185453,Jones; Miles E,0,13,50,50
1683638116354,CSE 141,A01,185458,Eldon; John,15,0,100,85
1683638117384,CSE 141L,A01,185461,Eldon; John,7,0,100,93
1683638118409,CSE 142,A01,185463,Staff,36,0,60,24
1683638118409,CSE 142,B01,201355,Staff,0,7,60,60
1683638119433,CSE 142L,A01,185470,Staff,36,0,60,24
1683638119433,CSE 142L,B01,201417,Staff,0,6,60,60
1683638120460,CSE 190,A00,201433,Staff,32,0,49,17
1683638121486,DOC 1,A01,259136,Strom; Megan C.,7,0,15,8
1683638121486,DOC 1,A02,259137,Strom; Megan C.,14,0,15,1
1683638121486,DOC 1,A03,259138,Strom; Megan C.,14,0,15,1
1683638121486,DOC 1,A04,259139,Strom; Megan C.,14,0,15,1
1683638122588,DOC 100D,A00,259140,Pass; Natalye Joann,14,0,25,11
1683638123613,DSGN 1,A01,184749,Rill; Bryan,0,26,30,30
1683638124638,DSGN 100,A01,185168,Staff,0,2,25,25
1683638125667,ECE 5,A01,185626,Morris; Karcher William,0,11,0,0
1683638126695,ECE 101,A01,185628,Staff,14,0,70,56
1683638127723,ECE 107,A01,185635,Baghdadchi; Saharnaz,0,0,20,20
1683638127723,ECE 107,A02,185638,Baghdadchi; Saharnaz,3,0,20,17
1683638128753,ECE 148,A01,185647,Silberman; Jack,0,0,16,16
1683638129782,ECON 1,A01,185537,Crane; Meredith Helen,54,0,70,16
1683638130808,ECON 3,A01,185549,Crane; Meredith Helen,29,0,70,41
1683638131834,ECON 4,A01,203354,Anderson; John Charles,0,5,10,10
1683638132859,ECON 100A,A01,185574,Staff,0,5,40,40
1683638133883,ECON 100B,A01,185576,Staff,0,12,50,50
1683638134907,ECON 100C,A01,185589,Newhouse; Herbert S,30,0,70,40
1683638135935,ECON 105,A00,185608,Vespa; Emanuel Ignacio,19,0,35,16
1683638136963,ECON 109,A01,185610,Shishkin; Denis,9,0,35,26
1683638137991,ECON 110A,A01,185612,Staff,9,0,40,31
1683638139016,ECON 120A,A01,185615,Staff,20,0,40,20
1683638140041,ECON 120C,A01,185617,Sun; Yixiao,0,20,70,70
1683638141066,ECON 144,A00,203346,Squires; Dale E,2,0,35,33
1683638142091,ECON 171,A01,203349,Newhouse; Herbert S,0,1,35,35
1683638143121,ECON 173A,A01,185621,Toda; Alexis Akira,21,0,35,14
1683638144155,EDS 25,A01,202413,Staff,0,1,0,0
1683638144155,EDS 25,A02,202414,Staff,0,1,0,0
1683638144155,EDS 25,A03,202415,Staff,0,0,0,0
1683638144155,EDS 25,A04,202416,Staff,0,1,0,0
1683638144155,EDS 25,A05,202439,Staff,0,0,0,0
1683638144155,EDS 25,A06,202440,Staff,0,0,0,0
1683638144155,EDS 25,B01,202631,Staff,0,0,0,0
1683638144155,EDS 25,B02,202632,Staff,0,0,0,0
1683638144155,EDS 25,B03,202639,Staff,0,0,0,0
1683638144155,EDS 25,B04,202640,Staff,0,0,0,0
1683638144155,EDS 25,B05,202643,Staff,0,0,0,0
1683638144155,EDS 25,B06,202644,Staff,0,0,0,0
1683638145182,EDS 38,A01,202659,Black; Alison Michelle,24,0,25,1
1683638146208,EDS 115,A00,202652,Staff,18,0,30,12
1683638147233,EDS 125,A00,202649,Staff,13,0,30,17
1683638148257,EDS 126,A01,203332,Staff,30,0,30,0
1683638149281,EDS 139,A00,202838,Staff,16,0,25,9
1683638150311,EDS 146,A01,202655,Staff,14,0,25,11
1683638151338,ENG 15,A00,185667,Staff,0,1,0,0
1683638151338,ENG 15,B00,185672,Staff,0,0,0,0
1683638151338,ENG 15,C00,185675,Staff,0,0,0,0
1683638151338,ENG 15,D00,185682,Staff,0,0,0,0
1683638151338,ENG 15,E00,185684,Staff,0,0,0,0
1683638152362,ETHN 103,A00,185710,Staff,0,8,35,35
1683638153392,ETHN 103A,A00,199228,Man; Simeon S,0,0,9,9
1683638154421,ETHN 109,A00,185711,Staff,16,0,35,19
1683638155446,ETHN 142,A00,185726,Staff,0,4,30,30
1683638156471,ETHN 163J,A00,199229,Man; Simeon S,5,0,8,3
1683638157497,ETHN 168,A00,185727,Staff,7,0,10,3
1683638158522,ETHN 182,A00,185728,Staff,0,0,35,35
1683638159549,ETHN 183,A00,185737,Staff,9,0,18,9
1683638160580,GLBH 111,A01,209361,Burgos; Jose L.,0,0,0,0
1683638162663,HIEU 104,A00,185792,Staff,14,0,20,6
1683638163689,HIEU 115,A00,185800,Staff,0,0,20,20
1683638164712,HIEU 128,A00,185801,Staff,0,9,20,20
1683638165740,HIEU 147,A00,185802,Staff,15,0,20,5
1683638166766,HIEU 154,A00,185823,Staff,11,0,20,9
1683638167790,HILA 102,A00,185826,Staff,14,0,20,6
1683638168817,HILD 2C,A01,185778,Staff,0,13,20,20
1683638169846,HILD 7B,A01,185780,Kwak; Nancy,0,16,32,32
1683638169846,HILD 7B,A02,185781,Kwak; Nancy,0,18,32,32
1683638170870,HILD 30,A01,185791,Staff,12,0,20,8
1683638171900,HISC 119,A00,185830,Golan; Tal,0,9,20,20
1683638172930,HITO 156GS,A00,185831,Patterson; Patrick H.,0,0,0,23
1683638173958,HIUS 103,A00,185832,Man; Simeon S,0,4,20,20
1683638174986,HIUS 117,A00,185836,Kwak; Nancy,2,0,20,18
1683638176011,HIUS 125,A00,185840,Man; Simeon S,0,1,23,23
1683638177036,HIUS 149,A00,185845,Staff,1,0,20,19
1683638178071,HUM 3,A01,185882,Zavodny; Tatiana Sophia,0,7,50,50
1683638178071,HUM 3,B01,185899,Caldwell; Michael Alan,0,18,50,50
1683638179101,HUM 3GS,A00,185900,Patterson; Patrick H.,0,0,0,23
1683638180132,HUM 4,A01,185938,Zroka; Amy Liane,30,0,50,20
1683638180132,HUM 4,B01,185956,Watkins; Eric,0,4,50,50
1683638180132,HUM 4,B02,202209,Watkins; Eric,0,4,50,50
1683638180132,HUM 4,B03,202210,Watkins; Eric,0,4,50,50
1683638181168,HUM 5,A01,185958,West; Geoffrey Scott,2,0,50,48
1683638181168,HUM 5,A02,202215,West; Geoffrey Scott,0,0,50,50
1683638182194,INTL 190,A00,185959,Gagnon; Jeffrey C,0,0,0,9
1683638182194,INTL 190,B00,185960,Lettieri; Michael Joseph,0,0,0,2
1683638183219,JAPN 180,A00,254509,Staff,5,0,30,25
1683638184248,LATI 10,A01,202853,Kennemore; Amy Michelle,4,0,35,31
1683638184248,LATI 10,A02,202854,Kennemore; Amy Michelle,2,0,35,33
1683638184248,LATI 10,A03,270054,Kennemore; Amy Michelle,30,0,30,0
1683638185273,LATI 180,A00,202855,Kennemore; Amy Michelle,11,0,20,9
1683638186298,LAWS 101,A00,201767,Golan; Tal,0,7,40,40
1683638187323,LIFR 1C,A00,185961,Staff,6,0,20,14
1683638188349,LIFR 1CX,A00,185962,Staff,7,0,20,13
1683638189374,LIFR 1D,A00,185963,Staff,7,0,20,13
1683638190402,LIFR 1DX,A00,185964,Staff,7,0,20,13
1683638191430,LIGN 101,A01,186039,Staff,43,0,50,7
1683638192457,LIGN 165,A00,186040,Staff,15,0,50,35
1683638193482,LTCS 108,A00,186041,Staff,5,0,10,5
1683638194509,LTCS 119,A00,186042,Staff,15,0,20,5
1683638195534,LTCS 130,A00,186043,Wesling; Megan E.,15,0,25,10
1683638197585,LTEA 138,A00,186119,Staff,14,0,40,26
1683638198613,LTEN 124,A00,186148,Staff,5,0,25,20
1683638199641,LTEN 178,A00,186149,Staff,7,0,15,8
1683638200667,LTEN 181,A00,186150,Blanco; John D,34,0,40,6
1683638201691,LTWL 120,A00,186160,Staff,20,0,25,5
1683638202719,LTWL 165,A00,186161,Staff,22,0,25,3
1683638203745,LTWR 100,A00,186162,Staff,0,5,15,15
1683638204769,LTWR 102,A00,186163,Doller; Ben,5,0,15,10
1683638205795,MAE 8,A01,186412,Staff,0,0,0,0
1683638206821,MAE 30B,A00,186445,Bahadori; Mohammad Yousef,82,0,100,18
1683638207846,MAE 40,A00,186592,Bewley; Thomas R,10,0,50,40
1683638208875,MAE 101B,A00,186593,Bahadori; Mohammad Yousef,80,0,100,20
1683638209903,MAE 105,A00,186594,Bandaru; Prabhakar,10,0,50,40
1683638210933,MAE 107,A00,186599,Pham; Hieu Tan,0,7,120,120
1683638211960,MAE 148,A01,186660,Silberman; Jack,3,0,16,13
1683638212990,MATH 10A,A01,188095,Staff,0,5,35,35
1683638214016,MATH 10B,A01,188097,Bowers; Adam R.,0,11,30,30
1683638214016,MATH 10B,A02,188099,Bowers; Adam R.,0,11,30,30
1683638214016,MATH 10B,B01,188104,Bowers; Adam R.,0,10,30,30
1683638214016,MATH 10B,B02,188106,Bowers; Adam R.,1,9,30,29
1683638215041,MATH 10C,A01,188111,Staff,0,18,30,30
1683638215041,MATH 10C,A02,188127,Staff,0,19,30,30
1683638215041,MATH 10C,A03,188131,Staff,0,19,30,30
1683638215041,MATH 10C,B01,188218,Staff,17,0,30,13
1683638215041,MATH 10C,B02,188244,Staff,13,0,30,17
1683638215041,MATH 10C,B03,188277,Staff,14,0,30,16
1683638216068,MATH 18,A01,188344,Bach; Quang Tran,18,0,30,12
1683638216068,MATH 18,A02,188345,Bach; Quang Tran,11,0,30,19
1683638216068,MATH 18,B01,188353,Bach; Quang Tran,11,0,30,19
1683638216068,MATH 18,B02,188354,Bach; Quang Tran,19,0,30,11
1683638217094,MATH 20A,A01,188374,Staff,11,0,35,24
1683638218118,MATH 20B,A01,188382,Ohm; Ko Woon,7,0,30,23
1683638218118,MATH 20B,A02,188383,Ohm; Ko Woon,22,0,30,8
1683638218118,MATH 20B,B01,188385,Ohm; Ko Woon,7,0,30,23
1683638218118,MATH 20B,B02,188392,Ohm; Ko Woon,22,0,30,8
1683638219149,MATH 20C,A01,188394,Harel; Guershon,11,0,30,19
1683638219149,MATH 20C,A02,188395,Harel; Guershon,14,0,30,16
1683638219149,MATH 20C,B01,188404,Harel; Guershon,4,0,30,26
1683638219149,MATH 20C,B02,188405,Harel; Guershon,18,0,30,12
1683638220181,MATH 20D,A01,188414,Hammock; Frances H,0,1,30,30
1683638220181,MATH 20D,A02,188415,Hammock; Frances H,0,1,30,30
1683638220181,MATH 20D,B01,188447,Hammock; Frances H,0,1,30,30
1683638220181,MATH 20D,B02,188486,Hammock; Frances H,4,0,30,26
1683638221258,MATH 20E,A01,188649,Staff,21,0,30,9
1683638221258,MATH 20E,A02,188650,Staff,21,0,30,9
1683638221258,MATH 20E,A03,188673,Staff,0,0,30,30
1683638222287,MATH 102,A01,188675,Staff,0,36,35,35
1683638223311,MATH 103B,A01,188681,Staff,3,0,35,32
1683638223311,MATH 103B,B01,188692,Staff,5,0,35,30
1683638224339,MATH 109,A01,188695,Salehi Golsefidy; Alireza,24,0,35,11
1683638224339,MATH 109,A02,188696,Salehi Golsefidy; Alireza,25,0,35,10
1683638225363,MATH 120A,A01,188698,Eggers; John Dietrich,7,0,35,28
1683638226452,MATH 142B,A01,188736,Ioana; Adrian,0,1,30,30
1683638226452,MATH 142B,A02,188741,Ioana; Adrian,0,1,30,30
1683638226452,MATH 142B,A03,188743,Ioana; Adrian,0,1,30,30
1683638227477,MATH 168A,A01,188790,Staff,0,10,35,35
1683638228505,MATH 170A,A01,188803,Nie; Jiawang,0,2,35,35
1683638228505,MATH 170A,A02,188811,Nie; Jiawang,0,0,35,35
1683638228505,MATH 170A,A03,188814,Nie; Jiawang,0,0,35,35
1683638228505,MATH 170A,A04,188815,Nie; Jiawang,10,0,35,25
1683638229531,MATH 193B,A01,188817,Staff,0,0,35,35
1683638229531,MATH 193B,A02,188818,Staff,5,0,35,30
1683638230556,MGT 4,A01,202857,Anderson; John Charles,61,0,80,19
1683638231585,MGT 12,A00,202858,Lindenberger; Wade Douglas,40,0,90,50
1683638232612,MGT 18,A00,202859,Staff,74,0,90,16
1683638233643,MGT 18GS,A00,202860,McKay; Michael J,13,0,28,15
1683638234674,MGT 45,A00,202861,Pecore; Joseph P.,12,0,90,78
1683638235704,MGT 100,A00,202863,Yavorsky; Daniel Ryan,28,0,90,62
1683638236731,MGT 103,A00,202864,Ehrich; Kristine R,0,17,90,90
1683638237756,MGT 112,A00,202865,Ehrich; Kristine R,15,0,90,75
1683638238783,MGT 121A,A00,202868,Staff,0,20,0,0
1683638239809,MGT 131B,A00,202869,Anderson; John Charles,59,0,90,31
1683638240835,MGT 136,A00,202871,Lindenberger; Wade Douglas,83,0,90,7
1683638241860,MGT 164,A00,202873,Staff,0,66,90,91
1683638242887,MGT 164GS,A00,202874,McKay; Mary A,13,0,28,15
1683638243916,MGT 180,A00,202875,Staff,0,50,90,91
1683638244943,MMW 11R,A01,205019,Herbst; Matthew,2,0,30,28
1683638244943,MMW 11R,A02,205026,Herbst; Matthew,29,0,30,1
1683638245971,MMW 15,A01,193512,Chang; Edmond Yi-Teh,0,8,28,28
1683638245971,MMW 15,A02,193513,Chang; Edmond Yi-Teh,0,5,28,28
1683638245971,MMW 15,A03,193514,Chang; Edmond Yi-Teh,0,5,28,28
1683638245971,MMW 15,A04,193515,Chang; Edmond Yi-Teh,0,5,28,28
1683638245971,MMW 15,A05,193516,Chang; Edmond Yi-Teh,0,5,28,28
1683638245971,MMW 15,A06,193517,Chang; Edmond Yi-Teh,0,6,28,28
1683638245971,MMW 15,B01,193519,Chang; Edmond Yi-Teh,0,5,28,28
1683638245971,MMW 15,B02,193520,Chang; Edmond Yi-Teh,0,5,28,28
1683638245971,MMW 15,B03,193521,Chang; Edmond Yi-Teh,0,5,28,28
1683638245971,MMW 15,B04,193522,Chang; Edmond Yi-Teh,0,5,28,28
1683638245971,MMW 15,B05,193523,Chang; Edmond Yi-Teh,0,5,28,28
1683638245971,MMW 15,B06,193524,Chang; Edmond Yi-Teh,0,5,28,28
1683638246997,MMW 122,A01,193526,Rahimi; Babak,0,16,28,28
1683638246997,MMW 122,A02,193527,Rahimi; Babak,0,15,28,28
1683638246997,MMW 122,A03,193528,Rahimi; Babak,0,0,0,0
1683638246997,MMW 122,A04,193529,Rahimi; Babak,0,0,0,0
1683638248022,MUS 1A,A01,186663,Staff,1,20,35,34
1683638249051,MUS 4,A01,186715,Staff,0,12,35,35
1683638250078,MUS 5R,A01,186796,Dubnov; Shlomo,0,17,35,35
1683638251105,MUS 6,A01,186798,Staff,0,5,25,25
1683638252129,MUS 7,A01,186830,Staff,11,0,35,24
1683638253156,MUS 8,A01,186930,Staff,0,26,35,35
1683638254183,MUS 15,A01,186932,Staff,0,16,35,35
1683638254183,MUS 15,B01,186934,Staff,0,17,35,35
1683638255214,MUS 80,A00,186935,Staff,0,0,20,20
1683638255214,MUS 80,B00,186936,Staff,24,0,25,1
1683638256244,NANO 11,A00,204702,Lipomi; Darren John,0,0,0,0
1683638257268,NANO 15,A01,204709,Yang; Kesong,0,1,0,0
1683638258293,NANO 114,A00,202069,Jahed Motlagh; Zeinab,3,0,10,7
1683638259323,PHIL 1,A00,186955,Grush; Rick Scott,31,0,40,9
1683638260349,PHIL 10,A01,186973,Grush; Rick Scott,27,0,35,8
1683638260349,PHIL 10,A02,186974,Grush; Rick Scott,33,0,35,2
1683638261378,PHIL 13,A01,186976,Staff,3,0,35,32
1683638261378,PHIL 13,A02,186977,Staff,16,0,35,19
1683638262404,PHIL 14,A01,186979,Staff,31,0,35,4
1683638262404,PHIL 14,A02,186986,Staff,32,0,35,3
1683638263434,PHIL 28,A01,186988,Staff,16,0,30,14
1683638263434,PHIL 28,A02,186989,Staff,1,0,30,29
1683638263434,PHIL 28,A03,186990,Staff,10,0,30,20
1683638263434,PHIL 28,A04,186991,Staff,26,0,30,4
1683638264459,PHIL 120,A00,186997,Staff,23,0,40,17
1683638265484,PHIL 137,A00,187003,Staff,7,0,40,33
1683638266510,PHIL 150,A00,187015,Staff,47,0,70,23
1683638267539,PHIL 167,A00,187021,Lamey; Andy M.,34,0,40,6
1683638268564,PHIL 174,A01,202226,Staff,17,0,20,3
1683638268564,PHIL 174,A02,202235,Staff,20,0,20,0
1683638269593,PHIL 191A,A00,258918,Staff,0,0,1,1
1683638270620,PHYS 1A,A00,187028,Staff,27,0,60,33
1683638271645,PHYS 1AL,001,187036,Staff,3,0,30,27
1683638271645,PHYS 1AL,002,187049,Staff,18,0,30,12
1683638272674,PHYS 1B,A00,187058,Staff,22,0,60,38
1683638273703,PHYS 1BL,001,187064,Staff,0,1,30,30
1683638273703,PHYS 1BL,002,187070,Staff,4,0,30,26
1683638274728,PHYS 1C,A00,187082,Staff,29,0,120,91
1683638275755,PHYS 1CL,001,187088,Staff,0,9,30,30
1683638275755,PHYS 1CL,002,187089,Staff,0,1,30,30
1683638275755,PHYS 1CL,009,262693,Staff,9,0,30,21
1683638276781,PHYS 2B,A01,187097,Staff,55,0,115,60
1683638277806,PHYS 2C,A01,187099,Staff,64,0,115,51
1683638278832,PHYS 2CL,A01,187101,Staff,5,0,28,23
1683638278832,PHYS 2CL,A02,187102,Staff,15,0,28,13
1683638279859,PHYS 2D,A01,187123,Shotwell; Brian,95,0,115,20
1683638280888,PHYS 4B,A01,187133,Grinstein; Benjamin,35,0,50,15
1683638281916,POLI 10,A00,188819,Staff,0,4,50,50
1683638282943,POLI 11,A00,188827,Staff,43,0,50,7
1683638283968,POLI 13R,A00,188828,Staff,0,1,20,20
1683638284999,POLI 27,A01,188830,Elgin; Samuel Zincke,0,2,70,70
1683638286027,POLI 30,A00,188832,Desposato; Scott,30,0,50,20
1683638287052,POLI 102F,A00,188834,Staff,0,0,40,40
1683638288081,POLI 104A,A00,188852,Staff,13,0,30,17
1683638289110,POLI 104I,A00,188853,Staff,0,7,20,20
1683638290146,POLI 110B,A00,188854,Wiens; David,7,0,20,13
1683638291173,POLI 112A,A00,188855,Wiens; David,4,0,30,26
1683638292199,POLI 117R,A00,188856,Forman; Fonna,0,12,20,20
1683638293222,POLI 118,A00,188857,Ingham; Sean,8,0,20,12
1683638294251,POLI 120G,A00,188858,Staff,8,0,30,22
1683638295278,POLI 131CR,A00,188863,Hoston; Germaine,21,0,50,29
1683638296307,POLI 133,A00,188864,Nellis; Gareth Hb,44,0,50,6
1683638297336,POLI 134D,A00,188865,Desposato; Scott,27,0,30,3
1683638298361,POLI 142A,A00,188871,Gartzke; Erik,21,0,50,29
1683638299399,POLI 142K,A00,188874,Staff,38,0,50,12
1683638300424,POLI 143,A00,188940,Gartzke; Erik,16,0,30,14
1683638301452,POLI 153,A00,188943,Staff,2,0,20,18
1683638302482,POLI 160AA,A00,188944,Staff,11,0,40,29
1683638303510,POLI 170A,A00,188945,Staff,11,0,30,19
1683638305563,PSYC 1,A00,188952,Staff,36,0,90,54
1683638306589,PSYC 2,B00,188953,Staff,19,0,35,16
1683638307615,PSYC 6,A00,188970,Staff,47,0,60,13
1683638308641,PSYC 7,A00,188973,Staff,35,0,45,10
1683638309667,PSYC 60,A01,188980,Rickard; Timothy C.,42,0,60,18
1683638310697,PSYC 70,A01,189001,Steiner; Eric Tomas,23,0,45,22
1683638311725,PSYC 100,A00,189005,Lacefield; Katharine I,0,99,120,120
1683638312753,PSYC 102,A00,189008,Staff,8,0,30,22
1683638313778,PSYC 106,B00,189026,Gorman; Michael R.,27,0,60,33
1683638314803,PSYC 114,B01,189033,Winkielman; Piotr,0,31,30,30
1683638315828,PSYC 131,A00,189036,Anagnostaras; Stephan,0,43,60,60
1683638316854,PSYC 136,A00,189041,Lowe; Angela Beth,0,7,25,25
1683638317883,PSYC 137,A00,189057,Winkielman; Piotr,0,37,25,25
1683638318912,PSYC 144,A00,189107,Wixted; John T,0,10,50,50
1683638320963,PSYC 162,A00,189142,Staff,0,9,85,85
1683638321991,PSYC 172,A00,189144,Gorman; Michael R.,0,6,30,30
1683638324052,PSYC 179,A00,189146,Lacefield; Katharine I,0,86,120,120
1683638325077,PSYC 181,A00,189147,Anagnostaras; Stephan,0,44,90,90
1683638326101,PSYC 190R,A00,189148,Barner; David A.,0,23,80,80
1683638327134,PSYC 191,A00,189275,Rickard; Timothy C.,0,10,25,25
1683638328159,PSYC 193,A00,189276,Chapman; Eddie Nathaniel,0,1,0,4
1683638329189,PSYC 193L,A01,189281,Lowe; Angela Beth,10,0,20,10
1683638329189,PSYC 193L,B01,189285,Staff,28,0,35,7
1683638330269,RELI 149,A00,187137,Rahimi; Babak,7,0,40,33
1683638331295,SE 9,A01,187315,Staff,0,2,18,18
1683638332319,SE 101B,A00,187409,Staff,24,0,30,6
1683638333346,SE 110B,A00,187444,Staff,10,0,40,30
1683638334371,SE 130B,A00,187449,Staff,31,0,40,9
1683638335395,SE 150A,A00,187516,Staff,9,0,20,11
1683638336422,SE 154,A00,187528,Staff,29,0,50,21
1683638337452,SIO 3,A01,258171,Staff,35,0,40,5
1683638338481,SIO 10,A00,187144,Cook; Geoffrey W,0,6,75,75
1683638339509,SIO 45,A00,187152,Cook; Geoffrey W,0,4,100,100
1683638340534,SIO 109R,A00,194486,Staff,0,4,20,20
1683638342589,SIO 187,A01,187233,Kacev; David,12,0,40,28
1683638343617,SOCI 1,A01,258656,Thorpe; Charles Robert,28,0,30,2
1683638343617,SOCI 1,A02,258658,Thorpe; Charles Robert,30,0,30,0
1683638343617,SOCI 1,A03,258661,Thorpe; Charles Robert,25,0,25,0
1683638343617,SOCI 1,A04,258666,Thorpe; Charles Robert,22,0,25,3
1683638343617,SOCI 1,A05,258897,Thorpe; Charles Robert,22,0,25,3
1683638343617,SOCI 1,A06,258898,Thorpe; Charles Robert,25,0,25,0
1683638344643,SOCI 30,A01,258903,Pardo Guerra; Juan Pablo,14,0,30,16
1683638345670,SOCI 102,A00,258904,Staff,9,0,25,16
1683638346696,SOCI 106,A00,258905,Staff,19,0,25,6
1683638347725,SOCI 111,A00,258907,Ribas Norris; Janet Vanesa,26,0,30,4
1683638348755,SOCI 121R,A00,258908,Pardo Guerra; Juan Pablo,8,0,30,22
1683638349780,SOCI 126,A01,203330,Staff,14,0,20,6
1683638350805,SOCI 131,A00,258909,Thorpe; Charles Robert,30,0,60,30
1683638351831,SOCI 135,A00,258910,Payne; Christine Anna,0,11,30,30
1683638352855,SOCI 157,A00,258911,Staff,12,0,30,18
1683638353883,SOCI 184,A00,258912,Staff,25,0,30,5
1683638354908,SOCI 188D,A00,258913,Staff,22,0,30,8
1683638355935,SYN 2,001,187529,Staff,9,0,16,7
1683638355935,SYN 2,002,201452,Staff,0,20,16,16
1683638355935,SYN 2,003,201469,Staff,2,0,16,14
1683638356962,SYN 100,A01,187531,Staff,0,9,20,20
1683638356962,SYN 100,B01,201491,Staff,0,10,20,20
1683638357988,TDAC 1,A00,189286,Walsh; Kim C.,3,0,20,17
1683638357988,TDAC 1,B00,189287,Harting; Carla Kelso,10,0,20,10
1683638359014,TDAC 101,A00,189300,Walsh; Kim C.,16,0,20,4
1683638359014,TDAC 101,B00,189301,Harting; Carla Kelso,18,0,20,2
1683638360039,TDAC 102,A00,189304,Basso; Beatrice,14,0,20,6
1683638361066,TDAC 108,A00,189305,Staff,18,0,20,2
1683638362097,TDDE 131,A00,189310,Staff,19,0,20,1
1683638362097,TDDE 131,B00,189314,Staff,19,0,20,1
1683638362097,TDDE 131,C00,189315,Staff,48,0,50,2
1683638362097,TDDE 131,D00,189316,Staff,14,0,15,1
1683638362097,TDDE 131,E00,204841,Staff,20,0,20,0
1683638363125,TDGE 10,A00,189289,Staff,27,0,50,23
1683638363125,TDGE 10,B00,189290,Havis; Allan,0,0,50,50
1683638364156,TDGE 11,A00,189291,Fulton; Julia,0,4,50,50
1683638364156,TDGE 11,B00,189292,Staff,20,0,25,5
1683638364156,TDGE 11,C00,260270,Staff,0,0,0,0
1683638365181,TDGE 25,A00,189294,Staff,2,0,20,18
1683638366210,TDGE 124,A00,189318,Fulton; Julia,0,8,50,50
1683638367239,TDGE 125,A00,189319,Staff,13,0,25,12
1683638367239,TDGE 125,B00,189320,Staff,23,0,25,2
1683638368268,TDGE 127,A00,189322,Havis; Allan,0,0,50,50
1683638369294,TDHT 101,A00,189323,Staff,18,0,25,7
1683638369294,TDHT 101,B00,189324,Staff,25,0,25,0
1683638370320,TDHT 102,A00,189325,Staff,49,0,50,1
1683638371347,TDMV 1,A00,189295,Arcidiacono; Kristin,20,0,30,10
1683638371347,TDMV 1,B00,189296,Caligagan; Maria T.,24,0,30,6
1683638372373,TDMV 2,A00,189297,Sammartano; Tonnie,27,0,30,3
1683638372373,TDMV 2,B00,189299,Arcidiacono; Kristin,23,0,30,7
1683638373399,TDMV 3,A00,204998,Rincon; Alicia,22,0,30,8
1683638374425,TDMV 120,A00,189458,Sammartano; Tonnie,28,0,30,2
1683638375452,TDMV 138,A00,189541,Jun; Grace Shin Hae,20,0,40,20
1683638376477,TDMV 142,A00,189717,Caligagan; Tony,25,0,30,5
1683638376477,TDMV 142,B00,189718,Caligagan; Maria T.,25,0,30,5
1683638377506,TMC 2,A01,187533,Staff,25,0,25,0
1683638377506,TMC 2,A02,187534,Staff,25,0,25,0
1683638378537,USP 1,A01,187536,Kwak; Nancy,0,16,25,25
1683638379566,USP 5,A01,187538,Staff,9,0,25,16
1683638380596,USP 101,A00,199253,Staff,0,4,0,0
1683638381623,USP 124,A00,187562,Boomhower; Matthew Charles,0,0,30,30
1683638382653,USP 138,A00,187582,Staff,20,0,25,5
1683638383683,USP 152,A01,187597,Staff,3,0,25,22
1683638384707,USP 153,A00,187598,Staff,19,0,25,6
1683638385732,USP 168,A00,187607,Kwak; Nancy,2,0,5,3
1683638386757,USP 173,A00,187619,Staff,4,0,25,21
1683638387786,USP 181,A00,187638,Staff,0,4,25,25
1683638388820,VIS 103,A00,187650,Cruz; Edwin Teddy,18,0,75,57
1683638389846,VIS 110D,A00,187669,Staff,13,0,22,9
1683638390871,VIS 127C,A00,187720,Shen; Kuiyi,67,0,146,79
1683638391897,VIS 149,A00,187731,Yoldas; Pinar,0,14,22,22
1683638392924,VIS 151,A01,188091,Staff,22,0,34,12
1683638392924,VIS 151,A02,188092,Staff,11,0,34,23
1683638393954,VIS 160B,A00,188093,Stalbaum; Brett,0,1,10,10
1683638396007,WCWP 10B,A00,201720,Staff,10,0,15,5
1683638396007,WCWP 10B,B00,201722,Staff,9,0,15,6
1683638397035,WCWP 100,A00,201725,Gagnon; Jeffrey C,0,0,2,2
1683638397035,WCWP 100,B00,201727,Staff,0,4,15,15
1683638400156,ANBI 133,A00,258401,Wilder; Linnea Lorene,34,0,40,6
1683638401181,ANBI 140,A00,258395,Hrvoj Mihic; Branka,18,0,25,7
1683638402207,ANSC 120,A00,258402,Bialecki; Jon Anthony,27,0,40,13
1683638403233,ANSC 144,A00,258400,Staff,12,0,40,28
1683638405288,ANSC 166,A00,258396,Parish; Steven Martin,156,0,175,19
1683638406316,ANSC 180,A00,193533,Staff,8,0,20,12
1683638407340,ANSC 188,A00,258397,Jassal; Aftab,34,0,40,6
1683638408366,ANTH 3,A01,258316,Staff,23,0,30,7
1683638409396,ANTH 5,A00,258394,Semendeferi; Ekaterini,16,0,20,4
1683638410430,ANTH 21,A01,258331,Staff,4,0,40,36
1683638411456,ANTH 103,A00,258398,Varma; Saiba,15,0,25,10
1683638412487,AWP 10,001,202034,Staff,0,0,0,0
1683638412487,AWP 10,002,202035,Staff,0,0,0,0
1683638412487,AWP 10,003,202036,Staff,0,0,0,0
1683638412487,AWP 10,004,202037,Staff,0,0,0,0
1683638412487,AWP 10,005,202038,Staff,0,0,0,0
1683638412487,AWP 10,006,202039,Staff,0,0,0,0
1683638412487,AWP 10,007,202040,Staff,0,0,0,0
1683638412487,AWP 10,008,202041,Staff,0,0,0,0
1683638412487,AWP 10,009,202042,Staff,0,0,0,0
1683638412487,AWP 10,010,202043,Staff,0,0,0,0
1683638412487,AWP 10,011,202044,Staff,0,0,0,0
1683638412487,AWP 10,012,202045,Staff,0,0,0,0
1683638412487,AWP 10,013,202046,Staff,0,0,0,0
1683638412487,AWP 10,014,202047,Staff,0,0,0,0
1683638412487,AWP 10,015,202048,Staff,0,0,0,0
1683638412487,AWP 10,016,202049,Staff,0,0,0,0
1683638412487,AWP 10,017,202050,Staff,0,0,0,0
1683638412487,AWP 10,018,202051,Staff,0,0,0,0
1683638412487,AWP 10,019,202052,Staff,0,0,0,0
1683638412487,AWP 10,020,202053,Staff,0,0,0,0
1683638412487,AWP 10,021,202054,Staff,0,0,0,0
1683638412487,AWP 10,022,202055,Staff,0,0,0,0
1683638412487,AWP 10,023,202056,Staff,0,0,0,0
1683638412487,AWP 10,024,202057,Staff,0,0,0,0
1683638412487,AWP 10,025,202058,Staff,0,0,0,0
1683638412487,AWP 10,026,202059,Staff,0,0,0,0
1683638413514,AWP 102,001,202032,Staff,0,0,0,0
1683638413514,AWP 102,002,202033,Staff,0,0,0,0
1683638414540,BENG 100,A01,254234,Taylor Amos; Alyssa C,31,0,40,9
1683638415570,BENG 196,001,270013,Engler; Adam J.,9999,0,9999,0
1683638416603,BICD 100R,A01,202018,Smith; Laurie,0,7,32,32
1683638416603,BICD 100R,A02,202019,Smith; Laurie,0,3,32,32
1683638416603,BICD 100R,A03,202020,Smith; Laurie,0,1,32,32
1683638416603,BICD 100R,A04,202021,Smith; Laurie,6,0,32,26
1683638416603,BICD 100R,A05,202022,Smith; Laurie,11,0,32,21
1683638417636,BICD 136,A01,193242,Gustafson-Brown; Cindy,0,2,32,32
1683638417636,BICD 136,A02,193244,Gustafson-Brown; Cindy,13,0,32,19
1683638418670,BIEB 102,A01,193249,Butler; Shannon Rhey,0,2,32,32
1683638418670,BIEB 102,A02,193251,Butler; Shannon Rhey,0,0,32,32
1683638418670,BIEB 102,A03,193253,Butler; Shannon Rhey,0,0,32,32
1683638418670,BIEB 102,A04,193255,Butler; Shannon Rhey,14,0,32,18
1683638418670,BIEB 102,A05,193265,Butler; Shannon Rhey,26,0,32,6
1683638418670,BIEB 102,A06,193269,Butler; Shannon Rhey,14,0,32,18
1683638420726,BIEB 150,A01,193274,Staff,0,0,32,32
1683638420726,BIEB 150,A02,193285,Staff,24,0,32,8
1683638421753,BIEB 194,A00,193286,Kurle; Carolyn M.,20,0,32,12
1683638422781,BILD 1,A01,192291,Staff,15,0,32,17
1683638422781,BILD 1,A02,192292,Staff,30,0,32,2
1683638422781,BILD 1,B01,192520,Reuther; Keefe,0,1,0,0
1683638422781,BILD 1,B02,192532,Reuther; Keefe,0,1,0,0
1683638423807,BILD 3,A01,192556,Butler; Shannon Rhey,0,0,32,32
1683638423807,BILD 3,A02,192581,Butler; Shannon Rhey,1,0,32,31
1683638423807,BILD 3,A03,192611,Butler; Shannon Rhey,21,0,32,11
1683638423807,BILD 3,A04,192612,Butler; Shannon Rhey,24,0,32,8
1683638423807,BILD 3,A05,192613,Butler; Shannon Rhey,26,0,32,6
1683638423807,BILD 3,A06,192679,Butler; Shannon Rhey,27,0,32,5
1683638423807,BILD 3,A07,192682,Butler; Shannon Rhey,20,0,32,12
1683638424834,BILD 4,A01,192836,Reuther; Keefe,0,0,24,24
1683638424834,BILD 4,A02,193044,Reuther; Keefe,4,0,24,20
1683638425862,BILD 10,A01,193142,Gustafson-Brown; Cindy,29,0,32,3
1683638425862,BILD 10,A02,193149,Gustafson-Brown; Cindy,31,0,32,1
1683638426891,BIMM 100,A01,193301,Staff,0,6,32,32
1683638426891,BIMM 100,A02,193312,Staff,0,7,32,32
1683638426891,BIMM 100,A03,193323,Staff,0,9,32,32
1683638427922,BIMM 101,A01,193329,McDonnell; Lisa Marie,0,4,24,24
1683638427922,BIMM 101,A02,193339,McDonnell; Lisa Marie,0,3,24,24
1683638427922,BIMM 101,B01,193354,McDonnell; Lisa Marie,0,4,24,24
1683638427922,BIMM 101,B02,193357,McDonnell; Lisa Marie,0,2,24,24
1683638428947,BIMM 110,A01,193377,Tat; John,0,11,32,32
1683638428947,BIMM 110,A02,193378,Tat; John,0,10,32,32
1683638429973,BIMM 120,A01,206116,Staff,0,0,32,32
1683638429973,BIMM 120,A02,206117,Staff,6,0,32,26
1683638429973,BIMM 120,A03,206121,Staff,21,0,32,11
1683638431001,BIPN 100,A01,193393,Park; Ji Young,0,14,32,32
1683638431001,BIPN 100,A02,193402,Park; Ji Young,0,14,32,32
1683638431001,BIPN 100,A03,193413,Park; Ji Young,0,14,32,32
1683638431001,BIPN 100,A04,193414,Park; Ji Young,0,13,32,32
1683638432027,BIPN 102,A01,193429,Staff,0,0,32,32
1683638432027,BIPN 102,A02,193438,Staff,18,0,32,14
1683638433052,BIPN 106,A01,193450,Reyes Gonzalez; Catalina,0,2,40,40
1683638434147,BIPN 134,A01,193465,Cooke; James Edward,0,0,32,32
1683638434147,BIPN 134,A02,193474,Cooke; James Edward,25,0,32,7
1683638434147,BIPN 134,A03,193485,Cooke; James Edward,29,0,32,3
1683638434147,BIPN 134,A04,193486,Cooke; James Edward,20,0,32,12
1683638434147,BIPN 134,A05,193491,Cooke; James Edward,31,0,32,1
1683638434147,BIPN 134,A06,193501,Cooke; James Edward,30,0,32,2
1683638434147,BIPN 134,A07,193510,Cooke; James Edward,29,0,32,3
1683638436207,BISP 194,A00,222522,Staff,14,0,32,18
1683638437232,CAT 124,A01,202407,Staff,19,0,25,6
1683638438257,CAT 125,A00,202408,Marchisotto; Jennifer Anne,2,0,20,18
1683638439285,CAT 125R,A00,202409,Smith; Lauryn Alissa,0,11,20,20
1683638439285,CAT 125R,B00,202410,Morales; Celeste Georgianna,0,11,20,20
1683638439285,CAT 125R,C00,202411,Irwin; Matthew Joseph,0,12,20,20
1683638440311,CENG 15,A01,204712,Yang; Kesong,0,1,0,0
1683638441337,CENG 114,A00,202070,Jahed Motlagh; Zeinab,5,0,20,15
1683638442363,CGS 105,A00,185477,Wesling; Megan E.,24,0,40,16
1683638443387,CGS 106,A00,185494,Staff,11,0,22,11
1683638444413,CGS 108,A00,185495,Staff,14,0,20,6
1683638445438,CGS 114,A00,185496,Staff,13,0,18,5
1683638446463,CGS 119,A00,185501,Staff,15,0,20,5
1683638447492,CGS 120,A00,185511,Staff,12,0,20,8
1683638448518,CHEM 4,A01,184675,Bussey; Thomas J,97,0,100,3
1683638449544,CHEM 6A,A01,184677,Staff,33,0,60,27
1683638450568,CHEM 6B,A01,184679,Staff,63,0,100,37
1683638451598,CHEM 6C,A01,184681,Bussey; Thomas J,0,0,50,50
1683638451598,CHEM 6C,A02,184682,Bussey; Thomas J,32,0,50,18
1683638452627,CHEM 40A,A01,184684,Albizati; Kim F.,35,0,100,65
1683638453655,CHEM 40B,A01,184686,Albizati; Kim F.,0,22,100,100
1683638454682,CHEM 41B,A01,184690,Staff,51,0,100,49
1683638455712,COGS 3,A01,184715,Boyle; Mary E. T.,0,27,40,40
1683638456742,COGS 14B,A01,185172,Staff,0,14,38,38
1683638457772,COGS 18,A01,184736,Staff,15,0,80,65
1683638458802,COGS 100,A01,184932,Staff,0,7,73,73
1683638459827,COGS 101A,A01,184935,Staff,0,39,30,30
1683638460856,COGS 101B,A01,184944,Staff,0,2,30,30
1683638461883,COGS 101C,A01,184946,Staff,0,10,30,30
1683638462908,COGS 102A,A01,184951,Johnson; Christine M.,2,0,40,38
1683638463933,COGS 107B,A01,184953,Mooshagian; Eric Frederick,0,51,40,40
1683638464963,COGS 118B,A01,184959,Gupta; Anjum,0,49,40,40
1683638465988,COGS 153,A00,184961,Staff,0,16,30,30
1683638467015,COGS 177,A00,184962,Staff,0,21,30,30
1683638468039,COGS 187A,A01,184969,Boyle; Mary E. T.,0,19,40,40
1683638469067,COMM 10,A01,185174,Staff,0,5,25,25
1683638469067,COMM 10,A02,185189,Staff,0,2,25,25
1683638469067,COMM 10,A03,269821,Staff,0,1,0,0
1683638470095,COMM 100B,A01,185475,Staff,0,1,0,2
1683638470095,COMM 100B,A02,185476,Staff,12,0,25,13
1683638471125,COMM 100C,A01,185314,Staff,1,0,25,24
1683638471125,COMM 100C,A02,185327,Staff,18,0,25,7
1683638472151,COMM 110M,A00,185349,Staff,0,0,40,40
1683638473173,COMM 113T,A00,185352,Staff,25,0,40,15
1683638474197,COMM 114I,A00,185353,Staff,31,0,40,9
1683638475226,COMM 131,A00,185354,Staff,17,0,30,13
1683638476251,CSE 8A,A50,185358,Cao; Yingjun,0,46,10,10
1683638477276,CSE 8B,A01,185362,Staff,0,48,50,50
1683638478304,CSE 11,A01,185416,Cao; Yingjun,0,91,10,10
1683638479329,CSE 20,A01,185445,Briones; Jor-el Thomas Caparas,4,0,25,21
1683638480356,CSE 21,A01,185447,Staff,9,0,50,41
1683638481382,CSE 101,A01,185451,Staff,0,13,50,50
1683638481382,CSE 101,B01,185453,Jones; Miles E,0,13,50,50
1683638483437,CSE 141,A01,185458,Eldon; John,15,0,100,85
1683638484466,CSE 141L,A01,185461,Eldon; John,7,0,100,93
1683638485491,CSE 142,A01,185463,Staff,36,0,60,24
1683638485491,CSE 142,B01,201355,Staff,0,7,60,60
1683638486515,CSE 142L,A01,185470,Staff,36,0,60,24
1683638486515,CSE 142L,B01,201417,Staff,0,6,60,60
1683638487540,CSE 190,A00,201433,Staff,32,0,49,17
1683638488566,DOC 1,A01,259136,Strom; Megan C.,7,0,15,8
1683638488566,DOC 1,A02,259137,Strom; Megan C.,14,0,15,1
1683638488566,DOC 1,A03,259138,Strom; Megan C.,14,0,15,1
1683638488566,DOC 1,A04,259139,Strom; Megan C.,14,0,15,1
1683638489591,DOC 100D,A00,259140,Pass; Natalye Joann,14,0,25,11
1683638490615,DSGN 1,A01,184749,Rill; Bryan,0,26,30,30
1683638491640,DSGN 100,A01,185168,Staff,0,2,25,25
1683638492669,ECE 5,A01,185626,Morris; Karcher William,0,11,0,0
1683638493697,ECE 101,A01,185628,Staff,14,0,70,56
1683638494723,ECE 107,A01,185635,Baghdadchi; Saharnaz,0,0,20,20
1683638494723,ECE 107,A02,185638,Baghdadchi; Saharnaz,3,0,20,17
1683638495748,ECE 148,A01,185647,Silberman; Jack,0,0,16,16
1683638496773,ECON 1,A01,185537,Crane; Meredith Helen,54,0,70,16
1683638497802,ECON 3,A01,185549,Crane; Meredith Helen,29,0,70,41
1683638498833,ECON 4,A01,203354,Anderson; John Charles,0,5,10,10
1683638499861,ECON 100A,A01,185574,Staff,0,5,40,40
1683638500885,ECON 100B,A01,185576,Staff,0,12,50,50
1683638501916,ECON 100C,A01,185589,Newhouse; Herbert S,30,0,70,40
1683638502943,ECON 105,A00,185608,Vespa; Emanuel Ignacio,19,0,35,16
1683638503973,ECON 109,A01,185610,Shishkin; Denis,9,0,35,26
1683638504997,ECON 110A,A01,185612,Staff,9,0,40,31
1683638506021,ECON 120A,A01,185615,Staff,20,0,40,20
1683638507046,ECON 120C,A01,185617,Sun; Yixiao,0,20,70,70
1683638508071,ECON 144,A00,203346,Squires; Dale E,2,0,35,33
1683638509095,ECON 171,A01,203349,Newhouse; Herbert S,0,1,35,35
1683638510123,ECON 173A,A01,185621,Toda; Alexis Akira,21,0,35,14
1683638511154,EDS 25,A01,202413,Staff,0,1,0,0
1683638511154,EDS 25,A02,202414,Staff,0,1,0,0
1683638511154,EDS 25,A03,202415,Staff,0,0,0,0
1683638511154,EDS 25,A04,202416,Staff,0,1,0,0
1683638511154,EDS 25,A05,202439,Staff,0,0,0,0
1683638511154,EDS 25,A06,202440,Staff,0,0,0,0
1683638511154,EDS 25,B01,202631,Staff,0,0,0,0
1683638511154,EDS 25,B02,202632,Staff,0,0,0,0
1683638511154,EDS 25,B03,202639,Staff,0,0,0,0
1683638511154,EDS 25,B04,202640,Staff,0,0,0,0
1683638511154,EDS 25,B05,202643,Staff,0,0,0,0
1683638511154,EDS 25,B06,202644,Staff,0,0,0,0
1683638512184,EDS 38,A01,202659,Black; Alison Michelle,24,0,25,1
1683638513208,EDS 115,A00,202652,Staff,18,0,30,12
1683638514233,EDS 125,A00,202649,Staff,13,0,30,17
1683638515258,EDS 126,A01,203332,Staff,30,0,30,0
1683638516287,EDS 139,A00,202838,Staff,16,0,25,9
1683638517314,EDS 146,A01,202655,Staff,14,0,25,11
1683638518340,ENG 15,A00,185667,Staff,0,1,0,0
1683638518340,ENG 15,B00,185672,Staff,0,0,0,0
1683638518340,ENG 15,C00,185675,Staff,0,0,0,0
1683638518340,ENG 15,D00,185682,Staff,0,0,0,0
1683638518340,ENG 15,E00,185684,Staff,0,0,0,0
1683638519365,ETHN 103,A00,185710,Staff,0,8,35,35
1683638520394,ETHN 103A,A00,199228,Man; Simeon S,0,0,9,9
1683638521420,ETHN 109,A00,185711,Staff,16,0,35,19
1683638522445,ETHN 142,A00,185726,Staff,0,4,30,30
1683638523470,ETHN 163J,A00,199229,Man; Simeon S,5,0,8,3
1683638524499,ETHN 168,A00,185727,Staff,7,0,10,3
1683638525528,ETHN 182,A00,185728,Staff,0,0,35,35
1683638526556,ETHN 183,A00,185737,Staff,9,0,18,9
1683638527586,GLBH 111,A01,209361,Burgos; Jose L.,0,0,0,0
1683638529637,HIEU 104,A00,185792,Staff,14,0,20,6
1683638530664,HIEU 115,A00,185800,Staff,0,0,20,20
1683638531688,HIEU 128,A00,185801,Staff,0,9,20,20
1683638532712,HIEU 147,A00,185802,Staff,15,0,20,5
1683638533737,HIEU 154,A00,185823,Staff,11,0,20,9
1683638534762,HILA 102,A00,185826,Staff,14,0,20,6
1683638535788,HILD 2C,A01,185778,Staff,0,13,20,20
1683638536819,HILD 7B,A01,185780,Kwak; Nancy,0,16,32,32
1683638536819,HILD 7B,A02,185781,Kwak; Nancy,0,18,32,32
1683638537901,HILD 30,A01,185791,Staff,12,0,20,8
1683638538928,HISC 119,A00,185830,Golan; Tal,0,9,20,20
1683638539956,HITO 156GS,A00,185831,Patterson; Patrick H.,0,0,0,23
1683638540984,HIUS 103,A00,185832,Man; Simeon S,0,4,20,20
1683638542010,HIUS 117,A00,185836,Kwak; Nancy,2,0,20,18
1683638543039,HIUS 125,A00,185840,Man; Simeon S,0,1,23,23
1683638544065,HIUS 149,A00,185845,Staff,1,0,20,19
1683638545097,HUM 3,A01,185882,Zavodny; Tatiana Sophia,0,7,50,50
1683638545097,HUM 3,B01,185899,Caldwell; Michael Alan,0,18,50,50
1683638546121,HUM 3GS,A00,185900,Patterson; Patrick H.,0,0,0,23
1683638547148,HUM 4,A01,185938,Zroka; Amy Liane,30,0,50,20
1683638547148,HUM 4,B01,185956,Watkins; Eric,0,4,50,50
1683638547148,HUM 4,B02,202209,Watkins; Eric,0,4,50,50
1683638547148,HUM 4,B03,202210,Watkins; Eric,0,4,50,50
1683638548172,HUM 5,A01,185958,West; Geoffrey Scott,2,0,50,48
1683638548172,HUM 5,A02,202215,West; Geoffrey Scott,0,0,50,50
1683638549199,INTL 190,A00,185959,Gagnon; Jeffrey C,0,0,0,9
1683638549199,INTL 190,B00,185960,Lettieri; Michael Joseph,0,0,0,2
1683638550224,JAPN 180,A00,254509,Staff,5,0,30,25
1683638551249,LATI 10,A01,202853,Kennemore; Amy Michelle,4,0,35,31
1683638551249,LATI 10,A02,202854,Kennemore; Amy Michelle,2,0,35,33
1683638551249,LATI 10,A03,270054,Kennemore; Amy Michelle,30,0,30,0
1683638552273,LATI 180,A00,202855,Kennemore; Amy Michelle,11,0,20,9
1683638553297,LAWS 101,A00,201767,Golan; Tal,0,7,40,40
1683638554324,LIFR 1C,A00,185961,Staff,6,0,20,14
1683638555352,LIFR 1CX,A00,185962,Staff,7,0,20,13
1683638556376,LIFR 1D,A00,185963,Staff,7,0,20,13
1683638557400,LIFR 1DX,A00,185964,Staff,7,0,20,13
1683638558424,LIGN 101,A01,186039,Staff,43,0,50,7
1683638559449,LIGN 165,A00,186040,Staff,15,0,50,35
1683638560477,LTCS 108,A00,186041,Staff,5,0,10,5
1683638561505,LTCS 119,A00,186042,Staff,15,0,20,5
1683638562530,LTCS 130,A00,186043,Wesling; Megan E.,15,0,25,10
1683638564582,LTEA 138,A00,186119,Staff,14,0,40,26
1683638565607,LTEN 124,A00,186148,Staff,5,0,25,20
1683638566635,LTEN 178,A00,186149,Staff,7,0,15,8
1683638567661,LTEN 181,A00,186150,Blanco; John D,34,0,40,6
1683638568689,LTWL 120,A00,186160,Staff,20,0,25,5
1683638569713,LTWL 165,A00,186161,Staff,22,0,25,3
1683638570737,LTWR 100,A00,186162,Staff,0,5,15,15
1683638571762,LTWR 102,A00,186163,Doller; Ben,5,0,15,10
1683638572787,MAE 8,A01,186412,Staff,0,0,0,0
1683638573814,MAE 30B,A00,186445,Bahadori; Mohammad Yousef,82,0,100,18
1683638574842,MAE 40,A00,186592,Bewley; Thomas R,10,0,50,40
1683638575867,MAE 101B,A00,186593,Bahadori; Mohammad Yousef,80,0,100,20
1683638576893,MAE 105,A00,186594,Bandaru; Prabhakar,10,0,50,40
1683638577923,MAE 107,A00,186599,Pham; Hieu Tan,0,7,120,120
1683638578953,MAE 148,A01,186660,Silberman; Jack,3,0,16,13
1683638579984,MATH 10A,A01,188095,Staff,0,5,35,35
1683638581016,MATH 10B,A01,188097,Bowers; Adam R.,0,11,30,30
1683638581016,MATH 10B,A02,188099,Bowers; Adam R.,0,11,30,30
1683638581016,MATH 10B,B01,188104,Bowers; Adam R.,0,10,30,30
1683638581016,MATH 10B,B02,188106,Bowers; Adam R.,1,9,30,29
1683638582050,MATH 10C,A01,188111,Staff,0,18,30,30
1683638582050,MATH 10C,A02,188127,Staff,0,19,30,30
1683638582050,MATH 10C,A03,188131,Staff,0,19,30,30
1683638582050,MATH 10C,B01,188218,Staff,17,0,30,13
1683638582050,MATH 10C,B02,188244,Staff,13,0,30,17
1683638582050,MATH 10C,B03,188277,Staff,14,0,30,16
1683638583077,MATH 18,A01,188344,Bach; Quang Tran,18,0,30,12
1683638583077,MATH 18,A02,188345,Bach; Quang Tran,11,0,30,19
1683638583077,MATH 18,B01,188353,Bach; Quang Tran,11,0,30,19
1683638583077,MATH 18,B02,188354,Bach; Quang Tran,19,0,30,11
1683638584103,MATH 20A,A01,188374,Staff,11,0,35,24
1683638585130,MATH 20B,A01,188382,Ohm; Ko Woon,7,0,30,23
1683638585130,MATH 20B,A02,188383,Ohm; Ko Woon,22,0,30,8
1683638585130,MATH 20B,B01,188385,Ohm; Ko Woon,7,0,30,23
1683638585130,MATH 20B,B02,188392,Ohm; Ko Woon,22,0,30,8
1683638586163,MATH 20C,A01,188394,Harel; Guershon,11,0,30,19
1683638586163,MATH 20C,A02,188395,Harel; Guershon,14,0,30,16
1683638586163,MATH 20C,B01,188404,Harel; Guershon,4,0,30,26
1683638586163,MATH 20C,B02,188405,Harel; Guershon,18,0,30,12
1683638587196,MATH 20D,A01,188414,Hammock; Frances H,0,1,30,30
1683638587196,MATH 20D,A02,188415,Hammock; Frances H,0,1,30,30
1683638587196,MATH 20D,B01,188447,Hammock; Frances H,0,1,30,30
1683638587196,MATH 20D,B02,188486,Hammock; Frances H,4,0,30,26
1683638588226,MATH 20E,A01,188649,Staff,21,0,30,9
1683638588226,MATH 20E,A02,188650,Staff,21,0,30,9
1683638588226,MATH 20E,A03,188673,Staff,0,0,30,30
1683638589251,MATH 102,A01,188675,Staff,0,36,35,35
1683638590275,MATH 103B,A01,188681,Staff,3,0,35,32
1683638590275,MATH 103B,B01,188692,Staff,5,0,35,30
1683638591305,MATH 109,A01,188695,Salehi Golsefidy; Alireza,24,0,35,11
1683638591305,MATH 109,A02,188696,Salehi Golsefidy; Alireza,25,0,35,10
1683638592335,MATH 120A,A01,188698,Eggers; John Dietrich,7,0,35,28
1683638593365,MATH 142B,A01,188736,Ioana; Adrian,0,1,30,30
1683638593365,MATH 142B,A02,188741,Ioana; Adrian,0,1,30,30
1683638593365,MATH 142B,A03,188743,Ioana; Adrian,0,1,30,30
1683638594394,MATH 168A,A01,188790,Staff,0,10,35,35
1683638595426,MATH 170A,A01,188803,Nie; Jiawang,0,2,35,35
1683638595426,MATH 170A,A02,188811,Nie; Jiawang,0,0,35,35
1683638595426,MATH 170A,A03,188814,Nie; Jiawang,0,0,35,35
1683638595426,MATH 170A,A04,188815,Nie; Jiawang,10,0,35,25
1683638596450,MATH 193B,A01,188817,Staff,0,0,35,35
1683638596450,MATH 193B,A02,188818,Staff,5,0,35,30
1683638597482,MGT 4,A01,202857,Anderson; John Charles,61,0,80,19
1683638598508,MGT 12,A00,202858,Lindenberger; Wade Douglas,40,0,90,50
1683638599533,MGT 18,A00,202859,Staff,74,0,90,16
1683638600565,MGT 18GS,A00,202860,McKay; Michael J,13,0,28,15
1683638601595,MGT 45,A00,202861,Pecore; Joseph P.,12,0,90,78
1683638602626,MGT 100,A00,202863,Yavorsky; Daniel Ryan,28,0,90,62
1683638603652,MGT 103,A00,202864,Ehrich; Kristine R,0,17,90,90
1683638604676,MGT 112,A00,202865,Ehrich; Kristine R,15,0,90,75
1683638605703,MGT 121A,A00,202868,Staff,0,20,0,0
1683638606728,MGT 131B,A00,202869,Anderson; John Charles,59,0,90,31
1683638607754,MGT 136,A00,202871,Lindenberger; Wade Douglas,83,0,90,7
1683638608783,MGT 164,A00,202873,Staff,0,66,90,91
1683638609811,MGT 164GS,A00,202874,McKay; Mary A,13,0,28,15
1683638610839,MGT 180,A00,202875,Staff,0,50,90,91
1683638611869,MMW 11R,A01,205019,Herbst; Matthew,2,0,30,28
1683638611869,MMW 11R,A02,205026,Herbst; Matthew,29,0,30,1
1683638612901,MMW 15,A01,193512,Chang; Edmond Yi-Teh,0,8,28,28
1683638612901,MMW 15,A02,193513,Chang; Edmond Yi-Teh,0,5,28,28
1683638612901,MMW 15,A03,193514,Chang; Edmond Yi-Teh,0,5,28,28
1683638612901,MMW 15,A04,193515,Chang; Edmond Yi-Teh,0,5,28,28
1683638612901,MMW 15,A05,193516,Chang; Edmond Yi-Teh,0,5,28,28
1683638612901,MMW 15,A06,193517,Chang; Edmond Yi-Teh,0,6,28,28
1683638612901,MMW 15,B01,193519,Chang; Edmond Yi-Teh,0,5,28,28
1683638612901,MMW 15,B02,193520,Chang; Edmond Yi-Teh,0,5,28,28
1683638612901,MMW 15,B03,193521,Chang; Edmond Yi-Teh,0,5,28,28
1683638612901,MMW 15,B04,193522,Chang; Edmond Yi-Teh,0,5,28,28
1683638612901,MMW 15,B05,193523,Chang; Edmond Yi-Teh,0,5,28,28
1683638612901,MMW 15,B06,193524,Chang; Edmond Yi-Teh,0,5,28,28
1683638613926,MMW 122,A01,193526,Rahimi; Babak,0,16,28,28
1683638613926,MMW 122,A02,193527,Rahimi; Babak,0,15,28,28
1683638613926,MMW 122,A03,193528,Rahimi; Babak,0,0,0,0
1683638613926,MMW 122,A04,193529,Rahimi; Babak,0,0,0,0
1683638614952,MUS 1A,A01,186663,Staff,1,20,35,34
1683638615976,MUS 4,A01,186715,Staff,0,12,35,35
1683638617008,MUS 5R,A01,186796,Dubnov; Shlomo,0,17,35,35
1683638618036,MUS 6,A01,186798,Staff,0,5,25,25
1683638619065,MUS 7,A01,186830,Staff,11,0,35,24
1683638620094,MUS 8,A01,186930,Staff,0,26,35,35
1683638621129,MUS 15,A01,186932,Staff,0,16,35,35
1683638621129,MUS 15,B01,186934,Staff,0,17,35,35
1683638622156,MUS 80,A00,186935,Staff,0,0,20,20
1683638622156,MUS 80,B00,186936,Staff,24,0,25,1
1683638623182,NANO 11,A00,204702,Lipomi; Darren John,0,0,0,0
1683638624214,NANO 15,A01,204709,Yang; Kesong,0,1,0,0
1683638625245,NANO 114,A00,202069,Jahed Motlagh; Zeinab,3,0,10,7
1683638626274,PHIL 1,A00,186955,Grush; Rick Scott,31,0,40,9
1683638627304,PHIL 10,A01,186973,Grush; Rick Scott,27,0,35,8
1683638627304,PHIL 10,A02,186974,Grush; Rick Scott,33,0,35,2
1683638628329,PHIL 13,A01,186976,Staff,3,0,35,32
1683638628329,PHIL 13,A02,186977,Staff,16,0,35,19
1683638629357,PHIL 14,A01,186979,Staff,31,0,35,4
1683638629357,PHIL 14,A02,186986,Staff,32,0,35,3
1683638630388,PHIL 28,A01,186988,Staff,16,0,30,14
1683638630388,PHIL 28,A02,186989,Staff,1,0,30,29
1683638630388,PHIL 28,A03,186990,Staff,10,0,30,20
1683638630388,PHIL 28,A04,186991,Staff,26,0,30,4
1683638631416,PHIL 120,A00,186997,Staff,23,0,40,17
1683638632441,PHIL 137,A00,187003,Staff,7,0,40,33
1683638633466,PHIL 150,A00,187015,Staff,47,0,70,23
1683638634492,PHIL 167,A00,187021,Lamey; Andy M.,34,0,40,6
1683638635518,PHIL 174,A01,202226,Staff,17,0,20,3
1683638635518,PHIL 174,A02,202235,Staff,20,0,20,0
1683638636543,PHIL 191A,A00,258918,Staff,0,0,1,1
1683638637568,PHYS 1A,A00,187028,Staff,27,0,60,33
1683638638593,PHYS 1AL,001,187036,Staff,3,0,30,27
1683638638593,PHYS 1AL,002,187049,Staff,18,0,30,12
1683638639620,PHYS 1B,A00,187058,Staff,22,0,60,38
1683638640646,PHYS 1BL,001,187064,Staff,0,1,30,30
1683638640646,PHYS 1BL,002,187070,Staff,4,0,30,26
1683638641728,PHYS 1C,A00,187082,Staff,29,0,120,91
1683638642759,PHYS 1CL,001,187088,Staff,0,9,30,30
1683638642759,PHYS 1CL,002,187089,Staff,0,1,30,30
1683638642759,PHYS 1CL,009,262693,Staff,9,0,30,21
1683638643789,PHYS 2B,A01,187097,Staff,55,0,115,60
1683638644818,PHYS 2C,A01,187099,Staff,64,0,115,51
1683638645843,PHYS 2CL,A01,187101,Staff,5,0,28,23
1683638645843,PHYS 2CL,A02,187102,Staff,15,0,28,13
1683638646869,PHYS 2D,A01,187123,Shotwell; Brian,95,0,115,20
1683638647903,PHYS 4B,A01,187133,Grinstein; Benjamin,35,0,50,15
1683638648932,POLI 10,A00,188819,Staff,0,4,50,50
1683638649958,POLI 11,A00,188827,Staff,43,0,50,7
1683638650989,POLI 13R,A00,188828,Staff,0,1,20,20
1683638652015,POLI 27,A01,188830,Elgin; Samuel Zincke,0,2,70,70
1683638653043,POLI 30,A00,188832,Desposato; Scott,30,0,50,20
1683638654068,POLI 102F,A00,188834,Staff,0,0,40,40
1683638655096,POLI 104A,A00,188852,Staff,13,0,30,17
1683638656121,POLI 104I,A00,188853,Staff,0,7,20,20
1683638657147,POLI 110B,A00,188854,Wiens; David,7,0,20,13
1683638658173,POLI 112A,A00,188855,Wiens; David,4,0,30,26
1683638659201,POLI 117R,A00,188856,Forman; Fonna,0,12,20,20
1683638660228,POLI 118,A00,188857,Ingham; Sean,8,0,20,12
1683638661254,POLI 120G,A00,188858,Staff,8,0,30,22
1683638662281,POLI 131CR,A00,188863,Hoston; Germaine,21,0,50,29
1683638663311,POLI 133,A00,188864,Nellis; Gareth Hb,44,0,50,6
1683638664340,POLI 134D,A00,188865,Desposato; Scott,27,0,30,3
1683638665366,POLI 142A,A00,188871,Gartzke; Erik,21,0,50,29
1683638666391,POLI 142K,A00,188874,Staff,38,0,50,12
1683638667416,POLI 143,A00,188940,Gartzke; Erik,16,0,30,14
1683638668442,POLI 153,A00,188943,Staff,2,0,20,18
1683638669468,POLI 160AA,A00,188944,Staff,11,0,40,29
1683638670498,POLI 170A,A00,188945,Staff,11,0,30,19
1683638672557,PSYC 1,A00,188952,Staff,36,0,90,54
1683638673584,PSYC 2,B00,188953,Staff,19,0,35,16
1683638674609,PSYC 6,A00,188970,Staff,47,0,60,13
1683638675637,PSYC 7,A00,188973,Staff,35,0,45,10
1683638676661,PSYC 60,A01,188980,Rickard; Timothy C.,42,0,60,18
1683638677688,PSYC 70,A01,189001,Steiner; Eric Tomas,23,0,45,22
1683638678719,PSYC 100,A00,189005,Lacefield; Katharine I,0,99,120,120
1683638679743,PSYC 102,A00,189008,Staff,8,0,30,22
1683638680771,PSYC 106,B00,189026,Gorman; Michael R.,27,0,60,33
1683638681801,PSYC 114,B01,189033,Winkielman; Piotr,0,31,30,30
1683638682828,PSYC 131,A00,189036,Anagnostaras; Stephan,0,43,60,60
1683638683853,PSYC 136,A00,189041,Lowe; Angela Beth,0,7,25,25
1683638684879,PSYC 137,A00,189057,Winkielman; Piotr,0,37,25,25
1683638685911,PSYC 144,A00,189107,Wixted; John T,0,10,50,50
1683638687971,PSYC 162,A00,189142,Staff,0,9,85,85
1683638688999,PSYC 172,A00,189144,Gorman; Michael R.,0,6,30,30
1683638691051,PSYC 179,A00,189146,Lacefield; Katharine I,0,86,120,120
1683638692079,PSYC 181,A00,189147,Anagnostaras; Stephan,0,44,90,90
1683638693105,PSYC 190R,A00,189148,Barner; David A.,0,23,80,80
1683638694132,PSYC 191,A00,189275,Rickard; Timothy C.,0,10,25,25
1683638695159,PSYC 193,A00,189276,Chapman; Eddie Nathaniel,0,1,0,4
1683638696191,PSYC 193L,A01,189281,Lowe; Angela Beth,10,0,20,10
1683638696191,PSYC 193L,B01,189285,Staff,28,0,35,7
1683638697220,RELI 149,A00,187137,Rahimi; Babak,7,0,40,33
1683638698247,SE 9,A01,187315,Staff,0,2,18,18
1683638699272,SE 101B,A00,187409,Staff,24,0,30,6
1683638700298,SE 110B,A00,187444,Staff,10,0,40,30
1683638701323,SE 130B,A00,187449,Staff,31,0,40,9
1683638702353,SE 150A,A00,187516,Staff,9,0,20,11
1683638703382,SE 154,A00,187528,Staff,29,0,50,21
1683638704407,SIO 3,A01,258171,Staff,35,0,40,5
1683638705436,SIO 10,A00,187144,Cook; Geoffrey W,0,6,75,75
1683638706461,SIO 45,A00,187152,Cook; Geoffrey W,0,4,100,100
1683638707486,SIO 109R,A00,194486,Staff,0,4,20,20
1683638709542,SIO 187,A01,187233,Kacev; David,12,0,40,28
1683638710577,SOCI 1,A01,258656,Thorpe; Charles Robert,28,0,30,2
1683638710577,SOCI 1,A02,258658,Thorpe; Charles Robert,30,0,30,0
1683638710577,SOCI 1,A03,258661,Thorpe; Charles Robert,25,0,25,0
1683638710577,SOCI 1,A04,258666,Thorpe; Charles Robert,22,0,25,3
1683638710577,SOCI 1,A05,258897,Thorpe; Charles Robert,22,0,25,3
1683638710577,SOCI 1,A06,258898,Thorpe; Charles Robert,25,0,25,0
1683638711607,SOCI 30,A01,258903,Pardo Guerra; Juan Pablo,14,0,30,16
1683638712632,SOCI 102,A00,258904,Staff,9,0,25,16
1683638713659,SOCI 106,A00,258905,Staff,19,0,25,6
1683638714689,SOCI 111,A00,258907,Ribas Norris; Janet Vanesa,26,0,30,4
1683638715719,SOCI 121R,A00,258908,Pardo Guerra; Juan Pablo,8,0,30,22
1683638716748,SOCI 126,A01,203330,Staff,14,0,20,6
1683638717775,SOCI 131,A00,258909,Thorpe; Charles Robert,30,0,60,30
1683638718805,SOCI 135,A00,258910,Payne; Christine Anna,0,11,30,30
1683638719835,SOCI 157,A00,258911,Staff,12,0,30,18
1683638720862,SOCI 184,A00,258912,Staff,25,0,30,5
1683638721886,SOCI 188D,A00,258913,Staff,22,0,30,8
1683638722911,SYN 2,001,187529,Staff,9,0,16,7
1683638722911,SYN 2,002,201452,Staff,0,20,16,16
1683638722911,SYN 2,003,201469,Staff,2,0,16,14
1683638723936,SYN 100,A01,187531,Staff,0,9,20,20
1683638723936,SYN 100,B01,201491,Staff,0,10,20,20
1683638724964,TDAC 1,A00,189286,Walsh; Kim C.,3,0,20,17
1683638724964,TDAC 1,B00,189287,Harting; Carla Kelso,10,0,20,10
1683638725988,TDAC 101,A00,189300,Walsh; Kim C.,16,0,20,4
1683638725988,TDAC 101,B00,189301,Harting; Carla Kelso,18,0,20,2
1683638727021,TDAC 102,A00,189304,Basso; Beatrice,14,0,20,6
1683638728050,TDAC 108,A00,189305,Staff,18,0,20,2
1683638729090,TDDE 131,A00,189310,Staff,19,0,20,1
1683638729090,TDDE 131,B00,189314,Staff,19,0,20,1
1683638729090,TDDE 131,C00,189315,Staff,48,0,50,2
1683638729090,TDDE 131,D00,189316,Staff,14,0,15,1
1683638729090,TDDE 131,E00,204841,Staff,20,0,20,0
1683638730119,TDGE 10,A00,189289,Staff,27,0,50,23
1683638730119,TDGE 10,B00,189290,Havis; Allan,0,0,50,50
1683638731150,TDGE 11,A00,189291,Fulton; Julia,0,4,50,50
1683638731150,TDGE 11,B00,189292,Staff,20,0,25,5
1683638731150,TDGE 11,C00,260270,Staff,0,0,0,0
1683638732175,TDGE 25,A00,189294,Staff,2,0,20,18
1683638733201,TDGE 124,A00,189318,Fulton; Julia,0,8,50,50
1683638734226,TDGE 125,A00,189319,Staff,13,0,25,12
1683638734226,TDGE 125,B00,189320,Staff,23,0,25,2
1683638735252,TDGE 127,A00,189322,Havis; Allan,0,0,50,50
1683638736280,TDHT 101,A00,189323,Staff,18,0,25,7
1683638736280,TDHT 101,B00,189324,Staff,25,0,25,0
1683638737309,TDHT 102,A00,189325,Staff,49,0,50,1
1683638738337,TDMV 1,A00,189295,Arcidiacono; Kristin,20,0,30,10
1683638738337,TDMV 1,B00,189296,Caligagan; Maria T.,24,0,30,6
1683638739366,TDMV 2,A00,189297,Sammartano; Tonnie,27,0,30,3
1683638739366,TDMV 2,B00,189299,Arcidiacono; Kristin,23,0,30,7
1683638740396,TDMV 3,A00,204998,Rincon; Alicia,22,0,30,8
1683638741424,TDMV 120,A00,189458,Sammartano; Tonnie,28,0,30,2
1683638742457,TDMV 138,A00,189541,Jun; Grace Shin Hae,20,0,40,20
1683638743483,TDMV 142,A00,189717,Caligagan; Tony,25,0,30,5
1683638743483,TDMV 142,B00,189718,Caligagan; Maria T.,25,0,30,5
1683638744509,TMC 2,A01,187533,Staff,25,0,25,0
1683638744509,TMC 2,A02,187534,Staff,25,0,25,0
1683638745590,USP 1,A01,187536,Kwak; Nancy,0,16,25,25
1683638746615,USP 5,A01,187538,Staff,9,0,25,16
1683638747641,USP 101,A00,199253,Staff,0,4,0,0
1683638748668,USP 124,A00,187562,Boomhower; Matthew Charles,0,0,30,30
1683638749694,USP 138,A00,187582,Staff,20,0,25,5
1683638750719,USP 152,A01,187597,Staff,3,0,25,22
1683638751744,USP 153,A00,187598,Staff,19,0,25,6
1683638752784,USP 168,A00,187607,Kwak; Nancy,2,0,5,3
1683638753815,USP 173,A00,187619,Staff,4,0,25,21
1683638754843,USP 181,A00,187638,Staff,0,4,25,25
1683638755874,VIS 103,A00,187650,Cruz; Edwin Teddy,18,0,75,57
1683638756903,VIS 110D,A00,187669,Staff,13,0,22,9
1683638757929,VIS 127C,A00,187720,Shen; Kuiyi,67,0,146,79
1683638758955,VIS 149,A00,187731,Yoldas; Pinar,0,14,22,22
1683638759983,VIS 151,A01,188091,Staff,22,0,34,12
1683638759983,VIS 151,A02,188092,Staff,11,0,34,23
1683638761011,VIS 160B,A00,188093,Stalbaum; Brett,0,1,10,10
1683638763064,WCWP 10B,A00,201720,Staff,10,0,15,5
1683638763064,WCWP 10B,B00,201722,Staff,9,0,15,6
1683638764090,WCWP 100,A00,201725,Gagnon; Jeffrey C,0,0,2,2
1683638764090,WCWP 100,B00,201727,Staff,0,4,15,15
1683638767256,ANBI 133,A00,258401,Wilder; Linnea Lorene,34,0,40,6
1683638768282,ANBI 140,A00,258395,Hrvoj Mihic; Branka,18,0,25,7
1683638769307,ANSC 120,A00,258402,Bialecki; Jon Anthony,27,0,40,13
1683638770331,ANSC 144,A00,258400,Staff,12,0,40,28
1683638772382,ANSC 166,A00,258396,Parish; Steven Martin,156,0,175,19
1683638773412,ANSC 180,A00,193533,Staff,8,0,20,12
1683638774443,ANSC 188,A00,258397,Jassal; Aftab,34,0,40,6
1683638775472,ANTH 3,A01,258316,Staff,23,0,30,7
1683638776498,ANTH 5,A00,258394,Semendeferi; Ekaterini,16,0,20,4
1683638777523,ANTH 21,A01,258331,Staff,4,0,40,36
1683638778548,ANTH 103,A00,258398,Varma; Saiba,15,0,25,10
1683638779577,AWP 10,001,202034,Staff,0,0,0,0
1683638779577,AWP 10,002,202035,Staff,0,0,0,0
1683638779577,AWP 10,003,202036,Staff,0,0,0,0
1683638779577,AWP 10,004,202037,Staff,0,0,0,0
1683638779577,AWP 10,005,202038,Staff,0,0,0,0
1683638779577,AWP 10,006,202039,Staff,0,0,0,0
1683638779577,AWP 10,007,202040,Staff,0,0,0,0
1683638779577,AWP 10,008,202041,Staff,0,0,0,0
1683638779577,AWP 10,009,202042,Staff,0,0,0,0
1683638779577,AWP 10,010,202043,Staff,0,0,0,0
1683638779577,AWP 10,011,202044,Staff,0,0,0,0
1683638779577,AWP 10,012,202045,Staff,0,0,0,0
1683638779577,AWP 10,013,202046,Staff,0,0,0,0
1683638779577,AWP 10,014,202047,Staff,0,0,0,0
1683638779577,AWP 10,015,202048,Staff,0,0,0,0
1683638779577,AWP 10,016,202049,Staff,0,0,0,0
1683638779577,AWP 10,017,202050,Staff,0,0,0,0
1683638779577,AWP 10,018,202051,Staff,0,0,0,0
1683638779577,AWP 10,019,202052,Staff,0,0,0,0
1683638779577,AWP 10,020,202053,Staff,0,0,0,0
1683638779577,AWP 10,021,202054,Staff,0,0,0,0
1683638779577,AWP 10,022,202055,Staff,0,0,0,0
1683638779577,AWP 10,023,202056,Staff,0,0,0,0
1683638779577,AWP 10,024,202057,Staff,0,0,0,0
1683638779577,AWP 10,025,202058,Staff,0,0,0,0
1683638779577,AWP 10,026,202059,Staff,0,0,0,0
1683638780603,AWP 102,001,202032,Staff,0,0,0,0
1683638780603,AWP 102,002,202033,Staff,0,0,0,0
1683638781637,BENG 100,A01,254234,Taylor Amos; Alyssa C,31,0,40,9
1683638782661,BENG 196,001,270013,Engler; Adam J.,9999,0,9999,0
1683638783697,BICD 100R,A01,202018,Smith; Laurie,0,7,32,32
1683638783697,BICD 100R,A02,202019,Smith; Laurie,0,3,32,32
1683638783697,BICD 100R,A03,202020,Smith; Laurie,0,1,32,32
1683638783697,BICD 100R,A04,202021,Smith; Laurie,6,0,32,26
1683638783697,BICD 100R,A05,202022,Smith; Laurie,11,0,32,21
1683638784727,BICD 136,A01,193242,Gustafson-Brown; Cindy,0,2,32,32
1683638784727,BICD 136,A02,193244,Gustafson-Brown; Cindy,13,0,32,19
1683638785761,BIEB 102,A01,193249,Butler; Shannon Rhey,0,2,32,32
1683638785761,BIEB 102,A02,193251,Butler; Shannon Rhey,0,0,32,32
1683638785761,BIEB 102,A03,193253,Butler; Shannon Rhey,0,0,32,32
1683638785761,BIEB 102,A04,193255,Butler; Shannon Rhey,14,0,32,18
1683638785761,BIEB 102,A05,193265,Butler; Shannon Rhey,26,0,32,6
1683638785761,BIEB 102,A06,193269,Butler; Shannon Rhey,14,0,32,18
1683638787816,BIEB 150,A01,193274,Staff,0,0,32,32
1683638787816,BIEB 150,A02,193285,Staff,24,0,32,8
1683638788841,BIEB 194,A00,193286,Kurle; Carolyn M.,20,0,32,12
1683638789868,BILD 1,A01,192291,Staff,15,0,32,17
1683638789868,BILD 1,A02,192292,Staff,30,0,32,2
1683638789868,BILD 1,B01,192520,Reuther; Keefe,0,1,0,0
1683638789868,BILD 1,B02,192532,Reuther; Keefe,0,1,0,0
1683638790898,BILD 3,A01,192556,Butler; Shannon Rhey,0,0,32,32
1683638790898,BILD 3,A02,192581,Butler; Shannon Rhey,1,0,32,31
1683638790898,BILD 3,A03,192611,Butler; Shannon Rhey,21,0,32,11
1683638790898,BILD 3,A04,192612,Butler; Shannon Rhey,24,0,32,8
1683638790898,BILD 3,A05,192613,Butler; Shannon Rhey,26,0,32,6
1683638790898,BILD 3,A06,192679,Butler; Shannon Rhey,27,0,32,5
1683638790898,BILD 3,A07,192682,Butler; Shannon Rhey,20,0,32,12
1683638791927,BILD 4,A01,192836,Reuther; Keefe,0,0,24,24
1683638791927,BILD 4,A02,193044,Reuther; Keefe,4,0,24,20
1683638792955,BILD 10,A01,193142,Gustafson-Brown; Cindy,29,0,32,3
1683638792955,BILD 10,A02,193149,Gustafson-Brown; Cindy,31,0,32,1
1683638793981,BIMM 100,A01,193301,Staff,0,6,32,32
1683638793981,BIMM 100,A02,193312,Staff,0,7,32,32
1683638793981,BIMM 100,A03,193323,Staff,0,9,32,32
1683638795008,BIMM 101,A01,193329,McDonnell; Lisa Marie,0,4,24,24
1683638795008,BIMM 101,A02,193339,McDonnell; Lisa Marie,0,3,24,24
1683638795008,BIMM 101,B01,193354,McDonnell; Lisa Marie,0,4,24,24
1683638795008,BIMM 101,B02,193357,McDonnell; Lisa Marie,0,2,24,24
1683638796034,BIMM 110,A01,193377,Tat; John,0,11,32,32
1683638796034,BIMM 110,A02,193378,Tat; John,0,10,32,32
1683638797065,BIMM 120,A01,206116,Staff,0,0,32,32
1683638797065,BIMM 120,A02,206117,Staff,6,0,32,26
1683638797065,BIMM 120,A03,206121,Staff,21,0,32,11
1683638798098,BIPN 100,A01,193393,Park; Ji Young,0,14,32,32
1683638798098,BIPN 100,A02,193402,Park; Ji Young,0,14,32,32
1683638798098,BIPN 100,A03,193413,Park; Ji Young,0,14,32,32
1683638798098,BIPN 100,A04,193414,Park; Ji Young,0,13,32,32
1683638799122,BIPN 102,A01,193429,Staff,0,0,32,32
1683638799122,BIPN 102,A02,193438,Staff,18,0,32,14
1683638800148,BIPN 106,A01,193450,Reyes Gonzalez; Catalina,0,2,40,40
1683638801178,BIPN 134,A01,193465,Cooke; James Edward,0,0,32,32
1683638801178,BIPN 134,A02,193474,Cooke; James Edward,25,0,32,7
1683638801178,BIPN 134,A03,193485,Cooke; James Edward,29,0,32,3
1683638801178,BIPN 134,A04,193486,Cooke; James Edward,20,0,32,12
1683638801178,BIPN 134,A05,193491,Cooke; James Edward,31,0,32,1
1683638801178,BIPN 134,A06,193501,Cooke; James Edward,30,0,32,2
1683638801178,BIPN 134,A07,193510,Cooke; James Edward,29,0,32,3
1683638803230,BISP 194,A00,222522,Staff,14,0,32,18
1683638804256,CAT 124,A01,202407,Staff,19,0,25,6
1683638805285,CAT 125,A00,202408,Marchisotto; Jennifer Anne,2,0,20,18
1683638806312,CAT 125R,A00,202409,Smith; Lauryn Alissa,0,11,20,20
1683638806312,CAT 125R,B00,202410,Morales; Celeste Georgianna,0,11,20,20
1683638806312,CAT 125R,C00,202411,Irwin; Matthew Joseph,0,12,20,20
1683638807338,CENG 15,A01,204712,Yang; Kesong,0,1,0,0
1683638808369,CENG 114,A00,202070,Jahed Motlagh; Zeinab,5,0,20,15
1683638809394,CGS 105,A00,185477,Wesling; Megan E.,24,0,40,16
1683638810419,CGS 106,A00,185494,Staff,11,0,22,11
1683638811443,CGS 108,A00,185495,Staff,14,0,20,6
1683638812468,CGS 114,A00,185496,Staff,13,0,18,5
1683638813493,CGS 119,A00,185501,Staff,15,0,20,5
1683638814520,CGS 120,A00,185511,Staff,12,0,20,8
1683638815553,CHEM 4,A01,184675,Bussey; Thomas J,97,0,100,3
1683638816578,CHEM 6A,A01,184677,Staff,33,0,60,27
1683638817603,CHEM 6B,A01,184679,Staff,63,0,100,37
1683638818630,CHEM 6C,A01,184681,Bussey; Thomas J,0,0,50,50
1683638818630,CHEM 6C,A02,184682,Bussey; Thomas J,32,0,50,18
1683638819657,CHEM 40A,A01,184684,Albizati; Kim F.,35,0,100,65
1683638820683,CHEM 40B,A01,184686,Albizati; Kim F.,0,22,100,100
1683638821712,CHEM 41B,A01,184690,Staff,51,0,100,49
1683638822744,COGS 3,A01,184715,Boyle; Mary E. T.,0,27,40,40
1683638823779,COGS 14B,A01,185172,Staff,0,14,38,38
1683638824810,COGS 18,A01,184736,Staff,15,0,80,65
1683638825835,COGS 100,A01,184932,Staff,0,7,73,73
1683638826860,COGS 101A,A01,184935,Staff,0,39,30,30
1683638827889,COGS 101B,A01,184944,Staff,0,2,30,30
1683638828917,COGS 101C,A01,184946,Staff,0,10,30,30
1683638829947,COGS 102A,A01,184951,Johnson; Christine M.,2,0,40,38
1683638830973,COGS 107B,A01,184953,Mooshagian; Eric Frederick,0,51,40,40
1683638831999,COGS 118B,A01,184959,Gupta; Anjum,0,49,40,40
1683638833025,COGS 153,A00,184961,Staff,0,16,30,30
1683638834053,COGS 177,A00,184962,Staff,0,21,30,30
1683638835081,COGS 187A,A01,184969,Boyle; Mary E. T.,0,19,40,40
1683638836113,COMM 10,A01,185174,Staff,0,5,25,25
1683638836113,COMM 10,A02,185189,Staff,0,2,25,25
1683638836113,COMM 10,A03,269821,Staff,0,1,0,0
1683638837143,COMM 100B,A01,185475,Staff,0,1,0,2
1683638837143,COMM 100B,A02,185476,Staff,12,0,25,13
1683638838169,COMM 100C,A01,185314,Staff,1,0,25,24
1683638838169,COMM 100C,A02,185327,Staff,18,0,25,7
1683638839194,COMM 110M,A00,185349,Staff,0,0,40,40
1683638840219,COMM 113T,A00,185352,Staff,25,0,40,15
1683638841246,COMM 114I,A00,185353,Staff,31,0,40,9
1683638842273,COMM 131,A00,185354,Staff,17,0,30,13
1683638843302,CSE 8A,A50,185358,Cao; Yingjun,0,46,10,10
1683638844328,CSE 8B,A01,185362,Staff,0,48,50,50
1683638845354,CSE 11,A01,185416,Cao; Yingjun,0,91,10,10
1683638846379,CSE 20,A01,185445,Briones; Jor-el Thomas Caparas,4,0,25,21
1683638847406,CSE 21,A01,185447,Staff,9,0,50,41
1683638848436,CSE 101,A01,185451,Staff,0,13,50,50
1683638848436,CSE 101,B01,185453,Jones; Miles E,0,13,50,50
1683638850553,CSE 141,A01,185458,Eldon; John,15,0,100,85
1683638851585,CSE 141L,A01,185461,Eldon; John,7,0,100,93
1683638852611,CSE 142,A01,185463,Staff,36,0,60,24
1683638852611,CSE 142,B01,201355,Staff,0,7,60,60
1683638853640,CSE 142L,A01,185470,Staff,36,0,60,24
1683638853640,CSE 142L,B01,201417,Staff,0,6,60,60
1683638854664,CSE 190,A00,201433,Staff,32,0,49,17
1683638855691,DOC 1,A01,259136,Strom; Megan C.,7,0,15,8
1683638855691,DOC 1,A02,259137,Strom; Megan C.,14,0,15,1
1683638855691,DOC 1,A03,259138,Strom; Megan C.,14,0,15,1
1683638855691,DOC 1,A04,259139,Strom; Megan C.,14,0,15,1
1683638856721,DOC 100D,A00,259140,Pass; Natalye Joann,14,0,25,11
1683638857748,DSGN 1,A01,184749,Rill; Bryan,0,26,30,30
1683638858776,DSGN 100,A01,185168,Staff,0,2,25,25
1683638859808,ECE 5,A01,185626,Morris; Karcher William,0,11,0,0
1683638860837,ECE 101,A01,185628,Staff,14,0,70,56
1683638861864,ECE 107,A01,185635,Baghdadchi; Saharnaz,0,0,20,20
1683638861864,ECE 107,A02,185638,Baghdadchi; Saharnaz,3,0,20,17
1683638862891,ECE 148,A01,185647,Silberman; Jack,0,0,16,16
1683638863920,ECON 1,A01,185537,Crane; Meredith Helen,54,0,70,16
1683638864945,ECON 3,A01,185549,Crane; Meredith Helen,29,0,70,41
1683638865971,ECON 4,A01,203354,Anderson; John Charles,0,5,10,10
1683638866997,ECON 100A,A01,185574,Staff,0,5,40,40
1683638868024,ECON 100B,A01,185576,Staff,0,12,50,50
1683638869051,ECON 100C,A01,185589,Newhouse; Herbert S,30,0,70,40
1683638870077,ECON 105,A00,185608,Vespa; Emanuel Ignacio,19,0,35,16
1683638871104,ECON 109,A01,185610,Shishkin; Denis,9,0,35,26
1683638872131,ECON 110A,A01,185612,Staff,9,0,40,31
1683638873158,ECON 120A,A01,185615,Staff,20,0,40,20
1683638874187,ECON 120C,A01,185617,Sun; Yixiao,0,20,70,70
1683638875213,ECON 144,A00,203346,Squires; Dale E,2,0,35,33
1683638876243,ECON 171,A01,203349,Newhouse; Herbert S,0,1,35,35
1683638877269,ECON 173A,A01,185621,Toda; Alexis Akira,21,0,35,14
1683638878296,EDS 25,A01,202413,Staff,0,1,0,0
1683638878296,EDS 25,A02,202414,Staff,0,1,0,0
1683638878296,EDS 25,A03,202415,Staff,0,0,0,0
1683638878296,EDS 25,A04,202416,Staff,0,1,0,0
1683638878296,EDS 25,A05,202439,Staff,0,0,0,0
1683638878296,EDS 25,A06,202440,Staff,0,0,0,0
1683638878296,EDS 25,B01,202631,Staff,0,0,0,0
1683638878296,EDS 25,B02,202632,Staff,0,0,0,0
1683638878296,EDS 25,B03,202639,Staff,0,0,0,0
1683638878296,EDS 25,B04,202640,Staff,0,0,0,0
1683638878296,EDS 25,B05,202643,Staff,0,0,0,0
1683638878296,EDS 25,B06,202644,Staff,0,0,0,0
1683638879323,EDS 38,A01,202659,Black; Alison Michelle,24,0,25,1
1683638880347,EDS 115,A00,202652,Staff,18,0,30,12
1683638881370,EDS 125,A00,202649,Staff,13,0,30,17
1683638882394,EDS 126,A01,203332,Staff,30,0,30,0
1683638883422,EDS 139,A00,202838,Staff,16,0,25,9
1683638884451,EDS 146,A01,202655,Staff,14,0,25,11
1683638885477,ENG 15,A00,185667,Staff,0,1,0,0
1683638885477,ENG 15,B00,185672,Staff,0,0,0,0
1683638885477,ENG 15,C00,185675,Staff,0,0,0,0
1683638885477,ENG 15,D00,185682,Staff,0,0,0,0
1683638885477,ENG 15,E00,185684,Staff,0,0,0,0
1683638886502,ETHN 103,A00,185710,Staff,0,8,35,35
1683638887527,ETHN 103A,A00,199228,Man; Simeon S,0,0,9,9
1683638888553,ETHN 109,A00,185711,Staff,16,0,35,19
1683638889581,ETHN 142,A00,185726,Staff,0,4,30,30
1683638890609,ETHN 163J,A00,199229,Man; Simeon S,5,0,8,3
1683638891636,ETHN 168,A00,185727,Staff,7,0,10,3
1683638892660,ETHN 182,A00,185728,Staff,0,0,35,35
1683638893689,ETHN 183,A00,185737,Staff,9,0,18,9
1683638894721,GLBH 111,A01,209361,Burgos; Jose L.,0,0,0,0
1683638896779,HIEU 104,A00,185792,Staff,14,0,20,6
1683638897803,HIEU 115,A00,185800,Staff,0,0,20,20
1683638898828,HIEU 128,A00,185801,Staff,0,9,20,20
1683638899856,HIEU 147,A00,185802,Staff,15,0,20,5
1683638900881,HIEU 154,A00,185823,Staff,11,0,20,9
1683638901907,HILA 102,A00,185826,Staff,14,0,20,6
1683638902936,HILD 2C,A01,185778,Staff,0,13,20,20
1683638903964,HILD 7B,A01,185780,Kwak; Nancy,0,16,32,32
1683638903964,HILD 7B,A02,185781,Kwak; Nancy,0,18,32,32
1683638904993,HILD 30,A01,185791,Staff,12,0,20,8
1683638906022,HISC 119,A00,185830,Golan; Tal,0,9,20,20
1683638907046,HITO 156GS,A00,185831,Patterson; Patrick H.,0,0,0,23
1683638908074,HIUS 103,A00,185832,Man; Simeon S,0,4,20,20
1683638909102,HIUS 117,A00,185836,Kwak; Nancy,2,0,20,18
1683638910130,HIUS 125,A00,185840,Man; Simeon S,0,1,23,23
1683638911158,HIUS 149,A00,185845,Staff,1,0,20,19
1683638912185,HUM 3,A01,185882,Zavodny; Tatiana Sophia,0,7,50,50
1683638912185,HUM 3,B01,185899,Caldwell; Michael Alan,0,18,50,50
1683638913209,HUM 3GS,A00,185900,Patterson; Patrick H.,0,0,0,23
1683638914235,HUM 4,A01,185938,Zroka; Amy Liane,30,0,50,20
1683638914235,HUM 4,B01,185956,Watkins; Eric,0,4,50,50
1683638914235,HUM 4,B02,202209,Watkins; Eric,0,4,50,50
1683638914235,HUM 4,B03,202210,Watkins; Eric,0,4,50,50
1683638915261,HUM 5,A01,185958,West; Geoffrey Scott,2,0,50,48
1683638915261,HUM 5,A02,202215,West; Geoffrey Scott,0,0,50,50
1683638916294,INTL 190,A00,185959,Gagnon; Jeffrey C,0,0,0,9
1683638916294,INTL 190,B00,185960,Lettieri; Michael Joseph,0,0,0,2
1683638917324,JAPN 180,A00,254509,Staff,5,0,30,25
1683638918357,LATI 10,A01,202853,Kennemore; Amy Michelle,4,0,35,31
1683638918357,LATI 10,A02,202854,Kennemore; Amy Michelle,2,0,35,33
1683638918357,LATI 10,A03,270054,Kennemore; Amy Michelle,30,0,30,0
1683638919385,LATI 180,A00,202855,Kennemore; Amy Michelle,11,0,20,9
1683638920411,LAWS 101,A00,201767,Golan; Tal,0,7,40,40
1683638921436,LIFR 1C,A00,185961,Staff,6,0,20,14
1683638922460,LIFR 1CX,A00,185962,Staff,7,0,20,13
1683638923485,LIFR 1D,A00,185963,Staff,7,0,20,13
1683638924510,LIFR 1DX,A00,185964,Staff,7,0,20,13
1683638925534,LIGN 101,A01,186039,Staff,43,0,50,7
1683638926562,LIGN 165,A00,186040,Staff,15,0,50,35
1683638927590,LTCS 108,A00,186041,Staff,5,0,10,5
1683638928617,LTCS 119,A00,186042,Staff,15,0,20,5
1683638929649,LTCS 130,A00,186043,Wesling; Megan E.,15,0,25,10
1683638931704,LTEA 138,A00,186119,Staff,14,0,40,26
1683638932730,LTEN 124,A00,186148,Staff,5,0,25,20
1683638933757,LTEN 178,A00,186149,Staff,7,0,15,8
1683638934788,LTEN 181,A00,186150,Blanco; John D,34,0,40,6
1683638935817,LTWL 120,A00,186160,Staff,20,0,25,5
1683638936842,LTWL 165,A00,186161,Staff,22,0,25,3
1683638937867,LTWR 100,A00,186162,Staff,0,5,15,15
1683638938891,LTWR 102,A00,186163,Doller; Ben,5,0,15,10
1683638939917,MAE 8,A01,186412,Staff,0,0,0,0
1683638940942,MAE 30B,A00,186445,Bahadori; Mohammad Yousef,82,0,100,18
1683638941974,MAE 40,A00,186592,Bewley; Thomas R,10,0,50,40
1683638943005,MAE 101B,A00,186593,Bahadori; Mohammad Yousef,80,0,100,20
1683638944031,MAE 105,A00,186594,Bandaru; Prabhakar,10,0,50,40
1683638945058,MAE 107,A00,186599,Pham; Hieu Tan,0,7,120,120
1683638946082,MAE 148,A01,186660,Silberman; Jack,3,0,16,13
1683638947108,MATH 10A,A01,188095,Staff,0,5,35,35
1683638948134,MATH 10B,A01,188097,Bowers; Adam R.,0,11,30,30
1683638948134,MATH 10B,A02,188099,Bowers; Adam R.,0,11,30,30
1683638948134,MATH 10B,B01,188104,Bowers; Adam R.,0,10,30,30
1683638948134,MATH 10B,B02,188106,Bowers; Adam R.,1,9,30,29
1683638949160,MATH 10C,A01,188111,Staff,0,18,30,30
1683638949160,MATH 10C,A02,188127,Staff,0,19,30,30
1683638949160,MATH 10C,A03,188131,Staff,0,19,30,30
1683638949160,MATH 10C,B01,188218,Staff,17,0,30,13
1683638949160,MATH 10C,B02,188244,Staff,13,0,30,17
1683638949160,MATH 10C,B03,188277,Staff,14,0,30,16
1683638950186,MATH 18,A01,188344,Bach; Quang Tran,18,0,30,12
1683638950186,MATH 18,A02,188345,Bach; Quang Tran,11,0,30,19
1683638950186,MATH 18,B01,188353,Bach; Quang Tran,11,0,30,19
1683638950186,MATH 18,B02,188354,Bach; Quang Tran,19,0,30,11
1683638951210,MATH 20A,A01,188374,Staff,11,0,35,24
1683638952242,MATH 20B,A01,188382,Ohm; Ko Woon,7,0,30,23
1683638952242,MATH 20B,A02,188383,Ohm; Ko Woon,22,0,30,8
1683638952242,MATH 20B,B01,188385,Ohm; Ko Woon,7,0,30,23
1683638952242,MATH 20B,B02,188392,Ohm; Ko Woon,22,0,30,8
1683638953325,MATH 20C,A01,188394,Harel; Guershon,11,0,30,19
1683638953325,MATH 20C,A02,188395,Harel; Guershon,14,0,30,16
1683638953325,MATH 20C,B01,188404,Harel; Guershon,4,0,30,26
1683638953325,MATH 20C,B02,188405,Harel; Guershon,18,0,30,12
1683638954351,MATH 20D,A01,188414,Hammock; Frances H,0,1,30,30
1683638954351,MATH 20D,A02,188415,Hammock; Frances H,0,1,30,30
1683638954351,MATH 20D,B01,188447,Hammock; Frances H,0,1,30,30
1683638954351,MATH 20D,B02,188486,Hammock; Frances H,4,0,30,26
1683638955376,MATH 20E,A01,188649,Staff,21,0,30,9
1683638955376,MATH 20E,A02,188650,Staff,21,0,30,9
1683638955376,MATH 20E,A03,188673,Staff,0,0,30,30
1683638956403,MATH 102,A01,188675,Staff,0,36,35,35
1683638957430,MATH 103B,A01,188681,Staff,3,0,35,32
1683638957430,MATH 103B,B01,188692,Staff,5,0,35,30
1683638958460,MATH 109,A01,188695,Salehi Golsefidy; Alireza,24,0,35,11
1683638958460,MATH 109,A02,188696,Salehi Golsefidy; Alireza,25,0,35,10
1683638959490,MATH 120A,A01,188698,Eggers; John Dietrich,7,0,35,28
1683638960515,MATH 142B,A01,188736,Ioana; Adrian,0,1,30,30
1683638960515,MATH 142B,A02,188741,Ioana; Adrian,0,1,30,30
1683638960515,MATH 142B,A03,188743,Ioana; Adrian,0,1,30,30
1683638961540,MATH 168A,A01,188790,Staff,0,10,35,35
1683638962565,MATH 170A,A01,188803,Nie; Jiawang,0,2,35,35
1683638962565,MATH 170A,A02,188811,Nie; Jiawang,0,0,35,35
1683638962565,MATH 170A,A03,188814,Nie; Jiawang,0,0,35,35
1683638962565,MATH 170A,A04,188815,Nie; Jiawang,10,0,35,25
1683638963590,MATH 193B,A01,188817,Staff,0,0,35,35
1683638963590,MATH 193B,A02,188818,Staff,5,0,35,30
1683638964616,MGT 4,A01,202857,Anderson; John Charles,61,0,80,19
1683638965646,MGT 12,A00,202858,Lindenberger; Wade Douglas,40,0,90,50
1683638966674,MGT 18,A00,202859,Staff,74,0,90,16
1683638967700,MGT 18GS,A00,202860,McKay; Michael J,13,0,28,15
1683638968729,MGT 45,A00,202861,Pecore; Joseph P.,12,0,90,78
1683638969758,MGT 100,A00,202863,Yavorsky; Daniel Ryan,28,0,90,62
1683638970787,MGT 103,A00,202864,Ehrich; Kristine R,0,17,90,90
1683638971815,MGT 112,A00,202865,Ehrich; Kristine R,15,0,90,75
1683638972844,MGT 121A,A00,202868,Staff,0,20,0,0
1683638973872,MGT 131B,A00,202869,Anderson; John Charles,59,0,90,31
1683638974900,MGT 136,A00,202871,Lindenberger; Wade Douglas,83,0,90,7
1683638975926,MGT 164,A00,202873,Staff,0,66,90,91
1683638976953,MGT 164GS,A00,202874,McKay; Mary A,13,0,28,15
1683638977979,MGT 180,A00,202875,Staff,0,50,90,91
1683638979005,MMW 11R,A01,205019,Herbst; Matthew,2,0,30,28
1683638979005,MMW 11R,A02,205026,Herbst; Matthew,29,0,30,1
1683638980031,MMW 15,A01,193512,Chang; Edmond Yi-Teh,0,8,28,28
1683638980031,MMW 15,A02,193513,Chang; Edmond Yi-Teh,0,5,28,28
1683638980031,MMW 15,A03,193514,Chang; Edmond Yi-Teh,0,5,28,28
1683638980031,MMW 15,A04,193515,Chang; Edmond Yi-Teh,0,5,28,28
1683638980031,MMW 15,A05,193516,Chang; Edmond Yi-Teh,0,5,28,28
1683638980031,MMW 15,A06,193517,Chang; Edmond Yi-Teh,0,6,28,28
1683638980031,MMW 15,B01,193519,Chang; Edmond Yi-Teh,0,5,28,28
1683638980031,MMW 15,B02,193520,Chang; Edmond Yi-Teh,0,5,28,28
1683638980031,MMW 15,B03,193521,Chang; Edmond Yi-Teh,0,5,28,28
1683638980031,MMW 15,B04,193522,Chang; Edmond Yi-Teh,0,5,28,28
1683638980031,MMW 15,B05,193523,Chang; Edmond Yi-Teh,0,5,28,28
1683638980031,MMW 15,B06,193524,Chang; Edmond Yi-Teh,0,5,28,28
1683638981057,MMW 122,A01,193526,Rahimi; Babak,0,16,28,28
1683638981057,MMW 122,A02,193527,Rahimi; Babak,0,15,28,28
1683638981057,MMW 122,A03,193528,Rahimi; Babak,0,0,0,0
1683638981057,MMW 122,A04,193529,Rahimi; Babak,0,0,0,0
1683638982087,MUS 1A,A01,186663,Staff,1,20,35,34
1683638983116,MUS 4,A01,186715,Staff,0,12,35,35
1683638984143,MUS 5R,A01,186796,Dubnov; Shlomo,0,17,35,35
1683638985173,MUS 6,A01,186798,Staff,0,5,25,25
1683638986203,MUS 7,A01,186830,Staff,11,0,35,24
1683638987229,MUS 8,A01,186930,Staff,0,26,35,35
1683638988254,MUS 15,A01,186932,Staff,0,16,35,35
1683638988254,MUS 15,B01,186934,Staff,0,17,35,35
1683638989278,MUS 80,A00,186935,Staff,0,0,20,20
1683638989278,MUS 80,B00,186936,Staff,24,0,25,1
1683638990307,NANO 11,A00,204702,Lipomi; Darren John,0,0,0,0
1683638991337,NANO 15,A01,204709,Yang; Kesong,0,1,0,0
1683638992366,NANO 114,A00,202069,Jahed Motlagh; Zeinab,3,0,10,7
1683638993398,PHIL 1,A00,186955,Grush; Rick Scott,31,0,40,9
1683638994424,PHIL 10,A01,186973,Grush; Rick Scott,27,0,35,8
1683638994424,PHIL 10,A02,186974,Grush; Rick Scott,33,0,35,2
1683638995448,PHIL 13,A01,186976,Staff,3,0,35,32
1683638995448,PHIL 13,A02,186977,Staff,16,0,35,19
1683638996473,PHIL 14,A01,186979,Staff,31,0,35,4
1683638996473,PHIL 14,A02,186986,Staff,32,0,35,3
1683638997498,PHIL 28,A01,186988,Staff,16,0,30,14
1683638997498,PHIL 28,A02,186989,Staff,1,0,30,29
1683638997498,PHIL 28,A03,186990,Staff,10,0,30,20
1683638997498,PHIL 28,A04,186991,Staff,26,0,30,4
1683638998523,PHIL 120,A00,186997,Staff,23,0,40,17
1683638999549,PHIL 137,A00,187003,Staff,7,0,40,33
1683639000573,PHIL 150,A00,187015,Staff,47,0,70,23
1683639001605,PHIL 167,A00,187021,Lamey; Andy M.,34,0,40,6
1683639002638,PHIL 174,A01,202226,Staff,17,0,20,3
1683639002638,PHIL 174,A02,202235,Staff,20,0,20,0
1683639003664,PHIL 191A,A00,258918,Staff,0,0,1,1
1683639004688,PHYS 1A,A00,187028,Staff,27,0,60,33
1683639005719,PHYS 1AL,001,187036,Staff,3,0,30,27
1683639005719,PHYS 1AL,002,187049,Staff,18,0,30,12
1683639006749,PHYS 1B,A00,187058,Staff,22,0,60,38
1683639007778,PHYS 1BL,001,187064,Staff,0,1,30,30
1683639007778,PHYS 1BL,002,187070,Staff,4,0,30,26
1683639008803,PHYS 1C,A00,187082,Staff,29,0,120,91
1683639009829,PHYS 1CL,001,187088,Staff,0,9,30,30
1683639009829,PHYS 1CL,002,187089,Staff,0,1,30,30
1683639009829,PHYS 1CL,009,262693,Staff,9,0,30,21
1683639010860,PHYS 2B,A01,187097,Staff,55,0,115,60
1683639011889,PHYS 2C,A01,187099,Staff,64,0,115,51
1683639012919,PHYS 2CL,A01,187101,Staff,5,0,28,23
1683639012919,PHYS 2CL,A02,187102,Staff,15,0,28,13
1683639013954,PHYS 2D,A01,187123,Shotwell; Brian,95,0,115,20
1683639014981,PHYS 4B,A01,187133,Grinstein; Benjamin,35,0,50,15
1683639016007,POLI 10,A00,188819,Staff,0,4,50,50
1683639017032,POLI 11,A00,188827,Staff,43,0,50,7
1683639018056,POLI 13R,A00,188828,Staff,0,1,20,20
1683639019084,POLI 27,A01,188830,Elgin; Samuel Zincke,0,2,70,70
1683639020109,POLI 30,A00,188832,Desposato; Scott,30,0,50,20
1683639021136,POLI 102F,A00,188834,Staff,0,0,40,40
1683639022160,POLI 104A,A00,188852,Staff,13,0,30,17
1683639023187,POLI 104I,A00,188853,Staff,0,7,20,20
1683639024216,POLI 110B,A00,188854,Wiens; David,7,0,20,13
1683639025242,POLI 112A,A00,188855,Wiens; David,4,0,30,26
1683639026267,POLI 117R,A00,188856,Forman; Fonna,0,12,20,20
1683639027295,POLI 118,A00,188857,Ingham; Sean,8,0,20,12
1683639028317,POLI 120G,A00,188858,Staff,8,0,30,22
1683639029347,POLI 131CR,A00,188863,Hoston; Germaine,21,0,50,29
1683639030372,POLI 133,A00,188864,Nellis; Gareth Hb,44,0,50,6
1683639031398,POLI 134D,A00,188865,Desposato; Scott,27,0,30,3
1683639032423,POLI 142A,A00,188871,Gartzke; Erik,21,0,50,29
1683639033452,POLI 142K,A00,188874,Staff,38,0,50,12
1683639034482,POLI 143,A00,188940,Gartzke; Erik,16,0,30,14
1683639035510,POLI 153,A00,188943,Staff,2,0,20,18
1683639036535,POLI 160AA,A00,188944,Staff,11,0,40,29
1683639037561,POLI 170A,A00,188945,Staff,11,0,30,19
1683639039611,PSYC 1,A00,188952,Staff,36,0,90,54
1683639040641,PSYC 2,B00,188953,Staff,19,0,35,16
1683639041666,PSYC 6,A00,188970,Staff,47,0,60,13
1683639042692,PSYC 7,A00,188973,Staff,35,0,45,10
1683639043718,PSYC 60,A01,188980,Rickard; Timothy C.,42,0,60,18
1683639044744,PSYC 70,A01,189001,Steiner; Eric Tomas,23,0,45,22
1683639045770,PSYC 100,A00,189005,Lacefield; Katharine I,0,99,120,120
1683639046795,PSYC 102,A00,189008,Staff,8,0,30,22
1683639047821,PSYC 106,B00,189026,Gorman; Michael R.,27,0,60,33
1683639048847,PSYC 114,B01,189033,Winkielman; Piotr,0,31,30,30
1683639049872,PSYC 131,A00,189036,Anagnostaras; Stephan,0,43,60,60
1683639050901,PSYC 136,A00,189041,Lowe; Angela Beth,0,7,25,25
1683639051930,PSYC 137,A00,189057,Winkielman; Piotr,0,37,25,25
1683639052959,PSYC 144,A00,189107,Wixted; John T,0,10,50,50
1683639055010,PSYC 162,A00,189142,Staff,0,9,85,85
1683639056040,PSYC 172,A00,189144,Gorman; Michael R.,0,6,30,30
1683639058149,PSYC 179,A00,189146,Lacefield; Katharine I,0,86,120,120
1683639059173,PSYC 181,A00,189147,Anagnostaras; Stephan,0,44,90,90
1683639060199,PSYC 190R,A00,189148,Barner; David A.,0,23,80,80
1683639061226,PSYC 191,A00,189275,Rickard; Timothy C.,0,10,25,25
1683639062257,PSYC 193,A00,189276,Chapman; Eddie Nathaniel,0,1,0,4
1683639063288,PSYC 193L,A01,189281,Lowe; Angela Beth,10,0,20,10
1683639063288,PSYC 193L,B01,189285,Staff,28,0,35,7
1683639064319,RELI 149,A00,187137,Rahimi; Babak,7,0,40,33
1683639065349,SE 9,A01,187315,Staff,0,2,18,18
1683639066375,SE 101B,A00,187409,Staff,24,0,30,6
1683639067400,SE 110B,A00,187444,Staff,10,0,40,30
1683639068429,SE 130B,A00,187449,Staff,31,0,40,9
1683639069457,SE 150A,A00,187516,Staff,9,0,20,11
1683639070484,SE 154,A00,187528,Staff,29,0,50,21
1683639071514,SIO 3,A01,258171,Staff,35,0,40,5
1683639072543,SIO 10,A00,187144,Cook; Geoffrey W,0,6,75,75
1683639073569,SIO 45,A00,187152,Cook; Geoffrey W,0,4,100,100
1683639074599,SIO 109R,A00,194486,Staff,0,4,20,20
1683639076656,SIO 187,A01,187233,Kacev; David,12,0,40,28
1683639077689,SOCI 1,A01,258656,Thorpe; Charles Robert,28,0,30,2
1683639077689,SOCI 1,A02,258658,Thorpe; Charles Robert,30,0,30,0
1683639077689,SOCI 1,A03,258661,Thorpe; Charles Robert,25,0,25,0
1683639077689,SOCI 1,A04,258666,Thorpe; Charles Robert,22,0,25,3
1683639077689,SOCI 1,A05,258897,Thorpe; Charles Robert,22,0,25,3
1683639077689,SOCI 1,A06,258898,Thorpe; Charles Robert,25,0,25,0
1683639078719,SOCI 30,A01,258903,Pardo Guerra; Juan Pablo,14,0,30,16
1683639079745,SOCI 102,A00,258904,Staff,9,0,25,16
1683639080770,SOCI 106,A00,258905,Staff,19,0,25,6
1683639081795,SOCI 111,A00,258907,Ribas Norris; Janet Vanesa,26,0,30,4
1683639082820,SOCI 121R,A00,258908,Pardo Guerra; Juan Pablo,8,0,30,22
1683639083846,SOCI 126,A01,203330,Staff,14,0,20,6
1683639084870,SOCI 131,A00,258909,Thorpe; Charles Robert,30,0,60,30
1683639085895,SOCI 135,A00,258910,Payne; Christine Anna,0,11,30,30
1683639086918,SOCI 157,A00,258911,Staff,12,0,30,18
1683639087943,SOCI 184,A00,258912,Staff,25,0,30,5
1683639088969,SOCI 188D,A00,258913,Staff,22,0,30,8
1683639089996,SYN 2,001,187529,Staff,9,0,16,7
1683639089996,SYN 2,002,201452,Staff,0,20,16,16
1683639089996,SYN 2,003,201469,Staff,2,0,16,14
1683639091021,SYN 100,A01,187531,Staff,0,9,20,20
1683639091021,SYN 100,B01,201491,Staff,0,10,20,20
1683639092057,TDAC 1,A00,189286,Walsh; Kim C.,3,0,20,17
1683639092057,TDAC 1,B00,189287,Harting; Carla Kelso,10,0,20,10
1683639093081,TDAC 101,A00,189300,Walsh; Kim C.,16,0,20,4
1683639093081,TDAC 101,B00,189301,Harting; Carla Kelso,18,0,20,2
1683639094111,TDAC 102,A00,189304,Basso; Beatrice,14,0,20,6
1683639095137,TDAC 108,A00,189305,Staff,18,0,20,2
1683639096164,TDDE 131,A00,189310,Staff,19,0,20,1
1683639096164,TDDE 131,B00,189314,Staff,19,0,20,1
1683639096164,TDDE 131,C00,189315,Staff,48,0,50,2
1683639096164,TDDE 131,D00,189316,Staff,14,0,15,1
1683639096164,TDDE 131,E00,204841,Staff,20,0,20,0
1683639097190,TDGE 10,A00,189289,Staff,27,0,50,23
1683639097190,TDGE 10,B00,189290,Havis; Allan,0,0,50,50
1683639098215,TDGE 11,A00,189291,Fulton; Julia,0,4,50,50
1683639098215,TDGE 11,B00,189292,Staff,20,0,25,5
1683639098215,TDGE 11,C00,260270,Staff,0,0,0,0
1683639099240,TDGE 25,A00,189294,Staff,2,0,20,18
1683639100265,TDGE 124,A00,189318,Fulton; Julia,0,8,50,50
1683639101290,TDGE 125,A00,189319,Staff,13,0,25,12
1683639101290,TDGE 125,B00,189320,Staff,23,0,25,2
1683639102316,TDGE 127,A00,189322,Havis; Allan,0,0,50,50
1683639103341,TDHT 101,A00,189323,Staff,18,0,25,7
1683639103341,TDHT 101,B00,189324,Staff,25,0,25,0
1683639104367,TDHT 102,A00,189325,Staff,49,0,50,1
1683639105394,TDMV 1,A00,189295,Arcidiacono; Kristin,20,0,30,10
1683639105394,TDMV 1,B00,189296,Caligagan; Maria T.,24,0,30,6
1683639106418,TDMV 2,A00,189297,Sammartano; Tonnie,27,0,30,3
1683639106418,TDMV 2,B00,189299,Arcidiacono; Kristin,23,0,30,7
1683639107442,TDMV 3,A00,204998,Rincon; Alicia,22,0,30,8
1683639108470,TDMV 120,A00,189458,Sammartano; Tonnie,28,0,30,2
1683639109495,TDMV 138,A00,189541,Jun; Grace Shin Hae,20,0,40,20
1683639110525,TDMV 142,A00,189717,Caligagan; Tony,25,0,30,5
1683639110525,TDMV 142,B00,189718,Caligagan; Maria T.,25,0,30,5
1683639111550,TMC 2,A01,187533,Staff,25,0,25,0
1683639111550,TMC 2,A02,187534,Staff,25,0,25,0
1683639112579,USP 1,A01,187536,Kwak; Nancy,0,16,25,25
1683639113604,USP 5,A01,187538,Staff,9,0,25,16
1683639114628,USP 101,A00,199253,Staff,0,4,0,0
1683639115653,USP 124,A00,187562,Boomhower; Matthew Charles,0,0,30,30
1683639116677,USP 138,A00,187582,Staff,20,0,25,5
1683639117701,USP 152,A01,187597,Staff,3,0,25,22
1683639118729,USP 153,A00,187598,Staff,19,0,25,6
1683639119760,USP 168,A00,187607,Kwak; Nancy,2,0,5,3
1683639120788,USP 173,A00,187619,Staff,4,0,25,21
1683639121817,USP 181,A00,187638,Staff,0,4,25,25
1683639122842,VIS 103,A00,187650,Cruz; Edwin Teddy,18,0,75,57
1683639123867,VIS 110D,A00,187669,Staff,13,0,22,9
1683639124894,VIS 127C,A00,187720,Shen; Kuiyi,67,0,146,79
1683639125920,VIS 149,A00,187731,Yoldas; Pinar,0,14,22,22
1683639126948,VIS 151,A01,188091,Staff,22,0,34,12
1683639126948,VIS 151,A02,188092,Staff,11,0,34,23
1683639127977,VIS 160B,A00,188093,Stalbaum; Brett,0,1,10,10
1683639130029,WCWP 10B,A00,201720,Staff,10,0,15,5
1683639130029,WCWP 10B,B00,201722,Staff,9,0,15,6
1683639131058,WCWP 100,A00,201725,Gagnon; Jeffrey C,0,0,2,2
1683639131058,WCWP 100,B00,201727,Staff,0,4,15,15
1683639134164,ANBI 133,A00,258401,Wilder; Linnea Lorene,34,0,40,6
1683639135189,ANBI 140,A00,258395,Hrvoj Mihic; Branka,18,0,25,7
1683639136212,ANSC 120,A00,258402,Bialecki; Jon Anthony,27,0,40,13
1683639137239,ANSC 144,A00,258400,Staff,12,0,40,28
1683639139292,ANSC 166,A00,258396,Parish; Steven Martin,156,0,175,19
1683639140316,ANSC 180,A00,193533,Staff,8,0,20,12
1683639141341,ANSC 188,A00,258397,Jassal; Aftab,34,0,40,6
1683639142366,ANTH 3,A01,258316,Staff,23,0,30,7
1683639143396,ANTH 5,A00,258394,Semendeferi; Ekaterini,16,0,20,4
1683639144427,ANTH 21,A01,258331,Staff,4,0,40,36
1683639145457,ANTH 103,A00,258398,Varma; Saiba,15,0,25,10
1683639146485,AWP 10,001,202034,Staff,0,0,0,0
1683639146485,AWP 10,002,202035,Staff,0,0,0,0
1683639146485,AWP 10,003,202036,Staff,0,0,0,0
1683639146485,AWP 10,004,202037,Staff,0,0,0,0
1683639146485,AWP 10,005,202038,Staff,0,0,0,0
1683639146485,AWP 10,006,202039,Staff,0,0,0,0
1683639146485,AWP 10,007,202040,Staff,0,0,0,0
1683639146485,AWP 10,008,202041,Staff,0,0,0,0
1683639146485,AWP 10,009,202042,Staff,0,0,0,0
1683639146485,AWP 10,010,202043,Staff,0,0,0,0
1683639146485,AWP 10,011,202044,Staff,0,0,0,0
1683639146485,AWP 10,012,202045,Staff,0,0,0,0
1683639146485,AWP 10,013,202046,Staff,0,0,0,0
1683639146485,AWP 10,014,202047,Staff,0,0,0,0
1683639146485,AWP 10,015,202048,Staff,0,0,0,0
1683639146485,AWP 10,016,202049,Staff,0,0,0,0
1683639146485,AWP 10,017,202050,Staff,0,0,0,0
1683639146485,AWP 10,018,202051,Staff,0,0,0,0
1683639146485,AWP 10,019,202052,Staff,0,0,0,0
1683639146485,AWP 10,020,202053,Staff,0,0,0,0
1683639146485,AWP 10,021,202054,Staff,0,0,0,0
1683639146485,AWP 10,022,202055,Staff,0,0,0,0
1683639146485,AWP 10,023,202056,Staff,0,0,0,0
1683639146485,AWP 10,024,202057,Staff,0,0,0,0
1683639146485,AWP 10,025,202058,Staff,0,0,0,0
1683639146485,AWP 10,026,202059,Staff,0,0,0,0
1683639147511,AWP 102,001,202032,Staff,0,0,0,0
1683639147511,AWP 102,002,202033,Staff,0,0,0,0
1683639148540,BENG 100,A01,254234,Taylor Amos; Alyssa C,31,0,40,9
1683639149566,BENG 196,001,270013,Engler; Adam J.,9999,0,9999,0
1683639150593,BICD 100R,A01,202018,Smith; Laurie,0,7,32,32
1683639150593,BICD 100R,A02,202019,Smith; Laurie,0,3,32,32
1683639150593,BICD 100R,A03,202020,Smith; Laurie,0,1,32,32
1683639150593,BICD 100R,A04,202021,Smith; Laurie,6,0,32,26
1683639150593,BICD 100R,A05,202022,Smith; Laurie,11,0,32,21
1683639151625,BICD 136,A01,193242,Gustafson-Brown; Cindy,0,2,32,32
1683639151625,BICD 136,A02,193244,Gustafson-Brown; Cindy,13,0,32,19
1683639152651,BIEB 102,A01,193249,Butler; Shannon Rhey,0,2,32,32
1683639152651,BIEB 102,A02,193251,Butler; Shannon Rhey,0,0,32,32
1683639152651,BIEB 102,A03,193253,Butler; Shannon Rhey,0,0,32,32
1683639152651,BIEB 102,A04,193255,Butler; Shannon Rhey,14,0,32,18
1683639152651,BIEB 102,A05,193265,Butler; Shannon Rhey,26,0,32,6
1683639152651,BIEB 102,A06,193269,Butler; Shannon Rhey,14,0,32,18
1683639154702,BIEB 150,A01,193274,Staff,0,0,32,32
1683639154702,BIEB 150,A02,193285,Staff,24,0,32,8
1683639155729,BIEB 194,A00,193286,Kurle; Carolyn M.,20,0,32,12
1683639156758,BILD 1,A01,192291,Staff,15,0,32,17
1683639156758,BILD 1,A02,192292,Staff,30,0,32,2
1683639156758,BILD 1,B01,192520,Reuther; Keefe,0,1,0,0
1683639156758,BILD 1,B02,192532,Reuther; Keefe,0,1,0,0
1683639157782,BILD 3,A01,192556,Butler; Shannon Rhey,0,0,32,32
1683639157782,BILD 3,A02,192581,Butler; Shannon Rhey,1,0,32,31
1683639157782,BILD 3,A03,192611,Butler; Shannon Rhey,21,0,32,11
1683639157782,BILD 3,A04,192612,Butler; Shannon Rhey,24,0,32,8
1683639157782,BILD 3,A05,192613,Butler; Shannon Rhey,26,0,32,6
1683639157782,BILD 3,A06,192679,Butler; Shannon Rhey,27,0,32,5
1683639157782,BILD 3,A07,192682,Butler; Shannon Rhey,20,0,32,12
1683639158814,BILD 4,A01,192836,Reuther; Keefe,0,0,24,24
1683639158814,BILD 4,A02,193044,Reuther; Keefe,4,0,24,20
1683639159840,BILD 10,A01,193142,Gustafson-Brown; Cindy,29,0,32,3
1683639159840,BILD 10,A02,193149,Gustafson-Brown; Cindy,31,0,32,1
1683639160938,BIMM 100,A01,193301,Staff,0,6,32,32
1683639160938,BIMM 100,A02,193312,Staff,0,7,32,32
1683639160938,BIMM 100,A03,193323,Staff,0,9,32,32
1683639161969,BIMM 101,A01,193329,McDonnell; Lisa Marie,0,4,24,24
1683639161969,BIMM 101,A02,193339,McDonnell; Lisa Marie,0,3,24,24
1683639161969,BIMM 101,B01,193354,McDonnell; Lisa Marie,0,4,24,24
1683639161969,BIMM 101,B02,193357,McDonnell; Lisa Marie,0,2,24,24
1683639162996,BIMM 110,A01,193377,Tat; John,0,11,32,32
1683639162996,BIMM 110,A02,193378,Tat; John,0,10,32,32
1683639164030,BIMM 120,A01,206116,Staff,0,0,32,32
1683639164030,BIMM 120,A02,206117,Staff,6,0,32,26
1683639164030,BIMM 120,A03,206121,Staff,21,0,32,11
1683639165063,BIPN 100,A01,193393,Park; Ji Young,0,14,32,32
1683639165063,BIPN 100,A02,193402,Park; Ji Young,0,14,32,32
1683639165063,BIPN 100,A03,193413,Park; Ji Young,0,14,32,32
1683639165063,BIPN 100,A04,193414,Park; Ji Young,0,13,32,32
1683639166092,BIPN 102,A01,193429,Staff,0,0,32,32
1683639166092,BIPN 102,A02,193438,Staff,18,0,32,14
1683639167118,BIPN 106,A01,193450,Reyes Gonzalez; Catalina,0,2,40,40
1683639168148,BIPN 134,A01,193465,Cooke; James Edward,0,0,32,32
1683639168148,BIPN 134,A02,193474,Cooke; James Edward,25,0,32,7
1683639168148,BIPN 134,A03,193485,Cooke; James Edward,29,0,32,3
1683639168148,BIPN 134,A04,193486,Cooke; James Edward,20,0,32,12
1683639168148,BIPN 134,A05,193491,Cooke; James Edward,31,0,32,1
1683639168148,BIPN 134,A06,193501,Cooke; James Edward,30,0,32,2
1683639168148,BIPN 134,A07,193510,Cooke; James Edward,29,0,32,3
1683639170202,BISP 194,A00,222522,Staff,14,0,32,18
1683639171228,CAT 124,A01,202407,Staff,19,0,25,6
1683639172256,CAT 125,A00,202408,Marchisotto; Jennifer Anne,2,0,20,18
1683639173283,CAT 125R,A00,202409,Smith; Lauryn Alissa,0,11,20,20
1683639173283,CAT 125R,B00,202410,Morales; Celeste Georgianna,0,11,20,20
1683639173283,CAT 125R,C00,202411,Irwin; Matthew Joseph,0,12,20,20
1683639174309,CENG 15,A01,204712,Yang; Kesong,0,1,0,0
1683639175336,CENG 114,A00,202070,Jahed Motlagh; Zeinab,5,0,20,15
1683639176362,CGS 105,A00,185477,Wesling; Megan E.,24,0,40,16
1683639177386,CGS 106,A00,185494,Staff,11,0,22,11
1683639178411,CGS 108,A00,185495,Staff,14,0,20,6
1683639179438,CGS 114,A00,185496,Staff,13,0,18,5
1683639180463,CGS 119,A00,185501,Staff,15,0,20,5
1683639181488,CGS 120,A00,185511,Staff,12,0,20,8
1683639182515,CHEM 4,A01,184675,Bussey; Thomas J,97,0,100,3
1683639183540,CHEM 6A,A01,184677,Staff,33,0,60,27
1683639184565,CHEM 6B,A01,184679,Staff,63,0,100,37
1683639185591,CHEM 6C,A01,184681,Bussey; Thomas J,0,0,50,50
1683639185591,CHEM 6C,A02,184682,Bussey; Thomas J,32,0,50,18
1683639186620,CHEM 40A,A01,184684,Albizati; Kim F.,35,0,100,65
1683639187650,CHEM 40B,A01,184686,Albizati; Kim F.,0,22,100,100
1683639188679,CHEM 41B,A01,184690,Staff,51,0,100,49
1683639189709,COGS 3,A01,184715,Boyle; Mary E. T.,0,27,40,40
1683639190735,COGS 14B,A01,185172,Staff,0,14,38,38
1683639191760,COGS 18,A01,184736,Staff,15,0,80,65
1683639192789,COGS 100,A01,184932,Staff,0,7,73,73
1683639193819,COGS 101A,A01,184935,Staff,0,39,30,30
1683639194845,COGS 101B,A01,184944,Staff,0,2,30,30
1683639195871,COGS 101C,A01,184946,Staff,0,10,30,30
1683639196899,COGS 102A,A01,184951,Johnson; Christine M.,2,0,40,38
1683639197925,COGS 107B,A01,184953,Mooshagian; Eric Frederick,0,51,40,40
1683639198952,COGS 118B,A01,184959,Gupta; Anjum,0,49,40,40
1683639199980,COGS 153,A00,184961,Staff,0,16,30,30
1683639201009,COGS 177,A00,184962,Staff,0,21,30,30
1683639202038,COGS 187A,A01,184969,Boyle; Mary E. T.,0,19,40,40
1683639203073,COMM 10,A01,185174,Staff,0,5,25,25
1683639203073,COMM 10,A02,185189,Staff,0,2,25,25
1683639203073,COMM 10,A03,269821,Staff,0,1,0,0
1683639204098,COMM 100B,A01,185475,Staff,0,1,0,2
1683639204098,COMM 100B,A02,185476,Staff,12,0,25,13
1683639205124,COMM 100C,A01,185314,Staff,1,0,25,24
1683639205124,COMM 100C,A02,185327,Staff,18,0,25,7
1683639206149,COMM 110M,A00,185349,Staff,0,0,40,40
1683639207174,COMM 113T,A00,185352,Staff,25,0,40,15
1683639208198,COMM 114I,A00,185353,Staff,31,0,40,9
1683639209224,COMM 131,A00,185354,Staff,17,0,30,13
1683639210249,CSE 8A,A50,185358,Cao; Yingjun,0,46,10,10
1683639211278,CSE 8B,A01,185362,Staff,0,48,50,50
1683639212309,CSE 11,A01,185416,Cao; Yingjun,0,91,10,10
1683639213333,CSE 20,A01,185445,Briones; Jor-el Thomas Caparas,4,0,25,21
1683639214357,CSE 21,A01,185447,Staff,9,0,50,41
1683639215388,CSE 101,A01,185451,Staff,0,13,50,50
1683639215388,CSE 101,B01,185453,Jones; Miles E,0,13,50,50
1683639217439,CSE 141,A01,185458,Eldon; John,15,0,100,85
1683639218468,CSE 141L,A01,185461,Eldon; John,7,0,100,93
1683639219498,CSE 142,A01,185463,Staff,36,0,60,24
1683639219498,CSE 142,B01,201355,Staff,0,7,60,60
1683639220526,CSE 142L,A01,185470,Staff,36,0,60,24
1683639220526,CSE 142L,B01,201417,Staff,0,6,60,60
1683639221554,CSE 190,A00,201433,Staff,32,0,49,17
1683639222584,DOC 1,A01,259136,Strom; Megan C.,7,0,15,8
1683639222584,DOC 1,A02,259137,Strom; Megan C.,14,0,15,1
1683639222584,DOC 1,A03,259138,Strom; Megan C.,14,0,15,1
1683639222584,DOC 1,A04,259139,Strom; Megan C.,14,0,15,1
1683639223608,DOC 100D,A00,259140,Pass; Natalye Joann,14,0,25,11
1683639224634,DSGN 1,A01,184749,Rill; Bryan,0,26,30,30
1683639225659,DSGN 100,A01,185168,Staff,0,2,25,25
1683639226685,ECE 5,A01,185626,Morris; Karcher William,0,11,0,0
1683639227709,ECE 101,A01,185628,Staff,14,0,70,56
1683639228734,ECE 107,A01,185635,Baghdadchi; Saharnaz,0,0,20,20
1683639228734,ECE 107,A02,185638,Baghdadchi; Saharnaz,3,0,20,17
1683639229760,ECE 148,A01,185647,Silberman; Jack,0,0,16,16
1683639230787,ECON 1,A01,185537,Crane; Meredith Helen,54,0,70,16
1683639231816,ECON 3,A01,185549,Crane; Meredith Helen,29,0,70,41
1683639232845,ECON 4,A01,203354,Anderson; John Charles,0,5,10,10
1683639233875,ECON 100A,A01,185574,Staff,0,5,40,40
1683639234904,ECON 100B,A01,185576,Staff,0,12,50,50
1683639235933,ECON 100C,A01,185589,Newhouse; Herbert S,30,0,70,40
1683639236958,ECON 105,A00,185608,Vespa; Emanuel Ignacio,19,0,35,16
1683639237984,ECON 109,A01,185610,Shishkin; Denis,9,0,35,26
1683639239010,ECON 110A,A01,185612,Staff,9,0,40,31
1683639240038,ECON 120A,A01,185615,Staff,20,0,40,20
1683639241074,ECON 120C,A01,185617,Sun; Yixiao,0,20,70,70
1683639242100,ECON 144,A00,203346,Squires; Dale E,2,0,35,33
1683639243139,ECON 171,A01,203349,Newhouse; Herbert S,0,1,35,35
1683639244165,ECON 173A,A01,185621,Toda; Alexis Akira,21,0,35,14
1683639245194,EDS 25,A01,202413,Staff,0,1,0,0
1683639245194,EDS 25,A02,202414,Staff,0,1,0,0
1683639245194,EDS 25,A03,202415,Staff,0,0,0,0
1683639245194,EDS 25,A04,202416,Staff,0,1,0,0
1683639245194,EDS 25,A05,202439,Staff,0,0,0,0
1683639245194,EDS 25,A06,202440,Staff,0,0,0,0
1683639245194,EDS 25,B01,202631,Staff,0,0,0,0
1683639245194,EDS 25,B02,202632,Staff,0,0,0,0
1683639245194,EDS 25,B03,202639,Staff,0,0,0,0
1683639245194,EDS 25,B04,202640,Staff,0,0,0,0
1683639245194,EDS 25,B05,202643,Staff,0,0,0,0
1683639245194,EDS 25,B06,202644,Staff,0,0,0,0
1683639246223,EDS 38,A01,202659,Black; Alison Michelle,24,0,25,1
1683639247250,EDS 115,A00,202652,Staff,18,0,30,12
1683639248279,EDS 125,A00,202649,Staff,13,0,30,17
1683639249305,EDS 126,A01,203332,Staff,30,0,30,0
1683639250333,EDS 139,A00,202838,Staff,16,0,25,9
1683639251357,EDS 146,A01,202655,Staff,14,0,25,11
1683639252383,ENG 15,A00,185667,Staff,0,1,0,0
1683639252383,ENG 15,B00,185672,Staff,0,0,0,0
1683639252383,ENG 15,C00,185675,Staff,0,0,0,0
1683639252383,ENG 15,D00,185682,Staff,0,0,0,0
1683639252383,ENG 15,E00,185684,Staff,0,0,0,0
1683639253408,ETHN 103,A00,185710,Staff,0,8,35,35
1683639254432,ETHN 103A,A00,199228,Man; Simeon S,0,0,9,9
1683639255456,ETHN 109,A00,185711,Staff,16,0,35,19
1683639256485,ETHN 142,A00,185726,Staff,0,4,30,30
1683639257510,ETHN 163J,A00,199229,Man; Simeon S,5,0,8,3
1683639258541,ETHN 168,A00,185727,Staff,7,0,10,3
1683639259568,ETHN 182,A00,185728,Staff,0,0,35,35
1683639260596,ETHN 183,A00,185737,Staff,9,0,18,9
1683639261626,GLBH 111,A01,209361,Burgos; Jose L.,0,0,0,0
1683639263675,HIEU 104,A00,185792,Staff,14,0,20,6
1683639264765,HIEU 115,A00,185800,Staff,0,0,20,20
1683639265791,HIEU 128,A00,185801,Staff,0,9,20,20
1683639266816,HIEU 147,A00,185802,Staff,15,0,20,5
1683639267842,HIEU 154,A00,185823,Staff,11,0,20,9
1683639268870,HILA 102,A00,185826,Staff,14,0,20,6
1683639269899,HILD 2C,A01,185778,Staff,0,13,20,20
1683639270925,HILD 7B,A01,185780,Kwak; Nancy,0,16,32,32
1683639270925,HILD 7B,A02,185781,Kwak; Nancy,0,18,32,32
1683639271951,HILD 30,A01,185791,Staff,12,0,20,8
1683639272981,HISC 119,A00,185830,Golan; Tal,0,9,20,20
1683639274007,HITO 156GS,A00,185831,Patterson; Patrick H.,0,0,0,23
1683639275032,HIUS 103,A00,185832,Man; Simeon S,0,4,20,20
1683639276058,HIUS 117,A00,185836,Kwak; Nancy,2,0,20,18
1683639277084,HIUS 125,A00,185840,Man; Simeon S,0,1,23,23
1683639278114,HIUS 149,A00,185845,Staff,1,0,20,19
1683639279146,HUM 3,A01,185882,Zavodny; Tatiana Sophia,0,7,50,50
1683639279146,HUM 3,B01,185899,Caldwell; Michael Alan,0,18,50,50
1683639280171,HUM 3GS,A00,185900,Patterson; Patrick H.,0,0,0,23
1683639281205,HUM 4,A01,185938,Zroka; Amy Liane,30,0,50,20
1683639281205,HUM 4,B01,185956,Watkins; Eric,0,4,50,50
1683639281205,HUM 4,B02,202209,Watkins; Eric,0,4,50,50
1683639281205,HUM 4,B03,202210,Watkins; Eric,0,4,50,50
1683639282233,HUM 5,A01,185958,West; Geoffrey Scott,2,0,50,48
1683639282233,HUM 5,A02,202215,West; Geoffrey Scott,0,0,50,50
1683639283261,INTL 190,A00,185959,Gagnon; Jeffrey C,0,0,0,9
1683639283261,INTL 190,B00,185960,Lettieri; Michael Joseph,0,0,0,2
1683639284285,JAPN 180,A00,254509,Staff,5,0,30,25
1683639285311,LATI 10,A01,202853,Kennemore; Amy Michelle,4,0,35,31
1683639285311,LATI 10,A02,202854,Kennemore; Amy Michelle,2,0,35,33
1683639285311,LATI 10,A03,270054,Kennemore; Amy Michelle,30,0,30,0
1683639286337,LATI 180,A00,202855,Kennemore; Amy Michelle,11,0,20,9
1683639287365,LAWS 101,A00,201767,Golan; Tal,0,7,40,40
1683639288391,LIFR 1C,A00,185961,Staff,6,0,20,14
1683639289418,LIFR 1CX,A00,185962,Staff,7,0,20,13
1683639290447,LIFR 1D,A00,185963,Staff,7,0,20,13
1683639291471,LIFR 1DX,A00,185964,Staff,7,0,20,13
1683639292495,LIGN 101,A01,186039,Staff,43,0,50,7
1683639293520,LIGN 165,A00,186040,Staff,15,0,50,35
1683639294544,LTCS 108,A00,186041,Staff,5,0,10,5
1683639295571,LTCS 119,A00,186042,Staff,15,0,20,5
1683639296600,LTCS 130,A00,186043,Wesling; Megan E.,15,0,25,10
1683639298653,LTEA 138,A00,186119,Staff,14,0,40,26
1683639299679,LTEN 124,A00,186148,Staff,5,0,25,20
1683639300703,LTEN 178,A00,186149,Staff,7,0,15,8
1683639301731,LTEN 181,A00,186150,Blanco; John D,34,0,40,6
1683639302756,LTWL 120,A00,186160,Staff,20,0,25,5
1683639303781,LTWL 165,A00,186161,Staff,22,0,25,3
1683639304806,LTWR 100,A00,186162,Staff,0,5,15,15
1683639305833,LTWR 102,A00,186163,Doller; Ben,5,0,15,10
1683639306861,MAE 8,A01,186412,Staff,0,0,0,0
1683639307890,MAE 30B,A00,186445,Bahadori; Mohammad Yousef,82,0,100,18
1683639308919,MAE 40,A00,186592,Bewley; Thomas R,10,0,50,40
1683639309943,MAE 101B,A00,186593,Bahadori; Mohammad Yousef,80,0,100,20
1683639310972,MAE 105,A00,186594,Bandaru; Prabhakar,10,0,50,40
1683639312000,MAE 107,A00,186599,Pham; Hieu Tan,0,7,120,120
1683639313027,MAE 148,A01,186660,Silberman; Jack,3,0,16,13
1683639314054,MATH 10A,A01,188095,Staff,0,5,35,35
1683639315080,MATH 10B,A01,188097,Bowers; Adam R.,0,11,30,30
1683639315080,MATH 10B,A02,188099,Bowers; Adam R.,0,11,30,30
1683639315080,MATH 10B,B01,188104,Bowers; Adam R.,0,10,30,30
1683639315080,MATH 10B,B02,188106,Bowers; Adam R.,1,9,30,29
1683639316106,MATH 10C,A01,188111,Staff,0,18,30,30
1683639316106,MATH 10C,A02,188127,Staff,0,19,30,30
1683639316106,MATH 10C,A03,188131,Staff,0,19,30,30
1683639316106,MATH 10C,B01,188218,Staff,17,0,30,13
1683639316106,MATH 10C,B02,188244,Staff,13,0,30,17
1683639316106,MATH 10C,B03,188277,Staff,14,0,30,16
1683639317138,MATH 18,A01,188344,Bach; Quang Tran,18,0,30,12
1683639317138,MATH 18,A02,188345,Bach; Quang Tran,11,0,30,19
1683639317138,MATH 18,B01,188353,Bach; Quang Tran,11,0,30,19
1683639317138,MATH 18,B02,188354,Bach; Quang Tran,19,0,30,11
1683639318161,MATH 20A,A01,188374,Staff,11,0,35,24
1683639319187,MATH 20B,A01,188382,Ohm; Ko Woon,7,0,30,23
1683639319187,MATH 20B,A02,188383,Ohm; Ko Woon,22,0,30,8
1683639319187,MATH 20B,B01,188385,Ohm; Ko Woon,7,0,30,23
1683639319187,MATH 20B,B02,188392,Ohm; Ko Woon,22,0,30,8
1683639320212,MATH 20C,A01,188394,Harel; Guershon,11,0,30,19
1683639320212,MATH 20C,A02,188395,Harel; Guershon,14,0,30,16
1683639320212,MATH 20C,B01,188404,Harel; Guershon,4,0,30,26
1683639320212,MATH 20C,B02,188405,Harel; Guershon,18,0,30,12
1683639321238,MATH 20D,A01,188414,Hammock; Frances H,0,1,30,30
1683639321238,MATH 20D,A02,188415,Hammock; Frances H,0,1,30,30
1683639321238,MATH 20D,B01,188447,Hammock; Frances H,0,1,30,30
1683639321238,MATH 20D,B02,188486,Hammock; Frances H,4,0,30,26
1683639322268,MATH 20E,A01,188649,Staff,21,0,30,9
1683639322268,MATH 20E,A02,188650,Staff,21,0,30,9
1683639322268,MATH 20E,A03,188673,Staff,0,0,30,30
1683639323296,MATH 102,A01,188675,Staff,0,36,35,35
1683639324320,MATH 103B,A01,188681,Staff,3,0,35,32
1683639324320,MATH 103B,B01,188692,Staff,5,0,35,30
1683639325345,MATH 109,A01,188695,Salehi Golsefidy; Alireza,24,0,35,11
1683639325345,MATH 109,A02,188696,Salehi Golsefidy; Alireza,25,0,35,10
1683639326369,MATH 120A,A01,188698,Eggers; John Dietrich,7,0,35,28
1683639327396,MATH 142B,A01,188736,Ioana; Adrian,0,1,30,30
1683639327396,MATH 142B,A02,188741,Ioana; Adrian,0,1,30,30
1683639327396,MATH 142B,A03,188743,Ioana; Adrian,0,1,30,30
1683639328421,MATH 168A,A01,188790,Staff,0,10,35,35
1683639329447,MATH 170A,A01,188803,Nie; Jiawang,0,2,35,35
1683639329447,MATH 170A,A02,188811,Nie; Jiawang,0,0,35,35
1683639329447,MATH 170A,A03,188814,Nie; Jiawang,0,0,35,35
1683639329447,MATH 170A,A04,188815,Nie; Jiawang,10,0,35,25
1683639330476,MATH 193B,A01,188817,Staff,0,0,35,35
1683639330476,MATH 193B,A02,188818,Staff,5,0,35,30
1683639331503,MGT 4,A01,202857,Anderson; John Charles,61,0,80,19
1683639332533,MGT 12,A00,202858,Lindenberger; Wade Douglas,40,0,90,50
1683639333561,MGT 18,A00,202859,Staff,74,0,90,16
1683639334590,MGT 18GS,A00,202860,McKay; Michael J,13,0,28,15
1683639335615,MGT 45,A00,202861,Pecore; Joseph P.,12,0,90,78
1683639336641,MGT 100,A00,202863,Yavorsky; Daniel Ryan,28,0,90,62
1683639337667,MGT 103,A00,202864,Ehrich; Kristine R,0,17,90,90
1683639338694,MGT 112,A00,202865,Ehrich; Kristine R,15,0,90,75
1683639339725,MGT 121A,A00,202868,Staff,0,20,0,0
1683639340754,MGT 131B,A00,202869,Anderson; John Charles,59,0,90,31
1683639341778,MGT 136,A00,202871,Lindenberger; Wade Douglas,83,0,90,7
1683639342808,MGT 164,A00,202873,Staff,0,66,90,91
1683639343837,MGT 164GS,A00,202874,McKay; Mary A,13,0,28,15
1683639344862,MGT 180,A00,202875,Staff,0,50,90,91
1683639345889,MMW 11R,A01,205019,Herbst; Matthew,2,0,30,28
1683639345889,MMW 11R,A02,205026,Herbst; Matthew,29,0,30,1
1683639346916,MMW 15,A01,193512,Chang; Edmond Yi-Teh,0,8,28,28
1683639346916,MMW 15,A02,193513,Chang; Edmond Yi-Teh,0,5,28,28
1683639346916,MMW 15,A03,193514,Chang; Edmond Yi-Teh,0,5,28,28
1683639346916,MMW 15,A04,193515,Chang; Edmond Yi-Teh,0,5,28,28
1683639346916,MMW 15,A05,193516,Chang; Edmond Yi-Teh,0,5,28,28
1683639346916,MMW 15,A06,193517,Chang; Edmond Yi-Teh,0,6,28,28
1683639346916,MMW 15,B01,193519,Chang; Edmond Yi-Teh,0,5,28,28
1683639346916,MMW 15,B02,193520,Chang; Edmond Yi-Teh,0,5,28,28
1683639346916,MMW 15,B03,193521,Chang; Edmond Yi-Teh,0,5,28,28
1683639346916,MMW 15,B04,193522,Chang; Edmond Yi-Teh,0,5,28,28
1683639346916,MMW 15,B05,193523,Chang; Edmond Yi-Teh,0,5,28,28
1683639346916,MMW 15,B06,193524,Chang; Edmond Yi-Teh,0,5,28,28
1683639347946,MMW 122,A01,193526,Rahimi; Babak,0,16,28,28
1683639347946,MMW 122,A02,193527,Rahimi; Babak,0,15,28,28
1683639347946,MMW 122,A03,193528,Rahimi; Babak,0,0,0,0
1683639347946,MMW 122,A04,193529,Rahimi; Babak,0,0,0,0
1683639348971,MUS 1A,A01,186663,Staff,1,20,35,34
1683639349998,MUS 4,A01,186715,Staff,0,12,35,35
1683639351027,MUS 5R,A01,186796,Dubnov; Shlomo,0,17,35,35
1683639352053,MUS 6,A01,186798,Staff,0,5,25,25
1683639353081,MUS 7,A01,186830,Staff,11,0,35,24
1683639354107,MUS 8,A01,186930,Staff,0,26,35,35
1683639355139,MUS 15,A01,186932,Staff,0,16,35,35
1683639355139,MUS 15,B01,186934,Staff,0,17,35,35
1683639356167,MUS 80,A00,186935,Staff,0,0,20,20
1683639356167,MUS 80,B00,186936,Staff,24,0,25,1
1683639357198,NANO 11,A00,204702,Lipomi; Darren John,0,0,0,0
1683639358223,NANO 15,A01,204709,Yang; Kesong,0,1,0,0
1683639359249,NANO 114,A00,202069,Jahed Motlagh; Zeinab,3,0,10,7
1683639360275,PHIL 1,A00,186955,Grush; Rick Scott,31,0,40,9
1683639361305,PHIL 10,A01,186973,Grush; Rick Scott,27,0,35,8
1683639361305,PHIL 10,A02,186974,Grush; Rick Scott,33,0,35,2
1683639362335,PHIL 13,A01,186976,Staff,3,0,35,32
1683639362335,PHIL 13,A02,186977,Staff,16,0,35,19
1683639363366,PHIL 14,A01,186979,Staff,31,0,35,4
1683639363366,PHIL 14,A02,186986,Staff,32,0,35,3
1683639364395,PHIL 28,A01,186988,Staff,16,0,30,14
1683639364395,PHIL 28,A02,186989,Staff,1,0,30,29
1683639364395,PHIL 28,A03,186990,Staff,10,0,30,20
1683639364395,PHIL 28,A04,186991,Staff,26,0,30,4
1683639365426,PHIL 120,A00,186997,Staff,23,0,40,17
1683639366451,PHIL 137,A00,187003,Staff,7,0,40,33
1683639367479,PHIL 150,A00,187015,Staff,47,0,70,23
1683639368577,PHIL 167,A00,187021,Lamey; Andy M.,34,0,40,6
1683639369603,PHIL 174,A01,202226,Staff,17,0,20,3
1683639369603,PHIL 174,A02,202235,Staff,20,0,20,0
1683639370632,PHIL 191A,A00,258918,Staff,0,0,1,1
1683639371657,PHYS 1A,A00,187028,Staff,27,0,60,33
1683639372688,PHYS 1AL,001,187036,Staff,3,0,30,27
1683639372688,PHYS 1AL,002,187049,Staff,18,0,30,12
1683639373713,PHYS 1B,A00,187058,Staff,22,0,60,38
1683639374738,PHYS 1BL,001,187064,Staff,0,1,30,30
1683639374738,PHYS 1BL,002,187070,Staff,4,0,30,26
1683639375763,PHYS 1C,A00,187082,Staff,29,0,120,91
1683639376789,PHYS 1CL,001,187088,Staff,0,9,30,30
1683639376789,PHYS 1CL,002,187089,Staff,0,1,30,30
1683639376789,PHYS 1CL,009,262693,Staff,9,0,30,21
1683639377817,PHYS 2B,A01,187097,Staff,55,0,115,60
1683639378846,PHYS 2C,A01,187099,Staff,64,0,115,51
1683639379876,PHYS 2CL,A01,187101,Staff,5,0,28,23
1683639379876,PHYS 2CL,A02,187102,Staff,15,0,28,13
1683639380906,PHYS 2D,A01,187123,Shotwell; Brian,95,0,115,20
1683639381936,PHYS 4B,A01,187133,Grinstein; Benjamin,35,0,50,15
1683639382966,POLI 10,A00,188819,Staff,0,4,50,50
1683639383994,POLI 11,A00,188827,Staff,43,0,50,7
1683639385021,POLI 13R,A00,188828,Staff,0,1,20,20
1683639386050,POLI 27,A01,188830,Elgin; Samuel Zincke,0,2,70,70
1683639387075,POLI 30,A00,188832,Desposato; Scott,30,0,50,20
1683639388099,POLI 102F,A00,188834,Staff,0,0,40,40
1683639389124,POLI 104A,A00,188852,Staff,13,0,30,17
1683639390149,POLI 104I,A00,188853,Staff,0,7,20,20
1683639391175,POLI 110B,A00,188854,Wiens; David,7,0,20,13
1683639392205,POLI 112A,A00,188855,Wiens; David,4,0,30,26
1683639393231,POLI 117R,A00,188856,Forman; Fonna,0,12,20,20
1683639394256,POLI 118,A00,188857,Ingham; Sean,8,0,20,12
1683639395281,POLI 120G,A00,188858,Staff,8,0,30,22
1683639396309,POLI 131CR,A00,188863,Hoston; Germaine,21,0,50,29
1683639397334,POLI 133,A00,188864,Nellis; Gareth Hb,44,0,50,6
1683639398360,POLI 134D,A00,188865,Desposato; Scott,27,0,30,3
1683639399386,POLI 142A,A00,188871,Gartzke; Erik,21,0,50,29
1683639400410,POLI 142K,A00,188874,Staff,38,0,50,12
1683639401438,POLI 143,A00,188940,Gartzke; Erik,16,0,30,14
1683639402466,POLI 153,A00,188943,Staff,2,0,20,18
1683639403495,POLI 160AA,A00,188944,Staff,11,0,40,29
1683639404520,POLI 170A,A00,188945,Staff,11,0,30,19
1683639406570,PSYC 1,A00,188952,Staff,36,0,90,54
1683639407595,PSYC 2,B00,188953,Staff,19,0,35,16
1683639408625,PSYC 6,A00,188970,Staff,47,0,60,13
1683639409653,PSYC 7,A00,188973,Staff,35,0,45,10
1683639410684,PSYC 60,A01,188980,Rickard; Timothy C.,42,0,60,18
1683639411710,PSYC 70,A01,189001,Steiner; Eric Tomas,23,0,45,22
1683639412738,PSYC 100,A00,189005,Lacefield; Katharine I,0,99,120,120
1683639413765,PSYC 102,A00,189008,Staff,8,0,30,22
1683639414793,PSYC 106,B00,189026,Gorman; Michael R.,27,0,60,33
1683639415819,PSYC 114,B01,189033,Winkielman; Piotr,0,31,30,30
1683639416847,PSYC 131,A00,189036,Anagnostaras; Stephan,0,43,60,60
1683639417871,PSYC 136,A00,189041,Lowe; Angela Beth,0,7,25,25
1683639418901,PSYC 137,A00,189057,Winkielman; Piotr,0,37,25,25
1683639419930,PSYC 144,A00,189107,Wixted; John T,0,10,50,50
1683639421987,PSYC 162,A00,189142,Staff,0,9,85,85
1683639423011,PSYC 172,A00,189144,Gorman; Michael R.,0,6,30,30
1683639425061,PSYC 179,A00,189146,Lacefield; Katharine I,0,86,120,120
1683639426091,PSYC 181,A00,189147,Anagnostaras; Stephan,0,44,90,90
1683639427115,PSYC 190R,A00,189148,Barner; David A.,0,23,80,80
1683639428141,PSYC 191,A00,189275,Rickard; Timothy C.,0,10,25,25
1683639429167,PSYC 193,A00,189276,Chapman; Eddie Nathaniel,0,1,0,4
1683639430192,PSYC 193L,A01,189281,Lowe; Angela Beth,10,0,20,10
1683639430192,PSYC 193L,B01,189285,Staff,28,0,35,7
1683639431222,RELI 149,A00,187137,Rahimi; Babak,7,0,40,33
1683639432251,SE 9,A01,187315,Staff,0,2,18,18
1683639433276,SE 101B,A00,187409,Staff,24,0,30,6
1683639434305,SE 110B,A00,187444,Staff,10,0,40,30
1683639435331,SE 130B,A00,187449,Staff,31,0,40,9
1683639436357,SE 150A,A00,187516,Staff,9,0,20,11
1683639437385,SE 154,A00,187528,Staff,29,0,50,21
1683639438414,SIO 3,A01,258171,Staff,35,0,40,5
1683639439441,SIO 10,A00,187144,Cook; Geoffrey W,0,6,75,75
1683639440470,SIO 45,A00,187152,Cook; Geoffrey W,0,4,100,100
1683639441495,SIO 109R,A00,194486,Staff,0,4,20,20
1683639443550,SIO 187,A01,187233,Kacev; David,12,0,40,28
1683639444577,SOCI 1,A01,258656,Thorpe; Charles Robert,28,0,30,2
1683639444577,SOCI 1,A02,258658,Thorpe; Charles Robert,30,0,30,0
1683639444577,SOCI 1,A03,258661,Thorpe; Charles Robert,25,0,25,0
1683639444577,SOCI 1,A04,258666,Thorpe; Charles Robert,22,0,25,3
1683639444577,SOCI 1,A05,258897,Thorpe; Charles Robert,22,0,25,3
1683639444577,SOCI 1,A06,258898,Thorpe; Charles Robert,25,0,25,0
1683639445604,SOCI 30,A01,258903,Pardo Guerra; Juan Pablo,14,0,30,16
1683639446628,SOCI 102,A00,258904,Staff,9,0,25,16
1683639447652,SOCI 106,A00,258905,Staff,19,0,25,6
1683639448677,SOCI 111,A00,258907,Ribas Norris; Janet Vanesa,26,0,30,4
1683639449708,SOCI 121R,A00,258908,Pardo Guerra; Juan Pablo,8,0,30,22
1683639450734,SOCI 126,A01,203330,Staff,14,0,20,6
1683639451759,SOCI 131,A00,258909,Thorpe; Charles Robert,30,0,60,30
1683639452785,SOCI 135,A00,258910,Payne; Christine Anna,0,11,30,30
1683639453814,SOCI 157,A00,258911,Staff,12,0,30,18
1683639454843,SOCI 184,A00,258912,Staff,25,0,30,5
1683639455875,SOCI 188D,A00,258913,Staff,22,0,30,8
1683639456907,SYN 2,001,187529,Staff,9,0,16,7
1683639456907,SYN 2,002,201452,Staff,0,20,16,16
1683639456907,SYN 2,003,201469,Staff,2,0,16,14
1683639457936,SYN 100,A01,187531,Staff,0,9,20,20
1683639457936,SYN 100,B01,201491,Staff,0,10,20,20
1683639458966,TDAC 1,A00,189286,Walsh; Kim C.,3,0,20,17
1683639458966,TDAC 1,B00,189287,Harting; Carla Kelso,10,0,20,10
1683639459992,TDAC 101,A00,189300,Walsh; Kim C.,16,0,20,4
1683639459992,TDAC 101,B00,189301,Harting; Carla Kelso,18,0,20,2
1683639461018,TDAC 102,A00,189304,Basso; Beatrice,14,0,20,6
1683639462048,TDAC 108,A00,189305,Staff,18,0,20,2
1683639463076,TDDE 131,A00,189310,Staff,19,0,20,1
1683639463076,TDDE 131,B00,189314,Staff,19,0,20,1
1683639463076,TDDE 131,C00,189315,Staff,48,0,50,2
1683639463076,TDDE 131,D00,189316,Staff,14,0,15,1
1683639463076,TDDE 131,E00,204841,Staff,20,0,20,0
1683639464102,TDGE 10,A00,189289,Staff,27,0,50,23
1683639464102,TDGE 10,B00,189290,Havis; Allan,0,0,50,50
1683639465130,TDGE 11,A00,189291,Fulton; Julia,0,4,50,50
1683639465130,TDGE 11,B00,189292,Staff,20,0,25,5
1683639465130,TDGE 11,C00,260270,Staff,0,0,0,0
1683639466155,TDGE 25,A00,189294,Staff,2,0,20,18
1683639467180,TDGE 124,A00,189318,Fulton; Julia,0,8,50,50
1683639468205,TDGE 125,A00,189319,Staff,13,0,25,12
1683639468205,TDGE 125,B00,189320,Staff,23,0,25,2
1683639469230,TDGE 127,A00,189322,Havis; Allan,0,0,50,50
1683639470259,TDHT 101,A00,189323,Staff,18,0,25,7
1683639470259,TDHT 101,B00,189324,Staff,25,0,25,0
1683639471286,TDHT 102,A00,189325,Staff,49,0,50,1
1683639472369,TDMV 1,A00,189295,Arcidiacono; Kristin,20,0,30,10
1683639472369,TDMV 1,B00,189296,Caligagan; Maria T.,24,0,30,6
1683639473395,TDMV 2,A00,189297,Sammartano; Tonnie,27,0,30,3
1683639473395,TDMV 2,B00,189299,Arcidiacono; Kristin,23,0,30,7
1683639474420,TDMV 3,A00,204998,Rincon; Alicia,22,0,30,8
1683639475447,TDMV 120,A00,189458,Sammartano; Tonnie,28,0,30,2
1683639476472,TDMV 138,A00,189541,Jun; Grace Shin Hae,20,0,40,20
1683639477497,TDMV 142,A00,189717,Caligagan; Tony,25,0,30,5
1683639477497,TDMV 142,B00,189718,Caligagan; Maria T.,25,0,30,5
1683639478522,TMC 2,A01,187533,Staff,25,0,25,0
1683639478522,TMC 2,A02,187534,Staff,25,0,25,0
1683639479552,USP 1,A01,187536,Kwak; Nancy,0,16,25,25
1683639480581,USP 5,A01,187538,Staff,9,0,25,16
1683639481606,USP 101,A00,199253,Staff,0,4,0,0
1683639482635,USP 124,A00,187562,Boomhower; Matthew Charles,0,0,30,30
1683639483660,USP 138,A00,187582,Staff,20,0,25,5
1683639484687,USP 152,A01,187597,Staff,3,0,25,22
1683639485711,USP 153,A00,187598,Staff,19,0,25,6
1683639486736,USP 168,A00,187607,Kwak; Nancy,2,0,5,3
1683639487760,USP 173,A00,187619,Staff,4,0,25,21
1683639488786,USP 181,A00,187638,Staff,0,4,25,25
1683639489818,VIS 103,A00,187650,Cruz; Edwin Teddy,18,0,75,57
1683639490842,VIS 110D,A00,187669,Staff,13,0,22,9
1683639491869,VIS 127C,A00,187720,Shen; Kuiyi,67,0,146,79
1683639492895,VIS 149,A00,187731,Yoldas; Pinar,0,14,22,22
1683639493920,VIS 151,A01,188091,Staff,22,0,34,12
1683639493920,VIS 151,A02,188092,Staff,11,0,34,23
1683639494949,VIS 160B,A00,188093,Stalbaum; Brett,0,1,10,10
1683639496999,WCWP 10B,A00,201720,Staff,10,0,15,5
1683639496999,WCWP 10B,B00,201722,Staff,9,0,15,6
1683639498028,WCWP 100,A00,201725,Gagnon; Jeffrey C,0,0,2,2
1683639498028,WCWP 100,B00,201727,Staff,0,4,15,15
1683639501158,ANBI 133,A00,258401,Wilder; Linnea Lorene,34,0,40,6
1683639502184,ANBI 140,A00,258395,Hrvoj Mihic; Branka,18,0,25,7
1683639503216,ANSC 120,A00,258402,Bialecki; Jon Anthony,27,0,40,13
1683639504243,ANSC 144,A00,258400,Staff,12,0,40,28
1683639506296,ANSC 166,A00,258396,Parish; Steven Martin,156,0,175,19
1683639507322,ANSC 180,A00,193533,Staff,8,0,20,12
1683639508345,ANSC 188,A00,258397,Jassal; Aftab,34,0,40,6
1683639509374,ANTH 3,A01,258316,Staff,23,0,30,7
1683639510403,ANTH 5,A00,258394,Semendeferi; Ekaterini,16,0,20,4
1683639511427,ANTH 21,A01,258331,Staff,4,0,40,36
1683639512456,ANTH 103,A00,258398,Varma; Saiba,15,0,25,10
1683639513487,AWP 10,001,202034,Staff,0,0,0,0
1683639513487,AWP 10,002,202035,Staff,0,0,0,0
1683639513487,AWP 10,003,202036,Staff,0,0,0,0
1683639513487,AWP 10,004,202037,Staff,0,0,0,0
1683639513487,AWP 10,005,202038,Staff,0,0,0,0
1683639513487,AWP 10,006,202039,Staff,0,0,0,0
1683639513487,AWP 10,007,202040,Staff,0,0,0,0
1683639513487,AWP 10,008,202041,Staff,0,0,0,0
1683639513487,AWP 10,009,202042,Staff,0,0,0,0
1683639513487,AWP 10,010,202043,Staff,0,0,0,0
1683639513487,AWP 10,011,202044,Staff,0,0,0,0
1683639513487,AWP 10,012,202045,Staff,0,0,0,0
1683639513487,AWP 10,013,202046,Staff,0,0,0,0
1683639513487,AWP 10,014,202047,Staff,0,0,0,0
1683639513487,AWP 10,015,202048,Staff,0,0,0,0
1683639513487,AWP 10,016,202049,Staff,0,0,0,0
1683639513487,AWP 10,017,202050,Staff,0,0,0,0
1683639513487,AWP 10,018,202051,Staff,0,0,0,0
1683639513487,AWP 10,019,202052,Staff,0,0,0,0
1683639513487,AWP 10,020,202053,Staff,0,0,0,0
1683639513487,AWP 10,021,202054,Staff,0,0,0,0
1683639513487,AWP 10,022,202055,Staff,0,0,0,0
1683639513487,AWP 10,023,202056,Staff,0,0,0,0
1683639513487,AWP 10,024,202057,Staff,0,0,0,0
1683639513487,AWP 10,025,202058,Staff,0,0,0,0
1683639513487,AWP 10,026,202059,Staff,0,0,0,0
1683639514512,AWP 102,001,202032,Staff,0,0,0,0
1683639514512,AWP 102,002,202033,Staff,0,0,0,0
1683639515542,BENG 100,A01,254234,Taylor Amos; Alyssa C,31,0,40,9
1683639516569,BENG 196,001,270013,Engler; Adam J.,9999,0,9999,0
1683639517602,BICD 100R,A01,202018,Smith; Laurie,0,7,32,32
1683639517602,BICD 100R,A02,202019,Smith; Laurie,0,3,32,32
1683639517602,BICD 100R,A03,202020,Smith; Laurie,0,1,32,32
1683639517602,BICD 100R,A04,202021,Smith; Laurie,6,0,32,26
1683639517602,BICD 100R,A05,202022,Smith; Laurie,11,0,32,21
1683639518629,BICD 136,A01,193242,Gustafson-Brown; Cindy,0,2,32,32
1683639518629,BICD 136,A02,193244,Gustafson-Brown; Cindy,13,0,32,19
1683639519664,BIEB 102,A01,193249,Butler; Shannon Rhey,0,2,32,32
1683639519664,BIEB 102,A02,193251,Butler; Shannon Rhey,0,0,32,32
1683639519664,BIEB 102,A03,193253,Butler; Shannon Rhey,0,0,32,32
1683639519664,BIEB 102,A04,193255,Butler; Shannon Rhey,14,0,32,18
1683639519664,BIEB 102,A05,193265,Butler; Shannon Rhey,26,0,32,6
1683639519664,BIEB 102,A06,193269,Butler; Shannon Rhey,14,0,32,18
1683639521721,BIEB 150,A01,193274,Staff,0,0,32,32
1683639521721,BIEB 150,A02,193285,Staff,24,0,32,8
1683639522747,BIEB 194,A00,193286,Kurle; Carolyn M.,20,0,32,12
1683639523783,BILD 1,A01,192291,Staff,15,0,32,17
1683639523783,BILD 1,A02,192292,Staff,30,0,32,2
1683639523783,BILD 1,B01,192520,Reuther; Keefe,0,1,0,0
1683639523783,BILD 1,B02,192532,Reuther; Keefe,0,1,0,0
1683639524814,BILD 3,A01,192556,Butler; Shannon Rhey,0,0,32,32
1683639524814,BILD 3,A02,192581,Butler; Shannon Rhey,1,0,32,31
1683639524814,BILD 3,A03,192611,Butler; Shannon Rhey,21,0,32,11
1683639524814,BILD 3,A04,192612,Butler; Shannon Rhey,24,0,32,8
1683639524814,BILD 3,A05,192613,Butler; Shannon Rhey,26,0,32,6
1683639524814,BILD 3,A06,192679,Butler; Shannon Rhey,27,0,32,5
1683639524814,BILD 3,A07,192682,Butler; Shannon Rhey,20,0,32,12
1683639525840,BILD 4,A01,192836,Reuther; Keefe,0,0,24,24
1683639525840,BILD 4,A02,193044,Reuther; Keefe,4,0,24,20
1683639526865,BILD 10,A01,193142,Gustafson-Brown; Cindy,29,0,32,3
1683639526865,BILD 10,A02,193149,Gustafson-Brown; Cindy,31,0,32,1
1683639527890,BIMM 100,A01,193301,Staff,0,6,32,32
1683639527890,BIMM 100,A02,193312,Staff,0,7,32,32
1683639527890,BIMM 100,A03,193323,Staff,0,9,32,32
1683639528918,BIMM 101,A01,193329,McDonnell; Lisa Marie,0,4,24,24
1683639528918,BIMM 101,A02,193339,McDonnell; Lisa Marie,0,3,24,24
1683639528918,BIMM 101,B01,193354,McDonnell; Lisa Marie,0,4,24,24
1683639528918,BIMM 101,B02,193357,McDonnell; Lisa Marie,0,2,24,24
1683639529943,BIMM 110,A01,193377,Tat; John,0,11,32,32
1683639529943,BIMM 110,A02,193378,Tat; John,0,10,32,32
1683639530979,BIMM 120,A01,206116,Staff,0,0,32,32
1683639530979,BIMM 120,A02,206117,Staff,6,0,32,26
1683639530979,BIMM 120,A03,206121,Staff,21,0,32,11
1683639532006,BIPN 100,A01,193393,Park; Ji Young,0,14,32,32
1683639532006,BIPN 100,A02,193402,Park; Ji Young,0,14,32,32
1683639532006,BIPN 100,A03,193413,Park; Ji Young,0,14,32,32
1683639532006,BIPN 100,A04,193414,Park; Ji Young,0,13,32,32
1683639533032,BIPN 102,A01,193429,Staff,0,0,32,32
1683639533032,BIPN 102,A02,193438,Staff,18,0,32,14
1683639534057,BIPN 106,A01,193450,Reyes Gonzalez; Catalina,0,2,40,40
1683639535084,BIPN 134,A01,193465,Cooke; James Edward,0,0,32,32
1683639535084,BIPN 134,A02,193474,Cooke; James Edward,25,0,32,7
1683639535084,BIPN 134,A03,193485,Cooke; James Edward,29,0,32,3
1683639535084,BIPN 134,A04,193486,Cooke; James Edward,20,0,32,12
1683639535084,BIPN 134,A05,193491,Cooke; James Edward,31,0,32,1
1683639535084,BIPN 134,A06,193501,Cooke; James Edward,30,0,32,2
1683639535084,BIPN 134,A07,193510,Cooke; James Edward,29,0,32,3
1683639537137,BISP 194,A00,222522,Staff,14,0,32,18
1683639538166,CAT 124,A01,202407,Staff,19,0,25,6
1683639539192,CAT 125,A00,202408,Marchisotto; Jennifer Anne,2,0,20,18
1683639540224,CAT 125R,A00,202409,Smith; Lauryn Alissa,0,11,20,20
1683639540224,CAT 125R,B00,202410,Morales; Celeste Georgianna,0,11,20,20
1683639540224,CAT 125R,C00,202411,Irwin; Matthew Joseph,0,12,20,20
1683639541276,CENG 15,A01,204712,Yang; Kesong,0,1,0,0
1683639542307,CENG 114,A00,202070,Jahed Motlagh; Zeinab,5,0,20,15
1683639543349,CGS 105,A00,185477,Wesling; Megan E.,24,0,40,16
1683639544380,CGS 106,A00,185494,Staff,11,0,22,11
1683639545406,CGS 108,A00,185495,Staff,14,0,20,6
1683639546437,CGS 114,A00,185496,Staff,13,0,18,5
1683639547460,CGS 119,A00,185501,Staff,15,0,20,5
1683639548484,CGS 120,A00,185511,Staff,12,0,20,8
1683639549516,CHEM 4,A01,184675,Bussey; Thomas J,97,0,100,3
1683639550541,CHEM 6A,A01,184677,Staff,33,0,60,27
1683639551566,CHEM 6B,A01,184679,Staff,63,0,100,37
1683639552593,CHEM 6C,A01,184681,Bussey; Thomas J,0,0,50,50
1683639552593,CHEM 6C,A02,184682,Bussey; Thomas J,32,0,50,18
1683639553618,CHEM 40A,A01,184684,Albizati; Kim F.,35,0,100,65
1683639554649,CHEM 40B,A01,184686,Albizati; Kim F.,0,22,100,100
1683639555675,CHEM 41B,A01,184690,Staff,51,0,100,49
1683639556701,COGS 3,A01,184715,Boyle; Mary E. T.,0,27,40,40
1683639557727,COGS 14B,A01,185172,Staff,0,14,38,38
1683639558753,COGS 18,A01,184736,Staff,15,0,80,65
1683639559779,COGS 100,A01,184932,Staff,0,7,73,73
1683639560805,COGS 101A,A01,184935,Staff,0,39,30,30
1683639561834,COGS 101B,A01,184944,Staff,0,2,30,30
1683639562860,COGS 101C,A01,184946,Staff,0,10,30,30
1683639563888,COGS 102A,A01,184951,Johnson; Christine M.,2,0,40,38
1683639564918,COGS 107B,A01,184953,Mooshagian; Eric Frederick,0,51,40,40
1683639565947,COGS 118B,A01,184959,Gupta; Anjum,0,49,40,40
1683639566972,COGS 153,A00,184961,Staff,0,16,30,30
1683639567998,COGS 177,A00,184962,Staff,0,21,30,30
1683639569025,COGS 187A,A01,184969,Boyle; Mary E. T.,0,19,40,40
1683639570050,COMM 10,A01,185174,Staff,0,5,25,25
1683639570050,COMM 10,A02,185189,Staff,0,2,25,25
1683639570050,COMM 10,A03,269821,Staff,0,1,0,0
1683639571074,COMM 100B,A01,185475,Staff,0,1,0,2
1683639571074,COMM 100B,A02,185476,Staff,12,0,25,13
1683639572102,COMM 100C,A01,185314,Staff,1,0,25,24
1683639572102,COMM 100C,A02,185327,Staff,18,0,25,7
1683639573126,COMM 110M,A00,185349,Staff,0,0,40,40
1683639574150,COMM 113T,A00,185352,Staff,25,0,40,15
1683639575174,COMM 114I,A00,185353,Staff,31,0,40,9
1683639576255,COMM 131,A00,185354,Staff,17,0,30,13
1683639577283,CSE 8A,A50,185358,Cao; Yingjun,0,46,10,10
1683639578308,CSE 8B,A01,185362,Staff,0,48,50,50
1683639579337,CSE 11,A01,185416,Cao; Yingjun,0,91,10,10
1683639580366,CSE 20,A01,185445,Briones; Jor-el Thomas Caparas,4,0,25,21
1683639581398,CSE 21,A01,185447,Staff,9,0,50,41
1683639582429,CSE 101,A01,185451,Staff,0,13,50,50
1683639582429,CSE 101,B01,185453,Jones; Miles E,0,13,50,50
1683639584483,CSE 141,A01,185458,Eldon; John,15,0,100,85
1683639585509,CSE 141L,A01,185461,Eldon; John,7,0,100,93
1683639586534,CSE 142,A01,185463,Staff,36,0,60,24
1683639586534,CSE 142,B01,201355,Staff,0,7,60,60
1683639587560,CSE 142L,A01,185470,Staff,36,0,60,24
1683639587560,CSE 142L,B01,201417,Staff,0,6,60,60
1683639588585,CSE 190,A00,201433,Staff,32,0,49,17
1683639589611,DOC 1,A01,259136,Strom; Megan C.,7,0,15,8
1683639589611,DOC 1,A02,259137,Strom; Megan C.,14,0,15,1
1683639589611,DOC 1,A03,259138,Strom; Megan C.,14,0,15,1
1683639589611,DOC 1,A04,259139,Strom; Megan C.,14,0,15,1
1683639590635,DOC 100D,A00,259140,Pass; Natalye Joann,14,0,25,11
1683639591660,DSGN 1,A01,184749,Rill; Bryan,0,26,30,30
1683639592694,DSGN 100,A01,185168,Staff,0,2,25,25
1683639593719,ECE 5,A01,185626,Morris; Karcher William,0,11,0,0
1683639594747,ECE 101,A01,185628,Staff,14,0,70,56
1683639595775,ECE 107,A01,185635,Baghdadchi; Saharnaz,0,0,20,20
1683639595775,ECE 107,A02,185638,Baghdadchi; Saharnaz,3,0,20,17
1683639596806,ECE 148,A01,185647,Silberman; Jack,0,0,16,16
1683639597834,ECON 1,A01,185537,Crane; Meredith Helen,54,0,70,16
1683639598860,ECON 3,A01,185549,Crane; Meredith Helen,29,0,70,41
1683639599885,ECON 4,A01,203354,Anderson; John Charles,0,5,10,10
1683639600910,ECON 100A,A01,185574,Staff,0,5,40,40
1683639601939,ECON 100B,A01,185576,Staff,0,12,50,50
1683639602963,ECON 100C,A01,185589,Newhouse; Herbert S,30,0,70,40
1683639603989,ECON 105,A00,185608,Vespa; Emanuel Ignacio,19,0,35,16
1683639605017,ECON 109,A01,185610,Shishkin; Denis,9,0,35,26
1683639606044,ECON 110A,A01,185612,Staff,9,0,40,31
1683639607070,ECON 120A,A01,185615,Staff,20,0,40,20
1683639608098,ECON 120C,A01,185617,Sun; Yixiao,0,20,70,70
1683639609127,ECON 144,A00,203346,Squires; Dale E,2,0,35,33
1683639610149,ECON 171,A01,203349,Newhouse; Herbert S,0,1,35,35
1683639611174,ECON 173A,A01,185621,Toda; Alexis Akira,21,0,35,14
1683639612209,EDS 25,A01,202413,Staff,0,1,0,0
1683639612209,EDS 25,A02,202414,Staff,0,1,0,0
1683639612209,EDS 25,A03,202415,Staff,0,0,0,0
1683639612209,EDS 25,A04,202416,Staff,0,1,0,0
1683639612209,EDS 25,A05,202439,Staff,0,0,0,0
1683639612209,EDS 25,A06,202440,Staff,0,0,0,0
1683639612209,EDS 25,B01,202631,Staff,0,0,0,0
1683639612209,EDS 25,B02,202632,Staff,0,0,0,0
1683639612209,EDS 25,B03,202639,Staff,0,0,0,0
1683639612209,EDS 25,B04,202640,Staff,0,0,0,0
1683639612209,EDS 25,B05,202643,Staff,0,0,0,0
1683639612209,EDS 25,B06,202644,Staff,0,0,0,0
1683639613234,EDS 38,A01,202659,Black; Alison Michelle,24,0,25,1
1683639614261,EDS 115,A00,202652,Staff,18,0,30,12
1683639615286,EDS 125,A00,202649,Staff,13,0,30,17
1683639616311,EDS 126,A01,203332,Staff,30,0,30,0
1683639617335,EDS 139,A00,202838,Staff,16,0,25,9
1683639618360,EDS 146,A01,202655,Staff,14,0,25,11
1683639619384,ENG 15,A00,185667,Staff,0,1,0,0
1683639619384,ENG 15,B00,185672,Staff,0,0,0,0
1683639619384,ENG 15,C00,185675,Staff,0,0,0,0
1683639619384,ENG 15,D00,185682,Staff,0,0,0,0
1683639619384,ENG 15,E00,185684,Staff,0,0,0,0
1683639620409,ETHN 103,A00,185710,Staff,0,8,35,35
1683639621437,ETHN 103A,A00,199228,Man; Simeon S,0,0,9,9
1683639622461,ETHN 109,A00,185711,Staff,16,0,35,19
1683639623489,ETHN 142,A00,185726,Staff,0,4,30,30
1683639624512,ETHN 163J,A00,199229,Man; Simeon S,5,0,8,3
1683639625539,ETHN 168,A00,185727,Staff,7,0,10,3
1683639626562,ETHN 182,A00,185728,Staff,0,0,35,35
1683639627590,ETHN 183,A00,185737,Staff,9,0,18,9
1683639628615,GLBH 111,A01,209361,Burgos; Jose L.,0,0,0,0
1683639630669,HIEU 104,A00,185792,Staff,14,0,20,6
1683639631694,HIEU 115,A00,185800,Staff,0,0,20,20
1683639632720,HIEU 128,A00,185801,Staff,0,9,20,20
1683639633749,HIEU 147,A00,185802,Staff,15,0,20,5
1683639634775,HIEU 154,A00,185823,Staff,11,0,20,9
1683639635800,HILA 102,A00,185826,Staff,14,0,20,6
1683639636826,HILD 2C,A01,185778,Staff,0,13,20,20
1683639637855,HILD 7B,A01,185780,Kwak; Nancy,0,16,32,32
1683639637855,HILD 7B,A02,185781,Kwak; Nancy,0,18,32,32
1683639638884,HILD 30,A01,185791,Staff,12,0,20,8
1683639639909,HISC 119,A00,185830,Golan; Tal,0,9,20,20
1683639640935,HITO 156GS,A00,185831,Patterson; Patrick H.,0,0,0,23
1683639641960,HIUS 103,A00,185832,Man; Simeon S,0,4,20,20
1683639642989,HIUS 117,A00,185836,Kwak; Nancy,2,0,20,18
1683639644017,HIUS 125,A00,185840,Man; Simeon S,0,1,23,23
1683639645042,HIUS 149,A00,185845,Staff,1,0,20,19
1683639646069,HUM 3,A01,185882,Zavodny; Tatiana Sophia,0,7,50,50
1683639646069,HUM 3,B01,185899,Caldwell; Michael Alan,0,18,50,50
1683639647096,HUM 3GS,A00,185900,Patterson; Patrick H.,0,0,0,23
1683639648128,HUM 4,A01,185938,Zroka; Amy Liane,30,0,50,20
1683639648128,HUM 4,B01,185956,Watkins; Eric,0,4,50,50
1683639648128,HUM 4,B02,202209,Watkins; Eric,0,4,50,50
1683639648128,HUM 4,B03,202210,Watkins; Eric,0,4,50,50
1683639649156,HUM 5,A01,185958,West; Geoffrey Scott,2,0,50,48
1683639649156,HUM 5,A02,202215,West; Geoffrey Scott,0,0,50,50
1683639650181,INTL 190,A00,185959,Gagnon; Jeffrey C,0,0,0,9
1683639650181,INTL 190,B00,185960,Lettieri; Michael Joseph,0,0,0,2
1683639651206,JAPN 180,A00,254509,Staff,5,0,30,25
1683639652231,LATI 10,A01,202853,Kennemore; Amy Michelle,4,0,35,31
1683639652231,LATI 10,A02,202854,Kennemore; Amy Michelle,2,0,35,33
1683639652231,LATI 10,A03,270054,Kennemore; Amy Michelle,30,0,30,0
1683639653259,LATI 180,A00,202855,Kennemore; Amy Michelle,11,0,20,9
1683639654285,LAWS 101,A00,201767,Golan; Tal,0,7,40,40
1683639655313,LIFR 1C,A00,185961,Staff,6,0,20,14
1683639656338,LIFR 1CX,A00,185962,Staff,7,0,20,13
1683639657362,LIFR 1D,A00,185963,Staff,7,0,20,13
1683639658386,LIFR 1DX,A00,185964,Staff,7,0,20,13
1683639659413,LIGN 101,A01,186039,Staff,43,0,50,7
1683639660441,LIGN 165,A00,186040,Staff,15,0,50,35
1683639661468,LTCS 108,A00,186041,Staff,5,0,10,5
1683639662495,LTCS 119,A00,186042,Staff,15,0,20,5
1683639663519,LTCS 130,A00,186043,Wesling; Megan E.,15,0,25,10
1683639665570,LTEA 138,A00,186119,Staff,14,0,40,26
1683639666596,LTEN 124,A00,186148,Staff,5,0,25,20
1683639667621,LTEN 178,A00,186149,Staff,7,0,15,8
1683639668647,LTEN 181,A00,186150,Blanco; John D,34,0,40,6
1683639669672,LTWL 120,A00,186160,Staff,20,0,25,5
1683639670696,LTWL 165,A00,186161,Staff,22,0,25,3
1683639671721,LTWR 100,A00,186162,Staff,0,5,15,15
1683639672746,LTWR 102,A00,186163,Doller; Ben,5,0,15,10
1683639673777,MAE 8,A01,186412,Staff,0,0,0,0
1683639674807,MAE 30B,A00,186445,Bahadori; Mohammad Yousef,82,0,100,18
1683639675832,MAE 40,A00,186592,Bewley; Thomas R,10,0,50,40
1683639676861,MAE 101B,A00,186593,Bahadori; Mohammad Yousef,80,0,100,20
1683639677890,MAE 105,A00,186594,Bandaru; Prabhakar,10,0,50,40
1683639678921,MAE 107,A00,186599,Pham; Hieu Tan,0,7,120,120
1683639680005,MAE 148,A01,186660,Silberman; Jack,3,0,16,13
1683639681030,MATH 10A,A01,188095,Staff,0,5,35,35
1683639682057,MATH 10B,A01,188097,Bowers; Adam R.,0,11,30,30
1683639682057,MATH 10B,A02,188099,Bowers; Adam R.,0,11,30,30
1683639682057,MATH 10B,B01,188104,Bowers; Adam R.,0,10,30,30
1683639682057,MATH 10B,B02,188106,Bowers; Adam R.,1,9,30,29
1683639683090,MATH 10C,A01,188111,Staff,0,18,30,30
1683639683090,MATH 10C,A02,188127,Staff,0,19,30,30
1683639683090,MATH 10C,A03,188131,Staff,0,19,30,30
1683639683090,MATH 10C,B01,188218,Staff,17,0,30,13
1683639683090,MATH 10C,B02,188244,Staff,13,0,30,17
1683639683090,MATH 10C,B03,188277,Staff,14,0,30,16
1683639684119,MATH 18,A01,188344,Bach; Quang Tran,18,0,30,12
1683639684119,MATH 18,A02,188345,Bach; Quang Tran,11,0,30,19
1683639684119,MATH 18,B01,188353,Bach; Quang Tran,11,0,30,19
1683639684119,MATH 18,B02,188354,Bach; Quang Tran,19,0,30,11
1683639685145,MATH 20A,A01,188374,Staff,11,0,35,24
1683639686177,MATH 20B,A01,188382,Ohm; Ko Woon,7,0,30,23
1683639686177,MATH 20B,A02,188383,Ohm; Ko Woon,22,0,30,8
1683639686177,MATH 20B,B01,188385,Ohm; Ko Woon,7,0,30,23
1683639686177,MATH 20B,B02,188392,Ohm; Ko Woon,22,0,30,8
1683639687208,MATH 20C,A01,188394,Harel; Guershon,11,0,30,19
1683639687208,MATH 20C,A02,188395,Harel; Guershon,14,0,30,16
1683639687208,MATH 20C,B01,188404,Harel; Guershon,4,0,30,26
1683639687208,MATH 20C,B02,188405,Harel; Guershon,18,0,30,12
1683639688235,MATH 20D,A01,188414,Hammock; Frances H,0,1,30,30
1683639688235,MATH 20D,A02,188415,Hammock; Frances H,0,1,30,30
1683639688235,MATH 20D,B01,188447,Hammock; Frances H,0,1,30,30
1683639688235,MATH 20D,B02,188486,Hammock; Frances H,4,0,30,26
1683639689265,MATH 20E,A01,188649,Staff,21,0,30,9
1683639689265,MATH 20E,A02,188650,Staff,21,0,30,9
1683639689265,MATH 20E,A03,188673,Staff,0,0,30,30
1683639690293,MATH 102,A01,188675,Staff,0,36,35,35
1683639691319,MATH 103B,A01,188681,Staff,3,0,35,32
1683639691319,MATH 103B,B01,188692,Staff,5,0,35,30
1683639692346,MATH 109,A01,188695,Salehi Golsefidy; Alireza,24,0,35,11
1683639692346,MATH 109,A02,188696,Salehi Golsefidy; Alireza,25,0,35,10
1683639693378,MATH 120A,A01,188698,Eggers; John Dietrich,7,0,35,28
1683639694410,MATH 142B,A01,188736,Ioana; Adrian,0,1,30,30
1683639694410,MATH 142B,A02,188741,Ioana; Adrian,0,1,30,30
1683639694410,MATH 142B,A03,188743,Ioana; Adrian,0,1,30,30
1683639695438,MATH 168A,A01,188790,Staff,0,10,35,35
1683639696464,MATH 170A,A01,188803,Nie; Jiawang,0,2,35,35
1683639696464,MATH 170A,A02,188811,Nie; Jiawang,0,0,35,35
1683639696464,MATH 170A,A03,188814,Nie; Jiawang,0,0,35,35
1683639696464,MATH 170A,A04,188815,Nie; Jiawang,10,0,35,25
1683639697489,MATH 193B,A01,188817,Staff,0,0,35,35
1683639697489,MATH 193B,A02,188818,Staff,5,0,35,30
1683639698513,MGT 4,A01,202857,Anderson; John Charles,61,0,80,19
1683639699539,MGT 12,A00,202858,Lindenberger; Wade Douglas,40,0,90,50
1683639700564,MGT 18,A00,202859,Staff,74,0,90,16
1683639701589,MGT 18GS,A00,202860,McKay; Michael J,13,0,28,15
1683639702615,MGT 45,A00,202861,Pecore; Joseph P.,12,0,90,78
1683639703640,MGT 100,A00,202863,Yavorsky; Daniel Ryan,28,0,90,62
1683639704669,MGT 103,A00,202864,Ehrich; Kristine R,0,17,90,90
1683639705697,MGT 112,A00,202865,Ehrich; Kristine R,15,0,90,75
1683639706726,MGT 121A,A00,202868,Staff,0,20,0,0
1683639707753,MGT 131B,A00,202869,Anderson; John Charles,59,0,90,31
1683639708777,MGT 136,A00,202871,Lindenberger; Wade Douglas,83,0,90,7
1683639709802,MGT 164,A00,202873,Staff,0,66,90,91
1683639710826,MGT 164GS,A00,202874,McKay; Mary A,13,0,28,15
1683639711851,MGT 180,A00,202875,Staff,0,50,90,91
1683639712879,MMW 11R,A01,205019,Herbst; Matthew,2,0,30,28
1683639712879,MMW 11R,A02,205026,Herbst; Matthew,29,0,30,1
1683639713904,MMW 15,A01,193512,Chang; Edmond Yi-Teh,0,8,28,28
1683639713904,MMW 15,A02,193513,Chang; Edmond Yi-Teh,0,5,28,28
1683639713904,MMW 15,A03,193514,Chang; Edmond Yi-Teh,0,5,28,28
1683639713904,MMW 15,A04,193515,Chang; Edmond Yi-Teh,0,5,28,28
1683639713904,MMW 15,A05,193516,Chang; Edmond Yi-Teh,0,5,28,28
1683639713904,MMW 15,A06,193517,Chang; Edmond Yi-Teh,0,6,28,28
1683639713904,MMW 15,B01,193519,Chang; Edmond Yi-Teh,0,5,28,28
1683639713904,MMW 15,B02,193520,Chang; Edmond Yi-Teh,0,5,28,28
1683639713904,MMW 15,B03,193521,Chang; Edmond Yi-Teh,0,5,28,28
1683639713904,MMW 15,B04,193522,Chang; Edmond Yi-Teh,0,5,28,28
1683639713904,MMW 15,B05,193523,Chang; Edmond Yi-Teh,0,5,28,28
1683639713904,MMW 15,B06,193524,Chang; Edmond Yi-Teh,0,5,28,28
1683639714929,MMW 122,A01,193526,Rahimi; Babak,0,16,28,28
1683639714929,MMW 122,A02,193527,Rahimi; Babak,0,15,28,28
1683639714929,MMW 122,A03,193528,Rahimi; Babak,0,0,0,0
1683639714929,MMW 122,A04,193529,Rahimi; Babak,0,0,0,0
1683639715953,MUS 1A,A01,186663,Staff,1,20,35,34
1683639716978,MUS 4,A01,186715,Staff,0,12,35,35
1683639718008,MUS 5R,A01,186796,Dubnov; Shlomo,0,17,35,35
1683639719031,MUS 6,A01,186798,Staff,0,5,25,25
1683639720057,MUS 7,A01,186830,Staff,11,0,35,24
1683639721080,MUS 8,A01,186930,Staff,0,26,35,35
1683639722106,MUS 15,A01,186932,Staff,0,16,35,35
1683639722106,MUS 15,B01,186934,Staff,0,17,35,35
1683639723139,MUS 80,A00,186935,Staff,0,0,20,20
1683639723139,MUS 80,B00,186936,Staff,24,0,25,1
1683639724167,NANO 11,A00,204702,Lipomi; Darren John,0,0,0,0
1683639725197,NANO 15,A01,204709,Yang; Kesong,0,1,0,0
1683639726225,NANO 114,A00,202069,Jahed Motlagh; Zeinab,3,0,10,7
1683639727250,PHIL 1,A00,186955,Grush; Rick Scott,31,0,40,9
1683639728275,PHIL 10,A01,186973,Grush; Rick Scott,27,0,35,8
1683639728275,PHIL 10,A02,186974,Grush; Rick Scott,33,0,35,2
1683639729301,PHIL 13,A01,186976,Staff,3,0,35,32
1683639729301,PHIL 13,A02,186977,Staff,16,0,35,19
1683639730327,PHIL 14,A01,186979,Staff,31,0,35,4
1683639730327,PHIL 14,A02,186986,Staff,32,0,35,3
1683639731352,PHIL 28,A01,186988,Staff,16,0,30,14
1683639731352,PHIL 28,A02,186989,Staff,1,0,30,29
1683639731352,PHIL 28,A03,186990,Staff,10,0,30,20
1683639731352,PHIL 28,A04,186991,Staff,26,0,30,4
1683639732377,PHIL 120,A00,186997,Staff,23,0,40,17
1683639733401,PHIL 137,A00,187003,Staff,7,0,40,33
1683639734426,PHIL 150,A00,187015,Staff,47,0,70,23
1683639735455,PHIL 167,A00,187021,Lamey; Andy M.,34,0,40,6
1683639736483,PHIL 174,A01,202226,Staff,17,0,20,3
1683639736483,PHIL 174,A02,202235,Staff,20,0,20,0
1683639737511,PHIL 191A,A00,258918,Staff,0,0,1,1
1683639738540,PHYS 1A,A00,187028,Staff,27,0,60,33
1683639739566,PHYS 1AL,001,187036,Staff,3,0,30,27
1683639739566,PHYS 1AL,002,187049,Staff,18,0,30,12
1683639740594,PHYS 1B,A00,187058,Staff,22,0,60,38
1683639741622,PHYS 1BL,001,187064,Staff,0,1,30,30
1683639741622,PHYS 1BL,002,187070,Staff,4,0,30,26
1683639742653,PHYS 1C,A00,187082,Staff,29,0,120,91
1683639743680,PHYS 1CL,001,187088,Staff,0,9,30,30
1683639743680,PHYS 1CL,002,187089,Staff,0,1,30,30
1683639743680,PHYS 1CL,009,262693,Staff,9,0,30,21
1683639744705,PHYS 2B,A01,187097,Staff,55,0,115,60
1683639745730,PHYS 2C,A01,187099,Staff,64,0,115,51
1683639746754,PHYS 2CL,A01,187101,Staff,5,0,28,23
1683639746754,PHYS 2CL,A02,187102,Staff,15,0,28,13
1683639747781,PHYS 2D,A01,187123,Shotwell; Brian,95,0,115,20
1683639748812,PHYS 4B,A01,187133,Grinstein; Benjamin,35,0,50,15
1683639749840,POLI 10,A00,188819,Staff,0,4,50,50
1683639750866,POLI 11,A00,188827,Staff,43,0,50,7
1683639751891,POLI 13R,A00,188828,Staff,0,1,20,20
1683639752916,POLI 27,A01,188830,Elgin; Samuel Zincke,0,2,70,70
1683639753941,POLI 30,A00,188832,Desposato; Scott,30,0,50,20
1683639754968,POLI 102F,A00,188834,Staff,0,0,40,40
1683639755993,POLI 104A,A00,188852,Staff,13,0,30,17
1683639757018,POLI 104I,A00,188853,Staff,0,7,20,20
1683639758067,POLI 110B,A00,188854,Wiens; David,7,0,20,13
1683639759093,POLI 112A,A00,188855,Wiens; David,4,0,30,26
1683639760124,POLI 117R,A00,188856,Forman; Fonna,0,12,20,20
1683639761153,POLI 118,A00,188857,Ingham; Sean,8,0,20,12
1683639762181,POLI 120G,A00,188858,Staff,8,0,30,22
1683639763207,POLI 131CR,A00,188863,Hoston; Germaine,21,0,50,29
1683639764234,POLI 133,A00,188864,Nellis; Gareth Hb,44,0,50,6
1683639765262,POLI 134D,A00,188865,Desposato; Scott,27,0,30,3
1683639766289,POLI 142A,A00,188871,Gartzke; Erik,21,0,50,29
1683639767315,POLI 142K,A00,188874,Staff,38,0,50,12
1683639768343,POLI 143,A00,188940,Gartzke; Erik,16,0,30,14
1683639769368,POLI 153,A00,188943,Staff,2,0,20,18
1683639770391,POLI 160AA,A00,188944,Staff,11,0,40,29
1683639771417,POLI 170A,A00,188945,Staff,11,0,30,19
1683639773465,PSYC 1,A00,188952,Staff,36,0,90,54
1683639774491,PSYC 2,B00,188953,Staff,19,0,35,16
1683639775516,PSYC 6,A00,188970,Staff,47,0,60,13
1683639776544,PSYC 7,A00,188973,Staff,35,0,45,10
1683639777576,PSYC 60,A01,188980,Rickard; Timothy C.,42,0,60,18
1683639778601,PSYC 70,A01,189001,Steiner; Eric Tomas,23,0,45,22
1683639779628,PSYC 100,A00,189005,Lacefield; Katharine I,0,99,120,120
1683639780655,PSYC 102,A00,189008,Staff,8,0,30,22
1683639781679,PSYC 106,B00,189026,Gorman; Michael R.,27,0,60,33
1683639782705,PSYC 114,B01,189033,Winkielman; Piotr,0,31,30,30
1683639783803,PSYC 131,A00,189036,Anagnostaras; Stephan,0,43,60,60
1683639784828,PSYC 136,A00,189041,Lowe; Angela Beth,0,7,25,25
1683639785852,PSYC 137,A00,189057,Winkielman; Piotr,0,37,25,25
1683639786876,PSYC 144,A00,189107,Wixted; John T,0,10,50,50
1683639788932,PSYC 162,A00,189142,Staff,0,9,85,85
1683639789957,PSYC 172,A00,189144,Gorman; Michael R.,0,6,30,30
1683639792007,PSYC 179,A00,189146,Lacefield; Katharine I,0,86,120,120
1683639793036,PSYC 181,A00,189147,Anagnostaras; Stephan,0,44,90,90
1683639794065,PSYC 190R,A00,189148,Barner; David A.,0,23,80,80
1683639795092,PSYC 191,A00,189275,Rickard; Timothy C.,0,10,25,25
1683639796121,PSYC 193,A00,189276,Chapman; Eddie Nathaniel,0,1,0,4
1683639797151,PSYC 193L,A01,189281,Lowe; Angela Beth,10,0,20,10
1683639797151,PSYC 193L,B01,189285,Staff,28,0,35,7
1683639798178,RELI 149,A00,187137,Rahimi; Babak,7,0,40,33
1683639799204,SE 9,A01,187315,Staff,0,2,18,18
1683639800233,SE 101B,A00,187409,Staff,24,0,30,6
1683639801263,SE 110B,A00,187444,Staff,10,0,40,30
1683639802288,SE 130B,A00,187449,Staff,31,0,40,9
1683639803313,SE 150A,A00,187516,Staff,9,0,20,11
1683639804342,SE 154,A00,187528,Staff,29,0,50,21
1683639805371,SIO 3,A01,258171,Staff,35,0,40,5
1683639806399,SIO 10,A00,187144,Cook; Geoffrey W,0,6,75,75
1683639807423,SIO 45,A00,187152,Cook; Geoffrey W,0,4,100,100
1683639808448,SIO 109R,A00,194486,Staff,0,4,20,20
1683639810499,SIO 187,A01,187233,Kacev; David,12,0,40,28
1683639811526,SOCI 1,A01,258656,Thorpe; Charles Robert,28,0,30,2
1683639811526,SOCI 1,A02,258658,Thorpe; Charles Robert,30,0,30,0
1683639811526,SOCI 1,A03,258661,Thorpe; Charles Robert,25,0,25,0
1683639811526,SOCI 1,A04,258666,Thorpe; Charles Robert,22,0,25,3
1683639811526,SOCI 1,A05,258897,Thorpe; Charles Robert,22,0,25,3
1683639811526,SOCI 1,A06,258898,Thorpe; Charles Robert,25,0,25,0
1683639812551,SOCI 30,A01,258903,Pardo Guerra; Juan Pablo,14,0,30,16
1683639813575,SOCI 102,A00,258904,Staff,9,0,25,16
1683639814600,SOCI 106,A00,258905,Staff,19,0,25,6
1683639815627,SOCI 111,A00,258907,Ribas Norris; Janet Vanesa,26,0,30,4
1683639816652,SOCI 121R,A00,258908,Pardo Guerra; Juan Pablo,8,0,30,22
1683639817682,SOCI 126,A01,203330,Staff,14,0,20,6
1683639818709,SOCI 131,A00,258909,Thorpe; Charles Robert,30,0,60,30
1683639819733,SOCI 135,A00,258910,Payne; Christine Anna,0,11,30,30
1683639820761,SOCI 157,A00,258911,Staff,12,0,30,18
1683639821788,SOCI 184,A00,258912,Staff,25,0,30,5
1683639822814,SOCI 188D,A00,258913,Staff,22,0,30,8
1683639823839,SYN 2,001,187529,Staff,9,0,16,7
1683639823839,SYN 2,002,201452,Staff,0,20,16,16
1683639823839,SYN 2,003,201469,Staff,2,0,16,14
1683639824864,SYN 100,A01,187531,Staff,0,9,20,20
1683639824864,SYN 100,B01,201491,Staff,0,10,20,20
1683639825896,TDAC 1,A00,189286,Walsh; Kim C.,3,0,20,17
1683639825896,TDAC 1,B00,189287,Harting; Carla Kelso,10,0,20,10
1683639826926,TDAC 101,A00,189300,Walsh; Kim C.,16,0,20,4
1683639826926,TDAC 101,B00,189301,Harting; Carla Kelso,18,0,20,2
1683639827952,TDAC 102,A00,189304,Basso; Beatrice,14,0,20,6
1683639828980,TDAC 108,A00,189305,Staff,18,0,20,2
1683639830012,TDDE 131,A00,189310,Staff,19,0,20,1
1683639830012,TDDE 131,B00,189314,Staff,19,0,20,1
1683639830012,TDDE 131,C00,189315,Staff,48,0,50,2
1683639830012,TDDE 131,D00,189316,Staff,14,0,15,1
1683639830012,TDDE 131,E00,204841,Staff,20,0,20,0
1683639831040,TDGE 10,A00,189289,Staff,27,0,50,23
1683639831040,TDGE 10,B00,189290,Havis; Allan,0,0,50,50
1683639832070,TDGE 11,A00,189291,Fulton; Julia,0,4,50,50
1683639832070,TDGE 11,B00,189292,Staff,20,0,25,5
1683639832070,TDGE 11,C00,260270,Staff,0,0,0,0
1683639833094,TDGE 25,A00,189294,Staff,2,0,20,18
1683639834118,TDGE 124,A00,189318,Fulton; Julia,0,8,50,50
1683639835141,TDGE 125,A00,189319,Staff,13,0,25,12
1683639835141,TDGE 125,B00,189320,Staff,23,0,25,2
1683639836169,TDGE 127,A00,189322,Havis; Allan,0,0,50,50
1683639837196,TDHT 101,A00,189323,Staff,18,0,25,7
1683639837196,TDHT 101,B00,189324,Staff,25,0,25,0
1683639838220,TDHT 102,A00,189325,Staff,49,0,50,1
1683639839245,TDMV 1,A00,189295,Arcidiacono; Kristin,20,0,30,10
1683639839245,TDMV 1,B00,189296,Caligagan; Maria T.,24,0,30,6
1683639840270,TDMV 2,A00,189297,Sammartano; Tonnie,27,0,30,3
1683639840270,TDMV 2,B00,189299,Arcidiacono; Kristin,23,0,30,7
1683639841300,TDMV 3,A00,204998,Rincon; Alicia,22,0,30,8
1683639842329,TDMV 120,A00,189458,Sammartano; Tonnie,28,0,30,2
1683639843354,TDMV 138,A00,189541,Jun; Grace Shin Hae,20,0,40,20
1683639844383,TDMV 142,A00,189717,Caligagan; Tony,25,0,30,5
1683639844383,TDMV 142,B00,189718,Caligagan; Maria T.,25,0,30,5
1683639845413,TMC 2,A01,187533,Staff,25,0,25,0
1683639845413,TMC 2,A02,187534,Staff,25,0,25,0
1683639846439,USP 1,A01,187536,Kwak; Nancy,0,16,25,25
1683639847463,USP 5,A01,187538,Staff,9,0,25,16
1683639848488,USP 101,A00,199253,Staff,0,4,0,0
1683639849513,USP 124,A00,187562,Boomhower; Matthew Charles,0,0,30,30
1683639850539,USP 138,A00,187582,Staff,20,0,25,5
1683639851566,USP 152,A01,187597,Staff,3,0,25,22
1683639852593,USP 153,A00,187598,Staff,19,0,25,6
1683639853625,USP 168,A00,187607,Kwak; Nancy,2,0,5,3
1683639854651,USP 173,A00,187619,Staff,4,0,25,21
1683639855679,USP 181,A00,187638,Staff,0,4,25,25
1683639856705,VIS 103,A00,187650,Cruz; Edwin Teddy,18,0,75,57
1683639857733,VIS 110D,A00,187669,Staff,13,0,22,9
1683639858759,VIS 127C,A00,187720,Shen; Kuiyi,67,0,146,79
1683639859785,VIS 149,A00,187731,Yoldas; Pinar,0,14,22,22
1683639860809,VIS 151,A01,188091,Staff,22,0,34,12
1683639860809,VIS 151,A02,188092,Staff,11,0,34,23
1683639861834,VIS 160B,A00,188093,Stalbaum; Brett,0,1,10,10
1683639863888,WCWP 10B,A00,201720,Staff,10,0,15,5
1683639863888,WCWP 10B,B00,201722,Staff,9,0,15,6
1683639864916,WCWP 100,A00,201725,Gagnon; Jeffrey C,0,0,2,2
1683639864916,WCWP 100,B00,201727,Staff,0,4,15,15
1683639868037,ANBI 133,A00,258401,Wilder; Linnea Lorene,34,0,40,6
1683639869063,ANBI 140,A00,258395,Hrvoj Mihic; Branka,18,0,25,7
1683639870089,ANSC 120,A00,258402,Bialecki; Jon Anthony,27,0,40,13
1683639871114,ANSC 144,A00,258400,Staff,12,0,40,28
1683639873163,ANSC 166,A00,258396,Parish; Steven Martin,156,0,175,19
1683639874186,ANSC 180,A00,193533,Staff,8,0,20,12
1683639875214,ANSC 188,A00,258397,Jassal; Aftab,34,0,40,6
1683639876243,ANTH 3,A01,258316,Staff,23,0,30,7
1683639877268,ANTH 5,A00,258394,Semendeferi; Ekaterini,16,0,20,4
1683639878294,ANTH 21,A01,258331,Staff,4,0,40,36
1683639879323,ANTH 103,A00,258398,Varma; Saiba,15,0,25,10
1683639880352,AWP 10,001,202034,Staff,0,0,0,0
1683639880352,AWP 10,002,202035,Staff,0,0,0,0
1683639880352,AWP 10,003,202036,Staff,0,0,0,0
1683639880352,AWP 10,004,202037,Staff,0,0,0,0
1683639880352,AWP 10,005,202038,Staff,0,0,0,0
1683639880352,AWP 10,006,202039,Staff,0,0,0,0
1683639880352,AWP 10,007,202040,Staff,0,0,0,0
1683639880352,AWP 10,008,202041,Staff,0,0,0,0
1683639880352,AWP 10,009,202042,Staff,0,0,0,0
1683639880352,AWP 10,010,202043,Staff,0,0,0,0
1683639880352,AWP 10,011,202044,Staff,0,0,0,0
1683639880352,AWP 10,012,202045,Staff,0,0,0,0
1683639880352,AWP 10,013,202046,Staff,0,0,0,0
1683639880352,AWP 10,014,202047,Staff,0,0,0,0
1683639880352,AWP 10,015,202048,Staff,0,0,0,0
1683639880352,AWP 10,016,202049,Staff,0,0,0,0
1683639880352,AWP 10,017,202050,Staff,0,0,0,0
1683639880352,AWP 10,018,202051,Staff,0,0,0,0
1683639880352,AWP 10,019,202052,Staff,0,0,0,0
1683639880352,AWP 10,020,202053,Staff,0,0,0,0
1683639880352,AWP 10,021,202054,Staff,0,0,0,0
1683639880352,AWP 10,022,202055,Staff,0,0,0,0
1683639880352,AWP 10,023,202056,Staff,0,0,0,0
1683639880352,AWP 10,024,202057,Staff,0,0,0,0
1683639880352,AWP 10,025,202058,Staff,0,0,0,0
1683639880352,AWP 10,026,202059,Staff,0,0,0,0
1683639881377,AWP 102,001,202032,Staff,0,0,0,0
1683639881377,AWP 102,002,202033,Staff,0,0,0,0
1683639882403,BENG 100,A01,254234,Taylor Amos; Alyssa C,31,0,40,9
1683639883427,BENG 196,001,270013,Engler; Adam J.,9999,0,9999,0
1683639884461,BICD 100R,A01,202018,Smith; Laurie,0,7,32,32
1683639884461,BICD 100R,A02,202019,Smith; Laurie,0,3,32,32
1683639884461,BICD 100R,A03,202020,Smith; Laurie,0,1,32,32
1683639884461,BICD 100R,A04,202021,Smith; Laurie,6,0,32,26
1683639884461,BICD 100R,A05,202022,Smith; Laurie,11,0,32,21
1683639885488,BICD 136,A01,193242,Gustafson-Brown; Cindy,0,2,32,32
1683639885488,BICD 136,A02,193244,Gustafson-Brown; Cindy,13,0,32,19
1683639886516,BIEB 102,A01,193249,Butler; Shannon Rhey,0,2,32,32
1683639886516,BIEB 102,A02,193251,Butler; Shannon Rhey,0,0,32,32
1683639886516,BIEB 102,A03,193253,Butler; Shannon Rhey,0,0,32,32
1683639886516,BIEB 102,A04,193255,Butler; Shannon Rhey,14,0,32,18
1683639886516,BIEB 102,A05,193265,Butler; Shannon Rhey,26,0,32,6
1683639886516,BIEB 102,A06,193269,Butler; Shannon Rhey,14,0,32,18
1683639888628,BIEB 150,A01,193274,Staff,0,0,32,32
1683639888628,BIEB 150,A02,193285,Staff,24,0,32,8
1683639889656,BIEB 194,A00,193286,Kurle; Carolyn M.,20,0,32,12
1683639890684,BILD 1,A01,192291,Staff,15,0,32,17
1683639890684,BILD 1,A02,192292,Staff,30,0,32,2
1683639890684,BILD 1,B01,192520,Reuther; Keefe,0,1,0,0
1683639890684,BILD 1,B02,192532,Reuther; Keefe,0,1,0,0
1683639891711,BILD 3,A01,192556,Butler; Shannon Rhey,0,0,32,32
1683639891711,BILD 3,A02,192581,Butler; Shannon Rhey,1,0,32,31
1683639891711,BILD 3,A03,192611,Butler; Shannon Rhey,21,0,32,11
1683639891711,BILD 3,A04,192612,Butler; Shannon Rhey,24,0,32,8
1683639891711,BILD 3,A05,192613,Butler; Shannon Rhey,26,0,32,6
1683639891711,BILD 3,A06,192679,Butler; Shannon Rhey,27,0,32,5
1683639891711,BILD 3,A07,192682,Butler; Shannon Rhey,20,0,32,12
1683639892744,BILD 4,A01,192836,Reuther; Keefe,0,0,24,24
1683639892744,BILD 4,A02,193044,Reuther; Keefe,4,0,24,20
1683639893773,BILD 10,A01,193142,Gustafson-Brown; Cindy,29,0,32,3
1683639893773,BILD 10,A02,193149,Gustafson-Brown; Cindy,31,0,32,1
1683639894799,BIMM 100,A01,193301,Staff,0,6,32,32
1683639894799,BIMM 100,A02,193312,Staff,0,7,32,32
1683639894799,BIMM 100,A03,193323,Staff,0,9,32,32
1683639895827,BIMM 101,A01,193329,McDonnell; Lisa Marie,0,4,24,24
1683639895827,BIMM 101,A02,193339,McDonnell; Lisa Marie,0,3,24,24
1683639895827,BIMM 101,B01,193354,McDonnell; Lisa Marie,0,4,24,24
1683639895827,BIMM 101,B02,193357,McDonnell; Lisa Marie,0,2,24,24
1683639896853,BIMM 110,A01,193377,Tat; John,0,11,32,32
1683639896853,BIMM 110,A02,193378,Tat; John,0,10,32,32
1683639897885,BIMM 120,A01,206116,Staff,0,0,32,32
1683639897885,BIMM 120,A02,206117,Staff,6,0,32,26
1683639897885,BIMM 120,A03,206121,Staff,21,0,32,11
1683639898911,BIPN 100,A01,193393,Park; Ji Young,0,14,32,32
1683639898911,BIPN 100,A02,193402,Park; Ji Young,0,14,32,32
1683639898911,BIPN 100,A03,193413,Park; Ji Young,0,14,32,32
1683639898911,BIPN 100,A04,193414,Park; Ji Young,0,13,32,32
1683639899937,BIPN 102,A01,193429,Staff,0,0,32,32
1683639899937,BIPN 102,A02,193438,Staff,18,0,32,14
1683639900962,BIPN 106,A01,193450,Reyes Gonzalez; Catalina,0,2,40,40
1683639901985,BIPN 134,A01,193465,Cooke; James Edward,0,0,32,32
1683639901985,BIPN 134,A02,193474,Cooke; James Edward,25,0,32,7
1683639901985,BIPN 134,A03,193485,Cooke; James Edward,29,0,32,3
1683639901985,BIPN 134,A04,193486,Cooke; James Edward,20,0,32,12
1683639901985,BIPN 134,A05,193491,Cooke; James Edward,31,0,32,1
1683639901985,BIPN 134,A06,193501,Cooke; James Edward,30,0,32,2
1683639901985,BIPN 134,A07,193510,Cooke; James Edward,29,0,32,3
1683639904039,BISP 194,A00,222522,Staff,14,0,32,18
1683639905063,CAT 124,A01,202407,Staff,19,0,25,6
1683639906093,CAT 125,A00,202408,Marchisotto; Jennifer Anne,2,0,20,18
1683639907118,CAT 125R,A00,202409,Smith; Lauryn Alissa,0,11,20,20
1683639907118,CAT 125R,B00,202410,Morales; Celeste Georgianna,0,11,20,20
1683639907118,CAT 125R,C00,202411,Irwin; Matthew Joseph,0,12,20,20
1683639908143,CENG 15,A01,204712,Yang; Kesong,0,1,0,0
1683639909170,CENG 114,A00,202070,Jahed Motlagh; Zeinab,5,0,20,15
1683639910196,CGS 105,A00,185477,Wesling; Megan E.,24,0,40,16
1683639911225,CGS 106,A00,185494,Staff,11,0,22,11
1683639912253,CGS 108,A00,185495,Staff,14,0,20,6
1683639913281,CGS 114,A00,185496,Staff,13,0,18,5
1683639914306,CGS 119,A00,185501,Staff,15,0,20,5
1683639915335,CGS 120,A00,185511,Staff,12,0,20,8
1683639916361,CHEM 4,A01,184675,Bussey; Thomas J,97,0,100,3
1683639917387,CHEM 6A,A01,184677,Staff,33,0,60,27
1683639918416,CHEM 6B,A01,184679,Staff,63,0,100,37
1683639919441,CHEM 6C,A01,184681,Bussey; Thomas J,0,0,50,50
1683639919441,CHEM 6C,A02,184682,Bussey; Thomas J,32,0,50,18
1683639920472,CHEM 40A,A01,184684,Albizati; Kim F.,35,0,100,65
1683639921501,CHEM 40B,A01,184686,Albizati; Kim F.,0,22,100,100
1683639922527,CHEM 41B,A01,184690,Staff,51,0,100,49
1683639923559,COGS 3,A01,184715,Boyle; Mary E. T.,0,27,40,40
1683639924589,COGS 14B,A01,185172,Staff,0,14,38,38
1683639925617,COGS 18,A01,184736,Staff,15,0,80,65
1683639926645,COGS 100,A01,184932,Staff,0,7,73,73
1683639927672,COGS 101A,A01,184935,Staff,0,39,30,30
1683639928701,COGS 101B,A01,184944,Staff,0,2,30,30
1683639929726,COGS 101C,A01,184946,Staff,0,10,30,30
1683639930755,COGS 102A,A01,184951,Johnson; Christine M.,2,0,40,38
1683639931785,COGS 107B,A01,184953,Mooshagian; Eric Frederick,0,51,40,40
1683639932815,COGS 118B,A01,184959,Gupta; Anjum,0,49,40,40
1683639933839,COGS 153,A00,184961,Staff,0,16,30,30
1683639934869,COGS 177,A00,184962,Staff,0,21,30,30
1683639935897,COGS 187A,A01,184969,Boyle; Mary E. T.,0,19,40,40
1683639936926,COMM 10,A01,185174,Staff,0,5,25,25
1683639936926,COMM 10,A02,185189,Staff,0,2,25,25
1683639936926,COMM 10,A03,269821,Staff,0,1,0,0
1683639937956,COMM 100B,A01,185475,Staff,0,1,0,2
1683639937956,COMM 100B,A02,185476,Staff,12,0,25,13
1683639938983,COMM 100C,A01,185314,Staff,1,0,25,24
1683639938983,COMM 100C,A02,185327,Staff,18,0,25,7
1683639940010,COMM 110M,A00,185349,Staff,0,0,40,40
1683639941039,COMM 113T,A00,185352,Staff,25,0,40,15
1683639942066,COMM 114I,A00,185353,Staff,31,0,40,9
1683639943090,COMM 131,A00,185354,Staff,17,0,30,13
1683639944114,CSE 8A,A50,185358,Cao; Yingjun,0,46,10,10
1683639945143,CSE 8B,A01,185362,Staff,0,48,50,50
1683639946169,CSE 11,A01,185416,Cao; Yingjun,0,91,10,10
1683639947198,CSE 20,A01,185445,Briones; Jor-el Thomas Caparas,4,0,25,21
1683639948229,CSE 21,A01,185447,Staff,9,0,50,41
1683639949259,CSE 101,A01,185451,Staff,0,13,50,50
1683639949259,CSE 101,B01,185453,Jones; Miles E,0,13,50,50
1683639951313,CSE 141,A01,185458,Eldon; John,15,0,100,85
1683639952342,CSE 141L,A01,185461,Eldon; John,7,0,100,93
1683639953366,CSE 142,A01,185463,Staff,36,0,60,24
1683639953366,CSE 142,B01,201355,Staff,0,7,60,60
1683639954391,CSE 142L,A01,185470,Staff,36,0,60,24
1683639954391,CSE 142L,B01,201417,Staff,0,6,60,60
1683639955415,CSE 190,A00,201433,Staff,32,0,49,17
1683639956446,DOC 1,A01,259136,Strom; Megan C.,7,0,15,8
1683639956446,DOC 1,A02,259137,Strom; Megan C.,14,0,15,1
1683639956446,DOC 1,A03,259138,Strom; Megan C.,14,0,15,1
1683639956446,DOC 1,A04,259139,Strom; Megan C.,14,0,15,1
1683639957479,DOC 100D,A00,259140,Pass; Natalye Joann,14,0,25,11
1683639958510,DSGN 1,A01,184749,Rill; Bryan,0,26,30,30
1683639959535,DSGN 100,A01,185168,Staff,0,2,25,25
1683639960565,ECE 5,A01,185626,Morris; Karcher William,0,11,0,0
1683639961605,ECE 101,A01,185628,Staff,14,0,70,56
1683639962638,ECE 107,A01,185635,Baghdadchi; Saharnaz,0,0,20,20
1683639962638,ECE 107,A02,185638,Baghdadchi; Saharnaz,3,0,20,17
1683639963664,ECE 148,A01,185647,Silberman; Jack,0,0,16,16
1683639964688,ECON 1,A01,185537,Crane; Meredith Helen,54,0,70,16
1683639965716,ECON 3,A01,185549,Crane; Meredith Helen,29,0,70,41
1683639966742,ECON 4,A01,203354,Anderson; John Charles,0,5,10,10
1683639967771,ECON 100A,A01,185574,Staff,0,5,40,40
1683639968795,ECON 100B,A01,185576,Staff,0,12,50,50
1683639969820,ECON 100C,A01,185589,Newhouse; Herbert S,30,0,70,40
1683639970845,ECON 105,A00,185608,Vespa; Emanuel Ignacio,19,0,35,16
1683639971870,ECON 109,A01,185610,Shishkin; Denis,9,0,35,26
1683639972896,ECON 110A,A01,185612,Staff,9,0,40,31
1683639973923,ECON 120A,A01,185615,Staff,20,0,40,20
1683639974951,ECON 120C,A01,185617,Sun; Yixiao,0,20,70,70
1683639975981,ECON 144,A00,203346,Squires; Dale E,2,0,35,33
1683639977010,ECON 171,A01,203349,Newhouse; Herbert S,0,1,35,35
1683639978039,ECON 173A,A01,185621,Toda; Alexis Akira,21,0,35,14
1683639979074,EDS 25,A01,202413,Staff,0,1,0,0
1683639979074,EDS 25,A02,202414,Staff,0,1,0,0
1683639979074,EDS 25,A03,202415,Staff,0,0,0,0
1683639979074,EDS 25,A04,202416,Staff,0,1,0,0
1683639979074,EDS 25,A05,202439,Staff,0,0,0,0
1683639979074,EDS 25,A06,202440,Staff,0,0,0,0
1683639979074,EDS 25,B01,202631,Staff,0,0,0,0
1683639979074,EDS 25,B02,202632,Staff,0,0,0,0
1683639979074,EDS 25,B03,202639,Staff,0,0,0,0
1683639979074,EDS 25,B04,202640,Staff,0,0,0,0
1683639979074,EDS 25,B05,202643,Staff,0,0,0,0
1683639979074,EDS 25,B06,202644,Staff,0,0,0,0
1683639980100,EDS 38,A01,202659,Black; Alison Michelle,24,0,25,1
1683639981125,EDS 115,A00,202652,Staff,18,0,30,12
1683639982153,EDS 125,A00,202649,Staff,13,0,30,17
1683639983180,EDS 126,A01,203332,Staff,30,0,30,0
1683639984207,EDS 139,A00,202838,Staff,16,0,25,9
1683639985231,EDS 146,A01,202655,Staff,14,0,25,11
1683639986257,ENG 15,A00,185667,Staff,0,1,0,0
1683639986257,ENG 15,B00,185672,Staff,0,0,0,0
1683639986257,ENG 15,C00,185675,Staff,0,0,0,0
1683639986257,ENG 15,D00,185682,Staff,0,0,0,0
1683639986257,ENG 15,E00,185684,Staff,0,0,0,0
1683639987285,ETHN 103,A00,185710,Staff,0,8,35,35
1683639988311,ETHN 103A,A00,199228,Man; Simeon S,0,0,9,9
1683639989338,ETHN 109,A00,185711,Staff,16,0,35,19
1683639990370,ETHN 142,A00,185726,Staff,0,4,30,30
1683639991456,ETHN 163J,A00,199229,Man; Simeon S,5,0,8,3
1683639992484,ETHN 168,A00,185727,Staff,7,0,10,3
1683639993513,ETHN 182,A00,185728,Staff,0,0,35,35
1683639994541,ETHN 183,A00,185737,Staff,9,0,18,9
1683639995568,GLBH 111,A01,209361,Burgos; Jose L.,0,0,0,0
1683639997625,HIEU 104,A00,185792,Staff,14,0,20,6
1683639998653,HIEU 115,A00,185800,Staff,0,0,20,20
1683639999678,HIEU 128,A00,185801,Staff,0,9,20,20
1683640000701,HIEU 147,A00,185802,Staff,15,0,20,5
1683640001726,HIEU 154,A00,185823,Staff,11,0,20,9
1683640002753,HILA 102,A00,185826,Staff,14,0,20,6
1683640003778,HILD 2C,A01,185778,Staff,0,13,20,20
1683640004807,HILD 7B,A01,185780,Kwak; Nancy,0,16,32,32
1683640004807,HILD 7B,A02,185781,Kwak; Nancy,0,18,32,32
1683640005835,HILD 30,A01,185791,Staff,12,0,20,8
1683640006862,HISC 119,A00,185830,Golan; Tal,0,9,20,20
1683640007887,HITO 156GS,A00,185831,Patterson; Patrick H.,0,0,0,23
1683640008916,HIUS 103,A00,185832,Man; Simeon S,0,4,20,20
1683640009943,HIUS 117,A00,185836,Kwak; Nancy,2,0,20,18
1683640010971,HIUS 125,A00,185840,Man; Simeon S,0,1,23,23
1683640011999,HIUS 149,A00,185845,Staff,1,0,20,19
1683640013032,HUM 3,A01,185882,Zavodny; Tatiana Sophia,0,7,50,50
1683640013032,HUM 3,B01,185899,Caldwell; Michael Alan,0,18,50,50
1683640014057,HUM 3GS,A00,185900,Patterson; Patrick H.,0,0,0,23
1683640015084,HUM 4,A01,185938,Zroka; Amy Liane,30,0,50,20
1683640015084,HUM 4,B01,185956,Watkins; Eric,0,4,50,50
1683640015084,HUM 4,B02,202209,Watkins; Eric,0,4,50,50
1683640015084,HUM 4,B03,202210,Watkins; Eric,0,4,50,50
1683640016110,HUM 5,A01,185958,West; Geoffrey Scott,2,0,50,48
1683640016110,HUM 5,A02,202215,West; Geoffrey Scott,0,0,50,50
1683640017136,INTL 190,A00,185959,Gagnon; Jeffrey C,0,0,0,9
1683640017136,INTL 190,B00,185960,Lettieri; Michael Joseph,0,0,0,2
1683640018163,JAPN 180,A00,254509,Staff,5,0,30,25
1683640019190,LATI 10,A01,202853,Kennemore; Amy Michelle,4,0,35,31
1683640019190,LATI 10,A02,202854,Kennemore; Amy Michelle,2,0,35,33
1683640019190,LATI 10,A03,270054,Kennemore; Amy Michelle,30,0,30,0
1683640020216,LATI 180,A00,202855,Kennemore; Amy Michelle,11,0,20,9
1683640021257,LAWS 101,A00,201767,Golan; Tal,0,7,40,40
1683640022282,LIFR 1C,A00,185961,Staff,6,0,20,14
1683640023308,LIFR 1CX,A00,185962,Staff,7,0,20,13
1683640024335,LIFR 1D,A00,185963,Staff,7,0,20,13
1683640025363,LIFR 1DX,A00,185964,Staff,7,0,20,13
1683640026390,LIGN 101,A01,186039,Staff,43,0,50,7
1683640027417,LIGN 165,A00,186040,Staff,15,0,50,35
1683640028442,LTCS 108,A00,186041,Staff,5,0,10,5
1683640029469,LTCS 119,A00,186042,Staff,15,0,20,5
1683640030494,LTCS 130,A00,186043,Wesling; Megan E.,15,0,25,10
1683640032543,LTEA 138,A00,186119,Staff,14,0,40,26
1683640033572,LTEN 124,A00,186148,Staff,5,0,25,20
1683640034598,LTEN 178,A00,186149,Staff,7,0,15,8
1683640035625,LTEN 181,A00,186150,Blanco; John D,34,0,40,6
1683640036653,LTWL 120,A00,186160,Staff,20,0,25,5
1683640037679,LTWL 165,A00,186161,Staff,22,0,25,3
1683640038707,LTWR 100,A00,186162,Staff,0,5,15,15
1683640039733,LTWR 102,A00,186163,Doller; Ben,5,0,15,10
1683640040761,MAE 8,A01,186412,Staff,0,0,0,0
1683640041786,MAE 30B,A00,186445,Bahadori; Mohammad Yousef,82,0,100,18
1683640042811,MAE 40,A00,186592,Bewley; Thomas R,10,0,50,40
1683640043837,MAE 101B,A00,186593,Bahadori; Mohammad Yousef,80,0,100,20
1683640044863,MAE 105,A00,186594,Bandaru; Prabhakar,10,0,50,40
1683640045890,MAE 107,A00,186599,Pham; Hieu Tan,0,7,120,120
1683640046918,MAE 148,A01,186660,Silberman; Jack,3,0,16,13
1683640047951,MATH 10A,A01,188095,Staff,0,5,35,35
1683640048979,MATH 10B,A01,188097,Bowers; Adam R.,0,11,30,30
1683640048979,MATH 10B,A02,188099,Bowers; Adam R.,0,11,30,30
1683640048979,MATH 10B,B01,188104,Bowers; Adam R.,0,10,30,30
1683640048979,MATH 10B,B02,188106,Bowers; Adam R.,1,9,30,29
1683640050007,MATH 10C,A01,188111,Staff,0,18,30,30
1683640050007,MATH 10C,A02,188127,Staff,0,19,30,30
1683640050007,MATH 10C,A03,188131,Staff,0,19,30,30
1683640050007,MATH 10C,B01,188218,Staff,17,0,30,13
1683640050007,MATH 10C,B02,188244,Staff,13,0,30,17
1683640050007,MATH 10C,B03,188277,Staff,14,0,30,16
1683640051034,MATH 18,A01,188344,Bach; Quang Tran,18,0,30,12
1683640051034,MATH 18,A02,188345,Bach; Quang Tran,11,0,30,19
1683640051034,MATH 18,B01,188353,Bach; Quang Tran,11,0,30,19
1683640051034,MATH 18,B02,188354,Bach; Quang Tran,19,0,30,11
1683640052059,MATH 20A,A01,188374,Staff,11,0,35,24
1683640053091,MATH 20B,A01,188382,Ohm; Ko Woon,7,0,30,23
1683640053091,MATH 20B,A02,188383,Ohm; Ko Woon,22,0,30,8
1683640053091,MATH 20B,B01,188385,Ohm; Ko Woon,7,0,30,23
1683640053091,MATH 20B,B02,188392,Ohm; Ko Woon,22,0,30,8
1683640054118,MATH 20C,A01,188394,Harel; Guershon,11,0,30,19
1683640054118,MATH 20C,A02,188395,Harel; Guershon,14,0,30,16
1683640054118,MATH 20C,B01,188404,Harel; Guershon,4,0,30,26
1683640054118,MATH 20C,B02,188405,Harel; Guershon,18,0,30,12
1683640055150,MATH 20D,A01,188414,Hammock; Frances H,0,1,30,30
1683640055150,MATH 20D,A02,188415,Hammock; Frances H,0,1,30,30
1683640055150,MATH 20D,B01,188447,Hammock; Frances H,0,1,30,30
1683640055150,MATH 20D,B02,188486,Hammock; Frances H,4,0,30,26
1683640056175,MATH 20E,A01,188649,Staff,21,0,30,9
1683640056175,MATH 20E,A02,188650,Staff,21,0,30,9
1683640056175,MATH 20E,A03,188673,Staff,0,0,30,30
1683640057203,MATH 102,A01,188675,Staff,0,36,35,35
1683640058233,MATH 103B,A01,188681,Staff,3,0,35,32
1683640058233,MATH 103B,B01,188692,Staff,5,0,35,30
1683640059264,MATH 109,A01,188695,Salehi Golsefidy; Alireza,24,0,35,11
1683640059264,MATH 109,A02,188696,Salehi Golsefidy; Alireza,25,0,35,10
1683640060289,MATH 120A,A01,188698,Eggers; John Dietrich,7,0,35,28
1683640061313,MATH 142B,A01,188736,Ioana; Adrian,0,1,30,30
1683640061313,MATH 142B,A02,188741,Ioana; Adrian,0,1,30,30
1683640061313,MATH 142B,A03,188743,Ioana; Adrian,0,1,30,30
1683640062342,MATH 168A,A01,188790,Staff,0,10,35,35
1683640063370,MATH 170A,A01,188803,Nie; Jiawang,0,2,35,35
1683640063370,MATH 170A,A02,188811,Nie; Jiawang,0,0,35,35
1683640063370,MATH 170A,A03,188814,Nie; Jiawang,0,0,35,35
1683640063370,MATH 170A,A04,188815,Nie; Jiawang,10,0,35,25
1683640064395,MATH 193B,A01,188817,Staff,0,0,35,35
1683640064395,MATH 193B,A02,188818,Staff,5,0,35,30
1683640065421,MGT 4,A01,202857,Anderson; John Charles,61,0,80,19
1683640066450,MGT 12,A00,202858,Lindenberger; Wade Douglas,40,0,90,50
1683640067473,MGT 18,A00,202859,Staff,74,0,90,16
1683640068501,MGT 18GS,A00,202860,McKay; Michael J,13,0,28,15
1683640069529,MGT 45,A00,202861,Pecore; Joseph P.,12,0,90,78
1683640070554,MGT 100,A00,202863,Yavorsky; Daniel Ryan,28,0,90,62
1683640071580,MGT 103,A00,202864,Ehrich; Kristine R,0,17,90,90
1683640072605,MGT 112,A00,202865,Ehrich; Kristine R,15,0,90,75
1683640073635,MGT 121A,A00,202868,Staff,0,20,0,0
1683640074661,MGT 131B,A00,202869,Anderson; John Charles,59,0,90,31
1683640075686,MGT 136,A00,202871,Lindenberger; Wade Douglas,83,0,90,7
1683640076714,MGT 164,A00,202873,Staff,0,66,90,91
1683640077741,MGT 164GS,A00,202874,McKay; Mary A,13,0,28,15
1683640078769,MGT 180,A00,202875,Staff,0,50,90,91
1683640079797,MMW 11R,A01,205019,Herbst; Matthew,2,0,30,28
1683640079797,MMW 11R,A02,205026,Herbst; Matthew,29,0,30,1
1683640080825,MMW 15,A01,193512,Chang; Edmond Yi-Teh,0,8,28,28
1683640080825,MMW 15,A02,193513,Chang; Edmond Yi-Teh,0,5,28,28
1683640080825,MMW 15,A03,193514,Chang; Edmond Yi-Teh,0,5,28,28
1683640080825,MMW 15,A04,193515,Chang; Edmond Yi-Teh,0,5,28,28
1683640080825,MMW 15,A05,193516,Chang; Edmond Yi-Teh,0,5,28,28
1683640080825,MMW 15,A06,193517,Chang; Edmond Yi-Teh,0,6,28,28
1683640080825,MMW 15,B01,193519,Chang; Edmond Yi-Teh,0,5,28,28
1683640080825,MMW 15,B02,193520,Chang; Edmond Yi-Teh,0,5,28,28
1683640080825,MMW 15,B03,193521,Chang; Edmond Yi-Teh,0,5,28,28
1683640080825,MMW 15,B04,193522,Chang; Edmond Yi-Teh,0,5,28,28
1683640080825,MMW 15,B05,193523,Chang; Edmond Yi-Teh,0,5,28,28
1683640080825,MMW 15,B06,193524,Chang; Edmond Yi-Teh,0,5,28,28
1683640081854,MMW 122,A01,193526,Rahimi; Babak,0,16,28,28
1683640081854,MMW 122,A02,193527,Rahimi; Babak,0,15,28,28
1683640081854,MMW 122,A03,193528,Rahimi; Babak,0,0,0,0
1683640081854,MMW 122,A04,193529,Rahimi; Babak,0,0,0,0
1683640082879,MUS 1A,A01,186663,Staff,1,20,35,34
1683640083908,MUS 4,A01,186715,Staff,0,12,35,35
1683640084940,MUS 5R,A01,186796,Dubnov; Shlomo,0,17,35,35
1683640085967,MUS 6,A01,186798,Staff,0,5,25,25
1683640086995,MUS 7,A01,186830,Staff,11,0,35,24
1683640088024,MUS 8,A01,186930,Staff,0,26,35,35
1683640089052,MUS 15,A01,186932,Staff,0,16,35,35
1683640089052,MUS 15,B01,186934,Staff,0,17,35,35
1683640090080,MUS 80,A00,186935,Staff,0,0,20,20
1683640090080,MUS 80,B00,186936,Staff,24,0,25,1
1683640091110,NANO 11,A00,204702,Lipomi; Darren John,0,0,0,0
1683640092141,NANO 15,A01,204709,Yang; Kesong,0,1,0,0
1683640093169,NANO 114,A00,202069,Jahed Motlagh; Zeinab,3,0,10,7
1683640094193,PHIL 1,A00,186955,Grush; Rick Scott,31,0,40,9
1683640095274,PHIL 10,A01,186973,Grush; Rick Scott,27,0,35,8
1683640095274,PHIL 10,A02,186974,Grush; Rick Scott,33,0,35,2
1683640096301,PHIL 13,A01,186976,Staff,3,0,35,32
1683640096301,PHIL 13,A02,186977,Staff,16,0,35,19
1683640097326,PHIL 14,A01,186979,Staff,31,0,35,4
1683640097326,PHIL 14,A02,186986,Staff,32,0,35,3
1683640098353,PHIL 28,A01,186988,Staff,16,0,30,14
1683640098353,PHIL 28,A02,186989,Staff,1,0,30,29
1683640098353,PHIL 28,A03,186990,Staff,10,0,30,20
1683640098353,PHIL 28,A04,186991,Staff,26,0,30,4
1683640099376,PHIL 120,A00,186997,Staff,23,0,40,17
1683640100406,PHIL 137,A00,187003,Staff,7,0,40,33
1683640101434,PHIL 150,A00,187015,Staff,47,0,70,23
1683640102457,PHIL 167,A00,187021,Lamey; Andy M.,34,0,40,6
1683640103483,PHIL 174,A01,202226,Staff,17,0,20,3
1683640103483,PHIL 174,A02,202235,Staff,20,0,20,0
1683640104516,PHIL 191A,A00,258918,Staff,0,0,1,1
1683640105546,PHYS 1A,A00,187028,Staff,27,0,60,33
1683640106572,PHYS 1AL,001,187036,Staff,3,0,30,27
1683640106572,PHYS 1AL,002,187049,Staff,18,0,30,12
1683640107599,PHYS 1B,A00,187058,Staff,22,0,60,38
1683640108624,PHYS 1BL,001,187064,Staff,0,1,30,30
1683640108624,PHYS 1BL,002,187070,Staff,4,0,30,26
1683640109649,PHYS 1C,A00,187082,Staff,29,0,120,91
1683640110675,PHYS 1CL,001,187088,Staff,0,9,30,30
1683640110675,PHYS 1CL,002,187089,Staff,0,1,30,30
1683640110675,PHYS 1CL,009,262693,Staff,9,0,30,21
1683640111700,PHYS 2B,A01,187097,Staff,55,0,115,60
1683640112726,PHYS 2C,A01,187099,Staff,64,0,115,51
1683640113752,PHYS 2CL,A01,187101,Staff,5,0,28,23
1683640113752,PHYS 2CL,A02,187102,Staff,15,0,28,13
1683640114777,PHYS 2D,A01,187123,Shotwell; Brian,95,0,115,20
1683640115802,PHYS 4B,A01,187133,Grinstein; Benjamin,35,0,50,15
1683640116827,POLI 10,A00,188819,Staff,0,4,50,50
1683640117853,POLI 11,A00,188827,Staff,43,0,50,7
1683640118878,POLI 13R,A00,188828,Staff,0,1,20,20
1683640119910,POLI 27,A01,188830,Elgin; Samuel Zincke,0,2,70,70
1683640120940,POLI 30,A00,188832,Desposato; Scott,30,0,50,20
1683640121967,POLI 102F,A00,188834,Staff,0,0,40,40
1683640122995,POLI 104A,A00,188852,Staff,13,0,30,17
1683640124025,POLI 104I,A00,188853,Staff,0,7,20,20
1683640125051,POLI 110B,A00,188854,Wiens; David,7,0,20,13
1683640126076,POLI 112A,A00,188855,Wiens; David,4,0,30,26
1683640127101,POLI 117R,A00,188856,Forman; Fonna,0,12,20,20
1683640128131,POLI 118,A00,188857,Ingham; Sean,8,0,20,12
1683640129157,POLI 120G,A00,188858,Staff,8,0,30,22
1683640130182,POLI 131CR,A00,188863,Hoston; Germaine,21,0,50,29
1683640131207,POLI 133,A00,188864,Nellis; Gareth Hb,44,0,50,6
1683640132239,POLI 134D,A00,188865,Desposato; Scott,27,0,30,3
1683640133269,POLI 142A,A00,188871,Gartzke; Erik,21,0,50,29
1683640134297,POLI 142K,A00,188874,Staff,38,0,50,12
1683640135325,POLI 143,A00,188940,Gartzke; Erik,16,0,30,14
1683640136351,POLI 153,A00,188943,Staff,2,0,20,18
1683640137376,POLI 160AA,A00,188944,Staff,11,0,40,29
1683640138401,POLI 170A,A00,188945,Staff,11,0,30,19
1683640140450,PSYC 1,A00,188952,Staff,36,0,90,54
1683640141475,PSYC 2,B00,188953,Staff,19,0,35,16
1683640142503,PSYC 6,A00,188970,Staff,47,0,60,13
1683640143532,PSYC 7,A00,188973,Staff,35,0,45,10
1683640144566,PSYC 60,A01,188980,Rickard; Timothy C.,42,0,60,18
1683640145595,PSYC 70,A01,189001,Steiner; Eric Tomas,23,0,45,22
1683640146626,PSYC 100,A00,189005,Lacefield; Katharine I,0,99,120,120
1683640147649,PSYC 102,A00,189008,Staff,8,0,30,22
1683640148676,PSYC 106,B00,189026,Gorman; Michael R.,27,0,60,33
1683640149702,PSYC 114,B01,189033,Winkielman; Piotr,0,31,30,30
1683640150732,PSYC 131,A00,189036,Anagnostaras; Stephan,0,43,60,60
1683640151757,PSYC 136,A00,189041,Lowe; Angela Beth,0,7,25,25
1683640152783,PSYC 137,A00,189057,Winkielman; Piotr,0,37,25,25
1683640153820,PSYC 144,A00,189107,Wixted; John T,0,10,50,50
1683640155880,PSYC 162,A00,189142,Staff,0,9,85,85
1683640156905,PSYC 172,A00,189144,Gorman; Michael R.,0,6,30,30
1683640158955,PSYC 179,A00,189146,Lacefield; Katharine I,0,86,120,120
1683640159981,PSYC 181,A00,189147,Anagnostaras; Stephan,0,44,90,90
1683640161007,PSYC 190R,A00,189148,Barner; David A.,0,23,80,80
1683640162035,PSYC 191,A00,189275,Rickard; Timothy C.,0,10,25,25
1683640163065,PSYC 193,A00,189276,Chapman; Eddie Nathaniel,0,1,0,4
1683640164091,PSYC 193L,A01,189281,Lowe; Angela Beth,10,0,20,10
1683640164091,PSYC 193L,B01,189285,Staff,28,0,35,7
1683640165119,RELI 149,A00,187137,Rahimi; Babak,7,0,40,33
1683640166148,SE 9,A01,187315,Staff,0,2,18,18
1683640167176,SE 101B,A00,187409,Staff,24,0,30,6
1683640168199,SE 110B,A00,187444,Staff,10,0,40,30
1683640169225,SE 130B,A00,187449,Staff,31,0,40,9
1683640170255,SE 150A,A00,187516,Staff,9,0,20,11
1683640171282,SE 154,A00,187528,Staff,29,0,50,21
1683640172312,SIO 3,A01,258171,Staff,35,0,40,5
1683640173339,SIO 10,A00,187144,Cook; Geoffrey W,0,6,75,75
1683640174364,SIO 45,A00,187152,Cook; Geoffrey W,0,4,100,100
1683640175394,SIO 109R,A00,194486,Staff,0,4,20,20
1683640177442,SIO 187,A01,187233,Kacev; David,12,0,40,28
1683640178469,SOCI 1,A01,258656,Thorpe; Charles Robert,28,0,30,2
1683640178469,SOCI 1,A02,258658,Thorpe; Charles Robert,30,0,30,0
1683640178469,SOCI 1,A03,258661,Thorpe; Charles Robert,25,0,25,0
1683640178469,SOCI 1,A04,258666,Thorpe; Charles Robert,22,0,25,3
1683640178469,SOCI 1,A05,258897,Thorpe; Charles Robert,22,0,25,3
1683640178469,SOCI 1,A06,258898,Thorpe; Charles Robert,25,0,25,0
1683640179494,SOCI 30,A01,258903,Pardo Guerra; Juan Pablo,14,0,30,16
1683640180521,SOCI 102,A00,258904,Staff,9,0,25,16
1683640181546,SOCI 106,A00,258905,Staff,19,0,25,6
1683640182574,SOCI 111,A00,258907,Ribas Norris; Janet Vanesa,26,0,30,4
1683640183601,SOCI 121R,A00,258908,Pardo Guerra; Juan Pablo,8,0,30,22
1683640184629,SOCI 126,A01,203330,Staff,14,0,20,6
1683640185654,SOCI 131,A00,258909,Thorpe; Charles Robert,30,0,60,30
1683640186686,SOCI 135,A00,258910,Payne; Christine Anna,0,11,30,30
1683640187712,SOCI 157,A00,258911,Staff,12,0,30,18
1683640188743,SOCI 184,A00,258912,Staff,25,0,30,5
1683640189767,SOCI 188D,A00,258913,Staff,22,0,30,8
1683640190793,SYN 2,001,187529,Staff,9,0,16,7
1683640190793,SYN 2,002,201452,Staff,0,20,16,16
1683640190793,SYN 2,003,201469,Staff,2,0,16,14
1683640191818,SYN 100,A01,187531,Staff,0,9,20,20
1683640191818,SYN 100,B01,201491,Staff,0,10,20,20
1683640192844,TDAC 1,A00,189286,Walsh; Kim C.,3,0,20,17
1683640192844,TDAC 1,B00,189287,Harting; Carla Kelso,10,0,20,10
1683640193871,TDAC 101,A00,189300,Walsh; Kim C.,16,0,20,4
1683640193871,TDAC 101,B00,189301,Harting; Carla Kelso,18,0,20,2
1683640194899,TDAC 102,A00,189304,Basso; Beatrice,14,0,20,6
1683640195922,TDAC 108,A00,189305,Staff,18,0,20,2
1683640196953,TDDE 131,A00,189310,Staff,19,0,20,1
1683640196953,TDDE 131,B00,189314,Staff,19,0,20,1
1683640196953,TDDE 131,C00,189315,Staff,48,0,50,2
1683640196953,TDDE 131,D00,189316,Staff,14,0,15,1
1683640196953,TDDE 131,E00,204841,Staff,20,0,20,0
1683640197978,TDGE 10,A00,189289,Staff,27,0,50,23
1683640197978,TDGE 10,B00,189290,Havis; Allan,0,0,50,50
1683640199059,TDGE 11,A00,189291,Fulton; Julia,0,4,50,50
1683640199059,TDGE 11,B00,189292,Staff,20,0,25,5
1683640199059,TDGE 11,C00,260270,Staff,0,0,0,0
1683640200083,TDGE 25,A00,189294,Staff,2,0,20,18
1683640201109,TDGE 124,A00,189318,Fulton; Julia,0,8,50,50
1683640202133,TDGE 125,A00,189319,Staff,13,0,25,12
1683640202133,TDGE 125,B00,189320,Staff,23,0,25,2
1683640203158,TDGE 127,A00,189322,Havis; Allan,0,0,50,50
1683640204188,TDHT 101,A00,189323,Staff,18,0,25,7
1683640204188,TDHT 101,B00,189324,Staff,25,0,25,0
1683640205212,TDHT 102,A00,189325,Staff,49,0,50,1
1683640206237,TDMV 1,A00,189295,Arcidiacono; Kristin,20,0,30,10
1683640206237,TDMV 1,B00,189296,Caligagan; Maria T.,24,0,30,6
1683640207261,TDMV 2,A00,189297,Sammartano; Tonnie,27,0,30,3
1683640207261,TDMV 2,B00,189299,Arcidiacono; Kristin,23,0,30,7
1683640208291,TDMV 3,A00,204998,Rincon; Alicia,22,0,30,8
1683640209315,TDMV 120,A00,189458,Sammartano; Tonnie,28,0,30,2
1683640210344,TDMV 138,A00,189541,Jun; Grace Shin Hae,20,0,40,20
1683640211373,TDMV 142,A00,189717,Caligagan; Tony,25,0,30,5
1683640211373,TDMV 142,B00,189718,Caligagan; Maria T.,25,0,30,5
1683640212398,TMC 2,A01,187533,Staff,25,0,25,0
1683640212398,TMC 2,A02,187534,Staff,25,0,25,0
1683640213423,USP 1,A01,187536,Kwak; Nancy,0,16,25,25
1683640214448,USP 5,A01,187538,Staff,9,0,25,16
1683640215473,USP 101,A00,199253,Staff,0,4,0,0
1683640216498,USP 124,A00,187562,Boomhower; Matthew Charles,0,0,30,30
1683640217527,USP 138,A00,187582,Staff,20,0,25,5
1683640218551,USP 152,A01,187597,Staff,3,0,25,22
1683640219574,USP 153,A00,187598,Staff,19,0,25,6
1683640220604,USP 168,A00,187607,Kwak; Nancy,2,0,5,3
1683640221633,USP 173,A00,187619,Staff,4,0,25,21
1683640222657,USP 181,A00,187638,Staff,0,4,25,25
1683640223689,VIS 103,A00,187650,Cruz; Edwin Teddy,18,0,75,57
1683640224714,VIS 110D,A00,187669,Staff,13,0,22,9
1683640225744,VIS 127C,A00,187720,Shen; Kuiyi,67,0,146,79
1683640226770,VIS 149,A00,187731,Yoldas; Pinar,0,14,22,22
1683640227806,VIS 151,A01,188091,Staff,22,0,34,12
1683640227806,VIS 151,A02,188092,Staff,11,0,34,23
1683640228829,VIS 160B,A00,188093,Stalbaum; Brett,0,1,10,10
1683640230878,WCWP 10B,A00,201720,Staff,10,0,15,5
1683640230878,WCWP 10B,B00,201722,Staff,9,0,15,6
1683640231903,WCWP 100,A00,201725,Gagnon; Jeffrey C,0,0,2,2
1683640231903,WCWP 100,B00,201727,Staff,0,4,15,15
1683640235004,ANBI 133,A00,258401,Wilder; Linnea Lorene,34,0,40,6
1683640236027,ANBI 140,A00,258395,Hrvoj Mihic; Branka,18,0,25,7
1683640237051,ANSC 120,A00,258402,Bialecki; Jon Anthony,27,0,40,13
1683640238076,ANSC 144,A00,258400,Staff,12,0,40,28
1683640240125,ANSC 166,A00,258396,Parish; Steven Martin,156,0,175,19
1683640241152,ANSC 180,A00,193533,Staff,8,0,20,12
1683640242178,ANSC 188,A00,258397,Jassal; Aftab,34,0,40,6
1683640243204,ANTH 3,A01,258316,Staff,23,0,30,7
1683640244229,ANTH 5,A00,258394,Semendeferi; Ekaterini,16,0,20,4
1683640245254,ANTH 21,A01,258331,Staff,4,0,40,36
1683640246282,ANTH 103,A00,258398,Varma; Saiba,15,0,25,10
1683640247313,AWP 10,001,202034,Staff,0,0,0,0
1683640247313,AWP 10,002,202035,Staff,0,0,0,0
1683640247313,AWP 10,003,202036,Staff,0,0,0,0
1683640247313,AWP 10,004,202037,Staff,0,0,0,0
1683640247313,AWP 10,005,202038,Staff,0,0,0,0
1683640247313,AWP 10,006,202039,Staff,0,0,0,0
1683640247313,AWP 10,007,202040,Staff,0,0,0,0
1683640247313,AWP 10,008,202041,Staff,0,0,0,0
1683640247313,AWP 10,009,202042,Staff,0,0,0,0
1683640247313,AWP 10,010,202043,Staff,0,0,0,0
1683640247313,AWP 10,011,202044,Staff,0,0,0,0
1683640247313,AWP 10,012,202045,Staff,0,0,0,0
1683640247313,AWP 10,013,202046,Staff,0,0,0,0
1683640247313,AWP 10,014,202047,Staff,0,0,0,0
1683640247313,AWP 10,015,202048,Staff,0,0,0,0
1683640247313,AWP 10,016,202049,Staff,0,0,0,0
1683640247313,AWP 10,017,202050,Staff,0,0,0,0
1683640247313,AWP 10,018,202051,Staff,0,0,0,0
1683640247313,AWP 10,019,202052,Staff,0,0,0,0
1683640247313,AWP 10,020,202053,Staff,0,0,0,0
1683640247313,AWP 10,021,202054,Staff,0,0,0,0
1683640247313,AWP 10,022,202055,Staff,0,0,0,0
1683640247313,AWP 10,023,202056,Staff,0,0,0,0
1683640247313,AWP 10,024,202057,Staff,0,0,0,0
1683640247313,AWP 10,025,202058,Staff,0,0,0,0
1683640247313,AWP 10,026,202059,Staff,0,0,0,0
1683640248338,AWP 102,001,202032,Staff,0,0,0,0
1683640248338,AWP 102,002,202033,Staff,0,0,0,0
1683640249367,BENG 100,A01,254234,Taylor Amos; Alyssa C,31,0,40,9
1683640250392,BENG 196,001,270013,Engler; Adam J.,9999,0,9999,0
1683640251419,BICD 100R,A01,202018,Smith; Laurie,0,7,32,32
1683640251419,BICD 100R,A02,202019,Smith; Laurie,0,3,32,32
1683640251419,BICD 100R,A03,202020,Smith; Laurie,0,1,32,32
1683640251419,BICD 100R,A04,202021,Smith; Laurie,6,0,32,26
1683640251419,BICD 100R,A05,202022,Smith; Laurie,11,0,32,21
1683640252445,BICD 136,A01,193242,Gustafson-Brown; Cindy,0,2,32,32
1683640252445,BICD 136,A02,193244,Gustafson-Brown; Cindy,13,0,32,19
1683640253477,BIEB 102,A01,193249,Butler; Shannon Rhey,0,2,32,32
1683640253477,BIEB 102,A02,193251,Butler; Shannon Rhey,0,0,32,32
1683640253477,BIEB 102,A03,193253,Butler; Shannon Rhey,0,0,32,32
1683640253477,BIEB 102,A04,193255,Butler; Shannon Rhey,14,0,32,18
1683640253477,BIEB 102,A05,193265,Butler; Shannon Rhey,26,0,32,6
1683640253477,BIEB 102,A06,193269,Butler; Shannon Rhey,14,0,32,18
1683640255532,BIEB 150,A01,193274,Staff,0,0,32,32
1683640255532,BIEB 150,A02,193285,Staff,24,0,32,8
1683640256557,BIEB 194,A00,193286,Kurle; Carolyn M.,20,0,32,12
1683640257589,BILD 1,A01,192291,Staff,15,0,32,17
1683640257589,BILD 1,A02,192292,Staff,30,0,32,2
1683640257589,BILD 1,B01,192520,Reuther; Keefe,0,1,0,0
1683640257589,BILD 1,B02,192532,Reuther; Keefe,0,1,0,0
1683640258615,BILD 3,A01,192556,Butler; Shannon Rhey,0,0,32,32
1683640258615,BILD 3,A02,192581,Butler; Shannon Rhey,1,0,32,31
1683640258615,BILD 3,A03,192611,Butler; Shannon Rhey,21,0,32,11
1683640258615,BILD 3,A04,192612,Butler; Shannon Rhey,24,0,32,8
1683640258615,BILD 3,A05,192613,Butler; Shannon Rhey,26,0,32,6
1683640258615,BILD 3,A06,192679,Butler; Shannon Rhey,27,0,32,5
1683640258615,BILD 3,A07,192682,Butler; Shannon Rhey,20,0,32,12
1683640259644,BILD 4,A01,192836,Reuther; Keefe,0,0,24,24
1683640259644,BILD 4,A02,193044,Reuther; Keefe,4,0,24,20
1683640260669,BILD 10,A01,193142,Gustafson-Brown; Cindy,29,0,32,3
1683640260669,BILD 10,A02,193149,Gustafson-Brown; Cindy,31,0,32,1
1683640261692,BIMM 100,A01,193301,Staff,0,6,32,32
1683640261692,BIMM 100,A02,193312,Staff,0,7,32,32
1683640261692,BIMM 100,A03,193323,Staff,0,9,32,32
1683640262720,BIMM 101,A01,193329,McDonnell; Lisa Marie,0,4,24,24
1683640262720,BIMM 101,A02,193339,McDonnell; Lisa Marie,0,3,24,24
1683640262720,BIMM 101,B01,193354,McDonnell; Lisa Marie,0,4,24,24
1683640262720,BIMM 101,B02,193357,McDonnell; Lisa Marie,0,2,24,24
1683640263743,BIMM 110,A01,193377,Tat; John,0,11,32,32
1683640263743,BIMM 110,A02,193378,Tat; John,0,10,32,32
1683640264768,BIMM 120,A01,206116,Staff,0,0,32,32
1683640264768,BIMM 120,A02,206117,Staff,6,0,32,26
1683640264768,BIMM 120,A03,206121,Staff,21,0,32,11
1683640265797,BIPN 100,A01,193393,Park; Ji Young,0,14,32,32
1683640265797,BIPN 100,A02,193402,Park; Ji Young,0,14,32,32
1683640265797,BIPN 100,A03,193413,Park; Ji Young,0,14,32,32
1683640265797,BIPN 100,A04,193414,Park; Ji Young,0,13,32,32
1683640266825,BIPN 102,A01,193429,Staff,0,0,32,32
1683640266825,BIPN 102,A02,193438,Staff,18,0,32,14
1683640267850,BIPN 106,A01,193450,Reyes Gonzalez; Catalina,0,2,40,40
1683640268877,BIPN 134,A01,193465,Cooke; James Edward,0,0,32,32
1683640268877,BIPN 134,A02,193474,Cooke; James Edward,25,0,32,7
1683640268877,BIPN 134,A03,193485,Cooke; James Edward,29,0,32,3
1683640268877,BIPN 134,A04,193486,Cooke; James Edward,20,0,32,12
1683640268877,BIPN 134,A05,193491,Cooke; James Edward,31,0,32,1
1683640268877,BIPN 134,A06,193501,Cooke; James Edward,30,0,32,2
1683640268877,BIPN 134,A07,193510,Cooke; James Edward,29,0,32,3
1683640270926,BISP 194,A00,222522,Staff,14,0,32,18
1683640271950,CAT 124,A01,202407,Staff,19,0,25,6
1683640272975,CAT 125,A00,202408,Marchisotto; Jennifer Anne,2,0,20,18
1683640274005,CAT 125R,A00,202409,Smith; Lauryn Alissa,0,11,20,20
1683640274005,CAT 125R,B00,202410,Morales; Celeste Georgianna,0,11,20,20
1683640274005,CAT 125R,C00,202411,Irwin; Matthew Joseph,0,12,20,20
1683640275036,CENG 15,A01,204712,Yang; Kesong,0,1,0,0
1683640276063,CENG 114,A00,202070,Jahed Motlagh; Zeinab,5,0,20,15
1683640277091,CGS 105,A00,185477,Wesling; Megan E.,24,0,40,16
1683640278119,CGS 106,A00,185494,Staff,11,0,22,11
1683640279146,CGS 108,A00,185495,Staff,14,0,20,6
1683640280172,CGS 114,A00,185496,Staff,13,0,18,5
1683640281203,CGS 119,A00,185501,Staff,15,0,20,5
1683640282229,CGS 120,A00,185511,Staff,12,0,20,8
1683640283258,CHEM 4,A01,184675,Bussey; Thomas J,97,0,100,3
1683640284290,CHEM 6A,A01,184677,Staff,33,0,60,27
1683640285315,CHEM 6B,A01,184679,Staff,63,0,100,37
1683640286340,CHEM 6C,A01,184681,Bussey; Thomas J,0,0,50,50
1683640286340,CHEM 6C,A02,184682,Bussey; Thomas J,32,0,50,18
1683640287364,CHEM 40A,A01,184684,Albizati; Kim F.,35,0,100,65
1683640288388,CHEM 40B,A01,184686,Albizati; Kim F.,0,22,100,100
1683640289414,CHEM 41B,A01,184690,Staff,51,0,100,49
1683640290471,COGS 3,A01,184715,Boyle; Mary E. T.,0,27,40,40
1683640291497,COGS 14B,A01,185172,Staff,0,14,38,38
1683640292527,COGS 18,A01,184736,Staff,15,0,80,65
1683640293553,COGS 100,A01,184932,Staff,0,7,73,73
1683640294578,COGS 101A,A01,184935,Staff,0,39,30,30
1683640295602,COGS 101B,A01,184944,Staff,0,2,30,30
1683640296628,COGS 101C,A01,184946,Staff,0,10,30,30
1683640297655,COGS 102A,A01,184951,Johnson; Christine M.,2,0,40,38
1683640298683,COGS 107B,A01,184953,Mooshagian; Eric Frederick,0,51,40,40
1683640299708,COGS 118B,A01,184959,Gupta; Anjum,0,49,40,40
1683640300731,COGS 153,A00,184961,Staff,0,16,30,30
1683640301758,COGS 177,A00,184962,Staff,0,21,30,30
1683640302839,COGS 187A,A01,184969,Boyle; Mary E. T.,0,19,40,40
1683640303864,COMM 10,A01,185174,Staff,0,5,25,25
1683640303864,COMM 10,A02,185189,Staff,0,2,25,25
1683640303864,COMM 10,A03,269821,Staff,0,1,0,0
1683640304893,COMM 100B,A01,185475,Staff,0,1,0,2
1683640304893,COMM 100B,A02,185476,Staff,12,0,25,13
1683640305919,COMM 100C,A01,185314,Staff,1,0,25,24
1683640305919,COMM 100C,A02,185327,Staff,18,0,25,7
1683640306944,COMM 110M,A00,185349,Staff,0,0,40,40
1683640307969,COMM 113T,A00,185352,Staff,25,0,40,15
1683640308995,COMM 114I,A00,185353,Staff,31,0,40,9
1683640310020,COMM 131,A00,185354,Staff,17,0,30,13
1683640311049,CSE 8A,A50,185358,Cao; Yingjun,0,46,10,10
1683640312076,CSE 8B,A01,185362,Staff,0,48,50,50
1683640313104,CSE 11,A01,185416,Cao; Yingjun,0,91,10,10
1683640314132,CSE 20,A01,185445,Briones; Jor-el Thomas Caparas,4,0,25,21
1683640315156,CSE 21,A01,185447,Staff,9,0,50,41
1683640316181,CSE 101,A01,185451,Staff,0,13,50,50
1683640316181,CSE 101,B01,185453,Jones; Miles E,0,13,50,50
1683640318232,CSE 141,A01,185458,Eldon; John,15,0,100,85
1683640319256,CSE 141L,A01,185461,Eldon; John,7,0,100,93
1683640320283,CSE 142,A01,185463,Staff,36,0,60,24
1683640320283,CSE 142,B01,201355,Staff,0,7,60,60
1683640321312,CSE 142L,A01,185470,Staff,36,0,60,24
1683640321312,CSE 142L,B01,201417,Staff,0,6,60,60
1683640322337,CSE 190,A00,201433,Staff,32,0,49,17
1683640323363,DOC 1,A01,259136,Strom; Megan C.,7,0,15,8
1683640323363,DOC 1,A02,259137,Strom; Megan C.,14,0,15,1
1683640323363,DOC 1,A03,259138,Strom; Megan C.,14,0,15,1
1683640323363,DOC 1,A04,259139,Strom; Megan C.,14,0,15,1
1683640324392,DOC 100D,A00,259140,Pass; Natalye Joann,14,0,25,11
1683640325423,DSGN 1,A01,184749,Rill; Bryan,0,26,30,30
1683640326452,DSGN 100,A01,185168,Staff,0,2,25,25
1683640327480,ECE 5,A01,185626,Morris; Karcher William,0,11,0,0
1683640328505,ECE 101,A01,185628,Staff,14,0,70,56
1683640329529,ECE 107,A01,185635,Baghdadchi; Saharnaz,0,0,20,20
1683640329529,ECE 107,A02,185638,Baghdadchi; Saharnaz,3,0,20,17
1683640330557,ECE 148,A01,185647,Silberman; Jack,0,0,16,16
1683640331581,ECON 1,A01,185537,Crane; Meredith Helen,54,0,70,16
1683640332608,ECON 3,A01,185549,Crane; Meredith Helen,29,0,70,41
1683640333632,ECON 4,A01,203354,Anderson; John Charles,0,5,10,10
1683640334657,ECON 100A,A01,185574,Staff,0,5,40,40
1683640335681,ECON 100B,A01,185576,Staff,0,12,50,50
1683640336706,ECON 100C,A01,185589,Newhouse; Herbert S,30,0,70,40
1683640337730,ECON 105,A00,185608,Vespa; Emanuel Ignacio,19,0,35,16
1683640338759,ECON 109,A01,185610,Shishkin; Denis,9,0,35,26
1683640339786,ECON 110A,A01,185612,Staff,9,0,40,31
1683640340811,ECON 120A,A01,185615,Staff,20,0,40,20
1683640341835,ECON 120C,A01,185617,Sun; Yixiao,0,20,70,70
1683640342862,ECON 144,A00,203346,Squires; Dale E,2,0,35,33
1683640343886,ECON 171,A01,203349,Newhouse; Herbert S,0,1,35,35
1683640344914,ECON 173A,A01,185621,Toda; Alexis Akira,21,0,35,14
1683640345945,EDS 25,A01,202413,Staff,0,1,0,0
1683640345945,EDS 25,A02,202414,Staff,0,1,0,0
1683640345945,EDS 25,A03,202415,Staff,0,0,0,0
1683640345945,EDS 25,A04,202416,Staff,0,1,0,0
1683640345945,EDS 25,A05,202439,Staff,0,0,0,0
1683640345945,EDS 25,A06,202440,Staff,0,0,0,0
1683640345945,EDS 25,B01,202631,Staff,0,0,0,0
1683640345945,EDS 25,B02,202632,Staff,0,0,0,0
1683640345945,EDS 25,B03,202639,Staff,0,0,0,0
1683640345945,EDS 25,B04,202640,Staff,0,0,0,0
1683640345945,EDS 25,B05,202643,Staff,0,0,0,0
1683640345945,EDS 25,B06,202644,Staff,0,0,0,0
1683640346970,EDS 38,A01,202659,Black; Alison Michelle,24,0,25,1
1683640347995,EDS 115,A00,202652,Staff,18,0,30,12
1683640349019,EDS 125,A00,202649,Staff,13,0,30,17
1683640350045,EDS 126,A01,203332,Staff,30,0,30,0
1683640351070,EDS 139,A00,202838,Staff,16,0,25,9
1683640352095,EDS 146,A01,202655,Staff,14,0,25,11
1683640353123,ENG 15,A00,185667,Staff,0,1,0,0
1683640353123,ENG 15,B00,185672,Staff,0,0,0,0
1683640353123,ENG 15,C00,185675,Staff,0,0,0,0
1683640353123,ENG 15,D00,185682,Staff,0,0,0,0
1683640353123,ENG 15,E00,185684,Staff,0,0,0,0
1683640354151,ETHN 103,A00,185710,Staff,0,8,35,35
1683640355179,ETHN 103A,A00,199228,Man; Simeon S,0,0,9,9
1683640356205,ETHN 109,A00,185711,Staff,16,0,35,19
1683640357229,ETHN 142,A00,185726,Staff,0,4,30,30
1683640358256,ETHN 163J,A00,199229,Man; Simeon S,5,0,8,3
1683640359283,ETHN 168,A00,185727,Staff,7,0,10,3
1683640360307,ETHN 182,A00,185728,Staff,0,0,35,35
1683640361332,ETHN 183,A00,185737,Staff,9,0,18,9
1683640362368,GLBH 111,A01,209361,Burgos; Jose L.,0,0,0,0
1683640364416,HIEU 104,A00,185792,Staff,14,0,20,6
1683640365439,HIEU 115,A00,185800,Staff,0,0,20,20
1683640366467,HIEU 128,A00,185801,Staff,0,9,20,20
1683640367497,HIEU 147,A00,185802,Staff,15,0,20,5
1683640368521,HIEU 154,A00,185823,Staff,11,0,20,9
1683640369546,HILA 102,A00,185826,Staff,14,0,20,6
1683640370571,HILD 2C,A01,185778,Staff,0,13,20,20
1683640371601,HILD 7B,A01,185780,Kwak; Nancy,0,16,32,32
1683640371601,HILD 7B,A02,185781,Kwak; Nancy,0,18,32,32
1683640372628,HILD 30,A01,185791,Staff,12,0,20,8
1683640373657,HISC 119,A00,185830,Golan; Tal,0,9,20,20
1683640374683,HITO 156GS,A00,185831,Patterson; Patrick H.,0,0,0,23
1683640375708,HIUS 103,A00,185832,Man; Simeon S,0,4,20,20
1683640376733,HIUS 117,A00,185836,Kwak; Nancy,2,0,20,18
1683640377756,HIUS 125,A00,185840,Man; Simeon S,0,1,23,23
1683640378781,HIUS 149,A00,185845,Staff,1,0,20,19
1683640379806,HUM 3,A01,185882,Zavodny; Tatiana Sophia,0,7,50,50
1683640379806,HUM 3,B01,185899,Caldwell; Michael Alan,0,18,50,50
1683640380830,HUM 3GS,A00,185900,Patterson; Patrick H.,0,0,0,23
1683640381856,HUM 4,A01,185938,Zroka; Amy Liane,30,0,50,20
1683640381856,HUM 4,B01,185956,Watkins; Eric,0,4,50,50
1683640381856,HUM 4,B02,202209,Watkins; Eric,0,4,50,50
1683640381856,HUM 4,B03,202210,Watkins; Eric,0,4,50,50
1683640382885,HUM 5,A01,185958,West; Geoffrey Scott,2,0,50,48
1683640382885,HUM 5,A02,202215,West; Geoffrey Scott,0,0,50,50
1683640383911,INTL 190,A00,185959,Gagnon; Jeffrey C,0,0,0,9
1683640383911,INTL 190,B00,185960,Lettieri; Michael Joseph,0,0,0,2
1683640384940,JAPN 180,A00,254509,Staff,5,0,30,25
1683640385966,LATI 10,A01,202853,Kennemore; Amy Michelle,4,0,35,31
1683640385966,LATI 10,A02,202854,Kennemore; Amy Michelle,2,0,35,33
1683640385966,LATI 10,A03,270054,Kennemore; Amy Michelle,30,0,30,0
1683640386989,LATI 180,A00,202855,Kennemore; Amy Michelle,11,0,20,9
1683640388014,LAWS 101,A00,201767,Golan; Tal,0,7,40,40
1683640389058,LIFR 1C,A00,185961,Staff,6,0,20,14
1683640390082,LIFR 1CX,A00,185962,Staff,7,0,20,13
1683640391108,LIFR 1D,A00,185963,Staff,7,0,20,13
1683640392142,LIFR 1DX,A00,185964,Staff,7,0,20,13
1683640393167,LIGN 101,A01,186039,Staff,43,0,50,7
1683640394194,LIGN 165,A00,186040,Staff,15,0,50,35
1683640395222,LTCS 108,A00,186041,Staff,5,0,10,5
1683640396245,LTCS 119,A00,186042,Staff,15,0,20,5
1683640397272,LTCS 130,A00,186043,Wesling; Megan E.,15,0,25,10
1683640399325,LTEA 138,A00,186119,Staff,14,0,40,26
1683640400352,LTEN 124,A00,186148,Staff,5,0,25,20
1683640401381,LTEN 178,A00,186149,Staff,7,0,15,8
1683640402404,LTEN 181,A00,186150,Blanco; John D,34,0,40,6
1683640403429,LTWL 120,A00,186160,Staff,20,0,25,5
1683640404453,LTWL 165,A00,186161,Staff,22,0,25,3
1683640405477,LTWR 100,A00,186162,Staff,0,5,15,15
1683640406562,LTWR 102,A00,186163,Doller; Ben,5,0,15,10
1683640407590,MAE 8,A01,186412,Staff,0,0,0,0
1683640408618,MAE 30B,A00,186445,Bahadori; Mohammad Yousef,82,0,100,18
1683640409642,MAE 40,A00,186592,Bewley; Thomas R,10,0,50,40
1683640410666,MAE 101B,A00,186593,Bahadori; Mohammad Yousef,80,0,100,20
1683640411694,MAE 105,A00,186594,Bandaru; Prabhakar,10,0,50,40
1683640412720,MAE 107,A00,186599,Pham; Hieu Tan,0,7,120,120
1683640413747,MAE 148,A01,186660,Silberman; Jack,3,0,16,13
1683640414775,MATH 10A,A01,188095,Staff,0,5,35,35
1683640415806,MATH 10B,A01,188097,Bowers; Adam R.,0,11,30,30
1683640415806,MATH 10B,A02,188099,Bowers; Adam R.,0,11,30,30
1683640415806,MATH 10B,B01,188104,Bowers; Adam R.,0,10,30,30
1683640415806,MATH 10B,B02,188106,Bowers; Adam R.,1,9,30,29
1683640416831,MATH 10C,A01,188111,Staff,0,18,30,30
1683640416831,MATH 10C,A02,188127,Staff,0,19,30,30
1683640416831,MATH 10C,A03,188131,Staff,0,19,30,30
1683640416831,MATH 10C,B01,188218,Staff,17,0,30,13
1683640416831,MATH 10C,B02,188244,Staff,13,0,30,17
1683640416831,MATH 10C,B03,188277,Staff,14,0,30,16
1683640417856,MATH 18,A01,188344,Bach; Quang Tran,18,0,30,12
1683640417856,MATH 18,A02,188345,Bach; Quang Tran,11,0,30,19
1683640417856,MATH 18,B01,188353,Bach; Quang Tran,11,0,30,19
1683640417856,MATH 18,B02,188354,Bach; Quang Tran,19,0,30,11
1683640418882,MATH 20A,A01,188374,Staff,11,0,35,24
1683640419908,MATH 20B,A01,188382,Ohm; Ko Woon,7,0,30,23
1683640419908,MATH 20B,A02,188383,Ohm; Ko Woon,22,0,30,8
1683640419908,MATH 20B,B01,188385,Ohm; Ko Woon,7,0,30,23
1683640419908,MATH 20B,B02,188392,Ohm; Ko Woon,22,0,30,8
1683640420933,MATH 20C,A01,188394,Harel; Guershon,11,0,30,19
1683640420933,MATH 20C,A02,188395,Harel; Guershon,14,0,30,16
1683640420933,MATH 20C,B01,188404,Harel; Guershon,4,0,30,26
1683640420933,MATH 20C,B02,188405,Harel; Guershon,18,0,30,12
1683640421965,MATH 20D,A01,188414,Hammock; Frances H,0,1,30,30
1683640421965,MATH 20D,A02,188415,Hammock; Frances H,0,1,30,30
1683640421965,MATH 20D,B01,188447,Hammock; Frances H,0,1,30,30
1683640421965,MATH 20D,B02,188486,Hammock; Frances H,4,0,30,26
1683640422992,MATH 20E,A01,188649,Staff,21,0,30,9
1683640422992,MATH 20E,A02,188650,Staff,21,0,30,9
1683640422992,MATH 20E,A03,188673,Staff,0,0,30,30
1683640424019,MATH 102,A01,188675,Staff,0,36,35,35
1683640425044,MATH 103B,A01,188681,Staff,3,0,35,32
1683640425044,MATH 103B,B01,188692,Staff,5,0,35,30
1683640426074,MATH 109,A01,188695,Salehi Golsefidy; Alireza,24,0,35,11
1683640426074,MATH 109,A02,188696,Salehi Golsefidy; Alireza,25,0,35,10
1683640427100,MATH 120A,A01,188698,Eggers; John Dietrich,7,0,35,28
1683640428131,MATH 142B,A01,188736,Ioana; Adrian,0,1,30,30
1683640428131,MATH 142B,A02,188741,Ioana; Adrian,0,1,30,30
1683640428131,MATH 142B,A03,188743,Ioana; Adrian,0,1,30,30
1683640429158,MATH 168A,A01,188790,Staff,0,10,35,35
1683640430183,MATH 170A,A01,188803,Nie; Jiawang,0,2,35,35
1683640430183,MATH 170A,A02,188811,Nie; Jiawang,0,0,35,35
1683640430183,MATH 170A,A03,188814,Nie; Jiawang,0,0,35,35
1683640430183,MATH 170A,A04,188815,Nie; Jiawang,10,0,35,25
1683640431208,MATH 193B,A01,188817,Staff,0,0,35,35
1683640431208,MATH 193B,A02,188818,Staff,5,0,35,30
1683640432233,MGT 4,A01,202857,Anderson; John Charles,61,0,80,19
1683640433258,MGT 12,A00,202858,Lindenberger; Wade Douglas,40,0,90,50
1683640434283,MGT 18,A00,202859,Staff,74,0,90,16
1683640435309,MGT 18GS,A00,202860,McKay; Michael J,13,0,28,15
1683640436333,MGT 45,A00,202861,Pecore; Joseph P.,12,0,90,78
1683640437362,MGT 100,A00,202863,Yavorsky; Daniel Ryan,28,0,90,62
1683640438387,MGT 103,A00,202864,Ehrich; Kristine R,0,17,90,90
1683640439415,MGT 112,A00,202865,Ehrich; Kristine R,15,0,90,75
1683640440440,MGT 121A,A00,202868,Staff,0,20,0,0
1683640441466,MGT 131B,A00,202869,Anderson; John Charles,59,0,90,31
1683640442490,MGT 136,A00,202871,Lindenberger; Wade Douglas,83,0,90,7
1683640443521,MGT 164,A00,202873,Staff,0,66,90,91
1683640444546,MGT 164GS,A00,202874,McKay; Mary A,13,0,28,15
1683640445570,MGT 180,A00,202875,Staff,0,50,90,91
1683640446596,MMW 11R,A01,205019,Herbst; Matthew,2,0,30,28
1683640446596,MMW 11R,A02,205026,Herbst; Matthew,29,0,30,1
1683640447627,MMW 15,A01,193512,Chang; Edmond Yi-Teh,0,8,28,28
1683640447627,MMW 15,A02,193513,Chang; Edmond Yi-Teh,0,5,28,28
1683640447627,MMW 15,A03,193514,Chang; Edmond Yi-Teh,0,5,28,28
1683640447627,MMW 15,A04,193515,Chang; Edmond Yi-Teh,0,5,28,28
1683640447627,MMW 15,A05,193516,Chang; Edmond Yi-Teh,0,5,28,28
1683640447627,MMW 15,A06,193517,Chang; Edmond Yi-Teh,0,6,28,28
1683640447627,MMW 15,B01,193519,Chang; Edmond Yi-Teh,0,5,28,28
1683640447627,MMW 15,B02,193520,Chang; Edmond Yi-Teh,0,5,28,28
1683640447627,MMW 15,B03,193521,Chang; Edmond Yi-Teh,0,5,28,28
1683640447627,MMW 15,B04,193522,Chang; Edmond Yi-Teh,0,5,28,28
1683640447627,MMW 15,B05,193523,Chang; Edmond Yi-Teh,0,5,28,28
1683640447627,MMW 15,B06,193524,Chang; Edmond Yi-Teh,0,5,28,28
1683640448664,MMW 122,A01,193526,Rahimi; Babak,0,16,28,28
1683640448664,MMW 122,A02,193527,Rahimi; Babak,0,15,28,28
1683640448664,MMW 122,A03,193528,Rahimi; Babak,0,0,0,0
1683640448664,MMW 122,A04,193529,Rahimi; Babak,0,0,0,0
1683640449694,MUS 1A,A01,186663,Staff,1,20,35,34
1683640450719,MUS 4,A01,186715,Staff,0,12,35,35
1683640451745,MUS 5R,A01,186796,Dubnov; Shlomo,0,17,35,35
1683640452772,MUS 6,A01,186798,Staff,0,5,25,25
1683640453797,MUS 7,A01,186830,Staff,11,0,35,24
1683640454822,MUS 8,A01,186930,Staff,0,26,35,35
1683640455848,MUS 15,A01,186932,Staff,0,16,35,35
1683640455848,MUS 15,B01,186934,Staff,0,17,35,35
1683640456874,MUS 80,A00,186935,Staff,0,0,20,20
1683640456874,MUS 80,B00,186936,Staff,24,0,25,1
1683640457902,NANO 11,A00,204702,Lipomi; Darren John,0,0,0,0
1683640458935,NANO 15,A01,204709,Yang; Kesong,0,1,0,0
1683640459969,NANO 114,A00,202069,Jahed Motlagh; Zeinab,3,0,10,7
1683640461001,PHIL 1,A00,186955,Grush; Rick Scott,31,0,40,9
1683640462027,PHIL 10,A01,186973,Grush; Rick Scott,27,0,35,8
1683640462027,PHIL 10,A02,186974,Grush; Rick Scott,33,0,35,2
1683640463052,PHIL 13,A01,186976,Staff,3,0,35,32
1683640463052,PHIL 13,A02,186977,Staff,16,0,35,19
1683640464076,PHIL 14,A01,186979,Staff,31,0,35,4
1683640464076,PHIL 14,A02,186986,Staff,32,0,35,3
1683640465106,PHIL 28,A01,186988,Staff,16,0,30,14
1683640465106,PHIL 28,A02,186989,Staff,1,0,30,29
1683640465106,PHIL 28,A03,186990,Staff,10,0,30,20
1683640465106,PHIL 28,A04,186991,Staff,26,0,30,4
1683640466137,PHIL 120,A00,186997,Staff,23,0,40,17
1683640467163,PHIL 137,A00,187003,Staff,7,0,40,33
1683640468192,PHIL 150,A00,187015,Staff,47,0,70,23
1683640469217,PHIL 167,A00,187021,Lamey; Andy M.,34,0,40,6
1683640470243,PHIL 174,A01,202226,Staff,17,0,20,3
1683640470243,PHIL 174,A02,202235,Staff,20,0,20,0
1683640471269,PHIL 191A,A00,258918,Staff,0,0,1,1
1683640472298,PHYS 1A,A00,187028,Staff,27,0,60,33
1683640473327,PHYS 1AL,001,187036,Staff,3,0,30,27
1683640473327,PHYS 1AL,002,187049,Staff,18,0,30,12
1683640474355,PHYS 1B,A00,187058,Staff,22,0,60,38
1683640475385,PHYS 1BL,001,187064,Staff,0,1,30,30
1683640475385,PHYS 1BL,002,187070,Staff,4,0,30,26
1683640476413,PHYS 1C,A00,187082,Staff,29,0,120,91
1683640477439,PHYS 1CL,001,187088,Staff,0,9,30,30
1683640477439,PHYS 1CL,002,187089,Staff,0,1,30,30
1683640477439,PHYS 1CL,009,262693,Staff,9,0,30,21
1683640478465,PHYS 2B,A01,187097,Staff,55,0,115,60
1683640479491,PHYS 2C,A01,187099,Staff,64,0,115,51
1683640480517,PHYS 2CL,A01,187101,Staff,5,0,28,23
1683640480517,PHYS 2CL,A02,187102,Staff,15,0,28,13
1683640481543,PHYS 2D,A01,187123,Shotwell; Brian,95,0,115,20
1683640482574,PHYS 4B,A01,187133,Grinstein; Benjamin,35,0,50,15
1683640483603,POLI 10,A00,188819,Staff,0,4,50,50
1683640484627,POLI 11,A00,188827,Staff,43,0,50,7
1683640485653,POLI 13R,A00,188828,Staff,0,1,20,20
1683640486679,POLI 27,A01,188830,Elgin; Samuel Zincke,0,2,70,70
1683640487707,POLI 30,A00,188832,Desposato; Scott,30,0,50,20
1683640488733,POLI 102F,A00,188834,Staff,0,0,40,40
1683640489763,POLI 104A,A00,188852,Staff,13,0,30,17
1683640490794,POLI 104I,A00,188853,Staff,0,7,20,20
1683640491820,POLI 110B,A00,188854,Wiens; David,7,0,20,13
1683640492847,POLI 112A,A00,188855,Wiens; David,4,0,30,26
1683640493877,POLI 117R,A00,188856,Forman; Fonna,0,12,20,20
1683640494905,POLI 118,A00,188857,Ingham; Sean,8,0,20,12
1683640495931,POLI 120G,A00,188858,Staff,8,0,30,22
1683640496958,POLI 131CR,A00,188863,Hoston; Germaine,21,0,50,29
1683640497986,POLI 133,A00,188864,Nellis; Gareth Hb,44,0,50,6
1683640499011,POLI 134D,A00,188865,Desposato; Scott,27,0,30,3
1683640500038,POLI 142A,A00,188871,Gartzke; Erik,21,0,50,29
1683640501063,POLI 142K,A00,188874,Staff,38,0,50,12
1683640502087,POLI 143,A00,188940,Gartzke; Erik,16,0,30,14
1683640503112,POLI 153,A00,188943,Staff,2,0,20,18
1683640504140,POLI 160AA,A00,188944,Staff,11,0,40,29
1683640505166,POLI 170A,A00,188945,Staff,11,0,30,19
1683640507214,PSYC 1,A00,188952,Staff,36,0,90,54
1683640508242,PSYC 2,B00,188953,Staff,19,0,35,16
1683640509270,PSYC 6,A00,188970,Staff,47,0,60,13
1683640510357,PSYC 7,A00,188973,Staff,35,0,45,10
1683640511383,PSYC 60,A01,188980,Rickard; Timothy C.,42,0,60,18
1683640512409,PSYC 70,A01,189001,Steiner; Eric Tomas,23,0,45,22
1683640513436,PSYC 100,A00,189005,Lacefield; Katharine I,0,99,120,120
1683640514461,PSYC 102,A00,189008,Staff,8,0,30,22
1683640515490,PSYC 106,B00,189026,Gorman; Michael R.,27,0,60,33
1683640516518,PSYC 114,B01,189033,Winkielman; Piotr,0,31,30,30
1683640517545,PSYC 131,A00,189036,Anagnostaras; Stephan,0,43,60,60
1683640518573,PSYC 136,A00,189041,Lowe; Angela Beth,0,7,25,25
1683640519598,PSYC 137,A00,189057,Winkielman; Piotr,0,37,25,25
1683640520624,PSYC 144,A00,189107,Wixted; John T,0,10,50,50
1683640522682,PSYC 162,A00,189142,Staff,0,9,85,85
1683640523711,PSYC 172,A00,189144,Gorman; Michael R.,0,6,30,30
1683640525768,PSYC 179,A00,189146,Lacefield; Katharine I,0,86,120,120
1683640526794,PSYC 181,A00,189147,Anagnostaras; Stephan,0,44,90,90
1683640527820,PSYC 190R,A00,189148,Barner; David A.,0,23,80,80
1683640528852,PSYC 191,A00,189275,Rickard; Timothy C.,0,10,25,25
1683640529879,PSYC 193,A00,189276,Chapman; Eddie Nathaniel,0,1,0,4
1683640530904,PSYC 193L,A01,189281,Lowe; Angela Beth,10,0,20,10
1683640530904,PSYC 193L,B01,189285,Staff,28,0,35,7
1683640531931,RELI 149,A00,187137,Rahimi; Babak,7,0,40,33
1683640532962,SE 9,A01,187315,Staff,0,2,18,18
1683640533987,SE 101B,A00,187409,Staff,24,0,30,6
1683640535013,SE 110B,A00,187444,Staff,10,0,40,30
1683640536038,SE 130B,A00,187449,Staff,31,0,40,9
1683640537068,SE 150A,A00,187516,Staff,9,0,20,11
1683640538096,SE 154,A00,187528,Staff,29,0,50,21
1683640539130,SIO 3,A01,258171,Staff,35,0,40,5
1683640540159,SIO 10,A00,187144,Cook; Geoffrey W,0,6,75,75
1683640541189,SIO 45,A00,187152,Cook; Geoffrey W,0,4,100,100
1683640542217,SIO 109R,A00,194486,Staff,0,4,20,20
1683640544271,SIO 187,A01,187233,Kacev; David,12,0,40,28
1683640545299,SOCI 1,A01,258656,Thorpe; Charles Robert,28,0,30,2
1683640545299,SOCI 1,A02,258658,Thorpe; Charles Robert,30,0,30,0
1683640545299,SOCI 1,A03,258661,Thorpe; Charles Robert,25,0,25,0
1683640545299,SOCI 1,A04,258666,Thorpe; Charles Robert,22,0,25,3
1683640545299,SOCI 1,A05,258897,Thorpe; Charles Robert,22,0,25,3
1683640545299,SOCI 1,A06,258898,Thorpe; Charles Robert,25,0,25,0
1683640546324,SOCI 30,A01,258903,Pardo Guerra; Juan Pablo,14,0,30,16
1683640547349,SOCI 102,A00,258904,Staff,9,0,25,16
1683640548374,SOCI 106,A00,258905,Staff,19,0,25,6
1683640549399,SOCI 111,A00,258907,Ribas Norris; Janet Vanesa,26,0,30,4
1683640550428,SOCI 121R,A00,258908,Pardo Guerra; Juan Pablo,8,0,30,22
1683640551455,SOCI 126,A01,203330,Staff,14,0,20,6
1683640552483,SOCI 131,A00,258909,Thorpe; Charles Robert,30,0,60,30
1683640553512,SOCI 135,A00,258910,Payne; Christine Anna,0,11,30,30
1683640554537,SOCI 157,A00,258911,Staff,12,0,30,18
1683640555563,SOCI 184,A00,258912,Staff,25,0,30,5
1683640556590,SOCI 188D,A00,258913,Staff,22,0,30,8
1683640557617,SYN 2,001,187529,Staff,9,0,16,7
1683640557617,SYN 2,002,201452,Staff,0,20,16,16
1683640557617,SYN 2,003,201469,Staff,2,0,16,14
1683640558642,SYN 100,A01,187531,Staff,0,9,20,20
1683640558642,SYN 100,B01,201491,Staff,0,10,20,20
1683640559670,TDAC 1,A00,189286,Walsh; Kim C.,3,0,20,17
1683640559670,TDAC 1,B00,189287,Harting; Carla Kelso,10,0,20,10
1683640560695,TDAC 101,A00,189300,Walsh; Kim C.,16,0,20,4
1683640560695,TDAC 101,B00,189301,Harting; Carla Kelso,18,0,20,2
1683640561723,TDAC 102,A00,189304,Basso; Beatrice,14,0,20,6
1683640562753,TDAC 108,A00,189305,Staff,18,0,20,2
1683640563780,TDDE 131,A00,189310,Staff,19,0,20,1
1683640563780,TDDE 131,B00,189314,Staff,19,0,20,1
1683640563780,TDDE 131,C00,189315,Staff,48,0,50,2
1683640563780,TDDE 131,D00,189316,Staff,14,0,15,1
1683640563780,TDDE 131,E00,204841,Staff,20,0,20,0
1683640564806,TDGE 10,A00,189289,Staff,27,0,50,23
1683640564806,TDGE 10,B00,189290,Havis; Allan,0,0,50,50
1683640565840,TDGE 11,A00,189291,Fulton; Julia,0,4,50,50
1683640565840,TDGE 11,B00,189292,Staff,20,0,25,5
1683640565840,TDGE 11,C00,260270,Staff,0,0,0,0
1683640566868,TDGE 25,A00,189294,Staff,2,0,20,18
1683640567893,TDGE 124,A00,189318,Fulton; Julia,0,8,50,50
1683640568919,TDGE 125,A00,189319,Staff,13,0,25,12
1683640568919,TDGE 125,B00,189320,Staff,23,0,25,2
1683640569945,TDGE 127,A00,189322,Havis; Allan,0,0,50,50
1683640570971,TDHT 101,A00,189323,Staff,18,0,25,7
1683640570971,TDHT 101,B00,189324,Staff,25,0,25,0
1683640571996,TDHT 102,A00,189325,Staff,49,0,50,1
1683640573021,TDMV 1,A00,189295,Arcidiacono; Kristin,20,0,30,10
1683640573021,TDMV 1,B00,189296,Caligagan; Maria T.,24,0,30,6
1683640574052,TDMV 2,A00,189297,Sammartano; Tonnie,27,0,30,3
1683640574052,TDMV 2,B00,189299,Arcidiacono; Kristin,23,0,30,7
1683640575080,TDMV 3,A00,204998,Rincon; Alicia,22,0,30,8
1683640576109,TDMV 120,A00,189458,Sammartano; Tonnie,28,0,30,2
1683640577140,TDMV 138,A00,189541,Jun; Grace Shin Hae,20,0,40,20
1683640578170,TDMV 142,A00,189717,Caligagan; Tony,25,0,30,5
1683640578170,TDMV 142,B00,189718,Caligagan; Maria T.,25,0,30,5
1683640579195,TMC 2,A01,187533,Staff,25,0,25,0
1683640579195,TMC 2,A02,187534,Staff,25,0,25,0
1683640580226,USP 1,A01,187536,Kwak; Nancy,0,16,25,25
1683640581255,USP 5,A01,187538,Staff,9,0,25,16
1683640582285,USP 101,A00,199253,Staff,0,4,0,0
1683640583315,USP 124,A00,187562,Boomhower; Matthew Charles,0,0,30,30
1683640584341,USP 138,A00,187582,Staff,20,0,25,5
1683640585366,USP 152,A01,187597,Staff,3,0,25,22
1683640586392,USP 153,A00,187598,Staff,19,0,25,6
1683640587426,USP 168,A00,187607,Kwak; Nancy,2,0,5,3
1683640588451,USP 173,A00,187619,Staff,4,0,25,21
1683640589484,USP 181,A00,187638,Staff,0,4,25,25
1683640590516,VIS 103,A00,187650,Cruz; Edwin Teddy,18,0,75,57
1683640591541,VIS 110D,A00,187669,Staff,13,0,22,9
1683640592573,VIS 127C,A00,187720,Shen; Kuiyi,67,0,146,79
1683640593598,VIS 149,A00,187731,Yoldas; Pinar,0,14,22,22
1683640594626,VIS 151,A01,188091,Staff,22,0,34,12
1683640594626,VIS 151,A02,188092,Staff,11,0,34,23
1683640595656,VIS 160B,A00,188093,Stalbaum; Brett,0,1,10,10
1683640597711,WCWP 10B,A00,201720,Staff,10,0,15,5
1683640597711,WCWP 10B,B00,201722,Staff,9,0,15,6
1683640598743,WCWP 100,A00,201725,Gagnon; Jeffrey C,0,0,2,2
1683640598743,WCWP 100,B00,201727,Staff,0,4,15,15
1683640601930,ANBI 133,A00,258401,Wilder; Linnea Lorene,34,0,40,6
1683640602956,ANBI 140,A00,258395,Hrvoj Mihic; Branka,18,0,25,7
1683640603980,ANSC 120,A00,258402,Bialecki; Jon Anthony,27,0,40,13
1683640605009,ANSC 144,A00,258400,Staff,12,0,40,28
1683640607063,ANSC 166,A00,258396,Parish; Steven Martin,156,0,175,19
1683640608093,ANSC 180,A00,193533,Staff,8,0,20,12
1683640609118,ANSC 188,A00,258397,Jassal; Aftab,34,0,40,6
1683640610143,ANTH 3,A01,258316,Staff,23,0,30,7
1683640611169,ANTH 5,A00,258394,Semendeferi; Ekaterini,16,0,20,4
1683640612193,ANTH 21,A01,258331,Staff,4,0,40,36
1683640613219,ANTH 103,A00,258398,Varma; Saiba,15,0,25,10
1683640614316,AWP 10,001,202034,Staff,0,0,0,0
1683640614316,AWP 10,002,202035,Staff,0,0,0,0
1683640614316,AWP 10,003,202036,Staff,0,0,0,0
1683640614316,AWP 10,004,202037,Staff,0,0,0,0
1683640614316,AWP 10,005,202038,Staff,0,0,0,0
1683640614316,AWP 10,006,202039,Staff,0,0,0,0
1683640614316,AWP 10,007,202040,Staff,0,0,0,0
1683640614316,AWP 10,008,202041,Staff,0,0,0,0
1683640614316,AWP 10,009,202042,Staff,0,0,0,0
1683640614316,AWP 10,010,202043,Staff,0,0,0,0
1683640614316,AWP 10,011,202044,Staff,0,0,0,0
1683640614316,AWP 10,012,202045,Staff,0,0,0,0
1683640614316,AWP 10,013,202046,Staff,0,0,0,0
1683640614316,AWP 10,014,202047,Staff,0,0,0,0
1683640614316,AWP 10,015,202048,Staff,0,0,0,0
1683640614316,AWP 10,016,202049,Staff,0,0,0,0
1683640614316,AWP 10,017,202050,Staff,0,0,0,0
1683640614316,AWP 10,018,202051,Staff,0,0,0,0
1683640614316,AWP 10,019,202052,Staff,0,0,0,0
1683640614316,AWP 10,020,202053,Staff,0,0,0,0
1683640614316,AWP 10,021,202054,Staff,0,0,0,0
1683640614316,AWP 10,022,202055,Staff,0,0,0,0
1683640614316,AWP 10,023,202056,Staff,0,0,0,0
1683640614316,AWP 10,024,202057,Staff,0,0,0,0
1683640614316,AWP 10,025,202058,Staff,0,0,0,0
1683640614316,AWP 10,026,202059,Staff,0,0,0,0
1683640615342,AWP 102,001,202032,Staff,0,0,0,0
1683640615342,AWP 102,002,202033,Staff,0,0,0,0
1683640616372,BENG 100,A01,254234,Taylor Amos; Alyssa C,31,0,40,9
1683640617405,BENG 196,001,270013,Engler; Adam J.,9999,0,9999,0
1683640618439,BICD 100R,A01,202018,Smith; Laurie,0,7,32,32
1683640618439,BICD 100R,A02,202019,Smith; Laurie,0,3,32,32
1683640618439,BICD 100R,A03,202020,Smith; Laurie,0,1,32,32
1683640618439,BICD 100R,A04,202021,Smith; Laurie,6,0,32,26
1683640618439,BICD 100R,A05,202022,Smith; Laurie,11,0,32,21
1683640619466,BICD 136,A01,193242,Gustafson-Brown; Cindy,0,2,32,32
1683640619466,BICD 136,A02,193244,Gustafson-Brown; Cindy,13,0,32,19
1683640620494,BIEB 102,A01,193249,Butler; Shannon Rhey,0,2,32,32
1683640620494,BIEB 102,A02,193251,Butler; Shannon Rhey,0,0,32,32
1683640620494,BIEB 102,A03,193253,Butler; Shannon Rhey,0,0,32,32
1683640620494,BIEB 102,A04,193255,Butler; Shannon Rhey,14,0,32,18
1683640620494,BIEB 102,A05,193265,Butler; Shannon Rhey,26,0,32,6
1683640620494,BIEB 102,A06,193269,Butler; Shannon Rhey,14,0,32,18
1683640622545,BIEB 150,A01,193274,Staff,0,0,32,32
1683640622545,BIEB 150,A02,193285,Staff,24,0,32,8
1683640623570,BIEB 194,A00,193286,Kurle; Carolyn M.,20,0,32,12
1683640624606,BILD 1,A01,192291,Staff,15,0,32,17
1683640624606,BILD 1,A02,192292,Staff,30,0,32,2
1683640624606,BILD 1,B01,192520,Reuther; Keefe,0,1,0,0
1683640624606,BILD 1,B02,192532,Reuther; Keefe,0,1,0,0
1683640625633,BILD 3,A01,192556,Butler; Shannon Rhey,0,0,32,32
1683640625633,BILD 3,A02,192581,Butler; Shannon Rhey,1,0,32,31
1683640625633,BILD 3,A03,192611,Butler; Shannon Rhey,21,0,32,11
1683640625633,BILD 3,A04,192612,Butler; Shannon Rhey,24,0,32,8
1683640625633,BILD 3,A05,192613,Butler; Shannon Rhey,26,0,32,6
1683640625633,BILD 3,A06,192679,Butler; Shannon Rhey,27,0,32,5
1683640625633,BILD 3,A07,192682,Butler; Shannon Rhey,20,0,32,12
1683640626659,BILD 4,A01,192836,Reuther; Keefe,0,0,24,24
1683640626659,BILD 4,A02,193044,Reuther; Keefe,4,0,24,20
1683640627688,BILD 10,A01,193142,Gustafson-Brown; Cindy,29,0,32,3
1683640627688,BILD 10,A02,193149,Gustafson-Brown; Cindy,31,0,32,1
1683640628714,BIMM 100,A01,193301,Staff,0,6,32,32
1683640628714,BIMM 100,A02,193312,Staff,0,7,32,32
1683640628714,BIMM 100,A03,193323,Staff,0,9,32,32
1683640629746,BIMM 101,A01,193329,McDonnell; Lisa Marie,0,4,24,24
1683640629746,BIMM 101,A02,193339,McDonnell; Lisa Marie,0,3,24,24
1683640629746,BIMM 101,B01,193354,McDonnell; Lisa Marie,0,4,24,24
1683640629746,BIMM 101,B02,193357,McDonnell; Lisa Marie,0,2,24,24
1683640630773,BIMM 110,A01,193377,Tat; John,0,11,32,32
1683640630773,BIMM 110,A02,193378,Tat; John,0,10,32,32
1683640631801,BIMM 120,A01,206116,Staff,0,0,32,32
1683640631801,BIMM 120,A02,206117,Staff,6,0,32,26
1683640631801,BIMM 120,A03,206121,Staff,21,0,32,11
1683640632827,BIPN 100,A01,193393,Park; Ji Young,0,14,32,32
1683640632827,BIPN 100,A02,193402,Park; Ji Young,0,14,32,32
1683640632827,BIPN 100,A03,193413,Park; Ji Young,0,14,32,32
1683640632827,BIPN 100,A04,193414,Park; Ji Young,0,13,32,32
1683640633857,BIPN 102,A01,193429,Staff,0,0,32,32
1683640633857,BIPN 102,A02,193438,Staff,18,0,32,14
1683640634884,BIPN 106,A01,193450,Reyes Gonzalez; Catalina,0,2,40,40
1683640635911,BIPN 134,A01,193465,Cooke; James Edward,0,0,32,32
1683640635911,BIPN 134,A02,193474,Cooke; James Edward,25,0,32,7
1683640635911,BIPN 134,A03,193485,Cooke; James Edward,29,0,32,3
1683640635911,BIPN 134,A04,193486,Cooke; James Edward,20,0,32,12
1683640635911,BIPN 134,A05,193491,Cooke; James Edward,31,0,32,1
1683640635911,BIPN 134,A06,193501,Cooke; James Edward,30,0,32,2
1683640635911,BIPN 134,A07,193510,Cooke; James Edward,29,0,32,3
1683640637965,BISP 194,A00,222522,Staff,14,0,32,18
1683640638992,CAT 124,A01,202407,Staff,19,0,25,6
1683640640023,CAT 125,A00,202408,Marchisotto; Jennifer Anne,2,0,20,18
1683640641050,CAT 125R,A00,202409,Smith; Lauryn Alissa,0,11,20,20
1683640641050,CAT 125R,B00,202410,Morales; Celeste Georgianna,0,11,20,20
1683640641050,CAT 125R,C00,202411,Irwin; Matthew Joseph,0,12,20,20
1683640642076,CENG 15,A01,204712,Yang; Kesong,0,1,0,0
1683640643105,CENG 114,A00,202070,Jahed Motlagh; Zeinab,5,0,20,15
1683640644145,CGS 105,A00,185477,Wesling; Megan E.,24,0,40,16
1683640645169,CGS 106,A00,185494,Staff,11,0,22,11
1683640646195,CGS 108,A00,185495,Staff,14,0,20,6
1683640647226,CGS 114,A00,185496,Staff,13,0,18,5
1683640648250,CGS 119,A00,185501,Staff,15,0,20,5
1683640649273,CGS 120,A00,185511,Staff,12,0,20,8
1683640650308,CHEM 4,A01,184675,Bussey; Thomas J,97,0,100,3
1683640651335,CHEM 6A,A01,184677,Staff,33,0,60,27
1683640652366,CHEM 6B,A01,184679,Staff,63,0,100,37
1683640653396,CHEM 6C,A01,184681,Bussey; Thomas J,0,0,50,50
1683640653396,CHEM 6C,A02,184682,Bussey; Thomas J,32,0,50,18
1683640654424,CHEM 40A,A01,184684,Albizati; Kim F.,35,0,100,65
1683640655449,CHEM 40B,A01,184686,Albizati; Kim F.,0,22,100,100
1683640656473,CHEM 41B,A01,184690,Staff,51,0,100,49
1683640657498,COGS 3,A01,184715,Boyle; Mary E. T.,0,27,40,40
1683640658523,COGS 14B,A01,185172,Staff,0,14,38,38
1683640659551,COGS 18,A01,184736,Staff,15,0,80,65
1683640660581,COGS 100,A01,184932,Staff,0,7,73,73
1683640661606,COGS 101A,A01,184935,Staff,0,39,30,30
1683640662633,COGS 101B,A01,184944,Staff,0,2,30,30
1683640663661,COGS 101C,A01,184946,Staff,0,10,30,30
1683640664686,COGS 102A,A01,184951,Johnson; Christine M.,2,0,40,38
1683640665714,COGS 107B,A01,184953,Mooshagian; Eric Frederick,0,51,40,40
1683640666738,COGS 118B,A01,184959,Gupta; Anjum,0,49,40,40
1683640667762,COGS 153,A00,184961,Staff,0,16,30,30
1683640668790,COGS 177,A00,184962,Staff,0,21,30,30
1683640669814,COGS 187A,A01,184969,Boyle; Mary E. T.,0,19,40,40
1683640670839,COMM 10,A01,185174,Staff,0,5,25,25
1683640670839,COMM 10,A02,185189,Staff,0,2,25,25
1683640670839,COMM 10,A03,269821,Staff,0,1,0,0
1683640671865,COMM 100B,A01,185475,Staff,0,1,0,2
1683640671865,COMM 100B,A02,185476,Staff,12,0,25,13
1683640672889,COMM 100C,A01,185314,Staff,1,0,25,24
1683640672889,COMM 100C,A02,185327,Staff,18,0,25,7
1683640673917,COMM 110M,A00,185349,Staff,0,0,40,40
1683640674944,COMM 113T,A00,185352,Staff,25,0,40,15
1683640675971,COMM 114I,A00,185353,Staff,31,0,40,9
1683640676998,COMM 131,A00,185354,Staff,17,0,30,13
1683640678023,CSE 8A,A50,185358,Cao; Yingjun,0,46,10,10
1683640679050,CSE 8B,A01,185362,Staff,0,48,50,50
1683640680074,CSE 11,A01,185416,Cao; Yingjun,0,91,10,10
1683640681099,CSE 20,A01,185445,Briones; Jor-el Thomas Caparas,4,0,25,21
1683640682123,CSE 21,A01,185447,Staff,9,0,50,41
1683640683157,CSE 101,A01,185451,Staff,0,13,50,50
1683640683157,CSE 101,B01,185453,Jones; Miles E,0,13,50,50
1683640685205,CSE 141,A01,185458,Eldon; John,15,0,100,85
1683640686233,CSE 141L,A01,185461,Eldon; John,7,0,100,93
1683640687257,CSE 142,A01,185463,Staff,36,0,60,24
1683640687257,CSE 142,B01,201355,Staff,0,7,60,60
1683640688284,CSE 142L,A01,185470,Staff,36,0,60,24
1683640688284,CSE 142L,B01,201417,Staff,0,6,60,60
1683640689309,CSE 190,A00,201433,Staff,32,0,49,17
1683640690334,DOC 1,A01,259136,Strom; Megan C.,7,0,15,8
1683640690334,DOC 1,A02,259137,Strom; Megan C.,14,0,15,1
1683640690334,DOC 1,A03,259138,Strom; Megan C.,14,0,15,1
1683640690334,DOC 1,A04,259139,Strom; Megan C.,14,0,15,1
1683640691361,DOC 100D,A00,259140,Pass; Natalye Joann,14,0,25,11
1683640692385,DSGN 1,A01,184749,Rill; Bryan,0,26,30,30
1683640693414,DSGN 100,A01,185168,Staff,0,2,25,25
1683640694439,ECE 5,A01,185626,Morris; Karcher William,0,11,0,0
1683640695464,ECE 101,A01,185628,Staff,14,0,70,56
1683640696495,ECE 107,A01,185635,Baghdadchi; Saharnaz,0,0,20,20
1683640696495,ECE 107,A02,185638,Baghdadchi; Saharnaz,3,0,20,17
1683640697520,ECE 148,A01,185647,Silberman; Jack,0,0,16,16
1683640698545,ECON 1,A01,185537,Crane; Meredith Helen,54,0,70,16
1683640699569,ECON 3,A01,185549,Crane; Meredith Helen,29,0,70,41
1683640700599,ECON 4,A01,203354,Anderson; John Charles,0,5,10,10
1683640701624,ECON 100A,A01,185574,Staff,0,5,40,40
1683640702649,ECON 100B,A01,185576,Staff,0,12,50,50
1683640703679,ECON 100C,A01,185589,Newhouse; Herbert S,30,0,70,40
1683640704707,ECON 105,A00,185608,Vespa; Emanuel Ignacio,19,0,35,16
1683640705733,ECON 109,A01,185610,Shishkin; Denis,9,0,35,26
1683640706757,ECON 110A,A01,185612,Staff,9,0,40,31
1683640707785,ECON 120A,A01,185615,Staff,20,0,40,20
1683640708813,ECON 120C,A01,185617,Sun; Yixiao,0,20,70,70
1683640709848,ECON 144,A00,203346,Squires; Dale E,2,0,35,33
1683640710878,ECON 171,A01,203349,Newhouse; Herbert S,0,1,35,35
1683640711909,ECON 173A,A01,185621,Toda; Alexis Akira,21,0,35,14
1683640712939,EDS 25,A01,202413,Staff,0,1,0,0
1683640712939,EDS 25,A02,202414,Staff,0,1,0,0
1683640712939,EDS 25,A03,202415,Staff,0,0,0,0
1683640712939,EDS 25,A04,202416,Staff,0,1,0,0
1683640712939,EDS 25,A05,202439,Staff,0,0,0,0
1683640712939,EDS 25,A06,202440,Staff,0,0,0,0
1683640712939,EDS 25,B01,202631,Staff,0,0,0,0
1683640712939,EDS 25,B02,202632,Staff,0,0,0,0
1683640712939,EDS 25,B03,202639,Staff,0,0,0,0
1683640712939,EDS 25,B04,202640,Staff,0,0,0,0
1683640712939,EDS 25,B05,202643,Staff,0,0,0,0
1683640712939,EDS 25,B06,202644,Staff,0,0,0,0
1683640713966,EDS 38,A01,202659,Black; Alison Michelle,24,0,25,1
1683640714996,EDS 115,A00,202652,Staff,18,0,30,12
1683640716025,EDS 125,A00,202649,Staff,13,0,30,17
1683640717050,EDS 126,A01,203332,Staff,30,0,30,0
1683640718133,EDS 139,A00,202838,Staff,16,0,25,9
1683640719158,EDS 146,A01,202655,Staff,14,0,25,11
1683640720187,ENG 15,A00,185667,Staff,0,1,0,0
1683640720187,ENG 15,B00,185672,Staff,0,0,0,0
1683640720187,ENG 15,C00,185675,Staff,0,0,0,0
1683640720187,ENG 15,D00,185682,Staff,0,0,0,0
1683640720187,ENG 15,E00,185684,Staff,0,0,0,0
1683640721216,ETHN 103,A00,185710,Staff,0,8,35,35
1683640722242,ETHN 103A,A00,199228,Man; Simeon S,0,0,9,9
1683640723268,ETHN 109,A00,185711,Staff,16,0,35,19
1683640724294,ETHN 142,A00,185726,Staff,0,4,30,30
1683640725319,ETHN 163J,A00,199229,Man; Simeon S,5,0,8,3
1683640726344,ETHN 168,A00,185727,Staff,7,0,10,3
1683640727374,ETHN 182,A00,185728,Staff,0,0,35,35
1683640728399,ETHN 183,A00,185737,Staff,9,0,18,9
1683640729424,GLBH 111,A01,209361,Burgos; Jose L.,0,0,0,0
1683640731474,HIEU 104,A00,185792,Staff,14,0,20,6
1683640732498,HIEU 115,A00,185800,Staff,0,0,20,20
1683640733523,HIEU 128,A00,185801,Staff,0,9,20,20
1683640734546,HIEU 147,A00,185802,Staff,15,0,20,5
1683640735571,HIEU 154,A00,185823,Staff,11,0,20,9
1683640736597,HILA 102,A00,185826,Staff,14,0,20,6
1683640737626,HILD 2C,A01,185778,Staff,0,13,20,20
1683640738650,HILD 7B,A01,185780,Kwak; Nancy,0,16,32,32
1683640738650,HILD 7B,A02,185781,Kwak; Nancy,0,18,32,32
1683640739679,HILD 30,A01,185791,Staff,12,0,20,8
1683640740709,HISC 119,A00,185830,Golan; Tal,0,9,20,20
1683640741739,HITO 156GS,A00,185831,Patterson; Patrick H.,0,0,0,23
1683640742765,HIUS 103,A00,185832,Man; Simeon S,0,4,20,20
1683640743789,HIUS 117,A00,185836,Kwak; Nancy,2,0,20,18
1683640744817,HIUS 125,A00,185840,Man; Simeon S,0,1,23,23
1683640745841,HIUS 149,A00,185845,Staff,1,0,20,19
1683640746868,HUM 3,A01,185882,Zavodny; Tatiana Sophia,0,7,50,50
1683640746868,HUM 3,B01,185899,Caldwell; Michael Alan,0,18,50,50
1683640747893,HUM 3GS,A00,185900,Patterson; Patrick H.,0,0,0,23
1683640748927,HUM 4,A01,185938,Zroka; Amy Liane,30,0,50,20
1683640748927,HUM 4,B01,185956,Watkins; Eric,0,4,50,50
1683640748927,HUM 4,B02,202209,Watkins; Eric,0,4,50,50
1683640748927,HUM 4,B03,202210,Watkins; Eric,0,4,50,50
1683640749955,HUM 5,A01,185958,West; Geoffrey Scott,2,0,50,48
1683640749955,HUM 5,A02,202215,West; Geoffrey Scott,0,0,50,50
1683640750985,INTL 190,A00,185959,Gagnon; Jeffrey C,0,0,0,9
1683640750985,INTL 190,B00,185960,Lettieri; Michael Joseph,0,0,0,2
1683640752014,JAPN 180,A00,254509,Staff,5,0,30,25
1683640753045,LATI 10,A01,202853,Kennemore; Amy Michelle,4,0,35,31
1683640753045,LATI 10,A02,202854,Kennemore; Amy Michelle,2,0,35,33
1683640753045,LATI 10,A03,270054,Kennemore; Amy Michelle,30,0,30,0
1683640754070,LATI 180,A00,202855,Kennemore; Amy Michelle,11,0,20,9
1683640755095,LAWS 101,A00,201767,Golan; Tal,0,7,40,40
1683640756120,LIFR 1C,A00,185961,Staff,6,0,20,14
1683640757148,LIFR 1CX,A00,185962,Staff,7,0,20,13
1683640758173,LIFR 1D,A00,185963,Staff,7,0,20,13
1683640759199,LIFR 1DX,A00,185964,Staff,7,0,20,13
1683640760228,LIGN 101,A01,186039,Staff,43,0,50,7
1683640761252,LIGN 165,A00,186040,Staff,15,0,50,35
1683640762278,LTCS 108,A00,186041,Staff,5,0,10,5
1683640763302,LTCS 119,A00,186042,Staff,15,0,20,5
1683640764330,LTCS 130,A00,186043,Wesling; Megan E.,15,0,25,10
1683640766379,LTEA 138,A00,186119,Staff,14,0,40,26
1683640767405,LTEN 124,A00,186148,Staff,5,0,25,20
1683640768432,LTEN 178,A00,186149,Staff,7,0,15,8
1683640769456,LTEN 181,A00,186150,Blanco; John D,34,0,40,6
1683640770481,LTWL 120,A00,186160,Staff,20,0,25,5
1683640771511,LTWL 165,A00,186161,Staff,22,0,25,3
1683640772539,LTWR 100,A00,186162,Staff,0,5,15,15
1683640773564,LTWR 102,A00,186163,Doller; Ben,5,0,15,10
1683640774591,MAE 8,A01,186412,Staff,0,0,0,0
1683640775624,MAE 30B,A00,186445,Bahadori; Mohammad Yousef,82,0,100,18
1683640776649,MAE 40,A00,186592,Bewley; Thomas R,10,0,50,40
1683640777679,MAE 101B,A00,186593,Bahadori; Mohammad Yousef,80,0,100,20
1683640778705,MAE 105,A00,186594,Bandaru; Prabhakar,10,0,50,40
1683640779731,MAE 107,A00,186599,Pham; Hieu Tan,0,7,120,120
1683640780756,MAE 148,A01,186660,Silberman; Jack,3,0,16,13
1683640781782,MATH 10A,A01,188095,Staff,0,5,35,35
1683640782815,MATH 10B,A01,188097,Bowers; Adam R.,0,11,30,30
1683640782815,MATH 10B,A02,188099,Bowers; Adam R.,0,11,30,30
1683640782815,MATH 10B,B01,188104,Bowers; Adam R.,0,10,30,30
1683640782815,MATH 10B,B02,188106,Bowers; Adam R.,1,9,30,29
1683640783841,MATH 10C,A01,188111,Staff,0,18,30,30
1683640783841,MATH 10C,A02,188127,Staff,0,19,30,30
1683640783841,MATH 10C,A03,188131,Staff,0,19,30,30
1683640783841,MATH 10C,B01,188218,Staff,17,0,30,13
1683640783841,MATH 10C,B02,188244,Staff,13,0,30,17
1683640783841,MATH 10C,B03,188277,Staff,14,0,30,16
1683640784866,MATH 18,A01,188344,Bach; Quang Tran,18,0,30,12
1683640784866,MATH 18,A02,188345,Bach; Quang Tran,11,0,30,19
1683640784866,MATH 18,B01,188353,Bach; Quang Tran,11,0,30,19
1683640784866,MATH 18,B02,188354,Bach; Quang Tran,19,0,30,11
1683640785895,MATH 20A,A01,188374,Staff,11,0,35,24
1683640786925,MATH 20B,A01,188382,Ohm; Ko Woon,7,0,30,23
1683640786925,MATH 20B,A02,188383,Ohm; Ko Woon,22,0,30,8
1683640786925,MATH 20B,B01,188385,Ohm; Ko Woon,7,0,30,23
1683640786925,MATH 20B,B02,188392,Ohm; Ko Woon,22,0,30,8
1683640787957,MATH 20C,A01,188394,Harel; Guershon,11,0,30,19
1683640787957,MATH 20C,A02,188395,Harel; Guershon,14,0,30,16
1683640787957,MATH 20C,B01,188404,Harel; Guershon,4,0,30,26
1683640787957,MATH 20C,B02,188405,Harel; Guershon,18,0,30,12
1683640788988,MATH 20D,A01,188414,Hammock; Frances H,0,1,30,30
1683640788988,MATH 20D,A02,188415,Hammock; Frances H,0,1,30,30
1683640788988,MATH 20D,B01,188447,Hammock; Frances H,0,1,30,30
1683640788988,MATH 20D,B02,188486,Hammock; Frances H,4,0,30,26
1683640790014,MATH 20E,A01,188649,Staff,21,0,30,9
1683640790014,MATH 20E,A02,188650,Staff,21,0,30,9
1683640790014,MATH 20E,A03,188673,Staff,0,0,30,30
1683640791039,MATH 102,A01,188675,Staff,0,36,35,35
1683640792063,MATH 103B,A01,188681,Staff,3,0,35,32
1683640792063,MATH 103B,B01,188692,Staff,5,0,35,30
1683640793090,MATH 109,A01,188695,Salehi Golsefidy; Alireza,24,0,35,11
1683640793090,MATH 109,A02,188696,Salehi Golsefidy; Alireza,25,0,35,10
1683640794122,MATH 120A,A01,188698,Eggers; John Dietrich,7,0,35,28
1683640795152,MATH 142B,A01,188736,Ioana; Adrian,0,1,30,30
1683640795152,MATH 142B,A02,188741,Ioana; Adrian,0,1,30,30
1683640795152,MATH 142B,A03,188743,Ioana; Adrian,0,1,30,30
1683640796181,MATH 168A,A01,188790,Staff,0,10,35,35
1683640797207,MATH 170A,A01,188803,Nie; Jiawang,0,2,35,35
1683640797207,MATH 170A,A02,188811,Nie; Jiawang,0,0,35,35
1683640797207,MATH 170A,A03,188814,Nie; Jiawang,0,0,35,35
1683640797207,MATH 170A,A04,188815,Nie; Jiawang,10,0,35,25
1683640798230,MATH 193B,A01,188817,Staff,0,0,35,35
1683640798230,MATH 193B,A02,188818,Staff,5,0,35,30
1683640799260,MGT 4,A01,202857,Anderson; John Charles,61,0,80,19
1683640800288,MGT 12,A00,202858,Lindenberger; Wade Douglas,40,0,90,50
1683640801321,MGT 18,A00,202859,Staff,74,0,90,16
1683640802346,MGT 18GS,A00,202860,McKay; Michael J,13,0,28,15
1683640803371,MGT 45,A00,202861,Pecore; Joseph P.,12,0,90,78
1683640804398,MGT 100,A00,202863,Yavorsky; Daniel Ryan,28,0,90,62
1683640805427,MGT 103,A00,202864,Ehrich; Kristine R,0,17,90,90
1683640806450,MGT 112,A00,202865,Ehrich; Kristine R,15,0,90,75
1683640807478,MGT 121A,A00,202868,Staff,0,20,0,0
1683640808505,MGT 131B,A00,202869,Anderson; John Charles,59,0,90,31
1683640809530,MGT 136,A00,202871,Lindenberger; Wade Douglas,83,0,90,7
1683640810554,MGT 164,A00,202873,Staff,0,66,90,91
1683640811583,MGT 164GS,A00,202874,McKay; Mary A,13,0,28,15
1683640812608,MGT 180,A00,202875,Staff,0,50,90,91
1683640813638,MMW 11R,A01,205019,Herbst; Matthew,2,0,30,28
1683640813638,MMW 11R,A02,205026,Herbst; Matthew,29,0,30,1
1683640814663,MMW 15,A01,193512,Chang; Edmond Yi-Teh,0,8,28,28
1683640814663,MMW 15,A02,193513,Chang; Edmond Yi-Teh,0,5,28,28
1683640814663,MMW 15,A03,193514,Chang; Edmond Yi-Teh,0,5,28,28
1683640814663,MMW 15,A04,193515,Chang; Edmond Yi-Teh,0,5,28,28
1683640814663,MMW 15,A05,193516,Chang; Edmond Yi-Teh,0,5,28,28
1683640814663,MMW 15,A06,193517,Chang; Edmond Yi-Teh,0,6,28,28
1683640814663,MMW 15,B01,193519,Chang; Edmond Yi-Teh,0,5,28,28
1683640814663,MMW 15,B02,193520,Chang; Edmond Yi-Teh,0,5,28,28
1683640814663,MMW 15,B03,193521,Chang; Edmond Yi-Teh,0,5,28,28
1683640814663,MMW 15,B04,193522,Chang; Edmond Yi-Teh,0,5,28,28
1683640814663,MMW 15,B05,193523,Chang; Edmond Yi-Teh,0,5,28,28
1683640814663,MMW 15,B06,193524,Chang; Edmond Yi-Teh,0,5,28,28
1683640815687,MMW 122,A01,193526,Rahimi; Babak,0,16,28,28
1683640815687,MMW 122,A02,193527,Rahimi; Babak,0,15,28,28
1683640815687,MMW 122,A03,193528,Rahimi; Babak,0,0,0,0
1683640815687,MMW 122,A04,193529,Rahimi; Babak,0,0,0,0
1683640816712,MUS 1A,A01,186663,Staff,1,20,35,34
1683640817739,MUS 4,A01,186715,Staff,0,12,35,35
1683640818764,MUS 5R,A01,186796,Dubnov; Shlomo,0,17,35,35
1683640819792,MUS 6,A01,186798,Staff,0,5,25,25
1683640820822,MUS 7,A01,186830,Staff,11,0,35,24
1683640821909,MUS 8,A01,186930,Staff,0,26,35,35
1683640822933,MUS 15,A01,186932,Staff,0,16,35,35
1683640822933,MUS 15,B01,186934,Staff,0,17,35,35
1683640823958,MUS 80,A00,186935,Staff,0,0,20,20
1683640823958,MUS 80,B00,186936,Staff,24,0,25,1
1683640824987,NANO 11,A00,204702,Lipomi; Darren John,0,0,0,0
1683640826011,NANO 15,A01,204709,Yang; Kesong,0,1,0,0
1683640827041,NANO 114,A00,202069,Jahed Motlagh; Zeinab,3,0,10,7
1683640828071,PHIL 1,A00,186955,Grush; Rick Scott,31,0,40,9
1683640829096,PHIL 10,A01,186973,Grush; Rick Scott,27,0,35,8
1683640829096,PHIL 10,A02,186974,Grush; Rick Scott,33,0,35,2
1683640830121,PHIL 13,A01,186976,Staff,3,0,35,32
1683640830121,PHIL 13,A02,186977,Staff,16,0,35,19
1683640831147,PHIL 14,A01,186979,Staff,31,0,35,4
1683640831147,PHIL 14,A02,186986,Staff,32,0,35,3
1683640832172,PHIL 28,A01,186988,Staff,16,0,30,14
1683640832172,PHIL 28,A02,186989,Staff,1,0,30,29
1683640832172,PHIL 28,A03,186990,Staff,10,0,30,20
1683640832172,PHIL 28,A04,186991,Staff,26,0,30,4
1683640833200,PHIL 120,A00,186997,Staff,23,0,40,17
1683640834228,PHIL 137,A00,187003,Staff,7,0,40,33
1683640835253,PHIL 150,A00,187015,Staff,47,0,70,23
1683640836278,PHIL 167,A00,187021,Lamey; Andy M.,34,0,40,6
1683640837308,PHIL 174,A01,202226,Staff,17,0,20,3
1683640837308,PHIL 174,A02,202235,Staff,20,0,20,0
1683640838334,PHIL 191A,A00,258918,Staff,0,0,1,1
1683640839366,PHYS 1A,A00,187028,Staff,27,0,60,33
1683640840391,PHYS 1AL,001,187036,Staff,3,0,30,27
1683640840391,PHYS 1AL,002,187049,Staff,18,0,30,12
1683640841419,PHYS 1B,A00,187058,Staff,22,0,60,38
1683640842448,PHYS 1BL,001,187064,Staff,0,1,30,30
1683640842448,PHYS 1BL,002,187070,Staff,4,0,30,26
1683640843472,PHYS 1C,A00,187082,Staff,29,0,120,91
1683640844504,PHYS 1CL,001,187088,Staff,0,9,30,30
1683640844504,PHYS 1CL,002,187089,Staff,0,1,30,30
1683640844504,PHYS 1CL,009,262693,Staff,9,0,30,21
1683640845527,PHYS 2B,A01,187097,Staff,55,0,115,60
1683640846554,PHYS 2C,A01,187099,Staff,64,0,115,51
1683640847583,PHYS 2CL,A01,187101,Staff,5,0,28,23
1683640847583,PHYS 2CL,A02,187102,Staff,15,0,28,13
1683640848609,PHYS 2D,A01,187123,Shotwell; Brian,95,0,115,20
1683640849637,PHYS 4B,A01,187133,Grinstein; Benjamin,35,0,50,15
1683640850661,POLI 10,A00,188819,Staff,0,4,50,50
1683640851688,POLI 11,A00,188827,Staff,43,0,50,7
1683640852714,POLI 13R,A00,188828,Staff,0,1,20,20
1683640853738,POLI 27,A01,188830,Elgin; Samuel Zincke,0,2,70,70
1683640854765,POLI 30,A00,188832,Desposato; Scott,30,0,50,20
1683640855791,POLI 102F,A00,188834,Staff,0,0,40,40
1683640856820,POLI 104A,A00,188852,Staff,13,0,30,17
1683640857845,POLI 104I,A00,188853,Staff,0,7,20,20
1683640858875,POLI 110B,A00,188854,Wiens; David,7,0,20,13
1683640859900,POLI 112A,A00,188855,Wiens; David,4,0,30,26
1683640860929,POLI 117R,A00,188856,Forman; Fonna,0,12,20,20
1683640861956,POLI 118,A00,188857,Ingham; Sean,8,0,20,12
1683640862988,POLI 120G,A00,188858,Staff,8,0,30,22
1683640864015,POLI 131CR,A00,188863,Hoston; Germaine,21,0,50,29
1683640865045,POLI 133,A00,188864,Nellis; Gareth Hb,44,0,50,6
1683640866086,POLI 134D,A00,188865,Desposato; Scott,27,0,30,3
1683640867112,POLI 142A,A00,188871,Gartzke; Erik,21,0,50,29
1683640868138,POLI 142K,A00,188874,Staff,38,0,50,12
1683640869168,POLI 143,A00,188940,Gartzke; Erik,16,0,30,14
1683640870196,POLI 153,A00,188943,Staff,2,0,20,18
1683640871221,POLI 160AA,A00,188944,Staff,11,0,40,29
1683640872249,POLI 170A,A00,188945,Staff,11,0,30,19
1683640874341,PSYC 1,A00,188952,Staff,36,0,90,54
1683640875368,PSYC 2,B00,188953,Staff,19,0,35,16
1683640876393,PSYC 6,A00,188970,Staff,47,0,60,13
1683640877418,PSYC 7,A00,188973,Staff,35,0,45,10
1683640878443,PSYC 60,A01,188980,Rickard; Timothy C.,42,0,60,18
1683640879477,PSYC 70,A01,189001,Steiner; Eric Tomas,23,0,45,22
1683640880505,PSYC 100,A00,189005,Lacefield; Katharine I,0,99,120,120
1683640881539,PSYC 102,A00,189008,Staff,8,0,30,22
1683640882564,PSYC 106,B00,189026,Gorman; Michael R.,27,0,60,33
1683640883596,PSYC 114,B01,189033,Winkielman; Piotr,0,31,30,30
1683640884627,PSYC 131,A00,189036,Anagnostaras; Stephan,0,43,60,60
1683640885659,PSYC 136,A00,189041,Lowe; Angela Beth,0,7,25,25
1683640886693,PSYC 137,A00,189057,Winkielman; Piotr,0,37,25,25
1683640887722,PSYC 144,A00,189107,Wixted; John T,0,10,50,50
1683640889772,PSYC 162,A00,189142,Staff,0,9,85,85
1683640890798,PSYC 172,A00,189144,Gorman; Michael R.,0,6,30,30
1683640892848,PSYC 179,A00,189146,Lacefield; Katharine I,0,86,120,120
1683640893879,PSYC 181,A00,189147,Anagnostaras; Stephan,0,44,90,90
1683640894905,PSYC 190R,A00,189148,Barner; David A.,0,23,80,80
1683640895932,PSYC 191,A00,189275,Rickard; Timothy C.,0,10,25,25
1683640896958,PSYC 193,A00,189276,Chapman; Eddie Nathaniel,0,1,0,4
1683640897989,PSYC 193L,A01,189281,Lowe; Angela Beth,10,0,20,10
1683640897989,PSYC 193L,B01,189285,Staff,28,0,35,7
1683640899013,RELI 149,A00,187137,Rahimi; Babak,7,0,40,33
1683640900046,SE 9,A01,187315,Staff,0,2,18,18
1683640901078,SE 101B,A00,187409,Staff,24,0,30,6
1683640902106,SE 110B,A00,187444,Staff,10,0,40,30
1683640903134,SE 130B,A00,187449,Staff,31,0,40,9
1683640904161,SE 150A,A00,187516,Staff,9,0,20,11
1683640905187,SE 154,A00,187528,Staff,29,0,50,21
1683640906215,SIO 3,A01,258171,Staff,35,0,40,5
1683640907245,SIO 10,A00,187144,Cook; Geoffrey W,0,6,75,75
1683640908272,SIO 45,A00,187152,Cook; Geoffrey W,0,4,100,100
1683640909299,SIO 109R,A00,194486,Staff,0,4,20,20
1683640911356,SIO 187,A01,187233,Kacev; David,12,0,40,28
1683640912387,SOCI 1,A01,258656,Thorpe; Charles Robert,28,0,30,2
1683640912387,SOCI 1,A02,258658,Thorpe; Charles Robert,30,0,30,0
1683640912387,SOCI 1,A03,258661,Thorpe; Charles Robert,25,0,25,0
1683640912387,SOCI 1,A04,258666,Thorpe; Charles Robert,22,0,25,3
1683640912387,SOCI 1,A05,258897,Thorpe; Charles Robert,22,0,25,3
1683640912387,SOCI 1,A06,258898,Thorpe; Charles Robert,25,0,25,0
1683640913410,SOCI 30,A01,258903,Pardo Guerra; Juan Pablo,14,0,30,16
1683640914439,SOCI 102,A00,258904,Staff,9,0,25,16
1683640915464,SOCI 106,A00,258905,Staff,19,0,25,6
1683640916494,SOCI 111,A00,258907,Ribas Norris; Janet Vanesa,26,0,30,4
1683640917519,SOCI 121R,A00,258908,Pardo Guerra; Juan Pablo,8,0,30,22
1683640918547,SOCI 126,A01,203330,Staff,14,0,20,6
1683640919572,SOCI 131,A00,258909,Thorpe; Charles Robert,30,0,60,30
1683640920599,SOCI 135,A00,258910,Payne; Christine Anna,0,11,30,30
1683640921623,SOCI 157,A00,258911,Staff,12,0,30,18
1683640922651,SOCI 184,A00,258912,Staff,25,0,30,5
1683640923677,SOCI 188D,A00,258913,Staff,22,0,30,8
1683640924708,SYN 2,001,187529,Staff,9,0,16,7
1683640924708,SYN 2,002,201452,Staff,0,20,16,16
1683640924708,SYN 2,003,201469,Staff,2,0,16,14
1683640925793,SYN 100,A01,187531,Staff,0,9,20,20
1683640925793,SYN 100,B01,201491,Staff,0,10,20,20
1683640926819,TDAC 1,A00,189286,Walsh; Kim C.,3,0,20,17
1683640926819,TDAC 1,B00,189287,Harting; Carla Kelso,10,0,20,10
1683640927844,TDAC 101,A00,189300,Walsh; Kim C.,16,0,20,4
1683640927844,TDAC 101,B00,189301,Harting; Carla Kelso,18,0,20,2
1683640928869,TDAC 102,A00,189304,Basso; Beatrice,14,0,20,6
1683640929894,TDAC 108,A00,189305,Staff,18,0,20,2
1683640930931,TDDE 131,A00,189310,Staff,19,0,20,1
1683640930931,TDDE 131,B00,189314,Staff,19,0,20,1
1683640930931,TDDE 131,C00,189315,Staff,48,0,50,2
1683640930931,TDDE 131,D00,189316,Staff,14,0,15,1
1683640930931,TDDE 131,E00,204841,Staff,20,0,20,0
1683640931957,TDGE 10,A00,189289,Staff,27,0,50,23
1683640931957,TDGE 10,B00,189290,Havis; Allan,0,0,50,50
1683640932988,TDGE 11,A00,189291,Fulton; Julia,0,4,50,50
1683640932988,TDGE 11,B00,189292,Staff,20,0,25,5
1683640932988,TDGE 11,C00,260270,Staff,0,0,0,0
1683640934012,TDGE 25,A00,189294,Staff,2,0,20,18
1683640935038,TDGE 124,A00,189318,Fulton; Julia,0,8,50,50
1683640936063,TDGE 125,A00,189319,Staff,13,0,25,12
1683640936063,TDGE 125,B00,189320,Staff,23,0,25,2
1683640937087,TDGE 127,A00,189322,Havis; Allan,0,0,50,50
1683640938113,TDHT 101,A00,189323,Staff,18,0,25,7
1683640938113,TDHT 101,B00,189324,Staff,25,0,25,0
1683640939137,TDHT 102,A00,189325,Staff,49,0,50,1
1683640940163,TDMV 1,A00,189295,Arcidiacono; Kristin,20,0,30,10
1683640940163,TDMV 1,B00,189296,Caligagan; Maria T.,24,0,30,6
1683640941188,TDMV 2,A00,189297,Sammartano; Tonnie,27,0,30,3
1683640941188,TDMV 2,B00,189299,Arcidiacono; Kristin,23,0,30,7
1683640942213,TDMV 3,A00,204998,Rincon; Alicia,22,0,30,8
1683640943238,TDMV 120,A00,189458,Sammartano; Tonnie,28,0,30,2
1683640944264,TDMV 138,A00,189541,Jun; Grace Shin Hae,20,0,40,20
1683640945293,TDMV 142,A00,189717,Caligagan; Tony,25,0,30,5
1683640945293,TDMV 142,B00,189718,Caligagan; Maria T.,25,0,30,5
1683640946323,TMC 2,A01,187533,Staff,25,0,25,0
1683640946323,TMC 2,A02,187534,Staff,25,0,25,0
1683640947349,USP 1,A01,187536,Kwak; Nancy,0,16,25,25
1683640948374,USP 5,A01,187538,Staff,9,0,25,16
1683640949400,USP 101,A00,199253,Staff,0,4,0,0
1683640950429,USP 124,A00,187562,Boomhower; Matthew Charles,0,0,30,30
1683640951453,USP 138,A00,187582,Staff,20,0,25,5
1683640952477,USP 152,A01,187597,Staff,3,0,25,22
1683640953505,USP 153,A00,187598,Staff,19,0,25,6
1683640954533,USP 168,A00,187607,Kwak; Nancy,2,0,5,3
1683640955557,USP 173,A00,187619,Staff,4,0,25,21
1683640956582,USP 181,A00,187638,Staff,0,4,25,25
1683640957607,VIS 103,A00,187650,Cruz; Edwin Teddy,18,0,75,57
1683640958631,VIS 110D,A00,187669,Staff,13,0,22,9
1683640959657,VIS 127C,A00,187720,Shen; Kuiyi,67,0,146,79
1683640960682,VIS 149,A00,187731,Yoldas; Pinar,0,14,22,22
1683640961707,VIS 151,A01,188091,Staff,22,0,34,12
1683640961707,VIS 151,A02,188092,Staff,11,0,34,23
1683640962738,VIS 160B,A00,188093,Stalbaum; Brett,0,1,10,10
1683640964798,WCWP 10B,A00,201720,Staff,10,0,15,5
1683640964798,WCWP 10B,B00,201722,Staff,9,0,15,6
1683640965833,WCWP 100,A00,201725,Gagnon; Jeffrey C,0,0,2,2
1683640965833,WCWP 100,B00,201727,Staff,0,4,15,15
1683640968996,ANBI 133,A00,258401,Wilder; Linnea Lorene,34,0,40,6
1683640970022,ANBI 140,A00,258395,Hrvoj Mihic; Branka,18,0,25,7
1683640971055,ANSC 120,A00,258402,Bialecki; Jon Anthony,27,0,40,13
1683640972080,ANSC 144,A00,258400,Staff,12,0,40,28
1683640974137,ANSC 166,A00,258396,Parish; Steven Martin,156,0,175,19
1683640975172,ANSC 180,A00,193533,Staff,8,0,20,12
1683640976201,ANSC 188,A00,258397,Jassal; Aftab,34,0,40,6
1683640977225,ANTH 3,A01,258316,Staff,23,0,30,7
1683640978253,ANTH 5,A00,258394,Semendeferi; Ekaterini,16,0,20,4
1683640979279,ANTH 21,A01,258331,Staff,4,0,40,36
1683640980307,ANTH 103,A00,258398,Varma; Saiba,15,0,25,10
1683640981389,AWP 10,001,202034,Staff,0,0,0,0
1683640981389,AWP 10,002,202035,Staff,0,0,0,0
1683640981389,AWP 10,003,202036,Staff,0,0,0,0
1683640981389,AWP 10,004,202037,Staff,0,0,0,0
1683640981389,AWP 10,005,202038,Staff,0,0,0,0
1683640981389,AWP 10,006,202039,Staff,0,0,0,0
1683640981389,AWP 10,007,202040,Staff,0,0,0,0
1683640981389,AWP 10,008,202041,Staff,0,0,0,0
1683640981389,AWP 10,009,202042,Staff,0,0,0,0
1683640981389,AWP 10,010,202043,Staff,0,0,0,0
1683640981389,AWP 10,011,202044,Staff,0,0,0,0
1683640981389,AWP 10,012,202045,Staff,0,0,0,0
1683640981389,AWP 10,013,202046,Staff,0,0,0,0
1683640981389,AWP 10,014,202047,Staff,0,0,0,0
1683640981389,AWP 10,015,202048,Staff,0,0,0,0
1683640981389,AWP 10,016,202049,Staff,0,0,0,0
1683640981389,AWP 10,017,202050,Staff,0,0,0,0
1683640981389,AWP 10,018,202051,Staff,0,0,0,0
1683640981389,AWP 10,019,202052,Staff,0,0,0,0
1683640981389,AWP 10,020,202053,Staff,0,0,0,0
1683640981389,AWP 10,021,202054,Staff,0,0,0,0
1683640981389,AWP 10,022,202055,Staff,0,0,0,0
1683640981389,AWP 10,023,202056,Staff,0,0,0,0
1683640981389,AWP 10,024,202057,Staff,0,0,0,0
1683640981389,AWP 10,025,202058,Staff,0,0,0,0
1683640981389,AWP 10,026,202059,Staff,0,0,0,0
1683640982416,AWP 102,001,202032,Staff,0,0,0,0
1683640982416,AWP 102,002,202033,Staff,0,0,0,0
1683640983441,BENG 100,A01,254234,Taylor Amos; Alyssa C,31,0,40,9
1683640984471,BENG 196,001,270013,Engler; Adam J.,9999,0,9999,0
1683640985503,BICD 100R,A01,202018,Smith; Laurie,0,7,32,32
1683640985503,BICD 100R,A02,202019,Smith; Laurie,0,3,32,32
1683640985503,BICD 100R,A03,202020,Smith; Laurie,0,1,32,32
1683640985503,BICD 100R,A04,202021,Smith; Laurie,6,0,32,26
1683640985503,BICD 100R,A05,202022,Smith; Laurie,11,0,32,21
1683640986534,BICD 136,A01,193242,Gustafson-Brown; Cindy,0,2,32,32
1683640986534,BICD 136,A02,193244,Gustafson-Brown; Cindy,13,0,32,19
1683640987562,BIEB 102,A01,193249,Butler; Shannon Rhey,0,2,32,32
1683640987562,BIEB 102,A02,193251,Butler; Shannon Rhey,0,0,32,32
1683640987562,BIEB 102,A03,193253,Butler; Shannon Rhey,0,0,32,32
1683640987562,BIEB 102,A04,193255,Butler; Shannon Rhey,14,0,32,18
1683640987562,BIEB 102,A05,193265,Butler; Shannon Rhey,26,0,32,6
1683640987562,BIEB 102,A06,193269,Butler; Shannon Rhey,14,0,32,18
1683640989611,BIEB 150,A01,193274,Staff,0,0,32,32
1683640989611,BIEB 150,A02,193285,Staff,24,0,32,8
1683640990637,BIEB 194,A00,193286,Kurle; Carolyn M.,20,0,32,12
1683640991664,BILD 1,A01,192291,Staff,15,0,32,17
1683640991664,BILD 1,A02,192292,Staff,30,0,32,2
1683640991664,BILD 1,B01,192520,Reuther; Keefe,0,1,0,0
1683640991664,BILD 1,B02,192532,Reuther; Keefe,0,1,0,0
1683640992690,BILD 3,A01,192556,Butler; Shannon Rhey,0,0,32,32
1683640992690,BILD 3,A02,192581,Butler; Shannon Rhey,1,0,32,31
1683640992690,BILD 3,A03,192611,Butler; Shannon Rhey,21,0,32,11
1683640992690,BILD 3,A04,192612,Butler; Shannon Rhey,24,0,32,8
1683640992690,BILD 3,A05,192613,Butler; Shannon Rhey,26,0,32,6
1683640992690,BILD 3,A06,192679,Butler; Shannon Rhey,27,0,32,5
1683640992690,BILD 3,A07,192682,Butler; Shannon Rhey,20,0,32,12
1683640993727,BILD 4,A01,192836,Reuther; Keefe,0,0,24,24
1683640993727,BILD 4,A02,193044,Reuther; Keefe,4,0,24,20
1683640994751,BILD 10,A01,193142,Gustafson-Brown; Cindy,29,0,32,3
1683640994751,BILD 10,A02,193149,Gustafson-Brown; Cindy,31,0,32,1
1683640995781,BIMM 100,A01,193301,Staff,0,6,32,32
1683640995781,BIMM 100,A02,193312,Staff,0,7,32,32
1683640995781,BIMM 100,A03,193323,Staff,0,9,32,32
1683640996813,BIMM 101,A01,193329,McDonnell; Lisa Marie,0,4,24,24
1683640996813,BIMM 101,A02,193339,McDonnell; Lisa Marie,0,3,24,24
1683640996813,BIMM 101,B01,193354,McDonnell; Lisa Marie,0,4,24,24
1683640996813,BIMM 101,B02,193357,McDonnell; Lisa Marie,0,2,24,24
1683640997851,BIMM 110,A01,193377,Tat; John,0,11,32,32
1683640997851,BIMM 110,A02,193378,Tat; John,0,10,32,32
1683640998877,BIMM 120,A01,206116,Staff,0,0,32,32
1683640998877,BIMM 120,A02,206117,Staff,6,0,32,26
1683640998877,BIMM 120,A03,206121,Staff,21,0,32,11
1683640999907,BIPN 100,A01,193393,Park; Ji Young,0,14,32,32
1683640999907,BIPN 100,A02,193402,Park; Ji Young,0,14,32,32
1683640999907,BIPN 100,A03,193413,Park; Ji Young,0,14,32,32
1683640999907,BIPN 100,A04,193414,Park; Ji Young,0,13,32,32
1683641000937,BIPN 102,A01,193429,Staff,0,0,32,32
1683641000937,BIPN 102,A02,193438,Staff,18,0,32,14
1683641001962,BIPN 106,A01,193450,Reyes Gonzalez; Catalina,0,2,40,40
1683641002988,BIPN 134,A01,193465,Cooke; James Edward,0,0,32,32
1683641002988,BIPN 134,A02,193474,Cooke; James Edward,25,0,32,7
1683641002988,BIPN 134,A03,193485,Cooke; James Edward,29,0,32,3
1683641002988,BIPN 134,A04,193486,Cooke; James Edward,20,0,32,12
1683641002988,BIPN 134,A05,193491,Cooke; James Edward,31,0,32,1
1683641002988,BIPN 134,A06,193501,Cooke; James Edward,30,0,32,2
1683641002988,BIPN 134,A07,193510,Cooke; James Edward,29,0,32,3
1683641005042,BISP 194,A00,222522,Staff,14,0,32,18
1683641006068,CAT 124,A01,202407,Staff,19,0,25,6
1683641007101,CAT 125,A00,202408,Marchisotto; Jennifer Anne,2,0,20,18
1683641008128,CAT 125R,A00,202409,Smith; Lauryn Alissa,0,11,20,20
1683641008128,CAT 125R,B00,202410,Morales; Celeste Georgianna,0,11,20,20
1683641008128,CAT 125R,C00,202411,Irwin; Matthew Joseph,0,12,20,20
1683641009156,CENG 15,A01,204712,Yang; Kesong,0,1,0,0
1683641010186,CENG 114,A00,202070,Jahed Motlagh; Zeinab,5,0,20,15
1683641011217,CGS 105,A00,185477,Wesling; Megan E.,24,0,40,16
1683641012248,CGS 106,A00,185494,Staff,11,0,22,11
1683641013280,CGS 108,A00,185495,Staff,14,0,20,6
1683641014304,CGS 114,A00,185496,Staff,13,0,18,5
1683641015333,CGS 119,A00,185501,Staff,15,0,20,5
1683641016359,CGS 120,A00,185511,Staff,12,0,20,8
1683641017384,CHEM 4,A01,184675,Bussey; Thomas J,97,0,100,3
1683641018408,CHEM 6A,A01,184677,Staff,33,0,60,27
1683641019433,CHEM 6B,A01,184679,Staff,63,0,100,37
1683641020465,CHEM 6C,A01,184681,Bussey; Thomas J,0,0,50,50
1683641020465,CHEM 6C,A02,184682,Bussey; Thomas J,32,0,50,18
1683641021490,CHEM 40A,A01,184684,Albizati; Kim F.,35,0,100,65
1683641022518,CHEM 40B,A01,184686,Albizati; Kim F.,0,22,100,100
1683641023543,CHEM 41B,A01,184690,Staff,51,0,100,49
1683641024567,COGS 3,A01,184715,Boyle; Mary E. T.,0,27,40,40
1683641025598,COGS 14B,A01,185172,Staff,0,14,38,38
1683641026629,COGS 18,A01,184736,Staff,15,0,80,65
1683641027655,COGS 100,A01,184932,Staff,0,7,73,73
1683641028682,COGS 101A,A01,184935,Staff,0,39,30,30
1683641029788,COGS 101B,A01,184944,Staff,0,2,30,30
1683641030819,COGS 101C,A01,184946,Staff,0,10,30,30
1683641031845,COGS 102A,A01,184951,Johnson; Christine M.,2,0,40,38
1683641032870,COGS 107B,A01,184953,Mooshagian; Eric Frederick,0,51,40,40
1683641033901,COGS 118B,A01,184959,Gupta; Anjum,0,49,40,40
1683641034930,COGS 153,A00,184961,Staff,0,16,30,30
1683641035957,COGS 177,A00,184962,Staff,0,21,30,30
1683641036984,COGS 187A,A01,184969,Boyle; Mary E. T.,0,19,40,40
1683641038013,COMM 10,A01,185174,Staff,0,5,25,25
1683641038013,COMM 10,A02,185189,Staff,0,2,25,25
1683641038013,COMM 10,A03,269821,Staff,0,1,0,0
1683641039045,COMM 100B,A01,185475,Staff,0,1,0,2
1683641039045,COMM 100B,A02,185476,Staff,12,0,25,13
1683641040074,COMM 100C,A01,185314,Staff,1,0,25,24
1683641040074,COMM 100C,A02,185327,Staff,18,0,25,7
1683641041099,COMM 110M,A00,185349,Staff,0,0,40,40
1683641042123,COMM 113T,A00,185352,Staff,25,0,40,15
1683641043148,COMM 114I,A00,185353,Staff,31,0,40,9
1683641044184,COMM 131,A00,185354,Staff,17,0,30,13
1683641045213,CSE 8A,A50,185358,Cao; Yingjun,0,46,10,10
1683641046241,CSE 8B,A01,185362,Staff,0,48,50,50
1683641047266,CSE 11,A01,185416,Cao; Yingjun,0,91,10,10
1683641048296,CSE 20,A01,185445,Briones; Jor-el Thomas Caparas,4,0,25,21
1683641049324,CSE 21,A01,185447,Staff,9,0,50,41
1683641050356,CSE 101,A01,185451,Staff,0,13,50,50
1683641050356,CSE 101,B01,185453,Jones; Miles E,0,13,50,50
1683641052416,CSE 141,A01,185458,Eldon; John,15,0,100,85
1683641053444,CSE 141L,A01,185461,Eldon; John,7,0,100,93
1683641054472,CSE 142,A01,185463,Staff,36,0,60,24
1683641054472,CSE 142,B01,201355,Staff,0,7,60,60
1683641055502,CSE 142L,A01,185470,Staff,36,0,60,24
1683641055502,CSE 142L,B01,201417,Staff,0,6,60,60
1683641056526,CSE 190,A00,201433,Staff,32,0,49,17
1683641057561,DOC 1,A01,259136,Strom; Megan C.,7,0,15,8
1683641057561,DOC 1,A02,259137,Strom; Megan C.,14,0,15,1
1683641057561,DOC 1,A03,259138,Strom; Megan C.,14,0,15,1
1683641057561,DOC 1,A04,259139,Strom; Megan C.,14,0,15,1
1683641058591,DOC 100D,A00,259140,Pass; Natalye Joann,14,0,25,11
1683641059620,DSGN 1,A01,184749,Rill; Bryan,0,26,30,30
1683641060646,DSGN 100,A01,185168,Staff,0,2,25,25
1683641061678,ECE 5,A01,185626,Morris; Karcher William,0,11,0,0
1683641062703,ECE 101,A01,185628,Staff,14,0,70,56
1683641063728,ECE 107,A01,185635,Baghdadchi; Saharnaz,0,0,20,20
1683641063728,ECE 107,A02,185638,Baghdadchi; Saharnaz,3,0,20,17
1683641064753,ECE 148,A01,185647,Silberman; Jack,0,0,16,16
1683641065779,ECON 1,A01,185537,Crane; Meredith Helen,54,0,70,16
1683641066809,ECON 3,A01,185549,Crane; Meredith Helen,29,0,70,41
1683641067835,ECON 4,A01,203354,Anderson; John Charles,0,5,10,10
1683641068863,ECON 100A,A01,185574,Staff,0,5,40,40
1683641069894,ECON 100B,A01,185576,Staff,0,12,50,50
1683641070923,ECON 100C,A01,185589,Newhouse; Herbert S,30,0,70,40
1683641071949,ECON 105,A00,185608,Vespa; Emanuel Ignacio,19,0,35,16
1683641072977,ECON 109,A01,185610,Shishkin; Denis,9,0,35,26
1683641074004,ECON 110A,A01,185612,Staff,9,0,40,31
1683641075030,ECON 120A,A01,185615,Staff,20,0,40,20
1683641076056,ECON 120C,A01,185617,Sun; Yixiao,0,20,70,70
1683641077079,ECON 144,A00,203346,Squires; Dale E,2,0,35,33
1683641078104,ECON 171,A01,203349,Newhouse; Herbert S,0,1,35,35
1683641079129,ECON 173A,A01,185621,Toda; Alexis Akira,21,0,35,14
1683641080153,EDS 25,A01,202413,Staff,0,1,0,0
1683641080153,EDS 25,A02,202414,Staff,0,1,0,0
1683641080153,EDS 25,A03,202415,Staff,0,0,0,0
1683641080153,EDS 25,A04,202416,Staff,0,1,0,0
1683641080153,EDS 25,A05,202439,Staff,0,0,0,0
1683641080153,EDS 25,A06,202440,Staff,0,0,0,0
1683641080153,EDS 25,B01,202631,Staff,0,0,0,0
1683641080153,EDS 25,B02,202632,Staff,0,0,0,0
1683641080153,EDS 25,B03,202639,Staff,0,0,0,0
1683641080153,EDS 25,B04,202640,Staff,0,0,0,0
1683641080153,EDS 25,B05,202643,Staff,0,0,0,0
1683641080153,EDS 25,B06,202644,Staff,0,0,0,0
1683641081184,EDS 38,A01,202659,Black; Alison Michelle,24,0,25,1
1683641082211,EDS 115,A00,202652,Staff,18,0,30,12
1683641083237,EDS 125,A00,202649,Staff,13,0,30,17
1683641084265,EDS 126,A01,203332,Staff,30,0,30,0
1683641085292,EDS 139,A00,202838,Staff,16,0,25,9
1683641086316,EDS 146,A01,202655,Staff,14,0,25,11
1683641087346,ENG 15,A00,185667,Staff,0,1,0,0
1683641087346,ENG 15,B00,185672,Staff,0,0,0,0
1683641087346,ENG 15,C00,185675,Staff,0,0,0,0
1683641087346,ENG 15,D00,185682,Staff,0,0,0,0
1683641087346,ENG 15,E00,185684,Staff,0,0,0,0
1683641088371,ETHN 103,A00,185710,Staff,0,8,35,35
1683641089401,ETHN 103A,A00,199228,Man; Simeon S,0,0,9,9
1683641090433,ETHN 109,A00,185711,Staff,16,0,35,19
1683641091457,ETHN 142,A00,185726,Staff,0,4,30,30
1683641092487,ETHN 163J,A00,199229,Man; Simeon S,5,0,8,3
1683641093514,ETHN 168,A00,185727,Staff,7,0,10,3
1683641094539,ETHN 182,A00,185728,Staff,0,0,35,35
1683641095578,ETHN 183,A00,185737,Staff,9,0,18,9
1683641096603,GLBH 111,A01,209361,Burgos; Jose L.,0,0,0,0
1683641098655,HIEU 104,A00,185792,Staff,14,0,20,6
1683641099680,HIEU 115,A00,185800,Staff,0,0,20,20
1683641100709,HIEU 128,A00,185801,Staff,0,9,20,20
1683641101738,HIEU 147,A00,185802,Staff,15,0,20,5
1683641102765,HIEU 154,A00,185823,Staff,11,0,20,9
1683641103791,HILA 102,A00,185826,Staff,14,0,20,6
1683641104820,HILD 2C,A01,185778,Staff,0,13,20,20
1683641105846,HILD 7B,A01,185780,Kwak; Nancy,0,16,32,32
1683641105846,HILD 7B,A02,185781,Kwak; Nancy,0,18,32,32
1683641106877,HILD 30,A01,185791,Staff,12,0,20,8
1683641107902,HISC 119,A00,185830,Golan; Tal,0,9,20,20
1683641108927,HITO 156GS,A00,185831,Patterson; Patrick H.,0,0,0,23
1683641109956,HIUS 103,A00,185832,Man; Simeon S,0,4,20,20
1683641110984,HIUS 117,A00,185836,Kwak; Nancy,2,0,20,18
1683641112009,HIUS 125,A00,185840,Man; Simeon S,0,1,23,23
1683641113033,HIUS 149,A00,185845,Staff,1,0,20,19
1683641114068,HUM 3,A01,185882,Zavodny; Tatiana Sophia,0,7,50,50
1683641114068,HUM 3,B01,185899,Caldwell; Michael Alan,0,18,50,50
1683641115093,HUM 3GS,A00,185900,Patterson; Patrick H.,0,0,0,23
1683641116126,HUM 4,A01,185938,Zroka; Amy Liane,30,0,50,20
1683641116126,HUM 4,B01,185956,Watkins; Eric,0,4,50,50
1683641116126,HUM 4,B02,202209,Watkins; Eric,0,4,50,50
1683641116126,HUM 4,B03,202210,Watkins; Eric,0,4,50,50
1683641117161,HUM 5,A01,185958,West; Geoffrey Scott,2,0,50,48
1683641117161,HUM 5,A02,202215,West; Geoffrey Scott,0,0,50,50
1683641118186,INTL 190,A00,185959,Gagnon; Jeffrey C,0,0,0,9
1683641118186,INTL 190,B00,185960,Lettieri; Michael Joseph,0,0,0,2
1683641119212,JAPN 180,A00,254509,Staff,5,0,30,25
1683641120238,LATI 10,A01,202853,Kennemore; Amy Michelle,4,0,35,31
1683641120238,LATI 10,A02,202854,Kennemore; Amy Michelle,2,0,35,33
1683641120238,LATI 10,A03,270054,Kennemore; Amy Michelle,30,0,30,0
1683641121263,LATI 180,A00,202855,Kennemore; Amy Michelle,11,0,20,9
1683641122288,LAWS 101,A00,201767,Golan; Tal,0,7,40,40
1683641123313,LIFR 1C,A00,185961,Staff,6,0,20,14
1683641124347,LIFR 1CX,A00,185962,Staff,7,0,20,13
1683641125375,LIFR 1D,A00,185963,Staff,7,0,20,13
1683641126398,LIFR 1DX,A00,185964,Staff,7,0,20,13
1683641127425,LIGN 101,A01,186039,Staff,43,0,50,7
1683641128451,LIGN 165,A00,186040,Staff,15,0,50,35
1683641129480,LTCS 108,A00,186041,Staff,5,0,10,5
1683641130507,LTCS 119,A00,186042,Staff,15,0,20,5
1683641131531,LTCS 130,A00,186043,Wesling; Megan E.,15,0,25,10
1683641133645,LTEA 138,A00,186119,Staff,14,0,40,26
1683641134670,LTEN 124,A00,186148,Staff,5,0,25,20
1683641135698,LTEN 178,A00,186149,Staff,7,0,15,8
1683641136724,LTEN 181,A00,186150,Blanco; John D,34,0,40,6
1683641137749,LTWL 120,A00,186160,Staff,20,0,25,5
1683641138777,LTWL 165,A00,186161,Staff,22,0,25,3
1683641139802,LTWR 100,A00,186162,Staff,0,5,15,15
1683641140828,LTWR 102,A00,186163,Doller; Ben,5,0,15,10
1683641141854,MAE 8,A01,186412,Staff,0,0,0,0
1683641142879,MAE 30B,A00,186445,Bahadori; Mohammad Yousef,82,0,100,18
1683641143908,MAE 40,A00,186592,Bewley; Thomas R,10,0,50,40
1683641144933,MAE 101B,A00,186593,Bahadori; Mohammad Yousef,80,0,100,20
1683641145963,MAE 105,A00,186594,Bandaru; Prabhakar,10,0,50,40
1683641146990,MAE 107,A00,186599,Pham; Hieu Tan,0,7,120,120
1683641148014,MAE 148,A01,186660,Silberman; Jack,3,0,16,13
1683641149040,MATH 10A,A01,188095,Staff,0,5,35,35
1683641150073,MATH 10B,A01,188097,Bowers; Adam R.,0,11,30,30
1683641150073,MATH 10B,A02,188099,Bowers; Adam R.,0,11,30,30
1683641150073,MATH 10B,B01,188104,Bowers; Adam R.,0,10,30,30
1683641150073,MATH 10B,B02,188106,Bowers; Adam R.,1,9,30,29
1683641151099,MATH 10C,A01,188111,Staff,0,18,30,30
1683641151099,MATH 10C,A02,188127,Staff,0,19,30,30
1683641151099,MATH 10C,A03,188131,Staff,0,19,30,30
1683641151099,MATH 10C,B01,188218,Staff,17,0,30,13
1683641151099,MATH 10C,B02,188244,Staff,13,0,30,17
1683641151099,MATH 10C,B03,188277,Staff,14,0,30,16
1683641152125,MATH 18,A01,188344,Bach; Quang Tran,18,0,30,12
1683641152125,MATH 18,A02,188345,Bach; Quang Tran,11,0,30,19
1683641152125,MATH 18,B01,188353,Bach; Quang Tran,11,0,30,19
1683641152125,MATH 18,B02,188354,Bach; Quang Tran,19,0,30,11
1683641153150,MATH 20A,A01,188374,Staff,11,0,35,24
1683641154181,MATH 20B,A01,188382,Ohm; Ko Woon,7,0,30,23
1683641154181,MATH 20B,A02,188383,Ohm; Ko Woon,22,0,30,8
1683641154181,MATH 20B,B01,188385,Ohm; Ko Woon,7,0,30,23
1683641154181,MATH 20B,B02,188392,Ohm; Ko Woon,22,0,30,8
1683641155205,MATH 20C,A01,188394,Harel; Guershon,11,0,30,19
1683641155205,MATH 20C,A02,188395,Harel; Guershon,14,0,30,16
1683641155205,MATH 20C,B01,188404,Harel; Guershon,4,0,30,26
1683641155205,MATH 20C,B02,188405,Harel; Guershon,18,0,30,12
1683641156231,MATH 20D,A01,188414,Hammock; Frances H,0,1,30,30
1683641156231,MATH 20D,A02,188415,Hammock; Frances H,0,1,30,30
1683641156231,MATH 20D,B01,188447,Hammock; Frances H,0,1,30,30
1683641156231,MATH 20D,B02,188486,Hammock; Frances H,4,0,30,26
1683641157257,MATH 20E,A01,188649,Staff,21,0,30,9
1683641157257,MATH 20E,A02,188650,Staff,21,0,30,9
1683641157257,MATH 20E,A03,188673,Staff,0,0,30,30
1683641158280,MATH 102,A01,188675,Staff,0,36,35,35
1683641159309,MATH 103B,A01,188681,Staff,3,0,35,32
1683641159309,MATH 103B,B01,188692,Staff,5,0,35,30
1683641160337,MATH 109,A01,188695,Salehi Golsefidy; Alireza,24,0,35,11
1683641160337,MATH 109,A02,188696,Salehi Golsefidy; Alireza,25,0,35,10
1683641161365,MATH 120A,A01,188698,Eggers; John Dietrich,7,0,35,28
1683641162391,MATH 142B,A01,188736,Ioana; Adrian,0,1,30,30
1683641162391,MATH 142B,A02,188741,Ioana; Adrian,0,1,30,30
1683641162391,MATH 142B,A03,188743,Ioana; Adrian,0,1,30,30
1683641163417,MATH 168A,A01,188790,Staff,0,10,35,35
1683641164445,MATH 170A,A01,188803,Nie; Jiawang,0,2,35,35
1683641164445,MATH 170A,A02,188811,Nie; Jiawang,0,0,35,35
1683641164445,MATH 170A,A03,188814,Nie; Jiawang,0,0,35,35
1683641164445,MATH 170A,A04,188815,Nie; Jiawang,10,0,35,25
1683641165470,MATH 193B,A01,188817,Staff,0,0,35,35
1683641165470,MATH 193B,A02,188818,Staff,5,0,35,30
1683641166499,MGT 4,A01,202857,Anderson; John Charles,61,0,80,19
1683641167524,MGT 12,A00,202858,Lindenberger; Wade Douglas,40,0,90,50
1683641168551,MGT 18,A00,202859,Staff,74,0,90,16
1683641169577,MGT 18GS,A00,202860,McKay; Michael J,13,0,28,15
1683641170603,MGT 45,A00,202861,Pecore; Joseph P.,12,0,90,78
1683641171629,MGT 100,A00,202863,Yavorsky; Daniel Ryan,28,0,90,62
1683641172655,MGT 103,A00,202864,Ehrich; Kristine R,0,17,90,90
1683641173679,MGT 112,A00,202865,Ehrich; Kristine R,15,0,90,75
1683641174704,MGT 121A,A00,202868,Staff,0,20,0,0
1683641175732,MGT 131B,A00,202869,Anderson; John Charles,59,0,90,31
1683641176758,MGT 136,A00,202871,Lindenberger; Wade Douglas,83,0,90,7
1683641177786,MGT 164,A00,202873,Staff,0,66,90,91
1683641178810,MGT 164GS,A00,202874,McKay; Mary A,13,0,28,15
1683641179839,MGT 180,A00,202875,Staff,0,50,90,91
1683641180867,MMW 11R,A01,205019,Herbst; Matthew,2,0,30,28
1683641180867,MMW 11R,A02,205026,Herbst; Matthew,29,0,30,1
1683641181893,MMW 15,A01,193512,Chang; Edmond Yi-Teh,0,8,28,28
1683641181893,MMW 15,A02,193513,Chang; Edmond Yi-Teh,0,5,28,28
1683641181893,MMW 15,A03,193514,Chang; Edmond Yi-Teh,0,5,28,28
1683641181893,MMW 15,A04,193515,Chang; Edmond Yi-Teh,0,5,28,28
1683641181893,MMW 15,A05,193516,Chang; Edmond Yi-Teh,0,5,28,28
1683641181893,MMW 15,A06,193517,Chang; Edmond Yi-Teh,0,6,28,28
1683641181893,MMW 15,B01,193519,Chang; Edmond Yi-Teh,0,5,28,28
1683641181893,MMW 15,B02,193520,Chang; Edmond Yi-Teh,0,5,28,28
1683641181893,MMW 15,B03,193521,Chang; Edmond Yi-Teh,0,5,28,28
1683641181893,MMW 15,B04,193522,Chang; Edmond Yi-Teh,0,5,28,28
1683641181893,MMW 15,B05,193523,Chang; Edmond Yi-Teh,0,5,28,28
1683641181893,MMW 15,B06,193524,Chang; Edmond Yi-Teh,0,5,28,28
1683641182923,MMW 122,A01,193526,Rahimi; Babak,0,16,28,28
1683641182923,MMW 122,A02,193527,Rahimi; Babak,0,15,28,28
1683641182923,MMW 122,A03,193528,Rahimi; Babak,0,0,0,0
1683641182923,MMW 122,A04,193529,Rahimi; Babak,0,0,0,0
1683641183951,MUS 1A,A01,186663,Staff,1,20,35,34
1683641184976,MUS 4,A01,186715,Staff,0,12,35,35
1683641186001,MUS 5R,A01,186796,Dubnov; Shlomo,0,17,35,35
1683641187027,MUS 6,A01,186798,Staff,0,5,25,25
1683641188052,MUS 7,A01,186830,Staff,11,0,35,24
1683641189080,MUS 8,A01,186930,Staff,0,26,35,35
1683641190106,MUS 15,A01,186932,Staff,0,16,35,35
1683641190106,MUS 15,B01,186934,Staff,0,17,35,35
1683641191133,MUS 80,A00,186935,Staff,0,0,20,20
1683641191133,MUS 80,B00,186936,Staff,24,0,25,1
1683641192159,NANO 11,A00,204702,Lipomi; Darren John,0,0,0,0
1683641193190,NANO 15,A01,204709,Yang; Kesong,0,1,0,0
1683641194214,NANO 114,A00,202069,Jahed Motlagh; Zeinab,3,0,10,7
1683641195239,PHIL 1,A00,186955,Grush; Rick Scott,31,0,40,9
1683641196264,PHIL 10,A01,186973,Grush; Rick Scott,27,0,35,8
1683641196264,PHIL 10,A02,186974,Grush; Rick Scott,33,0,35,2
1683641197293,PHIL 13,A01,186976,Staff,3,0,35,32
1683641197293,PHIL 13,A02,186977,Staff,16,0,35,19
1683641198318,PHIL 14,A01,186979,Staff,31,0,35,4
1683641198318,PHIL 14,A02,186986,Staff,32,0,35,3
1683641199349,PHIL 28,A01,186988,Staff,16,0,30,14
1683641199349,PHIL 28,A02,186989,Staff,1,0,30,29
1683641199349,PHIL 28,A03,186990,Staff,10,0,30,20
1683641199349,PHIL 28,A04,186991,Staff,26,0,30,4
1683641200376,PHIL 120,A00,186997,Staff,23,0,40,17
1683641201402,PHIL 137,A00,187003,Staff,7,0,40,33
1683641202427,PHIL 150,A00,187015,Staff,47,0,70,23
1683641203451,PHIL 167,A00,187021,Lamey; Andy M.,34,0,40,6
1683641204502,PHIL 174,A01,202226,Staff,17,0,20,3
1683641204502,PHIL 174,A02,202235,Staff,20,0,20,0
1683641205529,PHIL 191A,A00,258918,Staff,0,0,1,1
1683641206554,PHYS 1A,A00,187028,Staff,27,0,60,33
1683641207579,PHYS 1AL,001,187036,Staff,3,0,30,27
1683641207579,PHYS 1AL,002,187049,Staff,18,0,30,12
1683641208604,PHYS 1B,A00,187058,Staff,22,0,60,38
1683641209629,PHYS 1BL,001,187064,Staff,0,1,30,30
1683641209629,PHYS 1BL,002,187070,Staff,4,0,30,26
1683641210657,PHYS 1C,A00,187082,Staff,29,0,120,91
1683641211682,PHYS 1CL,001,187088,Staff,0,9,30,30
1683641211682,PHYS 1CL,002,187089,Staff,0,1,30,30
1683641211682,PHYS 1CL,009,262693,Staff,9,0,30,21
1683641212711,PHYS 2B,A01,187097,Staff,55,0,115,60
1683641213736,PHYS 2C,A01,187099,Staff,64,0,115,51
1683641214769,PHYS 2CL,A01,187101,Staff,5,0,28,23
1683641214769,PHYS 2CL,A02,187102,Staff,15,0,28,13
1683641215797,PHYS 2D,A01,187123,Shotwell; Brian,95,0,115,20
1683641216822,PHYS 4B,A01,187133,Grinstein; Benjamin,35,0,50,15
1683641217850,POLI 10,A00,188819,Staff,0,4,50,50
1683641218874,POLI 11,A00,188827,Staff,43,0,50,7
1683641219897,POLI 13R,A00,188828,Staff,0,1,20,20
1683641220927,POLI 27,A01,188830,Elgin; Samuel Zincke,0,2,70,70
1683641221955,POLI 30,A00,188832,Desposato; Scott,30,0,50,20
1683641222985,POLI 102F,A00,188834,Staff,0,0,40,40
1683641224010,POLI 104A,A00,188852,Staff,13,0,30,17
1683641225038,POLI 104I,A00,188853,Staff,0,7,20,20
1683641226066,POLI 110B,A00,188854,Wiens; David,7,0,20,13
1683641227091,POLI 112A,A00,188855,Wiens; David,4,0,30,26
1683641228116,POLI 117R,A00,188856,Forman; Fonna,0,12,20,20
1683641229139,POLI 118,A00,188857,Ingham; Sean,8,0,20,12
1683641230162,POLI 120G,A00,188858,Staff,8,0,30,22
1683641231186,POLI 131CR,A00,188863,Hoston; Germaine,21,0,50,29
1683641232217,POLI 133,A00,188864,Nellis; Gareth Hb,44,0,50,6
1683641233244,POLI 134D,A00,188865,Desposato; Scott,27,0,30,3
1683641234269,POLI 142A,A00,188871,Gartzke; Erik,21,0,50,29
1683641235294,POLI 142K,A00,188874,Staff,38,0,50,12
1683641236318,POLI 143,A00,188940,Gartzke; Erik,16,0,30,14
1683641237399,POLI 153,A00,188943,Staff,2,0,20,18
1683641238429,POLI 160AA,A00,188944,Staff,11,0,40,29
1683641239455,POLI 170A,A00,188945,Staff,11,0,30,19
1683641241504,PSYC 1,A00,188952,Staff,36,0,90,54
1683641242530,PSYC 2,B00,188953,Staff,19,0,35,16
1683641243555,PSYC 6,A00,188970,Staff,47,0,60,13
1683641244582,PSYC 7,A00,188973,Staff,35,0,45,10
1683641245608,PSYC 60,A01,188980,Rickard; Timothy C.,42,0,60,18
1683641246633,PSYC 70,A01,189001,Steiner; Eric Tomas,23,0,45,22
1683641247658,PSYC 100,A00,189005,Lacefield; Katharine I,0,99,120,120
1683641248685,PSYC 102,A00,189008,Staff,8,0,30,22
1683641249709,PSYC 106,B00,189026,Gorman; Michael R.,27,0,60,33
1683641250738,PSYC 114,B01,189033,Winkielman; Piotr,0,31,30,30
1683641251762,PSYC 131,A00,189036,Anagnostaras; Stephan,0,43,60,60
1683641252786,PSYC 136,A00,189041,Lowe; Angela Beth,0,7,25,25
1683641253814,PSYC 137,A00,189057,Winkielman; Piotr,0,37,25,25
1683641254838,PSYC 144,A00,189107,Wixted; John T,0,10,50,50
1683641256889,PSYC 162,A00,189142,Staff,0,9,85,85
1683641257917,PSYC 172,A00,189144,Gorman; Michael R.,0,6,30,30
1683641259963,PSYC 179,A00,189146,Lacefield; Katharine I,0,86,120,120
1683641260987,PSYC 181,A00,189147,Anagnostaras; Stephan,0,44,90,90
1683641262010,PSYC 190R,A00,189148,Barner; David A.,0,23,80,80
1683641263036,PSYC 191,A00,189275,Rickard; Timothy C.,0,10,25,25
1683641264061,PSYC 193,A00,189276,Chapman; Eddie Nathaniel,0,1,0,4
1683641265087,PSYC 193L,A01,189281,Lowe; Angela Beth,10,0,20,10
1683641265087,PSYC 193L,B01,189285,Staff,28,0,35,7
1683641266111,RELI 149,A00,187137,Rahimi; Babak,7,0,40,33
1683641267140,SE 9,A01,187315,Staff,0,2,18,18
1683641268166,SE 101B,A00,187409,Staff,24,0,30,6
1683641269190,SE 110B,A00,187444,Staff,10,0,40,30
1683641270220,SE 130B,A00,187449,Staff,31,0,40,9
1683641271245,SE 150A,A00,187516,Staff,9,0,20,11
1683641272273,SE 154,A00,187528,Staff,29,0,50,21
1683641273302,SIO 3,A01,258171,Staff,35,0,40,5
1683641274327,SIO 10,A00,187144,Cook; Geoffrey W,0,6,75,75
1683641275355,SIO 45,A00,187152,Cook; Geoffrey W,0,4,100,100
1683641276381,SIO 109R,A00,194486,Staff,0,4,20,20
1683641278439,SIO 187,A01,187233,Kacev; David,12,0,40,28
1683641279466,SOCI 1,A01,258656,Thorpe; Charles Robert,28,0,30,2
1683641279466,SOCI 1,A02,258658,Thorpe; Charles Robert,30,0,30,0
1683641279466,SOCI 1,A03,258661,Thorpe; Charles Robert,25,0,25,0
1683641279466,SOCI 1,A04,258666,Thorpe; Charles Robert,22,0,25,3
1683641279466,SOCI 1,A05,258897,Thorpe; Charles Robert,22,0,25,3
1683641279466,SOCI 1,A06,258898,Thorpe; Charles Robert,25,0,25,0
1683641280490,SOCI 30,A01,258903,Pardo Guerra; Juan Pablo,14,0,30,16
1683641281514,SOCI 102,A00,258904,Staff,9,0,25,16
1683641282539,SOCI 106,A00,258905,Staff,19,0,25,6
1683641283566,SOCI 111,A00,258907,Ribas Norris; Janet Vanesa,26,0,30,4
1683641284594,SOCI 121R,A00,258908,Pardo Guerra; Juan Pablo,8,0,30,22
1683641285623,SOCI 126,A01,203330,Staff,14,0,20,6
1683641286646,SOCI 131,A00,258909,Thorpe; Charles Robert,30,0,60,30
1683641287671,SOCI 135,A00,258910,Payne; Christine Anna,0,11,30,30
1683641288699,SOCI 157,A00,258911,Staff,12,0,30,18
1683641289725,SOCI 184,A00,258912,Staff,25,0,30,5
1683641290752,SOCI 188D,A00,258913,Staff,22,0,30,8
1683641291777,SYN 2,001,187529,Staff,9,0,16,7
1683641291777,SYN 2,002,201452,Staff,0,20,16,16
1683641291777,SYN 2,003,201469,Staff,2,0,16,14
1683641292807,SYN 100,A01,187531,Staff,0,9,20,20
1683641292807,SYN 100,B01,201491,Staff,0,10,20,20
1683641293833,TDAC 1,A00,189286,Walsh; Kim C.,3,0,20,17
1683641293833,TDAC 1,B00,189287,Harting; Carla Kelso,10,0,20,10
1683641294857,TDAC 101,A00,189300,Walsh; Kim C.,16,0,20,4
1683641294857,TDAC 101,B00,189301,Harting; Carla Kelso,18,0,20,2
1683641295889,TDAC 102,A00,189304,Basso; Beatrice,14,0,20,6
1683641296913,TDAC 108,A00,189305,Staff,18,0,20,2
1683641297941,TDDE 131,A00,189310,Staff,19,0,20,1
1683641297941,TDDE 131,B00,189314,Staff,19,0,20,1
1683641297941,TDDE 131,C00,189315,Staff,48,0,50,2
1683641297941,TDDE 131,D00,189316,Staff,14,0,15,1
1683641297941,TDDE 131,E00,204841,Staff,20,0,20,0
1683641298969,TDGE 10,A00,189289,Staff,27,0,50,23
1683641298969,TDGE 10,B00,189290,Havis; Allan,0,0,50,50
1683641299999,TDGE 11,A00,189291,Fulton; Julia,0,4,50,50
1683641299999,TDGE 11,B00,189292,Staff,20,0,25,5
1683641299999,TDGE 11,C00,260270,Staff,0,0,0,0
1683641301023,TDGE 25,A00,189294,Staff,2,0,20,18
1683641302049,TDGE 124,A00,189318,Fulton; Julia,0,8,50,50
1683641303078,TDGE 125,A00,189319,Staff,13,0,25,12
1683641303078,TDGE 125,B00,189320,Staff,23,0,25,2
1683641304104,TDGE 127,A00,189322,Havis; Allan,0,0,50,50
1683641305130,TDHT 101,A00,189323,Staff,18,0,25,7
1683641305130,TDHT 101,B00,189324,Staff,25,0,25,0
1683641306156,TDHT 102,A00,189325,Staff,49,0,50,1
1683641307181,TDMV 1,A00,189295,Arcidiacono; Kristin,20,0,30,10
1683641307181,TDMV 1,B00,189296,Caligagan; Maria T.,24,0,30,6
1683641308209,TDMV 2,A00,189297,Sammartano; Tonnie,27,0,30,3
1683641308209,TDMV 2,B00,189299,Arcidiacono; Kristin,23,0,30,7
1683641309234,TDMV 3,A00,204998,Rincon; Alicia,22,0,30,8
1683641310262,TDMV 120,A00,189458,Sammartano; Tonnie,28,0,30,2
1683641311288,TDMV 138,A00,189541,Jun; Grace Shin Hae,20,0,40,20
1683641312313,TDMV 142,A00,189717,Caligagan; Tony,25,0,30,5
1683641312313,TDMV 142,B00,189718,Caligagan; Maria T.,25,0,30,5
1683641313339,TMC 2,A01,187533,Staff,25,0,25,0
1683641313339,TMC 2,A02,187534,Staff,25,0,25,0
1683641314363,USP 1,A01,187536,Kwak; Nancy,0,16,25,25
1683641315392,USP 5,A01,187538,Staff,9,0,25,16
1683641316418,USP 101,A00,199253,Staff,0,4,0,0
1683641317443,USP 124,A00,187562,Boomhower; Matthew Charles,0,0,30,30
1683641318467,USP 138,A00,187582,Staff,20,0,25,5
1683641319495,USP 152,A01,187597,Staff,3,0,25,22
1683641320519,USP 153,A00,187598,Staff,19,0,25,6
1683641321546,USP 168,A00,187607,Kwak; Nancy,2,0,5,3
1683641322570,USP 173,A00,187619,Staff,4,0,25,21
1683641323593,USP 181,A00,187638,Staff,0,4,25,25
1683641324621,VIS 103,A00,187650,Cruz; Edwin Teddy,18,0,75,57
1683641325645,VIS 110D,A00,187669,Staff,13,0,22,9
1683641326671,VIS 127C,A00,187720,Shen; Kuiyi,67,0,146,79
1683641327697,VIS 149,A00,187731,Yoldas; Pinar,0,14,22,22
1683641328722,VIS 151,A01,188091,Staff,22,0,34,12
1683641328722,VIS 151,A02,188092,Staff,11,0,34,23
1683641329751,VIS 160B,A00,188093,Stalbaum; Brett,0,1,10,10
1683641331811,WCWP 10B,A00,201720,Staff,10,0,15,5
1683641331811,WCWP 10B,B00,201722,Staff,9,0,15,6
1683641332836,WCWP 100,A00,201725,Gagnon; Jeffrey C,0,0,2,2
1683641332836,WCWP 100,B00,201727,Staff,0,4,15,15
1683641335941,ANBI 133,A00,258401,Wilder; Linnea Lorene,34,0,40,6
1683641336966,ANBI 140,A00,258395,Hrvoj Mihic; Branka,18,0,25,7
1683641337990,ANSC 120,A00,258402,Bialecki; Jon Anthony,27,0,40,13
1683641339018,ANSC 144,A00,258400,Staff,12,0,40,28
1683641341126,ANSC 166,A00,258396,Parish; Steven Martin,156,0,175,19
1683641342154,ANSC 180,A00,193533,Staff,8,0,20,12
1683641343185,ANSC 188,A00,258397,Jassal; Aftab,34,0,40,6
1683641344214,ANTH 3,A01,258316,Staff,23,0,30,7
1683641345240,ANTH 5,A00,258394,Semendeferi; Ekaterini,16,0,20,4
1683641346264,ANTH 21,A01,258331,Staff,4,0,40,36
1683641347289,ANTH 103,A00,258398,Varma; Saiba,15,0,25,10
1683641348323,AWP 10,001,202034,Staff,0,0,0,0
1683641348323,AWP 10,002,202035,Staff,0,0,0,0
1683641348323,AWP 10,003,202036,Staff,0,0,0,0
1683641348323,AWP 10,004,202037,Staff,0,0,0,0
1683641348323,AWP 10,005,202038,Staff,0,0,0,0
1683641348323,AWP 10,006,202039,Staff,0,0,0,0
1683641348323,AWP 10,007,202040,Staff,0,0,0,0
1683641348323,AWP 10,008,202041,Staff,0,0,0,0
1683641348323,AWP 10,009,202042,Staff,0,0,0,0
1683641348323,AWP 10,010,202043,Staff,0,0,0,0
1683641348323,AWP 10,011,202044,Staff,0,0,0,0
1683641348323,AWP 10,012,202045,Staff,0,0,0,0
1683641348323,AWP 10,013,202046,Staff,0,0,0,0
1683641348323,AWP 10,014,202047,Staff,0,0,0,0
1683641348323,AWP 10,015,202048,Staff,0,0,0,0
1683641348323,AWP 10,016,202049,Staff,0,0,0,0
1683641348323,AWP 10,017,202050,Staff,0,0,0,0
1683641348323,AWP 10,018,202051,Staff,0,0,0,0
1683641348323,AWP 10,019,202052,Staff,0,0,0,0
1683641348323,AWP 10,020,202053,Staff,0,0,0,0
1683641348323,AWP 10,021,202054,Staff,0,0,0,0
1683641348323,AWP 10,022,202055,Staff,0,0,0,0
1683641348323,AWP 10,023,202056,Staff,0,0,0,0
1683641348323,AWP 10,024,202057,Staff,0,0,0,0
1683641348323,AWP 10,025,202058,Staff,0,0,0,0
1683641348323,AWP 10,026,202059,Staff,0,0,0,0
1683641349350,AWP 102,001,202032,Staff,0,0,0,0
1683641349350,AWP 102,002,202033,Staff,0,0,0,0
1683641350378,BENG 100,A01,254234,Taylor Amos; Alyssa C,31,0,40,9
1683641351404,BENG 196,001,270013,Engler; Adam J.,9999,0,9999,0
1683641352430,BICD 100R,A01,202018,Smith; Laurie,0,7,32,32
1683641352430,BICD 100R,A02,202019,Smith; Laurie,0,3,32,32
1683641352430,BICD 100R,A03,202020,Smith; Laurie,0,1,32,32
1683641352430,BICD 100R,A04,202021,Smith; Laurie,6,0,32,26
1683641352430,BICD 100R,A05,202022,Smith; Laurie,11,0,32,21
1683641353456,BICD 136,A01,193242,Gustafson-Brown; Cindy,0,2,32,32
1683641353456,BICD 136,A02,193244,Gustafson-Brown; Cindy,13,0,32,19
1683641354489,BIEB 102,A01,193249,Butler; Shannon Rhey,0,2,32,32
1683641354489,BIEB 102,A02,193251,Butler; Shannon Rhey,0,0,32,32
1683641354489,BIEB 102,A03,193253,Butler; Shannon Rhey,0,0,32,32
1683641354489,BIEB 102,A04,193255,Butler; Shannon Rhey,14,0,32,18
1683641354489,BIEB 102,A05,193265,Butler; Shannon Rhey,26,0,32,6
1683641354489,BIEB 102,A06,193269,Butler; Shannon Rhey,14,0,32,18
1683641356542,BIEB 150,A01,193274,Staff,0,0,32,32
1683641356542,BIEB 150,A02,193285,Staff,24,0,32,8
1683641357567,BIEB 194,A00,193286,Kurle; Carolyn M.,20,0,32,12
1683641358594,BILD 1,A01,192291,Staff,15,0,32,17
1683641358594,BILD 1,A02,192292,Staff,30,0,32,2
1683641358594,BILD 1,B01,192520,Reuther; Keefe,0,1,0,0
1683641358594,BILD 1,B02,192532,Reuther; Keefe,0,1,0,0
1683641359619,BILD 3,A01,192556,Butler; Shannon Rhey,0,0,32,32
1683641359619,BILD 3,A02,192581,Butler; Shannon Rhey,1,0,32,31
1683641359619,BILD 3,A03,192611,Butler; Shannon Rhey,21,0,32,11
1683641359619,BILD 3,A04,192612,Butler; Shannon Rhey,24,0,32,8
1683641359619,BILD 3,A05,192613,Butler; Shannon Rhey,26,0,32,6
1683641359619,BILD 3,A06,192679,Butler; Shannon Rhey,27,0,32,5
1683641359619,BILD 3,A07,192682,Butler; Shannon Rhey,20,0,32,12
1683641360645,BILD 4,A01,192836,Reuther; Keefe,0,0,24,24
1683641360645,BILD 4,A02,193044,Reuther; Keefe,4,0,24,20
1683641361674,BILD 10,A01,193142,Gustafson-Brown; Cindy,29,0,32,3
1683641361674,BILD 10,A02,193149,Gustafson-Brown; Cindy,31,0,32,1
1683641362698,BIMM 100,A01,193301,Staff,0,6,32,32
1683641362698,BIMM 100,A02,193312,Staff,0,7,32,32
1683641362698,BIMM 100,A03,193323,Staff,0,9,32,32
1683641363725,BIMM 101,A01,193329,McDonnell; Lisa Marie,0,4,24,24
1683641363725,BIMM 101,A02,193339,McDonnell; Lisa Marie,0,3,24,24
1683641363725,BIMM 101,B01,193354,McDonnell; Lisa Marie,0,4,24,24
1683641363725,BIMM 101,B02,193357,McDonnell; Lisa Marie,0,2,24,24
1683641364755,BIMM 110,A01,193377,Tat; John,0,11,32,32
1683641364755,BIMM 110,A02,193378,Tat; John,0,10,32,32
1683641365781,BIMM 120,A01,206116,Staff,0,0,32,32
1683641365781,BIMM 120,A02,206117,Staff,6,0,32,26
1683641365781,BIMM 120,A03,206121,Staff,21,0,32,11
1683641366807,BIPN 100,A01,193393,Park; Ji Young,0,14,32,32
1683641366807,BIPN 100,A02,193402,Park; Ji Young,0,14,32,32
1683641366807,BIPN 100,A03,193413,Park; Ji Young,0,14,32,32
1683641366807,BIPN 100,A04,193414,Park; Ji Young,0,13,32,32
1683641367834,BIPN 102,A01,193429,Staff,0,0,32,32
1683641367834,BIPN 102,A02,193438,Staff,18,0,32,14
1683641368859,BIPN 106,A01,193450,Reyes Gonzalez; Catalina,0,2,40,40
1683641369889,BIPN 134,A01,193465,Cooke; James Edward,0,0,32,32
1683641369889,BIPN 134,A02,193474,Cooke; James Edward,25,0,32,7
1683641369889,BIPN 134,A03,193485,Cooke; James Edward,29,0,32,3
1683641369889,BIPN 134,A04,193486,Cooke; James Edward,20,0,32,12
1683641369889,BIPN 134,A05,193491,Cooke; James Edward,31,0,32,1
1683641369889,BIPN 134,A06,193501,Cooke; James Edward,30,0,32,2
1683641369889,BIPN 134,A07,193510,Cooke; James Edward,29,0,32,3
1683641371938,BISP 194,A00,222522,Staff,14,0,32,18
1683641372962,CAT 124,A01,202407,Staff,19,0,25,6
1683641373991,CAT 125,A00,202408,Marchisotto; Jennifer Anne,2,0,20,18
1683641375015,CAT 125R,A00,202409,Smith; Lauryn Alissa,0,11,20,20
1683641375015,CAT 125R,B00,202410,Morales; Celeste Georgianna,0,11,20,20
1683641375015,CAT 125R,C00,202411,Irwin; Matthew Joseph,0,12,20,20
1683641376045,CENG 15,A01,204712,Yang; Kesong,0,1,0,0
1683641377069,CENG 114,A00,202070,Jahed Motlagh; Zeinab,5,0,20,15
1683641378097,CGS 105,A00,185477,Wesling; Megan E.,24,0,40,16
1683641379125,CGS 106,A00,185494,Staff,11,0,22,11
1683641380149,CGS 108,A00,185495,Staff,14,0,20,6
1683641381178,CGS 114,A00,185496,Staff,13,0,18,5
1683641382207,CGS 119,A00,185501,Staff,15,0,20,5
1683641383232,CGS 120,A00,185511,Staff,12,0,20,8
1683641384258,CHEM 4,A01,184675,Bussey; Thomas J,97,0,100,3
1683641385284,CHEM 6A,A01,184677,Staff,33,0,60,27
1683641386312,CHEM 6B,A01,184679,Staff,63,0,100,37
1683641387337,CHEM 6C,A01,184681,Bussey; Thomas J,0,0,50,50
1683641387337,CHEM 6C,A02,184682,Bussey; Thomas J,32,0,50,18
1683641388363,CHEM 40A,A01,184684,Albizati; Kim F.,35,0,100,65
1683641389395,CHEM 40B,A01,184686,Albizati; Kim F.,0,22,100,100
1683641390420,CHEM 41B,A01,184690,Staff,51,0,100,49
1683641391445,COGS 3,A01,184715,Boyle; Mary E. T.,0,27,40,40
1683641392469,COGS 14B,A01,185172,Staff,0,14,38,38
1683641393495,COGS 18,A01,184736,Staff,15,0,80,65
1683641394521,COGS 100,A01,184932,Staff,0,7,73,73
1683641395545,COGS 101A,A01,184935,Staff,0,39,30,30
1683641396574,COGS 101B,A01,184944,Staff,0,2,30,30
1683641397600,COGS 101C,A01,184946,Staff,0,10,30,30
1683641398624,COGS 102A,A01,184951,Johnson; Christine M.,2,0,40,38
1683641399649,COGS 107B,A01,184953,Mooshagian; Eric Frederick,0,51,40,40
1683641400674,COGS 118B,A01,184959,Gupta; Anjum,0,49,40,40
1683641401702,COGS 153,A00,184961,Staff,0,16,30,30
1683641402727,COGS 177,A00,184962,Staff,0,21,30,30
1683641403755,COGS 187A,A01,184969,Boyle; Mary E. T.,0,19,40,40
1683641404786,COMM 10,A01,185174,Staff,0,5,25,25
1683641404786,COMM 10,A02,185189,Staff,0,2,25,25
1683641404786,COMM 10,A03,269821,Staff,0,1,0,0
1683641405813,COMM 100B,A01,185475,Staff,0,1,0,2
1683641405813,COMM 100B,A02,185476,Staff,12,0,25,13
1683641406837,COMM 100C,A01,185314,Staff,1,0,25,24
1683641406837,COMM 100C,A02,185327,Staff,18,0,25,7
1683641407866,COMM 110M,A00,185349,Staff,0,0,40,40
1683641408895,COMM 113T,A00,185352,Staff,25,0,40,15
1683641409922,COMM 114I,A00,185353,Staff,31,0,40,9
1683641410947,COMM 131,A00,185354,Staff,17,0,30,13
1683641411972,CSE 8A,A50,185358,Cao; Yingjun,0,46,10,10
1683641412997,CSE 8B,A01,185362,Staff,0,48,50,50
1683641414021,CSE 11,A01,185416,Cao; Yingjun,0,91,10,10
1683641415050,CSE 20,A01,185445,Briones; Jor-el Thomas Caparas,4,0,25,21
1683641416074,CSE 21,A01,185447,Staff,9,0,50,41
1683641417104,CSE 101,A01,185451,Staff,0,13,50,50
1683641417104,CSE 101,B01,185453,Jones; Miles E,0,13,50,50
1683641419157,CSE 141,A01,185458,Eldon; John,15,0,100,85
1683641420185,CSE 141L,A01,185461,Eldon; John,7,0,100,93
1683641421210,CSE 142,A01,185463,Staff,36,0,60,24
1683641421210,CSE 142,B01,201355,Staff,0,7,60,60
1683641422235,CSE 142L,A01,185470,Staff,36,0,60,24
1683641422235,CSE 142L,B01,201417,Staff,0,6,60,60
1683641423260,CSE 190,A00,201433,Staff,32,0,49,17
1683641424291,DOC 1,A01,259136,Strom; Megan C.,7,0,15,8
1683641424291,DOC 1,A02,259137,Strom; Megan C.,14,0,15,1
1683641424291,DOC 1,A03,259138,Strom; Megan C.,14,0,15,1
1683641424291,DOC 1,A04,259139,Strom; Megan C.,14,0,15,1
1683641425319,DOC 100D,A00,259140,Pass; Natalye Joann,14,0,25,11
1683641426344,DSGN 1,A01,184749,Rill; Bryan,0,26,30,30
1683641427372,DSGN 100,A01,185168,Staff,0,2,25,25
1683641428397,ECE 5,A01,185626,Morris; Karcher William,0,11,0,0
1683641429425,ECE 101,A01,185628,Staff,14,0,70,56
1683641430454,ECE 107,A01,185635,Baghdadchi; Saharnaz,0,0,20,20
1683641430454,ECE 107,A02,185638,Baghdadchi; Saharnaz,3,0,20,17
1683641431479,ECE 148,A01,185647,Silberman; Jack,0,0,16,16
1683641432508,ECON 1,A01,185537,Crane; Meredith Helen,54,0,70,16
1683641433532,ECON 3,A01,185549,Crane; Meredith Helen,29,0,70,41
1683641434564,ECON 4,A01,203354,Anderson; John Charles,0,5,10,10
1683641435593,ECON 100A,A01,185574,Staff,0,5,40,40
1683641436622,ECON 100B,A01,185576,Staff,0,12,50,50
1683641437645,ECON 100C,A01,185589,Newhouse; Herbert S,30,0,70,40
1683641438670,ECON 105,A00,185608,Vespa; Emanuel Ignacio,19,0,35,16
1683641439693,ECON 109,A01,185610,Shishkin; Denis,9,0,35,26
1683641440718,ECON 110A,A01,185612,Staff,9,0,40,31
1683641441743,ECON 120A,A01,185615,Staff,20,0,40,20
1683641442771,ECON 120C,A01,185617,Sun; Yixiao,0,20,70,70
1683641443798,ECON 144,A00,203346,Squires; Dale E,2,0,35,33
1683641444878,ECON 171,A01,203349,Newhouse; Herbert S,0,1,35,35
1683641445908,ECON 173A,A01,185621,Toda; Alexis Akira,21,0,35,14
1683641446939,EDS 25,A01,202413,Staff,0,1,0,0
1683641446939,EDS 25,A02,202414,Staff,0,1,0,0
1683641446939,EDS 25,A03,202415,Staff,0,0,0,0
1683641446939,EDS 25,A04,202416,Staff,0,1,0,0
1683641446939,EDS 25,A05,202439,Staff,0,0,0,0
1683641446939,EDS 25,A06,202440,Staff,0,0,0,0
1683641446939,EDS 25,B01,202631,Staff,0,0,0,0
1683641446939,EDS 25,B02,202632,Staff,0,0,0,0
1683641446939,EDS 25,B03,202639,Staff,0,0,0,0
1683641446939,EDS 25,B04,202640,Staff,0,0,0,0
1683641446939,EDS 25,B05,202643,Staff,0,0,0,0
1683641446939,EDS 25,B06,202644,Staff,0,0,0,0
1683641447965,EDS 38,A01,202659,Black; Alison Michelle,24,0,25,1
1683641448989,EDS 115,A00,202652,Staff,18,0,30,12
1683641450015,EDS 125,A00,202649,Staff,13,0,30,17
1683641451040,EDS 126,A01,203332,Staff,30,0,30,0
1683641452063,EDS 139,A00,202838,Staff,16,0,25,9
1683641453091,EDS 146,A01,202655,Staff,14,0,25,11
1683641454122,ENG 15,A00,185667,Staff,0,1,0,0
1683641454122,ENG 15,B00,185672,Staff,0,0,0,0
1683641454122,ENG 15,C00,185675,Staff,0,0,0,0
1683641454122,ENG 15,D00,185682,Staff,0,0,0,0
1683641454122,ENG 15,E00,185684,Staff,0,0,0,0
1683641455151,ETHN 103,A00,185710,Staff,0,8,35,35
1683641456175,ETHN 103A,A00,199228,Man; Simeon S,0,0,9,9
1683641457200,ETHN 109,A00,185711,Staff,16,0,35,19
1683641458222,ETHN 142,A00,185726,Staff,0,4,30,30
1683641459250,ETHN 163J,A00,199229,Man; Simeon S,5,0,8,3
1683641460277,ETHN 168,A00,185727,Staff,7,0,10,3
1683641461315,ETHN 182,A00,185728,Staff,0,0,35,35
1683641462339,ETHN 183,A00,185737,Staff,9,0,18,9
1683641463370,GLBH 111,A01,209361,Burgos; Jose L.,0,0,0,0
1683641465418,HIEU 104,A00,185792,Staff,14,0,20,6
1683641466444,HIEU 115,A00,185800,Staff,0,0,20,20
1683641467470,HIEU 128,A00,185801,Staff,0,9,20,20
1683641468495,HIEU 147,A00,185802,Staff,15,0,20,5
1683641469519,HIEU 154,A00,185823,Staff,11,0,20,9
1683641470544,HILA 102,A00,185826,Staff,14,0,20,6
1683641471572,HILD 2C,A01,185778,Staff,0,13,20,20
1683641472595,HILD 7B,A01,185780,Kwak; Nancy,0,16,32,32
1683641472595,HILD 7B,A02,185781,Kwak; Nancy,0,18,32,32
1683641473620,HILD 30,A01,185791,Staff,12,0,20,8
1683641474649,HISC 119,A00,185830,Golan; Tal,0,9,20,20
1683641475673,HITO 156GS,A00,185831,Patterson; Patrick H.,0,0,0,23
1683641476698,HIUS 103,A00,185832,Man; Simeon S,0,4,20,20
1683641477723,HIUS 117,A00,185836,Kwak; Nancy,2,0,20,18
1683641478750,HIUS 125,A00,185840,Man; Simeon S,0,1,23,23
1683641479775,HIUS 149,A00,185845,Staff,1,0,20,19
1683641480801,HUM 3,A01,185882,Zavodny; Tatiana Sophia,0,7,50,50
1683641480801,HUM 3,B01,185899,Caldwell; Michael Alan,0,18,50,50
1683641481828,HUM 3GS,A00,185900,Patterson; Patrick H.,0,0,0,23
1683641482854,HUM 4,A01,185938,Zroka; Amy Liane,30,0,50,20
1683641482854,HUM 4,B01,185956,Watkins; Eric,0,4,50,50
1683641482854,HUM 4,B02,202209,Watkins; Eric,0,4,50,50
1683641482854,HUM 4,B03,202210,Watkins; Eric,0,4,50,50
1683641483882,HUM 5,A01,185958,West; Geoffrey Scott,2,0,50,48
1683641483882,HUM 5,A02,202215,West; Geoffrey Scott,0,0,50,50
1683641484913,INTL 190,A00,185959,Gagnon; Jeffrey C,0,0,0,9
1683641484913,INTL 190,B00,185960,Lettieri; Michael Joseph,0,0,0,2
1683641485937,JAPN 180,A00,254509,Staff,5,0,30,25
1683641486962,LATI 10,A01,202853,Kennemore; Amy Michelle,4,0,35,31
1683641486962,LATI 10,A02,202854,Kennemore; Amy Michelle,2,0,35,33
1683641486962,LATI 10,A03,270054,Kennemore; Amy Michelle,30,0,30,0
1683641487988,LATI 180,A00,202855,Kennemore; Amy Michelle,11,0,20,9
1683641489012,LAWS 101,A00,201767,Golan; Tal,0,7,40,40
1683641490036,LIFR 1C,A00,185961,Staff,6,0,20,14
1683641491059,LIFR 1CX,A00,185962,Staff,7,0,20,13
1683641492087,LIFR 1D,A00,185963,Staff,7,0,20,13
1683641493113,LIFR 1DX,A00,185964,Staff,7,0,20,13
1683641494139,LIGN 101,A01,186039,Staff,43,0,50,7
1683641495166,LIGN 165,A00,186040,Staff,15,0,50,35
1683641496191,LTCS 108,A00,186041,Staff,5,0,10,5
1683641497217,LTCS 119,A00,186042,Staff,15,0,20,5
1683641498241,LTCS 130,A00,186043,Wesling; Megan E.,15,0,25,10
1683641500294,LTEA 138,A00,186119,Staff,14,0,40,26
1683641501319,LTEN 124,A00,186148,Staff,5,0,25,20
1683641502344,LTEN 178,A00,186149,Staff,7,0,15,8
1683641503370,LTEN 181,A00,186150,Blanco; John D,34,0,40,6
1683641504398,LTWL 120,A00,186160,Staff,20,0,25,5
1683641505426,LTWL 165,A00,186161,Staff,22,0,25,3
1683641506453,LTWR 100,A00,186162,Staff,0,5,15,15
1683641507483,LTWR 102,A00,186163,Doller; Ben,5,0,15,10
1683641508507,MAE 8,A01,186412,Staff,0,0,0,0
1683641509537,MAE 30B,A00,186445,Bahadori; Mohammad Yousef,82,0,100,18
1683641510561,MAE 40,A00,186592,Bewley; Thomas R,10,0,50,40
1683641511589,MAE 101B,A00,186593,Bahadori; Mohammad Yousef,80,0,100,20
1683641512617,MAE 105,A00,186594,Bandaru; Prabhakar,10,0,50,40
1683641513643,MAE 107,A00,186599,Pham; Hieu Tan,0,7,120,120
1683641514670,MAE 148,A01,186660,Silberman; Jack,3,0,16,13
1683641515696,MATH 10A,A01,188095,Staff,0,5,35,35
1683641516724,MATH 10B,A01,188097,Bowers; Adam R.,0,11,30,30
1683641516724,MATH 10B,A02,188099,Bowers; Adam R.,0,11,30,30
1683641516724,MATH 10B,B01,188104,Bowers; Adam R.,0,10,30,30
1683641516724,MATH 10B,B02,188106,Bowers; Adam R.,1,9,30,29
1683641517750,MATH 10C,A01,188111,Staff,0,18,30,30
1683641517750,MATH 10C,A02,188127,Staff,0,19,30,30
1683641517750,MATH 10C,A03,188131,Staff,0,19,30,30
1683641517750,MATH 10C,B01,188218,Staff,17,0,30,13
1683641517750,MATH 10C,B02,188244,Staff,13,0,30,17
1683641517750,MATH 10C,B03,188277,Staff,14,0,30,16
1683641518781,MATH 18,A01,188344,Bach; Quang Tran,18,0,30,12
1683641518781,MATH 18,A02,188345,Bach; Quang Tran,11,0,30,19
1683641518781,MATH 18,B01,188353,Bach; Quang Tran,11,0,30,19
1683641518781,MATH 18,B02,188354,Bach; Quang Tran,19,0,30,11
1683641519809,MATH 20A,A01,188374,Staff,11,0,35,24
1683641520840,MATH 20B,A01,188382,Ohm; Ko Woon,7,0,30,23
1683641520840,MATH 20B,A02,188383,Ohm; Ko Woon,22,0,30,8
1683641520840,MATH 20B,B01,188385,Ohm; Ko Woon,7,0,30,23
1683641520840,MATH 20B,B02,188392,Ohm; Ko Woon,22,0,30,8
1683641521865,MATH 20C,A01,188394,Harel; Guershon,11,0,30,19
1683641521865,MATH 20C,A02,188395,Harel; Guershon,14,0,30,16
1683641521865,MATH 20C,B01,188404,Harel; Guershon,4,0,30,26
1683641521865,MATH 20C,B02,188405,Harel; Guershon,18,0,30,12
1683641522897,MATH 20D,A01,188414,Hammock; Frances H,0,1,30,30
1683641522897,MATH 20D,A02,188415,Hammock; Frances H,0,1,30,30
1683641522897,MATH 20D,B01,188447,Hammock; Frances H,0,1,30,30
1683641522897,MATH 20D,B02,188486,Hammock; Frances H,4,0,30,26
1683641523925,MATH 20E,A01,188649,Staff,21,0,30,9
1683641523925,MATH 20E,A02,188650,Staff,21,0,30,9
1683641523925,MATH 20E,A03,188673,Staff,0,0,30,30
1683641524950,MATH 102,A01,188675,Staff,0,36,35,35
1683641525981,MATH 103B,A01,188681,Staff,3,0,35,32
1683641525981,MATH 103B,B01,188692,Staff,5,0,35,30
1683641527006,MATH 109,A01,188695,Salehi Golsefidy; Alireza,24,0,35,11
1683641527006,MATH 109,A02,188696,Salehi Golsefidy; Alireza,25,0,35,10
1683641528035,MATH 120A,A01,188698,Eggers; John Dietrich,7,0,35,28
1683641529074,MATH 142B,A01,188736,Ioana; Adrian,0,1,30,30
1683641529074,MATH 142B,A02,188741,Ioana; Adrian,0,1,30,30
1683641529074,MATH 142B,A03,188743,Ioana; Adrian,0,1,30,30
1683641530111,MATH 168A,A01,188790,Staff,0,10,35,35
1683641531141,MATH 170A,A01,188803,Nie; Jiawang,0,2,35,35
1683641531141,MATH 170A,A02,188811,Nie; Jiawang,0,0,35,35
1683641531141,MATH 170A,A03,188814,Nie; Jiawang,0,0,35,35
1683641531141,MATH 170A,A04,188815,Nie; Jiawang,10,0,35,25
1683641532170,MATH 193B,A01,188817,Staff,0,0,35,35
1683641532170,MATH 193B,A02,188818,Staff,5,0,35,30
1683641533198,MGT 4,A01,202857,Anderson; John Charles,61,0,80,19
1683641534227,MGT 12,A00,202858,Lindenberger; Wade Douglas,40,0,90,50
1683641535250,MGT 18,A00,202859,Staff,74,0,90,16
1683641536277,MGT 18GS,A00,202860,McKay; Michael J,13,0,28,15
1683641537302,MGT 45,A00,202861,Pecore; Joseph P.,12,0,90,78
1683641538326,MGT 100,A00,202863,Yavorsky; Daniel Ryan,28,0,90,62
1683641539353,MGT 103,A00,202864,Ehrich; Kristine R,0,17,90,90
1683641540379,MGT 112,A00,202865,Ehrich; Kristine R,15,0,90,75
1683641541404,MGT 121A,A00,202868,Staff,0,20,0,0
1683641542432,MGT 131B,A00,202869,Anderson; John Charles,59,0,90,31
1683641543457,MGT 136,A00,202871,Lindenberger; Wade Douglas,83,0,90,7
1683641544482,MGT 164,A00,202873,Staff,0,66,90,91
1683641545510,MGT 164GS,A00,202874,McKay; Mary A,13,0,28,15
1683641546535,MGT 180,A00,202875,Staff,0,50,90,91
1683641547561,MMW 11R,A01,205019,Herbst; Matthew,2,0,30,28
1683641547561,MMW 11R,A02,205026,Herbst; Matthew,29,0,30,1
1683641548645,MMW 15,A01,193512,Chang; Edmond Yi-Teh,0,8,28,28
1683641548645,MMW 15,A02,193513,Chang; Edmond Yi-Teh,0,5,28,28
1683641548645,MMW 15,A03,193514,Chang; Edmond Yi-Teh,0,5,28,28
1683641548645,MMW 15,A04,193515,Chang; Edmond Yi-Teh,0,5,28,28
1683641548645,MMW 15,A05,193516,Chang; Edmond Yi-Teh,0,5,28,28
1683641548645,MMW 15,A06,193517,Chang; Edmond Yi-Teh,0,6,28,28
1683641548645,MMW 15,B01,193519,Chang; Edmond Yi-Teh,0,5,28,28
1683641548645,MMW 15,B02,193520,Chang; Edmond Yi-Teh,0,5,28,28
1683641548645,MMW 15,B03,193521,Chang; Edmond Yi-Teh,0,5,28,28
1683641548645,MMW 15,B04,193522,Chang; Edmond Yi-Teh,0,5,28,28
1683641548645,MMW 15,B05,193523,Chang; Edmond Yi-Teh,0,5,28,28
1683641548645,MMW 15,B06,193524,Chang; Edmond Yi-Teh,0,5,28,28
1683641549677,MMW 122,A01,193526,Rahimi; Babak,0,16,28,28
1683641549677,MMW 122,A02,193527,Rahimi; Babak,0,15,28,28
1683641549677,MMW 122,A03,193528,Rahimi; Babak,0,0,0,0
1683641549677,MMW 122,A04,193529,Rahimi; Babak,0,0,0,0
1683641550701,MUS 1A,A01,186663,Staff,1,20,35,34
1683641551729,MUS 4,A01,186715,Staff,0,12,35,35
1683641552758,MUS 5R,A01,186796,Dubnov; Shlomo,0,17,35,35
1683641553782,MUS 6,A01,186798,Staff,0,5,25,25
1683641554808,MUS 7,A01,186830,Staff,11,0,35,24
1683641555835,MUS 8,A01,186930,Staff,0,26,35,35
1683641556860,MUS 15,A01,186932,Staff,0,16,35,35
1683641556860,MUS 15,B01,186934,Staff,0,17,35,35
1683641557885,MUS 80,A00,186935,Staff,0,0,20,20
1683641557885,MUS 80,B00,186936,Staff,24,0,25,1
1683641558915,NANO 11,A00,204702,Lipomi; Darren John,0,0,0,0
1683641559940,NANO 15,A01,204709,Yang; Kesong,0,1,0,0
1683641560969,NANO 114,A00,202069,Jahed Motlagh; Zeinab,3,0,10,7
1683641561994,PHIL 1,A00,186955,Grush; Rick Scott,31,0,40,9
1683641563020,PHIL 10,A01,186973,Grush; Rick Scott,27,0,35,8
1683641563020,PHIL 10,A02,186974,Grush; Rick Scott,33,0,35,2
1683641564045,PHIL 13,A01,186976,Staff,3,0,35,32
1683641564045,PHIL 13,A02,186977,Staff,16,0,35,19
1683641565070,PHIL 14,A01,186979,Staff,31,0,35,4
1683641565070,PHIL 14,A02,186986,Staff,32,0,35,3
1683641566097,PHIL 28,A01,186988,Staff,16,0,30,14
1683641566097,PHIL 28,A02,186989,Staff,1,0,30,29
1683641566097,PHIL 28,A03,186990,Staff,10,0,30,20
1683641566097,PHIL 28,A04,186991,Staff,26,0,30,4
1683641567121,PHIL 120,A00,186997,Staff,23,0,40,17
1683641568145,PHIL 137,A00,187003,Staff,7,0,40,33
1683641569168,PHIL 150,A00,187015,Staff,47,0,70,23
1683641570195,PHIL 167,A00,187021,Lamey; Andy M.,34,0,40,6
1683641571219,PHIL 174,A01,202226,Staff,17,0,20,3
1683641571219,PHIL 174,A02,202235,Staff,20,0,20,0
1683641572243,PHIL 191A,A00,258918,Staff,0,0,1,1
1683641573274,PHYS 1A,A00,187028,Staff,27,0,60,33
1683641574299,PHYS 1AL,001,187036,Staff,3,0,30,27
1683641574299,PHYS 1AL,002,187049,Staff,18,0,30,12
1683641575324,PHYS 1B,A00,187058,Staff,22,0,60,38
1683641576353,PHYS 1BL,001,187064,Staff,0,1,30,30
1683641576353,PHYS 1BL,002,187070,Staff,4,0,30,26
1683641577375,PHYS 1C,A00,187082,Staff,29,0,120,91
1683641578399,PHYS 1CL,001,187088,Staff,0,9,30,30
1683641578399,PHYS 1CL,002,187089,Staff,0,1,30,30
1683641578399,PHYS 1CL,009,262693,Staff,9,0,30,21
1683641579424,PHYS 2B,A01,187097,Staff,55,0,115,60
1683641580453,PHYS 2C,A01,187099,Staff,64,0,115,51
1683641581476,PHYS 2CL,A01,187101,Staff,5,0,28,23
1683641581476,PHYS 2CL,A02,187102,Staff,15,0,28,13
1683641582506,PHYS 2D,A01,187123,Shotwell; Brian,95,0,115,20
1683641583532,PHYS 4B,A01,187133,Grinstein; Benjamin,35,0,50,15
1683641584559,POLI 10,A00,188819,Staff,0,4,50,50
1683641585584,POLI 11,A00,188827,Staff,43,0,50,7
1683641586612,POLI 13R,A00,188828,Staff,0,1,20,20
1683641587642,POLI 27,A01,188830,Elgin; Samuel Zincke,0,2,70,70
1683641588666,POLI 30,A00,188832,Desposato; Scott,30,0,50,20
1683641589693,POLI 102F,A00,188834,Staff,0,0,40,40
1683641590718,POLI 104A,A00,188852,Staff,13,0,30,17
1683641591741,POLI 104I,A00,188853,Staff,0,7,20,20
1683641592765,POLI 110B,A00,188854,Wiens; David,7,0,20,13
1683641593790,POLI 112A,A00,188855,Wiens; David,4,0,30,26
1683641594817,POLI 117R,A00,188856,Forman; Fonna,0,12,20,20
1683641595842,POLI 118,A00,188857,Ingham; Sean,8,0,20,12
1683641596868,POLI 120G,A00,188858,Staff,8,0,30,22
1683641597893,POLI 131CR,A00,188863,Hoston; Germaine,21,0,50,29
1683641598917,POLI 133,A00,188864,Nellis; Gareth Hb,44,0,50,6
1683641599944,POLI 134D,A00,188865,Desposato; Scott,27,0,30,3
1683641600973,POLI 142A,A00,188871,Gartzke; Erik,21,0,50,29
1683641602001,POLI 142K,A00,188874,Staff,38,0,50,12
1683641603025,POLI 143,A00,188940,Gartzke; Erik,16,0,30,14
1683641604051,POLI 153,A00,188943,Staff,2,0,20,18
1683641605077,POLI 160AA,A00,188944,Staff,11,0,40,29
1683641606102,POLI 170A,A00,188945,Staff,11,0,30,19
1683641608151,PSYC 1,A00,188952,Staff,36,0,90,54
1683641609175,PSYC 2,B00,188953,Staff,19,0,35,16
1683641610200,PSYC 6,A00,188970,Staff,47,0,60,13
1683641611225,PSYC 7,A00,188973,Staff,35,0,45,10
1683641612249,PSYC 60,A01,188980,Rickard; Timothy C.,42,0,60,18
1683641613280,PSYC 70,A01,189001,Steiner; Eric Tomas,23,0,45,22
1683641614306,PSYC 100,A00,189005,Lacefield; Katharine I,0,99,120,120
1683641615330,PSYC 102,A00,189008,Staff,8,0,30,22
1683641616354,PSYC 106,B00,189026,Gorman; Michael R.,27,0,60,33
1683641617383,PSYC 114,B01,189033,Winkielman; Piotr,0,31,30,30
1683641618408,PSYC 131,A00,189036,Anagnostaras; Stephan,0,43,60,60
1683641619437,PSYC 136,A00,189041,Lowe; Angela Beth,0,7,25,25
1683641620461,PSYC 137,A00,189057,Winkielman; Piotr,0,37,25,25
1683641621490,PSYC 144,A00,189107,Wixted; John T,0,10,50,50
1683641623542,PSYC 162,A00,189142,Staff,0,9,85,85
1683641624569,PSYC 172,A00,189144,Gorman; Michael R.,0,6,30,30
1683641626621,PSYC 179,A00,189146,Lacefield; Katharine I,0,86,120,120
1683641627644,PSYC 181,A00,189147,Anagnostaras; Stephan,0,44,90,90
1683641628675,PSYC 190R,A00,189148,Barner; David A.,0,23,80,80
1683641629700,PSYC 191,A00,189275,Rickard; Timothy C.,0,10,25,25
1683641630726,PSYC 193,A00,189276,Chapman; Eddie Nathaniel,0,1,0,4
1683641631754,PSYC 193L,A01,189281,Lowe; Angela Beth,10,0,20,10
1683641631754,PSYC 193L,B01,189285,Staff,28,0,35,7
1683641632779,RELI 149,A00,187137,Rahimi; Babak,7,0,40,33
1683641633804,SE 9,A01,187315,Staff,0,2,18,18
1683641634831,SE 101B,A00,187409,Staff,24,0,30,6
1683641635856,SE 110B,A00,187444,Staff,10,0,40,30
1683641636884,SE 130B,A00,187449,Staff,31,0,40,9
1683641637908,SE 150A,A00,187516,Staff,9,0,20,11
1683641638933,SE 154,A00,187528,Staff,29,0,50,21
1683641639957,SIO 3,A01,258171,Staff,35,0,40,5
1683641640981,SIO 10,A00,187144,Cook; Geoffrey W,0,6,75,75
1683641642011,SIO 45,A00,187152,Cook; Geoffrey W,0,4,100,100
1683641643036,SIO 109R,A00,194486,Staff,0,4,20,20
1683641645088,SIO 187,A01,187233,Kacev; David,12,0,40,28
1683641646114,SOCI 1,A01,258656,Thorpe; Charles Robert,28,0,30,2
1683641646114,SOCI 1,A02,258658,Thorpe; Charles Robert,30,0,30,0
1683641646114,SOCI 1,A03,258661,Thorpe; Charles Robert,25,0,25,0
1683641646114,SOCI 1,A04,258666,Thorpe; Charles Robert,22,0,25,3
1683641646114,SOCI 1,A05,258897,Thorpe; Charles Robert,22,0,25,3
1683641646114,SOCI 1,A06,258898,Thorpe; Charles Robert,25,0,25,0
1683641647140,SOCI 30,A01,258903,Pardo Guerra; Juan Pablo,14,0,30,16
1683641648164,SOCI 102,A00,258904,Staff,9,0,25,16
1683641649189,SOCI 106,A00,258905,Staff,19,0,25,6
1683641650216,SOCI 111,A00,258907,Ribas Norris; Janet Vanesa,26,0,30,4
1683641651244,SOCI 121R,A00,258908,Pardo Guerra; Juan Pablo,8,0,30,22
1683641652325,SOCI 126,A01,203330,Staff,14,0,20,6
1683641653351,SOCI 131,A00,258909,Thorpe; Charles Robert,30,0,60,30
1683641654379,SOCI 135,A00,258910,Payne; Christine Anna,0,11,30,30
1683641655404,SOCI 157,A00,258911,Staff,12,0,30,18
1683641656426,SOCI 184,A00,258912,Staff,25,0,30,5
1683641657452,SOCI 188D,A00,258913,Staff,22,0,30,8
1683641658478,SYN 2,001,187529,Staff,9,0,16,7
1683641658478,SYN 2,002,201452,Staff,0,20,16,16
1683641658478,SYN 2,003,201469,Staff,2,0,16,14
1683641659502,SYN 100,A01,187531,Staff,0,9,20,20
1683641659502,SYN 100,B01,201491,Staff,0,10,20,20
1683641660527,TDAC 1,A00,189286,Walsh; Kim C.,3,0,20,17
1683641660527,TDAC 1,B00,189287,Harting; Carla Kelso,10,0,20,10
1683641661555,TDAC 101,A00,189300,Walsh; Kim C.,16,0,20,4
1683641661555,TDAC 101,B00,189301,Harting; Carla Kelso,18,0,20,2
1683641662580,TDAC 102,A00,189304,Basso; Beatrice,14,0,20,6
1683641663606,TDAC 108,A00,189305,Staff,18,0,20,2
1683641664645,TDDE 131,A00,189310,Staff,19,0,20,1
1683641664645,TDDE 131,B00,189314,Staff,19,0,20,1
1683641664645,TDDE 131,C00,189315,Staff,48,0,50,2
1683641664645,TDDE 131,D00,189316,Staff,14,0,15,1
1683641664645,TDDE 131,E00,204841,Staff,20,0,20,0
1683641665680,TDGE 10,A00,189289,Staff,27,0,50,23
1683641665680,TDGE 10,B00,189290,Havis; Allan,0,0,50,50
1683641666706,TDGE 11,A00,189291,Fulton; Julia,0,4,50,50
1683641666706,TDGE 11,B00,189292,Staff,20,0,25,5
1683641666706,TDGE 11,C00,260270,Staff,0,0,0,0
1683641667730,TDGE 25,A00,189294,Staff,2,0,20,18
1683641668758,TDGE 124,A00,189318,Fulton; Julia,0,8,50,50
1683641669782,TDGE 125,A00,189319,Staff,13,0,25,12
1683641669782,TDGE 125,B00,189320,Staff,23,0,25,2
1683641670810,TDGE 127,A00,189322,Havis; Allan,0,0,50,50
1683641671834,TDHT 101,A00,189323,Staff,18,0,25,7
1683641671834,TDHT 101,B00,189324,Staff,25,0,25,0
1683641672858,TDHT 102,A00,189325,Staff,49,0,50,1
1683641673883,TDMV 1,A00,189295,Arcidiacono; Kristin,20,0,30,10
1683641673883,TDMV 1,B00,189296,Caligagan; Maria T.,24,0,30,6
1683641674908,TDMV 2,A00,189297,Sammartano; Tonnie,27,0,30,3
1683641674908,TDMV 2,B00,189299,Arcidiacono; Kristin,23,0,30,7
1683641675933,TDMV 3,A00,204998,Rincon; Alicia,22,0,30,8
1683641676955,TDMV 120,A00,189458,Sammartano; Tonnie,28,0,30,2
1683641677983,TDMV 138,A00,189541,Jun; Grace Shin Hae,20,0,40,20
1683641679013,TDMV 142,A00,189717,Caligagan; Tony,25,0,30,5
1683641679013,TDMV 142,B00,189718,Caligagan; Maria T.,25,0,30,5
1683641680038,TMC 2,A01,187533,Staff,25,0,25,0
1683641680038,TMC 2,A02,187534,Staff,25,0,25,0
1683641681063,USP 1,A01,187536,Kwak; Nancy,0,16,25,25
1683641682091,USP 5,A01,187538,Staff,9,0,25,16
1683641683116,USP 101,A00,199253,Staff,0,4,0,0
1683641684141,USP 124,A00,187562,Boomhower; Matthew Charles,0,0,30,30
1683641685165,USP 138,A00,187582,Staff,20,0,25,5
1683641686192,USP 152,A01,187597,Staff,3,0,25,22
1683641687225,USP 153,A00,187598,Staff,19,0,25,6
1683641688252,USP 168,A00,187607,Kwak; Nancy,2,0,5,3
1683641689278,USP 173,A00,187619,Staff,4,0,25,21
1683641690302,USP 181,A00,187638,Staff,0,4,25,25
1683641691331,VIS 103,A00,187650,Cruz; Edwin Teddy,18,0,75,57
1683641692359,VIS 110D,A00,187669,Staff,13,0,22,9
1683641693389,VIS 127C,A00,187720,Shen; Kuiyi,67,0,146,79
1683641694415,VIS 149,A00,187731,Yoldas; Pinar,0,14,22,22
1683641695442,VIS 151,A01,188091,Staff,22,0,34,12
1683641695442,VIS 151,A02,188092,Staff,11,0,34,23
1683641696467,VIS 160B,A00,188093,Stalbaum; Brett,0,1,10,10
1683641698522,WCWP 10B,A00,201720,Staff,10,0,15,5
1683641698522,WCWP 10B,B00,201722,Staff,9,0,15,6
1683641699552,WCWP 100,A00,201725,Gagnon; Jeffrey C,0,0,2,2
1683641699552,WCWP 100,B00,201727,Staff,0,4,15,15
1683641702665,ANBI 133,A00,258401,Wilder; Linnea Lorene,34,0,40,6
1683641703694,ANBI 140,A00,258395,Hrvoj Mihic; Branka,18,0,25,7
1683641704723,ANSC 120,A00,258402,Bialecki; Jon Anthony,27,0,40,13
1683641705749,ANSC 144,A00,258400,Staff,12,0,40,28
1683641707798,ANSC 166,A00,258396,Parish; Steven Martin,156,0,175,19
1683641708822,ANSC 180,A00,193533,Staff,8,0,20,12
1683641709850,ANSC 188,A00,258397,Jassal; Aftab,34,0,40,6
1683641710873,ANTH 3,A01,258316,Staff,23,0,30,7
1683641711903,ANTH 5,A00,258394,Semendeferi; Ekaterini,16,0,20,4
1683641712927,ANTH 21,A01,258331,Staff,4,0,40,36
1683641713952,ANTH 103,A00,258398,Varma; Saiba,15,0,25,10
1683641714985,AWP 10,001,202034,Staff,0,0,0,0
1683641714985,AWP 10,002,202035,Staff,0,0,0,0
1683641714985,AWP 10,003,202036,Staff,0,0,0,0
1683641714985,AWP 10,004,202037,Staff,0,0,0,0
1683641714985,AWP 10,005,202038,Staff,0,0,0,0
1683641714985,AWP 10,006,202039,Staff,0,0,0,0
1683641714985,AWP 10,007,202040,Staff,0,0,0,0
1683641714985,AWP 10,008,202041,Staff,0,0,0,0
1683641714985,AWP 10,009,202042,Staff,0,0,0,0
1683641714985,AWP 10,010,202043,Staff,0,0,0,0
1683641714985,AWP 10,011,202044,Staff,0,0,0,0
1683641714985,AWP 10,012,202045,Staff,0,0,0,0
1683641714985,AWP 10,013,202046,Staff,0,0,0,0
1683641714985,AWP 10,014,202047,Staff,0,0,0,0
1683641714985,AWP 10,015,202048,Staff,0,0,0,0
1683641714985,AWP 10,016,202049,Staff,0,0,0,0
1683641714985,AWP 10,017,202050,Staff,0,0,0,0
1683641714985,AWP 10,018,202051,Staff,0,0,0,0
1683641714985,AWP 10,019,202052,Staff,0,0,0,0
1683641714985,AWP 10,020,202053,Staff,0,0,0,0
1683641714985,AWP 10,021,202054,Staff,0,0,0,0
1683641714985,AWP 10,022,202055,Staff,0,0,0,0
1683641714985,AWP 10,023,202056,Staff,0,0,0,0
1683641714985,AWP 10,024,202057,Staff,0,0,0,0
1683641714985,AWP 10,025,202058,Staff,0,0,0,0
1683641714985,AWP 10,026,202059,Staff,0,0,0,0
1683641716013,AWP 102,001,202032,Staff,0,0,0,0
1683641716013,AWP 102,002,202033,Staff,0,0,0,0
1683641717037,BENG 100,A01,254234,Taylor Amos; Alyssa C,31,0,40,9
1683641718064,BENG 196,001,270013,Engler; Adam J.,9999,0,9999,0
1683641719089,BICD 100R,A01,202018,Smith; Laurie,0,7,32,32
1683641719089,BICD 100R,A02,202019,Smith; Laurie,0,3,32,32
1683641719089,BICD 100R,A03,202020,Smith; Laurie,0,1,32,32
1683641719089,BICD 100R,A04,202021,Smith; Laurie,6,0,32,26
1683641719089,BICD 100R,A05,202022,Smith; Laurie,11,0,32,21
1683641720113,BICD 136,A01,193242,Gustafson-Brown; Cindy,0,2,32,32
1683641720113,BICD 136,A02,193244,Gustafson-Brown; Cindy,13,0,32,19
1683641721139,BIEB 102,A01,193249,Butler; Shannon Rhey,0,2,32,32
1683641721139,BIEB 102,A02,193251,Butler; Shannon Rhey,0,0,32,32
1683641721139,BIEB 102,A03,193253,Butler; Shannon Rhey,0,0,32,32
1683641721139,BIEB 102,A04,193255,Butler; Shannon Rhey,14,0,32,18
1683641721139,BIEB 102,A05,193265,Butler; Shannon Rhey,26,0,32,6
1683641721139,BIEB 102,A06,193269,Butler; Shannon Rhey,14,0,32,18
1683641723189,BIEB 150,A01,193274,Staff,0,0,32,32
1683641723189,BIEB 150,A02,193285,Staff,24,0,32,8
1683641724216,BIEB 194,A00,193286,Kurle; Carolyn M.,20,0,32,12
1683641725242,BILD 1,A01,192291,Staff,15,0,32,17
1683641725242,BILD 1,A02,192292,Staff,30,0,32,2
1683641725242,BILD 1,B01,192520,Reuther; Keefe,0,1,0,0
1683641725242,BILD 1,B02,192532,Reuther; Keefe,0,1,0,0
1683641726272,BILD 3,A01,192556,Butler; Shannon Rhey,0,0,32,32
1683641726272,BILD 3,A02,192581,Butler; Shannon Rhey,1,0,32,31
1683641726272,BILD 3,A03,192611,Butler; Shannon Rhey,21,0,32,11
1683641726272,BILD 3,A04,192612,Butler; Shannon Rhey,24,0,32,8
1683641726272,BILD 3,A05,192613,Butler; Shannon Rhey,26,0,32,6
1683641726272,BILD 3,A06,192679,Butler; Shannon Rhey,27,0,32,5
1683641726272,BILD 3,A07,192682,Butler; Shannon Rhey,20,0,32,12
1683641727303,BILD 4,A01,192836,Reuther; Keefe,0,0,24,24
1683641727303,BILD 4,A02,193044,Reuther; Keefe,4,0,24,20
1683641728326,BILD 10,A01,193142,Gustafson-Brown; Cindy,29,0,32,3
1683641728326,BILD 10,A02,193149,Gustafson-Brown; Cindy,31,0,32,1
1683641729354,BIMM 100,A01,193301,Staff,0,6,32,32
1683641729354,BIMM 100,A02,193312,Staff,0,7,32,32
1683641729354,BIMM 100,A03,193323,Staff,0,9,32,32
1683641730380,BIMM 101,A01,193329,McDonnell; Lisa Marie,0,4,24,24
1683641730380,BIMM 101,A02,193339,McDonnell; Lisa Marie,0,3,24,24
1683641730380,BIMM 101,B01,193354,McDonnell; Lisa Marie,0,4,24,24
1683641730380,BIMM 101,B02,193357,McDonnell; Lisa Marie,0,2,24,24
1683641731410,BIMM 110,A01,193377,Tat; John,0,11,32,32
1683641731410,BIMM 110,A02,193378,Tat; John,0,10,32,32
1683641732436,BIMM 120,A01,206116,Staff,0,0,32,32
1683641732436,BIMM 120,A02,206117,Staff,6,0,32,26
1683641732436,BIMM 120,A03,206121,Staff,21,0,32,11
1683641733463,BIPN 100,A01,193393,Park; Ji Young,0,14,32,32
1683641733463,BIPN 100,A02,193402,Park; Ji Young,0,14,32,32
1683641733463,BIPN 100,A03,193413,Park; Ji Young,0,14,32,32
1683641733463,BIPN 100,A04,193414,Park; Ji Young,0,13,32,32
1683641734493,BIPN 102,A01,193429,Staff,0,0,32,32
1683641734493,BIPN 102,A02,193438,Staff,18,0,32,14
1683641735519,BIPN 106,A01,193450,Reyes Gonzalez; Catalina,0,2,40,40
1683641736545,BIPN 134,A01,193465,Cooke; James Edward,0,0,32,32
1683641736545,BIPN 134,A02,193474,Cooke; James Edward,25,0,32,7
1683641736545,BIPN 134,A03,193485,Cooke; James Edward,29,0,32,3
1683641736545,BIPN 134,A04,193486,Cooke; James Edward,20,0,32,12
1683641736545,BIPN 134,A05,193491,Cooke; James Edward,31,0,32,1
1683641736545,BIPN 134,A06,193501,Cooke; James Edward,30,0,32,2
1683641736545,BIPN 134,A07,193510,Cooke; James Edward,29,0,32,3
1683641738599,BISP 194,A00,222522,Staff,14,0,32,18
1683641739628,CAT 124,A01,202407,Staff,19,0,25,6
1683641740656,CAT 125,A00,202408,Marchisotto; Jennifer Anne,2,0,20,18
1683641741683,CAT 125R,A00,202409,Smith; Lauryn Alissa,0,11,20,20
1683641741683,CAT 125R,B00,202410,Morales; Celeste Georgianna,0,11,20,20
1683641741683,CAT 125R,C00,202411,Irwin; Matthew Joseph,0,12,20,20
1683641742713,CENG 15,A01,204712,Yang; Kesong,0,1,0,0
1683641743739,CENG 114,A00,202070,Jahed Motlagh; Zeinab,5,0,20,15
1683641744766,CGS 105,A00,185477,Wesling; Megan E.,24,0,40,16
1683641745793,CGS 106,A00,185494,Staff,11,0,22,11
1683641746817,CGS 108,A00,185495,Staff,14,0,20,6
1683641747841,CGS 114,A00,185496,Staff,13,0,18,5
1683641748865,CGS 119,A00,185501,Staff,15,0,20,5
1683641749890,CGS 120,A00,185511,Staff,12,0,20,8
1683641750917,CHEM 4,A01,184675,Bussey; Thomas J,97,0,100,3
1683641751944,CHEM 6A,A01,184677,Staff,33,0,60,27
1683641752969,CHEM 6B,A01,184679,Staff,63,0,100,37
1683641753994,CHEM 6C,A01,184681,Bussey; Thomas J,0,0,50,50
1683641753994,CHEM 6C,A02,184682,Bussey; Thomas J,32,0,50,18
1683641755022,CHEM 40A,A01,184684,Albizati; Kim F.,35,0,100,65
1683641756103,CHEM 40B,A01,184686,Albizati; Kim F.,0,22,100,100
1683641757130,CHEM 41B,A01,184690,Staff,51,0,100,49
1683641758159,COGS 3,A01,184715,Boyle; Mary E. T.,0,27,40,40
1683641759191,COGS 14B,A01,185172,Staff,0,14,38,38
1683641760222,COGS 18,A01,184736,Staff,15,0,80,65
1683641761247,COGS 100,A01,184932,Staff,0,7,73,73
1683641762276,COGS 101A,A01,184935,Staff,0,39,30,30
1683641763301,COGS 101B,A01,184944,Staff,0,2,30,30
1683641764325,COGS 101C,A01,184946,Staff,0,10,30,30
1683641765351,COGS 102A,A01,184951,Johnson; Christine M.,2,0,40,38
1683641766377,COGS 107B,A01,184953,Mooshagian; Eric Frederick,0,51,40,40
1683641767401,COGS 118B,A01,184959,Gupta; Anjum,0,49,40,40
1683641768425,COGS 153,A00,184961,Staff,0,16,30,30
1683641769450,COGS 177,A00,184962,Staff,0,21,30,30
1683641770476,COGS 187A,A01,184969,Boyle; Mary E. T.,0,19,40,40
1683641771501,COMM 10,A01,185174,Staff,0,5,25,25
1683641771501,COMM 10,A02,185189,Staff,0,2,25,25
1683641771501,COMM 10,A03,269821,Staff,0,1,0,0
1683641772528,COMM 100B,A01,185475,Staff,0,1,0,2
1683641772528,COMM 100B,A02,185476,Staff,12,0,25,13
1683641773553,COMM 100C,A01,185314,Staff,1,0,25,24
1683641773553,COMM 100C,A02,185327,Staff,18,0,25,7
1683641774581,COMM 110M,A00,185349,Staff,0,0,40,40
1683641775610,COMM 113T,A00,185352,Staff,25,0,40,15
1683641776637,COMM 114I,A00,185353,Staff,31,0,40,9
1683641777665,COMM 131,A00,185354,Staff,17,0,30,13
1683641778690,CSE 8A,A50,185358,Cao; Yingjun,0,46,10,10
1683641779715,CSE 8B,A01,185362,Staff,0,48,50,50
1683641780741,CSE 11,A01,185416,Cao; Yingjun,0,91,10,10
1683641781769,CSE 20,A01,185445,Briones; Jor-el Thomas Caparas,4,0,25,21
1683641782794,CSE 21,A01,185447,Staff,9,0,50,41
1683641783824,CSE 101,A01,185451,Staff,0,13,50,50
1683641783824,CSE 101,B01,185453,Jones; Miles E,0,13,50,50
1683641785878,CSE 141,A01,185458,Eldon; John,15,0,100,85
1683641786904,CSE 141L,A01,185461,Eldon; John,7,0,100,93
1683641787934,CSE 142,A01,185463,Staff,36,0,60,24
1683641787934,CSE 142,B01,201355,Staff,0,7,60,60
1683641788961,CSE 142L,A01,185470,Staff,36,0,60,24
1683641788961,CSE 142L,B01,201417,Staff,0,6,60,60
1683641789989,CSE 190,A00,201433,Staff,32,0,49,17
1683641791016,DOC 1,A01,259136,Strom; Megan C.,7,0,15,8
1683641791016,DOC 1,A02,259137,Strom; Megan C.,14,0,15,1
1683641791016,DOC 1,A03,259138,Strom; Megan C.,14,0,15,1
1683641791016,DOC 1,A04,259139,Strom; Megan C.,14,0,15,1
1683641792042,DOC 100D,A00,259140,Pass; Natalye Joann,14,0,25,11
1683641793066,DSGN 1,A01,184749,Rill; Bryan,0,26,30,30
1683641794089,DSGN 100,A01,185168,Staff,0,2,25,25
1683641795118,ECE 5,A01,185626,Morris; Karcher William,0,11,0,0
1683641796143,ECE 101,A01,185628,Staff,14,0,70,56
1683641797168,ECE 107,A01,185635,Baghdadchi; Saharnaz,0,0,20,20
1683641797168,ECE 107,A02,185638,Baghdadchi; Saharnaz,3,0,20,17
1683641798196,ECE 148,A01,185647,Silberman; Jack,0,0,16,16
1683641799221,ECON 1,A01,185537,Crane; Meredith Helen,54,0,70,16
1683641800244,ECON 3,A01,185549,Crane; Meredith Helen,29,0,70,41
1683641801270,ECON 4,A01,203354,Anderson; John Charles,0,5,10,10
1683641802295,ECON 100A,A01,185574,Staff,0,5,40,40
1683641803322,ECON 100B,A01,185576,Staff,0,12,50,50
1683641804346,ECON 100C,A01,185589,Newhouse; Herbert S,30,0,70,40
1683641805372,ECON 105,A00,185608,Vespa; Emanuel Ignacio,19,0,35,16
1683641806397,ECON 109,A01,185610,Shishkin; Denis,9,0,35,26
1683641807423,ECON 110A,A01,185612,Staff,9,0,40,31
1683641808447,ECON 120A,A01,185615,Staff,20,0,40,20
1683641809472,ECON 120C,A01,185617,Sun; Yixiao,0,20,70,70
1683641810506,ECON 144,A00,203346,Squires; Dale E,2,0,35,33
1683641811534,ECON 171,A01,203349,Newhouse; Herbert S,0,1,35,35
1683641812562,ECON 173A,A01,185621,Toda; Alexis Akira,21,0,35,14
1683641813588,EDS 25,A01,202413,Staff,0,1,0,0
1683641813588,EDS 25,A02,202414,Staff,0,1,0,0
1683641813588,EDS 25,A03,202415,Staff,0,0,0,0
1683641813588,EDS 25,A04,202416,Staff,0,1,0,0
1683641813588,EDS 25,A05,202439,Staff,0,0,0,0
1683641813588,EDS 25,A06,202440,Staff,0,0,0,0
1683641813588,EDS 25,B01,202631,Staff,0,0,0,0
1683641813588,EDS 25,B02,202632,Staff,0,0,0,0
1683641813588,EDS 25,B03,202639,Staff,0,0,0,0
1683641813588,EDS 25,B04,202640,Staff,0,0,0,0
1683641813588,EDS 25,B05,202643,Staff,0,0,0,0
1683641813588,EDS 25,B06,202644,Staff,0,0,0,0
1683641814614,EDS 38,A01,202659,Black; Alison Michelle,24,0,25,1
1683641815641,EDS 115,A00,202652,Staff,18,0,30,12
1683641816667,EDS 125,A00,202649,Staff,13,0,30,17
1683641817691,EDS 126,A01,203332,Staff,30,0,30,0
1683641818716,EDS 139,A00,202838,Staff,16,0,25,9
1683641819746,EDS 146,A01,202655,Staff,14,0,25,11
1683641820776,ENG 15,A00,185667,Staff,0,1,0,0
1683641820776,ENG 15,B00,185672,Staff,0,0,0,0
1683641820776,ENG 15,C00,185675,Staff,0,0,0,0
1683641820776,ENG 15,D00,185682,Staff,0,0,0,0
1683641820776,ENG 15,E00,185684,Staff,0,0,0,0
1683641821807,ETHN 103,A00,185710,Staff,0,8,35,35
1683641822836,ETHN 103A,A00,199228,Man; Simeon S,0,0,9,9
1683641823860,ETHN 109,A00,185711,Staff,16,0,35,19
1683641824887,ETHN 142,A00,185726,Staff,0,4,30,30
1683641825920,ETHN 163J,A00,199229,Man; Simeon S,5,0,8,3
1683641826947,ETHN 168,A00,185727,Staff,7,0,10,3
1683641827982,ETHN 182,A00,185728,Staff,0,0,35,35
1683641829006,ETHN 183,A00,185737,Staff,9,0,18,9
1683641830035,GLBH 111,A01,209361,Burgos; Jose L.,0,0,0,0
1683641832086,HIEU 104,A00,185792,Staff,14,0,20,6
1683641833112,HIEU 115,A00,185800,Staff,0,0,20,20
1683641834141,HIEU 128,A00,185801,Staff,0,9,20,20
1683641835166,HIEU 147,A00,185802,Staff,15,0,20,5
1683641836192,HIEU 154,A00,185823,Staff,11,0,20,9
1683641837220,HILA 102,A00,185826,Staff,14,0,20,6
1683641838244,HILD 2C,A01,185778,Staff,0,13,20,20
1683641839267,HILD 7B,A01,185780,Kwak; Nancy,0,16,32,32
1683641839267,HILD 7B,A02,185781,Kwak; Nancy,0,18,32,32
1683641840293,HILD 30,A01,185791,Staff,12,0,20,8
1683641841318,HISC 119,A00,185830,Golan; Tal,0,9,20,20
1683641842343,HITO 156GS,A00,185831,Patterson; Patrick H.,0,0,0,23
1683641843368,HIUS 103,A00,185832,Man; Simeon S,0,4,20,20
1683641844394,HIUS 117,A00,185836,Kwak; Nancy,2,0,20,18
1683641845421,HIUS 125,A00,185840,Man; Simeon S,0,1,23,23
1683641846445,HIUS 149,A00,185845,Staff,1,0,20,19
1683641847470,HUM 3,A01,185882,Zavodny; Tatiana Sophia,0,7,50,50
1683641847470,HUM 3,B01,185899,Caldwell; Michael Alan,0,18,50,50
1683641848495,HUM 3GS,A00,185900,Patterson; Patrick H.,0,0,0,23
1683641849531,HUM 4,A01,185938,Zroka; Amy Liane,30,0,50,20
1683641849531,HUM 4,B01,185956,Watkins; Eric,0,4,50,50
1683641849531,HUM 4,B02,202209,Watkins; Eric,0,4,50,50
1683641849531,HUM 4,B03,202210,Watkins; Eric,0,4,50,50
1683641850556,HUM 5,A01,185958,West; Geoffrey Scott,2,0,50,48
1683641850556,HUM 5,A02,202215,West; Geoffrey Scott,0,0,50,50
1683641851585,INTL 190,A00,185959,Gagnon; Jeffrey C,0,0,0,9
1683641851585,INTL 190,B00,185960,Lettieri; Michael Joseph,0,0,0,2
1683641852611,JAPN 180,A00,254509,Staff,5,0,30,25
1683641853638,LATI 10,A01,202853,Kennemore; Amy Michelle,4,0,35,31
1683641853638,LATI 10,A02,202854,Kennemore; Amy Michelle,2,0,35,33
1683641853638,LATI 10,A03,270054,Kennemore; Amy Michelle,30,0,30,0
1683641854666,LATI 180,A00,202855,Kennemore; Amy Michelle,11,0,20,9
1683641855690,LAWS 101,A00,201767,Golan; Tal,0,7,40,40
1683641856714,LIFR 1C,A00,185961,Staff,6,0,20,14
1683641857739,LIFR 1CX,A00,185962,Staff,7,0,20,13
1683641858766,LIFR 1D,A00,185963,Staff,7,0,20,13
1683641859868,LIFR 1DX,A00,185964,Staff,7,0,20,13
1683641860899,LIGN 101,A01,186039,Staff,43,0,50,7
1683641861923,LIGN 165,A00,186040,Staff,15,0,50,35
1683641862950,LTCS 108,A00,186041,Staff,5,0,10,5
1683641863975,LTCS 119,A00,186042,Staff,15,0,20,5
1683641864999,LTCS 130,A00,186043,Wesling; Megan E.,15,0,25,10
1683641867049,LTEA 138,A00,186119,Staff,14,0,40,26
1683641868073,LTEN 124,A00,186148,Staff,5,0,25,20
1683641869098,LTEN 178,A00,186149,Staff,7,0,15,8
1683641870128,LTEN 181,A00,186150,Blanco; John D,34,0,40,6
1683641871157,LTWL 120,A00,186160,Staff,20,0,25,5
1683641872183,LTWL 165,A00,186161,Staff,22,0,25,3
1683641873207,LTWR 100,A00,186162,Staff,0,5,15,15
1683641874237,LTWR 102,A00,186163,Doller; Ben,5,0,15,10
1683641875266,MAE 8,A01,186412,Staff,0,0,0,0
1683641876296,MAE 30B,A00,186445,Bahadori; Mohammad Yousef,82,0,100,18
1683641877321,MAE 40,A00,186592,Bewley; Thomas R,10,0,50,40
1683641878344,MAE 101B,A00,186593,Bahadori; Mohammad Yousef,80,0,100,20
1683641879372,MAE 105,A00,186594,Bandaru; Prabhakar,10,0,50,40
1683641880397,MAE 107,A00,186599,Pham; Hieu Tan,0,7,120,120
1683641881426,MAE 148,A01,186660,Silberman; Jack,3,0,16,13
1683641882457,MATH 10A,A01,188095,Staff,0,5,35,35
1683641883488,MATH 10B,A01,188097,Bowers; Adam R.,0,11,30,30
1683641883488,MATH 10B,A02,188099,Bowers; Adam R.,0,11,30,30
1683641883488,MATH 10B,B01,188104,Bowers; Adam R.,0,10,30,30
1683641883488,MATH 10B,B02,188106,Bowers; Adam R.,1,9,30,29
1683641884513,MATH 10C,A01,188111,Staff,0,18,30,30
1683641884513,MATH 10C,A02,188127,Staff,0,19,30,30
1683641884513,MATH 10C,A03,188131,Staff,0,19,30,30
1683641884513,MATH 10C,B01,188218,Staff,17,0,30,13
1683641884513,MATH 10C,B02,188244,Staff,13,0,30,17
1683641884513,MATH 10C,B03,188277,Staff,14,0,30,16
1683641885540,MATH 18,A01,188344,Bach; Quang Tran,18,0,30,12
1683641885540,MATH 18,A02,188345,Bach; Quang Tran,11,0,30,19
1683641885540,MATH 18,B01,188353,Bach; Quang Tran,11,0,30,19
1683641885540,MATH 18,B02,188354,Bach; Quang Tran,19,0,30,11
1683641886568,MATH 20A,A01,188374,Staff,11,0,35,24
1683641887595,MATH 20B,A01,188382,Ohm; Ko Woon,7,0,30,23
1683641887595,MATH 20B,A02,188383,Ohm; Ko Woon,22,0,30,8
1683641887595,MATH 20B,B01,188385,Ohm; Ko Woon,7,0,30,23
1683641887595,MATH 20B,B02,188392,Ohm; Ko Woon,22,0,30,8
1683641888627,MATH 20C,A01,188394,Harel; Guershon,11,0,30,19
1683641888627,MATH 20C,A02,188395,Harel; Guershon,14,0,30,16
1683641888627,MATH 20C,B01,188404,Harel; Guershon,4,0,30,26
1683641888627,MATH 20C,B02,188405,Harel; Guershon,18,0,30,12
1683641889659,MATH 20D,A01,188414,Hammock; Frances H,0,1,30,30
1683641889659,MATH 20D,A02,188415,Hammock; Frances H,0,1,30,30
1683641889659,MATH 20D,B01,188447,Hammock; Frances H,0,1,30,30
1683641889659,MATH 20D,B02,188486,Hammock; Frances H,4,0,30,26
1683641890685,MATH 20E,A01,188649,Staff,21,0,30,9
1683641890685,MATH 20E,A02,188650,Staff,21,0,30,9
1683641890685,MATH 20E,A03,188673,Staff,0,0,30,30
1683641891711,MATH 102,A01,188675,Staff,0,36,35,35
1683641892737,MATH 103B,A01,188681,Staff,3,0,35,32
1683641892737,MATH 103B,B01,188692,Staff,5,0,35,30
1683641893762,MATH 109,A01,188695,Salehi Golsefidy; Alireza,24,0,35,11
1683641893762,MATH 109,A02,188696,Salehi Golsefidy; Alireza,25,0,35,10
1683641894787,MATH 120A,A01,188698,Eggers; John Dietrich,7,0,35,28
1683641895813,MATH 142B,A01,188736,Ioana; Adrian,0,1,30,30
1683641895813,MATH 142B,A02,188741,Ioana; Adrian,0,1,30,30
1683641895813,MATH 142B,A03,188743,Ioana; Adrian,0,1,30,30
1683641896839,MATH 168A,A01,188790,Staff,0,10,35,35
1683641897866,MATH 170A,A01,188803,Nie; Jiawang,0,2,35,35
1683641897866,MATH 170A,A02,188811,Nie; Jiawang,0,0,35,35
1683641897866,MATH 170A,A03,188814,Nie; Jiawang,0,0,35,35
1683641897866,MATH 170A,A04,188815,Nie; Jiawang,10,0,35,25
1683641898892,MATH 193B,A01,188817,Staff,0,0,35,35
1683641898892,MATH 193B,A02,188818,Staff,5,0,35,30
1683641899917,MGT 4,A01,202857,Anderson; John Charles,61,0,80,19
1683641900941,MGT 12,A00,202858,Lindenberger; Wade Douglas,40,0,90,50
1683641901965,MGT 18,A00,202859,Staff,74,0,90,16
1683641902994,MGT 18GS,A00,202860,McKay; Michael J,13,0,28,15
1683641904018,MGT 45,A00,202861,Pecore; Joseph P.,12,0,90,78
1683641905045,MGT 100,A00,202863,Yavorsky; Daniel Ryan,28,0,90,62
1683641906071,MGT 103,A00,202864,Ehrich; Kristine R,0,17,90,90
1683641907097,MGT 112,A00,202865,Ehrich; Kristine R,15,0,90,75
1683641908122,MGT 121A,A00,202868,Staff,0,20,0,0
1683641909148,MGT 131B,A00,202869,Anderson; John Charles,59,0,90,31
1683641910176,MGT 136,A00,202871,Lindenberger; Wade Douglas,83,0,90,7
1683641911203,MGT 164,A00,202873,Staff,0,66,90,91
1683641912228,MGT 164GS,A00,202874,McKay; Mary A,13,0,28,15
1683641913255,MGT 180,A00,202875,Staff,0,50,90,91
1683641914281,MMW 11R,A01,205019,Herbst; Matthew,2,0,30,28
1683641914281,MMW 11R,A02,205026,Herbst; Matthew,29,0,30,1
1683641915306,MMW 15,A01,193512,Chang; Edmond Yi-Teh,0,8,28,28
1683641915306,MMW 15,A02,193513,Chang; Edmond Yi-Teh,0,5,28,28
1683641915306,MMW 15,A03,193514,Chang; Edmond Yi-Teh,0,5,28,28
1683641915306,MMW 15,A04,193515,Chang; Edmond Yi-Teh,0,5,28,28
1683641915306,MMW 15,A05,193516,Chang; Edmond Yi-Teh,0,5,28,28
1683641915306,MMW 15,A06,193517,Chang; Edmond Yi-Teh,0,6,28,28
1683641915306,MMW 15,B01,193519,Chang; Edmond Yi-Teh,0,5,28,28
1683641915306,MMW 15,B02,193520,Chang; Edmond Yi-Teh,0,5,28,28
1683641915306,MMW 15,B03,193521,Chang; Edmond Yi-Teh,0,5,28,28
1683641915306,MMW 15,B04,193522,Chang; Edmond Yi-Teh,0,5,28,28
1683641915306,MMW 15,B05,193523,Chang; Edmond Yi-Teh,0,5,28,28
1683641915306,MMW 15,B06,193524,Chang; Edmond Yi-Teh,0,5,28,28
1683641916331,MMW 122,A01,193526,Rahimi; Babak,0,16,28,28
1683641916331,MMW 122,A02,193527,Rahimi; Babak,0,15,28,28
1683641916331,MMW 122,A03,193528,Rahimi; Babak,0,0,0,0
1683641916331,MMW 122,A04,193529,Rahimi; Babak,0,0,0,0
1683641917357,MUS 1A,A01,186663,Staff,1,20,35,34
1683641918382,MUS 4,A01,186715,Staff,0,12,35,35
1683641919411,MUS 5R,A01,186796,Dubnov; Shlomo,0,17,35,35
1683641920437,MUS 6,A01,186798,Staff,0,5,25,25
1683641921465,MUS 7,A01,186830,Staff,11,0,35,24
1683641922489,MUS 8,A01,186930,Staff,0,26,35,35
1683641923515,MUS 15,A01,186932,Staff,0,16,35,35
1683641923515,MUS 15,B01,186934,Staff,0,17,35,35
1683641924545,MUS 80,A00,186935,Staff,0,0,20,20
1683641924545,MUS 80,B00,186936,Staff,24,0,25,1
1683641925574,NANO 11,A00,204702,Lipomi; Darren John,0,0,0,0
1683641926603,NANO 15,A01,204709,Yang; Kesong,0,1,0,0
1683641927631,NANO 114,A00,202069,Jahed Motlagh; Zeinab,3,0,10,7
1683641928656,PHIL 1,A00,186955,Grush; Rick Scott,31,0,40,9
1683641929685,PHIL 10,A01,186973,Grush; Rick Scott,27,0,35,8
1683641929685,PHIL 10,A02,186974,Grush; Rick Scott,33,0,35,2
1683641930710,PHIL 13,A01,186976,Staff,3,0,35,32
1683641930710,PHIL 13,A02,186977,Staff,16,0,35,19
1683641931736,PHIL 14,A01,186979,Staff,31,0,35,4
1683641931736,PHIL 14,A02,186986,Staff,32,0,35,3
1683641932764,PHIL 28,A01,186988,Staff,16,0,30,14
1683641932764,PHIL 28,A02,186989,Staff,1,0,30,29
1683641932764,PHIL 28,A03,186990,Staff,10,0,30,20
1683641932764,PHIL 28,A04,186991,Staff,26,0,30,4
1683641933793,PHIL 120,A00,186997,Staff,23,0,40,17
1683641934819,PHIL 137,A00,187003,Staff,7,0,40,33
1683641935844,PHIL 150,A00,187015,Staff,47,0,70,23
1683641936870,PHIL 167,A00,187021,Lamey; Andy M.,34,0,40,6
1683641937896,PHIL 174,A01,202226,Staff,17,0,20,3
1683641937896,PHIL 174,A02,202235,Staff,20,0,20,0
1683641938922,PHIL 191A,A00,258918,Staff,0,0,1,1
1683641939945,PHYS 1A,A00,187028,Staff,27,0,60,33
1683641940974,PHYS 1AL,001,187036,Staff,3,0,30,27
1683641940974,PHYS 1AL,002,187049,Staff,18,0,30,12
1683641941999,PHYS 1B,A00,187058,Staff,22,0,60,38
1683641943029,PHYS 1BL,001,187064,Staff,0,1,30,30
1683641943029,PHYS 1BL,002,187070,Staff,4,0,30,26
1683641944054,PHYS 1C,A00,187082,Staff,29,0,120,91
1683641945082,PHYS 1CL,001,187088,Staff,0,9,30,30
1683641945082,PHYS 1CL,002,187089,Staff,0,1,30,30
1683641945082,PHYS 1CL,009,262693,Staff,9,0,30,21
1683641946107,PHYS 2B,A01,187097,Staff,55,0,115,60
1683641947132,PHYS 2C,A01,187099,Staff,64,0,115,51
1683641948163,PHYS 2CL,A01,187101,Staff,5,0,28,23
1683641948163,PHYS 2CL,A02,187102,Staff,15,0,28,13
1683641949195,PHYS 2D,A01,187123,Shotwell; Brian,95,0,115,20
1683641950219,PHYS 4B,A01,187133,Grinstein; Benjamin,35,0,50,15
1683641951245,POLI 10,A00,188819,Staff,0,4,50,50
1683641952270,POLI 11,A00,188827,Staff,43,0,50,7
1683641953294,POLI 13R,A00,188828,Staff,0,1,20,20
1683641954322,POLI 27,A01,188830,Elgin; Samuel Zincke,0,2,70,70
1683641955349,POLI 30,A00,188832,Desposato; Scott,30,0,50,20
1683641956375,POLI 102F,A00,188834,Staff,0,0,40,40
1683641957402,POLI 104A,A00,188852,Staff,13,0,30,17
1683641958431,POLI 104I,A00,188853,Staff,0,7,20,20
1683641959457,POLI 110B,A00,188854,Wiens; David,7,0,20,13
1683641960482,POLI 112A,A00,188855,Wiens; David,4,0,30,26
1683641961510,POLI 117R,A00,188856,Forman; Fonna,0,12,20,20
1683641962534,POLI 118,A00,188857,Ingham; Sean,8,0,20,12
1683641963624,POLI 120G,A00,188858,Staff,8,0,30,22
1683641964651,POLI 131CR,A00,188863,Hoston; Germaine,21,0,50,29
1683641965676,POLI 133,A00,188864,Nellis; Gareth Hb,44,0,50,6
1683641966704,POLI 134D,A00,188865,Desposato; Scott,27,0,30,3
1683641967729,POLI 142A,A00,188871,Gartzke; Erik,21,0,50,29
1683641968757,POLI 142K,A00,188874,Staff,38,0,50,12
1683641969789,POLI 143,A00,188940,Gartzke; Erik,16,0,30,14
1683641970817,POLI 153,A00,188943,Staff,2,0,20,18
1683641971842,POLI 160AA,A00,188944,Staff,11,0,40,29
1683641972871,POLI 170A,A00,188945,Staff,11,0,30,19
1683641974922,PSYC 1,A00,188952,Staff,36,0,90,54
1683641975946,PSYC 2,B00,188953,Staff,19,0,35,16
1683641976971,PSYC 6,A00,188970,Staff,47,0,60,13
1683641977997,PSYC 7,A00,188973,Staff,35,0,45,10
1683641979027,PSYC 60,A01,188980,Rickard; Timothy C.,42,0,60,18
1683641980051,PSYC 70,A01,189001,Steiner; Eric Tomas,23,0,45,22
1683641981076,PSYC 100,A00,189005,Lacefield; Katharine I,0,99,120,120
1683641982101,PSYC 102,A00,189008,Staff,8,0,30,22
1683641983126,PSYC 106,B00,189026,Gorman; Michael R.,27,0,60,33
1683641984156,PSYC 114,B01,189033,Winkielman; Piotr,0,31,30,30
1683641985181,PSYC 131,A00,189036,Anagnostaras; Stephan,0,43,60,60
1683641986213,PSYC 136,A00,189041,Lowe; Angela Beth,0,7,25,25
1683641987241,PSYC 137,A00,189057,Winkielman; Piotr,0,37,25,25
1683641988266,PSYC 144,A00,189107,Wixted; John T,0,10,50,50
1683641990318,PSYC 162,A00,189142,Staff,0,9,85,85
1683641991348,PSYC 172,A00,189144,Gorman; Michael R.,0,6,30,30
1683641993401,PSYC 179,A00,189146,Lacefield; Katharine I,0,86,120,120
1683641994425,PSYC 181,A00,189147,Anagnostaras; Stephan,0,44,90,90
1683641995453,PSYC 190R,A00,189148,Barner; David A.,0,23,80,80
1683641996482,PSYC 191,A00,189275,Rickard; Timothy C.,0,10,25,25
1683641997509,PSYC 193,A00,189276,Chapman; Eddie Nathaniel,0,1,0,4
1683641998532,PSYC 193L,A01,189281,Lowe; Angela Beth,10,0,20,10
1683641998532,PSYC 193L,B01,189285,Staff,28,0,35,7
1683641999558,RELI 149,A00,187137,Rahimi; Babak,7,0,40,33
1683642000586,SE 9,A01,187315,Staff,0,2,18,18
1683642001610,SE 101B,A00,187409,Staff,24,0,30,6
1683642002642,SE 110B,A00,187444,Staff,10,0,40,30
1683642003666,SE 130B,A00,187449,Staff,31,0,40,9
1683642004695,SE 150A,A00,187516,Staff,9,0,20,11
1683642005719,SE 154,A00,187528,Staff,29,0,50,21
1683642006747,SIO 3,A01,258171,Staff,35,0,40,5
1683642007773,SIO 10,A00,187144,Cook; Geoffrey W,0,6,75,75
1683642008797,SIO 45,A00,187152,Cook; Geoffrey W,0,4,100,100
1683642009823,SIO 109R,A00,194486,Staff,0,4,20,20
1683642011877,SIO 187,A01,187233,Kacev; David,12,0,40,28
1683642012903,SOCI 1,A01,258656,Thorpe; Charles Robert,28,0,30,2
1683642012903,SOCI 1,A02,258658,Thorpe; Charles Robert,30,0,30,0
1683642012903,SOCI 1,A03,258661,Thorpe; Charles Robert,25,0,25,0
1683642012903,SOCI 1,A04,258666,Thorpe; Charles Robert,22,0,25,3
1683642012903,SOCI 1,A05,258897,Thorpe; Charles Robert,22,0,25,3
1683642012903,SOCI 1,A06,258898,Thorpe; Charles Robert,25,0,25,0
1683642013928,SOCI 30,A01,258903,Pardo Guerra; Juan Pablo,14,0,30,16
1683642014953,SOCI 102,A00,258904,Staff,9,0,25,16
1683642015978,SOCI 106,A00,258905,Staff,19,0,25,6
1683642017007,SOCI 111,A00,258907,Ribas Norris; Janet Vanesa,26,0,30,4
1683642018035,SOCI 121R,A00,258908,Pardo Guerra; Juan Pablo,8,0,30,22
1683642019063,SOCI 126,A01,203330,Staff,14,0,20,6
1683642020092,SOCI 131,A00,258909,Thorpe; Charles Robert,30,0,60,30
1683642021117,SOCI 135,A00,258910,Payne; Christine Anna,0,11,30,30
1683642022145,SOCI 157,A00,258911,Staff,12,0,30,18
1683642023169,SOCI 184,A00,258912,Staff,25,0,30,5
1683642024197,SOCI 188D,A00,258913,Staff,22,0,30,8
1683642025220,SYN 2,001,187529,Staff,9,0,16,7
1683642025220,SYN 2,002,201452,Staff,0,20,16,16
1683642025220,SYN 2,003,201469,Staff,2,0,16,14
1683642026243,SYN 100,A01,187531,Staff,0,9,20,20
1683642026243,SYN 100,B01,201491,Staff,0,10,20,20
1683642027267,TDAC 1,A00,189286,Walsh; Kim C.,3,0,20,17
1683642027267,TDAC 1,B00,189287,Harting; Carla Kelso,10,0,20,10
1683642028297,TDAC 101,A00,189300,Walsh; Kim C.,16,0,20,4
1683642028297,TDAC 101,B00,189301,Harting; Carla Kelso,18,0,20,2
1683642029322,TDAC 102,A00,189304,Basso; Beatrice,14,0,20,6
1683642030347,TDAC 108,A00,189305,Staff,18,0,20,2
1683642031377,TDDE 131,A00,189310,Staff,19,0,20,1
1683642031377,TDDE 131,B00,189314,Staff,19,0,20,1
1683642031377,TDDE 131,C00,189315,Staff,48,0,50,2
1683642031377,TDDE 131,D00,189316,Staff,14,0,15,1
1683642031377,TDDE 131,E00,204841,Staff,20,0,20,0
1683642032402,TDGE 10,A00,189289,Staff,27,0,50,23
1683642032402,TDGE 10,B00,189290,Havis; Allan,0,0,50,50
1683642033428,TDGE 11,A00,189291,Fulton; Julia,0,4,50,50
1683642033428,TDGE 11,B00,189292,Staff,20,0,25,5
1683642033428,TDGE 11,C00,260270,Staff,0,0,0,0
1683642034451,TDGE 25,A00,189294,Staff,2,0,20,18
1683642035475,TDGE 124,A00,189318,Fulton; Julia,0,8,50,50
1683642036503,TDGE 125,A00,189319,Staff,13,0,25,12
1683642036503,TDGE 125,B00,189320,Staff,23,0,25,2
1683642037527,TDGE 127,A00,189322,Havis; Allan,0,0,50,50
1683642038555,TDHT 101,A00,189323,Staff,18,0,25,7
1683642038555,TDHT 101,B00,189324,Staff,25,0,25,0
1683642039579,TDHT 102,A00,189325,Staff,49,0,50,1
1683642040618,TDMV 1,A00,189295,Arcidiacono; Kristin,20,0,30,10
1683642040618,TDMV 1,B00,189296,Caligagan; Maria T.,24,0,30,6
1683642041642,TDMV 2,A00,189297,Sammartano; Tonnie,27,0,30,3
1683642041642,TDMV 2,B00,189299,Arcidiacono; Kristin,23,0,30,7
1683642042671,TDMV 3,A00,204998,Rincon; Alicia,22,0,30,8
1683642043696,TDMV 120,A00,189458,Sammartano; Tonnie,28,0,30,2
1683642044721,TDMV 138,A00,189541,Jun; Grace Shin Hae,20,0,40,20
1683642045746,TDMV 142,A00,189717,Caligagan; Tony,25,0,30,5
1683642045746,TDMV 142,B00,189718,Caligagan; Maria T.,25,0,30,5
1683642046770,TMC 2,A01,187533,Staff,25,0,25,0
1683642046770,TMC 2,A02,187534,Staff,25,0,25,0
1683642047795,USP 1,A01,187536,Kwak; Nancy,0,16,25,25
1683642048820,USP 5,A01,187538,Staff,9,0,25,16
1683642049846,USP 101,A00,199253,Staff,0,4,0,0
1683642050874,USP 124,A00,187562,Boomhower; Matthew Charles,0,0,30,30
1683642051898,USP 138,A00,187582,Staff,20,0,25,5
1683642052926,USP 152,A01,187597,Staff,3,0,25,22
1683642053951,USP 153,A00,187598,Staff,19,0,25,6
1683642054974,USP 168,A00,187607,Kwak; Nancy,2,0,5,3
1683642056001,USP 173,A00,187619,Staff,4,0,25,21
1683642057026,USP 181,A00,187638,Staff,0,4,25,25
1683642058056,VIS 103,A00,187650,Cruz; Edwin Teddy,18,0,75,57
1683642059081,VIS 110D,A00,187669,Staff,13,0,22,9
1683642060110,VIS 127C,A00,187720,Shen; Kuiyi,67,0,146,79
1683642061139,VIS 149,A00,187731,Yoldas; Pinar,0,14,22,22
1683642062165,VIS 151,A01,188091,Staff,22,0,34,12
1683642062165,VIS 151,A02,188092,Staff,11,0,34,23
1683642063196,VIS 160B,A00,188093,Stalbaum; Brett,0,1,10,10
1683642065247,WCWP 10B,A00,201720,Staff,10,0,15,5
1683642065247,WCWP 10B,B00,201722,Staff,9,0,15,6
1683642066278,WCWP 100,A00,201725,Gagnon; Jeffrey C,0,0,2,2
1683642066278,WCWP 100,B00,201727,Staff,0,4,15,15
1683642069443,ANBI 133,A00,258401,Wilder; Linnea Lorene,34,0,40,6
1683642070475,ANBI 140,A00,258395,Hrvoj Mihic; Branka,18,0,25,7
1683642071501,ANSC 120,A00,258402,Bialecki; Jon Anthony,27,0,40,13
1683642072532,ANSC 144,A00,258400,Staff,12,0,40,28
1683642074581,ANSC 166,A00,258396,Parish; Steven Martin,156,0,175,19
1683642075606,ANSC 180,A00,193533,Staff,8,0,20,12
1683642076631,ANSC 188,A00,258397,Jassal; Aftab,34,0,40,6
1683642077654,ANTH 3,A01,258316,Staff,23,0,30,7
1683642078683,ANTH 5,A00,258394,Semendeferi; Ekaterini,16,0,20,4
1683642079710,ANTH 21,A01,258331,Staff,4,0,40,36
1683642080739,ANTH 103,A00,258398,Varma; Saiba,15,0,25,10
1683642081773,AWP 10,001,202034,Staff,0,0,0,0
1683642081773,AWP 10,002,202035,Staff,0,0,0,0
1683642081773,AWP 10,003,202036,Staff,0,0,0,0
1683642081773,AWP 10,004,202037,Staff,0,0,0,0
1683642081773,AWP 10,005,202038,Staff,0,0,0,0
1683642081773,AWP 10,006,202039,Staff,0,0,0,0
1683642081773,AWP 10,007,202040,Staff,0,0,0,0
1683642081773,AWP 10,008,202041,Staff,0,0,0,0
1683642081773,AWP 10,009,202042,Staff,0,0,0,0
1683642081773,AWP 10,010,202043,Staff,0,0,0,0
1683642081773,AWP 10,011,202044,Staff,0,0,0,0
1683642081773,AWP 10,012,202045,Staff,0,0,0,0
1683642081773,AWP 10,013,202046,Staff,0,0,0,0
1683642081773,AWP 10,014,202047,Staff,0,0,0,0
1683642081773,AWP 10,015,202048,Staff,0,0,0,0
1683642081773,AWP 10,016,202049,Staff,0,0,0,0
1683642081773,AWP 10,017,202050,Staff,0,0,0,0
1683642081773,AWP 10,018,202051,Staff,0,0,0,0
1683642081773,AWP 10,019,202052,Staff,0,0,0,0
1683642081773,AWP 10,020,202053,Staff,0,0,0,0
1683642081773,AWP 10,021,202054,Staff,0,0,0,0
1683642081773,AWP 10,022,202055,Staff,0,0,0,0
1683642081773,AWP 10,023,202056,Staff,0,0,0,0
1683642081773,AWP 10,024,202057,Staff,0,0,0,0
1683642081773,AWP 10,025,202058,Staff,0,0,0,0
1683642081773,AWP 10,026,202059,Staff,0,0,0,0
1683642082799,AWP 102,001,202032,Staff,0,0,0,0
1683642082799,AWP 102,002,202033,Staff,0,0,0,0
1683642083828,BENG 100,A01,254234,Taylor Amos; Alyssa C,31,0,40,9
1683642084853,BENG 196,001,270013,Engler; Adam J.,9999,0,9999,0
1683642085881,BICD 100R,A01,202018,Smith; Laurie,0,7,32,32
1683642085881,BICD 100R,A02,202019,Smith; Laurie,0,3,32,32
1683642085881,BICD 100R,A03,202020,Smith; Laurie,0,1,32,32
1683642085881,BICD 100R,A04,202021,Smith; Laurie,6,0,32,26
1683642085881,BICD 100R,A05,202022,Smith; Laurie,11,0,32,21
1683642086906,BICD 136,A01,193242,Gustafson-Brown; Cindy,0,2,32,32
1683642086906,BICD 136,A02,193244,Gustafson-Brown; Cindy,13,0,32,19
1683642087931,BIEB 102,A01,193249,Butler; Shannon Rhey,0,2,32,32
1683642087931,BIEB 102,A02,193251,Butler; Shannon Rhey,0,0,32,32
1683642087931,BIEB 102,A03,193253,Butler; Shannon Rhey,0,0,32,32
1683642087931,BIEB 102,A04,193255,Butler; Shannon Rhey,14,0,32,18
1683642087931,BIEB 102,A05,193265,Butler; Shannon Rhey,26,0,32,6
1683642087931,BIEB 102,A06,193269,Butler; Shannon Rhey,14,0,32,18
1683642089984,BIEB 150,A01,193274,Staff,0,0,32,32
1683642089984,BIEB 150,A02,193285,Staff,24,0,32,8
1683642091010,BIEB 194,A00,193286,Kurle; Carolyn M.,20,0,32,12
1683642092034,BILD 1,A01,192291,Staff,15,0,32,17
1683642092034,BILD 1,A02,192292,Staff,30,0,32,2
1683642092034,BILD 1,B01,192520,Reuther; Keefe,0,1,0,0
1683642092034,BILD 1,B02,192532,Reuther; Keefe,0,1,0,0
1683642093065,BILD 3,A01,192556,Butler; Shannon Rhey,0,0,32,32
1683642093065,BILD 3,A02,192581,Butler; Shannon Rhey,1,0,32,31
1683642093065,BILD 3,A03,192611,Butler; Shannon Rhey,21,0,32,11
1683642093065,BILD 3,A04,192612,Butler; Shannon Rhey,24,0,32,8
1683642093065,BILD 3,A05,192613,Butler; Shannon Rhey,26,0,32,6
1683642093065,BILD 3,A06,192679,Butler; Shannon Rhey,27,0,32,5
1683642093065,BILD 3,A07,192682,Butler; Shannon Rhey,20,0,32,12
1683642094090,BILD 4,A01,192836,Reuther; Keefe,0,0,24,24
1683642094090,BILD 4,A02,193044,Reuther; Keefe,4,0,24,20
1683642095116,BILD 10,A01,193142,Gustafson-Brown; Cindy,29,0,32,3
1683642095116,BILD 10,A02,193149,Gustafson-Brown; Cindy,31,0,32,1
1683642096146,BIMM 100,A01,193301,Staff,0,6,32,32
1683642096146,BIMM 100,A02,193312,Staff,0,7,32,32
1683642096146,BIMM 100,A03,193323,Staff,0,9,32,32
1683642097178,BIMM 101,A01,193329,McDonnell; Lisa Marie,0,4,24,24
1683642097178,BIMM 101,A02,193339,McDonnell; Lisa Marie,0,3,24,24
1683642097178,BIMM 101,B01,193354,McDonnell; Lisa Marie,0,4,24,24
1683642097178,BIMM 101,B02,193357,McDonnell; Lisa Marie,0,2,24,24
1683642098201,BIMM 110,A01,193377,Tat; John,0,11,32,32
1683642098201,BIMM 110,A02,193378,Tat; John,0,10,32,32
1683642099233,BIMM 120,A01,206116,Staff,0,0,32,32
1683642099233,BIMM 120,A02,206117,Staff,6,0,32,26
1683642099233,BIMM 120,A03,206121,Staff,21,0,32,11
1683642100262,BIPN 100,A01,193393,Park; Ji Young,0,14,32,32
1683642100262,BIPN 100,A02,193402,Park; Ji Young,0,14,32,32
1683642100262,BIPN 100,A03,193413,Park; Ji Young,0,14,32,32
1683642100262,BIPN 100,A04,193414,Park; Ji Young,0,13,32,32
1683642101287,BIPN 102,A01,193429,Staff,0,0,32,32
1683642101287,BIPN 102,A02,193438,Staff,18,0,32,14
1683642102317,BIPN 106,A01,193450,Reyes Gonzalez; Catalina,0,2,40,40
1683642103342,BIPN 134,A01,193465,Cooke; James Edward,0,0,32,32
1683642103342,BIPN 134,A02,193474,Cooke; James Edward,25,0,32,7
1683642103342,BIPN 134,A03,193485,Cooke; James Edward,29,0,32,3
1683642103342,BIPN 134,A04,193486,Cooke; James Edward,20,0,32,12
1683642103342,BIPN 134,A05,193491,Cooke; James Edward,31,0,32,1
1683642103342,BIPN 134,A06,193501,Cooke; James Edward,30,0,32,2
1683642103342,BIPN 134,A07,193510,Cooke; James Edward,29,0,32,3
1683642105395,BISP 194,A00,222522,Staff,14,0,32,18
1683642106419,CAT 124,A01,202407,Staff,19,0,25,6
1683642107445,CAT 125,A00,202408,Marchisotto; Jennifer Anne,2,0,20,18
1683642108472,CAT 125R,A00,202409,Smith; Lauryn Alissa,0,11,20,20
1683642108472,CAT 125R,B00,202410,Morales; Celeste Georgianna,0,11,20,20
1683642108472,CAT 125R,C00,202411,Irwin; Matthew Joseph,0,12,20,20
1683642109495,CENG 15,A01,204712,Yang; Kesong,0,1,0,0
1683642110523,CENG 114,A00,202070,Jahed Motlagh; Zeinab,5,0,20,15
1683642111549,CGS 105,A00,185477,Wesling; Megan E.,24,0,40,16
1683642112578,CGS 106,A00,185494,Staff,11,0,22,11
1683642113601,CGS 108,A00,185495,Staff,14,0,20,6
1683642114629,CGS 114,A00,185496,Staff,13,0,18,5
1683642115653,CGS 119,A00,185501,Staff,15,0,20,5
1683642116680,CGS 120,A00,185511,Staff,12,0,20,8
1683642117710,CHEM 4,A01,184675,Bussey; Thomas J,97,0,100,3
1683642118734,CHEM 6A,A01,184677,Staff,33,0,60,27
1683642119759,CHEM 6B,A01,184679,Staff,63,0,100,37
1683642120787,CHEM 6C,A01,184681,Bussey; Thomas J,0,0,50,50
1683642120787,CHEM 6C,A02,184682,Bussey; Thomas J,32,0,50,18
1683642121814,CHEM 40A,A01,184684,Albizati; Kim F.,35,0,100,65
1683642122843,CHEM 40B,A01,184686,Albizati; Kim F.,0,22,100,100
1683642123871,CHEM 41B,A01,184690,Staff,51,0,100,49
1683642124899,COGS 3,A01,184715,Boyle; Mary E. T.,0,27,40,40
1683642125926,COGS 14B,A01,185172,Staff,0,14,38,38
1683642126954,COGS 18,A01,184736,Staff,15,0,80,65
1683642127980,COGS 100,A01,184932,Staff,0,7,73,73
1683642129008,COGS 101A,A01,184935,Staff,0,39,30,30
1683642130033,COGS 101B,A01,184944,Staff,0,2,30,30
1683642131057,COGS 101C,A01,184946,Staff,0,10,30,30
1683642132083,COGS 102A,A01,184951,Johnson; Christine M.,2,0,40,38
1683642133110,COGS 107B,A01,184953,Mooshagian; Eric Frederick,0,51,40,40
1683642134134,COGS 118B,A01,184959,Gupta; Anjum,0,49,40,40
1683642135173,COGS 153,A00,184961,Staff,0,16,30,30
1683642136200,COGS 177,A00,184962,Staff,0,21,30,30
1683642137227,COGS 187A,A01,184969,Boyle; Mary E. T.,0,19,40,40
1683642138252,COMM 10,A01,185174,Staff,0,5,25,25
1683642138252,COMM 10,A02,185189,Staff,0,2,25,25
1683642138252,COMM 10,A03,269821,Staff,0,1,0,0
1683642139280,COMM 100B,A01,185475,Staff,0,1,0,2
1683642139280,COMM 100B,A02,185476,Staff,12,0,25,13
1683642140304,COMM 100C,A01,185314,Staff,1,0,25,24
1683642140304,COMM 100C,A02,185327,Staff,18,0,25,7
1683642141329,COMM 110M,A00,185349,Staff,0,0,40,40
1683642142353,COMM 113T,A00,185352,Staff,25,0,40,15
1683642143377,COMM 114I,A00,185353,Staff,31,0,40,9
1683642144404,COMM 131,A00,185354,Staff,17,0,30,13
1683642145429,CSE 8A,A50,185358,Cao; Yingjun,0,46,10,10
1683642146456,CSE 8B,A01,185362,Staff,0,48,50,50
1683642147482,CSE 11,A01,185416,Cao; Yingjun,0,91,10,10
1683642148505,CSE 20,A01,185445,Briones; Jor-el Thomas Caparas,4,0,25,21
1683642149533,CSE 21,A01,185447,Staff,9,0,50,41
1683642150562,CSE 101,A01,185451,Staff,0,13,50,50
1683642150562,CSE 101,B01,185453,Jones; Miles E,0,13,50,50
1683642152615,CSE 141,A01,185458,Eldon; John,15,0,100,85
1683642153642,CSE 141L,A01,185461,Eldon; John,7,0,100,93
1683642154667,CSE 142,A01,185463,Staff,36,0,60,24
1683642154667,CSE 142,B01,201355,Staff,0,7,60,60
1683642155691,CSE 142L,A01,185470,Staff,36,0,60,24
1683642155691,CSE 142L,B01,201417,Staff,0,6,60,60
1683642156720,CSE 190,A00,201433,Staff,32,0,49,17
1683642157745,DOC 1,A01,259136,Strom; Megan C.,7,0,15,8
1683642157745,DOC 1,A02,259137,Strom; Megan C.,14,0,15,1
1683642157745,DOC 1,A03,259138,Strom; Megan C.,14,0,15,1
1683642157745,DOC 1,A04,259139,Strom; Megan C.,14,0,15,1
1683642158769,DOC 100D,A00,259140,Pass; Natalye Joann,14,0,25,11
1683642159799,DSGN 1,A01,184749,Rill; Bryan,0,26,30,30
1683642160827,DSGN 100,A01,185168,Staff,0,2,25,25
1683642161852,ECE 5,A01,185626,Morris; Karcher William,0,11,0,0
1683642162881,ECE 101,A01,185628,Staff,14,0,70,56
1683642163914,ECE 107,A01,185635,Baghdadchi; Saharnaz,0,0,20,20
1683642163914,ECE 107,A02,185638,Baghdadchi; Saharnaz,3,0,20,17
1683642164938,ECE 148,A01,185647,Silberman; Jack,0,0,16,16
1683642165968,ECON 1,A01,185537,Crane; Meredith Helen,54,0,70,16
1683642166992,ECON 3,A01,185549,Crane; Meredith Helen,29,0,70,41
1683642168017,ECON 4,A01,203354,Anderson; John Charles,0,5,10,10
1683642169042,ECON 100A,A01,185574,Staff,0,5,40,40
1683642170070,ECON 100B,A01,185576,Staff,0,12,50,50
1683642171154,ECON 100C,A01,185589,Newhouse; Herbert S,30,0,70,40
1683642172183,ECON 105,A00,185608,Vespa; Emanuel Ignacio,19,0,35,16
1683642173211,ECON 109,A01,185610,Shishkin; Denis,9,0,35,26
1683642174239,ECON 110A,A01,185612,Staff,9,0,40,31
1683642175265,ECON 120A,A01,185615,Staff,20,0,40,20
1683642176291,ECON 120C,A01,185617,Sun; Yixiao,0,20,70,70
1683642177314,ECON 144,A00,203346,Squires; Dale E,2,0,35,33
1683642178341,ECON 171,A01,203349,Newhouse; Herbert S,0,1,35,35
1683642179368,ECON 173A,A01,185621,Toda; Alexis Akira,21,0,35,14
1683642180392,EDS 25,A01,202413,Staff,0,1,0,0
1683642180392,EDS 25,A02,202414,Staff,0,1,0,0
1683642180392,EDS 25,A03,202415,Staff,0,0,0,0
1683642180392,EDS 25,A04,202416,Staff,0,1,0,0
1683642180392,EDS 25,A05,202439,Staff,0,0,0,0
1683642180392,EDS 25,A06,202440,Staff,0,0,0,0
1683642180392,EDS 25,B01,202631,Staff,0,0,0,0
1683642180392,EDS 25,B02,202632,Staff,0,0,0,0
1683642180392,EDS 25,B03,202639,Staff,0,0,0,0
1683642180392,EDS 25,B04,202640,Staff,0,0,0,0
1683642180392,EDS 25,B05,202643,Staff,0,0,0,0
1683642180392,EDS 25,B06,202644,Staff,0,0,0,0
1683642181418,EDS 38,A01,202659,Black; Alison Michelle,24,0,25,1
1683642182444,EDS 115,A00,202652,Staff,18,0,30,12
1683642183471,EDS 125,A00,202649,Staff,13,0,30,17
1683642184499,EDS 126,A01,203332,Staff,30,0,30,0
1683642185524,EDS 139,A00,202838,Staff,16,0,25,9
1683642186550,EDS 146,A01,202655,Staff,14,0,25,11
1683642187580,ENG 15,A00,185667,Staff,0,1,0,0
1683642187580,ENG 15,B00,185672,Staff,0,0,0,0
1683642187580,ENG 15,C00,185675,Staff,0,0,0,0
1683642187580,ENG 15,D00,185682,Staff,0,0,0,0
1683642187580,ENG 15,E00,185684,Staff,0,0,0,0
1683642188607,ETHN 103,A00,185710,Staff,0,8,35,35
1683642189633,ETHN 103A,A00,199228,Man; Simeon S,0,0,9,9
1683642190661,ETHN 109,A00,185711,Staff,16,0,35,19
1683642191685,ETHN 142,A00,185726,Staff,0,4,30,30
1683642192709,ETHN 163J,A00,199229,Man; Simeon S,5,0,8,3
1683642193734,ETHN 168,A00,185727,Staff,7,0,10,3
1683642194758,ETHN 182,A00,185728,Staff,0,0,35,35
1683642195784,ETHN 183,A00,185737,Staff,9,0,18,9
1683642196810,GLBH 111,A01,209361,Burgos; Jose L.,0,0,0,0
1683642198859,HIEU 104,A00,185792,Staff,14,0,20,6
1683642199884,HIEU 115,A00,185800,Staff,0,0,20,20
1683642200913,HIEU 128,A00,185801,Staff,0,9,20,20
1683642201936,HIEU 147,A00,185802,Staff,15,0,20,5
1683642202961,HIEU 154,A00,185823,Staff,11,0,20,9
1683642203988,HILA 102,A00,185826,Staff,14,0,20,6
1683642205013,HILD 2C,A01,185778,Staff,0,13,20,20
1683642206039,HILD 7B,A01,185780,Kwak; Nancy,0,16,32,32
1683642206039,HILD 7B,A02,185781,Kwak; Nancy,0,18,32,32
1683642207067,HILD 30,A01,185791,Staff,12,0,20,8
1683642208093,HISC 119,A00,185830,Golan; Tal,0,9,20,20
1683642209117,HITO 156GS,A00,185831,Patterson; Patrick H.,0,0,0,23
1683642210141,HIUS 103,A00,185832,Man; Simeon S,0,4,20,20
1683642211168,HIUS 117,A00,185836,Kwak; Nancy,2,0,20,18
1683642212196,HIUS 125,A00,185840,Man; Simeon S,0,1,23,23
1683642213221,HIUS 149,A00,185845,Staff,1,0,20,19
1683642214245,HUM 3,A01,185882,Zavodny; Tatiana Sophia,0,7,50,50
1683642214245,HUM 3,B01,185899,Caldwell; Michael Alan,0,18,50,50
1683642215273,HUM 3GS,A00,185900,Patterson; Patrick H.,0,0,0,23
1683642216300,HUM 4,A01,185938,Zroka; Amy Liane,30,0,50,20
1683642216300,HUM 4,B01,185956,Watkins; Eric,0,4,50,50
1683642216300,HUM 4,B02,202209,Watkins; Eric,0,4,50,50
1683642216300,HUM 4,B03,202210,Watkins; Eric,0,4,50,50
1683642217328,HUM 5,A01,185958,West; Geoffrey Scott,2,0,50,48
1683642217328,HUM 5,A02,202215,West; Geoffrey Scott,0,0,50,50
1683642218356,INTL 190,A00,185959,Gagnon; Jeffrey C,0,0,0,9
1683642218356,INTL 190,B00,185960,Lettieri; Michael Joseph,0,0,0,2
1683642219381,JAPN 180,A00,254509,Staff,5,0,30,25
1683642220405,LATI 10,A01,202853,Kennemore; Amy Michelle,4,0,35,31
1683642220405,LATI 10,A02,202854,Kennemore; Amy Michelle,2,0,35,33
1683642220405,LATI 10,A03,270054,Kennemore; Amy Michelle,30,0,30,0
1683642221431,LATI 180,A00,202855,Kennemore; Amy Michelle,11,0,20,9
1683642222455,LAWS 101,A00,201767,Golan; Tal,0,7,40,40
1683642223480,LIFR 1C,A00,185961,Staff,6,0,20,14
1683642224505,LIFR 1CX,A00,185962,Staff,7,0,20,13
1683642225535,LIFR 1D,A00,185963,Staff,7,0,20,13
1683642226561,LIFR 1DX,A00,185964,Staff,7,0,20,13
1683642227586,LIGN 101,A01,186039,Staff,43,0,50,7
1683642228613,LIGN 165,A00,186040,Staff,15,0,50,35
1683642229638,LTCS 108,A00,186041,Staff,5,0,10,5
1683642230662,LTCS 119,A00,186042,Staff,15,0,20,5
1683642231687,LTCS 130,A00,186043,Wesling; Megan E.,15,0,25,10
1683642233739,LTEA 138,A00,186119,Staff,14,0,40,26
1683642234764,LTEN 124,A00,186148,Staff,5,0,25,20
1683642235791,LTEN 178,A00,186149,Staff,7,0,15,8
1683642236819,LTEN 181,A00,186150,Blanco; John D,34,0,40,6
1683642237847,LTWL 120,A00,186160,Staff,20,0,25,5
1683642238873,LTWL 165,A00,186161,Staff,22,0,25,3
1683642239897,LTWR 100,A00,186162,Staff,0,5,15,15
1683642240920,LTWR 102,A00,186163,Doller; Ben,5,0,15,10
1683642241959,MAE 8,A01,186412,Staff,0,0,0,0
1683642242984,MAE 30B,A00,186445,Bahadori; Mohammad Yousef,82,0,100,18
1683642244011,MAE 40,A00,186592,Bewley; Thomas R,10,0,50,40
1683642245038,MAE 101B,A00,186593,Bahadori; Mohammad Yousef,80,0,100,20
1683642246062,MAE 105,A00,186594,Bandaru; Prabhakar,10,0,50,40
1683642247087,MAE 107,A00,186599,Pham; Hieu Tan,0,7,120,120
1683642248112,MAE 148,A01,186660,Silberman; Jack,3,0,16,13
1683642249138,MATH 10A,A01,188095,Staff,0,5,35,35
1683642250164,MATH 10B,A01,188097,Bowers; Adam R.,0,11,30,30
1683642250164,MATH 10B,A02,188099,Bowers; Adam R.,0,11,30,30
1683642250164,MATH 10B,B01,188104,Bowers; Adam R.,0,10,30,30
1683642250164,MATH 10B,B02,188106,Bowers; Adam R.,1,9,30,29
1683642251189,MATH 10C,A01,188111,Staff,0,18,30,30
1683642251189,MATH 10C,A02,188127,Staff,0,19,30,30
1683642251189,MATH 10C,A03,188131,Staff,0,19,30,30
1683642251189,MATH 10C,B01,188218,Staff,17,0,30,13
1683642251189,MATH 10C,B02,188244,Staff,13,0,30,17
1683642251189,MATH 10C,B03,188277,Staff,14,0,30,16
1683642252218,MATH 18,A01,188344,Bach; Quang Tran,18,0,30,12
1683642252218,MATH 18,A02,188345,Bach; Quang Tran,11,0,30,19
1683642252218,MATH 18,B01,188353,Bach; Quang Tran,11,0,30,19
1683642252218,MATH 18,B02,188354,Bach; Quang Tran,19,0,30,11
1683642253244,MATH 20A,A01,188374,Staff,11,0,35,24
1683642254271,MATH 20B,A01,188382,Ohm; Ko Woon,7,0,30,23
1683642254271,MATH 20B,A02,188383,Ohm; Ko Woon,22,0,30,8
1683642254271,MATH 20B,B01,188385,Ohm; Ko Woon,7,0,30,23
1683642254271,MATH 20B,B02,188392,Ohm; Ko Woon,22,0,30,8
1683642255315,MATH 20C,A01,188394,Harel; Guershon,11,0,30,19
1683642255315,MATH 20C,A02,188395,Harel; Guershon,14,0,30,16
1683642255315,MATH 20C,B01,188404,Harel; Guershon,4,0,30,26
1683642255315,MATH 20C,B02,188405,Harel; Guershon,18,0,30,12
1683642256346,MATH 20D,A01,188414,Hammock; Frances H,0,1,30,30
1683642256346,MATH 20D,A02,188415,Hammock; Frances H,0,1,30,30
1683642256346,MATH 20D,B01,188447,Hammock; Frances H,0,1,30,30
1683642256346,MATH 20D,B02,188486,Hammock; Frances H,4,0,30,26
1683642257371,MATH 20E,A01,188649,Staff,21,0,30,9
1683642257371,MATH 20E,A02,188650,Staff,21,0,30,9
1683642257371,MATH 20E,A03,188673,Staff,0,0,30,30
1683642258395,MATH 102,A01,188675,Staff,0,36,35,35
1683642259420,MATH 103B,A01,188681,Staff,3,0,35,32
1683642259420,MATH 103B,B01,188692,Staff,5,0,35,30
1683642260446,MATH 109,A01,188695,Salehi Golsefidy; Alireza,24,0,35,11
1683642260446,MATH 109,A02,188696,Salehi Golsefidy; Alireza,25,0,35,10
1683642261471,MATH 120A,A01,188698,Eggers; John Dietrich,7,0,35,28
1683642262495,MATH 142B,A01,188736,Ioana; Adrian,0,1,30,30
1683642262495,MATH 142B,A02,188741,Ioana; Adrian,0,1,30,30
1683642262495,MATH 142B,A03,188743,Ioana; Adrian,0,1,30,30
1683642263520,MATH 168A,A01,188790,Staff,0,10,35,35
1683642264577,MATH 170A,A01,188803,Nie; Jiawang,0,2,35,35
1683642264577,MATH 170A,A02,188811,Nie; Jiawang,0,0,35,35
1683642264577,MATH 170A,A03,188814,Nie; Jiawang,0,0,35,35
1683642264577,MATH 170A,A04,188815,Nie; Jiawang,10,0,35,25
1683642265604,MATH 193B,A01,188817,Staff,0,0,35,35
1683642265604,MATH 193B,A02,188818,Staff,5,0,35,30
1683642266631,MGT 4,A01,202857,Anderson; John Charles,61,0,80,19
1683642267654,MGT 12,A00,202858,Lindenberger; Wade Douglas,40,0,90,50
1683642268677,MGT 18,A00,202859,Staff,74,0,90,16
1683642269701,MGT 18GS,A00,202860,McKay; Michael J,13,0,28,15
1683642270726,MGT 45,A00,202861,Pecore; Joseph P.,12,0,90,78
1683642271751,MGT 100,A00,202863,Yavorsky; Daniel Ryan,28,0,90,62
1683642272775,MGT 103,A00,202864,Ehrich; Kristine R,0,17,90,90
1683642273800,MGT 112,A00,202865,Ehrich; Kristine R,15,0,90,75
1683642274893,MGT 121A,A00,202868,Staff,0,20,0,0
1683642275921,MGT 131B,A00,202869,Anderson; John Charles,59,0,90,31
1683642276950,MGT 136,A00,202871,Lindenberger; Wade Douglas,83,0,90,7
1683642277976,MGT 164,A00,202873,Staff,0,66,90,91
1683642279004,MGT 164GS,A00,202874,McKay; Mary A,13,0,28,15
1683642280031,MGT 180,A00,202875,Staff,0,50,90,91
1683642281057,MMW 11R,A01,205019,Herbst; Matthew,2,0,30,28
1683642281057,MMW 11R,A02,205026,Herbst; Matthew,29,0,30,1
1683642282086,MMW 15,A01,193512,Chang; Edmond Yi-Teh,0,8,28,28
1683642282086,MMW 15,A02,193513,Chang; Edmond Yi-Teh,0,5,28,28
1683642282086,MMW 15,A03,193514,Chang; Edmond Yi-Teh,0,5,28,28
1683642282086,MMW 15,A04,193515,Chang; Edmond Yi-Teh,0,5,28,28
1683642282086,MMW 15,A05,193516,Chang; Edmond Yi-Teh,0,5,28,28
1683642282086,MMW 15,A06,193517,Chang; Edmond Yi-Teh,0,6,28,28
1683642282086,MMW 15,B01,193519,Chang; Edmond Yi-Teh,0,5,28,28
1683642282086,MMW 15,B02,193520,Chang; Edmond Yi-Teh,0,5,28,28
1683642282086,MMW 15,B03,193521,Chang; Edmond Yi-Teh,0,5,28,28
1683642282086,MMW 15,B04,193522,Chang; Edmond Yi-Teh,0,5,28,28
1683642282086,MMW 15,B05,193523,Chang; Edmond Yi-Teh,0,5,28,28
1683642282086,MMW 15,B06,193524,Chang; Edmond Yi-Teh,0,5,28,28
1683642283109,MMW 122,A01,193526,Rahimi; Babak,0,16,28,28
1683642283109,MMW 122,A02,193527,Rahimi; Babak,0,15,28,28
1683642283109,MMW 122,A03,193528,Rahimi; Babak,0,0,0,0
1683642283109,MMW 122,A04,193529,Rahimi; Babak,0,0,0,0
1683642284133,MUS 1A,A01,186663,Staff,1,20,35,34
1683642285157,MUS 4,A01,186715,Staff,0,12,35,35
1683642286181,MUS 5R,A01,186796,Dubnov; Shlomo,0,17,35,35
1683642287206,MUS 6,A01,186798,Staff,0,5,25,25
1683642288235,MUS 7,A01,186830,Staff,11,0,35,24
1683642289258,MUS 8,A01,186930,Staff,0,26,35,35
1683642290284,MUS 15,A01,186932,Staff,0,16,35,35
1683642290284,MUS 15,B01,186934,Staff,0,17,35,35
1683642291310,MUS 80,A00,186935,Staff,0,0,20,20
1683642291310,MUS 80,B00,186936,Staff,24,0,25,1
1683642292339,NANO 11,A00,204702,Lipomi; Darren John,0,0,0,0
1683642293366,NANO 15,A01,204709,Yang; Kesong,0,1,0,0
1683642294390,NANO 114,A00,202069,Jahed Motlagh; Zeinab,3,0,10,7
1683642295417,PHIL 1,A00,186955,Grush; Rick Scott,31,0,40,9
1683642296441,PHIL 10,A01,186973,Grush; Rick Scott,27,0,35,8
1683642296441,PHIL 10,A02,186974,Grush; Rick Scott,33,0,35,2
1683642297466,PHIL 13,A01,186976,Staff,3,0,35,32
1683642297466,PHIL 13,A02,186977,Staff,16,0,35,19
1683642298488,PHIL 14,A01,186979,Staff,31,0,35,4
1683642298488,PHIL 14,A02,186986,Staff,32,0,35,3
1683642299516,PHIL 28,A01,186988,Staff,16,0,30,14
1683642299516,PHIL 28,A02,186989,Staff,1,0,30,29
1683642299516,PHIL 28,A03,186990,Staff,10,0,30,20
1683642299516,PHIL 28,A04,186991,Staff,26,0,30,4
1683642300544,PHIL 120,A00,186997,Staff,23,0,40,17
1683642301568,PHIL 137,A00,187003,Staff,7,0,40,33
1683642302593,PHIL 150,A00,187015,Staff,47,0,70,23
1683642303621,PHIL 167,A00,187021,Lamey; Andy M.,34,0,40,6
1683642304649,PHIL 174,A01,202226,Staff,17,0,20,3
1683642304649,PHIL 174,A02,202235,Staff,20,0,20,0
1683642305674,PHIL 191A,A00,258918,Staff,0,0,1,1
1683642306699,PHYS 1A,A00,187028,Staff,27,0,60,33
1683642307727,PHYS 1AL,001,187036,Staff,3,0,30,27
1683642307727,PHYS 1AL,002,187049,Staff,18,0,30,12
1683642308755,PHYS 1B,A00,187058,Staff,22,0,60,38
1683642309777,PHYS 1BL,001,187064,Staff,0,1,30,30
1683642309777,PHYS 1BL,002,187070,Staff,4,0,30,26
1683642310805,PHYS 1C,A00,187082,Staff,29,0,120,91
1683642311830,PHYS 1CL,001,187088,Staff,0,9,30,30
1683642311830,PHYS 1CL,002,187089,Staff,0,1,30,30
1683642311830,PHYS 1CL,009,262693,Staff,9,0,30,21
1683642312864,PHYS 2B,A01,187097,Staff,55,0,115,60
1683642313894,PHYS 2C,A01,187099,Staff,64,0,115,51
1683642314919,PHYS 2CL,A01,187101,Staff,5,0,28,23
1683642314919,PHYS 2CL,A02,187102,Staff,15,0,28,13
1683642315945,PHYS 2D,A01,187123,Shotwell; Brian,95,0,115,20
1683642316974,PHYS 4B,A01,187133,Grinstein; Benjamin,35,0,50,15
1683642318003,POLI 10,A00,188819,Staff,0,4,50,50
1683642319029,POLI 11,A00,188827,Staff,43,0,50,7
1683642320054,POLI 13R,A00,188828,Staff,0,1,20,20
1683642321077,POLI 27,A01,188830,Elgin; Samuel Zincke,0,2,70,70
1683642322101,POLI 30,A00,188832,Desposato; Scott,30,0,50,20
1683642323128,POLI 102F,A00,188834,Staff,0,0,40,40
1683642324156,POLI 104A,A00,188852,Staff,13,0,30,17
1683642325180,POLI 104I,A00,188853,Staff,0,7,20,20
1683642326205,POLI 110B,A00,188854,Wiens; David,7,0,20,13
1683642327229,POLI 112A,A00,188855,Wiens; David,4,0,30,26
1683642328255,POLI 117R,A00,188856,Forman; Fonna,0,12,20,20
1683642329280,POLI 118,A00,188857,Ingham; Sean,8,0,20,12
1683642330305,POLI 120G,A00,188858,Staff,8,0,30,22
1683642331331,POLI 131CR,A00,188863,Hoston; Germaine,21,0,50,29
1683642332359,POLI 133,A00,188864,Nellis; Gareth Hb,44,0,50,6
1683642333382,POLI 134D,A00,188865,Desposato; Scott,27,0,30,3
1683642334406,POLI 142A,A00,188871,Gartzke; Erik,21,0,50,29
1683642335434,POLI 142K,A00,188874,Staff,38,0,50,12
1683642336459,POLI 143,A00,188940,Gartzke; Erik,16,0,30,14
1683642337487,POLI 153,A00,188943,Staff,2,0,20,18
1683642338515,POLI 160AA,A00,188944,Staff,11,0,40,29
1683642339545,POLI 170A,A00,188945,Staff,11,0,30,19
1683642341596,PSYC 1,A00,188952,Staff,36,0,90,54
1683642342620,PSYC 2,B00,188953,Staff,19,0,35,16
1683642343647,PSYC 6,A00,188970,Staff,47,0,60,13
1683642344671,PSYC 7,A00,188973,Staff,35,0,45,10
1683642345697,PSYC 60,A01,188980,Rickard; Timothy C.,42,0,60,18
1683642346722,PSYC 70,A01,189001,Steiner; Eric Tomas,23,0,45,22
1683642347751,PSYC 100,A00,189005,Lacefield; Katharine I,0,99,120,120
1683642348774,PSYC 102,A00,189008,Staff,8,0,30,22
1683642349801,PSYC 106,B00,189026,Gorman; Michael R.,27,0,60,33
1683642350826,PSYC 114,B01,189033,Winkielman; Piotr,0,31,30,30
1683642351853,PSYC 131,A00,189036,Anagnostaras; Stephan,0,43,60,60
1683642352879,PSYC 136,A00,189041,Lowe; Angela Beth,0,7,25,25
1683642353906,PSYC 137,A00,189057,Winkielman; Piotr,0,37,25,25
1683642354932,PSYC 144,A00,189107,Wixted; John T,0,10,50,50
1683642356985,PSYC 162,A00,189142,Staff,0,9,85,85
1683642358010,PSYC 172,A00,189144,Gorman; Michael R.,0,6,30,30
1683642360059,PSYC 179,A00,189146,Lacefield; Katharine I,0,86,120,120
1683642361084,PSYC 181,A00,189147,Anagnostaras; Stephan,0,44,90,90
1683642362109,PSYC 190R,A00,189148,Barner; David A.,0,23,80,80
1683642363137,PSYC 191,A00,189275,Rickard; Timothy C.,0,10,25,25
1683642364162,PSYC 193,A00,189276,Chapman; Eddie Nathaniel,0,1,0,4
1683642365191,PSYC 193L,A01,189281,Lowe; Angela Beth,10,0,20,10
1683642365191,PSYC 193L,B01,189285,Staff,28,0,35,7
1683642366214,RELI 149,A00,187137,Rahimi; Babak,7,0,40,33
1683642367238,SE 9,A01,187315,Staff,0,2,18,18
1683642368266,SE 101B,A00,187409,Staff,24,0,30,6
1683642369294,SE 110B,A00,187444,Staff,10,0,40,30
1683642370325,SE 130B,A00,187449,Staff,31,0,40,9
1683642371350,SE 150A,A00,187516,Staff,9,0,20,11
1683642372382,SE 154,A00,187528,Staff,29,0,50,21
1683642373407,SIO 3,A01,258171,Staff,35,0,40,5
1683642374437,SIO 10,A00,187144,Cook; Geoffrey W,0,6,75,75
1683642375489,SIO 45,A00,187152,Cook; Geoffrey W,0,4,100,100
1683642376516,SIO 109R,A00,194486,Staff,0,4,20,20
1683642378628,SIO 187,A01,187233,Kacev; David,12,0,40,28
1683642379654,SOCI 1,A01,258656,Thorpe; Charles Robert,28,0,30,2
1683642379654,SOCI 1,A02,258658,Thorpe; Charles Robert,30,0,30,0
1683642379654,SOCI 1,A03,258661,Thorpe; Charles Robert,25,0,25,0
1683642379654,SOCI 1,A04,258666,Thorpe; Charles Robert,22,0,25,3
1683642379654,SOCI 1,A05,258897,Thorpe; Charles Robert,22,0,25,3
1683642379654,SOCI 1,A06,258898,Thorpe; Charles Robert,25,0,25,0
1683642380684,SOCI 30,A01,258903,Pardo Guerra; Juan Pablo,14,0,30,16
1683642381711,SOCI 102,A00,258904,Staff,9,0,25,16
1683642382736,SOCI 106,A00,258905,Staff,19,0,25,6
1683642383762,SOCI 111,A00,258907,Ribas Norris; Janet Vanesa,26,0,30,4
1683642384788,SOCI 121R,A00,258908,Pardo Guerra; Juan Pablo,8,0,30,22
1683642385814,SOCI 126,A01,203330,Staff,14,0,20,6
1683642386842,SOCI 131,A00,258909,Thorpe; Charles Robert,30,0,60,30
1683642387870,SOCI 135,A00,258910,Payne; Christine Anna,0,11,30,30
1683642388896,SOCI 157,A00,258911,Staff,12,0,30,18
1683642389921,SOCI 184,A00,258912,Staff,25,0,30,5
1683642390946,SOCI 188D,A00,258913,Staff,22,0,30,8
1683642391971,SYN 2,001,187529,Staff,9,0,16,7
1683642391971,SYN 2,002,201452,Staff,0,20,16,16
1683642391971,SYN 2,003,201469,Staff,2,0,16,14
1683642392995,SYN 100,A01,187531,Staff,0,9,20,20
1683642392995,SYN 100,B01,201491,Staff,0,10,20,20
1683642394023,TDAC 1,A00,189286,Walsh; Kim C.,3,0,20,17
1683642394023,TDAC 1,B00,189287,Harting; Carla Kelso,10,0,20,10
1683642395052,TDAC 101,A00,189300,Walsh; Kim C.,16,0,20,4
1683642395052,TDAC 101,B00,189301,Harting; Carla Kelso,18,0,20,2
1683642396081,TDAC 102,A00,189304,Basso; Beatrice,14,0,20,6
1683642397109,TDAC 108,A00,189305,Staff,18,0,20,2
1683642398135,TDDE 131,A00,189310,Staff,19,0,20,1
1683642398135,TDDE 131,B00,189314,Staff,19,0,20,1
1683642398135,TDDE 131,C00,189315,Staff,48,0,50,2
1683642398135,TDDE 131,D00,189316,Staff,14,0,15,1
1683642398135,TDDE 131,E00,204841,Staff,20,0,20,0
1683642399159,TDGE 10,A00,189289,Staff,27,0,50,23
1683642399159,TDGE 10,B00,189290,Havis; Allan,0,0,50,50
1683642400185,TDGE 11,A00,189291,Fulton; Julia,0,4,50,50
1683642400185,TDGE 11,B00,189292,Staff,20,0,25,5
1683642400185,TDGE 11,C00,260270,Staff,0,0,0,0
1683642401209,TDGE 25,A00,189294,Staff,2,0,20,18
1683642402237,TDGE 124,A00,189318,Fulton; Julia,0,8,50,50
1683642403262,TDGE 125,A00,189319,Staff,13,0,25,12
1683642403262,TDGE 125,B00,189320,Staff,23,0,25,2
1683642404290,TDGE 127,A00,189322,Havis; Allan,0,0,50,50
1683642405312,TDHT 101,A00,189323,Staff,18,0,25,7
1683642405312,TDHT 101,B00,189324,Staff,25,0,25,0
1683642406337,TDHT 102,A00,189325,Staff,49,0,50,1
1683642407368,TDMV 1,A00,189295,Arcidiacono; Kristin,20,0,30,10
1683642407368,TDMV 1,B00,189296,Caligagan; Maria T.,24,0,30,6
1683642408397,TDMV 2,A00,189297,Sammartano; Tonnie,27,0,30,3
1683642408397,TDMV 2,B00,189299,Arcidiacono; Kristin,23,0,30,7
1683642409422,TDMV 3,A00,204998,Rincon; Alicia,22,0,30,8
1683642410447,TDMV 120,A00,189458,Sammartano; Tonnie,28,0,30,2
1683642411472,TDMV 138,A00,189541,Jun; Grace Shin Hae,20,0,40,20
1683642412495,TDMV 142,A00,189717,Caligagan; Tony,25,0,30,5
1683642412495,TDMV 142,B00,189718,Caligagan; Maria T.,25,0,30,5
1683642413523,TMC 2,A01,187533,Staff,25,0,25,0
1683642413523,TMC 2,A02,187534,Staff,25,0,25,0
1683642414552,USP 1,A01,187536,Kwak; Nancy,0,16,25,25
1683642415576,USP 5,A01,187538,Staff,9,0,25,16
1683642416599,USP 101,A00,199253,Staff,0,4,0,0
1683642417626,USP 124,A00,187562,Boomhower; Matthew Charles,0,0,30,30
1683642418654,USP 138,A00,187582,Staff,20,0,25,5
1683642419682,USP 152,A01,187597,Staff,3,0,25,22
1683642420709,USP 153,A00,187598,Staff,19,0,25,6
1683642421735,USP 168,A00,187607,Kwak; Nancy,2,0,5,3
1683642422763,USP 173,A00,187619,Staff,4,0,25,21
1683642423791,USP 181,A00,187638,Staff,0,4,25,25
1683642424819,VIS 103,A00,187650,Cruz; Edwin Teddy,18,0,75,57
1683642425843,VIS 110D,A00,187669,Staff,13,0,22,9
1683642426871,VIS 127C,A00,187720,Shen; Kuiyi,67,0,146,79
1683642427899,VIS 149,A00,187731,Yoldas; Pinar,0,14,22,22
1683642428926,VIS 151,A01,188091,Staff,22,0,34,12
1683642428926,VIS 151,A02,188092,Staff,11,0,34,23
1683642429952,VIS 160B,A00,188093,Stalbaum; Brett,0,1,10,10
1683642432006,WCWP 10B,A00,201720,Staff,10,0,15,5
1683642432006,WCWP 10B,B00,201722,Staff,9,0,15,6
1683642433031,WCWP 100,A00,201725,Gagnon; Jeffrey C,0,0,2,2
1683642433031,WCWP 100,B00,201727,Staff,0,4,15,15
1683642436130,ANBI 133,A00,258401,Wilder; Linnea Lorene,34,0,40,6
1683642437156,ANBI 140,A00,258395,Hrvoj Mihic; Branka,18,0,25,7
1683642438183,ANSC 120,A00,258402,Bialecki; Jon Anthony,27,0,40,13
1683642439209,ANSC 144,A00,258400,Staff,12,0,40,28
1683642441261,ANSC 166,A00,258396,Parish; Steven Martin,156,0,175,19
1683642442288,ANSC 180,A00,193533,Staff,8,0,20,12
1683642443317,ANSC 188,A00,258397,Jassal; Aftab,34,0,40,6
1683642444345,ANTH 3,A01,258316,Staff,23,0,30,7
1683642445371,ANTH 5,A00,258394,Semendeferi; Ekaterini,16,0,20,4
1683642446399,ANTH 21,A01,258331,Staff,4,0,40,36
1683642447426,ANTH 103,A00,258398,Varma; Saiba,15,0,25,10
1683642448454,AWP 10,001,202034,Staff,0,0,0,0
1683642448454,AWP 10,002,202035,Staff,0,0,0,0
1683642448454,AWP 10,003,202036,Staff,0,0,0,0
1683642448454,AWP 10,004,202037,Staff,0,0,0,0
1683642448454,AWP 10,005,202038,Staff,0,0,0,0
1683642448454,AWP 10,006,202039,Staff,0,0,0,0
1683642448454,AWP 10,007,202040,Staff,0,0,0,0
1683642448454,AWP 10,008,202041,Staff,0,0,0,0
1683642448454,AWP 10,009,202042,Staff,0,0,0,0
1683642448454,AWP 10,010,202043,Staff,0,0,0,0
1683642448454,AWP 10,011,202044,Staff,0,0,0,0
1683642448454,AWP 10,012,202045,Staff,0,0,0,0
1683642448454,AWP 10,013,202046,Staff,0,0,0,0
1683642448454,AWP 10,014,202047,Staff,0,0,0,0
1683642448454,AWP 10,015,202048,Staff,0,0,0,0
1683642448454,AWP 10,016,202049,Staff,0,0,0,0
1683642448454,AWP 10,017,202050,Staff,0,0,0,0
1683642448454,AWP 10,018,202051,Staff,0,0,0,0
1683642448454,AWP 10,019,202052,Staff,0,0,0,0
1683642448454,AWP 10,020,202053,Staff,0,0,0,0
1683642448454,AWP 10,021,202054,Staff,0,0,0,0
1683642448454,AWP 10,022,202055,Staff,0,0,0,0
1683642448454,AWP 10,023,202056,Staff,0,0,0,0
1683642448454,AWP 10,024,202057,Staff,0,0,0,0
1683642448454,AWP 10,025,202058,Staff,0,0,0,0
1683642448454,AWP 10,026,202059,Staff,0,0,0,0
1683642449478,AWP 102,001,202032,Staff,0,0,0,0
1683642449478,AWP 102,002,202033,Staff,0,0,0,0
1683642450507,BENG 100,A01,254234,Taylor Amos; Alyssa C,31,0,40,9
1683642451534,BENG 196,001,270013,Engler; Adam J.,9999,0,9999,0
1683642452565,BICD 100R,A01,202018,Smith; Laurie,0,7,32,32
1683642452565,BICD 100R,A02,202019,Smith; Laurie,0,3,32,32
1683642452565,BICD 100R,A03,202020,Smith; Laurie,0,1,32,32
1683642452565,BICD 100R,A04,202021,Smith; Laurie,6,0,32,26
1683642452565,BICD 100R,A05,202022,Smith; Laurie,11,0,32,21
1683642453591,BICD 136,A01,193242,Gustafson-Brown; Cindy,0,2,32,32
1683642453591,BICD 136,A02,193244,Gustafson-Brown; Cindy,13,0,32,19
1683642454615,BIEB 102,A01,193249,Butler; Shannon Rhey,0,2,32,32
1683642454615,BIEB 102,A02,193251,Butler; Shannon Rhey,0,0,32,32
1683642454615,BIEB 102,A03,193253,Butler; Shannon Rhey,0,0,32,32
1683642454615,BIEB 102,A04,193255,Butler; Shannon Rhey,14,0,32,18
1683642454615,BIEB 102,A05,193265,Butler; Shannon Rhey,26,0,32,6
1683642454615,BIEB 102,A06,193269,Butler; Shannon Rhey,14,0,32,18
1683642456668,BIEB 150,A01,193274,Staff,0,0,32,32
1683642456668,BIEB 150,A02,193285,Staff,24,0,32,8
1683642457697,BIEB 194,A00,193286,Kurle; Carolyn M.,20,0,32,12
1683642458723,BILD 1,A01,192291,Staff,15,0,32,17
1683642458723,BILD 1,A02,192292,Staff,30,0,32,2
1683642458723,BILD 1,B01,192520,Reuther; Keefe,0,1,0,0
1683642458723,BILD 1,B02,192532,Reuther; Keefe,0,1,0,0
1683642459748,BILD 3,A01,192556,Butler; Shannon Rhey,0,0,32,32
1683642459748,BILD 3,A02,192581,Butler; Shannon Rhey,1,0,32,31
1683642459748,BILD 3,A03,192611,Butler; Shannon Rhey,21,0,32,11
1683642459748,BILD 3,A04,192612,Butler; Shannon Rhey,24,0,32,8
1683642459748,BILD 3,A05,192613,Butler; Shannon Rhey,26,0,32,6
1683642459748,BILD 3,A06,192679,Butler; Shannon Rhey,27,0,32,5
1683642459748,BILD 3,A07,192682,Butler; Shannon Rhey,20,0,32,12
1683642460782,BILD 4,A01,192836,Reuther; Keefe,0,0,24,24
1683642460782,BILD 4,A02,193044,Reuther; Keefe,4,0,24,20
1683642461805,BILD 10,A01,193142,Gustafson-Brown; Cindy,29,0,32,3
1683642461805,BILD 10,A02,193149,Gustafson-Brown; Cindy,31,0,32,1
1683642462830,BIMM 100,A01,193301,Staff,0,6,32,32
1683642462830,BIMM 100,A02,193312,Staff,0,7,32,32
1683642462830,BIMM 100,A03,193323,Staff,0,9,32,32
1683642463858,BIMM 101,A01,193329,McDonnell; Lisa Marie,0,4,24,24
1683642463858,BIMM 101,A02,193339,McDonnell; Lisa Marie,0,3,24,24
1683642463858,BIMM 101,B01,193354,McDonnell; Lisa Marie,0,4,24,24
1683642463858,BIMM 101,B02,193357,McDonnell; Lisa Marie,0,2,24,24
1683642464888,BIMM 110,A01,193377,Tat; John,0,11,32,32
1683642464888,BIMM 110,A02,193378,Tat; John,0,10,32,32
1683642465915,BIMM 120,A01,206116,Staff,0,0,32,32
1683642465915,BIMM 120,A02,206117,Staff,6,0,32,26
1683642465915,BIMM 120,A03,206121,Staff,21,0,32,11
1683642466944,BIPN 100,A01,193393,Park; Ji Young,0,14,32,32
1683642466944,BIPN 100,A02,193402,Park; Ji Young,0,14,32,32
1683642466944,BIPN 100,A03,193413,Park; Ji Young,0,14,32,32
1683642466944,BIPN 100,A04,193414,Park; Ji Young,0,13,32,32
1683642467970,BIPN 102,A01,193429,Staff,0,0,32,32
1683642467970,BIPN 102,A02,193438,Staff,18,0,32,14
1683642468998,BIPN 106,A01,193450,Reyes Gonzalez; Catalina,0,2,40,40
1683642470022,BIPN 134,A01,193465,Cooke; James Edward,0,0,32,32
1683642470022,BIPN 134,A02,193474,Cooke; James Edward,25,0,32,7
1683642470022,BIPN 134,A03,193485,Cooke; James Edward,29,0,32,3
1683642470022,BIPN 134,A04,193486,Cooke; James Edward,20,0,32,12
1683642470022,BIPN 134,A05,193491,Cooke; James Edward,31,0,32,1
1683642470022,BIPN 134,A06,193501,Cooke; James Edward,30,0,32,2
1683642470022,BIPN 134,A07,193510,Cooke; James Edward,29,0,32,3
1683642472075,BISP 194,A00,222522,Staff,14,0,32,18
1683642473100,CAT 124,A01,202407,Staff,19,0,25,6
1683642474126,CAT 125,A00,202408,Marchisotto; Jennifer Anne,2,0,20,18
1683642475149,CAT 125R,A00,202409,Smith; Lauryn Alissa,0,11,20,20
1683642475149,CAT 125R,B00,202410,Morales; Celeste Georgianna,0,11,20,20
1683642475149,CAT 125R,C00,202411,Irwin; Matthew Joseph,0,12,20,20
1683642476181,CENG 15,A01,204712,Yang; Kesong,0,1,0,0
1683642477205,CENG 114,A00,202070,Jahed Motlagh; Zeinab,5,0,20,15
1683642478232,CGS 105,A00,185477,Wesling; Megan E.,24,0,40,16
1683642479260,CGS 106,A00,185494,Staff,11,0,22,11
1683642480284,CGS 108,A00,185495,Staff,14,0,20,6
1683642481314,CGS 114,A00,185496,Staff,13,0,18,5
1683642482397,CGS 119,A00,185501,Staff,15,0,20,5
1683642483423,CGS 120,A00,185511,Staff,12,0,20,8
1683642484453,CHEM 4,A01,184675,Bussey; Thomas J,97,0,100,3
1683642485477,CHEM 6A,A01,184677,Staff,33,0,60,27
1683642486501,CHEM 6B,A01,184679,Staff,63,0,100,37
1683642487526,CHEM 6C,A01,184681,Bussey; Thomas J,0,0,50,50
1683642487526,CHEM 6C,A02,184682,Bussey; Thomas J,32,0,50,18
1683642488556,CHEM 40A,A01,184684,Albizati; Kim F.,35,0,100,65
1683642489583,CHEM 40B,A01,184686,Albizati; Kim F.,0,22,100,100
1683642490612,CHEM 41B,A01,184690,Staff,51,0,100,49
1683642491639,COGS 3,A01,184715,Boyle; Mary E. T.,0,27,40,40
1683642492665,COGS 14B,A01,185172,Staff,0,14,38,38
1683642493693,COGS 18,A01,184736,Staff,15,0,80,65
1683642494717,COGS 100,A01,184932,Staff,0,7,73,73
1683642495742,COGS 101A,A01,184935,Staff,0,39,30,30
1683642496767,COGS 101B,A01,184944,Staff,0,2,30,30
1683642497791,COGS 101C,A01,184946,Staff,0,10,30,30
1683642498816,COGS 102A,A01,184951,Johnson; Christine M.,2,0,40,38
1683642499841,COGS 107B,A01,184953,Mooshagian; Eric Frederick,0,51,40,40
1683642500871,COGS 118B,A01,184959,Gupta; Anjum,0,49,40,40
1683642501895,COGS 153,A00,184961,Staff,0,16,30,30
1683642502919,COGS 177,A00,184962,Staff,0,21,30,30
1683642503944,COGS 187A,A01,184969,Boyle; Mary E. T.,0,19,40,40
1683642504970,COMM 10,A01,185174,Staff,0,5,25,25
1683642504970,COMM 10,A02,185189,Staff,0,2,25,25
1683642504970,COMM 10,A03,269821,Staff,0,1,0,0
1683642505995,COMM 100B,A01,185475,Staff,0,1,0,2
1683642505995,COMM 100B,A02,185476,Staff,12,0,25,13
1683642507023,COMM 100C,A01,185314,Staff,1,0,25,24
1683642507023,COMM 100C,A02,185327,Staff,18,0,25,7
1683642508048,COMM 110M,A00,185349,Staff,0,0,40,40
1683642509072,COMM 113T,A00,185352,Staff,25,0,40,15
1683642510099,COMM 114I,A00,185353,Staff,31,0,40,9
1683642511124,COMM 131,A00,185354,Staff,17,0,30,13
1683642512149,CSE 8A,A50,185358,Cao; Yingjun,0,46,10,10
1683642513174,CSE 8B,A01,185362,Staff,0,48,50,50
1683642514202,CSE 11,A01,185416,Cao; Yingjun,0,91,10,10
1683642515227,CSE 20,A01,185445,Briones; Jor-el Thomas Caparas,4,0,25,21
1683642516255,CSE 21,A01,185447,Staff,9,0,50,41
1683642517281,CSE 101,A01,185451,Staff,0,13,50,50
1683642517281,CSE 101,B01,185453,Jones; Miles E,0,13,50,50
1683642519334,CSE 141,A01,185458,Eldon; John,15,0,100,85
1683642520358,CSE 141L,A01,185461,Eldon; John,7,0,100,93
1683642521386,CSE 142,A01,185463,Staff,36,0,60,24
1683642521386,CSE 142,B01,201355,Staff,0,7,60,60
1683642522410,CSE 142L,A01,185470,Staff,36,0,60,24
1683642522410,CSE 142L,B01,201417,Staff,0,6,60,60
1683642523438,CSE 190,A00,201433,Staff,32,0,49,17
1683642524464,DOC 1,A01,259136,Strom; Megan C.,7,0,15,8
1683642524464,DOC 1,A02,259137,Strom; Megan C.,14,0,15,1
1683642524464,DOC 1,A03,259138,Strom; Megan C.,14,0,15,1
1683642524464,DOC 1,A04,259139,Strom; Megan C.,14,0,15,1
1683642525491,DOC 100D,A00,259140,Pass; Natalye Joann,14,0,25,11
1683642526515,DSGN 1,A01,184749,Rill; Bryan,0,26,30,30
1683642527539,DSGN 100,A01,185168,Staff,0,2,25,25
1683642528562,ECE 5,A01,185626,Morris; Karcher William,0,11,0,0
1683642529587,ECE 101,A01,185628,Staff,14,0,70,56
1683642530616,ECE 107,A01,185635,Baghdadchi; Saharnaz,0,0,20,20
1683642530616,ECE 107,A02,185638,Baghdadchi; Saharnaz,3,0,20,17
1683642531640,ECE 148,A01,185647,Silberman; Jack,0,0,16,16
1683642532665,ECON 1,A01,185537,Crane; Meredith Helen,54,0,70,16
1683642533697,ECON 3,A01,185549,Crane; Meredith Helen,29,0,70,41
1683642534724,ECON 4,A01,203354,Anderson; John Charles,0,5,10,10
1683642535752,ECON 100A,A01,185574,Staff,0,5,40,40
1683642536785,ECON 100B,A01,185576,Staff,0,12,50,50
1683642537810,ECON 100C,A01,185589,Newhouse; Herbert S,30,0,70,40
1683642538835,ECON 105,A00,185608,Vespa; Emanuel Ignacio,19,0,35,16
1683642539859,ECON 109,A01,185610,Shishkin; Denis,9,0,35,26
1683642540887,ECON 110A,A01,185612,Staff,9,0,40,31
1683642541920,ECON 120A,A01,185615,Staff,20,0,40,20
1683642542946,ECON 120C,A01,185617,Sun; Yixiao,0,20,70,70
1683642543973,ECON 144,A00,203346,Squires; Dale E,2,0,35,33
1683642545001,ECON 171,A01,203349,Newhouse; Herbert S,0,1,35,35
1683642546031,ECON 173A,A01,185621,Toda; Alexis Akira,21,0,35,14
1683642547063,EDS 25,A01,202413,Staff,0,1,0,0
1683642547063,EDS 25,A02,202414,Staff,0,1,0,0
1683642547063,EDS 25,A03,202415,Staff,0,0,0,0
1683642547063,EDS 25,A04,202416,Staff,0,1,0,0
1683642547063,EDS 25,A05,202439,Staff,0,0,0,0
1683642547063,EDS 25,A06,202440,Staff,0,0,0,0
1683642547063,EDS 25,B01,202631,Staff,0,0,0,0
1683642547063,EDS 25,B02,202632,Staff,0,0,0,0
1683642547063,EDS 25,B03,202639,Staff,0,0,0,0
1683642547063,EDS 25,B04,202640,Staff,0,0,0,0
1683642547063,EDS 25,B05,202643,Staff,0,0,0,0
1683642547063,EDS 25,B06,202644,Staff,0,0,0,0
1683642548090,EDS 38,A01,202659,Black; Alison Michelle,24,0,25,1
1683642549114,EDS 115,A00,202652,Staff,18,0,30,12
1683642550142,EDS 125,A00,202649,Staff,13,0,30,17
1683642551170,EDS 126,A01,203332,Staff,30,0,30,0
1683642552195,EDS 139,A00,202838,Staff,16,0,25,9
1683642553223,EDS 146,A01,202655,Staff,14,0,25,11
1683642554249,ENG 15,A00,185667,Staff,0,1,0,0
1683642554249,ENG 15,B00,185672,Staff,0,0,0,0
1683642554249,ENG 15,C00,185675,Staff,0,0,0,0
1683642554249,ENG 15,D00,185682,Staff,0,0,0,0
1683642554249,ENG 15,E00,185684,Staff,0,0,0,0
1683642555276,ETHN 103,A00,185710,Staff,0,8,35,35
1683642556301,ETHN 103A,A00,199228,Man; Simeon S,0,0,9,9
1683642557328,ETHN 109,A00,185711,Staff,16,0,35,19
1683642558354,ETHN 142,A00,185726,Staff,0,4,30,30
1683642559380,ETHN 163J,A00,199229,Man; Simeon S,5,0,8,3
1683642560407,ETHN 168,A00,185727,Staff,7,0,10,3
1683642561434,ETHN 182,A00,185728,Staff,0,0,35,35
1683642562460,ETHN 183,A00,185737,Staff,9,0,18,9
1683642563672,GLBH 111,A01,209361,Burgos; Jose L.,0,0,0,0
1683642565728,HIEU 104,A00,185792,Staff,14,0,20,6
1683642566753,HIEU 115,A00,185800,Staff,0,0,20,20
1683642567776,HIEU 128,A00,185801,Staff,0,9,20,20
1683642568807,HIEU 147,A00,185802,Staff,15,0,20,5
1683642569835,HIEU 154,A00,185823,Staff,11,0,20,9
1683642570861,HILA 102,A00,185826,Staff,14,0,20,6
1683642571887,HILD 2C,A01,185778,Staff,0,13,20,20
1683642572915,HILD 7B,A01,185780,Kwak; Nancy,0,16,32,32
1683642572915,HILD 7B,A02,185781,Kwak; Nancy,0,18,32,32
1683642573939,HILD 30,A01,185791,Staff,12,0,20,8
1683642574966,HISC 119,A00,185830,Golan; Tal,0,9,20,20
1683642575990,HITO 156GS,A00,185831,Patterson; Patrick H.,0,0,0,23
1683642577014,HIUS 103,A00,185832,Man; Simeon S,0,4,20,20
1683642578042,HIUS 117,A00,185836,Kwak; Nancy,2,0,20,18
1683642579069,HIUS 125,A00,185840,Man; Simeon S,0,1,23,23
1683642580094,HIUS 149,A00,185845,Staff,1,0,20,19
1683642581124,HUM 3,A01,185882,Zavodny; Tatiana Sophia,0,7,50,50
1683642581124,HUM 3,B01,185899,Caldwell; Michael Alan,0,18,50,50
1683642582148,HUM 3GS,A00,185900,Patterson; Patrick H.,0,0,0,23
1683642583177,HUM 4,A01,185938,Zroka; Amy Liane,30,0,50,20
1683642583177,HUM 4,B01,185956,Watkins; Eric,0,4,50,50
1683642583177,HUM 4,B02,202209,Watkins; Eric,0,4,50,50
1683642583177,HUM 4,B03,202210,Watkins; Eric,0,4,50,50
1683642584205,HUM 5,A01,185958,West; Geoffrey Scott,2,0,50,48
1683642584205,HUM 5,A02,202215,West; Geoffrey Scott,0,0,50,50
1683642585228,INTL 190,A00,185959,Gagnon; Jeffrey C,0,0,0,9
1683642585228,INTL 190,B00,185960,Lettieri; Michael Joseph,0,0,0,2
1683642586330,JAPN 180,A00,254509,Staff,5,0,30,25
1683642587358,LATI 10,A01,202853,Kennemore; Amy Michelle,4,0,35,31
1683642587358,LATI 10,A02,202854,Kennemore; Amy Michelle,2,0,35,33
1683642587358,LATI 10,A03,270054,Kennemore; Amy Michelle,30,0,30,0
1683642588382,LATI 180,A00,202855,Kennemore; Amy Michelle,11,0,20,9
1683642589409,LAWS 101,A00,201767,Golan; Tal,0,7,40,40
1683642590436,LIFR 1C,A00,185961,Staff,6,0,20,14
1683642591461,LIFR 1CX,A00,185962,Staff,7,0,20,13
1683642592487,LIFR 1D,A00,185963,Staff,7,0,20,13
1683642593512,LIFR 1DX,A00,185964,Staff,7,0,20,13
1683642594536,LIGN 101,A01,186039,Staff,43,0,50,7
1683642595565,LIGN 165,A00,186040,Staff,15,0,50,35
1683642596590,LTCS 108,A00,186041,Staff,5,0,10,5
1683642597614,LTCS 119,A00,186042,Staff,15,0,20,5
1683642598637,LTCS 130,A00,186043,Wesling; Megan E.,15,0,25,10
1683642600687,LTEA 138,A00,186119,Staff,14,0,40,26
1683642601713,LTEN 124,A00,186148,Staff,5,0,25,20
1683642602741,LTEN 178,A00,186149,Staff,7,0,15,8
1683642603771,LTEN 181,A00,186150,Blanco; John D,34,0,40,6
1683642604796,LTWL 120,A00,186160,Staff,20,0,25,5
1683642605821,LTWL 165,A00,186161,Staff,22,0,25,3
1683642606849,LTWR 100,A00,186162,Staff,0,5,15,15
1683642607875,LTWR 102,A00,186163,Doller; Ben,5,0,15,10
1683642608903,MAE 8,A01,186412,Staff,0,0,0,0
1683642609927,MAE 30B,A00,186445,Bahadori; Mohammad Yousef,82,0,100,18
1683642610954,MAE 40,A00,186592,Bewley; Thomas R,10,0,50,40
1683642611980,MAE 101B,A00,186593,Bahadori; Mohammad Yousef,80,0,100,20
1683642613007,MAE 105,A00,186594,Bandaru; Prabhakar,10,0,50,40
1683642614038,MAE 107,A00,186599,Pham; Hieu Tan,0,7,120,120
1683642615062,MAE 148,A01,186660,Silberman; Jack,3,0,16,13
1683642616091,MATH 10A,A01,188095,Staff,0,5,35,35
1683642617116,MATH 10B,A01,188097,Bowers; Adam R.,0,11,30,30
1683642617116,MATH 10B,A02,188099,Bowers; Adam R.,0,11,30,30
1683642617116,MATH 10B,B01,188104,Bowers; Adam R.,0,10,30,30
1683642617116,MATH 10B,B02,188106,Bowers; Adam R.,1,9,30,29
1683642618141,MATH 10C,A01,188111,Staff,0,18,30,30
1683642618141,MATH 10C,A02,188127,Staff,0,19,30,30
1683642618141,MATH 10C,A03,188131,Staff,0,19,30,30
1683642618141,MATH 10C,B01,188218,Staff,17,0,30,13
1683642618141,MATH 10C,B02,188244,Staff,13,0,30,17
1683642618141,MATH 10C,B03,188277,Staff,14,0,30,16
1683642619165,MATH 18,A01,188344,Bach; Quang Tran,18,0,30,12
1683642619165,MATH 18,A02,188345,Bach; Quang Tran,11,0,30,19
1683642619165,MATH 18,B01,188353,Bach; Quang Tran,11,0,30,19
1683642619165,MATH 18,B02,188354,Bach; Quang Tran,19,0,30,11
1683642620189,MATH 20A,A01,188374,Staff,11,0,35,24
1683642621222,MATH 20B,A01,188382,Ohm; Ko Woon,7,0,30,23
1683642621222,MATH 20B,A02,188383,Ohm; Ko Woon,22,0,30,8
1683642621222,MATH 20B,B01,188385,Ohm; Ko Woon,7,0,30,23
1683642621222,MATH 20B,B02,188392,Ohm; Ko Woon,22,0,30,8
1683642622246,MATH 20C,A01,188394,Harel; Guershon,11,0,30,19
1683642622246,MATH 20C,A02,188395,Harel; Guershon,14,0,30,16
1683642622246,MATH 20C,B01,188404,Harel; Guershon,4,0,30,26
1683642622246,MATH 20C,B02,188405,Harel; Guershon,18,0,30,12
1683642623274,MATH 20D,A01,188414,Hammock; Frances H,0,1,30,30
1683642623274,MATH 20D,A02,188415,Hammock; Frances H,0,1,30,30
1683642623274,MATH 20D,B01,188447,Hammock; Frances H,0,1,30,30
1683642623274,MATH 20D,B02,188486,Hammock; Frances H,4,0,30,26
1683642624304,MATH 20E,A01,188649,Staff,21,0,30,9
1683642624304,MATH 20E,A02,188650,Staff,21,0,30,9
1683642624304,MATH 20E,A03,188673,Staff,0,0,30,30
1683642625341,MATH 102,A01,188675,Staff,0,36,35,35
1683642626364,MATH 103B,A01,188681,Staff,3,0,35,32
1683642626364,MATH 103B,B01,188692,Staff,5,0,35,30
1683642627390,MATH 109,A01,188695,Salehi Golsefidy; Alireza,24,0,35,11
1683642627390,MATH 109,A02,188696,Salehi Golsefidy; Alireza,25,0,35,10
1683642628415,MATH 120A,A01,188698,Eggers; John Dietrich,7,0,35,28
1683642629444,MATH 142B,A01,188736,Ioana; Adrian,0,1,30,30
1683642629444,MATH 142B,A02,188741,Ioana; Adrian,0,1,30,30
1683642629444,MATH 142B,A03,188743,Ioana; Adrian,0,1,30,30
1683642630470,MATH 168A,A01,188790,Staff,0,10,35,35
1683642631502,MATH 170A,A01,188803,Nie; Jiawang,0,2,35,35
1683642631502,MATH 170A,A02,188811,Nie; Jiawang,0,0,35,35
1683642631502,MATH 170A,A03,188814,Nie; Jiawang,0,0,35,35
1683642631502,MATH 170A,A04,188815,Nie; Jiawang,10,0,35,25
1683642632531,MATH 193B,A01,188817,Staff,0,0,35,35
1683642632531,MATH 193B,A02,188818,Staff,5,0,35,30
1683642633559,MGT 4,A01,202857,Anderson; John Charles,61,0,80,19
1683642634587,MGT 12,A00,202858,Lindenberger; Wade Douglas,40,0,90,50
1683642635611,MGT 18,A00,202859,Staff,74,0,90,16
1683642636636,MGT 18GS,A00,202860,McKay; Michael J,13,0,28,15
1683642637664,MGT 45,A00,202861,Pecore; Joseph P.,12,0,90,78
1683642638688,MGT 100,A00,202863,Yavorsky; Daniel Ryan,28,0,90,62
1683642639716,MGT 103,A00,202864,Ehrich; Kristine R,0,17,90,90
1683642640741,MGT 112,A00,202865,Ehrich; Kristine R,15,0,90,75
1683642641767,MGT 121A,A00,202868,Staff,0,20,0,0
1683642642796,MGT 131B,A00,202869,Anderson; John Charles,59,0,90,31
1683642643820,MGT 136,A00,202871,Lindenberger; Wade Douglas,83,0,90,7
1683642644844,MGT 164,A00,202873,Staff,0,66,90,91
1683642645871,MGT 164GS,A00,202874,McKay; Mary A,13,0,28,15
1683642646899,MGT 180,A00,202875,Staff,0,50,90,91
1683642647927,MMW 11R,A01,205019,Herbst; Matthew,2,0,30,28
1683642647927,MMW 11R,A02,205026,Herbst; Matthew,29,0,30,1
1683642648954,MMW 15,A01,193512,Chang; Edmond Yi-Teh,0,8,28,28
1683642648954,MMW 15,A02,193513,Chang; Edmond Yi-Teh,0,5,28,28
1683642648954,MMW 15,A03,193514,Chang; Edmond Yi-Teh,0,5,28,28
1683642648954,MMW 15,A04,193515,Chang; Edmond Yi-Teh,0,5,28,28
1683642648954,MMW 15,A05,193516,Chang; Edmond Yi-Teh,0,5,28,28
1683642648954,MMW 15,A06,193517,Chang; Edmond Yi-Teh,0,6,28,28
1683642648954,MMW 15,B01,193519,Chang; Edmond Yi-Teh,0,5,28,28
1683642648954,MMW 15,B02,193520,Chang; Edmond Yi-Teh,0,5,28,28
1683642648954,MMW 15,B03,193521,Chang; Edmond Yi-Teh,0,5,28,28
1683642648954,MMW 15,B04,193522,Chang; Edmond Yi-Teh,0,5,28,28
1683642648954,MMW 15,B05,193523,Chang; Edmond Yi-Teh,0,5,28,28
1683642648954,MMW 15,B06,193524,Chang; Edmond Yi-Teh,0,5,28,28
1683642649978,MMW 122,A01,193526,Rahimi; Babak,0,16,28,28
1683642649978,MMW 122,A02,193527,Rahimi; Babak,0,15,28,28
1683642649978,MMW 122,A03,193528,Rahimi; Babak,0,0,0,0
1683642649978,MMW 122,A04,193529,Rahimi; Babak,0,0,0,0
1683642651003,MUS 1A,A01,186663,Staff,1,20,35,34
1683642652031,MUS 4,A01,186715,Staff,0,12,35,35
1683642653057,MUS 5R,A01,186796,Dubnov; Shlomo,0,17,35,35
1683642654085,MUS 6,A01,186798,Staff,0,5,25,25
1683642655113,MUS 7,A01,186830,Staff,11,0,35,24
1683642656139,MUS 8,A01,186930,Staff,0,26,35,35
1683642657167,MUS 15,A01,186932,Staff,0,16,35,35
1683642657167,MUS 15,B01,186934,Staff,0,17,35,35
1683642658191,MUS 80,A00,186935,Staff,0,0,20,20
1683642658191,MUS 80,B00,186936,Staff,24,0,25,1
1683642659226,NANO 11,A00,204702,Lipomi; Darren John,0,0,0,0
1683642660255,NANO 15,A01,204709,Yang; Kesong,0,1,0,0
1683642661285,NANO 114,A00,202069,Jahed Motlagh; Zeinab,3,0,10,7
1683642662311,PHIL 1,A00,186955,Grush; Rick Scott,31,0,40,9
1683642663339,PHIL 10,A01,186973,Grush; Rick Scott,27,0,35,8
1683642663339,PHIL 10,A02,186974,Grush; Rick Scott,33,0,35,2
1683642664373,PHIL 13,A01,186976,Staff,3,0,35,32
1683642664373,PHIL 13,A02,186977,Staff,16,0,35,19
1683642665401,PHIL 14,A01,186979,Staff,31,0,35,4
1683642665401,PHIL 14,A02,186986,Staff,32,0,35,3
1683642666432,PHIL 28,A01,186988,Staff,16,0,30,14
1683642666432,PHIL 28,A02,186989,Staff,1,0,30,29
1683642666432,PHIL 28,A03,186990,Staff,10,0,30,20
1683642666432,PHIL 28,A04,186991,Staff,26,0,30,4
1683642667462,PHIL 120,A00,186997,Staff,23,0,40,17
1683642668491,PHIL 137,A00,187003,Staff,7,0,40,33
1683642669516,PHIL 150,A00,187015,Staff,47,0,70,23
1683642670541,PHIL 167,A00,187021,Lamey; Andy M.,34,0,40,6
1683642671571,PHIL 174,A01,202226,Staff,17,0,20,3
1683642671571,PHIL 174,A02,202235,Staff,20,0,20,0
1683642672597,PHIL 191A,A00,258918,Staff,0,0,1,1
1683642673626,PHYS 1A,A00,187028,Staff,27,0,60,33
1683642674651,PHYS 1AL,001,187036,Staff,3,0,30,27
1683642674651,PHYS 1AL,002,187049,Staff,18,0,30,12
1683642675680,PHYS 1B,A00,187058,Staff,22,0,60,38
1683642676705,PHYS 1BL,001,187064,Staff,0,1,30,30
1683642676705,PHYS 1BL,002,187070,Staff,4,0,30,26
1683642677731,PHYS 1C,A00,187082,Staff,29,0,120,91
1683642678758,PHYS 1CL,001,187088,Staff,0,9,30,30
1683642678758,PHYS 1CL,002,187089,Staff,0,1,30,30
1683642678758,PHYS 1CL,009,262693,Staff,9,0,30,21
1683642679784,PHYS 2B,A01,187097,Staff,55,0,115,60
1683642680813,PHYS 2C,A01,187099,Staff,64,0,115,51
1683642681838,PHYS 2CL,A01,187101,Staff,5,0,28,23
1683642681838,PHYS 2CL,A02,187102,Staff,15,0,28,13
1683642682863,PHYS 2D,A01,187123,Shotwell; Brian,95,0,115,20
1683642683888,PHYS 4B,A01,187133,Grinstein; Benjamin,35,0,50,15
1683642684917,POLI 10,A00,188819,Staff,0,4,50,50
1683642685945,POLI 11,A00,188827,Staff,43,0,50,7
1683642686970,POLI 13R,A00,188828,Staff,0,1,20,20
1683642687994,POLI 27,A01,188830,Elgin; Samuel Zincke,0,2,70,70
1683642689019,POLI 30,A00,188832,Desposato; Scott,30,0,50,20
1683642690104,POLI 102F,A00,188834,Staff,0,0,40,40
1683642691129,POLI 104A,A00,188852,Staff,13,0,30,17
1683642692153,POLI 104I,A00,188853,Staff,0,7,20,20
1683642693179,POLI 110B,A00,188854,Wiens; David,7,0,20,13
1683642694203,POLI 112A,A00,188855,Wiens; David,4,0,30,26
1683642695227,POLI 117R,A00,188856,Forman; Fonna,0,12,20,20
1683642696252,POLI 118,A00,188857,Ingham; Sean,8,0,20,12
1683642697276,POLI 120G,A00,188858,Staff,8,0,30,22
1683642698305,POLI 131CR,A00,188863,Hoston; Germaine,21,0,50,29
1683642699330,POLI 133,A00,188864,Nellis; Gareth Hb,44,0,50,6
1683642700358,POLI 134D,A00,188865,Desposato; Scott,27,0,30,3
1683642701385,POLI 142A,A00,188871,Gartzke; Erik,21,0,50,29
1683642702408,POLI 142K,A00,188874,Staff,38,0,50,12
1683642703432,POLI 143,A00,188940,Gartzke; Erik,16,0,30,14
1683642704457,POLI 153,A00,188943,Staff,2,0,20,18
1683642705483,POLI 160AA,A00,188944,Staff,11,0,40,29
1683642706512,POLI 170A,A00,188945,Staff,11,0,30,19
1683642708565,PSYC 1,A00,188952,Staff,36,0,90,54
1683642709593,PSYC 2,B00,188953,Staff,19,0,35,16
1683642710618,PSYC 6,A00,188970,Staff,47,0,60,13
1683642711643,PSYC 7,A00,188973,Staff,35,0,45,10
1683642712667,PSYC 60,A01,188980,Rickard; Timothy C.,42,0,60,18
1683642713691,PSYC 70,A01,189001,Steiner; Eric Tomas,23,0,45,22
1683642714720,PSYC 100,A00,189005,Lacefield; Katharine I,0,99,120,120
1683642715746,PSYC 102,A00,189008,Staff,8,0,30,22
1683642716775,PSYC 106,B00,189026,Gorman; Michael R.,27,0,60,33
1683642717803,PSYC 114,B01,189033,Winkielman; Piotr,0,31,30,30
1683642718831,PSYC 131,A00,189036,Anagnostaras; Stephan,0,43,60,60
1683642719862,PSYC 136,A00,189041,Lowe; Angela Beth,0,7,25,25
1683642720887,PSYC 137,A00,189057,Winkielman; Piotr,0,37,25,25
1683642721912,PSYC 144,A00,189107,Wixted; John T,0,10,50,50
1683642723962,PSYC 162,A00,189142,Staff,0,9,85,85
1683642724985,PSYC 172,A00,189144,Gorman; Michael R.,0,6,30,30
1683642727033,PSYC 179,A00,189146,Lacefield; Katharine I,0,86,120,120
1683642728057,PSYC 181,A00,189147,Anagnostaras; Stephan,0,44,90,90
1683642729085,PSYC 190R,A00,189148,Barner; David A.,0,23,80,80
1683642730118,PSYC 191,A00,189275,Rickard; Timothy C.,0,10,25,25
1683642731145,PSYC 193,A00,189276,Chapman; Eddie Nathaniel,0,1,0,4
1683642732171,PSYC 193L,A01,189281,Lowe; Angela Beth,10,0,20,10
1683642732171,PSYC 193L,B01,189285,Staff,28,0,35,7
1683642733195,RELI 149,A00,187137,Rahimi; Babak,7,0,40,33
1683642734224,SE 9,A01,187315,Staff,0,2,18,18
1683642735250,SE 101B,A00,187409,Staff,24,0,30,6
1683642736275,SE 110B,A00,187444,Staff,10,0,40,30
1683642737301,SE 130B,A00,187449,Staff,31,0,40,9
1683642738326,SE 150A,A00,187516,Staff,9,0,20,11
1683642739351,SE 154,A00,187528,Staff,29,0,50,21
1683642740375,SIO 3,A01,258171,Staff,35,0,40,5
1683642741399,SIO 10,A00,187144,Cook; Geoffrey W,0,6,75,75
1683642742429,SIO 45,A00,187152,Cook; Geoffrey W,0,4,100,100
1683642743455,SIO 109R,A00,194486,Staff,0,4,20,20
1683642745507,SIO 187,A01,187233,Kacev; David,12,0,40,28
1683642746537,SOCI 1,A01,258656,Thorpe; Charles Robert,28,0,30,2
1683642746537,SOCI 1,A02,258658,Thorpe; Charles Robert,30,0,30,0
1683642746537,SOCI 1,A03,258661,Thorpe; Charles Robert,25,0,25,0
1683642746537,SOCI 1,A04,258666,Thorpe; Charles Robert,22,0,25,3
1683642746537,SOCI 1,A05,258897,Thorpe; Charles Robert,22,0,25,3
1683642746537,SOCI 1,A06,258898,Thorpe; Charles Robert,25,0,25,0
1683642747561,SOCI 30,A01,258903,Pardo Guerra; Juan Pablo,14,0,30,16
1683642748586,SOCI 102,A00,258904,Staff,9,0,25,16
1683642749615,SOCI 106,A00,258905,Staff,19,0,25,6
1683642750645,SOCI 111,A00,258907,Ribas Norris; Janet Vanesa,26,0,30,4
1683642751670,SOCI 121R,A00,258908,Pardo Guerra; Juan Pablo,8,0,30,22
1683642752694,SOCI 126,A01,203330,Staff,14,0,20,6
1683642753718,SOCI 131,A00,258909,Thorpe; Charles Robert,30,0,60,30
1683642754743,SOCI 135,A00,258910,Payne; Christine Anna,0,11,30,30
1683642755771,SOCI 157,A00,258911,Staff,12,0,30,18
1683642756796,SOCI 184,A00,258912,Staff,25,0,30,5
1683642757825,SOCI 188D,A00,258913,Staff,22,0,30,8
1683642758854,SYN 2,001,187529,Staff,9,0,16,7
1683642758854,SYN 2,002,201452,Staff,0,20,16,16
1683642758854,SYN 2,003,201469,Staff,2,0,16,14
1683642759886,SYN 100,A01,187531,Staff,0,9,20,20
1683642759886,SYN 100,B01,201491,Staff,0,10,20,20
1683642760923,TDAC 1,A00,189286,Walsh; Kim C.,3,0,20,17
1683642760923,TDAC 1,B00,189287,Harting; Carla Kelso,10,0,20,10
1683642761947,TDAC 101,A00,189300,Walsh; Kim C.,16,0,20,4
1683642761947,TDAC 101,B00,189301,Harting; Carla Kelso,18,0,20,2
1683642762974,TDAC 102,A00,189304,Basso; Beatrice,14,0,20,6
1683642763999,TDAC 108,A00,189305,Staff,18,0,20,2
1683642765029,TDDE 131,A00,189310,Staff,19,0,20,1
1683642765029,TDDE 131,B00,189314,Staff,19,0,20,1
1683642765029,TDDE 131,C00,189315,Staff,48,0,50,2
1683642765029,TDDE 131,D00,189316,Staff,14,0,15,1
1683642765029,TDDE 131,E00,204841,Staff,20,0,20,0
1683642766057,TDGE 10,A00,189289,Staff,27,0,50,23
1683642766057,TDGE 10,B00,189290,Havis; Allan,0,0,50,50
1683642767082,TDGE 11,A00,189291,Fulton; Julia,0,4,50,50
1683642767082,TDGE 11,B00,189292,Staff,20,0,25,5
1683642767082,TDGE 11,C00,260270,Staff,0,0,0,0
1683642768111,TDGE 25,A00,189294,Staff,2,0,20,18
1683642769136,TDGE 124,A00,189318,Fulton; Julia,0,8,50,50
1683642770161,TDGE 125,A00,189319,Staff,13,0,25,12
1683642770161,TDGE 125,B00,189320,Staff,23,0,25,2
1683642771185,TDGE 127,A00,189322,Havis; Allan,0,0,50,50
1683642772213,TDHT 101,A00,189323,Staff,18,0,25,7
1683642772213,TDHT 101,B00,189324,Staff,25,0,25,0
1683642773237,TDHT 102,A00,189325,Staff,49,0,50,1
1683642774261,TDMV 1,A00,189295,Arcidiacono; Kristin,20,0,30,10
1683642774261,TDMV 1,B00,189296,Caligagan; Maria T.,24,0,30,6
1683642775285,TDMV 2,A00,189297,Sammartano; Tonnie,27,0,30,3
1683642775285,TDMV 2,B00,189299,Arcidiacono; Kristin,23,0,30,7
1683642776312,TDMV 3,A00,204998,Rincon; Alicia,22,0,30,8
1683642777335,TDMV 120,A00,189458,Sammartano; Tonnie,28,0,30,2
1683642778362,TDMV 138,A00,189541,Jun; Grace Shin Hae,20,0,40,20
1683642779388,TDMV 142,A00,189717,Caligagan; Tony,25,0,30,5
1683642779388,TDMV 142,B00,189718,Caligagan; Maria T.,25,0,30,5
1683642780415,TMC 2,A01,187533,Staff,25,0,25,0
1683642780415,TMC 2,A02,187534,Staff,25,0,25,0
1683642781450,USP 1,A01,187536,Kwak; Nancy,0,16,25,25
1683642782478,USP 5,A01,187538,Staff,9,0,25,16
1683642783517,USP 101,A00,199253,Staff,0,4,0,0
1683642784546,USP 124,A00,187562,Boomhower; Matthew Charles,0,0,30,30
1683642785574,USP 138,A00,187582,Staff,20,0,25,5
1683642786600,USP 152,A01,187597,Staff,3,0,25,22
1683642787625,USP 153,A00,187598,Staff,19,0,25,6
1683642788649,USP 168,A00,187607,Kwak; Nancy,2,0,5,3
1683642789677,USP 173,A00,187619,Staff,4,0,25,21
1683642790702,USP 181,A00,187638,Staff,0,4,25,25
1683642791725,VIS 103,A00,187650,Cruz; Edwin Teddy,18,0,75,57
1683642792750,VIS 110D,A00,187669,Staff,13,0,22,9
1683642793830,VIS 127C,A00,187720,Shen; Kuiyi,67,0,146,79
1683642794855,VIS 149,A00,187731,Yoldas; Pinar,0,14,22,22
1683642795879,VIS 151,A01,188091,Staff,22,0,34,12
1683642795879,VIS 151,A02,188092,Staff,11,0,34,23
1683642796903,VIS 160B,A00,188093,Stalbaum; Brett,0,1,10,10
1683642798953,WCWP 10B,A00,201720,Staff,10,0,15,5
1683642798953,WCWP 10B,B00,201722,Staff,9,0,15,6
1683642799978,WCWP 100,A00,201725,Gagnon; Jeffrey C,0,0,2,2
1683642799978,WCWP 100,B00,201727,Staff,0,4,15,15
1683642803082,ANBI 133,A00,258401,Wilder; Linnea Lorene,34,0,40,6
1683642804112,ANBI 140,A00,258395,Hrvoj Mihic; Branka,18,0,25,7
1683642805136,ANSC 120,A00,258402,Bialecki; Jon Anthony,27,0,40,13
1683642806164,ANSC 144,A00,258400,Staff,12,0,40,28
1683642808213,ANSC 166,A00,258396,Parish; Steven Martin,156,0,175,19
1683642809237,ANSC 180,A00,193533,Staff,8,0,20,12
1683642810267,ANSC 188,A00,258397,Jassal; Aftab,34,0,40,6
1683642811292,ANTH 3,A01,258316,Staff,23,0,30,7
1683642812321,ANTH 5,A00,258394,Semendeferi; Ekaterini,16,0,20,4
1683642813349,ANTH 21,A01,258331,Staff,4,0,40,36
1683642814373,ANTH 103,A00,258398,Varma; Saiba,15,0,25,10
1683642815401,AWP 10,001,202034,Staff,0,0,0,0
1683642815401,AWP 10,002,202035,Staff,0,0,0,0
1683642815401,AWP 10,003,202036,Staff,0,0,0,0
1683642815401,AWP 10,004,202037,Staff,0,0,0,0
1683642815401,AWP 10,005,202038,Staff,0,0,0,0
1683642815401,AWP 10,006,202039,Staff,0,0,0,0
1683642815401,AWP 10,007,202040,Staff,0,0,0,0
1683642815401,AWP 10,008,202041,Staff,0,0,0,0
1683642815401,AWP 10,009,202042,Staff,0,0,0,0
1683642815401,AWP 10,010,202043,Staff,0,0,0,0
1683642815401,AWP 10,011,202044,Staff,0,0,0,0
1683642815401,AWP 10,012,202045,Staff,0,0,0,0
1683642815401,AWP 10,013,202046,Staff,0,0,0,0
1683642815401,AWP 10,014,202047,Staff,0,0,0,0
1683642815401,AWP 10,015,202048,Staff,0,0,0,0
1683642815401,AWP 10,016,202049,Staff,0,0,0,0
1683642815401,AWP 10,017,202050,Staff,0,0,0,0
1683642815401,AWP 10,018,202051,Staff,0,0,0,0
1683642815401,AWP 10,019,202052,Staff,0,0,0,0
1683642815401,AWP 10,020,202053,Staff,0,0,0,0
1683642815401,AWP 10,021,202054,Staff,0,0,0,0
1683642815401,AWP 10,022,202055,Staff,0,0,0,0
1683642815401,AWP 10,023,202056,Staff,0,0,0,0
1683642815401,AWP 10,024,202057,Staff,0,0,0,0
1683642815401,AWP 10,025,202058,Staff,0,0,0,0
1683642815401,AWP 10,026,202059,Staff,0,0,0,0
1683642816428,AWP 102,001,202032,Staff,0,0,0,0
1683642816428,AWP 102,002,202033,Staff,0,0,0,0
1683642817457,BENG 100,A01,254234,Taylor Amos; Alyssa C,31,0,40,9
1683642818485,BENG 196,001,270013,Engler; Adam J.,9999,0,9999,0
1683642819510,BICD 100R,A01,202018,Smith; Laurie,0,7,32,32
1683642819510,BICD 100R,A02,202019,Smith; Laurie,0,3,32,32
1683642819510,BICD 100R,A03,202020,Smith; Laurie,0,1,32,32
1683642819510,BICD 100R,A04,202021,Smith; Laurie,6,0,32,26
1683642819510,BICD 100R,A05,202022,Smith; Laurie,11,0,32,21
1683642820540,BICD 136,A01,193242,Gustafson-Brown; Cindy,0,2,32,32
1683642820540,BICD 136,A02,193244,Gustafson-Brown; Cindy,13,0,32,19
1683642821571,BIEB 102,A01,193249,Butler; Shannon Rhey,0,2,32,32
1683642821571,BIEB 102,A02,193251,Butler; Shannon Rhey,0,0,32,32
1683642821571,BIEB 102,A03,193253,Butler; Shannon Rhey,0,0,32,32
1683642821571,BIEB 102,A04,193255,Butler; Shannon Rhey,14,0,32,18
1683642821571,BIEB 102,A05,193265,Butler; Shannon Rhey,26,0,32,6
1683642821571,BIEB 102,A06,193269,Butler; Shannon Rhey,14,0,32,18
1683642823622,BIEB 150,A01,193274,Staff,0,0,32,32
1683642823622,BIEB 150,A02,193285,Staff,24,0,32,8
1683642824651,BIEB 194,A00,193286,Kurle; Carolyn M.,20,0,32,12
1683642825678,BILD 1,A01,192291,Staff,15,0,32,17
1683642825678,BILD 1,A02,192292,Staff,30,0,32,2
1683642825678,BILD 1,B01,192520,Reuther; Keefe,0,1,0,0
1683642825678,BILD 1,B02,192532,Reuther; Keefe,0,1,0,0
1683642826709,BILD 3,A01,192556,Butler; Shannon Rhey,0,0,32,32
1683642826709,BILD 3,A02,192581,Butler; Shannon Rhey,1,0,32,31
1683642826709,BILD 3,A03,192611,Butler; Shannon Rhey,21,0,32,11
1683642826709,BILD 3,A04,192612,Butler; Shannon Rhey,24,0,32,8
1683642826709,BILD 3,A05,192613,Butler; Shannon Rhey,26,0,32,6
1683642826709,BILD 3,A06,192679,Butler; Shannon Rhey,27,0,32,5
1683642826709,BILD 3,A07,192682,Butler; Shannon Rhey,20,0,32,12
1683642827740,BILD 4,A01,192836,Reuther; Keefe,0,0,24,24
1683642827740,BILD 4,A02,193044,Reuther; Keefe,4,0,24,20
1683642828767,BILD 10,A01,193142,Gustafson-Brown; Cindy,29,0,32,3
1683642828767,BILD 10,A02,193149,Gustafson-Brown; Cindy,31,0,32,1
1683642829792,BIMM 100,A01,193301,Staff,0,6,32,32
1683642829792,BIMM 100,A02,193312,Staff,0,7,32,32
1683642829792,BIMM 100,A03,193323,Staff,0,9,32,32
1683642830818,BIMM 101,A01,193329,McDonnell; Lisa Marie,0,4,24,24
1683642830818,BIMM 101,A02,193339,McDonnell; Lisa Marie,0,3,24,24
1683642830818,BIMM 101,B01,193354,McDonnell; Lisa Marie,0,4,24,24
1683642830818,BIMM 101,B02,193357,McDonnell; Lisa Marie,0,2,24,24
1683642831853,BIMM 110,A01,193377,Tat; John,0,11,32,32
1683642831853,BIMM 110,A02,193378,Tat; John,0,10,32,32
1683642832886,BIMM 120,A01,206116,Staff,0,0,32,32
1683642832886,BIMM 120,A02,206117,Staff,6,0,32,26
1683642832886,BIMM 120,A03,206121,Staff,21,0,32,11
1683642833916,BIPN 100,A01,193393,Park; Ji Young,0,14,32,32
1683642833916,BIPN 100,A02,193402,Park; Ji Young,0,14,32,32
1683642833916,BIPN 100,A03,193413,Park; Ji Young,0,14,32,32
1683642833916,BIPN 100,A04,193414,Park; Ji Young,0,13,32,32
1683642834941,BIPN 102,A01,193429,Staff,0,0,32,32
1683642834941,BIPN 102,A02,193438,Staff,18,0,32,14
1683642835966,BIPN 106,A01,193450,Reyes Gonzalez; Catalina,0,2,40,40
1683642836990,BIPN 134,A01,193465,Cooke; James Edward,0,0,32,32
1683642836990,BIPN 134,A02,193474,Cooke; James Edward,25,0,32,7
1683642836990,BIPN 134,A03,193485,Cooke; James Edward,29,0,32,3
1683642836990,BIPN 134,A04,193486,Cooke; James Edward,20,0,32,12
1683642836990,BIPN 134,A05,193491,Cooke; James Edward,31,0,32,1
1683642836990,BIPN 134,A06,193501,Cooke; James Edward,30,0,32,2
1683642836990,BIPN 134,A07,193510,Cooke; James Edward,29,0,32,3
1683642839038,BISP 194,A00,222522,Staff,14,0,32,18
1683642840065,CAT 124,A01,202407,Staff,19,0,25,6
1683642841090,CAT 125,A00,202408,Marchisotto; Jennifer Anne,2,0,20,18
1683642842120,CAT 125R,A00,202409,Smith; Lauryn Alissa,0,11,20,20
1683642842120,CAT 125R,B00,202410,Morales; Celeste Georgianna,0,11,20,20
1683642842120,CAT 125R,C00,202411,Irwin; Matthew Joseph,0,12,20,20
1683642843150,CENG 15,A01,204712,Yang; Kesong,0,1,0,0
1683642844176,CENG 114,A00,202070,Jahed Motlagh; Zeinab,5,0,20,15
1683642845204,CGS 105,A00,185477,Wesling; Megan E.,24,0,40,16
1683642846229,CGS 106,A00,185494,Staff,11,0,22,11
1683642847256,CGS 108,A00,185495,Staff,14,0,20,6
1683642848280,CGS 114,A00,185496,Staff,13,0,18,5
1683642849307,CGS 119,A00,185501,Staff,15,0,20,5
1683642850335,CGS 120,A00,185511,Staff,12,0,20,8
1683642851364,CHEM 4,A01,184675,Bussey; Thomas J,97,0,100,3
1683642852389,CHEM 6A,A01,184677,Staff,33,0,60,27
1683642853412,CHEM 6B,A01,184679,Staff,63,0,100,37
1683642854440,CHEM 6C,A01,184681,Bussey; Thomas J,0,0,50,50
1683642854440,CHEM 6C,A02,184682,Bussey; Thomas J,32,0,50,18
1683642855467,CHEM 40A,A01,184684,Albizati; Kim F.,35,0,100,65
1683642856492,CHEM 40B,A01,184686,Albizati; Kim F.,0,22,100,100
1683642857516,CHEM 41B,A01,184690,Staff,51,0,100,49
1683642858543,COGS 3,A01,184715,Boyle; Mary E. T.,0,27,40,40
1683642859572,COGS 14B,A01,185172,Staff,0,14,38,38
1683642860601,COGS 18,A01,184736,Staff,15,0,80,65
1683642861625,COGS 100,A01,184932,Staff,0,7,73,73
1683642862653,COGS 101A,A01,184935,Staff,0,39,30,30
1683642863678,COGS 101B,A01,184944,Staff,0,2,30,30
1683642864703,COGS 101C,A01,184946,Staff,0,10,30,30
1683642865729,COGS 102A,A01,184951,Johnson; Christine M.,2,0,40,38
1683642866755,COGS 107B,A01,184953,Mooshagian; Eric Frederick,0,51,40,40
1683642867780,COGS 118B,A01,184959,Gupta; Anjum,0,49,40,40
1683642868807,COGS 153,A00,184961,Staff,0,16,30,30
1683642869834,COGS 177,A00,184962,Staff,0,21,30,30
1683642870858,COGS 187A,A01,184969,Boyle; Mary E. T.,0,19,40,40
1683642871882,COMM 10,A01,185174,Staff,0,5,25,25
1683642871882,COMM 10,A02,185189,Staff,0,2,25,25
1683642871882,COMM 10,A03,269821,Staff,0,1,0,0
1683642872907,COMM 100B,A01,185475,Staff,0,1,0,2
1683642872907,COMM 100B,A02,185476,Staff,12,0,25,13
1683642873936,COMM 100C,A01,185314,Staff,1,0,25,24
1683642873936,COMM 100C,A02,185327,Staff,18,0,25,7
1683642874961,COMM 110M,A00,185349,Staff,0,0,40,40
1683642875985,COMM 113T,A00,185352,Staff,25,0,40,15
1683642877018,COMM 114I,A00,185353,Staff,31,0,40,9
1683642878043,COMM 131,A00,185354,Staff,17,0,30,13
1683642879072,CSE 8A,A50,185358,Cao; Yingjun,0,46,10,10
1683642880102,CSE 8B,A01,185362,Staff,0,48,50,50
1683642881127,CSE 11,A01,185416,Cao; Yingjun,0,91,10,10
1683642882153,CSE 20,A01,185445,Briones; Jor-el Thomas Caparas,4,0,25,21
1683642883177,CSE 21,A01,185447,Staff,9,0,50,41
1683642884202,CSE 101,A01,185451,Staff,0,13,50,50
1683642884202,CSE 101,B01,185453,Jones; Miles E,0,13,50,50
1683642886255,CSE 141,A01,185458,Eldon; John,15,0,100,85
1683642887281,CSE 141L,A01,185461,Eldon; John,7,0,100,93
1683642888307,CSE 142,A01,185463,Staff,36,0,60,24
1683642888307,CSE 142,B01,201355,Staff,0,7,60,60
1683642889334,CSE 142L,A01,185470,Staff,36,0,60,24
1683642889334,CSE 142L,B01,201417,Staff,0,6,60,60
1683642890359,CSE 190,A00,201433,Staff,32,0,49,17
1683642891389,DOC 1,A01,259136,Strom; Megan C.,7,0,15,8
1683642891389,DOC 1,A02,259137,Strom; Megan C.,14,0,15,1
1683642891389,DOC 1,A03,259138,Strom; Megan C.,14,0,15,1
1683642891389,DOC 1,A04,259139,Strom; Megan C.,14,0,15,1
1683642892413,DOC 100D,A00,259140,Pass; Natalye Joann,14,0,25,11
1683642893440,DSGN 1,A01,184749,Rill; Bryan,0,26,30,30
1683642894467,DSGN 100,A01,185168,Staff,0,2,25,25
1683642895490,ECE 5,A01,185626,Morris; Karcher William,0,11,0,0
1683642896516,ECE 101,A01,185628,Staff,14,0,70,56
1683642897611,ECE 107,A01,185635,Baghdadchi; Saharnaz,0,0,20,20
1683642897611,ECE 107,A02,185638,Baghdadchi; Saharnaz,3,0,20,17
1683642898639,ECE 148,A01,185647,Silberman; Jack,0,0,16,16
1683642899667,ECON 1,A01,185537,Crane; Meredith Helen,54,0,70,16
1683642900693,ECON 3,A01,185549,Crane; Meredith Helen,29,0,70,41
1683642901721,ECON 4,A01,203354,Anderson; John Charles,0,5,10,10
1683642902746,ECON 100A,A01,185574,Staff,0,5,40,40
1683642903772,ECON 100B,A01,185576,Staff,0,12,50,50
1683642904797,ECON 100C,A01,185589,Newhouse; Herbert S,30,0,70,40
1683642905822,ECON 105,A00,185608,Vespa; Emanuel Ignacio,19,0,35,16
1683642906850,ECON 109,A01,185610,Shishkin; Denis,9,0,35,26
1683642907878,ECON 110A,A01,185612,Staff,9,0,40,31
1683642908905,ECON 120A,A01,185615,Staff,20,0,40,20
1683642909930,ECON 120C,A01,185617,Sun; Yixiao,0,20,70,70
1683642910957,ECON 144,A00,203346,Squires; Dale E,2,0,35,33
1683642911986,ECON 171,A01,203349,Newhouse; Herbert S,0,1,35,35
1683642913009,ECON 173A,A01,185621,Toda; Alexis Akira,21,0,35,14
1683642914035,EDS 25,A01,202413,Staff,0,1,0,0
1683642914035,EDS 25,A02,202414,Staff,0,1,0,0
1683642914035,EDS 25,A03,202415,Staff,0,0,0,0
1683642914035,EDS 25,A04,202416,Staff,0,1,0,0
1683642914035,EDS 25,A05,202439,Staff,0,0,0,0
1683642914035,EDS 25,A06,202440,Staff,0,0,0,0
1683642914035,EDS 25,B01,202631,Staff,0,0,0,0
1683642914035,EDS 25,B02,202632,Staff,0,0,0,0
1683642914035,EDS 25,B03,202639,Staff,0,0,0,0
1683642914035,EDS 25,B04,202640,Staff,0,0,0,0
1683642914035,EDS 25,B05,202643,Staff,0,0,0,0
1683642914035,EDS 25,B06,202644,Staff,0,0,0,0
1683642915061,EDS 38,A01,202659,Black; Alison Michelle,24,0,25,1
1683642916085,EDS 115,A00,202652,Staff,18,0,30,12
1683642917112,EDS 125,A00,202649,Staff,13,0,30,17
1683642918137,EDS 126,A01,203332,Staff,30,0,30,0
1683642919159,EDS 139,A00,202838,Staff,16,0,25,9
1683642920186,EDS 146,A01,202655,Staff,14,0,25,11
1683642921210,ENG 15,A00,185667,Staff,0,1,0,0
1683642921210,ENG 15,B00,185672,Staff,0,0,0,0
1683642921210,ENG 15,C00,185675,Staff,0,0,0,0
1683642921210,ENG 15,D00,185682,Staff,0,0,0,0
1683642921210,ENG 15,E00,185684,Staff,0,0,0,0
1683642922235,ETHN 103,A00,185710,Staff,0,8,35,35
1683642923260,ETHN 103A,A00,199228,Man; Simeon S,0,0,9,9
1683642924288,ETHN 109,A00,185711,Staff,16,0,35,19
1683642925321,ETHN 142,A00,185726,Staff,0,4,30,30
1683642926345,ETHN 163J,A00,199229,Man; Simeon S,5,0,8,3
1683642927373,ETHN 168,A00,185727,Staff,7,0,10,3
1683642928399,ETHN 182,A00,185728,Staff,0,0,35,35
1683642929426,ETHN 183,A00,185737,Staff,9,0,18,9
1683642930449,GLBH 111,A01,209361,Burgos; Jose L.,0,0,0,0
1683642932503,HIEU 104,A00,185792,Staff,14,0,20,6
1683642933528,HIEU 115,A00,185800,Staff,0,0,20,20
1683642934553,HIEU 128,A00,185801,Staff,0,9,20,20
1683642935577,HIEU 147,A00,185802,Staff,15,0,20,5
1683642936605,HIEU 154,A00,185823,Staff,11,0,20,9
1683642937630,HILA 102,A00,185826,Staff,14,0,20,6
1683642938654,HILD 2C,A01,185778,Staff,0,13,20,20
1683642939682,HILD 7B,A01,185780,Kwak; Nancy,0,16,32,32
1683642939682,HILD 7B,A02,185781,Kwak; Nancy,0,18,32,32
1683642940707,HILD 30,A01,185791,Staff,12,0,20,8
1683642941736,HISC 119,A00,185830,Golan; Tal,0,9,20,20
1683642942761,HITO 156GS,A00,185831,Patterson; Patrick H.,0,0,0,23
1683642943789,HIUS 103,A00,185832,Man; Simeon S,0,4,20,20
1683642944813,HIUS 117,A00,185836,Kwak; Nancy,2,0,20,18
1683642945841,HIUS 125,A00,185840,Man; Simeon S,0,1,23,23
1683642946865,HIUS 149,A00,185845,Staff,1,0,20,19
1683642947891,HUM 3,A01,185882,Zavodny; Tatiana Sophia,0,7,50,50
1683642947891,HUM 3,B01,185899,Caldwell; Michael Alan,0,18,50,50
1683642948917,HUM 3GS,A00,185900,Patterson; Patrick H.,0,0,0,23
1683642949943,HUM 4,A01,185938,Zroka; Amy Liane,30,0,50,20
1683642949943,HUM 4,B01,185956,Watkins; Eric,0,4,50,50
1683642949943,HUM 4,B02,202209,Watkins; Eric,0,4,50,50
1683642949943,HUM 4,B03,202210,Watkins; Eric,0,4,50,50
1683642950971,HUM 5,A01,185958,West; Geoffrey Scott,2,0,50,48
1683642950971,HUM 5,A02,202215,West; Geoffrey Scott,0,0,50,50
1683642952000,INTL 190,A00,185959,Gagnon; Jeffrey C,0,0,0,9
1683642952000,INTL 190,B00,185960,Lettieri; Michael Joseph,0,0,0,2
1683642953026,JAPN 180,A00,254509,Staff,5,0,30,25
1683642954059,LATI 10,A01,202853,Kennemore; Amy Michelle,4,0,35,31
1683642954059,LATI 10,A02,202854,Kennemore; Amy Michelle,2,0,35,33
1683642954059,LATI 10,A03,270054,Kennemore; Amy Michelle,30,0,30,0
1683642955083,LATI 180,A00,202855,Kennemore; Amy Michelle,11,0,20,9
1683642956109,LAWS 101,A00,201767,Golan; Tal,0,7,40,40
1683642957134,LIFR 1C,A00,185961,Staff,6,0,20,14
1683642958157,LIFR 1CX,A00,185962,Staff,7,0,20,13
1683642959183,LIFR 1D,A00,185963,Staff,7,0,20,13
1683642960210,LIFR 1DX,A00,185964,Staff,7,0,20,13
1683642961235,LIGN 101,A01,186039,Staff,43,0,50,7
1683642962260,LIGN 165,A00,186040,Staff,15,0,50,35
1683642963285,LTCS 108,A00,186041,Staff,5,0,10,5
1683642964310,LTCS 119,A00,186042,Staff,15,0,20,5
1683642965332,LTCS 130,A00,186043,Wesling; Megan E.,15,0,25,10
1683642967383,LTEA 138,A00,186119,Staff,14,0,40,26
1683642968410,LTEN 124,A00,186148,Staff,5,0,25,20
1683642969440,LTEN 178,A00,186149,Staff,7,0,15,8
1683642970469,LTEN 181,A00,186150,Blanco; John D,34,0,40,6
1683642971501,LTWL 120,A00,186160,Staff,20,0,25,5
1683642972527,LTWL 165,A00,186161,Staff,22,0,25,3
1683642973551,LTWR 100,A00,186162,Staff,0,5,15,15
1683642974576,LTWR 102,A00,186163,Doller; Ben,5,0,15,10
1683642975601,MAE 8,A01,186412,Staff,0,0,0,0
1683642976626,MAE 30B,A00,186445,Bahadori; Mohammad Yousef,82,0,100,18
1683642977651,MAE 40,A00,186592,Bewley; Thomas R,10,0,50,40
1683642978680,MAE 101B,A00,186593,Bahadori; Mohammad Yousef,80,0,100,20
1683642979704,MAE 105,A00,186594,Bandaru; Prabhakar,10,0,50,40
1683642980730,MAE 107,A00,186599,Pham; Hieu Tan,0,7,120,120
1683642981758,MAE 148,A01,186660,Silberman; Jack,3,0,16,13
1683642982782,MATH 10A,A01,188095,Staff,0,5,35,35
1683642983811,MATH 10B,A01,188097,Bowers; Adam R.,0,11,30,30
1683642983811,MATH 10B,A02,188099,Bowers; Adam R.,0,11,30,30
1683642983811,MATH 10B,B01,188104,Bowers; Adam R.,0,10,30,30
1683642983811,MATH 10B,B02,188106,Bowers; Adam R.,1,9,30,29
1683642984838,MATH 10C,A01,188111,Staff,0,18,30,30
1683642984838,MATH 10C,A02,188127,Staff,0,19,30,30
1683642984838,MATH 10C,A03,188131,Staff,0,19,30,30
1683642984838,MATH 10C,B01,188218,Staff,17,0,30,13
1683642984838,MATH 10C,B02,188244,Staff,13,0,30,17
1683642984838,MATH 10C,B03,188277,Staff,14,0,30,16
1683642985870,MATH 18,A01,188344,Bach; Quang Tran,18,0,30,12
1683642985870,MATH 18,A02,188345,Bach; Quang Tran,11,0,30,19
1683642985870,MATH 18,B01,188353,Bach; Quang Tran,11,0,30,19
1683642985870,MATH 18,B02,188354,Bach; Quang Tran,19,0,30,11
1683642986895,MATH 20A,A01,188374,Staff,11,0,35,24
1683642987925,MATH 20B,A01,188382,Ohm; Ko Woon,7,0,30,23
1683642987925,MATH 20B,A02,188383,Ohm; Ko Woon,22,0,30,8
1683642987925,MATH 20B,B01,188385,Ohm; Ko Woon,7,0,30,23
1683642987925,MATH 20B,B02,188392,Ohm; Ko Woon,22,0,30,8
1683642988949,MATH 20C,A01,188394,Harel; Guershon,11,0,30,19
1683642988949,MATH 20C,A02,188395,Harel; Guershon,14,0,30,16
1683642988949,MATH 20C,B01,188404,Harel; Guershon,4,0,30,26
1683642988949,MATH 20C,B02,188405,Harel; Guershon,18,0,30,12
1683642989977,MATH 20D,A01,188414,Hammock; Frances H,0,1,30,30
1683642989977,MATH 20D,A02,188415,Hammock; Frances H,0,1,30,30
1683642989977,MATH 20D,B01,188447,Hammock; Frances H,0,1,30,30
1683642989977,MATH 20D,B02,188486,Hammock; Frances H,4,0,30,26
1683642991005,MATH 20E,A01,188649,Staff,21,0,30,9
1683642991005,MATH 20E,A02,188650,Staff,21,0,30,9
1683642991005,MATH 20E,A03,188673,Staff,0,0,30,30
1683642992032,MATH 102,A01,188675,Staff,0,36,35,35
1683642993061,MATH 103B,A01,188681,Staff,3,0,35,32
1683642993061,MATH 103B,B01,188692,Staff,5,0,35,30
1683642994087,MATH 109,A01,188695,Salehi Golsefidy; Alireza,24,0,35,11
1683642994087,MATH 109,A02,188696,Salehi Golsefidy; Alireza,25,0,35,10
1683642995115,MATH 120A,A01,188698,Eggers; John Dietrich,7,0,35,28
1683642996141,MATH 142B,A01,188736,Ioana; Adrian,0,1,30,30
1683642996141,MATH 142B,A02,188741,Ioana; Adrian,0,1,30,30
1683642996141,MATH 142B,A03,188743,Ioana; Adrian,0,1,30,30
1683642997165,MATH 168A,A01,188790,Staff,0,10,35,35
1683642998194,MATH 170A,A01,188803,Nie; Jiawang,0,2,35,35
1683642998194,MATH 170A,A02,188811,Nie; Jiawang,0,0,35,35
1683642998194,MATH 170A,A03,188814,Nie; Jiawang,0,0,35,35
1683642998194,MATH 170A,A04,188815,Nie; Jiawang,10,0,35,25
1683642999219,MATH 193B,A01,188817,Staff,0,0,35,35
1683642999219,MATH 193B,A02,188818,Staff,5,0,35,30
1683643000246,MGT 4,A01,202857,Anderson; John Charles,61,0,80,19
1683643001333,MGT 12,A00,202858,Lindenberger; Wade Douglas,40,0,90,50
1683643002360,MGT 18,A00,202859,Staff,74,0,90,16
1683643003386,MGT 18GS,A00,202860,McKay; Michael J,13,0,28,15
1683643004411,MGT 45,A00,202861,Pecore; Joseph P.,12,0,90,78
1683643005438,MGT 100,A00,202863,Yavorsky; Daniel Ryan,28,0,90,62
1683643006468,MGT 103,A00,202864,Ehrich; Kristine R,0,17,90,90
1683643007494,MGT 112,A00,202865,Ehrich; Kristine R,15,0,90,75
1683643008520,MGT 121A,A00,202868,Staff,0,20,0,0
1683643009545,MGT 131B,A00,202869,Anderson; John Charles,59,0,90,31
1683643010570,MGT 136,A00,202871,Lindenberger; Wade Douglas,83,0,90,7
1683643011594,MGT 164,A00,202873,Staff,0,66,90,91
1683643012619,MGT 164GS,A00,202874,McKay; Mary A,13,0,28,15
1683643013642,MGT 180,A00,202875,Staff,0,50,90,91
1683643014667,MMW 11R,A01,205019,Herbst; Matthew,2,0,30,28
1683643014667,MMW 11R,A02,205026,Herbst; Matthew,29,0,30,1
1683643015689,MMW 15,A01,193512,Chang; Edmond Yi-Teh,0,8,28,28
1683643015689,MMW 15,A02,193513,Chang; Edmond Yi-Teh,0,5,28,28
1683643015689,MMW 15,A03,193514,Chang; Edmond Yi-Teh,0,5,28,28
1683643015689,MMW 15,A04,193515,Chang; Edmond Yi-Teh,0,5,28,28
1683643015689,MMW 15,A05,193516,Chang; Edmond Yi-Teh,0,5,28,28
1683643015689,MMW 15,A06,193517,Chang; Edmond Yi-Teh,0,6,28,28
1683643015689,MMW 15,B01,193519,Chang; Edmond Yi-Teh,0,5,28,28
1683643015689,MMW 15,B02,193520,Chang; Edmond Yi-Teh,0,5,28,28
1683643015689,MMW 15,B03,193521,Chang; Edmond Yi-Teh,0,5,28,28
1683643015689,MMW 15,B04,193522,Chang; Edmond Yi-Teh,0,5,28,28
1683643015689,MMW 15,B05,193523,Chang; Edmond Yi-Teh,0,5,28,28
1683643015689,MMW 15,B06,193524,Chang; Edmond Yi-Teh,0,5,28,28
1683643016717,MMW 122,A01,193526,Rahimi; Babak,0,16,28,28
1683643016717,MMW 122,A02,193527,Rahimi; Babak,0,15,28,28
1683643016717,MMW 122,A03,193528,Rahimi; Babak,0,0,0,0
1683643016717,MMW 122,A04,193529,Rahimi; Babak,0,0,0,0
1683643017745,MUS 1A,A01,186663,Staff,1,20,35,34
1683643018770,MUS 4,A01,186715,Staff,0,12,35,35
1683643019796,MUS 5R,A01,186796,Dubnov; Shlomo,0,17,35,35
1683643020823,MUS 6,A01,186798,Staff,0,5,25,25
1683643021851,MUS 7,A01,186830,Staff,11,0,35,24
1683643022883,MUS 8,A01,186930,Staff,0,26,35,35
1683643023908,MUS 15,A01,186932,Staff,0,16,35,35
1683643023908,MUS 15,B01,186934,Staff,0,17,35,35
1683643024933,MUS 80,A00,186935,Staff,0,0,20,20
1683643024933,MUS 80,B00,186936,Staff,24,0,25,1
1683643025958,NANO 11,A00,204702,Lipomi; Darren John,0,0,0,0
1683643026981,NANO 15,A01,204709,Yang; Kesong,0,1,0,0
1683643028005,NANO 114,A00,202069,Jahed Motlagh; Zeinab,3,0,10,7
1683643029028,PHIL 1,A00,186955,Grush; Rick Scott,31,0,40,9
1683643030058,PHIL 10,A01,186973,Grush; Rick Scott,27,0,35,8
1683643030058,PHIL 10,A02,186974,Grush; Rick Scott,33,0,35,2
1683643031082,PHIL 13,A01,186976,Staff,3,0,35,32
1683643031082,PHIL 13,A02,186977,Staff,16,0,35,19
1683643032111,PHIL 14,A01,186979,Staff,31,0,35,4
1683643032111,PHIL 14,A02,186986,Staff,32,0,35,3
1683643033137,PHIL 28,A01,186988,Staff,16,0,30,14
1683643033137,PHIL 28,A02,186989,Staff,1,0,30,29
1683643033137,PHIL 28,A03,186990,Staff,10,0,30,20
1683643033137,PHIL 28,A04,186991,Staff,26,0,30,4
1683643034162,PHIL 120,A00,186997,Staff,23,0,40,17
1683643035189,PHIL 137,A00,187003,Staff,7,0,40,33
1683643036214,PHIL 150,A00,187015,Staff,47,0,70,23
1683643037239,PHIL 167,A00,187021,Lamey; Andy M.,34,0,40,6
1683643038267,PHIL 174,A01,202226,Staff,17,0,20,3
1683643038267,PHIL 174,A02,202235,Staff,20,0,20,0
1683643039293,PHIL 191A,A00,258918,Staff,0,0,1,1
1683643040321,PHYS 1A,A00,187028,Staff,27,0,60,33
1683643041349,PHYS 1AL,001,187036,Staff,3,0,30,27
1683643041349,PHYS 1AL,002,187049,Staff,18,0,30,12
1683643042375,PHYS 1B,A00,187058,Staff,22,0,60,38
1683643043401,PHYS 1BL,001,187064,Staff,0,1,30,30
1683643043401,PHYS 1BL,002,187070,Staff,4,0,30,26
1683643044425,PHYS 1C,A00,187082,Staff,29,0,120,91
1683643045449,PHYS 1CL,001,187088,Staff,0,9,30,30
1683643045449,PHYS 1CL,002,187089,Staff,0,1,30,30
1683643045449,PHYS 1CL,009,262693,Staff,9,0,30,21
1683643046474,PHYS 2B,A01,187097,Staff,55,0,115,60
1683643047500,PHYS 2C,A01,187099,Staff,64,0,115,51
1683643048525,PHYS 2CL,A01,187101,Staff,5,0,28,23
1683643048525,PHYS 2CL,A02,187102,Staff,15,0,28,13
1683643049555,PHYS 2D,A01,187123,Shotwell; Brian,95,0,115,20
1683643050582,PHYS 4B,A01,187133,Grinstein; Benjamin,35,0,50,15
1683643051606,POLI 10,A00,188819,Staff,0,4,50,50
1683643052634,POLI 11,A00,188827,Staff,43,0,50,7
1683643053661,POLI 13R,A00,188828,Staff,0,1,20,20
1683643054698,POLI 27,A01,188830,Elgin; Samuel Zincke,0,2,70,70
1683643055723,POLI 30,A00,188832,Desposato; Scott,30,0,50,20
1683643056747,POLI 102F,A00,188834,Staff,0,0,40,40
1683643057774,POLI 104A,A00,188852,Staff,13,0,30,17
1683643058798,POLI 104I,A00,188853,Staff,0,7,20,20
1683643059826,POLI 110B,A00,188854,Wiens; David,7,0,20,13
1683643060851,POLI 112A,A00,188855,Wiens; David,4,0,30,26
1683643061876,POLI 117R,A00,188856,Forman; Fonna,0,12,20,20
1683643062904,POLI 118,A00,188857,Ingham; Sean,8,0,20,12
1683643063932,POLI 120G,A00,188858,Staff,8,0,30,22
1683643064955,POLI 131CR,A00,188863,Hoston; Germaine,21,0,50,29
1683643065983,POLI 133,A00,188864,Nellis; Gareth Hb,44,0,50,6
1683643067007,POLI 134D,A00,188865,Desposato; Scott,27,0,30,3
1683643068038,POLI 142A,A00,188871,Gartzke; Erik,21,0,50,29
1683643069065,POLI 142K,A00,188874,Staff,38,0,50,12
1683643070090,POLI 143,A00,188940,Gartzke; Erik,16,0,30,14
1683643071117,POLI 153,A00,188943,Staff,2,0,20,18
1683643072141,POLI 160AA,A00,188944,Staff,11,0,40,29
1683643073166,POLI 170A,A00,188945,Staff,11,0,30,19
1683643075218,PSYC 1,A00,188952,Staff,36,0,90,54
1683643076245,PSYC 2,B00,188953,Staff,19,0,35,16
1683643077269,PSYC 6,A00,188970,Staff,47,0,60,13
1683643078295,PSYC 7,A00,188973,Staff,35,0,45,10
1683643079323,PSYC 60,A01,188980,Rickard; Timothy C.,42,0,60,18
1683643080350,PSYC 70,A01,189001,Steiner; Eric Tomas,23,0,45,22
1683643081378,PSYC 100,A00,189005,Lacefield; Katharine I,0,99,120,120
1683643082404,PSYC 102,A00,189008,Staff,8,0,30,22
1683643083432,PSYC 106,B00,189026,Gorman; Michael R.,27,0,60,33
1683643084461,PSYC 114,B01,189033,Winkielman; Piotr,0,31,30,30
1683643085488,PSYC 131,A00,189036,Anagnostaras; Stephan,0,43,60,60
1683643086517,PSYC 136,A00,189041,Lowe; Angela Beth,0,7,25,25
1683643087547,PSYC 137,A00,189057,Winkielman; Piotr,0,37,25,25
1683643088577,PSYC 144,A00,189107,Wixted; John T,0,10,50,50
1683643090632,PSYC 162,A00,189142,Staff,0,9,85,85
1683643091656,PSYC 172,A00,189144,Gorman; Michael R.,0,6,30,30
1683643093710,PSYC 179,A00,189146,Lacefield; Katharine I,0,86,120,120
1683643094735,PSYC 181,A00,189147,Anagnostaras; Stephan,0,44,90,90
1683643095759,PSYC 190R,A00,189148,Barner; David A.,0,23,80,80
1683643096789,PSYC 191,A00,189275,Rickard; Timothy C.,0,10,25,25
1683643097818,PSYC 193,A00,189276,Chapman; Eddie Nathaniel,0,1,0,4
1683643098848,PSYC 193L,A01,189281,Lowe; Angela Beth,10,0,20,10
1683643098848,PSYC 193L,B01,189285,Staff,28,0,35,7
1683643099876,RELI 149,A00,187137,Rahimi; Babak,7,0,40,33
1683643100903,SE 9,A01,187315,Staff,0,2,18,18
1683643101929,SE 101B,A00,187409,Staff,24,0,30,6
1683643102954,SE 110B,A00,187444,Staff,10,0,40,30
1683643103982,SE 130B,A00,187449,Staff,31,0,40,9
1683643105072,SE 150A,A00,187516,Staff,9,0,20,11
1683643106133,SE 154,A00,187528,Staff,29,0,50,21
1683643107158,SIO 3,A01,258171,Staff,35,0,40,5
1683643108183,SIO 10,A00,187144,Cook; Geoffrey W,0,6,75,75
1683643109211,SIO 45,A00,187152,Cook; Geoffrey W,0,4,100,100
1683643110239,SIO 109R,A00,194486,Staff,0,4,20,20
1683643112297,SIO 187,A01,187233,Kacev; David,12,0,40,28
1683643113322,SOCI 1,A01,258656,Thorpe; Charles Robert,28,0,30,2
1683643113322,SOCI 1,A02,258658,Thorpe; Charles Robert,30,0,30,0
1683643113322,SOCI 1,A03,258661,Thorpe; Charles Robert,25,0,25,0
1683643113322,SOCI 1,A04,258666,Thorpe; Charles Robert,22,0,25,3
1683643113322,SOCI 1,A05,258897,Thorpe; Charles Robert,22,0,25,3
1683643113322,SOCI 1,A06,258898,Thorpe; Charles Robert,25,0,25,0
1683643114348,SOCI 30,A01,258903,Pardo Guerra; Juan Pablo,14,0,30,16
1683643115383,SOCI 102,A00,258904,Staff,9,0,25,16
1683643116409,SOCI 106,A00,258905,Staff,19,0,25,6
1683643117438,SOCI 111,A00,258907,Ribas Norris; Janet Vanesa,26,0,30,4
1683643118463,SOCI 121R,A00,258908,Pardo Guerra; Juan Pablo,8,0,30,22
1683643119491,SOCI 126,A01,203330,Staff,14,0,20,6
1683643120517,SOCI 131,A00,258909,Thorpe; Charles Robert,30,0,60,30
1683643121542,SOCI 135,A00,258910,Payne; Christine Anna,0,11,30,30
1683643122567,SOCI 157,A00,258911,Staff,12,0,30,18
1683643123592,SOCI 184,A00,258912,Staff,25,0,30,5
1683643124618,SOCI 188D,A00,258913,Staff,22,0,30,8
1683643125641,SYN 2,001,187529,Staff,9,0,16,7
1683643125641,SYN 2,002,201452,Staff,0,20,16,16
1683643125641,SYN 2,003,201469,Staff,2,0,16,14
1683643126666,SYN 100,A01,187531,Staff,0,9,20,20
1683643126666,SYN 100,B01,201491,Staff,0,10,20,20
1683643127695,TDAC 1,A00,189286,Walsh; Kim C.,3,0,20,17
1683643127695,TDAC 1,B00,189287,Harting; Carla Kelso,10,0,20,10
1683643128719,TDAC 101,A00,189300,Walsh; Kim C.,16,0,20,4
1683643128719,TDAC 101,B00,189301,Harting; Carla Kelso,18,0,20,2
1683643129744,TDAC 102,A00,189304,Basso; Beatrice,14,0,20,6
1683643130771,TDAC 108,A00,189305,Staff,18,0,20,2
1683643131799,TDDE 131,A00,189310,Staff,19,0,20,1
1683643131799,TDDE 131,B00,189314,Staff,19,0,20,1
1683643131799,TDDE 131,C00,189315,Staff,48,0,50,2
1683643131799,TDDE 131,D00,189316,Staff,14,0,15,1
1683643131799,TDDE 131,E00,204841,Staff,20,0,20,0
1683643132829,TDGE 10,A00,189289,Staff,27,0,50,23
1683643132829,TDGE 10,B00,189290,Havis; Allan,0,0,50,50
1683643133859,TDGE 11,A00,189291,Fulton; Julia,0,4,50,50
1683643133859,TDGE 11,B00,189292,Staff,20,0,25,5
1683643133859,TDGE 11,C00,260270,Staff,0,0,0,0
1683643134884,TDGE 25,A00,189294,Staff,2,0,20,18
1683643135913,TDGE 124,A00,189318,Fulton; Julia,0,8,50,50
1683643136942,TDGE 125,A00,189319,Staff,13,0,25,12
1683643136942,TDGE 125,B00,189320,Staff,23,0,25,2
1683643137970,TDGE 127,A00,189322,Havis; Allan,0,0,50,50
1683643138999,TDHT 101,A00,189323,Staff,18,0,25,7
1683643138999,TDHT 101,B00,189324,Staff,25,0,25,0
1683643140028,TDHT 102,A00,189325,Staff,49,0,50,1
1683643141055,TDMV 1,A00,189295,Arcidiacono; Kristin,20,0,30,10
1683643141055,TDMV 1,B00,189296,Caligagan; Maria T.,24,0,30,6
1683643142081,TDMV 2,A00,189297,Sammartano; Tonnie,27,0,30,3
1683643142081,TDMV 2,B00,189299,Arcidiacono; Kristin,23,0,30,7
1683643143116,TDMV 3,A00,204998,Rincon; Alicia,22,0,30,8
1683643144142,TDMV 120,A00,189458,Sammartano; Tonnie,28,0,30,2
1683643145167,TDMV 138,A00,189541,Jun; Grace Shin Hae,20,0,40,20
1683643146192,TDMV 142,A00,189717,Caligagan; Tony,25,0,30,5
1683643146192,TDMV 142,B00,189718,Caligagan; Maria T.,25,0,30,5
1683643147219,TMC 2,A01,187533,Staff,25,0,25,0
1683643147219,TMC 2,A02,187534,Staff,25,0,25,0
1683643148243,USP 1,A01,187536,Kwak; Nancy,0,16,25,25
1683643149268,USP 5,A01,187538,Staff,9,0,25,16
1683643150295,USP 101,A00,199253,Staff,0,4,0,0
1683643151321,USP 124,A00,187562,Boomhower; Matthew Charles,0,0,30,30
1683643152344,USP 138,A00,187582,Staff,20,0,25,5
1683643153368,USP 152,A01,187597,Staff,3,0,25,22
1683643154395,USP 153,A00,187598,Staff,19,0,25,6
1683643155419,USP 168,A00,187607,Kwak; Nancy,2,0,5,3
1683643156444,USP 173,A00,187619,Staff,4,0,25,21
1683643157471,USP 181,A00,187638,Staff,0,4,25,25
1683643158494,VIS 103,A00,187650,Cruz; Edwin Teddy,18,0,75,57
1683643159518,VIS 110D,A00,187669,Staff,13,0,22,9
1683643160542,VIS 127C,A00,187720,Shen; Kuiyi,67,0,146,79
1683643161570,VIS 149,A00,187731,Yoldas; Pinar,0,14,22,22
1683643162594,VIS 151,A01,188091,Staff,22,0,34,12
1683643162594,VIS 151,A02,188092,Staff,11,0,34,23
1683643163619,VIS 160B,A00,188093,Stalbaum; Brett,0,1,10,10
1683643165679,WCWP 10B,A00,201720,Staff,10,0,15,5
1683643165679,WCWP 10B,B00,201722,Staff,9,0,15,6
1683643166712,WCWP 100,A00,201725,Gagnon; Jeffrey C,0,0,2,2
1683643166712,WCWP 100,B00,201727,Staff,0,4,15,15
1683643169861,ANBI 133,A00,258401,Wilder; Linnea Lorene,34,0,40,6
1683643170886,ANBI 140,A00,258395,Hrvoj Mihic; Branka,18,0,25,7
1683643171910,ANSC 120,A00,258402,Bialecki; Jon Anthony,27,0,40,13
1683643172934,ANSC 144,A00,258400,Staff,12,0,40,28
1683643174988,ANSC 166,A00,258396,Parish; Steven Martin,156,0,175,19
1683643176012,ANSC 180,A00,193533,Staff,8,0,20,12
1683643177041,ANSC 188,A00,258397,Jassal; Aftab,34,0,40,6
1683643178066,ANTH 3,A01,258316,Staff,23,0,30,7
1683643179099,ANTH 5,A00,258394,Semendeferi; Ekaterini,16,0,20,4
1683643180122,ANTH 21,A01,258331,Staff,4,0,40,36
1683643181147,ANTH 103,A00,258398,Varma; Saiba,15,0,25,10
1683643182178,AWP 10,001,202034,Staff,0,0,0,0
1683643182178,AWP 10,002,202035,Staff,0,0,0,0
1683643182178,AWP 10,003,202036,Staff,0,0,0,0
1683643182178,AWP 10,004,202037,Staff,0,0,0,0
1683643182178,AWP 10,005,202038,Staff,0,0,0,0
1683643182178,AWP 10,006,202039,Staff,0,0,0,0
1683643182178,AWP 10,007,202040,Staff,0,0,0,0
1683643182178,AWP 10,008,202041,Staff,0,0,0,0
1683643182178,AWP 10,009,202042,Staff,0,0,0,0
1683643182178,AWP 10,010,202043,Staff,0,0,0,0
1683643182178,AWP 10,011,202044,Staff,0,0,0,0
1683643182178,AWP 10,012,202045,Staff,0,0,0,0
1683643182178,AWP 10,013,202046,Staff,0,0,0,0
1683643182178,AWP 10,014,202047,Staff,0,0,0,0
1683643182178,AWP 10,015,202048,Staff,0,0,0,0
1683643182178,AWP 10,016,202049,Staff,0,0,0,0
1683643182178,AWP 10,017,202050,Staff,0,0,0,0
1683643182178,AWP 10,018,202051,Staff,0,0,0,0
1683643182178,AWP 10,019,202052,Staff,0,0,0,0
1683643182178,AWP 10,020,202053,Staff,0,0,0,0
1683643182178,AWP 10,021,202054,Staff,0,0,0,0
1683643182178,AWP 10,022,202055,Staff,0,0,0,0
1683643182178,AWP 10,023,202056,Staff,0,0,0,0
1683643182178,AWP 10,024,202057,Staff,0,0,0,0
1683643182178,AWP 10,025,202058,Staff,0,0,0,0
1683643182178,AWP 10,026,202059,Staff,0,0,0,0
1683643183205,AWP 102,001,202032,Staff,0,0,0,0
1683643183205,AWP 102,002,202033,Staff,0,0,0,0
1683643184233,BENG 100,A01,254234,Taylor Amos; Alyssa C,31,0,40,9
1683643185260,BENG 196,001,270013,Engler; Adam J.,9999,0,9999,0
1683643186295,BICD 100R,A01,202018,Smith; Laurie,0,7,32,32
1683643186295,BICD 100R,A02,202019,Smith; Laurie,0,3,32,32
1683643186295,BICD 100R,A03,202020,Smith; Laurie,0,1,32,32
1683643186295,BICD 100R,A04,202021,Smith; Laurie,6,0,32,26
1683643186295,BICD 100R,A05,202022,Smith; Laurie,11,0,32,21
1683643187329,BICD 136,A01,193242,Gustafson-Brown; Cindy,0,2,32,32
1683643187329,BICD 136,A02,193244,Gustafson-Brown; Cindy,13,0,32,19
1683643188364,BIEB 102,A01,193249,Butler; Shannon Rhey,0,2,32,32
1683643188364,BIEB 102,A02,193251,Butler; Shannon Rhey,0,0,32,32
1683643188364,BIEB 102,A03,193253,Butler; Shannon Rhey,0,0,32,32
1683643188364,BIEB 102,A04,193255,Butler; Shannon Rhey,14,0,32,18
1683643188364,BIEB 102,A05,193265,Butler; Shannon Rhey,26,0,32,6
1683643188364,BIEB 102,A06,193269,Butler; Shannon Rhey,14,0,32,18
1683643190417,BIEB 150,A01,193274,Staff,0,0,32,32
1683643190417,BIEB 150,A02,193285,Staff,24,0,32,8
1683643191444,BIEB 194,A00,193286,Kurle; Carolyn M.,20,0,32,12
1683643192473,BILD 1,A01,192291,Staff,15,0,32,17
1683643192473,BILD 1,A02,192292,Staff,30,0,32,2
1683643192473,BILD 1,B01,192520,Reuther; Keefe,0,1,0,0
1683643192473,BILD 1,B02,192532,Reuther; Keefe,0,1,0,0
1683643193500,BILD 3,A01,192556,Butler; Shannon Rhey,0,0,32,32
1683643193500,BILD 3,A02,192581,Butler; Shannon Rhey,1,0,32,31
1683643193500,BILD 3,A03,192611,Butler; Shannon Rhey,21,0,32,11
1683643193500,BILD 3,A04,192612,Butler; Shannon Rhey,24,0,32,8
1683643193500,BILD 3,A05,192613,Butler; Shannon Rhey,26,0,32,6
1683643193500,BILD 3,A06,192679,Butler; Shannon Rhey,27,0,32,5
1683643193500,BILD 3,A07,192682,Butler; Shannon Rhey,20,0,32,12
1683643194533,BILD 4,A01,192836,Reuther; Keefe,0,0,24,24
1683643194533,BILD 4,A02,193044,Reuther; Keefe,4,0,24,20
1683643195562,BILD 10,A01,193142,Gustafson-Brown; Cindy,29,0,32,3
1683643195562,BILD 10,A02,193149,Gustafson-Brown; Cindy,31,0,32,1
1683643196592,BIMM 100,A01,193301,Staff,0,6,32,32
1683643196592,BIMM 100,A02,193312,Staff,0,7,32,32
1683643196592,BIMM 100,A03,193323,Staff,0,9,32,32
1683643197621,BIMM 101,A01,193329,McDonnell; Lisa Marie,0,4,24,24
1683643197621,BIMM 101,A02,193339,McDonnell; Lisa Marie,0,3,24,24
1683643197621,BIMM 101,B01,193354,McDonnell; Lisa Marie,0,4,24,24
1683643197621,BIMM 101,B02,193357,McDonnell; Lisa Marie,0,2,24,24
1683643198649,BIMM 110,A01,193377,Tat; John,0,11,32,32
1683643198649,BIMM 110,A02,193378,Tat; John,0,10,32,32
1683643199678,BIMM 120,A01,206116,Staff,0,0,32,32
1683643199678,BIMM 120,A02,206117,Staff,6,0,32,26
1683643199678,BIMM 120,A03,206121,Staff,21,0,32,11
1683643200706,BIPN 100,A01,193393,Park; Ji Young,0,14,32,32
1683643200706,BIPN 100,A02,193402,Park; Ji Young,0,14,32,32
1683643200706,BIPN 100,A03,193413,Park; Ji Young,0,14,32,32
1683643200706,BIPN 100,A04,193414,Park; Ji Young,0,13,32,32
1683643201730,BIPN 102,A01,193429,Staff,0,0,32,32
1683643201730,BIPN 102,A02,193438,Staff,18,0,32,14
1683643202758,BIPN 106,A01,193450,Reyes Gonzalez; Catalina,0,2,40,40
1683643203785,BIPN 134,A01,193465,Cooke; James Edward,0,0,32,32
1683643203785,BIPN 134,A02,193474,Cooke; James Edward,25,0,32,7
1683643203785,BIPN 134,A03,193485,Cooke; James Edward,29,0,32,3
1683643203785,BIPN 134,A04,193486,Cooke; James Edward,20,0,32,12
1683643203785,BIPN 134,A05,193491,Cooke; James Edward,31,0,32,1
1683643203785,BIPN 134,A06,193501,Cooke; James Edward,30,0,32,2
1683643203785,BIPN 134,A07,193510,Cooke; James Edward,29,0,32,3
1683643205840,BISP 194,A00,222522,Staff,14,0,32,18
1683643206866,CAT 124,A01,202407,Staff,19,0,25,6
1683643207892,CAT 125,A00,202408,Marchisotto; Jennifer Anne,2,0,20,18
1683643208985,CAT 125R,A00,202409,Smith; Lauryn Alissa,0,11,20,20
1683643208985,CAT 125R,B00,202410,Morales; Celeste Georgianna,0,11,20,20
1683643208985,CAT 125R,C00,202411,Irwin; Matthew Joseph,0,12,20,20
1683643210017,CENG 15,A01,204712,Yang; Kesong,0,1,0,0
1683643211042,CENG 114,A00,202070,Jahed Motlagh; Zeinab,5,0,20,15
1683643212077,CGS 105,A00,185477,Wesling; Megan E.,24,0,40,16
1683643213105,CGS 106,A00,185494,Staff,11,0,22,11
1683643214136,CGS 108,A00,185495,Staff,14,0,20,6
1683643215161,CGS 114,A00,185496,Staff,13,0,18,5
1683643216189,CGS 119,A00,185501,Staff,15,0,20,5
1683643217216,CGS 120,A00,185511,Staff,12,0,20,8
1683643218246,CHEM 4,A01,184675,Bussey; Thomas J,97,0,100,3
1683643219273,CHEM 6A,A01,184677,Staff,33,0,60,27
1683643220302,CHEM 6B,A01,184679,Staff,63,0,100,37
1683643221332,CHEM 6C,A01,184681,Bussey; Thomas J,0,0,50,50
1683643221332,CHEM 6C,A02,184682,Bussey; Thomas J,32,0,50,18
1683643222363,CHEM 40A,A01,184684,Albizati; Kim F.,35,0,100,65
1683643223389,CHEM 40B,A01,184686,Albizati; Kim F.,0,22,100,100
1683643224413,CHEM 41B,A01,184690,Staff,51,0,100,49
1683643225439,COGS 3,A01,184715,Boyle; Mary E. T.,0,27,40,40
1683643226470,COGS 14B,A01,185172,Staff,0,14,38,38
1683643227495,COGS 18,A01,184736,Staff,15,0,80,65
1683643228526,COGS 100,A01,184932,Staff,0,7,73,73
1683643229555,COGS 101A,A01,184935,Staff,0,39,30,30
1683643230583,COGS 101B,A01,184944,Staff,0,2,30,30
1683643231615,COGS 101C,A01,184946,Staff,0,10,30,30
1683643232645,COGS 102A,A01,184951,Johnson; Christine M.,2,0,40,38
1683643233676,COGS 107B,A01,184953,Mooshagian; Eric Frederick,0,51,40,40
1683643234702,COGS 118B,A01,184959,Gupta; Anjum,0,49,40,40
1683643235728,COGS 153,A00,184961,Staff,0,16,30,30
1683643236757,COGS 177,A00,184962,Staff,0,21,30,30
1683643237782,COGS 187A,A01,184969,Boyle; Mary E. T.,0,19,40,40
1683643238810,COMM 10,A01,185174,Staff,0,5,25,25
1683643238810,COMM 10,A02,185189,Staff,0,2,25,25
1683643238810,COMM 10,A03,269821,Staff,0,1,0,0
1683643239837,COMM 100B,A01,185475,Staff,0,1,0,2
1683643239837,COMM 100B,A02,185476,Staff,12,0,25,13
1683643240861,COMM 100C,A01,185314,Staff,1,0,25,24
1683643240861,COMM 100C,A02,185327,Staff,18,0,25,7
1683643241889,COMM 110M,A00,185349,Staff,0,0,40,40
1683643242918,COMM 113T,A00,185352,Staff,25,0,40,15
1683643243944,COMM 114I,A00,185353,Staff,31,0,40,9
1683643244969,COMM 131,A00,185354,Staff,17,0,30,13
1683643245999,CSE 8A,A50,185358,Cao; Yingjun,0,46,10,10
1683643247025,CSE 8B,A01,185362,Staff,0,48,50,50
1683643248054,CSE 11,A01,185416,Cao; Yingjun,0,91,10,10
1683643249080,CSE 20,A01,185445,Briones; Jor-el Thomas Caparas,4,0,25,21
1683643250109,CSE 21,A01,185447,Staff,9,0,50,41
1683643251136,CSE 101,A01,185451,Staff,0,13,50,50
1683643251136,CSE 101,B01,185453,Jones; Miles E,0,13,50,50
1683643253194,CSE 141,A01,185458,Eldon; John,15,0,100,85
1683643254218,CSE 141L,A01,185461,Eldon; John,7,0,100,93
1683643255242,CSE 142,A01,185463,Staff,36,0,60,24
1683643255242,CSE 142,B01,201355,Staff,0,7,60,60
1683643256267,CSE 142L,A01,185470,Staff,36,0,60,24
1683643256267,CSE 142L,B01,201417,Staff,0,6,60,60
1683643257296,CSE 190,A00,201433,Staff,32,0,49,17
1683643258330,DOC 1,A01,259136,Strom; Megan C.,7,0,15,8
1683643258330,DOC 1,A02,259137,Strom; Megan C.,14,0,15,1
1683643258330,DOC 1,A03,259138,Strom; Megan C.,14,0,15,1
1683643258330,DOC 1,A04,259139,Strom; Megan C.,14,0,15,1
1683643259356,DOC 100D,A00,259140,Pass; Natalye Joann,14,0,25,11
1683643260389,DSGN 1,A01,184749,Rill; Bryan,0,26,30,30
1683643261415,DSGN 100,A01,185168,Staff,0,2,25,25
1683643262443,ECE 5,A01,185626,Morris; Karcher William,0,11,0,0
1683643263472,ECE 101,A01,185628,Staff,14,0,70,56
1683643264502,ECE 107,A01,185635,Baghdadchi; Saharnaz,0,0,20,20
1683643264502,ECE 107,A02,185638,Baghdadchi; Saharnaz,3,0,20,17
1683643265526,ECE 148,A01,185647,Silberman; Jack,0,0,16,16
1683643266554,ECON 1,A01,185537,Crane; Meredith Helen,54,0,70,16
1683643267581,ECON 3,A01,185549,Crane; Meredith Helen,29,0,70,41
1683643268607,ECON 4,A01,203354,Anderson; John Charles,0,5,10,10
1683643269635,ECON 100A,A01,185574,Staff,0,5,40,40
1683643270661,ECON 100B,A01,185576,Staff,0,12,50,50
1683643271697,ECON 100C,A01,185589,Newhouse; Herbert S,30,0,70,40
1683643272722,ECON 105,A00,185608,Vespa; Emanuel Ignacio,19,0,35,16
1683643273748,ECON 109,A01,185610,Shishkin; Denis,9,0,35,26
1683643274778,ECON 110A,A01,185612,Staff,9,0,40,31
1683643275802,ECON 120A,A01,185615,Staff,20,0,40,20
1683643276828,ECON 120C,A01,185617,Sun; Yixiao,0,20,70,70
1683643277856,ECON 144,A00,203346,Squires; Dale E,2,0,35,33
1683643278887,ECON 171,A01,203349,Newhouse; Herbert S,0,1,35,35
1683643279916,ECON 173A,A01,185621,Toda; Alexis Akira,21,0,35,14
1683643280943,EDS 25,A01,202413,Staff,0,1,0,0
1683643280943,EDS 25,A02,202414,Staff,0,1,0,0
1683643280943,EDS 25,A03,202415,Staff,0,0,0,0
1683643280943,EDS 25,A04,202416,Staff,0,1,0,0
1683643280943,EDS 25,A05,202439,Staff,0,0,0,0
1683643280943,EDS 25,A06,202440,Staff,0,0,0,0
1683643280943,EDS 25,B01,202631,Staff,0,0,0,0
1683643280943,EDS 25,B02,202632,Staff,0,0,0,0
1683643280943,EDS 25,B03,202639,Staff,0,0,0,0
1683643280943,EDS 25,B04,202640,Staff,0,0,0,0
1683643280943,EDS 25,B05,202643,Staff,0,0,0,0
1683643280943,EDS 25,B06,202644,Staff,0,0,0,0
1683643281981,EDS 38,A01,202659,Black; Alison Michelle,24,0,25,1
1683643283006,EDS 115,A00,202652,Staff,18,0,30,12
1683643284031,EDS 125,A00,202649,Staff,13,0,30,17
1683643285059,EDS 126,A01,203332,Staff,30,0,30,0
1683643286083,EDS 139,A00,202838,Staff,16,0,25,9
1683643287110,EDS 146,A01,202655,Staff,14,0,25,11
1683643288133,ENG 15,A00,185667,Staff,0,1,0,0
1683643288133,ENG 15,B00,185672,Staff,0,0,0,0
1683643288133,ENG 15,C00,185675,Staff,0,0,0,0
1683643288133,ENG 15,D00,185682,Staff,0,0,0,0
1683643288133,ENG 15,E00,185684,Staff,0,0,0,0
1683643289157,ETHN 103,A00,185710,Staff,0,8,35,35
1683643290186,ETHN 103A,A00,199228,Man; Simeon S,0,0,9,9
1683643291212,ETHN 109,A00,185711,Staff,16,0,35,19
1683643292244,ETHN 142,A00,185726,Staff,0,4,30,30
1683643293269,ETHN 163J,A00,199229,Man; Simeon S,5,0,8,3
1683643294296,ETHN 168,A00,185727,Staff,7,0,10,3
1683643295323,ETHN 182,A00,185728,Staff,0,0,35,35
1683643296352,ETHN 183,A00,185737,Staff,9,0,18,9
1683643297378,GLBH 111,A01,209361,Burgos; Jose L.,0,0,0,0
1683643299430,HIEU 104,A00,185792,Staff,14,0,20,6
1683643300455,HIEU 115,A00,185800,Staff,0,0,20,20
1683643301484,HIEU 128,A00,185801,Staff,0,9,20,20
1683643302511,HIEU 147,A00,185802,Staff,15,0,20,5
1683643303538,HIEU 154,A00,185823,Staff,11,0,20,9
1683643304563,HILA 102,A00,185826,Staff,14,0,20,6
1683643305594,HILD 2C,A01,185778,Staff,0,13,20,20
1683643306625,HILD 7B,A01,185780,Kwak; Nancy,0,16,32,32
1683643306625,HILD 7B,A02,185781,Kwak; Nancy,0,18,32,32
1683643307651,HILD 30,A01,185791,Staff,12,0,20,8
1683643308675,HISC 119,A00,185830,Golan; Tal,0,9,20,20
1683643309703,HITO 156GS,A00,185831,Patterson; Patrick H.,0,0,0,23
1683643310731,HIUS 103,A00,185832,Man; Simeon S,0,4,20,20
1683643311756,HIUS 117,A00,185836,Kwak; Nancy,2,0,20,18
1683643312841,HIUS 125,A00,185840,Man; Simeon S,0,1,23,23
1683643313864,HIUS 149,A00,185845,Staff,1,0,20,19
1683643314891,HUM 3,A01,185882,Zavodny; Tatiana Sophia,0,7,50,50
1683643314891,HUM 3,B01,185899,Caldwell; Michael Alan,0,18,50,50
1683643315917,HUM 3GS,A00,185900,Patterson; Patrick H.,0,0,0,23
1683643316944,HUM 4,A01,185938,Zroka; Amy Liane,30,0,50,20
1683643316944,HUM 4,B01,185956,Watkins; Eric,0,4,50,50
1683643316944,HUM 4,B02,202209,Watkins; Eric,0,4,50,50
1683643316944,HUM 4,B03,202210,Watkins; Eric,0,4,50,50
1683643317970,HUM 5,A01,185958,West; Geoffrey Scott,2,0,50,48
1683643317970,HUM 5,A02,202215,West; Geoffrey Scott,0,0,50,50
1683643318996,INTL 190,A00,185959,Gagnon; Jeffrey C,0,0,0,9
1683643318996,INTL 190,B00,185960,Lettieri; Michael Joseph,0,0,0,2
1683643320021,JAPN 180,A00,254509,Staff,5,0,30,25
1683643321052,LATI 10,A01,202853,Kennemore; Amy Michelle,4,0,35,31
1683643321052,LATI 10,A02,202854,Kennemore; Amy Michelle,2,0,35,33
1683643321052,LATI 10,A03,270054,Kennemore; Amy Michelle,30,0,30,0
1683643322089,LATI 180,A00,202855,Kennemore; Amy Michelle,11,0,20,9
1683643323119,LAWS 101,A00,201767,Golan; Tal,0,7,40,40
1683643324145,LIFR 1C,A00,185961,Staff,6,0,20,14
1683643325174,LIFR 1CX,A00,185962,Staff,7,0,20,13
1683643326204,LIFR 1D,A00,185963,Staff,7,0,20,13
1683643327232,LIFR 1DX,A00,185964,Staff,7,0,20,13
1683643328261,LIGN 101,A01,186039,Staff,43,0,50,7
1683643329286,LIGN 165,A00,186040,Staff,15,0,50,35
1683643330314,LTCS 108,A00,186041,Staff,5,0,10,5
1683643331341,LTCS 119,A00,186042,Staff,15,0,20,5
1683643332366,LTCS 130,A00,186043,Wesling; Megan E.,15,0,25,10
1683643334421,LTEA 138,A00,186119,Staff,14,0,40,26
1683643335449,LTEN 124,A00,186148,Staff,5,0,25,20
1683643336477,LTEN 178,A00,186149,Staff,7,0,15,8
1683643337502,LTEN 181,A00,186150,Blanco; John D,34,0,40,6
1683643338526,LTWL 120,A00,186160,Staff,20,0,25,5
1683643339550,LTWL 165,A00,186161,Staff,22,0,25,3
1683643340575,LTWR 100,A00,186162,Staff,0,5,15,15
1683643341598,LTWR 102,A00,186163,Doller; Ben,5,0,15,10
1683643342624,MAE 8,A01,186412,Staff,0,0,0,0
1683643343653,MAE 30B,A00,186445,Bahadori; Mohammad Yousef,82,0,100,18
1683643344682,MAE 40,A00,186592,Bewley; Thomas R,10,0,50,40
1683643345708,MAE 101B,A00,186593,Bahadori; Mohammad Yousef,80,0,100,20
1683643346733,MAE 105,A00,186594,Bandaru; Prabhakar,10,0,50,40
1683643347759,MAE 107,A00,186599,Pham; Hieu Tan,0,7,120,120
1683643348789,MAE 148,A01,186660,Silberman; Jack,3,0,16,13
1683643349813,MATH 10A,A01,188095,Staff,0,5,35,35
1683643350843,MATH 10B,A01,188097,Bowers; Adam R.,0,11,30,30
1683643350843,MATH 10B,A02,188099,Bowers; Adam R.,0,11,30,30
1683643350843,MATH 10B,B01,188104,Bowers; Adam R.,0,10,30,30
1683643350843,MATH 10B,B02,188106,Bowers; Adam R.,1,9,30,29
1683643351869,MATH 10C,A01,188111,Staff,0,18,30,30
1683643351869,MATH 10C,A02,188127,Staff,0,19,30,30
1683643351869,MATH 10C,A03,188131,Staff,0,19,30,30
1683643351869,MATH 10C,B01,188218,Staff,17,0,30,13
1683643351869,MATH 10C,B02,188244,Staff,13,0,30,17
1683643351869,MATH 10C,B03,188277,Staff,14,0,30,16
1683643352894,MATH 18,A01,188344,Bach; Quang Tran,18,0,30,12
1683643352894,MATH 18,A02,188345,Bach; Quang Tran,11,0,30,19
1683643352894,MATH 18,B01,188353,Bach; Quang Tran,11,0,30,19
1683643352894,MATH 18,B02,188354,Bach; Quang Tran,19,0,30,11
1683643353921,MATH 20A,A01,188374,Staff,11,0,35,24
1683643354947,MATH 20B,A01,188382,Ohm; Ko Woon,7,0,30,23
1683643354947,MATH 20B,A02,188383,Ohm; Ko Woon,22,0,30,8
1683643354947,MATH 20B,B01,188385,Ohm; Ko Woon,7,0,30,23
1683643354947,MATH 20B,B02,188392,Ohm; Ko Woon,22,0,30,8
1683643355973,MATH 20C,A01,188394,Harel; Guershon,11,0,30,19
1683643355973,MATH 20C,A02,188395,Harel; Guershon,14,0,30,16
1683643355973,MATH 20C,B01,188404,Harel; Guershon,4,0,30,26
1683643355973,MATH 20C,B02,188405,Harel; Guershon,18,0,30,12
1683643357000,MATH 20D,A01,188414,Hammock; Frances H,0,1,30,30
1683643357000,MATH 20D,A02,188415,Hammock; Frances H,0,1,30,30
1683643357000,MATH 20D,B01,188447,Hammock; Frances H,0,1,30,30
1683643357000,MATH 20D,B02,188486,Hammock; Frances H,4,0,30,26
1683643358026,MATH 20E,A01,188649,Staff,21,0,30,9
1683643358026,MATH 20E,A02,188650,Staff,21,0,30,9
1683643358026,MATH 20E,A03,188673,Staff,0,0,30,30
1683643359050,MATH 102,A01,188675,Staff,0,36,35,35
1683643360076,MATH 103B,A01,188681,Staff,3,0,35,32
1683643360076,MATH 103B,B01,188692,Staff,5,0,35,30
1683643361102,MATH 109,A01,188695,Salehi Golsefidy; Alireza,24,0,35,11
1683643361102,MATH 109,A02,188696,Salehi Golsefidy; Alireza,25,0,35,10
1683643362128,MATH 120A,A01,188698,Eggers; John Dietrich,7,0,35,28
1683643363158,MATH 142B,A01,188736,Ioana; Adrian,0,1,30,30
1683643363158,MATH 142B,A02,188741,Ioana; Adrian,0,1,30,30
1683643363158,MATH 142B,A03,188743,Ioana; Adrian,0,1,30,30
1683643364183,MATH 168A,A01,188790,Staff,0,10,35,35
1683643365208,MATH 170A,A01,188803,Nie; Jiawang,0,2,35,35
1683643365208,MATH 170A,A02,188811,Nie; Jiawang,0,0,35,35
1683643365208,MATH 170A,A03,188814,Nie; Jiawang,0,0,35,35
1683643365208,MATH 170A,A04,188815,Nie; Jiawang,10,0,35,25
1683643366235,MATH 193B,A01,188817,Staff,0,0,35,35
1683643366235,MATH 193B,A02,188818,Staff,5,0,35,30
1683643367258,MGT 4,A01,202857,Anderson; John Charles,61,0,80,19
1683643368281,MGT 12,A00,202858,Lindenberger; Wade Douglas,40,0,90,50
1683643369306,MGT 18,A00,202859,Staff,74,0,90,16
1683643370330,MGT 18GS,A00,202860,McKay; Michael J,13,0,28,15
1683643371355,MGT 45,A00,202861,Pecore; Joseph P.,12,0,90,78
1683643372380,MGT 100,A00,202863,Yavorsky; Daniel Ryan,28,0,90,62
1683643373409,MGT 103,A00,202864,Ehrich; Kristine R,0,17,90,90
1683643374433,MGT 112,A00,202865,Ehrich; Kristine R,15,0,90,75
1683643375457,MGT 121A,A00,202868,Staff,0,20,0,0
1683643376482,MGT 131B,A00,202869,Anderson; John Charles,59,0,90,31
1683643377506,MGT 136,A00,202871,Lindenberger; Wade Douglas,83,0,90,7
1683643378531,MGT 164,A00,202873,Staff,0,66,90,91
1683643379559,MGT 164GS,A00,202874,McKay; Mary A,13,0,28,15
1683643380583,MGT 180,A00,202875,Staff,0,50,90,91
1683643381613,MMW 11R,A01,205019,Herbst; Matthew,2,0,30,28
1683643381613,MMW 11R,A02,205026,Herbst; Matthew,29,0,30,1
1683643382639,MMW 15,A01,193512,Chang; Edmond Yi-Teh,0,8,28,28
1683643382639,MMW 15,A02,193513,Chang; Edmond Yi-Teh,0,5,28,28
1683643382639,MMW 15,A03,193514,Chang; Edmond Yi-Teh,0,5,28,28
1683643382639,MMW 15,A04,193515,Chang; Edmond Yi-Teh,0,5,28,28
1683643382639,MMW 15,A05,193516,Chang; Edmond Yi-Teh,0,5,28,28
1683643382639,MMW 15,A06,193517,Chang; Edmond Yi-Teh,0,6,28,28
1683643382639,MMW 15,B01,193519,Chang; Edmond Yi-Teh,0,5,28,28
1683643382639,MMW 15,B02,193520,Chang; Edmond Yi-Teh,0,5,28,28
1683643382639,MMW 15,B03,193521,Chang; Edmond Yi-Teh,0,5,28,28
1683643382639,MMW 15,B04,193522,Chang; Edmond Yi-Teh,0,5,28,28
1683643382639,MMW 15,B05,193523,Chang; Edmond Yi-Teh,0,5,28,28
1683643382639,MMW 15,B06,193524,Chang; Edmond Yi-Teh,0,5,28,28
1683643383665,MMW 122,A01,193526,Rahimi; Babak,0,16,28,28
1683643383665,MMW 122,A02,193527,Rahimi; Babak,0,15,28,28
1683643383665,MMW 122,A03,193528,Rahimi; Babak,0,0,0,0
1683643383665,MMW 122,A04,193529,Rahimi; Babak,0,0,0,0
1683643384694,MUS 1A,A01,186663,Staff,1,20,35,34
1683643385721,MUS 4,A01,186715,Staff,0,12,35,35
1683643386750,MUS 5R,A01,186796,Dubnov; Shlomo,0,17,35,35
1683643387777,MUS 6,A01,186798,Staff,0,5,25,25
1683643388806,MUS 7,A01,186830,Staff,11,0,35,24
1683643389831,MUS 8,A01,186930,Staff,0,26,35,35
1683643390861,MUS 15,A01,186932,Staff,0,16,35,35
1683643390861,MUS 15,B01,186934,Staff,0,17,35,35
1683643391887,MUS 80,A00,186935,Staff,0,0,20,20
1683643391887,MUS 80,B00,186936,Staff,24,0,25,1
1683643392920,NANO 11,A00,204702,Lipomi; Darren John,0,0,0,0
1683643393949,NANO 15,A01,204709,Yang; Kesong,0,1,0,0
1683643394974,NANO 114,A00,202069,Jahed Motlagh; Zeinab,3,0,10,7
1683643396004,PHIL 1,A00,186955,Grush; Rick Scott,31,0,40,9
1683643397030,PHIL 10,A01,186973,Grush; Rick Scott,27,0,35,8
1683643397030,PHIL 10,A02,186974,Grush; Rick Scott,33,0,35,2
1683643398058,PHIL 13,A01,186976,Staff,3,0,35,32
1683643398058,PHIL 13,A02,186977,Staff,16,0,35,19
1683643399083,PHIL 14,A01,186979,Staff,31,0,35,4
1683643399083,PHIL 14,A02,186986,Staff,32,0,35,3
1683643400108,PHIL 28,A01,186988,Staff,16,0,30,14
1683643400108,PHIL 28,A02,186989,Staff,1,0,30,29
1683643400108,PHIL 28,A03,186990,Staff,10,0,30,20
1683643400108,PHIL 28,A04,186991,Staff,26,0,30,4
1683643401133,PHIL 120,A00,186997,Staff,23,0,40,17
1683643402158,PHIL 137,A00,187003,Staff,7,0,40,33
1683643403184,PHIL 150,A00,187015,Staff,47,0,70,23
1683643404216,PHIL 167,A00,187021,Lamey; Andy M.,34,0,40,6
1683643405242,PHIL 174,A01,202226,Staff,17,0,20,3
1683643405242,PHIL 174,A02,202235,Staff,20,0,20,0
1683643406270,PHIL 191A,A00,258918,Staff,0,0,1,1
1683643407298,PHYS 1A,A00,187028,Staff,27,0,60,33
1683643408327,PHYS 1AL,001,187036,Staff,3,0,30,27
1683643408327,PHYS 1AL,002,187049,Staff,18,0,30,12
1683643409352,PHYS 1B,A00,187058,Staff,22,0,60,38
1683643410378,PHYS 1BL,001,187064,Staff,0,1,30,30
1683643410378,PHYS 1BL,002,187070,Staff,4,0,30,26
1683643411407,PHYS 1C,A00,187082,Staff,29,0,120,91
1683643412438,PHYS 1CL,001,187088,Staff,0,9,30,30
1683643412438,PHYS 1CL,002,187089,Staff,0,1,30,30
1683643412438,PHYS 1CL,009,262693,Staff,9,0,30,21
1683643413463,PHYS 2B,A01,187097,Staff,55,0,115,60
1683643414492,PHYS 2C,A01,187099,Staff,64,0,115,51
1683643415524,PHYS 2CL,A01,187101,Staff,5,0,28,23
1683643415524,PHYS 2CL,A02,187102,Staff,15,0,28,13
1683643416618,PHYS 2D,A01,187123,Shotwell; Brian,95,0,115,20
1683643417643,PHYS 4B,A01,187133,Grinstein; Benjamin,35,0,50,15
1683643418668,POLI 10,A00,188819,Staff,0,4,50,50
1683643419696,POLI 11,A00,188827,Staff,43,0,50,7
1683643420724,POLI 13R,A00,188828,Staff,0,1,20,20
1683643421751,POLI 27,A01,188830,Elgin; Samuel Zincke,0,2,70,70
1683643422779,POLI 30,A00,188832,Desposato; Scott,30,0,50,20
1683643423809,POLI 102F,A00,188834,Staff,0,0,40,40
1683643424835,POLI 104A,A00,188852,Staff,13,0,30,17
1683643425858,POLI 104I,A00,188853,Staff,0,7,20,20
1683643426886,POLI 110B,A00,188854,Wiens; David,7,0,20,13
1683643427912,POLI 112A,A00,188855,Wiens; David,4,0,30,26
1683643428936,POLI 117R,A00,188856,Forman; Fonna,0,12,20,20
1683643429964,POLI 118,A00,188857,Ingham; Sean,8,0,20,12
1683643430989,POLI 120G,A00,188858,Staff,8,0,30,22
1683643432018,POLI 131CR,A00,188863,Hoston; Germaine,21,0,50,29
1683643433046,POLI 133,A00,188864,Nellis; Gareth Hb,44,0,50,6
1683643434069,POLI 134D,A00,188865,Desposato; Scott,27,0,30,3
1683643435096,POLI 142A,A00,188871,Gartzke; Erik,21,0,50,29
1683643436124,POLI 142K,A00,188874,Staff,38,0,50,12
1683643437151,POLI 143,A00,188940,Gartzke; Erik,16,0,30,14
1683643438175,POLI 153,A00,188943,Staff,2,0,20,18
1683643439201,POLI 160AA,A00,188944,Staff,11,0,40,29
1683643440226,POLI 170A,A00,188945,Staff,11,0,30,19
1683643442275,PSYC 1,A00,188952,Staff,36,0,90,54
1683643443301,PSYC 2,B00,188953,Staff,19,0,35,16
1683643444327,PSYC 6,A00,188970,Staff,47,0,60,13
1683643445351,PSYC 7,A00,188973,Staff,35,0,45,10
1683643446378,PSYC 60,A01,188980,Rickard; Timothy C.,42,0,60,18
1683643447402,PSYC 70,A01,189001,Steiner; Eric Tomas,23,0,45,22
1683643448427,PSYC 100,A00,189005,Lacefield; Katharine I,0,99,120,120
1683643449453,PSYC 102,A00,189008,Staff,8,0,30,22
1683643450478,PSYC 106,B00,189026,Gorman; Michael R.,27,0,60,33
1683643451508,PSYC 114,B01,189033,Winkielman; Piotr,0,31,30,30
1683643452533,PSYC 131,A00,189036,Anagnostaras; Stephan,0,43,60,60
1683643453557,PSYC 136,A00,189041,Lowe; Angela Beth,0,7,25,25
1683643454580,PSYC 137,A00,189057,Winkielman; Piotr,0,37,25,25
1683643455603,PSYC 144,A00,189107,Wixted; John T,0,10,50,50
1683643457657,PSYC 162,A00,189142,Staff,0,9,85,85
1683643458681,PSYC 172,A00,189144,Gorman; Michael R.,0,6,30,30
1683643460733,PSYC 179,A00,189146,Lacefield; Katharine I,0,86,120,120
1683643461758,PSYC 181,A00,189147,Anagnostaras; Stephan,0,44,90,90
1683643462781,PSYC 190R,A00,189148,Barner; David A.,0,23,80,80
1683643463811,PSYC 191,A00,189275,Rickard; Timothy C.,0,10,25,25
1683643464839,PSYC 193,A00,189276,Chapman; Eddie Nathaniel,0,1,0,4
1683643465864,PSYC 193L,A01,189281,Lowe; Angela Beth,10,0,20,10
1683643465864,PSYC 193L,B01,189285,Staff,28,0,35,7
1683643466888,RELI 149,A00,187137,Rahimi; Babak,7,0,40,33
1683643467913,SE 9,A01,187315,Staff,0,2,18,18
1683643468943,SE 101B,A00,187409,Staff,24,0,30,6
1683643469968,SE 110B,A00,187444,Staff,10,0,40,30
1683643470997,SE 130B,A00,187449,Staff,31,0,40,9
1683643472022,SE 150A,A00,187516,Staff,9,0,20,11
1683643473048,SE 154,A00,187528,Staff,29,0,50,21
1683643474075,SIO 3,A01,258171,Staff,35,0,40,5
1683643475099,SIO 10,A00,187144,Cook; Geoffrey W,0,6,75,75
1683643476124,SIO 45,A00,187152,Cook; Geoffrey W,0,4,100,100
1683643477149,SIO 109R,A00,194486,Staff,0,4,20,20
1683643479199,SIO 187,A01,187233,Kacev; David,12,0,40,28
1683643480227,SOCI 1,A01,258656,Thorpe; Charles Robert,28,0,30,2
1683643480227,SOCI 1,A02,258658,Thorpe; Charles Robert,30,0,30,0
1683643480227,SOCI 1,A03,258661,Thorpe; Charles Robert,25,0,25,0
1683643480227,SOCI 1,A04,258666,Thorpe; Charles Robert,22,0,25,3
1683643480227,SOCI 1,A05,258897,Thorpe; Charles Robert,22,0,25,3
1683643480227,SOCI 1,A06,258898,Thorpe; Charles Robert,25,0,25,0
1683643481253,SOCI 30,A01,258903,Pardo Guerra; Juan Pablo,14,0,30,16
1683643482278,SOCI 102,A00,258904,Staff,9,0,25,16
1683643483302,SOCI 106,A00,258905,Staff,19,0,25,6
1683643484325,SOCI 111,A00,258907,Ribas Norris; Janet Vanesa,26,0,30,4
1683643485353,SOCI 121R,A00,258908,Pardo Guerra; Juan Pablo,8,0,30,22
1683643486381,SOCI 126,A01,203330,Staff,14,0,20,6
1683643487407,SOCI 131,A00,258909,Thorpe; Charles Robert,30,0,60,30
1683643488437,SOCI 135,A00,258910,Payne; Christine Anna,0,11,30,30
1683643489462,SOCI 157,A00,258911,Staff,12,0,30,18
1683643490488,SOCI 184,A00,258912,Staff,25,0,30,5
1683643491515,SOCI 188D,A00,258913,Staff,22,0,30,8
1683643492544,SYN 2,001,187529,Staff,9,0,16,7
1683643492544,SYN 2,002,201452,Staff,0,20,16,16
1683643492544,SYN 2,003,201469,Staff,2,0,16,14
1683643493568,SYN 100,A01,187531,Staff,0,9,20,20
1683643493568,SYN 100,B01,201491,Staff,0,10,20,20
1683643494595,TDAC 1,A00,189286,Walsh; Kim C.,3,0,20,17
1683643494595,TDAC 1,B00,189287,Harting; Carla Kelso,10,0,20,10
1683643495622,TDAC 101,A00,189300,Walsh; Kim C.,16,0,20,4
1683643495622,TDAC 101,B00,189301,Harting; Carla Kelso,18,0,20,2
1683643496650,TDAC 102,A00,189304,Basso; Beatrice,14,0,20,6
1683643497693,TDAC 108,A00,189305,Staff,18,0,20,2
1683643498727,TDDE 131,A00,189310,Staff,19,0,20,1
1683643498727,TDDE 131,B00,189314,Staff,19,0,20,1
1683643498727,TDDE 131,C00,189315,Staff,48,0,50,2
1683643498727,TDDE 131,D00,189316,Staff,14,0,15,1
1683643498727,TDDE 131,E00,204841,Staff,20,0,20,0
1683643499753,TDGE 10,A00,189289,Staff,27,0,50,23
1683643499753,TDGE 10,B00,189290,Havis; Allan,0,0,50,50
1683643500781,TDGE 11,A00,189291,Fulton; Julia,0,4,50,50
1683643500781,TDGE 11,B00,189292,Staff,20,0,25,5
1683643500781,TDGE 11,C00,260270,Staff,0,0,0,0
1683643501808,TDGE 25,A00,189294,Staff,2,0,20,18
1683643502836,TDGE 124,A00,189318,Fulton; Julia,0,8,50,50
1683643503861,TDGE 125,A00,189319,Staff,13,0,25,12
1683643503861,TDGE 125,B00,189320,Staff,23,0,25,2
1683643504885,TDGE 127,A00,189322,Havis; Allan,0,0,50,50
1683643505910,TDHT 101,A00,189323,Staff,18,0,25,7
1683643505910,TDHT 101,B00,189324,Staff,25,0,25,0
1683643506939,TDHT 102,A00,189325,Staff,49,0,50,1
1683643507965,TDMV 1,A00,189295,Arcidiacono; Kristin,20,0,30,10
1683643507965,TDMV 1,B00,189296,Caligagan; Maria T.,24,0,30,6
1683643508990,TDMV 2,A00,189297,Sammartano; Tonnie,27,0,30,3
1683643508990,TDMV 2,B00,189299,Arcidiacono; Kristin,23,0,30,7
1683643510016,TDMV 3,A00,204998,Rincon; Alicia,22,0,30,8
1683643511041,TDMV 120,A00,189458,Sammartano; Tonnie,28,0,30,2
1683643512069,TDMV 138,A00,189541,Jun; Grace Shin Hae,20,0,40,20
1683643513097,TDMV 142,A00,189717,Caligagan; Tony,25,0,30,5
1683643513097,TDMV 142,B00,189718,Caligagan; Maria T.,25,0,30,5
1683643514123,TMC 2,A01,187533,Staff,25,0,25,0
1683643514123,TMC 2,A02,187534,Staff,25,0,25,0
1683643515148,USP 1,A01,187536,Kwak; Nancy,0,16,25,25
1683643516172,USP 5,A01,187538,Staff,9,0,25,16
1683643517201,USP 101,A00,199253,Staff,0,4,0,0
1683643518226,USP 124,A00,187562,Boomhower; Matthew Charles,0,0,30,30
1683643519250,USP 138,A00,187582,Staff,20,0,25,5
1683643520333,USP 152,A01,187597,Staff,3,0,25,22
1683643521359,USP 153,A00,187598,Staff,19,0,25,6
1683643522385,USP 168,A00,187607,Kwak; Nancy,2,0,5,3
1683643523413,USP 173,A00,187619,Staff,4,0,25,21
1683643524440,USP 181,A00,187638,Staff,0,4,25,25
1683643525469,VIS 103,A00,187650,Cruz; Edwin Teddy,18,0,75,57
1683643526496,VIS 110D,A00,187669,Staff,13,0,22,9
1683643527521,VIS 127C,A00,187720,Shen; Kuiyi,67,0,146,79
1683643528549,VIS 149,A00,187731,Yoldas; Pinar,0,14,22,22
1683643529582,VIS 151,A01,188091,Staff,22,0,34,12
1683643529582,VIS 151,A02,188092,Staff,11,0,34,23
1683643530609,VIS 160B,A00,188093,Stalbaum; Brett,0,1,10,10
1683643532657,WCWP 10B,A00,201720,Staff,10,0,15,5
1683643532657,WCWP 10B,B00,201722,Staff,9,0,15,6
1683643533682,WCWP 100,A00,201725,Gagnon; Jeffrey C,0,0,2,2
1683643533682,WCWP 100,B00,201727,Staff,0,4,15,15
1683643536874,ANBI 133,A00,258401,Wilder; Linnea Lorene,34,0,40,6
1683643537903,ANBI 140,A00,258395,Hrvoj Mihic; Branka,18,0,25,7
1683643538934,ANSC 120,A00,258402,Bialecki; Jon Anthony,27,0,40,13
1683643539958,ANSC 144,A00,258400,Staff,12,0,40,28
1683643542013,ANSC 166,A00,258396,Parish; Steven Martin,156,0,175,19
1683643543039,ANSC 180,A00,193533,Staff,8,0,20,12
1683643544067,ANSC 188,A00,258397,Jassal; Aftab,34,0,40,6
1683643545093,ANTH 3,A01,258316,Staff,23,0,30,7
1683643546123,ANTH 5,A00,258394,Semendeferi; Ekaterini,16,0,20,4
1683643547150,ANTH 21,A01,258331,Staff,4,0,40,36
1683643548178,ANTH 103,A00,258398,Varma; Saiba,15,0,25,10
1683643549205,AWP 10,001,202034,Staff,0,0,0,0
1683643549205,AWP 10,002,202035,Staff,0,0,0,0
1683643549205,AWP 10,003,202036,Staff,0,0,0,0
1683643549205,AWP 10,004,202037,Staff,0,0,0,0
1683643549205,AWP 10,005,202038,Staff,0,0,0,0
1683643549205,AWP 10,006,202039,Staff,0,0,0,0
1683643549205,AWP 10,007,202040,Staff,0,0,0,0
1683643549205,AWP 10,008,202041,Staff,0,0,0,0
1683643549205,AWP 10,009,202042,Staff,0,0,0,0
1683643549205,AWP 10,010,202043,Staff,0,0,0,0
1683643549205,AWP 10,011,202044,Staff,0,0,0,0
1683643549205,AWP 10,012,202045,Staff,0,0,0,0
1683643549205,AWP 10,013,202046,Staff,0,0,0,0
1683643549205,AWP 10,014,202047,Staff,0,0,0,0
1683643549205,AWP 10,015,202048,Staff,0,0,0,0
1683643549205,AWP 10,016,202049,Staff,0,0,0,0
1683643549205,AWP 10,017,202050,Staff,0,0,0,0
1683643549205,AWP 10,018,202051,Staff,0,0,0,0
1683643549205,AWP 10,019,202052,Staff,0,0,0,0
1683643549205,AWP 10,020,202053,Staff,0,0,0,0
1683643549205,AWP 10,021,202054,Staff,0,0,0,0
1683643549205,AWP 10,022,202055,Staff,0,0,0,0
1683643549205,AWP 10,023,202056,Staff,0,0,0,0
1683643549205,AWP 10,024,202057,Staff,0,0,0,0
1683643549205,AWP 10,025,202058,Staff,0,0,0,0
1683643549205,AWP 10,026,202059,Staff,0,0,0,0
1683643550230,AWP 102,001,202032,Staff,0,0,0,0
1683643550230,AWP 102,002,202033,Staff,0,0,0,0
1683643551255,BENG 100,A01,254234,Taylor Amos; Alyssa C,31,0,40,9
1683643552281,BENG 196,001,270013,Engler; Adam J.,9999,0,9999,0
1683643553308,BICD 100R,A01,202018,Smith; Laurie,0,7,32,32
1683643553308,BICD 100R,A02,202019,Smith; Laurie,0,3,32,32
1683643553308,BICD 100R,A03,202020,Smith; Laurie,0,1,32,32
1683643553308,BICD 100R,A04,202021,Smith; Laurie,6,0,32,26
1683643553308,BICD 100R,A05,202022,Smith; Laurie,11,0,32,21
1683643554335,BICD 136,A01,193242,Gustafson-Brown; Cindy,0,2,32,32
1683643554335,BICD 136,A02,193244,Gustafson-Brown; Cindy,13,0,32,19
1683643555363,BIEB 102,A01,193249,Butler; Shannon Rhey,0,2,32,32
1683643555363,BIEB 102,A02,193251,Butler; Shannon Rhey,0,0,32,32
1683643555363,BIEB 102,A03,193253,Butler; Shannon Rhey,0,0,32,32
1683643555363,BIEB 102,A04,193255,Butler; Shannon Rhey,14,0,32,18
1683643555363,BIEB 102,A05,193265,Butler; Shannon Rhey,26,0,32,6
1683643555363,BIEB 102,A06,193269,Butler; Shannon Rhey,14,0,32,18
1683643557418,BIEB 150,A01,193274,Staff,0,0,32,32
1683643557418,BIEB 150,A02,193285,Staff,24,0,32,8
1683643558444,BIEB 194,A00,193286,Kurle; Carolyn M.,20,0,32,12
1683643559471,BILD 1,A01,192291,Staff,15,0,32,17
1683643559471,BILD 1,A02,192292,Staff,30,0,32,2
1683643559471,BILD 1,B01,192520,Reuther; Keefe,0,1,0,0
1683643559471,BILD 1,B02,192532,Reuther; Keefe,0,1,0,0
1683643560501,BILD 3,A01,192556,Butler; Shannon Rhey,0,0,32,32
1683643560501,BILD 3,A02,192581,Butler; Shannon Rhey,1,0,32,31
1683643560501,BILD 3,A03,192611,Butler; Shannon Rhey,21,0,32,11
1683643560501,BILD 3,A04,192612,Butler; Shannon Rhey,24,0,32,8
1683643560501,BILD 3,A05,192613,Butler; Shannon Rhey,26,0,32,6
1683643560501,BILD 3,A06,192679,Butler; Shannon Rhey,27,0,32,5
1683643560501,BILD 3,A07,192682,Butler; Shannon Rhey,20,0,32,12
1683643561528,BILD 4,A01,192836,Reuther; Keefe,0,0,24,24
1683643561528,BILD 4,A02,193044,Reuther; Keefe,4,0,24,20
1683643562554,BILD 10,A01,193142,Gustafson-Brown; Cindy,29,0,32,3
1683643562554,BILD 10,A02,193149,Gustafson-Brown; Cindy,31,0,32,1
1683643563579,BIMM 100,A01,193301,Staff,0,6,32,32
1683643563579,BIMM 100,A02,193312,Staff,0,7,32,32
1683643563579,BIMM 100,A03,193323,Staff,0,9,32,32
1683643564611,BIMM 101,A01,193329,McDonnell; Lisa Marie,0,4,24,24
1683643564611,BIMM 101,A02,193339,McDonnell; Lisa Marie,0,3,24,24
1683643564611,BIMM 101,B01,193354,McDonnell; Lisa Marie,0,4,24,24
1683643564611,BIMM 101,B02,193357,McDonnell; Lisa Marie,0,2,24,24
1683643565635,BIMM 110,A01,193377,Tat; John,0,11,32,32
1683643565635,BIMM 110,A02,193378,Tat; John,0,10,32,32
1683643566662,BIMM 120,A01,206116,Staff,0,0,32,32
1683643566662,BIMM 120,A02,206117,Staff,6,0,32,26
1683643566662,BIMM 120,A03,206121,Staff,21,0,32,11
1683643567693,BIPN 100,A01,193393,Park; Ji Young,0,14,32,32
1683643567693,BIPN 100,A02,193402,Park; Ji Young,0,14,32,32
1683643567693,BIPN 100,A03,193413,Park; Ji Young,0,14,32,32
1683643567693,BIPN 100,A04,193414,Park; Ji Young,0,13,32,32
1683643568724,BIPN 102,A01,193429,Staff,0,0,32,32
1683643568724,BIPN 102,A02,193438,Staff,18,0,32,14
1683643569750,BIPN 106,A01,193450,Reyes Gonzalez; Catalina,0,2,40,40
1683643570782,BIPN 134,A01,193465,Cooke; James Edward,0,0,32,32
1683643570782,BIPN 134,A02,193474,Cooke; James Edward,25,0,32,7
1683643570782,BIPN 134,A03,193485,Cooke; James Edward,29,0,32,3
1683643570782,BIPN 134,A04,193486,Cooke; James Edward,20,0,32,12
1683643570782,BIPN 134,A05,193491,Cooke; James Edward,31,0,32,1
1683643570782,BIPN 134,A06,193501,Cooke; James Edward,30,0,32,2
1683643570782,BIPN 134,A07,193510,Cooke; James Edward,29,0,32,3
1683643572841,BISP 194,A00,222522,Staff,14,0,32,18
1683643573866,CAT 124,A01,202407,Staff,19,0,25,6
1683643574897,CAT 125,A00,202408,Marchisotto; Jennifer Anne,2,0,20,18
1683643575923,CAT 125R,A00,202409,Smith; Lauryn Alissa,0,11,20,20
1683643575923,CAT 125R,B00,202410,Morales; Celeste Georgianna,0,11,20,20
1683643575923,CAT 125R,C00,202411,Irwin; Matthew Joseph,0,12,20,20
1683643576951,CENG 15,A01,204712,Yang; Kesong,0,1,0,0
1683643577976,CENG 114,A00,202070,Jahed Motlagh; Zeinab,5,0,20,15
1683643579005,CGS 105,A00,185477,Wesling; Megan E.,24,0,40,16
1683643580037,CGS 106,A00,185494,Staff,11,0,22,11
1683643581065,CGS 108,A00,185495,Staff,14,0,20,6
1683643582091,CGS 114,A00,185496,Staff,13,0,18,5
1683643583117,CGS 119,A00,185501,Staff,15,0,20,5
1683643584143,CGS 120,A00,185511,Staff,12,0,20,8
1683643585167,CHEM 4,A01,184675,Bussey; Thomas J,97,0,100,3
1683643586196,CHEM 6A,A01,184677,Staff,33,0,60,27
1683643587222,CHEM 6B,A01,184679,Staff,63,0,100,37
1683643588250,CHEM 6C,A01,184681,Bussey; Thomas J,0,0,50,50
1683643588250,CHEM 6C,A02,184682,Bussey; Thomas J,32,0,50,18
1683643589274,CHEM 40A,A01,184684,Albizati; Kim F.,35,0,100,65
1683643590299,CHEM 40B,A01,184686,Albizati; Kim F.,0,22,100,100
1683643591324,CHEM 41B,A01,184690,Staff,51,0,100,49
1683643592349,COGS 3,A01,184715,Boyle; Mary E. T.,0,27,40,40
1683643593377,COGS 14B,A01,185172,Staff,0,14,38,38
1683643594402,COGS 18,A01,184736,Staff,15,0,80,65
1683643595428,COGS 100,A01,184932,Staff,0,7,73,73
1683643596453,COGS 101A,A01,184935,Staff,0,39,30,30
1683643597478,COGS 101B,A01,184944,Staff,0,2,30,30
1683643598504,COGS 101C,A01,184946,Staff,0,10,30,30
1683643599534,COGS 102A,A01,184951,Johnson; Christine M.,2,0,40,38
1683643600564,COGS 107B,A01,184953,Mooshagian; Eric Frederick,0,51,40,40
1683643601593,COGS 118B,A01,184959,Gupta; Anjum,0,49,40,40
1683643602618,COGS 153,A00,184961,Staff,0,16,30,30
1683643603644,COGS 177,A00,184962,Staff,0,21,30,30
1683643604669,COGS 187A,A01,184969,Boyle; Mary E. T.,0,19,40,40
1683643605694,COMM 10,A01,185174,Staff,0,5,25,25
1683643605694,COMM 10,A02,185189,Staff,0,2,25,25
1683643605694,COMM 10,A03,269821,Staff,0,1,0,0
1683643606721,COMM 100B,A01,185475,Staff,0,1,0,2
1683643606721,COMM 100B,A02,185476,Staff,12,0,25,13
1683643607746,COMM 100C,A01,185314,Staff,1,0,25,24
1683643607746,COMM 100C,A02,185327,Staff,18,0,25,7
1683643608771,COMM 110M,A00,185349,Staff,0,0,40,40
1683643609795,COMM 113T,A00,185352,Staff,25,0,40,15
1683643610819,COMM 114I,A00,185353,Staff,31,0,40,9
1683643611844,COMM 131,A00,185354,Staff,17,0,30,13
1683643612869,CSE 8A,A50,185358,Cao; Yingjun,0,46,10,10
1683643613896,CSE 8B,A01,185362,Staff,0,48,50,50
1683643614921,CSE 11,A01,185416,Cao; Yingjun,0,91,10,10
1683643615953,CSE 20,A01,185445,Briones; Jor-el Thomas Caparas,4,0,25,21
1683643616982,CSE 21,A01,185447,Staff,9,0,50,41
1683643618009,CSE 101,A01,185451,Staff,0,13,50,50
1683643618009,CSE 101,B01,185453,Jones; Miles E,0,13,50,50
1683643620073,CSE 141,A01,185458,Eldon; John,15,0,100,85
1683643621107,CSE 141L,A01,185461,Eldon; John,7,0,100,93
1683643622136,CSE 142,A01,185463,Staff,36,0,60,24
1683643622136,CSE 142,B01,201355,Staff,0,7,60,60
1683643623164,CSE 142L,A01,185470,Staff,36,0,60,24
1683643623164,CSE 142L,B01,201417,Staff,0,6,60,60
1683643624249,CSE 190,A00,201433,Staff,32,0,49,17
1683643625281,DOC 1,A01,259136,Strom; Megan C.,7,0,15,8
1683643625281,DOC 1,A02,259137,Strom; Megan C.,14,0,15,1
1683643625281,DOC 1,A03,259138,Strom; Megan C.,14,0,15,1
1683643625281,DOC 1,A04,259139,Strom; Megan C.,14,0,15,1
1683643626312,DOC 100D,A00,259140,Pass; Natalye Joann,14,0,25,11
1683643627342,DSGN 1,A01,184749,Rill; Bryan,0,26,30,30
1683643628372,DSGN 100,A01,185168,Staff,0,2,25,25
1683643629399,ECE 5,A01,185626,Morris; Karcher William,0,11,0,0
1683643630427,ECE 101,A01,185628,Staff,14,0,70,56
1683643631456,ECE 107,A01,185635,Baghdadchi; Saharnaz,0,0,20,20
1683643631456,ECE 107,A02,185638,Baghdadchi; Saharnaz,3,0,20,17
1683643632487,ECE 148,A01,185647,Silberman; Jack,0,0,16,16
1683643633512,ECON 1,A01,185537,Crane; Meredith Helen,54,0,70,16
1683643634541,ECON 3,A01,185549,Crane; Meredith Helen,29,0,70,41
1683643635569,ECON 4,A01,203354,Anderson; John Charles,0,5,10,10
1683643636597,ECON 100A,A01,185574,Staff,0,5,40,40
1683643637625,ECON 100B,A01,185576,Staff,0,12,50,50
1683643638655,ECON 100C,A01,185589,Newhouse; Herbert S,30,0,70,40
1683643639681,ECON 105,A00,185608,Vespa; Emanuel Ignacio,19,0,35,16
1683643640707,ECON 109,A01,185610,Shishkin; Denis,9,0,35,26
1683643641736,ECON 110A,A01,185612,Staff,9,0,40,31
1683643642761,ECON 120A,A01,185615,Staff,20,0,40,20
1683643643801,ECON 120C,A01,185617,Sun; Yixiao,0,20,70,70
1683643644833,ECON 144,A00,203346,Squires; Dale E,2,0,35,33
1683643645861,ECON 171,A01,203349,Newhouse; Herbert S,0,1,35,35
1683643646890,ECON 173A,A01,185621,Toda; Alexis Akira,21,0,35,14
1683643647920,EDS 25,A01,202413,Staff,0,1,0,0
1683643647920,EDS 25,A02,202414,Staff,0,1,0,0
1683643647920,EDS 25,A03,202415,Staff,0,0,0,0
1683643647920,EDS 25,A04,202416,Staff,0,1,0,0
1683643647920,EDS 25,A05,202439,Staff,0,0,0,0
1683643647920,EDS 25,A06,202440,Staff,0,0,0,0
1683643647920,EDS 25,B01,202631,Staff,0,0,0,0
1683643647920,EDS 25,B02,202632,Staff,0,0,0,0
1683643647920,EDS 25,B03,202639,Staff,0,0,0,0
1683643647920,EDS 25,B04,202640,Staff,0,0,0,0
1683643647920,EDS 25,B05,202643,Staff,0,0,0,0
1683643647920,EDS 25,B06,202644,Staff,0,0,0,0
1683643648945,EDS 38,A01,202659,Black; Alison Michelle,24,0,25,1
1683643649969,EDS 115,A00,202652,Staff,18,0,30,12
1683643650997,EDS 125,A00,202649,Staff,13,0,30,17
1683643652026,EDS 126,A01,203332,Staff,30,0,30,0
1683643653050,EDS 139,A00,202838,Staff,16,0,25,9
1683643654073,EDS 146,A01,202655,Staff,14,0,25,11
1683643655100,ENG 15,A00,185667,Staff,0,1,0,0
1683643655100,ENG 15,B00,185672,Staff,0,0,0,0
1683643655100,ENG 15,C00,185675,Staff,0,0,0,0
1683643655100,ENG 15,D00,185682,Staff,0,0,0,0
1683643655100,ENG 15,E00,185684,Staff,0,0,0,0
1683643656128,ETHN 103,A00,185710,Staff,0,8,35,35
1683643657156,ETHN 103A,A00,199228,Man; Simeon S,0,0,9,9
1683643658184,ETHN 109,A00,185711,Staff,16,0,35,19
1683643659212,ETHN 142,A00,185726,Staff,0,4,30,30
1683643660239,ETHN 163J,A00,199229,Man; Simeon S,5,0,8,3
1683643661279,ETHN 168,A00,185727,Staff,7,0,10,3
1683643662307,ETHN 182,A00,185728,Staff,0,0,35,35
1683643663334,ETHN 183,A00,185737,Staff,9,0,18,9
1683643664364,GLBH 111,A01,209361,Burgos; Jose L.,0,0,0,0
1683643666414,HIEU 104,A00,185792,Staff,14,0,20,6
1683643667441,HIEU 115,A00,185800,Staff,0,0,20,20
1683643668470,HIEU 128,A00,185801,Staff,0,9,20,20
1683643669496,HIEU 147,A00,185802,Staff,15,0,20,5
1683643670522,HIEU 154,A00,185823,Staff,11,0,20,9
1683643671546,HILA 102,A00,185826,Staff,14,0,20,6
1683643672572,HILD 2C,A01,185778,Staff,0,13,20,20
1683643673596,HILD 7B,A01,185780,Kwak; Nancy,0,16,32,32
1683643673596,HILD 7B,A02,185781,Kwak; Nancy,0,18,32,32
1683643674621,HILD 30,A01,185791,Staff,12,0,20,8
1683643675647,HISC 119,A00,185830,Golan; Tal,0,9,20,20
1683643676673,HITO 156GS,A00,185831,Patterson; Patrick H.,0,0,0,23
1683643677704,HIUS 103,A00,185832,Man; Simeon S,0,4,20,20
1683643678731,HIUS 117,A00,185836,Kwak; Nancy,2,0,20,18
1683643679759,HIUS 125,A00,185840,Man; Simeon S,0,1,23,23
1683643680785,HIUS 149,A00,185845,Staff,1,0,20,19
1683643681817,HUM 3,A01,185882,Zavodny; Tatiana Sophia,0,7,50,50
1683643681817,HUM 3,B01,185899,Caldwell; Michael Alan,0,18,50,50
1683643682842,HUM 3GS,A00,185900,Patterson; Patrick H.,0,0,0,23
1683643683869,HUM 4,A01,185938,Zroka; Amy Liane,30,0,50,20
1683643683869,HUM 4,B01,185956,Watkins; Eric,0,4,50,50
1683643683869,HUM 4,B02,202209,Watkins; Eric,0,4,50,50
1683643683869,HUM 4,B03,202210,Watkins; Eric,0,4,50,50
1683643684894,HUM 5,A01,185958,West; Geoffrey Scott,2,0,50,48
1683643684894,HUM 5,A02,202215,West; Geoffrey Scott,0,0,50,50
1683643685921,INTL 190,A00,185959,Gagnon; Jeffrey C,0,0,0,9
1683643685921,INTL 190,B00,185960,Lettieri; Michael Joseph,0,0,0,2
1683643686950,JAPN 180,A00,254509,Staff,5,0,30,25
1683643687976,LATI 10,A01,202853,Kennemore; Amy Michelle,4,0,35,31
1683643687976,LATI 10,A02,202854,Kennemore; Amy Michelle,2,0,35,33
1683643687976,LATI 10,A03,270054,Kennemore; Amy Michelle,30,0,30,0
1683643689000,LATI 180,A00,202855,Kennemore; Amy Michelle,11,0,20,9
1683643690026,LAWS 101,A00,201767,Golan; Tal,0,7,40,40
1683643691054,LIFR 1C,A00,185961,Staff,6,0,20,14
1683643692078,LIFR 1CX,A00,185962,Staff,7,0,20,13
1683643693103,LIFR 1D,A00,185963,Staff,7,0,20,13
1683643694131,LIFR 1DX,A00,185964,Staff,7,0,20,13
1683643695157,LIGN 101,A01,186039,Staff,43,0,50,7
1683643696185,LIGN 165,A00,186040,Staff,15,0,50,35
1683643697213,LTCS 108,A00,186041,Staff,5,0,10,5
1683643698239,LTCS 119,A00,186042,Staff,15,0,20,5
1683643699268,LTCS 130,A00,186043,Wesling; Megan E.,15,0,25,10
1683643701318,LTEA 138,A00,186119,Staff,14,0,40,26
1683643702343,LTEN 124,A00,186148,Staff,5,0,25,20
1683643703370,LTEN 178,A00,186149,Staff,7,0,15,8
1683643704397,LTEN 181,A00,186150,Blanco; John D,34,0,40,6
1683643705424,LTWL 120,A00,186160,Staff,20,0,25,5
1683643706449,LTWL 165,A00,186161,Staff,22,0,25,3
1683643707473,LTWR 100,A00,186162,Staff,0,5,15,15
1683643708498,LTWR 102,A00,186163,Doller; Ben,5,0,15,10
1683643709523,MAE 8,A01,186412,Staff,0,0,0,0
1683643710549,MAE 30B,A00,186445,Bahadori; Mohammad Yousef,82,0,100,18
1683643711576,MAE 40,A00,186592,Bewley; Thomas R,10,0,50,40
1683643712600,MAE 101B,A00,186593,Bahadori; Mohammad Yousef,80,0,100,20
1683643713629,MAE 105,A00,186594,Bandaru; Prabhakar,10,0,50,40
1683643714655,MAE 107,A00,186599,Pham; Hieu Tan,0,7,120,120
1683643715684,MAE 148,A01,186660,Silberman; Jack,3,0,16,13
1683643716713,MATH 10A,A01,188095,Staff,0,5,35,35
1683643717739,MATH 10B,A01,188097,Bowers; Adam R.,0,11,30,30
1683643717739,MATH 10B,A02,188099,Bowers; Adam R.,0,11,30,30
1683643717739,MATH 10B,B01,188104,Bowers; Adam R.,0,10,30,30
1683643717739,MATH 10B,B02,188106,Bowers; Adam R.,1,9,30,29
1683643718766,MATH 10C,A01,188111,Staff,0,18,30,30
1683643718766,MATH 10C,A02,188127,Staff,0,19,30,30
1683643718766,MATH 10C,A03,188131,Staff,0,19,30,30
1683643718766,MATH 10C,B01,188218,Staff,17,0,30,13
1683643718766,MATH 10C,B02,188244,Staff,13,0,30,17
1683643718766,MATH 10C,B03,188277,Staff,14,0,30,16
1683643719796,MATH 18,A01,188344,Bach; Quang Tran,18,0,30,12
1683643719796,MATH 18,A02,188345,Bach; Quang Tran,11,0,30,19
1683643719796,MATH 18,B01,188353,Bach; Quang Tran,11,0,30,19
1683643719796,MATH 18,B02,188354,Bach; Quang Tran,19,0,30,11
1683643720824,MATH 20A,A01,188374,Staff,11,0,35,24
1683643721855,MATH 20B,A01,188382,Ohm; Ko Woon,7,0,30,23
1683643721855,MATH 20B,A02,188383,Ohm; Ko Woon,22,0,30,8
1683643721855,MATH 20B,B01,188385,Ohm; Ko Woon,7,0,30,23
1683643721855,MATH 20B,B02,188392,Ohm; Ko Woon,22,0,30,8
1683643722884,MATH 20C,A01,188394,Harel; Guershon,11,0,30,19
1683643722884,MATH 20C,A02,188395,Harel; Guershon,14,0,30,16
1683643722884,MATH 20C,B01,188404,Harel; Guershon,4,0,30,26
1683643722884,MATH 20C,B02,188405,Harel; Guershon,18,0,30,12
1683643723919,MATH 20D,A01,188414,Hammock; Frances H,0,1,30,30
1683643723919,MATH 20D,A02,188415,Hammock; Frances H,0,1,30,30
1683643723919,MATH 20D,B01,188447,Hammock; Frances H,0,1,30,30
1683643723919,MATH 20D,B02,188486,Hammock; Frances H,4,0,30,26
1683643724946,MATH 20E,A01,188649,Staff,21,0,30,9
1683643724946,MATH 20E,A02,188650,Staff,21,0,30,9
1683643724946,MATH 20E,A03,188673,Staff,0,0,30,30
1683643725972,MATH 102,A01,188675,Staff,0,36,35,35
1683643727002,MATH 103B,A01,188681,Staff,3,0,35,32
1683643727002,MATH 103B,B01,188692,Staff,5,0,35,30
1683643728084,MATH 109,A01,188695,Salehi Golsefidy; Alireza,24,0,35,11
1683643728084,MATH 109,A02,188696,Salehi Golsefidy; Alireza,25,0,35,10
1683643729110,MATH 120A,A01,188698,Eggers; John Dietrich,7,0,35,28
1683643730136,MATH 142B,A01,188736,Ioana; Adrian,0,1,30,30
1683643730136,MATH 142B,A02,188741,Ioana; Adrian,0,1,30,30
1683643730136,MATH 142B,A03,188743,Ioana; Adrian,0,1,30,30
1683643731161,MATH 168A,A01,188790,Staff,0,10,35,35
1683643732189,MATH 170A,A01,188803,Nie; Jiawang,0,2,35,35
1683643732189,MATH 170A,A02,188811,Nie; Jiawang,0,0,35,35
1683643732189,MATH 170A,A03,188814,Nie; Jiawang,0,0,35,35
1683643732189,MATH 170A,A04,188815,Nie; Jiawang,10,0,35,25
1683643733214,MATH 193B,A01,188817,Staff,0,0,35,35
1683643733214,MATH 193B,A02,188818,Staff,5,0,35,30
1683643734240,MGT 4,A01,202857,Anderson; John Charles,61,0,80,19
1683643735269,MGT 12,A00,202858,Lindenberger; Wade Douglas,40,0,90,50
1683643736296,MGT 18,A00,202859,Staff,74,0,90,16
1683643737324,MGT 18GS,A00,202860,McKay; Michael J,13,0,28,15
1683643738347,MGT 45,A00,202861,Pecore; Joseph P.,12,0,90,78
1683643739372,MGT 100,A00,202863,Yavorsky; Daniel Ryan,28,0,90,62
1683643740398,MGT 103,A00,202864,Ehrich; Kristine R,0,17,90,90
1683643741423,MGT 112,A00,202865,Ehrich; Kristine R,15,0,90,75
1683643742452,MGT 121A,A00,202868,Staff,0,20,0,0
1683643743478,MGT 131B,A00,202869,Anderson; John Charles,59,0,90,31
1683643744505,MGT 136,A00,202871,Lindenberger; Wade Douglas,83,0,90,7
1683643745533,MGT 164,A00,202873,Staff,0,66,90,91
1683643746558,MGT 164GS,A00,202874,McKay; Mary A,13,0,28,15
1683643747583,MGT 180,A00,202875,Staff,0,50,90,91
1683643748610,MMW 11R,A01,205019,Herbst; Matthew,2,0,30,28
1683643748610,MMW 11R,A02,205026,Herbst; Matthew,29,0,30,1
1683643749639,MMW 15,A01,193512,Chang; Edmond Yi-Teh,0,8,28,28
1683643749639,MMW 15,A02,193513,Chang; Edmond Yi-Teh,0,5,28,28
1683643749639,MMW 15,A03,193514,Chang; Edmond Yi-Teh,0,5,28,28
1683643749639,MMW 15,A04,193515,Chang; Edmond Yi-Teh,0,5,28,28
1683643749639,MMW 15,A05,193516,Chang; Edmond Yi-Teh,0,5,28,28
1683643749639,MMW 15,A06,193517,Chang; Edmond Yi-Teh,0,6,28,28
1683643749639,MMW 15,B01,193519,Chang; Edmond Yi-Teh,0,5,28,28
1683643749639,MMW 15,B02,193520,Chang; Edmond Yi-Teh,0,5,28,28
1683643749639,MMW 15,B03,193521,Chang; Edmond Yi-Teh,0,5,28,28
1683643749639,MMW 15,B04,193522,Chang; Edmond Yi-Teh,0,5,28,28
1683643749639,MMW 15,B05,193523,Chang; Edmond Yi-Teh,0,5,28,28
1683643749639,MMW 15,B06,193524,Chang; Edmond Yi-Teh,0,5,28,28
1683643750666,MMW 122,A01,193526,Rahimi; Babak,0,16,28,28
1683643750666,MMW 122,A02,193527,Rahimi; Babak,0,15,28,28
1683643750666,MMW 122,A03,193528,Rahimi; Babak,0,0,0,0
1683643750666,MMW 122,A04,193529,Rahimi; Babak,0,0,0,0
1683643751691,MUS 1A,A01,186663,Staff,1,20,35,34
1683643752719,MUS 4,A01,186715,Staff,0,12,35,35
1683643753745,MUS 5R,A01,186796,Dubnov; Shlomo,0,17,35,35
1683643754770,MUS 6,A01,186798,Staff,0,5,25,25
1683643755798,MUS 7,A01,186830,Staff,11,0,35,24
1683643756826,MUS 8,A01,186930,Staff,0,26,35,35
1683643757857,MUS 15,A01,186932,Staff,0,16,35,35
1683643757857,MUS 15,B01,186934,Staff,0,17,35,35
1683643758884,MUS 80,A00,186935,Staff,0,0,20,20
1683643758884,MUS 80,B00,186936,Staff,24,0,25,1
1683643759915,NANO 11,A00,204702,Lipomi; Darren John,0,0,0,0
1683643760941,NANO 15,A01,204709,Yang; Kesong,0,1,0,0
1683643761970,NANO 114,A00,202069,Jahed Motlagh; Zeinab,3,0,10,7
1683643762995,PHIL 1,A00,186955,Grush; Rick Scott,31,0,40,9
1683643764023,PHIL 10,A01,186973,Grush; Rick Scott,27,0,35,8
1683643764023,PHIL 10,A02,186974,Grush; Rick Scott,33,0,35,2
1683643765051,PHIL 13,A01,186976,Staff,3,0,35,32
1683643765051,PHIL 13,A02,186977,Staff,16,0,35,19
1683643766078,PHIL 14,A01,186979,Staff,31,0,35,4
1683643766078,PHIL 14,A02,186986,Staff,32,0,35,3
1683643767103,PHIL 28,A01,186988,Staff,16,0,30,14
1683643767103,PHIL 28,A02,186989,Staff,1,0,30,29
1683643767103,PHIL 28,A03,186990,Staff,10,0,30,20
1683643767103,PHIL 28,A04,186991,Staff,26,0,30,4
1683643768128,PHIL 120,A00,186997,Staff,23,0,40,17
1683643769151,PHIL 137,A00,187003,Staff,7,0,40,33
1683643770178,PHIL 150,A00,187015,Staff,47,0,70,23
1683643771206,PHIL 167,A00,187021,Lamey; Andy M.,34,0,40,6
1683643772232,PHIL 174,A01,202226,Staff,17,0,20,3
1683643772232,PHIL 174,A02,202235,Staff,20,0,20,0
1683643773260,PHIL 191A,A00,258918,Staff,0,0,1,1
1683643774288,PHYS 1A,A00,187028,Staff,27,0,60,33
1683643775317,PHYS 1AL,001,187036,Staff,3,0,30,27
1683643775317,PHYS 1AL,002,187049,Staff,18,0,30,12
1683643776345,PHYS 1B,A00,187058,Staff,22,0,60,38
1683643777370,PHYS 1BL,001,187064,Staff,0,1,30,30
1683643777370,PHYS 1BL,002,187070,Staff,4,0,30,26
1683643778395,PHYS 1C,A00,187082,Staff,29,0,120,91
1683643779426,PHYS 1CL,001,187088,Staff,0,9,30,30
1683643779426,PHYS 1CL,002,187089,Staff,0,1,30,30
1683643779426,PHYS 1CL,009,262693,Staff,9,0,30,21
1683643780450,PHYS 2B,A01,187097,Staff,55,0,115,60
1683643781477,PHYS 2C,A01,187099,Staff,64,0,115,51
1683643782504,PHYS 2CL,A01,187101,Staff,5,0,28,23
1683643782504,PHYS 2CL,A02,187102,Staff,15,0,28,13
1683643783529,PHYS 2D,A01,187123,Shotwell; Brian,95,0,115,20
1683643784558,PHYS 4B,A01,187133,Grinstein; Benjamin,35,0,50,15
1683643785586,POLI 10,A00,188819,Staff,0,4,50,50
1683643786614,POLI 11,A00,188827,Staff,43,0,50,7
1683643787638,POLI 13R,A00,188828,Staff,0,1,20,20
1683643788668,POLI 27,A01,188830,Elgin; Samuel Zincke,0,2,70,70
1683643789693,POLI 30,A00,188832,Desposato; Scott,30,0,50,20
1683643790719,POLI 102F,A00,188834,Staff,0,0,40,40
1683643791747,POLI 104A,A00,188852,Staff,13,0,30,17
1683643792774,POLI 104I,A00,188853,Staff,0,7,20,20
1683643793804,POLI 110B,A00,188854,Wiens; David,7,0,20,13
1683643794832,POLI 112A,A00,188855,Wiens; David,4,0,30,26
1683643795858,POLI 117R,A00,188856,Forman; Fonna,0,12,20,20
1683643796883,POLI 118,A00,188857,Ingham; Sean,8,0,20,12
1683643797908,POLI 120G,A00,188858,Staff,8,0,30,22
1683643798937,POLI 131CR,A00,188863,Hoston; Germaine,21,0,50,29
1683643799962,POLI 133,A00,188864,Nellis; Gareth Hb,44,0,50,6
1683643800986,POLI 134D,A00,188865,Desposato; Scott,27,0,30,3
1683643802013,POLI 142A,A00,188871,Gartzke; Erik,21,0,50,29
1683643803044,POLI 142K,A00,188874,Staff,38,0,50,12
1683643804071,POLI 143,A00,188940,Gartzke; Erik,16,0,30,14
1683643805095,POLI 153,A00,188943,Staff,2,0,20,18
1683643806120,POLI 160AA,A00,188944,Staff,11,0,40,29
1683643807144,POLI 170A,A00,188945,Staff,11,0,30,19
1683643809199,PSYC 1,A00,188952,Staff,36,0,90,54
1683643810232,PSYC 2,B00,188953,Staff,19,0,35,16
1683643811257,PSYC 6,A00,188970,Staff,47,0,60,13
1683643812283,PSYC 7,A00,188973,Staff,35,0,45,10
1683643813309,PSYC 60,A01,188980,Rickard; Timothy C.,42,0,60,18
1683643814334,PSYC 70,A01,189001,Steiner; Eric Tomas,23,0,45,22
1683643815365,PSYC 100,A00,189005,Lacefield; Katharine I,0,99,120,120
1683643816391,PSYC 102,A00,189008,Staff,8,0,30,22
1683643817420,PSYC 106,B00,189026,Gorman; Michael R.,27,0,60,33
1683643818450,PSYC 114,B01,189033,Winkielman; Piotr,0,31,30,30
1683643819480,PSYC 131,A00,189036,Anagnostaras; Stephan,0,43,60,60
1683643820509,PSYC 136,A00,189041,Lowe; Angela Beth,0,7,25,25
1683643821538,PSYC 137,A00,189057,Winkielman; Piotr,0,37,25,25
1683643822569,PSYC 144,A00,189107,Wixted; John T,0,10,50,50
1683643824619,PSYC 162,A00,189142,Staff,0,9,85,85
1683643825644,PSYC 172,A00,189144,Gorman; Michael R.,0,6,30,30
1683643827698,PSYC 179,A00,189146,Lacefield; Katharine I,0,86,120,120
1683643828733,PSYC 181,A00,189147,Anagnostaras; Stephan,0,44,90,90
1683643829760,PSYC 190R,A00,189148,Barner; David A.,0,23,80,80
1683643830785,PSYC 191,A00,189275,Rickard; Timothy C.,0,10,25,25
1683643831869,PSYC 193,A00,189276,Chapman; Eddie Nathaniel,0,1,0,4
1683643832900,PSYC 193L,A01,189281,Lowe; Angela Beth,10,0,20,10
1683643832900,PSYC 193L,B01,189285,Staff,28,0,35,7
1683643833929,RELI 149,A00,187137,Rahimi; Babak,7,0,40,33
1683643834957,SE 9,A01,187315,Staff,0,2,18,18
1683643835983,SE 101B,A00,187409,Staff,24,0,30,6
1683643837008,SE 110B,A00,187444,Staff,10,0,40,30
1683643838033,SE 130B,A00,187449,Staff,31,0,40,9
1683643839058,SE 150A,A00,187516,Staff,9,0,20,11
1683643840083,SE 154,A00,187528,Staff,29,0,50,21
1683643841106,SIO 3,A01,258171,Staff,35,0,40,5
1683643842135,SIO 10,A00,187144,Cook; Geoffrey W,0,6,75,75
1683643843158,SIO 45,A00,187152,Cook; Geoffrey W,0,4,100,100
1683643844185,SIO 109R,A00,194486,Staff,0,4,20,20
1683643846238,SIO 187,A01,187233,Kacev; David,12,0,40,28
1683643847268,SOCI 1,A01,258656,Thorpe; Charles Robert,28,0,30,2
1683643847268,SOCI 1,A02,258658,Thorpe; Charles Robert,30,0,30,0
1683643847268,SOCI 1,A03,258661,Thorpe; Charles Robert,25,0,25,0
1683643847268,SOCI 1,A04,258666,Thorpe; Charles Robert,22,0,25,3
1683643847268,SOCI 1,A05,258897,Thorpe; Charles Robert,22,0,25,3
1683643847268,SOCI 1,A06,258898,Thorpe; Charles Robert,25,0,25,0
1683643848294,SOCI 30,A01,258903,Pardo Guerra; Juan Pablo,14,0,30,16
1683643849320,SOCI 102,A00,258904,Staff,9,0,25,16
1683643850347,SOCI 106,A00,258905,Staff,19,0,25,6
1683643851377,SOCI 111,A00,258907,Ribas Norris; Janet Vanesa,26,0,30,4
1683643852404,SOCI 121R,A00,258908,Pardo Guerra; Juan Pablo,8,0,30,22
1683643853435,SOCI 126,A01,203330,Staff,14,0,20,6
1683643854462,SOCI 131,A00,258909,Thorpe; Charles Robert,30,0,60,30
1683643855493,SOCI 135,A00,258910,Payne; Christine Anna,0,11,30,30
1683643856521,SOCI 157,A00,258911,Staff,12,0,30,18
1683643857545,SOCI 184,A00,258912,Staff,25,0,30,5
1683643858570,SOCI 188D,A00,258913,Staff,22,0,30,8
1683643859599,SYN 2,001,187529,Staff,9,0,16,7
1683643859599,SYN 2,002,201452,Staff,0,20,16,16
1683643859599,SYN 2,003,201469,Staff,2,0,16,14
1683643860626,SYN 100,A01,187531,Staff,0,9,20,20
1683643860626,SYN 100,B01,201491,Staff,0,10,20,20
1683643861652,TDAC 1,A00,189286,Walsh; Kim C.,3,0,20,17
1683643861652,TDAC 1,B00,189287,Harting; Carla Kelso,10,0,20,10
1683643862681,TDAC 101,A00,189300,Walsh; Kim C.,16,0,20,4
1683643862681,TDAC 101,B00,189301,Harting; Carla Kelso,18,0,20,2
1683643863707,TDAC 102,A00,189304,Basso; Beatrice,14,0,20,6
1683643864736,TDAC 108,A00,189305,Staff,18,0,20,2
1683643865762,TDDE 131,A00,189310,Staff,19,0,20,1
1683643865762,TDDE 131,B00,189314,Staff,19,0,20,1
1683643865762,TDDE 131,C00,189315,Staff,48,0,50,2
1683643865762,TDDE 131,D00,189316,Staff,14,0,15,1
1683643865762,TDDE 131,E00,204841,Staff,20,0,20,0
1683643866794,TDGE 10,A00,189289,Staff,27,0,50,23
1683643866794,TDGE 10,B00,189290,Havis; Allan,0,0,50,50
1683643867819,TDGE 11,A00,189291,Fulton; Julia,0,4,50,50
1683643867819,TDGE 11,B00,189292,Staff,20,0,25,5
1683643867819,TDGE 11,C00,260270,Staff,0,0,0,0
1683643868844,TDGE 25,A00,189294,Staff,2,0,20,18
1683643869869,TDGE 124,A00,189318,Fulton; Julia,0,8,50,50
1683643870896,TDGE 125,A00,189319,Staff,13,0,25,12
1683643870896,TDGE 125,B00,189320,Staff,23,0,25,2
1683643871921,TDGE 127,A00,189322,Havis; Allan,0,0,50,50
1683643872946,TDHT 101,A00,189323,Staff,18,0,25,7
1683643872946,TDHT 101,B00,189324,Staff,25,0,25,0
1683643873971,TDHT 102,A00,189325,Staff,49,0,50,1
1683643875002,TDMV 1,A00,189295,Arcidiacono; Kristin,20,0,30,10
1683643875002,TDMV 1,B00,189296,Caligagan; Maria T.,24,0,30,6
1683643876031,TDMV 2,A00,189297,Sammartano; Tonnie,27,0,30,3
1683643876031,TDMV 2,B00,189299,Arcidiacono; Kristin,23,0,30,7
1683643877058,TDMV 3,A00,204998,Rincon; Alicia,22,0,30,8
1683643878083,TDMV 120,A00,189458,Sammartano; Tonnie,28,0,30,2
1683643879107,TDMV 138,A00,189541,Jun; Grace Shin Hae,20,0,40,20
1683643880134,TDMV 142,A00,189717,Caligagan; Tony,25,0,30,5
1683643880134,TDMV 142,B00,189718,Caligagan; Maria T.,25,0,30,5
1683643881164,TMC 2,A01,187533,Staff,25,0,25,0
1683643881164,TMC 2,A02,187534,Staff,25,0,25,0
1683643882190,USP 1,A01,187536,Kwak; Nancy,0,16,25,25
1683643883215,USP 5,A01,187538,Staff,9,0,25,16
1683643884243,USP 101,A00,199253,Staff,0,4,0,0
1683643885267,USP 124,A00,187562,Boomhower; Matthew Charles,0,0,30,30
1683643886294,USP 138,A00,187582,Staff,20,0,25,5
1683643887319,USP 152,A01,187597,Staff,3,0,25,22
1683643888342,USP 153,A00,187598,Staff,19,0,25,6
1683643889365,USP 168,A00,187607,Kwak; Nancy,2,0,5,3
1683643890391,USP 173,A00,187619,Staff,4,0,25,21
1683643891414,USP 181,A00,187638,Staff,0,4,25,25
1683643892444,VIS 103,A00,187650,Cruz; Edwin Teddy,18,0,75,57
1683643893475,VIS 110D,A00,187669,Staff,13,0,22,9
1683643894502,VIS 127C,A00,187720,Shen; Kuiyi,67,0,146,79
1683643895528,VIS 149,A00,187731,Yoldas; Pinar,0,14,22,22
1683643896554,VIS 151,A01,188091,Staff,22,0,34,12
1683643896554,VIS 151,A02,188092,Staff,11,0,34,23
1683643897582,VIS 160B,A00,188093,Stalbaum; Brett,0,1,10,10
1683643899635,WCWP 10B,A00,201720,Staff,10,0,15,5
1683643899635,WCWP 10B,B00,201722,Staff,9,0,15,6
1683643900661,WCWP 100,A00,201725,Gagnon; Jeffrey C,0,0,2,2
1683643900661,WCWP 100,B00,201727,Staff,0,4,15,15
1683643903780,ANBI 133,A00,258401,Wilder; Linnea Lorene,34,0,40,6
1683643904806,ANBI 140,A00,258395,Hrvoj Mihic; Branka,18,0,25,7
1683643905831,ANSC 120,A00,258402,Bialecki; Jon Anthony,27,0,40,13
1683643906859,ANSC 144,A00,258400,Staff,12,0,40,28
1683643908912,ANSC 166,A00,258396,Parish; Steven Martin,156,0,175,19
1683643909937,ANSC 180,A00,193533,Staff,8,0,20,12
1683643910966,ANSC 188,A00,258397,Jassal; Aftab,34,0,40,6
1683643911992,ANTH 3,A01,258316,Staff,23,0,30,7
1683643913019,ANTH 5,A00,258394,Semendeferi; Ekaterini,16,0,20,4
1683643914044,ANTH 21,A01,258331,Staff,4,0,40,36
1683643915068,ANTH 103,A00,258398,Varma; Saiba,15,0,25,10
1683643916101,AWP 10,001,202034,Staff,0,0,0,0
1683643916101,AWP 10,002,202035,Staff,0,0,0,0
1683643916101,AWP 10,003,202036,Staff,0,0,0,0
1683643916101,AWP 10,004,202037,Staff,0,0,0,0
1683643916101,AWP 10,005,202038,Staff,0,0,0,0
1683643916101,AWP 10,006,202039,Staff,0,0,0,0
1683643916101,AWP 10,007,202040,Staff,0,0,0,0
1683643916101,AWP 10,008,202041,Staff,0,0,0,0
1683643916101,AWP 10,009,202042,Staff,0,0,0,0
1683643916101,AWP 10,010,202043,Staff,0,0,0,0
1683643916101,AWP 10,011,202044,Staff,0,0,0,0
1683643916101,AWP 10,012,202045,Staff,0,0,0,0
1683643916101,AWP 10,013,202046,Staff,0,0,0,0
1683643916101,AWP 10,014,202047,Staff,0,0,0,0
1683643916101,AWP 10,015,202048,Staff,0,0,0,0
1683643916101,AWP 10,016,202049,Staff,0,0,0,0
1683643916101,AWP 10,017,202050,Staff,0,0,0,0
1683643916101,AWP 10,018,202051,Staff,0,0,0,0
1683643916101,AWP 10,019,202052,Staff,0,0,0,0
1683643916101,AWP 10,020,202053,Staff,0,0,0,0
1683643916101,AWP 10,021,202054,Staff,0,0,0,0
1683643916101,AWP 10,022,202055,Staff,0,0,0,0
1683643916101,AWP 10,023,202056,Staff,0,0,0,0
1683643916101,AWP 10,024,202057,Staff,0,0,0,0
1683643916101,AWP 10,025,202058,Staff,0,0,0,0
1683643916101,AWP 10,026,202059,Staff,0,0,0,0
1683643917130,AWP 102,001,202032,Staff,0,0,0,0
1683643917130,AWP 102,002,202033,Staff,0,0,0,0
1683643918156,BENG 100,A01,254234,Taylor Amos; Alyssa C,31,0,40,9
1683643919183,BENG 196,001,270013,Engler; Adam J.,9999,0,9999,0
1683643920215,BICD 100R,A01,202018,Smith; Laurie,0,7,32,32
1683643920215,BICD 100R,A02,202019,Smith; Laurie,0,3,32,32
1683643920215,BICD 100R,A03,202020,Smith; Laurie,0,1,32,32
1683643920215,BICD 100R,A04,202021,Smith; Laurie,6,0,32,26
1683643920215,BICD 100R,A05,202022,Smith; Laurie,11,0,32,21
1683643921241,BICD 136,A01,193242,Gustafson-Brown; Cindy,0,2,32,32
1683643921241,BICD 136,A02,193244,Gustafson-Brown; Cindy,13,0,32,19
1683643922267,BIEB 102,A01,193249,Butler; Shannon Rhey,0,2,32,32
1683643922267,BIEB 102,A02,193251,Butler; Shannon Rhey,0,0,32,32
1683643922267,BIEB 102,A03,193253,Butler; Shannon Rhey,0,0,32,32
1683643922267,BIEB 102,A04,193255,Butler; Shannon Rhey,14,0,32,18
1683643922267,BIEB 102,A05,193265,Butler; Shannon Rhey,26,0,32,6
1683643922267,BIEB 102,A06,193269,Butler; Shannon Rhey,14,0,32,18
1683643924322,BIEB 150,A01,193274,Staff,0,0,32,32
1683643924322,BIEB 150,A02,193285,Staff,24,0,32,8
1683643925347,BIEB 194,A00,193286,Kurle; Carolyn M.,20,0,32,12
1683643926374,BILD 1,A01,192291,Staff,15,0,32,17
1683643926374,BILD 1,A02,192292,Staff,30,0,32,2
1683643926374,BILD 1,B01,192520,Reuther; Keefe,0,1,0,0
1683643926374,BILD 1,B02,192532,Reuther; Keefe,0,1,0,0
1683643927405,BILD 3,A01,192556,Butler; Shannon Rhey,0,0,32,32
1683643927405,BILD 3,A02,192581,Butler; Shannon Rhey,1,0,32,31
1683643927405,BILD 3,A03,192611,Butler; Shannon Rhey,21,0,32,11
1683643927405,BILD 3,A04,192612,Butler; Shannon Rhey,24,0,32,8
1683643927405,BILD 3,A05,192613,Butler; Shannon Rhey,26,0,32,6
1683643927405,BILD 3,A06,192679,Butler; Shannon Rhey,27,0,32,5
1683643927405,BILD 3,A07,192682,Butler; Shannon Rhey,20,0,32,12
1683643928432,BILD 4,A01,192836,Reuther; Keefe,0,0,24,24
1683643928432,BILD 4,A02,193044,Reuther; Keefe,4,0,24,20
1683643929459,BILD 10,A01,193142,Gustafson-Brown; Cindy,29,0,32,3
1683643929459,BILD 10,A02,193149,Gustafson-Brown; Cindy,31,0,32,1
1683643930482,BIMM 100,A01,193301,Staff,0,6,32,32
1683643930482,BIMM 100,A02,193312,Staff,0,7,32,32
1683643930482,BIMM 100,A03,193323,Staff,0,9,32,32
1683643931507,BIMM 101,A01,193329,McDonnell; Lisa Marie,0,4,24,24
1683643931507,BIMM 101,A02,193339,McDonnell; Lisa Marie,0,3,24,24
1683643931507,BIMM 101,B01,193354,McDonnell; Lisa Marie,0,4,24,24
1683643931507,BIMM 101,B02,193357,McDonnell; Lisa Marie,0,3,24,24
1683643932537,BIMM 110,A01,193377,Tat; John,0,11,32,32
1683643932537,BIMM 110,A02,193378,Tat; John,0,10,32,32
1683643933562,BIMM 120,A01,206116,Staff,0,0,32,32
1683643933562,BIMM 120,A02,206117,Staff,6,0,32,26
1683643933562,BIMM 120,A03,206121,Staff,21,0,32,11
1683643934587,BIPN 100,A01,193393,Park; Ji Young,0,14,32,32
1683643934587,BIPN 100,A02,193402,Park; Ji Young,0,14,32,32
1683643934587,BIPN 100,A03,193413,Park; Ji Young,0,14,32,32
1683643934587,BIPN 100,A04,193414,Park; Ji Young,0,13,32,32
1683643935685,BIPN 102,A01,193429,Staff,0,0,32,32
1683643935685,BIPN 102,A02,193438,Staff,18,0,32,14
1683643936714,BIPN 106,A01,193450,Reyes Gonzalez; Catalina,0,2,40,40
1683643937738,BIPN 134,A01,193465,Cooke; James Edward,0,0,32,32
1683643937738,BIPN 134,A02,193474,Cooke; James Edward,25,0,32,7
1683643937738,BIPN 134,A03,193485,Cooke; James Edward,29,0,32,3
1683643937738,BIPN 134,A04,193486,Cooke; James Edward,20,0,32,12
1683643937738,BIPN 134,A05,193491,Cooke; James Edward,31,0,32,1
1683643937738,BIPN 134,A06,193501,Cooke; James Edward,30,0,32,2
1683643937738,BIPN 134,A07,193510,Cooke; James Edward,29,0,32,3
1683643939788,BISP 194,A00,222522,Staff,14,0,32,18
1683643940815,CAT 124,A01,202407,Staff,19,0,25,6
1683643941849,CAT 125,A00,202408,Marchisotto; Jennifer Anne,2,0,20,18
1683643942882,CAT 125R,A00,202409,Smith; Lauryn Alissa,0,11,20,20
1683643942882,CAT 125R,B00,202410,Morales; Celeste Georgianna,0,11,20,20
1683643942882,CAT 125R,C00,202411,Irwin; Matthew Joseph,0,12,20,20
1683643943911,CENG 15,A01,204712,Yang; Kesong,0,1,0,0
1683643944937,CENG 114,A00,202070,Jahed Motlagh; Zeinab,5,0,20,15
1683643945967,CGS 105,A00,185477,Wesling; Megan E.,24,0,40,16
1683643946993,CGS 106,A00,185494,Staff,11,0,22,11
1683643948020,CGS 108,A00,185495,Staff,14,0,20,6
1683643949046,CGS 114,A00,185496,Staff,13,0,18,5
1683643950074,CGS 119,A00,185501,Staff,15,0,20,5
1683643951099,CGS 120,A00,185511,Staff,12,0,20,8
1683643952126,CHEM 4,A01,184675,Bussey; Thomas J,97,0,100,3
1683643953150,CHEM 6A,A01,184677,Staff,33,0,60,27
1683643954180,CHEM 6B,A01,184679,Staff,63,0,100,37
1683643955204,CHEM 6C,A01,184681,Bussey; Thomas J,0,0,50,50
1683643955204,CHEM 6C,A02,184682,Bussey; Thomas J,32,0,50,18
1683643956229,CHEM 40A,A01,184684,Albizati; Kim F.,34,0,100,66
1683643957255,CHEM 40B,A01,184686,Albizati; Kim F.,0,22,100,100
1683643958280,CHEM 41B,A01,184690,Staff,51,0,100,49
1683643959306,COGS 3,A01,184715,Boyle; Mary E. T.,0,27,40,40
1683643960336,COGS 14B,A01,185172,Staff,0,14,38,38
1683643961368,COGS 18,A01,184736,Staff,15,0,80,65
1683643962397,COGS 100,A01,184932,Staff,0,7,73,73
1683643963420,COGS 101A,A01,184935,Staff,0,39,30,30
1683643964445,COGS 101B,A01,184944,Staff,0,2,30,30
1683643965473,COGS 101C,A01,184946,Staff,0,10,30,30
1683643966501,COGS 102A,A01,184951,Johnson; Christine M.,2,0,40,38
1683643967529,COGS 107B,A01,184953,Mooshagian; Eric Frederick,0,51,40,40
1683643968559,COGS 118B,A01,184959,Gupta; Anjum,0,49,40,40
1683643969583,COGS 153,A00,184961,Staff,0,16,30,30
1683643970607,COGS 177,A00,184962,Staff,0,21,30,30
1683643971632,COGS 187A,A01,184969,Boyle; Mary E. T.,0,19,40,40
1683643972658,COMM 10,A01,185174,Staff,0,5,25,25
1683643972658,COMM 10,A02,185189,Staff,0,2,25,25
1683643972658,COMM 10,A03,269821,Staff,0,1,0,0
1683643973685,COMM 100B,A01,185475,Staff,0,1,0,2
1683643973685,COMM 100B,A02,185476,Staff,12,0,25,13
1683643974715,COMM 100C,A01,185314,Staff,1,0,25,24
1683643974715,COMM 100C,A02,185327,Staff,18,0,25,7
1683643975741,COMM 110M,A00,185349,Staff,0,0,40,40
1683643976768,COMM 113T,A00,185352,Staff,25,0,40,15
1683643977793,COMM 114I,A00,185353,Staff,31,0,40,9
1683643978820,COMM 131,A00,185354,Staff,17,0,30,13
1683643979849,CSE 8A,A50,185358,Cao; Yingjun,0,46,10,10
1683643980874,CSE 8B,A01,185362,Staff,0,48,50,50
1683643981900,CSE 11,A01,185416,Cao; Yingjun,0,91,10,10
1683643982926,CSE 20,A01,185445,Briones; Jor-el Thomas Caparas,4,0,25,21
1683643983955,CSE 21,A01,185447,Staff,9,0,50,41
1683643984980,CSE 101,A01,185451,Staff,0,13,50,50
1683643984980,CSE 101,B01,185453,Jones; Miles E,0,13,50,50
1683643987035,CSE 141,A01,185458,Eldon; John,15,0,100,85
1683643988062,CSE 141L,A01,185461,Eldon; John,7,0,100,93
1683643989095,CSE 142,A01,185463,Staff,36,0,60,24
1683643989095,CSE 142,B01,201355,Staff,0,7,60,60
1683643990119,CSE 142L,A01,185470,Staff,36,0,60,24
1683643990119,CSE 142L,B01,201417,Staff,0,6,60,60
1683643991145,CSE 190,A00,201433,Staff,32,0,49,17
1683643992170,DOC 1,A01,259136,Strom; Megan C.,7,0,15,8
1683643992170,DOC 1,A02,259137,Strom; Megan C.,14,0,15,1
1683643992170,DOC 1,A03,259138,Strom; Megan C.,14,0,15,1
1683643992170,DOC 1,A04,259139,Strom; Megan C.,14,0,15,1
1683643993194,DOC 100D,A00,259140,Pass; Natalye Joann,14,0,25,11
1683643994222,DSGN 1,A01,184749,Rill; Bryan,0,26,30,30
1683643995245,DSGN 100,A01,185168,Staff,0,2,25,25
1683643996273,ECE 5,A01,185626,Morris; Karcher William,0,11,0,0
1683643997301,ECE 101,A01,185628,Staff,14,0,70,56
1683643998327,ECE 107,A01,185635,Baghdadchi; Saharnaz,0,0,20,20
1683643998327,ECE 107,A02,185638,Baghdadchi; Saharnaz,3,0,20,17
1683643999353,ECE 148,A01,185647,Silberman; Jack,0,0,16,16
1683644000375,ECON 1,A01,185537,Crane; Meredith Helen,54,0,70,16
1683644001401,ECON 3,A01,185549,Crane; Meredith Helen,29,0,70,41
1683644002428,ECON 4,A01,203354,Anderson; John Charles,0,5,10,10
1683644003452,ECON 100A,A01,185574,Staff,0,5,40,40
1683644004476,ECON 100B,A01,185576,Staff,0,12,50,50
1683644005501,ECON 100C,A01,185589,Newhouse; Herbert S,30,0,70,40
1683644006529,ECON 105,A00,185608,Vespa; Emanuel Ignacio,19,0,35,16
1683644007560,ECON 109,A01,185610,Shishkin; Denis,9,0,35,26
1683644008585,ECON 110A,A01,185612,Staff,9,0,40,31
1683644009617,ECON 120A,A01,185615,Staff,20,0,40,20
1683644010642,ECON 120C,A01,185617,Sun; Yixiao,0,20,70,70
1683644011677,ECON 144,A00,203346,Squires; Dale E,2,0,35,33
1683644012705,ECON 171,A01,203349,Newhouse; Herbert S,0,1,35,35
1683644013735,ECON 173A,A01,185621,Toda; Alexis Akira,21,0,35,14
1683644014796,EDS 25,A01,202413,Staff,0,1,0,0
1683644014796,EDS 25,A02,202414,Staff,0,1,0,0
1683644014796,EDS 25,A03,202415,Staff,0,0,0,0
1683644014796,EDS 25,A04,202416,Staff,0,1,0,0
1683644014796,EDS 25,A05,202439,Staff,0,0,0,0
1683644014796,EDS 25,A06,202440,Staff,0,0,0,0
1683644014796,EDS 25,B01,202631,Staff,0,0,0,0
1683644014796,EDS 25,B02,202632,Staff,0,0,0,0
1683644014796,EDS 25,B03,202639,Staff,0,0,0,0
1683644014796,EDS 25,B04,202640,Staff,0,0,0,0
1683644014796,EDS 25,B05,202643,Staff,0,0,0,0
1683644014796,EDS 25,B06,202644,Staff,0,0,0,0
1683644015828,EDS 38,A01,202659,Black; Alison Michelle,24,0,25,1
1683644016852,EDS 115,A00,202652,Staff,18,0,30,12
1683644017882,EDS 125,A00,202649,Staff,13,0,30,17
1683644018915,EDS 126,A01,203332,Staff,30,0,30,0
1683644019940,EDS 139,A00,202838,Staff,16,0,25,9
1683644020966,EDS 146,A01,202655,Staff,14,0,25,11
1683644021993,ENG 15,A00,185667,Staff,0,1,0,0
1683644021993,ENG 15,B00,185672,Staff,0,0,0,0
1683644021993,ENG 15,C00,185675,Staff,0,0,0,0
1683644021993,ENG 15,D00,185682,Staff,0,0,0,0
1683644021993,ENG 15,E00,185684,Staff,0,0,0,0
1683644023017,ETHN 103,A00,185710,Staff,0,8,35,35
1683644024045,ETHN 103A,A00,199228,Man; Simeon S,0,0,9,9
1683644025072,ETHN 109,A00,185711,Staff,16,0,35,19
1683644026097,ETHN 142,A00,185726,Staff,0,4,30,30
1683644027122,ETHN 163J,A00,199229,Man; Simeon S,5,0,8,3
1683644028150,ETHN 168,A00,185727,Staff,7,0,10,3
1683644029175,ETHN 182,A00,185728,Staff,0,0,35,35
1683644030200,ETHN 183,A00,185737,Staff,9,0,18,9
1683644031230,GLBH 111,A01,209361,Burgos; Jose L.,0,0,0,0
1683644033282,HIEU 104,A00,185792,Staff,14,0,20,6
1683644034308,HIEU 115,A00,185800,Staff,0,0,20,20
1683644035335,HIEU 128,A00,185801,Staff,0,9,20,20
1683644036364,HIEU 147,A00,185802,Staff,15,0,20,5
1683644037388,HIEU 154,A00,185823,Staff,11,0,20,9
1683644038416,HILA 102,A00,185826,Staff,14,0,20,6
1683644039507,HILD 2C,A01,185778,Staff,0,13,20,20
1683644040535,HILD 7B,A01,185780,Kwak; Nancy,0,16,32,32
1683644040535,HILD 7B,A02,185781,Kwak; Nancy,0,18,32,32
1683644041560,HILD 30,A01,185791,Staff,12,0,20,8
1683644042585,HISC 119,A00,185830,Golan; Tal,0,9,20,20
1683644043613,HITO 156GS,A00,185831,Patterson; Patrick H.,0,0,0,23
1683644044637,HIUS 103,A00,185832,Man; Simeon S,0,4,20,20
1683644045661,HIUS 117,A00,185836,Kwak; Nancy,2,0,20,18
1683644046689,HIUS 125,A00,185840,Man; Simeon S,0,1,23,23
1683644047713,HIUS 149,A00,185845,Staff,1,0,20,19
1683644048738,HUM 3,A01,185882,Zavodny; Tatiana Sophia,0,7,50,50
1683644048738,HUM 3,B01,185899,Caldwell; Michael Alan,0,18,50,50
1683644049779,HUM 3GS,A00,185900,Patterson; Patrick H.,0,0,0,23
1683644050809,HUM 4,A01,185938,Zroka; Amy Liane,30,0,50,20
1683644050809,HUM 4,B01,185956,Watkins; Eric,0,4,50,50
1683644050809,HUM 4,B02,202209,Watkins; Eric,0,4,50,50
1683644050809,HUM 4,B03,202210,Watkins; Eric,0,4,50,50
1683644051835,HUM 5,A01,185958,West; Geoffrey Scott,2,0,50,48
1683644051835,HUM 5,A02,202215,West; Geoffrey Scott,0,0,50,50
1683644052867,INTL 190,A00,185959,Gagnon; Jeffrey C,0,0,0,9
1683644052867,INTL 190,B00,185960,Lettieri; Michael Joseph,0,0,0,2
1683644053897,JAPN 180,A00,254509,Staff,5,0,30,25
1683644054929,LATI 10,A01,202853,Kennemore; Amy Michelle,4,0,35,31
1683644054929,LATI 10,A02,202854,Kennemore; Amy Michelle,2,0,35,33
1683644054929,LATI 10,A03,270054,Kennemore; Amy Michelle,30,0,30,0
1683644055954,LATI 180,A00,202855,Kennemore; Amy Michelle,11,0,20,9
1683644056979,LAWS 101,A00,201767,Golan; Tal,0,7,40,40
1683644058008,LIFR 1C,A00,185961,Staff,6,0,20,14
1683644059046,LIFR 1CX,A00,185962,Staff,7,0,20,13
1683644060070,LIFR 1D,A00,185963,Staff,7,0,20,13
1683644061094,LIFR 1DX,A00,185964,Staff,7,0,20,13
1683644062119,LIGN 101,A01,186039,Staff,43,0,50,7
1683644063154,LIGN 165,A00,186040,Staff,15,0,50,35
1683644064178,LTCS 108,A00,186041,Staff,5,0,10,5
1683644065203,LTCS 119,A00,186042,Staff,15,0,20,5
1683644066228,LTCS 130,A00,186043,Wesling; Megan E.,15,0,25,10
1683644068280,LTEA 138,A00,186119,Staff,14,0,40,26
1683644069305,LTEN 124,A00,186148,Staff,5,0,25,20
1683644070329,LTEN 178,A00,186149,Staff,7,0,15,8
1683644071353,LTEN 181,A00,186150,Blanco; John D,34,0,40,6
1683644072381,LTWL 120,A00,186160,Staff,20,0,25,5
1683644073409,LTWL 165,A00,186161,Staff,22,0,25,3
1683644074437,LTWR 100,A00,186162,Staff,0,5,15,15
1683644075462,LTWR 102,A00,186163,Doller; Ben,5,0,15,10
1683644076486,MAE 8,A01,186412,Staff,0,0,0,0
1683644077515,MAE 30B,A00,186445,Bahadori; Mohammad Yousef,82,0,100,18
1683644078541,MAE 40,A00,186592,Bewley; Thomas R,10,0,50,40
1683644079569,MAE 101B,A00,186593,Bahadori; Mohammad Yousef,80,0,100,20
1683644080597,MAE 105,A00,186594,Bandaru; Prabhakar,10,0,50,40
1683644081623,MAE 107,A00,186599,Pham; Hieu Tan,0,7,120,120
1683644082648,MAE 148,A01,186660,Silberman; Jack,3,0,16,13
1683644083706,MATH 10A,A01,188095,Staff,0,5,35,35
1683644084731,MATH 10B,A01,188097,Bowers; Adam R.,0,11,30,30
1683644084731,MATH 10B,A02,188099,Bowers; Adam R.,0,11,30,30
1683644084731,MATH 10B,B01,188104,Bowers; Adam R.,0,10,30,30
1683644084731,MATH 10B,B02,188106,Bowers; Adam R.,1,9,30,29
1683644085760,MATH 10C,A01,188111,Staff,0,18,30,30
1683644085760,MATH 10C,A02,188127,Staff,0,19,30,30
1683644085760,MATH 10C,A03,188131,Staff,0,19,30,30
1683644085760,MATH 10C,B01,188218,Staff,17,0,30,13
1683644085760,MATH 10C,B02,188244,Staff,13,0,30,17
1683644085760,MATH 10C,B03,188277,Staff,14,0,30,16
1683644086791,MATH 18,A01,188344,Bach; Quang Tran,18,0,30,12
1683644086791,MATH 18,A02,188345,Bach; Quang Tran,11,0,30,19
1683644086791,MATH 18,B01,188353,Bach; Quang Tran,11,0,30,19
1683644086791,MATH 18,B02,188354,Bach; Quang Tran,19,0,30,11
1683644087818,MATH 20A,A01,188374,Staff,11,0,35,24
1683644088841,MATH 20B,A01,188382,Ohm; Ko Woon,7,0,30,23
1683644088841,MATH 20B,A02,188383,Ohm; Ko Woon,22,0,30,8
1683644088841,MATH 20B,B01,188385,Ohm; Ko Woon,7,0,30,23
1683644088841,MATH 20B,B02,188392,Ohm; Ko Woon,22,0,30,8
1683644089870,MATH 20C,A01,188394,Harel; Guershon,11,0,30,19
1683644089870,MATH 20C,A02,188395,Harel; Guershon,14,0,30,16
1683644089870,MATH 20C,B01,188404,Harel; Guershon,4,0,30,26
1683644089870,MATH 20C,B02,188405,Harel; Guershon,18,0,30,12
1683644090902,MATH 20D,A01,188414,Hammock; Frances H,0,1,30,30
1683644090902,MATH 20D,A02,188415,Hammock; Frances H,0,1,30,30
1683644090902,MATH 20D,B01,188447,Hammock; Frances H,0,1,30,30
1683644090902,MATH 20D,B02,188486,Hammock; Frances H,4,0,30,26
1683644091928,MATH 20E,A01,188649,Staff,21,0,30,9
1683644091928,MATH 20E,A02,188650,Staff,21,0,30,9
1683644091928,MATH 20E,A03,188673,Staff,0,0,30,30
1683644092954,MATH 102,A01,188675,Staff,0,36,35,35
1683644093981,MATH 103B,A01,188681,Staff,3,0,35,32
1683644093981,MATH 103B,B01,188692,Staff,5,0,35,30
1683644095005,MATH 109,A01,188695,Salehi Golsefidy; Alireza,24,0,35,11
1683644095005,MATH 109,A02,188696,Salehi Golsefidy; Alireza,25,0,35,10
1683644096033,MATH 120A,A01,188698,Eggers; John Dietrich,7,0,35,28
1683644097061,MATH 142B,A01,188736,Ioana; Adrian,0,1,30,30
1683644097061,MATH 142B,A02,188741,Ioana; Adrian,0,1,30,30
1683644097061,MATH 142B,A03,188743,Ioana; Adrian,0,1,30,30
1683644098091,MATH 168A,A01,188790,Staff,0,10,35,35
1683644099119,MATH 170A,A01,188803,Nie; Jiawang,0,2,35,35
1683644099119,MATH 170A,A02,188811,Nie; Jiawang,0,0,35,35
1683644099119,MATH 170A,A03,188814,Nie; Jiawang,0,0,35,35
1683644099119,MATH 170A,A04,188815,Nie; Jiawang,10,0,35,25
1683644100149,MATH 193B,A01,188817,Staff,0,0,35,35
1683644100149,MATH 193B,A02,188818,Staff,5,0,35,30
1683644101176,MGT 4,A01,202857,Anderson; John Charles,61,0,80,19
1683644102201,MGT 12,A00,202858,Lindenberger; Wade Douglas,40,0,90,50
1683644103226,MGT 18,A00,202859,Staff,74,0,90,16
1683644104250,MGT 18GS,A00,202860,McKay; Michael J,13,0,28,15
1683644105280,MGT 45,A00,202861,Pecore; Joseph P.,12,0,90,78
1683644106307,MGT 100,A00,202863,Yavorsky; Daniel Ryan,28,0,90,62
1683644107332,MGT 103,A00,202864,Ehrich; Kristine R,0,17,90,90
1683644108361,MGT 112,A00,202865,Ehrich; Kristine R,15,0,90,75
1683644109389,MGT 121A,A00,202868,Staff,0,20,0,0
1683644110415,MGT 131B,A00,202869,Anderson; John Charles,59,0,90,31
1683644111440,MGT 136,A00,202871,Lindenberger; Wade Douglas,83,0,90,7
1683644112464,MGT 164,A00,202873,Staff,0,66,90,91
1683644113490,MGT 164GS,A00,202874,McKay; Mary A,13,0,28,15
1683644114512,MGT 180,A00,202875,Staff,0,50,90,91
1683644115536,MMW 11R,A01,205019,Herbst; Matthew,2,0,30,28
1683644115536,MMW 11R,A02,205026,Herbst; Matthew,29,0,30,1
1683644116562,MMW 15,A01,193512,Chang; Edmond Yi-Teh,0,8,28,28
1683644116562,MMW 15,A02,193513,Chang; Edmond Yi-Teh,0,5,28,28
1683644116562,MMW 15,A03,193514,Chang; Edmond Yi-Teh,0,5,28,28
1683644116562,MMW 15,A04,193515,Chang; Edmond Yi-Teh,0,5,28,28
1683644116562,MMW 15,A05,193516,Chang; Edmond Yi-Teh,0,5,28,28
1683644116562,MMW 15,A06,193517,Chang; Edmond Yi-Teh,0,6,28,28
1683644116562,MMW 15,B01,193519,Chang; Edmond Yi-Teh,0,5,28,28
1683644116562,MMW 15,B02,193520,Chang; Edmond Yi-Teh,0,5,28,28
1683644116562,MMW 15,B03,193521,Chang; Edmond Yi-Teh,0,5,28,28
1683644116562,MMW 15,B04,193522,Chang; Edmond Yi-Teh,0,5,28,28
1683644116562,MMW 15,B05,193523,Chang; Edmond Yi-Teh,0,5,28,28
1683644116562,MMW 15,B06,193524,Chang; Edmond Yi-Teh,0,5,28,28
1683644117590,MMW 122,A01,193526,Rahimi; Babak,0,16,28,28
1683644117590,MMW 122,A02,193527,Rahimi; Babak,0,15,28,28
1683644117590,MMW 122,A03,193528,Rahimi; Babak,0,0,0,0
1683644117590,MMW 122,A04,193529,Rahimi; Babak,0,0,0,0
1683644118614,MUS 1A,A01,186663,Staff,1,20,35,34
1683644119637,MUS 4,A01,186715,Staff,0,12,35,35
1683644120667,MUS 5R,A01,186796,Dubnov; Shlomo,0,17,35,35
1683644121691,MUS 6,A01,186798,Staff,0,5,25,25
1683644122715,MUS 7,A01,186830,Staff,11,0,35,24
1683644123740,MUS 8,A01,186930,Staff,0,26,35,35
1683644124767,MUS 15,A01,186932,Staff,0,16,35,35
1683644124767,MUS 15,B01,186934,Staff,0,17,35,35
1683644125795,MUS 80,A00,186935,Staff,0,0,20,20
1683644125795,MUS 80,B00,186936,Staff,24,0,25,1
1683644126819,NANO 11,A00,204702,Lipomi; Darren John,0,0,0,0
1683644127850,NANO 15,A01,204709,Yang; Kesong,0,1,0,0
1683644128876,NANO 114,A00,202069,Jahed Motlagh; Zeinab,3,0,10,7
1683644129906,PHIL 1,A00,186955,Grush; Rick Scott,31,0,40,9
1683644130932,PHIL 10,A01,186973,Grush; Rick Scott,27,0,35,8
1683644130932,PHIL 10,A02,186974,Grush; Rick Scott,33,0,35,2
1683644131957,PHIL 13,A01,186976,Staff,3,0,35,32
1683644131957,PHIL 13,A02,186977,Staff,16,0,35,19
1683644132984,PHIL 14,A01,186979,Staff,31,0,35,4
1683644132984,PHIL 14,A02,186986,Staff,32,0,35,3
1683644134010,PHIL 28,A01,186988,Staff,16,0,30,14
1683644134010,PHIL 28,A02,186989,Staff,1,0,30,29
1683644134010,PHIL 28,A03,186990,Staff,10,0,30,20
1683644134010,PHIL 28,A04,186991,Staff,26,0,30,4
1683644135036,PHIL 120,A00,186997,Staff,23,0,40,17
1683644136059,PHIL 137,A00,187003,Staff,7,0,40,33
1683644137088,PHIL 150,A00,187015,Staff,47,0,70,23
1683644138113,PHIL 167,A00,187021,Lamey; Andy M.,34,0,40,6
1683644139145,PHIL 174,A01,202226,Staff,17,0,20,3
1683644139145,PHIL 174,A02,202235,Staff,20,0,20,0
1683644140170,PHIL 191A,A00,258918,Staff,0,0,1,1
1683644141195,PHYS 1A,A00,187028,Staff,27,0,60,33
1683644142226,PHYS 1AL,001,187036,Staff,3,0,30,27
1683644142226,PHYS 1AL,002,187049,Staff,18,0,30,12
1683644143322,PHYS 1B,A00,187058,Staff,22,0,60,38
1683644144348,PHYS 1BL,001,187064,Staff,0,1,30,30
1683644144348,PHYS 1BL,002,187070,Staff,4,0,30,26
1683644145376,PHYS 1C,A00,187082,Staff,29,0,120,91
1683644146401,PHYS 1CL,001,187088,Staff,0,9,30,30
1683644146401,PHYS 1CL,002,187089,Staff,0,1,30,30
1683644146401,PHYS 1CL,009,262693,Staff,9,0,30,21
1683644147428,PHYS 2B,A01,187097,Staff,55,0,115,60
1683644148455,PHYS 2C,A01,187099,Staff,64,0,115,51
1683644149480,PHYS 2CL,A01,187101,Staff,5,0,28,23
1683644149480,PHYS 2CL,A02,187102,Staff,15,0,28,13
1683644150505,PHYS 2D,A01,187123,Shotwell; Brian,95,0,115,20
1683644151530,PHYS 4B,A01,187133,Grinstein; Benjamin,35,0,50,15
1683644152554,POLI 10,A00,188819,Staff,0,4,50,50
1683644153579,POLI 11,A00,188827,Staff,43,0,50,7
1683644154605,POLI 13R,A00,188828,Staff,0,1,20,20
1683644155634,POLI 27,A01,188830,Elgin; Samuel Zincke,0,2,70,70
1683644156658,POLI 30,A00,188832,Desposato; Scott,30,0,50,20
1683644157684,POLI 102F,A00,188834,Staff,0,0,40,40
1683644158708,POLI 104A,A00,188852,Staff,13,0,30,17
1683644159732,POLI 104I,A00,188853,Staff,0,7,20,20
1683644160757,POLI 110B,A00,188854,Wiens; David,7,0,20,13
1683644161792,POLI 112A,A00,188855,Wiens; David,4,0,30,26
1683644162817,POLI 117R,A00,188856,Forman; Fonna,0,12,20,20
1683644163843,POLI 118,A00,188857,Ingham; Sean,8,0,20,12
1683644164867,POLI 120G,A00,188858,Staff,8,0,30,22
1683644165892,POLI 131CR,A00,188863,Hoston; Germaine,21,0,50,29
1683644166918,POLI 133,A00,188864,Nellis; Gareth Hb,44,0,50,6
1683644168019,POLI 134D,A00,188865,Desposato; Scott,27,0,30,3
1683644169046,POLI 142A,A00,188871,Gartzke; Erik,21,0,50,29
1683644170069,POLI 142K,A00,188874,Staff,38,0,50,12
1683644171093,POLI 143,A00,188940,Gartzke; Erik,16,0,30,14
1683644172120,POLI 153,A00,188943,Staff,2,0,20,18
1683644173146,POLI 160AA,A00,188944,Staff,11,0,40,29
1683644174171,POLI 170A,A00,188945,Staff,11,0,30,19
1683644176219,PSYC 1,A00,188952,Staff,36,0,90,54
1683644177242,PSYC 2,B00,188953,Staff,19,0,35,16
1683644178267,PSYC 6,A00,188970,Staff,47,0,60,13
1683644179293,PSYC 7,A00,188973,Staff,35,0,45,10
1683644180318,PSYC 60,A01,188980,Rickard; Timothy C.,42,0,60,18
1683644181347,PSYC 70,A01,189001,Steiner; Eric Tomas,23,0,45,22
1683644182375,PSYC 100,A00,189005,Lacefield; Katharine I,0,99,120,120
1683644183401,PSYC 102,A00,189008,Staff,8,0,30,22
1683644184426,PSYC 106,B00,189026,Gorman; Michael R.,27,0,60,33
1683644185455,PSYC 114,B01,189033,Winkielman; Piotr,0,31,30,30
1683644186484,PSYC 131,A00,189036,Anagnostaras; Stephan,0,43,60,60
1683644187511,PSYC 136,A00,189041,Lowe; Angela Beth,0,7,25,25
1683644188535,PSYC 137,A00,189057,Winkielman; Piotr,0,37,25,25
1683644189563,PSYC 144,A00,189107,Wixted; John T,0,10,50,50
1683644191619,PSYC 162,A00,189142,Staff,0,9,85,85
1683644192645,PSYC 172,A00,189144,Gorman; Michael R.,0,6,30,30
1683644194695,PSYC 179,A00,189146,Lacefield; Katharine I,0,86,120,120
1683644195721,PSYC 181,A00,189147,Anagnostaras; Stephan,0,44,90,90
1683644196751,PSYC 190R,A00,189148,Barner; David A.,0,23,80,80
1683644197776,PSYC 191,A00,189275,Rickard; Timothy C.,0,10,25,25
1683644198801,PSYC 193,A00,189276,Chapman; Eddie Nathaniel,0,1,0,4
1683644199829,PSYC 193L,A01,189281,Lowe; Angela Beth,10,0,20,10
1683644199829,PSYC 193L,B01,189285,Staff,28,0,35,7
1683644200856,RELI 149,A00,187137,Rahimi; Babak,7,0,40,33
1683644201885,SE 9,A01,187315,Staff,0,2,18,18
1683644202911,SE 101B,A00,187409,Staff,24,0,30,6
1683644203936,SE 110B,A00,187444,Staff,10,0,40,30
1683644204965,SE 130B,A00,187449,Staff,31,0,40,9
1683644205989,SE 150A,A00,187516,Staff,9,0,20,11
1683644207017,SE 154,A00,187528,Staff,29,0,50,21
1683644208046,SIO 3,A01,258171,Staff,35,0,40,5
1683644209070,SIO 10,A00,187144,Cook; Geoffrey W,0,6,75,75
1683644210095,SIO 45,A00,187152,Cook; Geoffrey W,0,4,100,100
1683644211122,SIO 109R,A00,194486,Staff,0,4,20,20
1683644213171,SIO 187,A01,187233,Kacev; David,12,0,40,28
1683644214209,SOCI 1,A01,258656,Thorpe; Charles Robert,28,0,30,2
1683644214209,SOCI 1,A02,258658,Thorpe; Charles Robert,30,0,30,0
1683644214209,SOCI 1,A03,258661,Thorpe; Charles Robert,25,0,25,0
1683644214209,SOCI 1,A04,258666,Thorpe; Charles Robert,22,0,25,3
1683644214209,SOCI 1,A05,258897,Thorpe; Charles Robert,22,0,25,3
1683644214209,SOCI 1,A06,258898,Thorpe; Charles Robert,25,0,25,0
1683644215237,SOCI 30,A01,258903,Pardo Guerra; Juan Pablo,14,0,30,16
1683644216261,SOCI 102,A00,258904,Staff,9,0,25,16
1683644217285,SOCI 106,A00,258905,Staff,19,0,25,6
1683644218308,SOCI 111,A00,258907,Ribas Norris; Janet Vanesa,26,0,30,4
1683644219333,SOCI 121R,A00,258908,Pardo Guerra; Juan Pablo,8,0,30,22
1683644220360,SOCI 126,A01,203330,Staff,14,0,20,6
1683644221386,SOCI 131,A00,258909,Thorpe; Charles Robert,30,0,60,30
1683644222409,SOCI 135,A00,258910,Payne; Christine Anna,0,11,30,30
1683644223434,SOCI 157,A00,258911,Staff,12,0,30,18
1683644224459,SOCI 184,A00,258912,Staff,25,0,30,5
1683644225498,SOCI 188D,A00,258913,Staff,22,0,30,8
1683644226523,SYN 2,001,187529,Staff,9,0,16,7
1683644226523,SYN 2,002,201452,Staff,0,20,16,16
1683644226523,SYN 2,003,201469,Staff,2,0,16,14
1683644227551,SYN 100,A01,187531,Staff,0,9,20,20
1683644227551,SYN 100,B01,201491,Staff,0,10,20,20
1683644228580,TDAC 1,A00,189286,Walsh; Kim C.,3,0,20,17
1683644228580,TDAC 1,B00,189287,Harting; Carla Kelso,10,0,20,10
1683644229609,TDAC 101,A00,189300,Walsh; Kim C.,16,0,20,4
1683644229609,TDAC 101,B00,189301,Harting; Carla Kelso,18,0,20,2
1683644230638,TDAC 102,A00,189304,Basso; Beatrice,14,0,20,6
1683644231662,TDAC 108,A00,189305,Staff,18,0,20,2
1683644232694,TDDE 131,A00,189310,Staff,19,0,20,1
1683644232694,TDDE 131,B00,189314,Staff,19,0,20,1
1683644232694,TDDE 131,C00,189315,Staff,48,0,50,2
1683644232694,TDDE 131,D00,189316,Staff,14,0,15,1
1683644232694,TDDE 131,E00,204841,Staff,20,0,20,0
1683644233719,TDGE 10,A00,189289,Staff,27,0,50,23
1683644233719,TDGE 10,B00,189290,Havis; Allan,0,0,50,50
1683644234748,TDGE 11,A00,189291,Fulton; Julia,0,4,50,50
1683644234748,TDGE 11,B00,189292,Staff,20,0,25,5
1683644234748,TDGE 11,C00,260270,Staff,0,0,0,0
1683644235774,TDGE 25,A00,189294,Staff,2,0,20,18
1683644236800,TDGE 124,A00,189318,Fulton; Julia,0,8,50,50
1683644237828,TDGE 125,A00,189319,Staff,13,0,25,12
1683644237828,TDGE 125,B00,189320,Staff,23,0,25,2
1683644238856,TDGE 127,A00,189322,Havis; Allan,0,0,50,50
1683644239885,TDHT 101,A00,189323,Staff,18,0,25,7
1683644239885,TDHT 101,B00,189324,Staff,25,0,25,0
1683644240913,TDHT 102,A00,189325,Staff,49,0,50,1
1683644241941,TDMV 1,A00,189295,Arcidiacono; Kristin,20,0,30,10
1683644241941,TDMV 1,B00,189296,Caligagan; Maria T.,24,0,30,6
1683644242974,TDMV 2,A00,189297,Sammartano; Tonnie,27,0,30,3
1683644242974,TDMV 2,B00,189299,Arcidiacono; Kristin,23,0,30,7
1683644244001,TDMV 3,A00,204998,Rincon; Alicia,22,0,30,8
1683644245026,TDMV 120,A00,189458,Sammartano; Tonnie,28,0,30,2
1683644246051,TDMV 138,A00,189541,Jun; Grace Shin Hae,20,0,40,20
1683644247140,TDMV 142,A00,189717,Caligagan; Tony,25,0,30,5
1683644247140,TDMV 142,B00,189718,Caligagan; Maria T.,25,0,30,5
1683644248164,TMC 2,A01,187533,Staff,25,0,25,0
1683644248164,TMC 2,A02,187534,Staff,25,0,25,0
1683644249190,USP 1,A01,187536,Kwak; Nancy,0,16,25,25
1683644250217,USP 5,A01,187538,Staff,9,0,25,16
1683644251242,USP 101,A00,199253,Staff,0,4,0,0
1683644252267,USP 124,A00,187562,Boomhower; Matthew Charles,0,0,30,30
1683644253292,USP 138,A00,187582,Staff,20,0,25,5
1683644254315,USP 152,A01,187597,Staff,3,0,25,22
1683644255339,USP 153,A00,187598,Staff,19,0,25,6
1683644256366,USP 168,A00,187607,Kwak; Nancy,2,0,5,3
1683644257391,USP 173,A00,187619,Staff,4,0,25,21
1683644258416,USP 181,A00,187638,Staff,0,4,25,25
1683644259442,VIS 103,A00,187650,Cruz; Edwin Teddy,18,0,75,57
1683644260468,VIS 110D,A00,187669,Staff,13,0,22,9
1683644261498,VIS 127C,A00,187720,Shen; Kuiyi,67,0,146,79
1683644262525,VIS 149,A00,187731,Yoldas; Pinar,0,14,22,22
1683644263551,VIS 151,A01,188091,Staff,22,0,34,12
1683644263551,VIS 151,A02,188092,Staff,11,0,34,23
1683644264582,VIS 160B,A00,188093,Stalbaum; Brett,0,1,10,10
1683644266637,WCWP 10B,A00,201720,Staff,10,0,15,5
1683644266637,WCWP 10B,B00,201722,Staff,9,0,15,6
1683644267664,WCWP 100,A00,201725,Gagnon; Jeffrey C,0,0,2,2
1683644267664,WCWP 100,B00,201727,Staff,0,4,15,15
1683644270784,ANBI 133,A00,258401,Wilder; Linnea Lorene,34,0,40,6
1683644271808,ANBI 140,A00,258395,Hrvoj Mihic; Branka,18,0,25,7
1683644272833,ANSC 120,A00,258402,Bialecki; Jon Anthony,27,0,40,13
1683644273858,ANSC 144,A00,258400,Staff,12,0,40,28
1683644275916,ANSC 166,A00,258396,Parish; Steven Martin,156,0,175,19
1683644276944,ANSC 180,A00,193533,Staff,8,0,20,12
1683644277971,ANSC 188,A00,258397,Jassal; Aftab,34,0,40,6
1683644279000,ANTH 3,A01,258316,Staff,23,0,30,7
1683644280032,ANTH 5,A00,258394,Semendeferi; Ekaterini,16,0,20,4
1683644281058,ANTH 21,A01,258331,Staff,4,0,40,36
1683644282085,ANTH 103,A00,258398,Varma; Saiba,15,0,25,10
1683644283119,AWP 10,001,202034,Staff,0,0,0,0
1683644283119,AWP 10,002,202035,Staff,0,0,0,0
1683644283119,AWP 10,003,202036,Staff,0,0,0,0
1683644283119,AWP 10,004,202037,Staff,0,0,0,0
1683644283119,AWP 10,005,202038,Staff,0,0,0,0
1683644283119,AWP 10,006,202039,Staff,0,0,0,0
1683644283119,AWP 10,007,202040,Staff,0,0,0,0
1683644283119,AWP 10,008,202041,Staff,0,0,0,0
1683644283119,AWP 10,009,202042,Staff,0,0,0,0
1683644283119,AWP 10,010,202043,Staff,0,0,0,0
1683644283119,AWP 10,011,202044,Staff,0,0,0,0
1683644283119,AWP 10,012,202045,Staff,0,0,0,0
1683644283119,AWP 10,013,202046,Staff,0,0,0,0
1683644283119,AWP 10,014,202047,Staff,0,0,0,0
1683644283119,AWP 10,015,202048,Staff,0,0,0,0
1683644283119,AWP 10,016,202049,Staff,0,0,0,0
1683644283119,AWP 10,017,202050,Staff,0,0,0,0
1683644283119,AWP 10,018,202051,Staff,0,0,0,0
1683644283119,AWP 10,019,202052,Staff,0,0,0,0
1683644283119,AWP 10,020,202053,Staff,0,0,0,0
1683644283119,AWP 10,021,202054,Staff,0,0,0,0
1683644283119,AWP 10,022,202055,Staff,0,0,0,0
1683644283119,AWP 10,023,202056,Staff,0,0,0,0
1683644283119,AWP 10,024,202057,Staff,0,0,0,0
1683644283119,AWP 10,025,202058,Staff,0,0,0,0
1683644283119,AWP 10,026,202059,Staff,0,0,0,0
1683644284147,AWP 102,001,202032,Staff,0,0,0,0
1683644284147,AWP 102,002,202033,Staff,0,0,0,0
1683644285177,BENG 100,A01,254234,Taylor Amos; Alyssa C,31,0,40,9
1683644286206,BENG 196,001,270013,Engler; Adam J.,9999,0,9999,0
1683644287237,BICD 100R,A01,202018,Smith; Laurie,0,7,32,32
1683644287237,BICD 100R,A02,202019,Smith; Laurie,0,3,32,32
1683644287237,BICD 100R,A03,202020,Smith; Laurie,0,1,32,32
1683644287237,BICD 100R,A04,202021,Smith; Laurie,6,0,32,26
1683644287237,BICD 100R,A05,202022,Smith; Laurie,11,0,32,21
1683644288268,BICD 136,A01,193242,Gustafson-Brown; Cindy,0,2,32,32
1683644288268,BICD 136,A02,193244,Gustafson-Brown; Cindy,13,0,32,19
1683644289299,BIEB 102,A01,193249,Butler; Shannon Rhey,0,2,32,32
1683644289299,BIEB 102,A02,193251,Butler; Shannon Rhey,0,0,32,32
1683644289299,BIEB 102,A03,193253,Butler; Shannon Rhey,0,0,32,32
1683644289299,BIEB 102,A04,193255,Butler; Shannon Rhey,14,0,32,18
1683644289299,BIEB 102,A05,193265,Butler; Shannon Rhey,26,0,32,6
1683644289299,BIEB 102,A06,193269,Butler; Shannon Rhey,14,0,32,18
1683644291351,BIEB 150,A01,193274,Staff,0,0,32,32
1683644291351,BIEB 150,A02,193285,Staff,24,0,32,8
1683644292378,BIEB 194,A00,193286,Kurle; Carolyn M.,20,0,32,12
1683644293406,BILD 1,A01,192291,Staff,15,0,32,17
1683644293406,BILD 1,A02,192292,Staff,30,0,32,2
1683644293406,BILD 1,B01,192520,Reuther; Keefe,0,1,0,0
1683644293406,BILD 1,B02,192532,Reuther; Keefe,0,1,0,0
1683644294437,BILD 3,A01,192556,Butler; Shannon Rhey,0,0,32,32
1683644294437,BILD 3,A02,192581,Butler; Shannon Rhey,1,0,32,31
1683644294437,BILD 3,A03,192611,Butler; Shannon Rhey,21,0,32,11
1683644294437,BILD 3,A04,192612,Butler; Shannon Rhey,24,0,32,8
1683644294437,BILD 3,A05,192613,Butler; Shannon Rhey,26,0,32,6
1683644294437,BILD 3,A06,192679,Butler; Shannon Rhey,27,0,32,5
1683644294437,BILD 3,A07,192682,Butler; Shannon Rhey,20,0,32,12
1683644295468,BILD 4,A01,192836,Reuther; Keefe,0,0,24,24
1683644295468,BILD 4,A02,193044,Reuther; Keefe,4,0,24,20
1683644296498,BILD 10,A01,193142,Gustafson-Brown; Cindy,29,0,32,3
1683644296498,BILD 10,A02,193149,Gustafson-Brown; Cindy,31,0,32,1
1683644297526,BIMM 100,A01,193301,Staff,0,6,32,32
1683644297526,BIMM 100,A02,193312,Staff,0,7,32,32
1683644297526,BIMM 100,A03,193323,Staff,0,9,32,32
1683644298553,BIMM 101,A01,193329,McDonnell; Lisa Marie,0,4,24,24
1683644298553,BIMM 101,A02,193339,McDonnell; Lisa Marie,0,3,24,24
1683644298553,BIMM 101,B01,193354,McDonnell; Lisa Marie,0,4,24,24
1683644298553,BIMM 101,B02,193357,McDonnell; Lisa Marie,0,3,24,24
1683644299579,BIMM 110,A01,193377,Tat; John,0,11,32,32
1683644299579,BIMM 110,A02,193378,Tat; John,0,10,32,32
1683644300606,BIMM 120,A01,206116,Staff,0,0,32,32
1683644300606,BIMM 120,A02,206117,Staff,6,0,32,26
1683644300606,BIMM 120,A03,206121,Staff,21,0,32,11
1683644301632,BIPN 100,A01,193393,Park; Ji Young,0,14,32,32
1683644301632,BIPN 100,A02,193402,Park; Ji Young,0,14,32,32
1683644301632,BIPN 100,A03,193413,Park; Ji Young,0,14,32,32
1683644301632,BIPN 100,A04,193414,Park; Ji Young,0,13,32,32
1683644302661,BIPN 102,A01,193429,Staff,0,0,32,32
1683644302661,BIPN 102,A02,193438,Staff,18,0,32,14
1683644303687,BIPN 106,A01,193450,Reyes Gonzalez; Catalina,0,2,40,40
1683644304718,BIPN 134,A01,193465,Cooke; James Edward,0,0,32,32
1683644304718,BIPN 134,A02,193474,Cooke; James Edward,25,0,32,7
1683644304718,BIPN 134,A03,193485,Cooke; James Edward,29,0,32,3
1683644304718,BIPN 134,A04,193486,Cooke; James Edward,20,0,32,12
1683644304718,BIPN 134,A05,193491,Cooke; James Edward,31,0,32,1
1683644304718,BIPN 134,A06,193501,Cooke; James Edward,30,0,32,2
1683644304718,BIPN 134,A07,193510,Cooke; James Edward,29,0,32,3
1683644306774,BISP 194,A00,222522,Staff,14,0,32,18
1683644307800,CAT 124,A01,202407,Staff,19,0,25,6
1683644308825,CAT 125,A00,202408,Marchisotto; Jennifer Anne,2,0,20,18
1683644309857,CAT 125R,A00,202409,Smith; Lauryn Alissa,0,11,20,20
1683644309857,CAT 125R,B00,202410,Morales; Celeste Georgianna,0,11,20,20
1683644309857,CAT 125R,C00,202411,Irwin; Matthew Joseph,0,12,20,20
1683644310888,CENG 15,A01,204712,Yang; Kesong,0,1,0,0
1683644311915,CENG 114,A00,202070,Jahed Motlagh; Zeinab,5,0,20,15
1683644312941,CGS 105,A00,185477,Wesling; Megan E.,24,0,40,16
1683644313966,CGS 106,A00,185494,Staff,11,0,22,11
1683644314992,CGS 108,A00,185495,Staff,14,0,20,6
1683644316016,CGS 114,A00,185496,Staff,13,0,18,5
1683644317044,CGS 119,A00,185501,Staff,15,0,20,5
1683644318071,CGS 120,A00,185511,Staff,12,0,20,8
1683644319101,CHEM 4,A01,184675,Bussey; Thomas J,97,0,100,3
1683644320125,CHEM 6A,A01,184677,Staff,33,0,60,27
1683644321149,CHEM 6B,A01,184679,Staff,63,0,100,37
1683644322174,CHEM 6C,A01,184681,Bussey; Thomas J,0,0,50,50
1683644322174,CHEM 6C,A02,184682,Bussey; Thomas J,32,0,50,18
1683644323203,CHEM 40A,A01,184684,Albizati; Kim F.,34,0,100,66
1683644324226,CHEM 40B,A01,184686,Albizati; Kim F.,0,22,100,100
1683644325250,CHEM 41B,A01,184690,Staff,51,0,100,49
1683644326275,COGS 3,A01,184715,Boyle; Mary E. T.,0,27,40,40
1683644327301,COGS 14B,A01,185172,Staff,0,14,38,38
1683644328329,COGS 18,A01,184736,Staff,15,0,80,65
1683644329354,COGS 100,A01,184932,Staff,0,7,73,73
1683644330379,COGS 101A,A01,184935,Staff,0,39,30,30
1683644331404,COGS 101B,A01,184944,Staff,0,2,30,30
1683644332427,COGS 101C,A01,184946,Staff,0,10,30,30
1683644333453,COGS 102A,A01,184951,Johnson; Christine M.,2,0,40,38
1683644334483,COGS 107B,A01,184953,Mooshagian; Eric Frederick,0,51,40,40
1683644335511,COGS 118B,A01,184959,Gupta; Anjum,0,49,40,40
1683644336538,COGS 153,A00,184961,Staff,0,16,30,30
1683644337567,COGS 177,A00,184962,Staff,0,21,30,30
1683644338592,COGS 187A,A01,184969,Boyle; Mary E. T.,0,19,40,40
1683644339618,COMM 10,A01,185174,Staff,0,5,25,25
1683644339618,COMM 10,A02,185189,Staff,0,2,25,25
1683644339618,COMM 10,A03,269821,Staff,0,1,0,0
1683644340642,COMM 100B,A01,185475,Staff,0,1,0,2
1683644340642,COMM 100B,A02,185476,Staff,12,0,25,13
1683644341676,COMM 100C,A01,185314,Staff,1,0,25,24
1683644341676,COMM 100C,A02,185327,Staff,18,0,25,7
1683644342702,COMM 110M,A00,185349,Staff,0,0,40,40
1683644343729,COMM 113T,A00,185352,Staff,25,0,40,15
1683644344755,COMM 114I,A00,185353,Staff,31,0,40,9
1683644345781,COMM 131,A00,185354,Staff,17,0,30,13
1683644346807,CSE 8A,A50,185358,Cao; Yingjun,0,46,10,10
1683644347834,CSE 8B,A01,185362,Staff,0,48,50,50
1683644348859,CSE 11,A01,185416,Cao; Yingjun,0,91,10,10
1683644349886,CSE 20,A01,185445,Briones; Jor-el Thomas Caparas,4,0,25,21
1683644350966,CSE 21,A01,185447,Staff,9,0,50,41
1683644351990,CSE 101,A01,185451,Staff,0,13,50,50
1683644351990,CSE 101,B01,185453,Jones; Miles E,0,13,50,50
1683644354045,CSE 141,A01,185458,Eldon; John,15,0,100,85
1683644355074,CSE 141L,A01,185461,Eldon; John,7,0,100,93
1683644356102,CSE 142,A01,185463,Staff,36,0,60,24
1683644356102,CSE 142,B01,201355,Staff,0,7,60,60
1683644357126,CSE 142L,A01,185470,Staff,36,0,60,24
1683644357126,CSE 142L,B01,201417,Staff,0,6,60,60
1683644358152,CSE 190,A00,201433,Staff,32,0,49,17
1683644359179,DOC 1,A01,259136,Strom; Megan C.,7,0,15,8
1683644359179,DOC 1,A02,259137,Strom; Megan C.,14,0,15,1
1683644359179,DOC 1,A03,259138,Strom; Megan C.,14,0,15,1
1683644359179,DOC 1,A04,259139,Strom; Megan C.,14,0,15,1
1683644360206,DOC 100D,A00,259140,Pass; Natalye Joann,14,0,25,11
1683644361234,DSGN 1,A01,184749,Rill; Bryan,0,26,30,30
1683644362257,DSGN 100,A01,185168,Staff,0,2,25,25
1683644363283,ECE 5,A01,185626,Morris; Karcher William,0,11,0,0
1683644364313,ECE 101,A01,185628,Staff,14,0,70,56
1683644365337,ECE 107,A01,185635,Baghdadchi; Saharnaz,0,0,20,20
1683644365337,ECE 107,A02,185638,Baghdadchi; Saharnaz,3,0,20,17
1683644366363,ECE 148,A01,185647,Silberman; Jack,0,0,16,16
1683644367387,ECON 1,A01,185537,Crane; Meredith Helen,54,0,70,16
1683644368410,ECON 3,A01,185549,Crane; Meredith Helen,29,0,70,41
1683644369436,ECON 4,A01,203354,Anderson; John Charles,0,5,10,10
1683644370459,ECON 100A,A01,185574,Staff,0,5,40,40
1683644371485,ECON 100B,A01,185576,Staff,0,12,50,50
1683644372515,ECON 100C,A01,185589,Newhouse; Herbert S,30,0,70,40
1683644373542,ECON 105,A00,185608,Vespa; Emanuel Ignacio,19,0,35,16
1683644374572,ECON 109,A01,185610,Shishkin; Denis,9,0,35,26
1683644375598,ECON 110A,A01,185612,Staff,9,0,40,31
1683644376628,ECON 120A,A01,185615,Staff,20,0,40,20
1683644377655,ECON 120C,A01,185617,Sun; Yixiao,0,20,70,70
1683644378681,ECON 144,A00,203346,Squires; Dale E,2,0,35,33
1683644379708,ECON 171,A01,203349,Newhouse; Herbert S,0,1,35,35
1683644380733,ECON 173A,A01,185621,Toda; Alexis Akira,21,0,35,14
1683644381765,EDS 25,A01,202413,Staff,0,1,0,0
1683644381765,EDS 25,A02,202414,Staff,0,1,0,0
1683644381765,EDS 25,A03,202415,Staff,0,0,0,0
1683644381765,EDS 25,A04,202416,Staff,0,1,0,0
1683644381765,EDS 25,A05,202439,Staff,0,0,0,0
1683644381765,EDS 25,A06,202440,Staff,0,0,0,0
1683644381765,EDS 25,B01,202631,Staff,0,0,0,0
1683644381765,EDS 25,B02,202632,Staff,0,0,0,0
1683644381765,EDS 25,B03,202639,Staff,0,0,0,0
1683644381765,EDS 25,B04,202640,Staff,0,0,0,0
1683644381765,EDS 25,B05,202643,Staff,0,0,0,0
1683644381765,EDS 25,B06,202644,Staff,0,0,0,0
1683644382796,EDS 38,A01,202659,Black; Alison Michelle,24,0,25,1
1683644383824,EDS 115,A00,202652,Staff,18,0,30,12
1683644384851,EDS 125,A00,202649,Staff,13,0,30,17
1683644385878,EDS 126,A01,203332,Staff,30,0,30,0
1683644386905,EDS 139,A00,202838,Staff,16,0,25,9
1683644387933,EDS 146,A01,202655,Staff,14,0,25,11
1683644388958,ENG 15,A00,185667,Staff,0,1,0,0
1683644388958,ENG 15,B00,185672,Staff,0,0,0,0
1683644388958,ENG 15,C00,185675,Staff,0,0,0,0
1683644388958,ENG 15,D00,185682,Staff,0,0,0,0
1683644388958,ENG 15,E00,185684,Staff,0,0,0,0
1683644389982,ETHN 103,A00,185710,Staff,0,8,35,35
1683644391011,ETHN 103A,A00,199228,Man; Simeon S,0,0,9,9
1683644392036,ETHN 109,A00,185711,Staff,16,0,35,19
1683644393064,ETHN 142,A00,185726,Staff,0,4,30,30
1683644394089,ETHN 163J,A00,199229,Man; Simeon S,5,0,8,3
1683644395114,ETHN 168,A00,185727,Staff,7,0,10,3
1683644396141,ETHN 182,A00,185728,Staff,0,0,35,35
1683644397167,ETHN 183,A00,185737,Staff,9,0,18,9
1683644398189,GLBH 111,A01,209361,Burgos; Jose L.,0,0,0,0
1683644400246,HIEU 104,A00,185792,Staff,14,0,20,6
1683644401269,HIEU 115,A00,185800,Staff,0,0,20,20
1683644402299,HIEU 128,A00,185801,Staff,0,9,20,20
1683644403323,HIEU 147,A00,185802,Staff,15,0,20,5
1683644404346,HIEU 154,A00,185823,Staff,11,0,20,9
1683644405370,HILA 102,A00,185826,Staff,14,0,20,6
1683644406399,HILD 2C,A01,185778,Staff,0,13,20,20
1683644407430,HILD 7B,A01,185780,Kwak; Nancy,0,16,32,32
1683644407430,HILD 7B,A02,185781,Kwak; Nancy,0,18,32,32
1683644408458,HILD 30,A01,185791,Staff,12,0,20,8
1683644409484,HISC 119,A00,185830,Golan; Tal,0,9,20,20
1683644410512,HITO 156GS,A00,185831,Patterson; Patrick H.,0,0,0,23
1683644411540,HIUS 103,A00,185832,Man; Simeon S,0,4,20,20
1683644412565,HIUS 117,A00,185836,Kwak; Nancy,2,0,20,18
1683644413594,HIUS 125,A00,185840,Man; Simeon S,0,1,23,23
1683644414619,HIUS 149,A00,185845,Staff,1,0,20,19
1683644415646,HUM 3,A01,185882,Zavodny; Tatiana Sophia,0,7,50,50
1683644415646,HUM 3,B01,185899,Caldwell; Michael Alan,0,18,50,50
1683644416671,HUM 3GS,A00,185900,Patterson; Patrick H.,0,0,0,23
1683644417698,HUM 4,A01,185938,Zroka; Amy Liane,30,0,50,20
1683644417698,HUM 4,B01,185956,Watkins; Eric,0,4,50,50
1683644417698,HUM 4,B02,202209,Watkins; Eric,0,4,50,50
1683644417698,HUM 4,B03,202210,Watkins; Eric,0,4,50,50
1683644418725,HUM 5,A01,185958,West; Geoffrey Scott,2,0,50,48
1683644418725,HUM 5,A02,202215,West; Geoffrey Scott,0,0,50,50
1683644419751,INTL 190,A00,185959,Gagnon; Jeffrey C,0,0,0,9
1683644419751,INTL 190,B00,185960,Lettieri; Michael Joseph,0,0,0,2
1683644420776,JAPN 180,A00,254509,Staff,5,0,30,25
1683644421808,LATI 10,A01,202853,Kennemore; Amy Michelle,4,0,35,31
1683644421808,LATI 10,A02,202854,Kennemore; Amy Michelle,2,0,35,33
1683644421808,LATI 10,A03,270054,Kennemore; Amy Michelle,30,0,30,0
1683644422836,LATI 180,A00,202855,Kennemore; Amy Michelle,11,0,20,9
1683644423862,LAWS 101,A00,201767,Golan; Tal,0,7,40,40
1683644424891,LIFR 1C,A00,185961,Staff,6,0,20,14
1683644425916,LIFR 1CX,A00,185962,Staff,7,0,20,13
1683644426943,LIFR 1D,A00,185963,Staff,7,0,20,13
1683644427969,LIFR 1DX,A00,185964,Staff,7,0,20,13
1683644428993,LIGN 101,A01,186039,Staff,43,0,50,7
1683644430019,LIGN 165,A00,186040,Staff,15,0,50,35
1683644431046,LTCS 108,A00,186041,Staff,5,0,10,5
1683644432071,LTCS 119,A00,186042,Staff,15,0,20,5
1683644433101,LTCS 130,A00,186043,Wesling; Megan E.,15,0,25,10
1683644435152,LTEA 138,A00,186119,Staff,14,0,40,26
1683644436180,LTEN 124,A00,186148,Staff,5,0,25,20
1683644437204,LTEN 178,A00,186149,Staff,7,0,15,8
1683644438229,LTEN 181,A00,186150,Blanco; John D,34,0,40,6
1683644439256,LTWL 120,A00,186160,Staff,20,0,25,5
1683644440284,LTWL 165,A00,186161,Staff,22,0,25,3
1683644441312,LTWR 100,A00,186162,Staff,0,5,15,15
1683644442339,LTWR 102,A00,186163,Doller; Ben,5,0,15,10
1683644443364,MAE 8,A01,186412,Staff,0,0,0,0
1683644444390,MAE 30B,A00,186445,Bahadori; Mohammad Yousef,82,0,100,18
1683644445417,MAE 40,A00,186592,Bewley; Thomas R,10,0,50,40
1683644446443,MAE 101B,A00,186593,Bahadori; Mohammad Yousef,80,0,100,20
1683644447468,MAE 105,A00,186594,Bandaru; Prabhakar,10,0,50,40
1683644448497,MAE 107,A00,186599,Pham; Hieu Tan,0,7,120,120
1683644449525,MAE 148,A01,186660,Silberman; Jack,3,0,16,13
1683644450558,MATH 10A,A01,188095,Staff,0,5,35,35
1683644451585,MATH 10B,A01,188097,Bowers; Adam R.,0,11,30,30
1683644451585,MATH 10B,A02,188099,Bowers; Adam R.,0,11,30,30
1683644451585,MATH 10B,B01,188104,Bowers; Adam R.,0,10,30,30
1683644451585,MATH 10B,B02,188106,Bowers; Adam R.,1,9,30,29
1683644452611,MATH 10C,A01,188111,Staff,0,18,30,30
1683644452611,MATH 10C,A02,188127,Staff,0,19,30,30
1683644452611,MATH 10C,A03,188131,Staff,0,19,30,30
1683644452611,MATH 10C,B01,188218,Staff,17,0,30,13
1683644452611,MATH 10C,B02,188244,Staff,13,0,30,17
1683644452611,MATH 10C,B03,188277,Staff,14,0,30,16
1683644453636,MATH 18,A01,188344,Bach; Quang Tran,18,0,30,12
1683644453636,MATH 18,A02,188345,Bach; Quang Tran,11,0,30,19
1683644453636,MATH 18,B01,188353,Bach; Quang Tran,11,0,30,19
1683644453636,MATH 18,B02,188354,Bach; Quang Tran,19,0,30,11
1683644454723,MATH 20A,A01,188374,Staff,11,0,35,24
1683644455750,MATH 20B,A01,188382,Ohm; Ko Woon,7,0,30,23
1683644455750,MATH 20B,A02,188383,Ohm; Ko Woon,22,0,30,8
1683644455750,MATH 20B,B01,188385,Ohm; Ko Woon,7,0,30,23
1683644455750,MATH 20B,B02,188392,Ohm; Ko Woon,22,0,30,8
1683644456779,MATH 20C,A01,188394,Harel; Guershon,11,0,30,19
1683644456779,MATH 20C,A02,188395,Harel; Guershon,14,0,30,16
1683644456779,MATH 20C,B01,188404,Harel; Guershon,4,0,30,26
1683644456779,MATH 20C,B02,188405,Harel; Guershon,18,0,30,12
1683644457813,MATH 20D,A01,188414,Hammock; Frances H,0,1,30,30
1683644457813,MATH 20D,A02,188415,Hammock; Frances H,0,1,30,30
1683644457813,MATH 20D,B01,188447,Hammock; Frances H,0,1,30,30
1683644457813,MATH 20D,B02,188486,Hammock; Frances H,4,0,30,26
1683644458838,MATH 20E,A01,188649,Staff,21,0,30,9
1683644458838,MATH 20E,A02,188650,Staff,21,0,30,9
1683644458838,MATH 20E,A03,188673,Staff,0,0,30,30
1683644459863,MATH 102,A01,188675,Staff,0,36,35,35
1683644460891,MATH 103B,A01,188681,Staff,3,0,35,32
1683644460891,MATH 103B,B01,188692,Staff,5,0,35,30
1683644461923,MATH 109,A01,188695,Salehi Golsefidy; Alireza,24,0,35,11
1683644461923,MATH 109,A02,188696,Salehi Golsefidy; Alireza,25,0,35,10
1683644462948,MATH 120A,A01,188698,Eggers; John Dietrich,7,0,35,28
1683644463976,MATH 142B,A01,188736,Ioana; Adrian,0,1,30,30
1683644463976,MATH 142B,A02,188741,Ioana; Adrian,0,1,30,30
1683644463976,MATH 142B,A03,188743,Ioana; Adrian,0,1,30,30
1683644464999,MATH 168A,A01,188790,Staff,0,10,35,35
1683644466033,MATH 170A,A01,188803,Nie; Jiawang,0,2,35,35
1683644466033,MATH 170A,A02,188811,Nie; Jiawang,0,0,35,35
1683644466033,MATH 170A,A03,188814,Nie; Jiawang,0,0,35,35
1683644466033,MATH 170A,A04,188815,Nie; Jiawang,10,0,35,25
1683644467061,MATH 193B,A01,188817,Staff,0,0,35,35
1683644467061,MATH 193B,A02,188818,Staff,5,0,35,30
1683644468085,MGT 4,A01,202857,Anderson; John Charles,61,0,80,19
1683644469111,MGT 12,A00,202858,Lindenberger; Wade Douglas,40,0,90,50
1683644470136,MGT 18,A00,202859,Staff,74,0,90,16
1683644471161,MGT 18GS,A00,202860,McKay; Michael J,13,0,28,15
1683644472190,MGT 45,A00,202861,Pecore; Joseph P.,12,0,90,78
1683644473214,MGT 100,A00,202863,Yavorsky; Daniel Ryan,28,0,90,62
1683644474239,MGT 103,A00,202864,Ehrich; Kristine R,0,17,90,90
1683644475263,MGT 112,A00,202865,Ehrich; Kristine R,15,0,90,75
1683644476293,MGT 121A,A00,202868,Staff,0,20,0,0
1683644477321,MGT 131B,A00,202869,Anderson; John Charles,59,0,90,31
1683644478344,MGT 136,A00,202871,Lindenberger; Wade Douglas,83,0,90,7
1683644479371,MGT 164,A00,202873,Staff,0,66,90,91
1683644480400,MGT 164GS,A00,202874,McKay; Mary A,13,0,28,15
1683644481482,MGT 180,A00,202875,Staff,0,50,90,91
1683644482509,MMW 11R,A01,205019,Herbst; Matthew,2,0,30,28
1683644482509,MMW 11R,A02,205026,Herbst; Matthew,29,0,30,1
1683644483536,MMW 15,A01,193512,Chang; Edmond Yi-Teh,0,8,28,28
1683644483536,MMW 15,A02,193513,Chang; Edmond Yi-Teh,0,5,28,28
1683644483536,MMW 15,A03,193514,Chang; Edmond Yi-Teh,0,5,28,28
1683644483536,MMW 15,A04,193515,Chang; Edmond Yi-Teh,0,5,28,28
1683644483536,MMW 15,A05,193516,Chang; Edmond Yi-Teh,0,5,28,28
1683644483536,MMW 15,A06,193517,Chang; Edmond Yi-Teh,0,6,28,28
1683644483536,MMW 15,B01,193519,Chang; Edmond Yi-Teh,0,5,28,28
1683644483536,MMW 15,B02,193520,Chang; Edmond Yi-Teh,0,5,28,28
1683644483536,MMW 15,B03,193521,Chang; Edmond Yi-Teh,0,5,28,28
1683644483536,MMW 15,B04,193522,Chang; Edmond Yi-Teh,0,5,28,28
1683644483536,MMW 15,B05,193523,Chang; Edmond Yi-Teh,0,5,28,28
1683644483536,MMW 15,B06,193524,Chang; Edmond Yi-Teh,0,5,28,28
1683644484563,MMW 122,A01,193526,Rahimi; Babak,0,16,28,28
1683644484563,MMW 122,A02,193527,Rahimi; Babak,0,15,28,28
1683644484563,MMW 122,A03,193528,Rahimi; Babak,0,0,0,0
1683644484563,MMW 122,A04,193529,Rahimi; Babak,0,0,0,0
1683644485587,MUS 1A,A01,186663,Staff,1,20,35,34
1683644486625,MUS 4,A01,186715,Staff,0,12,35,35
1683644487655,MUS 5R,A01,186796,Dubnov; Shlomo,0,17,35,35
1683644488682,MUS 6,A01,186798,Staff,0,5,25,25
1683644489707,MUS 7,A01,186830,Staff,11,0,35,24
1683644490735,MUS 8,A01,186930,Staff,0,26,35,35
1683644491762,MUS 15,A01,186932,Staff,0,16,35,35
1683644491762,MUS 15,B01,186934,Staff,0,17,35,35
1683644492790,MUS 80,A00,186935,Staff,0,0,20,20
1683644492790,MUS 80,B00,186936,Staff,24,0,25,1
1683644493839,NANO 11,A00,204702,Lipomi; Darren John,0,0,0,0
1683644494866,NANO 15,A01,204709,Yang; Kesong,0,1,0,0
1683644495894,NANO 114,A00,202069,Jahed Motlagh; Zeinab,3,0,10,7
1683644496922,PHIL 1,A00,186955,Grush; Rick Scott,31,0,40,9
1683644497947,PHIL 10,A01,186973,Grush; Rick Scott,27,0,35,8
1683644497947,PHIL 10,A02,186974,Grush; Rick Scott,33,0,35,2
1683644498975,PHIL 13,A01,186976,Staff,3,0,35,32
1683644498975,PHIL 13,A02,186977,Staff,16,0,35,19
1683644500002,PHIL 14,A01,186979,Staff,31,0,35,4
1683644500002,PHIL 14,A02,186986,Staff,32,0,35,3
1683644501034,PHIL 28,A01,186988,Staff,16,0,30,14
1683644501034,PHIL 28,A02,186989,Staff,1,0,30,29
1683644501034,PHIL 28,A03,186990,Staff,10,0,30,20
1683644501034,PHIL 28,A04,186991,Staff,26,0,30,4
1683644502069,PHIL 120,A00,186997,Staff,23,0,40,17
1683644503095,PHIL 137,A00,187003,Staff,7,0,40,33
1683644504120,PHIL 150,A00,187015,Staff,47,0,70,23
1683644505147,PHIL 167,A00,187021,Lamey; Andy M.,34,0,40,6
1683644506180,PHIL 174,A01,202226,Staff,17,0,20,3
1683644506180,PHIL 174,A02,202235,Staff,20,0,20,0
1683644507205,PHIL 191A,A00,258918,Staff,0,0,1,1
1683644508232,PHYS 1A,A00,187028,Staff,27,0,60,33
1683644509260,PHYS 1AL,001,187036,Staff,3,0,30,27
1683644509260,PHYS 1AL,002,187049,Staff,18,0,30,12
1683644510287,PHYS 1B,A00,187058,Staff,22,0,60,38
1683644511311,PHYS 1BL,001,187064,Staff,0,1,30,30
1683644511311,PHYS 1BL,002,187070,Staff,4,0,30,26
1683644512340,PHYS 1C,A00,187082,Staff,29,0,120,91
1683644513367,PHYS 1CL,001,187088,Staff,0,9,30,30
1683644513367,PHYS 1CL,002,187089,Staff,0,1,30,30
1683644513367,PHYS 1CL,009,262693,Staff,9,0,30,21
1683644514393,PHYS 2B,A01,187097,Staff,55,0,115,60
1683644515423,PHYS 2C,A01,187099,Staff,64,0,115,51
1683644516446,PHYS 2CL,A01,187101,Staff,5,0,28,23
1683644516446,PHYS 2CL,A02,187102,Staff,15,0,28,13
1683644517471,PHYS 2D,A01,187123,Shotwell; Brian,95,0,115,20
1683644518498,PHYS 4B,A01,187133,Grinstein; Benjamin,35,0,50,15
1683644519529,POLI 10,A00,188819,Staff,0,4,50,50
1683644520552,POLI 11,A00,188827,Staff,43,0,50,7
1683644521582,POLI 13R,A00,188828,Staff,0,1,20,20
1683644522614,POLI 27,A01,188830,Elgin; Samuel Zincke,0,2,70,70
1683644523638,POLI 30,A00,188832,Desposato; Scott,30,0,50,20
1683644524668,POLI 102F,A00,188834,Staff,0,0,40,40
1683644525693,POLI 104A,A00,188852,Staff,13,0,30,17
1683644526718,POLI 104I,A00,188853,Staff,0,7,20,20
1683644527749,POLI 110B,A00,188854,Wiens; David,7,0,20,13
1683644528776,POLI 112A,A00,188855,Wiens; David,4,0,30,26
1683644529835,POLI 117R,A00,188856,Forman; Fonna,0,12,20,20
1683644530862,POLI 118,A00,188857,Ingham; Sean,8,0,20,12
1683644531885,POLI 120G,A00,188858,Staff,8,0,30,22
1683644532912,POLI 131CR,A00,188863,Hoston; Germaine,21,0,50,29
1683644533935,POLI 133,A00,188864,Nellis; Gareth Hb,44,0,50,6
1683644534964,POLI 134D,A00,188865,Desposato; Scott,27,0,30,3
1683644535991,POLI 142A,A00,188871,Gartzke; Erik,21,0,50,29
1683644537015,POLI 142K,A00,188874,Staff,38,0,50,12
1683644538039,POLI 143,A00,188940,Gartzke; Erik,16,0,30,14
1683644539062,POLI 153,A00,188943,Staff,2,0,20,18
1683644540085,POLI 160AA,A00,188944,Staff,11,0,40,29
1683644541113,POLI 170A,A00,188945,Staff,11,0,30,19
1683644543169,PSYC 1,A00,188952,Staff,36,0,90,54
1683644544192,PSYC 2,B00,188953,Staff,19,0,35,16
1683644545219,PSYC 6,A00,188970,Staff,47,0,60,13
1683644546244,PSYC 7,A00,188973,Staff,35,0,45,10
1683644547268,PSYC 60,A01,188980,Rickard; Timothy C.,42,0,60,18
1683644548292,PSYC 70,A01,189001,Steiner; Eric Tomas,23,0,45,22
1683644549322,PSYC 100,A00,189005,Lacefield; Katharine I,0,99,120,120
1683644550347,PSYC 102,A00,189008,Staff,8,0,30,22
1683644551377,PSYC 106,B00,189026,Gorman; Michael R.,27,0,60,33
1683644552405,PSYC 114,B01,189033,Winkielman; Piotr,0,31,30,30
1683644553431,PSYC 131,A00,189036,Anagnostaras; Stephan,0,43,60,60
1683644554456,PSYC 136,A00,189041,Lowe; Angela Beth,0,7,25,25
1683644555479,PSYC 137,A00,189057,Winkielman; Piotr,0,37,25,25
1683644556507,PSYC 144,A00,189107,Wixted; John T,0,10,50,50
1683644558629,PSYC 162,A00,189142,Staff,0,9,85,85
1683644559654,PSYC 172,A00,189144,Gorman; Michael R.,0,6,30,30
1683644561705,PSYC 179,A00,189146,Lacefield; Katharine I,0,86,120,120
1683644562732,PSYC 181,A00,189147,Anagnostaras; Stephan,0,44,90,90
1683644563756,PSYC 190R,A00,189148,Barner; David A.,0,23,80,80
1683644564785,PSYC 191,A00,189275,Rickard; Timothy C.,0,10,25,25
1683644565839,PSYC 193,A00,189276,Chapman; Eddie Nathaniel,0,1,0,4
1683644566869,PSYC 193L,A01,189281,Lowe; Angela Beth,10,0,20,10
1683644566869,PSYC 193L,B01,189285,Staff,28,0,35,7
1683644567897,RELI 149,A00,187137,Rahimi; Babak,7,0,40,33
1683644568922,SE 9,A01,187315,Staff,0,2,18,18
1683644569948,SE 101B,A00,187409,Staff,24,0,30,6
1683644570974,SE 110B,A00,187444,Staff,10,0,40,30
1683644572002,SE 130B,A00,187449,Staff,31,0,40,9
1683644573029,SE 150A,A00,187516,Staff,9,0,20,11
1683644574052,SE 154,A00,187528,Staff,29,0,50,21
1683644575081,SIO 3,A01,258171,Staff,35,0,40,5
1683644576106,SIO 10,A00,187144,Cook; Geoffrey W,0,6,75,75
1683644577130,SIO 45,A00,187152,Cook; Geoffrey W,0,4,100,100
1683644578153,SIO 109R,A00,194486,Staff,0,4,20,20
1683644580201,SIO 187,A01,187233,Kacev; David,12,0,40,28
1683644581229,SOCI 1,A01,258656,Thorpe; Charles Robert,28,0,30,2
1683644581229,SOCI 1,A02,258658,Thorpe; Charles Robert,30,0,30,0
1683644581229,SOCI 1,A03,258661,Thorpe; Charles Robert,25,0,25,0
1683644581229,SOCI 1,A04,258666,Thorpe; Charles Robert,22,0,25,3
1683644581229,SOCI 1,A05,258897,Thorpe; Charles Robert,22,0,25,3
1683644581229,SOCI 1,A06,258898,Thorpe; Charles Robert,25,0,25,0
1683644582252,SOCI 30,A01,258903,Pardo Guerra; Juan Pablo,14,0,30,16
1683644583277,SOCI 102,A00,258904,Staff,9,0,25,16
1683644584302,SOCI 106,A00,258905,Staff,19,0,25,6
1683644585326,SOCI 111,A00,258907,Ribas Norris; Janet Vanesa,26,0,30,4
1683644586353,SOCI 121R,A00,258908,Pardo Guerra; Juan Pablo,8,0,30,22
1683644587377,SOCI 126,A01,203330,Staff,14,0,20,6
1683644588405,SOCI 131,A00,258909,Thorpe; Charles Robert,30,0,60,30
1683644589429,SOCI 135,A00,258910,Payne; Christine Anna,0,11,30,30
1683644590454,SOCI 157,A00,258911,Staff,12,0,30,18
1683644591478,SOCI 184,A00,258912,Staff,25,0,30,5
1683644592505,SOCI 188D,A00,258913,Staff,22,0,30,8
1683644593530,SYN 2,001,187529,Staff,9,0,16,7
1683644593530,SYN 2,002,201452,Staff,0,20,16,16
1683644593530,SYN 2,003,201469,Staff,2,0,16,14
1683644594556,SYN 100,A01,187531,Staff,0,9,20,20
1683644594556,SYN 100,B01,201491,Staff,0,10,20,20
1683644595581,TDAC 1,A00,189286,Walsh; Kim C.,3,0,20,17
1683644595581,TDAC 1,B00,189287,Harting; Carla Kelso,10,0,20,10
1683644596608,TDAC 101,A00,189300,Walsh; Kim C.,16,0,20,4
1683644596608,TDAC 101,B00,189301,Harting; Carla Kelso,18,0,20,2
1683644597634,TDAC 102,A00,189304,Basso; Beatrice,14,0,20,6
1683644598662,TDAC 108,A00,189305,Staff,18,0,20,2
1683644599697,TDDE 131,A00,189310,Staff,19,0,20,1
1683644599697,TDDE 131,B00,189314,Staff,19,0,20,1
1683644599697,TDDE 131,C00,189315,Staff,48,0,50,2
1683644599697,TDDE 131,D00,189316,Staff,14,0,15,1
1683644599697,TDDE 131,E00,204841,Staff,20,0,20,0
1683644600722,TDGE 10,A00,189289,Staff,27,0,50,23
1683644600722,TDGE 10,B00,189290,Havis; Allan,0,0,50,50
1683644601750,TDGE 11,A00,189291,Fulton; Julia,0,4,50,50
1683644601750,TDGE 11,B00,189292,Staff,20,0,25,5
1683644601750,TDGE 11,C00,260270,Staff,0,0,0,0
1683644602776,TDGE 25,A00,189294,Staff,2,0,20,18
1683644603801,TDGE 124,A00,189318,Fulton; Julia,0,8,50,50
1683644604827,TDGE 125,A00,189319,Staff,13,0,25,12
1683644604827,TDGE 125,B00,189320,Staff,23,0,25,2
1683644605857,TDGE 127,A00,189322,Havis; Allan,0,0,50,50
1683644606886,TDHT 101,A00,189323,Staff,18,0,25,7
1683644606886,TDHT 101,B00,189324,Staff,25,0,25,0
1683644607913,TDHT 102,A00,189325,Staff,49,0,50,1
1683644608938,TDMV 1,A00,189295,Arcidiacono; Kristin,20,0,30,10
1683644608938,TDMV 1,B00,189296,Caligagan; Maria T.,24,0,30,6
1683644609963,TDMV 2,A00,189297,Sammartano; Tonnie,27,0,30,3
1683644609963,TDMV 2,B00,189299,Arcidiacono; Kristin,23,0,30,7
1683644610991,TDMV 3,A00,204998,Rincon; Alicia,22,0,30,8
1683644612016,TDMV 120,A00,189458,Sammartano; Tonnie,28,0,30,2
1683644613040,TDMV 138,A00,189541,Jun; Grace Shin Hae,20,0,40,20
1683644614067,TDMV 142,A00,189717,Caligagan; Tony,25,0,30,5
1683644614067,TDMV 142,B00,189718,Caligagan; Maria T.,25,0,30,5
1683644615090,TMC 2,A01,187533,Staff,25,0,25,0
1683644615090,TMC 2,A02,187534,Staff,25,0,25,0
1683644616118,USP 1,A01,187536,Kwak; Nancy,0,16,25,25
1683644617143,USP 5,A01,187538,Staff,9,0,25,16
1683644618170,USP 101,A00,199253,Staff,0,4,0,0
1683644619193,USP 124,A00,187562,Boomhower; Matthew Charles,0,0,30,30
1683644620218,USP 138,A00,187582,Staff,20,0,25,5
1683644621246,USP 152,A01,187597,Staff,3,0,25,22
1683644622270,USP 153,A00,187598,Staff,19,0,25,6
1683644623297,USP 168,A00,187607,Kwak; Nancy,2,0,5,3
1683644624324,USP 173,A00,187619,Staff,4,0,25,21
1683644625351,USP 181,A00,187638,Staff,0,4,25,25
1683644626378,VIS 103,A00,187650,Cruz; Edwin Teddy,18,0,75,57
1683644627403,VIS 110D,A00,187669,Staff,13,0,22,9
1683644628430,VIS 127C,A00,187720,Shen; Kuiyi,67,0,146,79
1683644629457,VIS 149,A00,187731,Yoldas; Pinar,0,14,22,22
1683644630483,VIS 151,A01,188091,Staff,22,0,34,12
1683644630483,VIS 151,A02,188092,Staff,11,0,34,23
1683644631507,VIS 160B,A00,188093,Stalbaum; Brett,0,1,10,10
1683644633560,WCWP 10B,A00,201720,Staff,10,0,15,5
1683644633560,WCWP 10B,B00,201722,Staff,9,0,15,6
1683644634590,WCWP 100,A00,201725,Gagnon; Jeffrey C,0,0,2,2
1683644634590,WCWP 100,B00,201727,Staff,0,4,15,15
1683644637704,ANBI 133,A00,258401,Wilder; Linnea Lorene,34,0,40,6
1683644638729,ANBI 140,A00,258395,Hrvoj Mihic; Branka,18,0,25,7
1683644639754,ANSC 120,A00,258402,Bialecki; Jon Anthony,26,0,40,14
1683644640778,ANSC 144,A00,258400,Staff,12,0,40,28
1683644642837,ANSC 166,A00,258396,Parish; Steven Martin,156,0,175,19
1683644643861,ANSC 180,A00,193533,Staff,8,0,20,12
1683644644889,ANSC 188,A00,258397,Jassal; Aftab,34,0,40,6
1683644645914,ANTH 3,A01,258316,Staff,23,0,30,7
1683644646939,ANTH 5,A00,258394,Semendeferi; Ekaterini,16,0,20,4
1683644647964,ANTH 21,A01,258331,Staff,4,0,40,36
1683644648990,ANTH 103,A00,258398,Varma; Saiba,15,0,25,10
1683644650018,AWP 10,001,202034,Staff,0,0,0,0
1683644650018,AWP 10,002,202035,Staff,0,0,0,0
1683644650018,AWP 10,003,202036,Staff,0,0,0,0
1683644650018,AWP 10,004,202037,Staff,0,0,0,0
1683644650018,AWP 10,005,202038,Staff,0,0,0,0
1683644650018,AWP 10,006,202039,Staff,0,0,0,0
1683644650018,AWP 10,007,202040,Staff,0,0,0,0
1683644650018,AWP 10,008,202041,Staff,0,0,0,0
1683644650018,AWP 10,009,202042,Staff,0,0,0,0
1683644650018,AWP 10,010,202043,Staff,0,0,0,0
1683644650018,AWP 10,011,202044,Staff,0,0,0,0
1683644650018,AWP 10,012,202045,Staff,0,0,0,0
1683644650018,AWP 10,013,202046,Staff,0,0,0,0
1683644650018,AWP 10,014,202047,Staff,0,0,0,0
1683644650018,AWP 10,015,202048,Staff,0,0,0,0
1683644650018,AWP 10,016,202049,Staff,0,0,0,0
1683644650018,AWP 10,017,202050,Staff,0,0,0,0
1683644650018,AWP 10,018,202051,Staff,0,0,0,0
1683644650018,AWP 10,019,202052,Staff,0,0,0,0
1683644650018,AWP 10,020,202053,Staff,0,0,0,0
1683644650018,AWP 10,021,202054,Staff,0,0,0,0
1683644650018,AWP 10,022,202055,Staff,0,0,0,0
1683644650018,AWP 10,023,202056,Staff,0,0,0,0
1683644650018,AWP 10,024,202057,Staff,0,0,0,0
1683644650018,AWP 10,025,202058,Staff,0,0,0,0
1683644650018,AWP 10,026,202059,Staff,0,0,0,0
1683644651044,AWP 102,001,202032,Staff,0,0,0,0
1683644651044,AWP 102,002,202033,Staff,0,0,0,0
1683644652068,BENG 100,A01,254234,Taylor Amos; Alyssa C,31,0,40,9
1683644653096,BENG 196,001,270013,Engler; Adam J.,9999,0,9999,0
1683644654132,BICD 100R,A01,202018,Smith; Laurie,0,7,32,32
1683644654132,BICD 100R,A02,202019,Smith; Laurie,0,3,32,32
1683644654132,BICD 100R,A03,202020,Smith; Laurie,0,1,32,32
1683644654132,BICD 100R,A04,202021,Smith; Laurie,6,0,32,26
1683644654132,BICD 100R,A05,202022,Smith; Laurie,11,0,32,21
1683644655160,BICD 136,A01,193242,Gustafson-Brown; Cindy,0,2,32,32
1683644655160,BICD 136,A02,193244,Gustafson-Brown; Cindy,13,0,32,19
1683644656194,BIEB 102,A01,193249,Butler; Shannon Rhey,0,2,32,32
1683644656194,BIEB 102,A02,193251,Butler; Shannon Rhey,0,0,32,32
1683644656194,BIEB 102,A03,193253,Butler; Shannon Rhey,0,0,32,32
1683644656194,BIEB 102,A04,193255,Butler; Shannon Rhey,14,0,32,18
1683644656194,BIEB 102,A05,193265,Butler; Shannon Rhey,26,0,32,6
1683644656194,BIEB 102,A06,193269,Butler; Shannon Rhey,14,0,32,18
1683644658245,BIEB 150,A01,193274,Staff,0,0,32,32
1683644658245,BIEB 150,A02,193285,Staff,24,0,32,8
1683644659269,BIEB 194,A00,193286,Kurle; Carolyn M.,20,0,32,12
1683644660296,BILD 1,A01,192291,Staff,15,0,32,17
1683644660296,BILD 1,A02,192292,Staff,30,0,32,2
1683644660296,BILD 1,B01,192520,Reuther; Keefe,0,1,0,0
1683644660296,BILD 1,B02,192532,Reuther; Keefe,0,1,0,0
1683644661324,BILD 3,A01,192556,Butler; Shannon Rhey,0,0,32,32
1683644661324,BILD 3,A02,192581,Butler; Shannon Rhey,1,0,32,31
1683644661324,BILD 3,A03,192611,Butler; Shannon Rhey,21,0,32,11
1683644661324,BILD 3,A04,192612,Butler; Shannon Rhey,24,0,32,8
1683644661324,BILD 3,A05,192613,Butler; Shannon Rhey,26,0,32,6
1683644661324,BILD 3,A06,192679,Butler; Shannon Rhey,27,0,32,5
1683644661324,BILD 3,A07,192682,Butler; Shannon Rhey,20,0,32,12
1683644662408,BILD 4,A01,192836,Reuther; Keefe,0,0,24,24
1683644662408,BILD 4,A02,193044,Reuther; Keefe,4,0,24,20
1683644663438,BILD 10,A01,193142,Gustafson-Brown; Cindy,29,0,32,3
1683644663438,BILD 10,A02,193149,Gustafson-Brown; Cindy,31,0,32,1
1683644664468,BIMM 100,A01,193301,Staff,0,6,32,32
1683644664468,BIMM 100,A02,193312,Staff,0,7,32,32
1683644664468,BIMM 100,A03,193323,Staff,0,9,32,32
1683644665500,BIMM 101,A01,193329,McDonnell; Lisa Marie,0,4,24,24
1683644665500,BIMM 101,A02,193339,McDonnell; Lisa Marie,0,3,24,24
1683644665500,BIMM 101,B01,193354,McDonnell; Lisa Marie,0,4,24,24
1683644665500,BIMM 101,B02,193357,McDonnell; Lisa Marie,0,3,24,24
1683644666528,BIMM 110,A01,193377,Tat; John,0,11,32,32
1683644666528,BIMM 110,A02,193378,Tat; John,0,10,32,32
1683644667557,BIMM 120,A01,206116,Staff,0,0,32,32
1683644667557,BIMM 120,A02,206117,Staff,6,0,32,26
1683644667557,BIMM 120,A03,206121,Staff,21,0,32,11
1683644668586,BIPN 100,A01,193393,Park; Ji Young,0,14,32,32
1683644668586,BIPN 100,A02,193402,Park; Ji Young,0,14,32,32
1683644668586,BIPN 100,A03,193413,Park; Ji Young,0,14,32,32
1683644668586,BIPN 100,A04,193414,Park; Ji Young,0,13,32,32
1683644669609,BIPN 102,A01,193429,Staff,0,0,32,32
1683644669609,BIPN 102,A02,193438,Staff,18,0,32,14
1683644670635,BIPN 106,A01,193450,Reyes Gonzalez; Catalina,0,2,40,40
1683644671661,BIPN 134,A01,193465,Cooke; James Edward,0,0,32,32
1683644671661,BIPN 134,A02,193474,Cooke; James Edward,25,0,32,7
1683644671661,BIPN 134,A03,193485,Cooke; James Edward,29,0,32,3
1683644671661,BIPN 134,A04,193486,Cooke; James Edward,20,0,32,12
1683644671661,BIPN 134,A05,193491,Cooke; James Edward,31,0,32,1
1683644671661,BIPN 134,A06,193501,Cooke; James Edward,30,0,32,2
1683644671661,BIPN 134,A07,193510,Cooke; James Edward,29,0,32,3
1683644673716,BISP 194,A00,222522,Staff,14,0,32,18
1683644674745,CAT 124,A01,202407,Staff,19,0,25,6
1683644675773,CAT 125,A00,202408,Marchisotto; Jennifer Anne,2,0,20,18
1683644676799,CAT 125R,A00,202409,Smith; Lauryn Alissa,0,11,20,20
1683644676799,CAT 125R,B00,202410,Morales; Celeste Georgianna,0,11,20,20
1683644676799,CAT 125R,C00,202411,Irwin; Matthew Joseph,0,12,20,20
1683644677826,CENG 15,A01,204712,Yang; Kesong,0,1,0,0
1683644678855,CENG 114,A00,202070,Jahed Motlagh; Zeinab,5,0,20,15
1683644679880,CGS 105,A00,185477,Wesling; Megan E.,24,0,40,16
1683644680907,CGS 106,A00,185494,Staff,11,0,22,11
1683644681934,CGS 108,A00,185495,Staff,14,0,20,6
1683644682960,CGS 114,A00,185496,Staff,13,0,18,5
1683644683985,CGS 119,A00,185501,Staff,15,0,20,5
1683644685010,CGS 120,A00,185511,Staff,12,0,20,8
1683644686035,CHEM 4,A01,184675,Bussey; Thomas J,97,0,100,3
1683644687060,CHEM 6A,A01,184677,Staff,33,0,60,27
1683644688085,CHEM 6B,A01,184679,Staff,63,0,100,37
1683644689113,CHEM 6C,A01,184681,Bussey; Thomas J,0,0,50,50
1683644689113,CHEM 6C,A02,184682,Bussey; Thomas J,32,0,50,18
1683644690138,CHEM 40A,A01,184684,Albizati; Kim F.,34,0,100,66
1683644691162,CHEM 40B,A01,184686,Albizati; Kim F.,0,22,100,100
1683644692190,CHEM 41B,A01,184690,Staff,51,0,100,49
1683644693219,COGS 3,A01,184715,Boyle; Mary E. T.,0,27,40,40
1683644694245,COGS 14B,A01,185172,Staff,0,14,38,38
1683644695270,COGS 18,A01,184736,Staff,15,0,80,65
1683644696295,COGS 100,A01,184932,Staff,0,7,73,73
1683644697325,COGS 101A,A01,184935,Staff,0,39,30,30
1683644698350,COGS 101B,A01,184944,Staff,0,2,30,30
1683644699375,COGS 101C,A01,184946,Staff,0,10,30,30
1683644700406,COGS 102A,A01,184951,Johnson; Christine M.,2,0,40,38
1683644701432,COGS 107B,A01,184953,Mooshagian; Eric Frederick,0,51,40,40
1683644702462,COGS 118B,A01,184959,Gupta; Anjum,0,49,40,40
1683644703490,COGS 153,A00,184961,Staff,0,16,30,30
1683644704518,COGS 177,A00,184962,Staff,0,21,30,30
1683644705542,COGS 187A,A01,184969,Boyle; Mary E. T.,0,19,40,40
1683644706569,COMM 10,A01,185174,Staff,0,5,25,25
1683644706569,COMM 10,A02,185189,Staff,0,2,25,25
1683644706569,COMM 10,A03,269821,Staff,0,1,0,0
1683644707594,COMM 100B,A01,185475,Staff,0,1,0,2
1683644707594,COMM 100B,A02,185476,Staff,12,0,25,13
1683644708618,COMM 100C,A01,185314,Staff,1,0,25,24
1683644708618,COMM 100C,A02,185327,Staff,18,0,25,7
1683644709644,COMM 110M,A00,185349,Staff,0,0,40,40
1683644710669,COMM 113T,A00,185352,Staff,25,0,40,15
1683644711698,COMM 114I,A00,185353,Staff,31,0,40,9
1683644712725,COMM 131,A00,185354,Staff,17,0,30,13
1683644713756,CSE 8A,A50,185358,Cao; Yingjun,0,46,10,10
1683644714781,CSE 8B,A01,185362,Staff,0,48,50,50
1683644715806,CSE 11,A01,185416,Cao; Yingjun,0,91,10,10
1683644716830,CSE 20,A01,185445,Briones; Jor-el Thomas Caparas,4,0,25,21
1683644717855,CSE 21,A01,185447,Staff,9,0,50,41
1683644718885,CSE 101,A01,185451,Staff,0,13,50,50
1683644718885,CSE 101,B01,185453,Jones; Miles E,0,13,50,50
1683644720936,CSE 141,A01,185458,Eldon; John,15,0,100,85
1683644721961,CSE 141L,A01,185461,Eldon; John,7,0,100,93
1683644722990,CSE 142,A01,185463,Staff,36,0,60,24
1683644722990,CSE 142,B01,201355,Staff,0,7,60,60
1683644724014,CSE 142L,A01,185470,Staff,36,0,60,24
1683644724014,CSE 142L,B01,201417,Staff,0,6,60,60
1683644725039,CSE 190,A00,201433,Staff,32,0,49,17
1683644726063,DOC 1,A01,259136,Strom; Megan C.,7,0,15,8
1683644726063,DOC 1,A02,259137,Strom; Megan C.,14,0,15,1
1683644726063,DOC 1,A03,259138,Strom; Megan C.,14,0,15,1
1683644726063,DOC 1,A04,259139,Strom; Megan C.,14,0,15,1
1683644727093,DOC 100D,A00,259140,Pass; Natalye Joann,14,0,25,11
1683644728118,DSGN 1,A01,184749,Rill; Bryan,0,26,30,30
1683644729145,DSGN 100,A01,185168,Staff,0,2,25,25
1683644730173,ECE 5,A01,185626,Morris; Karcher William,0,11,0,0
1683644731201,ECE 101,A01,185628,Staff,14,0,70,56
1683644732231,ECE 107,A01,185635,Baghdadchi; Saharnaz,0,0,20,20
1683644732231,ECE 107,A02,185638,Baghdadchi; Saharnaz,3,0,20,17
1683644733256,ECE 148,A01,185647,Silberman; Jack,0,0,16,16
1683644734283,ECON 1,A01,185537,Crane; Meredith Helen,54,0,70,16
1683644735309,ECON 3,A01,185549,Crane; Meredith Helen,29,0,70,41
1683644736341,ECON 4,A01,203354,Anderson; John Charles,0,5,10,10
1683644737369,ECON 100A,A01,185574,Staff,0,5,40,40
1683644738396,ECON 100B,A01,185576,Staff,0,12,50,50
1683644739424,ECON 100C,A01,185589,Newhouse; Herbert S,30,0,70,40
1683644740452,ECON 105,A00,185608,Vespa; Emanuel Ignacio,19,0,35,16
1683644741482,ECON 109,A01,185610,Shishkin; Denis,9,0,35,26
1683644742509,ECON 110A,A01,185612,Staff,9,0,40,31
1683644743535,ECON 120A,A01,185615,Staff,20,0,40,20
1683644744565,ECON 120C,A01,185617,Sun; Yixiao,0,20,70,70
1683644745594,ECON 144,A00,203346,Squires; Dale E,2,0,35,33
1683644746619,ECON 171,A01,203349,Newhouse; Herbert S,0,1,35,35
1683644747644,ECON 173A,A01,185621,Toda; Alexis Akira,21,0,35,14
1683644748678,EDS 25,A01,202413,Staff,0,1,0,0
1683644748678,EDS 25,A02,202414,Staff,0,1,0,0
1683644748678,EDS 25,A03,202415,Staff,0,0,0,0
1683644748678,EDS 25,A04,202416,Staff,0,1,0,0
1683644748678,EDS 25,A05,202439,Staff,0,0,0,0
1683644748678,EDS 25,A06,202440,Staff,0,0,0,0
1683644748678,EDS 25,B01,202631,Staff,0,0,0,0
1683644748678,EDS 25,B02,202632,Staff,0,0,0,0
1683644748678,EDS 25,B03,202639,Staff,0,0,0,0
1683644748678,EDS 25,B04,202640,Staff,0,0,0,0
1683644748678,EDS 25,B05,202643,Staff,0,0,0,0
1683644748678,EDS 25,B06,202644,Staff,0,0,0,0
1683644749707,EDS 38,A01,202659,Black; Alison Michelle,24,0,25,1
1683644750732,EDS 115,A00,202652,Staff,18,0,30,12
1683644751758,EDS 125,A00,202649,Staff,13,0,30,17
1683644752783,EDS 126,A01,203332,Staff,30,0,30,0
1683644753809,EDS 139,A00,202838,Staff,16,0,25,9
1683644754836,EDS 146,A01,202655,Staff,14,0,25,11
1683644755865,ENG 15,A00,185667,Staff,0,1,0,0
1683644755865,ENG 15,B00,185672,Staff,0,0,0,0
1683644755865,ENG 15,C00,185675,Staff,0,0,0,0
1683644755865,ENG 15,D00,185682,Staff,0,0,0,0
1683644755865,ENG 15,E00,185684,Staff,0,0,0,0
1683644756890,ETHN 103,A00,185710,Staff,0,8,35,35
1683644757920,ETHN 103A,A00,199228,Man; Simeon S,0,0,9,9
1683644758943,ETHN 109,A00,185711,Staff,16,0,35,19
1683644759983,ETHN 142,A00,185726,Staff,0,4,30,30
1683644761012,ETHN 163J,A00,199229,Man; Simeon S,5,0,8,3
1683644762040,ETHN 168,A00,185727,Staff,7,0,10,3
1683644763064,ETHN 182,A00,185728,Staff,0,0,35,35
1683644764087,ETHN 183,A00,185737,Staff,9,0,18,9
1683644765114,GLBH 111,A01,209361,Burgos; Jose L.,0,0,0,0
1683644767226,HIEU 104,A00,185792,Staff,14,0,20,6
1683644768251,HIEU 115,A00,185800,Staff,0,0,20,20
1683644769279,HIEU 128,A00,185801,Staff,0,9,20,20
1683644770305,HIEU 147,A00,185802,Staff,15,0,20,5
1683644771331,HIEU 154,A00,185823,Staff,11,0,20,9
1683644772356,HILA 102,A00,185826,Staff,14,0,20,6
1683644773380,HILD 2C,A01,185778,Staff,0,13,20,20
1683644774405,HILD 7B,A01,185780,Kwak; Nancy,0,16,32,32
1683644774405,HILD 7B,A02,185781,Kwak; Nancy,0,18,32,32
1683644775435,HILD 30,A01,185791,Staff,12,0,20,8
1683644776462,HISC 119,A00,185830,Golan; Tal,0,9,20,20
1683644777493,HITO 156GS,A00,185831,Patterson; Patrick H.,0,0,0,23
1683644778519,HIUS 103,A00,185832,Man; Simeon S,0,4,20,20
1683644779544,HIUS 117,A00,185836,Kwak; Nancy,2,0,20,18
1683644780572,HIUS 125,A00,185840,Man; Simeon S,0,1,23,23
1683644781598,HIUS 149,A00,185845,Staff,1,0,20,19
1683644782633,HUM 3,A01,185882,Zavodny; Tatiana Sophia,0,7,50,50
1683644782633,HUM 3,B01,185899,Caldwell; Michael Alan,0,18,50,50
1683644783662,HUM 3GS,A00,185900,Patterson; Patrick H.,0,0,0,23
1683644784693,HUM 4,A01,185938,Zroka; Amy Liane,30,0,50,20
1683644784693,HUM 4,B01,185956,Watkins; Eric,0,4,50,50
1683644784693,HUM 4,B02,202209,Watkins; Eric,0,4,50,50
1683644784693,HUM 4,B03,202210,Watkins; Eric,0,4,50,50
1683644785722,HUM 5,A01,185958,West; Geoffrey Scott,2,0,50,48
1683644785722,HUM 5,A02,202215,West; Geoffrey Scott,0,0,50,50
1683644786748,INTL 190,A00,185959,Gagnon; Jeffrey C,0,0,0,9
1683644786748,INTL 190,B00,185960,Lettieri; Michael Joseph,0,0,0,2
1683644787774,JAPN 180,A00,254509,Staff,5,0,30,25
1683644788802,LATI 10,A01,202853,Kennemore; Amy Michelle,4,0,35,31
1683644788802,LATI 10,A02,202854,Kennemore; Amy Michelle,2,0,35,33
1683644788802,LATI 10,A03,270054,Kennemore; Amy Michelle,30,0,30,0
1683644789831,LATI 180,A00,202855,Kennemore; Amy Michelle,11,0,20,9
1683644790855,LAWS 101,A00,201767,Golan; Tal,0,7,40,40
1683644791883,LIFR 1C,A00,185961,Staff,6,0,20,14
1683644792909,LIFR 1CX,A00,185962,Staff,7,0,20,13
1683644793937,LIFR 1D,A00,185963,Staff,7,0,20,13
1683644794964,LIFR 1DX,A00,185964,Staff,7,0,20,13
1683644795989,LIGN 101,A01,186039,Staff,43,0,50,7
1683644797014,LIGN 165,A00,186040,Staff,15,0,50,35
1683644798040,LTCS 108,A00,186041,Staff,5,0,10,5
1683644799065,LTCS 119,A00,186042,Staff,15,0,20,5
1683644800090,LTCS 130,A00,186043,Wesling; Megan E.,15,0,25,10
1683644802139,LTEA 138,A00,186119,Staff,14,0,40,26
1683644803163,LTEN 124,A00,186148,Staff,5,0,25,20
1683644804189,LTEN 178,A00,186149,Staff,7,0,15,8
1683644805215,LTEN 181,A00,186150,Blanco; John D,34,0,40,6
1683644806243,LTWL 120,A00,186160,Staff,20,0,25,5
1683644807268,LTWL 165,A00,186161,Staff,22,0,25,3
1683644808293,LTWR 100,A00,186162,Staff,0,5,15,15
1683644809323,LTWR 102,A00,186163,Doller; Ben,5,0,15,10
1683644810351,MAE 8,A01,186412,Staff,0,0,0,0
1683644811378,MAE 30B,A00,186445,Bahadori; Mohammad Yousef,82,0,100,18
1683644812402,MAE 40,A00,186592,Bewley; Thomas R,10,0,50,40
1683644813426,MAE 101B,A00,186593,Bahadori; Mohammad Yousef,80,0,100,20
1683644814451,MAE 105,A00,186594,Bandaru; Prabhakar,10,0,50,40
1683644815476,MAE 107,A00,186599,Pham; Hieu Tan,0,7,120,120
1683644816501,MAE 148,A01,186660,Silberman; Jack,3,0,16,13
1683644817525,MATH 10A,A01,188095,Staff,0,5,35,35
1683644818556,MATH 10B,A01,188097,Bowers; Adam R.,0,11,30,30
1683644818556,MATH 10B,A02,188099,Bowers; Adam R.,0,11,30,30
1683644818556,MATH 10B,B01,188104,Bowers; Adam R.,0,10,30,30
1683644818556,MATH 10B,B02,188106,Bowers; Adam R.,1,9,30,29
1683644819589,MATH 10C,A01,188111,Staff,0,18,30,30
1683644819589,MATH 10C,A02,188127,Staff,0,19,30,30
1683644819589,MATH 10C,A03,188131,Staff,0,19,30,30
1683644819589,MATH 10C,B01,188218,Staff,17,0,30,13
1683644819589,MATH 10C,B02,188244,Staff,13,0,30,17
1683644819589,MATH 10C,B03,188277,Staff,14,0,30,16
1683644820615,MATH 18,A01,188344,Bach; Quang Tran,18,0,30,12
1683644820615,MATH 18,A02,188345,Bach; Quang Tran,11,0,30,19
1683644820615,MATH 18,B01,188353,Bach; Quang Tran,11,0,30,19
1683644820615,MATH 18,B02,188354,Bach; Quang Tran,19,0,30,11
1683644821645,MATH 20A,A01,188374,Staff,11,0,35,24
1683644822670,MATH 20B,A01,188382,Ohm; Ko Woon,7,0,30,23
1683644822670,MATH 20B,A02,188383,Ohm; Ko Woon,22,0,30,8
1683644822670,MATH 20B,B01,188385,Ohm; Ko Woon,7,0,30,23
1683644822670,MATH 20B,B02,188392,Ohm; Ko Woon,22,0,30,8
1683644823697,MATH 20C,A01,188394,Harel; Guershon,11,0,30,19
1683644823697,MATH 20C,A02,188395,Harel; Guershon,14,0,30,16
1683644823697,MATH 20C,B01,188404,Harel; Guershon,4,0,30,26
1683644823697,MATH 20C,B02,188405,Harel; Guershon,18,0,30,12
1683644824723,MATH 20D,A01,188414,Hammock; Frances H,0,1,30,30
1683644824723,MATH 20D,A02,188415,Hammock; Frances H,0,1,30,30
1683644824723,MATH 20D,B01,188447,Hammock; Frances H,0,1,30,30
1683644824723,MATH 20D,B02,188486,Hammock; Frances H,4,0,30,26
1683644825750,MATH 20E,A01,188649,Staff,21,0,30,9
1683644825750,MATH 20E,A02,188650,Staff,21,0,30,9
1683644825750,MATH 20E,A03,188673,Staff,0,0,30,30
1683644826778,MATH 102,A01,188675,Staff,0,36,35,35
1683644827804,MATH 103B,A01,188681,Staff,3,0,35,32
1683644827804,MATH 103B,B01,188692,Staff,5,0,35,30
1683644828833,MATH 109,A01,188695,Salehi Golsefidy; Alireza,24,0,35,11
1683644828833,MATH 109,A02,188696,Salehi Golsefidy; Alireza,25,0,35,10
1683644829862,MATH 120A,A01,188698,Eggers; John Dietrich,7,0,35,28
1683644830888,MATH 142B,A01,188736,Ioana; Adrian,0,1,30,30
1683644830888,MATH 142B,A02,188741,Ioana; Adrian,0,1,30,30
1683644830888,MATH 142B,A03,188743,Ioana; Adrian,0,1,30,30
1683644831914,MATH 168A,A01,188790,Staff,0,10,35,35
1683644832945,MATH 170A,A01,188803,Nie; Jiawang,0,2,35,35
1683644832945,MATH 170A,A02,188811,Nie; Jiawang,0,0,35,35
1683644832945,MATH 170A,A03,188814,Nie; Jiawang,0,0,35,35
1683644832945,MATH 170A,A04,188815,Nie; Jiawang,10,0,35,25
1683644833970,MATH 193B,A01,188817,Staff,0,0,35,35
1683644833970,MATH 193B,A02,188818,Staff,5,0,35,30
1683644834997,MGT 4,A01,202857,Anderson; John Charles,61,0,80,19
1683644836026,MGT 12,A00,202858,Lindenberger; Wade Douglas,40,0,90,50
1683644837052,MGT 18,A00,202859,Staff,74,0,90,16
1683644838080,MGT 18GS,A00,202860,McKay; Michael J,13,0,28,15
1683644839106,MGT 45,A00,202861,Pecore; Joseph P.,12,0,90,78
1683644840135,MGT 100,A00,202863,Yavorsky; Daniel Ryan,28,0,90,62
1683644841168,MGT 103,A00,202864,Ehrich; Kristine R,0,17,90,90
1683644842193,MGT 112,A00,202865,Ehrich; Kristine R,15,0,90,75
1683644843226,MGT 121A,A00,202868,Staff,0,20,0,0
1683644844253,MGT 131B,A00,202869,Anderson; John Charles,59,0,90,31
1683644845280,MGT 136,A00,202871,Lindenberger; Wade Douglas,83,0,90,7
1683644846305,MGT 164,A00,202873,Staff,0,66,90,91
1683644847330,MGT 164GS,A00,202874,McKay; Mary A,13,0,28,15
1683644848353,MGT 180,A00,202875,Staff,0,50,90,91
1683644849383,MMW 11R,A01,205019,Herbst; Matthew,2,0,30,28
1683644849383,MMW 11R,A02,205026,Herbst; Matthew,29,0,30,1
1683644850413,MMW 15,A01,193512,Chang; Edmond Yi-Teh,0,8,28,28
1683644850413,MMW 15,A02,193513,Chang; Edmond Yi-Teh,0,5,28,28
1683644850413,MMW 15,A03,193514,Chang; Edmond Yi-Teh,0,5,28,28
1683644850413,MMW 15,A04,193515,Chang; Edmond Yi-Teh,0,5,28,28
1683644850413,MMW 15,A05,193516,Chang; Edmond Yi-Teh,0,5,28,28
1683644850413,MMW 15,A06,193517,Chang; Edmond Yi-Teh,0,6,28,28
1683644850413,MMW 15,B01,193519,Chang; Edmond Yi-Teh,0,5,28,28
1683644850413,MMW 15,B02,193520,Chang; Edmond Yi-Teh,0,5,28,28
1683644850413,MMW 15,B03,193521,Chang; Edmond Yi-Teh,0,5,28,28
1683644850413,MMW 15,B04,193522,Chang; Edmond Yi-Teh,0,5,28,28
1683644850413,MMW 15,B05,193523,Chang; Edmond Yi-Teh,0,5,28,28
1683644850413,MMW 15,B06,193524,Chang; Edmond Yi-Teh,0,5,28,28
1683644851441,MMW 122,A01,193526,Rahimi; Babak,0,16,28,28
1683644851441,MMW 122,A02,193527,Rahimi; Babak,0,15,28,28
1683644851441,MMW 122,A03,193528,Rahimi; Babak,0,0,0,0
1683644851441,MMW 122,A04,193529,Rahimi; Babak,0,0,0,0
1683644852466,MUS 1A,A01,186663,Staff,1,20,35,34
1683644853495,MUS 4,A01,186715,Staff,0,12,35,35
1683644854525,MUS 5R,A01,186796,Dubnov; Shlomo,0,17,35,35
1683644855549,MUS 6,A01,186798,Staff,0,5,25,25
1683644856573,MUS 7,A01,186830,Staff,11,0,35,24
1683644857599,MUS 8,A01,186930,Staff,0,26,35,35
1683644858628,MUS 15,A01,186932,Staff,0,16,35,35
1683644858628,MUS 15,B01,186934,Staff,0,17,35,35
1683644859654,MUS 80,A00,186935,Staff,0,0,20,20
1683644859654,MUS 80,B00,186936,Staff,24,0,25,1
1683644862726,NANO 11,A00,204702,Lipomi; Darren John,0,0,0,0
1683644863752,NANO 15,A01,204709,Yang; Kesong,0,1,0,0
1683644864781,NANO 114,A00,202069,Jahed Motlagh; Zeinab,3,0,10,7
1683644865806,PHIL 1,A00,186955,Grush; Rick Scott,31,0,40,9
1683644866832,PHIL 10,A01,186973,Grush; Rick Scott,27,0,35,8
1683644866832,PHIL 10,A02,186974,Grush; Rick Scott,33,0,35,2
1683644867859,PHIL 13,A01,186976,Staff,3,0,35,32
1683644867859,PHIL 13,A02,186977,Staff,16,0,35,19
1683644868886,PHIL 14,A01,186979,Staff,31,0,35,4
1683644868886,PHIL 14,A02,186986,Staff,32,0,35,3
1683644869916,PHIL 28,A01,186988,Staff,16,0,30,14
1683644869916,PHIL 28,A02,186989,Staff,1,0,30,29
1683644869916,PHIL 28,A03,186990,Staff,10,0,30,20
1683644869916,PHIL 28,A04,186991,Staff,26,0,30,4
1683644870941,PHIL 120,A00,186997,Staff,23,0,40,17
1683644872025,PHIL 137,A00,187003,Staff,7,0,40,33
1683644873054,PHIL 150,A00,187015,Staff,47,0,70,23
1683644874081,PHIL 167,A00,187021,Lamey; Andy M.,34,0,40,6
1683644875104,PHIL 174,A01,202226,Staff,17,0,20,3
1683644875104,PHIL 174,A02,202235,Staff,20,0,20,0
1683644876133,PHIL 191A,A00,258918,Staff,0,0,1,1
1683644877157,PHYS 1A,A00,187028,Staff,27,0,60,33
1683644878182,PHYS 1AL,001,187036,Staff,3,0,30,27
1683644878182,PHYS 1AL,002,187049,Staff,18,0,30,12
1683644879206,PHYS 1B,A00,187058,Staff,22,0,60,38
1683644880231,PHYS 1BL,001,187064,Staff,0,1,30,30
1683644880231,PHYS 1BL,002,187070,Staff,4,0,30,26
1683644881258,PHYS 1C,A00,187082,Staff,29,0,120,91
1683644882283,PHYS 1CL,001,187088,Staff,0,9,30,30
1683644882283,PHYS 1CL,002,187089,Staff,0,1,30,30
1683644882283,PHYS 1CL,009,262693,Staff,9,0,30,21
1683644883312,PHYS 2B,A01,187097,Staff,55,0,115,60
1683644884339,PHYS 2C,A01,187099,Staff,64,0,115,51
1683644885367,PHYS 2CL,A01,187101,Staff,5,0,28,23
1683644885367,PHYS 2CL,A02,187102,Staff,15,0,28,13
1683644886393,PHYS 2D,A01,187123,Shotwell; Brian,95,0,115,20
1683644887423,PHYS 4B,A01,187133,Grinstein; Benjamin,35,0,50,15
1683644888453,POLI 10,A00,188819,Staff,0,4,50,50
1683644889479,POLI 11,A00,188827,Staff,43,0,50,7
1683644890507,POLI 13R,A00,188828,Staff,0,1,20,20
1683644891538,POLI 27,A01,188830,Elgin; Samuel Zincke,0,2,70,70
1683644892568,POLI 30,A00,188832,Desposato; Scott,30,0,50,20
1683644893595,POLI 102F,A00,188834,Staff,0,0,40,40
1683644894620,POLI 104A,A00,188852,Staff,13,0,30,17
1683644895647,POLI 104I,A00,188853,Staff,0,7,20,20
1683644896673,POLI 110B,A00,188854,Wiens; David,7,0,20,13
1683644897698,POLI 112A,A00,188855,Wiens; David,4,0,30,26
1683644898727,POLI 117R,A00,188856,Forman; Fonna,0,12,20,20
1683644899755,POLI 118,A00,188857,Ingham; Sean,8,0,20,12
1683644900790,POLI 120G,A00,188858,Staff,8,0,30,22
1683644901820,POLI 131CR,A00,188863,Hoston; Germaine,21,0,50,29
1683644902849,POLI 133,A00,188864,Nellis; Gareth Hb,44,0,50,6
1683644903878,POLI 134D,A00,188865,Desposato; Scott,27,0,30,3
1683644904903,POLI 142A,A00,188871,Gartzke; Erik,21,0,50,29
1683644905931,POLI 142K,A00,188874,Staff,38,0,50,12
1683644906956,POLI 143,A00,188940,Gartzke; Erik,16,0,30,14
1683644907980,POLI 153,A00,188943,Staff,2,0,20,18
1683644909004,POLI 160AA,A00,188944,Staff,11,0,40,29
1683644910031,POLI 170A,A00,188945,Staff,11,0,30,19
1683644912081,PSYC 1,A00,188952,Staff,36,0,90,54
1683644913105,PSYC 2,B00,188953,Staff,19,0,35,16
1683644914133,PSYC 6,A00,188970,Staff,47,0,60,13
1683644915157,PSYC 7,A00,188973,Staff,35,0,45,10
1683644916182,PSYC 60,A01,188980,Rickard; Timothy C.,42,0,60,18
1683644917206,PSYC 70,A01,189001,Steiner; Eric Tomas,23,0,45,22
1683644918235,PSYC 100,A00,189005,Lacefield; Katharine I,0,99,120,120
1683644919264,PSYC 102,A00,189008,Staff,8,0,30,22
1683644920292,PSYC 106,B00,189026,Gorman; Michael R.,27,0,60,33
1683644921321,PSYC 114,B01,189033,Winkielman; Piotr,0,31,30,30
1683644922346,PSYC 131,A00,189036,Anagnostaras; Stephan,0,43,60,60
1683644923374,PSYC 136,A00,189041,Lowe; Angela Beth,0,7,25,25
1683644924402,PSYC 137,A00,189057,Winkielman; Piotr,0,37,25,25
1683644925425,PSYC 144,A00,189107,Wixted; John T,0,10,50,50
1683644927478,PSYC 162,A00,189142,Staff,0,9,85,85
1683644928506,PSYC 172,A00,189144,Gorman; Michael R.,0,6,30,30
1683644930555,PSYC 179,A00,189146,Lacefield; Katharine I,0,86,120,120
1683644931582,PSYC 181,A00,189147,Anagnostaras; Stephan,0,44,90,90
1683644932607,PSYC 190R,A00,189148,Barner; David A.,0,23,80,80
1683644933633,PSYC 191,A00,189275,Rickard; Timothy C.,0,10,25,25
1683644934660,PSYC 193,A00,189276,Chapman; Eddie Nathaniel,0,1,0,4
1683644935685,PSYC 193L,A01,189281,Lowe; Angela Beth,10,0,20,10
1683644935685,PSYC 193L,B01,189285,Staff,28,0,35,7
1683644936708,RELI 149,A00,187137,Rahimi; Babak,7,0,40,33
1683644937735,SE 9,A01,187315,Staff,0,2,18,18
1683644938764,SE 101B,A00,187409,Staff,24,0,30,6
1683644939792,SE 110B,A00,187444,Staff,10,0,40,30
1683644940816,SE 130B,A00,187449,Staff,31,0,40,9
1683644941848,SE 150A,A00,187516,Staff,9,0,20,11
1683644942872,SE 154,A00,187528,Staff,29,0,50,21
1683644943902,SIO 3,A01,258171,Staff,35,0,40,5
1683644944930,SIO 10,A00,187144,Cook; Geoffrey W,0,6,75,75
1683644945955,SIO 45,A00,187152,Cook; Geoffrey W,0,4,100,100
1683644946980,SIO 109R,A00,194486,Staff,0,4,20,20
1683644949030,SIO 187,A01,187233,Kacev; David,12,0,40,28
1683644950056,SOCI 1,A01,258656,Thorpe; Charles Robert,28,0,30,2
1683644950056,SOCI 1,A02,258658,Thorpe; Charles Robert,30,0,30,0
1683644950056,SOCI 1,A03,258661,Thorpe; Charles Robert,25,0,25,0
1683644950056,SOCI 1,A04,258666,Thorpe; Charles Robert,22,0,25,3
1683644950056,SOCI 1,A05,258897,Thorpe; Charles Robert,22,0,25,3
1683644950056,SOCI 1,A06,258898,Thorpe; Charles Robert,25,0,25,0
1683644951087,SOCI 30,A01,258903,Pardo Guerra; Juan Pablo,14,0,30,16
1683644952112,SOCI 102,A00,258904,Staff,9,0,25,16
1683644953139,SOCI 106,A00,258905,Staff,19,0,25,6
1683644954163,SOCI 111,A00,258907,Ribas Norris; Janet Vanesa,26,0,30,4
1683644955187,SOCI 121R,A00,258908,Pardo Guerra; Juan Pablo,8,0,30,22
1683644956211,SOCI 126,A01,203330,Staff,14,0,20,6
1683644957237,SOCI 131,A00,258909,Thorpe; Charles Robert,30,0,60,30
1683644958267,SOCI 135,A00,258910,Payne; Christine Anna,0,11,30,30
1683644959291,SOCI 157,A00,258911,Staff,12,0,30,18
1683644960318,SOCI 184,A00,258912,Staff,25,0,30,5
1683644961342,SOCI 188D,A00,258913,Staff,22,0,30,8
1683644962371,SYN 2,001,187529,Staff,9,0,16,7
1683644962371,SYN 2,002,201452,Staff,0,20,16,16
1683644962371,SYN 2,003,201469,Staff,2,0,16,14
1683644963395,SYN 100,A01,187531,Staff,0,9,20,20
1683644963395,SYN 100,B01,201491,Staff,0,10,20,20
1683644964425,TDAC 1,A00,189286,Walsh; Kim C.,3,0,20,17
1683644964425,TDAC 1,B00,189287,Harting; Carla Kelso,10,0,20,10
1683644965451,TDAC 101,A00,189300,Walsh; Kim C.,16,0,20,4
1683644965451,TDAC 101,B00,189301,Harting; Carla Kelso,18,0,20,2
1683644966478,TDAC 102,A00,189304,Basso; Beatrice,14,0,20,6
1683644967502,TDAC 108,A00,189305,Staff,18,0,20,2
1683644968533,TDDE 131,A00,189310,Staff,19,0,20,1
1683644968533,TDDE 131,B00,189314,Staff,19,0,20,1
1683644968533,TDDE 131,C00,189315,Staff,48,0,50,2
1683644968533,TDDE 131,D00,189316,Staff,14,0,15,1
1683644968533,TDDE 131,E00,204841,Staff,20,0,20,0
1683644969558,TDGE 10,A00,189289,Staff,27,0,50,23
1683644969558,TDGE 10,B00,189290,Havis; Allan,0,0,50,50
1683644970583,TDGE 11,A00,189291,Fulton; Julia,0,4,50,50
1683644970583,TDGE 11,B00,189292,Staff,20,0,25,5
1683644970583,TDGE 11,C00,260270,Staff,0,0,0,0
1683644971611,TDGE 25,A00,189294,Staff,2,0,20,18
1683644972635,TDGE 124,A00,189318,Fulton; Julia,0,8,50,50
1683644973659,TDGE 125,A00,189319,Staff,13,0,25,12
1683644973659,TDGE 125,B00,189320,Staff,23,0,25,2
1683644974683,TDGE 127,A00,189322,Havis; Allan,0,0,50,50
1683644975772,TDHT 101,A00,189323,Staff,18,0,25,7
1683644975772,TDHT 101,B00,189324,Staff,25,0,25,0
1683644976796,TDHT 102,A00,189325,Staff,49,0,50,1
1683644977823,TDMV 1,A00,189295,Arcidiacono; Kristin,20,0,30,10
1683644977823,TDMV 1,B00,189296,Caligagan; Maria T.,24,0,30,6
1683644978852,TDMV 2,A00,189297,Sammartano; Tonnie,27,0,30,3
1683644978852,TDMV 2,B00,189299,Arcidiacono; Kristin,23,0,30,7
1683644979876,TDMV 3,A00,204998,Rincon; Alicia,22,0,30,8
1683644980900,TDMV 120,A00,189458,Sammartano; Tonnie,28,0,30,2
1683644981925,TDMV 138,A00,189541,Jun; Grace Shin Hae,20,0,40,20
1683644982949,TDMV 142,A00,189717,Caligagan; Tony,25,0,30,5
1683644982949,TDMV 142,B00,189718,Caligagan; Maria T.,25,0,30,5
1683644983976,TMC 2,A01,187533,Staff,25,0,25,0
1683644983976,TMC 2,A02,187534,Staff,25,0,25,0
1683644985001,USP 1,A01,187536,Kwak; Nancy,0,16,25,25
1683644986027,USP 5,A01,187538,Staff,9,0,25,16
1683644987055,USP 101,A00,199253,Staff,0,4,0,0
1683644988081,USP 124,A00,187562,Boomhower; Matthew Charles,0,0,30,30
1683644989108,USP 138,A00,187582,Staff,20,0,25,5
1683644990136,USP 152,A01,187597,Staff,3,0,25,22
1683644991162,USP 153,A00,187598,Staff,19,0,25,6
1683644992192,USP 168,A00,187607,Kwak; Nancy,2,0,5,3
1683644993219,USP 173,A00,187619,Staff,4,0,25,21
1683644994247,USP 181,A00,187638,Staff,0,4,25,25
1683644995277,VIS 103,A00,187650,Cruz; Edwin Teddy,18,0,75,57
1683644996308,VIS 110D,A00,187669,Staff,13,0,22,9
1683644997338,VIS 127C,A00,187720,Shen; Kuiyi,67,0,146,79
1683644998364,VIS 149,A00,187731,Yoldas; Pinar,0,14,22,22
1683644999390,VIS 151,A01,188091,Staff,22,0,34,12
1683644999390,VIS 151,A02,188092,Staff,11,0,34,23
1683645000418,VIS 160B,A00,188093,Stalbaum; Brett,0,1,10,10
1683645002474,WCWP 10B,A00,201720,Staff,10,0,15,5
1683645002474,WCWP 10B,B00,201722,Staff,9,0,15,6
1683645003499,WCWP 100,A00,201725,Gagnon; Jeffrey C,0,0,2,2
1683645003499,WCWP 100,B00,201727,Staff,0,4,15,15
1683645006614,ANBI 133,A00,258401,Wilder; Linnea Lorene,34,0,40,6
1683645007641,ANBI 140,A00,258395,Hrvoj Mihic; Branka,18,0,25,7
1683645008666,ANSC 120,A00,258402,Bialecki; Jon Anthony,26,0,40,14
1683645009695,ANSC 144,A00,258400,Staff,12,0,40,28
1683645011752,ANSC 166,A00,258396,Parish; Steven Martin,156,0,175,19
1683645012778,ANSC 180,A00,193533,Staff,8,0,20,12
1683645013807,ANSC 188,A00,258397,Jassal; Aftab,34,0,40,6
1683645014833,ANTH 3,A01,258316,Staff,23,0,30,7
1683645015857,ANTH 5,A00,258394,Semendeferi; Ekaterini,16,0,20,4
1683645016885,ANTH 21,A01,258331,Staff,4,0,40,36
1683645017909,ANTH 103,A00,258398,Varma; Saiba,15,0,25,10
1683645018935,AWP 10,001,202034,Staff,0,0,0,0
1683645018935,AWP 10,002,202035,Staff,0,0,0,0
1683645018935,AWP 10,003,202036,Staff,0,0,0,0
1683645018935,AWP 10,004,202037,Staff,0,0,0,0
1683645018935,AWP 10,005,202038,Staff,0,0,0,0
1683645018935,AWP 10,006,202039,Staff,0,0,0,0
1683645018935,AWP 10,007,202040,Staff,0,0,0,0
1683645018935,AWP 10,008,202041,Staff,0,0,0,0
1683645018935,AWP 10,009,202042,Staff,0,0,0,0
1683645018935,AWP 10,010,202043,Staff,0,0,0,0
1683645018935,AWP 10,011,202044,Staff,0,0,0,0
1683645018935,AWP 10,012,202045,Staff,0,0,0,0
1683645018935,AWP 10,013,202046,Staff,0,0,0,0
1683645018935,AWP 10,014,202047,Staff,0,0,0,0
1683645018935,AWP 10,015,202048,Staff,0,0,0,0
1683645018935,AWP 10,016,202049,Staff,0,0,0,0
1683645018935,AWP 10,017,202050,Staff,0,0,0,0
1683645018935,AWP 10,018,202051,Staff,0,0,0,0
1683645018935,AWP 10,019,202052,Staff,0,0,0,0
1683645018935,AWP 10,020,202053,Staff,0,0,0,0
1683645018935,AWP 10,021,202054,Staff,0,0,0,0
1683645018935,AWP 10,022,202055,Staff,0,0,0,0
1683645018935,AWP 10,023,202056,Staff,0,0,0,0
1683645018935,AWP 10,024,202057,Staff,0,0,0,0
1683645018935,AWP 10,025,202058,Staff,0,0,0,0
1683645018935,AWP 10,026,202059,Staff,0,0,0,0
1683645019962,AWP 102,001,202032,Staff,0,0,0,0
1683645019962,AWP 102,002,202033,Staff,0,0,0,0
1683645020990,BENG 100,A01,254234,Taylor Amos; Alyssa C,31,0,40,9
1683645022013,BENG 196,001,270013,Engler; Adam J.,9999,0,9999,0
1683645023040,BICD 100R,A01,202018,Smith; Laurie,0,7,32,32
1683645023040,BICD 100R,A02,202019,Smith; Laurie,0,3,32,32
1683645023040,BICD 100R,A03,202020,Smith; Laurie,0,1,32,32
1683645023040,BICD 100R,A04,202021,Smith; Laurie,6,0,32,26
1683645023040,BICD 100R,A05,202022,Smith; Laurie,11,0,32,21
1683645024069,BICD 136,A01,193242,Gustafson-Brown; Cindy,0,2,32,32
1683645024069,BICD 136,A02,193244,Gustafson-Brown; Cindy,13,0,32,19
1683645025101,BIEB 102,A01,193249,Butler; Shannon Rhey,0,2,32,32
1683645025101,BIEB 102,A02,193251,Butler; Shannon Rhey,0,0,32,32
1683645025101,BIEB 102,A03,193253,Butler; Shannon Rhey,0,0,32,32
1683645025101,BIEB 102,A04,193255,Butler; Shannon Rhey,14,0,32,18
1683645025101,BIEB 102,A05,193265,Butler; Shannon Rhey,26,0,32,6
1683645025101,BIEB 102,A06,193269,Butler; Shannon Rhey,14,0,32,18
1683645027151,BIEB 150,A01,193274,Staff,0,0,32,32
1683645027151,BIEB 150,A02,193285,Staff,24,0,32,8
1683645028179,BIEB 194,A00,193286,Kurle; Carolyn M.,20,0,32,12
1683645029203,BILD 1,A01,192291,Staff,15,0,32,17
1683645029203,BILD 1,A02,192292,Staff,30,0,32,2
1683645029203,BILD 1,B01,192520,Reuther; Keefe,0,1,0,0
1683645029203,BILD 1,B02,192532,Reuther; Keefe,0,1,0,0
1683645030231,BILD 3,A01,192556,Butler; Shannon Rhey,0,0,32,32
1683645030231,BILD 3,A02,192581,Butler; Shannon Rhey,1,0,32,31
1683645030231,BILD 3,A03,192611,Butler; Shannon Rhey,21,0,32,11
1683645030231,BILD 3,A04,192612,Butler; Shannon Rhey,24,0,32,8
1683645030231,BILD 3,A05,192613,Butler; Shannon Rhey,26,0,32,6
1683645030231,BILD 3,A06,192679,Butler; Shannon Rhey,27,0,32,5
1683645030231,BILD 3,A07,192682,Butler; Shannon Rhey,20,0,32,12
1683645031257,BILD 4,A01,192836,Reuther; Keefe,0,0,24,24
1683645031257,BILD 4,A02,193044,Reuther; Keefe,4,0,24,20
1683645032280,BILD 10,A01,193142,Gustafson-Brown; Cindy,29,0,32,3
1683645032280,BILD 10,A02,193149,Gustafson-Brown; Cindy,31,0,32,1
1683645033307,BIMM 100,A01,193301,Staff,0,6,32,32
1683645033307,BIMM 100,A02,193312,Staff,0,7,32,32
1683645033307,BIMM 100,A03,193323,Staff,0,9,32,32
1683645034333,BIMM 101,A01,193329,McDonnell; Lisa Marie,0,4,24,24
1683645034333,BIMM 101,A02,193339,McDonnell; Lisa Marie,0,3,24,24
1683645034333,BIMM 101,B01,193354,McDonnell; Lisa Marie,0,4,24,24
1683645034333,BIMM 101,B02,193357,McDonnell; Lisa Marie,0,3,24,24
1683645035361,BIMM 110,A01,193377,Tat; John,0,11,32,32
1683645035361,BIMM 110,A02,193378,Tat; John,0,10,32,32
1683645036384,BIMM 120,A01,206116,Staff,0,0,32,32
1683645036384,BIMM 120,A02,206117,Staff,6,0,32,26
1683645036384,BIMM 120,A03,206121,Staff,21,0,32,11
1683645037415,BIPN 100,A01,193393,Park; Ji Young,0,14,32,32
1683645037415,BIPN 100,A02,193402,Park; Ji Young,0,14,32,32
1683645037415,BIPN 100,A03,193413,Park; Ji Young,0,14,32,32
1683645037415,BIPN 100,A04,193414,Park; Ji Young,0,13,32,32
1683645038440,BIPN 102,A01,193429,Staff,0,0,32,32
1683645038440,BIPN 102,A02,193438,Staff,18,0,32,14
1683645039468,BIPN 106,A01,193450,Reyes Gonzalez; Catalina,0,2,40,40
1683645040497,BIPN 134,A01,193465,Cooke; James Edward,0,0,32,32
1683645040497,BIPN 134,A02,193474,Cooke; James Edward,25,0,32,7
1683645040497,BIPN 134,A03,193485,Cooke; James Edward,29,0,32,3
1683645040497,BIPN 134,A04,193486,Cooke; James Edward,20,0,32,12
1683645040497,BIPN 134,A05,193491,Cooke; James Edward,31,0,32,1
1683645040497,BIPN 134,A06,193501,Cooke; James Edward,30,0,32,2
1683645040497,BIPN 134,A07,193510,Cooke; James Edward,29,0,32,3
1683645042550,BISP 194,A00,222522,Staff,14,0,32,18
1683645043578,CAT 124,A01,202407,Staff,19,0,25,6
1683645044604,CAT 125,A00,202408,Marchisotto; Jennifer Anne,2,0,20,18
1683645045635,CAT 125R,A00,202409,Smith; Lauryn Alissa,0,11,20,20
1683645045635,CAT 125R,B00,202410,Morales; Celeste Georgianna,0,11,20,20
1683645045635,CAT 125R,C00,202411,Irwin; Matthew Joseph,0,12,20,20
1683645046664,CENG 15,A01,204712,Yang; Kesong,0,1,0,0
1683645047689,CENG 114,A00,202070,Jahed Motlagh; Zeinab,5,0,20,15
1683645048713,CGS 105,A00,185477,Wesling; Megan E.,24,0,40,16
1683645049741,CGS 106,A00,185494,Staff,11,0,22,11
1683645050768,CGS 108,A00,185495,Staff,14,0,20,6
1683645051793,CGS 114,A00,185496,Staff,13,0,18,5
1683645052827,CGS 119,A00,185501,Staff,15,0,20,5
1683645053863,CGS 120,A00,185511,Staff,12,0,20,8
1683645054888,CHEM 4,A01,184675,Bussey; Thomas J,97,0,100,3
1683645055914,CHEM 6A,A01,184677,Staff,33,0,60,27
1683645056938,CHEM 6B,A01,184679,Staff,63,0,100,37
1683645057962,CHEM 6C,A01,184681,Bussey; Thomas J,0,0,50,50
1683645057962,CHEM 6C,A02,184682,Bussey; Thomas J,32,0,50,18
1683645058987,CHEM 40A,A01,184684,Albizati; Kim F.,34,0,100,66
1683645060012,CHEM 40B,A01,184686,Albizati; Kim F.,0,22,100,100
1683645061037,CHEM 41B,A01,184690,Staff,51,0,100,49
1683645062069,COGS 3,A01,184715,Boyle; Mary E. T.,0,27,40,40
1683645063094,COGS 14B,A01,185172,Staff,0,14,38,38
1683645064129,COGS 18,A01,184736,Staff,15,0,80,65
1683645065156,COGS 100,A01,184932,Staff,0,7,73,73
1683645066187,COGS 101A,A01,184935,Staff,0,39,30,30
1683645067214,COGS 101B,A01,184944,Staff,0,2,30,30
1683645068240,COGS 101C,A01,184946,Staff,0,10,30,30
1683645069265,COGS 102A,A01,184951,Johnson; Christine M.,2,0,40,38
1683645070290,COGS 107B,A01,184953,Mooshagian; Eric Frederick,0,51,40,40
1683645071315,COGS 118B,A01,184959,Gupta; Anjum,0,49,40,40
1683645072349,COGS 153,A00,184961,Staff,0,16,30,30
1683645073372,COGS 177,A00,184962,Staff,0,21,30,30
1683645074403,COGS 187A,A01,184969,Boyle; Mary E. T.,0,19,40,40
1683645075429,COMM 10,A01,185174,Staff,0,5,25,25
1683645075429,COMM 10,A02,185189,Staff,0,2,25,25
1683645075429,COMM 10,A03,269821,Staff,0,1,0,0
1683645076451,COMM 100B,A01,185475,Staff,0,1,0,2
1683645076451,COMM 100B,A02,185476,Staff,12,0,25,13
1683645077478,COMM 100C,A01,185314,Staff,1,0,25,24
1683645077478,COMM 100C,A02,185327,Staff,18,0,25,7
1683645078503,COMM 110M,A00,185349,Staff,0,0,40,40
1683645079590,COMM 113T,A00,185352,Staff,25,0,40,15
1683645080615,COMM 114I,A00,185353,Staff,31,0,40,9
1683645081639,COMM 131,A00,185354,Staff,17,0,30,13
1683645082666,CSE 8A,A50,185358,Cao; Yingjun,0,46,10,10
1683645083691,CSE 8B,A01,185362,Staff,0,48,50,50
1683645084716,CSE 11,A01,185416,Cao; Yingjun,0,91,10,10
1683645085741,CSE 20,A01,185445,Briones; Jor-el Thomas Caparas,4,0,25,21
1683645086767,CSE 21,A01,185447,Staff,9,0,50,41
1683645087795,CSE 101,A01,185451,Staff,0,13,50,50
1683645087795,CSE 101,B01,185453,Jones; Miles E,0,13,50,50
1683645089845,CSE 141,A01,185458,Eldon; John,15,0,100,85
1683645090875,CSE 141L,A01,185461,Eldon; John,7,0,100,93
1683645091903,CSE 142,A01,185463,Staff,36,0,60,24
1683645091903,CSE 142,B01,201355,Staff,0,7,60,60
1683645092930,CSE 142L,A01,185470,Staff,36,0,60,24
1683645092930,CSE 142L,B01,201417,Staff,0,6,60,60
1683645093957,CSE 190,A00,201433,Staff,32,0,49,17
1683645094986,DOC 1,A01,259136,Strom; Megan C.,7,0,15,8
1683645094986,DOC 1,A02,259137,Strom; Megan C.,14,0,15,1
1683645094986,DOC 1,A03,259138,Strom; Megan C.,14,0,15,1
1683645094986,DOC 1,A04,259139,Strom; Megan C.,14,0,15,1
1683645096011,DOC 100D,A00,259140,Pass; Natalye Joann,14,0,25,11
1683645097037,DSGN 1,A01,184749,Rill; Bryan,0,26,30,30
1683645098063,DSGN 100,A01,185168,Staff,0,2,25,25
1683645099088,ECE 5,A01,185626,Morris; Karcher William,0,11,0,0
1683645100113,ECE 101,A01,185628,Staff,14,0,70,56
1683645101139,ECE 107,A01,185635,Baghdadchi; Saharnaz,0,0,20,20
1683645101139,ECE 107,A02,185638,Baghdadchi; Saharnaz,3,0,20,17
1683645102166,ECE 148,A01,185647,Silberman; Jack,0,0,16,16
1683645103197,ECON 1,A01,185537,Crane; Meredith Helen,54,0,70,16
1683645104222,ECON 3,A01,185549,Crane; Meredith Helen,29,0,70,41
1683645105252,ECON 4,A01,203354,Anderson; John Charles,0,5,10,10
1683645106278,ECON 100A,A01,185574,Staff,0,5,40,40
1683645107312,ECON 100B,A01,185576,Staff,0,12,50,50
1683645108340,ECON 100C,A01,185589,Newhouse; Herbert S,30,0,70,40
1683645109369,ECON 105,A00,185608,Vespa; Emanuel Ignacio,19,0,35,16
1683645110399,ECON 109,A01,185610,Shishkin; Denis,9,0,35,26
1683645111423,ECON 110A,A01,185612,Staff,9,0,40,31
1683645112453,ECON 120A,A01,185615,Staff,20,0,40,20
1683645113476,ECON 120C,A01,185617,Sun; Yixiao,0,20,70,70
1683645114501,ECON 144,A00,203346,Squires; Dale E,2,0,35,33
1683645115530,ECON 171,A01,203349,Newhouse; Herbert S,0,1,35,35
1683645116556,ECON 173A,A01,185621,Toda; Alexis Akira,21,0,35,14
1683645117585,EDS 25,A01,202413,Staff,0,1,0,0
1683645117585,EDS 25,A02,202414,Staff,0,1,0,0
1683645117585,EDS 25,A03,202415,Staff,0,0,0,0
1683645117585,EDS 25,A04,202416,Staff,0,1,0,0
1683645117585,EDS 25,A05,202439,Staff,0,0,0,0
1683645117585,EDS 25,A06,202440,Staff,0,0,0,0
1683645117585,EDS 25,B01,202631,Staff,0,0,0,0
1683645117585,EDS 25,B02,202632,Staff,0,0,0,0
1683645117585,EDS 25,B03,202639,Staff,0,0,0,0
1683645117585,EDS 25,B04,202640,Staff,0,0,0,0
1683645117585,EDS 25,B05,202643,Staff,0,0,0,0
1683645117585,EDS 25,B06,202644,Staff,0,0,0,0
1683645118615,EDS 38,A01,202659,Black; Alison Michelle,24,0,25,1
1683645119642,EDS 115,A00,202652,Staff,18,0,30,12
1683645120669,EDS 125,A00,202649,Staff,13,0,30,17
1683645121698,EDS 126,A01,203332,Staff,30,0,30,0
1683645122723,EDS 139,A00,202838,Staff,16,0,25,9
1683645123754,EDS 146,A01,202655,Staff,14,0,25,11
1683645124783,ENG 15,A00,185667,Staff,0,1,0,0
1683645124783,ENG 15,B00,185672,Staff,0,0,0,0
1683645124783,ENG 15,C00,185675,Staff,0,0,0,0
1683645124783,ENG 15,D00,185682,Staff,0,0,0,0
1683645124783,ENG 15,E00,185684,Staff,0,0,0,0
1683645125813,ETHN 103,A00,185710,Staff,0,8,35,35
1683645126841,ETHN 103A,A00,199228,Man; Simeon S,0,0,9,9
1683645127866,ETHN 109,A00,185711,Staff,16,0,35,19
1683645128895,ETHN 142,A00,185726,Staff,0,4,30,30
1683645129920,ETHN 163J,A00,199229,Man; Simeon S,5,0,8,3
1683645130948,ETHN 168,A00,185727,Staff,7,0,10,3
1683645131976,ETHN 182,A00,185728,Staff,0,0,35,35
1683645133002,ETHN 183,A00,185737,Staff,9,0,18,9
1683645134027,GLBH 111,A01,209361,Burgos; Jose L.,0,0,0,0
1683645136083,HIEU 104,A00,185792,Staff,14,0,20,6
1683645137107,HIEU 115,A00,185800,Staff,0,0,20,20
1683645138131,HIEU 128,A00,185801,Staff,0,9,20,20
1683645139159,HIEU 147,A00,185802,Staff,15,0,20,5
1683645140192,HIEU 154,A00,185823,Staff,11,0,20,9
1683645141222,HILA 102,A00,185826,Staff,14,0,20,6
1683645142246,HILD 2C,A01,185778,Staff,0,13,20,20
1683645143275,HILD 7B,A01,185780,Kwak; Nancy,0,16,32,32
1683645143275,HILD 7B,A02,185781,Kwak; Nancy,0,18,32,32
1683645144301,HILD 30,A01,185791,Staff,12,0,20,8
1683645145325,HISC 119,A00,185830,Golan; Tal,0,9,20,20
1683645146351,HITO 156GS,A00,185831,Patterson; Patrick H.,0,0,0,23
1683645147385,HIUS 103,A00,185832,Man; Simeon S,0,4,20,20
1683645148412,HIUS 117,A00,185836,Kwak; Nancy,2,0,20,18
1683645149440,HIUS 125,A00,185840,Man; Simeon S,0,1,23,23
1683645150466,HIUS 149,A00,185845,Staff,1,0,20,19
1683645151494,HUM 3,A01,185882,Zavodny; Tatiana Sophia,0,7,50,50
1683645151494,HUM 3,B01,185899,Caldwell; Michael Alan,0,18,50,50
1683645152520,HUM 3GS,A00,185900,Patterson; Patrick H.,0,0,0,23
1683645153552,HUM 4,A01,185938,Zroka; Amy Liane,30,0,50,20
1683645153552,HUM 4,B01,185956,Watkins; Eric,0,4,50,50
1683645153552,HUM 4,B02,202209,Watkins; Eric,0,4,50,50
1683645153552,HUM 4,B03,202210,Watkins; Eric,0,4,50,50
1683645154581,HUM 5,A01,185958,West; Geoffrey Scott,2,0,50,48
1683645154581,HUM 5,A02,202215,West; Geoffrey Scott,0,0,50,50
1683645155607,INTL 190,A00,185959,Gagnon; Jeffrey C,0,0,0,9
1683645155607,INTL 190,B00,185960,Lettieri; Michael Joseph,0,0,0,2
1683645156634,JAPN 180,A00,254509,Staff,5,0,30,25
1683645157664,LATI 10,A01,202853,Kennemore; Amy Michelle,4,0,35,31
1683645157664,LATI 10,A02,202854,Kennemore; Amy Michelle,2,0,35,33
1683645157664,LATI 10,A03,270054,Kennemore; Amy Michelle,30,0,30,0
1683645158692,LATI 180,A00,202855,Kennemore; Amy Michelle,11,0,20,9
1683645159723,LAWS 101,A00,201767,Golan; Tal,0,7,40,40
1683645160747,LIFR 1C,A00,185961,Staff,6,0,20,14
1683645161773,LIFR 1CX,A00,185962,Staff,7,0,20,13
1683645162800,LIFR 1D,A00,185963,Staff,7,0,20,13
1683645163825,LIFR 1DX,A00,185964,Staff,7,0,20,13
1683645164850,LIGN 101,A01,186039,Staff,43,0,50,7
1683645165875,LIGN 165,A00,186040,Staff,15,0,50,35
1683645166900,LTCS 108,A00,186041,Staff,5,0,10,5
1683645167924,LTCS 119,A00,186042,Staff,15,0,20,5
1683645168949,LTCS 130,A00,186043,Wesling; Megan E.,15,0,25,10
1683645171005,LTEA 138,A00,186119,Staff,14,0,40,26
1683645172033,LTEN 124,A00,186148,Staff,5,0,25,20
1683645173058,LTEN 178,A00,186149,Staff,7,0,15,8
1683645174089,LTEN 181,A00,186150,Blanco; John D,34,0,40,6
1683645175119,LTWL 120,A00,186160,Staff,20,0,25,5
1683645176147,LTWL 165,A00,186161,Staff,22,0,25,3
1683645177175,LTWR 100,A00,186162,Staff,0,5,15,15
1683645178202,LTWR 102,A00,186163,Doller; Ben,5,0,15,10
1683645179228,MAE 8,A01,186412,Staff,0,0,0,0
1683645180253,MAE 30B,A00,186445,Bahadori; Mohammad Yousef,82,0,100,18
1683645181281,MAE 40,A00,186592,Bewley; Thomas R,10,0,50,40
1683645182306,MAE 101B,A00,186593,Bahadori; Mohammad Yousef,80,0,100,20
1683645183388,MAE 105,A00,186594,Bandaru; Prabhakar,10,0,50,40
1683645184413,MAE 107,A00,186599,Pham; Hieu Tan,0,7,120,120
1683645185438,MAE 148,A01,186660,Silberman; Jack,3,0,16,13
1683645186463,MATH 10A,A01,188095,Staff,0,5,35,35
1683645187492,MATH 10B,A01,188097,Bowers; Adam R.,0,11,30,30
1683645187492,MATH 10B,A02,188099,Bowers; Adam R.,0,11,30,30
1683645187492,MATH 10B,B01,188104,Bowers; Adam R.,0,10,30,30
1683645187492,MATH 10B,B02,188106,Bowers; Adam R.,1,9,30,29
1683645188518,MATH 10C,A01,188111,Staff,0,18,30,30
1683645188518,MATH 10C,A02,188127,Staff,0,19,30,30
1683645188518,MATH 10C,A03,188131,Staff,0,19,30,30
1683645188518,MATH 10C,B01,188218,Staff,17,0,30,13
1683645188518,MATH 10C,B02,188244,Staff,13,0,30,17
1683645188518,MATH 10C,B03,188277,Staff,14,0,30,16
1683645189548,MATH 18,A01,188344,Bach; Quang Tran,18,0,30,12
1683645189548,MATH 18,A02,188345,Bach; Quang Tran,11,0,30,19
1683645189548,MATH 18,B01,188353,Bach; Quang Tran,11,0,30,19
1683645189548,MATH 18,B02,188354,Bach; Quang Tran,19,0,30,11
1683645190573,MATH 20A,A01,188374,Staff,11,0,35,24
1683645191599,MATH 20B,A01,188382,Ohm; Ko Woon,7,0,30,23
1683645191599,MATH 20B,A02,188383,Ohm; Ko Woon,22,0,30,8
1683645191599,MATH 20B,B01,188385,Ohm; Ko Woon,7,0,30,23
1683645191599,MATH 20B,B02,188392,Ohm; Ko Woon,22,0,30,8
1683645192626,MATH 20C,A01,188394,Harel; Guershon,11,0,30,19
1683645192626,MATH 20C,A02,188395,Harel; Guershon,14,0,30,16
1683645192626,MATH 20C,B01,188404,Harel; Guershon,4,0,30,26
1683645192626,MATH 20C,B02,188405,Harel; Guershon,18,0,30,12
1683645193651,MATH 20D,A01,188414,Hammock; Frances H,0,1,30,30
1683645193651,MATH 20D,A02,188415,Hammock; Frances H,0,1,30,30
1683645193651,MATH 20D,B01,188447,Hammock; Frances H,0,1,30,30
1683645193651,MATH 20D,B02,188486,Hammock; Frances H,4,0,30,26
1683645194676,MATH 20E,A01,188649,Staff,21,0,30,9
1683645194676,MATH 20E,A02,188650,Staff,21,0,30,9
1683645194676,MATH 20E,A03,188673,Staff,0,0,30,30
1683645195701,MATH 102,A01,188675,Staff,0,36,35,35
1683645196729,MATH 103B,A01,188681,Staff,3,0,35,32
1683645196729,MATH 103B,B01,188692,Staff,5,0,35,30
1683645197758,MATH 109,A01,188695,Salehi Golsefidy; Alireza,24,0,35,11
1683645197758,MATH 109,A02,188696,Salehi Golsefidy; Alireza,25,0,35,10
1683645198786,MATH 120A,A01,188698,Eggers; John Dietrich,7,0,35,28
1683645199815,MATH 142B,A01,188736,Ioana; Adrian,0,1,30,30
1683645199815,MATH 142B,A02,188741,Ioana; Adrian,0,1,30,30
1683645199815,MATH 142B,A03,188743,Ioana; Adrian,0,1,30,30
1683645200843,MATH 168A,A01,188790,Staff,0,10,35,35
1683645201869,MATH 170A,A01,188803,Nie; Jiawang,0,2,35,35
1683645201869,MATH 170A,A02,188811,Nie; Jiawang,0,0,35,35
1683645201869,MATH 170A,A03,188814,Nie; Jiawang,0,0,35,35
1683645201869,MATH 170A,A04,188815,Nie; Jiawang,10,0,35,25
1683645202893,MATH 193B,A01,188817,Staff,0,0,35,35
1683645202893,MATH 193B,A02,188818,Staff,5,0,35,30
1683645203919,MGT 4,A01,202857,Anderson; John Charles,61,0,80,19
1683645204948,MGT 12,A00,202858,Lindenberger; Wade Douglas,40,0,90,50
1683645205971,MGT 18,A00,202859,Staff,74,0,90,16
1683645206998,MGT 18GS,A00,202860,McKay; Michael J,13,0,28,15
1683645208023,MGT 45,A00,202861,Pecore; Joseph P.,12,0,90,78
1683645209051,MGT 100,A00,202863,Yavorsky; Daniel Ryan,28,0,90,62
1683645210078,MGT 103,A00,202864,Ehrich; Kristine R,0,17,90,90
1683645211104,MGT 112,A00,202865,Ehrich; Kristine R,15,0,90,75
1683645212133,MGT 121A,A00,202868,Staff,0,20,0,0
1683645213161,MGT 131B,A00,202869,Anderson; John Charles,59,0,90,31
1683645214185,MGT 136,A00,202871,Lindenberger; Wade Douglas,83,0,90,7
1683645215213,MGT 164,A00,202873,Staff,0,66,90,91
1683645216240,MGT 164GS,A00,202874,McKay; Mary A,13,0,28,15
1683645217268,MGT 180,A00,202875,Staff,0,50,90,91
1683645218292,MMW 11R,A01,205019,Herbst; Matthew,2,0,30,28
1683645218292,MMW 11R,A02,205026,Herbst; Matthew,29,0,30,1
1683645219320,MMW 15,A01,193512,Chang; Edmond Yi-Teh,0,8,28,28
1683645219320,MMW 15,A02,193513,Chang; Edmond Yi-Teh,0,5,28,28
1683645219320,MMW 15,A03,193514,Chang; Edmond Yi-Teh,0,5,28,28
1683645219320,MMW 15,A04,193515,Chang; Edmond Yi-Teh,0,5,28,28
1683645219320,MMW 15,A05,193516,Chang; Edmond Yi-Teh,0,5,28,28
1683645219320,MMW 15,A06,193517,Chang; Edmond Yi-Teh,0,6,28,28
1683645219320,MMW 15,B01,193519,Chang; Edmond Yi-Teh,0,5,28,28
1683645219320,MMW 15,B02,193520,Chang; Edmond Yi-Teh,0,5,28,28
1683645219320,MMW 15,B03,193521,Chang; Edmond Yi-Teh,0,5,28,28
1683645219320,MMW 15,B04,193522,Chang; Edmond Yi-Teh,0,5,28,28
1683645219320,MMW 15,B05,193523,Chang; Edmond Yi-Teh,0,5,28,28
1683645219320,MMW 15,B06,193524,Chang; Edmond Yi-Teh,0,5,28,28
1683645220345,MMW 122,A01,193526,Rahimi; Babak,0,16,28,28
1683645220345,MMW 122,A02,193527,Rahimi; Babak,0,15,28,28
1683645220345,MMW 122,A03,193528,Rahimi; Babak,0,0,0,0
1683645220345,MMW 122,A04,193529,Rahimi; Babak,0,0,0,0
1683645221372,MUS 1A,A01,186663,Staff,1,20,35,34
1683645222397,MUS 4,A01,186715,Staff,0,12,35,35
1683645223426,MUS 5R,A01,186796,Dubnov; Shlomo,0,17,35,35
1683645224450,MUS 6,A01,186798,Staff,0,5,25,25
1683645225476,MUS 7,A01,186830,Staff,11,0,35,24
1683645226505,MUS 8,A01,186930,Staff,0,26,35,35
1683645227529,MUS 15,A01,186932,Staff,0,16,35,35
1683645227529,MUS 15,B01,186934,Staff,0,17,35,35
1683645228555,MUS 80,A00,186935,Staff,0,0,20,20
1683645228555,MUS 80,B00,186936,Staff,24,0,25,1
1683645229581,NANO 11,A00,204702,Lipomi; Darren John,0,0,0,0
1683645230604,NANO 15,A01,204709,Yang; Kesong,0,1,0,0
1683645231630,NANO 114,A00,202069,Jahed Motlagh; Zeinab,3,0,10,7
1683645232654,PHIL 1,A00,186955,Grush; Rick Scott,31,0,40,9
1683645233681,PHIL 10,A01,186973,Grush; Rick Scott,27,0,35,8
1683645233681,PHIL 10,A02,186974,Grush; Rick Scott,33,0,35,2
1683645234705,PHIL 13,A01,186976,Staff,3,0,35,32
1683645234705,PHIL 13,A02,186977,Staff,16,0,35,19
1683645235732,PHIL 14,A01,186979,Staff,31,0,35,4
1683645235732,PHIL 14,A02,186986,Staff,32,0,35,3
1683645236756,PHIL 28,A01,186988,Staff,16,0,30,14
1683645236756,PHIL 28,A02,186989,Staff,1,0,30,29
1683645236756,PHIL 28,A03,186990,Staff,10,0,30,20
1683645236756,PHIL 28,A04,186991,Staff,26,0,30,4
1683645237784,PHIL 120,A00,186997,Staff,23,0,40,17
1683645238809,PHIL 137,A00,187003,Staff,7,0,40,33
1683645239833,PHIL 150,A00,187015,Staff,47,0,70,23
1683645240861,PHIL 167,A00,187021,Lamey; Andy M.,34,0,40,6
1683645241895,PHIL 174,A01,202226,Staff,17,0,20,3
1683645241895,PHIL 174,A02,202235,Staff,20,0,20,0
1683645242920,PHIL 191A,A00,258918,Staff,0,0,1,1
1683645243947,PHYS 1A,A00,187028,Staff,27,0,60,33
1683645244982,PHYS 1AL,001,187036,Staff,3,0,30,27
1683645244982,PHYS 1AL,002,187049,Staff,18,0,30,12
1683645246009,PHYS 1B,A00,187058,Staff,22,0,60,38
1683645247035,PHYS 1BL,001,187064,Staff,0,1,30,30
1683645247035,PHYS 1BL,002,187070,Staff,4,0,30,26
1683645248058,PHYS 1C,A00,187082,Staff,29,0,120,91
1683645249083,PHYS 1CL,001,187088,Staff,0,9,30,30
1683645249083,PHYS 1CL,002,187089,Staff,0,1,30,30
1683645249083,PHYS 1CL,009,262693,Staff,9,0,30,21
1683645250110,PHYS 2B,A01,187097,Staff,55,0,115,60
1683645251138,PHYS 2C,A01,187099,Staff,64,0,115,51
1683645252165,PHYS 2CL,A01,187101,Staff,5,0,28,23
1683645252165,PHYS 2CL,A02,187102,Staff,15,0,28,13
1683645253190,PHYS 2D,A01,187123,Shotwell; Brian,95,0,115,20
1683645254218,PHYS 4B,A01,187133,Grinstein; Benjamin,35,0,50,15
1683645255245,POLI 10,A00,188819,Staff,0,4,50,50
1683645256269,POLI 11,A00,188827,Staff,43,0,50,7
1683645257293,POLI 13R,A00,188828,Staff,0,1,20,20
1683645258321,POLI 27,A01,188830,Elgin; Samuel Zincke,0,2,70,70
1683645259349,POLI 30,A00,188832,Desposato; Scott,30,0,50,20
1683645260376,POLI 102F,A00,188834,Staff,0,0,40,40
1683645261400,POLI 104A,A00,188852,Staff,13,0,30,17
1683645262424,POLI 104I,A00,188853,Staff,0,7,20,20
1683645263449,POLI 110B,A00,188854,Wiens; David,7,0,20,13
1683645264473,POLI 112A,A00,188855,Wiens; David,4,0,30,26
1683645265501,POLI 117R,A00,188856,Forman; Fonna,0,12,20,20
1683645266528,POLI 118,A00,188857,Ingham; Sean,8,0,20,12
1683645267558,POLI 120G,A00,188858,Staff,8,0,30,22
1683645268583,POLI 131CR,A00,188863,Hoston; Germaine,21,0,50,29
1683645269608,POLI 133,A00,188864,Nellis; Gareth Hb,44,0,50,6
1683645270635,POLI 134D,A00,188865,Desposato; Scott,27,0,30,3
1683645271663,POLI 142A,A00,188871,Gartzke; Erik,21,0,50,29
1683645272690,POLI 142K,A00,188874,Staff,38,0,50,12
1683645273714,POLI 143,A00,188940,Gartzke; Erik,16,0,30,14
1683645274737,POLI 153,A00,188943,Staff,2,0,20,18
1683645275765,POLI 160AA,A00,188944,Staff,11,0,40,29
1683645276788,POLI 170A,A00,188945,Staff,11,0,30,19
1683645278842,PSYC 1,A00,188952,Staff,36,0,90,54
1683645279867,PSYC 2,B00,188953,Staff,19,0,35,16
1683645280894,PSYC 6,A00,188970,Staff,47,0,60,13
1683645281918,PSYC 7,A00,188973,Staff,35,0,45,10
1683645282949,PSYC 60,A01,188980,Rickard; Timothy C.,42,0,60,18
1683645283973,PSYC 70,A01,189001,Steiner; Eric Tomas,23,0,45,22
1683645284998,PSYC 100,A00,189005,Lacefield; Katharine I,0,99,120,120
1683645286022,PSYC 102,A00,189008,Staff,8,0,30,22
1683645287120,PSYC 106,B00,189026,Gorman; Michael R.,27,0,60,33
1683645288148,PSYC 114,B01,189033,Winkielman; Piotr,0,31,30,30
1683645289171,PSYC 131,A00,189036,Anagnostaras; Stephan,0,43,60,60
1683645290199,PSYC 136,A00,189041,Lowe; Angela Beth,0,7,25,25
1683645291226,PSYC 137,A00,189057,Winkielman; Piotr,0,37,25,25
1683645292248,PSYC 144,A00,189107,Wixted; John T,0,10,50,50
1683645294303,PSYC 162,A00,189142,Staff,0,9,85,85
1683645295327,PSYC 172,A00,189144,Gorman; Michael R.,0,6,30,30
1683645297384,PSYC 179,A00,189146,Lacefield; Katharine I,0,86,120,120
1683645298408,PSYC 181,A00,189147,Anagnostaras; Stephan,0,44,90,90
1683645299430,PSYC 190R,A00,189148,Barner; David A.,0,23,80,80
1683645300454,PSYC 191,A00,189275,Rickard; Timothy C.,0,10,25,25
1683645301486,PSYC 193,A00,189276,Chapman; Eddie Nathaniel,0,1,0,4
1683645302514,PSYC 193L,A01,189281,Lowe; Angela Beth,10,0,20,10
1683645302514,PSYC 193L,B01,189285,Staff,28,0,35,7
1683645303538,RELI 149,A00,187137,Rahimi; Babak,7,0,40,33
1683645304561,SE 9,A01,187315,Staff,0,2,18,18
1683645305589,SE 101B,A00,187409,Staff,24,0,30,6
1683645306613,SE 110B,A00,187444,Staff,10,0,40,30
1683645307638,SE 130B,A00,187449,Staff,31,0,40,9
1683645308662,SE 150A,A00,187516,Staff,9,0,20,11
1683645309687,SE 154,A00,187528,Staff,29,0,50,21
1683645310713,SIO 3,A01,258171,Staff,35,0,40,5
1683645311738,SIO 10,A00,187144,Cook; Geoffrey W,0,6,75,75
1683645312761,SIO 45,A00,187152,Cook; Geoffrey W,0,4,100,100
1683645313786,SIO 109R,A00,194486,Staff,0,4,20,20
1683645315840,SIO 187,A01,187233,Kacev; David,12,0,40,28
1683645316869,SOCI 1,A01,258656,Thorpe; Charles Robert,28,0,30,2
1683645316869,SOCI 1,A02,258658,Thorpe; Charles Robert,30,0,30,0
1683645316869,SOCI 1,A03,258661,Thorpe; Charles Robert,25,0,25,0
1683645316869,SOCI 1,A04,258666,Thorpe; Charles Robert,22,0,25,3
1683645316869,SOCI 1,A05,258897,Thorpe; Charles Robert,22,0,25,3
1683645316869,SOCI 1,A06,258898,Thorpe; Charles Robert,25,0,25,0
1683645317896,SOCI 30,A01,258903,Pardo Guerra; Juan Pablo,14,0,30,16
1683645318921,SOCI 102,A00,258904,Staff,9,0,25,16
1683645319946,SOCI 106,A00,258905,Staff,19,0,25,6
1683645320972,SOCI 111,A00,258907,Ribas Norris; Janet Vanesa,26,0,30,4
1683645321996,SOCI 121R,A00,258908,Pardo Guerra; Juan Pablo,8,0,30,22
1683645323022,SOCI 126,A01,203330,Staff,14,0,20,6
1683645324046,SOCI 131,A00,258909,Thorpe; Charles Robert,30,0,60,30
1683645325075,SOCI 135,A00,258910,Payne; Christine Anna,0,11,30,30
1683645326099,SOCI 157,A00,258911,Staff,12,0,30,18
1683645327123,SOCI 184,A00,258912,Staff,25,0,30,5
1683645328146,SOCI 188D,A00,258913,Staff,22,0,30,8
1683645329169,SYN 2,001,187529,Staff,9,0,16,7
1683645329169,SYN 2,002,201452,Staff,0,20,16,16
1683645329169,SYN 2,003,201469,Staff,2,0,16,14
1683645330193,SYN 100,A01,187531,Staff,0,9,20,20
1683645330193,SYN 100,B01,201491,Staff,0,10,20,20
1683645331217,TDAC 1,A00,189286,Walsh; Kim C.,3,0,20,17
1683645331217,TDAC 1,B00,189287,Harting; Carla Kelso,10,0,20,10
1683645332243,TDAC 101,A00,189300,Walsh; Kim C.,16,0,20,4
1683645332243,TDAC 101,B00,189301,Harting; Carla Kelso,18,0,20,2
1683645333266,TDAC 102,A00,189304,Basso; Beatrice,14,0,20,6
1683645334293,TDAC 108,A00,189305,Staff,18,0,20,2
1683645335318,TDDE 131,A00,189310,Staff,19,0,20,1
1683645335318,TDDE 131,B00,189314,Staff,19,0,20,1
1683645335318,TDDE 131,C00,189315,Staff,48,0,50,2
1683645335318,TDDE 131,D00,189316,Staff,14,0,15,1
1683645335318,TDDE 131,E00,204841,Staff,20,0,20,0
1683645336341,TDGE 10,A00,189289,Staff,27,0,50,23
1683645336341,TDGE 10,B00,189290,Havis; Allan,0,0,50,50
1683645337365,TDGE 11,A00,189291,Fulton; Julia,0,4,50,50
1683645337365,TDGE 11,B00,189292,Staff,20,0,25,5
1683645337365,TDGE 11,C00,260270,Staff,0,0,0,0
1683645338390,TDGE 25,A00,189294,Staff,2,0,20,18
1683645339416,TDGE 124,A00,189318,Fulton; Julia,0,8,50,50
1683645340445,TDGE 125,A00,189319,Staff,13,0,25,12
1683645340445,TDGE 125,B00,189320,Staff,23,0,25,2
1683645341471,TDGE 127,A00,189322,Havis; Allan,0,0,50,50
1683645342505,TDHT 101,A00,189323,Staff,18,0,25,7
1683645342505,TDHT 101,B00,189324,Staff,25,0,25,0
1683645343532,TDHT 102,A00,189325,Staff,49,0,50,1
1683645344561,TDMV 1,A00,189295,Arcidiacono; Kristin,20,0,30,10
1683645344561,TDMV 1,B00,189296,Caligagan; Maria T.,24,0,30,6
1683645345591,TDMV 2,A00,189297,Sammartano; Tonnie,27,0,30,3
1683645345591,TDMV 2,B00,189299,Arcidiacono; Kristin,23,0,30,7
1683645346615,TDMV 3,A00,204998,Rincon; Alicia,22,0,30,8
1683645347640,TDMV 120,A00,189458,Sammartano; Tonnie,28,0,30,2
1683645348665,TDMV 138,A00,189541,Jun; Grace Shin Hae,20,0,40,20
1683645349694,TDMV 142,A00,189717,Caligagan; Tony,25,0,30,5
1683645349694,TDMV 142,B00,189718,Caligagan; Maria T.,25,0,30,5
1683645350724,TMC 2,A01,187533,Staff,25,0,25,0
1683645350724,TMC 2,A02,187534,Staff,25,0,25,0
1683645351754,USP 1,A01,187536,Kwak; Nancy,0,16,25,25
1683645352781,USP 5,A01,187538,Staff,9,0,25,16
1683645353810,USP 101,A00,199253,Staff,0,4,0,0
1683645354840,USP 124,A00,187562,Boomhower; Matthew Charles,0,0,30,30
1683645355873,USP 138,A00,187582,Staff,20,0,25,5
1683645356901,USP 152,A01,187597,Staff,3,0,25,22
1683645357929,USP 153,A00,187598,Staff,19,0,25,6
1683645358957,USP 168,A00,187607,Kwak; Nancy,2,0,5,3
1683645359985,USP 173,A00,187619,Staff,4,0,25,21
1683645361010,USP 181,A00,187638,Staff,0,4,25,25
1683645362035,VIS 103,A00,187650,Cruz; Edwin Teddy,18,0,75,57
1683645363060,VIS 110D,A00,187669,Staff,13,0,22,9
1683645364086,VIS 127C,A00,187720,Shen; Kuiyi,67,0,146,79
1683645365111,VIS 149,A00,187731,Yoldas; Pinar,0,14,22,22
1683645366139,VIS 151,A01,188091,Staff,22,0,34,12
1683645366139,VIS 151,A02,188092,Staff,11,0,34,23
1683645367171,VIS 160B,A00,188093,Stalbaum; Brett,0,1,10,10
1683645369220,WCWP 10B,A00,201720,Staff,10,0,15,5
1683645369220,WCWP 10B,B00,201722,Staff,9,0,15,6
1683645370245,WCWP 100,A00,201725,Gagnon; Jeffrey C,0,0,2,2
1683645370245,WCWP 100,B00,201727,Staff,0,4,15,15
1683645373347,ANBI 133,A00,258401,Wilder; Linnea Lorene,34,0,40,6
1683645374370,ANBI 140,A00,258395,Hrvoj Mihic; Branka,18,0,25,7
1683645375398,ANSC 120,A00,258402,Bialecki; Jon Anthony,26,0,40,14
1683645376422,ANSC 144,A00,258400,Staff,12,0,40,28
1683645378480,ANSC 166,A00,258396,Parish; Steven Martin,156,0,175,19
1683645379508,ANSC 180,A00,193533,Staff,8,0,20,12
1683645380539,ANSC 188,A00,258397,Jassal; Aftab,34,0,40,6
1683645381563,ANTH 3,A01,258316,Staff,23,0,30,7
1683645382591,ANTH 5,A00,258394,Semendeferi; Ekaterini,16,0,20,4
1683645383618,ANTH 21,A01,258331,Staff,4,0,40,36
1683645384643,ANTH 103,A00,258398,Varma; Saiba,15,0,25,10
1683645385677,AWP 10,001,202034,Staff,0,0,0,0
1683645385677,AWP 10,002,202035,Staff,0,0,0,0
1683645385677,AWP 10,003,202036,Staff,0,0,0,0
1683645385677,AWP 10,004,202037,Staff,0,0,0,0
1683645385677,AWP 10,005,202038,Staff,0,0,0,0
1683645385677,AWP 10,006,202039,Staff,0,0,0,0
1683645385677,AWP 10,007,202040,Staff,0,0,0,0
1683645385677,AWP 10,008,202041,Staff,0,0,0,0
1683645385677,AWP 10,009,202042,Staff,0,0,0,0
1683645385677,AWP 10,010,202043,Staff,0,0,0,0
1683645385677,AWP 10,011,202044,Staff,0,0,0,0
1683645385677,AWP 10,012,202045,Staff,0,0,0,0
1683645385677,AWP 10,013,202046,Staff,0,0,0,0
1683645385677,AWP 10,014,202047,Staff,0,0,0,0
1683645385677,AWP 10,015,202048,Staff,0,0,0,0
1683645385677,AWP 10,016,202049,Staff,0,0,0,0
1683645385677,AWP 10,017,202050,Staff,0,0,0,0
1683645385677,AWP 10,018,202051,Staff,0,0,0,0
1683645385677,AWP 10,019,202052,Staff,0,0,0,0
1683645385677,AWP 10,020,202053,Staff,0,0,0,0
1683645385677,AWP 10,021,202054,Staff,0,0,0,0
1683645385677,AWP 10,022,202055,Staff,0,0,0,0
1683645385677,AWP 10,023,202056,Staff,0,0,0,0
1683645385677,AWP 10,024,202057,Staff,0,0,0,0
1683645385677,AWP 10,025,202058,Staff,0,0,0,0
1683645385677,AWP 10,026,202059,Staff,0,0,0,0
1683645386701,AWP 102,001,202032,Staff,0,0,0,0
1683645386701,AWP 102,002,202033,Staff,0,0,0,0
1683645387724,BENG 100,A01,254234,Taylor Amos; Alyssa C,31,0,40,9
1683645388749,BENG 196,001,270013,Engler; Adam J.,9999,0,9999,0
1683645389773,BICD 100R,A01,202018,Smith; Laurie,0,7,32,32
1683645389773,BICD 100R,A02,202019,Smith; Laurie,0,3,32,32
1683645389773,BICD 100R,A03,202020,Smith; Laurie,0,1,32,32
1683645389773,BICD 100R,A04,202021,Smith; Laurie,6,0,32,26
1683645389773,BICD 100R,A05,202022,Smith; Laurie,11,0,32,21
1683645390856,BICD 136,A01,193242,Gustafson-Brown; Cindy,0,2,32,32
1683645390856,BICD 136,A02,193244,Gustafson-Brown; Cindy,13,0,32,19
1683645391881,BIEB 102,A01,193249,Butler; Shannon Rhey,0,2,32,32
1683645391881,BIEB 102,A02,193251,Butler; Shannon Rhey,0,0,32,32
1683645391881,BIEB 102,A03,193253,Butler; Shannon Rhey,0,0,32,32
1683645391881,BIEB 102,A04,193255,Butler; Shannon Rhey,14,0,32,18
1683645391881,BIEB 102,A05,193265,Butler; Shannon Rhey,26,0,32,6
1683645391881,BIEB 102,A06,193269,Butler; Shannon Rhey,14,0,32,18
1683645393935,BIEB 150,A01,193274,Staff,0,0,32,32
1683645393935,BIEB 150,A02,193285,Staff,24,0,32,8
1683645394962,BIEB 194,A00,193286,Kurle; Carolyn M.,20,0,32,12
1683645395990,BILD 1,A01,192291,Staff,15,0,32,17
1683645395990,BILD 1,A02,192292,Staff,30,0,32,2
1683645395990,BILD 1,B01,192520,Reuther; Keefe,0,1,0,0
1683645395990,BILD 1,B02,192532,Reuther; Keefe,0,1,0,0
1683645397019,BILD 3,A01,192556,Butler; Shannon Rhey,0,0,32,32
1683645397019,BILD 3,A02,192581,Butler; Shannon Rhey,1,0,32,31
1683645397019,BILD 3,A03,192611,Butler; Shannon Rhey,21,0,32,11
1683645397019,BILD 3,A04,192612,Butler; Shannon Rhey,24,0,32,8
1683645397019,BILD 3,A05,192613,Butler; Shannon Rhey,26,0,32,6
1683645397019,BILD 3,A06,192679,Butler; Shannon Rhey,27,0,32,5
1683645397019,BILD 3,A07,192682,Butler; Shannon Rhey,20,0,32,12
1683645398046,BILD 4,A01,192836,Reuther; Keefe,0,0,24,24
1683645398046,BILD 4,A02,193044,Reuther; Keefe,4,0,24,20
1683645399075,BILD 10,A01,193142,Gustafson-Brown; Cindy,29,0,32,3
1683645399075,BILD 10,A02,193149,Gustafson-Brown; Cindy,31,0,32,1
1683645400101,BIMM 100,A01,193301,Staff,0,6,32,32
1683645400101,BIMM 100,A02,193312,Staff,0,7,32,32
1683645400101,BIMM 100,A03,193323,Staff,0,9,32,32
1683645401131,BIMM 101,A01,193329,McDonnell; Lisa Marie,0,4,24,24
1683645401131,BIMM 101,A02,193339,McDonnell; Lisa Marie,0,3,24,24
1683645401131,BIMM 101,B01,193354,McDonnell; Lisa Marie,0,4,24,24
1683645401131,BIMM 101,B02,193357,McDonnell; Lisa Marie,0,3,24,24
1683645402160,BIMM 110,A01,193377,Tat; John,0,11,32,32
1683645402160,BIMM 110,A02,193378,Tat; John,0,10,32,32
1683645403190,BIMM 120,A01,206116,Staff,0,0,32,32
1683645403190,BIMM 120,A02,206117,Staff,6,0,32,26
1683645403190,BIMM 120,A03,206121,Staff,21,0,32,11
1683645404225,BIPN 100,A01,193393,Park; Ji Young,0,14,32,32
1683645404225,BIPN 100,A02,193402,Park; Ji Young,0,14,32,32
1683645404225,BIPN 100,A03,193413,Park; Ji Young,0,14,32,32
1683645404225,BIPN 100,A04,193414,Park; Ji Young,0,13,32,32
1683645405254,BIPN 102,A01,193429,Staff,0,0,32,32
1683645405254,BIPN 102,A02,193438,Staff,18,0,32,14
1683645406279,BIPN 106,A01,193450,Reyes Gonzalez; Catalina,0,2,40,40
1683645407306,BIPN 134,A01,193465,Cooke; James Edward,0,0,32,32
1683645407306,BIPN 134,A02,193474,Cooke; James Edward,25,0,32,7
1683645407306,BIPN 134,A03,193485,Cooke; James Edward,29,0,32,3
1683645407306,BIPN 134,A04,193486,Cooke; James Edward,20,0,32,12
1683645407306,BIPN 134,A05,193491,Cooke; James Edward,31,0,32,1
1683645407306,BIPN 134,A06,193501,Cooke; James Edward,30,0,32,2
1683645407306,BIPN 134,A07,193510,Cooke; James Edward,29,0,32,3
1683645409355,BISP 194,A00,222522,Staff,14,0,32,18
1683645410391,CAT 124,A01,202407,Staff,19,0,25,6
1683645411419,CAT 125,A00,202408,Marchisotto; Jennifer Anne,2,0,20,18
1683645412448,CAT 125R,A00,202409,Smith; Lauryn Alissa,0,11,20,20
1683645412448,CAT 125R,B00,202410,Morales; Celeste Georgianna,0,11,20,20
1683645412448,CAT 125R,C00,202411,Irwin; Matthew Joseph,0,12,20,20
1683645413477,CENG 15,A01,204712,Yang; Kesong,0,1,0,0
1683645414503,CENG 114,A00,202070,Jahed Motlagh; Zeinab,5,0,20,15
1683645415528,CGS 105,A00,185477,Wesling; Megan E.,24,0,40,16
1683645416552,CGS 106,A00,185494,Staff,11,0,22,11
1683645417577,CGS 108,A00,185495,Staff,14,0,20,6
1683645418600,CGS 114,A00,185496,Staff,13,0,18,5
1683645419625,CGS 119,A00,185501,Staff,15,0,20,5
1683645420650,CGS 120,A00,185511,Staff,12,0,20,8
1683645421676,CHEM 4,A01,184675,Bussey; Thomas J,97,0,100,3
1683645422702,CHEM 6A,A01,184677,Staff,33,0,60,27
1683645423726,CHEM 6B,A01,184679,Staff,63,0,100,37
1683645424751,CHEM 6C,A01,184681,Bussey; Thomas J,0,0,50,50
1683645424751,CHEM 6C,A02,184682,Bussey; Thomas J,32,0,50,18
1683645425776,CHEM 40A,A01,184684,Albizati; Kim F.,34,0,100,66
1683645426801,CHEM 40B,A01,184686,Albizati; Kim F.,0,22,100,100
1683645427829,CHEM 41B,A01,184690,Staff,51,0,100,49
1683645428858,COGS 3,A01,184715,Boyle; Mary E. T.,0,27,40,40
1683645429909,COGS 14B,A01,185172,Staff,0,14,38,38
1683645430941,COGS 18,A01,184736,Staff,14,0,80,66
1683645431968,COGS 100,A01,184932,Staff,0,7,73,73
1683645432993,COGS 101A,A01,184935,Staff,0,39,30,30
1683645434021,COGS 101B,A01,184944,Staff,0,2,30,30
1683645435049,COGS 101C,A01,184946,Staff,0,10,30,30
1683645436075,COGS 102A,A01,184951,Johnson; Christine M.,2,0,40,38
1683645437101,COGS 107B,A01,184953,Mooshagian; Eric Frederick,0,51,40,40
1683645438129,COGS 118B,A01,184959,Gupta; Anjum,0,49,40,40
1683645439157,COGS 153,A00,184961,Staff,0,16,30,30
1683645440184,COGS 177,A00,184962,Staff,0,21,30,30
1683645441208,COGS 187A,A01,184969,Boyle; Mary E. T.,0,19,40,40
1683645442232,COMM 10,A01,185174,Staff,0,5,25,25
1683645442232,COMM 10,A02,185189,Staff,0,2,25,25
1683645442232,COMM 10,A03,269821,Staff,0,1,0,0
1683645443259,COMM 100B,A01,185475,Staff,0,1,0,2
1683645443259,COMM 100B,A02,185476,Staff,12,0,25,13
1683645444284,COMM 100C,A01,185314,Staff,1,0,25,24
1683645444284,COMM 100C,A02,185327,Staff,18,0,25,7
1683645445309,COMM 110M,A00,185349,Staff,0,0,40,40
1683645446336,COMM 113T,A00,185352,Staff,25,0,40,15
1683645447362,COMM 114I,A00,185353,Staff,31,0,40,9
1683645448406,COMM 131,A00,185354,Staff,17,0,30,13
1683645449435,CSE 8A,A50,185358,Cao; Yingjun,0,46,10,10
1683645450464,CSE 8B,A01,185362,Staff,0,48,50,50
1683645451493,CSE 11,A01,185416,Cao; Yingjun,0,91,10,10
1683645452518,CSE 20,A01,185445,Briones; Jor-el Thomas Caparas,4,0,25,21
1683645453544,CSE 21,A01,185447,Staff,9,0,50,41
1683645454570,CSE 101,A01,185451,Staff,0,13,50,50
1683645454570,CSE 101,B01,185453,Jones; Miles E,0,13,50,50
1683645456623,CSE 141,A01,185458,Eldon; John,15,0,100,85
1683645457651,CSE 141L,A01,185461,Eldon; John,7,0,100,93
1683645458679,CSE 142,A01,185463,Staff,36,0,60,24
1683645458679,CSE 142,B01,201355,Staff,0,7,60,60
1683645459706,CSE 142L,A01,185470,Staff,36,0,60,24
1683645459706,CSE 142L,B01,201417,Staff,0,6,60,60
1683645460731,CSE 190,A00,201433,Staff,32,0,49,17
1683645461757,DOC 1,A01,259136,Strom; Megan C.,7,0,15,8
1683645461757,DOC 1,A02,259137,Strom; Megan C.,14,0,15,1
1683645461757,DOC 1,A03,259138,Strom; Megan C.,14,0,15,1
1683645461757,DOC 1,A04,259139,Strom; Megan C.,14,0,15,1
1683645462782,DOC 100D,A00,259140,Pass; Natalye Joann,14,0,25,11
1683645463808,DSGN 1,A01,184749,Rill; Bryan,0,26,30,30
1683645464838,DSGN 100,A01,185168,Staff,0,2,25,25
1683645465865,ECE 5,A01,185626,Morris; Karcher William,0,11,0,0
1683645466889,ECE 101,A01,185628,Staff,14,0,70,56
1683645467916,ECE 107,A01,185635,Baghdadchi; Saharnaz,0,0,20,20
1683645467916,ECE 107,A02,185638,Baghdadchi; Saharnaz,3,0,20,17
1683645468943,ECE 148,A01,185647,Silberman; Jack,0,0,16,16
1683645469970,ECON 1,A01,185537,Crane; Meredith Helen,54,0,70,16
1683645470999,ECON 3,A01,185549,Crane; Meredith Helen,29,0,70,41
1683645472026,ECON 4,A01,203354,Anderson; John Charles,0,5,10,10
1683645473053,ECON 100A,A01,185574,Staff,0,5,40,40
1683645474080,ECON 100B,A01,185576,Staff,0,12,50,50
1683645475109,ECON 100C,A01,185589,Newhouse; Herbert S,30,0,70,40
1683645476133,ECON 105,A00,185608,Vespa; Emanuel Ignacio,19,0,35,16
1683645477161,ECON 109,A01,185610,Shishkin; Denis,9,0,35,26
1683645478186,ECON 110A,A01,185612,Staff,9,0,40,31
1683645479211,ECON 120A,A01,185615,Staff,20,0,40,20
1683645480238,ECON 120C,A01,185617,Sun; Yixiao,0,20,70,70
1683645481266,ECON 144,A00,203346,Squires; Dale E,2,0,35,33
1683645482290,ECON 171,A01,203349,Newhouse; Herbert S,0,1,35,35
1683645483315,ECON 173A,A01,185621,Toda; Alexis Akira,21,0,35,14
1683645484345,EDS 25,A01,202413,Staff,0,1,0,0
1683645484345,EDS 25,A02,202414,Staff,0,1,0,0
1683645484345,EDS 25,A03,202415,Staff,0,0,0,0
1683645484345,EDS 25,A04,202416,Staff,0,1,0,0
1683645484345,EDS 25,A05,202439,Staff,0,0,0,0
1683645484345,EDS 25,A06,202440,Staff,0,0,0,0
1683645484345,EDS 25,B01,202631,Staff,0,0,0,0
1683645484345,EDS 25,B02,202632,Staff,0,0,0,0
1683645484345,EDS 25,B03,202639,Staff,0,0,0,0
1683645484345,EDS 25,B04,202640,Staff,0,0,0,0
1683645484345,EDS 25,B05,202643,Staff,0,0,0,0
1683645484345,EDS 25,B06,202644,Staff,0,0,0,0
1683645485371,EDS 38,A01,202659,Black; Alison Michelle,24,0,25,1
1683645486399,EDS 115,A00,202652,Staff,18,0,30,12
1683645487425,EDS 125,A00,202649,Staff,13,0,30,17
1683645488453,EDS 126,A01,203332,Staff,30,0,30,0
1683645489477,EDS 139,A00,202838,Staff,16,0,25,9
1683645490505,EDS 146,A01,202655,Staff,14,0,25,11
1683645491531,ENG 15,A00,185667,Staff,0,1,0,0
1683645491531,ENG 15,B00,185672,Staff,0,0,0,0
1683645491531,ENG 15,C00,185675,Staff,0,0,0,0
1683645491531,ENG 15,D00,185682,Staff,0,0,0,0
1683645491531,ENG 15,E00,185684,Staff,0,0,0,0
1683645492559,ETHN 103,A00,185710,Staff,0,8,35,35
1683645493586,ETHN 103A,A00,199228,Man; Simeon S,0,0,9,9
1683645494666,ETHN 109,A00,185711,Staff,16,0,35,19
1683645495695,ETHN 142,A00,185726,Staff,0,4,30,30
1683645496722,ETHN 163J,A00,199229,Man; Simeon S,5,0,8,3
1683645497748,ETHN 168,A00,185727,Staff,7,0,10,3
1683645498773,ETHN 182,A00,185728,Staff,0,0,35,35
1683645499806,ETHN 183,A00,185737,Staff,9,0,18,9
1683645500837,GLBH 111,A01,209361,Burgos; Jose L.,0,0,0,0
1683645502890,HIEU 104,A00,185792,Staff,14,0,20,6
1683645503914,HIEU 115,A00,185800,Staff,0,0,20,20
1683645504940,HIEU 128,A00,185801,Staff,0,9,20,20
1683645505964,HIEU 147,A00,185802,Staff,15,0,20,5
1683645506993,HIEU 154,A00,185823,Staff,11,0,20,9
1683645508019,HILA 102,A00,185826,Staff,14,0,20,6
1683645509045,HILD 2C,A01,185778,Staff,0,13,20,20
1683645510070,HILD 7B,A01,185780,Kwak; Nancy,0,16,32,32
1683645510070,HILD 7B,A02,185781,Kwak; Nancy,0,18,32,32
1683645511096,HILD 30,A01,185791,Staff,12,0,20,8
1683645512124,HISC 119,A00,185830,Golan; Tal,0,9,20,20
1683645513148,HITO 156GS,A00,185831,Patterson; Patrick H.,0,0,0,23
1683645514174,HIUS 103,A00,185832,Man; Simeon S,0,4,20,20
1683645515200,HIUS 117,A00,185836,Kwak; Nancy,2,0,20,18
1683645516226,HIUS 125,A00,185840,Man; Simeon S,0,1,23,23
1683645517249,HIUS 149,A00,185845,Staff,1,0,20,19
1683645518274,HUM 3,A01,185882,Zavodny; Tatiana Sophia,0,7,50,50
1683645518274,HUM 3,B01,185899,Caldwell; Michael Alan,0,18,50,50
1683645519302,HUM 3GS,A00,185900,Patterson; Patrick H.,0,0,0,23
1683645520327,HUM 4,A01,185938,Zroka; Amy Liane,30,0,50,20
1683645520327,HUM 4,B01,185956,Watkins; Eric,0,4,50,50
1683645520327,HUM 4,B02,202209,Watkins; Eric,0,4,50,50
1683645520327,HUM 4,B03,202210,Watkins; Eric,0,4,50,50
1683645521355,HUM 5,A01,185958,West; Geoffrey Scott,2,0,50,48
1683645521355,HUM 5,A02,202215,West; Geoffrey Scott,0,0,50,50
1683645522381,INTL 190,A00,185959,Gagnon; Jeffrey C,0,0,0,9
1683645522381,INTL 190,B00,185960,Lettieri; Michael Joseph,0,0,0,2
1683645523407,JAPN 180,A00,254509,Staff,5,0,30,25
1683645524433,LATI 10,A01,202853,Kennemore; Amy Michelle,4,0,35,31
1683645524433,LATI 10,A02,202854,Kennemore; Amy Michelle,2,0,35,33
1683645524433,LATI 10,A03,270054,Kennemore; Amy Michelle,30,0,30,0
1683645525461,LATI 180,A00,202855,Kennemore; Amy Michelle,11,0,20,9
1683645526488,LAWS 101,A00,201767,Golan; Tal,0,7,40,40
1683645527517,LIFR 1C,A00,185961,Staff,6,0,20,14
1683645528544,LIFR 1CX,A00,185962,Staff,7,0,20,13
1683645529569,LIFR 1D,A00,185963,Staff,7,0,20,13
1683645530599,LIFR 1DX,A00,185964,Staff,7,0,20,13
1683645531626,LIGN 101,A01,186039,Staff,43,0,50,7
1683645532652,LIGN 165,A00,186040,Staff,15,0,50,35
1683645533675,LTCS 108,A00,186041,Staff,5,0,10,5
1683645534705,LTCS 119,A00,186042,Staff,15,0,20,5
1683645535729,LTCS 130,A00,186043,Wesling; Megan E.,15,0,25,10
1683645537779,LTEA 138,A00,186119,Staff,14,0,40,26
1683645538804,LTEN 124,A00,186148,Staff,5,0,25,20
1683645539829,LTEN 178,A00,186149,Staff,7,0,15,8
1683645540854,LTEN 181,A00,186150,Blanco; John D,34,0,40,6
1683645541881,LTWL 120,A00,186160,Staff,20,0,25,5
1683645542906,LTWL 165,A00,186161,Staff,22,0,25,3
1683645543933,LTWR 100,A00,186162,Staff,0,5,15,15
1683645544957,LTWR 102,A00,186163,Doller; Ben,5,0,15,10
1683645545981,MAE 8,A01,186412,Staff,0,0,0,0
1683645547006,MAE 30B,A00,186445,Bahadori; Mohammad Yousef,82,0,100,18
1683645548039,MAE 40,A00,186592,Bewley; Thomas R,10,0,50,40
1683645549068,MAE 101B,A00,186593,Bahadori; Mohammad Yousef,80,0,100,20
1683645550095,MAE 105,A00,186594,Bandaru; Prabhakar,10,0,50,40
1683645551122,MAE 107,A00,186599,Pham; Hieu Tan,0,7,120,120
1683645552146,MAE 148,A01,186660,Silberman; Jack,3,0,16,13
1683645553169,MATH 10A,A01,188095,Staff,0,5,35,35
1683645554195,MATH 10B,A01,188097,Bowers; Adam R.,0,11,30,30
1683645554195,MATH 10B,A02,188099,Bowers; Adam R.,0,11,30,30
1683645554195,MATH 10B,B01,188104,Bowers; Adam R.,0,10,30,30
1683645554195,MATH 10B,B02,188106,Bowers; Adam R.,1,9,30,29
1683645555225,MATH 10C,A01,188111,Staff,0,18,30,30
1683645555225,MATH 10C,A02,188127,Staff,0,19,30,30
1683645555225,MATH 10C,A03,188131,Staff,0,19,30,30
1683645555225,MATH 10C,B01,188218,Staff,17,0,30,13
1683645555225,MATH 10C,B02,188244,Staff,13,0,30,17
1683645555225,MATH 10C,B03,188277,Staff,14,0,30,16
1683645556255,MATH 18,A01,188344,Bach; Quang Tran,18,0,30,12
1683645556255,MATH 18,A02,188345,Bach; Quang Tran,11,0,30,19
1683645556255,MATH 18,B01,188353,Bach; Quang Tran,11,0,30,19
1683645556255,MATH 18,B02,188354,Bach; Quang Tran,19,0,30,11
1683645557280,MATH 20A,A01,188374,Staff,11,0,35,24
1683645558310,MATH 20B,A01,188382,Ohm; Ko Woon,7,0,30,23
1683645558310,MATH 20B,A02,188383,Ohm; Ko Woon,22,0,30,8
1683645558310,MATH 20B,B01,188385,Ohm; Ko Woon,7,0,30,23
1683645558310,MATH 20B,B02,188392,Ohm; Ko Woon,22,0,30,8
1683645559336,MATH 20C,A01,188394,Harel; Guershon,11,0,30,19
1683645559336,MATH 20C,A02,188395,Harel; Guershon,14,0,30,16
1683645559336,MATH 20C,B01,188404,Harel; Guershon,4,0,30,26
1683645559336,MATH 20C,B02,188405,Harel; Guershon,18,0,30,12
1683645560362,MATH 20D,A01,188414,Hammock; Frances H,0,1,30,30
1683645560362,MATH 20D,A02,188415,Hammock; Frances H,0,1,30,30
1683645560362,MATH 20D,B01,188447,Hammock; Frances H,0,1,30,30
1683645560362,MATH 20D,B02,188486,Hammock; Frances H,4,0,30,26
1683645561392,MATH 20E,A01,188649,Staff,21,0,30,9
1683645561392,MATH 20E,A02,188650,Staff,21,0,30,9
1683645561392,MATH 20E,A03,188673,Staff,0,0,30,30
1683645562416,MATH 102,A01,188675,Staff,0,36,35,35
1683645563448,MATH 103B,A01,188681,Staff,3,0,35,32
1683645563448,MATH 103B,B01,188692,Staff,5,0,35,30
1683645564472,MATH 109,A01,188695,Salehi Golsefidy; Alireza,24,0,35,11
1683645564472,MATH 109,A02,188696,Salehi Golsefidy; Alireza,25,0,35,10
1683645565497,MATH 120A,A01,188698,Eggers; John Dietrich,7,0,35,28
1683645566527,MATH 142B,A01,188736,Ioana; Adrian,0,1,30,30
1683645566527,MATH 142B,A02,188741,Ioana; Adrian,0,1,30,30
1683645566527,MATH 142B,A03,188743,Ioana; Adrian,0,1,30,30
1683645567554,MATH 168A,A01,188790,Staff,0,10,35,35
1683645568586,MATH 170A,A01,188803,Nie; Jiawang,0,2,35,35
1683645568586,MATH 170A,A02,188811,Nie; Jiawang,0,0,35,35
1683645568586,MATH 170A,A03,188814,Nie; Jiawang,0,0,35,35
1683645568586,MATH 170A,A04,188815,Nie; Jiawang,10,0,35,25
1683645569611,MATH 193B,A01,188817,Staff,0,0,35,35
1683645569611,MATH 193B,A02,188818,Staff,5,0,35,30
1683645570639,MGT 4,A01,202857,Anderson; John Charles,61,0,80,19
1683645571664,MGT 12,A00,202858,Lindenberger; Wade Douglas,40,0,90,50
1683645572689,MGT 18,A00,202859,Staff,74,0,90,16
1683645573721,MGT 18GS,A00,202860,McKay; Michael J,13,0,28,15
1683645574746,MGT 45,A00,202861,Pecore; Joseph P.,12,0,90,78
1683645575777,MGT 100,A00,202863,Yavorsky; Daniel Ryan,28,0,90,62
1683645576805,MGT 103,A00,202864,Ehrich; Kristine R,0,17,90,90
1683645577830,MGT 112,A00,202865,Ehrich; Kristine R,15,0,90,75
1683645578861,MGT 121A,A00,202868,Staff,0,20,0,0
1683645579889,MGT 131B,A00,202869,Anderson; John Charles,59,0,90,31
1683645580917,MGT 136,A00,202871,Lindenberger; Wade Douglas,83,0,90,7
1683645581945,MGT 164,A00,202873,Staff,0,66,90,91
1683645582972,MGT 164GS,A00,202874,McKay; Mary A,13,0,28,15
1683645584001,MGT 180,A00,202875,Staff,0,50,90,91
1683645585027,MMW 11R,A01,205019,Herbst; Matthew,2,0,30,28
1683645585027,MMW 11R,A02,205026,Herbst; Matthew,29,0,30,1
1683645586063,MMW 15,A01,193512,Chang; Edmond Yi-Teh,0,8,28,28
1683645586063,MMW 15,A02,193513,Chang; Edmond Yi-Teh,0,5,28,28
1683645586063,MMW 15,A03,193514,Chang; Edmond Yi-Teh,0,5,28,28
1683645586063,MMW 15,A04,193515,Chang; Edmond Yi-Teh,0,5,28,28
1683645586063,MMW 15,A05,193516,Chang; Edmond Yi-Teh,0,5,28,28
1683645586063,MMW 15,A06,193517,Chang; Edmond Yi-Teh,0,6,28,28
1683645586063,MMW 15,B01,193519,Chang; Edmond Yi-Teh,0,5,28,28
1683645586063,MMW 15,B02,193520,Chang; Edmond Yi-Teh,0,5,28,28
1683645586063,MMW 15,B03,193521,Chang; Edmond Yi-Teh,0,5,28,28
1683645586063,MMW 15,B04,193522,Chang; Edmond Yi-Teh,0,5,28,28
1683645586063,MMW 15,B05,193523,Chang; Edmond Yi-Teh,0,5,28,28
1683645586063,MMW 15,B06,193524,Chang; Edmond Yi-Teh,0,5,28,28
1683645587093,MMW 122,A01,193526,Rahimi; Babak,0,16,28,28
1683645587093,MMW 122,A02,193527,Rahimi; Babak,0,15,28,28
1683645587093,MMW 122,A03,193528,Rahimi; Babak,0,0,0,0
1683645587093,MMW 122,A04,193529,Rahimi; Babak,0,0,0,0
1683645588121,MUS 1A,A01,186663,Staff,1,20,35,34
1683645589147,MUS 4,A01,186715,Staff,0,12,35,35
1683645590175,MUS 5R,A01,186796,Dubnov; Shlomo,0,17,35,35
1683645591200,MUS 6,A01,186798,Staff,0,5,25,25
1683645592224,MUS 7,A01,186830,Staff,11,0,35,24
1683645593253,MUS 8,A01,186930,Staff,0,26,35,35
1683645594283,MUS 15,A01,186932,Staff,0,16,35,35
1683645594283,MUS 15,B01,186934,Staff,0,17,35,35
1683645595311,MUS 80,A00,186935,Staff,0,0,20,20
1683645595311,MUS 80,B00,186936,Staff,24,0,25,1
1683645596342,NANO 11,A00,204702,Lipomi; Darren John,0,0,0,0
1683645597374,NANO 15,A01,204709,Yang; Kesong,0,1,0,0
1683645598457,NANO 114,A00,202069,Jahed Motlagh; Zeinab,3,0,10,7
1683645599482,PHIL 1,A00,186955,Grush; Rick Scott,31,0,40,9
1683645600508,PHIL 10,A01,186973,Grush; Rick Scott,27,0,35,8
1683645600508,PHIL 10,A02,186974,Grush; Rick Scott,33,0,35,2
1683645601533,PHIL 13,A01,186976,Staff,3,0,35,32
1683645601533,PHIL 13,A02,186977,Staff,16,0,35,19
1683645602560,PHIL 14,A01,186979,Staff,31,0,35,4
1683645602560,PHIL 14,A02,186986,Staff,32,0,35,3
1683645603594,PHIL 28,A01,186988,Staff,16,0,30,14
1683645603594,PHIL 28,A02,186989,Staff,1,0,30,29
1683645603594,PHIL 28,A03,186990,Staff,10,0,30,20
1683645603594,PHIL 28,A04,186991,Staff,26,0,30,4
1683645604622,PHIL 120,A00,186997,Staff,23,0,40,17
1683645605647,PHIL 137,A00,187003,Staff,7,0,40,33
1683645606673,PHIL 150,A00,187015,Staff,47,0,70,23
1683645607737,PHIL 167,A00,187021,Lamey; Andy M.,34,0,40,6
1683645608769,PHIL 174,A01,202226,Staff,17,0,20,3
1683645608769,PHIL 174,A02,202235,Staff,20,0,20,0
1683645609794,PHIL 191A,A00,258918,Staff,0,0,1,1
1683645610819,PHYS 1A,A00,187028,Staff,27,0,60,33
1683645611856,PHYS 1AL,001,187036,Staff,3,0,30,27
1683645611856,PHYS 1AL,002,187049,Staff,18,0,30,12
1683645612885,PHYS 1B,A00,187058,Staff,22,0,60,38
1683645613913,PHYS 1BL,001,187064,Staff,0,1,30,30
1683645613913,PHYS 1BL,002,187070,Staff,4,0,30,26
1683645614941,PHYS 1C,A00,187082,Staff,29,0,120,91
1683645615968,PHYS 1CL,001,187088,Staff,0,9,30,30
1683645615968,PHYS 1CL,002,187089,Staff,0,1,30,30
1683645615968,PHYS 1CL,009,262693,Staff,9,0,30,21
1683645616993,PHYS 2B,A01,187097,Staff,55,0,115,60
1683645618021,PHYS 2C,A01,187099,Staff,64,0,115,51
1683645619050,PHYS 2CL,A01,187101,Staff,5,0,28,23
1683645619050,PHYS 2CL,A02,187102,Staff,15,0,28,13
1683645620080,PHYS 2D,A01,187123,Shotwell; Brian,95,0,115,20
1683645621107,PHYS 4B,A01,187133,Grinstein; Benjamin,35,0,50,15
1683645622137,POLI 10,A00,188819,Staff,0,4,50,50
1683645623162,POLI 11,A00,188827,Staff,43,0,50,7
1683645624187,POLI 13R,A00,188828,Staff,0,1,20,20
1683645625211,POLI 27,A01,188830,Elgin; Samuel Zincke,0,2,70,70
1683645626238,POLI 30,A00,188832,Desposato; Scott,30,0,50,20
1683645627264,POLI 102F,A00,188834,Staff,0,0,40,40
1683645628291,POLI 104A,A00,188852,Staff,13,0,30,17
1683645629316,POLI 104I,A00,188853,Staff,0,7,20,20
1683645630341,POLI 110B,A00,188854,Wiens; David,7,0,20,13
1683645631365,POLI 112A,A00,188855,Wiens; David,4,0,30,26
1683645632390,POLI 117R,A00,188856,Forman; Fonna,0,12,20,20
1683645633417,POLI 118,A00,188857,Ingham; Sean,8,0,20,12
1683645634448,POLI 120G,A00,188858,Staff,8,0,30,22
1683645635476,POLI 131CR,A00,188863,Hoston; Germaine,21,0,50,29
1683645636500,POLI 133,A00,188864,Nellis; Gareth Hb,44,0,50,6
1683645637525,POLI 134D,A00,188865,Desposato; Scott,27,0,30,3
1683645638550,POLI 142A,A00,188871,Gartzke; Erik,21,0,50,29
1683645639578,POLI 142K,A00,188874,Staff,38,0,50,12
1683645640607,POLI 143,A00,188940,Gartzke; Erik,16,0,30,14
1683645641632,POLI 153,A00,188943,Staff,2,0,20,18
1683645642656,POLI 160AA,A00,188944,Staff,11,0,40,29
1683645643682,POLI 170A,A00,188945,Staff,11,0,30,19
1683645645734,PSYC 1,A00,188952,Staff,36,0,90,54
1683645646762,PSYC 2,B00,188953,Staff,19,0,35,16
1683645647787,PSYC 6,A00,188970,Staff,47,0,60,13
1683645648813,PSYC 7,A00,188973,Staff,35,0,45,10
1683645649845,PSYC 60,A01,188980,Rickard; Timothy C.,42,0,60,18
1683645650870,PSYC 70,A01,189001,Steiner; Eric Tomas,23,0,45,22
1683645651895,PSYC 100,A00,189005,Lacefield; Katharine I,0,99,120,120
1683645652926,PSYC 102,A00,189008,Staff,8,0,30,22
1683645653955,PSYC 106,B00,189026,Gorman; Michael R.,27,0,60,33
1683645654984,PSYC 114,B01,189033,Winkielman; Piotr,0,31,30,30
1683645656011,PSYC 131,A00,189036,Anagnostaras; Stephan,0,43,60,60
1683645657040,PSYC 136,A00,189041,Lowe; Angela Beth,0,7,25,25
1683645658070,PSYC 137,A00,189057,Winkielman; Piotr,0,37,25,25
1683645659095,PSYC 144,A00,189107,Wixted; John T,0,10,50,50
1683645661145,PSYC 162,A00,189142,Staff,0,9,85,85
1683645662171,PSYC 172,A00,189144,Gorman; Michael R.,0,6,30,30
1683645664220,PSYC 179,A00,189146,Lacefield; Katharine I,0,86,120,120
1683645665249,PSYC 181,A00,189147,Anagnostaras; Stephan,0,44,90,90
1683645666280,PSYC 190R,A00,189148,Barner; David A.,0,23,80,80
1683645667309,PSYC 191,A00,189275,Rickard; Timothy C.,0,10,25,25
1683645668342,PSYC 193,A00,189276,Chapman; Eddie Nathaniel,0,1,0,4
1683645669372,PSYC 193L,A01,189281,Lowe; Angela Beth,10,0,20,10
1683645669372,PSYC 193L,B01,189285,Staff,28,0,35,7
1683645670402,RELI 149,A00,187137,Rahimi; Babak,7,0,40,33
1683645671427,SE 9,A01,187315,Staff,0,2,18,18
1683645672452,SE 101B,A00,187409,Staff,24,0,30,6
1683645673477,SE 110B,A00,187444,Staff,10,0,40,30
1683645674507,SE 130B,A00,187449,Staff,31,0,40,9
1683645675535,SE 150A,A00,187516,Staff,9,0,20,11
1683645676562,SE 154,A00,187528,Staff,29,0,50,21
1683645677589,SIO 3,A01,258171,Staff,35,0,40,5
1683645678615,SIO 10,A00,187144,Cook; Geoffrey W,0,6,75,75
1683645679644,SIO 45,A00,187152,Cook; Geoffrey W,0,4,100,100
1683645680667,SIO 109R,A00,194486,Staff,0,4,20,20
1683645682718,SIO 187,A01,187233,Kacev; David,12,0,40,28
1683645683745,SOCI 1,A01,258656,Thorpe; Charles Robert,28,0,30,2
1683645683745,SOCI 1,A02,258658,Thorpe; Charles Robert,30,0,30,0
1683645683745,SOCI 1,A03,258661,Thorpe; Charles Robert,25,0,25,0
1683645683745,SOCI 1,A04,258666,Thorpe; Charles Robert,22,0,25,3
1683645683745,SOCI 1,A05,258897,Thorpe; Charles Robert,22,0,25,3
1683645683745,SOCI 1,A06,258898,Thorpe; Charles Robert,25,0,25,0
1683645684771,SOCI 30,A01,258903,Pardo Guerra; Juan Pablo,14,0,30,16
1683645685798,SOCI 102,A00,258904,Staff,9,0,25,16
1683645686828,SOCI 106,A00,258905,Staff,19,0,25,6
1683645687858,SOCI 111,A00,258907,Ribas Norris; Janet Vanesa,26,0,30,4
1683645688883,SOCI 121R,A00,258908,Pardo Guerra; Juan Pablo,8,0,30,22
1683645689907,SOCI 126,A01,203330,Staff,14,0,20,6
1683645690934,SOCI 131,A00,258909,Thorpe; Charles Robert,30,0,60,30
1683645691960,SOCI 135,A00,258910,Payne; Christine Anna,0,11,30,30
1683645692985,SOCI 157,A00,258911,Staff,12,0,30,18
1683645694010,SOCI 184,A00,258912,Staff,25,0,30,5
1683645695038,SOCI 188D,A00,258913,Staff,22,0,30,8
1683645696071,SYN 2,001,187529,Staff,9,0,16,7
1683645696071,SYN 2,002,201452,Staff,0,20,16,16
1683645696071,SYN 2,003,201469,Staff,2,0,16,14
1683645697096,SYN 100,A01,187531,Staff,0,9,20,20
1683645697096,SYN 100,B01,201491,Staff,0,10,20,20
1683645698125,TDAC 1,A00,189286,Walsh; Kim C.,3,0,20,17
1683645698125,TDAC 1,B00,189287,Harting; Carla Kelso,10,0,20,10
1683645699159,TDAC 101,A00,189300,Walsh; Kim C.,16,0,20,4
1683645699159,TDAC 101,B00,189301,Harting; Carla Kelso,18,0,20,2
1683645700183,TDAC 102,A00,189304,Basso; Beatrice,14,0,20,6
1683645701212,TDAC 108,A00,189305,Staff,18,0,20,2
1683645702297,TDDE 131,A00,189310,Staff,19,0,20,1
1683645702297,TDDE 131,B00,189314,Staff,19,0,20,1
1683645702297,TDDE 131,C00,189315,Staff,48,0,50,2
1683645702297,TDDE 131,D00,189316,Staff,14,0,15,1
1683645702297,TDDE 131,E00,204841,Staff,20,0,20,0
1683645703321,TDGE 10,A00,189289,Staff,27,0,50,23
1683645703321,TDGE 10,B00,189290,Havis; Allan,0,0,50,50
1683645704351,TDGE 11,A00,189291,Fulton; Julia,0,4,50,50
1683645704351,TDGE 11,B00,189292,Staff,20,0,25,5
1683645704351,TDGE 11,C00,260270,Staff,0,0,0,0
1683645705379,TDGE 25,A00,189294,Staff,2,0,20,18
1683645706405,TDGE 124,A00,189318,Fulton; Julia,0,8,50,50
1683645707429,TDGE 125,A00,189319,Staff,13,0,25,12
1683645707429,TDGE 125,B00,189320,Staff,23,0,25,2
1683645708458,TDGE 127,A00,189322,Havis; Allan,0,0,50,50
1683645709487,TDHT 101,A00,189323,Staff,18,0,25,7
1683645709487,TDHT 101,B00,189324,Staff,25,0,25,0
1683645710513,TDHT 102,A00,189325,Staff,49,0,50,1
1683645711546,TDMV 1,A00,189295,Arcidiacono; Kristin,20,0,30,10
1683645711546,TDMV 1,B00,189296,Caligagan; Maria T.,24,0,30,6
1683645712577,TDMV 2,A00,189297,Sammartano; Tonnie,27,0,30,3
1683645712577,TDMV 2,B00,189299,Arcidiacono; Kristin,23,0,30,7
1683645713604,TDMV 3,A00,204998,Rincon; Alicia,22,0,30,8
1683645714632,TDMV 120,A00,189458,Sammartano; Tonnie,28,0,30,2
1683645715660,TDMV 138,A00,189541,Jun; Grace Shin Hae,20,0,40,20
1683645716690,TDMV 142,A00,189717,Caligagan; Tony,25,0,30,5
1683645716690,TDMV 142,B00,189718,Caligagan; Maria T.,25,0,30,5
1683645717721,TMC 2,A01,187533,Staff,25,0,25,0
1683645717721,TMC 2,A02,187534,Staff,25,0,25,0
1683645718752,USP 1,A01,187536,Kwak; Nancy,0,16,25,25
1683645719777,USP 5,A01,187538,Staff,9,0,25,16
1683645720803,USP 101,A00,199253,Staff,0,4,0,0
1683645721826,USP 124,A00,187562,Boomhower; Matthew Charles,0,0,30,30
1683645722851,USP 138,A00,187582,Staff,20,0,25,5
1683645723885,USP 152,A01,187597,Staff,3,0,25,22
1683645724910,USP 153,A00,187598,Staff,19,0,25,6
1683645725938,USP 168,A00,187607,Kwak; Nancy,2,0,5,3
1683645726962,USP 173,A00,187619,Staff,4,0,25,21
1683645727989,USP 181,A00,187638,Staff,0,4,25,25
1683645729016,VIS 103,A00,187650,Cruz; Edwin Teddy,18,0,75,57
1683645730041,VIS 110D,A00,187669,Staff,13,0,22,9
1683645731067,VIS 127C,A00,187720,Shen; Kuiyi,67,0,146,79
1683645732092,VIS 149,A00,187731,Yoldas; Pinar,0,14,22,22
1683645733117,VIS 151,A01,188091,Staff,22,0,34,12
1683645733117,VIS 151,A02,188092,Staff,11,0,34,23
1683645734144,VIS 160B,A00,188093,Stalbaum; Brett,0,1,10,10
1683645736201,WCWP 10B,A00,201720,Staff,10,0,15,5
1683645736201,WCWP 10B,B00,201722,Staff,9,0,15,6
1683645737227,WCWP 100,A00,201725,Gagnon; Jeffrey C,0,0,2,2
1683645737227,WCWP 100,B00,201727,Staff,0,4,15,15
1683645740455,ANBI 133,A00,258401,Wilder; Linnea Lorene,34,0,40,6
1683645741481,ANBI 140,A00,258395,Hrvoj Mihic; Branka,18,0,25,7
1683645742507,ANSC 120,A00,258402,Bialecki; Jon Anthony,26,0,40,14
1683645743532,ANSC 144,A00,258400,Staff,12,0,40,28
1683645745583,ANSC 166,A00,258396,Parish; Steven Martin,156,0,175,19
1683645746611,ANSC 180,A00,193533,Staff,8,0,20,12
1683645747640,ANSC 188,A00,258397,Jassal; Aftab,34,0,40,6
1683645748665,ANTH 3,A01,258316,Staff,23,0,30,7
1683645749690,ANTH 5,A00,258394,Semendeferi; Ekaterini,16,0,20,4
1683645750724,ANTH 21,A01,258331,Staff,4,0,40,36
1683645751749,ANTH 103,A00,258398,Varma; Saiba,15,0,25,10
1683645752778,AWP 10,001,202034,Staff,0,0,0,0
1683645752778,AWP 10,002,202035,Staff,0,0,0,0
1683645752778,AWP 10,003,202036,Staff,0,0,0,0
1683645752778,AWP 10,004,202037,Staff,0,0,0,0
1683645752778,AWP 10,005,202038,Staff,0,0,0,0
1683645752778,AWP 10,006,202039,Staff,0,0,0,0
1683645752778,AWP 10,007,202040,Staff,0,0,0,0
1683645752778,AWP 10,008,202041,Staff,0,0,0,0
1683645752778,AWP 10,009,202042,Staff,0,0,0,0
1683645752778,AWP 10,010,202043,Staff,0,0,0,0
1683645752778,AWP 10,011,202044,Staff,0,0,0,0
1683645752778,AWP 10,012,202045,Staff,0,0,0,0
1683645752778,AWP 10,013,202046,Staff,0,0,0,0
1683645752778,AWP 10,014,202047,Staff,0,0,0,0
1683645752778,AWP 10,015,202048,Staff,0,0,0,0
1683645752778,AWP 10,016,202049,Staff,0,0,0,0
1683645752778,AWP 10,017,202050,Staff,0,0,0,0
1683645752778,AWP 10,018,202051,Staff,0,0,0,0
1683645752778,AWP 10,019,202052,Staff,0,0,0,0
1683645752778,AWP 10,020,202053,Staff,0,0,0,0
1683645752778,AWP 10,021,202054,Staff,0,0,0,0
1683645752778,AWP 10,022,202055,Staff,0,0,0,0
1683645752778,AWP 10,023,202056,Staff,0,0,0,0
1683645752778,AWP 10,024,202057,Staff,0,0,0,0
1683645752778,AWP 10,025,202058,Staff,0,0,0,0
1683645752778,AWP 10,026,202059,Staff,0,0,0,0
1683645753807,AWP 102,001,202032,Staff,0,0,0,0
1683645753807,AWP 102,002,202033,Staff,0,0,0,0
1683645754833,BENG 100,A01,254234,Taylor Amos; Alyssa C,31,0,40,9
1683645755858,BENG 196,001,270013,Engler; Adam J.,9999,0,9999,0
1683645756886,BICD 100R,A01,202018,Smith; Laurie,0,7,32,32
1683645756886,BICD 100R,A02,202019,Smith; Laurie,0,3,32,32
1683645756886,BICD 100R,A03,202020,Smith; Laurie,0,1,32,32
1683645756886,BICD 100R,A04,202021,Smith; Laurie,6,0,32,26
1683645756886,BICD 100R,A05,202022,Smith; Laurie,11,0,32,21
1683645757918,BICD 136,A01,193242,Gustafson-Brown; Cindy,0,2,32,32
1683645757918,BICD 136,A02,193244,Gustafson-Brown; Cindy,13,0,32,19
1683645758957,BIEB 102,A01,193249,Butler; Shannon Rhey,0,2,32,32
1683645758957,BIEB 102,A02,193251,Butler; Shannon Rhey,0,0,32,32
1683645758957,BIEB 102,A03,193253,Butler; Shannon Rhey,0,0,32,32
1683645758957,BIEB 102,A04,193255,Butler; Shannon Rhey,14,0,32,18
1683645758957,BIEB 102,A05,193265,Butler; Shannon Rhey,26,0,32,6
1683645758957,BIEB 102,A06,193269,Butler; Shannon Rhey,14,0,32,18
1683645761010,BIEB 150,A01,193274,Staff,0,0,32,32
1683645761010,BIEB 150,A02,193285,Staff,24,0,32,8
1683645762035,BIEB 194,A00,193286,Kurle; Carolyn M.,20,0,32,12
1683645763061,BILD 1,A01,192291,Staff,15,0,32,17
1683645763061,BILD 1,A02,192292,Staff,30,0,32,2
1683645763061,BILD 1,B01,192520,Reuther; Keefe,0,1,0,0
1683645763061,BILD 1,B02,192532,Reuther; Keefe,0,1,0,0
1683645764093,BILD 3,A01,192556,Butler; Shannon Rhey,0,0,32,32
1683645764093,BILD 3,A02,192581,Butler; Shannon Rhey,1,0,32,31
1683645764093,BILD 3,A03,192611,Butler; Shannon Rhey,21,0,32,11
1683645764093,BILD 3,A04,192612,Butler; Shannon Rhey,24,0,32,8
1683645764093,BILD 3,A05,192613,Butler; Shannon Rhey,26,0,32,6
1683645764093,BILD 3,A06,192679,Butler; Shannon Rhey,27,0,32,5
1683645764093,BILD 3,A07,192682,Butler; Shannon Rhey,20,0,32,12
1683645765122,BILD 4,A01,192836,Reuther; Keefe,0,0,24,24
1683645765122,BILD 4,A02,193044,Reuther; Keefe,4,0,24,20
1683645766146,BILD 10,A01,193142,Gustafson-Brown; Cindy,29,0,32,3
1683645766146,BILD 10,A02,193149,Gustafson-Brown; Cindy,31,0,32,1
1683645767171,BIMM 100,A01,193301,Staff,0,6,32,32
1683645767171,BIMM 100,A02,193312,Staff,0,7,32,32
1683645767171,BIMM 100,A03,193323,Staff,0,9,32,32
1683645768202,BIMM 101,A01,193329,McDonnell; Lisa Marie,0,4,24,24
1683645768202,BIMM 101,A02,193339,McDonnell; Lisa Marie,0,3,24,24
1683645768202,BIMM 101,B01,193354,McDonnell; Lisa Marie,0,4,24,24
1683645768202,BIMM 101,B02,193357,McDonnell; Lisa Marie,0,3,24,24
1683645769230,BIMM 110,A01,193377,Tat; John,0,11,32,32
1683645769230,BIMM 110,A02,193378,Tat; John,0,10,32,32
1683645770261,BIMM 120,A01,206116,Staff,0,0,32,32
1683645770261,BIMM 120,A02,206117,Staff,6,0,32,26
1683645770261,BIMM 120,A03,206121,Staff,21,0,32,11
1683645771291,BIPN 100,A01,193393,Park; Ji Young,0,14,32,32
1683645771291,BIPN 100,A02,193402,Park; Ji Young,0,14,32,32
1683645771291,BIPN 100,A03,193413,Park; Ji Young,0,14,32,32
1683645771291,BIPN 100,A04,193414,Park; Ji Young,0,13,32,32
1683645772319,BIPN 102,A01,193429,Staff,0,0,32,32
1683645772319,BIPN 102,A02,193438,Staff,18,0,32,14
1683645773346,BIPN 106,A01,193450,Reyes Gonzalez; Catalina,0,2,40,40
1683645774371,BIPN 134,A01,193465,Cooke; James Edward,0,0,32,32
1683645774371,BIPN 134,A02,193474,Cooke; James Edward,25,0,32,7
1683645774371,BIPN 134,A03,193485,Cooke; James Edward,29,0,32,3
1683645774371,BIPN 134,A04,193486,Cooke; James Edward,20,0,32,12
1683645774371,BIPN 134,A05,193491,Cooke; James Edward,31,0,32,1
1683645774371,BIPN 134,A06,193501,Cooke; James Edward,30,0,32,2
1683645774371,BIPN 134,A07,193510,Cooke; James Edward,29,0,32,3
1683645776421,BISP 194,A00,222522,Staff,14,0,32,18
1683645777446,CAT 124,A01,202407,Staff,19,0,25,6
1683645778485,CAT 125,A00,202408,Marchisotto; Jennifer Anne,2,0,20,18
1683645779513,CAT 125R,A00,202409,Smith; Lauryn Alissa,0,11,20,20
1683645779513,CAT 125R,B00,202410,Morales; Celeste Georgianna,0,11,20,20
1683645779513,CAT 125R,C00,202411,Irwin; Matthew Joseph,0,12,20,20
1683645780539,CENG 15,A01,204712,Yang; Kesong,0,1,0,0
1683645781563,CENG 114,A00,202070,Jahed Motlagh; Zeinab,5,0,20,15
1683645782589,CGS 105,A00,185477,Wesling; Megan E.,24,0,40,16
1683645783612,CGS 106,A00,185494,Staff,11,0,22,11
1683645784636,CGS 108,A00,185495,Staff,14,0,20,6
1683645785659,CGS 114,A00,185496,Staff,13,0,18,5
1683645786686,CGS 119,A00,185501,Staff,15,0,20,5
1683645787710,CGS 120,A00,185511,Staff,12,0,20,8
1683645788742,CHEM 4,A01,184675,Bussey; Thomas J,97,0,100,3
1683645789766,CHEM 6A,A01,184677,Staff,33,0,60,27
1683645790794,CHEM 6B,A01,184679,Staff,63,0,100,37
1683645791823,CHEM 6C,A01,184681,Bussey; Thomas J,0,0,50,50
1683645791823,CHEM 6C,A02,184682,Bussey; Thomas J,32,0,50,18
1683645792854,CHEM 40A,A01,184684,Albizati; Kim F.,34,0,100,66
1683645793878,CHEM 40B,A01,184686,Albizati; Kim F.,0,22,100,100
1683645794903,CHEM 41B,A01,184690,Staff,51,0,100,49
1683645795933,COGS 3,A01,184715,Boyle; Mary E. T.,0,27,40,40
1683645796962,COGS 14B,A01,185172,Staff,0,14,38,38
1683645797986,COGS 18,A01,184736,Staff,14,0,80,66
1683645799016,COGS 100,A01,184932,Staff,0,7,73,73
1683645800043,COGS 101A,A01,184935,Staff,0,39,30,30
1683645801069,COGS 101B,A01,184944,Staff,0,2,30,30
1683645802097,COGS 101C,A01,184946,Staff,0,10,30,30
1683645803127,COGS 102A,A01,184951,Johnson; Christine M.,2,0,40,38
1683645804155,COGS 107B,A01,184953,Mooshagian; Eric Frederick,0,51,40,40
1683645805181,COGS 118B,A01,184959,Gupta; Anjum,0,49,40,40
1683645806285,COGS 153,A00,184961,Staff,0,16,30,30
1683645807310,COGS 177,A00,184962,Staff,0,21,30,30
1683645808334,COGS 187A,A01,184969,Boyle; Mary E. T.,0,19,40,40
1683645809365,COMM 10,A01,185174,Staff,0,5,25,25
1683645809365,COMM 10,A02,185189,Staff,0,2,25,25
1683645809365,COMM 10,A03,269821,Staff,0,1,0,0
1683645810389,COMM 100B,A01,185475,Staff,0,1,0,2
1683645810389,COMM 100B,A02,185476,Staff,12,0,25,13
1683645811412,COMM 100C,A01,185314,Staff,1,0,25,24
1683645811412,COMM 100C,A02,185327,Staff,18,0,25,7
1683645812437,COMM 110M,A00,185349,Staff,0,0,40,40
1683645813462,COMM 113T,A00,185352,Staff,25,0,40,15
1683645814487,COMM 114I,A00,185353,Staff,31,0,40,9
1683645815511,COMM 131,A00,185354,Staff,17,0,30,13
1683645816537,CSE 8A,A50,185358,Cao; Yingjun,0,46,10,10
1683645817563,CSE 8B,A01,185362,Staff,0,48,50,50
1683645818589,CSE 11,A01,185416,Cao; Yingjun,0,91,10,10
1683645819614,CSE 20,A01,185445,Briones; Jor-el Thomas Caparas,4,0,25,21
1683645820639,CSE 21,A01,185447,Staff,9,0,50,41
1683645821666,CSE 101,A01,185451,Staff,0,13,50,50
1683645821666,CSE 101,B01,185453,Jones; Miles E,0,13,50,50
1683645823720,CSE 141,A01,185458,Eldon; John,15,0,100,85
1683645824743,CSE 141L,A01,185461,Eldon; John,7,0,100,93
1683645825776,CSE 142,A01,185463,Staff,36,0,60,24
1683645825776,CSE 142,B01,201355,Staff,0,7,60,60
1683645826806,CSE 142L,A01,185470,Staff,36,0,60,24
1683645826806,CSE 142L,B01,201417,Staff,0,6,60,60
1683645827835,CSE 190,A00,201433,Staff,32,0,49,17
1683645828865,DOC 1,A01,259136,Strom; Megan C.,7,0,15,8
1683645828865,DOC 1,A02,259137,Strom; Megan C.,14,0,15,1
1683645828865,DOC 1,A03,259138,Strom; Megan C.,14,0,15,1
1683645828865,DOC 1,A04,259139,Strom; Megan C.,14,0,15,1
1683645829889,DOC 100D,A00,259140,Pass; Natalye Joann,14,0,25,11
1683645830918,DSGN 1,A01,184749,Rill; Bryan,0,26,30,30
1683645831943,DSGN 100,A01,185168,Staff,0,2,25,25
1683645832969,ECE 5,A01,185626,Morris; Karcher William,0,11,0,0
1683645833994,ECE 101,A01,185628,Staff,14,0,70,56
1683645835021,ECE 107,A01,185635,Baghdadchi; Saharnaz,0,0,20,20
1683645835021,ECE 107,A02,185638,Baghdadchi; Saharnaz,3,0,20,17
1683645836048,ECE 148,A01,185647,Silberman; Jack,0,0,16,16
1683645837075,ECON 1,A01,185537,Crane; Meredith Helen,54,0,70,16
1683645838099,ECON 3,A01,185549,Crane; Meredith Helen,29,0,70,41
1683645839129,ECON 4,A01,203354,Anderson; John Charles,0,5,10,10
1683645840158,ECON 100A,A01,185574,Staff,0,5,40,40
1683645841181,ECON 100B,A01,185576,Staff,0,12,50,50
1683645842263,ECON 100C,A01,185589,Newhouse; Herbert S,30,0,70,40
1683645843288,ECON 105,A00,185608,Vespa; Emanuel Ignacio,19,0,35,16
1683645844312,ECON 109,A01,185610,Shishkin; Denis,9,0,35,26
1683645845341,ECON 110A,A01,185612,Staff,9,0,40,31
1683645846369,ECON 120A,A01,185615,Staff,20,0,40,20
1683645847400,ECON 120C,A01,185617,Sun; Yixiao,0,20,70,70
1683645848433,ECON 144,A00,203346,Squires; Dale E,2,0,35,33
1683645849460,ECON 171,A01,203349,Newhouse; Herbert S,0,1,35,35
1683645850486,ECON 173A,A01,185621,Toda; Alexis Akira,21,0,35,14
1683645851522,EDS 25,A01,202413,Staff,0,1,0,0
1683645851522,EDS 25,A02,202414,Staff,0,1,0,0
1683645851522,EDS 25,A03,202415,Staff,0,0,0,0
1683645851522,EDS 25,A04,202416,Staff,0,1,0,0
1683645851522,EDS 25,A05,202439,Staff,0,0,0,0
1683645851522,EDS 25,A06,202440,Staff,0,0,0,0
1683645851522,EDS 25,B01,202631,Staff,0,0,0,0
1683645851522,EDS 25,B02,202632,Staff,0,0,0,0
1683645851522,EDS 25,B03,202639,Staff,0,0,0,0
1683645851522,EDS 25,B04,202640,Staff,0,0,0,0
1683645851522,EDS 25,B05,202643,Staff,0,0,0,0
1683645851522,EDS 25,B06,202644,Staff,0,0,0,0
1683645852545,EDS 38,A01,202659,Black; Alison Michelle,24,0,25,1
1683645853576,EDS 115,A00,202652,Staff,18,0,30,12
1683645854604,EDS 125,A00,202649,Staff,13,0,30,17
1683645855633,EDS 126,A01,203332,Staff,30,0,30,0
1683645856656,EDS 139,A00,202838,Staff,16,0,25,9
1683645857684,EDS 146,A01,202655,Staff,14,0,25,11
1683645858711,ENG 15,A00,185667,Staff,0,1,0,0
1683645858711,ENG 15,B00,185672,Staff,0,0,0,0
1683645858711,ENG 15,C00,185675,Staff,0,0,0,0
1683645858711,ENG 15,D00,185682,Staff,0,0,0,0
1683645858711,ENG 15,E00,185684,Staff,0,0,0,0
1683645859738,ETHN 103,A00,185710,Staff,0,8,35,35
1683645860766,ETHN 103A,A00,199228,Man; Simeon S,0,0,9,9
1683645861792,ETHN 109,A00,185711,Staff,16,0,35,19
1683645862816,ETHN 142,A00,185726,Staff,0,4,30,30
1683645863844,ETHN 163J,A00,199229,Man; Simeon S,5,0,8,3
1683645864868,ETHN 168,A00,185727,Staff,7,0,10,3
1683645865893,ETHN 182,A00,185728,Staff,0,0,35,35
1683645866917,ETHN 183,A00,185737,Staff,9,0,18,9
1683645867948,GLBH 111,A01,209361,Burgos; Jose L.,0,0,0,0
1683645870001,HIEU 104,A00,185792,Staff,14,0,20,6
1683645871025,HIEU 115,A00,185800,Staff,0,0,20,20
1683645872053,HIEU 128,A00,185801,Staff,0,9,20,20
1683645873078,HIEU 147,A00,185802,Staff,15,0,20,5
1683645874102,HIEU 154,A00,185823,Staff,11,0,20,9
1683645875126,HILA 102,A00,185826,Staff,14,0,20,6
1683645876154,HILD 2C,A01,185778,Staff,0,13,20,20
1683645877177,HILD 7B,A01,185780,Kwak; Nancy,0,16,32,32
1683645877177,HILD 7B,A02,185781,Kwak; Nancy,0,18,32,32
1683645878202,HILD 30,A01,185791,Staff,12,0,20,8
1683645879227,HISC 119,A00,185830,Golan; Tal,0,9,20,20
1683645880254,HITO 156GS,A00,185831,Patterson; Patrick H.,0,0,0,23
1683645881278,HIUS 103,A00,185832,Man; Simeon S,0,4,20,20
1683645882302,HIUS 117,A00,185836,Kwak; Nancy,2,0,20,18
1683645883327,HIUS 125,A00,185840,Man; Simeon S,0,1,23,23
1683645884354,HIUS 149,A00,185845,Staff,1,0,20,19
1683645885380,HUM 3,A01,185882,Zavodny; Tatiana Sophia,0,7,50,50
1683645885380,HUM 3,B01,185899,Caldwell; Michael Alan,0,18,50,50
1683645886403,HUM 3GS,A00,185900,Patterson; Patrick H.,0,0,0,23
1683645887429,HUM 4,A01,185938,Zroka; Amy Liane,30,0,50,20
1683645887429,HUM 4,B01,185956,Watkins; Eric,0,4,50,50
1683645887429,HUM 4,B02,202209,Watkins; Eric,0,4,50,50
1683645887429,HUM 4,B03,202210,Watkins; Eric,0,4,50,50
1683645888458,HUM 5,A01,185958,West; Geoffrey Scott,2,0,50,48
1683645888458,HUM 5,A02,202215,West; Geoffrey Scott,0,0,50,50
1683645889484,INTL 190,A00,185959,Gagnon; Jeffrey C,0,0,0,9
1683645889484,INTL 190,B00,185960,Lettieri; Michael Joseph,0,0,0,2
1683645890511,JAPN 180,A00,254509,Staff,5,0,30,25
1683645891540,LATI 10,A01,202853,Kennemore; Amy Michelle,4,0,35,31
1683645891540,LATI 10,A02,202854,Kennemore; Amy Michelle,2,0,35,33
1683645891540,LATI 10,A03,270054,Kennemore; Amy Michelle,30,0,30,0
1683645892564,LATI 180,A00,202855,Kennemore; Amy Michelle,11,0,20,9
1683645893590,LAWS 101,A00,201767,Golan; Tal,0,7,40,40
1683645894615,LIFR 1C,A00,185961,Staff,6,0,20,14
1683645895638,LIFR 1CX,A00,185962,Staff,7,0,20,13
1683645896662,LIFR 1D,A00,185963,Staff,7,0,20,13
1683645897688,LIFR 1DX,A00,185964,Staff,7,0,20,13
1683645898714,LIGN 101,A01,186039,Staff,43,0,50,7
1683645899738,LIGN 165,A00,186040,Staff,15,0,50,35
1683645900764,LTCS 108,A00,186041,Staff,5,0,10,5
1683645901789,LTCS 119,A00,186042,Staff,15,0,20,5
1683645902813,LTCS 130,A00,186043,Wesling; Megan E.,15,0,25,10
1683645904861,LTEA 138,A00,186119,Staff,14,0,40,26
1683645905918,LTEN 124,A00,186148,Staff,5,0,25,20
1683645906942,LTEN 178,A00,186149,Staff,7,0,15,8
1683645907971,LTEN 181,A00,186150,Blanco; John D,34,0,40,6
1683645908997,LTWL 120,A00,186160,Staff,20,0,25,5
1683645910075,LTWL 165,A00,186161,Staff,22,0,25,3
1683645911103,LTWR 100,A00,186162,Staff,0,5,15,15
1683645912128,LTWR 102,A00,186163,Doller; Ben,5,0,15,10
1683645913152,MAE 8,A01,186412,Staff,0,0,0,0
1683645914181,MAE 30B,A00,186445,Bahadori; Mohammad Yousef,82,0,100,18
1683645915206,MAE 40,A00,186592,Bewley; Thomas R,10,0,50,40
1683645916231,MAE 101B,A00,186593,Bahadori; Mohammad Yousef,80,0,100,20
1683645917256,MAE 105,A00,186594,Bandaru; Prabhakar,10,0,50,40
1683645918281,MAE 107,A00,186599,Pham; Hieu Tan,0,7,120,120
1683645919304,MAE 148,A01,186660,Silberman; Jack,3,0,16,13
1683645920335,MATH 10A,A01,188095,Staff,0,5,35,35
1683645921365,MATH 10B,A01,188097,Bowers; Adam R.,0,11,30,30
1683645921365,MATH 10B,A02,188099,Bowers; Adam R.,0,11,30,30
1683645921365,MATH 10B,B01,188104,Bowers; Adam R.,0,10,30,30
1683645921365,MATH 10B,B02,188106,Bowers; Adam R.,1,9,30,29
1683645922395,MATH 10C,A01,188111,Staff,0,18,30,30
1683645922395,MATH 10C,A02,188127,Staff,0,19,30,30
1683645922395,MATH 10C,A03,188131,Staff,0,19,30,30
1683645922395,MATH 10C,B01,188218,Staff,17,0,30,13
1683645922395,MATH 10C,B02,188244,Staff,13,0,30,17
1683645922395,MATH 10C,B03,188277,Staff,14,0,30,16
1683645923426,MATH 18,A01,188344,Bach; Quang Tran,18,0,30,12
1683645923426,MATH 18,A02,188345,Bach; Quang Tran,11,0,30,19
1683645923426,MATH 18,B01,188353,Bach; Quang Tran,11,0,30,19
1683645923426,MATH 18,B02,188354,Bach; Quang Tran,19,0,30,11
1683645924450,MATH 20A,A01,188374,Staff,11,0,35,24
1683645925479,MATH 20B,A01,188382,Ohm; Ko Woon,7,0,30,23
1683645925479,MATH 20B,A02,188383,Ohm; Ko Woon,22,0,30,8
1683645925479,MATH 20B,B01,188385,Ohm; Ko Woon,7,0,30,23
1683645925479,MATH 20B,B02,188392,Ohm; Ko Woon,22,0,30,8
1683645926505,MATH 20C,A01,188394,Harel; Guershon,11,0,30,19
1683645926505,MATH 20C,A02,188395,Harel; Guershon,14,0,30,16
1683645926505,MATH 20C,B01,188404,Harel; Guershon,4,0,30,26
1683645926505,MATH 20C,B02,188405,Harel; Guershon,18,0,30,12
1683645927533,MATH 20D,A01,188414,Hammock; Frances H,0,1,30,30
1683645927533,MATH 20D,A02,188415,Hammock; Frances H,0,1,30,30
1683645927533,MATH 20D,B01,188447,Hammock; Frances H,0,1,30,30
1683645927533,MATH 20D,B02,188486,Hammock; Frances H,4,0,30,26
1683645928558,MATH 20E,A01,188649,Staff,21,0,30,9
1683645928558,MATH 20E,A02,188650,Staff,21,0,30,9
1683645928558,MATH 20E,A03,188673,Staff,0,0,30,30
1683645929583,MATH 102,A01,188675,Staff,0,36,35,35
1683645930612,MATH 103B,A01,188681,Staff,3,0,35,32
1683645930612,MATH 103B,B01,188692,Staff,5,0,35,30
1683645931636,MATH 109,A01,188695,Salehi Golsefidy; Alireza,24,0,35,11
1683645931636,MATH 109,A02,188696,Salehi Golsefidy; Alireza,25,0,35,10
1683645932661,MATH 120A,A01,188698,Eggers; John Dietrich,7,0,35,28
1683645933686,MATH 142B,A01,188736,Ioana; Adrian,0,1,30,30
1683645933686,MATH 142B,A02,188741,Ioana; Adrian,0,1,30,30
1683645933686,MATH 142B,A03,188743,Ioana; Adrian,0,1,30,30
1683645934715,MATH 168A,A01,188790,Staff,0,10,35,35
1683645935740,MATH 170A,A01,188803,Nie; Jiawang,0,2,35,35
1683645935740,MATH 170A,A02,188811,Nie; Jiawang,0,0,35,35
1683645935740,MATH 170A,A03,188814,Nie; Jiawang,0,0,35,35
1683645935740,MATH 170A,A04,188815,Nie; Jiawang,10,0,35,25
1683645936765,MATH 193B,A01,188817,Staff,0,0,35,35
1683645936765,MATH 193B,A02,188818,Staff,5,0,35,30
1683645937793,MGT 4,A01,202857,Anderson; John Charles,61,0,80,19
1683645938817,MGT 12,A00,202858,Lindenberger; Wade Douglas,40,0,90,50
1683645939841,MGT 18,A00,202859,Staff,74,0,90,16
1683645940871,MGT 18GS,A00,202860,McKay; Michael J,13,0,28,15
1683645941898,MGT 45,A00,202861,Pecore; Joseph P.,12,0,90,78
1683645942928,MGT 100,A00,202863,Yavorsky; Daniel Ryan,28,0,90,62
1683645943951,MGT 103,A00,202864,Ehrich; Kristine R,0,17,90,90
1683645944981,MGT 112,A00,202865,Ehrich; Kristine R,15,0,90,75
1683645946008,MGT 121A,A00,202868,Staff,0,20,0,0
1683645947035,MGT 131B,A00,202869,Anderson; John Charles,59,0,90,31
1683645948062,MGT 136,A00,202871,Lindenberger; Wade Douglas,83,0,90,7
1683645949085,MGT 164,A00,202873,Staff,0,66,90,91
1683645950108,MGT 164GS,A00,202874,McKay; Mary A,13,0,28,15
1683645951139,MGT 180,A00,202875,Staff,0,50,90,91
1683645952166,MMW 11R,A01,205019,Herbst; Matthew,2,0,30,28
1683645952166,MMW 11R,A02,205026,Herbst; Matthew,29,0,30,1
1683645953198,MMW 15,A01,193512,Chang; Edmond Yi-Teh,0,8,28,28
1683645953198,MMW 15,A02,193513,Chang; Edmond Yi-Teh,0,5,28,28
1683645953198,MMW 15,A03,193514,Chang; Edmond Yi-Teh,0,5,28,28
1683645953198,MMW 15,A04,193515,Chang; Edmond Yi-Teh,0,5,28,28
1683645953198,MMW 15,A05,193516,Chang; Edmond Yi-Teh,0,5,28,28
1683645953198,MMW 15,A06,193517,Chang; Edmond Yi-Teh,0,6,28,28
1683645953198,MMW 15,B01,193519,Chang; Edmond Yi-Teh,0,5,28,28
1683645953198,MMW 15,B02,193520,Chang; Edmond Yi-Teh,0,5,28,28
1683645953198,MMW 15,B03,193521,Chang; Edmond Yi-Teh,0,5,28,28
1683645953198,MMW 15,B04,193522,Chang; Edmond Yi-Teh,0,5,28,28
1683645953198,MMW 15,B05,193523,Chang; Edmond Yi-Teh,0,5,28,28
1683645953198,MMW 15,B06,193524,Chang; Edmond Yi-Teh,0,5,28,28
1683645954224,MMW 122,A01,193526,Rahimi; Babak,0,16,28,28
1683645954224,MMW 122,A02,193527,Rahimi; Babak,0,15,28,28
1683645954224,MMW 122,A03,193528,Rahimi; Babak,0,0,0,0
1683645954224,MMW 122,A04,193529,Rahimi; Babak,0,0,0,0
1683645955248,MUS 1A,A01,186663,Staff,1,20,35,34
1683645956273,MUS 4,A01,186715,Staff,0,12,35,35
1683645957302,MUS 5R,A01,186796,Dubnov; Shlomo,0,17,35,35
1683645958324,MUS 6,A01,186798,Staff,0,5,25,25
1683645959349,MUS 7,A01,186830,Staff,11,0,35,24
1683645960374,MUS 8,A01,186930,Staff,0,26,35,35
1683645961399,MUS 15,A01,186932,Staff,0,16,35,35
1683645961399,MUS 15,B01,186934,Staff,0,17,35,35
1683645962428,MUS 80,A00,186935,Staff,0,0,20,20
1683645962428,MUS 80,B00,186936,Staff,24,0,25,1
1683645963453,NANO 11,A00,204702,Lipomi; Darren John,0,0,0,0
1683645964477,NANO 15,A01,204709,Yang; Kesong,0,1,0,0
1683645965506,NANO 114,A00,202069,Jahed Motlagh; Zeinab,3,0,10,7
1683645966533,PHIL 1,A00,186955,Grush; Rick Scott,31,0,40,9
1683645967558,PHIL 10,A01,186973,Grush; Rick Scott,27,0,35,8
1683645967558,PHIL 10,A02,186974,Grush; Rick Scott,33,0,35,2
1683645968587,PHIL 13,A01,186976,Staff,3,0,35,32
1683645968587,PHIL 13,A02,186977,Staff,16,0,35,19
1683645969614,PHIL 14,A01,186979,Staff,31,0,35,4
1683645969614,PHIL 14,A02,186986,Staff,32,0,35,3
1683645970644,PHIL 28,A01,186988,Staff,16,0,30,14
1683645970644,PHIL 28,A02,186989,Staff,1,0,30,29
1683645970644,PHIL 28,A03,186990,Staff,10,0,30,20
1683645970644,PHIL 28,A04,186991,Staff,26,0,30,4
1683645971687,PHIL 120,A00,186997,Staff,23,0,40,17
1683645972714,PHIL 137,A00,187003,Staff,7,0,40,33
1683645973743,PHIL 150,A00,187015,Staff,47,0,70,23
1683645974774,PHIL 167,A00,187021,Lamey; Andy M.,34,0,40,6
1683645975798,PHIL 174,A01,202226,Staff,17,0,20,3
1683645975798,PHIL 174,A02,202235,Staff,20,0,20,0
1683645976824,PHIL 191A,A00,258918,Staff,0,0,1,1
1683645977850,PHYS 1A,A00,187028,Staff,27,0,60,33
1683645978878,PHYS 1AL,001,187036,Staff,3,0,30,27
1683645978878,PHYS 1AL,002,187049,Staff,18,0,30,12
1683645979902,PHYS 1B,A00,187058,Staff,22,0,60,38
1683645980927,PHYS 1BL,001,187064,Staff,0,1,30,30
1683645980927,PHYS 1BL,002,187070,Staff,4,0,30,26
1683645981952,PHYS 1C,A00,187082,Staff,29,0,120,91
1683645982983,PHYS 1CL,001,187088,Staff,0,9,30,30
1683645982983,PHYS 1CL,002,187089,Staff,0,1,30,30
1683645982983,PHYS 1CL,009,262693,Staff,9,0,30,21
1683645984008,PHYS 2B,A01,187097,Staff,55,0,115,60
1683645985033,PHYS 2C,A01,187099,Staff,64,0,115,51
1683645986060,PHYS 2CL,A01,187101,Staff,5,0,28,23
1683645986060,PHYS 2CL,A02,187102,Staff,15,0,28,13
1683645987089,PHYS 2D,A01,187123,Shotwell; Brian,95,0,115,20
1683645988114,PHYS 4B,A01,187133,Grinstein; Benjamin,35,0,50,15
1683645989141,POLI 10,A00,188819,Staff,0,4,50,50
1683645990166,POLI 11,A00,188827,Staff,43,0,50,7
1683645991193,POLI 13R,A00,188828,Staff,0,1,20,20
1683645992218,POLI 27,A01,188830,Elgin; Samuel Zincke,0,2,70,70
1683645993243,POLI 30,A00,188832,Desposato; Scott,30,0,50,20
1683645994269,POLI 102F,A00,188834,Staff,0,0,40,40
1683645995293,POLI 104A,A00,188852,Staff,13,0,30,17
1683645996318,POLI 104I,A00,188853,Staff,0,7,20,20
1683645997341,POLI 110B,A00,188854,Wiens; David,7,0,20,13
1683645998366,POLI 112A,A00,188855,Wiens; David,4,0,30,26
1683645999395,POLI 117R,A00,188856,Forman; Fonna,0,12,20,20
1683646000421,POLI 118,A00,188857,Ingham; Sean,8,0,20,12
1683646001445,POLI 120G,A00,188858,Staff,8,0,30,22
1683646002469,POLI 131CR,A00,188863,Hoston; Germaine,21,0,50,29
1683646003498,POLI 133,A00,188864,Nellis; Gareth Hb,44,0,50,6
1683646004526,POLI 134D,A00,188865,Desposato; Scott,27,0,30,3
1683646005551,POLI 142A,A00,188871,Gartzke; Erik,21,0,50,29
1683646006581,POLI 142K,A00,188874,Staff,38,0,50,12
1683646007607,POLI 143,A00,188940,Gartzke; Erik,16,0,30,14
1683646008633,POLI 153,A00,188943,Staff,2,0,20,18
1683646009658,POLI 160AA,A00,188944,Staff,11,0,40,29
1683646010683,POLI 170A,A00,188945,Staff,11,0,30,19
1683646012735,PSYC 1,A00,188952,Staff,36,0,90,54
1683646013836,PSYC 2,B00,188953,Staff,19,0,35,16
1683646014859,PSYC 6,A00,188970,Staff,47,0,60,13
1683646015885,PSYC 7,A00,188973,Staff,35,0,45,10
1683646016913,PSYC 60,A01,188980,Rickard; Timothy C.,42,0,60,18
1683646017938,PSYC 70,A01,189001,Steiner; Eric Tomas,23,0,45,22
1683646018964,PSYC 100,A00,189005,Lacefield; Katharine I,0,99,120,120
1683646019988,PSYC 102,A00,189008,Staff,8,0,30,22
1683646021012,PSYC 106,B00,189026,Gorman; Michael R.,27,0,60,33
1683646022040,PSYC 114,B01,189033,Winkielman; Piotr,0,31,30,30
1683646023071,PSYC 131,A00,189036,Anagnostaras; Stephan,0,43,60,60
1683646024094,PSYC 136,A00,189041,Lowe; Angela Beth,0,7,25,25
1683646025121,PSYC 137,A00,189057,Winkielman; Piotr,0,37,25,25
1683646026149,PSYC 144,A00,189107,Wixted; John T,0,10,50,50
1683646028199,PSYC 162,A00,189142,Staff,0,9,85,85
1683646029225,PSYC 172,A00,189144,Gorman; Michael R.,0,6,30,30
1683646031279,PSYC 179,A00,189146,Lacefield; Katharine I,0,86,120,120
1683646032303,PSYC 181,A00,189147,Anagnostaras; Stephan,0,44,90,90
1683646033330,PSYC 190R,A00,189148,Barner; David A.,0,23,80,80
1683646034359,PSYC 191,A00,189275,Rickard; Timothy C.,0,10,25,25
1683646035386,PSYC 193,A00,189276,Chapman; Eddie Nathaniel,0,1,0,4
1683646036415,PSYC 193L,A01,189281,Lowe; Angela Beth,10,0,20,10
1683646036415,PSYC 193L,B01,189285,Staff,28,0,35,7
1683646037443,RELI 149,A00,187137,Rahimi; Babak,7,0,40,33
1683646038468,SE 9,A01,187315,Staff,0,2,18,18
1683646039493,SE 101B,A00,187409,Staff,24,0,30,6
1683646040517,SE 110B,A00,187444,Staff,10,0,40,30
1683646041542,SE 130B,A00,187449,Staff,31,0,40,9
1683646042569,SE 150A,A00,187516,Staff,9,0,20,11
1683646043597,SE 154,A00,187528,Staff,29,0,50,21
1683646044621,SIO 3,A01,258171,Staff,35,0,40,5
1683646045646,SIO 10,A00,187144,Cook; Geoffrey W,0,6,75,75
1683646046671,SIO 45,A00,187152,Cook; Geoffrey W,0,4,100,100
1683646047697,SIO 109R,A00,194486,Staff,0,4,20,20
1683646049753,SIO 187,A01,187233,Kacev; David,12,0,40,28
1683646050782,SOCI 1,A01,258656,Thorpe; Charles Robert,28,0,30,2
1683646050782,SOCI 1,A02,258658,Thorpe; Charles Robert,30,0,30,0
1683646050782,SOCI 1,A03,258661,Thorpe; Charles Robert,25,0,25,0
1683646050782,SOCI 1,A04,258666,Thorpe; Charles Robert,22,0,25,3
1683646050782,SOCI 1,A05,258897,Thorpe; Charles Robert,22,0,25,3
1683646050782,SOCI 1,A06,258898,Thorpe; Charles Robert,25,0,25,0
1683646051808,SOCI 30,A01,258903,Pardo Guerra; Juan Pablo,14,0,30,16
1683646052832,SOCI 102,A00,258904,Staff,9,0,25,16
1683646053861,SOCI 106,A00,258905,Staff,19,0,25,6
1683646054886,SOCI 111,A00,258907,Ribas Norris; Janet Vanesa,26,0,30,4
1683646055913,SOCI 121R,A00,258908,Pardo Guerra; Juan Pablo,8,0,30,22
1683646056938,SOCI 126,A01,203330,Staff,14,0,20,6
1683646057967,SOCI 131,A00,258909,Thorpe; Charles Robert,30,0,60,30
1683646058992,SOCI 135,A00,258910,Payne; Christine Anna,0,11,30,30
1683646060019,SOCI 157,A00,258911,Staff,12,0,30,18
1683646061047,SOCI 184,A00,258912,Staff,25,0,30,5
1683646062071,SOCI 188D,A00,258913,Staff,22,0,30,8
1683646063096,SYN 2,001,187529,Staff,9,0,16,7
1683646063096,SYN 2,002,201452,Staff,0,20,16,16
1683646063096,SYN 2,003,201469,Staff,2,0,16,14
1683646064119,SYN 100,A01,187531,Staff,0,9,20,20
1683646064119,SYN 100,B01,201491,Staff,0,10,20,20
1683646065144,TDAC 1,A00,189286,Walsh; Kim C.,3,0,20,17
1683646065144,TDAC 1,B00,189287,Harting; Carla Kelso,10,0,20,10
1683646066167,TDAC 101,A00,189300,Walsh; Kim C.,16,0,20,4
1683646066167,TDAC 101,B00,189301,Harting; Carla Kelso,18,0,20,2
1683646067191,TDAC 102,A00,189304,Basso; Beatrice,14,0,20,6
1683646068215,TDAC 108,A00,189305,Staff,18,0,20,2
1683646069239,TDDE 131,A00,189310,Staff,19,0,20,1
1683646069239,TDDE 131,B00,189314,Staff,19,0,20,1
1683646069239,TDDE 131,C00,189315,Staff,48,0,50,2
1683646069239,TDDE 131,D00,189316,Staff,14,0,15,1
1683646069239,TDDE 131,E00,204841,Staff,20,0,20,0
1683646070263,TDGE 10,A00,189289,Staff,27,0,50,23
1683646070263,TDGE 10,B00,189290,Havis; Allan,0,0,50,50
1683646071289,TDGE 11,A00,189291,Fulton; Julia,0,4,50,50
1683646071289,TDGE 11,B00,189292,Staff,20,0,25,5
1683646071289,TDGE 11,C00,260270,Staff,0,0,0,0
1683646072316,TDGE 25,A00,189294,Staff,2,0,20,18
1683646073343,TDGE 124,A00,189318,Fulton; Julia,0,8,50,50
1683646074370,TDGE 125,A00,189319,Staff,13,0,25,12
1683646074370,TDGE 125,B00,189320,Staff,23,0,25,2
1683646075394,TDGE 127,A00,189322,Havis; Allan,0,0,50,50
1683646076422,TDHT 101,A00,189323,Staff,18,0,25,7
1683646076422,TDHT 101,B00,189324,Staff,25,0,25,0
1683646077447,TDHT 102,A00,189325,Staff,49,0,50,1
1683646078473,TDMV 1,A00,189295,Arcidiacono; Kristin,20,0,30,10
1683646078473,TDMV 1,B00,189296,Caligagan; Maria T.,24,0,30,6
1683646079501,TDMV 2,A00,189297,Sammartano; Tonnie,27,0,30,3
1683646079501,TDMV 2,B00,189299,Arcidiacono; Kristin,23,0,30,7
1683646080525,TDMV 3,A00,204998,Rincon; Alicia,22,0,30,8
1683646081549,TDMV 120,A00,189458,Sammartano; Tonnie,28,0,30,2
1683646082572,TDMV 138,A00,189541,Jun; Grace Shin Hae,20,0,40,20
1683646083596,TDMV 142,A00,189717,Caligagan; Tony,25,0,30,5
1683646083596,TDMV 142,B00,189718,Caligagan; Maria T.,25,0,30,5
1683646084623,TMC 2,A01,187533,Staff,25,0,25,0
1683646084623,TMC 2,A02,187534,Staff,25,0,25,0
1683646085649,USP 1,A01,187536,Kwak; Nancy,0,16,25,25
1683646086673,USP 5,A01,187538,Staff,9,0,25,16
1683646087700,USP 101,A00,199253,Staff,0,4,0,0
1683646088727,USP 124,A00,187562,Boomhower; Matthew Charles,0,0,30,30
1683646089751,USP 138,A00,187582,Staff,20,0,25,5
1683646090777,USP 152,A01,187597,Staff,3,0,25,22
1683646091802,USP 153,A00,187598,Staff,19,0,25,6
1683646092829,USP 168,A00,187607,Kwak; Nancy,2,0,5,3
1683646093854,USP 173,A00,187619,Staff,4,0,25,21
1683646094877,USP 181,A00,187638,Staff,0,4,25,25
1683646095901,VIS 103,A00,187650,Cruz; Edwin Teddy,18,0,75,57
1683646096925,VIS 110D,A00,187669,Staff,13,0,22,9
1683646097953,VIS 127C,A00,187720,Shen; Kuiyi,67,0,146,79
1683646098976,VIS 149,A00,187731,Yoldas; Pinar,0,14,22,22
1683646100003,VIS 151,A01,188091,Staff,22,0,34,12
1683646100003,VIS 151,A02,188092,Staff,11,0,34,23
1683646101033,VIS 160B,A00,188093,Stalbaum; Brett,0,1,10,10
1683646103085,WCWP 10B,A00,201720,Staff,10,0,15,5
1683646103085,WCWP 10B,B00,201722,Staff,9,0,15,6
1683646104115,WCWP 100,A00,201725,Gagnon; Jeffrey C,0,0,2,2
1683646104115,WCWP 100,B00,201727,Staff,0,4,15,15
1683646107257,ANBI 133,A00,258401,Wilder; Linnea Lorene,34,0,40,6
1683646108282,ANBI 140,A00,258395,Hrvoj Mihic; Branka,18,0,25,7
1683646109307,ANSC 120,A00,258402,Bialecki; Jon Anthony,26,0,40,14
1683646110332,ANSC 144,A00,258400,Staff,12,0,40,28
1683646112384,ANSC 166,A00,258396,Parish; Steven Martin,156,0,175,19
1683646113407,ANSC 180,A00,193533,Staff,8,0,20,12
1683646114430,ANSC 188,A00,258397,Jassal; Aftab,34,0,40,6
1683646115456,ANTH 3,A01,258316,Staff,23,0,30,7
1683646116480,ANTH 5,A00,258394,Semendeferi; Ekaterini,16,0,20,4
1683646117562,ANTH 21,A01,258331,Staff,4,0,40,36
1683646118588,ANTH 103,A00,258398,Varma; Saiba,15,0,25,10
1683646119615,AWP 10,001,202034,Staff,0,0,0,0
1683646119615,AWP 10,002,202035,Staff,0,0,0,0
1683646119615,AWP 10,003,202036,Staff,0,0,0,0
1683646119615,AWP 10,004,202037,Staff,0,0,0,0
1683646119615,AWP 10,005,202038,Staff,0,0,0,0
1683646119615,AWP 10,006,202039,Staff,0,0,0,0
1683646119615,AWP 10,007,202040,Staff,0,0,0,0
1683646119615,AWP 10,008,202041,Staff,0,0,0,0
1683646119615,AWP 10,009,202042,Staff,0,0,0,0
1683646119615,AWP 10,010,202043,Staff,0,0,0,0
1683646119615,AWP 10,011,202044,Staff,0,0,0,0
1683646119615,AWP 10,012,202045,Staff,0,0,0,0
1683646119615,AWP 10,013,202046,Staff,0,0,0,0
1683646119615,AWP 10,014,202047,Staff,0,0,0,0
1683646119615,AWP 10,015,202048,Staff,0,0,0,0
1683646119615,AWP 10,016,202049,Staff,0,0,0,0
1683646119615,AWP 10,017,202050,Staff,0,0,0,0
1683646119615,AWP 10,018,202051,Staff,0,0,0,0
1683646119615,AWP 10,019,202052,Staff,0,0,0,0
1683646119615,AWP 10,020,202053,Staff,0,0,0,0
1683646119615,AWP 10,021,202054,Staff,0,0,0,0
1683646119615,AWP 10,022,202055,Staff,0,0,0,0
1683646119615,AWP 10,023,202056,Staff,0,0,0,0
1683646119615,AWP 10,024,202057,Staff,0,0,0,0
1683646119615,AWP 10,025,202058,Staff,0,0,0,0
1683646119615,AWP 10,026,202059,Staff,0,0,0,0
1683646120639,AWP 102,001,202032,Staff,0,0,0,0
1683646120639,AWP 102,002,202033,Staff,0,0,0,0
1683646121667,BENG 100,A01,254234,Taylor Amos; Alyssa C,31,0,40,9
1683646122694,BENG 196,001,270013,Engler; Adam J.,9999,0,9999,0
1683646123720,BICD 100R,A01,202018,Smith; Laurie,0,7,32,32
1683646123720,BICD 100R,A02,202019,Smith; Laurie,0,3,32,32
1683646123720,BICD 100R,A03,202020,Smith; Laurie,0,1,32,32
1683646123720,BICD 100R,A04,202021,Smith; Laurie,6,0,32,26
1683646123720,BICD 100R,A05,202022,Smith; Laurie,11,0,32,21
1683646124750,BICD 136,A01,193242,Gustafson-Brown; Cindy,0,2,32,32
1683646124750,BICD 136,A02,193244,Gustafson-Brown; Cindy,13,0,32,19
1683646125781,BIEB 102,A01,193249,Butler; Shannon Rhey,0,2,32,32
1683646125781,BIEB 102,A02,193251,Butler; Shannon Rhey,0,0,32,32
1683646125781,BIEB 102,A03,193253,Butler; Shannon Rhey,0,0,32,32
1683646125781,BIEB 102,A04,193255,Butler; Shannon Rhey,14,0,32,18
1683646125781,BIEB 102,A05,193265,Butler; Shannon Rhey,26,0,32,6
1683646125781,BIEB 102,A06,193269,Butler; Shannon Rhey,14,0,32,18
1683646127832,BIEB 150,A01,193274,Staff,0,0,32,32
1683646127832,BIEB 150,A02,193285,Staff,24,0,32,8
1683646128860,BIEB 194,A00,193286,Kurle; Carolyn M.,20,0,32,12
1683646129891,BILD 1,A01,192291,Staff,15,0,32,17
1683646129891,BILD 1,A02,192292,Staff,30,0,32,2
1683646129891,BILD 1,B01,192520,Reuther; Keefe,0,1,0,0
1683646129891,BILD 1,B02,192532,Reuther; Keefe,0,1,0,0
1683646130918,BILD 3,A01,192556,Butler; Shannon Rhey,0,0,32,32
1683646130918,BILD 3,A02,192581,Butler; Shannon Rhey,1,0,32,31
1683646130918,BILD 3,A03,192611,Butler; Shannon Rhey,21,0,32,11
1683646130918,BILD 3,A04,192612,Butler; Shannon Rhey,24,0,32,8
1683646130918,BILD 3,A05,192613,Butler; Shannon Rhey,26,0,32,6
1683646130918,BILD 3,A06,192679,Butler; Shannon Rhey,27,0,32,5
1683646130918,BILD 3,A07,192682,Butler; Shannon Rhey,20,0,32,12
1683646131944,BILD 4,A01,192836,Reuther; Keefe,0,0,24,24
1683646131944,BILD 4,A02,193044,Reuther; Keefe,4,0,24,20
1683646132967,BILD 10,A01,193142,Gustafson-Brown; Cindy,29,0,32,3
1683646132967,BILD 10,A02,193149,Gustafson-Brown; Cindy,31,0,32,1
1683646133992,BIMM 100,A01,193301,Staff,0,6,32,32
1683646133992,BIMM 100,A02,193312,Staff,0,7,32,32
1683646133992,BIMM 100,A03,193323,Staff,0,9,32,32
1683646135017,BIMM 101,A01,193329,McDonnell; Lisa Marie,0,4,24,24
1683646135017,BIMM 101,A02,193339,McDonnell; Lisa Marie,0,3,24,24
1683646135017,BIMM 101,B01,193354,McDonnell; Lisa Marie,0,4,24,24
1683646135017,BIMM 101,B02,193357,McDonnell; Lisa Marie,0,3,24,24
1683646136042,BIMM 110,A01,193377,Tat; John,0,11,32,32
1683646136042,BIMM 110,A02,193378,Tat; John,0,10,32,32
1683646137067,BIMM 120,A01,206116,Staff,0,0,32,32
1683646137067,BIMM 120,A02,206117,Staff,6,0,32,26
1683646137067,BIMM 120,A03,206121,Staff,21,0,32,11
1683646138092,BIPN 100,A01,193393,Park; Ji Young,0,14,32,32
1683646138092,BIPN 100,A02,193402,Park; Ji Young,0,14,32,32
1683646138092,BIPN 100,A03,193413,Park; Ji Young,0,14,32,32
1683646138092,BIPN 100,A04,193414,Park; Ji Young,0,13,32,32
1683646139117,BIPN 102,A01,193429,Staff,0,0,32,32
1683646139117,BIPN 102,A02,193438,Staff,18,0,32,14
1683646140142,BIPN 106,A01,193450,Reyes Gonzalez; Catalina,0,2,40,40
1683646141171,BIPN 134,A01,193465,Cooke; James Edward,0,0,32,32
1683646141171,BIPN 134,A02,193474,Cooke; James Edward,25,0,32,7
1683646141171,BIPN 134,A03,193485,Cooke; James Edward,29,0,32,3
1683646141171,BIPN 134,A04,193486,Cooke; James Edward,20,0,32,12
1683646141171,BIPN 134,A05,193491,Cooke; James Edward,31,0,32,1
1683646141171,BIPN 134,A06,193501,Cooke; James Edward,30,0,32,2
1683646141171,BIPN 134,A07,193510,Cooke; James Edward,29,0,32,3
1683646143221,BISP 194,A00,222522,Staff,14,0,32,18
1683646144248,CAT 124,A01,202407,Staff,19,0,25,6
1683646145277,CAT 125,A00,202408,Marchisotto; Jennifer Anne,2,0,20,18
1683646146302,CAT 125R,A00,202409,Smith; Lauryn Alissa,0,11,20,20
1683646146302,CAT 125R,B00,202410,Morales; Celeste Georgianna,0,11,20,20
1683646146302,CAT 125R,C00,202411,Irwin; Matthew Joseph,0,12,20,20
1683646147325,CENG 15,A01,204712,Yang; Kesong,0,1,0,0
1683646148352,CENG 114,A00,202070,Jahed Motlagh; Zeinab,5,0,20,15
1683646149380,CGS 105,A00,185477,Wesling; Megan E.,24,0,40,16
1683646150403,CGS 106,A00,185494,Staff,11,0,22,11
1683646151429,CGS 108,A00,185495,Staff,14,0,20,6
1683646152455,CGS 114,A00,185496,Staff,13,0,18,5
1683646153481,CGS 119,A00,185501,Staff,15,0,20,5
1683646154504,CGS 120,A00,185511,Staff,12,0,20,8
1683646155529,CHEM 4,A01,184675,Bussey; Thomas J,97,0,100,3
1683646156553,CHEM 6A,A01,184677,Staff,33,0,60,27
1683646157577,CHEM 6B,A01,184679,Staff,63,0,100,37
1683646158601,CHEM 6C,A01,184681,Bussey; Thomas J,0,0,50,50
1683646158601,CHEM 6C,A02,184682,Bussey; Thomas J,32,0,50,18
1683646159625,CHEM 40A,A01,184684,Albizati; Kim F.,34,0,100,66
1683646160649,CHEM 40B,A01,184686,Albizati; Kim F.,0,22,100,100
1683646161673,CHEM 41B,A01,184690,Staff,51,0,100,49
1683646162697,COGS 3,A01,184715,Boyle; Mary E. T.,0,27,40,40
1683646163721,COGS 14B,A01,185172,Staff,0,14,38,38
1683646164746,COGS 18,A01,184736,Staff,14,0,80,66
1683646165769,COGS 100,A01,184932,Staff,0,7,73,73
1683646166797,COGS 101A,A01,184935,Staff,0,39,30,30
1683646167825,COGS 101B,A01,184944,Staff,0,2,30,30
1683646168851,COGS 101C,A01,184946,Staff,0,10,30,30
1683646169885,COGS 102A,A01,184951,Johnson; Christine M.,2,0,40,38
1683646170915,COGS 107B,A01,184953,Mooshagian; Eric Frederick,0,51,40,40
1683646171939,COGS 118B,A01,184959,Gupta; Anjum,0,49,40,40
1683646172969,COGS 153,A00,184961,Staff,0,16,30,30
1683646173997,COGS 177,A00,184962,Staff,0,21,30,30
1683646175022,COGS 187A,A01,184969,Boyle; Mary E. T.,0,19,40,40
1683646176050,COMM 10,A01,185174,Staff,0,5,25,25
1683646176050,COMM 10,A02,185189,Staff,0,2,25,25
1683646176050,COMM 10,A03,269821,Staff,0,1,0,0
1683646177074,COMM 100B,A01,185475,Staff,0,1,0,2
1683646177074,COMM 100B,A02,185476,Staff,12,0,25,13
1683646178101,COMM 100C,A01,185314,Staff,1,0,25,24
1683646178101,COMM 100C,A02,185327,Staff,18,0,25,7
1683646179129,COMM 110M,A00,185349,Staff,0,0,40,40
1683646180153,COMM 113T,A00,185352,Staff,25,0,40,15
1683646181176,COMM 114I,A00,185353,Staff,31,0,40,9
1683646182200,COMM 131,A00,185354,Staff,17,0,30,13
1683646183225,CSE 8A,A50,185358,Cao; Yingjun,0,46,10,10
1683646184251,CSE 8B,A01,185362,Staff,0,48,50,50
1683646185276,CSE 11,A01,185416,Cao; Yingjun,0,91,10,10
1683646186303,CSE 20,A01,185445,Briones; Jor-el Thomas Caparas,4,0,25,21
1683646187329,CSE 21,A01,185447,Staff,9,0,50,41
1683646188353,CSE 101,A01,185451,Staff,0,13,50,50
1683646188353,CSE 101,B01,185453,Jones; Miles E,0,13,50,50
1683646190401,CSE 141,A01,185458,Eldon; John,16,0,100,84
1683646191429,CSE 141L,A01,185461,Eldon; John,8,0,100,92
1683646192455,CSE 142,A01,185463,Staff,35,0,60,25
1683646192455,CSE 142,B01,201355,Staff,0,7,60,60
1683646193482,CSE 142L,A01,185470,Staff,35,0,60,25
1683646193482,CSE 142L,B01,201417,Staff,0,6,60,60
1683646194515,CSE 190,A00,201433,Staff,32,0,49,17
1683646195541,DOC 1,A01,259136,Strom; Megan C.,7,0,15,8
1683646195541,DOC 1,A02,259137,Strom; Megan C.,14,0,15,1
1683646195541,DOC 1,A03,259138,Strom; Megan C.,14,0,15,1
1683646195541,DOC 1,A04,259139,Strom; Megan C.,14,0,15,1
1683646196568,DOC 100D,A00,259140,Pass; Natalye Joann,14,0,25,11
1683646197593,DSGN 1,A01,184749,Rill; Bryan,0,26,30,30
1683646198621,DSGN 100,A01,185168,Staff,0,2,25,25
1683646199645,ECE 5,A01,185626,Morris; Karcher William,0,11,0,0
1683646200669,ECE 101,A01,185628,Staff,14,0,70,56
1683646201694,ECE 107,A01,185635,Baghdadchi; Saharnaz,0,0,20,20
1683646201694,ECE 107,A02,185638,Baghdadchi; Saharnaz,3,0,20,17
1683646202721,ECE 148,A01,185647,Silberman; Jack,0,0,16,16
1683646203745,ECON 1,A01,185537,Crane; Meredith Helen,54,0,70,16
1683646204769,ECON 3,A01,185549,Crane; Meredith Helen,29,0,70,41
1683646205802,ECON 4,A01,203354,Anderson; John Charles,0,5,10,10
1683646206825,ECON 100A,A01,185574,Staff,0,5,40,40
1683646207853,ECON 100B,A01,185576,Staff,0,12,50,50
1683646208877,ECON 100C,A01,185589,Newhouse; Herbert S,30,0,70,40
1683646209905,ECON 105,A00,185608,Vespa; Emanuel Ignacio,19,0,35,16
1683646210933,ECON 109,A01,185610,Shishkin; Denis,9,0,35,26
1683646211959,ECON 110A,A01,185612,Staff,9,0,40,31
1683646212986,ECON 120A,A01,185615,Staff,20,0,40,20
1683646214010,ECON 120C,A01,185617,Sun; Yixiao,0,20,70,70
1683646215039,ECON 144,A00,203346,Squires; Dale E,2,0,35,33
1683646216062,ECON 171,A01,203349,Newhouse; Herbert S,0,1,35,35
1683646217089,ECON 173A,A01,185621,Toda; Alexis Akira,21,0,35,14
1683646218113,EDS 25,A01,202413,Staff,0,1,0,0
1683646218113,EDS 25,A02,202414,Staff,0,1,0,0
1683646218113,EDS 25,A03,202415,Staff,0,0,0,0
1683646218113,EDS 25,A04,202416,Staff,0,1,0,0
1683646218113,EDS 25,A05,202439,Staff,0,0,0,0
1683646218113,EDS 25,A06,202440,Staff,0,0,0,0
1683646218113,EDS 25,B01,202631,Staff,0,0,0,0
1683646218113,EDS 25,B02,202632,Staff,0,0,0,0
1683646218113,EDS 25,B03,202639,Staff,0,0,0,0
1683646218113,EDS 25,B04,202640,Staff,0,0,0,0
1683646218113,EDS 25,B05,202643,Staff,0,0,0,0
1683646218113,EDS 25,B06,202644,Staff,0,0,0,0
1683646219139,EDS 38,A01,202659,Black; Alison Michelle,24,0,25,1
1683646220165,EDS 115,A00,202652,Staff,18,0,30,12
1683646221260,EDS 125,A00,202649,Staff,13,0,30,17
1683646222286,EDS 126,A01,203332,Staff,30,0,30,0
1683646223314,EDS 139,A00,202838,Staff,16,0,25,9
1683646224341,EDS 146,A01,202655,Staff,14,0,25,11
1683646225365,ENG 15,A00,185667,Staff,0,1,0,0
1683646225365,ENG 15,B00,185672,Staff,0,0,0,0
1683646225365,ENG 15,C00,185675,Staff,0,0,0,0
1683646225365,ENG 15,D00,185682,Staff,0,0,0,0
1683646225365,ENG 15,E00,185684,Staff,0,0,0,0
1683646226388,ETHN 103,A00,185710,Staff,0,8,35,35
1683646227414,ETHN 103A,A00,199228,Man; Simeon S,0,0,9,9
1683646228437,ETHN 109,A00,185711,Staff,16,0,35,19
1683646229461,ETHN 142,A00,185726,Staff,0,4,30,30
1683646230485,ETHN 163J,A00,199229,Man; Simeon S,5,0,8,3
1683646231508,ETHN 168,A00,185727,Staff,7,0,10,3
1683646232534,ETHN 182,A00,185728,Staff,0,0,35,35
1683646233557,ETHN 183,A00,185737,Staff,9,0,18,9
1683646234582,GLBH 111,A01,209361,Burgos; Jose L.,0,0,0,0
1683646236634,HIEU 104,A00,185792,Staff,14,0,20,6
1683646237660,HIEU 115,A00,185800,Staff,0,0,20,20
1683646238683,HIEU 128,A00,185801,Staff,0,9,20,20
1683646239710,HIEU 147,A00,185802,Staff,15,0,20,5
1683646240736,HIEU 154,A00,185823,Staff,11,0,20,9
1683646241761,HILA 102,A00,185826,Staff,14,0,20,6
1683646242785,HILD 2C,A01,185778,Staff,0,13,20,20
1683646243810,HILD 7B,A01,185780,Kwak; Nancy,0,16,32,32
1683646243810,HILD 7B,A02,185781,Kwak; Nancy,0,18,32,32
1683646244838,HILD 30,A01,185791,Staff,12,0,20,8
1683646245867,HISC 119,A00,185830,Golan; Tal,0,9,20,20
1683646246896,HITO 156GS,A00,185831,Patterson; Patrick H.,0,0,0,23
1683646247924,HIUS 103,A00,185832,Man; Simeon S,0,4,20,20
1683646248949,HIUS 117,A00,185836,Kwak; Nancy,2,0,20,18
1683646249975,HIUS 125,A00,185840,Man; Simeon S,0,1,23,23
1683646250999,HIUS 149,A00,185845,Staff,1,0,20,19
1683646252025,HUM 3,A01,185882,Zavodny; Tatiana Sophia,0,7,50,50
1683646252025,HUM 3,B01,185899,Caldwell; Michael Alan,0,18,50,50
1683646253048,HUM 3GS,A00,185900,Patterson; Patrick H.,0,0,0,23
1683646254074,HUM 4,A01,185938,Zroka; Amy Liane,30,0,50,20
1683646254074,HUM 4,B01,185956,Watkins; Eric,0,4,50,50
1683646254074,HUM 4,B02,202209,Watkins; Eric,0,4,50,50
1683646254074,HUM 4,B03,202210,Watkins; Eric,0,4,50,50
1683646255104,HUM 5,A01,185958,West; Geoffrey Scott,2,0,50,48
1683646255104,HUM 5,A02,202215,West; Geoffrey Scott,0,0,50,50
1683646256129,INTL 190,A00,185959,Gagnon; Jeffrey C,0,0,0,9
1683646256129,INTL 190,B00,185960,Lettieri; Michael Joseph,0,0,0,2
1683646257151,JAPN 180,A00,254509,Staff,5,0,30,25
1683646258179,LATI 10,A01,202853,Kennemore; Amy Michelle,4,0,35,31
1683646258179,LATI 10,A02,202854,Kennemore; Amy Michelle,2,0,35,33
1683646258179,LATI 10,A03,270054,Kennemore; Amy Michelle,30,0,30,0
1683646259205,LATI 180,A00,202855,Kennemore; Amy Michelle,11,0,20,9
1683646260233,LAWS 101,A00,201767,Golan; Tal,0,7,40,40
1683646261282,LIFR 1C,A00,185961,Staff,6,0,20,14
1683646262308,LIFR 1CX,A00,185962,Staff,7,0,20,13
1683646263332,LIFR 1D,A00,185963,Staff,7,0,20,13
1683646264361,LIFR 1DX,A00,185964,Staff,7,0,20,13
1683646265385,LIGN 101,A01,186039,Staff,43,0,50,7
1683646266414,LIGN 165,A00,186040,Staff,15,0,50,35
1683646267438,LTCS 108,A00,186041,Staff,5,0,10,5
1683646268469,LTCS 119,A00,186042,Staff,15,0,20,5
1683646269493,LTCS 130,A00,186043,Wesling; Megan E.,15,0,25,10
1683646271542,LTEA 138,A00,186119,Staff,14,0,40,26
1683646272566,LTEN 124,A00,186148,Staff,5,0,25,20
1683646273591,LTEN 178,A00,186149,Staff,7,0,15,8
1683646274616,LTEN 181,A00,186150,Blanco; John D,34,0,40,6
1683646275640,LTWL 120,A00,186160,Staff,20,0,25,5
1683646276667,LTWL 165,A00,186161,Staff,22,0,25,3
1683646277694,LTWR 100,A00,186162,Staff,0,5,15,15
1683646278722,LTWR 102,A00,186163,Doller; Ben,5,0,15,10
1683646279746,MAE 8,A01,186412,Staff,0,0,0,0
1683646280770,MAE 30B,A00,186445,Bahadori; Mohammad Yousef,82,0,100,18
1683646281795,MAE 40,A00,186592,Bewley; Thomas R,10,0,50,40
1683646282819,MAE 101B,A00,186593,Bahadori; Mohammad Yousef,80,0,100,20
1683646283843,MAE 105,A00,186594,Bandaru; Prabhakar,10,0,50,40
1683646284870,MAE 107,A00,186599,Pham; Hieu Tan,0,7,120,120
1683646285898,MAE 148,A01,186660,Silberman; Jack,3,0,16,13
1683646286926,MATH 10A,A01,188095,Staff,0,5,35,35
1683646287952,MATH 10B,A01,188097,Bowers; Adam R.,0,11,30,30
1683646287952,MATH 10B,A02,188099,Bowers; Adam R.,0,11,30,30
1683646287952,MATH 10B,B01,188104,Bowers; Adam R.,0,10,30,30
1683646287952,MATH 10B,B02,188106,Bowers; Adam R.,1,9,30,29
1683646288982,MATH 10C,A01,188111,Staff,0,18,30,30
1683646288982,MATH 10C,A02,188127,Staff,0,19,30,30
1683646288982,MATH 10C,A03,188131,Staff,0,19,30,30
1683646288982,MATH 10C,B01,188218,Staff,17,0,30,13
1683646288982,MATH 10C,B02,188244,Staff,13,0,30,17
1683646288982,MATH 10C,B03,188277,Staff,14,0,30,16
1683646290009,MATH 18,A01,188344,Bach; Quang Tran,18,0,30,12
1683646290009,MATH 18,A02,188345,Bach; Quang Tran,11,0,30,19
1683646290009,MATH 18,B01,188353,Bach; Quang Tran,11,0,30,19
1683646290009,MATH 18,B02,188354,Bach; Quang Tran,19,0,30,11
1683646291035,MATH 20A,A01,188374,Staff,11,0,35,24
1683646292062,MATH 20B,A01,188382,Ohm; Ko Woon,7,0,30,23
1683646292062,MATH 20B,A02,188383,Ohm; Ko Woon,22,0,30,8
1683646292062,MATH 20B,B01,188385,Ohm; Ko Woon,7,0,30,23
1683646292062,MATH 20B,B02,188392,Ohm; Ko Woon,22,0,30,8
1683646293091,MATH 20C,A01,188394,Harel; Guershon,11,0,30,19
1683646293091,MATH 20C,A02,188395,Harel; Guershon,13,0,30,17
1683646293091,MATH 20C,B01,188404,Harel; Guershon,5,0,30,25
1683646293091,MATH 20C,B02,188405,Harel; Guershon,18,0,30,12
1683646294122,MATH 20D,A01,188414,Hammock; Frances H,0,1,30,30
1683646294122,MATH 20D,A02,188415,Hammock; Frances H,0,1,30,30
1683646294122,MATH 20D,B01,188447,Hammock; Frances H,0,1,30,30
1683646294122,MATH 20D,B02,188486,Hammock; Frances H,4,0,30,26
1683646295147,MATH 20E,A01,188649,Staff,21,0,30,9
1683646295147,MATH 20E,A02,188650,Staff,21,0,30,9
1683646295147,MATH 20E,A03,188673,Staff,0,0,30,30
1683646296172,MATH 102,A01,188675,Staff,0,36,35,35
1683646297200,MATH 103B,A01,188681,Staff,3,0,35,32
1683646297200,MATH 103B,B01,188692,Staff,5,0,35,30
1683646298225,MATH 109,A01,188695,Salehi Golsefidy; Alireza,24,0,35,11
1683646298225,MATH 109,A02,188696,Salehi Golsefidy; Alireza,25,0,35,10
1683646299249,MATH 120A,A01,188698,Eggers; John Dietrich,7,0,35,28
1683646300274,MATH 142B,A01,188736,Ioana; Adrian,0,1,30,30
1683646300274,MATH 142B,A02,188741,Ioana; Adrian,0,1,30,30
1683646300274,MATH 142B,A03,188743,Ioana; Adrian,0,1,30,30
1683646301298,MATH 168A,A01,188790,Staff,0,10,35,35
1683646302323,MATH 170A,A01,188803,Nie; Jiawang,0,2,35,35
1683646302323,MATH 170A,A02,188811,Nie; Jiawang,0,0,35,35
1683646302323,MATH 170A,A03,188814,Nie; Jiawang,0,0,35,35
1683646302323,MATH 170A,A04,188815,Nie; Jiawang,10,0,35,25
1683646303347,MATH 193B,A01,188817,Staff,0,0,35,35
1683646303347,MATH 193B,A02,188818,Staff,5,0,35,30
1683646304376,MGT 4,A01,202857,Anderson; John Charles,61,0,80,19
1683646305404,MGT 12,A00,202858,Lindenberger; Wade Douglas,40,0,90,50
1683646306431,MGT 18,A00,202859,Staff,74,0,90,16
1683646307455,MGT 18GS,A00,202860,McKay; Michael J,13,0,28,15
1683646308482,MGT 45,A00,202861,Pecore; Joseph P.,12,0,90,78
1683646309509,MGT 100,A00,202863,Yavorsky; Daniel Ryan,28,0,90,62
1683646310536,MGT 103,A00,202864,Ehrich; Kristine R,0,17,90,90
1683646311565,MGT 112,A00,202865,Ehrich; Kristine R,15,0,90,75
1683646312602,MGT 121A,A00,202868,Staff,0,20,0,0
1683646313628,MGT 131B,A00,202869,Anderson; John Charles,59,0,90,31
1683646314652,MGT 136,A00,202871,Lindenberger; Wade Douglas,83,0,90,7
1683646315680,MGT 164,A00,202873,Staff,0,66,90,91
1683646316710,MGT 164GS,A00,202874,McKay; Mary A,13,0,28,15
1683646317734,MGT 180,A00,202875,Staff,0,50,90,91
1683646318762,MMW 11R,A01,205019,Herbst; Matthew,2,0,30,28
1683646318762,MMW 11R,A02,205026,Herbst; Matthew,29,0,30,1
1683646319791,MMW 15,A01,193512,Chang; Edmond Yi-Teh,0,8,28,28
1683646319791,MMW 15,A02,193513,Chang; Edmond Yi-Teh,0,5,28,28
1683646319791,MMW 15,A03,193514,Chang; Edmond Yi-Teh,0,5,28,28
1683646319791,MMW 15,A04,193515,Chang; Edmond Yi-Teh,0,5,28,28
1683646319791,MMW 15,A05,193516,Chang; Edmond Yi-Teh,0,5,28,28
1683646319791,MMW 15,A06,193517,Chang; Edmond Yi-Teh,0,6,28,28
1683646319791,MMW 15,B01,193519,Chang; Edmond Yi-Teh,0,5,28,28
1683646319791,MMW 15,B02,193520,Chang; Edmond Yi-Teh,0,5,28,28
1683646319791,MMW 15,B03,193521,Chang; Edmond Yi-Teh,0,5,28,28
1683646319791,MMW 15,B04,193522,Chang; Edmond Yi-Teh,0,5,28,28
1683646319791,MMW 15,B05,193523,Chang; Edmond Yi-Teh,0,5,28,28
1683646319791,MMW 15,B06,193524,Chang; Edmond Yi-Teh,0,5,28,28
1683646320815,MMW 122,A01,193526,Rahimi; Babak,0,16,28,28
1683646320815,MMW 122,A02,193527,Rahimi; Babak,0,15,28,28
1683646320815,MMW 122,A03,193528,Rahimi; Babak,0,0,0,0
1683646320815,MMW 122,A04,193529,Rahimi; Babak,0,0,0,0
1683646321839,MUS 1A,A01,186663,Staff,1,20,35,34
1683646322865,MUS 4,A01,186715,Staff,0,12,35,35
1683646323890,MUS 5R,A01,186796,Dubnov; Shlomo,0,17,35,35
1683646324971,MUS 6,A01,186798,Staff,0,5,25,25
1683646325998,MUS 7,A01,186830,Staff,11,0,35,24
1683646327022,MUS 8,A01,186930,Staff,0,26,35,35
1683646328052,MUS 15,A01,186932,Staff,0,16,35,35
1683646328052,MUS 15,B01,186934,Staff,0,17,35,35
1683646329078,MUS 80,A00,186935,Staff,0,0,20,20
1683646329078,MUS 80,B00,186936,Staff,24,0,25,1
1683646330102,NANO 11,A00,204702,Lipomi; Darren John,0,0,0,0
1683646331131,NANO 15,A01,204709,Yang; Kesong,0,1,0,0
1683646332159,NANO 114,A00,202069,Jahed Motlagh; Zeinab,3,0,10,7
1683646333184,PHIL 1,A00,186955,Grush; Rick Scott,31,0,40,9
1683646334209,PHIL 10,A01,186973,Grush; Rick Scott,27,0,35,8
1683646334209,PHIL 10,A02,186974,Grush; Rick Scott,33,0,35,2
1683646335238,PHIL 13,A01,186976,Staff,3,0,35,32
1683646335238,PHIL 13,A02,186977,Staff,16,0,35,19
1683646336261,PHIL 14,A01,186979,Staff,31,0,35,4
1683646336261,PHIL 14,A02,186986,Staff,32,0,35,3
1683646337287,PHIL 28,A01,186988,Staff,16,0,30,14
1683646337287,PHIL 28,A02,186989,Staff,1,0,30,29
1683646337287,PHIL 28,A03,186990,Staff,10,0,30,20
1683646337287,PHIL 28,A04,186991,Staff,26,0,30,4
1683646338316,PHIL 120,A00,186997,Staff,23,0,40,17
1683646339344,PHIL 137,A00,187003,Staff,7,0,40,33
1683646340369,PHIL 150,A00,187015,Staff,47,0,70,23
1683646341394,PHIL 167,A00,187021,Lamey; Andy M.,34,0,40,6
1683646342417,PHIL 174,A01,202226,Staff,17,0,20,3
1683646342417,PHIL 174,A02,202235,Staff,20,0,20,0
1683646343461,PHIL 191A,A00,258918,Staff,0,0,1,1
1683646344488,PHYS 1A,A00,187028,Staff,27,0,60,33
1683646345515,PHYS 1AL,001,187036,Staff,3,0,30,27
1683646345515,PHYS 1AL,002,187049,Staff,18,0,30,12
1683646346539,PHYS 1B,A00,187058,Staff,22,0,60,38
1683646347564,PHYS 1BL,001,187064,Staff,0,1,30,30
1683646347564,PHYS 1BL,002,187070,Staff,4,0,30,26
1683646348589,PHYS 1C,A00,187082,Staff,29,0,120,91
1683646349618,PHYS 1CL,001,187088,Staff,0,9,30,30
1683646349618,PHYS 1CL,002,187089,Staff,0,1,30,30
1683646349618,PHYS 1CL,009,262693,Staff,9,0,30,21
1683646350644,PHYS 2B,A01,187097,Staff,55,0,115,60
1683646351668,PHYS 2C,A01,187099,Staff,64,0,115,51
1683646352694,PHYS 2CL,A01,187101,Staff,5,0,28,23
1683646352694,PHYS 2CL,A02,187102,Staff,15,0,28,13
1683646353718,PHYS 2D,A01,187123,Shotwell; Brian,95,0,115,20
1683646354742,PHYS 4B,A01,187133,Grinstein; Benjamin,35,0,50,15
1683646355767,POLI 10,A00,188819,Staff,0,4,50,50
1683646356791,POLI 11,A00,188827,Staff,43,0,50,7
1683646357814,POLI 13R,A00,188828,Staff,0,1,20,20
1683646358844,POLI 27,A01,188830,Elgin; Samuel Zincke,0,2,70,70
1683646359868,POLI 30,A00,188832,Desposato; Scott,30,0,50,20
1683646360896,POLI 102F,A00,188834,Staff,0,0,40,40
1683646361923,POLI 104A,A00,188852,Staff,13,0,30,17
1683646362947,POLI 104I,A00,188853,Staff,0,7,20,20
1683646363971,POLI 110B,A00,188854,Wiens; David,7,0,20,13
1683646364999,POLI 112A,A00,188855,Wiens; David,4,0,30,26
1683646366028,POLI 117R,A00,188856,Forman; Fonna,0,12,20,20
1683646367053,POLI 118,A00,188857,Ingham; Sean,8,0,20,12
1683646368076,POLI 120G,A00,188858,Staff,8,0,30,22
1683646369105,POLI 131CR,A00,188863,Hoston; Germaine,21,0,50,29
1683646370129,POLI 133,A00,188864,Nellis; Gareth Hb,44,0,50,6
1683646371156,POLI 134D,A00,188865,Desposato; Scott,27,0,30,3
1683646372180,POLI 142A,A00,188871,Gartzke; Erik,21,0,50,29
1683646373208,POLI 142K,A00,188874,Staff,38,0,50,12
1683646374233,POLI 143,A00,188940,Gartzke; Erik,16,0,30,14
1683646375257,POLI 153,A00,188943,Staff,2,0,20,18
1683646376281,POLI 160AA,A00,188944,Staff,11,0,40,29
1683646377306,POLI 170A,A00,188945,Staff,11,0,30,19
1683646379353,PSYC 1,A00,188952,Staff,36,0,90,54
1683646380376,PSYC 2,B00,188953,Staff,19,0,35,16
1683646381405,PSYC 6,A00,188970,Staff,47,0,60,13
1683646382430,PSYC 7,A00,188973,Staff,35,0,45,10
1683646383467,PSYC 60,A01,188980,Rickard; Timothy C.,42,0,60,18
1683646384495,PSYC 70,A01,189001,Steiner; Eric Tomas,23,0,45,22
1683646385523,PSYC 100,A00,189005,Lacefield; Katharine I,0,99,120,120
1683646386547,PSYC 102,A00,189008,Staff,8,0,30,22
1683646387575,PSYC 106,B00,189026,Gorman; Michael R.,27,0,60,33
1683646388603,PSYC 114,B01,189033,Winkielman; Piotr,0,31,30,30
1683646389631,PSYC 131,A00,189036,Anagnostaras; Stephan,0,43,60,60
1683646390659,PSYC 136,A00,189041,Lowe; Angela Beth,0,7,25,25
1683646391688,PSYC 137,A00,189057,Winkielman; Piotr,0,37,25,25
1683646392712,PSYC 144,A00,189107,Wixted; John T,0,10,50,50
1683646394764,PSYC 162,A00,189142,Staff,0,9,85,85
1683646395791,PSYC 172,A00,189144,Gorman; Michael R.,0,6,30,30
1683646397849,PSYC 179,A00,189146,Lacefield; Katharine I,0,86,120,120
1683646398874,PSYC 181,A00,189147,Anagnostaras; Stephan,0,44,90,90
1683646399899,PSYC 190R,A00,189148,Barner; David A.,0,23,80,80
1683646400927,PSYC 191,A00,189275,Rickard; Timothy C.,0,10,25,25
1683646401950,PSYC 193,A00,189276,Chapman; Eddie Nathaniel,0,1,0,4
1683646402979,PSYC 193L,A01,189281,Lowe; Angela Beth,10,0,20,10
1683646402979,PSYC 193L,B01,189285,Staff,28,0,35,7
1683646404007,RELI 149,A00,187137,Rahimi; Babak,7,0,40,33
1683646405035,SE 9,A01,187315,Staff,0,2,18,18
1683646406059,SE 101B,A00,187409,Staff,24,0,30,6
1683646407088,SE 110B,A00,187444,Staff,10,0,40,30
1683646408113,SE 130B,A00,187449,Staff,31,0,40,9
1683646409140,SE 150A,A00,187516,Staff,9,0,20,11
1683646410165,SE 154,A00,187528,Staff,29,0,50,21
1683646411188,SIO 3,A01,258171,Staff,35,0,40,5
1683646412213,SIO 10,A00,187144,Cook; Geoffrey W,0,6,75,75
1683646413240,SIO 45,A00,187152,Cook; Geoffrey W,0,4,100,100
1683646414266,SIO 109R,A00,194486,Staff,0,4,20,20
1683646416318,SIO 187,A01,187233,Kacev; David,12,0,40,28
1683646417348,SOCI 1,A01,258656,Thorpe; Charles Robert,28,0,30,2
1683646417348,SOCI 1,A02,258658,Thorpe; Charles Robert,30,0,30,0
1683646417348,SOCI 1,A03,258661,Thorpe; Charles Robert,25,0,25,0
1683646417348,SOCI 1,A04,258666,Thorpe; Charles Robert,22,0,25,3
1683646417348,SOCI 1,A05,258897,Thorpe; Charles Robert,22,0,25,3
1683646417348,SOCI 1,A06,258898,Thorpe; Charles Robert,25,0,25,0
1683646418373,SOCI 30,A01,258903,Pardo Guerra; Juan Pablo,14,0,30,16
1683646419398,SOCI 102,A00,258904,Staff,9,0,25,16
1683646420421,SOCI 106,A00,258905,Staff,19,0,25,6
1683646421448,SOCI 111,A00,258907,Ribas Norris; Janet Vanesa,26,0,30,4
1683646422472,SOCI 121R,A00,258908,Pardo Guerra; Juan Pablo,8,0,30,22
1683646423497,SOCI 126,A01,203330,Staff,14,0,20,6
1683646424521,SOCI 131,A00,258909,Thorpe; Charles Robert,30,0,60,30
1683646425545,SOCI 135,A00,258910,Payne; Christine Anna,0,11,30,30
1683646426572,SOCI 157,A00,258911,Staff,12,0,30,18
1683646427604,SOCI 184,A00,258912,Staff,25,0,30,5
1683646428682,SOCI 188D,A00,258913,Staff,22,0,30,8
1683646429707,SYN 2,001,187529,Staff,9,0,16,7
1683646429707,SYN 2,002,201452,Staff,0,20,16,16
1683646429707,SYN 2,003,201469,Staff,2,0,16,14
1683646430737,SYN 100,A01,187531,Staff,0,9,20,20
1683646430737,SYN 100,B01,201491,Staff,0,10,20,20
1683646431773,TDAC 1,A00,189286,Walsh; Kim C.,3,0,20,17
1683646431773,TDAC 1,B00,189287,Harting; Carla Kelso,10,0,20,10
1683646432801,TDAC 101,A00,189300,Walsh; Kim C.,16,0,20,4
1683646432801,TDAC 101,B00,189301,Harting; Carla Kelso,18,0,20,2
1683646433825,TDAC 102,A00,189304,Basso; Beatrice,14,0,20,6
1683646434853,TDAC 108,A00,189305,Staff,18,0,20,2
1683646435884,TDDE 131,A00,189310,Staff,19,0,20,1
1683646435884,TDDE 131,B00,189314,Staff,19,0,20,1
1683646435884,TDDE 131,C00,189315,Staff,48,0,50,2
1683646435884,TDDE 131,D00,189316,Staff,14,0,15,1
1683646435884,TDDE 131,E00,204841,Staff,20,0,20,0
1683646436912,TDGE 10,A00,189289,Staff,27,0,50,23
1683646436912,TDGE 10,B00,189290,Havis; Allan,0,0,50,50
1683646437945,TDGE 11,A00,189291,Fulton; Julia,0,4,50,50
1683646437945,TDGE 11,B00,189292,Staff,20,0,25,5
1683646437945,TDGE 11,C00,260270,Staff,0,0,0,0
1683646438971,TDGE 25,A00,189294,Staff,2,0,20,18
1683646439996,TDGE 124,A00,189318,Fulton; Julia,0,8,50,50
1683646441020,TDGE 125,A00,189319,Staff,13,0,25,12
1683646441020,TDGE 125,B00,189320,Staff,23,0,25,2
1683646442051,TDGE 127,A00,189322,Havis; Allan,0,0,50,50
1683646443079,TDHT 101,A00,189323,Staff,18,0,25,7
1683646443079,TDHT 101,B00,189324,Staff,25,0,25,0
1683646444109,TDHT 102,A00,189325,Staff,49,0,50,1
1683646445134,TDMV 1,A00,189295,Arcidiacono; Kristin,20,0,30,10
1683646445134,TDMV 1,B00,189296,Caligagan; Maria T.,24,0,30,6
1683646446165,TDMV 2,A00,189297,Sammartano; Tonnie,27,0,30,3
1683646446165,TDMV 2,B00,189299,Arcidiacono; Kristin,23,0,30,7
1683646447194,TDMV 3,A00,204998,Rincon; Alicia,22,0,30,8
1683646448218,TDMV 120,A00,189458,Sammartano; Tonnie,28,0,30,2
1683646449246,TDMV 138,A00,189541,Jun; Grace Shin Hae,20,0,40,20
1683646450273,TDMV 142,A00,189717,Caligagan; Tony,25,0,30,5
1683646450273,TDMV 142,B00,189718,Caligagan; Maria T.,25,0,30,5
1683646451298,TMC 2,A01,187533,Staff,25,0,25,0
1683646451298,TMC 2,A02,187534,Staff,25,0,25,0
1683646452328,USP 1,A01,187536,Kwak; Nancy,0,16,25,25
1683646453357,USP 5,A01,187538,Staff,9,0,25,16
1683646454385,USP 101,A00,199253,Staff,0,4,0,0
1683646455413,USP 124,A00,187562,Boomhower; Matthew Charles,0,0,30,30
1683646456440,USP 138,A00,187582,Staff,20,0,25,5
1683646457467,USP 152,A01,187597,Staff,3,0,25,22
1683646458492,USP 153,A00,187598,Staff,19,0,25,6
1683646459519,USP 168,A00,187607,Kwak; Nancy,2,0,5,3
1683646460543,USP 173,A00,187619,Staff,4,0,25,21
1683646461570,USP 181,A00,187638,Staff,0,4,25,25
1683646462598,VIS 103,A00,187650,Cruz; Edwin Teddy,18,0,75,57
1683646463622,VIS 110D,A00,187669,Staff,13,0,22,9
1683646464646,VIS 127C,A00,187720,Shen; Kuiyi,67,0,146,79
1683646465672,VIS 149,A00,187731,Yoldas; Pinar,0,14,22,22
1683646466699,VIS 151,A01,188091,Staff,22,0,34,12
1683646466699,VIS 151,A02,188092,Staff,11,0,34,23
1683646467724,VIS 160B,A00,188093,Stalbaum; Brett,0,1,10,10
1683646469778,WCWP 10B,A00,201720,Staff,10,0,15,5
1683646469778,WCWP 10B,B00,201722,Staff,9,0,15,6
1683646470809,WCWP 100,A00,201725,Gagnon; Jeffrey C,0,0,2,2
1683646470809,WCWP 100,B00,201727,Staff,0,4,15,15
1683646473982,ANBI 133,A00,258401,Wilder; Linnea Lorene,34,0,40,6
1683646475012,ANBI 140,A00,258395,Hrvoj Mihic; Branka,18,0,25,7
1683646476040,ANSC 120,A00,258402,Bialecki; Jon Anthony,26,0,40,14
1683646477066,ANSC 144,A00,258400,Staff,12,0,40,28
1683646479116,ANSC 166,A00,258396,Parish; Steven Martin,156,0,175,19
1683646480140,ANSC 180,A00,193533,Staff,8,0,20,12
1683646481201,ANSC 188,A00,258397,Jassal; Aftab,34,0,40,6
1683646482229,ANTH 3,A01,258316,Staff,23,0,30,7
1683646483253,ANTH 5,A00,258394,Semendeferi; Ekaterini,16,0,20,4
1683646484277,ANTH 21,A01,258331,Staff,4,0,40,36
1683646485304,ANTH 103,A00,258398,Varma; Saiba,15,0,25,10
1683646486342,AWP 10,001,202034,Staff,0,0,0,0
1683646486342,AWP 10,002,202035,Staff,0,0,0,0
1683646486342,AWP 10,003,202036,Staff,0,0,0,0
1683646486342,AWP 10,004,202037,Staff,0,0,0,0
1683646486342,AWP 10,005,202038,Staff,0,0,0,0
1683646486342,AWP 10,006,202039,Staff,0,0,0,0
1683646486342,AWP 10,007,202040,Staff,0,0,0,0
1683646486342,AWP 10,008,202041,Staff,0,0,0,0
1683646486342,AWP 10,009,202042,Staff,0,0,0,0
1683646486342,AWP 10,010,202043,Staff,0,0,0,0
1683646486342,AWP 10,011,202044,Staff,0,0,0,0
1683646486342,AWP 10,012,202045,Staff,0,0,0,0
1683646486342,AWP 10,013,202046,Staff,0,0,0,0
1683646486342,AWP 10,014,202047,Staff,0,0,0,0
1683646486342,AWP 10,015,202048,Staff,0,0,0,0
1683646486342,AWP 10,016,202049,Staff,0,0,0,0
1683646486342,AWP 10,017,202050,Staff,0,0,0,0
1683646486342,AWP 10,018,202051,Staff,0,0,0,0
1683646486342,AWP 10,019,202052,Staff,0,0,0,0
1683646486342,AWP 10,020,202053,Staff,0,0,0,0
1683646486342,AWP 10,021,202054,Staff,0,0,0,0
1683646486342,AWP 10,022,202055,Staff,0,0,0,0
1683646486342,AWP 10,023,202056,Staff,0,0,0,0
1683646486342,AWP 10,024,202057,Staff,0,0,0,0
1683646486342,AWP 10,025,202058,Staff,0,0,0,0
1683646486342,AWP 10,026,202059,Staff,0,0,0,0
1683646487367,AWP 102,001,202032,Staff,0,0,0,0
1683646487367,AWP 102,002,202033,Staff,0,0,0,0
1683646488393,BENG 100,A01,254234,Taylor Amos; Alyssa C,31,0,40,9
1683646489420,BENG 196,001,270013,Engler; Adam J.,9999,0,9999,0
1683646490453,BICD 100R,A01,202018,Smith; Laurie,0,7,32,32
1683646490453,BICD 100R,A02,202019,Smith; Laurie,0,3,32,32
1683646490453,BICD 100R,A03,202020,Smith; Laurie,0,1,32,32
1683646490453,BICD 100R,A04,202021,Smith; Laurie,6,0,32,26
1683646490453,BICD 100R,A05,202022,Smith; Laurie,11,0,32,21
1683646491479,BICD 136,A01,193242,Gustafson-Brown; Cindy,0,2,32,32
1683646491479,BICD 136,A02,193244,Gustafson-Brown; Cindy,13,0,32,19
1683646492512,BIEB 102,A01,193249,Butler; Shannon Rhey,0,2,32,32
1683646492512,BIEB 102,A02,193251,Butler; Shannon Rhey,0,0,32,32
1683646492512,BIEB 102,A03,193253,Butler; Shannon Rhey,0,0,32,32
1683646492512,BIEB 102,A04,193255,Butler; Shannon Rhey,14,0,32,18
1683646492512,BIEB 102,A05,193265,Butler; Shannon Rhey,26,0,32,6
1683646492512,BIEB 102,A06,193269,Butler; Shannon Rhey,14,0,32,18
1683646494567,BIEB 150,A01,193274,Staff,0,0,32,32
1683646494567,BIEB 150,A02,193285,Staff,24,0,32,8
1683646495593,BIEB 194,A00,193286,Kurle; Carolyn M.,20,0,32,12
1683646496618,BILD 1,A01,192291,Staff,15,0,32,17
1683646496618,BILD 1,A02,192292,Staff,30,0,32,2
1683646496618,BILD 1,B01,192520,Reuther; Keefe,0,1,0,0
1683646496618,BILD 1,B02,192532,Reuther; Keefe,0,1,0,0
1683646497644,BILD 3,A01,192556,Butler; Shannon Rhey,0,0,32,32
1683646497644,BILD 3,A02,192581,Butler; Shannon Rhey,1,0,32,31
1683646497644,BILD 3,A03,192611,Butler; Shannon Rhey,21,0,32,11
1683646497644,BILD 3,A04,192612,Butler; Shannon Rhey,24,0,32,8
1683646497644,BILD 3,A05,192613,Butler; Shannon Rhey,26,0,32,6
1683646497644,BILD 3,A06,192679,Butler; Shannon Rhey,27,0,32,5
1683646497644,BILD 3,A07,192682,Butler; Shannon Rhey,20,0,32,12
1683646498670,BILD 4,A01,192836,Reuther; Keefe,0,0,24,24
1683646498670,BILD 4,A02,193044,Reuther; Keefe,4,0,24,20
1683646499696,BILD 10,A01,193142,Gustafson-Brown; Cindy,29,0,32,3
1683646499696,BILD 10,A02,193149,Gustafson-Brown; Cindy,31,0,32,1
1683646500727,BIMM 100,A01,193301,Staff,0,6,32,32
1683646500727,BIMM 100,A02,193312,Staff,0,7,32,32
1683646500727,BIMM 100,A03,193323,Staff,0,9,32,32
1683646501755,BIMM 101,A01,193329,McDonnell; Lisa Marie,0,4,24,24
1683646501755,BIMM 101,A02,193339,McDonnell; Lisa Marie,0,3,24,24
1683646501755,BIMM 101,B01,193354,McDonnell; Lisa Marie,0,4,24,24
1683646501755,BIMM 101,B02,193357,McDonnell; Lisa Marie,0,3,24,24
1683646502794,BIMM 110,A01,193377,Tat; John,0,11,32,32
1683646502794,BIMM 110,A02,193378,Tat; John,0,10,32,32
1683646503821,BIMM 120,A01,206116,Staff,0,0,32,32
1683646503821,BIMM 120,A02,206117,Staff,6,0,32,26
1683646503821,BIMM 120,A03,206121,Staff,21,0,32,11
1683646504847,BIPN 100,A01,193393,Park; Ji Young,0,14,32,32
1683646504847,BIPN 100,A02,193402,Park; Ji Young,0,14,32,32
1683646504847,BIPN 100,A03,193413,Park; Ji Young,0,14,32,32
1683646504847,BIPN 100,A04,193414,Park; Ji Young,0,13,32,32
1683646505879,BIPN 102,A01,193429,Staff,0,0,32,32
1683646505879,BIPN 102,A02,193438,Staff,18,0,32,14
1683646506908,BIPN 106,A01,193450,Reyes Gonzalez; Catalina,0,2,40,40
1683646507934,BIPN 134,A01,193465,Cooke; James Edward,0,0,32,32
1683646507934,BIPN 134,A02,193474,Cooke; James Edward,25,0,32,7
1683646507934,BIPN 134,A03,193485,Cooke; James Edward,29,0,32,3
1683646507934,BIPN 134,A04,193486,Cooke; James Edward,20,0,32,12
1683646507934,BIPN 134,A05,193491,Cooke; James Edward,31,0,32,1
1683646507934,BIPN 134,A06,193501,Cooke; James Edward,30,0,32,2
1683646507934,BIPN 134,A07,193510,Cooke; James Edward,29,0,32,3
1683646509982,BISP 194,A00,222522,Staff,14,0,32,18
1683646511007,CAT 124,A01,202407,Staff,19,0,25,6
1683646512030,CAT 125,A00,202408,Marchisotto; Jennifer Anne,2,0,20,18
1683646513062,CAT 125R,A00,202409,Smith; Lauryn Alissa,0,11,20,20
1683646513062,CAT 125R,B00,202410,Morales; Celeste Georgianna,0,11,20,20
1683646513062,CAT 125R,C00,202411,Irwin; Matthew Joseph,0,12,20,20
1683646514087,CENG 15,A01,204712,Yang; Kesong,0,1,0,0
1683646515112,CENG 114,A00,202070,Jahed Motlagh; Zeinab,5,0,20,15
1683646516135,CGS 105,A00,185477,Wesling; Megan E.,24,0,40,16
1683646517160,CGS 106,A00,185494,Staff,11,0,22,11
1683646518197,CGS 108,A00,185495,Staff,14,0,20,6
1683646519226,CGS 114,A00,185496,Staff,13,0,18,5
1683646520251,CGS 119,A00,185501,Staff,15,0,20,5
1683646521280,CGS 120,A00,185511,Staff,12,0,20,8
1683646522306,CHEM 4,A01,184675,Bussey; Thomas J,97,0,100,3
1683646523334,CHEM 6A,A01,184677,Staff,33,0,60,27
1683646524358,CHEM 6B,A01,184679,Staff,63,0,100,37
1683646525382,CHEM 6C,A01,184681,Bussey; Thomas J,0,0,50,50
1683646525382,CHEM 6C,A02,184682,Bussey; Thomas J,32,0,50,18
1683646526410,CHEM 40A,A01,184684,Albizati; Kim F.,34,0,100,66
1683646527434,CHEM 40B,A01,184686,Albizati; Kim F.,0,22,100,100
1683646528457,CHEM 41B,A01,184690,Staff,51,0,100,49
1683646529482,COGS 3,A01,184715,Boyle; Mary E. T.,0,27,40,40
1683646530505,COGS 14B,A01,185172,Staff,0,14,38,38
1683646539717,COGS 18,A01,184736,Staff,14,0,80,66
1683646540818,COGS 100,A01,184932,Staff,0,7,73,73
1683646541843,COGS 101A,A01,184935,Staff,0,39,30,30
1683646542870,COGS 101B,A01,184944,Staff,0,2,30,30
1683646543895,COGS 101C,A01,184946,Staff,0,10,30,30
1683646544922,COGS 102A,A01,184951,Johnson; Christine M.,2,0,40,38
1683646545948,COGS 107B,A01,184953,Mooshagian; Eric Frederick,0,51,40,40
1683646546975,COGS 118B,A01,184959,Gupta; Anjum,0,49,40,40
1683646548000,COGS 153,A00,184961,Staff,0,16,30,30
1683646549026,COGS 177,A00,184962,Staff,0,21,30,30
1683646550053,COGS 187A,A01,184969,Boyle; Mary E. T.,0,19,40,40
1683646551080,COMM 10,A01,185174,Staff,0,5,25,25
1683646551080,COMM 10,A02,185189,Staff,0,2,25,25
1683646551080,COMM 10,A03,269821,Staff,0,1,0,0
1683646552104,COMM 100B,A01,185475,Staff,0,1,0,2
1683646552104,COMM 100B,A02,185476,Staff,12,0,25,13
1683646553132,COMM 100C,A01,185314,Staff,1,0,25,24
1683646553132,COMM 100C,A02,185327,Staff,18,0,25,7
1683646554158,COMM 110M,A00,185349,Staff,0,0,40,40
1683646555181,COMM 113T,A00,185352,Staff,25,0,40,15
1683646556205,COMM 114I,A00,185353,Staff,31,0,40,9
1683646557233,COMM 131,A00,185354,Staff,17,0,30,13
1683646558262,CSE 8A,A50,185358,Cao; Yingjun,0,46,10,10
1683646559289,CSE 8B,A01,185362,Staff,0,48,50,50
1683646560314,CSE 11,A01,185416,Cao; Yingjun,0,91,10,10
1683646561343,CSE 20,A01,185445,Briones; Jor-el Thomas Caparas,4,0,25,21
1683646562368,CSE 21,A01,185447,Staff,9,0,50,41
1683646563395,CSE 101,A01,185451,Staff,0,13,50,50
1683646563395,CSE 101,B01,185453,Jones; Miles E,0,13,50,50
1683646565449,CSE 141,A01,185458,Eldon; John,16,0,100,84
1683646566476,CSE 141L,A01,185461,Eldon; John,8,0,100,92
1683646567502,CSE 142,A01,185463,Staff,35,0,60,25
1683646567502,CSE 142,B01,201355,Staff,0,7,60,60
1683646568525,CSE 142L,A01,185470,Staff,35,0,60,25
1683646568525,CSE 142L,B01,201417,Staff,0,6,60,60
1683646569552,CSE 190,A00,201433,Staff,32,0,49,17
1683646570577,DOC 1,A01,259136,Strom; Megan C.,7,0,15,8
1683646570577,DOC 1,A02,259137,Strom; Megan C.,14,0,15,1
1683646570577,DOC 1,A03,259138,Strom; Megan C.,14,0,15,1
1683646570577,DOC 1,A04,259139,Strom; Megan C.,14,0,15,1
1683646571602,DOC 100D,A00,259140,Pass; Natalye Joann,14,0,25,11
1683646572628,DSGN 1,A01,184749,Rill; Bryan,0,26,30,30
1683646573652,DSGN 100,A01,185168,Staff,0,2,25,25
1683646574682,ECE 5,A01,185626,Morris; Karcher William,0,11,0,0
1683646575707,ECE 101,A01,185628,Staff,14,0,70,56
1683646576734,ECE 107,A01,185635,Baghdadchi; Saharnaz,0,0,20,20
1683646576734,ECE 107,A02,185638,Baghdadchi; Saharnaz,3,0,20,17
1683646577758,ECE 148,A01,185647,Silberman; Jack,0,0,16,16
1683646578786,ECON 1,A01,185537,Crane; Meredith Helen,54,0,70,16
1683646579809,ECON 3,A01,185549,Crane; Meredith Helen,29,0,70,41
1683646580835,ECON 4,A01,203354,Anderson; John Charles,0,5,10,10
1683646581860,ECON 100A,A01,185574,Staff,0,5,40,40
1683646582889,ECON 100B,A01,185576,Staff,0,12,50,50
1683646583919,ECON 100C,A01,185589,Newhouse; Herbert S,30,0,70,40
1683646584948,ECON 105,A00,185608,Vespa; Emanuel Ignacio,19,0,35,16
1683646585973,ECON 109,A01,185610,Shishkin; Denis,9,0,35,26
1683646586998,ECON 110A,A01,185612,Staff,9,0,40,31
1683646588021,ECON 120A,A01,185615,Staff,20,0,40,20
1683646589046,ECON 120C,A01,185617,Sun; Yixiao,0,20,70,70
1683646590070,ECON 144,A00,203346,Squires; Dale E,2,0,35,33
1683646591098,ECON 171,A01,203349,Newhouse; Herbert S,0,1,35,35
1683646592128,ECON 173A,A01,185621,Toda; Alexis Akira,21,0,35,14
1683646593153,EDS 25,A01,202413,Staff,0,1,0,0
1683646593153,EDS 25,A02,202414,Staff,0,1,0,0
1683646593153,EDS 25,A03,202415,Staff,0,0,0,0
1683646593153,EDS 25,A04,202416,Staff,0,1,0,0
1683646593153,EDS 25,A05,202439,Staff,0,0,0,0
1683646593153,EDS 25,A06,202440,Staff,0,0,0,0
1683646593153,EDS 25,B01,202631,Staff,0,0,0,0
1683646593153,EDS 25,B02,202632,Staff,0,0,0,0
1683646593153,EDS 25,B03,202639,Staff,0,0,0,0
1683646593153,EDS 25,B04,202640,Staff,0,0,0,0
1683646593153,EDS 25,B05,202643,Staff,0,0,0,0
1683646593153,EDS 25,B06,202644,Staff,0,0,0,0
1683646594176,EDS 38,A01,202659,Black; Alison Michelle,24,0,25,1
1683646595200,EDS 115,A00,202652,Staff,18,0,30,12
1683646596227,EDS 125,A00,202649,Staff,13,0,30,17
1683646597251,EDS 126,A01,203332,Staff,30,0,30,0
1683646598288,EDS 139,A00,202838,Staff,16,0,25,9
1683646599313,EDS 146,A01,202655,Staff,14,0,25,11
1683646600338,ENG 15,A00,185667,Staff,0,1,0,0
1683646600338,ENG 15,B00,185672,Staff,0,0,0,0
1683646600338,ENG 15,C00,185675,Staff,0,0,0,0
1683646600338,ENG 15,D00,185682,Staff,0,0,0,0
1683646600338,ENG 15,E00,185684,Staff,0,0,0,0
1683646601365,ETHN 103,A00,185710,Staff,0,8,35,35
1683646602392,ETHN 103A,A00,199228,Man; Simeon S,0,0,9,9
1683646603418,ETHN 109,A00,185711,Staff,16,0,35,19
1683646604442,ETHN 142,A00,185726,Staff,0,4,30,30
1683646605465,ETHN 163J,A00,199229,Man; Simeon S,5,0,8,3
1683646606488,ETHN 168,A00,185727,Staff,7,0,10,3
1683646607516,ETHN 182,A00,185728,Staff,0,0,35,35
1683646608540,ETHN 183,A00,185737,Staff,9,0,18,9
1683646609565,GLBH 111,A01,209361,Burgos; Jose L.,0,0,0,0
1683646611614,HIEU 104,A00,185792,Staff,14,0,20,6
1683646612638,HIEU 115,A00,185800,Staff,0,0,20,20
1683646613662,HIEU 128,A00,185801,Staff,0,9,20,20
1683646614687,HIEU 147,A00,185802,Staff,15,0,20,5
1683646615712,HIEU 154,A00,185823,Staff,11,0,20,9
1683646616737,HILA 102,A00,185826,Staff,14,0,20,6
1683646617764,HILD 2C,A01,185778,Staff,0,13,20,20
1683646618791,HILD 7B,A01,185780,Kwak; Nancy,0,16,32,32
1683646618791,HILD 7B,A02,185781,Kwak; Nancy,0,18,32,32
1683646619817,HILD 30,A01,185791,Staff,12,0,20,8
1683646620845,HISC 119,A00,185830,Golan; Tal,0,9,20,20
1683646621874,HITO 156GS,A00,185831,Patterson; Patrick H.,0,0,0,23
1683646622899,HIUS 103,A00,185832,Man; Simeon S,0,4,20,20
1683646623926,HIUS 117,A00,185836,Kwak; Nancy,2,0,20,18
1683646624951,HIUS 125,A00,185840,Man; Simeon S,0,1,23,23
1683646625975,HIUS 149,A00,185845,Staff,1,0,20,19
1683646627006,HUM 3,A01,185882,Zavodny; Tatiana Sophia,0,7,50,50
1683646627006,HUM 3,B01,185899,Caldwell; Michael Alan,0,18,50,50
1683646628032,HUM 3GS,A00,185900,Patterson; Patrick H.,0,0,0,23
1683646629058,HUM 4,A01,185938,Zroka; Amy Liane,30,0,50,20
1683646629058,HUM 4,B01,185956,Watkins; Eric,0,4,50,50
1683646629058,HUM 4,B02,202209,Watkins; Eric,0,4,50,50
1683646629058,HUM 4,B03,202210,Watkins; Eric,0,4,50,50
1683646630087,HUM 5,A01,185958,West; Geoffrey Scott,2,0,50,48
1683646630087,HUM 5,A02,202215,West; Geoffrey Scott,0,0,50,50
1683646631115,INTL 190,A00,185959,Gagnon; Jeffrey C,0,0,0,9
1683646631115,INTL 190,B00,185960,Lettieri; Michael Joseph,0,0,0,2
1683646632139,JAPN 180,A00,254509,Staff,5,0,30,25
1683646633164,LATI 10,A01,202853,Kennemore; Amy Michelle,4,0,35,31
1683646633164,LATI 10,A02,202854,Kennemore; Amy Michelle,2,0,35,33
1683646633164,LATI 10,A03,270054,Kennemore; Amy Michelle,30,0,30,0
1683646634192,LATI 180,A00,202855,Kennemore; Amy Michelle,11,0,20,9
1683646635219,LAWS 101,A00,201767,Golan; Tal,0,7,40,40
1683646636246,LIFR 1C,A00,185961,Staff,6,0,20,14
1683646637272,LIFR 1CX,A00,185962,Staff,7,0,20,13
1683646638301,LIFR 1D,A00,185963,Staff,7,0,20,13
1683646639328,LIFR 1DX,A00,185964,Staff,7,0,20,13
1683646640354,LIGN 101,A01,186039,Staff,43,0,50,7
1683646641378,LIGN 165,A00,186040,Staff,15,0,50,35
1683646642406,LTCS 108,A00,186041,Staff,5,0,10,5
1683646643434,LTCS 119,A00,186042,Staff,15,0,20,5
1683646644515,LTCS 130,A00,186043,Wesling; Megan E.,15,0,25,10
1683646646564,LTEA 138,A00,186119,Staff,14,0,40,26
1683646647587,LTEN 124,A00,186148,Staff,5,0,25,20
1683646648612,LTEN 178,A00,186149,Staff,7,0,15,8
1683646649637,LTEN 181,A00,186150,Blanco; John D,34,0,40,6
1683646650661,LTWL 120,A00,186160,Staff,20,0,25,5
1683646651685,LTWL 165,A00,186161,Staff,22,0,25,3
1683646652712,LTWR 100,A00,186162,Staff,0,5,15,15
1683646653741,LTWR 102,A00,186163,Doller; Ben,5,0,15,10
1683646654766,MAE 8,A01,186412,Staff,0,0,0,0
1683646655791,MAE 30B,A00,186445,Bahadori; Mohammad Yousef,82,0,100,18
1683646656818,MAE 40,A00,186592,Bewley; Thomas R,10,0,50,40
1683646657843,MAE 101B,A00,186593,Bahadori; Mohammad Yousef,80,0,100,20
1683646658871,MAE 105,A00,186594,Bandaru; Prabhakar,10,0,50,40
1683646659899,MAE 107,A00,186599,Pham; Hieu Tan,0,7,120,120
1683646660927,MAE 148,A01,186660,Silberman; Jack,3,0,16,13
1683646661954,MATH 10A,A01,188095,Staff,0,5,35,35
1683646662984,MATH 10B,A01,188097,Bowers; Adam R.,0,11,30,30
1683646662984,MATH 10B,A02,188099,Bowers; Adam R.,0,11,30,30
1683646662984,MATH 10B,B01,188104,Bowers; Adam R.,0,10,30,30
1683646662984,MATH 10B,B02,188106,Bowers; Adam R.,1,9,30,29
1683646664013,MATH 10C,A01,188111,Staff,0,18,30,30
1683646664013,MATH 10C,A02,188127,Staff,0,19,30,30
1683646664013,MATH 10C,A03,188131,Staff,0,19,30,30
1683646664013,MATH 10C,B01,188218,Staff,17,0,30,13
1683646664013,MATH 10C,B02,188244,Staff,13,0,30,17
1683646664013,MATH 10C,B03,188277,Staff,14,0,30,16
1683646665045,MATH 18,A01,188344,Bach; Quang Tran,18,0,30,12
1683646665045,MATH 18,A02,188345,Bach; Quang Tran,11,0,30,19
1683646665045,MATH 18,B01,188353,Bach; Quang Tran,11,0,30,19
1683646665045,MATH 18,B02,188354,Bach; Quang Tran,19,0,30,11
1683646666071,MATH 20A,A01,188374,Staff,11,0,35,24
1683646667101,MATH 20B,A01,188382,Ohm; Ko Woon,7,0,30,23
1683646667101,MATH 20B,A02,188383,Ohm; Ko Woon,22,0,30,8
1683646667101,MATH 20B,B01,188385,Ohm; Ko Woon,7,0,30,23
1683646667101,MATH 20B,B02,188392,Ohm; Ko Woon,22,0,30,8
1683646668126,MATH 20C,A01,188394,Harel; Guershon,11,0,30,19
1683646668126,MATH 20C,A02,188395,Harel; Guershon,13,0,30,17
1683646668126,MATH 20C,B01,188404,Harel; Guershon,5,0,30,25
1683646668126,MATH 20C,B02,188405,Harel; Guershon,18,0,30,12
1683646669152,MATH 20D,A01,188414,Hammock; Frances H,0,1,30,30
1683646669152,MATH 20D,A02,188415,Hammock; Frances H,0,1,30,30
1683646669152,MATH 20D,B01,188447,Hammock; Frances H,0,1,30,30
1683646669152,MATH 20D,B02,188486,Hammock; Frances H,4,0,30,26
1683646670179,MATH 20E,A01,188649,Staff,21,0,30,9
1683646670179,MATH 20E,A02,188650,Staff,21,0,30,9
1683646670179,MATH 20E,A03,188673,Staff,0,0,30,30
1683646671203,MATH 102,A01,188675,Staff,0,36,35,35
1683646672228,MATH 103B,A01,188681,Staff,3,0,35,32
1683646672228,MATH 103B,B01,188692,Staff,5,0,35,30
1683646673257,MATH 109,A01,188695,Salehi Golsefidy; Alireza,24,0,35,11
1683646673257,MATH 109,A02,188696,Salehi Golsefidy; Alireza,25,0,35,10
1683646674281,MATH 120A,A01,188698,Eggers; John Dietrich,7,0,35,28
1683646675307,MATH 142B,A01,188736,Ioana; Adrian,0,1,30,30
1683646675307,MATH 142B,A02,188741,Ioana; Adrian,0,1,30,30
1683646675307,MATH 142B,A03,188743,Ioana; Adrian,0,1,30,30
1683646676332,MATH 168A,A01,188790,Staff,0,10,35,35
1683646677357,MATH 170A,A01,188803,Nie; Jiawang,0,2,35,35
1683646677357,MATH 170A,A02,188811,Nie; Jiawang,0,0,35,35
1683646677357,MATH 170A,A03,188814,Nie; Jiawang,0,0,35,35
1683646677357,MATH 170A,A04,188815,Nie; Jiawang,10,0,35,25
1683646678381,MATH 193B,A01,188817,Staff,0,0,35,35
1683646678381,MATH 193B,A02,188818,Staff,5,0,35,30
1683646679405,MGT 4,A01,202857,Anderson; John Charles,61,0,80,19
1683646680430,MGT 12,A00,202858,Lindenberger; Wade Douglas,40,0,90,50
1683646681456,MGT 18,A00,202859,Staff,74,0,90,16
1683646682480,MGT 18GS,A00,202860,McKay; Michael J,13,0,28,15
1683646683509,MGT 45,A00,202861,Pecore; Joseph P.,12,0,90,78
1683646684537,MGT 100,A00,202863,Yavorsky; Daniel Ryan,28,0,90,62
1683646685562,MGT 103,A00,202864,Ehrich; Kristine R,0,17,90,90
1683646686587,MGT 112,A00,202865,Ehrich; Kristine R,15,0,90,75
1683646687611,MGT 121A,A00,202868,Staff,0,20,0,0
1683646688636,MGT 131B,A00,202869,Anderson; John Charles,59,0,90,31
1683646689660,MGT 136,A00,202871,Lindenberger; Wade Douglas,83,0,90,7
1683646690684,MGT 164,A00,202873,Staff,0,66,90,91
1683646691714,MGT 164GS,A00,202874,McKay; Mary A,13,0,28,15
1683646692739,MGT 180,A00,202875,Staff,0,50,90,91
1683646693766,MMW 11R,A01,205019,Herbst; Matthew,2,0,30,28
1683646693766,MMW 11R,A02,205026,Herbst; Matthew,29,0,30,1
1683646694801,MMW 15,A01,193512,Chang; Edmond Yi-Teh,0,8,28,28
1683646694801,MMW 15,A02,193513,Chang; Edmond Yi-Teh,0,5,28,28
1683646694801,MMW 15,A03,193514,Chang; Edmond Yi-Teh,0,5,28,28
1683646694801,MMW 15,A04,193515,Chang; Edmond Yi-Teh,0,5,28,28
1683646694801,MMW 15,A05,193516,Chang; Edmond Yi-Teh,0,5,28,28
1683646694801,MMW 15,A06,193517,Chang; Edmond Yi-Teh,0,6,28,28
1683646694801,MMW 15,B01,193519,Chang; Edmond Yi-Teh,0,5,28,28
1683646694801,MMW 15,B02,193520,Chang; Edmond Yi-Teh,0,5,28,28
1683646694801,MMW 15,B03,193521,Chang; Edmond Yi-Teh,0,5,28,28
1683646694801,MMW 15,B04,193522,Chang; Edmond Yi-Teh,0,5,28,28
1683646694801,MMW 15,B05,193523,Chang; Edmond Yi-Teh,0,5,28,28
1683646694801,MMW 15,B06,193524,Chang; Edmond Yi-Teh,0,5,28,28
1683646695825,MMW 122,A01,193526,Rahimi; Babak,0,16,28,28
1683646695825,MMW 122,A02,193527,Rahimi; Babak,0,15,28,28
1683646695825,MMW 122,A03,193528,Rahimi; Babak,0,0,0,0
1683646695825,MMW 122,A04,193529,Rahimi; Babak,0,0,0,0
1683646696854,MUS 1A,A01,186663,Staff,1,20,35,34
1683646697884,MUS 4,A01,186715,Staff,0,12,35,35
1683646698911,MUS 5R,A01,186796,Dubnov; Shlomo,0,17,35,35
1683646699935,MUS 6,A01,186798,Staff,0,5,25,25
1683646700961,MUS 7,A01,186830,Staff,11,0,35,24
1683646701990,MUS 8,A01,186930,Staff,0,26,35,35
1683646703014,MUS 15,A01,186932,Staff,0,16,35,35
1683646703014,MUS 15,B01,186934,Staff,0,17,35,35
1683646704041,MUS 80,A00,186935,Staff,0,0,20,20
1683646704041,MUS 80,B00,186936,Staff,24,0,25,1
1683646705070,NANO 11,A00,204702,Lipomi; Darren John,0,0,0,0
1683646706094,NANO 15,A01,204709,Yang; Kesong,0,1,0,0
1683646707123,NANO 114,A00,202069,Jahed Motlagh; Zeinab,3,0,10,7
1683646708146,PHIL 1,A00,186955,Grush; Rick Scott,31,0,40,9
1683646709170,PHIL 10,A01,186973,Grush; Rick Scott,27,0,35,8
1683646709170,PHIL 10,A02,186974,Grush; Rick Scott,33,0,35,2
1683646710199,PHIL 13,A01,186976,Staff,3,0,35,32
1683646710199,PHIL 13,A02,186977,Staff,16,0,35,19
1683646711224,PHIL 14,A01,186979,Staff,31,0,35,4
1683646711224,PHIL 14,A02,186986,Staff,32,0,35,3
1683646712248,PHIL 28,A01,186988,Staff,16,0,30,14
1683646712248,PHIL 28,A02,186989,Staff,1,0,30,29
1683646712248,PHIL 28,A03,186990,Staff,10,0,30,20
1683646712248,PHIL 28,A04,186991,Staff,26,0,30,4
1683646713273,PHIL 120,A00,186997,Staff,23,0,40,17
1683646714296,PHIL 137,A00,187003,Staff,7,0,40,33
1683646715323,PHIL 150,A00,187015,Staff,47,0,70,23
1683646716348,PHIL 167,A00,187021,Lamey; Andy M.,34,0,40,6
1683646717375,PHIL 174,A01,202226,Staff,17,0,20,3
1683646717375,PHIL 174,A02,202235,Staff,20,0,20,0
1683646718401,PHIL 191A,A00,258918,Staff,0,0,1,1
1683646719426,PHYS 1A,A00,187028,Staff,27,0,60,33
1683646720450,PHYS 1AL,001,187036,Staff,3,0,30,27
1683646720450,PHYS 1AL,002,187049,Staff,18,0,30,12
1683646721477,PHYS 1B,A00,187058,Staff,22,0,60,38
1683646722510,PHYS 1BL,001,187064,Staff,0,1,30,30
1683646722510,PHYS 1BL,002,187070,Staff,4,0,30,26
1683646723533,PHYS 1C,A00,187082,Staff,29,0,120,91
1683646724559,PHYS 1CL,001,187088,Staff,0,9,30,30
1683646724559,PHYS 1CL,002,187089,Staff,0,1,30,30
1683646724559,PHYS 1CL,009,262693,Staff,9,0,30,21
1683646725585,PHYS 2B,A01,187097,Staff,55,0,115,60
1683646726610,PHYS 2C,A01,187099,Staff,64,0,115,51
1683646727635,PHYS 2CL,A01,187101,Staff,5,0,28,23
1683646727635,PHYS 2CL,A02,187102,Staff,15,0,28,13
1683646728666,PHYS 2D,A01,187123,Shotwell; Brian,95,0,115,20
1683646729694,PHYS 4B,A01,187133,Grinstein; Benjamin,35,0,50,15
1683646730718,POLI 10,A00,188819,Staff,0,4,50,50
1683646731753,POLI 11,A00,188827,Staff,43,0,50,7
1683646732779,POLI 13R,A00,188828,Staff,0,1,20,20
1683646733808,POLI 27,A01,188830,Elgin; Samuel Zincke,0,2,70,70
1683646734835,POLI 30,A00,188832,Desposato; Scott,30,0,50,20
1683646735861,POLI 102F,A00,188834,Staff,0,0,40,40
1683646736889,POLI 104A,A00,188852,Staff,13,0,30,17
1683646737914,POLI 104I,A00,188853,Staff,0,7,20,20
1683646738937,POLI 110B,A00,188854,Wiens; David,7,0,20,13
1683646739962,POLI 112A,A00,188855,Wiens; David,4,0,30,26
1683646740989,POLI 117R,A00,188856,Forman; Fonna,0,12,20,20
1683646742013,POLI 118,A00,188857,Ingham; Sean,8,0,20,12
1683646743040,POLI 120G,A00,188858,Staff,8,0,30,22
1683646744069,POLI 131CR,A00,188863,Hoston; Germaine,21,0,50,29
1683646745093,POLI 133,A00,188864,Nellis; Gareth Hb,44,0,50,6
1683646746118,POLI 134D,A00,188865,Desposato; Scott,27,0,30,3
1683646747142,POLI 142A,A00,188871,Gartzke; Erik,21,0,50,29
1683646748221,POLI 142K,A00,188874,Staff,38,0,50,12
1683646749245,POLI 143,A00,188940,Gartzke; Erik,16,0,30,14
1683646750268,POLI 153,A00,188943,Staff,2,0,20,18
1683646751293,POLI 160AA,A00,188944,Staff,11,0,40,29
1683646752322,POLI 170A,A00,188945,Staff,11,0,30,19
1683646754373,PSYC 1,A00,188952,Staff,36,0,90,54
1683646755400,PSYC 2,B00,188953,Staff,19,0,35,16
1683646756425,PSYC 6,A00,188970,Staff,47,0,60,13
1683646757449,PSYC 7,A00,188973,Staff,35,0,45,10
1683646758474,PSYC 60,A01,188980,Rickard; Timothy C.,42,0,60,18
1683646759503,PSYC 70,A01,189001,Steiner; Eric Tomas,23,0,45,22
1683646760526,PSYC 100,A00,189005,Lacefield; Katharine I,0,99,120,120
1683646761549,PSYC 102,A00,189008,Staff,8,0,30,22
1683646762574,PSYC 106,B00,189026,Gorman; Michael R.,27,0,60,33
1683646763599,PSYC 114,B01,189033,Winkielman; Piotr,0,31,30,30
1683646764627,PSYC 131,A00,189036,Anagnostaras; Stephan,0,43,60,60
1683646765654,PSYC 136,A00,189041,Lowe; Angela Beth,0,7,25,25
1683646766681,PSYC 137,A00,189057,Winkielman; Piotr,0,37,25,25
1683646767706,PSYC 144,A00,189107,Wixted; John T,0,10,50,50
1683646769762,PSYC 162,A00,189142,Staff,0,9,85,85
1683646770789,PSYC 172,A00,189144,Gorman; Michael R.,0,6,30,30
1683646772841,PSYC 179,A00,189146,Lacefield; Katharine I,0,86,120,120
1683646773870,PSYC 181,A00,189147,Anagnostaras; Stephan,0,44,90,90
1683646774894,PSYC 190R,A00,189148,Barner; David A.,0,23,80,80
1683646775918,PSYC 191,A00,189275,Rickard; Timothy C.,0,10,25,25
1683646776950,PSYC 193,A00,189276,Chapman; Eddie Nathaniel,0,1,0,4
1683646777975,PSYC 193L,A01,189281,Lowe; Angela Beth,10,0,20,10
1683646777975,PSYC 193L,B01,189285,Staff,28,0,35,7
1683646779011,RELI 149,A00,187137,Rahimi; Babak,7,0,40,33
1683646780038,SE 9,A01,187315,Staff,0,2,18,18
1683646781063,SE 101B,A00,187409,Staff,24,0,30,6
1683646782087,SE 110B,A00,187444,Staff,10,0,40,30
1683646783114,SE 130B,A00,187449,Staff,31,0,40,9
1683646784141,SE 150A,A00,187516,Staff,9,0,20,11
1683646785168,SE 154,A00,187528,Staff,29,0,50,21
1683646786195,SIO 3,A01,258171,Staff,35,0,40,5
1683646787219,SIO 10,A00,187144,Cook; Geoffrey W,0,6,75,75
1683646788244,SIO 45,A00,187152,Cook; Geoffrey W,0,4,100,100
1683646789270,SIO 109R,A00,194486,Staff,0,4,20,20
1683646791327,SIO 187,A01,187233,Kacev; David,12,0,40,28
1683646792352,SOCI 1,A01,258656,Thorpe; Charles Robert,28,0,30,2
1683646792352,SOCI 1,A02,258658,Thorpe; Charles Robert,30,0,30,0
1683646792352,SOCI 1,A03,258661,Thorpe; Charles Robert,25,0,25,0
1683646792352,SOCI 1,A04,258666,Thorpe; Charles Robert,22,0,25,3
1683646792352,SOCI 1,A05,258897,Thorpe; Charles Robert,22,0,25,3
1683646792352,SOCI 1,A06,258898,Thorpe; Charles Robert,25,0,25,0
1683646793377,SOCI 30,A01,258903,Pardo Guerra; Juan Pablo,14,0,30,16
1683646794403,SOCI 102,A00,258904,Staff,9,0,25,16
1683646795428,SOCI 106,A00,258905,Staff,19,0,25,6
1683646796452,SOCI 111,A00,258907,Ribas Norris; Janet Vanesa,26,0,30,4
1683646797476,SOCI 121R,A00,258908,Pardo Guerra; Juan Pablo,8,0,30,22
1683646798501,SOCI 126,A01,203330,Staff,14,0,20,6
1683646799524,SOCI 131,A00,258909,Thorpe; Charles Robert,30,0,60,30
1683646800553,SOCI 135,A00,258910,Payne; Christine Anna,0,11,30,30
1683646801588,SOCI 157,A00,258911,Staff,12,0,30,18
1683646802616,SOCI 184,A00,258912,Staff,25,0,30,5
1683646803643,SOCI 188D,A00,258913,Staff,22,0,30,8
1683646804670,SYN 2,001,187529,Staff,9,0,16,7
1683646804670,SYN 2,002,201452,Staff,0,20,16,16
1683646804670,SYN 2,003,201469,Staff,2,0,16,14
1683646805697,SYN 100,A01,187531,Staff,0,9,20,20
1683646805697,SYN 100,B01,201491,Staff,0,10,20,20
1683646806724,TDAC 1,A00,189286,Walsh; Kim C.,3,0,20,17
1683646806724,TDAC 1,B00,189287,Harting; Carla Kelso,10,0,20,10
1683646807747,TDAC 101,A00,189300,Walsh; Kim C.,16,0,20,4
1683646807747,TDAC 101,B00,189301,Harting; Carla Kelso,18,0,20,2
1683646808774,TDAC 102,A00,189304,Basso; Beatrice,14,0,20,6
1683646809798,TDAC 108,A00,189305,Staff,18,0,20,2
1683646810828,TDDE 131,A00,189310,Staff,19,0,20,1
1683646810828,TDDE 131,B00,189314,Staff,19,0,20,1
1683646810828,TDDE 131,C00,189315,Staff,48,0,50,2
1683646810828,TDDE 131,D00,189316,Staff,14,0,15,1
1683646810828,TDDE 131,E00,204841,Staff,20,0,20,0
1683646811856,TDGE 10,A00,189289,Staff,27,0,50,23
1683646811856,TDGE 10,B00,189290,Havis; Allan,0,0,50,50
1683646812885,TDGE 11,A00,189291,Fulton; Julia,0,4,50,50
1683646812885,TDGE 11,B00,189292,Staff,20,0,25,5
1683646812885,TDGE 11,C00,260270,Staff,0,0,0,0
1683646813909,TDGE 25,A00,189294,Staff,2,0,20,18
1683646814937,TDGE 124,A00,189318,Fulton; Julia,0,8,50,50
1683646815961,TDGE 125,A00,189319,Staff,13,0,25,12
1683646815961,TDGE 125,B00,189320,Staff,23,0,25,2
1683646816986,TDGE 127,A00,189322,Havis; Allan,0,0,50,50
1683646818012,TDHT 101,A00,189323,Staff,18,0,25,7
1683646818012,TDHT 101,B00,189324,Staff,25,0,25,0
1683646819037,TDHT 102,A00,189325,Staff,49,0,50,1
1683646820061,TDMV 1,A00,189295,Arcidiacono; Kristin,20,0,30,10
1683646820061,TDMV 1,B00,189296,Caligagan; Maria T.,24,0,30,6
1683646821090,TDMV 2,A00,189297,Sammartano; Tonnie,27,0,30,3
1683646821090,TDMV 2,B00,189299,Arcidiacono; Kristin,23,0,30,7
1683646822112,TDMV 3,A00,204998,Rincon; Alicia,22,0,30,8
1683646823138,TDMV 120,A00,189458,Sammartano; Tonnie,28,0,30,2
1683646824165,TDMV 138,A00,189541,Jun; Grace Shin Hae,20,0,40,20
1683646825189,TDMV 142,A00,189717,Caligagan; Tony,25,0,30,5
1683646825189,TDMV 142,B00,189718,Caligagan; Maria T.,25,0,30,5
1683646826219,TMC 2,A01,187533,Staff,25,0,25,0
1683646826219,TMC 2,A02,187534,Staff,25,0,25,0
1683646827242,USP 1,A01,187536,Kwak; Nancy,0,16,25,25
1683646828265,USP 5,A01,187538,Staff,9,0,25,16
1683646829293,USP 101,A00,199253,Staff,0,4,0,0
1683646830318,USP 124,A00,187562,Boomhower; Matthew Charles,0,0,30,30
1683646831345,USP 138,A00,187582,Staff,20,0,25,5
1683646832368,USP 152,A01,187597,Staff,3,0,25,22
1683646833391,USP 153,A00,187598,Staff,19,0,25,6
1683646834418,USP 168,A00,187607,Kwak; Nancy,2,0,5,3
1683646835441,USP 173,A00,187619,Staff,4,0,25,21
1683646836465,USP 181,A00,187638,Staff,0,4,25,25
1683646837492,VIS 103,A00,187650,Cruz; Edwin Teddy,18,0,75,57
1683646838516,VIS 110D,A00,187669,Staff,13,0,22,9
1683646839540,VIS 127C,A00,187720,Shen; Kuiyi,67,0,146,79
1683646840564,VIS 149,A00,187731,Yoldas; Pinar,0,14,22,22
1683646841588,VIS 151,A01,188091,Staff,22,0,34,12
1683646841588,VIS 151,A02,188092,Staff,11,0,34,23
1683646842612,VIS 160B,A00,188093,Stalbaum; Brett,0,1,10,10
1683646844668,WCWP 10B,A00,201720,Staff,10,0,15,5
1683646844668,WCWP 10B,B00,201722,Staff,9,0,15,6
1683646845695,WCWP 100,A00,201725,Gagnon; Jeffrey C,0,0,2,2
1683646845695,WCWP 100,B00,201727,Staff,0,4,15,15
1683646848801,ANBI 133,A00,258401,Wilder; Linnea Lorene,34,0,40,6
1683646849826,ANBI 140,A00,258395,Hrvoj Mihic; Branka,18,0,25,7
1683646850851,ANSC 120,A00,258402,Bialecki; Jon Anthony,26,0,40,14
1683646851954,ANSC 144,A00,258400,Staff,12,0,40,28
1683646854007,ANSC 166,A00,258396,Parish; Steven Martin,156,0,175,19
1683646855035,ANSC 180,A00,193533,Staff,8,0,20,12
1683646856060,ANSC 188,A00,258397,Jassal; Aftab,34,0,40,6
1683646857083,ANTH 3,A01,258316,Staff,23,0,30,7
1683646858110,ANTH 5,A00,258394,Semendeferi; Ekaterini,16,0,20,4
1683646859137,ANTH 21,A01,258331,Staff,4,0,40,36
1683646860162,ANTH 103,A00,258398,Varma; Saiba,15,0,25,10
1683646861194,AWP 10,001,202034,Staff,0,0,0,0
1683646861194,AWP 10,002,202035,Staff,0,0,0,0
1683646861194,AWP 10,003,202036,Staff,0,0,0,0
1683646861194,AWP 10,004,202037,Staff,0,0,0,0
1683646861194,AWP 10,005,202038,Staff,0,0,0,0
1683646861194,AWP 10,006,202039,Staff,0,0,0,0
1683646861194,AWP 10,007,202040,Staff,0,0,0,0
1683646861194,AWP 10,008,202041,Staff,0,0,0,0
1683646861194,AWP 10,009,202042,Staff,0,0,0,0
1683646861194,AWP 10,010,202043,Staff,0,0,0,0
1683646861194,AWP 10,011,202044,Staff,0,0,0,0
1683646861194,AWP 10,012,202045,Staff,0,0,0,0
1683646861194,AWP 10,013,202046,Staff,0,0,0,0
1683646861194,AWP 10,014,202047,Staff,0,0,0,0
1683646861194,AWP 10,015,202048,Staff,0,0,0,0
1683646861194,AWP 10,016,202049,Staff,0,0,0,0
1683646861194,AWP 10,017,202050,Staff,0,0,0,0
1683646861194,AWP 10,018,202051,Staff,0,0,0,0
1683646861194,AWP 10,019,202052,Staff,0,0,0,0
1683646861194,AWP 10,020,202053,Staff,0,0,0,0
1683646861194,AWP 10,021,202054,Staff,0,0,0,0
1683646861194,AWP 10,022,202055,Staff,0,0,0,0
1683646861194,AWP 10,023,202056,Staff,0,0,0,0
1683646861194,AWP 10,024,202057,Staff,0,0,0,0
1683646861194,AWP 10,025,202058,Staff,0,0,0,0
1683646861194,AWP 10,026,202059,Staff,0,0,0,0
1683646862223,AWP 102,001,202032,Staff,0,0,0,0
1683646862223,AWP 102,002,202033,Staff,0,0,0,0
1683646863247,BENG 100,A01,254234,Taylor Amos; Alyssa C,31,0,40,9
1683646864271,BENG 196,001,270013,Engler; Adam J.,9999,0,9999,0
1683646865297,BICD 100R,A01,202018,Smith; Laurie,0,7,32,32
1683646865297,BICD 100R,A02,202019,Smith; Laurie,0,3,32,32
1683646865297,BICD 100R,A03,202020,Smith; Laurie,0,1,32,32
1683646865297,BICD 100R,A04,202021,Smith; Laurie,6,0,32,26
1683646865297,BICD 100R,A05,202022,Smith; Laurie,11,0,32,21
1683646866322,BICD 136,A01,193242,Gustafson-Brown; Cindy,0,2,32,32
1683646866322,BICD 136,A02,193244,Gustafson-Brown; Cindy,13,0,32,19
1683646867347,BIEB 102,A01,193249,Butler; Shannon Rhey,0,2,32,32
1683646867347,BIEB 102,A02,193251,Butler; Shannon Rhey,0,0,32,32
1683646867347,BIEB 102,A03,193253,Butler; Shannon Rhey,0,0,32,32
1683646867347,BIEB 102,A04,193255,Butler; Shannon Rhey,14,0,32,18
1683646867347,BIEB 102,A05,193265,Butler; Shannon Rhey,26,0,32,6
1683646867347,BIEB 102,A06,193269,Butler; Shannon Rhey,14,0,32,18
1683646869403,BIEB 150,A01,193274,Staff,0,0,32,32
1683646869403,BIEB 150,A02,193285,Staff,24,0,32,8
1683646870429,BIEB 194,A00,193286,Kurle; Carolyn M.,20,0,32,12
1683646871455,BILD 1,A01,192291,Staff,15,0,32,17
1683646871455,BILD 1,A02,192292,Staff,30,0,32,2
1683646871455,BILD 1,B01,192520,Reuther; Keefe,0,1,0,0
1683646871455,BILD 1,B02,192532,Reuther; Keefe,0,1,0,0
1683646872485,BILD 3,A01,192556,Butler; Shannon Rhey,0,0,32,32
1683646872485,BILD 3,A02,192581,Butler; Shannon Rhey,1,0,32,31
1683646872485,BILD 3,A03,192611,Butler; Shannon Rhey,21,0,32,11
1683646872485,BILD 3,A04,192612,Butler; Shannon Rhey,24,0,32,8
1683646872485,BILD 3,A05,192613,Butler; Shannon Rhey,26,0,32,6
1683646872485,BILD 3,A06,192679,Butler; Shannon Rhey,27,0,32,5
1683646872485,BILD 3,A07,192682,Butler; Shannon Rhey,20,0,32,12
1683646873510,BILD 4,A01,192836,Reuther; Keefe,0,0,24,24
1683646873510,BILD 4,A02,193044,Reuther; Keefe,4,0,24,20
1683646874539,BILD 10,A01,193142,Gustafson-Brown; Cindy,29,0,32,3
1683646874539,BILD 10,A02,193149,Gustafson-Brown; Cindy,31,0,32,1
1683646875564,BIMM 100,A01,193301,Staff,0,6,32,32
1683646875564,BIMM 100,A02,193312,Staff,0,7,32,32
1683646875564,BIMM 100,A03,193323,Staff,0,9,32,32
1683646876591,BIMM 101,A01,193329,McDonnell; Lisa Marie,0,4,24,24
1683646876591,BIMM 101,A02,193339,McDonnell; Lisa Marie,0,3,24,24
1683646876591,BIMM 101,B01,193354,McDonnell; Lisa Marie,0,4,24,24
1683646876591,BIMM 101,B02,193357,McDonnell; Lisa Marie,0,3,24,24
1683646877619,BIMM 110,A01,193377,Tat; John,0,11,32,32
1683646877619,BIMM 110,A02,193378,Tat; John,0,10,32,32
1683646878648,BIMM 120,A01,206116,Staff,0,0,32,32
1683646878648,BIMM 120,A02,206117,Staff,6,0,32,26
1683646878648,BIMM 120,A03,206121,Staff,21,0,32,11
1683646879679,BIPN 100,A01,193393,Park; Ji Young,0,14,32,32
1683646879679,BIPN 100,A02,193402,Park; Ji Young,0,14,32,32
1683646879679,BIPN 100,A03,193413,Park; Ji Young,0,14,32,32
1683646879679,BIPN 100,A04,193414,Park; Ji Young,0,13,32,32
1683646880709,BIPN 102,A01,193429,Staff,0,0,32,32
1683646880709,BIPN 102,A02,193438,Staff,18,0,32,14
1683646881739,BIPN 106,A01,193450,Reyes Gonzalez; Catalina,0,2,40,40
1683646882767,BIPN 134,A01,193465,Cooke; James Edward,0,0,32,32
1683646882767,BIPN 134,A02,193474,Cooke; James Edward,25,0,32,7
1683646882767,BIPN 134,A03,193485,Cooke; James Edward,29,0,32,3
1683646882767,BIPN 134,A04,193486,Cooke; James Edward,20,0,32,12
1683646882767,BIPN 134,A05,193491,Cooke; James Edward,31,0,32,1
1683646882767,BIPN 134,A06,193501,Cooke; James Edward,30,0,32,2
1683646882767,BIPN 134,A07,193510,Cooke; James Edward,29,0,32,3
1683646884824,BISP 194,A00,222522,Staff,14,0,32,18
1683646885851,CAT 124,A01,202407,Staff,19,0,25,6
1683646886878,CAT 125,A00,202408,Marchisotto; Jennifer Anne,2,0,20,18
1683646887911,CAT 125R,A00,202409,Smith; Lauryn Alissa,0,11,20,20
1683646887911,CAT 125R,B00,202410,Morales; Celeste Georgianna,0,11,20,20
1683646887911,CAT 125R,C00,202411,Irwin; Matthew Joseph,0,12,20,20
1683646888939,CENG 15,A01,204712,Yang; Kesong,0,1,0,0
1683646889962,CENG 114,A00,202070,Jahed Motlagh; Zeinab,5,0,20,15
1683646890987,CGS 105,A00,185477,Wesling; Megan E.,24,0,40,16
1683646892013,CGS 106,A00,185494,Staff,11,0,22,11
1683646893039,CGS 108,A00,185495,Staff,14,0,20,6
1683646894062,CGS 114,A00,185496,Staff,13,0,18,5
1683646895086,CGS 119,A00,185501,Staff,15,0,20,5
1683646896110,CGS 120,A00,185511,Staff,12,0,20,8
1683646897136,CHEM 4,A01,184675,Bussey; Thomas J,97,0,100,3
1683646898159,CHEM 6A,A01,184677,Staff,33,0,60,27
1683646899184,CHEM 6B,A01,184679,Staff,63,0,100,37
1683646900211,CHEM 6C,A01,184681,Bussey; Thomas J,0,0,50,50
1683646900211,CHEM 6C,A02,184682,Bussey; Thomas J,32,0,50,18
1683646901235,CHEM 40A,A01,184684,Albizati; Kim F.,34,0,100,66
1683646902263,CHEM 40B,A01,184686,Albizati; Kim F.,0,22,100,100
1683646903290,CHEM 41B,A01,184690,Staff,51,0,100,49
1683646904319,COGS 3,A01,184715,Boyle; Mary E. T.,0,27,40,40
1683646905345,COGS 14B,A01,185172,Staff,0,14,38,38
1683646906372,COGS 18,A01,184736,Staff,14,0,80,66
1683646907398,COGS 100,A01,184932,Staff,0,7,73,73
1683646908421,COGS 101A,A01,184935,Staff,0,39,30,30
1683646909444,COGS 101B,A01,184944,Staff,0,2,30,30
1683646910468,COGS 101C,A01,184946,Staff,0,10,30,30
1683646911495,COGS 102A,A01,184951,Johnson; Christine M.,2,0,40,38
1683646912524,COGS 107B,A01,184953,Mooshagian; Eric Frederick,0,51,40,40
1683646913551,COGS 118B,A01,184959,Gupta; Anjum,0,49,40,40
1683646914576,COGS 153,A00,184961,Staff,0,16,30,30
1683646915600,COGS 177,A00,184962,Staff,0,21,30,30
1683646916626,COGS 187A,A01,184969,Boyle; Mary E. T.,0,19,40,40
1683646917651,COMM 10,A01,185174,Staff,0,5,25,25
1683646917651,COMM 10,A02,185189,Staff,0,2,25,25
1683646917651,COMM 10,A03,269821,Staff,0,1,0,0
1683646918676,COMM 100B,A01,185475,Staff,0,1,0,2
1683646918676,COMM 100B,A02,185476,Staff,12,0,25,13
1683646919703,COMM 100C,A01,185314,Staff,1,0,25,24
1683646919703,COMM 100C,A02,185327,Staff,18,0,25,7
1683646920730,COMM 110M,A00,185349,Staff,0,0,40,40
1683646921753,COMM 113T,A00,185352,Staff,25,0,40,15
1683646922777,COMM 114I,A00,185353,Staff,31,0,40,9
1683646923809,COMM 131,A00,185354,Staff,17,0,30,13
1683646924838,CSE 8A,A50,185358,Cao; Yingjun,0,46,10,10
1683646925863,CSE 8B,A01,185362,Staff,0,48,50,50
1683646926889,CSE 11,A01,185416,Cao; Yingjun,0,91,10,10
1683646927916,CSE 20,A01,185445,Briones; Jor-el Thomas Caparas,4,0,25,21
1683646928942,CSE 21,A01,185447,Staff,9,0,50,41
1683646929968,CSE 101,A01,185451,Staff,0,13,50,50
1683646929968,CSE 101,B01,185453,Jones; Miles E,0,13,50,50
1683646932022,CSE 141,A01,185458,Eldon; John,16,0,100,84
1683646933050,CSE 141L,A01,185461,Eldon; John,8,0,100,92
1683646934077,CSE 142,A01,185463,Staff,35,0,60,25
1683646934077,CSE 142,B01,201355,Staff,0,7,60,60
1683646935102,CSE 142L,A01,185470,Staff,35,0,60,25
1683646935102,CSE 142L,B01,201417,Staff,0,6,60,60
1683646936125,CSE 190,A00,201433,Staff,32,0,49,17
1683646937149,DOC 1,A01,259136,Strom; Megan C.,7,0,15,8
1683646937149,DOC 1,A02,259137,Strom; Megan C.,14,0,15,1
1683646937149,DOC 1,A03,259138,Strom; Megan C.,14,0,15,1
1683646937149,DOC 1,A04,259139,Strom; Megan C.,14,0,15,1
1683646938177,DOC 100D,A00,259140,Pass; Natalye Joann,14,0,25,11
1683646939204,DSGN 1,A01,184749,Rill; Bryan,0,26,30,30
1683646940230,DSGN 100,A01,185168,Staff,0,2,25,25
1683646941254,ECE 5,A01,185626,Morris; Karcher William,0,11,0,0
1683646942281,ECE 101,A01,185628,Staff,14,0,70,56
1683646943307,ECE 107,A01,185635,Baghdadchi; Saharnaz,0,0,20,20
1683646943307,ECE 107,A02,185638,Baghdadchi; Saharnaz,3,0,20,17
1683646944332,ECE 148,A01,185647,Silberman; Jack,0,0,16,16
1683646945355,ECON 1,A01,185537,Crane; Meredith Helen,54,0,70,16
1683646946383,ECON 3,A01,185549,Crane; Meredith Helen,29,0,70,41
1683646947408,ECON 4,A01,203354,Anderson; John Charles,0,5,10,10
1683646948437,ECON 100A,A01,185574,Staff,0,5,40,40
1683646949463,ECON 100B,A01,185576,Staff,0,12,50,50
1683646950487,ECON 100C,A01,185589,Newhouse; Herbert S,30,0,70,40
1683646951511,ECON 105,A00,185608,Vespa; Emanuel Ignacio,19,0,35,16
1683646952535,ECON 109,A01,185610,Shishkin; Denis,9,0,35,26
1683646953563,ECON 110A,A01,185612,Staff,9,0,40,31
1683646954587,ECON 120A,A01,185615,Staff,20,0,40,20
1683646955667,ECON 120C,A01,185617,Sun; Yixiao,0,20,70,70
1683646956690,ECON 144,A00,203346,Squires; Dale E,2,0,35,33
1683646957713,ECON 171,A01,203349,Newhouse; Herbert S,0,1,35,35
1683646958737,ECON 173A,A01,185621,Toda; Alexis Akira,21,0,35,14
1683646959770,EDS 25,A01,202413,Staff,0,1,0,0
1683646959770,EDS 25,A02,202414,Staff,0,1,0,0
1683646959770,EDS 25,A03,202415,Staff,0,0,0,0
1683646959770,EDS 25,A04,202416,Staff,0,1,0,0
1683646959770,EDS 25,A05,202439,Staff,0,0,0,0
1683646959770,EDS 25,A06,202440,Staff,0,0,0,0
1683646959770,EDS 25,B01,202631,Staff,0,0,0,0
1683646959770,EDS 25,B02,202632,Staff,0,0,0,0
1683646959770,EDS 25,B03,202639,Staff,0,0,0,0
1683646959770,EDS 25,B04,202640,Staff,0,0,0,0
1683646959770,EDS 25,B05,202643,Staff,0,0,0,0
1683646959770,EDS 25,B06,202644,Staff,0,0,0,0
1683646960798,EDS 38,A01,202659,Black; Alison Michelle,24,0,25,1
1683646961824,EDS 115,A00,202652,Staff,18,0,30,12
1683646962852,EDS 125,A00,202649,Staff,13,0,30,17
1683646963879,EDS 126,A01,203332,Staff,30,0,30,0
1683646964903,EDS 139,A00,202838,Staff,16,0,25,9
1683646965928,EDS 146,A01,202655,Staff,14,0,25,11
1683646966953,ENG 15,A00,185667,Staff,0,1,0,0
1683646966953,ENG 15,B00,185672,Staff,0,0,0,0
1683646966953,ENG 15,C00,185675,Staff,0,0,0,0
1683646966953,ENG 15,D00,185682,Staff,0,0,0,0
1683646966953,ENG 15,E00,185684,Staff,0,0,0,0
1683646967978,ETHN 103,A00,185710,Staff,0,8,35,35
1683646969004,ETHN 103A,A00,199228,Man; Simeon S,0,0,9,9
1683646970028,ETHN 109,A00,185711,Staff,16,0,35,19
1683646971054,ETHN 142,A00,185726,Staff,0,4,30,30
1683646972081,ETHN 163J,A00,199229,Man; Simeon S,5,0,8,3
1683646973105,ETHN 168,A00,185727,Staff,7,0,10,3
1683646974129,ETHN 182,A00,185728,Staff,0,0,35,35
1683646975152,ETHN 183,A00,185737,Staff,9,0,18,9
1683646976177,GLBH 111,A01,209361,Burgos; Jose L.,0,0,0,0
1683646978227,HIEU 104,A00,185792,Staff,14,0,20,6
1683646979255,HIEU 115,A00,185800,Staff,0,0,20,20
1683646980282,HIEU 128,A00,185801,Staff,0,9,20,20
1683646981306,HIEU 147,A00,185802,Staff,15,0,20,5
1683646982334,HIEU 154,A00,185823,Staff,11,0,20,9
1683646983361,HILA 102,A00,185826,Staff,14,0,20,6
1683646984386,HILD 2C,A01,185778,Staff,0,13,20,20
1683646985414,HILD 7B,A01,185780,Kwak; Nancy,0,16,32,32
1683646985414,HILD 7B,A02,185781,Kwak; Nancy,0,18,32,32
1683646986438,HILD 30,A01,185791,Staff,12,0,20,8
1683646987461,HISC 119,A00,185830,Golan; Tal,0,9,20,20
1683646988525,HITO 156GS,A00,185831,Patterson; Patrick H.,0,0,0,23
1683646989554,HIUS 103,A00,185832,Man; Simeon S,0,4,20,20
1683646990582,HIUS 117,A00,185836,Kwak; Nancy,2,0,20,18
1683646991606,HIUS 125,A00,185840,Man; Simeon S,0,1,23,23
1683646992629,HIUS 149,A00,185845,Staff,1,0,20,19
1683646993658,HUM 3,A01,185882,Zavodny; Tatiana Sophia,0,7,50,50
1683646993658,HUM 3,B01,185899,Caldwell; Michael Alan,0,18,50,50
1683646994683,HUM 3GS,A00,185900,Patterson; Patrick H.,0,0,0,23
1683646995710,HUM 4,A01,185938,Zroka; Amy Liane,30,0,50,20
1683646995710,HUM 4,B01,185956,Watkins; Eric,0,4,50,50
1683646995710,HUM 4,B02,202209,Watkins; Eric,0,4,50,50
1683646995710,HUM 4,B03,202210,Watkins; Eric,0,4,50,50
1683646996737,HUM 5,A01,185958,West; Geoffrey Scott,2,0,50,48
1683646996737,HUM 5,A02,202215,West; Geoffrey Scott,0,0,50,50
1683646997762,INTL 190,A00,185959,Gagnon; Jeffrey C,0,0,0,9
1683646997762,INTL 190,B00,185960,Lettieri; Michael Joseph,0,0,0,2
1683646998786,JAPN 180,A00,254509,Staff,5,0,30,25
1683646999816,LATI 10,A01,202853,Kennemore; Amy Michelle,4,0,35,31
1683646999816,LATI 10,A02,202854,Kennemore; Amy Michelle,2,0,35,33
1683646999816,LATI 10,A03,270054,Kennemore; Amy Michelle,30,0,30,0
1683647000839,LATI 180,A00,202855,Kennemore; Amy Michelle,11,0,20,9
1683647001868,LAWS 101,A00,201767,Golan; Tal,0,7,40,40
1683647002892,LIFR 1C,A00,185961,Staff,6,0,20,14
1683647003919,LIFR 1CX,A00,185962,Staff,7,0,20,13
1683647004947,LIFR 1D,A00,185963,Staff,7,0,20,13
1683647005972,LIFR 1DX,A00,185964,Staff,7,0,20,13
1683647006999,LIGN 101,A01,186039,Staff,43,0,50,7
1683647008025,LIGN 165,A00,186040,Staff,15,0,50,35
1683647009054,LTCS 108,A00,186041,Staff,5,0,10,5
1683647010077,LTCS 119,A00,186042,Staff,15,0,20,5
1683647011101,LTCS 130,A00,186043,Wesling; Megan E.,15,0,25,10
1683647013157,LTEA 138,A00,186119,Staff,14,0,40,26
1683647014182,LTEN 124,A00,186148,Staff,5,0,25,20
1683647015209,LTEN 178,A00,186149,Staff,7,0,15,8
1683647016237,LTEN 181,A00,186150,Blanco; John D,34,0,40,6
1683647017263,LTWL 120,A00,186160,Staff,20,0,25,5
1683647018289,LTWL 165,A00,186161,Staff,22,0,25,3
1683647019313,LTWR 100,A00,186162,Staff,0,5,15,15
1683647020341,LTWR 102,A00,186163,Doller; Ben,5,0,15,10
1683647021369,MAE 8,A01,186412,Staff,0,0,0,0
1683647022394,MAE 30B,A00,186445,Bahadori; Mohammad Yousef,82,0,100,18
1683647023418,MAE 40,A00,186592,Bewley; Thomas R,10,0,50,40
1683647024443,MAE 101B,A00,186593,Bahadori; Mohammad Yousef,80,0,100,20
1683647025467,MAE 105,A00,186594,Bandaru; Prabhakar,10,0,50,40
1683647026494,MAE 107,A00,186599,Pham; Hieu Tan,0,7,120,120
1683647027519,MAE 148,A01,186660,Silberman; Jack,3,0,16,13
1683647028548,MATH 10A,A01,188095,Staff,0,5,35,35
1683647029589,MATH 10B,A01,188097,Bowers; Adam R.,0,11,30,30
1683647029589,MATH 10B,A02,188099,Bowers; Adam R.,0,11,30,30
1683647029589,MATH 10B,B01,188104,Bowers; Adam R.,0,10,30,30
1683647029589,MATH 10B,B02,188106,Bowers; Adam R.,1,9,30,29
1683647030614,MATH 10C,A01,188111,Staff,0,18,30,30
1683647030614,MATH 10C,A02,188127,Staff,0,19,30,30
1683647030614,MATH 10C,A03,188131,Staff,0,19,30,30
1683647030614,MATH 10C,B01,188218,Staff,17,0,30,13
1683647030614,MATH 10C,B02,188244,Staff,13,0,30,17
1683647030614,MATH 10C,B03,188277,Staff,14,0,30,16
1683647031645,MATH 18,A01,188344,Bach; Quang Tran,18,0,30,12
1683647031645,MATH 18,A02,188345,Bach; Quang Tran,11,0,30,19
1683647031645,MATH 18,B01,188353,Bach; Quang Tran,11,0,30,19
1683647031645,MATH 18,B02,188354,Bach; Quang Tran,19,0,30,11
1683647032669,MATH 20A,A01,188374,Staff,11,0,35,24
1683647033693,MATH 20B,A01,188382,Ohm; Ko Woon,7,0,30,23
1683647033693,MATH 20B,A02,188383,Ohm; Ko Woon,22,0,30,8
1683647033693,MATH 20B,B01,188385,Ohm; Ko Woon,7,0,30,23
1683647033693,MATH 20B,B02,188392,Ohm; Ko Woon,22,0,30,8
1683647034718,MATH 20C,A01,188394,Harel; Guershon,11,0,30,19
1683647034718,MATH 20C,A02,188395,Harel; Guershon,13,0,30,17
1683647034718,MATH 20C,B01,188404,Harel; Guershon,5,0,30,25
1683647034718,MATH 20C,B02,188405,Harel; Guershon,18,0,30,12
1683647035744,MATH 20D,A01,188414,Hammock; Frances H,0,1,30,30
1683647035744,MATH 20D,A02,188415,Hammock; Frances H,0,1,30,30
1683647035744,MATH 20D,B01,188447,Hammock; Frances H,0,1,30,30
1683647035744,MATH 20D,B02,188486,Hammock; Frances H,4,0,30,26
1683647036768,MATH 20E,A01,188649,Staff,21,0,30,9
1683647036768,MATH 20E,A02,188650,Staff,21,0,30,9
1683647036768,MATH 20E,A03,188673,Staff,0,0,30,30
1683647037795,MATH 102,A01,188675,Staff,0,36,35,35
1683647038820,MATH 103B,A01,188681,Staff,3,0,35,32
1683647038820,MATH 103B,B01,188692,Staff,5,0,35,30
1683647039849,MATH 109,A01,188695,Salehi Golsefidy; Alireza,24,0,35,11
1683647039849,MATH 109,A02,188696,Salehi Golsefidy; Alireza,25,0,35,10
1683647040874,MATH 120A,A01,188698,Eggers; John Dietrich,7,0,35,28
1683647041901,MATH 142B,A01,188736,Ioana; Adrian,0,1,30,30
1683647041901,MATH 142B,A02,188741,Ioana; Adrian,0,1,30,30
1683647041901,MATH 142B,A03,188743,Ioana; Adrian,0,1,30,30
1683647042926,MATH 168A,A01,188790,Staff,0,10,35,35
1683647043956,MATH 170A,A01,188803,Nie; Jiawang,0,2,35,35
1683647043956,MATH 170A,A02,188811,Nie; Jiawang,0,0,35,35
1683647043956,MATH 170A,A03,188814,Nie; Jiawang,0,0,35,35
1683647043956,MATH 170A,A04,188815,Nie; Jiawang,10,0,35,25
1683647044979,MATH 193B,A01,188817,Staff,0,0,35,35
1683647044979,MATH 193B,A02,188818,Staff,5,0,35,30
1683647046006,MGT 4,A01,202857,Anderson; John Charles,61,0,80,19
1683647047033,MGT 12,A00,202858,Lindenberger; Wade Douglas,40,0,90,50
1683647048058,MGT 18,A00,202859,Staff,74,0,90,16
1683647049087,MGT 18GS,A00,202860,McKay; Michael J,13,0,28,15
1683647050111,MGT 45,A00,202861,Pecore; Joseph P.,12,0,90,78
1683647051139,MGT 100,A00,202863,Yavorsky; Daniel Ryan,28,0,90,62
1683647052172,MGT 103,A00,202864,Ehrich; Kristine R,0,17,90,90
1683647053195,MGT 112,A00,202865,Ehrich; Kristine R,15,0,90,75
1683647054221,MGT 121A,A00,202868,Staff,0,20,0,0
1683647055250,MGT 131B,A00,202869,Anderson; John Charles,59,0,90,31
1683647056278,MGT 136,A00,202871,Lindenberger; Wade Douglas,83,0,90,7
1683647057304,MGT 164,A00,202873,Staff,0,66,90,91
1683647058328,MGT 164GS,A00,202874,McKay; Mary A,13,0,28,15
1683647059414,MGT 180,A00,202875,Staff,0,50,90,91
1683647060441,MMW 11R,A01,205019,Herbst; Matthew,2,0,30,28
1683647060441,MMW 11R,A02,205026,Herbst; Matthew,29,0,30,1
1683647061468,MMW 15,A01,193512,Chang; Edmond Yi-Teh,0,8,28,28
1683647061468,MMW 15,A02,193513,Chang; Edmond Yi-Teh,0,5,28,28
1683647061468,MMW 15,A03,193514,Chang; Edmond Yi-Teh,0,5,28,28
1683647061468,MMW 15,A04,193515,Chang; Edmond Yi-Teh,0,5,28,28
1683647061468,MMW 15,A05,193516,Chang; Edmond Yi-Teh,0,5,28,28
1683647061468,MMW 15,A06,193517,Chang; Edmond Yi-Teh,0,6,28,28
1683647061468,MMW 15,B01,193519,Chang; Edmond Yi-Teh,0,5,28,28
1683647061468,MMW 15,B02,193520,Chang; Edmond Yi-Teh,0,5,28,28
1683647061468,MMW 15,B03,193521,Chang; Edmond Yi-Teh,0,5,28,28
1683647061468,MMW 15,B04,193522,Chang; Edmond Yi-Teh,0,5,28,28
1683647061468,MMW 15,B05,193523,Chang; Edmond Yi-Teh,0,5,28,28
1683647061468,MMW 15,B06,193524,Chang; Edmond Yi-Teh,0,5,28,28
1683647062499,MMW 122,A01,193526,Rahimi; Babak,0,16,28,28
1683647062499,MMW 122,A02,193527,Rahimi; Babak,0,15,28,28
1683647062499,MMW 122,A03,193528,Rahimi; Babak,0,0,0,0
1683647062499,MMW 122,A04,193529,Rahimi; Babak,0,0,0,0
1683647063544,MUS 1A,A01,186663,Staff,1,20,35,34
1683647064571,MUS 4,A01,186715,Staff,0,12,35,35
1683647065595,MUS 5R,A01,186796,Dubnov; Shlomo,0,17,35,35
1683647066619,MUS 6,A01,186798,Staff,0,5,25,25
1683647067644,MUS 7,A01,186830,Staff,11,0,35,24
1683647068667,MUS 8,A01,186930,Staff,0,26,35,35
1683647069692,MUS 15,A01,186932,Staff,0,16,35,35
1683647069692,MUS 15,B01,186934,Staff,0,17,35,35
1683647070716,MUS 80,A00,186935,Staff,0,0,20,20
1683647070716,MUS 80,B00,186936,Staff,24,0,25,1
1683647071740,NANO 11,A00,204702,Lipomi; Darren John,0,0,0,0
1683647072771,NANO 15,A01,204709,Yang; Kesong,0,1,0,0
1683647073796,NANO 114,A00,202069,Jahed Motlagh; Zeinab,3,0,10,7
1683647074819,PHIL 1,A00,186955,Grush; Rick Scott,31,0,40,9
1683647075844,PHIL 10,A01,186973,Grush; Rick Scott,27,0,35,8
1683647075844,PHIL 10,A02,186974,Grush; Rick Scott,33,0,35,2
1683647076867,PHIL 13,A01,186976,Staff,3,0,35,32
1683647076867,PHIL 13,A02,186977,Staff,16,0,35,19
1683647077890,PHIL 14,A01,186979,Staff,31,0,35,4
1683647077890,PHIL 14,A02,186986,Staff,32,0,35,3
1683647078912,PHIL 28,A01,186988,Staff,16,0,30,14
1683647078912,PHIL 28,A02,186989,Staff,1,0,30,29
1683647078912,PHIL 28,A03,186990,Staff,10,0,30,20
1683647078912,PHIL 28,A04,186991,Staff,26,0,30,4
1683647079937,PHIL 120,A00,186997,Staff,23,0,40,17
1683647080965,PHIL 137,A00,187003,Staff,7,0,40,33
1683647081991,PHIL 150,A00,187015,Staff,47,0,70,23
1683647083016,PHIL 167,A00,187021,Lamey; Andy M.,34,0,40,6
1683647084044,PHIL 174,A01,202226,Staff,17,0,20,3
1683647084044,PHIL 174,A02,202235,Staff,20,0,20,0
1683647085073,PHIL 191A,A00,258918,Staff,0,0,1,1
1683647086112,PHYS 1A,A00,187028,Staff,27,0,60,33
1683647087138,PHYS 1AL,001,187036,Staff,3,0,30,27
1683647087138,PHYS 1AL,002,187049,Staff,18,0,30,12
1683647088162,PHYS 1B,A00,187058,Staff,22,0,60,38
1683647089186,PHYS 1BL,001,187064,Staff,0,1,30,30
1683647089186,PHYS 1BL,002,187070,Staff,4,0,30,26
1683647090211,PHYS 1C,A00,187082,Staff,29,0,120,91
1683647091236,PHYS 1CL,001,187088,Staff,0,9,30,30
1683647091236,PHYS 1CL,002,187089,Staff,0,1,30,30
1683647091236,PHYS 1CL,009,262693,Staff,9,0,30,21
1683647092260,PHYS 2B,A01,187097,Staff,55,0,115,60
1683647093285,PHYS 2C,A01,187099,Staff,64,0,115,51
1683647094311,PHYS 2CL,A01,187101,Staff,5,0,28,23
1683647094311,PHYS 2CL,A02,187102,Staff,15,0,28,13
1683647095334,PHYS 2D,A01,187123,Shotwell; Brian,95,0,115,20
1683647096360,PHYS 4B,A01,187133,Grinstein; Benjamin,35,0,50,15
1683647097388,POLI 10,A00,188819,Staff,0,4,50,50
1683647098412,POLI 11,A00,188827,Staff,43,0,50,7
1683647099434,POLI 13R,A00,188828,Staff,0,1,20,20
1683647100466,POLI 27,A01,188830,Elgin; Samuel Zincke,0,2,70,70
1683647101489,POLI 30,A00,188832,Desposato; Scott,30,0,50,20
1683647102515,POLI 102F,A00,188834,Staff,0,0,40,40
1683647103541,POLI 104A,A00,188852,Staff,13,0,30,17
1683647104565,POLI 104I,A00,188853,Staff,0,7,20,20
1683647105589,POLI 110B,A00,188854,Wiens; David,7,0,20,13
1683647106613,POLI 112A,A00,188855,Wiens; David,4,0,30,26
1683647107639,POLI 117R,A00,188856,Forman; Fonna,0,12,20,20
1683647108673,POLI 118,A00,188857,Ingham; Sean,8,0,20,12
1683647109702,POLI 120G,A00,188858,Staff,8,0,30,22
1683647110732,POLI 131CR,A00,188863,Hoston; Germaine,21,0,50,29
1683647111757,POLI 133,A00,188864,Nellis; Gareth Hb,44,0,50,6
1683647112781,POLI 134D,A00,188865,Desposato; Scott,27,0,30,3
1683647113808,POLI 142A,A00,188871,Gartzke; Erik,21,0,50,29
1683647114832,POLI 142K,A00,188874,Staff,38,0,50,12
1683647115860,POLI 143,A00,188940,Gartzke; Erik,16,0,30,14
1683647116887,POLI 153,A00,188943,Staff,2,0,20,18
1683647117911,POLI 160AA,A00,188944,Staff,11,0,40,29
1683647118935,POLI 170A,A00,188945,Staff,11,0,30,19
1683647120989,PSYC 1,A00,188952,Staff,36,0,90,54
1683647122015,PSYC 2,B00,188953,Staff,19,0,35,16
1683647123040,PSYC 6,A00,188970,Staff,47,0,60,13
1683647124064,PSYC 7,A00,188973,Staff,35,0,45,10
1683647125090,PSYC 60,A01,188980,Rickard; Timothy C.,42,0,60,18
1683647126118,PSYC 70,A01,189001,Steiner; Eric Tomas,23,0,45,22
1683647127143,PSYC 100,A00,189005,Lacefield; Katharine I,0,99,120,120
1683647128167,PSYC 102,A00,189008,Staff,8,0,30,22
1683647129191,PSYC 106,B00,189026,Gorman; Michael R.,27,0,60,33
1683647130219,PSYC 114,B01,189033,Winkielman; Piotr,0,31,30,30
1683647131244,PSYC 131,A00,189036,Anagnostaras; Stephan,0,43,60,60
1683647132268,PSYC 136,A00,189041,Lowe; Angela Beth,0,7,25,25
1683647133295,PSYC 137,A00,189057,Winkielman; Piotr,0,37,25,25
1683647134323,PSYC 144,A00,189107,Wixted; John T,0,10,50,50
1683647136371,PSYC 162,A00,189142,Staff,0,9,85,85
1683647137398,PSYC 172,A00,189144,Gorman; Michael R.,0,6,30,30
1683647139449,PSYC 179,A00,189146,Lacefield; Katharine I,0,86,120,120
1683647140473,PSYC 181,A00,189147,Anagnostaras; Stephan,0,44,90,90
1683647141502,PSYC 190R,A00,189148,Barner; David A.,0,23,80,80
1683647142526,PSYC 191,A00,189275,Rickard; Timothy C.,0,10,25,25
1683647143550,PSYC 193,A00,189276,Chapman; Eddie Nathaniel,0,1,0,4
1683647144576,PSYC 193L,A01,189281,Lowe; Angela Beth,10,0,20,10
1683647144576,PSYC 193L,B01,189285,Staff,28,0,35,7
1683647145602,RELI 149,A00,187137,Rahimi; Babak,7,0,40,33
1683647146629,SE 9,A01,187315,Staff,0,2,18,18
1683647147657,SE 101B,A00,187409,Staff,24,0,30,6
1683647148681,SE 110B,A00,187444,Staff,10,0,40,30
1683647149706,SE 130B,A00,187449,Staff,31,0,40,9
1683647150733,SE 150A,A00,187516,Staff,9,0,20,11
1683647151761,SE 154,A00,187528,Staff,29,0,50,21
1683647152788,SIO 3,A01,258171,Staff,35,0,40,5
1683647153815,SIO 10,A00,187144,Cook; Geoffrey W,0,6,75,75
1683647154842,SIO 45,A00,187152,Cook; Geoffrey W,0,4,100,100
1683647155870,SIO 109R,A00,194486,Staff,0,4,20,20
1683647157922,SIO 187,A01,187233,Kacev; David,12,0,40,28
1683647158948,SOCI 1,A01,258656,Thorpe; Charles Robert,28,0,30,2
1683647158948,SOCI 1,A02,258658,Thorpe; Charles Robert,30,0,30,0
1683647158948,SOCI 1,A03,258661,Thorpe; Charles Robert,25,0,25,0
1683647158948,SOCI 1,A04,258666,Thorpe; Charles Robert,22,0,25,3
1683647158948,SOCI 1,A05,258897,Thorpe; Charles Robert,22,0,25,3
1683647158948,SOCI 1,A06,258898,Thorpe; Charles Robert,25,0,25,0
1683647159977,SOCI 30,A01,258903,Pardo Guerra; Juan Pablo,14,0,30,16
1683647161001,SOCI 102,A00,258904,Staff,9,0,25,16
1683647162025,SOCI 106,A00,258905,Staff,19,0,25,6
1683647163106,SOCI 111,A00,258907,Ribas Norris; Janet Vanesa,26,0,30,4
1683647164128,SOCI 121R,A00,258908,Pardo Guerra; Juan Pablo,8,0,30,22
1683647165153,SOCI 126,A01,203330,Staff,14,0,20,6
1683647166178,SOCI 131,A00,258909,Thorpe; Charles Robert,30,0,60,30
1683647167209,SOCI 135,A00,258910,Payne; Christine Anna,0,11,30,30
1683647168236,SOCI 157,A00,258911,Staff,12,0,30,18
1683647169260,SOCI 184,A00,258912,Staff,25,0,30,5
1683647170284,SOCI 188D,A00,258913,Staff,22,0,30,8
1683647171315,SYN 2,001,187529,Staff,9,0,16,7
1683647171315,SYN 2,002,201452,Staff,0,20,16,16
1683647171315,SYN 2,003,201469,Staff,2,0,16,14
1683647172398,SYN 100,A01,187531,Staff,0,9,20,20
1683647172398,SYN 100,B01,201491,Staff,0,10,20,20
1683647173423,TDAC 1,A00,189286,Walsh; Kim C.,3,0,20,17
1683647173423,TDAC 1,B00,189287,Harting; Carla Kelso,10,0,20,10
1683647174447,TDAC 101,A00,189300,Walsh; Kim C.,16,0,20,4
1683647174447,TDAC 101,B00,189301,Harting; Carla Kelso,18,0,20,2
1683647175475,TDAC 102,A00,189304,Basso; Beatrice,14,0,20,6
1683647176499,TDAC 108,A00,189305,Staff,18,0,20,2
1683647177528,TDDE 131,A00,189310,Staff,19,0,20,1
1683647177528,TDDE 131,B00,189314,Staff,19,0,20,1
1683647177528,TDDE 131,C00,189315,Staff,48,0,50,2
1683647177528,TDDE 131,D00,189316,Staff,14,0,15,1
1683647177528,TDDE 131,E00,204841,Staff,20,0,20,0
1683647178556,TDGE 10,A00,189289,Staff,27,0,50,23
1683647178556,TDGE 10,B00,189290,Havis; Allan,0,0,50,50
1683647179581,TDGE 11,A00,189291,Fulton; Julia,0,4,50,50
1683647179581,TDGE 11,B00,189292,Staff,20,0,25,5
1683647179581,TDGE 11,C00,260270,Staff,0,0,0,0
1683647180605,TDGE 25,A00,189294,Staff,2,0,20,18
1683647181631,TDGE 124,A00,189318,Fulton; Julia,0,8,50,50
1683647182655,TDGE 125,A00,189319,Staff,13,0,25,12
1683647182655,TDGE 125,B00,189320,Staff,23,0,25,2
1683647183684,TDGE 127,A00,189322,Havis; Allan,0,0,50,50
1683647184718,TDHT 101,A00,189323,Staff,18,0,25,7
1683647184718,TDHT 101,B00,189324,Staff,25,0,25,0
1683647185745,TDHT 102,A00,189325,Staff,49,0,50,1
1683647186772,TDMV 1,A00,189295,Arcidiacono; Kristin,20,0,30,10
1683647186772,TDMV 1,B00,189296,Caligagan; Maria T.,24,0,30,6
1683647187795,TDMV 2,A00,189297,Sammartano; Tonnie,27,0,30,3
1683647187795,TDMV 2,B00,189299,Arcidiacono; Kristin,23,0,30,7
1683647188822,TDMV 3,A00,204998,Rincon; Alicia,22,0,30,8
1683647189852,TDMV 120,A00,189458,Sammartano; Tonnie,28,0,30,2
1683647190880,TDMV 138,A00,189541,Jun; Grace Shin Hae,20,0,40,20
1683647191905,TDMV 142,A00,189717,Caligagan; Tony,25,0,30,5
1683647191905,TDMV 142,B00,189718,Caligagan; Maria T.,25,0,30,5
1683647192933,TMC 2,A01,187533,Staff,25,0,25,0
1683647192933,TMC 2,A02,187534,Staff,25,0,25,0
1683647193960,USP 1,A01,187536,Kwak; Nancy,0,16,25,25
1683647194984,USP 5,A01,187538,Staff,9,0,25,16
1683647196008,USP 101,A00,199253,Staff,0,4,0,0
1683647197032,USP 124,A00,187562,Boomhower; Matthew Charles,0,0,30,30
1683647198058,USP 138,A00,187582,Staff,20,0,25,5
1683647199081,USP 152,A01,187597,Staff,3,0,25,22
1683647200109,USP 153,A00,187598,Staff,19,0,25,6
1683647201133,USP 168,A00,187607,Kwak; Nancy,2,0,5,3
1683647202157,USP 173,A00,187619,Staff,4,0,25,21
1683647203181,USP 181,A00,187638,Staff,0,4,25,25
1683647204205,VIS 103,A00,187650,Cruz; Edwin Teddy,18,0,75,57
1683647205229,VIS 110D,A00,187669,Staff,13,0,22,9
1683647206256,VIS 127C,A00,187720,Shen; Kuiyi,67,0,146,79
1683647207281,VIS 149,A00,187731,Yoldas; Pinar,0,14,22,22
1683647208306,VIS 151,A01,188091,Staff,22,0,34,12
1683647208306,VIS 151,A02,188092,Staff,11,0,34,23
1683647209331,VIS 160B,A00,188093,Stalbaum; Brett,0,1,10,10
1683647211383,WCWP 10B,A00,201720,Staff,10,0,15,5
1683647211383,WCWP 10B,B00,201722,Staff,9,0,15,6
1683647212412,WCWP 100,A00,201725,Gagnon; Jeffrey C,0,0,2,2
1683647212412,WCWP 100,B00,201727,Staff,0,4,15,15
1683647215500,ANBI 133,A00,258401,Wilder; Linnea Lorene,34,0,40,6
1683647216525,ANBI 140,A00,258395,Hrvoj Mihic; Branka,18,0,25,7
1683647217552,ANSC 120,A00,258402,Bialecki; Jon Anthony,26,0,40,14
1683647218574,ANSC 144,A00,258400,Staff,12,0,40,28
1683647220627,ANSC 166,A00,258396,Parish; Steven Martin,156,0,175,19
1683647221652,ANSC 180,A00,193533,Staff,8,0,20,12
1683647222678,ANSC 188,A00,258397,Jassal; Aftab,34,0,40,6
1683647223705,ANTH 3,A01,258316,Staff,23,0,30,7
1683647224733,ANTH 5,A00,258394,Semendeferi; Ekaterini,16,0,20,4
1683647225760,ANTH 21,A01,258331,Staff,4,0,40,36
1683647226787,ANTH 103,A00,258398,Varma; Saiba,15,0,25,10
1683647227826,AWP 10,001,202034,Staff,0,0,0,0
1683647227826,AWP 10,002,202035,Staff,0,0,0,0
1683647227826,AWP 10,003,202036,Staff,0,0,0,0
1683647227826,AWP 10,004,202037,Staff,0,0,0,0
1683647227826,AWP 10,005,202038,Staff,0,0,0,0
1683647227826,AWP 10,006,202039,Staff,0,0,0,0
1683647227826,AWP 10,007,202040,Staff,0,0,0,0
1683647227826,AWP 10,008,202041,Staff,0,0,0,0
1683647227826,AWP 10,009,202042,Staff,0,0,0,0
1683647227826,AWP 10,010,202043,Staff,0,0,0,0
1683647227826,AWP 10,011,202044,Staff,0,0,0,0
1683647227826,AWP 10,012,202045,Staff,0,0,0,0
1683647227826,AWP 10,013,202046,Staff,0,0,0,0
1683647227826,AWP 10,014,202047,Staff,0,0,0,0
1683647227826,AWP 10,015,202048,Staff,0,0,0,0
1683647227826,AWP 10,016,202049,Staff,0,0,0,0
1683647227826,AWP 10,017,202050,Staff,0,0,0,0
1683647227826,AWP 10,018,202051,Staff,0,0,0,0
1683647227826,AWP 10,019,202052,Staff,0,0,0,0
1683647227826,AWP 10,020,202053,Staff,0,0,0,0
1683647227826,AWP 10,021,202054,Staff,0,0,0,0
1683647227826,AWP 10,022,202055,Staff,0,0,0,0
1683647227826,AWP 10,023,202056,Staff,0,0,0,0
1683647227826,AWP 10,024,202057,Staff,0,0,0,0
1683647227826,AWP 10,025,202058,Staff,0,0,0,0
1683647227826,AWP 10,026,202059,Staff,0,0,0,0
1683647228854,AWP 102,001,202032,Staff,0,0,0,0
1683647228854,AWP 102,002,202033,Staff,0,0,0,0
1683647229881,BENG 100,A01,254234,Taylor Amos; Alyssa C,31,0,40,9
1683647230906,BENG 196,001,270013,Engler; Adam J.,9999,0,9999,0
1683647231932,BICD 100R,A01,202018,Smith; Laurie,0,7,32,32
1683647231932,BICD 100R,A02,202019,Smith; Laurie,0,3,32,32
1683647231932,BICD 100R,A03,202020,Smith; Laurie,0,1,32,32
1683647231932,BICD 100R,A04,202021,Smith; Laurie,6,0,32,26
1683647231932,BICD 100R,A05,202022,Smith; Laurie,11,0,32,21
1683647232960,BICD 136,A01,193242,Gustafson-Brown; Cindy,0,2,32,32
1683647232960,BICD 136,A02,193244,Gustafson-Brown; Cindy,13,0,32,19
1683647233989,BIEB 102,A01,193249,Butler; Shannon Rhey,0,2,32,32
1683647233989,BIEB 102,A02,193251,Butler; Shannon Rhey,0,0,32,32
1683647233989,BIEB 102,A03,193253,Butler; Shannon Rhey,0,0,32,32
1683647233989,BIEB 102,A04,193255,Butler; Shannon Rhey,14,0,32,18
1683647233989,BIEB 102,A05,193265,Butler; Shannon Rhey,26,0,32,6
1683647233989,BIEB 102,A06,193269,Butler; Shannon Rhey,14,0,32,18
1683647236041,BIEB 150,A01,193274,Staff,0,0,32,32
1683647236041,BIEB 150,A02,193285,Staff,24,0,32,8
1683647237065,BIEB 194,A00,193286,Kurle; Carolyn M.,20,0,32,12
1683647238093,BILD 1,A01,192291,Staff,15,0,32,17
1683647238093,BILD 1,A02,192292,Staff,30,0,32,2
1683647238093,BILD 1,B01,192520,Reuther; Keefe,0,1,0,0
1683647238093,BILD 1,B02,192532,Reuther; Keefe,0,1,0,0
1683647239118,BILD 3,A01,192556,Butler; Shannon Rhey,0,0,32,32
1683647239118,BILD 3,A02,192581,Butler; Shannon Rhey,1,0,32,31
1683647239118,BILD 3,A03,192611,Butler; Shannon Rhey,21,0,32,11
1683647239118,BILD 3,A04,192612,Butler; Shannon Rhey,24,0,32,8
1683647239118,BILD 3,A05,192613,Butler; Shannon Rhey,26,0,32,6
1683647239118,BILD 3,A06,192679,Butler; Shannon Rhey,27,0,32,5
1683647239118,BILD 3,A07,192682,Butler; Shannon Rhey,20,0,32,12
1683647240146,BILD 4,A01,192836,Reuther; Keefe,0,0,24,24
1683647240146,BILD 4,A02,193044,Reuther; Keefe,4,0,24,20
1683647241178,BILD 10,A01,193142,Gustafson-Brown; Cindy,29,0,32,3
1683647241178,BILD 10,A02,193149,Gustafson-Brown; Cindy,31,0,32,1
1683647242206,BIMM 100,A01,193301,Staff,0,6,32,32
1683647242206,BIMM 100,A02,193312,Staff,0,7,32,32
1683647242206,BIMM 100,A03,193323,Staff,0,9,32,32
1683647243231,BIMM 101,A01,193329,McDonnell; Lisa Marie,0,4,24,24
1683647243231,BIMM 101,A02,193339,McDonnell; Lisa Marie,0,3,24,24
1683647243231,BIMM 101,B01,193354,McDonnell; Lisa Marie,0,4,24,24
1683647243231,BIMM 101,B02,193357,McDonnell; Lisa Marie,0,3,24,24
1683647244259,BIMM 110,A01,193377,Tat; John,0,11,32,32
1683647244259,BIMM 110,A02,193378,Tat; John,0,10,32,32
1683647245284,BIMM 120,A01,206116,Staff,0,0,32,32
1683647245284,BIMM 120,A02,206117,Staff,6,0,32,26
1683647245284,BIMM 120,A03,206121,Staff,21,0,32,11
1683647246313,BIPN 100,A01,193393,Park; Ji Young,0,14,32,32
1683647246313,BIPN 100,A02,193402,Park; Ji Young,0,14,32,32
1683647246313,BIPN 100,A03,193413,Park; Ji Young,0,14,32,32
1683647246313,BIPN 100,A04,193414,Park; Ji Young,0,13,32,32
1683647247337,BIPN 102,A01,193429,Staff,0,0,32,32
1683647247337,BIPN 102,A02,193438,Staff,18,0,32,14
1683647248360,BIPN 106,A01,193450,Reyes Gonzalez; Catalina,0,2,40,40
1683647249384,BIPN 134,A01,193465,Cooke; James Edward,0,0,32,32
1683647249384,BIPN 134,A02,193474,Cooke; James Edward,25,0,32,7
1683647249384,BIPN 134,A03,193485,Cooke; James Edward,29,0,32,3
1683647249384,BIPN 134,A04,193486,Cooke; James Edward,20,0,32,12
1683647249384,BIPN 134,A05,193491,Cooke; James Edward,31,0,32,1
1683647249384,BIPN 134,A06,193501,Cooke; James Edward,30,0,32,2
1683647249384,BIPN 134,A07,193510,Cooke; James Edward,29,0,32,3
1683647251439,BISP 194,A00,222522,Staff,14,0,32,18
1683647252464,CAT 124,A01,202407,Staff,19,0,25,6
1683647253489,CAT 125,A00,202408,Marchisotto; Jennifer Anne,2,0,20,18
1683647254519,CAT 125R,A00,202409,Smith; Lauryn Alissa,0,11,20,20
1683647254519,CAT 125R,B00,202410,Morales; Celeste Georgianna,0,11,20,20
1683647254519,CAT 125R,C00,202411,Irwin; Matthew Joseph,0,12,20,20
1683647255546,CENG 15,A01,204712,Yang; Kesong,0,1,0,0
1683647256574,CENG 114,A00,202070,Jahed Motlagh; Zeinab,5,0,20,15
1683647257600,CGS 105,A00,185477,Wesling; Megan E.,24,0,40,16
1683647258627,CGS 106,A00,185494,Staff,11,0,22,11
1683647259651,CGS 108,A00,185495,Staff,14,0,20,6
1683647260678,CGS 114,A00,185496,Staff,13,0,18,5
1683647261702,CGS 119,A00,185501,Staff,15,0,20,5
1683647262729,CGS 120,A00,185511,Staff,12,0,20,8
1683647263757,CHEM 4,A01,184675,Bussey; Thomas J,97,0,100,3
1683647264784,CHEM 6A,A01,184677,Staff,33,0,60,27
1683647265808,CHEM 6B,A01,184679,Staff,63,0,100,37
1683647266887,CHEM 6C,A01,184681,Bussey; Thomas J,0,0,50,50
1683647266887,CHEM 6C,A02,184682,Bussey; Thomas J,32,0,50,18
1683647267915,CHEM 40A,A01,184684,Albizati; Kim F.,34,0,100,66
1683647268941,CHEM 40B,A01,184686,Albizati; Kim F.,0,22,100,100
1683647269970,CHEM 41B,A01,184690,Staff,51,0,100,49
1683647270998,COGS 3,A01,184715,Boyle; Mary E. T.,0,27,40,40
1683647272022,COGS 14B,A01,185172,Staff,0,14,38,38
1683647273045,COGS 18,A01,184736,Staff,14,0,80,66
1683647274074,COGS 100,A01,184932,Staff,0,7,73,73
1683647275103,COGS 101A,A01,184935,Staff,0,39,30,30
1683647276127,COGS 101B,A01,184944,Staff,0,2,30,30
1683647277154,COGS 101C,A01,184946,Staff,0,10,30,30
1683647278177,COGS 102A,A01,184951,Johnson; Christine M.,2,0,40,38
1683647279205,COGS 107B,A01,184953,Mooshagian; Eric Frederick,0,51,40,40
1683647280229,COGS 118B,A01,184959,Gupta; Anjum,0,49,40,40
1683647281251,COGS 153,A00,184961,Staff,0,16,30,30
1683647282280,COGS 177,A00,184962,Staff,0,21,30,30
1683647283307,COGS 187A,A01,184969,Boyle; Mary E. T.,0,19,40,40
1683647284331,COMM 10,A01,185174,Staff,0,5,25,25
1683647284331,COMM 10,A02,185189,Staff,0,2,25,25
1683647284331,COMM 10,A03,269821,Staff,0,1,0,0
1683647285355,COMM 100B,A01,185475,Staff,0,1,0,2
1683647285355,COMM 100B,A02,185476,Staff,12,0,25,13
1683647286380,COMM 100C,A01,185314,Staff,1,0,25,24
1683647286380,COMM 100C,A02,185327,Staff,18,0,25,7
1683647287406,COMM 110M,A00,185349,Staff,0,0,40,40
1683647288433,COMM 113T,A00,185352,Staff,25,0,40,15
1683647289460,COMM 114I,A00,185353,Staff,31,0,40,9
1683647290486,COMM 131,A00,185354,Staff,17,0,30,13
1683647291510,CSE 8A,A50,185358,Cao; Yingjun,0,46,10,10
1683647292537,CSE 8B,A01,185362,Staff,0,48,50,50
1683647293565,CSE 11,A01,185416,Cao; Yingjun,0,91,10,10
1683647294590,CSE 20,A01,185445,Briones; Jor-el Thomas Caparas,4,0,25,21
1683647295617,CSE 21,A01,185447,Staff,9,0,50,41
1683647296648,CSE 101,A01,185451,Staff,0,13,50,50
1683647296648,CSE 101,B01,185453,Jones; Miles E,0,13,50,50
1683647298695,CSE 141,A01,185458,Eldon; John,16,0,100,84
1683647299721,CSE 141L,A01,185461,Eldon; John,8,0,100,92
1683647300757,CSE 142,A01,185463,Staff,35,0,60,25
1683647300757,CSE 142,B01,201355,Staff,0,7,60,60
1683647301787,CSE 142L,A01,185470,Staff,35,0,60,25
1683647301787,CSE 142L,B01,201417,Staff,0,6,60,60
1683647302812,CSE 190,A00,201433,Staff,32,0,49,17
1683647303837,DOC 1,A01,259136,Strom; Megan C.,7,0,15,8
1683647303837,DOC 1,A02,259137,Strom; Megan C.,14,0,15,1
1683647303837,DOC 1,A03,259138,Strom; Megan C.,14,0,15,1
1683647303837,DOC 1,A04,259139,Strom; Megan C.,14,0,15,1
1683647304865,DOC 100D,A00,259140,Pass; Natalye Joann,14,0,25,11
1683647305893,DSGN 1,A01,184749,Rill; Bryan,0,26,30,30
1683647306917,DSGN 100,A01,185168,Staff,0,2,25,25
1683647307945,ECE 5,A01,185626,Morris; Karcher William,0,11,0,0
1683647308969,ECE 101,A01,185628,Staff,14,0,70,56
1683647309994,ECE 107,A01,185635,Baghdadchi; Saharnaz,0,0,20,20
1683647309994,ECE 107,A02,185638,Baghdadchi; Saharnaz,3,0,20,17
1683647311018,ECE 148,A01,185647,Silberman; Jack,0,0,16,16
1683647312042,ECON 1,A01,185537,Crane; Meredith Helen,54,0,70,16
1683647313066,ECON 3,A01,185549,Crane; Meredith Helen,29,0,70,41
1683647314090,ECON 4,A01,203354,Anderson; John Charles,0,5,10,10
1683647315114,ECON 100A,A01,185574,Staff,0,5,40,40
1683647316141,ECON 100B,A01,185576,Staff,0,12,50,50
1683647317169,ECON 100C,A01,185589,Newhouse; Herbert S,30,0,70,40
1683647318193,ECON 105,A00,185608,Vespa; Emanuel Ignacio,19,0,35,16
1683647319217,ECON 109,A01,185610,Shishkin; Denis,9,0,35,26
1683647320242,ECON 110A,A01,185612,Staff,9,0,40,31
1683647321266,ECON 120A,A01,185615,Staff,20,0,40,20
1683647322290,ECON 120C,A01,185617,Sun; Yixiao,0,20,70,70
1683647323316,ECON 144,A00,203346,Squires; Dale E,2,0,35,33
1683647324340,ECON 171,A01,203349,Newhouse; Herbert S,0,1,35,35
1683647325366,ECON 173A,A01,185621,Toda; Alexis Akira,21,0,35,14
1683647326394,EDS 25,A01,202413,Staff,0,1,0,0
1683647326394,EDS 25,A02,202414,Staff,0,1,0,0
1683647326394,EDS 25,A03,202415,Staff,0,0,0,0
1683647326394,EDS 25,A04,202416,Staff,0,1,0,0
1683647326394,EDS 25,A05,202439,Staff,0,0,0,0
1683647326394,EDS 25,A06,202440,Staff,0,0,0,0
1683647326394,EDS 25,B01,202631,Staff,0,0,0,0
1683647326394,EDS 25,B02,202632,Staff,0,0,0,0
1683647326394,EDS 25,B03,202639,Staff,0,0,0,0
1683647326394,EDS 25,B04,202640,Staff,0,0,0,0
1683647326394,EDS 25,B05,202643,Staff,0,0,0,0
1683647326394,EDS 25,B06,202644,Staff,0,0,0,0
1683647327422,EDS 38,A01,202659,Black; Alison Michelle,24,0,25,1
1683647328449,EDS 115,A00,202652,Staff,18,0,30,12
1683647329472,EDS 125,A00,202649,Staff,13,0,30,17
1683647330500,EDS 126,A01,203332,Staff,30,0,30,0
1683647331524,EDS 139,A00,202838,Staff,16,0,25,9
1683647332548,EDS 146,A01,202655,Staff,14,0,25,11
1683647333577,ENG 15,A00,185667,Staff,0,1,0,0
1683647333577,ENG 15,B00,185672,Staff,0,0,0,0
1683647333577,ENG 15,C00,185675,Staff,0,0,0,0
1683647333577,ENG 15,D00,185682,Staff,0,0,0,0
1683647333577,ENG 15,E00,185684,Staff,0,0,0,0
1683647334601,ETHN 103,A00,185710,Staff,0,8,35,35
1683647335629,ETHN 103A,A00,199228,Man; Simeon S,0,0,9,9
1683647336656,ETHN 109,A00,185711,Staff,16,0,35,19
1683647337683,ETHN 142,A00,185726,Staff,0,4,30,30
1683647338710,ETHN 163J,A00,199229,Man; Simeon S,5,0,8,3
1683647339736,ETHN 168,A00,185727,Staff,7,0,10,3
1683647340762,ETHN 182,A00,185728,Staff,0,0,35,35
1683647341785,ETHN 183,A00,185737,Staff,9,0,18,9
1683647342810,GLBH 111,A01,209361,Burgos; Jose L.,0,0,0,0
1683647344864,HIEU 104,A00,185792,Staff,14,0,20,6
1683647345888,HIEU 115,A00,185800,Staff,0,0,20,20
1683647346915,HIEU 128,A00,185801,Staff,0,9,20,20
1683647347941,HIEU 147,A00,185802,Staff,15,0,20,5
1683647348963,HIEU 154,A00,185823,Staff,11,0,20,9
1683647349987,HILA 102,A00,185826,Staff,14,0,20,6
1683647351012,HILD 2C,A01,185778,Staff,0,13,20,20
1683647352038,HILD 7B,A01,185780,Kwak; Nancy,0,16,32,32
1683647352038,HILD 7B,A02,185781,Kwak; Nancy,0,18,32,32
1683647353064,HILD 30,A01,185791,Staff,12,0,20,8
1683647354087,HISC 119,A00,185830,Golan; Tal,0,9,20,20
1683647355111,HITO 156GS,A00,185831,Patterson; Patrick H.,0,0,0,23
1683647356133,HIUS 103,A00,185832,Man; Simeon S,0,4,20,20
1683647357160,HIUS 117,A00,185836,Kwak; Nancy,2,0,20,18
1683647358537,HIUS 125,A00,185840,Man; Simeon S,0,1,23,23
1683647359561,HIUS 149,A00,185845,Staff,1,0,20,19
1683647360590,HUM 3,A01,185882,Zavodny; Tatiana Sophia,0,7,50,50
1683647360590,HUM 3,B01,185899,Caldwell; Michael Alan,0,18,50,50
1683647361613,HUM 3GS,A00,185900,Patterson; Patrick H.,0,0,0,23
1683647362643,HUM 4,A01,185938,Zroka; Amy Liane,30,0,50,20
1683647362643,HUM 4,B01,185956,Watkins; Eric,0,4,50,50
1683647362643,HUM 4,B02,202209,Watkins; Eric,0,4,50,50
1683647362643,HUM 4,B03,202210,Watkins; Eric,0,4,50,50
1683647363667,HUM 5,A01,185958,West; Geoffrey Scott,2,0,50,48
1683647363667,HUM 5,A02,202215,West; Geoffrey Scott,0,0,50,50
1683647364692,INTL 190,A00,185959,Gagnon; Jeffrey C,0,0,0,9
1683647364692,INTL 190,B00,185960,Lettieri; Michael Joseph,0,0,0,2
1683647365716,JAPN 180,A00,254509,Staff,5,0,30,25
1683647366741,LATI 10,A01,202853,Kennemore; Amy Michelle,4,0,35,31
1683647366741,LATI 10,A02,202854,Kennemore; Amy Michelle,2,0,35,33
1683647366741,LATI 10,A03,270054,Kennemore; Amy Michelle,30,0,30,0
1683647367766,LATI 180,A00,202855,Kennemore; Amy Michelle,11,0,20,9
1683647368796,LAWS 101,A00,201767,Golan; Tal,0,7,40,40
1683647369819,LIFR 1C,A00,185961,Staff,6,0,20,14
1683647370916,LIFR 1CX,A00,185962,Staff,7,0,20,13
1683647371943,LIFR 1D,A00,185963,Staff,7,0,20,13
1683647372971,LIFR 1DX,A00,185964,Staff,7,0,20,13
1683647373998,LIGN 101,A01,186039,Staff,43,0,50,7
1683647375023,LIGN 165,A00,186040,Staff,15,0,50,35
1683647376047,LTCS 108,A00,186041,Staff,5,0,10,5
1683647377071,LTCS 119,A00,186042,Staff,15,0,20,5
1683647378094,LTCS 130,A00,186043,Wesling; Megan E.,15,0,25,10
1683647380145,LTEA 138,A00,186119,Staff,14,0,40,26
1683647381168,LTEN 124,A00,186148,Staff,5,0,25,20
1683647382192,LTEN 178,A00,186149,Staff,7,0,15,8
1683647383215,LTEN 181,A00,186150,Blanco; John D,34,0,40,6
1683647384241,LTWL 120,A00,186160,Staff,20,0,25,5
1683647385271,LTWL 165,A00,186161,Staff,22,0,25,3
1683647386294,LTWR 100,A00,186162,Staff,0,5,15,15
1683647387318,LTWR 102,A00,186163,Doller; Ben,5,0,15,10
1683647388344,MAE 8,A01,186412,Staff,0,0,0,0
1683647389371,MAE 30B,A00,186445,Bahadori; Mohammad Yousef,82,0,100,18
1683647390395,MAE 40,A00,186592,Bewley; Thomas R,10,0,50,40
1683647391422,MAE 101B,A00,186593,Bahadori; Mohammad Yousef,80,0,100,20
1683647392450,MAE 105,A00,186594,Bandaru; Prabhakar,10,0,50,40
1683647393477,MAE 107,A00,186599,Pham; Hieu Tan,0,7,120,120
1683647394502,MAE 148,A01,186660,Silberman; Jack,3,0,16,13
1683647395527,MATH 10A,A01,188095,Staff,0,5,35,35
1683647396552,MATH 10B,A01,188097,Bowers; Adam R.,0,11,30,30
1683647396552,MATH 10B,A02,188099,Bowers; Adam R.,0,11,30,30
1683647396552,MATH 10B,B01,188104,Bowers; Adam R.,0,10,30,30
1683647396552,MATH 10B,B02,188106,Bowers; Adam R.,1,9,30,29
1683647397581,MATH 10C,A01,188111,Staff,0,18,30,30
1683647397581,MATH 10C,A02,188127,Staff,0,19,30,30
1683647397581,MATH 10C,A03,188131,Staff,0,19,30,30
1683647397581,MATH 10C,B01,188218,Staff,17,0,30,13
1683647397581,MATH 10C,B02,188244,Staff,13,0,30,17
1683647397581,MATH 10C,B03,188277,Staff,14,0,30,16
1683647398609,MATH 18,A01,188344,Bach; Quang Tran,18,0,30,12
1683647398609,MATH 18,A02,188345,Bach; Quang Tran,11,0,30,19
1683647398609,MATH 18,B01,188353,Bach; Quang Tran,11,0,30,19
1683647398609,MATH 18,B02,188354,Bach; Quang Tran,19,0,30,11
1683647399633,MATH 20A,A01,188374,Staff,11,0,35,24
1683647400664,MATH 20B,A01,188382,Ohm; Ko Woon,7,0,30,23
1683647400664,MATH 20B,A02,188383,Ohm; Ko Woon,22,0,30,8
1683647400664,MATH 20B,B01,188385,Ohm; Ko Woon,7,0,30,23
1683647400664,MATH 20B,B02,188392,Ohm; Ko Woon,22,0,30,8
1683647401695,MATH 20C,A01,188394,Harel; Guershon,11,0,30,19
1683647401695,MATH 20C,A02,188395,Harel; Guershon,13,0,30,17
1683647401695,MATH 20C,B01,188404,Harel; Guershon,5,0,30,25
1683647401695,MATH 20C,B02,188405,Harel; Guershon,18,0,30,12
1683647402720,MATH 20D,A01,188414,Hammock; Frances H,0,1,30,30
1683647402720,MATH 20D,A02,188415,Hammock; Frances H,0,1,30,30
1683647402720,MATH 20D,B01,188447,Hammock; Frances H,0,1,30,30
1683647402720,MATH 20D,B02,188486,Hammock; Frances H,4,0,30,26
1683647403744,MATH 20E,A01,188649,Staff,21,0,30,9
1683647403744,MATH 20E,A02,188650,Staff,21,0,30,9
1683647403744,MATH 20E,A03,188673,Staff,0,0,30,30
1683647404766,MATH 102,A01,188675,Staff,0,36,35,35
1683647405791,MATH 103B,A01,188681,Staff,3,0,35,32
1683647405791,MATH 103B,B01,188692,Staff,5,0,35,30
1683647406816,MATH 109,A01,188695,Salehi Golsefidy; Alireza,24,0,35,11
1683647406816,MATH 109,A02,188696,Salehi Golsefidy; Alireza,25,0,35,10
1683647407839,MATH 120A,A01,188698,Eggers; John Dietrich,7,0,35,28
1683647408867,MATH 142B,A01,188736,Ioana; Adrian,0,1,30,30
1683647408867,MATH 142B,A02,188741,Ioana; Adrian,0,1,30,30
1683647408867,MATH 142B,A03,188743,Ioana; Adrian,0,1,30,30
1683647409893,MATH 168A,A01,188790,Staff,0,10,35,35
1683647410921,MATH 170A,A01,188803,Nie; Jiawang,0,2,35,35
1683647410921,MATH 170A,A02,188811,Nie; Jiawang,0,0,35,35
1683647410921,MATH 170A,A03,188814,Nie; Jiawang,0,0,35,35
1683647410921,MATH 170A,A04,188815,Nie; Jiawang,10,0,35,25
1683647411949,MATH 193B,A01,188817,Staff,0,0,35,35
1683647411949,MATH 193B,A02,188818,Staff,5,0,35,30
1683647412977,MGT 4,A01,202857,Anderson; John Charles,61,0,80,19
1683647414001,MGT 12,A00,202858,Lindenberger; Wade Douglas,40,0,90,50
1683647415026,MGT 18,A00,202859,Staff,74,0,90,16
1683647416051,MGT 18GS,A00,202860,McKay; Michael J,13,0,28,15
1683647417078,MGT 45,A00,202861,Pecore; Joseph P.,12,0,90,78
1683647418105,MGT 100,A00,202863,Yavorsky; Daniel Ryan,28,0,90,62
1683647419130,MGT 103,A00,202864,Ehrich; Kristine R,0,17,90,90
1683647420154,MGT 112,A00,202865,Ehrich; Kristine R,15,0,90,75
1683647421177,MGT 121A,A00,202868,Staff,0,20,0,0
1683647422202,MGT 131B,A00,202869,Anderson; John Charles,59,0,90,31
1683647423229,MGT 136,A00,202871,Lindenberger; Wade Douglas,83,0,90,7
1683647424255,MGT 164,A00,202873,Staff,0,66,90,91
1683647425282,MGT 164GS,A00,202874,McKay; Mary A,13,0,28,15
1683647426308,MGT 180,A00,202875,Staff,0,50,90,91
1683647427331,MMW 11R,A01,205019,Herbst; Matthew,2,0,30,28
1683647427331,MMW 11R,A02,205026,Herbst; Matthew,29,0,30,1
1683647428358,MMW 15,A01,193512,Chang; Edmond Yi-Teh,0,8,28,28
1683647428358,MMW 15,A02,193513,Chang; Edmond Yi-Teh,0,5,28,28
1683647428358,MMW 15,A03,193514,Chang; Edmond Yi-Teh,0,5,28,28
1683647428358,MMW 15,A04,193515,Chang; Edmond Yi-Teh,0,5,28,28
1683647428358,MMW 15,A05,193516,Chang; Edmond Yi-Teh,0,5,28,28
1683647428358,MMW 15,A06,193517,Chang; Edmond Yi-Teh,0,6,28,28
1683647428358,MMW 15,B01,193519,Chang; Edmond Yi-Teh,0,5,28,28
1683647428358,MMW 15,B02,193520,Chang; Edmond Yi-Teh,0,5,28,28
1683647428358,MMW 15,B03,193521,Chang; Edmond Yi-Teh,0,5,28,28
1683647428358,MMW 15,B04,193522,Chang; Edmond Yi-Teh,0,5,28,28
1683647428358,MMW 15,B05,193523,Chang; Edmond Yi-Teh,0,5,28,28
1683647428358,MMW 15,B06,193524,Chang; Edmond Yi-Teh,0,5,28,28
1683647429382,MMW 122,A01,193526,Rahimi; Babak,0,16,28,28
1683647429382,MMW 122,A02,193527,Rahimi; Babak,0,15,28,28
1683647429382,MMW 122,A03,193528,Rahimi; Babak,0,0,0,0
1683647429382,MMW 122,A04,193529,Rahimi; Babak,0,0,0,0
1683647430406,MUS 1A,A01,186663,Staff,1,20,35,34
1683647431431,MUS 4,A01,186715,Staff,0,12,35,35
1683647432455,MUS 5R,A01,186796,Dubnov; Shlomo,0,17,35,35
1683647433478,MUS 6,A01,186798,Staff,0,5,25,25
1683647434505,MUS 7,A01,186830,Staff,11,0,35,24
1683647435529,MUS 8,A01,186930,Staff,0,26,35,35
1683647436557,MUS 15,A01,186932,Staff,0,16,35,35
1683647436557,MUS 15,B01,186934,Staff,0,17,35,35
1683647437583,MUS 80,A00,186935,Staff,0,0,20,20
1683647437583,MUS 80,B00,186936,Staff,24,0,25,1
1683647438606,NANO 11,A00,204702,Lipomi; Darren John,0,0,0,0
1683647439630,NANO 15,A01,204709,Yang; Kesong,0,1,0,0
1683647440655,NANO 114,A00,202069,Jahed Motlagh; Zeinab,3,0,10,7
1683647441682,PHIL 1,A00,186955,Grush; Rick Scott,31,0,40,9
1683647442709,PHIL 10,A01,186973,Grush; Rick Scott,27,0,35,8
1683647442709,PHIL 10,A02,186974,Grush; Rick Scott,33,0,35,2
1683647443737,PHIL 13,A01,186976,Staff,3,0,35,32
1683647443737,PHIL 13,A02,186977,Staff,16,0,35,19
1683647444763,PHIL 14,A01,186979,Staff,31,0,35,4
1683647444763,PHIL 14,A02,186986,Staff,32,0,35,3
1683647445790,PHIL 28,A01,186988,Staff,16,0,30,14
1683647445790,PHIL 28,A02,186989,Staff,1,0,30,29
1683647445790,PHIL 28,A03,186990,Staff,10,0,30,20
1683647445790,PHIL 28,A04,186991,Staff,26,0,30,4
1683647446817,PHIL 120,A00,186997,Staff,23,0,40,17
1683647447842,PHIL 137,A00,187003,Staff,7,0,40,33
1683647448868,PHIL 150,A00,187015,Staff,47,0,70,23
1683647449895,PHIL 167,A00,187021,Lamey; Andy M.,34,0,40,6
1683647450923,PHIL 174,A01,202226,Staff,17,0,20,3
1683647450923,PHIL 174,A02,202235,Staff,20,0,20,0
1683647451947,PHIL 191A,A00,258918,Staff,0,0,1,1
1683647452972,PHYS 1A,A00,187028,Staff,27,0,60,33
1683647453996,PHYS 1AL,001,187036,Staff,3,0,30,27
1683647453996,PHYS 1AL,002,187049,Staff,18,0,30,12
1683647455030,PHYS 1B,A00,187058,Staff,22,0,60,38
1683647456058,PHYS 1BL,001,187064,Staff,0,1,30,30
1683647456058,PHYS 1BL,002,187070,Staff,4,0,30,26
1683647457082,PHYS 1C,A00,187082,Staff,29,0,120,91
1683647458110,PHYS 1CL,001,187088,Staff,0,9,30,30
1683647458110,PHYS 1CL,002,187089,Staff,0,1,30,30
1683647458110,PHYS 1CL,009,262693,Staff,9,0,30,21
1683647459136,PHYS 2B,A01,187097,Staff,55,0,115,60
1683647460165,PHYS 2C,A01,187099,Staff,64,0,115,51
1683647461191,PHYS 2CL,A01,187101,Staff,5,0,28,23
1683647461191,PHYS 2CL,A02,187102,Staff,15,0,28,13
1683647462222,PHYS 2D,A01,187123,Shotwell; Brian,95,0,115,20
1683647463249,PHYS 4B,A01,187133,Grinstein; Benjamin,35,0,50,15
1683647464273,POLI 10,A00,188819,Staff,0,4,50,50
1683647465295,POLI 11,A00,188827,Staff,43,0,50,7
1683647466320,POLI 13R,A00,188828,Staff,0,1,20,20
1683647467347,POLI 27,A01,188830,Elgin; Samuel Zincke,0,2,70,70
1683647468373,POLI 30,A00,188832,Desposato; Scott,30,0,50,20
1683647469396,POLI 102F,A00,188834,Staff,0,0,40,40
1683647470421,POLI 104A,A00,188852,Staff,13,0,30,17
1683647471447,POLI 104I,A00,188853,Staff,0,7,20,20
1683647472471,POLI 110B,A00,188854,Wiens; David,7,0,20,13
1683647473497,POLI 112A,A00,188855,Wiens; David,4,0,30,26
1683647474575,POLI 117R,A00,188856,Forman; Fonna,0,12,20,20
1683647475598,POLI 118,A00,188857,Ingham; Sean,8,0,20,12
1683647476622,POLI 120G,A00,188858,Staff,8,0,30,22
1683647477645,POLI 131CR,A00,188863,Hoston; Germaine,21,0,50,29
1683647478670,POLI 133,A00,188864,Nellis; Gareth Hb,44,0,50,6
1683647479695,POLI 134D,A00,188865,Desposato; Scott,27,0,30,3
1683647480720,POLI 142A,A00,188871,Gartzke; Erik,21,0,50,29
1683647481745,POLI 142K,A00,188874,Staff,38,0,50,12
1683647482769,POLI 143,A00,188940,Gartzke; Erik,16,0,30,14
1683647483793,POLI 153,A00,188943,Staff,2,0,20,18
1683647484820,POLI 160AA,A00,188944,Staff,11,0,40,29
1683647485847,POLI 170A,A00,188945,Staff,11,0,30,19
1683647487897,PSYC 1,A00,188952,Staff,36,0,90,54
1683647488922,PSYC 2,B00,188953,Staff,19,0,35,16
1683647489949,PSYC 6,A00,188970,Staff,47,0,60,13
1683647490973,PSYC 7,A00,188973,Staff,35,0,45,10
1683647491998,PSYC 60,A01,188980,Rickard; Timothy C.,42,0,60,18
1683647493023,PSYC 70,A01,189001,Steiner; Eric Tomas,23,0,45,22
1683647494046,PSYC 100,A00,189005,Lacefield; Katharine I,0,99,120,120
1683647495072,PSYC 102,A00,189008,Staff,8,0,30,22
1683647496099,PSYC 106,B00,189026,Gorman; Michael R.,27,0,60,33
1683647497121,PSYC 114,B01,189033,Winkielman; Piotr,0,31,30,30
1683647498148,PSYC 131,A00,189036,Anagnostaras; Stephan,0,43,60,60
1683647499172,PSYC 136,A00,189041,Lowe; Angela Beth,0,7,25,25
1683647500198,PSYC 137,A00,189057,Winkielman; Piotr,0,37,25,25
1683647501224,PSYC 144,A00,189107,Wixted; John T,0,10,50,50
1683647503272,PSYC 162,A00,189142,Staff,0,9,85,85
1683647504294,PSYC 172,A00,189144,Gorman; Michael R.,0,6,30,30
1683647506346,PSYC 179,A00,189146,Lacefield; Katharine I,0,86,120,120
1683647507371,PSYC 181,A00,189147,Anagnostaras; Stephan,0,44,90,90
1683647508395,PSYC 190R,A00,189148,Barner; David A.,0,23,80,80
1683647509419,PSYC 191,A00,189275,Rickard; Timothy C.,0,10,25,25
1683647510446,PSYC 193,A00,189276,Chapman; Eddie Nathaniel,0,1,0,4
1683647511475,PSYC 193L,A01,189281,Lowe; Angela Beth,10,0,20,10
1683647511475,PSYC 193L,B01,189285,Staff,28,0,35,7
1683647512502,RELI 149,A00,187137,Rahimi; Babak,7,0,40,33
1683647513530,SE 9,A01,187315,Staff,0,2,18,18
1683647514553,SE 101B,A00,187409,Staff,24,0,30,6
1683647515577,SE 110B,A00,187444,Staff,10,0,40,30
1683647516605,SE 130B,A00,187449,Staff,31,0,40,9
1683647517629,SE 150A,A00,187516,Staff,9,0,20,11
1683647518657,SE 154,A00,187528,Staff,29,0,50,21
1683647519680,SIO 3,A01,258171,Staff,35,0,40,5
1683647520706,SIO 10,A00,187144,Cook; Geoffrey W,0,6,75,75
1683647521739,SIO 45,A00,187152,Cook; Geoffrey W,0,4,100,100
1683647522762,SIO 109R,A00,194486,Staff,0,4,20,20
1683647524818,SIO 187,A01,187233,Kacev; David,12,0,40,28
1683647525846,SOCI 1,A01,258656,Thorpe; Charles Robert,28,0,30,2
1683647525846,SOCI 1,A02,258658,Thorpe; Charles Robert,30,0,30,0
1683647525846,SOCI 1,A03,258661,Thorpe; Charles Robert,25,0,25,0
1683647525846,SOCI 1,A04,258666,Thorpe; Charles Robert,22,0,25,3
1683647525846,SOCI 1,A05,258897,Thorpe; Charles Robert,22,0,25,3
1683647525846,SOCI 1,A06,258898,Thorpe; Charles Robert,25,0,25,0
1683647526874,SOCI 30,A01,258903,Pardo Guerra; Juan Pablo,14,0,30,16
1683647527898,SOCI 102,A00,258904,Staff,9,0,25,16
1683647528923,SOCI 106,A00,258905,Staff,19,0,25,6
1683647529950,SOCI 111,A00,258907,Ribas Norris; Janet Vanesa,26,0,30,4
1683647530974,SOCI 121R,A00,258908,Pardo Guerra; Juan Pablo,8,0,30,22
1683647532004,SOCI 126,A01,203330,Staff,14,0,20,6
1683647533029,SOCI 131,A00,258909,Thorpe; Charles Robert,30,0,60,30
1683647534053,SOCI 135,A00,258910,Payne; Christine Anna,0,11,30,30
1683647535079,SOCI 157,A00,258911,Staff,12,0,30,18
1683647536103,SOCI 184,A00,258912,Staff,25,0,30,5
1683647537131,SOCI 188D,A00,258913,Staff,22,0,30,8
1683647538169,SYN 2,001,187529,Staff,9,0,16,7
1683647538169,SYN 2,002,201452,Staff,0,20,16,16
1683647538169,SYN 2,003,201469,Staff,2,0,16,14
1683647539196,SYN 100,A01,187531,Staff,0,9,20,20
1683647539196,SYN 100,B01,201491,Staff,0,10,20,20
1683647540222,TDAC 1,A00,189286,Walsh; Kim C.,3,0,20,17
1683647540222,TDAC 1,B00,189287,Harting; Carla Kelso,10,0,20,10
1683647541250,TDAC 101,A00,189300,Walsh; Kim C.,16,0,20,4
1683647541250,TDAC 101,B00,189301,Harting; Carla Kelso,18,0,20,2
1683647542275,TDAC 102,A00,189304,Basso; Beatrice,14,0,20,6
1683647543300,TDAC 108,A00,189305,Staff,18,0,20,2
1683647544329,TDDE 131,A00,189310,Staff,19,0,20,1
1683647544329,TDDE 131,B00,189314,Staff,19,0,20,1
1683647544329,TDDE 131,C00,189315,Staff,48,0,50,2
1683647544329,TDDE 131,D00,189316,Staff,14,0,15,1
1683647544329,TDDE 131,E00,204841,Staff,20,0,20,0
1683647545354,TDGE 10,A00,189289,Staff,27,0,50,23
1683647545354,TDGE 10,B00,189290,Havis; Allan,0,0,50,50
1683647546382,TDGE 11,A00,189291,Fulton; Julia,0,4,50,50
1683647546382,TDGE 11,B00,189292,Staff,20,0,25,5
1683647546382,TDGE 11,C00,260270,Staff,0,0,0,0
1683647547407,TDGE 25,A00,189294,Staff,2,0,20,18
1683647548430,TDGE 124,A00,189318,Fulton; Julia,0,8,50,50
1683647549458,TDGE 125,A00,189319,Staff,13,0,25,12
1683647549458,TDGE 125,B00,189320,Staff,23,0,25,2
1683647550482,TDGE 127,A00,189322,Havis; Allan,0,0,50,50
1683647551508,TDHT 101,A00,189323,Staff,18,0,25,7
1683647551508,TDHT 101,B00,189324,Staff,25,0,25,0
1683647552535,TDHT 102,A00,189325,Staff,49,0,50,1
1683647553560,TDMV 1,A00,189295,Arcidiacono; Kristin,20,0,30,10
1683647553560,TDMV 1,B00,189296,Caligagan; Maria T.,24,0,30,6
1683647554584,TDMV 2,A00,189297,Sammartano; Tonnie,27,0,30,3
1683647554584,TDMV 2,B00,189299,Arcidiacono; Kristin,23,0,30,7
1683647555614,TDMV 3,A00,204998,Rincon; Alicia,22,0,30,8
1683647556642,TDMV 120,A00,189458,Sammartano; Tonnie,28,0,30,2
1683647557666,TDMV 138,A00,189541,Jun; Grace Shin Hae,20,0,40,20
1683647558690,TDMV 142,A00,189717,Caligagan; Tony,25,0,30,5
1683647558690,TDMV 142,B00,189718,Caligagan; Maria T.,25,0,30,5
1683647559714,TMC 2,A01,187533,Staff,25,0,25,0
1683647559714,TMC 2,A02,187534,Staff,25,0,25,0
1683647560739,USP 1,A01,187536,Kwak; Nancy,0,16,25,25
1683647561766,USP 5,A01,187538,Staff,9,0,25,16
1683647562791,USP 101,A00,199253,Staff,0,4,0,0
1683647563820,USP 124,A00,187562,Boomhower; Matthew Charles,0,0,30,30
1683647564848,USP 138,A00,187582,Staff,20,0,25,5
1683647565873,USP 152,A01,187597,Staff,3,0,25,22
1683647566907,USP 153,A00,187598,Staff,19,0,25,6
1683647567931,USP 168,A00,187607,Kwak; Nancy,2,0,5,3
1683647568955,USP 173,A00,187619,Staff,4,0,25,21
1683647569983,USP 181,A00,187638,Staff,0,4,25,25
1683647571008,VIS 103,A00,187650,Cruz; Edwin Teddy,18,0,75,57
1683647572032,VIS 110D,A00,187669,Staff,13,0,22,9
1683647573061,VIS 127C,A00,187720,Shen; Kuiyi,67,0,146,79
1683647574088,VIS 149,A00,187731,Yoldas; Pinar,0,14,22,22
1683647575117,VIS 151,A01,188091,Staff,22,0,34,12
1683647575117,VIS 151,A02,188092,Staff,11,0,34,23
1683647576144,VIS 160B,A00,188093,Stalbaum; Brett,0,1,10,10
1683647578262,WCWP 10B,A00,201720,Staff,10,0,15,5
1683647578262,WCWP 10B,B00,201722,Staff,9,0,15,6
1683647579289,WCWP 100,A00,201725,Gagnon; Jeffrey C,0,0,2,2
1683647579289,WCWP 100,B00,201727,Staff,0,4,15,15
1683647582416,ANBI 133,A00,258401,Wilder; Linnea Lorene,34,0,40,6
1683647583439,ANBI 140,A00,258395,Hrvoj Mihic; Branka,18,0,25,7
1683647584461,ANSC 120,A00,258402,Bialecki; Jon Anthony,26,0,40,14
1683647585486,ANSC 144,A00,258400,Staff,12,0,40,28
1683647587541,ANSC 166,A00,258396,Parish; Steven Martin,156,0,175,19
1683647588567,ANSC 180,A00,193533,Staff,8,0,20,12
1683647589593,ANSC 188,A00,258397,Jassal; Aftab,34,0,40,6
1683647590618,ANTH 3,A01,258316,Staff,23,0,30,7
1683647591644,ANTH 5,A00,258394,Semendeferi; Ekaterini,16,0,20,4
1683647592671,ANTH 21,A01,258331,Staff,4,0,40,36
1683647593701,ANTH 103,A00,258398,Varma; Saiba,15,0,25,10
1683647594732,AWP 10,001,202034,Staff,0,0,0,0
1683647594732,AWP 10,002,202035,Staff,0,0,0,0
1683647594732,AWP 10,003,202036,Staff,0,0,0,0
1683647594732,AWP 10,004,202037,Staff,0,0,0,0
1683647594732,AWP 10,005,202038,Staff,0,0,0,0
1683647594732,AWP 10,006,202039,Staff,0,0,0,0
1683647594732,AWP 10,007,202040,Staff,0,0,0,0
1683647594732,AWP 10,008,202041,Staff,0,0,0,0
1683647594732,AWP 10,009,202042,Staff,0,0,0,0
1683647594732,AWP 10,010,202043,Staff,0,0,0,0
1683647594732,AWP 10,011,202044,Staff,0,0,0,0
1683647594732,AWP 10,012,202045,Staff,0,0,0,0
1683647594732,AWP 10,013,202046,Staff,0,0,0,0
1683647594732,AWP 10,014,202047,Staff,0,0,0,0
1683647594732,AWP 10,015,202048,Staff,0,0,0,0
1683647594732,AWP 10,016,202049,Staff,0,0,0,0
1683647594732,AWP 10,017,202050,Staff,0,0,0,0
1683647594732,AWP 10,018,202051,Staff,0,0,0,0
1683647594732,AWP 10,019,202052,Staff,0,0,0,0
1683647594732,AWP 10,020,202053,Staff,0,0,0,0
1683647594732,AWP 10,021,202054,Staff,0,0,0,0
1683647594732,AWP 10,022,202055,Staff,0,0,0,0
1683647594732,AWP 10,023,202056,Staff,0,0,0,0
1683647594732,AWP 10,024,202057,Staff,0,0,0,0
1683647594732,AWP 10,025,202058,Staff,0,0,0,0
1683647594732,AWP 10,026,202059,Staff,0,0,0,0
1683647595756,AWP 102,001,202032,Staff,0,0,0,0
1683647595756,AWP 102,002,202033,Staff,0,0,0,0
1683647596795,BENG 100,A01,254234,Taylor Amos; Alyssa C,31,0,40,9
1683647597821,BENG 196,001,270013,Engler; Adam J.,9999,0,9999,0
1683647598849,BICD 100R,A01,202018,Smith; Laurie,0,7,32,32
1683647598849,BICD 100R,A02,202019,Smith; Laurie,0,3,32,32
1683647598849,BICD 100R,A03,202020,Smith; Laurie,0,1,32,32
1683647598849,BICD 100R,A04,202021,Smith; Laurie,6,0,32,26
1683647598849,BICD 100R,A05,202022,Smith; Laurie,11,0,32,21
1683647599878,BICD 136,A01,193242,Gustafson-Brown; Cindy,0,2,32,32
1683647599878,BICD 136,A02,193244,Gustafson-Brown; Cindy,13,0,32,19
1683647600903,BIEB 102,A01,193249,Butler; Shannon Rhey,0,2,32,32
1683647600903,BIEB 102,A02,193251,Butler; Shannon Rhey,0,0,32,32
1683647600903,BIEB 102,A03,193253,Butler; Shannon Rhey,0,0,32,32
1683647600903,BIEB 102,A04,193255,Butler; Shannon Rhey,14,0,32,18
1683647600903,BIEB 102,A05,193265,Butler; Shannon Rhey,26,0,32,6
1683647600903,BIEB 102,A06,193269,Butler; Shannon Rhey,14,0,32,18
1683647602956,BIEB 150,A01,193274,Staff,0,0,32,32
1683647602956,BIEB 150,A02,193285,Staff,24,0,32,8
1683647603984,BIEB 194,A00,193286,Kurle; Carolyn M.,20,0,32,12
1683647605013,BILD 1,A01,192291,Staff,15,0,32,17
1683647605013,BILD 1,A02,192292,Staff,30,0,32,2
1683647605013,BILD 1,B01,192520,Reuther; Keefe,0,1,0,0
1683647605013,BILD 1,B02,192532,Reuther; Keefe,0,1,0,0
1683647606038,BILD 3,A01,192556,Butler; Shannon Rhey,0,0,32,32
1683647606038,BILD 3,A02,192581,Butler; Shannon Rhey,1,0,32,31
1683647606038,BILD 3,A03,192611,Butler; Shannon Rhey,21,0,32,11
1683647606038,BILD 3,A04,192612,Butler; Shannon Rhey,24,0,32,8
1683647606038,BILD 3,A05,192613,Butler; Shannon Rhey,26,0,32,6
1683647606038,BILD 3,A06,192679,Butler; Shannon Rhey,27,0,32,5
1683647606038,BILD 3,A07,192682,Butler; Shannon Rhey,20,0,32,12
1683647607064,BILD 4,A01,192836,Reuther; Keefe,0,0,24,24
1683647607064,BILD 4,A02,193044,Reuther; Keefe,4,0,24,20
1683647608085,BILD 10,A01,193142,Gustafson-Brown; Cindy,29,0,32,3
1683647608085,BILD 10,A02,193149,Gustafson-Brown; Cindy,31,0,32,1
1683647609113,BIMM 100,A01,193301,Staff,0,6,32,32
1683647609113,BIMM 100,A02,193312,Staff,0,7,32,32
1683647609113,BIMM 100,A03,193323,Staff,0,9,32,32
1683647610139,BIMM 101,A01,193329,McDonnell; Lisa Marie,0,4,24,24
1683647610139,BIMM 101,A02,193339,McDonnell; Lisa Marie,0,3,24,24
1683647610139,BIMM 101,B01,193354,McDonnell; Lisa Marie,0,4,24,24
1683647610139,BIMM 101,B02,193357,McDonnell; Lisa Marie,0,3,24,24
1683647611162,BIMM 110,A01,193377,Tat; John,0,11,32,32
1683647611162,BIMM 110,A02,193378,Tat; John,0,10,32,32
1683647612190,BIMM 120,A01,206116,Staff,0,0,32,32
1683647612190,BIMM 120,A02,206117,Staff,6,0,32,26
1683647612190,BIMM 120,A03,206121,Staff,21,0,32,11
1683647613218,BIPN 100,A01,193393,Park; Ji Young,0,14,32,32
1683647613218,BIPN 100,A02,193402,Park; Ji Young,0,14,32,32
1683647613218,BIPN 100,A03,193413,Park; Ji Young,0,14,32,32
1683647613218,BIPN 100,A04,193414,Park; Ji Young,0,13,32,32
1683647614245,BIPN 102,A01,193429,Staff,0,0,32,32
1683647614245,BIPN 102,A02,193438,Staff,18,0,32,14
1683647615270,BIPN 106,A01,193450,Reyes Gonzalez; Catalina,0,2,40,40
1683647616294,BIPN 134,A01,193465,Cooke; James Edward,0,0,32,32
1683647616294,BIPN 134,A02,193474,Cooke; James Edward,25,0,32,7
1683647616294,BIPN 134,A03,193485,Cooke; James Edward,29,0,32,3
1683647616294,BIPN 134,A04,193486,Cooke; James Edward,20,0,32,12
1683647616294,BIPN 134,A05,193491,Cooke; James Edward,31,0,32,1
1683647616294,BIPN 134,A06,193501,Cooke; James Edward,30,0,32,2
1683647616294,BIPN 134,A07,193510,Cooke; James Edward,29,0,32,3
1683647618349,BISP 194,A00,222522,Staff,14,0,32,18
1683647619376,CAT 124,A01,202407,Staff,19,0,25,6
1683647620403,CAT 125,A00,202408,Marchisotto; Jennifer Anne,2,0,20,18
1683647621427,CAT 125R,A00,202409,Smith; Lauryn Alissa,0,11,20,20
1683647621427,CAT 125R,B00,202410,Morales; Celeste Georgianna,0,11,20,20
1683647621427,CAT 125R,C00,202411,Irwin; Matthew Joseph,0,12,20,20
1683647622452,CENG 15,A01,204712,Yang; Kesong,0,1,0,0
1683647623476,CENG 114,A00,202070,Jahed Motlagh; Zeinab,5,0,20,15
1683647624502,CGS 105,A00,185477,Wesling; Megan E.,24,0,40,16
1683647625524,CGS 106,A00,185494,Staff,11,0,22,11
1683647626551,CGS 108,A00,185495,Staff,14,0,20,6
1683647627577,CGS 114,A00,185496,Staff,13,0,18,5
1683647628601,CGS 119,A00,185501,Staff,15,0,20,5
1683647629625,CGS 120,A00,185511,Staff,12,0,20,8
1683647630650,CHEM 4,A01,184675,Bussey; Thomas J,97,0,100,3
1683647631675,CHEM 6A,A01,184677,Staff,33,0,60,27
1683647632700,CHEM 6B,A01,184679,Staff,63,0,100,37
1683647633728,CHEM 6C,A01,184681,Bussey; Thomas J,0,0,50,50
1683647633728,CHEM 6C,A02,184682,Bussey; Thomas J,32,0,50,18
1683647634753,CHEM 40A,A01,184684,Albizati; Kim F.,34,0,100,66
1683647635781,CHEM 40B,A01,184686,Albizati; Kim F.,0,22,100,100
1683647636806,CHEM 41B,A01,184690,Staff,51,0,100,49
1683647637830,COGS 3,A01,184715,Boyle; Mary E. T.,0,27,40,40
1683647638864,COGS 14B,A01,185172,Staff,0,14,38,38
1683647639890,COGS 18,A01,184736,Staff,14,0,80,66
1683647640919,COGS 100,A01,184932,Staff,0,7,73,73
1683647641950,COGS 101A,A01,184935,Staff,0,39,30,30
1683647642981,COGS 101B,A01,184944,Staff,0,2,30,30
1683647644006,COGS 101C,A01,184946,Staff,0,10,30,30
1683647645029,COGS 102A,A01,184951,Johnson; Christine M.,2,0,40,38
1683647646053,COGS 107B,A01,184953,Mooshagian; Eric Frederick,0,51,40,40
1683647647081,COGS 118B,A01,184959,Gupta; Anjum,0,49,40,40
1683647648106,COGS 153,A00,184961,Staff,0,16,30,30
1683647649132,COGS 177,A00,184962,Staff,0,21,30,30
1683647650154,COGS 187A,A01,184969,Boyle; Mary E. T.,0,19,40,40
1683647651180,COMM 10,A01,185174,Staff,0,5,25,25
1683647651180,COMM 10,A02,185189,Staff,0,2,25,25
1683647651180,COMM 10,A03,269821,Staff,0,1,0,0
1683647652203,COMM 100B,A01,185475,Staff,0,1,0,2
1683647652203,COMM 100B,A02,185476,Staff,12,0,25,13
1683647653228,COMM 100C,A01,185314,Staff,1,0,25,24
1683647653228,COMM 100C,A02,185327,Staff,18,0,25,7
1683647654253,COMM 110M,A00,185349,Staff,0,0,40,40
1683647655277,COMM 113T,A00,185352,Staff,25,0,40,15
1683647656305,COMM 114I,A00,185353,Staff,31,0,40,9
1683647657329,COMM 131,A00,185354,Staff,17,0,30,13
1683647658357,CSE 8A,A50,185358,Cao; Yingjun,0,46,10,10
1683647659380,CSE 8B,A01,185362,Staff,0,48,50,50
1683647660408,CSE 11,A01,185416,Cao; Yingjun,0,91,10,10
1683647661432,CSE 20,A01,185445,Briones; Jor-el Thomas Caparas,4,0,25,21
1683647662456,CSE 21,A01,185447,Staff,9,0,50,41
1683647663481,CSE 101,A01,185451,Staff,0,13,50,50
1683647663481,CSE 101,B01,185453,Jones; Miles E,0,13,50,50
1683647665529,CSE 141,A01,185458,Eldon; John,16,0,100,84
1683647666558,CSE 141L,A01,185461,Eldon; John,8,0,100,92
1683647667583,CSE 142,A01,185463,Staff,35,0,60,25
1683647667583,CSE 142,B01,201355,Staff,0,7,60,60
1683647668739,CSE 142L,A01,185470,Staff,35,0,60,25
1683647668739,CSE 142L,B01,201417,Staff,0,6,60,60
1683647669762,CSE 190,A00,201433,Staff,32,0,49,17
1683647670791,DOC 1,A01,259136,Strom; Megan C.,7,0,15,8
1683647670791,DOC 1,A02,259137,Strom; Megan C.,14,0,15,1
1683647670791,DOC 1,A03,259138,Strom; Megan C.,14,0,15,1
1683647670791,DOC 1,A04,259139,Strom; Megan C.,14,0,15,1
1683647671815,DOC 100D,A00,259140,Pass; Natalye Joann,14,0,25,11
1683647672842,DSGN 1,A01,184749,Rill; Bryan,0,26,30,30
1683647673870,DSGN 100,A01,185168,Staff,0,2,25,25
1683647674896,ECE 5,A01,185626,Morris; Karcher William,0,11,0,0
1683647675920,ECE 101,A01,185628,Staff,14,0,70,56
1683647676944,ECE 107,A01,185635,Baghdadchi; Saharnaz,0,0,20,20
1683647676944,ECE 107,A02,185638,Baghdadchi; Saharnaz,3,0,20,17
1683647677968,ECE 148,A01,185647,Silberman; Jack,0,0,16,16
1683647678996,ECON 1,A01,185537,Crane; Meredith Helen,54,0,70,16
1683647680023,ECON 3,A01,185549,Crane; Meredith Helen,29,0,70,41
1683647681047,ECON 4,A01,203354,Anderson; John Charles,0,5,10,10
1683647682142,ECON 100A,A01,185574,Staff,0,5,40,40
1683647683167,ECON 100B,A01,185576,Staff,0,12,50,50
1683647684193,ECON 100C,A01,185589,Newhouse; Herbert S,30,0,70,40
1683647685217,ECON 105,A00,185608,Vespa; Emanuel Ignacio,19,0,35,16
1683647686241,ECON 109,A01,185610,Shishkin; Denis,9,0,35,26
1683647687267,ECON 110A,A01,185612,Staff,9,0,40,31
1683647688294,ECON 120A,A01,185615,Staff,20,0,40,20
1683647689317,ECON 120C,A01,185617,Sun; Yixiao,0,20,70,70
1683647690348,ECON 144,A00,203346,Squires; Dale E,2,0,35,33
1683647691373,ECON 171,A01,203349,Newhouse; Herbert S,0,1,35,35
1683647692400,ECON 173A,A01,185621,Toda; Alexis Akira,21,0,35,14
1683647693432,EDS 25,A01,202413,Staff,0,1,0,0
1683647693432,EDS 25,A02,202414,Staff,0,1,0,0
1683647693432,EDS 25,A03,202415,Staff,0,0,0,0
1683647693432,EDS 25,A04,202416,Staff,0,1,0,0
1683647693432,EDS 25,A05,202439,Staff,0,0,0,0
1683647693432,EDS 25,A06,202440,Staff,0,0,0,0
1683647693432,EDS 25,B01,202631,Staff,0,0,0,0
1683647693432,EDS 25,B02,202632,Staff,0,0,0,0
1683647693432,EDS 25,B03,202639,Staff,0,0,0,0
1683647693432,EDS 25,B04,202640,Staff,0,0,0,0
1683647693432,EDS 25,B05,202643,Staff,0,0,0,0
1683647693432,EDS 25,B06,202644,Staff,0,0,0,0
1683647694456,EDS 38,A01,202659,Black; Alison Michelle,24,0,25,1
1683647695486,EDS 115,A00,202652,Staff,18,0,30,12
1683647696514,EDS 125,A00,202649,Staff,13,0,30,17
1683647697540,EDS 126,A01,203332,Staff,30,0,30,0
1683647698564,EDS 139,A00,202838,Staff,16,0,25,9
1683647699588,EDS 146,A01,202655,Staff,14,0,25,11
1683647700617,ENG 15,A00,185667,Staff,0,1,0,0
1683647700617,ENG 15,B00,185672,Staff,0,0,0,0
1683647700617,ENG 15,C00,185675,Staff,0,0,0,0
1683647700617,ENG 15,D00,185682,Staff,0,0,0,0
1683647700617,ENG 15,E00,185684,Staff,0,0,0,0
1683647701645,ETHN 103,A00,185710,Staff,0,8,35,35
1683647702676,ETHN 103A,A00,199228,Man; Simeon S,0,0,9,9
1683647703703,ETHN 109,A00,185711,Staff,16,0,35,19
1683647704728,ETHN 142,A00,185726,Staff,0,4,30,30
1683647705756,ETHN 163J,A00,199229,Man; Simeon S,5,0,8,3
1683647706780,ETHN 168,A00,185727,Staff,7,0,10,3
1683647707808,ETHN 182,A00,185728,Staff,0,0,35,35
1683647708832,ETHN 183,A00,185737,Staff,9,0,18,9
1683647709856,GLBH 111,A01,209361,Burgos; Jose L.,0,0,0,0
1683647711904,HIEU 104,A00,185792,Staff,14,0,20,6
1683647712928,HIEU 115,A00,185800,Staff,0,0,20,20
1683647713957,HIEU 128,A00,185801,Staff,0,9,20,20
1683647714988,HIEU 147,A00,185802,Staff,15,0,20,5
1683647716017,HIEU 154,A00,185823,Staff,11,0,20,9
1683647717041,HILA 102,A00,185826,Staff,14,0,20,6
1683647718069,HILD 2C,A01,185778,Staff,0,13,20,20
1683647719097,HILD 7B,A01,185780,Kwak; Nancy,0,16,32,32
1683647719097,HILD 7B,A02,185781,Kwak; Nancy,0,18,32,32
1683647720121,HILD 30,A01,185791,Staff,12,0,20,8
1683647721145,HISC 119,A00,185830,Golan; Tal,0,9,20,20
1683647722172,HITO 156GS,A00,185831,Patterson; Patrick H.,0,0,0,23
1683647723196,HIUS 103,A00,185832,Man; Simeon S,0,4,20,20
1683647724219,HIUS 117,A00,185836,Kwak; Nancy,2,0,20,18
1683647725242,HIUS 125,A00,185840,Man; Simeon S,0,1,23,23
1683647726266,HIUS 149,A00,185845,Staff,1,0,20,19
1683647727291,HUM 3,A01,185882,Zavodny; Tatiana Sophia,0,7,50,50
1683647727291,HUM 3,B01,185899,Caldwell; Michael Alan,0,18,50,50
1683647728312,HUM 3GS,A00,185900,Patterson; Patrick H.,0,0,0,23
1683647729335,HUM 4,A01,185938,Zroka; Amy Liane,30,0,50,20
1683647729335,HUM 4,B01,185956,Watkins; Eric,0,4,50,50
1683647729335,HUM 4,B02,202209,Watkins; Eric,0,4,50,50
1683647729335,HUM 4,B03,202210,Watkins; Eric,0,4,50,50
1683647730360,HUM 5,A01,185958,West; Geoffrey Scott,2,0,50,48
1683647730360,HUM 5,A02,202215,West; Geoffrey Scott,0,0,50,50
1683647731382,INTL 190,A00,185959,Gagnon; Jeffrey C,0,0,0,9
1683647731382,INTL 190,B00,185960,Lettieri; Michael Joseph,0,0,0,2
1683647732409,JAPN 180,A00,254509,Staff,5,0,30,25
1683647733437,LATI 10,A01,202853,Kennemore; Amy Michelle,4,0,35,31
1683647733437,LATI 10,A02,202854,Kennemore; Amy Michelle,2,0,35,33
1683647733437,LATI 10,A03,270054,Kennemore; Amy Michelle,30,0,30,0
1683647734463,LATI 180,A00,202855,Kennemore; Amy Michelle,11,0,20,9
1683647735488,LAWS 101,A00,201767,Golan; Tal,0,7,40,40
1683647736517,LIFR 1C,A00,185961,Staff,6,0,20,14
1683647737541,LIFR 1CX,A00,185962,Staff,7,0,20,13
1683647738565,LIFR 1D,A00,185963,Staff,7,0,20,13
1683647739592,LIFR 1DX,A00,185964,Staff,7,0,20,13
1683647740618,LIGN 101,A01,186039,Staff,43,0,50,7
1683647741644,LIGN 165,A00,186040,Staff,15,0,50,35
1683647742670,LTCS 108,A00,186041,Staff,5,0,10,5
1683647743694,LTCS 119,A00,186042,Staff,15,0,20,5
1683647744719,LTCS 130,A00,186043,Wesling; Megan E.,15,0,25,10
1683647746768,LTEA 138,A00,186119,Staff,14,0,40,26
1683647747793,LTEN 124,A00,186148,Staff,5,0,25,20
1683647748817,LTEN 178,A00,186149,Staff,7,0,15,8
1683647749844,LTEN 181,A00,186150,Blanco; John D,34,0,40,6
1683647750868,LTWL 120,A00,186160,Staff,20,0,25,5
1683647751895,LTWL 165,A00,186161,Staff,22,0,25,3
1683647752922,LTWR 100,A00,186162,Staff,0,5,15,15
1683647753950,LTWR 102,A00,186163,Doller; Ben,5,0,15,10
1683647754974,MAE 8,A01,186412,Staff,0,0,0,0
1683647755998,MAE 30B,A00,186445,Bahadori; Mohammad Yousef,82,0,100,18
1683647757023,MAE 40,A00,186592,Bewley; Thomas R,10,0,50,40
1683647758048,MAE 101B,A00,186593,Bahadori; Mohammad Yousef,80,0,100,20
1683647759073,MAE 105,A00,186594,Bandaru; Prabhakar,10,0,50,40
1683647760100,MAE 107,A00,186599,Pham; Hieu Tan,0,7,120,120
1683647761123,MAE 148,A01,186660,Silberman; Jack,3,0,16,13
1683647762147,MATH 10A,A01,188095,Staff,0,5,35,35
1683647763177,MATH 10B,A01,188097,Bowers; Adam R.,0,11,30,30
1683647763177,MATH 10B,A02,188099,Bowers; Adam R.,0,11,30,30
1683647763177,MATH 10B,B01,188104,Bowers; Adam R.,0,10,30,30
1683647763177,MATH 10B,B02,188106,Bowers; Adam R.,1,9,30,29
1683647764201,MATH 10C,A01,188111,Staff,0,18,30,30
1683647764201,MATH 10C,A02,188127,Staff,0,19,30,30
1683647764201,MATH 10C,A03,188131,Staff,0,19,30,30
1683647764201,MATH 10C,B01,188218,Staff,17,0,30,13
1683647764201,MATH 10C,B02,188244,Staff,13,0,30,17
1683647764201,MATH 10C,B03,188277,Staff,14,0,30,16
1683647765226,MATH 18,A01,188344,Bach; Quang Tran,18,0,30,12
1683647765226,MATH 18,A02,188345,Bach; Quang Tran,11,0,30,19
1683647765226,MATH 18,B01,188353,Bach; Quang Tran,11,0,30,19
1683647765226,MATH 18,B02,188354,Bach; Quang Tran,19,0,30,11
1683647766254,MATH 20A,A01,188374,Staff,11,0,35,24
1683647767278,MATH 20B,A01,188382,Ohm; Ko Woon,7,0,30,23
1683647767278,MATH 20B,A02,188383,Ohm; Ko Woon,22,0,30,8
1683647767278,MATH 20B,B01,188385,Ohm; Ko Woon,7,0,30,23
1683647767278,MATH 20B,B02,188392,Ohm; Ko Woon,22,0,30,8
1683647768302,MATH 20C,A01,188394,Harel; Guershon,11,0,30,19
1683647768302,MATH 20C,A02,188395,Harel; Guershon,13,0,30,17
1683647768302,MATH 20C,B01,188404,Harel; Guershon,5,0,30,25
1683647768302,MATH 20C,B02,188405,Harel; Guershon,18,0,30,12
1683647769333,MATH 20D,A01,188414,Hammock; Frances H,0,1,30,30
1683647769333,MATH 20D,A02,188415,Hammock; Frances H,0,1,30,30
1683647769333,MATH 20D,B01,188447,Hammock; Frances H,0,1,30,30
1683647769333,MATH 20D,B02,188486,Hammock; Frances H,4,0,30,26
1683647770359,MATH 20E,A01,188649,Staff,21,0,30,9
1683647770359,MATH 20E,A02,188650,Staff,21,0,30,9
1683647770359,MATH 20E,A03,188673,Staff,0,0,30,30
1683647771391,MATH 102,A01,188675,Staff,0,36,35,35
1683647772417,MATH 103B,A01,188681,Staff,3,0,35,32
1683647772417,MATH 103B,B01,188692,Staff,5,0,35,30
1683647773441,MATH 109,A01,188695,Salehi Golsefidy; Alireza,24,0,35,11
1683647773441,MATH 109,A02,188696,Salehi Golsefidy; Alireza,25,0,35,10
1683647774466,MATH 120A,A01,188698,Eggers; John Dietrich,7,0,35,28
1683647775491,MATH 142B,A01,188736,Ioana; Adrian,0,1,30,30
1683647775491,MATH 142B,A02,188741,Ioana; Adrian,0,1,30,30
1683647775491,MATH 142B,A03,188743,Ioana; Adrian,0,1,30,30
1683647776518,MATH 168A,A01,188790,Staff,0,10,35,35
1683647777543,MATH 170A,A01,188803,Nie; Jiawang,0,2,35,35
1683647777543,MATH 170A,A02,188811,Nie; Jiawang,0,0,35,35
1683647777543,MATH 170A,A03,188814,Nie; Jiawang,0,0,35,35
1683647777543,MATH 170A,A04,188815,Nie; Jiawang,10,0,35,25
1683647778571,MATH 193B,A01,188817,Staff,0,0,35,35
1683647778571,MATH 193B,A02,188818,Staff,5,0,35,30
1683647779596,MGT 4,A01,202857,Anderson; John Charles,61,0,80,19
1683647780622,MGT 12,A00,202858,Lindenberger; Wade Douglas,40,0,90,50
1683647781648,MGT 18,A00,202859,Staff,74,0,90,16
1683647782672,MGT 18GS,A00,202860,McKay; Michael J,13,0,28,15
1683647783696,MGT 45,A00,202861,Pecore; Joseph P.,12,0,90,78
1683647784722,MGT 100,A00,202863,Yavorsky; Daniel Ryan,28,0,90,62
1683647785818,MGT 103,A00,202864,Ehrich; Kristine R,0,17,90,90
1683647786845,MGT 112,A00,202865,Ehrich; Kristine R,15,0,90,75
1683647787871,MGT 121A,A00,202868,Staff,0,20,0,0
1683647788894,MGT 131B,A00,202869,Anderson; John Charles,59,0,90,31
1683647789921,MGT 136,A00,202871,Lindenberger; Wade Douglas,83,0,90,7
1683647790951,MGT 164,A00,202873,Staff,0,66,90,91
1683647791977,MGT 164GS,A00,202874,McKay; Mary A,13,0,28,15
1683647793004,MGT 180,A00,202875,Staff,0,50,90,91
1683647794031,MMW 11R,A01,205019,Herbst; Matthew,2,0,30,28
1683647794031,MMW 11R,A02,205026,Herbst; Matthew,29,0,30,1
1683647795061,MMW 15,A01,193512,Chang; Edmond Yi-Teh,0,8,28,28
1683647795061,MMW 15,A02,193513,Chang; Edmond Yi-Teh,0,5,28,28
1683647795061,MMW 15,A03,193514,Chang; Edmond Yi-Teh,0,5,28,28
1683647795061,MMW 15,A04,193515,Chang; Edmond Yi-Teh,0,5,28,28
1683647795061,MMW 15,A05,193516,Chang; Edmond Yi-Teh,0,5,28,28
1683647795061,MMW 15,A06,193517,Chang; Edmond Yi-Teh,0,6,28,28
1683647795061,MMW 15,B01,193519,Chang; Edmond Yi-Teh,0,5,28,28
1683647795061,MMW 15,B02,193520,Chang; Edmond Yi-Teh,0,5,28,28
1683647795061,MMW 15,B03,193521,Chang; Edmond Yi-Teh,0,5,28,28
1683647795061,MMW 15,B04,193522,Chang; Edmond Yi-Teh,0,5,28,28
1683647795061,MMW 15,B05,193523,Chang; Edmond Yi-Teh,0,5,28,28
1683647795061,MMW 15,B06,193524,Chang; Edmond Yi-Teh,0,5,28,28
1683647796085,MMW 122,A01,193526,Rahimi; Babak,0,16,28,28
1683647796085,MMW 122,A02,193527,Rahimi; Babak,0,15,28,28
1683647796085,MMW 122,A03,193528,Rahimi; Babak,0,0,0,0
1683647796085,MMW 122,A04,193529,Rahimi; Babak,0,0,0,0
1683647797111,MUS 1A,A01,186663,Staff,1,20,35,34
1683647798139,MUS 4,A01,186715,Staff,0,12,35,35
1683647799162,MUS 5R,A01,186796,Dubnov; Shlomo,0,17,35,35
1683647800187,MUS 6,A01,186798,Staff,0,5,25,25
1683647801210,MUS 7,A01,186830,Staff,11,0,35,24
1683647802237,MUS 8,A01,186930,Staff,0,26,35,35
1683647803263,MUS 15,A01,186932,Staff,0,16,35,35
1683647803263,MUS 15,B01,186934,Staff,0,17,35,35
1683647804287,MUS 80,A00,186935,Staff,0,0,20,20
1683647804287,MUS 80,B00,186936,Staff,24,0,25,1
1683647805315,NANO 11,A00,204702,Lipomi; Darren John,0,0,0,0
1683647806343,NANO 15,A01,204709,Yang; Kesong,0,1,0,0
1683647807370,NANO 114,A00,202069,Jahed Motlagh; Zeinab,3,0,10,7
1683647808396,PHIL 1,A00,186955,Grush; Rick Scott,31,0,40,9
1683647809420,PHIL 10,A01,186973,Grush; Rick Scott,27,0,35,8
1683647809420,PHIL 10,A02,186974,Grush; Rick Scott,33,0,35,2
1683647810443,PHIL 13,A01,186976,Staff,3,0,35,32
1683647810443,PHIL 13,A02,186977,Staff,16,0,35,19
1683647811468,PHIL 14,A01,186979,Staff,31,0,35,4
1683647811468,PHIL 14,A02,186986,Staff,32,0,35,3
1683647812493,PHIL 28,A01,186988,Staff,16,0,30,14
1683647812493,PHIL 28,A02,186989,Staff,1,0,30,29
1683647812493,PHIL 28,A03,186990,Staff,10,0,30,20
1683647812493,PHIL 28,A04,186991,Staff,26,0,30,4
1683647813517,PHIL 120,A00,186997,Staff,23,0,40,17
1683647814545,PHIL 137,A00,187003,Staff,7,0,40,33
1683647815570,PHIL 150,A00,187015,Staff,47,0,70,23
1683647816595,PHIL 167,A00,187021,Lamey; Andy M.,34,0,40,6
1683647817623,PHIL 174,A01,202226,Staff,17,0,20,3
1683647817623,PHIL 174,A02,202235,Staff,20,0,20,0
1683647818647,PHIL 191A,A00,258918,Staff,0,0,1,1
1683647819671,PHYS 1A,A00,187028,Staff,27,0,60,33
1683647820696,PHYS 1AL,001,187036,Staff,3,0,30,27
1683647820696,PHYS 1AL,002,187049,Staff,18,0,30,12
1683647821723,PHYS 1B,A00,187058,Staff,22,0,60,38
1683647822755,PHYS 1BL,001,187064,Staff,0,1,30,30
1683647822755,PHYS 1BL,002,187070,Staff,4,0,30,26
1683647823778,PHYS 1C,A00,187082,Staff,29,0,120,91
1683647824803,PHYS 1CL,001,187088,Staff,0,9,30,30
1683647824803,PHYS 1CL,002,187089,Staff,0,1,30,30
1683647824803,PHYS 1CL,009,262693,Staff,9,0,30,21
1683647825826,PHYS 2B,A01,187097,Staff,55,0,115,60
1683647826854,PHYS 2C,A01,187099,Staff,64,0,115,51
1683647827879,PHYS 2CL,A01,187101,Staff,5,0,28,23
1683647827879,PHYS 2CL,A02,187102,Staff,15,0,28,13
1683647828904,PHYS 2D,A01,187123,Shotwell; Brian,95,0,115,20
1683647829931,PHYS 4B,A01,187133,Grinstein; Benjamin,35,0,50,15
1683647830955,POLI 10,A00,188819,Staff,0,4,50,50
1683647831984,POLI 11,A00,188827,Staff,43,0,50,7
1683647833011,POLI 13R,A00,188828,Staff,0,1,20,20
1683647834042,POLI 27,A01,188830,Elgin; Samuel Zincke,0,2,70,70
1683647835071,POLI 30,A00,188832,Desposato; Scott,30,0,50,20
1683647836098,POLI 102F,A00,188834,Staff,0,0,40,40
1683647837121,POLI 104A,A00,188852,Staff,13,0,30,17
1683647838151,POLI 104I,A00,188853,Staff,0,7,20,20
1683647839177,POLI 110B,A00,188854,Wiens; David,7,0,20,13
1683647840204,POLI 112A,A00,188855,Wiens; David,4,0,30,26
1683647841228,POLI 117R,A00,188856,Forman; Fonna,0,12,20,20
1683647842252,POLI 118,A00,188857,Ingham; Sean,8,0,20,12
1683647843278,POLI 120G,A00,188858,Staff,8,0,30,22
1683647844302,POLI 131CR,A00,188863,Hoston; Germaine,21,0,50,29
1683647845326,POLI 133,A00,188864,Nellis; Gareth Hb,44,0,50,6
1683647846350,POLI 134D,A00,188865,Desposato; Scott,27,0,30,3
1683647847375,POLI 142A,A00,188871,Gartzke; Erik,21,0,50,29
1683647848400,POLI 142K,A00,188874,Staff,38,0,50,12
1683647849427,POLI 143,A00,188940,Gartzke; Erik,16,0,30,14
1683647850453,POLI 153,A00,188943,Staff,2,0,20,18
1683647851480,POLI 160AA,A00,188944,Staff,11,0,40,29
1683647852507,POLI 170A,A00,188945,Staff,11,0,30,19
1683647854555,PSYC 1,A00,188952,Staff,36,0,90,54
1683647855580,PSYC 2,B00,188953,Staff,19,0,35,16
1683647856604,PSYC 6,A00,188970,Staff,47,0,60,13
1683647857630,PSYC 7,A00,188973,Staff,35,0,45,10
1683647858655,PSYC 60,A01,188980,Rickard; Timothy C.,42,0,60,18
1683647859683,PSYC 70,A01,189001,Steiner; Eric Tomas,23,0,45,22
1683647860708,PSYC 100,A00,189005,Lacefield; Katharine I,0,99,120,120
1683647861735,PSYC 102,A00,189008,Staff,8,0,30,22
1683647862763,PSYC 106,B00,189026,Gorman; Michael R.,27,0,60,33
1683647863787,PSYC 114,B01,189033,Winkielman; Piotr,0,31,30,30
1683647864819,PSYC 131,A00,189036,Anagnostaras; Stephan,0,43,60,60
1683647865841,PSYC 136,A00,189041,Lowe; Angela Beth,0,7,25,25
1683647866866,PSYC 137,A00,189057,Winkielman; Piotr,0,37,25,25
1683647867894,PSYC 144,A00,189107,Wixted; John T,0,10,50,50
1683647869945,PSYC 162,A00,189142,Staff,0,9,85,85
1683647870971,PSYC 172,A00,189144,Gorman; Michael R.,0,6,30,30
1683647873026,PSYC 179,A00,189146,Lacefield; Katharine I,0,86,120,120
1683647874051,PSYC 181,A00,189147,Anagnostaras; Stephan,0,44,90,90
1683647875074,PSYC 190R,A00,189148,Barner; David A.,0,23,80,80
1683647876098,PSYC 191,A00,189275,Rickard; Timothy C.,0,10,25,25
1683647877122,PSYC 193,A00,189276,Chapman; Eddie Nathaniel,0,1,0,4
1683647878147,PSYC 193L,A01,189281,Lowe; Angela Beth,10,0,20,10
1683647878147,PSYC 193L,B01,189285,Staff,28,0,35,7
1683647879170,RELI 149,A00,187137,Rahimi; Babak,7,0,40,33
1683647880198,SE 9,A01,187315,Staff,0,2,18,18
1683647881239,SE 101B,A00,187409,Staff,24,0,30,6
1683647882261,SE 110B,A00,187444,Staff,10,0,40,30
1683647883295,SE 130B,A00,187449,Staff,31,0,40,9
1683647884323,SE 150A,A00,187516,Staff,9,0,20,11
1683647885349,SE 154,A00,187528,Staff,29,0,50,21
1683647886378,SIO 3,A01,258171,Staff,35,0,40,5
1683647887403,SIO 10,A00,187144,Cook; Geoffrey W,0,6,75,75
1683647888426,SIO 45,A00,187152,Cook; Geoffrey W,0,4,100,100
1683647889511,SIO 109R,A00,194486,Staff,0,4,20,20
1683647891560,SIO 187,A01,187233,Kacev; David,12,0,40,28
1683647892589,SOCI 1,A01,258656,Thorpe; Charles Robert,28,0,30,2
1683647892589,SOCI 1,A02,258658,Thorpe; Charles Robert,30,0,30,0
1683647892589,SOCI 1,A03,258661,Thorpe; Charles Robert,25,0,25,0
1683647892589,SOCI 1,A04,258666,Thorpe; Charles Robert,22,0,25,3
1683647892589,SOCI 1,A05,258897,Thorpe; Charles Robert,22,0,25,3
1683647892589,SOCI 1,A06,258898,Thorpe; Charles Robert,25,0,25,0
1683647893612,SOCI 30,A01,258903,Pardo Guerra; Juan Pablo,14,0,30,16
1683647894639,SOCI 102,A00,258904,Staff,9,0,25,16
1683647895665,SOCI 106,A00,258905,Staff,19,0,25,6
1683647896695,SOCI 111,A00,258907,Ribas Norris; Janet Vanesa,26,0,30,4
1683647897721,SOCI 121R,A00,258908,Pardo Guerra; Juan Pablo,8,0,30,22
1683647898747,SOCI 126,A01,203330,Staff,14,0,20,6
1683647899772,SOCI 131,A00,258909,Thorpe; Charles Robert,30,0,60,30
1683647900796,SOCI 135,A00,258910,Payne; Christine Anna,0,11,30,30
1683647901822,SOCI 157,A00,258911,Staff,12,0,30,18
1683647902848,SOCI 184,A00,258912,Staff,25,0,30,5
1683647903875,SOCI 188D,A00,258913,Staff,22,0,30,8
1683647904900,SYN 2,001,187529,Staff,9,0,16,7
1683647904900,SYN 2,002,201452,Staff,0,20,16,16
1683647904900,SYN 2,003,201469,Staff,2,0,16,14
1683647905924,SYN 100,A01,187531,Staff,0,9,20,20
1683647905924,SYN 100,B01,201491,Staff,0,10,20,20
1683647906948,TDAC 1,A00,189286,Walsh; Kim C.,3,0,20,17
1683647906948,TDAC 1,B00,189287,Harting; Carla Kelso,10,0,20,10
1683647907974,TDAC 101,A00,189300,Walsh; Kim C.,16,0,20,4
1683647907974,TDAC 101,B00,189301,Harting; Carla Kelso,18,0,20,2
1683647909001,TDAC 102,A00,189304,Basso; Beatrice,14,0,20,6
1683647910030,TDAC 108,A00,189305,Staff,18,0,20,2
1683647911060,TDDE 131,A00,189310,Staff,19,0,20,1
1683647911060,TDDE 131,B00,189314,Staff,19,0,20,1
1683647911060,TDDE 131,C00,189315,Staff,48,0,50,2
1683647911060,TDDE 131,D00,189316,Staff,14,0,15,1
1683647911060,TDDE 131,E00,204841,Staff,20,0,20,0
1683647912084,TDGE 10,A00,189289,Staff,27,0,50,23
1683647912084,TDGE 10,B00,189290,Havis; Allan,0,0,50,50
1683647913107,TDGE 11,A00,189291,Fulton; Julia,0,4,50,50
1683647913107,TDGE 11,B00,189292,Staff,20,0,25,5
1683647913107,TDGE 11,C00,260270,Staff,0,0,0,0
1683647914131,TDGE 25,A00,189294,Staff,2,0,20,18
1683647915156,TDGE 124,A00,189318,Fulton; Julia,0,8,50,50
1683647916181,TDGE 125,A00,189319,Staff,13,0,25,12
1683647916181,TDGE 125,B00,189320,Staff,23,0,25,2
1683647917208,TDGE 127,A00,189322,Havis; Allan,0,0,50,50
1683647918232,TDHT 101,A00,189323,Staff,18,0,25,7
1683647918232,TDHT 101,B00,189324,Staff,25,0,25,0
1683647919259,TDHT 102,A00,189325,Staff,49,0,50,1
1683647920282,TDMV 1,A00,189295,Arcidiacono; Kristin,20,0,30,10
1683647920282,TDMV 1,B00,189296,Caligagan; Maria T.,24,0,30,6
1683647921306,TDMV 2,A00,189297,Sammartano; Tonnie,27,0,30,3
1683647921306,TDMV 2,B00,189299,Arcidiacono; Kristin,23,0,30,7
1683647922330,TDMV 3,A00,204998,Rincon; Alicia,22,0,30,8
1683647923354,TDMV 120,A00,189458,Sammartano; Tonnie,28,0,30,2
1683647924377,TDMV 138,A00,189541,Jun; Grace Shin Hae,20,0,40,20
1683647925401,TDMV 142,A00,189717,Caligagan; Tony,25,0,30,5
1683647925401,TDMV 142,B00,189718,Caligagan; Maria T.,25,0,30,5
1683647926429,TMC 2,A01,187533,Staff,25,0,25,0
1683647926429,TMC 2,A02,187534,Staff,25,0,25,0
1683647927455,USP 1,A01,187536,Kwak; Nancy,0,16,25,25
1683647928478,USP 5,A01,187538,Staff,9,0,25,16
1683647929502,USP 101,A00,199253,Staff,0,4,0,0
1683647930532,USP 124,A00,187562,Boomhower; Matthew Charles,0,0,30,30
1683647931558,USP 138,A00,187582,Staff,20,0,25,5
1683647932586,USP 152,A01,187597,Staff,3,0,25,22
1683647933610,USP 153,A00,187598,Staff,19,0,25,6
1683647934638,USP 168,A00,187607,Kwak; Nancy,2,0,5,3
1683647935664,USP 173,A00,187619,Staff,4,0,25,21
1683647936692,USP 181,A00,187638,Staff,0,4,25,25
1683647937719,VIS 103,A00,187650,Cruz; Edwin Teddy,18,0,75,57
1683647938742,VIS 110D,A00,187669,Staff,13,0,22,9
1683647939770,VIS 127C,A00,187720,Shen; Kuiyi,67,0,146,79
1683647940796,VIS 149,A00,187731,Yoldas; Pinar,0,14,22,22
1683647941820,VIS 151,A01,188091,Staff,22,0,34,12
1683647941820,VIS 151,A02,188092,Staff,11,0,34,23
1683647942844,VIS 160B,A00,188093,Stalbaum; Brett,0,1,10,10
1683647944900,WCWP 10B,A00,201720,Staff,10,0,15,5
1683647944900,WCWP 10B,B00,201722,Staff,9,0,15,6
1683647945925,WCWP 100,A00,201725,Gagnon; Jeffrey C,0,0,2,2
1683647945925,WCWP 100,B00,201727,Staff,0,4,15,15
1683647949058,ANBI 133,A00,258401,Wilder; Linnea Lorene,34,0,40,6
1683647950085,ANBI 140,A00,258395,Hrvoj Mihic; Branka,18,0,25,7
1683647951109,ANSC 120,A00,258402,Bialecki; Jon Anthony,26,0,40,14
1683647952134,ANSC 144,A00,258400,Staff,12,0,40,28
1683647954186,ANSC 166,A00,258396,Parish; Steven Martin,156,0,175,19
1683647955212,ANSC 180,A00,193533,Staff,8,0,20,12
1683647956239,ANSC 188,A00,258397,Jassal; Aftab,34,0,40,6
1683647957262,ANTH 3,A01,258316,Staff,23,0,30,7
1683647958287,ANTH 5,A00,258394,Semendeferi; Ekaterini,16,0,20,4
1683647959313,ANTH 21,A01,258331,Staff,4,0,40,36
1683647960337,ANTH 103,A00,258398,Varma; Saiba,15,0,25,10
1683647961364,AWP 10,001,202034,Staff,0,0,0,0
1683647961364,AWP 10,002,202035,Staff,0,0,0,0
1683647961364,AWP 10,003,202036,Staff,0,0,0,0
1683647961364,AWP 10,004,202037,Staff,0,0,0,0
1683647961364,AWP 10,005,202038,Staff,0,0,0,0
1683647961364,AWP 10,006,202039,Staff,0,0,0,0
1683647961364,AWP 10,007,202040,Staff,0,0,0,0
1683647961364,AWP 10,008,202041,Staff,0,0,0,0
1683647961364,AWP 10,009,202042,Staff,0,0,0,0
1683647961364,AWP 10,010,202043,Staff,0,0,0,0
1683647961364,AWP 10,011,202044,Staff,0,0,0,0
1683647961364,AWP 10,012,202045,Staff,0,0,0,0
1683647961364,AWP 10,013,202046,Staff,0,0,0,0
1683647961364,AWP 10,014,202047,Staff,0,0,0,0
1683647961364,AWP 10,015,202048,Staff,0,0,0,0
1683647961364,AWP 10,016,202049,Staff,0,0,0,0
1683647961364,AWP 10,017,202050,Staff,0,0,0,0
1683647961364,AWP 10,018,202051,Staff,0,0,0,0
1683647961364,AWP 10,019,202052,Staff,0,0,0,0
1683647961364,AWP 10,020,202053,Staff,0,0,0,0
1683647961364,AWP 10,021,202054,Staff,0,0,0,0
1683647961364,AWP 10,022,202055,Staff,0,0,0,0
1683647961364,AWP 10,023,202056,Staff,0,0,0,0
1683647961364,AWP 10,024,202057,Staff,0,0,0,0
1683647961364,AWP 10,025,202058,Staff,0,0,0,0
1683647961364,AWP 10,026,202059,Staff,0,0,0,0
1683647962388,AWP 102,001,202032,Staff,0,0,0,0
1683647962388,AWP 102,002,202033,Staff,0,0,0,0
1683647963414,BENG 100,A01,254234,Taylor Amos; Alyssa C,31,0,40,9
1683647964438,BENG 196,001,270013,Engler; Adam J.,9999,0,9999,0
1683647965464,BICD 100R,A01,202018,Smith; Laurie,0,7,32,32
1683647965464,BICD 100R,A02,202019,Smith; Laurie,0,3,32,32
1683647965464,BICD 100R,A03,202020,Smith; Laurie,0,1,32,32
1683647965464,BICD 100R,A04,202021,Smith; Laurie,6,0,32,26
1683647965464,BICD 100R,A05,202022,Smith; Laurie,11,0,32,21
1683647966488,BICD 136,A01,193242,Gustafson-Brown; Cindy,0,2,32,32
1683647966488,BICD 136,A02,193244,Gustafson-Brown; Cindy,13,0,32,19
1683647967512,BIEB 102,A01,193249,Butler; Shannon Rhey,0,2,32,32
1683647967512,BIEB 102,A02,193251,Butler; Shannon Rhey,0,0,32,32
1683647967512,BIEB 102,A03,193253,Butler; Shannon Rhey,0,0,32,32
1683647967512,BIEB 102,A04,193255,Butler; Shannon Rhey,14,0,32,18
1683647967512,BIEB 102,A05,193265,Butler; Shannon Rhey,26,0,32,6
1683647967512,BIEB 102,A06,193269,Butler; Shannon Rhey,14,0,32,18
1683647969566,BIEB 150,A01,193274,Staff,0,0,32,32
1683647969566,BIEB 150,A02,193285,Staff,24,0,32,8
1683647970592,BIEB 194,A00,193286,Kurle; Carolyn M.,20,0,32,12
1683647971617,BILD 1,A01,192291,Staff,15,0,32,17
1683647971617,BILD 1,A02,192292,Staff,30,0,32,2
1683647971617,BILD 1,B01,192520,Reuther; Keefe,0,1,0,0
1683647971617,BILD 1,B02,192532,Reuther; Keefe,0,1,0,0
1683647972642,BILD 3,A01,192556,Butler; Shannon Rhey,0,0,32,32
1683647972642,BILD 3,A02,192581,Butler; Shannon Rhey,1,0,32,31
1683647972642,BILD 3,A03,192611,Butler; Shannon Rhey,21,0,32,11
1683647972642,BILD 3,A04,192612,Butler; Shannon Rhey,24,0,32,8
1683647972642,BILD 3,A05,192613,Butler; Shannon Rhey,26,0,32,6
1683647972642,BILD 3,A06,192679,Butler; Shannon Rhey,27,0,32,5
1683647972642,BILD 3,A07,192682,Butler; Shannon Rhey,20,0,32,12
1683647973666,BILD 4,A01,192836,Reuther; Keefe,0,0,24,24
1683647973666,BILD 4,A02,193044,Reuther; Keefe,4,0,24,20
1683647974691,BILD 10,A01,193142,Gustafson-Brown; Cindy,29,0,32,3
1683647974691,BILD 10,A02,193149,Gustafson-Brown; Cindy,31,0,32,1
1683647975719,BIMM 100,A01,193301,Staff,0,6,32,32
1683647975719,BIMM 100,A02,193312,Staff,0,7,32,32
1683647975719,BIMM 100,A03,193323,Staff,0,9,32,32
1683647976748,BIMM 101,A01,193329,McDonnell; Lisa Marie,0,4,24,24
1683647976748,BIMM 101,A02,193339,McDonnell; Lisa Marie,0,3,24,24
1683647976748,BIMM 101,B01,193354,McDonnell; Lisa Marie,0,4,24,24
1683647976748,BIMM 101,B02,193357,McDonnell; Lisa Marie,0,3,24,24
1683647977777,BIMM 110,A01,193377,Tat; John,0,11,32,32
1683647977777,BIMM 110,A02,193378,Tat; John,0,10,32,32
1683647978807,BIMM 120,A01,206116,Staff,0,0,32,32
1683647978807,BIMM 120,A02,206117,Staff,6,0,32,26
1683647978807,BIMM 120,A03,206121,Staff,21,0,32,11
1683647979833,BIPN 100,A01,193393,Park; Ji Young,0,14,32,32
1683647979833,BIPN 100,A02,193402,Park; Ji Young,0,14,32,32
1683647979833,BIPN 100,A03,193413,Park; Ji Young,0,14,32,32
1683647979833,BIPN 100,A04,193414,Park; Ji Young,0,13,32,32
1683647980857,BIPN 102,A01,193429,Staff,0,0,32,32
1683647980857,BIPN 102,A02,193438,Staff,18,0,32,14
1683647981881,BIPN 106,A01,193450,Reyes Gonzalez; Catalina,0,2,40,40
1683647982912,BIPN 134,A01,193465,Cooke; James Edward,0,0,32,32
1683647982912,BIPN 134,A02,193474,Cooke; James Edward,25,0,32,7
1683647982912,BIPN 134,A03,193485,Cooke; James Edward,29,0,32,3
1683647982912,BIPN 134,A04,193486,Cooke; James Edward,20,0,32,12
1683647982912,BIPN 134,A05,193491,Cooke; James Edward,31,0,32,1
1683647982912,BIPN 134,A06,193501,Cooke; James Edward,30,0,32,2
1683647982912,BIPN 134,A07,193510,Cooke; James Edward,29,0,32,3
1683647984961,BISP 194,A00,222522,Staff,14,0,32,18
1683647985989,CAT 124,A01,202407,Staff,19,0,25,6
1683647987013,CAT 125,A00,202408,Marchisotto; Jennifer Anne,2,0,20,18
1683647988039,CAT 125R,A00,202409,Smith; Lauryn Alissa,0,11,20,20
1683647988039,CAT 125R,B00,202410,Morales; Celeste Georgianna,0,11,20,20
1683647988039,CAT 125R,C00,202411,Irwin; Matthew Joseph,0,12,20,20
1683647989070,CENG 15,A01,204712,Yang; Kesong,0,1,0,0
1683647990094,CENG 114,A00,202070,Jahed Motlagh; Zeinab,5,0,20,15
1683647991118,CGS 105,A00,185477,Wesling; Megan E.,24,0,40,16
1683647992141,CGS 106,A00,185494,Staff,11,0,22,11
1683647993219,CGS 108,A00,185495,Staff,14,0,20,6
1683647994244,CGS 114,A00,185496,Staff,13,0,18,5
1683647995268,CGS 119,A00,185501,Staff,15,0,20,5
1683647996295,CGS 120,A00,185511,Staff,12,0,20,8
1683647997319,CHEM 4,A01,184675,Bussey; Thomas J,97,0,100,3
1683647998342,CHEM 6A,A01,184677,Staff,33,0,60,27
1683647999370,CHEM 6B,A01,184679,Staff,63,0,100,37
1683648000395,CHEM 6C,A01,184681,Bussey; Thomas J,0,0,50,50
1683648000395,CHEM 6C,A02,184682,Bussey; Thomas J,32,0,50,18
1683648001423,CHEM 40A,A01,184684,Albizati; Kim F.,34,0,100,66
1683648002445,CHEM 40B,A01,184686,Albizati; Kim F.,0,22,100,100
1683648003471,CHEM 41B,A01,184690,Staff,51,0,100,49
1683648004494,COGS 3,A01,184715,Boyle; Mary E. T.,0,27,40,40
1683648005520,COGS 14B,A01,185172,Staff,0,14,38,38
1683648006546,COGS 18,A01,184736,Staff,14,0,80,66
1683648007570,COGS 100,A01,184932,Staff,0,7,73,73
1683648008600,COGS 101A,A01,184935,Staff,0,39,30,30
1683648009627,COGS 101B,A01,184944,Staff,0,2,30,30
1683648010651,COGS 101C,A01,184946,Staff,0,10,30,30
1683648011679,COGS 102A,A01,184951,Johnson; Christine M.,2,0,40,38
1683648012707,COGS 107B,A01,184953,Mooshagian; Eric Frederick,0,51,40,40
1683648013738,COGS 118B,A01,184959,Gupta; Anjum,0,49,40,40
1683648014764,COGS 153,A00,184961,Staff,0,16,30,30
1683648015791,COGS 177,A00,184962,Staff,0,21,30,30
1683648016819,COGS 187A,A01,184969,Boyle; Mary E. T.,0,19,40,40
1683648017840,COMM 10,A01,185174,Staff,0,5,25,25
1683648017840,COMM 10,A02,185189,Staff,0,2,25,25
1683648017840,COMM 10,A03,269821,Staff,0,1,0,0
1683648018867,COMM 100B,A01,185475,Staff,0,1,0,2
1683648018867,COMM 100B,A02,185476,Staff,12,0,25,13
1683648019890,COMM 100C,A01,185314,Staff,1,0,25,24
1683648019890,COMM 100C,A02,185327,Staff,18,0,25,7
1683648020914,COMM 110M,A00,185349,Staff,0,0,40,40
1683648021939,COMM 113T,A00,185352,Staff,25,0,40,15
1683648022963,COMM 114I,A00,185353,Staff,31,0,40,9
1683648023992,COMM 131,A00,185354,Staff,17,0,30,13
1683648025016,CSE 8A,A50,185358,Cao; Yingjun,0,46,10,10
1683648026044,CSE 8B,A01,185362,Staff,0,48,50,50
1683648027071,CSE 11,A01,185416,Cao; Yingjun,0,91,10,10
1683648028095,CSE 20,A01,185445,Briones; Jor-el Thomas Caparas,4,0,25,21
1683648029119,CSE 21,A01,185447,Staff,9,0,50,41
1683648030144,CSE 101,A01,185451,Staff,0,13,50,50
1683648030144,CSE 101,B01,185453,Jones; Miles E,0,13,50,50
1683648032194,CSE 141,A01,185458,Eldon; John,16,0,100,84
1683648033218,CSE 141L,A01,185461,Eldon; John,8,0,100,92
1683648034246,CSE 142,A01,185463,Staff,35,0,60,25
1683648034246,CSE 142,B01,201355,Staff,0,7,60,60
1683648035270,CSE 142L,A01,185470,Staff,35,0,60,25
1683648035270,CSE 142L,B01,201417,Staff,0,6,60,60
1683648036298,CSE 190,A00,201433,Staff,32,0,49,17
1683648037321,DOC 1,A01,259136,Strom; Megan C.,7,0,15,8
1683648037321,DOC 1,A02,259137,Strom; Megan C.,14,0,15,1
1683648037321,DOC 1,A03,259138,Strom; Megan C.,14,0,15,1
1683648037321,DOC 1,A04,259139,Strom; Megan C.,14,0,15,1
1683648038345,DOC 100D,A00,259140,Pass; Natalye Joann,14,0,25,11
1683648039372,DSGN 1,A01,184749,Rill; Bryan,0,26,30,30
1683648040398,DSGN 100,A01,185168,Staff,0,2,25,25
1683648041422,ECE 5,A01,185626,Morris; Karcher William,0,11,0,0
1683648042445,ECE 101,A01,185628,Staff,14,0,70,56
1683648043469,ECE 107,A01,185635,Baghdadchi; Saharnaz,0,0,20,20
1683648043469,ECE 107,A02,185638,Baghdadchi; Saharnaz,3,0,20,17
1683648044493,ECE 148,A01,185647,Silberman; Jack,0,0,16,16
1683648045520,ECON 1,A01,185537,Crane; Meredith Helen,54,0,70,16
1683648046547,ECON 3,A01,185549,Crane; Meredith Helen,29,0,70,41
1683648047571,ECON 4,A01,203354,Anderson; John Charles,0,5,10,10
1683648048594,ECON 100A,A01,185574,Staff,0,5,40,40
1683648049619,ECON 100B,A01,185576,Staff,0,12,50,50
1683648050642,ECON 100C,A01,185589,Newhouse; Herbert S,30,0,70,40
1683648051668,ECON 105,A00,185608,Vespa; Emanuel Ignacio,19,0,35,16
1683648052694,ECON 109,A01,185610,Shishkin; Denis,9,0,35,26
1683648053717,ECON 110A,A01,185612,Staff,9,0,40,31
1683648054744,ECON 120A,A01,185615,Staff,20,0,40,20
1683648055767,ECON 120C,A01,185617,Sun; Yixiao,0,20,70,70
1683648056793,ECON 144,A00,203346,Squires; Dale E,2,0,35,33
1683648057820,ECON 171,A01,203349,Newhouse; Herbert S,0,1,35,35
1683648058847,ECON 173A,A01,185621,Toda; Alexis Akira,21,0,35,14
1683648059872,EDS 25,A01,202413,Staff,0,1,0,0
1683648059872,EDS 25,A02,202414,Staff,0,1,0,0
1683648059872,EDS 25,A03,202415,Staff,0,0,0,0
1683648059872,EDS 25,A04,202416,Staff,0,1,0,0
1683648059872,EDS 25,A05,202439,Staff,0,0,0,0
1683648059872,EDS 25,A06,202440,Staff,0,0,0,0
1683648059872,EDS 25,B01,202631,Staff,0,0,0,0
1683648059872,EDS 25,B02,202632,Staff,0,0,0,0
1683648059872,EDS 25,B03,202639,Staff,0,0,0,0
1683648059872,EDS 25,B04,202640,Staff,0,0,0,0
1683648059872,EDS 25,B05,202643,Staff,0,0,0,0
1683648059872,EDS 25,B06,202644,Staff,0,0,0,0
1683648060899,EDS 38,A01,202659,Black; Alison Michelle,24,0,25,1
1683648061922,EDS 115,A00,202652,Staff,18,0,30,12
1683648062949,EDS 125,A00,202649,Staff,13,0,30,17
1683648063974,EDS 126,A01,203332,Staff,30,0,30,0
1683648064998,EDS 139,A00,202838,Staff,16,0,25,9
1683648066022,EDS 146,A01,202655,Staff,14,0,25,11
1683648067047,ENG 15,A00,185667,Staff,0,1,0,0
1683648067047,ENG 15,B00,185672,Staff,0,0,0,0
1683648067047,ENG 15,C00,185675,Staff,0,0,0,0
1683648067047,ENG 15,D00,185682,Staff,0,0,0,0
1683648067047,ENG 15,E00,185684,Staff,0,0,0,0
1683648068076,ETHN 103,A00,185710,Staff,0,8,35,35
1683648069101,ETHN 103A,A00,199228,Man; Simeon S,0,0,9,9
1683648070126,ETHN 109,A00,185711,Staff,16,0,35,19
1683648071152,ETHN 142,A00,185726,Staff,0,4,30,30
1683648072175,ETHN 163J,A00,199229,Man; Simeon S,5,0,8,3
1683648073201,ETHN 168,A00,185727,Staff,7,0,10,3
1683648074227,ETHN 182,A00,185728,Staff,0,0,35,35
1683648075257,ETHN 183,A00,185737,Staff,9,0,18,9
1683648076284,GLBH 111,A01,209361,Burgos; Jose L.,0,0,0,0
1683648078334,HIEU 104,A00,185792,Staff,14,0,20,6
1683648079356,HIEU 115,A00,185800,Staff,0,0,20,20
1683648080383,HIEU 128,A00,185801,Staff,0,9,20,20
1683648081409,HIEU 147,A00,185802,Staff,15,0,20,5
1683648082433,HIEU 154,A00,185823,Staff,11,0,20,9
1683648083457,HILA 102,A00,185826,Staff,14,0,20,6
1683648084482,HILD 2C,A01,185778,Staff,0,13,20,20
1683648085508,HILD 7B,A01,185780,Kwak; Nancy,0,16,32,32
1683648085508,HILD 7B,A02,185781,Kwak; Nancy,0,18,32,32
1683648086533,HILD 30,A01,185791,Staff,12,0,20,8
1683648087557,HISC 119,A00,185830,Golan; Tal,0,9,20,20
1683648088581,HITO 156GS,A00,185831,Patterson; Patrick H.,0,0,0,23
1683648089610,HIUS 103,A00,185832,Man; Simeon S,0,4,20,20
1683648090634,HIUS 117,A00,185836,Kwak; Nancy,2,0,20,18
1683648091661,HIUS 125,A00,185840,Man; Simeon S,0,1,23,23
1683648092687,HIUS 149,A00,185845,Staff,1,0,20,19
1683648093719,HUM 3,A01,185882,Zavodny; Tatiana Sophia,0,7,50,50
1683648093719,HUM 3,B01,185899,Caldwell; Michael Alan,0,18,50,50
1683648094746,HUM 3GS,A00,185900,Patterson; Patrick H.,0,0,0,23
1683648095770,HUM 4,A01,185938,Zroka; Amy Liane,30,0,50,20
1683648095770,HUM 4,B01,185956,Watkins; Eric,0,4,50,50
1683648095770,HUM 4,B02,202209,Watkins; Eric,0,4,50,50
1683648095770,HUM 4,B03,202210,Watkins; Eric,0,4,50,50
1683648096851,HUM 5,A01,185958,West; Geoffrey Scott,2,0,50,48
1683648096851,HUM 5,A02,202215,West; Geoffrey Scott,0,0,50,50
1683648097874,INTL 190,A00,185959,Gagnon; Jeffrey C,0,0,0,9
1683648097874,INTL 190,B00,185960,Lettieri; Michael Joseph,0,0,0,2
1683648098898,JAPN 180,A00,254509,Staff,5,0,30,25
1683648099923,LATI 10,A01,202853,Kennemore; Amy Michelle,4,0,35,31
1683648099923,LATI 10,A02,202854,Kennemore; Amy Michelle,2,0,35,33
1683648099923,LATI 10,A03,270054,Kennemore; Amy Michelle,30,0,30,0
1683648100949,LATI 180,A00,202855,Kennemore; Amy Michelle,11,0,20,9
1683648101973,LAWS 101,A00,201767,Golan; Tal,0,7,40,40
1683648103000,LIFR 1C,A00,185961,Staff,6,0,20,14
1683648104030,LIFR 1CX,A00,185962,Staff,7,0,20,13
1683648105058,LIFR 1D,A00,185963,Staff,7,0,20,13
1683648106084,LIFR 1DX,A00,185964,Staff,7,0,20,13
1683648107111,LIGN 101,A01,186039,Staff,43,0,50,7
1683648108136,LIGN 165,A00,186040,Staff,15,0,50,35
1683648109161,LTCS 108,A00,186041,Staff,5,0,10,5
1683648110187,LTCS 119,A00,186042,Staff,15,0,20,5
1683648111220,LTCS 130,A00,186043,Wesling; Megan E.,15,0,25,10
1683648113271,LTEA 138,A00,186119,Staff,14,0,40,26
1683648114306,LTEN 124,A00,186148,Staff,5,0,25,20
1683648115331,LTEN 178,A00,186149,Staff,7,0,15,8
1683648116355,LTEN 181,A00,186150,Blanco; John D,34,0,40,6
1683648117389,LTWL 120,A00,186160,Staff,20,0,25,5
1683648118412,LTWL 165,A00,186161,Staff,22,0,25,3
1683648119439,LTWR 100,A00,186162,Staff,0,5,15,15
1683648120463,LTWR 102,A00,186163,Doller; Ben,5,0,15,10
1683648121492,MAE 8,A01,186412,Staff,0,0,0,0
1683648122517,MAE 30B,A00,186445,Bahadori; Mohammad Yousef,82,0,100,18
1683648123539,MAE 40,A00,186592,Bewley; Thomas R,10,0,50,40
1683648124565,MAE 101B,A00,186593,Bahadori; Mohammad Yousef,80,0,100,20
1683648125593,MAE 105,A00,186594,Bandaru; Prabhakar,10,0,50,40
1683648126618,MAE 107,A00,186599,Pham; Hieu Tan,0,7,120,120
1683648127642,MAE 148,A01,186660,Silberman; Jack,3,0,16,13
1683648128665,MATH 10A,A01,188095,Staff,0,5,35,35
1683648129695,MATH 10B,A01,188097,Bowers; Adam R.,0,11,30,30
1683648129695,MATH 10B,A02,188099,Bowers; Adam R.,0,11,30,30
1683648129695,MATH 10B,B01,188104,Bowers; Adam R.,0,10,30,30
1683648129695,MATH 10B,B02,188106,Bowers; Adam R.,1,9,30,29
1683648130718,MATH 10C,A01,188111,Staff,0,18,30,30
1683648130718,MATH 10C,A02,188127,Staff,0,19,30,30
1683648130718,MATH 10C,A03,188131,Staff,0,19,30,30
1683648130718,MATH 10C,B01,188218,Staff,17,0,30,13
1683648130718,MATH 10C,B02,188244,Staff,13,0,30,17
1683648130718,MATH 10C,B03,188277,Staff,14,0,30,16
1683648131750,MATH 18,A01,188344,Bach; Quang Tran,18,0,30,12
1683648131750,MATH 18,A02,188345,Bach; Quang Tran,11,0,30,19
1683648131750,MATH 18,B01,188353,Bach; Quang Tran,11,0,30,19
1683648131750,MATH 18,B02,188354,Bach; Quang Tran,19,0,30,11
1683648132777,MATH 20A,A01,188374,Staff,11,0,35,24
1683648133803,MATH 20B,A01,188382,Ohm; Ko Woon,7,0,30,23
1683648133803,MATH 20B,A02,188383,Ohm; Ko Woon,22,0,30,8
1683648133803,MATH 20B,B01,188385,Ohm; Ko Woon,7,0,30,23
1683648133803,MATH 20B,B02,188392,Ohm; Ko Woon,22,0,30,8
1683648134828,MATH 20C,A01,188394,Harel; Guershon,11,0,30,19
1683648134828,MATH 20C,A02,188395,Harel; Guershon,13,0,30,17
1683648134828,MATH 20C,B01,188404,Harel; Guershon,5,0,30,25
1683648134828,MATH 20C,B02,188405,Harel; Guershon,18,0,30,12
1683648135856,MATH 20D,A01,188414,Hammock; Frances H,0,1,30,30
1683648135856,MATH 20D,A02,188415,Hammock; Frances H,0,1,30,30
1683648135856,MATH 20D,B01,188447,Hammock; Frances H,0,1,30,30
1683648135856,MATH 20D,B02,188486,Hammock; Frances H,4,0,30,26
1683648136884,MATH 20E,A01,188649,Staff,21,0,30,9
1683648136884,MATH 20E,A02,188650,Staff,21,0,30,9
1683648136884,MATH 20E,A03,188673,Staff,0,0,30,30
1683648137913,MATH 102,A01,188675,Staff,0,36,35,35
1683648138940,MATH 103B,A01,188681,Staff,3,0,35,32
1683648138940,MATH 103B,B01,188692,Staff,5,0,35,30
1683648139968,MATH 109,A01,188695,Salehi Golsefidy; Alireza,24,0,35,11
1683648139968,MATH 109,A02,188696,Salehi Golsefidy; Alireza,25,0,35,10
1683648140991,MATH 120A,A01,188698,Eggers; John Dietrich,7,0,35,28
1683648142021,MATH 142B,A01,188736,Ioana; Adrian,0,1,30,30
1683648142021,MATH 142B,A02,188741,Ioana; Adrian,0,1,30,30
1683648142021,MATH 142B,A03,188743,Ioana; Adrian,0,1,30,30
1683648143045,MATH 168A,A01,188790,Staff,0,10,35,35
1683648144070,MATH 170A,A01,188803,Nie; Jiawang,0,2,35,35
1683648144070,MATH 170A,A02,188811,Nie; Jiawang,0,0,35,35
1683648144070,MATH 170A,A03,188814,Nie; Jiawang,0,0,35,35
1683648144070,MATH 170A,A04,188815,Nie; Jiawang,10,0,35,25
1683648145095,MATH 193B,A01,188817,Staff,0,0,35,35
1683648145095,MATH 193B,A02,188818,Staff,5,0,35,30
1683648146123,MGT 4,A01,202857,Anderson; John Charles,61,0,80,19
1683648147146,MGT 12,A00,202858,Lindenberger; Wade Douglas,40,0,90,50
1683648148171,MGT 18,A00,202859,Staff,74,0,90,16
1683648149198,MGT 18GS,A00,202860,McKay; Michael J,13,0,28,15
1683648150225,MGT 45,A00,202861,Pecore; Joseph P.,12,0,90,78
1683648151248,MGT 100,A00,202863,Yavorsky; Daniel Ryan,28,0,90,62
1683648152273,MGT 103,A00,202864,Ehrich; Kristine R,0,17,90,90
1683648153297,MGT 112,A00,202865,Ehrich; Kristine R,15,0,90,75
1683648154319,MGT 121A,A00,202868,Staff,0,20,0,0
1683648155342,MGT 131B,A00,202869,Anderson; John Charles,59,0,90,31
1683648156370,MGT 136,A00,202871,Lindenberger; Wade Douglas,83,0,90,7
1683648157393,MGT 164,A00,202873,Staff,0,66,90,91
1683648158416,MGT 164GS,A00,202874,McKay; Mary A,13,0,28,15
1683648159443,MGT 180,A00,202875,Staff,0,50,90,91
1683648160464,MMW 11R,A01,205019,Herbst; Matthew,2,0,30,28
1683648160464,MMW 11R,A02,205026,Herbst; Matthew,29,0,30,1
1683648161490,MMW 15,A01,193512,Chang; Edmond Yi-Teh,0,8,28,28
1683648161490,MMW 15,A02,193513,Chang; Edmond Yi-Teh,0,5,28,28
1683648161490,MMW 15,A03,193514,Chang; Edmond Yi-Teh,0,5,28,28
1683648161490,MMW 15,A04,193515,Chang; Edmond Yi-Teh,0,5,28,28
1683648161490,MMW 15,A05,193516,Chang; Edmond Yi-Teh,0,5,28,28
1683648161490,MMW 15,A06,193517,Chang; Edmond Yi-Teh,0,6,28,28
1683648161490,MMW 15,B01,193519,Chang; Edmond Yi-Teh,0,5,28,28
1683648161490,MMW 15,B02,193520,Chang; Edmond Yi-Teh,0,5,28,28
1683648161490,MMW 15,B03,193521,Chang; Edmond Yi-Teh,0,5,28,28
1683648161490,MMW 15,B04,193522,Chang; Edmond Yi-Teh,0,5,28,28
1683648161490,MMW 15,B05,193523,Chang; Edmond Yi-Teh,0,5,28,28
1683648161490,MMW 15,B06,193524,Chang; Edmond Yi-Teh,0,5,28,28
1683648162515,MMW 122,A01,193526,Rahimi; Babak,0,16,28,28
1683648162515,MMW 122,A02,193527,Rahimi; Babak,0,15,28,28
1683648162515,MMW 122,A03,193528,Rahimi; Babak,0,0,0,0
1683648162515,MMW 122,A04,193529,Rahimi; Babak,0,0,0,0
1683648163538,MUS 1A,A01,186663,Staff,1,20,35,34
1683648164564,MUS 4,A01,186715,Staff,0,12,35,35
1683648165590,MUS 5R,A01,186796,Dubnov; Shlomo,0,17,35,35
1683648166615,MUS 6,A01,186798,Staff,0,5,25,25
1683648167638,MUS 7,A01,186830,Staff,11,0,35,24
1683648168665,MUS 8,A01,186930,Staff,0,26,35,35
1683648169689,MUS 15,A01,186932,Staff,0,16,35,35
1683648169689,MUS 15,B01,186934,Staff,0,17,35,35
1683648170712,MUS 80,A00,186935,Staff,0,0,20,20
1683648170712,MUS 80,B00,186936,Staff,24,0,25,1
1683648171737,NANO 11,A00,204702,Lipomi; Darren John,0,0,0,0
1683648172762,NANO 15,A01,204709,Yang; Kesong,0,1,0,0
1683648173785,NANO 114,A00,202069,Jahed Motlagh; Zeinab,3,0,10,7
1683648174809,PHIL 1,A00,186955,Grush; Rick Scott,31,0,40,9
1683648175834,PHIL 10,A01,186973,Grush; Rick Scott,27,0,35,8
1683648175834,PHIL 10,A02,186974,Grush; Rick Scott,33,0,35,2
1683648176862,PHIL 13,A01,186976,Staff,3,0,35,32
1683648176862,PHIL 13,A02,186977,Staff,16,0,35,19
1683648177888,PHIL 14,A01,186979,Staff,31,0,35,4
1683648177888,PHIL 14,A02,186986,Staff,32,0,35,3
1683648178913,PHIL 28,A01,186988,Staff,16,0,30,14
1683648178913,PHIL 28,A02,186989,Staff,1,0,30,29
1683648178913,PHIL 28,A03,186990,Staff,10,0,30,20
1683648178913,PHIL 28,A04,186991,Staff,26,0,30,4
1683648179939,PHIL 120,A00,186997,Staff,23,0,40,17
1683648180962,PHIL 137,A00,187003,Staff,7,0,40,33
1683648181985,PHIL 150,A00,187015,Staff,47,0,70,23
1683648183010,PHIL 167,A00,187021,Lamey; Andy M.,34,0,40,6
1683648184037,PHIL 174,A01,202226,Staff,17,0,20,3
1683648184037,PHIL 174,A02,202235,Staff,20,0,20,0
1683648185065,PHIL 191A,A00,258918,Staff,0,0,1,1
1683648186091,PHYS 1A,A00,187028,Staff,26,0,60,34
1683648187117,PHYS 1AL,001,187036,Staff,3,0,30,27
1683648187117,PHYS 1AL,002,187049,Staff,18,0,30,12
1683648188145,PHYS 1B,A00,187058,Staff,22,0,60,38
1683648189173,PHYS 1BL,001,187064,Staff,0,1,30,30
1683648189173,PHYS 1BL,002,187070,Staff,4,0,30,26
1683648190196,PHYS 1C,A00,187082,Staff,29,0,120,91
1683648191222,PHYS 1CL,001,187088,Staff,0,9,30,30
1683648191222,PHYS 1CL,002,187089,Staff,0,1,30,30
1683648191222,PHYS 1CL,009,262693,Staff,9,0,30,21
1683648192248,PHYS 2B,A01,187097,Staff,55,0,115,60
1683648193274,PHYS 2C,A01,187099,Staff,64,0,115,51
1683648194298,PHYS 2CL,A01,187101,Staff,5,0,28,23
1683648194298,PHYS 2CL,A02,187102,Staff,15,0,28,13
1683648195322,PHYS 2D,A01,187123,Shotwell; Brian,95,0,115,20
1683648196348,PHYS 4B,A01,187133,Grinstein; Benjamin,35,0,50,15
1683648197371,POLI 10,A00,188819,Staff,0,4,50,50
1683648198398,POLI 11,A00,188827,Staff,43,0,50,7
1683648199424,POLI 13R,A00,188828,Staff,0,1,20,20
1683648200525,POLI 27,A01,188830,Elgin; Samuel Zincke,0,2,70,70
1683648201550,POLI 30,A00,188832,Desposato; Scott,30,0,50,20
1683648202573,POLI 102F,A00,188834,Staff,0,0,40,40
1683648203598,POLI 104A,A00,188852,Staff,13,0,30,17
1683648204623,POLI 104I,A00,188853,Staff,0,7,20,20
1683648205650,POLI 110B,A00,188854,Wiens; David,7,0,20,13
1683648206678,POLI 112A,A00,188855,Wiens; David,4,0,30,26
1683648207703,POLI 117R,A00,188856,Forman; Fonna,0,12,20,20
1683648208734,POLI 118,A00,188857,Ingham; Sean,8,0,20,12
1683648209758,POLI 120G,A00,188858,Staff,8,0,30,22
1683648210786,POLI 131CR,A00,188863,Hoston; Germaine,21,0,50,29
1683648211810,POLI 133,A00,188864,Nellis; Gareth Hb,44,0,50,6
1683648212840,POLI 134D,A00,188865,Desposato; Scott,27,0,30,3
1683648213868,POLI 142A,A00,188871,Gartzke; Erik,21,0,50,29
1683648214893,POLI 142K,A00,188874,Staff,38,0,50,12
1683648215921,POLI 143,A00,188940,Gartzke; Erik,16,0,30,14
1683648216945,POLI 153,A00,188943,Staff,2,0,20,18
1683648217970,POLI 160AA,A00,188944,Staff,11,0,40,29
1683648218996,POLI 170A,A00,188945,Staff,11,0,30,19
1683648221047,PSYC 1,A00,188952,Staff,36,0,90,54
1683648222070,PSYC 2,B00,188953,Staff,19,0,35,16
1683648223093,PSYC 6,A00,188970,Staff,47,0,60,13
1683648224117,PSYC 7,A00,188973,Staff,35,0,45,10
1683648225139,PSYC 60,A01,188980,Rickard; Timothy C.,42,0,60,18
1683648226161,PSYC 70,A01,189001,Steiner; Eric Tomas,23,0,45,22
1683648227184,PSYC 100,A00,189005,Lacefield; Katharine I,0,99,120,120
1683648228211,PSYC 102,A00,189008,Staff,8,0,30,22
1683648229241,PSYC 106,B00,189026,Gorman; Michael R.,27,0,60,33
1683648230264,PSYC 114,B01,189033,Winkielman; Piotr,0,31,30,30
1683648231287,PSYC 131,A00,189036,Anagnostaras; Stephan,0,43,60,60
1683648232311,PSYC 136,A00,189041,Lowe; Angela Beth,0,7,25,25
1683648233339,PSYC 137,A00,189057,Winkielman; Piotr,0,37,25,25
1683648234367,PSYC 144,A00,189107,Wixted; John T,0,10,50,50
1683648236420,PSYC 162,A00,189142,Staff,0,9,85,85
1683648237447,PSYC 172,A00,189144,Gorman; Michael R.,0,6,30,30
1683648239501,PSYC 179,A00,189146,Lacefield; Katharine I,0,86,120,120
1683648240526,PSYC 181,A00,189147,Anagnostaras; Stephan,0,44,90,90
1683648241550,PSYC 190R,A00,189148,Barner; David A.,0,23,80,80
1683648242575,PSYC 191,A00,189275,Rickard; Timothy C.,0,10,25,25
1683648243599,PSYC 193,A00,189276,Chapman; Eddie Nathaniel,0,1,0,4
1683648244630,PSYC 193L,A01,189281,Lowe; Angela Beth,10,0,20,10
1683648244630,PSYC 193L,B01,189285,Staff,28,0,35,7
1683648245655,RELI 149,A00,187137,Rahimi; Babak,7,0,40,33
1683648246683,SE 9,A01,187315,Staff,0,2,18,18
1683648247713,SE 101B,A00,187409,Staff,24,0,30,6
1683648248737,SE 110B,A00,187444,Staff,10,0,40,30
1683648249764,SE 130B,A00,187449,Staff,31,0,40,9
1683648250788,SE 150A,A00,187516,Staff,9,0,20,11
1683648251811,SE 154,A00,187528,Staff,29,0,50,21
1683648252835,SIO 3,A01,258171,Staff,35,0,40,5
1683648253860,SIO 10,A00,187144,Cook; Geoffrey W,0,6,75,75
1683648254886,SIO 45,A00,187152,Cook; Geoffrey W,0,4,100,100
1683648255914,SIO 109R,A00,194486,Staff,0,4,20,20
1683648257967,SIO 187,A01,187233,Kacev; David,12,0,40,28
1683648258993,SOCI 1,A01,258656,Thorpe; Charles Robert,28,0,30,2
1683648258993,SOCI 1,A02,258658,Thorpe; Charles Robert,30,0,30,0
1683648258993,SOCI 1,A03,258661,Thorpe; Charles Robert,25,0,25,0
1683648258993,SOCI 1,A04,258666,Thorpe; Charles Robert,22,0,25,3
1683648258993,SOCI 1,A05,258897,Thorpe; Charles Robert,22,0,25,3
1683648258993,SOCI 1,A06,258898,Thorpe; Charles Robert,25,0,25,0
1683648260018,SOCI 30,A01,258903,Pardo Guerra; Juan Pablo,14,0,30,16
1683648261044,SOCI 102,A00,258904,Staff,9,0,25,16
1683648262068,SOCI 106,A00,258905,Staff,19,0,25,6
1683648263092,SOCI 111,A00,258907,Ribas Norris; Janet Vanesa,26,0,30,4
1683648264121,SOCI 121R,A00,258908,Pardo Guerra; Juan Pablo,8,0,30,22
1683648265147,SOCI 126,A01,203330,Staff,14,0,20,6
1683648266174,SOCI 131,A00,258909,Thorpe; Charles Robert,30,0,60,30
1683648267199,SOCI 135,A00,258910,Payne; Christine Anna,0,11,30,30
1683648268225,SOCI 157,A00,258911,Staff,12,0,30,18
1683648269248,SOCI 184,A00,258912,Staff,25,0,30,5
1683648270275,SOCI 188D,A00,258913,Staff,22,0,30,8
1683648271300,SYN 2,001,187529,Staff,9,0,16,7
1683648271300,SYN 2,002,201452,Staff,0,20,16,16
1683648271300,SYN 2,003,201469,Staff,2,0,16,14
1683648272327,SYN 100,A01,187531,Staff,0,9,20,20
1683648272327,SYN 100,B01,201491,Staff,0,10,20,20
1683648273352,TDAC 1,A00,189286,Walsh; Kim C.,3,0,20,17
1683648273352,TDAC 1,B00,189287,Harting; Carla Kelso,10,0,20,10
1683648274379,TDAC 101,A00,189300,Walsh; Kim C.,16,0,20,4
1683648274379,TDAC 101,B00,189301,Harting; Carla Kelso,18,0,20,2
1683648275405,TDAC 102,A00,189304,Basso; Beatrice,14,0,20,6
1683648276432,TDAC 108,A00,189305,Staff,18,0,20,2
1683648277457,TDDE 131,A00,189310,Staff,19,0,20,1
1683648277457,TDDE 131,B00,189314,Staff,19,0,20,1
1683648277457,TDDE 131,C00,189315,Staff,48,0,50,2
1683648277457,TDDE 131,D00,189316,Staff,14,0,15,1
1683648277457,TDDE 131,E00,204841,Staff,20,0,20,0
1683648278485,TDGE 10,A00,189289,Staff,27,0,50,23
1683648278485,TDGE 10,B00,189290,Havis; Allan,0,0,50,50
1683648279513,TDGE 11,A00,189291,Fulton; Julia,0,4,50,50
1683648279513,TDGE 11,B00,189292,Staff,20,0,25,5
1683648279513,TDGE 11,C00,260270,Staff,0,0,0,0
1683648280538,TDGE 25,A00,189294,Staff,2,0,20,18
1683648281561,TDGE 124,A00,189318,Fulton; Julia,0,8,50,50
1683648282586,TDGE 125,A00,189319,Staff,13,0,25,12
1683648282586,TDGE 125,B00,189320,Staff,23,0,25,2
1683648283610,TDGE 127,A00,189322,Havis; Allan,0,0,50,50
1683648284634,TDHT 101,A00,189323,Staff,18,0,25,7
1683648284634,TDHT 101,B00,189324,Staff,25,0,25,0
1683648285661,TDHT 102,A00,189325,Staff,49,0,50,1
1683648286686,TDMV 1,A00,189295,Arcidiacono; Kristin,20,0,30,10
1683648286686,TDMV 1,B00,189296,Caligagan; Maria T.,24,0,30,6
1683648287714,TDMV 2,A00,189297,Sammartano; Tonnie,27,0,30,3
1683648287714,TDMV 2,B00,189299,Arcidiacono; Kristin,23,0,30,7
1683648288741,TDMV 3,A00,204998,Rincon; Alicia,22,0,30,8
1683648289765,TDMV 120,A00,189458,Sammartano; Tonnie,28,0,30,2
1683648290795,TDMV 138,A00,189541,Jun; Grace Shin Hae,20,0,40,20
1683648291821,TDMV 142,A00,189717,Caligagan; Tony,25,0,30,5
1683648291821,TDMV 142,B00,189718,Caligagan; Maria T.,25,0,30,5
1683648292849,TMC 2,A01,187533,Staff,25,0,25,0
1683648292849,TMC 2,A02,187534,Staff,25,0,25,0
1683648293878,USP 1,A01,187536,Kwak; Nancy,0,16,25,25
1683648294902,USP 5,A01,187538,Staff,9,0,25,16
1683648295930,USP 101,A00,199253,Staff,0,4,0,0
1683648296955,USP 124,A00,187562,Boomhower; Matthew Charles,0,0,30,30
1683648297980,USP 138,A00,187582,Staff,20,0,25,5
1683648299011,USP 152,A01,187597,Staff,3,0,25,22
1683648300035,USP 153,A00,187598,Staff,19,0,25,6
1683648301061,USP 168,A00,187607,Kwak; Nancy,2,0,5,3
1683648302090,USP 173,A00,187619,Staff,4,0,25,21
1683648303114,USP 181,A00,187638,Staff,0,4,25,25
1683648304202,VIS 103,A00,187650,Cruz; Edwin Teddy,18,0,75,57
1683648305227,VIS 110D,A00,187669,Staff,13,0,22,9
1683648306252,VIS 127C,A00,187720,Shen; Kuiyi,67,0,146,79
1683648307284,VIS 149,A00,187731,Yoldas; Pinar,0,14,22,22
1683648308309,VIS 151,A01,188091,Staff,22,0,34,12
1683648308309,VIS 151,A02,188092,Staff,11,0,34,23
1683648309334,VIS 160B,A00,188093,Stalbaum; Brett,0,1,10,10
1683648311385,WCWP 10B,A00,201720,Staff,10,0,15,5
1683648311385,WCWP 10B,B00,201722,Staff,9,0,15,6
1683648312419,WCWP 100,A00,201725,Gagnon; Jeffrey C,0,0,2,2
1683648312419,WCWP 100,B00,201727,Staff,0,4,15,15
1683648315556,ANBI 133,A00,258401,Wilder; Linnea Lorene,34,0,40,6
1683648316580,ANBI 140,A00,258395,Hrvoj Mihic; Branka,18,0,25,7
1683648317604,ANSC 120,A00,258402,Bialecki; Jon Anthony,26,0,40,14
1683648318626,ANSC 144,A00,258400,Staff,12,0,40,28
1683648320687,ANSC 166,A00,258396,Parish; Steven Martin,156,0,175,19
1683648321711,ANSC 180,A00,193533,Staff,8,0,20,12
1683648322738,ANSC 188,A00,258397,Jassal; Aftab,34,0,40,6
1683648323763,ANTH 3,A01,258316,Staff,23,0,30,7
1683648324788,ANTH 5,A00,258394,Semendeferi; Ekaterini,16,0,20,4
1683648325817,ANTH 21,A01,258331,Staff,4,0,40,36
1683648326843,ANTH 103,A00,258398,Varma; Saiba,15,0,25,10
1683648327871,AWP 10,001,202034,Staff,0,0,0,0
1683648327871,AWP 10,002,202035,Staff,0,0,0,0
1683648327871,AWP 10,003,202036,Staff,0,0,0,0
1683648327871,AWP 10,004,202037,Staff,0,0,0,0
1683648327871,AWP 10,005,202038,Staff,0,0,0,0
1683648327871,AWP 10,006,202039,Staff,0,0,0,0
1683648327871,AWP 10,007,202040,Staff,0,0,0,0
1683648327871,AWP 10,008,202041,Staff,0,0,0,0
1683648327871,AWP 10,009,202042,Staff,0,0,0,0
1683648327871,AWP 10,010,202043,Staff,0,0,0,0
1683648327871,AWP 10,011,202044,Staff,0,0,0,0
1683648327871,AWP 10,012,202045,Staff,0,0,0,0
1683648327871,AWP 10,013,202046,Staff,0,0,0,0
1683648327871,AWP 10,014,202047,Staff,0,0,0,0
1683648327871,AWP 10,015,202048,Staff,0,0,0,0
1683648327871,AWP 10,016,202049,Staff,0,0,0,0
1683648327871,AWP 10,017,202050,Staff,0,0,0,0
1683648327871,AWP 10,018,202051,Staff,0,0,0,0
1683648327871,AWP 10,019,202052,Staff,0,0,0,0
1683648327871,AWP 10,020,202053,Staff,0,0,0,0
1683648327871,AWP 10,021,202054,Staff,0,0,0,0
1683648327871,AWP 10,022,202055,Staff,0,0,0,0
1683648327871,AWP 10,023,202056,Staff,0,0,0,0
1683648327871,AWP 10,024,202057,Staff,0,0,0,0
1683648327871,AWP 10,025,202058,Staff,0,0,0,0
1683648327871,AWP 10,026,202059,Staff,0,0,0,0
1683648328896,AWP 102,001,202032,Staff,0,0,0,0
1683648328896,AWP 102,002,202033,Staff,0,0,0,0
1683648329919,BENG 100,A01,254234,Taylor Amos; Alyssa C,31,0,40,9
1683648330944,BENG 196,001,270013,Engler; Adam J.,9999,0,9999,0
1683648331972,BICD 100R,A01,202018,Smith; Laurie,0,7,32,32
1683648331972,BICD 100R,A02,202019,Smith; Laurie,0,3,32,32
1683648331972,BICD 100R,A03,202020,Smith; Laurie,0,1,32,32
1683648331972,BICD 100R,A04,202021,Smith; Laurie,6,0,32,26
1683648331972,BICD 100R,A05,202022,Smith; Laurie,11,0,32,21
1683648332996,BICD 136,A01,193242,Gustafson-Brown; Cindy,0,2,32,32
1683648332996,BICD 136,A02,193244,Gustafson-Brown; Cindy,13,0,32,19
1683648334020,BIEB 102,A01,193249,Butler; Shannon Rhey,0,2,32,32
1683648334020,BIEB 102,A02,193251,Butler; Shannon Rhey,0,0,32,32
1683648334020,BIEB 102,A03,193253,Butler; Shannon Rhey,0,0,32,32
1683648334020,BIEB 102,A04,193255,Butler; Shannon Rhey,14,0,32,18
1683648334020,BIEB 102,A05,193265,Butler; Shannon Rhey,26,0,32,6
1683648334020,BIEB 102,A06,193269,Butler; Shannon Rhey,14,0,32,18
1683648336068,BIEB 150,A01,193274,Staff,0,0,32,32
1683648336068,BIEB 150,A02,193285,Staff,24,0,32,8
1683648337091,BIEB 194,A00,193286,Kurle; Carolyn M.,20,0,32,12
1683648338121,BILD 1,A01,192291,Staff,15,0,32,17
1683648338121,BILD 1,A02,192292,Staff,30,0,32,2
1683648338121,BILD 1,B01,192520,Reuther; Keefe,0,1,0,0
1683648338121,BILD 1,B02,192532,Reuther; Keefe,0,1,0,0
1683648339145,BILD 3,A01,192556,Butler; Shannon Rhey,0,0,32,32
1683648339145,BILD 3,A02,192581,Butler; Shannon Rhey,1,0,32,31
1683648339145,BILD 3,A03,192611,Butler; Shannon Rhey,21,0,32,11
1683648339145,BILD 3,A04,192612,Butler; Shannon Rhey,24,0,32,8
1683648339145,BILD 3,A05,192613,Butler; Shannon Rhey,26,0,32,6
1683648339145,BILD 3,A06,192679,Butler; Shannon Rhey,27,0,32,5
1683648339145,BILD 3,A07,192682,Butler; Shannon Rhey,20,0,32,12
1683648340169,BILD 4,A01,192836,Reuther; Keefe,1,0,24,23
1683648340169,BILD 4,A02,193044,Reuther; Keefe,4,0,24,20
1683648341197,BILD 10,A01,193142,Gustafson-Brown; Cindy,29,0,32,3
1683648341197,BILD 10,A02,193149,Gustafson-Brown; Cindy,31,0,32,1
1683648342246,BIMM 100,A01,193301,Staff,0,6,32,32
1683648342246,BIMM 100,A02,193312,Staff,0,7,32,32
1683648342246,BIMM 100,A03,193323,Staff,0,9,32,32
1683648343279,BIMM 101,A01,193329,McDonnell; Lisa Marie,0,4,24,24
1683648343279,BIMM 101,A02,193339,McDonnell; Lisa Marie,0,3,24,24
1683648343279,BIMM 101,B01,193354,McDonnell; Lisa Marie,0,4,24,24
1683648343279,BIMM 101,B02,193357,McDonnell; Lisa Marie,0,3,24,24
1683648344308,BIMM 110,A01,193377,Tat; John,0,11,32,32
1683648344308,BIMM 110,A02,193378,Tat; John,0,10,32,32
1683648345342,BIMM 120,A01,206116,Staff,0,0,32,32
1683648345342,BIMM 120,A02,206117,Staff,6,0,32,26
1683648345342,BIMM 120,A03,206121,Staff,21,0,32,11
1683648346372,BIPN 100,A01,193393,Park; Ji Young,0,14,32,32
1683648346372,BIPN 100,A02,193402,Park; Ji Young,0,14,32,32
1683648346372,BIPN 100,A03,193413,Park; Ji Young,0,14,32,32
1683648346372,BIPN 100,A04,193414,Park; Ji Young,0,13,32,32
1683648347399,BIPN 102,A01,193429,Staff,0,0,32,32
1683648347399,BIPN 102,A02,193438,Staff,18,0,32,14
1683648348424,BIPN 106,A01,193450,Reyes Gonzalez; Catalina,0,2,40,40
1683648349452,BIPN 134,A01,193465,Cooke; James Edward,0,0,32,32
1683648349452,BIPN 134,A02,193474,Cooke; James Edward,25,0,32,7
1683648349452,BIPN 134,A03,193485,Cooke; James Edward,29,0,32,3
1683648349452,BIPN 134,A04,193486,Cooke; James Edward,20,0,32,12
1683648349452,BIPN 134,A05,193491,Cooke; James Edward,31,0,32,1
1683648349452,BIPN 134,A06,193501,Cooke; James Edward,30,0,32,2
1683648349452,BIPN 134,A07,193510,Cooke; James Edward,29,0,32,3
1683648351507,BISP 194,A00,222522,Staff,14,0,32,18
1683648352531,CAT 124,A01,202407,Staff,19,0,25,6
1683648353558,CAT 125,A00,202408,Marchisotto; Jennifer Anne,2,0,20,18
1683648354583,CAT 125R,A00,202409,Smith; Lauryn Alissa,0,11,20,20
1683648354583,CAT 125R,B00,202410,Morales; Celeste Georgianna,0,11,20,20
1683648354583,CAT 125R,C00,202411,Irwin; Matthew Joseph,0,12,20,20
1683648355609,CENG 15,A01,204712,Yang; Kesong,0,1,0,0
1683648356634,CENG 114,A00,202070,Jahed Motlagh; Zeinab,5,0,20,15
1683648357658,CGS 105,A00,185477,Wesling; Megan E.,24,0,40,16
1683648358683,CGS 106,A00,185494,Staff,11,0,22,11
1683648359709,CGS 108,A00,185495,Staff,14,0,20,6
1683648360734,CGS 114,A00,185496,Staff,13,0,18,5
1683648361759,CGS 119,A00,185501,Staff,15,0,20,5
1683648362783,CGS 120,A00,185511,Staff,12,0,20,8
1683648363811,CHEM 4,A01,184675,Bussey; Thomas J,97,0,100,3
1683648364840,CHEM 6A,A01,184677,Staff,33,0,60,27
1683648365868,CHEM 6B,A01,184679,Staff,63,0,100,37
1683648366894,CHEM 6C,A01,184681,Bussey; Thomas J,0,0,50,50
1683648366894,CHEM 6C,A02,184682,Bussey; Thomas J,32,0,50,18
1683648367923,CHEM 40A,A01,184684,Albizati; Kim F.,34,0,100,66
1683648368950,CHEM 40B,A01,184686,Albizati; Kim F.,0,22,100,100
1683648369975,CHEM 41B,A01,184690,Staff,51,0,100,49
1683648371004,COGS 3,A01,184715,Boyle; Mary E. T.,0,27,40,40
1683648372032,COGS 14B,A01,185172,Staff,0,14,38,38
1683648373063,COGS 18,A01,184736,Staff,14,0,80,66
1683648374090,COGS 100,A01,184932,Staff,0,7,73,73
1683648375118,COGS 101A,A01,184935,Staff,0,39,30,30
1683648376140,COGS 101B,A01,184944,Staff,0,2,30,30
1683648377166,COGS 101C,A01,184946,Staff,0,10,30,30
1683648378197,COGS 102A,A01,184951,Johnson; Christine M.,2,0,40,38
1683648379220,COGS 107B,A01,184953,Mooshagian; Eric Frederick,0,51,40,40
1683648380244,COGS 118B,A01,184959,Gupta; Anjum,0,49,40,40
1683648381269,COGS 153,A00,184961,Staff,0,16,30,30
1683648382293,COGS 177,A00,184962,Staff,0,21,30,30
1683648383319,COGS 187A,A01,184969,Boyle; Mary E. T.,0,19,40,40
1683648384348,COMM 10,A01,185174,Staff,0,5,25,25
1683648384348,COMM 10,A02,185189,Staff,0,2,25,25
1683648384348,COMM 10,A03,269821,Staff,0,1,0,0
1683648385373,COMM 100B,A01,185475,Staff,0,1,0,2
1683648385373,COMM 100B,A02,185476,Staff,12,0,25,13
1683648386402,COMM 100C,A01,185314,Staff,1,0,25,24
1683648386402,COMM 100C,A02,185327,Staff,18,0,25,7
1683648387428,COMM 110M,A00,185349,Staff,0,0,40,40
1683648388453,COMM 113T,A00,185352,Staff,25,0,40,15
1683648389478,COMM 114I,A00,185353,Staff,31,0,40,9
1683648390502,COMM 131,A00,185354,Staff,17,0,30,13
1683648391526,CSE 8A,A50,185358,Cao; Yingjun,0,46,10,10
1683648392550,CSE 8B,A01,185362,Staff,0,48,50,50
1683648393575,CSE 11,A01,185416,Cao; Yingjun,0,91,10,10
1683648394603,CSE 20,A01,185445,Briones; Jor-el Thomas Caparas,4,0,25,21
1683648395636,CSE 21,A01,185447,Staff,9,0,50,41
1683648396664,CSE 101,A01,185451,Staff,0,13,50,50
1683648396664,CSE 101,B01,185453,Jones; Miles E,0,13,50,50
1683648398713,CSE 141,A01,185458,Eldon; John,16,0,100,84
1683648399738,CSE 141L,A01,185461,Eldon; John,8,0,100,92
1683648400764,CSE 142,A01,185463,Staff,35,0,60,25
1683648400764,CSE 142,B01,201355,Staff,0,7,60,60
1683648401792,CSE 142L,A01,185470,Staff,35,0,60,25
1683648401792,CSE 142L,B01,201417,Staff,0,6,60,60
1683648402817,CSE 190,A00,201433,Staff,32,0,49,17
1683648403845,DOC 1,A01,259136,Strom; Megan C.,7,0,15,8
1683648403845,DOC 1,A02,259137,Strom; Megan C.,14,0,15,1
1683648403845,DOC 1,A03,259138,Strom; Megan C.,14,0,15,1
1683648403845,DOC 1,A04,259139,Strom; Megan C.,14,0,15,1
1683648404869,DOC 100D,A00,259140,Pass; Natalye Joann,14,0,25,11
1683648405893,DSGN 1,A01,184749,Rill; Bryan,0,26,30,30
1683648406918,DSGN 100,A01,185168,Staff,0,2,25,25
1683648408002,ECE 5,A01,185626,Morris; Karcher William,0,11,0,0
1683648409026,ECE 101,A01,185628,Staff,14,0,70,56
1683648410052,ECE 107,A01,185635,Baghdadchi; Saharnaz,0,0,20,20
1683648410052,ECE 107,A02,185638,Baghdadchi; Saharnaz,3,0,20,17
1683648411081,ECE 148,A01,185647,Silberman; Jack,0,0,16,16
1683648412107,ECON 1,A01,185537,Crane; Meredith Helen,54,0,70,16
1683648413132,ECON 3,A01,185549,Crane; Meredith Helen,29,0,70,41
1683648414155,ECON 4,A01,203354,Anderson; John Charles,0,5,10,10
1683648415180,ECON 100A,A01,185574,Staff,0,5,40,40
1683648416204,ECON 100B,A01,185576,Staff,0,12,50,50
1683648417233,ECON 100C,A01,185589,Newhouse; Herbert S,30,0,70,40
1683648418258,ECON 105,A00,185608,Vespa; Emanuel Ignacio,19,0,35,16
1683648419285,ECON 109,A01,185610,Shishkin; Denis,9,0,35,26
1683648420310,ECON 110A,A01,185612,Staff,9,0,40,31
1683648421347,ECON 120A,A01,185615,Staff,20,0,40,20
1683648422372,ECON 120C,A01,185617,Sun; Yixiao,0,20,70,70
1683648423395,ECON 144,A00,203346,Squires; Dale E,2,0,35,33
1683648424423,ECON 171,A01,203349,Newhouse; Herbert S,0,1,35,35
1683648425447,ECON 173A,A01,185621,Toda; Alexis Akira,21,0,35,14
1683648426478,EDS 25,A01,202413,Staff,0,1,0,0
1683648426478,EDS 25,A02,202414,Staff,0,1,0,0
1683648426478,EDS 25,A03,202415,Staff,0,0,0,0
1683648426478,EDS 25,A04,202416,Staff,0,1,0,0
1683648426478,EDS 25,A05,202439,Staff,0,0,0,0
1683648426478,EDS 25,A06,202440,Staff,0,0,0,0
1683648426478,EDS 25,B01,202631,Staff,0,0,0,0
1683648426478,EDS 25,B02,202632,Staff,0,0,0,0
1683648426478,EDS 25,B03,202639,Staff,0,0,0,0
1683648426478,EDS 25,B04,202640,Staff,0,0,0,0
1683648426478,EDS 25,B05,202643,Staff,0,0,0,0
1683648426478,EDS 25,B06,202644,Staff,0,0,0,0
1683648427506,EDS 38,A01,202659,Black; Alison Michelle,24,0,25,1
1683648428532,EDS 115,A00,202652,Staff,18,0,30,12
1683648429559,EDS 125,A00,202649,Staff,13,0,30,17
1683648430582,EDS 126,A01,203332,Staff,30,0,30,0
1683648431606,EDS 139,A00,202838,Staff,16,0,25,9
1683648432631,EDS 146,A01,202655,Staff,14,0,25,11
1683648433660,ENG 15,A00,185667,Staff,0,1,0,0
1683648433660,ENG 15,B00,185672,Staff,0,0,0,0
1683648433660,ENG 15,C00,185675,Staff,0,0,0,0
1683648433660,ENG 15,D00,185682,Staff,0,0,0,0
1683648433660,ENG 15,E00,185684,Staff,0,0,0,0
1683648434686,ETHN 103,A00,185710,Staff,0,8,35,35
1683648435711,ETHN 103A,A00,199228,Man; Simeon S,0,0,9,9
1683648436739,ETHN 109,A00,185711,Staff,16,0,35,19
1683648437763,ETHN 142,A00,185726,Staff,0,4,30,30
1683648438790,ETHN 163J,A00,199229,Man; Simeon S,5,0,8,3
1683648439818,ETHN 168,A00,185727,Staff,7,0,10,3
1683648440842,ETHN 182,A00,185728,Staff,0,0,35,35
1683648441869,ETHN 183,A00,185737,Staff,9,0,18,9
1683648442896,GLBH 111,A01,209361,Burgos; Jose L.,0,0,0,0
1683648444948,HIEU 104,A00,185792,Staff,14,0,20,6
1683648445972,HIEU 115,A00,185800,Staff,0,0,20,20
1683648447000,HIEU 128,A00,185801,Staff,0,9,20,20
1683648448025,HIEU 147,A00,185802,Staff,15,0,20,5
1683648449052,HIEU 154,A00,185823,Staff,11,0,20,9
1683648450079,HILA 102,A00,185826,Staff,14,0,20,6
1683648451103,HILD 2C,A01,185778,Staff,0,13,20,20
1683648452128,HILD 7B,A01,185780,Kwak; Nancy,0,16,32,32
1683648452128,HILD 7B,A02,185781,Kwak; Nancy,0,18,32,32
1683648453152,HILD 30,A01,185791,Staff,12,0,20,8
1683648454176,HISC 119,A00,185830,Golan; Tal,0,9,20,20
1683648455199,HITO 156GS,A00,185831,Patterson; Patrick H.,0,0,0,23
1683648456226,HIUS 103,A00,185832,Man; Simeon S,0,4,20,20
1683648457252,HIUS 117,A00,185836,Kwak; Nancy,2,0,20,18
1683648458280,HIUS 125,A00,185840,Man; Simeon S,0,1,23,23
1683648459307,HIUS 149,A00,185845,Staff,1,0,20,19
1683648460333,HUM 3,A01,185882,Zavodny; Tatiana Sophia,0,7,50,50
1683648460333,HUM 3,B01,185899,Caldwell; Michael Alan,0,18,50,50
1683648461357,HUM 3GS,A00,185900,Patterson; Patrick H.,0,0,0,23
1683648462383,HUM 4,A01,185938,Zroka; Amy Liane,30,0,50,20
1683648462383,HUM 4,B01,185956,Watkins; Eric,0,4,50,50
1683648462383,HUM 4,B02,202209,Watkins; Eric,0,4,50,50
1683648462383,HUM 4,B03,202210,Watkins; Eric,0,4,50,50
1683648463408,HUM 5,A01,185958,West; Geoffrey Scott,2,0,50,48
1683648463408,HUM 5,A02,202215,West; Geoffrey Scott,0,0,50,50
1683648464433,INTL 190,A00,185959,Gagnon; Jeffrey C,0,0,0,9
1683648464433,INTL 190,B00,185960,Lettieri; Michael Joseph,0,0,0,2
1683648465462,JAPN 180,A00,254509,Staff,5,0,30,25
1683648466487,LATI 10,A01,202853,Kennemore; Amy Michelle,4,0,35,31
1683648466487,LATI 10,A02,202854,Kennemore; Amy Michelle,2,0,35,33
1683648466487,LATI 10,A03,270054,Kennemore; Amy Michelle,30,0,30,0
1683648467511,LATI 180,A00,202855,Kennemore; Amy Michelle,11,0,20,9
1683648468536,LAWS 101,A00,201767,Golan; Tal,0,7,40,40
1683648469565,LIFR 1C,A00,185961,Staff,6,0,20,14
1683648470599,LIFR 1CX,A00,185962,Staff,7,0,20,13
1683648471626,LIFR 1D,A00,185963,Staff,7,0,20,13
1683648472654,LIFR 1DX,A00,185964,Staff,7,0,20,13
1683648473682,LIGN 101,A01,186039,Staff,43,0,50,7
1683648474706,LIGN 165,A00,186040,Staff,15,0,50,35
1683648475734,LTCS 108,A00,186041,Staff,5,0,10,5
1683648476758,LTCS 119,A00,186042,Staff,15,0,20,5
1683648477782,LTCS 130,A00,186043,Wesling; Megan E.,15,0,25,10
1683648479831,LTEA 138,A00,186119,Staff,14,0,40,26
1683648480853,LTEN 124,A00,186148,Staff,5,0,25,20
1683648481878,LTEN 178,A00,186149,Staff,7,0,15,8
1683648482905,LTEN 181,A00,186150,Blanco; John D,34,0,40,6
1683648483936,LTWL 120,A00,186160,Staff,20,0,25,5
1683648484964,LTWL 165,A00,186161,Staff,22,0,25,3
1683648485988,LTWR 100,A00,186162,Staff,0,5,15,15
1683648487016,LTWR 102,A00,186163,Doller; Ben,5,0,15,10
1683648488047,MAE 8,A01,186412,Staff,0,0,0,0
1683648489073,MAE 30B,A00,186445,Bahadori; Mohammad Yousef,82,0,100,18
1683648490103,MAE 40,A00,186592,Bewley; Thomas R,10,0,50,40
1683648491131,MAE 101B,A00,186593,Bahadori; Mohammad Yousef,80,0,100,20
1683648492155,MAE 105,A00,186594,Bandaru; Prabhakar,10,0,50,40
1683648493183,MAE 107,A00,186599,Pham; Hieu Tan,0,7,120,120
1683648494210,MAE 148,A01,186660,Silberman; Jack,3,0,16,13
1683648495238,MATH 10A,A01,188095,Staff,0,5,35,35
1683648496262,MATH 10B,A01,188097,Bowers; Adam R.,0,11,30,30
1683648496262,MATH 10B,A02,188099,Bowers; Adam R.,0,11,30,30
1683648496262,MATH 10B,B01,188104,Bowers; Adam R.,0,10,30,30
1683648496262,MATH 10B,B02,188106,Bowers; Adam R.,1,9,30,29
1683648497287,MATH 10C,A01,188111,Staff,0,18,30,30
1683648497287,MATH 10C,A02,188127,Staff,0,19,30,30
1683648497287,MATH 10C,A03,188131,Staff,0,19,30,30
1683648497287,MATH 10C,B01,188218,Staff,17,0,30,13
1683648497287,MATH 10C,B02,188244,Staff,13,0,30,17
1683648497287,MATH 10C,B03,188277,Staff,14,0,30,16
1683648498315,MATH 18,A01,188344,Bach; Quang Tran,18,0,30,12
1683648498315,MATH 18,A02,188345,Bach; Quang Tran,11,0,30,19
1683648498315,MATH 18,B01,188353,Bach; Quang Tran,11,0,30,19
1683648498315,MATH 18,B02,188354,Bach; Quang Tran,19,0,30,11
1683648499339,MATH 20A,A01,188374,Staff,11,0,35,24
1683648500363,MATH 20B,A01,188382,Ohm; Ko Woon,7,0,30,23
1683648500363,MATH 20B,A02,188383,Ohm; Ko Woon,22,0,30,8
1683648500363,MATH 20B,B01,188385,Ohm; Ko Woon,7,0,30,23
1683648500363,MATH 20B,B02,188392,Ohm; Ko Woon,22,0,30,8
1683648501388,MATH 20C,A01,188394,Harel; Guershon,11,0,30,19
1683648501388,MATH 20C,A02,188395,Harel; Guershon,13,0,30,17
1683648501388,MATH 20C,B01,188404,Harel; Guershon,5,0,30,25
1683648501388,MATH 20C,B02,188405,Harel; Guershon,18,0,30,12
1683648502411,MATH 20D,A01,188414,Hammock; Frances H,0,1,30,30
1683648502411,MATH 20D,A02,188415,Hammock; Frances H,0,1,30,30
1683648502411,MATH 20D,B01,188447,Hammock; Frances H,0,1,30,30
1683648502411,MATH 20D,B02,188486,Hammock; Frances H,4,0,30,26
1683648503437,MATH 20E,A01,188649,Staff,21,0,30,9
1683648503437,MATH 20E,A02,188650,Staff,21,0,30,9
1683648503437,MATH 20E,A03,188673,Staff,0,0,30,30
1683648504459,MATH 102,A01,188675,Staff,0,36,35,35
1683648505484,MATH 103B,A01,188681,Staff,3,0,35,32
1683648505484,MATH 103B,B01,188692,Staff,5,0,35,30
1683648506512,MATH 109,A01,188695,Salehi Golsefidy; Alireza,24,0,35,11
1683648506512,MATH 109,A02,188696,Salehi Golsefidy; Alireza,25,0,35,10
1683648507537,MATH 120A,A01,188698,Eggers; John Dietrich,7,0,35,28
1683648508562,MATH 142B,A01,188736,Ioana; Adrian,0,1,30,30
1683648508562,MATH 142B,A02,188741,Ioana; Adrian,0,1,30,30
1683648508562,MATH 142B,A03,188743,Ioana; Adrian,0,1,30,30
1683648509586,MATH 168A,A01,188790,Staff,0,10,35,35
1683648510611,MATH 170A,A01,188803,Nie; Jiawang,0,2,35,35
1683648510611,MATH 170A,A02,188811,Nie; Jiawang,0,0,35,35
1683648510611,MATH 170A,A03,188814,Nie; Jiawang,0,0,35,35
1683648510611,MATH 170A,A04,188815,Nie; Jiawang,10,0,35,25
1683648511701,MATH 193B,A01,188817,Staff,0,0,35,35
1683648511701,MATH 193B,A02,188818,Staff,5,0,35,30
1683648512729,MGT 4,A01,202857,Anderson; John Charles,61,0,80,19
1683648513757,MGT 12,A00,202858,Lindenberger; Wade Douglas,40,0,90,50
1683648514782,MGT 18,A00,202859,Staff,74,0,90,16
1683648515808,MGT 18GS,A00,202860,McKay; Michael J,13,0,28,15
1683648516835,MGT 45,A00,202861,Pecore; Joseph P.,12,0,90,78
1683648517865,MGT 100,A00,202863,Yavorsky; Daniel Ryan,28,0,90,62
1683648518889,MGT 103,A00,202864,Ehrich; Kristine R,0,17,90,90
1683648519914,MGT 112,A00,202865,Ehrich; Kristine R,15,0,90,75
1683648520941,MGT 121A,A00,202868,Staff,0,20,0,0
1683648521967,MGT 131B,A00,202869,Anderson; John Charles,59,0,90,31
1683648522992,MGT 136,A00,202871,Lindenberger; Wade Douglas,83,0,90,7
1683648524018,MGT 164,A00,202873,Staff,0,66,90,91
1683648525042,MGT 164GS,A00,202874,McKay; Mary A,13,0,28,15
1683648526067,MGT 180,A00,202875,Staff,0,50,90,91
1683648527091,MMW 11R,A01,205019,Herbst; Matthew,2,0,30,28
1683648527091,MMW 11R,A02,205026,Herbst; Matthew,29,0,30,1
1683648528126,MMW 15,A01,193512,Chang; Edmond Yi-Teh,0,8,28,28
1683648528126,MMW 15,A02,193513,Chang; Edmond Yi-Teh,0,5,28,28
1683648528126,MMW 15,A03,193514,Chang; Edmond Yi-Teh,0,5,28,28
1683648528126,MMW 15,A04,193515,Chang; Edmond Yi-Teh,0,5,28,28
1683648528126,MMW 15,A05,193516,Chang; Edmond Yi-Teh,0,5,28,28
1683648528126,MMW 15,A06,193517,Chang; Edmond Yi-Teh,0,6,28,28
1683648528126,MMW 15,B01,193519,Chang; Edmond Yi-Teh,0,5,28,28
1683648528126,MMW 15,B02,193520,Chang; Edmond Yi-Teh,0,5,28,28
1683648528126,MMW 15,B03,193521,Chang; Edmond Yi-Teh,0,5,28,28
1683648528126,MMW 15,B04,193522,Chang; Edmond Yi-Teh,0,5,28,28
1683648528126,MMW 15,B05,193523,Chang; Edmond Yi-Teh,0,5,28,28
1683648528126,MMW 15,B06,193524,Chang; Edmond Yi-Teh,0,5,28,28
1683648529152,MMW 122,A01,193526,Rahimi; Babak,0,16,28,28
1683648529152,MMW 122,A02,193527,Rahimi; Babak,0,15,28,28
1683648529152,MMW 122,A03,193528,Rahimi; Babak,0,0,0,0
1683648529152,MMW 122,A04,193529,Rahimi; Babak,0,0,0,0
1683648530179,MUS 1A,A01,186663,Staff,1,20,35,34
1683648531206,MUS 4,A01,186715,Staff,0,12,35,35
1683648532229,MUS 5R,A01,186796,Dubnov; Shlomo,0,17,35,35
1683648533253,MUS 6,A01,186798,Staff,0,5,25,25
1683648534278,MUS 7,A01,186830,Staff,11,0,35,24
1683648535300,MUS 8,A01,186930,Staff,0,26,35,35
1683648536328,MUS 15,A01,186932,Staff,0,16,35,35
1683648536328,MUS 15,B01,186934,Staff,0,17,35,35
1683648537361,MUS 80,A00,186935,Staff,0,0,20,20
1683648537361,MUS 80,B00,186936,Staff,24,0,25,1
1683648538387,NANO 11,A00,204702,Lipomi; Darren John,0,0,0,0
1683648539412,NANO 15,A01,204709,Yang; Kesong,0,1,0,0
1683648540436,NANO 114,A00,202069,Jahed Motlagh; Zeinab,3,0,10,7
1683648541466,PHIL 1,A00,186955,Grush; Rick Scott,31,0,40,9
1683648542493,PHIL 10,A01,186973,Grush; Rick Scott,27,0,35,8
1683648542493,PHIL 10,A02,186974,Grush; Rick Scott,33,0,35,2
1683648543517,PHIL 13,A01,186976,Staff,3,0,35,32
1683648543517,PHIL 13,A02,186977,Staff,16,0,35,19
1683648544543,PHIL 14,A01,186979,Staff,31,0,35,4
1683648544543,PHIL 14,A02,186986,Staff,32,0,35,3
1683648545571,PHIL 28,A01,186988,Staff,16,0,30,14
1683648545571,PHIL 28,A02,186989,Staff,1,0,30,29
1683648545571,PHIL 28,A03,186990,Staff,10,0,30,20
1683648545571,PHIL 28,A04,186991,Staff,26,0,30,4
1683648546597,PHIL 120,A00,186997,Staff,23,0,40,17
1683648547626,PHIL 137,A00,187003,Staff,7,0,40,33
1683648548650,PHIL 150,A00,187015,Staff,47,0,70,23
1683648549678,PHIL 167,A00,187021,Lamey; Andy M.,34,0,40,6
1683648550708,PHIL 174,A01,202226,Staff,17,0,20,3
1683648550708,PHIL 174,A02,202235,Staff,20,0,20,0
1683648551733,PHIL 191A,A00,258918,Staff,0,0,1,1
1683648552759,PHYS 1A,A00,187028,Staff,26,0,60,34
1683648553786,PHYS 1AL,001,187036,Staff,3,0,30,27
1683648553786,PHYS 1AL,002,187049,Staff,18,0,30,12
1683648554813,PHYS 1B,A00,187058,Staff,22,0,60,38
1683648555838,PHYS 1BL,001,187064,Staff,0,1,30,30
1683648555838,PHYS 1BL,002,187070,Staff,4,0,30,26
1683648556865,PHYS 1C,A00,187082,Staff,29,0,120,91
1683648557893,PHYS 1CL,001,187088,Staff,0,9,30,30
1683648557893,PHYS 1CL,002,187089,Staff,0,1,30,30
1683648557893,PHYS 1CL,009,262693,Staff,9,0,30,21
1683648558920,PHYS 2B,A01,187097,Staff,55,0,115,60
1683648559947,PHYS 2C,A01,187099,Staff,64,0,115,51
1683648560972,PHYS 2CL,A01,187101,Staff,5,0,28,23
1683648560972,PHYS 2CL,A02,187102,Staff,15,0,28,13
1683648562007,PHYS 2D,A01,187123,Shotwell; Brian,95,0,115,20
1683648563036,PHYS 4B,A01,187133,Grinstein; Benjamin,35,0,50,15
1683648564060,POLI 10,A00,188819,Staff,0,4,50,50
1683648565085,POLI 11,A00,188827,Staff,43,0,50,7
1683648566119,POLI 13R,A00,188828,Staff,0,1,20,20
1683648567146,POLI 27,A01,188830,Elgin; Samuel Zincke,0,2,70,70
1683648568169,POLI 30,A00,188832,Desposato; Scott,30,0,50,20
1683648569193,POLI 102F,A00,188834,Staff,0,0,40,40
1683648570217,POLI 104A,A00,188852,Staff,13,0,30,17
1683648571248,POLI 104I,A00,188853,Staff,0,7,20,20
1683648572272,POLI 110B,A00,188854,Wiens; David,7,0,20,13
1683648573296,POLI 112A,A00,188855,Wiens; David,4,0,30,26
1683648574320,POLI 117R,A00,188856,Forman; Fonna,0,12,20,20
1683648575347,POLI 118,A00,188857,Ingham; Sean,8,0,20,12
1683648576372,POLI 120G,A00,188858,Staff,8,0,30,22
1683648577398,POLI 131CR,A00,188863,Hoston; Germaine,21,0,50,29
1683648578422,POLI 133,A00,188864,Nellis; Gareth Hb,44,0,50,6
1683648579449,POLI 134D,A00,188865,Desposato; Scott,27,0,30,3
1683648580472,POLI 142A,A00,188871,Gartzke; Erik,21,0,50,29
1683648581495,POLI 142K,A00,188874,Staff,38,0,50,12
1683648582519,POLI 143,A00,188940,Gartzke; Erik,16,0,30,14
1683648583543,POLI 153,A00,188943,Staff,2,0,20,18
1683648584566,POLI 160AA,A00,188944,Staff,11,0,40,29
1683648585589,POLI 170A,A00,188945,Staff,11,0,30,19
1683648587641,PSYC 1,A00,188952,Staff,36,0,90,54
1683648588671,PSYC 2,B00,188953,Staff,19,0,35,16
1683648589698,PSYC 6,A00,188970,Staff,47,0,60,13
1683648590722,PSYC 7,A00,188973,Staff,35,0,45,10
1683648591745,PSYC 60,A01,188980,Rickard; Timothy C.,42,0,60,18
1683648592769,PSYC 70,A01,189001,Steiner; Eric Tomas,23,0,45,22
1683648593798,PSYC 100,A00,189005,Lacefield; Katharine I,0,99,120,120
1683648594824,PSYC 102,A00,189008,Staff,8,0,30,22
1683648595852,PSYC 106,B00,189026,Gorman; Michael R.,27,0,60,33
1683648596880,PSYC 114,B01,189033,Winkielman; Piotr,0,31,30,30
1683648597906,PSYC 131,A00,189036,Anagnostaras; Stephan,0,43,60,60
1683648598931,PSYC 136,A00,189041,Lowe; Angela Beth,0,7,25,25
1683648599957,PSYC 137,A00,189057,Winkielman; Piotr,0,37,25,25
1683648600982,PSYC 144,A00,189107,Wixted; John T,0,10,50,50
1683648603031,PSYC 162,A00,189142,Staff,0,9,85,85
1683648604054,PSYC 172,A00,189144,Gorman; Michael R.,0,6,30,30
1683648606101,PSYC 179,A00,189146,Lacefield; Katharine I,0,86,120,120
1683648607124,PSYC 181,A00,189147,Anagnostaras; Stephan,0,44,90,90
1683648608151,PSYC 190R,A00,189148,Barner; David A.,0,23,80,80
1683648609179,PSYC 191,A00,189275,Rickard; Timothy C.,0,10,25,25
1683648610202,PSYC 193,A00,189276,Chapman; Eddie Nathaniel,0,1,0,4
1683648611229,PSYC 193L,A01,189281,Lowe; Angela Beth,10,0,20,10
1683648611229,PSYC 193L,B01,189285,Staff,28,0,35,7
1683648612262,RELI 149,A00,187137,Rahimi; Babak,7,0,40,33
1683648613288,SE 9,A01,187315,Staff,0,2,18,18
1683648614314,SE 101B,A00,187409,Staff,24,0,30,6
1683648615397,SE 110B,A00,187444,Staff,10,0,40,30
1683648616423,SE 130B,A00,187449,Staff,31,0,40,9
1683648617447,SE 150A,A00,187516,Staff,9,0,20,11
1683648618472,SE 154,A00,187528,Staff,29,0,50,21
1683648619495,SIO 3,A01,258171,Staff,35,0,40,5
1683648620523,SIO 10,A00,187144,Cook; Geoffrey W,0,6,75,75
1683648621546,SIO 45,A00,187152,Cook; Geoffrey W,0,4,100,100
1683648622571,SIO 109R,A00,194486,Staff,0,4,20,20
1683648624617,SIO 187,A01,187233,Kacev; David,12,0,40,28
1683648625644,SOCI 1,A01,258656,Thorpe; Charles Robert,28,0,30,2
1683648625644,SOCI 1,A02,258658,Thorpe; Charles Robert,30,0,30,0
1683648625644,SOCI 1,A03,258661,Thorpe; Charles Robert,25,0,25,0
1683648625644,SOCI 1,A04,258666,Thorpe; Charles Robert,22,0,25,3
1683648625644,SOCI 1,A05,258897,Thorpe; Charles Robert,22,0,25,3
1683648625644,SOCI 1,A06,258898,Thorpe; Charles Robert,25,0,25,0
1683648626668,SOCI 30,A01,258903,Pardo Guerra; Juan Pablo,14,0,30,16
1683648627694,SOCI 102,A00,258904,Staff,9,0,25,16
1683648628718,SOCI 106,A00,258905,Staff,19,0,25,6
1683648629745,SOCI 111,A00,258907,Ribas Norris; Janet Vanesa,26,0,30,4
1683648630772,SOCI 121R,A00,258908,Pardo Guerra; Juan Pablo,8,0,30,22
1683648631803,SOCI 126,A01,203330,Staff,14,0,20,6
1683648632826,SOCI 131,A00,258909,Thorpe; Charles Robert,30,0,60,30
1683648633853,SOCI 135,A00,258910,Payne; Christine Anna,0,11,30,30
1683648634882,SOCI 157,A00,258911,Staff,12,0,30,18
1683648635906,SOCI 184,A00,258912,Staff,25,0,30,5
1683648636930,SOCI 188D,A00,258913,Staff,22,0,30,8
1683648637954,SYN 2,001,187529,Staff,9,0,16,7
1683648637954,SYN 2,002,201452,Staff,0,20,16,16
1683648637954,SYN 2,003,201469,Staff,2,0,16,14
1683648638981,SYN 100,A01,187531,Staff,0,9,20,20
1683648638981,SYN 100,B01,201491,Staff,0,10,20,20
1683648640005,TDAC 1,A00,189286,Walsh; Kim C.,3,0,20,17
1683648640005,TDAC 1,B00,189287,Harting; Carla Kelso,10,0,20,10
1683648641032,TDAC 101,A00,189300,Walsh; Kim C.,16,0,20,4
1683648641032,TDAC 101,B00,189301,Harting; Carla Kelso,18,0,20,2
1683648642057,TDAC 102,A00,189304,Basso; Beatrice,14,0,20,6
1683648643081,TDAC 108,A00,189305,Staff,18,0,20,2
1683648644113,TDDE 131,A00,189310,Staff,19,0,20,1
1683648644113,TDDE 131,B00,189314,Staff,19,0,20,1
1683648644113,TDDE 131,C00,189315,Staff,48,0,50,2
1683648644113,TDDE 131,D00,189316,Staff,14,0,15,1
1683648644113,TDDE 131,E00,204841,Staff,20,0,20,0
1683648645136,TDGE 10,A00,189289,Staff,27,0,50,23
1683648645136,TDGE 10,B00,189290,Havis; Allan,0,0,50,50
1683648646161,TDGE 11,A00,189291,Fulton; Julia,0,4,50,50
1683648646161,TDGE 11,B00,189292,Staff,20,0,25,5
1683648646161,TDGE 11,C00,260270,Staff,0,0,0,0
1683648647188,TDGE 25,A00,189294,Staff,2,0,20,18
1683648648212,TDGE 124,A00,189318,Fulton; Julia,0,8,50,50
1683648649239,TDGE 125,A00,189319,Staff,13,0,25,12
1683648649239,TDGE 125,B00,189320,Staff,23,0,25,2
1683648650266,TDGE 127,A00,189322,Havis; Allan,0,0,50,50
1683648651290,TDHT 101,A00,189323,Staff,18,0,25,7
1683648651290,TDHT 101,B00,189324,Staff,25,0,25,0
1683648652320,TDHT 102,A00,189325,Staff,49,0,50,1
1683648653346,TDMV 1,A00,189295,Arcidiacono; Kristin,20,0,30,10
1683648653346,TDMV 1,B00,189296,Caligagan; Maria T.,24,0,30,6
1683648654373,TDMV 2,A00,189297,Sammartano; Tonnie,27,0,30,3
1683648654373,TDMV 2,B00,189299,Arcidiacono; Kristin,23,0,30,7
1683648655406,TDMV 3,A00,204998,Rincon; Alicia,22,0,30,8
1683648656431,TDMV 120,A00,189458,Sammartano; Tonnie,28,0,30,2
1683648657455,TDMV 138,A00,189541,Jun; Grace Shin Hae,20,0,40,20
1683648658484,TDMV 142,A00,189717,Caligagan; Tony,25,0,30,5
1683648658484,TDMV 142,B00,189718,Caligagan; Maria T.,25,0,30,5
1683648659508,TMC 2,A01,187533,Staff,25,0,25,0
1683648659508,TMC 2,A02,187534,Staff,25,0,25,0
1683648660533,USP 1,A01,187536,Kwak; Nancy,0,16,25,25
1683648661561,USP 5,A01,187538,Staff,9,0,25,16
1683648662588,USP 101,A00,199253,Staff,0,4,0,0
1683648663612,USP 124,A00,187562,Boomhower; Matthew Charles,0,0,30,30
1683648664643,USP 138,A00,187582,Staff,20,0,25,5
1683648665667,USP 152,A01,187597,Staff,3,0,25,22
1683648666692,USP 153,A00,187598,Staff,19,0,25,6
1683648667721,USP 168,A00,187607,Kwak; Nancy,2,0,5,3
1683648668749,USP 173,A00,187619,Staff,4,0,25,21
1683648669773,USP 181,A00,187638,Staff,0,4,25,25
1683648670799,VIS 103,A00,187650,Cruz; Edwin Teddy,18,0,75,57
1683648671832,VIS 110D,A00,187669,Staff,13,0,22,9
1683648672856,VIS 127C,A00,187720,Shen; Kuiyi,67,0,146,79
1683648673881,VIS 149,A00,187731,Yoldas; Pinar,0,14,22,22
1683648674906,VIS 151,A01,188091,Staff,22,0,34,12
1683648674906,VIS 151,A02,188092,Staff,11,0,34,23
1683648675931,VIS 160B,A00,188093,Stalbaum; Brett,0,1,10,10
1683648677988,WCWP 10B,A00,201720,Staff,10,0,15,5
1683648677988,WCWP 10B,B00,201722,Staff,9,0,15,6
1683648679012,WCWP 100,A00,201725,Gagnon; Jeffrey C,0,0,2,2
1683648679012,WCWP 100,B00,201727,Staff,0,4,15,15
1683648682108,ANBI 133,A00,258401,Wilder; Linnea Lorene,34,0,40,6
1683648683141,ANBI 140,A00,258395,Hrvoj Mihic; Branka,18,0,25,7
1683648684166,ANSC 120,A00,258402,Bialecki; Jon Anthony,26,0,40,14
1683648685191,ANSC 144,A00,258400,Staff,12,0,40,28
1683648687242,ANSC 166,A00,258396,Parish; Steven Martin,156,0,175,19
1683648688265,ANSC 180,A00,193533,Staff,8,0,20,12
1683648689289,ANSC 188,A00,258397,Jassal; Aftab,34,0,40,6
1683648690318,ANTH 3,A01,258316,Staff,23,0,30,7
1683648691345,ANTH 5,A00,258394,Semendeferi; Ekaterini,16,0,20,4
1683648692369,ANTH 21,A01,258331,Staff,4,0,40,36
1683648693396,ANTH 103,A00,258398,Varma; Saiba,15,0,25,10
1683648694427,AWP 10,001,202034,Staff,0,0,0,0
1683648694427,AWP 10,002,202035,Staff,0,0,0,0
1683648694427,AWP 10,003,202036,Staff,0,0,0,0
1683648694427,AWP 10,004,202037,Staff,0,0,0,0
1683648694427,AWP 10,005,202038,Staff,0,0,0,0
1683648694427,AWP 10,006,202039,Staff,0,0,0,0
1683648694427,AWP 10,007,202040,Staff,0,0,0,0
1683648694427,AWP 10,008,202041,Staff,0,0,0,0
1683648694427,AWP 10,009,202042,Staff,0,0,0,0
1683648694427,AWP 10,010,202043,Staff,0,0,0,0
1683648694427,AWP 10,011,202044,Staff,0,0,0,0
1683648694427,AWP 10,012,202045,Staff,0,0,0,0
1683648694427,AWP 10,013,202046,Staff,0,0,0,0
1683648694427,AWP 10,014,202047,Staff,0,0,0,0
1683648694427,AWP 10,015,202048,Staff,0,0,0,0
1683648694427,AWP 10,016,202049,Staff,0,0,0,0
1683648694427,AWP 10,017,202050,Staff,0,0,0,0
1683648694427,AWP 10,018,202051,Staff,0,0,0,0
1683648694427,AWP 10,019,202052,Staff,0,0,0,0
1683648694427,AWP 10,020,202053,Staff,0,0,0,0
1683648694427,AWP 10,021,202054,Staff,0,0,0,0
1683648694427,AWP 10,022,202055,Staff,0,0,0,0
1683648694427,AWP 10,023,202056,Staff,0,0,0,0
1683648694427,AWP 10,024,202057,Staff,0,0,0,0
1683648694427,AWP 10,025,202058,Staff,0,0,0,0
1683648694427,AWP 10,026,202059,Staff,0,0,0,0
1683648695452,AWP 102,001,202032,Staff,0,0,0,0
1683648695452,AWP 102,002,202033,Staff,0,0,0,0
1683648696476,BENG 100,A01,254234,Taylor Amos; Alyssa C,31,0,40,9
1683648697504,BENG 196,001,270013,Engler; Adam J.,9999,0,9999,0
1683648698530,BICD 100R,A01,202018,Smith; Laurie,0,7,32,32
1683648698530,BICD 100R,A02,202019,Smith; Laurie,0,3,32,32
1683648698530,BICD 100R,A03,202020,Smith; Laurie,0,1,32,32
1683648698530,BICD 100R,A04,202021,Smith; Laurie,6,0,32,26
1683648698530,BICD 100R,A05,202022,Smith; Laurie,11,0,32,21
1683648699558,BICD 136,A01,193242,Gustafson-Brown; Cindy,0,2,32,32
1683648699558,BICD 136,A02,193244,Gustafson-Brown; Cindy,13,0,32,19
1683648700588,BIEB 102,A01,193249,Butler; Shannon Rhey,0,2,32,32
1683648700588,BIEB 102,A02,193251,Butler; Shannon Rhey,0,0,32,32
1683648700588,BIEB 102,A03,193253,Butler; Shannon Rhey,0,0,32,32
1683648700588,BIEB 102,A04,193255,Butler; Shannon Rhey,14,0,32,18
1683648700588,BIEB 102,A05,193265,Butler; Shannon Rhey,26,0,32,6
1683648700588,BIEB 102,A06,193269,Butler; Shannon Rhey,14,0,32,18
1683648702645,BIEB 150,A01,193274,Staff,0,0,32,32
1683648702645,BIEB 150,A02,193285,Staff,24,0,32,8
1683648703670,BIEB 194,A00,193286,Kurle; Carolyn M.,20,0,32,12
1683648704700,BILD 1,A01,192291,Staff,15,0,32,17
1683648704700,BILD 1,A02,192292,Staff,30,0,32,2
1683648704700,BILD 1,B01,192520,Reuther; Keefe,0,1,0,0
1683648704700,BILD 1,B02,192532,Reuther; Keefe,0,1,0,0
1683648705726,BILD 3,A01,192556,Butler; Shannon Rhey,0,0,32,32
1683648705726,BILD 3,A02,192581,Butler; Shannon Rhey,1,0,32,31
1683648705726,BILD 3,A03,192611,Butler; Shannon Rhey,21,0,32,11
1683648705726,BILD 3,A04,192612,Butler; Shannon Rhey,24,0,32,8
1683648705726,BILD 3,A05,192613,Butler; Shannon Rhey,26,0,32,6
1683648705726,BILD 3,A06,192679,Butler; Shannon Rhey,27,0,32,5
1683648705726,BILD 3,A07,192682,Butler; Shannon Rhey,20,0,32,12
1683648706751,BILD 4,A01,192836,Reuther; Keefe,1,0,24,23
1683648706751,BILD 4,A02,193044,Reuther; Keefe,4,0,24,20
1683648707776,BILD 10,A01,193142,Gustafson-Brown; Cindy,29,0,32,3
1683648707776,BILD 10,A02,193149,Gustafson-Brown; Cindy,31,0,32,1
1683648708801,BIMM 100,A01,193301,Staff,0,6,32,32
1683648708801,BIMM 100,A02,193312,Staff,0,7,32,32
1683648708801,BIMM 100,A03,193323,Staff,0,9,32,32
1683648709826,BIMM 101,A01,193329,McDonnell; Lisa Marie,0,4,24,24
1683648709826,BIMM 101,A02,193339,McDonnell; Lisa Marie,0,3,24,24
1683648709826,BIMM 101,B01,193354,McDonnell; Lisa Marie,0,4,24,24
1683648709826,BIMM 101,B02,193357,McDonnell; Lisa Marie,0,3,24,24
1683648710854,BIMM 110,A01,193377,Tat; John,0,11,32,32
1683648710854,BIMM 110,A02,193378,Tat; John,0,10,32,32
1683648711879,BIMM 120,A01,206116,Staff,0,0,32,32
1683648711879,BIMM 120,A02,206117,Staff,6,0,32,26
1683648711879,BIMM 120,A03,206121,Staff,21,0,32,11
1683648712903,BIPN 100,A01,193393,Park; Ji Young,0,14,32,32
1683648712903,BIPN 100,A02,193402,Park; Ji Young,0,14,32,32
1683648712903,BIPN 100,A03,193413,Park; Ji Young,0,14,32,32
1683648712903,BIPN 100,A04,193414,Park; Ji Young,0,13,32,32
1683648713928,BIPN 102,A01,193429,Staff,0,0,32,32
1683648713928,BIPN 102,A02,193438,Staff,18,0,32,14
1683648714956,BIPN 106,A01,193450,Reyes Gonzalez; Catalina,0,2,40,40
1683648715984,BIPN 134,A01,193465,Cooke; James Edward,0,0,32,32
1683648715984,BIPN 134,A02,193474,Cooke; James Edward,25,0,32,7
1683648715984,BIPN 134,A03,193485,Cooke; James Edward,29,0,32,3
1683648715984,BIPN 134,A04,193486,Cooke; James Edward,20,0,32,12
1683648715984,BIPN 134,A05,193491,Cooke; James Edward,31,0,32,1
1683648715984,BIPN 134,A06,193501,Cooke; James Edward,30,0,32,2
1683648715984,BIPN 134,A07,193510,Cooke; James Edward,29,0,32,3
1683648718037,BISP 194,A00,222522,Staff,14,0,32,18
1683648719135,CAT 124,A01,202407,Staff,19,0,25,6
1683648720158,CAT 125,A00,202408,Marchisotto; Jennifer Anne,2,0,20,18
1683648721183,CAT 125R,A00,202409,Smith; Lauryn Alissa,0,11,20,20
1683648721183,CAT 125R,B00,202410,Morales; Celeste Georgianna,0,11,20,20
1683648721183,CAT 125R,C00,202411,Irwin; Matthew Joseph,0,12,20,20
1683648722209,CENG 15,A01,204712,Yang; Kesong,0,1,0,0
1683648723238,CENG 114,A00,202070,Jahed Motlagh; Zeinab,5,0,20,15
1683648724261,CGS 105,A00,185477,Wesling; Megan E.,24,0,40,16
1683648725290,CGS 106,A00,185494,Staff,11,0,22,11
1683648726315,CGS 108,A00,185495,Staff,14,0,20,6
1683648727340,CGS 114,A00,185496,Staff,13,0,18,5
1683648728368,CGS 119,A00,185501,Staff,15,0,20,5
1683648729397,CGS 120,A00,185511,Staff,12,0,20,8
1683648730422,CHEM 4,A01,184675,Bussey; Thomas J,97,0,100,3
1683648731452,CHEM 6A,A01,184677,Staff,33,0,60,27
1683648732485,CHEM 6B,A01,184679,Staff,63,0,100,37
1683648733510,CHEM 6C,A01,184681,Bussey; Thomas J,0,0,50,50
1683648733510,CHEM 6C,A02,184682,Bussey; Thomas J,32,0,50,18
1683648734533,CHEM 40A,A01,184684,Albizati; Kim F.,34,0,100,66
1683648735561,CHEM 40B,A01,184686,Albizati; Kim F.,0,22,100,100
1683648736590,CHEM 41B,A01,184690,Staff,51,0,100,49
1683648737614,COGS 3,A01,184715,Boyle; Mary E. T.,0,27,40,40
1683648738639,COGS 14B,A01,185172,Staff,0,14,38,38
1683648739664,COGS 18,A01,184736,Staff,14,0,80,66
1683648740687,COGS 100,A01,184932,Staff,0,7,73,73
1683648741711,COGS 101A,A01,184935,Staff,0,39,30,30
1683648742736,COGS 101B,A01,184944,Staff,0,2,30,30
1683648743760,COGS 101C,A01,184946,Staff,0,10,30,30
1683648744785,COGS 102A,A01,184951,Johnson; Christine M.,2,0,40,38
1683648745815,COGS 107B,A01,184953,Mooshagian; Eric Frederick,0,51,40,40
1683648746840,COGS 118B,A01,184959,Gupta; Anjum,0,49,40,40
1683648747864,COGS 153,A00,184961,Staff,0,16,30,30
1683648748890,COGS 177,A00,184962,Staff,0,21,30,30
1683648749922,COGS 187A,A01,184969,Boyle; Mary E. T.,0,19,40,40
1683648750950,COMM 10,A01,185174,Staff,0,5,25,25
1683648750950,COMM 10,A02,185189,Staff,0,2,25,25
1683648750950,COMM 10,A03,269821,Staff,0,1,0,0
1683648751974,COMM 100B,A01,185475,Staff,0,1,0,2
1683648751974,COMM 100B,A02,185476,Staff,12,0,25,13
1683648752999,COMM 100C,A01,185314,Staff,1,0,25,24
1683648752999,COMM 100C,A02,185327,Staff,18,0,25,7
1683648754026,COMM 110M,A00,185349,Staff,0,0,40,40
1683648755050,COMM 113T,A00,185352,Staff,25,0,40,15
1683648756073,COMM 114I,A00,185353,Staff,31,0,40,9
1683648757096,COMM 131,A00,185354,Staff,17,0,30,13
1683648758122,CSE 8A,A50,185358,Cao; Yingjun,0,46,10,10
1683648759144,CSE 8B,A01,185362,Staff,0,48,50,50
1683648760168,CSE 11,A01,185416,Cao; Yingjun,0,91,10,10
1683648761194,CSE 20,A01,185445,Briones; Jor-el Thomas Caparas,4,0,25,21
1683648762218,CSE 21,A01,185447,Staff,9,0,50,41
1683648763242,CSE 101,A01,185451,Staff,0,13,50,50
1683648763242,CSE 101,B01,185453,Jones; Miles E,0,13,50,50
1683648765296,CSE 141,A01,185458,Eldon; John,16,0,100,84
1683648766322,CSE 141L,A01,185461,Eldon; John,8,0,100,92
1683648767347,CSE 142,A01,185463,Staff,35,0,60,25
1683648767347,CSE 142,B01,201355,Staff,0,7,60,60
1683648768371,CSE 142L,A01,185470,Staff,35,0,60,25
1683648768371,CSE 142L,B01,201417,Staff,0,6,60,60
1683648769397,CSE 190,A00,201433,Staff,32,0,49,17
1683648770458,DOC 1,A01,259136,Strom; Megan C.,7,0,15,8
1683648770458,DOC 1,A02,259137,Strom; Megan C.,14,0,15,1
1683648770458,DOC 1,A03,259138,Strom; Megan C.,14,0,15,1
1683648770458,DOC 1,A04,259139,Strom; Megan C.,14,0,15,1
1683648771483,DOC 100D,A00,259140,Pass; Natalye Joann,14,0,25,11
1683648772507,DSGN 1,A01,184749,Rill; Bryan,0,26,30,30
1683648773535,DSGN 100,A01,185168,Staff,0,2,25,25
1683648774562,ECE 5,A01,185626,Morris; Karcher William,0,11,0,0
1683648775585,ECE 101,A01,185628,Staff,14,0,70,56
1683648776610,ECE 107,A01,185635,Baghdadchi; Saharnaz,0,0,20,20
1683648776610,ECE 107,A02,185638,Baghdadchi; Saharnaz,3,0,20,17
1683648777637,ECE 148,A01,185647,Silberman; Jack,0,0,16,16
1683648778663,ECON 1,A01,185537,Crane; Meredith Helen,54,0,70,16
1683648779693,ECON 3,A01,185549,Crane; Meredith Helen,29,0,70,41
1683648780716,ECON 4,A01,203354,Anderson; John Charles,0,5,10,10
1683648781741,ECON 100A,A01,185574,Staff,0,5,40,40
1683648782768,ECON 100B,A01,185576,Staff,0,12,50,50
1683648783796,ECON 100C,A01,185589,Newhouse; Herbert S,30,0,70,40
1683648784823,ECON 105,A00,185608,Vespa; Emanuel Ignacio,19,0,35,16
1683648785850,ECON 109,A01,185610,Shishkin; Denis,9,0,35,26
1683648786874,ECON 110A,A01,185612,Staff,9,0,40,31
1683648787903,ECON 120A,A01,185615,Staff,20,0,40,20
1683648788930,ECON 120C,A01,185617,Sun; Yixiao,0,20,70,70
1683648789957,ECON 144,A00,203346,Squires; Dale E,2,0,35,33
1683648790986,ECON 171,A01,203349,Newhouse; Herbert S,0,1,35,35
1683648792011,ECON 173A,A01,185621,Toda; Alexis Akira,21,0,35,14
1683648793035,EDS 25,A01,202413,Staff,0,1,0,0
1683648793035,EDS 25,A02,202414,Staff,0,1,0,0
1683648793035,EDS 25,A03,202415,Staff,0,0,0,0
1683648793035,EDS 25,A04,202416,Staff,0,1,0,0
1683648793035,EDS 25,A05,202439,Staff,0,0,0,0
1683648793035,EDS 25,A06,202440,Staff,0,0,0,0
1683648793035,EDS 25,B01,202631,Staff,0,0,0,0
1683648793035,EDS 25,B02,202632,Staff,0,0,0,0
1683648793035,EDS 25,B03,202639,Staff,0,0,0,0
1683648793035,EDS 25,B04,202640,Staff,0,0,0,0
1683648793035,EDS 25,B05,202643,Staff,0,0,0,0
1683648793035,EDS 25,B06,202644,Staff,0,0,0,0
1683648794065,EDS 38,A01,202659,Black; Alison Michelle,24,0,25,1
1683648795092,EDS 115,A00,202652,Staff,18,0,30,12
1683648796113,EDS 125,A00,202649,Staff,13,0,30,17
1683648797142,EDS 126,A01,203332,Staff,30,0,30,0
1683648798169,EDS 139,A00,202838,Staff,16,0,25,9
1683648799193,EDS 146,A01,202655,Staff,14,0,25,11
1683648800217,ENG 15,A00,185667,Staff,0,1,0,0
1683648800217,ENG 15,B00,185672,Staff,0,0,0,0
1683648800217,ENG 15,C00,185675,Staff,0,0,0,0
1683648800217,ENG 15,D00,185682,Staff,0,0,0,0
1683648800217,ENG 15,E00,185684,Staff,0,0,0,0
1683648801242,ETHN 103,A00,185710,Staff,0,8,35,35
1683648802266,ETHN 103A,A00,199228,Man; Simeon S,0,0,9,9
1683648803293,ETHN 109,A00,185711,Staff,16,0,35,19
1683648804317,ETHN 142,A00,185726,Staff,0,4,30,30
1683648805340,ETHN 163J,A00,199229,Man; Simeon S,5,0,8,3
1683648806367,ETHN 168,A00,185727,Staff,7,0,10,3
1683648807394,ETHN 182,A00,185728,Staff,0,0,35,35
1683648808418,ETHN 183,A00,185737,Staff,9,0,18,9
1683648809445,GLBH 111,A01,209361,Burgos; Jose L.,0,0,0,0
1683648811498,HIEU 104,A00,185792,Staff,14,0,20,6
1683648812522,HIEU 115,A00,185800,Staff,0,0,20,20
1683648813549,HIEU 128,A00,185801,Staff,0,9,20,20
1683648814574,HIEU 147,A00,185802,Staff,15,0,20,5
1683648815602,HIEU 154,A00,185823,Staff,11,0,20,9
1683648816628,HILA 102,A00,185826,Staff,14,0,20,6
1683648817655,HILD 2C,A01,185778,Staff,0,13,20,20
1683648818681,HILD 7B,A01,185780,Kwak; Nancy,0,16,32,32
1683648818681,HILD 7B,A02,185781,Kwak; Nancy,0,18,32,32
1683648819705,HILD 30,A01,185791,Staff,12,0,20,8
1683648820730,HISC 119,A00,185830,Golan; Tal,0,9,20,20
1683648821754,HITO 156GS,A00,185831,Patterson; Patrick H.,0,0,0,23
1683648822834,HIUS 103,A00,185832,Man; Simeon S,0,4,20,20
1683648823861,HIUS 117,A00,185836,Kwak; Nancy,2,0,20,18
1683648824886,HIUS 125,A00,185840,Man; Simeon S,0,1,23,23
1683648825908,HIUS 149,A00,185845,Staff,1,0,20,19
1683648826933,HUM 3,A01,185882,Zavodny; Tatiana Sophia,0,7,50,50
1683648826933,HUM 3,B01,185899,Caldwell; Michael Alan,0,18,50,50
1683648827958,HUM 3GS,A00,185900,Patterson; Patrick H.,0,0,0,23
1683648828989,HUM 4,A01,185938,Zroka; Amy Liane,30,0,50,20
1683648828989,HUM 4,B01,185956,Watkins; Eric,0,4,50,50
1683648828989,HUM 4,B02,202209,Watkins; Eric,0,4,50,50
1683648828989,HUM 4,B03,202210,Watkins; Eric,0,4,50,50
1683648830014,HUM 5,A01,185958,West; Geoffrey Scott,2,0,50,48
1683648830014,HUM 5,A02,202215,West; Geoffrey Scott,0,0,50,50
1683648831041,INTL 190,A00,185959,Gagnon; Jeffrey C,0,0,0,9
1683648831041,INTL 190,B00,185960,Lettieri; Michael Joseph,0,0,0,2
1683648832065,JAPN 180,A00,254509,Staff,5,0,30,25
1683648833089,LATI 10,A01,202853,Kennemore; Amy Michelle,4,0,35,31
1683648833089,LATI 10,A02,202854,Kennemore; Amy Michelle,2,0,35,33
1683648833089,LATI 10,A03,270054,Kennemore; Amy Michelle,30,0,30,0
1683648834113,LATI 180,A00,202855,Kennemore; Amy Michelle,11,0,20,9
1683648835140,LAWS 101,A00,201767,Golan; Tal,0,7,40,40
1683648836169,LIFR 1C,A00,185961,Staff,6,0,20,14
1683648837195,LIFR 1CX,A00,185962,Staff,7,0,20,13
1683648838231,LIFR 1D,A00,185963,Staff,7,0,20,13
1683648839255,LIFR 1DX,A00,185964,Staff,7,0,20,13
1683648840279,LIGN 101,A01,186039,Staff,43,0,50,7
1683648841302,LIGN 165,A00,186040,Staff,15,0,50,35
1683648842327,LTCS 108,A00,186041,Staff,5,0,10,5
1683648843352,LTCS 119,A00,186042,Staff,15,0,20,5
1683648844379,LTCS 130,A00,186043,Wesling; Megan E.,15,0,25,10
1683648846430,LTEA 138,A00,186119,Staff,14,0,40,26
1683648847454,LTEN 124,A00,186148,Staff,5,0,25,20
1683648848483,LTEN 178,A00,186149,Staff,7,0,15,8
1683648849508,LTEN 181,A00,186150,Blanco; John D,34,0,40,6
1683648850533,LTWL 120,A00,186160,Staff,20,0,25,5
1683648851557,LTWL 165,A00,186161,Staff,22,0,25,3
1683648852581,LTWR 100,A00,186162,Staff,0,5,15,15
1683648853608,LTWR 102,A00,186163,Doller; Ben,5,0,15,10
1683648854637,MAE 8,A01,186412,Staff,0,0,0,0
1683648855659,MAE 30B,A00,186445,Bahadori; Mohammad Yousef,82,0,100,18
1683648856683,MAE 40,A00,186592,Bewley; Thomas R,10,0,50,40
1683648857707,MAE 101B,A00,186593,Bahadori; Mohammad Yousef,80,0,100,20
1683648858736,MAE 105,A00,186594,Bandaru; Prabhakar,10,0,50,40
1683648859760,MAE 107,A00,186599,Pham; Hieu Tan,0,7,120,120
1683648860788,MAE 148,A01,186660,Silberman; Jack,3,0,16,13
1683648861812,MATH 10A,A01,188095,Staff,0,5,35,35
1683648862837,MATH 10B,A01,188097,Bowers; Adam R.,0,11,30,30
1683648862837,MATH 10B,A02,188099,Bowers; Adam R.,0,11,30,30
1683648862837,MATH 10B,B01,188104,Bowers; Adam R.,0,10,30,30
1683648862837,MATH 10B,B02,188106,Bowers; Adam R.,1,9,30,29
1683648863862,MATH 10C,A01,188111,Staff,0,18,30,30
1683648863862,MATH 10C,A02,188127,Staff,0,19,30,30
1683648863862,MATH 10C,A03,188131,Staff,0,19,30,30
1683648863862,MATH 10C,B01,188218,Staff,17,0,30,13
1683648863862,MATH 10C,B02,188244,Staff,13,0,30,17
1683648863862,MATH 10C,B03,188277,Staff,14,0,30,16
1683648864892,MATH 18,A01,188344,Bach; Quang Tran,18,0,30,12
1683648864892,MATH 18,A02,188345,Bach; Quang Tran,11,0,30,19
1683648864892,MATH 18,B01,188353,Bach; Quang Tran,11,0,30,19
1683648864892,MATH 18,B02,188354,Bach; Quang Tran,19,0,30,11
1683648865919,MATH 20A,A01,188374,Staff,11,0,35,24
1683648866943,MATH 20B,A01,188382,Ohm; Ko Woon,7,0,30,23
1683648866943,MATH 20B,A02,188383,Ohm; Ko Woon,22,0,30,8
1683648866943,MATH 20B,B01,188385,Ohm; Ko Woon,7,0,30,23
1683648866943,MATH 20B,B02,188392,Ohm; Ko Woon,22,0,30,8
1683648867968,MATH 20C,A01,188394,Harel; Guershon,11,0,30,19
1683648867968,MATH 20C,A02,188395,Harel; Guershon,13,0,30,17
1683648867968,MATH 20C,B01,188404,Harel; Guershon,5,0,30,25
1683648867968,MATH 20C,B02,188405,Harel; Guershon,18,0,30,12
1683648868993,MATH 20D,A01,188414,Hammock; Frances H,0,1,30,30
1683648868993,MATH 20D,A02,188415,Hammock; Frances H,0,1,30,30
1683648868993,MATH 20D,B01,188447,Hammock; Frances H,0,1,30,30
1683648868993,MATH 20D,B02,188486,Hammock; Frances H,4,0,30,26
1683648870021,MATH 20E,A01,188649,Staff,21,0,30,9
1683648870021,MATH 20E,A02,188650,Staff,21,0,30,9
1683648870021,MATH 20E,A03,188673,Staff,0,0,30,30
1683648871048,MATH 102,A01,188675,Staff,0,36,35,35
1683648872072,MATH 103B,A01,188681,Staff,3,0,35,32
1683648872072,MATH 103B,B01,188692,Staff,5,0,35,30
1683648873096,MATH 109,A01,188695,Salehi Golsefidy; Alireza,24,0,35,11
1683648873096,MATH 109,A02,188696,Salehi Golsefidy; Alireza,25,0,35,10
1683648874124,MATH 120A,A01,188698,Eggers; John Dietrich,7,0,35,28
1683648875150,MATH 142B,A01,188736,Ioana; Adrian,0,1,30,30
1683648875150,MATH 142B,A02,188741,Ioana; Adrian,0,1,30,30
1683648875150,MATH 142B,A03,188743,Ioana; Adrian,0,1,30,30
1683648876174,MATH 168A,A01,188790,Staff,0,10,35,35
1683648877198,MATH 170A,A01,188803,Nie; Jiawang,0,2,35,35
1683648877198,MATH 170A,A02,188811,Nie; Jiawang,0,0,35,35
1683648877198,MATH 170A,A03,188814,Nie; Jiawang,0,0,35,35
1683648877198,MATH 170A,A04,188815,Nie; Jiawang,10,0,35,25
1683648878225,MATH 193B,A01,188817,Staff,0,0,35,35
1683648878225,MATH 193B,A02,188818,Staff,5,0,35,30
1683648879252,MGT 4,A01,202857,Anderson; John Charles,61,0,80,19
1683648880275,MGT 12,A00,202858,Lindenberger; Wade Douglas,40,0,90,50
1683648881300,MGT 18,A00,202859,Staff,74,0,90,16
1683648882326,MGT 18GS,A00,202860,McKay; Michael J,13,0,28,15
1683648883351,MGT 45,A00,202861,Pecore; Joseph P.,12,0,90,78
1683648884382,MGT 100,A00,202863,Yavorsky; Daniel Ryan,28,0,90,62
1683648885405,MGT 103,A00,202864,Ehrich; Kristine R,0,17,90,90
1683648886429,MGT 112,A00,202865,Ehrich; Kristine R,15,0,90,75
1683648887458,MGT 121A,A00,202868,Staff,0,20,0,0
1683648888482,MGT 131B,A00,202869,Anderson; John Charles,59,0,90,31
1683648889506,MGT 136,A00,202871,Lindenberger; Wade Douglas,83,0,90,7
1683648890531,MGT 164,A00,202873,Staff,0,66,90,91
1683648891555,MGT 164GS,A00,202874,McKay; Mary A,13,0,28,15
1683648892578,MGT 180,A00,202875,Staff,0,50,90,91
1683648893602,MMW 11R,A01,205019,Herbst; Matthew,2,0,30,28
1683648893602,MMW 11R,A02,205026,Herbst; Matthew,29,0,30,1
1683648894628,MMW 15,A01,193512,Chang; Edmond Yi-Teh,0,8,28,28
1683648894628,MMW 15,A02,193513,Chang; Edmond Yi-Teh,0,5,28,28
1683648894628,MMW 15,A03,193514,Chang; Edmond Yi-Teh,0,5,28,28
1683648894628,MMW 15,A04,193515,Chang; Edmond Yi-Teh,0,5,28,28
1683648894628,MMW 15,A05,193516,Chang; Edmond Yi-Teh,0,5,28,28
1683648894628,MMW 15,A06,193517,Chang; Edmond Yi-Teh,0,6,28,28
1683648894628,MMW 15,B01,193519,Chang; Edmond Yi-Teh,0,5,28,28
1683648894628,MMW 15,B02,193520,Chang; Edmond Yi-Teh,0,5,28,28
1683648894628,MMW 15,B03,193521,Chang; Edmond Yi-Teh,0,5,28,28
1683648894628,MMW 15,B04,193522,Chang; Edmond Yi-Teh,0,5,28,28
1683648894628,MMW 15,B05,193523,Chang; Edmond Yi-Teh,0,5,28,28
1683648894628,MMW 15,B06,193524,Chang; Edmond Yi-Teh,0,5,28,28
1683648895653,MMW 122,A01,193526,Rahimi; Babak,0,16,28,28
1683648895653,MMW 122,A02,193527,Rahimi; Babak,0,15,28,28
1683648895653,MMW 122,A03,193528,Rahimi; Babak,0,0,0,0
1683648895653,MMW 122,A04,193529,Rahimi; Babak,0,0,0,0
1683648896677,MUS 1A,A01,186663,Staff,1,20,35,34
1683648897701,MUS 4,A01,186715,Staff,0,12,35,35
1683648898728,MUS 5R,A01,186796,Dubnov; Shlomo,0,17,35,35
1683648899753,MUS 6,A01,186798,Staff,0,5,25,25
1683648900777,MUS 7,A01,186830,Staff,11,0,35,24
1683648901804,MUS 8,A01,186930,Staff,0,26,35,35
1683648902837,MUS 15,A01,186932,Staff,0,16,35,35
1683648902837,MUS 15,B01,186934,Staff,0,17,35,35
1683648903865,MUS 80,A00,186935,Staff,0,0,20,20
1683648903865,MUS 80,B00,186936,Staff,24,0,25,1
1683648904898,NANO 11,A00,204702,Lipomi; Darren John,0,0,0,0
1683648905923,NANO 15,A01,204709,Yang; Kesong,0,1,0,0
1683648906948,NANO 114,A00,202069,Jahed Motlagh; Zeinab,3,0,10,7
1683648907974,PHIL 1,A00,186955,Grush; Rick Scott,31,0,40,9
1683648909002,PHIL 10,A01,186973,Grush; Rick Scott,27,0,35,8
1683648909002,PHIL 10,A02,186974,Grush; Rick Scott,33,0,35,2
1683648910032,PHIL 13,A01,186976,Staff,3,0,35,32
1683648910032,PHIL 13,A02,186977,Staff,16,0,35,19
1683648911062,PHIL 14,A01,186979,Staff,31,0,35,4
1683648911062,PHIL 14,A02,186986,Staff,32,0,35,3
1683648912090,PHIL 28,A01,186988,Staff,16,0,30,14
1683648912090,PHIL 28,A02,186989,Staff,1,0,30,29
1683648912090,PHIL 28,A03,186990,Staff,10,0,30,20
1683648912090,PHIL 28,A04,186991,Staff,26,0,30,4
1683648913117,PHIL 120,A00,186997,Staff,23,0,40,17
1683648914144,PHIL 137,A00,187003,Staff,7,0,40,33
1683648915171,PHIL 150,A00,187015,Staff,47,0,70,23
1683648916199,PHIL 167,A00,187021,Lamey; Andy M.,34,0,40,6
1683648917224,PHIL 174,A01,202226,Staff,17,0,20,3
1683648917224,PHIL 174,A02,202235,Staff,20,0,20,0
1683648918248,PHIL 191A,A00,258918,Staff,0,0,1,1
1683648919272,PHYS 1A,A00,187028,Staff,26,0,60,34
1683648920297,PHYS 1AL,001,187036,Staff,3,0,30,27
1683648920297,PHYS 1AL,002,187049,Staff,18,0,30,12
1683648921321,PHYS 1B,A00,187058,Staff,22,0,60,38
1683648922345,PHYS 1BL,001,187064,Staff,0,1,30,30
1683648922345,PHYS 1BL,002,187070,Staff,4,0,30,26
1683648923376,PHYS 1C,A00,187082,Staff,29,0,120,91
1683648924402,PHYS 1CL,001,187088,Staff,0,9,30,30
1683648924402,PHYS 1CL,002,187089,Staff,0,1,30,30
1683648924402,PHYS 1CL,009,262693,Staff,9,0,30,21
1683648925427,PHYS 2B,A01,187097,Staff,55,0,115,60
1683648926520,PHYS 2C,A01,187099,Staff,64,0,115,51
1683648927551,PHYS 2CL,A01,187101,Staff,5,0,28,23
1683648927551,PHYS 2CL,A02,187102,Staff,15,0,28,13
1683648928582,PHYS 2D,A01,187123,Shotwell; Brian,95,0,115,20
1683648929609,PHYS 4B,A01,187133,Grinstein; Benjamin,35,0,50,15
1683648930637,POLI 10,A00,188819,Staff,0,4,50,50
1683648931662,POLI 11,A00,188827,Staff,43,0,50,7
1683648932686,POLI 13R,A00,188828,Staff,0,1,20,20
1683648933709,POLI 27,A01,188830,Elgin; Samuel Zincke,0,2,70,70
1683648934733,POLI 30,A00,188832,Desposato; Scott,30,0,50,20
1683648935760,POLI 102F,A00,188834,Staff,0,0,40,40
1683648936786,POLI 104A,A00,188852,Staff,13,0,30,17
1683648937810,POLI 104I,A00,188853,Staff,0,7,20,20
1683648938837,POLI 110B,A00,188854,Wiens; David,7,0,20,13
1683648939864,POLI 112A,A00,188855,Wiens; David,4,0,30,26
1683648940887,POLI 117R,A00,188856,Forman; Fonna,0,12,20,20
1683648941915,POLI 118,A00,188857,Ingham; Sean,8,0,20,12
1683648942939,POLI 120G,A00,188858,Staff,8,0,30,22
1683648943967,POLI 131CR,A00,188863,Hoston; Germaine,21,0,50,29
1683648944991,POLI 133,A00,188864,Nellis; Gareth Hb,44,0,50,6
1683648946015,POLI 134D,A00,188865,Desposato; Scott,27,0,30,3
1683648947038,POLI 142A,A00,188871,Gartzke; Erik,21,0,50,29
1683648948063,POLI 142K,A00,188874,Staff,38,0,50,12
1683648949086,POLI 143,A00,188940,Gartzke; Erik,16,0,30,14
1683648950113,POLI 153,A00,188943,Staff,2,0,20,18
1683648951138,POLI 160AA,A00,188944,Staff,11,0,40,29
1683648952164,POLI 170A,A00,188945,Staff,11,0,30,19
1683648954215,PSYC 1,A00,188952,Staff,36,0,90,54
1683648955242,PSYC 2,B00,188953,Staff,19,0,35,16
1683648956268,PSYC 6,A00,188970,Staff,47,0,60,13
1683648957291,PSYC 7,A00,188973,Staff,35,0,45,10
1683648958313,PSYC 60,A01,188980,Rickard; Timothy C.,42,0,60,18
1683648959343,PSYC 70,A01,189001,Steiner; Eric Tomas,23,0,45,22
1683648960371,PSYC 100,A00,189005,Lacefield; Katharine I,0,99,120,120
1683648961395,PSYC 102,A00,189008,Staff,8,0,30,22
1683648962426,PSYC 106,B00,189026,Gorman; Michael R.,27,0,60,33
1683648963451,PSYC 114,B01,189033,Winkielman; Piotr,0,31,30,30
1683648964477,PSYC 131,A00,189036,Anagnostaras; Stephan,0,43,60,60
1683648965502,PSYC 136,A00,189041,Lowe; Angela Beth,0,7,25,25
1683648966527,PSYC 137,A00,189057,Winkielman; Piotr,0,37,25,25
1683648967552,PSYC 144,A00,189107,Wixted; John T,0,10,50,50
1683648969611,PSYC 162,A00,189142,Staff,0,9,85,85
1683648970637,PSYC 172,A00,189144,Gorman; Michael R.,0,6,30,30
1683648972692,PSYC 179,A00,189146,Lacefield; Katharine I,0,86,120,120
1683648973716,PSYC 181,A00,189147,Anagnostaras; Stephan,0,44,90,90
1683648974749,PSYC 190R,A00,189148,Barner; David A.,0,23,80,80
1683648975777,PSYC 191,A00,189275,Rickard; Timothy C.,0,10,25,25
1683648976801,PSYC 193,A00,189276,Chapman; Eddie Nathaniel,0,1,0,4
1683648977826,PSYC 193L,A01,189281,Lowe; Angela Beth,10,0,20,10
1683648977826,PSYC 193L,B01,189285,Staff,28,0,35,7
1683648978853,RELI 149,A00,187137,Rahimi; Babak,7,0,40,33
1683648979876,SE 9,A01,187315,Staff,0,2,18,18
1683648980901,SE 101B,A00,187409,Staff,24,0,30,6
1683648981926,SE 110B,A00,187444,Staff,10,0,40,30
1683648982950,SE 130B,A00,187449,Staff,31,0,40,9
1683648983975,SE 150A,A00,187516,Staff,9,0,20,11
1683648984999,SE 154,A00,187528,Staff,29,0,50,21
1683648986034,SIO 3,A01,258171,Staff,35,0,40,5
1683648987057,SIO 10,A00,187144,Cook; Geoffrey W,0,6,75,75
1683648988080,SIO 45,A00,187152,Cook; Geoffrey W,0,4,100,100
1683648989107,SIO 109R,A00,194486,Staff,0,4,20,20
1683648991157,SIO 187,A01,187233,Kacev; David,12,0,40,28
1683648992182,SOCI 1,A01,258656,Thorpe; Charles Robert,28,0,30,2
1683648992182,SOCI 1,A02,258658,Thorpe; Charles Robert,30,0,30,0
1683648992182,SOCI 1,A03,258661,Thorpe; Charles Robert,25,0,25,0
1683648992182,SOCI 1,A04,258666,Thorpe; Charles Robert,22,0,25,3
1683648992182,SOCI 1,A05,258897,Thorpe; Charles Robert,22,0,25,3
1683648992182,SOCI 1,A06,258898,Thorpe; Charles Robert,25,0,25,0
1683648993208,SOCI 30,A01,258903,Pardo Guerra; Juan Pablo,14,0,30,16
1683648994232,SOCI 102,A00,258904,Staff,9,0,25,16
1683648995260,SOCI 106,A00,258905,Staff,19,0,25,6
1683648996289,SOCI 111,A00,258907,Ribas Norris; Janet Vanesa,26,0,30,4
1683648997315,SOCI 121R,A00,258908,Pardo Guerra; Juan Pablo,8,0,30,22
1683648998342,SOCI 126,A01,203330,Staff,14,0,20,6
1683648999377,SOCI 131,A00,258909,Thorpe; Charles Robert,30,0,60,30
1683649000404,SOCI 135,A00,258910,Payne; Christine Anna,0,11,30,30
1683649001432,SOCI 157,A00,258911,Staff,12,0,30,18
1683649002456,SOCI 184,A00,258912,Staff,25,0,30,5
1683649003480,SOCI 188D,A00,258913,Staff,22,0,30,8
1683649004507,SYN 2,001,187529,Staff,9,0,16,7
1683649004507,SYN 2,002,201452,Staff,0,20,16,16
1683649004507,SYN 2,003,201469,Staff,2,0,16,14
1683649005532,SYN 100,A01,187531,Staff,0,9,20,20
1683649005532,SYN 100,B01,201491,Staff,0,10,20,20
1683649006560,TDAC 1,A00,189286,Walsh; Kim C.,3,0,20,17
1683649006560,TDAC 1,B00,189287,Harting; Carla Kelso,10,0,20,10
1683649007588,TDAC 101,A00,189300,Walsh; Kim C.,16,0,20,4
1683649007588,TDAC 101,B00,189301,Harting; Carla Kelso,18,0,20,2
1683649008613,TDAC 102,A00,189304,Basso; Beatrice,14,0,20,6
1683649009640,TDAC 108,A00,189305,Staff,18,0,20,2
1683649010666,TDDE 131,A00,189310,Staff,19,0,20,1
1683649010666,TDDE 131,B00,189314,Staff,19,0,20,1
1683649010666,TDDE 131,C00,189315,Staff,48,0,50,2
1683649010666,TDDE 131,D00,189316,Staff,14,0,15,1
1683649010666,TDDE 131,E00,204841,Staff,20,0,20,0
1683649011690,TDGE 10,A00,189289,Staff,27,0,50,23
1683649011690,TDGE 10,B00,189290,Havis; Allan,0,0,50,50
1683649012715,TDGE 11,A00,189291,Fulton; Julia,0,4,50,50
1683649012715,TDGE 11,B00,189292,Staff,20,0,25,5
1683649012715,TDGE 11,C00,260270,Staff,0,0,0,0
1683649013740,TDGE 25,A00,189294,Staff,2,0,20,18
1683649014764,TDGE 124,A00,189318,Fulton; Julia,0,8,50,50
1683649015793,TDGE 125,A00,189319,Staff,13,0,25,12
1683649015793,TDGE 125,B00,189320,Staff,23,0,25,2
1683649016817,TDGE 127,A00,189322,Havis; Allan,0,0,50,50
1683649017846,TDHT 101,A00,189323,Staff,18,0,25,7
1683649017846,TDHT 101,B00,189324,Staff,25,0,25,0
1683649018869,TDHT 102,A00,189325,Staff,49,0,50,1
1683649019899,TDMV 1,A00,189295,Arcidiacono; Kristin,20,0,30,10
1683649019899,TDMV 1,B00,189296,Caligagan; Maria T.,24,0,30,6
1683649020924,TDMV 2,A00,189297,Sammartano; Tonnie,27,0,30,3
1683649020924,TDMV 2,B00,189299,Arcidiacono; Kristin,23,0,30,7
1683649021949,TDMV 3,A00,204998,Rincon; Alicia,22,0,30,8
1683649022976,TDMV 120,A00,189458,Sammartano; Tonnie,28,0,30,2
1683649024001,TDMV 138,A00,189541,Jun; Grace Shin Hae,20,0,40,20
1683649025026,TDMV 142,A00,189717,Caligagan; Tony,25,0,30,5
1683649025026,TDMV 142,B00,189718,Caligagan; Maria T.,25,0,30,5
1683649026051,TMC 2,A01,187533,Staff,25,0,25,0
1683649026051,TMC 2,A02,187534,Staff,25,0,25,0
1683649027073,USP 1,A01,187536,Kwak; Nancy,0,16,25,25
1683649028102,USP 5,A01,187538,Staff,9,0,25,16
1683649029129,USP 101,A00,199253,Staff,0,4,0,0
1683649030220,USP 124,A00,187562,Boomhower; Matthew Charles,0,0,30,30
1683649031251,USP 138,A00,187582,Staff,20,0,25,5
1683649032275,USP 152,A01,187597,Staff,3,0,25,22
1683649033298,USP 153,A00,187598,Staff,19,0,25,6
1683649034323,USP 168,A00,187607,Kwak; Nancy,2,0,5,3
1683649035348,USP 173,A00,187619,Staff,4,0,25,21
1683649036376,USP 181,A00,187638,Staff,0,4,25,25
1683649037401,VIS 103,A00,187650,Cruz; Edwin Teddy,18,0,75,57
1683649038425,VIS 110D,A00,187669,Staff,13,0,22,9
1683649039449,VIS 127C,A00,187720,Shen; Kuiyi,67,0,146,79
1683649040477,VIS 149,A00,187731,Yoldas; Pinar,0,14,22,22
1683649041501,VIS 151,A01,188091,Staff,22,0,34,12
1683649041501,VIS 151,A02,188092,Staff,11,0,34,23
1683649042526,VIS 160B,A00,188093,Stalbaum; Brett,0,1,10,10
1683649044580,WCWP 10B,A00,201720,Staff,10,0,15,5
1683649044580,WCWP 10B,B00,201722,Staff,9,0,15,6
1683649045609,WCWP 100,A00,201725,Gagnon; Jeffrey C,0,0,2,2
1683649045609,WCWP 100,B00,201727,Staff,0,4,15,15
1683649048702,ANBI 133,A00,258401,Wilder; Linnea Lorene,34,0,40,6
1683649049730,ANBI 140,A00,258395,Hrvoj Mihic; Branka,18,0,25,7
1683649050758,ANSC 120,A00,258402,Bialecki; Jon Anthony,26,0,40,14
1683649051783,ANSC 144,A00,258400,Staff,12,0,40,28
1683649053840,ANSC 166,A00,258396,Parish; Steven Martin,156,0,175,19
1683649054865,ANSC 180,A00,193533,Staff,8,0,20,12
1683649055889,ANSC 188,A00,258397,Jassal; Aftab,34,0,40,6
1683649056914,ANTH 3,A01,258316,Staff,23,0,30,7
1683649057942,ANTH 5,A00,258394,Semendeferi; Ekaterini,16,0,20,4
1683649058966,ANTH 21,A01,258331,Staff,4,0,40,36
1683649059990,ANTH 103,A00,258398,Varma; Saiba,15,0,25,10
1683649061017,AWP 10,001,202034,Staff,0,0,0,0
1683649061017,AWP 10,002,202035,Staff,0,0,0,0
1683649061017,AWP 10,003,202036,Staff,0,0,0,0
1683649061017,AWP 10,004,202037,Staff,0,0,0,0
1683649061017,AWP 10,005,202038,Staff,0,0,0,0
1683649061017,AWP 10,006,202039,Staff,0,0,0,0
1683649061017,AWP 10,007,202040,Staff,0,0,0,0
1683649061017,AWP 10,008,202041,Staff,0,0,0,0
1683649061017,AWP 10,009,202042,Staff,0,0,0,0
1683649061017,AWP 10,010,202043,Staff,0,0,0,0
1683649061017,AWP 10,011,202044,Staff,0,0,0,0
1683649061017,AWP 10,012,202045,Staff,0,0,0,0
1683649061017,AWP 10,013,202046,Staff,0,0,0,0
1683649061017,AWP 10,014,202047,Staff,0,0,0,0
1683649061017,AWP 10,015,202048,Staff,0,0,0,0
1683649061017,AWP 10,016,202049,Staff,0,0,0,0
1683649061017,AWP 10,017,202050,Staff,0,0,0,0
1683649061017,AWP 10,018,202051,Staff,0,0,0,0
1683649061017,AWP 10,019,202052,Staff,0,0,0,0
1683649061017,AWP 10,020,202053,Staff,0,0,0,0
1683649061017,AWP 10,021,202054,Staff,0,0,0,0
1683649061017,AWP 10,022,202055,Staff,0,0,0,0
1683649061017,AWP 10,023,202056,Staff,0,0,0,0
1683649061017,AWP 10,024,202057,Staff,0,0,0,0
1683649061017,AWP 10,025,202058,Staff,0,0,0,0
1683649061017,AWP 10,026,202059,Staff,0,0,0,0
1683649062045,AWP 102,001,202032,Staff,0,0,0,0
1683649062045,AWP 102,002,202033,Staff,0,0,0,0
1683649063070,BENG 100,A01,254234,Taylor Amos; Alyssa C,31,0,40,9
1683649064097,BENG 196,001,270013,Engler; Adam J.,9999,0,9999,0
1683649065122,BICD 100R,A01,202018,Smith; Laurie,0,7,32,32
1683649065122,BICD 100R,A02,202019,Smith; Laurie,0,3,32,32
1683649065122,BICD 100R,A03,202020,Smith; Laurie,0,1,32,32
1683649065122,BICD 100R,A04,202021,Smith; Laurie,6,0,32,26
1683649065122,BICD 100R,A05,202022,Smith; Laurie,11,0,32,21
1683649066148,BICD 136,A01,193242,Gustafson-Brown; Cindy,0,2,32,32
1683649066148,BICD 136,A02,193244,Gustafson-Brown; Cindy,13,0,32,19
1683649067176,BIEB 102,A01,193249,Butler; Shannon Rhey,0,2,32,32
1683649067176,BIEB 102,A02,193251,Butler; Shannon Rhey,0,0,32,32
1683649067176,BIEB 102,A03,193253,Butler; Shannon Rhey,0,0,32,32
1683649067176,BIEB 102,A04,193255,Butler; Shannon Rhey,14,0,32,18
1683649067176,BIEB 102,A05,193265,Butler; Shannon Rhey,26,0,32,6
1683649067176,BIEB 102,A06,193269,Butler; Shannon Rhey,14,0,32,18
1683649069225,BIEB 150,A01,193274,Staff,0,0,32,32
1683649069225,BIEB 150,A02,193285,Staff,24,0,32,8
1683649070249,BIEB 194,A00,193286,Kurle; Carolyn M.,20,0,32,12
1683649071274,BILD 1,A01,192291,Staff,15,0,32,17
1683649071274,BILD 1,A02,192292,Staff,30,0,32,2
1683649071274,BILD 1,B01,192520,Reuther; Keefe,0,1,0,0
1683649071274,BILD 1,B02,192532,Reuther; Keefe,0,1,0,0
1683649072303,BILD 3,A01,192556,Butler; Shannon Rhey,0,0,32,32
1683649072303,BILD 3,A02,192581,Butler; Shannon Rhey,1,0,32,31
1683649072303,BILD 3,A03,192611,Butler; Shannon Rhey,21,0,32,11
1683649072303,BILD 3,A04,192612,Butler; Shannon Rhey,24,0,32,8
1683649072303,BILD 3,A05,192613,Butler; Shannon Rhey,26,0,32,6
1683649072303,BILD 3,A06,192679,Butler; Shannon Rhey,27,0,32,5
1683649072303,BILD 3,A07,192682,Butler; Shannon Rhey,20,0,32,12
1683649073345,BILD 4,A01,192836,Reuther; Keefe,1,0,24,23
1683649073345,BILD 4,A02,193044,Reuther; Keefe,4,0,24,20
1683649074373,BILD 10,A01,193142,Gustafson-Brown; Cindy,29,0,32,3
1683649074373,BILD 10,A02,193149,Gustafson-Brown; Cindy,31,0,32,1
1683649075400,BIMM 100,A01,193301,Staff,0,6,32,32
1683649075400,BIMM 100,A02,193312,Staff,0,7,32,32
1683649075400,BIMM 100,A03,193323,Staff,0,9,32,32
1683649076427,BIMM 101,A01,193329,McDonnell; Lisa Marie,0,4,24,24
1683649076427,BIMM 101,A02,193339,McDonnell; Lisa Marie,0,3,24,24
1683649076427,BIMM 101,B01,193354,McDonnell; Lisa Marie,0,4,24,24
1683649076427,BIMM 101,B02,193357,McDonnell; Lisa Marie,0,3,24,24
1683649077451,BIMM 110,A01,193377,Tat; John,0,11,32,32
1683649077451,BIMM 110,A02,193378,Tat; John,0,10,32,32
1683649078478,BIMM 120,A01,206116,Staff,0,0,32,32
1683649078478,BIMM 120,A02,206117,Staff,6,0,32,26
1683649078478,BIMM 120,A03,206121,Staff,21,0,32,11
1683649079510,BIPN 100,A01,193393,Park; Ji Young,0,14,32,32
1683649079510,BIPN 100,A02,193402,Park; Ji Young,0,14,32,32
1683649079510,BIPN 100,A03,193413,Park; Ji Young,0,14,32,32
1683649079510,BIPN 100,A04,193414,Park; Ji Young,0,13,32,32
1683649080538,BIPN 102,A01,193429,Staff,0,0,32,32
1683649080538,BIPN 102,A02,193438,Staff,18,0,32,14
1683649081563,BIPN 106,A01,193450,Reyes Gonzalez; Catalina,0,2,40,40
1683649082591,BIPN 134,A01,193465,Cooke; James Edward,0,0,32,32
1683649082591,BIPN 134,A02,193474,Cooke; James Edward,25,0,32,7
1683649082591,BIPN 134,A03,193485,Cooke; James Edward,29,0,32,3
1683649082591,BIPN 134,A04,193486,Cooke; James Edward,20,0,32,12
1683649082591,BIPN 134,A05,193491,Cooke; James Edward,31,0,32,1
1683649082591,BIPN 134,A06,193501,Cooke; James Edward,30,0,32,2
1683649082591,BIPN 134,A07,193510,Cooke; James Edward,29,0,32,3
1683649084651,BISP 194,A00,222522,Staff,14,0,32,18
1683649085675,CAT 124,A01,202407,Staff,19,0,25,6
1683649086700,CAT 125,A00,202408,Marchisotto; Jennifer Anne,2,0,20,18
1683649087730,CAT 125R,A00,202409,Smith; Lauryn Alissa,0,11,20,20
1683649087730,CAT 125R,B00,202410,Morales; Celeste Georgianna,0,11,20,20
1683649087730,CAT 125R,C00,202411,Irwin; Matthew Joseph,0,12,20,20
1683649088759,CENG 15,A01,204712,Yang; Kesong,0,1,0,0
1683649089783,CENG 114,A00,202070,Jahed Motlagh; Zeinab,5,0,20,15
1683649090815,CGS 105,A00,185477,Wesling; Megan E.,24,0,40,16
1683649091844,CGS 106,A00,185494,Staff,11,0,22,11
1683649092869,CGS 108,A00,185495,Staff,14,0,20,6
1683649093893,CGS 114,A00,185496,Staff,13,0,18,5
1683649094919,CGS 119,A00,185501,Staff,15,0,20,5
1683649095943,CGS 120,A00,185511,Staff,12,0,20,8
1683649096968,CHEM 4,A01,184675,Bussey; Thomas J,97,0,100,3
1683649097998,CHEM 6A,A01,184677,Staff,33,0,60,27
1683649099031,CHEM 6B,A01,184679,Staff,63,0,100,37
1683649100062,CHEM 6C,A01,184681,Bussey; Thomas J,0,0,50,50
1683649100062,CHEM 6C,A02,184682,Bussey; Thomas J,32,0,50,18
1683649101091,CHEM 40A,A01,184684,Albizati; Kim F.,34,0,100,66
1683649102117,CHEM 40B,A01,184686,Albizati; Kim F.,0,22,100,100
1683649103141,CHEM 41B,A01,184690,Staff,51,0,100,49
1683649104166,COGS 3,A01,184715,Boyle; Mary E. T.,0,27,40,40
1683649105191,COGS 14B,A01,185172,Staff,0,14,38,38
1683649106220,COGS 18,A01,184736,Staff,14,0,80,66
1683649107245,COGS 100,A01,184932,Staff,0,7,73,73
1683649108269,COGS 101A,A01,184935,Staff,0,39,30,30
1683649109293,COGS 101B,A01,184944,Staff,0,2,30,30
1683649110317,COGS 101C,A01,184946,Staff,0,10,30,30
1683649111344,COGS 102A,A01,184951,Johnson; Christine M.,2,0,40,38
1683649112369,COGS 107B,A01,184953,Mooshagian; Eric Frederick,0,51,40,40
1683649113396,COGS 118B,A01,184959,Gupta; Anjum,0,49,40,40
1683649114423,COGS 153,A00,184961,Staff,0,16,30,30
1683649115446,COGS 177,A00,184962,Staff,0,21,30,30
1683649116474,COGS 187A,A01,184969,Boyle; Mary E. T.,0,19,40,40
1683649117505,COMM 10,A01,185174,Staff,0,5,25,25
1683649117505,COMM 10,A02,185189,Staff,0,2,25,25
1683649117505,COMM 10,A03,269821,Staff,0,1,0,0
1683649118535,COMM 100B,A01,185475,Staff,0,1,0,2
1683649118535,COMM 100B,A02,185476,Staff,12,0,25,13
1683649119560,COMM 100C,A01,185314,Staff,1,0,25,24
1683649119560,COMM 100C,A02,185327,Staff,18,0,25,7
1683649120588,COMM 110M,A00,185349,Staff,0,0,40,40
1683649121617,COMM 113T,A00,185352,Staff,25,0,40,15
1683649122644,COMM 114I,A00,185353,Staff,31,0,40,9
1683649123669,COMM 131,A00,185354,Staff,17,0,30,13
1683649124695,CSE 8A,A50,185358,Cao; Yingjun,0,46,10,10
1683649125722,CSE 8B,A01,185362,Staff,0,48,50,50
1683649126748,CSE 11,A01,185416,Cao; Yingjun,0,91,10,10
1683649127778,CSE 20,A01,185445,Briones; Jor-el Thomas Caparas,4,0,25,21
1683649128802,CSE 21,A01,185447,Staff,9,0,50,41
1683649129828,CSE 101,A01,185451,Staff,0,13,50,50
1683649129828,CSE 101,B01,185453,Jones; Miles E,0,13,50,50
1683649131889,CSE 141,A01,185458,Eldon; John,16,0,100,84
1683649132913,CSE 141L,A01,185461,Eldon; John,8,0,100,92
1683649134018,CSE 142,A01,185463,Staff,35,0,60,25
1683649134018,CSE 142,B01,201355,Staff,0,7,60,60
1683649135046,CSE 142L,A01,185470,Staff,35,0,60,25
1683649135046,CSE 142L,B01,201417,Staff,0,6,60,60
1683649136070,CSE 190,A00,201433,Staff,32,0,49,17
1683649137096,DOC 1,A01,259136,Strom; Megan C.,7,0,15,8
1683649137096,DOC 1,A02,259137,Strom; Megan C.,14,0,15,1
1683649137096,DOC 1,A03,259138,Strom; Megan C.,14,0,15,1
1683649137096,DOC 1,A04,259139,Strom; Megan C.,14,0,15,1
1683649138119,DOC 100D,A00,259140,Pass; Natalye Joann,14,0,25,11
1683649139148,DSGN 1,A01,184749,Rill; Bryan,0,26,30,30
1683649140171,DSGN 100,A01,185168,Staff,0,2,25,25
1683649141199,ECE 5,A01,185626,Morris; Karcher William,0,11,0,0
1683649142223,ECE 101,A01,185628,Staff,14,0,70,56
1683649143247,ECE 107,A01,185635,Baghdadchi; Saharnaz,0,0,20,20
1683649143247,ECE 107,A02,185638,Baghdadchi; Saharnaz,3,0,20,17
1683649144271,ECE 148,A01,185647,Silberman; Jack,0,0,16,16
1683649145295,ECON 1,A01,185537,Crane; Meredith Helen,54,0,70,16
1683649146321,ECON 3,A01,185549,Crane; Meredith Helen,29,0,70,41
1683649147344,ECON 4,A01,203354,Anderson; John Charles,0,5,10,10
1683649148367,ECON 100A,A01,185574,Staff,0,5,40,40
1683649149391,ECON 100B,A01,185576,Staff,0,12,50,50
1683649150414,ECON 100C,A01,185589,Newhouse; Herbert S,30,0,70,40
1683649151442,ECON 105,A00,185608,Vespa; Emanuel Ignacio,19,0,35,16
1683649152470,ECON 109,A01,185610,Shishkin; Denis,9,0,35,26
1683649153501,ECON 110A,A01,185612,Staff,9,0,40,31
1683649154528,ECON 120A,A01,185615,Staff,20,0,40,20
1683649155552,ECON 120C,A01,185617,Sun; Yixiao,0,20,70,70
1683649156580,ECON 144,A00,203346,Squires; Dale E,2,0,35,33
1683649157603,ECON 171,A01,203349,Newhouse; Herbert S,0,1,35,35
1683649158626,ECON 173A,A01,185621,Toda; Alexis Akira,21,0,35,14
1683649159652,EDS 25,A01,202413,Staff,0,1,0,0
1683649159652,EDS 25,A02,202414,Staff,0,1,0,0
1683649159652,EDS 25,A03,202415,Staff,0,0,0,0
1683649159652,EDS 25,A04,202416,Staff,0,1,0,0
1683649159652,EDS 25,A05,202439,Staff,0,0,0,0
1683649159652,EDS 25,A06,202440,Staff,0,0,0,0
1683649159652,EDS 25,B01,202631,Staff,0,0,0,0
1683649159652,EDS 25,B02,202632,Staff,0,0,0,0
1683649159652,EDS 25,B03,202639,Staff,0,0,0,0
1683649159652,EDS 25,B04,202640,Staff,0,0,0,0
1683649159652,EDS 25,B05,202643,Staff,0,0,0,0
1683649159652,EDS 25,B06,202644,Staff,0,0,0,0
1683649160676,EDS 38,A01,202659,Black; Alison Michelle,24,0,25,1
1683649161698,EDS 115,A00,202652,Staff,18,0,30,12
1683649162722,EDS 125,A00,202649,Staff,13,0,30,17
1683649163749,EDS 126,A01,203332,Staff,30,0,30,0
1683649164773,EDS 139,A00,202838,Staff,16,0,25,9
1683649165800,EDS 146,A01,202655,Staff,14,0,25,11
1683649166824,ENG 15,A00,185667,Staff,0,1,0,0
1683649166824,ENG 15,B00,185672,Staff,0,0,0,0
1683649166824,ENG 15,C00,185675,Staff,0,0,0,0
1683649166824,ENG 15,D00,185682,Staff,0,0,0,0
1683649166824,ENG 15,E00,185684,Staff,0,0,0,0
1683649167850,ETHN 103,A00,185710,Staff,0,8,35,35
1683649168876,ETHN 103A,A00,199228,Man; Simeon S,0,0,9,9
1683649169903,ETHN 109,A00,185711,Staff,16,0,35,19
1683649170928,ETHN 142,A00,185726,Staff,0,4,30,30
1683649171951,ETHN 163J,A00,199229,Man; Simeon S,5,0,8,3
1683649172979,ETHN 168,A00,185727,Staff,7,0,10,3
1683649174003,ETHN 182,A00,185728,Staff,0,0,35,35
1683649175033,ETHN 183,A00,185737,Staff,9,0,18,9
1683649176060,GLBH 111,A01,209361,Burgos; Jose L.,0,0,0,0
1683649178112,HIEU 104,A00,185792,Staff,14,0,20,6
1683649179136,HIEU 115,A00,185800,Staff,0,0,20,20
1683649180161,HIEU 128,A00,185801,Staff,0,9,20,20
1683649181188,HIEU 147,A00,185802,Staff,15,0,20,5
1683649182216,HIEU 154,A00,185823,Staff,11,0,20,9
1683649183250,HILA 102,A00,185826,Staff,14,0,20,6
1683649184274,HILD 2C,A01,185778,Staff,0,13,20,20
1683649185302,HILD 7B,A01,185780,Kwak; Nancy,0,16,32,32
1683649185302,HILD 7B,A02,185781,Kwak; Nancy,0,18,32,32
1683649186330,HILD 30,A01,185791,Staff,12,0,20,8
1683649187354,HISC 119,A00,185830,Golan; Tal,0,9,20,20
1683649188377,HITO 156GS,A00,185831,Patterson; Patrick H.,0,0,0,23
1683649189402,HIUS 103,A00,185832,Man; Simeon S,0,4,20,20
1683649190425,HIUS 117,A00,185836,Kwak; Nancy,2,0,20,18
1683649191451,HIUS 125,A00,185840,Man; Simeon S,0,1,23,23
1683649192474,HIUS 149,A00,185845,Staff,1,0,20,19
1683649193499,HUM 3,A01,185882,Zavodny; Tatiana Sophia,0,7,50,50
1683649193499,HUM 3,B01,185899,Caldwell; Michael Alan,0,18,50,50
1683649194525,HUM 3GS,A00,185900,Patterson; Patrick H.,0,0,0,23
1683649195551,HUM 4,A01,185938,Zroka; Amy Liane,30,0,50,20
1683649195551,HUM 4,B01,185956,Watkins; Eric,0,4,50,50
1683649195551,HUM 4,B02,202209,Watkins; Eric,0,4,50,50
1683649195551,HUM 4,B03,202210,Watkins; Eric,0,4,50,50
1683649196581,HUM 5,A01,185958,West; Geoffrey Scott,2,0,50,48
1683649196581,HUM 5,A02,202215,West; Geoffrey Scott,0,0,50,50
1683649197607,INTL 190,A00,185959,Gagnon; Jeffrey C,0,0,0,9
1683649197607,INTL 190,B00,185960,Lettieri; Michael Joseph,0,0,0,2
1683649198633,JAPN 180,A00,254509,Staff,5,0,30,25
1683649199662,LATI 10,A01,202853,Kennemore; Amy Michelle,4,0,35,31
1683649199662,LATI 10,A02,202854,Kennemore; Amy Michelle,2,0,35,33
1683649199662,LATI 10,A03,270054,Kennemore; Amy Michelle,30,0,30,0
1683649200686,LATI 180,A00,202855,Kennemore; Amy Michelle,11,0,20,9
1683649201711,LAWS 101,A00,201767,Golan; Tal,0,7,40,40
1683649202736,LIFR 1C,A00,185961,Staff,6,0,20,14
1683649203762,LIFR 1CX,A00,185962,Staff,7,0,20,13
1683649204785,LIFR 1D,A00,185963,Staff,7,0,20,13
1683649205811,LIFR 1DX,A00,185964,Staff,7,0,20,13
1683649206840,LIGN 101,A01,186039,Staff,43,0,50,7
1683649207867,LIGN 165,A00,186040,Staff,15,0,50,35
1683649208894,LTCS 108,A00,186041,Staff,5,0,10,5
1683649209962,LTCS 119,A00,186042,Staff,15,0,20,5
1683649210987,LTCS 130,A00,186043,Wesling; Megan E.,15,0,25,10
1683649213037,LTEA 138,A00,186119,Staff,14,0,40,26
1683649214062,LTEN 124,A00,186148,Staff,5,0,25,20
1683649215085,LTEN 178,A00,186149,Staff,7,0,15,8
1683649216109,LTEN 181,A00,186150,Blanco; John D,34,0,40,6
1683649217135,LTWL 120,A00,186160,Staff,20,0,25,5
1683649218162,LTWL 165,A00,186161,Staff,22,0,25,3
1683649219186,LTWR 100,A00,186162,Staff,0,5,15,15
1683649220210,LTWR 102,A00,186163,Doller; Ben,5,0,15,10
1683649221236,MAE 8,A01,186412,Staff,0,0,0,0
1683649222266,MAE 30B,A00,186445,Bahadori; Mohammad Yousef,82,0,100,18
1683649223291,MAE 40,A00,186592,Bewley; Thomas R,10,0,50,40
1683649224320,MAE 101B,A00,186593,Bahadori; Mohammad Yousef,80,0,100,20
1683649225345,MAE 105,A00,186594,Bandaru; Prabhakar,10,0,50,40
1683649226370,MAE 107,A00,186599,Pham; Hieu Tan,0,7,120,120
1683649227394,MAE 148,A01,186660,Silberman; Jack,3,0,16,13
1683649228418,MATH 10A,A01,188095,Staff,0,5,35,35
1683649229443,MATH 10B,A01,188097,Bowers; Adam R.,0,11,30,30
1683649229443,MATH 10B,A02,188099,Bowers; Adam R.,0,11,30,30
1683649229443,MATH 10B,B01,188104,Bowers; Adam R.,0,10,30,30
1683649229443,MATH 10B,B02,188106,Bowers; Adam R.,1,9,30,29
1683649230466,MATH 10C,A01,188111,Staff,0,18,30,30
1683649230466,MATH 10C,A02,188127,Staff,0,19,30,30
1683649230466,MATH 10C,A03,188131,Staff,0,19,30,30
1683649230466,MATH 10C,B01,188218,Staff,17,0,30,13
1683649230466,MATH 10C,B02,188244,Staff,13,0,30,17
1683649230466,MATH 10C,B03,188277,Staff,14,0,30,16
1683649231490,MATH 18,A01,188344,Bach; Quang Tran,18,0,30,12
1683649231490,MATH 18,A02,188345,Bach; Quang Tran,11,0,30,19
1683649231490,MATH 18,B01,188353,Bach; Quang Tran,11,0,30,19
1683649231490,MATH 18,B02,188354,Bach; Quang Tran,19,0,30,11
1683649232517,MATH 20A,A01,188374,Staff,11,0,35,24
1683649233545,MATH 20B,A01,188382,Ohm; Ko Woon,7,0,30,23
1683649233545,MATH 20B,A02,188383,Ohm; Ko Woon,22,0,30,8
1683649233545,MATH 20B,B01,188385,Ohm; Ko Woon,7,0,30,23
1683649233545,MATH 20B,B02,188392,Ohm; Ko Woon,22,0,30,8
1683649234571,MATH 20C,A01,188394,Harel; Guershon,11,0,30,19
1683649234571,MATH 20C,A02,188395,Harel; Guershon,13,0,30,17
1683649234571,MATH 20C,B01,188404,Harel; Guershon,5,0,30,25
1683649234571,MATH 20C,B02,188405,Harel; Guershon,18,0,30,12
1683649235602,MATH 20D,A01,188414,Hammock; Frances H,0,1,30,30
1683649235602,MATH 20D,A02,188415,Hammock; Frances H,0,1,30,30
1683649235602,MATH 20D,B01,188447,Hammock; Frances H,0,1,30,30
1683649235602,MATH 20D,B02,188486,Hammock; Frances H,4,0,30,26
1683649236634,MATH 20E,A01,188649,Staff,21,0,30,9
1683649236634,MATH 20E,A02,188650,Staff,21,0,30,9
1683649236634,MATH 20E,A03,188673,Staff,0,0,30,30
1683649237715,MATH 102,A01,188675,Staff,0,36,35,35
1683649238740,MATH 103B,A01,188681,Staff,3,0,35,32
1683649238740,MATH 103B,B01,188692,Staff,5,0,35,30
1683649239765,MATH 109,A01,188695,Salehi Golsefidy; Alireza,24,0,35,11
1683649239765,MATH 109,A02,188696,Salehi Golsefidy; Alireza,25,0,35,10
1683649240789,MATH 120A,A01,188698,Eggers; John Dietrich,7,0,35,28
1683649241816,MATH 142B,A01,188736,Ioana; Adrian,0,1,30,30
1683649241816,MATH 142B,A02,188741,Ioana; Adrian,0,1,30,30
1683649241816,MATH 142B,A03,188743,Ioana; Adrian,0,1,30,30
1683649242840,MATH 168A,A01,188790,Staff,0,10,35,35
1683649243865,MATH 170A,A01,188803,Nie; Jiawang,0,2,35,35
1683649243865,MATH 170A,A02,188811,Nie; Jiawang,0,0,35,35
1683649243865,MATH 170A,A03,188814,Nie; Jiawang,0,0,35,35
1683649243865,MATH 170A,A04,188815,Nie; Jiawang,10,0,35,25
1683649244892,MATH 193B,A01,188817,Staff,0,0,35,35
1683649244892,MATH 193B,A02,188818,Staff,5,0,35,30
1683649245918,MGT 4,A01,202857,Anderson; John Charles,61,0,80,19
1683649246944,MGT 12,A00,202858,Lindenberger; Wade Douglas,40,0,90,50
1683649247973,MGT 18,A00,202859,Staff,74,0,90,16
1683649249000,MGT 18GS,A00,202860,McKay; Michael J,13,0,28,15
1683649250028,MGT 45,A00,202861,Pecore; Joseph P.,12,0,90,78
1683649251056,MGT 100,A00,202863,Yavorsky; Daniel Ryan,28,0,90,62
1683649252084,MGT 103,A00,202864,Ehrich; Kristine R,0,17,90,90
1683649253107,MGT 112,A00,202865,Ehrich; Kristine R,15,0,90,75
1683649254142,MGT 121A,A00,202868,Staff,0,20,0,0
1683649255169,MGT 131B,A00,202869,Anderson; John Charles,59,0,90,31
1683649256196,MGT 136,A00,202871,Lindenberger; Wade Douglas,83,0,90,7
1683649257221,MGT 164,A00,202873,Staff,0,66,90,91
1683649258246,MGT 164GS,A00,202874,McKay; Mary A,13,0,28,15
1683649259273,MGT 180,A00,202875,Staff,0,50,90,91
1683649260297,MMW 11R,A01,205019,Herbst; Matthew,2,0,30,28
1683649260297,MMW 11R,A02,205026,Herbst; Matthew,29,0,30,1
1683649261322,MMW 15,A01,193512,Chang; Edmond Yi-Teh,0,8,28,28
1683649261322,MMW 15,A02,193513,Chang; Edmond Yi-Teh,0,5,28,28
1683649261322,MMW 15,A03,193514,Chang; Edmond Yi-Teh,0,5,28,28
1683649261322,MMW 15,A04,193515,Chang; Edmond Yi-Teh,0,5,28,28
1683649261322,MMW 15,A05,193516,Chang; Edmond Yi-Teh,0,5,28,28
1683649261322,MMW 15,A06,193517,Chang; Edmond Yi-Teh,0,6,28,28
1683649261322,MMW 15,B01,193519,Chang; Edmond Yi-Teh,0,5,28,28
1683649261322,MMW 15,B02,193520,Chang; Edmond Yi-Teh,0,5,28,28
1683649261322,MMW 15,B03,193521,Chang; Edmond Yi-Teh,0,5,28,28
1683649261322,MMW 15,B04,193522,Chang; Edmond Yi-Teh,0,5,28,28
1683649261322,MMW 15,B05,193523,Chang; Edmond Yi-Teh,0,5,28,28
1683649261322,MMW 15,B06,193524,Chang; Edmond Yi-Teh,0,5,28,28
1683649262346,MMW 122,A01,193526,Rahimi; Babak,0,16,28,28
1683649262346,MMW 122,A02,193527,Rahimi; Babak,0,15,28,28
1683649262346,MMW 122,A03,193528,Rahimi; Babak,0,0,0,0
1683649262346,MMW 122,A04,193529,Rahimi; Babak,0,0,0,0
1683649263373,MUS 1A,A01,186663,Staff,1,20,35,34
1683649264400,MUS 4,A01,186715,Staff,0,12,35,35
1683649265425,MUS 5R,A01,186796,Dubnov; Shlomo,0,17,35,35
1683649266450,MUS 6,A01,186798,Staff,0,5,25,25
1683649267475,MUS 7,A01,186830,Staff,11,0,35,24
1683649268499,MUS 8,A01,186930,Staff,0,26,35,35
1683649269524,MUS 15,A01,186932,Staff,0,16,35,35
1683649269524,MUS 15,B01,186934,Staff,0,17,35,35
1683649270556,MUS 80,A00,186935,Staff,0,0,20,20
1683649270556,MUS 80,B00,186936,Staff,24,0,25,1
1683649271583,NANO 11,A00,204702,Lipomi; Darren John,0,0,0,0
1683649272616,NANO 15,A01,204709,Yang; Kesong,0,1,0,0
1683649273642,NANO 114,A00,202069,Jahed Motlagh; Zeinab,3,0,10,7
1683649274675,PHIL 1,A00,186955,Grush; Rick Scott,31,0,40,9
1683649275699,PHIL 10,A01,186973,Grush; Rick Scott,27,0,35,8
1683649275699,PHIL 10,A02,186974,Grush; Rick Scott,33,0,35,2
1683649276724,PHIL 13,A01,186976,Staff,3,0,35,32
1683649276724,PHIL 13,A02,186977,Staff,16,0,35,19
1683649277758,PHIL 14,A01,186979,Staff,31,0,35,4
1683649277758,PHIL 14,A02,186986,Staff,32,0,35,3
1683649278783,PHIL 28,A01,186988,Staff,16,0,30,14
1683649278783,PHIL 28,A02,186989,Staff,1,0,30,29
1683649278783,PHIL 28,A03,186990,Staff,10,0,30,20
1683649278783,PHIL 28,A04,186991,Staff,26,0,30,4
1683649279809,PHIL 120,A00,186997,Staff,23,0,40,17
1683649280835,PHIL 137,A00,187003,Staff,7,0,40,33
1683649281859,PHIL 150,A00,187015,Staff,47,0,70,23
1683649282883,PHIL 167,A00,187021,Lamey; Andy M.,34,0,40,6
1683649283906,PHIL 174,A01,202226,Staff,17,0,20,3
1683649283906,PHIL 174,A02,202235,Staff,20,0,20,0
1683649284931,PHIL 191A,A00,258918,Staff,0,0,1,1
1683649285958,PHYS 1A,A00,187028,Staff,26,0,60,34
1683649286982,PHYS 1AL,001,187036,Staff,3,0,30,27
1683649286982,PHYS 1AL,002,187049,Staff,18,0,30,12
1683649288010,PHYS 1B,A00,187058,Staff,22,0,60,38
1683649289038,PHYS 1BL,001,187064,Staff,0,1,30,30
1683649289038,PHYS 1BL,002,187070,Staff,4,0,30,26
1683649290062,PHYS 1C,A00,187082,Staff,29,0,120,91
1683649291086,PHYS 1CL,001,187088,Staff,0,9,30,30
1683649291086,PHYS 1CL,002,187089,Staff,0,1,30,30
1683649291086,PHYS 1CL,009,262693,Staff,9,0,30,21
1683649292109,PHYS 2B,A01,187097,Staff,55,0,115,60
1683649293137,PHYS 2C,A01,187099,Staff,64,0,115,51
1683649294162,PHYS 2CL,A01,187101,Staff,5,0,28,23
1683649294162,PHYS 2CL,A02,187102,Staff,15,0,28,13
1683649295186,PHYS 2D,A01,187123,Shotwell; Brian,95,0,115,20
1683649296215,PHYS 4B,A01,187133,Grinstein; Benjamin,35,0,50,15
1683649297241,POLI 10,A00,188819,Staff,0,4,50,50
1683649298269,POLI 11,A00,188827,Staff,43,0,50,7
1683649299299,POLI 13R,A00,188828,Staff,0,1,20,20
1683649300322,POLI 27,A01,188830,Elgin; Samuel Zincke,0,2,70,70
1683649301348,POLI 30,A00,188832,Desposato; Scott,30,0,50,20
1683649302375,POLI 102F,A00,188834,Staff,0,0,40,40
1683649303398,POLI 104A,A00,188852,Staff,13,0,30,17
1683649304425,POLI 104I,A00,188853,Staff,0,7,20,20
1683649305448,POLI 110B,A00,188854,Wiens; David,7,0,20,13
1683649306472,POLI 112A,A00,188855,Wiens; David,4,0,30,26
1683649307496,POLI 117R,A00,188856,Forman; Fonna,0,12,20,20
1683649308529,POLI 118,A00,188857,Ingham; Sean,8,0,20,12
1683649309553,POLI 120G,A00,188858,Staff,8,0,30,22
1683649310577,POLI 131CR,A00,188863,Hoston; Germaine,21,0,50,29
1683649311601,POLI 133,A00,188864,Nellis; Gareth Hb,44,0,50,6
1683649312626,POLI 134D,A00,188865,Desposato; Scott,27,0,30,3
1683649313650,POLI 142A,A00,188871,Gartzke; Erik,21,0,50,29
1683649314674,POLI 142K,A00,188874,Staff,38,0,50,12
1683649315701,POLI 143,A00,188940,Gartzke; Erik,16,0,30,14
1683649316729,POLI 153,A00,188943,Staff,2,0,20,18
1683649317762,POLI 160AA,A00,188944,Staff,11,0,40,29
1683649318784,POLI 170A,A00,188945,Staff,11,0,30,19
1683649320840,PSYC 1,A00,188952,Staff,36,0,90,54
1683649321865,PSYC 2,B00,188953,Staff,19,0,35,16
1683649322887,PSYC 6,A00,188970,Staff,47,0,60,13
1683649323915,PSYC 7,A00,188973,Staff,35,0,45,10
1683649324940,PSYC 60,A01,188980,Rickard; Timothy C.,42,0,60,18
1683649325964,PSYC 70,A01,189001,Steiner; Eric Tomas,23,0,45,22
1683649326988,PSYC 100,A00,189005,Lacefield; Katharine I,0,99,120,120
1683649328012,PSYC 102,A00,189008,Staff,8,0,30,22
1683649329036,PSYC 106,B00,189026,Gorman; Michael R.,27,0,60,33
1683649330065,PSYC 114,B01,189033,Winkielman; Piotr,0,31,30,30
1683649331089,PSYC 131,A00,189036,Anagnostaras; Stephan,0,43,60,60
1683649332112,PSYC 136,A00,189041,Lowe; Angela Beth,0,7,25,25
1683649333139,PSYC 137,A00,189057,Winkielman; Piotr,0,37,25,25
1683649334163,PSYC 144,A00,189107,Wixted; John T,0,10,50,50
1683649336213,PSYC 162,A00,189142,Staff,0,9,85,85
1683649337239,PSYC 172,A00,189144,Gorman; Michael R.,0,6,30,30
1683649339290,PSYC 179,A00,189146,Lacefield; Katharine I,0,86,120,120
1683649340315,PSYC 181,A00,189147,Anagnostaras; Stephan,0,44,90,90
1683649341394,PSYC 190R,A00,189148,Barner; David A.,0,23,80,80
1683649342422,PSYC 191,A00,189275,Rickard; Timothy C.,0,10,25,25
1683649343451,PSYC 193,A00,189276,Chapman; Eddie Nathaniel,0,1,0,4
1683649344476,PSYC 193L,A01,189281,Lowe; Angela Beth,10,0,20,10
1683649344476,PSYC 193L,B01,189285,Staff,28,0,35,7
1683649345501,RELI 149,A00,187137,Rahimi; Babak,7,0,40,33
1683649346529,SE 9,A01,187315,Staff,0,2,18,18
1683649347553,SE 101B,A00,187409,Staff,24,0,30,6
1683649348578,SE 110B,A00,187444,Staff,10,0,40,30
1683649349603,SE 130B,A00,187449,Staff,31,0,40,9
1683649350627,SE 150A,A00,187516,Staff,9,0,20,11
1683649351653,SE 154,A00,187528,Staff,29,0,50,21
1683649352678,SIO 3,A01,258171,Staff,35,0,40,5
1683649353704,SIO 10,A00,187144,Cook; Geoffrey W,0,6,75,75
1683649354729,SIO 45,A00,187152,Cook; Geoffrey W,0,4,100,100
1683649355770,SIO 109R,A00,194486,Staff,0,4,20,20
1683649357820,SIO 187,A01,187233,Kacev; David,12,0,40,28
1683649358846,SOCI 1,A01,258656,Thorpe; Charles Robert,28,0,30,2
1683649358846,SOCI 1,A02,258658,Thorpe; Charles Robert,30,0,30,0
1683649358846,SOCI 1,A03,258661,Thorpe; Charles Robert,25,0,25,0
1683649358846,SOCI 1,A04,258666,Thorpe; Charles Robert,22,0,25,3
1683649358846,SOCI 1,A05,258897,Thorpe; Charles Robert,22,0,25,3
1683649358846,SOCI 1,A06,258898,Thorpe; Charles Robert,25,0,25,0
1683649359872,SOCI 30,A01,258903,Pardo Guerra; Juan Pablo,14,0,30,16
1683649360894,SOCI 102,A00,258904,Staff,9,0,25,16
1683649361920,SOCI 106,A00,258905,Staff,19,0,25,6
1683649362958,SOCI 111,A00,258907,Ribas Norris; Janet Vanesa,26,0,30,4
1683649363988,SOCI 121R,A00,258908,Pardo Guerra; Juan Pablo,8,0,30,22
1683649365009,SOCI 126,A01,203330,Staff,14,0,20,6
1683649366033,SOCI 131,A00,258909,Thorpe; Charles Robert,30,0,60,30
1683649367057,SOCI 135,A00,258910,Payne; Christine Anna,0,11,30,30
1683649368082,SOCI 157,A00,258911,Staff,12,0,30,18
1683649369106,SOCI 184,A00,258912,Staff,25,0,30,5
1683649370131,SOCI 188D,A00,258913,Staff,22,0,30,8
1683649371155,SYN 2,001,187529,Staff,9,0,16,7
1683649371155,SYN 2,002,201452,Staff,0,20,16,16
1683649371155,SYN 2,003,201469,Staff,2,0,16,14
1683649372180,SYN 100,A01,187531,Staff,0,9,20,20
1683649372180,SYN 100,B01,201491,Staff,0,10,20,20
1683649373207,TDAC 1,A00,189286,Walsh; Kim C.,3,0,20,17
1683649373207,TDAC 1,B00,189287,Harting; Carla Kelso,10,0,20,10
1683649374234,TDAC 101,A00,189300,Walsh; Kim C.,16,0,20,4
1683649374234,TDAC 101,B00,189301,Harting; Carla Kelso,18,0,20,2
1683649375262,TDAC 102,A00,189304,Basso; Beatrice,14,0,20,6
1683649376286,TDAC 108,A00,189305,Staff,18,0,20,2
1683649377312,TDDE 131,A00,189310,Staff,19,0,20,1
1683649377312,TDDE 131,B00,189314,Staff,19,0,20,1
1683649377312,TDDE 131,C00,189315,Staff,48,0,50,2
1683649377312,TDDE 131,D00,189316,Staff,14,0,15,1
1683649377312,TDDE 131,E00,204841,Staff,20,0,20,0
1683649378339,TDGE 10,A00,189289,Staff,27,0,50,23
1683649378339,TDGE 10,B00,189290,Havis; Allan,0,0,50,50
1683649379367,TDGE 11,A00,189291,Fulton; Julia,0,4,50,50
1683649379367,TDGE 11,B00,189292,Staff,20,0,25,5
1683649379367,TDGE 11,C00,260270,Staff,0,0,0,0
1683649380391,TDGE 25,A00,189294,Staff,2,0,20,18
1683649381418,TDGE 124,A00,189318,Fulton; Julia,0,8,50,50
1683649382445,TDGE 125,A00,189319,Staff,13,0,25,12
1683649382445,TDGE 125,B00,189320,Staff,23,0,25,2
1683649383471,TDGE 127,A00,189322,Havis; Allan,0,0,50,50
1683649384496,TDHT 101,A00,189323,Staff,18,0,25,7
1683649384496,TDHT 101,B00,189324,Staff,25,0,25,0
1683649385524,TDHT 102,A00,189325,Staff,49,0,50,1
1683649386548,TDMV 1,A00,189295,Arcidiacono; Kristin,20,0,30,10
1683649386548,TDMV 1,B00,189296,Caligagan; Maria T.,24,0,30,6
1683649387575,TDMV 2,A00,189297,Sammartano; Tonnie,27,0,30,3
1683649387575,TDMV 2,B00,189299,Arcidiacono; Kristin,23,0,30,7
1683649388602,TDMV 3,A00,204998,Rincon; Alicia,22,0,30,8
1683649389628,TDMV 120,A00,189458,Sammartano; Tonnie,28,0,30,2
1683649390655,TDMV 138,A00,189541,Jun; Grace Shin Hae,20,0,40,20
1683649391683,TDMV 142,A00,189717,Caligagan; Tony,25,0,30,5
1683649391683,TDMV 142,B00,189718,Caligagan; Maria T.,25,0,30,5
1683649392710,TMC 2,A01,187533,Staff,25,0,25,0
1683649392710,TMC 2,A02,187534,Staff,25,0,25,0
1683649393737,USP 1,A01,187536,Kwak; Nancy,0,16,25,25
1683649394765,USP 5,A01,187538,Staff,9,0,25,16
1683649395787,USP 101,A00,199253,Staff,0,4,0,0
1683649396812,USP 124,A00,187562,Boomhower; Matthew Charles,0,0,30,30
1683649397838,USP 138,A00,187582,Staff,20,0,25,5
1683649398863,USP 152,A01,187597,Staff,3,0,25,22
1683649399890,USP 153,A00,187598,Staff,19,0,25,6
1683649400914,USP 168,A00,187607,Kwak; Nancy,2,0,5,3
1683649401941,USP 173,A00,187619,Staff,4,0,25,21
1683649402967,USP 181,A00,187638,Staff,0,4,25,25
1683649403994,VIS 103,A00,187650,Cruz; Edwin Teddy,18,0,75,57
1683649405023,VIS 110D,A00,187669,Staff,13,0,22,9
1683649406051,VIS 127C,A00,187720,Shen; Kuiyi,67,0,146,79
1683649407075,VIS 149,A00,187731,Yoldas; Pinar,0,14,22,22
1683649408098,VIS 151,A01,188091,Staff,22,0,34,12
1683649408098,VIS 151,A02,188092,Staff,11,0,34,23
1683649409125,VIS 160B,A00,188093,Stalbaum; Brett,0,1,10,10
1683649411178,WCWP 10B,A00,201720,Staff,10,0,15,5
1683649411178,WCWP 10B,B00,201722,Staff,9,0,15,6
1683649412203,WCWP 100,A00,201725,Gagnon; Jeffrey C,0,0,2,2
1683649412203,WCWP 100,B00,201727,Staff,0,4,15,15
1683649415299,ANBI 133,A00,258401,Wilder; Linnea Lorene,34,0,40,6
1683649416327,ANBI 140,A00,258395,Hrvoj Mihic; Branka,18,0,25,7
1683649417350,ANSC 120,A00,258402,Bialecki; Jon Anthony,26,0,40,14
1683649418375,ANSC 144,A00,258400,Staff,12,0,40,28
1683649420427,ANSC 166,A00,258396,Parish; Steven Martin,156,0,175,19
1683649421451,ANSC 180,A00,193533,Staff,8,0,20,12
1683649422478,ANSC 188,A00,258397,Jassal; Aftab,34,0,40,6
1683649423503,ANTH 3,A01,258316,Staff,23,0,30,7
1683649424527,ANTH 5,A00,258394,Semendeferi; Ekaterini,16,0,20,4
1683649425551,ANTH 21,A01,258331,Staff,4,0,40,36
1683649426578,ANTH 103,A00,258398,Varma; Saiba,15,0,25,10
1683649427610,AWP 10,001,202034,Staff,0,0,0,0
1683649427610,AWP 10,002,202035,Staff,0,0,0,0
1683649427610,AWP 10,003,202036,Staff,0,0,0,0
1683649427610,AWP 10,004,202037,Staff,0,0,0,0
1683649427610,AWP 10,005,202038,Staff,0,0,0,0
1683649427610,AWP 10,006,202039,Staff,0,0,0,0
1683649427610,AWP 10,007,202040,Staff,0,0,0,0
1683649427610,AWP 10,008,202041,Staff,0,0,0,0
1683649427610,AWP 10,009,202042,Staff,0,0,0,0
1683649427610,AWP 10,010,202043,Staff,0,0,0,0
1683649427610,AWP 10,011,202044,Staff,0,0,0,0
1683649427610,AWP 10,012,202045,Staff,0,0,0,0
1683649427610,AWP 10,013,202046,Staff,0,0,0,0
1683649427610,AWP 10,014,202047,Staff,0,0,0,0
1683649427610,AWP 10,015,202048,Staff,0,0,0,0
1683649427610,AWP 10,016,202049,Staff,0,0,0,0
1683649427610,AWP 10,017,202050,Staff,0,0,0,0
1683649427610,AWP 10,018,202051,Staff,0,0,0,0
1683649427610,AWP 10,019,202052,Staff,0,0,0,0
1683649427610,AWP 10,020,202053,Staff,0,0,0,0
1683649427610,AWP 10,021,202054,Staff,0,0,0,0
1683649427610,AWP 10,022,202055,Staff,0,0,0,0
1683649427610,AWP 10,023,202056,Staff,0,0,0,0
1683649427610,AWP 10,024,202057,Staff,0,0,0,0
1683649427610,AWP 10,025,202058,Staff,0,0,0,0
1683649427610,AWP 10,026,202059,Staff,0,0,0,0
1683649428635,AWP 102,001,202032,Staff,0,0,0,0
1683649428635,AWP 102,002,202033,Staff,0,0,0,0
1683649429665,BENG 100,A01,254234,Taylor Amos; Alyssa C,31,0,40,9
1683649430691,BENG 196,001,270013,Engler; Adam J.,9999,0,9999,0
1683649431717,BICD 100R,A01,202018,Smith; Laurie,0,7,32,32
1683649431717,BICD 100R,A02,202019,Smith; Laurie,0,3,32,32
1683649431717,BICD 100R,A03,202020,Smith; Laurie,0,1,32,32
1683649431717,BICD 100R,A04,202021,Smith; Laurie,6,0,32,26
1683649431717,BICD 100R,A05,202022,Smith; Laurie,11,0,32,21
1683649432743,BICD 136,A01,193242,Gustafson-Brown; Cindy,0,2,32,32
1683649432743,BICD 136,A02,193244,Gustafson-Brown; Cindy,13,0,32,19
1683649433769,BIEB 102,A01,193249,Butler; Shannon Rhey,0,2,32,32
1683649433769,BIEB 102,A02,193251,Butler; Shannon Rhey,0,0,32,32
1683649433769,BIEB 102,A03,193253,Butler; Shannon Rhey,0,0,32,32
1683649433769,BIEB 102,A04,193255,Butler; Shannon Rhey,14,0,32,18
1683649433769,BIEB 102,A05,193265,Butler; Shannon Rhey,26,0,32,6
1683649433769,BIEB 102,A06,193269,Butler; Shannon Rhey,14,0,32,18
1683649435832,BIEB 150,A01,193274,Staff,0,0,32,32
1683649435832,BIEB 150,A02,193285,Staff,24,0,32,8
1683649436859,BIEB 194,A00,193286,Kurle; Carolyn M.,20,0,32,12
1683649437891,BILD 1,A01,192291,Staff,15,0,32,17
1683649437891,BILD 1,A02,192292,Staff,30,0,32,2
1683649437891,BILD 1,B01,192520,Reuther; Keefe,0,1,0,0
1683649437891,BILD 1,B02,192532,Reuther; Keefe,0,1,0,0
1683649438918,BILD 3,A01,192556,Butler; Shannon Rhey,0,0,32,32
1683649438918,BILD 3,A02,192581,Butler; Shannon Rhey,1,0,32,31
1683649438918,BILD 3,A03,192611,Butler; Shannon Rhey,21,0,32,11
1683649438918,BILD 3,A04,192612,Butler; Shannon Rhey,24,0,32,8
1683649438918,BILD 3,A05,192613,Butler; Shannon Rhey,26,0,32,6
1683649438918,BILD 3,A06,192679,Butler; Shannon Rhey,27,0,32,5
1683649438918,BILD 3,A07,192682,Butler; Shannon Rhey,20,0,32,12
1683649439943,BILD 4,A01,192836,Reuther; Keefe,1,0,24,23
1683649439943,BILD 4,A02,193044,Reuther; Keefe,4,0,24,20
1683649440970,BILD 10,A01,193142,Gustafson-Brown; Cindy,29,0,32,3
1683649440970,BILD 10,A02,193149,Gustafson-Brown; Cindy,31,0,32,1
1683649441995,BIMM 100,A01,193301,Staff,0,6,32,32
1683649441995,BIMM 100,A02,193312,Staff,0,7,32,32
1683649441995,BIMM 100,A03,193323,Staff,0,9,32,32
1683649443020,BIMM 101,A01,193329,McDonnell; Lisa Marie,0,4,24,24
1683649443020,BIMM 101,A02,193339,McDonnell; Lisa Marie,0,3,24,24
1683649443020,BIMM 101,B01,193354,McDonnell; Lisa Marie,0,4,24,24
1683649443020,BIMM 101,B02,193357,McDonnell; Lisa Marie,0,3,24,24
1683649444045,BIMM 110,A01,193377,Tat; John,0,11,32,32
1683649444045,BIMM 110,A02,193378,Tat; John,0,10,32,32
1683649445129,BIMM 120,A01,206116,Staff,0,0,32,32
1683649445129,BIMM 120,A02,206117,Staff,6,0,32,26
1683649445129,BIMM 120,A03,206121,Staff,21,0,32,11
1683649446158,BIPN 100,A01,193393,Park; Ji Young,0,14,32,32
1683649446158,BIPN 100,A02,193402,Park; Ji Young,0,14,32,32
1683649446158,BIPN 100,A03,193413,Park; Ji Young,0,14,32,32
1683649446158,BIPN 100,A04,193414,Park; Ji Young,0,13,32,32
1683649447181,BIPN 102,A01,193429,Staff,0,0,32,32
1683649447181,BIPN 102,A02,193438,Staff,18,0,32,14
1683649448207,BIPN 106,A01,193450,Reyes Gonzalez; Catalina,0,2,40,40
1683649449232,BIPN 134,A01,193465,Cooke; James Edward,0,0,32,32
1683649449232,BIPN 134,A02,193474,Cooke; James Edward,25,0,32,7
1683649449232,BIPN 134,A03,193485,Cooke; James Edward,29,0,32,3
1683649449232,BIPN 134,A04,193486,Cooke; James Edward,20,0,32,12
1683649449232,BIPN 134,A05,193491,Cooke; James Edward,31,0,32,1
1683649449232,BIPN 134,A06,193501,Cooke; James Edward,30,0,32,2
1683649449232,BIPN 134,A07,193510,Cooke; James Edward,29,0,32,3
1683649451279,BISP 194,A00,222522,Staff,14,0,32,18
1683649452307,CAT 124,A01,202407,Staff,19,0,25,6
1683649453335,CAT 125,A00,202408,Marchisotto; Jennifer Anne,2,0,20,18
1683649454360,CAT 125R,A00,202409,Smith; Lauryn Alissa,0,11,20,20
1683649454360,CAT 125R,B00,202410,Morales; Celeste Georgianna,0,11,20,20
1683649454360,CAT 125R,C00,202411,Irwin; Matthew Joseph,0,12,20,20
1683649455388,CENG 15,A01,204712,Yang; Kesong,0,1,0,0
1683649456415,CENG 114,A00,202070,Jahed Motlagh; Zeinab,5,0,20,15
1683649457440,CGS 105,A00,185477,Wesling; Megan E.,24,0,40,16
1683649458469,CGS 106,A00,185494,Staff,11,0,22,11
1683649459505,CGS 108,A00,185495,Staff,14,0,20,6
1683649460533,CGS 114,A00,185496,Staff,13,0,18,5
1683649461557,CGS 119,A00,185501,Staff,15,0,20,5
1683649462584,CGS 120,A00,185511,Staff,12,0,20,8
1683649463608,CHEM 4,A01,184675,Bussey; Thomas J,97,0,100,3
1683649464632,CHEM 6A,A01,184677,Staff,33,0,60,27
1683649465656,CHEM 6B,A01,184679,Staff,63,0,100,37
1683649466686,CHEM 6C,A01,184681,Bussey; Thomas J,0,0,50,50
1683649466686,CHEM 6C,A02,184682,Bussey; Thomas J,32,0,50,18
1683649467710,CHEM 40A,A01,184684,Albizati; Kim F.,34,0,100,66
1683649468741,CHEM 40B,A01,184686,Albizati; Kim F.,0,22,100,100
1683649469766,CHEM 41B,A01,184690,Staff,51,0,100,49
1683649470792,COGS 3,A01,184715,Boyle; Mary E. T.,0,27,40,40
1683649471819,COGS 14B,A01,185172,Staff,0,14,38,38
1683649472845,COGS 18,A01,184736,Staff,14,0,80,66
1683649473870,COGS 100,A01,184932,Staff,0,7,73,73
1683649474894,COGS 101A,A01,184935,Staff,0,39,30,30
1683649475921,COGS 101B,A01,184944,Staff,0,2,30,30
1683649476944,COGS 101C,A01,184946,Staff,0,10,30,30
1683649477970,COGS 102A,A01,184951,Johnson; Christine M.,2,0,40,38
1683649478995,COGS 107B,A01,184953,Mooshagian; Eric Frederick,0,51,40,40
1683649480018,COGS 118B,A01,184959,Gupta; Anjum,0,49,40,40
1683649481046,COGS 153,A00,184961,Staff,0,16,30,30
1683649482074,COGS 177,A00,184962,Staff,0,21,30,30
1683649483105,COGS 187A,A01,184969,Boyle; Mary E. T.,0,19,40,40
1683649484130,COMM 10,A01,185174,Staff,0,5,25,25
1683649484130,COMM 10,A02,185189,Staff,0,2,25,25
1683649484130,COMM 10,A03,269821,Staff,0,1,0,0
1683649485157,COMM 100B,A01,185475,Staff,0,1,0,2
1683649485157,COMM 100B,A02,185476,Staff,12,0,25,13
1683649486182,COMM 100C,A01,185314,Staff,1,0,25,24
1683649486182,COMM 100C,A02,185327,Staff,18,0,25,7
1683649487206,COMM 110M,A00,185349,Staff,0,0,40,40
1683649488233,COMM 113T,A00,185352,Staff,25,0,40,15
1683649489258,COMM 114I,A00,185353,Staff,31,0,40,9
1683649490282,COMM 131,A00,185354,Staff,17,0,30,13
1683649491310,CSE 8A,A50,185358,Cao; Yingjun,0,46,10,10
1683649492335,CSE 8B,A01,185362,Staff,0,48,50,50
1683649493359,CSE 11,A01,185416,Cao; Yingjun,0,91,10,10
1683649494383,CSE 20,A01,185445,Briones; Jor-el Thomas Caparas,4,0,25,21
1683649495409,CSE 21,A01,185447,Staff,9,0,50,41
1683649496436,CSE 101,A01,185451,Staff,0,13,50,50
1683649496436,CSE 101,B01,185453,Jones; Miles E,0,13,50,50
1683649498484,CSE 141,A01,185458,Eldon; John,16,0,100,84
1683649499509,CSE 141L,A01,185461,Eldon; John,8,0,100,92
1683649500533,CSE 142,A01,185463,Staff,35,0,60,25
1683649500533,CSE 142,B01,201355,Staff,0,7,60,60
1683649501559,CSE 142L,A01,185470,Staff,35,0,60,25
1683649501559,CSE 142L,B01,201417,Staff,0,6,60,60
1683649502583,CSE 190,A00,201433,Staff,32,0,49,17
1683649503607,DOC 1,A01,259136,Strom; Megan C.,7,0,15,8
1683649503607,DOC 1,A02,259137,Strom; Megan C.,14,0,15,1
1683649503607,DOC 1,A03,259138,Strom; Megan C.,14,0,15,1
1683649503607,DOC 1,A04,259139,Strom; Megan C.,14,0,15,1
1683649504641,DOC 100D,A00,259140,Pass; Natalye Joann,14,0,25,11
1683649505669,DSGN 1,A01,184749,Rill; Bryan,0,26,30,30
1683649506696,DSGN 100,A01,185168,Staff,0,2,25,25
1683649507731,ECE 5,A01,185626,Morris; Karcher William,0,11,0,0
1683649508755,ECE 101,A01,185628,Staff,14,0,70,56
1683649509780,ECE 107,A01,185635,Baghdadchi; Saharnaz,0,0,20,20
1683649509780,ECE 107,A02,185638,Baghdadchi; Saharnaz,3,0,20,17
1683649510806,ECE 148,A01,185647,Silberman; Jack,0,0,16,16
1683649511831,ECON 1,A01,185537,Crane; Meredith Helen,54,0,70,16
1683649512853,ECON 3,A01,185549,Crane; Meredith Helen,29,0,70,41
1683649513879,ECON 4,A01,203354,Anderson; John Charles,0,5,10,10
1683649514904,ECON 100A,A01,185574,Staff,0,5,40,40
1683649515931,ECON 100B,A01,185576,Staff,0,12,50,50
1683649516959,ECON 100C,A01,185589,Newhouse; Herbert S,30,0,70,40
1683649517983,ECON 105,A00,185608,Vespa; Emanuel Ignacio,19,0,35,16
1683649519010,ECON 109,A01,185610,Shishkin; Denis,9,0,35,26
1683649520037,ECON 110A,A01,185612,Staff,9,0,40,31
1683649521061,ECON 120A,A01,185615,Staff,20,0,40,20
1683649522088,ECON 120C,A01,185617,Sun; Yixiao,0,20,70,70
1683649523115,ECON 144,A00,203346,Squires; Dale E,2,0,35,33
1683649524139,ECON 171,A01,203349,Newhouse; Herbert S,0,1,35,35
1683649525162,ECON 173A,A01,185621,Toda; Alexis Akira,21,0,35,14
1683649526195,EDS 25,A01,202413,Staff,0,1,0,0
1683649526195,EDS 25,A02,202414,Staff,0,1,0,0
1683649526195,EDS 25,A03,202415,Staff,0,0,0,0
1683649526195,EDS 25,A04,202416,Staff,0,1,0,0
1683649526195,EDS 25,A05,202439,Staff,0,0,0,0
1683649526195,EDS 25,A06,202440,Staff,0,0,0,0
1683649526195,EDS 25,B01,202631,Staff,0,0,0,0
1683649526195,EDS 25,B02,202632,Staff,0,0,0,0
1683649526195,EDS 25,B03,202639,Staff,0,0,0,0
1683649526195,EDS 25,B04,202640,Staff,0,0,0,0
1683649526195,EDS 25,B05,202643,Staff,0,0,0,0
1683649526195,EDS 25,B06,202644,Staff,0,0,0,0
1683649527221,EDS 38,A01,202659,Black; Alison Michelle,24,0,25,1
1683649528243,EDS 115,A00,202652,Staff,18,0,30,12
1683649529272,EDS 125,A00,202649,Staff,13,0,30,17
1683649530296,EDS 126,A01,203332,Staff,30,0,30,0
1683649531319,EDS 139,A00,202838,Staff,16,0,25,9
1683649532345,EDS 146,A01,202655,Staff,14,0,25,11
1683649533370,ENG 15,A00,185667,Staff,0,1,0,0
1683649533370,ENG 15,B00,185672,Staff,0,0,0,0
1683649533370,ENG 15,C00,185675,Staff,0,0,0,0
1683649533370,ENG 15,D00,185682,Staff,0,0,0,0
1683649533370,ENG 15,E00,185684,Staff,0,0,0,0
1683649534406,ETHN 103,A00,185710,Staff,0,8,35,35
1683649535430,ETHN 103A,A00,199228,Man; Simeon S,0,0,9,9
1683649536452,ETHN 109,A00,185711,Staff,16,0,35,19
1683649537477,ETHN 142,A00,185726,Staff,0,4,30,30
1683649538501,ETHN 163J,A00,199229,Man; Simeon S,5,0,8,3
1683649539524,ETHN 168,A00,185727,Staff,7,0,10,3
1683649540551,ETHN 182,A00,185728,Staff,0,0,35,35
1683649541576,ETHN 183,A00,185737,Staff,9,0,18,9
1683649542603,GLBH 111,A01,209361,Burgos; Jose L.,0,0,0,0
1683649544654,HIEU 104,A00,185792,Staff,14,0,20,6
1683649545679,HIEU 115,A00,185800,Staff,0,0,20,20
1683649546705,HIEU 128,A00,185801,Staff,0,9,20,20
1683649547733,HIEU 147,A00,185802,Staff,15,0,20,5
1683649548811,HIEU 154,A00,185823,Staff,11,0,20,9
1683649549851,HILA 102,A00,185826,Staff,14,0,20,6
1683649550878,HILD 2C,A01,185778,Staff,0,13,20,20
1683649551906,HILD 7B,A01,185780,Kwak; Nancy,0,16,32,32
1683649551906,HILD 7B,A02,185781,Kwak; Nancy,0,18,32,32
1683649552934,HILD 30,A01,185791,Staff,12,0,20,8
1683649553960,HISC 119,A00,185830,Golan; Tal,0,9,20,20
1683649554984,HITO 156GS,A00,185831,Patterson; Patrick H.,0,0,0,23
1683649556009,HIUS 103,A00,185832,Man; Simeon S,0,4,20,20
1683649557035,HIUS 117,A00,185836,Kwak; Nancy,2,0,20,18
1683649558058,HIUS 125,A00,185840,Man; Simeon S,0,1,23,23
1683649559083,HIUS 149,A00,185845,Staff,1,0,20,19
1683649560107,HUM 3,A01,185882,Zavodny; Tatiana Sophia,0,7,50,50
1683649560107,HUM 3,B01,185899,Caldwell; Michael Alan,0,18,50,50
1683649561131,HUM 3GS,A00,185900,Patterson; Patrick H.,0,0,0,23
1683649562157,HUM 4,A01,185938,Zroka; Amy Liane,30,0,50,20
1683649562157,HUM 4,B01,185956,Watkins; Eric,0,4,50,50
1683649562157,HUM 4,B02,202209,Watkins; Eric,0,4,50,50
1683649562157,HUM 4,B03,202210,Watkins; Eric,0,4,50,50
1683649563183,HUM 5,A01,185958,West; Geoffrey Scott,2,0,50,48
1683649563183,HUM 5,A02,202215,West; Geoffrey Scott,0,0,50,50
1683649564211,INTL 190,A00,185959,Gagnon; Jeffrey C,0,0,0,9
1683649564211,INTL 190,B00,185960,Lettieri; Michael Joseph,0,0,0,2
1683649565238,JAPN 180,A00,254509,Staff,5,0,30,25
1683649566262,LATI 10,A01,202853,Kennemore; Amy Michelle,4,0,35,31
1683649566262,LATI 10,A02,202854,Kennemore; Amy Michelle,2,0,35,33
1683649566262,LATI 10,A03,270054,Kennemore; Amy Michelle,30,0,30,0
1683649567285,LATI 180,A00,202855,Kennemore; Amy Michelle,11,0,20,9
1683649568312,LAWS 101,A00,201767,Golan; Tal,0,7,40,40
1683649569339,LIFR 1C,A00,185961,Staff,6,0,20,14
1683649570366,LIFR 1CX,A00,185962,Staff,7,0,20,13
1683649571389,LIFR 1D,A00,185963,Staff,7,0,20,13
1683649572413,LIFR 1DX,A00,185964,Staff,7,0,20,13
1683649573437,LIGN 101,A01,186039,Staff,43,0,50,7
1683649574461,LIGN 165,A00,186040,Staff,15,0,50,35
1683649575486,LTCS 108,A00,186041,Staff,5,0,10,5
1683649576516,LTCS 119,A00,186042,Staff,15,0,20,5
1683649577540,LTCS 130,A00,186043,Wesling; Megan E.,15,0,25,10
1683649579592,LTEA 138,A00,186119,Staff,14,0,40,26
1683649580620,LTEN 124,A00,186148,Staff,5,0,25,20
1683649581644,LTEN 178,A00,186149,Staff,7,0,15,8
1683649582669,LTEN 181,A00,186150,Blanco; John D,34,0,40,6
1683649583695,LTWL 120,A00,186160,Staff,20,0,25,5
1683649584719,LTWL 165,A00,186161,Staff,22,0,25,3
1683649585743,LTWR 100,A00,186162,Staff,0,5,15,15
1683649586766,LTWR 102,A00,186163,Doller; Ben,5,0,15,10
1683649587791,MAE 8,A01,186412,Staff,0,0,0,0
1683649588819,MAE 30B,A00,186445,Bahadori; Mohammad Yousef,82,0,100,18
1683649589848,MAE 40,A00,186592,Bewley; Thomas R,10,0,50,40
1683649590877,MAE 101B,A00,186593,Bahadori; Mohammad Yousef,80,0,100,20
1683649591901,MAE 105,A00,186594,Bandaru; Prabhakar,10,0,50,40
1683649592930,MAE 107,A00,186599,Pham; Hieu Tan,0,7,120,120
1683649593953,MAE 148,A01,186660,Silberman; Jack,3,0,16,13
1683649594977,MATH 10A,A01,188095,Staff,0,5,35,35
1683649596002,MATH 10B,A01,188097,Bowers; Adam R.,0,11,30,30
1683649596002,MATH 10B,A02,188099,Bowers; Adam R.,0,11,30,30
1683649596002,MATH 10B,B01,188104,Bowers; Adam R.,0,10,30,30
1683649596002,MATH 10B,B02,188106,Bowers; Adam R.,1,9,30,29
1683649597028,MATH 10C,A01,188111,Staff,0,18,30,30
1683649597028,MATH 10C,A02,188127,Staff,0,19,30,30
1683649597028,MATH 10C,A03,188131,Staff,0,19,30,30
1683649597028,MATH 10C,B01,188218,Staff,17,0,30,13
1683649597028,MATH 10C,B02,188244,Staff,13,0,30,17
1683649597028,MATH 10C,B03,188277,Staff,14,0,30,16
1683649598054,MATH 18,A01,188344,Bach; Quang Tran,18,0,30,12
1683649598054,MATH 18,A02,188345,Bach; Quang Tran,11,0,30,19
1683649598054,MATH 18,B01,188353,Bach; Quang Tran,11,0,30,19
1683649598054,MATH 18,B02,188354,Bach; Quang Tran,19,0,30,11
1683649599082,MATH 20A,A01,188374,Staff,11,0,35,24
1683649600111,MATH 20B,A01,188382,Ohm; Ko Woon,7,0,30,23
1683649600111,MATH 20B,A02,188383,Ohm; Ko Woon,22,0,30,8
1683649600111,MATH 20B,B01,188385,Ohm; Ko Woon,7,0,30,23
1683649600111,MATH 20B,B02,188392,Ohm; Ko Woon,22,0,30,8
1683649601136,MATH 20C,A01,188394,Harel; Guershon,11,0,30,19
1683649601136,MATH 20C,A02,188395,Harel; Guershon,13,0,30,17
1683649601136,MATH 20C,B01,188404,Harel; Guershon,5,0,30,25
1683649601136,MATH 20C,B02,188405,Harel; Guershon,18,0,30,12
1683649602166,MATH 20D,A01,188414,Hammock; Frances H,0,1,30,30
1683649602166,MATH 20D,A02,188415,Hammock; Frances H,0,1,30,30
1683649602166,MATH 20D,B01,188447,Hammock; Frances H,0,1,30,30
1683649602166,MATH 20D,B02,188486,Hammock; Frances H,4,0,30,26
1683649603191,MATH 20E,A01,188649,Staff,21,0,30,9
1683649603191,MATH 20E,A02,188650,Staff,21,0,30,9
1683649603191,MATH 20E,A03,188673,Staff,0,0,30,30
1683649604215,MATH 102,A01,188675,Staff,0,36,35,35
1683649605240,MATH 103B,A01,188681,Staff,3,0,35,32
1683649605240,MATH 103B,B01,188692,Staff,5,0,35,30
1683649606266,MATH 109,A01,188695,Salehi Golsefidy; Alireza,24,0,35,11
1683649606266,MATH 109,A02,188696,Salehi Golsefidy; Alireza,25,0,35,10
1683649607291,MATH 120A,A01,188698,Eggers; John Dietrich,7,0,35,28
1683649608316,MATH 142B,A01,188736,Ioana; Adrian,0,1,30,30
1683649608316,MATH 142B,A02,188741,Ioana; Adrian,0,1,30,30
1683649608316,MATH 142B,A03,188743,Ioana; Adrian,0,1,30,30
1683649609339,MATH 168A,A01,188790,Staff,0,10,35,35
1683649610365,MATH 170A,A01,188803,Nie; Jiawang,0,2,35,35
1683649610365,MATH 170A,A02,188811,Nie; Jiawang,0,0,35,35
1683649610365,MATH 170A,A03,188814,Nie; Jiawang,0,0,35,35
1683649610365,MATH 170A,A04,188815,Nie; Jiawang,10,0,35,25
1683649611389,MATH 193B,A01,188817,Staff,0,0,35,35
1683649611389,MATH 193B,A02,188818,Staff,5,0,35,30
1683649612419,MGT 4,A01,202857,Anderson; John Charles,61,0,80,19
1683649613442,MGT 12,A00,202858,Lindenberger; Wade Douglas,40,0,90,50
1683649614466,MGT 18,A00,202859,Staff,74,0,90,16
1683649615490,MGT 18GS,A00,202860,McKay; Michael J,13,0,28,15
1683649616520,MGT 45,A00,202861,Pecore; Joseph P.,12,0,90,78
1683649617546,MGT 100,A00,202863,Yavorsky; Daniel Ryan,28,0,90,62
1683649618571,MGT 103,A00,202864,Ehrich; Kristine R,0,17,90,90
1683649619599,MGT 112,A00,202865,Ehrich; Kristine R,15,0,90,75
1683649620627,MGT 121A,A00,202868,Staff,0,20,0,0
1683649621654,MGT 131B,A00,202869,Anderson; John Charles,59,0,90,31
1683649622678,MGT 136,A00,202871,Lindenberger; Wade Douglas,83,0,90,7
1683649623706,MGT 164,A00,202873,Staff,0,66,90,91
1683649624730,MGT 164GS,A00,202874,McKay; Mary A,13,0,28,15
1683649625755,MGT 180,A00,202875,Staff,0,50,90,91
1683649626783,MMW 11R,A01,205019,Herbst; Matthew,2,0,30,28
1683649626783,MMW 11R,A02,205026,Herbst; Matthew,29,0,30,1
1683649627817,MMW 15,A01,193512,Chang; Edmond Yi-Teh,0,8,28,28
1683649627817,MMW 15,A02,193513,Chang; Edmond Yi-Teh,0,5,28,28
1683649627817,MMW 15,A03,193514,Chang; Edmond Yi-Teh,0,5,28,28
1683649627817,MMW 15,A04,193515,Chang; Edmond Yi-Teh,0,5,28,28
1683649627817,MMW 15,A05,193516,Chang; Edmond Yi-Teh,0,5,28,28
1683649627817,MMW 15,A06,193517,Chang; Edmond Yi-Teh,0,6,28,28
1683649627817,MMW 15,B01,193519,Chang; Edmond Yi-Teh,0,5,28,28
1683649627817,MMW 15,B02,193520,Chang; Edmond Yi-Teh,0,5,28,28
1683649627817,MMW 15,B03,193521,Chang; Edmond Yi-Teh,0,5,28,28
1683649627817,MMW 15,B04,193522,Chang; Edmond Yi-Teh,0,5,28,28
1683649627817,MMW 15,B05,193523,Chang; Edmond Yi-Teh,0,5,28,28
1683649627817,MMW 15,B06,193524,Chang; Edmond Yi-Teh,0,5,28,28
1683649628842,MMW 122,A01,193526,Rahimi; Babak,0,16,28,28
1683649628842,MMW 122,A02,193527,Rahimi; Babak,0,15,28,28
1683649628842,MMW 122,A03,193528,Rahimi; Babak,0,0,0,0
1683649628842,MMW 122,A04,193529,Rahimi; Babak,0,0,0,0
1683649629870,MUS 1A,A01,186663,Staff,1,20,35,34
1683649630898,MUS 4,A01,186715,Staff,0,12,35,35
1683649631935,MUS 5R,A01,186796,Dubnov; Shlomo,0,17,35,35
1683649632963,MUS 6,A01,186798,Staff,0,5,25,25
1683649633989,MUS 7,A01,186830,Staff,11,0,35,24
1683649635010,MUS 8,A01,186930,Staff,0,26,35,35
1683649636035,MUS 15,A01,186932,Staff,0,16,35,35
1683649636035,MUS 15,B01,186934,Staff,0,17,35,35
1683649637062,MUS 80,A00,186935,Staff,0,0,20,20
1683649637062,MUS 80,B00,186936,Staff,24,0,25,1
1683649638086,NANO 11,A00,204702,Lipomi; Darren John,0,0,0,0
1683649639110,NANO 15,A01,204709,Yang; Kesong,0,1,0,0
1683649640137,NANO 114,A00,202069,Jahed Motlagh; Zeinab,3,0,10,7
1683649641164,PHIL 1,A00,186955,Grush; Rick Scott,31,0,40,9
1683649642189,PHIL 10,A01,186973,Grush; Rick Scott,27,0,35,8
1683649642189,PHIL 10,A02,186974,Grush; Rick Scott,33,0,35,2
1683649643222,PHIL 13,A01,186976,Staff,3,0,35,32
1683649643222,PHIL 13,A02,186977,Staff,16,0,35,19
1683649644246,PHIL 14,A01,186979,Staff,31,0,35,4
1683649644246,PHIL 14,A02,186986,Staff,32,0,35,3
1683649645271,PHIL 28,A01,186988,Staff,16,0,30,14
1683649645271,PHIL 28,A02,186989,Staff,1,0,30,29
1683649645271,PHIL 28,A03,186990,Staff,10,0,30,20
1683649645271,PHIL 28,A04,186991,Staff,26,0,30,4
1683649646294,PHIL 120,A00,186997,Staff,23,0,40,17
1683649647321,PHIL 137,A00,187003,Staff,7,0,40,33
1683649648347,PHIL 150,A00,187015,Staff,47,0,70,23
1683649649374,PHIL 167,A00,187021,Lamey; Andy M.,34,0,40,6
1683649650404,PHIL 174,A01,202226,Staff,17,0,20,3
1683649650404,PHIL 174,A02,202235,Staff,20,0,20,0
1683649651429,PHIL 191A,A00,258918,Staff,0,0,1,1
1683649652522,PHYS 1A,A00,187028,Staff,26,0,60,34
1683649653547,PHYS 1AL,001,187036,Staff,3,0,30,27
1683649653547,PHYS 1AL,002,187049,Staff,18,0,30,12
1683649654572,PHYS 1B,A00,187058,Staff,22,0,60,38
1683649655597,PHYS 1BL,001,187064,Staff,0,1,30,30
1683649655597,PHYS 1BL,002,187070,Staff,4,0,30,26
1683649656626,PHYS 1C,A00,187082,Staff,29,0,120,91
1683649657651,PHYS 1CL,001,187088,Staff,0,9,30,30
1683649657651,PHYS 1CL,002,187089,Staff,0,1,30,30
1683649657651,PHYS 1CL,009,262693,Staff,9,0,30,21
1683649658676,PHYS 2B,A01,187097,Staff,55,0,115,60
1683649659702,PHYS 2C,A01,187099,Staff,64,0,115,51
1683649660726,PHYS 2CL,A01,187101,Staff,5,0,28,23
1683649660726,PHYS 2CL,A02,187102,Staff,15,0,28,13
1683649661754,PHYS 2D,A01,187123,Shotwell; Brian,95,0,115,20
1683649662779,PHYS 4B,A01,187133,Grinstein; Benjamin,35,0,50,15
1683649663806,POLI 10,A00,188819,Staff,0,4,50,50
1683649664831,POLI 11,A00,188827,Staff,43,0,50,7
1683649665853,POLI 13R,A00,188828,Staff,0,1,20,20
1683649666877,POLI 27,A01,188830,Elgin; Samuel Zincke,0,2,70,70
1683649667902,POLI 30,A00,188832,Desposato; Scott,30,0,50,20
1683649668924,POLI 102F,A00,188834,Staff,0,0,40,40
1683649669948,POLI 104A,A00,188852,Staff,13,0,30,17
1683649670974,POLI 104I,A00,188853,Staff,0,7,20,20
1683649672007,POLI 110B,A00,188854,Wiens; David,7,0,20,13
1683649673034,POLI 112A,A00,188855,Wiens; David,4,0,30,26
1683649674060,POLI 117R,A00,188856,Forman; Fonna,0,12,20,20
1683649675083,POLI 118,A00,188857,Ingham; Sean,8,0,20,12
1683649676108,POLI 120G,A00,188858,Staff,8,0,30,22
1683649677131,POLI 131CR,A00,188863,Hoston; Germaine,21,0,50,29
1683649678156,POLI 133,A00,188864,Nellis; Gareth Hb,44,0,50,6
1683649679185,POLI 134D,A00,188865,Desposato; Scott,27,0,30,3
1683649680213,POLI 142A,A00,188871,Gartzke; Erik,21,0,50,29
1683649681243,POLI 142K,A00,188874,Staff,38,0,50,12
1683649682267,POLI 143,A00,188940,Gartzke; Erik,16,0,30,14
1683649683291,POLI 153,A00,188943,Staff,2,0,20,18
1683649684315,POLI 160AA,A00,188944,Staff,11,0,40,29
1683649685341,POLI 170A,A00,188945,Staff,11,0,30,19
1683649687389,PSYC 1,A00,188952,Staff,36,0,90,54
1683649688413,PSYC 2,B00,188953,Staff,19,0,35,16
1683649689441,PSYC 6,A00,188970,Staff,47,0,60,13
1683649690464,PSYC 7,A00,188973,Staff,35,0,45,10
1683649691612,PSYC 60,A01,188980,Rickard; Timothy C.,42,0,60,18
1683649692635,PSYC 70,A01,189001,Steiner; Eric Tomas,23,0,45,22
1683649693663,PSYC 100,A00,189005,Lacefield; Katharine I,0,99,120,120
1683649694690,PSYC 102,A00,189008,Staff,8,0,30,22
1683649695716,PSYC 106,B00,189026,Gorman; Michael R.,27,0,60,33
1683649696740,PSYC 114,B01,189033,Winkielman; Piotr,0,31,30,30
1683649697767,PSYC 131,A00,189036,Anagnostaras; Stephan,0,43,60,60
1683649698790,PSYC 136,A00,189041,Lowe; Angela Beth,0,7,25,25
1683649699824,PSYC 137,A00,189057,Winkielman; Piotr,0,37,25,25
1683649700848,PSYC 144,A00,189107,Wixted; John T,0,10,50,50
1683649702898,PSYC 162,A00,189142,Staff,0,9,85,85
1683649703941,PSYC 172,A00,189144,Gorman; Michael R.,0,6,30,30
1683649705990,PSYC 179,A00,189146,Lacefield; Katharine I,0,86,120,120
1683649707014,PSYC 181,A00,189147,Anagnostaras; Stephan,0,44,90,90
1683649708038,PSYC 190R,A00,189148,Barner; David A.,0,23,80,80
1683649709066,PSYC 191,A00,189275,Rickard; Timothy C.,0,10,25,25
1683649710094,PSYC 193,A00,189276,Chapman; Eddie Nathaniel,0,1,0,4
1683649711122,PSYC 193L,A01,189281,Lowe; Angela Beth,10,0,20,10
1683649711122,PSYC 193L,B01,189285,Staff,28,0,35,7
1683649712147,RELI 149,A00,187137,Rahimi; Babak,7,0,40,33
1683649713170,SE 9,A01,187315,Staff,0,2,18,18
1683649714196,SE 101B,A00,187409,Staff,24,0,30,6
1683649715222,SE 110B,A00,187444,Staff,10,0,40,30
1683649716245,SE 130B,A00,187449,Staff,31,0,40,9
1683649717269,SE 150A,A00,187516,Staff,9,0,20,11
1683649718294,SE 154,A00,187528,Staff,29,0,50,21
1683649719319,SIO 3,A01,258171,Staff,35,0,40,5
1683649720346,SIO 10,A00,187144,Cook; Geoffrey W,0,6,75,75
1683649721373,SIO 45,A00,187152,Cook; Geoffrey W,0,4,100,100
1683649722400,SIO 109R,A00,194486,Staff,0,4,20,20
1683649724450,SIO 187,A01,187233,Kacev; David,12,0,40,28
1683649725472,SOCI 1,A01,258656,Thorpe; Charles Robert,28,0,30,2
1683649725472,SOCI 1,A02,258658,Thorpe; Charles Robert,30,0,30,0
1683649725472,SOCI 1,A03,258661,Thorpe; Charles Robert,25,0,25,0
1683649725472,SOCI 1,A04,258666,Thorpe; Charles Robert,22,0,25,3
1683649725472,SOCI 1,A05,258897,Thorpe; Charles Robert,22,0,25,3
1683649725472,SOCI 1,A06,258898,Thorpe; Charles Robert,25,0,25,0
1683649726498,SOCI 30,A01,258903,Pardo Guerra; Juan Pablo,14,0,30,16
1683649727526,SOCI 102,A00,258904,Staff,9,0,25,16
1683649728550,SOCI 106,A00,258905,Staff,19,0,25,6
1683649729577,SOCI 111,A00,258907,Ribas Norris; Janet Vanesa,26,0,30,4
1683649730604,SOCI 121R,A00,258908,Pardo Guerra; Juan Pablo,8,0,30,22
1683649731630,SOCI 126,A01,203330,Staff,14,0,20,6
1683649732660,SOCI 131,A00,258909,Thorpe; Charles Robert,30,0,60,30
1683649733698,SOCI 135,A00,258910,Payne; Christine Anna,0,11,30,30
1683649734722,SOCI 157,A00,258911,Staff,12,0,30,18
1683649735746,SOCI 184,A00,258912,Staff,25,0,30,5
1683649736773,SOCI 188D,A00,258913,Staff,22,0,30,8
1683649737797,SYN 2,001,187529,Staff,9,0,16,7
1683649737797,SYN 2,002,201452,Staff,0,20,16,16
1683649737797,SYN 2,003,201469,Staff,2,0,16,14
1683649738822,SYN 100,A01,187531,Staff,0,9,20,20
1683649738822,SYN 100,B01,201491,Staff,0,10,20,20
1683649739846,TDAC 1,A00,189286,Walsh; Kim C.,3,0,20,17
1683649739846,TDAC 1,B00,189287,Harting; Carla Kelso,10,0,20,10
1683649740870,TDAC 101,A00,189300,Walsh; Kim C.,16,0,20,4
1683649740870,TDAC 101,B00,189301,Harting; Carla Kelso,18,0,20,2
1683649741897,TDAC 102,A00,189304,Basso; Beatrice,14,0,20,6
1683649742921,TDAC 108,A00,189305,Staff,18,0,20,2
1683649743946,TDDE 131,A00,189310,Staff,19,0,20,1
1683649743946,TDDE 131,B00,189314,Staff,19,0,20,1
1683649743946,TDDE 131,C00,189315,Staff,48,0,50,2
1683649743946,TDDE 131,D00,189316,Staff,14,0,15,1
1683649743946,TDDE 131,E00,204841,Staff,20,0,20,0
1683649744970,TDGE 10,A00,189289,Staff,27,0,50,23
1683649744970,TDGE 10,B00,189290,Havis; Allan,0,0,50,50
1683649745999,TDGE 11,A00,189291,Fulton; Julia,0,4,50,50
1683649745999,TDGE 11,B00,189292,Staff,20,0,25,5
1683649745999,TDGE 11,C00,260270,Staff,0,0,0,0
1683649747024,TDGE 25,A00,189294,Staff,2,0,20,18
1683649748051,TDGE 124,A00,189318,Fulton; Julia,0,8,50,50
1683649749076,TDGE 125,A00,189319,Staff,13,0,25,12
1683649749076,TDGE 125,B00,189320,Staff,23,0,25,2
1683649750099,TDGE 127,A00,189322,Havis; Allan,0,0,50,50
1683649751124,TDHT 101,A00,189323,Staff,18,0,25,7
1683649751124,TDHT 101,B00,189324,Staff,25,0,25,0
1683649752147,TDHT 102,A00,189325,Staff,49,0,50,1
1683649753170,TDMV 1,A00,189295,Arcidiacono; Kristin,20,0,30,10
1683649753170,TDMV 1,B00,189296,Caligagan; Maria T.,24,0,30,6
1683649754196,TDMV 2,A00,189297,Sammartano; Tonnie,27,0,30,3
1683649754196,TDMV 2,B00,189299,Arcidiacono; Kristin,23,0,30,7
1683649755221,TDMV 3,A00,204998,Rincon; Alicia,22,0,30,8
1683649756305,TDMV 120,A00,189458,Sammartano; Tonnie,28,0,30,2
1683649757328,TDMV 138,A00,189541,Jun; Grace Shin Hae,20,0,40,20
1683649758352,TDMV 142,A00,189717,Caligagan; Tony,25,0,30,5
1683649758352,TDMV 142,B00,189718,Caligagan; Maria T.,25,0,30,5
1683649759376,TMC 2,A01,187533,Staff,25,0,25,0
1683649759376,TMC 2,A02,187534,Staff,25,0,25,0
1683649760400,USP 1,A01,187536,Kwak; Nancy,0,16,25,25
1683649761422,USP 5,A01,187538,Staff,9,0,25,16
1683649762446,USP 101,A00,199253,Staff,0,4,0,0
1683649763479,USP 124,A00,187562,Boomhower; Matthew Charles,0,0,30,30
1683649764504,USP 138,A00,187582,Staff,20,0,25,5
1683649765531,USP 152,A01,187597,Staff,3,0,25,22
1683649766555,USP 153,A00,187598,Staff,19,0,25,6
1683649767579,USP 168,A00,187607,Kwak; Nancy,2,0,5,3
1683649768606,USP 173,A00,187619,Staff,4,0,25,21
1683649769632,USP 181,A00,187638,Staff,0,4,25,25
1683649770658,VIS 103,A00,187650,Cruz; Edwin Teddy,18,0,75,57
1683649771685,VIS 110D,A00,187669,Staff,13,0,22,9
1683649772710,VIS 127C,A00,187720,Shen; Kuiyi,67,0,146,79
1683649773734,VIS 149,A00,187731,Yoldas; Pinar,0,14,22,22
1683649774759,VIS 151,A01,188091,Staff,22,0,34,12
1683649774759,VIS 151,A02,188092,Staff,11,0,34,23
1683649775782,VIS 160B,A00,188093,Stalbaum; Brett,0,1,10,10
1683649777833,WCWP 10B,A00,201720,Staff,10,0,15,5
1683649777833,WCWP 10B,B00,201722,Staff,9,0,15,6
1683649778860,WCWP 100,A00,201725,Gagnon; Jeffrey C,0,0,2,2
1683649778860,WCWP 100,B00,201727,Staff,0,4,15,15
1683649781989,ANBI 133,A00,258401,Wilder; Linnea Lorene,34,0,40,6
1683649783014,ANBI 140,A00,258395,Hrvoj Mihic; Branka,18,0,25,7
1683649784041,ANSC 120,A00,258402,Bialecki; Jon Anthony,26,0,40,14
1683649785068,ANSC 144,A00,258400,Staff,12,0,40,28
1683649787115,ANSC 166,A00,258396,Parish; Steven Martin,156,0,175,19
1683649788142,ANSC 180,A00,193533,Staff,8,0,20,12
1683649789165,ANSC 188,A00,258397,Jassal; Aftab,34,0,40,6
1683649790191,ANTH 3,A01,258316,Staff,23,0,30,7
1683649791214,ANTH 5,A00,258394,Semendeferi; Ekaterini,16,0,20,4
1683649792242,ANTH 21,A01,258331,Staff,4,0,40,36
1683649793270,ANTH 103,A00,258398,Varma; Saiba,15,0,25,10
1683649794303,AWP 10,001,202034,Staff,0,0,0,0
1683649794303,AWP 10,002,202035,Staff,0,0,0,0
1683649794303,AWP 10,003,202036,Staff,0,0,0,0
1683649794303,AWP 10,004,202037,Staff,0,0,0,0
1683649794303,AWP 10,005,202038,Staff,0,0,0,0
1683649794303,AWP 10,006,202039,Staff,0,0,0,0
1683649794303,AWP 10,007,202040,Staff,0,0,0,0
1683649794303,AWP 10,008,202041,Staff,0,0,0,0
1683649794303,AWP 10,009,202042,Staff,0,0,0,0
1683649794303,AWP 10,010,202043,Staff,0,0,0,0
1683649794303,AWP 10,011,202044,Staff,0,0,0,0
1683649794303,AWP 10,012,202045,Staff,0,0,0,0
1683649794303,AWP 10,013,202046,Staff,0,0,0,0
1683649794303,AWP 10,014,202047,Staff,0,0,0,0
1683649794303,AWP 10,015,202048,Staff,0,0,0,0
1683649794303,AWP 10,016,202049,Staff,0,0,0,0
1683649794303,AWP 10,017,202050,Staff,0,0,0,0
1683649794303,AWP 10,018,202051,Staff,0,0,0,0
1683649794303,AWP 10,019,202052,Staff,0,0,0,0
1683649794303,AWP 10,020,202053,Staff,0,0,0,0
1683649794303,AWP 10,021,202054,Staff,0,0,0,0
1683649794303,AWP 10,022,202055,Staff,0,0,0,0
1683649794303,AWP 10,023,202056,Staff,0,0,0,0
1683649794303,AWP 10,024,202057,Staff,0,0,0,0
1683649794303,AWP 10,025,202058,Staff,0,0,0,0
1683649794303,AWP 10,026,202059,Staff,0,0,0,0
1683649795326,AWP 102,001,202032,Staff,0,0,0,0
1683649795326,AWP 102,002,202033,Staff,0,0,0,0
1683649796351,BENG 100,A01,254234,Taylor Amos; Alyssa C,31,0,40,9
1683649797375,BENG 196,001,270013,Engler; Adam J.,9999,0,9999,0
1683649798403,BICD 100R,A01,202018,Smith; Laurie,0,7,32,32
1683649798403,BICD 100R,A02,202019,Smith; Laurie,0,3,32,32
1683649798403,BICD 100R,A03,202020,Smith; Laurie,0,1,32,32
1683649798403,BICD 100R,A04,202021,Smith; Laurie,6,0,32,26
1683649798403,BICD 100R,A05,202022,Smith; Laurie,11,0,32,21
1683649799427,BICD 136,A01,193242,Gustafson-Brown; Cindy,0,2,32,32
1683649799427,BICD 136,A02,193244,Gustafson-Brown; Cindy,13,0,32,19
1683649800456,BIEB 102,A01,193249,Butler; Shannon Rhey,0,2,32,32
1683649800456,BIEB 102,A02,193251,Butler; Shannon Rhey,0,0,32,32
1683649800456,BIEB 102,A03,193253,Butler; Shannon Rhey,0,0,32,32
1683649800456,BIEB 102,A04,193255,Butler; Shannon Rhey,14,0,32,18
1683649800456,BIEB 102,A05,193265,Butler; Shannon Rhey,26,0,32,6
1683649800456,BIEB 102,A06,193269,Butler; Shannon Rhey,14,0,32,18
1683649802509,BIEB 150,A01,193274,Staff,0,0,32,32
1683649802509,BIEB 150,A02,193285,Staff,24,0,32,8
1683649803536,BIEB 194,A00,193286,Kurle; Carolyn M.,20,0,32,12
1683649804564,BILD 1,A01,192291,Staff,15,0,32,17
1683649804564,BILD 1,A02,192292,Staff,30,0,32,2
1683649804564,BILD 1,B01,192520,Reuther; Keefe,0,1,0,0
1683649804564,BILD 1,B02,192532,Reuther; Keefe,0,1,0,0
1683649805593,BILD 3,A01,192556,Butler; Shannon Rhey,0,0,32,32
1683649805593,BILD 3,A02,192581,Butler; Shannon Rhey,1,0,32,31
1683649805593,BILD 3,A03,192611,Butler; Shannon Rhey,21,0,32,11
1683649805593,BILD 3,A04,192612,Butler; Shannon Rhey,24,0,32,8
1683649805593,BILD 3,A05,192613,Butler; Shannon Rhey,26,0,32,6
1683649805593,BILD 3,A06,192679,Butler; Shannon Rhey,27,0,32,5
1683649805593,BILD 3,A07,192682,Butler; Shannon Rhey,20,0,32,12
1683649806617,BILD 4,A01,192836,Reuther; Keefe,1,0,24,23
1683649806617,BILD 4,A02,193044,Reuther; Keefe,4,0,24,20
1683649807646,BILD 10,A01,193142,Gustafson-Brown; Cindy,29,0,32,3
1683649807646,BILD 10,A02,193149,Gustafson-Brown; Cindy,31,0,32,1
1683649808673,BIMM 100,A01,193301,Staff,0,6,32,32
1683649808673,BIMM 100,A02,193312,Staff,0,7,32,32
1683649808673,BIMM 100,A03,193323,Staff,0,9,32,32
1683649809704,BIMM 101,A01,193329,McDonnell; Lisa Marie,0,4,24,24
1683649809704,BIMM 101,A02,193339,McDonnell; Lisa Marie,0,3,24,24
1683649809704,BIMM 101,B01,193354,McDonnell; Lisa Marie,0,4,24,24
1683649809704,BIMM 101,B02,193357,McDonnell; Lisa Marie,0,3,24,24
1683649810734,BIMM 110,A01,193377,Tat; John,0,11,32,32
1683649810734,BIMM 110,A02,193378,Tat; John,0,10,32,32
1683649811762,BIMM 120,A01,206116,Staff,0,0,32,32
1683649811762,BIMM 120,A02,206117,Staff,6,0,32,26
1683649811762,BIMM 120,A03,206121,Staff,21,0,32,11
1683649812791,BIPN 100,A01,193393,Park; Ji Young,0,14,32,32
1683649812791,BIPN 100,A02,193402,Park; Ji Young,0,14,32,32
1683649812791,BIPN 100,A03,193413,Park; Ji Young,0,14,32,32
1683649812791,BIPN 100,A04,193414,Park; Ji Young,0,13,32,32
1683649813819,BIPN 102,A01,193429,Staff,0,0,32,32
1683649813819,BIPN 102,A02,193438,Staff,18,0,32,14
1683649814844,BIPN 106,A01,193450,Reyes Gonzalez; Catalina,0,2,40,40
1683649815871,BIPN 134,A01,193465,Cooke; James Edward,0,0,32,32
1683649815871,BIPN 134,A02,193474,Cooke; James Edward,25,0,32,7
1683649815871,BIPN 134,A03,193485,Cooke; James Edward,29,0,32,3
1683649815871,BIPN 134,A04,193486,Cooke; James Edward,20,0,32,12
1683649815871,BIPN 134,A05,193491,Cooke; James Edward,31,0,32,1
1683649815871,BIPN 134,A06,193501,Cooke; James Edward,30,0,32,2
1683649815871,BIPN 134,A07,193510,Cooke; James Edward,29,0,32,3
1683649817923,BISP 194,A00,222522,Staff,14,0,32,18
1683649818950,CAT 124,A01,202407,Staff,19,0,25,6
1683649819976,CAT 125,A00,202408,Marchisotto; Jennifer Anne,2,0,20,18
1683649821005,CAT 125R,A00,202409,Smith; Lauryn Alissa,0,11,20,20
1683649821005,CAT 125R,B00,202410,Morales; Celeste Georgianna,0,11,20,20
1683649821005,CAT 125R,C00,202411,Irwin; Matthew Joseph,0,12,20,20
1683649822035,CENG 15,A01,204712,Yang; Kesong,0,1,0,0
1683649823058,CENG 114,A00,202070,Jahed Motlagh; Zeinab,5,0,20,15
1683649824083,CGS 105,A00,185477,Wesling; Megan E.,24,0,40,16
1683649825109,CGS 106,A00,185494,Staff,11,0,22,11
1683649826134,CGS 108,A00,185495,Staff,14,0,20,6
1683649827161,CGS 114,A00,185496,Staff,13,0,18,5
1683649828188,CGS 119,A00,185501,Staff,15,0,20,5
1683649829212,CGS 120,A00,185511,Staff,12,0,20,8
1683649830237,CHEM 4,A01,184675,Bussey; Thomas J,97,0,100,3
1683649831260,CHEM 6A,A01,184677,Staff,33,0,60,27
1683649832285,CHEM 6B,A01,184679,Staff,63,0,100,37
1683649833316,CHEM 6C,A01,184681,Bussey; Thomas J,0,0,50,50
1683649833316,CHEM 6C,A02,184682,Bussey; Thomas J,32,0,50,18
1683649834347,CHEM 40A,A01,184684,Albizati; Kim F.,34,0,100,66
1683649835371,CHEM 40B,A01,184686,Albizati; Kim F.,0,22,100,100
1683649836399,CHEM 41B,A01,184690,Staff,51,0,100,49
1683649837425,COGS 3,A01,184715,Boyle; Mary E. T.,0,27,40,40
1683649838452,COGS 14B,A01,185172,Staff,0,14,38,38
1683649839479,COGS 18,A01,184736,Staff,14,0,80,66
1683649840507,COGS 100,A01,184932,Staff,0,7,73,73
1683649841534,COGS 101A,A01,184935,Staff,0,39,30,30
1683649842561,COGS 101B,A01,184944,Staff,0,2,30,30
1683649843589,COGS 101C,A01,184946,Staff,0,10,30,30
1683649844615,COGS 102A,A01,184951,Johnson; Christine M.,2,0,40,38
1683649845643,COGS 107B,A01,184953,Mooshagian; Eric Frederick,0,51,40,40
1683649846668,COGS 118B,A01,184959,Gupta; Anjum,0,49,40,40
1683649847692,COGS 153,A00,184961,Staff,0,16,30,30
1683649848717,COGS 177,A00,184962,Staff,0,21,30,30
1683649849742,COGS 187A,A01,184969,Boyle; Mary E. T.,0,19,40,40
1683649850768,COMM 10,A01,185174,Staff,0,5,25,25
1683649850768,COMM 10,A02,185189,Staff,0,2,25,25
1683649850768,COMM 10,A03,269821,Staff,0,1,0,0
1683649851801,COMM 100B,A01,185475,Staff,0,1,0,2
1683649851801,COMM 100B,A02,185476,Staff,12,0,25,13
1683649852829,COMM 100C,A01,185314,Staff,1,0,25,24
1683649852829,COMM 100C,A02,185327,Staff,18,0,25,7
1683649853855,COMM 110M,A00,185349,Staff,0,0,40,40
1683649854880,COMM 113T,A00,185352,Staff,25,0,40,15
1683649855904,COMM 114I,A00,185353,Staff,31,0,40,9
1683649856928,COMM 131,A00,185354,Staff,17,0,30,13
1683649857955,CSE 8A,A50,185358,Cao; Yingjun,0,46,10,10
1683649858979,CSE 8B,A01,185362,Staff,0,48,50,50
1683649860061,CSE 11,A01,185416,Cao; Yingjun,0,91,10,10
1683649861101,CSE 20,A01,185445,Briones; Jor-el Thomas Caparas,4,0,25,21
1683649862131,CSE 21,A01,185447,Staff,9,0,50,41
1683649863161,CSE 101,A01,185451,Staff,0,13,50,50
1683649863161,CSE 101,B01,185453,Jones; Miles E,0,13,50,50
1683649865213,CSE 141,A01,185458,Eldon; John,16,0,100,84
1683649866238,CSE 141L,A01,185461,Eldon; John,8,0,100,92
1683649867265,CSE 142,A01,185463,Staff,35,0,60,25
1683649867265,CSE 142,B01,201355,Staff,0,7,60,60
1683649868293,CSE 142L,A01,185470,Staff,35,0,60,25
1683649868293,CSE 142L,B01,201417,Staff,0,6,60,60
1683649869318,CSE 190,A00,201433,Staff,32,0,49,17
1683649870345,DOC 1,A01,259136,Strom; Megan C.,7,0,15,8
1683649870345,DOC 1,A02,259137,Strom; Megan C.,14,0,15,1
1683649870345,DOC 1,A03,259138,Strom; Megan C.,14,0,15,1
1683649870345,DOC 1,A04,259139,Strom; Megan C.,14,0,15,1
1683649871368,DOC 100D,A00,259140,Pass; Natalye Joann,14,0,25,11
1683649872397,DSGN 1,A01,184749,Rill; Bryan,0,26,30,30
1683649873420,DSGN 100,A01,185168,Staff,0,2,25,25
1683649874444,ECE 5,A01,185626,Morris; Karcher William,0,11,0,0
1683649875472,ECE 101,A01,185628,Staff,14,0,70,56
1683649876501,ECE 107,A01,185635,Baghdadchi; Saharnaz,0,0,20,20
1683649876501,ECE 107,A02,185638,Baghdadchi; Saharnaz,3,0,20,17
1683649877524,ECE 148,A01,185647,Silberman; Jack,0,0,16,16
1683649878550,ECON 1,A01,185537,Crane; Meredith Helen,54,0,70,16
1683649879575,ECON 3,A01,185549,Crane; Meredith Helen,29,0,70,41
1683649880602,ECON 4,A01,203354,Anderson; John Charles,0,5,10,10
1683649881627,ECON 100A,A01,185574,Staff,0,5,40,40
1683649882655,ECON 100B,A01,185576,Staff,0,12,50,50
1683649883678,ECON 100C,A01,185589,Newhouse; Herbert S,30,0,70,40
1683649884710,ECON 105,A00,185608,Vespa; Emanuel Ignacio,19,0,35,16
1683649885734,ECON 109,A01,185610,Shishkin; Denis,9,0,35,26
1683649886759,ECON 110A,A01,185612,Staff,9,0,40,31
1683649887783,ECON 120A,A01,185615,Staff,20,0,40,20
1683649888807,ECON 120C,A01,185617,Sun; Yixiao,0,20,70,70
1683649889835,ECON 144,A00,203346,Squires; Dale E,2,0,35,33
1683649890862,ECON 171,A01,203349,Newhouse; Herbert S,0,1,35,35
1683649891887,ECON 173A,A01,185621,Toda; Alexis Akira,21,0,35,14
1683649892917,EDS 25,A01,202413,Staff,0,1,0,0
1683649892917,EDS 25,A02,202414,Staff,0,1,0,0
1683649892917,EDS 25,A03,202415,Staff,0,0,0,0
1683649892917,EDS 25,A04,202416,Staff,0,1,0,0
1683649892917,EDS 25,A05,202439,Staff,0,0,0,0
1683649892917,EDS 25,A06,202440,Staff,0,0,0,0
1683649892917,EDS 25,B01,202631,Staff,0,0,0,0
1683649892917,EDS 25,B02,202632,Staff,0,0,0,0
1683649892917,EDS 25,B03,202639,Staff,0,0,0,0
1683649892917,EDS 25,B04,202640,Staff,0,0,0,0
1683649892917,EDS 25,B05,202643,Staff,0,0,0,0
1683649892917,EDS 25,B06,202644,Staff,0,0,0,0
1683649893945,EDS 38,A01,202659,Black; Alison Michelle,24,0,25,1
1683649894971,EDS 115,A00,202652,Staff,18,0,30,12
1683649895999,EDS 125,A00,202649,Staff,13,0,30,17
1683649897029,EDS 126,A01,203332,Staff,30,0,30,0
1683649898055,EDS 139,A00,202838,Staff,16,0,25,9
1683649899083,EDS 146,A01,202655,Staff,14,0,25,11
1683649900119,ENG 15,A00,185667,Staff,0,1,0,0
1683649900119,ENG 15,B00,185672,Staff,0,0,0,0
1683649900119,ENG 15,C00,185675,Staff,0,0,0,0
1683649900119,ENG 15,D00,185682,Staff,0,0,0,0
1683649900119,ENG 15,E00,185684,Staff,0,0,0,0
1683649901147,ETHN 103,A00,185710,Staff,0,8,35,35
1683649902171,ETHN 103A,A00,199228,Man; Simeon S,0,0,9,9
1683649903195,ETHN 109,A00,185711,Staff,16,0,35,19
1683649904218,ETHN 142,A00,185726,Staff,0,4,30,30
1683649905245,ETHN 163J,A00,199229,Man; Simeon S,5,0,8,3
1683649906270,ETHN 168,A00,185727,Staff,7,0,10,3
1683649907296,ETHN 182,A00,185728,Staff,0,0,35,35
1683649908323,ETHN 183,A00,185737,Staff,9,0,18,9
1683649909349,GLBH 111,A01,209361,Burgos; Jose L.,0,0,0,0
1683649911399,HIEU 104,A00,185792,Staff,14,0,20,6
1683649912425,HIEU 115,A00,185800,Staff,0,0,20,20
1683649913451,HIEU 128,A00,185801,Staff,0,9,20,20
1683649914476,HIEU 147,A00,185802,Staff,15,0,20,5
1683649915501,HIEU 154,A00,185823,Staff,11,0,20,9
1683649916525,HILA 102,A00,185826,Staff,14,0,20,6
1683649917551,HILD 2C,A01,185778,Staff,0,13,20,20
1683649918579,HILD 7B,A01,185780,Kwak; Nancy,0,16,32,32
1683649918579,HILD 7B,A02,185781,Kwak; Nancy,0,18,32,32
1683649919606,HILD 30,A01,185791,Staff,12,0,20,8
1683649920630,HISC 119,A00,185830,Golan; Tal,0,9,20,20
1683649921657,HITO 156GS,A00,185831,Patterson; Patrick H.,0,0,0,23
1683649922686,HIUS 103,A00,185832,Man; Simeon S,0,4,20,20
1683649923710,HIUS 117,A00,185836,Kwak; Nancy,2,0,20,18
1683649924734,HIUS 125,A00,185840,Man; Simeon S,0,1,23,23
1683649925760,HIUS 149,A00,185845,Staff,1,0,20,19
1683649926788,HUM 3,A01,185882,Zavodny; Tatiana Sophia,0,7,50,50
1683649926788,HUM 3,B01,185899,Caldwell; Michael Alan,0,18,50,50
1683649927814,HUM 3GS,A00,185900,Patterson; Patrick H.,0,0,0,23
1683649928839,HUM 4,A01,185938,Zroka; Amy Liane,30,0,50,20
1683649928839,HUM 4,B01,185956,Watkins; Eric,0,4,50,50
1683649928839,HUM 4,B02,202209,Watkins; Eric,0,4,50,50
1683649928839,HUM 4,B03,202210,Watkins; Eric,0,4,50,50
1683649929867,HUM 5,A01,185958,West; Geoffrey Scott,2,0,50,48
1683649929867,HUM 5,A02,202215,West; Geoffrey Scott,0,0,50,50
1683649930892,INTL 190,A00,185959,Gagnon; Jeffrey C,0,0,0,9
1683649930892,INTL 190,B00,185960,Lettieri; Michael Joseph,0,0,0,2
1683649931918,JAPN 180,A00,254509,Staff,5,0,30,25
1683649932944,LATI 10,A01,202853,Kennemore; Amy Michelle,4,0,35,31
1683649932944,LATI 10,A02,202854,Kennemore; Amy Michelle,2,0,35,33
1683649932944,LATI 10,A03,270054,Kennemore; Amy Michelle,30,0,30,0
1683649933971,LATI 180,A00,202855,Kennemore; Amy Michelle,11,0,20,9
1683649934995,LAWS 101,A00,201767,Golan; Tal,0,7,40,40
1683649936022,LIFR 1C,A00,185961,Staff,6,0,20,14
1683649937046,LIFR 1CX,A00,185962,Staff,7,0,20,13
1683649938073,LIFR 1D,A00,185963,Staff,7,0,20,13
1683649939098,LIFR 1DX,A00,185964,Staff,7,0,20,13
1683649940123,LIGN 101,A01,186039,Staff,43,0,50,7
1683649941148,LIGN 165,A00,186040,Staff,15,0,50,35
1683649942172,LTCS 108,A00,186041,Staff,5,0,10,5
1683649943196,LTCS 119,A00,186042,Staff,15,0,20,5
1683649944223,LTCS 130,A00,186043,Wesling; Megan E.,15,0,25,10
1683649946277,LTEA 138,A00,186119,Staff,14,0,40,26
1683649947300,LTEN 124,A00,186148,Staff,5,0,25,20
1683649948323,LTEN 178,A00,186149,Staff,7,0,15,8
1683649949353,LTEN 181,A00,186150,Blanco; John D,34,0,40,6
1683649950383,LTWL 120,A00,186160,Staff,20,0,25,5
1683649951406,LTWL 165,A00,186161,Staff,22,0,25,3
1683649952434,LTWR 100,A00,186162,Staff,0,5,15,15
1683649953458,LTWR 102,A00,186163,Doller; Ben,5,0,15,10
1683649954482,MAE 8,A01,186412,Staff,0,0,0,0
1683649955506,MAE 30B,A00,186445,Bahadori; Mohammad Yousef,82,0,100,18
1683649956530,MAE 40,A00,186592,Bewley; Thomas R,10,0,50,40
1683649957557,MAE 101B,A00,186593,Bahadori; Mohammad Yousef,80,0,100,20
1683649958581,MAE 105,A00,186594,Bandaru; Prabhakar,10,0,50,40
1683649959605,MAE 107,A00,186599,Pham; Hieu Tan,0,7,120,120
1683649960632,MAE 148,A01,186660,Silberman; Jack,3,0,16,13
1683649961659,MATH 10A,A01,188095,Staff,0,5,35,35
1683649962687,MATH 10B,A01,188097,Bowers; Adam R.,0,11,30,30
1683649962687,MATH 10B,A02,188099,Bowers; Adam R.,0,11,30,30
1683649962687,MATH 10B,B01,188104,Bowers; Adam R.,0,10,30,30
1683649962687,MATH 10B,B02,188106,Bowers; Adam R.,1,9,30,29
1683649963788,MATH 10C,A01,188111,Staff,0,18,30,30
1683649963788,MATH 10C,A02,188127,Staff,0,19,30,30
1683649963788,MATH 10C,A03,188131,Staff,0,19,30,30
1683649963788,MATH 10C,B01,188218,Staff,17,0,30,13
1683649963788,MATH 10C,B02,188244,Staff,13,0,30,17
1683649963788,MATH 10C,B03,188277,Staff,14,0,30,16
1683649964817,MATH 18,A01,188344,Bach; Quang Tran,18,0,30,12
1683649964817,MATH 18,A02,188345,Bach; Quang Tran,11,0,30,19
1683649964817,MATH 18,B01,188353,Bach; Quang Tran,11,0,30,19
1683649964817,MATH 18,B02,188354,Bach; Quang Tran,19,0,30,11
1683649965845,MATH 20A,A01,188374,Staff,11,0,35,24
1683649966873,MATH 20B,A01,188382,Ohm; Ko Woon,7,0,30,23
1683649966873,MATH 20B,A02,188383,Ohm; Ko Woon,22,0,30,8
1683649966873,MATH 20B,B01,188385,Ohm; Ko Woon,7,0,30,23
1683649966873,MATH 20B,B02,188392,Ohm; Ko Woon,22,0,30,8
1683649967897,MATH 20C,A01,188394,Harel; Guershon,11,0,30,19
1683649967897,MATH 20C,A02,188395,Harel; Guershon,13,0,30,17
1683649967897,MATH 20C,B01,188404,Harel; Guershon,5,0,30,25
1683649967897,MATH 20C,B02,188405,Harel; Guershon,18,0,30,12
1683649968923,MATH 20D,A01,188414,Hammock; Frances H,0,1,30,30
1683649968923,MATH 20D,A02,188415,Hammock; Frances H,0,1,30,30
1683649968923,MATH 20D,B01,188447,Hammock; Frances H,0,1,30,30
1683649968923,MATH 20D,B02,188486,Hammock; Frances H,4,0,30,26
1683649969951,MATH 20E,A01,188649,Staff,21,0,30,9
1683649969951,MATH 20E,A02,188650,Staff,21,0,30,9
1683649969951,MATH 20E,A03,188673,Staff,0,0,30,30
1683649970975,MATH 102,A01,188675,Staff,0,36,35,35
1683649972000,MATH 103B,A01,188681,Staff,3,0,35,32
1683649972000,MATH 103B,B01,188692,Staff,5,0,35,30
1683649973027,MATH 109,A01,188695,Salehi Golsefidy; Alireza,24,0,35,11
1683649973027,MATH 109,A02,188696,Salehi Golsefidy; Alireza,25,0,35,10
1683649974050,MATH 120A,A01,188698,Eggers; John Dietrich,7,0,35,28
1683649975079,MATH 142B,A01,188736,Ioana; Adrian,0,1,30,30
1683649975079,MATH 142B,A02,188741,Ioana; Adrian,0,1,30,30
1683649975079,MATH 142B,A03,188743,Ioana; Adrian,0,1,30,30
1683649976106,MATH 168A,A01,188790,Staff,0,10,35,35
1683649977132,MATH 170A,A01,188803,Nie; Jiawang,0,2,35,35
1683649977132,MATH 170A,A02,188811,Nie; Jiawang,0,0,35,35
1683649977132,MATH 170A,A03,188814,Nie; Jiawang,0,0,35,35
1683649977132,MATH 170A,A04,188815,Nie; Jiawang,10,0,35,25
1683649978155,MATH 193B,A01,188817,Staff,0,0,35,35
1683649978155,MATH 193B,A02,188818,Staff,5,0,35,30
1683649979179,MGT 4,A01,202857,Anderson; John Charles,61,0,80,19
1683649980207,MGT 12,A00,202858,Lindenberger; Wade Douglas,40,0,90,50
1683649981257,MGT 18,A00,202859,Staff,74,0,90,16
1683649982283,MGT 18GS,A00,202860,McKay; Michael J,13,0,28,15
1683649983307,MGT 45,A00,202861,Pecore; Joseph P.,12,0,90,78
1683649984330,MGT 100,A00,202863,Yavorsky; Daniel Ryan,28,0,90,62
1683649985354,MGT 103,A00,202864,Ehrich; Kristine R,0,17,90,90
1683649986382,MGT 112,A00,202865,Ehrich; Kristine R,15,0,90,75
1683649987408,MGT 121A,A00,202868,Staff,0,20,0,0
1683649988433,MGT 131B,A00,202869,Anderson; John Charles,59,0,90,31
1683649989457,MGT 136,A00,202871,Lindenberger; Wade Douglas,83,0,90,7
1683649990485,MGT 164,A00,202873,Staff,0,66,90,91
1683649991511,MGT 164GS,A00,202874,McKay; Mary A,13,0,28,15
1683649992534,MGT 180,A00,202875,Staff,0,50,90,91
1683649993558,MMW 11R,A01,205019,Herbst; Matthew,2,0,30,28
1683649993558,MMW 11R,A02,205026,Herbst; Matthew,29,0,30,1
1683649994585,MMW 15,A01,193512,Chang; Edmond Yi-Teh,0,8,28,28
1683649994585,MMW 15,A02,193513,Chang; Edmond Yi-Teh,0,5,28,28
1683649994585,MMW 15,A03,193514,Chang; Edmond Yi-Teh,0,5,28,28
1683649994585,MMW 15,A04,193515,Chang; Edmond Yi-Teh,0,5,28,28
1683649994585,MMW 15,A05,193516,Chang; Edmond Yi-Teh,0,5,28,28
1683649994585,MMW 15,A06,193517,Chang; Edmond Yi-Teh,0,6,28,28
1683649994585,MMW 15,B01,193519,Chang; Edmond Yi-Teh,0,5,28,28
1683649994585,MMW 15,B02,193520,Chang; Edmond Yi-Teh,0,5,28,28
1683649994585,MMW 15,B03,193521,Chang; Edmond Yi-Teh,0,5,28,28
1683649994585,MMW 15,B04,193522,Chang; Edmond Yi-Teh,0,5,28,28
1683649994585,MMW 15,B05,193523,Chang; Edmond Yi-Teh,0,5,28,28
1683649994585,MMW 15,B06,193524,Chang; Edmond Yi-Teh,0,5,28,28
1683649995613,MMW 122,A01,193526,Rahimi; Babak,0,16,28,28
1683649995613,MMW 122,A02,193527,Rahimi; Babak,0,15,28,28
1683649995613,MMW 122,A03,193528,Rahimi; Babak,0,0,0,0
1683649995613,MMW 122,A04,193529,Rahimi; Babak,0,0,0,0
1683649996640,MUS 1A,A01,186663,Staff,1,20,35,34
1683649997665,MUS 4,A01,186715,Staff,0,12,35,35
1683649998690,MUS 5R,A01,186796,Dubnov; Shlomo,0,17,35,35
1683649999716,MUS 6,A01,186798,Staff,0,5,25,25
1683650000743,MUS 7,A01,186830,Staff,11,0,35,24
1683650001771,MUS 8,A01,186930,Staff,0,26,35,35
1683650002795,MUS 15,A01,186932,Staff,0,16,35,35
1683650002795,MUS 15,B01,186934,Staff,0,17,35,35
1683650003818,MUS 80,A00,186935,Staff,0,0,20,20
1683650003818,MUS 80,B00,186936,Staff,24,0,25,1
1683650004841,NANO 11,A00,204702,Lipomi; Darren John,0,0,0,0
1683650005864,NANO 15,A01,204709,Yang; Kesong,0,1,0,0
1683650006892,NANO 114,A00,202069,Jahed Motlagh; Zeinab,3,0,10,7
1683650007918,PHIL 1,A00,186955,Grush; Rick Scott,31,0,40,9
1683650008941,PHIL 10,A01,186973,Grush; Rick Scott,27,0,35,8
1683650008941,PHIL 10,A02,186974,Grush; Rick Scott,33,0,35,2
1683650009965,PHIL 13,A01,186976,Staff,3,0,35,32
1683650009965,PHIL 13,A02,186977,Staff,16,0,35,19
1683650010991,PHIL 14,A01,186979,Staff,31,0,35,4
1683650010991,PHIL 14,A02,186986,Staff,32,0,35,3
1683650012019,PHIL 28,A01,186988,Staff,16,0,30,14
1683650012019,PHIL 28,A02,186989,Staff,1,0,30,29
1683650012019,PHIL 28,A03,186990,Staff,10,0,30,20
1683650012019,PHIL 28,A04,186991,Staff,26,0,30,4
1683650013044,PHIL 120,A00,186997,Staff,23,0,40,17
1683650014071,PHIL 137,A00,187003,Staff,7,0,40,33
1683650015094,PHIL 150,A00,187015,Staff,47,0,70,23
1683650016125,PHIL 167,A00,187021,Lamey; Andy M.,34,0,40,6
1683650017153,PHIL 174,A01,202226,Staff,17,0,20,3
1683650017153,PHIL 174,A02,202235,Staff,20,0,20,0
1683650018180,PHIL 191A,A00,258918,Staff,0,0,1,1
1683650019205,PHYS 1A,A00,187028,Staff,26,0,60,34
1683650020229,PHYS 1AL,001,187036,Staff,3,0,30,27
1683650020229,PHYS 1AL,002,187049,Staff,18,0,30,12
1683650021253,PHYS 1B,A00,187058,Staff,22,0,60,38
1683650022276,PHYS 1BL,001,187064,Staff,0,1,30,30
1683650022276,PHYS 1BL,002,187070,Staff,4,0,30,26
1683650023309,PHYS 1C,A00,187082,Staff,29,0,120,91
1683650024334,PHYS 1CL,001,187088,Staff,0,9,30,30
1683650024334,PHYS 1CL,002,187089,Staff,0,1,30,30
1683650024334,PHYS 1CL,009,262693,Staff,9,0,30,21
1683650025358,PHYS 2B,A01,187097,Staff,55,0,115,60
1683650026386,PHYS 2C,A01,187099,Staff,64,0,115,51
1683650027410,PHYS 2CL,A01,187101,Staff,5,0,28,23
1683650027410,PHYS 2CL,A02,187102,Staff,15,0,28,13
1683650028437,PHYS 2D,A01,187123,Shotwell; Brian,95,0,115,20
1683650029461,PHYS 4B,A01,187133,Grinstein; Benjamin,35,0,50,15
1683650030485,POLI 10,A00,188819,Staff,0,4,50,50
1683650031512,POLI 11,A00,188827,Staff,43,0,50,7
1683650032539,POLI 13R,A00,188828,Staff,0,1,20,20
1683650033567,POLI 27,A01,188830,Elgin; Samuel Zincke,0,2,70,70
1683650034592,POLI 30,A00,188832,Desposato; Scott,30,0,50,20
1683650035618,POLI 102F,A00,188834,Staff,0,0,40,40
1683650036644,POLI 104A,A00,188852,Staff,13,0,30,17
1683650037671,POLI 104I,A00,188853,Staff,0,7,20,20
1683650038694,POLI 110B,A00,188854,Wiens; David,7,0,20,13
1683650039720,POLI 112A,A00,188855,Wiens; David,4,0,30,26
1683650040747,POLI 117R,A00,188856,Forman; Fonna,0,12,20,20
1683650041775,POLI 118,A00,188857,Ingham; Sean,8,0,20,12
1683650042800,POLI 120G,A00,188858,Staff,8,0,30,22
1683650043828,POLI 131CR,A00,188863,Hoston; Germaine,21,0,50,29
1683650044856,POLI 133,A00,188864,Nellis; Gareth Hb,44,0,50,6
1683650045881,POLI 134D,A00,188865,Desposato; Scott,27,0,30,3
1683650046907,POLI 142A,A00,188871,Gartzke; Erik,21,0,50,29
1683650047931,POLI 142K,A00,188874,Staff,38,0,50,12
1683650048954,POLI 143,A00,188940,Gartzke; Erik,16,0,30,14
1683650049978,POLI 153,A00,188943,Staff,2,0,20,18
1683650051002,POLI 160AA,A00,188944,Staff,11,0,40,29
1683650052027,POLI 170A,A00,188945,Staff,11,0,30,19
1683650054074,PSYC 1,A00,188952,Staff,36,0,90,54
1683650055102,PSYC 2,B00,188953,Staff,19,0,35,16
1683650056125,PSYC 6,A00,188970,Staff,47,0,60,13
1683650057153,PSYC 7,A00,188973,Staff,35,0,45,10
1683650058178,PSYC 60,A01,188980,Rickard; Timothy C.,42,0,60,18
1683650059201,PSYC 70,A01,189001,Steiner; Eric Tomas,23,0,45,22
1683650060234,PSYC 100,A00,189005,Lacefield; Katharine I,0,99,120,120
1683650061261,PSYC 102,A00,189008,Staff,8,0,30,22
1683650062285,PSYC 106,B00,189026,Gorman; Michael R.,27,0,60,33
1683650063309,PSYC 114,B01,189033,Winkielman; Piotr,0,31,30,30
1683650064333,PSYC 131,A00,189036,Anagnostaras; Stephan,0,43,60,60
1683650065358,PSYC 136,A00,189041,Lowe; Angela Beth,0,7,25,25
1683650066387,PSYC 137,A00,189057,Winkielman; Piotr,0,37,25,25
1683650067469,PSYC 144,A00,189107,Wixted; John T,0,10,50,50
1683650069517,PSYC 162,A00,189142,Staff,0,9,85,85
1683650070542,PSYC 172,A00,189144,Gorman; Michael R.,0,6,30,30
1683650072591,PSYC 179,A00,189146,Lacefield; Katharine I,0,86,120,120
1683650073618,PSYC 181,A00,189147,Anagnostaras; Stephan,0,44,90,90
1683650074646,PSYC 190R,A00,189148,Barner; David A.,0,23,80,80
1683650075673,PSYC 191,A00,189275,Rickard; Timothy C.,0,10,25,25
1683650076697,PSYC 193,A00,189276,Chapman; Eddie Nathaniel,0,1,0,4
1683650077721,PSYC 193L,A01,189281,Lowe; Angela Beth,10,0,20,10
1683650077721,PSYC 193L,B01,189285,Staff,28,0,35,7
1683650078748,RELI 149,A00,187137,Rahimi; Babak,7,0,40,33
1683650079774,SE 9,A01,187315,Staff,0,2,18,18
1683650080801,SE 101B,A00,187409,Staff,24,0,30,6
1683650081828,SE 110B,A00,187444,Staff,10,0,40,30
1683650082852,SE 130B,A00,187449,Staff,31,0,40,9
1683650083880,SE 150A,A00,187516,Staff,9,0,20,11
1683650084903,SE 154,A00,187528,Staff,29,0,50,21
1683650085931,SIO 3,A01,258171,Staff,35,0,40,5
1683650086955,SIO 10,A00,187144,Cook; Geoffrey W,0,6,75,75
1683650087979,SIO 45,A00,187152,Cook; Geoffrey W,0,4,100,100
1683650089002,SIO 109R,A00,194486,Staff,0,4,20,20
1683650091059,SIO 187,A01,187233,Kacev; David,12,0,40,28
1683650092083,SOCI 1,A01,258656,Thorpe; Charles Robert,28,0,30,2
1683650092083,SOCI 1,A02,258658,Thorpe; Charles Robert,30,0,30,0
1683650092083,SOCI 1,A03,258661,Thorpe; Charles Robert,25,0,25,0
1683650092083,SOCI 1,A04,258666,Thorpe; Charles Robert,22,0,25,3
1683650092083,SOCI 1,A05,258897,Thorpe; Charles Robert,22,0,25,3
1683650092083,SOCI 1,A06,258898,Thorpe; Charles Robert,25,0,25,0
1683650093107,SOCI 30,A01,258903,Pardo Guerra; Juan Pablo,14,0,30,16
1683650094131,SOCI 102,A00,258904,Staff,9,0,25,16
1683650095157,SOCI 106,A00,258905,Staff,19,0,25,6
1683650096186,SOCI 111,A00,258907,Ribas Norris; Janet Vanesa,26,0,30,4
1683650097213,SOCI 121R,A00,258908,Pardo Guerra; Juan Pablo,8,0,30,22
1683650098236,SOCI 126,A01,203330,Staff,14,0,20,6
1683650099260,SOCI 131,A00,258909,Thorpe; Charles Robert,30,0,60,30
1683650100285,SOCI 135,A00,258910,Payne; Christine Anna,0,11,30,30
1683650101317,SOCI 157,A00,258911,Staff,12,0,30,18
1683650102345,SOCI 184,A00,258912,Staff,25,0,30,5
1683650103372,SOCI 188D,A00,258913,Staff,22,0,30,8
1683650104395,SYN 2,001,187529,Staff,9,0,16,7
1683650104395,SYN 2,002,201452,Staff,0,20,16,16
1683650104395,SYN 2,003,201469,Staff,2,0,16,14
1683650105420,SYN 100,A01,187531,Staff,0,9,20,20
1683650105420,SYN 100,B01,201491,Staff,0,10,20,20
1683650106445,TDAC 1,A00,189286,Walsh; Kim C.,3,0,20,17
1683650106445,TDAC 1,B00,189287,Harting; Carla Kelso,10,0,20,10
1683650107469,TDAC 101,A00,189300,Walsh; Kim C.,16,0,20,4
1683650107469,TDAC 101,B00,189301,Harting; Carla Kelso,18,0,20,2
1683650108494,TDAC 102,A00,189304,Basso; Beatrice,14,0,20,6
1683650109521,TDAC 108,A00,189305,Staff,18,0,20,2
1683650110547,TDDE 131,A00,189310,Staff,19,0,20,1
1683650110547,TDDE 131,B00,189314,Staff,19,0,20,1
1683650110547,TDDE 131,C00,189315,Staff,48,0,50,2
1683650110547,TDDE 131,D00,189316,Staff,14,0,15,1
1683650110547,TDDE 131,E00,204841,Staff,20,0,20,0
1683650111574,TDGE 10,A00,189289,Staff,27,0,50,23
1683650111574,TDGE 10,B00,189290,Havis; Allan,0,0,50,50
1683650112603,TDGE 11,A00,189291,Fulton; Julia,0,4,50,50
1683650112603,TDGE 11,B00,189292,Staff,20,0,25,5
1683650112603,TDGE 11,C00,260270,Staff,0,0,0,0
1683650113627,TDGE 25,A00,189294,Staff,2,0,20,18
1683650114652,TDGE 124,A00,189318,Fulton; Julia,0,8,50,50
1683650115675,TDGE 125,A00,189319,Staff,13,0,25,12
1683650115675,TDGE 125,B00,189320,Staff,23,0,25,2
1683650116699,TDGE 127,A00,189322,Havis; Allan,0,0,50,50
1683650117730,TDHT 101,A00,189323,Staff,18,0,25,7
1683650117730,TDHT 101,B00,189324,Staff,25,0,25,0
1683650118753,TDHT 102,A00,189325,Staff,49,0,50,1
1683650119777,TDMV 1,A00,189295,Arcidiacono; Kristin,20,0,30,10
1683650119777,TDMV 1,B00,189296,Caligagan; Maria T.,24,0,30,6
1683650120801,TDMV 2,A00,189297,Sammartano; Tonnie,27,0,30,3
1683650120801,TDMV 2,B00,189299,Arcidiacono; Kristin,23,0,30,7
1683650121827,TDMV 3,A00,204998,Rincon; Alicia,22,0,30,8
1683650122851,TDMV 120,A00,189458,Sammartano; Tonnie,28,0,30,2
1683650123876,TDMV 138,A00,189541,Jun; Grace Shin Hae,20,0,40,20
1683650124901,TDMV 142,A00,189717,Caligagan; Tony,25,0,30,5
1683650124901,TDMV 142,B00,189718,Caligagan; Maria T.,25,0,30,5
1683650125924,TMC 2,A01,187533,Staff,25,0,25,0
1683650125924,TMC 2,A02,187534,Staff,25,0,25,0
1683650126949,USP 1,A01,187536,Kwak; Nancy,0,16,25,25
1683650127974,USP 5,A01,187538,Staff,9,0,25,16
1683650128998,USP 101,A00,199253,Staff,0,4,0,0
1683650130028,USP 124,A00,187562,Boomhower; Matthew Charles,0,0,30,30
1683650131056,USP 138,A00,187582,Staff,20,0,25,5
1683650132079,USP 152,A01,187597,Staff,3,0,25,22
1683650133105,USP 153,A00,187598,Staff,19,0,25,6
1683650134128,USP 168,A00,187607,Kwak; Nancy,2,0,5,3
1683650135152,USP 173,A00,187619,Staff,4,0,25,21
1683650136177,USP 181,A00,187638,Staff,0,4,25,25
1683650137201,VIS 103,A00,187650,Cruz; Edwin Teddy,18,0,75,57
1683650138228,VIS 110D,A00,187669,Staff,13,0,22,9
1683650139257,VIS 127C,A00,187720,Shen; Kuiyi,67,0,146,79
1683650140285,VIS 149,A00,187731,Yoldas; Pinar,0,14,22,22
1683650141308,VIS 151,A01,188091,Staff,22,0,34,12
1683650141308,VIS 151,A02,188092,Staff,11,0,34,23
1683650142335,VIS 160B,A00,188093,Stalbaum; Brett,0,1,10,10
1683650144389,WCWP 10B,A00,201720,Staff,10,0,15,5
1683650144389,WCWP 10B,B00,201722,Staff,9,0,15,6
1683650145412,WCWP 100,A00,201725,Gagnon; Jeffrey C,0,0,2,2
1683650145412,WCWP 100,B00,201727,Staff,0,4,15,15
1683650148558,ANBI 133,A00,258401,Wilder; Linnea Lorene,34,0,40,6
1683650149582,ANBI 140,A00,258395,Hrvoj Mihic; Branka,18,0,25,7
1683650150610,ANSC 120,A00,258402,Bialecki; Jon Anthony,26,0,40,14
1683650151634,ANSC 144,A00,258400,Staff,12,0,40,28
1683650153684,ANSC 166,A00,258396,Parish; Steven Martin,156,0,175,19
1683650154711,ANSC 180,A00,193533,Staff,8,0,20,12
1683650155738,ANSC 188,A00,258397,Jassal; Aftab,34,0,40,6
1683650156763,ANTH 3,A01,258316,Staff,23,0,30,7
1683650157786,ANTH 5,A00,258394,Semendeferi; Ekaterini,16,0,20,4
1683650158813,ANTH 21,A01,258331,Staff,4,0,40,36
1683650159840,ANTH 103,A00,258398,Varma; Saiba,15,0,25,10
1683650160867,AWP 10,001,202034,Staff,0,0,0,0
1683650160867,AWP 10,002,202035,Staff,0,0,0,0
1683650160867,AWP 10,003,202036,Staff,0,0,0,0
1683650160867,AWP 10,004,202037,Staff,0,0,0,0
1683650160867,AWP 10,005,202038,Staff,0,0,0,0
1683650160867,AWP 10,006,202039,Staff,0,0,0,0
1683650160867,AWP 10,007,202040,Staff,0,0,0,0
1683650160867,AWP 10,008,202041,Staff,0,0,0,0
1683650160867,AWP 10,009,202042,Staff,0,0,0,0
1683650160867,AWP 10,010,202043,Staff,0,0,0,0
1683650160867,AWP 10,011,202044,Staff,0,0,0,0
1683650160867,AWP 10,012,202045,Staff,0,0,0,0
1683650160867,AWP 10,013,202046,Staff,0,0,0,0
1683650160867,AWP 10,014,202047,Staff,0,0,0,0
1683650160867,AWP 10,015,202048,Staff,0,0,0,0
1683650160867,AWP 10,016,202049,Staff,0,0,0,0
1683650160867,AWP 10,017,202050,Staff,0,0,0,0
1683650160867,AWP 10,018,202051,Staff,0,0,0,0
1683650160867,AWP 10,019,202052,Staff,0,0,0,0
1683650160867,AWP 10,020,202053,Staff,0,0,0,0
1683650160867,AWP 10,021,202054,Staff,0,0,0,0
1683650160867,AWP 10,022,202055,Staff,0,0,0,0
1683650160867,AWP 10,023,202056,Staff,0,0,0,0
1683650160867,AWP 10,024,202057,Staff,0,0,0,0
1683650160867,AWP 10,025,202058,Staff,0,0,0,0
1683650160867,AWP 10,026,202059,Staff,0,0,0,0
1683650161894,AWP 102,001,202032,Staff,0,0,0,0
1683650161894,AWP 102,002,202033,Staff,0,0,0,0
1683650162921,BENG 100,A01,254234,Taylor Amos; Alyssa C,31,0,40,9
1683650163952,BENG 196,001,270013,Engler; Adam J.,9999,0,9999,0
1683650164975,BICD 100R,A01,202018,Smith; Laurie,0,7,32,32
1683650164975,BICD 100R,A02,202019,Smith; Laurie,0,3,32,32
1683650164975,BICD 100R,A03,202020,Smith; Laurie,0,1,32,32
1683650164975,BICD 100R,A04,202021,Smith; Laurie,6,0,32,26
1683650164975,BICD 100R,A05,202022,Smith; Laurie,11,0,32,21
1683650166004,BICD 136,A01,193242,Gustafson-Brown; Cindy,0,2,32,32
1683650166004,BICD 136,A02,193244,Gustafson-Brown; Cindy,13,0,32,19
1683650167035,BIEB 102,A01,193249,Butler; Shannon Rhey,0,2,32,32
1683650167035,BIEB 102,A02,193251,Butler; Shannon Rhey,0,0,32,32
1683650167035,BIEB 102,A03,193253,Butler; Shannon Rhey,0,0,32,32
1683650167035,BIEB 102,A04,193255,Butler; Shannon Rhey,14,0,32,18
1683650167035,BIEB 102,A05,193265,Butler; Shannon Rhey,26,0,32,6
1683650167035,BIEB 102,A06,193269,Butler; Shannon Rhey,14,0,32,18
1683650169084,BIEB 150,A01,193274,Staff,0,0,32,32
1683650169084,BIEB 150,A02,193285,Staff,24,0,32,8
1683650170110,BIEB 194,A00,193286,Kurle; Carolyn M.,20,0,32,12
1683650171209,BILD 1,A01,192291,Staff,15,0,32,17
1683650171209,BILD 1,A02,192292,Staff,30,0,32,2
1683650171209,BILD 1,B01,192520,Reuther; Keefe,0,1,0,0
1683650171209,BILD 1,B02,192532,Reuther; Keefe,0,1,0,0
1683650172235,BILD 3,A01,192556,Butler; Shannon Rhey,0,0,32,32
1683650172235,BILD 3,A02,192581,Butler; Shannon Rhey,1,0,32,31
1683650172235,BILD 3,A03,192611,Butler; Shannon Rhey,21,0,32,11
1683650172235,BILD 3,A04,192612,Butler; Shannon Rhey,24,0,32,8
1683650172235,BILD 3,A05,192613,Butler; Shannon Rhey,26,0,32,6
1683650172235,BILD 3,A06,192679,Butler; Shannon Rhey,27,0,32,5
1683650172235,BILD 3,A07,192682,Butler; Shannon Rhey,20,0,32,12
1683650173261,BILD 4,A01,192836,Reuther; Keefe,1,0,24,23
1683650173261,BILD 4,A02,193044,Reuther; Keefe,4,0,24,20
1683650174286,BILD 10,A01,193142,Gustafson-Brown; Cindy,29,0,32,3
1683650174286,BILD 10,A02,193149,Gustafson-Brown; Cindy,31,0,32,1
1683650175309,BIMM 100,A01,193301,Staff,0,6,32,32
1683650175309,BIMM 100,A02,193312,Staff,0,7,32,32
1683650175309,BIMM 100,A03,193323,Staff,0,9,32,32
1683650176334,BIMM 101,A01,193329,McDonnell; Lisa Marie,0,4,24,24
1683650176334,BIMM 101,A02,193339,McDonnell; Lisa Marie,0,3,24,24
1683650176334,BIMM 101,B01,193354,McDonnell; Lisa Marie,0,4,24,24
1683650176334,BIMM 101,B02,193357,McDonnell; Lisa Marie,0,3,24,24
1683650177363,BIMM 110,A01,193377,Tat; John,0,11,32,32
1683650177363,BIMM 110,A02,193378,Tat; John,0,10,32,32
1683650178392,BIMM 120,A01,206116,Staff,0,0,32,32
1683650178392,BIMM 120,A02,206117,Staff,6,0,32,26
1683650178392,BIMM 120,A03,206121,Staff,21,0,32,11
1683650179417,BIPN 100,A01,193393,Park; Ji Young,0,14,32,32
1683650179417,BIPN 100,A02,193402,Park; Ji Young,0,14,32,32
1683650179417,BIPN 100,A03,193413,Park; Ji Young,0,14,32,32
1683650179417,BIPN 100,A04,193414,Park; Ji Young,0,13,32,32
1683650180442,BIPN 102,A01,193429,Staff,0,0,32,32
1683650180442,BIPN 102,A02,193438,Staff,18,0,32,14
1683650181465,BIPN 106,A01,193450,Reyes Gonzalez; Catalina,0,2,40,40
1683650182489,BIPN 134,A01,193465,Cooke; James Edward,0,0,32,32
1683650182489,BIPN 134,A02,193474,Cooke; James Edward,25,0,32,7
1683650182489,BIPN 134,A03,193485,Cooke; James Edward,29,0,32,3
1683650182489,BIPN 134,A04,193486,Cooke; James Edward,20,0,32,12
1683650182489,BIPN 134,A05,193491,Cooke; James Edward,31,0,32,1
1683650182489,BIPN 134,A06,193501,Cooke; James Edward,30,0,32,2
1683650182489,BIPN 134,A07,193510,Cooke; James Edward,29,0,32,3
1683650184542,BISP 194,A00,222522,Staff,14,0,32,18
1683650185569,CAT 124,A01,202407,Staff,19,0,25,6
1683650186598,CAT 125,A00,202408,Marchisotto; Jennifer Anne,2,0,20,18
1683650187622,CAT 125R,A00,202409,Smith; Lauryn Alissa,0,11,20,20
1683650187622,CAT 125R,B00,202410,Morales; Celeste Georgianna,0,11,20,20
1683650187622,CAT 125R,C00,202411,Irwin; Matthew Joseph,0,12,20,20
1683650188647,CENG 15,A01,204712,Yang; Kesong,0,1,0,0
1683650189673,CENG 114,A00,202070,Jahed Motlagh; Zeinab,5,0,20,15
1683650190696,CGS 105,A00,185477,Wesling; Megan E.,24,0,40,16
1683650191722,CGS 106,A00,185494,Staff,11,0,22,11
1683650192745,CGS 108,A00,185495,Staff,14,0,20,6
1683650193769,CGS 114,A00,185496,Staff,13,0,18,5
1683650194795,CGS 119,A00,185501,Staff,15,0,20,5
1683650195821,CGS 120,A00,185511,Staff,12,0,20,8
1683650196847,CHEM 4,A01,184675,Bussey; Thomas J,97,0,100,3
1683650197869,CHEM 6A,A01,184677,Staff,33,0,60,27
1683650198892,CHEM 6B,A01,184679,Staff,63,0,100,37
1683650199921,CHEM 6C,A01,184681,Bussey; Thomas J,0,0,50,50
1683650199921,CHEM 6C,A02,184682,Bussey; Thomas J,32,0,50,18
1683650200945,CHEM 40A,A01,184684,Albizati; Kim F.,34,0,100,66
1683650201969,CHEM 40B,A01,184686,Albizati; Kim F.,0,22,100,100
1683650202997,CHEM 41B,A01,184690,Staff,51,0,100,49
1683650204026,COGS 3,A01,184715,Boyle; Mary E. T.,0,27,40,40
1683650205050,COGS 14B,A01,185172,Staff,0,14,38,38
1683650206076,COGS 18,A01,184736,Staff,14,0,80,66
1683650207100,COGS 100,A01,184932,Staff,0,7,73,73
1683650208124,COGS 101A,A01,184935,Staff,0,39,30,30
1683650209149,COGS 101B,A01,184944,Staff,0,2,30,30
1683650210177,COGS 101C,A01,184946,Staff,0,10,30,30
1683650211201,COGS 102A,A01,184951,Johnson; Christine M.,2,0,40,38
1683650212224,COGS 107B,A01,184953,Mooshagian; Eric Frederick,0,51,40,40
1683650213248,COGS 118B,A01,184959,Gupta; Anjum,0,49,40,40
1683650214271,COGS 153,A00,184961,Staff,0,16,30,30
1683650215295,COGS 177,A00,184962,Staff,0,21,30,30
1683650216318,COGS 187A,A01,184969,Boyle; Mary E. T.,0,19,40,40
1683650217342,COMM 10,A01,185174,Staff,0,5,25,25
1683650217342,COMM 10,A02,185189,Staff,0,2,25,25
1683650217342,COMM 10,A03,269821,Staff,0,1,0,0
1683650218367,COMM 100B,A01,185475,Staff,0,1,0,2
1683650218367,COMM 100B,A02,185476,Staff,12,0,25,13
1683650219393,COMM 100C,A01,185314,Staff,1,0,25,24
1683650219393,COMM 100C,A02,185327,Staff,18,0,25,7
1683650220421,COMM 110M,A00,185349,Staff,0,0,40,40
1683650221445,COMM 113T,A00,185352,Staff,25,0,40,15
1683650222470,COMM 114I,A00,185353,Staff,31,0,40,9
1683650223496,COMM 131,A00,185354,Staff,17,0,30,13
1683650224520,CSE 8A,A50,185358,Cao; Yingjun,0,46,10,10
1683650225548,CSE 8B,A01,185362,Staff,0,48,50,50
1683650226573,CSE 11,A01,185416,Cao; Yingjun,0,91,10,10
1683650227603,CSE 20,A01,185445,Briones; Jor-el Thomas Caparas,4,0,25,21
1683650228629,CSE 21,A01,185447,Staff,9,0,50,41
1683650229654,CSE 101,A01,185451,Staff,0,13,50,50
1683650229654,CSE 101,B01,185453,Jones; Miles E,0,13,50,50
1683650231707,CSE 141,A01,185458,Eldon; John,16,0,100,84
1683650232731,CSE 141L,A01,185461,Eldon; John,8,0,100,92
1683650233758,CSE 142,A01,185463,Staff,35,0,60,25
1683650233758,CSE 142,B01,201355,Staff,0,7,60,60
1683650234783,CSE 142L,A01,185470,Staff,35,0,60,25
1683650234783,CSE 142L,B01,201417,Staff,0,6,60,60
1683650235815,CSE 190,A00,201433,Staff,32,0,49,17
1683650236844,DOC 1,A01,259136,Strom; Megan C.,7,0,15,8
1683650236844,DOC 1,A02,259137,Strom; Megan C.,14,0,15,1
1683650236844,DOC 1,A03,259138,Strom; Megan C.,14,0,15,1
1683650236844,DOC 1,A04,259139,Strom; Megan C.,14,0,15,1
1683650237873,DOC 100D,A00,259140,Pass; Natalye Joann,14,0,25,11
1683650238901,DSGN 1,A01,184749,Rill; Bryan,0,26,30,30
1683650239925,DSGN 100,A01,185168,Staff,0,2,25,25
1683650240950,ECE 5,A01,185626,Morris; Karcher William,0,11,0,0
1683650241977,ECE 101,A01,185628,Staff,14,0,70,56
1683650243006,ECE 107,A01,185635,Baghdadchi; Saharnaz,0,0,20,20
1683650243006,ECE 107,A02,185638,Baghdadchi; Saharnaz,3,0,20,17
1683650244030,ECE 148,A01,185647,Silberman; Jack,0,0,16,16
1683650245057,ECON 1,A01,185537,Crane; Meredith Helen,54,0,70,16
1683650246083,ECON 3,A01,185549,Crane; Meredith Helen,29,0,70,41
1683650247111,ECON 4,A01,203354,Anderson; John Charles,0,5,10,10
1683650248137,ECON 100A,A01,185574,Staff,0,5,40,40
1683650249161,ECON 100B,A01,185576,Staff,0,12,50,50
1683650250190,ECON 100C,A01,185589,Newhouse; Herbert S,30,0,70,40
1683650251214,ECON 105,A00,185608,Vespa; Emanuel Ignacio,19,0,35,16
1683650252243,ECON 109,A01,185610,Shishkin; Denis,9,0,35,26
1683650253270,ECON 110A,A01,185612,Staff,9,0,40,31
1683650254294,ECON 120A,A01,185615,Staff,20,0,40,20
1683650255321,ECON 120C,A01,185617,Sun; Yixiao,0,20,70,70
1683650256349,ECON 144,A00,203346,Squires; Dale E,2,0,35,33
1683650257374,ECON 171,A01,203349,Newhouse; Herbert S,0,1,35,35
1683650258398,ECON 173A,A01,185621,Toda; Alexis Akira,21,0,35,14
1683650259423,EDS 25,A01,202413,Staff,0,1,0,0
1683650259423,EDS 25,A02,202414,Staff,0,1,0,0
1683650259423,EDS 25,A03,202415,Staff,0,0,0,0
1683650259423,EDS 25,A04,202416,Staff,0,1,0,0
1683650259423,EDS 25,A05,202439,Staff,0,0,0,0
1683650259423,EDS 25,A06,202440,Staff,0,0,0,0
1683650259423,EDS 25,B01,202631,Staff,0,0,0,0
1683650259423,EDS 25,B02,202632,Staff,0,0,0,0
1683650259423,EDS 25,B03,202639,Staff,0,0,0,0
1683650259423,EDS 25,B04,202640,Staff,0,0,0,0
1683650259423,EDS 25,B05,202643,Staff,0,0,0,0
1683650259423,EDS 25,B06,202644,Staff,0,0,0,0
1683650260447,EDS 38,A01,202659,Black; Alison Michelle,24,0,25,1
1683650261470,EDS 115,A00,202652,Staff,18,0,30,12
1683650262496,EDS 125,A00,202649,Staff,13,0,30,17
1683650263520,EDS 126,A01,203332,Staff,30,0,30,0
1683650264546,EDS 139,A00,202838,Staff,16,0,25,9
1683650265572,EDS 146,A01,202655,Staff,14,0,25,11
1683650266601,ENG 15,A00,185667,Staff,0,1,0,0
1683650266601,ENG 15,B00,185672,Staff,0,0,0,0
1683650266601,ENG 15,C00,185675,Staff,0,0,0,0
1683650266601,ENG 15,D00,185682,Staff,0,0,0,0
1683650266601,ENG 15,E00,185684,Staff,0,0,0,0
1683650267625,ETHN 103,A00,185710,Staff,0,8,35,35
1683650268648,ETHN 103A,A00,199228,Man; Simeon S,0,0,9,9
1683650269676,ETHN 109,A00,185711,Staff,16,0,35,19
1683650270699,ETHN 142,A00,185726,Staff,0,4,30,30
1683650271724,ETHN 163J,A00,199229,Man; Simeon S,5,0,8,3
1683650272751,ETHN 168,A00,185727,Staff,7,0,10,3
1683650273776,ETHN 182,A00,185728,Staff,0,0,35,35
1683650274866,ETHN 183,A00,185737,Staff,9,0,18,9
1683650275894,GLBH 111,A01,209361,Burgos; Jose L.,0,0,0,0
1683650277947,HIEU 104,A00,185792,Staff,14,0,20,6
1683650278977,HIEU 115,A00,185800,Staff,0,0,20,20
1683650280003,HIEU 128,A00,185801,Staff,0,9,20,20
1683650281029,HIEU 147,A00,185802,Staff,15,0,20,5
1683650282055,HIEU 154,A00,185823,Staff,11,0,20,9
1683650283079,HILA 102,A00,185826,Staff,14,0,20,6
1683650284103,HILD 2C,A01,185778,Staff,0,13,20,20
1683650285136,HILD 7B,A01,185780,Kwak; Nancy,0,16,32,32
1683650285136,HILD 7B,A02,185781,Kwak; Nancy,0,18,32,32
1683650286165,HILD 30,A01,185791,Staff,12,0,20,8
1683650287191,HISC 119,A00,185830,Golan; Tal,0,9,20,20
1683650288218,HITO 156GS,A00,185831,Patterson; Patrick H.,0,0,0,23
1683650289244,HIUS 103,A00,185832,Man; Simeon S,0,4,20,20
1683650290267,HIUS 117,A00,185836,Kwak; Nancy,2,0,20,18
1683650291291,HIUS 125,A00,185840,Man; Simeon S,0,1,23,23
1683650292317,HIUS 149,A00,185845,Staff,1,0,20,19
1683650293342,HUM 3,A01,185882,Zavodny; Tatiana Sophia,0,7,50,50
1683650293342,HUM 3,B01,185899,Caldwell; Michael Alan,0,18,50,50
1683650294369,HUM 3GS,A00,185900,Patterson; Patrick H.,0,0,0,23
1683650295396,HUM 4,A01,185938,Zroka; Amy Liane,30,0,50,20
1683650295396,HUM 4,B01,185956,Watkins; Eric,0,4,50,50
1683650295396,HUM 4,B02,202209,Watkins; Eric,0,4,50,50
1683650295396,HUM 4,B03,202210,Watkins; Eric,0,4,50,50
1683650296421,HUM 5,A01,185958,West; Geoffrey Scott,2,0,50,48
1683650296421,HUM 5,A02,202215,West; Geoffrey Scott,0,0,50,50
1683650297450,INTL 190,A00,185959,Gagnon; Jeffrey C,0,0,0,9
1683650297450,INTL 190,B00,185960,Lettieri; Michael Joseph,0,0,0,2
1683650298477,JAPN 180,A00,254509,Staff,5,0,30,25
1683650299502,LATI 10,A01,202853,Kennemore; Amy Michelle,4,0,35,31
1683650299502,LATI 10,A02,202854,Kennemore; Amy Michelle,2,0,35,33
1683650299502,LATI 10,A03,270054,Kennemore; Amy Michelle,30,0,30,0
1683650300527,LATI 180,A00,202855,Kennemore; Amy Michelle,11,0,20,9
1683650301551,LAWS 101,A00,201767,Golan; Tal,0,7,40,40
1683650302579,LIFR 1C,A00,185961,Staff,6,0,20,14
1683650303604,LIFR 1CX,A00,185962,Staff,7,0,20,13
1683650304628,LIFR 1D,A00,185963,Staff,7,0,20,13
1683650305652,LIFR 1DX,A00,185964,Staff,7,0,20,13
1683650306679,LIGN 101,A01,186039,Staff,43,0,50,7
1683650307703,LIGN 165,A00,186040,Staff,15,0,50,35
1683650308762,LTCS 108,A00,186041,Staff,5,0,10,5
1683650309787,LTCS 119,A00,186042,Staff,15,0,20,5
1683650310812,LTCS 130,A00,186043,Wesling; Megan E.,15,0,25,10
1683650312863,LTEA 138,A00,186119,Staff,14,0,40,26
1683650313887,LTEN 124,A00,186148,Staff,5,0,25,20
1683650314912,LTEN 178,A00,186149,Staff,7,0,15,8
1683650315936,LTEN 181,A00,186150,Blanco; John D,34,0,40,6
1683650316960,LTWL 120,A00,186160,Staff,20,0,25,5
1683650317987,LTWL 165,A00,186161,Staff,22,0,25,3
1683650319012,LTWR 100,A00,186162,Staff,0,5,15,15
1683650320039,LTWR 102,A00,186163,Doller; Ben,5,0,15,10
1683650321064,MAE 8,A01,186412,Staff,0,0,0,0
1683650322091,MAE 30B,A00,186445,Bahadori; Mohammad Yousef,82,0,100,18
1683650323117,MAE 40,A00,186592,Bewley; Thomas R,10,0,50,40
1683650324142,MAE 101B,A00,186593,Bahadori; Mohammad Yousef,80,0,100,20
1683650325168,MAE 105,A00,186594,Bandaru; Prabhakar,10,0,50,40
1683650326192,MAE 107,A00,186599,Pham; Hieu Tan,0,7,120,120
1683650327218,MAE 148,A01,186660,Silberman; Jack,3,0,16,13
1683650328244,MATH 10A,A01,188095,Staff,0,5,35,35
1683650329268,MATH 10B,A01,188097,Bowers; Adam R.,0,11,30,30
1683650329268,MATH 10B,A02,188099,Bowers; Adam R.,0,11,30,30
1683650329268,MATH 10B,B01,188104,Bowers; Adam R.,0,10,30,30
1683650329268,MATH 10B,B02,188106,Bowers; Adam R.,1,9,30,29
1683650330296,MATH 10C,A01,188111,Staff,0,18,30,30
1683650330296,MATH 10C,A02,188127,Staff,0,19,30,30
1683650330296,MATH 10C,A03,188131,Staff,0,19,30,30
1683650330296,MATH 10C,B01,188218,Staff,17,0,30,13
1683650330296,MATH 10C,B02,188244,Staff,13,0,30,17
1683650330296,MATH 10C,B03,188277,Staff,14,0,30,16
1683650331322,MATH 18,A01,188344,Bach; Quang Tran,18,0,30,12
1683650331322,MATH 18,A02,188345,Bach; Quang Tran,11,0,30,19
1683650331322,MATH 18,B01,188353,Bach; Quang Tran,11,0,30,19
1683650331322,MATH 18,B02,188354,Bach; Quang Tran,19,0,30,11
1683650332348,MATH 20A,A01,188374,Staff,11,0,35,24
1683650333375,MATH 20B,A01,188382,Ohm; Ko Woon,7,0,30,23
1683650333375,MATH 20B,A02,188383,Ohm; Ko Woon,22,0,30,8
1683650333375,MATH 20B,B01,188385,Ohm; Ko Woon,7,0,30,23
1683650333375,MATH 20B,B02,188392,Ohm; Ko Woon,22,0,30,8
1683650334404,MATH 20C,A01,188394,Harel; Guershon,11,0,30,19
1683650334404,MATH 20C,A02,188395,Harel; Guershon,13,0,30,17
1683650334404,MATH 20C,B01,188404,Harel; Guershon,5,0,30,25
1683650334404,MATH 20C,B02,188405,Harel; Guershon,18,0,30,12
1683650335427,MATH 20D,A01,188414,Hammock; Frances H,0,1,30,30
1683650335427,MATH 20D,A02,188415,Hammock; Frances H,0,1,30,30
1683650335427,MATH 20D,B01,188447,Hammock; Frances H,0,1,30,30
1683650335427,MATH 20D,B02,188486,Hammock; Frances H,4,0,30,26
1683650336454,MATH 20E,A01,188649,Staff,21,0,30,9
1683650336454,MATH 20E,A02,188650,Staff,21,0,30,9
1683650336454,MATH 20E,A03,188673,Staff,0,0,30,30
1683650337481,MATH 102,A01,188675,Staff,0,36,35,35
1683650338505,MATH 103B,A01,188681,Staff,3,0,35,32
1683650338505,MATH 103B,B01,188692,Staff,5,0,35,30
1683650339530,MATH 109,A01,188695,Salehi Golsefidy; Alireza,24,0,35,11
1683650339530,MATH 109,A02,188696,Salehi Golsefidy; Alireza,25,0,35,10
1683650340558,MATH 120A,A01,188698,Eggers; John Dietrich,7,0,35,28
1683650341593,MATH 142B,A01,188736,Ioana; Adrian,0,1,30,30
1683650341593,MATH 142B,A02,188741,Ioana; Adrian,0,1,30,30
1683650341593,MATH 142B,A03,188743,Ioana; Adrian,0,1,30,30
1683650342620,MATH 168A,A01,188790,Staff,0,10,35,35
1683650343645,MATH 170A,A01,188803,Nie; Jiawang,0,2,35,35
1683650343645,MATH 170A,A02,188811,Nie; Jiawang,0,0,35,35
1683650343645,MATH 170A,A03,188814,Nie; Jiawang,0,0,35,35
1683650343645,MATH 170A,A04,188815,Nie; Jiawang,10,0,35,25
1683650344673,MATH 193B,A01,188817,Staff,0,0,35,35
1683650344673,MATH 193B,A02,188818,Staff,5,0,35,30
1683650345702,MGT 4,A01,202857,Anderson; John Charles,61,0,80,19
1683650346729,MGT 12,A00,202858,Lindenberger; Wade Douglas,40,0,90,50
1683650347758,MGT 18,A00,202859,Staff,74,0,90,16
1683650348785,MGT 18GS,A00,202860,McKay; Michael J,13,0,28,15
1683650349816,MGT 45,A00,202861,Pecore; Joseph P.,12,0,90,78
1683650350842,MGT 100,A00,202863,Yavorsky; Daniel Ryan,28,0,90,62
1683650351865,MGT 103,A00,202864,Ehrich; Kristine R,0,17,90,90
1683650352891,MGT 112,A00,202865,Ehrich; Kristine R,15,0,90,75
1683650353919,MGT 121A,A00,202868,Staff,0,20,0,0
1683650354946,MGT 131B,A00,202869,Anderson; John Charles,59,0,90,31
1683650355971,MGT 136,A00,202871,Lindenberger; Wade Douglas,83,0,90,7
1683650356997,MGT 164,A00,202873,Staff,0,66,90,91
1683650358021,MGT 164GS,A00,202874,McKay; Mary A,13,0,28,15
1683650359045,MGT 180,A00,202875,Staff,0,50,90,91
1683650360069,MMW 11R,A01,205019,Herbst; Matthew,2,0,30,28
1683650360069,MMW 11R,A02,205026,Herbst; Matthew,29,0,30,1
1683650361100,MMW 15,A01,193512,Chang; Edmond Yi-Teh,0,8,28,28
1683650361100,MMW 15,A02,193513,Chang; Edmond Yi-Teh,0,5,28,28
1683650361100,MMW 15,A03,193514,Chang; Edmond Yi-Teh,0,5,28,28
1683650361100,MMW 15,A04,193515,Chang; Edmond Yi-Teh,0,5,28,28
1683650361100,MMW 15,A05,193516,Chang; Edmond Yi-Teh,0,5,28,28
1683650361100,MMW 15,A06,193517,Chang; Edmond Yi-Teh,0,6,28,28
1683650361100,MMW 15,B01,193519,Chang; Edmond Yi-Teh,0,5,28,28
1683650361100,MMW 15,B02,193520,Chang; Edmond Yi-Teh,0,5,28,28
1683650361100,MMW 15,B03,193521,Chang; Edmond Yi-Teh,0,5,28,28
1683650361100,MMW 15,B04,193522,Chang; Edmond Yi-Teh,0,5,28,28
1683650361100,MMW 15,B05,193523,Chang; Edmond Yi-Teh,0,5,28,28
1683650361100,MMW 15,B06,193524,Chang; Edmond Yi-Teh,0,5,28,28
1683650362123,MMW 122,A01,193526,Rahimi; Babak,0,16,28,28
1683650362123,MMW 122,A02,193527,Rahimi; Babak,0,15,28,28
1683650362123,MMW 122,A03,193528,Rahimi; Babak,0,0,0,0
1683650362123,MMW 122,A04,193529,Rahimi; Babak,0,0,0,0
1683650363150,MUS 1A,A01,186663,Staff,1,20,35,34
1683650364178,MUS 4,A01,186715,Staff,0,12,35,35
1683650365204,MUS 5R,A01,186796,Dubnov; Shlomo,0,17,35,35
1683650366228,MUS 6,A01,186798,Staff,0,5,25,25
1683650367255,MUS 7,A01,186830,Staff,11,0,35,24
1683650368278,MUS 8,A01,186930,Staff,0,26,35,35
1683650369302,MUS 15,A01,186932,Staff,0,16,35,35
1683650369302,MUS 15,B01,186934,Staff,0,17,35,35
1683650370331,MUS 80,A00,186935,Staff,0,0,20,20
1683650370331,MUS 80,B00,186936,Staff,24,0,25,1
1683650371355,NANO 11,A00,204702,Lipomi; Darren John,0,0,0,0
1683650372379,NANO 15,A01,204709,Yang; Kesong,0,1,0,0
1683650373407,NANO 114,A00,202069,Jahed Motlagh; Zeinab,3,0,10,7
1683650374431,PHIL 1,A00,186955,Grush; Rick Scott,31,0,40,9
1683650375456,PHIL 10,A01,186973,Grush; Rick Scott,27,0,35,8
1683650375456,PHIL 10,A02,186974,Grush; Rick Scott,33,0,35,2
1683650376480,PHIL 13,A01,186976,Staff,3,0,35,32
1683650376480,PHIL 13,A02,186977,Staff,16,0,35,19
1683650377507,PHIL 14,A01,186979,Staff,31,0,35,4
1683650377507,PHIL 14,A02,186986,Staff,32,0,35,3
1683650378586,PHIL 28,A01,186988,Staff,16,0,30,14
1683650378586,PHIL 28,A02,186989,Staff,1,0,30,29
1683650378586,PHIL 28,A03,186990,Staff,10,0,30,20
1683650378586,PHIL 28,A04,186991,Staff,26,0,30,4
1683650379614,PHIL 120,A00,186997,Staff,23,0,40,17
1683650380641,PHIL 137,A00,187003,Staff,7,0,40,33
1683650381664,PHIL 150,A00,187015,Staff,47,0,70,23
1683650382692,PHIL 167,A00,187021,Lamey; Andy M.,34,0,40,6
1683650383715,PHIL 174,A01,202226,Staff,17,0,20,3
1683650383715,PHIL 174,A02,202235,Staff,20,0,20,0
1683650384741,PHIL 191A,A00,258918,Staff,0,0,1,1
1683650385769,PHYS 1A,A00,187028,Staff,26,0,60,34
1683650386796,PHYS 1AL,001,187036,Staff,3,0,30,27
1683650386796,PHYS 1AL,002,187049,Staff,18,0,30,12
1683650387820,PHYS 1B,A00,187058,Staff,22,0,60,38
1683650388848,PHYS 1BL,001,187064,Staff,0,1,30,30
1683650388848,PHYS 1BL,002,187070,Staff,4,0,30,26
1683650389873,PHYS 1C,A00,187082,Staff,29,0,120,91
1683650390901,PHYS 1CL,001,187088,Staff,0,9,30,30
1683650390901,PHYS 1CL,002,187089,Staff,0,1,30,30
1683650390901,PHYS 1CL,009,262693,Staff,9,0,30,21
1683650391925,PHYS 2B,A01,187097,Staff,55,0,115,60
1683650392952,PHYS 2C,A01,187099,Staff,64,0,115,51
1683650393976,PHYS 2CL,A01,187101,Staff,5,0,28,23
1683650393976,PHYS 2CL,A02,187102,Staff,15,0,28,13
1683650395005,PHYS 2D,A01,187123,Shotwell; Brian,95,0,115,20
1683650396032,PHYS 4B,A01,187133,Grinstein; Benjamin,35,0,50,15
1683650397057,POLI 10,A00,188819,Staff,0,4,50,50
1683650398083,POLI 11,A00,188827,Staff,43,0,50,7
1683650399107,POLI 13R,A00,188828,Staff,0,1,20,20
1683650400133,POLI 27,A01,188830,Elgin; Samuel Zincke,0,2,70,70
1683650401155,POLI 30,A00,188832,Desposato; Scott,30,0,50,20
1683650402182,POLI 102F,A00,188834,Staff,0,0,40,40
1683650403205,POLI 104A,A00,188852,Staff,13,0,30,17
1683650404229,POLI 104I,A00,188853,Staff,0,7,20,20
1683650405257,POLI 110B,A00,188854,Wiens; David,7,0,20,13
1683650406281,POLI 112A,A00,188855,Wiens; David,4,0,30,26
1683650407305,POLI 117R,A00,188856,Forman; Fonna,0,12,20,20
1683650408329,POLI 118,A00,188857,Ingham; Sean,8,0,20,12
1683650409353,POLI 120G,A00,188858,Staff,8,0,30,22
1683650410379,POLI 131CR,A00,188863,Hoston; Germaine,21,0,50,29
1683650411402,POLI 133,A00,188864,Nellis; Gareth Hb,44,0,50,6
1683650412428,POLI 134D,A00,188865,Desposato; Scott,27,0,30,3
1683650413452,POLI 142A,A00,188871,Gartzke; Erik,21,0,50,29
1683650414476,POLI 142K,A00,188874,Staff,38,0,50,12
1683650415501,POLI 143,A00,188940,Gartzke; Erik,16,0,30,14
1683650416525,POLI 153,A00,188943,Staff,2,0,20,18
1683650417551,POLI 160AA,A00,188944,Staff,11,0,40,29
1683650418575,POLI 170A,A00,188945,Staff,11,0,30,19
1683650420625,PSYC 1,A00,188952,Staff,36,0,90,54
1683650421652,PSYC 2,B00,188953,Staff,19,0,35,16
1683650422676,PSYC 6,A00,188970,Staff,47,0,60,13
1683650423700,PSYC 7,A00,188973,Staff,35,0,45,10
1683650424723,PSYC 60,A01,188980,Rickard; Timothy C.,42,0,60,18
1683650425759,PSYC 70,A01,189001,Steiner; Eric Tomas,23,0,45,22
1683650426782,PSYC 100,A00,189005,Lacefield; Katharine I,0,99,120,120
1683650427809,PSYC 102,A00,189008,Staff,8,0,30,22
1683650428833,PSYC 106,B00,189026,Gorman; Michael R.,27,0,60,33
1683650429860,PSYC 114,B01,189033,Winkielman; Piotr,0,31,30,30
1683650430885,PSYC 131,A00,189036,Anagnostaras; Stephan,0,43,60,60
1683650431908,PSYC 136,A00,189041,Lowe; Angela Beth,0,7,25,25
1683650432930,PSYC 137,A00,189057,Winkielman; Piotr,0,37,25,25
1683650433954,PSYC 144,A00,189107,Wixted; John T,0,10,50,50
1683650436009,PSYC 162,A00,189142,Staff,0,9,85,85
1683650437036,PSYC 172,A00,189144,Gorman; Michael R.,0,6,30,30
1683650439091,PSYC 179,A00,189146,Lacefield; Katharine I,0,86,120,120
1683650440116,PSYC 181,A00,189147,Anagnostaras; Stephan,0,44,90,90
1683650441141,PSYC 190R,A00,189148,Barner; David A.,0,23,80,80
1683650442166,PSYC 191,A00,189275,Rickard; Timothy C.,0,10,25,25
1683650443190,PSYC 193,A00,189276,Chapman; Eddie Nathaniel,0,1,0,4
1683650444214,PSYC 193L,A01,189281,Lowe; Angela Beth,10,0,20,10
1683650444214,PSYC 193L,B01,189285,Staff,28,0,35,7
1683650451641,RELI 149,A00,187137,Rahimi; Babak,7,0,40,33
1683650452666,SE 9,A01,187315,Staff,0,2,18,18
1683650453691,SE 101B,A00,187409,Staff,24,0,30,6
1683650454717,SE 110B,A00,187444,Staff,10,0,40,30
1683650455746,SE 130B,A00,187449,Staff,31,0,40,9
1683650457198,SE 150A,A00,187516,Staff,9,0,20,11
1683650458226,SE 154,A00,187528,Staff,29,0,50,21
1683650459251,SIO 3,A01,258171,Staff,35,0,40,5
1683650460282,SIO 10,A00,187144,Cook; Geoffrey W,0,6,75,75
1683650461307,SIO 45,A00,187152,Cook; Geoffrey W,0,4,100,100
1683650462366,SIO 109R,A00,194486,Staff,0,4,20,20
1683650464422,SIO 187,A01,187233,Kacev; David,12,0,40,28
1683650471807,SOCI 1,A01,258656,Thorpe; Charles Robert,28,0,30,2
1683650471807,SOCI 1,A02,258658,Thorpe; Charles Robert,30,0,30,0
1683650471807,SOCI 1,A03,258661,Thorpe; Charles Robert,25,0,25,0
1683650471807,SOCI 1,A04,258666,Thorpe; Charles Robert,22,0,25,3
1683650471807,SOCI 1,A05,258897,Thorpe; Charles Robert,22,0,25,3
1683650471807,SOCI 1,A06,258898,Thorpe; Charles Robert,25,0,25,0
1683650472832,SOCI 30,A01,258903,Pardo Guerra; Juan Pablo,14,0,30,16
1683650481076,SOCI 102,A00,258904,Staff,9,0,25,16
1683650482101,SOCI 106,A00,258905,Staff,19,0,25,6
1683650489290,SOCI 111,A00,258907,Ribas Norris; Janet Vanesa,26,0,30,4
1683650490315,SOCI 121R,A00,258908,Pardo Guerra; Juan Pablo,8,0,30,22
1683650497190,SOCI 126,A01,203330,Staff,14,0,20,6
1683650504131,SOCI 131,A00,258909,Thorpe; Charles Robert,30,0,60,30
1683650510272,SOCI 135,A00,258910,Payne; Christine Anna,0,11,30,30
1683650516508,SOCI 157,A00,258911,Staff,12,0,30,18
1683650517539,SOCI 184,A00,258912,Staff,25,0,30,5
1683650524231,SOCI 188D,A00,258913,Staff,22,0,30,8
1683650525257,SYN 2,001,187529,Staff,9,0,16,7
1683650525257,SYN 2,002,201452,Staff,0,20,16,16
1683650525257,SYN 2,003,201469,Staff,2,0,16,14
1683650526284,SYN 100,A01,187531,Staff,0,9,20,20
1683650526284,SYN 100,B01,201491,Staff,0,10,20,20
1683650533411,TDAC 1,A00,189286,Walsh; Kim C.,3,0,20,17
1683650533411,TDAC 1,B00,189287,Harting; Carla Kelso,10,0,20,10
1683650534436,TDAC 101,A00,189300,Walsh; Kim C.,16,0,20,4
1683650534436,TDAC 101,B00,189301,Harting; Carla Kelso,18,0,20,2
1683650535460,TDAC 102,A00,189304,Basso; Beatrice,14,0,20,6
1683650542423,TDAC 108,A00,189305,Staff,18,0,20,2
1683650543447,TDDE 131,A00,189310,Staff,19,0,20,1
1683650543447,TDDE 131,B00,189314,Staff,19,0,20,1
1683650543447,TDDE 131,C00,189315,Staff,48,0,50,2
1683650543447,TDDE 131,D00,189316,Staff,14,0,15,1
1683650543447,TDDE 131,E00,204841,Staff,20,0,20,0
1683650549457,TDGE 10,A00,189289,Staff,27,0,50,23
1683650549457,TDGE 10,B00,189290,Havis; Allan,0,0,50,50
1683650550487,TDGE 11,A00,189291,Fulton; Julia,0,4,50,50
1683650550487,TDGE 11,B00,189292,Staff,20,0,25,5
1683650550487,TDGE 11,C00,260270,Staff,0,0,0,0
1683650551513,TDGE 25,A00,189294,Staff,2,0,20,18
1683650552539,TDGE 124,A00,189318,Fulton; Julia,0,8,50,50
1683650559474,TDGE 125,A00,189319,Staff,13,0,25,12
1683650559474,TDGE 125,B00,189320,Staff,23,0,25,2
1683650560499,TDGE 127,A00,189322,Havis; Allan,0,0,50,50
1683650567011,TDHT 101,A00,189323,Staff,18,0,25,7
1683650567011,TDHT 101,B00,189324,Staff,25,0,25,0
1683650568038,TDHT 102,A00,189325,Staff,49,0,50,1
1683650575571,TDMV 1,A00,189295,Arcidiacono; Kristin,20,0,30,10
1683650575571,TDMV 1,B00,189296,Caligagan; Maria T.,24,0,30,6
1683650581959,TDMV 2,A00,189297,Sammartano; Tonnie,27,0,30,3
1683650581959,TDMV 2,B00,189299,Arcidiacono; Kristin,23,0,30,7
1683650582984,TDMV 3,A00,204998,Rincon; Alicia,22,0,30,8
1683650588899,TDMV 120,A00,189458,Sammartano; Tonnie,28,0,30,2
1683650595794,TDMV 138,A00,189541,Jun; Grace Shin Hae,20,0,40,20
1683650601117,TDMV 142,A00,189717,Caligagan; Tony,25,0,30,5
1683650601117,TDMV 142,B00,189718,Caligagan; Maria T.,25,0,30,5
1683650606723,TMC 2,A01,187533,Staff,25,0,25,0
1683650606723,TMC 2,A02,187534,Staff,25,0,25,0
1683650612518,USP 1,A01,187536,Kwak; Nancy,0,16,25,25
1683650617477,USP 5,A01,187538,Staff,9,0,25,16
1683650623141,USP 101,A00,199253,Staff,0,4,0,0
1683650629329,USP 124,A00,187562,Boomhower; Matthew Charles,0,0,30,30
1683650635708,USP 138,A00,187582,Staff,20,0,25,5
1683650641373,USP 152,A01,187597,Staff,3,0,25,22
1683650648053,USP 153,A00,187598,Staff,19,0,25,6
1683650654806,USP 168,A00,187607,Kwak; Nancy,2,0,5,3
1683650659973,USP 173,A00,187619,Staff,4,0,25,21
1683650666432,USP 181,A00,187638,Staff,0,4,25,25
1683650671136,VIS 103,A00,187650,Cruz; Edwin Teddy,18,0,75,57
1683650677035,VIS 110D,A00,187669,Staff,13,0,22,9
1683650681999,VIS 127C,A00,187720,Shen; Kuiyi,67,0,146,79
1683650687374,VIS 149,A00,187731,Yoldas; Pinar,0,14,22,22
1683650692641,VIS 151,A01,188091,Staff,22,0,34,12
1683650692641,VIS 151,A02,188092,Staff,11,0,34,23
1683650698231,VIS 160B,A00,188093,Stalbaum; Brett,0,1,10,10
1683650707962,WCWP 10B,A00,201720,Staff,10,0,15,5
1683650707962,WCWP 10B,B00,201722,Staff,9,0,15,6
1683650713157,WCWP 100,A00,201725,Gagnon; Jeffrey C,0,0,2,2
1683650713157,WCWP 100,B00,201727,Staff,0,4,15,15
1683650728945,ANBI 133,A00,258401,Wilder; Linnea Lorene,34,0,40,6
1683650735608,ANBI 140,A00,258395,Hrvoj Mihic; Branka,18,0,25,7
1683650741005,ANSC 120,A00,258402,Bialecki; Jon Anthony,26,0,40,14
1683650747677,ANSC 144,A00,258400,Staff,12,0,40,28
1683650757647,ANSC 166,A00,258396,Parish; Steven Martin,156,0,175,19
1683650762047,ANSC 180,A00,193533,Staff,8,0,20,12
1683650767962,ANSC 188,A00,258397,Jassal; Aftab,34,0,40,6
1683650773439,ANTH 3,A01,258316,Staff,23,0,30,7
1683650778551,ANTH 5,A00,258394,Semendeferi; Ekaterini,16,0,20,4
1683650783671,ANTH 21,A01,258331,Staff,4,0,40,36
1683650787328,ANTH 103,A00,258398,Varma; Saiba,15,0,25,10
1683650791226,AWP 10,001,202034,Staff,0,0,0,0
1683650791226,AWP 10,002,202035,Staff,0,0,0,0
1683650791226,AWP 10,003,202036,Staff,0,0,0,0
1683650791226,AWP 10,004,202037,Staff,0,0,0,0
1683650791226,AWP 10,005,202038,Staff,0,0,0,0
1683650791226,AWP 10,006,202039,Staff,0,0,0,0
1683650791226,AWP 10,007,202040,Staff,0,0,0,0
1683650791226,AWP 10,008,202041,Staff,0,0,0,0
1683650791226,AWP 10,009,202042,Staff,0,0,0,0
1683650791226,AWP 10,010,202043,Staff,0,0,0,0
1683650791226,AWP 10,011,202044,Staff,0,0,0,0
1683650791226,AWP 10,012,202045,Staff,0,0,0,0
1683650791226,AWP 10,013,202046,Staff,0,0,0,0
1683650791226,AWP 10,014,202047,Staff,0,0,0,0
1683650791226,AWP 10,015,202048,Staff,0,0,0,0
1683650791226,AWP 10,016,202049,Staff,0,0,0,0
1683650791226,AWP 10,017,202050,Staff,0,0,0,0
1683650791226,AWP 10,018,202051,Staff,0,0,0,0
1683650791226,AWP 10,019,202052,Staff,0,0,0,0
1683650791226,AWP 10,020,202053,Staff,0,0,0,0
1683650791226,AWP 10,021,202054,Staff,0,0,0,0
1683650791226,AWP 10,022,202055,Staff,0,0,0,0
1683650791226,AWP 10,023,202056,Staff,0,0,0,0
1683650791226,AWP 10,024,202057,Staff,0,0,0,0
1683650791226,AWP 10,025,202058,Staff,0,0,0,0
1683650791226,AWP 10,026,202059,Staff,0,0,0,0
1683650795047,AWP 102,001,202032,Staff,0,0,0,0
1683650795047,AWP 102,002,202033,Staff,0,0,0,0
1683650800430,BENG 100,A01,254234,Taylor Amos; Alyssa C,31,0,40,9
1683650806874,BENG 196,001,270013,Engler; Adam J.,9999,0,9999,0
1683650813670,BICD 100R,A01,202018,Smith; Laurie,0,7,32,32
1683650813670,BICD 100R,A02,202019,Smith; Laurie,0,3,32,32
1683650813670,BICD 100R,A03,202020,Smith; Laurie,0,1,32,32
1683650813670,BICD 100R,A04,202021,Smith; Laurie,6,0,32,26
1683650813670,BICD 100R,A05,202022,Smith; Laurie,11,0,32,21
1683650819667,BICD 136,A01,193242,Gustafson-Brown; Cindy,0,2,32,32
1683650819667,BICD 136,A02,193244,Gustafson-Brown; Cindy,13,0,32,19
1683650825719,BIEB 102,A01,193249,Butler; Shannon Rhey,0,2,32,32
1683650825719,BIEB 102,A02,193251,Butler; Shannon Rhey,0,0,32,32
1683650825719,BIEB 102,A03,193253,Butler; Shannon Rhey,0,0,32,32
1683650825719,BIEB 102,A04,193255,Butler; Shannon Rhey,14,0,32,18
1683650825719,BIEB 102,A05,193265,Butler; Shannon Rhey,26,0,32,6
1683650825719,BIEB 102,A06,193269,Butler; Shannon Rhey,14,0,32,18
1683650838580,BIEB 150,A01,193274,Staff,0,0,32,32
1683650838580,BIEB 150,A02,193285,Staff,24,0,32,8
1683650844615,BIEB 194,A00,193286,Kurle; Carolyn M.,20,0,32,12
1683650850679,BILD 1,A01,192291,Staff,15,0,32,17
1683650850679,BILD 1,A02,192292,Staff,30,0,32,2
1683650850679,BILD 1,B01,192520,Reuther; Keefe,0,1,0,0
1683650850679,BILD 1,B02,192532,Reuther; Keefe,0,1,0,0
1683650857007,BILD 3,A01,192556,Butler; Shannon Rhey,0,0,32,32
1683650857007,BILD 3,A02,192581,Butler; Shannon Rhey,1,0,32,31
1683650857007,BILD 3,A03,192611,Butler; Shannon Rhey,21,0,32,11
1683650857007,BILD 3,A04,192612,Butler; Shannon Rhey,24,0,32,8
1683650857007,BILD 3,A05,192613,Butler; Shannon Rhey,26,0,32,6
1683650857007,BILD 3,A06,192679,Butler; Shannon Rhey,27,0,32,5
1683650857007,BILD 3,A07,192682,Butler; Shannon Rhey,20,0,32,12
1683650862683,BILD 4,A01,192836,Reuther; Keefe,1,0,24,23
1683650862683,BILD 4,A02,193044,Reuther; Keefe,4,0,24,20
1683650867604,BILD 10,A01,193142,Gustafson-Brown; Cindy,29,0,32,3
1683650867604,BILD 10,A02,193149,Gustafson-Brown; Cindy,31,0,32,1
1683650872690,BIMM 100,A01,193301,Staff,0,6,32,32
1683650872690,BIMM 100,A02,193312,Staff,0,7,32,32
1683650872690,BIMM 100,A03,193323,Staff,0,9,32,32
1683650878967,BIMM 101,A01,193329,McDonnell; Lisa Marie,0,4,24,24
1683650878967,BIMM 101,A02,193339,McDonnell; Lisa Marie,0,3,24,24
1683650878967,BIMM 101,B01,193354,McDonnell; Lisa Marie,0,4,24,24
1683650878967,BIMM 101,B02,193357,McDonnell; Lisa Marie,0,3,24,24
1683650884709,BIMM 110,A01,193377,Tat; John,0,11,32,32
1683650884709,BIMM 110,A02,193378,Tat; John,0,10,32,32
1683650891482,BIMM 120,A01,206116,Staff,0,0,32,32
1683650891482,BIMM 120,A02,206117,Staff,6,0,32,26
1683650891482,BIMM 120,A03,206121,Staff,21,0,32,11
1683650897103,BIPN 100,A01,193393,Park; Ji Young,0,14,32,32
1683650897103,BIPN 100,A02,193402,Park; Ji Young,0,14,32,32
1683650897103,BIPN 100,A03,193413,Park; Ji Young,0,14,32,32
1683650897103,BIPN 100,A04,193414,Park; Ji Young,0,13,32,32
1683650903290,BIPN 102,A01,193429,Staff,0,0,32,32
1683650903290,BIPN 102,A02,193438,Staff,18,0,32,14
1683650907778,BIPN 106,A01,193450,Reyes Gonzalez; Catalina,0,2,40,40
1683650911489,BIPN 134,A01,193465,Cooke; James Edward,0,0,32,32
1683650911489,BIPN 134,A02,193474,Cooke; James Edward,25,0,32,7
1683650911489,BIPN 134,A03,193485,Cooke; James Edward,29,0,32,3
1683650911489,BIPN 134,A04,193486,Cooke; James Edward,20,0,32,12
1683650911489,BIPN 134,A05,193491,Cooke; James Edward,31,0,32,1
1683650911489,BIPN 134,A06,193501,Cooke; James Edward,30,0,32,2
1683650911489,BIPN 134,A07,193510,Cooke; James Edward,29,0,32,3
1683650919675,BISP 194,A00,222522,Staff,14,0,32,18
1683650924259,CAT 124,A01,202407,Staff,19,0,25,6
1683650930270,CAT 125,A00,202408,Marchisotto; Jennifer Anne,2,0,20,18
1683650936499,CAT 125R,A00,202409,Smith; Lauryn Alissa,0,11,20,20
1683650936499,CAT 125R,B00,202410,Morales; Celeste Georgianna,0,11,20,20
1683650936499,CAT 125R,C00,202411,Irwin; Matthew Joseph,0,12,20,20
1683650941562,CENG 15,A01,204712,Yang; Kesong,0,1,0,0
1683650946843,CENG 114,A00,202070,Jahed Motlagh; Zeinab,5,0,20,15
1683650952244,CGS 105,A00,185477,Wesling; Megan E.,24,0,40,16
1683650958524,CGS 106,A00,185494,Staff,11,0,22,11
1683650962190,CGS 108,A00,185495,Staff,14,0,20,6
1683650968567,CGS 114,A00,185496,Staff,13,0,18,5
1683650974355,CGS 119,A00,185501,Staff,15,0,20,5
1683650978797,CGS 120,A00,185511,Staff,12,0,20,8
1683650983801,CHEM 4,A01,184675,Bussey; Thomas J,97,0,100,3
1683650988853,CHEM 6A,A01,184677,Staff,33,0,60,27
1683650994798,CHEM 6B,A01,184679,Staff,63,0,100,37
1683650999779,CHEM 6C,A01,184681,Bussey; Thomas J,0,0,50,50
1683650999779,CHEM 6C,A02,184682,Bussey; Thomas J,32,0,50,18
1683651005903,CHEM 40A,A01,184684,Albizati; Kim F.,34,0,100,66
1683651010491,CHEM 40B,A01,184686,Albizati; Kim F.,0,22,100,100
1683651015519,CHEM 41B,A01,184690,Staff,51,0,100,49
1683651020601,COGS 3,A01,184715,Boyle; Mary E. T.,0,27,40,40
1683651024362,COGS 14B,A01,185172,Staff,0,14,38,38
1683651030214,COGS 18,A01,184736,Staff,14,0,80,66
1683651034108,COGS 100,A01,184932,Staff,0,7,73,73
1683651037822,COGS 101A,A01,184935,Staff,0,39,30,30
1683651043767,COGS 101B,A01,184944,Staff,0,2,30,30
1683651048856,COGS 101C,A01,184946,Staff,0,10,30,30
1683651052602,COGS 102A,A01,184951,Johnson; Christine M.,2,0,40,38
1683651057738,COGS 107B,A01,184953,Mooshagian; Eric Frederick,0,51,40,40
1683651062888,COGS 118B,A01,184959,Gupta; Anjum,0,49,40,40
1683651068031,COGS 153,A00,184961,Staff,0,16,30,30
1683651073002,COGS 177,A00,184962,Staff,0,21,30,30
1683651077948,COGS 187A,A01,184969,Boyle; Mary E. T.,0,19,40,40
1683651082798,COMM 10,A01,185174,Staff,0,5,25,25
1683651082798,COMM 10,A02,185189,Staff,0,2,25,25
1683651082798,COMM 10,A03,269821,Staff,0,1,0,0
1683651087894,COMM 100B,A01,185475,Staff,0,1,0,2
1683651087894,COMM 100B,A02,185476,Staff,12,0,25,13
1683651091619,COMM 100C,A01,185314,Staff,1,0,25,24
1683651091619,COMM 100C,A02,185327,Staff,18,0,25,7
1683651095457,COMM 110M,A00,185349,Staff,0,0,40,40
1683651099875,COMM 113T,A00,185352,Staff,25,0,40,15
1683651105802,COMM 114I,A00,185353,Staff,31,0,40,9
1683651109487,COMM 131,A00,185354,Staff,17,0,30,13
1683651114218,CSE 8A,A50,185358,Cao; Yingjun,0,46,10,10
1683651119289,CSE 8B,A01,185362,Staff,0,48,50,50
1683651123030,CSE 11,A01,185416,Cao; Yingjun,0,91,10,10
1683651127867,CSE 20,A01,185445,Briones; Jor-el Thomas Caparas,4,0,25,21
1683651132691,CSE 21,A01,185447,Staff,9,0,50,41
1683651137876,CSE 101,A01,185451,Staff,0,13,50,50
1683651137876,CSE 101,B01,185453,Jones; Miles E,0,13,50,50
1683651146683,CSE 141,A01,185458,Eldon; John,16,0,100,84
1683651150579,CSE 141L,A01,185461,Eldon; John,8,0,100,92
1683651154497,CSE 142,A01,185463,Staff,35,0,60,25
1683651154497,CSE 142,B01,201355,Staff,0,7,60,60
1683651158252,CSE 142L,A01,185470,Staff,35,0,60,25
1683651158252,CSE 142L,B01,201417,Staff,0,6,60,60
1683651162029,CSE 190,A00,201433,Staff,32,0,49,17
1683651165793,DOC 1,A01,259136,Strom; Megan C.,7,0,15,8
1683651165793,DOC 1,A02,259137,Strom; Megan C.,14,0,15,1
1683651165793,DOC 1,A03,259138,Strom; Megan C.,14,0,15,1
1683651165793,DOC 1,A04,259139,Strom; Megan C.,14,0,15,1
1683651172180,DOC 100D,A00,259140,Pass; Natalye Joann,14,0,25,11
1683651175738,DSGN 1,A01,184749,Rill; Bryan,0,26,30,30
1683651179353,DSGN 100,A01,185168,Staff,0,2,25,25
1683651183229,ECE 5,A01,185626,Morris; Karcher William,0,11,0,0
1683651186928,ECE 101,A01,185628,Staff,14,0,70,56
1683651191536,ECE 107,A01,185635,Baghdadchi; Saharnaz,0,0,20,20
1683651191536,ECE 107,A02,185638,Baghdadchi; Saharnaz,3,0,20,17
1683651196281,ECE 148,A01,185647,Silberman; Jack,0,0,16,16
1683651200620,ECON 1,A01,185537,Crane; Meredith Helen,54,0,70,16
1683651204325,ECON 3,A01,185549,Crane; Meredith Helen,29,0,70,41
1683651208076,ECON 4,A01,203354,Anderson; John Charles,0,5,10,10
1683651213087,ECON 100A,A01,185574,Staff,0,5,40,40
1683651216857,ECON 100B,A01,185576,Staff,0,12,50,50
1683651220588,ECON 100C,A01,185589,Newhouse; Herbert S,30,0,70,40
1683651226799,ECON 105,A00,185608,Vespa; Emanuel Ignacio,19,0,35,16
1683651231655,ECON 109,A01,185610,Shishkin; Denis,9,0,35,26
1683651237873,ECON 110A,A01,185612,Staff,9,0,40,31
1683651242769,ECON 120A,A01,185615,Staff,20,0,40,20
1683651247368,ECON 120C,A01,185617,Sun; Yixiao,0,20,70,70
1683651252157,ECON 144,A00,203346,Squires; Dale E,2,0,35,33
1683651256571,ECON 171,A01,203349,Newhouse; Herbert S,0,1,35,35
1683651260173,ECON 173A,A01,185621,Toda; Alexis Akira,21,0,35,14
1683651265030,EDS 25,A01,202413,Staff,0,1,0,0
1683651265030,EDS 25,A02,202414,Staff,0,1,0,0
1683651265030,EDS 25,A03,202415,Staff,0,0,0,0
1683651265030,EDS 25,A04,202416,Staff,0,1,0,0
1683651265030,EDS 25,A05,202439,Staff,0,0,0,0
1683651265030,EDS 25,A06,202440,Staff,0,0,0,0
1683651265030,EDS 25,B01,202631,Staff,0,0,0,0
1683651265030,EDS 25,B02,202632,Staff,0,0,0,0
1683651265030,EDS 25,B03,202639,Staff,0,0,0,0
1683651265030,EDS 25,B04,202640,Staff,0,0,0,0
1683651265030,EDS 25,B05,202643,Staff,0,0,0,0
1683651265030,EDS 25,B06,202644,Staff,0,0,0,0
1683651270000,EDS 38,A01,202659,Black; Alison Michelle,24,0,25,1
1683651273686,EDS 115,A00,202652,Staff,18,0,30,12
1683651279805,EDS 125,A00,202649,Staff,13,0,30,17
1683651284728,EDS 126,A01,203332,Staff,30,0,30,0
1683651289339,EDS 139,A00,202838,Staff,16,0,25,9
1683651294502,EDS 146,A01,202655,Staff,14,0,25,11
1683651299998,ENG 15,A00,185667,Staff,0,1,0,0
1683651299998,ENG 15,B00,185672,Staff,0,0,0,0
1683651299998,ENG 15,C00,185675,Staff,0,0,0,0
1683651299998,ENG 15,D00,185682,Staff,0,0,0,0
1683651299998,ENG 15,E00,185684,Staff,0,0,0,0
1683651305047,ETHN 103,A00,185710,Staff,0,8,35,35
1683651310471,ETHN 103A,A00,199228,Man; Simeon S,0,0,9,9
1683651315562,ETHN 109,A00,185711,Staff,16,0,35,19
1683651320407,ETHN 142,A00,185726,Staff,0,4,30,30
1683651325241,ETHN 163J,A00,199229,Man; Simeon S,5,0,8,3
1683651330073,ETHN 168,A00,185727,Staff,7,0,10,3
1683651333912,ETHN 182,A00,185728,Staff,0,0,35,35
1683651337681,ETHN 183,A00,185737,Staff,9,0,18,9
1683651342952,GLBH 111,A01,209361,Burgos; Jose L.,0,0,0,0
1683651353030,HIEU 104,A00,185792,Staff,14,0,20,6
1683651358450,HIEU 115,A00,185800,Staff,0,0,20,20
1683651363434,HIEU 128,A00,185801,Staff,0,9,20,20
1683651368437,HIEU 147,A00,185802,Staff,15,0,20,5
1683651372592,HIEU 154,A00,185823,Staff,11,0,20,9
1683651376098,HILA 102,A00,185826,Staff,14,0,20,6
1683651380731,HILD 2C,A01,185778,Staff,0,13,20,20
1683651385378,HILD 7B,A01,185780,Kwak; Nancy,0,16,32,32
1683651385378,HILD 7B,A02,185781,Kwak; Nancy,0,18,32,32
1683651390294,HILD 30,A01,185791,Staff,12,0,20,8
1683651395083,HISC 119,A00,185830,Golan; Tal,0,9,20,20
1683651399794,HITO 156GS,A00,185831,Patterson; Patrick H.,0,0,0,23
1683651403220,HIUS 103,A00,185832,Man; Simeon S,0,4,20,20
1683651408050,HIUS 117,A00,185836,Kwak; Nancy,2,0,20,18
1683651411605,HIUS 125,A00,185840,Man; Simeon S,0,1,23,23
1683651415202,HIUS 149,A00,185845,Staff,1,0,20,19
1683651418789,HUM 3,A01,185882,Zavodny; Tatiana Sophia,0,7,50,50
1683651418789,HUM 3,B01,185899,Caldwell; Michael Alan,0,18,50,50
1683651422353,HUM 3GS,A00,185900,Patterson; Patrick H.,0,0,0,23
1683651425885,HUM 4,A01,185938,Zroka; Amy Liane,29,0,50,21
1683651425885,HUM 4,B01,185956,Watkins; Eric,0,4,50,50
1683651425885,HUM 4,B02,202209,Watkins; Eric,0,4,50,50
1683651425885,HUM 4,B03,202210,Watkins; Eric,0,4,50,50
1683651430570,HUM 5,A01,185958,West; Geoffrey Scott,2,0,50,48
1683651430570,HUM 5,A02,202215,West; Geoffrey Scott,0,0,50,50
1683651435252,INTL 190,A00,185959,Gagnon; Jeffrey C,0,0,0,9
1683651435252,INTL 190,B00,185960,Lettieri; Michael Joseph,0,0,0,2
1683651440075,JAPN 180,A00,254509,Staff,5,0,30,25
1683651445393,LATI 10,A01,202853,Kennemore; Amy Michelle,4,0,35,31
1683651445393,LATI 10,A02,202854,Kennemore; Amy Michelle,2,0,35,33
1683651445393,LATI 10,A03,270054,Kennemore; Amy Michelle,30,0,30,0
1683651450219,LATI 180,A00,202855,Kennemore; Amy Michelle,11,0,20,9
1683651455101,LAWS 101,A00,201767,Golan; Tal,0,7,40,40
1683651459471,LIFR 1C,A00,185961,Staff,6,0,20,14
1683651463177,LIFR 1CX,A00,185962,Staff,7,0,20,13
1683651467488,LIFR 1D,A00,185963,Staff,7,0,20,13
1683651471173,LIFR 1DX,A00,185964,Staff,7,0,20,13
1683651476134,LIGN 101,A01,186039,Staff,43,0,50,7
1683651481100,LIGN 165,A00,186040,Staff,15,0,50,35
1683651484610,LTCS 108,A00,186041,Staff,5,0,10,5
1683651488119,LTCS 119,A00,186042,Staff,15,0,20,5
1683651492461,LTCS 130,A00,186043,Wesling; Megan E.,15,0,25,10
1683651501060,LTEA 138,A00,186119,Staff,14,0,40,26
1683651505859,LTEN 124,A00,186148,Staff,5,0,25,20
1683651510640,LTEN 178,A00,186149,Staff,7,0,15,8
1683651515464,LTEN 181,A00,186150,Blanco; John D,34,0,40,6
1683651518932,LTWL 120,A00,186160,Staff,20,0,25,5
1683651523193,LTWL 165,A00,186161,Staff,22,0,25,3
1683651527585,LTWR 100,A00,186162,Staff,0,5,15,15
1683651532166,LTWR 102,A00,186163,Doller; Ben,5,0,15,10
1683651535627,MAE 8,A01,186412,Staff,0,0,0,0
1683651539185,MAE 30B,A00,186445,Bahadori; Mohammad Yousef,82,0,100,18
1683651542749,MAE 40,A00,186592,Bewley; Thomas R,10,0,50,40
1683651547213,MAE 101B,A00,186593,Bahadori; Mohammad Yousef,80,0,100,20
1683651550831,MAE 105,A00,186594,Bandaru; Prabhakar,10,0,50,40
1683651554577,MAE 107,A00,186599,Pham; Hieu Tan,0,7,120,120
1683651558231,MAE 148,A01,186660,Silberman; Jack,3,0,16,13
1683651562955,MATH 10A,A01,188095,Staff,0,6,35,35
1683651567376,MATH 10B,A01,188097,Bowers; Adam R.,0,12,30,30
1683651567376,MATH 10B,A02,188099,Bowers; Adam R.,0,11,30,30
1683651567376,MATH 10B,B01,188104,Bowers; Adam R.,0,10,30,30
1683651567376,MATH 10B,B02,188106,Bowers; Adam R.,1,9,30,29
1683651571935,MATH 10C,A01,188111,Staff,0,18,30,30
1683651571935,MATH 10C,A02,188127,Staff,0,19,30,30
1683651571935,MATH 10C,A03,188131,Staff,0,19,30,30
1683651571935,MATH 10C,B01,188218,Staff,17,0,30,13
1683651571935,MATH 10C,B02,188244,Staff,13,0,30,17
1683651571935,MATH 10C,B03,188277,Staff,14,0,30,16
1683651575554,MATH 18,A01,188344,Bach; Quang Tran,18,0,30,12
1683651575554,MATH 18,A02,188345,Bach; Quang Tran,11,0,30,19
1683651575554,MATH 18,B01,188353,Bach; Quang Tran,11,0,30,19
1683651575554,MATH 18,B02,188354,Bach; Quang Tran,19,0,30,11
1683651579828,MATH 20A,A01,188374,Staff,11,0,35,24
1683651585791,MATH 20B,A01,188382,Ohm; Ko Woon,7,0,30,23
1683651585791,MATH 20B,A02,188383,Ohm; Ko Woon,22,0,30,8
1683651585791,MATH 20B,B01,188385,Ohm; Ko Woon,7,0,30,23
1683651585791,MATH 20B,B02,188392,Ohm; Ko Woon,22,0,30,8
1683651590387,MATH 20C,A01,188394,Harel; Guershon,11,0,30,19
1683651590387,MATH 20C,A02,188395,Harel; Guershon,13,0,30,17
1683651590387,MATH 20C,B01,188404,Harel; Guershon,5,0,30,25
1683651590387,MATH 20C,B02,188405,Harel; Guershon,18,0,30,12
1683651594050,MATH 20D,A01,188414,Hammock; Frances H,0,1,30,30
1683651594050,MATH 20D,A02,188415,Hammock; Frances H,0,1,30,30
1683651594050,MATH 20D,B01,188447,Hammock; Frances H,0,1,30,30
1683651594050,MATH 20D,B02,188486,Hammock; Frances H,4,0,30,26
1683651598269,MATH 20E,A01,188649,Staff,21,0,30,9
1683651598269,MATH 20E,A02,188650,Staff,21,0,30,9
1683651598269,MATH 20E,A03,188673,Staff,0,0,30,30
1683651601961,MATH 102,A01,188675,Staff,0,36,35,35
1683651606401,MATH 103B,A01,188681,Staff,3,0,35,32
1683651606401,MATH 103B,B01,188692,Staff,5,0,35,30
1683651610047,MATH 109,A01,188695,Salehi Golsefidy; Alireza,24,0,35,11
1683651610047,MATH 109,A02,188696,Salehi Golsefidy; Alireza,25,0,35,10
1683651614939,MATH 120A,A01,188698,Eggers; John Dietrich,7,0,35,28
1683651620899,MATH 142B,A01,188736,Ioana; Adrian,0,1,30,30
1683651620899,MATH 142B,A02,188741,Ioana; Adrian,0,1,30,30
1683651620899,MATH 142B,A03,188743,Ioana; Adrian,0,1,30,30
1683651624460,MATH 168A,A01,188790,Staff,0,10,35,35
1683651628745,MATH 170A,A01,188803,Nie; Jiawang,0,2,35,35
1683651628745,MATH 170A,A02,188811,Nie; Jiawang,0,0,35,35
1683651628745,MATH 170A,A03,188814,Nie; Jiawang,0,0,35,35
1683651628745,MATH 170A,A04,188815,Nie; Jiawang,10,0,35,25
1683651633751,MATH 193B,A01,188817,Staff,0,0,35,35
1683651633751,MATH 193B,A02,188818,Staff,5,0,35,30
1683651638667,MGT 4,A01,202857,Anderson; John Charles,61,0,80,19
1683651644029,MGT 12,A00,202858,Lindenberger; Wade Douglas,40,0,90,50
1683651648737,MGT 18,A00,202859,Staff,74,0,90,16
1683651653329,MGT 18GS,A00,202860,McKay; Michael J,13,0,28,15
1683651657793,MGT 45,A00,202861,Pecore; Joseph P.,12,0,90,78
1683651661474,MGT 100,A00,202863,Yavorsky; Daniel Ryan,28,0,90,62
1683651665041,MGT 103,A00,202864,Ehrich; Kristine R,0,17,90,90
1683651669844,MGT 112,A00,202865,Ehrich; Kristine R,15,0,90,75
1683651674548,MGT 121A,A00,202868,Staff,0,20,0,0
1683651678156,MGT 131B,A00,202869,Anderson; John Charles,59,0,90,31
1683651682143,MGT 136,A00,202871,Lindenberger; Wade Douglas,83,0,90,7
1683651685708,MGT 164,A00,202873,Staff,0,66,90,91
1683651690955,MGT 164GS,A00,202874,McKay; Mary A,13,0,28,15
1683651696012,MGT 180,A00,202875,Staff,0,50,90,91
1683651700273,MMW 11R,A01,205019,Herbst; Matthew,2,0,30,28
1683651700273,MMW 11R,A02,205026,Herbst; Matthew,29,0,30,1
1683651704690,MMW 15,A01,193512,Chang; Edmond Yi-Teh,0,8,28,28
1683651704690,MMW 15,A02,193513,Chang; Edmond Yi-Teh,0,5,28,28
1683651704690,MMW 15,A03,193514,Chang; Edmond Yi-Teh,0,5,28,28
1683651704690,MMW 15,A04,193515,Chang; Edmond Yi-Teh,0,5,28,28
1683651704690,MMW 15,A05,193516,Chang; Edmond Yi-Teh,0,5,28,28
1683651704690,MMW 15,A06,193517,Chang; Edmond Yi-Teh,0,6,28,28
1683651704690,MMW 15,B01,193519,Chang; Edmond Yi-Teh,0,5,28,28
1683651704690,MMW 15,B02,193520,Chang; Edmond Yi-Teh,0,5,28,28
1683651704690,MMW 15,B03,193521,Chang; Edmond Yi-Teh,0,5,28,28
1683651704690,MMW 15,B04,193522,Chang; Edmond Yi-Teh,0,5,28,28
1683651704690,MMW 15,B05,193523,Chang; Edmond Yi-Teh,0,5,28,28
1683651704690,MMW 15,B06,193524,Chang; Edmond Yi-Teh,0,5,28,28
1683651708285,MMW 122,A01,193526,Rahimi; Babak,0,16,28,28
1683651708285,MMW 122,A02,193527,Rahimi; Babak,0,15,28,28
1683651708285,MMW 122,A03,193528,Rahimi; Babak,0,0,0,0
1683651708285,MMW 122,A04,193529,Rahimi; Babak,0,0,0,0
1683651713222,MUS 1A,A01,186663,Staff,1,20,35,34
1683651717688,MUS 4,A01,186715,Staff,0,12,35,35
1683651722603,MUS 5R,A01,186796,Dubnov; Shlomo,0,17,35,35
1683651728991,MUS 6,A01,186798,Staff,0,5,25,25
1683651733959,MUS 7,A01,186830,Staff,11,0,35,24
1683651738705,MUS 8,A01,186930,Staff,0,26,35,35
1683651743651,MUS 15,A01,186932,Staff,0,16,35,35
1683651743651,MUS 15,B01,186934,Staff,0,17,35,35
1683651748492,MUS 80,A00,186935,Staff,0,0,20,20
1683651748492,MUS 80,B00,186936,Staff,24,0,25,1
1683651753278,NANO 11,A00,204702,Lipomi; Darren John,0,0,0,0
1683651756861,NANO 15,A01,204709,Yang; Kesong,0,1,0,0
1683651761386,NANO 114,A00,202069,Jahed Motlagh; Zeinab,3,0,10,7
1683651765050,PHIL 1,A00,186955,Grush; Rick Scott,31,0,40,9
1683651769981,PHIL 10,A01,186973,Grush; Rick Scott,27,0,35,8
1683651769981,PHIL 10,A02,186974,Grush; Rick Scott,33,0,35,2
1683651774663,PHIL 13,A01,186976,Staff,3,0,35,32
1683651774663,PHIL 13,A02,186977,Staff,16,0,35,19
1683651779202,PHIL 14,A01,186979,Staff,31,0,35,4
1683651779202,PHIL 14,A02,186986,Staff,32,0,35,3
1683651783658,PHIL 28,A01,186988,Staff,16,0,30,14
1683651783658,PHIL 28,A02,186989,Staff,1,0,30,29
1683651783658,PHIL 28,A03,186990,Staff,10,0,30,20
1683651783658,PHIL 28,A04,186991,Staff,26,0,30,4
1683651788270,PHIL 120,A00,186997,Staff,23,0,40,17
1683651793669,PHIL 137,A00,187003,Staff,7,0,40,33
1683651798474,PHIL 150,A00,187015,Staff,47,0,70,23
1683651802062,PHIL 167,A00,187021,Lamey; Andy M.,34,0,40,6
1683651808216,PHIL 174,A01,202226,Staff,17,0,20,3
1683651808216,PHIL 174,A02,202235,Staff,20,0,20,0
1683651814172,PHIL 191A,A00,258918,Staff,0,0,1,1
1683651818482,PHYS 1A,A00,187028,Staff,26,0,60,34
1683651822753,PHYS 1AL,001,187036,Staff,3,0,30,27
1683651822753,PHYS 1AL,002,187049,Staff,18,0,30,12
1683651827749,PHYS 1B,A00,187058,Staff,22,0,60,38
1683651832733,PHYS 1BL,001,187064,Staff,0,1,30,30
1683651832733,PHYS 1BL,002,187070,Staff,4,0,30,26
1683651837523,PHYS 1C,A00,187082,Staff,29,0,120,91
1683651842247,PHYS 1CL,001,187088,Staff,0,9,30,30
1683651842247,PHYS 1CL,002,187089,Staff,0,1,30,30
1683651842247,PHYS 1CL,009,262693,Staff,9,0,30,21
1683651845947,PHYS 2B,A01,187097,Staff,55,0,115,60
1683651849528,PHYS 2C,A01,187099,Staff,64,0,115,51
1683651855347,PHYS 2CL,A01,187101,Staff,5,0,28,23
1683651855347,PHYS 2CL,A02,187102,Staff,15,0,28,13
1683651860109,PHYS 2D,A01,187123,Shotwell; Brian,95,0,115,20
1683651863753,PHYS 4B,A01,187133,Grinstein; Benjamin,35,0,50,15
1683651868270,POLI 10,A00,188819,Staff,0,4,50,50
1683651871823,POLI 11,A00,188827,Staff,43,0,50,7
1683651876853,POLI 13R,A00,188828,Staff,0,1,20,20
1683651880501,POLI 27,A01,188830,Elgin; Samuel Zincke,0,2,70,70
1683651885820,POLI 30,A00,188832,Desposato; Scott,30,0,50,20
1683651890928,POLI 102F,A00,188834,Staff,0,0,40,40
1683651896486,POLI 104A,A00,188852,Staff,13,0,30,17
1683651901632,POLI 104I,A00,188853,Staff,0,7,20,20
1683651906565,POLI 110B,A00,188854,Wiens; David,6,0,20,14
1683651911743,POLI 112A,A00,188855,Wiens; David,3,0,30,27
1683651916605,POLI 117R,A00,188856,Forman; Fonna,0,12,20,20
1683651920161,POLI 118,A00,188857,Ingham; Sean,8,0,20,12
1683651923716,POLI 120G,A00,188858,Staff,8,0,30,22
1683651927998,POLI 131CR,A00,188863,Hoston; Germaine,21,0,50,29
1683651931705,POLI 133,A00,188864,Nellis; Gareth Hb,44,0,50,6
1683651936909,POLI 134D,A00,188865,Desposato; Scott,27,0,30,3
1683651940417,POLI 142A,A00,188871,Gartzke; Erik,21,0,50,29
1683651943907,POLI 142K,A00,188874,Staff,38,0,50,12
1683651948634,POLI 143,A00,188940,Gartzke; Erik,16,0,30,14
1683651954688,POLI 153,A00,188943,Staff,2,0,20,18
1683651958130,POLI 160AA,A00,188944,Staff,11,0,40,29
1683651963202,POLI 170A,A00,188945,Staff,11,0,30,19
1683651972777,PSYC 1,A00,188952,Staff,36,0,90,54
1683651977576,PSYC 2,B00,188953,Staff,19,0,35,16
1683651981029,PSYC 6,A00,188970,Staff,47,0,60,13
1683651984549,PSYC 7,A00,188973,Staff,35,0,45,10
1683651989063,PSYC 60,A01,188980,Rickard; Timothy C.,42,0,60,18
1683651993813,PSYC 70,A01,189001,Steiner; Eric Tomas,23,0,45,22
1683651998490,PSYC 100,A00,189005,Lacefield; Katharine I,0,99,120,120
1683652001988,PSYC 102,A00,189008,Staff,8,0,30,22
1683652007442,PSYC 106,B00,189026,Gorman; Michael R.,27,0,60,33
1683652011027,PSYC 114,B01,189033,Winkielman; Piotr,0,31,30,30
1683652016838,PSYC 131,A00,189036,Anagnostaras; Stephan,0,43,60,60
1683652023195,PSYC 136,A00,189041,Lowe; Angela Beth,0,7,25,25
1683652029941,PSYC 137,A00,189057,Winkielman; Piotr,0,37,25,25
1683652035781,PSYC 144,A00,189107,Wixted; John T,0,10,50,50
1683652046184,PSYC 162,A00,189142,Staff,0,9,85,85
1683652049815,PSYC 172,A00,189144,Gorman; Michael R.,0,6,30,30
1683652056990,PSYC 179,A00,189146,Lacefield; Katharine I,0,86,120,120
1683652061798,PSYC 181,A00,189147,Anagnostaras; Stephan,0,44,90,90
1683652066137,PSYC 190R,A00,189148,Barner; David A.,0,23,80,80
1683652070750,PSYC 191,A00,189275,Rickard; Timothy C.,0,10,25,25
1683652074253,PSYC 193,A00,189276,Chapman; Eddie Nathaniel,0,1,0,4
1683652078946,PSYC 193L,A01,189281,Lowe; Angela Beth,10,0,20,10
1683652078946,PSYC 193L,B01,189285,Staff,28,0,35,7
1683652082453,RELI 149,A00,187137,Rahimi; Babak,7,0,40,33
1683652086022,SE 9,A01,187315,Staff,0,2,18,18
1683652090912,SE 101B,A00,187409,Staff,24,0,30,6
1683652095671,SE 110B,A00,187444,Staff,10,0,40,30
1683652100297,SE 130B,A00,187449,Staff,31,0,40,9
1683652104967,SE 150A,A00,187516,Staff,9,0,20,11
1683652110260,SE 154,A00,187528,Staff,29,0,50,21
1683652114867,SIO 3,A01,258171,Staff,35,0,40,5
1683652119452,SIO 10,A00,187144,Cook; Geoffrey W,0,6,75,75
1683652122970,SIO 45,A00,187152,Cook; Geoffrey W,0,4,100,100
1683652128555,SIO 109R,A00,194486,Staff,0,4,20,20
1683652138877,SIO 187,A01,187233,Kacev; David,12,0,40,28
1683652143203,SOCI 1,A01,258656,Thorpe; Charles Robert,28,0,30,2
1683652143203,SOCI 1,A02,258658,Thorpe; Charles Robert,30,0,30,0
1683652143203,SOCI 1,A03,258661,Thorpe; Charles Robert,25,0,25,0
1683652143203,SOCI 1,A04,258666,Thorpe; Charles Robert,22,0,25,3
1683652143203,SOCI 1,A05,258897,Thorpe; Charles Robert,22,0,25,3
1683652143203,SOCI 1,A06,258898,Thorpe; Charles Robert,25,0,25,0
1683652147796,SOCI 30,A01,258903,Pardo Guerra; Juan Pablo,14,0,30,16
1683652151450,SOCI 102,A00,258904,Staff,9,0,25,16
1683652155239,SOCI 106,A00,258905,Staff,19,0,25,6
1683652158760,SOCI 111,A00,258907,Ribas Norris; Janet Vanesa,26,0,30,4
1683652163192,SOCI 121R,A00,258908,Pardo Guerra; Juan Pablo,8,0,30,22
1683652167893,SOCI 126,A01,203330,Staff,14,0,20,6
1683652172133,SOCI 131,A00,258909,Thorpe; Charles Robert,30,0,60,30
1683652176793,SOCI 135,A00,258910,Payne; Christine Anna,0,11,30,30
1683652180343,SOCI 157,A00,258911,Staff,12,0,30,18
1683652183951,SOCI 184,A00,258912,Staff,25,0,30,5
1683652188539,SOCI 188D,A00,258913,Staff,22,0,30,8
1683652192925,SYN 2,001,187529,Staff,9,0,16,7
1683652192925,SYN 2,002,201452,Staff,0,20,16,16
1683652192925,SYN 2,003,201469,Staff,2,0,16,14
1683652196616,SYN 100,A01,187531,Staff,0,9,20,20
1683652196616,SYN 100,B01,201491,Staff,0,10,20,20
1683652203150,TDAC 1,A00,189286,Walsh; Kim C.,3,0,20,17
1683652203150,TDAC 1,B00,189287,Harting; Carla Kelso,10,0,20,10
1683652207683,TDAC 101,A00,189300,Walsh; Kim C.,16,0,20,4
1683652207683,TDAC 101,B00,189301,Harting; Carla Kelso,18,0,20,2
1683652211158,TDAC 102,A00,189304,Basso; Beatrice,14,0,20,6
1683652214658,TDAC 108,A00,189305,Staff,18,0,20,2
1683652218149,TDDE 131,A00,189310,Staff,19,0,20,1
1683652218149,TDDE 131,B00,189314,Staff,19,0,20,1
1683652218149,TDDE 131,C00,189315,Staff,48,0,50,2
1683652218149,TDDE 131,D00,189316,Staff,14,0,15,1
1683652218149,TDDE 131,E00,204841,Staff,20,0,20,0
1683652221583,TDGE 10,A00,189289,Staff,27,0,50,23
1683652221583,TDGE 10,B00,189290,Havis; Allan,0,0,50,50
1683652225077,TDGE 11,A00,189291,Fulton; Julia,0,4,50,50
1683652225077,TDGE 11,B00,189292,Staff,20,0,25,5
1683652225077,TDGE 11,C00,260270,Staff,0,0,0,0
1683652229950,TDGE 25,A00,189294,Staff,2,0,20,18
1683652233759,TDGE 124,A00,189318,Fulton; Julia,0,8,50,50
1683652237373,TDGE 125,A00,189319,Staff,13,0,25,12
1683652237373,TDGE 125,B00,189320,Staff,23,0,25,2
1683652242047,TDGE 127,A00,189322,Havis; Allan,0,0,50,50
1683652248392,TDHT 101,A00,189323,Staff,18,0,25,7
1683652248392,TDHT 101,B00,189324,Staff,25,0,25,0
1683652253225,TDHT 102,A00,189325,Staff,49,0,50,1
1683652257881,TDMV 1,A00,189295,Arcidiacono; Kristin,20,0,30,10
1683652257881,TDMV 1,B00,189296,Caligagan; Maria T.,24,0,30,6
1683652264100,TDMV 2,A00,189297,Sammartano; Tonnie,27,0,30,3
1683652264100,TDMV 2,B00,189299,Arcidiacono; Kristin,23,0,30,7
1683652267564,TDMV 3,A00,204998,Rincon; Alicia,22,0,30,8
1683652272414,TDMV 120,A00,189458,Sammartano; Tonnie,28,0,30,2
1683652276502,TDMV 138,A00,189541,Jun; Grace Shin Hae,20,0,40,20
1683652281421,TDMV 142,A00,189717,Caligagan; Tony,25,0,30,5
1683652281421,TDMV 142,B00,189718,Caligagan; Maria T.,25,0,30,5
1683652284858,TMC 2,A01,187533,Staff,25,0,25,0
1683652284858,TMC 2,A02,187534,Staff,25,0,25,0
1683652288318,USP 1,A01,187536,Kwak; Nancy,0,16,25,25
1683652291779,USP 5,A01,187538,Staff,9,0,25,16
1683652296159,USP 101,A00,199253,Staff,0,4,0,0
1683652300980,USP 124,A00,187562,Boomhower; Matthew Charles,0,0,30,30
1683652304549,USP 138,A00,187582,Staff,20,0,25,5
1683652308130,USP 152,A01,187597,Staff,3,0,25,22
1683652311696,USP 153,A00,187598,Staff,19,0,25,6
1683652315281,USP 168,A00,187607,Kwak; Nancy,2,0,5,3
1683652318837,USP 173,A00,187619,Staff,4,0,25,21
1683652322538,USP 181,A00,187638,Staff,0,4,25,25
1683652327421,VIS 103,A00,187650,Cruz; Edwin Teddy,18,0,75,57
1683652332420,VIS 110D,A00,187669,Staff,13,0,22,9
1683652337230,VIS 127C,A00,187720,Shen; Kuiyi,67,0,146,79
1683652342203,VIS 149,A00,187731,Yoldas; Pinar,0,14,22,22
1683652347029,VIS 151,A01,188091,Staff,22,0,34,12
1683652347029,VIS 151,A02,188092,Staff,11,0,34,23
1683652351827,VIS 160B,A00,188093,Stalbaum; Brett,0,1,10,10
1683652359894,WCWP 10B,A00,201720,Staff,10,0,15,5
1683652359894,WCWP 10B,B00,201722,Staff,9,0,15,6
1683652363641,WCWP 100,A00,201725,Gagnon; Jeffrey C,0,0,2,2
1683652363641,WCWP 100,B00,201727,Staff,0,4,15,15
1683652374031,ANBI 133,A00,258401,Wilder; Linnea Lorene,34,0,40,6
1683652379723,ANBI 140,A00,258395,Hrvoj Mihic; Branka,18,0,25,7
1683652383273,ANSC 120,A00,258402,Bialecki; Jon Anthony,26,0,40,14
1683652386743,ANSC 144,A00,258400,Staff,12,0,40,28
1683652393755,ANSC 166,A00,258396,Parish; Steven Martin,156,0,175,19
1683652398391,ANSC 180,A00,193533,Staff,8,0,20,12
1683652402783,ANSC 188,A00,258397,Jassal; Aftab,34,0,40,6
1683652406278,ANTH 3,A01,258316,Staff,23,0,30,7
1683652409837,ANTH 5,A00,258394,Semendeferi; Ekaterini,16,0,20,4
1683652415675,ANTH 21,A01,258331,Staff,4,0,40,36
1683652420865,ANTH 103,A00,258398,Varma; Saiba,15,0,25,10
1683652425760,AWP 10,001,202034,Staff,0,0,0,0
1683652425760,AWP 10,002,202035,Staff,0,0,0,0
1683652425760,AWP 10,003,202036,Staff,0,0,0,0
1683652425760,AWP 10,004,202037,Staff,0,0,0,0
1683652425760,AWP 10,005,202038,Staff,0,0,0,0
1683652425760,AWP 10,006,202039,Staff,0,0,0,0
1683652425760,AWP 10,007,202040,Staff,0,0,0,0
1683652425760,AWP 10,008,202041,Staff,0,0,0,0
1683652425760,AWP 10,009,202042,Staff,0,0,0,0
1683652425760,AWP 10,010,202043,Staff,0,0,0,0
1683652425760,AWP 10,011,202044,Staff,0,0,0,0
1683652425760,AWP 10,012,202045,Staff,0,0,0,0
1683652425760,AWP 10,013,202046,Staff,0,0,0,0
1683652425760,AWP 10,014,202047,Staff,0,0,0,0
1683652425760,AWP 10,015,202048,Staff,0,0,0,0
1683652425760,AWP 10,016,202049,Staff,0,0,0,0
1683652425760,AWP 10,017,202050,Staff,0,0,0,0
1683652425760,AWP 10,018,202051,Staff,0,0,0,0
1683652425760,AWP 10,019,202052,Staff,0,0,0,0
1683652425760,AWP 10,020,202053,Staff,0,0,0,0
1683652425760,AWP 10,021,202054,Staff,0,0,0,0
1683652425760,AWP 10,022,202055,Staff,0,0,0,0
1683652425760,AWP 10,023,202056,Staff,0,0,0,0
1683652425760,AWP 10,024,202057,Staff,0,0,0,0
1683652425760,AWP 10,025,202058,Staff,0,0,0,0
1683652425760,AWP 10,026,202059,Staff,0,0,0,0
1683652429273,AWP 102,001,202032,Staff,0,0,0,0
1683652429273,AWP 102,002,202033,Staff,0,0,0,0
1683652432735,BENG 100,A01,254234,Taylor Amos; Alyssa C,31,0,40,9
1683652438082,BENG 196,001,270013,Engler; Adam J.,9999,0,9999,0
1683652442815,BICD 100R,A01,202018,Smith; Laurie,0,7,32,32
1683652442815,BICD 100R,A02,202019,Smith; Laurie,0,3,32,32
1683652442815,BICD 100R,A03,202020,Smith; Laurie,0,1,32,32
1683652442815,BICD 100R,A04,202021,Smith; Laurie,6,0,32,26
1683652442815,BICD 100R,A05,202022,Smith; Laurie,11,0,32,21
1683652446310,BICD 136,A01,193242,Gustafson-Brown; Cindy,0,2,32,32
1683652446310,BICD 136,A02,193244,Gustafson-Brown; Cindy,13,0,32,19
1683652449856,BIEB 102,A01,193249,Butler; Shannon Rhey,0,2,32,32
1683652449856,BIEB 102,A02,193251,Butler; Shannon Rhey,0,0,32,32
1683652449856,BIEB 102,A03,193253,Butler; Shannon Rhey,0,0,32,32
1683652449856,BIEB 102,A04,193255,Butler; Shannon Rhey,14,0,32,18
1683652449856,BIEB 102,A05,193265,Butler; Shannon Rhey,26,0,32,6
1683652449856,BIEB 102,A06,193269,Butler; Shannon Rhey,14,0,32,18
1683652458031,BIEB 150,A01,193274,Staff,0,0,32,32
1683652458031,BIEB 150,A02,193285,Staff,24,0,32,8
1683652461491,BIEB 194,A00,193286,Kurle; Carolyn M.,20,0,32,12
1683652465053,BILD 1,A01,192291,Staff,15,0,32,17
1683652465053,BILD 1,A02,192292,Staff,30,0,32,2
1683652465053,BILD 1,B01,192520,Reuther; Keefe,0,1,0,0
1683652465053,BILD 1,B02,192532,Reuther; Keefe,0,1,0,0
1683652470015,BILD 3,A01,192556,Butler; Shannon Rhey,0,0,32,32
1683652470015,BILD 3,A02,192581,Butler; Shannon Rhey,1,0,32,31
1683652470015,BILD 3,A03,192611,Butler; Shannon Rhey,21,0,32,11
1683652470015,BILD 3,A04,192612,Butler; Shannon Rhey,24,0,32,8
1683652470015,BILD 3,A05,192613,Butler; Shannon Rhey,26,0,32,6
1683652470015,BILD 3,A06,192679,Butler; Shannon Rhey,27,0,32,5
1683652470015,BILD 3,A07,192682,Butler; Shannon Rhey,20,0,32,12
1683652474751,BILD 4,A01,192836,Reuther; Keefe,1,0,24,23
1683652474751,BILD 4,A02,193044,Reuther; Keefe,4,0,24,20
1683652479549,BILD 10,A01,193142,Gustafson-Brown; Cindy,29,0,32,3
1683652479549,BILD 10,A02,193149,Gustafson-Brown; Cindy,31,0,32,1
1683652484255,BIMM 100,A01,193301,Staff,0,6,32,32
1683652484255,BIMM 100,A02,193312,Staff,0,7,32,32
1683652484255,BIMM 100,A03,193323,Staff,0,9,32,32
1683652488194,BIMM 101,A01,193329,McDonnell; Lisa Marie,0,4,24,24
1683652488194,BIMM 101,A02,193339,McDonnell; Lisa Marie,1,3,24,23
1683652488194,BIMM 101,B01,193354,McDonnell; Lisa Marie,0,4,24,24
1683652488194,BIMM 101,B02,193357,McDonnell; Lisa Marie,0,3,24,24
1683652494232,BIMM 110,A01,193377,Tat; John,0,11,32,32
1683652494232,BIMM 110,A02,193378,Tat; John,0,10,32,32
1683652497791,BIMM 120,A01,206116,Staff,0,0,32,32
1683652497791,BIMM 120,A02,206117,Staff,6,0,32,26
1683652497791,BIMM 120,A03,206121,Staff,21,0,32,11
1683652501330,BIPN 100,A01,193393,Park; Ji Young,0,14,32,32
1683652501330,BIPN 100,A02,193402,Park; Ji Young,0,14,32,32
1683652501330,BIPN 100,A03,193413,Park; Ji Young,0,14,32,32
1683652501330,BIPN 100,A04,193414,Park; Ji Young,0,13,32,32
1683652504909,BIPN 102,A01,193429,Staff,0,0,32,32
1683652504909,BIPN 102,A02,193438,Staff,18,0,32,14
1683652508461,BIPN 106,A01,193450,Reyes Gonzalez; Catalina,0,2,40,40
1683652512199,BIPN 134,A01,193465,Cooke; James Edward,0,0,32,32
1683652512199,BIPN 134,A02,193474,Cooke; James Edward,25,0,32,7
1683652512199,BIPN 134,A03,193485,Cooke; James Edward,29,0,32,3
1683652512199,BIPN 134,A04,193486,Cooke; James Edward,20,0,32,12
1683652512199,BIPN 134,A05,193491,Cooke; James Edward,31,0,32,1
1683652512199,BIPN 134,A06,193501,Cooke; James Edward,30,0,32,2
1683652512199,BIPN 134,A07,193510,Cooke; James Edward,29,0,32,3
1683652520484,BISP 194,A00,222522,Staff,14,0,32,18
1683652524953,CAT 124,A01,202407,Staff,19,0,25,6
1683652530891,CAT 125,A00,202408,Marchisotto; Jennifer Anne,2,0,20,18
1683652535680,CAT 125R,A00,202409,Smith; Lauryn Alissa,0,11,20,20
1683652535680,CAT 125R,B00,202410,Morales; Celeste Georgianna,0,11,20,20
1683652535680,CAT 125R,C00,202411,Irwin; Matthew Joseph,0,12,20,20
1683652539218,CENG 15,A01,204712,Yang; Kesong,0,1,0,0
1683652543364,CENG 114,A00,202070,Jahed Motlagh; Zeinab,5,0,20,15
1683652548423,CGS 105,A00,185477,Wesling; Megan E.,24,0,40,16
1683652551984,CGS 106,A00,185494,Staff,11,0,22,11
1683652555509,CGS 108,A00,185495,Staff,14,0,20,6
1683652558966,CGS 114,A00,185496,Staff,13,0,18,5
1683652562482,CGS 119,A00,185501,Staff,15,0,20,5
1683652567260,CGS 120,A00,185511,Staff,12,0,20,8
1683652570713,CHEM 4,A01,184675,Bussey; Thomas J,97,0,100,3
1683652574171,CHEM 6A,A01,184677,Staff,33,0,60,27
1683652577687,CHEM 6B,A01,184679,Staff,63,0,100,37
1683652581211,CHEM 6C,A01,184681,Bussey; Thomas J,0,0,50,50
1683652581211,CHEM 6C,A02,184682,Bussey; Thomas J,32,0,50,18
1683652586010,CHEM 40A,A01,184684,Albizati; Kim F.,34,0,100,66
1683652589710,CHEM 40B,A01,184686,Albizati; Kim F.,0,22,100,100
1683652593263,CHEM 41B,A01,184690,Staff,51,0,100,49
1683652596822,COGS 3,A01,184715,Boyle; Mary E. T.,0,27,40,40
1683652600434,COGS 14B,A01,185172,Staff,0,14,38,38
1683652605155,COGS 18,A01,184736,Staff,14,0,80,66
1683652611066,COGS 100,A01,184932,Staff,0,7,73,73
1683652614584,COGS 101A,A01,184935,Staff,0,39,30,30
1683652618009,COGS 101B,A01,184944,Staff,0,2,30,30
1683652621575,COGS 101C,A01,184946,Staff,0,10,30,30
1683652625052,COGS 102A,A01,184951,Johnson; Christine M.,2,0,40,38
1683652628488,COGS 107B,A01,184953,Mooshagian; Eric Frederick,0,51,40,40
1683652633339,COGS 118B,A01,184959,Gupta; Anjum,0,49,40,40
1683652636806,COGS 153,A00,184961,Staff,0,16,30,30
1683652641597,COGS 177,A00,184962,Staff,0,21,30,30
1683652645161,COGS 187A,A01,184969,Boyle; Mary E. T.,0,19,40,40
1683652648600,COMM 10,A01,185174,Staff,0,5,25,25
1683652648600,COMM 10,A02,185189,Staff,0,2,25,25
1683652648600,COMM 10,A03,269821,Staff,0,1,0,0
1683652652139,COMM 100B,A01,185475,Staff,0,1,0,2
1683652652139,COMM 100B,A02,185476,Staff,12,0,25,13
1683652655691,COMM 100C,A01,185314,Staff,1,0,25,24
1683652655691,COMM 100C,A02,185327,Staff,18,0,25,7
1683652659214,COMM 110M,A00,185349,Staff,0,0,40,40
1683652662843,COMM 113T,A00,185352,Staff,25,0,40,15
1683652668274,COMM 114I,A00,185353,Staff,31,0,40,9
1683652673127,COMM 131,A00,185354,Staff,17,0,30,13
1683652678115,CSE 8A,A50,185358,Cao; Yingjun,0,46,10,10
1683652683818,CSE 8B,A01,185362,Staff,0,48,50,50
1683652689573,CSE 11,A01,185416,Cao; Yingjun,0,91,10,10
1683652694369,CSE 20,A01,185445,Briones; Jor-el Thomas Caparas,4,0,25,21
1683652699076,CSE 21,A01,185447,Staff,9,0,50,41
1683652703897,CSE 101,A01,185451,Staff,0,13,50,50
1683652703897,CSE 101,B01,185453,Jones; Miles E,0,13,50,50
1683652712286,CSE 141,A01,185458,Eldon; John,16,0,100,84
1683652715811,CSE 141L,A01,185461,Eldon; John,8,0,100,92
1683652720067,CSE 142,A01,185463,Staff,35,0,60,25
1683652720067,CSE 142,B01,201355,Staff,0,7,60,60
1683652723499,CSE 142L,A01,185470,Staff,35,0,60,25
1683652723499,CSE 142L,B01,201417,Staff,0,6,60,60
1683652726831,CSE 190,A00,201433,Staff,32,0,49,17
1683652731746,DOC 1,A01,259136,Strom; Megan C.,7,0,15,8
1683652731746,DOC 1,A02,259137,Strom; Megan C.,14,0,15,1
1683652731746,DOC 1,A03,259138,Strom; Megan C.,14,0,15,1
1683652731746,DOC 1,A04,259139,Strom; Megan C.,14,0,15,1
1683652735227,DOC 100D,A00,259140,Pass; Natalye Joann,14,0,25,11
1683652740380,DSGN 1,A01,184749,Rill; Bryan,0,26,30,30
1683652745067,DSGN 100,A01,185168,Staff,0,2,25,25
1683652749850,ECE 5,A01,185626,Morris; Karcher William,0,11,0,0
1683652754402,ECE 101,A01,185628,Staff,14,0,70,56
1683652760359,ECE 107,A01,185635,Baghdadchi; Saharnaz,0,0,20,20
1683652760359,ECE 107,A02,185638,Baghdadchi; Saharnaz,3,0,20,17
1683652766723,ECE 148,A01,185647,Silberman; Jack,0,0,16,16
1683652772884,ECON 1,A01,185537,Crane; Meredith Helen,54,0,70,16
1683652781498,ECON 3,A01,185549,Crane; Meredith Helen,29,0,70,41
1683652786387,ECON 4,A01,203354,Anderson; John Charles,0,5,10,10
1683652791310,ECON 100A,A01,185574,Staff,0,5,40,40
1683652795949,ECON 100B,A01,185576,Staff,0,12,50,50
1683652800885,ECON 100C,A01,185589,Newhouse; Herbert S,30,0,70,40
1683652804390,ECON 105,A00,185608,Vespa; Emanuel Ignacio,19,0,35,16
1683652807862,ECON 109,A01,185610,Shishkin; Denis,9,0,35,26
1683652812200,ECON 110A,A01,185612,Staff,9,0,40,31
1683652816560,ECON 120A,A01,185615,Staff,20,0,40,20
1683652819904,ECON 120C,A01,185617,Sun; Yixiao,0,20,70,70
1683652824413,ECON 144,A00,203346,Squires; Dale E,2,0,35,33
1683652827845,ECON 171,A01,203349,Newhouse; Herbert S,0,1,35,35
1683652832970,ECON 173A,A01,185621,Toda; Alexis Akira,21,0,35,14
1683652838548,EDS 25,A01,202413,Staff,0,1,0,0
1683652838548,EDS 25,A02,202414,Staff,0,1,0,0
1683652838548,EDS 25,A03,202415,Staff,0,0,0,0
1683652838548,EDS 25,A04,202416,Staff,0,1,0,0
1683652838548,EDS 25,A05,202439,Staff,0,0,0,0
1683652838548,EDS 25,A06,202440,Staff,0,0,0,0
1683652838548,EDS 25,B01,202631,Staff,0,0,0,0
1683652838548,EDS 25,B02,202632,Staff,0,0,0,0
1683652838548,EDS 25,B03,202639,Staff,0,0,0,0
1683652838548,EDS 25,B04,202640,Staff,0,0,0,0
1683652838548,EDS 25,B05,202643,Staff,0,0,0,0
1683652838548,EDS 25,B06,202644,Staff,0,0,0,0
1683652843001,EDS 38,A01,202659,Black; Alison Michelle,24,0,25,1
1683652846666,EDS 115,A00,202652,Staff,18,0,30,12
1683652850169,EDS 125,A00,202649,Staff,13,0,30,17
1683652855934,EDS 126,A01,203332,Staff,30,0,30,0
1683652862104,EDS 139,A00,202838,Staff,16,0,25,9
1683652867096,EDS 146,A01,202655,Staff,14,0,25,11
1683652870513,ENG 15,A00,185667,Staff,0,1,0,0
1683652870513,ENG 15,B00,185672,Staff,0,0,0,0
1683652870513,ENG 15,C00,185675,Staff,0,0,0,0
1683652870513,ENG 15,D00,185682,Staff,0,0,0,0
1683652870513,ENG 15,E00,185684,Staff,0,0,0,0
1683652874833,ETHN 103,A00,185710,Staff,0,8,35,35
1683652879206,ETHN 103A,A00,199228,Man; Simeon S,0,0,9,9
1683652884379,ETHN 109,A00,185711,Staff,16,0,35,19
1683652889765,ETHN 142,A00,185726,Staff,0,4,30,30
1683652895121,ETHN 163J,A00,199229,Man; Simeon S,5,0,8,3
1683652898643,ETHN 168,A00,185727,Staff,7,0,10,3
1683652903699,ETHN 182,A00,185728,Staff,0,0,35,35
1683652908351,ETHN 183,A00,185737,Staff,9,0,18,9
1683652913545,GLBH 111,A01,209361,Burgos; Jose L.,0,0,0,0
1683652921868,HIEU 104,A00,185792,Staff,14,0,20,6
1683652928276,HIEU 115,A00,185800,Staff,0,0,20,20
1683652931703,HIEU 128,A00,185801,Staff,0,9,20,20
1683652935194,HIEU 147,A00,185802,Staff,15,0,20,5
1683652939474,HIEU 154,A00,185823,Staff,11,0,20,9
1683652942890,HILA 102,A00,185826,Staff,14,0,20,6
1683652946353,HILD 2C,A01,185778,Staff,0,13,20,20
1683652949876,HILD 7B,A01,185780,Kwak; Nancy,0,16,32,32
1683652949876,HILD 7B,A02,185781,Kwak; Nancy,0,18,32,32
1683652953643,HILD 30,A01,185791,Staff,12,0,20,8
1683652957276,HISC 119,A00,185830,Golan; Tal,0,9,20,20
1683652960939,HITO 156GS,A00,185831,Patterson; Patrick H.,0,0,0,23
1683652964266,HIUS 103,A00,185832,Man; Simeon S,0,4,20,20
1683652967586,HIUS 117,A00,185836,Kwak; Nancy,2,0,20,18
1683652970882,HIUS 125,A00,185840,Man; Simeon S,0,1,23,23
1683652974264,HIUS 149,A00,185845,Staff,1,0,20,19
1683652977713,HUM 3,A01,185882,Zavodny; Tatiana Sophia,0,8,50,50
1683652977713,HUM 3,B01,185899,Caldwell; Michael Alan,0,18,50,50
1683652981089,HUM 3GS,A00,185900,Patterson; Patrick H.,0,0,0,23
1683652985121,HUM 4,A01,185938,Zroka; Amy Liane,29,0,50,21
1683652985121,HUM 4,B01,185956,Watkins; Eric,0,4,50,50
1683652985121,HUM 4,B02,202209,Watkins; Eric,0,4,50,50
1683652985121,HUM 4,B03,202210,Watkins; Eric,0,5,50,50
1683652988549,HUM 5,A01,185958,West; Geoffrey Scott,2,0,50,48
1683652988549,HUM 5,A02,202215,West; Geoffrey Scott,0,0,50,50
1683652991967,INTL 190,A00,185959,Gagnon; Jeffrey C,0,0,0,9
1683652991967,INTL 190,B00,185960,Lettieri; Michael Joseph,0,0,0,2
1683652997540,JAPN 180,A00,254509,Staff,5,0,30,25
1683653003414,LATI 10,A01,202853,Kennemore; Amy Michelle,4,0,35,31
1683653003414,LATI 10,A02,202854,Kennemore; Amy Michelle,2,0,35,33
1683653003414,LATI 10,A03,270054,Kennemore; Amy Michelle,30,0,30,0
1683653008817,LATI 180,A00,202855,Kennemore; Amy Michelle,11,0,20,9
1683653014534,LAWS 101,A00,201767,Golan; Tal,0,7,40,40
1683653020207,LIFR 1C,A00,185961,Staff,6,0,20,14
1683653025102,LIFR 1CX,A00,185962,Staff,7,0,20,13
1683653028721,LIFR 1D,A00,185963,Staff,7,0,20,13
1683653032141,LIFR 1DX,A00,185964,Staff,7,0,20,13
1683653035595,LIGN 101,A01,186039,Staff,43,0,50,7
1683653039100,LIGN 165,A00,186040,Staff,15,0,50,35
1683653042667,LTCS 108,A00,186041,Staff,5,0,10,5
1683653046093,LTCS 119,A00,186042,Staff,15,0,20,5
1683653049552,LTCS 130,A00,186043,Wesling; Megan E.,15,0,25,10
1683653056620,LTEA 138,A00,186119,Staff,14,0,40,26
1683653060129,LTEN 124,A00,186148,Staff,5,0,25,20
1683653064987,LTEN 178,A00,186149,Staff,7,0,15,8
1683653068416,LTEN 181,A00,186150,Blanco; John D,34,0,40,6
1683653071815,LTWL 120,A00,186160,Staff,20,0,25,5
1683653076843,LTWL 165,A00,186161,Staff,22,0,25,3
1683653081554,LTWR 100,A00,186162,Staff,0,5,15,15
1683653087565,LTWR 102,A00,186163,Doller; Ben,5,0,15,10
1683653092500,MAE 8,A01,186412,Staff,0,0,0,0
1683653097275,MAE 30B,A00,186445,Bahadori; Mohammad Yousef,82,0,100,18
1683653102419,MAE 40,A00,186592,Bewley; Thomas R,10,0,50,40
1683653107073,MAE 101B,A00,186593,Bahadori; Mohammad Yousef,80,0,100,20
1683653110521,MAE 105,A00,186594,Bandaru; Prabhakar,10,0,50,40
1683653114735,MAE 107,A00,186599,Pham; Hieu Tan,0,7,120,120
1683653119327,MAE 148,A01,186660,Silberman; Jack,3,0,16,13
1683653122760,MATH 10A,A01,188095,Staff,0,6,35,35
1683653126127,MATH 10B,A01,188097,Bowers; Adam R.,0,12,30,30
1683653126127,MATH 10B,A02,188099,Bowers; Adam R.,0,11,30,30
1683653126127,MATH 10B,B01,188104,Bowers; Adam R.,0,10,30,30
1683653126127,MATH 10B,B02,188106,Bowers; Adam R.,1,9,30,29
1683653129696,MATH 10C,A01,188111,Staff,0,18,30,30
1683653129696,MATH 10C,A02,188127,Staff,0,19,30,30
1683653129696,MATH 10C,A03,188131,Staff,0,19,30,30
1683653129696,MATH 10C,B01,188218,Staff,17,0,30,13
1683653129696,MATH 10C,B02,188244,Staff,13,0,30,17
1683653129696,MATH 10C,B03,188277,Staff,14,0,30,16
1683653133246,MATH 18,A01,188344,Bach; Quang Tran,18,0,30,12
1683653133246,MATH 18,A02,188345,Bach; Quang Tran,11,0,30,19
1683653133246,MATH 18,B01,188353,Bach; Quang Tran,11,0,30,19
1683653133246,MATH 18,B02,188354,Bach; Quang Tran,19,0,30,11
1683653136777,MATH 20A,A01,188374,Staff,11,0,35,24
1683653140205,MATH 20B,A01,188382,Ohm; Ko Woon,7,0,30,23
1683653140205,MATH 20B,A02,188383,Ohm; Ko Woon,22,0,30,8
1683653140205,MATH 20B,B01,188385,Ohm; Ko Woon,7,0,30,23
1683653140205,MATH 20B,B02,188392,Ohm; Ko Woon,22,0,30,8
1683653143750,MATH 20C,A01,188394,Harel; Guershon,11,0,30,19
1683653143750,MATH 20C,A02,188395,Harel; Guershon,13,0,30,17
1683653143750,MATH 20C,B01,188404,Harel; Guershon,5,0,30,25
1683653143750,MATH 20C,B02,188405,Harel; Guershon,18,0,30,12
1683653147157,MATH 20D,A01,188414,Hammock; Frances H,0,1,30,30
1683653147157,MATH 20D,A02,188415,Hammock; Frances H,0,1,30,30
1683653147157,MATH 20D,B01,188447,Hammock; Frances H,0,1,30,30
1683653147157,MATH 20D,B02,188486,Hammock; Frances H,4,0,30,26
1683653150639,MATH 20E,A01,188649,Staff,21,0,30,9
1683653150639,MATH 20E,A02,188650,Staff,21,0,30,9
1683653150639,MATH 20E,A03,188673,Staff,0,0,30,30
1683653154077,MATH 102,A01,188675,Staff,0,36,35,35
1683653157564,MATH 103B,A01,188681,Staff,3,0,35,32
1683653157564,MATH 103B,B01,188692,Staff,5,0,35,30
1683653161248,MATH 109,A01,188695,Salehi Golsefidy; Alireza,24,0,35,11
1683653161248,MATH 109,A02,188696,Salehi Golsefidy; Alireza,25,0,35,10
1683653164661,MATH 120A,A01,188698,Eggers; John Dietrich,7,0,35,28
1683653168116,MATH 142B,A01,188736,Ioana; Adrian,0,1,30,30
1683653168116,MATH 142B,A02,188741,Ioana; Adrian,0,1,30,30
1683653168116,MATH 142B,A03,188743,Ioana; Adrian,0,1,30,30
1683653173094,MATH 168A,A01,188790,Staff,0,10,35,35
1683653178978,MATH 170A,A01,188803,Nie; Jiawang,0,2,35,35
1683653178978,MATH 170A,A02,188811,Nie; Jiawang,0,0,35,35
1683653178978,MATH 170A,A03,188814,Nie; Jiawang,0,0,35,35
1683653178978,MATH 170A,A04,188815,Nie; Jiawang,10,0,35,25
1683653182392,MATH 193B,A01,188817,Staff,0,0,35,35
1683653182392,MATH 193B,A02,188818,Staff,5,0,35,30
1683653185789,MGT 4,A01,202857,Anderson; John Charles,61,0,80,19
1683653189233,MGT 12,A00,202858,Lindenberger; Wade Douglas,40,0,90,50
1683653192729,MGT 18,A00,202859,Staff,74,0,90,16
1683653196264,MGT 18GS,A00,202860,McKay; Michael J,13,0,28,15
1683653201003,MGT 45,A00,202861,Pecore; Joseph P.,12,0,90,78
1683653204496,MGT 100,A00,202863,Yavorsky; Daniel Ryan,28,0,90,62
1683653207925,MGT 103,A00,202864,Ehrich; Kristine R,0,17,90,90
1683653211416,MGT 112,A00,202865,Ehrich; Kristine R,15,0,90,75
1683653214856,MGT 121A,A00,202868,Staff,0,20,0,0
1683653219430,MGT 131B,A00,202869,Anderson; John Charles,59,0,90,31
1683653222977,MGT 136,A00,202871,Lindenberger; Wade Douglas,83,0,90,7
1683653227225,MGT 164,A00,202873,Staff,0,66,90,91
1683653230713,MGT 164GS,A00,202874,McKay; Mary A,13,0,28,15
1683653234195,MGT 180,A00,202875,Staff,0,50,90,91
1683653239114,MMW 11R,A01,205019,Herbst; Matthew,2,0,30,28
1683653239114,MMW 11R,A02,205026,Herbst; Matthew,29,0,30,1
1683653242761,MMW 15,A01,193512,Chang; Edmond Yi-Teh,0,8,28,28
1683653242761,MMW 15,A02,193513,Chang; Edmond Yi-Teh,0,5,28,28
1683653242761,MMW 15,A03,193514,Chang; Edmond Yi-Teh,0,5,28,28
1683653242761,MMW 15,A04,193515,Chang; Edmond Yi-Teh,0,5,28,28
1683653242761,MMW 15,A05,193516,Chang; Edmond Yi-Teh,0,5,28,28
1683653242761,MMW 15,A06,193517,Chang; Edmond Yi-Teh,0,6,28,28
1683653242761,MMW 15,B01,193519,Chang; Edmond Yi-Teh,0,5,28,28
1683653242761,MMW 15,B02,193520,Chang; Edmond Yi-Teh,0,5,28,28
1683653242761,MMW 15,B03,193521,Chang; Edmond Yi-Teh,0,5,28,28
1683653242761,MMW 15,B04,193522,Chang; Edmond Yi-Teh,0,5,28,28
1683653242761,MMW 15,B05,193523,Chang; Edmond Yi-Teh,0,5,28,28
1683653242761,MMW 15,B06,193524,Chang; Edmond Yi-Teh,0,5,28,28
1683653246233,MMW 122,A01,193526,Rahimi; Babak,0,16,28,28
1683653246233,MMW 122,A02,193527,Rahimi; Babak,0,15,28,28
1683653246233,MMW 122,A03,193528,Rahimi; Babak,0,0,0,0
1683653246233,MMW 122,A04,193529,Rahimi; Babak,0,0,0,0
1683653249786,MUS 1A,A01,186663,Staff,1,20,35,34
1683653253477,MUS 4,A01,186715,Staff,0,12,35,35
1683653256949,MUS 5R,A01,186796,Dubnov; Shlomo,0,17,35,35
1683653260501,MUS 6,A01,186798,Staff,0,5,25,25
1683653263955,MUS 7,A01,186830,Staff,11,0,35,24
1683653267393,MUS 8,A01,186930,Staff,0,26,35,35
1683653270880,MUS 15,A01,186932,Staff,0,16,35,35
1683653270880,MUS 15,B01,186934,Staff,0,17,35,35
1683653274338,MUS 80,A00,186935,Staff,0,0,20,20
1683653274338,MUS 80,B00,186936,Staff,24,0,25,1
1683653277794,NANO 11,A00,204702,Lipomi; Darren John,0,0,0,0
1683653281304,NANO 15,A01,204709,Yang; Kesong,0,1,0,0
1683653284714,NANO 114,A00,202069,Jahed Motlagh; Zeinab,3,0,10,7
1683653288957,PHIL 1,A00,186955,Grush; Rick Scott,31,0,40,9
1683653292353,PHIL 10,A01,186973,Grush; Rick Scott,27,0,35,8
1683653292353,PHIL 10,A02,186974,Grush; Rick Scott,33,0,35,2
1683653296110,PHIL 13,A01,186976,Staff,3,0,35,32
1683653296110,PHIL 13,A02,186977,Staff,16,0,35,19
1683653299503,PHIL 14,A01,186979,Staff,31,0,35,4
1683653299503,PHIL 14,A02,186986,Staff,32,0,35,3
1683653302936,PHIL 28,A01,186988,Staff,16,0,30,14
1683653302936,PHIL 28,A02,186989,Staff,1,0,30,29
1683653302936,PHIL 28,A03,186990,Staff,10,0,30,20
1683653302936,PHIL 28,A04,186991,Staff,26,0,30,4
1683653306434,PHIL 120,A00,186997,Staff,23,0,40,17
1683653310883,PHIL 137,A00,187003,Staff,7,0,40,33
1683653314414,PHIL 150,A00,187015,Staff,47,0,70,23
1683653317936,PHIL 167,A00,187021,Lamey; Andy M.,34,0,40,6
1683653321464,PHIL 174,A01,202226,Staff,17,0,20,3
1683653321464,PHIL 174,A02,202235,Staff,20,0,20,0
1683653327498,PHIL 191A,A00,258918,Staff,0,0,1,1
1683653333378,PHYS 1A,A00,187028,Staff,26,0,60,34
1683653338592,PHYS 1AL,001,187036,Staff,3,0,30,27
1683653338592,PHYS 1AL,002,187049,Staff,18,0,30,12
1683653344630,PHYS 1B,A00,187058,Staff,22,0,60,38
1683653350518,PHYS 1BL,001,187064,Staff,0,1,30,30
1683653350518,PHYS 1BL,002,187070,Staff,4,0,30,26
1683653356512,PHYS 1C,A00,187082,Staff,29,0,120,91
1683653361142,PHYS 1CL,001,187088,Staff,0,9,30,30
1683653361142,PHYS 1CL,002,187089,Staff,0,1,30,30
1683653361142,PHYS 1CL,009,262693,Staff,9,0,30,21
1683653365908,PHYS 2B,A01,187097,Staff,55,0,115,60
1683653370840,PHYS 2C,A01,187099,Staff,64,0,115,51
1683653374217,PHYS 2CL,A01,187101,Staff,5,0,28,23
1683653374217,PHYS 2CL,A02,187102,Staff,15,0,28,13
1683653378670,PHYS 2D,A01,187123,Shotwell; Brian,95,0,115,20
1683653384432,PHYS 4B,A01,187133,Grinstein; Benjamin,35,0,50,15
1683653389039,POLI 10,A00,188819,Staff,0,4,50,50
1683653394280,POLI 11,A00,188827,Staff,43,0,50,7
1683653405109,POLI 13R,A00,188828,Staff,0,1,20,20
1683653408567,POLI 27,A01,188830,Elgin; Samuel Zincke,0,2,70,70
1683653411954,POLI 30,A00,188832,Desposato; Scott,30,0,50,20
1683653415495,POLI 102F,A00,188834,Staff,0,0,40,40
1683653421503,POLI 104A,A00,188852,Staff,13,0,30,17
1683653427379,POLI 104I,A00,188853,Staff,0,7,20,20
1683653439011,POLI 110B,A00,188854,Wiens; David,6,0,20,14
1683653449682,POLI 112A,A00,188855,Wiens; David,3,0,30,27
1683653453148,POLI 117R,A00,188856,Forman; Fonna,0,12,20,20
1683653456461,POLI 118,A00,188857,Ingham; Sean,8,0,20,12
1683653459950,POLI 120G,A00,188858,Staff,8,0,30,22
1683653463449,POLI 131CR,A00,188863,Hoston; Germaine,21,0,50,29
1683653466899,POLI 133,A00,188864,Nellis; Gareth Hb,44,0,50,6
1683653470365,POLI 134D,A00,188865,Desposato; Scott,27,0,30,3
1683653473794,POLI 142A,A00,188871,Gartzke; Erik,21,0,50,29
1683653477138,POLI 142K,A00,188874,Staff,38,0,50,12
1683653480505,POLI 143,A00,188940,Gartzke; Erik,16,0,30,14
1683653483847,POLI 153,A00,188943,Staff,2,0,20,18
1683653487268,POLI 160AA,A00,188944,Staff,11,0,40,29
1683653491984,POLI 170A,A00,188945,Staff,11,0,30,19
1683653498727,PSYC 1,A00,188952,Staff,36,0,90,54
1683653502181,PSYC 2,B00,188953,Staff,19,0,35,16
1683653506778,PSYC 6,A00,188970,Staff,47,0,60,13
1683653510237,PSYC 7,A00,188973,Staff,35,0,45,10
1683653513721,PSYC 60,A01,188980,Rickard; Timothy C.,42,0,60,18
1683653517295,PSYC 70,A01,189001,Steiner; Eric Tomas,23,0,45,22
1683653521046,PSYC 100,A00,189005,Lacefield; Katharine I,0,99,120,120
1683653525418,PSYC 102,A00,189008,Staff,8,0,30,22
1683653528793,PSYC 106,B00,189026,Gorman; Michael R.,27,0,60,33
1683653533221,PSYC 114,B01,189033,Winkielman; Piotr,0,31,30,30
1683653536667,PSYC 131,A00,189036,Anagnostaras; Stephan,0,43,60,60
1683653540070,PSYC 136,A00,189041,Lowe; Angela Beth,0,7,25,25
1683653543630,PSYC 137,A00,189057,Winkielman; Piotr,0,37,25,25
1683653546990,PSYC 144,A00,189107,Wixted; John T,0,11,50,50
1683653554048,PSYC 162,A00,189142,Staff,0,9,85,85
1683653557564,PSYC 172,A00,189144,Gorman; Michael R.,0,6,30,30
1683653564387,PSYC 179,A00,189146,Lacefield; Katharine I,0,87,120,120
1683653567811,PSYC 181,A00,189147,Anagnostaras; Stephan,0,44,90,90
1683653571199,PSYC 190R,A00,189148,Barner; David A.,0,23,80,80
1683653574601,PSYC 191,A00,189275,Rickard; Timothy C.,0,10,25,25
1683653578069,PSYC 193,A00,189276,Chapman; Eddie Nathaniel,0,1,0,4
1683653581591,PSYC 193L,A01,189281,Lowe; Angela Beth,10,0,20,10
1683653581591,PSYC 193L,B01,189285,Staff,28,0,35,7
1683653585018,RELI 149,A00,187137,Rahimi; Babak,7,0,40,33
1683653588417,SE 9,A01,187315,Staff,0,2,18,18
1683653591776,SE 101B,A00,187409,Staff,24,0,30,6
1683653595126,SE 110B,A00,187444,Staff,10,0,40,30
1683653600868,SE 130B,A00,187449,Staff,31,0,40,9
1683653604206,SE 150A,A00,187516,Staff,9,0,20,11
1683653609960,SE 154,A00,187528,Staff,29,0,50,21
1683653615529,SIO 3,A01,258171,Staff,35,0,40,5
1683653618939,SIO 10,A00,187144,Cook; Geoffrey W,0,6,75,75
1683653622309,SIO 45,A00,187152,Cook; Geoffrey W,0,4,100,100
1683653625730,SIO 109R,A00,194486,Staff,0,4,20,20
1683653637351,SIO 187,A01,187233,Kacev; David,12,0,40,28
1683653642168,SOCI 1,A01,258656,Thorpe; Charles Robert,28,0,30,2
1683653642168,SOCI 1,A02,258658,Thorpe; Charles Robert,30,0,30,0
1683653642168,SOCI 1,A03,258661,Thorpe; Charles Robert,25,0,25,0
1683653642168,SOCI 1,A04,258666,Thorpe; Charles Robert,22,0,25,3
1683653642168,SOCI 1,A05,258897,Thorpe; Charles Robert,22,0,25,3
1683653642168,SOCI 1,A06,258898,Thorpe; Charles Robert,25,0,25,0
1683653645530,SOCI 30,A01,258903,Pardo Guerra; Juan Pablo,14,0,30,16
1683653648945,SOCI 102,A00,258904,Staff,9,0,25,16
1683653652290,SOCI 106,A00,258905,Staff,19,0,25,6
1683653655862,SOCI 111,A00,258907,Ribas Norris; Janet Vanesa,26,0,30,4
1683653660451,SOCI 121R,A00,258908,Pardo Guerra; Juan Pablo,8,0,30,22
1683653665148,SOCI 126,A01,203330,Staff,14,0,20,6
1683653670400,SOCI 131,A00,258909,Thorpe; Charles Robert,30,0,60,30
1683653675041,SOCI 135,A00,258910,Payne; Christine Anna,0,11,30,30
1683653678403,SOCI 157,A00,258911,Staff,12,0,30,18
1683653683110,SOCI 184,A00,258912,Staff,25,0,30,5
1683653686597,SOCI 188D,A00,258913,Staff,22,0,30,8
1683653690131,SYN 2,001,187529,Staff,9,0,16,7
1683653690131,SYN 2,002,201452,Staff,0,20,16,16
1683653690131,SYN 2,003,201469,Staff,2,0,16,14
1683653693441,SYN 100,A01,187531,Staff,0,9,20,20
1683653693441,SYN 100,B01,201491,Staff,0,10,20,20
1683653697959,TDAC 1,A00,189286,Walsh; Kim C.,3,0,20,17
1683653697959,TDAC 1,B00,189287,Harting; Carla Kelso,10,0,20,10
1683653702723,TDAC 101,A00,189300,Walsh; Kim C.,16,0,20,4
1683653702723,TDAC 101,B00,189301,Harting; Carla Kelso,18,0,20,2
1683653707646,TDAC 102,A00,189304,Basso; Beatrice,14,0,20,6
1683653711029,TDAC 108,A00,189305,Staff,18,0,20,2
1683653715712,TDDE 131,A00,189310,Staff,19,0,20,1
1683653715712,TDDE 131,B00,189314,Staff,19,0,20,1
1683653715712,TDDE 131,C00,189315,Staff,48,0,50,2
1683653715712,TDDE 131,D00,189316,Staff,14,0,15,1
1683653715712,TDDE 131,E00,204841,Staff,20,0,20,0
1683653720500,TDGE 10,A00,189289,Staff,27,0,50,23
1683653720500,TDGE 10,B00,189290,Havis; Allan,0,0,50,50
1683653723874,TDGE 11,A00,189291,Fulton; Julia,0,4,50,50
1683653723874,TDGE 11,B00,189292,Staff,20,0,25,5
1683653723874,TDGE 11,C00,260270,Staff,0,0,0,0
1683653727270,TDGE 25,A00,189294,Staff,2,0,20,18
1683653730734,TDGE 124,A00,189318,Fulton; Julia,0,8,50,50
1683653734138,TDGE 125,A00,189319,Staff,13,0,25,12
1683653734138,TDGE 125,B00,189320,Staff,23,0,25,2
1683653737611,TDGE 127,A00,189322,Havis; Allan,0,0,50,50
1683653740976,TDHT 101,A00,189323,Staff,18,0,25,7
1683653740976,TDHT 101,B00,189324,Staff,25,0,25,0
1683653745690,TDHT 102,A00,189325,Staff,49,0,50,1
1683653749022,TDMV 1,A00,189295,Arcidiacono; Kristin,20,0,30,10
1683653749022,TDMV 1,B00,189296,Caligagan; Maria T.,24,0,30,6
1683653752401,TDMV 2,A00,189297,Sammartano; Tonnie,27,0,30,3
1683653752401,TDMV 2,B00,189299,Arcidiacono; Kristin,23,0,30,7
1683653755746,TDMV 3,A00,204998,Rincon; Alicia,22,0,30,8
1683653759122,TDMV 120,A00,189458,Sammartano; Tonnie,28,0,30,2
1683653763790,TDMV 138,A00,189541,Jun; Grace Shin Hae,20,0,40,20
1683653771798,TDMV 142,A00,189717,Caligagan; Tony,25,0,30,5
1683653771798,TDMV 142,B00,189718,Caligagan; Maria T.,25,0,30,5
1683653775204,TMC 2,A01,187533,Staff,25,0,25,0
1683653775204,TMC 2,A02,187534,Staff,25,0,25,0
1683653778576,USP 1,A01,187536,Kwak; Nancy,0,16,25,25
1683653782009,USP 5,A01,187538,Staff,9,0,25,16
1683653785375,USP 101,A00,199253,Staff,0,4,0,0
1683653788763,USP 124,A00,187562,Boomhower; Matthew Charles,0,0,30,30
1683653792118,USP 138,A00,187582,Staff,20,0,25,5
1683653795529,USP 152,A01,187597,Staff,3,0,25,22
1683653798941,USP 153,A00,187598,Staff,19,0,25,6
1683653803613,USP 168,A00,187607,Kwak; Nancy,2,0,5,3
1683653812886,USP 173,A00,187619,Staff,4,0,25,21
1683653816324,USP 181,A00,187638,Staff,0,4,25,25
1683653819778,VIS 103,A00,187650,Cruz; Edwin Teddy,18,0,75,57
1683653823214,VIS 110D,A00,187669,Staff,13,0,22,9
1683653827789,VIS 127C,A00,187720,Shen; Kuiyi,67,0,146,79
1683653831101,VIS 149,A00,187731,Yoldas; Pinar,0,14,22,22
1683653835818,VIS 151,A01,188091,Staff,22,0,34,12
1683653835818,VIS 151,A02,188092,Staff,11,0,34,23
1683653840427,VIS 160B,A00,188093,Stalbaum; Brett,0,1,10,10
1683653847064,WCWP 10B,A00,201720,Staff,10,0,15,5
1683653847064,WCWP 10B,B00,201722,Staff,9,0,15,6
1683653857994,WCWP 100,A00,201725,Gagnon; Jeffrey C,0,0,2,2
1683653857994,WCWP 100,B00,201727,Staff,0,4,15,15
1683653881392,ANBI 133,A00,258401,Wilder; Linnea Lorene,34,0,40,6
1683653884828,ANBI 140,A00,258395,Hrvoj Mihic; Branka,18,0,25,7
1683653890088,ANSC 120,A00,258402,Bialecki; Jon Anthony,26,0,40,14
1683653893757,ANSC 144,A00,258400,Staff,12,0,40,28
1683653912966,ANSC 166,A00,258396,Parish; Steven Martin,156,0,175,19
1683653922260,ANSC 180,A00,193533,Staff,8,0,20,12
1683653925821,ANSC 188,A00,258397,Jassal; Aftab,34,0,40,6
1683653929776,ANTH 3,A01,258316,Staff,23,0,30,7
1683653934404,ANTH 5,A00,258394,Semendeferi; Ekaterini,16,0,20,4
1683653937889,ANTH 21,A01,258331,Staff,4,0,40,36
1683653941395,ANTH 103,A00,258398,Varma; Saiba,15,0,25,10
1683653949477,AWP 10,001,202034,Staff,0,0,0,0
1683653949477,AWP 10,002,202035,Staff,0,0,0,0
1683653949477,AWP 10,003,202036,Staff,0,0,0,0
1683653949477,AWP 10,004,202037,Staff,0,0,0,0
1683653949477,AWP 10,005,202038,Staff,0,0,0,0
1683653949477,AWP 10,006,202039,Staff,0,0,0,0
1683653949477,AWP 10,007,202040,Staff,0,0,0,0
1683653949477,AWP 10,008,202041,Staff,0,0,0,0
1683653949477,AWP 10,009,202042,Staff,0,0,0,0
1683653949477,AWP 10,010,202043,Staff,0,0,0,0
1683653949477,AWP 10,011,202044,Staff,0,0,0,0
1683653949477,AWP 10,012,202045,Staff,0,0,0,0
1683653949477,AWP 10,013,202046,Staff,0,0,0,0
1683653949477,AWP 10,014,202047,Staff,0,0,0,0
1683653949477,AWP 10,015,202048,Staff,0,0,0,0
1683653949477,AWP 10,016,202049,Staff,0,0,0,0
1683653949477,AWP 10,017,202050,Staff,0,0,0,0
1683653949477,AWP 10,018,202051,Staff,0,0,0,0
1683653949477,AWP 10,019,202052,Staff,0,0,0,0
1683653949477,AWP 10,020,202053,Staff,0,0,0,0
1683653949477,AWP 10,021,202054,Staff,0,0,0,0
1683653949477,AWP 10,022,202055,Staff,0,0,0,0
1683653949477,AWP 10,023,202056,Staff,0,0,0,0
1683653949477,AWP 10,024,202057,Staff,0,0,0,0
1683653949477,AWP 10,025,202058,Staff,0,0,0,0
1683653949477,AWP 10,026,202059,Staff,0,0,0,0
1683653959052,AWP 102,001,202032,Staff,0,0,0,0
1683653959052,AWP 102,002,202033,Staff,0,0,0,0
1683653962409,BENG 100,A01,254234,Taylor Amos; Alyssa C,31,0,40,9
1683653968186,BENG 196,001,270013,Engler; Adam J.,9999,0,9999,0
1683653973467,BICD 100R,A01,202018,Smith; Laurie,0,7,32,32
1683653973467,BICD 100R,A02,202019,Smith; Laurie,0,3,32,32
1683653973467,BICD 100R,A03,202020,Smith; Laurie,0,1,32,32
1683653973467,BICD 100R,A04,202021,Smith; Laurie,6,0,32,26
1683653973467,BICD 100R,A05,202022,Smith; Laurie,11,0,32,21
1683653978700,BICD 136,A01,193242,Gustafson-Brown; Cindy,0,2,32,32
1683653978700,BICD 136,A02,193244,Gustafson-Brown; Cindy,13,0,32,19
1683653984646,BIEB 102,A01,193249,Butler; Shannon Rhey,0,2,32,32
1683653984646,BIEB 102,A02,193251,Butler; Shannon Rhey,0,0,32,32
1683653984646,BIEB 102,A03,193253,Butler; Shannon Rhey,0,0,32,32
1683653984646,BIEB 102,A04,193255,Butler; Shannon Rhey,14,0,32,18
1683653984646,BIEB 102,A05,193265,Butler; Shannon Rhey,26,0,32,6
1683653984646,BIEB 102,A06,193269,Butler; Shannon Rhey,14,0,32,18
1683653992425,BIEB 150,A01,193274,Staff,0,0,32,32
1683653992425,BIEB 150,A02,193285,Staff,24,0,32,8
1683653995755,BIEB 194,A00,193286,Kurle; Carolyn M.,20,0,32,12
1683654001722,BILD 1,A01,192291,Staff,15,0,32,17
1683654001722,BILD 1,A02,192292,Staff,30,0,32,2
1683654001722,BILD 1,B01,192520,Reuther; Keefe,0,1,0,0
1683654001722,BILD 1,B02,192532,Reuther; Keefe,0,1,0,0
1683654005233,BILD 3,A01,192556,Butler; Shannon Rhey,0,0,32,32
1683654005233,BILD 3,A02,192581,Butler; Shannon Rhey,1,0,32,31
1683654005233,BILD 3,A03,192611,Butler; Shannon Rhey,21,0,32,11
1683654005233,BILD 3,A04,192612,Butler; Shannon Rhey,24,0,32,8
1683654005233,BILD 3,A05,192613,Butler; Shannon Rhey,26,0,32,6
1683654005233,BILD 3,A06,192679,Butler; Shannon Rhey,27,0,32,5
1683654005233,BILD 3,A07,192682,Butler; Shannon Rhey,20,0,32,12
1683654009971,BILD 4,A01,192836,Reuther; Keefe,1,0,24,23
1683654009971,BILD 4,A02,193044,Reuther; Keefe,4,0,24,20
1683654014765,BILD 10,A01,193142,Gustafson-Brown; Cindy,29,0,32,3
1683654014765,BILD 10,A02,193149,Gustafson-Brown; Cindy,31,0,32,1
1683654018174,BIMM 100,A01,193301,Staff,0,6,32,32
1683654018174,BIMM 100,A02,193312,Staff,0,7,32,32
1683654018174,BIMM 100,A03,193323,Staff,0,9,32,32
1683654025060,BIMM 101,A01,193329,McDonnell; Lisa Marie,0,4,24,24
1683654025060,BIMM 101,A02,193339,McDonnell; Lisa Marie,1,3,24,23
1683654025060,BIMM 101,B01,193354,McDonnell; Lisa Marie,0,4,24,24
1683654025060,BIMM 101,B02,193357,McDonnell; Lisa Marie,0,3,24,24
1683654032065,BIMM 110,A01,193377,Tat; John,0,11,32,32
1683654032065,BIMM 110,A02,193378,Tat; John,0,10,32,32
1683654041898,BIMM 120,A01,206116,Staff,0,0,32,32
1683654041898,BIMM 120,A02,206117,Staff,6,0,32,26
1683654041898,BIMM 120,A03,206121,Staff,21,0,32,11
1683654052282,BIPN 100,A01,193393,Park; Ji Young,0,14,32,32
1683654052282,BIPN 100,A02,193402,Park; Ji Young,0,14,32,32
1683654052282,BIPN 100,A03,193413,Park; Ji Young,0,14,32,32
1683654052282,BIPN 100,A04,193414,Park; Ji Young,0,13,32,32
1683654059276,BIPN 102,A01,193429,Staff,0,0,32,32
1683654059276,BIPN 102,A02,193438,Staff,18,0,32,14
1683654068500,BIPN 106,A01,193450,Reyes Gonzalez; Catalina,0,2,40,40
1683654078648,BIPN 134,A01,193465,Cooke; James Edward,0,0,32,32
1683654078648,BIPN 134,A02,193474,Cooke; James Edward,25,0,32,7
1683654078648,BIPN 134,A03,193485,Cooke; James Edward,29,0,32,3
1683654078648,BIPN 134,A04,193486,Cooke; James Edward,20,0,32,12
1683654078648,BIPN 134,A05,193491,Cooke; James Edward,31,0,32,1
1683654078648,BIPN 134,A06,193501,Cooke; James Edward,30,0,32,2
1683654078648,BIPN 134,A07,193510,Cooke; James Edward,29,0,32,3
1683654086702,BISP 194,A00,222522,Staff,14,0,32,18
1683654090139,CAT 124,A01,202407,Staff,19,0,25,6
1683654093510,CAT 125,A00,202408,Marchisotto; Jennifer Anne,2,0,20,18
1683654108210,CAT 125R,A00,202409,Smith; Lauryn Alissa,0,11,20,20
1683654108210,CAT 125R,B00,202410,Morales; Celeste Georgianna,0,11,20,20
1683654108210,CAT 125R,C00,202411,Irwin; Matthew Joseph,0,12,20,20
1683654114973,CENG 15,A01,204712,Yang; Kesong,0,1,0,0
1683654123879,CENG 114,A00,202070,Jahed Motlagh; Zeinab,5,0,20,15
1683654134238,CGS 105,A00,185477,Wesling; Megan E.,24,0,40,16
1683654144502,CGS 106,A00,185494,Staff,11,0,22,11
1683654150294,CGS 108,A00,185495,Staff,14,0,20,6
1683654159541,CGS 114,A00,185496,Staff,13,0,18,5
1683654181980,CGS 119,A00,185501,Staff,15,0,20,5
1683654188827,CGS 120,A00,185511,Staff,12,0,20,8
1683654196859,CHEM 4,A01,184675,Bussey; Thomas J,97,0,100,3
1683654203588,CHEM 6A,A01,184677,Staff,33,0,60,27
1683654208363,CHEM 6B,A01,184679,Staff,63,0,100,37
1683654211806,CHEM 6C,A01,184681,Bussey; Thomas J,0,0,50,50
1683654211806,CHEM 6C,A02,184682,Bussey; Thomas J,32,0,50,18
1683654215161,CHEM 40A,A01,184684,Albizati; Kim F.,34,0,100,66
1683654218599,CHEM 40B,A01,184686,Albizati; Kim F.,0,22,100,100
1683654222212,CHEM 41B,A01,184690,Staff,51,0,100,49
1683654232646,COGS 3,A01,184715,Boyle; Mary E. T.,0,27,40,40
1683654235967,COGS 14B,A01,185172,Staff,0,14,38,38
1683654242726,COGS 18,A01,184736,Staff,14,0,80,66
1683654251957,COGS 100,A01,184932,Staff,0,7,73,73
1683654255364,COGS 101A,A01,184935,Staff,0,39,30,30
1683654258746,COGS 101B,A01,184944,Staff,0,2,30,30
1683654265590,COGS 101C,A01,184946,Staff,0,10,30,30
1683654271090,COGS 102A,A01,184951,Johnson; Christine M.,2,0,40,38
1683654274573,COGS 107B,A01,184953,Mooshagian; Eric Frederick,0,51,40,40
1683654277990,COGS 118B,A01,184959,Gupta; Anjum,0,49,40,40
1683654281364,COGS 153,A00,184961,Staff,0,16,30,30
1683654285886,COGS 177,A00,184962,Staff,0,21,30,30
1683654289326,COGS 187A,A01,184969,Boyle; Mary E. T.,0,19,40,40
1683654297468,COMM 10,A01,185174,Staff,0,5,25,25
1683654297468,COMM 10,A02,185189,Staff,0,2,25,25
1683654297468,COMM 10,A03,269821,Staff,0,1,0,0
1683654311549,COMM 100B,A01,185475,Staff,0,1,0,2
1683654311549,COMM 100B,A02,185476,Staff,12,0,25,13
1683654315042,COMM 100C,A01,185314,Staff,1,0,25,24
1683654315042,COMM 100C,A02,185327,Staff,18,0,25,7
1683654325875,COMM 110M,A00,185349,Staff,0,0,40,40
1683654371368,COMM 114I,A00,185353,Staff,31,0,40,9
1683654385189,COMM 131,A00,185354,Staff,17,0,30,13
1683654398049,CSE 8A,A50,185358,Cao; Yingjun,0,46,10,10
1683654401425,CSE 8B,A01,185362,Staff,0,48,50,50
1683654411524,CSE 11,A01,185416,Cao; Yingjun,0,91,10,10
1683654422890,CSE 20,A01,185445,Briones; Jor-el Thomas Caparas,4,0,25,21
1683654431334,CSE 21,A01,185447,Staff,9,0,50,41
1683654436030,CSE 101,A01,185451,Staff,0,13,50,50
1683654436030,CSE 101,B01,185453,Jones; Miles E,0,13,50,50
1683654455259,CSE 141,A01,185458,Eldon; John,16,0,100,84
1683654495730,CSE 142,A01,185463,Staff,35,0,60,25
1683654495730,CSE 142,B01,201355,Staff,0,7,60,60
1683654628539,DSGN 100,A01,185168,Staff,0,2,25,25
1683654640331,ECE 5,A01,185626,Morris; Karcher William,0,11,0,0
1683654651290,ECE 101,A01,185628,Staff,14,0,70,56
1683654656869,ECE 107,A01,185635,Baghdadchi; Saharnaz,0,0,20,20
1683654656869,ECE 107,A02,185638,Baghdadchi; Saharnaz,3,0,20,17
1683654674468,ECE 148,A01,185647,Silberman; Jack,0,0,16,16
1683654683974,ECON 1,A01,185537,Crane; Meredith Helen,54,0,70,16
1683654689187,ECON 3,A01,185549,Crane; Meredith Helen,29,0,70,41
1683654694632,ECON 4,A01,203354,Anderson; John Charles,0,5,10,10
1683654699590,ECON 100A,A01,185574,Staff,0,5,40,40
1683654721463,ECON 100B,A01,185576,Staff,0,12,50,50
1683654753860,ECON 105,A00,185608,Vespa; Emanuel Ignacio,19,0,35,16
1683654758647,ECON 109,A01,185610,Shishkin; Denis,9,0,35,26
1683654763754,ECON 110A,A01,185612,Staff,9,0,40,31
1683654772645,ECON 120A,A01,185615,Staff,20,0,40,20
1683654777986,ECON 120C,A01,185617,Sun; Yixiao,0,20,70,70
1683654788750,ECON 144,A00,203346,Squires; Dale E,2,0,35,33
1683654792222,ECON 171,A01,203349,Newhouse; Herbert S,0,1,35,35
1683654811631,ECON 173A,A01,185621,Toda; Alexis Akira,21,0,35,14
1683654826954,EDS 25,A01,202413,Staff,0,1,0,0
1683654826954,EDS 25,A02,202414,Staff,0,1,0,0
1683654826954,EDS 25,A03,202415,Staff,0,0,0,0
1683654826954,EDS 25,A04,202416,Staff,0,1,0,0
1683654826954,EDS 25,A05,202439,Staff,0,0,0,0
1683654826954,EDS 25,A06,202440,Staff,0,0,0,0
1683654826954,EDS 25,B01,202631,Staff,0,0,0,0
1683654826954,EDS 25,B02,202632,Staff,0,0,0,0
1683654826954,EDS 25,B03,202639,Staff,0,0,0,0
1683654826954,EDS 25,B04,202640,Staff,0,0,0,0
1683654826954,EDS 25,B05,202643,Staff,0,0,0,0
1683654826954,EDS 25,B06,202644,Staff,0,0,0,0
1683654844246,EDS 38,A01,202659,Black; Alison Michelle,24,0,25,1
1683654862146,EDS 115,A00,202652,Staff,18,0,30,12
1683654874628,EDS 125,A00,202649,Staff,13,0,30,17
1683654882932,EDS 126,A01,203332,Staff,30,0,30,0
1683654886462,EDS 139,A00,202838,Staff,16,0,25,9
1683654891381,EDS 146,A01,202655,Staff,14,0,25,11
1683654898263,ENG 15,A00,185667,Staff,0,1,0,0
1683654898263,ENG 15,B00,185672,Staff,0,0,0,0
1683654898263,ENG 15,C00,185675,Staff,0,0,0,0
1683654898263,ENG 15,D00,185682,Staff,0,0,0,0
1683654898263,ENG 15,E00,185684,Staff,0,0,0,0
1683654905317,ETHN 103,A00,185710,Staff,0,8,35,35
1683654964557,ETHN 142,A00,185726,Staff,0,4,30,30
1683654985548,ETHN 163J,A00,199229,Man; Simeon S,5,0,8,3
1683655026941,ETHN 182,A00,185728,Staff,0,0,35,35
1683655041005,ETHN 183,A00,185737,Staff,9,0,18,9
1683655050511,GLBH 111,A01,209361,Burgos; Jose L.,0,0,0,0
1683655112776,HIEU 115,A00,185800,Staff,0,0,20,20
