time,subj_course_id,sec_code,sec_id,prof,available,waitlist,total,enrolled_ct
1683285246987,ANBI 133,A00,258401,Wilder; Linnea Lorene,34,0,40,6
1683285248018,ANBI 140,A00,258395,Hrvoj Mihic; Branka,18,0,25,7
1683285249049,ANSC 120,A00,258402,Bialecki; Jon Anthony,27,0,40,13
1683285250075,ANSC 144,A00,258400,Staff,14,0,40,26
1683285252127,ANSC 166,A00,258396,Parish; Steven Martin,157,0,175,18
1683285253156,ANSC 180,A00,193533,Staff,9,0,20,11
1683285254183,ANSC 188,A00,258397,Jassal; Aftab,33,0,40,7
1683285255207,ANTH 3,A01,258316,Staff,23,0,30,7
1683285256238,ANTH 5,A00,258394,Semendeferi; Ekaterini,16,0,20,4
1683285257264,ANTH 21,A01,258331,Staff,9,0,40,31
1683285258290,ANTH 103,A00,258398,Varma; Saiba,15,0,25,10
1683285259319,AWP 10,001,202034,Staff,0,0,0,0
1683285259319,AWP 10,002,202035,Staff,0,0,0,0
1683285259319,AWP 10,003,202036,Staff,0,0,0,0
1683285259319,AWP 10,004,202037,Staff,0,0,0,0
1683285259319,AWP 10,005,202038,Staff,0,0,0,0
1683285259319,AWP 10,006,202039,Staff,0,0,0,0
1683285259319,AWP 10,007,202040,Staff,0,0,0,0
1683285259319,AWP 10,008,202041,Staff,0,0,0,0
1683285259319,AWP 10,009,202042,Staff,0,0,0,0
1683285259319,AWP 10,010,202043,Staff,0,0,0,0
1683285259319,AWP 10,011,202044,Staff,0,0,0,0
1683285259319,AWP 10,012,202045,Staff,0,0,0,0
1683285259319,AWP 10,013,202046,Staff,0,0,0,0
1683285259319,AWP 10,014,202047,Staff,0,0,0,0
1683285259319,AWP 10,015,202048,Staff,0,0,0,0
1683285259319,AWP 10,016,202049,Staff,0,0,0,0
1683285259319,AWP 10,017,202050,Staff,0,0,0,0
1683285259319,AWP 10,018,202051,Staff,0,0,0,0
1683285259319,AWP 10,019,202052,Staff,0,0,0,0
1683285259319,AWP 10,020,202053,Staff,0,0,0,0
1683285259319,AWP 10,021,202054,Staff,0,0,0,0
1683285259319,AWP 10,022,202055,Staff,0,0,0,0
1683285259319,AWP 10,023,202056,Staff,0,0,0,0
1683285259319,AWP 10,024,202057,Staff,0,0,0,0
1683285259319,AWP 10,025,202058,Staff,0,0,0,0
1683285259319,AWP 10,026,202059,Staff,0,0,0,0
1683285260348,AWP 102,001,202032,Staff,0,0,0,0
1683285260348,AWP 102,002,202033,Staff,0,0,0,0
1683285261380,BENG 100,A01,254234,Taylor Amos; Alyssa C,31,0,40,9
1683285262411,BENG 196,001,270013,Engler; Adam J.,9999,0,9999,0
1683285263446,BICD 100R,A01,202018,Smith; Laurie,0,7,32,32
1683285263446,BICD 100R,A02,202019,Smith; Laurie,0,2,32,32
1683285263446,BICD 100R,A03,202020,Smith; Laurie,0,1,32,32
1683285263446,BICD 100R,A04,202021,Smith; Laurie,8,0,32,24
1683285263446,BICD 100R,A05,202022,Smith; Laurie,12,0,32,20
1683285264475,BICD 136,A01,193242,Gustafson-Brown; Cindy,0,2,32,32
1683285264475,BICD 136,A02,193244,Gustafson-Brown; Cindy,15,0,32,17
1683285265504,BIEB 102,A01,193249,Butler; Shannon Rhey,0,2,32,32
1683285265504,BIEB 102,A02,193251,Butler; Shannon Rhey,0,0,32,32
1683285265504,BIEB 102,A03,193253,Butler; Shannon Rhey,0,1,32,32
1683285265504,BIEB 102,A04,193255,Butler; Shannon Rhey,17,0,32,15
1683285265504,BIEB 102,A05,193265,Butler; Shannon Rhey,26,0,32,6
1683285265504,BIEB 102,A06,193269,Butler; Shannon Rhey,16,0,32,16
1683285267560,BIEB 150,A01,193274,Staff,0,0,32,32
1683285267560,BIEB 150,A02,193285,Staff,24,0,32,8
1683285268588,BIEB 194,A00,193286,Kurle; Carolyn M.,22,0,32,10
1683285269623,BILD 1,A01,192291,Staff,16,0,32,16
1683285269623,BILD 1,A02,192292,Staff,30,0,32,2
1683285269623,BILD 1,B01,192520,Reuther; Keefe,0,1,0,0
1683285269623,BILD 1,B02,192532,Reuther; Keefe,0,1,0,0
1683285270649,BILD 3,A01,192556,Butler; Shannon Rhey,0,0,32,32
1683285270649,BILD 3,A02,192581,Butler; Shannon Rhey,5,0,32,27
1683285270649,BILD 3,A03,192611,Butler; Shannon Rhey,23,0,32,9
1683285270649,BILD 3,A04,192612,Butler; Shannon Rhey,25,0,32,7
1683285270649,BILD 3,A05,192613,Butler; Shannon Rhey,27,0,32,5
1683285270649,BILD 3,A06,192679,Butler; Shannon Rhey,27,0,32,5
1683285270649,BILD 3,A07,192682,Butler; Shannon Rhey,22,0,32,10
1683285271677,BILD 4,A01,192836,Reuther; Keefe,1,0,24,23
1683285271677,BILD 4,A02,193044,Reuther; Keefe,4,0,24,20
1683285272707,BILD 10,A01,193142,Gustafson-Brown; Cindy,31,0,32,1
1683285272707,BILD 10,A02,193149,Gustafson-Brown; Cindy,31,0,32,1
1683285273735,BIMM 100,A01,193301,Staff,0,6,32,32
1683285273735,BIMM 100,A02,193312,Staff,0,5,32,32
1683285273735,BIMM 100,A03,193323,Staff,0,8,32,32
1683285274762,BIMM 101,A01,193329,McDonnell; Lisa Marie,0,3,24,24
1683285274762,BIMM 101,A02,193339,McDonnell; Lisa Marie,0,2,24,24
1683285274762,BIMM 101,B01,193354,McDonnell; Lisa Marie,0,3,24,24
1683285274762,BIMM 101,B02,193357,McDonnell; Lisa Marie,0,3,24,24
1683285275789,BIMM 110,A01,193377,Tat; John,0,11,32,32
1683285275789,BIMM 110,A02,193378,Tat; John,1,9,32,31
1683285276823,BIMM 120,A01,206116,Staff,0,0,32,32
1683285276823,BIMM 120,A02,206117,Staff,8,0,32,24
1683285276823,BIMM 120,A03,206121,Staff,21,0,32,11
1683285277851,BIPN 100,A01,193393,Park; Ji Young,0,14,32,32
1683285277851,BIPN 100,A02,193402,Park; Ji Young,0,12,32,32
1683285277851,BIPN 100,A03,193413,Park; Ji Young,0,14,32,32
1683285277851,BIPN 100,A04,193414,Park; Ji Young,0,13,32,32
1683285278877,BIPN 102,A01,193429,Staff,0,0,32,32
1683285278877,BIPN 102,A02,193438,Staff,23,0,32,9
1683285279907,BIPN 106,A01,193450,Reyes Gonzalez; Catalina,0,2,40,40
1683285280933,BIPN 134,A01,193465,Cooke; James Edward,0,0,32,32
1683285280933,BIPN 134,A02,193474,Cooke; James Edward,27,0,32,5
1683285280933,BIPN 134,A03,193485,Cooke; James Edward,29,0,32,3
1683285280933,BIPN 134,A04,193486,Cooke; James Edward,21,0,32,11
1683285280933,BIPN 134,A05,193491,Cooke; James Edward,31,0,32,1
1683285280933,BIPN 134,A06,193501,Cooke; James Edward,30,0,32,2
1683285280933,BIPN 134,A07,193510,Cooke; James Edward,29,0,32,3
1683285282986,BISP 194,A00,222522,Staff,16,0,32,16
1683285284015,CAT 124,A01,202407,Staff,20,0,25,5
1683285285042,CAT 125,A00,202408,Marchisotto; Jennifer Anne,4,0,20,16
1683285286072,CAT 125R,A00,202409,Smith; Lauryn Alissa,0,11,20,20
1683285286072,CAT 125R,B00,202410,Morales; Celeste Georgianna,0,11,20,20
1683285286072,CAT 125R,C00,202411,Irwin; Matthew Joseph,0,10,20,20
1683285287100,CENG 15,A01,204712,Yang; Kesong,0,1,0,0
1683285288126,CENG 114,A00,202070,Jahed Motlagh; Zeinab,5,0,20,15
1683285289155,CGS 105,A00,185477,Wesling; Megan E.,24,0,40,16
1683285290180,CGS 106,A00,185494,Staff,13,0,22,9
1683285291206,CGS 108,A00,185495,Staff,14,0,20,6
1683285292232,CGS 114,A00,185496,Staff,13,0,18,5
1683285293258,CGS 119,A00,185501,Staff,15,0,20,5
1683285294283,CGS 120,A00,185511,Staff,13,0,20,7
1683285295310,CHEM 4,A01,184675,Bussey; Thomas J,96,0,100,4
1683285296337,CHEM 6A,A01,184677,Staff,35,0,60,25
1683285297365,CHEM 6B,A01,184679,Staff,65,0,100,35
1683285298393,CHEM 6C,A01,184681,Bussey; Thomas J,1,0,50,49
1683285298393,CHEM 6C,A02,184682,Bussey; Thomas J,34,0,50,16
1683285299420,CHEM 40A,A01,184684,Albizati; Kim F.,37,0,100,63
1683285300447,CHEM 40B,A01,184686,Albizati; Kim F.,0,20,100,100
1683285301472,CHEM 41B,A01,184690,Staff,52,0,100,48
1683285302502,COGS 3,A01,184715,Boyle; Mary E. T.,0,25,40,40
1683285303534,COGS 14B,A01,185172,Staff,0,15,38,38
1683285304558,COGS 18,A01,184736,Staff,20,0,80,60
1683285305587,COGS 100,A01,184932,Staff,0,5,73,73
1683285306611,COGS 101A,A01,184935,Staff,0,38,30,30
1683285307635,COGS 101B,A01,184944,Staff,0,2,30,30
1683285308663,COGS 101C,A01,184946,Staff,0,12,30,30
1683285309702,COGS 102A,A01,184951,Johnson; Christine M.,2,0,40,38
1683285310733,COGS 107B,A01,184953,Mooshagian; Eric Frederick,0,50,40,40
1683285311760,COGS 118B,A01,184959,Gupta; Anjum,0,48,40,40
1683285312789,COGS 153,A00,184961,Staff,0,15,30,30
1683285313822,COGS 177,A00,184962,Staff,0,21,30,30
1683285314851,COGS 187A,A01,184969,Boyle; Mary E. T.,0,17,40,40
1683285315879,COMM 10,A01,185174,Staff,0,5,25,25
1683285315879,COMM 10,A02,185189,Staff,0,5,25,25
1683285315879,COMM 10,A03,269821,Staff,0,0,0,0
1683285316908,COMM 100B,A01,185475,Staff,0,0,0,2
1683285316908,COMM 100B,A02,185476,Staff,14,0,25,11
1683285317934,COMM 100C,A01,185314,Staff,1,0,25,24
1683285317934,COMM 100C,A02,185327,Staff,19,0,25,6
1683285318960,COMM 110M,A00,185349,Staff,2,0,40,38
1683285319988,COMM 113T,A00,185352,Staff,25,0,40,15
1683285321014,COMM 114I,A00,185353,Staff,33,0,40,7
1683285322040,COMM 131,A00,185354,Staff,19,0,30,11
