time,subj_course_id,sec_code,sec_id,prof,available,waitlist,total,enrolled_ct
1683669922680,ANBI 133,A00,258401,Wilder; Linnea Lorene,34,0,40,6
1683669923706,ANBI 140,A00,258395,Hrvoj Mihic; Branka,18,0,25,7
1683669924733,ANSC 120,A00,258402,Bialecki; Jon Anthony,26,0,40,14
1683669925763,ANSC 144,A00,258400,Staff,12,0,40,28
1683669927962,ANSC 166,A00,258396,Parish; Steven Martin,156,0,175,19
1683669928992,ANSC 180,A00,193533,Staff,8,0,20,12
1683669930025,ANSC 188,A00,258397,Jassal; Aftab,34,0,40,6
1683669931061,ANTH 3,A01,258316,Staff,23,0,30,7
1683669932088,ANTH 5,A00,258394,Semendeferi; Ekaterini,16,0,20,4
1683669933117,ANTH 21,A01,258331,Staff,4,0,40,36
1683669934146,ANTH 103,A00,258398,Varma; Saiba,15,0,25,10
1683669935174,AWP 10,001,202034,Staff,0,0,0,0
1683669935174,AWP 10,002,202035,Staff,0,0,0,0
1683669935174,AWP 10,003,202036,Staff,0,0,0,0
1683669935174,AWP 10,004,202037,Staff,0,0,0,0
1683669935174,AWP 10,005,202038,Staff,0,0,0,0
1683669935174,AWP 10,006,202039,Staff,0,0,0,0
1683669935174,AWP 10,007,202040,Staff,0,0,0,0
1683669935174,AWP 10,008,202041,Staff,0,0,0,0
1683669935174,AWP 10,009,202042,Staff,0,0,0,0
1683669935174,AWP 10,010,202043,Staff,0,0,0,0
1683669935174,AWP 10,011,202044,Staff,0,0,0,0
1683669935174,AWP 10,012,202045,Staff,0,0,0,0
1683669935174,AWP 10,013,202046,Staff,0,0,0,0
1683669935174,AWP 10,014,202047,Staff,0,0,0,0
1683669935174,AWP 10,015,202048,Staff,0,0,0,0
1683669935174,AWP 10,016,202049,Staff,0,0,0,0
1683669935174,AWP 10,017,202050,Staff,0,0,0,0
1683669935174,AWP 10,018,202051,Staff,0,0,0,0
1683669935174,AWP 10,019,202052,Staff,0,0,0,0
1683669935174,AWP 10,020,202053,Staff,0,0,0,0
1683669935174,AWP 10,021,202054,Staff,0,0,0,0
1683669935174,AWP 10,022,202055,Staff,0,0,0,0
1683669935174,AWP 10,023,202056,Staff,0,0,0,0
1683669935174,AWP 10,024,202057,Staff,0,0,0,0
1683669935174,AWP 10,025,202058,Staff,0,0,0,0
1683669935174,AWP 10,026,202059,Staff,0,0,0,0
1683669936214,AWP 102,001,202032,Staff,0,0,0,0
1683669936214,AWP 102,002,202033,Staff,0,0,0,0
1683669937240,BENG 100,A01,254234,Taylor Amos; Alyssa C,31,0,40,9
1683669938269,BENG 196,001,270013,Engler; Adam J.,9999,0,9999,0
1683669939296,BICD 100R,A01,202018,Smith; Laurie,0,7,32,32
1683669939296,BICD 100R,A02,202019,Smith; Laurie,0,3,32,32
1683669939296,BICD 100R,A03,202020,Smith; Laurie,0,1,32,32
1683669939296,BICD 100R,A04,202021,Smith; Laurie,6,0,32,26
1683669939296,BICD 100R,A05,202022,Smith; Laurie,11,0,32,21
1683669940325,BICD 136,A01,193242,Gustafson-Brown; Cindy,0,2,32,32
1683669940325,BICD 136,A02,193244,Gustafson-Brown; Cindy,13,0,32,19
1683669941353,BIEB 102,A01,193249,Butler; Shannon Rhey,1,2,32,31
1683669941353,BIEB 102,A02,193251,Butler; Shannon Rhey,0,0,32,32
1683669941353,BIEB 102,A03,193253,Butler; Shannon Rhey,0,0,32,32
1683669941353,BIEB 102,A04,193255,Butler; Shannon Rhey,13,0,32,19
1683669941353,BIEB 102,A05,193265,Butler; Shannon Rhey,25,0,32,7
1683669941353,BIEB 102,A06,193269,Butler; Shannon Rhey,14,0,32,18
1683669943407,BIEB 150,A01,193274,Staff,0,0,32,32
1683669943407,BIEB 150,A02,193285,Staff,24,0,32,8
1683669944437,BIEB 194,A00,193286,Kurle; Carolyn M.,20,0,32,12
1683669945462,BILD 1,A01,192291,Staff,15,0,32,17
1683669945462,BILD 1,A02,192292,Staff,30,0,32,2
1683669945462,BILD 1,B01,192520,Reuther; Keefe,0,1,0,0
1683669945462,BILD 1,B02,192532,Reuther; Keefe,0,1,0,0
1683669946497,BILD 3,A01,192556,Butler; Shannon Rhey,0,0,32,32
1683669946497,BILD 3,A02,192581,Butler; Shannon Rhey,0,0,32,32
1683669946497,BILD 3,A03,192611,Butler; Shannon Rhey,20,0,32,12
1683669946497,BILD 3,A04,192612,Butler; Shannon Rhey,24,0,32,8
1683669946497,BILD 3,A05,192613,Butler; Shannon Rhey,26,0,32,6
1683669946497,BILD 3,A06,192679,Butler; Shannon Rhey,27,0,32,5
1683669946497,BILD 3,A07,192682,Butler; Shannon Rhey,20,0,32,12
1683669947527,BILD 4,A01,192836,Reuther; Keefe,1,0,24,23
1683669947527,BILD 4,A02,193044,Reuther; Keefe,4,0,24,20
1683669948559,BILD 10,A01,193142,Gustafson-Brown; Cindy,29,0,32,3
1683669948559,BILD 10,A02,193149,Gustafson-Brown; Cindy,31,0,32,1
1683669949586,BIMM 100,A01,193301,Staff,0,6,32,32
1683669949586,BIMM 100,A02,193312,Staff,0,7,32,32
1683669949586,BIMM 100,A03,193323,Staff,0,9,32,32
1683669950614,BIMM 101,A01,193329,McDonnell; Lisa Marie,1,4,24,23
1683669950614,BIMM 101,A02,193339,McDonnell; Lisa Marie,1,4,24,23
1683669950614,BIMM 101,B01,193354,McDonnell; Lisa Marie,0,4,24,24
1683669950614,BIMM 101,B02,193357,McDonnell; Lisa Marie,0,3,24,24
1683669951644,BIMM 110,A01,193377,Tat; John,0,11,32,32
1683669951644,BIMM 110,A02,193378,Tat; John,0,10,32,32
1683669952671,BIMM 120,A01,206116,Staff,0,0,32,32
1683669952671,BIMM 120,A02,206117,Staff,7,0,32,25
1683669952671,BIMM 120,A03,206121,Staff,21,0,32,11
1683669953703,BIPN 100,A01,193393,Park; Ji Young,0,15,32,32
1683669953703,BIPN 100,A02,193402,Park; Ji Young,0,14,32,32
1683669953703,BIPN 100,A03,193413,Park; Ji Young,0,14,32,32
1683669953703,BIPN 100,A04,193414,Park; Ji Young,0,13,32,32
1683669954734,BIPN 102,A01,193429,Staff,0,0,32,32
1683669954734,BIPN 102,A02,193438,Staff,18,0,32,14
1683669955765,BIPN 106,A01,193450,Reyes Gonzalez; Catalina,0,2,40,40
1683669956792,BIPN 134,A01,193465,Cooke; James Edward,0,0,32,32
1683669956792,BIPN 134,A02,193474,Cooke; James Edward,25,0,32,7
1683669956792,BIPN 134,A03,193485,Cooke; James Edward,29,0,32,3
1683669956792,BIPN 134,A04,193486,Cooke; James Edward,20,0,32,12
1683669956792,BIPN 134,A05,193491,Cooke; James Edward,31,0,32,1
1683669956792,BIPN 134,A06,193501,Cooke; James Edward,30,0,32,2
1683669956792,BIPN 134,A07,193510,Cooke; James Edward,29,0,32,3
1683669958851,BISP 194,A00,222522,Staff,14,0,32,18
1683669959875,CAT 124,A01,202407,Staff,19,0,25,6
1683669960901,CAT 125,A00,202408,Marchisotto; Jennifer Anne,2,0,20,18
1683669961929,CAT 125R,A00,202409,Smith; Lauryn Alissa,0,11,20,20
1683669961929,CAT 125R,B00,202410,Morales; Celeste Georgianna,0,11,20,20
1683669961929,CAT 125R,C00,202411,Irwin; Matthew Joseph,0,12,20,20
1683669962957,CENG 15,A01,204712,Yang; Kesong,0,1,0,0
1683669963984,CENG 114,A00,202070,Jahed Motlagh; Zeinab,5,0,20,15
1683669965013,CGS 105,A00,185477,Wesling; Megan E.,24,0,40,16
1683669966040,CGS 106,A00,185494,Staff,11,0,22,11
1683669967070,CGS 108,A00,185495,Staff,14,0,20,6
1683669968097,CGS 114,A00,185496,Staff,13,0,18,5
1683669969126,CGS 119,A00,185501,Staff,15,0,20,5
1683669970153,CGS 120,A00,185511,Staff,12,0,20,8
1683669971180,CHEM 4,A01,184675,Bussey; Thomas J,97,0,100,3
1683669972212,CHEM 6A,A01,184677,Staff,32,0,60,28
1683669973239,CHEM 6B,A01,184679,Staff,63,0,100,37
1683669974265,CHEM 6C,A01,184681,Bussey; Thomas J,0,0,50,50
1683669974265,CHEM 6C,A02,184682,Bussey; Thomas J,32,0,50,18
1683669975293,CHEM 40A,A01,184684,Albizati; Kim F.,34,0,100,66
1683669976319,CHEM 40B,A01,184686,Albizati; Kim F.,0,22,100,100
1683669977347,CHEM 41B,A01,184690,Staff,51,0,100,49
1683669978376,COGS 3,A01,184715,Boyle; Mary E. T.,0,27,40,40
1683669979404,COGS 14B,A01,185172,Staff,0,14,38,38
1683669980431,COGS 18,A01,184736,Staff,14,0,80,66
1683669981458,COGS 100,A01,184932,Staff,0,8,73,73
1683669982488,COGS 101A,A01,184935,Staff,0,40,30,30
1683669983519,COGS 101B,A01,184944,Staff,0,2,30,30
1683669984551,COGS 101C,A01,184946,Staff,0,10,30,30
1683669985579,COGS 102A,A01,184951,Johnson; Christine M.,2,0,40,38
1683669986609,COGS 107B,A01,184953,Mooshagian; Eric Frederick,0,51,40,40
1683669987637,COGS 118B,A01,184959,Gupta; Anjum,0,50,40,40
1683669988666,COGS 153,A00,184961,Staff,0,16,30,30
1683669989696,COGS 177,A00,184962,Staff,0,21,30,30
1683669990725,COGS 187A,A01,184969,Boyle; Mary E. T.,0,19,40,40
1683669991753,COMM 10,A01,185174,Staff,0,5,25,25
1683669991753,COMM 10,A02,185189,Staff,0,2,25,25
1683669991753,COMM 10,A03,269821,Staff,0,1,0,0
1683669992780,COMM 100B,A01,185475,Staff,0,1,0,2
1683669992780,COMM 100B,A02,185476,Staff,12,0,25,13
1683669993808,COMM 100C,A01,185314,Staff,1,0,25,24
1683669993808,COMM 100C,A02,185327,Staff,17,0,25,8
1683669994835,COMM 110M,A00,185349,Staff,0,0,40,40
1683669995863,COMM 113T,A00,185352,Staff,25,0,40,15
1683669996894,COMM 114I,A00,185353,Staff,31,0,40,9
1683669997920,COMM 131,A00,185354,Staff,17,0,30,13
1683669998948,CSE 8A,A50,185358,Cao; Yingjun,0,46,10,10
1683669999980,CSE 8B,A01,185362,Staff,0,48,50,50
1683670001007,CSE 11,A01,185416,Cao; Yingjun,0,91,10,10
1683670002035,CSE 20,A01,185445,Briones; Jor-el Thomas Caparas,4,0,25,21
1683670003062,CSE 21,A01,185447,Staff,9,0,50,41
1683670004094,CSE 101,A01,185451,Staff,0,13,50,50
1683670004094,CSE 101,B01,185453,Jones; Miles E,0,14,50,50
1683670006153,CSE 141,A01,185458,Eldon; John,16,0,100,84
1683670007185,CSE 141L,A01,185461,Eldon; John,8,0,100,92
1683670008216,CSE 142,A01,185463,Staff,34,0,60,26
1683670008216,CSE 142,B01,201355,Staff,0,7,60,60
1683670009242,CSE 142L,A01,185470,Staff,34,0,60,26
1683670009242,CSE 142L,B01,201417,Staff,0,6,60,60
1683670010270,CSE 190,A00,201433,Staff,32,0,49,17
1683670011302,DOC 1,A01,259136,Strom; Megan C.,7,0,15,8
1683670011302,DOC 1,A02,259137,Strom; Megan C.,14,0,15,1
1683670011302,DOC 1,A03,259138,Strom; Megan C.,14,0,15,1
1683670011302,DOC 1,A04,259139,Strom; Megan C.,14,0,15,1
1683670012329,DOC 100D,A00,259140,Pass; Natalye Joann,14,0,25,11
1683670013356,DSGN 1,A01,184749,Rill; Bryan,0,26,30,30
1683670014383,DSGN 100,A01,185168,Staff,0,2,25,25
1683670015409,ECE 5,A01,185626,Morris; Karcher William,0,12,0,0
1683670016439,ECE 101,A01,185628,Staff,14,0,70,56
1683670017467,ECE 107,A01,185635,Baghdadchi; Saharnaz,0,0,20,20
1683670017467,ECE 107,A02,185638,Baghdadchi; Saharnaz,1,0,20,19
1683670018495,ECE 148,A01,185647,Silberman; Jack,0,0,16,16
1683670019522,ECON 1,A01,185537,Crane; Meredith Helen,54,0,70,16
1683670020549,ECON 3,A01,185549,Crane; Meredith Helen,29,0,70,41
1683670021635,ECON 4,A01,203354,Anderson; John Charles,0,5,10,10
1683670022660,ECON 100A,A01,185574,Staff,0,5,40,40
1683670023691,ECON 100B,A01,185576,Staff,0,12,50,50
1683670024722,ECON 100C,A01,185589,Newhouse; Herbert S,30,0,70,40
1683670025750,ECON 105,A00,185608,Vespa; Emanuel Ignacio,19,0,35,16
1683670026779,ECON 109,A01,185610,Shishkin; Denis,9,0,35,26
1683670027808,ECON 110A,A01,185612,Staff,9,0,40,31
1683670028833,ECON 120A,A01,185615,Staff,19,0,40,21
1683670029863,ECON 120C,A01,185617,Sun; Yixiao,0,20,70,70
1683670030893,ECON 144,A00,203346,Squires; Dale E,2,0,35,33
1683670031921,ECON 171,A01,203349,Newhouse; Herbert S,0,1,35,35
1683670032950,ECON 173A,A01,185621,Toda; Alexis Akira,20,0,35,15
1683670033983,EDS 25,A01,202413,Staff,0,1,0,0
1683670033983,EDS 25,A02,202414,Staff,0,1,0,0
1683670033983,EDS 25,A03,202415,Staff,0,0,0,0
1683670033983,EDS 25,A04,202416,Staff,0,1,0,0
1683670033983,EDS 25,A05,202439,Staff,0,0,0,0
1683670033983,EDS 25,A06,202440,Staff,0,0,0,0
1683670033983,EDS 25,B01,202631,Staff,0,0,0,0
1683670033983,EDS 25,B02,202632,Staff,0,0,0,0
1683670033983,EDS 25,B03,202639,Staff,0,0,0,0
1683670033983,EDS 25,B04,202640,Staff,0,0,0,0
1683670033983,EDS 25,B05,202643,Staff,0,0,0,0
1683670033983,EDS 25,B06,202644,Staff,0,0,0,0
1683670035009,EDS 38,A01,202659,Black; Alison Michelle,24,0,25,1
1683670036036,EDS 115,A00,202652,Staff,18,0,30,12
1683670037064,EDS 125,A00,202649,Staff,13,0,30,17
1683670038090,EDS 126,A01,203332,Staff,30,0,30,0
1683670039115,EDS 139,A00,202838,Staff,16,0,25,9
1683670040146,EDS 146,A01,202655,Staff,14,0,25,11
1683670041175,ENG 15,A00,185667,Staff,0,1,0,0
1683670041175,ENG 15,B00,185672,Staff,0,0,0,0
1683670041175,ENG 15,C00,185675,Staff,0,0,0,0
1683670041175,ENG 15,D00,185682,Staff,0,0,0,0
1683670041175,ENG 15,E00,185684,Staff,0,0,0,0
1683670042201,ETHN 103,A00,185710,Staff,0,8,35,35
1683670043227,ETHN 103A,A00,199228,Man; Simeon S,0,0,9,9
1683670044256,ETHN 109,A00,185711,Staff,15,0,35,20
1683670045285,ETHN 142,A00,185726,Staff,0,4,30,30
1683670046315,ETHN 163J,A00,199229,Man; Simeon S,5,0,8,3
1683670047341,ETHN 168,A00,185727,Staff,7,0,10,3
1683670048367,ETHN 182,A00,185728,Staff,0,0,35,35
1683670049399,ETHN 183,A00,185737,Staff,9,0,18,9
1683670050429,GLBH 111,A01,209361,Burgos; Jose L.,0,0,0,0
1683670052482,HIEU 104,A00,185792,Staff,14,0,20,6
1683670053511,HIEU 115,A00,185800,Staff,0,0,20,20
1683670054538,HIEU 128,A00,185801,Staff,0,9,20,20
1683670055565,HIEU 147,A00,185802,Staff,15,0,20,5
1683670056590,HIEU 154,A00,185823,Staff,11,0,20,9
1683670057618,HILA 102,A00,185826,Staff,14,0,20,6
1683670058645,HILD 2C,A01,185778,Staff,0,13,20,20
1683670059673,HILD 7B,A01,185780,Kwak; Nancy,0,17,32,32
1683670059673,HILD 7B,A02,185781,Kwak; Nancy,0,18,32,32
1683670060698,HILD 30,A01,185791,Staff,12,0,20,8
1683670061728,HISC 119,A00,185830,Golan; Tal,0,9,20,20
1683670062752,HITO 156GS,A00,185831,Patterson; Patrick H.,0,0,0,23
1683670063781,HIUS 103,A00,185832,Man; Simeon S,0,4,20,20
1683670064807,HIUS 117,A00,185836,Kwak; Nancy,2,0,20,18
1683670065832,HIUS 125,A00,185840,Man; Simeon S,0,2,23,23
1683670066857,HIUS 149,A00,185845,Staff,1,0,20,19
1683670067889,HUM 3,A01,185882,Zavodny; Tatiana Sophia,0,8,50,50
1683670067889,HUM 3,B01,185899,Caldwell; Michael Alan,0,18,50,50
1683670068919,HUM 3GS,A00,185900,Patterson; Patrick H.,0,0,0,23
1683670069949,HUM 4,A01,185938,Zroka; Amy Liane,29,0,50,21
1683670069949,HUM 4,B01,185956,Watkins; Eric,0,5,50,50
1683670069949,HUM 4,B02,202209,Watkins; Eric,0,5,50,50
1683670069949,HUM 4,B03,202210,Watkins; Eric,0,5,50,50
1683670070975,HUM 5,A01,185958,West; Geoffrey Scott,0,0,50,50
1683670070975,HUM 5,A02,202215,West; Geoffrey Scott,0,0,50,50
1683670072001,INTL 190,A00,185959,Gagnon; Jeffrey C,0,0,0,9
1683670072001,INTL 190,B00,185960,Lettieri; Michael Joseph,0,0,0,2
1683670073027,JAPN 180,A00,254509,Staff,5,0,30,25
1683670074053,LATI 10,A01,202853,Kennemore; Amy Michelle,4,0,35,31
1683670074053,LATI 10,A02,202854,Kennemore; Amy Michelle,2,0,35,33
1683670074053,LATI 10,A03,270054,Kennemore; Amy Michelle,30,0,30,0
1683670075077,LATI 180,A00,202855,Kennemore; Amy Michelle,11,0,20,9
1683670076104,LAWS 101,A00,201767,Golan; Tal,0,7,40,40
1683670077133,LIFR 1C,A00,185961,Staff,6,0,20,14
1683670078156,LIFR 1CX,A00,185962,Staff,7,0,20,13
1683670079181,LIFR 1D,A00,185963,Staff,7,0,20,13
1683670080209,LIFR 1DX,A00,185964,Staff,7,0,20,13
1683670081235,LIGN 101,A01,186039,Staff,43,0,50,7
1683670082262,LIGN 165,A00,186040,Staff,15,0,50,35
1683670083291,LTCS 108,A00,186041,Staff,5,0,10,5
1683670084314,LTCS 119,A00,186042,Staff,15,0,20,5
1683670085340,LTCS 130,A00,186043,Wesling; Megan E.,15,0,25,10
1683670087392,LTEA 138,A00,186119,Staff,14,0,40,26
1683670088421,LTEN 124,A00,186148,Staff,5,0,25,20
1683670089454,LTEN 178,A00,186149,Staff,7,0,15,8
1683670090483,LTEN 181,A00,186150,Blanco; John D,34,0,40,6
1683670091511,LTWL 120,A00,186160,Staff,19,0,25,6
1683670092542,LTWL 165,A00,186161,Staff,22,0,25,3
1683670093570,LTWR 100,A00,186162,Staff,0,5,15,15
1683670094603,LTWR 102,A00,186163,Doller; Ben,5,0,15,10
1683670095631,MAE 8,A01,186412,Staff,0,0,0,0
1683670096659,MAE 30B,A00,186445,Bahadori; Mohammad Yousef,82,0,100,18
1683670097685,MAE 40,A00,186592,Bewley; Thomas R,10,0,50,40
1683670098713,MAE 101B,A00,186593,Bahadori; Mohammad Yousef,80,0,100,20
1683670099742,MAE 105,A00,186594,Bandaru; Prabhakar,10,0,50,40
1683670100768,MAE 107,A00,186599,Pham; Hieu Tan,0,7,120,120
1683670101798,MAE 148,A01,186660,Silberman; Jack,3,0,16,13
1683670102824,MATH 10A,A01,188095,Staff,0,6,35,35
1683670103854,MATH 10B,A01,188097,Bowers; Adam R.,0,12,30,30
1683670103854,MATH 10B,A02,188099,Bowers; Adam R.,0,11,30,30
1683670103854,MATH 10B,B01,188104,Bowers; Adam R.,0,10,30,30
1683670103854,MATH 10B,B02,188106,Bowers; Adam R.,1,9,30,29
1683670104885,MATH 10C,A01,188111,Staff,0,19,30,30
1683670104885,MATH 10C,A02,188127,Staff,0,19,30,30
1683670104885,MATH 10C,A03,188131,Staff,0,19,30,30
1683670104885,MATH 10C,B01,188218,Staff,17,0,30,13
1683670104885,MATH 10C,B02,188244,Staff,13,0,30,17
1683670104885,MATH 10C,B03,188277,Staff,14,0,30,16
1683670105913,MATH 18,A01,188344,Bach; Quang Tran,18,0,30,12
1683670105913,MATH 18,A02,188345,Bach; Quang Tran,11,0,30,19
1683670105913,MATH 18,B01,188353,Bach; Quang Tran,11,0,30,19
1683670105913,MATH 18,B02,188354,Bach; Quang Tran,19,0,30,11
1683670106942,MATH 20A,A01,188374,Staff,11,0,35,24
1683670107968,MATH 20B,A01,188382,Ohm; Ko Woon,7,0,30,23
1683670107968,MATH 20B,A02,188383,Ohm; Ko Woon,22,0,30,8
1683670107968,MATH 20B,B01,188385,Ohm; Ko Woon,7,0,30,23
1683670107968,MATH 20B,B02,188392,Ohm; Ko Woon,22,0,30,8
1683670109000,MATH 20C,A01,188394,Harel; Guershon,10,0,30,20
1683670109000,MATH 20C,A02,188395,Harel; Guershon,13,0,30,17
1683670109000,MATH 20C,B01,188404,Harel; Guershon,5,0,30,25
1683670109000,MATH 20C,B02,188405,Harel; Guershon,18,0,30,12
1683670110025,MATH 20D,A01,188414,Hammock; Frances H,0,1,30,30
1683670110025,MATH 20D,A02,188415,Hammock; Frances H,0,1,30,30
1683670110025,MATH 20D,B01,188447,Hammock; Frances H,0,1,30,30
1683670110025,MATH 20D,B02,188486,Hammock; Frances H,3,0,30,27
1683670111050,MATH 20E,A01,188649,Staff,21,0,30,9
1683670111050,MATH 20E,A02,188650,Staff,21,0,30,9
1683670111050,MATH 20E,A03,188673,Staff,0,0,30,30
1683670112078,MATH 102,A01,188675,Staff,0,36,35,35
1683670113103,MATH 103B,A01,188681,Staff,3,0,35,32
1683670113103,MATH 103B,B01,188692,Staff,5,0,35,30
1683670114158,MATH 109,A01,188695,Salehi Golsefidy; Alireza,24,0,35,11
1683670114158,MATH 109,A02,188696,Salehi Golsefidy; Alireza,25,0,35,10
1683670115188,MATH 120A,A01,188698,Eggers; John Dietrich,7,0,35,28
1683670116217,MATH 142B,A01,188736,Ioana; Adrian,1,1,30,29
1683670116217,MATH 142B,A02,188741,Ioana; Adrian,0,1,30,30
1683670116217,MATH 142B,A03,188743,Ioana; Adrian,0,1,30,30
1683670117245,MATH 168A,A01,188790,Staff,0,11,35,35
1683670118275,MATH 170A,A01,188803,Nie; Jiawang,0,2,35,35
1683670118275,MATH 170A,A02,188811,Nie; Jiawang,0,0,35,35
1683670118275,MATH 170A,A03,188814,Nie; Jiawang,0,0,35,35
1683670118275,MATH 170A,A04,188815,Nie; Jiawang,8,0,35,27
1683670119303,MATH 193B,A01,188817,Staff,0,0,35,35
1683670119303,MATH 193B,A02,188818,Staff,5,0,35,30
1683670120329,MGT 4,A01,202857,Anderson; John Charles,59,0,80,21
1683670121355,MGT 12,A00,202858,Lindenberger; Wade Douglas,40,0,90,50
1683670122382,MGT 18,A00,202859,Staff,74,0,90,16
1683670123415,MGT 18GS,A00,202860,McKay; Michael J,13,0,28,15
1683670124442,MGT 45,A00,202861,Pecore; Joseph P.,11,0,90,79
1683670125528,MGT 100,A00,202863,Yavorsky; Daniel Ryan,28,0,90,62
1683670126556,MGT 103,A00,202864,Ehrich; Kristine R,0,18,90,90
1683670127581,MGT 112,A00,202865,Ehrich; Kristine R,15,0,90,75
1683670128606,MGT 121A,A00,202868,Staff,90,20,90,0
1683670129631,MGT 131B,A00,202869,Anderson; John Charles,59,0,90,31
1683670130657,MGT 136,A00,202871,Lindenberger; Wade Douglas,83,0,90,7
1683670131683,MGT 164,A00,202873,Staff,0,67,90,91
1683670132709,MGT 164GS,A00,202874,McKay; Mary A,13,0,28,15
1683670133740,MGT 180,A00,202875,Staff,0,51,90,91
1683670134771,MMW 11R,A01,205019,Herbst; Matthew,0,0,30,30
1683670134771,MMW 11R,A02,205026,Herbst; Matthew,29,0,30,1
1683670135798,MMW 15,A01,193512,Chang; Edmond Yi-Teh,0,8,28,28
1683670135798,MMW 15,A02,193513,Chang; Edmond Yi-Teh,0,5,28,28
1683670135798,MMW 15,A03,193514,Chang; Edmond Yi-Teh,0,5,28,28
1683670135798,MMW 15,A04,193515,Chang; Edmond Yi-Teh,0,5,28,28
1683670135798,MMW 15,A05,193516,Chang; Edmond Yi-Teh,0,5,28,28
1683670135798,MMW 15,A06,193517,Chang; Edmond Yi-Teh,0,6,28,28
1683670135798,MMW 15,B01,193519,Chang; Edmond Yi-Teh,0,5,28,28
1683670135798,MMW 15,B02,193520,Chang; Edmond Yi-Teh,0,5,28,28
1683670135798,MMW 15,B03,193521,Chang; Edmond Yi-Teh,0,5,28,28
1683670135798,MMW 15,B04,193522,Chang; Edmond Yi-Teh,0,5,28,28
1683670135798,MMW 15,B05,193523,Chang; Edmond Yi-Teh,0,5,28,28
1683670135798,MMW 15,B06,193524,Chang; Edmond Yi-Teh,0,5,28,28
1683670136824,MMW 122,A01,193526,Rahimi; Babak,0,16,28,28
1683670136824,MMW 122,A02,193527,Rahimi; Babak,0,15,28,28
1683670136824,MMW 122,A03,193528,Rahimi; Babak,0,0,0,0
1683670136824,MMW 122,A04,193529,Rahimi; Babak,0,0,0,0
1683670137850,MUS 1A,A01,186663,Staff,1,19,35,34
1683670138880,MUS 4,A01,186715,Staff,0,12,35,35
1683670139910,MUS 5R,A01,186796,Dubnov; Shlomo,0,17,35,35
1683670140936,MUS 6,A01,186798,Staff,0,5,25,25
1683670141982,MUS 7,A01,186830,Staff,11,0,35,24
1683670143008,MUS 8,A01,186930,Staff,0,27,35,35
1683670144035,MUS 15,A01,186932,Staff,0,15,35,35
1683670144035,MUS 15,B01,186934,Staff,1,17,35,34
1683670145062,MUS 80,A00,186935,Staff,0,0,20,20
1683670145062,MUS 80,B00,186936,Staff,24,0,25,1
1683670146091,NANO 11,A00,204702,Lipomi; Darren John,0,0,0,0
1683670147122,NANO 15,A01,204709,Yang; Kesong,0,1,0,0
1683670148147,NANO 114,A00,202069,Jahed Motlagh; Zeinab,3,0,10,7
1683670149172,PHIL 1,A00,186955,Grush; Rick Scott,31,0,40,9
1683670150198,PHIL 10,A01,186973,Grush; Rick Scott,27,0,35,8
1683670150198,PHIL 10,A02,186974,Grush; Rick Scott,33,0,35,2
1683670151229,PHIL 13,A01,186976,Staff,3,0,35,32
1683670151229,PHIL 13,A02,186977,Staff,16,0,35,19
1683670152259,PHIL 14,A01,186979,Staff,31,0,35,4
1683670152259,PHIL 14,A02,186986,Staff,32,0,35,3
1683670153285,PHIL 28,A01,186988,Staff,16,0,30,14
1683670153285,PHIL 28,A02,186989,Staff,1,0,30,29
1683670153285,PHIL 28,A03,186990,Staff,10,0,30,20
1683670153285,PHIL 28,A04,186991,Staff,26,0,30,4
1683670154310,PHIL 120,A00,186997,Staff,23,0,40,17
1683670155341,PHIL 137,A00,187003,Staff,7,0,40,33
1683670156370,PHIL 150,A00,187015,Staff,47,0,70,23
1683670157398,PHIL 167,A00,187021,Lamey; Andy M.,34,0,40,6
1683670158426,PHIL 174,A01,202226,Staff,17,0,20,3
1683670158426,PHIL 174,A02,202235,Staff,20,0,20,0
1683670159452,PHIL 191A,A00,258918,Staff,0,0,1,1
1683670160478,PHYS 1A,A00,187028,Staff,26,0,60,34
1683670161503,PHYS 1AL,001,187036,Staff,3,0,30,27
1683670161503,PHYS 1AL,002,187049,Staff,18,0,30,12
1683670162529,PHYS 1B,A00,187058,Staff,22,0,60,38
1683670163557,PHYS 1BL,001,187064,Staff,0,1,30,30
1683670163557,PHYS 1BL,002,187070,Staff,4,0,30,26
1683670164582,PHYS 1C,A00,187082,Staff,29,0,120,91
1683670165607,PHYS 1CL,001,187088,Staff,0,9,30,30
1683670165607,PHYS 1CL,002,187089,Staff,0,1,30,30
1683670165607,PHYS 1CL,009,262693,Staff,9,0,30,21
1683670166637,PHYS 2B,A01,187097,Staff,55,0,115,60
1683670167665,PHYS 2C,A01,187099,Staff,63,0,115,52
1683670168694,PHYS 2CL,A01,187101,Staff,5,0,28,23
1683670168694,PHYS 2CL,A02,187102,Staff,15,0,28,13
1683670169723,PHYS 2D,A01,187123,Shotwell; Brian,95,0,115,20
1683670170749,PHYS 4B,A01,187133,Grinstein; Benjamin,35,0,50,15
1683670171777,POLI 10,A00,188819,Staff,0,4,50,50
1683670172805,POLI 11,A00,188827,Staff,43,0,50,7
1683670173834,POLI 13R,A00,188828,Staff,0,1,20,20
1683670174859,POLI 27,A01,188830,Elgin; Samuel Zincke,0,2,70,70
1683670175884,POLI 30,A00,188832,Desposato; Scott,30,0,50,20
1683670176909,POLI 102F,A00,188834,Staff,0,0,40,40
1683670177938,POLI 104A,A00,188852,Staff,13,0,30,17
1683670178965,POLI 104I,A00,188853,Staff,0,7,20,20
1683670179993,POLI 110B,A00,188854,Wiens; David,6,0,20,14
1683670181021,POLI 112A,A00,188855,Wiens; David,3,0,30,27
1683670182046,POLI 117R,A00,188856,Forman; Fonna,0,12,20,20
1683670183074,POLI 118,A00,188857,Ingham; Sean,8,0,20,12
1683670184100,POLI 120G,A00,188858,Staff,8,0,30,22
1683670185125,POLI 131CR,A00,188863,Hoston; Germaine,20,0,50,30
1683670186151,POLI 133,A00,188864,Nellis; Gareth Hb,44,0,50,6
1683670187177,POLI 134D,A00,188865,Desposato; Scott,27,0,30,3
1683670188204,POLI 142A,A00,188871,Gartzke; Erik,21,0,50,29
1683670189227,POLI 142K,A00,188874,Staff,38,0,50,12
1683670190264,POLI 143,A00,188940,Gartzke; Erik,16,0,30,14
1683670191295,POLI 153,A00,188943,Staff,2,0,20,18
1683670192329,POLI 160AA,A00,188944,Staff,11,0,40,29
1683670193354,POLI 170A,A00,188945,Staff,11,0,30,19
1683670195407,PSYC 1,A00,188952,Staff,37,0,90,53
1683670196431,PSYC 2,B00,188953,Staff,19,0,35,16
1683670197458,PSYC 6,A00,188970,Staff,47,0,60,13
1683670198481,PSYC 7,A00,188973,Staff,35,0,45,10
1683670199511,PSYC 60,A01,188980,Rickard; Timothy C.,42,0,60,18
1683670200536,PSYC 70,A01,189001,Steiner; Eric Tomas,22,0,45,23
1683670201566,PSYC 100,A00,189005,Lacefield; Katharine I,0,99,120,120
1683670202591,PSYC 102,A00,189008,Staff,8,0,30,22
1683670203618,PSYC 106,B00,189026,Gorman; Michael R.,27,0,60,33
1683670204643,PSYC 114,B01,189033,Winkielman; Piotr,0,31,30,30
1683670205669,PSYC 131,A00,189036,Anagnostaras; Stephan,0,43,60,60
1683670206693,PSYC 136,A00,189041,Lowe; Angela Beth,0,7,25,25
1683670207719,PSYC 137,A00,189057,Winkielman; Piotr,1,37,25,24
1683670208745,PSYC 144,A00,189107,Wixted; John T,0,11,50,50
1683670210795,PSYC 162,A00,189142,Staff,0,9,85,85
1683670211821,PSYC 172,A00,189144,Gorman; Michael R.,0,6,30,30
1683670213873,PSYC 179,A00,189146,Lacefield; Katharine I,0,87,120,120
1683670214901,PSYC 181,A00,189147,Anagnostaras; Stephan,0,44,90,90
1683670215926,PSYC 190R,A00,189148,Barner; David A.,0,23,80,80
1683670216951,PSYC 191,A00,189275,Rickard; Timothy C.,0,10,25,25
1683670217979,PSYC 193,A00,189276,Chapman; Eddie Nathaniel,0,1,0,4
1683670219007,PSYC 193L,A01,189281,Lowe; Angela Beth,10,0,20,10
1683670219007,PSYC 193L,B01,189285,Staff,28,0,35,7
1683670220036,RELI 149,A00,187137,Rahimi; Babak,7,0,40,33
1683670221065,SE 9,A01,187315,Staff,0,2,18,18
1683670222094,SE 101B,A00,187409,Staff,24,0,30,6
1683670223124,SE 110B,A00,187444,Staff,10,0,40,30
1683670224153,SE 130B,A00,187449,Staff,31,0,40,9
1683670225182,SE 150A,A00,187516,Staff,8,0,20,12
1683670226210,SE 154,A00,187528,Staff,29,0,50,21
1683670227236,SIO 3,A01,258171,Staff,35,0,40,5
1683670228261,SIO 10,A00,187144,Cook; Geoffrey W,0,7,75,75
1683670229364,SIO 45,A00,187152,Cook; Geoffrey W,0,5,100,100
1683670230391,SIO 109R,A00,194486,Staff,0,4,20,20
1683670232442,SIO 187,A01,187233,Kacev; David,12,0,40,28
1683670245452,SOCI 1,A01,258656,Thorpe; Charles Robert,28,0,30,2
1683670245452,SOCI 1,A02,258658,Thorpe; Charles Robert,30,0,30,0
1683670245452,SOCI 1,A03,258661,Thorpe; Charles Robert,25,0,25,0
1683670245452,SOCI 1,A04,258666,Thorpe; Charles Robert,22,0,25,3
1683670245452,SOCI 1,A05,258897,Thorpe; Charles Robert,22,0,25,3
1683670245452,SOCI 1,A06,258898,Thorpe; Charles Robert,25,0,25,0
1683670246478,SOCI 30,A01,258903,Pardo Guerra; Juan Pablo,14,0,30,16
1683670247503,SOCI 102,A00,258904,Staff,9,0,25,16
1683670248531,SOCI 106,A00,258905,Staff,19,0,25,6
1683670249557,SOCI 111,A00,258907,Ribas Norris; Janet Vanesa,26,0,30,4
1683670250581,SOCI 121R,A00,258908,Pardo Guerra; Juan Pablo,8,0,30,22
1683670251605,SOCI 126,A01,203330,Staff,14,0,20,6
1683670252629,SOCI 131,A00,258909,Thorpe; Charles Robert,30,0,60,30
1683670253657,SOCI 135,A00,258910,Payne; Christine Anna,0,11,30,30
1683670254680,SOCI 157,A00,258911,Staff,12,0,30,18
1683670268389,SOCI 184,A00,258912,Staff,25,0,30,5
1683670269415,SOCI 188D,A00,258913,Staff,22,0,30,8
1683670270444,SYN 2,001,187529,Staff,9,0,16,7
1683670270444,SYN 2,002,201452,Staff,0,20,16,16
1683670270444,SYN 2,003,201469,Staff,1,0,16,15
1683670271471,SYN 100,A01,187531,Staff,0,9,20,20
1683670271471,SYN 100,B01,201491,Staff,0,10,20,20
1683670272500,TDAC 1,A00,189286,Walsh; Kim C.,3,0,20,17
1683670272500,TDAC 1,B00,189287,Harting; Carla Kelso,10,0,20,10
1683670273529,TDAC 101,A00,189300,Walsh; Kim C.,16,0,20,4
1683670273529,TDAC 101,B00,189301,Harting; Carla Kelso,18,0,20,2
1683670274558,TDAC 102,A00,189304,Basso; Beatrice,14,0,20,6
1683670275584,TDAC 108,A00,189305,Staff,18,0,20,2
1683670276611,TDDE 131,A00,189310,Staff,19,0,20,1
1683670276611,TDDE 131,B00,189314,Staff,19,0,20,1
1683670276611,TDDE 131,C00,189315,Staff,48,0,50,2
1683670276611,TDDE 131,D00,189316,Staff,14,0,15,1
1683670276611,TDDE 131,E00,204841,Staff,20,0,20,0
1683670277635,TDGE 10,A00,189289,Staff,27,0,50,23
1683670277635,TDGE 10,B00,189290,Havis; Allan,0,1,50,50
1683670281825,TDGE 11,A00,189291,Fulton; Julia,0,4,50,50
1683670281825,TDGE 11,B00,189292,Staff,20,0,25,5
1683670281825,TDGE 11,C00,260270,Staff,0,0,0,0
1683670282852,TDGE 25,A00,189294,Staff,2,0,20,18
1683670283880,TDGE 124,A00,189318,Fulton; Julia,0,8,50,50
1683670284911,TDGE 125,A00,189319,Staff,13,0,25,12
1683670284911,TDGE 125,B00,189320,Staff,23,0,25,2
1683670285938,TDGE 127,A00,189322,Havis; Allan,0,0,50,50
1683670286966,TDHT 101,A00,189323,Staff,18,0,25,7
1683670286966,TDHT 101,B00,189324,Staff,25,0,25,0
1683670287991,TDHT 102,A00,189325,Staff,49,0,50,1
1683670289017,TDMV 1,A00,189295,Arcidiacono; Kristin,20,0,30,10
1683670289017,TDMV 1,B00,189296,Caligagan; Maria T.,24,0,30,6
1683670290045,TDMV 2,A00,189297,Sammartano; Tonnie,27,0,30,3
1683670290045,TDMV 2,B00,189299,Arcidiacono; Kristin,23,0,30,7
1683670291071,TDMV 3,A00,204998,Rincon; Alicia,22,0,30,8
1683670292099,TDMV 120,A00,189458,Sammartano; Tonnie,28,0,30,2
1683670293123,TDMV 138,A00,189541,Jun; Grace Shin Hae,20,0,40,20
1683670294145,TDMV 142,A00,189717,Caligagan; Tony,25,0,30,5
1683670294145,TDMV 142,B00,189718,Caligagan; Maria T.,25,0,30,5
1683670295172,TMC 2,A01,187533,Staff,25,0,25,0
1683670295172,TMC 2,A02,187534,Staff,25,0,25,0
1683670296199,USP 1,A01,187536,Kwak; Nancy,0,16,25,25
1683670297225,USP 5,A01,187538,Staff,9,0,25,16
1683670298250,USP 101,A00,199253,Staff,0,4,0,0
1683670299276,USP 124,A00,187562,Boomhower; Matthew Charles,0,0,30,30
1683670300304,USP 138,A00,187582,Staff,20,0,25,5
1683670301330,USP 152,A01,187597,Staff,3,0,25,22
1683670302356,USP 153,A00,187598,Staff,19,0,25,6
1683670303385,USP 168,A00,187607,Kwak; Nancy,2,0,5,3
1683670304411,USP 173,A00,187619,Staff,4,0,25,21
1683670305440,USP 181,A00,187638,Staff,0,4,25,25
1683670306464,VIS 103,A00,187650,Cruz; Edwin Teddy,17,0,75,58
1683670307490,VIS 110D,A00,187669,Staff,13,0,22,9
1683670308516,VIS 127C,A00,187720,Shen; Kuiyi,67,0,146,79
1683670309544,VIS 149,A00,187731,Yoldas; Pinar,1,14,22,21
1683670310605,VIS 151,A01,188091,Staff,22,0,34,12
1683670310605,VIS 151,A02,188092,Staff,11,0,34,23
1683670311633,VIS 160B,A00,188093,Stalbaum; Brett,0,1,10,10
1683670313685,WCWP 10B,A00,201720,Staff,10,0,15,5
1683670313685,WCWP 10B,B00,201722,Staff,9,0,15,6
1683670314715,WCWP 100,A00,201725,Gagnon; Jeffrey C,0,0,2,2
1683670314715,WCWP 100,B00,201727,Staff,0,4,15,15
1683670317847,ANBI 133,A00,258401,Wilder; Linnea Lorene,34,0,40,6
1683670318871,ANBI 140,A00,258395,Hrvoj Mihic; Branka,18,0,25,7
1683670319895,ANSC 120,A00,258402,Bialecki; Jon Anthony,26,0,40,14
1683670320920,ANSC 144,A00,258400,Staff,12,0,40,28
1683670322972,ANSC 166,A00,258396,Parish; Steven Martin,156,0,175,19
1683670324000,ANSC 180,A00,193533,Staff,8,0,20,12
1683670325025,ANSC 188,A00,258397,Jassal; Aftab,34,0,40,6
1683670326050,ANTH 3,A01,258316,Staff,23,0,30,7
1683670327079,ANTH 5,A00,258394,Semendeferi; Ekaterini,16,0,20,4
1683670328103,ANTH 21,A01,258331,Staff,4,0,40,36
1683670329129,ANTH 103,A00,258398,Varma; Saiba,15,0,25,10
1683670330156,AWP 10,001,202034,Staff,0,0,0,0
1683670330156,AWP 10,002,202035,Staff,0,0,0,0
1683670330156,AWP 10,003,202036,Staff,0,0,0,0
1683670330156,AWP 10,004,202037,Staff,0,0,0,0
1683670330156,AWP 10,005,202038,Staff,0,0,0,0
1683670330156,AWP 10,006,202039,Staff,0,0,0,0
1683670330156,AWP 10,007,202040,Staff,0,0,0,0
1683670330156,AWP 10,008,202041,Staff,0,0,0,0
1683670330156,AWP 10,009,202042,Staff,0,0,0,0
1683670330156,AWP 10,010,202043,Staff,0,0,0,0
1683670330156,AWP 10,011,202044,Staff,0,0,0,0
1683670330156,AWP 10,012,202045,Staff,0,0,0,0
1683670330156,AWP 10,013,202046,Staff,0,0,0,0
1683670330156,AWP 10,014,202047,Staff,0,0,0,0
1683670330156,AWP 10,015,202048,Staff,0,0,0,0
1683670330156,AWP 10,016,202049,Staff,0,0,0,0
1683670330156,AWP 10,017,202050,Staff,0,0,0,0
1683670330156,AWP 10,018,202051,Staff,0,0,0,0
1683670330156,AWP 10,019,202052,Staff,0,0,0,0
1683670330156,AWP 10,020,202053,Staff,0,0,0,0
1683670330156,AWP 10,021,202054,Staff,0,0,0,0
1683670330156,AWP 10,022,202055,Staff,0,0,0,0
1683670330156,AWP 10,023,202056,Staff,0,0,0,0
1683670330156,AWP 10,024,202057,Staff,0,0,0,0
1683670330156,AWP 10,025,202058,Staff,0,0,0,0
1683670330156,AWP 10,026,202059,Staff,0,0,0,0
1683670331183,AWP 102,001,202032,Staff,0,0,0,0
1683670331183,AWP 102,002,202033,Staff,0,0,0,0
1683670332213,BENG 100,A01,254234,Taylor Amos; Alyssa C,31,0,40,9
1683670333237,BENG 196,001,270013,Engler; Adam J.,9999,0,9999,0
1683670334263,BICD 100R,A01,202018,Smith; Laurie,0,7,32,32
1683670334263,BICD 100R,A02,202019,Smith; Laurie,0,3,32,32
1683670334263,BICD 100R,A03,202020,Smith; Laurie,0,1,32,32
1683670334263,BICD 100R,A04,202021,Smith; Laurie,6,0,32,26
1683670334263,BICD 100R,A05,202022,Smith; Laurie,11,0,32,21
1683670335288,BICD 136,A01,193242,Gustafson-Brown; Cindy,0,2,32,32
1683670335288,BICD 136,A02,193244,Gustafson-Brown; Cindy,13,0,32,19
1683670336315,BIEB 102,A01,193249,Butler; Shannon Rhey,1,2,32,31
1683670336315,BIEB 102,A02,193251,Butler; Shannon Rhey,0,0,32,32
1683670336315,BIEB 102,A03,193253,Butler; Shannon Rhey,0,0,32,32
1683670336315,BIEB 102,A04,193255,Butler; Shannon Rhey,13,0,32,19
1683670336315,BIEB 102,A05,193265,Butler; Shannon Rhey,25,0,32,7
1683670336315,BIEB 102,A06,193269,Butler; Shannon Rhey,14,0,32,18
1683670338372,BIEB 150,A01,193274,Staff,0,0,32,32
1683670338372,BIEB 150,A02,193285,Staff,24,0,32,8
1683670339397,BIEB 194,A00,193286,Kurle; Carolyn M.,20,0,32,12
1683670340425,BILD 1,A01,192291,Staff,15,0,32,17
1683670340425,BILD 1,A02,192292,Staff,30,0,32,2
1683670340425,BILD 1,B01,192520,Reuther; Keefe,0,1,0,0
1683670340425,BILD 1,B02,192532,Reuther; Keefe,0,1,0,0
1683670341449,BILD 3,A01,192556,Butler; Shannon Rhey,0,0,32,32
1683670341449,BILD 3,A02,192581,Butler; Shannon Rhey,0,0,32,32
1683670341449,BILD 3,A03,192611,Butler; Shannon Rhey,20,0,32,12
1683670341449,BILD 3,A04,192612,Butler; Shannon Rhey,24,0,32,8
1683670341449,BILD 3,A05,192613,Butler; Shannon Rhey,26,0,32,6
1683670341449,BILD 3,A06,192679,Butler; Shannon Rhey,27,0,32,5
1683670341449,BILD 3,A07,192682,Butler; Shannon Rhey,20,0,32,12
1683670342481,BILD 4,A01,192836,Reuther; Keefe,1,0,24,23
1683670342481,BILD 4,A02,193044,Reuther; Keefe,4,0,24,20
1683670343506,BILD 10,A01,193142,Gustafson-Brown; Cindy,29,0,32,3
1683670343506,BILD 10,A02,193149,Gustafson-Brown; Cindy,31,0,32,1
1683670344536,BIMM 100,A01,193301,Staff,0,6,32,32
1683670344536,BIMM 100,A02,193312,Staff,0,7,32,32
1683670344536,BIMM 100,A03,193323,Staff,0,9,32,32
1683670345566,BIMM 101,A01,193329,McDonnell; Lisa Marie,1,4,24,23
1683670345566,BIMM 101,A02,193339,McDonnell; Lisa Marie,1,4,24,23
1683670345566,BIMM 101,B01,193354,McDonnell; Lisa Marie,0,4,24,24
1683670345566,BIMM 101,B02,193357,McDonnell; Lisa Marie,0,3,24,24
1683670346595,BIMM 110,A01,193377,Tat; John,0,11,32,32
1683670346595,BIMM 110,A02,193378,Tat; John,0,10,32,32
1683670347621,BIMM 120,A01,206116,Staff,0,0,32,32
1683670347621,BIMM 120,A02,206117,Staff,7,0,32,25
1683670347621,BIMM 120,A03,206121,Staff,21,0,32,11
1683670348651,BIPN 100,A01,193393,Park; Ji Young,0,15,32,32
1683670348651,BIPN 100,A02,193402,Park; Ji Young,0,14,32,32
1683670348651,BIPN 100,A03,193413,Park; Ji Young,0,14,32,32
1683670348651,BIPN 100,A04,193414,Park; Ji Young,0,13,32,32
1683670349676,BIPN 102,A01,193429,Staff,0,0,32,32
1683670349676,BIPN 102,A02,193438,Staff,18,0,32,14
1683670350701,BIPN 106,A01,193450,Reyes Gonzalez; Catalina,0,2,40,40
1683670351727,BIPN 134,A01,193465,Cooke; James Edward,0,0,32,32
1683670351727,BIPN 134,A02,193474,Cooke; James Edward,25,0,32,7
1683670351727,BIPN 134,A03,193485,Cooke; James Edward,29,0,32,3
1683670351727,BIPN 134,A04,193486,Cooke; James Edward,20,0,32,12
1683670351727,BIPN 134,A05,193491,Cooke; James Edward,31,0,32,1
1683670351727,BIPN 134,A06,193501,Cooke; James Edward,30,0,32,2
1683670351727,BIPN 134,A07,193510,Cooke; James Edward,29,0,32,3
1683670353779,BISP 194,A00,222522,Staff,14,0,32,18
1683670354803,CAT 124,A01,202407,Staff,19,0,25,6
1683670355831,CAT 125,A00,202408,Marchisotto; Jennifer Anne,2,0,20,18
1683670356857,CAT 125R,A00,202409,Smith; Lauryn Alissa,0,11,20,20
1683670356857,CAT 125R,B00,202410,Morales; Celeste Georgianna,0,11,20,20
1683670356857,CAT 125R,C00,202411,Irwin; Matthew Joseph,0,12,20,20
1683670357883,CENG 15,A01,204712,Yang; Kesong,0,1,0,0
1683670358908,CENG 114,A00,202070,Jahed Motlagh; Zeinab,5,0,20,15
1683670359933,CGS 105,A00,185477,Wesling; Megan E.,24,0,40,16
1683670361015,CGS 106,A00,185494,Staff,11,0,22,11
1683670362053,CGS 108,A00,185495,Staff,14,0,20,6
1683670363081,CGS 114,A00,185496,Staff,13,0,18,5
1683670364108,CGS 119,A00,185501,Staff,15,0,20,5
1683670365134,CGS 120,A00,185511,Staff,12,0,20,8
1683670366161,CHEM 4,A01,184675,Bussey; Thomas J,97,0,100,3
1683670367188,CHEM 6A,A01,184677,Staff,32,0,60,28
1683670368217,CHEM 6B,A01,184679,Staff,63,0,100,37
1683670369243,CHEM 6C,A01,184681,Bussey; Thomas J,0,0,50,50
1683670369243,CHEM 6C,A02,184682,Bussey; Thomas J,32,0,50,18
1683670370275,CHEM 40A,A01,184684,Albizati; Kim F.,34,0,100,66
1683670371302,CHEM 40B,A01,184686,Albizati; Kim F.,0,22,100,100
1683670372327,CHEM 41B,A01,184690,Staff,51,0,100,49
1683670373352,COGS 3,A01,184715,Boyle; Mary E. T.,0,27,40,40
1683670374386,COGS 14B,A01,185172,Staff,0,14,38,38
1683670375411,COGS 18,A01,184736,Staff,14,0,80,66
1683670376437,COGS 100,A01,184932,Staff,0,8,73,73
1683670377466,COGS 101A,A01,184935,Staff,0,40,30,30
1683670378491,COGS 101B,A01,184944,Staff,0,2,30,30
1683670379519,COGS 101C,A01,184946,Staff,0,10,30,30
1683670380544,COGS 102A,A01,184951,Johnson; Christine M.,2,0,40,38
1683670381573,COGS 107B,A01,184953,Mooshagian; Eric Frederick,0,51,40,40
1683670382600,COGS 118B,A01,184959,Gupta; Anjum,0,50,40,40
1683670383629,COGS 153,A00,184961,Staff,0,16,30,30
1683670384658,COGS 177,A00,184962,Staff,0,21,30,30
1683670385688,COGS 187A,A01,184969,Boyle; Mary E. T.,0,19,40,40
1683670386717,COMM 10,A01,185174,Staff,0,5,25,25
1683670386717,COMM 10,A02,185189,Staff,0,2,25,25
1683670386717,COMM 10,A03,269821,Staff,0,1,0,0
1683670387746,COMM 100B,A01,185475,Staff,0,1,0,2
1683670387746,COMM 100B,A02,185476,Staff,12,0,25,13
1683670388771,COMM 100C,A01,185314,Staff,1,0,25,24
1683670388771,COMM 100C,A02,185327,Staff,17,0,25,8
1683670389796,COMM 110M,A00,185349,Staff,0,0,40,40
1683670390824,COMM 113T,A00,185352,Staff,25,0,40,15
1683670391851,COMM 114I,A00,185353,Staff,31,0,40,9
1683670392876,COMM 131,A00,185354,Staff,17,0,30,13
1683670393901,CSE 8A,A50,185358,Cao; Yingjun,0,46,10,10
1683670394926,CSE 8B,A01,185362,Staff,0,48,50,50
1683670395951,CSE 11,A01,185416,Cao; Yingjun,0,91,10,10
1683670396979,CSE 20,A01,185445,Briones; Jor-el Thomas Caparas,4,0,25,21
1683670398009,CSE 21,A01,185447,Staff,9,0,50,41
1683670399039,CSE 101,A01,185451,Staff,0,13,50,50
1683670399039,CSE 101,B01,185453,Jones; Miles E,0,14,50,50
1683670401090,CSE 141,A01,185458,Eldon; John,16,0,100,84
1683670402116,CSE 141L,A01,185461,Eldon; John,8,0,100,92
1683670403141,CSE 142,A01,185463,Staff,34,0,60,26
1683670403141,CSE 142,B01,201355,Staff,0,7,60,60
1683670404167,CSE 142L,A01,185470,Staff,34,0,60,26
1683670404167,CSE 142L,B01,201417,Staff,0,6,60,60
1683670405193,CSE 190,A00,201433,Staff,32,0,49,17
1683670406218,DOC 1,A01,259136,Strom; Megan C.,7,0,15,8
1683670406218,DOC 1,A02,259137,Strom; Megan C.,14,0,15,1
1683670406218,DOC 1,A03,259138,Strom; Megan C.,14,0,15,1
1683670406218,DOC 1,A04,259139,Strom; Megan C.,14,0,15,1
1683670407245,DOC 100D,A00,259140,Pass; Natalye Joann,14,0,25,11
1683670408271,DSGN 1,A01,184749,Rill; Bryan,0,26,30,30
1683670409297,DSGN 100,A01,185168,Staff,0,2,25,25
1683670410325,ECE 5,A01,185626,Morris; Karcher William,0,12,0,0
1683670411354,ECE 101,A01,185628,Staff,14,0,70,56
1683670412379,ECE 107,A01,185635,Baghdadchi; Saharnaz,0,0,20,20
1683670412379,ECE 107,A02,185638,Baghdadchi; Saharnaz,1,0,20,19
1683670413408,ECE 148,A01,185647,Silberman; Jack,0,0,16,16
1683670414436,ECON 1,A01,185537,Crane; Meredith Helen,54,0,70,16
1683670415462,ECON 3,A01,185549,Crane; Meredith Helen,29,0,70,41
1683670416489,ECON 4,A01,203354,Anderson; John Charles,0,5,10,10
1683670417514,ECON 100A,A01,185574,Staff,0,5,40,40
1683670418537,ECON 100B,A01,185576,Staff,0,12,50,50
1683670419563,ECON 100C,A01,185589,Newhouse; Herbert S,30,0,70,40
1683670420589,ECON 105,A00,185608,Vespa; Emanuel Ignacio,19,0,35,16
1683670421611,ECON 109,A01,185610,Shishkin; Denis,9,0,35,26
1683670422636,ECON 110A,A01,185612,Staff,9,0,40,31
1683670423663,ECON 120A,A01,185615,Staff,19,0,40,21
1683670424688,ECON 120C,A01,185617,Sun; Yixiao,0,20,70,70
1683670425715,ECON 144,A00,203346,Squires; Dale E,2,0,35,33
1683670426743,ECON 171,A01,203349,Newhouse; Herbert S,0,1,35,35
1683670427769,ECON 173A,A01,185621,Toda; Alexis Akira,20,0,35,15
1683670428800,EDS 25,A01,202413,Staff,0,1,0,0
1683670428800,EDS 25,A02,202414,Staff,0,1,0,0
1683670428800,EDS 25,A03,202415,Staff,0,0,0,0
1683670428800,EDS 25,A04,202416,Staff,0,1,0,0
1683670428800,EDS 25,A05,202439,Staff,0,0,0,0
1683670428800,EDS 25,A06,202440,Staff,0,0,0,0
1683670428800,EDS 25,B01,202631,Staff,0,0,0,0
1683670428800,EDS 25,B02,202632,Staff,0,0,0,0
1683670428800,EDS 25,B03,202639,Staff,0,0,0,0
1683670428800,EDS 25,B04,202640,Staff,0,0,0,0
1683670428800,EDS 25,B05,202643,Staff,0,0,0,0
1683670428800,EDS 25,B06,202644,Staff,0,0,0,0
1683670429827,EDS 38,A01,202659,Black; Alison Michelle,24,0,25,1
1683670430851,EDS 115,A00,202652,Staff,18,0,30,12
1683670431878,EDS 125,A00,202649,Staff,13,0,30,17
1683670432907,EDS 126,A01,203332,Staff,30,0,30,0
1683670433933,EDS 139,A00,202838,Staff,16,0,25,9
1683670434959,EDS 146,A01,202655,Staff,14,0,25,11
1683670435986,ENG 15,A00,185667,Staff,0,1,0,0
1683670435986,ENG 15,B00,185672,Staff,0,0,0,0
1683670435986,ENG 15,C00,185675,Staff,0,0,0,0
1683670435986,ENG 15,D00,185682,Staff,0,0,0,0
1683670435986,ENG 15,E00,185684,Staff,0,0,0,0
1683670437011,ETHN 103,A00,185710,Staff,0,8,35,35
1683670438039,ETHN 103A,A00,199228,Man; Simeon S,0,0,9,9
1683670439068,ETHN 109,A00,185711,Staff,15,0,35,20
1683670440093,ETHN 142,A00,185726,Staff,0,4,30,30
1683670441118,ETHN 163J,A00,199229,Man; Simeon S,5,0,8,3
1683670442144,ETHN 168,A00,185727,Staff,7,0,10,3
1683670443174,ETHN 182,A00,185728,Staff,0,0,35,35
1683670444201,ETHN 183,A00,185737,Staff,9,0,18,9
1683670445226,GLBH 111,A01,209361,Burgos; Jose L.,0,0,0,0
1683670447275,HIEU 104,A00,185792,Staff,14,0,20,6
1683670448302,HIEU 115,A00,185800,Staff,0,0,20,20
1683670449327,HIEU 128,A00,185801,Staff,0,9,20,20
1683670450357,HIEU 147,A00,185802,Staff,15,0,20,5
1683670451382,HIEU 154,A00,185823,Staff,11,0,20,9
1683670452411,HILA 102,A00,185826,Staff,14,0,20,6
1683670453437,HILD 2C,A01,185778,Staff,0,13,20,20
1683670454467,HILD 7B,A01,185780,Kwak; Nancy,0,17,32,32
1683670454467,HILD 7B,A02,185781,Kwak; Nancy,0,18,32,32
1683670455495,HILD 30,A01,185791,Staff,12,0,20,8
1683670456519,HISC 119,A00,185830,Golan; Tal,0,9,20,20
1683670457546,HITO 156GS,A00,185831,Patterson; Patrick H.,0,0,0,23
1683670458572,HIUS 103,A00,185832,Man; Simeon S,0,4,20,20
1683670459598,HIUS 117,A00,185836,Kwak; Nancy,2,0,20,18
1683670460624,HIUS 125,A00,185840,Man; Simeon S,0,2,23,23
1683670461651,HIUS 149,A00,185845,Staff,1,0,20,19
1683670462680,HUM 3,A01,185882,Zavodny; Tatiana Sophia,0,8,50,50
1683670462680,HUM 3,B01,185899,Caldwell; Michael Alan,0,18,50,50
1683670463705,HUM 3GS,A00,185900,Patterson; Patrick H.,0,0,0,23
1683670464791,HUM 4,A01,185938,Zroka; Amy Liane,29,0,50,21
1683670464791,HUM 4,B01,185956,Watkins; Eric,0,5,50,50
1683670464791,HUM 4,B02,202209,Watkins; Eric,0,5,50,50
1683670464791,HUM 4,B03,202210,Watkins; Eric,0,5,50,50
1683670465820,HUM 5,A01,185958,West; Geoffrey Scott,0,0,50,50
1683670465820,HUM 5,A02,202215,West; Geoffrey Scott,0,0,50,50
1683670466845,INTL 190,A00,185959,Gagnon; Jeffrey C,0,0,0,9
1683670466845,INTL 190,B00,185960,Lettieri; Michael Joseph,0,0,0,2
1683670467873,JAPN 180,A00,254509,Staff,5,0,30,25
1683670468903,LATI 10,A01,202853,Kennemore; Amy Michelle,4,0,35,31
1683670468903,LATI 10,A02,202854,Kennemore; Amy Michelle,2,0,35,33
1683670468903,LATI 10,A03,270054,Kennemore; Amy Michelle,30,0,30,0
1683670469929,LATI 180,A00,202855,Kennemore; Amy Michelle,11,0,20,9
1683670470957,LAWS 101,A00,201767,Golan; Tal,0,7,40,40
1683670471982,LIFR 1C,A00,185961,Staff,6,0,20,14
1683670473010,LIFR 1CX,A00,185962,Staff,7,0,20,13
1683670474034,LIFR 1D,A00,185963,Staff,7,0,20,13
1683670475060,LIFR 1DX,A00,185964,Staff,7,0,20,13
1683670476086,LIGN 101,A01,186039,Staff,43,0,50,7
1683670477112,LIGN 165,A00,186040,Staff,15,0,50,35
1683670478137,LTCS 108,A00,186041,Staff,5,0,10,5
1683670479165,LTCS 119,A00,186042,Staff,15,0,20,5
1683670480193,LTCS 130,A00,186043,Wesling; Megan E.,15,0,25,10
1683670482243,LTEA 138,A00,186119,Staff,14,0,40,26
1683670483268,LTEN 124,A00,186148,Staff,5,0,25,20
1683670484294,LTEN 178,A00,186149,Staff,7,0,15,8
1683670485324,LTEN 181,A00,186150,Blanco; John D,34,0,40,6
1683670486351,LTWL 120,A00,186160,Staff,19,0,25,6
1683670487377,LTWL 165,A00,186161,Staff,22,0,25,3
1683670488405,LTWR 100,A00,186162,Staff,0,5,15,15
1683670489428,LTWR 102,A00,186163,Doller; Ben,5,0,15,10
1683670490457,MAE 8,A01,186412,Staff,0,0,0,0
1683670491488,MAE 30B,A00,186445,Bahadori; Mohammad Yousef,82,0,100,18
1683670492513,MAE 40,A00,186592,Bewley; Thomas R,10,0,50,40
1683670493542,MAE 101B,A00,186593,Bahadori; Mohammad Yousef,80,0,100,20
1683670494568,MAE 105,A00,186594,Bandaru; Prabhakar,10,0,50,40
1683670495595,MAE 107,A00,186599,Pham; Hieu Tan,0,7,120,120
1683670496623,MAE 148,A01,186660,Silberman; Jack,3,0,16,13
1683670497652,MATH 10A,A01,188095,Staff,0,6,35,35
1683670498676,MATH 10B,A01,188097,Bowers; Adam R.,0,12,30,30
1683670498676,MATH 10B,A02,188099,Bowers; Adam R.,0,11,30,30
1683670498676,MATH 10B,B01,188104,Bowers; Adam R.,0,10,30,30
1683670498676,MATH 10B,B02,188106,Bowers; Adam R.,1,9,30,29
1683670499703,MATH 10C,A01,188111,Staff,0,19,30,30
1683670499703,MATH 10C,A02,188127,Staff,0,19,30,30
1683670499703,MATH 10C,A03,188131,Staff,0,19,30,30
1683670499703,MATH 10C,B01,188218,Staff,17,0,30,13
1683670499703,MATH 10C,B02,188244,Staff,13,0,30,17
1683670499703,MATH 10C,B03,188277,Staff,14,0,30,16
1683670500730,MATH 18,A01,188344,Bach; Quang Tran,18,0,30,12
1683670500730,MATH 18,A02,188345,Bach; Quang Tran,11,0,30,19
1683670500730,MATH 18,B01,188353,Bach; Quang Tran,11,0,30,19
1683670500730,MATH 18,B02,188354,Bach; Quang Tran,19,0,30,11
1683670501766,MATH 20A,A01,188374,Staff,11,0,35,24
1683670502790,MATH 20B,A01,188382,Ohm; Ko Woon,7,0,30,23
1683670502790,MATH 20B,A02,188383,Ohm; Ko Woon,22,0,30,8
1683670502790,MATH 20B,B01,188385,Ohm; Ko Woon,7,0,30,23
1683670502790,MATH 20B,B02,188392,Ohm; Ko Woon,22,0,30,8
1683670503819,MATH 20C,A01,188394,Harel; Guershon,10,0,30,20
1683670503819,MATH 20C,A02,188395,Harel; Guershon,13,0,30,17
1683670503819,MATH 20C,B01,188404,Harel; Guershon,5,0,30,25
1683670503819,MATH 20C,B02,188405,Harel; Guershon,18,0,30,12
1683670504846,MATH 20D,A01,188414,Hammock; Frances H,0,1,30,30
1683670504846,MATH 20D,A02,188415,Hammock; Frances H,0,1,30,30
1683670504846,MATH 20D,B01,188447,Hammock; Frances H,0,1,30,30
1683670504846,MATH 20D,B02,188486,Hammock; Frances H,3,0,30,27
1683670505875,MATH 20E,A01,188649,Staff,21,0,30,9
1683670505875,MATH 20E,A02,188650,Staff,20,0,30,10
1683670505875,MATH 20E,A03,188673,Staff,0,0,30,30
1683670506904,MATH 102,A01,188675,Staff,0,37,35,35
1683670507931,MATH 103B,A01,188681,Staff,3,0,35,32
1683670507931,MATH 103B,B01,188692,Staff,5,0,35,30
1683670508957,MATH 109,A01,188695,Salehi Golsefidy; Alireza,24,0,35,11
1683670508957,MATH 109,A02,188696,Salehi Golsefidy; Alireza,25,0,35,10
1683670509987,MATH 120A,A01,188698,Eggers; John Dietrich,7,0,35,28
1683670511013,MATH 142B,A01,188736,Ioana; Adrian,1,1,30,29
1683670511013,MATH 142B,A02,188741,Ioana; Adrian,0,1,30,30
1683670511013,MATH 142B,A03,188743,Ioana; Adrian,0,1,30,30
1683670512042,MATH 168A,A01,188790,Staff,0,11,35,35
1683670513066,MATH 170A,A01,188803,Nie; Jiawang,0,2,35,35
1683670513066,MATH 170A,A02,188811,Nie; Jiawang,0,0,35,35
1683670513066,MATH 170A,A03,188814,Nie; Jiawang,0,0,35,35
1683670513066,MATH 170A,A04,188815,Nie; Jiawang,8,0,35,27
1683670514091,MATH 193B,A01,188817,Staff,0,0,35,35
1683670514091,MATH 193B,A02,188818,Staff,5,0,35,30
1683670515116,MGT 4,A01,202857,Anderson; John Charles,59,0,80,21
1683670516141,MGT 12,A00,202858,Lindenberger; Wade Douglas,40,0,90,50
1683670517170,MGT 18,A00,202859,Staff,74,0,90,16
1683670518198,MGT 18GS,A00,202860,McKay; Michael J,13,0,28,15
1683670519221,MGT 45,A00,202861,Pecore; Joseph P.,11,0,90,79
1683670520247,MGT 100,A00,202863,Yavorsky; Daniel Ryan,28,0,90,62
1683670521276,MGT 103,A00,202864,Ehrich; Kristine R,0,18,90,90
1683670522300,MGT 112,A00,202865,Ehrich; Kristine R,15,0,90,75
1683670523325,MGT 121A,A00,202868,Staff,90,20,90,0
1683670524351,MGT 131B,A00,202869,Anderson; John Charles,59,0,90,31
1683670525378,MGT 136,A00,202871,Lindenberger; Wade Douglas,83,0,90,7
1683670526403,MGT 164,A00,202873,Staff,0,67,90,91
1683670527427,MGT 164GS,A00,202874,McKay; Mary A,13,0,28,15
1683670528451,MGT 180,A00,202875,Staff,0,51,90,91
1683670529476,MMW 11R,A01,205019,Herbst; Matthew,0,0,30,30
1683670529476,MMW 11R,A02,205026,Herbst; Matthew,29,0,30,1
1683670530502,MMW 15,A01,193512,Chang; Edmond Yi-Teh,0,8,28,28
1683670530502,MMW 15,A02,193513,Chang; Edmond Yi-Teh,0,5,28,28
1683670530502,MMW 15,A03,193514,Chang; Edmond Yi-Teh,0,5,28,28
1683670530502,MMW 15,A04,193515,Chang; Edmond Yi-Teh,0,5,28,28
1683670530502,MMW 15,A05,193516,Chang; Edmond Yi-Teh,0,5,28,28
1683670530502,MMW 15,A06,193517,Chang; Edmond Yi-Teh,0,6,28,28
1683670530502,MMW 15,B01,193519,Chang; Edmond Yi-Teh,0,5,28,28
1683670530502,MMW 15,B02,193520,Chang; Edmond Yi-Teh,0,5,28,28
1683670530502,MMW 15,B03,193521,Chang; Edmond Yi-Teh,0,5,28,28
1683670530502,MMW 15,B04,193522,Chang; Edmond Yi-Teh,0,5,28,28
1683670530502,MMW 15,B05,193523,Chang; Edmond Yi-Teh,0,5,28,28
1683670530502,MMW 15,B06,193524,Chang; Edmond Yi-Teh,0,5,28,28
1683670531528,MMW 122,A01,193526,Rahimi; Babak,0,16,28,28
1683670531528,MMW 122,A02,193527,Rahimi; Babak,0,15,28,28
1683670531528,MMW 122,A03,193528,Rahimi; Babak,0,0,0,0
1683670531528,MMW 122,A04,193529,Rahimi; Babak,0,0,0,0
1683670532556,MUS 1A,A01,186663,Staff,1,19,35,34
1683670533581,MUS 4,A01,186715,Staff,0,12,35,35
1683670534607,MUS 5R,A01,186796,Dubnov; Shlomo,0,17,35,35
1683670535676,MUS 6,A01,186798,Staff,0,5,25,25
1683670536708,MUS 7,A01,186830,Staff,11,0,35,24
1683670537736,MUS 8,A01,186930,Staff,0,27,35,35
1683670538760,MUS 15,A01,186932,Staff,0,15,35,35
1683670538760,MUS 15,B01,186934,Staff,1,17,35,34
1683670539789,MUS 80,A00,186935,Staff,0,0,20,20
1683670539789,MUS 80,B00,186936,Staff,24,0,25,1
1683670540818,NANO 11,A00,204702,Lipomi; Darren John,0,0,0,0
1683670541849,NANO 15,A01,204709,Yang; Kesong,0,1,0,0
1683670542874,NANO 114,A00,202069,Jahed Motlagh; Zeinab,3,0,10,7
1683670543899,PHIL 1,A00,186955,Grush; Rick Scott,31,0,40,9
1683670544925,PHIL 10,A01,186973,Grush; Rick Scott,27,0,35,8
1683670544925,PHIL 10,A02,186974,Grush; Rick Scott,33,0,35,2
1683670545952,PHIL 13,A01,186976,Staff,3,0,35,32
1683670545952,PHIL 13,A02,186977,Staff,16,0,35,19
1683670546977,PHIL 14,A01,186979,Staff,31,0,35,4
1683670546977,PHIL 14,A02,186986,Staff,32,0,35,3
1683670548003,PHIL 28,A01,186988,Staff,16,0,30,14
1683670548003,PHIL 28,A02,186989,Staff,1,0,30,29
1683670548003,PHIL 28,A03,186990,Staff,10,0,30,20
1683670548003,PHIL 28,A04,186991,Staff,26,0,30,4
1683670549028,PHIL 120,A00,186997,Staff,23,0,40,17
1683670550053,PHIL 137,A00,187003,Staff,7,0,40,33
1683670551082,PHIL 150,A00,187015,Staff,47,0,70,23
1683670552111,PHIL 167,A00,187021,Lamey; Andy M.,34,0,40,6
1683670553136,PHIL 174,A01,202226,Staff,17,0,20,3
1683670553136,PHIL 174,A02,202235,Staff,20,0,20,0
1683670554164,PHIL 191A,A00,258918,Staff,0,0,1,1
1683670555190,PHYS 1A,A00,187028,Staff,26,0,60,34
1683670556219,PHYS 1AL,001,187036,Staff,3,0,30,27
1683670556219,PHYS 1AL,002,187049,Staff,18,0,30,12
1683670557248,PHYS 1B,A00,187058,Staff,22,0,60,38
1683670558272,PHYS 1BL,001,187064,Staff,0,1,30,30
1683670558272,PHYS 1BL,002,187070,Staff,4,0,30,26
1683670559296,PHYS 1C,A00,187082,Staff,29,0,120,91
1683670560320,PHYS 1CL,001,187088,Staff,0,9,30,30
1683670560320,PHYS 1CL,002,187089,Staff,0,1,30,30
1683670560320,PHYS 1CL,009,262693,Staff,9,0,30,21
1683670561347,PHYS 2B,A01,187097,Staff,55,0,115,60
1683670562372,PHYS 2C,A01,187099,Staff,63,0,115,52
1683670563396,PHYS 2CL,A01,187101,Staff,5,0,28,23
1683670563396,PHYS 2CL,A02,187102,Staff,15,0,28,13
1683670564420,PHYS 2D,A01,187123,Shotwell; Brian,95,0,115,20
1683670565445,PHYS 4B,A01,187133,Grinstein; Benjamin,35,0,50,15
1683670566471,POLI 10,A00,188819,Staff,0,4,50,50
1683670567499,POLI 11,A00,188827,Staff,43,0,50,7
1683670568583,POLI 13R,A00,188828,Staff,0,1,20,20
1683670569609,POLI 27,A01,188830,Elgin; Samuel Zincke,0,2,70,70
1683670570636,POLI 30,A00,188832,Desposato; Scott,30,0,50,20
1683670571662,POLI 102F,A00,188834,Staff,0,0,40,40
1683670572686,POLI 104A,A00,188852,Staff,13,0,30,17
1683670573713,POLI 104I,A00,188853,Staff,0,7,20,20
1683670574741,POLI 110B,A00,188854,Wiens; David,6,0,20,14
1683670575769,POLI 112A,A00,188855,Wiens; David,3,0,30,27
1683670576800,POLI 117R,A00,188856,Forman; Fonna,0,12,20,20
1683670577829,POLI 118,A00,188857,Ingham; Sean,8,0,20,12
1683670578858,POLI 120G,A00,188858,Staff,8,0,30,22
1683670579885,POLI 131CR,A00,188863,Hoston; Germaine,20,0,50,30
1683670580911,POLI 133,A00,188864,Nellis; Gareth Hb,44,0,50,6
1683670581935,POLI 134D,A00,188865,Desposato; Scott,27,0,30,3
1683670582961,POLI 142A,A00,188871,Gartzke; Erik,21,0,50,29
1683670583989,POLI 142K,A00,188874,Staff,38,0,50,12
1683670585015,POLI 143,A00,188940,Gartzke; Erik,16,0,30,14
1683670586044,POLI 153,A00,188943,Staff,2,0,20,18
1683670587069,POLI 160AA,A00,188944,Staff,11,0,40,29
1683670588092,POLI 170A,A00,188945,Staff,11,0,30,19
1683670590143,PSYC 1,A00,188952,Staff,37,0,90,53
1683670591168,PSYC 2,B00,188953,Staff,19,0,35,16
1683670592194,PSYC 6,A00,188970,Staff,47,0,60,13
1683670593222,PSYC 7,A00,188973,Staff,35,0,45,10
1683670594250,PSYC 60,A01,188980,Rickard; Timothy C.,42,0,60,18
1683670595276,PSYC 70,A01,189001,Steiner; Eric Tomas,22,0,45,23
1683670596300,PSYC 100,A00,189005,Lacefield; Katharine I,0,99,120,120
1683670597326,PSYC 102,A00,189008,Staff,8,0,30,22
1683670598352,PSYC 106,B00,189026,Gorman; Michael R.,27,0,60,33
1683670599381,PSYC 114,B01,189033,Winkielman; Piotr,0,31,30,30
1683670600409,PSYC 131,A00,189036,Anagnostaras; Stephan,0,43,60,60
1683670601433,PSYC 136,A00,189041,Lowe; Angela Beth,0,7,25,25
1683670602460,PSYC 137,A00,189057,Winkielman; Piotr,1,37,25,24
1683670603486,PSYC 144,A00,189107,Wixted; John T,0,11,50,50
1683670605544,PSYC 162,A00,189142,Staff,0,9,85,85
1683670606573,PSYC 172,A00,189144,Gorman; Michael R.,0,6,30,30
1683670608625,PSYC 179,A00,189146,Lacefield; Katharine I,0,87,120,120
1683670609651,PSYC 181,A00,189147,Anagnostaras; Stephan,0,44,90,90
1683670610677,PSYC 190R,A00,189148,Barner; David A.,0,23,80,80
1683670611706,PSYC 191,A00,189275,Rickard; Timothy C.,0,10,25,25
1683670612733,PSYC 193,A00,189276,Chapman; Eddie Nathaniel,0,1,0,4
1683670613759,PSYC 193L,A01,189281,Lowe; Angela Beth,10,0,20,10
1683670613759,PSYC 193L,B01,189285,Staff,28,0,35,7
1683670614785,RELI 149,A00,187137,Rahimi; Babak,7,0,40,33
1683670615814,SE 9,A01,187315,Staff,0,2,18,18
1683670616839,SE 101B,A00,187409,Staff,24,0,30,6
1683670617867,SE 110B,A00,187444,Staff,10,0,40,30
1683670618893,SE 130B,A00,187449,Staff,31,0,40,9
1683670619918,SE 150A,A00,187516,Staff,8,0,20,12
1683670620942,SE 154,A00,187528,Staff,29,0,50,21
1683670621969,SIO 3,A01,258171,Staff,35,0,40,5
1683670622997,SIO 10,A00,187144,Cook; Geoffrey W,0,7,75,75
1683670624025,SIO 45,A00,187152,Cook; Geoffrey W,0,5,100,100
1683670625055,SIO 109R,A00,194486,Staff,0,4,20,20
1683670627109,SIO 187,A01,187233,Kacev; David,12,0,40,28
1683670628136,SOCI 1,A01,258656,Thorpe; Charles Robert,28,0,30,2
1683670628136,SOCI 1,A02,258658,Thorpe; Charles Robert,30,0,30,0
1683670628136,SOCI 1,A03,258661,Thorpe; Charles Robert,25,0,25,0
1683670628136,SOCI 1,A04,258666,Thorpe; Charles Robert,22,0,25,3
1683670628136,SOCI 1,A05,258897,Thorpe; Charles Robert,22,0,25,3
1683670628136,SOCI 1,A06,258898,Thorpe; Charles Robert,25,0,25,0
1683670629165,SOCI 30,A01,258903,Pardo Guerra; Juan Pablo,14,0,30,16
1683670630190,SOCI 102,A00,258904,Staff,9,0,25,16
1683670631215,SOCI 106,A00,258905,Staff,19,0,25,6
1683670632238,SOCI 111,A00,258907,Ribas Norris; Janet Vanesa,26,0,30,4
1683670633267,SOCI 121R,A00,258908,Pardo Guerra; Juan Pablo,8,0,30,22
1683670634293,SOCI 126,A01,203330,Staff,14,0,20,6
1683670635322,SOCI 131,A00,258909,Thorpe; Charles Robert,30,0,60,30
1683670636350,SOCI 135,A00,258910,Payne; Christine Anna,0,11,30,30
1683670637375,SOCI 157,A00,258911,Staff,12,0,30,18
1683670638402,SOCI 184,A00,258912,Staff,25,0,30,5
1683670639430,SOCI 188D,A00,258913,Staff,22,0,30,8
1683670640459,SYN 2,001,187529,Staff,9,0,16,7
1683670640459,SYN 2,002,201452,Staff,0,20,16,16
1683670640459,SYN 2,003,201469,Staff,1,0,16,15
1683670641484,SYN 100,A01,187531,Staff,0,9,20,20
1683670641484,SYN 100,B01,201491,Staff,0,10,20,20
1683670642512,TDAC 1,A00,189286,Walsh; Kim C.,3,0,20,17
1683670642512,TDAC 1,B00,189287,Harting; Carla Kelso,10,0,20,10
1683670643541,TDAC 101,A00,189300,Walsh; Kim C.,16,0,20,4
1683670643541,TDAC 101,B00,189301,Harting; Carla Kelso,18,0,20,2
1683670644565,TDAC 102,A00,189304,Basso; Beatrice,14,0,20,6
1683670645589,TDAC 108,A00,189305,Staff,18,0,20,2
1683670646627,TDDE 131,A00,189310,Staff,19,0,20,1
1683670646627,TDDE 131,B00,189314,Staff,19,0,20,1
1683670646627,TDDE 131,C00,189315,Staff,48,0,50,2
1683670646627,TDDE 131,D00,189316,Staff,14,0,15,1
1683670646627,TDDE 131,E00,204841,Staff,20,0,20,0
1683670647653,TDGE 10,A00,189289,Staff,27,0,50,23
1683670647653,TDGE 10,B00,189290,Havis; Allan,0,1,50,50
1683670648679,TDGE 11,A00,189291,Fulton; Julia,0,4,50,50
1683670648679,TDGE 11,B00,189292,Staff,20,0,25,5
1683670648679,TDGE 11,C00,260270,Staff,0,0,0,0
1683670649708,TDGE 25,A00,189294,Staff,2,0,20,18
1683670650734,TDGE 124,A00,189318,Fulton; Julia,0,8,50,50
1683670651759,TDGE 125,A00,189319,Staff,13,0,25,12
1683670651759,TDGE 125,B00,189320,Staff,23,0,25,2
1683670652784,TDGE 127,A00,189322,Havis; Allan,0,0,50,50
1683670653809,TDHT 101,A00,189323,Staff,18,0,25,7
1683670653809,TDHT 101,B00,189324,Staff,25,0,25,0
1683670654834,TDHT 102,A00,189325,Staff,49,0,50,1
1683670655858,TDMV 1,A00,189295,Arcidiacono; Kristin,20,0,30,10
1683670655858,TDMV 1,B00,189296,Caligagan; Maria T.,24,0,30,6
1683670656882,TDMV 2,A00,189297,Sammartano; Tonnie,27,0,30,3
1683670656882,TDMV 2,B00,189299,Arcidiacono; Kristin,23,0,30,7
1683670657912,TDMV 3,A00,204998,Rincon; Alicia,22,0,30,8
1683670658941,TDMV 120,A00,189458,Sammartano; Tonnie,28,0,30,2
1683670659967,TDMV 138,A00,189541,Jun; Grace Shin Hae,20,0,40,20
1683670660994,TDMV 142,A00,189717,Caligagan; Tony,25,0,30,5
1683670660994,TDMV 142,B00,189718,Caligagan; Maria T.,25,0,30,5
1683670662018,TMC 2,A01,187533,Staff,25,0,25,0
1683670662018,TMC 2,A02,187534,Staff,25,0,25,0
1683670663044,USP 1,A01,187536,Kwak; Nancy,0,16,25,25
1683670664069,USP 5,A01,187538,Staff,9,0,25,16
1683670665093,USP 101,A00,199253,Staff,0,4,0,0
1683670666121,USP 124,A00,187562,Boomhower; Matthew Charles,0,0,30,30
1683670667147,USP 138,A00,187582,Staff,19,0,25,6
1683670668175,USP 152,A01,187597,Staff,3,0,25,22
1683670669201,USP 153,A00,187598,Staff,19,0,25,6
1683670670226,USP 168,A00,187607,Kwak; Nancy,2,0,5,3
1683670671251,USP 173,A00,187619,Staff,4,0,25,21
1683670672334,USP 181,A00,187638,Staff,0,4,25,25
1683670673359,VIS 103,A00,187650,Cruz; Edwin Teddy,17,0,75,58
1683670674384,VIS 110D,A00,187669,Staff,13,0,22,9
1683670675413,VIS 127C,A00,187720,Shen; Kuiyi,67,0,146,79
1683670676441,VIS 149,A00,187731,Yoldas; Pinar,1,14,22,21
1683670677466,VIS 151,A01,188091,Staff,22,0,34,12
1683670677466,VIS 151,A02,188092,Staff,11,0,34,23
1683670678493,VIS 160B,A00,188093,Stalbaum; Brett,0,1,10,10
1683670680544,WCWP 10B,A00,201720,Staff,10,0,15,5
1683670680544,WCWP 10B,B00,201722,Staff,9,0,15,6
1683670681573,WCWP 100,A00,201725,Gagnon; Jeffrey C,0,0,2,2
1683670681573,WCWP 100,B00,201727,Staff,0,4,15,15
1683670684675,ANBI 133,A00,258401,Wilder; Linnea Lorene,34,0,40,6
1683670685702,ANBI 140,A00,258395,Hrvoj Mihic; Branka,18,0,25,7
1683670686729,ANSC 120,A00,258402,Bialecki; Jon Anthony,26,0,40,14
1683670687757,ANSC 144,A00,258400,Staff,12,0,40,28
1683670689807,ANSC 166,A00,258396,Parish; Steven Martin,156,0,175,19
1683670690835,ANSC 180,A00,193533,Staff,8,0,20,12
1683670691864,ANSC 188,A00,258397,Jassal; Aftab,34,0,40,6
1683670692891,ANTH 3,A01,258316,Staff,23,0,30,7
1683670693918,ANTH 5,A00,258394,Semendeferi; Ekaterini,16,0,20,4
1683670694948,ANTH 21,A01,258331,Staff,4,0,40,36
1683670695975,ANTH 103,A00,258398,Varma; Saiba,15,0,25,10
1683670697009,AWP 10,001,202034,Staff,0,0,0,0
1683670697009,AWP 10,002,202035,Staff,0,0,0,0
1683670697009,AWP 10,003,202036,Staff,0,0,0,0
1683670697009,AWP 10,004,202037,Staff,0,0,0,0
1683670697009,AWP 10,005,202038,Staff,0,0,0,0
1683670697009,AWP 10,006,202039,Staff,0,0,0,0
1683670697009,AWP 10,007,202040,Staff,0,0,0,0
1683670697009,AWP 10,008,202041,Staff,0,0,0,0
1683670697009,AWP 10,009,202042,Staff,0,0,0,0
1683670697009,AWP 10,010,202043,Staff,0,0,0,0
1683670697009,AWP 10,011,202044,Staff,0,0,0,0
1683670697009,AWP 10,012,202045,Staff,0,0,0,0
1683670697009,AWP 10,013,202046,Staff,0,0,0,0
1683670697009,AWP 10,014,202047,Staff,0,0,0,0
1683670697009,AWP 10,015,202048,Staff,0,0,0,0
1683670697009,AWP 10,016,202049,Staff,0,0,0,0
1683670697009,AWP 10,017,202050,Staff,0,0,0,0
1683670697009,AWP 10,018,202051,Staff,0,0,0,0
1683670697009,AWP 10,019,202052,Staff,0,0,0,0
1683670697009,AWP 10,020,202053,Staff,0,0,0,0
1683670697009,AWP 10,021,202054,Staff,0,0,0,0
1683670697009,AWP 10,022,202055,Staff,0,0,0,0
1683670697009,AWP 10,023,202056,Staff,0,0,0,0
1683670697009,AWP 10,024,202057,Staff,0,0,0,0
1683670697009,AWP 10,025,202058,Staff,0,0,0,0
1683670697009,AWP 10,026,202059,Staff,0,0,0,0
1683670698035,AWP 102,001,202032,Staff,0,0,0,0
1683670698035,AWP 102,002,202033,Staff,0,0,0,0
1683670699064,BENG 100,A01,254234,Taylor Amos; Alyssa C,31,0,40,9
1683670700091,BENG 196,001,270013,Engler; Adam J.,9999,0,9999,0
1683670701120,BICD 100R,A01,202018,Smith; Laurie,0,7,32,32
1683670701120,BICD 100R,A02,202019,Smith; Laurie,0,3,32,32
1683670701120,BICD 100R,A03,202020,Smith; Laurie,0,1,32,32
1683670701120,BICD 100R,A04,202021,Smith; Laurie,6,0,32,26
1683670701120,BICD 100R,A05,202022,Smith; Laurie,11,0,32,21
1683670702148,BICD 136,A01,193242,Gustafson-Brown; Cindy,0,2,32,32
1683670702148,BICD 136,A02,193244,Gustafson-Brown; Cindy,13,0,32,19
1683670703179,BIEB 102,A01,193249,Butler; Shannon Rhey,1,2,32,31
1683670703179,BIEB 102,A02,193251,Butler; Shannon Rhey,0,0,32,32
1683670703179,BIEB 102,A03,193253,Butler; Shannon Rhey,0,0,32,32
1683670703179,BIEB 102,A04,193255,Butler; Shannon Rhey,13,0,32,19
1683670703179,BIEB 102,A05,193265,Butler; Shannon Rhey,25,0,32,7
1683670703179,BIEB 102,A06,193269,Butler; Shannon Rhey,14,0,32,18
1683670705229,BIEB 150,A01,193274,Staff,0,0,32,32
1683670705229,BIEB 150,A02,193285,Staff,24,0,32,8
1683670706253,BIEB 194,A00,193286,Kurle; Carolyn M.,20,0,32,12
1683670707279,BILD 1,A01,192291,Staff,15,0,32,17
1683670707279,BILD 1,A02,192292,Staff,30,0,32,2
1683670707279,BILD 1,B01,192520,Reuther; Keefe,0,1,0,0
1683670707279,BILD 1,B02,192532,Reuther; Keefe,0,1,0,0
1683670708307,BILD 3,A01,192556,Butler; Shannon Rhey,0,0,32,32
1683670708307,BILD 3,A02,192581,Butler; Shannon Rhey,0,1,32,32
1683670708307,BILD 3,A03,192611,Butler; Shannon Rhey,20,0,32,12
1683670708307,BILD 3,A04,192612,Butler; Shannon Rhey,24,0,32,8
1683670708307,BILD 3,A05,192613,Butler; Shannon Rhey,26,0,32,6
1683670708307,BILD 3,A06,192679,Butler; Shannon Rhey,27,0,32,5
1683670708307,BILD 3,A07,192682,Butler; Shannon Rhey,20,0,32,12
1683670709333,BILD 4,A01,192836,Reuther; Keefe,1,0,24,23
1683670709333,BILD 4,A02,193044,Reuther; Keefe,4,0,24,20
1683670710358,BILD 10,A01,193142,Gustafson-Brown; Cindy,29,0,32,3
1683670710358,BILD 10,A02,193149,Gustafson-Brown; Cindy,31,0,32,1
1683670711387,BIMM 100,A01,193301,Staff,0,6,32,32
1683670711387,BIMM 100,A02,193312,Staff,0,7,32,32
1683670711387,BIMM 100,A03,193323,Staff,0,10,32,32
1683670712413,BIMM 101,A01,193329,McDonnell; Lisa Marie,1,4,24,23
1683670712413,BIMM 101,A02,193339,McDonnell; Lisa Marie,1,4,24,23
1683670712413,BIMM 101,B01,193354,McDonnell; Lisa Marie,0,4,24,24
1683670712413,BIMM 101,B02,193357,McDonnell; Lisa Marie,0,3,24,24
1683670713439,BIMM 110,A01,193377,Tat; John,0,11,32,32
1683670713439,BIMM 110,A02,193378,Tat; John,0,10,32,32
1683670714468,BIMM 120,A01,206116,Staff,0,0,32,32
1683670714468,BIMM 120,A02,206117,Staff,7,0,32,25
1683670714468,BIMM 120,A03,206121,Staff,21,0,32,11
1683670715496,BIPN 100,A01,193393,Park; Ji Young,0,15,32,32
1683670715496,BIPN 100,A02,193402,Park; Ji Young,0,14,32,32
1683670715496,BIPN 100,A03,193413,Park; Ji Young,0,14,32,32
1683670715496,BIPN 100,A04,193414,Park; Ji Young,0,13,32,32
1683670716521,BIPN 102,A01,193429,Staff,0,0,32,32
1683670716521,BIPN 102,A02,193438,Staff,18,0,32,14
1683670717545,BIPN 106,A01,193450,Reyes Gonzalez; Catalina,0,2,40,40
1683670718571,BIPN 134,A01,193465,Cooke; James Edward,0,0,32,32
1683670718571,BIPN 134,A02,193474,Cooke; James Edward,25,0,32,7
1683670718571,BIPN 134,A03,193485,Cooke; James Edward,29,0,32,3
1683670718571,BIPN 134,A04,193486,Cooke; James Edward,20,0,32,12
1683670718571,BIPN 134,A05,193491,Cooke; James Edward,31,0,32,1
1683670718571,BIPN 134,A06,193501,Cooke; James Edward,30,0,32,2
1683670718571,BIPN 134,A07,193510,Cooke; James Edward,29,0,32,3
1683670720625,BISP 194,A00,222522,Staff,14,0,32,18
1683670721650,CAT 124,A01,202407,Staff,19,0,25,6
1683670722678,CAT 125,A00,202408,Marchisotto; Jennifer Anne,2,0,20,18
1683670723704,CAT 125R,A00,202409,Smith; Lauryn Alissa,0,11,20,20
1683670723704,CAT 125R,B00,202410,Morales; Celeste Georgianna,0,11,20,20
1683670723704,CAT 125R,C00,202411,Irwin; Matthew Joseph,0,12,20,20
1683670724727,CENG 15,A01,204712,Yang; Kesong,0,1,0,0
1683670725756,CENG 114,A00,202070,Jahed Motlagh; Zeinab,5,0,20,15
1683670726785,CGS 105,A00,185477,Wesling; Megan E.,24,0,40,16
1683670727808,CGS 106,A00,185494,Staff,11,0,22,11
1683670728835,CGS 108,A00,185495,Staff,14,0,20,6
1683670729863,CGS 114,A00,185496,Staff,13,0,18,5
1683670730890,CGS 119,A00,185501,Staff,15,0,20,5
1683670731918,CGS 120,A00,185511,Staff,12,0,20,8
1683670732946,CHEM 4,A01,184675,Bussey; Thomas J,97,0,100,3
1683670733974,CHEM 6A,A01,184677,Staff,32,0,60,28
1683670735000,CHEM 6B,A01,184679,Staff,63,0,100,37
1683670736025,CHEM 6C,A01,184681,Bussey; Thomas J,0,0,50,50
1683670736025,CHEM 6C,A02,184682,Bussey; Thomas J,32,0,50,18
1683670737049,CHEM 40A,A01,184684,Albizati; Kim F.,33,0,100,67
1683670738073,CHEM 40B,A01,184686,Albizati; Kim F.,0,22,100,100
1683670739098,CHEM 41B,A01,184690,Staff,51,0,100,49
1683670740124,COGS 3,A01,184715,Boyle; Mary E. T.,0,27,40,40
1683670741150,COGS 14B,A01,185172,Staff,0,14,38,38
1683670742176,COGS 18,A01,184736,Staff,14,0,80,66
1683670743205,COGS 100,A01,184932,Staff,0,8,73,73
1683670744228,COGS 101A,A01,184935,Staff,0,40,30,30
1683670745255,COGS 101B,A01,184944,Staff,0,2,30,30
1683670746280,COGS 101C,A01,184946,Staff,0,10,30,30
1683670747305,COGS 102A,A01,184951,Johnson; Christine M.,2,0,40,38
1683670748333,COGS 107B,A01,184953,Mooshagian; Eric Frederick,0,51,40,40
1683670749361,COGS 118B,A01,184959,Gupta; Anjum,0,50,40,40
1683670750388,COGS 153,A00,184961,Staff,0,16,30,30
1683670751413,COGS 177,A00,184962,Staff,0,21,30,30
1683670752439,COGS 187A,A01,184969,Boyle; Mary E. T.,0,19,40,40
1683670753467,COMM 10,A01,185174,Staff,0,5,25,25
1683670753467,COMM 10,A02,185189,Staff,0,2,25,25
1683670753467,COMM 10,A03,269821,Staff,0,1,0,0
1683670754493,COMM 100B,A01,185475,Staff,0,1,0,2
1683670754493,COMM 100B,A02,185476,Staff,12,0,25,13
1683670755522,COMM 100C,A01,185314,Staff,1,0,25,24
1683670755522,COMM 100C,A02,185327,Staff,17,0,25,8
1683670756549,COMM 110M,A00,185349,Staff,0,0,40,40
1683670757577,COMM 113T,A00,185352,Staff,25,0,40,15
1683670758603,COMM 114I,A00,185353,Staff,31,0,40,9
1683670759628,COMM 131,A00,185354,Staff,17,0,30,13
1683670760655,CSE 8A,A50,185358,Cao; Yingjun,0,46,10,10
1683670761680,CSE 8B,A01,185362,Staff,0,48,50,50
1683670762703,CSE 11,A01,185416,Cao; Yingjun,0,91,10,10
1683670763731,CSE 20,A01,185445,Briones; Jor-el Thomas Caparas,4,0,25,21
1683670764757,CSE 21,A01,185447,Staff,9,0,50,41
1683670765785,CSE 101,A01,185451,Staff,0,13,50,50
1683670765785,CSE 101,B01,185453,Jones; Miles E,0,14,50,50
1683670767843,CSE 141,A01,185458,Eldon; John,16,0,100,84
1683670768868,CSE 141L,A01,185461,Eldon; John,8,0,100,92
1683670769895,CSE 142,A01,185463,Staff,34,0,60,26
1683670769895,CSE 142,B01,201355,Staff,0,7,60,60
1683670770920,CSE 142L,A01,185470,Staff,34,0,60,26
1683670770920,CSE 142L,B01,201417,Staff,0,6,60,60
1683670771946,CSE 190,A00,201433,Staff,32,0,49,17
1683670772971,DOC 1,A01,259136,Strom; Megan C.,7,0,15,8
1683670772971,DOC 1,A02,259137,Strom; Megan C.,14,0,15,1
1683670772971,DOC 1,A03,259138,Strom; Megan C.,14,0,15,1
1683670772971,DOC 1,A04,259139,Strom; Megan C.,14,0,15,1
1683670773995,DOC 100D,A00,259140,Pass; Natalye Joann,14,0,25,11
1683670775026,DSGN 1,A01,184749,Rill; Bryan,0,26,30,30
1683670776110,DSGN 100,A01,185168,Staff,0,2,25,25
1683670777137,ECE 5,A01,185626,Morris; Karcher William,0,12,0,0
1683670778161,ECE 101,A01,185628,Staff,14,0,70,56
1683670779191,ECE 107,A01,185635,Baghdadchi; Saharnaz,0,0,20,20
1683670779191,ECE 107,A02,185638,Baghdadchi; Saharnaz,1,0,20,19
1683670780215,ECE 148,A01,185647,Silberman; Jack,0,0,16,16
1683670781241,ECON 1,A01,185537,Crane; Meredith Helen,54,0,70,16
1683670782268,ECON 3,A01,185549,Crane; Meredith Helen,29,0,70,41
1683670783296,ECON 4,A01,203354,Anderson; John Charles,0,5,10,10
1683670784320,ECON 100A,A01,185574,Staff,0,5,40,40
1683670785347,ECON 100B,A01,185576,Staff,0,12,50,50
1683670786370,ECON 100C,A01,185589,Newhouse; Herbert S,30,0,70,40
1683670787395,ECON 105,A00,185608,Vespa; Emanuel Ignacio,19,0,35,16
1683670788420,ECON 109,A01,185610,Shishkin; Denis,9,0,35,26
1683670789446,ECON 110A,A01,185612,Staff,9,0,40,31
1683670790473,ECON 120A,A01,185615,Staff,19,0,40,21
1683670791503,ECON 120C,A01,185617,Sun; Yixiao,0,20,70,70
1683670792534,ECON 144,A00,203346,Squires; Dale E,2,0,35,33
1683670793561,ECON 171,A01,203349,Newhouse; Herbert S,0,1,35,35
1683670794589,ECON 173A,A01,185621,Toda; Alexis Akira,20,0,35,15
1683670795615,EDS 25,A01,202413,Staff,0,1,0,0
1683670795615,EDS 25,A02,202414,Staff,0,1,0,0
1683670795615,EDS 25,A03,202415,Staff,0,0,0,0
1683670795615,EDS 25,A04,202416,Staff,0,1,0,0
1683670795615,EDS 25,A05,202439,Staff,0,0,0,0
1683670795615,EDS 25,A06,202440,Staff,0,0,0,0
1683670795615,EDS 25,B01,202631,Staff,0,0,0,0
1683670795615,EDS 25,B02,202632,Staff,0,0,0,0
1683670795615,EDS 25,B03,202639,Staff,0,0,0,0
1683670795615,EDS 25,B04,202640,Staff,0,0,0,0
1683670795615,EDS 25,B05,202643,Staff,0,0,0,0
1683670795615,EDS 25,B06,202644,Staff,0,0,0,0
1683670796640,EDS 38,A01,202659,Black; Alison Michelle,24,0,25,1
1683670797666,EDS 115,A00,202652,Staff,18,0,30,12
1683670798691,EDS 125,A00,202649,Staff,13,0,30,17
1683670799717,EDS 126,A01,203332,Staff,30,0,30,0
1683670800741,EDS 139,A00,202838,Staff,16,0,25,9
1683670801766,EDS 146,A01,202655,Staff,14,0,25,11
1683670802791,ENG 15,A00,185667,Staff,0,1,0,0
1683670802791,ENG 15,B00,185672,Staff,0,0,0,0
1683670802791,ENG 15,C00,185675,Staff,0,0,0,0
1683670802791,ENG 15,D00,185682,Staff,0,0,0,0
1683670802791,ENG 15,E00,185684,Staff,0,0,0,0
1683670803816,ETHN 103,A00,185710,Staff,0,8,35,35
1683670804841,ETHN 103A,A00,199228,Man; Simeon S,0,0,9,9
1683670805869,ETHN 109,A00,185711,Staff,15,0,35,20
1683670806897,ETHN 142,A00,185726,Staff,0,4,30,30
1683670807923,ETHN 163J,A00,199229,Man; Simeon S,5,0,8,3
1683670808950,ETHN 168,A00,185727,Staff,7,0,10,3
1683670809974,ETHN 182,A00,185728,Staff,0,0,35,35
1683670810998,ETHN 183,A00,185737,Staff,9,0,18,9
1683670812022,GLBH 111,A01,209361,Burgos; Jose L.,0,0,0,0
1683670814077,HIEU 104,A00,185792,Staff,14,0,20,6
1683670815101,HIEU 115,A00,185800,Staff,0,0,20,20
1683670816129,HIEU 128,A00,185801,Staff,0,9,20,20
1683670817154,HIEU 147,A00,185802,Staff,15,0,20,5
1683670818178,HIEU 154,A00,185823,Staff,11,0,20,9
1683670819203,HILA 102,A00,185826,Staff,14,0,20,6
1683670820229,HILD 2C,A01,185778,Staff,0,13,20,20
1683670821257,HILD 7B,A01,185780,Kwak; Nancy,0,17,32,32
1683670821257,HILD 7B,A02,185781,Kwak; Nancy,0,18,32,32
1683670822281,HILD 30,A01,185791,Staff,12,0,20,8
1683670823310,HISC 119,A00,185830,Golan; Tal,0,9,20,20
1683670824338,HITO 156GS,A00,185831,Patterson; Patrick H.,0,0,0,23
1683670825366,HIUS 103,A00,185832,Man; Simeon S,0,4,20,20
1683670826395,HIUS 117,A00,185836,Kwak; Nancy,2,0,20,18
1683670827419,HIUS 125,A00,185840,Man; Simeon S,0,2,23,23
1683670828446,HIUS 149,A00,185845,Staff,1,0,20,19
1683670829470,HUM 3,A01,185882,Zavodny; Tatiana Sophia,0,8,50,50
1683670829470,HUM 3,B01,185899,Caldwell; Michael Alan,0,18,50,50
1683670830497,HUM 3GS,A00,185900,Patterson; Patrick H.,0,0,0,23
1683670831527,HUM 4,A01,185938,Zroka; Amy Liane,29,0,50,21
1683670831527,HUM 4,B01,185956,Watkins; Eric,0,5,50,50
1683670831527,HUM 4,B02,202209,Watkins; Eric,0,5,50,50
1683670831527,HUM 4,B03,202210,Watkins; Eric,0,5,50,50
1683670832554,HUM 5,A01,185958,West; Geoffrey Scott,0,0,50,50
1683670832554,HUM 5,A02,202215,West; Geoffrey Scott,0,0,50,50
1683670833586,INTL 190,A00,185959,Gagnon; Jeffrey C,0,0,0,9
1683670833586,INTL 190,B00,185960,Lettieri; Michael Joseph,0,0,0,2
1683670834609,JAPN 180,A00,254509,Staff,5,0,30,25
1683670835634,LATI 10,A01,202853,Kennemore; Amy Michelle,4,0,35,31
1683670835634,LATI 10,A02,202854,Kennemore; Amy Michelle,2,0,35,33
1683670835634,LATI 10,A03,270054,Kennemore; Amy Michelle,30,0,30,0
1683670836664,LATI 180,A00,202855,Kennemore; Amy Michelle,11,0,20,9
1683670837692,LAWS 101,A00,201767,Golan; Tal,0,7,40,40
1683670838717,LIFR 1C,A00,185961,Staff,6,0,20,14
1683670839744,LIFR 1CX,A00,185962,Staff,7,0,20,13
1683670840770,LIFR 1D,A00,185963,Staff,7,0,20,13
1683670841795,LIFR 1DX,A00,185964,Staff,7,0,20,13
1683670842818,LIGN 101,A01,186039,Staff,43,0,50,7
1683670843845,LIGN 165,A00,186040,Staff,15,0,50,35
1683670844870,LTCS 108,A00,186041,Staff,5,0,10,5
1683670845898,LTCS 119,A00,186042,Staff,15,0,20,5
1683670846926,LTCS 130,A00,186043,Wesling; Megan E.,15,0,25,10
1683670848981,LTEA 138,A00,186119,Staff,14,0,40,26
1683670850006,LTEN 124,A00,186148,Staff,5,0,25,20
1683670851034,LTEN 178,A00,186149,Staff,7,0,15,8
1683670852061,LTEN 181,A00,186150,Blanco; John D,34,0,40,6
1683670853087,LTWL 120,A00,186160,Staff,19,0,25,6
1683670854113,LTWL 165,A00,186161,Staff,22,0,25,3
1683670855140,LTWR 100,A00,186162,Staff,0,5,15,15
1683670856166,LTWR 102,A00,186163,Doller; Ben,5,0,15,10
1683670857190,MAE 8,A01,186412,Staff,0,0,0,0
1683670858216,MAE 30B,A00,186445,Bahadori; Mohammad Yousef,82,0,100,18
1683670859241,MAE 40,A00,186592,Bewley; Thomas R,10,0,50,40
1683670860267,MAE 101B,A00,186593,Bahadori; Mohammad Yousef,80,0,100,20
1683670861297,MAE 105,A00,186594,Bandaru; Prabhakar,10,0,50,40
1683670862325,MAE 107,A00,186599,Pham; Hieu Tan,0,7,120,120
1683670863359,MAE 148,A01,186660,Silberman; Jack,3,0,16,13
1683670864385,MATH 10A,A01,188095,Staff,0,6,35,35
1683670865409,MATH 10B,A01,188097,Bowers; Adam R.,0,12,30,30
1683670865409,MATH 10B,A02,188099,Bowers; Adam R.,0,11,30,30
1683670865409,MATH 10B,B01,188104,Bowers; Adam R.,0,10,30,30
1683670865409,MATH 10B,B02,188106,Bowers; Adam R.,1,9,30,29
1683670866438,MATH 10C,A01,188111,Staff,0,19,30,30
1683670866438,MATH 10C,A02,188127,Staff,0,19,30,30
1683670866438,MATH 10C,A03,188131,Staff,0,19,30,30
1683670866438,MATH 10C,B01,188218,Staff,17,0,30,13
1683670866438,MATH 10C,B02,188244,Staff,13,0,30,17
1683670866438,MATH 10C,B03,188277,Staff,14,0,30,16
1683670867467,MATH 18,A01,188344,Bach; Quang Tran,18,0,30,12
1683670867467,MATH 18,A02,188345,Bach; Quang Tran,11,0,30,19
1683670867467,MATH 18,B01,188353,Bach; Quang Tran,11,0,30,19
1683670867467,MATH 18,B02,188354,Bach; Quang Tran,19,0,30,11
1683670868496,MATH 20A,A01,188374,Staff,11,0,35,24
1683670869521,MATH 20B,A01,188382,Ohm; Ko Woon,7,0,30,23
1683670869521,MATH 20B,A02,188383,Ohm; Ko Woon,22,0,30,8
1683670869521,MATH 20B,B01,188385,Ohm; Ko Woon,7,0,30,23
1683670869521,MATH 20B,B02,188392,Ohm; Ko Woon,22,0,30,8
1683670870552,MATH 20C,A01,188394,Harel; Guershon,10,0,30,20
1683670870552,MATH 20C,A02,188395,Harel; Guershon,13,0,30,17
1683670870552,MATH 20C,B01,188404,Harel; Guershon,5,0,30,25
1683670870552,MATH 20C,B02,188405,Harel; Guershon,18,0,30,12
1683670871578,MATH 20D,A01,188414,Hammock; Frances H,0,1,30,30
1683670871578,MATH 20D,A02,188415,Hammock; Frances H,0,1,30,30
1683670871578,MATH 20D,B01,188447,Hammock; Frances H,0,1,30,30
1683670871578,MATH 20D,B02,188486,Hammock; Frances H,3,0,30,27
1683670872604,MATH 20E,A01,188649,Staff,21,0,30,9
1683670872604,MATH 20E,A02,188650,Staff,20,0,30,10
1683670872604,MATH 20E,A03,188673,Staff,0,0,30,30
1683670873628,MATH 102,A01,188675,Staff,0,37,35,35
1683670874655,MATH 103B,A01,188681,Staff,3,0,35,32
1683670874655,MATH 103B,B01,188692,Staff,5,0,35,30
1683670875683,MATH 109,A01,188695,Salehi Golsefidy; Alireza,24,0,35,11
1683670875683,MATH 109,A02,188696,Salehi Golsefidy; Alireza,25,0,35,10
1683670876711,MATH 120A,A01,188698,Eggers; John Dietrich,7,0,35,28
1683670877742,MATH 142B,A01,188736,Ioana; Adrian,1,1,30,29
1683670877742,MATH 142B,A02,188741,Ioana; Adrian,0,1,30,30
1683670877742,MATH 142B,A03,188743,Ioana; Adrian,0,1,30,30
1683670878768,MATH 168A,A01,188790,Staff,0,11,35,35
1683670879859,MATH 170A,A01,188803,Nie; Jiawang,0,2,35,35
1683670879859,MATH 170A,A02,188811,Nie; Jiawang,0,0,35,35
1683670879859,MATH 170A,A03,188814,Nie; Jiawang,0,0,35,35
1683670879859,MATH 170A,A04,188815,Nie; Jiawang,8,0,35,27
1683670880890,MATH 193B,A01,188817,Staff,0,0,35,35
1683670880890,MATH 193B,A02,188818,Staff,5,0,35,30
1683670881915,MGT 4,A01,202857,Anderson; John Charles,59,0,80,21
1683670882939,MGT 12,A00,202858,Lindenberger; Wade Douglas,40,0,90,50
1683670883972,MGT 18,A00,202859,Staff,74,0,90,16
1683670884997,MGT 18GS,A00,202860,McKay; Michael J,13,0,28,15
1683670886022,MGT 45,A00,202861,Pecore; Joseph P.,11,0,90,79
1683670887046,MGT 100,A00,202863,Yavorsky; Daniel Ryan,28,0,90,62
1683670888069,MGT 103,A00,202864,Ehrich; Kristine R,0,18,90,90
1683670889095,MGT 112,A00,202865,Ehrich; Kristine R,15,0,90,75
1683670890119,MGT 121A,A00,202868,Staff,90,20,90,0
1683670891142,MGT 131B,A00,202869,Anderson; John Charles,59,0,90,31
1683670892165,MGT 136,A00,202871,Lindenberger; Wade Douglas,83,0,90,7
1683670893190,MGT 164,A00,202873,Staff,0,67,90,91
1683670894215,MGT 164GS,A00,202874,McKay; Mary A,13,0,28,15
1683670895239,MGT 180,A00,202875,Staff,0,51,90,91
1683670896262,MMW 11R,A01,205019,Herbst; Matthew,0,0,30,30
1683670896262,MMW 11R,A02,205026,Herbst; Matthew,29,0,30,1
1683670897295,MMW 15,A01,193512,Chang; Edmond Yi-Teh,0,8,28,28
1683670897295,MMW 15,A02,193513,Chang; Edmond Yi-Teh,0,5,28,28
1683670897295,MMW 15,A03,193514,Chang; Edmond Yi-Teh,0,5,28,28
1683670897295,MMW 15,A04,193515,Chang; Edmond Yi-Teh,0,5,28,28
1683670897295,MMW 15,A05,193516,Chang; Edmond Yi-Teh,0,5,28,28
1683670897295,MMW 15,A06,193517,Chang; Edmond Yi-Teh,0,6,28,28
1683670897295,MMW 15,B01,193519,Chang; Edmond Yi-Teh,0,5,28,28
1683670897295,MMW 15,B02,193520,Chang; Edmond Yi-Teh,0,5,28,28
1683670897295,MMW 15,B03,193521,Chang; Edmond Yi-Teh,0,5,28,28
1683670897295,MMW 15,B04,193522,Chang; Edmond Yi-Teh,0,5,28,28
1683670897295,MMW 15,B05,193523,Chang; Edmond Yi-Teh,0,5,28,28
1683670897295,MMW 15,B06,193524,Chang; Edmond Yi-Teh,0,5,28,28
1683670898318,MMW 122,A01,193526,Rahimi; Babak,0,16,28,28
1683670898318,MMW 122,A02,193527,Rahimi; Babak,0,15,28,28
1683670898318,MMW 122,A03,193528,Rahimi; Babak,0,0,0,0
1683670898318,MMW 122,A04,193529,Rahimi; Babak,0,0,0,0
1683670899344,MUS 1A,A01,186663,Staff,1,19,35,34
1683670900369,MUS 4,A01,186715,Staff,0,12,35,35
1683670901397,MUS 5R,A01,186796,Dubnov; Shlomo,0,17,35,35
1683670902425,MUS 6,A01,186798,Staff,0,5,25,25
1683670903451,MUS 7,A01,186830,Staff,11,0,35,24
1683670904480,MUS 8,A01,186930,Staff,0,27,35,35
1683670905510,MUS 15,A01,186932,Staff,0,15,35,35
1683670905510,MUS 15,B01,186934,Staff,1,17,35,34
1683670906535,MUS 80,A00,186935,Staff,0,0,20,20
1683670906535,MUS 80,B00,186936,Staff,24,0,25,1
1683670907565,NANO 11,A00,204702,Lipomi; Darren John,0,0,0,0
1683670908589,NANO 15,A01,204709,Yang; Kesong,0,1,0,0
1683670909615,NANO 114,A00,202069,Jahed Motlagh; Zeinab,3,0,10,7
1683670910643,PHIL 1,A00,186955,Grush; Rick Scott,31,0,40,9
1683670911669,PHIL 10,A01,186973,Grush; Rick Scott,27,0,35,8
1683670911669,PHIL 10,A02,186974,Grush; Rick Scott,33,0,35,2
1683670912699,PHIL 13,A01,186976,Staff,3,0,35,32
1683670912699,PHIL 13,A02,186977,Staff,16,0,35,19
1683670913729,PHIL 14,A01,186979,Staff,31,0,35,4
1683670913729,PHIL 14,A02,186986,Staff,32,0,35,3
1683670914757,PHIL 28,A01,186988,Staff,16,0,30,14
1683670914757,PHIL 28,A02,186989,Staff,1,0,30,29
1683670914757,PHIL 28,A03,186990,Staff,10,0,30,20
1683670914757,PHIL 28,A04,186991,Staff,26,0,30,4
1683670915783,PHIL 120,A00,186997,Staff,23,0,40,17
1683670916808,PHIL 137,A00,187003,Staff,7,0,40,33
1683670917837,PHIL 150,A00,187015,Staff,47,0,70,23
1683670918866,PHIL 167,A00,187021,Lamey; Andy M.,34,0,40,6
1683670919892,PHIL 174,A01,202226,Staff,17,0,20,3
1683670919892,PHIL 174,A02,202235,Staff,20,0,20,0
1683670920919,PHIL 191A,A00,258918,Staff,0,0,1,1
1683670921952,PHYS 1A,A00,187028,Staff,26,0,60,34
1683670922977,PHYS 1AL,001,187036,Staff,3,0,30,27
1683670922977,PHYS 1AL,002,187049,Staff,18,0,30,12
1683670924003,PHYS 1B,A00,187058,Staff,22,0,60,38
1683670925030,PHYS 1BL,001,187064,Staff,0,1,30,30
1683670925030,PHYS 1BL,002,187070,Staff,4,0,30,26
1683670926056,PHYS 1C,A00,187082,Staff,29,0,120,91
1683670927082,PHYS 1CL,001,187088,Staff,0,9,30,30
1683670927082,PHYS 1CL,002,187089,Staff,0,1,30,30
1683670927082,PHYS 1CL,009,262693,Staff,9,0,30,21
1683670928107,PHYS 2B,A01,187097,Staff,55,0,115,60
1683670929137,PHYS 2C,A01,187099,Staff,63,0,115,52
1683670930164,PHYS 2CL,A01,187101,Staff,5,0,28,23
1683670930164,PHYS 2CL,A02,187102,Staff,15,0,28,13
1683670931191,PHYS 2D,A01,187123,Shotwell; Brian,95,0,115,20
1683670932220,PHYS 4B,A01,187133,Grinstein; Benjamin,35,0,50,15
1683670933246,POLI 10,A00,188819,Staff,0,4,50,50
1683670934274,POLI 11,A00,188827,Staff,43,0,50,7
1683670935301,POLI 13R,A00,188828,Staff,0,1,20,20
1683670936329,POLI 27,A01,188830,Elgin; Samuel Zincke,0,2,70,70
1683670937360,POLI 30,A00,188832,Desposato; Scott,30,0,50,20
1683670938386,POLI 102F,A00,188834,Staff,0,0,40,40
1683670939410,POLI 104A,A00,188852,Staff,13,0,30,17
1683670940438,POLI 104I,A00,188853,Staff,0,7,20,20
1683670941466,POLI 110B,A00,188854,Wiens; David,6,0,20,14
1683670942491,POLI 112A,A00,188855,Wiens; David,3,0,30,27
1683670943518,POLI 117R,A00,188856,Forman; Fonna,0,12,20,20
1683670944543,POLI 118,A00,188857,Ingham; Sean,8,0,20,12
1683670945572,POLI 120G,A00,188858,Staff,8,0,30,22
1683670946596,POLI 131CR,A00,188863,Hoston; Germaine,20,0,50,30
1683670947621,POLI 133,A00,188864,Nellis; Gareth Hb,44,0,50,6
1683670948647,POLI 134D,A00,188865,Desposato; Scott,27,0,30,3
1683670949675,POLI 142A,A00,188871,Gartzke; Erik,21,0,50,29
1683670950705,POLI 142K,A00,188874,Staff,38,0,50,12
1683670951729,POLI 143,A00,188940,Gartzke; Erik,16,0,30,14
1683670952757,POLI 153,A00,188943,Staff,2,0,20,18
1683670953784,POLI 160AA,A00,188944,Staff,11,0,40,29
1683670954808,POLI 170A,A00,188945,Staff,11,0,30,19
1683670956860,PSYC 1,A00,188952,Staff,37,0,90,53
1683670957885,PSYC 2,B00,188953,Staff,19,0,35,16
1683670958913,PSYC 6,A00,188970,Staff,47,0,60,13
1683670959938,PSYC 7,A00,188973,Staff,35,0,45,10
1683670960962,PSYC 60,A01,188980,Rickard; Timothy C.,42,0,60,18
1683670961987,PSYC 70,A01,189001,Steiner; Eric Tomas,22,0,45,23
1683670963012,PSYC 100,A00,189005,Lacefield; Katharine I,0,99,120,120
1683670964036,PSYC 102,A00,189008,Staff,8,0,30,22
1683670965065,PSYC 106,B00,189026,Gorman; Michael R.,27,0,60,33
1683670966092,PSYC 114,B01,189033,Winkielman; Piotr,0,31,30,30
1683670967116,PSYC 131,A00,189036,Anagnostaras; Stephan,0,43,60,60
1683670968140,PSYC 136,A00,189041,Lowe; Angela Beth,0,7,25,25
1683670969172,PSYC 137,A00,189057,Winkielman; Piotr,1,37,25,24
1683670970200,PSYC 144,A00,189107,Wixted; John T,0,11,50,50
1683670972254,PSYC 162,A00,189142,Staff,0,9,85,85
1683670973282,PSYC 172,A00,189144,Gorman; Michael R.,0,6,30,30
1683670975333,PSYC 179,A00,189146,Lacefield; Katharine I,0,87,120,120
1683670976362,PSYC 181,A00,189147,Anagnostaras; Stephan,0,44,90,90
1683670977387,PSYC 190R,A00,189148,Barner; David A.,0,23,80,80
1683670978414,PSYC 191,A00,189275,Rickard; Timothy C.,0,10,25,25
1683670979439,PSYC 193,A00,189276,Chapman; Eddie Nathaniel,0,1,0,4
1683670980465,PSYC 193L,A01,189281,Lowe; Angela Beth,10,0,20,10
1683670980465,PSYC 193L,B01,189285,Staff,28,0,35,7
1683670981490,RELI 149,A00,187137,Rahimi; Babak,7,0,40,33
1683670982519,SE 9,A01,187315,Staff,0,2,18,18
1683670983600,SE 101B,A00,187409,Staff,24,0,30,6
1683670984623,SE 110B,A00,187444,Staff,10,0,40,30
1683670985651,SE 130B,A00,187449,Staff,31,0,40,9
1683670986677,SE 150A,A00,187516,Staff,8,0,20,12
1683670987703,SE 154,A00,187528,Staff,29,0,50,21
1683670988731,SIO 3,A01,258171,Staff,35,0,40,5
1683670989756,SIO 10,A00,187144,Cook; Geoffrey W,0,7,75,75
1683670990781,SIO 45,A00,187152,Cook; Geoffrey W,0,5,100,100
1683670991805,SIO 109R,A00,194486,Staff,0,4,20,20
1683670993854,SIO 187,A01,187233,Kacev; David,12,0,40,28
1683670994879,SOCI 1,A01,258656,Thorpe; Charles Robert,28,0,30,2
1683670994879,SOCI 1,A02,258658,Thorpe; Charles Robert,30,0,30,0
1683670994879,SOCI 1,A03,258661,Thorpe; Charles Robert,25,0,25,0
1683670994879,SOCI 1,A04,258666,Thorpe; Charles Robert,22,0,25,3
1683670994879,SOCI 1,A05,258897,Thorpe; Charles Robert,22,0,25,3
1683670994879,SOCI 1,A06,258898,Thorpe; Charles Robert,25,0,25,0
1683670995901,SOCI 30,A01,258903,Pardo Guerra; Juan Pablo,14,0,30,16
1683670996926,SOCI 102,A00,258904,Staff,9,0,25,16
1683670997952,SOCI 106,A00,258905,Staff,19,0,25,6
1683670998977,SOCI 111,A00,258907,Ribas Norris; Janet Vanesa,26,0,30,4
1683671000001,SOCI 121R,A00,258908,Pardo Guerra; Juan Pablo,8,0,30,22
1683671001028,SOCI 126,A01,203330,Staff,14,0,20,6
1683671002052,SOCI 131,A00,258909,Thorpe; Charles Robert,30,0,60,30
1683671003077,SOCI 135,A00,258910,Payne; Christine Anna,0,11,30,30
1683671004105,SOCI 157,A00,258911,Staff,12,0,30,18
1683671005130,SOCI 184,A00,258912,Staff,25,0,30,5
1683671006155,SOCI 188D,A00,258913,Staff,22,0,30,8
1683671007179,SYN 2,001,187529,Staff,9,0,16,7
1683671007179,SYN 2,002,201452,Staff,0,20,16,16
1683671007179,SYN 2,003,201469,Staff,1,0,16,15
1683671008202,SYN 100,A01,187531,Staff,0,9,20,20
1683671008202,SYN 100,B01,201491,Staff,0,10,20,20
1683671009233,TDAC 1,A00,189286,Walsh; Kim C.,3,0,20,17
1683671009233,TDAC 1,B00,189287,Harting; Carla Kelso,10,0,20,10
1683671010260,TDAC 101,A00,189300,Walsh; Kim C.,16,0,20,4
1683671010260,TDAC 101,B00,189301,Harting; Carla Kelso,18,0,20,2
1683671011284,TDAC 102,A00,189304,Basso; Beatrice,14,0,20,6
1683671012312,TDAC 108,A00,189305,Staff,18,0,20,2
1683671013339,TDDE 131,A00,189310,Staff,19,0,20,1
1683671013339,TDDE 131,B00,189314,Staff,19,0,20,1
1683671013339,TDDE 131,C00,189315,Staff,48,0,50,2
1683671013339,TDDE 131,D00,189316,Staff,14,0,15,1
1683671013339,TDDE 131,E00,204841,Staff,20,0,20,0
1683671014363,TDGE 10,A00,189289,Staff,27,0,50,23
1683671014363,TDGE 10,B00,189290,Havis; Allan,0,1,50,50
1683671015392,TDGE 11,A00,189291,Fulton; Julia,0,4,50,50
1683671015392,TDGE 11,B00,189292,Staff,20,0,25,5
1683671015392,TDGE 11,C00,260270,Staff,0,0,0,0
1683671016416,TDGE 25,A00,189294,Staff,2,0,20,18
1683671017443,TDGE 124,A00,189318,Fulton; Julia,0,8,50,50
1683671018468,TDGE 125,A00,189319,Staff,13,0,25,12
1683671018468,TDGE 125,B00,189320,Staff,23,0,25,2
1683671019493,TDGE 127,A00,189322,Havis; Allan,0,0,50,50
1683671020521,TDHT 101,A00,189323,Staff,18,0,25,7
1683671020521,TDHT 101,B00,189324,Staff,25,0,25,0
1683671021545,TDHT 102,A00,189325,Staff,49,0,50,1
1683671022575,TDMV 1,A00,189295,Arcidiacono; Kristin,20,0,30,10
1683671022575,TDMV 1,B00,189296,Caligagan; Maria T.,24,0,30,6
1683671023598,TDMV 2,A00,189297,Sammartano; Tonnie,27,0,30,3
1683671023598,TDMV 2,B00,189299,Arcidiacono; Kristin,23,0,30,7
1683671024621,TDMV 3,A00,204998,Rincon; Alicia,22,0,30,8
1683671025644,TDMV 120,A00,189458,Sammartano; Tonnie,28,0,30,2
1683671026667,TDMV 138,A00,189541,Jun; Grace Shin Hae,20,0,40,20
1683671027691,TDMV 142,A00,189717,Caligagan; Tony,25,0,30,5
1683671027691,TDMV 142,B00,189718,Caligagan; Maria T.,25,0,30,5
1683671028716,TMC 2,A01,187533,Staff,25,0,25,0
1683671028716,TMC 2,A02,187534,Staff,25,0,25,0
1683671029741,USP 1,A01,187536,Kwak; Nancy,0,16,25,25
1683671030768,USP 5,A01,187538,Staff,9,0,25,16
1683671031792,USP 101,A00,199253,Staff,0,4,0,0
1683671032817,USP 124,A00,187562,Boomhower; Matthew Charles,0,0,30,30
1683671033841,USP 138,A00,187582,Staff,19,0,25,6
1683671034865,USP 152,A01,187597,Staff,3,0,25,22
1683671035893,USP 153,A00,187598,Staff,19,0,25,6
1683671036937,USP 168,A00,187607,Kwak; Nancy,2,0,5,3
1683671037961,USP 173,A00,187619,Staff,4,0,25,21
1683671038989,USP 181,A00,187638,Staff,0,4,25,25
1683671040012,VIS 103,A00,187650,Cruz; Edwin Teddy,17,0,75,58
1683671041036,VIS 110D,A00,187669,Staff,13,0,22,9
1683671042062,VIS 127C,A00,187720,Shen; Kuiyi,67,0,146,79
1683671043086,VIS 149,A00,187731,Yoldas; Pinar,1,14,22,21
1683671044113,VIS 151,A01,188091,Staff,22,0,34,12
1683671044113,VIS 151,A02,188092,Staff,11,0,34,23
1683671045142,VIS 160B,A00,188093,Stalbaum; Brett,0,1,10,10
1683671047197,WCWP 10B,A00,201720,Staff,10,0,15,5
1683671047197,WCWP 10B,B00,201722,Staff,9,0,15,6
1683671048224,WCWP 100,A00,201725,Gagnon; Jeffrey C,0,0,2,2
1683671048224,WCWP 100,B00,201727,Staff,0,4,15,15
1683671051324,ANBI 133,A00,258401,Wilder; Linnea Lorene,34,0,40,6
1683671052351,ANBI 140,A00,258395,Hrvoj Mihic; Branka,18,0,25,7
1683671053374,ANSC 120,A00,258402,Bialecki; Jon Anthony,26,0,40,14
1683671054404,ANSC 144,A00,258400,Staff,12,0,40,28
1683671056458,ANSC 166,A00,258396,Parish; Steven Martin,156,0,175,19
1683671057484,ANSC 180,A00,193533,Staff,8,0,20,12
1683671058509,ANSC 188,A00,258397,Jassal; Aftab,34,0,40,6
1683671059538,ANTH 3,A01,258316,Staff,23,0,30,7
1683671060563,ANTH 5,A00,258394,Semendeferi; Ekaterini,16,0,20,4
1683671061588,ANTH 21,A01,258331,Staff,4,0,40,36
1683671062616,ANTH 103,A00,258398,Varma; Saiba,15,0,25,10
1683671063643,AWP 10,001,202034,Staff,0,0,0,0
1683671063643,AWP 10,002,202035,Staff,0,0,0,0
1683671063643,AWP 10,003,202036,Staff,0,0,0,0
1683671063643,AWP 10,004,202037,Staff,0,0,0,0
1683671063643,AWP 10,005,202038,Staff,0,0,0,0
1683671063643,AWP 10,006,202039,Staff,0,0,0,0
1683671063643,AWP 10,007,202040,Staff,0,0,0,0
1683671063643,AWP 10,008,202041,Staff,0,0,0,0
1683671063643,AWP 10,009,202042,Staff,0,0,0,0
1683671063643,AWP 10,010,202043,Staff,0,0,0,0
1683671063643,AWP 10,011,202044,Staff,0,0,0,0
1683671063643,AWP 10,012,202045,Staff,0,0,0,0
1683671063643,AWP 10,013,202046,Staff,0,0,0,0
1683671063643,AWP 10,014,202047,Staff,0,0,0,0
1683671063643,AWP 10,015,202048,Staff,0,0,0,0
1683671063643,AWP 10,016,202049,Staff,0,0,0,0
1683671063643,AWP 10,017,202050,Staff,0,0,0,0
1683671063643,AWP 10,018,202051,Staff,0,0,0,0
1683671063643,AWP 10,019,202052,Staff,0,0,0,0
1683671063643,AWP 10,020,202053,Staff,0,0,0,0
1683671063643,AWP 10,021,202054,Staff,0,0,0,0
1683671063643,AWP 10,022,202055,Staff,0,0,0,0
1683671063643,AWP 10,023,202056,Staff,0,0,0,0
1683671063643,AWP 10,024,202057,Staff,0,0,0,0
1683671063643,AWP 10,025,202058,Staff,0,0,0,0
1683671063643,AWP 10,026,202059,Staff,0,0,0,0
1683671064669,AWP 102,001,202032,Staff,0,0,0,0
1683671064669,AWP 102,002,202033,Staff,0,0,0,0
1683671065694,BENG 100,A01,254234,Taylor Amos; Alyssa C,31,0,40,9
1683671066721,BENG 196,001,270013,Engler; Adam J.,9999,0,9999,0
1683671067750,BICD 100R,A01,202018,Smith; Laurie,0,7,32,32
1683671067750,BICD 100R,A02,202019,Smith; Laurie,0,3,32,32
1683671067750,BICD 100R,A03,202020,Smith; Laurie,0,1,32,32
1683671067750,BICD 100R,A04,202021,Smith; Laurie,6,0,32,26
1683671067750,BICD 100R,A05,202022,Smith; Laurie,11,0,32,21
1683671068776,BICD 136,A01,193242,Gustafson-Brown; Cindy,0,2,32,32
1683671068776,BICD 136,A02,193244,Gustafson-Brown; Cindy,13,0,32,19
1683671069802,BIEB 102,A01,193249,Butler; Shannon Rhey,1,2,32,31
1683671069802,BIEB 102,A02,193251,Butler; Shannon Rhey,0,0,32,32
1683671069802,BIEB 102,A03,193253,Butler; Shannon Rhey,0,0,32,32
1683671069802,BIEB 102,A04,193255,Butler; Shannon Rhey,13,0,32,19
1683671069802,BIEB 102,A05,193265,Butler; Shannon Rhey,25,0,32,7
1683671069802,BIEB 102,A06,193269,Butler; Shannon Rhey,14,0,32,18
1683671071851,BIEB 150,A01,193274,Staff,0,0,32,32
1683671071851,BIEB 150,A02,193285,Staff,24,0,32,8
1683671072880,BIEB 194,A00,193286,Kurle; Carolyn M.,20,0,32,12
1683671073909,BILD 1,A01,192291,Staff,15,0,32,17
1683671073909,BILD 1,A02,192292,Staff,30,0,32,2
1683671073909,BILD 1,B01,192520,Reuther; Keefe,0,1,0,0
1683671073909,BILD 1,B02,192532,Reuther; Keefe,0,1,0,0
1683671074935,BILD 3,A01,192556,Butler; Shannon Rhey,0,0,32,32
1683671074935,BILD 3,A02,192581,Butler; Shannon Rhey,0,1,32,32
1683671074935,BILD 3,A03,192611,Butler; Shannon Rhey,20,0,32,12
1683671074935,BILD 3,A04,192612,Butler; Shannon Rhey,24,0,32,8
1683671074935,BILD 3,A05,192613,Butler; Shannon Rhey,26,0,32,6
1683671074935,BILD 3,A06,192679,Butler; Shannon Rhey,27,0,32,5
1683671074935,BILD 3,A07,192682,Butler; Shannon Rhey,20,0,32,12
1683671075961,BILD 4,A01,192836,Reuther; Keefe,1,0,24,23
1683671075961,BILD 4,A02,193044,Reuther; Keefe,4,0,24,20
1683671076986,BILD 10,A01,193142,Gustafson-Brown; Cindy,29,0,32,3
1683671076986,BILD 10,A02,193149,Gustafson-Brown; Cindy,31,0,32,1
1683671078013,BIMM 100,A01,193301,Staff,0,6,32,32
1683671078013,BIMM 100,A02,193312,Staff,0,7,32,32
1683671078013,BIMM 100,A03,193323,Staff,0,10,32,32
1683671079039,BIMM 101,A01,193329,McDonnell; Lisa Marie,1,4,24,23
1683671079039,BIMM 101,A02,193339,McDonnell; Lisa Marie,1,4,24,23
1683671079039,BIMM 101,B01,193354,McDonnell; Lisa Marie,0,4,24,24
1683671079039,BIMM 101,B02,193357,McDonnell; Lisa Marie,0,3,24,24
1683671080067,BIMM 110,A01,193377,Tat; John,0,11,32,32
1683671080067,BIMM 110,A02,193378,Tat; John,0,10,32,32
1683671081092,BIMM 120,A01,206116,Staff,0,0,32,32
1683671081092,BIMM 120,A02,206117,Staff,7,0,32,25
1683671081092,BIMM 120,A03,206121,Staff,21,0,32,11
1683671082118,BIPN 100,A01,193393,Park; Ji Young,0,15,32,32
1683671082118,BIPN 100,A02,193402,Park; Ji Young,0,14,32,32
1683671082118,BIPN 100,A03,193413,Park; Ji Young,0,14,32,32
1683671082118,BIPN 100,A04,193414,Park; Ji Young,0,13,32,32
1683671083144,BIPN 102,A01,193429,Staff,0,0,32,32
1683671083144,BIPN 102,A02,193438,Staff,18,0,32,14
1683671084169,BIPN 106,A01,193450,Reyes Gonzalez; Catalina,0,2,40,40
1683671085199,BIPN 134,A01,193465,Cooke; James Edward,0,0,32,32
1683671085199,BIPN 134,A02,193474,Cooke; James Edward,25,0,32,7
1683671085199,BIPN 134,A03,193485,Cooke; James Edward,29,0,32,3
1683671085199,BIPN 134,A04,193486,Cooke; James Edward,20,0,32,12
1683671085199,BIPN 134,A05,193491,Cooke; James Edward,31,0,32,1
1683671085199,BIPN 134,A06,193501,Cooke; James Edward,30,0,32,2
1683671085199,BIPN 134,A07,193510,Cooke; James Edward,29,0,32,3
1683671087307,BISP 194,A00,222522,Staff,14,0,32,18
1683671088333,CAT 124,A01,202407,Staff,19,0,25,6
1683671089356,CAT 125,A00,202408,Marchisotto; Jennifer Anne,2,0,20,18
1683671090380,CAT 125R,A00,202409,Smith; Lauryn Alissa,0,11,20,20
1683671090380,CAT 125R,B00,202410,Morales; Celeste Georgianna,0,11,20,20
1683671090380,CAT 125R,C00,202411,Irwin; Matthew Joseph,0,12,20,20
1683671091404,CENG 15,A01,204712,Yang; Kesong,0,1,0,0
1683671092429,CENG 114,A00,202070,Jahed Motlagh; Zeinab,5,0,20,15
1683671093457,CGS 105,A00,185477,Wesling; Megan E.,24,0,40,16
1683671094482,CGS 106,A00,185494,Staff,11,0,22,11
1683671095508,CGS 108,A00,185495,Staff,14,0,20,6
1683671096532,CGS 114,A00,185496,Staff,13,0,18,5
1683671097557,CGS 119,A00,185501,Staff,15,0,20,5
1683671098582,CGS 120,A00,185511,Staff,12,0,20,8
1683671099611,CHEM 4,A01,184675,Bussey; Thomas J,97,0,100,3
1683671100638,CHEM 6A,A01,184677,Staff,32,0,60,28
1683671101667,CHEM 6B,A01,184679,Staff,63,0,100,37
1683671102696,CHEM 6C,A01,184681,Bussey; Thomas J,0,0,50,50
1683671102696,CHEM 6C,A02,184682,Bussey; Thomas J,32,0,50,18
1683671103724,CHEM 40A,A01,184684,Albizati; Kim F.,33,0,100,67
1683671104747,CHEM 40B,A01,184686,Albizati; Kim F.,0,22,100,100
1683671105772,CHEM 41B,A01,184690,Staff,51,0,100,49
1683671106797,COGS 3,A01,184715,Boyle; Mary E. T.,0,27,40,40
1683671107825,COGS 14B,A01,185172,Staff,0,14,38,38
1683671108852,COGS 18,A01,184736,Staff,14,0,80,66
1683671109876,COGS 100,A01,184932,Staff,0,8,73,73
1683671110905,COGS 101A,A01,184935,Staff,0,40,30,30
1683671111932,COGS 101B,A01,184944,Staff,0,2,30,30
1683671112959,COGS 101C,A01,184946,Staff,0,10,30,30
1683671113985,COGS 102A,A01,184951,Johnson; Christine M.,2,0,40,38
1683671115010,COGS 107B,A01,184953,Mooshagian; Eric Frederick,0,51,40,40
1683671116037,COGS 118B,A01,184959,Gupta; Anjum,0,50,40,40
1683671117066,COGS 153,A00,184961,Staff,0,16,30,30
1683671118093,COGS 177,A00,184962,Staff,0,21,30,30
1683671119117,COGS 187A,A01,184969,Boyle; Mary E. T.,0,19,40,40
1683671120145,COMM 10,A01,185174,Staff,0,5,25,25
1683671120145,COMM 10,A02,185189,Staff,0,2,25,25
1683671120145,COMM 10,A03,269821,Staff,0,1,0,0
1683671121172,COMM 100B,A01,185475,Staff,0,1,0,2
1683671121172,COMM 100B,A02,185476,Staff,12,0,25,13
1683671122195,COMM 100C,A01,185314,Staff,1,0,25,24
1683671122195,COMM 100C,A02,185327,Staff,17,0,25,8
1683671123219,COMM 110M,A00,185349,Staff,0,0,40,40
1683671124247,COMM 113T,A00,185352,Staff,25,0,40,15
1683671125275,COMM 114I,A00,185353,Staff,31,0,40,9
1683671126304,COMM 131,A00,185354,Staff,17,0,30,13
1683671127332,CSE 8A,A50,185358,Cao; Yingjun,0,46,10,10
1683671128358,CSE 8B,A01,185362,Staff,0,48,50,50
1683671129386,CSE 11,A01,185416,Cao; Yingjun,0,91,10,10
1683671130411,CSE 20,A01,185445,Briones; Jor-el Thomas Caparas,4,0,25,21
1683671131436,CSE 21,A01,185447,Staff,9,0,50,41
1683671132464,CSE 101,A01,185451,Staff,0,13,50,50
1683671132464,CSE 101,B01,185453,Jones; Miles E,0,14,50,50
1683671134513,CSE 141,A01,185458,Eldon; John,16,0,100,84
1683671135537,CSE 141L,A01,185461,Eldon; John,8,0,100,92
1683671136562,CSE 142,A01,185463,Staff,34,0,60,26
1683671136562,CSE 142,B01,201355,Staff,0,7,60,60
1683671137585,CSE 142L,A01,185470,Staff,34,0,60,26
1683671137585,CSE 142L,B01,201417,Staff,0,6,60,60
1683671138613,CSE 190,A00,201433,Staff,32,0,49,17
1683671139636,DOC 1,A01,259136,Strom; Megan C.,7,0,15,8
1683671139636,DOC 1,A02,259137,Strom; Megan C.,14,0,15,1
1683671139636,DOC 1,A03,259138,Strom; Megan C.,14,0,15,1
1683671139636,DOC 1,A04,259139,Strom; Megan C.,14,0,15,1
1683671140661,DOC 100D,A00,259140,Pass; Natalye Joann,14,0,25,11
1683671141689,DSGN 1,A01,184749,Rill; Bryan,0,26,30,30
1683671142717,DSGN 100,A01,185168,Staff,0,2,25,25
1683671143743,ECE 5,A01,185626,Morris; Karcher William,0,12,0,0
1683671144773,ECE 101,A01,185628,Staff,14,0,70,56
1683671145798,ECE 107,A01,185635,Baghdadchi; Saharnaz,0,0,20,20
1683671145798,ECE 107,A02,185638,Baghdadchi; Saharnaz,1,0,20,19
1683671146823,ECE 148,A01,185647,Silberman; Jack,0,0,16,16
1683671147851,ECON 1,A01,185537,Crane; Meredith Helen,54,0,70,16
1683671148881,ECON 3,A01,185549,Crane; Meredith Helen,29,0,70,41
1683671149905,ECON 4,A01,203354,Anderson; John Charles,0,5,10,10
1683671150930,ECON 100A,A01,185574,Staff,0,5,40,40
1683671151955,ECON 100B,A01,185576,Staff,0,12,50,50
1683671152979,ECON 100C,A01,185589,Newhouse; Herbert S,30,0,70,40
1683671154004,ECON 105,A00,185608,Vespa; Emanuel Ignacio,19,0,35,16
1683671155033,ECON 109,A01,185610,Shishkin; Denis,9,0,35,26
1683671156060,ECON 110A,A01,185612,Staff,9,0,40,31
1683671157087,ECON 120A,A01,185615,Staff,19,0,40,21
1683671158115,ECON 120C,A01,185617,Sun; Yixiao,0,21,70,70
1683671159142,ECON 144,A00,203346,Squires; Dale E,2,0,35,33
1683671160166,ECON 171,A01,203349,Newhouse; Herbert S,0,1,35,35
1683671161190,ECON 173A,A01,185621,Toda; Alexis Akira,20,0,35,15
1683671162219,EDS 25,A01,202413,Staff,0,1,0,0
1683671162219,EDS 25,A02,202414,Staff,0,1,0,0
1683671162219,EDS 25,A03,202415,Staff,0,0,0,0
1683671162219,EDS 25,A04,202416,Staff,0,1,0,0
1683671162219,EDS 25,A05,202439,Staff,0,0,0,0
1683671162219,EDS 25,A06,202440,Staff,0,0,0,0
1683671162219,EDS 25,B01,202631,Staff,0,0,0,0
1683671162219,EDS 25,B02,202632,Staff,0,0,0,0
1683671162219,EDS 25,B03,202639,Staff,0,0,0,0
1683671162219,EDS 25,B04,202640,Staff,0,0,0,0
1683671162219,EDS 25,B05,202643,Staff,0,0,0,0
1683671162219,EDS 25,B06,202644,Staff,0,0,0,0
1683671163256,EDS 38,A01,202659,Black; Alison Michelle,24,0,25,1
1683671164284,EDS 115,A00,202652,Staff,18,0,30,12
1683671165310,EDS 125,A00,202649,Staff,13,0,30,17
1683671166338,EDS 126,A01,203332,Staff,30,0,30,0
1683671167364,EDS 139,A00,202838,Staff,16,0,25,9
1683671168389,EDS 146,A01,202655,Staff,14,0,25,11
1683671169416,ENG 15,A00,185667,Staff,0,1,0,0
1683671169416,ENG 15,B00,185672,Staff,0,0,0,0
1683671169416,ENG 15,C00,185675,Staff,0,0,0,0
1683671169416,ENG 15,D00,185682,Staff,0,0,0,0
1683671169416,ENG 15,E00,185684,Staff,0,0,0,0
1683671170443,ETHN 103,A00,185710,Staff,0,8,35,35
1683671171472,ETHN 103A,A00,199228,Man; Simeon S,0,0,9,9
1683671172501,ETHN 109,A00,185711,Staff,15,0,35,20
1683671173528,ETHN 142,A00,185726,Staff,0,4,30,30
1683671174558,ETHN 163J,A00,199229,Man; Simeon S,5,0,8,3
1683671175582,ETHN 168,A00,185727,Staff,7,0,10,3
1683671176610,ETHN 182,A00,185728,Staff,0,0,35,35
1683671177634,ETHN 183,A00,185737,Staff,9,0,18,9
1683671178659,GLBH 111,A01,209361,Burgos; Jose L.,0,0,0,0
1683671180712,HIEU 104,A00,185792,Staff,14,0,20,6
1683671181741,HIEU 115,A00,185800,Staff,0,0,20,20
1683671182770,HIEU 128,A00,185801,Staff,0,9,20,20
1683671183797,HIEU 147,A00,185802,Staff,15,0,20,5
1683671184822,HIEU 154,A00,185823,Staff,11,0,20,9
1683671185847,HILA 102,A00,185826,Staff,14,0,20,6
1683671186871,HILD 2C,A01,185778,Staff,0,13,20,20
1683671187896,HILD 7B,A01,185780,Kwak; Nancy,0,17,32,32
1683671187896,HILD 7B,A02,185781,Kwak; Nancy,0,18,32,32
1683671188921,HILD 30,A01,185791,Staff,12,0,20,8
1683671189946,HISC 119,A00,185830,Golan; Tal,0,9,20,20
1683671191033,HITO 156GS,A00,185831,Patterson; Patrick H.,0,0,0,23
1683671192063,HIUS 103,A00,185832,Man; Simeon S,0,4,20,20
1683671193088,HIUS 117,A00,185836,Kwak; Nancy,2,0,20,18
1683671194116,HIUS 125,A00,185840,Man; Simeon S,0,2,23,23
1683671195145,HIUS 149,A00,185845,Staff,1,0,20,19
1683671196173,HUM 3,A01,185882,Zavodny; Tatiana Sophia,0,8,50,50
1683671196173,HUM 3,B01,185899,Caldwell; Michael Alan,0,18,50,50
1683671197196,HUM 3GS,A00,185900,Patterson; Patrick H.,0,0,0,23
1683671198225,HUM 4,A01,185938,Zroka; Amy Liane,29,0,50,21
1683671198225,HUM 4,B01,185956,Watkins; Eric,0,5,50,50
1683671198225,HUM 4,B02,202209,Watkins; Eric,0,5,50,50
1683671198225,HUM 4,B03,202210,Watkins; Eric,0,5,50,50
1683671199253,HUM 5,A01,185958,West; Geoffrey Scott,0,0,50,50
1683671199253,HUM 5,A02,202215,West; Geoffrey Scott,0,0,50,50
1683671200277,INTL 190,A00,185959,Gagnon; Jeffrey C,0,0,0,9
1683671200277,INTL 190,B00,185960,Lettieri; Michael Joseph,0,0,0,2
1683671201301,JAPN 180,A00,254509,Staff,5,0,30,25
1683671202327,LATI 10,A01,202853,Kennemore; Amy Michelle,4,0,35,31
1683671202327,LATI 10,A02,202854,Kennemore; Amy Michelle,2,0,35,33
1683671202327,LATI 10,A03,270054,Kennemore; Amy Michelle,30,0,30,0
1683671203352,LATI 180,A00,202855,Kennemore; Amy Michelle,11,0,20,9
1683671204377,LAWS 101,A00,201767,Golan; Tal,0,7,40,40
1683671205402,LIFR 1C,A00,185961,Staff,6,0,20,14
1683671206427,LIFR 1CX,A00,185962,Staff,7,0,20,13
1683671207455,LIFR 1D,A00,185963,Staff,7,0,20,13
1683671208480,LIFR 1DX,A00,185964,Staff,7,0,20,13
1683671209505,LIGN 101,A01,186039,Staff,43,0,50,7
1683671210530,LIGN 165,A00,186040,Staff,15,0,50,35
1683671211557,LTCS 108,A00,186041,Staff,5,0,10,5
1683671212583,LTCS 119,A00,186042,Staff,15,0,20,5
1683671213606,LTCS 130,A00,186043,Wesling; Megan E.,15,0,25,10
1683671215661,LTEA 138,A00,186119,Staff,14,0,40,26
1683671216689,LTEN 124,A00,186148,Staff,5,0,25,20
1683671217717,LTEN 178,A00,186149,Staff,7,0,15,8
1683671218742,LTEN 181,A00,186150,Blanco; John D,34,0,40,6
1683671219768,LTWL 120,A00,186160,Staff,19,0,25,6
1683671220793,LTWL 165,A00,186161,Staff,22,0,25,3
1683671221818,LTWR 100,A00,186162,Staff,0,5,15,15
1683671222842,LTWR 102,A00,186163,Doller; Ben,5,0,15,10
1683671223865,MAE 8,A01,186412,Staff,0,0,0,0
1683671224893,MAE 30B,A00,186445,Bahadori; Mohammad Yousef,82,0,100,18
1683671225920,MAE 40,A00,186592,Bewley; Thomas R,10,0,50,40
1683671226943,MAE 101B,A00,186593,Bahadori; Mohammad Yousef,80,0,100,20
1683671227968,MAE 105,A00,186594,Bandaru; Prabhakar,10,0,50,40
1683671228991,MAE 107,A00,186599,Pham; Hieu Tan,0,7,120,120
1683671230014,MAE 148,A01,186660,Silberman; Jack,3,0,16,13
1683671231040,MATH 10A,A01,188095,Staff,0,6,35,35
1683671232065,MATH 10B,A01,188097,Bowers; Adam R.,0,12,30,30
1683671232065,MATH 10B,A02,188099,Bowers; Adam R.,0,11,30,30
1683671232065,MATH 10B,B01,188104,Bowers; Adam R.,0,10,30,30
1683671232065,MATH 10B,B02,188106,Bowers; Adam R.,1,9,30,29
1683671233089,MATH 10C,A01,188111,Staff,0,19,30,30
1683671233089,MATH 10C,A02,188127,Staff,0,19,30,30
1683671233089,MATH 10C,A03,188131,Staff,0,19,30,30
1683671233089,MATH 10C,B01,188218,Staff,17,0,30,13
1683671233089,MATH 10C,B02,188244,Staff,13,0,30,17
1683671233089,MATH 10C,B03,188277,Staff,14,0,30,16
1683671234117,MATH 18,A01,188344,Bach; Quang Tran,18,0,30,12
1683671234117,MATH 18,A02,188345,Bach; Quang Tran,11,0,30,19
1683671234117,MATH 18,B01,188353,Bach; Quang Tran,11,0,30,19
1683671234117,MATH 18,B02,188354,Bach; Quang Tran,19,0,30,11
1683671235144,MATH 20A,A01,188374,Staff,11,0,35,24
1683671236167,MATH 20B,A01,188382,Ohm; Ko Woon,7,0,30,23
1683671236167,MATH 20B,A02,188383,Ohm; Ko Woon,22,0,30,8
1683671236167,MATH 20B,B01,188385,Ohm; Ko Woon,7,0,30,23
1683671236167,MATH 20B,B02,188392,Ohm; Ko Woon,22,0,30,8
1683671237194,MATH 20C,A01,188394,Harel; Guershon,10,0,30,20
1683671237194,MATH 20C,A02,188395,Harel; Guershon,13,0,30,17
1683671237194,MATH 20C,B01,188404,Harel; Guershon,5,0,30,25
1683671237194,MATH 20C,B02,188405,Harel; Guershon,18,0,30,12
1683671238217,MATH 20D,A01,188414,Hammock; Frances H,0,1,30,30
1683671238217,MATH 20D,A02,188415,Hammock; Frances H,0,1,30,30
1683671238217,MATH 20D,B01,188447,Hammock; Frances H,0,1,30,30
1683671238217,MATH 20D,B02,188486,Hammock; Frances H,3,0,30,27
1683671239241,MATH 20E,A01,188649,Staff,21,0,30,9
1683671239241,MATH 20E,A02,188650,Staff,20,0,30,10
1683671239241,MATH 20E,A03,188673,Staff,0,0,30,30
1683671240268,MATH 102,A01,188675,Staff,0,37,35,35
1683671241294,MATH 103B,A01,188681,Staff,3,0,35,32
1683671241294,MATH 103B,B01,188692,Staff,5,0,35,30
1683671242318,MATH 109,A01,188695,Salehi Golsefidy; Alireza,24,0,35,11
1683671242318,MATH 109,A02,188696,Salehi Golsefidy; Alireza,25,0,35,10
1683671243347,MATH 120A,A01,188698,Eggers; John Dietrich,7,0,35,28
1683671244370,MATH 142B,A01,188736,Ioana; Adrian,1,1,30,29
1683671244370,MATH 142B,A02,188741,Ioana; Adrian,0,1,30,30
1683671244370,MATH 142B,A03,188743,Ioana; Adrian,0,1,30,30
1683671245393,MATH 168A,A01,188790,Staff,0,11,35,35
1683671246419,MATH 170A,A01,188803,Nie; Jiawang,0,2,35,35
1683671246419,MATH 170A,A02,188811,Nie; Jiawang,0,0,35,35
1683671246419,MATH 170A,A03,188814,Nie; Jiawang,0,0,35,35
1683671246419,MATH 170A,A04,188815,Nie; Jiawang,8,0,35,27
1683671247448,MATH 193B,A01,188817,Staff,0,0,35,35
1683671247448,MATH 193B,A02,188818,Staff,5,0,35,30
1683671248474,MGT 4,A01,202857,Anderson; John Charles,59,0,80,21
1683671249499,MGT 12,A00,202858,Lindenberger; Wade Douglas,40,0,90,50
1683671250523,MGT 18,A00,202859,Staff,74,0,90,16
1683671251547,MGT 18GS,A00,202860,McKay; Michael J,13,0,28,15
1683671252592,MGT 45,A00,202861,Pecore; Joseph P.,11,0,90,79
1683671253616,MGT 100,A00,202863,Yavorsky; Daniel Ryan,28,0,90,62
1683671254642,MGT 103,A00,202864,Ehrich; Kristine R,0,18,90,90
1683671255670,MGT 112,A00,202865,Ehrich; Kristine R,15,0,90,75
1683671256698,MGT 121A,A00,202868,Staff,90,20,90,0
1683671257726,MGT 131B,A00,202869,Anderson; John Charles,59,0,90,31
1683671258754,MGT 136,A00,202871,Lindenberger; Wade Douglas,83,0,90,7
1683671259780,MGT 164,A00,202873,Staff,0,67,90,91
1683671260804,MGT 164GS,A00,202874,McKay; Mary A,13,0,28,15
1683671261832,MGT 180,A00,202875,Staff,0,51,90,91
1683671262859,MMW 11R,A01,205019,Herbst; Matthew,0,0,30,30
1683671262859,MMW 11R,A02,205026,Herbst; Matthew,29,0,30,1
1683671263888,MMW 15,A01,193512,Chang; Edmond Yi-Teh,0,8,28,28
1683671263888,MMW 15,A02,193513,Chang; Edmond Yi-Teh,0,5,28,28
1683671263888,MMW 15,A03,193514,Chang; Edmond Yi-Teh,0,5,28,28
1683671263888,MMW 15,A04,193515,Chang; Edmond Yi-Teh,0,5,28,28
1683671263888,MMW 15,A05,193516,Chang; Edmond Yi-Teh,0,5,28,28
1683671263888,MMW 15,A06,193517,Chang; Edmond Yi-Teh,0,6,28,28
1683671263888,MMW 15,B01,193519,Chang; Edmond Yi-Teh,0,5,28,28
1683671263888,MMW 15,B02,193520,Chang; Edmond Yi-Teh,0,5,28,28
1683671263888,MMW 15,B03,193521,Chang; Edmond Yi-Teh,0,5,28,28
1683671263888,MMW 15,B04,193522,Chang; Edmond Yi-Teh,0,5,28,28
1683671263888,MMW 15,B05,193523,Chang; Edmond Yi-Teh,0,5,28,28
1683671263888,MMW 15,B06,193524,Chang; Edmond Yi-Teh,0,5,28,28
1683671264913,MMW 122,A01,193526,Rahimi; Babak,0,16,28,28
1683671264913,MMW 122,A02,193527,Rahimi; Babak,0,15,28,28
1683671264913,MMW 122,A03,193528,Rahimi; Babak,0,0,0,0
1683671264913,MMW 122,A04,193529,Rahimi; Babak,0,0,0,0
1683671265941,MUS 1A,A01,186663,Staff,1,19,35,34
1683671266966,MUS 4,A01,186715,Staff,0,12,35,35
1683671267993,MUS 5R,A01,186796,Dubnov; Shlomo,0,17,35,35
1683671269018,MUS 6,A01,186798,Staff,0,5,25,25
1683671270042,MUS 7,A01,186830,Staff,11,0,35,24
1683671271071,MUS 8,A01,186930,Staff,0,27,35,35
1683671272097,MUS 15,A01,186932,Staff,0,15,35,35
1683671272097,MUS 15,B01,186934,Staff,1,17,35,34
1683671273123,MUS 80,A00,186935,Staff,0,0,20,20
1683671273123,MUS 80,B00,186936,Staff,24,0,25,1
1683671274148,NANO 11,A00,204702,Lipomi; Darren John,0,0,0,0
1683671275173,NANO 15,A01,204709,Yang; Kesong,0,1,0,0
1683671276202,NANO 114,A00,202069,Jahed Motlagh; Zeinab,3,0,10,7
1683671277230,PHIL 1,A00,186955,Grush; Rick Scott,31,0,40,9
1683671278254,PHIL 10,A01,186973,Grush; Rick Scott,27,0,35,8
1683671278254,PHIL 10,A02,186974,Grush; Rick Scott,33,0,35,2
1683671279279,PHIL 13,A01,186976,Staff,3,0,35,32
1683671279279,PHIL 13,A02,186977,Staff,16,0,35,19
1683671280309,PHIL 14,A01,186979,Staff,31,0,35,4
1683671280309,PHIL 14,A02,186986,Staff,32,0,35,3
1683671281337,PHIL 28,A01,186988,Staff,16,0,30,14
1683671281337,PHIL 28,A02,186989,Staff,1,0,30,29
1683671281337,PHIL 28,A03,186990,Staff,10,0,30,20
1683671281337,PHIL 28,A04,186991,Staff,26,0,30,4
1683671282363,PHIL 120,A00,186997,Staff,23,0,40,17
1683671283388,PHIL 137,A00,187003,Staff,7,0,40,33
1683671284413,PHIL 150,A00,187015,Staff,47,0,70,23
1683671285439,PHIL 167,A00,187021,Lamey; Andy M.,34,0,40,6
1683671286468,PHIL 174,A01,202226,Staff,17,0,20,3
1683671286468,PHIL 174,A02,202235,Staff,20,0,20,0
1683671287491,PHIL 191A,A00,258918,Staff,0,0,1,1
1683671288515,PHYS 1A,A00,187028,Staff,26,0,60,34
1683671289545,PHYS 1AL,001,187036,Staff,3,0,30,27
1683671289545,PHYS 1AL,002,187049,Staff,18,0,30,12
1683671290574,PHYS 1B,A00,187058,Staff,22,0,60,38
1683671291599,PHYS 1BL,001,187064,Staff,0,1,30,30
1683671291599,PHYS 1BL,002,187070,Staff,4,0,30,26
1683671292624,PHYS 1C,A00,187082,Staff,29,0,120,91
1683671293654,PHYS 1CL,001,187088,Staff,0,9,30,30
1683671293654,PHYS 1CL,002,187089,Staff,0,1,30,30
1683671293654,PHYS 1CL,009,262693,Staff,9,0,30,21
1683671294736,PHYS 2B,A01,187097,Staff,55,0,115,60
1683671295761,PHYS 2C,A01,187099,Staff,63,0,115,52
1683671296785,PHYS 2CL,A01,187101,Staff,5,0,28,23
1683671296785,PHYS 2CL,A02,187102,Staff,15,0,28,13
1683671297809,PHYS 2D,A01,187123,Shotwell; Brian,95,0,115,20
1683671298839,PHYS 4B,A01,187133,Grinstein; Benjamin,35,0,50,15
1683671299867,POLI 10,A00,188819,Staff,0,4,50,50
1683671300895,POLI 11,A00,188827,Staff,43,0,50,7
1683671301920,POLI 13R,A00,188828,Staff,0,1,20,20
1683671302946,POLI 27,A01,188830,Elgin; Samuel Zincke,0,2,70,70
1683671303974,POLI 30,A00,188832,Desposato; Scott,30,0,50,20
1683671304998,POLI 102F,A00,188834,Staff,0,0,40,40
1683671306026,POLI 104A,A00,188852,Staff,13,0,30,17
1683671307054,POLI 104I,A00,188853,Staff,0,7,20,20
1683671308081,POLI 110B,A00,188854,Wiens; David,6,0,20,14
1683671309106,POLI 112A,A00,188855,Wiens; David,3,0,30,27
1683671310133,POLI 117R,A00,188856,Forman; Fonna,0,12,20,20
1683671311156,POLI 118,A00,188857,Ingham; Sean,8,0,20,12
1683671312183,POLI 120G,A00,188858,Staff,8,0,30,22
1683671313209,POLI 131CR,A00,188863,Hoston; Germaine,20,0,50,30
1683671314234,POLI 133,A00,188864,Nellis; Gareth Hb,44,0,50,6
1683671315259,POLI 134D,A00,188865,Desposato; Scott,27,0,30,3
1683671316287,POLI 142A,A00,188871,Gartzke; Erik,21,0,50,29
1683671317312,POLI 142K,A00,188874,Staff,38,0,50,12
1683671318338,POLI 143,A00,188940,Gartzke; Erik,16,0,30,14
1683671319363,POLI 153,A00,188943,Staff,2,0,20,18
1683671320390,POLI 160AA,A00,188944,Staff,11,0,40,29
1683671321418,POLI 170A,A00,188945,Staff,11,0,30,19
1683671323471,PSYC 1,A00,188952,Staff,37,0,90,53
1683671324496,PSYC 2,B00,188953,Staff,19,0,35,16
1683671325520,PSYC 6,A00,188970,Staff,47,0,60,13
1683671326544,PSYC 7,A00,188973,Staff,35,0,45,10
1683671327573,PSYC 60,A01,188980,Rickard; Timothy C.,42,0,60,18
1683671328598,PSYC 70,A01,189001,Steiner; Eric Tomas,22,0,45,23
1683671329624,PSYC 100,A00,189005,Lacefield; Katharine I,0,99,120,120
1683671330652,PSYC 102,A00,189008,Staff,8,0,30,22
1683671331681,PSYC 106,B00,189026,Gorman; Michael R.,27,0,60,33
1683671332703,PSYC 114,B01,189033,Winkielman; Piotr,0,31,30,30
1683671333728,PSYC 131,A00,189036,Anagnostaras; Stephan,0,43,60,60
1683671334758,PSYC 136,A00,189041,Lowe; Angela Beth,0,7,25,25
1683671335787,PSYC 137,A00,189057,Winkielman; Piotr,1,37,25,24
1683671336815,PSYC 144,A00,189107,Wixted; John T,0,11,50,50
1683671338872,PSYC 162,A00,189142,Staff,0,9,85,85
1683671339896,PSYC 172,A00,189144,Gorman; Michael R.,0,6,30,30
1683671341952,PSYC 179,A00,189146,Lacefield; Katharine I,0,87,120,120
1683671342976,PSYC 181,A00,189147,Anagnostaras; Stephan,0,44,90,90
1683671344004,PSYC 190R,A00,189148,Barner; David A.,0,23,80,80
1683671345029,PSYC 191,A00,189275,Rickard; Timothy C.,0,10,25,25
1683671346053,PSYC 193,A00,189276,Chapman; Eddie Nathaniel,0,1,0,4
1683671347079,PSYC 193L,A01,189281,Lowe; Angela Beth,10,0,20,10
1683671347079,PSYC 193L,B01,189285,Staff,28,0,35,7
1683671348106,RELI 149,A00,187137,Rahimi; Babak,7,0,40,33
1683671349131,SE 9,A01,187315,Staff,0,2,18,18
1683671350156,SE 101B,A00,187409,Staff,24,0,30,6
1683671351181,SE 110B,A00,187444,Staff,10,0,40,30
1683671352209,SE 130B,A00,187449,Staff,31,0,40,9
1683671353232,SE 150A,A00,187516,Staff,8,0,20,12
1683671354261,SE 154,A00,187528,Staff,29,0,50,21
1683671355289,SIO 3,A01,258171,Staff,35,0,40,5
1683671356317,SIO 10,A00,187144,Cook; Geoffrey W,0,7,75,75
1683671357343,SIO 45,A00,187152,Cook; Geoffrey W,0,5,100,100
1683671358366,SIO 109R,A00,194486,Staff,0,4,20,20
1683671360419,SIO 187,A01,187233,Kacev; David,12,0,40,28
1683671361445,SOCI 1,A01,258656,Thorpe; Charles Robert,28,0,30,2
1683671361445,SOCI 1,A02,258658,Thorpe; Charles Robert,30,0,30,0
1683671361445,SOCI 1,A03,258661,Thorpe; Charles Robert,25,0,25,0
1683671361445,SOCI 1,A04,258666,Thorpe; Charles Robert,22,0,25,3
1683671361445,SOCI 1,A05,258897,Thorpe; Charles Robert,22,0,25,3
1683671361445,SOCI 1,A06,258898,Thorpe; Charles Robert,25,0,25,0
1683671362473,SOCI 30,A01,258903,Pardo Guerra; Juan Pablo,14,0,30,16
1683671363502,SOCI 102,A00,258904,Staff,9,0,25,16
1683671364530,SOCI 106,A00,258905,Staff,19,0,25,6
1683671365559,SOCI 111,A00,258907,Ribas Norris; Janet Vanesa,26,0,30,4
1683671366588,SOCI 121R,A00,258908,Pardo Guerra; Juan Pablo,8,0,30,22
1683671367614,SOCI 126,A01,203330,Staff,14,0,20,6
1683671368638,SOCI 131,A00,258909,Thorpe; Charles Robert,30,0,60,30
1683671369667,SOCI 135,A00,258910,Payne; Christine Anna,0,11,30,30
1683671370692,SOCI 157,A00,258911,Staff,12,0,30,18
1683671371717,SOCI 184,A00,258912,Staff,25,0,30,5
1683671372744,SOCI 188D,A00,258913,Staff,22,0,30,8
1683671373769,SYN 2,001,187529,Staff,9,0,16,7
1683671373769,SYN 2,002,201452,Staff,0,20,16,16
1683671373769,SYN 2,003,201469,Staff,1,0,16,15
1683671374796,SYN 100,A01,187531,Staff,0,9,20,20
1683671374796,SYN 100,B01,201491,Staff,0,10,20,20
1683671375824,TDAC 1,A00,189286,Walsh; Kim C.,3,0,20,17
1683671375824,TDAC 1,B00,189287,Harting; Carla Kelso,10,0,20,10
1683671376850,TDAC 101,A00,189300,Walsh; Kim C.,16,0,20,4
1683671376850,TDAC 101,B00,189301,Harting; Carla Kelso,18,0,20,2
1683671377877,TDAC 102,A00,189304,Basso; Beatrice,14,0,20,6
1683671378901,TDAC 108,A00,189305,Staff,18,0,20,2
1683671379927,TDDE 131,A00,189310,Staff,19,0,20,1
1683671379927,TDDE 131,B00,189314,Staff,19,0,20,1
1683671379927,TDDE 131,C00,189315,Staff,48,0,50,2
1683671379927,TDDE 131,D00,189316,Staff,14,0,15,1
1683671379927,TDDE 131,E00,204841,Staff,20,0,20,0
1683671380951,TDGE 10,A00,189289,Staff,27,0,50,23
1683671380951,TDGE 10,B00,189290,Havis; Allan,0,1,50,50
1683671381976,TDGE 11,A00,189291,Fulton; Julia,0,4,50,50
1683671381976,TDGE 11,B00,189292,Staff,20,0,25,5
1683671381976,TDGE 11,C00,260270,Staff,0,0,0,0
1683671383001,TDGE 25,A00,189294,Staff,2,0,20,18
1683671384025,TDGE 124,A00,189318,Fulton; Julia,0,8,50,50
1683671385052,TDGE 125,A00,189319,Staff,13,0,25,12
1683671385052,TDGE 125,B00,189320,Staff,23,0,25,2
1683671386080,TDGE 127,A00,189322,Havis; Allan,0,0,50,50
1683671387108,TDHT 101,A00,189323,Staff,18,0,25,7
1683671387108,TDHT 101,B00,189324,Staff,25,0,25,0
1683671388134,TDHT 102,A00,189325,Staff,49,0,50,1
1683671389159,TDMV 1,A00,189295,Arcidiacono; Kristin,20,0,30,10
1683671389159,TDMV 1,B00,189296,Caligagan; Maria T.,24,0,30,6
1683671390184,TDMV 2,A00,189297,Sammartano; Tonnie,27,0,30,3
1683671390184,TDMV 2,B00,189299,Arcidiacono; Kristin,23,0,30,7
1683671391212,TDMV 3,A00,204998,Rincon; Alicia,22,0,30,8
1683671392239,TDMV 120,A00,189458,Sammartano; Tonnie,28,0,30,2
1683671393264,TDMV 138,A00,189541,Jun; Grace Shin Hae,20,0,40,20
1683671394289,TDMV 142,A00,189717,Caligagan; Tony,25,0,30,5
1683671394289,TDMV 142,B00,189718,Caligagan; Maria T.,25,0,30,5
1683671395316,TMC 2,A01,187533,Staff,25,0,25,0
1683671395316,TMC 2,A02,187534,Staff,25,0,25,0
1683671396344,USP 1,A01,187536,Kwak; Nancy,0,16,25,25
1683671397369,USP 5,A01,187538,Staff,9,0,25,16
1683671398451,USP 101,A00,199253,Staff,0,4,0,0
1683671399481,USP 124,A00,187562,Boomhower; Matthew Charles,0,0,30,30
1683671400505,USP 138,A00,187582,Staff,19,0,25,6
1683671401530,USP 152,A01,187597,Staff,3,0,25,22
1683671402553,USP 153,A00,187598,Staff,19,0,25,6
1683671403577,USP 168,A00,187607,Kwak; Nancy,2,0,5,3
1683671404602,USP 173,A00,187619,Staff,4,0,25,21
1683671405625,USP 181,A00,187638,Staff,0,4,25,25
1683671406652,VIS 103,A00,187650,Cruz; Edwin Teddy,17,0,75,58
1683671407679,VIS 110D,A00,187669,Staff,13,0,22,9
1683671408707,VIS 127C,A00,187720,Shen; Kuiyi,67,0,146,79
1683671409730,VIS 149,A00,187731,Yoldas; Pinar,1,14,22,21
1683671410757,VIS 151,A01,188091,Staff,22,0,34,12
1683671410757,VIS 151,A02,188092,Staff,11,0,34,23
1683671411782,VIS 160B,A00,188093,Stalbaum; Brett,0,1,10,10
1683671413833,WCWP 10B,A00,201720,Staff,10,0,15,5
1683671413833,WCWP 10B,B00,201722,Staff,9,0,15,6
1683671414859,WCWP 100,A00,201725,Gagnon; Jeffrey C,0,0,2,2
1683671414859,WCWP 100,B00,201727,Staff,0,4,15,15
1683671417953,ANBI 133,A00,258401,Wilder; Linnea Lorene,34,0,40,6
1683671418977,ANBI 140,A00,258395,Hrvoj Mihic; Branka,18,0,25,7
1683671420002,ANSC 120,A00,258402,Bialecki; Jon Anthony,26,0,40,14
1683671421027,ANSC 144,A00,258400,Staff,12,0,40,28
1683671423076,ANSC 166,A00,258396,Parish; Steven Martin,156,0,175,19
1683671424100,ANSC 180,A00,193533,Staff,8,0,20,12
1683671425123,ANSC 188,A00,258397,Jassal; Aftab,34,0,40,6
1683671426148,ANTH 3,A01,258316,Staff,23,0,30,7
1683671427172,ANTH 5,A00,258394,Semendeferi; Ekaterini,16,0,20,4
1683671428195,ANTH 21,A01,258331,Staff,4,0,40,36
1683671429222,ANTH 103,A00,258398,Varma; Saiba,15,0,25,10
1683671430249,AWP 10,001,202034,Staff,0,0,0,0
1683671430249,AWP 10,002,202035,Staff,0,0,0,0
1683671430249,AWP 10,003,202036,Staff,0,0,0,0
1683671430249,AWP 10,004,202037,Staff,0,0,0,0
1683671430249,AWP 10,005,202038,Staff,0,0,0,0
1683671430249,AWP 10,006,202039,Staff,0,0,0,0
1683671430249,AWP 10,007,202040,Staff,0,0,0,0
1683671430249,AWP 10,008,202041,Staff,0,0,0,0
1683671430249,AWP 10,009,202042,Staff,0,0,0,0
1683671430249,AWP 10,010,202043,Staff,0,0,0,0
1683671430249,AWP 10,011,202044,Staff,0,0,0,0
1683671430249,AWP 10,012,202045,Staff,0,0,0,0
1683671430249,AWP 10,013,202046,Staff,0,0,0,0
1683671430249,AWP 10,014,202047,Staff,0,0,0,0
1683671430249,AWP 10,015,202048,Staff,0,0,0,0
1683671430249,AWP 10,016,202049,Staff,0,0,0,0
1683671430249,AWP 10,017,202050,Staff,0,0,0,0
1683671430249,AWP 10,018,202051,Staff,0,0,0,0
1683671430249,AWP 10,019,202052,Staff,0,0,0,0
1683671430249,AWP 10,020,202053,Staff,0,0,0,0
1683671430249,AWP 10,021,202054,Staff,0,0,0,0
1683671430249,AWP 10,022,202055,Staff,0,0,0,0
1683671430249,AWP 10,023,202056,Staff,0,0,0,0
1683671430249,AWP 10,024,202057,Staff,0,0,0,0
1683671430249,AWP 10,025,202058,Staff,0,0,0,0
1683671430249,AWP 10,026,202059,Staff,0,0,0,0
1683671431275,AWP 102,001,202032,Staff,0,0,0,0
1683671431275,AWP 102,002,202033,Staff,0,0,0,0
1683671432299,BENG 100,A01,254234,Taylor Amos; Alyssa C,31,0,40,9
1683671433324,BENG 196,001,270013,Engler; Adam J.,9999,0,9999,0
1683671434353,BICD 100R,A01,202018,Smith; Laurie,0,7,32,32
1683671434353,BICD 100R,A02,202019,Smith; Laurie,0,3,32,32
1683671434353,BICD 100R,A03,202020,Smith; Laurie,0,1,32,32
1683671434353,BICD 100R,A04,202021,Smith; Laurie,6,0,32,26
1683671434353,BICD 100R,A05,202022,Smith; Laurie,11,0,32,21
1683671435381,BICD 136,A01,193242,Gustafson-Brown; Cindy,0,2,32,32
1683671435381,BICD 136,A02,193244,Gustafson-Brown; Cindy,13,0,32,19
1683671436410,BIEB 102,A01,193249,Butler; Shannon Rhey,1,2,32,31
1683671436410,BIEB 102,A02,193251,Butler; Shannon Rhey,0,0,32,32
1683671436410,BIEB 102,A03,193253,Butler; Shannon Rhey,0,0,32,32
1683671436410,BIEB 102,A04,193255,Butler; Shannon Rhey,13,0,32,19
1683671436410,BIEB 102,A05,193265,Butler; Shannon Rhey,25,0,32,7
1683671436410,BIEB 102,A06,193269,Butler; Shannon Rhey,14,0,32,18
1683671438460,BIEB 150,A01,193274,Staff,0,0,32,32
1683671438460,BIEB 150,A02,193285,Staff,24,0,32,8
1683671439488,BIEB 194,A00,193286,Kurle; Carolyn M.,20,0,32,12
1683671440512,BILD 1,A01,192291,Staff,15,0,32,17
1683671440512,BILD 1,A02,192292,Staff,30,0,32,2
1683671440512,BILD 1,B01,192520,Reuther; Keefe,0,1,0,0
1683671440512,BILD 1,B02,192532,Reuther; Keefe,0,1,0,0
1683671441542,BILD 3,A01,192556,Butler; Shannon Rhey,0,0,32,32
1683671441542,BILD 3,A02,192581,Butler; Shannon Rhey,0,1,32,32
1683671441542,BILD 3,A03,192611,Butler; Shannon Rhey,20,0,32,12
1683671441542,BILD 3,A04,192612,Butler; Shannon Rhey,24,0,32,8
1683671441542,BILD 3,A05,192613,Butler; Shannon Rhey,26,0,32,6
1683671441542,BILD 3,A06,192679,Butler; Shannon Rhey,27,0,32,5
1683671441542,BILD 3,A07,192682,Butler; Shannon Rhey,20,0,32,12
1683671442568,BILD 4,A01,192836,Reuther; Keefe,1,0,24,23
1683671442568,BILD 4,A02,193044,Reuther; Keefe,4,0,24,20
1683671443597,BILD 10,A01,193142,Gustafson-Brown; Cindy,29,0,32,3
1683671443597,BILD 10,A02,193149,Gustafson-Brown; Cindy,31,0,32,1
1683671444626,BIMM 100,A01,193301,Staff,0,6,32,32
1683671444626,BIMM 100,A02,193312,Staff,0,7,32,32
1683671444626,BIMM 100,A03,193323,Staff,0,10,32,32
1683671445652,BIMM 101,A01,193329,McDonnell; Lisa Marie,1,4,24,23
1683671445652,BIMM 101,A02,193339,McDonnell; Lisa Marie,1,4,24,23
1683671445652,BIMM 101,B01,193354,McDonnell; Lisa Marie,0,4,24,24
1683671445652,BIMM 101,B02,193357,McDonnell; Lisa Marie,0,3,24,24
1683671446681,BIMM 110,A01,193377,Tat; John,0,11,32,32
1683671446681,BIMM 110,A02,193378,Tat; John,0,10,32,32
1683671447708,BIMM 120,A01,206116,Staff,0,0,32,32
1683671447708,BIMM 120,A02,206117,Staff,7,0,32,25
1683671447708,BIMM 120,A03,206121,Staff,21,0,32,11
1683671448734,BIPN 100,A01,193393,Park; Ji Young,0,15,32,32
1683671448734,BIPN 100,A02,193402,Park; Ji Young,0,14,32,32
1683671448734,BIPN 100,A03,193413,Park; Ji Young,0,14,32,32
1683671448734,BIPN 100,A04,193414,Park; Ji Young,0,13,32,32
1683671449764,BIPN 102,A01,193429,Staff,0,0,32,32
1683671449764,BIPN 102,A02,193438,Staff,18,0,32,14
1683671450789,BIPN 106,A01,193450,Reyes Gonzalez; Catalina,0,2,40,40
1683671451819,BIPN 134,A01,193465,Cooke; James Edward,0,0,32,32
1683671451819,BIPN 134,A02,193474,Cooke; James Edward,25,0,32,7
1683671451819,BIPN 134,A03,193485,Cooke; James Edward,29,0,32,3
1683671451819,BIPN 134,A04,193486,Cooke; James Edward,20,0,32,12
1683671451819,BIPN 134,A05,193491,Cooke; James Edward,31,0,32,1
1683671451819,BIPN 134,A06,193501,Cooke; James Edward,30,0,32,2
1683671451819,BIPN 134,A07,193510,Cooke; James Edward,29,0,32,3
1683671453870,BISP 194,A00,222522,Staff,14,0,32,18
1683671454894,CAT 124,A01,202407,Staff,19,0,25,6
1683671455921,CAT 125,A00,202408,Marchisotto; Jennifer Anne,2,0,20,18
1683671459703,CAT 125R,A00,202409,Smith; Lauryn Alissa,0,11,20,20
1683671459703,CAT 125R,B00,202410,Morales; Celeste Georgianna,0,11,20,20
1683671459703,CAT 125R,C00,202411,Irwin; Matthew Joseph,0,12,20,20
1683671460727,CENG 15,A01,204712,Yang; Kesong,0,1,0,0
1683671461753,CENG 114,A00,202070,Jahed Motlagh; Zeinab,5,0,20,15
1683671462777,CGS 105,A00,185477,Wesling; Megan E.,24,0,40,16
1683671463801,CGS 106,A00,185494,Staff,11,0,22,11
1683671464826,CGS 108,A00,185495,Staff,14,0,20,6
1683671465852,CGS 114,A00,185496,Staff,13,0,18,5
1683671466877,CGS 119,A00,185501,Staff,15,0,20,5
1683671467903,CGS 120,A00,185511,Staff,12,0,20,8
1683671468931,CHEM 4,A01,184675,Bussey; Thomas J,97,0,100,3
1683671469958,CHEM 6A,A01,184677,Staff,32,0,60,28
1683671470985,CHEM 6B,A01,184679,Staff,63,0,100,37
1683671472010,CHEM 6C,A01,184681,Bussey; Thomas J,0,0,50,50
1683671472010,CHEM 6C,A02,184682,Bussey; Thomas J,32,0,50,18
1683671473034,CHEM 40A,A01,184684,Albizati; Kim F.,33,0,100,67
1683671474058,CHEM 40B,A01,184686,Albizati; Kim F.,0,22,100,100
1683671475084,CHEM 41B,A01,184690,Staff,51,0,100,49
1683671476109,COGS 3,A01,184715,Boyle; Mary E. T.,0,27,40,40
1683671477133,COGS 14B,A01,185172,Staff,0,14,38,38
1683671478157,COGS 18,A01,184736,Staff,14,0,80,66
1683671479186,COGS 100,A01,184932,Staff,0,8,73,73
1683671480210,COGS 101A,A01,184935,Staff,0,40,30,30
1683671481238,COGS 101B,A01,184944,Staff,0,2,30,30
1683671482261,COGS 101C,A01,184946,Staff,0,10,30,30
1683671483291,COGS 102A,A01,184951,Johnson; Christine M.,2,0,40,38
1683671484318,COGS 107B,A01,184953,Mooshagian; Eric Frederick,0,52,40,40
1683671485345,COGS 118B,A01,184959,Gupta; Anjum,0,50,40,40
1683671486370,COGS 153,A00,184961,Staff,0,16,30,30
1683671487392,COGS 177,A00,184962,Staff,0,21,30,30
1683671488415,COGS 187A,A01,184969,Boyle; Mary E. T.,0,19,40,40
1683671489439,COMM 10,A01,185174,Staff,0,5,25,25
1683671489439,COMM 10,A02,185189,Staff,0,2,25,25
1683671489439,COMM 10,A03,269821,Staff,0,1,0,0
1683671490465,COMM 100B,A01,185475,Staff,0,1,0,2
1683671490465,COMM 100B,A02,185476,Staff,12,0,25,13
1683671491493,COMM 100C,A01,185314,Staff,1,0,25,24
1683671491493,COMM 100C,A02,185327,Staff,17,0,25,8
1683671492521,COMM 110M,A00,185349,Staff,0,0,40,40
1683671493546,COMM 113T,A00,185352,Staff,25,0,40,15
1683671494574,COMM 114I,A00,185353,Staff,31,0,40,9
1683671495601,COMM 131,A00,185354,Staff,17,0,30,13
1683671496673,CSE 8A,A50,185358,Cao; Yingjun,0,46,10,10
1683671497699,CSE 8B,A01,185362,Staff,0,48,50,50
1683671498726,CSE 11,A01,185416,Cao; Yingjun,0,91,10,10
1683671499751,CSE 20,A01,185445,Briones; Jor-el Thomas Caparas,4,0,25,21
1683671500778,CSE 21,A01,185447,Staff,9,0,50,41
1683671501802,CSE 101,A01,185451,Staff,0,13,50,50
1683671501802,CSE 101,B01,185453,Jones; Miles E,0,14,50,50
1683671503857,CSE 141,A01,185458,Eldon; John,16,0,100,84
1683671504940,CSE 141L,A01,185461,Eldon; John,8,0,100,92
1683671505969,CSE 142,A01,185463,Staff,34,0,60,26
1683671505969,CSE 142,B01,201355,Staff,0,7,60,60
1683671506995,CSE 142L,A01,185470,Staff,34,0,60,26
1683671506995,CSE 142L,B01,201417,Staff,0,6,60,60
1683671508023,CSE 190,A00,201433,Staff,32,0,49,17
1683671509047,DOC 1,A01,259136,Strom; Megan C.,7,0,15,8
1683671509047,DOC 1,A02,259137,Strom; Megan C.,14,0,15,1
1683671509047,DOC 1,A03,259138,Strom; Megan C.,14,0,15,1
1683671509047,DOC 1,A04,259139,Strom; Megan C.,14,0,15,1
1683671510075,DOC 100D,A00,259140,Pass; Natalye Joann,14,0,25,11
1683671511099,DSGN 1,A01,184749,Rill; Bryan,0,26,30,30
1683671512124,DSGN 100,A01,185168,Staff,0,2,25,25
1683671513148,ECE 5,A01,185626,Morris; Karcher William,0,12,0,0
1683671514173,ECE 101,A01,185628,Staff,14,0,70,56
1683671515200,ECE 107,A01,185635,Baghdadchi; Saharnaz,0,0,20,20
1683671515200,ECE 107,A02,185638,Baghdadchi; Saharnaz,1,0,20,19
1683671516225,ECE 148,A01,185647,Silberman; Jack,0,0,16,16
1683671517252,ECON 1,A01,185537,Crane; Meredith Helen,54,0,70,16
1683671518275,ECON 3,A01,185549,Crane; Meredith Helen,29,0,70,41
1683671519299,ECON 4,A01,203354,Anderson; John Charles,0,5,10,10
1683671520321,ECON 100A,A01,185574,Staff,0,5,40,40
1683671521345,ECON 100B,A01,185576,Staff,0,12,50,50
1683671522371,ECON 100C,A01,185589,Newhouse; Herbert S,30,0,70,40
1683671523396,ECON 105,A00,185608,Vespa; Emanuel Ignacio,19,0,35,16
1683671524420,ECON 109,A01,185610,Shishkin; Denis,9,0,35,26
1683671525444,ECON 110A,A01,185612,Staff,9,0,40,31
1683671526472,ECON 120A,A01,185615,Staff,19,0,40,21
1683671527501,ECON 120C,A01,185617,Sun; Yixiao,0,21,70,70
1683671528526,ECON 144,A00,203346,Squires; Dale E,2,0,35,33
1683671529558,ECON 171,A01,203349,Newhouse; Herbert S,0,1,35,35
1683671530583,ECON 173A,A01,185621,Toda; Alexis Akira,20,0,35,15
1683671531610,EDS 25,A01,202413,Staff,0,1,0,0
1683671531610,EDS 25,A02,202414,Staff,0,1,0,0
1683671531610,EDS 25,A03,202415,Staff,0,0,0,0
1683671531610,EDS 25,A04,202416,Staff,0,1,0,0
1683671531610,EDS 25,A05,202439,Staff,0,0,0,0
1683671531610,EDS 25,A06,202440,Staff,0,0,0,0
1683671531610,EDS 25,B01,202631,Staff,0,0,0,0
1683671531610,EDS 25,B02,202632,Staff,0,0,0,0
1683671531610,EDS 25,B03,202639,Staff,0,0,0,0
1683671531610,EDS 25,B04,202640,Staff,0,0,0,0
1683671531610,EDS 25,B05,202643,Staff,0,0,0,0
1683671531610,EDS 25,B06,202644,Staff,0,0,0,0
1683671532636,EDS 38,A01,202659,Black; Alison Michelle,24,0,25,1
1683671533664,EDS 115,A00,202652,Staff,18,0,30,12
1683671534692,EDS 125,A00,202649,Staff,13,0,30,17
1683671535720,EDS 126,A01,203332,Staff,30,0,30,0
1683671536747,EDS 139,A00,202838,Staff,16,0,25,9
1683671537772,EDS 146,A01,202655,Staff,14,0,25,11
1683671538797,ENG 15,A00,185667,Staff,0,1,0,0
1683671538797,ENG 15,B00,185672,Staff,0,0,0,0
1683671538797,ENG 15,C00,185675,Staff,0,0,0,0
1683671538797,ENG 15,D00,185682,Staff,0,0,0,0
1683671538797,ENG 15,E00,185684,Staff,0,0,0,0
1683671539823,ETHN 103,A00,185710,Staff,0,8,35,35
1683671540851,ETHN 103A,A00,199228,Man; Simeon S,0,0,9,9
1683671541876,ETHN 109,A00,185711,Staff,15,0,35,20
1683671542904,ETHN 142,A00,185726,Staff,0,4,30,30
1683671543928,ETHN 163J,A00,199229,Man; Simeon S,5,0,8,3
1683671544955,ETHN 168,A00,185727,Staff,7,0,10,3
1683671545983,ETHN 182,A00,185728,Staff,0,0,35,35
1683671547010,ETHN 183,A00,185737,Staff,9,0,18,9
1683671548037,GLBH 111,A01,209361,Burgos; Jose L.,0,0,0,0
1683671550086,HIEU 104,A00,185792,Staff,14,0,20,6
1683671551112,HIEU 115,A00,185800,Staff,0,0,20,20
1683671552139,HIEU 128,A00,185801,Staff,0,9,20,20
1683671553166,HIEU 147,A00,185802,Staff,15,0,20,5
1683671554200,HIEU 154,A00,185823,Staff,11,0,20,9
1683671555227,HILA 102,A00,185826,Staff,14,0,20,6
1683671556254,HILD 2C,A01,185778,Staff,0,13,20,20
1683671557279,HILD 7B,A01,185780,Kwak; Nancy,0,17,32,32
1683671557279,HILD 7B,A02,185781,Kwak; Nancy,0,18,32,32
1683671558307,HILD 30,A01,185791,Staff,12,0,20,8
1683671559337,HISC 119,A00,185830,Golan; Tal,0,9,20,20
1683671560361,HITO 156GS,A00,185831,Patterson; Patrick H.,0,0,0,23
1683671561389,HIUS 103,A00,185832,Man; Simeon S,0,4,20,20
1683671562415,HIUS 117,A00,185836,Kwak; Nancy,2,0,20,18
1683671563438,HIUS 125,A00,185840,Man; Simeon S,0,2,23,23
1683671564461,HIUS 149,A00,185845,Staff,1,0,20,19
1683671565486,HUM 3,A01,185882,Zavodny; Tatiana Sophia,0,8,50,50
1683671565486,HUM 3,B01,185899,Caldwell; Michael Alan,0,18,50,50
1683671566512,HUM 3GS,A00,185900,Patterson; Patrick H.,0,0,0,23
1683671567537,HUM 4,A01,185938,Zroka; Amy Liane,29,0,50,21
1683671567537,HUM 4,B01,185956,Watkins; Eric,0,5,50,50
1683671567537,HUM 4,B02,202209,Watkins; Eric,0,5,50,50
1683671567537,HUM 4,B03,202210,Watkins; Eric,0,5,50,50
1683671568565,HUM 5,A01,185958,West; Geoffrey Scott,0,0,50,50
1683671568565,HUM 5,A02,202215,West; Geoffrey Scott,0,0,50,50
1683671569591,INTL 190,A00,185959,Gagnon; Jeffrey C,0,0,0,9
1683671569591,INTL 190,B00,185960,Lettieri; Michael Joseph,0,0,0,2
1683671570615,JAPN 180,A00,254509,Staff,5,0,30,25
1683671571640,LATI 10,A01,202853,Kennemore; Amy Michelle,4,0,35,31
1683671571640,LATI 10,A02,202854,Kennemore; Amy Michelle,2,0,35,33
1683671571640,LATI 10,A03,270054,Kennemore; Amy Michelle,30,0,30,0
1683671572665,LATI 180,A00,202855,Kennemore; Amy Michelle,11,0,20,9
1683671573694,LAWS 101,A00,201767,Golan; Tal,0,7,40,40
1683671574717,LIFR 1C,A00,185961,Staff,6,0,20,14
1683671575742,LIFR 1CX,A00,185962,Staff,7,0,20,13
1683671576766,LIFR 1D,A00,185963,Staff,7,0,20,13
1683671577792,LIFR 1DX,A00,185964,Staff,7,0,20,13
1683671578818,LIGN 101,A01,186039,Staff,43,0,50,7
1683671579846,LIGN 165,A00,186040,Staff,15,0,50,35
1683671580871,LTCS 108,A00,186041,Staff,5,0,10,5
1683671581902,LTCS 119,A00,186042,Staff,15,0,20,5
1683671582926,LTCS 130,A00,186043,Wesling; Megan E.,15,0,25,10
1683671584983,LTEA 138,A00,186119,Staff,14,0,40,26
1683671586011,LTEN 124,A00,186148,Staff,5,0,25,20
1683671587038,LTEN 178,A00,186149,Staff,7,0,15,8
1683671588063,LTEN 181,A00,186150,Blanco; John D,34,0,40,6
1683671589089,LTWL 120,A00,186160,Staff,19,0,25,6
1683671590116,LTWL 165,A00,186161,Staff,22,0,25,3
1683671591143,LTWR 100,A00,186162,Staff,0,5,15,15
1683671592168,LTWR 102,A00,186163,Doller; Ben,5,0,15,10
1683671593190,MAE 8,A01,186412,Staff,0,0,0,0
1683671594214,MAE 30B,A00,186445,Bahadori; Mohammad Yousef,82,0,100,18
1683671595239,MAE 40,A00,186592,Bewley; Thomas R,10,0,50,40
1683671596264,MAE 101B,A00,186593,Bahadori; Mohammad Yousef,80,0,100,20
1683671597291,MAE 105,A00,186594,Bandaru; Prabhakar,10,0,50,40
1683671598318,MAE 107,A00,186599,Pham; Hieu Tan,0,7,120,120
1683671599341,MAE 148,A01,186660,Silberman; Jack,3,0,16,13
1683671600365,MATH 10A,A01,188095,Staff,0,6,35,35
1683671601395,MATH 10B,A01,188097,Bowers; Adam R.,0,12,30,30
1683671601395,MATH 10B,A02,188099,Bowers; Adam R.,0,11,30,30
1683671601395,MATH 10B,B01,188104,Bowers; Adam R.,0,10,30,30
1683671601395,MATH 10B,B02,188106,Bowers; Adam R.,1,9,30,29
1683671602418,MATH 10C,A01,188111,Staff,0,19,30,30
1683671602418,MATH 10C,A02,188127,Staff,0,19,30,30
1683671602418,MATH 10C,A03,188131,Staff,0,19,30,30
1683671602418,MATH 10C,B01,188218,Staff,17,0,30,13
1683671602418,MATH 10C,B02,188244,Staff,13,0,30,17
1683671602418,MATH 10C,B03,188277,Staff,14,0,30,16
1683671603443,MATH 18,A01,188344,Bach; Quang Tran,18,0,30,12
1683671603443,MATH 18,A02,188345,Bach; Quang Tran,11,0,30,19
1683671603443,MATH 18,B01,188353,Bach; Quang Tran,11,0,30,19
1683671603443,MATH 18,B02,188354,Bach; Quang Tran,19,0,30,11
1683671604469,MATH 20A,A01,188374,Staff,11,0,35,24
1683671605495,MATH 20B,A01,188382,Ohm; Ko Woon,7,0,30,23
1683671605495,MATH 20B,A02,188383,Ohm; Ko Woon,22,0,30,8
1683671605495,MATH 20B,B01,188385,Ohm; Ko Woon,7,0,30,23
1683671605495,MATH 20B,B02,188392,Ohm; Ko Woon,22,0,30,8
1683671606521,MATH 20C,A01,188394,Harel; Guershon,10,0,30,20
1683671606521,MATH 20C,A02,188395,Harel; Guershon,13,0,30,17
1683671606521,MATH 20C,B01,188404,Harel; Guershon,5,0,30,25
1683671606521,MATH 20C,B02,188405,Harel; Guershon,18,0,30,12
1683671607545,MATH 20D,A01,188414,Hammock; Frances H,0,1,30,30
1683671607545,MATH 20D,A02,188415,Hammock; Frances H,0,1,30,30
1683671607545,MATH 20D,B01,188447,Hammock; Frances H,0,1,30,30
1683671607545,MATH 20D,B02,188486,Hammock; Frances H,3,0,30,27
1683671608629,MATH 20E,A01,188649,Staff,21,0,30,9
1683671608629,MATH 20E,A02,188650,Staff,20,0,30,10
1683671608629,MATH 20E,A03,188673,Staff,0,0,30,30
1683671609657,MATH 102,A01,188675,Staff,0,37,35,35
1683671610685,MATH 103B,A01,188681,Staff,3,0,35,32
1683671610685,MATH 103B,B01,188692,Staff,5,0,35,30
1683671611708,MATH 109,A01,188695,Salehi Golsefidy; Alireza,24,0,35,11
1683671611708,MATH 109,A02,188696,Salehi Golsefidy; Alireza,25,0,35,10
1683671612737,MATH 120A,A01,188698,Eggers; John Dietrich,7,0,35,28
1683671613760,MATH 142B,A01,188736,Ioana; Adrian,1,1,30,29
1683671613760,MATH 142B,A02,188741,Ioana; Adrian,0,1,30,30
1683671613760,MATH 142B,A03,188743,Ioana; Adrian,0,1,30,30
1683671614786,MATH 168A,A01,188790,Staff,0,11,35,35
1683671615814,MATH 170A,A01,188803,Nie; Jiawang,0,2,35,35
1683671615814,MATH 170A,A02,188811,Nie; Jiawang,0,0,35,35
1683671615814,MATH 170A,A03,188814,Nie; Jiawang,0,0,35,35
1683671615814,MATH 170A,A04,188815,Nie; Jiawang,8,0,35,27
1683671616841,MATH 193B,A01,188817,Staff,0,0,35,35
1683671616841,MATH 193B,A02,188818,Staff,5,0,35,30
1683671617871,MGT 4,A01,202857,Anderson; John Charles,60,0,80,20
1683671618895,MGT 12,A00,202858,Lindenberger; Wade Douglas,40,0,90,50
1683671619920,MGT 18,A00,202859,Staff,74,0,90,16
1683671620945,MGT 18GS,A00,202860,McKay; Michael J,13,0,28,15
1683671621969,MGT 45,A00,202861,Pecore; Joseph P.,10,0,90,80
1683671622995,MGT 100,A00,202863,Yavorsky; Daniel Ryan,28,0,90,62
1683671624019,MGT 103,A00,202864,Ehrich; Kristine R,0,18,90,90
1683671625042,MGT 112,A00,202865,Ehrich; Kristine R,15,0,90,75
1683671626068,MGT 121A,A00,202868,Staff,90,20,90,0
1683671627094,MGT 131B,A00,202869,Anderson; John Charles,59,0,90,31
1683671628120,MGT 136,A00,202871,Lindenberger; Wade Douglas,83,0,90,7
1683671629144,MGT 164,A00,202873,Staff,0,67,90,91
1683671630168,MGT 164GS,A00,202874,McKay; Mary A,13,0,28,15
1683671631192,MGT 180,A00,202875,Staff,0,51,90,91
1683671632219,MMW 11R,A01,205019,Herbst; Matthew,0,0,30,30
1683671632219,MMW 11R,A02,205026,Herbst; Matthew,29,0,30,1
1683671633248,MMW 15,A01,193512,Chang; Edmond Yi-Teh,0,8,28,28
1683671633248,MMW 15,A02,193513,Chang; Edmond Yi-Teh,0,5,28,28
1683671633248,MMW 15,A03,193514,Chang; Edmond Yi-Teh,0,5,28,28
1683671633248,MMW 15,A04,193515,Chang; Edmond Yi-Teh,0,5,28,28
1683671633248,MMW 15,A05,193516,Chang; Edmond Yi-Teh,0,5,28,28
1683671633248,MMW 15,A06,193517,Chang; Edmond Yi-Teh,0,6,28,28
1683671633248,MMW 15,B01,193519,Chang; Edmond Yi-Teh,0,5,28,28
1683671633248,MMW 15,B02,193520,Chang; Edmond Yi-Teh,0,5,28,28
1683671633248,MMW 15,B03,193521,Chang; Edmond Yi-Teh,0,5,28,28
1683671633248,MMW 15,B04,193522,Chang; Edmond Yi-Teh,0,5,28,28
1683671633248,MMW 15,B05,193523,Chang; Edmond Yi-Teh,0,5,28,28
1683671633248,MMW 15,B06,193524,Chang; Edmond Yi-Teh,0,5,28,28
1683671634276,MMW 122,A01,193526,Rahimi; Babak,0,16,28,28
1683671634276,MMW 122,A02,193527,Rahimi; Babak,0,15,28,28
1683671634276,MMW 122,A03,193528,Rahimi; Babak,0,0,0,0
1683671634276,MMW 122,A04,193529,Rahimi; Babak,0,0,0,0
1683671635304,MUS 1A,A01,186663,Staff,1,19,35,34
1683671636332,MUS 4,A01,186715,Staff,0,12,35,35
1683671637356,MUS 5R,A01,186796,Dubnov; Shlomo,0,17,35,35
1683671638383,MUS 6,A01,186798,Staff,0,5,25,25
1683671639409,MUS 7,A01,186830,Staff,11,0,35,24
1683671640434,MUS 8,A01,186930,Staff,0,27,35,35
1683671641464,MUS 15,A01,186932,Staff,0,15,35,35
1683671641464,MUS 15,B01,186934,Staff,1,17,35,34
1683671642488,MUS 80,A00,186935,Staff,0,0,20,20
1683671642488,MUS 80,B00,186936,Staff,24,0,25,1
1683671643513,NANO 11,A00,204702,Lipomi; Darren John,0,0,0,0
1683671644542,NANO 15,A01,204709,Yang; Kesong,0,1,0,0
1683671645568,NANO 114,A00,202069,Jahed Motlagh; Zeinab,3,0,10,7
1683671646595,PHIL 1,A00,186955,Grush; Rick Scott,31,0,40,9
1683671647619,PHIL 10,A01,186973,Grush; Rick Scott,27,0,35,8
1683671647619,PHIL 10,A02,186974,Grush; Rick Scott,33,0,35,2
1683671648646,PHIL 13,A01,186976,Staff,3,0,35,32
1683671648646,PHIL 13,A02,186977,Staff,16,0,35,19
1683671649671,PHIL 14,A01,186979,Staff,31,0,35,4
1683671649671,PHIL 14,A02,186986,Staff,32,0,35,3
1683671650694,PHIL 28,A01,186988,Staff,16,0,30,14
1683671650694,PHIL 28,A02,186989,Staff,1,0,30,29
1683671650694,PHIL 28,A03,186990,Staff,10,0,30,20
1683671650694,PHIL 28,A04,186991,Staff,26,0,30,4
1683671651721,PHIL 120,A00,186997,Staff,23,0,40,17
1683671652750,PHIL 137,A00,187003,Staff,7,0,40,33
1683671653774,PHIL 150,A00,187015,Staff,47,0,70,23
1683671654801,PHIL 167,A00,187021,Lamey; Andy M.,34,0,40,6
1683671655829,PHIL 174,A01,202226,Staff,17,0,20,3
1683671655829,PHIL 174,A02,202235,Staff,20,0,20,0
1683671656856,PHIL 191A,A00,258918,Staff,0,0,1,1
1683671657884,PHYS 1A,A00,187028,Staff,26,0,60,34
1683671658909,PHYS 1AL,001,187036,Staff,3,0,30,27
1683671658909,PHYS 1AL,002,187049,Staff,18,0,30,12
1683671659934,PHYS 1B,A00,187058,Staff,22,0,60,38
1683671660964,PHYS 1BL,001,187064,Staff,0,1,30,30
1683671660964,PHYS 1BL,002,187070,Staff,4,0,30,26
1683671661988,PHYS 1C,A00,187082,Staff,29,0,120,91
1683671663023,PHYS 1CL,001,187088,Staff,0,9,30,30
1683671663023,PHYS 1CL,002,187089,Staff,0,1,30,30
1683671663023,PHYS 1CL,009,262693,Staff,9,0,30,21
1683671664048,PHYS 2B,A01,187097,Staff,55,0,115,60
1683671665072,PHYS 2C,A01,187099,Staff,63,0,115,52
1683671666100,PHYS 2CL,A01,187101,Staff,5,0,28,23
1683671666100,PHYS 2CL,A02,187102,Staff,15,0,28,13
1683671667125,PHYS 2D,A01,187123,Shotwell; Brian,95,0,115,20
1683671668154,PHYS 4B,A01,187133,Grinstein; Benjamin,35,0,50,15
1683671669182,POLI 10,A00,188819,Staff,0,4,50,50
1683671670206,POLI 11,A00,188827,Staff,43,0,50,7
1683671671229,POLI 13R,A00,188828,Staff,0,1,20,20
1683671672256,POLI 27,A01,188830,Elgin; Samuel Zincke,0,2,70,70
1683671673280,POLI 30,A00,188832,Desposato; Scott,30,0,50,20
1683671674308,POLI 102F,A00,188834,Staff,0,0,40,40
1683671675335,POLI 104A,A00,188852,Staff,13,0,30,17
1683671676360,POLI 104I,A00,188853,Staff,0,7,20,20
1683671677386,POLI 110B,A00,188854,Wiens; David,6,0,20,14
1683671678410,POLI 112A,A00,188855,Wiens; David,3,0,30,27
1683671679436,POLI 117R,A00,188856,Forman; Fonna,0,12,20,20
1683671680464,POLI 118,A00,188857,Ingham; Sean,8,0,20,12
1683671681490,POLI 120G,A00,188858,Staff,8,0,30,22
1683671682519,POLI 131CR,A00,188863,Hoston; Germaine,20,0,50,30
1683671683545,POLI 133,A00,188864,Nellis; Gareth Hb,44,0,50,6
1683671684573,POLI 134D,A00,188865,Desposato; Scott,27,0,30,3
1683671685602,POLI 142A,A00,188871,Gartzke; Erik,21,0,50,29
1683671686632,POLI 142K,A00,188874,Staff,38,0,50,12
1683671687658,POLI 143,A00,188940,Gartzke; Erik,16,0,30,14
1683671688687,POLI 153,A00,188943,Staff,2,0,20,18
1683671689715,POLI 160AA,A00,188944,Staff,11,0,40,29
1683671690744,POLI 170A,A00,188945,Staff,10,0,30,20
1683671692809,PSYC 1,A00,188952,Staff,37,0,90,53
1683671693837,PSYC 2,B00,188953,Staff,19,0,35,16
1683671694864,PSYC 6,A00,188970,Staff,47,0,60,13
1683671695891,PSYC 7,A00,188973,Staff,35,0,45,10
1683671696918,PSYC 60,A01,188980,Rickard; Timothy C.,42,0,60,18
1683671697947,PSYC 70,A01,189001,Steiner; Eric Tomas,22,0,45,23
1683671698976,PSYC 100,A00,189005,Lacefield; Katharine I,0,99,120,120
1683671700003,PSYC 102,A00,189008,Staff,8,0,30,22
1683671701032,PSYC 106,B00,189026,Gorman; Michael R.,27,0,60,33
1683671702057,PSYC 114,B01,189033,Winkielman; Piotr,0,31,30,30
1683671703082,PSYC 131,A00,189036,Anagnostaras; Stephan,0,43,60,60
1683671704109,PSYC 136,A00,189041,Lowe; Angela Beth,0,7,25,25
1683671705133,PSYC 137,A00,189057,Winkielman; Piotr,1,37,25,24
1683671706162,PSYC 144,A00,189107,Wixted; John T,0,11,50,50
1683671708211,PSYC 162,A00,189142,Staff,0,9,85,85
1683671709239,PSYC 172,A00,189144,Gorman; Michael R.,0,6,30,30
1683671711289,PSYC 179,A00,189146,Lacefield; Katharine I,0,87,120,120
1683671712368,PSYC 181,A00,189147,Anagnostaras; Stephan,0,44,90,90
1683671713391,PSYC 190R,A00,189148,Barner; David A.,0,23,80,80
1683671714416,PSYC 191,A00,189275,Rickard; Timothy C.,0,10,25,25
1683671715444,PSYC 193,A00,189276,Chapman; Eddie Nathaniel,0,1,0,4
1683671716468,PSYC 193L,A01,189281,Lowe; Angela Beth,10,0,20,10
1683671716468,PSYC 193L,B01,189285,Staff,28,0,35,7
1683671717492,RELI 149,A00,187137,Rahimi; Babak,7,0,40,33
1683671718516,SE 9,A01,187315,Staff,0,2,18,18
1683671719540,SE 101B,A00,187409,Staff,24,0,30,6
1683671720565,SE 110B,A00,187444,Staff,10,0,40,30
1683671721589,SE 130B,A00,187449,Staff,31,0,40,9
1683671722615,SE 150A,A00,187516,Staff,8,0,20,12
1683671723640,SE 154,A00,187528,Staff,29,0,50,21
1683671724664,SIO 3,A01,258171,Staff,35,0,40,5
1683671725688,SIO 10,A00,187144,Cook; Geoffrey W,0,7,75,75
1683671726714,SIO 45,A00,187152,Cook; Geoffrey W,0,6,100,100
1683671727744,SIO 109R,A00,194486,Staff,0,4,20,20
1683671729793,SIO 187,A01,187233,Kacev; David,12,0,40,28
1683671730819,SOCI 1,A01,258656,Thorpe; Charles Robert,28,0,30,2
1683671730819,SOCI 1,A02,258658,Thorpe; Charles Robert,30,0,30,0
1683671730819,SOCI 1,A03,258661,Thorpe; Charles Robert,25,0,25,0
1683671730819,SOCI 1,A04,258666,Thorpe; Charles Robert,22,0,25,3
1683671730819,SOCI 1,A05,258897,Thorpe; Charles Robert,22,0,25,3
1683671730819,SOCI 1,A06,258898,Thorpe; Charles Robert,25,0,25,0
1683671731849,SOCI 30,A01,258903,Pardo Guerra; Juan Pablo,14,0,30,16
1683671732876,SOCI 102,A00,258904,Staff,9,0,25,16
1683671733926,SOCI 106,A00,258905,Staff,19,0,25,6
1683671734954,SOCI 111,A00,258907,Ribas Norris; Janet Vanesa,26,0,30,4
1683671735980,SOCI 121R,A00,258908,Pardo Guerra; Juan Pablo,8,0,30,22
1683671737004,SOCI 126,A01,203330,Staff,14,0,20,6
1683671738031,SOCI 131,A00,258909,Thorpe; Charles Robert,30,0,60,30
1683671739056,SOCI 135,A00,258910,Payne; Christine Anna,0,11,30,30
1683671740081,SOCI 157,A00,258911,Staff,12,0,30,18
1683671741105,SOCI 184,A00,258912,Staff,25,0,30,5
1683671742129,SOCI 188D,A00,258913,Staff,22,0,30,8
1683671743157,SYN 2,001,187529,Staff,9,0,16,7
1683671743157,SYN 2,002,201452,Staff,0,20,16,16
1683671743157,SYN 2,003,201469,Staff,1,0,16,15
1683671744180,SYN 100,A01,187531,Staff,0,9,20,20
1683671744180,SYN 100,B01,201491,Staff,0,10,20,20
1683671745208,TDAC 1,A00,189286,Walsh; Kim C.,3,0,20,17
1683671745208,TDAC 1,B00,189287,Harting; Carla Kelso,10,0,20,10
1683671746266,TDAC 101,A00,189300,Walsh; Kim C.,16,0,20,4
1683671746266,TDAC 101,B00,189301,Harting; Carla Kelso,18,0,20,2
1683671747292,TDAC 102,A00,189304,Basso; Beatrice,14,0,20,6
1683671748315,TDAC 108,A00,189305,Staff,18,0,20,2
1683671749340,TDDE 131,A00,189310,Staff,19,0,20,1
1683671749340,TDDE 131,B00,189314,Staff,19,0,20,1
1683671749340,TDDE 131,C00,189315,Staff,48,0,50,2
1683671749340,TDDE 131,D00,189316,Staff,14,0,15,1
1683671749340,TDDE 131,E00,204841,Staff,20,0,20,0
1683671750369,TDGE 10,A00,189289,Staff,27,0,50,23
1683671750369,TDGE 10,B00,189290,Havis; Allan,0,1,50,50
1683671751399,TDGE 11,A00,189291,Fulton; Julia,0,4,50,50
1683671751399,TDGE 11,B00,189292,Staff,20,0,25,5
1683671751399,TDGE 11,C00,260270,Staff,0,0,0,0
1683671752426,TDGE 25,A00,189294,Staff,2,0,20,18
1683671753451,TDGE 124,A00,189318,Fulton; Julia,0,8,50,50
1683671754477,TDGE 125,A00,189319,Staff,13,0,25,12
1683671754477,TDGE 125,B00,189320,Staff,23,0,25,2
1683671755501,TDGE 127,A00,189322,Havis; Allan,0,0,50,50
1683671756527,TDHT 101,A00,189323,Staff,18,0,25,7
1683671756527,TDHT 101,B00,189324,Staff,25,0,25,0
1683671757551,TDHT 102,A00,189325,Staff,49,0,50,1
1683671758576,TDMV 1,A00,189295,Arcidiacono; Kristin,20,0,30,10
1683671758576,TDMV 1,B00,189296,Caligagan; Maria T.,24,0,30,6
1683671759601,TDMV 2,A00,189297,Sammartano; Tonnie,27,0,30,3
1683671759601,TDMV 2,B00,189299,Arcidiacono; Kristin,23,0,30,7
1683671760627,TDMV 3,A00,204998,Rincon; Alicia,22,0,30,8
1683671761651,TDMV 120,A00,189458,Sammartano; Tonnie,28,0,30,2
1683671762679,TDMV 138,A00,189541,Jun; Grace Shin Hae,20,0,40,20
1683671763702,TDMV 142,A00,189717,Caligagan; Tony,25,0,30,5
1683671763702,TDMV 142,B00,189718,Caligagan; Maria T.,25,0,30,5
1683671764726,TMC 2,A01,187533,Staff,25,0,25,0
1683671764726,TMC 2,A02,187534,Staff,25,0,25,0
1683671765759,USP 1,A01,187536,Kwak; Nancy,0,16,25,25
1683671766786,USP 5,A01,187538,Staff,9,0,25,16
1683671767812,USP 101,A00,199253,Staff,0,4,0,0
1683671768836,USP 124,A00,187562,Boomhower; Matthew Charles,0,0,30,30
1683671769863,USP 138,A00,187582,Staff,19,0,25,6
1683671770886,USP 152,A01,187597,Staff,3,0,25,22
1683671771915,USP 153,A00,187598,Staff,19,0,25,6
1683671772942,USP 168,A00,187607,Kwak; Nancy,2,0,5,3
1683671773970,USP 173,A00,187619,Staff,4,0,25,21
1683671774998,USP 181,A00,187638,Staff,0,4,25,25
1683671776021,VIS 103,A00,187650,Cruz; Edwin Teddy,17,0,75,58
1683671777046,VIS 110D,A00,187669,Staff,13,0,22,9
1683671778070,VIS 127C,A00,187720,Shen; Kuiyi,67,0,146,79
1683671779093,VIS 149,A00,187731,Yoldas; Pinar,1,14,22,21
1683671780117,VIS 151,A01,188091,Staff,22,0,34,12
1683671780117,VIS 151,A02,188092,Staff,11,0,34,23
1683671781142,VIS 160B,A00,188093,Stalbaum; Brett,0,1,10,10
1683671783197,WCWP 10B,A00,201720,Staff,10,0,15,5
1683671783197,WCWP 10B,B00,201722,Staff,9,0,15,6
1683671784226,WCWP 100,A00,201725,Gagnon; Jeffrey C,0,0,2,2
1683671784226,WCWP 100,B00,201727,Staff,0,4,15,15
1683671787315,ANBI 133,A00,258401,Wilder; Linnea Lorene,34,0,40,6
1683671788338,ANBI 140,A00,258395,Hrvoj Mihic; Branka,18,0,25,7
1683671789365,ANSC 120,A00,258402,Bialecki; Jon Anthony,26,0,40,14
1683671790392,ANSC 144,A00,258400,Staff,12,0,40,28
1683671792440,ANSC 166,A00,258396,Parish; Steven Martin,156,0,175,19
1683671793463,ANSC 180,A00,193533,Staff,8,0,20,12
1683671794492,ANSC 188,A00,258397,Jassal; Aftab,34,0,40,6
1683671795523,ANTH 3,A01,258316,Staff,23,0,30,7
1683671796548,ANTH 5,A00,258394,Semendeferi; Ekaterini,16,0,20,4
1683671797574,ANTH 21,A01,258331,Staff,4,0,40,36
1683671798602,ANTH 103,A00,258398,Varma; Saiba,15,0,25,10
1683671799630,AWP 10,001,202034,Staff,0,0,0,0
1683671799630,AWP 10,002,202035,Staff,0,0,0,0
1683671799630,AWP 10,003,202036,Staff,0,0,0,0
1683671799630,AWP 10,004,202037,Staff,0,0,0,0
1683671799630,AWP 10,005,202038,Staff,0,0,0,0
1683671799630,AWP 10,006,202039,Staff,0,0,0,0
1683671799630,AWP 10,007,202040,Staff,0,0,0,0
1683671799630,AWP 10,008,202041,Staff,0,0,0,0
1683671799630,AWP 10,009,202042,Staff,0,0,0,0
1683671799630,AWP 10,010,202043,Staff,0,0,0,0
1683671799630,AWP 10,011,202044,Staff,0,0,0,0
1683671799630,AWP 10,012,202045,Staff,0,0,0,0
1683671799630,AWP 10,013,202046,Staff,0,0,0,0
1683671799630,AWP 10,014,202047,Staff,0,0,0,0
1683671799630,AWP 10,015,202048,Staff,0,0,0,0
1683671799630,AWP 10,016,202049,Staff,0,0,0,0
1683671799630,AWP 10,017,202050,Staff,0,0,0,0
1683671799630,AWP 10,018,202051,Staff,0,0,0,0
1683671799630,AWP 10,019,202052,Staff,0,0,0,0
1683671799630,AWP 10,020,202053,Staff,0,0,0,0
1683671799630,AWP 10,021,202054,Staff,0,0,0,0
1683671799630,AWP 10,022,202055,Staff,0,0,0,0
1683671799630,AWP 10,023,202056,Staff,0,0,0,0
1683671799630,AWP 10,024,202057,Staff,0,0,0,0
1683671799630,AWP 10,025,202058,Staff,0,0,0,0
1683671799630,AWP 10,026,202059,Staff,0,0,0,0
1683671800654,AWP 102,001,202032,Staff,0,0,0,0
1683671800654,AWP 102,002,202033,Staff,0,0,0,0
1683671801682,BENG 100,A01,254234,Taylor Amos; Alyssa C,31,0,40,9
1683671802707,BENG 196,001,270013,Engler; Adam J.,9999,0,9999,0
1683671803737,BICD 100R,A01,202018,Smith; Laurie,0,7,32,32
1683671803737,BICD 100R,A02,202019,Smith; Laurie,0,3,32,32
1683671803737,BICD 100R,A03,202020,Smith; Laurie,0,1,32,32
1683671803737,BICD 100R,A04,202021,Smith; Laurie,6,0,32,26
1683671803737,BICD 100R,A05,202022,Smith; Laurie,11,0,32,21
1683671804765,BICD 136,A01,193242,Gustafson-Brown; Cindy,0,2,32,32
1683671804765,BICD 136,A02,193244,Gustafson-Brown; Cindy,13,0,32,19
1683671805794,BIEB 102,A01,193249,Butler; Shannon Rhey,1,2,32,31
1683671805794,BIEB 102,A02,193251,Butler; Shannon Rhey,0,0,32,32
1683671805794,BIEB 102,A03,193253,Butler; Shannon Rhey,0,0,32,32
1683671805794,BIEB 102,A04,193255,Butler; Shannon Rhey,13,0,32,19
1683671805794,BIEB 102,A05,193265,Butler; Shannon Rhey,25,0,32,7
1683671805794,BIEB 102,A06,193269,Butler; Shannon Rhey,14,0,32,18
1683671807841,BIEB 150,A01,193274,Staff,0,0,32,32
1683671807841,BIEB 150,A02,193285,Staff,24,0,32,8
1683671808868,BIEB 194,A00,193286,Kurle; Carolyn M.,20,0,32,12
1683671809892,BILD 1,A01,192291,Staff,15,0,32,17
1683671809892,BILD 1,A02,192292,Staff,30,0,32,2
1683671809892,BILD 1,B01,192520,Reuther; Keefe,0,1,0,0
1683671809892,BILD 1,B02,192532,Reuther; Keefe,0,1,0,0
1683671810920,BILD 3,A01,192556,Butler; Shannon Rhey,0,0,32,32
1683671810920,BILD 3,A02,192581,Butler; Shannon Rhey,0,1,32,32
1683671810920,BILD 3,A03,192611,Butler; Shannon Rhey,20,0,32,12
1683671810920,BILD 3,A04,192612,Butler; Shannon Rhey,24,0,32,8
1683671810920,BILD 3,A05,192613,Butler; Shannon Rhey,26,0,32,6
1683671810920,BILD 3,A06,192679,Butler; Shannon Rhey,27,0,32,5
1683671810920,BILD 3,A07,192682,Butler; Shannon Rhey,20,0,32,12
1683671811949,BILD 4,A01,192836,Reuther; Keefe,1,0,24,23
1683671811949,BILD 4,A02,193044,Reuther; Keefe,4,0,24,20
1683671812977,BILD 10,A01,193142,Gustafson-Brown; Cindy,29,0,32,3
1683671812977,BILD 10,A02,193149,Gustafson-Brown; Cindy,31,0,32,1
1683671814005,BIMM 100,A01,193301,Staff,0,6,32,32
1683671814005,BIMM 100,A02,193312,Staff,0,7,32,32
1683671814005,BIMM 100,A03,193323,Staff,0,10,32,32
1683671815033,BIMM 101,A01,193329,McDonnell; Lisa Marie,1,4,24,23
1683671815033,BIMM 101,A02,193339,McDonnell; Lisa Marie,1,4,24,23
1683671815033,BIMM 101,B01,193354,McDonnell; Lisa Marie,0,4,24,24
1683671815033,BIMM 101,B02,193357,McDonnell; Lisa Marie,0,3,24,24
1683671816117,BIMM 110,A01,193377,Tat; John,0,11,32,32
1683671816117,BIMM 110,A02,193378,Tat; John,0,10,32,32
1683671817142,BIMM 120,A01,206116,Staff,0,0,32,32
1683671817142,BIMM 120,A02,206117,Staff,7,0,32,25
1683671817142,BIMM 120,A03,206121,Staff,21,0,32,11
1683671818167,BIPN 100,A01,193393,Park; Ji Young,0,15,32,32
1683671818167,BIPN 100,A02,193402,Park; Ji Young,0,14,32,32
1683671818167,BIPN 100,A03,193413,Park; Ji Young,0,14,32,32
1683671818167,BIPN 100,A04,193414,Park; Ji Young,0,13,32,32
1683671819193,BIPN 102,A01,193429,Staff,0,0,32,32
1683671819193,BIPN 102,A02,193438,Staff,18,0,32,14
1683671820218,BIPN 106,A01,193450,Reyes Gonzalez; Catalina,0,2,40,40
1683671821243,BIPN 134,A01,193465,Cooke; James Edward,0,0,32,32
1683671821243,BIPN 134,A02,193474,Cooke; James Edward,25,0,32,7
1683671821243,BIPN 134,A03,193485,Cooke; James Edward,29,0,32,3
1683671821243,BIPN 134,A04,193486,Cooke; James Edward,20,0,32,12
1683671821243,BIPN 134,A05,193491,Cooke; James Edward,31,0,32,1
1683671821243,BIPN 134,A06,193501,Cooke; James Edward,30,0,32,2
1683671821243,BIPN 134,A07,193510,Cooke; James Edward,29,0,32,3
1683671823293,BISP 194,A00,222522,Staff,14,0,32,18
1683671824317,CAT 124,A01,202407,Staff,19,0,25,6
1683671825345,CAT 125,A00,202408,Marchisotto; Jennifer Anne,2,0,20,18
1683671826370,CAT 125R,A00,202409,Smith; Lauryn Alissa,0,11,20,20
1683671826370,CAT 125R,B00,202410,Morales; Celeste Georgianna,0,11,20,20
1683671826370,CAT 125R,C00,202411,Irwin; Matthew Joseph,0,12,20,20
1683671827396,CENG 15,A01,204712,Yang; Kesong,0,1,0,0
1683671828420,CENG 114,A00,202070,Jahed Motlagh; Zeinab,5,0,20,15
1683671829447,CGS 105,A00,185477,Wesling; Megan E.,24,0,40,16
1683671830472,CGS 106,A00,185494,Staff,11,0,22,11
1683671831499,CGS 108,A00,185495,Staff,14,0,20,6
1683671832522,CGS 114,A00,185496,Staff,13,0,18,5
1683671833546,CGS 119,A00,185501,Staff,15,0,20,5
1683671834573,CGS 120,A00,185511,Staff,12,0,20,8
1683671835601,CHEM 4,A01,184675,Bussey; Thomas J,97,0,100,3
1683671836626,CHEM 6A,A01,184677,Staff,32,0,60,28
1683671837651,CHEM 6B,A01,184679,Staff,63,0,100,37
1683671838676,CHEM 6C,A01,184681,Bussey; Thomas J,0,0,50,50
1683671838676,CHEM 6C,A02,184682,Bussey; Thomas J,32,0,50,18
1683671839703,CHEM 40A,A01,184684,Albizati; Kim F.,33,0,100,67
1683671840731,CHEM 40B,A01,184686,Albizati; Kim F.,0,22,100,100
1683671841760,CHEM 41B,A01,184690,Staff,51,0,100,49
1683671842792,COGS 3,A01,184715,Boyle; Mary E. T.,0,27,40,40
1683671843817,COGS 14B,A01,185172,Staff,0,14,38,38
1683671844841,COGS 18,A01,184736,Staff,14,0,80,66
1683671845867,COGS 100,A01,184932,Staff,0,8,73,73
1683671846894,COGS 101A,A01,184935,Staff,0,40,30,30
1683671847922,COGS 101B,A01,184944,Staff,0,2,30,30
1683671848945,COGS 101C,A01,184946,Staff,0,10,30,30
1683671849970,COGS 102A,A01,184951,Johnson; Christine M.,2,0,40,38
1683671850995,COGS 107B,A01,184953,Mooshagian; Eric Frederick,0,52,40,40
1683671852020,COGS 118B,A01,184959,Gupta; Anjum,0,50,40,40
1683671853049,COGS 153,A00,184961,Staff,0,16,30,30
1683671854073,COGS 177,A00,184962,Staff,0,21,30,30
1683671855098,COGS 187A,A01,184969,Boyle; Mary E. T.,0,19,40,40
1683671856125,COMM 10,A01,185174,Staff,0,5,25,25
1683671856125,COMM 10,A02,185189,Staff,0,2,25,25
1683671856125,COMM 10,A03,269821,Staff,0,1,0,0
1683671857148,COMM 100B,A01,185475,Staff,0,1,0,1
1683671857148,COMM 100B,A02,185476,Staff,11,0,25,14
1683671858176,COMM 100C,A01,185314,Staff,1,0,25,24
1683671858176,COMM 100C,A02,185327,Staff,17,0,25,8
1683671859201,COMM 110M,A00,185349,Staff,0,0,40,40
1683671860225,COMM 113T,A00,185352,Staff,25,0,40,15
1683671861252,COMM 114I,A00,185353,Staff,31,0,40,9
1683671862277,COMM 131,A00,185354,Staff,17,0,30,13
1683671863306,CSE 8A,A50,185358,Cao; Yingjun,0,46,10,10
1683671864332,CSE 8B,A01,185362,Staff,0,48,50,50
1683671865357,CSE 11,A01,185416,Cao; Yingjun,0,91,10,10
1683671866381,CSE 20,A01,185445,Briones; Jor-el Thomas Caparas,4,0,25,21
1683671867406,CSE 21,A01,185447,Staff,9,0,50,41
1683671868431,CSE 101,A01,185451,Staff,0,13,50,50
1683671868431,CSE 101,B01,185453,Jones; Miles E,0,14,50,50
1683671870484,CSE 141,A01,185458,Eldon; John,16,0,100,84
1683671871511,CSE 141L,A01,185461,Eldon; John,8,0,100,92
1683671872536,CSE 142,A01,185463,Staff,34,0,60,26
1683671872536,CSE 142,B01,201355,Staff,0,7,60,60
1683671873560,CSE 142L,A01,185470,Staff,34,0,60,26
1683671873560,CSE 142L,B01,201417,Staff,0,6,60,60
1683671874584,CSE 190,A00,201433,Staff,32,0,49,17
1683671875612,DOC 1,A01,259136,Strom; Megan C.,7,0,15,8
1683671875612,DOC 1,A02,259137,Strom; Megan C.,14,0,15,1
1683671875612,DOC 1,A03,259138,Strom; Megan C.,14,0,15,1
1683671875612,DOC 1,A04,259139,Strom; Megan C.,14,0,15,1
1683671876637,DOC 100D,A00,259140,Pass; Natalye Joann,14,0,25,11
1683671877661,DSGN 1,A01,184749,Rill; Bryan,0,26,30,30
1683671878686,DSGN 100,A01,185168,Staff,0,2,25,25
1683671879714,ECE 5,A01,185626,Morris; Karcher William,0,12,0,0
1683671880739,ECE 101,A01,185628,Staff,14,0,70,56
1683671881765,ECE 107,A01,185635,Baghdadchi; Saharnaz,0,0,20,20
1683671881765,ECE 107,A02,185638,Baghdadchi; Saharnaz,1,0,20,19
1683671882793,ECE 148,A01,185647,Silberman; Jack,0,0,16,16
1683671883821,ECON 1,A01,185537,Crane; Meredith Helen,54,0,70,16
1683671884846,ECON 3,A01,185549,Crane; Meredith Helen,29,0,70,41
1683671885872,ECON 4,A01,203354,Anderson; John Charles,0,5,10,10
1683671886900,ECON 100A,A01,185574,Staff,0,5,40,40
1683671887925,ECON 100B,A01,185576,Staff,0,12,50,50
1683671888956,ECON 100C,A01,185589,Newhouse; Herbert S,30,0,70,40
1683671889983,ECON 105,A00,185608,Vespa; Emanuel Ignacio,19,0,35,16
1683671891012,ECON 109,A01,185610,Shishkin; Denis,9,0,35,26
1683671892039,ECON 110A,A01,185612,Staff,9,0,40,31
1683671893067,ECON 120A,A01,185615,Staff,19,0,40,21
1683671894096,ECON 120C,A01,185617,Sun; Yixiao,0,21,70,70
1683671895121,ECON 144,A00,203346,Squires; Dale E,2,0,35,33
1683671896149,ECON 171,A01,203349,Newhouse; Herbert S,0,1,35,35
1683671897178,ECON 173A,A01,185621,Toda; Alexis Akira,20,0,35,15
1683671898204,EDS 25,A01,202413,Staff,0,1,0,0
1683671898204,EDS 25,A02,202414,Staff,0,1,0,0
1683671898204,EDS 25,A03,202415,Staff,0,0,0,0
1683671898204,EDS 25,A04,202416,Staff,0,1,0,0
1683671898204,EDS 25,A05,202439,Staff,0,0,0,0
1683671898204,EDS 25,A06,202440,Staff,0,0,0,0
1683671898204,EDS 25,B01,202631,Staff,0,0,0,0
1683671898204,EDS 25,B02,202632,Staff,0,0,0,0
1683671898204,EDS 25,B03,202639,Staff,0,0,0,0
1683671898204,EDS 25,B04,202640,Staff,0,0,0,0
1683671898204,EDS 25,B05,202643,Staff,0,0,0,0
1683671898204,EDS 25,B06,202644,Staff,0,0,0,0
1683671899228,EDS 38,A01,202659,Black; Alison Michelle,24,0,25,1
1683671900252,EDS 115,A00,202652,Staff,18,0,30,12
1683671901277,EDS 125,A00,202649,Staff,13,0,30,17
1683671902304,EDS 126,A01,203332,Staff,30,0,30,0
1683671903331,EDS 139,A00,202838,Staff,16,0,25,9
1683671904359,EDS 146,A01,202655,Staff,14,0,25,11
1683671905384,ENG 15,A00,185667,Staff,0,1,0,0
1683671905384,ENG 15,B00,185672,Staff,0,0,0,0
1683671905384,ENG 15,C00,185675,Staff,0,0,0,0
1683671905384,ENG 15,D00,185682,Staff,0,0,0,0
1683671905384,ENG 15,E00,185684,Staff,0,0,0,0
1683671906411,ETHN 103,A00,185710,Staff,0,8,35,35
1683671907435,ETHN 103A,A00,199228,Man; Simeon S,0,0,9,9
1683671908459,ETHN 109,A00,185711,Staff,15,0,35,20
1683671909486,ETHN 142,A00,185726,Staff,0,4,30,30
1683671910513,ETHN 163J,A00,199229,Man; Simeon S,5,0,8,3
1683671911542,ETHN 168,A00,185727,Staff,7,0,10,3
1683671912570,ETHN 182,A00,185728,Staff,0,0,35,35
1683671913595,ETHN 183,A00,185737,Staff,9,0,18,9
1683671914622,GLBH 111,A01,209361,Burgos; Jose L.,0,0,0,0
1683671916674,HIEU 104,A00,185792,Staff,14,0,20,6
1683671917699,HIEU 115,A00,185800,Staff,0,0,20,20
1683671918726,HIEU 128,A00,185801,Staff,0,9,20,20
1683671919806,HIEU 147,A00,185802,Staff,15,0,20,5
1683671920832,HIEU 154,A00,185823,Staff,11,0,20,9
1683671921886,HILA 102,A00,185826,Staff,14,0,20,6
1683671922925,HILD 2C,A01,185778,Staff,0,13,20,20
1683671923949,HILD 7B,A01,185780,Kwak; Nancy,0,17,32,32
1683671923949,HILD 7B,A02,185781,Kwak; Nancy,0,18,32,32
1683671924975,HILD 30,A01,185791,Staff,12,0,20,8
1683671926002,HISC 119,A00,185830,Golan; Tal,0,9,20,20
1683671927025,HITO 156GS,A00,185831,Patterson; Patrick H.,0,0,0,23
1683671928053,HIUS 103,A00,185832,Man; Simeon S,0,4,20,20
1683671929077,HIUS 117,A00,185836,Kwak; Nancy,2,0,20,18
1683671930101,HIUS 125,A00,185840,Man; Simeon S,0,2,23,23
1683671931129,HIUS 149,A00,185845,Staff,1,0,20,19
1683671932154,HUM 3,A01,185882,Zavodny; Tatiana Sophia,0,8,50,50
1683671932154,HUM 3,B01,185899,Caldwell; Michael Alan,0,18,50,50
1683671933179,HUM 3GS,A00,185900,Patterson; Patrick H.,0,0,0,23
1683671934206,HUM 4,A01,185938,Zroka; Amy Liane,29,0,50,21
1683671934206,HUM 4,B01,185956,Watkins; Eric,0,5,50,50
1683671934206,HUM 4,B02,202209,Watkins; Eric,0,5,50,50
1683671934206,HUM 4,B03,202210,Watkins; Eric,0,5,50,50
1683671935229,HUM 5,A01,185958,West; Geoffrey Scott,0,0,50,50
1683671935229,HUM 5,A02,202215,West; Geoffrey Scott,0,0,50,50
1683671936258,INTL 190,A00,185959,Gagnon; Jeffrey C,0,0,0,9
1683671936258,INTL 190,B00,185960,Lettieri; Michael Joseph,0,0,0,2
1683671937283,JAPN 180,A00,254509,Staff,5,0,30,25
1683671938305,LATI 10,A01,202853,Kennemore; Amy Michelle,4,0,35,31
1683671938305,LATI 10,A02,202854,Kennemore; Amy Michelle,2,0,35,33
1683671938305,LATI 10,A03,270054,Kennemore; Amy Michelle,30,0,30,0
1683671939334,LATI 180,A00,202855,Kennemore; Amy Michelle,11,0,20,9
1683671940359,LAWS 101,A00,201767,Golan; Tal,0,7,40,40
1683671941389,LIFR 1C,A00,185961,Staff,6,0,20,14
1683671942417,LIFR 1CX,A00,185962,Staff,7,0,20,13
1683671943443,LIFR 1D,A00,185963,Staff,7,0,20,13
1683671944473,LIFR 1DX,A00,185964,Staff,7,0,20,13
1683671945500,LIGN 101,A01,186039,Staff,43,0,50,7
1683671946528,LIGN 165,A00,186040,Staff,15,0,50,35
1683671947554,LTCS 108,A00,186041,Staff,5,0,10,5
1683671948578,LTCS 119,A00,186042,Staff,15,0,20,5
1683671949606,LTCS 130,A00,186043,Wesling; Megan E.,15,0,25,10
1683671951654,LTEA 138,A00,186119,Staff,14,0,40,26
1683671952677,LTEN 124,A00,186148,Staff,5,0,25,20
1683671953702,LTEN 178,A00,186149,Staff,7,0,15,8
1683671954730,LTEN 181,A00,186150,Blanco; John D,34,0,40,6
1683671955754,LTWL 120,A00,186160,Staff,19,0,25,6
1683671956779,LTWL 165,A00,186161,Staff,22,0,25,3
1683671957809,LTWR 100,A00,186162,Staff,0,5,15,15
1683671958834,LTWR 102,A00,186163,Doller; Ben,5,0,15,10
1683671959861,MAE 8,A01,186412,Staff,0,0,0,0
1683671960885,MAE 30B,A00,186445,Bahadori; Mohammad Yousef,82,0,100,18
1683671961909,MAE 40,A00,186592,Bewley; Thomas R,10,0,50,40
1683671962936,MAE 101B,A00,186593,Bahadori; Mohammad Yousef,80,0,100,20
1683671963961,MAE 105,A00,186594,Bandaru; Prabhakar,10,0,50,40
1683671964989,MAE 107,A00,186599,Pham; Hieu Tan,0,7,120,120
1683671966015,MAE 148,A01,186660,Silberman; Jack,3,0,16,13
1683671967040,MATH 10A,A01,188095,Staff,0,6,35,35
1683671968065,MATH 10B,A01,188097,Bowers; Adam R.,0,12,30,30
1683671968065,MATH 10B,A02,188099,Bowers; Adam R.,0,11,30,30
1683671968065,MATH 10B,B01,188104,Bowers; Adam R.,0,10,30,30
1683671968065,MATH 10B,B02,188106,Bowers; Adam R.,1,9,30,29
1683671969093,MATH 10C,A01,188111,Staff,0,20,30,30
1683671969093,MATH 10C,A02,188127,Staff,0,19,30,30
1683671969093,MATH 10C,A03,188131,Staff,0,19,30,30
1683671969093,MATH 10C,B01,188218,Staff,17,0,30,13
1683671969093,MATH 10C,B02,188244,Staff,13,0,30,17
1683671969093,MATH 10C,B03,188277,Staff,14,0,30,16
1683671970119,MATH 18,A01,188344,Bach; Quang Tran,18,0,30,12
1683671970119,MATH 18,A02,188345,Bach; Quang Tran,11,0,30,19
1683671970119,MATH 18,B01,188353,Bach; Quang Tran,11,0,30,19
1683671970119,MATH 18,B02,188354,Bach; Quang Tran,19,0,30,11
1683671971142,MATH 20A,A01,188374,Staff,11,0,35,24
1683671972167,MATH 20B,A01,188382,Ohm; Ko Woon,7,0,30,23
1683671972167,MATH 20B,A02,188383,Ohm; Ko Woon,22,0,30,8
1683671972167,MATH 20B,B01,188385,Ohm; Ko Woon,7,0,30,23
1683671972167,MATH 20B,B02,188392,Ohm; Ko Woon,22,0,30,8
1683671973192,MATH 20C,A01,188394,Harel; Guershon,10,0,30,20
1683671973192,MATH 20C,A02,188395,Harel; Guershon,13,0,30,17
1683671973192,MATH 20C,B01,188404,Harel; Guershon,5,0,30,25
1683671973192,MATH 20C,B02,188405,Harel; Guershon,18,0,30,12
1683671974217,MATH 20D,A01,188414,Hammock; Frances H,0,1,30,30
1683671974217,MATH 20D,A02,188415,Hammock; Frances H,0,1,30,30
1683671974217,MATH 20D,B01,188447,Hammock; Frances H,0,1,30,30
1683671974217,MATH 20D,B02,188486,Hammock; Frances H,3,0,30,27
1683671975242,MATH 20E,A01,188649,Staff,21,0,30,9
1683671975242,MATH 20E,A02,188650,Staff,20,0,30,10
1683671975242,MATH 20E,A03,188673,Staff,0,0,30,30
1683671976266,MATH 102,A01,188675,Staff,0,37,35,35
1683671977292,MATH 103B,A01,188681,Staff,3,0,35,32
1683671977292,MATH 103B,B01,188692,Staff,5,0,35,30
1683671978317,MATH 109,A01,188695,Salehi Golsefidy; Alireza,24,0,35,11
1683671978317,MATH 109,A02,188696,Salehi Golsefidy; Alireza,25,0,35,10
1683671979342,MATH 120A,A01,188698,Eggers; John Dietrich,7,0,35,28
1683671980370,MATH 142B,A01,188736,Ioana; Adrian,1,1,30,29
1683671980370,MATH 142B,A02,188741,Ioana; Adrian,0,1,30,30
1683671980370,MATH 142B,A03,188743,Ioana; Adrian,0,1,30,30
1683671981398,MATH 168A,A01,188790,Staff,0,11,35,35
1683671982423,MATH 170A,A01,188803,Nie; Jiawang,0,2,35,35
1683671982423,MATH 170A,A02,188811,Nie; Jiawang,0,0,35,35
1683671982423,MATH 170A,A03,188814,Nie; Jiawang,0,0,35,35
1683671982423,MATH 170A,A04,188815,Nie; Jiawang,7,0,35,28
1683671983450,MATH 193B,A01,188817,Staff,0,0,35,35
1683671983450,MATH 193B,A02,188818,Staff,5,0,35,30
1683671984475,MGT 4,A01,202857,Anderson; John Charles,60,0,80,20
1683671985498,MGT 12,A00,202858,Lindenberger; Wade Douglas,40,0,90,50
1683671986522,MGT 18,A00,202859,Staff,74,0,90,16
1683671987547,MGT 18GS,A00,202860,McKay; Michael J,13,0,28,15
1683671988570,MGT 45,A00,202861,Pecore; Joseph P.,10,0,90,80
1683671989596,MGT 100,A00,202863,Yavorsky; Daniel Ryan,28,0,90,62
1683671990621,MGT 103,A00,202864,Ehrich; Kristine R,0,18,90,90
1683671991649,MGT 112,A00,202865,Ehrich; Kristine R,15,0,90,75
1683671992677,MGT 121A,A00,202868,Staff,90,20,90,0
1683671993701,MGT 131B,A00,202869,Anderson; John Charles,59,0,90,31
1683671994727,MGT 136,A00,202871,Lindenberger; Wade Douglas,83,0,90,7
1683671995751,MGT 164,A00,202873,Staff,0,67,90,91
1683671996775,MGT 164GS,A00,202874,McKay; Mary A,13,0,28,15
1683671997801,MGT 180,A00,202875,Staff,0,51,90,91
1683671998829,MMW 11R,A01,205019,Herbst; Matthew,0,0,30,30
1683671998829,MMW 11R,A02,205026,Herbst; Matthew,29,0,30,1
1683671999853,MMW 15,A01,193512,Chang; Edmond Yi-Teh,0,8,28,28
1683671999853,MMW 15,A02,193513,Chang; Edmond Yi-Teh,0,5,28,28
1683671999853,MMW 15,A03,193514,Chang; Edmond Yi-Teh,0,5,28,28
1683671999853,MMW 15,A04,193515,Chang; Edmond Yi-Teh,0,5,28,28
1683671999853,MMW 15,A05,193516,Chang; Edmond Yi-Teh,0,5,28,28
1683671999853,MMW 15,A06,193517,Chang; Edmond Yi-Teh,0,6,28,28
1683671999853,MMW 15,B01,193519,Chang; Edmond Yi-Teh,0,5,28,28
1683671999853,MMW 15,B02,193520,Chang; Edmond Yi-Teh,0,5,28,28
1683671999853,MMW 15,B03,193521,Chang; Edmond Yi-Teh,0,5,28,28
1683671999853,MMW 15,B04,193522,Chang; Edmond Yi-Teh,0,5,28,28
1683671999853,MMW 15,B05,193523,Chang; Edmond Yi-Teh,0,5,28,28
1683671999853,MMW 15,B06,193524,Chang; Edmond Yi-Teh,0,5,28,28
1683672000880,MMW 122,A01,193526,Rahimi; Babak,0,16,28,28
1683672000880,MMW 122,A02,193527,Rahimi; Babak,0,15,28,28
1683672000880,MMW 122,A03,193528,Rahimi; Babak,0,0,0,0
1683672000880,MMW 122,A04,193529,Rahimi; Babak,0,0,0,0
1683672001906,MUS 1A,A01,186663,Staff,1,19,35,34
1683672002936,MUS 4,A01,186715,Staff,0,12,35,35
1683672003962,MUS 5R,A01,186796,Dubnov; Shlomo,0,17,35,35
1683672004987,MUS 6,A01,186798,Staff,0,5,25,25
1683672006011,MUS 7,A01,186830,Staff,11,0,35,24
1683672007036,MUS 8,A01,186930,Staff,0,27,35,35
1683672008063,MUS 15,A01,186932,Staff,0,15,35,35
1683672008063,MUS 15,B01,186934,Staff,1,17,35,34
1683672009091,MUS 80,A00,186935,Staff,0,0,20,20
1683672009091,MUS 80,B00,186936,Staff,24,0,25,1
1683672010114,NANO 11,A00,204702,Lipomi; Darren John,0,0,0,0
1683672011139,NANO 15,A01,204709,Yang; Kesong,0,1,0,0
1683672012167,NANO 114,A00,202069,Jahed Motlagh; Zeinab,3,0,10,7
1683672013190,PHIL 1,A00,186955,Grush; Rick Scott,31,0,40,9
1683672014213,PHIL 10,A01,186973,Grush; Rick Scott,27,0,35,8
1683672014213,PHIL 10,A02,186974,Grush; Rick Scott,33,0,35,2
1683672015237,PHIL 13,A01,186976,Staff,3,0,35,32
1683672015237,PHIL 13,A02,186977,Staff,16,0,35,19
1683672016263,PHIL 14,A01,186979,Staff,31,0,35,4
1683672016263,PHIL 14,A02,186986,Staff,32,0,35,3
1683672017290,PHIL 28,A01,186988,Staff,16,0,30,14
1683672017290,PHIL 28,A02,186989,Staff,1,0,30,29
1683672017290,PHIL 28,A03,186990,Staff,10,0,30,20
1683672017290,PHIL 28,A04,186991,Staff,26,0,30,4
1683672018315,PHIL 120,A00,186997,Staff,23,0,40,17
1683672019339,PHIL 137,A00,187003,Staff,7,0,40,33
1683672020363,PHIL 150,A00,187015,Staff,47,0,70,23
1683672021389,PHIL 167,A00,187021,Lamey; Andy M.,34,0,40,6
1683672022521,PHIL 174,A01,202226,Staff,17,0,20,3
1683672022521,PHIL 174,A02,202235,Staff,20,0,20,0
1683672023603,PHIL 191A,A00,258918,Staff,0,0,1,1
1683672024628,PHYS 1A,A00,187028,Staff,26,0,60,34
1683672025659,PHYS 1AL,001,187036,Staff,3,0,30,27
1683672025659,PHYS 1AL,002,187049,Staff,18,0,30,12
1683672026688,PHYS 1B,A00,187058,Staff,22,0,60,38
1683672027713,PHYS 1BL,001,187064,Staff,0,1,30,30
1683672027713,PHYS 1BL,002,187070,Staff,4,0,30,26
1683672028739,PHYS 1C,A00,187082,Staff,29,0,120,91
1683672029768,PHYS 1CL,001,187088,Staff,0,9,30,30
1683672029768,PHYS 1CL,002,187089,Staff,0,1,30,30
1683672029768,PHYS 1CL,009,262693,Staff,9,0,30,21
1683672030792,PHYS 2B,A01,187097,Staff,55,0,115,60
1683672031822,PHYS 2C,A01,187099,Staff,63,0,115,52
1683672032847,PHYS 2CL,A01,187101,Staff,5,0,28,23
1683672032847,PHYS 2CL,A02,187102,Staff,15,0,28,13
1683672033871,PHYS 2D,A01,187123,Shotwell; Brian,95,0,115,20
1683672034894,PHYS 4B,A01,187133,Grinstein; Benjamin,35,0,50,15
1683672035921,POLI 10,A00,188819,Staff,0,4,50,50
1683672036949,POLI 11,A00,188827,Staff,43,0,50,7
1683672037973,POLI 13R,A00,188828,Staff,0,1,20,20
1683672038998,POLI 27,A01,188830,Elgin; Samuel Zincke,0,2,70,70
1683672040028,POLI 30,A00,188832,Desposato; Scott,30,0,50,20
1683672041051,POLI 102F,A00,188834,Staff,0,0,40,40
1683672042075,POLI 104A,A00,188852,Staff,13,0,30,17
1683672043102,POLI 104I,A00,188853,Staff,0,7,20,20
1683672044126,POLI 110B,A00,188854,Wiens; David,6,0,20,14
1683672045150,POLI 112A,A00,188855,Wiens; David,3,0,30,27
1683672046178,POLI 117R,A00,188856,Forman; Fonna,0,12,20,20
1683672047205,POLI 118,A00,188857,Ingham; Sean,8,0,20,12
1683672048229,POLI 120G,A00,188858,Staff,8,0,30,22
1683672049252,POLI 131CR,A00,188863,Hoston; Germaine,20,0,50,30
1683672050276,POLI 133,A00,188864,Nellis; Gareth Hb,44,0,50,6
1683672051303,POLI 134D,A00,188865,Desposato; Scott,27,0,30,3
1683672052327,POLI 142A,A00,188871,Gartzke; Erik,21,0,50,29
1683672053351,POLI 142K,A00,188874,Staff,38,0,50,12
1683672054375,POLI 143,A00,188940,Gartzke; Erik,16,0,30,14
1683672055398,POLI 153,A00,188943,Staff,2,0,20,18
1683672056425,POLI 160AA,A00,188944,Staff,11,0,40,29
1683672057449,POLI 170A,A00,188945,Staff,10,0,30,20
1683672059498,PSYC 1,A00,188952,Staff,37,0,90,53
1683672060525,PSYC 2,B00,188953,Staff,19,0,35,16
1683672061550,PSYC 6,A00,188970,Staff,47,0,60,13
1683672062573,PSYC 7,A00,188973,Staff,35,0,45,10
1683672063600,PSYC 60,A01,188980,Rickard; Timothy C.,42,0,60,18
1683672064628,PSYC 70,A01,189001,Steiner; Eric Tomas,22,0,45,23
1683672065652,PSYC 100,A00,189005,Lacefield; Katharine I,0,99,120,120
1683672066679,PSYC 102,A00,189008,Staff,8,0,30,22
1683672067703,PSYC 106,B00,189026,Gorman; Michael R.,27,0,60,33
1683672068730,PSYC 114,B01,189033,Winkielman; Piotr,0,31,30,30
1683672069757,PSYC 131,A00,189036,Anagnostaras; Stephan,0,43,60,60
1683672070785,PSYC 136,A00,189041,Lowe; Angela Beth,0,7,25,25
1683672071810,PSYC 137,A00,189057,Winkielman; Piotr,1,37,25,24
1683672072835,PSYC 144,A00,189107,Wixted; John T,0,11,50,50
1683672074886,PSYC 162,A00,189142,Staff,0,9,85,85
1683672075911,PSYC 172,A00,189144,Gorman; Michael R.,0,6,30,30
1683672077966,PSYC 179,A00,189146,Lacefield; Katharine I,0,87,120,120
1683672078990,PSYC 181,A00,189147,Anagnostaras; Stephan,0,44,90,90
1683672080016,PSYC 190R,A00,189148,Barner; David A.,0,23,80,80
1683672081042,PSYC 191,A00,189275,Rickard; Timothy C.,0,10,25,25
1683672082065,PSYC 193,A00,189276,Chapman; Eddie Nathaniel,0,1,0,4
1683672083090,PSYC 193L,A01,189281,Lowe; Angela Beth,10,0,20,10
1683672083090,PSYC 193L,B01,189285,Staff,28,0,35,7
1683672084113,RELI 149,A00,187137,Rahimi; Babak,7,0,40,33
1683672085138,SE 9,A01,187315,Staff,0,2,18,18
1683672086162,SE 101B,A00,187409,Staff,24,0,30,6
1683672087191,SE 110B,A00,187444,Staff,10,0,40,30
1683672088216,SE 130B,A00,187449,Staff,31,0,40,9
1683672089241,SE 150A,A00,187516,Staff,8,0,20,12
1683672090268,SE 154,A00,187528,Staff,29,0,50,21
1683672091293,SIO 3,A01,258171,Staff,35,0,40,5
1683672092317,SIO 10,A00,187144,Cook; Geoffrey W,0,7,75,75
1683672093341,SIO 45,A00,187152,Cook; Geoffrey W,0,6,100,100
1683672094369,SIO 109R,A00,194486,Staff,0,4,20,20
1683672096420,SIO 187,A01,187233,Kacev; David,12,0,40,28
1683672097446,SOCI 1,A01,258656,Thorpe; Charles Robert,28,0,30,2
1683672097446,SOCI 1,A02,258658,Thorpe; Charles Robert,30,0,30,0
1683672097446,SOCI 1,A03,258661,Thorpe; Charles Robert,25,0,25,0
1683672097446,SOCI 1,A04,258666,Thorpe; Charles Robert,22,0,25,3
1683672097446,SOCI 1,A05,258897,Thorpe; Charles Robert,22,0,25,3
1683672097446,SOCI 1,A06,258898,Thorpe; Charles Robert,25,0,25,0
1683672098474,SOCI 30,A01,258903,Pardo Guerra; Juan Pablo,14,0,30,16
1683672099498,SOCI 102,A00,258904,Staff,9,0,25,16
1683672100522,SOCI 106,A00,258905,Staff,19,0,25,6
1683672101549,SOCI 111,A00,258907,Ribas Norris; Janet Vanesa,26,0,30,4
1683672102577,SOCI 121R,A00,258908,Pardo Guerra; Juan Pablo,8,0,30,22
1683672103601,SOCI 126,A01,203330,Staff,14,0,20,6
1683672104625,SOCI 131,A00,258909,Thorpe; Charles Robert,30,0,60,30
1683672105653,SOCI 135,A00,258910,Payne; Christine Anna,0,11,30,30
1683672106679,SOCI 157,A00,258911,Staff,11,0,30,19
1683672107702,SOCI 184,A00,258912,Staff,25,0,30,5
1683672108727,SOCI 188D,A00,258913,Staff,22,0,30,8
1683672109750,SYN 2,001,187529,Staff,9,0,16,7
1683672109750,SYN 2,002,201452,Staff,0,20,16,16
1683672109750,SYN 2,003,201469,Staff,1,0,16,15
1683672110777,SYN 100,A01,187531,Staff,0,9,20,20
1683672110777,SYN 100,B01,201491,Staff,0,10,20,20
1683672111805,TDAC 1,A00,189286,Walsh; Kim C.,3,0,20,17
1683672111805,TDAC 1,B00,189287,Harting; Carla Kelso,10,0,20,10
1683672112832,TDAC 101,A00,189300,Walsh; Kim C.,16,0,20,4
1683672112832,TDAC 101,B00,189301,Harting; Carla Kelso,18,0,20,2
1683672113856,TDAC 102,A00,189304,Basso; Beatrice,14,0,20,6
1683672114881,TDAC 108,A00,189305,Staff,18,0,20,2
1683672115906,TDDE 131,A00,189310,Staff,19,0,20,1
1683672115906,TDDE 131,B00,189314,Staff,19,0,20,1
1683672115906,TDDE 131,C00,189315,Staff,48,0,50,2
1683672115906,TDDE 131,D00,189316,Staff,14,0,15,1
1683672115906,TDDE 131,E00,204841,Staff,20,0,20,0
1683672116934,TDGE 10,A00,189289,Staff,27,0,50,23
1683672116934,TDGE 10,B00,189290,Havis; Allan,0,1,50,50
1683672117962,TDGE 11,A00,189291,Fulton; Julia,0,4,50,50
1683672117962,TDGE 11,B00,189292,Staff,20,0,25,5
1683672117962,TDGE 11,C00,260270,Staff,0,0,0,0
1683672118986,TDGE 25,A00,189294,Staff,2,0,20,18
1683672120011,TDGE 124,A00,189318,Fulton; Julia,0,8,50,50
1683672121034,TDGE 125,A00,189319,Staff,13,0,25,12
1683672121034,TDGE 125,B00,189320,Staff,23,0,25,2
1683672122061,TDGE 127,A00,189322,Havis; Allan,0,0,50,50
1683672123086,TDHT 101,A00,189323,Staff,18,0,25,7
1683672123086,TDHT 101,B00,189324,Staff,25,0,25,0
1683672124113,TDHT 102,A00,189325,Staff,49,0,50,1
1683672125142,TDMV 1,A00,189295,Arcidiacono; Kristin,20,0,30,10
1683672125142,TDMV 1,B00,189296,Caligagan; Maria T.,24,0,30,6
1683672126170,TDMV 2,A00,189297,Sammartano; Tonnie,27,0,30,3
1683672126170,TDMV 2,B00,189299,Arcidiacono; Kristin,23,0,30,7
1683672127253,TDMV 3,A00,204998,Rincon; Alicia,22,0,30,8
1683672128281,TDMV 120,A00,189458,Sammartano; Tonnie,28,0,30,2
1683672129307,TDMV 138,A00,189541,Jun; Grace Shin Hae,20,0,40,20
1683672130332,TDMV 142,A00,189717,Caligagan; Tony,25,0,30,5
1683672130332,TDMV 142,B00,189718,Caligagan; Maria T.,25,0,30,5
1683672131358,TMC 2,A01,187533,Staff,25,0,25,0
1683672131358,TMC 2,A02,187534,Staff,25,0,25,0
1683672132381,USP 1,A01,187536,Kwak; Nancy,0,16,25,25
1683672133405,USP 5,A01,187538,Staff,9,0,25,16
1683672134429,USP 101,A00,199253,Staff,0,4,0,0
1683672135458,USP 124,A00,187562,Boomhower; Matthew Charles,0,0,30,30
1683672136481,USP 138,A00,187582,Staff,19,0,25,6
1683672137505,USP 152,A01,187597,Staff,3,0,25,22
1683672138533,USP 153,A00,187598,Staff,19,0,25,6
1683672139557,USP 168,A00,187607,Kwak; Nancy,2,0,5,3
1683672140584,USP 173,A00,187619,Staff,4,0,25,21
1683672141608,USP 181,A00,187638,Staff,0,4,25,25
1683672142632,VIS 103,A00,187650,Cruz; Edwin Teddy,17,0,75,58
1683672143660,VIS 110D,A00,187669,Staff,13,0,22,9
1683672144691,VIS 127C,A00,187720,Shen; Kuiyi,67,0,146,79
1683672145716,VIS 149,A00,187731,Yoldas; Pinar,1,14,22,21
1683672146741,VIS 151,A01,188091,Staff,22,0,34,12
1683672146741,VIS 151,A02,188092,Staff,11,0,34,23
1683672147765,VIS 160B,A00,188093,Stalbaum; Brett,0,1,10,10
1683672149819,WCWP 10B,A00,201720,Staff,10,0,15,5
1683672149819,WCWP 10B,B00,201722,Staff,9,0,15,6
1683672150845,WCWP 100,A00,201725,Gagnon; Jeffrey C,0,0,2,2
1683672150845,WCWP 100,B00,201727,Staff,0,4,15,15
1683672153938,ANBI 133,A00,258401,Wilder; Linnea Lorene,34,0,40,6
1683672154961,ANBI 140,A00,258395,Hrvoj Mihic; Branka,18,0,25,7
1683672155985,ANSC 120,A00,258402,Bialecki; Jon Anthony,26,0,40,14
1683672157009,ANSC 144,A00,258400,Staff,12,0,40,28
1683672159070,ANSC 166,A00,258396,Parish; Steven Martin,156,0,175,19
1683672160093,ANSC 180,A00,193533,Staff,8,0,20,12
1683672161116,ANSC 188,A00,258397,Jassal; Aftab,34,0,40,6
1683672162140,ANTH 3,A01,258316,Staff,23,0,30,7
1683672163167,ANTH 5,A00,258394,Semendeferi; Ekaterini,16,0,20,4
1683672164191,ANTH 21,A01,258331,Staff,4,0,40,36
1683672165218,ANTH 103,A00,258398,Varma; Saiba,15,0,25,10
1683672166247,AWP 10,001,202034,Staff,0,0,0,0
1683672166247,AWP 10,002,202035,Staff,0,0,0,0
1683672166247,AWP 10,003,202036,Staff,0,0,0,0
1683672166247,AWP 10,004,202037,Staff,0,0,0,0
1683672166247,AWP 10,005,202038,Staff,0,0,0,0
1683672166247,AWP 10,006,202039,Staff,0,0,0,0
1683672166247,AWP 10,007,202040,Staff,0,0,0,0
1683672166247,AWP 10,008,202041,Staff,0,0,0,0
1683672166247,AWP 10,009,202042,Staff,0,0,0,0
1683672166247,AWP 10,010,202043,Staff,0,0,0,0
1683672166247,AWP 10,011,202044,Staff,0,0,0,0
1683672166247,AWP 10,012,202045,Staff,0,0,0,0
1683672166247,AWP 10,013,202046,Staff,0,0,0,0
1683672166247,AWP 10,014,202047,Staff,0,0,0,0
1683672166247,AWP 10,015,202048,Staff,0,0,0,0
1683672166247,AWP 10,016,202049,Staff,0,0,0,0
1683672166247,AWP 10,017,202050,Staff,0,0,0,0
1683672166247,AWP 10,018,202051,Staff,0,0,0,0
1683672166247,AWP 10,019,202052,Staff,0,0,0,0
1683672166247,AWP 10,020,202053,Staff,0,0,0,0
1683672166247,AWP 10,021,202054,Staff,0,0,0,0
1683672166247,AWP 10,022,202055,Staff,0,0,0,0
1683672166247,AWP 10,023,202056,Staff,0,0,0,0
1683672166247,AWP 10,024,202057,Staff,0,0,0,0
1683672166247,AWP 10,025,202058,Staff,0,0,0,0
1683672166247,AWP 10,026,202059,Staff,0,0,0,0
1683672167271,AWP 102,001,202032,Staff,0,0,0,0
1683672167271,AWP 102,002,202033,Staff,0,0,0,0
1683672168295,BENG 100,A01,254234,Taylor Amos; Alyssa C,31,0,40,9
1683672169317,BENG 196,001,270013,Engler; Adam J.,9999,0,9999,0
1683672170342,BICD 100R,A01,202018,Smith; Laurie,0,7,32,32
1683672170342,BICD 100R,A02,202019,Smith; Laurie,0,3,32,32
1683672170342,BICD 100R,A03,202020,Smith; Laurie,0,1,32,32
1683672170342,BICD 100R,A04,202021,Smith; Laurie,6,0,32,26
1683672170342,BICD 100R,A05,202022,Smith; Laurie,11,0,32,21
1683672171366,BICD 136,A01,193242,Gustafson-Brown; Cindy,0,2,32,32
1683672171366,BICD 136,A02,193244,Gustafson-Brown; Cindy,13,0,32,19
1683672172391,BIEB 102,A01,193249,Butler; Shannon Rhey,1,2,32,31
1683672172391,BIEB 102,A02,193251,Butler; Shannon Rhey,0,0,32,32
1683672172391,BIEB 102,A03,193253,Butler; Shannon Rhey,0,0,32,32
1683672172391,BIEB 102,A04,193255,Butler; Shannon Rhey,13,0,32,19
1683672172391,BIEB 102,A05,193265,Butler; Shannon Rhey,25,0,32,7
1683672172391,BIEB 102,A06,193269,Butler; Shannon Rhey,14,0,32,18
1683672174445,BIEB 150,A01,193274,Staff,0,0,32,32
1683672174445,BIEB 150,A02,193285,Staff,24,0,32,8
1683672175469,BIEB 194,A00,193286,Kurle; Carolyn M.,20,0,32,12
1683672176493,BILD 1,A01,192291,Staff,15,0,32,17
1683672176493,BILD 1,A02,192292,Staff,30,0,32,2
1683672176493,BILD 1,B01,192520,Reuther; Keefe,0,1,0,0
1683672176493,BILD 1,B02,192532,Reuther; Keefe,0,1,0,0
1683672177518,BILD 3,A01,192556,Butler; Shannon Rhey,0,0,32,32
1683672177518,BILD 3,A02,192581,Butler; Shannon Rhey,0,1,32,32
1683672177518,BILD 3,A03,192611,Butler; Shannon Rhey,20,0,32,12
1683672177518,BILD 3,A04,192612,Butler; Shannon Rhey,24,0,32,8
1683672177518,BILD 3,A05,192613,Butler; Shannon Rhey,26,0,32,6
1683672177518,BILD 3,A06,192679,Butler; Shannon Rhey,27,0,32,5
1683672177518,BILD 3,A07,192682,Butler; Shannon Rhey,20,0,32,12
1683672178548,BILD 4,A01,192836,Reuther; Keefe,1,0,24,23
1683672178548,BILD 4,A02,193044,Reuther; Keefe,4,0,24,20
1683672179572,BILD 10,A01,193142,Gustafson-Brown; Cindy,29,0,32,3
1683672179572,BILD 10,A02,193149,Gustafson-Brown; Cindy,31,0,32,1
1683672180600,BIMM 100,A01,193301,Staff,0,6,32,32
1683672180600,BIMM 100,A02,193312,Staff,0,7,32,32
1683672180600,BIMM 100,A03,193323,Staff,0,10,32,32
1683672181629,BIMM 101,A01,193329,McDonnell; Lisa Marie,1,4,24,23
1683672181629,BIMM 101,A02,193339,McDonnell; Lisa Marie,1,4,24,23
1683672181629,BIMM 101,B01,193354,McDonnell; Lisa Marie,0,4,24,24
1683672181629,BIMM 101,B02,193357,McDonnell; Lisa Marie,0,3,24,24
1683672182655,BIMM 110,A01,193377,Tat; John,0,11,32,32
1683672182655,BIMM 110,A02,193378,Tat; John,0,10,32,32
1683672183680,BIMM 120,A01,206116,Staff,0,0,32,32
1683672183680,BIMM 120,A02,206117,Staff,7,0,32,25
1683672183680,BIMM 120,A03,206121,Staff,21,0,32,11
1683672184704,BIPN 100,A01,193393,Park; Ji Young,0,15,32,32
1683672184704,BIPN 100,A02,193402,Park; Ji Young,0,14,32,32
1683672184704,BIPN 100,A03,193413,Park; Ji Young,0,14,32,32
1683672184704,BIPN 100,A04,193414,Park; Ji Young,0,13,32,32
1683672185727,BIPN 102,A01,193429,Staff,0,0,32,32
1683672185727,BIPN 102,A02,193438,Staff,18,0,32,14
1683672186752,BIPN 106,A01,193450,Reyes Gonzalez; Catalina,0,2,40,40
1683672187781,BIPN 134,A01,193465,Cooke; James Edward,0,0,32,32
1683672187781,BIPN 134,A02,193474,Cooke; James Edward,25,0,32,7
1683672187781,BIPN 134,A03,193485,Cooke; James Edward,29,0,32,3
1683672187781,BIPN 134,A04,193486,Cooke; James Edward,20,0,32,12
1683672187781,BIPN 134,A05,193491,Cooke; James Edward,31,0,32,1
1683672187781,BIPN 134,A06,193501,Cooke; James Edward,30,0,32,2
1683672187781,BIPN 134,A07,193510,Cooke; James Edward,29,0,32,3
1683672189830,BISP 194,A00,222522,Staff,14,0,32,18
1683672190854,CAT 124,A01,202407,Staff,19,0,25,6
1683672191882,CAT 125,A00,202408,Marchisotto; Jennifer Anne,2,0,20,18
1683672192909,CAT 125R,A00,202409,Smith; Lauryn Alissa,0,11,20,20
1683672192909,CAT 125R,B00,202410,Morales; Celeste Georgianna,0,11,20,20
1683672192909,CAT 125R,C00,202411,Irwin; Matthew Joseph,0,12,20,20
1683672193934,CENG 15,A01,204712,Yang; Kesong,0,1,0,0
1683672194960,CENG 114,A00,202070,Jahed Motlagh; Zeinab,5,0,20,15
1683672195988,CGS 105,A00,185477,Wesling; Megan E.,24,0,40,16
1683672197012,CGS 106,A00,185494,Staff,11,0,22,11
1683672198034,CGS 108,A00,185495,Staff,14,0,20,6
1683672199059,CGS 114,A00,185496,Staff,13,0,18,5
1683672200086,CGS 119,A00,185501,Staff,15,0,20,5
1683672201111,CGS 120,A00,185511,Staff,12,0,20,8
1683672202138,CHEM 4,A01,184675,Bussey; Thomas J,97,0,100,3
1683672203165,CHEM 6A,A01,184677,Staff,32,0,60,28
1683672204189,CHEM 6B,A01,184679,Staff,63,0,100,37
1683672205212,CHEM 6C,A01,184681,Bussey; Thomas J,0,0,50,50
1683672205212,CHEM 6C,A02,184682,Bussey; Thomas J,32,0,50,18
1683672206237,CHEM 40A,A01,184684,Albizati; Kim F.,33,0,100,67
1683672207261,CHEM 40B,A01,184686,Albizati; Kim F.,0,22,100,100
1683672208284,CHEM 41B,A01,184690,Staff,51,0,100,49
1683672209308,COGS 3,A01,184715,Boyle; Mary E. T.,0,27,40,40
1683672210333,COGS 14B,A01,185172,Staff,0,14,38,38
1683672211360,COGS 18,A01,184736,Staff,14,0,80,66
1683672212386,COGS 100,A01,184932,Staff,0,8,73,73
1683672213414,COGS 101A,A01,184935,Staff,0,40,30,30
1683672214440,COGS 101B,A01,184944,Staff,0,2,30,30
1683672215465,COGS 101C,A01,184946,Staff,0,10,30,30
1683672216487,COGS 102A,A01,184951,Johnson; Christine M.,2,0,40,38
1683672217511,COGS 107B,A01,184953,Mooshagian; Eric Frederick,0,52,40,40
1683672218535,COGS 118B,A01,184959,Gupta; Anjum,0,50,40,40
1683672219559,COGS 153,A00,184961,Staff,0,16,30,30
1683672220582,COGS 177,A00,184962,Staff,0,21,30,30
1683672221606,COGS 187A,A01,184969,Boyle; Mary E. T.,0,19,40,40
1683672222631,COMM 10,A01,185174,Staff,0,5,25,25
1683672222631,COMM 10,A02,185189,Staff,0,2,25,25
1683672222631,COMM 10,A03,269821,Staff,0,1,0,0
1683672223658,COMM 100B,A01,185475,Staff,0,1,0,1
1683672223658,COMM 100B,A02,185476,Staff,11,0,25,14
1683672224682,COMM 100C,A01,185314,Staff,1,0,25,24
1683672224682,COMM 100C,A02,185327,Staff,17,0,25,8
1683672225707,COMM 110M,A00,185349,Staff,0,0,40,40
1683672226734,COMM 113T,A00,185352,Staff,25,0,40,15
1683672227760,COMM 114I,A00,185353,Staff,31,0,40,9
1683672228785,COMM 131,A00,185354,Staff,17,0,30,13
1683672229813,CSE 8A,A50,185358,Cao; Yingjun,0,46,10,10
1683672230894,CSE 8B,A01,185362,Staff,0,48,50,50
1683672231922,CSE 11,A01,185416,Cao; Yingjun,0,91,10,10
1683672232951,CSE 20,A01,185445,Briones; Jor-el Thomas Caparas,4,0,25,21
1683672233977,CSE 21,A01,185447,Staff,9,0,50,41
1683672235006,CSE 101,A01,185451,Staff,0,13,50,50
1683672235006,CSE 101,B01,185453,Jones; Miles E,0,14,50,50
1683672237061,CSE 141,A01,185458,Eldon; John,16,0,100,84
1683672238083,CSE 141L,A01,185461,Eldon; John,8,0,100,92
1683672239111,CSE 142,A01,185463,Staff,34,0,60,26
1683672239111,CSE 142,B01,201355,Staff,0,7,60,60
1683672240135,CSE 142L,A01,185470,Staff,34,0,60,26
1683672240135,CSE 142L,B01,201417,Staff,0,6,60,60
1683672241159,CSE 190,A00,201433,Staff,32,0,49,17
1683672242187,DOC 1,A01,259136,Strom; Megan C.,7,0,15,8
1683672242187,DOC 1,A02,259137,Strom; Megan C.,14,0,15,1
1683672242187,DOC 1,A03,259138,Strom; Megan C.,14,0,15,1
1683672242187,DOC 1,A04,259139,Strom; Megan C.,14,0,15,1
1683672243211,DOC 100D,A00,259140,Pass; Natalye Joann,14,0,25,11
1683672244236,DSGN 1,A01,184749,Rill; Bryan,0,26,30,30
1683672245264,DSGN 100,A01,185168,Staff,0,2,25,25
1683672246289,ECE 5,A01,185626,Morris; Karcher William,0,12,0,0
1683672247313,ECE 101,A01,185628,Staff,14,0,70,56
1683672248342,ECE 107,A01,185635,Baghdadchi; Saharnaz,0,0,20,20
1683672248342,ECE 107,A02,185638,Baghdadchi; Saharnaz,1,0,20,19
1683672249366,ECE 148,A01,185647,Silberman; Jack,0,0,16,16
1683672250395,ECON 1,A01,185537,Crane; Meredith Helen,54,0,70,16
1683672251418,ECON 3,A01,185549,Crane; Meredith Helen,29,0,70,41
1683672252441,ECON 4,A01,203354,Anderson; John Charles,0,5,10,10
1683672253468,ECON 100A,A01,185574,Staff,0,5,40,40
1683672254492,ECON 100B,A01,185576,Staff,0,12,50,50
1683672255518,ECON 100C,A01,185589,Newhouse; Herbert S,30,0,70,40
1683672256545,ECON 105,A00,185608,Vespa; Emanuel Ignacio,19,0,35,16
1683672257570,ECON 109,A01,185610,Shishkin; Denis,9,0,35,26
1683672258597,ECON 110A,A01,185612,Staff,9,0,40,31
1683672259622,ECON 120A,A01,185615,Staff,19,0,40,21
1683672260646,ECON 120C,A01,185617,Sun; Yixiao,0,21,70,70
1683672261671,ECON 144,A00,203346,Squires; Dale E,2,0,35,33
1683672262699,ECON 171,A01,203349,Newhouse; Herbert S,0,1,35,35
1683672263725,ECON 173A,A01,185621,Toda; Alexis Akira,20,0,35,15
1683672264751,EDS 25,A01,202413,Staff,0,1,0,0
1683672264751,EDS 25,A02,202414,Staff,0,1,0,0
1683672264751,EDS 25,A03,202415,Staff,0,0,0,0
1683672264751,EDS 25,A04,202416,Staff,0,1,0,0
1683672264751,EDS 25,A05,202439,Staff,0,0,0,0
1683672264751,EDS 25,A06,202440,Staff,0,0,0,0
1683672264751,EDS 25,B01,202631,Staff,0,0,0,0
1683672264751,EDS 25,B02,202632,Staff,0,0,0,0
1683672264751,EDS 25,B03,202639,Staff,0,0,0,0
1683672264751,EDS 25,B04,202640,Staff,0,0,0,0
1683672264751,EDS 25,B05,202643,Staff,0,0,0,0
1683672264751,EDS 25,B06,202644,Staff,0,0,0,0
1683672265774,EDS 38,A01,202659,Black; Alison Michelle,24,0,25,1
1683672266797,EDS 115,A00,202652,Staff,18,0,30,12
1683672267825,EDS 125,A00,202649,Staff,13,0,30,17
1683672268849,EDS 126,A01,203332,Staff,30,0,30,0
1683672269874,EDS 139,A00,202838,Staff,16,0,25,9
1683672270904,EDS 146,A01,202655,Staff,14,0,25,11
1683672271930,ENG 15,A00,185667,Staff,0,1,0,0
1683672271930,ENG 15,B00,185672,Staff,0,0,0,0
1683672271930,ENG 15,C00,185675,Staff,0,0,0,0
1683672271930,ENG 15,D00,185682,Staff,0,0,0,0
1683672271930,ENG 15,E00,185684,Staff,0,0,0,0
1683672272957,ETHN 103,A00,185710,Staff,0,8,35,35
1683672273986,ETHN 103A,A00,199228,Man; Simeon S,0,0,9,9
1683672275012,ETHN 109,A00,185711,Staff,15,0,35,20
1683672276038,ETHN 142,A00,185726,Staff,0,4,30,30
1683672277065,ETHN 163J,A00,199229,Man; Simeon S,5,0,8,3
1683672278093,ETHN 168,A00,185727,Staff,7,0,10,3
1683672279116,ETHN 182,A00,185728,Staff,0,0,35,35
1683672280144,ETHN 183,A00,185737,Staff,9,0,18,9
1683672281167,GLBH 111,A01,209361,Burgos; Jose L.,0,0,0,0
1683672283220,HIEU 104,A00,185792,Staff,14,0,20,6
1683672284246,HIEU 115,A00,185800,Staff,0,0,20,20
1683672285270,HIEU 128,A00,185801,Staff,0,9,20,20
1683672286306,HIEU 147,A00,185802,Staff,15,0,20,5
1683672287330,HIEU 154,A00,185823,Staff,11,0,20,9
1683672288354,HILA 102,A00,185826,Staff,14,0,20,6
1683672289380,HILD 2C,A01,185778,Staff,0,13,20,20
1683672290403,HILD 7B,A01,185780,Kwak; Nancy,0,17,32,32
1683672290403,HILD 7B,A02,185781,Kwak; Nancy,0,18,32,32
1683672291427,HILD 30,A01,185791,Staff,12,0,20,8
1683672292450,HISC 119,A00,185830,Golan; Tal,0,9,20,20
1683672293473,HITO 156GS,A00,185831,Patterson; Patrick H.,0,0,0,23
1683672294499,HIUS 103,A00,185832,Man; Simeon S,0,4,20,20
1683672295523,HIUS 117,A00,185836,Kwak; Nancy,2,0,20,18
1683672296548,HIUS 125,A00,185840,Man; Simeon S,0,2,23,23
1683672297571,HIUS 149,A00,185845,Staff,1,0,20,19
1683672298595,HUM 3,A01,185882,Zavodny; Tatiana Sophia,0,8,50,50
1683672298595,HUM 3,B01,185899,Caldwell; Michael Alan,0,18,50,50
1683672299619,HUM 3GS,A00,185900,Patterson; Patrick H.,0,0,0,23
1683672300642,HUM 4,A01,185938,Zroka; Amy Liane,29,0,50,21
1683672300642,HUM 4,B01,185956,Watkins; Eric,0,5,50,50
1683672300642,HUM 4,B02,202209,Watkins; Eric,0,5,50,50
1683672300642,HUM 4,B03,202210,Watkins; Eric,0,5,50,50
1683672301681,HUM 5,A01,185958,West; Geoffrey Scott,0,0,50,50
1683672301681,HUM 5,A02,202215,West; Geoffrey Scott,0,0,50,50
1683672302710,INTL 190,A00,185959,Gagnon; Jeffrey C,0,0,0,9
1683672302710,INTL 190,B00,185960,Lettieri; Michael Joseph,0,0,0,2
1683672303734,JAPN 180,A00,254509,Staff,5,0,30,25
1683672304758,LATI 10,A01,202853,Kennemore; Amy Michelle,4,0,35,31
1683672304758,LATI 10,A02,202854,Kennemore; Amy Michelle,2,0,35,33
1683672304758,LATI 10,A03,270054,Kennemore; Amy Michelle,30,0,30,0
1683672305781,LATI 180,A00,202855,Kennemore; Amy Michelle,11,0,20,9
1683672306805,LAWS 101,A00,201767,Golan; Tal,0,7,40,40
1683672307827,LIFR 1C,A00,185961,Staff,6,0,20,14
1683672308857,LIFR 1CX,A00,185962,Staff,7,0,20,13
1683672309885,LIFR 1D,A00,185963,Staff,7,0,20,13
1683672310911,LIFR 1DX,A00,185964,Staff,7,0,20,13
1683672311937,LIGN 101,A01,186039,Staff,43,0,50,7
1683672312961,LIGN 165,A00,186040,Staff,15,0,50,35
1683672313985,LTCS 108,A00,186041,Staff,5,0,10,5
1683672315008,LTCS 119,A00,186042,Staff,15,0,20,5
1683672316036,LTCS 130,A00,186043,Wesling; Megan E.,15,0,25,10
1683672318084,LTEA 138,A00,186119,Staff,14,0,40,26
1683672319108,LTEN 124,A00,186148,Staff,5,0,25,20
1683672320134,LTEN 178,A00,186149,Staff,7,0,15,8
1683672321159,LTEN 181,A00,186150,Blanco; John D,34,0,40,6
1683672322181,LTWL 120,A00,186160,Staff,19,0,25,6
1683672323205,LTWL 165,A00,186161,Staff,22,0,25,3
1683672324233,LTWR 100,A00,186162,Staff,0,5,15,15
1683672325257,LTWR 102,A00,186163,Doller; Ben,5,0,15,10
1683672326281,MAE 8,A01,186412,Staff,0,0,0,0
1683672327307,MAE 30B,A00,186445,Bahadori; Mohammad Yousef,82,0,100,18
1683672328333,MAE 40,A00,186592,Bewley; Thomas R,10,0,50,40
1683672329358,MAE 101B,A00,186593,Bahadori; Mohammad Yousef,80,0,100,20
1683672330390,MAE 105,A00,186594,Bandaru; Prabhakar,10,0,50,40
1683672331415,MAE 107,A00,186599,Pham; Hieu Tan,0,7,120,120
1683672332446,MAE 148,A01,186660,Silberman; Jack,3,0,16,13
1683672333473,MATH 10A,A01,188095,Staff,0,6,35,35
1683672334556,MATH 10B,A01,188097,Bowers; Adam R.,0,12,30,30
1683672334556,MATH 10B,A02,188099,Bowers; Adam R.,0,11,30,30
1683672334556,MATH 10B,B01,188104,Bowers; Adam R.,0,10,30,30
1683672334556,MATH 10B,B02,188106,Bowers; Adam R.,1,9,30,29
1683672335582,MATH 10C,A01,188111,Staff,0,20,30,30
1683672335582,MATH 10C,A02,188127,Staff,0,19,30,30
1683672335582,MATH 10C,A03,188131,Staff,0,19,30,30
1683672335582,MATH 10C,B01,188218,Staff,17,0,30,13
1683672335582,MATH 10C,B02,188244,Staff,13,0,30,17
1683672335582,MATH 10C,B03,188277,Staff,14,0,30,16
1683672336607,MATH 18,A01,188344,Bach; Quang Tran,18,0,30,12
1683672336607,MATH 18,A02,188345,Bach; Quang Tran,11,0,30,19
1683672336607,MATH 18,B01,188353,Bach; Quang Tran,11,0,30,19
1683672336607,MATH 18,B02,188354,Bach; Quang Tran,19,0,30,11
1683672337633,MATH 20A,A01,188374,Staff,11,0,35,24
1683672338657,MATH 20B,A01,188382,Ohm; Ko Woon,7,0,30,23
1683672338657,MATH 20B,A02,188383,Ohm; Ko Woon,22,0,30,8
1683672338657,MATH 20B,B01,188385,Ohm; Ko Woon,7,0,30,23
1683672338657,MATH 20B,B02,188392,Ohm; Ko Woon,22,0,30,8
1683672339686,MATH 20C,A01,188394,Harel; Guershon,10,0,30,20
1683672339686,MATH 20C,A02,188395,Harel; Guershon,13,0,30,17
1683672339686,MATH 20C,B01,188404,Harel; Guershon,5,0,30,25
1683672339686,MATH 20C,B02,188405,Harel; Guershon,18,0,30,12
1683672340716,MATH 20D,A01,188414,Hammock; Frances H,0,1,30,30
1683672340716,MATH 20D,A02,188415,Hammock; Frances H,0,1,30,30
1683672340716,MATH 20D,B01,188447,Hammock; Frances H,0,1,30,30
1683672340716,MATH 20D,B02,188486,Hammock; Frances H,3,0,30,27
1683672341746,MATH 20E,A01,188649,Staff,21,0,30,9
1683672341746,MATH 20E,A02,188650,Staff,20,0,30,10
1683672341746,MATH 20E,A03,188673,Staff,0,0,30,30
1683672342776,MATH 102,A01,188675,Staff,0,37,35,35
1683672343804,MATH 103B,A01,188681,Staff,3,0,35,32
1683672343804,MATH 103B,B01,188692,Staff,5,0,35,30
1683672344829,MATH 109,A01,188695,Salehi Golsefidy; Alireza,24,0,35,11
1683672344829,MATH 109,A02,188696,Salehi Golsefidy; Alireza,25,0,35,10
1683672345854,MATH 120A,A01,188698,Eggers; John Dietrich,7,0,35,28
1683672346878,MATH 142B,A01,188736,Ioana; Adrian,1,1,30,29
1683672346878,MATH 142B,A02,188741,Ioana; Adrian,0,1,30,30
1683672346878,MATH 142B,A03,188743,Ioana; Adrian,0,1,30,30
1683672347904,MATH 168A,A01,188790,Staff,0,11,35,35
1683672348931,MATH 170A,A01,188803,Nie; Jiawang,0,2,35,35
1683672348931,MATH 170A,A02,188811,Nie; Jiawang,0,0,35,35
1683672348931,MATH 170A,A03,188814,Nie; Jiawang,0,0,35,35
1683672348931,MATH 170A,A04,188815,Nie; Jiawang,6,0,35,29
1683672349955,MATH 193B,A01,188817,Staff,0,0,35,35
1683672349955,MATH 193B,A02,188818,Staff,5,0,35,30
1683672350982,MGT 4,A01,202857,Anderson; John Charles,60,0,80,20
1683672352010,MGT 12,A00,202858,Lindenberger; Wade Douglas,40,0,90,50
1683672353035,MGT 18,A00,202859,Staff,74,0,90,16
1683672354062,MGT 18GS,A00,202860,McKay; Michael J,13,0,28,15
1683672355087,MGT 45,A00,202861,Pecore; Joseph P.,10,0,90,80
1683672356112,MGT 100,A00,202863,Yavorsky; Daniel Ryan,28,0,90,62
1683672357137,MGT 103,A00,202864,Ehrich; Kristine R,0,18,90,90
1683672358161,MGT 112,A00,202865,Ehrich; Kristine R,15,0,90,75
1683672359186,MGT 121A,A00,202868,Staff,90,20,90,0
1683672360211,MGT 131B,A00,202869,Anderson; John Charles,59,0,90,31
1683672361236,MGT 136,A00,202871,Lindenberger; Wade Douglas,83,0,90,7
1683672362264,MGT 164,A00,202873,Staff,0,67,90,91
1683672363288,MGT 164GS,A00,202874,McKay; Mary A,13,0,28,15
1683672364315,MGT 180,A00,202875,Staff,0,51,90,91
1683672365343,MMW 11R,A01,205019,Herbst; Matthew,0,0,30,30
1683672365343,MMW 11R,A02,205026,Herbst; Matthew,29,0,30,1
1683672366372,MMW 15,A01,193512,Chang; Edmond Yi-Teh,0,8,28,28
1683672366372,MMW 15,A02,193513,Chang; Edmond Yi-Teh,0,5,28,28
1683672366372,MMW 15,A03,193514,Chang; Edmond Yi-Teh,0,5,28,28
1683672366372,MMW 15,A04,193515,Chang; Edmond Yi-Teh,0,5,28,28
1683672366372,MMW 15,A05,193516,Chang; Edmond Yi-Teh,0,5,28,28
1683672366372,MMW 15,A06,193517,Chang; Edmond Yi-Teh,0,6,28,28
1683672366372,MMW 15,B01,193519,Chang; Edmond Yi-Teh,0,5,28,28
1683672366372,MMW 15,B02,193520,Chang; Edmond Yi-Teh,0,5,28,28
1683672366372,MMW 15,B03,193521,Chang; Edmond Yi-Teh,0,5,28,28
1683672366372,MMW 15,B04,193522,Chang; Edmond Yi-Teh,0,5,28,28
1683672366372,MMW 15,B05,193523,Chang; Edmond Yi-Teh,0,5,28,28
1683672366372,MMW 15,B06,193524,Chang; Edmond Yi-Teh,0,5,28,28
1683672367399,MMW 122,A01,193526,Rahimi; Babak,0,16,28,28
1683672367399,MMW 122,A02,193527,Rahimi; Babak,0,15,28,28
1683672367399,MMW 122,A03,193528,Rahimi; Babak,0,0,0,0
1683672367399,MMW 122,A04,193529,Rahimi; Babak,0,0,0,0
1683672368425,MUS 1A,A01,186663,Staff,1,19,35,34
1683672369451,MUS 4,A01,186715,Staff,0,12,35,35
1683672370479,MUS 5R,A01,186796,Dubnov; Shlomo,0,17,35,35
1683672371504,MUS 6,A01,186798,Staff,0,5,25,25
1683672372529,MUS 7,A01,186830,Staff,11,0,35,24
1683672373553,MUS 8,A01,186930,Staff,0,27,35,35
1683672374590,MUS 15,A01,186932,Staff,0,15,35,35
1683672374590,MUS 15,B01,186934,Staff,1,17,35,34
1683672375618,MUS 80,A00,186935,Staff,0,0,20,20
1683672375618,MUS 80,B00,186936,Staff,24,0,25,1
1683672376646,NANO 11,A00,204702,Lipomi; Darren John,0,0,0,0
1683672377673,NANO 15,A01,204709,Yang; Kesong,0,1,0,0
1683672378702,NANO 114,A00,202069,Jahed Motlagh; Zeinab,3,0,10,7
1683672379728,PHIL 1,A00,186955,Grush; Rick Scott,31,0,40,9
1683672380753,PHIL 10,A01,186973,Grush; Rick Scott,27,0,35,8
1683672380753,PHIL 10,A02,186974,Grush; Rick Scott,33,0,35,2
1683672381777,PHIL 13,A01,186976,Staff,3,0,35,32
1683672381777,PHIL 13,A02,186977,Staff,16,0,35,19
1683672382801,PHIL 14,A01,186979,Staff,31,0,35,4
1683672382801,PHIL 14,A02,186986,Staff,32,0,35,3
1683672383829,PHIL 28,A01,186988,Staff,16,0,30,14
1683672383829,PHIL 28,A02,186989,Staff,1,0,30,29
1683672383829,PHIL 28,A03,186990,Staff,10,0,30,20
1683672383829,PHIL 28,A04,186991,Staff,26,0,30,4
1683672384855,PHIL 120,A00,186997,Staff,23,0,40,17
1683672385880,PHIL 137,A00,187003,Staff,7,0,40,33
1683672386908,PHIL 150,A00,187015,Staff,47,0,70,23
1683672387932,PHIL 167,A00,187021,Lamey; Andy M.,34,0,40,6
1683672388957,PHIL 174,A01,202226,Staff,17,0,20,3
1683672388957,PHIL 174,A02,202235,Staff,20,0,20,0
1683672389980,PHIL 191A,A00,258918,Staff,0,0,1,1
1683672391006,PHYS 1A,A00,187028,Staff,26,0,60,34
1683672392031,PHYS 1AL,001,187036,Staff,3,0,30,27
1683672392031,PHYS 1AL,002,187049,Staff,18,0,30,12
1683672393058,PHYS 1B,A00,187058,Staff,22,0,60,38
1683672394085,PHYS 1BL,001,187064,Staff,0,1,30,30
1683672394085,PHYS 1BL,002,187070,Staff,4,0,30,26
1683672395111,PHYS 1C,A00,187082,Staff,29,0,120,91
1683672396138,PHYS 1CL,001,187088,Staff,0,9,30,30
1683672396138,PHYS 1CL,002,187089,Staff,0,1,30,30
1683672396138,PHYS 1CL,009,262693,Staff,9,0,30,21
1683672397165,PHYS 2B,A01,187097,Staff,55,0,115,60
1683672398190,PHYS 2C,A01,187099,Staff,63,0,115,52
1683672399215,PHYS 2CL,A01,187101,Staff,5,0,28,23
1683672399215,PHYS 2CL,A02,187102,Staff,15,0,28,13
1683672400243,PHYS 2D,A01,187123,Shotwell; Brian,95,0,115,20
1683672401269,PHYS 4B,A01,187133,Grinstein; Benjamin,35,0,50,15
1683672402293,POLI 10,A00,188819,Staff,0,4,50,50
1683672403316,POLI 11,A00,188827,Staff,43,0,50,7
1683672404341,POLI 13R,A00,188828,Staff,0,1,20,20
1683672405366,POLI 27,A01,188830,Elgin; Samuel Zincke,0,2,70,70
1683672406394,POLI 30,A00,188832,Desposato; Scott,30,0,50,20
1683672407420,POLI 102F,A00,188834,Staff,0,0,40,40
1683672408446,POLI 104A,A00,188852,Staff,13,0,30,17
1683672409473,POLI 104I,A00,188853,Staff,0,7,20,20
1683672410498,POLI 110B,A00,188854,Wiens; David,6,0,20,14
1683672411525,POLI 112A,A00,188855,Wiens; David,3,0,30,27
1683672412549,POLI 117R,A00,188856,Forman; Fonna,0,12,20,20
1683672413576,POLI 118,A00,188857,Ingham; Sean,8,0,20,12
1683672414601,POLI 120G,A00,188858,Staff,8,0,30,22
1683672415635,POLI 131CR,A00,188863,Hoston; Germaine,20,0,50,30
1683672416659,POLI 133,A00,188864,Nellis; Gareth Hb,44,0,50,6
1683672417683,POLI 134D,A00,188865,Desposato; Scott,27,0,30,3
1683672418710,POLI 142A,A00,188871,Gartzke; Erik,21,0,50,29
1683672419737,POLI 142K,A00,188874,Staff,38,0,50,12
1683672420763,POLI 143,A00,188940,Gartzke; Erik,16,0,30,14
1683672421788,POLI 153,A00,188943,Staff,2,0,20,18
1683672422816,POLI 160AA,A00,188944,Staff,11,0,40,29
1683672423842,POLI 170A,A00,188945,Staff,10,0,30,20
1683672425892,PSYC 1,A00,188952,Staff,37,0,90,53
1683672426916,PSYC 2,B00,188953,Staff,19,0,35,16
1683672427943,PSYC 6,A00,188970,Staff,47,0,60,13
1683672428970,PSYC 7,A00,188973,Staff,35,0,45,10
1683672430000,PSYC 60,A01,188980,Rickard; Timothy C.,42,0,60,18
1683672431030,PSYC 70,A01,189001,Steiner; Eric Tomas,22,0,45,23
1683672432056,PSYC 100,A00,189005,Lacefield; Katharine I,0,99,120,120
1683672433081,PSYC 102,A00,189008,Staff,8,0,30,22
1683672434109,PSYC 106,B00,189026,Gorman; Michael R.,27,0,60,33
1683672435137,PSYC 114,B01,189033,Winkielman; Piotr,0,31,30,30
1683672436165,PSYC 131,A00,189036,Anagnostaras; Stephan,0,43,60,60
1683672437192,PSYC 136,A00,189041,Lowe; Angela Beth,0,7,25,25
1683672438273,PSYC 137,A00,189057,Winkielman; Piotr,1,37,25,24
1683672439301,PSYC 144,A00,189107,Wixted; John T,0,11,50,50
1683672441349,PSYC 162,A00,189142,Staff,0,9,85,85
1683672442377,PSYC 172,A00,189144,Gorman; Michael R.,0,6,30,30
1683672444425,PSYC 179,A00,189146,Lacefield; Katharine I,0,87,120,120
1683672445450,PSYC 181,A00,189147,Anagnostaras; Stephan,0,44,90,90
1683672446477,PSYC 190R,A00,189148,Barner; David A.,0,23,80,80
1683672447503,PSYC 191,A00,189275,Rickard; Timothy C.,0,10,25,25
1683672448542,PSYC 193,A00,189276,Chapman; Eddie Nathaniel,0,1,0,4
1683672449573,PSYC 193L,A01,189281,Lowe; Angela Beth,9,0,20,11
1683672449573,PSYC 193L,B01,189285,Staff,28,0,35,7
1683672450600,RELI 149,A00,187137,Rahimi; Babak,7,0,40,33
1683672451624,SE 9,A01,187315,Staff,0,2,18,18
1683672452652,SE 101B,A00,187409,Staff,24,0,30,6
1683672453680,SE 110B,A00,187444,Staff,10,0,40,30
1683672454705,SE 130B,A00,187449,Staff,31,0,40,9
1683672455732,SE 150A,A00,187516,Staff,8,0,20,12
1683672456755,SE 154,A00,187528,Staff,29,0,50,21
1683672457782,SIO 3,A01,258171,Staff,35,0,40,5
1683672458810,SIO 10,A00,187144,Cook; Geoffrey W,0,7,75,75
1683672459834,SIO 45,A00,187152,Cook; Geoffrey W,0,6,100,100
1683672460858,SIO 109R,A00,194486,Staff,0,4,20,20
1683672462907,SIO 187,A01,187233,Kacev; David,12,0,40,28
1683672463939,SOCI 1,A01,258656,Thorpe; Charles Robert,28,0,30,2
1683672463939,SOCI 1,A02,258658,Thorpe; Charles Robert,30,0,30,0
1683672463939,SOCI 1,A03,258661,Thorpe; Charles Robert,25,0,25,0
1683672463939,SOCI 1,A04,258666,Thorpe; Charles Robert,22,0,25,3
1683672463939,SOCI 1,A05,258897,Thorpe; Charles Robert,22,0,25,3
1683672463939,SOCI 1,A06,258898,Thorpe; Charles Robert,25,0,25,0
1683672464963,SOCI 30,A01,258903,Pardo Guerra; Juan Pablo,14,0,30,16
1683672465991,SOCI 102,A00,258904,Staff,9,0,25,16
1683672467015,SOCI 106,A00,258905,Staff,19,0,25,6
1683672468043,SOCI 111,A00,258907,Ribas Norris; Janet Vanesa,26,0,30,4
1683672469069,SOCI 121R,A00,258908,Pardo Guerra; Juan Pablo,8,0,30,22
1683672470096,SOCI 126,A01,203330,Staff,14,0,20,6
1683672471121,SOCI 131,A00,258909,Thorpe; Charles Robert,30,0,60,30
1683672472145,SOCI 135,A00,258910,Payne; Christine Anna,0,11,30,30
1683672473170,SOCI 157,A00,258911,Staff,11,0,30,19
1683672474193,SOCI 184,A00,258912,Staff,25,0,30,5
1683672475216,SOCI 188D,A00,258913,Staff,22,0,30,8
1683672476244,SYN 2,001,187529,Staff,9,0,16,7
1683672476244,SYN 2,002,201452,Staff,0,20,16,16
1683672476244,SYN 2,003,201469,Staff,1,0,16,15
1683672477266,SYN 100,A01,187531,Staff,0,9,20,20
1683672477266,SYN 100,B01,201491,Staff,0,10,20,20
1683672478290,TDAC 1,A00,189286,Walsh; Kim C.,3,0,20,17
1683672478290,TDAC 1,B00,189287,Harting; Carla Kelso,10,0,20,10
1683672479316,TDAC 101,A00,189300,Walsh; Kim C.,16,0,20,4
1683672479316,TDAC 101,B00,189301,Harting; Carla Kelso,18,0,20,2
1683672480343,TDAC 102,A00,189304,Basso; Beatrice,14,0,20,6
1683672481370,TDAC 108,A00,189305,Staff,18,0,20,2
1683672482395,TDDE 131,A00,189310,Staff,19,0,20,1
1683672482395,TDDE 131,B00,189314,Staff,19,0,20,1
1683672482395,TDDE 131,C00,189315,Staff,48,0,50,2
1683672482395,TDDE 131,D00,189316,Staff,14,0,15,1
1683672482395,TDDE 131,E00,204841,Staff,20,0,20,0
1683672483420,TDGE 10,A00,189289,Staff,27,0,50,23
1683672483420,TDGE 10,B00,189290,Havis; Allan,0,1,50,50
1683672484445,TDGE 11,A00,189291,Fulton; Julia,0,4,50,50
1683672484445,TDGE 11,B00,189292,Staff,20,0,25,5
1683672484445,TDGE 11,C00,260270,Staff,0,0,0,0
1683672485469,TDGE 25,A00,189294,Staff,2,0,20,18
1683672486497,TDGE 124,A00,189318,Fulton; Julia,0,8,50,50
1683672487526,TDGE 125,A00,189319,Staff,13,0,25,12
1683672487526,TDGE 125,B00,189320,Staff,23,0,25,2
1683672488551,TDGE 127,A00,189322,Havis; Allan,0,0,50,50
1683672489580,TDHT 101,A00,189323,Staff,18,0,25,7
1683672489580,TDHT 101,B00,189324,Staff,25,0,25,0
1683672490607,TDHT 102,A00,189325,Staff,49,0,50,1
1683672491640,TDMV 1,A00,189295,Arcidiacono; Kristin,20,0,30,10
1683672491640,TDMV 1,B00,189296,Caligagan; Maria T.,24,0,30,6
1683672492666,TDMV 2,A00,189297,Sammartano; Tonnie,27,0,30,3
1683672492666,TDMV 2,B00,189299,Arcidiacono; Kristin,23,0,30,7
1683672493690,TDMV 3,A00,204998,Rincon; Alicia,22,0,30,8
1683672494715,TDMV 120,A00,189458,Sammartano; Tonnie,28,0,30,2
1683672495745,TDMV 138,A00,189541,Jun; Grace Shin Hae,20,0,40,20
1683672496769,TDMV 142,A00,189717,Caligagan; Tony,25,0,30,5
1683672496769,TDMV 142,B00,189718,Caligagan; Maria T.,25,0,30,5
1683672497798,TMC 2,A01,187533,Staff,25,0,25,0
1683672497798,TMC 2,A02,187534,Staff,25,0,25,0
1683672498826,USP 1,A01,187536,Kwak; Nancy,0,16,25,25
1683672499851,USP 5,A01,187538,Staff,9,0,25,16
1683672500879,USP 101,A00,199253,Staff,0,4,0,0
1683672501905,USP 124,A00,187562,Boomhower; Matthew Charles,0,0,30,30
1683672502932,USP 138,A00,187582,Staff,19,0,25,6
1683672503958,USP 152,A01,187597,Staff,3,0,25,22
1683672504982,USP 153,A00,187598,Staff,19,0,25,6
1683672506007,USP 168,A00,187607,Kwak; Nancy,2,0,5,3
1683672507032,USP 173,A00,187619,Staff,4,0,25,21
1683672508055,USP 181,A00,187638,Staff,0,4,25,25
1683672509084,VIS 103,A00,187650,Cruz; Edwin Teddy,17,0,75,58
1683672510111,VIS 110D,A00,187669,Staff,13,0,22,9
1683672511137,VIS 127C,A00,187720,Shen; Kuiyi,67,0,146,79
1683672512162,VIS 149,A00,187731,Yoldas; Pinar,1,14,22,21
1683672513186,VIS 151,A01,188091,Staff,22,0,34,12
1683672513186,VIS 151,A02,188092,Staff,11,0,34,23
1683672514213,VIS 160B,A00,188093,Stalbaum; Brett,0,1,10,10
1683672516282,WCWP 10B,A00,201720,Staff,10,0,15,5
1683672516282,WCWP 10B,B00,201722,Staff,9,0,15,6
1683672517310,WCWP 100,A00,201725,Gagnon; Jeffrey C,0,0,2,2
1683672517310,WCWP 100,B00,201727,Staff,0,4,15,15
1683672520434,ANBI 133,A00,258401,Wilder; Linnea Lorene,34,0,40,6
1683672521462,ANBI 140,A00,258395,Hrvoj Mihic; Branka,18,0,25,7
1683672522489,ANSC 120,A00,258402,Bialecki; Jon Anthony,26,0,40,14
1683672523513,ANSC 144,A00,258400,Staff,12,0,40,28
1683672525563,ANSC 166,A00,258396,Parish; Steven Martin,156,0,175,19
1683672526588,ANSC 180,A00,193533,Staff,8,0,20,12
1683672527615,ANSC 188,A00,258397,Jassal; Aftab,34,0,40,6
1683672528641,ANTH 3,A01,258316,Staff,23,0,30,7
1683672529664,ANTH 5,A00,258394,Semendeferi; Ekaterini,16,0,20,4
1683672530704,ANTH 21,A01,258331,Staff,4,0,40,36
1683672531741,ANTH 103,A00,258398,Varma; Saiba,15,0,25,10
1683672532768,AWP 10,001,202034,Staff,0,0,0,0
1683672532768,AWP 10,002,202035,Staff,0,0,0,0
1683672532768,AWP 10,003,202036,Staff,0,0,0,0
1683672532768,AWP 10,004,202037,Staff,0,0,0,0
1683672532768,AWP 10,005,202038,Staff,0,0,0,0
1683672532768,AWP 10,006,202039,Staff,0,0,0,0
1683672532768,AWP 10,007,202040,Staff,0,0,0,0
1683672532768,AWP 10,008,202041,Staff,0,0,0,0
1683672532768,AWP 10,009,202042,Staff,0,0,0,0
1683672532768,AWP 10,010,202043,Staff,0,0,0,0
1683672532768,AWP 10,011,202044,Staff,0,0,0,0
1683672532768,AWP 10,012,202045,Staff,0,0,0,0
1683672532768,AWP 10,013,202046,Staff,0,0,0,0
1683672532768,AWP 10,014,202047,Staff,0,0,0,0
1683672532768,AWP 10,015,202048,Staff,0,0,0,0
1683672532768,AWP 10,016,202049,Staff,0,0,0,0
1683672532768,AWP 10,017,202050,Staff,0,0,0,0
1683672532768,AWP 10,018,202051,Staff,0,0,0,0
1683672532768,AWP 10,019,202052,Staff,0,0,0,0
1683672532768,AWP 10,020,202053,Staff,0,0,0,0
1683672532768,AWP 10,021,202054,Staff,0,0,0,0
1683672532768,AWP 10,022,202055,Staff,0,0,0,0
1683672532768,AWP 10,023,202056,Staff,0,0,0,0
1683672532768,AWP 10,024,202057,Staff,0,0,0,0
1683672532768,AWP 10,025,202058,Staff,0,0,0,0
1683672532768,AWP 10,026,202059,Staff,0,0,0,0
1683672533796,AWP 102,001,202032,Staff,0,0,0,0
1683672533796,AWP 102,002,202033,Staff,0,0,0,0
1683672534820,BENG 100,A01,254234,Taylor Amos; Alyssa C,31,0,40,9
1683672535848,BENG 196,001,270013,Engler; Adam J.,9999,0,9999,0
1683672536878,BICD 100R,A01,202018,Smith; Laurie,0,7,32,32
1683672536878,BICD 100R,A02,202019,Smith; Laurie,0,3,32,32
1683672536878,BICD 100R,A03,202020,Smith; Laurie,0,1,32,32
1683672536878,BICD 100R,A04,202021,Smith; Laurie,6,0,32,26
1683672536878,BICD 100R,A05,202022,Smith; Laurie,11,0,32,21
1683672537903,BICD 136,A01,193242,Gustafson-Brown; Cindy,0,2,32,32
1683672537903,BICD 136,A02,193244,Gustafson-Brown; Cindy,13,0,32,19
1683672538928,BIEB 102,A01,193249,Butler; Shannon Rhey,1,2,32,31
1683672538928,BIEB 102,A02,193251,Butler; Shannon Rhey,0,0,32,32
1683672538928,BIEB 102,A03,193253,Butler; Shannon Rhey,0,0,32,32
1683672538928,BIEB 102,A04,193255,Butler; Shannon Rhey,13,0,32,19
1683672538928,BIEB 102,A05,193265,Butler; Shannon Rhey,25,0,32,7
1683672538928,BIEB 102,A06,193269,Butler; Shannon Rhey,14,0,32,18
1683672540978,BIEB 150,A01,193274,Staff,0,0,32,32
1683672540978,BIEB 150,A02,193285,Staff,24,0,32,8
1683672542083,BIEB 194,A00,193286,Kurle; Carolyn M.,20,0,32,12
1683672543108,BILD 1,A01,192291,Staff,15,0,32,17
1683672543108,BILD 1,A02,192292,Staff,30,0,32,2
1683672543108,BILD 1,B01,192520,Reuther; Keefe,0,1,0,0
1683672543108,BILD 1,B02,192532,Reuther; Keefe,0,1,0,0
1683672544141,BILD 3,A01,192556,Butler; Shannon Rhey,0,0,32,32
1683672544141,BILD 3,A02,192581,Butler; Shannon Rhey,0,1,32,32
1683672544141,BILD 3,A03,192611,Butler; Shannon Rhey,20,0,32,12
1683672544141,BILD 3,A04,192612,Butler; Shannon Rhey,24,0,32,8
1683672544141,BILD 3,A05,192613,Butler; Shannon Rhey,26,0,32,6
1683672544141,BILD 3,A06,192679,Butler; Shannon Rhey,27,0,32,5
1683672544141,BILD 3,A07,192682,Butler; Shannon Rhey,20,0,32,12
1683672545170,BILD 4,A01,192836,Reuther; Keefe,1,0,24,23
1683672545170,BILD 4,A02,193044,Reuther; Keefe,4,0,24,20
1683672546195,BILD 10,A01,193142,Gustafson-Brown; Cindy,29,0,32,3
1683672546195,BILD 10,A02,193149,Gustafson-Brown; Cindy,31,0,32,1
1683672547219,BIMM 100,A01,193301,Staff,0,6,32,32
1683672547219,BIMM 100,A02,193312,Staff,0,7,32,32
1683672547219,BIMM 100,A03,193323,Staff,0,10,32,32
1683672548244,BIMM 101,A01,193329,McDonnell; Lisa Marie,1,4,24,23
1683672548244,BIMM 101,A02,193339,McDonnell; Lisa Marie,1,4,24,23
1683672548244,BIMM 101,B01,193354,McDonnell; Lisa Marie,0,4,24,24
1683672548244,BIMM 101,B02,193357,McDonnell; Lisa Marie,0,3,24,24
1683672549268,BIMM 110,A01,193377,Tat; John,0,11,32,32
1683672549268,BIMM 110,A02,193378,Tat; John,0,10,32,32
1683672550291,BIMM 120,A01,206116,Staff,0,0,32,32
1683672550291,BIMM 120,A02,206117,Staff,7,0,32,25
1683672550291,BIMM 120,A03,206121,Staff,21,0,32,11
1683672551316,BIPN 100,A01,193393,Park; Ji Young,0,15,32,32
1683672551316,BIPN 100,A02,193402,Park; Ji Young,0,14,32,32
1683672551316,BIPN 100,A03,193413,Park; Ji Young,0,14,32,32
1683672551316,BIPN 100,A04,193414,Park; Ji Young,0,13,32,32
1683672552341,BIPN 102,A01,193429,Staff,0,0,32,32
1683672552341,BIPN 102,A02,193438,Staff,18,0,32,14
1683672553369,BIPN 106,A01,193450,Reyes Gonzalez; Catalina,0,2,40,40
1683672554394,BIPN 134,A01,193465,Cooke; James Edward,0,0,32,32
1683672554394,BIPN 134,A02,193474,Cooke; James Edward,25,0,32,7
1683672554394,BIPN 134,A03,193485,Cooke; James Edward,29,0,32,3
1683672554394,BIPN 134,A04,193486,Cooke; James Edward,20,0,32,12
1683672554394,BIPN 134,A05,193491,Cooke; James Edward,31,0,32,1
1683672554394,BIPN 134,A06,193501,Cooke; James Edward,30,0,32,2
1683672554394,BIPN 134,A07,193510,Cooke; James Edward,29,0,32,3
1683672556446,BISP 194,A00,222522,Staff,14,0,32,18
1683672557470,CAT 124,A01,202407,Staff,19,0,25,6
1683672558496,CAT 125,A00,202408,Marchisotto; Jennifer Anne,2,0,20,18
1683672559525,CAT 125R,A00,202409,Smith; Lauryn Alissa,0,11,20,20
1683672559525,CAT 125R,B00,202410,Morales; Celeste Georgianna,0,11,20,20
1683672559525,CAT 125R,C00,202411,Irwin; Matthew Joseph,0,12,20,20
1683672560551,CENG 15,A01,204712,Yang; Kesong,0,1,0,0
1683672561582,CENG 114,A00,202070,Jahed Motlagh; Zeinab,5,0,20,15
1683672562608,CGS 105,A00,185477,Wesling; Megan E.,24,0,40,16
1683672563634,CGS 106,A00,185494,Staff,11,0,22,11
1683672564658,CGS 108,A00,185495,Staff,14,0,20,6
1683672565682,CGS 114,A00,185496,Staff,13,0,18,5
1683672566707,CGS 119,A00,185501,Staff,15,0,20,5
1683672567735,CGS 120,A00,185511,Staff,12,0,20,8
1683672568764,CHEM 4,A01,184675,Bussey; Thomas J,97,0,100,3
1683672569792,CHEM 6A,A01,184677,Staff,32,0,60,28
1683672570815,CHEM 6B,A01,184679,Staff,63,0,100,37
1683672571844,CHEM 6C,A01,184681,Bussey; Thomas J,0,0,50,50
1683672571844,CHEM 6C,A02,184682,Bussey; Thomas J,32,0,50,18
1683672572869,CHEM 40A,A01,184684,Albizati; Kim F.,33,0,100,67
1683672573894,CHEM 40B,A01,184686,Albizati; Kim F.,0,22,100,100
1683672574918,CHEM 41B,A01,184690,Staff,51,0,100,49
1683672575942,COGS 3,A01,184715,Boyle; Mary E. T.,0,27,40,40
1683672576972,COGS 14B,A01,185172,Staff,0,14,38,38
1683672577996,COGS 18,A01,184736,Staff,14,0,80,66
1683672579021,COGS 100,A01,184932,Staff,0,8,73,73
1683672580047,COGS 101A,A01,184935,Staff,0,40,30,30
1683672581071,COGS 101B,A01,184944,Staff,0,2,30,30
1683672582095,COGS 101C,A01,184946,Staff,0,10,30,30
1683672583121,COGS 102A,A01,184951,Johnson; Christine M.,2,0,40,38
1683672584146,COGS 107B,A01,184953,Mooshagian; Eric Frederick,0,52,40,40
1683672585170,COGS 118B,A01,184959,Gupta; Anjum,0,50,40,40
1683672586193,COGS 153,A00,184961,Staff,0,16,30,30
1683672587220,COGS 177,A00,184962,Staff,0,21,30,30
1683672588245,COGS 187A,A01,184969,Boyle; Mary E. T.,0,19,40,40
1683672589273,COMM 10,A01,185174,Staff,0,5,25,25
1683672589273,COMM 10,A02,185189,Staff,0,2,25,25
1683672589273,COMM 10,A03,269821,Staff,0,1,0,0
1683672590300,COMM 100B,A01,185475,Staff,0,1,0,1
1683672590300,COMM 100B,A02,185476,Staff,11,0,25,14
1683672591329,COMM 100C,A01,185314,Staff,1,0,25,24
1683672591329,COMM 100C,A02,185327,Staff,17,0,25,8
1683672592352,COMM 110M,A00,185349,Staff,0,0,40,40
1683672593376,COMM 113T,A00,185352,Staff,25,0,40,15
1683672594402,COMM 114I,A00,185353,Staff,31,0,40,9
1683672595427,COMM 131,A00,185354,Staff,17,0,30,13
1683672596450,CSE 8A,A50,185358,Cao; Yingjun,0,46,10,10
1683672597477,CSE 8B,A01,185362,Staff,0,48,50,50
1683672598502,CSE 11,A01,185416,Cao; Yingjun,0,91,10,10
1683672599527,CSE 20,A01,185445,Briones; Jor-el Thomas Caparas,4,0,25,21
1683672600551,CSE 21,A01,185447,Staff,9,0,50,41
1683672601578,CSE 101,A01,185451,Staff,0,13,50,50
1683672601578,CSE 101,B01,185453,Jones; Miles E,0,14,50,50
1683672603633,CSE 141,A01,185458,Eldon; John,16,0,100,84
1683672604662,CSE 141L,A01,185461,Eldon; John,8,0,100,92
1683672605690,CSE 142,A01,185463,Staff,34,0,60,26
1683672605690,CSE 142,B01,201355,Staff,0,7,60,60
1683672606715,CSE 142L,A01,185470,Staff,34,0,60,26
1683672606715,CSE 142L,B01,201417,Staff,0,6,60,60
1683672607738,CSE 190,A00,201433,Staff,32,0,49,17
1683672608766,DOC 1,A01,259136,Strom; Megan C.,7,0,15,8
1683672608766,DOC 1,A02,259137,Strom; Megan C.,14,0,15,1
1683672608766,DOC 1,A03,259138,Strom; Megan C.,14,0,15,1
1683672608766,DOC 1,A04,259139,Strom; Megan C.,14,0,15,1
1683672609790,DOC 100D,A00,259140,Pass; Natalye Joann,14,0,25,11
1683672610818,DSGN 1,A01,184749,Rill; Bryan,0,26,30,30
1683672611844,DSGN 100,A01,185168,Staff,0,2,25,25
1683672612869,ECE 5,A01,185626,Morris; Karcher William,0,12,0,0
1683672613891,ECE 101,A01,185628,Staff,14,0,70,56
1683672614914,ECE 107,A01,185635,Baghdadchi; Saharnaz,0,0,20,20
1683672614914,ECE 107,A02,185638,Baghdadchi; Saharnaz,1,0,20,19
1683672615940,ECE 148,A01,185647,Silberman; Jack,0,0,16,16
1683672616963,ECON 1,A01,185537,Crane; Meredith Helen,54,0,70,16
1683672617991,ECON 3,A01,185549,Crane; Meredith Helen,29,0,70,41
1683672619014,ECON 4,A01,203354,Anderson; John Charles,0,5,10,10
1683672620042,ECON 100A,A01,185574,Staff,0,5,40,40
1683672621065,ECON 100B,A01,185576,Staff,0,12,50,50
1683672622093,ECON 100C,A01,185589,Newhouse; Herbert S,30,0,70,40
1683672623118,ECON 105,A00,185608,Vespa; Emanuel Ignacio,19,0,35,16
1683672624144,ECON 109,A01,185610,Shishkin; Denis,9,0,35,26
1683672625171,ECON 110A,A01,185612,Staff,9,0,40,31
1683672626194,ECON 120A,A01,185615,Staff,19,0,40,21
1683672627223,ECON 120C,A01,185617,Sun; Yixiao,0,21,70,70
1683672628246,ECON 144,A00,203346,Squires; Dale E,2,0,35,33
1683672629275,ECON 171,A01,203349,Newhouse; Herbert S,0,1,35,35
1683672630304,ECON 173A,A01,185621,Toda; Alexis Akira,20,0,35,15
1683672631329,EDS 25,A01,202413,Staff,0,1,0,0
1683672631329,EDS 25,A02,202414,Staff,0,1,0,0
1683672631329,EDS 25,A03,202415,Staff,0,0,0,0
1683672631329,EDS 25,A04,202416,Staff,0,1,0,0
1683672631329,EDS 25,A05,202439,Staff,0,0,0,0
1683672631329,EDS 25,A06,202440,Staff,0,0,0,0
1683672631329,EDS 25,B01,202631,Staff,0,0,0,0
1683672631329,EDS 25,B02,202632,Staff,0,0,0,0
1683672631329,EDS 25,B03,202639,Staff,0,0,0,0
1683672631329,EDS 25,B04,202640,Staff,0,0,0,0
1683672631329,EDS 25,B05,202643,Staff,0,0,0,0
1683672631329,EDS 25,B06,202644,Staff,0,0,0,0
1683672632354,EDS 38,A01,202659,Black; Alison Michelle,24,0,25,1
1683672633378,EDS 115,A00,202652,Staff,18,0,30,12
1683672634404,EDS 125,A00,202649,Staff,13,0,30,17
1683672635429,EDS 126,A01,203332,Staff,30,0,30,0
1683672636455,EDS 139,A00,202838,Staff,16,0,25,9
1683672637479,EDS 146,A01,202655,Staff,14,0,25,11
1683672638505,ENG 15,A00,185667,Staff,0,1,0,0
1683672638505,ENG 15,B00,185672,Staff,0,0,0,0
1683672638505,ENG 15,C00,185675,Staff,0,0,0,0
1683672638505,ENG 15,D00,185682,Staff,0,0,0,0
1683672638505,ENG 15,E00,185684,Staff,0,0,0,0
1683672639530,ETHN 103,A00,185710,Staff,0,8,35,35
1683672640558,ETHN 103A,A00,199228,Man; Simeon S,0,0,9,9
1683672641580,ETHN 109,A00,185711,Staff,15,0,35,20
1683672642606,ETHN 142,A00,185726,Staff,0,4,30,30
1683672643631,ETHN 163J,A00,199229,Man; Simeon S,5,0,8,3
1683672644659,ETHN 168,A00,185727,Staff,7,0,10,3
1683672645742,ETHN 182,A00,185728,Staff,0,0,35,35
1683672646764,ETHN 183,A00,185737,Staff,9,0,18,9
1683672647788,GLBH 111,A01,209361,Burgos; Jose L.,0,0,0,0
1683672649835,HIEU 104,A00,185792,Staff,14,0,20,6
1683672650859,HIEU 115,A00,185800,Staff,0,0,20,20
1683672651886,HIEU 128,A00,185801,Staff,0,9,20,20
1683672652914,HIEU 147,A00,185802,Staff,15,0,20,5
1683672653937,HIEU 154,A00,185823,Staff,11,0,20,9
1683672654962,HILA 102,A00,185826,Staff,14,0,20,6
1683672655985,HILD 2C,A01,185778,Staff,0,13,20,20
1683672657009,HILD 7B,A01,185780,Kwak; Nancy,0,17,32,32
1683672657009,HILD 7B,A02,185781,Kwak; Nancy,0,18,32,32
1683672658033,HILD 30,A01,185791,Staff,12,0,20,8
1683672659058,HISC 119,A00,185830,Golan; Tal,0,9,20,20
1683672660081,HITO 156GS,A00,185831,Patterson; Patrick H.,0,0,0,23
1683672661105,HIUS 103,A00,185832,Man; Simeon S,0,4,20,20
1683672662129,HIUS 117,A00,185836,Kwak; Nancy,2,0,20,18
1683672663157,HIUS 125,A00,185840,Man; Simeon S,0,2,23,23
1683672664184,HIUS 149,A00,185845,Staff,1,0,20,19
1683672665209,HUM 3,A01,185882,Zavodny; Tatiana Sophia,0,8,50,50
1683672665209,HUM 3,B01,185899,Caldwell; Michael Alan,0,18,50,50
1683672666234,HUM 3GS,A00,185900,Patterson; Patrick H.,0,0,0,23
1683672667262,HUM 4,A01,185938,Zroka; Amy Liane,29,0,50,21
1683672667262,HUM 4,B01,185956,Watkins; Eric,0,5,50,50
1683672667262,HUM 4,B02,202209,Watkins; Eric,0,5,50,50
1683672667262,HUM 4,B03,202210,Watkins; Eric,0,5,50,50
1683672668286,HUM 5,A01,185958,West; Geoffrey Scott,0,0,50,50
1683672668286,HUM 5,A02,202215,West; Geoffrey Scott,0,0,50,50
1683672669310,INTL 190,A00,185959,Gagnon; Jeffrey C,0,0,0,9
1683672669310,INTL 190,B00,185960,Lettieri; Michael Joseph,0,0,0,2
1683672670336,JAPN 180,A00,254509,Staff,5,0,30,25
1683672671365,LATI 10,A01,202853,Kennemore; Amy Michelle,4,0,35,31
1683672671365,LATI 10,A02,202854,Kennemore; Amy Michelle,2,0,35,33
1683672671365,LATI 10,A03,270054,Kennemore; Amy Michelle,30,0,30,0
1683672672392,LATI 180,A00,202855,Kennemore; Amy Michelle,11,0,20,9
1683672673415,LAWS 101,A00,201767,Golan; Tal,0,7,40,40
1683672674441,LIFR 1C,A00,185961,Staff,6,0,20,14
1683672675467,LIFR 1CX,A00,185962,Staff,7,0,20,13
1683672676493,LIFR 1D,A00,185963,Staff,7,0,20,13
1683672677517,LIFR 1DX,A00,185964,Staff,7,0,20,13
1683672678543,LIGN 101,A01,186039,Staff,43,0,50,7
1683672679567,LIGN 165,A00,186040,Staff,15,0,50,35
1683672680593,LTCS 108,A00,186041,Staff,5,0,10,5
1683672681617,LTCS 119,A00,186042,Staff,15,0,20,5
1683672682641,LTCS 130,A00,186043,Wesling; Megan E.,15,0,25,10
1683672684689,LTEA 138,A00,186119,Staff,14,0,40,26
1683672685713,LTEN 124,A00,186148,Staff,5,0,25,20
1683672686738,LTEN 178,A00,186149,Staff,7,0,15,8
1683672687764,LTEN 181,A00,186150,Blanco; John D,34,0,40,6
1683672688788,LTWL 120,A00,186160,Staff,19,0,25,6
1683672689815,LTWL 165,A00,186161,Staff,22,0,25,3
1683672690843,LTWR 100,A00,186162,Staff,0,5,15,15
1683672691868,LTWR 102,A00,186163,Doller; Ben,5,0,15,10
1683672692893,MAE 8,A01,186412,Staff,0,0,0,0
1683672693919,MAE 30B,A00,186445,Bahadori; Mohammad Yousef,82,0,100,18
1683672694943,MAE 40,A00,186592,Bewley; Thomas R,10,0,50,40
1683672695967,MAE 101B,A00,186593,Bahadori; Mohammad Yousef,80,0,100,20
1683672696995,MAE 105,A00,186594,Bandaru; Prabhakar,10,0,50,40
1683672698019,MAE 107,A00,186599,Pham; Hieu Tan,0,7,120,120
1683672699046,MAE 148,A01,186660,Silberman; Jack,3,0,16,13
1683672700068,MATH 10A,A01,188095,Staff,0,6,35,35
1683672701093,MATH 10B,A01,188097,Bowers; Adam R.,0,12,30,30
1683672701093,MATH 10B,A02,188099,Bowers; Adam R.,0,11,30,30
1683672701093,MATH 10B,B01,188104,Bowers; Adam R.,0,10,30,30
1683672701093,MATH 10B,B02,188106,Bowers; Adam R.,1,9,30,29
1683672702123,MATH 10C,A01,188111,Staff,0,20,30,30
1683672702123,MATH 10C,A02,188127,Staff,0,19,30,30
1683672702123,MATH 10C,A03,188131,Staff,0,19,30,30
1683672702123,MATH 10C,B01,188218,Staff,17,0,30,13
1683672702123,MATH 10C,B02,188244,Staff,13,0,30,17
1683672702123,MATH 10C,B03,188277,Staff,14,0,30,16
1683672703150,MATH 18,A01,188344,Bach; Quang Tran,18,0,30,12
1683672703150,MATH 18,A02,188345,Bach; Quang Tran,11,0,30,19
1683672703150,MATH 18,B01,188353,Bach; Quang Tran,11,0,30,19
1683672703150,MATH 18,B02,188354,Bach; Quang Tran,19,0,30,11
1683672704174,MATH 20A,A01,188374,Staff,11,0,35,24
1683672705201,MATH 20B,A01,188382,Ohm; Ko Woon,7,0,30,23
1683672705201,MATH 20B,A02,188383,Ohm; Ko Woon,22,0,30,8
1683672705201,MATH 20B,B01,188385,Ohm; Ko Woon,7,0,30,23
1683672705201,MATH 20B,B02,188392,Ohm; Ko Woon,22,0,30,8
1683672706229,MATH 20C,A01,188394,Harel; Guershon,10,0,30,20
1683672706229,MATH 20C,A02,188395,Harel; Guershon,13,0,30,17
1683672706229,MATH 20C,B01,188404,Harel; Guershon,5,0,30,25
1683672706229,MATH 20C,B02,188405,Harel; Guershon,18,0,30,12
1683672707260,MATH 20D,A01,188414,Hammock; Frances H,0,1,30,30
1683672707260,MATH 20D,A02,188415,Hammock; Frances H,0,1,30,30
1683672707260,MATH 20D,B01,188447,Hammock; Frances H,0,1,30,30
1683672707260,MATH 20D,B02,188486,Hammock; Frances H,3,0,30,27
1683672708285,MATH 20E,A01,188649,Staff,21,0,30,9
1683672708285,MATH 20E,A02,188650,Staff,20,0,30,10
1683672708285,MATH 20E,A03,188673,Staff,0,0,30,30
1683672709312,MATH 102,A01,188675,Staff,0,37,35,35
1683672710336,MATH 103B,A01,188681,Staff,3,0,35,32
1683672710336,MATH 103B,B01,188692,Staff,5,0,35,30
1683672711364,MATH 109,A01,188695,Salehi Golsefidy; Alireza,24,0,35,11
1683672711364,MATH 109,A02,188696,Salehi Golsefidy; Alireza,25,0,35,10
1683672712388,MATH 120A,A01,188698,Eggers; John Dietrich,7,0,35,28
1683672713414,MATH 142B,A01,188736,Ioana; Adrian,1,1,30,29
1683672713414,MATH 142B,A02,188741,Ioana; Adrian,0,1,30,30
1683672713414,MATH 142B,A03,188743,Ioana; Adrian,0,1,30,30
1683672714441,MATH 168A,A01,188790,Staff,0,11,35,35
1683672715466,MATH 170A,A01,188803,Nie; Jiawang,0,2,35,35
1683672715466,MATH 170A,A02,188811,Nie; Jiawang,0,0,35,35
1683672715466,MATH 170A,A03,188814,Nie; Jiawang,0,0,35,35
1683672715466,MATH 170A,A04,188815,Nie; Jiawang,6,0,35,29
1683672716495,MATH 193B,A01,188817,Staff,0,0,35,35
1683672716495,MATH 193B,A02,188818,Staff,5,0,35,30
1683672717523,MGT 4,A01,202857,Anderson; John Charles,60,0,80,20
1683672718545,MGT 12,A00,202858,Lindenberger; Wade Douglas,40,0,90,50
1683672719573,MGT 18,A00,202859,Staff,74,0,90,16
1683672720594,MGT 18GS,A00,202860,McKay; Michael J,13,0,28,15
1683672721630,MGT 45,A00,202861,Pecore; Joseph P.,10,0,90,80
1683672722655,MGT 100,A00,202863,Yavorsky; Daniel Ryan,28,0,90,62
1683672723685,MGT 103,A00,202864,Ehrich; Kristine R,0,18,90,90
1683672724709,MGT 112,A00,202865,Ehrich; Kristine R,15,0,90,75
1683672725733,MGT 121A,A00,202868,Staff,90,20,90,0
1683672726757,MGT 131B,A00,202869,Anderson; John Charles,59,0,90,31
1683672727782,MGT 136,A00,202871,Lindenberger; Wade Douglas,83,0,90,7
1683672728810,MGT 164,A00,202873,Staff,0,67,90,91
1683672729833,MGT 164GS,A00,202874,McKay; Mary A,13,0,28,15
1683672730857,MGT 180,A00,202875,Staff,0,51,90,91
1683672731885,MMW 11R,A01,205019,Herbst; Matthew,0,0,30,30
1683672731885,MMW 11R,A02,205026,Herbst; Matthew,29,0,30,1
1683672732909,MMW 15,A01,193512,Chang; Edmond Yi-Teh,0,8,28,28
1683672732909,MMW 15,A02,193513,Chang; Edmond Yi-Teh,0,5,28,28
1683672732909,MMW 15,A03,193514,Chang; Edmond Yi-Teh,0,5,28,28
1683672732909,MMW 15,A04,193515,Chang; Edmond Yi-Teh,0,5,28,28
1683672732909,MMW 15,A05,193516,Chang; Edmond Yi-Teh,0,5,28,28
1683672732909,MMW 15,A06,193517,Chang; Edmond Yi-Teh,0,6,28,28
1683672732909,MMW 15,B01,193519,Chang; Edmond Yi-Teh,0,5,28,28
1683672732909,MMW 15,B02,193520,Chang; Edmond Yi-Teh,0,5,28,28
1683672732909,MMW 15,B03,193521,Chang; Edmond Yi-Teh,0,5,28,28
1683672732909,MMW 15,B04,193522,Chang; Edmond Yi-Teh,0,5,28,28
1683672732909,MMW 15,B05,193523,Chang; Edmond Yi-Teh,0,5,28,28
1683672732909,MMW 15,B06,193524,Chang; Edmond Yi-Teh,0,5,28,28
1683672733937,MMW 122,A01,193526,Rahimi; Babak,0,16,28,28
1683672733937,MMW 122,A02,193527,Rahimi; Babak,0,15,28,28
1683672733937,MMW 122,A03,193528,Rahimi; Babak,0,0,0,0
1683672733937,MMW 122,A04,193529,Rahimi; Babak,0,0,0,0
1683672734962,MUS 1A,A01,186663,Staff,1,19,35,34
1683672735990,MUS 4,A01,186715,Staff,0,12,35,35
1683672737014,MUS 5R,A01,186796,Dubnov; Shlomo,0,17,35,35
1683672738038,MUS 6,A01,186798,Staff,0,5,25,25
1683672739061,MUS 7,A01,186830,Staff,11,0,35,24
1683672740086,MUS 8,A01,186930,Staff,0,27,35,35
1683672741110,MUS 15,A01,186932,Staff,0,15,35,35
1683672741110,MUS 15,B01,186934,Staff,1,17,35,34
1683672742135,MUS 80,A00,186935,Staff,0,0,20,20
1683672742135,MUS 80,B00,186936,Staff,24,0,25,1
1683672743183,NANO 11,A00,204702,Lipomi; Darren John,0,0,0,0
1683672744211,NANO 15,A01,204709,Yang; Kesong,0,1,0,0
1683672745235,NANO 114,A00,202069,Jahed Motlagh; Zeinab,3,0,10,7
1683672746267,PHIL 1,A00,186955,Grush; Rick Scott,31,0,40,9
1683672747290,PHIL 10,A01,186973,Grush; Rick Scott,27,0,35,8
1683672747290,PHIL 10,A02,186974,Grush; Rick Scott,33,0,35,2
1683672748316,PHIL 13,A01,186976,Staff,3,0,35,32
1683672748316,PHIL 13,A02,186977,Staff,16,0,35,19
1683672749402,PHIL 14,A01,186979,Staff,31,0,35,4
1683672749402,PHIL 14,A02,186986,Staff,32,0,35,3
1683672750426,PHIL 28,A01,186988,Staff,16,0,30,14
1683672750426,PHIL 28,A02,186989,Staff,1,0,30,29
1683672750426,PHIL 28,A03,186990,Staff,10,0,30,20
1683672750426,PHIL 28,A04,186991,Staff,26,0,30,4
1683672751452,PHIL 120,A00,186997,Staff,23,0,40,17
1683672752476,PHIL 137,A00,187003,Staff,7,0,40,33
1683672753501,PHIL 150,A00,187015,Staff,47,0,70,23
1683672754527,PHIL 167,A00,187021,Lamey; Andy M.,34,0,40,6
1683672755553,PHIL 174,A01,202226,Staff,17,0,20,3
1683672755553,PHIL 174,A02,202235,Staff,20,0,20,0
1683672756577,PHIL 191A,A00,258918,Staff,0,0,1,1
1683672757601,PHYS 1A,A00,187028,Staff,26,0,60,34
1683672758625,PHYS 1AL,001,187036,Staff,3,0,30,27
1683672758625,PHYS 1AL,002,187049,Staff,18,0,30,12
1683672759649,PHYS 1B,A00,187058,Staff,22,0,60,38
1683672760678,PHYS 1BL,001,187064,Staff,0,1,30,30
1683672760678,PHYS 1BL,002,187070,Staff,4,0,30,26
1683672761702,PHYS 1C,A00,187082,Staff,29,0,120,91
1683672762730,PHYS 1CL,001,187088,Staff,0,9,30,30
1683672762730,PHYS 1CL,002,187089,Staff,0,1,30,30
1683672762730,PHYS 1CL,009,262693,Staff,9,0,30,21
1683672763757,PHYS 2B,A01,187097,Staff,55,0,115,60
1683672764782,PHYS 2C,A01,187099,Staff,63,0,115,52
1683672765807,PHYS 2CL,A01,187101,Staff,5,0,28,23
1683672765807,PHYS 2CL,A02,187102,Staff,15,0,28,13
1683672766830,PHYS 2D,A01,187123,Shotwell; Brian,95,0,115,20
1683672767854,PHYS 4B,A01,187133,Grinstein; Benjamin,35,0,50,15
1683672768878,POLI 10,A00,188819,Staff,0,4,50,50
1683672769902,POLI 11,A00,188827,Staff,43,0,50,7
1683672770926,POLI 13R,A00,188828,Staff,0,1,20,20
1683672771951,POLI 27,A01,188830,Elgin; Samuel Zincke,0,2,70,70
1683672772976,POLI 30,A00,188832,Desposato; Scott,30,0,50,20
1683672774003,POLI 102F,A00,188834,Staff,0,0,40,40
1683672775029,POLI 104A,A00,188852,Staff,13,0,30,17
1683672776053,POLI 104I,A00,188853,Staff,0,7,20,20
1683672777078,POLI 110B,A00,188854,Wiens; David,6,0,20,14
1683672778104,POLI 112A,A00,188855,Wiens; David,3,0,30,27
1683672779131,POLI 117R,A00,188856,Forman; Fonna,0,12,20,20
1683672780158,POLI 118,A00,188857,Ingham; Sean,8,0,20,12
1683672781186,POLI 120G,A00,188858,Staff,8,0,30,22
1683672782215,POLI 131CR,A00,188863,Hoston; Germaine,20,0,50,30
1683672783239,POLI 133,A00,188864,Nellis; Gareth Hb,44,0,50,6
1683672784263,POLI 134D,A00,188865,Desposato; Scott,27,0,30,3
1683672785287,POLI 142A,A00,188871,Gartzke; Erik,21,0,50,29
1683672786311,POLI 142K,A00,188874,Staff,38,0,50,12
1683672787335,POLI 143,A00,188940,Gartzke; Erik,16,0,30,14
1683672788359,POLI 153,A00,188943,Staff,2,0,20,18
1683672789386,POLI 160AA,A00,188944,Staff,11,0,40,29
1683672790410,POLI 170A,A00,188945,Staff,10,0,30,20
1683672792462,PSYC 1,A00,188952,Staff,37,0,90,53
1683672793490,PSYC 2,B00,188953,Staff,19,0,35,16
1683672794521,PSYC 6,A00,188970,Staff,47,0,60,13
1683672795545,PSYC 7,A00,188973,Staff,35,0,45,10
1683672796570,PSYC 60,A01,188980,Rickard; Timothy C.,42,0,60,18
1683672797593,PSYC 70,A01,189001,Steiner; Eric Tomas,22,0,45,23
1683672798618,PSYC 100,A00,189005,Lacefield; Katharine I,0,99,120,120
1683672799646,PSYC 102,A00,189008,Staff,8,0,30,22
1683672800671,PSYC 106,B00,189026,Gorman; Michael R.,27,0,60,33
1683672801695,PSYC 114,B01,189033,Winkielman; Piotr,0,31,30,30
1683672802722,PSYC 131,A00,189036,Anagnostaras; Stephan,0,43,60,60
1683672803749,PSYC 136,A00,189041,Lowe; Angela Beth,0,7,25,25
1683672804774,PSYC 137,A00,189057,Winkielman; Piotr,1,37,25,24
1683672805799,PSYC 144,A00,189107,Wixted; John T,0,11,50,50
1683672807853,PSYC 162,A00,189142,Staff,0,9,85,85
1683672808876,PSYC 172,A00,189144,Gorman; Michael R.,0,6,30,30
1683672810928,PSYC 179,A00,189146,Lacefield; Katharine I,0,87,120,120
1683672811954,PSYC 181,A00,189147,Anagnostaras; Stephan,0,44,90,90
1683672812977,PSYC 190R,A00,189148,Barner; David A.,0,23,80,80
1683672814002,PSYC 191,A00,189275,Rickard; Timothy C.,0,10,25,25
1683672815030,PSYC 193,A00,189276,Chapman; Eddie Nathaniel,0,1,0,4
1683672816057,PSYC 193L,A01,189281,Lowe; Angela Beth,9,0,20,11
1683672816057,PSYC 193L,B01,189285,Staff,28,0,35,7
1683672817082,RELI 149,A00,187137,Rahimi; Babak,7,0,40,33
1683672818107,SE 9,A01,187315,Staff,0,2,18,18
1683672819133,SE 101B,A00,187409,Staff,24,0,30,6
1683672820157,SE 110B,A00,187444,Staff,10,0,40,30
1683672821181,SE 130B,A00,187449,Staff,31,0,40,9
1683672822205,SE 150A,A00,187516,Staff,8,0,20,12
1683672823230,SE 154,A00,187528,Staff,29,0,50,21
1683672824253,SIO 3,A01,258171,Staff,35,0,40,5
1683672825276,SIO 10,A00,187144,Cook; Geoffrey W,0,7,75,75
1683672826299,SIO 45,A00,187152,Cook; Geoffrey W,0,6,100,100
1683672827326,SIO 109R,A00,194486,Staff,0,4,20,20
1683672829375,SIO 187,A01,187233,Kacev; David,12,0,40,28
1683672830405,SOCI 1,A01,258656,Thorpe; Charles Robert,28,0,30,2
1683672830405,SOCI 1,A02,258658,Thorpe; Charles Robert,30,0,30,0
1683672830405,SOCI 1,A03,258661,Thorpe; Charles Robert,25,0,25,0
1683672830405,SOCI 1,A04,258666,Thorpe; Charles Robert,22,0,25,3
1683672830405,SOCI 1,A05,258897,Thorpe; Charles Robert,22,0,25,3
1683672830405,SOCI 1,A06,258898,Thorpe; Charles Robert,25,0,25,0
1683672831430,SOCI 30,A01,258903,Pardo Guerra; Juan Pablo,14,0,30,16
1683672832454,SOCI 102,A00,258904,Staff,9,0,25,16
1683672833480,SOCI 106,A00,258905,Staff,19,0,25,6
1683672834503,SOCI 111,A00,258907,Ribas Norris; Janet Vanesa,26,0,30,4
1683672835530,SOCI 121R,A00,258908,Pardo Guerra; Juan Pablo,8,0,30,22
1683672836555,SOCI 126,A01,203330,Staff,14,0,20,6
1683672837579,SOCI 131,A00,258909,Thorpe; Charles Robert,30,0,60,30
1683672838605,SOCI 135,A00,258910,Payne; Christine Anna,0,11,30,30
1683672839635,SOCI 157,A00,258911,Staff,11,0,30,19
1683672840659,SOCI 184,A00,258912,Staff,25,0,30,5
1683672841686,SOCI 188D,A00,258913,Staff,22,0,30,8
1683672842717,SYN 2,001,187529,Staff,9,0,16,7
1683672842717,SYN 2,002,201452,Staff,0,20,16,16
1683672842717,SYN 2,003,201469,Staff,1,0,16,15
1683672843740,SYN 100,A01,187531,Staff,0,9,20,20
1683672843740,SYN 100,B01,201491,Staff,0,10,20,20
1683672844768,TDAC 1,A00,189286,Walsh; Kim C.,3,0,20,17
1683672844768,TDAC 1,B00,189287,Harting; Carla Kelso,10,0,20,10
1683672845793,TDAC 101,A00,189300,Walsh; Kim C.,16,0,20,4
1683672845793,TDAC 101,B00,189301,Harting; Carla Kelso,18,0,20,2
1683672846815,TDAC 102,A00,189304,Basso; Beatrice,14,0,20,6
1683672847842,TDAC 108,A00,189305,Staff,18,0,20,2
1683672848870,TDDE 131,A00,189310,Staff,19,0,20,1
1683672848870,TDDE 131,B00,189314,Staff,19,0,20,1
1683672848870,TDDE 131,C00,189315,Staff,48,0,50,2
1683672848870,TDDE 131,D00,189316,Staff,14,0,15,1
1683672848870,TDDE 131,E00,204841,Staff,20,0,20,0
1683672849897,TDGE 10,A00,189289,Staff,27,0,50,23
1683672849897,TDGE 10,B00,189290,Havis; Allan,0,1,50,50
1683672850925,TDGE 11,A00,189291,Fulton; Julia,0,4,50,50
1683672850925,TDGE 11,B00,189292,Staff,20,0,25,5
1683672850925,TDGE 11,C00,260270,Staff,0,0,0,0
1683672851951,TDGE 25,A00,189294,Staff,2,0,20,18
1683672853033,TDGE 124,A00,189318,Fulton; Julia,0,8,50,50
1683672854060,TDGE 125,A00,189319,Staff,13,0,25,12
1683672854060,TDGE 125,B00,189320,Staff,23,0,25,2
1683672855083,TDGE 127,A00,189322,Havis; Allan,0,0,50,50
1683672856107,TDHT 101,A00,189323,Staff,18,0,25,7
1683672856107,TDHT 101,B00,189324,Staff,25,0,25,0
1683672857134,TDHT 102,A00,189325,Staff,49,0,50,1
1683672858164,TDMV 1,A00,189295,Arcidiacono; Kristin,20,0,30,10
1683672858164,TDMV 1,B00,189296,Caligagan; Maria T.,24,0,30,6
1683672859191,TDMV 2,A00,189297,Sammartano; Tonnie,27,0,30,3
1683672859191,TDMV 2,B00,189299,Arcidiacono; Kristin,23,0,30,7
1683672860221,TDMV 3,A00,204998,Rincon; Alicia,22,0,30,8
1683672861247,TDMV 120,A00,189458,Sammartano; Tonnie,28,0,30,2
1683672862274,TDMV 138,A00,189541,Jun; Grace Shin Hae,20,0,40,20
1683672863303,TDMV 142,A00,189717,Caligagan; Tony,25,0,30,5
1683672863303,TDMV 142,B00,189718,Caligagan; Maria T.,25,0,30,5
1683672864330,TMC 2,A01,187533,Staff,25,0,25,0
1683672864330,TMC 2,A02,187534,Staff,25,0,25,0
1683672865357,USP 1,A01,187536,Kwak; Nancy,0,16,25,25
1683672866382,USP 5,A01,187538,Staff,9,0,25,16
1683672867406,USP 101,A00,199253,Staff,0,4,0,0
1683672868430,USP 124,A00,187562,Boomhower; Matthew Charles,0,0,30,30
1683672869454,USP 138,A00,187582,Staff,19,0,25,6
1683672870481,USP 152,A01,187597,Staff,3,0,25,22
1683672871508,USP 153,A00,187598,Staff,19,0,25,6
1683672872532,USP 168,A00,187607,Kwak; Nancy,2,0,5,3
1683672873558,USP 173,A00,187619,Staff,4,0,25,21
1683672874583,USP 181,A00,187638,Staff,0,4,25,25
1683672875608,VIS 103,A00,187650,Cruz; Edwin Teddy,17,0,75,58
1683672876635,VIS 110D,A00,187669,Staff,13,0,22,9
1683672877661,VIS 127C,A00,187720,Shen; Kuiyi,67,0,146,79
1683672878690,VIS 149,A00,187731,Yoldas; Pinar,1,14,22,21
1683672879717,VIS 151,A01,188091,Staff,22,0,34,12
1683672879717,VIS 151,A02,188092,Staff,11,0,34,23
1683672880743,VIS 160B,A00,188093,Stalbaum; Brett,0,1,10,10
1683672882797,WCWP 10B,A00,201720,Staff,10,0,15,5
1683672882797,WCWP 10B,B00,201722,Staff,9,0,15,6
1683672883821,WCWP 100,A00,201725,Gagnon; Jeffrey C,0,0,2,2
1683672883821,WCWP 100,B00,201727,Staff,0,4,15,15
1683672886953,ANBI 133,A00,258401,Wilder; Linnea Lorene,34,0,40,6
1683672887980,ANBI 140,A00,258395,Hrvoj Mihic; Branka,18,0,25,7
1683672889004,ANSC 120,A00,258402,Bialecki; Jon Anthony,26,0,40,14
1683672890031,ANSC 144,A00,258400,Staff,12,0,40,28
1683672892081,ANSC 166,A00,258396,Parish; Steven Martin,156,0,175,19
1683672893106,ANSC 180,A00,193533,Staff,8,0,20,12
1683672894132,ANSC 188,A00,258397,Jassal; Aftab,34,0,40,6
1683672895154,ANTH 3,A01,258316,Staff,23,0,30,7
1683672896179,ANTH 5,A00,258394,Semendeferi; Ekaterini,16,0,20,4
1683672897207,ANTH 21,A01,258331,Staff,4,0,40,36
1683672898230,ANTH 103,A00,258398,Varma; Saiba,15,0,25,10
1683672899259,AWP 10,001,202034,Staff,0,0,0,0
1683672899259,AWP 10,002,202035,Staff,0,0,0,0
1683672899259,AWP 10,003,202036,Staff,0,0,0,0
1683672899259,AWP 10,004,202037,Staff,0,0,0,0
1683672899259,AWP 10,005,202038,Staff,0,0,0,0
1683672899259,AWP 10,006,202039,Staff,0,0,0,0
1683672899259,AWP 10,007,202040,Staff,0,0,0,0
1683672899259,AWP 10,008,202041,Staff,0,0,0,0
1683672899259,AWP 10,009,202042,Staff,0,0,0,0
1683672899259,AWP 10,010,202043,Staff,0,0,0,0
1683672899259,AWP 10,011,202044,Staff,0,0,0,0
1683672899259,AWP 10,012,202045,Staff,0,0,0,0
1683672899259,AWP 10,013,202046,Staff,0,0,0,0
1683672899259,AWP 10,014,202047,Staff,0,0,0,0
1683672899259,AWP 10,015,202048,Staff,0,0,0,0
1683672899259,AWP 10,016,202049,Staff,0,0,0,0
1683672899259,AWP 10,017,202050,Staff,0,0,0,0
1683672899259,AWP 10,018,202051,Staff,0,0,0,0
1683672899259,AWP 10,019,202052,Staff,0,0,0,0
1683672899259,AWP 10,020,202053,Staff,0,0,0,0
1683672899259,AWP 10,021,202054,Staff,0,0,0,0
1683672899259,AWP 10,022,202055,Staff,0,0,0,0
1683672899259,AWP 10,023,202056,Staff,0,0,0,0
1683672899259,AWP 10,024,202057,Staff,0,0,0,0
1683672899259,AWP 10,025,202058,Staff,0,0,0,0
1683672899259,AWP 10,026,202059,Staff,0,0,0,0
1683672900286,AWP 102,001,202032,Staff,0,0,0,0
1683672900286,AWP 102,002,202033,Staff,0,0,0,0
1683672901347,BENG 100,A01,254234,Taylor Amos; Alyssa C,31,0,40,9
1683672902374,BENG 196,001,270013,Engler; Adam J.,9999,0,9999,0
1683672903404,BICD 100R,A01,202018,Smith; Laurie,0,7,32,32
1683672903404,BICD 100R,A02,202019,Smith; Laurie,0,3,32,32
1683672903404,BICD 100R,A03,202020,Smith; Laurie,0,1,32,32
1683672903404,BICD 100R,A04,202021,Smith; Laurie,6,0,32,26
1683672903404,BICD 100R,A05,202022,Smith; Laurie,11,0,32,21
1683672904429,BICD 136,A01,193242,Gustafson-Brown; Cindy,0,2,32,32
1683672904429,BICD 136,A02,193244,Gustafson-Brown; Cindy,13,0,32,19
1683672905456,BIEB 102,A01,193249,Butler; Shannon Rhey,1,2,32,31
1683672905456,BIEB 102,A02,193251,Butler; Shannon Rhey,0,0,32,32
1683672905456,BIEB 102,A03,193253,Butler; Shannon Rhey,0,0,32,32
1683672905456,BIEB 102,A04,193255,Butler; Shannon Rhey,13,0,32,19
1683672905456,BIEB 102,A05,193265,Butler; Shannon Rhey,25,0,32,7
1683672905456,BIEB 102,A06,193269,Butler; Shannon Rhey,14,0,32,18
1683672907518,BIEB 150,A01,193274,Staff,0,0,32,32
1683672907518,BIEB 150,A02,193285,Staff,24,0,32,8
1683672908544,BIEB 194,A00,193286,Kurle; Carolyn M.,20,0,32,12
1683672909573,BILD 1,A01,192291,Staff,15,0,32,17
1683672909573,BILD 1,A02,192292,Staff,30,0,32,2
1683672909573,BILD 1,B01,192520,Reuther; Keefe,0,1,0,0
1683672909573,BILD 1,B02,192532,Reuther; Keefe,0,1,0,0
1683672910601,BILD 3,A01,192556,Butler; Shannon Rhey,0,0,32,32
1683672910601,BILD 3,A02,192581,Butler; Shannon Rhey,0,1,32,32
1683672910601,BILD 3,A03,192611,Butler; Shannon Rhey,20,0,32,12
1683672910601,BILD 3,A04,192612,Butler; Shannon Rhey,24,0,32,8
1683672910601,BILD 3,A05,192613,Butler; Shannon Rhey,26,0,32,6
1683672910601,BILD 3,A06,192679,Butler; Shannon Rhey,27,0,32,5
1683672910601,BILD 3,A07,192682,Butler; Shannon Rhey,20,0,32,12
1683672911627,BILD 4,A01,192836,Reuther; Keefe,1,0,24,23
1683672911627,BILD 4,A02,193044,Reuther; Keefe,4,0,24,20
1683672912652,BILD 10,A01,193142,Gustafson-Brown; Cindy,29,0,32,3
1683672912652,BILD 10,A02,193149,Gustafson-Brown; Cindy,31,0,32,1
1683672913677,BIMM 100,A01,193301,Staff,0,6,32,32
1683672913677,BIMM 100,A02,193312,Staff,0,7,32,32
1683672913677,BIMM 100,A03,193323,Staff,0,10,32,32
1683672914702,BIMM 101,A01,193329,McDonnell; Lisa Marie,1,4,24,23
1683672914702,BIMM 101,A02,193339,McDonnell; Lisa Marie,1,4,24,23
1683672914702,BIMM 101,B01,193354,McDonnell; Lisa Marie,0,4,24,24
1683672914702,BIMM 101,B02,193357,McDonnell; Lisa Marie,0,3,24,24
1683672915729,BIMM 110,A01,193377,Tat; John,0,11,32,32
1683672915729,BIMM 110,A02,193378,Tat; John,0,10,32,32
1683672916754,BIMM 120,A01,206116,Staff,0,0,32,32
1683672916754,BIMM 120,A02,206117,Staff,7,0,32,25
1683672916754,BIMM 120,A03,206121,Staff,21,0,32,11
1683672917777,BIPN 100,A01,193393,Park; Ji Young,0,15,32,32
1683672917777,BIPN 100,A02,193402,Park; Ji Young,0,14,32,32
1683672917777,BIPN 100,A03,193413,Park; Ji Young,0,14,32,32
1683672917777,BIPN 100,A04,193414,Park; Ji Young,0,13,32,32
1683672918802,BIPN 102,A01,193429,Staff,0,0,32,32
1683672918802,BIPN 102,A02,193438,Staff,18,0,32,14
1683672919826,BIPN 106,A01,193450,Reyes Gonzalez; Catalina,0,2,40,40
1683672920859,BIPN 134,A01,193465,Cooke; James Edward,0,0,32,32
1683672920859,BIPN 134,A02,193474,Cooke; James Edward,25,0,32,7
1683672920859,BIPN 134,A03,193485,Cooke; James Edward,29,0,32,3
1683672920859,BIPN 134,A04,193486,Cooke; James Edward,20,0,32,12
1683672920859,BIPN 134,A05,193491,Cooke; James Edward,31,0,32,1
1683672920859,BIPN 134,A06,193501,Cooke; James Edward,30,0,32,2
1683672920859,BIPN 134,A07,193510,Cooke; James Edward,29,0,32,3
1683672922909,BISP 194,A00,222522,Staff,14,0,32,18
1683672923934,CAT 124,A01,202407,Staff,19,0,25,6
1683672924958,CAT 125,A00,202408,Marchisotto; Jennifer Anne,2,0,20,18
1683672925987,CAT 125R,A00,202409,Smith; Lauryn Alissa,0,11,20,20
1683672925987,CAT 125R,B00,202410,Morales; Celeste Georgianna,0,11,20,20
1683672925987,CAT 125R,C00,202411,Irwin; Matthew Joseph,0,12,20,20
1683672927014,CENG 15,A01,204712,Yang; Kesong,0,1,0,0
1683672928037,CENG 114,A00,202070,Jahed Motlagh; Zeinab,5,0,20,15
1683672929064,CGS 105,A00,185477,Wesling; Megan E.,24,0,40,16
1683672930089,CGS 106,A00,185494,Staff,11,0,22,11
1683672931114,CGS 108,A00,185495,Staff,14,0,20,6
1683672932142,CGS 114,A00,185496,Staff,13,0,18,5
1683672933171,CGS 119,A00,185501,Staff,15,0,20,5
1683672934197,CGS 120,A00,185511,Staff,12,0,20,8
1683672935222,CHEM 4,A01,184675,Bussey; Thomas J,97,0,100,3
1683672936246,CHEM 6A,A01,184677,Staff,32,0,60,28
1683672937277,CHEM 6B,A01,184679,Staff,63,0,100,37
1683672938305,CHEM 6C,A01,184681,Bussey; Thomas J,0,0,50,50
1683672938305,CHEM 6C,A02,184682,Bussey; Thomas J,32,0,50,18
1683672939329,CHEM 40A,A01,184684,Albizati; Kim F.,33,0,100,67
1683672940353,CHEM 40B,A01,184686,Albizati; Kim F.,0,22,100,100
1683672941381,CHEM 41B,A01,184690,Staff,51,0,100,49
1683672942405,COGS 3,A01,184715,Boyle; Mary E. T.,0,27,40,40
1683672943433,COGS 14B,A01,185172,Staff,0,14,38,38
1683672944460,COGS 18,A01,184736,Staff,14,0,80,66
1683672945487,COGS 100,A01,184932,Staff,0,8,73,73
1683672946512,COGS 101A,A01,184935,Staff,0,40,30,30
1683672947537,COGS 101B,A01,184944,Staff,0,2,30,30
1683672948565,COGS 101C,A01,184946,Staff,0,10,30,30
1683672949590,COGS 102A,A01,184951,Johnson; Christine M.,2,0,40,38
1683672950615,COGS 107B,A01,184953,Mooshagian; Eric Frederick,0,52,40,40
1683672951640,COGS 118B,A01,184959,Gupta; Anjum,0,50,40,40
1683672952667,COGS 153,A00,184961,Staff,0,16,30,30
1683672953692,COGS 177,A00,184962,Staff,0,21,30,30
1683672954718,COGS 187A,A01,184969,Boyle; Mary E. T.,0,19,40,40
1683672955746,COMM 10,A01,185174,Staff,0,5,25,25
1683672955746,COMM 10,A02,185189,Staff,0,2,25,25
1683672955746,COMM 10,A03,269821,Staff,0,1,0,0
1683672956826,COMM 100B,A01,185475,Staff,0,1,0,1
1683672956826,COMM 100B,A02,185476,Staff,11,0,25,14
1683672957853,COMM 100C,A01,185314,Staff,1,0,25,24
1683672957853,COMM 100C,A02,185327,Staff,17,0,25,8
1683672958876,COMM 110M,A00,185349,Staff,0,0,40,40
1683672959900,COMM 113T,A00,185352,Staff,25,0,40,15
1683672960924,COMM 114I,A00,185353,Staff,31,0,40,9
1683672961948,COMM 131,A00,185354,Staff,17,0,30,13
1683672962973,CSE 8A,A50,185358,Cao; Yingjun,0,46,10,10
1683672963996,CSE 8B,A01,185362,Staff,0,48,50,50
1683672965025,CSE 11,A01,185416,Cao; Yingjun,0,91,10,10
1683672966054,CSE 20,A01,185445,Briones; Jor-el Thomas Caparas,4,0,25,21
1683672967084,CSE 21,A01,185447,Staff,9,0,50,41
1683672968197,CSE 101,A01,185451,Staff,0,13,50,50
1683672968197,CSE 101,B01,185453,Jones; Miles E,0,14,50,50
1683672970245,CSE 141,A01,185458,Eldon; John,16,0,100,84
1683672971268,CSE 141L,A01,185461,Eldon; John,8,0,100,92
1683672972295,CSE 142,A01,185463,Staff,34,0,60,26
1683672972295,CSE 142,B01,201355,Staff,0,7,60,60
1683672973333,CSE 142L,A01,185470,Staff,34,0,60,26
1683672973333,CSE 142L,B01,201417,Staff,0,6,60,60
1683672974362,CSE 190,A00,201433,Staff,32,0,49,17
1683672975386,DOC 1,A01,259136,Strom; Megan C.,7,0,15,8
1683672975386,DOC 1,A02,259137,Strom; Megan C.,14,0,15,1
1683672975386,DOC 1,A03,259138,Strom; Megan C.,14,0,15,1
1683672975386,DOC 1,A04,259139,Strom; Megan C.,14,0,15,1
1683672976412,DOC 100D,A00,259140,Pass; Natalye Joann,14,0,25,11
1683672977437,DSGN 1,A01,184749,Rill; Bryan,0,26,30,30
1683672978470,DSGN 100,A01,185168,Staff,0,2,25,25
1683672979495,ECE 5,A01,185626,Morris; Karcher William,0,12,0,0
1683672980520,ECE 101,A01,185628,Staff,14,0,70,56
1683672981545,ECE 107,A01,185635,Baghdadchi; Saharnaz,0,0,20,20
1683672981545,ECE 107,A02,185638,Baghdadchi; Saharnaz,1,0,20,19
1683672982573,ECE 148,A01,185647,Silberman; Jack,0,0,16,16
1683672983598,ECON 1,A01,185537,Crane; Meredith Helen,54,0,70,16
1683672984626,ECON 3,A01,185549,Crane; Meredith Helen,29,0,70,41
1683672985651,ECON 4,A01,203354,Anderson; John Charles,0,5,10,10
1683672986675,ECON 100A,A01,185574,Staff,0,5,40,40
1683672987701,ECON 100B,A01,185576,Staff,0,12,50,50
1683672988725,ECON 100C,A01,185589,Newhouse; Herbert S,30,0,70,40
1683672989751,ECON 105,A00,185608,Vespa; Emanuel Ignacio,19,0,35,16
1683672990775,ECON 109,A01,185610,Shishkin; Denis,9,0,35,26
1683672991799,ECON 110A,A01,185612,Staff,9,0,40,31
1683672992824,ECON 120A,A01,185615,Staff,19,0,40,21
1683672993852,ECON 120C,A01,185617,Sun; Yixiao,0,21,70,70
1683672994880,ECON 144,A00,203346,Squires; Dale E,2,0,35,33
1683672995909,ECON 171,A01,203349,Newhouse; Herbert S,0,1,35,35
1683672996936,ECON 173A,A01,185621,Toda; Alexis Akira,20,0,35,15
1683672997962,EDS 25,A01,202413,Staff,0,1,0,0
1683672997962,EDS 25,A02,202414,Staff,0,1,0,0
1683672997962,EDS 25,A03,202415,Staff,0,0,0,0
1683672997962,EDS 25,A04,202416,Staff,0,1,0,0
1683672997962,EDS 25,A05,202439,Staff,0,0,0,0
1683672997962,EDS 25,A06,202440,Staff,0,0,0,0
1683672997962,EDS 25,B01,202631,Staff,0,0,0,0
1683672997962,EDS 25,B02,202632,Staff,0,0,0,0
1683672997962,EDS 25,B03,202639,Staff,0,0,0,0
1683672997962,EDS 25,B04,202640,Staff,0,0,0,0
1683672997962,EDS 25,B05,202643,Staff,0,0,0,0
1683672997962,EDS 25,B06,202644,Staff,0,0,0,0
1683672998989,EDS 38,A01,202659,Black; Alison Michelle,24,0,25,1
1683673000014,EDS 115,A00,202652,Staff,18,0,30,12
1683673001041,EDS 125,A00,202649,Staff,13,0,30,17
1683673002066,EDS 126,A01,203332,Staff,30,0,30,0
1683673003092,EDS 139,A00,202838,Staff,16,0,25,9
1683673004116,EDS 146,A01,202655,Staff,14,0,25,11
1683673005145,ENG 15,A00,185667,Staff,0,1,0,0
1683673005145,ENG 15,B00,185672,Staff,0,0,0,0
1683673005145,ENG 15,C00,185675,Staff,0,0,0,0
1683673005145,ENG 15,D00,185682,Staff,0,0,0,0
1683673005145,ENG 15,E00,185684,Staff,0,0,0,0
1683673006170,ETHN 103,A00,185710,Staff,0,8,35,35
1683673007195,ETHN 103A,A00,199228,Man; Simeon S,0,0,9,9
1683673008219,ETHN 109,A00,185711,Staff,15,0,35,20
1683673009243,ETHN 142,A00,185726,Staff,0,4,30,30
1683673010270,ETHN 163J,A00,199229,Man; Simeon S,5,0,8,3
1683673011293,ETHN 168,A00,185727,Staff,7,0,10,3
1683673012328,ETHN 182,A00,185728,Staff,0,0,35,35
1683673013355,ETHN 183,A00,185737,Staff,9,0,18,9
1683673014380,GLBH 111,A01,209361,Burgos; Jose L.,0,0,0,0
1683673016431,HIEU 104,A00,185792,Staff,14,0,20,6
1683673017454,HIEU 115,A00,185800,Staff,0,0,20,20
1683673018477,HIEU 128,A00,185801,Staff,0,9,20,20
1683673019504,HIEU 147,A00,185802,Staff,15,0,20,5
1683673020533,HIEU 154,A00,185823,Staff,11,0,20,9
1683673021565,HILA 102,A00,185826,Staff,14,0,20,6
1683673022597,HILD 2C,A01,185778,Staff,0,13,20,20
1683673023620,HILD 7B,A01,185780,Kwak; Nancy,0,17,32,32
1683673023620,HILD 7B,A02,185781,Kwak; Nancy,0,18,32,32
1683673024645,HILD 30,A01,185791,Staff,12,0,20,8
1683673025668,HISC 119,A00,185830,Golan; Tal,0,9,20,20
1683673026692,HITO 156GS,A00,185831,Patterson; Patrick H.,0,0,0,23
1683673027717,HIUS 103,A00,185832,Man; Simeon S,0,4,20,20
1683673028745,HIUS 117,A00,185836,Kwak; Nancy,2,0,20,18
1683673029771,HIUS 125,A00,185840,Man; Simeon S,0,2,23,23
1683673030800,HIUS 149,A00,185845,Staff,1,0,20,19
1683673031838,HUM 3,A01,185882,Zavodny; Tatiana Sophia,0,8,50,50
1683673031838,HUM 3,B01,185899,Caldwell; Michael Alan,0,18,50,50
1683673032863,HUM 3GS,A00,185900,Patterson; Patrick H.,0,0,0,23
1683673033889,HUM 4,A01,185938,Zroka; Amy Liane,29,0,50,21
1683673033889,HUM 4,B01,185956,Watkins; Eric,0,5,50,50
1683673033889,HUM 4,B02,202209,Watkins; Eric,0,5,50,50
1683673033889,HUM 4,B03,202210,Watkins; Eric,0,5,50,50
1683673034917,HUM 5,A01,185958,West; Geoffrey Scott,0,0,50,50
1683673034917,HUM 5,A02,202215,West; Geoffrey Scott,0,0,50,50
1683673035941,INTL 190,A00,185959,Gagnon; Jeffrey C,0,0,0,9
1683673035941,INTL 190,B00,185960,Lettieri; Michael Joseph,0,0,0,2
1683673036966,JAPN 180,A00,254509,Staff,5,0,30,25
1683673037992,LATI 10,A01,202853,Kennemore; Amy Michelle,4,0,35,31
1683673037992,LATI 10,A02,202854,Kennemore; Amy Michelle,2,0,35,33
1683673037992,LATI 10,A03,270054,Kennemore; Amy Michelle,30,0,30,0
1683673039019,LATI 180,A00,202855,Kennemore; Amy Michelle,11,0,20,9
1683673040043,LAWS 101,A00,201767,Golan; Tal,0,7,40,40
1683673041068,LIFR 1C,A00,185961,Staff,6,0,20,14
1683673042094,LIFR 1CX,A00,185962,Staff,7,0,20,13
1683673043121,LIFR 1D,A00,185963,Staff,7,0,20,13
1683673044146,LIFR 1DX,A00,185964,Staff,7,0,20,13
1683673045170,LIGN 101,A01,186039,Staff,43,0,50,7
1683673046195,LIGN 165,A00,186040,Staff,15,0,50,35
1683673047220,LTCS 108,A00,186041,Staff,5,0,10,5
1683673048245,LTCS 119,A00,186042,Staff,15,0,20,5
1683673049273,LTCS 130,A00,186043,Wesling; Megan E.,15,0,25,10
1683673051330,LTEA 138,A00,186119,Staff,14,0,40,26
1683673052355,LTEN 124,A00,186148,Staff,5,0,25,20
1683673053379,LTEN 178,A00,186149,Staff,7,0,15,8
1683673054403,LTEN 181,A00,186150,Blanco; John D,34,0,40,6
1683673055427,LTWL 120,A00,186160,Staff,19,0,25,6
1683673056452,LTWL 165,A00,186161,Staff,22,0,25,3
1683673057475,LTWR 100,A00,186162,Staff,0,5,15,15
1683673058505,LTWR 102,A00,186163,Doller; Ben,5,0,15,10
1683673059529,MAE 8,A01,186412,Staff,0,0,0,0
1683673060609,MAE 30B,A00,186445,Bahadori; Mohammad Yousef,82,0,100,18
1683673061637,MAE 40,A00,186592,Bewley; Thomas R,10,0,50,40
1683673062660,MAE 101B,A00,186593,Bahadori; Mohammad Yousef,80,0,100,20
1683673063687,MAE 105,A00,186594,Bandaru; Prabhakar,10,0,50,40
1683673064710,MAE 107,A00,186599,Pham; Hieu Tan,0,7,120,120
1683673065733,MAE 148,A01,186660,Silberman; Jack,3,0,16,13
1683673066758,MATH 10A,A01,188095,Staff,0,6,35,35
1683673067786,MATH 10B,A01,188097,Bowers; Adam R.,0,12,30,30
1683673067786,MATH 10B,A02,188099,Bowers; Adam R.,0,11,30,30
1683673067786,MATH 10B,B01,188104,Bowers; Adam R.,0,10,30,30
1683673067786,MATH 10B,B02,188106,Bowers; Adam R.,1,9,30,29
1683673068813,MATH 10C,A01,188111,Staff,0,20,30,30
1683673068813,MATH 10C,A02,188127,Staff,0,19,30,30
1683673068813,MATH 10C,A03,188131,Staff,0,19,30,30
1683673068813,MATH 10C,B01,188218,Staff,17,0,30,13
1683673068813,MATH 10C,B02,188244,Staff,13,0,30,17
1683673068813,MATH 10C,B03,188277,Staff,14,0,30,16
1683673069843,MATH 18,A01,188344,Bach; Quang Tran,18,0,30,12
1683673069843,MATH 18,A02,188345,Bach; Quang Tran,11,0,30,19
1683673069843,MATH 18,B01,188353,Bach; Quang Tran,11,0,30,19
1683673069843,MATH 18,B02,188354,Bach; Quang Tran,19,0,30,11
1683673070872,MATH 20A,A01,188374,Staff,11,0,35,24
1683673071901,MATH 20B,A01,188382,Ohm; Ko Woon,7,0,30,23
1683673071901,MATH 20B,A02,188383,Ohm; Ko Woon,22,0,30,8
1683673071901,MATH 20B,B01,188385,Ohm; Ko Woon,7,0,30,23
1683673071901,MATH 20B,B02,188392,Ohm; Ko Woon,22,0,30,8
1683673072926,MATH 20C,A01,188394,Harel; Guershon,10,0,30,20
1683673072926,MATH 20C,A02,188395,Harel; Guershon,13,0,30,17
1683673072926,MATH 20C,B01,188404,Harel; Guershon,5,0,30,25
1683673072926,MATH 20C,B02,188405,Harel; Guershon,18,0,30,12
1683673073951,MATH 20D,A01,188414,Hammock; Frances H,0,1,30,30
1683673073951,MATH 20D,A02,188415,Hammock; Frances H,0,1,30,30
1683673073951,MATH 20D,B01,188447,Hammock; Frances H,0,1,30,30
1683673073951,MATH 20D,B02,188486,Hammock; Frances H,3,0,30,27
1683673074977,MATH 20E,A01,188649,Staff,21,0,30,9
1683673074977,MATH 20E,A02,188650,Staff,20,0,30,10
1683673074977,MATH 20E,A03,188673,Staff,0,0,30,30
1683673076004,MATH 102,A01,188675,Staff,0,38,35,35
1683673077029,MATH 103B,A01,188681,Staff,3,0,35,32
1683673077029,MATH 103B,B01,188692,Staff,5,0,35,30
1683673078057,MATH 109,A01,188695,Salehi Golsefidy; Alireza,24,0,35,11
1683673078057,MATH 109,A02,188696,Salehi Golsefidy; Alireza,25,0,35,10
1683673079080,MATH 120A,A01,188698,Eggers; John Dietrich,7,0,35,28
1683673080108,MATH 142B,A01,188736,Ioana; Adrian,1,1,30,29
1683673080108,MATH 142B,A02,188741,Ioana; Adrian,0,1,30,30
1683673080108,MATH 142B,A03,188743,Ioana; Adrian,0,1,30,30
1683673081130,MATH 168A,A01,188790,Staff,0,11,35,35
1683673082158,MATH 170A,A01,188803,Nie; Jiawang,0,2,35,35
1683673082158,MATH 170A,A02,188811,Nie; Jiawang,0,0,35,35
1683673082158,MATH 170A,A03,188814,Nie; Jiawang,0,0,35,35
1683673082158,MATH 170A,A04,188815,Nie; Jiawang,6,0,35,29
1683673083186,MATH 193B,A01,188817,Staff,0,0,35,35
1683673083186,MATH 193B,A02,188818,Staff,5,0,35,30
1683673084210,MGT 4,A01,202857,Anderson; John Charles,60,0,80,20
1683673085234,MGT 12,A00,202858,Lindenberger; Wade Douglas,40,0,90,50
1683673086257,MGT 18,A00,202859,Staff,74,0,90,16
1683673087280,MGT 18GS,A00,202860,McKay; Michael J,13,0,28,15
1683673088304,MGT 45,A00,202861,Pecore; Joseph P.,10,0,90,80
1683673089329,MGT 100,A00,202863,Yavorsky; Daniel Ryan,28,0,90,62
1683673090357,MGT 103,A00,202864,Ehrich; Kristine R,0,18,90,90
1683673091387,MGT 112,A00,202865,Ehrich; Kristine R,15,0,90,75
1683673092409,MGT 121A,A00,202868,Staff,90,20,90,0
1683673093432,MGT 131B,A00,202869,Anderson; John Charles,59,0,90,31
1683673094459,MGT 136,A00,202871,Lindenberger; Wade Douglas,83,0,90,7
1683673095486,MGT 164,A00,202873,Staff,0,67,90,91
1683673096511,MGT 164GS,A00,202874,McKay; Mary A,13,0,28,15
1683673097535,MGT 180,A00,202875,Staff,0,51,90,91
1683673098559,MMW 11R,A01,205019,Herbst; Matthew,0,0,30,30
1683673098559,MMW 11R,A02,205026,Herbst; Matthew,29,0,30,1
1683673099584,MMW 15,A01,193512,Chang; Edmond Yi-Teh,0,8,28,28
1683673099584,MMW 15,A02,193513,Chang; Edmond Yi-Teh,0,5,28,28
1683673099584,MMW 15,A03,193514,Chang; Edmond Yi-Teh,0,5,28,28
1683673099584,MMW 15,A04,193515,Chang; Edmond Yi-Teh,0,5,28,28
1683673099584,MMW 15,A05,193516,Chang; Edmond Yi-Teh,0,5,28,28
1683673099584,MMW 15,A06,193517,Chang; Edmond Yi-Teh,0,6,28,28
1683673099584,MMW 15,B01,193519,Chang; Edmond Yi-Teh,0,5,28,28
1683673099584,MMW 15,B02,193520,Chang; Edmond Yi-Teh,0,5,28,28
1683673099584,MMW 15,B03,193521,Chang; Edmond Yi-Teh,0,5,28,28
1683673099584,MMW 15,B04,193522,Chang; Edmond Yi-Teh,0,5,28,28
1683673099584,MMW 15,B05,193523,Chang; Edmond Yi-Teh,0,5,28,28
1683673099584,MMW 15,B06,193524,Chang; Edmond Yi-Teh,0,5,28,28
1683673100610,MMW 122,A01,193526,Rahimi; Babak,0,16,28,28
1683673100610,MMW 122,A02,193527,Rahimi; Babak,0,15,28,28
1683673100610,MMW 122,A03,193528,Rahimi; Babak,0,0,0,0
1683673100610,MMW 122,A04,193529,Rahimi; Babak,0,0,0,0
1683673101637,MUS 1A,A01,186663,Staff,1,19,35,34
1683673102665,MUS 4,A01,186715,Staff,0,12,35,35
1683673103692,MUS 5R,A01,186796,Dubnov; Shlomo,0,17,35,35
1683673104719,MUS 6,A01,186798,Staff,0,5,25,25
1683673105746,MUS 7,A01,186830,Staff,11,0,35,24
1683673106770,MUS 8,A01,186930,Staff,0,27,35,35
1683673107795,MUS 15,A01,186932,Staff,0,15,35,35
1683673107795,MUS 15,B01,186934,Staff,1,17,35,34
1683673108818,MUS 80,A00,186935,Staff,0,0,20,20
1683673108818,MUS 80,B00,186936,Staff,24,0,25,1
1683673109845,NANO 11,A00,204702,Lipomi; Darren John,0,0,0,0
1683673110869,NANO 15,A01,204709,Yang; Kesong,0,1,0,0
1683673111896,NANO 114,A00,202069,Jahed Motlagh; Zeinab,3,0,10,7
1683673112921,PHIL 1,A00,186955,Grush; Rick Scott,31,0,40,9
1683673113944,PHIL 10,A01,186973,Grush; Rick Scott,27,0,35,8
1683673113944,PHIL 10,A02,186974,Grush; Rick Scott,33,0,35,2
1683673114971,PHIL 13,A01,186976,Staff,3,0,35,32
1683673114971,PHIL 13,A02,186977,Staff,16,0,35,19
1683673115994,PHIL 14,A01,186979,Staff,31,0,35,4
1683673115994,PHIL 14,A02,186986,Staff,32,0,35,3
1683673117021,PHIL 28,A01,186988,Staff,16,0,30,14
1683673117021,PHIL 28,A02,186989,Staff,1,0,30,29
1683673117021,PHIL 28,A03,186990,Staff,10,0,30,20
1683673117021,PHIL 28,A04,186991,Staff,26,0,30,4
1683673118046,PHIL 120,A00,186997,Staff,23,0,40,17
1683673119074,PHIL 137,A00,187003,Staff,7,0,40,33
1683673120098,PHIL 150,A00,187015,Staff,47,0,70,23
1683673121124,PHIL 167,A00,187021,Lamey; Andy M.,34,0,40,6
1683673122151,PHIL 174,A01,202226,Staff,17,0,20,3
1683673122151,PHIL 174,A02,202235,Staff,20,0,20,0
1683673123174,PHIL 191A,A00,258918,Staff,0,0,1,1
1683673124201,PHYS 1A,A00,187028,Staff,26,0,60,34
1683673125224,PHYS 1AL,001,187036,Staff,3,0,30,27
1683673125224,PHYS 1AL,002,187049,Staff,18,0,30,12
1683673126251,PHYS 1B,A00,187058,Staff,22,0,60,38
1683673127279,PHYS 1BL,001,187064,Staff,0,1,30,30
1683673127279,PHYS 1BL,002,187070,Staff,4,0,30,26
1683673128307,PHYS 1C,A00,187082,Staff,29,0,120,91
1683673129336,PHYS 1CL,001,187088,Staff,0,9,30,30
1683673129336,PHYS 1CL,002,187089,Staff,0,1,30,30
1683673129336,PHYS 1CL,009,262693,Staff,9,0,30,21
1683673130359,PHYS 2B,A01,187097,Staff,55,0,115,60
1683673131386,PHYS 2C,A01,187099,Staff,63,0,115,52
1683673132413,PHYS 2CL,A01,187101,Staff,5,0,28,23
1683673132413,PHYS 2CL,A02,187102,Staff,15,0,28,13
1683673133439,PHYS 2D,A01,187123,Shotwell; Brian,95,0,115,20
1683673134475,PHYS 4B,A01,187133,Grinstein; Benjamin,35,0,50,15
1683673135501,POLI 10,A00,188819,Staff,0,4,50,50
1683673136524,POLI 11,A00,188827,Staff,43,0,50,7
1683673137548,POLI 13R,A00,188828,Staff,0,1,20,20
1683673138571,POLI 27,A01,188830,Elgin; Samuel Zincke,0,2,70,70
1683673139595,POLI 30,A00,188832,Desposato; Scott,30,0,50,20
1683673140624,POLI 102F,A00,188834,Staff,0,0,40,40
1683673141651,POLI 104A,A00,188852,Staff,13,0,30,17
1683673142679,POLI 104I,A00,188853,Staff,0,7,20,20
1683673143709,POLI 110B,A00,188854,Wiens; David,6,0,20,14
1683673144732,POLI 112A,A00,188855,Wiens; David,3,0,30,27
1683673145756,POLI 117R,A00,188856,Forman; Fonna,0,12,20,20
1683673146783,POLI 118,A00,188857,Ingham; Sean,8,0,20,12
1683673147809,POLI 120G,A00,188858,Staff,8,0,30,22
1683673148835,POLI 131CR,A00,188863,Hoston; Germaine,20,0,50,30
1683673149862,POLI 133,A00,188864,Nellis; Gareth Hb,44,0,50,6
1683673150889,POLI 134D,A00,188865,Desposato; Scott,27,0,30,3
1683673151912,POLI 142A,A00,188871,Gartzke; Erik,21,0,50,29
1683673152940,POLI 142K,A00,188874,Staff,38,0,50,12
1683673153966,POLI 143,A00,188940,Gartzke; Erik,16,0,30,14
1683673154993,POLI 153,A00,188943,Staff,2,0,20,18
1683673156017,POLI 160AA,A00,188944,Staff,11,0,40,29
1683673157042,POLI 170A,A00,188945,Staff,10,0,30,20
1683673159090,PSYC 1,A00,188952,Staff,37,0,90,53
1683673160117,PSYC 2,B00,188953,Staff,19,0,35,16
1683673161141,PSYC 6,A00,188970,Staff,47,0,60,13
1683673162167,PSYC 7,A00,188973,Staff,35,0,45,10
1683673163195,PSYC 60,A01,188980,Rickard; Timothy C.,42,0,60,18
1683673164281,PSYC 70,A01,189001,Steiner; Eric Tomas,22,0,45,23
1683673165309,PSYC 100,A00,189005,Lacefield; Katharine I,0,99,120,120
1683673166337,PSYC 102,A00,189008,Staff,8,0,30,22
1683673167361,PSYC 106,B00,189026,Gorman; Michael R.,27,0,60,33
1683673168384,PSYC 114,B01,189033,Winkielman; Piotr,0,31,30,30
1683673169409,PSYC 131,A00,189036,Anagnostaras; Stephan,0,43,60,60
1683673170435,PSYC 136,A00,189041,Lowe; Angela Beth,0,7,25,25
1683673171459,PSYC 137,A00,189057,Winkielman; Piotr,1,37,25,24
1683673172483,PSYC 144,A00,189107,Wixted; John T,0,11,50,50
1683673174528,PSYC 162,A00,189142,Staff,0,9,85,85
1683673175555,PSYC 172,A00,189144,Gorman; Michael R.,0,6,30,30
1683673177610,PSYC 179,A00,189146,Lacefield; Katharine I,0,87,120,120
1683673178637,PSYC 181,A00,189147,Anagnostaras; Stephan,0,44,90,90
1683673179659,PSYC 190R,A00,189148,Barner; David A.,0,23,80,80
1683673180683,PSYC 191,A00,189275,Rickard; Timothy C.,0,10,25,25
1683673181705,PSYC 193,A00,189276,Chapman; Eddie Nathaniel,0,1,0,4
1683673182730,PSYC 193L,A01,189281,Lowe; Angela Beth,9,0,20,11
1683673182730,PSYC 193L,B01,189285,Staff,28,0,35,7
1683673183755,RELI 149,A00,187137,Rahimi; Babak,7,0,40,33
1683673184783,SE 9,A01,187315,Staff,0,2,18,18
1683673185806,SE 101B,A00,187409,Staff,24,0,30,6
1683673186831,SE 110B,A00,187444,Staff,10,0,40,30
1683673187859,SE 130B,A00,187449,Staff,31,0,40,9
1683673188882,SE 150A,A00,187516,Staff,8,0,20,12
1683673189906,SE 154,A00,187528,Staff,29,0,50,21
1683673190929,SIO 3,A01,258171,Staff,35,0,40,5
1683673191957,SIO 10,A00,187144,Cook; Geoffrey W,0,7,75,75
1683673192980,SIO 45,A00,187152,Cook; Geoffrey W,0,7,100,100
1683673194004,SIO 109R,A00,194486,Staff,0,4,20,20
1683673196056,SIO 187,A01,187233,Kacev; David,12,0,40,28
1683673197080,SOCI 1,A01,258656,Thorpe; Charles Robert,28,0,30,2
1683673197080,SOCI 1,A02,258658,Thorpe; Charles Robert,30,0,30,0
1683673197080,SOCI 1,A03,258661,Thorpe; Charles Robert,25,0,25,0
1683673197080,SOCI 1,A04,258666,Thorpe; Charles Robert,22,0,25,3
1683673197080,SOCI 1,A05,258897,Thorpe; Charles Robert,22,0,25,3
1683673197080,SOCI 1,A06,258898,Thorpe; Charles Robert,25,0,25,0
1683673198106,SOCI 30,A01,258903,Pardo Guerra; Juan Pablo,14,0,30,16
1683673199133,SOCI 102,A00,258904,Staff,9,0,25,16
1683673200159,SOCI 106,A00,258905,Staff,19,0,25,6
1683673201183,SOCI 111,A00,258907,Ribas Norris; Janet Vanesa,26,0,30,4
1683673202206,SOCI 121R,A00,258908,Pardo Guerra; Juan Pablo,8,0,30,22
1683673203233,SOCI 126,A01,203330,Staff,14,0,20,6
1683673204260,SOCI 131,A00,258909,Thorpe; Charles Robert,30,0,60,30
1683673205286,SOCI 135,A00,258910,Payne; Christine Anna,0,11,30,30
1683673206310,SOCI 157,A00,258911,Staff,11,0,30,19
1683673207333,SOCI 184,A00,258912,Staff,25,0,30,5
1683673208356,SOCI 188D,A00,258913,Staff,22,0,30,8
1683673209379,SYN 2,001,187529,Staff,9,0,16,7
1683673209379,SYN 2,002,201452,Staff,0,20,16,16
1683673209379,SYN 2,003,201469,Staff,1,0,16,15
1683673210407,SYN 100,A01,187531,Staff,0,9,20,20
1683673210407,SYN 100,B01,201491,Staff,0,10,20,20
1683673211434,TDAC 1,A00,189286,Walsh; Kim C.,3,0,20,17
1683673211434,TDAC 1,B00,189287,Harting; Carla Kelso,10,0,20,10
1683673212457,TDAC 101,A00,189300,Walsh; Kim C.,16,0,20,4
1683673212457,TDAC 101,B00,189301,Harting; Carla Kelso,18,0,20,2
1683673213489,TDAC 102,A00,189304,Basso; Beatrice,14,0,20,6
1683673214515,TDAC 108,A00,189305,Staff,18,0,20,2
1683673215539,TDDE 131,A00,189310,Staff,19,0,20,1
1683673215539,TDDE 131,B00,189314,Staff,19,0,20,1
1683673215539,TDDE 131,C00,189315,Staff,48,0,50,2
1683673215539,TDDE 131,D00,189316,Staff,14,0,15,1
1683673215539,TDDE 131,E00,204841,Staff,20,0,20,0
1683673216567,TDGE 10,A00,189289,Staff,27,0,50,23
1683673216567,TDGE 10,B00,189290,Havis; Allan,0,1,50,50
1683673217593,TDGE 11,A00,189291,Fulton; Julia,0,4,50,50
1683673217593,TDGE 11,B00,189292,Staff,20,0,25,5
1683673217593,TDGE 11,C00,260270,Staff,0,0,0,0
1683673218617,TDGE 25,A00,189294,Staff,2,0,20,18
1683673219639,TDGE 124,A00,189318,Fulton; Julia,0,8,50,50
1683673220665,TDGE 125,A00,189319,Staff,13,0,25,12
1683673220665,TDGE 125,B00,189320,Staff,23,0,25,2
1683673221689,TDGE 127,A00,189322,Havis; Allan,0,0,50,50
1683673222714,TDHT 101,A00,189323,Staff,18,0,25,7
1683673222714,TDHT 101,B00,189324,Staff,25,0,25,0
1683673223738,TDHT 102,A00,189325,Staff,49,0,50,1
1683673224766,TDMV 1,A00,189295,Arcidiacono; Kristin,20,0,30,10
1683673224766,TDMV 1,B00,189296,Caligagan; Maria T.,24,0,30,6
1683673225792,TDMV 2,A00,189297,Sammartano; Tonnie,27,0,30,3
1683673225792,TDMV 2,B00,189299,Arcidiacono; Kristin,23,0,30,7
1683673226816,TDMV 3,A00,204998,Rincon; Alicia,22,0,30,8
1683673227844,TDMV 120,A00,189458,Sammartano; Tonnie,28,0,30,2
1683673228873,TDMV 138,A00,189541,Jun; Grace Shin Hae,20,0,40,20
1683673229904,TDMV 142,A00,189717,Caligagan; Tony,25,0,30,5
1683673229904,TDMV 142,B00,189718,Caligagan; Maria T.,25,0,30,5
1683673230932,TMC 2,A01,187533,Staff,25,0,25,0
1683673230932,TMC 2,A02,187534,Staff,25,0,25,0
1683673231958,USP 1,A01,187536,Kwak; Nancy,0,16,25,25
1683673232980,USP 5,A01,187538,Staff,9,0,25,16
1683673234004,USP 101,A00,199253,Staff,0,4,0,0
1683673235034,USP 124,A00,187562,Boomhower; Matthew Charles,0,0,30,30
1683673236057,USP 138,A00,187582,Staff,19,0,25,6
1683673237084,USP 152,A01,187597,Staff,3,0,25,22
1683673238110,USP 153,A00,187598,Staff,19,0,25,6
1683673239137,USP 168,A00,187607,Kwak; Nancy,2,0,5,3
1683673240165,USP 173,A00,187619,Staff,4,0,25,21
1683673241190,USP 181,A00,187638,Staff,0,4,25,25
1683673242213,VIS 103,A00,187650,Cruz; Edwin Teddy,17,0,75,58
1683673243235,VIS 110D,A00,187669,Staff,13,0,22,9
1683673244264,VIS 127C,A00,187720,Shen; Kuiyi,67,0,146,79
1683673245289,VIS 149,A00,187731,Yoldas; Pinar,1,14,22,21
1683673246321,VIS 151,A01,188091,Staff,22,0,34,12
1683673246321,VIS 151,A02,188092,Staff,11,0,34,23
1683673247343,VIS 160B,A00,188093,Stalbaum; Brett,0,1,10,10
1683673249391,WCWP 10B,A00,201720,Staff,10,0,15,5
1683673249391,WCWP 10B,B00,201722,Staff,9,0,15,6
1683673250415,WCWP 100,A00,201725,Gagnon; Jeffrey C,0,0,2,2
1683673250415,WCWP 100,B00,201727,Staff,0,4,15,15
1683673253539,ANBI 133,A00,258401,Wilder; Linnea Lorene,34,0,40,6
1683673254566,ANBI 140,A00,258395,Hrvoj Mihic; Branka,18,0,25,7
1683673255590,ANSC 120,A00,258402,Bialecki; Jon Anthony,26,0,40,14
1683673256614,ANSC 144,A00,258400,Staff,12,0,40,28
1683673258664,ANSC 166,A00,258396,Parish; Steven Martin,156,0,175,19
1683673259688,ANSC 180,A00,193533,Staff,8,0,20,12
1683673260715,ANSC 188,A00,258397,Jassal; Aftab,34,0,40,6
1683673261742,ANTH 3,A01,258316,Staff,23,0,30,7
1683673262767,ANTH 5,A00,258394,Semendeferi; Ekaterini,16,0,20,4
1683673263795,ANTH 21,A01,258331,Staff,4,0,40,36
1683673264818,ANTH 103,A00,258398,Varma; Saiba,15,0,25,10
1683673265848,AWP 10,001,202034,Staff,0,0,0,0
1683673265848,AWP 10,002,202035,Staff,0,0,0,0
1683673265848,AWP 10,003,202036,Staff,0,0,0,0
1683673265848,AWP 10,004,202037,Staff,0,0,0,0
1683673265848,AWP 10,005,202038,Staff,0,0,0,0
1683673265848,AWP 10,006,202039,Staff,0,0,0,0
1683673265848,AWP 10,007,202040,Staff,0,0,0,0
1683673265848,AWP 10,008,202041,Staff,0,0,0,0
1683673265848,AWP 10,009,202042,Staff,0,0,0,0
1683673265848,AWP 10,010,202043,Staff,0,0,0,0
1683673265848,AWP 10,011,202044,Staff,0,0,0,0
1683673265848,AWP 10,012,202045,Staff,0,0,0,0
1683673265848,AWP 10,013,202046,Staff,0,0,0,0
1683673265848,AWP 10,014,202047,Staff,0,0,0,0
1683673265848,AWP 10,015,202048,Staff,0,0,0,0
1683673265848,AWP 10,016,202049,Staff,0,0,0,0
1683673265848,AWP 10,017,202050,Staff,0,0,0,0
1683673265848,AWP 10,018,202051,Staff,0,0,0,0
1683673265848,AWP 10,019,202052,Staff,0,0,0,0
1683673265848,AWP 10,020,202053,Staff,0,0,0,0
1683673265848,AWP 10,021,202054,Staff,0,0,0,0
1683673265848,AWP 10,022,202055,Staff,0,0,0,0
1683673265848,AWP 10,023,202056,Staff,0,0,0,0
1683673265848,AWP 10,024,202057,Staff,0,0,0,0
1683673265848,AWP 10,025,202058,Staff,0,0,0,0
1683673265848,AWP 10,026,202059,Staff,0,0,0,0
1683673266888,AWP 102,001,202032,Staff,0,0,0,0
1683673266888,AWP 102,002,202033,Staff,0,0,0,0
1683673267965,BENG 100,A01,254234,Taylor Amos; Alyssa C,31,0,40,9
1683673268991,BENG 196,001,270013,Engler; Adam J.,9999,0,9999,0
1683673270016,BICD 100R,A01,202018,Smith; Laurie,0,7,32,32
1683673270016,BICD 100R,A02,202019,Smith; Laurie,0,3,32,32
1683673270016,BICD 100R,A03,202020,Smith; Laurie,0,1,32,32
1683673270016,BICD 100R,A04,202021,Smith; Laurie,6,0,32,26
1683673270016,BICD 100R,A05,202022,Smith; Laurie,11,0,32,21
1683673271044,BICD 136,A01,193242,Gustafson-Brown; Cindy,0,2,32,32
1683673271044,BICD 136,A02,193244,Gustafson-Brown; Cindy,13,0,32,19
1683673272070,BIEB 102,A01,193249,Butler; Shannon Rhey,1,2,32,31
1683673272070,BIEB 102,A02,193251,Butler; Shannon Rhey,0,0,32,32
1683673272070,BIEB 102,A03,193253,Butler; Shannon Rhey,0,0,32,32
1683673272070,BIEB 102,A04,193255,Butler; Shannon Rhey,13,0,32,19
1683673272070,BIEB 102,A05,193265,Butler; Shannon Rhey,25,0,32,7
1683673272070,BIEB 102,A06,193269,Butler; Shannon Rhey,14,0,32,18
1683673274117,BIEB 150,A01,193274,Staff,0,0,32,32
1683673274117,BIEB 150,A02,193285,Staff,24,0,32,8
1683673275143,BIEB 194,A00,193286,Kurle; Carolyn M.,20,0,32,12
1683673276168,BILD 1,A01,192291,Staff,15,0,32,17
1683673276168,BILD 1,A02,192292,Staff,30,0,32,2
1683673276168,BILD 1,B01,192520,Reuther; Keefe,0,1,0,0
1683673276168,BILD 1,B02,192532,Reuther; Keefe,0,1,0,0
1683673277198,BILD 3,A01,192556,Butler; Shannon Rhey,0,0,32,32
1683673277198,BILD 3,A02,192581,Butler; Shannon Rhey,0,1,32,32
1683673277198,BILD 3,A03,192611,Butler; Shannon Rhey,20,0,32,12
1683673277198,BILD 3,A04,192612,Butler; Shannon Rhey,24,0,32,8
1683673277198,BILD 3,A05,192613,Butler; Shannon Rhey,26,0,32,6
1683673277198,BILD 3,A06,192679,Butler; Shannon Rhey,27,0,32,5
1683673277198,BILD 3,A07,192682,Butler; Shannon Rhey,20,0,32,12
1683673278223,BILD 4,A01,192836,Reuther; Keefe,1,0,24,23
1683673278223,BILD 4,A02,193044,Reuther; Keefe,4,0,24,20
1683673279251,BILD 10,A01,193142,Gustafson-Brown; Cindy,29,0,32,3
1683673279251,BILD 10,A02,193149,Gustafson-Brown; Cindy,31,0,32,1
1683673280279,BIMM 100,A01,193301,Staff,0,6,32,32
1683673280279,BIMM 100,A02,193312,Staff,0,7,32,32
1683673280279,BIMM 100,A03,193323,Staff,0,10,32,32
1683673281308,BIMM 101,A01,193329,McDonnell; Lisa Marie,1,4,24,23
1683673281308,BIMM 101,A02,193339,McDonnell; Lisa Marie,1,4,24,23
1683673281308,BIMM 101,B01,193354,McDonnell; Lisa Marie,0,4,24,24
1683673281308,BIMM 101,B02,193357,McDonnell; Lisa Marie,0,3,24,24
1683673282333,BIMM 110,A01,193377,Tat; John,0,11,32,32
1683673282333,BIMM 110,A02,193378,Tat; John,0,10,32,32
1683673283361,BIMM 120,A01,206116,Staff,0,0,32,32
1683673283361,BIMM 120,A02,206117,Staff,7,0,32,25
1683673283361,BIMM 120,A03,206121,Staff,21,0,32,11
1683673284386,BIPN 100,A01,193393,Park; Ji Young,0,15,32,32
1683673284386,BIPN 100,A02,193402,Park; Ji Young,0,14,32,32
1683673284386,BIPN 100,A03,193413,Park; Ji Young,0,14,32,32
1683673284386,BIPN 100,A04,193414,Park; Ji Young,0,13,32,32
1683673285410,BIPN 102,A01,193429,Staff,0,0,32,32
1683673285410,BIPN 102,A02,193438,Staff,18,0,32,14
1683673286435,BIPN 106,A01,193450,Reyes Gonzalez; Catalina,0,2,40,40
1683673287460,BIPN 134,A01,193465,Cooke; James Edward,0,0,32,32
1683673287460,BIPN 134,A02,193474,Cooke; James Edward,25,0,32,7
1683673287460,BIPN 134,A03,193485,Cooke; James Edward,29,0,32,3
1683673287460,BIPN 134,A04,193486,Cooke; James Edward,20,0,32,12
1683673287460,BIPN 134,A05,193491,Cooke; James Edward,31,0,32,1
1683673287460,BIPN 134,A06,193501,Cooke; James Edward,30,0,32,2
1683673287460,BIPN 134,A07,193510,Cooke; James Edward,29,0,32,3
1683673289513,BISP 194,A00,222522,Staff,14,0,32,18
1683673290538,CAT 124,A01,202407,Staff,19,0,25,6
1683673291564,CAT 125,A00,202408,Marchisotto; Jennifer Anne,2,0,20,18
1683673292588,CAT 125R,A00,202409,Smith; Lauryn Alissa,0,11,20,20
1683673292588,CAT 125R,B00,202410,Morales; Celeste Georgianna,0,11,20,20
1683673292588,CAT 125R,C00,202411,Irwin; Matthew Joseph,0,12,20,20
1683673293616,CENG 15,A01,204712,Yang; Kesong,0,1,0,0
1683673294640,CENG 114,A00,202070,Jahed Motlagh; Zeinab,5,0,20,15
1683673295663,CGS 105,A00,185477,Wesling; Megan E.,24,0,40,16
1683673296687,CGS 106,A00,185494,Staff,11,0,22,11
1683673297713,CGS 108,A00,185495,Staff,14,0,20,6
1683673298737,CGS 114,A00,185496,Staff,13,0,18,5
1683673299760,CGS 119,A00,185501,Staff,15,0,20,5
1683673300788,CGS 120,A00,185511,Staff,12,0,20,8
1683673301813,CHEM 4,A01,184675,Bussey; Thomas J,97,0,100,3
1683673302837,CHEM 6A,A01,184677,Staff,32,0,60,28
1683673303868,CHEM 6B,A01,184679,Staff,63,0,100,37
1683673304893,CHEM 6C,A01,184681,Bussey; Thomas J,0,0,50,50
1683673304893,CHEM 6C,A02,184682,Bussey; Thomas J,32,0,50,18
1683673305920,CHEM 40A,A01,184684,Albizati; Kim F.,33,0,100,67
1683673306944,CHEM 40B,A01,184686,Albizati; Kim F.,0,22,100,100
1683673307967,CHEM 41B,A01,184690,Staff,51,0,100,49
1683673308991,COGS 3,A01,184715,Boyle; Mary E. T.,0,27,40,40
1683673310015,COGS 14B,A01,185172,Staff,0,14,38,38
1683673311042,COGS 18,A01,184736,Staff,14,0,80,66
1683673312068,COGS 100,A01,184932,Staff,0,8,73,73
1683673313091,COGS 101A,A01,184935,Staff,0,40,30,30
1683673314115,COGS 101B,A01,184944,Staff,0,2,30,30
1683673315139,COGS 101C,A01,184946,Staff,0,10,30,30
1683673316163,COGS 102A,A01,184951,Johnson; Christine M.,2,0,40,38
1683673317190,COGS 107B,A01,184953,Mooshagian; Eric Frederick,0,52,40,40
1683673318212,COGS 118B,A01,184959,Gupta; Anjum,0,50,40,40
1683673319239,COGS 153,A00,184961,Staff,0,16,30,30
1683673320266,COGS 177,A00,184962,Staff,0,21,30,30
1683673321291,COGS 187A,A01,184969,Boyle; Mary E. T.,0,19,40,40
1683673322316,COMM 10,A01,185174,Staff,0,5,25,25
1683673322316,COMM 10,A02,185189,Staff,0,2,25,25
1683673322316,COMM 10,A03,269821,Staff,0,1,0,0
1683673323344,COMM 100B,A01,185475,Staff,0,1,0,1
1683673323344,COMM 100B,A02,185476,Staff,11,0,25,14
1683673324369,COMM 100C,A01,185314,Staff,1,0,25,24
1683673324369,COMM 100C,A02,185327,Staff,17,0,25,8
1683673325393,COMM 110M,A00,185349,Staff,0,0,40,40
1683673326420,COMM 113T,A00,185352,Staff,25,0,40,15
1683673327446,COMM 114I,A00,185353,Staff,31,0,40,9
1683673328470,COMM 131,A00,185354,Staff,17,0,30,13
1683673329493,CSE 8A,A50,185358,Cao; Yingjun,0,46,10,10
1683673330521,CSE 8B,A01,185362,Staff,0,48,50,50
1683673331546,CSE 11,A01,185416,Cao; Yingjun,0,91,10,10
1683673332571,CSE 20,A01,185445,Briones; Jor-el Thomas Caparas,4,0,25,21
1683673333595,CSE 21,A01,185447,Staff,9,0,50,41
1683673334620,CSE 101,A01,185451,Staff,0,13,50,50
1683673334620,CSE 101,B01,185453,Jones; Miles E,0,14,50,50
1683673336673,CSE 141,A01,185458,Eldon; John,16,0,100,84
1683673337797,CSE 141L,A01,185461,Eldon; John,8,0,100,92
1683673338825,CSE 142,A01,185463,Staff,34,0,60,26
1683673338825,CSE 142,B01,201355,Staff,0,7,60,60
1683673339852,CSE 142L,A01,185470,Staff,34,0,60,26
1683673339852,CSE 142L,B01,201417,Staff,0,6,60,60
1683673340876,CSE 190,A00,201433,Staff,32,0,49,17
1683673341901,DOC 1,A01,259136,Strom; Megan C.,7,0,15,8
1683673341901,DOC 1,A02,259137,Strom; Megan C.,14,0,15,1
1683673341901,DOC 1,A03,259138,Strom; Megan C.,14,0,15,1
1683673341901,DOC 1,A04,259139,Strom; Megan C.,14,0,15,1
1683673342925,DOC 100D,A00,259140,Pass; Natalye Joann,14,0,25,11
1683673343953,DSGN 1,A01,184749,Rill; Bryan,0,26,30,30
1683673344976,DSGN 100,A01,185168,Staff,0,2,25,25
1683673346000,ECE 5,A01,185626,Morris; Karcher William,0,12,0,0
1683673347027,ECE 101,A01,185628,Staff,14,0,70,56
1683673348053,ECE 107,A01,185635,Baghdadchi; Saharnaz,0,0,20,20
1683673348053,ECE 107,A02,185638,Baghdadchi; Saharnaz,1,0,20,19
1683673349080,ECE 148,A01,185647,Silberman; Jack,0,0,16,16
1683673350104,ECON 1,A01,185537,Crane; Meredith Helen,54,0,70,16
1683673351129,ECON 3,A01,185549,Crane; Meredith Helen,29,0,70,41
1683673352156,ECON 4,A01,203354,Anderson; John Charles,0,5,10,10
1683673353180,ECON 100A,A01,185574,Staff,0,5,40,40
1683673354208,ECON 100B,A01,185576,Staff,0,12,50,50
1683673355232,ECON 100C,A01,185589,Newhouse; Herbert S,30,0,70,40
1683673356261,ECON 105,A00,185608,Vespa; Emanuel Ignacio,19,0,35,16
1683673357289,ECON 109,A01,185610,Shishkin; Denis,9,0,35,26
1683673358313,ECON 110A,A01,185612,Staff,9,0,40,31
1683673359336,ECON 120A,A01,185615,Staff,19,0,40,21
1683673360362,ECON 120C,A01,185617,Sun; Yixiao,0,21,70,70
1683673361386,ECON 144,A00,203346,Squires; Dale E,2,0,35,33
1683673362410,ECON 171,A01,203349,Newhouse; Herbert S,0,1,35,35
1683673363434,ECON 173A,A01,185621,Toda; Alexis Akira,20,0,35,15
1683673364459,EDS 25,A01,202413,Staff,0,1,0,0
1683673364459,EDS 25,A02,202414,Staff,0,1,0,0
1683673364459,EDS 25,A03,202415,Staff,0,0,0,0
1683673364459,EDS 25,A04,202416,Staff,0,1,0,0
1683673364459,EDS 25,A05,202439,Staff,0,0,0,0
1683673364459,EDS 25,A06,202440,Staff,0,0,0,0
1683673364459,EDS 25,B01,202631,Staff,0,0,0,0
1683673364459,EDS 25,B02,202632,Staff,0,0,0,0
1683673364459,EDS 25,B03,202639,Staff,0,0,0,0
1683673364459,EDS 25,B04,202640,Staff,0,0,0,0
1683673364459,EDS 25,B05,202643,Staff,0,0,0,0
1683673364459,EDS 25,B06,202644,Staff,0,0,0,0
1683673365482,EDS 38,A01,202659,Black; Alison Michelle,24,0,25,1
1683673366509,EDS 115,A00,202652,Staff,18,0,30,12
1683673367533,EDS 125,A00,202649,Staff,13,0,30,17
1683673368557,EDS 126,A01,203332,Staff,30,0,30,0
1683673369581,EDS 139,A00,202838,Staff,16,0,25,9
1683673370607,EDS 146,A01,202655,Staff,14,0,25,11
1683673371688,ENG 15,A00,185667,Staff,0,1,0,0
1683673371688,ENG 15,B00,185672,Staff,0,0,0,0
1683673371688,ENG 15,C00,185675,Staff,0,0,0,0
1683673371688,ENG 15,D00,185682,Staff,0,0,0,0
1683673371688,ENG 15,E00,185684,Staff,0,0,0,0
1683673372713,ETHN 103,A00,185710,Staff,0,8,35,35
1683673373748,ETHN 103A,A00,199228,Man; Simeon S,0,0,9,9
1683673374776,ETHN 109,A00,185711,Staff,15,0,35,20
1683673375800,ETHN 142,A00,185726,Staff,0,4,30,30
1683673376826,ETHN 163J,A00,199229,Man; Simeon S,5,0,8,3
1683673377850,ETHN 168,A00,185727,Staff,7,0,10,3
1683673378873,ETHN 182,A00,185728,Staff,0,0,35,35
1683673379897,ETHN 183,A00,185737,Staff,9,0,18,9
1683673380922,GLBH 111,A01,209361,Burgos; Jose L.,0,0,0,0
1683673382973,HIEU 104,A00,185792,Staff,14,0,20,6
1683673384000,HIEU 115,A00,185800,Staff,0,0,20,20
1683673385024,HIEU 128,A00,185801,Staff,0,9,20,20
1683673386048,HIEU 147,A00,185802,Staff,15,0,20,5
1683673387071,HIEU 154,A00,185823,Staff,11,0,20,9
1683673388097,HILA 102,A00,185826,Staff,14,0,20,6
1683673389121,HILD 2C,A01,185778,Staff,0,13,20,20
1683673390146,HILD 7B,A01,185780,Kwak; Nancy,0,17,32,32
1683673390146,HILD 7B,A02,185781,Kwak; Nancy,0,18,32,32
1683673391172,HILD 30,A01,185791,Staff,12,0,20,8
1683673392196,HISC 119,A00,185830,Golan; Tal,0,9,20,20
1683673393220,HITO 156GS,A00,185831,Patterson; Patrick H.,0,0,0,23
1683673394245,HIUS 103,A00,185832,Man; Simeon S,0,4,20,20
1683673395272,HIUS 117,A00,185836,Kwak; Nancy,2,0,20,18
1683673396298,HIUS 125,A00,185840,Man; Simeon S,0,2,23,23
1683673397328,HIUS 149,A00,185845,Staff,1,0,20,19
1683673398352,HUM 3,A01,185882,Zavodny; Tatiana Sophia,0,8,50,50
1683673398352,HUM 3,B01,185899,Caldwell; Michael Alan,0,18,50,50
1683673399375,HUM 3GS,A00,185900,Patterson; Patrick H.,0,0,0,23
1683673400399,HUM 4,A01,185938,Zroka; Amy Liane,29,0,50,21
1683673400399,HUM 4,B01,185956,Watkins; Eric,0,5,50,50
1683673400399,HUM 4,B02,202209,Watkins; Eric,0,5,50,50
1683673400399,HUM 4,B03,202210,Watkins; Eric,0,5,50,50
1683673401424,HUM 5,A01,185958,West; Geoffrey Scott,0,0,50,50
1683673401424,HUM 5,A02,202215,West; Geoffrey Scott,0,0,50,50
1683673402450,INTL 190,A00,185959,Gagnon; Jeffrey C,0,0,0,9
1683673402450,INTL 190,B00,185960,Lettieri; Michael Joseph,0,0,0,2
1683673403473,JAPN 180,A00,254509,Staff,5,0,30,25
1683673404498,LATI 10,A01,202853,Kennemore; Amy Michelle,4,0,35,31
1683673404498,LATI 10,A02,202854,Kennemore; Amy Michelle,2,0,35,33
1683673404498,LATI 10,A03,270054,Kennemore; Amy Michelle,30,0,30,0
1683673405521,LATI 180,A00,202855,Kennemore; Amy Michelle,11,0,20,9
1683673406545,LAWS 101,A00,201767,Golan; Tal,0,7,40,40
1683673407571,LIFR 1C,A00,185961,Staff,6,0,20,14
1683673408595,LIFR 1CX,A00,185962,Staff,7,0,20,13
1683673409619,LIFR 1D,A00,185963,Staff,7,0,20,13
1683673410647,LIFR 1DX,A00,185964,Staff,7,0,20,13
1683673411671,LIGN 101,A01,186039,Staff,43,0,50,7
1683673412695,LIGN 165,A00,186040,Staff,15,0,50,35
1683673413720,LTCS 108,A00,186041,Staff,5,0,10,5
1683673414745,LTCS 119,A00,186042,Staff,15,0,20,5
1683673415768,LTCS 130,A00,186043,Wesling; Megan E.,15,0,25,10
1683673417819,LTEA 138,A00,186119,Staff,14,0,40,26
1683673418847,LTEN 124,A00,186148,Staff,5,0,25,20
1683673419871,LTEN 178,A00,186149,Staff,7,0,15,8
1683673420895,LTEN 181,A00,186150,Blanco; John D,34,0,40,6
1683673421924,LTWL 120,A00,186160,Staff,19,0,25,6
1683673422949,LTWL 165,A00,186161,Staff,22,0,25,3
1683673423977,LTWR 100,A00,186162,Staff,0,5,15,15
1683673425000,LTWR 102,A00,186163,Doller; Ben,5,0,15,10
1683673426029,MAE 8,A01,186412,Staff,0,0,0,0
1683673427055,MAE 30B,A00,186445,Bahadori; Mohammad Yousef,82,0,100,18
1683673428083,MAE 40,A00,186592,Bewley; Thomas R,10,0,50,40
1683673429108,MAE 101B,A00,186593,Bahadori; Mohammad Yousef,80,0,100,20
1683673430135,MAE 105,A00,186594,Bandaru; Prabhakar,10,0,50,40
1683673431159,MAE 107,A00,186599,Pham; Hieu Tan,0,7,120,120
1683673432185,MAE 148,A01,186660,Silberman; Jack,3,0,16,13
1683673433211,MATH 10A,A01,188095,Staff,0,6,35,35
1683673434240,MATH 10B,A01,188097,Bowers; Adam R.,0,12,30,30
1683673434240,MATH 10B,A02,188099,Bowers; Adam R.,0,11,30,30
1683673434240,MATH 10B,B01,188104,Bowers; Adam R.,0,10,30,30
1683673434240,MATH 10B,B02,188106,Bowers; Adam R.,1,9,30,29
1683673435268,MATH 10C,A01,188111,Staff,0,20,30,30
1683673435268,MATH 10C,A02,188127,Staff,0,19,30,30
1683673435268,MATH 10C,A03,188131,Staff,0,19,30,30
1683673435268,MATH 10C,B01,188218,Staff,17,0,30,13
1683673435268,MATH 10C,B02,188244,Staff,13,0,30,17
1683673435268,MATH 10C,B03,188277,Staff,14,0,30,16
1683673436293,MATH 18,A01,188344,Bach; Quang Tran,18,0,30,12
1683673436293,MATH 18,A02,188345,Bach; Quang Tran,11,0,30,19
1683673436293,MATH 18,B01,188353,Bach; Quang Tran,11,0,30,19
1683673436293,MATH 18,B02,188354,Bach; Quang Tran,19,0,30,11
1683673437317,MATH 20A,A01,188374,Staff,11,0,35,24
1683673438339,MATH 20B,A01,188382,Ohm; Ko Woon,7,0,30,23
1683673438339,MATH 20B,A02,188383,Ohm; Ko Woon,22,0,30,8
1683673438339,MATH 20B,B01,188385,Ohm; Ko Woon,7,0,30,23
1683673438339,MATH 20B,B02,188392,Ohm; Ko Woon,22,0,30,8
1683673439363,MATH 20C,A01,188394,Harel; Guershon,10,0,30,20
1683673439363,MATH 20C,A02,188395,Harel; Guershon,13,0,30,17
1683673439363,MATH 20C,B01,188404,Harel; Guershon,5,0,30,25
1683673439363,MATH 20C,B02,188405,Harel; Guershon,18,0,30,12
1683673440389,MATH 20D,A01,188414,Hammock; Frances H,0,1,30,30
1683673440389,MATH 20D,A02,188415,Hammock; Frances H,0,1,30,30
1683673440389,MATH 20D,B01,188447,Hammock; Frances H,0,1,30,30
1683673440389,MATH 20D,B02,188486,Hammock; Frances H,3,0,30,27
1683673441414,MATH 20E,A01,188649,Staff,21,0,30,9
1683673441414,MATH 20E,A02,188650,Staff,20,0,30,10
1683673441414,MATH 20E,A03,188673,Staff,0,0,30,30
1683673442437,MATH 102,A01,188675,Staff,0,38,35,35
1683673443461,MATH 103B,A01,188681,Staff,3,0,35,32
1683673443461,MATH 103B,B01,188692,Staff,5,0,35,30
1683673444489,MATH 109,A01,188695,Salehi Golsefidy; Alireza,24,0,35,11
1683673444489,MATH 109,A02,188696,Salehi Golsefidy; Alireza,25,0,35,10
1683673445513,MATH 120A,A01,188698,Eggers; John Dietrich,7,0,35,28
1683673446540,MATH 142B,A01,188736,Ioana; Adrian,1,1,30,29
1683673446540,MATH 142B,A02,188741,Ioana; Adrian,0,1,30,30
1683673446540,MATH 142B,A03,188743,Ioana; Adrian,0,1,30,30
1683673447564,MATH 168A,A01,188790,Staff,0,11,35,35
1683673448593,MATH 170A,A01,188803,Nie; Jiawang,0,2,35,35
1683673448593,MATH 170A,A02,188811,Nie; Jiawang,0,0,35,35
1683673448593,MATH 170A,A03,188814,Nie; Jiawang,0,0,35,35
1683673448593,MATH 170A,A04,188815,Nie; Jiawang,6,0,35,29
1683673449617,MATH 193B,A01,188817,Staff,0,0,35,35
1683673449617,MATH 193B,A02,188818,Staff,5,0,35,30
1683673450640,MGT 4,A01,202857,Anderson; John Charles,60,0,80,20
1683673451662,MGT 12,A00,202858,Lindenberger; Wade Douglas,40,0,90,50
1683673452686,MGT 18,A00,202859,Staff,74,0,90,16
1683673453710,MGT 18GS,A00,202860,McKay; Michael J,13,0,28,15
1683673454737,MGT 45,A00,202861,Pecore; Joseph P.,10,0,90,80
1683673455762,MGT 100,A00,202863,Yavorsky; Daniel Ryan,28,0,90,62
1683673456794,MGT 103,A00,202864,Ehrich; Kristine R,0,18,90,90
1683673457819,MGT 112,A00,202865,Ehrich; Kristine R,15,0,90,75
1683673458846,MGT 121A,A00,202868,Staff,90,20,90,0
1683673459873,MGT 131B,A00,202869,Anderson; John Charles,59,0,90,31
1683673460898,MGT 136,A00,202871,Lindenberger; Wade Douglas,83,0,90,7
1683673461925,MGT 164,A00,202873,Staff,0,67,90,91
1683673462950,MGT 164GS,A00,202874,McKay; Mary A,13,0,28,15
1683673463972,MGT 180,A00,202875,Staff,0,51,90,91
1683673464997,MMW 11R,A01,205019,Herbst; Matthew,0,0,30,30
1683673464997,MMW 11R,A02,205026,Herbst; Matthew,29,0,30,1
1683673466027,MMW 15,A01,193512,Chang; Edmond Yi-Teh,0,8,28,28
1683673466027,MMW 15,A02,193513,Chang; Edmond Yi-Teh,0,5,28,28
1683673466027,MMW 15,A03,193514,Chang; Edmond Yi-Teh,0,5,28,28
1683673466027,MMW 15,A04,193515,Chang; Edmond Yi-Teh,0,5,28,28
1683673466027,MMW 15,A05,193516,Chang; Edmond Yi-Teh,0,5,28,28
1683673466027,MMW 15,A06,193517,Chang; Edmond Yi-Teh,0,6,28,28
1683673466027,MMW 15,B01,193519,Chang; Edmond Yi-Teh,0,5,28,28
1683673466027,MMW 15,B02,193520,Chang; Edmond Yi-Teh,0,5,28,28
1683673466027,MMW 15,B03,193521,Chang; Edmond Yi-Teh,0,5,28,28
1683673466027,MMW 15,B04,193522,Chang; Edmond Yi-Teh,0,5,28,28
1683673466027,MMW 15,B05,193523,Chang; Edmond Yi-Teh,0,5,28,28
1683673466027,MMW 15,B06,193524,Chang; Edmond Yi-Teh,0,5,28,28
1683673467055,MMW 122,A01,193526,Rahimi; Babak,0,16,28,28
1683673467055,MMW 122,A02,193527,Rahimi; Babak,0,15,28,28
1683673467055,MMW 122,A03,193528,Rahimi; Babak,0,0,0,0
1683673467055,MMW 122,A04,193529,Rahimi; Babak,0,0,0,0
1683673468083,MUS 1A,A01,186663,Staff,1,19,35,34
1683673469111,MUS 4,A01,186715,Staff,0,12,35,35
1683673470135,MUS 5R,A01,186796,Dubnov; Shlomo,0,17,35,35
1683673471159,MUS 6,A01,186798,Staff,0,5,25,25
1683673472185,MUS 7,A01,186830,Staff,11,0,35,24
1683673473209,MUS 8,A01,186930,Staff,0,27,35,35
1683673474234,MUS 15,A01,186932,Staff,0,15,35,35
1683673474234,MUS 15,B01,186934,Staff,1,17,35,34
1683673475314,MUS 80,A00,186935,Staff,0,0,20,20
1683673475314,MUS 80,B00,186936,Staff,24,0,25,1
1683673476337,NANO 11,A00,204702,Lipomi; Darren John,0,0,0,0
1683673477361,NANO 15,A01,204709,Yang; Kesong,0,1,0,0
1683673478385,NANO 114,A00,202069,Jahed Motlagh; Zeinab,3,0,10,7
1683673479413,PHIL 1,A00,186955,Grush; Rick Scott,31,0,40,9
1683673480437,PHIL 10,A01,186973,Grush; Rick Scott,27,0,35,8
1683673480437,PHIL 10,A02,186974,Grush; Rick Scott,33,0,35,2
1683673481462,PHIL 13,A01,186976,Staff,3,0,35,32
1683673481462,PHIL 13,A02,186977,Staff,16,0,35,19
1683673482495,PHIL 14,A01,186979,Staff,31,0,35,4
1683673482495,PHIL 14,A02,186986,Staff,32,0,35,3
1683673483522,PHIL 28,A01,186988,Staff,16,0,30,14
1683673483522,PHIL 28,A02,186989,Staff,1,0,30,29
1683673483522,PHIL 28,A03,186990,Staff,10,0,30,20
1683673483522,PHIL 28,A04,186991,Staff,26,0,30,4
1683673484550,PHIL 120,A00,186997,Staff,23,0,40,17
1683673485576,PHIL 137,A00,187003,Staff,7,0,40,33
1683673486599,PHIL 150,A00,187015,Staff,47,0,70,23
1683673487626,PHIL 167,A00,187021,Lamey; Andy M.,34,0,40,6
1683673488654,PHIL 174,A01,202226,Staff,17,0,20,3
1683673488654,PHIL 174,A02,202235,Staff,20,0,20,0
1683673489680,PHIL 191A,A00,258918,Staff,0,0,1,1
1683673490704,PHYS 1A,A00,187028,Staff,26,0,60,34
1683673491729,PHYS 1AL,001,187036,Staff,3,0,30,27
1683673491729,PHYS 1AL,002,187049,Staff,18,0,30,12
1683673492754,PHYS 1B,A00,187058,Staff,22,0,60,38
1683673493779,PHYS 1BL,001,187064,Staff,0,1,30,30
1683673493779,PHYS 1BL,002,187070,Staff,4,0,30,26
1683673494803,PHYS 1C,A00,187082,Staff,29,0,120,91
1683673495828,PHYS 1CL,001,187088,Staff,0,9,30,30
1683673495828,PHYS 1CL,002,187089,Staff,0,1,30,30
1683673495828,PHYS 1CL,009,262693,Staff,9,0,30,21
1683673496852,PHYS 2B,A01,187097,Staff,55,0,115,60
1683673497879,PHYS 2C,A01,187099,Staff,63,0,115,52
1683673498907,PHYS 2CL,A01,187101,Staff,5,0,28,23
1683673498907,PHYS 2CL,A02,187102,Staff,15,0,28,13
1683673499930,PHYS 2D,A01,187123,Shotwell; Brian,95,0,115,20
1683673500954,PHYS 4B,A01,187133,Grinstein; Benjamin,35,0,50,15
1683673501978,POLI 10,A00,188819,Staff,0,4,50,50
1683673503006,POLI 11,A00,188827,Staff,43,0,50,7
1683673504030,POLI 13R,A00,188828,Staff,0,1,20,20
1683673505055,POLI 27,A01,188830,Elgin; Samuel Zincke,0,2,70,70
1683673506080,POLI 30,A00,188832,Desposato; Scott,30,0,50,20
1683673507104,POLI 102F,A00,188834,Staff,0,0,40,40
1683673508130,POLI 104A,A00,188852,Staff,13,0,30,17
1683673509154,POLI 104I,A00,188853,Staff,0,7,20,20
1683673510178,POLI 110B,A00,188854,Wiens; David,6,0,20,14
1683673511206,POLI 112A,A00,188855,Wiens; David,3,0,30,27
1683673512233,POLI 117R,A00,188856,Forman; Fonna,0,12,20,20
1683673513257,POLI 118,A00,188857,Ingham; Sean,8,0,20,12
1683673514281,POLI 120G,A00,188858,Staff,8,0,30,22
1683673515305,POLI 131CR,A00,188863,Hoston; Germaine,20,0,50,30
1683673516331,POLI 133,A00,188864,Nellis; Gareth Hb,44,0,50,6
1683673517355,POLI 134D,A00,188865,Desposato; Scott,27,0,30,3
1683673518379,POLI 142A,A00,188871,Gartzke; Erik,21,0,50,29
1683673519402,POLI 142K,A00,188874,Staff,38,0,50,12
1683673520426,POLI 143,A00,188940,Gartzke; Erik,16,0,30,14
1683673521449,POLI 153,A00,188943,Staff,2,0,20,18
1683673522472,POLI 160AA,A00,188944,Staff,11,0,40,29
1683673523498,POLI 170A,A00,188945,Staff,10,0,30,20
1683673525548,PSYC 1,A00,188952,Staff,37,0,90,53
1683673526572,PSYC 2,B00,188953,Staff,19,0,35,16
1683673527597,PSYC 6,A00,188970,Staff,47,0,60,13
1683673528624,PSYC 7,A00,188973,Staff,35,0,45,10
1683673529652,PSYC 60,A01,188980,Rickard; Timothy C.,42,0,60,18
1683673530677,PSYC 70,A01,189001,Steiner; Eric Tomas,22,0,45,23
1683673531711,PSYC 100,A00,189005,Lacefield; Katharine I,0,99,120,120
1683673532736,PSYC 102,A00,189008,Staff,8,0,30,22
1683673533759,PSYC 106,B00,189026,Gorman; Michael R.,27,0,60,33
1683673534783,PSYC 114,B01,189033,Winkielman; Piotr,0,31,30,30
1683673535810,PSYC 131,A00,189036,Anagnostaras; Stephan,0,43,60,60
1683673536838,PSYC 136,A00,189041,Lowe; Angela Beth,0,7,25,25
1683673537862,PSYC 137,A00,189057,Winkielman; Piotr,1,37,25,24
1683673538889,PSYC 144,A00,189107,Wixted; John T,0,11,50,50
1683673540942,PSYC 162,A00,189142,Staff,0,9,85,85
1683673541964,PSYC 172,A00,189144,Gorman; Michael R.,0,6,30,30
1683673544013,PSYC 179,A00,189146,Lacefield; Katharine I,0,87,120,120
1683673545037,PSYC 181,A00,189147,Anagnostaras; Stephan,0,44,90,90
1683673546061,PSYC 190R,A00,189148,Barner; David A.,0,23,80,80
1683673547088,PSYC 191,A00,189275,Rickard; Timothy C.,0,10,25,25
1683673548115,PSYC 193,A00,189276,Chapman; Eddie Nathaniel,0,1,0,4
1683673549139,PSYC 193L,A01,189281,Lowe; Angela Beth,9,0,20,11
1683673549139,PSYC 193L,B01,189285,Staff,28,0,35,7
1683673550167,RELI 149,A00,187137,Rahimi; Babak,7,0,40,33
1683673551192,SE 9,A01,187315,Staff,0,2,18,18
1683673552214,SE 101B,A00,187409,Staff,24,0,30,6
1683673553238,SE 110B,A00,187444,Staff,10,0,40,30
1683673554262,SE 130B,A00,187449,Staff,31,0,40,9
1683673555286,SE 150A,A00,187516,Staff,8,0,20,12
1683673556314,SE 154,A00,187528,Staff,29,0,50,21
1683673557337,SIO 3,A01,258171,Staff,35,0,40,5
1683673558362,SIO 10,A00,187144,Cook; Geoffrey W,0,7,75,75
1683673559386,SIO 45,A00,187152,Cook; Geoffrey W,0,7,100,100
1683673560411,SIO 109R,A00,194486,Staff,0,4,20,20
1683673562463,SIO 187,A01,187233,Kacev; David,12,0,40,28
1683673563488,SOCI 1,A01,258656,Thorpe; Charles Robert,28,0,30,2
1683673563488,SOCI 1,A02,258658,Thorpe; Charles Robert,30,0,30,0
1683673563488,SOCI 1,A03,258661,Thorpe; Charles Robert,25,0,25,0
1683673563488,SOCI 1,A04,258666,Thorpe; Charles Robert,22,0,25,3
1683673563488,SOCI 1,A05,258897,Thorpe; Charles Robert,22,0,25,3
1683673563488,SOCI 1,A06,258898,Thorpe; Charles Robert,25,0,25,0
1683673564512,SOCI 30,A01,258903,Pardo Guerra; Juan Pablo,14,0,30,16
1683673565536,SOCI 102,A00,258904,Staff,9,0,25,16
1683673566560,SOCI 106,A00,258905,Staff,19,0,25,6
1683673567587,SOCI 111,A00,258907,Ribas Norris; Janet Vanesa,26,0,30,4
1683673568612,SOCI 121R,A00,258908,Pardo Guerra; Juan Pablo,8,0,30,22
1683673569640,SOCI 126,A01,203330,Staff,14,0,20,6
1683673570670,SOCI 131,A00,258909,Thorpe; Charles Robert,30,0,60,30
1683673571695,SOCI 135,A00,258910,Payne; Christine Anna,0,11,30,30
1683673572725,SOCI 157,A00,258911,Staff,11,0,30,19
1683673573752,SOCI 184,A00,258912,Staff,25,0,30,5
1683673574774,SOCI 188D,A00,258913,Staff,22,0,30,8
1683673575799,SYN 2,001,187529,Staff,9,0,16,7
1683673575799,SYN 2,002,201452,Staff,0,20,16,16
1683673575799,SYN 2,003,201469,Staff,1,0,16,15
1683673576825,SYN 100,A01,187531,Staff,0,9,20,20
1683673576825,SYN 100,B01,201491,Staff,0,10,20,20
1683673577853,TDAC 1,A00,189286,Walsh; Kim C.,3,0,20,17
1683673577853,TDAC 1,B00,189287,Harting; Carla Kelso,10,0,20,10
1683673578933,TDAC 101,A00,189300,Walsh; Kim C.,16,0,20,4
1683673578933,TDAC 101,B00,189301,Harting; Carla Kelso,18,0,20,2
1683673579957,TDAC 102,A00,189304,Basso; Beatrice,14,0,20,6
1683673580984,TDAC 108,A00,189305,Staff,18,0,20,2
1683673582013,TDDE 131,A00,189310,Staff,19,0,20,1
1683673582013,TDDE 131,B00,189314,Staff,19,0,20,1
1683673582013,TDDE 131,C00,189315,Staff,48,0,50,2
1683673582013,TDDE 131,D00,189316,Staff,14,0,15,1
1683673582013,TDDE 131,E00,204841,Staff,20,0,20,0
1683673583040,TDGE 10,A00,189289,Staff,27,0,50,23
1683673583040,TDGE 10,B00,189290,Havis; Allan,0,1,50,50
1683673584068,TDGE 11,A00,189291,Fulton; Julia,0,4,50,50
1683673584068,TDGE 11,B00,189292,Staff,20,0,25,5
1683673584068,TDGE 11,C00,260270,Staff,0,0,0,0
1683673585094,TDGE 25,A00,189294,Staff,2,0,20,18
1683673586119,TDGE 124,A00,189318,Fulton; Julia,0,8,50,50
1683673587143,TDGE 125,A00,189319,Staff,13,0,25,12
1683673587143,TDGE 125,B00,189320,Staff,23,0,25,2
1683673588165,TDGE 127,A00,189322,Havis; Allan,0,0,50,50
1683673589190,TDHT 101,A00,189323,Staff,18,0,25,7
1683673589190,TDHT 101,B00,189324,Staff,25,0,25,0
1683673590215,TDHT 102,A00,189325,Staff,49,0,50,1
1683673591237,TDMV 1,A00,189295,Arcidiacono; Kristin,20,0,30,10
1683673591237,TDMV 1,B00,189296,Caligagan; Maria T.,24,0,30,6
1683673592261,TDMV 2,A00,189297,Sammartano; Tonnie,27,0,30,3
1683673592261,TDMV 2,B00,189299,Arcidiacono; Kristin,23,0,30,7
1683673593290,TDMV 3,A00,204998,Rincon; Alicia,22,0,30,8
1683673594317,TDMV 120,A00,189458,Sammartano; Tonnie,28,0,30,2
1683673595342,TDMV 138,A00,189541,Jun; Grace Shin Hae,20,0,40,20
1683673596370,TDMV 142,A00,189717,Caligagan; Tony,25,0,30,5
1683673596370,TDMV 142,B00,189718,Caligagan; Maria T.,25,0,30,5
1683673597397,TMC 2,A01,187533,Staff,25,0,25,0
1683673597397,TMC 2,A02,187534,Staff,25,0,25,0
1683673598421,USP 1,A01,187536,Kwak; Nancy,0,16,25,25
1683673599446,USP 5,A01,187538,Staff,9,0,25,16
1683673600471,USP 101,A00,199253,Staff,0,4,0,0
1683673601494,USP 124,A00,187562,Boomhower; Matthew Charles,0,0,30,30
1683673602520,USP 138,A00,187582,Staff,19,0,25,6
1683673603547,USP 152,A01,187597,Staff,3,0,25,22
1683673604572,USP 153,A00,187598,Staff,19,0,25,6
1683673605596,USP 168,A00,187607,Kwak; Nancy,2,0,5,3
1683673606618,USP 173,A00,187619,Staff,4,0,25,21
1683673607646,USP 181,A00,187638,Staff,0,4,25,25
1683673608672,VIS 103,A00,187650,Cruz; Edwin Teddy,17,0,75,58
1683673609699,VIS 110D,A00,187669,Staff,13,0,22,9
1683673610723,VIS 127C,A00,187720,Shen; Kuiyi,67,0,146,79
1683673611751,VIS 149,A00,187731,Yoldas; Pinar,1,14,22,21
1683673612779,VIS 151,A01,188091,Staff,22,0,34,12
1683673612779,VIS 151,A02,188092,Staff,11,0,34,23
1683673613809,VIS 160B,A00,188093,Stalbaum; Brett,0,1,10,10
1683673615860,WCWP 10B,A00,201720,Staff,10,0,15,5
1683673615860,WCWP 10B,B00,201722,Staff,9,0,15,6
1683673616883,WCWP 100,A00,201725,Gagnon; Jeffrey C,0,0,2,2
1683673616883,WCWP 100,B00,201727,Staff,0,4,15,15
1683673620000,ANBI 133,A00,258401,Wilder; Linnea Lorene,34,0,40,6
1683673621024,ANBI 140,A00,258395,Hrvoj Mihic; Branka,18,0,25,7
1683673622049,ANSC 120,A00,258402,Bialecki; Jon Anthony,26,0,40,14
1683673623076,ANSC 144,A00,258400,Staff,12,0,40,28
1683673625124,ANSC 166,A00,258396,Parish; Steven Martin,156,0,175,19
1683673626148,ANSC 180,A00,193533,Staff,8,0,20,12
1683673627174,ANSC 188,A00,258397,Jassal; Aftab,34,0,40,6
1683673628198,ANTH 3,A01,258316,Staff,23,0,30,7
1683673629225,ANTH 5,A00,258394,Semendeferi; Ekaterini,16,0,20,4
1683673630249,ANTH 21,A01,258331,Staff,4,0,40,36
1683673631273,ANTH 103,A00,258398,Varma; Saiba,15,0,25,10
1683673632306,AWP 10,001,202034,Staff,0,0,0,0
1683673632306,AWP 10,002,202035,Staff,0,0,0,0
1683673632306,AWP 10,003,202036,Staff,0,0,0,0
1683673632306,AWP 10,004,202037,Staff,0,0,0,0
1683673632306,AWP 10,005,202038,Staff,0,0,0,0
1683673632306,AWP 10,006,202039,Staff,0,0,0,0
1683673632306,AWP 10,007,202040,Staff,0,0,0,0
1683673632306,AWP 10,008,202041,Staff,0,0,0,0
1683673632306,AWP 10,009,202042,Staff,0,0,0,0
1683673632306,AWP 10,010,202043,Staff,0,0,0,0
1683673632306,AWP 10,011,202044,Staff,0,0,0,0
1683673632306,AWP 10,012,202045,Staff,0,0,0,0
1683673632306,AWP 10,013,202046,Staff,0,0,0,0
1683673632306,AWP 10,014,202047,Staff,0,0,0,0
1683673632306,AWP 10,015,202048,Staff,0,0,0,0
1683673632306,AWP 10,016,202049,Staff,0,0,0,0
1683673632306,AWP 10,017,202050,Staff,0,0,0,0
1683673632306,AWP 10,018,202051,Staff,0,0,0,0
1683673632306,AWP 10,019,202052,Staff,0,0,0,0
1683673632306,AWP 10,020,202053,Staff,0,0,0,0
1683673632306,AWP 10,021,202054,Staff,0,0,0,0
1683673632306,AWP 10,022,202055,Staff,0,0,0,0
1683673632306,AWP 10,023,202056,Staff,0,0,0,0
1683673632306,AWP 10,024,202057,Staff,0,0,0,0
1683673632306,AWP 10,025,202058,Staff,0,0,0,0
1683673632306,AWP 10,026,202059,Staff,0,0,0,0
1683673633332,AWP 102,001,202032,Staff,0,0,0,0
1683673633332,AWP 102,002,202033,Staff,0,0,0,0
1683673634361,BENG 100,A01,254234,Taylor Amos; Alyssa C,31,0,40,9
1683673635385,BENG 196,001,270013,Engler; Adam J.,9999,0,9999,0
1683673636413,BICD 100R,A01,202018,Smith; Laurie,0,7,32,32
1683673636413,BICD 100R,A02,202019,Smith; Laurie,0,3,32,32
1683673636413,BICD 100R,A03,202020,Smith; Laurie,0,1,32,32
1683673636413,BICD 100R,A04,202021,Smith; Laurie,6,0,32,26
1683673636413,BICD 100R,A05,202022,Smith; Laurie,11,0,32,21
1683673637442,BICD 136,A01,193242,Gustafson-Brown; Cindy,0,2,32,32
1683673637442,BICD 136,A02,193244,Gustafson-Brown; Cindy,13,0,32,19
1683673638480,BIEB 102,A01,193249,Butler; Shannon Rhey,1,2,32,31
1683673638480,BIEB 102,A02,193251,Butler; Shannon Rhey,0,0,32,32
1683673638480,BIEB 102,A03,193253,Butler; Shannon Rhey,0,0,32,32
1683673638480,BIEB 102,A04,193255,Butler; Shannon Rhey,13,0,32,19
1683673638480,BIEB 102,A05,193265,Butler; Shannon Rhey,25,0,32,7
1683673638480,BIEB 102,A06,193269,Butler; Shannon Rhey,14,0,32,18
1683673640530,BIEB 150,A01,193274,Staff,0,0,32,32
1683673640530,BIEB 150,A02,193285,Staff,24,0,32,8
1683673641553,BIEB 194,A00,193286,Kurle; Carolyn M.,20,0,32,12
1683673642578,BILD 1,A01,192291,Staff,15,0,32,17
1683673642578,BILD 1,A02,192292,Staff,30,0,32,2
1683673642578,BILD 1,B01,192520,Reuther; Keefe,0,1,0,0
1683673642578,BILD 1,B02,192532,Reuther; Keefe,0,1,0,0
1683673643602,BILD 3,A01,192556,Butler; Shannon Rhey,0,0,32,32
1683673643602,BILD 3,A02,192581,Butler; Shannon Rhey,0,1,32,32
1683673643602,BILD 3,A03,192611,Butler; Shannon Rhey,20,0,32,12
1683673643602,BILD 3,A04,192612,Butler; Shannon Rhey,24,0,32,8
1683673643602,BILD 3,A05,192613,Butler; Shannon Rhey,26,0,32,6
1683673643602,BILD 3,A06,192679,Butler; Shannon Rhey,27,0,32,5
1683673643602,BILD 3,A07,192682,Butler; Shannon Rhey,20,0,32,12
1683673644627,BILD 4,A01,192836,Reuther; Keefe,1,0,24,23
1683673644627,BILD 4,A02,193044,Reuther; Keefe,4,0,24,20
1683673645655,BILD 10,A01,193142,Gustafson-Brown; Cindy,29,0,32,3
1683673645655,BILD 10,A02,193149,Gustafson-Brown; Cindy,31,0,32,1
1683673646680,BIMM 100,A01,193301,Staff,0,6,32,32
1683673646680,BIMM 100,A02,193312,Staff,0,7,32,32
1683673646680,BIMM 100,A03,193323,Staff,0,10,32,32
1683673647707,BIMM 101,A01,193329,McDonnell; Lisa Marie,1,4,24,23
1683673647707,BIMM 101,A02,193339,McDonnell; Lisa Marie,1,4,24,23
1683673647707,BIMM 101,B01,193354,McDonnell; Lisa Marie,0,4,24,24
1683673647707,BIMM 101,B02,193357,McDonnell; Lisa Marie,0,3,24,24
1683673648730,BIMM 110,A01,193377,Tat; John,0,11,32,32
1683673648730,BIMM 110,A02,193378,Tat; John,0,10,32,32
1683673649758,BIMM 120,A01,206116,Staff,0,0,32,32
1683673649758,BIMM 120,A02,206117,Staff,7,0,32,25
1683673649758,BIMM 120,A03,206121,Staff,21,0,32,11
1683673650782,BIPN 100,A01,193393,Park; Ji Young,0,15,32,32
1683673650782,BIPN 100,A02,193402,Park; Ji Young,0,14,32,32
1683673650782,BIPN 100,A03,193413,Park; Ji Young,0,14,32,32
1683673650782,BIPN 100,A04,193414,Park; Ji Young,0,13,32,32
1683673651811,BIPN 102,A01,193429,Staff,0,0,32,32
1683673651811,BIPN 102,A02,193438,Staff,18,0,32,14
1683673652837,BIPN 106,A01,193450,Reyes Gonzalez; Catalina,0,2,40,40
1683673653866,BIPN 134,A01,193465,Cooke; James Edward,0,0,32,32
1683673653866,BIPN 134,A02,193474,Cooke; James Edward,25,0,32,7
1683673653866,BIPN 134,A03,193485,Cooke; James Edward,29,0,32,3
1683673653866,BIPN 134,A04,193486,Cooke; James Edward,20,0,32,12
1683673653866,BIPN 134,A05,193491,Cooke; James Edward,31,0,32,1
1683673653866,BIPN 134,A06,193501,Cooke; James Edward,30,0,32,2
1683673653866,BIPN 134,A07,193510,Cooke; James Edward,29,0,32,3
1683673655917,BISP 194,A00,222522,Staff,14,0,32,18
1683673656945,CAT 124,A01,202407,Staff,19,0,25,6
1683673657969,CAT 125,A00,202408,Marchisotto; Jennifer Anne,2,0,20,18
1683673658998,CAT 125R,A00,202409,Smith; Lauryn Alissa,0,11,20,20
1683673658998,CAT 125R,B00,202410,Morales; Celeste Georgianna,0,11,20,20
1683673658998,CAT 125R,C00,202411,Irwin; Matthew Joseph,0,12,20,20
1683673660025,CENG 15,A01,204712,Yang; Kesong,0,1,0,0
1683673661051,CENG 114,A00,202070,Jahed Motlagh; Zeinab,5,0,20,15
1683673662076,CGS 105,A00,185477,Wesling; Megan E.,24,0,40,16
1683673663100,CGS 106,A00,185494,Staff,11,0,22,11
1683673664124,CGS 108,A00,185495,Staff,14,0,20,6
1683673665148,CGS 114,A00,185496,Staff,13,0,18,5
1683673666172,CGS 119,A00,185501,Staff,15,0,20,5
1683673667197,CGS 120,A00,185511,Staff,12,0,20,8
1683673668221,CHEM 4,A01,184675,Bussey; Thomas J,97,0,100,3
1683673669247,CHEM 6A,A01,184677,Staff,32,0,60,28
1683673670272,CHEM 6B,A01,184679,Staff,63,0,100,37
1683673671297,CHEM 6C,A01,184681,Bussey; Thomas J,0,0,50,50
1683673671297,CHEM 6C,A02,184682,Bussey; Thomas J,32,0,50,18
1683673672325,CHEM 40A,A01,184684,Albizati; Kim F.,33,0,100,67
1683673673350,CHEM 40B,A01,184686,Albizati; Kim F.,0,22,100,100
1683673674375,CHEM 41B,A01,184690,Staff,51,0,100,49
1683673675401,COGS 3,A01,184715,Boyle; Mary E. T.,0,27,40,40
1683673676426,COGS 14B,A01,185172,Staff,0,14,38,38
1683673677454,COGS 18,A01,184736,Staff,14,0,80,66
1683673678477,COGS 100,A01,184932,Staff,0,8,73,73
1683673679502,COGS 101A,A01,184935,Staff,0,40,30,30
1683673680528,COGS 101B,A01,184944,Staff,0,2,30,30
1683673681557,COGS 101C,A01,184946,Staff,0,10,30,30
1683673682646,COGS 102A,A01,184951,Johnson; Christine M.,2,0,40,38
1683673683672,COGS 107B,A01,184953,Mooshagian; Eric Frederick,0,52,40,40
1683673684697,COGS 118B,A01,184959,Gupta; Anjum,0,50,40,40
1683673685721,COGS 153,A00,184961,Staff,0,16,30,30
1683673686753,COGS 177,A00,184962,Staff,0,21,30,30
1683673687777,COGS 187A,A01,184969,Boyle; Mary E. T.,0,19,40,40
1683673688802,COMM 10,A01,185174,Staff,0,5,25,25
1683673688802,COMM 10,A02,185189,Staff,0,2,25,25
1683673688802,COMM 10,A03,269821,Staff,0,1,0,0
1683673689826,COMM 100B,A01,185475,Staff,0,1,0,1
1683673689826,COMM 100B,A02,185476,Staff,11,0,25,14
1683673690851,COMM 100C,A01,185314,Staff,1,0,25,24
1683673690851,COMM 100C,A02,185327,Staff,17,0,25,8
1683673691875,COMM 110M,A00,185349,Staff,0,0,40,40
1683673692902,COMM 113T,A00,185352,Staff,25,0,40,15
1683673693935,COMM 114I,A00,185353,Staff,31,0,40,9
1683673694959,COMM 131,A00,185354,Staff,17,0,30,13
1683673695984,CSE 8A,A50,185358,Cao; Yingjun,0,46,10,10
1683673697011,CSE 8B,A01,185362,Staff,0,48,50,50
1683673698038,CSE 11,A01,185416,Cao; Yingjun,0,91,10,10
1683673699067,CSE 20,A01,185445,Briones; Jor-el Thomas Caparas,4,0,25,21
1683673700094,CSE 21,A01,185447,Staff,9,0,50,41
1683673701118,CSE 101,A01,185451,Staff,0,13,50,50
1683673701118,CSE 101,B01,185453,Jones; Miles E,0,14,50,50
1683673703170,CSE 141,A01,185458,Eldon; John,16,0,100,84
1683673704198,CSE 141L,A01,185461,Eldon; John,8,0,100,92
1683673705222,CSE 142,A01,185463,Staff,34,0,60,26
1683673705222,CSE 142,B01,201355,Staff,0,7,60,60
1683673706247,CSE 142L,A01,185470,Staff,34,0,60,26
1683673706247,CSE 142L,B01,201417,Staff,0,6,60,60
1683673707270,CSE 190,A00,201433,Staff,32,0,49,17
1683673708297,DOC 1,A01,259136,Strom; Megan C.,7,0,15,8
1683673708297,DOC 1,A02,259137,Strom; Megan C.,14,0,15,1
1683673708297,DOC 1,A03,259138,Strom; Megan C.,14,0,15,1
1683673708297,DOC 1,A04,259139,Strom; Megan C.,14,0,15,1
1683673709321,DOC 100D,A00,259140,Pass; Natalye Joann,14,0,25,11
1683673710344,DSGN 1,A01,184749,Rill; Bryan,0,26,30,30
1683673711370,DSGN 100,A01,185168,Staff,0,2,25,25
1683673712395,ECE 5,A01,185626,Morris; Karcher William,0,12,0,0
1683673713421,ECE 101,A01,185628,Staff,14,0,70,56
1683673714444,ECE 107,A01,185635,Baghdadchi; Saharnaz,0,0,20,20
1683673714444,ECE 107,A02,185638,Baghdadchi; Saharnaz,1,0,20,19
1683673715469,ECE 148,A01,185647,Silberman; Jack,0,0,16,16
1683673716498,ECON 1,A01,185537,Crane; Meredith Helen,54,0,70,16
1683673717522,ECON 3,A01,185549,Crane; Meredith Helen,29,0,70,41
1683673718546,ECON 4,A01,203354,Anderson; John Charles,0,5,10,10
1683673719569,ECON 100A,A01,185574,Staff,0,5,40,40
1683673720596,ECON 100B,A01,185576,Staff,0,12,50,50
1683673721621,ECON 100C,A01,185589,Newhouse; Herbert S,30,0,70,40
1683673722649,ECON 105,A00,185608,Vespa; Emanuel Ignacio,19,0,35,16
1683673723676,ECON 109,A01,185610,Shishkin; Denis,9,0,35,26
1683673724703,ECON 110A,A01,185612,Staff,9,0,40,31
1683673725727,ECON 120A,A01,185615,Staff,19,0,40,21
1683673726754,ECON 120C,A01,185617,Sun; Yixiao,0,21,70,70
1683673727782,ECON 144,A00,203346,Squires; Dale E,2,0,35,33
1683673728811,ECON 171,A01,203349,Newhouse; Herbert S,0,1,35,35
1683673729838,ECON 173A,A01,185621,Toda; Alexis Akira,20,0,35,15
1683673730868,EDS 25,A01,202413,Staff,0,1,0,0
1683673730868,EDS 25,A02,202414,Staff,0,1,0,0
1683673730868,EDS 25,A03,202415,Staff,0,0,0,0
1683673730868,EDS 25,A04,202416,Staff,0,1,0,0
1683673730868,EDS 25,A05,202439,Staff,0,0,0,0
1683673730868,EDS 25,A06,202440,Staff,0,0,0,0
1683673730868,EDS 25,B01,202631,Staff,0,0,0,0
1683673730868,EDS 25,B02,202632,Staff,0,0,0,0
1683673730868,EDS 25,B03,202639,Staff,0,0,0,0
1683673730868,EDS 25,B04,202640,Staff,0,0,0,0
1683673730868,EDS 25,B05,202643,Staff,0,0,0,0
1683673730868,EDS 25,B06,202644,Staff,0,0,0,0
1683673731893,EDS 38,A01,202659,Black; Alison Michelle,24,0,25,1
1683673732917,EDS 115,A00,202652,Staff,18,0,30,12
1683673733945,EDS 125,A00,202649,Staff,13,0,30,17
1683673734967,EDS 126,A01,203332,Staff,30,0,30,0
1683673735990,EDS 139,A00,202838,Staff,16,0,25,9
1683673737014,EDS 146,A01,202655,Staff,14,0,25,11
1683673738043,ENG 15,A00,185667,Staff,0,1,0,0
1683673738043,ENG 15,B00,185672,Staff,0,0,0,0
1683673738043,ENG 15,C00,185675,Staff,0,0,0,0
1683673738043,ENG 15,D00,185682,Staff,0,0,0,0
1683673738043,ENG 15,E00,185684,Staff,0,0,0,0
1683673739069,ETHN 103,A00,185710,Staff,0,8,35,35
1683673740099,ETHN 103A,A00,199228,Man; Simeon S,0,0,9,9
1683673741125,ETHN 109,A00,185711,Staff,15,0,35,20
1683673742148,ETHN 142,A00,185726,Staff,0,4,30,30
1683673743174,ETHN 163J,A00,199229,Man; Simeon S,5,0,8,3
1683673744209,ETHN 168,A00,185727,Staff,7,0,10,3
1683673745233,ETHN 182,A00,185728,Staff,0,0,35,35
1683673746257,ETHN 183,A00,185737,Staff,9,0,18,9
1683673747281,GLBH 111,A01,209361,Burgos; Jose L.,0,0,0,0
1683673749333,HIEU 104,A00,185792,Staff,14,0,20,6
1683673750359,HIEU 115,A00,185800,Staff,0,0,20,20
1683673751383,HIEU 128,A00,185801,Staff,0,9,20,20
1683673752409,HIEU 147,A00,185802,Staff,15,0,20,5
1683673753436,HIEU 154,A00,185823,Staff,11,0,20,9
1683673754460,HILA 102,A00,185826,Staff,14,0,20,6
1683673755485,HILD 2C,A01,185778,Staff,0,13,20,20
1683673756512,HILD 7B,A01,185780,Kwak; Nancy,0,17,32,32
1683673756512,HILD 7B,A02,185781,Kwak; Nancy,0,18,32,32
1683673757537,HILD 30,A01,185791,Staff,12,0,20,8
1683673758561,HISC 119,A00,185830,Golan; Tal,0,9,20,20
1683673759585,HITO 156GS,A00,185831,Patterson; Patrick H.,0,0,0,23
1683673760613,HIUS 103,A00,185832,Man; Simeon S,0,4,20,20
1683673761640,HIUS 117,A00,185836,Kwak; Nancy,2,0,20,18
1683673762667,HIUS 125,A00,185840,Man; Simeon S,0,2,23,23
1683673763694,HIUS 149,A00,185845,Staff,1,0,20,19
1683673764723,HUM 3,A01,185882,Zavodny; Tatiana Sophia,0,8,50,50
1683673764723,HUM 3,B01,185899,Caldwell; Michael Alan,0,18,50,50
1683673765750,HUM 3GS,A00,185900,Patterson; Patrick H.,0,0,0,23
1683673766781,HUM 4,A01,185938,Zroka; Amy Liane,28,0,50,22
1683673766781,HUM 4,B01,185956,Watkins; Eric,0,5,50,50
1683673766781,HUM 4,B02,202209,Watkins; Eric,0,5,50,50
1683673766781,HUM 4,B03,202210,Watkins; Eric,0,5,50,50
1683673767806,HUM 5,A01,185958,West; Geoffrey Scott,0,0,50,50
1683673767806,HUM 5,A02,202215,West; Geoffrey Scott,0,0,50,50
1683673768833,INTL 190,A00,185959,Gagnon; Jeffrey C,0,0,0,9
1683673768833,INTL 190,B00,185960,Lettieri; Michael Joseph,0,0,0,2
1683673769859,JAPN 180,A00,254509,Staff,5,0,30,25
1683673770886,LATI 10,A01,202853,Kennemore; Amy Michelle,4,0,35,31
1683673770886,LATI 10,A02,202854,Kennemore; Amy Michelle,2,0,35,33
1683673770886,LATI 10,A03,270054,Kennemore; Amy Michelle,30,0,30,0
1683673771910,LATI 180,A00,202855,Kennemore; Amy Michelle,11,0,20,9
1683673772936,LAWS 101,A00,201767,Golan; Tal,0,7,40,40
1683673773959,LIFR 1C,A00,185961,Staff,6,0,20,14
1683673774985,LIFR 1CX,A00,185962,Staff,7,0,20,13
1683673776009,LIFR 1D,A00,185963,Staff,7,0,20,13
1683673777036,LIFR 1DX,A00,185964,Staff,7,0,20,13
1683673778058,LIGN 101,A01,186039,Staff,43,0,50,7
1683673779083,LIGN 165,A00,186040,Staff,15,0,50,35
1683673780108,LTCS 108,A00,186041,Staff,5,0,10,5
1683673781134,LTCS 119,A00,186042,Staff,15,0,20,5
1683673782161,LTCS 130,A00,186043,Wesling; Megan E.,15,0,25,10
1683673784213,LTEA 138,A00,186119,Staff,14,0,40,26
1683673785241,LTEN 124,A00,186148,Staff,5,0,25,20
1683673786326,LTEN 178,A00,186149,Staff,7,0,15,8
1683673787351,LTEN 181,A00,186150,Blanco; John D,34,0,40,6
1683673788379,LTWL 120,A00,186160,Staff,19,0,25,6
1683673789407,LTWL 165,A00,186161,Staff,22,0,25,3
1683673790433,LTWR 100,A00,186162,Staff,0,5,15,15
1683673791457,LTWR 102,A00,186163,Doller; Ben,5,0,15,10
1683673792481,MAE 8,A01,186412,Staff,0,0,0,0
1683673793509,MAE 30B,A00,186445,Bahadori; Mohammad Yousef,82,0,100,18
1683673794533,MAE 40,A00,186592,Bewley; Thomas R,10,0,50,40
1683673795558,MAE 101B,A00,186593,Bahadori; Mohammad Yousef,80,0,100,20
1683673796585,MAE 105,A00,186594,Bandaru; Prabhakar,10,0,50,40
1683673797612,MAE 107,A00,186599,Pham; Hieu Tan,0,7,120,120
1683673798638,MAE 148,A01,186660,Silberman; Jack,3,0,16,13
1683673799662,MATH 10A,A01,188095,Staff,0,6,35,35
1683673800687,MATH 10B,A01,188097,Bowers; Adam R.,0,12,30,30
1683673800687,MATH 10B,A02,188099,Bowers; Adam R.,0,11,30,30
1683673800687,MATH 10B,B01,188104,Bowers; Adam R.,0,10,30,30
1683673800687,MATH 10B,B02,188106,Bowers; Adam R.,1,9,30,29
1683673801714,MATH 10C,A01,188111,Staff,0,20,30,30
1683673801714,MATH 10C,A02,188127,Staff,0,19,30,30
1683673801714,MATH 10C,A03,188131,Staff,0,19,30,30
1683673801714,MATH 10C,B01,188218,Staff,17,0,30,13
1683673801714,MATH 10C,B02,188244,Staff,13,0,30,17
1683673801714,MATH 10C,B03,188277,Staff,14,0,30,16
1683673802743,MATH 18,A01,188344,Bach; Quang Tran,18,0,30,12
1683673802743,MATH 18,A02,188345,Bach; Quang Tran,11,0,30,19
1683673802743,MATH 18,B01,188353,Bach; Quang Tran,11,0,30,19
1683673802743,MATH 18,B02,188354,Bach; Quang Tran,19,0,30,11
1683673803768,MATH 20A,A01,188374,Staff,11,0,35,24
1683673804792,MATH 20B,A01,188382,Ohm; Ko Woon,7,0,30,23
1683673804792,MATH 20B,A02,188383,Ohm; Ko Woon,22,0,30,8
1683673804792,MATH 20B,B01,188385,Ohm; Ko Woon,7,0,30,23
1683673804792,MATH 20B,B02,188392,Ohm; Ko Woon,22,0,30,8
1683673805821,MATH 20C,A01,188394,Harel; Guershon,10,0,30,20
1683673805821,MATH 20C,A02,188395,Harel; Guershon,13,0,30,17
1683673805821,MATH 20C,B01,188404,Harel; Guershon,5,0,30,25
1683673805821,MATH 20C,B02,188405,Harel; Guershon,18,0,30,12
1683673806846,MATH 20D,A01,188414,Hammock; Frances H,0,1,30,30
1683673806846,MATH 20D,A02,188415,Hammock; Frances H,0,1,30,30
1683673806846,MATH 20D,B01,188447,Hammock; Frances H,0,1,30,30
1683673806846,MATH 20D,B02,188486,Hammock; Frances H,3,0,30,27
1683673807871,MATH 20E,A01,188649,Staff,21,0,30,9
1683673807871,MATH 20E,A02,188650,Staff,20,0,30,10
1683673807871,MATH 20E,A03,188673,Staff,0,0,30,30
1683673808897,MATH 102,A01,188675,Staff,0,38,35,35
1683673809923,MATH 103B,A01,188681,Staff,3,0,35,32
1683673809923,MATH 103B,B01,188692,Staff,5,0,35,30
1683673810947,MATH 109,A01,188695,Salehi Golsefidy; Alireza,24,0,35,11
1683673810947,MATH 109,A02,188696,Salehi Golsefidy; Alireza,25,0,35,10
1683673811973,MATH 120A,A01,188698,Eggers; John Dietrich,7,0,35,28
1683673813000,MATH 142B,A01,188736,Ioana; Adrian,1,1,30,29
1683673813000,MATH 142B,A02,188741,Ioana; Adrian,0,1,30,30
1683673813000,MATH 142B,A03,188743,Ioana; Adrian,0,1,30,30
1683673814026,MATH 168A,A01,188790,Staff,0,11,35,35
1683673815051,MATH 170A,A01,188803,Nie; Jiawang,0,2,35,35
1683673815051,MATH 170A,A02,188811,Nie; Jiawang,0,0,35,35
1683673815051,MATH 170A,A03,188814,Nie; Jiawang,0,0,35,35
1683673815051,MATH 170A,A04,188815,Nie; Jiawang,6,0,35,29
1683673816081,MATH 193B,A01,188817,Staff,0,0,35,35
1683673816081,MATH 193B,A02,188818,Staff,5,0,35,30
1683673817108,MGT 4,A01,202857,Anderson; John Charles,60,0,80,20
1683673818134,MGT 12,A00,202858,Lindenberger; Wade Douglas,40,0,90,50
1683673819157,MGT 18,A00,202859,Staff,74,0,90,16
1683673820184,MGT 18GS,A00,202860,McKay; Michael J,13,0,28,15
1683673821208,MGT 45,A00,202861,Pecore; Joseph P.,10,0,90,80
1683673822233,MGT 100,A00,202863,Yavorsky; Daniel Ryan,28,0,90,62
1683673823258,MGT 103,A00,202864,Ehrich; Kristine R,0,18,90,90
1683673824286,MGT 112,A00,202865,Ehrich; Kristine R,15,0,90,75
1683673825311,MGT 121A,A00,202868,Staff,90,20,90,0
1683673826335,MGT 131B,A00,202869,Anderson; John Charles,59,0,90,31
1683673827362,MGT 136,A00,202871,Lindenberger; Wade Douglas,83,0,90,7
1683673828386,MGT 164,A00,202873,Staff,0,67,90,91
1683673829409,MGT 164GS,A00,202874,McKay; Mary A,13,0,28,15
1683673830433,MGT 180,A00,202875,Staff,0,51,90,91
1683673831461,MMW 11R,A01,205019,Herbst; Matthew,0,0,30,30
1683673831461,MMW 11R,A02,205026,Herbst; Matthew,29,0,30,1
1683673832490,MMW 15,A01,193512,Chang; Edmond Yi-Teh,0,8,28,28
1683673832490,MMW 15,A02,193513,Chang; Edmond Yi-Teh,0,5,28,28
1683673832490,MMW 15,A03,193514,Chang; Edmond Yi-Teh,0,5,28,28
1683673832490,MMW 15,A04,193515,Chang; Edmond Yi-Teh,0,5,28,28
1683673832490,MMW 15,A05,193516,Chang; Edmond Yi-Teh,0,5,28,28
1683673832490,MMW 15,A06,193517,Chang; Edmond Yi-Teh,0,6,28,28
1683673832490,MMW 15,B01,193519,Chang; Edmond Yi-Teh,0,5,28,28
1683673832490,MMW 15,B02,193520,Chang; Edmond Yi-Teh,0,5,28,28
1683673832490,MMW 15,B03,193521,Chang; Edmond Yi-Teh,0,5,28,28
1683673832490,MMW 15,B04,193522,Chang; Edmond Yi-Teh,0,5,28,28
1683673832490,MMW 15,B05,193523,Chang; Edmond Yi-Teh,0,5,28,28
1683673832490,MMW 15,B06,193524,Chang; Edmond Yi-Teh,0,5,28,28
1683673833514,MMW 122,A01,193526,Rahimi; Babak,0,16,28,28
1683673833514,MMW 122,A02,193527,Rahimi; Babak,0,15,28,28
1683673833514,MMW 122,A03,193528,Rahimi; Babak,0,0,0,0
1683673833514,MMW 122,A04,193529,Rahimi; Babak,0,0,0,0
1683673834542,MUS 1A,A01,186663,Staff,1,19,35,34
1683673835570,MUS 4,A01,186715,Staff,0,12,35,35
1683673836597,MUS 5R,A01,186796,Dubnov; Shlomo,0,17,35,35
1683673837624,MUS 6,A01,186798,Staff,0,5,25,25
1683673838652,MUS 7,A01,186830,Staff,11,0,35,24
1683673839676,MUS 8,A01,186930,Staff,0,27,35,35
1683673840704,MUS 15,A01,186932,Staff,0,15,35,35
1683673840704,MUS 15,B01,186934,Staff,1,17,35,34
1683673841730,MUS 80,A00,186935,Staff,0,0,20,20
1683673841730,MUS 80,B00,186936,Staff,24,0,25,1
1683673842754,NANO 11,A00,204702,Lipomi; Darren John,0,0,0,0
1683673843782,NANO 15,A01,204709,Yang; Kesong,0,1,0,0
1683673844810,NANO 114,A00,202069,Jahed Motlagh; Zeinab,3,0,10,7
1683673845835,PHIL 1,A00,186955,Grush; Rick Scott,31,0,40,9
1683673846875,PHIL 10,A01,186973,Grush; Rick Scott,27,0,35,8
1683673846875,PHIL 10,A02,186974,Grush; Rick Scott,33,0,35,2
1683673847900,PHIL 13,A01,186976,Staff,3,0,35,32
1683673847900,PHIL 13,A02,186977,Staff,16,0,35,19
1683673848927,PHIL 14,A01,186979,Staff,31,0,35,4
1683673848927,PHIL 14,A02,186986,Staff,32,0,35,3
1683673849955,PHIL 28,A01,186988,Staff,16,0,30,14
1683673849955,PHIL 28,A02,186989,Staff,1,0,30,29
1683673849955,PHIL 28,A03,186990,Staff,10,0,30,20
1683673849955,PHIL 28,A04,186991,Staff,26,0,30,4
1683673850978,PHIL 120,A00,186997,Staff,23,0,40,17
1683673852005,PHIL 137,A00,187003,Staff,7,0,40,33
1683673853030,PHIL 150,A00,187015,Staff,47,0,70,23
1683673854058,PHIL 167,A00,187021,Lamey; Andy M.,34,0,40,6
1683673855085,PHIL 174,A01,202226,Staff,17,0,20,3
1683673855085,PHIL 174,A02,202235,Staff,20,0,20,0
1683673856110,PHIL 191A,A00,258918,Staff,0,0,1,1
1683673857137,PHYS 1A,A00,187028,Staff,26,0,60,34
1683673858163,PHYS 1AL,001,187036,Staff,3,0,30,27
1683673858163,PHYS 1AL,002,187049,Staff,18,0,30,12
1683673859191,PHYS 1B,A00,187058,Staff,22,0,60,38
1683673860216,PHYS 1BL,001,187064,Staff,0,1,30,30
1683673860216,PHYS 1BL,002,187070,Staff,4,0,30,26
1683673861243,PHYS 1C,A00,187082,Staff,29,0,120,91
1683673862268,PHYS 1CL,001,187088,Staff,0,9,30,30
1683673862268,PHYS 1CL,002,187089,Staff,0,1,30,30
1683673862268,PHYS 1CL,009,262693,Staff,9,0,30,21
1683673863294,PHYS 2B,A01,187097,Staff,55,0,115,60
1683673864322,PHYS 2C,A01,187099,Staff,63,0,115,52
1683673865351,PHYS 2CL,A01,187101,Staff,5,0,28,23
1683673865351,PHYS 2CL,A02,187102,Staff,15,0,28,13
1683673866375,PHYS 2D,A01,187123,Shotwell; Brian,95,0,115,20
1683673867399,PHYS 4B,A01,187133,Grinstein; Benjamin,35,0,50,15
1683673868425,POLI 10,A00,188819,Staff,0,4,50,50
1683673869448,POLI 11,A00,188827,Staff,43,0,50,7
1683673870474,POLI 13R,A00,188828,Staff,0,1,20,20
1683673871498,POLI 27,A01,188830,Elgin; Samuel Zincke,0,2,70,70
1683673872524,POLI 30,A00,188832,Desposato; Scott,30,0,50,20
1683673873551,POLI 102F,A00,188834,Staff,0,0,40,40
1683673874577,POLI 104A,A00,188852,Staff,13,0,30,17
1683673875601,POLI 104I,A00,188853,Staff,0,7,20,20
1683673876630,POLI 110B,A00,188854,Wiens; David,6,0,20,14
1683673877653,POLI 112A,A00,188855,Wiens; David,3,0,30,27
1683673878679,POLI 117R,A00,188856,Forman; Fonna,0,12,20,20
1683673879705,POLI 118,A00,188857,Ingham; Sean,8,0,20,12
1683673880731,POLI 120G,A00,188858,Staff,8,0,30,22
1683673881758,POLI 131CR,A00,188863,Hoston; Germaine,20,0,50,30
1683673882785,POLI 133,A00,188864,Nellis; Gareth Hb,44,0,50,6
1683673883815,POLI 134D,A00,188865,Desposato; Scott,27,0,30,3
1683673884848,POLI 142A,A00,188871,Gartzke; Erik,21,0,50,29
1683673885873,POLI 142K,A00,188874,Staff,38,0,50,12
1683673886898,POLI 143,A00,188940,Gartzke; Erik,16,0,30,14
1683673887922,POLI 153,A00,188943,Staff,2,0,20,18
1683673888949,POLI 160AA,A00,188944,Staff,11,0,40,29
1683673890030,POLI 170A,A00,188945,Staff,10,0,30,20
1683673892082,PSYC 1,A00,188952,Staff,37,0,90,53
1683673893105,PSYC 2,B00,188953,Staff,19,0,35,16
1683673894131,PSYC 6,A00,188970,Staff,47,0,60,13
1683673895159,PSYC 7,A00,188973,Staff,35,0,45,10
1683673896183,PSYC 60,A01,188980,Rickard; Timothy C.,42,0,60,18
1683673897206,PSYC 70,A01,189001,Steiner; Eric Tomas,21,0,45,24
1683673898229,PSYC 100,A00,189005,Lacefield; Katharine I,0,99,120,120
1683673899253,PSYC 102,A00,189008,Staff,8,0,30,22
1683673900278,PSYC 106,B00,189026,Gorman; Michael R.,27,0,60,33
1683673901302,PSYC 114,B01,189033,Winkielman; Piotr,0,31,30,30
1683673902330,PSYC 131,A00,189036,Anagnostaras; Stephan,0,43,60,60
1683673903354,PSYC 136,A00,189041,Lowe; Angela Beth,0,7,25,25
1683673904378,PSYC 137,A00,189057,Winkielman; Piotr,1,37,25,24
1683673905413,PSYC 144,A00,189107,Wixted; John T,0,11,50,50
1683673907464,PSYC 162,A00,189142,Staff,0,9,85,85
1683673908492,PSYC 172,A00,189144,Gorman; Michael R.,0,6,30,30
1683673910543,PSYC 179,A00,189146,Lacefield; Katharine I,0,87,120,120
1683673911568,PSYC 181,A00,189147,Anagnostaras; Stephan,0,44,90,90
1683673912592,PSYC 190R,A00,189148,Barner; David A.,0,23,80,80
1683673913617,PSYC 191,A00,189275,Rickard; Timothy C.,0,10,25,25
1683673914640,PSYC 193,A00,189276,Chapman; Eddie Nathaniel,0,1,0,4
1683673915665,PSYC 193L,A01,189281,Lowe; Angela Beth,9,0,20,11
1683673915665,PSYC 193L,B01,189285,Staff,28,0,35,7
1683673916693,RELI 149,A00,187137,Rahimi; Babak,7,0,40,33
1683673917721,SE 9,A01,187315,Staff,0,2,18,18
1683673918746,SE 101B,A00,187409,Staff,24,0,30,6
1683673919771,SE 110B,A00,187444,Staff,10,0,40,30
1683673920799,SE 130B,A00,187449,Staff,31,0,40,9
1683673921825,SE 150A,A00,187516,Staff,8,0,20,12
1683673922852,SE 154,A00,187528,Staff,29,0,50,21
1683673923876,SIO 3,A01,258171,Staff,35,0,40,5
1683673924900,SIO 10,A00,187144,Cook; Geoffrey W,0,7,75,75
1683673925925,SIO 45,A00,187152,Cook; Geoffrey W,0,7,100,100
1683673926953,SIO 109R,A00,194486,Staff,0,4,20,20
1683673929008,SIO 187,A01,187233,Kacev; David,12,0,40,28
1683673930033,SOCI 1,A01,258656,Thorpe; Charles Robert,28,0,30,2
1683673930033,SOCI 1,A02,258658,Thorpe; Charles Robert,30,0,30,0
1683673930033,SOCI 1,A03,258661,Thorpe; Charles Robert,25,0,25,0
1683673930033,SOCI 1,A04,258666,Thorpe; Charles Robert,22,0,25,3
1683673930033,SOCI 1,A05,258897,Thorpe; Charles Robert,22,0,25,3
1683673930033,SOCI 1,A06,258898,Thorpe; Charles Robert,25,0,25,0
1683673931060,SOCI 30,A01,258903,Pardo Guerra; Juan Pablo,14,0,30,16
1683673932086,SOCI 102,A00,258904,Staff,9,0,25,16
1683673933111,SOCI 106,A00,258905,Staff,19,0,25,6
1683673934137,SOCI 111,A00,258907,Ribas Norris; Janet Vanesa,26,0,30,4
1683673935162,SOCI 121R,A00,258908,Pardo Guerra; Juan Pablo,8,0,30,22
1683673936188,SOCI 126,A01,203330,Staff,14,0,20,6
1683673937214,SOCI 131,A00,258909,Thorpe; Charles Robert,30,0,60,30
1683673938237,SOCI 135,A00,258910,Payne; Christine Anna,0,11,30,30
1683673939261,SOCI 157,A00,258911,Staff,11,0,30,19
1683673940285,SOCI 184,A00,258912,Staff,25,0,30,5
1683673941314,SOCI 188D,A00,258913,Staff,22,0,30,8
1683673942341,SYN 2,001,187529,Staff,9,0,16,7
1683673942341,SYN 2,002,201452,Staff,0,20,16,16
1683673942341,SYN 2,003,201469,Staff,1,0,16,15
1683673943366,SYN 100,A01,187531,Staff,0,9,20,20
1683673943366,SYN 100,B01,201491,Staff,0,10,20,20
1683673944390,TDAC 1,A00,189286,Walsh; Kim C.,3,0,20,17
1683673944390,TDAC 1,B00,189287,Harting; Carla Kelso,10,0,20,10
1683673945414,TDAC 101,A00,189300,Walsh; Kim C.,16,0,20,4
1683673945414,TDAC 101,B00,189301,Harting; Carla Kelso,18,0,20,2
1683673946440,TDAC 102,A00,189304,Basso; Beatrice,14,0,20,6
1683673947464,TDAC 108,A00,189305,Staff,18,0,20,2
1683673948493,TDDE 131,A00,189310,Staff,19,0,20,1
1683673948493,TDDE 131,B00,189314,Staff,19,0,20,1
1683673948493,TDDE 131,C00,189315,Staff,48,0,50,2
1683673948493,TDDE 131,D00,189316,Staff,14,0,15,1
1683673948493,TDDE 131,E00,204841,Staff,20,0,20,0
1683673949525,TDGE 10,A00,189289,Staff,27,0,50,23
1683673949525,TDGE 10,B00,189290,Havis; Allan,0,1,50,50
1683673950549,TDGE 11,A00,189291,Fulton; Julia,0,4,50,50
1683673950549,TDGE 11,B00,189292,Staff,20,0,25,5
1683673950549,TDGE 11,C00,260270,Staff,0,0,0,0
1683673951579,TDGE 25,A00,189294,Staff,1,0,20,19
1683673952605,TDGE 124,A00,189318,Fulton; Julia,0,8,50,50
1683673953633,TDGE 125,A00,189319,Staff,13,0,25,12
1683673953633,TDGE 125,B00,189320,Staff,23,0,25,2
1683673954656,TDGE 127,A00,189322,Havis; Allan,0,0,50,50
1683673955683,TDHT 101,A00,189323,Staff,18,0,25,7
1683673955683,TDHT 101,B00,189324,Staff,25,0,25,0
1683673956707,TDHT 102,A00,189325,Staff,49,0,50,1
1683673957731,TDMV 1,A00,189295,Arcidiacono; Kristin,20,0,30,10
1683673957731,TDMV 1,B00,189296,Caligagan; Maria T.,24,0,30,6
1683673958759,TDMV 2,A00,189297,Sammartano; Tonnie,27,0,30,3
1683673958759,TDMV 2,B00,189299,Arcidiacono; Kristin,23,0,30,7
1683673959784,TDMV 3,A00,204998,Rincon; Alicia,22,0,30,8
1683673960807,TDMV 120,A00,189458,Sammartano; Tonnie,28,0,30,2
1683673961835,TDMV 138,A00,189541,Jun; Grace Shin Hae,20,0,40,20
1683673962862,TDMV 142,A00,189717,Caligagan; Tony,25,0,30,5
1683673962862,TDMV 142,B00,189718,Caligagan; Maria T.,25,0,30,5
1683673963886,TMC 2,A01,187533,Staff,25,0,25,0
1683673963886,TMC 2,A02,187534,Staff,25,0,25,0
1683673964910,USP 1,A01,187536,Kwak; Nancy,0,16,25,25
1683673965935,USP 5,A01,187538,Staff,9,0,25,16
1683673966964,USP 101,A00,199253,Staff,0,4,0,0
1683673967991,USP 124,A00,187562,Boomhower; Matthew Charles,0,0,30,30
1683673969016,USP 138,A00,187582,Staff,19,0,25,6
1683673970040,USP 152,A01,187597,Staff,3,0,25,22
1683673971064,USP 153,A00,187598,Staff,19,0,25,6
1683673972089,USP 168,A00,187607,Kwak; Nancy,2,0,5,3
1683673973114,USP 173,A00,187619,Staff,4,0,25,21
1683673974141,USP 181,A00,187638,Staff,0,4,25,25
1683673975166,VIS 103,A00,187650,Cruz; Edwin Teddy,17,0,75,58
1683673976191,VIS 110D,A00,187669,Staff,13,0,22,9
1683673977216,VIS 127C,A00,187720,Shen; Kuiyi,67,0,146,79
1683673978239,VIS 149,A00,187731,Yoldas; Pinar,1,14,22,21
1683673979265,VIS 151,A01,188091,Staff,22,0,34,12
1683673979265,VIS 151,A02,188092,Staff,11,0,34,23
1683673980290,VIS 160B,A00,188093,Stalbaum; Brett,0,1,10,10
1683673982341,WCWP 10B,A00,201720,Staff,10,0,15,5
1683673982341,WCWP 10B,B00,201722,Staff,9,0,15,6
1683673983366,WCWP 100,A00,201725,Gagnon; Jeffrey C,0,0,2,2
1683673983366,WCWP 100,B00,201727,Staff,0,4,15,15
1683673986461,ANBI 133,A00,258401,Wilder; Linnea Lorene,34,0,40,6
1683673987488,ANBI 140,A00,258395,Hrvoj Mihic; Branka,18,0,25,7
1683673988512,ANSC 120,A00,258402,Bialecki; Jon Anthony,26,0,40,14
1683673989536,ANSC 144,A00,258400,Staff,12,0,40,28
1683673991591,ANSC 166,A00,258396,Parish; Steven Martin,156,0,175,19
1683673992617,ANSC 180,A00,193533,Staff,8,0,20,12
1683673993699,ANSC 188,A00,258397,Jassal; Aftab,34,0,40,6
1683673994729,ANTH 3,A01,258316,Staff,23,0,30,7
1683673995752,ANTH 5,A00,258394,Semendeferi; Ekaterini,16,0,20,4
1683673996775,ANTH 21,A01,258331,Staff,4,0,40,36
1683673997802,ANTH 103,A00,258398,Varma; Saiba,15,0,25,10
1683673998835,AWP 10,001,202034,Staff,0,0,0,0
1683673998835,AWP 10,002,202035,Staff,0,0,0,0
1683673998835,AWP 10,003,202036,Staff,0,0,0,0
1683673998835,AWP 10,004,202037,Staff,0,0,0,0
1683673998835,AWP 10,005,202038,Staff,0,0,0,0
1683673998835,AWP 10,006,202039,Staff,0,0,0,0
1683673998835,AWP 10,007,202040,Staff,0,0,0,0
1683673998835,AWP 10,008,202041,Staff,0,0,0,0
1683673998835,AWP 10,009,202042,Staff,0,0,0,0
1683673998835,AWP 10,010,202043,Staff,0,0,0,0
1683673998835,AWP 10,011,202044,Staff,0,0,0,0
1683673998835,AWP 10,012,202045,Staff,0,0,0,0
1683673998835,AWP 10,013,202046,Staff,0,0,0,0
1683673998835,AWP 10,014,202047,Staff,0,0,0,0
1683673998835,AWP 10,015,202048,Staff,0,0,0,0
1683673998835,AWP 10,016,202049,Staff,0,0,0,0
1683673998835,AWP 10,017,202050,Staff,0,0,0,0
1683673998835,AWP 10,018,202051,Staff,0,0,0,0
1683673998835,AWP 10,019,202052,Staff,0,0,0,0
1683673998835,AWP 10,020,202053,Staff,0,0,0,0
1683673998835,AWP 10,021,202054,Staff,0,0,0,0
1683673998835,AWP 10,022,202055,Staff,0,0,0,0
1683673998835,AWP 10,023,202056,Staff,0,0,0,0
1683673998835,AWP 10,024,202057,Staff,0,0,0,0
1683673998835,AWP 10,025,202058,Staff,0,0,0,0
1683673998835,AWP 10,026,202059,Staff,0,0,0,0
1683673999861,AWP 102,001,202032,Staff,0,0,0,0
1683673999861,AWP 102,002,202033,Staff,0,0,0,0
1683674000889,BENG 100,A01,254234,Taylor Amos; Alyssa C,31,0,40,9
1683674001914,BENG 196,001,270013,Engler; Adam J.,9999,0,9999,0
1683674002939,BICD 100R,A01,202018,Smith; Laurie,0,7,32,32
1683674002939,BICD 100R,A02,202019,Smith; Laurie,0,3,32,32
1683674002939,BICD 100R,A03,202020,Smith; Laurie,0,1,32,32
1683674002939,BICD 100R,A04,202021,Smith; Laurie,6,0,32,26
1683674002939,BICD 100R,A05,202022,Smith; Laurie,11,0,32,21
1683674003964,BICD 136,A01,193242,Gustafson-Brown; Cindy,0,2,32,32
1683674003964,BICD 136,A02,193244,Gustafson-Brown; Cindy,13,0,32,19
1683674004989,BIEB 102,A01,193249,Butler; Shannon Rhey,1,2,32,31
1683674004989,BIEB 102,A02,193251,Butler; Shannon Rhey,0,0,32,32
1683674004989,BIEB 102,A03,193253,Butler; Shannon Rhey,0,0,32,32
1683674004989,BIEB 102,A04,193255,Butler; Shannon Rhey,13,0,32,19
1683674004989,BIEB 102,A05,193265,Butler; Shannon Rhey,25,0,32,7
1683674004989,BIEB 102,A06,193269,Butler; Shannon Rhey,14,0,32,18
1683674007040,BIEB 150,A01,193274,Staff,0,0,32,32
1683674007040,BIEB 150,A02,193285,Staff,24,0,32,8
1683674008067,BIEB 194,A00,193286,Kurle; Carolyn M.,20,0,32,12
1683674009093,BILD 1,A01,192291,Staff,15,0,32,17
1683674009093,BILD 1,A02,192292,Staff,30,0,32,2
1683674009093,BILD 1,B01,192520,Reuther; Keefe,0,1,0,0
1683674009093,BILD 1,B02,192532,Reuther; Keefe,0,1,0,0
1683674010123,BILD 3,A01,192556,Butler; Shannon Rhey,0,0,32,32
1683674010123,BILD 3,A02,192581,Butler; Shannon Rhey,0,1,32,32
1683674010123,BILD 3,A03,192611,Butler; Shannon Rhey,20,0,32,12
1683674010123,BILD 3,A04,192612,Butler; Shannon Rhey,24,0,32,8
1683674010123,BILD 3,A05,192613,Butler; Shannon Rhey,26,0,32,6
1683674010123,BILD 3,A06,192679,Butler; Shannon Rhey,27,0,32,5
1683674010123,BILD 3,A07,192682,Butler; Shannon Rhey,20,0,32,12
1683674011148,BILD 4,A01,192836,Reuther; Keefe,1,0,24,23
1683674011148,BILD 4,A02,193044,Reuther; Keefe,4,0,24,20
1683674012173,BILD 10,A01,193142,Gustafson-Brown; Cindy,29,0,32,3
1683674012173,BILD 10,A02,193149,Gustafson-Brown; Cindy,31,0,32,1
1683674013200,BIMM 100,A01,193301,Staff,0,6,32,32
1683674013200,BIMM 100,A02,193312,Staff,0,7,32,32
1683674013200,BIMM 100,A03,193323,Staff,0,10,32,32
1683674014223,BIMM 101,A01,193329,McDonnell; Lisa Marie,1,4,24,23
1683674014223,BIMM 101,A02,193339,McDonnell; Lisa Marie,1,4,24,23
1683674014223,BIMM 101,B01,193354,McDonnell; Lisa Marie,0,4,24,24
1683674014223,BIMM 101,B02,193357,McDonnell; Lisa Marie,0,3,24,24
1683674015251,BIMM 110,A01,193377,Tat; John,0,11,32,32
1683674015251,BIMM 110,A02,193378,Tat; John,0,10,32,32
1683674016279,BIMM 120,A01,206116,Staff,0,0,32,32
1683674016279,BIMM 120,A02,206117,Staff,7,0,32,25
1683674016279,BIMM 120,A03,206121,Staff,21,0,32,11
1683674017309,BIPN 100,A01,193393,Park; Ji Young,0,15,32,32
1683674017309,BIPN 100,A02,193402,Park; Ji Young,0,14,32,32
1683674017309,BIPN 100,A03,193413,Park; Ji Young,0,14,32,32
1683674017309,BIPN 100,A04,193414,Park; Ji Young,0,13,32,32
1683674018341,BIPN 102,A01,193429,Staff,0,0,32,32
1683674018341,BIPN 102,A02,193438,Staff,18,0,32,14
1683674019369,BIPN 106,A01,193450,Reyes Gonzalez; Catalina,0,2,40,40
1683674020392,BIPN 134,A01,193465,Cooke; James Edward,0,0,32,32
1683674020392,BIPN 134,A02,193474,Cooke; James Edward,25,0,32,7
1683674020392,BIPN 134,A03,193485,Cooke; James Edward,29,0,32,3
1683674020392,BIPN 134,A04,193486,Cooke; James Edward,20,0,32,12
1683674020392,BIPN 134,A05,193491,Cooke; James Edward,31,0,32,1
1683674020392,BIPN 134,A06,193501,Cooke; James Edward,30,0,32,2
1683674020392,BIPN 134,A07,193510,Cooke; James Edward,29,0,32,3
1683674022441,BISP 194,A00,222522,Staff,14,0,32,18
1683674023467,CAT 124,A01,202407,Staff,19,0,25,6
1683674024495,CAT 125,A00,202408,Marchisotto; Jennifer Anne,2,0,20,18
1683674025525,CAT 125R,A00,202409,Smith; Lauryn Alissa,0,11,20,20
1683674025525,CAT 125R,B00,202410,Morales; Celeste Georgianna,0,11,20,20
1683674025525,CAT 125R,C00,202411,Irwin; Matthew Joseph,0,12,20,20
1683674026552,CENG 15,A01,204712,Yang; Kesong,0,1,0,0
1683674027577,CENG 114,A00,202070,Jahed Motlagh; Zeinab,5,0,20,15
1683674028605,CGS 105,A00,185477,Wesling; Megan E.,24,0,40,16
1683674029631,CGS 106,A00,185494,Staff,11,0,22,11
1683674030658,CGS 108,A00,185495,Staff,14,0,20,6
1683674031684,CGS 114,A00,185496,Staff,13,0,18,5
1683674032710,CGS 119,A00,185501,Staff,15,0,20,5
1683674033741,CGS 120,A00,185511,Staff,12,0,20,8
1683674034769,CHEM 4,A01,184675,Bussey; Thomas J,97,0,100,3
1683674035792,CHEM 6A,A01,184677,Staff,32,0,60,28
1683674036817,CHEM 6B,A01,184679,Staff,63,0,100,37
1683674037841,CHEM 6C,A01,184681,Bussey; Thomas J,0,0,50,50
1683674037841,CHEM 6C,A02,184682,Bussey; Thomas J,32,0,50,18
1683674038865,CHEM 40A,A01,184684,Albizati; Kim F.,33,0,100,67
1683674039891,CHEM 40B,A01,184686,Albizati; Kim F.,0,22,100,100
1683674040914,CHEM 41B,A01,184690,Staff,51,0,100,49
1683674041938,COGS 3,A01,184715,Boyle; Mary E. T.,0,27,40,40
1683674042961,COGS 14B,A01,185172,Staff,0,14,38,38
1683674043989,COGS 18,A01,184736,Staff,14,0,80,66
1683674045013,COGS 100,A01,184932,Staff,0,8,73,73
1683674046040,COGS 101A,A01,184935,Staff,0,40,30,30
1683674047064,COGS 101B,A01,184944,Staff,0,2,30,30
1683674048089,COGS 101C,A01,184946,Staff,0,10,30,30
1683674049115,COGS 102A,A01,184951,Johnson; Christine M.,2,0,40,38
1683674050144,COGS 107B,A01,184953,Mooshagian; Eric Frederick,0,52,40,40
1683674051168,COGS 118B,A01,184959,Gupta; Anjum,0,50,40,40
1683674052193,COGS 153,A00,184961,Staff,0,16,30,30
1683674053219,COGS 177,A00,184962,Staff,0,21,30,30
1683674054247,COGS 187A,A01,184969,Boyle; Mary E. T.,0,19,40,40
1683674055271,COMM 10,A01,185174,Staff,0,5,25,25
1683674055271,COMM 10,A02,185189,Staff,0,2,25,25
1683674055271,COMM 10,A03,269821,Staff,0,1,0,0
1683674056294,COMM 100B,A01,185475,Staff,0,1,0,1
1683674056294,COMM 100B,A02,185476,Staff,11,0,25,14
1683674057319,COMM 100C,A01,185314,Staff,1,0,25,24
1683674057319,COMM 100C,A02,185327,Staff,17,0,25,8
1683674058347,COMM 110M,A00,185349,Staff,0,0,40,40
1683674059374,COMM 113T,A00,185352,Staff,25,0,40,15
1683674060399,COMM 114I,A00,185353,Staff,31,0,40,9
1683674061426,COMM 131,A00,185354,Staff,17,0,30,13
1683674062450,CSE 8A,A50,185358,Cao; Yingjun,0,46,10,10
1683674063478,CSE 8B,A01,185362,Staff,0,48,50,50
1683674064505,CSE 11,A01,185416,Cao; Yingjun,0,91,10,10
1683674065529,CSE 20,A01,185445,Briones; Jor-el Thomas Caparas,4,0,25,21
1683674066557,CSE 21,A01,185447,Staff,9,0,50,41
1683674067585,CSE 101,A01,185451,Staff,0,13,50,50
1683674067585,CSE 101,B01,185453,Jones; Miles E,0,14,50,50
1683674069634,CSE 141,A01,185458,Eldon; John,16,0,100,84
1683674070665,CSE 141L,A01,185461,Eldon; John,8,0,100,92
1683674071693,CSE 142,A01,185463,Staff,34,0,60,26
1683674071693,CSE 142,B01,201355,Staff,0,7,60,60
1683674072716,CSE 142L,A01,185470,Staff,34,0,60,26
1683674072716,CSE 142L,B01,201417,Staff,0,6,60,60
1683674073740,CSE 190,A00,201433,Staff,32,0,49,17
1683674074766,DOC 1,A01,259136,Strom; Megan C.,7,0,15,8
1683674074766,DOC 1,A02,259137,Strom; Megan C.,14,0,15,1
1683674074766,DOC 1,A03,259138,Strom; Megan C.,14,0,15,1
1683674074766,DOC 1,A04,259139,Strom; Megan C.,14,0,15,1
1683674075790,DOC 100D,A00,259140,Pass; Natalye Joann,14,0,25,11
1683674076817,DSGN 1,A01,184749,Rill; Bryan,0,26,30,30
1683674077840,DSGN 100,A01,185168,Staff,0,2,25,25
1683674078865,ECE 5,A01,185626,Morris; Karcher William,0,12,0,0
1683674079890,ECE 101,A01,185628,Staff,14,0,70,56
1683674080917,ECE 107,A01,185635,Baghdadchi; Saharnaz,0,0,20,20
1683674080917,ECE 107,A02,185638,Baghdadchi; Saharnaz,1,0,20,19
1683674081944,ECE 148,A01,185647,Silberman; Jack,0,0,16,16
1683674082969,ECON 1,A01,185537,Crane; Meredith Helen,54,0,70,16
1683674083997,ECON 3,A01,185549,Crane; Meredith Helen,29,0,70,41
1683674085022,ECON 4,A01,203354,Anderson; John Charles,0,5,10,10
1683674086046,ECON 100A,A01,185574,Staff,0,5,40,40
1683674087073,ECON 100B,A01,185576,Staff,0,12,50,50
1683674088097,ECON 100C,A01,185589,Newhouse; Herbert S,30,0,70,40
1683674089120,ECON 105,A00,185608,Vespa; Emanuel Ignacio,19,0,35,16
1683674090145,ECON 109,A01,185610,Shishkin; Denis,9,0,35,26
1683674091169,ECON 110A,A01,185612,Staff,9,0,40,31
1683674092193,ECON 120A,A01,185615,Staff,19,0,40,21
1683674093230,ECON 120C,A01,185617,Sun; Yixiao,0,21,70,70
1683674094255,ECON 144,A00,203346,Squires; Dale E,2,0,35,33
1683674095279,ECON 171,A01,203349,Newhouse; Herbert S,0,1,35,35
1683674096312,ECON 173A,A01,185621,Toda; Alexis Akira,21,0,35,14
1683674097397,EDS 25,A01,202413,Staff,0,1,0,0
1683674097397,EDS 25,A02,202414,Staff,0,1,0,0
1683674097397,EDS 25,A03,202415,Staff,0,0,0,0
1683674097397,EDS 25,A04,202416,Staff,0,1,0,0
1683674097397,EDS 25,A05,202439,Staff,0,0,0,0
1683674097397,EDS 25,A06,202440,Staff,0,0,0,0
1683674097397,EDS 25,B01,202631,Staff,0,0,0,0
1683674097397,EDS 25,B02,202632,Staff,0,0,0,0
1683674097397,EDS 25,B03,202639,Staff,0,0,0,0
1683674097397,EDS 25,B04,202640,Staff,0,0,0,0
1683674097397,EDS 25,B05,202643,Staff,0,0,0,0
1683674097397,EDS 25,B06,202644,Staff,0,0,0,0
1683674098423,EDS 38,A01,202659,Black; Alison Michelle,24,0,25,1
1683674099449,EDS 115,A00,202652,Staff,18,0,30,12
1683674100475,EDS 125,A00,202649,Staff,13,0,30,17
1683674101500,EDS 126,A01,203332,Staff,30,0,30,0
1683674102525,EDS 139,A00,202838,Staff,16,0,25,9
1683674103550,EDS 146,A01,202655,Staff,14,0,25,11
1683674104574,ENG 15,A00,185667,Staff,0,1,0,0
1683674104574,ENG 15,B00,185672,Staff,0,0,0,0
1683674104574,ENG 15,C00,185675,Staff,0,0,0,0
1683674104574,ENG 15,D00,185682,Staff,0,0,0,0
1683674104574,ENG 15,E00,185684,Staff,0,0,0,0
1683674105599,ETHN 103,A00,185710,Staff,0,8,35,35
1683674106624,ETHN 103A,A00,199228,Man; Simeon S,0,0,9,9
1683674107649,ETHN 109,A00,185711,Staff,15,0,35,20
1683674108677,ETHN 142,A00,185726,Staff,0,4,30,30
1683674109704,ETHN 163J,A00,199229,Man; Simeon S,5,0,8,3
1683674110728,ETHN 168,A00,185727,Staff,7,0,10,3
1683674111752,ETHN 182,A00,185728,Staff,0,0,35,35
1683674112776,ETHN 183,A00,185737,Staff,9,0,18,9
1683674113799,GLBH 111,A01,209361,Burgos; Jose L.,0,0,0,0
1683674115849,HIEU 104,A00,185792,Staff,14,0,20,6
1683674116873,HIEU 115,A00,185800,Staff,0,0,20,20
1683674117900,HIEU 128,A00,185801,Staff,0,9,20,20
1683674118924,HIEU 147,A00,185802,Staff,15,0,20,5
1683674119951,HIEU 154,A00,185823,Staff,11,0,20,9
1683674120975,HILA 102,A00,185826,Staff,14,0,20,6
1683674121998,HILD 2C,A01,185778,Staff,0,13,20,20
1683674123022,HILD 7B,A01,185780,Kwak; Nancy,0,17,32,32
1683674123022,HILD 7B,A02,185781,Kwak; Nancy,0,18,32,32
1683674124047,HILD 30,A01,185791,Staff,12,0,20,8
1683674125073,HISC 119,A00,185830,Golan; Tal,0,9,20,20
1683674126099,HITO 156GS,A00,185831,Patterson; Patrick H.,0,0,0,23
1683674127124,HIUS 103,A00,185832,Man; Simeon S,0,4,20,20
1683674128147,HIUS 117,A00,185836,Kwak; Nancy,2,0,20,18
1683674129174,HIUS 125,A00,185840,Man; Simeon S,0,2,23,23
1683674130199,HIUS 149,A00,185845,Staff,1,0,20,19
1683674131223,HUM 3,A01,185882,Zavodny; Tatiana Sophia,0,8,50,50
1683674131223,HUM 3,B01,185899,Caldwell; Michael Alan,0,18,50,50
1683674132249,HUM 3GS,A00,185900,Patterson; Patrick H.,0,0,0,23
1683674133274,HUM 4,A01,185938,Zroka; Amy Liane,28,0,50,22
1683674133274,HUM 4,B01,185956,Watkins; Eric,0,5,50,50
1683674133274,HUM 4,B02,202209,Watkins; Eric,0,5,50,50
1683674133274,HUM 4,B03,202210,Watkins; Eric,0,5,50,50
1683674134299,HUM 5,A01,185958,West; Geoffrey Scott,0,0,50,50
1683674134299,HUM 5,A02,202215,West; Geoffrey Scott,0,0,50,50
1683674135326,INTL 190,A00,185959,Gagnon; Jeffrey C,0,0,0,9
1683674135326,INTL 190,B00,185960,Lettieri; Michael Joseph,0,0,0,2
1683674136350,JAPN 180,A00,254509,Staff,5,0,30,25
1683674137376,LATI 10,A01,202853,Kennemore; Amy Michelle,4,0,35,31
1683674137376,LATI 10,A02,202854,Kennemore; Amy Michelle,2,0,35,33
1683674137376,LATI 10,A03,270054,Kennemore; Amy Michelle,30,0,30,0
1683674138403,LATI 180,A00,202855,Kennemore; Amy Michelle,11,0,20,9
1683674139427,LAWS 101,A00,201767,Golan; Tal,0,7,40,40
1683674140450,LIFR 1C,A00,185961,Staff,6,0,20,14
1683674141473,LIFR 1CX,A00,185962,Staff,7,0,20,13
1683674142501,LIFR 1D,A00,185963,Staff,7,0,20,13
1683674143525,LIFR 1DX,A00,185964,Staff,7,0,20,13
1683674144552,LIGN 101,A01,186039,Staff,43,0,50,7
1683674145582,LIGN 165,A00,186040,Staff,15,0,50,35
1683674146607,LTCS 108,A00,186041,Staff,5,0,10,5
1683674147630,LTCS 119,A00,186042,Staff,15,0,20,5
1683674148655,LTCS 130,A00,186043,Wesling; Megan E.,15,0,25,10
1683674150706,LTEA 138,A00,186119,Staff,14,0,40,26
1683674151730,LTEN 124,A00,186148,Staff,5,0,25,20
1683674152755,LTEN 178,A00,186149,Staff,7,0,15,8
1683674153779,LTEN 181,A00,186150,Blanco; John D,34,0,40,6
1683674154804,LTWL 120,A00,186160,Staff,19,0,25,6
1683674155828,LTWL 165,A00,186161,Staff,22,0,25,3
1683674156851,LTWR 100,A00,186162,Staff,0,5,15,15
1683674157878,LTWR 102,A00,186163,Doller; Ben,5,0,15,10
1683674158906,MAE 8,A01,186412,Staff,0,1,0,0
1683674159929,MAE 30B,A00,186445,Bahadori; Mohammad Yousef,82,0,100,18
1683674160953,MAE 40,A00,186592,Bewley; Thomas R,10,0,50,40
1683674161982,MAE 101B,A00,186593,Bahadori; Mohammad Yousef,80,0,100,20
1683674163007,MAE 105,A00,186594,Bandaru; Prabhakar,10,0,50,40
1683674164032,MAE 107,A00,186599,Pham; Hieu Tan,0,7,120,120
1683674165057,MAE 148,A01,186660,Silberman; Jack,3,0,16,13
1683674166082,MATH 10A,A01,188095,Staff,0,6,35,35
1683674167111,MATH 10B,A01,188097,Bowers; Adam R.,0,12,30,30
1683674167111,MATH 10B,A02,188099,Bowers; Adam R.,0,11,30,30
1683674167111,MATH 10B,B01,188104,Bowers; Adam R.,0,10,30,30
1683674167111,MATH 10B,B02,188106,Bowers; Adam R.,1,9,30,29
1683674168138,MATH 10C,A01,188111,Staff,0,20,30,30
1683674168138,MATH 10C,A02,188127,Staff,0,19,30,30
1683674168138,MATH 10C,A03,188131,Staff,0,19,30,30
1683674168138,MATH 10C,B01,188218,Staff,17,0,30,13
1683674168138,MATH 10C,B02,188244,Staff,13,0,30,17
1683674168138,MATH 10C,B03,188277,Staff,14,0,30,16
1683674169163,MATH 18,A01,188344,Bach; Quang Tran,18,0,30,12
1683674169163,MATH 18,A02,188345,Bach; Quang Tran,11,0,30,19
1683674169163,MATH 18,B01,188353,Bach; Quang Tran,11,0,30,19
1683674169163,MATH 18,B02,188354,Bach; Quang Tran,19,0,30,11
1683674170187,MATH 20A,A01,188374,Staff,11,0,35,24
1683674171218,MATH 20B,A01,188382,Ohm; Ko Woon,7,0,30,23
1683674171218,MATH 20B,A02,188383,Ohm; Ko Woon,22,0,30,8
1683674171218,MATH 20B,B01,188385,Ohm; Ko Woon,7,0,30,23
1683674171218,MATH 20B,B02,188392,Ohm; Ko Woon,22,0,30,8
1683674172242,MATH 20C,A01,188394,Harel; Guershon,10,0,30,20
1683674172242,MATH 20C,A02,188395,Harel; Guershon,13,0,30,17
1683674172242,MATH 20C,B01,188404,Harel; Guershon,5,0,30,25
1683674172242,MATH 20C,B02,188405,Harel; Guershon,18,0,30,12
1683674173272,MATH 20D,A01,188414,Hammock; Frances H,0,1,30,30
1683674173272,MATH 20D,A02,188415,Hammock; Frances H,0,1,30,30
1683674173272,MATH 20D,B01,188447,Hammock; Frances H,0,1,30,30
1683674173272,MATH 20D,B02,188486,Hammock; Frances H,3,0,30,27
1683674174298,MATH 20E,A01,188649,Staff,21,0,30,9
1683674174298,MATH 20E,A02,188650,Staff,20,0,30,10
1683674174298,MATH 20E,A03,188673,Staff,0,0,30,30
1683674175323,MATH 102,A01,188675,Staff,0,39,35,35
1683674176348,MATH 103B,A01,188681,Staff,3,0,35,32
1683674176348,MATH 103B,B01,188692,Staff,5,0,35,30
1683674177375,MATH 109,A01,188695,Salehi Golsefidy; Alireza,24,0,35,11
1683674177375,MATH 109,A02,188696,Salehi Golsefidy; Alireza,25,0,35,10
1683674178403,MATH 120A,A01,188698,Eggers; John Dietrich,7,0,35,28
1683674179430,MATH 142B,A01,188736,Ioana; Adrian,1,1,30,29
1683674179430,MATH 142B,A02,188741,Ioana; Adrian,0,1,30,30
1683674179430,MATH 142B,A03,188743,Ioana; Adrian,0,1,30,30
1683674180457,MATH 168A,A01,188790,Staff,0,11,35,35
1683674181483,MATH 170A,A01,188803,Nie; Jiawang,0,2,35,35
1683674181483,MATH 170A,A02,188811,Nie; Jiawang,0,0,35,35
1683674181483,MATH 170A,A03,188814,Nie; Jiawang,0,0,35,35
1683674181483,MATH 170A,A04,188815,Nie; Jiawang,6,0,35,29
1683674182511,MATH 193B,A01,188817,Staff,0,0,35,35
1683674182511,MATH 193B,A02,188818,Staff,5,0,35,30
1683674183538,MGT 4,A01,202857,Anderson; John Charles,60,0,80,20
1683674184565,MGT 12,A00,202858,Lindenberger; Wade Douglas,40,0,90,50
1683674185590,MGT 18,A00,202859,Staff,74,0,90,16
1683674186617,MGT 18GS,A00,202860,McKay; Michael J,13,0,28,15
1683674187644,MGT 45,A00,202861,Pecore; Joseph P.,10,0,90,80
1683674188669,MGT 100,A00,202863,Yavorsky; Daniel Ryan,28,0,90,62
1683674189692,MGT 103,A00,202864,Ehrich; Kristine R,0,18,90,90
1683674190719,MGT 112,A00,202865,Ehrich; Kristine R,15,0,90,75
1683674191744,MGT 121A,A00,202868,Staff,90,20,90,0
1683674192771,MGT 131B,A00,202869,Anderson; John Charles,59,0,90,31
1683674193799,MGT 136,A00,202871,Lindenberger; Wade Douglas,83,0,90,7
1683674194824,MGT 164,A00,202873,Staff,0,67,90,91
1683674195851,MGT 164GS,A00,202874,McKay; Mary A,13,0,28,15
1683674196875,MGT 180,A00,202875,Staff,0,51,90,91
1683674197901,MMW 11R,A01,205019,Herbst; Matthew,0,0,30,30
1683674197901,MMW 11R,A02,205026,Herbst; Matthew,29,0,30,1
1683674198929,MMW 15,A01,193512,Chang; Edmond Yi-Teh,0,8,28,28
1683674198929,MMW 15,A02,193513,Chang; Edmond Yi-Teh,0,5,28,28
1683674198929,MMW 15,A03,193514,Chang; Edmond Yi-Teh,0,5,28,28
1683674198929,MMW 15,A04,193515,Chang; Edmond Yi-Teh,0,5,28,28
1683674198929,MMW 15,A05,193516,Chang; Edmond Yi-Teh,0,5,28,28
1683674198929,MMW 15,A06,193517,Chang; Edmond Yi-Teh,0,6,28,28
1683674198929,MMW 15,B01,193519,Chang; Edmond Yi-Teh,0,5,28,28
1683674198929,MMW 15,B02,193520,Chang; Edmond Yi-Teh,0,5,28,28
1683674198929,MMW 15,B03,193521,Chang; Edmond Yi-Teh,0,5,28,28
1683674198929,MMW 15,B04,193522,Chang; Edmond Yi-Teh,0,5,28,28
1683674198929,MMW 15,B05,193523,Chang; Edmond Yi-Teh,0,5,28,28
1683674198929,MMW 15,B06,193524,Chang; Edmond Yi-Teh,0,5,28,28
1683674199955,MMW 122,A01,193526,Rahimi; Babak,0,16,28,28
1683674199955,MMW 122,A02,193527,Rahimi; Babak,0,15,28,28
1683674199955,MMW 122,A03,193528,Rahimi; Babak,0,0,0,0
1683674199955,MMW 122,A04,193529,Rahimi; Babak,0,0,0,0
1683674201038,MUS 1A,A01,186663,Staff,1,19,35,34
1683674202067,MUS 4,A01,186715,Staff,0,12,35,35
1683674203095,MUS 5R,A01,186796,Dubnov; Shlomo,0,17,35,35
1683674204119,MUS 6,A01,186798,Staff,0,5,25,25
1683674205144,MUS 7,A01,186830,Staff,11,0,35,24
1683674206171,MUS 8,A01,186930,Staff,0,27,35,35
1683674207196,MUS 15,A01,186932,Staff,0,15,35,35
1683674207196,MUS 15,B01,186934,Staff,1,17,35,34
1683674208223,MUS 80,A00,186935,Staff,0,0,20,20
1683674208223,MUS 80,B00,186936,Staff,24,0,25,1
1683674209245,NANO 11,A00,204702,Lipomi; Darren John,0,0,0,0
1683674210269,NANO 15,A01,204709,Yang; Kesong,0,1,0,0
1683674211294,NANO 114,A00,202069,Jahed Motlagh; Zeinab,3,0,10,7
1683674212322,PHIL 1,A00,186955,Grush; Rick Scott,31,0,40,9
1683674213351,PHIL 10,A01,186973,Grush; Rick Scott,27,0,35,8
1683674213351,PHIL 10,A02,186974,Grush; Rick Scott,33,0,35,2
1683674214375,PHIL 13,A01,186976,Staff,3,0,35,32
1683674214375,PHIL 13,A02,186977,Staff,16,0,35,19
1683674215399,PHIL 14,A01,186979,Staff,31,0,35,4
1683674215399,PHIL 14,A02,186986,Staff,32,0,35,3
1683674216424,PHIL 28,A01,186988,Staff,16,0,30,14
1683674216424,PHIL 28,A02,186989,Staff,1,0,30,29
1683674216424,PHIL 28,A03,186990,Staff,10,0,30,20
1683674216424,PHIL 28,A04,186991,Staff,26,0,30,4
1683674217447,PHIL 120,A00,186997,Staff,23,0,40,17
1683674218471,PHIL 137,A00,187003,Staff,7,0,40,33
1683674219498,PHIL 150,A00,187015,Staff,47,0,70,23
1683674220522,PHIL 167,A00,187021,Lamey; Andy M.,34,0,40,6
1683674221550,PHIL 174,A01,202226,Staff,17,0,20,3
1683674221550,PHIL 174,A02,202235,Staff,20,0,20,0
1683674222574,PHIL 191A,A00,258918,Staff,0,0,1,1
1683674223598,PHYS 1A,A00,187028,Staff,26,0,60,34
1683674224623,PHYS 1AL,001,187036,Staff,3,0,30,27
1683674224623,PHYS 1AL,002,187049,Staff,18,0,30,12
1683674225648,PHYS 1B,A00,187058,Staff,22,0,60,38
1683674226673,PHYS 1BL,001,187064,Staff,0,1,30,30
1683674226673,PHYS 1BL,002,187070,Staff,4,0,30,26
1683674227698,PHYS 1C,A00,187082,Staff,29,0,120,91
1683674228726,PHYS 1CL,001,187088,Staff,0,9,30,30
1683674228726,PHYS 1CL,002,187089,Staff,0,1,30,30
1683674228726,PHYS 1CL,009,262693,Staff,9,0,30,21
1683674229750,PHYS 2B,A01,187097,Staff,55,0,115,60
1683674230777,PHYS 2C,A01,187099,Staff,63,0,115,52
1683674231802,PHYS 2CL,A01,187101,Staff,5,0,28,23
1683674231802,PHYS 2CL,A02,187102,Staff,15,0,28,13
1683674232827,PHYS 2D,A01,187123,Shotwell; Brian,95,0,115,20
1683674233869,PHYS 4B,A01,187133,Grinstein; Benjamin,35,0,50,15
1683674234896,POLI 10,A00,188819,Staff,0,4,50,50
1683674235920,POLI 11,A00,188827,Staff,43,0,50,7
1683674236945,POLI 13R,A00,188828,Staff,0,1,20,20
1683674237972,POLI 27,A01,188830,Elgin; Samuel Zincke,0,2,70,70
1683674238995,POLI 30,A00,188832,Desposato; Scott,30,0,50,20
1683674240022,POLI 102F,A00,188834,Staff,0,0,40,40
1683674241046,POLI 104A,A00,188852,Staff,13,0,30,17
1683674242071,POLI 104I,A00,188853,Staff,0,7,20,20
1683674243098,POLI 110B,A00,188854,Wiens; David,6,0,20,14
1683674244123,POLI 112A,A00,188855,Wiens; David,3,0,30,27
1683674245146,POLI 117R,A00,188856,Forman; Fonna,0,12,20,20
1683674246171,POLI 118,A00,188857,Ingham; Sean,8,0,20,12
1683674247195,POLI 120G,A00,188858,Staff,8,0,30,22
1683674248221,POLI 131CR,A00,188863,Hoston; Germaine,20,0,50,30
1683674249248,POLI 133,A00,188864,Nellis; Gareth Hb,44,0,50,6
1683674250275,POLI 134D,A00,188865,Desposato; Scott,27,0,30,3
1683674251304,POLI 142A,A00,188871,Gartzke; Erik,21,0,50,29
1683674252330,POLI 142K,A00,188874,Staff,38,0,50,12
1683674253355,POLI 143,A00,188940,Gartzke; Erik,16,0,30,14
1683674254380,POLI 153,A00,188943,Staff,2,0,20,18
1683674255404,POLI 160AA,A00,188944,Staff,11,0,40,29
1683674256432,POLI 170A,A00,188945,Staff,10,0,30,20
1683674258482,PSYC 1,A00,188952,Staff,37,0,90,53
1683674259506,PSYC 2,B00,188953,Staff,19,0,35,16
1683674260531,PSYC 6,A00,188970,Staff,47,0,60,13
1683674261559,PSYC 7,A00,188973,Staff,35,0,45,10
1683674262586,PSYC 60,A01,188980,Rickard; Timothy C.,42,0,60,18
1683674263610,PSYC 70,A01,189001,Steiner; Eric Tomas,21,0,45,24
1683674264633,PSYC 100,A00,189005,Lacefield; Katharine I,0,99,120,120
1683674265660,PSYC 102,A00,189008,Staff,8,0,30,22
1683674266685,PSYC 106,B00,189026,Gorman; Michael R.,27,0,60,33
1683674267709,PSYC 114,B01,189033,Winkielman; Piotr,0,31,30,30
1683674268734,PSYC 131,A00,189036,Anagnostaras; Stephan,0,43,60,60
1683674269757,PSYC 136,A00,189041,Lowe; Angela Beth,0,7,25,25
1683674270784,PSYC 137,A00,189057,Winkielman; Piotr,1,37,25,24
1683674271808,PSYC 144,A00,189107,Wixted; John T,0,11,50,50
1683674273858,PSYC 162,A00,189142,Staff,0,9,85,85
1683674274882,PSYC 172,A00,189144,Gorman; Michael R.,0,6,30,30
1683674276937,PSYC 179,A00,189146,Lacefield; Katharine I,0,87,120,120
1683674277977,PSYC 181,A00,189147,Anagnostaras; Stephan,0,44,90,90
1683674279004,PSYC 190R,A00,189148,Barner; David A.,0,23,80,80
1683674280037,PSYC 191,A00,189275,Rickard; Timothy C.,0,10,25,25
1683674281062,PSYC 193,A00,189276,Chapman; Eddie Nathaniel,0,1,0,4
1683674282086,PSYC 193L,A01,189281,Lowe; Angela Beth,9,0,20,11
1683674282086,PSYC 193L,B01,189285,Staff,28,0,35,7
1683674283115,RELI 149,A00,187137,Rahimi; Babak,7,0,40,33
1683674284143,SE 9,A01,187315,Staff,0,2,18,18
1683674285167,SE 101B,A00,187409,Staff,24,0,30,6
1683674286191,SE 110B,A00,187444,Staff,10,0,40,30
1683674287219,SE 130B,A00,187449,Staff,31,0,40,9
1683674288244,SE 150A,A00,187516,Staff,8,0,20,12
1683674289272,SE 154,A00,187528,Staff,29,0,50,21
1683674290299,SIO 3,A01,258171,Staff,35,0,40,5
1683674291325,SIO 10,A00,187144,Cook; Geoffrey W,0,7,75,75
1683674292349,SIO 45,A00,187152,Cook; Geoffrey W,0,7,100,100
1683674293375,SIO 109R,A00,194486,Staff,0,4,20,20
1683674295429,SIO 187,A01,187233,Kacev; David,12,0,40,28
1683674296452,SOCI 1,A01,258656,Thorpe; Charles Robert,28,0,30,2
1683674296452,SOCI 1,A02,258658,Thorpe; Charles Robert,30,0,30,0
1683674296452,SOCI 1,A03,258661,Thorpe; Charles Robert,25,0,25,0
1683674296452,SOCI 1,A04,258666,Thorpe; Charles Robert,22,0,25,3
1683674296452,SOCI 1,A05,258897,Thorpe; Charles Robert,22,0,25,3
1683674296452,SOCI 1,A06,258898,Thorpe; Charles Robert,25,0,25,0
1683674297480,SOCI 30,A01,258903,Pardo Guerra; Juan Pablo,14,0,30,16
1683674298504,SOCI 102,A00,258904,Staff,9,0,25,16
1683674299528,SOCI 106,A00,258905,Staff,19,0,25,6
1683674300555,SOCI 111,A00,258907,Ribas Norris; Janet Vanesa,26,0,30,4
1683674301579,SOCI 121R,A00,258908,Pardo Guerra; Juan Pablo,8,0,30,22
1683674302607,SOCI 126,A01,203330,Staff,14,0,20,6
1683674303631,SOCI 131,A00,258909,Thorpe; Charles Robert,30,0,60,30
1683674304716,SOCI 135,A00,258910,Payne; Christine Anna,0,11,30,30
1683674305741,SOCI 157,A00,258911,Staff,11,0,30,19
1683674306766,SOCI 184,A00,258912,Staff,25,0,30,5
1683674307792,SOCI 188D,A00,258913,Staff,22,0,30,8
1683674308817,SYN 2,001,187529,Staff,9,0,16,7
1683674308817,SYN 2,002,201452,Staff,0,20,16,16
1683674308817,SYN 2,003,201469,Staff,1,0,16,15
1683674309845,SYN 100,A01,187531,Staff,0,9,20,20
1683674309845,SYN 100,B01,201491,Staff,0,10,20,20
1683674310870,TDAC 1,A00,189286,Walsh; Kim C.,3,0,20,17
1683674310870,TDAC 1,B00,189287,Harting; Carla Kelso,10,0,20,10
1683674311897,TDAC 101,A00,189300,Walsh; Kim C.,16,0,20,4
1683674311897,TDAC 101,B00,189301,Harting; Carla Kelso,18,0,20,2
1683674312926,TDAC 102,A00,189304,Basso; Beatrice,14,0,20,6
1683674313953,TDAC 108,A00,189305,Staff,18,0,20,2
1683674314981,TDDE 131,A00,189310,Staff,19,0,20,1
1683674314981,TDDE 131,B00,189314,Staff,19,0,20,1
1683674314981,TDDE 131,C00,189315,Staff,48,0,50,2
1683674314981,TDDE 131,D00,189316,Staff,14,0,15,1
1683674314981,TDDE 131,E00,204841,Staff,20,0,20,0
1683674316006,TDGE 10,A00,189289,Staff,27,0,50,23
1683674316006,TDGE 10,B00,189290,Havis; Allan,0,1,50,50
1683674317030,TDGE 11,A00,189291,Fulton; Julia,0,4,50,50
1683674317030,TDGE 11,B00,189292,Staff,20,0,25,5
1683674317030,TDGE 11,C00,260270,Staff,0,0,0,0
1683674318053,TDGE 25,A00,189294,Staff,1,0,20,19
1683674319076,TDGE 124,A00,189318,Fulton; Julia,0,8,50,50
1683674320101,TDGE 125,A00,189319,Staff,13,0,25,12
1683674320101,TDGE 125,B00,189320,Staff,23,0,25,2
1683674321124,TDGE 127,A00,189322,Havis; Allan,0,0,50,50
1683674322151,TDHT 101,A00,189323,Staff,18,0,25,7
1683674322151,TDHT 101,B00,189324,Staff,25,0,25,0
1683674323178,TDHT 102,A00,189325,Staff,49,0,50,1
1683674324202,TDMV 1,A00,189295,Arcidiacono; Kristin,20,0,30,10
1683674324202,TDMV 1,B00,189296,Caligagan; Maria T.,24,0,30,6
1683674325229,TDMV 2,A00,189297,Sammartano; Tonnie,27,0,30,3
1683674325229,TDMV 2,B00,189299,Arcidiacono; Kristin,23,0,30,7
1683674326254,TDMV 3,A00,204998,Rincon; Alicia,22,0,30,8
1683674327279,TDMV 120,A00,189458,Sammartano; Tonnie,28,0,30,2
1683674328309,TDMV 138,A00,189541,Jun; Grace Shin Hae,20,0,40,20
1683674329335,TDMV 142,A00,189717,Caligagan; Tony,25,0,30,5
1683674329335,TDMV 142,B00,189718,Caligagan; Maria T.,25,0,30,5
1683674330361,TMC 2,A01,187533,Staff,25,0,25,0
1683674330361,TMC 2,A02,187534,Staff,25,0,25,0
1683674331386,USP 1,A01,187536,Kwak; Nancy,0,16,25,25
1683674332413,USP 5,A01,187538,Staff,9,0,25,16
1683674333441,USP 101,A00,199253,Staff,0,4,0,0
1683674334466,USP 124,A00,187562,Boomhower; Matthew Charles,0,0,30,30
1683674335491,USP 138,A00,187582,Staff,19,0,25,6
1683674336518,USP 152,A01,187597,Staff,3,0,25,22
1683674337542,USP 153,A00,187598,Staff,19,0,25,6
1683674338570,USP 168,A00,187607,Kwak; Nancy,2,0,5,3
1683674339595,USP 173,A00,187619,Staff,4,0,25,21
1683674340619,USP 181,A00,187638,Staff,0,4,25,25
1683674341648,VIS 103,A00,187650,Cruz; Edwin Teddy,17,0,75,58
1683674342675,VIS 110D,A00,187669,Staff,13,0,22,9
1683674343700,VIS 127C,A00,187720,Shen; Kuiyi,67,0,146,79
1683674344729,VIS 149,A00,187731,Yoldas; Pinar,1,14,22,21
1683674345753,VIS 151,A01,188091,Staff,22,0,34,12
1683674345753,VIS 151,A02,188092,Staff,11,0,34,23
1683674346777,VIS 160B,A00,188093,Stalbaum; Brett,0,1,10,10
1683674348832,WCWP 10B,A00,201720,Staff,0,0,5,5
1683674348832,WCWP 10B,B00,201722,Staff,0,0,6,6
1683674349858,WCWP 100,A00,201725,Gagnon; Jeffrey C,0,0,2,2
1683674349858,WCWP 100,B00,201727,Staff,0,4,15,15
1683674352981,ANBI 133,A00,258401,Wilder; Linnea Lorene,34,0,40,6
1683674354007,ANBI 140,A00,258395,Hrvoj Mihic; Branka,18,0,25,7
1683674355034,ANSC 120,A00,258402,Bialecki; Jon Anthony,26,0,40,14
1683674356059,ANSC 144,A00,258400,Staff,12,0,40,28
1683674358111,ANSC 166,A00,258396,Parish; Steven Martin,156,0,175,19
1683674359136,ANSC 180,A00,193533,Staff,8,0,20,12
1683674360160,ANSC 188,A00,258397,Jassal; Aftab,34,0,40,6
1683674361183,ANTH 3,A01,258316,Staff,23,0,30,7
1683674362205,ANTH 5,A00,258394,Semendeferi; Ekaterini,16,0,20,4
1683674363231,ANTH 21,A01,258331,Staff,4,0,40,36
1683674364254,ANTH 103,A00,258398,Varma; Saiba,15,0,25,10
1683674365285,AWP 10,001,202034,Staff,0,0,0,0
1683674365285,AWP 10,002,202035,Staff,0,0,0,0
1683674365285,AWP 10,003,202036,Staff,0,0,0,0
1683674365285,AWP 10,004,202037,Staff,0,0,0,0
1683674365285,AWP 10,005,202038,Staff,0,0,0,0
1683674365285,AWP 10,006,202039,Staff,0,0,0,0
1683674365285,AWP 10,007,202040,Staff,0,0,0,0
1683674365285,AWP 10,008,202041,Staff,0,0,0,0
1683674365285,AWP 10,009,202042,Staff,0,0,0,0
1683674365285,AWP 10,010,202043,Staff,0,0,0,0
1683674365285,AWP 10,011,202044,Staff,0,0,0,0
1683674365285,AWP 10,012,202045,Staff,0,0,0,0
1683674365285,AWP 10,013,202046,Staff,0,0,0,0
1683674365285,AWP 10,014,202047,Staff,0,0,0,0
1683674365285,AWP 10,015,202048,Staff,0,0,0,0
1683674365285,AWP 10,016,202049,Staff,0,0,0,0
1683674365285,AWP 10,017,202050,Staff,0,0,0,0
1683674365285,AWP 10,018,202051,Staff,0,0,0,0
1683674365285,AWP 10,019,202052,Staff,0,0,0,0
1683674365285,AWP 10,020,202053,Staff,0,0,0,0
1683674365285,AWP 10,021,202054,Staff,0,0,0,0
1683674365285,AWP 10,022,202055,Staff,0,0,0,0
1683674365285,AWP 10,023,202056,Staff,0,0,0,0
1683674365285,AWP 10,024,202057,Staff,0,0,0,0
1683674365285,AWP 10,025,202058,Staff,0,0,0,0
1683674365285,AWP 10,026,202059,Staff,0,0,0,0
1683674366308,AWP 102,001,202032,Staff,0,0,0,0
1683674366308,AWP 102,002,202033,Staff,0,0,0,0
1683674367335,BENG 100,A01,254234,Taylor Amos; Alyssa C,31,0,40,9
1683674368362,BENG 196,001,270013,Engler; Adam J.,9999,0,9999,0
1683674369387,BICD 100R,A01,202018,Smith; Laurie,0,7,32,32
1683674369387,BICD 100R,A02,202019,Smith; Laurie,0,3,32,32
1683674369387,BICD 100R,A03,202020,Smith; Laurie,0,1,32,32
1683674369387,BICD 100R,A04,202021,Smith; Laurie,6,0,32,26
1683674369387,BICD 100R,A05,202022,Smith; Laurie,11,0,32,21
1683674370411,BICD 136,A01,193242,Gustafson-Brown; Cindy,0,2,32,32
1683674370411,BICD 136,A02,193244,Gustafson-Brown; Cindy,13,0,32,19
1683674371436,BIEB 102,A01,193249,Butler; Shannon Rhey,1,1,32,31
1683674371436,BIEB 102,A02,193251,Butler; Shannon Rhey,0,0,32,32
1683674371436,BIEB 102,A03,193253,Butler; Shannon Rhey,0,0,32,32
1683674371436,BIEB 102,A04,193255,Butler; Shannon Rhey,13,0,32,19
1683674371436,BIEB 102,A05,193265,Butler; Shannon Rhey,25,0,32,7
1683674371436,BIEB 102,A06,193269,Butler; Shannon Rhey,13,0,32,19
1683674373486,BIEB 150,A01,193274,Staff,0,0,32,32
1683674373486,BIEB 150,A02,193285,Staff,24,0,32,8
1683674374513,BIEB 194,A00,193286,Kurle; Carolyn M.,19,0,32,13
1683674375540,BILD 1,A01,192291,Staff,15,0,32,17
1683674375540,BILD 1,A02,192292,Staff,30,0,32,2
1683674375540,BILD 1,B01,192520,Reuther; Keefe,0,1,0,0
1683674375540,BILD 1,B02,192532,Reuther; Keefe,0,1,0,0
1683674376565,BILD 3,A01,192556,Butler; Shannon Rhey,0,0,32,32
1683674376565,BILD 3,A02,192581,Butler; Shannon Rhey,0,1,32,32
1683674376565,BILD 3,A03,192611,Butler; Shannon Rhey,20,0,32,12
1683674376565,BILD 3,A04,192612,Butler; Shannon Rhey,24,0,32,8
1683674376565,BILD 3,A05,192613,Butler; Shannon Rhey,26,0,32,6
1683674376565,BILD 3,A06,192679,Butler; Shannon Rhey,27,0,32,5
1683674376565,BILD 3,A07,192682,Butler; Shannon Rhey,20,0,32,12
1683674377590,BILD 4,A01,192836,Reuther; Keefe,1,0,24,23
1683674377590,BILD 4,A02,193044,Reuther; Keefe,4,0,24,20
1683674378613,BILD 10,A01,193142,Gustafson-Brown; Cindy,29,0,32,3
1683674378613,BILD 10,A02,193149,Gustafson-Brown; Cindy,31,0,32,1
1683674379641,BIMM 100,A01,193301,Staff,0,6,32,32
1683674379641,BIMM 100,A02,193312,Staff,0,7,32,32
1683674379641,BIMM 100,A03,193323,Staff,0,10,32,32
1683674380667,BIMM 101,A01,193329,McDonnell; Lisa Marie,1,4,24,23
1683674380667,BIMM 101,A02,193339,McDonnell; Lisa Marie,1,4,24,23
1683674380667,BIMM 101,B01,193354,McDonnell; Lisa Marie,0,4,24,24
1683674380667,BIMM 101,B02,193357,McDonnell; Lisa Marie,0,3,24,24
1683674381695,BIMM 110,A01,193377,Tat; John,0,11,32,32
1683674381695,BIMM 110,A02,193378,Tat; John,0,10,32,32
1683674382721,BIMM 120,A01,206116,Staff,0,0,32,32
1683674382721,BIMM 120,A02,206117,Staff,7,0,32,25
1683674382721,BIMM 120,A03,206121,Staff,21,0,32,11
1683674383745,BIPN 100,A01,193393,Park; Ji Young,0,15,32,32
1683674383745,BIPN 100,A02,193402,Park; Ji Young,0,14,32,32
1683674383745,BIPN 100,A03,193413,Park; Ji Young,0,14,32,32
1683674383745,BIPN 100,A04,193414,Park; Ji Young,0,13,32,32
1683674384773,BIPN 102,A01,193429,Staff,0,0,32,32
1683674384773,BIPN 102,A02,193438,Staff,18,0,32,14
1683674385796,BIPN 106,A01,193450,Reyes Gonzalez; Catalina,0,2,40,40
1683674386821,BIPN 134,A01,193465,Cooke; James Edward,0,0,32,32
1683674386821,BIPN 134,A02,193474,Cooke; James Edward,25,0,32,7
1683674386821,BIPN 134,A03,193485,Cooke; James Edward,29,0,32,3
1683674386821,BIPN 134,A04,193486,Cooke; James Edward,20,0,32,12
1683674386821,BIPN 134,A05,193491,Cooke; James Edward,31,0,32,1
1683674386821,BIPN 134,A06,193501,Cooke; James Edward,30,0,32,2
1683674386821,BIPN 134,A07,193510,Cooke; James Edward,29,0,32,3
1683674388869,BISP 194,A00,222522,Staff,14,0,32,18
1683674389892,CAT 124,A01,202407,Staff,19,0,25,6
1683674390918,CAT 125,A00,202408,Marchisotto; Jennifer Anne,2,0,20,18
1683674391944,CAT 125R,A00,202409,Smith; Lauryn Alissa,0,11,20,20
1683674391944,CAT 125R,B00,202410,Morales; Celeste Georgianna,0,11,20,20
1683674391944,CAT 125R,C00,202411,Irwin; Matthew Joseph,0,12,20,20
1683674392971,CENG 15,A01,204712,Yang; Kesong,0,1,0,0
1683674393998,CENG 114,A00,202070,Jahed Motlagh; Zeinab,5,0,20,15
1683674395023,CGS 105,A00,185477,Wesling; Megan E.,24,0,40,16
1683674396050,CGS 106,A00,185494,Staff,11,0,22,11
1683674397074,CGS 108,A00,185495,Staff,14,0,20,6
1683674398098,CGS 114,A00,185496,Staff,13,0,18,5
1683674399125,CGS 119,A00,185501,Staff,15,0,20,5
1683674400148,CGS 120,A00,185511,Staff,12,0,20,8
1683674401172,CHEM 4,A01,184675,Bussey; Thomas J,97,0,100,3
1683674402199,CHEM 6A,A01,184677,Staff,32,0,60,28
1683674403223,CHEM 6B,A01,184679,Staff,63,0,100,37
1683674404246,CHEM 6C,A01,184681,Bussey; Thomas J,0,0,50,50
1683674404246,CHEM 6C,A02,184682,Bussey; Thomas J,32,0,50,18
1683674405271,CHEM 40A,A01,184684,Albizati; Kim F.,33,0,100,67
1683674406301,CHEM 40B,A01,184686,Albizati; Kim F.,0,22,100,100
1683674407327,CHEM 41B,A01,184690,Staff,51,0,100,49
1683674408411,COGS 3,A01,184715,Boyle; Mary E. T.,0,27,40,40
1683674409438,COGS 14B,A01,185172,Staff,0,14,38,38
1683674410465,COGS 18,A01,184736,Staff,14,0,80,66
1683674411493,COGS 100,A01,184932,Staff,0,8,73,73
1683674412517,COGS 101A,A01,184935,Staff,0,40,30,30
1683674413543,COGS 101B,A01,184944,Staff,0,2,30,30
1683674414570,COGS 101C,A01,184946,Staff,0,10,30,30
1683674415597,COGS 102A,A01,184951,Johnson; Christine M.,2,0,40,38
1683674416621,COGS 107B,A01,184953,Mooshagian; Eric Frederick,0,52,40,40
1683674417645,COGS 118B,A01,184959,Gupta; Anjum,0,50,40,40
1683674418670,COGS 153,A00,184961,Staff,0,16,30,30
1683674419698,COGS 177,A00,184962,Staff,0,21,30,30
1683674420725,COGS 187A,A01,184969,Boyle; Mary E. T.,0,19,40,40
1683674421750,COMM 10,A01,185174,Staff,0,5,25,25
1683674421750,COMM 10,A02,185189,Staff,0,2,25,25
1683674421750,COMM 10,A03,269821,Staff,0,1,0,0
1683674422777,COMM 100B,A01,185475,Staff,0,1,0,1
1683674422777,COMM 100B,A02,185476,Staff,11,0,25,14
1683674423801,COMM 100C,A01,185314,Staff,1,0,25,24
1683674423801,COMM 100C,A02,185327,Staff,17,0,25,8
1683674424828,COMM 110M,A00,185349,Staff,0,0,40,40
1683674425851,COMM 113T,A00,185352,Staff,25,0,40,15
1683674426877,COMM 114I,A00,185353,Staff,31,0,40,9
1683674427903,COMM 131,A00,185354,Staff,17,0,30,13
1683674428931,CSE 8A,A50,185358,Cao; Yingjun,0,46,10,10
1683674429954,CSE 8B,A01,185362,Staff,0,48,50,50
1683674430981,CSE 11,A01,185416,Cao; Yingjun,0,91,10,10
1683674432008,CSE 20,A01,185445,Briones; Jor-el Thomas Caparas,4,0,25,21
1683674433032,CSE 21,A01,185447,Staff,9,0,50,41
1683674434058,CSE 101,A01,185451,Staff,0,13,50,50
1683674434058,CSE 101,B01,185453,Jones; Miles E,0,14,50,50
1683674436108,CSE 141,A01,185458,Eldon; John,16,0,100,84
1683674437135,CSE 141L,A01,185461,Eldon; John,8,0,100,92
1683674438160,CSE 142,A01,185463,Staff,34,0,60,26
1683674438160,CSE 142,B01,201355,Staff,0,7,60,60
1683674439189,CSE 142L,A01,185470,Staff,34,0,60,26
1683674439189,CSE 142L,B01,201417,Staff,0,6,60,60
1683674440213,CSE 190,A00,201433,Staff,32,0,49,17
1683674441249,DOC 1,A01,259136,Strom; Megan C.,7,0,15,8
1683674441249,DOC 1,A02,259137,Strom; Megan C.,14,0,15,1
1683674441249,DOC 1,A03,259138,Strom; Megan C.,14,0,15,1
1683674441249,DOC 1,A04,259139,Strom; Megan C.,14,0,15,1
1683674442273,DOC 100D,A00,259140,Pass; Natalye Joann,14,0,25,11
1683674443297,DSGN 1,A01,184749,Rill; Bryan,0,26,30,30
1683674444322,DSGN 100,A01,185168,Staff,0,2,25,25
1683674445350,ECE 5,A01,185626,Morris; Karcher William,0,12,0,0
1683674446374,ECE 101,A01,185628,Staff,14,0,70,56
1683674447400,ECE 107,A01,185635,Baghdadchi; Saharnaz,0,0,20,20
1683674447400,ECE 107,A02,185638,Baghdadchi; Saharnaz,1,0,20,19
1683674448427,ECE 148,A01,185647,Silberman; Jack,0,0,16,16
1683674449453,ECON 1,A01,185537,Crane; Meredith Helen,54,0,70,16
1683674450480,ECON 3,A01,185549,Crane; Meredith Helen,29,0,70,41
1683674451508,ECON 4,A01,203354,Anderson; John Charles,0,5,10,10
1683674452532,ECON 100A,A01,185574,Staff,0,5,40,40
1683674453560,ECON 100B,A01,185576,Staff,0,12,50,50
1683674454586,ECON 100C,A01,185589,Newhouse; Herbert S,30,0,70,40
1683674455610,ECON 105,A00,185608,Vespa; Emanuel Ignacio,19,0,35,16
1683674456637,ECON 109,A01,185610,Shishkin; Denis,9,0,35,26
1683674457664,ECON 110A,A01,185612,Staff,9,0,40,31
1683674458687,ECON 120A,A01,185615,Staff,19,0,40,21
1683674459714,ECON 120C,A01,185617,Sun; Yixiao,0,21,70,70
1683674460738,ECON 144,A00,203346,Squires; Dale E,2,0,35,33
1683674461762,ECON 171,A01,203349,Newhouse; Herbert S,0,1,35,35
1683674462790,ECON 173A,A01,185621,Toda; Alexis Akira,21,0,35,14
1683674463816,EDS 25,A01,202413,Staff,0,1,0,0
1683674463816,EDS 25,A02,202414,Staff,0,1,0,0
1683674463816,EDS 25,A03,202415,Staff,0,0,0,0
1683674463816,EDS 25,A04,202416,Staff,0,1,0,0
1683674463816,EDS 25,A05,202439,Staff,0,0,0,0
1683674463816,EDS 25,A06,202440,Staff,0,0,0,0
1683674463816,EDS 25,B01,202631,Staff,0,0,0,0
1683674463816,EDS 25,B02,202632,Staff,0,0,0,0
1683674463816,EDS 25,B03,202639,Staff,0,0,0,0
1683674463816,EDS 25,B04,202640,Staff,0,0,0,0
1683674463816,EDS 25,B05,202643,Staff,0,0,0,0
1683674463816,EDS 25,B06,202644,Staff,0,0,0,0
1683674464845,EDS 38,A01,202659,Black; Alison Michelle,24,0,25,1
1683674465869,EDS 115,A00,202652,Staff,18,0,30,12
1683674466892,EDS 125,A00,202649,Staff,13,0,30,17
1683674467918,EDS 126,A01,203332,Staff,30,0,30,0
1683674468945,EDS 139,A00,202838,Staff,16,0,25,9
1683674469973,EDS 146,A01,202655,Staff,14,0,25,11
1683674470999,ENG 15,A00,185667,Staff,0,1,0,0
1683674470999,ENG 15,B00,185672,Staff,0,0,0,0
1683674470999,ENG 15,C00,185675,Staff,0,0,0,0
1683674470999,ENG 15,D00,185682,Staff,0,0,0,0
1683674470999,ENG 15,E00,185684,Staff,0,0,0,0
1683674472033,ETHN 103,A00,185710,Staff,0,8,35,35
1683674473060,ETHN 103A,A00,199228,Man; Simeon S,0,0,9,9
1683674474087,ETHN 109,A00,185711,Staff,15,0,35,20
1683674475111,ETHN 142,A00,185726,Staff,0,4,30,30
1683674476135,ETHN 163J,A00,199229,Man; Simeon S,5,0,8,3
1683674477160,ETHN 168,A00,185727,Staff,7,0,10,3
1683674478184,ETHN 182,A00,185728,Staff,0,0,35,35
1683674479209,ETHN 183,A00,185737,Staff,9,0,18,9
1683674480233,GLBH 111,A01,209361,Burgos; Jose L.,0,0,0,0
1683674482284,HIEU 104,A00,185792,Staff,14,0,20,6
1683674483308,HIEU 115,A00,185800,Staff,0,0,20,20
1683674484335,HIEU 128,A00,185801,Staff,0,9,20,20
1683674485358,HIEU 147,A00,185802,Staff,15,0,20,5
1683674486385,HIEU 154,A00,185823,Staff,11,0,20,9
1683674487411,HILA 102,A00,185826,Staff,14,0,20,6
1683674488437,HILD 2C,A01,185778,Staff,0,13,20,20
1683674489463,HILD 7B,A01,185780,Kwak; Nancy,0,17,32,32
1683674489463,HILD 7B,A02,185781,Kwak; Nancy,0,18,32,32
1683674490486,HILD 30,A01,185791,Staff,12,0,20,8
1683674491511,HISC 119,A00,185830,Golan; Tal,0,9,20,20
1683674492532,HITO 156GS,A00,185831,Patterson; Patrick H.,0,0,0,23
1683674493556,HIUS 103,A00,185832,Man; Simeon S,0,4,20,20
1683674494584,HIUS 117,A00,185836,Kwak; Nancy,2,0,20,18
1683674495611,HIUS 125,A00,185840,Man; Simeon S,0,2,23,23
1683674496636,HIUS 149,A00,185845,Staff,1,0,20,19
1683674497661,HUM 3,A01,185882,Zavodny; Tatiana Sophia,0,8,50,50
1683674497661,HUM 3,B01,185899,Caldwell; Michael Alan,0,18,50,50
1683674498683,HUM 3GS,A00,185900,Patterson; Patrick H.,0,0,0,23
1683674499712,HUM 4,A01,185938,Zroka; Amy Liane,28,0,50,22
1683674499712,HUM 4,B01,185956,Watkins; Eric,0,5,50,50
1683674499712,HUM 4,B02,202209,Watkins; Eric,0,5,50,50
1683674499712,HUM 4,B03,202210,Watkins; Eric,0,5,50,50
1683674500738,HUM 5,A01,185958,West; Geoffrey Scott,0,0,50,50
1683674500738,HUM 5,A02,202215,West; Geoffrey Scott,0,0,50,50
1683674501763,INTL 190,A00,185959,Gagnon; Jeffrey C,0,0,0,9
1683674501763,INTL 190,B00,185960,Lettieri; Michael Joseph,0,0,0,2
1683674502789,JAPN 180,A00,254509,Staff,5,0,30,25
1683674503813,LATI 10,A01,202853,Kennemore; Amy Michelle,4,0,35,31
1683674503813,LATI 10,A02,202854,Kennemore; Amy Michelle,2,0,35,33
1683674503813,LATI 10,A03,270054,Kennemore; Amy Michelle,30,0,30,0
1683674504841,LATI 180,A00,202855,Kennemore; Amy Michelle,11,0,20,9
1683674505865,LAWS 101,A00,201767,Golan; Tal,0,7,40,40
1683674506891,LIFR 1C,A00,185961,Staff,6,0,20,14
1683674507915,LIFR 1CX,A00,185962,Staff,7,0,20,13
1683674508941,LIFR 1D,A00,185963,Staff,7,0,20,13
1683674509965,LIFR 1DX,A00,185964,Staff,7,0,20,13
1683674510992,LIGN 101,A01,186039,Staff,43,0,50,7
1683674512077,LIGN 165,A00,186040,Staff,15,0,50,35
1683674513101,LTCS 108,A00,186041,Staff,5,0,10,5
1683674514125,LTCS 119,A00,186042,Staff,15,0,20,5
1683674515149,LTCS 130,A00,186043,Wesling; Megan E.,15,0,25,10
1683674517200,LTEA 138,A00,186119,Staff,14,0,40,26
1683674518225,LTEN 124,A00,186148,Staff,5,0,25,20
1683674519249,LTEN 178,A00,186149,Staff,7,0,15,8
1683674520273,LTEN 181,A00,186150,Blanco; John D,34,0,40,6
1683674521298,LTWL 120,A00,186160,Staff,19,0,25,6
1683674522322,LTWL 165,A00,186161,Staff,22,0,25,3
1683674523350,LTWR 100,A00,186162,Staff,0,5,15,15
1683674524374,LTWR 102,A00,186163,Doller; Ben,5,0,15,10
1683674525398,MAE 8,A01,186412,Staff,0,1,0,0
1683674526421,MAE 30B,A00,186445,Bahadori; Mohammad Yousef,82,0,100,18
1683674527447,MAE 40,A00,186592,Bewley; Thomas R,10,0,50,40
1683674528474,MAE 101B,A00,186593,Bahadori; Mohammad Yousef,80,0,100,20
1683674529498,MAE 105,A00,186594,Bandaru; Prabhakar,10,0,50,40
1683674530525,MAE 107,A00,186599,Pham; Hieu Tan,0,7,120,120
1683674531552,MAE 148,A01,186660,Silberman; Jack,3,0,16,13
1683674532579,MATH 10A,A01,188095,Staff,0,6,35,35
1683674533604,MATH 10B,A01,188097,Bowers; Adam R.,0,12,30,30
1683674533604,MATH 10B,A02,188099,Bowers; Adam R.,0,11,30,30
1683674533604,MATH 10B,B01,188104,Bowers; Adam R.,0,10,30,30
1683674533604,MATH 10B,B02,188106,Bowers; Adam R.,1,9,30,29
1683674534628,MATH 10C,A01,188111,Staff,0,20,30,30
1683674534628,MATH 10C,A02,188127,Staff,0,19,30,30
1683674534628,MATH 10C,A03,188131,Staff,0,19,30,30
1683674534628,MATH 10C,B01,188218,Staff,17,0,30,13
1683674534628,MATH 10C,B02,188244,Staff,13,0,30,17
1683674534628,MATH 10C,B03,188277,Staff,14,0,30,16
1683674535653,MATH 18,A01,188344,Bach; Quang Tran,18,0,30,12
1683674535653,MATH 18,A02,188345,Bach; Quang Tran,11,0,30,19
1683674535653,MATH 18,B01,188353,Bach; Quang Tran,11,0,30,19
1683674535653,MATH 18,B02,188354,Bach; Quang Tran,19,0,30,11
1683674536677,MATH 20A,A01,188374,Staff,11,0,35,24
1683674537702,MATH 20B,A01,188382,Ohm; Ko Woon,7,0,30,23
1683674537702,MATH 20B,A02,188383,Ohm; Ko Woon,22,0,30,8
1683674537702,MATH 20B,B01,188385,Ohm; Ko Woon,7,0,30,23
1683674537702,MATH 20B,B02,188392,Ohm; Ko Woon,22,0,30,8
1683674538730,MATH 20C,A01,188394,Harel; Guershon,10,0,30,20
1683674538730,MATH 20C,A02,188395,Harel; Guershon,13,0,30,17
1683674538730,MATH 20C,B01,188404,Harel; Guershon,5,0,30,25
1683674538730,MATH 20C,B02,188405,Harel; Guershon,18,0,30,12
1683674539760,MATH 20D,A01,188414,Hammock; Frances H,0,1,30,30
1683674539760,MATH 20D,A02,188415,Hammock; Frances H,0,1,30,30
1683674539760,MATH 20D,B01,188447,Hammock; Frances H,0,1,30,30
1683674539760,MATH 20D,B02,188486,Hammock; Frances H,3,0,30,27
1683674540787,MATH 20E,A01,188649,Staff,21,0,30,9
1683674540787,MATH 20E,A02,188650,Staff,20,0,30,10
1683674540787,MATH 20E,A03,188673,Staff,0,0,30,30
1683674541812,MATH 102,A01,188675,Staff,0,39,35,35
1683674542840,MATH 103B,A01,188681,Staff,3,0,35,32
1683674542840,MATH 103B,B01,188692,Staff,5,0,35,30
1683674543866,MATH 109,A01,188695,Salehi Golsefidy; Alireza,24,0,35,11
1683674543866,MATH 109,A02,188696,Salehi Golsefidy; Alireza,25,0,35,10
1683674544895,MATH 120A,A01,188698,Eggers; John Dietrich,7,0,35,28
1683674545918,MATH 142B,A01,188736,Ioana; Adrian,1,1,30,29
1683674545918,MATH 142B,A02,188741,Ioana; Adrian,0,1,30,30
1683674545918,MATH 142B,A03,188743,Ioana; Adrian,0,1,30,30
1683674546944,MATH 168A,A01,188790,Staff,0,11,35,35
1683674547973,MATH 170A,A01,188803,Nie; Jiawang,0,2,35,35
1683674547973,MATH 170A,A02,188811,Nie; Jiawang,0,0,35,35
1683674547973,MATH 170A,A03,188814,Nie; Jiawang,0,0,35,35
1683674547973,MATH 170A,A04,188815,Nie; Jiawang,6,0,35,29
1683674548999,MATH 193B,A01,188817,Staff,0,0,35,35
1683674548999,MATH 193B,A02,188818,Staff,5,0,35,30
1683674550028,MGT 4,A01,202857,Anderson; John Charles,60,0,80,20
1683674551056,MGT 12,A00,202858,Lindenberger; Wade Douglas,40,0,90,50
1683674552082,MGT 18,A00,202859,Staff,74,0,90,16
1683674553106,MGT 18GS,A00,202860,McKay; Michael J,13,0,28,15
1683674554131,MGT 45,A00,202861,Pecore; Joseph P.,10,0,90,80
1683674555157,MGT 100,A00,202863,Yavorsky; Daniel Ryan,28,0,90,62
1683674556184,MGT 103,A00,202864,Ehrich; Kristine R,0,18,90,90
1683674557209,MGT 112,A00,202865,Ehrich; Kristine R,15,0,90,75
1683674558236,MGT 121A,A00,202868,Staff,90,20,90,0
1683674559260,MGT 131B,A00,202869,Anderson; John Charles,59,0,90,31
1683674560289,MGT 136,A00,202871,Lindenberger; Wade Douglas,83,0,90,7
1683674561314,MGT 164,A00,202873,Staff,0,67,90,91
1683674562338,MGT 164GS,A00,202874,McKay; Mary A,13,0,28,15
1683674563365,MGT 180,A00,202875,Staff,0,51,90,91
1683674564392,MMW 11R,A01,205019,Herbst; Matthew,0,0,30,30
1683674564392,MMW 11R,A02,205026,Herbst; Matthew,29,0,30,1
1683674565418,MMW 15,A01,193512,Chang; Edmond Yi-Teh,0,8,28,28
1683674565418,MMW 15,A02,193513,Chang; Edmond Yi-Teh,0,5,28,28
1683674565418,MMW 15,A03,193514,Chang; Edmond Yi-Teh,0,5,28,28
1683674565418,MMW 15,A04,193515,Chang; Edmond Yi-Teh,0,5,28,28
1683674565418,MMW 15,A05,193516,Chang; Edmond Yi-Teh,0,5,28,28
1683674565418,MMW 15,A06,193517,Chang; Edmond Yi-Teh,0,6,28,28
1683674565418,MMW 15,B01,193519,Chang; Edmond Yi-Teh,0,5,28,28
1683674565418,MMW 15,B02,193520,Chang; Edmond Yi-Teh,0,5,28,28
1683674565418,MMW 15,B03,193521,Chang; Edmond Yi-Teh,0,5,28,28
1683674565418,MMW 15,B04,193522,Chang; Edmond Yi-Teh,0,5,28,28
1683674565418,MMW 15,B05,193523,Chang; Edmond Yi-Teh,0,5,28,28
1683674565418,MMW 15,B06,193524,Chang; Edmond Yi-Teh,0,5,28,28
1683674566447,MMW 122,A01,193526,Rahimi; Babak,0,16,28,28
1683674566447,MMW 122,A02,193527,Rahimi; Babak,0,15,28,28
1683674566447,MMW 122,A03,193528,Rahimi; Babak,0,0,0,0
1683674566447,MMW 122,A04,193529,Rahimi; Babak,0,0,0,0
1683674567471,MUS 1A,A01,186663,Staff,1,19,35,34
1683674568496,MUS 4,A01,186715,Staff,0,12,35,35
1683674569524,MUS 5R,A01,186796,Dubnov; Shlomo,0,17,35,35
1683674570551,MUS 6,A01,186798,Staff,0,5,25,25
1683674571578,MUS 7,A01,186830,Staff,11,0,35,24
1683674572601,MUS 8,A01,186930,Staff,0,27,35,35
1683674573631,MUS 15,A01,186932,Staff,0,15,35,35
1683674573631,MUS 15,B01,186934,Staff,1,17,35,34
1683674574658,MUS 80,A00,186935,Staff,0,0,20,20
1683674574658,MUS 80,B00,186936,Staff,24,0,25,1
1683674575683,NANO 11,A00,204702,Lipomi; Darren John,0,0,0,0
1683674576707,NANO 15,A01,204709,Yang; Kesong,0,1,0,0
1683674577732,NANO 114,A00,202069,Jahed Motlagh; Zeinab,3,0,10,7
1683674578755,PHIL 1,A00,186955,Grush; Rick Scott,31,0,40,9
1683674579783,PHIL 10,A01,186973,Grush; Rick Scott,27,0,35,8
1683674579783,PHIL 10,A02,186974,Grush; Rick Scott,33,0,35,2
1683674580807,PHIL 13,A01,186976,Staff,3,0,35,32
1683674580807,PHIL 13,A02,186977,Staff,16,0,35,19
1683674581833,PHIL 14,A01,186979,Staff,31,0,35,4
1683674581833,PHIL 14,A02,186986,Staff,32,0,35,3
1683674582858,PHIL 28,A01,186988,Staff,16,0,30,14
1683674582858,PHIL 28,A02,186989,Staff,1,0,30,29
1683674582858,PHIL 28,A03,186990,Staff,10,0,30,20
1683674582858,PHIL 28,A04,186991,Staff,26,0,30,4
1683674583885,PHIL 120,A00,186997,Staff,23,0,40,17
1683674584913,PHIL 137,A00,187003,Staff,7,0,40,33
1683674585937,PHIL 150,A00,187015,Staff,47,0,70,23
1683674586962,PHIL 167,A00,187021,Lamey; Andy M.,34,0,40,6
1683674587986,PHIL 174,A01,202226,Staff,17,0,20,3
1683674587986,PHIL 174,A02,202235,Staff,20,0,20,0
1683674589010,PHIL 191A,A00,258918,Staff,0,0,1,1
1683674590037,PHYS 1A,A00,187028,Staff,26,0,60,34
1683674591065,PHYS 1AL,001,187036,Staff,3,0,30,27
1683674591065,PHYS 1AL,002,187049,Staff,18,0,30,12
1683674592089,PHYS 1B,A00,187058,Staff,22,0,60,38
1683674593115,PHYS 1BL,001,187064,Staff,0,1,30,30
1683674593115,PHYS 1BL,002,187070,Staff,4,0,30,26
1683674594140,PHYS 1C,A00,187082,Staff,29,0,120,91
1683674595169,PHYS 1CL,001,187088,Staff,0,9,30,30
1683674595169,PHYS 1CL,002,187089,Staff,0,1,30,30
1683674595169,PHYS 1CL,009,262693,Staff,9,0,30,21
1683674596193,PHYS 2B,A01,187097,Staff,55,0,115,60
1683674597218,PHYS 2C,A01,187099,Staff,63,0,115,52
1683674598246,PHYS 2CL,A01,187101,Staff,5,0,28,23
1683674598246,PHYS 2CL,A02,187102,Staff,15,0,28,13
1683674599273,PHYS 2D,A01,187123,Shotwell; Brian,95,0,115,20
1683674600298,PHYS 4B,A01,187133,Grinstein; Benjamin,35,0,50,15
1683674601321,POLI 10,A00,188819,Staff,0,4,50,50
1683674602345,POLI 11,A00,188827,Staff,43,0,50,7
1683674603369,POLI 13R,A00,188828,Staff,0,1,20,20
1683674604394,POLI 27,A01,188830,Elgin; Samuel Zincke,0,2,70,70
1683674605416,POLI 30,A00,188832,Desposato; Scott,30,0,50,20
1683674606441,POLI 102F,A00,188834,Staff,0,0,40,40
1683674607465,POLI 104A,A00,188852,Staff,12,0,30,18
1683674608489,POLI 104I,A00,188853,Staff,0,8,20,20
1683674609513,POLI 110B,A00,188854,Wiens; David,6,0,20,14
1683674610541,POLI 112A,A00,188855,Wiens; David,3,0,30,27
1683674611568,POLI 117R,A00,188856,Forman; Fonna,0,12,20,20
1683674612595,POLI 118,A00,188857,Ingham; Sean,8,0,20,12
1683674613619,POLI 120G,A00,188858,Staff,8,0,30,22
1683674614647,POLI 131CR,A00,188863,Hoston; Germaine,20,0,50,30
1683674615729,POLI 133,A00,188864,Nellis; Gareth Hb,44,0,50,6
1683674616758,POLI 134D,A00,188865,Desposato; Scott,27,0,30,3
1683674617783,POLI 142A,A00,188871,Gartzke; Erik,21,0,50,29
1683674618808,POLI 142K,A00,188874,Staff,38,0,50,12
1683674619832,POLI 143,A00,188940,Gartzke; Erik,16,0,30,14
1683674620856,POLI 153,A00,188943,Staff,2,0,20,18
1683674621882,POLI 160AA,A00,188944,Staff,11,0,40,29
1683674622906,POLI 170A,A00,188945,Staff,10,0,30,20
1683674624954,PSYC 1,A00,188952,Staff,37,0,90,53
1683674625981,PSYC 2,B00,188953,Staff,19,0,35,16
1683674627008,PSYC 6,A00,188970,Staff,47,0,60,13
1683674628036,PSYC 7,A00,188973,Staff,35,0,45,10
1683674629062,PSYC 60,A01,188980,Rickard; Timothy C.,42,0,60,18
1683674630089,PSYC 70,A01,189001,Steiner; Eric Tomas,21,0,45,24
1683674631117,PSYC 100,A00,189005,Lacefield; Katharine I,0,99,120,120
1683674632141,PSYC 102,A00,189008,Staff,8,0,30,22
1683674633166,PSYC 106,B00,189026,Gorman; Michael R.,27,0,60,33
1683674634191,PSYC 114,B01,189033,Winkielman; Piotr,0,31,30,30
1683674635215,PSYC 131,A00,189036,Anagnostaras; Stephan,0,43,60,60
1683674636238,PSYC 136,A00,189041,Lowe; Angela Beth,0,7,25,25
1683674637266,PSYC 137,A00,189057,Winkielman; Piotr,1,37,25,24
1683674638291,PSYC 144,A00,189107,Wixted; John T,0,11,50,50
1683674640341,PSYC 162,A00,189142,Staff,0,9,85,85
1683674641365,PSYC 172,A00,189144,Gorman; Michael R.,0,6,30,30
1683674643418,PSYC 179,A00,189146,Lacefield; Katharine I,0,87,120,120
1683674644440,PSYC 181,A00,189147,Anagnostaras; Stephan,0,44,90,90
1683674645466,PSYC 190R,A00,189148,Barner; David A.,0,23,80,80
1683674646490,PSYC 191,A00,189275,Rickard; Timothy C.,0,10,25,25
1683674647518,PSYC 193,A00,189276,Chapman; Eddie Nathaniel,0,1,0,4
1683674648545,PSYC 193L,A01,189281,Lowe; Angela Beth,8,0,20,12
1683674648545,PSYC 193L,B01,189285,Staff,28,0,35,7
1683674649570,RELI 149,A00,187137,Rahimi; Babak,7,0,40,33
1683674650594,SE 9,A01,187315,Staff,0,2,18,18
1683674651616,SE 101B,A00,187409,Staff,24,0,30,6
1683674652641,SE 110B,A00,187444,Staff,10,0,40,30
1683674653665,SE 130B,A00,187449,Staff,31,0,40,9
1683674654694,SE 150A,A00,187516,Staff,8,0,20,12
1683674655721,SE 154,A00,187528,Staff,29,0,50,21
1683674656745,SIO 3,A01,258171,Staff,35,0,40,5
1683674657773,SIO 10,A00,187144,Cook; Geoffrey W,0,7,75,75
1683674658797,SIO 45,A00,187152,Cook; Geoffrey W,0,7,100,100
1683674659821,SIO 109R,A00,194486,Staff,0,4,20,20
1683674661873,SIO 187,A01,187233,Kacev; David,12,0,40,28
1683674662903,SOCI 1,A01,258656,Thorpe; Charles Robert,28,0,30,2
1683674662903,SOCI 1,A02,258658,Thorpe; Charles Robert,30,0,30,0
1683674662903,SOCI 1,A03,258661,Thorpe; Charles Robert,25,0,25,0
1683674662903,SOCI 1,A04,258666,Thorpe; Charles Robert,22,0,25,3
1683674662903,SOCI 1,A05,258897,Thorpe; Charles Robert,22,0,25,3
1683674662903,SOCI 1,A06,258898,Thorpe; Charles Robert,25,0,25,0
1683674663927,SOCI 30,A01,258903,Pardo Guerra; Juan Pablo,14,0,30,16
1683674664953,SOCI 102,A00,258904,Staff,9,0,25,16
1683674665977,SOCI 106,A00,258905,Staff,19,0,25,6
1683674667001,SOCI 111,A00,258907,Ribas Norris; Janet Vanesa,26,0,30,4
1683674668025,SOCI 121R,A00,258908,Pardo Guerra; Juan Pablo,8,0,30,22
1683674669049,SOCI 126,A01,203330,Staff,14,0,20,6
1683674670073,SOCI 131,A00,258909,Thorpe; Charles Robert,30,0,60,30
1683674671097,SOCI 135,A00,258910,Payne; Christine Anna,0,11,30,30
1683674672125,SOCI 157,A00,258911,Staff,11,0,30,19
1683674673153,SOCI 184,A00,258912,Staff,25,0,30,5
1683674674177,SOCI 188D,A00,258913,Staff,22,0,30,8
1683674675201,SYN 2,001,187529,Staff,9,0,16,7
1683674675201,SYN 2,002,201452,Staff,0,20,16,16
1683674675201,SYN 2,003,201469,Staff,1,0,16,15
1683674676225,SYN 100,A01,187531,Staff,0,9,20,20
1683674676225,SYN 100,B01,201491,Staff,0,10,20,20
1683674677251,TDAC 1,A00,189286,Walsh; Kim C.,3,0,20,17
1683674677251,TDAC 1,B00,189287,Harting; Carla Kelso,10,0,20,10
1683674678278,TDAC 101,A00,189300,Walsh; Kim C.,16,0,20,4
1683674678278,TDAC 101,B00,189301,Harting; Carla Kelso,18,0,20,2
1683674679304,TDAC 102,A00,189304,Basso; Beatrice,14,0,20,6
1683674680328,TDAC 108,A00,189305,Staff,18,0,20,2
1683674681353,TDDE 131,A00,189310,Staff,19,0,20,1
1683674681353,TDDE 131,B00,189314,Staff,19,0,20,1
1683674681353,TDDE 131,C00,189315,Staff,48,0,50,2
1683674681353,TDDE 131,D00,189316,Staff,14,0,15,1
1683674681353,TDDE 131,E00,204841,Staff,20,0,20,0
1683674682377,TDGE 10,A00,189289,Staff,27,0,50,23
1683674682377,TDGE 10,B00,189290,Havis; Allan,0,1,50,50
1683674683408,TDGE 11,A00,189291,Fulton; Julia,0,4,50,50
1683674683408,TDGE 11,B00,189292,Staff,20,0,25,5
1683674683408,TDGE 11,C00,260270,Staff,0,0,0,0
1683674684432,TDGE 25,A00,189294,Staff,1,0,20,19
1683674685459,TDGE 124,A00,189318,Fulton; Julia,0,8,50,50
1683674686483,TDGE 125,A00,189319,Staff,13,0,25,12
1683674686483,TDGE 125,B00,189320,Staff,23,0,25,2
1683674687510,TDGE 127,A00,189322,Havis; Allan,0,0,50,50
1683674688535,TDHT 101,A00,189323,Staff,18,0,25,7
1683674688535,TDHT 101,B00,189324,Staff,25,0,25,0
1683674689562,TDHT 102,A00,189325,Staff,49,0,50,1
1683674690590,TDMV 1,A00,189295,Arcidiacono; Kristin,20,0,30,10
1683674690590,TDMV 1,B00,189296,Caligagan; Maria T.,24,0,30,6
1683674691620,TDMV 2,A00,189297,Sammartano; Tonnie,27,0,30,3
1683674691620,TDMV 2,B00,189299,Arcidiacono; Kristin,23,0,30,7
1683674692646,TDMV 3,A00,204998,Rincon; Alicia,22,0,30,8
1683674693669,TDMV 120,A00,189458,Sammartano; Tonnie,28,0,30,2
1683674694693,TDMV 138,A00,189541,Jun; Grace Shin Hae,20,0,40,20
1683674695722,TDMV 142,A00,189717,Caligagan; Tony,25,0,30,5
1683674695722,TDMV 142,B00,189718,Caligagan; Maria T.,25,0,30,5
1683674696750,TMC 2,A01,187533,Staff,25,0,25,0
1683674696750,TMC 2,A02,187534,Staff,25,0,25,0
1683674697774,USP 1,A01,187536,Kwak; Nancy,0,16,25,25
1683674698798,USP 5,A01,187538,Staff,9,0,25,16
1683674699825,USP 101,A00,199253,Staff,0,4,0,0
1683674700852,USP 124,A00,187562,Boomhower; Matthew Charles,0,0,30,30
1683674701883,USP 138,A00,187582,Staff,19,0,25,6
1683674702907,USP 152,A01,187597,Staff,3,0,25,22
1683674703933,USP 153,A00,187598,Staff,19,0,25,6
1683674704958,USP 168,A00,187607,Kwak; Nancy,2,0,5,3
1683674705982,USP 173,A00,187619,Staff,4,0,25,21
1683674707006,USP 181,A00,187638,Staff,0,4,25,25
1683674708031,VIS 103,A00,187650,Cruz; Edwin Teddy,17,0,75,58
1683674709058,VIS 110D,A00,187669,Staff,13,0,22,9
1683674710082,VIS 127C,A00,187720,Shen; Kuiyi,67,0,146,79
1683674711108,VIS 149,A00,187731,Yoldas; Pinar,1,14,22,21
1683674712137,VIS 151,A01,188091,Staff,22,0,34,12
1683674712137,VIS 151,A02,188092,Staff,11,0,34,23
1683674713160,VIS 160B,A00,188093,Stalbaum; Brett,0,1,10,10
1683674715212,WCWP 10B,A00,201720,Staff,0,0,5,5
1683674715212,WCWP 10B,B00,201722,Staff,0,0,6,6
1683674716235,WCWP 100,A00,201725,Gagnon; Jeffrey C,0,0,2,2
1683674716235,WCWP 100,B00,201727,Staff,0,4,15,15
1683674719400,ANBI 133,A00,258401,Wilder; Linnea Lorene,34,0,40,6
1683674720429,ANBI 140,A00,258395,Hrvoj Mihic; Branka,18,0,25,7
1683674721453,ANSC 120,A00,258402,Bialecki; Jon Anthony,26,0,40,14
1683674722477,ANSC 144,A00,258400,Staff,12,0,40,28
1683674724530,ANSC 166,A00,258396,Parish; Steven Martin,156,0,175,19
1683674725556,ANSC 180,A00,193533,Staff,8,0,20,12
1683674726581,ANSC 188,A00,258397,Jassal; Aftab,34,0,40,6
1683674727609,ANTH 3,A01,258316,Staff,23,0,30,7
1683674728636,ANTH 5,A00,258394,Semendeferi; Ekaterini,16,0,20,4
1683674729661,ANTH 21,A01,258331,Staff,4,0,40,36
1683674730689,ANTH 103,A00,258398,Varma; Saiba,15,0,25,10
1683674731723,AWP 10,001,202034,Staff,0,0,0,0
1683674731723,AWP 10,002,202035,Staff,0,0,0,0
1683674731723,AWP 10,003,202036,Staff,0,0,0,0
1683674731723,AWP 10,004,202037,Staff,0,0,0,0
1683674731723,AWP 10,005,202038,Staff,0,0,0,0
1683674731723,AWP 10,006,202039,Staff,0,0,0,0
1683674731723,AWP 10,007,202040,Staff,0,0,0,0
1683674731723,AWP 10,008,202041,Staff,0,0,0,0
1683674731723,AWP 10,009,202042,Staff,0,0,0,0
1683674731723,AWP 10,010,202043,Staff,0,0,0,0
1683674731723,AWP 10,011,202044,Staff,0,0,0,0
1683674731723,AWP 10,012,202045,Staff,0,0,0,0
1683674731723,AWP 10,013,202046,Staff,0,0,0,0
1683674731723,AWP 10,014,202047,Staff,0,0,0,0
1683674731723,AWP 10,015,202048,Staff,0,0,0,0
1683674731723,AWP 10,016,202049,Staff,0,0,0,0
1683674731723,AWP 10,017,202050,Staff,0,0,0,0
1683674731723,AWP 10,018,202051,Staff,0,0,0,0
1683674731723,AWP 10,019,202052,Staff,0,0,0,0
1683674731723,AWP 10,020,202053,Staff,0,0,0,0
1683674731723,AWP 10,021,202054,Staff,0,0,0,0
1683674731723,AWP 10,022,202055,Staff,0,0,0,0
1683674731723,AWP 10,023,202056,Staff,0,0,0,0
1683674731723,AWP 10,024,202057,Staff,0,0,0,0
1683674731723,AWP 10,025,202058,Staff,0,0,0,0
1683674731723,AWP 10,026,202059,Staff,0,0,0,0
1683674732747,AWP 102,001,202032,Staff,0,0,0,0
1683674732747,AWP 102,002,202033,Staff,0,0,0,0
1683674733777,BENG 100,A01,254234,Taylor Amos; Alyssa C,31,0,40,9
1683674734801,BENG 196,001,270013,Engler; Adam J.,9999,0,9999,0
1683674735827,BICD 100R,A01,202018,Smith; Laurie,0,7,32,32
1683674735827,BICD 100R,A02,202019,Smith; Laurie,0,3,32,32
1683674735827,BICD 100R,A03,202020,Smith; Laurie,0,1,32,32
1683674735827,BICD 100R,A04,202021,Smith; Laurie,6,0,32,26
1683674735827,BICD 100R,A05,202022,Smith; Laurie,11,0,32,21
1683674736854,BICD 136,A01,193242,Gustafson-Brown; Cindy,0,2,32,32
1683674736854,BICD 136,A02,193244,Gustafson-Brown; Cindy,13,0,32,19
1683674737884,BIEB 102,A01,193249,Butler; Shannon Rhey,1,1,32,31
1683674737884,BIEB 102,A02,193251,Butler; Shannon Rhey,0,0,32,32
1683674737884,BIEB 102,A03,193253,Butler; Shannon Rhey,0,0,32,32
1683674737884,BIEB 102,A04,193255,Butler; Shannon Rhey,13,0,32,19
1683674737884,BIEB 102,A05,193265,Butler; Shannon Rhey,25,0,32,7
1683674737884,BIEB 102,A06,193269,Butler; Shannon Rhey,13,0,32,19
1683674739937,BIEB 150,A01,193274,Staff,0,0,32,32
1683674739937,BIEB 150,A02,193285,Staff,24,0,32,8
1683674740963,BIEB 194,A00,193286,Kurle; Carolyn M.,19,0,32,13
1683674741991,BILD 1,A01,192291,Staff,15,0,32,17
1683674741991,BILD 1,A02,192292,Staff,30,0,32,2
1683674741991,BILD 1,B01,192520,Reuther; Keefe,0,1,0,0
1683674741991,BILD 1,B02,192532,Reuther; Keefe,0,1,0,0
1683674743021,BILD 3,A01,192556,Butler; Shannon Rhey,0,0,32,32
1683674743021,BILD 3,A02,192581,Butler; Shannon Rhey,0,1,32,32
1683674743021,BILD 3,A03,192611,Butler; Shannon Rhey,19,0,32,13
1683674743021,BILD 3,A04,192612,Butler; Shannon Rhey,24,0,32,8
1683674743021,BILD 3,A05,192613,Butler; Shannon Rhey,26,0,32,6
1683674743021,BILD 3,A06,192679,Butler; Shannon Rhey,27,0,32,5
1683674743021,BILD 3,A07,192682,Butler; Shannon Rhey,20,0,32,12
1683674744045,BILD 4,A01,192836,Reuther; Keefe,1,0,24,23
1683674744045,BILD 4,A02,193044,Reuther; Keefe,4,0,24,20
1683674745070,BILD 10,A01,193142,Gustafson-Brown; Cindy,29,0,32,3
1683674745070,BILD 10,A02,193149,Gustafson-Brown; Cindy,31,0,32,1
1683674746098,BIMM 100,A01,193301,Staff,0,6,32,32
1683674746098,BIMM 100,A02,193312,Staff,0,7,32,32
1683674746098,BIMM 100,A03,193323,Staff,0,10,32,32
1683674747125,BIMM 101,A01,193329,McDonnell; Lisa Marie,1,4,24,23
1683674747125,BIMM 101,A02,193339,McDonnell; Lisa Marie,1,4,24,23
1683674747125,BIMM 101,B01,193354,McDonnell; Lisa Marie,0,4,24,24
1683674747125,BIMM 101,B02,193357,McDonnell; Lisa Marie,0,3,24,24
1683674748151,BIMM 110,A01,193377,Tat; John,0,11,32,32
1683674748151,BIMM 110,A02,193378,Tat; John,0,10,32,32
1683674749177,BIMM 120,A01,206116,Staff,0,0,32,32
1683674749177,BIMM 120,A02,206117,Staff,7,0,32,25
1683674749177,BIMM 120,A03,206121,Staff,21,0,32,11
1683674750201,BIPN 100,A01,193393,Park; Ji Young,0,15,32,32
1683674750201,BIPN 100,A02,193402,Park; Ji Young,0,14,32,32
1683674750201,BIPN 100,A03,193413,Park; Ji Young,0,14,32,32
1683674750201,BIPN 100,A04,193414,Park; Ji Young,0,13,32,32
1683674751226,BIPN 102,A01,193429,Staff,0,0,32,32
1683674751226,BIPN 102,A02,193438,Staff,18,0,32,14
1683674752253,BIPN 106,A01,193450,Reyes Gonzalez; Catalina,0,2,40,40
1683674753277,BIPN 134,A01,193465,Cooke; James Edward,0,0,32,32
1683674753277,BIPN 134,A02,193474,Cooke; James Edward,25,0,32,7
1683674753277,BIPN 134,A03,193485,Cooke; James Edward,29,0,32,3
1683674753277,BIPN 134,A04,193486,Cooke; James Edward,20,0,32,12
1683674753277,BIPN 134,A05,193491,Cooke; James Edward,31,0,32,1
1683674753277,BIPN 134,A06,193501,Cooke; James Edward,30,0,32,2
1683674753277,BIPN 134,A07,193510,Cooke; James Edward,29,0,32,3
1683674755330,BISP 194,A00,222522,Staff,14,0,32,18
1683674756357,CAT 124,A01,202407,Staff,19,0,25,6
1683674757384,CAT 125,A00,202408,Marchisotto; Jennifer Anne,2,0,20,18
1683674758408,CAT 125R,A00,202409,Smith; Lauryn Alissa,0,11,20,20
1683674758408,CAT 125R,B00,202410,Morales; Celeste Georgianna,0,11,20,20
1683674758408,CAT 125R,C00,202411,Irwin; Matthew Joseph,0,12,20,20
1683674759434,CENG 15,A01,204712,Yang; Kesong,0,1,0,0
1683674760461,CENG 114,A00,202070,Jahed Motlagh; Zeinab,5,0,20,15
1683674761489,CGS 105,A00,185477,Wesling; Megan E.,24,0,40,16
1683674762513,CGS 106,A00,185494,Staff,11,0,22,11
1683674763540,CGS 108,A00,185495,Staff,14,0,20,6
1683674764563,CGS 114,A00,185496,Staff,13,0,18,5
1683674765589,CGS 119,A00,185501,Staff,15,0,20,5
1683674766613,CGS 120,A00,185511,Staff,12,0,20,8
1683674767641,CHEM 4,A01,184675,Bussey; Thomas J,97,0,100,3
1683674768665,CHEM 6A,A01,184677,Staff,32,0,60,28
1683674769689,CHEM 6B,A01,184679,Staff,63,0,100,37
1683674770713,CHEM 6C,A01,184681,Bussey; Thomas J,0,0,50,50
1683674770713,CHEM 6C,A02,184682,Bussey; Thomas J,32,0,50,18
1683674771741,CHEM 40A,A01,184684,Albizati; Kim F.,33,0,100,67
1683674772768,CHEM 40B,A01,184686,Albizati; Kim F.,0,22,100,100
1683674773791,CHEM 41B,A01,184690,Staff,51,0,100,49
1683674774832,COGS 3,A01,184715,Boyle; Mary E. T.,0,27,40,40
1683674775856,COGS 14B,A01,185172,Staff,0,14,38,38
1683674776881,COGS 18,A01,184736,Staff,14,0,80,66
1683674777905,COGS 100,A01,184932,Staff,0,8,73,73
1683674778933,COGS 101A,A01,184935,Staff,0,40,30,30
1683674779957,COGS 101B,A01,184944,Staff,0,2,30,30
1683674780985,COGS 101C,A01,184946,Staff,0,10,30,30
1683674782008,COGS 102A,A01,184951,Johnson; Christine M.,2,0,40,38
1683674783034,COGS 107B,A01,184953,Mooshagian; Eric Frederick,0,52,40,40
1683674784059,COGS 118B,A01,184959,Gupta; Anjum,0,50,40,40
1683674785083,COGS 153,A00,184961,Staff,0,16,30,30
1683674786107,COGS 177,A00,184962,Staff,0,21,30,30
1683674787131,COGS 187A,A01,184969,Boyle; Mary E. T.,0,19,40,40
1683674788156,COMM 10,A01,185174,Staff,0,5,25,25
1683674788156,COMM 10,A02,185189,Staff,0,2,25,25
1683674788156,COMM 10,A03,269821,Staff,0,1,0,0
1683674789180,COMM 100B,A01,185475,Staff,0,1,0,1
1683674789180,COMM 100B,A02,185476,Staff,11,0,25,14
1683674790207,COMM 100C,A01,185314,Staff,1,0,25,24
1683674790207,COMM 100C,A02,185327,Staff,17,0,25,8
1683674791233,COMM 110M,A00,185349,Staff,0,0,40,40
1683674792257,COMM 113T,A00,185352,Staff,25,0,40,15
1683674793281,COMM 114I,A00,185353,Staff,31,0,40,9
1683674794306,COMM 131,A00,185354,Staff,17,0,30,13
1683674795330,CSE 8A,A50,185358,Cao; Yingjun,0,46,10,10
1683674796356,CSE 8B,A01,185362,Staff,0,48,50,50
1683674797384,CSE 11,A01,185416,Cao; Yingjun,0,91,10,10
1683674798409,CSE 20,A01,185445,Briones; Jor-el Thomas Caparas,4,0,25,21
1683674799433,CSE 21,A01,185447,Staff,9,0,50,41
1683674800458,CSE 101,A01,185451,Staff,0,13,50,50
1683674800458,CSE 101,B01,185453,Jones; Miles E,0,14,50,50
1683674802509,CSE 141,A01,185458,Eldon; John,16,0,100,84
1683674803534,CSE 141L,A01,185461,Eldon; John,8,0,100,92
1683674804561,CSE 142,A01,185463,Staff,34,0,60,26
1683674804561,CSE 142,B01,201355,Staff,0,7,60,60
1683674805589,CSE 142L,A01,185470,Staff,34,0,60,26
1683674805589,CSE 142L,B01,201417,Staff,0,6,60,60
1683674806612,CSE 190,A00,201433,Staff,32,0,49,17
1683674807637,DOC 1,A01,259136,Strom; Megan C.,7,0,15,8
1683674807637,DOC 1,A02,259137,Strom; Megan C.,14,0,15,1
1683674807637,DOC 1,A03,259138,Strom; Megan C.,14,0,15,1
1683674807637,DOC 1,A04,259139,Strom; Megan C.,14,0,15,1
1683674808664,DOC 100D,A00,259140,Pass; Natalye Joann,14,0,25,11
1683674809693,DSGN 1,A01,184749,Rill; Bryan,0,26,30,30
1683674810717,DSGN 100,A01,185168,Staff,0,2,25,25
1683674811741,ECE 5,A01,185626,Morris; Karcher William,0,12,0,0
1683674812770,ECE 101,A01,185628,Staff,14,0,70,56
1683674813795,ECE 107,A01,185635,Baghdadchi; Saharnaz,0,0,20,20
1683674813795,ECE 107,A02,185638,Baghdadchi; Saharnaz,1,0,20,19
1683674814822,ECE 148,A01,185647,Silberman; Jack,0,0,16,16
1683674815845,ECON 1,A01,185537,Crane; Meredith Helen,54,0,70,16
1683674816873,ECON 3,A01,185549,Crane; Meredith Helen,29,0,70,41
1683674817897,ECON 4,A01,203354,Anderson; John Charles,0,5,10,10
1683674818924,ECON 100A,A01,185574,Staff,0,5,40,40
1683674819951,ECON 100B,A01,185576,Staff,0,12,50,50
1683674820975,ECON 100C,A01,185589,Newhouse; Herbert S,30,0,70,40
1683674821998,ECON 105,A00,185608,Vespa; Emanuel Ignacio,19,0,35,16
1683674823080,ECON 109,A01,185610,Shishkin; Denis,9,0,35,26
1683674824106,ECON 110A,A01,185612,Staff,9,0,40,31
1683674825133,ECON 120A,A01,185615,Staff,19,0,40,21
1683674826161,ECON 120C,A01,185617,Sun; Yixiao,0,21,70,70
1683674827185,ECON 144,A00,203346,Squires; Dale E,2,0,35,33
1683674828209,ECON 171,A01,203349,Newhouse; Herbert S,0,1,35,35
1683674829236,ECON 173A,A01,185621,Toda; Alexis Akira,21,0,35,14
1683674830260,EDS 25,A01,202413,Staff,0,1,0,0
1683674830260,EDS 25,A02,202414,Staff,0,1,0,0
1683674830260,EDS 25,A03,202415,Staff,0,0,0,0
1683674830260,EDS 25,A04,202416,Staff,0,1,0,0
1683674830260,EDS 25,A05,202439,Staff,0,0,0,0
1683674830260,EDS 25,A06,202440,Staff,0,0,0,0
1683674830260,EDS 25,B01,202631,Staff,0,0,0,0
1683674830260,EDS 25,B02,202632,Staff,0,0,0,0
1683674830260,EDS 25,B03,202639,Staff,0,0,0,0
1683674830260,EDS 25,B04,202640,Staff,0,0,0,0
1683674830260,EDS 25,B05,202643,Staff,0,0,0,0
1683674830260,EDS 25,B06,202644,Staff,0,0,0,0
1683674831284,EDS 38,A01,202659,Black; Alison Michelle,24,0,25,1
1683674832307,EDS 115,A00,202652,Staff,18,0,30,12
1683674833331,EDS 125,A00,202649,Staff,13,0,30,17
1683674834355,EDS 126,A01,203332,Staff,30,0,30,0
1683674835379,EDS 139,A00,202838,Staff,16,0,25,9
1683674836405,EDS 146,A01,202655,Staff,14,0,25,11
1683674837430,ENG 15,A00,185667,Staff,0,1,0,0
1683674837430,ENG 15,B00,185672,Staff,0,0,0,0
1683674837430,ENG 15,C00,185675,Staff,0,0,0,0
1683674837430,ENG 15,D00,185682,Staff,0,0,0,0
1683674837430,ENG 15,E00,185684,Staff,0,0,0,0
1683674838456,ETHN 103,A00,185710,Staff,0,8,35,35
1683674839480,ETHN 103A,A00,199228,Man; Simeon S,0,0,9,9
1683674840507,ETHN 109,A00,185711,Staff,15,0,35,20
1683674841531,ETHN 142,A00,185726,Staff,0,4,30,30
1683674842556,ETHN 163J,A00,199229,Man; Simeon S,5,0,8,3
1683674843580,ETHN 168,A00,185727,Staff,7,0,10,3
1683674844606,ETHN 182,A00,185728,Staff,0,0,35,35
1683674845630,ETHN 183,A00,185737,Staff,9,0,18,9
1683674846657,GLBH 111,A01,209361,Burgos; Jose L.,0,0,0,0
1683674848707,HIEU 104,A00,185792,Staff,14,0,20,6
1683674849730,HIEU 115,A00,185800,Staff,0,0,20,20
1683674850754,HIEU 128,A00,185801,Staff,0,9,20,20
1683674851779,HIEU 147,A00,185802,Staff,15,0,20,5
1683674852808,HIEU 154,A00,185823,Staff,11,0,20,9
1683674853834,HILA 102,A00,185826,Staff,14,0,20,6
1683674854858,HILD 2C,A01,185778,Staff,0,13,20,20
1683674855886,HILD 7B,A01,185780,Kwak; Nancy,0,17,32,32
1683674855886,HILD 7B,A02,185781,Kwak; Nancy,0,18,32,32
1683674856910,HILD 30,A01,185791,Staff,12,0,20,8
1683674857934,HISC 119,A00,185830,Golan; Tal,0,9,20,20
1683674858957,HITO 156GS,A00,185831,Patterson; Patrick H.,0,0,0,23
1683674859981,HIUS 103,A00,185832,Man; Simeon S,0,4,20,20
1683674861013,HIUS 117,A00,185836,Kwak; Nancy,2,0,20,18
1683674862039,HIUS 125,A00,185840,Man; Simeon S,0,2,23,23
1683674863064,HIUS 149,A00,185845,Staff,1,0,20,19
1683674864092,HUM 3,A01,185882,Zavodny; Tatiana Sophia,0,8,50,50
1683674864092,HUM 3,B01,185899,Caldwell; Michael Alan,0,18,50,50
1683674865116,HUM 3GS,A00,185900,Patterson; Patrick H.,0,0,0,23
1683674866144,HUM 4,A01,185938,Zroka; Amy Liane,28,0,50,22
1683674866144,HUM 4,B01,185956,Watkins; Eric,0,5,50,50
1683674866144,HUM 4,B02,202209,Watkins; Eric,0,5,50,50
1683674866144,HUM 4,B03,202210,Watkins; Eric,0,5,50,50
1683674867175,HUM 5,A01,185958,West; Geoffrey Scott,0,0,50,50
1683674867175,HUM 5,A02,202215,West; Geoffrey Scott,0,0,50,50
1683674868202,INTL 190,A00,185959,Gagnon; Jeffrey C,0,0,0,9
1683674868202,INTL 190,B00,185960,Lettieri; Michael Joseph,0,0,0,2
1683674869225,JAPN 180,A00,254509,Staff,5,0,30,25
1683674870254,LATI 10,A01,202853,Kennemore; Amy Michelle,4,0,35,31
1683674870254,LATI 10,A02,202854,Kennemore; Amy Michelle,2,0,35,33
1683674870254,LATI 10,A03,270054,Kennemore; Amy Michelle,30,0,30,0
1683674871282,LATI 180,A00,202855,Kennemore; Amy Michelle,11,0,20,9
1683674872311,LAWS 101,A00,201767,Golan; Tal,0,7,40,40
1683674873336,LIFR 1C,A00,185961,Staff,6,0,20,14
1683674874360,LIFR 1CX,A00,185962,Staff,7,0,20,13
1683674875383,LIFR 1D,A00,185963,Staff,7,0,20,13
1683674876410,LIFR 1DX,A00,185964,Staff,7,0,20,13
1683674877434,LIGN 101,A01,186039,Staff,43,0,50,7
1683674878458,LIGN 165,A00,186040,Staff,15,0,50,35
1683674879484,LTCS 108,A00,186041,Staff,5,0,10,5
1683674880509,LTCS 119,A00,186042,Staff,15,0,20,5
1683674881533,LTCS 130,A00,186043,Wesling; Megan E.,15,0,25,10
1683674883584,LTEA 138,A00,186119,Staff,14,0,40,26
1683674884608,LTEN 124,A00,186148,Staff,5,0,25,20
1683674885632,LTEN 178,A00,186149,Staff,7,0,15,8
1683674886659,LTEN 181,A00,186150,Blanco; John D,34,0,40,6
1683674887683,LTWL 120,A00,186160,Staff,19,0,25,6
1683674888709,LTWL 165,A00,186161,Staff,22,0,25,3
1683674889733,LTWR 100,A00,186162,Staff,0,5,15,15
1683674890757,LTWR 102,A00,186163,Doller; Ben,5,0,15,10
1683674891783,MAE 8,A01,186412,Staff,0,1,0,0
1683674892809,MAE 30B,A00,186445,Bahadori; Mohammad Yousef,82,0,100,18
1683674893834,MAE 40,A00,186592,Bewley; Thomas R,10,0,50,40
1683674894885,MAE 101B,A00,186593,Bahadori; Mohammad Yousef,80,0,100,20
1683674895913,MAE 105,A00,186594,Bandaru; Prabhakar,10,0,50,40
1683674896937,MAE 107,A00,186599,Pham; Hieu Tan,0,7,120,120
1683674897963,MAE 148,A01,186660,Silberman; Jack,3,0,16,13
1683674898993,MATH 10A,A01,188095,Staff,0,6,35,35
1683674900018,MATH 10B,A01,188097,Bowers; Adam R.,0,12,30,30
1683674900018,MATH 10B,A02,188099,Bowers; Adam R.,0,11,30,30
1683674900018,MATH 10B,B01,188104,Bowers; Adam R.,0,10,30,30
1683674900018,MATH 10B,B02,188106,Bowers; Adam R.,1,9,30,29
1683674901044,MATH 10C,A01,188111,Staff,0,20,30,30
1683674901044,MATH 10C,A02,188127,Staff,0,19,30,30
1683674901044,MATH 10C,A03,188131,Staff,0,19,30,30
1683674901044,MATH 10C,B01,188218,Staff,17,0,30,13
1683674901044,MATH 10C,B02,188244,Staff,13,0,30,17
1683674901044,MATH 10C,B03,188277,Staff,14,0,30,16
1683674902073,MATH 18,A01,188344,Bach; Quang Tran,18,0,30,12
1683674902073,MATH 18,A02,188345,Bach; Quang Tran,11,0,30,19
1683674902073,MATH 18,B01,188353,Bach; Quang Tran,11,0,30,19
1683674902073,MATH 18,B02,188354,Bach; Quang Tran,19,0,30,11
1683674903100,MATH 20A,A01,188374,Staff,11,0,35,24
1683674904129,MATH 20B,A01,188382,Ohm; Ko Woon,7,0,30,23
1683674904129,MATH 20B,A02,188383,Ohm; Ko Woon,22,0,30,8
1683674904129,MATH 20B,B01,188385,Ohm; Ko Woon,7,0,30,23
1683674904129,MATH 20B,B02,188392,Ohm; Ko Woon,22,0,30,8
1683674905155,MATH 20C,A01,188394,Harel; Guershon,10,0,30,20
1683674905155,MATH 20C,A02,188395,Harel; Guershon,13,0,30,17
1683674905155,MATH 20C,B01,188404,Harel; Guershon,5,0,30,25
1683674905155,MATH 20C,B02,188405,Harel; Guershon,18,0,30,12
1683674906184,MATH 20D,A01,188414,Hammock; Frances H,0,1,30,30
1683674906184,MATH 20D,A02,188415,Hammock; Frances H,0,1,30,30
1683674906184,MATH 20D,B01,188447,Hammock; Frances H,0,1,30,30
1683674906184,MATH 20D,B02,188486,Hammock; Frances H,3,0,30,27
1683674907209,MATH 20E,A01,188649,Staff,21,0,30,9
1683674907209,MATH 20E,A02,188650,Staff,20,0,30,10
1683674907209,MATH 20E,A03,188673,Staff,0,0,30,30
1683674908231,MATH 102,A01,188675,Staff,0,39,35,35
1683674909261,MATH 103B,A01,188681,Staff,3,0,35,32
1683674909261,MATH 103B,B01,188692,Staff,5,0,35,30
1683674910286,MATH 109,A01,188695,Salehi Golsefidy; Alireza,24,0,35,11
1683674910286,MATH 109,A02,188696,Salehi Golsefidy; Alireza,25,0,35,10
1683674911312,MATH 120A,A01,188698,Eggers; John Dietrich,7,0,35,28
1683674912336,MATH 142B,A01,188736,Ioana; Adrian,1,1,30,29
1683674912336,MATH 142B,A02,188741,Ioana; Adrian,0,1,30,30
1683674912336,MATH 142B,A03,188743,Ioana; Adrian,0,1,30,30
1683674913362,MATH 168A,A01,188790,Staff,0,11,35,35
1683674914386,MATH 170A,A01,188803,Nie; Jiawang,0,2,35,35
1683674914386,MATH 170A,A02,188811,Nie; Jiawang,0,0,35,35
1683674914386,MATH 170A,A03,188814,Nie; Jiawang,0,0,35,35
1683674914386,MATH 170A,A04,188815,Nie; Jiawang,6,0,35,29
1683674915411,MATH 193B,A01,188817,Staff,0,0,35,35
1683674915411,MATH 193B,A02,188818,Staff,5,0,35,30
1683674916438,MGT 4,A01,202857,Anderson; John Charles,60,0,80,20
1683674917461,MGT 12,A00,202858,Lindenberger; Wade Douglas,40,0,90,50
1683674918485,MGT 18,A00,202859,Staff,74,0,90,16
1683674919509,MGT 18GS,A00,202860,McKay; Michael J,13,0,28,15
1683674920533,MGT 45,A00,202861,Pecore; Joseph P.,10,0,90,80
1683674921561,MGT 100,A00,202863,Yavorsky; Daniel Ryan,28,0,90,62
1683674922587,MGT 103,A00,202864,Ehrich; Kristine R,0,18,90,90
1683674923611,MGT 112,A00,202865,Ehrich; Kristine R,15,0,90,75
1683674924636,MGT 121A,A00,202868,Staff,90,20,90,0
1683674925660,MGT 131B,A00,202869,Anderson; John Charles,59,0,90,31
1683674926743,MGT 136,A00,202871,Lindenberger; Wade Douglas,83,0,90,7
1683674927773,MGT 164,A00,202873,Staff,0,67,90,91
1683674928798,MGT 164GS,A00,202874,McKay; Mary A,13,0,28,15
1683674929821,MGT 180,A00,202875,Staff,0,51,90,91
1683674930849,MMW 11R,A01,205019,Herbst; Matthew,0,0,30,30
1683674930849,MMW 11R,A02,205026,Herbst; Matthew,29,0,30,1
1683674931873,MMW 15,A01,193512,Chang; Edmond Yi-Teh,0,8,28,28
1683674931873,MMW 15,A02,193513,Chang; Edmond Yi-Teh,0,5,28,28
1683674931873,MMW 15,A03,193514,Chang; Edmond Yi-Teh,0,5,28,28
1683674931873,MMW 15,A04,193515,Chang; Edmond Yi-Teh,0,5,28,28
1683674931873,MMW 15,A05,193516,Chang; Edmond Yi-Teh,0,5,28,28
1683674931873,MMW 15,A06,193517,Chang; Edmond Yi-Teh,0,6,28,28
1683674931873,MMW 15,B01,193519,Chang; Edmond Yi-Teh,0,5,28,28
1683674931873,MMW 15,B02,193520,Chang; Edmond Yi-Teh,0,5,28,28
1683674931873,MMW 15,B03,193521,Chang; Edmond Yi-Teh,0,5,28,28
1683674931873,MMW 15,B04,193522,Chang; Edmond Yi-Teh,0,5,28,28
1683674931873,MMW 15,B05,193523,Chang; Edmond Yi-Teh,0,5,28,28
1683674931873,MMW 15,B06,193524,Chang; Edmond Yi-Teh,0,5,28,28
1683674932896,MMW 122,A01,193526,Rahimi; Babak,0,16,28,28
1683674932896,MMW 122,A02,193527,Rahimi; Babak,0,15,28,28
1683674932896,MMW 122,A03,193528,Rahimi; Babak,0,0,0,0
1683674932896,MMW 122,A04,193529,Rahimi; Babak,0,0,0,0
1683674933920,MUS 1A,A01,186663,Staff,1,19,35,34
1683674934944,MUS 4,A01,186715,Staff,0,12,35,35
1683674935971,MUS 5R,A01,186796,Dubnov; Shlomo,0,17,35,35
1683674936995,MUS 6,A01,186798,Staff,0,5,25,25
1683674938019,MUS 7,A01,186830,Staff,11,0,35,24
1683674939047,MUS 8,A01,186930,Staff,0,27,35,35
1683674940074,MUS 15,A01,186932,Staff,0,15,35,35
1683674940074,MUS 15,B01,186934,Staff,1,17,35,34
1683674941103,MUS 80,A00,186935,Staff,0,0,20,20
1683674941103,MUS 80,B00,186936,Staff,24,0,25,1
1683674942129,NANO 11,A00,204702,Lipomi; Darren John,0,0,0,0
1683674943157,NANO 15,A01,204709,Yang; Kesong,0,1,0,0
1683674944187,NANO 114,A00,202069,Jahed Motlagh; Zeinab,3,0,10,7
1683674945214,PHIL 1,A00,186955,Grush; Rick Scott,31,0,40,9
1683674946241,PHIL 10,A01,186973,Grush; Rick Scott,27,0,35,8
1683674946241,PHIL 10,A02,186974,Grush; Rick Scott,33,0,35,2
1683674947265,PHIL 13,A01,186976,Staff,3,0,35,32
1683674947265,PHIL 13,A02,186977,Staff,16,0,35,19
1683674948288,PHIL 14,A01,186979,Staff,31,0,35,4
1683674948288,PHIL 14,A02,186986,Staff,32,0,35,3
1683674949312,PHIL 28,A01,186988,Staff,16,0,30,14
1683674949312,PHIL 28,A02,186989,Staff,1,0,30,29
1683674949312,PHIL 28,A03,186990,Staff,10,0,30,20
1683674949312,PHIL 28,A04,186991,Staff,26,0,30,4
1683674950336,PHIL 120,A00,186997,Staff,23,0,40,17
1683674951359,PHIL 137,A00,187003,Staff,7,0,40,33
1683674952383,PHIL 150,A00,187015,Staff,47,0,70,23
1683674953413,PHIL 167,A00,187021,Lamey; Andy M.,34,0,40,6
1683674954435,PHIL 174,A01,202226,Staff,17,0,20,3
1683674954435,PHIL 174,A02,202235,Staff,20,0,20,0
1683674955461,PHIL 191A,A00,258918,Staff,0,0,1,1
1683674956487,PHYS 1A,A00,187028,Staff,26,0,60,34
1683674957513,PHYS 1AL,001,187036,Staff,3,0,30,27
1683674957513,PHYS 1AL,002,187049,Staff,18,0,30,12
1683674958537,PHYS 1B,A00,187058,Staff,22,0,60,38
1683674959561,PHYS 1BL,001,187064,Staff,0,1,30,30
1683674959561,PHYS 1BL,002,187070,Staff,4,0,30,26
1683674960585,PHYS 1C,A00,187082,Staff,29,0,120,91
1683674961609,PHYS 1CL,001,187088,Staff,0,9,30,30
1683674961609,PHYS 1CL,002,187089,Staff,0,1,30,30
1683674961609,PHYS 1CL,009,262693,Staff,9,0,30,21
1683674962633,PHYS 2B,A01,187097,Staff,55,0,115,60
1683674963661,PHYS 2C,A01,187099,Staff,63,0,115,52
1683674964686,PHYS 2CL,A01,187101,Staff,5,0,28,23
1683674964686,PHYS 2CL,A02,187102,Staff,15,0,28,13
1683674965709,PHYS 2D,A01,187123,Shotwell; Brian,95,0,115,20
1683674966736,PHYS 4B,A01,187133,Grinstein; Benjamin,35,0,50,15
1683674967763,POLI 10,A00,188819,Staff,0,4,50,50
1683674968788,POLI 11,A00,188827,Staff,43,0,50,7
1683674969812,POLI 13R,A00,188828,Staff,0,1,20,20
1683674970837,POLI 27,A01,188830,Elgin; Samuel Zincke,0,2,70,70
1683674971864,POLI 30,A00,188832,Desposato; Scott,30,0,50,20
1683674972891,POLI 102F,A00,188834,Staff,0,0,40,40
1683674973917,POLI 104A,A00,188852,Staff,12,0,30,18
1683674974942,POLI 104I,A00,188853,Staff,0,8,20,20
1683674975965,POLI 110B,A00,188854,Wiens; David,6,0,20,14
1683674976992,POLI 112A,A00,188855,Wiens; David,3,0,30,27
1683674978015,POLI 117R,A00,188856,Forman; Fonna,0,12,20,20
1683674979043,POLI 118,A00,188857,Ingham; Sean,8,0,20,12
1683674980067,POLI 120G,A00,188858,Staff,8,0,30,22
1683674981090,POLI 131CR,A00,188863,Hoston; Germaine,20,0,50,30
1683674982114,POLI 133,A00,188864,Nellis; Gareth Hb,44,0,50,6
1683674983137,POLI 134D,A00,188865,Desposato; Scott,27,0,30,3
1683674984163,POLI 142A,A00,188871,Gartzke; Erik,21,0,50,29
1683674985186,POLI 142K,A00,188874,Staff,38,0,50,12
1683674986211,POLI 143,A00,188940,Gartzke; Erik,16,0,30,14
1683674987237,POLI 153,A00,188943,Staff,2,0,20,18
1683674988261,POLI 160AA,A00,188944,Staff,11,0,40,29
1683674989285,POLI 170A,A00,188945,Staff,10,0,30,20
1683674991331,PSYC 1,A00,188952,Staff,37,0,90,53
1683674992354,PSYC 2,B00,188953,Staff,19,0,35,16
1683674993381,PSYC 6,A00,188970,Staff,47,0,60,13
1683674994404,PSYC 7,A00,188973,Staff,35,0,45,10
1683674995427,PSYC 60,A01,188980,Rickard; Timothy C.,42,0,60,18
1683674996451,PSYC 70,A01,189001,Steiner; Eric Tomas,21,0,45,24
1683674997478,PSYC 100,A00,189005,Lacefield; Katharine I,0,100,120,120
1683674998501,PSYC 102,A00,189008,Staff,8,0,30,22
1683674999524,PSYC 106,B00,189026,Gorman; Michael R.,27,0,60,33
1683675000550,PSYC 114,B01,189033,Winkielman; Piotr,0,31,30,30
1683675001574,PSYC 131,A00,189036,Anagnostaras; Stephan,0,43,60,60
1683675002600,PSYC 136,A00,189041,Lowe; Angela Beth,0,7,25,25
1683675003626,PSYC 137,A00,189057,Winkielman; Piotr,1,37,25,24
1683675004650,PSYC 144,A00,189107,Wixted; John T,0,11,50,50
1683675006699,PSYC 162,A00,189142,Staff,0,9,85,85
1683675007722,PSYC 172,A00,189144,Gorman; Michael R.,0,6,30,30
1683675009769,PSYC 179,A00,189146,Lacefield; Katharine I,0,87,120,120
1683675010794,PSYC 181,A00,189147,Anagnostaras; Stephan,0,44,90,90
1683675011821,PSYC 190R,A00,189148,Barner; David A.,0,23,80,80
1683675012849,PSYC 191,A00,189275,Rickard; Timothy C.,0,10,25,25
1683675013872,PSYC 193,A00,189276,Chapman; Eddie Nathaniel,0,1,0,4
1683675014901,PSYC 193L,A01,189281,Lowe; Angela Beth,8,0,20,12
1683675014901,PSYC 193L,B01,189285,Staff,28,0,35,7
1683675015927,RELI 149,A00,187137,Rahimi; Babak,7,0,40,33
1683675016951,SE 9,A01,187315,Staff,0,2,18,18
1683675017975,SE 101B,A00,187409,Staff,24,0,30,6
1683675019003,SE 110B,A00,187444,Staff,10,0,40,30
1683675020028,SE 130B,A00,187449,Staff,31,0,40,9
1683675021055,SE 150A,A00,187516,Staff,8,0,20,12
1683675022080,SE 154,A00,187528,Staff,29,0,50,21
1683675023109,SIO 3,A01,258171,Staff,35,0,40,5
1683675024136,SIO 10,A00,187144,Cook; Geoffrey W,0,7,75,75
1683675025159,SIO 45,A00,187152,Cook; Geoffrey W,0,7,100,100
1683675026186,SIO 109R,A00,194486,Staff,0,4,20,20
1683675028233,SIO 187,A01,187233,Kacev; David,12,0,40,28
1683675029259,SOCI 1,A01,258656,Thorpe; Charles Robert,28,0,30,2
1683675029259,SOCI 1,A02,258658,Thorpe; Charles Robert,30,0,30,0
1683675029259,SOCI 1,A03,258661,Thorpe; Charles Robert,25,0,25,0
1683675029259,SOCI 1,A04,258666,Thorpe; Charles Robert,22,0,25,3
1683675029259,SOCI 1,A05,258897,Thorpe; Charles Robert,22,0,25,3
1683675029259,SOCI 1,A06,258898,Thorpe; Charles Robert,25,0,25,0
1683675030340,SOCI 30,A01,258903,Pardo Guerra; Juan Pablo,14,0,30,16
1683675031364,SOCI 102,A00,258904,Staff,9,0,25,16
1683675032396,SOCI 106,A00,258905,Staff,19,0,25,6
1683675033419,SOCI 111,A00,258907,Ribas Norris; Janet Vanesa,26,0,30,4
1683675034446,SOCI 121R,A00,258908,Pardo Guerra; Juan Pablo,8,0,30,22
1683675035470,SOCI 126,A01,203330,Staff,14,0,20,6
1683675036498,SOCI 131,A00,258909,Thorpe; Charles Robert,30,0,60,30
1683675037525,SOCI 135,A00,258910,Payne; Christine Anna,0,12,30,30
1683675038549,SOCI 157,A00,258911,Staff,11,0,30,19
1683675039576,SOCI 184,A00,258912,Staff,25,0,30,5
1683675040603,SOCI 188D,A00,258913,Staff,22,0,30,8
1683675041627,SYN 2,001,187529,Staff,9,0,16,7
1683675041627,SYN 2,002,201452,Staff,1,20,16,15
1683675041627,SYN 2,003,201469,Staff,1,0,16,15
1683675042651,SYN 100,A01,187531,Staff,0,9,20,20
1683675042651,SYN 100,B01,201491,Staff,0,10,20,20
1683675043675,TDAC 1,A00,189286,Walsh; Kim C.,3,0,20,17
1683675043675,TDAC 1,B00,189287,Harting; Carla Kelso,10,0,20,10
1683675044698,TDAC 101,A00,189300,Walsh; Kim C.,16,0,20,4
1683675044698,TDAC 101,B00,189301,Harting; Carla Kelso,18,0,20,2
1683675045726,TDAC 102,A00,189304,Basso; Beatrice,14,0,20,6
1683675046750,TDAC 108,A00,189305,Staff,18,0,20,2
1683675047778,TDDE 131,A00,189310,Staff,19,0,20,1
1683675047778,TDDE 131,B00,189314,Staff,19,0,20,1
1683675047778,TDDE 131,C00,189315,Staff,48,0,50,2
1683675047778,TDDE 131,D00,189316,Staff,14,0,15,1
1683675047778,TDDE 131,E00,204841,Staff,20,0,20,0
1683675048806,TDGE 10,A00,189289,Staff,27,0,50,23
1683675048806,TDGE 10,B00,189290,Havis; Allan,0,1,50,50
1683675049834,TDGE 11,A00,189291,Fulton; Julia,0,4,50,50
1683675049834,TDGE 11,B00,189292,Staff,20,0,25,5
1683675049834,TDGE 11,C00,260270,Staff,0,0,0,0
1683675050860,TDGE 25,A00,189294,Staff,1,0,20,19
1683675051884,TDGE 124,A00,189318,Fulton; Julia,0,8,50,50
1683675052909,TDGE 125,A00,189319,Staff,13,0,25,12
1683675052909,TDGE 125,B00,189320,Staff,23,0,25,2
1683675053936,TDGE 127,A00,189322,Havis; Allan,0,0,50,50
1683675054961,TDHT 101,A00,189323,Staff,18,0,25,7
1683675054961,TDHT 101,B00,189324,Staff,25,0,25,0
1683675055985,TDHT 102,A00,189325,Staff,49,0,50,1
1683675057014,TDMV 1,A00,189295,Arcidiacono; Kristin,20,0,30,10
1683675057014,TDMV 1,B00,189296,Caligagan; Maria T.,24,0,30,6
1683675058038,TDMV 2,A00,189297,Sammartano; Tonnie,27,0,30,3
1683675058038,TDMV 2,B00,189299,Arcidiacono; Kristin,23,0,30,7
1683675059066,TDMV 3,A00,204998,Rincon; Alicia,22,0,30,8
1683675060094,TDMV 120,A00,189458,Sammartano; Tonnie,28,0,30,2
1683675061118,TDMV 138,A00,189541,Jun; Grace Shin Hae,20,0,40,20
1683675062148,TDMV 142,A00,189717,Caligagan; Tony,25,0,30,5
1683675062148,TDMV 142,B00,189718,Caligagan; Maria T.,25,0,30,5
1683675063173,TMC 2,A01,187533,Staff,25,0,25,0
1683675063173,TMC 2,A02,187534,Staff,25,0,25,0
1683675064197,USP 1,A01,187536,Kwak; Nancy,0,17,25,25
1683675065220,USP 5,A01,187538,Staff,8,0,25,17
1683675066245,USP 101,A00,199253,Staff,0,4,0,0
1683675067272,USP 124,A00,187562,Boomhower; Matthew Charles,0,0,30,30
1683675068297,USP 138,A00,187582,Staff,19,0,25,6
1683675069320,USP 152,A01,187597,Staff,3,0,25,22
1683675070345,USP 153,A00,187598,Staff,19,0,25,6
1683675071378,USP 168,A00,187607,Kwak; Nancy,2,0,5,3
1683675072405,USP 173,A00,187619,Staff,4,0,25,21
1683675073429,USP 181,A00,187638,Staff,0,4,25,25
1683675074454,VIS 103,A00,187650,Cruz; Edwin Teddy,17,0,75,58
1683675075478,VIS 110D,A00,187669,Staff,13,0,22,9
1683675076503,VIS 127C,A00,187720,Shen; Kuiyi,67,0,146,79
1683675077527,VIS 149,A00,187731,Yoldas; Pinar,1,14,22,21
1683675078552,VIS 151,A01,188091,Staff,22,0,34,12
1683675078552,VIS 151,A02,188092,Staff,11,0,34,23
1683675079576,VIS 160B,A00,188093,Stalbaum; Brett,0,1,10,10
1683675081630,WCWP 10B,A00,201720,Staff,0,0,5,5
1683675081630,WCWP 10B,B00,201722,Staff,0,0,6,6
1683675082659,WCWP 100,A00,201725,Gagnon; Jeffrey C,0,0,2,2
1683675082659,WCWP 100,B00,201727,Staff,0,4,15,15
1683675085753,ANBI 133,A00,258401,Wilder; Linnea Lorene,34,0,40,6
1683675086781,ANBI 140,A00,258395,Hrvoj Mihic; Branka,18,0,25,7
1683675087805,ANSC 120,A00,258402,Bialecki; Jon Anthony,26,0,40,14
1683675088831,ANSC 144,A00,258400,Staff,12,0,40,28
1683675090882,ANSC 166,A00,258396,Parish; Steven Martin,156,0,175,19
1683675091907,ANSC 180,A00,193533,Staff,8,0,20,12
1683675092932,ANSC 188,A00,258397,Jassal; Aftab,34,0,40,6
1683675093957,ANTH 3,A01,258316,Staff,23,0,30,7
1683675094982,ANTH 5,A00,258394,Semendeferi; Ekaterini,16,0,20,4
1683675096010,ANTH 21,A01,258331,Staff,4,0,40,36
1683675097035,ANTH 103,A00,258398,Varma; Saiba,15,0,25,10
1683675098069,AWP 10,001,202034,Staff,0,0,0,0
1683675098069,AWP 10,002,202035,Staff,0,0,0,0
1683675098069,AWP 10,003,202036,Staff,0,0,0,0
1683675098069,AWP 10,004,202037,Staff,0,0,0,0
1683675098069,AWP 10,005,202038,Staff,0,0,0,0
1683675098069,AWP 10,006,202039,Staff,0,0,0,0
1683675098069,AWP 10,007,202040,Staff,0,0,0,0
1683675098069,AWP 10,008,202041,Staff,0,0,0,0
1683675098069,AWP 10,009,202042,Staff,0,0,0,0
1683675098069,AWP 10,010,202043,Staff,0,0,0,0
1683675098069,AWP 10,011,202044,Staff,0,0,0,0
1683675098069,AWP 10,012,202045,Staff,0,0,0,0
1683675098069,AWP 10,013,202046,Staff,0,0,0,0
1683675098069,AWP 10,014,202047,Staff,0,0,0,0
1683675098069,AWP 10,015,202048,Staff,0,0,0,0
1683675098069,AWP 10,016,202049,Staff,0,0,0,0
1683675098069,AWP 10,017,202050,Staff,0,0,0,0
1683675098069,AWP 10,018,202051,Staff,0,0,0,0
1683675098069,AWP 10,019,202052,Staff,0,0,0,0
1683675098069,AWP 10,020,202053,Staff,0,0,0,0
1683675098069,AWP 10,021,202054,Staff,0,0,0,0
1683675098069,AWP 10,022,202055,Staff,0,0,0,0
1683675098069,AWP 10,023,202056,Staff,0,0,0,0
1683675098069,AWP 10,024,202057,Staff,0,0,0,0
1683675098069,AWP 10,025,202058,Staff,0,0,0,0
1683675098069,AWP 10,026,202059,Staff,0,0,0,0
1683675099093,AWP 102,001,202032,Staff,0,0,0,0
1683675099093,AWP 102,002,202033,Staff,0,0,0,0
1683675100117,BENG 100,A01,254234,Taylor Amos; Alyssa C,31,0,40,9
1683675101144,BENG 196,001,270013,Engler; Adam J.,9999,0,9999,0
1683675102169,BICD 100R,A01,202018,Smith; Laurie,0,7,32,32
1683675102169,BICD 100R,A02,202019,Smith; Laurie,0,3,32,32
1683675102169,BICD 100R,A03,202020,Smith; Laurie,0,1,32,32
1683675102169,BICD 100R,A04,202021,Smith; Laurie,6,0,32,26
1683675102169,BICD 100R,A05,202022,Smith; Laurie,11,0,32,21
1683675103198,BICD 136,A01,193242,Gustafson-Brown; Cindy,0,2,32,32
1683675103198,BICD 136,A02,193244,Gustafson-Brown; Cindy,13,0,32,19
1683675104228,BIEB 102,A01,193249,Butler; Shannon Rhey,1,1,32,31
1683675104228,BIEB 102,A02,193251,Butler; Shannon Rhey,0,0,32,32
1683675104228,BIEB 102,A03,193253,Butler; Shannon Rhey,0,0,32,32
1683675104228,BIEB 102,A04,193255,Butler; Shannon Rhey,13,0,32,19
1683675104228,BIEB 102,A05,193265,Butler; Shannon Rhey,25,0,32,7
1683675104228,BIEB 102,A06,193269,Butler; Shannon Rhey,13,0,32,19
1683675106279,BIEB 150,A01,193274,Staff,0,0,32,32
1683675106279,BIEB 150,A02,193285,Staff,24,0,32,8
1683675107306,BIEB 194,A00,193286,Kurle; Carolyn M.,19,0,32,13
1683675108331,BILD 1,A01,192291,Staff,15,0,32,17
1683675108331,BILD 1,A02,192292,Staff,30,0,32,2
1683675108331,BILD 1,B01,192520,Reuther; Keefe,0,1,0,0
1683675108331,BILD 1,B02,192532,Reuther; Keefe,0,1,0,0
1683675109357,BILD 3,A01,192556,Butler; Shannon Rhey,0,0,32,32
1683675109357,BILD 3,A02,192581,Butler; Shannon Rhey,0,1,32,32
1683675109357,BILD 3,A03,192611,Butler; Shannon Rhey,19,0,32,13
1683675109357,BILD 3,A04,192612,Butler; Shannon Rhey,24,0,32,8
1683675109357,BILD 3,A05,192613,Butler; Shannon Rhey,26,0,32,6
1683675109357,BILD 3,A06,192679,Butler; Shannon Rhey,27,0,32,5
1683675109357,BILD 3,A07,192682,Butler; Shannon Rhey,20,0,32,12
1683675110382,BILD 4,A01,192836,Reuther; Keefe,1,0,24,23
1683675110382,BILD 4,A02,193044,Reuther; Keefe,4,0,24,20
1683675111406,BILD 10,A01,193142,Gustafson-Brown; Cindy,29,0,32,3
1683675111406,BILD 10,A02,193149,Gustafson-Brown; Cindy,31,0,32,1
1683675112433,BIMM 100,A01,193301,Staff,0,6,32,32
1683675112433,BIMM 100,A02,193312,Staff,0,7,32,32
1683675112433,BIMM 100,A03,193323,Staff,0,10,32,32
1683675113461,BIMM 101,A01,193329,McDonnell; Lisa Marie,1,4,24,23
1683675113461,BIMM 101,A02,193339,McDonnell; Lisa Marie,1,4,24,23
1683675113461,BIMM 101,B01,193354,McDonnell; Lisa Marie,0,4,24,24
1683675113461,BIMM 101,B02,193357,McDonnell; Lisa Marie,0,3,24,24
1683675114490,BIMM 110,A01,193377,Tat; John,0,11,32,32
1683675114490,BIMM 110,A02,193378,Tat; John,0,10,32,32
1683675115521,BIMM 120,A01,206116,Staff,0,0,32,32
1683675115521,BIMM 120,A02,206117,Staff,7,0,32,25
1683675115521,BIMM 120,A03,206121,Staff,21,0,32,11
1683675116546,BIPN 100,A01,193393,Park; Ji Young,0,15,32,32
1683675116546,BIPN 100,A02,193402,Park; Ji Young,0,14,32,32
1683675116546,BIPN 100,A03,193413,Park; Ji Young,0,14,32,32
1683675116546,BIPN 100,A04,193414,Park; Ji Young,0,13,32,32
1683675117575,BIPN 102,A01,193429,Staff,0,0,32,32
1683675117575,BIPN 102,A02,193438,Staff,18,0,32,14
1683675118599,BIPN 106,A01,193450,Reyes Gonzalez; Catalina,0,2,40,40
1683675119625,BIPN 134,A01,193465,Cooke; James Edward,0,0,32,32
1683675119625,BIPN 134,A02,193474,Cooke; James Edward,25,0,32,7
1683675119625,BIPN 134,A03,193485,Cooke; James Edward,29,0,32,3
1683675119625,BIPN 134,A04,193486,Cooke; James Edward,20,0,32,12
1683675119625,BIPN 134,A05,193491,Cooke; James Edward,31,0,32,1
1683675119625,BIPN 134,A06,193501,Cooke; James Edward,30,0,32,2
1683675119625,BIPN 134,A07,193510,Cooke; James Edward,29,0,32,3
1683675121675,BISP 194,A00,222522,Staff,14,0,32,18
1683675122715,CAT 124,A01,202407,Staff,19,0,25,6
1683675123740,CAT 125,A00,202408,Marchisotto; Jennifer Anne,2,0,20,18
1683675124767,CAT 125R,A00,202409,Smith; Lauryn Alissa,0,11,20,20
1683675124767,CAT 125R,B00,202410,Morales; Celeste Georgianna,0,11,20,20
1683675124767,CAT 125R,C00,202411,Irwin; Matthew Joseph,0,12,20,20
1683675125795,CENG 15,A01,204712,Yang; Kesong,0,1,0,0
1683675126820,CENG 114,A00,202070,Jahed Motlagh; Zeinab,5,0,20,15
1683675127848,CGS 105,A00,185477,Wesling; Megan E.,24,0,40,16
1683675128874,CGS 106,A00,185494,Staff,11,0,22,11
1683675129901,CGS 108,A00,185495,Staff,14,0,20,6
1683675130928,CGS 114,A00,185496,Staff,13,0,18,5
1683675131953,CGS 119,A00,185501,Staff,15,0,20,5
1683675132980,CGS 120,A00,185511,Staff,12,0,20,8
1683675134062,CHEM 4,A01,184675,Bussey; Thomas J,97,0,100,3
1683675135087,CHEM 6A,A01,184677,Staff,32,0,60,28
1683675136111,CHEM 6B,A01,184679,Staff,63,0,100,37
1683675137134,CHEM 6C,A01,184681,Bussey; Thomas J,0,0,50,50
1683675137134,CHEM 6C,A02,184682,Bussey; Thomas J,32,0,50,18
1683675138165,CHEM 40A,A01,184684,Albizati; Kim F.,33,0,100,67
1683675139189,CHEM 40B,A01,184686,Albizati; Kim F.,0,22,100,100
1683675140218,CHEM 41B,A01,184690,Staff,51,0,100,49
1683675141242,COGS 3,A01,184715,Boyle; Mary E. T.,0,27,40,40
1683675142269,COGS 14B,A01,185172,Staff,0,14,38,38
1683675143296,COGS 18,A01,184736,Staff,14,0,80,66
1683675144323,COGS 100,A01,184932,Staff,0,8,73,73
1683675145351,COGS 101A,A01,184935,Staff,0,40,30,30
1683675146376,COGS 101B,A01,184944,Staff,0,2,30,30
1683675147401,COGS 101C,A01,184946,Staff,0,10,30,30
1683675148429,COGS 102A,A01,184951,Johnson; Christine M.,2,0,40,38
1683675149459,COGS 107B,A01,184953,Mooshagian; Eric Frederick,0,52,40,40
1683675150484,COGS 118B,A01,184959,Gupta; Anjum,0,50,40,40
1683675151509,COGS 153,A00,184961,Staff,0,16,30,30
1683675152534,COGS 177,A00,184962,Staff,0,21,30,30
1683675153559,COGS 187A,A01,184969,Boyle; Mary E. T.,0,19,40,40
1683675154589,COMM 10,A01,185174,Staff,0,5,25,25
1683675154589,COMM 10,A02,185189,Staff,0,2,25,25
1683675154589,COMM 10,A03,269821,Staff,0,1,0,0
1683675155617,COMM 100B,A01,185475,Staff,0,1,0,1
1683675155617,COMM 100B,A02,185476,Staff,11,0,25,14
1683675156644,COMM 100C,A01,185314,Staff,1,0,25,24
1683675156644,COMM 100C,A02,185327,Staff,17,0,25,8
1683675157668,COMM 110M,A00,185349,Staff,0,0,40,40
1683675158692,COMM 113T,A00,185352,Staff,25,0,40,15
1683675159719,COMM 114I,A00,185353,Staff,31,0,40,9
1683675160742,COMM 131,A00,185354,Staff,17,0,30,13
1683675161766,CSE 8A,A50,185358,Cao; Yingjun,0,46,10,10
1683675162790,CSE 8B,A01,185362,Staff,0,48,50,50
1683675163818,CSE 11,A01,185416,Cao; Yingjun,0,91,10,10
1683675164843,CSE 20,A01,185445,Briones; Jor-el Thomas Caparas,4,0,25,21
1683675165867,CSE 21,A01,185447,Staff,9,0,50,41
1683675166892,CSE 101,A01,185451,Staff,0,13,50,50
1683675166892,CSE 101,B01,185453,Jones; Miles E,0,14,50,50
1683675168944,CSE 141,A01,185458,Eldon; John,16,0,100,84
1683675169970,CSE 141L,A01,185461,Eldon; John,8,0,100,92
1683675170995,CSE 142,A01,185463,Staff,34,0,60,26
1683675170995,CSE 142,B01,201355,Staff,0,7,60,60
1683675172022,CSE 142L,A01,185470,Staff,34,0,60,26
1683675172022,CSE 142L,B01,201417,Staff,0,6,60,60
1683675173049,CSE 190,A00,201433,Staff,32,0,49,17
1683675174074,DOC 1,A01,259136,Strom; Megan C.,7,0,15,8
1683675174074,DOC 1,A02,259137,Strom; Megan C.,14,0,15,1
1683675174074,DOC 1,A03,259138,Strom; Megan C.,14,0,15,1
1683675174074,DOC 1,A04,259139,Strom; Megan C.,14,0,15,1
1683675175103,DOC 100D,A00,259140,Pass; Natalye Joann,14,0,25,11
1683675176126,DSGN 1,A01,184749,Rill; Bryan,0,26,30,30
1683675177150,DSGN 100,A01,185168,Staff,0,2,25,25
1683675178174,ECE 5,A01,185626,Morris; Karcher William,0,12,0,0
1683675179233,ECE 101,A01,185628,Staff,14,0,70,56
1683675180262,ECE 107,A01,185635,Baghdadchi; Saharnaz,0,0,20,20
1683675180262,ECE 107,A02,185638,Baghdadchi; Saharnaz,1,0,20,19
1683675181287,ECE 148,A01,185647,Silberman; Jack,0,0,16,16
1683675182313,ECON 1,A01,185537,Crane; Meredith Helen,54,0,70,16
1683675183339,ECON 3,A01,185549,Crane; Meredith Helen,29,0,70,41
1683675184367,ECON 4,A01,203354,Anderson; John Charles,0,5,10,10
1683675185392,ECON 100A,A01,185574,Staff,0,5,40,40
1683675186420,ECON 100B,A01,185576,Staff,0,12,50,50
1683675187447,ECON 100C,A01,185589,Newhouse; Herbert S,30,0,70,40
1683675188475,ECON 105,A00,185608,Vespa; Emanuel Ignacio,19,0,35,16
1683675189500,ECON 109,A01,185610,Shishkin; Denis,9,0,35,26
1683675190525,ECON 110A,A01,185612,Staff,9,0,40,31
1683675191547,ECON 120A,A01,185615,Staff,19,0,40,21
1683675192575,ECON 120C,A01,185617,Sun; Yixiao,0,21,70,70
1683675193606,ECON 144,A00,203346,Squires; Dale E,2,0,35,33
1683675194632,ECON 171,A01,203349,Newhouse; Herbert S,0,1,35,35
1683675195659,ECON 173A,A01,185621,Toda; Alexis Akira,21,0,35,14
1683675196690,EDS 25,A01,202413,Staff,0,1,0,0
1683675196690,EDS 25,A02,202414,Staff,0,1,0,0
1683675196690,EDS 25,A03,202415,Staff,0,0,0,0
1683675196690,EDS 25,A04,202416,Staff,0,1,0,0
1683675196690,EDS 25,A05,202439,Staff,0,0,0,0
1683675196690,EDS 25,A06,202440,Staff,0,0,0,0
1683675196690,EDS 25,B01,202631,Staff,0,0,0,0
1683675196690,EDS 25,B02,202632,Staff,0,0,0,0
1683675196690,EDS 25,B03,202639,Staff,0,0,0,0
1683675196690,EDS 25,B04,202640,Staff,0,0,0,0
1683675196690,EDS 25,B05,202643,Staff,0,0,0,0
1683675196690,EDS 25,B06,202644,Staff,0,0,0,0
1683675197717,EDS 38,A01,202659,Black; Alison Michelle,24,0,25,1
1683675198746,EDS 115,A00,202652,Staff,18,0,30,12
1683675199773,EDS 125,A00,202649,Staff,13,0,30,17
1683675200800,EDS 126,A01,203332,Staff,30,0,30,0
1683675201825,EDS 139,A00,202838,Staff,16,0,25,9
1683675202849,EDS 146,A01,202655,Staff,14,0,25,11
1683675203874,ENG 15,A00,185667,Staff,0,1,0,0
1683675203874,ENG 15,B00,185672,Staff,0,0,0,0
1683675203874,ENG 15,C00,185675,Staff,0,0,0,0
1683675203874,ENG 15,D00,185682,Staff,0,0,0,0
1683675203874,ENG 15,E00,185684,Staff,0,0,0,0
1683675204908,ETHN 103,A00,185710,Staff,0,8,35,35
1683675205932,ETHN 103A,A00,199228,Man; Simeon S,0,0,9,9
1683675206956,ETHN 109,A00,185711,Staff,15,0,35,20
1683675207984,ETHN 142,A00,185726,Staff,0,4,30,30
1683675209011,ETHN 163J,A00,199229,Man; Simeon S,5,0,8,3
1683675210037,ETHN 168,A00,185727,Staff,7,0,10,3
1683675211062,ETHN 182,A00,185728,Staff,0,0,35,35
1683675212090,ETHN 183,A00,185737,Staff,9,0,18,9
1683675213115,GLBH 111,A01,209361,Burgos; Jose L.,0,0,0,0
1683675215165,HIEU 104,A00,185792,Staff,14,0,20,6
1683675216190,HIEU 115,A00,185800,Staff,0,0,20,20
1683675217215,HIEU 128,A00,185801,Staff,0,9,20,20
1683675218242,HIEU 147,A00,185802,Staff,15,0,20,5
1683675219268,HIEU 154,A00,185823,Staff,11,0,20,9
1683675220294,HILA 102,A00,185826,Staff,14,0,20,6
1683675221321,HILD 2C,A01,185778,Staff,0,13,20,20
1683675222345,HILD 7B,A01,185780,Kwak; Nancy,0,17,32,32
1683675222345,HILD 7B,A02,185781,Kwak; Nancy,0,18,32,32
1683675223368,HILD 30,A01,185791,Staff,12,0,20,8
1683675224392,HISC 119,A00,185830,Golan; Tal,0,9,20,20
1683675225418,HITO 156GS,A00,185831,Patterson; Patrick H.,0,0,0,23
1683675226445,HIUS 103,A00,185832,Man; Simeon S,0,4,20,20
1683675227473,HIUS 117,A00,185836,Kwak; Nancy,2,0,20,18
1683675228499,HIUS 125,A00,185840,Man; Simeon S,0,2,23,23
1683675229526,HIUS 149,A00,185845,Staff,1,0,20,19
1683675230556,HUM 3,A01,185882,Zavodny; Tatiana Sophia,0,8,50,50
1683675230556,HUM 3,B01,185899,Caldwell; Michael Alan,0,18,50,50
1683675231579,HUM 3GS,A00,185900,Patterson; Patrick H.,0,0,0,23
1683675232609,HUM 4,A01,185938,Zroka; Amy Liane,28,0,50,22
1683675232609,HUM 4,B01,185956,Watkins; Eric,0,5,50,50
1683675232609,HUM 4,B02,202209,Watkins; Eric,0,5,50,50
1683675232609,HUM 4,B03,202210,Watkins; Eric,0,5,50,50
1683675233636,HUM 5,A01,185958,West; Geoffrey Scott,0,0,50,50
1683675233636,HUM 5,A02,202215,West; Geoffrey Scott,0,0,50,50
1683675234662,INTL 190,A00,185959,Gagnon; Jeffrey C,0,0,0,9
1683675234662,INTL 190,B00,185960,Lettieri; Michael Joseph,0,0,0,2
1683675235686,JAPN 180,A00,254509,Staff,5,0,30,25
1683675236713,LATI 10,A01,202853,Kennemore; Amy Michelle,4,0,35,31
1683675236713,LATI 10,A02,202854,Kennemore; Amy Michelle,2,0,35,33
1683675236713,LATI 10,A03,270054,Kennemore; Amy Michelle,30,0,30,0
1683675237795,LATI 180,A00,202855,Kennemore; Amy Michelle,11,0,20,9
1683675238819,LAWS 101,A00,201767,Golan; Tal,0,7,40,40
1683675239845,LIFR 1C,A00,185961,Staff,6,0,20,14
1683675240871,LIFR 1CX,A00,185962,Staff,7,0,20,13
1683675241894,LIFR 1D,A00,185963,Staff,7,0,20,13
1683675242923,LIFR 1DX,A00,185964,Staff,7,0,20,13
1683675243950,LIGN 101,A01,186039,Staff,43,0,50,7
1683675244974,LIGN 165,A00,186040,Staff,15,0,50,35
1683675245999,LTCS 108,A00,186041,Staff,5,0,10,5
1683675247022,LTCS 119,A00,186042,Staff,15,0,20,5
1683675248047,LTCS 130,A00,186043,Wesling; Megan E.,15,0,25,10
1683675250095,LTEA 138,A00,186119,Staff,14,0,40,26
1683675251119,LTEN 124,A00,186148,Staff,5,0,25,20
1683675252143,LTEN 178,A00,186149,Staff,7,0,15,8
1683675253171,LTEN 181,A00,186150,Blanco; John D,34,0,40,6
1683675254194,LTWL 120,A00,186160,Staff,19,0,25,6
1683675255221,LTWL 165,A00,186161,Staff,22,0,25,3
1683675256244,LTWR 100,A00,186162,Staff,0,5,15,15
1683675257268,LTWR 102,A00,186163,Doller; Ben,5,0,15,10
1683675258294,MAE 8,A01,186412,Staff,0,1,0,0
1683675259318,MAE 30B,A00,186445,Bahadori; Mohammad Yousef,82,0,100,18
1683675260344,MAE 40,A00,186592,Bewley; Thomas R,10,0,50,40
1683675261368,MAE 101B,A00,186593,Bahadori; Mohammad Yousef,80,0,100,20
1683675262394,MAE 105,A00,186594,Bandaru; Prabhakar,10,0,50,40
1683675263418,MAE 107,A00,186599,Pham; Hieu Tan,0,7,120,120
1683675264446,MAE 148,A01,186660,Silberman; Jack,3,0,16,13
1683675265469,MATH 10A,A01,188095,Staff,0,6,35,35
1683675266498,MATH 10B,A01,188097,Bowers; Adam R.,0,12,30,30
1683675266498,MATH 10B,A02,188099,Bowers; Adam R.,0,11,30,30
1683675266498,MATH 10B,B01,188104,Bowers; Adam R.,0,10,30,30
1683675266498,MATH 10B,B02,188106,Bowers; Adam R.,1,9,30,29
1683675267527,MATH 10C,A01,188111,Staff,0,20,30,30
1683675267527,MATH 10C,A02,188127,Staff,0,19,30,30
1683675267527,MATH 10C,A03,188131,Staff,0,19,30,30
1683675267527,MATH 10C,B01,188218,Staff,17,0,30,13
1683675267527,MATH 10C,B02,188244,Staff,13,0,30,17
1683675267527,MATH 10C,B03,188277,Staff,14,0,30,16
1683675268556,MATH 18,A01,188344,Bach; Quang Tran,18,0,30,12
1683675268556,MATH 18,A02,188345,Bach; Quang Tran,11,0,30,19
1683675268556,MATH 18,B01,188353,Bach; Quang Tran,11,0,30,19
1683675268556,MATH 18,B02,188354,Bach; Quang Tran,19,0,30,11
1683675269582,MATH 20A,A01,188374,Staff,11,0,35,24
1683675270607,MATH 20B,A01,188382,Ohm; Ko Woon,7,0,30,23
1683675270607,MATH 20B,A02,188383,Ohm; Ko Woon,22,0,30,8
1683675270607,MATH 20B,B01,188385,Ohm; Ko Woon,7,0,30,23
1683675270607,MATH 20B,B02,188392,Ohm; Ko Woon,22,0,30,8
1683675271636,MATH 20C,A01,188394,Harel; Guershon,10,0,30,20
1683675271636,MATH 20C,A02,188395,Harel; Guershon,13,0,30,17
1683675271636,MATH 20C,B01,188404,Harel; Guershon,5,0,30,25
1683675271636,MATH 20C,B02,188405,Harel; Guershon,18,0,30,12
1683675272661,MATH 20D,A01,188414,Hammock; Frances H,0,1,30,30
1683675272661,MATH 20D,A02,188415,Hammock; Frances H,0,1,30,30
1683675272661,MATH 20D,B01,188447,Hammock; Frances H,0,1,30,30
1683675272661,MATH 20D,B02,188486,Hammock; Frances H,3,0,30,27
1683675273686,MATH 20E,A01,188649,Staff,21,0,30,9
1683675273686,MATH 20E,A02,188650,Staff,20,0,30,10
1683675273686,MATH 20E,A03,188673,Staff,0,0,30,30
1683675274713,MATH 102,A01,188675,Staff,0,39,35,35
1683675275738,MATH 103B,A01,188681,Staff,3,0,35,32
1683675275738,MATH 103B,B01,188692,Staff,5,0,35,30
1683675276762,MATH 109,A01,188695,Salehi Golsefidy; Alireza,24,0,35,11
1683675276762,MATH 109,A02,188696,Salehi Golsefidy; Alireza,25,0,35,10
1683675277786,MATH 120A,A01,188698,Eggers; John Dietrich,7,0,35,28
1683675278814,MATH 142B,A01,188736,Ioana; Adrian,1,1,30,29
1683675278814,MATH 142B,A02,188741,Ioana; Adrian,0,1,30,30
1683675278814,MATH 142B,A03,188743,Ioana; Adrian,0,1,30,30
1683675279842,MATH 168A,A01,188790,Staff,0,11,35,35
1683675280871,MATH 170A,A01,188803,Nie; Jiawang,0,2,35,35
1683675280871,MATH 170A,A02,188811,Nie; Jiawang,0,1,35,35
1683675280871,MATH 170A,A03,188814,Nie; Jiawang,0,0,35,35
1683675280871,MATH 170A,A04,188815,Nie; Jiawang,5,0,35,30
1683675281895,MATH 193B,A01,188817,Staff,0,0,35,35
1683675281895,MATH 193B,A02,188818,Staff,5,0,35,30
1683675282920,MGT 4,A01,202857,Anderson; John Charles,60,0,80,20
1683675283947,MGT 12,A00,202858,Lindenberger; Wade Douglas,40,0,90,50
1683675284990,MGT 18,A00,202859,Staff,74,0,90,16
1683675286017,MGT 18GS,A00,202860,McKay; Michael J,13,0,28,15
1683675287045,MGT 45,A00,202861,Pecore; Joseph P.,10,0,90,80
1683675288072,MGT 100,A00,202863,Yavorsky; Daniel Ryan,28,0,90,62
1683675289095,MGT 103,A00,202864,Ehrich; Kristine R,0,18,90,90
1683675290119,MGT 112,A00,202865,Ehrich; Kristine R,15,0,90,75
1683675291146,MGT 121A,A00,202868,Staff,90,20,90,0
1683675292171,MGT 131B,A00,202869,Anderson; John Charles,59,0,90,31
1683675293195,MGT 136,A00,202871,Lindenberger; Wade Douglas,83,0,90,7
1683675294219,MGT 164,A00,202873,Staff,0,67,90,91
1683675295242,MGT 164GS,A00,202874,McKay; Mary A,13,0,28,15
1683675296269,MGT 180,A00,202875,Staff,0,51,90,91
1683675297295,MMW 11R,A01,205019,Herbst; Matthew,0,0,30,30
1683675297295,MMW 11R,A02,205026,Herbst; Matthew,29,0,30,1
1683675298324,MMW 15,A01,193512,Chang; Edmond Yi-Teh,0,8,28,28
1683675298324,MMW 15,A02,193513,Chang; Edmond Yi-Teh,0,5,28,28
1683675298324,MMW 15,A03,193514,Chang; Edmond Yi-Teh,0,5,28,28
1683675298324,MMW 15,A04,193515,Chang; Edmond Yi-Teh,0,5,28,28
1683675298324,MMW 15,A05,193516,Chang; Edmond Yi-Teh,0,5,28,28
1683675298324,MMW 15,A06,193517,Chang; Edmond Yi-Teh,0,6,28,28
1683675298324,MMW 15,B01,193519,Chang; Edmond Yi-Teh,0,5,28,28
1683675298324,MMW 15,B02,193520,Chang; Edmond Yi-Teh,0,5,28,28
1683675298324,MMW 15,B03,193521,Chang; Edmond Yi-Teh,0,5,28,28
1683675298324,MMW 15,B04,193522,Chang; Edmond Yi-Teh,0,5,28,28
1683675298324,MMW 15,B05,193523,Chang; Edmond Yi-Teh,0,5,28,28
1683675298324,MMW 15,B06,193524,Chang; Edmond Yi-Teh,0,5,28,28
1683675299348,MMW 122,A01,193526,Rahimi; Babak,0,16,28,28
1683675299348,MMW 122,A02,193527,Rahimi; Babak,0,15,28,28
1683675299348,MMW 122,A03,193528,Rahimi; Babak,0,0,0,0
1683675299348,MMW 122,A04,193529,Rahimi; Babak,0,0,0,0
1683675300376,MUS 1A,A01,186663,Staff,1,19,35,34
1683675301399,MUS 4,A01,186715,Staff,0,12,35,35
1683675302427,MUS 5R,A01,186796,Dubnov; Shlomo,0,17,35,35
1683675303451,MUS 6,A01,186798,Staff,0,5,25,25
1683675304475,MUS 7,A01,186830,Staff,11,0,35,24
1683675305499,MUS 8,A01,186930,Staff,0,27,35,35
1683675306528,MUS 15,A01,186932,Staff,0,15,35,35
1683675306528,MUS 15,B01,186934,Staff,1,17,35,34
1683675307556,MUS 80,A00,186935,Staff,0,0,20,20
1683675307556,MUS 80,B00,186936,Staff,24,0,25,1
1683675308584,NANO 11,A00,204702,Lipomi; Darren John,0,0,0,0
1683675309609,NANO 15,A01,204709,Yang; Kesong,0,1,0,0
1683675310637,NANO 114,A00,202069,Jahed Motlagh; Zeinab,3,0,10,7
1683675311660,PHIL 1,A00,186955,Grush; Rick Scott,31,0,40,9
1683675312691,PHIL 10,A01,186973,Grush; Rick Scott,27,0,35,8
1683675312691,PHIL 10,A02,186974,Grush; Rick Scott,33,0,35,2
1683675313717,PHIL 13,A01,186976,Staff,3,0,35,32
1683675313717,PHIL 13,A02,186977,Staff,16,0,35,19
1683675314742,PHIL 14,A01,186979,Staff,31,0,35,4
1683675314742,PHIL 14,A02,186986,Staff,32,0,35,3
1683675315768,PHIL 28,A01,186988,Staff,16,0,30,14
1683675315768,PHIL 28,A02,186989,Staff,1,0,30,29
1683675315768,PHIL 28,A03,186990,Staff,10,0,30,20
1683675315768,PHIL 28,A04,186991,Staff,26,0,30,4
1683675316792,PHIL 120,A00,186997,Staff,23,0,40,17
1683675317819,PHIL 137,A00,187003,Staff,7,0,40,33
1683675318843,PHIL 150,A00,187015,Staff,47,0,70,23
1683675319867,PHIL 167,A00,187021,Lamey; Andy M.,34,0,40,6
1683675320891,PHIL 174,A01,202226,Staff,17,0,20,3
1683675320891,PHIL 174,A02,202235,Staff,20,0,20,0
1683675321917,PHIL 191A,A00,258918,Staff,0,0,1,1
1683675322945,PHYS 1A,A00,187028,Staff,26,0,60,34
1683675323973,PHYS 1AL,001,187036,Staff,3,0,30,27
1683675323973,PHYS 1AL,002,187049,Staff,18,0,30,12
1683675324998,PHYS 1B,A00,187058,Staff,22,0,60,38
1683675326023,PHYS 1BL,001,187064,Staff,0,1,30,30
1683675326023,PHYS 1BL,002,187070,Staff,4,0,30,26
1683675327050,PHYS 1C,A00,187082,Staff,29,0,120,91
1683675328076,PHYS 1CL,001,187088,Staff,0,9,30,30
1683675328076,PHYS 1CL,002,187089,Staff,0,1,30,30
1683675328076,PHYS 1CL,009,262693,Staff,9,0,30,21
1683675329103,PHYS 2B,A01,187097,Staff,55,0,115,60
1683675330129,PHYS 2C,A01,187099,Staff,63,0,115,52
1683675331155,PHYS 2CL,A01,187101,Staff,5,0,28,23
1683675331155,PHYS 2CL,A02,187102,Staff,15,0,28,13
1683675332180,PHYS 2D,A01,187123,Shotwell; Brian,95,0,115,20
1683675333209,PHYS 4B,A01,187133,Grinstein; Benjamin,35,0,50,15
1683675334233,POLI 10,A00,188819,Staff,0,4,50,50
1683675335258,POLI 11,A00,188827,Staff,43,0,50,7
1683675336282,POLI 13R,A00,188828,Staff,0,1,20,20
1683675337310,POLI 27,A01,188830,Elgin; Samuel Zincke,0,2,70,70
1683675338342,POLI 30,A00,188832,Desposato; Scott,30,0,50,20
1683675339367,POLI 102F,A00,188834,Staff,0,0,40,40
1683675340394,POLI 104A,A00,188852,Staff,12,0,30,18
1683675341475,POLI 104I,A00,188853,Staff,0,8,20,20
1683675342500,POLI 110B,A00,188854,Wiens; David,6,0,20,14
1683675343524,POLI 112A,A00,188855,Wiens; David,3,0,30,27
1683675344547,POLI 117R,A00,188856,Forman; Fonna,0,12,20,20
1683675345572,POLI 118,A00,188857,Ingham; Sean,8,0,20,12
1683675346597,POLI 120G,A00,188858,Staff,8,0,30,22
1683675347625,POLI 131CR,A00,188863,Hoston; Germaine,20,0,50,30
1683675348651,POLI 133,A00,188864,Nellis; Gareth Hb,44,0,50,6
1683675349675,POLI 134D,A00,188865,Desposato; Scott,27,0,30,3
1683675350699,POLI 142A,A00,188871,Gartzke; Erik,21,0,50,29
1683675351727,POLI 142K,A00,188874,Staff,38,0,50,12
1683675352754,POLI 143,A00,188940,Gartzke; Erik,16,0,30,14
1683675353781,POLI 153,A00,188943,Staff,2,0,20,18
1683675354806,POLI 160AA,A00,188944,Staff,11,0,40,29
1683675355833,POLI 170A,A00,188945,Staff,10,0,30,20
1683675357881,PSYC 1,A00,188952,Staff,37,0,90,53
1683675358905,PSYC 2,B00,188953,Staff,19,0,35,16
1683675359932,PSYC 6,A00,188970,Staff,47,0,60,13
1683675360956,PSYC 7,A00,188973,Staff,35,0,45,10
1683675361981,PSYC 60,A01,188980,Rickard; Timothy C.,42,0,60,18
1683675363006,PSYC 70,A01,189001,Steiner; Eric Tomas,21,0,45,24
1683675364031,PSYC 100,A00,189005,Lacefield; Katharine I,0,100,120,120
1683675365054,PSYC 102,A00,189008,Staff,8,0,30,22
1683675366078,PSYC 106,B00,189026,Gorman; Michael R.,27,0,60,33
1683675367107,PSYC 114,B01,189033,Winkielman; Piotr,0,31,30,30
1683675368135,PSYC 131,A00,189036,Anagnostaras; Stephan,0,43,60,60
1683675369162,PSYC 136,A00,189041,Lowe; Angela Beth,0,7,25,25
1683675370189,PSYC 137,A00,189057,Winkielman; Piotr,1,37,25,24
1683675371215,PSYC 144,A00,189107,Wixted; John T,0,11,50,50
1683675373269,PSYC 162,A00,189142,Staff,0,9,85,85
1683675374296,PSYC 172,A00,189144,Gorman; Michael R.,0,6,30,30
1683675376350,PSYC 179,A00,189146,Lacefield; Katharine I,0,87,120,120
1683675377374,PSYC 181,A00,189147,Anagnostaras; Stephan,0,44,90,90
1683675378401,PSYC 190R,A00,189148,Barner; David A.,0,23,80,80
1683675379426,PSYC 191,A00,189275,Rickard; Timothy C.,0,10,25,25
1683675380455,PSYC 193,A00,189276,Chapman; Eddie Nathaniel,0,1,0,4
1683675381481,PSYC 193L,A01,189281,Lowe; Angela Beth,8,0,20,12
1683675381481,PSYC 193L,B01,189285,Staff,28,0,35,7
1683675382507,RELI 149,A00,187137,Rahimi; Babak,7,0,40,33
1683675383532,SE 9,A01,187315,Staff,0,2,18,18
1683675384556,SE 101B,A00,187409,Staff,24,0,30,6
1683675385583,SE 110B,A00,187444,Staff,10,0,40,30
1683675386611,SE 130B,A00,187449,Staff,31,0,40,9
1683675387635,SE 150A,A00,187516,Staff,8,0,20,12
1683675388663,SE 154,A00,187528,Staff,29,0,50,21
1683675389688,SIO 3,A01,258171,Staff,35,0,40,5
1683675390715,SIO 10,A00,187144,Cook; Geoffrey W,0,7,75,75
1683675391740,SIO 45,A00,187152,Cook; Geoffrey W,0,7,100,100
1683675392763,SIO 109R,A00,194486,Staff,0,4,20,20
1683675394816,SIO 187,A01,187233,Kacev; David,12,0,40,28
1683675395842,SOCI 1,A01,258656,Thorpe; Charles Robert,28,0,30,2
1683675395842,SOCI 1,A02,258658,Thorpe; Charles Robert,30,0,30,0
1683675395842,SOCI 1,A03,258661,Thorpe; Charles Robert,25,0,25,0
1683675395842,SOCI 1,A04,258666,Thorpe; Charles Robert,22,0,25,3
1683675395842,SOCI 1,A05,258897,Thorpe; Charles Robert,22,0,25,3
1683675395842,SOCI 1,A06,258898,Thorpe; Charles Robert,25,0,25,0
1683675396866,SOCI 30,A01,258903,Pardo Guerra; Juan Pablo,14,0,30,16
1683675397891,SOCI 102,A00,258904,Staff,9,0,25,16
1683675398917,SOCI 106,A00,258905,Staff,19,0,25,6
1683675399941,SOCI 111,A00,258907,Ribas Norris; Janet Vanesa,26,0,30,4
1683675400965,SOCI 121R,A00,258908,Pardo Guerra; Juan Pablo,8,0,30,22
1683675401992,SOCI 126,A01,203330,Staff,14,0,20,6
1683675403021,SOCI 131,A00,258909,Thorpe; Charles Robert,30,0,60,30
1683675404045,SOCI 135,A00,258910,Payne; Christine Anna,0,12,30,30
1683675405072,SOCI 157,A00,258911,Staff,11,0,30,19
1683675406096,SOCI 184,A00,258912,Staff,25,0,30,5
1683675407120,SOCI 188D,A00,258913,Staff,22,0,30,8
1683675408144,SYN 2,001,187529,Staff,9,0,16,7
1683675408144,SYN 2,002,201452,Staff,1,20,16,15
1683675408144,SYN 2,003,201469,Staff,1,0,16,15
1683675409168,SYN 100,A01,187531,Staff,0,9,20,20
1683675409168,SYN 100,B01,201491,Staff,0,10,20,20
1683675410196,TDAC 1,A00,189286,Walsh; Kim C.,3,0,20,17
1683675410196,TDAC 1,B00,189287,Harting; Carla Kelso,10,0,20,10
1683675411223,TDAC 101,A00,189300,Walsh; Kim C.,16,0,20,4
1683675411223,TDAC 101,B00,189301,Harting; Carla Kelso,18,0,20,2
1683675412247,TDAC 102,A00,189304,Basso; Beatrice,14,0,20,6
1683675413274,TDAC 108,A00,189305,Staff,18,0,20,2
1683675414300,TDDE 131,A00,189310,Staff,19,0,20,1
1683675414300,TDDE 131,B00,189314,Staff,19,0,20,1
1683675414300,TDDE 131,C00,189315,Staff,48,0,50,2
1683675414300,TDDE 131,D00,189316,Staff,14,0,15,1
1683675414300,TDDE 131,E00,204841,Staff,20,0,20,0
1683675415323,TDGE 10,A00,189289,Staff,27,0,50,23
1683675415323,TDGE 10,B00,189290,Havis; Allan,0,1,50,50
1683675416348,TDGE 11,A00,189291,Fulton; Julia,0,4,50,50
1683675416348,TDGE 11,B00,189292,Staff,20,0,25,5
1683675416348,TDGE 11,C00,260270,Staff,0,0,0,0
1683675417375,TDGE 25,A00,189294,Staff,1,0,20,19
1683675418403,TDGE 124,A00,189318,Fulton; Julia,0,8,50,50
1683675419429,TDGE 125,A00,189319,Staff,13,0,25,12
1683675419429,TDGE 125,B00,189320,Staff,23,0,25,2
1683675420455,TDGE 127,A00,189322,Havis; Allan,0,0,50,50
1683675421479,TDHT 101,A00,189323,Staff,18,0,25,7
1683675421479,TDHT 101,B00,189324,Staff,25,0,25,0
1683675422507,TDHT 102,A00,189325,Staff,49,0,50,1
1683675423534,TDMV 1,A00,189295,Arcidiacono; Kristin,20,0,30,10
1683675423534,TDMV 1,B00,189296,Caligagan; Maria T.,24,0,30,6
1683675424559,TDMV 2,A00,189297,Sammartano; Tonnie,27,0,30,3
1683675424559,TDMV 2,B00,189299,Arcidiacono; Kristin,23,0,30,7
1683675425584,TDMV 3,A00,204998,Rincon; Alicia,22,0,30,8
1683675426611,TDMV 120,A00,189458,Sammartano; Tonnie,28,0,30,2
1683675427636,TDMV 138,A00,189541,Jun; Grace Shin Hae,20,0,40,20
1683675428673,TDMV 142,A00,189717,Caligagan; Tony,25,0,30,5
1683675428673,TDMV 142,B00,189718,Caligagan; Maria T.,25,0,30,5
1683675429698,TMC 2,A01,187533,Staff,25,0,25,0
1683675429698,TMC 2,A02,187534,Staff,25,0,25,0
1683675430722,USP 1,A01,187536,Kwak; Nancy,0,16,25,25
1683675431746,USP 5,A01,187538,Staff,8,0,25,17
1683675432771,USP 101,A00,199253,Staff,0,4,0,0
1683675433797,USP 124,A00,187562,Boomhower; Matthew Charles,0,0,30,30
1683675434821,USP 138,A00,187582,Staff,19,0,25,6
1683675435848,USP 152,A01,187597,Staff,3,0,25,22
1683675436874,USP 153,A00,187598,Staff,19,0,25,6
1683675437899,USP 168,A00,187607,Kwak; Nancy,2,0,5,3
1683675438923,USP 173,A00,187619,Staff,4,0,25,21
1683675439949,USP 181,A00,187638,Staff,0,4,25,25
1683675440976,VIS 103,A00,187650,Cruz; Edwin Teddy,17,0,75,58
1683675442002,VIS 110D,A00,187669,Staff,13,0,22,9
1683675443029,VIS 127C,A00,187720,Shen; Kuiyi,67,0,146,79
1683675444057,VIS 149,A00,187731,Yoldas; Pinar,1,14,22,21
1683675445138,VIS 151,A01,188091,Staff,22,0,34,12
1683675445138,VIS 151,A02,188092,Staff,11,0,34,23
1683675446165,VIS 160B,A00,188093,Stalbaum; Brett,0,1,10,10
1683675448225,WCWP 10B,A00,201720,Staff,0,0,5,5
1683675448225,WCWP 10B,B00,201722,Staff,0,0,6,6
1683675449252,WCWP 100,A00,201725,Gagnon; Jeffrey C,0,0,2,2
1683675449252,WCWP 100,B00,201727,Staff,0,4,15,15
1683675452343,ANBI 133,A00,258401,Wilder; Linnea Lorene,34,0,40,6
1683675453370,ANBI 140,A00,258395,Hrvoj Mihic; Branka,18,0,25,7
1683675454393,ANSC 120,A00,258402,Bialecki; Jon Anthony,26,0,40,14
1683675455421,ANSC 144,A00,258400,Staff,12,0,40,28
1683675457474,ANSC 166,A00,258396,Parish; Steven Martin,156,0,175,19
1683675458499,ANSC 180,A00,193533,Staff,8,0,20,12
1683675459524,ANSC 188,A00,258397,Jassal; Aftab,34,0,40,6
1683675460548,ANTH 3,A01,258316,Staff,23,0,30,7
1683675461574,ANTH 5,A00,258394,Semendeferi; Ekaterini,16,0,20,4
1683675462600,ANTH 21,A01,258331,Staff,4,0,40,36
1683675463623,ANTH 103,A00,258398,Varma; Saiba,15,0,25,10
1683675464650,AWP 10,001,202034,Staff,0,0,0,0
1683675464650,AWP 10,002,202035,Staff,0,0,0,0
1683675464650,AWP 10,003,202036,Staff,0,0,0,0
1683675464650,AWP 10,004,202037,Staff,0,0,0,0
1683675464650,AWP 10,005,202038,Staff,0,0,0,0
1683675464650,AWP 10,006,202039,Staff,0,0,0,0
1683675464650,AWP 10,007,202040,Staff,0,0,0,0
1683675464650,AWP 10,008,202041,Staff,0,0,0,0
1683675464650,AWP 10,009,202042,Staff,0,0,0,0
1683675464650,AWP 10,010,202043,Staff,0,0,0,0
1683675464650,AWP 10,011,202044,Staff,0,0,0,0
1683675464650,AWP 10,012,202045,Staff,0,0,0,0
1683675464650,AWP 10,013,202046,Staff,0,0,0,0
1683675464650,AWP 10,014,202047,Staff,0,0,0,0
1683675464650,AWP 10,015,202048,Staff,0,0,0,0
1683675464650,AWP 10,016,202049,Staff,0,0,0,0
1683675464650,AWP 10,017,202050,Staff,0,0,0,0
1683675464650,AWP 10,018,202051,Staff,0,0,0,0
1683675464650,AWP 10,019,202052,Staff,0,0,0,0
1683675464650,AWP 10,020,202053,Staff,0,0,0,0
1683675464650,AWP 10,021,202054,Staff,0,0,0,0
1683675464650,AWP 10,022,202055,Staff,0,0,0,0
1683675464650,AWP 10,023,202056,Staff,0,0,0,0
1683675464650,AWP 10,024,202057,Staff,0,0,0,0
1683675464650,AWP 10,025,202058,Staff,0,0,0,0
1683675464650,AWP 10,026,202059,Staff,0,0,0,0
1683675465674,AWP 102,001,202032,Staff,0,0,0,0
1683675465674,AWP 102,002,202033,Staff,0,0,0,0
1683675466698,BENG 100,A01,254234,Taylor Amos; Alyssa C,31,0,40,9
1683675467727,BENG 196,001,270013,Engler; Adam J.,9999,0,9999,0
1683675468753,BICD 100R,A01,202018,Smith; Laurie,0,7,32,32
1683675468753,BICD 100R,A02,202019,Smith; Laurie,0,3,32,32
1683675468753,BICD 100R,A03,202020,Smith; Laurie,0,1,32,32
1683675468753,BICD 100R,A04,202021,Smith; Laurie,6,0,32,26
1683675468753,BICD 100R,A05,202022,Smith; Laurie,10,0,32,22
1683675469781,BICD 136,A01,193242,Gustafson-Brown; Cindy,0,2,32,32
1683675469781,BICD 136,A02,193244,Gustafson-Brown; Cindy,13,0,32,19
1683675470813,BIEB 102,A01,193249,Butler; Shannon Rhey,1,1,32,31
1683675470813,BIEB 102,A02,193251,Butler; Shannon Rhey,0,0,32,32
1683675470813,BIEB 102,A03,193253,Butler; Shannon Rhey,0,0,32,32
1683675470813,BIEB 102,A04,193255,Butler; Shannon Rhey,13,0,32,19
1683675470813,BIEB 102,A05,193265,Butler; Shannon Rhey,25,0,32,7
1683675470813,BIEB 102,A06,193269,Butler; Shannon Rhey,13,0,32,19
1683675472866,BIEB 150,A01,193274,Staff,0,0,32,32
1683675472866,BIEB 150,A02,193285,Staff,24,0,32,8
1683675473890,BIEB 194,A00,193286,Kurle; Carolyn M.,19,0,32,13
1683675474915,BILD 1,A01,192291,Staff,15,0,32,17
1683675474915,BILD 1,A02,192292,Staff,30,0,32,2
1683675474915,BILD 1,B01,192520,Reuther; Keefe,0,1,0,0
1683675474915,BILD 1,B02,192532,Reuther; Keefe,0,1,0,0
1683675475941,BILD 3,A01,192556,Butler; Shannon Rhey,0,0,32,32
1683675475941,BILD 3,A02,192581,Butler; Shannon Rhey,0,1,32,32
1683675475941,BILD 3,A03,192611,Butler; Shannon Rhey,19,0,32,13
1683675475941,BILD 3,A04,192612,Butler; Shannon Rhey,24,0,32,8
1683675475941,BILD 3,A05,192613,Butler; Shannon Rhey,26,0,32,6
1683675475941,BILD 3,A06,192679,Butler; Shannon Rhey,27,0,32,5
1683675475941,BILD 3,A07,192682,Butler; Shannon Rhey,20,0,32,12
1683675476968,BILD 4,A01,192836,Reuther; Keefe,1,0,24,23
1683675476968,BILD 4,A02,193044,Reuther; Keefe,4,0,24,20
1683675477991,BILD 10,A01,193142,Gustafson-Brown; Cindy,29,0,32,3
1683675477991,BILD 10,A02,193149,Gustafson-Brown; Cindy,31,0,32,1
1683675479018,BIMM 100,A01,193301,Staff,0,6,32,32
1683675479018,BIMM 100,A02,193312,Staff,0,7,32,32
1683675479018,BIMM 100,A03,193323,Staff,0,10,32,32
1683675480046,BIMM 101,A01,193329,McDonnell; Lisa Marie,1,4,24,23
1683675480046,BIMM 101,A02,193339,McDonnell; Lisa Marie,1,4,24,23
1683675480046,BIMM 101,B01,193354,McDonnell; Lisa Marie,0,4,24,24
1683675480046,BIMM 101,B02,193357,McDonnell; Lisa Marie,0,3,24,24
1683675481075,BIMM 110,A01,193377,Tat; John,0,11,32,32
1683675481075,BIMM 110,A02,193378,Tat; John,0,10,32,32
1683675482103,BIMM 120,A01,206116,Staff,0,0,32,32
1683675482103,BIMM 120,A02,206117,Staff,7,0,32,25
1683675482103,BIMM 120,A03,206121,Staff,21,0,32,11
1683675483133,BIPN 100,A01,193393,Park; Ji Young,0,15,32,32
1683675483133,BIPN 100,A02,193402,Park; Ji Young,0,14,32,32
1683675483133,BIPN 100,A03,193413,Park; Ji Young,0,14,32,32
1683675483133,BIPN 100,A04,193414,Park; Ji Young,0,13,32,32
1683675484158,BIPN 102,A01,193429,Staff,0,0,32,32
1683675484158,BIPN 102,A02,193438,Staff,18,0,32,14
1683675485182,BIPN 106,A01,193450,Reyes Gonzalez; Catalina,0,2,40,40
1683675486211,BIPN 134,A01,193465,Cooke; James Edward,0,0,32,32
1683675486211,BIPN 134,A02,193474,Cooke; James Edward,25,0,32,7
1683675486211,BIPN 134,A03,193485,Cooke; James Edward,29,0,32,3
1683675486211,BIPN 134,A04,193486,Cooke; James Edward,20,0,32,12
1683675486211,BIPN 134,A05,193491,Cooke; James Edward,31,0,32,1
1683675486211,BIPN 134,A06,193501,Cooke; James Edward,30,0,32,2
1683675486211,BIPN 134,A07,193510,Cooke; James Edward,29,0,32,3
1683675488264,BISP 194,A00,222522,Staff,14,0,32,18
1683675489288,CAT 124,A01,202407,Staff,19,0,25,6
1683675490313,CAT 125,A00,202408,Marchisotto; Jennifer Anne,2,0,20,18
1683675491343,CAT 125R,A00,202409,Smith; Lauryn Alissa,0,11,20,20
1683675491343,CAT 125R,B00,202410,Morales; Celeste Georgianna,0,11,20,20
1683675491343,CAT 125R,C00,202411,Irwin; Matthew Joseph,0,12,20,20
1683675492368,CENG 15,A01,204712,Yang; Kesong,0,1,0,0
1683675493395,CENG 114,A00,202070,Jahed Motlagh; Zeinab,5,0,20,15
1683675494420,CGS 105,A00,185477,Wesling; Megan E.,24,0,40,16
1683675495450,CGS 106,A00,185494,Staff,11,0,22,11
1683675496475,CGS 108,A00,185495,Staff,14,0,20,6
1683675497500,CGS 114,A00,185496,Staff,13,0,18,5
1683675498525,CGS 119,A00,185501,Staff,15,0,20,5
1683675499552,CGS 120,A00,185511,Staff,12,0,20,8
1683675500577,CHEM 4,A01,184675,Bussey; Thomas J,97,0,100,3
1683675501603,CHEM 6A,A01,184677,Staff,32,0,60,28
1683675502637,CHEM 6B,A01,184679,Staff,63,0,100,37
1683675503663,CHEM 6C,A01,184681,Bussey; Thomas J,0,0,50,50
1683675503663,CHEM 6C,A02,184682,Bussey; Thomas J,32,0,50,18
1683675504691,CHEM 40A,A01,184684,Albizati; Kim F.,33,0,100,67
1683675505715,CHEM 40B,A01,184686,Albizati; Kim F.,0,22,100,100
1683675506741,CHEM 41B,A01,184690,Staff,51,0,100,49
1683675507769,COGS 3,A01,184715,Boyle; Mary E. T.,0,27,40,40
1683675508792,COGS 14B,A01,185172,Staff,0,14,38,38
1683675509815,COGS 18,A01,184736,Staff,14,0,80,66
1683675510840,COGS 100,A01,184932,Staff,0,8,73,73
1683675511864,COGS 101A,A01,184935,Staff,0,40,30,30
1683675512889,COGS 101B,A01,184944,Staff,0,2,30,30
1683675513917,COGS 101C,A01,184946,Staff,0,10,30,30
1683675514943,COGS 102A,A01,184951,Johnson; Christine M.,2,0,40,38
1683675515966,COGS 107B,A01,184953,Mooshagian; Eric Frederick,0,52,40,40
1683675516997,COGS 118B,A01,184959,Gupta; Anjum,0,50,40,40
1683675518021,COGS 153,A00,184961,Staff,0,16,30,30
1683675519045,COGS 177,A00,184962,Staff,0,21,30,30
1683675520069,COGS 187A,A01,184969,Boyle; Mary E. T.,0,19,40,40
1683675521094,COMM 10,A01,185174,Staff,0,5,25,25
1683675521094,COMM 10,A02,185189,Staff,0,2,25,25
1683675521094,COMM 10,A03,269821,Staff,0,1,0,0
1683675522119,COMM 100B,A01,185475,Staff,0,1,0,1
1683675522119,COMM 100B,A02,185476,Staff,11,0,25,14
1683675523148,COMM 100C,A01,185314,Staff,1,0,25,24
1683675523148,COMM 100C,A02,185327,Staff,17,0,25,8
1683675524175,COMM 110M,A00,185349,Staff,0,0,40,40
1683675525200,COMM 113T,A00,185352,Staff,25,0,40,15
1683675526223,COMM 114I,A00,185353,Staff,31,0,40,9
1683675527246,COMM 131,A00,185354,Staff,17,0,30,13
1683675528273,CSE 8A,A50,185358,Cao; Yingjun,0,46,10,10
1683675529297,CSE 8B,A01,185362,Staff,0,48,50,50
1683675530322,CSE 11,A01,185416,Cao; Yingjun,0,91,10,10
1683675531349,CSE 20,A01,185445,Briones; Jor-el Thomas Caparas,3,0,25,22
1683675532375,CSE 21,A01,185447,Staff,9,0,50,41
1683675533400,CSE 101,A01,185451,Staff,0,13,50,50
1683675533400,CSE 101,B01,185453,Jones; Miles E,0,14,50,50
1683675535453,CSE 141,A01,185458,Eldon; John,16,0,100,84
1683675536481,CSE 141L,A01,185461,Eldon; John,8,0,100,92
1683675537505,CSE 142,A01,185463,Staff,34,0,60,26
1683675537505,CSE 142,B01,201355,Staff,0,7,60,60
1683675538529,CSE 142L,A01,185470,Staff,34,0,60,26
1683675538529,CSE 142L,B01,201417,Staff,0,6,60,60
1683675539553,CSE 190,A00,201433,Staff,32,0,49,17
1683675540577,DOC 1,A01,259136,Strom; Megan C.,7,0,15,8
1683675540577,DOC 1,A02,259137,Strom; Megan C.,14,0,15,1
1683675540577,DOC 1,A03,259138,Strom; Megan C.,14,0,15,1
1683675540577,DOC 1,A04,259139,Strom; Megan C.,14,0,15,1
1683675541603,DOC 100D,A00,259140,Pass; Natalye Joann,14,0,25,11
1683675542630,DSGN 1,A01,184749,Rill; Bryan,0,26,30,30
1683675543661,DSGN 100,A01,185168,Staff,0,2,25,25
1683675544688,ECE 5,A01,185626,Morris; Karcher William,0,12,0,0
1683675545713,ECE 101,A01,185628,Staff,14,0,70,56
1683675546751,ECE 107,A01,185635,Baghdadchi; Saharnaz,0,0,20,20
1683675546751,ECE 107,A02,185638,Baghdadchi; Saharnaz,1,0,20,19
1683675547777,ECE 148,A01,185647,Silberman; Jack,0,0,16,16
1683675548857,ECON 1,A01,185537,Crane; Meredith Helen,54,0,70,16
1683675549881,ECON 3,A01,185549,Crane; Meredith Helen,29,0,70,41
1683675550907,ECON 4,A01,203354,Anderson; John Charles,0,5,10,10
1683675551932,ECON 100A,A01,185574,Staff,0,5,40,40
1683675552956,ECON 100B,A01,185576,Staff,0,12,50,50
1683675553981,ECON 100C,A01,185589,Newhouse; Herbert S,30,0,70,40
1683675555008,ECON 105,A00,185608,Vespa; Emanuel Ignacio,19,0,35,16
1683675556031,ECON 109,A01,185610,Shishkin; Denis,9,0,35,26
1683675557059,ECON 110A,A01,185612,Staff,9,0,40,31
1683675558084,ECON 120A,A01,185615,Staff,19,0,40,21
1683675559107,ECON 120C,A01,185617,Sun; Yixiao,0,21,70,70
1683675560133,ECON 144,A00,203346,Squires; Dale E,2,0,35,33
1683675561161,ECON 171,A01,203349,Newhouse; Herbert S,0,1,35,35
1683675562185,ECON 173A,A01,185621,Toda; Alexis Akira,21,0,35,14
1683675563216,EDS 25,A01,202413,Staff,0,1,0,0
1683675563216,EDS 25,A02,202414,Staff,0,1,0,0
1683675563216,EDS 25,A03,202415,Staff,0,0,0,0
1683675563216,EDS 25,A04,202416,Staff,0,1,0,0
1683675563216,EDS 25,A05,202439,Staff,0,0,0,0
1683675563216,EDS 25,A06,202440,Staff,0,0,0,0
1683675563216,EDS 25,B01,202631,Staff,0,0,0,0
1683675563216,EDS 25,B02,202632,Staff,0,0,0,0
1683675563216,EDS 25,B03,202639,Staff,0,0,0,0
1683675563216,EDS 25,B04,202640,Staff,0,0,0,0
1683675563216,EDS 25,B05,202643,Staff,0,0,0,0
1683675563216,EDS 25,B06,202644,Staff,0,0,0,0
1683675564243,EDS 38,A01,202659,Black; Alison Michelle,24,0,25,1
1683675565267,EDS 115,A00,202652,Staff,18,0,30,12
1683675566292,EDS 125,A00,202649,Staff,13,0,30,17
1683675567314,EDS 126,A01,203332,Staff,30,0,30,0
1683675568338,EDS 139,A00,202838,Staff,16,0,25,9
1683675569363,EDS 146,A01,202655,Staff,14,0,25,11
1683675570392,ENG 15,A00,185667,Staff,0,1,0,0
1683675570392,ENG 15,B00,185672,Staff,0,0,0,0
1683675570392,ENG 15,C00,185675,Staff,0,0,0,0
1683675570392,ENG 15,D00,185682,Staff,0,0,0,0
1683675570392,ENG 15,E00,185684,Staff,0,0,0,0
1683675571416,ETHN 103,A00,185710,Staff,0,8,35,35
1683675572444,ETHN 103A,A00,199228,Man; Simeon S,0,0,9,9
1683675573472,ETHN 109,A00,185711,Staff,15,0,35,20
1683675574499,ETHN 142,A00,185726,Staff,0,4,30,30
1683675575532,ETHN 163J,A00,199229,Man; Simeon S,5,0,8,3
1683675576558,ETHN 168,A00,185727,Staff,7,0,10,3
1683675577585,ETHN 182,A00,185728,Staff,0,0,35,35
1683675578609,ETHN 183,A00,185737,Staff,9,0,18,9
1683675579633,GLBH 111,A01,209361,Burgos; Jose L.,0,0,0,0
1683675581681,HIEU 104,A00,185792,Staff,14,0,20,6
1683675582705,HIEU 115,A00,185800,Staff,0,0,20,20
1683675583729,HIEU 128,A00,185801,Staff,0,9,20,20
1683675584757,HIEU 147,A00,185802,Staff,15,0,20,5
1683675585784,HIEU 154,A00,185823,Staff,11,0,20,9
1683675586809,HILA 102,A00,185826,Staff,14,0,20,6
1683675587834,HILD 2C,A01,185778,Staff,0,13,20,20
1683675588859,HILD 7B,A01,185780,Kwak; Nancy,0,17,32,32
1683675588859,HILD 7B,A02,185781,Kwak; Nancy,0,18,32,32
1683675589885,HILD 30,A01,185791,Staff,12,0,20,8
1683675590910,HISC 119,A00,185830,Golan; Tal,0,9,20,20
1683675591937,HITO 156GS,A00,185831,Patterson; Patrick H.,0,0,0,23
1683675592965,HIUS 103,A00,185832,Man; Simeon S,0,4,20,20
1683675593993,HIUS 117,A00,185836,Kwak; Nancy,2,0,20,18
1683675595018,HIUS 125,A00,185840,Man; Simeon S,0,2,23,23
1683675596045,HIUS 149,A00,185845,Staff,1,0,20,19
1683675597075,HUM 3,A01,185882,Zavodny; Tatiana Sophia,0,8,50,50
1683675597075,HUM 3,B01,185899,Caldwell; Michael Alan,0,18,50,50
1683675598101,HUM 3GS,A00,185900,Patterson; Patrick H.,0,0,0,23
1683675599130,HUM 4,A01,185938,Zroka; Amy Liane,28,0,50,22
1683675599130,HUM 4,B01,185956,Watkins; Eric,0,5,50,50
1683675599130,HUM 4,B02,202209,Watkins; Eric,0,5,50,50
1683675599130,HUM 4,B03,202210,Watkins; Eric,0,5,50,50
1683675600153,HUM 5,A01,185958,West; Geoffrey Scott,0,0,50,50
1683675600153,HUM 5,A02,202215,West; Geoffrey Scott,0,0,50,50
1683675601178,INTL 190,A00,185959,Gagnon; Jeffrey C,0,0,0,9
1683675601178,INTL 190,B00,185960,Lettieri; Michael Joseph,0,0,0,2
1683675602205,JAPN 180,A00,254509,Staff,5,0,30,25
1683675603233,LATI 10,A01,202853,Kennemore; Amy Michelle,4,0,35,31
1683675603233,LATI 10,A02,202854,Kennemore; Amy Michelle,3,0,35,32
1683675603233,LATI 10,A03,270054,Kennemore; Amy Michelle,30,0,30,0
1683675604266,LATI 180,A00,202855,Kennemore; Amy Michelle,11,0,20,9
1683675605290,LAWS 101,A00,201767,Golan; Tal,0,7,40,40
1683675606313,LIFR 1C,A00,185961,Staff,6,0,20,14
1683675607342,LIFR 1CX,A00,185962,Staff,7,0,20,13
1683675608366,LIFR 1D,A00,185963,Staff,7,0,20,13
1683675609394,LIFR 1DX,A00,185964,Staff,7,0,20,13
1683675610420,LIGN 101,A01,186039,Staff,43,0,50,7
1683675611446,LIGN 165,A00,186040,Staff,15,0,50,35
1683675612473,LTCS 108,A00,186041,Staff,5,0,10,5
1683675613496,LTCS 119,A00,186042,Staff,15,0,20,5
1683675614535,LTCS 130,A00,186043,Wesling; Megan E.,15,0,25,10
1683675616586,LTEA 138,A00,186119,Staff,14,0,40,26
1683675617610,LTEN 124,A00,186148,Staff,5,0,25,20
1683675618634,LTEN 178,A00,186149,Staff,7,0,15,8
1683675619662,LTEN 181,A00,186150,Blanco; John D,34,0,40,6
1683675620689,LTWL 120,A00,186160,Staff,19,0,25,6
1683675621713,LTWL 165,A00,186161,Staff,22,0,25,3
1683675622742,LTWR 100,A00,186162,Staff,0,5,15,15
1683675623767,LTWR 102,A00,186163,Doller; Ben,5,0,15,10
1683675624797,MAE 8,A01,186412,Staff,0,1,0,0
1683675625826,MAE 30B,A00,186445,Bahadori; Mohammad Yousef,82,0,100,18
1683675626849,MAE 40,A00,186592,Bewley; Thomas R,10,0,50,40
1683675627877,MAE 101B,A00,186593,Bahadori; Mohammad Yousef,80,0,100,20
1683675628905,MAE 105,A00,186594,Bandaru; Prabhakar,10,0,50,40
1683675629931,MAE 107,A00,186599,Pham; Hieu Tan,0,7,120,120
1683675630955,MAE 148,A01,186660,Silberman; Jack,3,0,16,13
1683675631980,MATH 10A,A01,188095,Staff,0,6,35,35
1683675633007,MATH 10B,A01,188097,Bowers; Adam R.,0,12,30,30
1683675633007,MATH 10B,A02,188099,Bowers; Adam R.,0,11,30,30
1683675633007,MATH 10B,B01,188104,Bowers; Adam R.,0,10,30,30
1683675633007,MATH 10B,B02,188106,Bowers; Adam R.,1,9,30,29
1683675634035,MATH 10C,A01,188111,Staff,0,20,30,30
1683675634035,MATH 10C,A02,188127,Staff,0,19,30,30
1683675634035,MATH 10C,A03,188131,Staff,0,19,30,30
1683675634035,MATH 10C,B01,188218,Staff,17,0,30,13
1683675634035,MATH 10C,B02,188244,Staff,13,0,30,17
1683675634035,MATH 10C,B03,188277,Staff,14,0,30,16
1683675635060,MATH 18,A01,188344,Bach; Quang Tran,18,0,30,12
1683675635060,MATH 18,A02,188345,Bach; Quang Tran,11,0,30,19
1683675635060,MATH 18,B01,188353,Bach; Quang Tran,11,0,30,19
1683675635060,MATH 18,B02,188354,Bach; Quang Tran,19,0,30,11
1683675636087,MATH 20A,A01,188374,Staff,11,0,35,24
1683675637115,MATH 20B,A01,188382,Ohm; Ko Woon,7,0,30,23
1683675637115,MATH 20B,A02,188383,Ohm; Ko Woon,22,0,30,8
1683675637115,MATH 20B,B01,188385,Ohm; Ko Woon,7,0,30,23
1683675637115,MATH 20B,B02,188392,Ohm; Ko Woon,22,0,30,8
1683675638139,MATH 20C,A01,188394,Harel; Guershon,10,0,30,20
1683675638139,MATH 20C,A02,188395,Harel; Guershon,13,0,30,17
1683675638139,MATH 20C,B01,188404,Harel; Guershon,5,0,30,25
1683675638139,MATH 20C,B02,188405,Harel; Guershon,18,0,30,12
1683675639163,MATH 20D,A01,188414,Hammock; Frances H,0,1,30,30
1683675639163,MATH 20D,A02,188415,Hammock; Frances H,0,1,30,30
1683675639163,MATH 20D,B01,188447,Hammock; Frances H,0,1,30,30
1683675639163,MATH 20D,B02,188486,Hammock; Frances H,3,0,30,27
1683675640191,MATH 20E,A01,188649,Staff,21,0,30,9
1683675640191,MATH 20E,A02,188650,Staff,20,0,30,10
1683675640191,MATH 20E,A03,188673,Staff,0,0,30,30
1683675641215,MATH 102,A01,188675,Staff,0,39,35,35
1683675642240,MATH 103B,A01,188681,Staff,3,0,35,32
1683675642240,MATH 103B,B01,188692,Staff,5,0,35,30
1683675643267,MATH 109,A01,188695,Salehi Golsefidy; Alireza,24,0,35,11
1683675643267,MATH 109,A02,188696,Salehi Golsefidy; Alireza,25,0,35,10
1683675644296,MATH 120A,A01,188698,Eggers; John Dietrich,7,0,35,28
1683675645324,MATH 142B,A01,188736,Ioana; Adrian,1,1,30,29
1683675645324,MATH 142B,A02,188741,Ioana; Adrian,0,1,30,30
1683675645324,MATH 142B,A03,188743,Ioana; Adrian,0,1,30,30
1683675646349,MATH 168A,A01,188790,Staff,0,11,35,35
1683675647373,MATH 170A,A01,188803,Nie; Jiawang,0,2,35,35
1683675647373,MATH 170A,A02,188811,Nie; Jiawang,0,1,35,35
1683675647373,MATH 170A,A03,188814,Nie; Jiawang,0,0,35,35
1683675647373,MATH 170A,A04,188815,Nie; Jiawang,5,0,35,30
1683675648397,MATH 193B,A01,188817,Staff,0,0,35,35
1683675648397,MATH 193B,A02,188818,Staff,5,0,35,30
1683675649424,MGT 4,A01,202857,Anderson; John Charles,60,0,80,20
1683675650448,MGT 12,A00,202858,Lindenberger; Wade Douglas,40,0,90,50
1683675651473,MGT 18,A00,202859,Staff,74,0,90,16
1683675652555,MGT 18GS,A00,202860,McKay; Michael J,13,0,28,15
1683675653583,MGT 45,A00,202861,Pecore; Joseph P.,10,0,90,80
1683675654613,MGT 100,A00,202863,Yavorsky; Daniel Ryan,28,0,90,62
1683675655638,MGT 103,A00,202864,Ehrich; Kristine R,0,18,90,90
1683675656666,MGT 112,A00,202865,Ehrich; Kristine R,15,0,90,75
1683675657693,MGT 121A,A00,202868,Staff,90,20,90,0
1683675658716,MGT 131B,A00,202869,Anderson; John Charles,59,0,90,31
1683675659744,MGT 136,A00,202871,Lindenberger; Wade Douglas,83,0,90,7
1683675660768,MGT 164,A00,202873,Staff,0,67,90,91
1683675661792,MGT 164GS,A00,202874,McKay; Mary A,13,0,28,15
1683675662829,MGT 180,A00,202875,Staff,0,51,90,91
1683675663852,MMW 11R,A01,205019,Herbst; Matthew,0,0,30,30
1683675663852,MMW 11R,A02,205026,Herbst; Matthew,29,0,30,1
1683675664878,MMW 15,A01,193512,Chang; Edmond Yi-Teh,0,8,28,28
1683675664878,MMW 15,A02,193513,Chang; Edmond Yi-Teh,0,5,28,28
1683675664878,MMW 15,A03,193514,Chang; Edmond Yi-Teh,0,5,28,28
1683675664878,MMW 15,A04,193515,Chang; Edmond Yi-Teh,0,5,28,28
1683675664878,MMW 15,A05,193516,Chang; Edmond Yi-Teh,0,5,28,28
1683675664878,MMW 15,A06,193517,Chang; Edmond Yi-Teh,0,6,28,28
1683675664878,MMW 15,B01,193519,Chang; Edmond Yi-Teh,0,5,28,28
1683675664878,MMW 15,B02,193520,Chang; Edmond Yi-Teh,0,5,28,28
1683675664878,MMW 15,B03,193521,Chang; Edmond Yi-Teh,0,5,28,28
1683675664878,MMW 15,B04,193522,Chang; Edmond Yi-Teh,0,5,28,28
1683675664878,MMW 15,B05,193523,Chang; Edmond Yi-Teh,0,5,28,28
1683675664878,MMW 15,B06,193524,Chang; Edmond Yi-Teh,0,5,28,28
1683675665903,MMW 122,A01,193526,Rahimi; Babak,0,16,28,28
1683675665903,MMW 122,A02,193527,Rahimi; Babak,0,15,28,28
1683675665903,MMW 122,A03,193528,Rahimi; Babak,0,0,0,0
1683675665903,MMW 122,A04,193529,Rahimi; Babak,0,0,0,0
1683675666928,MUS 1A,A01,186663,Staff,1,19,35,34
1683675667956,MUS 4,A01,186715,Staff,0,12,35,35
1683675668980,MUS 5R,A01,186796,Dubnov; Shlomo,0,17,35,35
1683675670007,MUS 6,A01,186798,Staff,0,5,25,25
1683675671029,MUS 7,A01,186830,Staff,11,0,35,24
1683675672056,MUS 8,A01,186930,Staff,0,27,35,35
1683675673081,MUS 15,A01,186932,Staff,0,15,35,35
1683675673081,MUS 15,B01,186934,Staff,1,17,35,34
1683675674105,MUS 80,A00,186935,Staff,0,0,20,20
1683675674105,MUS 80,B00,186936,Staff,24,0,25,1
1683675675131,NANO 11,A00,204702,Lipomi; Darren John,0,0,0,0
1683675676158,NANO 15,A01,204709,Yang; Kesong,0,1,0,0
1683675677185,NANO 114,A00,202069,Jahed Motlagh; Zeinab,3,0,10,7
1683675678210,PHIL 1,A00,186955,Grush; Rick Scott,31,0,40,9
1683675679234,PHIL 10,A01,186973,Grush; Rick Scott,27,0,35,8
1683675679234,PHIL 10,A02,186974,Grush; Rick Scott,33,0,35,2
1683675680257,PHIL 13,A01,186976,Staff,3,0,35,32
1683675680257,PHIL 13,A02,186977,Staff,16,0,35,19
1683675681286,PHIL 14,A01,186979,Staff,31,0,35,4
1683675681286,PHIL 14,A02,186986,Staff,32,0,35,3
1683675682313,PHIL 28,A01,186988,Staff,16,0,30,14
1683675682313,PHIL 28,A02,186989,Staff,1,0,30,29
1683675682313,PHIL 28,A03,186990,Staff,10,0,30,20
1683675682313,PHIL 28,A04,186991,Staff,26,0,30,4
1683675683348,PHIL 120,A00,186997,Staff,23,0,40,17
1683675684377,PHIL 137,A00,187003,Staff,7,0,40,33
1683675685405,PHIL 150,A00,187015,Staff,47,0,70,23
1683675686430,PHIL 167,A00,187021,Lamey; Andy M.,34,0,40,6
1683675687454,PHIL 174,A01,202226,Staff,17,0,20,3
1683675687454,PHIL 174,A02,202235,Staff,20,0,20,0
1683675688481,PHIL 191A,A00,258918,Staff,0,0,1,1
1683675689509,PHYS 1A,A00,187028,Staff,26,0,60,34
1683675690534,PHYS 1AL,001,187036,Staff,3,0,30,27
1683675690534,PHYS 1AL,002,187049,Staff,18,0,30,12
1683675691558,PHYS 1B,A00,187058,Staff,22,0,60,38
1683675692583,PHYS 1BL,001,187064,Staff,0,1,30,30
1683675692583,PHYS 1BL,002,187070,Staff,4,0,30,26
1683675693608,PHYS 1C,A00,187082,Staff,29,0,120,91
1683675694637,PHYS 1CL,001,187088,Staff,0,9,30,30
1683675694637,PHYS 1CL,002,187089,Staff,0,1,30,30
1683675694637,PHYS 1CL,009,262693,Staff,9,0,30,21
1683675695664,PHYS 2B,A01,187097,Staff,55,0,115,60
1683675696689,PHYS 2C,A01,187099,Staff,63,0,115,52
1683675697714,PHYS 2CL,A01,187101,Staff,5,0,28,23
1683675697714,PHYS 2CL,A02,187102,Staff,15,0,28,13
1683675698739,PHYS 2D,A01,187123,Shotwell; Brian,95,0,115,20
1683675699772,PHYS 4B,A01,187133,Grinstein; Benjamin,35,0,50,15
1683675700795,POLI 10,A00,188819,Staff,0,4,50,50
1683675701820,POLI 11,A00,188827,Staff,43,0,50,7
1683675702845,POLI 13R,A00,188828,Staff,0,1,20,20
1683675703873,POLI 27,A01,188830,Elgin; Samuel Zincke,0,2,70,70
1683675704897,POLI 30,A00,188832,Desposato; Scott,30,0,50,20
1683675705925,POLI 102F,A00,188834,Staff,0,0,40,40
1683675706952,POLI 104A,A00,188852,Staff,12,0,30,18
1683675707979,POLI 104I,A00,188853,Staff,0,8,20,20
1683675709005,POLI 110B,A00,188854,Wiens; David,6,0,20,14
1683675710030,POLI 112A,A00,188855,Wiens; David,3,0,30,27
1683675711059,POLI 117R,A00,188856,Forman; Fonna,0,12,20,20
1683675712086,POLI 118,A00,188857,Ingham; Sean,8,0,20,12
1683675713110,POLI 120G,A00,188858,Staff,8,0,30,22
1683675714138,POLI 131CR,A00,188863,Hoston; Germaine,20,0,50,30
1683675715163,POLI 133,A00,188864,Nellis; Gareth Hb,44,0,50,6
1683675716189,POLI 134D,A00,188865,Desposato; Scott,27,0,30,3
1683675717214,POLI 142A,A00,188871,Gartzke; Erik,21,0,50,29
1683675718239,POLI 142K,A00,188874,Staff,38,0,50,12
1683675719263,POLI 143,A00,188940,Gartzke; Erik,16,0,30,14
1683675720287,POLI 153,A00,188943,Staff,2,0,20,18
1683675721310,POLI 160AA,A00,188944,Staff,11,0,40,29
1683675722340,POLI 170A,A00,188945,Staff,10,0,30,20
1683675724394,PSYC 1,A00,188952,Staff,37,0,90,53
1683675725417,PSYC 2,B00,188953,Staff,19,0,35,16
1683675726441,PSYC 6,A00,188970,Staff,47,0,60,13
1683675727466,PSYC 7,A00,188973,Staff,35,0,45,10
1683675728494,PSYC 60,A01,188980,Rickard; Timothy C.,42,0,60,18
1683675729518,PSYC 70,A01,189001,Steiner; Eric Tomas,21,0,45,24
1683675730549,PSYC 100,A00,189005,Lacefield; Katharine I,0,100,120,120
1683675731575,PSYC 102,A00,189008,Staff,7,0,30,23
1683675732603,PSYC 106,B00,189026,Gorman; Michael R.,27,0,60,33
1683675733633,PSYC 114,B01,189033,Winkielman; Piotr,0,31,30,30
1683675734662,PSYC 131,A00,189036,Anagnostaras; Stephan,0,43,60,60
1683675735687,PSYC 136,A00,189041,Lowe; Angela Beth,0,7,25,25
1683675736712,PSYC 137,A00,189057,Winkielman; Piotr,1,37,25,24
1683675737736,PSYC 144,A00,189107,Wixted; John T,0,11,50,50
1683675739788,PSYC 162,A00,189142,Staff,0,9,85,85
1683675740811,PSYC 172,A00,189144,Gorman; Michael R.,0,6,30,30
1683675742858,PSYC 179,A00,189146,Lacefield; Katharine I,0,87,120,120
1683675743886,PSYC 181,A00,189147,Anagnostaras; Stephan,0,44,90,90
1683675744913,PSYC 190R,A00,189148,Barner; David A.,0,23,80,80
1683675745937,PSYC 191,A00,189275,Rickard; Timothy C.,0,10,25,25
1683675746961,PSYC 193,A00,189276,Chapman; Eddie Nathaniel,0,1,0,4
1683675747985,PSYC 193L,A01,189281,Lowe; Angela Beth,8,0,20,12
1683675747985,PSYC 193L,B01,189285,Staff,28,0,35,7
1683675749009,RELI 149,A00,187137,Rahimi; Babak,7,0,40,33
1683675750034,SE 9,A01,187315,Staff,0,2,18,18
1683675751058,SE 101B,A00,187409,Staff,24,0,30,6
1683675752083,SE 110B,A00,187444,Staff,10,0,40,30
1683675753110,SE 130B,A00,187449,Staff,31,0,40,9
1683675754135,SE 150A,A00,187516,Staff,8,0,20,12
1683675755162,SE 154,A00,187528,Staff,29,0,50,21
1683675756242,SIO 3,A01,258171,Staff,35,0,40,5
1683675757268,SIO 10,A00,187144,Cook; Geoffrey W,1,7,75,74
1683675758296,SIO 45,A00,187152,Cook; Geoffrey W,0,7,100,100
1683675759321,SIO 109R,A00,194486,Staff,0,4,20,20
1683675761370,SIO 187,A01,187233,Kacev; David,12,0,40,28
1683675762396,SOCI 1,A01,258656,Thorpe; Charles Robert,28,0,30,2
1683675762396,SOCI 1,A02,258658,Thorpe; Charles Robert,30,0,30,0
1683675762396,SOCI 1,A03,258661,Thorpe; Charles Robert,25,0,25,0
1683675762396,SOCI 1,A04,258666,Thorpe; Charles Robert,22,0,25,3
1683675762396,SOCI 1,A05,258897,Thorpe; Charles Robert,22,0,25,3
1683675762396,SOCI 1,A06,258898,Thorpe; Charles Robert,25,0,25,0
1683675763418,SOCI 30,A01,258903,Pardo Guerra; Juan Pablo,14,0,30,16
1683675764441,SOCI 102,A00,258904,Staff,9,0,25,16
1683675765469,SOCI 106,A00,258905,Staff,19,0,25,6
1683675766494,SOCI 111,A00,258907,Ribas Norris; Janet Vanesa,26,0,30,4
1683675767520,SOCI 121R,A00,258908,Pardo Guerra; Juan Pablo,8,0,30,22
1683675768544,SOCI 126,A01,203330,Staff,14,0,20,6
1683675769573,SOCI 131,A00,258909,Thorpe; Charles Robert,30,0,60,30
1683675770598,SOCI 135,A00,258910,Payne; Christine Anna,0,12,30,30
1683675771625,SOCI 157,A00,258911,Staff,11,0,30,19
1683675772649,SOCI 184,A00,258912,Staff,25,0,30,5
1683675773673,SOCI 188D,A00,258913,Staff,22,0,30,8
1683675774697,SYN 2,001,187529,Staff,9,0,16,7
1683675774697,SYN 2,002,201452,Staff,1,20,16,15
1683675774697,SYN 2,003,201469,Staff,1,0,16,15
1683675775722,SYN 100,A01,187531,Staff,0,9,20,20
1683675775722,SYN 100,B01,201491,Staff,0,10,20,20
1683675776746,TDAC 1,A00,189286,Walsh; Kim C.,3,0,20,17
1683675776746,TDAC 1,B00,189287,Harting; Carla Kelso,10,0,20,10
1683675777770,TDAC 101,A00,189300,Walsh; Kim C.,16,0,20,4
1683675777770,TDAC 101,B00,189301,Harting; Carla Kelso,18,0,20,2
1683675778795,TDAC 102,A00,189304,Basso; Beatrice,14,0,20,6
1683675779819,TDAC 108,A00,189305,Staff,18,0,20,2
1683675780846,TDDE 131,A00,189310,Staff,19,0,20,1
1683675780846,TDDE 131,B00,189314,Staff,19,0,20,1
1683675780846,TDDE 131,C00,189315,Staff,48,0,50,2
1683675780846,TDDE 131,D00,189316,Staff,14,0,15,1
1683675780846,TDDE 131,E00,204841,Staff,20,0,20,0
1683675781873,TDGE 10,A00,189289,Staff,27,0,50,23
1683675781873,TDGE 10,B00,189290,Havis; Allan,0,1,50,50
1683675782902,TDGE 11,A00,189291,Fulton; Julia,0,4,50,50
1683675782902,TDGE 11,B00,189292,Staff,20,0,25,5
1683675782902,TDGE 11,C00,260270,Staff,0,0,0,0
1683675783926,TDGE 25,A00,189294,Staff,1,0,20,19
1683675784954,TDGE 124,A00,189318,Fulton; Julia,0,8,50,50
1683675785981,TDGE 125,A00,189319,Staff,13,0,25,12
1683675785981,TDGE 125,B00,189320,Staff,23,0,25,2
1683675787006,TDGE 127,A00,189322,Havis; Allan,0,0,50,50
1683675788035,TDHT 101,A00,189323,Staff,18,0,25,7
1683675788035,TDHT 101,B00,189324,Staff,25,0,25,0
1683675789060,TDHT 102,A00,189325,Staff,49,0,50,1
1683675790093,TDMV 1,A00,189295,Arcidiacono; Kristin,20,0,30,10
1683675790093,TDMV 1,B00,189296,Caligagan; Maria T.,24,0,30,6
1683675791118,TDMV 2,A00,189297,Sammartano; Tonnie,27,0,30,3
1683675791118,TDMV 2,B00,189299,Arcidiacono; Kristin,23,0,30,7
1683675792143,TDMV 3,A00,204998,Rincon; Alicia,22,0,30,8
1683675793167,TDMV 120,A00,189458,Sammartano; Tonnie,28,0,30,2
1683675794192,TDMV 138,A00,189541,Jun; Grace Shin Hae,20,0,40,20
1683675795216,TDMV 142,A00,189717,Caligagan; Tony,25,0,30,5
1683675795216,TDMV 142,B00,189718,Caligagan; Maria T.,25,0,30,5
1683675796240,TMC 2,A01,187533,Staff,25,0,25,0
1683675796240,TMC 2,A02,187534,Staff,25,0,25,0
1683675797266,USP 1,A01,187536,Kwak; Nancy,0,16,25,25
1683675798293,USP 5,A01,187538,Staff,8,0,25,17
1683675799318,USP 101,A00,199253,Staff,0,4,0,0
1683675800346,USP 124,A00,187562,Boomhower; Matthew Charles,0,0,30,30
1683675801371,USP 138,A00,187582,Staff,19,0,25,6
1683675802398,USP 152,A01,187597,Staff,3,0,25,22
1683675803421,USP 153,A00,187598,Staff,19,0,25,6
1683675804457,USP 168,A00,187607,Kwak; Nancy,2,0,5,3
1683675805482,USP 173,A00,187619,Staff,4,0,25,21
1683675806507,USP 181,A00,187638,Staff,0,4,25,25
1683675807534,VIS 103,A00,187650,Cruz; Edwin Teddy,17,0,75,58
1683675808558,VIS 110D,A00,187669,Staff,13,0,22,9
1683675809582,VIS 127C,A00,187720,Shen; Kuiyi,67,0,146,79
1683675810609,VIS 149,A00,187731,Yoldas; Pinar,1,14,22,21
1683675811633,VIS 151,A01,188091,Staff,22,0,34,12
1683675811633,VIS 151,A02,188092,Staff,11,0,34,23
1683675812658,VIS 160B,A00,188093,Stalbaum; Brett,0,1,10,10
1683675814708,WCWP 10B,A00,201720,Staff,0,0,5,5
1683675814708,WCWP 10B,B00,201722,Staff,0,0,6,6
1683675815733,WCWP 100,A00,201725,Gagnon; Jeffrey C,0,0,2,2
1683675815733,WCWP 100,B00,201727,Staff,0,4,15,15
1683675818827,ANBI 133,A00,258401,Wilder; Linnea Lorene,34,0,40,6
1683675819853,ANBI 140,A00,258395,Hrvoj Mihic; Branka,18,0,25,7
1683675820875,ANSC 120,A00,258402,Bialecki; Jon Anthony,26,0,40,14
1683675821899,ANSC 144,A00,258400,Staff,12,0,40,28
1683675823947,ANSC 166,A00,258396,Parish; Steven Martin,156,0,175,19
1683675824975,ANSC 180,A00,193533,Staff,8,0,20,12
1683675826005,ANSC 188,A00,258397,Jassal; Aftab,34,0,40,6
1683675827030,ANTH 3,A01,258316,Staff,23,0,30,7
1683675828057,ANTH 5,A00,258394,Semendeferi; Ekaterini,16,0,20,4
1683675829081,ANTH 21,A01,258331,Staff,4,0,40,36
1683675830106,ANTH 103,A00,258398,Varma; Saiba,15,0,25,10
1683675831139,AWP 10,001,202034,Staff,0,0,0,0
1683675831139,AWP 10,002,202035,Staff,0,0,0,0
1683675831139,AWP 10,003,202036,Staff,0,0,0,0
1683675831139,AWP 10,004,202037,Staff,0,0,0,0
1683675831139,AWP 10,005,202038,Staff,0,0,0,0
1683675831139,AWP 10,006,202039,Staff,0,0,0,0
1683675831139,AWP 10,007,202040,Staff,0,0,0,0
1683675831139,AWP 10,008,202041,Staff,0,0,0,0
1683675831139,AWP 10,009,202042,Staff,0,0,0,0
1683675831139,AWP 10,010,202043,Staff,0,0,0,0
1683675831139,AWP 10,011,202044,Staff,0,0,0,0
1683675831139,AWP 10,012,202045,Staff,0,0,0,0
1683675831139,AWP 10,013,202046,Staff,0,0,0,0
1683675831139,AWP 10,014,202047,Staff,0,0,0,0
1683675831139,AWP 10,015,202048,Staff,0,0,0,0
1683675831139,AWP 10,016,202049,Staff,0,0,0,0
1683675831139,AWP 10,017,202050,Staff,0,0,0,0
1683675831139,AWP 10,018,202051,Staff,0,0,0,0
1683675831139,AWP 10,019,202052,Staff,0,0,0,0
1683675831139,AWP 10,020,202053,Staff,0,0,0,0
1683675831139,AWP 10,021,202054,Staff,0,0,0,0
1683675831139,AWP 10,022,202055,Staff,0,0,0,0
1683675831139,AWP 10,023,202056,Staff,0,0,0,0
1683675831139,AWP 10,024,202057,Staff,0,0,0,0
1683675831139,AWP 10,025,202058,Staff,0,0,0,0
1683675831139,AWP 10,026,202059,Staff,0,0,0,0
1683675832163,AWP 102,001,202032,Staff,0,0,0,0
1683675832163,AWP 102,002,202033,Staff,0,0,0,0
1683675833191,BENG 100,A01,254234,Taylor Amos; Alyssa C,31,0,40,9
1683675834214,BENG 196,001,270013,Engler; Adam J.,9999,0,9999,0
1683675835238,BICD 100R,A01,202018,Smith; Laurie,0,7,32,32
1683675835238,BICD 100R,A02,202019,Smith; Laurie,0,3,32,32
1683675835238,BICD 100R,A03,202020,Smith; Laurie,0,1,32,32
1683675835238,BICD 100R,A04,202021,Smith; Laurie,6,0,32,26
1683675835238,BICD 100R,A05,202022,Smith; Laurie,10,0,32,22
1683675836261,BICD 136,A01,193242,Gustafson-Brown; Cindy,0,2,32,32
1683675836261,BICD 136,A02,193244,Gustafson-Brown; Cindy,13,0,32,19
1683675837286,BIEB 102,A01,193249,Butler; Shannon Rhey,1,1,32,31
1683675837286,BIEB 102,A02,193251,Butler; Shannon Rhey,0,0,32,32
1683675837286,BIEB 102,A03,193253,Butler; Shannon Rhey,0,0,32,32
1683675837286,BIEB 102,A04,193255,Butler; Shannon Rhey,13,0,32,19
1683675837286,BIEB 102,A05,193265,Butler; Shannon Rhey,25,0,32,7
1683675837286,BIEB 102,A06,193269,Butler; Shannon Rhey,13,0,32,19
1683675839333,BIEB 150,A01,193274,Staff,0,0,32,32
1683675839333,BIEB 150,A02,193285,Staff,24,0,32,8
1683675840361,BIEB 194,A00,193286,Kurle; Carolyn M.,19,0,32,13
1683675841385,BILD 1,A01,192291,Staff,15,0,32,17
1683675841385,BILD 1,A02,192292,Staff,30,0,32,2
1683675841385,BILD 1,B01,192520,Reuther; Keefe,0,1,0,0
1683675841385,BILD 1,B02,192532,Reuther; Keefe,0,1,0,0
1683675842416,BILD 3,A01,192556,Butler; Shannon Rhey,0,0,32,32
1683675842416,BILD 3,A02,192581,Butler; Shannon Rhey,0,1,32,32
1683675842416,BILD 3,A03,192611,Butler; Shannon Rhey,19,0,32,13
1683675842416,BILD 3,A04,192612,Butler; Shannon Rhey,24,0,32,8
1683675842416,BILD 3,A05,192613,Butler; Shannon Rhey,26,0,32,6
1683675842416,BILD 3,A06,192679,Butler; Shannon Rhey,27,0,32,5
1683675842416,BILD 3,A07,192682,Butler; Shannon Rhey,20,0,32,12
1683675843441,BILD 4,A01,192836,Reuther; Keefe,1,0,24,23
1683675843441,BILD 4,A02,193044,Reuther; Keefe,4,0,24,20
1683675844465,BILD 10,A01,193142,Gustafson-Brown; Cindy,29,0,32,3
1683675844465,BILD 10,A02,193149,Gustafson-Brown; Cindy,31,0,32,1
1683675845491,BIMM 100,A01,193301,Staff,0,6,32,32
1683675845491,BIMM 100,A02,193312,Staff,0,7,32,32
1683675845491,BIMM 100,A03,193323,Staff,0,10,32,32
1683675846520,BIMM 101,A01,193329,McDonnell; Lisa Marie,1,4,24,23
1683675846520,BIMM 101,A02,193339,McDonnell; Lisa Marie,1,4,24,23
1683675846520,BIMM 101,B01,193354,McDonnell; Lisa Marie,0,4,24,24
1683675846520,BIMM 101,B02,193357,McDonnell; Lisa Marie,0,3,24,24
1683675847548,BIMM 110,A01,193377,Tat; John,0,11,32,32
1683675847548,BIMM 110,A02,193378,Tat; John,0,10,32,32
1683675848574,BIMM 120,A01,206116,Staff,0,0,32,32
1683675848574,BIMM 120,A02,206117,Staff,7,0,32,25
1683675848574,BIMM 120,A03,206121,Staff,21,0,32,11
1683675849599,BIPN 100,A01,193393,Park; Ji Young,0,15,32,32
1683675849599,BIPN 100,A02,193402,Park; Ji Young,0,14,32,32
1683675849599,BIPN 100,A03,193413,Park; Ji Young,0,14,32,32
1683675849599,BIPN 100,A04,193414,Park; Ji Young,0,13,32,32
1683675850626,BIPN 102,A01,193429,Staff,0,0,32,32
1683675850626,BIPN 102,A02,193438,Staff,18,0,32,14
1683675851652,BIPN 106,A01,193450,Reyes Gonzalez; Catalina,0,2,40,40
1683675852681,BIPN 134,A01,193465,Cooke; James Edward,0,0,32,32
1683675852681,BIPN 134,A02,193474,Cooke; James Edward,25,0,32,7
1683675852681,BIPN 134,A03,193485,Cooke; James Edward,29,0,32,3
1683675852681,BIPN 134,A04,193486,Cooke; James Edward,20,0,32,12
1683675852681,BIPN 134,A05,193491,Cooke; James Edward,31,0,32,1
1683675852681,BIPN 134,A06,193501,Cooke; James Edward,30,0,32,2
1683675852681,BIPN 134,A07,193510,Cooke; James Edward,29,0,32,3
1683675854742,BISP 194,A00,222522,Staff,14,0,32,18
1683675855766,CAT 124,A01,202407,Staff,19,0,25,6
1683675856791,CAT 125,A00,202408,Marchisotto; Jennifer Anne,2,0,20,18
1683675857816,CAT 125R,A00,202409,Smith; Lauryn Alissa,0,11,20,20
1683675857816,CAT 125R,B00,202410,Morales; Celeste Georgianna,0,11,20,20
1683675857816,CAT 125R,C00,202411,Irwin; Matthew Joseph,0,12,20,20
1683675858840,CENG 15,A01,204712,Yang; Kesong,0,1,0,0
1683675859922,CENG 114,A00,202070,Jahed Motlagh; Zeinab,5,0,20,15
1683675860946,CGS 105,A00,185477,Wesling; Megan E.,24,0,40,16
1683675861969,CGS 106,A00,185494,Staff,11,0,22,11
1683675862993,CGS 108,A00,185495,Staff,14,0,20,6
1683675864016,CGS 114,A00,185496,Staff,13,0,18,5
1683675865040,CGS 119,A00,185501,Staff,15,0,20,5
1683675866064,CGS 120,A00,185511,Staff,12,0,20,8
1683675867089,CHEM 4,A01,184675,Bussey; Thomas J,97,0,100,3
1683675868111,CHEM 6A,A01,184677,Staff,32,0,60,28
1683675869139,CHEM 6B,A01,184679,Staff,63,0,100,37
1683675870165,CHEM 6C,A01,184681,Bussey; Thomas J,0,0,50,50
1683675870165,CHEM 6C,A02,184682,Bussey; Thomas J,32,0,50,18
1683675871188,CHEM 40A,A01,184684,Albizati; Kim F.,33,0,100,67
1683675872214,CHEM 40B,A01,184686,Albizati; Kim F.,0,22,100,100
1683675873244,CHEM 41B,A01,184690,Staff,51,0,100,49
1683675874271,COGS 3,A01,184715,Boyle; Mary E. T.,0,27,40,40
1683675875294,COGS 14B,A01,185172,Staff,0,14,38,38
1683675876321,COGS 18,A01,184736,Staff,14,0,80,66
1683675877344,COGS 100,A01,184932,Staff,0,8,73,73
1683675878369,COGS 101A,A01,184935,Staff,0,40,30,30
1683675879397,COGS 101B,A01,184944,Staff,0,2,30,30
1683675880422,COGS 101C,A01,184946,Staff,0,10,30,30
1683675881446,COGS 102A,A01,184951,Johnson; Christine M.,2,0,40,38
1683675882470,COGS 107B,A01,184953,Mooshagian; Eric Frederick,0,52,40,40
1683675883498,COGS 118B,A01,184959,Gupta; Anjum,0,50,40,40
1683675884522,COGS 153,A00,184961,Staff,0,16,30,30
1683675885547,COGS 177,A00,184962,Staff,0,21,30,30
1683675886571,COGS 187A,A01,184969,Boyle; Mary E. T.,0,19,40,40
1683675887596,COMM 10,A01,185174,Staff,0,5,25,25
1683675887596,COMM 10,A02,185189,Staff,0,2,25,25
1683675887596,COMM 10,A03,269821,Staff,0,1,0,0
1683675888621,COMM 100B,A01,185475,Staff,0,1,0,1
1683675888621,COMM 100B,A02,185476,Staff,11,0,25,14
1683675889646,COMM 100C,A01,185314,Staff,1,0,25,24
1683675889646,COMM 100C,A02,185327,Staff,17,0,25,8
1683675890670,COMM 110M,A00,185349,Staff,0,0,40,40
1683675891695,COMM 113T,A00,185352,Staff,25,0,40,15
1683675892720,COMM 114I,A00,185353,Staff,31,0,40,9
1683675893744,COMM 131,A00,185354,Staff,17,0,30,13
1683675894772,CSE 8A,A50,185358,Cao; Yingjun,0,46,10,10
1683675895797,CSE 8B,A01,185362,Staff,0,48,50,50
1683675896827,CSE 11,A01,185416,Cao; Yingjun,0,91,10,10
1683675897852,CSE 20,A01,185445,Briones; Jor-el Thomas Caparas,3,0,25,22
1683675898879,CSE 21,A01,185447,Staff,9,0,50,41
1683675899905,CSE 101,A01,185451,Staff,0,13,50,50
1683675899905,CSE 101,B01,185453,Jones; Miles E,0,14,50,50
1683675901957,CSE 141,A01,185458,Eldon; John,16,0,100,84
1683675902983,CSE 141L,A01,185461,Eldon; John,8,0,100,92
1683675904010,CSE 142,A01,185463,Staff,34,0,60,26
1683675904010,CSE 142,B01,201355,Staff,0,7,60,60
1683675905033,CSE 142L,A01,185470,Staff,34,0,60,26
1683675905033,CSE 142L,B01,201417,Staff,0,6,60,60
1683675906057,CSE 190,A00,201433,Staff,32,0,49,17
1683675907079,DOC 1,A01,259136,Strom; Megan C.,7,0,15,8
1683675907079,DOC 1,A02,259137,Strom; Megan C.,14,0,15,1
1683675907079,DOC 1,A03,259138,Strom; Megan C.,14,0,15,1
1683675907079,DOC 1,A04,259139,Strom; Megan C.,14,0,15,1
1683675908106,DOC 100D,A00,259140,Pass; Natalye Joann,14,0,25,11
1683675909134,DSGN 1,A01,184749,Rill; Bryan,0,26,30,30
1683675910157,DSGN 100,A01,185168,Staff,0,2,25,25
1683675911180,ECE 5,A01,185626,Morris; Karcher William,0,12,0,0
1683675912205,ECE 101,A01,185628,Staff,14,0,70,56
1683675913232,ECE 107,A01,185635,Baghdadchi; Saharnaz,0,0,20,20
1683675913232,ECE 107,A02,185638,Baghdadchi; Saharnaz,1,0,20,19
1683675914256,ECE 148,A01,185647,Silberman; Jack,0,0,16,16
1683675915281,ECON 1,A01,185537,Crane; Meredith Helen,54,0,70,16
1683675916305,ECON 3,A01,185549,Crane; Meredith Helen,29,0,70,41
1683675917332,ECON 4,A01,203354,Anderson; John Charles,0,5,10,10
1683675918355,ECON 100A,A01,185574,Staff,0,5,40,40
1683675919379,ECON 100B,A01,185576,Staff,0,12,50,50
1683675920403,ECON 100C,A01,185589,Newhouse; Herbert S,30,0,70,40
1683675921427,ECON 105,A00,185608,Vespa; Emanuel Ignacio,19,0,35,16
1683675922452,ECON 109,A01,185610,Shishkin; Denis,9,0,35,26
1683675923476,ECON 110A,A01,185612,Staff,9,0,40,31
1683675924502,ECON 120A,A01,185615,Staff,19,0,40,21
1683675925525,ECON 120C,A01,185617,Sun; Yixiao,0,21,70,70
1683675926550,ECON 144,A00,203346,Squires; Dale E,1,0,35,34
1683675927576,ECON 171,A01,203349,Newhouse; Herbert S,0,1,35,35
1683675928605,ECON 173A,A01,185621,Toda; Alexis Akira,21,0,35,14
1683675929635,EDS 25,A01,202413,Staff,0,1,0,0
1683675929635,EDS 25,A02,202414,Staff,0,1,0,0
1683675929635,EDS 25,A03,202415,Staff,0,0,0,0
1683675929635,EDS 25,A04,202416,Staff,0,1,0,0
1683675929635,EDS 25,A05,202439,Staff,0,0,0,0
1683675929635,EDS 25,A06,202440,Staff,0,0,0,0
1683675929635,EDS 25,B01,202631,Staff,0,0,0,0
1683675929635,EDS 25,B02,202632,Staff,0,0,0,0
1683675929635,EDS 25,B03,202639,Staff,0,0,0,0
1683675929635,EDS 25,B04,202640,Staff,0,0,0,0
1683675929635,EDS 25,B05,202643,Staff,0,0,0,0
1683675929635,EDS 25,B06,202644,Staff,0,0,0,0
1683675930660,EDS 38,A01,202659,Black; Alison Michelle,24,0,25,1
1683675931684,EDS 115,A00,202652,Staff,18,0,30,12
1683675932713,EDS 125,A00,202649,Staff,13,0,30,17
1683675933740,EDS 126,A01,203332,Staff,30,0,30,0
1683675934765,EDS 139,A00,202838,Staff,16,0,25,9
1683675935792,EDS 146,A01,202655,Staff,14,0,25,11
1683675936821,ENG 15,A00,185667,Staff,0,1,0,0
1683675936821,ENG 15,B00,185672,Staff,0,0,0,0
1683675936821,ENG 15,C00,185675,Staff,0,0,0,0
1683675936821,ENG 15,D00,185682,Staff,0,0,0,0
1683675936821,ENG 15,E00,185684,Staff,0,0,0,0
1683675937847,ETHN 103,A00,185710,Staff,0,8,35,35
1683675938875,ETHN 103A,A00,199228,Man; Simeon S,0,0,9,9
1683675939900,ETHN 109,A00,185711,Staff,15,0,35,20
1683675940925,ETHN 142,A00,185726,Staff,0,4,30,30
1683675941948,ETHN 163J,A00,199229,Man; Simeon S,5,0,8,3
1683675942972,ETHN 168,A00,185727,Staff,7,0,10,3
1683675944000,ETHN 182,A00,185728,Staff,0,0,35,35
1683675945023,ETHN 183,A00,185737,Staff,9,0,18,9
1683675946050,GLBH 111,A01,209361,Burgos; Jose L.,0,0,0,0
1683675948097,HIEU 104,A00,185792,Staff,14,0,20,6
1683675949122,HIEU 115,A00,185800,Staff,0,0,20,20
1683675950146,HIEU 128,A00,185801,Staff,0,9,20,20
1683675951172,HIEU 147,A00,185802,Staff,15,0,20,5
1683675952197,HIEU 154,A00,185823,Staff,11,0,20,9
1683675953224,HILA 102,A00,185826,Staff,14,0,20,6
1683675954249,HILD 2C,A01,185778,Staff,0,13,20,20
1683675955275,HILD 7B,A01,185780,Kwak; Nancy,0,17,32,32
1683675955275,HILD 7B,A02,185781,Kwak; Nancy,0,18,32,32
1683675956305,HILD 30,A01,185791,Staff,12,0,20,8
1683675957329,HISC 119,A00,185830,Golan; Tal,0,9,20,20
1683675958352,HITO 156GS,A00,185831,Patterson; Patrick H.,0,0,0,23
1683675959376,HIUS 103,A00,185832,Man; Simeon S,0,4,20,20
1683675960403,HIUS 117,A00,185836,Kwak; Nancy,2,0,20,18
1683675961432,HIUS 125,A00,185840,Man; Simeon S,0,2,23,23
1683675962460,HIUS 149,A00,185845,Staff,1,0,20,19
1683675963542,HUM 3,A01,185882,Zavodny; Tatiana Sophia,0,8,50,50
1683675963542,HUM 3,B01,185899,Caldwell; Michael Alan,0,18,50,50
1683675964566,HUM 3GS,A00,185900,Patterson; Patrick H.,0,0,0,23
1683675965596,HUM 4,A01,185938,Zroka; Amy Liane,28,0,50,22
1683675965596,HUM 4,B01,185956,Watkins; Eric,0,5,50,50
1683675965596,HUM 4,B02,202209,Watkins; Eric,0,5,50,50
1683675965596,HUM 4,B03,202210,Watkins; Eric,0,5,50,50
1683675966618,HUM 5,A01,185958,West; Geoffrey Scott,0,0,50,50
1683675966618,HUM 5,A02,202215,West; Geoffrey Scott,0,0,50,50
1683675967645,INTL 190,A00,185959,Gagnon; Jeffrey C,0,0,0,9
1683675967645,INTL 190,B00,185960,Lettieri; Michael Joseph,0,0,0,2
1683675968670,JAPN 180,A00,254509,Staff,5,0,30,25
1683675969695,LATI 10,A01,202853,Kennemore; Amy Michelle,4,0,35,31
1683675969695,LATI 10,A02,202854,Kennemore; Amy Michelle,3,0,35,32
1683675969695,LATI 10,A03,270054,Kennemore; Amy Michelle,30,0,30,0
1683675970724,LATI 180,A00,202855,Kennemore; Amy Michelle,11,0,20,9
1683675971749,LAWS 101,A00,201767,Golan; Tal,0,7,40,40
1683675972773,LIFR 1C,A00,185961,Staff,6,0,20,14
1683675973796,LIFR 1CX,A00,185962,Staff,7,0,20,13
1683675974821,LIFR 1D,A00,185963,Staff,7,0,20,13
1683675975846,LIFR 1DX,A00,185964,Staff,7,0,20,13
1683675976871,LIGN 101,A01,186039,Staff,43,0,50,7
1683675977898,LIGN 165,A00,186040,Staff,15,0,50,35
1683675978925,LTCS 108,A00,186041,Staff,5,0,10,5
1683675979949,LTCS 119,A00,186042,Staff,15,0,20,5
1683675980975,LTCS 130,A00,186043,Wesling; Megan E.,15,0,25,10
1683675983026,LTEA 138,A00,186119,Staff,14,0,40,26
1683675984050,LTEN 124,A00,186148,Staff,5,0,25,20
1683675985078,LTEN 178,A00,186149,Staff,7,0,15,8
1683675986102,LTEN 181,A00,186150,Blanco; John D,34,0,40,6
1683675987127,LTWL 120,A00,186160,Staff,19,0,25,6
1683675988155,LTWL 165,A00,186161,Staff,22,0,25,3
1683675989180,LTWR 100,A00,186162,Staff,0,5,15,15
1683675990208,LTWR 102,A00,186163,Doller; Ben,5,0,15,10
1683675991234,MAE 8,A01,186412,Staff,0,1,0,0
1683675992256,MAE 30B,A00,186445,Bahadori; Mohammad Yousef,82,0,100,18
1683675993284,MAE 40,A00,186592,Bewley; Thomas R,10,0,50,40
1683675994308,MAE 101B,A00,186593,Bahadori; Mohammad Yousef,80,0,100,20
1683675995332,MAE 105,A00,186594,Bandaru; Prabhakar,10,0,50,40
1683675996357,MAE 107,A00,186599,Pham; Hieu Tan,0,7,120,120
1683675997386,MAE 148,A01,186660,Silberman; Jack,3,0,16,13
1683675998417,MATH 10A,A01,188095,Staff,0,6,35,35
1683675999448,MATH 10B,A01,188097,Bowers; Adam R.,0,12,30,30
1683675999448,MATH 10B,A02,188099,Bowers; Adam R.,0,11,30,30
1683675999448,MATH 10B,B01,188104,Bowers; Adam R.,0,10,30,30
1683675999448,MATH 10B,B02,188106,Bowers; Adam R.,1,9,30,29
1683676000474,MATH 10C,A01,188111,Staff,0,20,30,30
1683676000474,MATH 10C,A02,188127,Staff,0,19,30,30
1683676000474,MATH 10C,A03,188131,Staff,0,19,30,30
1683676000474,MATH 10C,B01,188218,Staff,17,0,30,13
1683676000474,MATH 10C,B02,188244,Staff,13,0,30,17
1683676000474,MATH 10C,B03,188277,Staff,14,0,30,16
1683676001505,MATH 18,A01,188344,Bach; Quang Tran,18,0,30,12
1683676001505,MATH 18,A02,188345,Bach; Quang Tran,11,0,30,19
1683676001505,MATH 18,B01,188353,Bach; Quang Tran,11,0,30,19
1683676001505,MATH 18,B02,188354,Bach; Quang Tran,19,0,30,11
1683676002533,MATH 20A,A01,188374,Staff,11,0,35,24
1683676003562,MATH 20B,A01,188382,Ohm; Ko Woon,7,0,30,23
1683676003562,MATH 20B,A02,188383,Ohm; Ko Woon,22,0,30,8
1683676003562,MATH 20B,B01,188385,Ohm; Ko Woon,7,0,30,23
1683676003562,MATH 20B,B02,188392,Ohm; Ko Woon,22,0,30,8
1683676004586,MATH 20C,A01,188394,Harel; Guershon,10,0,30,20
1683676004586,MATH 20C,A02,188395,Harel; Guershon,13,0,30,17
1683676004586,MATH 20C,B01,188404,Harel; Guershon,5,0,30,25
1683676004586,MATH 20C,B02,188405,Harel; Guershon,18,0,30,12
1683676005616,MATH 20D,A01,188414,Hammock; Frances H,0,1,30,30
1683676005616,MATH 20D,A02,188415,Hammock; Frances H,0,1,30,30
1683676005616,MATH 20D,B01,188447,Hammock; Frances H,0,1,30,30
1683676005616,MATH 20D,B02,188486,Hammock; Frances H,3,0,30,27
1683676006639,MATH 20E,A01,188649,Staff,21,0,30,9
1683676006639,MATH 20E,A02,188650,Staff,20,0,30,10
1683676006639,MATH 20E,A03,188673,Staff,0,0,30,30
1683676007669,MATH 102,A01,188675,Staff,0,39,35,35
1683676008694,MATH 103B,A01,188681,Staff,3,0,35,32
1683676008694,MATH 103B,B01,188692,Staff,5,0,35,30
1683676009718,MATH 109,A01,188695,Salehi Golsefidy; Alireza,24,0,35,11
1683676009718,MATH 109,A02,188696,Salehi Golsefidy; Alireza,25,0,35,10
1683676010742,MATH 120A,A01,188698,Eggers; John Dietrich,7,0,35,28
1683676011767,MATH 142B,A01,188736,Ioana; Adrian,1,1,30,29
1683676011767,MATH 142B,A02,188741,Ioana; Adrian,0,1,30,30
1683676011767,MATH 142B,A03,188743,Ioana; Adrian,0,1,30,30
1683676012791,MATH 168A,A01,188790,Staff,0,11,35,35
1683676013817,MATH 170A,A01,188803,Nie; Jiawang,0,2,35,35
1683676013817,MATH 170A,A02,188811,Nie; Jiawang,0,1,35,35
1683676013817,MATH 170A,A03,188814,Nie; Jiawang,0,0,35,35
1683676013817,MATH 170A,A04,188815,Nie; Jiawang,5,0,35,30
1683676014845,MATH 193B,A01,188817,Staff,0,0,35,35
1683676014845,MATH 193B,A02,188818,Staff,5,0,35,30
1683676015872,MGT 4,A01,202857,Anderson; John Charles,60,0,80,20
1683676016897,MGT 12,A00,202858,Lindenberger; Wade Douglas,40,0,90,50
1683676017923,MGT 18,A00,202859,Staff,74,0,90,16
1683676018952,MGT 18GS,A00,202860,McKay; Michael J,13,0,28,15
1683676019978,MGT 45,A00,202861,Pecore; Joseph P.,10,0,90,80
1683676021005,MGT 100,A00,202863,Yavorsky; Daniel Ryan,28,0,90,62
1683676022030,MGT 103,A00,202864,Ehrich; Kristine R,0,18,90,90
1683676023052,MGT 112,A00,202865,Ehrich; Kristine R,15,0,90,75
1683676024079,MGT 121A,A00,202868,Staff,90,20,90,0
1683676025104,MGT 131B,A00,202869,Anderson; John Charles,59,0,90,31
1683676026133,MGT 136,A00,202871,Lindenberger; Wade Douglas,83,0,90,7
1683676027157,MGT 164,A00,202873,Staff,0,67,90,91
1683676028182,MGT 164GS,A00,202874,McKay; Mary A,13,0,28,15
1683676029207,MGT 180,A00,202875,Staff,0,51,90,91
1683676030232,MMW 11R,A01,205019,Herbst; Matthew,0,0,30,30
1683676030232,MMW 11R,A02,205026,Herbst; Matthew,29,0,30,1
1683676031258,MMW 15,A01,193512,Chang; Edmond Yi-Teh,0,8,28,28
1683676031258,MMW 15,A02,193513,Chang; Edmond Yi-Teh,0,5,28,28
1683676031258,MMW 15,A03,193514,Chang; Edmond Yi-Teh,0,5,28,28
1683676031258,MMW 15,A04,193515,Chang; Edmond Yi-Teh,0,5,28,28
1683676031258,MMW 15,A05,193516,Chang; Edmond Yi-Teh,0,5,28,28
1683676031258,MMW 15,A06,193517,Chang; Edmond Yi-Teh,0,6,28,28
1683676031258,MMW 15,B01,193519,Chang; Edmond Yi-Teh,0,5,28,28
1683676031258,MMW 15,B02,193520,Chang; Edmond Yi-Teh,0,5,28,28
1683676031258,MMW 15,B03,193521,Chang; Edmond Yi-Teh,0,5,28,28
1683676031258,MMW 15,B04,193522,Chang; Edmond Yi-Teh,0,5,28,28
1683676031258,MMW 15,B05,193523,Chang; Edmond Yi-Teh,0,5,28,28
1683676031258,MMW 15,B06,193524,Chang; Edmond Yi-Teh,0,5,28,28
1683676032286,MMW 122,A01,193526,Rahimi; Babak,0,16,28,28
1683676032286,MMW 122,A02,193527,Rahimi; Babak,0,15,28,28
1683676032286,MMW 122,A03,193528,Rahimi; Babak,0,0,0,0
1683676032286,MMW 122,A04,193529,Rahimi; Babak,0,0,0,0
1683676033309,MUS 1A,A01,186663,Staff,1,19,35,34
1683676034337,MUS 4,A01,186715,Staff,0,12,35,35
1683676035362,MUS 5R,A01,186796,Dubnov; Shlomo,0,17,35,35
1683676036392,MUS 6,A01,186798,Staff,0,5,25,25
1683676037416,MUS 7,A01,186830,Staff,11,0,35,24
1683676038443,MUS 8,A01,186930,Staff,0,27,35,35
1683676039468,MUS 15,A01,186932,Staff,0,15,35,35
1683676039468,MUS 15,B01,186934,Staff,1,17,35,34
1683676040496,MUS 80,A00,186935,Staff,0,0,20,20
1683676040496,MUS 80,B00,186936,Staff,24,0,25,1
1683676041519,NANO 11,A00,204702,Lipomi; Darren John,0,0,0,0
1683676042544,NANO 15,A01,204709,Yang; Kesong,0,1,0,0
1683676043570,NANO 114,A00,202069,Jahed Motlagh; Zeinab,3,0,10,7
1683676044597,PHIL 1,A00,186955,Grush; Rick Scott,31,0,40,9
1683676045625,PHIL 10,A01,186973,Grush; Rick Scott,27,0,35,8
1683676045625,PHIL 10,A02,186974,Grush; Rick Scott,33,0,35,2
1683676046651,PHIL 13,A01,186976,Staff,3,0,35,32
1683676046651,PHIL 13,A02,186977,Staff,16,0,35,19
1683676047680,PHIL 14,A01,186979,Staff,31,0,35,4
1683676047680,PHIL 14,A02,186986,Staff,32,0,35,3
1683676048708,PHIL 28,A01,186988,Staff,16,0,30,14
1683676048708,PHIL 28,A02,186989,Staff,1,0,30,29
1683676048708,PHIL 28,A03,186990,Staff,10,0,30,20
1683676048708,PHIL 28,A04,186991,Staff,26,0,30,4
1683676049731,PHIL 120,A00,186997,Staff,23,0,40,17
1683676050758,PHIL 137,A00,187003,Staff,7,0,40,33
1683676051782,PHIL 150,A00,187015,Staff,47,0,70,23
1683676052810,PHIL 167,A00,187021,Lamey; Andy M.,34,0,40,6
1683676053833,PHIL 174,A01,202226,Staff,17,0,20,3
1683676053833,PHIL 174,A02,202235,Staff,20,0,20,0
1683676054858,PHIL 191A,A00,258918,Staff,0,0,1,1
1683676055885,PHYS 1A,A00,187028,Staff,26,0,60,34
1683676056913,PHYS 1AL,001,187036,Staff,3,0,30,27
1683676056913,PHYS 1AL,002,187049,Staff,18,0,30,12
1683676057939,PHYS 1B,A00,187058,Staff,22,0,60,38
1683676058964,PHYS 1BL,001,187064,Staff,0,1,30,30
1683676058964,PHYS 1BL,002,187070,Staff,4,0,30,26
1683676059993,PHYS 1C,A00,187082,Staff,29,0,120,91
1683676061021,PHYS 1CL,001,187088,Staff,0,9,30,30
1683676061021,PHYS 1CL,002,187089,Staff,0,1,30,30
1683676061021,PHYS 1CL,009,262693,Staff,9,0,30,21
1683676062044,PHYS 2B,A01,187097,Staff,55,0,115,60
1683676063074,PHYS 2C,A01,187099,Staff,63,0,115,52
1683676064102,PHYS 2CL,A01,187101,Staff,5,0,28,23
1683676064102,PHYS 2CL,A02,187102,Staff,15,0,28,13
1683676065127,PHYS 2D,A01,187123,Shotwell; Brian,95,0,115,20
1683676066153,PHYS 4B,A01,187133,Grinstein; Benjamin,35,0,50,15
1683676067235,POLI 10,A00,188819,Staff,0,4,50,50
1683676068260,POLI 11,A00,188827,Staff,43,0,50,7
1683676069283,POLI 13R,A00,188828,Staff,0,1,20,20
1683676070311,POLI 27,A01,188830,Elgin; Samuel Zincke,0,2,70,70
1683676071338,POLI 30,A00,188832,Desposato; Scott,30,0,50,20
1683676072362,POLI 102F,A00,188834,Staff,0,0,40,40
1683676073389,POLI 104A,A00,188852,Staff,12,0,30,18
1683676074416,POLI 104I,A00,188853,Staff,0,8,20,20
1683676075443,POLI 110B,A00,188854,Wiens; David,6,0,20,14
1683676076468,POLI 112A,A00,188855,Wiens; David,3,0,30,27
1683676077491,POLI 117R,A00,188856,Forman; Fonna,0,12,20,20
1683676078514,POLI 118,A00,188857,Ingham; Sean,8,0,20,12
1683676079540,POLI 120G,A00,188858,Staff,8,0,30,22
1683676080563,POLI 131CR,A00,188863,Hoston; Germaine,20,0,50,30
1683676081587,POLI 133,A00,188864,Nellis; Gareth Hb,44,0,50,6
1683676082611,POLI 134D,A00,188865,Desposato; Scott,27,0,30,3
1683676083635,POLI 142A,A00,188871,Gartzke; Erik,21,0,50,29
1683676084660,POLI 142K,A00,188874,Staff,38,0,50,12
1683676085687,POLI 143,A00,188940,Gartzke; Erik,16,0,30,14
1683676086710,POLI 153,A00,188943,Staff,2,0,20,18
1683676087734,POLI 160AA,A00,188944,Staff,10,0,40,30
1683676088761,POLI 170A,A00,188945,Staff,10,0,30,20
1683676090809,PSYC 1,A00,188952,Staff,37,0,90,53
1683676091833,PSYC 2,B00,188953,Staff,19,0,35,16
1683676092858,PSYC 6,A00,188970,Staff,47,0,60,13
1683676093884,PSYC 7,A00,188973,Staff,35,0,45,10
1683676094909,PSYC 60,A01,188980,Rickard; Timothy C.,42,0,60,18
1683676095936,PSYC 70,A01,189001,Steiner; Eric Tomas,21,0,45,24
1683676096959,PSYC 100,A00,189005,Lacefield; Katharine I,0,100,120,120
1683676097984,PSYC 102,A00,189008,Staff,7,0,30,23
1683676099011,PSYC 106,B00,189026,Gorman; Michael R.,27,0,60,33
1683676100036,PSYC 114,B01,189033,Winkielman; Piotr,0,31,30,30
1683676101060,PSYC 131,A00,189036,Anagnostaras; Stephan,0,43,60,60
1683676102084,PSYC 136,A00,189041,Lowe; Angela Beth,0,7,25,25
1683676103107,PSYC 137,A00,189057,Winkielman; Piotr,1,37,25,24
1683676104133,PSYC 144,A00,189107,Wixted; John T,0,11,50,50
1683676106180,PSYC 162,A00,189142,Staff,0,9,85,85
1683676107207,PSYC 172,A00,189144,Gorman; Michael R.,0,6,30,30
1683676109257,PSYC 179,A00,189146,Lacefield; Katharine I,0,87,120,120
1683676110284,PSYC 181,A00,189147,Anagnostaras; Stephan,0,44,90,90
1683676111308,PSYC 190R,A00,189148,Barner; David A.,0,23,80,80
1683676112332,PSYC 191,A00,189275,Rickard; Timothy C.,0,10,25,25
1683676113358,PSYC 193,A00,189276,Chapman; Eddie Nathaniel,0,1,0,4
1683676114386,PSYC 193L,A01,189281,Lowe; Angela Beth,8,0,20,12
1683676114386,PSYC 193L,B01,189285,Staff,28,0,35,7
1683676115413,RELI 149,A00,187137,Rahimi; Babak,7,0,40,33
1683676116437,SE 9,A01,187315,Staff,0,2,18,18
1683676117460,SE 101B,A00,187409,Staff,24,0,30,6
1683676118483,SE 110B,A00,187444,Staff,10,0,40,30
1683676119509,SE 130B,A00,187449,Staff,31,0,40,9
1683676120534,SE 150A,A00,187516,Staff,8,0,20,12
1683676121560,SE 154,A00,187528,Staff,29,0,50,21
1683676122582,SIO 3,A01,258171,Staff,35,0,40,5
1683676123610,SIO 10,A00,187144,Cook; Geoffrey W,1,7,75,74
1683676124636,SIO 45,A00,187152,Cook; Geoffrey W,0,7,100,100
1683676125659,SIO 109R,A00,194486,Staff,0,4,20,20
1683676127711,SIO 187,A01,187233,Kacev; David,12,0,40,28
1683676128736,SOCI 1,A01,258656,Thorpe; Charles Robert,28,0,30,2
1683676128736,SOCI 1,A02,258658,Thorpe; Charles Robert,30,0,30,0
1683676128736,SOCI 1,A03,258661,Thorpe; Charles Robert,25,0,25,0
1683676128736,SOCI 1,A04,258666,Thorpe; Charles Robert,22,0,25,3
1683676128736,SOCI 1,A05,258897,Thorpe; Charles Robert,22,0,25,3
1683676128736,SOCI 1,A06,258898,Thorpe; Charles Robert,25,0,25,0
1683676129759,SOCI 30,A01,258903,Pardo Guerra; Juan Pablo,14,0,30,16
1683676130782,SOCI 102,A00,258904,Staff,9,0,25,16
1683676131809,SOCI 106,A00,258905,Staff,19,0,25,6
1683676132834,SOCI 111,A00,258907,Ribas Norris; Janet Vanesa,26,0,30,4
1683676133861,SOCI 121R,A00,258908,Pardo Guerra; Juan Pablo,8,0,30,22
1683676134887,SOCI 126,A01,203330,Staff,14,0,20,6
1683676135913,SOCI 131,A00,258909,Thorpe; Charles Robert,30,0,60,30
1683676136940,SOCI 135,A00,258910,Payne; Christine Anna,0,12,30,30
1683676137963,SOCI 157,A00,258911,Staff,11,0,30,19
1683676138990,SOCI 184,A00,258912,Staff,25,0,30,5
1683676140014,SOCI 188D,A00,258913,Staff,22,0,30,8
1683676141038,SYN 2,001,187529,Staff,9,0,16,7
1683676141038,SYN 2,002,201452,Staff,1,20,16,15
1683676141038,SYN 2,003,201469,Staff,1,0,16,15
1683676142064,SYN 100,A01,187531,Staff,0,9,20,20
1683676142064,SYN 100,B01,201491,Staff,0,10,20,20
1683676143088,TDAC 1,A00,189286,Walsh; Kim C.,3,0,20,17
1683676143088,TDAC 1,B00,189287,Harting; Carla Kelso,10,0,20,10
1683676144112,TDAC 101,A00,189300,Walsh; Kim C.,16,0,20,4
1683676144112,TDAC 101,B00,189301,Harting; Carla Kelso,18,0,20,2
1683676145135,TDAC 102,A00,189304,Basso; Beatrice,14,0,20,6
1683676146159,TDAC 108,A00,189305,Staff,18,0,20,2
1683676147185,TDDE 131,A00,189310,Staff,19,0,20,1
1683676147185,TDDE 131,B00,189314,Staff,19,0,20,1
1683676147185,TDDE 131,C00,189315,Staff,48,0,50,2
1683676147185,TDDE 131,D00,189316,Staff,14,0,15,1
1683676147185,TDDE 131,E00,204841,Staff,20,0,20,0
1683676148212,TDGE 10,A00,189289,Staff,27,0,50,23
1683676148212,TDGE 10,B00,189290,Havis; Allan,0,1,50,50
1683676149237,TDGE 11,A00,189291,Fulton; Julia,0,4,50,50
1683676149237,TDGE 11,B00,189292,Staff,20,0,25,5
1683676149237,TDGE 11,C00,260270,Staff,0,0,0,0
1683676150260,TDGE 25,A00,189294,Staff,1,0,20,19
1683676151287,TDGE 124,A00,189318,Fulton; Julia,0,8,50,50
1683676152311,TDGE 125,A00,189319,Staff,13,0,25,12
1683676152311,TDGE 125,B00,189320,Staff,23,0,25,2
1683676153334,TDGE 127,A00,189322,Havis; Allan,0,0,50,50
1683676154358,TDHT 101,A00,189323,Staff,18,0,25,7
1683676154358,TDHT 101,B00,189324,Staff,25,0,25,0
1683676155383,TDHT 102,A00,189325,Staff,49,0,50,1
1683676156410,TDMV 1,A00,189295,Arcidiacono; Kristin,20,0,30,10
1683676156410,TDMV 1,B00,189296,Caligagan; Maria T.,24,0,30,6
1683676157435,TDMV 2,A00,189297,Sammartano; Tonnie,27,0,30,3
1683676157435,TDMV 2,B00,189299,Arcidiacono; Kristin,23,0,30,7
1683676158459,TDMV 3,A00,204998,Rincon; Alicia,22,0,30,8
1683676159483,TDMV 120,A00,189458,Sammartano; Tonnie,28,0,30,2
1683676160507,TDMV 138,A00,189541,Jun; Grace Shin Hae,20,0,40,20
1683676161535,TDMV 142,A00,189717,Caligagan; Tony,25,0,30,5
1683676161535,TDMV 142,B00,189718,Caligagan; Maria T.,25,0,30,5
1683676162560,TMC 2,A01,187533,Staff,25,0,25,0
1683676162560,TMC 2,A02,187534,Staff,25,0,25,0
1683676163585,USP 1,A01,187536,Kwak; Nancy,0,16,25,25
1683676164613,USP 5,A01,187538,Staff,8,0,25,17
1683676165640,USP 101,A00,199253,Staff,0,4,0,0
1683676166666,USP 124,A00,187562,Boomhower; Matthew Charles,0,0,30,30
1683676167693,USP 138,A00,187582,Staff,19,0,25,6
1683676168720,USP 152,A01,187597,Staff,3,0,25,22
1683676169747,USP 153,A00,187598,Staff,19,0,25,6
1683676170827,USP 168,A00,187607,Kwak; Nancy,2,0,5,3
1683676171861,USP 173,A00,187619,Staff,4,0,25,21
1683676172893,USP 181,A00,187638,Staff,0,4,25,25
1683676173921,VIS 103,A00,187650,Cruz; Edwin Teddy,17,0,75,58
1683676174948,VIS 110D,A00,187669,Staff,13,0,22,9
1683676175970,VIS 127C,A00,187720,Shen; Kuiyi,67,0,146,79
1683676176994,VIS 149,A00,187731,Yoldas; Pinar,1,14,22,21
1683676178020,VIS 151,A01,188091,Staff,22,0,34,12
1683676178020,VIS 151,A02,188092,Staff,11,0,34,23
1683676179048,VIS 160B,A00,188093,Stalbaum; Brett,0,1,10,10
1683676181098,WCWP 10B,A00,201720,Staff,0,0,5,5
1683676181098,WCWP 10B,B00,201722,Staff,0,0,6,6
1683676182122,WCWP 100,A00,201725,Gagnon; Jeffrey C,0,0,2,2
1683676182122,WCWP 100,B00,201727,Staff,0,4,15,15
1683676185210,ANBI 133,A00,258401,Wilder; Linnea Lorene,34,0,40,6
1683676186234,ANBI 140,A00,258395,Hrvoj Mihic; Branka,18,0,25,7
1683676187258,ANSC 120,A00,258402,Bialecki; Jon Anthony,26,0,40,14
1683676188283,ANSC 144,A00,258400,Staff,12,0,40,28
1683676190336,ANSC 166,A00,258396,Parish; Steven Martin,156,0,175,19
1683676191363,ANSC 180,A00,193533,Staff,8,0,20,12
1683676192390,ANSC 188,A00,258397,Jassal; Aftab,34,0,40,6
1683676193414,ANTH 3,A01,258316,Staff,23,0,30,7
1683676194438,ANTH 5,A00,258394,Semendeferi; Ekaterini,16,0,20,4
1683676195463,ANTH 21,A01,258331,Staff,4,0,40,36
1683676196488,ANTH 103,A00,258398,Varma; Saiba,15,0,25,10
1683676197513,AWP 10,001,202034,Staff,0,0,0,0
1683676197513,AWP 10,002,202035,Staff,0,0,0,0
1683676197513,AWP 10,003,202036,Staff,0,0,0,0
1683676197513,AWP 10,004,202037,Staff,0,0,0,0
1683676197513,AWP 10,005,202038,Staff,0,0,0,0
1683676197513,AWP 10,006,202039,Staff,0,0,0,0
1683676197513,AWP 10,007,202040,Staff,0,0,0,0
1683676197513,AWP 10,008,202041,Staff,0,0,0,0
1683676197513,AWP 10,009,202042,Staff,0,0,0,0
1683676197513,AWP 10,010,202043,Staff,0,0,0,0
1683676197513,AWP 10,011,202044,Staff,0,0,0,0
1683676197513,AWP 10,012,202045,Staff,0,0,0,0
1683676197513,AWP 10,013,202046,Staff,0,0,0,0
1683676197513,AWP 10,014,202047,Staff,0,0,0,0
1683676197513,AWP 10,015,202048,Staff,0,0,0,0
1683676197513,AWP 10,016,202049,Staff,0,0,0,0
1683676197513,AWP 10,017,202050,Staff,0,0,0,0
1683676197513,AWP 10,018,202051,Staff,0,0,0,0
1683676197513,AWP 10,019,202052,Staff,0,0,0,0
1683676197513,AWP 10,020,202053,Staff,0,0,0,0
1683676197513,AWP 10,021,202054,Staff,0,0,0,0
1683676197513,AWP 10,022,202055,Staff,0,0,0,0
1683676197513,AWP 10,023,202056,Staff,0,0,0,0
1683676197513,AWP 10,024,202057,Staff,0,0,0,0
1683676197513,AWP 10,025,202058,Staff,0,0,0,0
1683676197513,AWP 10,026,202059,Staff,0,0,0,0
1683676198537,AWP 102,001,202032,Staff,0,0,0,0
1683676198537,AWP 102,002,202033,Staff,0,0,0,0
1683676199561,BENG 100,A01,254234,Taylor Amos; Alyssa C,31,0,40,9
1683676200585,BENG 196,001,270013,Engler; Adam J.,9999,0,9999,0
1683676201614,BICD 100R,A01,202018,Smith; Laurie,0,7,32,32
1683676201614,BICD 100R,A02,202019,Smith; Laurie,0,3,32,32
1683676201614,BICD 100R,A03,202020,Smith; Laurie,0,1,32,32
1683676201614,BICD 100R,A04,202021,Smith; Laurie,6,0,32,26
1683676201614,BICD 100R,A05,202022,Smith; Laurie,10,0,32,22
1683676202644,BICD 136,A01,193242,Gustafson-Brown; Cindy,0,2,32,32
1683676202644,BICD 136,A02,193244,Gustafson-Brown; Cindy,13,0,32,19
1683676203672,BIEB 102,A01,193249,Butler; Shannon Rhey,1,1,32,31
1683676203672,BIEB 102,A02,193251,Butler; Shannon Rhey,0,0,32,32
1683676203672,BIEB 102,A03,193253,Butler; Shannon Rhey,0,0,32,32
1683676203672,BIEB 102,A04,193255,Butler; Shannon Rhey,13,0,32,19
1683676203672,BIEB 102,A05,193265,Butler; Shannon Rhey,25,0,32,7
1683676203672,BIEB 102,A06,193269,Butler; Shannon Rhey,13,0,32,19
1683676205721,BIEB 150,A01,193274,Staff,0,0,32,32
1683676205721,BIEB 150,A02,193285,Staff,24,0,32,8
1683676206747,BIEB 194,A00,193286,Kurle; Carolyn M.,19,0,32,13
1683676207777,BILD 1,A01,192291,Staff,15,0,32,17
1683676207777,BILD 1,A02,192292,Staff,30,0,32,2
1683676207777,BILD 1,B01,192520,Reuther; Keefe,0,1,0,0
1683676207777,BILD 1,B02,192532,Reuther; Keefe,0,1,0,0
1683676208809,BILD 3,A01,192556,Butler; Shannon Rhey,0,0,32,32
1683676208809,BILD 3,A02,192581,Butler; Shannon Rhey,0,1,32,32
1683676208809,BILD 3,A03,192611,Butler; Shannon Rhey,19,0,32,13
1683676208809,BILD 3,A04,192612,Butler; Shannon Rhey,24,0,32,8
1683676208809,BILD 3,A05,192613,Butler; Shannon Rhey,26,0,32,6
1683676208809,BILD 3,A06,192679,Butler; Shannon Rhey,27,0,32,5
1683676208809,BILD 3,A07,192682,Butler; Shannon Rhey,20,0,32,12
1683676209833,BILD 4,A01,192836,Reuther; Keefe,1,0,24,23
1683676209833,BILD 4,A02,193044,Reuther; Keefe,4,0,24,20
1683676210858,BILD 10,A01,193142,Gustafson-Brown; Cindy,29,0,32,3
1683676210858,BILD 10,A02,193149,Gustafson-Brown; Cindy,31,0,32,1
1683676211887,BIMM 100,A01,193301,Staff,0,6,32,32
1683676211887,BIMM 100,A02,193312,Staff,0,7,32,32
1683676211887,BIMM 100,A03,193323,Staff,0,10,32,32
1683676212912,BIMM 101,A01,193329,McDonnell; Lisa Marie,1,4,24,23
1683676212912,BIMM 101,A02,193339,McDonnell; Lisa Marie,1,4,24,23
1683676212912,BIMM 101,B01,193354,McDonnell; Lisa Marie,0,4,24,24
1683676212912,BIMM 101,B02,193357,McDonnell; Lisa Marie,0,3,24,24
1683676213937,BIMM 110,A01,193377,Tat; John,0,11,32,32
1683676213937,BIMM 110,A02,193378,Tat; John,0,10,32,32
1683676214963,BIMM 120,A01,206116,Staff,0,0,32,32
1683676214963,BIMM 120,A02,206117,Staff,7,0,32,25
1683676214963,BIMM 120,A03,206121,Staff,21,0,32,11
1683676215989,BIPN 100,A01,193393,Park; Ji Young,0,15,32,32
1683676215989,BIPN 100,A02,193402,Park; Ji Young,0,14,32,32
1683676215989,BIPN 100,A03,193413,Park; Ji Young,0,14,32,32
1683676215989,BIPN 100,A04,193414,Park; Ji Young,0,13,32,32
1683676217013,BIPN 102,A01,193429,Staff,0,0,32,32
1683676217013,BIPN 102,A02,193438,Staff,18,0,32,14
1683676218038,BIPN 106,A01,193450,Reyes Gonzalez; Catalina,0,2,40,40
1683676219067,BIPN 134,A01,193465,Cooke; James Edward,0,0,32,32
1683676219067,BIPN 134,A02,193474,Cooke; James Edward,25,0,32,7
1683676219067,BIPN 134,A03,193485,Cooke; James Edward,29,0,32,3
1683676219067,BIPN 134,A04,193486,Cooke; James Edward,20,0,32,12
1683676219067,BIPN 134,A05,193491,Cooke; James Edward,31,0,32,1
1683676219067,BIPN 134,A06,193501,Cooke; James Edward,30,0,32,2
1683676219067,BIPN 134,A07,193510,Cooke; James Edward,29,0,32,3
1683676221123,BISP 194,A00,222522,Staff,14,0,32,18
1683676222148,CAT 124,A01,202407,Staff,19,0,25,6
1683676223177,CAT 125,A00,202408,Marchisotto; Jennifer Anne,2,0,20,18
1683676224202,CAT 125R,A00,202409,Smith; Lauryn Alissa,0,11,20,20
1683676224202,CAT 125R,B00,202410,Morales; Celeste Georgianna,0,11,20,20
1683676224202,CAT 125R,C00,202411,Irwin; Matthew Joseph,0,12,20,20
1683676225226,CENG 15,A01,204712,Yang; Kesong,0,1,0,0
1683676226251,CENG 114,A00,202070,Jahed Motlagh; Zeinab,5,0,20,15
1683676227274,CGS 105,A00,185477,Wesling; Megan E.,24,0,40,16
1683676228299,CGS 106,A00,185494,Staff,11,0,22,11
1683676229325,CGS 108,A00,185495,Staff,14,0,20,6
1683676230349,CGS 114,A00,185496,Staff,13,0,18,5
1683676231372,CGS 119,A00,185501,Staff,15,0,20,5
1683676232397,CGS 120,A00,185511,Staff,12,0,20,8
1683676233426,CHEM 4,A01,184675,Bussey; Thomas J,97,0,100,3
1683676234453,CHEM 6A,A01,184677,Staff,32,0,60,28
1683676235477,CHEM 6B,A01,184679,Staff,63,0,100,37
1683676236506,CHEM 6C,A01,184681,Bussey; Thomas J,0,0,50,50
1683676236506,CHEM 6C,A02,184682,Bussey; Thomas J,32,0,50,18
1683676237535,CHEM 40A,A01,184684,Albizati; Kim F.,33,0,100,67
1683676238559,CHEM 40B,A01,184686,Albizati; Kim F.,0,22,100,100
1683676239586,CHEM 41B,A01,184690,Staff,51,0,100,49
1683676240615,COGS 3,A01,184715,Boyle; Mary E. T.,0,27,40,40
1683676241642,COGS 14B,A01,185172,Staff,0,14,38,38
1683676242670,COGS 18,A01,184736,Staff,14,0,80,66
1683676243697,COGS 100,A01,184932,Staff,0,8,73,73
1683676244722,COGS 101A,A01,184935,Staff,0,40,30,30
1683676245746,COGS 101B,A01,184944,Staff,0,2,30,30
1683676246771,COGS 101C,A01,184946,Staff,0,10,30,30
1683676247794,COGS 102A,A01,184951,Johnson; Christine M.,2,0,40,38
1683676248821,COGS 107B,A01,184953,Mooshagian; Eric Frederick,0,52,40,40
1683676249850,COGS 118B,A01,184959,Gupta; Anjum,0,50,40,40
1683676250876,COGS 153,A00,184961,Staff,0,16,30,30
1683676251901,COGS 177,A00,184962,Staff,0,21,30,30
1683676252930,COGS 187A,A01,184969,Boyle; Mary E. T.,0,19,40,40
1683676253957,COMM 10,A01,185174,Staff,0,5,25,25
1683676253957,COMM 10,A02,185189,Staff,0,2,25,25
1683676253957,COMM 10,A03,269821,Staff,0,1,0,0
1683676254982,COMM 100B,A01,185475,Staff,0,1,0,1
1683676254982,COMM 100B,A02,185476,Staff,11,0,25,14
1683676256007,COMM 100C,A01,185314,Staff,1,0,25,24
1683676256007,COMM 100C,A02,185327,Staff,17,0,25,8
1683676257030,COMM 110M,A00,185349,Staff,0,0,40,40
1683676258058,COMM 113T,A00,185352,Staff,25,0,40,15
1683676259086,COMM 114I,A00,185353,Staff,31,0,40,9
1683676260111,COMM 131,A00,185354,Staff,17,0,30,13
1683676261135,CSE 8A,A50,185358,Cao; Yingjun,0,46,10,10
1683676262165,CSE 8B,A01,185362,Staff,0,48,50,50
1683676263190,CSE 11,A01,185416,Cao; Yingjun,0,91,10,10
1683676264217,CSE 20,A01,185445,Briones; Jor-el Thomas Caparas,3,0,25,22
1683676265244,CSE 21,A01,185447,Staff,9,0,50,41
1683676266272,CSE 101,A01,185451,Staff,0,13,50,50
1683676266272,CSE 101,B01,185453,Jones; Miles E,0,14,50,50
1683676268322,CSE 141,A01,185458,Eldon; John,16,0,100,84
1683676269346,CSE 141L,A01,185461,Eldon; John,8,0,100,92
1683676270373,CSE 142,A01,185463,Staff,34,0,60,26
1683676270373,CSE 142,B01,201355,Staff,0,7,60,60
1683676271397,CSE 142L,A01,185470,Staff,34,0,60,26
1683676271397,CSE 142L,B01,201417,Staff,0,6,60,60
1683676272421,CSE 190,A00,201433,Staff,32,0,49,17
1683676273444,DOC 1,A01,259136,Strom; Megan C.,7,0,15,8
1683676273444,DOC 1,A02,259137,Strom; Megan C.,14,0,15,1
1683676273444,DOC 1,A03,259138,Strom; Megan C.,14,0,15,1
1683676273444,DOC 1,A04,259139,Strom; Megan C.,14,0,15,1
1683676274527,DOC 100D,A00,259140,Pass; Natalye Joann,14,0,25,11
1683676275555,DSGN 1,A01,184749,Rill; Bryan,0,26,30,30
1683676276579,DSGN 100,A01,185168,Staff,0,2,25,25
1683676277609,ECE 5,A01,185626,Morris; Karcher William,0,12,0,0
1683676278635,ECE 101,A01,185628,Staff,14,0,70,56
1683676279661,ECE 107,A01,185635,Baghdadchi; Saharnaz,0,0,20,20
1683676279661,ECE 107,A02,185638,Baghdadchi; Saharnaz,1,0,20,19
1683676280685,ECE 148,A01,185647,Silberman; Jack,0,0,16,16
1683676281709,ECON 1,A01,185537,Crane; Meredith Helen,54,0,70,16
1683676282738,ECON 3,A01,185549,Crane; Meredith Helen,29,0,70,41
1683676283762,ECON 4,A01,203354,Anderson; John Charles,0,5,10,10
1683676284788,ECON 100A,A01,185574,Staff,0,5,40,40
1683676285812,ECON 100B,A01,185576,Staff,0,12,50,50
1683676286840,ECON 100C,A01,185589,Newhouse; Herbert S,30,0,70,40
1683676287864,ECON 105,A00,185608,Vespa; Emanuel Ignacio,19,0,35,16
1683676288889,ECON 109,A01,185610,Shishkin; Denis,9,0,35,26
1683676289914,ECON 110A,A01,185612,Staff,9,0,40,31
1683676290938,ECON 120A,A01,185615,Staff,19,0,40,21
1683676291964,ECON 120C,A01,185617,Sun; Yixiao,0,21,70,70
1683676292990,ECON 144,A00,203346,Squires; Dale E,1,0,35,34
1683676294021,ECON 171,A01,203349,Newhouse; Herbert S,0,1,35,35
1683676295046,ECON 173A,A01,185621,Toda; Alexis Akira,21,0,35,14
1683676296071,EDS 25,A01,202413,Staff,0,1,0,0
1683676296071,EDS 25,A02,202414,Staff,0,1,0,0
1683676296071,EDS 25,A03,202415,Staff,0,0,0,0
1683676296071,EDS 25,A04,202416,Staff,0,1,0,0
1683676296071,EDS 25,A05,202439,Staff,0,0,0,0
1683676296071,EDS 25,A06,202440,Staff,0,0,0,0
1683676296071,EDS 25,B01,202631,Staff,0,0,0,0
1683676296071,EDS 25,B02,202632,Staff,0,0,0,0
1683676296071,EDS 25,B03,202639,Staff,0,0,0,0
1683676296071,EDS 25,B04,202640,Staff,0,0,0,0
1683676296071,EDS 25,B05,202643,Staff,0,0,0,0
1683676296071,EDS 25,B06,202644,Staff,0,0,0,0
1683676297097,EDS 38,A01,202659,Black; Alison Michelle,24,0,25,1
1683676298123,EDS 115,A00,202652,Staff,18,0,30,12
1683676299147,EDS 125,A00,202649,Staff,13,0,30,17
1683676300172,EDS 126,A01,203332,Staff,30,0,30,0
1683676301199,EDS 139,A00,202838,Staff,16,0,25,9
1683676302223,EDS 146,A01,202655,Staff,14,0,25,11
1683676303246,ENG 15,A00,185667,Staff,0,1,0,0
1683676303246,ENG 15,B00,185672,Staff,0,0,0,0
1683676303246,ENG 15,C00,185675,Staff,0,0,0,0
1683676303246,ENG 15,D00,185682,Staff,0,0,0,0
1683676303246,ENG 15,E00,185684,Staff,0,0,0,0
1683676304272,ETHN 103,A00,185710,Staff,0,8,35,35
1683676305297,ETHN 103A,A00,199228,Man; Simeon S,0,0,9,9
1683676306320,ETHN 109,A00,185711,Staff,15,0,35,20
1683676307347,ETHN 142,A00,185726,Staff,0,4,30,30
1683676308374,ETHN 163J,A00,199229,Man; Simeon S,5,0,8,3
1683676309398,ETHN 168,A00,185727,Staff,7,0,10,3
1683676310422,ETHN 182,A00,185728,Staff,0,0,35,35
1683676311447,ETHN 183,A00,185737,Staff,9,0,18,9
1683676312474,GLBH 111,A01,209361,Burgos; Jose L.,0,0,0,0
1683676314522,HIEU 104,A00,185792,Staff,14,0,20,6
1683676315547,HIEU 115,A00,185800,Staff,0,0,20,20
1683676316574,HIEU 128,A00,185801,Staff,0,9,20,20
1683676317597,HIEU 147,A00,185802,Staff,15,0,20,5
1683676318622,HIEU 154,A00,185823,Staff,11,0,20,9
1683676319649,HILA 102,A00,185826,Staff,14,0,20,6
1683676320672,HILD 2C,A01,185778,Staff,0,13,20,20
1683676321700,HILD 7B,A01,185780,Kwak; Nancy,0,17,32,32
1683676321700,HILD 7B,A02,185781,Kwak; Nancy,0,18,32,32
1683676322725,HILD 30,A01,185791,Staff,12,0,20,8
1683676323752,HISC 119,A00,185830,Golan; Tal,0,9,20,20
1683676324776,HITO 156GS,A00,185831,Patterson; Patrick H.,0,0,0,23
1683676325803,HIUS 103,A00,185832,Man; Simeon S,0,4,20,20
1683676326831,HIUS 117,A00,185836,Kwak; Nancy,2,0,20,18
1683676327857,HIUS 125,A00,185840,Man; Simeon S,0,2,23,23
1683676328884,HIUS 149,A00,185845,Staff,1,0,20,19
1683676329910,HUM 3,A01,185882,Zavodny; Tatiana Sophia,0,8,50,50
1683676329910,HUM 3,B01,185899,Caldwell; Michael Alan,0,18,50,50
1683676330934,HUM 3GS,A00,185900,Patterson; Patrick H.,0,0,0,23
1683676331959,HUM 4,A01,185938,Zroka; Amy Liane,28,0,50,22
1683676331959,HUM 4,B01,185956,Watkins; Eric,0,5,50,50
1683676331959,HUM 4,B02,202209,Watkins; Eric,0,5,50,50
1683676331959,HUM 4,B03,202210,Watkins; Eric,0,5,50,50
1683676332984,HUM 5,A01,185958,West; Geoffrey Scott,0,0,50,50
1683676332984,HUM 5,A02,202215,West; Geoffrey Scott,0,0,50,50
1683676334011,INTL 190,A00,185959,Gagnon; Jeffrey C,0,0,0,9
1683676334011,INTL 190,B00,185960,Lettieri; Michael Joseph,0,0,0,2
1683676335035,JAPN 180,A00,254509,Staff,5,0,30,25
1683676336059,LATI 10,A01,202853,Kennemore; Amy Michelle,4,0,35,31
1683676336059,LATI 10,A02,202854,Kennemore; Amy Michelle,3,0,35,32
1683676336059,LATI 10,A03,270054,Kennemore; Amy Michelle,30,0,30,0
1683676337086,LATI 180,A00,202855,Kennemore; Amy Michelle,11,0,20,9
1683676338111,LAWS 101,A00,201767,Golan; Tal,0,7,40,40
1683676339137,LIFR 1C,A00,185961,Staff,6,0,20,14
1683676340165,LIFR 1CX,A00,185962,Staff,7,0,20,13
1683676341189,LIFR 1D,A00,185963,Staff,7,0,20,13
1683676342213,LIFR 1DX,A00,185964,Staff,7,0,20,13
1683676343237,LIGN 101,A01,186039,Staff,43,0,50,7
1683676344264,LIGN 165,A00,186040,Staff,15,0,50,35
1683676345288,LTCS 108,A00,186041,Staff,5,0,10,5
1683676346312,LTCS 119,A00,186042,Staff,15,0,20,5
1683676347338,LTCS 130,A00,186043,Wesling; Megan E.,15,0,25,10
1683676349386,LTEA 138,A00,186119,Staff,14,0,40,26
1683676350409,LTEN 124,A00,186148,Staff,5,0,25,20
1683676351435,LTEN 178,A00,186149,Staff,7,0,15,8
1683676352460,LTEN 181,A00,186150,Blanco; John D,34,0,40,6
1683676353484,LTWL 120,A00,186160,Staff,19,0,25,6
1683676354513,LTWL 165,A00,186161,Staff,22,0,25,3
1683676355541,LTWR 100,A00,186162,Staff,0,5,15,15
1683676356567,LTWR 102,A00,186163,Doller; Ben,5,0,15,10
1683676357594,MAE 8,A01,186412,Staff,0,1,0,0
1683676358618,MAE 30B,A00,186445,Bahadori; Mohammad Yousef,82,0,100,18
1683676359641,MAE 40,A00,186592,Bewley; Thomas R,10,0,50,40
1683676360666,MAE 101B,A00,186593,Bahadori; Mohammad Yousef,80,0,100,20
1683676361694,MAE 105,A00,186594,Bandaru; Prabhakar,10,0,50,40
1683676362719,MAE 107,A00,186599,Pham; Hieu Tan,0,7,120,120
1683676363743,MAE 148,A01,186660,Silberman; Jack,3,0,16,13
1683676364768,MATH 10A,A01,188095,Staff,0,6,35,35
1683676365798,MATH 10B,A01,188097,Bowers; Adam R.,0,12,30,30
1683676365798,MATH 10B,A02,188099,Bowers; Adam R.,0,11,30,30
1683676365798,MATH 10B,B01,188104,Bowers; Adam R.,0,10,30,30
1683676365798,MATH 10B,B02,188106,Bowers; Adam R.,1,9,30,29
1683676366863,MATH 10C,A01,188111,Staff,0,20,30,30
1683676366863,MATH 10C,A02,188127,Staff,0,19,30,30
1683676366863,MATH 10C,A03,188131,Staff,0,19,30,30
1683676366863,MATH 10C,B01,188218,Staff,17,0,30,13
1683676366863,MATH 10C,B02,188244,Staff,13,0,30,17
1683676366863,MATH 10C,B03,188277,Staff,14,0,30,16
1683676367888,MATH 18,A01,188344,Bach; Quang Tran,18,0,30,12
1683676367888,MATH 18,A02,188345,Bach; Quang Tran,11,0,30,19
1683676367888,MATH 18,B01,188353,Bach; Quang Tran,11,0,30,19
1683676367888,MATH 18,B02,188354,Bach; Quang Tran,19,0,30,11
1683676368913,MATH 20A,A01,188374,Staff,11,0,35,24
1683676369938,MATH 20B,A01,188382,Ohm; Ko Woon,7,0,30,23
1683676369938,MATH 20B,A02,188383,Ohm; Ko Woon,22,0,30,8
1683676369938,MATH 20B,B01,188385,Ohm; Ko Woon,7,0,30,23
1683676369938,MATH 20B,B02,188392,Ohm; Ko Woon,22,0,30,8
1683676370967,MATH 20C,A01,188394,Harel; Guershon,10,0,30,20
1683676370967,MATH 20C,A02,188395,Harel; Guershon,13,0,30,17
1683676370967,MATH 20C,B01,188404,Harel; Guershon,5,0,30,25
1683676370967,MATH 20C,B02,188405,Harel; Guershon,18,0,30,12
1683676371997,MATH 20D,A01,188414,Hammock; Frances H,0,1,30,30
1683676371997,MATH 20D,A02,188415,Hammock; Frances H,0,1,30,30
1683676371997,MATH 20D,B01,188447,Hammock; Frances H,0,1,30,30
1683676371997,MATH 20D,B02,188486,Hammock; Frances H,3,0,30,27
1683676373022,MATH 20E,A01,188649,Staff,21,0,30,9
1683676373022,MATH 20E,A02,188650,Staff,20,0,30,10
1683676373022,MATH 20E,A03,188673,Staff,0,0,30,30
1683676374046,MATH 102,A01,188675,Staff,0,39,35,35
1683676375074,MATH 103B,A01,188681,Staff,3,0,35,32
1683676375074,MATH 103B,B01,188692,Staff,5,0,35,30
1683676376102,MATH 109,A01,188695,Salehi Golsefidy; Alireza,24,0,35,11
1683676376102,MATH 109,A02,188696,Salehi Golsefidy; Alireza,25,0,35,10
1683676377127,MATH 120A,A01,188698,Eggers; John Dietrich,7,0,35,28
1683676378210,MATH 142B,A01,188736,Ioana; Adrian,1,1,30,29
1683676378210,MATH 142B,A02,188741,Ioana; Adrian,0,1,30,30
1683676378210,MATH 142B,A03,188743,Ioana; Adrian,0,1,30,30
1683676379239,MATH 168A,A01,188790,Staff,0,11,35,35
1683676380263,MATH 170A,A01,188803,Nie; Jiawang,0,2,35,35
1683676380263,MATH 170A,A02,188811,Nie; Jiawang,0,1,35,35
1683676380263,MATH 170A,A03,188814,Nie; Jiawang,0,0,35,35
1683676380263,MATH 170A,A04,188815,Nie; Jiawang,5,0,35,30
1683676381288,MATH 193B,A01,188817,Staff,0,0,35,35
1683676381288,MATH 193B,A02,188818,Staff,5,0,35,30
1683676382313,MGT 4,A01,202857,Anderson; John Charles,60,0,80,20
1683676383336,MGT 12,A00,202858,Lindenberger; Wade Douglas,40,0,90,50
1683676384360,MGT 18,A00,202859,Staff,74,0,90,16
1683676385384,MGT 18GS,A00,202860,McKay; Michael J,13,0,28,15
1683676386411,MGT 45,A00,202861,Pecore; Joseph P.,10,0,90,80
1683676387435,MGT 100,A00,202863,Yavorsky; Daniel Ryan,28,0,90,62
1683676388467,MGT 103,A00,202864,Ehrich; Kristine R,0,18,90,90
1683676389495,MGT 112,A00,202865,Ehrich; Kristine R,15,0,90,75
1683676390520,MGT 121A,A00,202868,Staff,90,20,90,0
1683676391545,MGT 131B,A00,202869,Anderson; John Charles,59,0,90,31
1683676392570,MGT 136,A00,202871,Lindenberger; Wade Douglas,83,0,90,7
1683676393594,MGT 164,A00,202873,Staff,0,67,90,91
1683676394623,MGT 164GS,A00,202874,McKay; Mary A,13,0,28,15
1683676395647,MGT 180,A00,202875,Staff,0,51,90,91
1683676396670,MMW 11R,A01,205019,Herbst; Matthew,0,0,30,30
1683676396670,MMW 11R,A02,205026,Herbst; Matthew,29,0,30,1
1683676397694,MMW 15,A01,193512,Chang; Edmond Yi-Teh,0,8,28,28
1683676397694,MMW 15,A02,193513,Chang; Edmond Yi-Teh,0,5,28,28
1683676397694,MMW 15,A03,193514,Chang; Edmond Yi-Teh,0,5,28,28
1683676397694,MMW 15,A04,193515,Chang; Edmond Yi-Teh,0,5,28,28
1683676397694,MMW 15,A05,193516,Chang; Edmond Yi-Teh,0,5,28,28
1683676397694,MMW 15,A06,193517,Chang; Edmond Yi-Teh,0,6,28,28
1683676397694,MMW 15,B01,193519,Chang; Edmond Yi-Teh,0,5,28,28
1683676397694,MMW 15,B02,193520,Chang; Edmond Yi-Teh,0,5,28,28
1683676397694,MMW 15,B03,193521,Chang; Edmond Yi-Teh,0,5,28,28
1683676397694,MMW 15,B04,193522,Chang; Edmond Yi-Teh,0,5,28,28
1683676397694,MMW 15,B05,193523,Chang; Edmond Yi-Teh,0,5,28,28
1683676397694,MMW 15,B06,193524,Chang; Edmond Yi-Teh,0,5,28,28
1683676398719,MMW 122,A01,193526,Rahimi; Babak,0,16,28,28
1683676398719,MMW 122,A02,193527,Rahimi; Babak,0,15,28,28
1683676398719,MMW 122,A03,193528,Rahimi; Babak,0,0,0,0
1683676398719,MMW 122,A04,193529,Rahimi; Babak,0,0,0,0
1683676399746,MUS 1A,A01,186663,Staff,1,19,35,34
1683676400771,MUS 4,A01,186715,Staff,0,12,35,35
1683676401801,MUS 5R,A01,186796,Dubnov; Shlomo,0,17,35,35
1683676402829,MUS 6,A01,186798,Staff,0,5,25,25
1683676403861,MUS 7,A01,186830,Staff,11,0,35,24
1683676404889,MUS 8,A01,186930,Staff,0,27,35,35
1683676405915,MUS 15,A01,186932,Staff,0,15,35,35
1683676405915,MUS 15,B01,186934,Staff,1,17,35,34
1683676406940,MUS 80,A00,186935,Staff,0,0,20,20
1683676406940,MUS 80,B00,186936,Staff,24,0,25,1
1683676407964,NANO 11,A00,204702,Lipomi; Darren John,0,0,0,0
1683676408988,NANO 15,A01,204709,Yang; Kesong,0,1,0,0
1683676410013,NANO 114,A00,202069,Jahed Motlagh; Zeinab,3,0,10,7
1683676411041,PHIL 1,A00,186955,Grush; Rick Scott,31,0,40,9
1683676412066,PHIL 10,A01,186973,Grush; Rick Scott,27,0,35,8
1683676412066,PHIL 10,A02,186974,Grush; Rick Scott,33,0,35,2
1683676413093,PHIL 13,A01,186976,Staff,3,0,35,32
1683676413093,PHIL 13,A02,186977,Staff,16,0,35,19
1683676414118,PHIL 14,A01,186979,Staff,31,0,35,4
1683676414118,PHIL 14,A02,186986,Staff,32,0,35,3
1683676415143,PHIL 28,A01,186988,Staff,16,0,30,14
1683676415143,PHIL 28,A02,186989,Staff,1,0,30,29
1683676415143,PHIL 28,A03,186990,Staff,10,0,30,20
1683676415143,PHIL 28,A04,186991,Staff,26,0,30,4
1683676416167,PHIL 120,A00,186997,Staff,23,0,40,17
1683676417191,PHIL 137,A00,187003,Staff,7,0,40,33
1683676418216,PHIL 150,A00,187015,Staff,47,0,70,23
1683676419239,PHIL 167,A00,187021,Lamey; Andy M.,34,0,40,6
1683676420265,PHIL 174,A01,202226,Staff,17,0,20,3
1683676420265,PHIL 174,A02,202235,Staff,20,0,20,0
1683676421291,PHIL 191A,A00,258918,Staff,0,0,1,1
1683676422319,PHYS 1A,A00,187028,Staff,26,0,60,34
1683676423348,PHYS 1AL,001,187036,Staff,3,0,30,27
1683676423348,PHYS 1AL,002,187049,Staff,18,0,30,12
1683676424372,PHYS 1B,A00,187058,Staff,22,0,60,38
1683676425399,PHYS 1BL,001,187064,Staff,0,1,30,30
1683676425399,PHYS 1BL,002,187070,Staff,4,0,30,26
1683676426421,PHYS 1C,A00,187082,Staff,29,0,120,91
1683676427449,PHYS 1CL,001,187088,Staff,0,9,30,30
1683676427449,PHYS 1CL,002,187089,Staff,0,1,30,30
1683676427449,PHYS 1CL,009,262693,Staff,9,0,30,21
1683676428475,PHYS 2B,A01,187097,Staff,55,0,115,60
1683676429502,PHYS 2C,A01,187099,Staff,63,0,115,52
1683676430531,PHYS 2CL,A01,187101,Staff,5,0,28,23
1683676430531,PHYS 2CL,A02,187102,Staff,15,0,28,13
1683676431558,PHYS 2D,A01,187123,Shotwell; Brian,95,0,115,20
1683676432583,PHYS 4B,A01,187133,Grinstein; Benjamin,35,0,50,15
1683676433610,POLI 10,A00,188819,Staff,0,4,50,50
1683676434635,POLI 11,A00,188827,Staff,43,0,50,7
1683676435660,POLI 13R,A00,188828,Staff,0,1,20,20
1683676436686,POLI 27,A01,188830,Elgin; Samuel Zincke,0,2,70,70
1683676437713,POLI 30,A00,188832,Desposato; Scott,30,0,50,20
1683676438739,POLI 102F,A00,188834,Staff,0,0,40,40
1683676439763,POLI 104A,A00,188852,Staff,12,0,30,18
1683676440788,POLI 104I,A00,188853,Staff,0,8,20,20
1683676441816,POLI 110B,A00,188854,Wiens; David,6,0,20,14
1683676442844,POLI 112A,A00,188855,Wiens; David,3,0,30,27
1683676443867,POLI 117R,A00,188856,Forman; Fonna,0,12,20,20
1683676444894,POLI 118,A00,188857,Ingham; Sean,8,0,20,12
1683676445919,POLI 120G,A00,188858,Staff,8,0,30,22
1683676446943,POLI 131CR,A00,188863,Hoston; Germaine,20,0,50,30
1683676447971,POLI 133,A00,188864,Nellis; Gareth Hb,44,0,50,6
1683676448998,POLI 134D,A00,188865,Desposato; Scott,27,0,30,3
1683676450026,POLI 142A,A00,188871,Gartzke; Erik,21,0,50,29
1683676451049,POLI 142K,A00,188874,Staff,38,0,50,12
1683676452076,POLI 143,A00,188940,Gartzke; Erik,16,0,30,14
1683676453100,POLI 153,A00,188943,Staff,2,0,20,18
1683676454124,POLI 160AA,A00,188944,Staff,10,0,40,30
1683676455148,POLI 170A,A00,188945,Staff,10,0,30,20
1683676457197,PSYC 1,A00,188952,Staff,37,0,90,53
1683676458225,PSYC 2,B00,188953,Staff,19,0,35,16
1683676459249,PSYC 6,A00,188970,Staff,47,0,60,13
1683676460276,PSYC 7,A00,188973,Staff,35,0,45,10
1683676461300,PSYC 60,A01,188980,Rickard; Timothy C.,42,0,60,18
1683676462327,PSYC 70,A01,189001,Steiner; Eric Tomas,21,0,45,24
1683676463353,PSYC 100,A00,189005,Lacefield; Katharine I,0,100,120,120
1683676464380,PSYC 102,A00,189008,Staff,7,0,30,23
1683676465406,PSYC 106,B00,189026,Gorman; Michael R.,27,0,60,33
1683676466436,PSYC 114,B01,189033,Winkielman; Piotr,0,31,30,30
1683676467459,PSYC 131,A00,189036,Anagnostaras; Stephan,0,43,60,60
1683676468483,PSYC 136,A00,189041,Lowe; Angela Beth,0,7,25,25
1683676469507,PSYC 137,A00,189057,Winkielman; Piotr,1,37,25,24
1683676470531,PSYC 144,A00,189107,Wixted; John T,0,11,50,50
1683676472580,PSYC 162,A00,189142,Staff,0,9,85,85
1683676473603,PSYC 172,A00,189144,Gorman; Michael R.,0,6,30,30
1683676475654,PSYC 179,A00,189146,Lacefield; Katharine I,0,87,120,120
1683676476678,PSYC 181,A00,189147,Anagnostaras; Stephan,0,45,90,90
1683676477704,PSYC 190R,A00,189148,Barner; David A.,0,23,80,80
1683676478732,PSYC 191,A00,189275,Rickard; Timothy C.,0,10,25,25
1683676479756,PSYC 193,A00,189276,Chapman; Eddie Nathaniel,0,1,0,4
1683676480787,PSYC 193L,A01,189281,Lowe; Angela Beth,8,0,20,12
1683676480787,PSYC 193L,B01,189285,Staff,28,0,35,7
1683676481866,RELI 149,A00,187137,Rahimi; Babak,7,0,40,33
1683676482895,SE 9,A01,187315,Staff,0,2,18,18
1683676483922,SE 101B,A00,187409,Staff,24,0,30,6
1683676484949,SE 110B,A00,187444,Staff,10,0,40,30
1683676485976,SE 130B,A00,187449,Staff,31,0,40,9
1683676487003,SE 150A,A00,187516,Staff,8,0,20,12
1683676488027,SE 154,A00,187528,Staff,29,0,50,21
1683676489054,SIO 3,A01,258171,Staff,35,0,40,5
1683676490080,SIO 10,A00,187144,Cook; Geoffrey W,1,7,75,74
1683676491107,SIO 45,A00,187152,Cook; Geoffrey W,0,7,100,100
1683676492130,SIO 109R,A00,194486,Staff,0,4,20,20
1683676494178,SIO 187,A01,187233,Kacev; David,12,0,40,28
1683676495204,SOCI 1,A01,258656,Thorpe; Charles Robert,28,0,30,2
1683676495204,SOCI 1,A02,258658,Thorpe; Charles Robert,30,0,30,0
1683676495204,SOCI 1,A03,258661,Thorpe; Charles Robert,25,0,25,0
1683676495204,SOCI 1,A04,258666,Thorpe; Charles Robert,22,0,25,3
1683676495204,SOCI 1,A05,258897,Thorpe; Charles Robert,22,0,25,3
1683676495204,SOCI 1,A06,258898,Thorpe; Charles Robert,25,0,25,0
1683676496228,SOCI 30,A01,258903,Pardo Guerra; Juan Pablo,14,0,30,16
1683676497252,SOCI 102,A00,258904,Staff,9,0,25,16
1683676498278,SOCI 106,A00,258905,Staff,19,0,25,6
1683676499303,SOCI 111,A00,258907,Ribas Norris; Janet Vanesa,26,0,30,4
1683676500331,SOCI 121R,A00,258908,Pardo Guerra; Juan Pablo,8,0,30,22
1683676501368,SOCI 126,A01,203330,Staff,14,0,20,6
1683676502396,SOCI 131,A00,258909,Thorpe; Charles Robert,30,0,60,30
1683676503421,SOCI 135,A00,258910,Payne; Christine Anna,0,12,30,30
1683676504451,SOCI 157,A00,258911,Staff,11,0,30,19
1683676505475,SOCI 184,A00,258912,Staff,25,0,30,5
1683676506501,SOCI 188D,A00,258913,Staff,22,0,30,8
1683676507527,SYN 2,001,187529,Staff,9,0,16,7
1683676507527,SYN 2,002,201452,Staff,1,20,16,15
1683676507527,SYN 2,003,201469,Staff,1,0,16,15
1683676508552,SYN 100,A01,187531,Staff,0,9,20,20
1683676508552,SYN 100,B01,201491,Staff,0,10,20,20
1683676509576,TDAC 1,A00,189286,Walsh; Kim C.,3,0,20,17
1683676509576,TDAC 1,B00,189287,Harting; Carla Kelso,10,0,20,10
1683676510600,TDAC 101,A00,189300,Walsh; Kim C.,16,0,20,4
1683676510600,TDAC 101,B00,189301,Harting; Carla Kelso,18,0,20,2
1683676511624,TDAC 102,A00,189304,Basso; Beatrice,14,0,20,6
1683676512650,TDAC 108,A00,189305,Staff,18,0,20,2
1683676513674,TDDE 131,A00,189310,Staff,19,0,20,1
1683676513674,TDDE 131,B00,189314,Staff,19,0,20,1
1683676513674,TDDE 131,C00,189315,Staff,48,0,50,2
1683676513674,TDDE 131,D00,189316,Staff,14,0,15,1
1683676513674,TDDE 131,E00,204841,Staff,20,0,20,0
1683676514701,TDGE 10,A00,189289,Staff,27,0,50,23
1683676514701,TDGE 10,B00,189290,Havis; Allan,0,1,50,50
1683676515726,TDGE 11,A00,189291,Fulton; Julia,0,4,50,50
1683676515726,TDGE 11,B00,189292,Staff,20,0,25,5
1683676515726,TDGE 11,C00,260270,Staff,0,0,0,0
1683676516752,TDGE 25,A00,189294,Staff,1,0,20,19
1683676517778,TDGE 124,A00,189318,Fulton; Julia,0,8,50,50
1683676518802,TDGE 125,A00,189319,Staff,13,0,25,12
1683676518802,TDGE 125,B00,189320,Staff,23,0,25,2
1683676519826,TDGE 127,A00,189322,Havis; Allan,0,0,50,50
1683676520853,TDHT 101,A00,189323,Staff,18,0,25,7
1683676520853,TDHT 101,B00,189324,Staff,25,0,25,0
1683676521880,TDHT 102,A00,189325,Staff,49,0,50,1
1683676522910,TDMV 1,A00,189295,Arcidiacono; Kristin,20,0,30,10
1683676522910,TDMV 1,B00,189296,Caligagan; Maria T.,24,0,30,6
1683676523935,TDMV 2,A00,189297,Sammartano; Tonnie,27,0,30,3
1683676523935,TDMV 2,B00,189299,Arcidiacono; Kristin,23,0,30,7
1683676524959,TDMV 3,A00,204998,Rincon; Alicia,22,0,30,8
1683676525983,TDMV 120,A00,189458,Sammartano; Tonnie,28,0,30,2
1683676527010,TDMV 138,A00,189541,Jun; Grace Shin Hae,20,0,40,20
1683676528037,TDMV 142,A00,189717,Caligagan; Tony,25,0,30,5
1683676528037,TDMV 142,B00,189718,Caligagan; Maria T.,25,0,30,5
1683676529063,TMC 2,A01,187533,Staff,25,0,25,0
1683676529063,TMC 2,A02,187534,Staff,25,0,25,0
1683676530087,USP 1,A01,187536,Kwak; Nancy,0,16,25,25
1683676531111,USP 5,A01,187538,Staff,8,0,25,17
1683676532135,USP 101,A00,199253,Staff,0,4,0,0
1683676533159,USP 124,A00,187562,Boomhower; Matthew Charles,0,0,30,30
1683676534183,USP 138,A00,187582,Staff,19,0,25,6
1683676535218,USP 152,A01,187597,Staff,3,0,25,22
1683676536244,USP 153,A00,187598,Staff,19,0,25,6
1683676537270,USP 168,A00,187607,Kwak; Nancy,2,0,5,3
1683676538294,USP 173,A00,187619,Staff,4,0,25,21
1683676539318,USP 181,A00,187638,Staff,0,4,25,25
1683676540344,VIS 103,A00,187650,Cruz; Edwin Teddy,17,0,75,58
1683676541370,VIS 110D,A00,187669,Staff,13,0,22,9
1683676542397,VIS 127C,A00,187720,Shen; Kuiyi,67,0,146,79
1683676543421,VIS 149,A00,187731,Yoldas; Pinar,1,14,22,21
1683676544445,VIS 151,A01,188091,Staff,22,0,34,12
1683676544445,VIS 151,A02,188092,Staff,11,0,34,23
1683676545473,VIS 160B,A00,188093,Stalbaum; Brett,0,1,10,10
1683676547522,WCWP 10B,A00,201720,Staff,0,0,5,5
1683676547522,WCWP 10B,B00,201722,Staff,0,0,6,6
1683676548547,WCWP 100,A00,201725,Gagnon; Jeffrey C,0,0,2,2
1683676548547,WCWP 100,B00,201727,Staff,0,4,15,15
1683676551638,ANBI 133,A00,258401,Wilder; Linnea Lorene,34,0,40,6
1683676552665,ANBI 140,A00,258395,Hrvoj Mihic; Branka,18,0,25,7
1683676553692,ANSC 120,A00,258402,Bialecki; Jon Anthony,26,0,40,14
1683676554720,ANSC 144,A00,258400,Staff,12,0,40,28
1683676556794,ANSC 166,A00,258396,Parish; Steven Martin,156,0,175,19
1683676557820,ANSC 180,A00,193533,Staff,8,0,20,12
1683676558848,ANSC 188,A00,258397,Jassal; Aftab,34,0,40,6
1683676559876,ANTH 3,A01,258316,Staff,23,0,30,7
1683676560901,ANTH 5,A00,258394,Semendeferi; Ekaterini,16,0,20,4
1683676561926,ANTH 21,A01,258331,Staff,4,0,40,36
1683676562950,ANTH 103,A00,258398,Varma; Saiba,15,0,25,10
1683676563983,AWP 10,001,202034,Staff,0,0,0,0
1683676563983,AWP 10,002,202035,Staff,0,0,0,0
1683676563983,AWP 10,003,202036,Staff,0,0,0,0
1683676563983,AWP 10,004,202037,Staff,0,0,0,0
1683676563983,AWP 10,005,202038,Staff,0,0,0,0
1683676563983,AWP 10,006,202039,Staff,0,0,0,0
1683676563983,AWP 10,007,202040,Staff,0,0,0,0
1683676563983,AWP 10,008,202041,Staff,0,0,0,0
1683676563983,AWP 10,009,202042,Staff,0,0,0,0
1683676563983,AWP 10,010,202043,Staff,0,0,0,0
1683676563983,AWP 10,011,202044,Staff,0,0,0,0
1683676563983,AWP 10,012,202045,Staff,0,0,0,0
1683676563983,AWP 10,013,202046,Staff,0,0,0,0
1683676563983,AWP 10,014,202047,Staff,0,0,0,0
1683676563983,AWP 10,015,202048,Staff,0,0,0,0
1683676563983,AWP 10,016,202049,Staff,0,0,0,0
1683676563983,AWP 10,017,202050,Staff,0,0,0,0
1683676563983,AWP 10,018,202051,Staff,0,0,0,0
1683676563983,AWP 10,019,202052,Staff,0,0,0,0
1683676563983,AWP 10,020,202053,Staff,0,0,0,0
1683676563983,AWP 10,021,202054,Staff,0,0,0,0
1683676563983,AWP 10,022,202055,Staff,0,0,0,0
1683676563983,AWP 10,023,202056,Staff,0,0,0,0
1683676563983,AWP 10,024,202057,Staff,0,0,0,0
1683676563983,AWP 10,025,202058,Staff,0,0,0,0
1683676563983,AWP 10,026,202059,Staff,0,0,0,0
1683676565007,AWP 102,001,202032,Staff,0,0,0,0
1683676565007,AWP 102,002,202033,Staff,0,0,0,0
1683676566031,BENG 100,A01,254234,Taylor Amos; Alyssa C,31,0,40,9
1683676567055,BENG 196,001,270013,Engler; Adam J.,9999,0,9999,0
1683676568081,BICD 100R,A01,202018,Smith; Laurie,0,7,32,32
1683676568081,BICD 100R,A02,202019,Smith; Laurie,0,3,32,32
1683676568081,BICD 100R,A03,202020,Smith; Laurie,0,1,32,32
1683676568081,BICD 100R,A04,202021,Smith; Laurie,6,0,32,26
1683676568081,BICD 100R,A05,202022,Smith; Laurie,10,0,32,22
1683676569110,BICD 136,A01,193242,Gustafson-Brown; Cindy,0,2,32,32
1683676569110,BICD 136,A02,193244,Gustafson-Brown; Cindy,13,0,32,19
1683676570141,BIEB 102,A01,193249,Butler; Shannon Rhey,1,1,32,31
1683676570141,BIEB 102,A02,193251,Butler; Shannon Rhey,0,0,32,32
1683676570141,BIEB 102,A03,193253,Butler; Shannon Rhey,0,0,32,32
1683676570141,BIEB 102,A04,193255,Butler; Shannon Rhey,13,0,32,19
1683676570141,BIEB 102,A05,193265,Butler; Shannon Rhey,25,0,32,7
1683676570141,BIEB 102,A06,193269,Butler; Shannon Rhey,13,0,32,19
1683676572194,BIEB 150,A01,193274,Staff,0,0,32,32
1683676572194,BIEB 150,A02,193285,Staff,24,0,32,8
1683676573221,BIEB 194,A00,193286,Kurle; Carolyn M.,19,0,32,13
1683676574247,BILD 1,A01,192291,Staff,15,0,32,17
1683676574247,BILD 1,A02,192292,Staff,30,0,32,2
1683676574247,BILD 1,B01,192520,Reuther; Keefe,0,1,0,0
1683676574247,BILD 1,B02,192532,Reuther; Keefe,0,1,0,0
1683676575273,BILD 3,A01,192556,Butler; Shannon Rhey,0,0,32,32
1683676575273,BILD 3,A02,192581,Butler; Shannon Rhey,0,1,32,32
1683676575273,BILD 3,A03,192611,Butler; Shannon Rhey,19,0,32,13
1683676575273,BILD 3,A04,192612,Butler; Shannon Rhey,24,0,32,8
1683676575273,BILD 3,A05,192613,Butler; Shannon Rhey,26,0,32,6
1683676575273,BILD 3,A06,192679,Butler; Shannon Rhey,27,0,32,5
1683676575273,BILD 3,A07,192682,Butler; Shannon Rhey,20,0,32,12
1683676576300,BILD 4,A01,192836,Reuther; Keefe,1,0,24,23
1683676576300,BILD 4,A02,193044,Reuther; Keefe,4,0,24,20
1683676577328,BILD 10,A01,193142,Gustafson-Brown; Cindy,29,0,32,3
1683676577328,BILD 10,A02,193149,Gustafson-Brown; Cindy,31,0,32,1
1683676578353,BIMM 100,A01,193301,Staff,0,6,32,32
1683676578353,BIMM 100,A02,193312,Staff,0,7,32,32
1683676578353,BIMM 100,A03,193323,Staff,0,10,32,32
1683676579382,BIMM 101,A01,193329,McDonnell; Lisa Marie,1,4,24,23
1683676579382,BIMM 101,A02,193339,McDonnell; Lisa Marie,1,4,24,23
1683676579382,BIMM 101,B01,193354,McDonnell; Lisa Marie,0,4,24,24
1683676579382,BIMM 101,B02,193357,McDonnell; Lisa Marie,0,3,24,24
1683676580410,BIMM 110,A01,193377,Tat; John,0,11,32,32
1683676580410,BIMM 110,A02,193378,Tat; John,0,10,32,32
1683676581438,BIMM 120,A01,206116,Staff,0,0,32,32
1683676581438,BIMM 120,A02,206117,Staff,7,0,32,25
1683676581438,BIMM 120,A03,206121,Staff,21,0,32,11
1683676582464,BIPN 100,A01,193393,Park; Ji Young,0,15,32,32
1683676582464,BIPN 100,A02,193402,Park; Ji Young,0,14,32,32
1683676582464,BIPN 100,A03,193413,Park; Ji Young,0,14,32,32
1683676582464,BIPN 100,A04,193414,Park; Ji Young,0,13,32,32
1683676583489,BIPN 102,A01,193429,Staff,0,0,32,32
1683676583489,BIPN 102,A02,193438,Staff,18,0,32,14
1683676584517,BIPN 106,A01,193450,Reyes Gonzalez; Catalina,0,2,40,40
1683676585605,BIPN 134,A01,193465,Cooke; James Edward,0,0,32,32
1683676585605,BIPN 134,A02,193474,Cooke; James Edward,25,0,32,7
1683676585605,BIPN 134,A03,193485,Cooke; James Edward,29,0,32,3
1683676585605,BIPN 134,A04,193486,Cooke; James Edward,20,0,32,12
1683676585605,BIPN 134,A05,193491,Cooke; James Edward,31,0,32,1
1683676585605,BIPN 134,A06,193501,Cooke; James Edward,30,0,32,2
1683676585605,BIPN 134,A07,193510,Cooke; James Edward,29,0,32,3
1683676587656,BISP 194,A00,222522,Staff,14,0,32,18
1683676588679,CAT 124,A01,202407,Staff,19,0,25,6
1683676589704,CAT 125,A00,202408,Marchisotto; Jennifer Anne,2,0,20,18
1683676590731,CAT 125R,A00,202409,Smith; Lauryn Alissa,0,11,20,20
1683676590731,CAT 125R,B00,202410,Morales; Celeste Georgianna,0,11,20,20
1683676590731,CAT 125R,C00,202411,Irwin; Matthew Joseph,0,12,20,20
1683676591756,CENG 15,A01,204712,Yang; Kesong,0,1,0,0
1683676592783,CENG 114,A00,202070,Jahed Motlagh; Zeinab,5,0,20,15
1683676593807,CGS 105,A00,185477,Wesling; Megan E.,24,0,40,16
1683676594832,CGS 106,A00,185494,Staff,11,0,22,11
1683676595856,CGS 108,A00,185495,Staff,14,0,20,6
1683676596885,CGS 114,A00,185496,Staff,13,0,18,5
1683676597910,CGS 119,A00,185501,Staff,15,0,20,5
1683676598934,CGS 120,A00,185511,Staff,12,0,20,8
1683676599961,CHEM 4,A01,184675,Bussey; Thomas J,97,0,100,3
1683676600985,CHEM 6A,A01,184677,Staff,32,0,60,28
1683676602010,CHEM 6B,A01,184679,Staff,63,0,100,37
1683676603035,CHEM 6C,A01,184681,Bussey; Thomas J,0,0,50,50
1683676603035,CHEM 6C,A02,184682,Bussey; Thomas J,32,0,50,18
1683676604063,CHEM 40A,A01,184684,Albizati; Kim F.,33,0,100,67
1683676605091,CHEM 40B,A01,184686,Albizati; Kim F.,0,22,100,100
1683676606117,CHEM 41B,A01,184690,Staff,51,0,100,49
1683676607141,COGS 3,A01,184715,Boyle; Mary E. T.,0,27,40,40
1683676608168,COGS 14B,A01,185172,Staff,0,14,38,38
1683676609193,COGS 18,A01,184736,Staff,14,0,80,66
1683676610217,COGS 100,A01,184932,Staff,0,8,73,73
1683676611246,COGS 101A,A01,184935,Staff,0,40,30,30
1683676612273,COGS 101B,A01,184944,Staff,0,2,30,30
1683676613301,COGS 101C,A01,184946,Staff,0,10,30,30
1683676614330,COGS 102A,A01,184951,Johnson; Christine M.,2,0,40,38
1683676615355,COGS 107B,A01,184953,Mooshagian; Eric Frederick,0,52,40,40
1683676616379,COGS 118B,A01,184959,Gupta; Anjum,0,50,40,40
1683676617409,COGS 153,A00,184961,Staff,0,16,30,30
1683676618437,COGS 177,A00,184962,Staff,0,21,30,30
1683676619462,COGS 187A,A01,184969,Boyle; Mary E. T.,0,19,40,40
1683676620489,COMM 10,A01,185174,Staff,0,5,25,25
1683676620489,COMM 10,A02,185189,Staff,0,2,25,25
1683676620489,COMM 10,A03,269821,Staff,0,1,0,0
1683676621515,COMM 100B,A01,185475,Staff,0,1,0,1
1683676621515,COMM 100B,A02,185476,Staff,11,0,25,14
1683676622543,COMM 100C,A01,185314,Staff,1,0,25,24
1683676622543,COMM 100C,A02,185327,Staff,17,0,25,8
1683676623569,COMM 110M,A00,185349,Staff,0,0,40,40
1683676624594,COMM 113T,A00,185352,Staff,25,0,40,15
1683676625619,COMM 114I,A00,185353,Staff,31,0,40,9
1683676626642,COMM 131,A00,185354,Staff,17,0,30,13
1683676627669,CSE 8A,A50,185358,Cao; Yingjun,0,46,10,10
1683676628696,CSE 8B,A01,185362,Staff,0,48,50,50
1683676629723,CSE 11,A01,185416,Cao; Yingjun,0,91,10,10
1683676630747,CSE 20,A01,185445,Briones; Jor-el Thomas Caparas,3,0,25,22
1683676631773,CSE 21,A01,185447,Staff,9,0,50,41
1683676632801,CSE 101,A01,185451,Staff,0,13,50,50
1683676632801,CSE 101,B01,185453,Jones; Miles E,0,14,50,50
1683676634854,CSE 141,A01,185458,Eldon; John,16,0,100,84
1683676635881,CSE 141L,A01,185461,Eldon; John,8,0,100,92
1683676636906,CSE 142,A01,185463,Staff,34,0,60,26
1683676636906,CSE 142,B01,201355,Staff,0,7,60,60
1683676637934,CSE 142L,A01,185470,Staff,34,0,60,26
1683676637934,CSE 142L,B01,201417,Staff,0,6,60,60
1683676638961,CSE 190,A00,201433,Staff,32,0,49,17
1683676639989,DOC 1,A01,259136,Strom; Megan C.,7,0,15,8
1683676639989,DOC 1,A02,259137,Strom; Megan C.,14,0,15,1
1683676639989,DOC 1,A03,259138,Strom; Megan C.,14,0,15,1
1683676639989,DOC 1,A04,259139,Strom; Megan C.,14,0,15,1
1683676641019,DOC 100D,A00,259140,Pass; Natalye Joann,14,0,25,11
1683676642046,DSGN 1,A01,184749,Rill; Bryan,0,26,30,30
1683676643070,DSGN 100,A01,185168,Staff,0,2,25,25
1683676644094,ECE 5,A01,185626,Morris; Karcher William,0,12,0,0
1683676645117,ECE 101,A01,185628,Staff,14,0,70,56
1683676646145,ECE 107,A01,185635,Baghdadchi; Saharnaz,0,0,20,20
1683676646145,ECE 107,A02,185638,Baghdadchi; Saharnaz,1,0,20,19
1683676647168,ECE 148,A01,185647,Silberman; Jack,0,0,16,16
1683676648194,ECON 1,A01,185537,Crane; Meredith Helen,54,0,70,16
1683676649220,ECON 3,A01,185549,Crane; Meredith Helen,29,0,70,41
1683676650243,ECON 4,A01,203354,Anderson; John Charles,0,5,10,10
1683676651270,ECON 100A,A01,185574,Staff,0,5,40,40
1683676652295,ECON 100B,A01,185576,Staff,0,12,50,50
1683676653322,ECON 100C,A01,185589,Newhouse; Herbert S,30,0,70,40
1683676654346,ECON 105,A00,185608,Vespa; Emanuel Ignacio,19,0,35,16
1683676655370,ECON 109,A01,185610,Shishkin; Denis,9,0,35,26
1683676656396,ECON 110A,A01,185612,Staff,9,0,40,31
1683676657422,ECON 120A,A01,185615,Staff,19,0,40,21
1683676658448,ECON 120C,A01,185617,Sun; Yixiao,0,21,70,70
1683676659475,ECON 144,A00,203346,Squires; Dale E,1,0,35,34
1683676660499,ECON 171,A01,203349,Newhouse; Herbert S,0,1,35,35
1683676661524,ECON 173A,A01,185621,Toda; Alexis Akira,21,0,35,14
1683676662551,EDS 25,A01,202413,Staff,0,1,0,0
1683676662551,EDS 25,A02,202414,Staff,0,1,0,0
1683676662551,EDS 25,A03,202415,Staff,0,0,0,0
1683676662551,EDS 25,A04,202416,Staff,0,1,0,0
1683676662551,EDS 25,A05,202439,Staff,0,0,0,0
1683676662551,EDS 25,A06,202440,Staff,0,0,0,0
1683676662551,EDS 25,B01,202631,Staff,0,0,0,0
1683676662551,EDS 25,B02,202632,Staff,0,0,0,0
1683676662551,EDS 25,B03,202639,Staff,0,0,0,0
1683676662551,EDS 25,B04,202640,Staff,0,0,0,0
1683676662551,EDS 25,B05,202643,Staff,0,0,0,0
1683676662551,EDS 25,B06,202644,Staff,0,0,0,0
1683676663576,EDS 38,A01,202659,Black; Alison Michelle,24,0,25,1
1683676664601,EDS 115,A00,202652,Staff,18,0,30,12
1683676665625,EDS 125,A00,202649,Staff,13,0,30,17
1683676666650,EDS 126,A01,203332,Staff,30,0,30,0
1683676667675,EDS 139,A00,202838,Staff,16,0,25,9
1683676668699,EDS 146,A01,202655,Staff,14,0,25,11
1683676669728,ENG 15,A00,185667,Staff,0,1,0,0
1683676669728,ENG 15,B00,185672,Staff,0,0,0,0
1683676669728,ENG 15,C00,185675,Staff,0,0,0,0
1683676669728,ENG 15,D00,185682,Staff,0,0,0,0
1683676669728,ENG 15,E00,185684,Staff,0,0,0,0
1683676670752,ETHN 103,A00,185710,Staff,0,8,35,35
1683676671776,ETHN 103A,A00,199228,Man; Simeon S,0,0,9,9
1683676672800,ETHN 109,A00,185711,Staff,15,0,35,20
1683676673826,ETHN 142,A00,185726,Staff,0,4,30,30
1683676674853,ETHN 163J,A00,199229,Man; Simeon S,5,0,8,3
1683676675881,ETHN 168,A00,185727,Staff,7,0,10,3
1683676676909,ETHN 182,A00,185728,Staff,0,0,35,35
1683676677936,ETHN 183,A00,185737,Staff,9,0,18,9
1683676678960,GLBH 111,A01,209361,Burgos; Jose L.,0,0,0,0
1683676681012,HIEU 104,A00,185792,Staff,14,0,20,6
1683676682044,HIEU 115,A00,185800,Staff,0,0,20,20
1683676683070,HIEU 128,A00,185801,Staff,0,9,20,20
1683676684094,HIEU 147,A00,185802,Staff,15,0,20,5
1683676685120,HIEU 154,A00,185823,Staff,11,0,20,9
1683676686147,HILA 102,A00,185826,Staff,14,0,20,6
1683676687174,HILD 2C,A01,185778,Staff,0,13,20,20
1683676688200,HILD 7B,A01,185780,Kwak; Nancy,0,17,32,32
1683676688200,HILD 7B,A02,185781,Kwak; Nancy,0,18,32,32
1683676689282,HILD 30,A01,185791,Staff,12,0,20,8
1683676690309,HISC 119,A00,185830,Golan; Tal,0,9,20,20
1683676691333,HITO 156GS,A00,185831,Patterson; Patrick H.,0,0,0,23
1683676692367,HIUS 103,A00,185832,Man; Simeon S,0,4,20,20
1683676693393,HIUS 117,A00,185836,Kwak; Nancy,2,0,20,18
1683676694416,HIUS 125,A00,185840,Man; Simeon S,0,2,23,23
1683676695443,HIUS 149,A00,185845,Staff,1,0,20,19
1683676696471,HUM 3,A01,185882,Zavodny; Tatiana Sophia,0,8,50,50
1683676696471,HUM 3,B01,185899,Caldwell; Michael Alan,0,18,50,50
1683676697497,HUM 3GS,A00,185900,Patterson; Patrick H.,0,0,0,23
1683676698522,HUM 4,A01,185938,Zroka; Amy Liane,28,0,50,22
1683676698522,HUM 4,B01,185956,Watkins; Eric,0,6,50,50
1683676698522,HUM 4,B02,202209,Watkins; Eric,0,5,50,50
1683676698522,HUM 4,B03,202210,Watkins; Eric,0,5,50,50
1683676699550,HUM 5,A01,185958,West; Geoffrey Scott,0,0,50,50
1683676699550,HUM 5,A02,202215,West; Geoffrey Scott,0,0,50,50
1683676700576,INTL 190,A00,185959,Gagnon; Jeffrey C,0,0,0,9
1683676700576,INTL 190,B00,185960,Lettieri; Michael Joseph,0,0,0,2
1683676701600,JAPN 180,A00,254509,Staff,5,0,30,25
1683676702628,LATI 10,A01,202853,Kennemore; Amy Michelle,4,0,35,31
1683676702628,LATI 10,A02,202854,Kennemore; Amy Michelle,3,0,35,32
1683676702628,LATI 10,A03,270054,Kennemore; Amy Michelle,30,0,30,0
1683676703652,LATI 180,A00,202855,Kennemore; Amy Michelle,11,0,20,9
1683676704676,LAWS 101,A00,201767,Golan; Tal,0,7,40,40
1683676705703,LIFR 1C,A00,185961,Staff,6,0,20,14
1683676706729,LIFR 1CX,A00,185962,Staff,7,0,20,13
1683676707753,LIFR 1D,A00,185963,Staff,7,0,20,13
1683676708781,LIFR 1DX,A00,185964,Staff,7,0,20,13
1683676709804,LIGN 101,A01,186039,Staff,43,0,50,7
1683676710832,LIGN 165,A00,186040,Staff,15,0,50,35
1683676711858,LTCS 108,A00,186041,Staff,5,0,10,5
1683676712885,LTCS 119,A00,186042,Staff,15,0,20,5
1683676713908,LTCS 130,A00,186043,Wesling; Megan E.,15,0,25,10
1683676715958,LTEA 138,A00,186119,Staff,14,0,40,26
1683676716980,LTEN 124,A00,186148,Staff,5,0,25,20
1683676718007,LTEN 178,A00,186149,Staff,7,0,15,8
1683676719031,LTEN 181,A00,186150,Blanco; John D,34,0,40,6
1683676720056,LTWL 120,A00,186160,Staff,19,0,25,6
1683676721080,LTWL 165,A00,186161,Staff,22,0,25,3
1683676722105,LTWR 100,A00,186162,Staff,0,5,15,15
1683676723129,LTWR 102,A00,186163,Doller; Ben,5,0,15,10
1683676724153,MAE 8,A01,186412,Staff,0,1,0,0
1683676725181,MAE 30B,A00,186445,Bahadori; Mohammad Yousef,82,0,100,18
1683676726207,MAE 40,A00,186592,Bewley; Thomas R,10,0,50,40
1683676727231,MAE 101B,A00,186593,Bahadori; Mohammad Yousef,80,0,100,20
1683676728256,MAE 105,A00,186594,Bandaru; Prabhakar,10,0,50,40
1683676729280,MAE 107,A00,186599,Pham; Hieu Tan,0,7,120,120
1683676730308,MAE 148,A01,186660,Silberman; Jack,3,0,16,13
1683676731330,MATH 10A,A01,188095,Staff,0,6,35,35
1683676732359,MATH 10B,A01,188097,Bowers; Adam R.,0,12,30,30
1683676732359,MATH 10B,A02,188099,Bowers; Adam R.,0,11,30,30
1683676732359,MATH 10B,B01,188104,Bowers; Adam R.,0,10,30,30
1683676732359,MATH 10B,B02,188106,Bowers; Adam R.,1,9,30,29
1683676733383,MATH 10C,A01,188111,Staff,0,20,30,30
1683676733383,MATH 10C,A02,188127,Staff,0,19,30,30
1683676733383,MATH 10C,A03,188131,Staff,0,19,30,30
1683676733383,MATH 10C,B01,188218,Staff,17,0,30,13
1683676733383,MATH 10C,B02,188244,Staff,13,0,30,17
1683676733383,MATH 10C,B03,188277,Staff,14,0,30,16
1683676734411,MATH 18,A01,188344,Bach; Quang Tran,18,0,30,12
1683676734411,MATH 18,A02,188345,Bach; Quang Tran,11,0,30,19
1683676734411,MATH 18,B01,188353,Bach; Quang Tran,11,0,30,19
1683676734411,MATH 18,B02,188354,Bach; Quang Tran,19,0,30,11
1683676735436,MATH 20A,A01,188374,Staff,11,0,35,24
1683676736460,MATH 20B,A01,188382,Ohm; Ko Woon,7,0,30,23
1683676736460,MATH 20B,A02,188383,Ohm; Ko Woon,22,0,30,8
1683676736460,MATH 20B,B01,188385,Ohm; Ko Woon,7,0,30,23
1683676736460,MATH 20B,B02,188392,Ohm; Ko Woon,22,0,30,8
1683676737485,MATH 20C,A01,188394,Harel; Guershon,10,0,30,20
1683676737485,MATH 20C,A02,188395,Harel; Guershon,13,0,30,17
1683676737485,MATH 20C,B01,188404,Harel; Guershon,5,0,30,25
1683676737485,MATH 20C,B02,188405,Harel; Guershon,18,0,30,12
1683676738509,MATH 20D,A01,188414,Hammock; Frances H,0,1,30,30
1683676738509,MATH 20D,A02,188415,Hammock; Frances H,0,1,30,30
1683676738509,MATH 20D,B01,188447,Hammock; Frances H,0,1,30,30
1683676738509,MATH 20D,B02,188486,Hammock; Frances H,3,0,30,27
1683676739534,MATH 20E,A01,188649,Staff,21,0,30,9
1683676739534,MATH 20E,A02,188650,Staff,20,0,30,10
1683676739534,MATH 20E,A03,188673,Staff,0,0,30,30
1683676740558,MATH 102,A01,188675,Staff,0,39,35,35
1683676741583,MATH 103B,A01,188681,Staff,3,0,35,32
1683676741583,MATH 103B,B01,188692,Staff,5,0,35,30
1683676742611,MATH 109,A01,188695,Salehi Golsefidy; Alireza,24,0,35,11
1683676742611,MATH 109,A02,188696,Salehi Golsefidy; Alireza,25,0,35,10
1683676743634,MATH 120A,A01,188698,Eggers; John Dietrich,7,0,35,28
1683676744661,MATH 142B,A01,188736,Ioana; Adrian,1,1,30,29
1683676744661,MATH 142B,A02,188741,Ioana; Adrian,0,1,30,30
1683676744661,MATH 142B,A03,188743,Ioana; Adrian,0,1,30,30
1683676745685,MATH 168A,A01,188790,Staff,0,11,35,35
1683676746712,MATH 170A,A01,188803,Nie; Jiawang,0,2,35,35
1683676746712,MATH 170A,A02,188811,Nie; Jiawang,0,1,35,35
1683676746712,MATH 170A,A03,188814,Nie; Jiawang,0,0,35,35
1683676746712,MATH 170A,A04,188815,Nie; Jiawang,5,0,35,30
1683676747739,MATH 193B,A01,188817,Staff,0,0,35,35
1683676747739,MATH 193B,A02,188818,Staff,5,0,35,30
1683676748762,MGT 4,A01,202857,Anderson; John Charles,60,0,80,20
1683676749785,MGT 12,A00,202858,Lindenberger; Wade Douglas,40,0,90,50
1683676750809,MGT 18,A00,202859,Staff,74,0,90,16
1683676751832,MGT 18GS,A00,202860,McKay; Michael J,13,0,28,15
1683676752856,MGT 45,A00,202861,Pecore; Joseph P.,9,0,90,81
1683676753880,MGT 100,A00,202863,Yavorsky; Daniel Ryan,28,0,90,62
1683676754910,MGT 103,A00,202864,Ehrich; Kristine R,0,18,90,90
1683676755934,MGT 112,A00,202865,Ehrich; Kristine R,15,0,90,75
1683676756961,MGT 121A,A00,202868,Staff,90,20,90,0
1683676757988,MGT 131B,A00,202869,Anderson; John Charles,59,0,90,31
1683676759011,MGT 136,A00,202871,Lindenberger; Wade Douglas,83,0,90,7
1683676760037,MGT 164,A00,202873,Staff,0,67,90,91
1683676761061,MGT 164GS,A00,202874,McKay; Mary A,13,0,28,15
1683676762091,MGT 180,A00,202875,Staff,0,51,90,91
1683676763117,MMW 11R,A01,205019,Herbst; Matthew,0,0,30,30
1683676763117,MMW 11R,A02,205026,Herbst; Matthew,29,0,30,1
1683676764147,MMW 15,A01,193512,Chang; Edmond Yi-Teh,0,8,28,28
1683676764147,MMW 15,A02,193513,Chang; Edmond Yi-Teh,0,5,28,28
1683676764147,MMW 15,A03,193514,Chang; Edmond Yi-Teh,0,5,28,28
1683676764147,MMW 15,A04,193515,Chang; Edmond Yi-Teh,0,5,28,28
1683676764147,MMW 15,A05,193516,Chang; Edmond Yi-Teh,0,5,28,28
1683676764147,MMW 15,A06,193517,Chang; Edmond Yi-Teh,0,6,28,28
1683676764147,MMW 15,B01,193519,Chang; Edmond Yi-Teh,0,5,28,28
1683676764147,MMW 15,B02,193520,Chang; Edmond Yi-Teh,0,5,28,28
1683676764147,MMW 15,B03,193521,Chang; Edmond Yi-Teh,0,5,28,28
1683676764147,MMW 15,B04,193522,Chang; Edmond Yi-Teh,0,5,28,28
1683676764147,MMW 15,B05,193523,Chang; Edmond Yi-Teh,0,5,28,28
1683676764147,MMW 15,B06,193524,Chang; Edmond Yi-Teh,0,5,28,28
1683676765171,MMW 122,A01,193526,Rahimi; Babak,0,16,28,28
1683676765171,MMW 122,A02,193527,Rahimi; Babak,0,15,28,28
1683676765171,MMW 122,A03,193528,Rahimi; Babak,0,0,0,0
1683676765171,MMW 122,A04,193529,Rahimi; Babak,0,0,0,0
1683676766194,MUS 1A,A01,186663,Staff,1,19,35,34
1683676767218,MUS 4,A01,186715,Staff,0,12,35,35
1683676768241,MUS 5R,A01,186796,Dubnov; Shlomo,0,17,35,35
1683676769265,MUS 6,A01,186798,Staff,0,5,25,25
1683676770292,MUS 7,A01,186830,Staff,11,0,35,24
1683676771319,MUS 8,A01,186930,Staff,0,27,35,35
1683676772343,MUS 15,A01,186932,Staff,0,15,35,35
1683676772343,MUS 15,B01,186934,Staff,1,17,35,34
1683676773368,MUS 80,A00,186935,Staff,0,0,20,20
1683676773368,MUS 80,B00,186936,Staff,24,0,25,1
1683676774392,NANO 11,A00,204702,Lipomi; Darren John,0,0,0,0
1683676775416,NANO 15,A01,204709,Yang; Kesong,0,1,0,0
1683676776444,NANO 114,A00,202069,Jahed Motlagh; Zeinab,3,0,10,7
1683676777470,PHIL 1,A00,186955,Grush; Rick Scott,31,0,40,9
1683676778494,PHIL 10,A01,186973,Grush; Rick Scott,27,0,35,8
1683676778494,PHIL 10,A02,186974,Grush; Rick Scott,33,0,35,2
1683676779523,PHIL 13,A01,186976,Staff,3,0,35,32
1683676779523,PHIL 13,A02,186977,Staff,16,0,35,19
1683676780547,PHIL 14,A01,186979,Staff,31,0,35,4
1683676780547,PHIL 14,A02,186986,Staff,32,0,35,3
1683676781574,PHIL 28,A01,186988,Staff,16,0,30,14
1683676781574,PHIL 28,A02,186989,Staff,1,0,30,29
1683676781574,PHIL 28,A03,186990,Staff,10,0,30,20
1683676781574,PHIL 28,A04,186991,Staff,26,0,30,4
1683676782598,PHIL 120,A00,186997,Staff,23,0,40,17
1683676783621,PHIL 137,A00,187003,Staff,7,0,40,33
1683676784650,PHIL 150,A00,187015,Staff,47,0,70,23
1683676785677,PHIL 167,A00,187021,Lamey; Andy M.,34,0,40,6
1683676786702,PHIL 174,A01,202226,Staff,17,0,20,3
1683676786702,PHIL 174,A02,202235,Staff,20,0,20,0
1683676787726,PHIL 191A,A00,258918,Staff,0,0,1,1
1683676788754,PHYS 1A,A00,187028,Staff,26,0,60,34
1683676789777,PHYS 1AL,001,187036,Staff,3,0,30,27
1683676789777,PHYS 1AL,002,187049,Staff,18,0,30,12
1683676790804,PHYS 1B,A00,187058,Staff,22,0,60,38
1683676791829,PHYS 1BL,001,187064,Staff,0,1,30,30
1683676791829,PHYS 1BL,002,187070,Staff,4,0,30,26
1683676792913,PHYS 1C,A00,187082,Staff,29,0,120,91
1683676793937,PHYS 1CL,001,187088,Staff,0,9,30,30
1683676793937,PHYS 1CL,002,187089,Staff,0,1,30,30
1683676793937,PHYS 1CL,009,262693,Staff,9,0,30,21
1683676794961,PHYS 2B,A01,187097,Staff,55,0,115,60
1683676795989,PHYS 2C,A01,187099,Staff,63,0,115,52
1683676797017,PHYS 2CL,A01,187101,Staff,5,0,28,23
1683676797017,PHYS 2CL,A02,187102,Staff,15,0,28,13
1683676798044,PHYS 2D,A01,187123,Shotwell; Brian,95,0,115,20
1683676799069,PHYS 4B,A01,187133,Grinstein; Benjamin,35,0,50,15
1683676800096,POLI 10,A00,188819,Staff,0,4,50,50
1683676801120,POLI 11,A00,188827,Staff,43,0,50,7
1683676802147,POLI 13R,A00,188828,Staff,0,1,20,20
1683676803168,POLI 27,A01,188830,Elgin; Samuel Zincke,0,2,70,70
1683676804192,POLI 30,A00,188832,Desposato; Scott,30,0,50,20
1683676805216,POLI 102F,A00,188834,Staff,0,0,40,40
1683676806239,POLI 104A,A00,188852,Staff,12,0,30,18
1683676807261,POLI 104I,A00,188853,Staff,0,8,20,20
1683676808287,POLI 110B,A00,188854,Wiens; David,6,0,20,14
1683676809312,POLI 112A,A00,188855,Wiens; David,3,0,30,27
1683676810337,POLI 117R,A00,188856,Forman; Fonna,0,12,20,20
1683676811373,POLI 118,A00,188857,Ingham; Sean,8,0,20,12
1683676812397,POLI 120G,A00,188858,Staff,8,0,30,22
1683676813420,POLI 131CR,A00,188863,Hoston; Germaine,20,0,50,30
1683676814448,POLI 133,A00,188864,Nellis; Gareth Hb,44,0,50,6
1683676815471,POLI 134D,A00,188865,Desposato; Scott,27,0,30,3
1683676816502,POLI 142A,A00,188871,Gartzke; Erik,21,0,50,29
1683676817525,POLI 142K,A00,188874,Staff,38,0,50,12
1683676818547,POLI 143,A00,188940,Gartzke; Erik,16,0,30,14
1683676819574,POLI 153,A00,188943,Staff,2,0,20,18
1683676820600,POLI 160AA,A00,188944,Staff,10,0,40,30
1683676821623,POLI 170A,A00,188945,Staff,10,0,30,20
1683676823673,PSYC 1,A00,188952,Staff,37,0,90,53
1683676824697,PSYC 2,B00,188953,Staff,19,0,35,16
1683676825720,PSYC 6,A00,188970,Staff,47,0,60,13
1683676826746,PSYC 7,A00,188973,Staff,35,0,45,10
1683676827776,PSYC 60,A01,188980,Rickard; Timothy C.,42,0,60,18
1683676828803,PSYC 70,A01,189001,Steiner; Eric Tomas,21,0,45,24
1683676829830,PSYC 100,A00,189005,Lacefield; Katharine I,0,100,120,120
1683676830856,PSYC 102,A00,189008,Staff,7,0,30,23
1683676831882,PSYC 106,B00,189026,Gorman; Michael R.,27,0,60,33
1683676832907,PSYC 114,B01,189033,Winkielman; Piotr,0,31,30,30
1683676833933,PSYC 131,A00,189036,Anagnostaras; Stephan,0,43,60,60
1683676834956,PSYC 136,A00,189041,Lowe; Angela Beth,0,7,25,25
1683676835984,PSYC 137,A00,189057,Winkielman; Piotr,1,37,25,24
1683676837009,PSYC 144,A00,189107,Wixted; John T,0,11,50,50
1683676839056,PSYC 162,A00,189142,Staff,0,9,85,85
1683676840079,PSYC 172,A00,189144,Gorman; Michael R.,0,6,30,30
1683676842130,PSYC 179,A00,189146,Lacefield; Katharine I,0,87,120,120
1683676843157,PSYC 181,A00,189147,Anagnostaras; Stephan,0,44,90,90
1683676844181,PSYC 190R,A00,189148,Barner; David A.,0,23,80,80
1683676845206,PSYC 191,A00,189275,Rickard; Timothy C.,0,10,25,25
1683676846229,PSYC 193,A00,189276,Chapman; Eddie Nathaniel,0,1,0,4
1683676847253,PSYC 193L,A01,189281,Lowe; Angela Beth,8,0,20,12
1683676847253,PSYC 193L,B01,189285,Staff,28,0,35,7
1683676848282,RELI 149,A00,187137,Rahimi; Babak,7,0,40,33
1683676849309,SE 9,A01,187315,Staff,0,2,18,18
1683676850331,SE 101B,A00,187409,Staff,24,0,30,6
1683676851355,SE 110B,A00,187444,Staff,10,0,40,30
1683676852382,SE 130B,A00,187449,Staff,31,0,40,9
1683676853405,SE 150A,A00,187516,Staff,8,0,20,12
1683676854429,SE 154,A00,187528,Staff,29,0,50,21
1683676855452,SIO 3,A01,258171,Staff,35,0,40,5
1683676856475,SIO 10,A00,187144,Cook; Geoffrey W,1,7,75,74
1683676857502,SIO 45,A00,187152,Cook; Geoffrey W,0,7,100,100
1683676858524,SIO 109R,A00,194486,Staff,0,4,20,20
1683676860571,SIO 187,A01,187233,Kacev; David,12,0,40,28
1683676861615,SOCI 1,A01,258656,Thorpe; Charles Robert,28,0,30,2
1683676861615,SOCI 1,A02,258658,Thorpe; Charles Robert,30,0,30,0
1683676861615,SOCI 1,A03,258661,Thorpe; Charles Robert,25,0,25,0
1683676861615,SOCI 1,A04,258666,Thorpe; Charles Robert,22,0,25,3
1683676861615,SOCI 1,A05,258897,Thorpe; Charles Robert,22,0,25,3
1683676861615,SOCI 1,A06,258898,Thorpe; Charles Robert,25,0,25,0
1683676862675,SOCI 30,A01,258903,Pardo Guerra; Juan Pablo,14,0,30,16
1683676863706,SOCI 102,A00,258904,Staff,9,0,25,16
1683676864731,SOCI 106,A00,258905,Staff,19,0,25,6
1683676865753,SOCI 111,A00,258907,Ribas Norris; Janet Vanesa,26,0,30,4
1683676866784,SOCI 121R,A00,258908,Pardo Guerra; Juan Pablo,8,0,30,22
1683676867812,SOCI 126,A01,203330,Staff,14,0,20,6
1683676868838,SOCI 131,A00,258909,Thorpe; Charles Robert,30,0,60,30
1683676869871,SOCI 135,A00,258910,Payne; Christine Anna,0,12,30,30
1683676870898,SOCI 157,A00,258911,Staff,11,0,30,19
1683676871924,SOCI 184,A00,258912,Staff,25,0,30,5
1683676872947,SOCI 188D,A00,258913,Staff,22,0,30,8
1683676873971,SYN 2,001,187529,Staff,9,0,16,7
1683676873971,SYN 2,002,201452,Staff,1,20,16,15
1683676873971,SYN 2,003,201469,Staff,1,0,16,15
1683676874999,SYN 100,A01,187531,Staff,0,9,20,20
1683676874999,SYN 100,B01,201491,Staff,0,10,20,20
1683676876027,TDAC 1,A00,189286,Walsh; Kim C.,3,0,20,17
1683676876027,TDAC 1,B00,189287,Harting; Carla Kelso,10,0,20,10
1683676877054,TDAC 101,A00,189300,Walsh; Kim C.,16,0,20,4
1683676877054,TDAC 101,B00,189301,Harting; Carla Kelso,18,0,20,2
1683676878078,TDAC 102,A00,189304,Basso; Beatrice,14,0,20,6
1683676879103,TDAC 108,A00,189305,Staff,18,0,20,2
1683676880127,TDDE 131,A00,189310,Staff,19,0,20,1
1683676880127,TDDE 131,B00,189314,Staff,19,0,20,1
1683676880127,TDDE 131,C00,189315,Staff,48,0,50,2
1683676880127,TDDE 131,D00,189316,Staff,14,0,15,1
1683676880127,TDDE 131,E00,204841,Staff,20,0,20,0
1683676881155,TDGE 10,A00,189289,Staff,27,0,50,23
1683676881155,TDGE 10,B00,189290,Havis; Allan,0,1,50,50
1683676882178,TDGE 11,A00,189291,Fulton; Julia,0,4,50,50
1683676882178,TDGE 11,B00,189292,Staff,20,0,25,5
1683676882178,TDGE 11,C00,260270,Staff,0,0,0,0
1683676883205,TDGE 25,A00,189294,Staff,1,0,20,19
1683676884229,TDGE 124,A00,189318,Fulton; Julia,0,8,50,50
1683676885253,TDGE 125,A00,189319,Staff,13,0,25,12
1683676885253,TDGE 125,B00,189320,Staff,23,0,25,2
1683676886277,TDGE 127,A00,189322,Havis; Allan,0,0,50,50
1683676887301,TDHT 101,A00,189323,Staff,18,0,25,7
1683676887301,TDHT 101,B00,189324,Staff,25,0,25,0
1683676888327,TDHT 102,A00,189325,Staff,49,0,50,1
1683676889358,TDMV 1,A00,189295,Arcidiacono; Kristin,20,0,30,10
1683676889358,TDMV 1,B00,189296,Caligagan; Maria T.,24,0,30,6
1683676890385,TDMV 2,A00,189297,Sammartano; Tonnie,27,0,30,3
1683676890385,TDMV 2,B00,189299,Arcidiacono; Kristin,23,0,30,7
1683676891409,TDMV 3,A00,204998,Rincon; Alicia,22,0,30,8
1683676892433,TDMV 120,A00,189458,Sammartano; Tonnie,28,0,30,2
1683676893461,TDMV 138,A00,189541,Jun; Grace Shin Hae,20,0,40,20
1683676894484,TDMV 142,A00,189717,Caligagan; Tony,25,0,30,5
1683676894484,TDMV 142,B00,189718,Caligagan; Maria T.,25,0,30,5
1683676895510,TMC 2,A01,187533,Staff,25,0,25,0
1683676895510,TMC 2,A02,187534,Staff,25,0,25,0
1683676896596,USP 1,A01,187536,Kwak; Nancy,0,16,25,25
1683676897620,USP 5,A01,187538,Staff,8,0,25,17
1683676898660,USP 101,A00,199253,Staff,0,4,0,0
1683676899683,USP 124,A00,187562,Boomhower; Matthew Charles,0,0,30,30
1683676900706,USP 138,A00,187582,Staff,19,0,25,6
1683676901735,USP 152,A01,187597,Staff,3,0,25,22
1683676902760,USP 153,A00,187598,Staff,19,0,25,6
1683676903789,USP 168,A00,187607,Kwak; Nancy,2,0,5,3
1683676904815,USP 173,A00,187619,Staff,4,0,25,21
1683676905845,USP 181,A00,187638,Staff,0,4,25,25
1683676906872,VIS 103,A00,187650,Cruz; Edwin Teddy,17,0,75,58
1683676907899,VIS 110D,A00,187669,Staff,13,0,22,9
1683676908924,VIS 127C,A00,187720,Shen; Kuiyi,67,0,146,79
1683676909948,VIS 149,A00,187731,Yoldas; Pinar,1,14,22,21
1683676910972,VIS 151,A01,188091,Staff,22,0,34,12
1683676910972,VIS 151,A02,188092,Staff,11,0,34,23
1683676911998,VIS 160B,A00,188093,Stalbaum; Brett,0,1,10,10
1683676914049,WCWP 10B,A00,201720,Staff,0,0,5,5
1683676914049,WCWP 10B,B00,201722,Staff,0,0,6,6
1683676915076,WCWP 100,A00,201725,Gagnon; Jeffrey C,0,0,2,2
1683676915076,WCWP 100,B00,201727,Staff,0,4,15,15
1683676918208,ANBI 133,A00,258401,Wilder; Linnea Lorene,34,0,40,6
1683676919231,ANBI 140,A00,258395,Hrvoj Mihic; Branka,18,0,25,7
1683676920261,ANSC 120,A00,258402,Bialecki; Jon Anthony,26,0,40,14
1683676921286,ANSC 144,A00,258400,Staff,12,0,40,28
1683676923348,ANSC 166,A00,258396,Parish; Steven Martin,156,0,175,19
1683676924374,ANSC 180,A00,193533,Staff,8,0,20,12
1683676925401,ANSC 188,A00,258397,Jassal; Aftab,34,0,40,6
1683676926429,ANTH 3,A01,258316,Staff,23,0,30,7
1683676927457,ANTH 5,A00,258394,Semendeferi; Ekaterini,16,0,20,4
1683676928485,ANTH 21,A01,258331,Staff,4,0,40,36
1683676929513,ANTH 103,A00,258398,Varma; Saiba,15,0,25,10
1683676930541,AWP 10,001,202034,Staff,0,0,0,0
1683676930541,AWP 10,002,202035,Staff,0,0,0,0
1683676930541,AWP 10,003,202036,Staff,0,0,0,0
1683676930541,AWP 10,004,202037,Staff,0,0,0,0
1683676930541,AWP 10,005,202038,Staff,0,0,0,0
1683676930541,AWP 10,006,202039,Staff,0,0,0,0
1683676930541,AWP 10,007,202040,Staff,0,0,0,0
1683676930541,AWP 10,008,202041,Staff,0,0,0,0
1683676930541,AWP 10,009,202042,Staff,0,0,0,0
1683676930541,AWP 10,010,202043,Staff,0,0,0,0
1683676930541,AWP 10,011,202044,Staff,0,0,0,0
1683676930541,AWP 10,012,202045,Staff,0,0,0,0
1683676930541,AWP 10,013,202046,Staff,0,0,0,0
1683676930541,AWP 10,014,202047,Staff,0,0,0,0
1683676930541,AWP 10,015,202048,Staff,0,0,0,0
1683676930541,AWP 10,016,202049,Staff,0,0,0,0
1683676930541,AWP 10,017,202050,Staff,0,0,0,0
1683676930541,AWP 10,018,202051,Staff,0,0,0,0
1683676930541,AWP 10,019,202052,Staff,0,0,0,0
1683676930541,AWP 10,020,202053,Staff,0,0,0,0
1683676930541,AWP 10,021,202054,Staff,0,0,0,0
1683676930541,AWP 10,022,202055,Staff,0,0,0,0
1683676930541,AWP 10,023,202056,Staff,0,0,0,0
1683676930541,AWP 10,024,202057,Staff,0,0,0,0
1683676930541,AWP 10,025,202058,Staff,0,0,0,0
1683676930541,AWP 10,026,202059,Staff,0,0,0,0
1683676931570,AWP 102,001,202032,Staff,0,0,0,0
1683676931570,AWP 102,002,202033,Staff,0,0,0,0
1683676932598,BENG 100,A01,254234,Taylor Amos; Alyssa C,31,0,40,9
1683676933625,BENG 196,001,270013,Engler; Adam J.,9999,0,9999,0
1683676934650,BICD 100R,A01,202018,Smith; Laurie,0,7,32,32
1683676934650,BICD 100R,A02,202019,Smith; Laurie,0,3,32,32
1683676934650,BICD 100R,A03,202020,Smith; Laurie,0,1,32,32
1683676934650,BICD 100R,A04,202021,Smith; Laurie,6,0,32,26
1683676934650,BICD 100R,A05,202022,Smith; Laurie,10,0,32,22
1683676935674,BICD 136,A01,193242,Gustafson-Brown; Cindy,0,2,32,32
1683676935674,BICD 136,A02,193244,Gustafson-Brown; Cindy,13,0,32,19
1683676936704,BIEB 102,A01,193249,Butler; Shannon Rhey,1,1,32,31
1683676936704,BIEB 102,A02,193251,Butler; Shannon Rhey,0,0,32,32
1683676936704,BIEB 102,A03,193253,Butler; Shannon Rhey,0,0,32,32
1683676936704,BIEB 102,A04,193255,Butler; Shannon Rhey,13,0,32,19
1683676936704,BIEB 102,A05,193265,Butler; Shannon Rhey,25,0,32,7
1683676936704,BIEB 102,A06,193269,Butler; Shannon Rhey,13,0,32,19
1683676938769,BIEB 150,A01,193274,Staff,0,0,32,32
1683676938769,BIEB 150,A02,193285,Staff,24,0,32,8
1683676939793,BIEB 194,A00,193286,Kurle; Carolyn M.,19,0,32,13
1683676940830,BILD 1,A01,192291,Staff,15,0,32,17
1683676940830,BILD 1,A02,192292,Staff,30,0,32,2
1683676940830,BILD 1,B01,192520,Reuther; Keefe,0,1,0,0
1683676940830,BILD 1,B02,192532,Reuther; Keefe,0,1,0,0
1683676941860,BILD 3,A01,192556,Butler; Shannon Rhey,0,0,32,32
1683676941860,BILD 3,A02,192581,Butler; Shannon Rhey,0,1,32,32
1683676941860,BILD 3,A03,192611,Butler; Shannon Rhey,19,0,32,13
1683676941860,BILD 3,A04,192612,Butler; Shannon Rhey,24,0,32,8
1683676941860,BILD 3,A05,192613,Butler; Shannon Rhey,26,0,32,6
1683676941860,BILD 3,A06,192679,Butler; Shannon Rhey,27,0,32,5
1683676941860,BILD 3,A07,192682,Butler; Shannon Rhey,20,0,32,12
1683676942886,BILD 4,A01,192836,Reuther; Keefe,1,0,24,23
1683676942886,BILD 4,A02,193044,Reuther; Keefe,4,0,24,20
1683676943914,BILD 10,A01,193142,Gustafson-Brown; Cindy,29,0,32,3
1683676943914,BILD 10,A02,193149,Gustafson-Brown; Cindy,31,0,32,1
1683676944946,BIMM 100,A01,193301,Staff,0,6,32,32
1683676944946,BIMM 100,A02,193312,Staff,0,7,32,32
1683676944946,BIMM 100,A03,193323,Staff,0,10,32,32
1683676945999,BIMM 101,A01,193329,McDonnell; Lisa Marie,1,4,24,23
1683676945999,BIMM 101,A02,193339,McDonnell; Lisa Marie,1,4,24,23
1683676945999,BIMM 101,B01,193354,McDonnell; Lisa Marie,0,4,24,24
1683676945999,BIMM 101,B02,193357,McDonnell; Lisa Marie,0,3,24,24
1683676947025,BIMM 110,A01,193377,Tat; John,0,11,32,32
1683676947025,BIMM 110,A02,193378,Tat; John,0,11,32,32
1683676948055,BIMM 120,A01,206116,Staff,0,0,32,32
1683676948055,BIMM 120,A02,206117,Staff,7,0,32,25
1683676948055,BIMM 120,A03,206121,Staff,21,0,32,11
1683676949082,BIPN 100,A01,193393,Park; Ji Young,0,15,32,32
1683676949082,BIPN 100,A02,193402,Park; Ji Young,0,14,32,32
1683676949082,BIPN 100,A03,193413,Park; Ji Young,0,14,32,32
1683676949082,BIPN 100,A04,193414,Park; Ji Young,0,13,32,32
1683676950106,BIPN 102,A01,193429,Staff,0,0,32,32
1683676950106,BIPN 102,A02,193438,Staff,18,0,32,14
1683676951134,BIPN 106,A01,193450,Reyes Gonzalez; Catalina,0,2,40,40
1683676952164,BIPN 134,A01,193465,Cooke; James Edward,0,0,32,32
1683676952164,BIPN 134,A02,193474,Cooke; James Edward,25,0,32,7
1683676952164,BIPN 134,A03,193485,Cooke; James Edward,29,0,32,3
1683676952164,BIPN 134,A04,193486,Cooke; James Edward,20,0,32,12
1683676952164,BIPN 134,A05,193491,Cooke; James Edward,31,0,32,1
1683676952164,BIPN 134,A06,193501,Cooke; James Edward,30,0,32,2
1683676952164,BIPN 134,A07,193510,Cooke; James Edward,29,0,32,3
1683676954212,BISP 194,A00,222522,Staff,14,0,32,18
1683676955240,CAT 124,A01,202407,Staff,19,0,25,6
1683676956264,CAT 125,A00,202408,Marchisotto; Jennifer Anne,2,0,20,18
1683676957292,CAT 125R,A00,202409,Smith; Lauryn Alissa,0,11,20,20
1683676957292,CAT 125R,B00,202410,Morales; Celeste Georgianna,0,11,20,20
1683676957292,CAT 125R,C00,202411,Irwin; Matthew Joseph,0,12,20,20
1683676958319,CENG 15,A01,204712,Yang; Kesong,0,1,0,0
1683676959344,CENG 114,A00,202070,Jahed Motlagh; Zeinab,5,0,20,15
1683676960374,CGS 105,A00,185477,Wesling; Megan E.,24,0,40,16
1683676961399,CGS 106,A00,185494,Staff,11,0,22,11
1683676962424,CGS 108,A00,185495,Staff,14,0,20,6
1683676963452,CGS 114,A00,185496,Staff,13,0,18,5
1683676964479,CGS 119,A00,185501,Staff,15,0,20,5
1683676965504,CGS 120,A00,185511,Staff,12,0,20,8
1683676966536,CHEM 4,A01,184675,Bussey; Thomas J,97,0,100,3
1683676967560,CHEM 6A,A01,184677,Staff,32,0,60,28
1683676968584,CHEM 6B,A01,184679,Staff,63,0,100,37
1683676969609,CHEM 6C,A01,184681,Bussey; Thomas J,0,0,50,50
1683676969609,CHEM 6C,A02,184682,Bussey; Thomas J,32,0,50,18
1683676970636,CHEM 40A,A01,184684,Albizati; Kim F.,33,0,100,67
1683676971664,CHEM 40B,A01,184686,Albizati; Kim F.,0,22,100,100
1683676972692,CHEM 41B,A01,184690,Staff,51,0,100,49
1683676973715,COGS 3,A01,184715,Boyle; Mary E. T.,0,27,40,40
1683676974742,COGS 14B,A01,185172,Staff,0,14,38,38
1683676975767,COGS 18,A01,184736,Staff,14,0,80,66
1683676976795,COGS 100,A01,184932,Staff,0,8,73,73
1683676977819,COGS 101A,A01,184935,Staff,0,40,30,30
1683676978844,COGS 101B,A01,184944,Staff,0,2,30,30
1683676979869,COGS 101C,A01,184946,Staff,0,10,30,30
1683676980894,COGS 102A,A01,184951,Johnson; Christine M.,2,0,40,38
1683676981920,COGS 107B,A01,184953,Mooshagian; Eric Frederick,0,52,40,40
1683676982950,COGS 118B,A01,184959,Gupta; Anjum,0,50,40,40
1683676983974,COGS 153,A00,184961,Staff,0,16,30,30
1683676984998,COGS 177,A00,184962,Staff,0,21,30,30
1683676986026,COGS 187A,A01,184969,Boyle; Mary E. T.,0,19,40,40
1683676987050,COMM 10,A01,185174,Staff,0,5,25,25
1683676987050,COMM 10,A02,185189,Staff,0,2,25,25
1683676987050,COMM 10,A03,269821,Staff,0,1,0,0
1683676988079,COMM 100B,A01,185475,Staff,0,1,0,1
1683676988079,COMM 100B,A02,185476,Staff,11,0,25,14
1683676989103,COMM 100C,A01,185314,Staff,1,0,25,24
1683676989103,COMM 100C,A02,185327,Staff,17,0,25,8
1683676990130,COMM 110M,A00,185349,Staff,0,0,40,40
1683676991155,COMM 113T,A00,185352,Staff,25,0,40,15
1683676992182,COMM 114I,A00,185353,Staff,31,0,40,9
1683676993218,COMM 131,A00,185354,Staff,17,0,30,13
1683676994246,CSE 8A,A50,185358,Cao; Yingjun,0,46,10,10
1683676995274,CSE 8B,A01,185362,Staff,0,48,50,50
1683676996302,CSE 11,A01,185416,Cao; Yingjun,0,91,10,10
1683676997326,CSE 20,A01,185445,Briones; Jor-el Thomas Caparas,3,0,25,22
1683676998351,CSE 21,A01,185447,Staff,9,0,50,41
1683676999375,CSE 101,A01,185451,Staff,0,13,50,50
1683676999375,CSE 101,B01,185453,Jones; Miles E,0,14,50,50
1683677001493,CSE 141,A01,185458,Eldon; John,16,0,100,84
1683677002518,CSE 141L,A01,185461,Eldon; John,8,0,100,92
1683677003542,CSE 142,A01,185463,Staff,34,0,60,26
1683677003542,CSE 142,B01,201355,Staff,0,7,60,60
1683677004566,CSE 142L,A01,185470,Staff,34,0,60,26
1683677004566,CSE 142L,B01,201417,Staff,0,6,60,60
1683677005591,CSE 190,A00,201433,Staff,32,0,49,17
1683677006616,DOC 1,A01,259136,Strom; Megan C.,7,0,15,8
1683677006616,DOC 1,A02,259137,Strom; Megan C.,14,0,15,1
1683677006616,DOC 1,A03,259138,Strom; Megan C.,14,0,15,1
1683677006616,DOC 1,A04,259139,Strom; Megan C.,14,0,15,1
1683677007640,DOC 100D,A00,259140,Pass; Natalye Joann,14,0,25,11
1683677008668,DSGN 1,A01,184749,Rill; Bryan,0,26,30,30
1683677009692,DSGN 100,A01,185168,Staff,0,2,25,25
1683677010716,ECE 5,A01,185626,Morris; Karcher William,0,12,0,0
1683677011741,ECE 101,A01,185628,Staff,14,0,70,56
1683677012770,ECE 107,A01,185635,Baghdadchi; Saharnaz,0,0,20,20
1683677012770,ECE 107,A02,185638,Baghdadchi; Saharnaz,1,0,20,19
1683677013794,ECE 148,A01,185647,Silberman; Jack,0,0,16,16
1683677014817,ECON 1,A01,185537,Crane; Meredith Helen,54,0,70,16
1683677015844,ECON 3,A01,185549,Crane; Meredith Helen,29,0,70,41
1683677016871,ECON 4,A01,203354,Anderson; John Charles,0,5,10,10
1683677017896,ECON 100A,A01,185574,Staff,0,5,40,40
1683677018921,ECON 100B,A01,185576,Staff,0,12,50,50
1683677019948,ECON 100C,A01,185589,Newhouse; Herbert S,30,0,70,40
1683677020972,ECON 105,A00,185608,Vespa; Emanuel Ignacio,19,0,35,16
1683677021999,ECON 109,A01,185610,Shishkin; Denis,9,0,35,26
1683677023030,ECON 110A,A01,185612,Staff,9,0,40,31
1683677024057,ECON 120A,A01,185615,Staff,19,0,40,21
1683677025086,ECON 120C,A01,185617,Sun; Yixiao,0,21,70,70
1683677026112,ECON 144,A00,203346,Squires; Dale E,2,0,35,33
1683677027137,ECON 171,A01,203349,Newhouse; Herbert S,0,1,35,35
1683677028163,ECON 173A,A01,185621,Toda; Alexis Akira,21,0,35,14
1683677029193,EDS 25,A01,202413,Staff,0,1,0,0
1683677029193,EDS 25,A02,202414,Staff,0,1,0,0
1683677029193,EDS 25,A03,202415,Staff,0,0,0,0
1683677029193,EDS 25,A04,202416,Staff,0,1,0,0
1683677029193,EDS 25,A05,202439,Staff,0,0,0,0
1683677029193,EDS 25,A06,202440,Staff,0,0,0,0
1683677029193,EDS 25,B01,202631,Staff,0,0,0,0
1683677029193,EDS 25,B02,202632,Staff,0,0,0,0
1683677029193,EDS 25,B03,202639,Staff,0,0,0,0
1683677029193,EDS 25,B04,202640,Staff,0,0,0,0
1683677029193,EDS 25,B05,202643,Staff,0,0,0,0
1683677029193,EDS 25,B06,202644,Staff,0,0,0,0
1683677030221,EDS 38,A01,202659,Black; Alison Michelle,24,0,25,1
1683677031248,EDS 115,A00,202652,Staff,18,0,30,12
1683677032272,EDS 125,A00,202649,Staff,13,0,30,17
1683677033301,EDS 126,A01,203332,Staff,30,0,30,0
1683677034326,EDS 139,A00,202838,Staff,16,0,25,9
1683677035349,EDS 146,A01,202655,Staff,14,0,25,11
1683677036374,ENG 15,A00,185667,Staff,0,1,0,0
1683677036374,ENG 15,B00,185672,Staff,0,0,0,0
1683677036374,ENG 15,C00,185675,Staff,0,0,0,0
1683677036374,ENG 15,D00,185682,Staff,0,0,0,0
1683677036374,ENG 15,E00,185684,Staff,0,0,0,0
1683677037399,ETHN 103,A00,185710,Staff,0,8,35,35
1683677038423,ETHN 103A,A00,199228,Man; Simeon S,0,0,9,9
1683677039446,ETHN 109,A00,185711,Staff,15,0,35,20
1683677040473,ETHN 142,A00,185726,Staff,0,4,30,30
1683677041500,ETHN 163J,A00,199229,Man; Simeon S,5,0,8,3
1683677042525,ETHN 168,A00,185727,Staff,7,0,10,3
1683677043550,ETHN 182,A00,185728,Staff,0,0,35,35
1683677044575,ETHN 183,A00,185737,Staff,9,0,18,9
1683677045599,GLBH 111,A01,209361,Burgos; Jose L.,0,0,0,0
1683677047648,HIEU 104,A00,185792,Staff,14,0,20,6
1683677048672,HIEU 115,A00,185800,Staff,0,0,20,20
1683677049696,HIEU 128,A00,185801,Staff,0,9,20,20
1683677050720,HIEU 147,A00,185802,Staff,15,0,20,5
1683677051744,HIEU 154,A00,185823,Staff,11,0,20,9
1683677052772,HILA 102,A00,185826,Staff,14,0,20,6
1683677053796,HILD 2C,A01,185778,Staff,0,13,20,20
1683677054824,HILD 7B,A01,185780,Kwak; Nancy,0,17,32,32
1683677054824,HILD 7B,A02,185781,Kwak; Nancy,0,18,32,32
1683677055849,HILD 30,A01,185791,Staff,12,0,20,8
1683677056873,HISC 119,A00,185830,Golan; Tal,0,9,20,20
1683677057898,HITO 156GS,A00,185831,Patterson; Patrick H.,0,0,0,23
1683677058927,HIUS 103,A00,185832,Man; Simeon S,0,4,20,20
1683677059954,HIUS 117,A00,185836,Kwak; Nancy,2,0,20,18
1683677060983,HIUS 125,A00,185840,Man; Simeon S,0,2,23,23
1683677062007,HIUS 149,A00,185845,Staff,1,0,20,19
1683677063040,HUM 3,A01,185882,Zavodny; Tatiana Sophia,0,8,50,50
1683677063040,HUM 3,B01,185899,Caldwell; Michael Alan,0,18,50,50
1683677064068,HUM 3GS,A00,185900,Patterson; Patrick H.,0,0,0,23
1683677065093,HUM 4,A01,185938,Zroka; Amy Liane,28,0,50,22
1683677065093,HUM 4,B01,185956,Watkins; Eric,0,6,50,50
1683677065093,HUM 4,B02,202209,Watkins; Eric,0,5,50,50
1683677065093,HUM 4,B03,202210,Watkins; Eric,0,5,50,50
1683677066119,HUM 5,A01,185958,West; Geoffrey Scott,0,0,50,50
1683677066119,HUM 5,A02,202215,West; Geoffrey Scott,0,0,50,50
1683677067146,INTL 190,A00,185959,Gagnon; Jeffrey C,0,0,0,9
1683677067146,INTL 190,B00,185960,Lettieri; Michael Joseph,0,0,0,2
1683677068173,JAPN 180,A00,254509,Staff,5,0,30,25
1683677069201,LATI 10,A01,202853,Kennemore; Amy Michelle,4,0,35,31
1683677069201,LATI 10,A02,202854,Kennemore; Amy Michelle,3,0,35,32
1683677069201,LATI 10,A03,270054,Kennemore; Amy Michelle,30,0,30,0
1683677070229,LATI 180,A00,202855,Kennemore; Amy Michelle,11,0,20,9
1683677071255,LAWS 101,A00,201767,Golan; Tal,0,7,40,40
1683677072279,LIFR 1C,A00,185961,Staff,6,0,20,14
1683677073308,LIFR 1CX,A00,185962,Staff,7,0,20,13
1683677074332,LIFR 1D,A00,185963,Staff,7,0,20,13
1683677075356,LIFR 1DX,A00,185964,Staff,7,0,20,13
1683677076382,LIGN 101,A01,186039,Staff,43,0,50,7
1683677077405,LIGN 165,A00,186040,Staff,15,0,50,35
1683677078432,LTCS 108,A00,186041,Staff,5,0,10,5
1683677079459,LTCS 119,A00,186042,Staff,15,0,20,5
1683677080482,LTCS 130,A00,186043,Wesling; Megan E.,15,0,25,10
1683677082534,LTEA 138,A00,186119,Staff,14,0,40,26
1683677083559,LTEN 124,A00,186148,Staff,5,0,25,20
1683677084586,LTEN 178,A00,186149,Staff,7,0,15,8
1683677085610,LTEN 181,A00,186150,Blanco; John D,34,0,40,6
1683677086635,LTWL 120,A00,186160,Staff,19,0,25,6
1683677087660,LTWL 165,A00,186161,Staff,22,0,25,3
1683677088684,LTWR 100,A00,186162,Staff,0,5,15,15
1683677089708,LTWR 102,A00,186163,Doller; Ben,5,0,15,10
1683677090736,MAE 8,A01,186412,Staff,0,1,0,0
1683677091762,MAE 30B,A00,186445,Bahadori; Mohammad Yousef,82,0,100,18
1683677092790,MAE 40,A00,186592,Bewley; Thomas R,10,0,50,40
1683677093819,MAE 101B,A00,186593,Bahadori; Mohammad Yousef,80,0,100,20
1683677094847,MAE 105,A00,186594,Bandaru; Prabhakar,10,0,50,40
1683677095872,MAE 107,A00,186599,Pham; Hieu Tan,0,7,120,120
1683677096894,MAE 148,A01,186660,Silberman; Jack,3,0,16,13
1683677097920,MATH 10A,A01,188095,Staff,0,6,35,35
1683677098946,MATH 10B,A01,188097,Bowers; Adam R.,0,12,30,30
1683677098946,MATH 10B,A02,188099,Bowers; Adam R.,0,11,30,30
1683677098946,MATH 10B,B01,188104,Bowers; Adam R.,0,10,30,30
1683677098946,MATH 10B,B02,188106,Bowers; Adam R.,1,9,30,29
1683677099970,MATH 10C,A01,188111,Staff,0,20,30,30
1683677099970,MATH 10C,A02,188127,Staff,0,19,30,30
1683677099970,MATH 10C,A03,188131,Staff,0,19,30,30
1683677099970,MATH 10C,B01,188218,Staff,17,0,30,13
1683677099970,MATH 10C,B02,188244,Staff,13,0,30,17
1683677099970,MATH 10C,B03,188277,Staff,14,0,30,16
1683677100994,MATH 18,A01,188344,Bach; Quang Tran,18,0,30,12
1683677100994,MATH 18,A02,188345,Bach; Quang Tran,11,0,30,19
1683677100994,MATH 18,B01,188353,Bach; Quang Tran,11,0,30,19
1683677100994,MATH 18,B02,188354,Bach; Quang Tran,19,0,30,11
1683677102019,MATH 20A,A01,188374,Staff,11,0,35,24
1683677103051,MATH 20B,A01,188382,Ohm; Ko Woon,7,0,30,23
1683677103051,MATH 20B,A02,188383,Ohm; Ko Woon,22,0,30,8
1683677103051,MATH 20B,B01,188385,Ohm; Ko Woon,7,0,30,23
1683677103051,MATH 20B,B02,188392,Ohm; Ko Woon,22,0,30,8
1683677104135,MATH 20C,A01,188394,Harel; Guershon,10,0,30,20
1683677104135,MATH 20C,A02,188395,Harel; Guershon,13,0,30,17
1683677104135,MATH 20C,B01,188404,Harel; Guershon,5,0,30,25
1683677104135,MATH 20C,B02,188405,Harel; Guershon,18,0,30,12
1683677105170,MATH 20D,A01,188414,Hammock; Frances H,0,1,30,30
1683677105170,MATH 20D,A02,188415,Hammock; Frances H,0,1,30,30
1683677105170,MATH 20D,B01,188447,Hammock; Frances H,0,1,30,30
1683677105170,MATH 20D,B02,188486,Hammock; Frances H,3,0,30,27
1683677106193,MATH 20E,A01,188649,Staff,21,0,30,9
1683677106193,MATH 20E,A02,188650,Staff,20,0,30,10
1683677106193,MATH 20E,A03,188673,Staff,0,0,30,30
1683677107218,MATH 102,A01,188675,Staff,0,39,35,35
1683677108244,MATH 103B,A01,188681,Staff,3,0,35,32
1683677108244,MATH 103B,B01,188692,Staff,5,0,35,30
1683677109268,MATH 109,A01,188695,Salehi Golsefidy; Alireza,24,0,35,11
1683677109268,MATH 109,A02,188696,Salehi Golsefidy; Alireza,25,0,35,10
1683677110292,MATH 120A,A01,188698,Eggers; John Dietrich,7,0,35,28
1683677111317,MATH 142B,A01,188736,Ioana; Adrian,1,1,30,29
1683677111317,MATH 142B,A02,188741,Ioana; Adrian,0,1,30,30
1683677111317,MATH 142B,A03,188743,Ioana; Adrian,0,1,30,30
1683677112346,MATH 168A,A01,188790,Staff,0,11,35,35
1683677113371,MATH 170A,A01,188803,Nie; Jiawang,0,2,35,35
1683677113371,MATH 170A,A02,188811,Nie; Jiawang,0,1,35,35
1683677113371,MATH 170A,A03,188814,Nie; Jiawang,0,0,35,35
1683677113371,MATH 170A,A04,188815,Nie; Jiawang,5,0,35,30
1683677114398,MATH 193B,A01,188817,Staff,0,0,35,35
1683677114398,MATH 193B,A02,188818,Staff,5,0,35,30
1683677115422,MGT 4,A01,202857,Anderson; John Charles,60,0,80,20
1683677116447,MGT 12,A00,202858,Lindenberger; Wade Douglas,40,0,90,50
1683677117471,MGT 18,A00,202859,Staff,74,0,90,16
1683677118495,MGT 18GS,A00,202860,McKay; Michael J,13,0,28,15
1683677119520,MGT 45,A00,202861,Pecore; Joseph P.,9,0,90,81
1683677120546,MGT 100,A00,202863,Yavorsky; Daniel Ryan,28,0,90,62
1683677121570,MGT 103,A00,202864,Ehrich; Kristine R,0,18,90,90
1683677122598,MGT 112,A00,202865,Ehrich; Kristine R,15,0,90,75
1683677123623,MGT 121A,A00,202868,Staff,90,20,90,0
1683677124647,MGT 131B,A00,202869,Anderson; John Charles,59,0,90,31
1683677125674,MGT 136,A00,202871,Lindenberger; Wade Douglas,83,0,90,7
1683677126701,MGT 164,A00,202873,Staff,0,67,90,91
1683677127728,MGT 164GS,A00,202874,McKay; Mary A,13,0,28,15
1683677128755,MGT 180,A00,202875,Staff,0,51,90,91
1683677129780,MMW 11R,A01,205019,Herbst; Matthew,0,0,30,30
1683677129780,MMW 11R,A02,205026,Herbst; Matthew,29,0,30,1
1683677130806,MMW 15,A01,193512,Chang; Edmond Yi-Teh,0,8,28,28
1683677130806,MMW 15,A02,193513,Chang; Edmond Yi-Teh,0,5,28,28
1683677130806,MMW 15,A03,193514,Chang; Edmond Yi-Teh,0,5,28,28
1683677130806,MMW 15,A04,193515,Chang; Edmond Yi-Teh,0,5,28,28
1683677130806,MMW 15,A05,193516,Chang; Edmond Yi-Teh,0,5,28,28
1683677130806,MMW 15,A06,193517,Chang; Edmond Yi-Teh,0,6,28,28
1683677130806,MMW 15,B01,193519,Chang; Edmond Yi-Teh,0,5,28,28
1683677130806,MMW 15,B02,193520,Chang; Edmond Yi-Teh,0,5,28,28
1683677130806,MMW 15,B03,193521,Chang; Edmond Yi-Teh,0,5,28,28
1683677130806,MMW 15,B04,193522,Chang; Edmond Yi-Teh,0,5,28,28
1683677130806,MMW 15,B05,193523,Chang; Edmond Yi-Teh,0,5,28,28
1683677130806,MMW 15,B06,193524,Chang; Edmond Yi-Teh,0,5,28,28
1683677131831,MMW 122,A01,193526,Rahimi; Babak,0,16,28,28
1683677131831,MMW 122,A02,193527,Rahimi; Babak,0,15,28,28
1683677131831,MMW 122,A03,193528,Rahimi; Babak,0,0,0,0
1683677131831,MMW 122,A04,193529,Rahimi; Babak,0,0,0,0
1683677132859,MUS 1A,A01,186663,Staff,1,19,35,34
1683677133886,MUS 4,A01,186715,Staff,0,12,35,35
1683677134912,MUS 5R,A01,186796,Dubnov; Shlomo,0,17,35,35
1683677135935,MUS 6,A01,186798,Staff,0,5,25,25
1683677136959,MUS 7,A01,186830,Staff,11,0,35,24
1683677137984,MUS 8,A01,186930,Staff,0,27,35,35
1683677139013,MUS 15,A01,186932,Staff,0,15,35,35
1683677139013,MUS 15,B01,186934,Staff,1,17,35,34
1683677140041,MUS 80,A00,186935,Staff,0,0,20,20
1683677140041,MUS 80,B00,186936,Staff,24,0,25,1
1683677141070,NANO 11,A00,204702,Lipomi; Darren John,0,0,0,0
1683677142097,NANO 15,A01,204709,Yang; Kesong,0,1,0,0
1683677143121,NANO 114,A00,202069,Jahed Motlagh; Zeinab,3,0,10,7
1683677144149,PHIL 1,A00,186955,Grush; Rick Scott,31,0,40,9
1683677145174,PHIL 10,A01,186973,Grush; Rick Scott,27,0,35,8
1683677145174,PHIL 10,A02,186974,Grush; Rick Scott,33,0,35,2
1683677146198,PHIL 13,A01,186976,Staff,3,0,35,32
1683677146198,PHIL 13,A02,186977,Staff,16,0,35,19
1683677147228,PHIL 14,A01,186979,Staff,31,0,35,4
1683677147228,PHIL 14,A02,186986,Staff,32,0,35,3
1683677148255,PHIL 28,A01,186988,Staff,16,0,30,14
1683677148255,PHIL 28,A02,186989,Staff,1,0,30,29
1683677148255,PHIL 28,A03,186990,Staff,10,0,30,20
1683677148255,PHIL 28,A04,186991,Staff,26,0,30,4
1683677149284,PHIL 120,A00,186997,Staff,23,0,40,17
1683677150311,PHIL 137,A00,187003,Staff,7,0,40,33
1683677151342,PHIL 150,A00,187015,Staff,47,0,70,23
1683677152370,PHIL 167,A00,187021,Lamey; Andy M.,34,0,40,6
1683677153398,PHIL 174,A01,202226,Staff,17,0,20,3
1683677153398,PHIL 174,A02,202235,Staff,20,0,20,0
1683677154426,PHIL 191A,A00,258918,Staff,0,0,1,1
1683677155452,PHYS 1A,A00,187028,Staff,26,0,60,34
1683677156480,PHYS 1AL,001,187036,Staff,3,0,30,27
1683677156480,PHYS 1AL,002,187049,Staff,18,0,30,12
1683677157505,PHYS 1B,A00,187058,Staff,22,0,60,38
1683677158535,PHYS 1BL,001,187064,Staff,0,1,30,30
1683677158535,PHYS 1BL,002,187070,Staff,4,0,30,26
1683677159568,PHYS 1C,A00,187082,Staff,29,0,120,91
1683677160598,PHYS 1CL,001,187088,Staff,0,9,30,30
1683677160598,PHYS 1CL,002,187089,Staff,0,1,30,30
1683677160598,PHYS 1CL,009,262693,Staff,9,0,30,21
1683677161624,PHYS 2B,A01,187097,Staff,55,0,115,60
1683677162650,PHYS 2C,A01,187099,Staff,63,0,115,52
1683677163676,PHYS 2CL,A01,187101,Staff,5,0,28,23
1683677163676,PHYS 2CL,A02,187102,Staff,15,0,28,13
1683677164703,PHYS 2D,A01,187123,Shotwell; Brian,95,0,115,20
1683677165732,PHYS 4B,A01,187133,Grinstein; Benjamin,35,0,50,15
1683677166760,POLI 10,A00,188819,Staff,0,4,50,50
1683677167787,POLI 11,A00,188827,Staff,43,0,50,7
1683677168814,POLI 13R,A00,188828,Staff,0,1,20,20
1683677169839,POLI 27,A01,188830,Elgin; Samuel Zincke,0,2,70,70
1683677170866,POLI 30,A00,188832,Desposato; Scott,30,0,50,20
1683677171895,POLI 102F,A00,188834,Staff,0,0,40,40
1683677172921,POLI 104A,A00,188852,Staff,12,0,30,18
1683677173950,POLI 104I,A00,188853,Staff,0,8,20,20
1683677174974,POLI 110B,A00,188854,Wiens; David,6,0,20,14
1683677176002,POLI 112A,A00,188855,Wiens; David,3,0,30,27
1683677177028,POLI 117R,A00,188856,Forman; Fonna,0,12,20,20
1683677178057,POLI 118,A00,188857,Ingham; Sean,8,0,20,12
1683677179085,POLI 120G,A00,188858,Staff,8,0,30,22
1683677180110,POLI 131CR,A00,188863,Hoston; Germaine,20,0,50,30
1683677181136,POLI 133,A00,188864,Nellis; Gareth Hb,44,0,50,6
1683677182163,POLI 134D,A00,188865,Desposato; Scott,27,0,30,3
1683677183187,POLI 142A,A00,188871,Gartzke; Erik,21,0,50,29
1683677184215,POLI 142K,A00,188874,Staff,38,0,50,12
1683677185242,POLI 143,A00,188940,Gartzke; Erik,16,0,30,14
1683677186265,POLI 153,A00,188943,Staff,2,0,20,18
1683677187290,POLI 160AA,A00,188944,Staff,10,0,40,30
1683677188313,POLI 170A,A00,188945,Staff,10,0,30,20
1683677190363,PSYC 1,A00,188952,Staff,36,0,90,54
1683677191394,PSYC 2,B00,188953,Staff,19,0,35,16
1683677192421,PSYC 6,A00,188970,Staff,47,0,60,13
1683677193450,PSYC 7,A00,188973,Staff,35,0,45,10
1683677194475,PSYC 60,A01,188980,Rickard; Timothy C.,42,0,60,18
1683677195503,PSYC 70,A01,189001,Steiner; Eric Tomas,21,0,45,24
1683677196534,PSYC 100,A00,189005,Lacefield; Katharine I,0,100,120,120
1683677197557,PSYC 102,A00,189008,Staff,7,0,30,23
1683677198584,PSYC 106,B00,189026,Gorman; Michael R.,27,0,60,33
1683677199611,PSYC 114,B01,189033,Winkielman; Piotr,0,31,30,30
1683677200639,PSYC 131,A00,189036,Anagnostaras; Stephan,0,43,60,60
1683677201664,PSYC 136,A00,189041,Lowe; Angela Beth,0,7,25,25
1683677202690,PSYC 137,A00,189057,Winkielman; Piotr,1,37,25,24
1683677203716,PSYC 144,A00,189107,Wixted; John T,0,11,50,50
1683677205766,PSYC 162,A00,189142,Staff,0,9,85,85
1683677206792,PSYC 172,A00,189144,Gorman; Michael R.,0,6,30,30
1683677208917,PSYC 179,A00,189146,Lacefield; Katharine I,0,87,120,120
1683677209945,PSYC 181,A00,189147,Anagnostaras; Stephan,0,44,90,90
1683677210973,PSYC 190R,A00,189148,Barner; David A.,0,23,80,80
1683677212000,PSYC 191,A00,189275,Rickard; Timothy C.,0,10,25,25
1683677213025,PSYC 193,A00,189276,Chapman; Eddie Nathaniel,0,1,0,4
1683677214050,PSYC 193L,A01,189281,Lowe; Angela Beth,8,0,20,12
1683677214050,PSYC 193L,B01,189285,Staff,28,0,35,7
1683677215075,RELI 149,A00,187137,Rahimi; Babak,7,0,40,33
1683677216126,SE 9,A01,187315,Staff,0,2,18,18
1683677217156,SE 101B,A00,187409,Staff,24,0,30,6
1683677218184,SE 110B,A00,187444,Staff,10,0,40,30
1683677219211,SE 130B,A00,187449,Staff,31,0,40,9
1683677220234,SE 150A,A00,187516,Staff,8,0,20,12
1683677221258,SE 154,A00,187528,Staff,29,0,50,21
1683677222281,SIO 3,A01,258171,Staff,35,0,40,5
1683677223310,SIO 10,A00,187144,Cook; Geoffrey W,1,7,75,74
1683677224342,SIO 45,A00,187152,Cook; Geoffrey W,0,7,100,100
1683677225370,SIO 109R,A00,194486,Staff,0,4,20,20
1683677227420,SIO 187,A01,187233,Kacev; David,12,0,40,28
1683677228445,SOCI 1,A01,258656,Thorpe; Charles Robert,28,0,30,2
1683677228445,SOCI 1,A02,258658,Thorpe; Charles Robert,30,0,30,0
1683677228445,SOCI 1,A03,258661,Thorpe; Charles Robert,25,0,25,0
1683677228445,SOCI 1,A04,258666,Thorpe; Charles Robert,22,0,25,3
1683677228445,SOCI 1,A05,258897,Thorpe; Charles Robert,22,0,25,3
1683677228445,SOCI 1,A06,258898,Thorpe; Charles Robert,25,0,25,0
1683677229471,SOCI 30,A01,258903,Pardo Guerra; Juan Pablo,14,0,30,16
1683677230497,SOCI 102,A00,258904,Staff,9,0,25,16
1683677231524,SOCI 106,A00,258905,Staff,19,0,25,6
1683677232551,SOCI 111,A00,258907,Ribas Norris; Janet Vanesa,26,0,30,4
1683677233579,SOCI 121R,A00,258908,Pardo Guerra; Juan Pablo,8,0,30,22
1683677234606,SOCI 126,A01,203330,Staff,14,0,20,6
1683677235631,SOCI 131,A00,258909,Thorpe; Charles Robert,30,0,60,30
1683677236657,SOCI 135,A00,258910,Payne; Christine Anna,0,12,30,30
1683677237687,SOCI 157,A00,258911,Staff,11,0,30,19
1683677238711,SOCI 184,A00,258912,Staff,25,0,30,5
1683677239735,SOCI 188D,A00,258913,Staff,22,0,30,8
1683677240764,SYN 2,001,187529,Staff,9,0,16,7
1683677240764,SYN 2,002,201452,Staff,1,20,16,15
1683677240764,SYN 2,003,201469,Staff,1,0,16,15
1683677241793,SYN 100,A01,187531,Staff,0,9,20,20
1683677241793,SYN 100,B01,201491,Staff,0,10,20,20
1683677242819,TDAC 1,A00,189286,Walsh; Kim C.,3,0,20,17
1683677242819,TDAC 1,B00,189287,Harting; Carla Kelso,10,0,20,10
1683677243842,TDAC 101,A00,189300,Walsh; Kim C.,16,0,20,4
1683677243842,TDAC 101,B00,189301,Harting; Carla Kelso,18,0,20,2
1683677244865,TDAC 102,A00,189304,Basso; Beatrice,14,0,20,6
1683677245893,TDAC 108,A00,189305,Staff,18,0,20,2
1683677246922,TDDE 131,A00,189310,Staff,19,0,20,1
1683677246922,TDDE 131,B00,189314,Staff,19,0,20,1
1683677246922,TDDE 131,C00,189315,Staff,48,0,50,2
1683677246922,TDDE 131,D00,189316,Staff,14,0,15,1
1683677246922,TDDE 131,E00,204841,Staff,20,0,20,0
1683677247950,TDGE 10,A00,189289,Staff,27,0,50,23
1683677247950,TDGE 10,B00,189290,Havis; Allan,0,1,50,50
1683677248978,TDGE 11,A00,189291,Fulton; Julia,0,4,50,50
1683677248978,TDGE 11,B00,189292,Staff,20,0,25,5
1683677248978,TDGE 11,C00,260270,Staff,0,0,0,0
1683677250005,TDGE 25,A00,189294,Staff,1,0,20,19
1683677251032,TDGE 124,A00,189318,Fulton; Julia,0,8,50,50
1683677252057,TDGE 125,A00,189319,Staff,13,0,25,12
1683677252057,TDGE 125,B00,189320,Staff,23,0,25,2
1683677253081,TDGE 127,A00,189322,Havis; Allan,0,0,50,50
1683677254109,TDHT 101,A00,189323,Staff,18,0,25,7
1683677254109,TDHT 101,B00,189324,Staff,25,0,25,0
1683677255137,TDHT 102,A00,189325,Staff,49,0,50,1
1683677256162,TDMV 1,A00,189295,Arcidiacono; Kristin,20,0,30,10
1683677256162,TDMV 1,B00,189296,Caligagan; Maria T.,24,0,30,6
1683677257187,TDMV 2,A00,189297,Sammartano; Tonnie,27,0,30,3
1683677257187,TDMV 2,B00,189299,Arcidiacono; Kristin,23,0,30,7
1683677258215,TDMV 3,A00,204998,Rincon; Alicia,22,0,30,8
1683677259241,TDMV 120,A00,189458,Sammartano; Tonnie,28,0,30,2
1683677260268,TDMV 138,A00,189541,Jun; Grace Shin Hae,20,0,40,20
1683677261296,TDMV 142,A00,189717,Caligagan; Tony,25,0,30,5
1683677261296,TDMV 142,B00,189718,Caligagan; Maria T.,25,0,30,5
1683677262331,TMC 2,A01,187533,Staff,25,0,25,0
1683677262331,TMC 2,A02,187534,Staff,25,0,25,0
1683677263359,USP 1,A01,187536,Kwak; Nancy,0,16,25,25
1683677264387,USP 5,A01,187538,Staff,8,0,25,17
1683677265415,USP 101,A00,199253,Staff,0,4,0,0
1683677266442,USP 124,A00,187562,Boomhower; Matthew Charles,0,0,30,30
1683677267471,USP 138,A00,187582,Staff,19,0,25,6
1683677268496,USP 152,A01,187597,Staff,3,0,25,22
1683677269521,USP 153,A00,187598,Staff,19,0,25,6
1683677270546,USP 168,A00,187607,Kwak; Nancy,2,0,5,3
1683677271569,USP 173,A00,187619,Staff,4,0,25,21
1683677272593,USP 181,A00,187638,Staff,0,4,25,25
1683677273622,VIS 103,A00,187650,Cruz; Edwin Teddy,17,0,75,58
1683677274647,VIS 110D,A00,187669,Staff,13,0,22,9
1683677275676,VIS 127C,A00,187720,Shen; Kuiyi,67,0,146,79
1683677276702,VIS 149,A00,187731,Yoldas; Pinar,1,14,22,21
1683677277728,VIS 151,A01,188091,Staff,22,0,34,12
1683677277728,VIS 151,A02,188092,Staff,11,0,34,23
1683677278755,VIS 160B,A00,188093,Stalbaum; Brett,0,1,10,10
1683677280802,WCWP 10B,A00,201720,Staff,0,0,5,5
1683677280802,WCWP 10B,B00,201722,Staff,0,0,6,6
1683677281829,WCWP 100,A00,201725,Gagnon; Jeffrey C,0,0,2,2
1683677281829,WCWP 100,B00,201727,Staff,0,4,15,15
1683677284922,ANBI 133,A00,258401,Wilder; Linnea Lorene,34,0,40,6
1683677285947,ANBI 140,A00,258395,Hrvoj Mihic; Branka,18,0,25,7
1683677286973,ANSC 120,A00,258402,Bialecki; Jon Anthony,26,0,40,14
1683677288000,ANSC 144,A00,258400,Staff,12,0,40,28
1683677290053,ANSC 166,A00,258396,Parish; Steven Martin,156,0,175,19
1683677301778,ANSC 180,A00,193533,Staff,8,0,20,12
1683677302803,ANSC 188,A00,258397,Jassal; Aftab,34,0,40,6
1683677303827,ANTH 3,A01,258316,Staff,23,0,30,7
1683677304851,ANTH 5,A00,258394,Semendeferi; Ekaterini,16,0,20,4
1683677305878,ANTH 21,A01,258331,Staff,4,0,40,36
1683677306902,ANTH 103,A00,258398,Varma; Saiba,15,0,25,10
1683677307930,AWP 10,001,202034,Staff,0,0,0,0
1683677307930,AWP 10,002,202035,Staff,0,0,0,0
1683677307930,AWP 10,003,202036,Staff,0,0,0,0
1683677307930,AWP 10,004,202037,Staff,0,0,0,0
1683677307930,AWP 10,005,202038,Staff,0,0,0,0
1683677307930,AWP 10,006,202039,Staff,0,0,0,0
1683677307930,AWP 10,007,202040,Staff,0,0,0,0
1683677307930,AWP 10,008,202041,Staff,0,0,0,0
1683677307930,AWP 10,009,202042,Staff,0,0,0,0
1683677307930,AWP 10,010,202043,Staff,0,0,0,0
1683677307930,AWP 10,011,202044,Staff,0,0,0,0
1683677307930,AWP 10,012,202045,Staff,0,0,0,0
1683677307930,AWP 10,013,202046,Staff,0,0,0,0
1683677307930,AWP 10,014,202047,Staff,0,0,0,0
1683677307930,AWP 10,015,202048,Staff,0,0,0,0
1683677307930,AWP 10,016,202049,Staff,0,0,0,0
1683677307930,AWP 10,017,202050,Staff,0,0,0,0
1683677307930,AWP 10,018,202051,Staff,0,0,0,0
1683677307930,AWP 10,019,202052,Staff,0,0,0,0
1683677307930,AWP 10,020,202053,Staff,0,0,0,0
1683677307930,AWP 10,021,202054,Staff,0,0,0,0
1683677307930,AWP 10,022,202055,Staff,0,0,0,0
1683677307930,AWP 10,023,202056,Staff,0,0,0,0
1683677307930,AWP 10,024,202057,Staff,0,0,0,0
1683677307930,AWP 10,025,202058,Staff,0,0,0,0
1683677307930,AWP 10,026,202059,Staff,0,0,0,0
1683677308959,AWP 102,001,202032,Staff,0,0,0,0
1683677308959,AWP 102,002,202033,Staff,0,0,0,0
1683677309985,BENG 100,A01,254234,Taylor Amos; Alyssa C,31,0,40,9
1683677311010,BENG 196,001,270013,Engler; Adam J.,9999,0,9999,0
1683677312040,BICD 100R,A01,202018,Smith; Laurie,0,7,32,32
1683677312040,BICD 100R,A02,202019,Smith; Laurie,0,3,32,32
1683677312040,BICD 100R,A03,202020,Smith; Laurie,0,1,32,32
1683677312040,BICD 100R,A04,202021,Smith; Laurie,6,0,32,26
1683677312040,BICD 100R,A05,202022,Smith; Laurie,10,0,32,22
1683677313070,BICD 136,A01,193242,Gustafson-Brown; Cindy,0,2,32,32
1683677313070,BICD 136,A02,193244,Gustafson-Brown; Cindy,13,0,32,19
1683677314097,BIEB 102,A01,193249,Butler; Shannon Rhey,1,1,32,31
1683677314097,BIEB 102,A02,193251,Butler; Shannon Rhey,0,0,32,32
1683677314097,BIEB 102,A03,193253,Butler; Shannon Rhey,0,0,32,32
1683677314097,BIEB 102,A04,193255,Butler; Shannon Rhey,13,0,32,19
1683677314097,BIEB 102,A05,193265,Butler; Shannon Rhey,25,0,32,7
1683677314097,BIEB 102,A06,193269,Butler; Shannon Rhey,13,0,32,19
1683677316161,BIEB 150,A01,193274,Staff,0,0,32,32
1683677316161,BIEB 150,A02,193285,Staff,24,0,32,8
1683677317185,BIEB 194,A00,193286,Kurle; Carolyn M.,19,0,32,13
1683677318209,BILD 1,A01,192291,Staff,15,0,32,17
1683677318209,BILD 1,A02,192292,Staff,30,0,32,2
1683677318209,BILD 1,B01,192520,Reuther; Keefe,0,1,0,0
1683677318209,BILD 1,B02,192532,Reuther; Keefe,0,1,0,0
1683677319238,BILD 3,A01,192556,Butler; Shannon Rhey,0,0,32,32
1683677319238,BILD 3,A02,192581,Butler; Shannon Rhey,0,1,32,32
1683677319238,BILD 3,A03,192611,Butler; Shannon Rhey,19,0,32,13
1683677319238,BILD 3,A04,192612,Butler; Shannon Rhey,24,0,32,8
1683677319238,BILD 3,A05,192613,Butler; Shannon Rhey,26,0,32,6
1683677319238,BILD 3,A06,192679,Butler; Shannon Rhey,27,0,32,5
1683677319238,BILD 3,A07,192682,Butler; Shannon Rhey,20,0,32,12
1683677320263,BILD 4,A01,192836,Reuther; Keefe,1,0,24,23
1683677320263,BILD 4,A02,193044,Reuther; Keefe,4,0,24,20
1683677321287,BILD 10,A01,193142,Gustafson-Brown; Cindy,29,0,32,3
1683677321287,BILD 10,A02,193149,Gustafson-Brown; Cindy,31,0,32,1
1683677322366,BIMM 100,A01,193301,Staff,0,6,32,32
1683677322366,BIMM 100,A02,193312,Staff,0,7,32,32
1683677322366,BIMM 100,A03,193323,Staff,0,10,32,32
1683677323391,BIMM 101,A01,193329,McDonnell; Lisa Marie,1,4,24,23
1683677323391,BIMM 101,A02,193339,McDonnell; Lisa Marie,1,4,24,23
1683677323391,BIMM 101,B01,193354,McDonnell; Lisa Marie,0,4,24,24
1683677323391,BIMM 101,B02,193357,McDonnell; Lisa Marie,0,3,24,24
1683677324419,BIMM 110,A01,193377,Tat; John,0,11,32,32
1683677324419,BIMM 110,A02,193378,Tat; John,0,11,32,32
1683677325468,BIMM 120,A01,206116,Staff,0,0,32,32
1683677325468,BIMM 120,A02,206117,Staff,7,0,32,25
1683677325468,BIMM 120,A03,206121,Staff,21,0,32,11
1683677326497,BIPN 100,A01,193393,Park; Ji Young,0,15,32,32
1683677326497,BIPN 100,A02,193402,Park; Ji Young,0,14,32,32
1683677326497,BIPN 100,A03,193413,Park; Ji Young,0,14,32,32
1683677326497,BIPN 100,A04,193414,Park; Ji Young,0,13,32,32
1683677327526,BIPN 102,A01,193429,Staff,0,0,32,32
1683677327526,BIPN 102,A02,193438,Staff,18,0,32,14
1683677328551,BIPN 106,A01,193450,Reyes Gonzalez; Catalina,0,2,40,40
1683677329581,BIPN 134,A01,193465,Cooke; James Edward,0,0,32,32
1683677329581,BIPN 134,A02,193474,Cooke; James Edward,25,0,32,7
1683677329581,BIPN 134,A03,193485,Cooke; James Edward,29,0,32,3
1683677329581,BIPN 134,A04,193486,Cooke; James Edward,20,0,32,12
1683677329581,BIPN 134,A05,193491,Cooke; James Edward,31,0,32,1
1683677329581,BIPN 134,A06,193501,Cooke; James Edward,30,0,32,2
1683677329581,BIPN 134,A07,193510,Cooke; James Edward,29,0,32,3
1683677331632,BISP 194,A00,222522,Staff,14,0,32,18
1683677332656,CAT 124,A01,202407,Staff,19,0,25,6
1683677333682,CAT 125,A00,202408,Marchisotto; Jennifer Anne,2,0,20,18
1683677334707,CAT 125R,A00,202409,Smith; Lauryn Alissa,0,11,20,20
1683677334707,CAT 125R,B00,202410,Morales; Celeste Georgianna,0,11,20,20
1683677334707,CAT 125R,C00,202411,Irwin; Matthew Joseph,0,12,20,20
1683677335732,CENG 15,A01,204712,Yang; Kesong,0,1,0,0
1683677336755,CENG 114,A00,202070,Jahed Motlagh; Zeinab,5,0,20,15
1683677337783,CGS 105,A00,185477,Wesling; Megan E.,24,0,40,16
1683677338808,CGS 106,A00,185494,Staff,11,0,22,11
1683677339833,CGS 108,A00,185495,Staff,14,0,20,6
1683677340857,CGS 114,A00,185496,Staff,13,0,18,5
1683677341887,CGS 119,A00,185501,Staff,15,0,20,5
1683677342914,CGS 120,A00,185511,Staff,12,0,20,8
1683677343944,CHEM 4,A01,184675,Bussey; Thomas J,97,0,100,3
1683677344969,CHEM 6A,A01,184677,Staff,32,0,60,28
1683677345993,CHEM 6B,A01,184679,Staff,63,0,100,37
1683677347018,CHEM 6C,A01,184681,Bussey; Thomas J,0,0,50,50
1683677347018,CHEM 6C,A02,184682,Bussey; Thomas J,32,0,50,18
1683677348046,CHEM 40A,A01,184684,Albizati; Kim F.,33,0,100,67
1683677349072,CHEM 40B,A01,184686,Albizati; Kim F.,0,22,100,100
1683677350095,CHEM 41B,A01,184690,Staff,51,0,100,49
1683677351120,COGS 3,A01,184715,Boyle; Mary E. T.,0,27,40,40
1683677352149,COGS 14B,A01,185172,Staff,0,14,38,38
1683677353177,COGS 18,A01,184736,Staff,14,0,80,66
1683677354206,COGS 100,A01,184932,Staff,0,8,73,73
1683677355234,COGS 101A,A01,184935,Staff,0,40,30,30
1683677356262,COGS 101B,A01,184944,Staff,0,2,30,30
1683677357286,COGS 101C,A01,184946,Staff,0,10,30,30
1683677358311,COGS 102A,A01,184951,Johnson; Christine M.,2,0,40,38
1683677359338,COGS 107B,A01,184953,Mooshagian; Eric Frederick,0,52,40,40
1683677360362,COGS 118B,A01,184959,Gupta; Anjum,0,50,40,40
1683677361385,COGS 153,A00,184961,Staff,0,16,30,30
1683677362415,COGS 177,A00,184962,Staff,0,21,30,30
1683677363445,COGS 187A,A01,184969,Boyle; Mary E. T.,0,19,40,40
1683677364470,COMM 10,A01,185174,Staff,0,5,25,25
1683677364470,COMM 10,A02,185189,Staff,0,2,25,25
1683677364470,COMM 10,A03,269821,Staff,0,1,0,0
1683677365496,COMM 100B,A01,185475,Staff,0,1,0,1
1683677365496,COMM 100B,A02,185476,Staff,11,0,25,14
1683677366524,COMM 100C,A01,185314,Staff,1,0,25,24
1683677366524,COMM 100C,A02,185327,Staff,17,0,25,8
1683677367550,COMM 110M,A00,185349,Staff,0,0,40,40
1683677368573,COMM 113T,A00,185352,Staff,25,0,40,15
1683677369597,COMM 114I,A00,185353,Staff,31,0,40,9
1683677370623,COMM 131,A00,185354,Staff,17,0,30,13
1683677371648,CSE 8A,A50,185358,Cao; Yingjun,0,46,10,10
1683677372676,CSE 8B,A01,185362,Staff,0,48,50,50
1683677373700,CSE 11,A01,185416,Cao; Yingjun,0,91,10,10
1683677374726,CSE 20,A01,185445,Briones; Jor-el Thomas Caparas,3,0,25,22
1683677375750,CSE 21,A01,185447,Staff,9,0,50,41
1683677376775,CSE 101,A01,185451,Staff,0,13,50,50
1683677376775,CSE 101,B01,185453,Jones; Miles E,0,14,50,50
1683677378832,CSE 141,A01,185458,Eldon; John,16,0,100,84
1683677379856,CSE 141L,A01,185461,Eldon; John,8,0,100,92
1683677380884,CSE 142,A01,185463,Staff,34,0,60,26
1683677380884,CSE 142,B01,201355,Staff,0,7,60,60
1683677381910,CSE 142L,A01,185470,Staff,34,0,60,26
1683677381910,CSE 142L,B01,201417,Staff,0,6,60,60
1683677382938,CSE 190,A00,201433,Staff,32,0,49,17
1683677383962,DOC 1,A01,259136,Strom; Megan C.,7,0,15,8
1683677383962,DOC 1,A02,259137,Strom; Megan C.,14,0,15,1
1683677383962,DOC 1,A03,259138,Strom; Megan C.,14,0,15,1
1683677383962,DOC 1,A04,259139,Strom; Megan C.,14,0,15,1
1683677384991,DOC 100D,A00,259140,Pass; Natalye Joann,14,0,25,11
1683677386015,DSGN 1,A01,184749,Rill; Bryan,0,26,30,30
1683677387039,DSGN 100,A01,185168,Staff,0,2,25,25
1683677388067,ECE 5,A01,185626,Morris; Karcher William,0,12,0,0
1683677389092,ECE 101,A01,185628,Staff,14,0,70,56
1683677390116,ECE 107,A01,185635,Baghdadchi; Saharnaz,0,0,20,20
1683677390116,ECE 107,A02,185638,Baghdadchi; Saharnaz,1,0,20,19
1683677391141,ECE 148,A01,185647,Silberman; Jack,0,0,16,16
1683677392165,ECON 1,A01,185537,Crane; Meredith Helen,54,0,70,16
1683677393189,ECON 3,A01,185549,Crane; Meredith Helen,29,0,70,41
1683677394218,ECON 4,A01,203354,Anderson; John Charles,0,5,10,10
1683677395247,ECON 100A,A01,185574,Staff,0,5,40,40
1683677396275,ECON 100B,A01,185576,Staff,0,12,50,50
1683677397300,ECON 100C,A01,185589,Newhouse; Herbert S,30,0,70,40
1683677398325,ECON 105,A00,185608,Vespa; Emanuel Ignacio,19,0,35,16
1683677399350,ECON 109,A01,185610,Shishkin; Denis,9,0,35,26
1683677400374,ECON 110A,A01,185612,Staff,9,0,40,31
1683677401397,ECON 120A,A01,185615,Staff,19,0,40,21
1683677402426,ECON 120C,A01,185617,Sun; Yixiao,0,21,70,70
1683677403452,ECON 144,A00,203346,Squires; Dale E,2,0,35,33
1683677404476,ECON 171,A01,203349,Newhouse; Herbert S,0,1,35,35
1683677405505,ECON 173A,A01,185621,Toda; Alexis Akira,21,0,35,14
1683677406531,EDS 25,A01,202413,Staff,0,1,0,0
1683677406531,EDS 25,A02,202414,Staff,0,1,0,0
1683677406531,EDS 25,A03,202415,Staff,0,0,0,0
1683677406531,EDS 25,A04,202416,Staff,0,1,0,0
1683677406531,EDS 25,A05,202439,Staff,0,0,0,0
1683677406531,EDS 25,A06,202440,Staff,0,0,0,0
1683677406531,EDS 25,B01,202631,Staff,0,0,0,0
1683677406531,EDS 25,B02,202632,Staff,0,0,0,0
1683677406531,EDS 25,B03,202639,Staff,0,0,0,0
1683677406531,EDS 25,B04,202640,Staff,0,0,0,0
1683677406531,EDS 25,B05,202643,Staff,0,0,0,0
1683677406531,EDS 25,B06,202644,Staff,0,0,0,0
1683677407561,EDS 38,A01,202659,Black; Alison Michelle,24,0,25,1
1683677408590,EDS 115,A00,202652,Staff,18,0,30,12
1683677409620,EDS 125,A00,202649,Staff,13,0,30,17
1683677410650,EDS 126,A01,203332,Staff,30,0,30,0
1683677411674,EDS 139,A00,202838,Staff,16,0,25,9
1683677412698,EDS 146,A01,202655,Staff,14,0,25,11
1683677413721,ENG 15,A00,185667,Staff,0,1,0,0
1683677413721,ENG 15,B00,185672,Staff,0,0,0,0
1683677413721,ENG 15,C00,185675,Staff,0,0,0,0
1683677413721,ENG 15,D00,185682,Staff,0,0,0,0
1683677413721,ENG 15,E00,185684,Staff,0,0,0,0
1683677414744,ETHN 103,A00,185710,Staff,0,8,35,35
1683677415767,ETHN 103A,A00,199228,Man; Simeon S,0,0,9,9
1683677416791,ETHN 109,A00,185711,Staff,15,0,35,20
1683677417815,ETHN 142,A00,185726,Staff,0,4,30,30
1683677418843,ETHN 163J,A00,199229,Man; Simeon S,5,0,8,3
1683677419868,ETHN 168,A00,185727,Staff,7,0,10,3
1683677420896,ETHN 182,A00,185728,Staff,0,0,35,35
1683677421921,ETHN 183,A00,185737,Staff,9,0,18,9
1683677422947,GLBH 111,A01,209361,Burgos; Jose L.,0,0,0,0
1683677425002,HIEU 104,A00,185792,Staff,14,0,20,6
1683677426086,HIEU 115,A00,185800,Staff,0,0,20,20
1683677427117,HIEU 128,A00,185801,Staff,0,9,20,20
1683677428141,HIEU 147,A00,185802,Staff,15,0,20,5
1683677429170,HIEU 154,A00,185823,Staff,11,0,20,9
1683677430200,HILA 102,A00,185826,Staff,14,0,20,6
1683677431224,HILD 2C,A01,185778,Staff,0,13,20,20
1683677432251,HILD 7B,A01,185780,Kwak; Nancy,0,17,32,32
1683677432251,HILD 7B,A02,185781,Kwak; Nancy,0,18,32,32
1683677433283,HILD 30,A01,185791,Staff,12,0,20,8
1683677434312,HISC 119,A00,185830,Golan; Tal,0,9,20,20
1683677435338,HITO 156GS,A00,185831,Patterson; Patrick H.,0,0,0,23
1683677436363,HIUS 103,A00,185832,Man; Simeon S,0,4,20,20
1683677437390,HIUS 117,A00,185836,Kwak; Nancy,2,0,20,18
1683677438414,HIUS 125,A00,185840,Man; Simeon S,0,2,23,23
1683677439437,HIUS 149,A00,185845,Staff,1,0,20,19
1683677440463,HUM 3,A01,185882,Zavodny; Tatiana Sophia,0,8,50,50
1683677440463,HUM 3,B01,185899,Caldwell; Michael Alan,0,18,50,50
1683677441487,HUM 3GS,A00,185900,Patterson; Patrick H.,0,0,0,23
1683677442512,HUM 4,A01,185938,Zroka; Amy Liane,28,0,50,22
1683677442512,HUM 4,B01,185956,Watkins; Eric,0,6,50,50
1683677442512,HUM 4,B02,202209,Watkins; Eric,0,5,50,50
1683677442512,HUM 4,B03,202210,Watkins; Eric,0,5,50,50
1683677443546,HUM 5,A01,185958,West; Geoffrey Scott,0,0,50,50
1683677443546,HUM 5,A02,202215,West; Geoffrey Scott,0,0,50,50
1683677444570,INTL 190,A00,185959,Gagnon; Jeffrey C,0,0,0,9
1683677444570,INTL 190,B00,185960,Lettieri; Michael Joseph,0,0,0,2
1683677445597,JAPN 180,A00,254509,Staff,5,0,30,25
1683677446632,LATI 10,A01,202853,Kennemore; Amy Michelle,4,0,35,31
1683677446632,LATI 10,A02,202854,Kennemore; Amy Michelle,3,0,35,32
1683677446632,LATI 10,A03,270054,Kennemore; Amy Michelle,30,0,30,0
1683677447660,LATI 180,A00,202855,Kennemore; Amy Michelle,11,0,20,9
1683677448685,LAWS 101,A00,201767,Golan; Tal,0,7,40,40
1683677449710,LIFR 1C,A00,185961,Staff,6,0,20,14
1683677450735,LIFR 1CX,A00,185962,Staff,7,0,20,13
1683677451772,LIFR 1D,A00,185963,Staff,7,0,20,13
1683677452801,LIFR 1DX,A00,185964,Staff,7,0,20,13
1683677453832,LIGN 101,A01,186039,Staff,43,0,50,7
1683677454859,LIGN 165,A00,186040,Staff,15,0,50,35
1683677455887,LTCS 108,A00,186041,Staff,5,0,10,5
1683677456917,LTCS 119,A00,186042,Staff,15,0,20,5
1683677457944,LTCS 130,A00,186043,Wesling; Megan E.,15,0,25,10
1683677459995,LTEA 138,A00,186119,Staff,14,0,40,26
1683677461022,LTEN 124,A00,186148,Staff,5,0,25,20
1683677462046,LTEN 178,A00,186149,Staff,7,0,15,8
1683677463072,LTEN 181,A00,186150,Blanco; John D,34,0,40,6
1683677464099,LTWL 120,A00,186160,Staff,19,0,25,6
1683677465126,LTWL 165,A00,186161,Staff,22,0,25,3
1683677466150,LTWR 100,A00,186162,Staff,0,5,15,15
1683677467174,LTWR 102,A00,186163,Doller; Ben,5,0,15,10
1683677468200,MAE 8,A01,186412,Staff,0,1,0,0
1683677469229,MAE 30B,A00,186445,Bahadori; Mohammad Yousef,82,0,100,18
1683677470267,MAE 40,A00,186592,Bewley; Thomas R,10,0,50,40
1683677471292,MAE 101B,A00,186593,Bahadori; Mohammad Yousef,80,0,100,20
1683677472319,MAE 105,A00,186594,Bandaru; Prabhakar,10,0,50,40
1683677473344,MAE 107,A00,186599,Pham; Hieu Tan,0,7,120,120
1683677474371,MAE 148,A01,186660,Silberman; Jack,3,0,16,13
1683677475396,MATH 10A,A01,188095,Staff,0,6,35,35
1683677476421,MATH 10B,A01,188097,Bowers; Adam R.,0,12,30,30
1683677476421,MATH 10B,A02,188099,Bowers; Adam R.,0,11,30,30
1683677476421,MATH 10B,B01,188104,Bowers; Adam R.,0,10,30,30
1683677476421,MATH 10B,B02,188106,Bowers; Adam R.,1,9,30,29
1683677477447,MATH 10C,A01,188111,Staff,0,20,30,30
1683677477447,MATH 10C,A02,188127,Staff,0,19,30,30
1683677477447,MATH 10C,A03,188131,Staff,0,19,30,30
1683677477447,MATH 10C,B01,188218,Staff,17,0,30,13
1683677477447,MATH 10C,B02,188244,Staff,13,0,30,17
1683677477447,MATH 10C,B03,188277,Staff,14,0,30,16
1683677478472,MATH 18,A01,188344,Bach; Quang Tran,18,0,30,12
1683677478472,MATH 18,A02,188345,Bach; Quang Tran,11,0,30,19
1683677478472,MATH 18,B01,188353,Bach; Quang Tran,11,0,30,19
1683677478472,MATH 18,B02,188354,Bach; Quang Tran,19,0,30,11
1683677479500,MATH 20A,A01,188374,Staff,11,0,35,24
1683677480527,MATH 20B,A01,188382,Ohm; Ko Woon,7,0,30,23
1683677480527,MATH 20B,A02,188383,Ohm; Ko Woon,22,0,30,8
1683677480527,MATH 20B,B01,188385,Ohm; Ko Woon,7,0,30,23
1683677480527,MATH 20B,B02,188392,Ohm; Ko Woon,22,0,30,8
1683677481552,MATH 20C,A01,188394,Harel; Guershon,10,0,30,20
1683677481552,MATH 20C,A02,188395,Harel; Guershon,13,0,30,17
1683677481552,MATH 20C,B01,188404,Harel; Guershon,5,0,30,25
1683677481552,MATH 20C,B02,188405,Harel; Guershon,18,0,30,12
1683677482583,MATH 20D,A01,188414,Hammock; Frances H,0,1,30,30
1683677482583,MATH 20D,A02,188415,Hammock; Frances H,0,1,30,30
1683677482583,MATH 20D,B01,188447,Hammock; Frances H,0,1,30,30
1683677482583,MATH 20D,B02,188486,Hammock; Frances H,3,0,30,27
1683677483612,MATH 20E,A01,188649,Staff,21,0,30,9
1683677483612,MATH 20E,A02,188650,Staff,20,0,30,10
1683677483612,MATH 20E,A03,188673,Staff,0,0,30,30
1683677484640,MATH 102,A01,188675,Staff,0,39,35,35
1683677485669,MATH 103B,A01,188681,Staff,3,0,35,32
1683677485669,MATH 103B,B01,188692,Staff,5,0,35,30
1683677486695,MATH 109,A01,188695,Salehi Golsefidy; Alireza,24,0,35,11
1683677486695,MATH 109,A02,188696,Salehi Golsefidy; Alireza,25,0,35,10
1683677487719,MATH 120A,A01,188698,Eggers; John Dietrich,7,0,35,28
1683677488745,MATH 142B,A01,188736,Ioana; Adrian,1,1,30,29
1683677488745,MATH 142B,A02,188741,Ioana; Adrian,0,1,30,30
1683677488745,MATH 142B,A03,188743,Ioana; Adrian,0,1,30,30
1683677489770,MATH 168A,A01,188790,Staff,0,11,35,35
1683677490795,MATH 170A,A01,188803,Nie; Jiawang,0,2,35,35
1683677490795,MATH 170A,A02,188811,Nie; Jiawang,0,1,35,35
1683677490795,MATH 170A,A03,188814,Nie; Jiawang,0,0,35,35
1683677490795,MATH 170A,A04,188815,Nie; Jiawang,6,0,35,29
1683677491819,MATH 193B,A01,188817,Staff,0,0,35,35
1683677491819,MATH 193B,A02,188818,Staff,5,0,35,30
1683677492844,MGT 4,A01,202857,Anderson; John Charles,60,0,80,20
1683677493873,MGT 12,A00,202858,Lindenberger; Wade Douglas,40,0,90,50
1683677494901,MGT 18,A00,202859,Staff,74,0,90,16
1683677495925,MGT 18GS,A00,202860,McKay; Michael J,13,0,28,15
1683677496949,MGT 45,A00,202861,Pecore; Joseph P.,9,0,90,81
1683677497978,MGT 100,A00,202863,Yavorsky; Daniel Ryan,28,0,90,62
1683677499002,MGT 103,A00,202864,Ehrich; Kristine R,0,18,90,90
1683677500027,MGT 112,A00,202865,Ehrich; Kristine R,15,0,90,75
1683677501052,MGT 121A,A00,202868,Staff,90,20,90,0
1683677502081,MGT 131B,A00,202869,Anderson; John Charles,59,0,90,31
1683677503105,MGT 136,A00,202871,Lindenberger; Wade Douglas,83,0,90,7
1683677504133,MGT 164,A00,202873,Staff,0,67,90,91
1683677505157,MGT 164GS,A00,202874,McKay; Mary A,13,0,28,15
1683677506180,MGT 180,A00,202875,Staff,0,51,90,91
1683677507208,MMW 11R,A01,205019,Herbst; Matthew,0,0,30,30
1683677507208,MMW 11R,A02,205026,Herbst; Matthew,29,0,30,1
1683677508239,MMW 15,A01,193512,Chang; Edmond Yi-Teh,0,8,28,28
1683677508239,MMW 15,A02,193513,Chang; Edmond Yi-Teh,0,5,28,28
1683677508239,MMW 15,A03,193514,Chang; Edmond Yi-Teh,0,5,28,28
1683677508239,MMW 15,A04,193515,Chang; Edmond Yi-Teh,0,5,28,28
1683677508239,MMW 15,A05,193516,Chang; Edmond Yi-Teh,0,5,28,28
1683677508239,MMW 15,A06,193517,Chang; Edmond Yi-Teh,0,6,28,28
1683677508239,MMW 15,B01,193519,Chang; Edmond Yi-Teh,0,5,28,28
1683677508239,MMW 15,B02,193520,Chang; Edmond Yi-Teh,0,5,28,28
1683677508239,MMW 15,B03,193521,Chang; Edmond Yi-Teh,0,5,28,28
1683677508239,MMW 15,B04,193522,Chang; Edmond Yi-Teh,0,5,28,28
1683677508239,MMW 15,B05,193523,Chang; Edmond Yi-Teh,0,5,28,28
1683677508239,MMW 15,B06,193524,Chang; Edmond Yi-Teh,0,5,28,28
1683677509267,MMW 122,A01,193526,Rahimi; Babak,0,16,28,28
1683677509267,MMW 122,A02,193527,Rahimi; Babak,0,15,28,28
1683677509267,MMW 122,A03,193528,Rahimi; Babak,0,0,0,0
1683677509267,MMW 122,A04,193529,Rahimi; Babak,0,0,0,0
1683677510291,MUS 1A,A01,186663,Staff,1,19,35,34
1683677511315,MUS 4,A01,186715,Staff,0,12,35,35
1683677512344,MUS 5R,A01,186796,Dubnov; Shlomo,0,17,35,35
1683677513368,MUS 6,A01,186798,Staff,0,5,25,25
1683677514393,MUS 7,A01,186830,Staff,11,0,35,24
1683677515421,MUS 8,A01,186930,Staff,0,27,35,35
1683677516450,MUS 15,A01,186932,Staff,0,15,35,35
1683677516450,MUS 15,B01,186934,Staff,1,17,35,34
1683677517480,MUS 80,A00,186935,Staff,0,0,20,20
1683677517480,MUS 80,B00,186936,Staff,24,0,25,1
1683677518505,NANO 11,A00,204702,Lipomi; Darren John,0,0,0,0
1683677519538,NANO 15,A01,204709,Yang; Kesong,0,1,0,0
1683677520563,NANO 114,A00,202069,Jahed Motlagh; Zeinab,3,0,10,7
1683677521593,PHIL 1,A00,186955,Grush; Rick Scott,31,0,40,9
1683677522619,PHIL 10,A01,186973,Grush; Rick Scott,27,0,35,8
1683677522619,PHIL 10,A02,186974,Grush; Rick Scott,33,0,35,2
1683677523646,PHIL 13,A01,186976,Staff,3,0,35,32
1683677523646,PHIL 13,A02,186977,Staff,16,0,35,19
1683677524669,PHIL 14,A01,186979,Staff,31,0,35,4
1683677524669,PHIL 14,A02,186986,Staff,32,0,35,3
1683677525698,PHIL 28,A01,186988,Staff,16,0,30,14
1683677525698,PHIL 28,A02,186989,Staff,1,0,30,29
1683677525698,PHIL 28,A03,186990,Staff,10,0,30,20
1683677525698,PHIL 28,A04,186991,Staff,26,0,30,4
1683677526725,PHIL 120,A00,186997,Staff,23,0,40,17
1683677527756,PHIL 137,A00,187003,Staff,7,0,40,33
1683677528782,PHIL 150,A00,187015,Staff,47,0,70,23
1683677529877,PHIL 167,A00,187021,Lamey; Andy M.,34,0,40,6
1683677530907,PHIL 174,A01,202226,Staff,17,0,20,3
1683677530907,PHIL 174,A02,202235,Staff,20,0,20,0
1683677531937,PHIL 191A,A00,258918,Staff,0,0,1,1
1683677532966,PHYS 1A,A00,187028,Staff,26,0,60,34
1683677533992,PHYS 1AL,001,187036,Staff,3,0,30,27
1683677533992,PHYS 1AL,002,187049,Staff,18,0,30,12
1683677535024,PHYS 1B,A00,187058,Staff,22,0,60,38
1683677536053,PHYS 1BL,001,187064,Staff,0,1,30,30
1683677536053,PHYS 1BL,002,187070,Staff,4,0,30,26
1683677537082,PHYS 1C,A00,187082,Staff,29,0,120,91
1683677538113,PHYS 1CL,001,187088,Staff,0,9,30,30
1683677538113,PHYS 1CL,002,187089,Staff,0,1,30,30
1683677538113,PHYS 1CL,009,262693,Staff,9,0,30,21
1683677539136,PHYS 2B,A01,187097,Staff,55,0,115,60
1683677540161,PHYS 2C,A01,187099,Staff,63,0,115,52
1683677541187,PHYS 2CL,A01,187101,Staff,5,0,28,23
1683677541187,PHYS 2CL,A02,187102,Staff,15,0,28,13
1683677542216,PHYS 2D,A01,187123,Shotwell; Brian,95,0,115,20
1683677543245,PHYS 4B,A01,187133,Grinstein; Benjamin,35,0,50,15
1683677544273,POLI 10,A00,188819,Staff,0,4,50,50
1683677545297,POLI 11,A00,188827,Staff,43,0,50,7
1683677546326,POLI 13R,A00,188828,Staff,0,1,20,20
1683677547356,POLI 27,A01,188830,Elgin; Samuel Zincke,0,2,70,70
1683677548386,POLI 30,A00,188832,Desposato; Scott,30,0,50,20
1683677549416,POLI 102F,A00,188834,Staff,0,0,40,40
1683677550444,POLI 104A,A00,188852,Staff,12,0,30,18
1683677551478,POLI 104I,A00,188853,Staff,0,8,20,20
1683677552503,POLI 110B,A00,188854,Wiens; David,6,0,20,14
1683677553532,POLI 112A,A00,188855,Wiens; David,3,0,30,27
1683677554560,POLI 117R,A00,188856,Forman; Fonna,0,12,20,20
1683677555593,POLI 118,A00,188857,Ingham; Sean,8,0,20,12
1683677556621,POLI 120G,A00,188858,Staff,8,0,30,22
1683677557647,POLI 131CR,A00,188863,Hoston; Germaine,20,0,50,30
1683677558676,POLI 133,A00,188864,Nellis; Gareth Hb,44,0,50,6
1683677559703,POLI 134D,A00,188865,Desposato; Scott,27,0,30,3
1683677560730,POLI 142A,A00,188871,Gartzke; Erik,21,0,50,29
1683677561755,POLI 142K,A00,188874,Staff,38,0,50,12
1683677562784,POLI 143,A00,188940,Gartzke; Erik,16,0,30,14
1683677563810,POLI 153,A00,188943,Staff,2,0,20,18
1683677564838,POLI 160AA,A00,188944,Staff,10,0,40,30
1683677565868,POLI 170A,A00,188945,Staff,10,0,30,20
1683677567924,PSYC 1,A00,188952,Staff,36,0,90,54
1683677568950,PSYC 2,B00,188953,Staff,19,0,35,16
1683677569976,PSYC 6,A00,188970,Staff,47,0,60,13
1683677571022,PSYC 7,A00,188973,Staff,35,0,45,10
1683677572048,PSYC 60,A01,188980,Rickard; Timothy C.,42,0,60,18
1683677573072,PSYC 70,A01,189001,Steiner; Eric Tomas,21,0,45,24
1683677574097,PSYC 100,A00,189005,Lacefield; Katharine I,0,99,120,120
1683677575126,PSYC 102,A00,189008,Staff,7,0,30,23
1683677576154,PSYC 106,B00,189026,Gorman; Michael R.,27,0,60,33
1683677577184,PSYC 114,B01,189033,Winkielman; Piotr,0,31,30,30
1683677578211,PSYC 131,A00,189036,Anagnostaras; Stephan,0,43,60,60
1683677579237,PSYC 136,A00,189041,Lowe; Angela Beth,0,7,25,25
1683677580262,PSYC 137,A00,189057,Winkielman; Piotr,1,37,25,24
1683677581287,PSYC 144,A00,189107,Wixted; John T,0,11,50,50
1683677583346,PSYC 162,A00,189142,Staff,0,9,85,85
1683677584377,PSYC 172,A00,189144,Gorman; Michael R.,0,6,30,30
1683677586437,PSYC 179,A00,189146,Lacefield; Katharine I,0,87,120,120
1683677587467,PSYC 181,A00,189147,Anagnostaras; Stephan,0,44,90,90
1683677588492,PSYC 190R,A00,189148,Barner; David A.,0,23,80,80
1683677589520,PSYC 191,A00,189275,Rickard; Timothy C.,0,10,25,25
1683677590547,PSYC 193,A00,189276,Chapman; Eddie Nathaniel,0,1,0,4
1683677591572,PSYC 193L,A01,189281,Lowe; Angela Beth,8,0,20,12
1683677591572,PSYC 193L,B01,189285,Staff,28,0,35,7
1683677592598,RELI 149,A00,187137,Rahimi; Babak,7,0,40,33
1683677593630,SE 9,A01,187315,Staff,0,2,18,18
1683677594657,SE 101B,A00,187409,Staff,24,0,30,6
1683677595686,SE 110B,A00,187444,Staff,10,0,40,30
1683677596715,SE 130B,A00,187449,Staff,31,0,40,9
1683677597741,SE 150A,A00,187516,Staff,8,0,20,12
1683677598766,SE 154,A00,187528,Staff,29,0,50,21
1683677599791,SIO 3,A01,258171,Staff,35,0,40,5
1683677600825,SIO 10,A00,187144,Cook; Geoffrey W,1,7,75,74
1683677601849,SIO 45,A00,187152,Cook; Geoffrey W,0,7,100,100
1683677602874,SIO 109R,A00,194486,Staff,0,4,20,20
1683677604931,SIO 187,A01,187233,Kacev; David,12,0,40,28
1683677605961,SOCI 1,A01,258656,Thorpe; Charles Robert,28,0,30,2
1683677605961,SOCI 1,A02,258658,Thorpe; Charles Robert,30,0,30,0
1683677605961,SOCI 1,A03,258661,Thorpe; Charles Robert,25,0,25,0
1683677605961,SOCI 1,A04,258666,Thorpe; Charles Robert,22,0,25,3
1683677605961,SOCI 1,A05,258897,Thorpe; Charles Robert,22,0,25,3
1683677605961,SOCI 1,A06,258898,Thorpe; Charles Robert,25,0,25,0
1683677606986,SOCI 30,A01,258903,Pardo Guerra; Juan Pablo,14,0,30,16
1683677608012,SOCI 102,A00,258904,Staff,9,0,25,16
1683677609040,SOCI 106,A00,258905,Staff,19,0,25,6
1683677610071,SOCI 111,A00,258907,Ribas Norris; Janet Vanesa,26,0,30,4
1683677611098,SOCI 121R,A00,258908,Pardo Guerra; Juan Pablo,8,0,30,22
1683677612126,SOCI 126,A01,203330,Staff,14,0,20,6
1683677613154,SOCI 131,A00,258909,Thorpe; Charles Robert,30,0,60,30
1683677614179,SOCI 135,A00,258910,Payne; Christine Anna,0,12,30,30
1683677615207,SOCI 157,A00,258911,Staff,11,0,30,19
1683677616232,SOCI 184,A00,258912,Staff,25,0,30,5
1683677617257,SOCI 188D,A00,258913,Staff,22,0,30,8
1683677618282,SYN 2,001,187529,Staff,9,0,16,7
1683677618282,SYN 2,002,201452,Staff,1,20,16,15
1683677618282,SYN 2,003,201469,Staff,1,0,16,15
1683677619307,SYN 100,A01,187531,Staff,0,9,20,20
1683677619307,SYN 100,B01,201491,Staff,0,10,20,20
1683677620332,TDAC 1,A00,189286,Walsh; Kim C.,3,0,20,17
1683677620332,TDAC 1,B00,189287,Harting; Carla Kelso,10,0,20,10
1683677621362,TDAC 101,A00,189300,Walsh; Kim C.,16,0,20,4
1683677621362,TDAC 101,B00,189301,Harting; Carla Kelso,18,0,20,2
1683677622389,TDAC 102,A00,189304,Basso; Beatrice,14,0,20,6
1683677623413,TDAC 108,A00,189305,Staff,18,0,20,2
1683677624449,TDDE 131,A00,189310,Staff,19,0,20,1
1683677624449,TDDE 131,B00,189314,Staff,19,0,20,1
1683677624449,TDDE 131,C00,189315,Staff,48,0,50,2
1683677624449,TDDE 131,D00,189316,Staff,14,0,15,1
1683677624449,TDDE 131,E00,204841,Staff,20,0,20,0
1683677625474,TDGE 10,A00,189289,Staff,27,0,50,23
1683677625474,TDGE 10,B00,189290,Havis; Allan,0,1,50,50
1683677626507,TDGE 11,A00,189291,Fulton; Julia,0,4,50,50
1683677626507,TDGE 11,B00,189292,Staff,20,0,25,5
1683677626507,TDGE 11,C00,260270,Staff,0,0,0,0
1683677627535,TDGE 25,A00,189294,Staff,1,0,20,19
1683677628565,TDGE 124,A00,189318,Fulton; Julia,0,8,50,50
1683677629592,TDGE 125,A00,189319,Staff,13,0,25,12
1683677629592,TDGE 125,B00,189320,Staff,23,0,25,2
1683677630618,TDGE 127,A00,189322,Havis; Allan,0,0,50,50
1683677631643,TDHT 101,A00,189323,Staff,18,0,25,7
1683677631643,TDHT 101,B00,189324,Staff,25,0,25,0
1683677632673,TDHT 102,A00,189325,Staff,49,0,50,1
1683677633767,TDMV 1,A00,189295,Arcidiacono; Kristin,20,0,30,10
1683677633767,TDMV 1,B00,189296,Caligagan; Maria T.,24,0,30,6
1683677634796,TDMV 2,A00,189297,Sammartano; Tonnie,27,0,30,3
1683677634796,TDMV 2,B00,189299,Arcidiacono; Kristin,23,0,30,7
1683677635825,TDMV 3,A00,204998,Rincon; Alicia,22,0,30,8
1683677636850,TDMV 120,A00,189458,Sammartano; Tonnie,28,0,30,2
1683677637878,TDMV 138,A00,189541,Jun; Grace Shin Hae,20,0,40,20
1683677638907,TDMV 142,A00,189717,Caligagan; Tony,25,0,30,5
1683677638907,TDMV 142,B00,189718,Caligagan; Maria T.,25,0,30,5
1683677639932,TMC 2,A01,187533,Staff,25,0,25,0
1683677639932,TMC 2,A02,187534,Staff,25,0,25,0
1683677640957,USP 1,A01,187536,Kwak; Nancy,0,16,25,25
1683677641981,USP 5,A01,187538,Staff,8,0,25,17
1683677643006,USP 101,A00,199253,Staff,0,4,0,0
1683677644033,USP 124,A00,187562,Boomhower; Matthew Charles,0,0,30,30
1683677645059,USP 138,A00,187582,Staff,19,0,25,6
1683677646089,USP 152,A01,187597,Staff,3,0,25,22
1683677647118,USP 153,A00,187598,Staff,19,0,25,6
1683677648144,USP 168,A00,187607,Kwak; Nancy,2,0,5,3
1683677649169,USP 173,A00,187619,Staff,4,0,25,21
1683677650192,USP 181,A00,187638,Staff,0,4,25,25
1683677651216,VIS 103,A00,187650,Cruz; Edwin Teddy,17,0,75,58
1683677652244,VIS 110D,A00,187669,Staff,13,0,22,9
1683677653272,VIS 127C,A00,187720,Shen; Kuiyi,67,0,146,79
1683677654303,VIS 149,A00,187731,Yoldas; Pinar,1,14,22,21
1683677655329,VIS 151,A01,188091,Staff,22,0,34,12
1683677655329,VIS 151,A02,188092,Staff,11,0,34,23
1683677656354,VIS 160B,A00,188093,Stalbaum; Brett,0,1,10,10
1683677658406,WCWP 10B,A00,201720,Staff,0,0,5,5
1683677658406,WCWP 10B,B00,201722,Staff,0,0,6,6
1683677659434,WCWP 100,A00,201725,Gagnon; Jeffrey C,0,0,2,2
1683677659434,WCWP 100,B00,201727,Staff,0,4,15,15
1683677662535,ANBI 133,A00,258401,Wilder; Linnea Lorene,34,0,40,6
1683677663569,ANBI 140,A00,258395,Hrvoj Mihic; Branka,18,0,25,7
1683677664596,ANSC 120,A00,258402,Bialecki; Jon Anthony,26,0,40,14
1683677665625,ANSC 144,A00,258400,Staff,12,0,40,28
1683677667679,ANSC 166,A00,258396,Parish; Steven Martin,156,0,175,19
1683677668704,ANSC 180,A00,193533,Staff,8,0,20,12
1683677669732,ANSC 188,A00,258397,Jassal; Aftab,34,0,40,6
1683677670758,ANTH 3,A01,258316,Staff,23,0,30,7
1683677671790,ANTH 5,A00,258394,Semendeferi; Ekaterini,16,0,20,4
1683677672815,ANTH 21,A01,258331,Staff,4,0,40,36
1683677673840,ANTH 103,A00,258398,Varma; Saiba,15,0,25,10
1683677674876,AWP 10,001,202034,Staff,0,0,0,0
1683677674876,AWP 10,002,202035,Staff,0,0,0,0
1683677674876,AWP 10,003,202036,Staff,0,0,0,0
1683677674876,AWP 10,004,202037,Staff,0,0,0,0
1683677674876,AWP 10,005,202038,Staff,0,0,0,0
1683677674876,AWP 10,006,202039,Staff,0,0,0,0
1683677674876,AWP 10,007,202040,Staff,0,0,0,0
1683677674876,AWP 10,008,202041,Staff,0,0,0,0
1683677674876,AWP 10,009,202042,Staff,0,0,0,0
1683677674876,AWP 10,010,202043,Staff,0,0,0,0
1683677674876,AWP 10,011,202044,Staff,0,0,0,0
1683677674876,AWP 10,012,202045,Staff,0,0,0,0
1683677674876,AWP 10,013,202046,Staff,0,0,0,0
1683677674876,AWP 10,014,202047,Staff,0,0,0,0
1683677674876,AWP 10,015,202048,Staff,0,0,0,0
1683677674876,AWP 10,016,202049,Staff,0,0,0,0
1683677674876,AWP 10,017,202050,Staff,0,0,0,0
1683677674876,AWP 10,018,202051,Staff,0,0,0,0
1683677674876,AWP 10,019,202052,Staff,0,0,0,0
1683677674876,AWP 10,020,202053,Staff,0,0,0,0
1683677674876,AWP 10,021,202054,Staff,0,0,0,0
1683677674876,AWP 10,022,202055,Staff,0,0,0,0
1683677674876,AWP 10,023,202056,Staff,0,0,0,0
1683677674876,AWP 10,024,202057,Staff,0,0,0,0
1683677674876,AWP 10,025,202058,Staff,0,0,0,0
1683677674876,AWP 10,026,202059,Staff,0,0,0,0
1683677675904,AWP 102,001,202032,Staff,0,0,0,0
1683677675904,AWP 102,002,202033,Staff,0,0,0,0
1683677676931,BENG 100,A01,254234,Taylor Amos; Alyssa C,31,0,40,9
1683677677956,BENG 196,001,270013,Engler; Adam J.,9999,0,9999,0
1683677678983,BICD 100R,A01,202018,Smith; Laurie,0,7,32,32
1683677678983,BICD 100R,A02,202019,Smith; Laurie,0,3,32,32
1683677678983,BICD 100R,A03,202020,Smith; Laurie,0,1,32,32
1683677678983,BICD 100R,A04,202021,Smith; Laurie,6,0,32,26
1683677678983,BICD 100R,A05,202022,Smith; Laurie,10,0,32,22
1683677680013,BICD 136,A01,193242,Gustafson-Brown; Cindy,0,2,32,32
1683677680013,BICD 136,A02,193244,Gustafson-Brown; Cindy,13,0,32,19
1683677681039,BIEB 102,A01,193249,Butler; Shannon Rhey,1,1,32,31
1683677681039,BIEB 102,A02,193251,Butler; Shannon Rhey,0,0,32,32
1683677681039,BIEB 102,A03,193253,Butler; Shannon Rhey,0,0,32,32
1683677681039,BIEB 102,A04,193255,Butler; Shannon Rhey,13,0,32,19
1683677681039,BIEB 102,A05,193265,Butler; Shannon Rhey,25,0,32,7
1683677681039,BIEB 102,A06,193269,Butler; Shannon Rhey,13,0,32,19
1683677683107,BIEB 150,A01,193274,Staff,0,0,32,32
1683677683107,BIEB 150,A02,193285,Staff,24,0,32,8
1683677684131,BIEB 194,A00,193286,Kurle; Carolyn M.,19,0,32,13
1683677685166,BILD 1,A01,192291,Staff,15,0,32,17
1683677685166,BILD 1,A02,192292,Staff,30,0,32,2
1683677685166,BILD 1,B01,192520,Reuther; Keefe,0,1,0,0
1683677685166,BILD 1,B02,192532,Reuther; Keefe,0,1,0,0
1683677686197,BILD 3,A01,192556,Butler; Shannon Rhey,0,0,32,32
1683677686197,BILD 3,A02,192581,Butler; Shannon Rhey,0,1,32,32
1683677686197,BILD 3,A03,192611,Butler; Shannon Rhey,19,0,32,13
1683677686197,BILD 3,A04,192612,Butler; Shannon Rhey,24,0,32,8
1683677686197,BILD 3,A05,192613,Butler; Shannon Rhey,26,0,32,6
1683677686197,BILD 3,A06,192679,Butler; Shannon Rhey,27,0,32,5
1683677686197,BILD 3,A07,192682,Butler; Shannon Rhey,20,0,32,12
1683677687244,BILD 4,A01,192836,Reuther; Keefe,1,0,24,23
1683677687244,BILD 4,A02,193044,Reuther; Keefe,4,0,24,20
1683677688271,BILD 10,A01,193142,Gustafson-Brown; Cindy,29,0,32,3
1683677688271,BILD 10,A02,193149,Gustafson-Brown; Cindy,31,0,32,1
1683677689296,BIMM 100,A01,193301,Staff,0,6,32,32
1683677689296,BIMM 100,A02,193312,Staff,0,7,32,32
1683677689296,BIMM 100,A03,193323,Staff,0,10,32,32
1683677690334,BIMM 101,A01,193329,McDonnell; Lisa Marie,1,4,24,23
1683677690334,BIMM 101,A02,193339,McDonnell; Lisa Marie,1,4,24,23
1683677690334,BIMM 101,B01,193354,McDonnell; Lisa Marie,0,4,24,24
1683677690334,BIMM 101,B02,193357,McDonnell; Lisa Marie,0,3,24,24
1683677691359,BIMM 110,A01,193377,Tat; John,0,11,32,32
1683677691359,BIMM 110,A02,193378,Tat; John,0,11,32,32
1683677692385,BIMM 120,A01,206116,Staff,0,0,32,32
1683677692385,BIMM 120,A02,206117,Staff,7,0,32,25
1683677692385,BIMM 120,A03,206121,Staff,21,0,32,11
1683677693410,BIPN 100,A01,193393,Park; Ji Young,0,15,32,32
1683677693410,BIPN 100,A02,193402,Park; Ji Young,0,14,32,32
1683677693410,BIPN 100,A03,193413,Park; Ji Young,0,14,32,32
1683677693410,BIPN 100,A04,193414,Park; Ji Young,0,13,32,32
1683677694436,BIPN 102,A01,193429,Staff,0,0,32,32
1683677694436,BIPN 102,A02,193438,Staff,18,0,32,14
1683677695462,BIPN 106,A01,193450,Reyes Gonzalez; Catalina,0,2,40,40
1683677696492,BIPN 134,A01,193465,Cooke; James Edward,0,0,32,32
1683677696492,BIPN 134,A02,193474,Cooke; James Edward,25,0,32,7
1683677696492,BIPN 134,A03,193485,Cooke; James Edward,29,0,32,3
1683677696492,BIPN 134,A04,193486,Cooke; James Edward,20,0,32,12
1683677696492,BIPN 134,A05,193491,Cooke; James Edward,31,0,32,1
1683677696492,BIPN 134,A06,193501,Cooke; James Edward,30,0,32,2
1683677696492,BIPN 134,A07,193510,Cooke; James Edward,29,0,32,3
1683677698541,BISP 194,A00,222522,Staff,14,0,32,18
1683677699566,CAT 124,A01,202407,Staff,19,0,25,6
1683677700593,CAT 125,A00,202408,Marchisotto; Jennifer Anne,2,0,20,18
1683677701623,CAT 125R,A00,202409,Smith; Lauryn Alissa,0,11,20,20
1683677701623,CAT 125R,B00,202410,Morales; Celeste Georgianna,0,11,20,20
1683677701623,CAT 125R,C00,202411,Irwin; Matthew Joseph,0,12,20,20
1683677702648,CENG 15,A01,204712,Yang; Kesong,0,1,0,0
1683677703674,CENG 114,A00,202070,Jahed Motlagh; Zeinab,5,0,20,15
1683677704701,CGS 105,A00,185477,Wesling; Megan E.,24,0,40,16
1683677705734,CGS 106,A00,185494,Staff,11,0,22,11
1683677706759,CGS 108,A00,185495,Staff,14,0,20,6
1683677707786,CGS 114,A00,185496,Staff,13,0,18,5
1683677708812,CGS 119,A00,185501,Staff,15,0,20,5
1683677709837,CGS 120,A00,185511,Staff,12,0,20,8
1683677710877,CHEM 4,A01,184675,Bussey; Thomas J,97,0,100,3
1683677711905,CHEM 6A,A01,184677,Staff,32,0,60,28
1683677712933,CHEM 6B,A01,184679,Staff,63,0,100,37
1683677713961,CHEM 6C,A01,184681,Bussey; Thomas J,0,0,50,50
1683677713961,CHEM 6C,A02,184682,Bussey; Thomas J,32,0,50,18
1683677714993,CHEM 40A,A01,184684,Albizati; Kim F.,33,0,100,67
1683677716018,CHEM 40B,A01,184686,Albizati; Kim F.,0,22,100,100
1683677717047,CHEM 41B,A01,184690,Staff,51,0,100,49
1683677718076,COGS 3,A01,184715,Boyle; Mary E. T.,0,27,40,40
1683677719100,COGS 14B,A01,185172,Staff,0,14,38,38
1683677720127,COGS 18,A01,184736,Staff,14,0,80,66
1683677721157,COGS 100,A01,184932,Staff,0,8,73,73
1683677722184,COGS 101A,A01,184935,Staff,0,40,30,30
1683677723211,COGS 101B,A01,184944,Staff,0,2,30,30
1683677724237,COGS 101C,A01,184946,Staff,0,10,30,30
1683677725265,COGS 102A,A01,184951,Johnson; Christine M.,2,0,40,38
1683677726290,COGS 107B,A01,184953,Mooshagian; Eric Frederick,0,52,40,40
1683677727319,COGS 118B,A01,184959,Gupta; Anjum,0,50,40,40
1683677728343,COGS 153,A00,184961,Staff,0,16,30,30
1683677729369,COGS 177,A00,184962,Staff,0,21,30,30
1683677730397,COGS 187A,A01,184969,Boyle; Mary E. T.,0,19,40,40
1683677731429,COMM 10,A01,185174,Staff,0,5,25,25
1683677731429,COMM 10,A02,185189,Staff,0,2,25,25
1683677731429,COMM 10,A03,269821,Staff,0,1,0,0
1683677732455,COMM 100B,A01,185475,Staff,0,1,0,1
1683677732455,COMM 100B,A02,185476,Staff,11,0,25,14
1683677732455,COMM 100B,A03,277340,Staff,25,0,25,0
1683677733482,COMM 100C,A01,185314,Staff,1,0,25,24
1683677733482,COMM 100C,A02,185327,Staff,17,0,25,8
1683677734507,COMM 110M,A00,185349,Staff,0,0,40,40
1683677735531,COMM 113T,A00,185352,Staff,25,0,40,15
1683677736554,COMM 114I,A00,185353,Staff,31,0,40,9
1683677737641,COMM 131,A00,185354,Staff,17,0,30,13
1683677738666,CSE 8A,A50,185358,Cao; Yingjun,0,46,10,10
1683677739690,CSE 8B,A01,185362,Staff,0,48,50,50
1683677740716,CSE 11,A01,185416,Cao; Yingjun,0,91,10,10
1683677741743,CSE 20,A01,185445,Briones; Jor-el Thomas Caparas,3,0,25,22
1683677742771,CSE 21,A01,185447,Staff,9,0,50,41
1683677743797,CSE 101,A01,185451,Staff,0,13,50,50
1683677743797,CSE 101,B01,185453,Jones; Miles E,0,14,50,50
1683677745853,CSE 141,A01,185458,Eldon; John,16,0,100,84
1683677746889,CSE 141L,A01,185461,Eldon; John,8,0,100,92
1683677747914,CSE 142,A01,185463,Staff,34,0,60,26
1683677747914,CSE 142,B01,201355,Staff,0,7,60,60
1683677748940,CSE 142L,A01,185470,Staff,34,0,60,26
1683677748940,CSE 142L,B01,201417,Staff,0,6,60,60
1683677749965,CSE 190,A00,201433,Staff,32,0,49,17
1683677750994,DOC 1,A01,259136,Strom; Megan C.,7,0,15,8
1683677750994,DOC 1,A02,259137,Strom; Megan C.,14,0,15,1
1683677750994,DOC 1,A03,259138,Strom; Megan C.,14,0,15,1
1683677750994,DOC 1,A04,259139,Strom; Megan C.,14,0,15,1
1683677752021,DOC 100D,A00,259140,Pass; Natalye Joann,14,0,25,11
1683677753046,DSGN 1,A01,184749,Rill; Bryan,0,26,30,30
1683677754070,DSGN 100,A01,185168,Staff,0,2,25,25
1683677755094,ECE 5,A01,185626,Morris; Karcher William,0,12,0,0
1683677756122,ECE 101,A01,185628,Staff,14,0,70,56
1683677757146,ECE 107,A01,185635,Baghdadchi; Saharnaz,0,0,20,20
1683677757146,ECE 107,A02,185638,Baghdadchi; Saharnaz,1,0,20,19
1683677758173,ECE 148,A01,185647,Silberman; Jack,0,0,16,16
1683677759200,ECON 1,A01,185537,Crane; Meredith Helen,54,0,70,16
1683677760229,ECON 3,A01,185549,Crane; Meredith Helen,29,0,70,41
1683677761255,ECON 4,A01,203354,Anderson; John Charles,0,5,10,10
1683677762287,ECON 100A,A01,185574,Staff,0,5,40,40
1683677763311,ECON 100B,A01,185576,Staff,0,12,50,50
1683677764338,ECON 100C,A01,185589,Newhouse; Herbert S,30,0,70,40
1683677765364,ECON 105,A00,185608,Vespa; Emanuel Ignacio,19,0,35,16
1683677766398,ECON 109,A01,185610,Shishkin; Denis,9,0,35,26
1683677767423,ECON 110A,A01,185612,Staff,9,0,40,31
1683677768451,ECON 120A,A01,185615,Staff,19,0,40,21
1683677769481,ECON 120C,A01,185617,Sun; Yixiao,0,21,70,70
1683677770509,ECON 144,A00,203346,Squires; Dale E,2,0,35,33
1683677771537,ECON 171,A01,203349,Newhouse; Herbert S,0,1,35,35
1683677772562,ECON 173A,A01,185621,Toda; Alexis Akira,21,0,35,14
1683677773588,EDS 25,A01,202413,Staff,0,1,0,0
1683677773588,EDS 25,A02,202414,Staff,0,1,0,0
1683677773588,EDS 25,A03,202415,Staff,0,0,0,0
1683677773588,EDS 25,A04,202416,Staff,0,1,0,0
1683677773588,EDS 25,A05,202439,Staff,0,0,0,0
1683677773588,EDS 25,A06,202440,Staff,0,0,0,0
1683677773588,EDS 25,B01,202631,Staff,0,0,0,0
1683677773588,EDS 25,B02,202632,Staff,0,0,0,0
1683677773588,EDS 25,B03,202639,Staff,0,0,0,0
1683677773588,EDS 25,B04,202640,Staff,0,0,0,0
1683677773588,EDS 25,B05,202643,Staff,0,0,0,0
1683677773588,EDS 25,B06,202644,Staff,0,0,0,0
1683677774613,EDS 38,A01,202659,Black; Alison Michelle,24,0,25,1
1683677775640,EDS 115,A00,202652,Staff,18,0,30,12
1683677776666,EDS 125,A00,202649,Staff,13,0,30,17
1683677777693,EDS 126,A01,203332,Staff,30,0,30,0
1683677778720,EDS 139,A00,202838,Staff,16,0,25,9
1683677779746,EDS 146,A01,202655,Staff,14,0,25,11
1683677780772,ENG 15,A00,185667,Staff,0,1,0,0
1683677780772,ENG 15,B00,185672,Staff,0,0,0,0
1683677780772,ENG 15,C00,185675,Staff,0,0,0,0
1683677780772,ENG 15,D00,185682,Staff,0,0,0,0
1683677780772,ENG 15,E00,185684,Staff,0,0,0,0
1683677781796,ETHN 103,A00,185710,Staff,0,8,35,35
1683677782824,ETHN 103A,A00,199228,Man; Simeon S,0,0,9,9
1683677783852,ETHN 109,A00,185711,Staff,15,0,35,20
1683677784891,ETHN 142,A00,185726,Staff,0,4,30,30
1683677785921,ETHN 163J,A00,199229,Man; Simeon S,5,0,8,3
1683677786946,ETHN 168,A00,185727,Staff,7,0,10,3
1683677787972,ETHN 182,A00,185728,Staff,0,0,35,35
1683677788997,ETHN 183,A00,185737,Staff,9,0,18,9
1683677790029,GLBH 111,A01,209361,Burgos; Jose L.,0,0,0,0
1683677792081,HIEU 104,A00,185792,Staff,14,0,20,6
1683677793107,HIEU 115,A00,185800,Staff,0,0,20,20
1683677794131,HIEU 128,A00,185801,Staff,0,9,20,20
1683677795155,HIEU 147,A00,185802,Staff,15,0,20,5
1683677796184,HIEU 154,A00,185823,Staff,11,0,20,9
1683677797223,HILA 102,A00,185826,Staff,14,0,20,6
1683677798250,HILD 2C,A01,185778,Staff,0,13,20,20
1683677799278,HILD 7B,A01,185780,Kwak; Nancy,0,17,32,32
1683677799278,HILD 7B,A02,185781,Kwak; Nancy,0,18,32,32
1683677800305,HILD 30,A01,185791,Staff,12,0,20,8
1683677801335,HISC 119,A00,185830,Golan; Tal,0,9,20,20
1683677802371,HITO 156GS,A00,185831,Patterson; Patrick H.,0,0,0,23
1683677803401,HIUS 103,A00,185832,Man; Simeon S,0,4,20,20
1683677804426,HIUS 117,A00,185836,Kwak; Nancy,2,0,20,18
1683677805453,HIUS 125,A00,185840,Man; Simeon S,0,2,23,23
1683677806479,HIUS 149,A00,185845,Staff,1,0,20,19
1683677807505,HUM 3,A01,185882,Zavodny; Tatiana Sophia,0,8,50,50
1683677807505,HUM 3,B01,185899,Caldwell; Michael Alan,0,18,50,50
1683677808529,HUM 3GS,A00,185900,Patterson; Patrick H.,0,0,0,23
1683677809557,HUM 4,A01,185938,Zroka; Amy Liane,28,0,50,22
1683677809557,HUM 4,B01,185956,Watkins; Eric,0,6,50,50
1683677809557,HUM 4,B02,202209,Watkins; Eric,0,5,50,50
1683677809557,HUM 4,B03,202210,Watkins; Eric,0,5,50,50
1683677810582,HUM 5,A01,185958,West; Geoffrey Scott,0,0,50,50
1683677810582,HUM 5,A02,202215,West; Geoffrey Scott,0,0,50,50
1683677811610,INTL 190,A00,185959,Gagnon; Jeffrey C,0,0,0,9
1683677811610,INTL 190,B00,185960,Lettieri; Michael Joseph,0,0,0,2
1683677812638,JAPN 180,A00,254509,Staff,5,0,30,25
1683677813668,LATI 10,A01,202853,Kennemore; Amy Michelle,4,0,35,31
1683677813668,LATI 10,A02,202854,Kennemore; Amy Michelle,3,0,35,32
1683677813668,LATI 10,A03,270054,Kennemore; Amy Michelle,30,0,30,0
1683677814697,LATI 180,A00,202855,Kennemore; Amy Michelle,11,0,20,9
1683677815726,LAWS 101,A00,201767,Golan; Tal,0,7,40,40
1683677816752,LIFR 1C,A00,185961,Staff,6,0,20,14
1683677817777,LIFR 1CX,A00,185962,Staff,7,0,20,13
1683677818802,LIFR 1D,A00,185963,Staff,7,0,20,13
1683677819830,LIFR 1DX,A00,185964,Staff,7,0,20,13
1683677820854,LIGN 101,A01,186039,Staff,43,0,50,7
1683677821885,LIGN 165,A00,186040,Staff,15,0,50,35
1683677822909,LTCS 108,A00,186041,Staff,5,0,10,5
1683677823942,LTCS 119,A00,186042,Staff,15,0,20,5
1683677824969,LTCS 130,A00,186043,Wesling; Megan E.,15,0,25,10
1683677827023,LTEA 138,A00,186119,Staff,14,0,40,26
1683677828049,LTEN 124,A00,186148,Staff,5,0,25,20
1683677829078,LTEN 178,A00,186149,Staff,7,0,15,8
1683677830104,LTEN 181,A00,186150,Blanco; John D,34,0,40,6
1683677831133,LTWL 120,A00,186160,Staff,19,0,25,6
1683677832162,LTWL 165,A00,186161,Staff,22,0,25,3
1683677833188,LTWR 100,A00,186162,Staff,0,5,15,15
1683677834221,LTWR 102,A00,186163,Doller; Ben,5,0,15,10
1683677835248,MAE 8,A01,186412,Staff,0,1,0,0
1683677836276,MAE 30B,A00,186445,Bahadori; Mohammad Yousef,82,0,100,18
1683677837308,MAE 40,A00,186592,Bewley; Thomas R,10,0,50,40
1683677838336,MAE 101B,A00,186593,Bahadori; Mohammad Yousef,80,0,100,20
1683677839366,MAE 105,A00,186594,Bandaru; Prabhakar,10,0,50,40
1683677840392,MAE 107,A00,186599,Pham; Hieu Tan,0,7,120,120
1683677841477,MAE 148,A01,186660,Silberman; Jack,3,0,16,13
1683677842503,MATH 10A,A01,188095,Staff,0,6,35,35
1683677843537,MATH 10B,A01,188097,Bowers; Adam R.,0,12,30,30
1683677843537,MATH 10B,A02,188099,Bowers; Adam R.,0,11,30,30
1683677843537,MATH 10B,B01,188104,Bowers; Adam R.,0,10,30,30
1683677843537,MATH 10B,B02,188106,Bowers; Adam R.,1,9,30,29
1683677844574,MATH 10C,A01,188111,Staff,0,20,30,30
1683677844574,MATH 10C,A02,188127,Staff,0,19,30,30
1683677844574,MATH 10C,A03,188131,Staff,0,19,30,30
1683677844574,MATH 10C,B01,188218,Staff,17,0,30,13
1683677844574,MATH 10C,B02,188244,Staff,13,0,30,17
1683677844574,MATH 10C,B03,188277,Staff,14,0,30,16
1683677845599,MATH 18,A01,188344,Bach; Quang Tran,18,0,30,12
1683677845599,MATH 18,A02,188345,Bach; Quang Tran,11,0,30,19
1683677845599,MATH 18,B01,188353,Bach; Quang Tran,11,0,30,19
1683677845599,MATH 18,B02,188354,Bach; Quang Tran,19,0,30,11
1683677846692,MATH 20A,A01,188374,Staff,11,0,35,24
1683677847721,MATH 20B,A01,188382,Ohm; Ko Woon,7,0,30,23
1683677847721,MATH 20B,A02,188383,Ohm; Ko Woon,22,0,30,8
1683677847721,MATH 20B,B01,188385,Ohm; Ko Woon,7,0,30,23
1683677847721,MATH 20B,B02,188392,Ohm; Ko Woon,22,0,30,8
1683677848756,MATH 20C,A01,188394,Harel; Guershon,10,0,30,20
1683677848756,MATH 20C,A02,188395,Harel; Guershon,13,0,30,17
1683677848756,MATH 20C,B01,188404,Harel; Guershon,5,0,30,25
1683677848756,MATH 20C,B02,188405,Harel; Guershon,18,0,30,12
1683677849785,MATH 20D,A01,188414,Hammock; Frances H,0,1,30,30
1683677849785,MATH 20D,A02,188415,Hammock; Frances H,0,1,30,30
1683677849785,MATH 20D,B01,188447,Hammock; Frances H,0,1,30,30
1683677849785,MATH 20D,B02,188486,Hammock; Frances H,3,0,30,27
1683677850809,MATH 20E,A01,188649,Staff,21,0,30,9
1683677850809,MATH 20E,A02,188650,Staff,20,0,30,10
1683677850809,MATH 20E,A03,188673,Staff,0,0,30,30
1683677851836,MATH 102,A01,188675,Staff,0,39,35,35
1683677852864,MATH 103B,A01,188681,Staff,3,0,35,32
1683677852864,MATH 103B,B01,188692,Staff,5,0,35,30
1683677853892,MATH 109,A01,188695,Salehi Golsefidy; Alireza,24,0,35,11
1683677853892,MATH 109,A02,188696,Salehi Golsefidy; Alireza,25,0,35,10
1683677854922,MATH 120A,A01,188698,Eggers; John Dietrich,7,0,35,28
1683677855948,MATH 142B,A01,188736,Ioana; Adrian,1,1,30,29
1683677855948,MATH 142B,A02,188741,Ioana; Adrian,0,1,30,30
1683677855948,MATH 142B,A03,188743,Ioana; Adrian,0,1,30,30
1683677856977,MATH 168A,A01,188790,Staff,0,11,35,35
1683677858006,MATH 170A,A01,188803,Nie; Jiawang,0,2,35,35
1683677858006,MATH 170A,A02,188811,Nie; Jiawang,0,1,35,35
1683677858006,MATH 170A,A03,188814,Nie; Jiawang,0,0,35,35
1683677858006,MATH 170A,A04,188815,Nie; Jiawang,6,0,35,29
1683677859030,MATH 193B,A01,188817,Staff,0,0,35,35
1683677859030,MATH 193B,A02,188818,Staff,5,0,35,30
1683677860058,MGT 4,A01,202857,Anderson; John Charles,60,0,80,20
1683677861085,MGT 12,A00,202858,Lindenberger; Wade Douglas,40,0,90,50
1683677862112,MGT 18,A00,202859,Staff,74,0,90,16
1683677863134,MGT 18GS,A00,202860,McKay; Michael J,13,0,28,15
1683677864159,MGT 45,A00,202861,Pecore; Joseph P.,9,0,90,81
1683677865188,MGT 100,A00,202863,Yavorsky; Daniel Ryan,28,0,90,62
1683677866216,MGT 103,A00,202864,Ehrich; Kristine R,0,18,90,90
1683677867242,MGT 112,A00,202865,Ehrich; Kristine R,15,0,90,75
1683677868266,MGT 121A,A00,202868,Staff,90,20,90,0
1683677869293,MGT 131B,A00,202869,Anderson; John Charles,59,0,90,31
1683677870318,MGT 136,A00,202871,Lindenberger; Wade Douglas,83,0,90,7
1683677871343,MGT 164,A00,202873,Staff,0,67,90,91
1683677872367,MGT 164GS,A00,202874,McKay; Mary A,13,0,28,15
1683677873395,MGT 180,A00,202875,Staff,0,51,90,91
1683677874423,MMW 11R,A01,205019,Herbst; Matthew,0,0,30,30
1683677874423,MMW 11R,A02,205026,Herbst; Matthew,29,0,30,1
1683677875452,MMW 15,A01,193512,Chang; Edmond Yi-Teh,0,8,28,28
1683677875452,MMW 15,A02,193513,Chang; Edmond Yi-Teh,0,5,28,28
1683677875452,MMW 15,A03,193514,Chang; Edmond Yi-Teh,0,5,28,28
1683677875452,MMW 15,A04,193515,Chang; Edmond Yi-Teh,0,5,28,28
1683677875452,MMW 15,A05,193516,Chang; Edmond Yi-Teh,0,5,28,28
1683677875452,MMW 15,A06,193517,Chang; Edmond Yi-Teh,0,6,28,28
1683677875452,MMW 15,B01,193519,Chang; Edmond Yi-Teh,0,5,28,28
1683677875452,MMW 15,B02,193520,Chang; Edmond Yi-Teh,0,5,28,28
1683677875452,MMW 15,B03,193521,Chang; Edmond Yi-Teh,0,5,28,28
1683677875452,MMW 15,B04,193522,Chang; Edmond Yi-Teh,0,5,28,28
1683677875452,MMW 15,B05,193523,Chang; Edmond Yi-Teh,0,5,28,28
1683677875452,MMW 15,B06,193524,Chang; Edmond Yi-Teh,0,5,28,28
1683677876481,MMW 122,A01,193526,Rahimi; Babak,0,16,28,28
1683677876481,MMW 122,A02,193527,Rahimi; Babak,0,15,28,28
1683677876481,MMW 122,A03,193528,Rahimi; Babak,0,0,0,0
1683677876481,MMW 122,A04,193529,Rahimi; Babak,0,0,0,0
1683677877507,MUS 1A,A01,186663,Staff,1,19,35,34
1683677878530,MUS 4,A01,186715,Staff,0,12,35,35
1683677879558,MUS 5R,A01,186796,Dubnov; Shlomo,0,17,35,35
1683677880585,MUS 6,A01,186798,Staff,0,5,25,25
1683677881613,MUS 7,A01,186830,Staff,11,0,35,24
1683677882639,MUS 8,A01,186930,Staff,0,27,35,35
1683677883666,MUS 15,A01,186932,Staff,0,15,35,35
1683677883666,MUS 15,B01,186934,Staff,1,17,35,34
1683677884690,MUS 80,A00,186935,Staff,0,0,20,20
1683677884690,MUS 80,B00,186936,Staff,24,0,25,1
1683677885716,NANO 11,A00,204702,Lipomi; Darren John,0,0,0,0
1683677886745,NANO 15,A01,204709,Yang; Kesong,0,1,0,0
1683677887770,NANO 114,A00,202069,Jahed Motlagh; Zeinab,3,0,10,7
1683677888794,PHIL 1,A00,186955,Grush; Rick Scott,31,0,40,9
1683677889818,PHIL 10,A01,186973,Grush; Rick Scott,27,0,35,8
1683677889818,PHIL 10,A02,186974,Grush; Rick Scott,33,0,35,2
1683677890842,PHIL 13,A01,186976,Staff,3,0,35,32
1683677890842,PHIL 13,A02,186977,Staff,16,0,35,19
1683677891866,PHIL 14,A01,186979,Staff,31,0,35,4
1683677891866,PHIL 14,A02,186986,Staff,32,0,35,3
1683677892891,PHIL 28,A01,186988,Staff,16,0,30,14
1683677892891,PHIL 28,A02,186989,Staff,1,0,30,29
1683677892891,PHIL 28,A03,186990,Staff,10,0,30,20
1683677892891,PHIL 28,A04,186991,Staff,26,0,30,4
1683677893918,PHIL 120,A00,186997,Staff,23,0,40,17
1683677894944,PHIL 137,A00,187003,Staff,7,0,40,33
1683677895971,PHIL 150,A00,187015,Staff,47,0,70,23
1683677896996,PHIL 167,A00,187021,Lamey; Andy M.,34,0,40,6
1683677898022,PHIL 174,A01,202226,Staff,17,0,20,3
1683677898022,PHIL 174,A02,202235,Staff,20,0,20,0
1683677899047,PHIL 191A,A00,258918,Staff,0,0,1,1
1683677900077,PHYS 1A,A00,187028,Staff,26,0,60,34
1683677901102,PHYS 1AL,001,187036,Staff,3,0,30,27
1683677901102,PHYS 1AL,002,187049,Staff,18,0,30,12
1683677902132,PHYS 1B,A00,187058,Staff,22,0,60,38
1683677903162,PHYS 1BL,001,187064,Staff,0,1,30,30
1683677903162,PHYS 1BL,002,187070,Staff,4,0,30,26
1683677904189,PHYS 1C,A00,187082,Staff,29,0,120,91
1683677905217,PHYS 1CL,001,187088,Staff,0,9,30,30
1683677905217,PHYS 1CL,002,187089,Staff,0,1,30,30
1683677905217,PHYS 1CL,009,262693,Staff,9,0,30,21
1683677906247,PHYS 2B,A01,187097,Staff,55,0,115,60
1683677907276,PHYS 2C,A01,187099,Staff,63,0,115,52
1683677908299,PHYS 2CL,A01,187101,Staff,5,0,28,23
1683677908299,PHYS 2CL,A02,187102,Staff,15,0,28,13
1683677909327,PHYS 2D,A01,187123,Shotwell; Brian,95,0,115,20
1683677910356,PHYS 4B,A01,187133,Grinstein; Benjamin,35,0,50,15
1683677911381,POLI 10,A00,188819,Staff,0,4,50,50
1683677912405,POLI 11,A00,188827,Staff,43,0,50,7
1683677913429,POLI 13R,A00,188828,Staff,0,1,20,20
1683677914452,POLI 27,A01,188830,Elgin; Samuel Zincke,0,2,70,70
1683677915477,POLI 30,A00,188832,Desposato; Scott,30,0,50,20
1683677916507,POLI 102F,A00,188834,Staff,0,0,40,40
1683677917534,POLI 104A,A00,188852,Staff,12,0,30,18
1683677918561,POLI 104I,A00,188853,Staff,0,8,20,20
1683677919587,POLI 110B,A00,188854,Wiens; David,6,0,20,14
1683677920612,POLI 112A,A00,188855,Wiens; David,3,0,30,27
1683677921637,POLI 117R,A00,188856,Forman; Fonna,0,12,20,20
1683677922663,POLI 118,A00,188857,Ingham; Sean,8,0,20,12
1683677923688,POLI 120G,A00,188858,Staff,8,0,30,22
1683677924710,POLI 131CR,A00,188863,Hoston; Germaine,20,0,50,30
1683677925735,POLI 133,A00,188864,Nellis; Gareth Hb,44,0,50,6
1683677926763,POLI 134D,A00,188865,Desposato; Scott,27,0,30,3
1683677927788,POLI 142A,A00,188871,Gartzke; Erik,21,0,50,29
1683677928815,POLI 142K,A00,188874,Staff,38,0,50,12
1683677929842,POLI 143,A00,188940,Gartzke; Erik,16,0,30,14
1683677930869,POLI 153,A00,188943,Staff,2,0,20,18
1683677931894,POLI 160AA,A00,188944,Staff,10,0,40,30
1683677932918,POLI 170A,A00,188945,Staff,10,0,30,20
1683677934966,PSYC 1,A00,188952,Staff,36,0,90,54
1683677935991,PSYC 2,B00,188953,Staff,19,0,35,16
1683677937014,PSYC 6,A00,188970,Staff,47,0,60,13
1683677938040,PSYC 7,A00,188973,Staff,35,0,45,10
1683677939064,PSYC 60,A01,188980,Rickard; Timothy C.,42,0,60,18
1683677940091,PSYC 70,A01,189001,Steiner; Eric Tomas,21,0,45,24
1683677941121,PSYC 100,A00,189005,Lacefield; Katharine I,0,99,120,120
1683677942147,PSYC 102,A00,189008,Staff,7,0,30,23
1683677943171,PSYC 106,B00,189026,Gorman; Michael R.,27,0,60,33
1683677944196,PSYC 114,B01,189033,Winkielman; Piotr,0,31,30,30
1683677945275,PSYC 131,A00,189036,Anagnostaras; Stephan,0,43,60,60
1683677946299,PSYC 136,A00,189041,Lowe; Angela Beth,0,7,25,25
1683677947326,PSYC 137,A00,189057,Winkielman; Piotr,1,37,25,24
1683677948353,PSYC 144,A00,189107,Wixted; John T,0,11,50,50
1683677950403,PSYC 162,A00,189142,Staff,0,9,85,85
1683677951426,PSYC 172,A00,189144,Gorman; Michael R.,0,6,30,30
1683677953477,PSYC 179,A00,189146,Lacefield; Katharine I,0,87,120,120
1683677954504,PSYC 181,A00,189147,Anagnostaras; Stephan,0,44,90,90
1683677955532,PSYC 190R,A00,189148,Barner; David A.,0,23,80,80
1683677956560,PSYC 191,A00,189275,Rickard; Timothy C.,0,10,25,25
1683677957584,PSYC 193,A00,189276,Chapman; Eddie Nathaniel,0,1,0,4
1683677958609,PSYC 193L,A01,189281,Lowe; Angela Beth,8,0,20,12
1683677958609,PSYC 193L,B01,189285,Staff,28,0,35,7
1683677959631,RELI 149,A00,187137,Rahimi; Babak,7,0,40,33
1683677960655,SE 9,A01,187315,Staff,0,2,18,18
1683677961680,SE 101B,A00,187409,Staff,24,0,30,6
1683677962705,SE 110B,A00,187444,Staff,10,0,40,30
1683677963733,SE 130B,A00,187449,Staff,31,0,40,9
1683677964756,SE 150A,A00,187516,Staff,8,0,20,12
1683677965780,SE 154,A00,187528,Staff,29,0,50,21
1683677966805,SIO 3,A01,258171,Staff,35,0,40,5
1683677967832,SIO 10,A00,187144,Cook; Geoffrey W,1,7,75,74
1683677968860,SIO 45,A00,187152,Cook; Geoffrey W,0,7,100,100
1683677969886,SIO 109R,A00,194486,Staff,0,4,20,20
1683677971935,SIO 187,A01,187233,Kacev; David,12,0,40,28
1683677972961,SOCI 1,A01,258656,Thorpe; Charles Robert,28,0,30,2
1683677972961,SOCI 1,A02,258658,Thorpe; Charles Robert,30,0,30,0
1683677972961,SOCI 1,A03,258661,Thorpe; Charles Robert,25,0,25,0
1683677972961,SOCI 1,A04,258666,Thorpe; Charles Robert,22,0,25,3
1683677972961,SOCI 1,A05,258897,Thorpe; Charles Robert,22,0,25,3
1683677972961,SOCI 1,A06,258898,Thorpe; Charles Robert,25,0,25,0
1683677973987,SOCI 30,A01,258903,Pardo Guerra; Juan Pablo,14,0,30,16
1683677975018,SOCI 102,A00,258904,Staff,9,0,25,16
1683677976042,SOCI 106,A00,258905,Staff,19,0,25,6
1683677977069,SOCI 111,A00,258907,Ribas Norris; Janet Vanesa,26,0,30,4
1683677978093,SOCI 121R,A00,258908,Pardo Guerra; Juan Pablo,8,0,30,22
1683677979123,SOCI 126,A01,203330,Staff,14,0,20,6
1683677980150,SOCI 131,A00,258909,Thorpe; Charles Robert,30,0,60,30
1683677981174,SOCI 135,A00,258910,Payne; Christine Anna,0,12,30,30
1683677982201,SOCI 157,A00,258911,Staff,11,0,30,19
1683677983225,SOCI 184,A00,258912,Staff,25,0,30,5
1683677984249,SOCI 188D,A00,258913,Staff,22,0,30,8
1683677985274,SYN 2,001,187529,Staff,9,0,16,7
1683677985274,SYN 2,002,201452,Staff,1,20,16,15
1683677985274,SYN 2,003,201469,Staff,1,0,16,15
1683677986302,SYN 100,A01,187531,Staff,0,9,20,20
1683677986302,SYN 100,B01,201491,Staff,0,10,20,20
1683677987330,TDAC 1,A00,189286,Walsh; Kim C.,3,0,20,17
1683677987330,TDAC 1,B00,189287,Harting; Carla Kelso,10,0,20,10
1683677988354,TDAC 101,A00,189300,Walsh; Kim C.,16,0,20,4
1683677988354,TDAC 101,B00,189301,Harting; Carla Kelso,18,0,20,2
1683677989378,TDAC 102,A00,189304,Basso; Beatrice,14,0,20,6
1683677990405,TDAC 108,A00,189305,Staff,18,0,20,2
1683677991431,TDDE 131,A00,189310,Staff,19,0,20,1
1683677991431,TDDE 131,B00,189314,Staff,19,0,20,1
1683677991431,TDDE 131,C00,189315,Staff,48,0,50,2
1683677991431,TDDE 131,D00,189316,Staff,14,0,15,1
1683677991431,TDDE 131,E00,204841,Staff,20,0,20,0
1683677992455,TDGE 10,A00,189289,Staff,27,0,50,23
1683677992455,TDGE 10,B00,189290,Havis; Allan,0,1,50,50
1683677993481,TDGE 11,A00,189291,Fulton; Julia,0,4,50,50
1683677993481,TDGE 11,B00,189292,Staff,20,0,25,5
1683677993481,TDGE 11,C00,260270,Staff,0,0,0,0
1683677994506,TDGE 25,A00,189294,Staff,1,0,20,19
1683677995532,TDGE 124,A00,189318,Fulton; Julia,0,8,50,50
1683677996559,TDGE 125,A00,189319,Staff,13,0,25,12
1683677996559,TDGE 125,B00,189320,Staff,23,0,25,2
1683677997586,TDGE 127,A00,189322,Havis; Allan,0,0,50,50
1683677998614,TDHT 101,A00,189323,Staff,18,0,25,7
1683677998614,TDHT 101,B00,189324,Staff,25,0,25,0
1683677999641,TDHT 102,A00,189325,Staff,49,0,50,1
1683678000673,TDMV 1,A00,189295,Arcidiacono; Kristin,20,0,30,10
1683678000673,TDMV 1,B00,189296,Caligagan; Maria T.,24,0,30,6
1683678001710,TDMV 2,A00,189297,Sammartano; Tonnie,27,0,30,3
1683678001710,TDMV 2,B00,189299,Arcidiacono; Kristin,23,0,30,7
1683678002734,TDMV 3,A00,204998,Rincon; Alicia,22,0,30,8
1683678003762,TDMV 120,A00,189458,Sammartano; Tonnie,28,0,30,2
1683678004790,TDMV 138,A00,189541,Jun; Grace Shin Hae,20,0,40,20
1683678005820,TDMV 142,A00,189717,Caligagan; Tony,25,0,30,5
1683678005820,TDMV 142,B00,189718,Caligagan; Maria T.,25,0,30,5
1683678006847,TMC 2,A01,187533,Staff,25,0,25,0
1683678006847,TMC 2,A02,187534,Staff,25,0,25,0
1683678007873,USP 1,A01,187536,Kwak; Nancy,0,16,25,25
1683678008896,USP 5,A01,187538,Staff,8,0,25,17
1683678009925,USP 101,A00,199253,Staff,0,4,0,0
1683678010949,USP 124,A00,187562,Boomhower; Matthew Charles,0,0,30,30
1683678011974,USP 138,A00,187582,Staff,19,0,25,6
1683678013004,USP 152,A01,187597,Staff,3,0,25,22
1683678014028,USP 153,A00,187598,Staff,19,0,25,6
1683678015055,USP 168,A00,187607,Kwak; Nancy,2,0,5,3
1683678016082,USP 173,A00,187619,Staff,4,0,25,21
1683678017106,USP 181,A00,187638,Staff,0,4,25,25
1683678018131,VIS 103,A00,187650,Cruz; Edwin Teddy,17,0,75,58
1683678019154,VIS 110D,A00,187669,Staff,13,0,22,9
1683678020182,VIS 127C,A00,187720,Shen; Kuiyi,67,0,146,79
1683678021207,VIS 149,A00,187731,Yoldas; Pinar,1,14,22,21
1683678022231,VIS 151,A01,188091,Staff,22,0,34,12
1683678022231,VIS 151,A02,188092,Staff,11,0,34,23
1683678023259,VIS 160B,A00,188093,Stalbaum; Brett,0,1,10,10
1683678025307,WCWP 10B,A00,201720,Staff,0,0,5,5
1683678025307,WCWP 10B,B00,201722,Staff,0,0,6,6
1683678026334,WCWP 100,A00,201725,Gagnon; Jeffrey C,0,0,2,2
1683678026334,WCWP 100,B00,201727,Staff,0,4,15,15
1683678029454,ANBI 133,A00,258401,Wilder; Linnea Lorene,34,0,40,6
1683678030478,ANBI 140,A00,258395,Hrvoj Mihic; Branka,18,0,25,7
1683678031503,ANSC 120,A00,258402,Bialecki; Jon Anthony,26,0,40,14
1683678032528,ANSC 144,A00,258400,Staff,12,0,40,28
1683678034579,ANSC 166,A00,258396,Parish; Steven Martin,156,0,175,19
1683678035606,ANSC 180,A00,193533,Staff,8,0,20,12
1683678036630,ANSC 188,A00,258397,Jassal; Aftab,34,0,40,6
1683678037655,ANTH 3,A01,258316,Staff,23,0,30,7
1683678038680,ANTH 5,A00,258394,Semendeferi; Ekaterini,16,0,20,4
1683678039704,ANTH 21,A01,258331,Staff,4,0,40,36
1683678040729,ANTH 103,A00,258398,Varma; Saiba,15,0,25,10
1683678041756,AWP 10,001,202034,Staff,0,0,0,0
1683678041756,AWP 10,002,202035,Staff,0,0,0,0
1683678041756,AWP 10,003,202036,Staff,0,0,0,0
1683678041756,AWP 10,004,202037,Staff,0,0,0,0
1683678041756,AWP 10,005,202038,Staff,0,0,0,0
1683678041756,AWP 10,006,202039,Staff,0,0,0,0
1683678041756,AWP 10,007,202040,Staff,0,0,0,0
1683678041756,AWP 10,008,202041,Staff,0,0,0,0
1683678041756,AWP 10,009,202042,Staff,0,0,0,0
1683678041756,AWP 10,010,202043,Staff,0,0,0,0
1683678041756,AWP 10,011,202044,Staff,0,0,0,0
1683678041756,AWP 10,012,202045,Staff,0,0,0,0
1683678041756,AWP 10,013,202046,Staff,0,0,0,0
1683678041756,AWP 10,014,202047,Staff,0,0,0,0
1683678041756,AWP 10,015,202048,Staff,0,0,0,0
1683678041756,AWP 10,016,202049,Staff,0,0,0,0
1683678041756,AWP 10,017,202050,Staff,0,0,0,0
1683678041756,AWP 10,018,202051,Staff,0,0,0,0
1683678041756,AWP 10,019,202052,Staff,0,0,0,0
1683678041756,AWP 10,020,202053,Staff,0,0,0,0
1683678041756,AWP 10,021,202054,Staff,0,0,0,0
1683678041756,AWP 10,022,202055,Staff,0,0,0,0
1683678041756,AWP 10,023,202056,Staff,0,0,0,0
1683678041756,AWP 10,024,202057,Staff,0,0,0,0
1683678041756,AWP 10,025,202058,Staff,0,0,0,0
1683678041756,AWP 10,026,202059,Staff,0,0,0,0
1683678042781,AWP 102,001,202032,Staff,0,0,0,0
1683678042781,AWP 102,002,202033,Staff,0,0,0,0
1683678043809,BENG 100,A01,254234,Taylor Amos; Alyssa C,31,0,40,9
1683678044835,BENG 196,001,270013,Engler; Adam J.,9999,0,9999,0
1683678045865,BICD 100R,A01,202018,Smith; Laurie,0,7,32,32
1683678045865,BICD 100R,A02,202019,Smith; Laurie,0,3,32,32
1683678045865,BICD 100R,A03,202020,Smith; Laurie,0,1,32,32
1683678045865,BICD 100R,A04,202021,Smith; Laurie,6,0,32,26
1683678045865,BICD 100R,A05,202022,Smith; Laurie,10,0,32,22
1683678046889,BICD 136,A01,193242,Gustafson-Brown; Cindy,0,2,32,32
1683678046889,BICD 136,A02,193244,Gustafson-Brown; Cindy,13,0,32,19
1683678047912,BIEB 102,A01,193249,Butler; Shannon Rhey,1,1,32,31
1683678047912,BIEB 102,A02,193251,Butler; Shannon Rhey,0,0,32,32
1683678047912,BIEB 102,A03,193253,Butler; Shannon Rhey,0,0,32,32
1683678047912,BIEB 102,A04,193255,Butler; Shannon Rhey,13,0,32,19
1683678047912,BIEB 102,A05,193265,Butler; Shannon Rhey,25,0,32,7
1683678047912,BIEB 102,A06,193269,Butler; Shannon Rhey,13,0,32,19
1683678050037,BIEB 150,A01,193274,Staff,0,0,32,32
1683678050037,BIEB 150,A02,193285,Staff,24,0,32,8
1683678051069,BIEB 194,A00,193286,Kurle; Carolyn M.,19,0,32,13
1683678052092,BILD 1,A01,192291,Staff,15,0,32,17
1683678052092,BILD 1,A02,192292,Staff,30,0,32,2
1683678052092,BILD 1,B01,192520,Reuther; Keefe,0,1,0,0
1683678052092,BILD 1,B02,192532,Reuther; Keefe,0,1,0,0
1683678053116,BILD 3,A01,192556,Butler; Shannon Rhey,0,0,32,32
1683678053116,BILD 3,A02,192581,Butler; Shannon Rhey,0,1,32,32
1683678053116,BILD 3,A03,192611,Butler; Shannon Rhey,19,0,32,13
1683678053116,BILD 3,A04,192612,Butler; Shannon Rhey,24,0,32,8
1683678053116,BILD 3,A05,192613,Butler; Shannon Rhey,26,0,32,6
1683678053116,BILD 3,A06,192679,Butler; Shannon Rhey,27,0,32,5
1683678053116,BILD 3,A07,192682,Butler; Shannon Rhey,20,0,32,12
1683678054145,BILD 4,A01,192836,Reuther; Keefe,1,0,24,23
1683678054145,BILD 4,A02,193044,Reuther; Keefe,4,0,24,20
1683678055169,BILD 10,A01,193142,Gustafson-Brown; Cindy,29,0,32,3
1683678055169,BILD 10,A02,193149,Gustafson-Brown; Cindy,31,0,32,1
1683678056194,BIMM 100,A01,193301,Staff,0,6,32,32
1683678056194,BIMM 100,A02,193312,Staff,0,7,32,32
1683678056194,BIMM 100,A03,193323,Staff,0,10,32,32
1683678057223,BIMM 101,A01,193329,McDonnell; Lisa Marie,1,4,24,23
1683678057223,BIMM 101,A02,193339,McDonnell; Lisa Marie,1,4,24,23
1683678057223,BIMM 101,B01,193354,McDonnell; Lisa Marie,0,4,24,24
1683678057223,BIMM 101,B02,193357,McDonnell; Lisa Marie,0,3,24,24
1683678058251,BIMM 110,A01,193377,Tat; John,0,11,32,32
1683678058251,BIMM 110,A02,193378,Tat; John,0,11,32,32
1683678059278,BIMM 120,A01,206116,Staff,0,0,32,32
1683678059278,BIMM 120,A02,206117,Staff,7,0,32,25
1683678059278,BIMM 120,A03,206121,Staff,21,0,32,11
1683678060308,BIPN 100,A01,193393,Park; Ji Young,0,15,32,32
1683678060308,BIPN 100,A02,193402,Park; Ji Young,0,14,32,32
1683678060308,BIPN 100,A03,193413,Park; Ji Young,0,14,32,32
1683678060308,BIPN 100,A04,193414,Park; Ji Young,0,13,32,32
1683678061337,BIPN 102,A01,193429,Staff,0,0,32,32
1683678061337,BIPN 102,A02,193438,Staff,18,0,32,14
1683678062362,BIPN 106,A01,193450,Reyes Gonzalez; Catalina,0,2,40,40
1683678063390,BIPN 134,A01,193465,Cooke; James Edward,0,0,32,32
1683678063390,BIPN 134,A02,193474,Cooke; James Edward,25,0,32,7
1683678063390,BIPN 134,A03,193485,Cooke; James Edward,29,0,32,3
1683678063390,BIPN 134,A04,193486,Cooke; James Edward,20,0,32,12
1683678063390,BIPN 134,A05,193491,Cooke; James Edward,31,0,32,1
1683678063390,BIPN 134,A06,193501,Cooke; James Edward,30,0,32,2
1683678063390,BIPN 134,A07,193510,Cooke; James Edward,29,0,32,3
1683678065441,BISP 194,A00,222522,Staff,14,0,32,18
1683678066470,CAT 124,A01,202407,Staff,19,0,25,6
1683678067494,CAT 125,A00,202408,Marchisotto; Jennifer Anne,2,0,20,18
1683678068522,CAT 125R,A00,202409,Smith; Lauryn Alissa,0,11,20,20
1683678068522,CAT 125R,B00,202410,Morales; Celeste Georgianna,0,11,20,20
1683678068522,CAT 125R,C00,202411,Irwin; Matthew Joseph,0,12,20,20
1683678069547,CENG 15,A01,204712,Yang; Kesong,0,1,0,0
1683678070571,CENG 114,A00,202070,Jahed Motlagh; Zeinab,5,0,20,15
1683678071596,CGS 105,A00,185477,Wesling; Megan E.,24,0,40,16
1683678072619,CGS 106,A00,185494,Staff,11,0,22,11
1683678073643,CGS 108,A00,185495,Staff,14,0,20,6
1683678074668,CGS 114,A00,185496,Staff,13,0,18,5
1683678075692,CGS 119,A00,185501,Staff,15,0,20,5
1683678076715,CGS 120,A00,185511,Staff,12,0,20,8
1683678077744,CHEM 4,A01,184675,Bussey; Thomas J,97,0,100,3
1683678078771,CHEM 6A,A01,184677,Staff,32,0,60,28
1683678079798,CHEM 6B,A01,184679,Staff,63,0,100,37
1683678080827,CHEM 6C,A01,184681,Bussey; Thomas J,0,0,50,50
1683678080827,CHEM 6C,A02,184682,Bussey; Thomas J,32,0,50,18
1683678081853,CHEM 40A,A01,184684,Albizati; Kim F.,33,0,100,67
1683678082879,CHEM 40B,A01,184686,Albizati; Kim F.,0,22,100,100
1683678083906,CHEM 41B,A01,184690,Staff,51,0,100,49
1683678084929,COGS 3,A01,184715,Boyle; Mary E. T.,0,27,40,40
1683678085954,COGS 14B,A01,185172,Staff,0,14,38,38
1683678086978,COGS 18,A01,184736,Staff,14,0,80,66
1683678088003,COGS 100,A01,184932,Staff,0,8,73,73
1683678089035,COGS 101A,A01,184935,Staff,0,40,30,30
1683678090062,COGS 101B,A01,184944,Staff,0,2,30,30
1683678091085,COGS 101C,A01,184946,Staff,0,10,30,30
1683678092109,COGS 102A,A01,184951,Johnson; Christine M.,2,0,40,38
1683678093138,COGS 107B,A01,184953,Mooshagian; Eric Frederick,0,52,40,40
1683678094164,COGS 118B,A01,184959,Gupta; Anjum,0,50,40,40
1683678095191,COGS 153,A00,184961,Staff,0,16,30,30
1683678096215,COGS 177,A00,184962,Staff,0,21,30,30
1683678097238,COGS 187A,A01,184969,Boyle; Mary E. T.,0,19,40,40
1683678098266,COMM 10,A01,185174,Staff,0,5,25,25
1683678098266,COMM 10,A02,185189,Staff,0,2,25,25
1683678098266,COMM 10,A03,269821,Staff,0,1,0,0
1683678099292,COMM 100B,A02,185476,Staff,11,0,25,14
1683678099292,COMM 100B,A03,277340,Staff,25,0,25,0
1683678100315,COMM 100C,A01,185314,Staff,1,0,25,24
1683678100315,COMM 100C,A02,185327,Staff,17,0,25,8
1683678101343,COMM 110M,A00,185349,Staff,0,0,40,40
1683678102366,COMM 113T,A00,185352,Staff,25,0,40,15
1683678103392,COMM 114I,A00,185353,Staff,31,0,40,9
1683678104416,COMM 131,A00,185354,Staff,17,0,30,13
1683678105447,CSE 8A,A50,185358,Cao; Yingjun,0,46,10,10
1683678106471,CSE 8B,A01,185362,Staff,0,48,50,50
1683678107497,CSE 11,A01,185416,Cao; Yingjun,0,91,10,10
1683678108523,CSE 20,A01,185445,Briones; Jor-el Thomas Caparas,3,0,25,22
1683678109546,CSE 21,A01,185447,Staff,9,0,50,41
1683678110571,CSE 101,A01,185451,Staff,0,13,50,50
1683678110571,CSE 101,B01,185453,Jones; Miles E,0,14,50,50
1683678112626,CSE 141,A01,185458,Eldon; John,16,0,100,84
1683678113651,CSE 141L,A01,185461,Eldon; John,8,0,100,92
1683678114676,CSE 142,A01,185463,Staff,34,0,60,26
1683678114676,CSE 142,B01,201355,Staff,0,7,60,60
1683678115701,CSE 142L,A01,185470,Staff,34,0,60,26
1683678115701,CSE 142L,B01,201417,Staff,0,6,60,60
1683678116726,CSE 190,A00,201433,Staff,32,0,49,17
1683678117750,DOC 1,A01,259136,Strom; Megan C.,7,0,15,8
1683678117750,DOC 1,A02,259137,Strom; Megan C.,14,0,15,1
1683678117750,DOC 1,A03,259138,Strom; Megan C.,14,0,15,1
1683678117750,DOC 1,A04,259139,Strom; Megan C.,14,0,15,1
1683678118778,DOC 100D,A00,259140,Pass; Natalye Joann,14,0,25,11
1683678119807,DSGN 1,A01,184749,Rill; Bryan,0,26,30,30
1683678120831,DSGN 100,A01,185168,Staff,0,2,25,25
1683678121855,ECE 5,A01,185626,Morris; Karcher William,0,12,0,0
1683678122883,ECE 101,A01,185628,Staff,14,0,70,56
1683678123908,ECE 107,A01,185635,Baghdadchi; Saharnaz,0,0,20,20
1683678123908,ECE 107,A02,185638,Baghdadchi; Saharnaz,1,0,20,19
1683678124936,ECE 148,A01,185647,Silberman; Jack,0,0,16,16
1683678125963,ECON 1,A01,185537,Crane; Meredith Helen,54,0,70,16
1683678126987,ECON 3,A01,185549,Crane; Meredith Helen,29,0,70,41
1683678128012,ECON 4,A01,203354,Anderson; John Charles,0,5,10,10
1683678129035,ECON 100A,A01,185574,Staff,0,5,40,40
1683678130060,ECON 100B,A01,185576,Staff,0,12,50,50
1683678131088,ECON 100C,A01,185589,Newhouse; Herbert S,30,0,70,40
1683678132115,ECON 105,A00,185608,Vespa; Emanuel Ignacio,19,0,35,16
1683678133140,ECON 109,A01,185610,Shishkin; Denis,9,0,35,26
1683678134167,ECON 110A,A01,185612,Staff,9,0,40,31
1683678135193,ECON 120A,A01,185615,Staff,19,0,40,21
1683678136220,ECON 120C,A01,185617,Sun; Yixiao,0,21,70,70
1683678137249,ECON 144,A00,203346,Squires; Dale E,2,0,35,33
1683678138276,ECON 171,A01,203349,Newhouse; Herbert S,0,1,35,35
1683678139305,ECON 173A,A01,185621,Toda; Alexis Akira,21,0,35,14
1683678140330,EDS 25,A01,202413,Staff,0,1,0,0
1683678140330,EDS 25,A02,202414,Staff,0,1,0,0
1683678140330,EDS 25,A03,202415,Staff,0,0,0,0
1683678140330,EDS 25,A04,202416,Staff,0,1,0,0
1683678140330,EDS 25,A05,202439,Staff,0,0,0,0
1683678140330,EDS 25,A06,202440,Staff,0,0,0,0
1683678140330,EDS 25,B01,202631,Staff,0,0,0,0
1683678140330,EDS 25,B02,202632,Staff,0,0,0,0
1683678140330,EDS 25,B03,202639,Staff,0,0,0,0
1683678140330,EDS 25,B04,202640,Staff,0,0,0,0
1683678140330,EDS 25,B05,202643,Staff,0,0,0,0
1683678140330,EDS 25,B06,202644,Staff,0,0,0,0
1683678141357,EDS 38,A01,202659,Black; Alison Michelle,24,0,25,1
1683678142381,EDS 115,A00,202652,Staff,18,0,30,12
1683678143407,EDS 125,A00,202649,Staff,13,0,30,17
1683678144429,EDS 126,A01,203332,Staff,30,0,30,0
1683678145454,EDS 139,A00,202838,Staff,16,0,25,9
1683678146482,EDS 146,A01,202655,Staff,14,0,25,11
1683678147511,ENG 15,A00,185667,Staff,0,1,0,0
1683678147511,ENG 15,B00,185672,Staff,0,0,0,0
1683678147511,ENG 15,C00,185675,Staff,0,0,0,0
1683678147511,ENG 15,D00,185682,Staff,0,0,0,0
1683678147511,ENG 15,E00,185684,Staff,0,0,0,0
1683678148534,ETHN 103,A00,185710,Staff,0,8,35,35
1683678149559,ETHN 103A,A00,199228,Man; Simeon S,0,0,9,9
1683678150586,ETHN 109,A00,185711,Staff,15,0,35,20
1683678151611,ETHN 142,A00,185726,Staff,0,4,30,30
1683678152702,ETHN 163J,A00,199229,Man; Simeon S,5,0,8,3
1683678153728,ETHN 168,A00,185727,Staff,7,0,10,3
1683678154752,ETHN 182,A00,185728,Staff,0,0,35,35
1683678155779,ETHN 183,A00,185737,Staff,9,0,18,9
1683678156803,GLBH 111,A01,209361,Burgos; Jose L.,0,0,0,0
1683678158853,HIEU 104,A00,185792,Staff,14,0,20,6
1683678159876,HIEU 115,A00,185800,Staff,0,0,20,20
1683678160900,HIEU 128,A00,185801,Staff,0,9,20,20
1683678161928,HIEU 147,A00,185802,Staff,15,0,20,5
1683678162953,HIEU 154,A00,185823,Staff,11,0,20,9
1683678163977,HILA 102,A00,185826,Staff,14,0,20,6
1683678165001,HILD 2C,A01,185778,Staff,0,13,20,20
1683678166029,HILD 7B,A01,185780,Kwak; Nancy,0,17,32,32
1683678166029,HILD 7B,A02,185781,Kwak; Nancy,0,18,32,32
1683678167056,HILD 30,A01,185791,Staff,12,0,20,8
1683678168080,HISC 119,A00,185830,Golan; Tal,0,9,20,20
1683678169105,HITO 156GS,A00,185831,Patterson; Patrick H.,0,0,0,23
1683678170129,HIUS 103,A00,185832,Man; Simeon S,0,4,20,20
1683678171155,HIUS 117,A00,185836,Kwak; Nancy,2,0,20,18
1683678172178,HIUS 125,A00,185840,Man; Simeon S,0,2,23,23
1683678173202,HIUS 149,A00,185845,Staff,1,0,20,19
1683678174231,HUM 3,A01,185882,Zavodny; Tatiana Sophia,0,8,50,50
1683678174231,HUM 3,B01,185899,Caldwell; Michael Alan,0,18,50,50
1683678175255,HUM 3GS,A00,185900,Patterson; Patrick H.,0,0,0,23
1683678176281,HUM 4,A01,185938,Zroka; Amy Liane,28,0,50,22
1683678176281,HUM 4,B01,185956,Watkins; Eric,0,6,50,50
1683678176281,HUM 4,B02,202209,Watkins; Eric,0,5,50,50
1683678176281,HUM 4,B03,202210,Watkins; Eric,0,5,50,50
1683678177309,HUM 5,A01,185958,West; Geoffrey Scott,0,0,50,50
1683678177309,HUM 5,A02,202215,West; Geoffrey Scott,0,0,50,50
1683678178334,INTL 190,A00,185959,Gagnon; Jeffrey C,0,0,0,9
1683678178334,INTL 190,B00,185960,Lettieri; Michael Joseph,0,0,0,2
1683678179358,JAPN 180,A00,254509,Staff,5,0,30,25
1683678180384,LATI 10,A01,202853,Kennemore; Amy Michelle,4,0,35,31
1683678180384,LATI 10,A02,202854,Kennemore; Amy Michelle,3,0,35,32
1683678180384,LATI 10,A03,270054,Kennemore; Amy Michelle,30,0,30,0
1683678181407,LATI 180,A00,202855,Kennemore; Amy Michelle,11,0,20,9
1683678182433,LAWS 101,A00,201767,Golan; Tal,0,7,40,40
1683678183457,LIFR 1C,A00,185961,Staff,6,0,20,14
1683678184481,LIFR 1CX,A00,185962,Staff,7,0,20,13
1683678185505,LIFR 1D,A00,185963,Staff,7,0,20,13
1683678186529,LIFR 1DX,A00,185964,Staff,7,0,20,13
1683678187553,LIGN 101,A01,186039,Staff,43,0,50,7
1683678188577,LIGN 165,A00,186040,Staff,15,0,50,35
1683678189601,LTCS 108,A00,186041,Staff,5,0,10,5
1683678190629,LTCS 119,A00,186042,Staff,15,0,20,5
1683678191655,LTCS 130,A00,186043,Wesling; Megan E.,15,0,25,10
1683678193704,LTEA 138,A00,186119,Staff,14,0,40,26
1683678194732,LTEN 124,A00,186148,Staff,5,0,25,20
1683678195756,LTEN 178,A00,186149,Staff,7,0,15,8
1683678196781,LTEN 181,A00,186150,Blanco; John D,34,0,40,6
1683678197804,LTWL 120,A00,186160,Staff,19,0,25,6
1683678198831,LTWL 165,A00,186161,Staff,22,0,25,3
1683678199856,LTWR 100,A00,186162,Staff,0,5,15,15
1683678200883,LTWR 102,A00,186163,Doller; Ben,5,0,15,10
1683678201907,MAE 8,A01,186412,Staff,0,1,0,0
1683678202935,MAE 30B,A00,186445,Bahadori; Mohammad Yousef,82,0,100,18
1683678203962,MAE 40,A00,186592,Bewley; Thomas R,10,0,50,40
1683678204991,MAE 101B,A00,186593,Bahadori; Mohammad Yousef,80,0,100,20
1683678206018,MAE 105,A00,186594,Bandaru; Prabhakar,10,0,50,40
1683678207041,MAE 107,A00,186599,Pham; Hieu Tan,0,7,120,120
1683678208064,MAE 148,A01,186660,Silberman; Jack,3,0,16,13
1683678209091,MATH 10A,A01,188095,Staff,0,6,35,35
1683678210120,MATH 10B,A01,188097,Bowers; Adam R.,0,12,30,30
1683678210120,MATH 10B,A02,188099,Bowers; Adam R.,0,11,30,30
1683678210120,MATH 10B,B01,188104,Bowers; Adam R.,0,10,30,30
1683678210120,MATH 10B,B02,188106,Bowers; Adam R.,1,9,30,29
1683678211143,MATH 10C,A01,188111,Staff,0,20,30,30
1683678211143,MATH 10C,A02,188127,Staff,0,19,30,30
1683678211143,MATH 10C,A03,188131,Staff,0,19,30,30
1683678211143,MATH 10C,B01,188218,Staff,17,0,30,13
1683678211143,MATH 10C,B02,188244,Staff,13,0,30,17
1683678211143,MATH 10C,B03,188277,Staff,14,0,30,16
1683678212168,MATH 18,A01,188344,Bach; Quang Tran,18,0,30,12
1683678212168,MATH 18,A02,188345,Bach; Quang Tran,11,0,30,19
1683678212168,MATH 18,B01,188353,Bach; Quang Tran,11,0,30,19
1683678212168,MATH 18,B02,188354,Bach; Quang Tran,19,0,30,11
1683678213192,MATH 20A,A01,188374,Staff,11,0,35,24
1683678214215,MATH 20B,A01,188382,Ohm; Ko Woon,7,0,30,23
1683678214215,MATH 20B,A02,188383,Ohm; Ko Woon,22,0,30,8
1683678214215,MATH 20B,B01,188385,Ohm; Ko Woon,7,0,30,23
1683678214215,MATH 20B,B02,188392,Ohm; Ko Woon,22,0,30,8
1683678215241,MATH 20C,A01,188394,Harel; Guershon,10,0,30,20
1683678215241,MATH 20C,A02,188395,Harel; Guershon,13,0,30,17
1683678215241,MATH 20C,B01,188404,Harel; Guershon,5,0,30,25
1683678215241,MATH 20C,B02,188405,Harel; Guershon,18,0,30,12
1683678216267,MATH 20D,A01,188414,Hammock; Frances H,0,1,30,30
1683678216267,MATH 20D,A02,188415,Hammock; Frances H,0,1,30,30
1683678216267,MATH 20D,B01,188447,Hammock; Frances H,0,1,30,30
1683678216267,MATH 20D,B02,188486,Hammock; Frances H,3,0,30,27
1683678217297,MATH 20E,A01,188649,Staff,21,0,30,9
1683678217297,MATH 20E,A02,188650,Staff,20,0,30,10
1683678217297,MATH 20E,A03,188673,Staff,0,0,30,30
1683678218321,MATH 102,A01,188675,Staff,0,39,35,35
1683678219350,MATH 103B,A01,188681,Staff,3,0,35,32
1683678219350,MATH 103B,B01,188692,Staff,5,0,35,30
1683678220375,MATH 109,A01,188695,Salehi Golsefidy; Alireza,24,0,35,11
1683678220375,MATH 109,A02,188696,Salehi Golsefidy; Alireza,25,0,35,10
1683678221404,MATH 120A,A01,188698,Eggers; John Dietrich,7,0,35,28
1683678222430,MATH 142B,A01,188736,Ioana; Adrian,1,1,30,29
1683678222430,MATH 142B,A02,188741,Ioana; Adrian,0,1,30,30
1683678222430,MATH 142B,A03,188743,Ioana; Adrian,0,1,30,30
1683678223454,MATH 168A,A01,188790,Staff,0,11,35,35
1683678224479,MATH 170A,A01,188803,Nie; Jiawang,0,2,35,35
1683678224479,MATH 170A,A02,188811,Nie; Jiawang,0,1,35,35
1683678224479,MATH 170A,A03,188814,Nie; Jiawang,0,0,35,35
1683678224479,MATH 170A,A04,188815,Nie; Jiawang,6,0,35,29
1683678225507,MATH 193B,A01,188817,Staff,0,0,35,35
1683678225507,MATH 193B,A02,188818,Staff,5,0,35,30
1683678226532,MGT 4,A01,202857,Anderson; John Charles,60,0,80,20
1683678227561,MGT 12,A00,202858,Lindenberger; Wade Douglas,40,0,90,50
1683678228587,MGT 18,A00,202859,Staff,74,0,90,16
1683678229615,MGT 18GS,A00,202860,McKay; Michael J,13,0,28,15
1683678230640,MGT 45,A00,202861,Pecore; Joseph P.,9,0,90,81
1683678231665,MGT 100,A00,202863,Yavorsky; Daniel Ryan,28,0,90,62
1683678232689,MGT 103,A00,202864,Ehrich; Kristine R,0,18,90,90
1683678233713,MGT 112,A00,202865,Ehrich; Kristine R,15,0,90,75
1683678234741,MGT 121A,A00,202868,Staff,90,20,90,0
1683678235769,MGT 131B,A00,202869,Anderson; John Charles,59,0,90,31
1683678236803,MGT 136,A00,202871,Lindenberger; Wade Douglas,83,0,90,7
1683678237828,MGT 164,A00,202873,Staff,0,67,90,91
1683678238855,MGT 164GS,A00,202874,McKay; Mary A,13,0,28,15
1683678239880,MGT 180,A00,202875,Staff,0,51,90,91
1683678240908,MMW 11R,A01,205019,Herbst; Matthew,0,0,30,30
1683678240908,MMW 11R,A02,205026,Herbst; Matthew,29,0,30,1
1683678241934,MMW 15,A01,193512,Chang; Edmond Yi-Teh,0,8,28,28
1683678241934,MMW 15,A02,193513,Chang; Edmond Yi-Teh,0,5,28,28
1683678241934,MMW 15,A03,193514,Chang; Edmond Yi-Teh,0,5,28,28
1683678241934,MMW 15,A04,193515,Chang; Edmond Yi-Teh,0,5,28,28
1683678241934,MMW 15,A05,193516,Chang; Edmond Yi-Teh,0,5,28,28
1683678241934,MMW 15,A06,193517,Chang; Edmond Yi-Teh,0,6,28,28
1683678241934,MMW 15,B01,193519,Chang; Edmond Yi-Teh,0,5,28,28
1683678241934,MMW 15,B02,193520,Chang; Edmond Yi-Teh,0,5,28,28
1683678241934,MMW 15,B03,193521,Chang; Edmond Yi-Teh,0,5,28,28
1683678241934,MMW 15,B04,193522,Chang; Edmond Yi-Teh,0,5,28,28
1683678241934,MMW 15,B05,193523,Chang; Edmond Yi-Teh,0,5,28,28
1683678241934,MMW 15,B06,193524,Chang; Edmond Yi-Teh,0,5,28,28
1683678242958,MMW 122,A01,193526,Rahimi; Babak,0,16,28,28
1683678242958,MMW 122,A02,193527,Rahimi; Babak,0,15,28,28
1683678242958,MMW 122,A03,193528,Rahimi; Babak,0,0,0,0
1683678242958,MMW 122,A04,193529,Rahimi; Babak,0,0,0,0
1683678243982,MUS 1A,A01,186663,Staff,1,19,35,34
1683678245010,MUS 4,A01,186715,Staff,0,12,35,35
1683678246037,MUS 5R,A01,186796,Dubnov; Shlomo,0,17,35,35
1683678247060,MUS 6,A01,186798,Staff,0,5,25,25
1683678248084,MUS 7,A01,186830,Staff,11,0,35,24
1683678249111,MUS 8,A01,186930,Staff,0,27,35,35
1683678250138,MUS 15,A01,186932,Staff,0,15,35,35
1683678250138,MUS 15,B01,186934,Staff,1,17,35,34
1683678251164,MUS 80,A00,186935,Staff,0,0,20,20
1683678251164,MUS 80,B00,186936,Staff,24,0,25,1
1683678252193,NANO 11,A00,204702,Lipomi; Darren John,0,0,0,0
1683678253216,NANO 15,A01,204709,Yang; Kesong,0,1,0,0
1683678254242,NANO 114,A00,202069,Jahed Motlagh; Zeinab,3,0,10,7
1683678255269,PHIL 1,A00,186955,Grush; Rick Scott,31,0,40,9
1683678256350,PHIL 10,A01,186973,Grush; Rick Scott,27,0,35,8
1683678256350,PHIL 10,A02,186974,Grush; Rick Scott,33,0,35,2
1683678257377,PHIL 13,A01,186976,Staff,3,0,35,32
1683678257377,PHIL 13,A02,186977,Staff,16,0,35,19
1683678258402,PHIL 14,A01,186979,Staff,31,0,35,4
1683678258402,PHIL 14,A02,186986,Staff,32,0,35,3
1683678259426,PHIL 28,A01,186988,Staff,16,0,30,14
1683678259426,PHIL 28,A02,186989,Staff,1,0,30,29
1683678259426,PHIL 28,A03,186990,Staff,10,0,30,20
1683678259426,PHIL 28,A04,186991,Staff,26,0,30,4
1683678260451,PHIL 120,A00,186997,Staff,23,0,40,17
1683678261478,PHIL 137,A00,187003,Staff,7,0,40,33
1683678262505,PHIL 150,A00,187015,Staff,47,0,70,23
1683678263529,PHIL 167,A00,187021,Lamey; Andy M.,34,0,40,6
1683678264554,PHIL 174,A01,202226,Staff,17,0,20,3
1683678264554,PHIL 174,A02,202235,Staff,20,0,20,0
1683678265580,PHIL 191A,A00,258918,Staff,0,0,1,1
1683678266605,PHYS 1A,A00,187028,Staff,26,0,60,34
1683678267629,PHYS 1AL,001,187036,Staff,3,0,30,27
1683678267629,PHYS 1AL,002,187049,Staff,18,0,30,12
1683678268652,PHYS 1B,A00,187058,Staff,22,0,60,38
1683678269680,PHYS 1BL,001,187064,Staff,0,1,30,30
1683678269680,PHYS 1BL,002,187070,Staff,4,0,30,26
1683678270705,PHYS 1C,A00,187082,Staff,29,0,120,91
1683678271731,PHYS 1CL,001,187088,Staff,0,9,30,30
1683678271731,PHYS 1CL,002,187089,Staff,0,1,30,30
1683678271731,PHYS 1CL,009,262693,Staff,9,0,30,21
1683678272758,PHYS 2B,A01,187097,Staff,55,0,115,60
1683678273785,PHYS 2C,A01,187099,Staff,63,0,115,52
1683678274812,PHYS 2CL,A01,187101,Staff,5,0,28,23
1683678274812,PHYS 2CL,A02,187102,Staff,15,0,28,13
1683678275840,PHYS 2D,A01,187123,Shotwell; Brian,95,0,115,20
1683678276865,PHYS 4B,A01,187133,Grinstein; Benjamin,35,0,50,15
1683678277890,POLI 10,A00,188819,Staff,0,4,50,50
1683678278914,POLI 11,A00,188827,Staff,43,0,50,7
1683678279938,POLI 13R,A00,188828,Staff,0,1,20,20
1683678280966,POLI 27,A01,188830,Elgin; Samuel Zincke,0,2,70,70
1683678281994,POLI 30,A00,188832,Desposato; Scott,30,0,50,20
1683678283020,POLI 102F,A00,188834,Staff,0,0,40,40
1683678284045,POLI 104A,A00,188852,Staff,12,0,30,18
1683678285069,POLI 104I,A00,188853,Staff,0,8,20,20
1683678286095,POLI 110B,A00,188854,Wiens; David,6,0,20,14
1683678287123,POLI 112A,A00,188855,Wiens; David,3,0,30,27
1683678288146,POLI 117R,A00,188856,Forman; Fonna,0,12,20,20
1683678289170,POLI 118,A00,188857,Ingham; Sean,8,0,20,12
1683678290198,POLI 120G,A00,188858,Staff,8,0,30,22
1683678291225,POLI 131CR,A00,188863,Hoston; Germaine,20,0,50,30
1683678292249,POLI 133,A00,188864,Nellis; Gareth Hb,44,0,50,6
1683678293274,POLI 134D,A00,188865,Desposato; Scott,27,0,30,3
1683678294298,POLI 142A,A00,188871,Gartzke; Erik,21,0,50,29
1683678295322,POLI 142K,A00,188874,Staff,38,0,50,12
1683678296347,POLI 143,A00,188940,Gartzke; Erik,16,0,30,14
1683678297371,POLI 153,A00,188943,Staff,2,0,20,18
1683678298394,POLI 160AA,A00,188944,Staff,10,0,40,30
1683678299417,POLI 170A,A00,188945,Staff,10,0,30,20
1683678301467,PSYC 1,A00,188952,Staff,36,0,90,54
1683678302496,PSYC 2,B00,188953,Staff,19,0,35,16
1683678303521,PSYC 6,A00,188970,Staff,47,0,60,13
1683678304549,PSYC 7,A00,188973,Staff,35,0,45,10
1683678305577,PSYC 60,A01,188980,Rickard; Timothy C.,42,0,60,18
1683678306609,PSYC 70,A01,189001,Steiner; Eric Tomas,21,0,45,24
1683678307637,PSYC 100,A00,189005,Lacefield; Katharine I,0,99,120,120
1683678308662,PSYC 102,A00,189008,Staff,7,0,30,23
1683678309686,PSYC 106,B00,189026,Gorman; Michael R.,27,0,60,33
1683678310711,PSYC 114,B01,189033,Winkielman; Piotr,0,31,30,30
1683678311734,PSYC 131,A00,189036,Anagnostaras; Stephan,0,43,60,60
1683678312758,PSYC 136,A00,189041,Lowe; Angela Beth,0,7,25,25
1683678313781,PSYC 137,A00,189057,Winkielman; Piotr,1,37,25,24
1683678314805,PSYC 144,A00,189107,Wixted; John T,0,11,50,50
1683678316855,PSYC 162,A00,189142,Staff,0,9,85,85
1683678317885,PSYC 172,A00,189144,Gorman; Michael R.,0,6,30,30
1683678319937,PSYC 179,A00,189146,Lacefield; Katharine I,0,87,120,120
1683678320965,PSYC 181,A00,189147,Anagnostaras; Stephan,0,44,90,90
1683678321992,PSYC 190R,A00,189148,Barner; David A.,0,23,80,80
1683678323016,PSYC 191,A00,189275,Rickard; Timothy C.,0,10,25,25
1683678324043,PSYC 193,A00,189276,Chapman; Eddie Nathaniel,0,1,0,4
1683678325068,PSYC 193L,A01,189281,Lowe; Angela Beth,8,0,20,12
1683678325068,PSYC 193L,B01,189285,Staff,28,0,35,7
1683678326096,RELI 149,A00,187137,Rahimi; Babak,7,0,40,33
1683678327122,SE 9,A01,187315,Staff,0,2,18,18
1683678328151,SE 101B,A00,187409,Staff,24,0,30,6
1683678329178,SE 110B,A00,187444,Staff,10,0,40,30
1683678330203,SE 130B,A00,187449,Staff,31,0,40,9
1683678331233,SE 150A,A00,187516,Staff,8,0,20,12
1683678332259,SE 154,A00,187528,Staff,29,0,50,21
1683678333287,SIO 3,A01,258171,Staff,35,0,40,5
1683678334313,SIO 10,A00,187144,Cook; Geoffrey W,1,7,75,74
1683678335337,SIO 45,A00,187152,Cook; Geoffrey W,0,7,100,100
1683678336362,SIO 109R,A00,194486,Staff,0,4,20,20
1683678338412,SIO 187,A01,187233,Kacev; David,12,0,40,28
1683678339437,SOCI 1,A01,258656,Thorpe; Charles Robert,28,0,30,2
1683678339437,SOCI 1,A02,258658,Thorpe; Charles Robert,30,0,30,0
1683678339437,SOCI 1,A03,258661,Thorpe; Charles Robert,25,0,25,0
1683678339437,SOCI 1,A04,258666,Thorpe; Charles Robert,22,0,25,3
1683678339437,SOCI 1,A05,258897,Thorpe; Charles Robert,22,0,25,3
1683678339437,SOCI 1,A06,258898,Thorpe; Charles Robert,25,0,25,0
1683678340460,SOCI 30,A01,258903,Pardo Guerra; Juan Pablo,14,0,30,16
1683678341485,SOCI 102,A00,258904,Staff,9,0,25,16
1683678342508,SOCI 106,A00,258905,Staff,19,0,25,6
1683678343532,SOCI 111,A00,258907,Ribas Norris; Janet Vanesa,26,0,30,4
1683678344560,SOCI 121R,A00,258908,Pardo Guerra; Juan Pablo,8,0,30,22
1683678345586,SOCI 126,A01,203330,Staff,14,0,20,6
1683678346611,SOCI 131,A00,258909,Thorpe; Charles Robert,30,0,60,30
1683678347639,SOCI 135,A00,258910,Payne; Christine Anna,0,12,30,30
1683678348663,SOCI 157,A00,258911,Staff,11,0,30,19
1683678349689,SOCI 184,A00,258912,Staff,25,0,30,5
1683678350716,SOCI 188D,A00,258913,Staff,22,0,30,8
1683678351740,SYN 2,001,187529,Staff,9,0,16,7
1683678351740,SYN 2,002,201452,Staff,1,20,16,15
1683678351740,SYN 2,003,201469,Staff,1,0,16,15
1683678352764,SYN 100,A01,187531,Staff,0,9,20,20
1683678352764,SYN 100,B01,201491,Staff,0,10,20,20
1683678353793,TDAC 1,A00,189286,Walsh; Kim C.,3,0,20,17
1683678353793,TDAC 1,B00,189287,Harting; Carla Kelso,10,0,20,10
1683678354820,TDAC 101,A00,189300,Walsh; Kim C.,16,0,20,4
1683678354820,TDAC 101,B00,189301,Harting; Carla Kelso,18,0,20,2
1683678355846,TDAC 102,A00,189304,Basso; Beatrice,14,0,20,6
1683678356877,TDAC 108,A00,189305,Staff,18,0,20,2
1683678357903,TDDE 131,A00,189310,Staff,19,0,20,1
1683678357903,TDDE 131,B00,189314,Staff,19,0,20,1
1683678357903,TDDE 131,C00,189315,Staff,48,0,50,2
1683678357903,TDDE 131,D00,189316,Staff,14,0,15,1
1683678357903,TDDE 131,E00,204841,Staff,20,0,20,0
1683678358929,TDGE 10,A00,189289,Staff,27,0,50,23
1683678358929,TDGE 10,B00,189290,Havis; Allan,0,1,50,50
1683678360018,TDGE 11,A00,189291,Fulton; Julia,0,4,50,50
1683678360018,TDGE 11,B00,189292,Staff,20,0,25,5
1683678360018,TDGE 11,C00,260270,Staff,0,0,0,0
1683678361042,TDGE 25,A00,189294,Staff,1,0,20,19
1683678362066,TDGE 124,A00,189318,Fulton; Julia,0,8,50,50
1683678363098,TDGE 125,A00,189319,Staff,13,0,25,12
1683678363098,TDGE 125,B00,189320,Staff,23,0,25,2
1683678364122,TDGE 127,A00,189322,Havis; Allan,0,0,50,50
1683678365151,TDHT 101,A00,189323,Staff,18,0,25,7
1683678365151,TDHT 101,B00,189324,Staff,25,0,25,0
1683678366176,TDHT 102,A00,189325,Staff,49,0,50,1
1683678367198,TDMV 1,A00,189295,Arcidiacono; Kristin,20,0,30,10
1683678367198,TDMV 1,B00,189296,Caligagan; Maria T.,24,0,30,6
1683678368226,TDMV 2,A00,189297,Sammartano; Tonnie,27,0,30,3
1683678368226,TDMV 2,B00,189299,Arcidiacono; Kristin,23,0,30,7
1683678369254,TDMV 3,A00,204998,Rincon; Alicia,22,0,30,8
1683678370278,TDMV 120,A00,189458,Sammartano; Tonnie,28,0,30,2
1683678371308,TDMV 138,A00,189541,Jun; Grace Shin Hae,20,0,40,20
1683678372335,TDMV 142,A00,189717,Caligagan; Tony,25,0,30,5
1683678372335,TDMV 142,B00,189718,Caligagan; Maria T.,25,0,30,5
1683678373359,TMC 2,A01,187533,Staff,25,0,25,0
1683678373359,TMC 2,A02,187534,Staff,25,0,25,0
1683678374387,USP 1,A01,187536,Kwak; Nancy,0,16,25,25
1683678375411,USP 5,A01,187538,Staff,8,0,25,17
1683678376434,USP 101,A00,199253,Staff,0,4,0,0
1683678377458,USP 124,A00,187562,Boomhower; Matthew Charles,0,0,30,30
1683678378487,USP 138,A00,187582,Staff,19,0,25,6
1683678379511,USP 152,A01,187597,Staff,3,0,25,22
1683678380537,USP 153,A00,187598,Staff,19,0,25,6
1683678381562,USP 168,A00,187607,Kwak; Nancy,2,0,5,3
1683678382589,USP 173,A00,187619,Staff,4,0,25,21
1683678383612,USP 181,A00,187638,Staff,0,4,25,25
1683678384637,VIS 103,A00,187650,Cruz; Edwin Teddy,17,0,75,58
1683678385665,VIS 110D,A00,187669,Staff,13,0,22,9
1683678386694,VIS 127C,A00,187720,Shen; Kuiyi,67,0,146,79
1683678387718,VIS 149,A00,187731,Yoldas; Pinar,1,14,22,21
1683678388744,VIS 151,A01,188091,Staff,22,0,34,12
1683678388744,VIS 151,A02,188092,Staff,11,0,34,23
1683678389772,VIS 160B,A00,188093,Stalbaum; Brett,0,1,10,10
1683678391824,WCWP 10B,A00,201720,Staff,0,0,5,5
1683678391824,WCWP 10B,B00,201722,Staff,0,0,6,6
1683678392849,WCWP 100,A00,201725,Gagnon; Jeffrey C,0,0,2,2
1683678392849,WCWP 100,B00,201727,Staff,0,4,15,15
1683678395935,ANBI 133,A00,258401,Wilder; Linnea Lorene,34,0,40,6
1683678396963,ANBI 140,A00,258395,Hrvoj Mihic; Branka,18,0,25,7
1683678397991,ANSC 120,A00,258402,Bialecki; Jon Anthony,26,0,40,14
1683678399016,ANSC 144,A00,258400,Staff,12,0,40,28
1683678401064,ANSC 166,A00,258396,Parish; Steven Martin,156,0,175,19
1683678402092,ANSC 180,A00,193533,Staff,8,0,20,12
1683678403116,ANSC 188,A00,258397,Jassal; Aftab,34,0,40,6
1683678404144,ANTH 3,A01,258316,Staff,23,0,30,7
1683678405170,ANTH 5,A00,258394,Semendeferi; Ekaterini,16,0,20,4
1683678406195,ANTH 21,A01,258331,Staff,4,0,40,36
1683678407219,ANTH 103,A00,258398,Varma; Saiba,15,0,25,10
1683678408246,AWP 10,001,202034,Staff,0,0,0,0
1683678408246,AWP 10,002,202035,Staff,0,0,0,0
1683678408246,AWP 10,003,202036,Staff,0,0,0,0
1683678408246,AWP 10,004,202037,Staff,0,0,0,0
1683678408246,AWP 10,005,202038,Staff,0,0,0,0
1683678408246,AWP 10,006,202039,Staff,0,0,0,0
1683678408246,AWP 10,007,202040,Staff,0,0,0,0
1683678408246,AWP 10,008,202041,Staff,0,0,0,0
1683678408246,AWP 10,009,202042,Staff,0,0,0,0
1683678408246,AWP 10,010,202043,Staff,0,0,0,0
1683678408246,AWP 10,011,202044,Staff,0,0,0,0
1683678408246,AWP 10,012,202045,Staff,0,0,0,0
1683678408246,AWP 10,013,202046,Staff,0,0,0,0
1683678408246,AWP 10,014,202047,Staff,0,0,0,0
1683678408246,AWP 10,015,202048,Staff,0,0,0,0
1683678408246,AWP 10,016,202049,Staff,0,0,0,0
1683678408246,AWP 10,017,202050,Staff,0,0,0,0
1683678408246,AWP 10,018,202051,Staff,0,0,0,0
1683678408246,AWP 10,019,202052,Staff,0,0,0,0
1683678408246,AWP 10,020,202053,Staff,0,0,0,0
1683678408246,AWP 10,021,202054,Staff,0,0,0,0
1683678408246,AWP 10,022,202055,Staff,0,0,0,0
1683678408246,AWP 10,023,202056,Staff,0,0,0,0
1683678408246,AWP 10,024,202057,Staff,0,0,0,0
1683678408246,AWP 10,025,202058,Staff,0,0,0,0
1683678408246,AWP 10,026,202059,Staff,0,0,0,0
1683678409273,AWP 102,001,202032,Staff,0,0,0,0
1683678409273,AWP 102,002,202033,Staff,0,0,0,0
1683678410297,BENG 100,A01,254234,Taylor Amos; Alyssa C,31,0,40,9
1683678411321,BENG 196,001,270013,Engler; Adam J.,9999,0,9999,0
1683678412349,BICD 100R,A01,202018,Smith; Laurie,0,7,32,32
1683678412349,BICD 100R,A02,202019,Smith; Laurie,0,3,32,32
1683678412349,BICD 100R,A03,202020,Smith; Laurie,0,1,32,32
1683678412349,BICD 100R,A04,202021,Smith; Laurie,6,0,32,26
1683678412349,BICD 100R,A05,202022,Smith; Laurie,10,0,32,22
1683678413374,BICD 136,A01,193242,Gustafson-Brown; Cindy,0,2,32,32
1683678413374,BICD 136,A02,193244,Gustafson-Brown; Cindy,13,0,32,19
1683678414400,BIEB 102,A01,193249,Butler; Shannon Rhey,1,1,32,31
1683678414400,BIEB 102,A02,193251,Butler; Shannon Rhey,0,0,32,32
1683678414400,BIEB 102,A03,193253,Butler; Shannon Rhey,0,0,32,32
1683678414400,BIEB 102,A04,193255,Butler; Shannon Rhey,13,0,32,19
1683678414400,BIEB 102,A05,193265,Butler; Shannon Rhey,25,0,32,7
1683678414400,BIEB 102,A06,193269,Butler; Shannon Rhey,13,0,32,19
1683678416452,BIEB 150,A01,193274,Staff,0,0,32,32
1683678416452,BIEB 150,A02,193285,Staff,24,0,32,8
1683678417479,BIEB 194,A00,193286,Kurle; Carolyn M.,19,0,32,13
1683678418505,BILD 1,A01,192291,Staff,15,0,32,17
1683678418505,BILD 1,A02,192292,Staff,30,0,32,2
1683678418505,BILD 1,B01,192520,Reuther; Keefe,0,1,0,0
1683678418505,BILD 1,B02,192532,Reuther; Keefe,0,1,0,0
1683678419534,BILD 3,A01,192556,Butler; Shannon Rhey,0,0,32,32
1683678419534,BILD 3,A02,192581,Butler; Shannon Rhey,0,1,32,32
1683678419534,BILD 3,A03,192611,Butler; Shannon Rhey,19,0,32,13
1683678419534,BILD 3,A04,192612,Butler; Shannon Rhey,24,0,32,8
1683678419534,BILD 3,A05,192613,Butler; Shannon Rhey,26,0,32,6
1683678419534,BILD 3,A06,192679,Butler; Shannon Rhey,27,0,32,5
1683678419534,BILD 3,A07,192682,Butler; Shannon Rhey,20,0,32,12
1683678420559,BILD 4,A01,192836,Reuther; Keefe,1,0,24,23
1683678420559,BILD 4,A02,193044,Reuther; Keefe,4,0,24,20
1683678421585,BILD 10,A01,193142,Gustafson-Brown; Cindy,29,0,32,3
1683678421585,BILD 10,A02,193149,Gustafson-Brown; Cindy,31,0,32,1
1683678422610,BIMM 100,A01,193301,Staff,0,6,32,32
1683678422610,BIMM 100,A02,193312,Staff,0,7,32,32
1683678422610,BIMM 100,A03,193323,Staff,0,10,32,32
1683678423637,BIMM 101,A01,193329,McDonnell; Lisa Marie,1,4,24,23
1683678423637,BIMM 101,A02,193339,McDonnell; Lisa Marie,1,4,24,23
1683678423637,BIMM 101,B01,193354,McDonnell; Lisa Marie,0,4,24,24
1683678423637,BIMM 101,B02,193357,McDonnell; Lisa Marie,0,3,24,24
1683678424666,BIMM 110,A01,193377,Tat; John,0,11,32,32
1683678424666,BIMM 110,A02,193378,Tat; John,0,11,32,32
1683678425693,BIMM 120,A01,206116,Staff,0,0,32,32
1683678425693,BIMM 120,A02,206117,Staff,7,0,32,25
1683678425693,BIMM 120,A03,206121,Staff,21,0,32,11
1683678426719,BIPN 100,A01,193393,Park; Ji Young,0,15,32,32
1683678426719,BIPN 100,A02,193402,Park; Ji Young,0,14,32,32
1683678426719,BIPN 100,A03,193413,Park; Ji Young,0,14,32,32
1683678426719,BIPN 100,A04,193414,Park; Ji Young,0,13,32,32
1683678427744,BIPN 102,A01,193429,Staff,0,0,32,32
1683678427744,BIPN 102,A02,193438,Staff,18,0,32,14
1683678428768,BIPN 106,A01,193450,Reyes Gonzalez; Catalina,0,2,40,40
1683678429795,BIPN 134,A01,193465,Cooke; James Edward,0,0,32,32
1683678429795,BIPN 134,A02,193474,Cooke; James Edward,25,0,32,7
1683678429795,BIPN 134,A03,193485,Cooke; James Edward,29,0,32,3
1683678429795,BIPN 134,A04,193486,Cooke; James Edward,20,0,32,12
1683678429795,BIPN 134,A05,193491,Cooke; James Edward,31,0,32,1
1683678429795,BIPN 134,A06,193501,Cooke; James Edward,30,0,32,2
1683678429795,BIPN 134,A07,193510,Cooke; James Edward,29,0,32,3
1683678431850,BISP 194,A00,222522,Staff,14,0,32,18
1683678432875,CAT 124,A01,202407,Staff,19,0,25,6
1683678433901,CAT 125,A00,202408,Marchisotto; Jennifer Anne,2,0,20,18
1683678434927,CAT 125R,A00,202409,Smith; Lauryn Alissa,0,11,20,20
1683678434927,CAT 125R,B00,202410,Morales; Celeste Georgianna,0,11,20,20
1683678434927,CAT 125R,C00,202411,Irwin; Matthew Joseph,0,12,20,20
1683678435956,CENG 15,A01,204712,Yang; Kesong,0,1,0,0
1683678436980,CENG 114,A00,202070,Jahed Motlagh; Zeinab,5,0,20,15
1683678438008,CGS 105,A00,185477,Wesling; Megan E.,24,0,40,16
1683678439035,CGS 106,A00,185494,Staff,11,0,22,11
1683678440059,CGS 108,A00,185495,Staff,14,0,20,6
1683678441083,CGS 114,A00,185496,Staff,13,0,18,5
1683678442106,CGS 119,A00,185501,Staff,15,0,20,5
1683678443130,CGS 120,A00,185511,Staff,12,0,20,8
1683678444159,CHEM 4,A01,184675,Bussey; Thomas J,97,0,100,3
1683678445185,CHEM 6A,A01,184677,Staff,32,0,60,28
1683678446209,CHEM 6B,A01,184679,Staff,63,0,100,37
1683678447233,CHEM 6C,A01,184681,Bussey; Thomas J,0,0,50,50
1683678447233,CHEM 6C,A02,184682,Bussey; Thomas J,32,0,50,18
1683678448256,CHEM 40A,A01,184684,Albizati; Kim F.,33,0,100,67
1683678449283,CHEM 40B,A01,184686,Albizati; Kim F.,0,22,100,100
1683678450309,CHEM 41B,A01,184690,Staff,51,0,100,49
1683678451337,COGS 3,A01,184715,Boyle; Mary E. T.,0,27,40,40
1683678452365,COGS 14B,A01,185172,Staff,0,14,38,38
1683678453390,COGS 18,A01,184736,Staff,14,0,80,66
1683678454414,COGS 100,A01,184932,Staff,0,8,73,73
1683678455438,COGS 101A,A01,184935,Staff,0,40,30,30
1683678456466,COGS 101B,A01,184944,Staff,0,2,30,30
1683678457489,COGS 101C,A01,184946,Staff,0,10,30,30
1683678458513,COGS 102A,A01,184951,Johnson; Christine M.,2,0,40,38
1683678459538,COGS 107B,A01,184953,Mooshagian; Eric Frederick,0,52,40,40
1683678460565,COGS 118B,A01,184959,Gupta; Anjum,0,50,40,40
1683678461593,COGS 153,A00,184961,Staff,0,16,30,30
1683678462622,COGS 177,A00,184962,Staff,0,21,30,30
1683678463700,COGS 187A,A01,184969,Boyle; Mary E. T.,0,19,40,40
1683678464725,COMM 10,A01,185174,Staff,0,5,25,25
1683678464725,COMM 10,A02,185189,Staff,0,2,25,25
1683678464725,COMM 10,A03,269821,Staff,0,1,0,0
1683678465750,COMM 100B,A02,185476,Staff,11,0,25,14
1683678465750,COMM 100B,A03,277340,Staff,25,0,25,0
1683678466784,COMM 100C,A01,185314,Staff,1,0,25,24
1683678466784,COMM 100C,A02,185327,Staff,17,0,25,8
1683678467812,COMM 110M,A00,185349,Staff,0,0,40,40
1683678468836,COMM 113T,A00,185352,Staff,25,0,40,15
1683678469859,COMM 114I,A00,185353,Staff,31,0,40,9
1683678470885,COMM 131,A00,185354,Staff,17,0,30,13
1683678471910,CSE 8A,A50,185358,Cao; Yingjun,0,46,10,10
1683678472936,CSE 8B,A01,185362,Staff,0,48,50,50
1683678473961,CSE 11,A01,185416,Cao; Yingjun,0,91,10,10
1683678474989,CSE 20,A01,185445,Briones; Jor-el Thomas Caparas,3,0,25,22
1683678476016,CSE 21,A01,185447,Staff,9,0,50,41
1683678477044,CSE 101,A01,185451,Staff,0,13,50,50
1683678477044,CSE 101,B01,185453,Jones; Miles E,0,14,50,50
1683678479099,CSE 141,A01,185458,Eldon; John,16,0,100,84
1683678480127,CSE 141L,A01,185461,Eldon; John,8,0,100,92
1683678481151,CSE 142,A01,185463,Staff,34,0,60,26
1683678481151,CSE 142,B01,201355,Staff,0,7,60,60
1683678482177,CSE 142L,A01,185470,Staff,34,0,60,26
1683678482177,CSE 142L,B01,201417,Staff,0,6,60,60
1683678483201,CSE 190,A00,201433,Staff,32,0,49,17
1683678484226,DOC 1,A01,259136,Strom; Megan C.,7,0,15,8
1683678484226,DOC 1,A02,259137,Strom; Megan C.,14,0,15,1
1683678484226,DOC 1,A03,259138,Strom; Megan C.,14,0,15,1
1683678484226,DOC 1,A04,259139,Strom; Megan C.,14,0,15,1
1683678485254,DOC 100D,A00,259140,Pass; Natalye Joann,14,0,25,11
1683678486283,DSGN 1,A01,184749,Rill; Bryan,0,26,30,30
1683678487310,DSGN 100,A01,185168,Staff,0,2,25,25
1683678488338,ECE 5,A01,185626,Morris; Karcher William,0,12,0,0
1683678489365,ECE 101,A01,185628,Staff,14,0,70,56
1683678490389,ECE 107,A01,185635,Baghdadchi; Saharnaz,0,0,20,20
1683678490389,ECE 107,A02,185638,Baghdadchi; Saharnaz,1,0,20,19
1683678491414,ECE 148,A01,185647,Silberman; Jack,0,0,16,16
1683678492442,ECON 1,A01,185537,Crane; Meredith Helen,54,0,70,16
1683678493467,ECON 3,A01,185549,Crane; Meredith Helen,29,0,70,41
1683678494495,ECON 4,A01,203354,Anderson; John Charles,0,5,10,10
1683678495521,ECON 100A,A01,185574,Staff,0,5,40,40
1683678496550,ECON 100B,A01,185576,Staff,0,12,50,50
1683678497579,ECON 100C,A01,185589,Newhouse; Herbert S,30,0,70,40
1683678498602,ECON 105,A00,185608,Vespa; Emanuel Ignacio,19,0,35,16
1683678499626,ECON 109,A01,185610,Shishkin; Denis,9,0,35,26
1683678500653,ECON 110A,A01,185612,Staff,9,0,40,31
1683678501678,ECON 120A,A01,185615,Staff,19,0,40,21
1683678502706,ECON 120C,A01,185617,Sun; Yixiao,0,21,70,70
1683678503733,ECON 144,A00,203346,Squires; Dale E,2,0,35,33
1683678504761,ECON 171,A01,203349,Newhouse; Herbert S,0,1,35,35
1683678505793,ECON 173A,A01,185621,Toda; Alexis Akira,21,0,35,14
1683678506837,EDS 25,A01,202413,Staff,0,1,0,0
1683678506837,EDS 25,A02,202414,Staff,0,1,0,0
1683678506837,EDS 25,A03,202415,Staff,0,0,0,0
1683678506837,EDS 25,A04,202416,Staff,0,1,0,0
1683678506837,EDS 25,A05,202439,Staff,0,0,0,0
1683678506837,EDS 25,A06,202440,Staff,0,0,0,0
1683678506837,EDS 25,B01,202631,Staff,0,0,0,0
1683678506837,EDS 25,B02,202632,Staff,0,0,0,0
1683678506837,EDS 25,B03,202639,Staff,0,0,0,0
1683678506837,EDS 25,B04,202640,Staff,0,0,0,0
1683678506837,EDS 25,B05,202643,Staff,0,0,0,0
1683678506837,EDS 25,B06,202644,Staff,0,0,0,0
1683678507865,EDS 38,A01,202659,Black; Alison Michelle,24,0,25,1
1683678508887,EDS 115,A00,202652,Staff,18,0,30,12
1683678509910,EDS 125,A00,202649,Staff,13,0,30,17
1683678510937,EDS 126,A01,203332,Staff,30,0,30,0
1683678511965,EDS 139,A00,202838,Staff,16,0,25,9
1683678512989,EDS 146,A01,202655,Staff,14,0,25,11
1683678514014,ENG 15,A00,185667,Staff,0,1,0,0
1683678514014,ENG 15,B00,185672,Staff,0,0,0,0
1683678514014,ENG 15,C00,185675,Staff,0,0,0,0
1683678514014,ENG 15,D00,185682,Staff,0,0,0,0
1683678514014,ENG 15,E00,185684,Staff,0,0,0,0
1683678515038,ETHN 103,A00,185710,Staff,0,8,35,35
1683678516062,ETHN 103A,A00,199228,Man; Simeon S,0,0,9,9
1683678517086,ETHN 109,A00,185711,Staff,15,0,35,20
1683678518111,ETHN 142,A00,185726,Staff,0,4,30,30
1683678519137,ETHN 163J,A00,199229,Man; Simeon S,5,0,8,3
1683678520164,ETHN 168,A00,185727,Staff,7,0,10,3
1683678521189,ETHN 182,A00,185728,Staff,0,0,35,35
1683678522213,ETHN 183,A00,185737,Staff,9,0,18,9
1683678523240,GLBH 111,A01,209361,Burgos; Jose L.,0,0,0,0
1683678525286,HIEU 104,A00,185792,Staff,14,0,20,6
1683678526309,HIEU 115,A00,185800,Staff,0,0,20,20
1683678527333,HIEU 128,A00,185801,Staff,0,9,20,20
1683678528358,HIEU 147,A00,185802,Staff,15,0,20,5
1683678529381,HIEU 154,A00,185823,Staff,11,0,20,9
1683678530408,HILA 102,A00,185826,Staff,14,0,20,6
1683678531435,HILD 2C,A01,185778,Staff,0,13,20,20
1683678532459,HILD 7B,A01,185780,Kwak; Nancy,0,17,32,32
1683678532459,HILD 7B,A02,185781,Kwak; Nancy,0,18,32,32
1683678533486,HILD 30,A01,185791,Staff,12,0,20,8
1683678534513,HISC 119,A00,185830,Golan; Tal,0,9,20,20
1683678535536,HITO 156GS,A00,185831,Patterson; Patrick H.,0,0,0,23
1683678536559,HIUS 103,A00,185832,Man; Simeon S,0,4,20,20
1683678537583,HIUS 117,A00,185836,Kwak; Nancy,2,0,20,18
1683678538609,HIUS 125,A00,185840,Man; Simeon S,0,2,23,23
1683678539633,HIUS 149,A00,185845,Staff,1,0,20,19
1683678540664,HUM 3,A01,185882,Zavodny; Tatiana Sophia,0,8,50,50
1683678540664,HUM 3,B01,185899,Caldwell; Michael Alan,0,18,50,50
1683678541690,HUM 3GS,A00,185900,Patterson; Patrick H.,0,0,0,23
1683678542715,HUM 4,A01,185938,Zroka; Amy Liane,28,0,50,22
1683678542715,HUM 4,B01,185956,Watkins; Eric,0,6,50,50
1683678542715,HUM 4,B02,202209,Watkins; Eric,0,5,50,50
1683678542715,HUM 4,B03,202210,Watkins; Eric,0,5,50,50
1683678543739,HUM 5,A01,185958,West; Geoffrey Scott,0,0,50,50
1683678543739,HUM 5,A02,202215,West; Geoffrey Scott,0,0,50,50
1683678544763,INTL 190,A00,185959,Gagnon; Jeffrey C,0,0,0,9
1683678544763,INTL 190,B00,185960,Lettieri; Michael Joseph,0,0,0,2
1683678545787,JAPN 180,A00,254509,Staff,5,0,30,25
1683678546815,LATI 10,A01,202853,Kennemore; Amy Michelle,4,0,35,31
1683678546815,LATI 10,A02,202854,Kennemore; Amy Michelle,3,0,35,32
1683678546815,LATI 10,A03,270054,Kennemore; Amy Michelle,30,0,30,0
1683678547840,LATI 180,A00,202855,Kennemore; Amy Michelle,11,0,20,9
1683678548863,LAWS 101,A00,201767,Golan; Tal,0,7,40,40
1683678549887,LIFR 1C,A00,185961,Staff,6,0,20,14
1683678550915,LIFR 1CX,A00,185962,Staff,7,0,20,13
1683678551939,LIFR 1D,A00,185963,Staff,7,0,20,13
1683678552964,LIFR 1DX,A00,185964,Staff,7,0,20,13
1683678553986,LIGN 101,A01,186039,Staff,43,0,50,7
1683678555010,LIGN 165,A00,186040,Staff,15,0,50,35
1683678556036,LTCS 108,A00,186041,Staff,5,0,10,5
1683678557060,LTCS 119,A00,186042,Staff,15,0,20,5
1683678558082,LTCS 130,A00,186043,Wesling; Megan E.,15,0,25,10
1683678560131,LTEA 138,A00,186119,Staff,14,0,40,26
1683678561158,LTEN 124,A00,186148,Staff,5,0,25,20
1683678562180,LTEN 178,A00,186149,Staff,7,0,15,8
1683678563205,LTEN 181,A00,186150,Blanco; John D,34,0,40,6
1683678564228,LTWL 120,A00,186160,Staff,19,0,25,6
1683678565250,LTWL 165,A00,186161,Staff,22,0,25,3
1683678566278,LTWR 100,A00,186162,Staff,0,5,15,15
1683678567373,LTWR 102,A00,186163,Doller; Ben,5,0,15,10
1683678568399,MAE 8,A01,186412,Staff,0,1,0,0
1683678569423,MAE 30B,A00,186445,Bahadori; Mohammad Yousef,82,0,100,18
1683678570448,MAE 40,A00,186592,Bewley; Thomas R,10,0,50,40
1683678571473,MAE 101B,A00,186593,Bahadori; Mohammad Yousef,80,0,100,20
1683678572501,MAE 105,A00,186594,Bandaru; Prabhakar,10,0,50,40
1683678573528,MAE 107,A00,186599,Pham; Hieu Tan,0,7,120,120
1683678574552,MAE 148,A01,186660,Silberman; Jack,3,0,16,13
1683678575579,MATH 10A,A01,188095,Staff,0,6,35,35
1683678576605,MATH 10B,A01,188097,Bowers; Adam R.,0,12,30,30
1683678576605,MATH 10B,A02,188099,Bowers; Adam R.,0,11,30,30
1683678576605,MATH 10B,B01,188104,Bowers; Adam R.,0,10,30,30
1683678576605,MATH 10B,B02,188106,Bowers; Adam R.,1,9,30,29
1683678577629,MATH 10C,A01,188111,Staff,0,20,30,30
1683678577629,MATH 10C,A02,188127,Staff,0,19,30,30
1683678577629,MATH 10C,A03,188131,Staff,0,19,30,30
1683678577629,MATH 10C,B01,188218,Staff,17,0,30,13
1683678577629,MATH 10C,B02,188244,Staff,13,0,30,17
1683678577629,MATH 10C,B03,188277,Staff,14,0,30,16
1683678578654,MATH 18,A01,188344,Bach; Quang Tran,18,0,30,12
1683678578654,MATH 18,A02,188345,Bach; Quang Tran,11,0,30,19
1683678578654,MATH 18,B01,188353,Bach; Quang Tran,11,0,30,19
1683678578654,MATH 18,B02,188354,Bach; Quang Tran,19,0,30,11
1683678579679,MATH 20A,A01,188374,Staff,11,0,35,24
1683678580706,MATH 20B,A01,188382,Ohm; Ko Woon,7,0,30,23
1683678580706,MATH 20B,A02,188383,Ohm; Ko Woon,22,0,30,8
1683678580706,MATH 20B,B01,188385,Ohm; Ko Woon,7,0,30,23
1683678580706,MATH 20B,B02,188392,Ohm; Ko Woon,22,0,30,8
1683678581732,MATH 20C,A01,188394,Harel; Guershon,10,0,30,20
1683678581732,MATH 20C,A02,188395,Harel; Guershon,13,0,30,17
1683678581732,MATH 20C,B01,188404,Harel; Guershon,5,0,30,25
1683678581732,MATH 20C,B02,188405,Harel; Guershon,18,0,30,12
1683678582761,MATH 20D,A01,188414,Hammock; Frances H,0,1,30,30
1683678582761,MATH 20D,A02,188415,Hammock; Frances H,0,1,30,30
1683678582761,MATH 20D,B01,188447,Hammock; Frances H,0,1,30,30
1683678582761,MATH 20D,B02,188486,Hammock; Frances H,3,0,30,27
1683678583789,MATH 20E,A01,188649,Staff,21,0,30,9
1683678583789,MATH 20E,A02,188650,Staff,20,0,30,10
1683678583789,MATH 20E,A03,188673,Staff,0,0,30,30
1683678584815,MATH 102,A01,188675,Staff,0,39,35,35
1683678585841,MATH 103B,A01,188681,Staff,3,0,35,32
1683678585841,MATH 103B,B01,188692,Staff,5,0,35,30
1683678586870,MATH 109,A01,188695,Salehi Golsefidy; Alireza,24,0,35,11
1683678586870,MATH 109,A02,188696,Salehi Golsefidy; Alireza,25,0,35,10
1683678587894,MATH 120A,A01,188698,Eggers; John Dietrich,7,0,35,28
1683678588918,MATH 142B,A01,188736,Ioana; Adrian,1,1,30,29
1683678588918,MATH 142B,A02,188741,Ioana; Adrian,0,1,30,30
1683678588918,MATH 142B,A03,188743,Ioana; Adrian,0,1,30,30
1683678589942,MATH 168A,A01,188790,Staff,0,11,35,35
1683678590967,MATH 170A,A01,188803,Nie; Jiawang,0,2,35,35
1683678590967,MATH 170A,A02,188811,Nie; Jiawang,0,1,35,35
1683678590967,MATH 170A,A03,188814,Nie; Jiawang,0,0,35,35
1683678590967,MATH 170A,A04,188815,Nie; Jiawang,6,0,35,29
1683678591994,MATH 193B,A01,188817,Staff,0,0,35,35
1683678591994,MATH 193B,A02,188818,Staff,5,0,35,30
1683678593018,MGT 4,A01,202857,Anderson; John Charles,60,0,80,20
1683678594046,MGT 12,A00,202858,Lindenberger; Wade Douglas,40,0,90,50
1683678595069,MGT 18,A00,202859,Staff,74,0,90,16
1683678596095,MGT 18GS,A00,202860,McKay; Michael J,13,0,28,15
1683678597123,MGT 45,A00,202861,Pecore; Joseph P.,9,0,90,81
1683678598146,MGT 100,A00,202863,Yavorsky; Daniel Ryan,28,0,90,62
1683678599170,MGT 103,A00,202864,Ehrich; Kristine R,0,18,90,90
1683678600193,MGT 112,A00,202865,Ehrich; Kristine R,15,0,90,75
1683678601220,MGT 121A,A00,202868,Staff,90,20,90,0
1683678602243,MGT 131B,A00,202869,Anderson; John Charles,59,0,90,31
1683678603266,MGT 136,A00,202871,Lindenberger; Wade Douglas,83,0,90,7
1683678604288,MGT 164,A00,202873,Staff,0,67,90,91
1683678605315,MGT 164GS,A00,202874,McKay; Mary A,13,0,28,15
1683678606341,MGT 180,A00,202875,Staff,0,51,90,91
1683678607364,MMW 11R,A01,205019,Herbst; Matthew,0,0,30,30
1683678607364,MMW 11R,A02,205026,Herbst; Matthew,29,0,30,1
1683678608392,MMW 15,A01,193512,Chang; Edmond Yi-Teh,0,8,28,28
1683678608392,MMW 15,A02,193513,Chang; Edmond Yi-Teh,0,5,28,28
1683678608392,MMW 15,A03,193514,Chang; Edmond Yi-Teh,0,5,28,28
1683678608392,MMW 15,A04,193515,Chang; Edmond Yi-Teh,0,5,28,28
1683678608392,MMW 15,A05,193516,Chang; Edmond Yi-Teh,0,5,28,28
1683678608392,MMW 15,A06,193517,Chang; Edmond Yi-Teh,0,6,28,28
1683678608392,MMW 15,B01,193519,Chang; Edmond Yi-Teh,0,5,28,28
1683678608392,MMW 15,B02,193520,Chang; Edmond Yi-Teh,0,5,28,28
1683678608392,MMW 15,B03,193521,Chang; Edmond Yi-Teh,0,5,28,28
1683678608392,MMW 15,B04,193522,Chang; Edmond Yi-Teh,0,5,28,28
1683678608392,MMW 15,B05,193523,Chang; Edmond Yi-Teh,0,5,28,28
1683678608392,MMW 15,B06,193524,Chang; Edmond Yi-Teh,0,5,28,28
1683678609416,MMW 122,A01,193526,Rahimi; Babak,0,16,28,28
1683678609416,MMW 122,A02,193527,Rahimi; Babak,0,15,28,28
1683678609416,MMW 122,A03,193528,Rahimi; Babak,0,0,0,0
1683678609416,MMW 122,A04,193529,Rahimi; Babak,0,0,0,0
1683678610443,MUS 1A,A01,186663,Staff,1,19,35,34
1683678611470,MUS 4,A01,186715,Staff,0,12,35,35
1683678612495,MUS 5R,A01,186796,Dubnov; Shlomo,0,17,35,35
1683678613522,MUS 6,A01,186798,Staff,0,5,25,25
1683678614547,MUS 7,A01,186830,Staff,11,0,35,24
1683678615570,MUS 8,A01,186930,Staff,0,27,35,35
1683678616598,MUS 15,A01,186932,Staff,0,15,35,35
1683678616598,MUS 15,B01,186934,Staff,1,17,35,34
1683678617621,MUS 80,A00,186935,Staff,0,0,20,20
1683678617621,MUS 80,B00,186936,Staff,24,0,25,1
1683678618648,NANO 11,A00,204702,Lipomi; Darren John,0,0,0,0
1683678619676,NANO 15,A01,204709,Yang; Kesong,0,1,0,0
1683678620704,NANO 114,A00,202069,Jahed Motlagh; Zeinab,3,0,10,7
1683678621729,PHIL 1,A00,186955,Grush; Rick Scott,31,0,40,9
1683678622754,PHIL 10,A01,186973,Grush; Rick Scott,27,0,35,8
1683678622754,PHIL 10,A02,186974,Grush; Rick Scott,33,0,35,2
1683678623779,PHIL 13,A01,186976,Staff,3,0,35,32
1683678623779,PHIL 13,A02,186977,Staff,16,0,35,19
1683678624804,PHIL 14,A01,186979,Staff,31,0,35,4
1683678624804,PHIL 14,A02,186986,Staff,32,0,35,3
1683678625829,PHIL 28,A01,186988,Staff,16,0,30,14
1683678625829,PHIL 28,A02,186989,Staff,1,0,30,29
1683678625829,PHIL 28,A03,186990,Staff,10,0,30,20
1683678625829,PHIL 28,A04,186991,Staff,26,0,30,4
1683678626854,PHIL 120,A00,186997,Staff,23,0,40,17
1683678627882,PHIL 137,A00,187003,Staff,7,0,40,33
1683678628907,PHIL 150,A00,187015,Staff,47,0,70,23
1683678629931,PHIL 167,A00,187021,Lamey; Andy M.,34,0,40,6
1683678630959,PHIL 174,A01,202226,Staff,17,0,20,3
1683678630959,PHIL 174,A02,202235,Staff,20,0,20,0
1683678631985,PHIL 191A,A00,258918,Staff,0,0,1,1
1683678633015,PHYS 1A,A00,187028,Staff,26,0,60,34
1683678634043,PHYS 1AL,001,187036,Staff,3,0,30,27
1683678634043,PHYS 1AL,002,187049,Staff,18,0,30,12
1683678635066,PHYS 1B,A00,187058,Staff,22,0,60,38
1683678636090,PHYS 1BL,001,187064,Staff,0,1,30,30
1683678636090,PHYS 1BL,002,187070,Staff,4,0,30,26
1683678637116,PHYS 1C,A00,187082,Staff,29,0,120,91
1683678638141,PHYS 1CL,001,187088,Staff,0,9,30,30
1683678638141,PHYS 1CL,002,187089,Staff,0,1,30,30
1683678638141,PHYS 1CL,009,262693,Staff,9,0,30,21
1683678639173,PHYS 2B,A01,187097,Staff,55,0,115,60
1683678640196,PHYS 2C,A01,187099,Staff,63,0,115,52
1683678641224,PHYS 2CL,A01,187101,Staff,5,0,28,23
1683678641224,PHYS 2CL,A02,187102,Staff,15,0,28,13
1683678642252,PHYS 2D,A01,187123,Shotwell; Brian,95,0,115,20
1683678643276,PHYS 4B,A01,187133,Grinstein; Benjamin,35,0,50,15
1683678644300,POLI 10,A00,188819,Staff,0,4,50,50
1683678645324,POLI 11,A00,188827,Staff,43,0,50,7
1683678646348,POLI 13R,A00,188828,Staff,0,1,20,20
1683678647375,POLI 27,A01,188830,Elgin; Samuel Zincke,0,2,70,70
1683678648399,POLI 30,A00,188832,Desposato; Scott,30,0,50,20
1683678649425,POLI 102F,A00,188834,Staff,0,0,40,40
1683678650449,POLI 104A,A00,188852,Staff,12,0,30,18
1683678651473,POLI 104I,A00,188853,Staff,0,8,20,20
1683678652497,POLI 110B,A00,188854,Wiens; David,6,0,20,14
1683678653521,POLI 112A,A00,188855,Wiens; David,3,0,30,27
1683678654549,POLI 117R,A00,188856,Forman; Fonna,0,12,20,20
1683678655577,POLI 118,A00,188857,Ingham; Sean,8,0,20,12
1683678656603,POLI 120G,A00,188858,Staff,8,0,30,22
1683678657627,POLI 131CR,A00,188863,Hoston; Germaine,20,0,50,30
1683678658654,POLI 133,A00,188864,Nellis; Gareth Hb,44,0,50,6
1683678659678,POLI 134D,A00,188865,Desposato; Scott,27,0,30,3
1683678660710,POLI 142A,A00,188871,Gartzke; Erik,21,0,50,29
1683678661735,POLI 142K,A00,188874,Staff,38,0,50,12
1683678662759,POLI 143,A00,188940,Gartzke; Erik,16,0,30,14
1683678663784,POLI 153,A00,188943,Staff,2,0,20,18
1683678664812,POLI 160AA,A00,188944,Staff,10,0,40,30
1683678665837,POLI 170A,A00,188945,Staff,10,0,30,20
1683678667886,PSYC 1,A00,188952,Staff,36,0,90,54
1683678668914,PSYC 2,B00,188953,Staff,19,0,35,16
1683678669938,PSYC 6,A00,188970,Staff,47,0,60,13
1683678671020,PSYC 7,A00,188973,Staff,35,0,45,10
1683678672044,PSYC 60,A01,188980,Rickard; Timothy C.,42,0,60,18
1683678673068,PSYC 70,A01,189001,Steiner; Eric Tomas,21,0,45,24
1683678674093,PSYC 100,A00,189005,Lacefield; Katharine I,0,99,120,120
1683678675121,PSYC 102,A00,189008,Staff,7,0,30,23
1683678676148,PSYC 106,B00,189026,Gorman; Michael R.,27,0,60,33
1683678677173,PSYC 114,B01,189033,Winkielman; Piotr,0,31,30,30
1683678678198,PSYC 131,A00,189036,Anagnostaras; Stephan,0,43,60,60
1683678679223,PSYC 136,A00,189041,Lowe; Angela Beth,0,7,25,25
1683678680249,PSYC 137,A00,189057,Winkielman; Piotr,1,37,25,24
1683678681274,PSYC 144,A00,189107,Wixted; John T,0,11,50,50
1683678683325,PSYC 162,A00,189142,Staff,0,9,85,85
1683678684350,PSYC 172,A00,189144,Gorman; Michael R.,0,6,30,30
1683678686397,PSYC 179,A00,189146,Lacefield; Katharine I,0,87,120,120
1683678687421,PSYC 181,A00,189147,Anagnostaras; Stephan,0,44,90,90
1683678688445,PSYC 190R,A00,189148,Barner; David A.,0,23,80,80
1683678689468,PSYC 191,A00,189275,Rickard; Timothy C.,0,10,25,25
1683678690493,PSYC 193,A00,189276,Chapman; Eddie Nathaniel,0,1,0,4
1683678691522,PSYC 193L,A01,189281,Lowe; Angela Beth,8,0,20,12
1683678691522,PSYC 193L,B01,189285,Staff,28,0,35,7
1683678692546,RELI 149,A00,187137,Rahimi; Babak,7,0,40,33
1683678693571,SE 9,A01,187315,Staff,0,2,18,18
1683678694596,SE 101B,A00,187409,Staff,24,0,30,6
1683678695623,SE 110B,A00,187444,Staff,10,0,40,30
1683678696648,SE 130B,A00,187449,Staff,31,0,40,9
1683678697673,SE 150A,A00,187516,Staff,8,0,20,12
1683678698696,SE 154,A00,187528,Staff,29,0,50,21
1683678699724,SIO 3,A01,258171,Staff,35,0,40,5
1683678700749,SIO 10,A00,187144,Cook; Geoffrey W,1,7,75,74
1683678701776,SIO 45,A00,187152,Cook; Geoffrey W,0,7,100,100
1683678702804,SIO 109R,A00,194486,Staff,0,4,20,20
1683678704855,SIO 187,A01,187233,Kacev; David,12,0,40,28
1683678705880,SOCI 1,A01,258656,Thorpe; Charles Robert,28,0,30,2
1683678705880,SOCI 1,A02,258658,Thorpe; Charles Robert,30,0,30,0
1683678705880,SOCI 1,A03,258661,Thorpe; Charles Robert,25,0,25,0
1683678705880,SOCI 1,A04,258666,Thorpe; Charles Robert,22,0,25,3
1683678705880,SOCI 1,A05,258897,Thorpe; Charles Robert,22,0,25,3
1683678705880,SOCI 1,A06,258898,Thorpe; Charles Robert,25,0,25,0
1683678706910,SOCI 30,A01,258903,Pardo Guerra; Juan Pablo,14,0,30,16
1683678707937,SOCI 102,A00,258904,Staff,9,0,25,16
1683678708961,SOCI 106,A00,258905,Staff,19,0,25,6
1683678709986,SOCI 111,A00,258907,Ribas Norris; Janet Vanesa,26,0,30,4
1683678711010,SOCI 121R,A00,258908,Pardo Guerra; Juan Pablo,8,0,30,22
1683678712040,SOCI 126,A01,203330,Staff,14,0,20,6
1683678713067,SOCI 131,A00,258909,Thorpe; Charles Robert,30,0,60,30
1683678714093,SOCI 135,A00,258910,Payne; Christine Anna,0,12,30,30
1683678715117,SOCI 157,A00,258911,Staff,11,0,30,19
1683678716142,SOCI 184,A00,258912,Staff,25,0,30,5
1683678717168,SOCI 188D,A00,258913,Staff,22,0,30,8
1683678718191,SYN 2,001,187529,Staff,9,0,16,7
1683678718191,SYN 2,002,201452,Staff,1,20,16,15
1683678718191,SYN 2,003,201469,Staff,1,0,16,15
1683678719219,SYN 100,A01,187531,Staff,0,9,20,20
1683678719219,SYN 100,B01,201491,Staff,0,10,20,20
1683678720243,TDAC 1,A00,189286,Walsh; Kim C.,3,0,20,17
1683678720243,TDAC 1,B00,189287,Harting; Carla Kelso,10,0,20,10
1683678721267,TDAC 101,A00,189300,Walsh; Kim C.,16,0,20,4
1683678721267,TDAC 101,B00,189301,Harting; Carla Kelso,18,0,20,2
1683678722294,TDAC 102,A00,189304,Basso; Beatrice,14,0,20,6
1683678723319,TDAC 108,A00,189305,Staff,18,0,20,2
1683678724349,TDDE 131,A00,189310,Staff,19,0,20,1
1683678724349,TDDE 131,B00,189314,Staff,19,0,20,1
1683678724349,TDDE 131,C00,189315,Staff,48,0,50,2
1683678724349,TDDE 131,D00,189316,Staff,14,0,15,1
1683678724349,TDDE 131,E00,204841,Staff,20,0,20,0
1683678725375,TDGE 10,A00,189289,Staff,27,0,50,23
1683678725375,TDGE 10,B00,189290,Havis; Allan,0,1,50,50
1683678726399,TDGE 11,A00,189291,Fulton; Julia,0,4,50,50
1683678726399,TDGE 11,B00,189292,Staff,20,0,25,5
1683678726399,TDGE 11,C00,260270,Staff,0,0,0,0
1683678727423,TDGE 25,A00,189294,Staff,1,0,20,19
1683678728448,TDGE 124,A00,189318,Fulton; Julia,0,8,50,50
1683678729477,TDGE 125,A00,189319,Staff,13,0,25,12
1683678729477,TDGE 125,B00,189320,Staff,23,0,25,2
1683678730501,TDGE 127,A00,189322,Havis; Allan,0,0,50,50
1683678731529,TDHT 101,A00,189323,Staff,18,0,25,7
1683678731529,TDHT 101,B00,189324,Staff,25,0,25,0
1683678732555,TDHT 102,A00,189325,Staff,49,0,50,1
1683678733586,TDMV 1,A00,189295,Arcidiacono; Kristin,20,0,30,10
1683678733586,TDMV 1,B00,189296,Caligagan; Maria T.,24,0,30,6
1683678734610,TDMV 2,A00,189297,Sammartano; Tonnie,27,0,30,3
1683678734610,TDMV 2,B00,189299,Arcidiacono; Kristin,23,0,30,7
1683678735637,TDMV 3,A00,204998,Rincon; Alicia,22,0,30,8
1683678736661,TDMV 120,A00,189458,Sammartano; Tonnie,28,0,30,2
1683678737689,TDMV 138,A00,189541,Jun; Grace Shin Hae,20,0,40,20
1683678738714,TDMV 142,A00,189717,Caligagan; Tony,25,0,30,5
1683678738714,TDMV 142,B00,189718,Caligagan; Maria T.,25,0,30,5
1683678739738,TMC 2,A01,187533,Staff,25,0,25,0
1683678739738,TMC 2,A02,187534,Staff,25,0,25,0
1683678740762,USP 1,A01,187536,Kwak; Nancy,0,16,25,25
1683678741787,USP 5,A01,187538,Staff,8,0,25,17
1683678742815,USP 101,A00,199253,Staff,0,4,0,0
1683678743842,USP 124,A00,187562,Boomhower; Matthew Charles,0,0,30,30
1683678744866,USP 138,A00,187582,Staff,19,0,25,6
1683678745891,USP 152,A01,187597,Staff,3,0,25,22
1683678746918,USP 153,A00,187598,Staff,19,0,25,6
1683678747943,USP 168,A00,187607,Kwak; Nancy,2,0,5,3
1683678748970,USP 173,A00,187619,Staff,4,0,25,21
1683678749994,USP 181,A00,187638,Staff,0,4,25,25
1683678751022,VIS 103,A00,187650,Cruz; Edwin Teddy,17,0,75,58
1683678752050,VIS 110D,A00,187669,Staff,13,0,22,9
1683678753073,VIS 127C,A00,187720,Shen; Kuiyi,67,0,146,79
1683678754100,VIS 149,A00,187731,Yoldas; Pinar,1,14,22,21
1683678755127,VIS 151,A01,188091,Staff,22,0,34,12
1683678755127,VIS 151,A02,188092,Staff,11,0,34,23
1683678756154,VIS 160B,A00,188093,Stalbaum; Brett,0,1,10,10
1683678758204,WCWP 10B,A00,201720,Staff,0,0,5,5
1683678758204,WCWP 10B,B00,201722,Staff,0,0,6,6
1683678759227,WCWP 100,A00,201725,Gagnon; Jeffrey C,0,0,2,2
1683678759227,WCWP 100,B00,201727,Staff,0,4,15,15
1683678762315,ANBI 133,A00,258401,Wilder; Linnea Lorene,34,0,40,6
1683678763339,ANBI 140,A00,258395,Hrvoj Mihic; Branka,18,0,25,7
1683678764363,ANSC 120,A00,258402,Bialecki; Jon Anthony,26,0,40,14
1683678765387,ANSC 144,A00,258400,Staff,12,0,40,28
1683678767440,ANSC 166,A00,258396,Parish; Steven Martin,156,0,175,19
1683678768467,ANSC 180,A00,193533,Staff,8,0,20,12
1683678769492,ANSC 188,A00,258397,Jassal; Aftab,34,0,40,6
1683678770520,ANTH 3,A01,258316,Staff,23,0,30,7
1683678771545,ANTH 5,A00,258394,Semendeferi; Ekaterini,16,0,20,4
1683678772569,ANTH 21,A01,258331,Staff,4,0,40,36
1683678773598,ANTH 103,A00,258398,Varma; Saiba,15,0,25,10
1683678774682,AWP 10,001,202034,Staff,0,0,0,0
1683678774682,AWP 10,002,202035,Staff,0,0,0,0
1683678774682,AWP 10,003,202036,Staff,0,0,0,0
1683678774682,AWP 10,004,202037,Staff,0,0,0,0
1683678774682,AWP 10,005,202038,Staff,0,0,0,0
1683678774682,AWP 10,006,202039,Staff,0,0,0,0
1683678774682,AWP 10,007,202040,Staff,0,0,0,0
1683678774682,AWP 10,008,202041,Staff,0,0,0,0
1683678774682,AWP 10,009,202042,Staff,0,0,0,0
1683678774682,AWP 10,010,202043,Staff,0,0,0,0
1683678774682,AWP 10,011,202044,Staff,0,0,0,0
1683678774682,AWP 10,012,202045,Staff,0,0,0,0
1683678774682,AWP 10,013,202046,Staff,0,0,0,0
1683678774682,AWP 10,014,202047,Staff,0,0,0,0
1683678774682,AWP 10,015,202048,Staff,0,0,0,0
1683678774682,AWP 10,016,202049,Staff,0,0,0,0
1683678774682,AWP 10,017,202050,Staff,0,0,0,0
1683678774682,AWP 10,018,202051,Staff,0,0,0,0
1683678774682,AWP 10,019,202052,Staff,0,0,0,0
1683678774682,AWP 10,020,202053,Staff,0,0,0,0
1683678774682,AWP 10,021,202054,Staff,0,0,0,0
1683678774682,AWP 10,022,202055,Staff,0,0,0,0
1683678774682,AWP 10,023,202056,Staff,0,0,0,0
1683678774682,AWP 10,024,202057,Staff,0,0,0,0
1683678774682,AWP 10,025,202058,Staff,0,0,0,0
1683678774682,AWP 10,026,202059,Staff,0,0,0,0
1683678775706,AWP 102,001,202032,Staff,0,0,0,0
1683678775706,AWP 102,002,202033,Staff,0,0,0,0
1683678776731,BENG 100,A01,254234,Taylor Amos; Alyssa C,31,0,40,9
1683678777755,BENG 196,001,270013,Engler; Adam J.,9999,0,9999,0
1683678778781,BICD 100R,A01,202018,Smith; Laurie,0,7,32,32
1683678778781,BICD 100R,A02,202019,Smith; Laurie,0,3,32,32
1683678778781,BICD 100R,A03,202020,Smith; Laurie,0,1,32,32
1683678778781,BICD 100R,A04,202021,Smith; Laurie,6,0,32,26
1683678778781,BICD 100R,A05,202022,Smith; Laurie,10,0,32,22
1683678779806,BICD 136,A01,193242,Gustafson-Brown; Cindy,0,2,32,32
1683678779806,BICD 136,A02,193244,Gustafson-Brown; Cindy,13,0,32,19
1683678780835,BIEB 102,A01,193249,Butler; Shannon Rhey,1,1,32,31
1683678780835,BIEB 102,A02,193251,Butler; Shannon Rhey,0,0,32,32
1683678780835,BIEB 102,A03,193253,Butler; Shannon Rhey,0,0,32,32
1683678780835,BIEB 102,A04,193255,Butler; Shannon Rhey,13,0,32,19
1683678780835,BIEB 102,A05,193265,Butler; Shannon Rhey,25,0,32,7
1683678780835,BIEB 102,A06,193269,Butler; Shannon Rhey,13,0,32,19
1683678782885,BIEB 150,A01,193274,Staff,0,0,32,32
1683678782885,BIEB 150,A02,193285,Staff,24,0,32,8
1683678783909,BIEB 194,A00,193286,Kurle; Carolyn M.,19,0,32,13
1683678784934,BILD 1,A01,192291,Staff,15,0,32,17
1683678784934,BILD 1,A02,192292,Staff,30,0,32,2
1683678784934,BILD 1,B01,192520,Reuther; Keefe,0,1,0,0
1683678784934,BILD 1,B02,192532,Reuther; Keefe,0,1,0,0
1683678785964,BILD 3,A01,192556,Butler; Shannon Rhey,0,0,32,32
1683678785964,BILD 3,A02,192581,Butler; Shannon Rhey,0,1,32,32
1683678785964,BILD 3,A03,192611,Butler; Shannon Rhey,19,0,32,13
1683678785964,BILD 3,A04,192612,Butler; Shannon Rhey,24,0,32,8
1683678785964,BILD 3,A05,192613,Butler; Shannon Rhey,26,0,32,6
1683678785964,BILD 3,A06,192679,Butler; Shannon Rhey,27,0,32,5
1683678785964,BILD 3,A07,192682,Butler; Shannon Rhey,20,0,32,12
1683678786999,BILD 4,A01,192836,Reuther; Keefe,1,0,24,23
1683678786999,BILD 4,A02,193044,Reuther; Keefe,4,0,24,20
1683678788027,BILD 10,A01,193142,Gustafson-Brown; Cindy,29,0,32,3
1683678788027,BILD 10,A02,193149,Gustafson-Brown; Cindy,31,0,32,1
1683678789052,BIMM 100,A01,193301,Staff,0,6,32,32
1683678789052,BIMM 100,A02,193312,Staff,0,7,32,32
1683678789052,BIMM 100,A03,193323,Staff,0,10,32,32
1683678790080,BIMM 101,A01,193329,McDonnell; Lisa Marie,1,4,24,23
1683678790080,BIMM 101,A02,193339,McDonnell; Lisa Marie,1,4,24,23
1683678790080,BIMM 101,B01,193354,McDonnell; Lisa Marie,0,4,24,24
1683678790080,BIMM 101,B02,193357,McDonnell; Lisa Marie,0,3,24,24
1683678791105,BIMM 110,A01,193377,Tat; John,0,11,32,32
1683678791105,BIMM 110,A02,193378,Tat; John,0,11,32,32
1683678792130,BIMM 120,A01,206116,Staff,0,0,32,32
1683678792130,BIMM 120,A02,206117,Staff,7,0,32,25
1683678792130,BIMM 120,A03,206121,Staff,21,0,32,11
1683678793154,BIPN 100,A01,193393,Park; Ji Young,0,15,32,32
1683678793154,BIPN 100,A02,193402,Park; Ji Young,0,14,32,32
1683678793154,BIPN 100,A03,193413,Park; Ji Young,0,14,32,32
1683678793154,BIPN 100,A04,193414,Park; Ji Young,0,13,32,32
1683678794180,BIPN 102,A01,193429,Staff,0,0,32,32
1683678794180,BIPN 102,A02,193438,Staff,18,0,32,14
1683678795205,BIPN 106,A01,193450,Reyes Gonzalez; Catalina,0,2,40,40
1683678796235,BIPN 134,A01,193465,Cooke; James Edward,0,0,32,32
1683678796235,BIPN 134,A02,193474,Cooke; James Edward,25,0,32,7
1683678796235,BIPN 134,A03,193485,Cooke; James Edward,29,0,32,3
1683678796235,BIPN 134,A04,193486,Cooke; James Edward,20,0,32,12
1683678796235,BIPN 134,A05,193491,Cooke; James Edward,31,0,32,1
1683678796235,BIPN 134,A06,193501,Cooke; James Edward,30,0,32,2
1683678796235,BIPN 134,A07,193510,Cooke; James Edward,29,0,32,3
1683678798286,BISP 194,A00,222522,Staff,14,0,32,18
1683678799310,CAT 124,A01,202407,Staff,19,0,25,6
1683678800337,CAT 125,A00,202408,Marchisotto; Jennifer Anne,2,0,20,18
1683678801363,CAT 125R,A00,202409,Smith; Lauryn Alissa,0,11,20,20
1683678801363,CAT 125R,B00,202410,Morales; Celeste Georgianna,0,11,20,20
1683678801363,CAT 125R,C00,202411,Irwin; Matthew Joseph,0,12,20,20
1683678802386,CENG 15,A01,204712,Yang; Kesong,0,1,0,0
1683678803410,CENG 114,A00,202070,Jahed Motlagh; Zeinab,5,0,20,15
1683678804437,CGS 105,A00,185477,Wesling; Megan E.,24,0,40,16
1683678805460,CGS 106,A00,185494,Staff,11,0,22,11
1683678806485,CGS 108,A00,185495,Staff,14,0,20,6
1683678807511,CGS 114,A00,185496,Staff,13,0,18,5
1683678808535,CGS 119,A00,185501,Staff,15,0,20,5
1683678809562,CGS 120,A00,185511,Staff,12,0,20,8
1683678810590,CHEM 4,A01,184675,Bussey; Thomas J,97,0,100,3
1683678811617,CHEM 6A,A01,184677,Staff,32,0,60,28
1683678812644,CHEM 6B,A01,184679,Staff,63,0,100,37
1683678813669,CHEM 6C,A01,184681,Bussey; Thomas J,0,0,50,50
1683678813669,CHEM 6C,A02,184682,Bussey; Thomas J,32,0,50,18
1683678814693,CHEM 40A,A01,184684,Albizati; Kim F.,33,0,100,67
1683678815718,CHEM 40B,A01,184686,Albizati; Kim F.,0,22,100,100
1683678816741,CHEM 41B,A01,184690,Staff,51,0,100,49
1683678817765,COGS 3,A01,184715,Boyle; Mary E. T.,0,27,40,40
1683678818789,COGS 14B,A01,185172,Staff,0,14,38,38
1683678819814,COGS 18,A01,184736,Staff,14,0,80,66
1683678820845,COGS 100,A01,184932,Staff,0,8,73,73
1683678821868,COGS 101A,A01,184935,Staff,0,40,30,30
1683678822893,COGS 101B,A01,184944,Staff,0,2,30,30
1683678823917,COGS 101C,A01,184946,Staff,0,10,30,30
1683678824944,COGS 102A,A01,184951,Johnson; Christine M.,2,0,40,38
1683678825969,COGS 107B,A01,184953,Mooshagian; Eric Frederick,0,52,40,40
1683678826997,COGS 118B,A01,184959,Gupta; Anjum,0,50,40,40
1683678828021,COGS 153,A00,184961,Staff,0,16,30,30
1683678829045,COGS 177,A00,184962,Staff,0,21,30,30
1683678830069,COGS 187A,A01,184969,Boyle; Mary E. T.,0,19,40,40
1683678831093,COMM 10,A01,185174,Staff,0,5,25,25
1683678831093,COMM 10,A02,185189,Staff,0,2,25,25
1683678831093,COMM 10,A03,269821,Staff,0,1,0,0
1683678832120,COMM 100B,A02,185476,Staff,11,0,25,14
1683678832120,COMM 100B,A03,277340,Staff,25,0,25,0
1683678833145,COMM 100C,A01,185314,Staff,1,0,25,24
1683678833145,COMM 100C,A02,185327,Staff,17,0,25,8
1683678834168,COMM 110M,A00,185349,Staff,0,0,40,40
1683678835195,COMM 113T,A00,185352,Staff,25,0,40,15
1683678836221,COMM 114I,A00,185353,Staff,31,0,40,9
1683678837248,COMM 131,A00,185354,Staff,17,0,30,13
1683678838275,CSE 8A,A50,185358,Cao; Yingjun,0,46,10,10
1683678839298,CSE 8B,A01,185362,Staff,0,48,50,50
1683678840322,CSE 11,A01,185416,Cao; Yingjun,0,91,10,10
1683678841348,CSE 20,A01,185445,Briones; Jor-el Thomas Caparas,3,0,25,22
1683678842373,CSE 21,A01,185447,Staff,9,0,50,41
1683678843397,CSE 101,A01,185451,Staff,0,13,50,50
1683678843397,CSE 101,B01,185453,Jones; Miles E,0,14,50,50
1683678845448,CSE 141,A01,185458,Eldon; John,16,0,100,84
1683678846472,CSE 141L,A01,185461,Eldon; John,8,0,100,92
1683678847500,CSE 142,A01,185463,Staff,34,0,60,26
1683678847500,CSE 142,B01,201355,Staff,0,7,60,60
1683678848527,CSE 142L,A01,185470,Staff,34,0,60,26
1683678848527,CSE 142L,B01,201417,Staff,0,6,60,60
1683678849551,CSE 190,A00,201433,Staff,32,0,49,17
1683678850579,DOC 1,A01,259136,Strom; Megan C.,7,0,15,8
1683678850579,DOC 1,A02,259137,Strom; Megan C.,14,0,15,1
1683678850579,DOC 1,A03,259138,Strom; Megan C.,14,0,15,1
1683678850579,DOC 1,A04,259139,Strom; Megan C.,14,0,15,1
1683678851604,DOC 100D,A00,259140,Pass; Natalye Joann,14,0,25,11
1683678852628,DSGN 1,A01,184749,Rill; Bryan,0,26,30,30
1683678853657,DSGN 100,A01,185168,Staff,0,2,25,25
1683678854685,ECE 5,A01,185626,Morris; Karcher William,0,12,0,0
1683678855708,ECE 101,A01,185628,Staff,14,0,70,56
1683678856736,ECE 107,A01,185635,Baghdadchi; Saharnaz,0,0,20,20
1683678856736,ECE 107,A02,185638,Baghdadchi; Saharnaz,1,0,20,19
1683678857759,ECE 148,A01,185647,Silberman; Jack,0,0,16,16
1683678858786,ECON 1,A01,185537,Crane; Meredith Helen,54,0,70,16
1683678859811,ECON 3,A01,185549,Crane; Meredith Helen,29,0,70,41
1683678860834,ECON 4,A01,203354,Anderson; John Charles,0,5,10,10
1683678861858,ECON 100A,A01,185574,Staff,0,5,40,40
1683678862881,ECON 100B,A01,185576,Staff,0,12,50,50
1683678863905,ECON 100C,A01,185589,Newhouse; Herbert S,30,0,70,40
1683678864932,ECON 105,A00,185608,Vespa; Emanuel Ignacio,19,0,35,16
1683678865959,ECON 109,A01,185610,Shishkin; Denis,9,0,35,26
1683678866984,ECON 110A,A01,185612,Staff,9,0,40,31
1683678868009,ECON 120A,A01,185615,Staff,19,0,40,21
1683678869034,ECON 120C,A01,185617,Sun; Yixiao,0,21,70,70
1683678870059,ECON 144,A00,203346,Squires; Dale E,2,0,35,33
1683678871082,ECON 171,A01,203349,Newhouse; Herbert S,0,1,35,35
1683678872107,ECON 173A,A01,185621,Toda; Alexis Akira,21,0,35,14
1683678873141,EDS 25,A01,202413,Staff,0,1,0,0
1683678873141,EDS 25,A02,202414,Staff,0,1,0,0
1683678873141,EDS 25,A03,202415,Staff,0,0,0,0
1683678873141,EDS 25,A04,202416,Staff,0,1,0,0
1683678873141,EDS 25,A05,202439,Staff,0,0,0,0
1683678873141,EDS 25,A06,202440,Staff,0,0,0,0
1683678873141,EDS 25,B01,202631,Staff,0,0,0,0
1683678873141,EDS 25,B02,202632,Staff,0,0,0,0
1683678873141,EDS 25,B03,202639,Staff,0,0,0,0
1683678873141,EDS 25,B04,202640,Staff,0,0,0,0
1683678873141,EDS 25,B05,202643,Staff,0,0,0,0
1683678873141,EDS 25,B06,202644,Staff,0,0,0,0
1683678874168,EDS 38,A01,202659,Black; Alison Michelle,24,0,25,1
1683678875193,EDS 115,A00,202652,Staff,18,0,30,12
1683678876217,EDS 125,A00,202649,Staff,13,0,30,17
1683678877246,EDS 126,A01,203332,Staff,30,0,30,0
1683678878326,EDS 139,A00,202838,Staff,16,0,25,9
1683678879351,EDS 146,A01,202655,Staff,14,0,25,11
1683678880379,ENG 15,A00,185667,Staff,0,1,0,0
1683678880379,ENG 15,B00,185672,Staff,0,0,0,0
1683678880379,ENG 15,C00,185675,Staff,0,0,0,0
1683678880379,ENG 15,D00,185682,Staff,0,0,0,0
1683678880379,ENG 15,E00,185684,Staff,0,0,0,0
1683678881403,ETHN 103,A00,185710,Staff,0,8,35,35
1683678882428,ETHN 103A,A00,199228,Man; Simeon S,0,0,9,9
1683678883455,ETHN 109,A00,185711,Staff,15,0,35,20
1683678884482,ETHN 142,A00,185726,Staff,0,4,30,30
1683678885505,ETHN 163J,A00,199229,Man; Simeon S,5,0,8,3
1683678886530,ETHN 168,A00,185727,Staff,7,0,10,3
1683678887557,ETHN 182,A00,185728,Staff,0,0,35,35
1683678888582,ETHN 183,A00,185737,Staff,9,0,18,9
1683678889605,GLBH 111,A01,209361,Burgos; Jose L.,0,0,0,0
1683678891654,HIEU 104,A00,185792,Staff,14,0,20,6
1683678892678,HIEU 115,A00,185800,Staff,0,0,20,20
1683678893705,HIEU 128,A00,185801,Staff,0,9,20,20
1683678894731,HIEU 147,A00,185802,Staff,15,0,20,5
1683678895756,HIEU 154,A00,185823,Staff,11,0,20,9
1683678896781,HILA 102,A00,185826,Staff,14,0,20,6
1683678897806,HILD 2C,A01,185778,Staff,0,13,20,20
1683678898833,HILD 7B,A01,185780,Kwak; Nancy,0,17,32,32
1683678898833,HILD 7B,A02,185781,Kwak; Nancy,0,18,32,32
1683678899858,HILD 30,A01,185791,Staff,12,0,20,8
1683678900882,HISC 119,A00,185830,Golan; Tal,0,9,20,20
1683678901911,HITO 156GS,A00,185831,Patterson; Patrick H.,0,0,0,23
1683678902938,HIUS 103,A00,185832,Man; Simeon S,0,4,20,20
1683678903966,HIUS 117,A00,185836,Kwak; Nancy,2,0,20,18
1683678905005,HIUS 125,A00,185840,Man; Simeon S,0,2,23,23
1683678906028,HIUS 149,A00,185845,Staff,1,0,20,19
1683678907081,HUM 3,A01,185882,Zavodny; Tatiana Sophia,0,8,50,50
1683678907081,HUM 3,B01,185899,Caldwell; Michael Alan,0,18,50,50
1683678908106,HUM 3GS,A00,185900,Patterson; Patrick H.,0,0,0,23
1683678909130,HUM 4,A01,185938,Zroka; Amy Liane,28,0,50,22
1683678909130,HUM 4,B01,185956,Watkins; Eric,0,6,50,50
1683678909130,HUM 4,B02,202209,Watkins; Eric,0,5,50,50
1683678909130,HUM 4,B03,202210,Watkins; Eric,0,5,50,50
1683678910156,HUM 5,A01,185958,West; Geoffrey Scott,0,0,50,50
1683678910156,HUM 5,A02,202215,West; Geoffrey Scott,0,0,50,50
1683678911181,INTL 190,A00,185959,Gagnon; Jeffrey C,0,0,0,9
1683678911181,INTL 190,B00,185960,Lettieri; Michael Joseph,0,0,0,2
1683678912209,JAPN 180,A00,254509,Staff,5,0,30,25
1683678913232,LATI 10,A01,202853,Kennemore; Amy Michelle,4,0,35,31
1683678913232,LATI 10,A02,202854,Kennemore; Amy Michelle,3,0,35,32
1683678913232,LATI 10,A03,270054,Kennemore; Amy Michelle,30,0,30,0
1683678914255,LATI 180,A00,202855,Kennemore; Amy Michelle,11,0,20,9
1683678915282,LAWS 101,A00,201767,Golan; Tal,0,7,40,40
1683678916308,LIFR 1C,A00,185961,Staff,6,0,20,14
1683678917336,LIFR 1CX,A00,185962,Staff,7,0,20,13
1683678918365,LIFR 1D,A00,185963,Staff,7,0,20,13
1683678919389,LIFR 1DX,A00,185964,Staff,7,0,20,13
1683678920413,LIGN 101,A01,186039,Staff,43,0,50,7
1683678921440,LIGN 165,A00,186040,Staff,15,0,50,35
1683678922464,LTCS 108,A00,186041,Staff,5,0,10,5
1683678923491,LTCS 119,A00,186042,Staff,15,0,20,5
1683678924518,LTCS 130,A00,186043,Wesling; Megan E.,15,0,25,10
1683678926567,LTEA 138,A00,186119,Staff,14,0,40,26
1683678927591,LTEN 124,A00,186148,Staff,5,0,25,20
1683678928616,LTEN 178,A00,186149,Staff,7,0,15,8
1683678929641,LTEN 181,A00,186150,Blanco; John D,34,0,40,6
1683678930668,LTWL 120,A00,186160,Staff,19,0,25,6
1683678931692,LTWL 165,A00,186161,Staff,22,0,25,3
1683678932720,LTWR 100,A00,186162,Staff,0,5,15,15
1683678933746,LTWR 102,A00,186163,Doller; Ben,5,0,15,10
1683678934770,MAE 8,A01,186412,Staff,0,1,0,0
1683678935795,MAE 30B,A00,186445,Bahadori; Mohammad Yousef,82,0,100,18
1683678936820,MAE 40,A00,186592,Bewley; Thomas R,10,0,50,40
1683678937844,MAE 101B,A00,186593,Bahadori; Mohammad Yousef,80,0,100,20
1683678938871,MAE 105,A00,186594,Bandaru; Prabhakar,10,0,50,40
1683678939895,MAE 107,A00,186599,Pham; Hieu Tan,0,7,120,120
1683678940920,MAE 148,A01,186660,Silberman; Jack,3,0,16,13
1683678941943,MATH 10A,A01,188095,Staff,0,6,35,35
1683678942968,MATH 10B,A01,188097,Bowers; Adam R.,0,12,30,30
1683678942968,MATH 10B,A02,188099,Bowers; Adam R.,0,11,30,30
1683678942968,MATH 10B,B01,188104,Bowers; Adam R.,0,10,30,30
1683678942968,MATH 10B,B02,188106,Bowers; Adam R.,1,9,30,29
1683678943993,MATH 10C,A01,188111,Staff,0,20,30,30
1683678943993,MATH 10C,A02,188127,Staff,0,19,30,30
1683678943993,MATH 10C,A03,188131,Staff,0,19,30,30
1683678943993,MATH 10C,B01,188218,Staff,17,0,30,13
1683678943993,MATH 10C,B02,188244,Staff,13,0,30,17
1683678943993,MATH 10C,B03,188277,Staff,14,0,30,16
1683678945019,MATH 18,A01,188344,Bach; Quang Tran,18,0,30,12
1683678945019,MATH 18,A02,188345,Bach; Quang Tran,11,0,30,19
1683678945019,MATH 18,B01,188353,Bach; Quang Tran,11,0,30,19
1683678945019,MATH 18,B02,188354,Bach; Quang Tran,19,0,30,11
1683678946044,MATH 20A,A01,188374,Staff,11,0,35,24
1683678947073,MATH 20B,A01,188382,Ohm; Ko Woon,7,0,30,23
1683678947073,MATH 20B,A02,188383,Ohm; Ko Woon,22,0,30,8
1683678947073,MATH 20B,B01,188385,Ohm; Ko Woon,7,0,30,23
1683678947073,MATH 20B,B02,188392,Ohm; Ko Woon,22,0,30,8
1683678948098,MATH 20C,A01,188394,Harel; Guershon,10,0,30,20
1683678948098,MATH 20C,A02,188395,Harel; Guershon,13,0,30,17
1683678948098,MATH 20C,B01,188404,Harel; Guershon,5,0,30,25
1683678948098,MATH 20C,B02,188405,Harel; Guershon,18,0,30,12
1683678949124,MATH 20D,A01,188414,Hammock; Frances H,0,1,30,30
1683678949124,MATH 20D,A02,188415,Hammock; Frances H,0,1,30,30
1683678949124,MATH 20D,B01,188447,Hammock; Frances H,0,1,30,30
1683678949124,MATH 20D,B02,188486,Hammock; Frances H,3,0,30,27
1683678950149,MATH 20E,A01,188649,Staff,21,0,30,9
1683678950149,MATH 20E,A02,188650,Staff,20,0,30,10
1683678950149,MATH 20E,A03,188673,Staff,0,0,30,30
1683678951173,MATH 102,A01,188675,Staff,0,39,35,35
1683678952197,MATH 103B,A01,188681,Staff,3,0,35,32
1683678952197,MATH 103B,B01,188692,Staff,5,0,35,30
1683678953221,MATH 109,A01,188695,Salehi Golsefidy; Alireza,24,0,35,11
1683678953221,MATH 109,A02,188696,Salehi Golsefidy; Alireza,25,0,35,10
1683678954248,MATH 120A,A01,188698,Eggers; John Dietrich,7,0,35,28
1683678955272,MATH 142B,A01,188736,Ioana; Adrian,1,1,30,29
1683678955272,MATH 142B,A02,188741,Ioana; Adrian,0,1,30,30
1683678955272,MATH 142B,A03,188743,Ioana; Adrian,0,1,30,30
1683678956301,MATH 168A,A01,188790,Staff,0,11,35,35
1683678957326,MATH 170A,A01,188803,Nie; Jiawang,0,2,35,35
1683678957326,MATH 170A,A02,188811,Nie; Jiawang,0,1,35,35
1683678957326,MATH 170A,A03,188814,Nie; Jiawang,0,0,35,35
1683678957326,MATH 170A,A04,188815,Nie; Jiawang,6,0,35,29
1683678958349,MATH 193B,A01,188817,Staff,0,0,35,35
1683678958349,MATH 193B,A02,188818,Staff,5,0,35,30
1683678959374,MGT 4,A01,202857,Anderson; John Charles,60,0,80,20
1683678960401,MGT 12,A00,202858,Lindenberger; Wade Douglas,40,0,90,50
1683678961428,MGT 18,A00,202859,Staff,74,0,90,16
1683678962455,MGT 18GS,A00,202860,McKay; Michael J,13,0,28,15
1683678963482,MGT 45,A00,202861,Pecore; Joseph P.,9,0,90,81
1683678964505,MGT 100,A00,202863,Yavorsky; Daniel Ryan,28,0,90,62
1683678965531,MGT 103,A00,202864,Ehrich; Kristine R,0,18,90,90
1683678966557,MGT 112,A00,202865,Ehrich; Kristine R,15,0,90,75
1683678967587,MGT 121A,A00,202868,Staff,90,20,90,0
1683678968615,MGT 131B,A00,202869,Anderson; John Charles,59,0,90,31
1683678969642,MGT 136,A00,202871,Lindenberger; Wade Douglas,83,0,90,7
1683678970669,MGT 164,A00,202873,Staff,0,67,90,91
1683678971694,MGT 164GS,A00,202874,McKay; Mary A,13,0,28,15
1683678972718,MGT 180,A00,202875,Staff,0,51,90,91
1683678973743,MMW 11R,A01,205019,Herbst; Matthew,0,0,30,30
1683678973743,MMW 11R,A02,205026,Herbst; Matthew,29,0,30,1
1683678974769,MMW 15,A01,193512,Chang; Edmond Yi-Teh,0,8,28,28
1683678974769,MMW 15,A02,193513,Chang; Edmond Yi-Teh,0,5,28,28
1683678974769,MMW 15,A03,193514,Chang; Edmond Yi-Teh,0,5,28,28
1683678974769,MMW 15,A04,193515,Chang; Edmond Yi-Teh,0,5,28,28
1683678974769,MMW 15,A05,193516,Chang; Edmond Yi-Teh,0,5,28,28
1683678974769,MMW 15,A06,193517,Chang; Edmond Yi-Teh,0,6,28,28
1683678974769,MMW 15,B01,193519,Chang; Edmond Yi-Teh,0,5,28,28
1683678974769,MMW 15,B02,193520,Chang; Edmond Yi-Teh,0,5,28,28
1683678974769,MMW 15,B03,193521,Chang; Edmond Yi-Teh,0,5,28,28
1683678974769,MMW 15,B04,193522,Chang; Edmond Yi-Teh,0,6,28,28
1683678974769,MMW 15,B05,193523,Chang; Edmond Yi-Teh,0,5,28,28
1683678974769,MMW 15,B06,193524,Chang; Edmond Yi-Teh,0,5,28,28
1683678975797,MMW 122,A01,193526,Rahimi; Babak,0,16,28,28
1683678975797,MMW 122,A02,193527,Rahimi; Babak,0,15,28,28
1683678975797,MMW 122,A03,193528,Rahimi; Babak,0,0,0,0
1683678975797,MMW 122,A04,193529,Rahimi; Babak,0,0,0,0
1683678976825,MUS 1A,A01,186663,Staff,1,19,35,34
1683678977853,MUS 4,A01,186715,Staff,0,12,35,35
1683678978877,MUS 5R,A01,186796,Dubnov; Shlomo,0,17,35,35
1683678979901,MUS 6,A01,186798,Staff,0,5,25,25
1683678980930,MUS 7,A01,186830,Staff,11,0,35,24
1683678982008,MUS 8,A01,186930,Staff,0,27,35,35
1683678983037,MUS 15,A01,186932,Staff,0,15,35,35
1683678983037,MUS 15,B01,186934,Staff,1,17,35,34
1683678984065,MUS 80,A00,186935,Staff,0,0,20,20
1683678984065,MUS 80,B00,186936,Staff,24,0,25,1
1683678985088,NANO 11,A00,204702,Lipomi; Darren John,0,0,0,0
1683678986112,NANO 15,A01,204709,Yang; Kesong,0,1,0,0
1683678987136,NANO 114,A00,202069,Jahed Motlagh; Zeinab,3,0,10,7
1683678988161,PHIL 1,A00,186955,Grush; Rick Scott,31,0,40,9
1683678989186,PHIL 10,A01,186973,Grush; Rick Scott,27,0,35,8
1683678989186,PHIL 10,A02,186974,Grush; Rick Scott,33,0,35,2
1683678990210,PHIL 13,A01,186976,Staff,3,0,35,32
1683678990210,PHIL 13,A02,186977,Staff,16,0,35,19
1683678991236,PHIL 14,A01,186979,Staff,31,0,35,4
1683678991236,PHIL 14,A02,186986,Staff,32,0,35,3
1683678992263,PHIL 28,A01,186988,Staff,16,0,30,14
1683678992263,PHIL 28,A02,186989,Staff,1,0,30,29
1683678992263,PHIL 28,A03,186990,Staff,10,0,30,20
1683678992263,PHIL 28,A04,186991,Staff,26,0,30,4
1683678993290,PHIL 120,A00,186997,Staff,23,0,40,17
1683678994315,PHIL 137,A00,187003,Staff,7,0,40,33
1683678995342,PHIL 150,A00,187015,Staff,47,0,70,23
1683678996369,PHIL 167,A00,187021,Lamey; Andy M.,34,0,40,6
1683678997392,PHIL 174,A01,202226,Staff,17,0,20,3
1683678997392,PHIL 174,A02,202235,Staff,20,0,20,0
1683678998420,PHIL 191A,A00,258918,Staff,0,0,1,1
1683678999445,PHYS 1A,A00,187028,Staff,26,0,60,34
1683679000470,PHYS 1AL,001,187036,Staff,3,0,30,27
1683679000470,PHYS 1AL,002,187049,Staff,18,0,30,12
1683679001497,PHYS 1B,A00,187058,Staff,22,0,60,38
1683679002527,PHYS 1BL,001,187064,Staff,0,1,30,30
1683679002527,PHYS 1BL,002,187070,Staff,4,0,30,26
1683679003556,PHYS 1C,A00,187082,Staff,29,0,120,91
1683679004580,PHYS 1CL,001,187088,Staff,0,9,30,30
1683679004580,PHYS 1CL,002,187089,Staff,0,1,30,30
1683679004580,PHYS 1CL,009,262693,Staff,9,0,30,21
1683679005605,PHYS 2B,A01,187097,Staff,55,0,115,60
1683679006630,PHYS 2C,A01,187099,Staff,63,0,115,52
1683679007659,PHYS 2CL,A01,187101,Staff,5,0,28,23
1683679007659,PHYS 2CL,A02,187102,Staff,15,0,28,13
1683679008682,PHYS 2D,A01,187123,Shotwell; Brian,95,0,115,20
1683679009708,PHYS 4B,A01,187133,Grinstein; Benjamin,35,0,50,15
1683679010733,POLI 10,A00,188819,Staff,0,4,50,50
1683679011755,POLI 11,A00,188827,Staff,43,0,50,7
1683679012781,POLI 13R,A00,188828,Staff,0,1,20,20
1683679013808,POLI 27,A01,188830,Elgin; Samuel Zincke,0,2,70,70
1683679014836,POLI 30,A00,188832,Desposato; Scott,30,0,50,20
1683679015862,POLI 102F,A00,188834,Staff,0,0,40,40
1683679016889,POLI 104A,A00,188852,Staff,12,0,30,18
1683679017912,POLI 104I,A00,188853,Staff,0,8,20,20
1683679018939,POLI 110B,A00,188854,Wiens; David,6,0,20,14
1683679019966,POLI 112A,A00,188855,Wiens; David,3,0,30,27
1683679020990,POLI 117R,A00,188856,Forman; Fonna,0,12,20,20
1683679022014,POLI 118,A00,188857,Ingham; Sean,8,0,20,12
1683679023039,POLI 120G,A00,188858,Staff,8,0,30,22
1683679024066,POLI 131CR,A00,188863,Hoston; Germaine,20,0,50,30
1683679025091,POLI 133,A00,188864,Nellis; Gareth Hb,44,0,50,6
1683679026115,POLI 134D,A00,188865,Desposato; Scott,27,0,30,3
1683679027145,POLI 142A,A00,188871,Gartzke; Erik,21,0,50,29
1683679028174,POLI 142K,A00,188874,Staff,38,0,50,12
1683679029202,POLI 143,A00,188940,Gartzke; Erik,16,0,30,14
1683679030228,POLI 153,A00,188943,Staff,2,0,20,18
1683679031251,POLI 160AA,A00,188944,Staff,10,0,40,30
1683679032276,POLI 170A,A00,188945,Staff,10,0,30,20
1683679034327,PSYC 1,A00,188952,Staff,36,0,90,54
1683679035351,PSYC 2,B00,188953,Staff,19,0,35,16
1683679036375,PSYC 6,A00,188970,Staff,47,0,60,13
1683679037401,PSYC 7,A00,188973,Staff,35,0,45,10
1683679038425,PSYC 60,A01,188980,Rickard; Timothy C.,42,0,60,18
1683679039453,PSYC 70,A01,189001,Steiner; Eric Tomas,21,0,45,24
1683679040483,PSYC 100,A00,189005,Lacefield; Katharine I,0,99,120,120
1683679041507,PSYC 102,A00,189008,Staff,7,0,30,23
1683679042531,PSYC 106,B00,189026,Gorman; Michael R.,27,0,60,33
1683679043556,PSYC 114,B01,189033,Winkielman; Piotr,0,31,30,30
1683679044581,PSYC 131,A00,189036,Anagnostaras; Stephan,0,43,60,60
1683679045604,PSYC 136,A00,189041,Lowe; Angela Beth,0,7,25,25
1683679046628,PSYC 137,A00,189057,Winkielman; Piotr,1,37,25,24
1683679047653,PSYC 144,A00,189107,Wixted; John T,0,11,50,50
1683679049702,PSYC 162,A00,189142,Staff,0,9,85,85
1683679050726,PSYC 172,A00,189144,Gorman; Michael R.,0,6,30,30
1683679052776,PSYC 179,A00,189146,Lacefield; Katharine I,0,87,120,120
1683679053804,PSYC 181,A00,189147,Anagnostaras; Stephan,0,44,90,90
1683679054829,PSYC 190R,A00,189148,Barner; David A.,0,23,80,80
1683679055855,PSYC 191,A00,189275,Rickard; Timothy C.,0,10,25,25
1683679056881,PSYC 193,A00,189276,Chapman; Eddie Nathaniel,0,1,0,4
1683679057906,PSYC 193L,A01,189281,Lowe; Angela Beth,8,0,20,12
1683679057906,PSYC 193L,B01,189285,Staff,28,0,35,7
1683679058930,RELI 149,A00,187137,Rahimi; Babak,7,0,40,33
1683679059957,SE 9,A01,187315,Staff,0,2,18,18
1683679060981,SE 101B,A00,187409,Staff,24,0,30,6
1683679062006,SE 110B,A00,187444,Staff,10,0,40,30
1683679063029,SE 130B,A00,187449,Staff,31,0,40,9
1683679064055,SE 150A,A00,187516,Staff,8,0,20,12
1683679065081,SE 154,A00,187528,Staff,29,0,50,21
1683679066105,SIO 3,A01,258171,Staff,35,0,40,5
1683679067129,SIO 10,A00,187144,Cook; Geoffrey W,1,7,75,74
1683679068157,SIO 45,A00,187152,Cook; Geoffrey W,0,7,100,100
1683679069183,SIO 109R,A00,194486,Staff,0,4,20,20
1683679071233,SIO 187,A01,187233,Kacev; David,12,0,40,28
1683679072257,SOCI 1,A01,258656,Thorpe; Charles Robert,28,0,30,2
1683679072257,SOCI 1,A02,258658,Thorpe; Charles Robert,30,0,30,0
1683679072257,SOCI 1,A03,258661,Thorpe; Charles Robert,25,0,25,0
1683679072257,SOCI 1,A04,258666,Thorpe; Charles Robert,22,0,25,3
1683679072257,SOCI 1,A05,258897,Thorpe; Charles Robert,22,0,25,3
1683679072257,SOCI 1,A06,258898,Thorpe; Charles Robert,25,0,25,0
1683679073281,SOCI 30,A01,258903,Pardo Guerra; Juan Pablo,14,0,30,16
1683679074305,SOCI 102,A00,258904,Staff,9,0,25,16
1683679075329,SOCI 106,A00,258905,Staff,19,0,25,6
1683679076356,SOCI 111,A00,258907,Ribas Norris; Janet Vanesa,26,0,30,4
1683679077383,SOCI 121R,A00,258908,Pardo Guerra; Juan Pablo,8,0,30,22
1683679078406,SOCI 126,A01,203330,Staff,14,0,20,6
1683679079430,SOCI 131,A00,258909,Thorpe; Charles Robert,30,0,60,30
1683679080456,SOCI 135,A00,258910,Payne; Christine Anna,0,12,30,30
1683679081482,SOCI 157,A00,258911,Staff,11,0,30,19
1683679082506,SOCI 184,A00,258912,Staff,25,0,30,5
1683679083543,SOCI 188D,A00,258913,Staff,22,0,30,8
1683679084571,SYN 2,001,187529,Staff,9,0,16,7
1683679084571,SYN 2,002,201452,Staff,1,20,16,15
1683679084571,SYN 2,003,201469,Staff,1,0,16,15
1683679085652,SYN 100,A01,187531,Staff,0,9,20,20
1683679085652,SYN 100,B01,201491,Staff,0,10,20,20
1683679086681,TDAC 1,A00,189286,Walsh; Kim C.,3,0,20,17
1683679086681,TDAC 1,B00,189287,Harting; Carla Kelso,10,0,20,10
1683679087706,TDAC 101,A00,189300,Walsh; Kim C.,16,0,20,4
1683679087706,TDAC 101,B00,189301,Harting; Carla Kelso,18,0,20,2
1683679088730,TDAC 102,A00,189304,Basso; Beatrice,14,0,20,6
1683679089753,TDAC 108,A00,189305,Staff,18,0,20,2
1683679090782,TDDE 131,A00,189310,Staff,19,0,20,1
1683679090782,TDDE 131,B00,189314,Staff,19,0,20,1
1683679090782,TDDE 131,C00,189315,Staff,48,0,50,2
1683679090782,TDDE 131,D00,189316,Staff,14,0,15,1
1683679090782,TDDE 131,E00,204841,Staff,20,0,20,0
1683679091807,TDGE 10,A00,189289,Staff,27,0,50,23
1683679091807,TDGE 10,B00,189290,Havis; Allan,0,1,50,50
1683679092836,TDGE 11,A00,189291,Fulton; Julia,0,4,50,50
1683679092836,TDGE 11,B00,189292,Staff,20,0,25,5
1683679092836,TDGE 11,C00,260270,Staff,0,0,0,0
1683679093864,TDGE 25,A00,189294,Staff,1,0,20,19
1683679094893,TDGE 124,A00,189318,Fulton; Julia,0,8,50,50
1683679095921,TDGE 125,A00,189319,Staff,13,0,25,12
1683679095921,TDGE 125,B00,189320,Staff,23,0,25,2
1683679096948,TDGE 127,A00,189322,Havis; Allan,0,0,50,50
1683679097975,TDHT 101,A00,189323,Staff,18,0,25,7
1683679097975,TDHT 101,B00,189324,Staff,25,0,25,0
1683679099000,TDHT 102,A00,189325,Staff,49,0,50,1
1683679100030,TDMV 1,A00,189295,Arcidiacono; Kristin,20,0,30,10
1683679100030,TDMV 1,B00,189296,Caligagan; Maria T.,24,0,30,6
1683679101055,TDMV 2,A00,189297,Sammartano; Tonnie,27,0,30,3
1683679101055,TDMV 2,B00,189299,Arcidiacono; Kristin,23,0,30,7
1683679102080,TDMV 3,A00,204998,Rincon; Alicia,22,0,30,8
1683679103108,TDMV 120,A00,189458,Sammartano; Tonnie,28,0,30,2
1683679104132,TDMV 138,A00,189541,Jun; Grace Shin Hae,20,0,40,20
1683679105155,TDMV 142,A00,189717,Caligagan; Tony,25,0,30,5
1683679105155,TDMV 142,B00,189718,Caligagan; Maria T.,25,0,30,5
1683679106179,TMC 2,A01,187533,Staff,25,0,25,0
1683679106179,TMC 2,A02,187534,Staff,25,0,25,0
1683679107207,USP 1,A01,187536,Kwak; Nancy,0,16,25,25
1683679108233,USP 5,A01,187538,Staff,8,0,25,17
1683679109257,USP 101,A00,199253,Staff,0,4,0,0
1683679110282,USP 124,A00,187562,Boomhower; Matthew Charles,0,0,30,30
1683679111308,USP 138,A00,187582,Staff,19,0,25,6
1683679112335,USP 152,A01,187597,Staff,3,0,25,22
1683679113359,USP 153,A00,187598,Staff,19,0,25,6
1683679114385,USP 168,A00,187607,Kwak; Nancy,2,0,5,3
1683679115406,USP 173,A00,187619,Staff,4,0,25,21
1683679116430,USP 181,A00,187638,Staff,0,4,25,25
1683679117458,VIS 103,A00,187650,Cruz; Edwin Teddy,17,0,75,58
1683679118482,VIS 110D,A00,187669,Staff,13,0,22,9
1683679119510,VIS 127C,A00,187720,Shen; Kuiyi,67,0,146,79
1683679120536,VIS 149,A00,187731,Yoldas; Pinar,1,14,22,21
1683679121562,VIS 151,A01,188091,Staff,22,0,34,12
1683679121562,VIS 151,A02,188092,Staff,11,0,34,23
1683679122586,VIS 160B,A00,188093,Stalbaum; Brett,0,1,10,10
1683679124636,WCWP 10B,A00,201720,Staff,0,0,5,5
1683679124636,WCWP 10B,B00,201722,Staff,0,0,6,6
1683679125659,WCWP 100,A00,201725,Gagnon; Jeffrey C,0,0,2,2
1683679125659,WCWP 100,B00,201727,Staff,0,4,15,15
1683679128789,ANBI 133,A00,258401,Wilder; Linnea Lorene,34,0,40,6
1683679129813,ANBI 140,A00,258395,Hrvoj Mihic; Branka,18,0,25,7
1683679130839,ANSC 120,A00,258402,Bialecki; Jon Anthony,26,0,40,14
1683679131869,ANSC 144,A00,258400,Staff,12,0,40,28
1683679133922,ANSC 166,A00,258396,Parish; Steven Martin,156,0,175,19
1683679134945,ANSC 180,A00,193533,Staff,8,0,20,12
1683679135970,ANSC 188,A00,258397,Jassal; Aftab,34,0,40,6
1683679136997,ANTH 3,A01,258316,Staff,23,0,30,7
1683679138023,ANTH 5,A00,258394,Semendeferi; Ekaterini,16,0,20,4
1683679139048,ANTH 21,A01,258331,Staff,4,0,40,36
1683679140077,ANTH 103,A00,258398,Varma; Saiba,15,0,25,10
1683679141105,AWP 10,001,202034,Staff,0,0,0,0
1683679141105,AWP 10,002,202035,Staff,0,0,0,0
1683679141105,AWP 10,003,202036,Staff,0,0,0,0
1683679141105,AWP 10,004,202037,Staff,0,0,0,0
1683679141105,AWP 10,005,202038,Staff,0,0,0,0
1683679141105,AWP 10,006,202039,Staff,0,0,0,0
1683679141105,AWP 10,007,202040,Staff,0,0,0,0
1683679141105,AWP 10,008,202041,Staff,0,0,0,0
1683679141105,AWP 10,009,202042,Staff,0,0,0,0
1683679141105,AWP 10,010,202043,Staff,0,0,0,0
1683679141105,AWP 10,011,202044,Staff,0,0,0,0
1683679141105,AWP 10,012,202045,Staff,0,0,0,0
1683679141105,AWP 10,013,202046,Staff,0,0,0,0
1683679141105,AWP 10,014,202047,Staff,0,0,0,0
1683679141105,AWP 10,015,202048,Staff,0,0,0,0
1683679141105,AWP 10,016,202049,Staff,0,0,0,0
1683679141105,AWP 10,017,202050,Staff,0,0,0,0
1683679141105,AWP 10,018,202051,Staff,0,0,0,0
1683679141105,AWP 10,019,202052,Staff,0,0,0,0
1683679141105,AWP 10,020,202053,Staff,0,0,0,0
1683679141105,AWP 10,021,202054,Staff,0,0,0,0
1683679141105,AWP 10,022,202055,Staff,0,0,0,0
1683679141105,AWP 10,023,202056,Staff,0,0,0,0
1683679141105,AWP 10,024,202057,Staff,0,0,0,0
1683679141105,AWP 10,025,202058,Staff,0,0,0,0
1683679141105,AWP 10,026,202059,Staff,0,0,0,0
1683679142129,AWP 102,001,202032,Staff,0,0,0,0
1683679142129,AWP 102,002,202033,Staff,0,0,0,0
1683679143158,BENG 100,A01,254234,Taylor Amos; Alyssa C,31,0,40,9
1683679144181,BENG 196,001,270013,Engler; Adam J.,9999,0,9999,0
1683679145207,BICD 100R,A01,202018,Smith; Laurie,0,7,32,32
1683679145207,BICD 100R,A02,202019,Smith; Laurie,0,3,32,32
1683679145207,BICD 100R,A03,202020,Smith; Laurie,0,1,32,32
1683679145207,BICD 100R,A04,202021,Smith; Laurie,6,0,32,26
1683679145207,BICD 100R,A05,202022,Smith; Laurie,10,0,32,22
1683679146237,BICD 136,A01,193242,Gustafson-Brown; Cindy,0,2,32,32
1683679146237,BICD 136,A02,193244,Gustafson-Brown; Cindy,13,0,32,19
1683679147265,BIEB 102,A01,193249,Butler; Shannon Rhey,1,1,32,31
1683679147265,BIEB 102,A02,193251,Butler; Shannon Rhey,0,0,32,32
1683679147265,BIEB 102,A03,193253,Butler; Shannon Rhey,0,0,32,32
1683679147265,BIEB 102,A04,193255,Butler; Shannon Rhey,13,0,32,19
1683679147265,BIEB 102,A05,193265,Butler; Shannon Rhey,25,0,32,7
1683679147265,BIEB 102,A06,193269,Butler; Shannon Rhey,13,0,32,19
1683679149314,BIEB 150,A01,193274,Staff,0,0,32,32
1683679149314,BIEB 150,A02,193285,Staff,24,0,32,8
1683679150338,BIEB 194,A00,193286,Kurle; Carolyn M.,19,0,32,13
1683679151361,BILD 1,A01,192291,Staff,15,0,32,17
1683679151361,BILD 1,A02,192292,Staff,30,0,32,2
1683679151361,BILD 1,B01,192520,Reuther; Keefe,0,1,0,0
1683679151361,BILD 1,B02,192532,Reuther; Keefe,0,1,0,0
1683679152390,BILD 3,A01,192556,Butler; Shannon Rhey,0,0,32,32
1683679152390,BILD 3,A02,192581,Butler; Shannon Rhey,0,1,32,32
1683679152390,BILD 3,A03,192611,Butler; Shannon Rhey,19,0,32,13
1683679152390,BILD 3,A04,192612,Butler; Shannon Rhey,24,0,32,8
1683679152390,BILD 3,A05,192613,Butler; Shannon Rhey,26,0,32,6
1683679152390,BILD 3,A06,192679,Butler; Shannon Rhey,27,0,32,5
1683679152390,BILD 3,A07,192682,Butler; Shannon Rhey,20,0,32,12
1683679153416,BILD 4,A01,192836,Reuther; Keefe,1,0,24,23
1683679153416,BILD 4,A02,193044,Reuther; Keefe,4,0,24,20
1683679154446,BILD 10,A01,193142,Gustafson-Brown; Cindy,29,0,32,3
1683679154446,BILD 10,A02,193149,Gustafson-Brown; Cindy,31,0,32,1
1683679155469,BIMM 100,A01,193301,Staff,0,6,32,32
1683679155469,BIMM 100,A02,193312,Staff,0,7,32,32
1683679155469,BIMM 100,A03,193323,Staff,0,10,32,32
1683679156499,BIMM 101,A01,193329,McDonnell; Lisa Marie,1,4,24,23
1683679156499,BIMM 101,A02,193339,McDonnell; Lisa Marie,1,4,24,23
1683679156499,BIMM 101,B01,193354,McDonnell; Lisa Marie,0,4,24,24
1683679156499,BIMM 101,B02,193357,McDonnell; Lisa Marie,0,3,24,24
1683679157526,BIMM 110,A01,193377,Tat; John,0,11,32,32
1683679157526,BIMM 110,A02,193378,Tat; John,0,11,32,32
1683679158550,BIMM 120,A01,206116,Staff,0,0,32,32
1683679158550,BIMM 120,A02,206117,Staff,7,0,32,25
1683679158550,BIMM 120,A03,206121,Staff,21,0,32,11
1683679159575,BIPN 100,A01,193393,Park; Ji Young,0,15,32,32
1683679159575,BIPN 100,A02,193402,Park; Ji Young,0,14,32,32
1683679159575,BIPN 100,A03,193413,Park; Ji Young,0,14,32,32
1683679159575,BIPN 100,A04,193414,Park; Ji Young,0,13,32,32
1683679160603,BIPN 102,A01,193429,Staff,0,0,32,32
1683679160603,BIPN 102,A02,193438,Staff,18,0,32,14
1683679161628,BIPN 106,A01,193450,Reyes Gonzalez; Catalina,0,2,40,40
1683679162654,BIPN 134,A01,193465,Cooke; James Edward,0,0,32,32
1683679162654,BIPN 134,A02,193474,Cooke; James Edward,25,0,32,7
1683679162654,BIPN 134,A03,193485,Cooke; James Edward,29,0,32,3
1683679162654,BIPN 134,A04,193486,Cooke; James Edward,20,0,32,12
1683679162654,BIPN 134,A05,193491,Cooke; James Edward,31,0,32,1
1683679162654,BIPN 134,A06,193501,Cooke; James Edward,30,0,32,2
1683679162654,BIPN 134,A07,193510,Cooke; James Edward,29,0,32,3
1683679164702,BISP 194,A00,222522,Staff,14,0,32,18
1683679165726,CAT 124,A01,202407,Staff,19,0,25,6
1683679166750,CAT 125,A00,202408,Marchisotto; Jennifer Anne,2,0,20,18
1683679167775,CAT 125R,A00,202409,Smith; Lauryn Alissa,0,11,20,20
1683679167775,CAT 125R,B00,202410,Morales; Celeste Georgianna,0,11,20,20
1683679167775,CAT 125R,C00,202411,Irwin; Matthew Joseph,0,12,20,20
1683679168801,CENG 15,A01,204712,Yang; Kesong,0,1,0,0
1683679169825,CENG 114,A00,202070,Jahed Motlagh; Zeinab,5,0,20,15
1683679170852,CGS 105,A00,185477,Wesling; Megan E.,24,0,40,16
1683679171875,CGS 106,A00,185494,Staff,11,0,22,11
1683679172902,CGS 108,A00,185495,Staff,14,0,20,6
1683679173926,CGS 114,A00,185496,Staff,13,0,18,5
1683679174953,CGS 119,A00,185501,Staff,15,0,20,5
1683679175979,CGS 120,A00,185511,Staff,12,0,20,8
1683679177006,CHEM 4,A01,184675,Bussey; Thomas J,97,0,100,3
1683679178033,CHEM 6A,A01,184677,Staff,32,0,60,28
1683679179059,CHEM 6B,A01,184679,Staff,63,0,100,37
1683679180089,CHEM 6C,A01,184681,Bussey; Thomas J,0,0,50,50
1683679180089,CHEM 6C,A02,184682,Bussey; Thomas J,32,0,50,18
1683679181116,CHEM 40A,A01,184684,Albizati; Kim F.,33,0,100,67
1683679182144,CHEM 40B,A01,184686,Albizati; Kim F.,0,22,100,100
1683679183171,CHEM 41B,A01,184690,Staff,51,0,100,49
1683679184198,COGS 3,A01,184715,Boyle; Mary E. T.,0,27,40,40
1683679185225,COGS 14B,A01,185172,Staff,0,14,38,38
1683679186248,COGS 18,A01,184736,Staff,14,0,80,66
1683679187276,COGS 100,A01,184932,Staff,0,8,73,73
1683679188299,COGS 101A,A01,184935,Staff,0,40,30,30
1683679189382,COGS 101B,A01,184944,Staff,0,2,30,30
1683679190407,COGS 101C,A01,184946,Staff,0,10,30,30
1683679191430,COGS 102A,A01,184951,Johnson; Christine M.,2,0,40,38
1683679192455,COGS 107B,A01,184953,Mooshagian; Eric Frederick,0,52,40,40
1683679193479,COGS 118B,A01,184959,Gupta; Anjum,0,50,40,40
1683679194503,COGS 153,A00,184961,Staff,0,16,30,30
1683679195528,COGS 177,A00,184962,Staff,0,21,30,30
1683679196556,COGS 187A,A01,184969,Boyle; Mary E. T.,0,19,40,40
1683679197583,COMM 10,A01,185174,Staff,0,5,25,25
1683679197583,COMM 10,A02,185189,Staff,0,2,25,25
1683679197583,COMM 10,A03,269821,Staff,0,1,0,0
1683679198609,COMM 100B,A02,185476,Staff,11,0,25,14
1683679198609,COMM 100B,A03,277340,Staff,25,0,25,0
1683679199632,COMM 100C,A01,185314,Staff,1,0,25,24
1683679199632,COMM 100C,A02,185327,Staff,17,0,25,8
1683679200659,COMM 110M,A00,185349,Staff,0,0,40,40
1683679201687,COMM 113T,A00,185352,Staff,25,0,40,15
1683679202713,COMM 114I,A00,185353,Staff,31,0,40,9
1683679203736,COMM 131,A00,185354,Staff,17,0,30,13
1683679204761,CSE 8A,A50,185358,Cao; Yingjun,0,46,10,10
1683679205787,CSE 8B,A01,185362,Staff,0,48,50,50
1683679206811,CSE 11,A01,185416,Cao; Yingjun,0,91,10,10
1683679207836,CSE 20,A01,185445,Briones; Jor-el Thomas Caparas,3,0,25,22
1683679208860,CSE 21,A01,185447,Staff,9,0,50,41
1683679209885,CSE 101,A01,185451,Staff,0,13,50,50
1683679209885,CSE 101,B01,185453,Jones; Miles E,0,14,50,50
1683679211937,CSE 141,A01,185458,Eldon; John,16,0,100,84
1683679212962,CSE 141L,A01,185461,Eldon; John,8,0,100,92
1683679213986,CSE 142,A01,185463,Staff,34,0,60,26
1683679213986,CSE 142,B01,201355,Staff,0,7,60,60
1683679215009,CSE 142L,A01,185470,Staff,34,0,60,26
1683679215009,CSE 142L,B01,201417,Staff,0,6,60,60
1683679216032,CSE 190,A00,201433,Staff,32,0,49,17
1683679217056,DOC 1,A01,259136,Strom; Megan C.,7,0,15,8
1683679217056,DOC 1,A02,259137,Strom; Megan C.,14,0,15,1
1683679217056,DOC 1,A03,259138,Strom; Megan C.,14,0,15,1
1683679217056,DOC 1,A04,259139,Strom; Megan C.,14,0,15,1
1683679218078,DOC 100D,A00,259140,Pass; Natalye Joann,14,0,25,11
1683679219105,DSGN 1,A01,184749,Rill; Bryan,0,26,30,30
1683679220129,DSGN 100,A01,185168,Staff,0,2,25,25
1683679221157,ECE 5,A01,185626,Morris; Karcher William,0,12,0,0
1683679222184,ECE 101,A01,185628,Staff,14,0,70,56
1683679223211,ECE 107,A01,185635,Baghdadchi; Saharnaz,0,0,20,20
1683679223211,ECE 107,A02,185638,Baghdadchi; Saharnaz,1,0,20,19
1683679224239,ECE 148,A01,185647,Silberman; Jack,0,0,16,16
1683679225262,ECON 1,A01,185537,Crane; Meredith Helen,54,0,70,16
1683679226286,ECON 3,A01,185549,Crane; Meredith Helen,29,0,70,41
1683679227311,ECON 4,A01,203354,Anderson; John Charles,0,5,10,10
1683679228337,ECON 100A,A01,185574,Staff,0,5,40,40
1683679229362,ECON 100B,A01,185576,Staff,0,12,50,50
1683679230386,ECON 100C,A01,185589,Newhouse; Herbert S,30,0,70,40
1683679231409,ECON 105,A00,185608,Vespa; Emanuel Ignacio,19,0,35,16
1683679232432,ECON 109,A01,185610,Shishkin; Denis,9,0,35,26
1683679233457,ECON 110A,A01,185612,Staff,9,0,40,31
1683679234481,ECON 120A,A01,185615,Staff,19,0,40,21
1683679235506,ECON 120C,A01,185617,Sun; Yixiao,0,21,70,70
1683679236530,ECON 144,A00,203346,Squires; Dale E,2,0,35,33
1683679237558,ECON 171,A01,203349,Newhouse; Herbert S,0,1,35,35
1683679238583,ECON 173A,A01,185621,Toda; Alexis Akira,21,0,35,14
1683679239614,EDS 25,A01,202413,Staff,0,1,0,0
1683679239614,EDS 25,A02,202414,Staff,0,1,0,0
1683679239614,EDS 25,A03,202415,Staff,0,0,0,0
1683679239614,EDS 25,A04,202416,Staff,0,1,0,0
1683679239614,EDS 25,A05,202439,Staff,0,0,0,0
1683679239614,EDS 25,A06,202440,Staff,0,0,0,0
1683679239614,EDS 25,B01,202631,Staff,0,0,0,0
1683679239614,EDS 25,B02,202632,Staff,0,0,0,0
1683679239614,EDS 25,B03,202639,Staff,0,0,0,0
1683679239614,EDS 25,B04,202640,Staff,0,0,0,0
1683679239614,EDS 25,B05,202643,Staff,0,0,0,0
1683679239614,EDS 25,B06,202644,Staff,0,0,0,0
1683679240641,EDS 38,A01,202659,Black; Alison Michelle,24,0,25,1
1683679241667,EDS 115,A00,202652,Staff,18,0,30,12
1683679242691,EDS 125,A00,202649,Staff,13,0,30,17
1683679243716,EDS 126,A01,203332,Staff,30,0,30,0
1683679244739,EDS 139,A00,202838,Staff,16,0,25,9
1683679245763,EDS 146,A01,202655,Staff,14,0,25,11
1683679246789,ENG 15,A00,185667,Staff,0,1,0,0
1683679246789,ENG 15,B00,185672,Staff,0,0,0,0
1683679246789,ENG 15,C00,185675,Staff,0,0,0,0
1683679246789,ENG 15,D00,185682,Staff,0,0,0,0
1683679246789,ENG 15,E00,185684,Staff,0,0,0,0
1683679247813,ETHN 103,A00,185710,Staff,0,8,35,35
1683679248839,ETHN 103A,A00,199228,Man; Simeon S,0,0,9,9
1683679249866,ETHN 109,A00,185711,Staff,15,0,35,20
1683679250890,ETHN 142,A00,185726,Staff,0,4,30,30
1683679251915,ETHN 163J,A00,199229,Man; Simeon S,5,0,8,3
1683679252940,ETHN 168,A00,185727,Staff,7,0,10,3
1683679253964,ETHN 182,A00,185728,Staff,0,0,35,35
1683679254989,ETHN 183,A00,185737,Staff,9,0,18,9
1683679256011,GLBH 111,A01,209361,Burgos; Jose L.,0,0,0,0
1683679258059,HIEU 104,A00,185792,Staff,14,0,20,6
1683679259084,HIEU 115,A00,185800,Staff,0,0,20,20
1683679260111,HIEU 128,A00,185801,Staff,0,9,20,20
1683679261134,HIEU 147,A00,185802,Staff,15,0,20,5
1683679262161,HIEU 154,A00,185823,Staff,11,0,20,9
1683679263189,HILA 102,A00,185826,Staff,14,0,20,6
1683679264212,HILD 2C,A01,185778,Staff,0,13,20,20
1683679265237,HILD 7B,A01,185780,Kwak; Nancy,0,17,32,32
1683679265237,HILD 7B,A02,185781,Kwak; Nancy,0,18,32,32
1683679266265,HILD 30,A01,185791,Staff,12,0,20,8
1683679267292,HISC 119,A00,185830,Golan; Tal,0,9,20,20
1683679268317,HITO 156GS,A00,185831,Patterson; Patrick H.,0,0,0,23
1683679269344,HIUS 103,A00,185832,Man; Simeon S,0,4,20,20
1683679270369,HIUS 117,A00,185836,Kwak; Nancy,2,0,20,18
1683679271394,HIUS 125,A00,185840,Man; Simeon S,0,2,23,23
1683679272417,HIUS 149,A00,185845,Staff,1,0,20,19
1683679273444,HUM 3,A01,185882,Zavodny; Tatiana Sophia,0,8,50,50
1683679273444,HUM 3,B01,185899,Caldwell; Michael Alan,0,18,50,50
1683679274471,HUM 3GS,A00,185900,Patterson; Patrick H.,0,0,0,23
1683679275496,HUM 4,A01,185938,Zroka; Amy Liane,28,0,50,22
1683679275496,HUM 4,B01,185956,Watkins; Eric,0,6,50,50
1683679275496,HUM 4,B02,202209,Watkins; Eric,0,5,50,50
1683679275496,HUM 4,B03,202210,Watkins; Eric,0,5,50,50
1683679276521,HUM 5,A01,185958,West; Geoffrey Scott,0,0,50,50
1683679276521,HUM 5,A02,202215,West; Geoffrey Scott,0,0,50,50
1683679277545,INTL 190,A00,185959,Gagnon; Jeffrey C,0,0,0,9
1683679277545,INTL 190,B00,185960,Lettieri; Michael Joseph,0,0,0,2
1683679278572,JAPN 180,A00,254509,Staff,5,0,30,25
1683679279601,LATI 10,A01,202853,Kennemore; Amy Michelle,4,0,35,31
1683679279601,LATI 10,A02,202854,Kennemore; Amy Michelle,3,0,35,32
1683679279601,LATI 10,A03,270054,Kennemore; Amy Michelle,30,0,30,0
1683679280629,LATI 180,A00,202855,Kennemore; Amy Michelle,11,0,20,9
1683679281653,LAWS 101,A00,201767,Golan; Tal,0,7,40,40
1683679282677,LIFR 1C,A00,185961,Staff,6,0,20,14
1683679283702,LIFR 1CX,A00,185962,Staff,7,0,20,13
1683679284726,LIFR 1D,A00,185963,Staff,7,0,20,13
1683679285753,LIFR 1DX,A00,185964,Staff,7,0,20,13
1683679286777,LIGN 101,A01,186039,Staff,43,0,50,7
1683679287801,LIGN 165,A00,186040,Staff,15,0,50,35
1683679288824,LTCS 108,A00,186041,Staff,5,0,10,5
1683679289848,LTCS 119,A00,186042,Staff,15,0,20,5
1683679290872,LTCS 130,A00,186043,Wesling; Megan E.,15,0,25,10
1683679292980,LTEA 138,A00,186119,Staff,14,0,40,26
1683679294007,LTEN 124,A00,186148,Staff,5,0,25,20
1683679295031,LTEN 178,A00,186149,Staff,7,0,15,8
1683679296055,LTEN 181,A00,186150,Blanco; John D,34,0,40,6
1683679297080,LTWL 120,A00,186160,Staff,19,0,25,6
1683679298105,LTWL 165,A00,186161,Staff,22,0,25,3
1683679299128,LTWR 100,A00,186162,Staff,0,5,15,15
1683679300153,LTWR 102,A00,186163,Doller; Ben,5,0,15,10
1683679301178,MAE 8,A01,186412,Staff,0,1,0,0
1683679302209,MAE 30B,A00,186445,Bahadori; Mohammad Yousef,82,0,100,18
1683679303232,MAE 40,A00,186592,Bewley; Thomas R,10,0,50,40
1683679304257,MAE 101B,A00,186593,Bahadori; Mohammad Yousef,80,0,100,20
1683679305286,MAE 105,A00,186594,Bandaru; Prabhakar,10,0,50,40
1683679306314,MAE 107,A00,186599,Pham; Hieu Tan,0,7,120,120
1683679307339,MAE 148,A01,186660,Silberman; Jack,3,0,16,13
1683679308362,MATH 10A,A01,188095,Staff,0,6,35,35
1683679309388,MATH 10B,A01,188097,Bowers; Adam R.,0,12,30,30
1683679309388,MATH 10B,A02,188099,Bowers; Adam R.,0,11,30,30
1683679309388,MATH 10B,B01,188104,Bowers; Adam R.,0,10,30,30
1683679309388,MATH 10B,B02,188106,Bowers; Adam R.,1,9,30,29
1683679310413,MATH 10C,A01,188111,Staff,0,20,30,30
1683679310413,MATH 10C,A02,188127,Staff,0,19,30,30
1683679310413,MATH 10C,A03,188131,Staff,0,19,30,30
1683679310413,MATH 10C,B01,188218,Staff,17,0,30,13
1683679310413,MATH 10C,B02,188244,Staff,13,0,30,17
1683679310413,MATH 10C,B03,188277,Staff,14,0,30,16
1683679311441,MATH 18,A01,188344,Bach; Quang Tran,18,0,30,12
1683679311441,MATH 18,A02,188345,Bach; Quang Tran,11,0,30,19
1683679311441,MATH 18,B01,188353,Bach; Quang Tran,11,0,30,19
1683679311441,MATH 18,B02,188354,Bach; Quang Tran,19,0,30,11
1683679312469,MATH 20A,A01,188374,Staff,11,0,35,24
1683679313494,MATH 20B,A01,188382,Ohm; Ko Woon,7,0,30,23
1683679313494,MATH 20B,A02,188383,Ohm; Ko Woon,22,0,30,8
1683679313494,MATH 20B,B01,188385,Ohm; Ko Woon,7,0,30,23
1683679313494,MATH 20B,B02,188392,Ohm; Ko Woon,22,0,30,8
1683679314519,MATH 20C,A01,188394,Harel; Guershon,10,0,30,20
1683679314519,MATH 20C,A02,188395,Harel; Guershon,13,0,30,17
1683679314519,MATH 20C,B01,188404,Harel; Guershon,5,0,30,25
1683679314519,MATH 20C,B02,188405,Harel; Guershon,18,0,30,12
1683679315549,MATH 20D,A01,188414,Hammock; Frances H,0,1,30,30
1683679315549,MATH 20D,A02,188415,Hammock; Frances H,0,1,30,30
1683679315549,MATH 20D,B01,188447,Hammock; Frances H,0,1,30,30
1683679315549,MATH 20D,B02,188486,Hammock; Frances H,3,0,30,27
1683679316576,MATH 20E,A01,188649,Staff,21,0,30,9
1683679316576,MATH 20E,A02,188650,Staff,20,0,30,10
1683679316576,MATH 20E,A03,188673,Staff,0,0,30,30
1683679317603,MATH 102,A01,188675,Staff,0,39,35,35
1683679318631,MATH 103B,A01,188681,Staff,3,0,35,32
1683679318631,MATH 103B,B01,188692,Staff,5,0,35,30
1683679319655,MATH 109,A01,188695,Salehi Golsefidy; Alireza,24,0,35,11
1683679319655,MATH 109,A02,188696,Salehi Golsefidy; Alireza,25,0,35,10
1683679320678,MATH 120A,A01,188698,Eggers; John Dietrich,7,0,35,28
1683679321704,MATH 142B,A01,188736,Ioana; Adrian,1,1,30,29
1683679321704,MATH 142B,A02,188741,Ioana; Adrian,0,1,30,30
1683679321704,MATH 142B,A03,188743,Ioana; Adrian,0,1,30,30
1683679322733,MATH 168A,A01,188790,Staff,0,11,35,35
1683679323762,MATH 170A,A01,188803,Nie; Jiawang,0,2,35,35
1683679323762,MATH 170A,A02,188811,Nie; Jiawang,0,1,35,35
1683679323762,MATH 170A,A03,188814,Nie; Jiawang,0,0,35,35
1683679323762,MATH 170A,A04,188815,Nie; Jiawang,6,0,35,29
1683679324786,MATH 193B,A01,188817,Staff,0,0,35,35
1683679324786,MATH 193B,A02,188818,Staff,5,0,35,30
1683679325812,MGT 4,A01,202857,Anderson; John Charles,60,0,80,20
1683679326836,MGT 12,A00,202858,Lindenberger; Wade Douglas,40,0,90,50
1683679327864,MGT 18,A00,202859,Staff,74,0,90,16
1683679328889,MGT 18GS,A00,202860,McKay; Michael J,13,0,28,15
1683679329917,MGT 45,A00,202861,Pecore; Joseph P.,9,0,90,81
1683679330945,MGT 100,A00,202863,Yavorsky; Daniel Ryan,28,0,90,62
1683679331974,MGT 103,A00,202864,Ehrich; Kristine R,0,18,90,90
1683679332999,MGT 112,A00,202865,Ehrich; Kristine R,15,0,90,75
1683679334024,MGT 121A,A00,202868,Staff,90,20,90,0
1683679335048,MGT 131B,A00,202869,Anderson; John Charles,59,0,90,31
1683679336074,MGT 136,A00,202871,Lindenberger; Wade Douglas,83,0,90,7
1683679337097,MGT 164,A00,202873,Staff,0,67,90,91
1683679338122,MGT 164GS,A00,202874,McKay; Mary A,13,0,28,15
1683679339144,MGT 180,A00,202875,Staff,0,51,90,91
1683679340171,MMW 11R,A01,205019,Herbst; Matthew,0,0,30,30
1683679340171,MMW 11R,A02,205026,Herbst; Matthew,29,0,30,1
1683679341198,MMW 15,A01,193512,Chang; Edmond Yi-Teh,0,8,28,28
1683679341198,MMW 15,A02,193513,Chang; Edmond Yi-Teh,0,5,28,28
1683679341198,MMW 15,A03,193514,Chang; Edmond Yi-Teh,0,5,28,28
1683679341198,MMW 15,A04,193515,Chang; Edmond Yi-Teh,0,5,28,28
1683679341198,MMW 15,A05,193516,Chang; Edmond Yi-Teh,0,5,28,28
1683679341198,MMW 15,A06,193517,Chang; Edmond Yi-Teh,0,6,28,28
1683679341198,MMW 15,B01,193519,Chang; Edmond Yi-Teh,0,5,28,28
1683679341198,MMW 15,B02,193520,Chang; Edmond Yi-Teh,0,5,28,28
1683679341198,MMW 15,B03,193521,Chang; Edmond Yi-Teh,0,5,28,28
1683679341198,MMW 15,B04,193522,Chang; Edmond Yi-Teh,0,6,28,28
1683679341198,MMW 15,B05,193523,Chang; Edmond Yi-Teh,0,5,28,28
1683679341198,MMW 15,B06,193524,Chang; Edmond Yi-Teh,0,5,28,28
1683679342225,MMW 122,A01,193526,Rahimi; Babak,0,16,28,28
1683679342225,MMW 122,A02,193527,Rahimi; Babak,0,15,28,28
1683679342225,MMW 122,A03,193528,Rahimi; Babak,0,0,0,0
1683679342225,MMW 122,A04,193529,Rahimi; Babak,0,0,0,0
1683679343252,MUS 1A,A01,186663,Staff,1,19,35,34
1683679344276,MUS 4,A01,186715,Staff,0,12,35,35
1683679345301,MUS 5R,A01,186796,Dubnov; Shlomo,0,17,35,35
1683679346330,MUS 6,A01,186798,Staff,0,5,25,25
1683679347354,MUS 7,A01,186830,Staff,11,0,35,24
1683679348382,MUS 8,A01,186930,Staff,0,27,35,35
1683679349408,MUS 15,A01,186932,Staff,0,15,35,35
1683679349408,MUS 15,B01,186934,Staff,1,17,35,34
1683679350434,MUS 80,A00,186935,Staff,0,0,20,20
1683679350434,MUS 80,B00,186936,Staff,24,0,25,1
1683679351463,NANO 11,A00,204702,Lipomi; Darren John,0,0,0,0
1683679352492,NANO 15,A01,204709,Yang; Kesong,0,1,0,0
1683679353516,NANO 114,A00,202069,Jahed Motlagh; Zeinab,3,0,10,7
1683679354539,PHIL 1,A00,186955,Grush; Rick Scott,31,0,40,9
1683679355564,PHIL 10,A01,186973,Grush; Rick Scott,27,0,35,8
1683679355564,PHIL 10,A02,186974,Grush; Rick Scott,33,0,35,2
1683679356589,PHIL 13,A01,186976,Staff,3,0,35,32
1683679356589,PHIL 13,A02,186977,Staff,16,0,35,19
1683679357617,PHIL 14,A01,186979,Staff,31,0,35,4
1683679357617,PHIL 14,A02,186986,Staff,32,0,35,3
1683679358645,PHIL 28,A01,186988,Staff,16,0,30,14
1683679358645,PHIL 28,A02,186989,Staff,1,0,30,29
1683679358645,PHIL 28,A03,186990,Staff,10,0,30,20
1683679358645,PHIL 28,A04,186991,Staff,26,0,30,4
1683679359672,PHIL 120,A00,186997,Staff,23,0,40,17
1683679360697,PHIL 137,A00,187003,Staff,7,0,40,33
1683679361723,PHIL 150,A00,187015,Staff,47,0,70,23
1683679362749,PHIL 167,A00,187021,Lamey; Andy M.,34,0,40,6
1683679363775,PHIL 174,A01,202226,Staff,17,0,20,3
1683679363775,PHIL 174,A02,202235,Staff,20,0,20,0
1683679364802,PHIL 191A,A00,258918,Staff,0,0,1,1
1683679365826,PHYS 1A,A00,187028,Staff,26,0,60,34
1683679366850,PHYS 1AL,001,187036,Staff,3,0,30,27
1683679366850,PHYS 1AL,002,187049,Staff,18,0,30,12
1683679367873,PHYS 1B,A00,187058,Staff,22,0,60,38
1683679368901,PHYS 1BL,001,187064,Staff,0,1,30,30
1683679368901,PHYS 1BL,002,187070,Staff,4,0,30,26
1683679369924,PHYS 1C,A00,187082,Staff,29,0,120,91
1683679370951,PHYS 1CL,001,187088,Staff,0,9,30,30
1683679370951,PHYS 1CL,002,187089,Staff,0,1,30,30
1683679370951,PHYS 1CL,009,262693,Staff,9,0,30,21
1683679371980,PHYS 2B,A01,187097,Staff,55,0,115,60
1683679373004,PHYS 2C,A01,187099,Staff,63,0,115,52
1683679374028,PHYS 2CL,A01,187101,Staff,5,0,28,23
1683679374028,PHYS 2CL,A02,187102,Staff,15,0,28,13
1683679375052,PHYS 2D,A01,187123,Shotwell; Brian,95,0,115,20
1683679376077,PHYS 4B,A01,187133,Grinstein; Benjamin,35,0,50,15
1683679377100,POLI 10,A00,188819,Staff,0,4,50,50
1683679378126,POLI 11,A00,188827,Staff,43,0,50,7
1683679379151,POLI 13R,A00,188828,Staff,0,1,20,20
1683679380175,POLI 27,A01,188830,Elgin; Samuel Zincke,0,2,70,70
1683679381200,POLI 30,A00,188832,Desposato; Scott,30,0,50,20
1683679382223,POLI 102F,A00,188834,Staff,0,0,40,40
1683679383250,POLI 104A,A00,188852,Staff,12,0,30,18
1683679384277,POLI 104I,A00,188853,Staff,0,8,20,20
1683679385305,POLI 110B,A00,188854,Wiens; David,6,0,20,14
1683679386330,POLI 112A,A00,188855,Wiens; David,3,0,30,27
1683679387354,POLI 117R,A00,188856,Forman; Fonna,0,12,20,20
1683679388379,POLI 118,A00,188857,Ingham; Sean,8,0,20,12
1683679389403,POLI 120G,A00,188858,Staff,8,0,30,22
1683679390427,POLI 131CR,A00,188863,Hoston; Germaine,20,0,50,30
1683679391452,POLI 133,A00,188864,Nellis; Gareth Hb,44,0,50,6
1683679392475,POLI 134D,A00,188865,Desposato; Scott,27,0,30,3
1683679393499,POLI 142A,A00,188871,Gartzke; Erik,21,0,50,29
1683679394524,POLI 142K,A00,188874,Staff,38,0,50,12
1683679395552,POLI 143,A00,188940,Gartzke; Erik,16,0,30,14
1683679396634,POLI 153,A00,188943,Staff,2,0,20,18
1683679397659,POLI 160AA,A00,188944,Staff,10,0,40,30
1683679398687,POLI 170A,A00,188945,Staff,10,0,30,20
1683679400735,PSYC 1,A00,188952,Staff,36,0,90,54
1683679401762,PSYC 2,B00,188953,Staff,19,0,35,16
1683679402788,PSYC 6,A00,188970,Staff,47,0,60,13
1683679403815,PSYC 7,A00,188973,Staff,35,0,45,10
1683679404839,PSYC 60,A01,188980,Rickard; Timothy C.,42,0,60,18
1683679405864,PSYC 70,A01,189001,Steiner; Eric Tomas,21,0,45,24
1683679406887,PSYC 100,A00,189005,Lacefield; Katharine I,0,99,120,120
1683679407912,PSYC 102,A00,189008,Staff,7,0,30,23
1683679408941,PSYC 106,B00,189026,Gorman; Michael R.,27,0,60,33
1683679409966,PSYC 114,B01,189033,Winkielman; Piotr,0,31,30,30
1683679410989,PSYC 131,A00,189036,Anagnostaras; Stephan,0,43,60,60
1683679412015,PSYC 136,A00,189041,Lowe; Angela Beth,0,7,25,25
1683679413040,PSYC 137,A00,189057,Winkielman; Piotr,1,37,25,24
1683679414064,PSYC 144,A00,189107,Wixted; John T,0,11,50,50
1683679416113,PSYC 162,A00,189142,Staff,0,9,85,85
1683679417138,PSYC 172,A00,189144,Gorman; Michael R.,0,6,30,30
1683679419190,PSYC 179,A00,189146,Lacefield; Katharine I,0,87,120,120
1683679420213,PSYC 181,A00,189147,Anagnostaras; Stephan,0,44,90,90
1683679421238,PSYC 190R,A00,189148,Barner; David A.,0,23,80,80
1683679422266,PSYC 191,A00,189275,Rickard; Timothy C.,0,10,25,25
1683679423290,PSYC 193,A00,189276,Chapman; Eddie Nathaniel,0,1,0,4
1683679424315,PSYC 193L,A01,189281,Lowe; Angela Beth,8,0,20,12
1683679424315,PSYC 193L,B01,189285,Staff,28,0,35,7
1683679425339,RELI 149,A00,187137,Rahimi; Babak,7,0,40,33
1683679426363,SE 9,A01,187315,Staff,0,2,18,18
1683679427386,SE 101B,A00,187409,Staff,24,0,30,6
1683679428414,SE 110B,A00,187444,Staff,10,0,40,30
1683679429438,SE 130B,A00,187449,Staff,31,0,40,9
1683679430468,SE 150A,A00,187516,Staff,8,0,20,12
1683679431494,SE 154,A00,187528,Staff,29,0,50,21
1683679432519,SIO 3,A01,258171,Staff,35,0,40,5
1683679433543,SIO 10,A00,187144,Cook; Geoffrey W,1,7,75,74
1683679434567,SIO 45,A00,187152,Cook; Geoffrey W,0,7,100,100
1683679435592,SIO 109R,A00,194486,Staff,0,4,20,20
1683679437640,SIO 187,A01,187233,Kacev; David,12,0,40,28
1683679438665,SOCI 1,A01,258656,Thorpe; Charles Robert,28,0,30,2
1683679438665,SOCI 1,A02,258658,Thorpe; Charles Robert,30,0,30,0
1683679438665,SOCI 1,A03,258661,Thorpe; Charles Robert,25,0,25,0
1683679438665,SOCI 1,A04,258666,Thorpe; Charles Robert,22,0,25,3
1683679438665,SOCI 1,A05,258897,Thorpe; Charles Robert,22,0,25,3
1683679438665,SOCI 1,A06,258898,Thorpe; Charles Robert,25,0,25,0
1683679439693,SOCI 30,A01,258903,Pardo Guerra; Juan Pablo,14,0,30,16
1683679440719,SOCI 102,A00,258904,Staff,9,0,25,16
1683679441742,SOCI 106,A00,258905,Staff,19,0,25,6
1683679442770,SOCI 111,A00,258907,Ribas Norris; Janet Vanesa,26,0,30,4
1683679443793,SOCI 121R,A00,258908,Pardo Guerra; Juan Pablo,8,0,30,22
1683679444820,SOCI 126,A01,203330,Staff,14,0,20,6
1683679445844,SOCI 131,A00,258909,Thorpe; Charles Robert,30,0,60,30
1683679446870,SOCI 135,A00,258910,Payne; Christine Anna,0,12,30,30
1683679447897,SOCI 157,A00,258911,Staff,11,0,30,19
1683679448924,SOCI 184,A00,258912,Staff,25,0,30,5
1683679449950,SOCI 188D,A00,258913,Staff,22,0,30,8
1683679450979,SYN 2,001,187529,Staff,9,0,16,7
1683679450979,SYN 2,002,201452,Staff,1,20,16,15
1683679450979,SYN 2,003,201469,Staff,1,0,16,15
1683679452005,SYN 100,A01,187531,Staff,0,9,20,20
1683679452005,SYN 100,B01,201491,Staff,0,10,20,20
1683679453029,TDAC 1,A00,189286,Walsh; Kim C.,3,0,20,17
1683679453029,TDAC 1,B00,189287,Harting; Carla Kelso,10,0,20,10
1683679454053,TDAC 101,A00,189300,Walsh; Kim C.,16,0,20,4
1683679454053,TDAC 101,B00,189301,Harting; Carla Kelso,18,0,20,2
1683679455080,TDAC 102,A00,189304,Basso; Beatrice,14,0,20,6
1683679456106,TDAC 108,A00,189305,Staff,18,0,20,2
1683679457132,TDDE 131,A00,189310,Staff,19,0,20,1
1683679457132,TDDE 131,B00,189314,Staff,19,0,20,1
1683679457132,TDDE 131,C00,189315,Staff,48,0,50,2
1683679457132,TDDE 131,D00,189316,Staff,14,0,15,1
1683679457132,TDDE 131,E00,204841,Staff,20,0,20,0
1683679458160,TDGE 10,A00,189289,Staff,27,0,50,23
1683679458160,TDGE 10,B00,189290,Havis; Allan,0,1,50,50
1683679459184,TDGE 11,A00,189291,Fulton; Julia,0,4,50,50
1683679459184,TDGE 11,B00,189292,Staff,20,0,25,5
1683679459184,TDGE 11,C00,260270,Staff,0,0,0,0
1683679460211,TDGE 25,A00,189294,Staff,1,0,20,19
1683679461235,TDGE 124,A00,189318,Fulton; Julia,0,8,50,50
1683679462261,TDGE 125,A00,189319,Staff,13,0,25,12
1683679462261,TDGE 125,B00,189320,Staff,23,0,25,2
1683679463286,TDGE 127,A00,189322,Havis; Allan,0,0,50,50
1683679464313,TDHT 101,A00,189323,Staff,18,0,25,7
1683679464313,TDHT 101,B00,189324,Staff,25,0,25,0
1683679465336,TDHT 102,A00,189325,Staff,49,0,50,1
1683679466365,TDMV 1,A00,189295,Arcidiacono; Kristin,20,0,30,10
1683679466365,TDMV 1,B00,189296,Caligagan; Maria T.,24,0,30,6
1683679467392,TDMV 2,A00,189297,Sammartano; Tonnie,27,0,30,3
1683679467392,TDMV 2,B00,189299,Arcidiacono; Kristin,23,0,30,7
1683679468419,TDMV 3,A00,204998,Rincon; Alicia,22,0,30,8
1683679469445,TDMV 120,A00,189458,Sammartano; Tonnie,28,0,30,2
1683679470469,TDMV 138,A00,189541,Jun; Grace Shin Hae,20,0,40,20
1683679471495,TDMV 142,A00,189717,Caligagan; Tony,25,0,30,5
1683679471495,TDMV 142,B00,189718,Caligagan; Maria T.,25,0,30,5
1683679472523,TMC 2,A01,187533,Staff,25,0,25,0
1683679472523,TMC 2,A02,187534,Staff,25,0,25,0
1683679473552,USP 1,A01,187536,Kwak; Nancy,0,16,25,25
1683679474575,USP 5,A01,187538,Staff,8,0,25,17
1683679475599,USP 101,A00,199253,Staff,0,4,0,0
1683679476624,USP 124,A00,187562,Boomhower; Matthew Charles,0,0,30,30
1683679477648,USP 138,A00,187582,Staff,19,0,25,6
1683679478676,USP 152,A01,187597,Staff,3,0,25,22
1683679479701,USP 153,A00,187598,Staff,18,0,25,7
1683679480727,USP 168,A00,187607,Kwak; Nancy,2,0,5,3
1683679481754,USP 173,A00,187619,Staff,4,0,25,21
1683679482778,USP 181,A00,187638,Staff,0,4,25,25
1683679483807,VIS 103,A00,187650,Cruz; Edwin Teddy,17,0,75,58
1683679484831,VIS 110D,A00,187669,Staff,13,0,22,9
1683679485854,VIS 127C,A00,187720,Shen; Kuiyi,67,0,146,79
1683679486878,VIS 149,A00,187731,Yoldas; Pinar,1,14,22,21
1683679487905,VIS 151,A01,188091,Staff,22,0,34,12
1683679487905,VIS 151,A02,188092,Staff,11,0,34,23
1683679488934,VIS 160B,A00,188093,Stalbaum; Brett,0,1,10,10
1683679490984,WCWP 10B,A00,201720,Staff,0,0,5,5
1683679490984,WCWP 10B,B00,201722,Staff,0,0,6,6
1683679492010,WCWP 100,A00,201725,Gagnon; Jeffrey C,0,0,2,2
1683679492010,WCWP 100,B00,201727,Staff,0,4,15,15
1683679495101,ANBI 133,A00,258401,Wilder; Linnea Lorene,34,0,40,6
1683679496125,ANBI 140,A00,258395,Hrvoj Mihic; Branka,18,0,25,7
1683679497150,ANSC 120,A00,258402,Bialecki; Jon Anthony,26,0,40,14
1683679498173,ANSC 144,A00,258400,Staff,12,0,40,28
1683679500277,ANSC 166,A00,258396,Parish; Steven Martin,156,0,175,19
1683679501312,ANSC 180,A00,193533,Staff,8,0,20,12
1683679502337,ANSC 188,A00,258397,Jassal; Aftab,34,0,40,6
1683679503361,ANTH 3,A01,258316,Staff,23,0,30,7
1683679504383,ANTH 5,A00,258394,Semendeferi; Ekaterini,16,0,20,4
1683679505411,ANTH 21,A01,258331,Staff,4,0,40,36
1683679506439,ANTH 103,A00,258398,Varma; Saiba,15,0,25,10
1683679507468,AWP 10,001,202034,Staff,0,0,0,0
1683679507468,AWP 10,002,202035,Staff,0,0,0,0
1683679507468,AWP 10,003,202036,Staff,0,0,0,0
1683679507468,AWP 10,004,202037,Staff,0,0,0,0
1683679507468,AWP 10,005,202038,Staff,0,0,0,0
1683679507468,AWP 10,006,202039,Staff,0,0,0,0
1683679507468,AWP 10,007,202040,Staff,0,0,0,0
1683679507468,AWP 10,008,202041,Staff,0,0,0,0
1683679507468,AWP 10,009,202042,Staff,0,0,0,0
1683679507468,AWP 10,010,202043,Staff,0,0,0,0
1683679507468,AWP 10,011,202044,Staff,0,0,0,0
1683679507468,AWP 10,012,202045,Staff,0,0,0,0
1683679507468,AWP 10,013,202046,Staff,0,0,0,0
1683679507468,AWP 10,014,202047,Staff,0,0,0,0
1683679507468,AWP 10,015,202048,Staff,0,0,0,0
1683679507468,AWP 10,016,202049,Staff,0,0,0,0
1683679507468,AWP 10,017,202050,Staff,0,0,0,0
1683679507468,AWP 10,018,202051,Staff,0,0,0,0
1683679507468,AWP 10,019,202052,Staff,0,0,0,0
1683679507468,AWP 10,020,202053,Staff,0,0,0,0
1683679507468,AWP 10,021,202054,Staff,0,0,0,0
1683679507468,AWP 10,022,202055,Staff,0,0,0,0
1683679507468,AWP 10,023,202056,Staff,0,0,0,0
1683679507468,AWP 10,024,202057,Staff,0,0,0,0
1683679507468,AWP 10,025,202058,Staff,0,0,0,0
1683679507468,AWP 10,026,202059,Staff,0,0,0,0
1683679508494,AWP 102,001,202032,Staff,0,0,0,0
1683679508494,AWP 102,002,202033,Staff,0,0,0,0
1683679509520,BENG 100,A01,254234,Taylor Amos; Alyssa C,31,0,40,9
1683679510544,BENG 196,001,270013,Engler; Adam J.,9999,0,9999,0
1683679511568,BICD 100R,A01,202018,Smith; Laurie,0,7,32,32
1683679511568,BICD 100R,A02,202019,Smith; Laurie,0,3,32,32
1683679511568,BICD 100R,A03,202020,Smith; Laurie,0,1,32,32
1683679511568,BICD 100R,A04,202021,Smith; Laurie,6,0,32,26
1683679511568,BICD 100R,A05,202022,Smith; Laurie,10,0,32,22
1683679512593,BICD 136,A01,193242,Gustafson-Brown; Cindy,0,2,32,32
1683679512593,BICD 136,A02,193244,Gustafson-Brown; Cindy,13,0,32,19
1683679513619,BIEB 102,A01,193249,Butler; Shannon Rhey,1,1,32,31
1683679513619,BIEB 102,A02,193251,Butler; Shannon Rhey,0,0,32,32
1683679513619,BIEB 102,A03,193253,Butler; Shannon Rhey,0,0,32,32
1683679513619,BIEB 102,A04,193255,Butler; Shannon Rhey,13,0,32,19
1683679513619,BIEB 102,A05,193265,Butler; Shannon Rhey,25,0,32,7
1683679513619,BIEB 102,A06,193269,Butler; Shannon Rhey,13,0,32,19
1683679515667,BIEB 150,A01,193274,Staff,0,0,32,32
1683679515667,BIEB 150,A02,193285,Staff,24,0,32,8
1683679516690,BIEB 194,A00,193286,Kurle; Carolyn M.,19,0,32,13
1683679517717,BILD 1,A01,192291,Staff,15,0,32,17
1683679517717,BILD 1,A02,192292,Staff,30,0,32,2
1683679517717,BILD 1,B01,192520,Reuther; Keefe,0,1,0,0
1683679517717,BILD 1,B02,192532,Reuther; Keefe,0,1,0,0
1683679518742,BILD 3,A01,192556,Butler; Shannon Rhey,0,0,32,32
1683679518742,BILD 3,A02,192581,Butler; Shannon Rhey,0,1,32,32
1683679518742,BILD 3,A03,192611,Butler; Shannon Rhey,19,0,32,13
1683679518742,BILD 3,A04,192612,Butler; Shannon Rhey,24,0,32,8
1683679518742,BILD 3,A05,192613,Butler; Shannon Rhey,26,0,32,6
1683679518742,BILD 3,A06,192679,Butler; Shannon Rhey,27,0,32,5
1683679518742,BILD 3,A07,192682,Butler; Shannon Rhey,20,0,32,12
1683679519766,BILD 4,A01,192836,Reuther; Keefe,1,0,24,23
1683679519766,BILD 4,A02,193044,Reuther; Keefe,4,0,24,20
1683679520866,BILD 10,A01,193142,Gustafson-Brown; Cindy,29,0,32,3
1683679520866,BILD 10,A02,193149,Gustafson-Brown; Cindy,31,0,32,1
1683679521890,BIMM 100,A01,193301,Staff,0,6,32,32
1683679521890,BIMM 100,A02,193312,Staff,0,7,32,32
1683679521890,BIMM 100,A03,193323,Staff,0,10,32,32
1683679522916,BIMM 101,A01,193329,McDonnell; Lisa Marie,1,4,24,23
1683679522916,BIMM 101,A02,193339,McDonnell; Lisa Marie,1,4,24,23
1683679522916,BIMM 101,B01,193354,McDonnell; Lisa Marie,0,4,24,24
1683679522916,BIMM 101,B02,193357,McDonnell; Lisa Marie,0,3,24,24
1683679523939,BIMM 110,A01,193377,Tat; John,0,11,32,32
1683679523939,BIMM 110,A02,193378,Tat; John,0,11,32,32
1683679524964,BIMM 120,A01,206116,Staff,0,0,32,32
1683679524964,BIMM 120,A02,206117,Staff,7,0,32,25
1683679524964,BIMM 120,A03,206121,Staff,21,0,32,11
1683679525989,BIPN 100,A01,193393,Park; Ji Young,0,15,32,32
1683679525989,BIPN 100,A02,193402,Park; Ji Young,0,14,32,32
1683679525989,BIPN 100,A03,193413,Park; Ji Young,0,14,32,32
1683679525989,BIPN 100,A04,193414,Park; Ji Young,0,13,32,32
1683679527014,BIPN 102,A01,193429,Staff,0,0,32,32
1683679527014,BIPN 102,A02,193438,Staff,18,0,32,14
1683679528040,BIPN 106,A01,193450,Reyes Gonzalez; Catalina,0,2,40,40
1683679529065,BIPN 134,A01,193465,Cooke; James Edward,0,0,32,32
1683679529065,BIPN 134,A02,193474,Cooke; James Edward,25,0,32,7
1683679529065,BIPN 134,A03,193485,Cooke; James Edward,29,0,32,3
1683679529065,BIPN 134,A04,193486,Cooke; James Edward,20,0,32,12
1683679529065,BIPN 134,A05,193491,Cooke; James Edward,31,0,32,1
1683679529065,BIPN 134,A06,193501,Cooke; James Edward,30,0,32,2
1683679529065,BIPN 134,A07,193510,Cooke; James Edward,29,0,32,3
1683679531115,BISP 194,A00,222522,Staff,14,0,32,18
1683679532141,CAT 124,A01,202407,Staff,19,0,25,6
1683679533169,CAT 125,A00,202408,Marchisotto; Jennifer Anne,2,0,20,18
1683679534192,CAT 125R,A00,202409,Smith; Lauryn Alissa,0,11,20,20
1683679534192,CAT 125R,B00,202410,Morales; Celeste Georgianna,0,11,20,20
1683679534192,CAT 125R,C00,202411,Irwin; Matthew Joseph,0,12,20,20
1683679535220,CENG 15,A01,204712,Yang; Kesong,0,1,0,0
1683679536247,CENG 114,A00,202070,Jahed Motlagh; Zeinab,5,0,20,15
1683679537275,CGS 105,A00,185477,Wesling; Megan E.,24,0,40,16
1683679538299,CGS 106,A00,185494,Staff,11,0,22,11
1683679539323,CGS 108,A00,185495,Staff,14,0,20,6
1683679540347,CGS 114,A00,185496,Staff,13,0,18,5
1683679541374,CGS 119,A00,185501,Staff,15,0,20,5
1683679542399,CGS 120,A00,185511,Staff,12,0,20,8
1683679543427,CHEM 4,A01,184675,Bussey; Thomas J,97,0,100,3
1683679544450,CHEM 6A,A01,184677,Staff,32,0,60,28
1683679545478,CHEM 6B,A01,184679,Staff,63,0,100,37
1683679546506,CHEM 6C,A01,184681,Bussey; Thomas J,0,0,50,50
1683679546506,CHEM 6C,A02,184682,Bussey; Thomas J,32,0,50,18
1683679547530,CHEM 40A,A01,184684,Albizati; Kim F.,33,0,100,67
1683679548556,CHEM 40B,A01,184686,Albizati; Kim F.,0,22,100,100
1683679549584,CHEM 41B,A01,184690,Staff,51,0,100,49
1683679550610,COGS 3,A01,184715,Boyle; Mary E. T.,0,27,40,40
1683679551633,COGS 14B,A01,185172,Staff,0,14,38,38
1683679552657,COGS 18,A01,184736,Staff,14,0,80,66
1683679553684,COGS 100,A01,184932,Staff,0,8,73,73
1683679554711,COGS 101A,A01,184935,Staff,0,40,30,30
1683679555738,COGS 101B,A01,184944,Staff,0,2,30,30
1683679556763,COGS 101C,A01,184946,Staff,0,10,30,30
1683679557788,COGS 102A,A01,184951,Johnson; Christine M.,2,0,40,38
1683679558813,COGS 107B,A01,184953,Mooshagian; Eric Frederick,0,52,40,40
1683679559840,COGS 118B,A01,184959,Gupta; Anjum,0,50,40,40
1683679560866,COGS 153,A00,184961,Staff,0,16,30,30
1683679561893,COGS 177,A00,184962,Staff,0,21,30,30
1683679562918,COGS 187A,A01,184969,Boyle; Mary E. T.,0,19,40,40
1683679563942,COMM 10,A01,185174,Staff,0,5,25,25
1683679563942,COMM 10,A02,185189,Staff,0,2,25,25
1683679563942,COMM 10,A03,269821,Staff,0,1,0,0
1683679564967,COMM 100B,A02,185476,Staff,11,0,25,14
1683679564967,COMM 100B,A03,277340,Staff,25,0,25,0
1683679566023,COMM 100C,A01,185314,Staff,1,0,25,24
1683679566023,COMM 100C,A02,185327,Staff,17,0,25,8
1683679567048,COMM 110M,A00,185349,Staff,0,0,40,40
1683679568073,COMM 113T,A00,185352,Staff,25,0,40,15
1683679569101,COMM 114I,A00,185353,Staff,31,0,40,9
1683679570124,COMM 131,A00,185354,Staff,17,0,30,13
1683679571152,CSE 8A,A50,185358,Cao; Yingjun,0,46,10,10
1683679572178,CSE 8B,A01,185362,Staff,0,48,50,50
1683679573201,CSE 11,A01,185416,Cao; Yingjun,0,91,10,10
1683679574225,CSE 20,A01,185445,Briones; Jor-el Thomas Caparas,3,0,25,22
1683679575250,CSE 21,A01,185447,Staff,9,0,50,41
1683679576277,CSE 101,A01,185451,Staff,0,13,50,50
1683679576277,CSE 101,B01,185453,Jones; Miles E,0,14,50,50
1683679578329,CSE 141,A01,185458,Eldon; John,16,0,100,84
1683679579353,CSE 141L,A01,185461,Eldon; John,8,0,100,92
1683679580382,CSE 142,A01,185463,Staff,34,0,60,26
1683679580382,CSE 142,B01,201355,Staff,0,7,60,60
1683679581409,CSE 142L,A01,185470,Staff,34,0,60,26
1683679581409,CSE 142L,B01,201417,Staff,0,6,60,60
1683679582435,CSE 190,A00,201433,Staff,32,0,49,17
1683679583461,DOC 1,A01,259136,Strom; Megan C.,7,0,15,8
1683679583461,DOC 1,A02,259137,Strom; Megan C.,14,0,15,1
1683679583461,DOC 1,A03,259138,Strom; Megan C.,14,0,15,1
1683679583461,DOC 1,A04,259139,Strom; Megan C.,14,0,15,1
1683679584487,DOC 100D,A00,259140,Pass; Natalye Joann,14,0,25,11
1683679585512,DSGN 1,A01,184749,Rill; Bryan,0,26,30,30
1683679586536,DSGN 100,A01,185168,Staff,0,2,25,25
1683679587560,ECE 5,A01,185626,Morris; Karcher William,0,12,0,0
1683679588583,ECE 101,A01,185628,Staff,14,0,70,56
1683679589608,ECE 107,A01,185635,Baghdadchi; Saharnaz,0,0,20,20
1683679589608,ECE 107,A02,185638,Baghdadchi; Saharnaz,1,0,20,19
1683679590632,ECE 148,A01,185647,Silberman; Jack,0,0,16,16
1683679591655,ECON 1,A01,185537,Crane; Meredith Helen,54,0,70,16
1683679592679,ECON 3,A01,185549,Crane; Meredith Helen,29,0,70,41
1683679593707,ECON 4,A01,203354,Anderson; John Charles,0,5,10,10
1683679594733,ECON 100A,A01,185574,Staff,0,5,40,40
1683679595760,ECON 100B,A01,185576,Staff,0,12,50,50
1683679596784,ECON 100C,A01,185589,Newhouse; Herbert S,30,0,70,40
1683679597809,ECON 105,A00,185608,Vespa; Emanuel Ignacio,19,0,35,16
1683679598833,ECON 109,A01,185610,Shishkin; Denis,9,0,35,26
1683679599856,ECON 110A,A01,185612,Staff,9,0,40,31
1683679600879,ECON 120A,A01,185615,Staff,19,0,40,21
1683679601902,ECON 120C,A01,185617,Sun; Yixiao,0,21,70,70
1683679602927,ECON 144,A00,203346,Squires; Dale E,2,0,35,33
1683679604025,ECON 171,A01,203349,Newhouse; Herbert S,0,1,35,35
1683679605049,ECON 173A,A01,185621,Toda; Alexis Akira,21,0,35,14
1683679606079,EDS 25,A01,202413,Staff,0,1,0,0
1683679606079,EDS 25,A02,202414,Staff,0,1,0,0
1683679606079,EDS 25,A03,202415,Staff,0,0,0,0
1683679606079,EDS 25,A04,202416,Staff,0,1,0,0
1683679606079,EDS 25,A05,202439,Staff,0,0,0,0
1683679606079,EDS 25,A06,202440,Staff,0,0,0,0
1683679606079,EDS 25,B01,202631,Staff,0,0,0,0
1683679606079,EDS 25,B02,202632,Staff,0,0,0,0
1683679606079,EDS 25,B03,202639,Staff,0,0,0,0
1683679606079,EDS 25,B04,202640,Staff,0,0,0,0
1683679606079,EDS 25,B05,202643,Staff,0,0,0,0
1683679606079,EDS 25,B06,202644,Staff,0,0,0,0
1683679607106,EDS 38,A01,202659,Black; Alison Michelle,24,0,25,1
1683679608130,EDS 115,A00,202652,Staff,18,0,30,12
1683679609153,EDS 125,A00,202649,Staff,13,0,30,17
1683679610178,EDS 126,A01,203332,Staff,30,0,30,0
1683679611202,EDS 139,A00,202838,Staff,16,0,25,9
1683679612226,EDS 146,A01,202655,Staff,14,0,25,11
1683679613251,ENG 15,A00,185667,Staff,0,1,0,0
1683679613251,ENG 15,B00,185672,Staff,0,0,0,0
1683679613251,ENG 15,C00,185675,Staff,0,0,0,0
1683679613251,ENG 15,D00,185682,Staff,0,0,0,0
1683679613251,ENG 15,E00,185684,Staff,0,0,0,0
1683679614274,ETHN 103,A00,185710,Staff,0,8,35,35
1683679615297,ETHN 103A,A00,199228,Man; Simeon S,0,0,9,9
1683679616321,ETHN 109,A00,185711,Staff,15,0,35,20
1683679617346,ETHN 142,A00,185726,Staff,0,4,30,30
1683679618372,ETHN 163J,A00,199229,Man; Simeon S,5,0,8,3
1683679619396,ETHN 168,A00,185727,Staff,7,0,10,3
1683679620423,ETHN 182,A00,185728,Staff,0,0,35,35
1683679621447,ETHN 183,A00,185737,Staff,9,0,18,9
1683679622472,GLBH 111,A01,209361,Burgos; Jose L.,0,0,0,0
1683679624523,HIEU 104,A00,185792,Staff,14,0,20,6
1683679625550,HIEU 115,A00,185800,Staff,0,0,20,20
1683679626574,HIEU 128,A00,185801,Staff,0,9,20,20
1683679627597,HIEU 147,A00,185802,Staff,15,0,20,5
1683679628622,HIEU 154,A00,185823,Staff,11,0,20,9
1683679629646,HILA 102,A00,185826,Staff,14,0,20,6
1683679630671,HILD 2C,A01,185778,Staff,0,13,20,20
1683679631698,HILD 7B,A01,185780,Kwak; Nancy,0,17,32,32
1683679631698,HILD 7B,A02,185781,Kwak; Nancy,0,18,32,32
1683679632726,HILD 30,A01,185791,Staff,12,0,20,8
1683679633751,HISC 119,A00,185830,Golan; Tal,0,9,20,20
1683679634775,HITO 156GS,A00,185831,Patterson; Patrick H.,0,0,0,23
1683679635798,HIUS 103,A00,185832,Man; Simeon S,0,4,20,20
1683679636823,HIUS 117,A00,185836,Kwak; Nancy,2,0,20,18
1683679637849,HIUS 125,A00,185840,Man; Simeon S,0,2,23,23
1683679638873,HIUS 149,A00,185845,Staff,1,0,20,19
1683679639899,HUM 3,A01,185882,Zavodny; Tatiana Sophia,0,8,50,50
1683679639899,HUM 3,B01,185899,Caldwell; Michael Alan,0,18,50,50
1683679640922,HUM 3GS,A00,185900,Patterson; Patrick H.,0,0,0,23
1683679641947,HUM 4,A01,185938,Zroka; Amy Liane,28,0,50,22
1683679641947,HUM 4,B01,185956,Watkins; Eric,0,6,50,50
1683679641947,HUM 4,B02,202209,Watkins; Eric,0,5,50,50
1683679641947,HUM 4,B03,202210,Watkins; Eric,0,5,50,50
1683679642976,HUM 5,A01,185958,West; Geoffrey Scott,0,0,50,50
1683679642976,HUM 5,A02,202215,West; Geoffrey Scott,0,0,50,50
1683679644007,INTL 190,A00,185959,Gagnon; Jeffrey C,0,0,0,9
1683679644007,INTL 190,B00,185960,Lettieri; Michael Joseph,0,0,0,2
1683679645035,JAPN 180,A00,254509,Staff,5,0,30,25
1683679646060,LATI 10,A01,202853,Kennemore; Amy Michelle,4,0,35,31
1683679646060,LATI 10,A02,202854,Kennemore; Amy Michelle,3,0,35,32
1683679646060,LATI 10,A03,270054,Kennemore; Amy Michelle,30,0,30,0
1683679647084,LATI 180,A00,202855,Kennemore; Amy Michelle,11,0,20,9
1683679648110,LAWS 101,A00,201767,Golan; Tal,0,7,40,40
1683679649137,LIFR 1C,A00,185961,Staff,6,0,20,14
1683679650161,LIFR 1CX,A00,185962,Staff,7,0,20,13
1683679651186,LIFR 1D,A00,185963,Staff,7,0,20,13
1683679652214,LIFR 1DX,A00,185964,Staff,7,0,20,13
1683679653238,LIGN 101,A01,186039,Staff,43,0,50,7
1683679654265,LIGN 165,A00,186040,Staff,15,0,50,35
1683679655294,LTCS 108,A00,186041,Staff,5,0,10,5
1683679656321,LTCS 119,A00,186042,Staff,15,0,20,5
1683679657347,LTCS 130,A00,186043,Wesling; Megan E.,15,0,25,10
1683679659394,LTEA 138,A00,186119,Staff,14,0,40,26
1683679660422,LTEN 124,A00,186148,Staff,5,0,25,20
1683679661449,LTEN 178,A00,186149,Staff,7,0,15,8
1683679662473,LTEN 181,A00,186150,Blanco; John D,34,0,40,6
1683679663497,LTWL 120,A00,186160,Staff,19,0,25,6
1683679664521,LTWL 165,A00,186161,Staff,22,0,25,3
1683679665545,LTWR 100,A00,186162,Staff,0,5,15,15
1683679666572,LTWR 102,A00,186163,Doller; Ben,5,0,15,10
1683679667599,MAE 8,A01,186412,Staff,0,1,0,0
1683679668623,MAE 30B,A00,186445,Bahadori; Mohammad Yousef,82,0,100,18
1683679669651,MAE 40,A00,186592,Bewley; Thomas R,10,0,50,40
1683679670676,MAE 101B,A00,186593,Bahadori; Mohammad Yousef,80,0,100,20
1683679671700,MAE 105,A00,186594,Bandaru; Prabhakar,10,0,50,40
1683679672725,MAE 107,A00,186599,Pham; Hieu Tan,0,7,120,120
1683679673750,MAE 148,A01,186660,Silberman; Jack,3,0,16,13
1683679674776,MATH 10A,A01,188095,Staff,0,6,35,35
1683679675802,MATH 10B,A01,188097,Bowers; Adam R.,0,12,30,30
1683679675802,MATH 10B,A02,188099,Bowers; Adam R.,0,11,30,30
1683679675802,MATH 10B,B01,188104,Bowers; Adam R.,0,10,30,30
1683679675802,MATH 10B,B02,188106,Bowers; Adam R.,1,9,30,29
1683679676829,MATH 10C,A01,188111,Staff,0,20,30,30
1683679676829,MATH 10C,A02,188127,Staff,0,19,30,30
1683679676829,MATH 10C,A03,188131,Staff,0,19,30,30
1683679676829,MATH 10C,B01,188218,Staff,17,0,30,13
1683679676829,MATH 10C,B02,188244,Staff,13,0,30,17
1683679676829,MATH 10C,B03,188277,Staff,14,0,30,16
1683679677857,MATH 18,A01,188344,Bach; Quang Tran,18,0,30,12
1683679677857,MATH 18,A02,188345,Bach; Quang Tran,11,0,30,19
1683679677857,MATH 18,B01,188353,Bach; Quang Tran,11,0,30,19
1683679677857,MATH 18,B02,188354,Bach; Quang Tran,19,0,30,11
1683679678880,MATH 20A,A01,188374,Staff,11,0,35,24
1683679679907,MATH 20B,A01,188382,Ohm; Ko Woon,7,0,30,23
1683679679907,MATH 20B,A02,188383,Ohm; Ko Woon,22,0,30,8
1683679679907,MATH 20B,B01,188385,Ohm; Ko Woon,7,0,30,23
1683679679907,MATH 20B,B02,188392,Ohm; Ko Woon,22,0,30,8
1683679680931,MATH 20C,A01,188394,Harel; Guershon,10,0,30,20
1683679680931,MATH 20C,A02,188395,Harel; Guershon,13,0,30,17
1683679680931,MATH 20C,B01,188404,Harel; Guershon,5,0,30,25
1683679680931,MATH 20C,B02,188405,Harel; Guershon,18,0,30,12
1683679681961,MATH 20D,A01,188414,Hammock; Frances H,0,1,30,30
1683679681961,MATH 20D,A02,188415,Hammock; Frances H,0,1,30,30
1683679681961,MATH 20D,B01,188447,Hammock; Frances H,0,1,30,30
1683679681961,MATH 20D,B02,188486,Hammock; Frances H,3,0,30,27
1683679682987,MATH 20E,A01,188649,Staff,21,0,30,9
1683679682987,MATH 20E,A02,188650,Staff,20,0,30,10
1683679682987,MATH 20E,A03,188673,Staff,0,0,30,30
1683679684012,MATH 102,A01,188675,Staff,0,39,35,35
1683679685036,MATH 103B,A01,188681,Staff,3,0,35,32
1683679685036,MATH 103B,B01,188692,Staff,5,0,35,30
1683679686061,MATH 109,A01,188695,Salehi Golsefidy; Alireza,24,0,35,11
1683679686061,MATH 109,A02,188696,Salehi Golsefidy; Alireza,25,0,35,10
1683679687085,MATH 120A,A01,188698,Eggers; John Dietrich,7,0,35,28
1683679688110,MATH 142B,A01,188736,Ioana; Adrian,1,1,30,29
1683679688110,MATH 142B,A02,188741,Ioana; Adrian,0,1,30,30
1683679688110,MATH 142B,A03,188743,Ioana; Adrian,0,1,30,30
1683679689138,MATH 168A,A01,188790,Staff,0,11,35,35
1683679690163,MATH 170A,A01,188803,Nie; Jiawang,0,2,35,35
1683679690163,MATH 170A,A02,188811,Nie; Jiawang,0,1,35,35
1683679690163,MATH 170A,A03,188814,Nie; Jiawang,0,0,35,35
1683679690163,MATH 170A,A04,188815,Nie; Jiawang,6,0,35,29
1683679691188,MATH 193B,A01,188817,Staff,0,0,35,35
1683679691188,MATH 193B,A02,188818,Staff,5,0,35,30
1683679692219,MGT 4,A01,202857,Anderson; John Charles,60,0,80,20
1683679693245,MGT 12,A00,202858,Lindenberger; Wade Douglas,40,0,90,50
1683679694270,MGT 18,A00,202859,Staff,74,0,90,16
1683679695296,MGT 18GS,A00,202860,McKay; Michael J,13,0,28,15
1683679696322,MGT 45,A00,202861,Pecore; Joseph P.,9,0,90,81
1683679697351,MGT 100,A00,202863,Yavorsky; Daniel Ryan,28,0,90,62
1683679698379,MGT 103,A00,202864,Ehrich; Kristine R,0,18,90,90
1683679699406,MGT 112,A00,202865,Ehrich; Kristine R,15,0,90,75
1683679700434,MGT 121A,A00,202868,Staff,90,20,90,0
1683679701462,MGT 131B,A00,202869,Anderson; John Charles,59,0,90,31
1683679702489,MGT 136,A00,202871,Lindenberger; Wade Douglas,83,0,90,7
1683679703517,MGT 164,A00,202873,Staff,0,67,90,91
1683679704544,MGT 164GS,A00,202874,McKay; Mary A,13,0,28,15
1683679705571,MGT 180,A00,202875,Staff,0,51,90,91
1683679706596,MMW 11R,A01,205019,Herbst; Matthew,0,0,30,30
1683679706596,MMW 11R,A02,205026,Herbst; Matthew,29,0,30,1
1683679707685,MMW 15,A01,193512,Chang; Edmond Yi-Teh,0,8,28,28
1683679707685,MMW 15,A02,193513,Chang; Edmond Yi-Teh,0,5,28,28
1683679707685,MMW 15,A03,193514,Chang; Edmond Yi-Teh,0,5,28,28
1683679707685,MMW 15,A04,193515,Chang; Edmond Yi-Teh,0,5,28,28
1683679707685,MMW 15,A05,193516,Chang; Edmond Yi-Teh,0,5,28,28
1683679707685,MMW 15,A06,193517,Chang; Edmond Yi-Teh,0,6,28,28
1683679707685,MMW 15,B01,193519,Chang; Edmond Yi-Teh,0,5,28,28
1683679707685,MMW 15,B02,193520,Chang; Edmond Yi-Teh,0,5,28,28
1683679707685,MMW 15,B03,193521,Chang; Edmond Yi-Teh,0,5,28,28
1683679707685,MMW 15,B04,193522,Chang; Edmond Yi-Teh,0,6,28,28
1683679707685,MMW 15,B05,193523,Chang; Edmond Yi-Teh,0,5,28,28
1683679707685,MMW 15,B06,193524,Chang; Edmond Yi-Teh,0,5,28,28
1683679708715,MMW 122,A01,193526,Rahimi; Babak,0,16,28,28
1683679708715,MMW 122,A02,193527,Rahimi; Babak,0,15,28,28
1683679708715,MMW 122,A03,193528,Rahimi; Babak,0,0,0,0
1683679708715,MMW 122,A04,193529,Rahimi; Babak,0,0,0,0
1683679709742,MUS 1A,A01,186663,Staff,1,19,35,34
1683679710766,MUS 4,A01,186715,Staff,0,12,35,35
1683679711790,MUS 5R,A01,186796,Dubnov; Shlomo,0,17,35,35
1683679712814,MUS 6,A01,186798,Staff,0,5,25,25
1683679713838,MUS 7,A01,186830,Staff,11,0,35,24
1683679714863,MUS 8,A01,186930,Staff,0,27,35,35
1683679715891,MUS 15,A01,186932,Staff,0,15,35,35
1683679715891,MUS 15,B01,186934,Staff,1,17,35,34
1683679716917,MUS 80,A00,186935,Staff,0,0,20,20
1683679716917,MUS 80,B00,186936,Staff,24,0,25,1
1683679717945,NANO 11,A00,204702,Lipomi; Darren John,0,0,0,0
1683679718973,NANO 15,A01,204709,Yang; Kesong,0,1,0,0
1683679720002,NANO 114,A00,202069,Jahed Motlagh; Zeinab,3,0,10,7
1683679721029,PHIL 1,A00,186955,Grush; Rick Scott,31,0,40,9
1683679722054,PHIL 10,A01,186973,Grush; Rick Scott,27,0,35,8
1683679722054,PHIL 10,A02,186974,Grush; Rick Scott,33,0,35,2
1683679723079,PHIL 13,A01,186976,Staff,3,0,35,32
1683679723079,PHIL 13,A02,186977,Staff,16,0,35,19
1683679724104,PHIL 14,A01,186979,Staff,31,0,35,4
1683679724104,PHIL 14,A02,186986,Staff,32,0,35,3
1683679725132,PHIL 28,A01,186988,Staff,16,0,30,14
1683679725132,PHIL 28,A02,186989,Staff,1,0,30,29
1683679725132,PHIL 28,A03,186990,Staff,10,0,30,20
1683679725132,PHIL 28,A04,186991,Staff,26,0,30,4
1683679726157,PHIL 120,A00,186997,Staff,23,0,40,17
1683679727180,PHIL 137,A00,187003,Staff,7,0,40,33
1683679728205,PHIL 150,A00,187015,Staff,47,0,70,23
1683679729230,PHIL 167,A00,187021,Lamey; Andy M.,34,0,40,6
1683679730254,PHIL 174,A01,202226,Staff,17,0,20,3
1683679730254,PHIL 174,A02,202235,Staff,20,0,20,0
1683679731277,PHIL 191A,A00,258918,Staff,0,0,1,1
1683679732300,PHYS 1A,A00,187028,Staff,26,0,60,34
1683679733327,PHYS 1AL,001,187036,Staff,3,0,30,27
1683679733327,PHYS 1AL,002,187049,Staff,18,0,30,12
1683679734351,PHYS 1B,A00,187058,Staff,22,0,60,38
1683679735379,PHYS 1BL,001,187064,Staff,0,1,30,30
1683679735379,PHYS 1BL,002,187070,Staff,4,0,30,26
1683679736405,PHYS 1C,A00,187082,Staff,29,0,120,91
1683679737430,PHYS 1CL,001,187088,Staff,0,9,30,30
1683679737430,PHYS 1CL,002,187089,Staff,0,1,30,30
1683679737430,PHYS 1CL,009,262693,Staff,9,0,30,21
1683679738451,PHYS 2B,A01,187097,Staff,55,0,115,60
1683679739475,PHYS 2C,A01,187099,Staff,63,0,115,52
1683679740499,PHYS 2CL,A01,187101,Staff,5,0,28,23
1683679740499,PHYS 2CL,A02,187102,Staff,15,0,28,13
1683679741529,PHYS 2D,A01,187123,Shotwell; Brian,95,0,115,20
1683679742552,PHYS 4B,A01,187133,Grinstein; Benjamin,35,0,50,15
1683679743578,POLI 10,A00,188819,Staff,0,4,50,50
1683679744604,POLI 11,A00,188827,Staff,43,0,50,7
1683679745630,POLI 13R,A00,188828,Staff,0,1,20,20
1683679746657,POLI 27,A01,188830,Elgin; Samuel Zincke,0,2,70,70
1683679747681,POLI 30,A00,188832,Desposato; Scott,30,0,50,20
1683679748705,POLI 102F,A00,188834,Staff,0,0,40,40
1683679749731,POLI 104A,A00,188852,Staff,12,0,30,18
1683679750765,POLI 104I,A00,188853,Staff,0,8,20,20
1683679751791,POLI 110B,A00,188854,Wiens; David,6,0,20,14
1683679752815,POLI 112A,A00,188855,Wiens; David,3,0,30,27
1683679753841,POLI 117R,A00,188856,Forman; Fonna,0,12,20,20
1683679754864,POLI 118,A00,188857,Ingham; Sean,8,0,20,12
1683679755887,POLI 120G,A00,188858,Staff,8,0,30,22
1683679756912,POLI 131CR,A00,188863,Hoston; Germaine,20,0,50,30
1683679757939,POLI 133,A00,188864,Nellis; Gareth Hb,44,0,50,6
1683679758963,POLI 134D,A00,188865,Desposato; Scott,27,0,30,3
1683679759987,POLI 142A,A00,188871,Gartzke; Erik,21,0,50,29
1683679761014,POLI 142K,A00,188874,Staff,38,0,50,12
1683679762040,POLI 143,A00,188940,Gartzke; Erik,16,0,30,14
1683679763067,POLI 153,A00,188943,Staff,2,0,20,18
1683679764096,POLI 160AA,A00,188944,Staff,10,0,40,30
1683679765120,POLI 170A,A00,188945,Staff,10,0,30,20
1683679767170,PSYC 1,A00,188952,Staff,36,0,90,54
1683679768196,PSYC 2,B00,188953,Staff,19,0,35,16
1683679769220,PSYC 6,A00,188970,Staff,47,0,60,13
1683679770245,PSYC 7,A00,188973,Staff,35,0,45,10
1683679771270,PSYC 60,A01,188980,Rickard; Timothy C.,42,0,60,18
1683679772294,PSYC 70,A01,189001,Steiner; Eric Tomas,21,0,45,24
1683679773318,PSYC 100,A00,189005,Lacefield; Katharine I,0,99,120,120
1683679774341,PSYC 102,A00,189008,Staff,7,0,30,23
1683679775365,PSYC 106,B00,189026,Gorman; Michael R.,27,0,60,33
1683679776389,PSYC 114,B01,189033,Winkielman; Piotr,0,31,30,30
1683679777412,PSYC 131,A00,189036,Anagnostaras; Stephan,0,43,60,60
1683679778440,PSYC 136,A00,189041,Lowe; Angela Beth,0,7,25,25
1683679779464,PSYC 137,A00,189057,Winkielman; Piotr,1,37,25,24
1683679780487,PSYC 144,A00,189107,Wixted; John T,0,11,50,50
1683679782536,PSYC 162,A00,189142,Staff,0,9,85,85
1683679783562,PSYC 172,A00,189144,Gorman; Michael R.,0,6,30,30
1683679785614,PSYC 179,A00,189146,Lacefield; Katharine I,0,87,120,120
1683679786639,PSYC 181,A00,189147,Anagnostaras; Stephan,0,44,90,90
1683679787664,PSYC 190R,A00,189148,Barner; David A.,0,23,80,80
1683679788688,PSYC 191,A00,189275,Rickard; Timothy C.,0,10,25,25
1683679789718,PSYC 193,A00,189276,Chapman; Eddie Nathaniel,0,1,0,4
1683679790747,PSYC 193L,A01,189281,Lowe; Angela Beth,8,0,20,12
1683679790747,PSYC 193L,B01,189285,Staff,28,0,35,7
1683679791771,RELI 149,A00,187137,Rahimi; Babak,7,0,40,33
1683679792795,SE 9,A01,187315,Staff,0,2,18,18
1683679793819,SE 101B,A00,187409,Staff,24,0,30,6
1683679794844,SE 110B,A00,187444,Staff,10,0,40,30
1683679795869,SE 130B,A00,187449,Staff,31,0,40,9
1683679796896,SE 150A,A00,187516,Staff,8,0,20,12
1683679797919,SE 154,A00,187528,Staff,29,0,50,21
1683679798944,SIO 3,A01,258171,Staff,35,0,40,5
1683679799973,SIO 10,A00,187144,Cook; Geoffrey W,1,7,75,74
1683679800997,SIO 45,A00,187152,Cook; Geoffrey W,0,7,100,100
1683679802023,SIO 109R,A00,194486,Staff,0,4,20,20
1683679804075,SIO 187,A01,187233,Kacev; David,12,0,40,28
1683679805101,SOCI 1,A01,258656,Thorpe; Charles Robert,28,0,30,2
1683679805101,SOCI 1,A02,258658,Thorpe; Charles Robert,30,0,30,0
1683679805101,SOCI 1,A03,258661,Thorpe; Charles Robert,25,0,25,0
1683679805101,SOCI 1,A04,258666,Thorpe; Charles Robert,22,0,25,3
1683679805101,SOCI 1,A05,258897,Thorpe; Charles Robert,22,0,25,3
1683679805101,SOCI 1,A06,258898,Thorpe; Charles Robert,25,0,25,0
1683679806125,SOCI 30,A01,258903,Pardo Guerra; Juan Pablo,14,0,30,16
1683679807148,SOCI 102,A00,258904,Staff,9,0,25,16
1683679808171,SOCI 106,A00,258905,Staff,19,0,25,6
1683679809195,SOCI 111,A00,258907,Ribas Norris; Janet Vanesa,26,0,30,4
1683679810223,SOCI 121R,A00,258908,Pardo Guerra; Juan Pablo,8,0,30,22
1683679811305,SOCI 126,A01,203330,Staff,14,0,20,6
1683679812331,SOCI 131,A00,258909,Thorpe; Charles Robert,30,0,60,30
1683679813354,SOCI 135,A00,258910,Payne; Christine Anna,0,12,30,30
1683679814381,SOCI 157,A00,258911,Staff,11,0,30,19
1683679815405,SOCI 184,A00,258912,Staff,25,0,30,5
1683679816429,SOCI 188D,A00,258913,Staff,22,0,30,8
1683679817452,SYN 2,001,187529,Staff,9,0,16,7
1683679817452,SYN 2,002,201452,Staff,1,20,16,15
1683679817452,SYN 2,003,201469,Staff,1,0,16,15
1683679818477,SYN 100,A01,187531,Staff,0,9,20,20
1683679818477,SYN 100,B01,201491,Staff,0,10,20,20
1683679819501,TDAC 1,A00,189286,Walsh; Kim C.,3,0,20,17
1683679819501,TDAC 1,B00,189287,Harting; Carla Kelso,10,0,20,10
1683679820527,TDAC 101,A00,189300,Walsh; Kim C.,16,0,20,4
1683679820527,TDAC 101,B00,189301,Harting; Carla Kelso,18,0,20,2
1683679821551,TDAC 102,A00,189304,Basso; Beatrice,14,0,20,6
1683679822577,TDAC 108,A00,189305,Staff,18,0,20,2
1683679823604,TDDE 131,A00,189310,Staff,19,0,20,1
1683679823604,TDDE 131,B00,189314,Staff,19,0,20,1
1683679823604,TDDE 131,C00,189315,Staff,48,0,50,2
1683679823604,TDDE 131,D00,189316,Staff,14,0,15,1
1683679823604,TDDE 131,E00,204841,Staff,20,0,20,0
1683679824631,TDGE 10,A00,189289,Staff,27,0,50,23
1683679824631,TDGE 10,B00,189290,Havis; Allan,0,1,50,50
1683679825659,TDGE 11,A00,189291,Fulton; Julia,0,4,50,50
1683679825659,TDGE 11,B00,189292,Staff,20,0,25,5
1683679825659,TDGE 11,C00,260270,Staff,0,0,0,0
1683679826687,TDGE 25,A00,189294,Staff,1,0,20,19
1683679827712,TDGE 124,A00,189318,Fulton; Julia,0,8,50,50
1683679828736,TDGE 125,A00,189319,Staff,13,0,25,12
1683679828736,TDGE 125,B00,189320,Staff,23,0,25,2
1683679829764,TDGE 127,A00,189322,Havis; Allan,0,0,50,50
1683679830788,TDHT 101,A00,189323,Staff,18,0,25,7
1683679830788,TDHT 101,B00,189324,Staff,25,0,25,0
1683679831815,TDHT 102,A00,189325,Staff,49,0,50,1
1683679832841,TDMV 1,A00,189295,Arcidiacono; Kristin,20,0,30,10
1683679832841,TDMV 1,B00,189296,Caligagan; Maria T.,24,0,30,6
1683679833865,TDMV 2,A00,189297,Sammartano; Tonnie,27,0,30,3
1683679833865,TDMV 2,B00,189299,Arcidiacono; Kristin,23,0,30,7
1683679834893,TDMV 3,A00,204998,Rincon; Alicia,22,0,30,8
1683679835919,TDMV 120,A00,189458,Sammartano; Tonnie,28,0,30,2
1683679836946,TDMV 138,A00,189541,Jun; Grace Shin Hae,20,0,40,20
1683679837973,TDMV 142,A00,189717,Caligagan; Tony,25,0,30,5
1683679837973,TDMV 142,B00,189718,Caligagan; Maria T.,25,0,30,5
1683679839003,TMC 2,A01,187533,Staff,25,0,25,0
1683679839003,TMC 2,A02,187534,Staff,25,0,25,0
1683679840026,USP 1,A01,187536,Kwak; Nancy,0,16,25,25
1683679841050,USP 5,A01,187538,Staff,8,0,25,17
1683679842073,USP 101,A00,199253,Staff,0,4,0,0
1683679843099,USP 124,A00,187562,Boomhower; Matthew Charles,0,0,30,30
1683679844122,USP 138,A00,187582,Staff,19,0,25,6
1683679845144,USP 152,A01,187597,Staff,3,0,25,22
1683679846180,USP 153,A00,187598,Staff,18,0,25,7
1683679847204,USP 168,A00,187607,Kwak; Nancy,2,0,5,3
1683679848231,USP 173,A00,187619,Staff,4,0,25,21
1683679849255,USP 181,A00,187638,Staff,0,4,25,25
1683679850281,VIS 103,A00,187650,Cruz; Edwin Teddy,17,0,75,58
1683679851305,VIS 110D,A00,187669,Staff,13,0,22,9
1683679852333,VIS 127C,A00,187720,Shen; Kuiyi,67,0,146,79
1683679853357,VIS 149,A00,187731,Yoldas; Pinar,1,14,22,21
1683679854385,VIS 151,A01,188091,Staff,22,0,34,12
1683679854385,VIS 151,A02,188092,Staff,11,0,34,23
1683679855409,VIS 160B,A00,188093,Stalbaum; Brett,0,1,10,10
1683679857460,WCWP 10B,A00,201720,Staff,0,0,5,5
1683679857460,WCWP 10B,B00,201722,Staff,0,0,6,6
1683679858487,WCWP 100,A00,201725,Gagnon; Jeffrey C,0,0,2,2
1683679858487,WCWP 100,B00,201727,Staff,0,4,15,15
1683679861580,ANBI 133,A00,258401,Wilder; Linnea Lorene,34,0,40,6
1683679862605,ANBI 140,A00,258395,Hrvoj Mihic; Branka,18,0,25,7
1683679863627,ANSC 120,A00,258402,Bialecki; Jon Anthony,26,0,40,14
1683679864651,ANSC 144,A00,258400,Staff,12,0,40,28
1683679866699,ANSC 166,A00,258396,Parish; Steven Martin,156,0,175,19
1683679867723,ANSC 180,A00,193533,Staff,8,0,20,12
1683679868750,ANSC 188,A00,258397,Jassal; Aftab,34,0,40,6
1683679869777,ANTH 3,A01,258316,Staff,23,0,30,7
1683679870802,ANTH 5,A00,258394,Semendeferi; Ekaterini,16,0,20,4
1683679871827,ANTH 21,A01,258331,Staff,4,0,40,36
1683679872851,ANTH 103,A00,258398,Varma; Saiba,15,0,25,10
1683679873878,AWP 10,001,202034,Staff,0,0,0,0
1683679873878,AWP 10,002,202035,Staff,0,0,0,0
1683679873878,AWP 10,003,202036,Staff,0,0,0,0
1683679873878,AWP 10,004,202037,Staff,0,0,0,0
1683679873878,AWP 10,005,202038,Staff,0,0,0,0
1683679873878,AWP 10,006,202039,Staff,0,0,0,0
1683679873878,AWP 10,007,202040,Staff,0,0,0,0
1683679873878,AWP 10,008,202041,Staff,0,0,0,0
1683679873878,AWP 10,009,202042,Staff,0,0,0,0
1683679873878,AWP 10,010,202043,Staff,0,0,0,0
1683679873878,AWP 10,011,202044,Staff,0,0,0,0
1683679873878,AWP 10,012,202045,Staff,0,0,0,0
1683679873878,AWP 10,013,202046,Staff,0,0,0,0
1683679873878,AWP 10,014,202047,Staff,0,0,0,0
1683679873878,AWP 10,015,202048,Staff,0,0,0,0
1683679873878,AWP 10,016,202049,Staff,0,0,0,0
1683679873878,AWP 10,017,202050,Staff,0,0,0,0
1683679873878,AWP 10,018,202051,Staff,0,0,0,0
1683679873878,AWP 10,019,202052,Staff,0,0,0,0
1683679873878,AWP 10,020,202053,Staff,0,0,0,0
1683679873878,AWP 10,021,202054,Staff,0,0,0,0
1683679873878,AWP 10,022,202055,Staff,0,0,0,0
1683679873878,AWP 10,023,202056,Staff,0,0,0,0
1683679873878,AWP 10,024,202057,Staff,0,0,0,0
1683679873878,AWP 10,025,202058,Staff,0,0,0,0
1683679873878,AWP 10,026,202059,Staff,0,0,0,0
1683679874903,AWP 102,001,202032,Staff,0,0,0,0
1683679874903,AWP 102,002,202033,Staff,0,0,0,0
1683679875927,BENG 100,A01,254234,Taylor Amos; Alyssa C,31,0,40,9
1683679876954,BENG 196,001,270013,Engler; Adam J.,9999,0,9999,0
1683679877979,BICD 100R,A01,202018,Smith; Laurie,0,7,32,32
1683679877979,BICD 100R,A02,202019,Smith; Laurie,0,3,32,32
1683679877979,BICD 100R,A03,202020,Smith; Laurie,0,1,32,32
1683679877979,BICD 100R,A04,202021,Smith; Laurie,6,0,32,26
1683679877979,BICD 100R,A05,202022,Smith; Laurie,10,0,32,22
1683679879003,BICD 136,A01,193242,Gustafson-Brown; Cindy,0,2,32,32
1683679879003,BICD 136,A02,193244,Gustafson-Brown; Cindy,13,0,32,19
1683679880035,BIEB 102,A01,193249,Butler; Shannon Rhey,1,1,32,31
1683679880035,BIEB 102,A02,193251,Butler; Shannon Rhey,0,0,32,32
1683679880035,BIEB 102,A03,193253,Butler; Shannon Rhey,0,0,32,32
1683679880035,BIEB 102,A04,193255,Butler; Shannon Rhey,13,0,32,19
1683679880035,BIEB 102,A05,193265,Butler; Shannon Rhey,25,0,32,7
1683679880035,BIEB 102,A06,193269,Butler; Shannon Rhey,13,0,32,19
1683679882086,BIEB 150,A01,193274,Staff,0,0,32,32
1683679882086,BIEB 150,A02,193285,Staff,24,0,32,8
1683679883113,BIEB 194,A00,193286,Kurle; Carolyn M.,19,0,32,13
1683679884138,BILD 1,A01,192291,Staff,15,0,32,17
1683679884138,BILD 1,A02,192292,Staff,30,0,32,2
1683679884138,BILD 1,B01,192520,Reuther; Keefe,0,1,0,0
1683679884138,BILD 1,B02,192532,Reuther; Keefe,0,1,0,0
1683679885166,BILD 3,A01,192556,Butler; Shannon Rhey,0,0,32,32
1683679885166,BILD 3,A02,192581,Butler; Shannon Rhey,0,1,32,32
1683679885166,BILD 3,A03,192611,Butler; Shannon Rhey,19,0,32,13
1683679885166,BILD 3,A04,192612,Butler; Shannon Rhey,24,0,32,8
1683679885166,BILD 3,A05,192613,Butler; Shannon Rhey,26,0,32,6
1683679885166,BILD 3,A06,192679,Butler; Shannon Rhey,27,0,32,5
1683679885166,BILD 3,A07,192682,Butler; Shannon Rhey,20,0,32,12
1683679886194,BILD 4,A01,192836,Reuther; Keefe,1,0,24,23
1683679886194,BILD 4,A02,193044,Reuther; Keefe,4,0,24,20
1683679887221,BILD 10,A01,193142,Gustafson-Brown; Cindy,29,0,32,3
1683679887221,BILD 10,A02,193149,Gustafson-Brown; Cindy,31,0,32,1
1683679888243,BIMM 100,A01,193301,Staff,0,6,32,32
1683679888243,BIMM 100,A02,193312,Staff,0,7,32,32
1683679888243,BIMM 100,A03,193323,Staff,0,10,32,32
1683679889273,BIMM 101,A01,193329,McDonnell; Lisa Marie,1,4,24,23
1683679889273,BIMM 101,A02,193339,McDonnell; Lisa Marie,1,4,24,23
1683679889273,BIMM 101,B01,193354,McDonnell; Lisa Marie,0,4,24,24
1683679889273,BIMM 101,B02,193357,McDonnell; Lisa Marie,0,3,24,24
1683679890297,BIMM 110,A01,193377,Tat; John,0,11,32,32
1683679890297,BIMM 110,A02,193378,Tat; John,0,11,32,32
1683679891326,BIMM 120,A01,206116,Staff,0,0,32,32
1683679891326,BIMM 120,A02,206117,Staff,7,0,32,25
1683679891326,BIMM 120,A03,206121,Staff,21,0,32,11
1683679892349,BIPN 100,A01,193393,Park; Ji Young,0,15,32,32
1683679892349,BIPN 100,A02,193402,Park; Ji Young,0,14,32,32
1683679892349,BIPN 100,A03,193413,Park; Ji Young,0,14,32,32
1683679892349,BIPN 100,A04,193414,Park; Ji Young,0,13,32,32
1683679893377,BIPN 102,A01,193429,Staff,0,0,32,32
1683679893377,BIPN 102,A02,193438,Staff,18,0,32,14
1683679894405,BIPN 106,A01,193450,Reyes Gonzalez; Catalina,0,2,40,40
1683679895430,BIPN 134,A01,193465,Cooke; James Edward,0,0,32,32
1683679895430,BIPN 134,A02,193474,Cooke; James Edward,25,0,32,7
1683679895430,BIPN 134,A03,193485,Cooke; James Edward,29,0,32,3
1683679895430,BIPN 134,A04,193486,Cooke; James Edward,20,0,32,12
1683679895430,BIPN 134,A05,193491,Cooke; James Edward,31,0,32,1
1683679895430,BIPN 134,A06,193501,Cooke; James Edward,30,0,32,2
1683679895430,BIPN 134,A07,193510,Cooke; James Edward,29,0,32,3
1683679897482,BISP 194,A00,222522,Staff,14,0,32,18
1683679898507,CAT 124,A01,202407,Staff,19,0,25,6
1683679899532,CAT 125,A00,202408,Marchisotto; Jennifer Anne,2,0,20,18
1683679900557,CAT 125R,A00,202409,Smith; Lauryn Alissa,0,11,20,20
1683679900557,CAT 125R,B00,202410,Morales; Celeste Georgianna,0,11,20,20
1683679900557,CAT 125R,C00,202411,Irwin; Matthew Joseph,0,12,20,20
1683679901590,CENG 15,A01,204712,Yang; Kesong,0,1,0,0
1683679902616,CENG 114,A00,202070,Jahed Motlagh; Zeinab,5,0,20,15
1683679903643,CGS 105,A00,185477,Wesling; Megan E.,24,0,40,16
1683679904670,CGS 106,A00,185494,Staff,11,0,22,11
1683679905695,CGS 108,A00,185495,Staff,14,0,20,6
1683679906723,CGS 114,A00,185496,Staff,13,0,18,5
1683679907746,CGS 119,A00,185501,Staff,15,0,20,5
1683679908771,CGS 120,A00,185511,Staff,12,0,20,8
1683679909797,CHEM 4,A01,184675,Bussey; Thomas J,97,0,100,3
1683679910822,CHEM 6A,A01,184677,Staff,32,0,60,28
1683679911848,CHEM 6B,A01,184679,Staff,63,0,100,37
1683679912873,CHEM 6C,A01,184681,Bussey; Thomas J,0,0,50,50
1683679912873,CHEM 6C,A02,184682,Bussey; Thomas J,32,0,50,18
1683679913900,CHEM 40A,A01,184684,Albizati; Kim F.,33,0,100,67
1683679914986,CHEM 40B,A01,184686,Albizati; Kim F.,0,22,100,100
1683679916015,CHEM 41B,A01,184690,Staff,51,0,100,49
1683679917039,COGS 3,A01,184715,Boyle; Mary E. T.,0,27,40,40
1683679918063,COGS 14B,A01,185172,Staff,0,14,38,38
1683679919091,COGS 18,A01,184736,Staff,14,0,80,66
1683679920118,COGS 100,A01,184932,Staff,0,8,73,73
1683679921143,COGS 101A,A01,184935,Staff,0,40,30,30
1683679922167,COGS 101B,A01,184944,Staff,0,2,30,30
1683679923195,COGS 101C,A01,184946,Staff,0,10,30,30
1683679924219,COGS 102A,A01,184951,Johnson; Christine M.,2,0,40,38
1683679925244,COGS 107B,A01,184953,Mooshagian; Eric Frederick,0,52,40,40
1683679926268,COGS 118B,A01,184959,Gupta; Anjum,0,50,40,40
1683679927295,COGS 153,A00,184961,Staff,0,16,30,30
1683679928319,COGS 177,A00,184962,Staff,0,21,30,30
1683679929350,COGS 187A,A01,184969,Boyle; Mary E. T.,0,19,40,40
1683679930374,COMM 10,A01,185174,Staff,0,5,25,25
1683679930374,COMM 10,A02,185189,Staff,0,2,25,25
1683679930374,COMM 10,A03,269821,Staff,0,1,0,0
1683679931402,COMM 100B,A02,185476,Staff,11,0,25,14
1683679931402,COMM 100B,A03,277340,Staff,25,0,25,0
1683679932430,COMM 100C,A01,185314,Staff,1,0,25,24
1683679932430,COMM 100C,A02,185327,Staff,17,0,25,8
1683679933457,COMM 110M,A00,185349,Staff,0,0,40,40
1683679934485,COMM 113T,A00,185352,Staff,25,0,40,15
1683679935510,COMM 114I,A00,185353,Staff,31,0,40,9
1683679936534,COMM 131,A00,185354,Staff,17,0,30,13
1683679937559,CSE 8A,A50,185358,Cao; Yingjun,0,46,10,10
1683679938585,CSE 8B,A01,185362,Staff,0,48,50,50
1683679939610,CSE 11,A01,185416,Cao; Yingjun,0,91,10,10
1683679940638,CSE 20,A01,185445,Briones; Jor-el Thomas Caparas,3,0,25,22
1683679941663,CSE 21,A01,185447,Staff,9,0,50,41
1683679942688,CSE 101,A01,185451,Staff,0,13,50,50
1683679942688,CSE 101,B01,185453,Jones; Miles E,0,14,50,50
1683679944735,CSE 141,A01,185458,Eldon; John,16,0,100,84
1683679945759,CSE 141L,A01,185461,Eldon; John,8,0,100,92
1683679946783,CSE 142,A01,185463,Staff,34,0,60,26
1683679946783,CSE 142,B01,201355,Staff,0,7,60,60
1683679947813,CSE 142L,A01,185470,Staff,34,0,60,26
1683679947813,CSE 142L,B01,201417,Staff,0,6,60,60
1683679948837,CSE 190,A00,201433,Staff,32,0,49,17
1683679949868,DOC 1,A01,259136,Strom; Megan C.,7,0,15,8
1683679949868,DOC 1,A02,259137,Strom; Megan C.,14,0,15,1
1683679949868,DOC 1,A03,259138,Strom; Megan C.,14,0,15,1
1683679949868,DOC 1,A04,259139,Strom; Megan C.,14,0,15,1
1683679950891,DOC 100D,A00,259140,Pass; Natalye Joann,14,0,25,11
1683679951919,DSGN 1,A01,184749,Rill; Bryan,0,26,30,30
1683679952946,DSGN 100,A01,185168,Staff,0,2,25,25
1683679953971,ECE 5,A01,185626,Morris; Karcher William,0,12,0,0
1683679954997,ECE 101,A01,185628,Staff,14,0,70,56
1683679956024,ECE 107,A01,185635,Baghdadchi; Saharnaz,0,0,20,20
1683679956024,ECE 107,A02,185638,Baghdadchi; Saharnaz,1,0,20,19
1683679957048,ECE 148,A01,185647,Silberman; Jack,0,0,16,16
1683679958075,ECON 1,A01,185537,Crane; Meredith Helen,54,0,70,16
1683679959102,ECON 3,A01,185549,Crane; Meredith Helen,30,0,70,40
1683679960125,ECON 4,A01,203354,Anderson; John Charles,0,5,10,10
1683679961149,ECON 100A,A01,185574,Staff,0,5,40,40
1683679962176,ECON 100B,A01,185576,Staff,0,12,50,50
1683679963206,ECON 100C,A01,185589,Newhouse; Herbert S,30,0,70,40
1683679964232,ECON 105,A00,185608,Vespa; Emanuel Ignacio,19,0,35,16
1683679965259,ECON 109,A01,185610,Shishkin; Denis,9,0,35,26
1683679966284,ECON 110A,A01,185612,Staff,9,0,40,31
1683679967308,ECON 120A,A01,185615,Staff,19,0,40,21
1683679968333,ECON 120C,A01,185617,Sun; Yixiao,0,21,70,70
1683679969359,ECON 144,A00,203346,Squires; Dale E,2,0,35,33
1683679970383,ECON 171,A01,203349,Newhouse; Herbert S,0,1,35,35
1683679971409,ECON 173A,A01,185621,Toda; Alexis Akira,21,0,35,14
1683679972439,EDS 25,A01,202413,Staff,0,1,0,0
1683679972439,EDS 25,A02,202414,Staff,0,1,0,0
1683679972439,EDS 25,A03,202415,Staff,0,0,0,0
1683679972439,EDS 25,A04,202416,Staff,0,1,0,0
1683679972439,EDS 25,A05,202439,Staff,0,0,0,0
1683679972439,EDS 25,A06,202440,Staff,0,0,0,0
1683679972439,EDS 25,B01,202631,Staff,0,0,0,0
1683679972439,EDS 25,B02,202632,Staff,0,0,0,0
1683679972439,EDS 25,B03,202639,Staff,0,0,0,0
1683679972439,EDS 25,B04,202640,Staff,0,0,0,0
1683679972439,EDS 25,B05,202643,Staff,0,0,0,0
1683679972439,EDS 25,B06,202644,Staff,0,0,0,0
1683679973461,EDS 38,A01,202659,Black; Alison Michelle,24,0,25,1
1683679974485,EDS 115,A00,202652,Staff,18,0,30,12
1683679975515,EDS 125,A00,202649,Staff,13,0,30,17
1683679976539,EDS 126,A01,203332,Staff,30,0,30,0
1683679977562,EDS 139,A00,202838,Staff,16,0,25,9
1683679978588,EDS 146,A01,202655,Staff,14,0,25,11
1683679979613,ENG 15,A00,185667,Staff,0,1,0,0
1683679979613,ENG 15,B00,185672,Staff,0,0,0,0
1683679979613,ENG 15,C00,185675,Staff,0,0,0,0
1683679979613,ENG 15,D00,185682,Staff,0,0,0,0
1683679979613,ENG 15,E00,185684,Staff,0,0,0,0
1683679980637,ETHN 103,A00,185710,Staff,0,8,35,35
1683679981663,ETHN 103A,A00,199228,Man; Simeon S,0,0,9,9
1683679982689,ETHN 109,A00,185711,Staff,15,0,35,20
1683679983713,ETHN 142,A00,185726,Staff,0,4,30,30
1683679984740,ETHN 163J,A00,199229,Man; Simeon S,5,0,8,3
1683679985764,ETHN 168,A00,185727,Staff,7,0,10,3
1683679986788,ETHN 182,A00,185728,Staff,0,0,35,35
1683679987811,ETHN 183,A00,185737,Staff,9,0,18,9
1683679988835,GLBH 111,A01,209361,Burgos; Jose L.,0,0,0,0
1683679990883,HIEU 104,A00,185792,Staff,14,0,20,6
1683679991908,HIEU 115,A00,185800,Staff,0,0,20,20
1683679992935,HIEU 128,A00,185801,Staff,0,9,20,20
1683679993962,HIEU 147,A00,185802,Staff,15,0,20,5
1683679994988,HIEU 154,A00,185823,Staff,11,0,20,9
1683679996015,HILA 102,A00,185826,Staff,14,0,20,6
1683679997043,HILD 2C,A01,185778,Staff,0,13,20,20
1683679998075,HILD 7B,A01,185780,Kwak; Nancy,0,17,32,32
1683679998075,HILD 7B,A02,185781,Kwak; Nancy,0,18,32,32
1683679999098,HILD 30,A01,185791,Staff,12,0,20,8
1683680000126,HISC 119,A00,185830,Golan; Tal,0,9,20,20
1683680001150,HITO 156GS,A00,185831,Patterson; Patrick H.,0,0,0,23
1683680002174,HIUS 103,A00,185832,Man; Simeon S,0,4,20,20
1683680003202,HIUS 117,A00,185836,Kwak; Nancy,2,0,20,18
1683680004227,HIUS 125,A00,185840,Man; Simeon S,0,2,23,23
1683680005252,HIUS 149,A00,185845,Staff,1,0,20,19
1683680006280,HUM 3,A01,185882,Zavodny; Tatiana Sophia,0,8,50,50
1683680006280,HUM 3,B01,185899,Caldwell; Michael Alan,0,18,50,50
1683680007312,HUM 3GS,A00,185900,Patterson; Patrick H.,0,0,0,23
1683680008337,HUM 4,A01,185938,Zroka; Amy Liane,28,0,50,22
1683680008337,HUM 4,B01,185956,Watkins; Eric,0,6,50,50
1683680008337,HUM 4,B02,202209,Watkins; Eric,0,5,50,50
1683680008337,HUM 4,B03,202210,Watkins; Eric,0,5,50,50
1683680009365,HUM 5,A01,185958,West; Geoffrey Scott,0,0,50,50
1683680009365,HUM 5,A02,202215,West; Geoffrey Scott,0,0,50,50
1683680010388,INTL 190,A00,185959,Gagnon; Jeffrey C,0,0,0,9
1683680010388,INTL 190,B00,185960,Lettieri; Michael Joseph,0,0,0,2
1683680011412,JAPN 180,A00,254509,Staff,5,0,30,25
1683680012437,LATI 10,A01,202853,Kennemore; Amy Michelle,4,0,35,31
1683680012437,LATI 10,A02,202854,Kennemore; Amy Michelle,3,0,35,32
1683680012437,LATI 10,A03,270054,Kennemore; Amy Michelle,30,0,30,0
1683680013461,LATI 180,A00,202855,Kennemore; Amy Michelle,11,0,20,9
1683680014489,LAWS 101,A00,201767,Golan; Tal,0,7,40,40
1683680015514,LIFR 1C,A00,185961,Staff,6,0,20,14
1683680016538,LIFR 1CX,A00,185962,Staff,7,0,20,13
1683680017563,LIFR 1D,A00,185963,Staff,7,0,20,13
1683680018645,LIFR 1DX,A00,185964,Staff,7,0,20,13
1683680019675,LIGN 101,A01,186039,Staff,43,0,50,7
1683680020703,LIGN 165,A00,186040,Staff,15,0,50,35
1683680021728,LTCS 108,A00,186041,Staff,5,0,10,5
1683680022751,LTCS 119,A00,186042,Staff,15,0,20,5
1683680023780,LTCS 130,A00,186043,Wesling; Megan E.,15,0,25,10
1683680025832,LTEA 138,A00,186119,Staff,14,0,40,26
1683680026857,LTEN 124,A00,186148,Staff,5,0,25,20
1683680027881,LTEN 178,A00,186149,Staff,7,0,15,8
1683680028906,LTEN 181,A00,186150,Blanco; John D,34,0,40,6
1683680029931,LTWL 120,A00,186160,Staff,19,0,25,6
1683680030955,LTWL 165,A00,186161,Staff,22,0,25,3
1683680031981,LTWR 100,A00,186162,Staff,0,5,15,15
1683680033004,LTWR 102,A00,186163,Doller; Ben,5,0,15,10
1683680034028,MAE 8,A01,186412,Staff,0,1,0,0
1683680035054,MAE 30B,A00,186445,Bahadori; Mohammad Yousef,82,0,100,18
1683680036079,MAE 40,A00,186592,Bewley; Thomas R,10,0,50,40
1683680037106,MAE 101B,A00,186593,Bahadori; Mohammad Yousef,80,0,100,20
1683680038133,MAE 105,A00,186594,Bandaru; Prabhakar,10,0,50,40
1683680039161,MAE 107,A00,186599,Pham; Hieu Tan,0,7,120,120
1683680040186,MAE 148,A01,186660,Silberman; Jack,3,0,16,13
1683680041212,MATH 10A,A01,188095,Staff,0,6,35,35
1683680042237,MATH 10B,A01,188097,Bowers; Adam R.,0,12,30,30
1683680042237,MATH 10B,A02,188099,Bowers; Adam R.,0,11,30,30
1683680042237,MATH 10B,B01,188104,Bowers; Adam R.,0,10,30,30
1683680042237,MATH 10B,B02,188106,Bowers; Adam R.,1,9,30,29
1683680043263,MATH 10C,A01,188111,Staff,0,20,30,30
1683680043263,MATH 10C,A02,188127,Staff,0,19,30,30
1683680043263,MATH 10C,A03,188131,Staff,0,19,30,30
1683680043263,MATH 10C,B01,188218,Staff,17,0,30,13
1683680043263,MATH 10C,B02,188244,Staff,13,0,30,17
1683680043263,MATH 10C,B03,188277,Staff,14,0,30,16
1683680044294,MATH 18,A01,188344,Bach; Quang Tran,18,0,30,12
1683680044294,MATH 18,A02,188345,Bach; Quang Tran,11,0,30,19
1683680044294,MATH 18,B01,188353,Bach; Quang Tran,11,0,30,19
1683680044294,MATH 18,B02,188354,Bach; Quang Tran,19,0,30,11
1683680045320,MATH 20A,A01,188374,Staff,11,0,35,24
1683680046347,MATH 20B,A01,188382,Ohm; Ko Woon,7,0,30,23
1683680046347,MATH 20B,A02,188383,Ohm; Ko Woon,22,0,30,8
1683680046347,MATH 20B,B01,188385,Ohm; Ko Woon,7,0,30,23
1683680046347,MATH 20B,B02,188392,Ohm; Ko Woon,22,0,30,8
1683680047376,MATH 20C,A01,188394,Harel; Guershon,10,0,30,20
1683680047376,MATH 20C,A02,188395,Harel; Guershon,13,0,30,17
1683680047376,MATH 20C,B01,188404,Harel; Guershon,5,0,30,25
1683680047376,MATH 20C,B02,188405,Harel; Guershon,18,0,30,12
1683680048407,MATH 20D,A01,188414,Hammock; Frances H,0,1,30,30
1683680048407,MATH 20D,A02,188415,Hammock; Frances H,0,1,30,30
1683680048407,MATH 20D,B01,188447,Hammock; Frances H,0,1,30,30
1683680048407,MATH 20D,B02,188486,Hammock; Frances H,3,0,30,27
1683680049433,MATH 20E,A01,188649,Staff,21,0,30,9
1683680049433,MATH 20E,A02,188650,Staff,20,0,30,10
1683680049433,MATH 20E,A03,188673,Staff,0,0,30,30
1683680050457,MATH 102,A01,188675,Staff,0,39,35,35
1683680051482,MATH 103B,A01,188681,Staff,3,0,35,32
1683680051482,MATH 103B,B01,188692,Staff,5,0,35,30
1683680052505,MATH 109,A01,188695,Salehi Golsefidy; Alireza,24,0,35,11
1683680052505,MATH 109,A02,188696,Salehi Golsefidy; Alireza,25,0,35,10
1683680053534,MATH 120A,A01,188698,Eggers; John Dietrich,7,0,35,28
1683680054559,MATH 142B,A01,188736,Ioana; Adrian,1,1,30,29
1683680054559,MATH 142B,A02,188741,Ioana; Adrian,0,1,30,30
1683680054559,MATH 142B,A03,188743,Ioana; Adrian,0,1,30,30
1683680055583,MATH 168A,A01,188790,Staff,0,11,35,35
1683680056613,MATH 170A,A01,188803,Nie; Jiawang,0,2,35,35
1683680056613,MATH 170A,A02,188811,Nie; Jiawang,0,1,35,35
1683680056613,MATH 170A,A03,188814,Nie; Jiawang,0,0,35,35
1683680056613,MATH 170A,A04,188815,Nie; Jiawang,6,0,35,29
1683680057640,MATH 193B,A01,188817,Staff,0,0,35,35
1683680057640,MATH 193B,A02,188818,Staff,5,0,35,30
1683680058663,MGT 4,A01,202857,Anderson; John Charles,60,0,80,20
1683680059689,MGT 12,A00,202858,Lindenberger; Wade Douglas,40,0,90,50
1683680060715,MGT 18,A00,202859,Staff,74,0,90,16
1683680061741,MGT 18GS,A00,202860,McKay; Michael J,13,0,28,15
1683680062765,MGT 45,A00,202861,Pecore; Joseph P.,9,0,90,81
1683680063789,MGT 100,A00,202863,Yavorsky; Daniel Ryan,28,0,90,62
1683680064815,MGT 103,A00,202864,Ehrich; Kristine R,0,18,90,90
1683680065840,MGT 112,A00,202865,Ehrich; Kristine R,15,0,90,75
1683680066865,MGT 121A,A00,202868,Staff,90,20,90,0
1683680067889,MGT 131B,A00,202869,Anderson; John Charles,59,0,90,31
1683680068913,MGT 136,A00,202871,Lindenberger; Wade Douglas,83,0,90,7
1683680069937,MGT 164,A00,202873,Staff,0,67,90,91
1683680070963,MGT 164GS,A00,202874,McKay; Mary A,13,0,28,15
1683680071986,MGT 180,A00,202875,Staff,0,51,90,91
1683680073013,MMW 11R,A01,205019,Herbst; Matthew,0,0,30,30
1683680073013,MMW 11R,A02,205026,Herbst; Matthew,29,0,30,1
1683680074042,MMW 15,A01,193512,Chang; Edmond Yi-Teh,0,8,28,28
1683680074042,MMW 15,A02,193513,Chang; Edmond Yi-Teh,0,5,28,28
1683680074042,MMW 15,A03,193514,Chang; Edmond Yi-Teh,0,5,28,28
1683680074042,MMW 15,A04,193515,Chang; Edmond Yi-Teh,0,5,28,28
1683680074042,MMW 15,A05,193516,Chang; Edmond Yi-Teh,0,5,28,28
1683680074042,MMW 15,A06,193517,Chang; Edmond Yi-Teh,0,6,28,28
1683680074042,MMW 15,B01,193519,Chang; Edmond Yi-Teh,0,5,28,28
1683680074042,MMW 15,B02,193520,Chang; Edmond Yi-Teh,0,5,28,28
1683680074042,MMW 15,B03,193521,Chang; Edmond Yi-Teh,0,5,28,28
1683680074042,MMW 15,B04,193522,Chang; Edmond Yi-Teh,0,6,28,28
1683680074042,MMW 15,B05,193523,Chang; Edmond Yi-Teh,0,5,28,28
1683680074042,MMW 15,B06,193524,Chang; Edmond Yi-Teh,0,5,28,28
1683680075066,MMW 122,A01,193526,Rahimi; Babak,0,16,28,28
1683680075066,MMW 122,A02,193527,Rahimi; Babak,0,15,28,28
1683680075066,MMW 122,A03,193528,Rahimi; Babak,0,0,0,0
1683680075066,MMW 122,A04,193529,Rahimi; Babak,0,0,0,0
1683680076093,MUS 1A,A01,186663,Staff,1,19,35,34
1683680077121,MUS 4,A01,186715,Staff,0,12,35,35
1683680078144,MUS 5R,A01,186796,Dubnov; Shlomo,0,17,35,35
1683680079169,MUS 6,A01,186798,Staff,1,5,25,24
1683680080194,MUS 7,A01,186830,Staff,11,0,35,24
1683680081221,MUS 8,A01,186930,Staff,0,27,35,35
1683680082245,MUS 15,A01,186932,Staff,0,15,35,35
1683680082245,MUS 15,B01,186934,Staff,1,17,35,34
1683680083269,MUS 80,A00,186935,Staff,0,0,20,20
1683680083269,MUS 80,B00,186936,Staff,24,0,25,1
1683680084296,NANO 11,A00,204702,Lipomi; Darren John,0,0,0,0
1683680085319,NANO 15,A01,204709,Yang; Kesong,0,1,0,0
1683680086346,NANO 114,A00,202069,Jahed Motlagh; Zeinab,3,0,10,7
1683680087369,PHIL 1,A00,186955,Grush; Rick Scott,31,0,40,9
1683680088398,PHIL 10,A01,186973,Grush; Rick Scott,27,0,35,8
1683680088398,PHIL 10,A02,186974,Grush; Rick Scott,33,0,35,2
1683680089425,PHIL 13,A01,186976,Staff,2,0,35,33
1683680089425,PHIL 13,A02,186977,Staff,16,0,35,19
1683680090451,PHIL 14,A01,186979,Staff,31,0,35,4
1683680090451,PHIL 14,A02,186986,Staff,32,0,35,3
1683680091475,PHIL 28,A01,186988,Staff,16,0,30,14
1683680091475,PHIL 28,A02,186989,Staff,1,0,30,29
1683680091475,PHIL 28,A03,186990,Staff,10,0,30,20
1683680091475,PHIL 28,A04,186991,Staff,26,0,30,4
1683680092498,PHIL 120,A00,186997,Staff,23,0,40,17
1683680093522,PHIL 137,A00,187003,Staff,7,0,40,33
1683680094545,PHIL 150,A00,187015,Staff,47,0,70,23
1683680095572,PHIL 167,A00,187021,Lamey; Andy M.,34,0,40,6
1683680096600,PHIL 174,A01,202226,Staff,17,0,20,3
1683680096600,PHIL 174,A02,202235,Staff,20,0,20,0
1683680097625,PHIL 191A,A00,258918,Staff,0,0,1,1
1683680098652,PHYS 1A,A00,187028,Staff,26,0,60,34
1683680099676,PHYS 1AL,001,187036,Staff,3,0,30,27
1683680099676,PHYS 1AL,002,187049,Staff,18,0,30,12
1683680100704,PHYS 1B,A00,187058,Staff,22,0,60,38
1683680101733,PHYS 1BL,001,187064,Staff,0,1,30,30
1683680101733,PHYS 1BL,002,187070,Staff,4,0,30,26
1683680102756,PHYS 1C,A00,187082,Staff,29,0,120,91
1683680103784,PHYS 1CL,001,187088,Staff,0,9,30,30
1683680103784,PHYS 1CL,002,187089,Staff,0,1,30,30
1683680103784,PHYS 1CL,009,262693,Staff,9,0,30,21
1683680104809,PHYS 2B,A01,187097,Staff,55,0,115,60
1683680105833,PHYS 2C,A01,187099,Staff,63,0,115,52
1683680106862,PHYS 2CL,A01,187101,Staff,5,0,28,23
1683680106862,PHYS 2CL,A02,187102,Staff,15,0,28,13
1683680107889,PHYS 2D,A01,187123,Shotwell; Brian,95,0,115,20
1683680108917,PHYS 4B,A01,187133,Grinstein; Benjamin,35,0,50,15
1683680109941,POLI 10,A00,188819,Staff,0,4,50,50
1683680110966,POLI 11,A00,188827,Staff,43,0,50,7
1683680111991,POLI 13R,A00,188828,Staff,0,1,20,20
1683680113017,POLI 27,A01,188830,Elgin; Samuel Zincke,0,2,70,70
1683680114040,POLI 30,A00,188832,Desposato; Scott,30,0,50,20
1683680115067,POLI 102F,A00,188834,Staff,0,0,40,40
1683680116090,POLI 104A,A00,188852,Staff,12,0,30,18
1683680117117,POLI 104I,A00,188853,Staff,0,8,20,20
1683680118144,POLI 110B,A00,188854,Wiens; David,6,0,20,14
1683680119171,POLI 112A,A00,188855,Wiens; David,3,0,30,27
1683680120195,POLI 117R,A00,188856,Forman; Fonna,0,12,20,20
1683680121223,POLI 118,A00,188857,Ingham; Sean,8,0,20,12
1683680122318,POLI 120G,A00,188858,Staff,8,0,30,22
1683680123342,POLI 131CR,A00,188863,Hoston; Germaine,20,0,50,30
1683680124369,POLI 133,A00,188864,Nellis; Gareth Hb,44,0,50,6
1683680125396,POLI 134D,A00,188865,Desposato; Scott,27,0,30,3
1683680126422,POLI 142A,A00,188871,Gartzke; Erik,21,0,50,29
1683680127445,POLI 142K,A00,188874,Staff,38,0,50,12
1683680128471,POLI 143,A00,188940,Gartzke; Erik,16,0,30,14
1683680129495,POLI 153,A00,188943,Staff,2,0,20,18
1683680130518,POLI 160AA,A00,188944,Staff,10,0,40,30
1683680131543,POLI 170A,A00,188945,Staff,10,0,30,20
1683680133593,PSYC 1,A00,188952,Staff,36,0,90,54
1683680134617,PSYC 2,B00,188953,Staff,19,0,35,16
1683680135642,PSYC 6,A00,188970,Staff,47,0,60,13
1683680136667,PSYC 7,A00,188973,Staff,35,0,45,10
1683680137694,PSYC 60,A01,188980,Rickard; Timothy C.,42,0,60,18
1683680138717,PSYC 70,A01,189001,Steiner; Eric Tomas,21,0,45,24
1683680139741,PSYC 100,A00,189005,Lacefield; Katharine I,0,99,120,120
1683680140765,PSYC 102,A00,189008,Staff,7,0,30,23
1683680141791,PSYC 106,B00,189026,Gorman; Michael R.,27,0,60,33
1683680142815,PSYC 114,B01,189033,Winkielman; Piotr,0,31,30,30
1683680143838,PSYC 131,A00,189036,Anagnostaras; Stephan,0,43,60,60
1683680144862,PSYC 136,A00,189041,Lowe; Angela Beth,0,7,25,25
1683680145889,PSYC 137,A00,189057,Winkielman; Piotr,1,37,25,24
1683680146914,PSYC 144,A00,189107,Wixted; John T,0,11,50,50
1683680148964,PSYC 162,A00,189142,Staff,0,9,85,85
1683680149989,PSYC 172,A00,189144,Gorman; Michael R.,0,6,30,30
1683680152041,PSYC 179,A00,189146,Lacefield; Katharine I,0,87,120,120
1683680153066,PSYC 181,A00,189147,Anagnostaras; Stephan,0,44,90,90
1683680154100,PSYC 190R,A00,189148,Barner; David A.,0,23,80,80
1683680155124,PSYC 191,A00,189275,Rickard; Timothy C.,0,10,25,25
1683680156149,PSYC 193,A00,189276,Chapman; Eddie Nathaniel,0,1,0,4
1683680157176,PSYC 193L,A01,189281,Lowe; Angela Beth,8,0,20,12
1683680157176,PSYC 193L,B01,189285,Staff,28,0,35,7
1683680158201,RELI 149,A00,187137,Rahimi; Babak,7,0,40,33
1683680159229,SE 9,A01,187315,Staff,0,2,18,18
1683680160257,SE 101B,A00,187409,Staff,24,0,30,6
1683680161284,SE 110B,A00,187444,Staff,10,0,40,30
1683680162309,SE 130B,A00,187449,Staff,31,0,40,9
1683680163334,SE 150A,A00,187516,Staff,8,0,20,12
1683680164358,SE 154,A00,187528,Staff,29,0,50,21
1683680165385,SIO 3,A01,258171,Staff,35,0,40,5
1683680166408,SIO 10,A00,187144,Cook; Geoffrey W,1,7,75,74
1683680167433,SIO 45,A00,187152,Cook; Geoffrey W,0,7,100,100
1683680168463,SIO 109R,A00,194486,Staff,0,4,20,20
1683680170510,SIO 187,A01,187233,Kacev; David,12,0,40,28
1683680171538,SOCI 1,A01,258656,Thorpe; Charles Robert,28,0,30,2
1683680171538,SOCI 1,A02,258658,Thorpe; Charles Robert,30,0,30,0
1683680171538,SOCI 1,A03,258661,Thorpe; Charles Robert,25,0,25,0
1683680171538,SOCI 1,A04,258666,Thorpe; Charles Robert,22,0,25,3
1683680171538,SOCI 1,A05,258897,Thorpe; Charles Robert,22,0,25,3
1683680171538,SOCI 1,A06,258898,Thorpe; Charles Robert,25,0,25,0
1683680172566,SOCI 30,A01,258903,Pardo Guerra; Juan Pablo,14,0,30,16
1683680173594,SOCI 102,A00,258904,Staff,9,0,25,16
1683680174620,SOCI 106,A00,258905,Staff,19,0,25,6
1683680175644,SOCI 111,A00,258907,Ribas Norris; Janet Vanesa,26,0,30,4
1683680176668,SOCI 121R,A00,258908,Pardo Guerra; Juan Pablo,8,0,30,22
1683680177693,SOCI 126,A01,203330,Staff,14,0,20,6
1683680178718,SOCI 131,A00,258909,Thorpe; Charles Robert,30,0,60,30
1683680179745,SOCI 135,A00,258910,Payne; Christine Anna,0,12,30,30
1683680180772,SOCI 157,A00,258911,Staff,11,0,30,19
1683680181798,SOCI 184,A00,258912,Staff,25,0,30,5
1683680182823,SOCI 188D,A00,258913,Staff,22,0,30,8
1683680183848,SYN 2,001,187529,Staff,9,0,16,7
1683680183848,SYN 2,002,201452,Staff,1,20,16,15
1683680183848,SYN 2,003,201469,Staff,1,0,16,15
1683680184873,SYN 100,A01,187531,Staff,0,9,20,20
1683680184873,SYN 100,B01,201491,Staff,0,10,20,20
1683680185906,TDAC 1,A00,189286,Walsh; Kim C.,3,0,20,17
1683680185906,TDAC 1,B00,189287,Harting; Carla Kelso,10,0,20,10
1683680186934,TDAC 101,A00,189300,Walsh; Kim C.,16,0,20,4
1683680186934,TDAC 101,B00,189301,Harting; Carla Kelso,18,0,20,2
1683680187958,TDAC 102,A00,189304,Basso; Beatrice,14,0,20,6
1683680188982,TDAC 108,A00,189305,Staff,18,0,20,2
1683680190013,TDDE 131,A00,189310,Staff,19,0,20,1
1683680190013,TDDE 131,B00,189314,Staff,19,0,20,1
1683680190013,TDDE 131,C00,189315,Staff,48,0,50,2
1683680190013,TDDE 131,D00,189316,Staff,14,0,15,1
1683680190013,TDDE 131,E00,204841,Staff,20,0,20,0
1683680191037,TDGE 10,A00,189289,Staff,27,0,50,23
1683680191037,TDGE 10,B00,189290,Havis; Allan,0,1,50,50
1683680192067,TDGE 11,A00,189291,Fulton; Julia,0,4,50,50
1683680192067,TDGE 11,B00,189292,Staff,20,0,25,5
1683680192067,TDGE 11,C00,260270,Staff,0,0,0,0
1683680193093,TDGE 25,A00,189294,Staff,1,0,20,19
1683680194117,TDGE 124,A00,189318,Fulton; Julia,0,8,50,50
1683680195144,TDGE 125,A00,189319,Staff,13,0,25,12
1683680195144,TDGE 125,B00,189320,Staff,23,0,25,2
1683680196170,TDGE 127,A00,189322,Havis; Allan,0,0,50,50
1683680197194,TDHT 101,A00,189323,Staff,18,0,25,7
1683680197194,TDHT 101,B00,189324,Staff,25,0,25,0
1683680198218,TDHT 102,A00,189325,Staff,49,0,50,1
1683680199247,TDMV 1,A00,189295,Arcidiacono; Kristin,20,0,30,10
1683680199247,TDMV 1,B00,189296,Caligagan; Maria T.,24,0,30,6
1683680200274,TDMV 2,A00,189297,Sammartano; Tonnie,27,0,30,3
1683680200274,TDMV 2,B00,189299,Arcidiacono; Kristin,23,0,30,7
1683680201300,TDMV 3,A00,204998,Rincon; Alicia,22,0,30,8
1683680202329,TDMV 120,A00,189458,Sammartano; Tonnie,28,0,30,2
1683680203355,TDMV 138,A00,189541,Jun; Grace Shin Hae,20,0,40,20
1683680204379,TDMV 142,A00,189717,Caligagan; Tony,25,0,30,5
1683680204379,TDMV 142,B00,189718,Caligagan; Maria T.,25,0,30,5
1683680205407,TMC 2,A01,187533,Staff,25,0,25,0
1683680205407,TMC 2,A02,187534,Staff,25,0,25,0
1683680206430,USP 1,A01,187536,Kwak; Nancy,0,16,25,25
1683680207454,USP 5,A01,187538,Staff,8,0,25,17
1683680208481,USP 101,A00,199253,Staff,0,4,0,0
1683680209509,USP 124,A00,187562,Boomhower; Matthew Charles,0,0,30,30
1683680210533,USP 138,A00,187582,Staff,19,0,25,6
1683680211558,USP 152,A01,187597,Staff,3,0,25,22
1683680212585,USP 153,A00,187598,Staff,18,0,25,7
1683680213611,USP 168,A00,187607,Kwak; Nancy,2,0,5,3
1683680214634,USP 173,A00,187619,Staff,4,0,25,21
1683680215661,USP 181,A00,187638,Staff,0,4,25,25
1683680216685,VIS 103,A00,187650,Cruz; Edwin Teddy,17,0,75,58
1683680217712,VIS 110D,A00,187669,Staff,13,0,22,9
1683680218735,VIS 127C,A00,187720,Shen; Kuiyi,67,0,146,79
1683680219763,VIS 149,A00,187731,Yoldas; Pinar,1,14,22,21
1683680220786,VIS 151,A01,188091,Staff,22,0,34,12
1683680220786,VIS 151,A02,188092,Staff,11,0,34,23
1683680221810,VIS 160B,A00,188093,Stalbaum; Brett,0,1,10,10
1683680223856,WCWP 10B,A00,201720,Staff,0,0,5,5
1683680223856,WCWP 10B,B00,201722,Staff,0,0,6,6
1683680224883,WCWP 100,A00,201725,Gagnon; Jeffrey C,0,0,2,2
1683680224883,WCWP 100,B00,201727,Staff,0,4,15,15
1683680228062,ANBI 133,A00,258401,Wilder; Linnea Lorene,34,0,40,6
1683680229087,ANBI 140,A00,258395,Hrvoj Mihic; Branka,18,0,25,7
1683680230117,ANSC 120,A00,258402,Bialecki; Jon Anthony,26,0,40,14
1683680231143,ANSC 144,A00,258400,Staff,12,0,40,28
1683680233197,ANSC 166,A00,258396,Parish; Steven Martin,156,0,175,19
1683680234222,ANSC 180,A00,193533,Staff,8,0,20,12
1683680235247,ANSC 188,A00,258397,Jassal; Aftab,34,0,40,6
1683680236273,ANTH 3,A01,258316,Staff,23,0,30,7
1683680237300,ANTH 5,A00,258394,Semendeferi; Ekaterini,16,0,20,4
1683680238328,ANTH 21,A01,258331,Staff,4,0,40,36
1683680239354,ANTH 103,A00,258398,Varma; Saiba,15,0,25,10
1683680240387,AWP 10,001,202034,Staff,0,0,0,0
1683680240387,AWP 10,002,202035,Staff,0,0,0,0
1683680240387,AWP 10,003,202036,Staff,0,0,0,0
1683680240387,AWP 10,004,202037,Staff,0,0,0,0
1683680240387,AWP 10,005,202038,Staff,0,0,0,0
1683680240387,AWP 10,006,202039,Staff,0,0,0,0
1683680240387,AWP 10,007,202040,Staff,0,0,0,0
1683680240387,AWP 10,008,202041,Staff,0,0,0,0
1683680240387,AWP 10,009,202042,Staff,0,0,0,0
1683680240387,AWP 10,010,202043,Staff,0,0,0,0
1683680240387,AWP 10,011,202044,Staff,0,0,0,0
1683680240387,AWP 10,012,202045,Staff,0,0,0,0
1683680240387,AWP 10,013,202046,Staff,0,0,0,0
1683680240387,AWP 10,014,202047,Staff,0,0,0,0
1683680240387,AWP 10,015,202048,Staff,0,0,0,0
1683680240387,AWP 10,016,202049,Staff,0,0,0,0
1683680240387,AWP 10,017,202050,Staff,0,0,0,0
1683680240387,AWP 10,018,202051,Staff,0,0,0,0
1683680240387,AWP 10,019,202052,Staff,0,0,0,0
1683680240387,AWP 10,020,202053,Staff,0,0,0,0
1683680240387,AWP 10,021,202054,Staff,0,0,0,0
1683680240387,AWP 10,022,202055,Staff,0,0,0,0
1683680240387,AWP 10,023,202056,Staff,0,0,0,0
1683680240387,AWP 10,024,202057,Staff,0,0,0,0
1683680240387,AWP 10,025,202058,Staff,0,0,0,0
1683680240387,AWP 10,026,202059,Staff,0,0,0,0
1683680241414,AWP 102,001,202032,Staff,0,0,0,0
1683680241414,AWP 102,002,202033,Staff,0,0,0,0
1683680242438,BENG 100,A01,254234,Taylor Amos; Alyssa C,31,0,40,9
1683680243468,BENG 196,001,270013,Engler; Adam J.,9999,0,9999,0
1683680244496,BICD 100R,A01,202018,Smith; Laurie,0,7,32,32
1683680244496,BICD 100R,A02,202019,Smith; Laurie,0,3,32,32
1683680244496,BICD 100R,A03,202020,Smith; Laurie,0,1,32,32
1683680244496,BICD 100R,A04,202021,Smith; Laurie,6,0,32,26
1683680244496,BICD 100R,A05,202022,Smith; Laurie,10,0,32,22
1683680245524,BICD 136,A01,193242,Gustafson-Brown; Cindy,0,2,32,32
1683680245524,BICD 136,A02,193244,Gustafson-Brown; Cindy,13,0,32,19
1683680246551,BIEB 102,A01,193249,Butler; Shannon Rhey,1,1,32,31
1683680246551,BIEB 102,A02,193251,Butler; Shannon Rhey,0,0,32,32
1683680246551,BIEB 102,A03,193253,Butler; Shannon Rhey,0,0,32,32
1683680246551,BIEB 102,A04,193255,Butler; Shannon Rhey,13,0,32,19
1683680246551,BIEB 102,A05,193265,Butler; Shannon Rhey,25,0,32,7
1683680246551,BIEB 102,A06,193269,Butler; Shannon Rhey,13,0,32,19
1683680248603,BIEB 150,A01,193274,Staff,0,0,32,32
1683680248603,BIEB 150,A02,193285,Staff,24,0,32,8
1683680249629,BIEB 194,A00,193286,Kurle; Carolyn M.,19,0,32,13
1683680250658,BILD 1,A01,192291,Staff,15,0,32,17
1683680250658,BILD 1,A02,192292,Staff,30,0,32,2
1683680250658,BILD 1,B01,192520,Reuther; Keefe,0,1,0,0
1683680250658,BILD 1,B02,192532,Reuther; Keefe,0,1,0,0
1683680251685,BILD 3,A01,192556,Butler; Shannon Rhey,0,0,32,32
1683680251685,BILD 3,A02,192581,Butler; Shannon Rhey,0,1,32,32
1683680251685,BILD 3,A03,192611,Butler; Shannon Rhey,19,0,32,13
1683680251685,BILD 3,A04,192612,Butler; Shannon Rhey,24,0,32,8
1683680251685,BILD 3,A05,192613,Butler; Shannon Rhey,26,0,32,6
1683680251685,BILD 3,A06,192679,Butler; Shannon Rhey,27,0,32,5
1683680251685,BILD 3,A07,192682,Butler; Shannon Rhey,20,0,32,12
1683680252712,BILD 4,A01,192836,Reuther; Keefe,1,0,24,23
1683680252712,BILD 4,A02,193044,Reuther; Keefe,4,0,24,20
1683680253738,BILD 10,A01,193142,Gustafson-Brown; Cindy,29,0,32,3
1683680253738,BILD 10,A02,193149,Gustafson-Brown; Cindy,31,0,32,1
1683680254765,BIMM 100,A01,193301,Staff,0,6,32,32
1683680254765,BIMM 100,A02,193312,Staff,0,7,32,32
1683680254765,BIMM 100,A03,193323,Staff,0,10,32,32
1683680255790,BIMM 101,A01,193329,McDonnell; Lisa Marie,1,4,24,23
1683680255790,BIMM 101,A02,193339,McDonnell; Lisa Marie,1,4,24,23
1683680255790,BIMM 101,B01,193354,McDonnell; Lisa Marie,0,4,24,24
1683680255790,BIMM 101,B02,193357,McDonnell; Lisa Marie,0,3,24,24
1683680256818,BIMM 110,A01,193377,Tat; John,0,11,32,32
1683680256818,BIMM 110,A02,193378,Tat; John,0,11,32,32
1683680257845,BIMM 120,A01,206116,Staff,0,0,32,32
1683680257845,BIMM 120,A02,206117,Staff,7,0,32,25
1683680257845,BIMM 120,A03,206121,Staff,21,0,32,11
1683680258870,BIPN 100,A01,193393,Park; Ji Young,0,15,32,32
1683680258870,BIPN 100,A02,193402,Park; Ji Young,0,14,32,32
1683680258870,BIPN 100,A03,193413,Park; Ji Young,0,14,32,32
1683680258870,BIPN 100,A04,193414,Park; Ji Young,0,13,32,32
1683680259895,BIPN 102,A01,193429,Staff,0,0,32,32
1683680259895,BIPN 102,A02,193438,Staff,18,0,32,14
1683680260920,BIPN 106,A01,193450,Reyes Gonzalez; Catalina,0,2,40,40
1683680261949,BIPN 134,A01,193465,Cooke; James Edward,0,0,32,32
1683680261949,BIPN 134,A02,193474,Cooke; James Edward,25,0,32,7
1683680261949,BIPN 134,A03,193485,Cooke; James Edward,29,0,32,3
1683680261949,BIPN 134,A04,193486,Cooke; James Edward,20,0,32,12
1683680261949,BIPN 134,A05,193491,Cooke; James Edward,31,0,32,1
1683680261949,BIPN 134,A06,193501,Cooke; James Edward,30,0,32,2
1683680261949,BIPN 134,A07,193510,Cooke; James Edward,29,0,32,3
1683680264003,BISP 194,A00,222522,Staff,14,0,32,18
1683680265026,CAT 124,A01,202407,Staff,19,0,25,6
1683680266054,CAT 125,A00,202408,Marchisotto; Jennifer Anne,2,0,20,18
1683680267079,CAT 125R,A00,202409,Smith; Lauryn Alissa,0,11,20,20
1683680267079,CAT 125R,B00,202410,Morales; Celeste Georgianna,0,11,20,20
1683680267079,CAT 125R,C00,202411,Irwin; Matthew Joseph,0,12,20,20
1683680268103,CENG 15,A01,204712,Yang; Kesong,0,1,0,0
1683680269128,CENG 114,A00,202070,Jahed Motlagh; Zeinab,5,0,20,15
1683680270151,CGS 105,A00,185477,Wesling; Megan E.,24,0,40,16
1683680271179,CGS 106,A00,185494,Staff,11,0,22,11
1683680272203,CGS 108,A00,185495,Staff,14,0,20,6
1683680273226,CGS 114,A00,185496,Staff,13,0,18,5
1683680274254,CGS 119,A00,185501,Staff,15,0,20,5
1683680275277,CGS 120,A00,185511,Staff,12,0,20,8
1683680276305,CHEM 4,A01,184675,Bussey; Thomas J,97,0,100,3
1683680277332,CHEM 6A,A01,184677,Staff,32,0,60,28
1683680278356,CHEM 6B,A01,184679,Staff,63,0,100,37
1683680279379,CHEM 6C,A01,184681,Bussey; Thomas J,0,0,50,50
1683680279379,CHEM 6C,A02,184682,Bussey; Thomas J,32,0,50,18
1683680280403,CHEM 40A,A01,184684,Albizati; Kim F.,33,0,100,67
1683680281427,CHEM 40B,A01,184686,Albizati; Kim F.,0,22,100,100
1683680282451,CHEM 41B,A01,184690,Staff,51,0,100,49
1683680283478,COGS 3,A01,184715,Boyle; Mary E. T.,0,27,40,40
1683680284506,COGS 14B,A01,185172,Staff,0,14,38,38
1683680285533,COGS 18,A01,184736,Staff,14,0,80,66
1683680286561,COGS 100,A01,184932,Staff,0,8,73,73
1683680287585,COGS 101A,A01,184935,Staff,0,40,30,30
1683680288611,COGS 101B,A01,184944,Staff,0,2,30,30
1683680289638,COGS 101C,A01,184946,Staff,0,10,30,30
1683680290663,COGS 102A,A01,184951,Johnson; Christine M.,2,0,40,38
1683680291693,COGS 107B,A01,184953,Mooshagian; Eric Frederick,0,52,40,40
1683680292718,COGS 118B,A01,184959,Gupta; Anjum,0,50,40,40
1683680293746,COGS 153,A00,184961,Staff,0,16,30,30
1683680294774,COGS 177,A00,184962,Staff,0,21,30,30
1683680295798,COGS 187A,A01,184969,Boyle; Mary E. T.,0,19,40,40
1683680296820,COMM 10,A01,185174,Staff,0,5,25,25
1683680296820,COMM 10,A02,185189,Staff,0,2,25,25
1683680296820,COMM 10,A03,269821,Staff,0,1,0,0
1683680297847,COMM 100B,A02,185476,Staff,11,0,25,14
1683680297847,COMM 100B,A03,277340,Staff,25,0,25,0
1683680298871,COMM 100C,A01,185314,Staff,1,0,25,24
1683680298871,COMM 100C,A02,185327,Staff,17,0,25,8
1683680299898,COMM 110M,A00,185349,Staff,0,0,40,40
1683680300924,COMM 113T,A00,185352,Staff,25,0,40,15
1683680301947,COMM 114I,A00,185353,Staff,31,0,40,9
1683680302974,COMM 131,A00,185354,Staff,17,0,30,13
1683680304002,CSE 8A,A50,185358,Cao; Yingjun,0,46,10,10
1683680305026,CSE 8B,A01,185362,Staff,0,48,50,50
1683680306055,CSE 11,A01,185416,Cao; Yingjun,0,91,10,10
1683680307079,CSE 20,A01,185445,Briones; Jor-el Thomas Caparas,3,0,25,22
1683680308104,CSE 21,A01,185447,Staff,9,0,50,41
1683680309128,CSE 101,A01,185451,Staff,0,13,50,50
1683680309128,CSE 101,B01,185453,Jones; Miles E,0,14,50,50
1683680311182,CSE 141,A01,185458,Eldon; John,16,0,100,84
1683680312209,CSE 141L,A01,185461,Eldon; John,8,0,100,92
1683680313238,CSE 142,A01,185463,Staff,34,0,60,26
1683680313238,CSE 142,B01,201355,Staff,0,7,60,60
1683680314261,CSE 142L,A01,185470,Staff,34,0,60,26
1683680314261,CSE 142L,B01,201417,Staff,0,6,60,60
1683680315286,CSE 190,A00,201433,Staff,32,0,49,17
1683680316315,DOC 1,A01,259136,Strom; Megan C.,7,0,15,8
1683680316315,DOC 1,A02,259137,Strom; Megan C.,14,0,15,1
1683680316315,DOC 1,A03,259138,Strom; Megan C.,14,0,15,1
1683680316315,DOC 1,A04,259139,Strom; Megan C.,14,0,15,1
1683680317342,DOC 100D,A00,259140,Pass; Natalye Joann,14,0,25,11
1683680318371,DSGN 1,A01,184749,Rill; Bryan,0,26,30,30
1683680319396,DSGN 100,A01,185168,Staff,0,2,25,25
1683680320420,ECE 5,A01,185626,Morris; Karcher William,0,12,0,0
1683680321444,ECE 101,A01,185628,Staff,14,0,70,56
1683680322468,ECE 107,A01,185635,Baghdadchi; Saharnaz,0,0,20,20
1683680322468,ECE 107,A02,185638,Baghdadchi; Saharnaz,1,0,20,19
1683680323492,ECE 148,A01,185647,Silberman; Jack,0,0,16,16
1683680324515,ECON 1,A01,185537,Crane; Meredith Helen,54,0,70,16
1683680325539,ECON 3,A01,185549,Crane; Meredith Helen,30,0,70,40
1683680326562,ECON 4,A01,203354,Anderson; John Charles,0,5,10,10
1683680327587,ECON 100A,A01,185574,Staff,0,5,40,40
1683680328615,ECON 100B,A01,185576,Staff,0,12,50,50
1683680329698,ECON 100C,A01,185589,Newhouse; Herbert S,30,0,70,40
1683680330722,ECON 105,A00,185608,Vespa; Emanuel Ignacio,19,0,35,16
1683680331749,ECON 109,A01,185610,Shishkin; Denis,9,0,35,26
1683680332772,ECON 110A,A01,185612,Staff,9,0,40,31
1683680333796,ECON 120A,A01,185615,Staff,19,0,40,21
1683680334820,ECON 120C,A01,185617,Sun; Yixiao,0,21,70,70
1683680335847,ECON 144,A00,203346,Squires; Dale E,2,0,35,33
1683680336871,ECON 171,A01,203349,Newhouse; Herbert S,0,1,35,35
1683680337900,ECON 173A,A01,185621,Toda; Alexis Akira,21,0,35,14
1683680338926,EDS 25,A01,202413,Staff,0,1,0,0
1683680338926,EDS 25,A02,202414,Staff,0,1,0,0
1683680338926,EDS 25,A03,202415,Staff,0,0,0,0
1683680338926,EDS 25,A04,202416,Staff,0,1,0,0
1683680338926,EDS 25,A05,202439,Staff,0,0,0,0
1683680338926,EDS 25,A06,202440,Staff,0,0,0,0
1683680338926,EDS 25,B01,202631,Staff,0,0,0,0
1683680338926,EDS 25,B02,202632,Staff,0,0,0,0
1683680338926,EDS 25,B03,202639,Staff,0,0,0,0
1683680338926,EDS 25,B04,202640,Staff,0,0,0,0
1683680338926,EDS 25,B05,202643,Staff,0,0,0,0
1683680338926,EDS 25,B06,202644,Staff,0,0,0,0
1683680339953,EDS 38,A01,202659,Black; Alison Michelle,24,0,25,1
1683680340980,EDS 115,A00,202652,Staff,18,0,30,12
1683680342006,EDS 125,A00,202649,Staff,13,0,30,17
1683680343032,EDS 126,A01,203332,Staff,30,0,30,0
1683680344063,EDS 139,A00,202838,Staff,16,0,25,9
1683680345087,EDS 146,A01,202655,Staff,14,0,25,11
1683680346117,ENG 15,A00,185667,Staff,0,1,0,0
1683680346117,ENG 15,B00,185672,Staff,0,0,0,0
1683680346117,ENG 15,C00,185675,Staff,0,0,0,0
1683680346117,ENG 15,D00,185682,Staff,0,0,0,0
1683680346117,ENG 15,E00,185684,Staff,0,0,0,0
1683680347142,ETHN 103,A00,185710,Staff,0,8,35,35
1683680348167,ETHN 103A,A00,199228,Man; Simeon S,0,0,9,9
1683680349194,ETHN 109,A00,185711,Staff,15,0,35,20
1683680350219,ETHN 142,A00,185726,Staff,0,4,30,30
1683680351247,ETHN 163J,A00,199229,Man; Simeon S,5,0,8,3
1683680352270,ETHN 168,A00,185727,Staff,7,0,10,3
1683680353294,ETHN 182,A00,185728,Staff,0,0,35,35
1683680354318,ETHN 183,A00,185737,Staff,9,0,18,9
1683680355343,GLBH 111,A01,209361,Burgos; Jose L.,0,0,0,0
1683680357392,HIEU 104,A00,185792,Staff,14,0,20,6
1683680358415,HIEU 115,A00,185800,Staff,0,0,20,20
1683680359438,HIEU 128,A00,185801,Staff,0,9,20,20
1683680360465,HIEU 147,A00,185802,Staff,15,0,20,5
1683680361490,HIEU 154,A00,185823,Staff,11,0,20,9
1683680362514,HILA 102,A00,185826,Staff,14,0,20,6
1683680363540,HILD 2C,A01,185778,Staff,0,13,20,20
1683680364568,HILD 7B,A01,185780,Kwak; Nancy,0,17,32,32
1683680364568,HILD 7B,A02,185781,Kwak; Nancy,0,18,32,32
1683680365596,HILD 30,A01,185791,Staff,12,0,20,8
1683680366624,HISC 119,A00,185830,Golan; Tal,0,9,20,20
1683680367653,HITO 156GS,A00,185831,Patterson; Patrick H.,0,0,0,23
1683680368677,HIUS 103,A00,185832,Man; Simeon S,0,4,20,20
1683680369702,HIUS 117,A00,185836,Kwak; Nancy,2,0,20,18
1683680370726,HIUS 125,A00,185840,Man; Simeon S,0,2,23,23
1683680371758,HIUS 149,A00,185845,Staff,1,0,20,19
1683680372788,HUM 3,A01,185882,Zavodny; Tatiana Sophia,0,8,50,50
1683680372788,HUM 3,B01,185899,Caldwell; Michael Alan,0,18,50,50
1683680373815,HUM 3GS,A00,185900,Patterson; Patrick H.,0,0,0,23
1683680374839,HUM 4,A01,185938,Zroka; Amy Liane,28,0,50,22
1683680374839,HUM 4,B01,185956,Watkins; Eric,0,6,50,50
1683680374839,HUM 4,B02,202209,Watkins; Eric,0,5,50,50
1683680374839,HUM 4,B03,202210,Watkins; Eric,0,5,50,50
1683680375863,HUM 5,A01,185958,West; Geoffrey Scott,0,0,50,50
1683680375863,HUM 5,A02,202215,West; Geoffrey Scott,0,0,50,50
1683680376890,INTL 190,A00,185959,Gagnon; Jeffrey C,0,0,0,9
1683680376890,INTL 190,B00,185960,Lettieri; Michael Joseph,0,0,0,2
1683680377917,JAPN 180,A00,254509,Staff,5,0,30,25
1683680378945,LATI 10,A01,202853,Kennemore; Amy Michelle,4,0,35,31
1683680378945,LATI 10,A02,202854,Kennemore; Amy Michelle,3,0,35,32
1683680378945,LATI 10,A03,270054,Kennemore; Amy Michelle,30,0,30,0
1683680379970,LATI 180,A00,202855,Kennemore; Amy Michelle,11,0,20,9
1683680380994,LAWS 101,A00,201767,Golan; Tal,0,7,40,40
1683680382021,LIFR 1C,A00,185961,Staff,6,0,20,14
1683680383048,LIFR 1CX,A00,185962,Staff,7,0,20,13
1683680384073,LIFR 1D,A00,185963,Staff,7,0,20,13
1683680385101,LIFR 1DX,A00,185964,Staff,7,0,20,13
1683680386124,LIGN 101,A01,186039,Staff,43,0,50,7
1683680387148,LIGN 165,A00,186040,Staff,15,0,50,35
1683680388176,LTCS 108,A00,186041,Staff,5,0,10,5
1683680389202,LTCS 119,A00,186042,Staff,15,0,20,5
1683680390228,LTCS 130,A00,186043,Wesling; Megan E.,15,0,25,10
1683680392279,LTEA 138,A00,186119,Staff,14,0,40,26
1683680393304,LTEN 124,A00,186148,Staff,5,0,25,20
1683680394331,LTEN 178,A00,186149,Staff,7,0,15,8
1683680395355,LTEN 181,A00,186150,Blanco; John D,34,0,40,6
1683680396382,LTWL 120,A00,186160,Staff,19,0,25,6
1683680397406,LTWL 165,A00,186161,Staff,22,0,25,3
1683680398431,LTWR 100,A00,186162,Staff,0,5,15,15
1683680399458,LTWR 102,A00,186163,Doller; Ben,5,0,15,10
1683680400483,MAE 8,A01,186412,Staff,0,1,0,0
1683680401510,MAE 30B,A00,186445,Bahadori; Mohammad Yousef,81,0,100,19
1683680402537,MAE 40,A00,186592,Bewley; Thomas R,10,0,50,40
1683680403560,MAE 101B,A00,186593,Bahadori; Mohammad Yousef,80,0,100,20
1683680404584,MAE 105,A00,186594,Bandaru; Prabhakar,10,0,50,40
1683680405611,MAE 107,A00,186599,Pham; Hieu Tan,0,7,120,120
1683680406640,MAE 148,A01,186660,Silberman; Jack,3,0,16,13
1683680407665,MATH 10A,A01,188095,Staff,0,6,35,35
1683680408691,MATH 10B,A01,188097,Bowers; Adam R.,0,12,30,30
1683680408691,MATH 10B,A02,188099,Bowers; Adam R.,0,11,30,30
1683680408691,MATH 10B,B01,188104,Bowers; Adam R.,0,10,30,30
1683680408691,MATH 10B,B02,188106,Bowers; Adam R.,1,9,30,29
1683680409717,MATH 10C,A01,188111,Staff,0,20,30,30
1683680409717,MATH 10C,A02,188127,Staff,0,19,30,30
1683680409717,MATH 10C,A03,188131,Staff,0,19,30,30
1683680409717,MATH 10C,B01,188218,Staff,17,0,30,13
1683680409717,MATH 10C,B02,188244,Staff,13,0,30,17
1683680409717,MATH 10C,B03,188277,Staff,14,0,30,16
1683680410746,MATH 18,A01,188344,Bach; Quang Tran,18,0,30,12
1683680410746,MATH 18,A02,188345,Bach; Quang Tran,11,0,30,19
1683680410746,MATH 18,B01,188353,Bach; Quang Tran,11,0,30,19
1683680410746,MATH 18,B02,188354,Bach; Quang Tran,19,0,30,11
1683680411770,MATH 20A,A01,188374,Staff,11,0,35,24
1683680412794,MATH 20B,A01,188382,Ohm; Ko Woon,7,0,30,23
1683680412794,MATH 20B,A02,188383,Ohm; Ko Woon,22,0,30,8
1683680412794,MATH 20B,B01,188385,Ohm; Ko Woon,7,0,30,23
1683680412794,MATH 20B,B02,188392,Ohm; Ko Woon,22,0,30,8
1683680413819,MATH 20C,A01,188394,Harel; Guershon,10,0,30,20
1683680413819,MATH 20C,A02,188395,Harel; Guershon,13,0,30,17
1683680413819,MATH 20C,B01,188404,Harel; Guershon,5,0,30,25
1683680413819,MATH 20C,B02,188405,Harel; Guershon,18,0,30,12
1683680414844,MATH 20D,A01,188414,Hammock; Frances H,0,1,30,30
1683680414844,MATH 20D,A02,188415,Hammock; Frances H,0,1,30,30
1683680414844,MATH 20D,B01,188447,Hammock; Frances H,0,1,30,30
1683680414844,MATH 20D,B02,188486,Hammock; Frances H,3,0,30,27
1683680415870,MATH 20E,A01,188649,Staff,21,0,30,9
1683680415870,MATH 20E,A02,188650,Staff,20,0,30,10
1683680415870,MATH 20E,A03,188673,Staff,0,0,30,30
1683680416899,MATH 102,A01,188675,Staff,0,39,35,35
1683680417924,MATH 103B,A01,188681,Staff,3,0,35,32
1683680417924,MATH 103B,B01,188692,Staff,5,0,35,30
1683680418949,MATH 109,A01,188695,Salehi Golsefidy; Alireza,24,0,35,11
1683680418949,MATH 109,A02,188696,Salehi Golsefidy; Alireza,25,0,35,10
1683680419993,MATH 120A,A01,188698,Eggers; John Dietrich,7,0,35,28
1683680421018,MATH 142B,A01,188736,Ioana; Adrian,1,1,30,29
1683680421018,MATH 142B,A02,188741,Ioana; Adrian,0,1,30,30
1683680421018,MATH 142B,A03,188743,Ioana; Adrian,0,1,30,30
1683680422045,MATH 168A,A01,188790,Staff,0,11,35,35
1683680423168,MATH 170A,A01,188803,Nie; Jiawang,0,2,35,35
1683680423168,MATH 170A,A02,188811,Nie; Jiawang,0,1,35,35
1683680423168,MATH 170A,A03,188814,Nie; Jiawang,0,0,35,35
1683680423168,MATH 170A,A04,188815,Nie; Jiawang,6,0,35,29
1683680424195,MATH 193B,A01,188817,Staff,0,0,35,35
1683680424195,MATH 193B,A02,188818,Staff,5,0,35,30
1683680425218,MGT 4,A01,202857,Anderson; John Charles,60,0,80,20
1683680426243,MGT 12,A00,202858,Lindenberger; Wade Douglas,40,0,90,50
1683680427267,MGT 18,A00,202859,Staff,74,0,90,16
1683680428290,MGT 18GS,A00,202860,McKay; Michael J,13,0,28,15
1683680429317,MGT 45,A00,202861,Pecore; Joseph P.,9,0,90,81
1683680430341,MGT 100,A00,202863,Yavorsky; Daniel Ryan,28,0,90,62
1683680431365,MGT 103,A00,202864,Ehrich; Kristine R,0,18,90,90
1683680432393,MGT 112,A00,202865,Ehrich; Kristine R,15,0,90,75
1683680433476,MGT 121A,A00,202868,Staff,90,20,90,0
1683680434500,MGT 131B,A00,202869,Anderson; John Charles,59,0,90,31
1683680435526,MGT 136,A00,202871,Lindenberger; Wade Douglas,83,0,90,7
1683680436550,MGT 164,A00,202873,Staff,0,67,90,91
1683680437577,MGT 164GS,A00,202874,McKay; Mary A,13,0,28,15
1683680438600,MGT 180,A00,202875,Staff,0,51,90,91
1683680439623,MMW 11R,A01,205019,Herbst; Matthew,0,0,30,30
1683680439623,MMW 11R,A02,205026,Herbst; Matthew,29,0,30,1
1683680440649,MMW 15,A01,193512,Chang; Edmond Yi-Teh,0,8,28,28
1683680440649,MMW 15,A02,193513,Chang; Edmond Yi-Teh,0,5,28,28
1683680440649,MMW 15,A03,193514,Chang; Edmond Yi-Teh,0,5,28,28
1683680440649,MMW 15,A04,193515,Chang; Edmond Yi-Teh,0,5,28,28
1683680440649,MMW 15,A05,193516,Chang; Edmond Yi-Teh,0,5,28,28
1683680440649,MMW 15,A06,193517,Chang; Edmond Yi-Teh,0,6,28,28
1683680440649,MMW 15,B01,193519,Chang; Edmond Yi-Teh,0,5,28,28
1683680440649,MMW 15,B02,193520,Chang; Edmond Yi-Teh,0,5,28,28
1683680440649,MMW 15,B03,193521,Chang; Edmond Yi-Teh,0,5,28,28
1683680440649,MMW 15,B04,193522,Chang; Edmond Yi-Teh,0,6,28,28
1683680440649,MMW 15,B05,193523,Chang; Edmond Yi-Teh,0,5,28,28
1683680440649,MMW 15,B06,193524,Chang; Edmond Yi-Teh,0,5,28,28
1683680441673,MMW 122,A01,193526,Rahimi; Babak,0,16,28,28
1683680441673,MMW 122,A02,193527,Rahimi; Babak,0,15,28,28
1683680441673,MMW 122,A03,193528,Rahimi; Babak,0,0,0,0
1683680441673,MMW 122,A04,193529,Rahimi; Babak,0,0,0,0
1683680442758,MUS 1A,A01,186663,Staff,1,19,35,34
1683680443782,MUS 4,A01,186715,Staff,0,12,35,35
1683680444806,MUS 5R,A01,186796,Dubnov; Shlomo,0,17,35,35
1683680445829,MUS 6,A01,186798,Staff,1,5,25,24
1683680446853,MUS 7,A01,186830,Staff,11,0,35,24
1683680447879,MUS 8,A01,186930,Staff,0,27,35,35
1683680448903,MUS 15,A01,186932,Staff,0,15,35,35
1683680448903,MUS 15,B01,186934,Staff,1,17,35,34
1683680449929,MUS 80,A00,186935,Staff,0,0,20,20
1683680449929,MUS 80,B00,186936,Staff,24,0,25,1
1683680450953,NANO 11,A00,204702,Lipomi; Darren John,0,0,0,0
1683680451987,NANO 15,A01,204709,Yang; Kesong,0,1,0,0
1683680453014,NANO 114,A00,202069,Jahed Motlagh; Zeinab,3,0,10,7
1683680454039,PHIL 1,A00,186955,Grush; Rick Scott,31,0,40,9
1683680455064,PHIL 10,A01,186973,Grush; Rick Scott,27,0,35,8
1683680455064,PHIL 10,A02,186974,Grush; Rick Scott,33,0,35,2
1683680456090,PHIL 13,A01,186976,Staff,2,0,35,33
1683680456090,PHIL 13,A02,186977,Staff,16,0,35,19
1683680457113,PHIL 14,A01,186979,Staff,31,0,35,4
1683680457113,PHIL 14,A02,186986,Staff,32,0,35,3
1683680458139,PHIL 28,A01,186988,Staff,16,0,30,14
1683680458139,PHIL 28,A02,186989,Staff,1,0,30,29
1683680458139,PHIL 28,A03,186990,Staff,10,0,30,20
1683680458139,PHIL 28,A04,186991,Staff,26,0,30,4
1683680459168,PHIL 120,A00,186997,Staff,23,0,40,17
1683680460191,PHIL 137,A00,187003,Staff,7,0,40,33
1683680461242,PHIL 150,A00,187015,Staff,47,0,70,23
1683680462266,PHIL 167,A00,187021,Lamey; Andy M.,34,0,40,6
1683680463290,PHIL 174,A01,202226,Staff,17,0,20,3
1683680463290,PHIL 174,A02,202235,Staff,20,0,20,0
1683680464315,PHIL 191A,A00,258918,Staff,0,0,1,1
1683680465339,PHYS 1A,A00,187028,Staff,26,0,60,34
1683680466362,PHYS 1AL,001,187036,Staff,3,0,30,27
1683680466362,PHYS 1AL,002,187049,Staff,18,0,30,12
1683680467389,PHYS 1B,A00,187058,Staff,22,0,60,38
1683680468413,PHYS 1BL,001,187064,Staff,0,1,30,30
1683680468413,PHYS 1BL,002,187070,Staff,4,0,30,26
1683680469436,PHYS 1C,A00,187082,Staff,29,0,120,91
1683680470459,PHYS 1CL,001,187088,Staff,0,9,30,30
1683680470459,PHYS 1CL,002,187089,Staff,0,1,30,30
1683680470459,PHYS 1CL,009,262693,Staff,9,0,30,21
1683680471490,PHYS 2B,A01,187097,Staff,55,0,115,60
1683680472515,PHYS 2C,A01,187099,Staff,63,0,115,52
1683680473539,PHYS 2CL,A01,187101,Staff,5,0,28,23
1683680473539,PHYS 2CL,A02,187102,Staff,15,0,28,13
1683680474565,PHYS 2D,A01,187123,Shotwell; Brian,95,0,115,20
1683680475589,PHYS 4B,A01,187133,Grinstein; Benjamin,35,0,50,15
1683680476614,POLI 10,A00,188819,Staff,0,4,50,50
1683680477638,POLI 11,A00,188827,Staff,43,0,50,7
1683680478666,POLI 13R,A00,188828,Staff,0,1,20,20
1683680479692,POLI 27,A01,188830,Elgin; Samuel Zincke,0,2,70,70
1683680480721,POLI 30,A00,188832,Desposato; Scott,30,0,50,20
1683680481748,POLI 102F,A00,188834,Staff,0,0,40,40
1683680482776,POLI 104A,A00,188852,Staff,12,0,30,18
1683680483803,POLI 104I,A00,188853,Staff,0,8,20,20
1683680484828,POLI 110B,A00,188854,Wiens; David,6,0,20,14
1683680485852,POLI 112A,A00,188855,Wiens; David,3,0,30,27
1683680486880,POLI 117R,A00,188856,Forman; Fonna,0,12,20,20
1683680487904,POLI 118,A00,188857,Ingham; Sean,8,0,20,12
1683680488934,POLI 120G,A00,188858,Staff,8,0,30,22
1683680489957,POLI 131CR,A00,188863,Hoston; Germaine,20,0,50,30
1683680490985,POLI 133,A00,188864,Nellis; Gareth Hb,44,0,50,6
1683680492012,POLI 134D,A00,188865,Desposato; Scott,27,0,30,3
1683680493036,POLI 142A,A00,188871,Gartzke; Erik,21,0,50,29
1683680494060,POLI 142K,A00,188874,Staff,38,0,50,12
1683680495086,POLI 143,A00,188940,Gartzke; Erik,16,0,30,14
1683680496109,POLI 153,A00,188943,Staff,2,0,20,18
1683680497132,POLI 160AA,A00,188944,Staff,10,0,40,30
1683680498156,POLI 170A,A00,188945,Staff,10,0,30,20
1683680500202,PSYC 1,A00,188952,Staff,36,0,90,54
1683680501229,PSYC 2,B00,188953,Staff,19,0,35,16
1683680502256,PSYC 6,A00,188970,Staff,47,0,60,13
1683680503279,PSYC 7,A00,188973,Staff,35,0,45,10
1683680504307,PSYC 60,A01,188980,Rickard; Timothy C.,42,0,60,18
1683680505331,PSYC 70,A01,189001,Steiner; Eric Tomas,21,0,45,24
1683680506359,PSYC 100,A00,189005,Lacefield; Katharine I,0,99,120,120
1683680507382,PSYC 102,A00,189008,Staff,7,0,30,23
1683680508405,PSYC 106,B00,189026,Gorman; Michael R.,27,0,60,33
1683680509430,PSYC 114,B01,189033,Winkielman; Piotr,0,31,30,30
1683680510455,PSYC 131,A00,189036,Anagnostaras; Stephan,0,43,60,60
1683680511483,PSYC 136,A00,189041,Lowe; Angela Beth,0,7,25,25
1683680512512,PSYC 137,A00,189057,Winkielman; Piotr,1,37,25,24
1683680513536,PSYC 144,A00,189107,Wixted; John T,0,11,50,50
1683680515586,PSYC 162,A00,189142,Staff,0,9,85,85
1683680516610,PSYC 172,A00,189144,Gorman; Michael R.,0,6,30,30
1683680518660,PSYC 179,A00,189146,Lacefield; Katharine I,0,87,120,120
1683680519687,PSYC 181,A00,189147,Anagnostaras; Stephan,0,44,90,90
1683680520711,PSYC 190R,A00,189148,Barner; David A.,0,23,80,80
1683680521741,PSYC 191,A00,189275,Rickard; Timothy C.,0,10,25,25
1683680522765,PSYC 193,A00,189276,Chapman; Eddie Nathaniel,0,1,0,4
1683680523798,PSYC 193L,A01,189281,Lowe; Angela Beth,8,0,20,12
1683680523798,PSYC 193L,B01,189285,Staff,28,0,35,7
1683680524825,RELI 149,A00,187137,Rahimi; Babak,7,0,40,33
1683680525850,SE 9,A01,187315,Staff,0,2,18,18
1683680526874,SE 101B,A00,187409,Staff,24,0,30,6
1683680527901,SE 110B,A00,187444,Staff,10,0,40,30
1683680528929,SE 130B,A00,187449,Staff,31,0,40,9
1683680529956,SE 150A,A00,187516,Staff,8,0,20,12
1683680530984,SE 154,A00,187528,Staff,29,0,50,21
1683680532006,SIO 3,A01,258171,Staff,35,0,40,5
1683680533033,SIO 10,A00,187144,Cook; Geoffrey W,1,7,75,74
1683680534057,SIO 45,A00,187152,Cook; Geoffrey W,0,7,100,100
1683680535080,SIO 109R,A00,194486,Staff,0,4,20,20
1683680537184,SIO 187,A01,187233,Kacev; David,12,0,40,28
1683680538209,SOCI 1,A01,258656,Thorpe; Charles Robert,28,0,30,2
1683680538209,SOCI 1,A02,258658,Thorpe; Charles Robert,30,0,30,0
1683680538209,SOCI 1,A03,258661,Thorpe; Charles Robert,25,0,25,0
1683680538209,SOCI 1,A04,258666,Thorpe; Charles Robert,22,0,25,3
1683680538209,SOCI 1,A05,258897,Thorpe; Charles Robert,22,0,25,3
1683680538209,SOCI 1,A06,258898,Thorpe; Charles Robert,25,0,25,0
1683680539232,SOCI 30,A01,258903,Pardo Guerra; Juan Pablo,14,0,30,16
1683680540256,SOCI 102,A00,258904,Staff,9,0,25,16
1683680541280,SOCI 106,A00,258905,Staff,19,0,25,6
1683680542307,SOCI 111,A00,258907,Ribas Norris; Janet Vanesa,26,0,30,4
1683680543334,SOCI 121R,A00,258908,Pardo Guerra; Juan Pablo,8,0,30,22
1683680544358,SOCI 126,A01,203330,Staff,14,0,20,6
1683680545382,SOCI 131,A00,258909,Thorpe; Charles Robert,30,0,60,30
1683680546409,SOCI 135,A00,258910,Payne; Christine Anna,0,12,30,30
1683680547434,SOCI 157,A00,258911,Staff,11,0,30,19
1683680548459,SOCI 184,A00,258912,Staff,25,0,30,5
1683680549482,SOCI 188D,A00,258913,Staff,22,0,30,8
1683680550507,SYN 2,001,187529,Staff,9,0,16,7
1683680550507,SYN 2,002,201452,Staff,1,20,16,15
1683680550507,SYN 2,003,201469,Staff,1,0,16,15
1683680551532,SYN 100,A01,187531,Staff,0,9,20,20
1683680551532,SYN 100,B01,201491,Staff,0,10,20,20
1683680552560,TDAC 1,A00,189286,Walsh; Kim C.,3,0,20,17
1683680552560,TDAC 1,B00,189287,Harting; Carla Kelso,10,0,20,10
1683680553584,TDAC 101,A00,189300,Walsh; Kim C.,16,0,20,4
1683680553584,TDAC 101,B00,189301,Harting; Carla Kelso,18,0,20,2
1683680554608,TDAC 102,A00,189304,Basso; Beatrice,14,0,20,6
1683680555633,TDAC 108,A00,189305,Staff,18,0,20,2
1683680556658,TDDE 131,A00,189310,Staff,19,0,20,1
1683680556658,TDDE 131,B00,189314,Staff,19,0,20,1
1683680556658,TDDE 131,C00,189315,Staff,48,0,50,2
1683680556658,TDDE 131,D00,189316,Staff,14,0,15,1
1683680556658,TDDE 131,E00,204841,Staff,20,0,20,0
1683680557683,TDGE 10,A00,189289,Staff,27,0,50,23
1683680557683,TDGE 10,B00,189290,Havis; Allan,0,1,50,50
1683680558706,TDGE 11,A00,189291,Fulton; Julia,0,4,50,50
1683680558706,TDGE 11,B00,189292,Staff,20,0,25,5
1683680558706,TDGE 11,C00,260270,Staff,0,0,0,0
1683680559734,TDGE 25,A00,189294,Staff,1,0,20,19
1683680560759,TDGE 124,A00,189318,Fulton; Julia,0,8,50,50
1683680561784,TDGE 125,A00,189319,Staff,13,0,25,12
1683680561784,TDGE 125,B00,189320,Staff,23,0,25,2
1683680562809,TDGE 127,A00,189322,Havis; Allan,0,0,50,50
1683680563834,TDHT 101,A00,189323,Staff,18,0,25,7
1683680563834,TDHT 101,B00,189324,Staff,25,0,25,0
1683680564859,TDHT 102,A00,189325,Staff,49,0,50,1
1683680565883,TDMV 1,A00,189295,Arcidiacono; Kristin,20,0,30,10
1683680565883,TDMV 1,B00,189296,Caligagan; Maria T.,24,0,30,6
1683680566907,TDMV 2,A00,189297,Sammartano; Tonnie,27,0,30,3
1683680566907,TDMV 2,B00,189299,Arcidiacono; Kristin,23,0,30,7
1683680567930,TDMV 3,A00,204998,Rincon; Alicia,22,0,30,8
1683680568956,TDMV 120,A00,189458,Sammartano; Tonnie,28,0,30,2
1683680569990,TDMV 138,A00,189541,Jun; Grace Shin Hae,20,0,40,20
1683680571016,TDMV 142,A00,189717,Caligagan; Tony,25,0,30,5
1683680571016,TDMV 142,B00,189718,Caligagan; Maria T.,25,0,30,5
1683680572043,TMC 2,A01,187533,Staff,25,0,25,0
1683680572043,TMC 2,A02,187534,Staff,25,0,25,0
1683680573071,USP 1,A01,187536,Kwak; Nancy,0,16,25,25
1683680574095,USP 5,A01,187538,Staff,8,0,25,17
1683680575121,USP 101,A00,199253,Staff,0,4,0,0
1683680576150,USP 124,A00,187562,Boomhower; Matthew Charles,0,0,30,30
1683680577177,USP 138,A00,187582,Staff,19,0,25,6
1683680578201,USP 152,A01,187597,Staff,3,0,25,22
1683680579226,USP 153,A00,187598,Staff,18,0,25,7
1683680580250,USP 168,A00,187607,Kwak; Nancy,2,0,5,3
1683680581277,USP 173,A00,187619,Staff,4,0,25,21
1683680582315,USP 181,A00,187638,Staff,0,4,25,25
1683680583340,VIS 103,A00,187650,Cruz; Edwin Teddy,17,0,75,58
1683680584368,VIS 110D,A00,187669,Staff,13,0,22,9
1683680585394,VIS 127C,A00,187720,Shen; Kuiyi,67,0,146,79
1683680586421,VIS 149,A00,187731,Yoldas; Pinar,1,14,22,21
1683680587449,VIS 151,A01,188091,Staff,22,0,34,12
1683680587449,VIS 151,A02,188092,Staff,11,0,34,23
1683680588476,VIS 160B,A00,188093,Stalbaum; Brett,0,1,10,10
1683680590528,WCWP 10B,A00,201720,Staff,0,0,5,5
1683680590528,WCWP 10B,B00,201722,Staff,0,0,6,6
1683680591554,WCWP 100,A00,201725,Gagnon; Jeffrey C,0,0,2,2
1683680591554,WCWP 100,B00,201727,Staff,0,4,15,15
1683680594651,ANBI 133,A00,258401,Wilder; Linnea Lorene,34,0,40,6
1683680595676,ANBI 140,A00,258395,Hrvoj Mihic; Branka,18,0,25,7
1683680596700,ANSC 120,A00,258402,Bialecki; Jon Anthony,26,0,40,14
1683680597723,ANSC 144,A00,258400,Staff,12,0,40,28
1683680599775,ANSC 166,A00,258396,Parish; Steven Martin,156,0,175,19
1683680600798,ANSC 180,A00,193533,Staff,8,0,20,12
1683680601827,ANSC 188,A00,258397,Jassal; Aftab,34,0,40,6
1683680602855,ANTH 3,A01,258316,Staff,23,0,30,7
1683680603882,ANTH 5,A00,258394,Semendeferi; Ekaterini,16,0,20,4
1683680604909,ANTH 21,A01,258331,Staff,4,0,40,36
1683680605934,ANTH 103,A00,258398,Varma; Saiba,15,0,25,10
1683680606961,AWP 10,001,202034,Staff,0,0,0,0
1683680606961,AWP 10,002,202035,Staff,0,0,0,0
1683680606961,AWP 10,003,202036,Staff,0,0,0,0
1683680606961,AWP 10,004,202037,Staff,0,0,0,0
1683680606961,AWP 10,005,202038,Staff,0,0,0,0
1683680606961,AWP 10,006,202039,Staff,0,0,0,0
1683680606961,AWP 10,007,202040,Staff,0,0,0,0
1683680606961,AWP 10,008,202041,Staff,0,0,0,0
1683680606961,AWP 10,009,202042,Staff,0,0,0,0
1683680606961,AWP 10,010,202043,Staff,0,0,0,0
1683680606961,AWP 10,011,202044,Staff,0,0,0,0
1683680606961,AWP 10,012,202045,Staff,0,0,0,0
1683680606961,AWP 10,013,202046,Staff,0,0,0,0
1683680606961,AWP 10,014,202047,Staff,0,0,0,0
1683680606961,AWP 10,015,202048,Staff,0,0,0,0
1683680606961,AWP 10,016,202049,Staff,0,0,0,0
1683680606961,AWP 10,017,202050,Staff,0,0,0,0
1683680606961,AWP 10,018,202051,Staff,0,0,0,0
1683680606961,AWP 10,019,202052,Staff,0,0,0,0
1683680606961,AWP 10,020,202053,Staff,0,0,0,0
1683680606961,AWP 10,021,202054,Staff,0,0,0,0
1683680606961,AWP 10,022,202055,Staff,0,0,0,0
1683680606961,AWP 10,023,202056,Staff,0,0,0,0
1683680606961,AWP 10,024,202057,Staff,0,0,0,0
1683680606961,AWP 10,025,202058,Staff,0,0,0,0
1683680606961,AWP 10,026,202059,Staff,0,0,0,0
1683680607986,AWP 102,001,202032,Staff,0,0,0,0
1683680607986,AWP 102,002,202033,Staff,0,0,0,0
1683680609009,BENG 100,A01,254234,Taylor Amos; Alyssa C,31,0,40,9
1683680610037,BENG 196,001,270013,Engler; Adam J.,9999,0,9999,0
1683680611062,BICD 100R,A01,202018,Smith; Laurie,0,7,32,32
1683680611062,BICD 100R,A02,202019,Smith; Laurie,0,3,32,32
1683680611062,BICD 100R,A03,202020,Smith; Laurie,0,1,32,32
1683680611062,BICD 100R,A04,202021,Smith; Laurie,6,0,32,26
1683680611062,BICD 100R,A05,202022,Smith; Laurie,10,0,32,22
1683680612091,BICD 136,A01,193242,Gustafson-Brown; Cindy,0,2,32,32
1683680612091,BICD 136,A02,193244,Gustafson-Brown; Cindy,13,0,32,19
1683680613120,BIEB 102,A01,193249,Butler; Shannon Rhey,1,1,32,31
1683680613120,BIEB 102,A02,193251,Butler; Shannon Rhey,0,0,32,32
1683680613120,BIEB 102,A03,193253,Butler; Shannon Rhey,0,0,32,32
1683680613120,BIEB 102,A04,193255,Butler; Shannon Rhey,13,0,32,19
1683680613120,BIEB 102,A05,193265,Butler; Shannon Rhey,25,0,32,7
1683680613120,BIEB 102,A06,193269,Butler; Shannon Rhey,13,0,32,19
1683680615169,BIEB 150,A01,193274,Staff,0,0,32,32
1683680615169,BIEB 150,A02,193285,Staff,24,0,32,8
1683680616192,BIEB 194,A00,193286,Kurle; Carolyn M.,19,0,32,13
1683680617220,BILD 1,A01,192291,Staff,15,0,32,17
1683680617220,BILD 1,A02,192292,Staff,30,0,32,2
1683680617220,BILD 1,B01,192520,Reuther; Keefe,0,1,0,0
1683680617220,BILD 1,B02,192532,Reuther; Keefe,0,1,0,0
1683680618248,BILD 3,A01,192556,Butler; Shannon Rhey,0,0,32,32
1683680618248,BILD 3,A02,192581,Butler; Shannon Rhey,0,1,32,32
1683680618248,BILD 3,A03,192611,Butler; Shannon Rhey,19,0,32,13
1683680618248,BILD 3,A04,192612,Butler; Shannon Rhey,24,0,32,8
1683680618248,BILD 3,A05,192613,Butler; Shannon Rhey,26,0,32,6
1683680618248,BILD 3,A06,192679,Butler; Shannon Rhey,27,0,32,5
1683680618248,BILD 3,A07,192682,Butler; Shannon Rhey,20,0,32,12
1683680619273,BILD 4,A01,192836,Reuther; Keefe,1,0,24,23
1683680619273,BILD 4,A02,193044,Reuther; Keefe,4,0,24,20
1683680620297,BILD 10,A01,193142,Gustafson-Brown; Cindy,29,0,32,3
1683680620297,BILD 10,A02,193149,Gustafson-Brown; Cindy,31,0,32,1
1683680621323,BIMM 100,A01,193301,Staff,0,6,32,32
1683680621323,BIMM 100,A02,193312,Staff,0,7,32,32
1683680621323,BIMM 100,A03,193323,Staff,0,10,32,32
1683680622350,BIMM 101,A01,193329,McDonnell; Lisa Marie,1,4,24,23
1683680622350,BIMM 101,A02,193339,McDonnell; Lisa Marie,1,4,24,23
1683680622350,BIMM 101,B01,193354,McDonnell; Lisa Marie,0,4,24,24
1683680622350,BIMM 101,B02,193357,McDonnell; Lisa Marie,0,3,24,24
1683680623374,BIMM 110,A01,193377,Tat; John,0,11,32,32
1683680623374,BIMM 110,A02,193378,Tat; John,0,11,32,32
1683680624400,BIMM 120,A01,206116,Staff,0,0,32,32
1683680624400,BIMM 120,A02,206117,Staff,7,0,32,25
1683680624400,BIMM 120,A03,206121,Staff,21,0,32,11
1683680625431,BIPN 100,A01,193393,Park; Ji Young,0,15,32,32
1683680625431,BIPN 100,A02,193402,Park; Ji Young,0,14,32,32
1683680625431,BIPN 100,A03,193413,Park; Ji Young,0,14,32,32
1683680625431,BIPN 100,A04,193414,Park; Ji Young,0,13,32,32
1683680626455,BIPN 102,A01,193429,Staff,0,0,32,32
1683680626455,BIPN 102,A02,193438,Staff,18,0,32,14
1683680627479,BIPN 106,A01,193450,Reyes Gonzalez; Catalina,0,2,40,40
1683680628504,BIPN 134,A01,193465,Cooke; James Edward,0,0,32,32
1683680628504,BIPN 134,A02,193474,Cooke; James Edward,25,0,32,7
1683680628504,BIPN 134,A03,193485,Cooke; James Edward,29,0,32,3
1683680628504,BIPN 134,A04,193486,Cooke; James Edward,20,0,32,12
1683680628504,BIPN 134,A05,193491,Cooke; James Edward,31,0,32,1
1683680628504,BIPN 134,A06,193501,Cooke; James Edward,30,0,32,2
1683680628504,BIPN 134,A07,193510,Cooke; James Edward,29,0,32,3
1683680630552,BISP 194,A00,222522,Staff,14,0,32,18
1683680631578,CAT 124,A01,202407,Staff,19,0,25,6
1683680632604,CAT 125,A00,202408,Marchisotto; Jennifer Anne,2,0,20,18
1683680633629,CAT 125R,A00,202409,Smith; Lauryn Alissa,0,11,20,20
1683680633629,CAT 125R,B00,202410,Morales; Celeste Georgianna,0,11,20,20
1683680633629,CAT 125R,C00,202411,Irwin; Matthew Joseph,0,12,20,20
1683680634656,CENG 15,A01,204712,Yang; Kesong,0,1,0,0
1683680635680,CENG 114,A00,202070,Jahed Motlagh; Zeinab,5,0,20,15
1683680636706,CGS 105,A00,185477,Wesling; Megan E.,24,0,40,16
1683680637730,CGS 106,A00,185494,Staff,11,0,22,11
1683680638756,CGS 108,A00,185495,Staff,14,0,20,6
1683680639783,CGS 114,A00,185496,Staff,13,0,18,5
1683680640881,CGS 119,A00,185501,Staff,15,0,20,5
1683680641905,CGS 120,A00,185511,Staff,12,0,20,8
1683680642938,CHEM 4,A01,184675,Bussey; Thomas J,97,0,100,3
1683680643965,CHEM 6A,A01,184677,Staff,32,0,60,28
1683680645001,CHEM 6B,A01,184679,Staff,63,0,100,37
1683680646026,CHEM 6C,A01,184681,Bussey; Thomas J,0,0,50,50
1683680646026,CHEM 6C,A02,184682,Bussey; Thomas J,32,0,50,18
1683680647050,CHEM 40A,A01,184684,Albizati; Kim F.,33,0,100,67
1683680648074,CHEM 40B,A01,184686,Albizati; Kim F.,0,22,100,100
1683680649099,CHEM 41B,A01,184690,Staff,51,0,100,49
1683680650127,COGS 3,A01,184715,Boyle; Mary E. T.,0,27,40,40
1683680651151,COGS 14B,A01,185172,Staff,0,14,38,38
1683680652176,COGS 18,A01,184736,Staff,14,0,80,66
1683680653204,COGS 100,A01,184932,Staff,0,8,73,73
1683680654231,COGS 101A,A01,184935,Staff,0,40,30,30
1683680655256,COGS 101B,A01,184944,Staff,0,2,30,30
1683680656282,COGS 101C,A01,184946,Staff,0,10,30,30
1683680657306,COGS 102A,A01,184951,Johnson; Christine M.,2,0,40,38
1683680658330,COGS 107B,A01,184953,Mooshagian; Eric Frederick,0,52,40,40
1683680659359,COGS 118B,A01,184959,Gupta; Anjum,0,50,40,40
1683680660386,COGS 153,A00,184961,Staff,0,16,30,30
1683680661412,COGS 177,A00,184962,Staff,0,21,30,30
1683680662435,COGS 187A,A01,184969,Boyle; Mary E. T.,0,19,40,40
1683680663460,COMM 10,A01,185174,Staff,0,5,25,25
1683680663460,COMM 10,A02,185189,Staff,0,2,25,25
1683680663460,COMM 10,A03,269821,Staff,0,1,0,0
1683680664486,COMM 100B,A02,185476,Staff,11,0,25,14
1683680664486,COMM 100B,A03,277340,Staff,25,0,25,0
1683680665514,COMM 100C,A01,185314,Staff,1,0,25,24
1683680665514,COMM 100C,A02,185327,Staff,17,0,25,8
1683680666539,COMM 110M,A00,185349,Staff,0,0,40,40
1683680667566,COMM 113T,A00,185352,Staff,25,0,40,15
1683680668590,COMM 114I,A00,185353,Staff,31,0,40,9
1683680669616,COMM 131,A00,185354,Staff,17,0,30,13
1683680670644,CSE 8A,A50,185358,Cao; Yingjun,0,46,10,10
1683680671672,CSE 8B,A01,185362,Staff,0,48,50,50
1683680672698,CSE 11,A01,185416,Cao; Yingjun,0,91,10,10
1683680673721,CSE 20,A01,185445,Briones; Jor-el Thomas Caparas,3,0,25,22
1683680674750,CSE 21,A01,185447,Staff,9,0,50,41
1683680675774,CSE 101,A01,185451,Staff,0,13,50,50
1683680675774,CSE 101,B01,185453,Jones; Miles E,0,14,50,50
1683680677824,CSE 141,A01,185458,Eldon; John,16,0,100,84
1683680678855,CSE 141L,A01,185461,Eldon; John,8,0,100,92
1683680679882,CSE 142,A01,185463,Staff,34,0,60,26
1683680679882,CSE 142,B01,201355,Staff,0,7,60,60
1683680680907,CSE 142L,A01,185470,Staff,34,0,60,26
1683680680907,CSE 142L,B01,201417,Staff,0,6,60,60
1683680681935,CSE 190,A00,201433,Staff,32,0,49,17
1683680682963,DOC 1,A01,259136,Strom; Megan C.,7,0,15,8
1683680682963,DOC 1,A02,259137,Strom; Megan C.,14,0,15,1
1683680682963,DOC 1,A03,259138,Strom; Megan C.,14,0,15,1
1683680682963,DOC 1,A04,259139,Strom; Megan C.,14,0,15,1
1683680683992,DOC 100D,A00,259140,Pass; Natalye Joann,14,0,25,11
1683680685019,DSGN 1,A01,184749,Rill; Bryan,0,26,30,30
1683680686046,DSGN 100,A01,185168,Staff,0,2,25,25
1683680687074,ECE 5,A01,185626,Morris; Karcher William,0,12,0,0
1683680688099,ECE 101,A01,185628,Staff,14,0,70,56
1683680689123,ECE 107,A01,185635,Baghdadchi; Saharnaz,0,0,20,20
1683680689123,ECE 107,A02,185638,Baghdadchi; Saharnaz,1,0,20,19
1683680690148,ECE 148,A01,185647,Silberman; Jack,0,0,16,16
1683680691173,ECON 1,A01,185537,Crane; Meredith Helen,54,0,70,16
1683680692200,ECON 3,A01,185549,Crane; Meredith Helen,30,0,70,40
1683680693227,ECON 4,A01,203354,Anderson; John Charles,0,5,10,10
1683680694257,ECON 100A,A01,185574,Staff,0,5,40,40
1683680695280,ECON 100B,A01,185576,Staff,0,12,50,50
1683680696307,ECON 100C,A01,185589,Newhouse; Herbert S,30,0,70,40
1683680697331,ECON 105,A00,185608,Vespa; Emanuel Ignacio,19,0,35,16
1683680698357,ECON 109,A01,185610,Shishkin; Denis,9,0,35,26
1683680699381,ECON 110A,A01,185612,Staff,9,0,40,31
1683680700405,ECON 120A,A01,185615,Staff,19,0,40,21
1683680701430,ECON 120C,A01,185617,Sun; Yixiao,0,21,70,70
1683680702458,ECON 144,A00,203346,Squires; Dale E,2,0,35,33
1683680703486,ECON 171,A01,203349,Newhouse; Herbert S,0,1,35,35
1683680704512,ECON 173A,A01,185621,Toda; Alexis Akira,21,0,35,14
1683680705538,EDS 25,A01,202413,Staff,0,1,0,0
1683680705538,EDS 25,A02,202414,Staff,0,1,0,0
1683680705538,EDS 25,A03,202415,Staff,0,0,0,0
1683680705538,EDS 25,A04,202416,Staff,0,1,0,0
1683680705538,EDS 25,A05,202439,Staff,0,0,0,0
1683680705538,EDS 25,A06,202440,Staff,0,0,0,0
1683680705538,EDS 25,B01,202631,Staff,0,0,0,0
1683680705538,EDS 25,B02,202632,Staff,0,0,0,0
1683680705538,EDS 25,B03,202639,Staff,0,0,0,0
1683680705538,EDS 25,B04,202640,Staff,0,0,0,0
1683680705538,EDS 25,B05,202643,Staff,0,0,0,0
1683680705538,EDS 25,B06,202644,Staff,0,0,0,0
1683680706562,EDS 38,A01,202659,Black; Alison Michelle,24,0,25,1
1683680707585,EDS 115,A00,202652,Staff,18,0,30,12
1683680708613,EDS 125,A00,202649,Staff,13,0,30,17
1683680709639,EDS 126,A01,203332,Staff,30,0,30,0
1683680710665,EDS 139,A00,202838,Staff,16,0,25,9
1683680711689,EDS 146,A01,202655,Staff,14,0,25,11
1683680712714,ENG 15,A00,185667,Staff,0,1,0,0
1683680712714,ENG 15,B00,185672,Staff,0,0,0,0
1683680712714,ENG 15,C00,185675,Staff,0,0,0,0
1683680712714,ENG 15,D00,185682,Staff,0,0,0,0
1683680712714,ENG 15,E00,185684,Staff,0,0,0,0
1683680713738,ETHN 103,A00,185710,Staff,0,8,35,35
1683680714766,ETHN 103A,A00,199228,Man; Simeon S,0,0,9,9
1683680715793,ETHN 109,A00,185711,Staff,15,0,35,20
1683680716818,ETHN 142,A00,185726,Staff,0,4,30,30
1683680717842,ETHN 163J,A00,199229,Man; Simeon S,5,0,8,3
1683680718867,ETHN 168,A00,185727,Staff,7,0,10,3
1683680719890,ETHN 182,A00,185728,Staff,0,0,35,35
1683680720913,ETHN 183,A00,185737,Staff,9,0,18,9
1683680721938,GLBH 111,A01,209361,Burgos; Jose L.,0,0,0,0
1683680723992,HIEU 104,A00,185792,Staff,14,0,20,6
1683680725016,HIEU 115,A00,185800,Staff,0,0,20,20
1683680726040,HIEU 128,A00,185801,Staff,0,9,20,20
1683680727066,HIEU 147,A00,185802,Staff,15,0,20,5
1683680728093,HIEU 154,A00,185823,Staff,11,0,20,9
1683680729118,HILA 102,A00,185826,Staff,14,0,20,6
1683680730142,HILD 2C,A01,185778,Staff,0,13,20,20
1683680731164,HILD 7B,A01,185780,Kwak; Nancy,0,17,32,32
1683680731164,HILD 7B,A02,185781,Kwak; Nancy,0,18,32,32
1683680732191,HILD 30,A01,185791,Staff,12,0,20,8
1683680733215,HISC 119,A00,185830,Golan; Tal,0,9,20,20
1683680734238,HITO 156GS,A00,185831,Patterson; Patrick H.,0,0,0,23
1683680735266,HIUS 103,A00,185832,Man; Simeon S,0,4,20,20
1683680736289,HIUS 117,A00,185836,Kwak; Nancy,2,0,20,18
1683680737314,HIUS 125,A00,185840,Man; Simeon S,0,2,23,23
1683680738339,HIUS 149,A00,185845,Staff,1,0,20,19
1683680739368,HUM 3,A01,185882,Zavodny; Tatiana Sophia,0,8,50,50
1683680739368,HUM 3,B01,185899,Caldwell; Michael Alan,0,18,50,50
1683680740395,HUM 3GS,A00,185900,Patterson; Patrick H.,0,0,0,23
1683680741419,HUM 4,A01,185938,Zroka; Amy Liane,28,0,50,22
1683680741419,HUM 4,B01,185956,Watkins; Eric,0,6,50,50
1683680741419,HUM 4,B02,202209,Watkins; Eric,0,5,50,50
1683680741419,HUM 4,B03,202210,Watkins; Eric,0,5,50,50
1683680742443,HUM 5,A01,185958,West; Geoffrey Scott,0,0,50,50
1683680742443,HUM 5,A02,202215,West; Geoffrey Scott,0,0,50,50
1683680743466,INTL 190,A00,185959,Gagnon; Jeffrey C,0,0,0,9
1683680743466,INTL 190,B00,185960,Lettieri; Michael Joseph,0,0,0,2
1683680744550,JAPN 180,A00,254509,Staff,5,0,30,25
1683680745578,LATI 10,A01,202853,Kennemore; Amy Michelle,4,0,35,31
1683680745578,LATI 10,A02,202854,Kennemore; Amy Michelle,3,0,35,32
1683680745578,LATI 10,A03,270054,Kennemore; Amy Michelle,30,0,30,0
1683680746601,LATI 180,A00,202855,Kennemore; Amy Michelle,11,0,20,9
1683680747629,LAWS 101,A00,201767,Golan; Tal,0,7,40,40
1683680748655,LIFR 1C,A00,185961,Staff,6,0,20,14
1683680749681,LIFR 1CX,A00,185962,Staff,7,0,20,13
1683680750704,LIFR 1D,A00,185963,Staff,7,0,20,13
1683680751729,LIFR 1DX,A00,185964,Staff,7,0,20,13
1683680752754,LIGN 101,A01,186039,Staff,43,0,50,7
1683680753779,LIGN 165,A00,186040,Staff,15,0,50,35
1683680754808,LTCS 108,A00,186041,Staff,5,0,10,5
1683680755834,LTCS 119,A00,186042,Staff,15,0,20,5
1683680756859,LTCS 130,A00,186043,Wesling; Megan E.,15,0,25,10
1683680758906,LTEA 138,A00,186119,Staff,14,0,40,26
1683680759931,LTEN 124,A00,186148,Staff,5,0,25,20
1683680760955,LTEN 178,A00,186149,Staff,7,0,15,8
1683680761980,LTEN 181,A00,186150,Blanco; John D,34,0,40,6
1683680763005,LTWL 120,A00,186160,Staff,19,0,25,6
1683680764029,LTWL 165,A00,186161,Staff,22,0,25,3
1683680765054,LTWR 100,A00,186162,Staff,0,5,15,15
1683680766081,LTWR 102,A00,186163,Doller; Ben,5,0,15,10
1683680767108,MAE 8,A01,186412,Staff,0,1,0,0
1683680768135,MAE 30B,A00,186445,Bahadori; Mohammad Yousef,81,0,100,19
1683680769159,MAE 40,A00,186592,Bewley; Thomas R,10,0,50,40
1683680770184,MAE 101B,A00,186593,Bahadori; Mohammad Yousef,80,0,100,20
1683680771212,MAE 105,A00,186594,Bandaru; Prabhakar,10,0,50,40
1683680772240,MAE 107,A00,186599,Pham; Hieu Tan,0,7,120,120
1683680773269,MAE 148,A01,186660,Silberman; Jack,3,0,16,13
1683680774296,MATH 10A,A01,188095,Staff,0,6,35,35
1683680775322,MATH 10B,A01,188097,Bowers; Adam R.,0,12,30,30
1683680775322,MATH 10B,A02,188099,Bowers; Adam R.,0,11,30,30
1683680775322,MATH 10B,B01,188104,Bowers; Adam R.,0,10,30,30
1683680775322,MATH 10B,B02,188106,Bowers; Adam R.,1,9,30,29
1683680776349,MATH 10C,A01,188111,Staff,0,20,30,30
1683680776349,MATH 10C,A02,188127,Staff,0,19,30,30
1683680776349,MATH 10C,A03,188131,Staff,0,19,30,30
1683680776349,MATH 10C,B01,188218,Staff,17,0,30,13
1683680776349,MATH 10C,B02,188244,Staff,13,0,30,17
1683680776349,MATH 10C,B03,188277,Staff,14,0,30,16
1683680777379,MATH 18,A01,188344,Bach; Quang Tran,18,0,30,12
1683680777379,MATH 18,A02,188345,Bach; Quang Tran,11,0,30,19
1683680777379,MATH 18,B01,188353,Bach; Quang Tran,11,0,30,19
1683680777379,MATH 18,B02,188354,Bach; Quang Tran,19,0,30,11
1683680778404,MATH 20A,A01,188374,Staff,11,0,35,24
1683680779432,MATH 20B,A01,188382,Ohm; Ko Woon,7,0,30,23
1683680779432,MATH 20B,A02,188383,Ohm; Ko Woon,22,0,30,8
1683680779432,MATH 20B,B01,188385,Ohm; Ko Woon,7,0,30,23
1683680779432,MATH 20B,B02,188392,Ohm; Ko Woon,22,0,30,8
1683680780455,MATH 20C,A01,188394,Harel; Guershon,10,0,30,20
1683680780455,MATH 20C,A02,188395,Harel; Guershon,13,0,30,17
1683680780455,MATH 20C,B01,188404,Harel; Guershon,5,0,30,25
1683680780455,MATH 20C,B02,188405,Harel; Guershon,18,0,30,12
1683680781489,MATH 20D,A01,188414,Hammock; Frances H,0,1,30,30
1683680781489,MATH 20D,A02,188415,Hammock; Frances H,0,1,30,30
1683680781489,MATH 20D,B01,188447,Hammock; Frances H,0,1,30,30
1683680781489,MATH 20D,B02,188486,Hammock; Frances H,3,0,30,27
1683680782517,MATH 20E,A01,188649,Staff,21,0,30,9
1683680782517,MATH 20E,A02,188650,Staff,20,0,30,10
1683680782517,MATH 20E,A03,188673,Staff,0,0,30,30
1683680783541,MATH 102,A01,188675,Staff,0,39,35,35
1683680784568,MATH 103B,A01,188681,Staff,3,0,35,32
1683680784568,MATH 103B,B01,188692,Staff,5,0,35,30
1683680785592,MATH 109,A01,188695,Salehi Golsefidy; Alireza,24,0,35,11
1683680785592,MATH 109,A02,188696,Salehi Golsefidy; Alireza,25,0,35,10
1683680786616,MATH 120A,A01,188698,Eggers; John Dietrich,7,0,35,28
1683680787641,MATH 142B,A01,188736,Ioana; Adrian,1,1,30,29
1683680787641,MATH 142B,A02,188741,Ioana; Adrian,0,1,30,30
1683680787641,MATH 142B,A03,188743,Ioana; Adrian,0,1,30,30
1683680788665,MATH 168A,A01,188790,Staff,0,11,35,35
1683680789689,MATH 170A,A01,188803,Nie; Jiawang,0,2,35,35
1683680789689,MATH 170A,A02,188811,Nie; Jiawang,0,1,35,35
1683680789689,MATH 170A,A03,188814,Nie; Jiawang,0,0,35,35
1683680789689,MATH 170A,A04,188815,Nie; Jiawang,6,0,35,29
1683680790717,MATH 193B,A01,188817,Staff,0,0,35,35
1683680790717,MATH 193B,A02,188818,Staff,5,0,35,30
1683680791741,MGT 4,A01,202857,Anderson; John Charles,60,0,80,20
1683680792765,MGT 12,A00,202858,Lindenberger; Wade Douglas,40,0,90,50
1683680793792,MGT 18,A00,202859,Staff,74,0,90,16
1683680794818,MGT 18GS,A00,202860,McKay; Michael J,13,0,28,15
1683680795842,MGT 45,A00,202861,Pecore; Joseph P.,9,0,90,81
1683680796866,MGT 100,A00,202863,Yavorsky; Daniel Ryan,28,0,90,62
1683680797892,MGT 103,A00,202864,Ehrich; Kristine R,0,18,90,90
1683680798916,MGT 112,A00,202865,Ehrich; Kristine R,15,0,90,75
1683680799944,MGT 121A,A00,202868,Staff,90,20,90,0
1683680800968,MGT 131B,A00,202869,Anderson; John Charles,59,0,90,31
1683680801993,MGT 136,A00,202871,Lindenberger; Wade Douglas,83,0,90,7
1683680803017,MGT 164,A00,202873,Staff,0,67,90,91
1683680804039,MGT 164GS,A00,202874,McKay; Mary A,13,0,28,15
1683680805066,MGT 180,A00,202875,Staff,0,51,90,91
1683680806090,MMW 11R,A01,205019,Herbst; Matthew,0,0,30,30
1683680806090,MMW 11R,A02,205026,Herbst; Matthew,29,0,30,1
1683680807116,MMW 15,A01,193512,Chang; Edmond Yi-Teh,0,8,28,28
1683680807116,MMW 15,A02,193513,Chang; Edmond Yi-Teh,0,5,28,28
1683680807116,MMW 15,A03,193514,Chang; Edmond Yi-Teh,0,5,28,28
1683680807116,MMW 15,A04,193515,Chang; Edmond Yi-Teh,0,5,28,28
1683680807116,MMW 15,A05,193516,Chang; Edmond Yi-Teh,0,5,28,28
1683680807116,MMW 15,A06,193517,Chang; Edmond Yi-Teh,0,6,28,28
1683680807116,MMW 15,B01,193519,Chang; Edmond Yi-Teh,0,5,28,28
1683680807116,MMW 15,B02,193520,Chang; Edmond Yi-Teh,0,5,28,28
1683680807116,MMW 15,B03,193521,Chang; Edmond Yi-Teh,0,5,28,28
1683680807116,MMW 15,B04,193522,Chang; Edmond Yi-Teh,0,6,28,28
1683680807116,MMW 15,B05,193523,Chang; Edmond Yi-Teh,0,5,28,28
1683680807116,MMW 15,B06,193524,Chang; Edmond Yi-Teh,0,5,28,28
1683680808139,MMW 122,A01,193526,Rahimi; Babak,0,16,28,28
1683680808139,MMW 122,A02,193527,Rahimi; Babak,0,15,28,28
1683680808139,MMW 122,A03,193528,Rahimi; Babak,0,0,0,0
1683680808139,MMW 122,A04,193529,Rahimi; Babak,0,0,0,0
1683680809171,MUS 1A,A01,186663,Staff,1,19,35,34
1683680810197,MUS 4,A01,186715,Staff,0,12,35,35
1683680811220,MUS 5R,A01,186796,Dubnov; Shlomo,0,17,35,35
1683680812244,MUS 6,A01,186798,Staff,1,5,25,24
1683680813268,MUS 7,A01,186830,Staff,11,0,35,24
1683680814292,MUS 8,A01,186930,Staff,0,27,35,35
1683680815319,MUS 15,A01,186932,Staff,0,15,35,35
1683680815319,MUS 15,B01,186934,Staff,1,17,35,34
1683680816344,MUS 80,A00,186935,Staff,0,0,20,20
1683680816344,MUS 80,B00,186936,Staff,24,0,25,1
1683680817368,NANO 11,A00,204702,Lipomi; Darren John,0,0,0,0
1683680818392,NANO 15,A01,204709,Yang; Kesong,0,1,0,0
1683680819420,NANO 114,A00,202069,Jahed Motlagh; Zeinab,3,0,10,7
1683680820443,PHIL 1,A00,186955,Grush; Rick Scott,31,0,40,9
1683680821473,PHIL 10,A01,186973,Grush; Rick Scott,27,0,35,8
1683680821473,PHIL 10,A02,186974,Grush; Rick Scott,33,0,35,2
1683680822499,PHIL 13,A01,186976,Staff,2,0,35,33
1683680822499,PHIL 13,A02,186977,Staff,16,0,35,19
1683680823527,PHIL 14,A01,186979,Staff,31,0,35,4
1683680823527,PHIL 14,A02,186986,Staff,32,0,35,3
1683680824553,PHIL 28,A01,186988,Staff,16,0,30,14
1683680824553,PHIL 28,A02,186989,Staff,1,0,30,29
1683680824553,PHIL 28,A03,186990,Staff,10,0,30,20
1683680824553,PHIL 28,A04,186991,Staff,26,0,30,4
1683680825578,PHIL 120,A00,186997,Staff,23,0,40,17
1683680826603,PHIL 137,A00,187003,Staff,7,0,40,33
1683680827628,PHIL 150,A00,187015,Staff,47,0,70,23
1683680828653,PHIL 167,A00,187021,Lamey; Andy M.,34,0,40,6
1683680829677,PHIL 174,A01,202226,Staff,17,0,20,3
1683680829677,PHIL 174,A02,202235,Staff,20,0,20,0
1683680830704,PHIL 191A,A00,258918,Staff,0,0,1,1
1683680831729,PHYS 1A,A00,187028,Staff,26,0,60,34
1683680832754,PHYS 1AL,001,187036,Staff,3,0,30,27
1683680832754,PHYS 1AL,002,187049,Staff,18,0,30,12
1683680833778,PHYS 1B,A00,187058,Staff,22,0,60,38
1683680834805,PHYS 1BL,001,187064,Staff,0,1,30,30
1683680834805,PHYS 1BL,002,187070,Staff,4,0,30,26
1683680835832,PHYS 1C,A00,187082,Staff,29,0,120,91
1683680836860,PHYS 1CL,001,187088,Staff,0,9,30,30
1683680836860,PHYS 1CL,002,187089,Staff,0,1,30,30
1683680836860,PHYS 1CL,009,262693,Staff,9,0,30,21
1683680837887,PHYS 2B,A01,187097,Staff,55,0,115,60
1683680838912,PHYS 2C,A01,187099,Staff,63,0,115,52
1683680839937,PHYS 2CL,A01,187101,Staff,5,0,28,23
1683680839937,PHYS 2CL,A02,187102,Staff,15,0,28,13
1683680840962,PHYS 2D,A01,187123,Shotwell; Brian,95,0,115,20
1683680841988,PHYS 4B,A01,187133,Grinstein; Benjamin,35,0,50,15
1683680843014,POLI 10,A00,188819,Staff,0,4,50,50
1683680844040,POLI 11,A00,188827,Staff,43,0,50,7
1683680845066,POLI 13R,A00,188828,Staff,0,1,20,20
1683680846095,POLI 27,A01,188830,Elgin; Samuel Zincke,0,2,70,70
1683680847124,POLI 30,A00,188832,Desposato; Scott,30,0,50,20
1683680848202,POLI 102F,A00,188834,Staff,0,0,40,40
1683680849229,POLI 104A,A00,188852,Staff,12,0,30,18
1683680850253,POLI 104I,A00,188853,Staff,0,8,20,20
1683680851277,POLI 110B,A00,188854,Wiens; David,6,0,20,14
1683680852300,POLI 112A,A00,188855,Wiens; David,3,0,30,27
1683680853324,POLI 117R,A00,188856,Forman; Fonna,0,12,20,20
1683680854347,POLI 118,A00,188857,Ingham; Sean,8,0,20,12
1683680855372,POLI 120G,A00,188858,Staff,8,0,30,22
1683680856396,POLI 131CR,A00,188863,Hoston; Germaine,20,0,50,30
1683680857420,POLI 133,A00,188864,Nellis; Gareth Hb,44,0,50,6
1683680858444,POLI 134D,A00,188865,Desposato; Scott,27,0,30,3
1683680859471,POLI 142A,A00,188871,Gartzke; Erik,21,0,50,29
1683680860498,POLI 142K,A00,188874,Staff,38,0,50,12
1683680861522,POLI 143,A00,188940,Gartzke; Erik,16,0,30,14
1683680862548,POLI 153,A00,188943,Staff,2,0,20,18
1683680863572,POLI 160AA,A00,188944,Staff,10,0,40,30
1683680864598,POLI 170A,A00,188945,Staff,10,0,30,20
1683680866653,PSYC 1,A00,188952,Staff,36,0,90,54
1683680867679,PSYC 2,B00,188953,Staff,19,0,35,16
1683680868703,PSYC 6,A00,188970,Staff,47,0,60,13
1683680869726,PSYC 7,A00,188973,Staff,35,0,45,10
1683680870753,PSYC 60,A01,188980,Rickard; Timothy C.,42,0,60,18
1683680871776,PSYC 70,A01,189001,Steiner; Eric Tomas,21,0,45,24
1683680872806,PSYC 100,A00,189005,Lacefield; Katharine I,0,99,120,120
1683680873830,PSYC 102,A00,189008,Staff,7,0,30,23
1683680874857,PSYC 106,B00,189026,Gorman; Michael R.,27,0,60,33
1683680875884,PSYC 114,B01,189033,Winkielman; Piotr,0,31,30,30
1683680876909,PSYC 131,A00,189036,Anagnostaras; Stephan,0,43,60,60
1683680877934,PSYC 136,A00,189041,Lowe; Angela Beth,0,7,25,25
1683680878958,PSYC 137,A00,189057,Winkielman; Piotr,1,37,25,24
1683680879986,PSYC 144,A00,189107,Wixted; John T,0,11,50,50
1683680882036,PSYC 162,A00,189142,Staff,0,9,85,85
1683680883064,PSYC 172,A00,189144,Gorman; Michael R.,0,6,30,30
1683680885119,PSYC 179,A00,189146,Lacefield; Katharine I,0,87,120,120
1683680886143,PSYC 181,A00,189147,Anagnostaras; Stephan,0,44,90,90
1683680887171,PSYC 190R,A00,189148,Barner; David A.,0,23,80,80
1683680888202,PSYC 191,A00,189275,Rickard; Timothy C.,0,10,25,25
1683680889228,PSYC 193,A00,189276,Chapman; Eddie Nathaniel,0,1,0,4
1683680890254,PSYC 193L,A01,189281,Lowe; Angela Beth,8,0,20,12
1683680890254,PSYC 193L,B01,189285,Staff,28,0,35,7
1683680891280,RELI 149,A00,187137,Rahimi; Babak,7,0,40,33
1683680892305,SE 9,A01,187315,Staff,0,2,18,18
1683680893329,SE 101B,A00,187409,Staff,24,0,30,6
1683680894354,SE 110B,A00,187444,Staff,10,0,40,30
1683680895378,SE 130B,A00,187449,Staff,31,0,40,9
1683680896404,SE 150A,A00,187516,Staff,8,0,20,12
1683680897428,SE 154,A00,187528,Staff,29,0,50,21
1683680898452,SIO 3,A01,258171,Staff,35,0,40,5
1683680899480,SIO 10,A00,187144,Cook; Geoffrey W,1,7,75,74
1683680900504,SIO 45,A00,187152,Cook; Geoffrey W,0,7,100,100
1683680901531,SIO 109R,A00,194486,Staff,0,4,20,20
1683680903586,SIO 187,A01,187233,Kacev; David,12,0,40,28
1683680904614,SOCI 1,A01,258656,Thorpe; Charles Robert,28,0,30,2
1683680904614,SOCI 1,A02,258658,Thorpe; Charles Robert,30,0,30,0
1683680904614,SOCI 1,A03,258661,Thorpe; Charles Robert,25,0,25,0
1683680904614,SOCI 1,A04,258666,Thorpe; Charles Robert,22,0,25,3
1683680904614,SOCI 1,A05,258897,Thorpe; Charles Robert,22,0,25,3
1683680904614,SOCI 1,A06,258898,Thorpe; Charles Robert,25,0,25,0
1683680905638,SOCI 30,A01,258903,Pardo Guerra; Juan Pablo,14,0,30,16
1683680906662,SOCI 102,A00,258904,Staff,9,0,25,16
1683680907690,SOCI 106,A00,258905,Staff,19,0,25,6
1683680908713,SOCI 111,A00,258907,Ribas Norris; Janet Vanesa,26,0,30,4
1683680909738,SOCI 121R,A00,258908,Pardo Guerra; Juan Pablo,8,0,30,22
1683680910762,SOCI 126,A01,203330,Staff,14,0,20,6
1683680911788,SOCI 131,A00,258909,Thorpe; Charles Robert,30,0,60,30
1683680912820,SOCI 135,A00,258910,Payne; Christine Anna,0,12,30,30
1683680913845,SOCI 157,A00,258911,Staff,11,0,30,19
1683680914869,SOCI 184,A00,258912,Staff,25,0,30,5
1683680915892,SOCI 188D,A00,258913,Staff,22,0,30,8
1683680916919,SYN 2,001,187529,Staff,9,0,16,7
1683680916919,SYN 2,002,201452,Staff,1,20,16,15
1683680916919,SYN 2,003,201469,Staff,1,0,16,15
1683680917943,SYN 100,A01,187531,Staff,0,9,20,20
1683680917943,SYN 100,B01,201491,Staff,0,10,20,20
1683680918969,TDAC 1,A00,189286,Walsh; Kim C.,3,0,20,17
1683680918969,TDAC 1,B00,189287,Harting; Carla Kelso,10,0,20,10
1683680919993,TDAC 101,A00,189300,Walsh; Kim C.,16,0,20,4
1683680919993,TDAC 101,B00,189301,Harting; Carla Kelso,18,0,20,2
1683680921018,TDAC 102,A00,189304,Basso; Beatrice,14,0,20,6
1683680922040,TDAC 108,A00,189305,Staff,18,0,20,2
1683680923065,TDDE 131,A00,189310,Staff,19,0,20,1
1683680923065,TDDE 131,B00,189314,Staff,19,0,20,1
1683680923065,TDDE 131,C00,189315,Staff,48,0,50,2
1683680923065,TDDE 131,D00,189316,Staff,14,0,15,1
1683680923065,TDDE 131,E00,204841,Staff,20,0,20,0
1683680924094,TDGE 10,A00,189289,Staff,27,0,50,23
1683680924094,TDGE 10,B00,189290,Havis; Allan,0,1,50,50
1683680925122,TDGE 11,A00,189291,Fulton; Julia,0,4,50,50
1683680925122,TDGE 11,B00,189292,Staff,20,0,25,5
1683680925122,TDGE 11,C00,260270,Staff,0,0,0,0
1683680926145,TDGE 25,A00,189294,Staff,1,0,20,19
1683680927169,TDGE 124,A00,189318,Fulton; Julia,0,8,50,50
1683680928193,TDGE 125,A00,189319,Staff,13,0,25,12
1683680928193,TDGE 125,B00,189320,Staff,23,0,25,2
1683680929219,TDGE 127,A00,189322,Havis; Allan,0,0,50,50
1683680930245,TDHT 101,A00,189323,Staff,18,0,25,7
1683680930245,TDHT 101,B00,189324,Staff,25,0,25,0
1683680931270,TDHT 102,A00,189325,Staff,49,0,50,1
1683680932293,TDMV 1,A00,189295,Arcidiacono; Kristin,20,0,30,10
1683680932293,TDMV 1,B00,189296,Caligagan; Maria T.,24,0,30,6
1683680933317,TDMV 2,A00,189297,Sammartano; Tonnie,27,0,30,3
1683680933317,TDMV 2,B00,189299,Arcidiacono; Kristin,23,0,30,7
1683680934341,TDMV 3,A00,204998,Rincon; Alicia,22,0,30,8
1683680935366,TDMV 120,A00,189458,Sammartano; Tonnie,28,0,30,2
1683680936390,TDMV 138,A00,189541,Jun; Grace Shin Hae,20,0,40,20
1683680937413,TDMV 142,A00,189717,Caligagan; Tony,25,0,30,5
1683680937413,TDMV 142,B00,189718,Caligagan; Maria T.,25,0,30,5
1683680938438,TMC 2,A01,187533,Staff,25,0,25,0
1683680938438,TMC 2,A02,187534,Staff,25,0,25,0
1683680939462,USP 1,A01,187536,Kwak; Nancy,0,16,25,25
1683680940486,USP 5,A01,187538,Staff,8,0,25,17
1683680941512,USP 101,A00,199253,Staff,0,4,0,0
1683680942536,USP 124,A00,187562,Boomhower; Matthew Charles,0,0,30,30
1683680943564,USP 138,A00,187582,Staff,19,0,25,6
1683680944597,USP 152,A01,187597,Staff,3,0,25,22
1683680945620,USP 153,A00,187598,Staff,18,0,25,7
1683680946645,USP 168,A00,187607,Kwak; Nancy,2,0,5,3
1683680947670,USP 173,A00,187619,Staff,4,0,25,21
1683680948693,USP 181,A00,187638,Staff,0,4,25,25
1683680949716,VIS 103,A00,187650,Cruz; Edwin Teddy,17,0,75,58
1683680950740,VIS 110D,A00,187669,Staff,13,0,22,9
1683680951821,VIS 127C,A00,187720,Shen; Kuiyi,67,0,146,79
1683680952848,VIS 149,A00,187731,Yoldas; Pinar,1,14,22,21
1683680953875,VIS 151,A01,188091,Staff,22,0,34,12
1683680953875,VIS 151,A02,188092,Staff,11,0,34,23
1683680954900,VIS 160B,A00,188093,Stalbaum; Brett,0,1,10,10
1683680956953,WCWP 10B,A00,201720,Staff,0,0,5,5
1683680956953,WCWP 10B,B00,201722,Staff,0,0,6,6
1683680957979,WCWP 100,A00,201725,Gagnon; Jeffrey C,0,0,2,2
1683680957979,WCWP 100,B00,201727,Staff,0,4,15,15
1683680961069,ANBI 133,A00,258401,Wilder; Linnea Lorene,34,0,40,6
1683680962094,ANBI 140,A00,258395,Hrvoj Mihic; Branka,18,0,25,7
1683680963119,ANSC 120,A00,258402,Bialecki; Jon Anthony,26,0,40,14
1683680964147,ANSC 144,A00,258400,Staff,12,0,40,28
1683680966194,ANSC 166,A00,258396,Parish; Steven Martin,156,0,175,19
1683680967218,ANSC 180,A00,193533,Staff,8,0,20,12
1683680968245,ANSC 188,A00,258397,Jassal; Aftab,34,0,40,6
1683680969272,ANTH 3,A01,258316,Staff,23,0,30,7
1683680970299,ANTH 5,A00,258394,Semendeferi; Ekaterini,16,0,20,4
1683680971326,ANTH 21,A01,258331,Staff,4,0,40,36
1683680972350,ANTH 103,A00,258398,Varma; Saiba,15,0,25,10
1683680973378,AWP 10,001,202034,Staff,0,0,0,0
1683680973378,AWP 10,002,202035,Staff,0,0,0,0
1683680973378,AWP 10,003,202036,Staff,0,0,0,0
1683680973378,AWP 10,004,202037,Staff,0,0,0,0
1683680973378,AWP 10,005,202038,Staff,0,0,0,0
1683680973378,AWP 10,006,202039,Staff,0,0,0,0
1683680973378,AWP 10,007,202040,Staff,0,0,0,0
1683680973378,AWP 10,008,202041,Staff,0,0,0,0
1683680973378,AWP 10,009,202042,Staff,0,0,0,0
1683680973378,AWP 10,010,202043,Staff,0,0,0,0
1683680973378,AWP 10,011,202044,Staff,0,0,0,0
1683680973378,AWP 10,012,202045,Staff,0,0,0,0
1683680973378,AWP 10,013,202046,Staff,0,0,0,0
1683680973378,AWP 10,014,202047,Staff,0,0,0,0
1683680973378,AWP 10,015,202048,Staff,0,0,0,0
1683680973378,AWP 10,016,202049,Staff,0,0,0,0
1683680973378,AWP 10,017,202050,Staff,0,0,0,0
1683680973378,AWP 10,018,202051,Staff,0,0,0,0
1683680973378,AWP 10,019,202052,Staff,0,0,0,0
1683680973378,AWP 10,020,202053,Staff,0,0,0,0
1683680973378,AWP 10,021,202054,Staff,0,0,0,0
1683680973378,AWP 10,022,202055,Staff,0,0,0,0
1683680973378,AWP 10,023,202056,Staff,0,0,0,0
1683680973378,AWP 10,024,202057,Staff,0,0,0,0
1683680973378,AWP 10,025,202058,Staff,0,0,0,0
1683680973378,AWP 10,026,202059,Staff,0,0,0,0
1683680974404,AWP 102,001,202032,Staff,0,0,0,0
1683680974404,AWP 102,002,202033,Staff,0,0,0,0
1683680975428,BENG 100,A01,254234,Taylor Amos; Alyssa C,31,0,40,9
1683680976453,BENG 196,001,270013,Engler; Adam J.,9999,0,9999,0
1683680977477,BICD 100R,A01,202018,Smith; Laurie,0,7,32,32
1683680977477,BICD 100R,A02,202019,Smith; Laurie,0,3,32,32
1683680977477,BICD 100R,A03,202020,Smith; Laurie,0,1,32,32
1683680977477,BICD 100R,A04,202021,Smith; Laurie,6,0,32,26
1683680977477,BICD 100R,A05,202022,Smith; Laurie,10,0,32,22
1683680978504,BICD 136,A01,193242,Gustafson-Brown; Cindy,0,2,32,32
1683680978504,BICD 136,A02,193244,Gustafson-Brown; Cindy,13,0,32,19
1683680979531,BIEB 102,A01,193249,Butler; Shannon Rhey,1,1,32,31
1683680979531,BIEB 102,A02,193251,Butler; Shannon Rhey,0,0,32,32
1683680979531,BIEB 102,A03,193253,Butler; Shannon Rhey,0,0,32,32
1683680979531,BIEB 102,A04,193255,Butler; Shannon Rhey,13,0,32,19
1683680979531,BIEB 102,A05,193265,Butler; Shannon Rhey,25,0,32,7
1683680979531,BIEB 102,A06,193269,Butler; Shannon Rhey,13,0,32,19
1683680981579,BIEB 150,A01,193274,Staff,0,0,32,32
1683680981579,BIEB 150,A02,193285,Staff,24,0,32,8
1683680982605,BIEB 194,A00,193286,Kurle; Carolyn M.,19,0,32,13
1683680983630,BILD 1,A01,192291,Staff,15,0,32,17
1683680983630,BILD 1,A02,192292,Staff,30,0,32,2
1683680983630,BILD 1,B01,192520,Reuther; Keefe,0,1,0,0
1683680983630,BILD 1,B02,192532,Reuther; Keefe,0,1,0,0
1683680984653,BILD 3,A01,192556,Butler; Shannon Rhey,0,0,32,32
1683680984653,BILD 3,A02,192581,Butler; Shannon Rhey,0,1,32,32
1683680984653,BILD 3,A03,192611,Butler; Shannon Rhey,19,0,32,13
1683680984653,BILD 3,A04,192612,Butler; Shannon Rhey,24,0,32,8
1683680984653,BILD 3,A05,192613,Butler; Shannon Rhey,26,0,32,6
1683680984653,BILD 3,A06,192679,Butler; Shannon Rhey,27,0,32,5
1683680984653,BILD 3,A07,192682,Butler; Shannon Rhey,20,0,32,12
1683680985682,BILD 4,A01,192836,Reuther; Keefe,1,0,24,23
1683680985682,BILD 4,A02,193044,Reuther; Keefe,4,0,24,20
1683680986705,BILD 10,A01,193142,Gustafson-Brown; Cindy,29,0,32,3
1683680986705,BILD 10,A02,193149,Gustafson-Brown; Cindy,31,0,32,1
1683680987729,BIMM 100,A01,193301,Staff,0,6,32,32
1683680987729,BIMM 100,A02,193312,Staff,0,7,32,32
1683680987729,BIMM 100,A03,193323,Staff,0,10,32,32
1683680988759,BIMM 101,A01,193329,McDonnell; Lisa Marie,1,4,24,23
1683680988759,BIMM 101,A02,193339,McDonnell; Lisa Marie,1,4,24,23
1683680988759,BIMM 101,B01,193354,McDonnell; Lisa Marie,0,4,24,24
1683680988759,BIMM 101,B02,193357,McDonnell; Lisa Marie,0,3,24,24
1683680989787,BIMM 110,A01,193377,Tat; John,0,11,32,32
1683680989787,BIMM 110,A02,193378,Tat; John,0,11,32,32
1683680990814,BIMM 120,A01,206116,Staff,0,0,32,32
1683680990814,BIMM 120,A02,206117,Staff,7,0,32,25
1683680990814,BIMM 120,A03,206121,Staff,21,0,32,11
1683680991838,BIPN 100,A01,193393,Park; Ji Young,0,15,32,32
1683680991838,BIPN 100,A02,193402,Park; Ji Young,0,14,32,32
1683680991838,BIPN 100,A03,193413,Park; Ji Young,0,14,32,32
1683680991838,BIPN 100,A04,193414,Park; Ji Young,0,13,32,32
1683680992863,BIPN 102,A01,193429,Staff,0,0,32,32
1683680992863,BIPN 102,A02,193438,Staff,18,0,32,14
1683680993888,BIPN 106,A01,193450,Reyes Gonzalez; Catalina,0,2,40,40
1683680994917,BIPN 134,A01,193465,Cooke; James Edward,0,0,32,32
1683680994917,BIPN 134,A02,193474,Cooke; James Edward,25,0,32,7
1683680994917,BIPN 134,A03,193485,Cooke; James Edward,29,0,32,3
1683680994917,BIPN 134,A04,193486,Cooke; James Edward,20,0,32,12
1683680994917,BIPN 134,A05,193491,Cooke; James Edward,31,0,32,1
1683680994917,BIPN 134,A06,193501,Cooke; James Edward,30,0,32,2
1683680994917,BIPN 134,A07,193510,Cooke; James Edward,29,0,32,3
1683680996970,BISP 194,A00,222522,Staff,14,0,32,18
1683680997997,CAT 124,A01,202407,Staff,19,0,25,6
1683680999022,CAT 125,A00,202408,Marchisotto; Jennifer Anne,2,0,20,18
1683681000055,CAT 125R,A00,202409,Smith; Lauryn Alissa,0,11,20,20
1683681000055,CAT 125R,B00,202410,Morales; Celeste Georgianna,0,11,20,20
1683681000055,CAT 125R,C00,202411,Irwin; Matthew Joseph,0,12,20,20
1683681001083,CENG 15,A01,204712,Yang; Kesong,0,1,0,0
1683681002110,CENG 114,A00,202070,Jahed Motlagh; Zeinab,5,0,20,15
1683681003135,CGS 105,A00,185477,Wesling; Megan E.,24,0,40,16
1683681004160,CGS 106,A00,185494,Staff,11,0,22,11
1683681005185,CGS 108,A00,185495,Staff,14,0,20,6
1683681006208,CGS 114,A00,185496,Staff,13,0,18,5
1683681007233,CGS 119,A00,185501,Staff,15,0,20,5
1683681008257,CGS 120,A00,185511,Staff,12,0,20,8
1683681009285,CHEM 4,A01,184675,Bussey; Thomas J,97,0,100,3
1683681010311,CHEM 6A,A01,184677,Staff,32,0,60,28
1683681011336,CHEM 6B,A01,184679,Staff,63,0,100,37
1683681012362,CHEM 6C,A01,184681,Bussey; Thomas J,0,0,50,50
1683681012362,CHEM 6C,A02,184682,Bussey; Thomas J,32,0,50,18
1683681013391,CHEM 40A,A01,184684,Albizati; Kim F.,33,0,100,67
1683681014419,CHEM 40B,A01,184686,Albizati; Kim F.,0,22,100,100
1683681015447,CHEM 41B,A01,184690,Staff,51,0,100,49
1683681016474,COGS 3,A01,184715,Boyle; Mary E. T.,0,27,40,40
1683681017505,COGS 14B,A01,185172,Staff,0,14,38,38
1683681018534,COGS 18,A01,184736,Staff,14,0,80,66
1683681019556,COGS 100,A01,184932,Staff,0,8,73,73
1683681020584,COGS 101A,A01,184935,Staff,0,40,30,30
1683681021608,COGS 101B,A01,184944,Staff,0,2,30,30
1683681022632,COGS 101C,A01,184946,Staff,0,10,30,30
1683681023659,COGS 102A,A01,184951,Johnson; Christine M.,2,0,40,38
1683681024683,COGS 107B,A01,184953,Mooshagian; Eric Frederick,0,52,40,40
1683681025711,COGS 118B,A01,184959,Gupta; Anjum,0,50,40,40
1683681026738,COGS 153,A00,184961,Staff,0,16,30,30
1683681027761,COGS 177,A00,184962,Staff,0,21,30,30
1683681028788,COGS 187A,A01,184969,Boyle; Mary E. T.,0,19,40,40
1683681029812,COMM 10,A01,185174,Staff,0,5,25,25
1683681029812,COMM 10,A02,185189,Staff,0,2,25,25
1683681029812,COMM 10,A03,269821,Staff,0,1,0,0
1683681030834,COMM 100B,A02,185476,Staff,11,0,25,14
1683681030834,COMM 100B,A03,277340,Staff,25,0,25,0
1683681031858,COMM 100C,A01,185314,Staff,1,0,25,24
1683681031858,COMM 100C,A02,185327,Staff,17,0,25,8
1683681032881,COMM 110M,A00,185349,Staff,0,0,40,40
1683681033906,COMM 113T,A00,185352,Staff,25,0,40,15
1683681034931,COMM 114I,A00,185353,Staff,31,0,40,9
1683681035955,COMM 131,A00,185354,Staff,17,0,30,13
1683681036979,CSE 8A,A50,185358,Cao; Yingjun,0,46,10,10
1683681038002,CSE 8B,A01,185362,Staff,0,48,50,50
1683681039025,CSE 11,A01,185416,Cao; Yingjun,0,91,10,10
1683681040049,CSE 20,A01,185445,Briones; Jor-el Thomas Caparas,3,0,25,22
1683681041076,CSE 21,A01,185447,Staff,9,0,50,41
1683681042103,CSE 101,A01,185451,Staff,0,13,50,50
1683681042103,CSE 101,B01,185453,Jones; Miles E,0,14,50,50
1683681044152,CSE 141,A01,185458,Eldon; John,16,0,100,84
1683681045177,CSE 141L,A01,185461,Eldon; John,8,0,100,92
1683681046205,CSE 142,A01,185463,Staff,34,0,60,26
1683681046205,CSE 142,B01,201355,Staff,0,7,60,60
1683681047232,CSE 142L,A01,185470,Staff,34,0,60,26
1683681047232,CSE 142L,B01,201417,Staff,0,6,60,60
1683681048260,CSE 190,A00,201433,Staff,32,0,49,17
1683681049288,DOC 1,A01,259136,Strom; Megan C.,7,0,15,8
1683681049288,DOC 1,A02,259137,Strom; Megan C.,14,0,15,1
1683681049288,DOC 1,A03,259138,Strom; Megan C.,14,0,15,1
1683681049288,DOC 1,A04,259139,Strom; Megan C.,14,0,15,1
1683681050316,DOC 100D,A00,259140,Pass; Natalye Joann,14,0,25,11
1683681051339,DSGN 1,A01,184749,Rill; Bryan,0,26,30,30
1683681052362,DSGN 100,A01,185168,Staff,0,2,25,25
1683681053385,ECE 5,A01,185626,Morris; Karcher William,0,12,0,0
1683681054409,ECE 101,A01,185628,Staff,14,0,70,56
1683681055492,ECE 107,A01,185635,Baghdadchi; Saharnaz,0,0,20,20
1683681055492,ECE 107,A02,185638,Baghdadchi; Saharnaz,1,0,20,19
1683681056515,ECE 148,A01,185647,Silberman; Jack,0,0,16,16
1683681057542,ECON 1,A01,185537,Crane; Meredith Helen,54,0,70,16
1683681058568,ECON 3,A01,185549,Crane; Meredith Helen,30,0,70,40
1683681059596,ECON 4,A01,203354,Anderson; John Charles,0,5,10,10
1683681060622,ECON 100A,A01,185574,Staff,0,5,40,40
1683681061646,ECON 100B,A01,185576,Staff,0,12,50,50
1683681062670,ECON 100C,A01,185589,Newhouse; Herbert S,30,0,70,40
1683681063698,ECON 105,A00,185608,Vespa; Emanuel Ignacio,19,0,35,16
1683681064731,ECON 109,A01,185610,Shishkin; Denis,9,0,35,26
1683681065756,ECON 110A,A01,185612,Staff,9,0,40,31
1683681066781,ECON 120A,A01,185615,Staff,19,0,40,21
1683681067806,ECON 120C,A01,185617,Sun; Yixiao,0,21,70,70
1683681068833,ECON 144,A00,203346,Squires; Dale E,2,0,35,33
1683681069857,ECON 171,A01,203349,Newhouse; Herbert S,0,1,35,35
1683681070882,ECON 173A,A01,185621,Toda; Alexis Akira,21,0,35,14
1683681071908,EDS 25,A01,202413,Staff,0,1,0,0
1683681071908,EDS 25,A02,202414,Staff,0,1,0,0
1683681071908,EDS 25,A03,202415,Staff,0,0,0,0
1683681071908,EDS 25,A04,202416,Staff,0,1,0,0
1683681071908,EDS 25,A05,202439,Staff,0,0,0,0
1683681071908,EDS 25,A06,202440,Staff,0,0,0,0
1683681071908,EDS 25,B01,202631,Staff,0,0,0,0
1683681071908,EDS 25,B02,202632,Staff,0,0,0,0
1683681071908,EDS 25,B03,202639,Staff,0,0,0,0
1683681071908,EDS 25,B04,202640,Staff,0,0,0,0
1683681071908,EDS 25,B05,202643,Staff,0,0,0,0
1683681071908,EDS 25,B06,202644,Staff,0,0,0,0
1683681072933,EDS 38,A01,202659,Black; Alison Michelle,24,0,25,1
1683681073958,EDS 115,A00,202652,Staff,18,0,30,12
1683681074983,EDS 125,A00,202649,Staff,13,0,30,17
1683681076011,EDS 126,A01,203332,Staff,30,0,30,0
1683681077035,EDS 139,A00,202838,Staff,16,0,25,9
1683681078062,EDS 146,A01,202655,Staff,14,0,25,11
1683681079088,ENG 15,A00,185667,Staff,0,1,0,0
1683681079088,ENG 15,B00,185672,Staff,0,0,0,0
1683681079088,ENG 15,C00,185675,Staff,0,0,0,0
1683681079088,ENG 15,D00,185682,Staff,0,0,0,0
1683681079088,ENG 15,E00,185684,Staff,0,0,0,0
1683681080115,ETHN 103,A00,185710,Staff,0,8,35,35
1683681081143,ETHN 103A,A00,199228,Man; Simeon S,0,0,9,9
1683681082166,ETHN 109,A00,185711,Staff,15,0,35,20
1683681083191,ETHN 142,A00,185726,Staff,0,4,30,30
1683681084216,ETHN 163J,A00,199229,Man; Simeon S,5,0,8,3
1683681085240,ETHN 168,A00,185727,Staff,7,0,10,3
1683681086265,ETHN 182,A00,185728,Staff,0,0,35,35
1683681087289,ETHN 183,A00,185737,Staff,9,0,18,9
1683681088317,GLBH 111,A01,209361,Burgos; Jose L.,0,0,0,0
1683681090365,HIEU 104,A00,185792,Staff,14,0,20,6
1683681091388,HIEU 115,A00,185800,Staff,0,0,20,20
1683681092416,HIEU 128,A00,185801,Staff,0,9,20,20
1683681093442,HIEU 147,A00,185802,Staff,15,0,20,5
1683681094469,HIEU 154,A00,185823,Staff,11,0,20,9
1683681095494,HILA 102,A00,185826,Staff,14,0,20,6
1683681096518,HILD 2C,A01,185778,Staff,0,13,20,20
1683681097542,HILD 7B,A01,185780,Kwak; Nancy,0,17,32,32
1683681097542,HILD 7B,A02,185781,Kwak; Nancy,0,18,32,32
1683681098566,HILD 30,A01,185791,Staff,12,0,20,8
1683681099590,HISC 119,A00,185830,Golan; Tal,0,10,20,20
1683681100613,HITO 156GS,A00,185831,Patterson; Patrick H.,0,0,0,23
1683681101642,HIUS 103,A00,185832,Man; Simeon S,0,4,20,20
1683681102668,HIUS 117,A00,185836,Kwak; Nancy,2,0,20,18
1683681103693,HIUS 125,A00,185840,Man; Simeon S,0,2,23,23
1683681104721,HIUS 149,A00,185845,Staff,1,0,20,19
1683681105746,HUM 3,A01,185882,Zavodny; Tatiana Sophia,0,8,50,50
1683681105746,HUM 3,B01,185899,Caldwell; Michael Alan,0,18,50,50
1683681106775,HUM 3GS,A00,185900,Patterson; Patrick H.,0,0,0,23
1683681107801,HUM 4,A01,185938,Zroka; Amy Liane,28,0,50,22
1683681107801,HUM 4,B01,185956,Watkins; Eric,0,6,50,50
1683681107801,HUM 4,B02,202209,Watkins; Eric,0,5,50,50
1683681107801,HUM 4,B03,202210,Watkins; Eric,0,5,50,50
1683681108826,HUM 5,A01,185958,West; Geoffrey Scott,0,0,50,50
1683681108826,HUM 5,A02,202215,West; Geoffrey Scott,0,0,50,50
1683681109849,INTL 190,A00,185959,Gagnon; Jeffrey C,0,0,0,9
1683681109849,INTL 190,B00,185960,Lettieri; Michael Joseph,0,0,0,2
1683681110873,JAPN 180,A00,254509,Staff,5,0,30,25
1683681111901,LATI 10,A01,202853,Kennemore; Amy Michelle,4,0,35,31
1683681111901,LATI 10,A02,202854,Kennemore; Amy Michelle,3,0,35,32
1683681111901,LATI 10,A03,270054,Kennemore; Amy Michelle,30,0,30,0
1683681112926,LATI 180,A00,202855,Kennemore; Amy Michelle,11,0,20,9
1683681113954,LAWS 101,A00,201767,Golan; Tal,0,7,40,40
1683681114980,LIFR 1C,A00,185961,Staff,6,0,20,14
1683681116006,LIFR 1CX,A00,185962,Staff,7,0,20,13
1683681117030,LIFR 1D,A00,185963,Staff,7,0,20,13
1683681118055,LIFR 1DX,A00,185964,Staff,7,0,20,13
1683681119082,LIGN 101,A01,186039,Staff,43,0,50,7
1683681120109,LIGN 165,A00,186040,Staff,15,0,50,35
1683681121134,LTCS 108,A00,186041,Staff,5,0,10,5
1683681122158,LTCS 119,A00,186042,Staff,15,0,20,5
1683681123181,LTCS 130,A00,186043,Wesling; Megan E.,15,0,25,10
1683681125236,LTEA 138,A00,186119,Staff,14,0,40,26
1683681126263,LTEN 124,A00,186148,Staff,5,0,25,20
1683681127291,LTEN 178,A00,186149,Staff,7,0,15,8
1683681128318,LTEN 181,A00,186150,Blanco; John D,34,0,40,6
1683681129343,LTWL 120,A00,186160,Staff,19,0,25,6
1683681130368,LTWL 165,A00,186161,Staff,22,0,25,3
1683681131394,LTWR 100,A00,186162,Staff,0,5,15,15
1683681132417,LTWR 102,A00,186163,Doller; Ben,5,0,15,10
1683681133442,MAE 8,A01,186412,Staff,0,1,0,0
1683681134468,MAE 30B,A00,186445,Bahadori; Mohammad Yousef,81,0,100,19
1683681135492,MAE 40,A00,186592,Bewley; Thomas R,10,0,50,40
1683681136516,MAE 101B,A00,186593,Bahadori; Mohammad Yousef,80,0,100,20
1683681137543,MAE 105,A00,186594,Bandaru; Prabhakar,10,0,50,40
1683681138571,MAE 107,A00,186599,Pham; Hieu Tan,0,7,120,120
1683681139598,MAE 148,A01,186660,Silberman; Jack,3,0,16,13
1683681140625,MATH 10A,A01,188095,Staff,0,6,35,35
1683681141648,MATH 10B,A01,188097,Bowers; Adam R.,0,12,30,30
1683681141648,MATH 10B,A02,188099,Bowers; Adam R.,0,11,30,30
1683681141648,MATH 10B,B01,188104,Bowers; Adam R.,0,10,30,30
1683681141648,MATH 10B,B02,188106,Bowers; Adam R.,1,9,30,29
1683681142677,MATH 10C,A01,188111,Staff,0,20,30,30
1683681142677,MATH 10C,A02,188127,Staff,0,19,30,30
1683681142677,MATH 10C,A03,188131,Staff,0,19,30,30
1683681142677,MATH 10C,B01,188218,Staff,17,0,30,13
1683681142677,MATH 10C,B02,188244,Staff,13,0,30,17
1683681142677,MATH 10C,B03,188277,Staff,14,0,30,16
1683681143706,MATH 18,A01,188344,Bach; Quang Tran,18,0,30,12
1683681143706,MATH 18,A02,188345,Bach; Quang Tran,11,0,30,19
1683681143706,MATH 18,B01,188353,Bach; Quang Tran,11,0,30,19
1683681143706,MATH 18,B02,188354,Bach; Quang Tran,19,0,30,11
1683681144730,MATH 20A,A01,188374,Staff,11,0,35,24
1683681145761,MATH 20B,A01,188382,Ohm; Ko Woon,7,0,30,23
1683681145761,MATH 20B,A02,188383,Ohm; Ko Woon,22,0,30,8
1683681145761,MATH 20B,B01,188385,Ohm; Ko Woon,7,0,30,23
1683681145761,MATH 20B,B02,188392,Ohm; Ko Woon,22,0,30,8
1683681146786,MATH 20C,A01,188394,Harel; Guershon,10,0,30,20
1683681146786,MATH 20C,A02,188395,Harel; Guershon,13,0,30,17
1683681146786,MATH 20C,B01,188404,Harel; Guershon,5,0,30,25
1683681146786,MATH 20C,B02,188405,Harel; Guershon,18,0,30,12
1683681147815,MATH 20D,A01,188414,Hammock; Frances H,0,1,30,30
1683681147815,MATH 20D,A02,188415,Hammock; Frances H,0,1,30,30
1683681147815,MATH 20D,B01,188447,Hammock; Frances H,0,1,30,30
1683681147815,MATH 20D,B02,188486,Hammock; Frances H,3,0,30,27
1683681148841,MATH 20E,A01,188649,Staff,21,0,30,9
1683681148841,MATH 20E,A02,188650,Staff,20,0,30,10
1683681148841,MATH 20E,A03,188673,Staff,0,0,30,30
1683681149865,MATH 102,A01,188675,Staff,0,39,35,35
1683681150889,MATH 103B,A01,188681,Staff,3,0,35,32
1683681150889,MATH 103B,B01,188692,Staff,5,0,35,30
1683681151912,MATH 109,A01,188695,Salehi Golsefidy; Alireza,24,0,35,11
1683681151912,MATH 109,A02,188696,Salehi Golsefidy; Alireza,25,0,35,10
1683681152937,MATH 120A,A01,188698,Eggers; John Dietrich,7,0,35,28
1683681153962,MATH 142B,A01,188736,Ioana; Adrian,1,1,30,29
1683681153962,MATH 142B,A02,188741,Ioana; Adrian,0,1,30,30
1683681153962,MATH 142B,A03,188743,Ioana; Adrian,0,1,30,30
1683681154987,MATH 168A,A01,188790,Staff,0,11,35,35
1683681156011,MATH 170A,A01,188803,Nie; Jiawang,0,2,35,35
1683681156011,MATH 170A,A02,188811,Nie; Jiawang,0,1,35,35
1683681156011,MATH 170A,A03,188814,Nie; Jiawang,0,0,35,35
1683681156011,MATH 170A,A04,188815,Nie; Jiawang,6,0,35,29
1683681157039,MATH 193B,A01,188817,Staff,0,0,35,35
1683681157039,MATH 193B,A02,188818,Staff,5,0,35,30
1683681158068,MGT 4,A01,202857,Anderson; John Charles,60,0,80,20
1683681159151,MGT 12,A00,202858,Lindenberger; Wade Douglas,40,0,90,50
1683681160174,MGT 18,A00,202859,Staff,74,0,90,16
1683681161202,MGT 18GS,A00,202860,McKay; Michael J,13,0,28,15
1683681162227,MGT 45,A00,202861,Pecore; Joseph P.,9,0,90,81
1683681163254,MGT 100,A00,202863,Yavorsky; Daniel Ryan,28,0,90,62
1683681164277,MGT 103,A00,202864,Ehrich; Kristine R,0,18,90,90
1683681165306,MGT 112,A00,202865,Ehrich; Kristine R,15,0,90,75
1683681166332,MGT 121A,A00,202868,Staff,90,20,90,0
1683681167360,MGT 131B,A00,202869,Anderson; John Charles,59,0,90,31
1683681168386,MGT 136,A00,202871,Lindenberger; Wade Douglas,83,0,90,7
1683681169413,MGT 164,A00,202873,Staff,0,67,90,91
1683681170438,MGT 164GS,A00,202874,McKay; Mary A,13,0,28,15
1683681171465,MGT 180,A00,202875,Staff,0,51,90,91
1683681172492,MMW 11R,A01,205019,Herbst; Matthew,0,0,30,30
1683681172492,MMW 11R,A02,205026,Herbst; Matthew,29,0,30,1
1683681173517,MMW 15,A01,193512,Chang; Edmond Yi-Teh,0,8,28,28
1683681173517,MMW 15,A02,193513,Chang; Edmond Yi-Teh,0,5,28,28
1683681173517,MMW 15,A03,193514,Chang; Edmond Yi-Teh,0,5,28,28
1683681173517,MMW 15,A04,193515,Chang; Edmond Yi-Teh,0,5,28,28
1683681173517,MMW 15,A05,193516,Chang; Edmond Yi-Teh,0,5,28,28
1683681173517,MMW 15,A06,193517,Chang; Edmond Yi-Teh,0,6,28,28
1683681173517,MMW 15,B01,193519,Chang; Edmond Yi-Teh,0,5,28,28
1683681173517,MMW 15,B02,193520,Chang; Edmond Yi-Teh,0,5,28,28
1683681173517,MMW 15,B03,193521,Chang; Edmond Yi-Teh,0,5,28,28
1683681173517,MMW 15,B04,193522,Chang; Edmond Yi-Teh,0,6,28,28
1683681173517,MMW 15,B05,193523,Chang; Edmond Yi-Teh,0,5,28,28
1683681173517,MMW 15,B06,193524,Chang; Edmond Yi-Teh,0,5,28,28
1683681174546,MMW 122,A01,193526,Rahimi; Babak,0,16,28,28
1683681174546,MMW 122,A02,193527,Rahimi; Babak,0,15,28,28
1683681174546,MMW 122,A03,193528,Rahimi; Babak,0,0,0,0
1683681174546,MMW 122,A04,193529,Rahimi; Babak,0,0,0,0
1683681175573,MUS 1A,A01,186663,Staff,1,19,35,34
1683681176601,MUS 4,A01,186715,Staff,0,12,35,35
1683681177628,MUS 5R,A01,186796,Dubnov; Shlomo,0,17,35,35
1683681178655,MUS 6,A01,186798,Staff,1,5,25,24
1683681179682,MUS 7,A01,186830,Staff,11,0,35,24
1683681180705,MUS 8,A01,186930,Staff,0,27,35,35
1683681181729,MUS 15,A01,186932,Staff,0,15,35,35
1683681181729,MUS 15,B01,186934,Staff,1,17,35,34
1683681182754,MUS 80,A00,186935,Staff,0,0,20,20
1683681182754,MUS 80,B00,186936,Staff,24,0,25,1
1683681183778,NANO 11,A00,204702,Lipomi; Darren John,0,0,0,0
1683681184808,NANO 15,A01,204709,Yang; Kesong,0,1,0,0
1683681185836,NANO 114,A00,202069,Jahed Motlagh; Zeinab,3,0,10,7
1683681186863,PHIL 1,A00,186955,Grush; Rick Scott,31,0,40,9
1683681187891,PHIL 10,A01,186973,Grush; Rick Scott,27,0,35,8
1683681187891,PHIL 10,A02,186974,Grush; Rick Scott,33,0,35,2
1683681188916,PHIL 13,A01,186976,Staff,2,0,35,33
1683681188916,PHIL 13,A02,186977,Staff,16,0,35,19
1683681189941,PHIL 14,A01,186979,Staff,31,0,35,4
1683681189941,PHIL 14,A02,186986,Staff,32,0,35,3
1683681190966,PHIL 28,A01,186988,Staff,16,0,30,14
1683681190966,PHIL 28,A02,186989,Staff,1,0,30,29
1683681190966,PHIL 28,A03,186990,Staff,10,0,30,20
1683681190966,PHIL 28,A04,186991,Staff,26,0,30,4
1683681191991,PHIL 120,A00,186997,Staff,23,0,40,17
1683681193017,PHIL 137,A00,187003,Staff,7,0,40,33
1683681194044,PHIL 150,A00,187015,Staff,47,0,70,23
1683681195068,PHIL 167,A00,187021,Lamey; Andy M.,34,0,40,6
1683681196091,PHIL 174,A01,202226,Staff,17,0,20,3
1683681196091,PHIL 174,A02,202235,Staff,20,0,20,0
1683681197115,PHIL 191A,A00,258918,Staff,0,0,1,1
1683681198138,PHYS 1A,A00,187028,Staff,26,0,60,34
1683681199161,PHYS 1AL,001,187036,Staff,3,0,30,27
1683681199161,PHYS 1AL,002,187049,Staff,18,0,30,12
1683681200198,PHYS 1B,A00,187058,Staff,22,0,60,38
1683681201223,PHYS 1BL,001,187064,Staff,0,1,30,30
1683681201223,PHYS 1BL,002,187070,Staff,4,0,30,26
1683681202249,PHYS 1C,A00,187082,Staff,29,0,120,91
1683681203282,PHYS 1CL,001,187088,Staff,0,9,30,30
1683681203282,PHYS 1CL,002,187089,Staff,0,1,30,30
1683681203282,PHYS 1CL,009,262693,Staff,9,0,30,21
1683681204306,PHYS 2B,A01,187097,Staff,55,0,115,60
1683681205335,PHYS 2C,A01,187099,Staff,63,0,115,52
1683681206361,PHYS 2CL,A01,187101,Staff,5,0,28,23
1683681206361,PHYS 2CL,A02,187102,Staff,15,0,28,13
1683681207385,PHYS 2D,A01,187123,Shotwell; Brian,95,0,115,20
1683681208410,PHYS 4B,A01,187133,Grinstein; Benjamin,35,0,50,15
1683681209433,POLI 10,A00,188819,Staff,0,4,50,50
1683681210458,POLI 11,A00,188827,Staff,43,0,50,7
1683681211485,POLI 13R,A00,188828,Staff,0,1,20,20
1683681212513,POLI 27,A01,188830,Elgin; Samuel Zincke,0,2,70,70
1683681213537,POLI 30,A00,188832,Desposato; Scott,30,0,50,20
1683681214565,POLI 102F,A00,188834,Staff,0,0,40,40
1683681215589,POLI 104A,A00,188852,Staff,12,0,30,18
1683681216614,POLI 104I,A00,188853,Staff,0,8,20,20
1683681217639,POLI 110B,A00,188854,Wiens; David,6,0,20,14
1683681218664,POLI 112A,A00,188855,Wiens; David,3,0,30,27
1683681219692,POLI 117R,A00,188856,Forman; Fonna,0,12,20,20
1683681220717,POLI 118,A00,188857,Ingham; Sean,8,0,20,12
1683681221741,POLI 120G,A00,188858,Staff,8,0,30,22
1683681222770,POLI 131CR,A00,188863,Hoston; Germaine,20,0,50,30
1683681223798,POLI 133,A00,188864,Nellis; Gareth Hb,44,0,50,6
1683681224824,POLI 134D,A00,188865,Desposato; Scott,27,0,30,3
1683681225846,POLI 142A,A00,188871,Gartzke; Erik,21,0,50,29
1683681226870,POLI 142K,A00,188874,Staff,38,0,50,12
1683681227894,POLI 143,A00,188940,Gartzke; Erik,16,0,30,14
1683681228917,POLI 153,A00,188943,Staff,2,0,20,18
1683681229944,POLI 160AA,A00,188944,Staff,10,0,40,30
1683681230972,POLI 170A,A00,188945,Staff,10,0,30,20
1683681233020,PSYC 1,A00,188952,Staff,36,0,90,54
1683681234043,PSYC 2,B00,188953,Staff,19,0,35,16
1683681235069,PSYC 6,A00,188970,Staff,47,0,60,13
1683681236096,PSYC 7,A00,188973,Staff,35,0,45,10
1683681237123,PSYC 60,A01,188980,Rickard; Timothy C.,42,0,60,18
1683681238146,PSYC 70,A01,189001,Steiner; Eric Tomas,21,0,45,24
1683681239170,PSYC 100,A00,189005,Lacefield; Katharine I,0,99,120,120
1683681240194,PSYC 102,A00,189008,Staff,7,0,30,23
1683681241218,PSYC 106,B00,189026,Gorman; Michael R.,27,0,60,33
1683681242246,PSYC 114,B01,189033,Winkielman; Piotr,0,31,30,30
1683681243270,PSYC 131,A00,189036,Anagnostaras; Stephan,0,43,60,60
1683681244302,PSYC 136,A00,189041,Lowe; Angela Beth,0,7,25,25
1683681245326,PSYC 137,A00,189057,Winkielman; Piotr,1,37,25,24
1683681246352,PSYC 144,A00,189107,Wixted; John T,0,11,50,50
1683681248404,PSYC 162,A00,189142,Staff,0,9,85,85
1683681249428,PSYC 172,A00,189144,Gorman; Michael R.,0,6,30,30
1683681251489,PSYC 179,A00,189146,Lacefield; Katharine I,0,87,120,120
1683681252517,PSYC 181,A00,189147,Anagnostaras; Stephan,0,44,90,90
1683681253541,PSYC 190R,A00,189148,Barner; David A.,0,23,80,80
1683681254564,PSYC 191,A00,189275,Rickard; Timothy C.,0,10,25,25
1683681255588,PSYC 193,A00,189276,Chapman; Eddie Nathaniel,0,1,0,4
1683681256618,PSYC 193L,A01,189281,Lowe; Angela Beth,8,0,20,12
1683681256618,PSYC 193L,B01,189285,Staff,28,0,35,7
1683681257642,RELI 149,A00,187137,Rahimi; Babak,7,0,40,33
1683681258670,SE 9,A01,187315,Staff,0,2,18,18
1683681259694,SE 101B,A00,187409,Staff,24,0,30,6
1683681260721,SE 110B,A00,187444,Staff,10,0,40,30
1683681261749,SE 130B,A00,187449,Staff,31,0,40,9
1683681262830,SE 150A,A00,187516,Staff,8,0,20,12
1683681263856,SE 154,A00,187528,Staff,29,0,50,21
1683681264880,SIO 3,A01,258171,Staff,35,0,40,5
1683681265907,SIO 10,A00,187144,Cook; Geoffrey W,1,7,75,74
1683681266931,SIO 45,A00,187152,Cook; Geoffrey W,0,7,100,100
1683681267962,SIO 109R,A00,194486,Staff,0,4,20,20
1683681270015,SIO 187,A01,187233,Kacev; David,12,0,40,28
1683681271040,SOCI 1,A01,258656,Thorpe; Charles Robert,28,0,30,2
1683681271040,SOCI 1,A02,258658,Thorpe; Charles Robert,30,0,30,0
1683681271040,SOCI 1,A03,258661,Thorpe; Charles Robert,25,0,25,0
1683681271040,SOCI 1,A04,258666,Thorpe; Charles Robert,22,0,25,3
1683681271040,SOCI 1,A05,258897,Thorpe; Charles Robert,22,0,25,3
1683681271040,SOCI 1,A06,258898,Thorpe; Charles Robert,25,0,25,0
1683681272067,SOCI 30,A01,258903,Pardo Guerra; Juan Pablo,14,0,30,16
1683681273091,SOCI 102,A00,258904,Staff,9,0,25,16
1683681274117,SOCI 106,A00,258905,Staff,19,0,25,6
1683681275142,SOCI 111,A00,258907,Ribas Norris; Janet Vanesa,26,0,30,4
1683681276164,SOCI 121R,A00,258908,Pardo Guerra; Juan Pablo,8,0,30,22
1683681277187,SOCI 126,A01,203330,Staff,14,0,20,6
1683681278214,SOCI 131,A00,258909,Thorpe; Charles Robert,30,0,60,30
1683681279238,SOCI 135,A00,258910,Payne; Christine Anna,0,12,30,30
1683681280264,SOCI 157,A00,258911,Staff,11,0,30,19
1683681281288,SOCI 184,A00,258912,Staff,25,0,30,5
1683681282317,SOCI 188D,A00,258913,Staff,22,0,30,8
1683681283344,SYN 2,001,187529,Staff,9,0,16,7
1683681283344,SYN 2,002,201452,Staff,1,20,16,15
1683681283344,SYN 2,003,201469,Staff,1,0,16,15
1683681284371,SYN 100,A01,187531,Staff,0,9,20,20
1683681284371,SYN 100,B01,201491,Staff,0,10,20,20
1683681285396,TDAC 1,A00,189286,Walsh; Kim C.,3,0,20,17
1683681285396,TDAC 1,B00,189287,Harting; Carla Kelso,10,0,20,10
1683681286422,TDAC 101,A00,189300,Walsh; Kim C.,16,0,20,4
1683681286422,TDAC 101,B00,189301,Harting; Carla Kelso,18,0,20,2
1683681287448,TDAC 102,A00,189304,Basso; Beatrice,14,0,20,6
1683681288472,TDAC 108,A00,189305,Staff,18,0,20,2
1683681289501,TDDE 131,A00,189310,Staff,19,0,20,1
1683681289501,TDDE 131,B00,189314,Staff,19,0,20,1
1683681289501,TDDE 131,C00,189315,Staff,48,0,50,2
1683681289501,TDDE 131,D00,189316,Staff,14,0,15,1
1683681289501,TDDE 131,E00,204841,Staff,20,0,20,0
1683681290525,TDGE 10,A00,189289,Staff,27,0,50,23
1683681290525,TDGE 10,B00,189290,Havis; Allan,0,1,50,50
1683681291555,TDGE 11,A00,189291,Fulton; Julia,0,4,50,50
1683681291555,TDGE 11,B00,189292,Staff,20,0,25,5
1683681291555,TDGE 11,C00,260270,Staff,0,0,0,0
1683681292581,TDGE 25,A00,189294,Staff,1,0,20,19
1683681293605,TDGE 124,A00,189318,Fulton; Julia,0,8,50,50
1683681294629,TDGE 125,A00,189319,Staff,13,0,25,12
1683681294629,TDGE 125,B00,189320,Staff,23,0,25,2
1683681295652,TDGE 127,A00,189322,Havis; Allan,0,0,50,50
1683681296676,TDHT 101,A00,189323,Staff,18,0,25,7
1683681296676,TDHT 101,B00,189324,Staff,25,0,25,0
1683681297701,TDHT 102,A00,189325,Staff,49,0,50,1
1683681298728,TDMV 1,A00,189295,Arcidiacono; Kristin,20,0,30,10
1683681298728,TDMV 1,B00,189296,Caligagan; Maria T.,24,0,30,6
1683681299752,TDMV 2,A00,189297,Sammartano; Tonnie,27,0,30,3
1683681299752,TDMV 2,B00,189299,Arcidiacono; Kristin,23,0,30,7
1683681300774,TDMV 3,A00,204998,Rincon; Alicia,22,0,30,8
1683681301798,TDMV 120,A00,189458,Sammartano; Tonnie,28,0,30,2
1683681302824,TDMV 138,A00,189541,Jun; Grace Shin Hae,20,0,40,20
1683681303852,TDMV 142,A00,189717,Caligagan; Tony,25,0,30,5
1683681303852,TDMV 142,B00,189718,Caligagan; Maria T.,25,0,30,5
1683681304878,TMC 2,A01,187533,Staff,25,0,25,0
1683681304878,TMC 2,A02,187534,Staff,25,0,25,0
1683681305910,USP 1,A01,187536,Kwak; Nancy,0,16,25,25
1683681306936,USP 5,A01,187538,Staff,8,0,25,17
1683681307960,USP 101,A00,199253,Staff,0,4,0,0
1683681308988,USP 124,A00,187562,Boomhower; Matthew Charles,0,0,30,30
1683681310018,USP 138,A00,187582,Staff,19,0,25,6
1683681311041,USP 152,A01,187597,Staff,3,0,25,22
1683681312065,USP 153,A00,187598,Staff,18,0,25,7
1683681313092,USP 168,A00,187607,Kwak; Nancy,2,0,5,3
1683681314116,USP 173,A00,187619,Staff,4,0,25,21
1683681315140,USP 181,A00,187638,Staff,0,4,25,25
1683681316167,VIS 103,A00,187650,Cruz; Edwin Teddy,17,0,75,58
1683681317194,VIS 110D,A00,187669,Staff,13,0,22,9
1683681318220,VIS 127C,A00,187720,Shen; Kuiyi,67,0,146,79
1683681319247,VIS 149,A00,187731,Yoldas; Pinar,1,14,22,21
1683681320276,VIS 151,A01,188091,Staff,22,0,34,12
1683681320276,VIS 151,A02,188092,Staff,11,0,34,23
1683681321305,VIS 160B,A00,188093,Stalbaum; Brett,0,1,10,10
1683681323360,WCWP 10B,A00,201720,Staff,0,0,5,5
1683681323360,WCWP 10B,B00,201722,Staff,0,0,6,6
1683681324385,WCWP 100,A00,201725,Gagnon; Jeffrey C,0,0,2,2
1683681324385,WCWP 100,B00,201727,Staff,0,4,15,15
1683681327466,ANBI 133,A00,258401,Wilder; Linnea Lorene,34,0,40,6
1683681328491,ANBI 140,A00,258395,Hrvoj Mihic; Branka,18,0,25,7
1683681329516,ANSC 120,A00,258402,Bialecki; Jon Anthony,26,0,40,14
1683681330540,ANSC 144,A00,258400,Staff,12,0,40,28
1683681332593,ANSC 166,A00,258396,Parish; Steven Martin,156,0,175,19
1683681333618,ANSC 180,A00,193533,Staff,8,0,20,12
1683681334646,ANSC 188,A00,258397,Jassal; Aftab,34,0,40,6
1683681335673,ANTH 3,A01,258316,Staff,23,0,30,7
1683681336697,ANTH 5,A00,258394,Semendeferi; Ekaterini,16,0,20,4
1683681337724,ANTH 21,A01,258331,Staff,4,0,40,36
1683681338748,ANTH 103,A00,258398,Varma; Saiba,15,0,25,10
1683681339776,AWP 10,001,202034,Staff,0,0,0,0
1683681339776,AWP 10,002,202035,Staff,0,0,0,0
1683681339776,AWP 10,003,202036,Staff,0,0,0,0
1683681339776,AWP 10,004,202037,Staff,0,0,0,0
1683681339776,AWP 10,005,202038,Staff,0,0,0,0
1683681339776,AWP 10,006,202039,Staff,0,0,0,0
1683681339776,AWP 10,007,202040,Staff,0,0,0,0
1683681339776,AWP 10,008,202041,Staff,0,0,0,0
1683681339776,AWP 10,009,202042,Staff,0,0,0,0
1683681339776,AWP 10,010,202043,Staff,0,0,0,0
1683681339776,AWP 10,011,202044,Staff,0,0,0,0
1683681339776,AWP 10,012,202045,Staff,0,0,0,0
1683681339776,AWP 10,013,202046,Staff,0,0,0,0
1683681339776,AWP 10,014,202047,Staff,0,0,0,0
1683681339776,AWP 10,015,202048,Staff,0,0,0,0
1683681339776,AWP 10,016,202049,Staff,0,0,0,0
1683681339776,AWP 10,017,202050,Staff,0,0,0,0
1683681339776,AWP 10,018,202051,Staff,0,0,0,0
1683681339776,AWP 10,019,202052,Staff,0,0,0,0
1683681339776,AWP 10,020,202053,Staff,0,0,0,0
1683681339776,AWP 10,021,202054,Staff,0,0,0,0
1683681339776,AWP 10,022,202055,Staff,0,0,0,0
1683681339776,AWP 10,023,202056,Staff,0,0,0,0
1683681339776,AWP 10,024,202057,Staff,0,0,0,0
1683681339776,AWP 10,025,202058,Staff,0,0,0,0
1683681339776,AWP 10,026,202059,Staff,0,0,0,0
1683681340800,AWP 102,001,202032,Staff,0,0,0,0
1683681340800,AWP 102,002,202033,Staff,0,0,0,0
1683681341825,BENG 100,A01,254234,Taylor Amos; Alyssa C,31,0,40,9
1683681342853,BENG 196,001,270013,Engler; Adam J.,9999,0,9999,0
1683681343878,BICD 100R,A01,202018,Smith; Laurie,0,7,32,32
1683681343878,BICD 100R,A02,202019,Smith; Laurie,0,3,32,32
1683681343878,BICD 100R,A03,202020,Smith; Laurie,0,1,32,32
1683681343878,BICD 100R,A04,202021,Smith; Laurie,6,0,32,26
1683681343878,BICD 100R,A05,202022,Smith; Laurie,10,0,32,22
1683681344907,BICD 136,A01,193242,Gustafson-Brown; Cindy,0,2,32,32
1683681344907,BICD 136,A02,193244,Gustafson-Brown; Cindy,13,0,32,19
1683681345933,BIEB 102,A01,193249,Butler; Shannon Rhey,1,1,32,31
1683681345933,BIEB 102,A02,193251,Butler; Shannon Rhey,0,0,32,32
1683681345933,BIEB 102,A03,193253,Butler; Shannon Rhey,0,0,32,32
1683681345933,BIEB 102,A04,193255,Butler; Shannon Rhey,13,0,32,19
1683681345933,BIEB 102,A05,193265,Butler; Shannon Rhey,25,0,32,7
1683681345933,BIEB 102,A06,193269,Butler; Shannon Rhey,13,0,32,19
1683681347984,BIEB 150,A01,193274,Staff,0,0,32,32
1683681347984,BIEB 150,A02,193285,Staff,24,0,32,8
1683681349011,BIEB 194,A00,193286,Kurle; Carolyn M.,19,0,32,13
1683681350042,BILD 1,A01,192291,Staff,15,0,32,17
1683681350042,BILD 1,A02,192292,Staff,30,0,32,2
1683681350042,BILD 1,B01,192520,Reuther; Keefe,0,1,0,0
1683681350042,BILD 1,B02,192532,Reuther; Keefe,0,1,0,0
1683681351068,BILD 3,A01,192556,Butler; Shannon Rhey,0,0,32,32
1683681351068,BILD 3,A02,192581,Butler; Shannon Rhey,0,1,32,32
1683681351068,BILD 3,A03,192611,Butler; Shannon Rhey,19,0,32,13
1683681351068,BILD 3,A04,192612,Butler; Shannon Rhey,24,0,32,8
1683681351068,BILD 3,A05,192613,Butler; Shannon Rhey,26,0,32,6
1683681351068,BILD 3,A06,192679,Butler; Shannon Rhey,27,0,32,5
1683681351068,BILD 3,A07,192682,Butler; Shannon Rhey,20,0,32,12
1683681352092,BILD 4,A01,192836,Reuther; Keefe,1,0,24,23
1683681352092,BILD 4,A02,193044,Reuther; Keefe,4,0,24,20
1683681353120,BILD 10,A01,193142,Gustafson-Brown; Cindy,29,0,32,3
1683681353120,BILD 10,A02,193149,Gustafson-Brown; Cindy,31,0,32,1
1683681354144,BIMM 100,A01,193301,Staff,0,6,32,32
1683681354144,BIMM 100,A02,193312,Staff,0,7,32,32
1683681354144,BIMM 100,A03,193323,Staff,0,10,32,32
1683681355168,BIMM 101,A01,193329,McDonnell; Lisa Marie,1,4,24,23
1683681355168,BIMM 101,A02,193339,McDonnell; Lisa Marie,1,4,24,23
1683681355168,BIMM 101,B01,193354,McDonnell; Lisa Marie,0,4,24,24
1683681355168,BIMM 101,B02,193357,McDonnell; Lisa Marie,0,3,24,24
1683681356193,BIMM 110,A01,193377,Tat; John,0,11,32,32
1683681356193,BIMM 110,A02,193378,Tat; John,0,11,32,32
1683681357219,BIMM 120,A01,206116,Staff,0,0,32,32
1683681357219,BIMM 120,A02,206117,Staff,7,0,32,25
1683681357219,BIMM 120,A03,206121,Staff,21,0,32,11
1683681358246,BIPN 100,A01,193393,Park; Ji Young,0,15,32,32
1683681358246,BIPN 100,A02,193402,Park; Ji Young,0,14,32,32
1683681358246,BIPN 100,A03,193413,Park; Ji Young,0,14,32,32
1683681358246,BIPN 100,A04,193414,Park; Ji Young,0,13,32,32
1683681359270,BIPN 102,A01,193429,Staff,0,0,32,32
1683681359270,BIPN 102,A02,193438,Staff,18,0,32,14
1683681360297,BIPN 106,A01,193450,Reyes Gonzalez; Catalina,0,2,40,40
1683681361325,BIPN 134,A01,193465,Cooke; James Edward,0,0,32,32
1683681361325,BIPN 134,A02,193474,Cooke; James Edward,25,0,32,7
1683681361325,BIPN 134,A03,193485,Cooke; James Edward,29,0,32,3
1683681361325,BIPN 134,A04,193486,Cooke; James Edward,20,0,32,12
1683681361325,BIPN 134,A05,193491,Cooke; James Edward,31,0,32,1
1683681361325,BIPN 134,A06,193501,Cooke; James Edward,30,0,32,2
1683681361325,BIPN 134,A07,193510,Cooke; James Edward,29,0,32,3
1683681363376,BISP 194,A00,222522,Staff,14,0,32,18
1683681364399,CAT 124,A01,202407,Staff,19,0,25,6
1683681365424,CAT 125,A00,202408,Marchisotto; Jennifer Anne,2,0,20,18
1683681366508,CAT 125R,A00,202409,Smith; Lauryn Alissa,0,11,20,20
1683681366508,CAT 125R,B00,202410,Morales; Celeste Georgianna,0,11,20,20
1683681366508,CAT 125R,C00,202411,Irwin; Matthew Joseph,0,12,20,20
1683681367533,CENG 15,A01,204712,Yang; Kesong,0,1,0,0
1683681368560,CENG 114,A00,202070,Jahed Motlagh; Zeinab,5,0,20,15
1683681369588,CGS 105,A00,185477,Wesling; Megan E.,24,0,40,16
1683681370614,CGS 106,A00,185494,Staff,11,0,22,11
1683681371640,CGS 108,A00,185495,Staff,14,0,20,6
1683681372664,CGS 114,A00,185496,Staff,13,0,18,5
1683681373690,CGS 119,A00,185501,Staff,15,0,20,5
1683681374716,CGS 120,A00,185511,Staff,12,0,20,8
1683681375742,CHEM 4,A01,184675,Bussey; Thomas J,97,0,100,3
1683681376770,CHEM 6A,A01,184677,Staff,32,0,60,28
1683681377795,CHEM 6B,A01,184679,Staff,63,0,100,37
1683681378820,CHEM 6C,A01,184681,Bussey; Thomas J,0,0,50,50
1683681378820,CHEM 6C,A02,184682,Bussey; Thomas J,32,0,50,18
1683681379848,CHEM 40A,A01,184684,Albizati; Kim F.,33,0,100,67
1683681380875,CHEM 40B,A01,184686,Albizati; Kim F.,0,22,100,100
1683681381901,CHEM 41B,A01,184690,Staff,51,0,100,49
1683681382926,COGS 3,A01,184715,Boyle; Mary E. T.,0,27,40,40
1683681383949,COGS 14B,A01,185172,Staff,0,14,38,38
1683681384974,COGS 18,A01,184736,Staff,14,0,80,66
1683681385999,COGS 100,A01,184932,Staff,0,8,73,73
1683681387024,COGS 101A,A01,184935,Staff,0,40,30,30
1683681388048,COGS 101B,A01,184944,Staff,0,2,30,30
1683681389073,COGS 101C,A01,184946,Staff,0,10,30,30
1683681390099,COGS 102A,A01,184951,Johnson; Christine M.,2,0,40,38
1683681391123,COGS 107B,A01,184953,Mooshagian; Eric Frederick,0,52,40,40
1683681392147,COGS 118B,A01,184959,Gupta; Anjum,0,50,40,40
1683681393170,COGS 153,A00,184961,Staff,0,16,30,30
1683681394194,COGS 177,A00,184962,Staff,0,21,30,30
1683681395221,COGS 187A,A01,184969,Boyle; Mary E. T.,0,19,40,40
1683681396244,COMM 10,A01,185174,Staff,0,5,25,25
1683681396244,COMM 10,A02,185189,Staff,0,2,25,25
1683681396244,COMM 10,A03,269821,Staff,0,1,0,0
1683681397269,COMM 100B,A02,185476,Staff,11,0,25,14
1683681397269,COMM 100B,A03,277340,Staff,25,0,25,0
1683681398294,COMM 100C,A01,185314,Staff,1,0,25,24
1683681398294,COMM 100C,A02,185327,Staff,17,0,25,8
1683681399318,COMM 110M,A00,185349,Staff,0,0,40,40
1683681400341,COMM 113T,A00,185352,Staff,25,0,40,15
1683681401368,COMM 114I,A00,185353,Staff,31,0,40,9
1683681402391,COMM 131,A00,185354,Staff,17,0,30,13
1683681403419,CSE 8A,A50,185358,Cao; Yingjun,0,46,10,10
1683681404444,CSE 8B,A01,185362,Staff,0,48,50,50
1683681405467,CSE 11,A01,185416,Cao; Yingjun,0,91,10,10
1683681406494,CSE 20,A01,185445,Briones; Jor-el Thomas Caparas,3,0,25,22
1683681407521,CSE 21,A01,185447,Staff,9,0,50,41
1683681408545,CSE 101,A01,185451,Staff,0,13,50,50
1683681408545,CSE 101,B01,185453,Jones; Miles E,0,14,50,50
1683681410595,CSE 141,A01,185458,Eldon; John,16,0,100,84
1683681411623,CSE 141L,A01,185461,Eldon; John,8,0,100,92
1683681412648,CSE 142,A01,185463,Staff,34,0,60,26
1683681412648,CSE 142,B01,201355,Staff,0,7,60,60
1683681413671,CSE 142L,A01,185470,Staff,34,0,60,26
1683681413671,CSE 142L,B01,201417,Staff,0,6,60,60
1683681414697,CSE 190,A00,201433,Staff,32,0,49,17
1683681415722,DOC 1,A01,259136,Strom; Megan C.,7,0,15,8
1683681415722,DOC 1,A02,259137,Strom; Megan C.,14,0,15,1
1683681415722,DOC 1,A03,259138,Strom; Megan C.,14,0,15,1
1683681415722,DOC 1,A04,259139,Strom; Megan C.,14,0,15,1
1683681416746,DOC 100D,A00,259140,Pass; Natalye Joann,14,0,25,11
1683681417769,DSGN 1,A01,184749,Rill; Bryan,0,26,30,30
1683681418794,DSGN 100,A01,185168,Staff,0,2,25,25
1683681419821,ECE 5,A01,185626,Morris; Karcher William,0,12,0,0
1683681420849,ECE 101,A01,185628,Staff,14,0,70,56
1683681421877,ECE 107,A01,185635,Baghdadchi; Saharnaz,0,0,20,20
1683681421877,ECE 107,A02,185638,Baghdadchi; Saharnaz,1,0,20,19
1683681422901,ECE 148,A01,185647,Silberman; Jack,0,0,16,16
1683681423925,ECON 1,A01,185537,Crane; Meredith Helen,54,0,70,16
1683681424953,ECON 3,A01,185549,Crane; Meredith Helen,30,0,70,40
1683681425976,ECON 4,A01,203354,Anderson; John Charles,0,5,10,10
1683681427001,ECON 100A,A01,185574,Staff,0,5,40,40
1683681428028,ECON 100B,A01,185576,Staff,0,12,50,50
1683681429058,ECON 100C,A01,185589,Newhouse; Herbert S,30,0,70,40
1683681430083,ECON 105,A00,185608,Vespa; Emanuel Ignacio,19,0,35,16
1683681431107,ECON 109,A01,185610,Shishkin; Denis,9,0,35,26
1683681432130,ECON 110A,A01,185612,Staff,9,0,40,31
1683681433157,ECON 120A,A01,185615,Staff,19,0,40,21
1683681434184,ECON 120C,A01,185617,Sun; Yixiao,0,21,70,70
1683681435212,ECON 144,A00,203346,Squires; Dale E,2,0,35,33
1683681436236,ECON 171,A01,203349,Newhouse; Herbert S,0,1,35,35
1683681437264,ECON 173A,A01,185621,Toda; Alexis Akira,21,0,35,14
1683681438294,EDS 25,A01,202413,Staff,0,1,0,0
1683681438294,EDS 25,A02,202414,Staff,0,1,0,0
1683681438294,EDS 25,A03,202415,Staff,0,0,0,0
1683681438294,EDS 25,A04,202416,Staff,0,1,0,0
1683681438294,EDS 25,A05,202439,Staff,0,0,0,0
1683681438294,EDS 25,A06,202440,Staff,0,0,0,0
1683681438294,EDS 25,B01,202631,Staff,0,0,0,0
1683681438294,EDS 25,B02,202632,Staff,0,0,0,0
1683681438294,EDS 25,B03,202639,Staff,0,0,0,0
1683681438294,EDS 25,B04,202640,Staff,0,0,0,0
1683681438294,EDS 25,B05,202643,Staff,0,0,0,0
1683681438294,EDS 25,B06,202644,Staff,0,0,0,0
1683681439321,EDS 38,A01,202659,Black; Alison Michelle,24,0,25,1
1683681440345,EDS 115,A00,202652,Staff,18,0,30,12
1683681441371,EDS 125,A00,202649,Staff,13,0,30,17
1683681442394,EDS 126,A01,203332,Staff,30,0,30,0
1683681443418,EDS 139,A00,202838,Staff,16,0,25,9
1683681444442,EDS 146,A01,202655,Staff,14,0,25,11
1683681445471,ENG 15,A00,185667,Staff,0,1,0,0
1683681445471,ENG 15,B00,185672,Staff,0,0,0,0
1683681445471,ENG 15,C00,185675,Staff,0,0,0,0
1683681445471,ENG 15,D00,185682,Staff,0,0,0,0
1683681445471,ENG 15,E00,185684,Staff,0,0,0,0
1683681446498,ETHN 103,A00,185710,Staff,0,8,35,35
1683681447522,ETHN 103A,A00,199228,Man; Simeon S,0,0,9,9
1683681448546,ETHN 109,A00,185711,Staff,15,0,35,20
1683681449570,ETHN 142,A00,185726,Staff,0,4,30,30
1683681450596,ETHN 163J,A00,199229,Man; Simeon S,5,0,8,3
1683681451618,ETHN 168,A00,185727,Staff,7,0,10,3
1683681452642,ETHN 182,A00,185728,Staff,0,0,35,35
1683681453665,ETHN 183,A00,185737,Staff,9,0,18,9
1683681454689,GLBH 111,A01,209361,Burgos; Jose L.,0,0,0,0
1683681456737,HIEU 104,A00,185792,Staff,14,0,20,6
1683681457765,HIEU 115,A00,185800,Staff,0,0,20,20
1683681458790,HIEU 128,A00,185801,Staff,0,9,20,20
1683681459813,HIEU 147,A00,185802,Staff,15,0,20,5
1683681460837,HIEU 154,A00,185823,Staff,11,0,20,9
1683681461859,HILA 102,A00,185826,Staff,14,0,20,6
1683681462883,HILD 2C,A01,185778,Staff,0,13,20,20
1683681463908,HILD 7B,A01,185780,Kwak; Nancy,0,17,32,32
1683681463908,HILD 7B,A02,185781,Kwak; Nancy,0,18,32,32
1683681464931,HILD 30,A01,185791,Staff,12,0,20,8
1683681465956,HISC 119,A00,185830,Golan; Tal,0,10,20,20
1683681466980,HITO 156GS,A00,185831,Patterson; Patrick H.,0,0,0,23
1683681468006,HIUS 103,A00,185832,Man; Simeon S,0,4,20,20
1683681469033,HIUS 117,A00,185836,Kwak; Nancy,2,0,20,18
1683681470114,HIUS 125,A00,185840,Man; Simeon S,0,2,23,23
1683681471140,HIUS 149,A00,185845,Staff,1,0,20,19
1683681472168,HUM 3,A01,185882,Zavodny; Tatiana Sophia,0,8,50,50
1683681472168,HUM 3,B01,185899,Caldwell; Michael Alan,0,18,50,50
1683681473196,HUM 3GS,A00,185900,Patterson; Patrick H.,0,0,0,23
1683681474221,HUM 4,A01,185938,Zroka; Amy Liane,28,0,50,22
1683681474221,HUM 4,B01,185956,Watkins; Eric,0,6,50,50
1683681474221,HUM 4,B02,202209,Watkins; Eric,0,5,50,50
1683681474221,HUM 4,B03,202210,Watkins; Eric,0,5,50,50
1683681475245,HUM 5,A01,185958,West; Geoffrey Scott,0,0,50,50
1683681475245,HUM 5,A02,202215,West; Geoffrey Scott,0,0,50,50
1683681476270,INTL 190,A00,185959,Gagnon; Jeffrey C,0,0,0,9
1683681476270,INTL 190,B00,185960,Lettieri; Michael Joseph,0,0,0,2
1683681477296,JAPN 180,A00,254509,Staff,5,0,30,25
1683681478323,LATI 10,A01,202853,Kennemore; Amy Michelle,4,0,35,31
1683681478323,LATI 10,A02,202854,Kennemore; Amy Michelle,3,0,35,32
1683681478323,LATI 10,A03,270054,Kennemore; Amy Michelle,30,0,30,0
1683681479350,LATI 180,A00,202855,Kennemore; Amy Michelle,11,0,20,9
1683681480376,LAWS 101,A00,201767,Golan; Tal,0,7,40,40
1683681481401,LIFR 1C,A00,185961,Staff,6,0,20,14
1683681482425,LIFR 1CX,A00,185962,Staff,7,0,20,13
1683681483452,LIFR 1D,A00,185963,Staff,7,0,20,13
1683681484481,LIFR 1DX,A00,185964,Staff,7,0,20,13
1683681485506,LIGN 101,A01,186039,Staff,43,0,50,7
1683681486531,LIGN 165,A00,186040,Staff,15,0,50,35
1683681487557,LTCS 108,A00,186041,Staff,5,0,10,5
1683681488584,LTCS 119,A00,186042,Staff,15,0,20,5
1683681489609,LTCS 130,A00,186043,Wesling; Megan E.,15,0,25,10
1683681491657,LTEA 138,A00,186119,Staff,14,0,40,26
1683681492684,LTEN 124,A00,186148,Staff,5,0,25,20
1683681493709,LTEN 178,A00,186149,Staff,7,0,15,8
1683681494741,LTEN 181,A00,186150,Blanco; John D,34,0,40,6
1683681495768,LTWL 120,A00,186160,Staff,19,0,25,6
1683681496795,LTWL 165,A00,186161,Staff,22,0,25,3
1683681497821,LTWR 100,A00,186162,Staff,0,5,15,15
1683681498844,LTWR 102,A00,186163,Doller; Ben,5,0,15,10
1683681499870,MAE 8,A01,186412,Staff,0,1,0,0
1683681500894,MAE 30B,A00,186445,Bahadori; Mohammad Yousef,81,0,100,19
1683681501921,MAE 40,A00,186592,Bewley; Thomas R,10,0,50,40
1683681502946,MAE 101B,A00,186593,Bahadori; Mohammad Yousef,80,0,100,20
1683681503973,MAE 105,A00,186594,Bandaru; Prabhakar,10,0,50,40
1683681505003,MAE 107,A00,186599,Pham; Hieu Tan,0,7,120,120
1683681506028,MAE 148,A01,186660,Silberman; Jack,3,0,16,13
1683681507056,MATH 10A,A01,188095,Staff,0,6,35,35
1683681508080,MATH 10B,A01,188097,Bowers; Adam R.,0,12,30,30
1683681508080,MATH 10B,A02,188099,Bowers; Adam R.,0,11,30,30
1683681508080,MATH 10B,B01,188104,Bowers; Adam R.,0,10,30,30
1683681508080,MATH 10B,B02,188106,Bowers; Adam R.,1,9,30,29
1683681509104,MATH 10C,A01,188111,Staff,0,20,30,30
1683681509104,MATH 10C,A02,188127,Staff,0,19,30,30
1683681509104,MATH 10C,A03,188131,Staff,0,19,30,30
1683681509104,MATH 10C,B01,188218,Staff,17,0,30,13
1683681509104,MATH 10C,B02,188244,Staff,13,0,30,17
1683681509104,MATH 10C,B03,188277,Staff,14,0,30,16
1683681510129,MATH 18,A01,188344,Bach; Quang Tran,18,0,30,12
1683681510129,MATH 18,A02,188345,Bach; Quang Tran,11,0,30,19
1683681510129,MATH 18,B01,188353,Bach; Quang Tran,11,0,30,19
1683681510129,MATH 18,B02,188354,Bach; Quang Tran,19,0,30,11
1683681511153,MATH 20A,A01,188374,Staff,11,0,35,24
1683681512180,MATH 20B,A01,188382,Ohm; Ko Woon,7,0,30,23
1683681512180,MATH 20B,A02,188383,Ohm; Ko Woon,22,0,30,8
1683681512180,MATH 20B,B01,188385,Ohm; Ko Woon,7,0,30,23
1683681512180,MATH 20B,B02,188392,Ohm; Ko Woon,22,0,30,8
1683681513206,MATH 20C,A01,188394,Harel; Guershon,10,0,30,20
1683681513206,MATH 20C,A02,188395,Harel; Guershon,13,0,30,17
1683681513206,MATH 20C,B01,188404,Harel; Guershon,5,0,30,25
1683681513206,MATH 20C,B02,188405,Harel; Guershon,18,0,30,12
1683681514233,MATH 20D,A01,188414,Hammock; Frances H,0,1,30,30
1683681514233,MATH 20D,A02,188415,Hammock; Frances H,0,1,30,30
1683681514233,MATH 20D,B01,188447,Hammock; Frances H,0,1,30,30
1683681514233,MATH 20D,B02,188486,Hammock; Frances H,3,0,30,27
1683681515259,MATH 20E,A01,188649,Staff,21,0,30,9
1683681515259,MATH 20E,A02,188650,Staff,20,0,30,10
1683681515259,MATH 20E,A03,188673,Staff,0,0,30,30
1683681516285,MATH 102,A01,188675,Staff,0,39,35,35
1683681517315,MATH 103B,A01,188681,Staff,3,0,35,32
1683681517315,MATH 103B,B01,188692,Staff,5,0,35,30
1683681518340,MATH 109,A01,188695,Salehi Golsefidy; Alireza,24,0,35,11
1683681518340,MATH 109,A02,188696,Salehi Golsefidy; Alireza,25,0,35,10
1683681519366,MATH 120A,A01,188698,Eggers; John Dietrich,7,0,35,28
1683681520394,MATH 142B,A01,188736,Ioana; Adrian,1,1,30,29
1683681520394,MATH 142B,A02,188741,Ioana; Adrian,0,1,30,30
1683681520394,MATH 142B,A03,188743,Ioana; Adrian,0,1,30,30
1683681521421,MATH 168A,A01,188790,Staff,0,11,35,35
1683681522446,MATH 170A,A01,188803,Nie; Jiawang,0,2,35,35
1683681522446,MATH 170A,A02,188811,Nie; Jiawang,0,1,35,35
1683681522446,MATH 170A,A03,188814,Nie; Jiawang,0,0,35,35
1683681522446,MATH 170A,A04,188815,Nie; Jiawang,6,0,35,29
1683681523469,MATH 193B,A01,188817,Staff,0,0,35,35
1683681523469,MATH 193B,A02,188818,Staff,5,0,35,30
1683681524495,MGT 4,A01,202857,Anderson; John Charles,60,0,80,20
1683681525518,MGT 12,A00,202858,Lindenberger; Wade Douglas,40,0,90,50
1683681526540,MGT 18,A00,202859,Staff,74,0,90,16
1683681527570,MGT 18GS,A00,202860,McKay; Michael J,13,0,28,15
1683681528596,MGT 45,A00,202861,Pecore; Joseph P.,9,0,90,81
1683681529620,MGT 100,A00,202863,Yavorsky; Daniel Ryan,28,0,90,62
1683681530648,MGT 103,A00,202864,Ehrich; Kristine R,0,18,90,90
1683681531672,MGT 112,A00,202865,Ehrich; Kristine R,15,0,90,75
1683681532696,MGT 121A,A00,202868,Staff,90,20,90,0
1683681533725,MGT 131B,A00,202869,Anderson; John Charles,59,0,90,31
1683681534752,MGT 136,A00,202871,Lindenberger; Wade Douglas,83,0,90,7
1683681535774,MGT 164,A00,202873,Staff,0,67,90,91
1683681536797,MGT 164GS,A00,202874,McKay; Mary A,13,0,28,15
1683681537825,MGT 180,A00,202875,Staff,0,51,90,91
1683681538854,MMW 11R,A01,205019,Herbst; Matthew,0,0,30,30
1683681538854,MMW 11R,A02,205026,Herbst; Matthew,29,0,30,1
1683681539878,MMW 15,A01,193512,Chang; Edmond Yi-Teh,0,8,28,28
1683681539878,MMW 15,A02,193513,Chang; Edmond Yi-Teh,0,5,28,28
1683681539878,MMW 15,A03,193514,Chang; Edmond Yi-Teh,0,5,28,28
1683681539878,MMW 15,A04,193515,Chang; Edmond Yi-Teh,0,5,28,28
1683681539878,MMW 15,A05,193516,Chang; Edmond Yi-Teh,0,5,28,28
1683681539878,MMW 15,A06,193517,Chang; Edmond Yi-Teh,0,6,28,28
1683681539878,MMW 15,B01,193519,Chang; Edmond Yi-Teh,0,5,28,28
1683681539878,MMW 15,B02,193520,Chang; Edmond Yi-Teh,0,5,28,28
1683681539878,MMW 15,B03,193521,Chang; Edmond Yi-Teh,0,5,28,28
1683681539878,MMW 15,B04,193522,Chang; Edmond Yi-Teh,0,6,28,28
1683681539878,MMW 15,B05,193523,Chang; Edmond Yi-Teh,0,5,28,28
1683681539878,MMW 15,B06,193524,Chang; Edmond Yi-Teh,0,5,28,28
1683681540905,MMW 122,A01,193526,Rahimi; Babak,0,16,28,28
1683681540905,MMW 122,A02,193527,Rahimi; Babak,0,15,28,28
1683681540905,MMW 122,A03,193528,Rahimi; Babak,0,0,0,0
1683681540905,MMW 122,A04,193529,Rahimi; Babak,0,0,0,0
1683681541934,MUS 1A,A01,186663,Staff,1,19,35,34
1683681542959,MUS 4,A01,186715,Staff,0,12,35,35
1683681543985,MUS 5R,A01,186796,Dubnov; Shlomo,0,17,35,35
1683681545010,MUS 6,A01,186798,Staff,1,5,25,24
1683681546036,MUS 7,A01,186830,Staff,11,0,35,24
1683681547061,MUS 8,A01,186930,Staff,0,27,35,35
1683681548089,MUS 15,A01,186932,Staff,0,15,35,35
1683681548089,MUS 15,B01,186934,Staff,1,17,35,34
1683681549115,MUS 80,A00,186935,Staff,0,0,20,20
1683681549115,MUS 80,B00,186936,Staff,24,0,25,1
1683681550139,NANO 11,A00,204702,Lipomi; Darren John,0,0,0,0
1683681551163,NANO 15,A01,204709,Yang; Kesong,0,1,0,0
1683681552186,NANO 114,A00,202069,Jahed Motlagh; Zeinab,3,0,10,7
1683681553210,PHIL 1,A00,186955,Grush; Rick Scott,31,0,40,9
1683681554238,PHIL 10,A01,186973,Grush; Rick Scott,27,0,35,8
1683681554238,PHIL 10,A02,186974,Grush; Rick Scott,33,0,35,2
1683681555262,PHIL 13,A01,186976,Staff,2,0,35,33
1683681555262,PHIL 13,A02,186977,Staff,16,0,35,19
1683681556289,PHIL 14,A01,186979,Staff,31,0,35,4
1683681556289,PHIL 14,A02,186986,Staff,32,0,35,3
1683681557317,PHIL 28,A01,186988,Staff,16,0,30,14
1683681557317,PHIL 28,A02,186989,Staff,1,0,30,29
1683681557317,PHIL 28,A03,186990,Staff,10,0,30,20
1683681557317,PHIL 28,A04,186991,Staff,26,0,30,4
1683681558340,PHIL 120,A00,186997,Staff,23,0,40,17
1683681559366,PHIL 137,A00,187003,Staff,7,0,40,33
1683681560389,PHIL 150,A00,187015,Staff,47,0,70,23
1683681561415,PHIL 167,A00,187021,Lamey; Andy M.,34,0,40,6
1683681562439,PHIL 174,A01,202226,Staff,17,0,20,3
1683681562439,PHIL 174,A02,202235,Staff,20,0,20,0
1683681563466,PHIL 191A,A00,258918,Staff,0,0,1,1
1683681564490,PHYS 1A,A00,187028,Staff,26,0,60,34
1683681565514,PHYS 1AL,001,187036,Staff,3,0,30,27
1683681565514,PHYS 1AL,002,187049,Staff,18,0,30,12
1683681566539,PHYS 1B,A00,187058,Staff,22,0,60,38
1683681567570,PHYS 1BL,001,187064,Staff,0,1,30,30
1683681567570,PHYS 1BL,002,187070,Staff,4,0,30,26
1683681568593,PHYS 1C,A00,187082,Staff,29,0,120,91
1683681569620,PHYS 1CL,001,187088,Staff,0,9,30,30
1683681569620,PHYS 1CL,002,187089,Staff,0,1,30,30
1683681569620,PHYS 1CL,009,262693,Staff,9,0,30,21
1683681570645,PHYS 2B,A01,187097,Staff,55,0,115,60
1683681571669,PHYS 2C,A01,187099,Staff,63,0,115,52
1683681572694,PHYS 2CL,A01,187101,Staff,5,0,28,23
1683681572694,PHYS 2CL,A02,187102,Staff,15,0,28,13
1683681573777,PHYS 2D,A01,187123,Shotwell; Brian,95,0,115,20
1683681574804,PHYS 4B,A01,187133,Grinstein; Benjamin,35,0,50,15
1683681575831,POLI 10,A00,188819,Staff,0,4,50,50
1683681576857,POLI 11,A00,188827,Staff,43,0,50,7
1683681577883,POLI 13R,A00,188828,Staff,0,1,20,20
1683681578908,POLI 27,A01,188830,Elgin; Samuel Zincke,0,2,70,70
1683681579934,POLI 30,A00,188832,Desposato; Scott,30,0,50,20
1683681580961,POLI 102F,A00,188834,Staff,0,0,40,40
1683681581984,POLI 104A,A00,188852,Staff,12,0,30,18
1683681583007,POLI 104I,A00,188853,Staff,0,8,20,20
1683681584031,POLI 110B,A00,188854,Wiens; David,6,0,20,14
1683681585054,POLI 112A,A00,188855,Wiens; David,3,0,30,27
1683681586077,POLI 117R,A00,188856,Forman; Fonna,0,12,20,20
1683681587104,POLI 118,A00,188857,Ingham; Sean,8,0,20,12
1683681588127,POLI 120G,A00,188858,Staff,8,0,30,22
1683681589152,POLI 131CR,A00,188863,Hoston; Germaine,20,0,50,30
1683681590174,POLI 133,A00,188864,Nellis; Gareth Hb,44,0,50,6
1683681591201,POLI 134D,A00,188865,Desposato; Scott,27,0,30,3
1683681592228,POLI 142A,A00,188871,Gartzke; Erik,21,0,50,29
1683681593259,POLI 142K,A00,188874,Staff,38,0,50,12
1683681594283,POLI 143,A00,188940,Gartzke; Erik,16,0,30,14
1683681595310,POLI 153,A00,188943,Staff,2,0,20,18
1683681596334,POLI 160AA,A00,188944,Staff,10,0,40,30
1683681597359,POLI 170A,A00,188945,Staff,10,0,30,20
1683681599409,PSYC 1,A00,188952,Staff,36,0,90,54
1683681600433,PSYC 2,B00,188953,Staff,19,0,35,16
1683681601461,PSYC 6,A00,188970,Staff,47,0,60,13
1683681602486,PSYC 7,A00,188973,Staff,35,0,45,10
1683681603515,PSYC 60,A01,188980,Rickard; Timothy C.,42,0,60,18
1683681604540,PSYC 70,A01,189001,Steiner; Eric Tomas,21,0,45,24
1683681605564,PSYC 100,A00,189005,Lacefield; Katharine I,0,99,120,120
1683681606592,PSYC 102,A00,189008,Staff,7,0,30,23
1683681607618,PSYC 106,B00,189026,Gorman; Michael R.,27,0,60,33
1683681608645,PSYC 114,B01,189033,Winkielman; Piotr,0,31,30,30
1683681609672,PSYC 131,A00,189036,Anagnostaras; Stephan,0,43,60,60
1683681610696,PSYC 136,A00,189041,Lowe; Angela Beth,0,7,25,25
1683681611721,PSYC 137,A00,189057,Winkielman; Piotr,1,37,25,24
1683681612748,PSYC 144,A00,189107,Wixted; John T,0,11,50,50
1683681614799,PSYC 162,A00,189142,Staff,0,9,85,85
1683681615828,PSYC 172,A00,189144,Gorman; Michael R.,0,6,30,30
1683681617877,PSYC 179,A00,189146,Lacefield; Katharine I,0,87,120,120
1683681618902,PSYC 181,A00,189147,Anagnostaras; Stephan,0,44,90,90
1683681619925,PSYC 190R,A00,189148,Barner; David A.,0,23,80,80
1683681620954,PSYC 191,A00,189275,Rickard; Timothy C.,0,10,25,25
1683681621982,PSYC 193,A00,189276,Chapman; Eddie Nathaniel,0,1,0,4
1683681623011,PSYC 193L,A01,189281,Lowe; Angela Beth,8,0,20,12
1683681623011,PSYC 193L,B01,189285,Staff,28,0,35,7
1683681624035,RELI 149,A00,187137,Rahimi; Babak,7,0,40,33
1683681625062,SE 9,A01,187315,Staff,0,2,18,18
1683681626086,SE 101B,A00,187409,Staff,24,0,30,6
1683681627115,SE 110B,A00,187444,Staff,10,0,40,30
1683681628142,SE 130B,A00,187449,Staff,31,0,40,9
1683681629166,SE 150A,A00,187516,Staff,8,0,20,12
1683681630193,SE 154,A00,187528,Staff,29,0,50,21
1683681631222,SIO 3,A01,258171,Staff,35,0,40,5
1683681632247,SIO 10,A00,187144,Cook; Geoffrey W,1,7,75,74
1683681633274,SIO 45,A00,187152,Cook; Geoffrey W,0,7,100,100
1683681634301,SIO 109R,A00,194486,Staff,0,4,20,20
1683681636349,SIO 187,A01,187233,Kacev; David,12,0,40,28
1683681637378,SOCI 1,A01,258656,Thorpe; Charles Robert,28,0,30,2
1683681637378,SOCI 1,A02,258658,Thorpe; Charles Robert,30,0,30,0
1683681637378,SOCI 1,A03,258661,Thorpe; Charles Robert,25,0,25,0
1683681637378,SOCI 1,A04,258666,Thorpe; Charles Robert,22,0,25,3
1683681637378,SOCI 1,A05,258897,Thorpe; Charles Robert,22,0,25,3
1683681637378,SOCI 1,A06,258898,Thorpe; Charles Robert,25,0,25,0
1683681638402,SOCI 30,A01,258903,Pardo Guerra; Juan Pablo,14,0,30,16
1683681639426,SOCI 102,A00,258904,Staff,9,0,25,16
1683681640451,SOCI 106,A00,258905,Staff,19,0,25,6
1683681641478,SOCI 111,A00,258907,Ribas Norris; Janet Vanesa,26,0,30,4
1683681642503,SOCI 121R,A00,258908,Pardo Guerra; Juan Pablo,8,0,30,22
1683681643528,SOCI 126,A01,203330,Staff,14,0,20,6
1683681644552,SOCI 131,A00,258909,Thorpe; Charles Robert,30,0,60,30
1683681645575,SOCI 135,A00,258910,Payne; Christine Anna,0,12,30,30
1683681646601,SOCI 157,A00,258911,Staff,11,0,30,19
1683681647624,SOCI 184,A00,258912,Staff,25,0,30,5
1683681648651,SOCI 188D,A00,258913,Staff,22,0,30,8
1683681649680,SYN 2,001,187529,Staff,9,0,16,7
1683681649680,SYN 2,002,201452,Staff,1,20,16,15
1683681649680,SYN 2,003,201469,Staff,1,0,16,15
1683681650705,SYN 100,A01,187531,Staff,0,9,20,20
1683681650705,SYN 100,B01,201491,Staff,0,10,20,20
1683681651730,TDAC 1,A00,189286,Walsh; Kim C.,3,0,20,17
1683681651730,TDAC 1,B00,189287,Harting; Carla Kelso,10,0,20,10
1683681652757,TDAC 101,A00,189300,Walsh; Kim C.,16,0,20,4
1683681652757,TDAC 101,B00,189301,Harting; Carla Kelso,18,0,20,2
1683681653780,TDAC 102,A00,189304,Basso; Beatrice,14,0,20,6
1683681654805,TDAC 108,A00,189305,Staff,18,0,20,2
1683681655828,TDDE 131,A00,189310,Staff,19,0,20,1
1683681655828,TDDE 131,B00,189314,Staff,19,0,20,1
1683681655828,TDDE 131,C00,189315,Staff,48,0,50,2
1683681655828,TDDE 131,D00,189316,Staff,14,0,15,1
1683681655828,TDDE 131,E00,204841,Staff,20,0,20,0
1683681656855,TDGE 10,A00,189289,Staff,27,0,50,23
1683681656855,TDGE 10,B00,189290,Havis; Allan,0,1,50,50
1683681657880,TDGE 11,A00,189291,Fulton; Julia,0,4,50,50
1683681657880,TDGE 11,B00,189292,Staff,20,0,25,5
1683681657880,TDGE 11,C00,260270,Staff,0,0,0,0
1683681658904,TDGE 25,A00,189294,Staff,1,0,20,19
1683681659928,TDGE 124,A00,189318,Fulton; Julia,0,8,50,50
1683681660952,TDGE 125,A00,189319,Staff,13,0,25,12
1683681660952,TDGE 125,B00,189320,Staff,23,0,25,2
1683681661976,TDGE 127,A00,189322,Havis; Allan,0,0,50,50
1683681663001,TDHT 101,A00,189323,Staff,18,0,25,7
1683681663001,TDHT 101,B00,189324,Staff,25,0,25,0
1683681664030,TDHT 102,A00,189325,Staff,49,0,50,1
1683681665055,TDMV 1,A00,189295,Arcidiacono; Kristin,20,0,30,10
1683681665055,TDMV 1,B00,189296,Caligagan; Maria T.,24,0,30,6
1683681666084,TDMV 2,A00,189297,Sammartano; Tonnie,27,0,30,3
1683681666084,TDMV 2,B00,189299,Arcidiacono; Kristin,23,0,30,7
1683681667111,TDMV 3,A00,204998,Rincon; Alicia,22,0,30,8
1683681668138,TDMV 120,A00,189458,Sammartano; Tonnie,28,0,30,2
1683681669167,TDMV 138,A00,189541,Jun; Grace Shin Hae,20,0,40,20
1683681670193,TDMV 142,A00,189717,Caligagan; Tony,25,0,30,5
1683681670193,TDMV 142,B00,189718,Caligagan; Maria T.,25,0,30,5
1683681671220,TMC 2,A01,187533,Staff,25,0,25,0
1683681671220,TMC 2,A02,187534,Staff,25,0,25,0
1683681672247,USP 1,A01,187536,Kwak; Nancy,0,16,25,25
1683681673274,USP 5,A01,187538,Staff,8,0,25,17
1683681674297,USP 101,A00,199253,Staff,0,4,0,0
1683681675325,USP 124,A00,187562,Boomhower; Matthew Charles,0,0,30,30
1683681676352,USP 138,A00,187582,Staff,19,0,25,6
1683681677450,USP 152,A01,187597,Staff,3,0,25,22
1683681678478,USP 153,A00,187598,Staff,18,0,25,7
1683681679503,USP 168,A00,187607,Kwak; Nancy,2,0,5,3
1683681680526,USP 173,A00,187619,Staff,4,0,25,21
1683681681550,USP 181,A00,187638,Staff,0,4,25,25
1683681682575,VIS 103,A00,187650,Cruz; Edwin Teddy,17,0,75,58
1683681683600,VIS 110D,A00,187669,Staff,13,0,22,9
1683681684628,VIS 127C,A00,187720,Shen; Kuiyi,67,0,146,79
1683681685656,VIS 149,A00,187731,Yoldas; Pinar,1,14,22,21
1683681686682,VIS 151,A01,188091,Staff,22,0,34,12
1683681686682,VIS 151,A02,188092,Staff,11,0,34,23
1683681687709,VIS 160B,A00,188093,Stalbaum; Brett,0,1,10,10
1683681689762,WCWP 10B,A00,201720,Staff,0,0,5,5
1683681689762,WCWP 10B,B00,201722,Staff,0,0,6,6
1683681690786,WCWP 100,A00,201725,Gagnon; Jeffrey C,0,0,2,2
1683681690786,WCWP 100,B00,201727,Staff,0,4,15,15
1683681693912,ANBI 133,A00,258401,Wilder; Linnea Lorene,34,0,40,6
1683681694937,ANBI 140,A00,258395,Hrvoj Mihic; Branka,18,0,25,7
1683681695962,ANSC 120,A00,258402,Bialecki; Jon Anthony,26,0,40,14
1683681696987,ANSC 144,A00,258400,Staff,12,0,40,28
1683681699039,ANSC 166,A00,258396,Parish; Steven Martin,156,0,175,19
1683681700063,ANSC 180,A00,193533,Staff,8,0,20,12
1683681701105,ANSC 188,A00,258397,Jassal; Aftab,34,0,40,6
1683681702133,ANTH 3,A01,258316,Staff,23,0,30,7
1683681703162,ANTH 5,A00,258394,Semendeferi; Ekaterini,16,0,20,4
1683681704187,ANTH 21,A01,258331,Staff,4,0,40,36
1683681705212,ANTH 103,A00,258398,Varma; Saiba,15,0,25,10
1683681706245,AWP 10,001,202034,Staff,0,0,0,0
1683681706245,AWP 10,002,202035,Staff,0,0,0,0
1683681706245,AWP 10,003,202036,Staff,0,0,0,0
1683681706245,AWP 10,004,202037,Staff,0,0,0,0
1683681706245,AWP 10,005,202038,Staff,0,0,0,0
1683681706245,AWP 10,006,202039,Staff,0,0,0,0
1683681706245,AWP 10,007,202040,Staff,0,0,0,0
1683681706245,AWP 10,008,202041,Staff,0,0,0,0
1683681706245,AWP 10,009,202042,Staff,0,0,0,0
1683681706245,AWP 10,010,202043,Staff,0,0,0,0
1683681706245,AWP 10,011,202044,Staff,0,0,0,0
1683681706245,AWP 10,012,202045,Staff,0,0,0,0
1683681706245,AWP 10,013,202046,Staff,0,0,0,0
1683681706245,AWP 10,014,202047,Staff,0,0,0,0
1683681706245,AWP 10,015,202048,Staff,0,0,0,0
1683681706245,AWP 10,016,202049,Staff,0,0,0,0
1683681706245,AWP 10,017,202050,Staff,0,0,0,0
1683681706245,AWP 10,018,202051,Staff,0,0,0,0
1683681706245,AWP 10,019,202052,Staff,0,0,0,0
1683681706245,AWP 10,020,202053,Staff,0,0,0,0
1683681706245,AWP 10,021,202054,Staff,0,0,0,0
1683681706245,AWP 10,022,202055,Staff,0,0,0,0
1683681706245,AWP 10,023,202056,Staff,0,0,0,0
1683681706245,AWP 10,024,202057,Staff,0,0,0,0
1683681706245,AWP 10,025,202058,Staff,0,0,0,0
1683681706245,AWP 10,026,202059,Staff,0,0,0,0
1683681707269,AWP 102,001,202032,Staff,0,0,0,0
1683681707269,AWP 102,002,202033,Staff,0,0,0,0
1683681708298,BENG 100,A01,254234,Taylor Amos; Alyssa C,31,0,40,9
1683681709327,BENG 196,001,270013,Engler; Adam J.,9999,0,9999,0
1683681710352,BICD 100R,A01,202018,Smith; Laurie,0,7,32,32
1683681710352,BICD 100R,A02,202019,Smith; Laurie,0,3,32,32
1683681710352,BICD 100R,A03,202020,Smith; Laurie,0,1,32,32
1683681710352,BICD 100R,A04,202021,Smith; Laurie,6,0,32,26
1683681710352,BICD 100R,A05,202022,Smith; Laurie,10,0,32,22
1683681711380,BICD 136,A01,193242,Gustafson-Brown; Cindy,0,2,32,32
1683681711380,BICD 136,A02,193244,Gustafson-Brown; Cindy,13,0,32,19
1683681712404,BIEB 102,A01,193249,Butler; Shannon Rhey,1,1,32,31
1683681712404,BIEB 102,A02,193251,Butler; Shannon Rhey,0,0,32,32
1683681712404,BIEB 102,A03,193253,Butler; Shannon Rhey,0,0,32,32
1683681712404,BIEB 102,A04,193255,Butler; Shannon Rhey,13,0,32,19
1683681712404,BIEB 102,A05,193265,Butler; Shannon Rhey,25,0,32,7
1683681712404,BIEB 102,A06,193269,Butler; Shannon Rhey,13,0,32,19
1683681714453,BIEB 150,A01,193274,Staff,0,0,32,32
1683681714453,BIEB 150,A02,193285,Staff,24,0,32,8
1683681715476,BIEB 194,A00,193286,Kurle; Carolyn M.,19,0,32,13
1683681716501,BILD 1,A01,192291,Staff,15,0,32,17
1683681716501,BILD 1,A02,192292,Staff,30,0,32,2
1683681716501,BILD 1,B01,192520,Reuther; Keefe,0,1,0,0
1683681716501,BILD 1,B02,192532,Reuther; Keefe,0,1,0,0
1683681717527,BILD 3,A01,192556,Butler; Shannon Rhey,0,0,32,32
1683681717527,BILD 3,A02,192581,Butler; Shannon Rhey,0,1,32,32
1683681717527,BILD 3,A03,192611,Butler; Shannon Rhey,19,0,32,13
1683681717527,BILD 3,A04,192612,Butler; Shannon Rhey,24,0,32,8
1683681717527,BILD 3,A05,192613,Butler; Shannon Rhey,26,0,32,6
1683681717527,BILD 3,A06,192679,Butler; Shannon Rhey,27,0,32,5
1683681717527,BILD 3,A07,192682,Butler; Shannon Rhey,20,0,32,12
1683681718552,BILD 4,A01,192836,Reuther; Keefe,1,0,24,23
1683681718552,BILD 4,A02,193044,Reuther; Keefe,4,0,24,20
1683681719579,BILD 10,A01,193142,Gustafson-Brown; Cindy,29,0,32,3
1683681719579,BILD 10,A02,193149,Gustafson-Brown; Cindy,31,0,32,1
1683681720602,BIMM 100,A01,193301,Staff,0,6,32,32
1683681720602,BIMM 100,A02,193312,Staff,0,7,32,32
1683681720602,BIMM 100,A03,193323,Staff,0,10,32,32
1683681721630,BIMM 101,A01,193329,McDonnell; Lisa Marie,1,4,24,23
1683681721630,BIMM 101,A02,193339,McDonnell; Lisa Marie,1,4,24,23
1683681721630,BIMM 101,B01,193354,McDonnell; Lisa Marie,0,4,24,24
1683681721630,BIMM 101,B02,193357,McDonnell; Lisa Marie,0,3,24,24
1683681722659,BIMM 110,A01,193377,Tat; John,0,11,32,32
1683681722659,BIMM 110,A02,193378,Tat; John,0,11,32,32
1683681723689,BIMM 120,A01,206116,Staff,0,0,32,32
1683681723689,BIMM 120,A02,206117,Staff,7,0,32,25
1683681723689,BIMM 120,A03,206121,Staff,21,0,32,11
1683681724715,BIPN 100,A01,193393,Park; Ji Young,0,15,32,32
1683681724715,BIPN 100,A02,193402,Park; Ji Young,0,14,32,32
1683681724715,BIPN 100,A03,193413,Park; Ji Young,0,14,32,32
1683681724715,BIPN 100,A04,193414,Park; Ji Young,0,13,32,32
1683681725743,BIPN 102,A01,193429,Staff,0,0,32,32
1683681725743,BIPN 102,A02,193438,Staff,18,0,32,14
1683681726767,BIPN 106,A01,193450,Reyes Gonzalez; Catalina,0,2,40,40
1683681727795,BIPN 134,A01,193465,Cooke; James Edward,0,0,32,32
1683681727795,BIPN 134,A02,193474,Cooke; James Edward,25,0,32,7
1683681727795,BIPN 134,A03,193485,Cooke; James Edward,29,0,32,3
1683681727795,BIPN 134,A04,193486,Cooke; James Edward,20,0,32,12
1683681727795,BIPN 134,A05,193491,Cooke; James Edward,31,0,32,1
1683681727795,BIPN 134,A06,193501,Cooke; James Edward,30,0,32,2
1683681727795,BIPN 134,A07,193510,Cooke; James Edward,29,0,32,3
1683681729849,BISP 194,A00,222522,Staff,14,0,32,18
1683681730876,CAT 124,A01,202407,Staff,19,0,25,6
1683681731901,CAT 125,A00,202408,Marchisotto; Jennifer Anne,2,0,20,18
1683681732930,CAT 125R,A00,202409,Smith; Lauryn Alissa,0,11,20,20
1683681732930,CAT 125R,B00,202410,Morales; Celeste Georgianna,0,11,20,20
1683681732930,CAT 125R,C00,202411,Irwin; Matthew Joseph,0,12,20,20
1683681733958,CENG 15,A01,204712,Yang; Kesong,0,1,0,0
1683681734983,CENG 114,A00,202070,Jahed Motlagh; Zeinab,5,0,20,15
1683681736010,CGS 105,A00,185477,Wesling; Megan E.,24,0,40,16
1683681737035,CGS 106,A00,185494,Staff,11,0,22,11
1683681738058,CGS 108,A00,185495,Staff,14,0,20,6
1683681739083,CGS 114,A00,185496,Staff,13,0,18,5
1683681740108,CGS 119,A00,185501,Staff,15,0,20,5
1683681741132,CGS 120,A00,185511,Staff,12,0,20,8
1683681742155,CHEM 4,A01,184675,Bussey; Thomas J,97,0,100,3
1683681743185,CHEM 6A,A01,184677,Staff,32,0,60,28
1683681744209,CHEM 6B,A01,184679,Staff,63,0,100,37
1683681745233,CHEM 6C,A01,184681,Bussey; Thomas J,0,0,50,50
1683681745233,CHEM 6C,A02,184682,Bussey; Thomas J,32,0,50,18
1683681746257,CHEM 40A,A01,184684,Albizati; Kim F.,33,0,100,67
1683681747281,CHEM 40B,A01,184686,Albizati; Kim F.,0,22,100,100
1683681748308,CHEM 41B,A01,184690,Staff,51,0,100,49
1683681749336,COGS 3,A01,184715,Boyle; Mary E. T.,0,27,40,40
1683681750362,COGS 14B,A01,185172,Staff,0,14,38,38
1683681751389,COGS 18,A01,184736,Staff,14,0,80,66
1683681752413,COGS 100,A01,184932,Staff,0,8,73,73
1683681753441,COGS 101A,A01,184935,Staff,0,40,30,30
1683681754466,COGS 101B,A01,184944,Staff,0,2,30,30
1683681755494,COGS 101C,A01,184946,Staff,0,10,30,30
1683681756523,COGS 102A,A01,184951,Johnson; Christine M.,2,0,40,38
1683681757561,COGS 107B,A01,184953,Mooshagian; Eric Frederick,0,52,40,40
1683681758589,COGS 118B,A01,184959,Gupta; Anjum,0,50,40,40
1683681759614,COGS 153,A00,184961,Staff,0,16,30,30
1683681760643,COGS 177,A00,184962,Staff,0,21,30,30
1683681761669,COGS 187A,A01,184969,Boyle; Mary E. T.,0,19,40,40
1683681762697,COMM 10,A01,185174,Staff,0,5,25,25
1683681762697,COMM 10,A02,185189,Staff,0,2,25,25
1683681762697,COMM 10,A03,269821,Staff,0,1,0,0
1683681763722,COMM 100B,A02,185476,Staff,11,0,25,14
1683681763722,COMM 100B,A03,277340,Staff,25,0,25,0
1683681764750,COMM 100C,A01,185314,Staff,1,0,25,24
1683681764750,COMM 100C,A02,185327,Staff,17,0,25,8
1683681765777,COMM 110M,A00,185349,Staff,0,0,40,40
1683681766801,COMM 113T,A00,185352,Staff,25,0,40,15
1683681767828,COMM 114I,A00,185353,Staff,31,0,40,9
1683681768852,COMM 131,A00,185354,Staff,17,0,30,13
1683681769880,CSE 8A,A50,185358,Cao; Yingjun,0,46,10,10
1683681770907,CSE 8B,A01,185362,Staff,0,48,50,50
1683681771935,CSE 11,A01,185416,Cao; Yingjun,0,91,10,10
1683681772963,CSE 20,A01,185445,Briones; Jor-el Thomas Caparas,3,0,25,22
1683681773988,CSE 21,A01,185447,Staff,9,0,50,41
1683681775015,CSE 101,A01,185451,Staff,0,13,50,50
1683681775015,CSE 101,B01,185453,Jones; Miles E,0,14,50,50
1683681777064,CSE 141,A01,185458,Eldon; John,16,0,100,84
1683681778086,CSE 141L,A01,185461,Eldon; John,8,0,100,92
1683681779110,CSE 142,A01,185463,Staff,34,0,60,26
1683681779110,CSE 142,B01,201355,Staff,0,7,60,60
1683681780134,CSE 142L,A01,185470,Staff,34,0,60,26
1683681780134,CSE 142L,B01,201417,Staff,0,6,60,60
1683681781215,CSE 190,A00,201433,Staff,32,0,49,17
1683681782246,DOC 1,A01,259136,Strom; Megan C.,7,0,15,8
1683681782246,DOC 1,A02,259137,Strom; Megan C.,14,0,15,1
1683681782246,DOC 1,A03,259138,Strom; Megan C.,14,0,15,1
1683681782246,DOC 1,A04,259139,Strom; Megan C.,14,0,15,1
1683681783269,DOC 100D,A00,259140,Pass; Natalye Joann,14,0,25,11
1683681784294,DSGN 1,A01,184749,Rill; Bryan,0,26,30,30
1683681785319,DSGN 100,A01,185168,Staff,0,2,25,25
1683681786343,ECE 5,A01,185626,Morris; Karcher William,0,12,0,0
1683681787370,ECE 101,A01,185628,Staff,14,0,70,56
1683681788397,ECE 107,A01,185635,Baghdadchi; Saharnaz,0,0,20,20
1683681788397,ECE 107,A02,185638,Baghdadchi; Saharnaz,1,0,20,19
1683681789421,ECE 148,A01,185647,Silberman; Jack,0,0,16,16
1683681790446,ECON 1,A01,185537,Crane; Meredith Helen,54,0,70,16
1683681791471,ECON 3,A01,185549,Crane; Meredith Helen,30,0,70,40
1683681792495,ECON 4,A01,203354,Anderson; John Charles,0,5,10,10
1683681793519,ECON 100A,A01,185574,Staff,0,5,40,40
1683681794543,ECON 100B,A01,185576,Staff,0,12,50,50
1683681795571,ECON 100C,A01,185589,Newhouse; Herbert S,30,0,70,40
1683681796595,ECON 105,A00,185608,Vespa; Emanuel Ignacio,19,0,35,16
1683681797619,ECON 109,A01,185610,Shishkin; Denis,9,0,35,26
1683681798643,ECON 110A,A01,185612,Staff,9,0,40,31
1683681799668,ECON 120A,A01,185615,Staff,19,0,40,21
1683681800695,ECON 120C,A01,185617,Sun; Yixiao,0,21,70,70
1683681801723,ECON 144,A00,203346,Squires; Dale E,2,0,35,33
1683681802747,ECON 171,A01,203349,Newhouse; Herbert S,0,1,35,35
1683681803771,ECON 173A,A01,185621,Toda; Alexis Akira,21,0,35,14
1683681804796,EDS 25,A01,202413,Staff,0,1,0,0
1683681804796,EDS 25,A02,202414,Staff,0,1,0,0
1683681804796,EDS 25,A03,202415,Staff,0,0,0,0
1683681804796,EDS 25,A04,202416,Staff,0,1,0,0
1683681804796,EDS 25,A05,202439,Staff,0,0,0,0
1683681804796,EDS 25,A06,202440,Staff,0,0,0,0
1683681804796,EDS 25,B01,202631,Staff,0,0,0,0
1683681804796,EDS 25,B02,202632,Staff,0,0,0,0
1683681804796,EDS 25,B03,202639,Staff,0,0,0,0
1683681804796,EDS 25,B04,202640,Staff,0,0,0,0
1683681804796,EDS 25,B05,202643,Staff,0,0,0,0
1683681804796,EDS 25,B06,202644,Staff,0,0,0,0
1683681805821,EDS 38,A01,202659,Black; Alison Michelle,24,0,25,1
1683681806845,EDS 115,A00,202652,Staff,18,0,30,12
1683681807873,EDS 125,A00,202649,Staff,13,0,30,17
1683681808897,EDS 126,A01,203332,Staff,30,0,30,0
1683681809923,EDS 139,A00,202838,Staff,16,0,25,9
1683681810950,EDS 146,A01,202655,Staff,14,0,25,11
1683681811979,ENG 15,A00,185667,Staff,0,1,0,0
1683681811979,ENG 15,B00,185672,Staff,0,0,0,0
1683681811979,ENG 15,C00,185675,Staff,0,0,0,0
1683681811979,ENG 15,D00,185682,Staff,0,0,0,0
1683681811979,ENG 15,E00,185684,Staff,0,0,0,0
1683681813006,ETHN 103,A00,185710,Staff,0,8,35,35
1683681814034,ETHN 103A,A00,199228,Man; Simeon S,0,0,9,9
1683681815059,ETHN 109,A00,185711,Staff,15,0,35,20
1683681816088,ETHN 142,A00,185726,Staff,0,4,30,30
1683681817115,ETHN 163J,A00,199229,Man; Simeon S,5,0,8,3
1683681818139,ETHN 168,A00,185727,Staff,7,0,10,3
1683681819163,ETHN 182,A00,185728,Staff,0,0,35,35
1683681820188,ETHN 183,A00,185737,Staff,9,0,18,9
1683681821212,GLBH 111,A01,209361,Burgos; Jose L.,0,0,0,0
1683681823268,HIEU 104,A00,185792,Staff,14,0,20,6
1683681824291,HIEU 115,A00,185800,Staff,0,0,20,20
1683681825315,HIEU 128,A00,185801,Staff,0,9,20,20
1683681826343,HIEU 147,A00,185802,Staff,15,0,20,5
1683681827370,HIEU 154,A00,185823,Staff,11,0,20,9
1683681828394,HILA 102,A00,185826,Staff,14,0,20,6
1683681829418,HILD 2C,A01,185778,Staff,0,13,20,20
1683681830442,HILD 7B,A01,185780,Kwak; Nancy,0,17,32,32
1683681830442,HILD 7B,A02,185781,Kwak; Nancy,0,18,32,32
1683681831466,HILD 30,A01,185791,Staff,12,0,20,8
1683681832493,HISC 119,A00,185830,Golan; Tal,0,10,20,20
1683681833517,HITO 156GS,A00,185831,Patterson; Patrick H.,0,0,0,23
1683681834542,HIUS 103,A00,185832,Man; Simeon S,0,4,20,20
1683681835569,HIUS 117,A00,185836,Kwak; Nancy,2,0,20,18
1683681836595,HIUS 125,A00,185840,Man; Simeon S,0,2,23,23
1683681837620,HIUS 149,A00,185845,Staff,1,0,20,19
1683681838645,HUM 3,A01,185882,Zavodny; Tatiana Sophia,0,8,50,50
1683681838645,HUM 3,B01,185899,Caldwell; Michael Alan,0,18,50,50
1683681839671,HUM 3GS,A00,185900,Patterson; Patrick H.,0,0,0,23
1683681840696,HUM 4,A01,185938,Zroka; Amy Liane,28,0,50,22
1683681840696,HUM 4,B01,185956,Watkins; Eric,0,6,50,50
1683681840696,HUM 4,B02,202209,Watkins; Eric,0,5,50,50
1683681840696,HUM 4,B03,202210,Watkins; Eric,0,5,50,50
1683681841720,HUM 5,A01,185958,West; Geoffrey Scott,0,0,50,50
1683681841720,HUM 5,A02,202215,West; Geoffrey Scott,0,0,50,50
1683681842746,INTL 190,A00,185959,Gagnon; Jeffrey C,0,0,0,9
1683681842746,INTL 190,B00,185960,Lettieri; Michael Joseph,0,0,0,2
1683681843771,JAPN 180,A00,254509,Staff,5,0,30,25
1683681844800,LATI 10,A01,202853,Kennemore; Amy Michelle,4,0,35,31
1683681844800,LATI 10,A02,202854,Kennemore; Amy Michelle,3,0,35,32
1683681844800,LATI 10,A03,270054,Kennemore; Amy Michelle,30,0,30,0
1683681845827,LATI 180,A00,202855,Kennemore; Amy Michelle,11,0,20,9
1683681846852,LAWS 101,A00,201767,Golan; Tal,0,7,40,40
1683681847876,LIFR 1C,A00,185961,Staff,6,0,20,14
1683681848900,LIFR 1CX,A00,185962,Staff,7,0,20,13
1683681849927,LIFR 1D,A00,185963,Staff,7,0,20,13
1683681850951,LIFR 1DX,A00,185964,Staff,7,0,20,13
1683681851974,LIGN 101,A01,186039,Staff,43,0,50,7
1683681852998,LIGN 165,A00,186040,Staff,15,0,50,35
1683681854024,LTCS 108,A00,186041,Staff,5,0,10,5
1683681855047,LTCS 119,A00,186042,Staff,15,0,20,5
1683681856071,LTCS 130,A00,186043,Wesling; Megan E.,15,0,25,10
1683681858121,LTEA 138,A00,186119,Staff,14,0,40,26
1683681859148,LTEN 124,A00,186148,Staff,5,0,25,20
1683681860172,LTEN 178,A00,186149,Staff,6,0,15,9
1683681861196,LTEN 181,A00,186150,Blanco; John D,34,0,40,6
1683681862218,LTWL 120,A00,186160,Staff,19,0,25,6
1683681863246,LTWL 165,A00,186161,Staff,22,0,25,3
1683681864273,LTWR 100,A00,186162,Staff,0,5,15,15
1683681865301,LTWR 102,A00,186163,Doller; Ben,5,0,15,10
1683681866325,MAE 8,A01,186412,Staff,0,1,0,0
1683681867353,MAE 30B,A00,186445,Bahadori; Mohammad Yousef,81,0,100,19
1683681868380,MAE 40,A00,186592,Bewley; Thomas R,10,0,50,40
1683681869405,MAE 101B,A00,186593,Bahadori; Mohammad Yousef,80,0,100,20
1683681870432,MAE 105,A00,186594,Bandaru; Prabhakar,10,0,50,40
1683681871457,MAE 107,A00,186599,Pham; Hieu Tan,0,7,120,120
1683681872484,MAE 148,A01,186660,Silberman; Jack,3,0,16,13
1683681873512,MATH 10A,A01,188095,Staff,0,6,35,35
1683681874541,MATH 10B,A01,188097,Bowers; Adam R.,0,12,30,30
1683681874541,MATH 10B,A02,188099,Bowers; Adam R.,0,11,30,30
1683681874541,MATH 10B,B01,188104,Bowers; Adam R.,0,10,30,30
1683681874541,MATH 10B,B02,188106,Bowers; Adam R.,1,9,30,29
1683681875570,MATH 10C,A01,188111,Staff,0,20,30,30
1683681875570,MATH 10C,A02,188127,Staff,0,19,30,30
1683681875570,MATH 10C,A03,188131,Staff,0,19,30,30
1683681875570,MATH 10C,B01,188218,Staff,17,0,30,13
1683681875570,MATH 10C,B02,188244,Staff,13,0,30,17
1683681875570,MATH 10C,B03,188277,Staff,14,0,30,16
1683681876600,MATH 18,A01,188344,Bach; Quang Tran,18,0,30,12
1683681876600,MATH 18,A02,188345,Bach; Quang Tran,11,0,30,19
1683681876600,MATH 18,B01,188353,Bach; Quang Tran,11,0,30,19
1683681876600,MATH 18,B02,188354,Bach; Quang Tran,19,0,30,11
1683681877623,MATH 20A,A01,188374,Staff,11,0,35,24
1683681878648,MATH 20B,A01,188382,Ohm; Ko Woon,7,0,30,23
1683681878648,MATH 20B,A02,188383,Ohm; Ko Woon,22,0,30,8
1683681878648,MATH 20B,B01,188385,Ohm; Ko Woon,7,0,30,23
1683681878648,MATH 20B,B02,188392,Ohm; Ko Woon,22,0,30,8
1683681879673,MATH 20C,A01,188394,Harel; Guershon,10,0,30,20
1683681879673,MATH 20C,A02,188395,Harel; Guershon,13,0,30,17
1683681879673,MATH 20C,B01,188404,Harel; Guershon,5,0,30,25
1683681879673,MATH 20C,B02,188405,Harel; Guershon,18,0,30,12
1683681880703,MATH 20D,A01,188414,Hammock; Frances H,0,1,30,30
1683681880703,MATH 20D,A02,188415,Hammock; Frances H,0,1,30,30
1683681880703,MATH 20D,B01,188447,Hammock; Frances H,0,1,30,30
1683681880703,MATH 20D,B02,188486,Hammock; Frances H,3,0,30,27
1683681881731,MATH 20E,A01,188649,Staff,21,0,30,9
1683681881731,MATH 20E,A02,188650,Staff,20,0,30,10
1683681881731,MATH 20E,A03,188673,Staff,0,0,30,30
1683681882758,MATH 102,A01,188675,Staff,0,39,35,35
1683681883783,MATH 103B,A01,188681,Staff,3,0,35,32
1683681883783,MATH 103B,B01,188692,Staff,5,0,35,30
1683681884867,MATH 109,A01,188695,Salehi Golsefidy; Alireza,24,0,35,11
1683681884867,MATH 109,A02,188696,Salehi Golsefidy; Alireza,25,0,35,10
1683681885893,MATH 120A,A01,188698,Eggers; John Dietrich,7,0,35,28
1683681886918,MATH 142B,A01,188736,Ioana; Adrian,1,1,30,29
1683681886918,MATH 142B,A02,188741,Ioana; Adrian,0,1,30,30
1683681886918,MATH 142B,A03,188743,Ioana; Adrian,0,1,30,30
1683681887945,MATH 168A,A01,188790,Staff,0,11,35,35
1683681888974,MATH 170A,A01,188803,Nie; Jiawang,0,2,35,35
1683681888974,MATH 170A,A02,188811,Nie; Jiawang,0,1,35,35
1683681888974,MATH 170A,A03,188814,Nie; Jiawang,0,0,35,35
1683681888974,MATH 170A,A04,188815,Nie; Jiawang,6,0,35,29
1683681890000,MATH 193B,A01,188817,Staff,0,0,35,35
1683681890000,MATH 193B,A02,188818,Staff,5,0,35,30
1683681891035,MGT 4,A01,202857,Anderson; John Charles,60,0,80,20
1683681892063,MGT 12,A00,202858,Lindenberger; Wade Douglas,40,0,90,50
1683681893088,MGT 18,A00,202859,Staff,74,0,90,16
1683681894113,MGT 18GS,A00,202860,McKay; Michael J,13,0,28,15
1683681895141,MGT 45,A00,202861,Pecore; Joseph P.,8,0,90,82
1683681896169,MGT 100,A00,202863,Yavorsky; Daniel Ryan,28,0,90,62
1683681897196,MGT 103,A00,202864,Ehrich; Kristine R,0,18,90,90
1683681898222,MGT 112,A00,202865,Ehrich; Kristine R,15,0,90,75
1683681899249,MGT 121A,A00,202868,Staff,90,20,90,0
1683681900273,MGT 131B,A00,202869,Anderson; John Charles,59,0,90,31
1683681901299,MGT 136,A00,202871,Lindenberger; Wade Douglas,83,0,90,7
1683681902323,MGT 164,A00,202873,Staff,0,68,90,91
1683681903347,MGT 164GS,A00,202874,McKay; Mary A,13,0,28,15
1683681904371,MGT 180,A00,202875,Staff,0,51,90,91
1683681905399,MMW 11R,A01,205019,Herbst; Matthew,0,0,30,30
1683681905399,MMW 11R,A02,205026,Herbst; Matthew,29,0,30,1
1683681906427,MMW 15,A01,193512,Chang; Edmond Yi-Teh,0,8,28,28
1683681906427,MMW 15,A02,193513,Chang; Edmond Yi-Teh,0,5,28,28
1683681906427,MMW 15,A03,193514,Chang; Edmond Yi-Teh,0,5,28,28
1683681906427,MMW 15,A04,193515,Chang; Edmond Yi-Teh,0,5,28,28
1683681906427,MMW 15,A05,193516,Chang; Edmond Yi-Teh,0,5,28,28
1683681906427,MMW 15,A06,193517,Chang; Edmond Yi-Teh,0,6,28,28
1683681906427,MMW 15,B01,193519,Chang; Edmond Yi-Teh,0,5,28,28
1683681906427,MMW 15,B02,193520,Chang; Edmond Yi-Teh,0,5,28,28
1683681906427,MMW 15,B03,193521,Chang; Edmond Yi-Teh,0,5,28,28
1683681906427,MMW 15,B04,193522,Chang; Edmond Yi-Teh,0,6,28,28
1683681906427,MMW 15,B05,193523,Chang; Edmond Yi-Teh,0,5,28,28
1683681906427,MMW 15,B06,193524,Chang; Edmond Yi-Teh,0,5,28,28
1683681907451,MMW 122,A01,193526,Rahimi; Babak,0,16,28,28
1683681907451,MMW 122,A02,193527,Rahimi; Babak,0,15,28,28
1683681907451,MMW 122,A03,193528,Rahimi; Babak,0,0,0,0
1683681907451,MMW 122,A04,193529,Rahimi; Babak,0,0,0,0
1683681908476,MUS 1A,A01,186663,Staff,1,19,35,34
1683681909499,MUS 4,A01,186715,Staff,0,12,35,35
1683681910523,MUS 5R,A01,186796,Dubnov; Shlomo,0,17,35,35
1683681911546,MUS 6,A01,186798,Staff,1,5,25,24
1683681912571,MUS 7,A01,186830,Staff,11,0,35,24
1683681913596,MUS 8,A01,186930,Staff,0,27,35,35
1683681914625,MUS 15,A01,186932,Staff,0,15,35,35
1683681914625,MUS 15,B01,186934,Staff,1,17,35,34
1683681915649,MUS 80,A00,186935,Staff,0,0,20,20
1683681915649,MUS 80,B00,186936,Staff,24,0,25,1
1683681916672,NANO 11,A00,204702,Lipomi; Darren John,0,0,0,0
1683681917701,NANO 15,A01,204709,Yang; Kesong,0,1,0,0
1683681918728,NANO 114,A00,202069,Jahed Motlagh; Zeinab,3,0,10,7
1683681919751,PHIL 1,A00,186955,Grush; Rick Scott,31,0,40,9
1683681920776,PHIL 10,A01,186973,Grush; Rick Scott,27,0,35,8
1683681920776,PHIL 10,A02,186974,Grush; Rick Scott,33,0,35,2
1683681921800,PHIL 13,A01,186976,Staff,2,0,35,33
1683681921800,PHIL 13,A02,186977,Staff,16,0,35,19
1683681922825,PHIL 14,A01,186979,Staff,31,0,35,4
1683681922825,PHIL 14,A02,186986,Staff,32,0,35,3
1683681923853,PHIL 28,A01,186988,Staff,16,0,30,14
1683681923853,PHIL 28,A02,186989,Staff,1,0,30,29
1683681923853,PHIL 28,A03,186990,Staff,10,0,30,20
1683681923853,PHIL 28,A04,186991,Staff,26,0,30,4
1683681924881,PHIL 120,A00,186997,Staff,23,0,40,17
1683681925909,PHIL 137,A00,187003,Staff,7,0,40,33
1683681926933,PHIL 150,A00,187015,Staff,47,0,70,23
1683681927961,PHIL 167,A00,187021,Lamey; Andy M.,34,0,40,6
1683681928988,PHIL 174,A01,202226,Staff,17,0,20,3
1683681928988,PHIL 174,A02,202235,Staff,20,0,20,0
1683681930016,PHIL 191A,A00,258918,Staff,0,0,1,1
1683681931042,PHYS 1A,A00,187028,Staff,26,0,60,34
1683681932067,PHYS 1AL,001,187036,Staff,3,0,30,27
1683681932067,PHYS 1AL,002,187049,Staff,18,0,30,12
1683681933094,PHYS 1B,A00,187058,Staff,22,0,60,38
1683681934117,PHYS 1BL,001,187064,Staff,0,1,30,30
1683681934117,PHYS 1BL,002,187070,Staff,4,0,30,26
1683681935142,PHYS 1C,A00,187082,Staff,29,0,120,91
1683681936167,PHYS 1CL,001,187088,Staff,0,9,30,30
1683681936167,PHYS 1CL,002,187089,Staff,0,1,30,30
1683681936167,PHYS 1CL,009,262693,Staff,9,0,30,21
1683681937194,PHYS 2B,A01,187097,Staff,55,0,115,60
1683681938223,PHYS 2C,A01,187099,Staff,63,0,115,52
1683681939252,PHYS 2CL,A01,187101,Staff,5,0,28,23
1683681939252,PHYS 2CL,A02,187102,Staff,15,0,28,13
1683681940285,PHYS 2D,A01,187123,Shotwell; Brian,95,0,115,20
1683681941311,PHYS 4B,A01,187133,Grinstein; Benjamin,35,0,50,15
1683681942335,POLI 10,A00,188819,Staff,0,4,50,50
1683681943359,POLI 11,A00,188827,Staff,43,0,50,7
1683681944383,POLI 13R,A00,188828,Staff,0,1,20,20
1683681945407,POLI 27,A01,188830,Elgin; Samuel Zincke,0,2,70,70
1683681946432,POLI 30,A00,188832,Desposato; Scott,30,0,50,20
1683681947457,POLI 102F,A00,188834,Staff,1,0,40,39
1683681948482,POLI 104A,A00,188852,Staff,12,0,30,18
1683681949507,POLI 104I,A00,188853,Staff,0,8,20,20
1683681950531,POLI 110B,A00,188854,Wiens; David,6,0,20,14
1683681951559,POLI 112A,A00,188855,Wiens; David,3,0,30,27
1683681952586,POLI 117R,A00,188856,Forman; Fonna,0,12,20,20
1683681953614,POLI 118,A00,188857,Ingham; Sean,8,0,20,12
1683681954638,POLI 120G,A00,188858,Staff,8,0,30,22
1683681955663,POLI 131CR,A00,188863,Hoston; Germaine,20,0,50,30
1683681956691,POLI 133,A00,188864,Nellis; Gareth Hb,44,0,50,6
1683681957718,POLI 134D,A00,188865,Desposato; Scott,27,0,30,3
1683681958743,POLI 142A,A00,188871,Gartzke; Erik,21,0,50,29
1683681959769,POLI 142K,A00,188874,Staff,38,0,50,12
1683681960797,POLI 143,A00,188940,Gartzke; Erik,16,0,30,14
1683681961822,POLI 153,A00,188943,Staff,2,0,20,18
1683681962846,POLI 160AA,A00,188944,Staff,10,0,40,30
1683681963874,POLI 170A,A00,188945,Staff,10,0,30,20
1683681965923,PSYC 1,A00,188952,Staff,36,0,90,54
1683681966950,PSYC 2,B00,188953,Staff,19,0,35,16
1683681967978,PSYC 6,A00,188970,Staff,47,0,60,13
1683681969005,PSYC 7,A00,188973,Staff,35,0,45,10
1683681970030,PSYC 60,A01,188980,Rickard; Timothy C.,42,0,60,18
1683681971054,PSYC 70,A01,189001,Steiner; Eric Tomas,21,0,45,24
1683681972080,PSYC 100,A00,189005,Lacefield; Katharine I,0,99,120,120
1683681973104,PSYC 102,A00,189008,Staff,7,0,30,23
1683681974132,PSYC 106,B00,189026,Gorman; Michael R.,27,0,60,33
1683681975160,PSYC 114,B01,189033,Winkielman; Piotr,0,31,30,30
1683681976185,PSYC 131,A00,189036,Anagnostaras; Stephan,0,43,60,60
1683681977209,PSYC 136,A00,189041,Lowe; Angela Beth,0,7,25,25
1683681978234,PSYC 137,A00,189057,Winkielman; Piotr,1,37,25,24
1683681979262,PSYC 144,A00,189107,Wixted; John T,0,11,50,50
1683681981315,PSYC 162,A00,189142,Staff,0,9,85,85
1683681982339,PSYC 172,A00,189144,Gorman; Michael R.,0,6,30,30
1683681984388,PSYC 179,A00,189146,Lacefield; Katharine I,0,87,120,120
1683681985413,PSYC 181,A00,189147,Anagnostaras; Stephan,0,44,90,90
1683681986442,PSYC 190R,A00,189148,Barner; David A.,0,23,80,80
1683681987466,PSYC 191,A00,189275,Rickard; Timothy C.,0,10,25,25
1683681988550,PSYC 193,A00,189276,Chapman; Eddie Nathaniel,0,1,0,4
1683681989578,PSYC 193L,A01,189281,Lowe; Angela Beth,8,0,20,12
1683681989578,PSYC 193L,B01,189285,Staff,28,0,35,7
1683681990602,RELI 149,A00,187137,Rahimi; Babak,7,0,40,33
1683681991628,SE 9,A01,187315,Staff,0,2,18,18
1683681992652,SE 101B,A00,187409,Staff,24,0,30,6
1683681993676,SE 110B,A00,187444,Staff,10,0,40,30
1683681994702,SE 130B,A00,187449,Staff,31,0,40,9
1683681995731,SE 150A,A00,187516,Staff,8,0,20,12
1683681996755,SE 154,A00,187528,Staff,29,0,50,21
1683681997779,SIO 3,A01,258171,Staff,35,0,40,5
1683681998813,SIO 10,A00,187144,Cook; Geoffrey W,1,7,75,74
1683681999841,SIO 45,A00,187152,Cook; Geoffrey W,0,7,100,100
1683682000869,SIO 109R,A00,194486,Staff,0,4,20,20
1683682002918,SIO 187,A01,187233,Kacev; David,12,0,40,28
1683682003943,SOCI 1,A01,258656,Thorpe; Charles Robert,28,0,30,2
1683682003943,SOCI 1,A02,258658,Thorpe; Charles Robert,30,0,30,0
1683682003943,SOCI 1,A03,258661,Thorpe; Charles Robert,25,0,25,0
1683682003943,SOCI 1,A04,258666,Thorpe; Charles Robert,22,0,25,3
1683682003943,SOCI 1,A05,258897,Thorpe; Charles Robert,22,0,25,3
1683682003943,SOCI 1,A06,258898,Thorpe; Charles Robert,25,0,25,0
1683682004969,SOCI 30,A01,258903,Pardo Guerra; Juan Pablo,14,0,30,16
1683682005994,SOCI 102,A00,258904,Staff,9,0,25,16
1683682007021,SOCI 106,A00,258905,Staff,19,0,25,6
1683682008048,SOCI 111,A00,258907,Ribas Norris; Janet Vanesa,26,0,30,4
1683682009076,SOCI 121R,A00,258908,Pardo Guerra; Juan Pablo,8,0,30,22
1683682010103,SOCI 126,A01,203330,Staff,14,0,20,6
1683682011127,SOCI 131,A00,258909,Thorpe; Charles Robert,30,0,60,30
1683682012152,SOCI 135,A00,258910,Payne; Christine Anna,0,12,30,30
1683682013177,SOCI 157,A00,258911,Staff,11,0,30,19
1683682014207,SOCI 184,A00,258912,Staff,25,0,30,5
1683682015232,SOCI 188D,A00,258913,Staff,22,0,30,8
1683682016262,SYN 2,001,187529,Staff,9,0,16,7
1683682016262,SYN 2,002,201452,Staff,1,20,16,15
1683682016262,SYN 2,003,201469,Staff,1,0,16,15
1683682017287,SYN 100,A01,187531,Staff,0,9,20,20
1683682017287,SYN 100,B01,201491,Staff,0,10,20,20
1683682018310,TDAC 1,A00,189286,Walsh; Kim C.,3,0,20,17
1683682018310,TDAC 1,B00,189287,Harting; Carla Kelso,10,0,20,10
1683682019340,TDAC 101,A00,189300,Walsh; Kim C.,16,0,20,4
1683682019340,TDAC 101,B00,189301,Harting; Carla Kelso,18,0,20,2
1683682020364,TDAC 102,A00,189304,Basso; Beatrice,14,0,20,6
1683682021390,TDAC 108,A00,189305,Staff,18,0,20,2
1683682022415,TDDE 131,A00,189310,Staff,19,0,20,1
1683682022415,TDDE 131,B00,189314,Staff,19,0,20,1
1683682022415,TDDE 131,C00,189315,Staff,48,0,50,2
1683682022415,TDDE 131,D00,189316,Staff,14,0,15,1
1683682022415,TDDE 131,E00,204841,Staff,20,0,20,0
1683682023441,TDGE 10,A00,189289,Staff,27,0,50,23
1683682023441,TDGE 10,B00,189290,Havis; Allan,0,1,50,50
1683682024466,TDGE 11,A00,189291,Fulton; Julia,0,4,50,50
1683682024466,TDGE 11,B00,189292,Staff,20,0,25,5
1683682024466,TDGE 11,C00,260270,Staff,0,0,0,0
1683682025493,TDGE 25,A00,189294,Staff,1,0,20,19
1683682026519,TDGE 124,A00,189318,Fulton; Julia,0,8,50,50
1683682027542,TDGE 125,A00,189319,Staff,13,0,25,12
1683682027542,TDGE 125,B00,189320,Staff,23,0,25,2
1683682028566,TDGE 127,A00,189322,Havis; Allan,0,0,50,50
1683682029590,TDHT 101,A00,189323,Staff,18,0,25,7
1683682029590,TDHT 101,B00,189324,Staff,25,0,25,0
1683682030617,TDHT 102,A00,189325,Staff,49,0,50,1
1683682031641,TDMV 1,A00,189295,Arcidiacono; Kristin,20,0,30,10
1683682031641,TDMV 1,B00,189296,Caligagan; Maria T.,24,0,30,6
1683682032666,TDMV 2,A00,189297,Sammartano; Tonnie,27,0,30,3
1683682032666,TDMV 2,B00,189299,Arcidiacono; Kristin,23,0,30,7
1683682033691,TDMV 3,A00,204998,Rincon; Alicia,22,0,30,8
1683682034715,TDMV 120,A00,189458,Sammartano; Tonnie,28,0,30,2
1683682035739,TDMV 138,A00,189541,Jun; Grace Shin Hae,20,0,40,20
1683682036768,TDMV 142,A00,189717,Caligagan; Tony,25,0,30,5
1683682036768,TDMV 142,B00,189718,Caligagan; Maria T.,25,0,30,5
1683682037791,TMC 2,A01,187533,Staff,25,0,25,0
1683682037791,TMC 2,A02,187534,Staff,25,0,25,0
1683682038815,USP 1,A01,187536,Kwak; Nancy,0,16,25,25
1683682039842,USP 5,A01,187538,Staff,8,0,25,17
1683682040865,USP 101,A00,199253,Staff,0,4,0,0
1683682041891,USP 124,A00,187562,Boomhower; Matthew Charles,0,0,30,30
1683682042918,USP 138,A00,187582,Staff,19,0,25,6
1683682043943,USP 152,A01,187597,Staff,3,0,25,22
1683682044968,USP 153,A00,187598,Staff,18,0,25,7
1683682045992,USP 168,A00,187607,Kwak; Nancy,2,0,5,3
1683682047016,USP 173,A00,187619,Staff,4,0,25,21
1683682048044,USP 181,A00,187638,Staff,0,4,25,25
1683682049071,VIS 103,A00,187650,Cruz; Edwin Teddy,17,0,75,58
1683682050099,VIS 110D,A00,187669,Staff,13,0,22,9
1683682051122,VIS 127C,A00,187720,Shen; Kuiyi,67,0,146,79
1683682052150,VIS 149,A00,187731,Yoldas; Pinar,1,14,22,21
1683682053176,VIS 151,A01,188091,Staff,22,0,34,12
1683682053176,VIS 151,A02,188092,Staff,11,0,34,23
1683682054203,VIS 160B,A00,188093,Stalbaum; Brett,0,1,10,10
1683682056257,WCWP 10B,A00,201720,Staff,0,0,5,5
1683682056257,WCWP 10B,B00,201722,Staff,0,0,6,6
1683682057279,WCWP 100,A00,201725,Gagnon; Jeffrey C,0,0,2,2
1683682057279,WCWP 100,B00,201727,Staff,0,4,15,15
1683682060370,ANBI 133,A00,258401,Wilder; Linnea Lorene,34,0,40,6
1683682061398,ANBI 140,A00,258395,Hrvoj Mihic; Branka,18,0,25,7
1683682062426,ANSC 120,A00,258402,Bialecki; Jon Anthony,26,0,40,14
1683682063451,ANSC 144,A00,258400,Staff,12,0,40,28
1683682065503,ANSC 166,A00,258396,Parish; Steven Martin,156,0,175,19
1683682066530,ANSC 180,A00,193533,Staff,8,0,20,12
1683682067555,ANSC 188,A00,258397,Jassal; Aftab,34,0,40,6
1683682068582,ANTH 3,A01,258316,Staff,23,0,30,7
1683682069610,ANTH 5,A00,258394,Semendeferi; Ekaterini,16,0,20,4
1683682070634,ANTH 21,A01,258331,Staff,4,0,40,36
1683682071660,ANTH 103,A00,258398,Varma; Saiba,15,0,25,10
1683682072693,AWP 10,001,202034,Staff,0,0,0,0
1683682072693,AWP 10,002,202035,Staff,0,0,0,0
1683682072693,AWP 10,003,202036,Staff,0,0,0,0
1683682072693,AWP 10,004,202037,Staff,0,0,0,0
1683682072693,AWP 10,005,202038,Staff,0,0,0,0
1683682072693,AWP 10,006,202039,Staff,0,0,0,0
1683682072693,AWP 10,007,202040,Staff,0,0,0,0
1683682072693,AWP 10,008,202041,Staff,0,0,0,0
1683682072693,AWP 10,009,202042,Staff,0,0,0,0
1683682072693,AWP 10,010,202043,Staff,0,0,0,0
1683682072693,AWP 10,011,202044,Staff,0,0,0,0
1683682072693,AWP 10,012,202045,Staff,0,0,0,0
1683682072693,AWP 10,013,202046,Staff,0,0,0,0
1683682072693,AWP 10,014,202047,Staff,0,0,0,0
1683682072693,AWP 10,015,202048,Staff,0,0,0,0
1683682072693,AWP 10,016,202049,Staff,0,0,0,0
1683682072693,AWP 10,017,202050,Staff,0,0,0,0
1683682072693,AWP 10,018,202051,Staff,0,0,0,0
1683682072693,AWP 10,019,202052,Staff,0,0,0,0
1683682072693,AWP 10,020,202053,Staff,0,0,0,0
1683682072693,AWP 10,021,202054,Staff,0,0,0,0
1683682072693,AWP 10,022,202055,Staff,0,0,0,0
1683682072693,AWP 10,023,202056,Staff,0,0,0,0
1683682072693,AWP 10,024,202057,Staff,0,0,0,0
1683682072693,AWP 10,025,202058,Staff,0,0,0,0
1683682072693,AWP 10,026,202059,Staff,0,0,0,0
1683682073720,AWP 102,001,202032,Staff,0,0,0,0
1683682073720,AWP 102,002,202033,Staff,0,0,0,0
1683682074745,BENG 100,A01,254234,Taylor Amos; Alyssa C,31,0,40,9
1683682075770,BENG 196,001,270013,Engler; Adam J.,9999,0,9999,0
1683682076800,BICD 100R,A01,202018,Smith; Laurie,0,7,32,32
1683682076800,BICD 100R,A02,202019,Smith; Laurie,0,3,32,32
1683682076800,BICD 100R,A03,202020,Smith; Laurie,0,1,32,32
1683682076800,BICD 100R,A04,202021,Smith; Laurie,6,0,32,26
1683682076800,BICD 100R,A05,202022,Smith; Laurie,10,0,32,22
1683682077826,BICD 136,A01,193242,Gustafson-Brown; Cindy,0,2,32,32
1683682077826,BICD 136,A02,193244,Gustafson-Brown; Cindy,13,0,32,19
1683682078855,BIEB 102,A01,193249,Butler; Shannon Rhey,1,1,32,31
1683682078855,BIEB 102,A02,193251,Butler; Shannon Rhey,0,0,32,32
1683682078855,BIEB 102,A03,193253,Butler; Shannon Rhey,0,0,32,32
1683682078855,BIEB 102,A04,193255,Butler; Shannon Rhey,13,0,32,19
1683682078855,BIEB 102,A05,193265,Butler; Shannon Rhey,25,0,32,7
1683682078855,BIEB 102,A06,193269,Butler; Shannon Rhey,13,0,32,19
1683682080905,BIEB 150,A01,193274,Staff,0,0,32,32
1683682080905,BIEB 150,A02,193285,Staff,24,0,32,8
1683682081933,BIEB 194,A00,193286,Kurle; Carolyn M.,19,0,32,13
1683682082958,BILD 1,A01,192291,Staff,15,0,32,17
1683682082958,BILD 1,A02,192292,Staff,30,0,32,2
1683682082958,BILD 1,B01,192520,Reuther; Keefe,0,1,0,0
1683682082958,BILD 1,B02,192532,Reuther; Keefe,0,1,0,0
1683682083984,BILD 3,A01,192556,Butler; Shannon Rhey,0,0,32,32
1683682083984,BILD 3,A02,192581,Butler; Shannon Rhey,0,1,32,32
1683682083984,BILD 3,A03,192611,Butler; Shannon Rhey,19,0,32,13
1683682083984,BILD 3,A04,192612,Butler; Shannon Rhey,24,0,32,8
1683682083984,BILD 3,A05,192613,Butler; Shannon Rhey,26,0,32,6
1683682083984,BILD 3,A06,192679,Butler; Shannon Rhey,27,0,32,5
1683682083984,BILD 3,A07,192682,Butler; Shannon Rhey,20,0,32,12
1683682085010,BILD 4,A01,192836,Reuther; Keefe,1,0,24,23
1683682085010,BILD 4,A02,193044,Reuther; Keefe,4,0,24,20
1683682086038,BILD 10,A01,193142,Gustafson-Brown; Cindy,29,0,32,3
1683682086038,BILD 10,A02,193149,Gustafson-Brown; Cindy,31,0,32,1
1683682087069,BIMM 100,A01,193301,Staff,0,6,32,32
1683682087069,BIMM 100,A02,193312,Staff,0,7,32,32
1683682087069,BIMM 100,A03,193323,Staff,0,10,32,32
1683682088099,BIMM 101,A01,193329,McDonnell; Lisa Marie,1,4,24,23
1683682088099,BIMM 101,A02,193339,McDonnell; Lisa Marie,1,4,24,23
1683682088099,BIMM 101,B01,193354,McDonnell; Lisa Marie,0,4,24,24
1683682088099,BIMM 101,B02,193357,McDonnell; Lisa Marie,0,3,24,24
1683682089123,BIMM 110,A01,193377,Tat; John,0,11,32,32
1683682089123,BIMM 110,A02,193378,Tat; John,0,11,32,32
1683682090145,BIMM 120,A01,206116,Staff,0,0,32,32
1683682090145,BIMM 120,A02,206117,Staff,7,0,32,25
1683682090145,BIMM 120,A03,206121,Staff,21,0,32,11
1683682091171,BIPN 100,A01,193393,Park; Ji Young,0,15,32,32
1683682091171,BIPN 100,A02,193402,Park; Ji Young,0,14,32,32
1683682091171,BIPN 100,A03,193413,Park; Ji Young,0,14,32,32
1683682091171,BIPN 100,A04,193414,Park; Ji Young,0,13,32,32
1683682092255,BIPN 102,A01,193429,Staff,0,0,32,32
1683682092255,BIPN 102,A02,193438,Staff,18,0,32,14
1683682093282,BIPN 106,A01,193450,Reyes Gonzalez; Catalina,0,2,40,40
1683682094311,BIPN 134,A01,193465,Cooke; James Edward,0,0,32,32
1683682094311,BIPN 134,A02,193474,Cooke; James Edward,25,0,32,7
1683682094311,BIPN 134,A03,193485,Cooke; James Edward,29,0,32,3
1683682094311,BIPN 134,A04,193486,Cooke; James Edward,20,0,32,12
1683682094311,BIPN 134,A05,193491,Cooke; James Edward,31,0,32,1
1683682094311,BIPN 134,A06,193501,Cooke; James Edward,30,0,32,2
1683682094311,BIPN 134,A07,193510,Cooke; James Edward,29,0,32,3
1683682096362,BISP 194,A00,222522,Staff,14,0,32,18
1683682097391,CAT 124,A01,202407,Staff,19,0,25,6
1683682098415,CAT 125,A00,202408,Marchisotto; Jennifer Anne,2,0,20,18
1683682099444,CAT 125R,A00,202409,Smith; Lauryn Alissa,0,11,20,20
1683682099444,CAT 125R,B00,202410,Morales; Celeste Georgianna,0,11,20,20
1683682099444,CAT 125R,C00,202411,Irwin; Matthew Joseph,0,12,20,20
1683682100473,CENG 15,A01,204712,Yang; Kesong,0,1,0,0
1683682101498,CENG 114,A00,202070,Jahed Motlagh; Zeinab,5,0,20,15
1683682102528,CGS 105,A00,185477,Wesling; Megan E.,24,0,40,16
1683682103558,CGS 106,A00,185494,Staff,11,0,22,11
1683682104585,CGS 108,A00,185495,Staff,14,0,20,6
1683682105613,CGS 114,A00,185496,Staff,13,0,18,5
1683682106637,CGS 119,A00,185501,Staff,15,0,20,5
1683682107661,CGS 120,A00,185511,Staff,12,0,20,8
1683682108684,CHEM 4,A01,184675,Bussey; Thomas J,97,0,100,3
1683682109712,CHEM 6A,A01,184677,Staff,32,0,60,28
1683682110737,CHEM 6B,A01,184679,Staff,63,0,100,37
1683682111762,CHEM 6C,A01,184681,Bussey; Thomas J,0,0,50,50
1683682111762,CHEM 6C,A02,184682,Bussey; Thomas J,32,0,50,18
1683682112786,CHEM 40A,A01,184684,Albizati; Kim F.,33,0,100,67
1683682113810,CHEM 40B,A01,184686,Albizati; Kim F.,0,22,100,100
1683682114835,CHEM 41B,A01,184690,Staff,51,0,100,49
1683682115863,COGS 3,A01,184715,Boyle; Mary E. T.,0,27,40,40
1683682116891,COGS 14B,A01,185172,Staff,0,14,38,38
1683682117918,COGS 18,A01,184736,Staff,14,0,80,66
1683682118945,COGS 100,A01,184932,Staff,0,8,73,73
1683682119969,COGS 101A,A01,184935,Staff,0,40,30,30
1683682120997,COGS 101B,A01,184944,Staff,0,2,30,30
1683682122021,COGS 101C,A01,184946,Staff,0,10,30,30
1683682123047,COGS 102A,A01,184951,Johnson; Christine M.,2,0,40,38
1683682124071,COGS 107B,A01,184953,Mooshagian; Eric Frederick,0,52,40,40
1683682125094,COGS 118B,A01,184959,Gupta; Anjum,0,50,40,40
1683682126121,COGS 153,A00,184961,Staff,0,16,30,30
1683682127148,COGS 177,A00,184962,Staff,0,21,30,30
1683682128171,COGS 187A,A01,184969,Boyle; Mary E. T.,0,19,40,40
1683682129199,COMM 10,A01,185174,Staff,0,5,25,25
1683682129199,COMM 10,A02,185189,Staff,0,2,25,25
1683682129199,COMM 10,A03,269821,Staff,0,1,0,0
1683682130223,COMM 100B,A02,185476,Staff,10,0,25,15
1683682130223,COMM 100B,A03,277340,Staff,25,0,25,0
1683682131247,COMM 100C,A01,185314,Staff,1,0,25,24
1683682131247,COMM 100C,A02,185327,Staff,17,0,25,8
1683682132271,COMM 110M,A00,185349,Staff,0,0,40,40
1683682133295,COMM 113T,A00,185352,Staff,25,0,40,15
1683682134319,COMM 114I,A00,185353,Staff,31,0,40,9
1683682135347,COMM 131,A00,185354,Staff,17,0,30,13
1683682136371,CSE 8A,A50,185358,Cao; Yingjun,0,46,10,10
1683682137395,CSE 8B,A01,185362,Staff,0,48,50,50
1683682138423,CSE 11,A01,185416,Cao; Yingjun,0,91,10,10
1683682139448,CSE 20,A01,185445,Briones; Jor-el Thomas Caparas,3,0,25,22
1683682140473,CSE 21,A01,185447,Staff,9,0,50,41
1683682141497,CSE 101,A01,185451,Staff,0,13,50,50
1683682141497,CSE 101,B01,185453,Jones; Miles E,0,14,50,50
1683682143546,CSE 141,A01,185458,Eldon; John,16,0,100,84
1683682144569,CSE 141L,A01,185461,Eldon; John,8,0,100,92
1683682145592,CSE 142,A01,185463,Staff,34,0,60,26
1683682145592,CSE 142,B01,201355,Staff,0,7,60,60
1683682146619,CSE 142L,A01,185470,Staff,34,0,60,26
1683682146619,CSE 142L,B01,201417,Staff,0,6,60,60
1683682147643,CSE 190,A00,201433,Staff,32,0,49,17
1683682148671,DOC 1,A01,259136,Strom; Megan C.,7,0,15,8
1683682148671,DOC 1,A02,259137,Strom; Megan C.,14,0,15,1
1683682148671,DOC 1,A03,259138,Strom; Megan C.,14,0,15,1
1683682148671,DOC 1,A04,259139,Strom; Megan C.,14,0,15,1
1683682149695,DOC 100D,A00,259140,Pass; Natalye Joann,14,0,25,11
1683682150723,DSGN 1,A01,184749,Rill; Bryan,0,26,30,30
1683682151750,DSGN 100,A01,185168,Staff,0,2,25,25
1683682152775,ECE 5,A01,185626,Morris; Karcher William,0,12,0,0
1683682153799,ECE 101,A01,185628,Staff,14,0,70,56
1683682154827,ECE 107,A01,185635,Baghdadchi; Saharnaz,0,0,20,20
1683682154827,ECE 107,A02,185638,Baghdadchi; Saharnaz,1,0,20,19
1683682155855,ECE 148,A01,185647,Silberman; Jack,0,0,16,16
1683682156879,ECON 1,A01,185537,Crane; Meredith Helen,54,0,70,16
1683682157907,ECON 3,A01,185549,Crane; Meredith Helen,30,0,70,40
1683682158936,ECON 4,A01,203354,Anderson; John Charles,0,5,10,10
1683682159961,ECON 100A,A01,185574,Staff,0,5,40,40
1683682160989,ECON 100B,A01,185576,Staff,0,12,50,50
1683682162013,ECON 100C,A01,185589,Newhouse; Herbert S,30,0,70,40
1683682163041,ECON 105,A00,185608,Vespa; Emanuel Ignacio,19,0,35,16
1683682164065,ECON 109,A01,185610,Shishkin; Denis,9,0,35,26
1683682165089,ECON 110A,A01,185612,Staff,9,0,40,31
1683682166116,ECON 120A,A01,185615,Staff,19,0,40,21
1683682167144,ECON 120C,A01,185617,Sun; Yixiao,0,21,70,70
1683682168170,ECON 144,A00,203346,Squires; Dale E,2,0,35,33
1683682169195,ECON 171,A01,203349,Newhouse; Herbert S,0,1,35,35
1683682170221,ECON 173A,A01,185621,Toda; Alexis Akira,21,0,35,14
1683682171251,EDS 25,A01,202413,Staff,0,1,0,0
1683682171251,EDS 25,A02,202414,Staff,0,1,0,0
1683682171251,EDS 25,A03,202415,Staff,0,0,0,0
1683682171251,EDS 25,A04,202416,Staff,0,1,0,0
1683682171251,EDS 25,A05,202439,Staff,0,0,0,0
1683682171251,EDS 25,A06,202440,Staff,0,0,0,0
1683682171251,EDS 25,B01,202631,Staff,0,0,0,0
1683682171251,EDS 25,B02,202632,Staff,0,0,0,0
1683682171251,EDS 25,B03,202639,Staff,0,0,0,0
1683682171251,EDS 25,B04,202640,Staff,0,0,0,0
1683682171251,EDS 25,B05,202643,Staff,0,0,0,0
1683682171251,EDS 25,B06,202644,Staff,0,0,0,0
1683682172277,EDS 38,A01,202659,Black; Alison Michelle,24,0,25,1
1683682173306,EDS 115,A00,202652,Staff,18,0,30,12
1683682174332,EDS 125,A00,202649,Staff,13,0,30,17
1683682175356,EDS 126,A01,203332,Staff,30,0,30,0
1683682176382,EDS 139,A00,202838,Staff,16,0,25,9
1683682177409,EDS 146,A01,202655,Staff,14,0,25,11
1683682178438,ENG 15,A00,185667,Staff,0,1,0,0
1683682178438,ENG 15,B00,185672,Staff,0,0,0,0
1683682178438,ENG 15,C00,185675,Staff,0,0,0,0
1683682178438,ENG 15,D00,185682,Staff,0,0,0,0
1683682178438,ENG 15,E00,185684,Staff,0,0,0,0
1683682179463,ETHN 103,A00,185710,Staff,0,8,35,35
1683682180488,ETHN 103A,A00,199228,Man; Simeon S,0,0,9,9
1683682181516,ETHN 109,A00,185711,Staff,15,0,35,20
1683682182543,ETHN 142,A00,185726,Staff,0,4,30,30
1683682183568,ETHN 163J,A00,199229,Man; Simeon S,5,0,8,3
1683682184593,ETHN 168,A00,185727,Staff,7,0,10,3
1683682185621,ETHN 182,A00,185728,Staff,0,0,35,35
1683682186649,ETHN 183,A00,185737,Staff,9,0,18,9
1683682187677,GLBH 111,A01,209361,Burgos; Jose L.,0,0,0,0
1683682189729,HIEU 104,A00,185792,Staff,14,0,20,6
1683682190753,HIEU 115,A00,185800,Staff,0,0,20,20
1683682191777,HIEU 128,A00,185801,Staff,0,9,20,20
1683682192805,HIEU 147,A00,185802,Staff,15,0,20,5
1683682193829,HIEU 154,A00,185823,Staff,11,0,20,9
1683682194852,HILA 102,A00,185826,Staff,14,0,20,6
1683682195932,HILD 2C,A01,185778,Staff,0,13,20,20
1683682196960,HILD 7B,A01,185780,Kwak; Nancy,0,17,32,32
1683682196960,HILD 7B,A02,185781,Kwak; Nancy,0,18,32,32
1683682197985,HILD 30,A01,185791,Staff,12,0,20,8
1683682199010,HISC 119,A00,185830,Golan; Tal,0,10,20,20
1683682200038,HITO 156GS,A00,185831,Patterson; Patrick H.,0,0,0,23
1683682201066,HIUS 103,A00,185832,Man; Simeon S,0,4,20,20
1683682202091,HIUS 117,A00,185836,Kwak; Nancy,2,0,20,18
1683682203122,HIUS 125,A00,185840,Man; Simeon S,0,2,23,23
1683682204150,HIUS 149,A00,185845,Staff,1,0,20,19
1683682205174,HUM 3,A01,185882,Zavodny; Tatiana Sophia,0,8,50,50
1683682205174,HUM 3,B01,185899,Caldwell; Michael Alan,0,18,50,50
1683682206200,HUM 3GS,A00,185900,Patterson; Patrick H.,0,0,0,23
1683682207224,HUM 4,A01,185938,Zroka; Amy Liane,28,0,50,22
1683682207224,HUM 4,B01,185956,Watkins; Eric,0,6,50,50
1683682207224,HUM 4,B02,202209,Watkins; Eric,0,5,50,50
1683682207224,HUM 4,B03,202210,Watkins; Eric,0,5,50,50
1683682208254,HUM 5,A01,185958,West; Geoffrey Scott,0,0,50,50
1683682208254,HUM 5,A02,202215,West; Geoffrey Scott,0,0,50,50
1683682209279,INTL 190,A00,185959,Gagnon; Jeffrey C,0,0,0,9
1683682209279,INTL 190,B00,185960,Lettieri; Michael Joseph,0,0,0,2
1683682210305,JAPN 180,A00,254509,Staff,5,0,30,25
1683682211334,LATI 10,A01,202853,Kennemore; Amy Michelle,4,0,35,31
1683682211334,LATI 10,A02,202854,Kennemore; Amy Michelle,3,0,35,32
1683682211334,LATI 10,A03,270054,Kennemore; Amy Michelle,30,0,30,0
1683682212359,LATI 180,A00,202855,Kennemore; Amy Michelle,11,0,20,9
1683682213384,LAWS 101,A00,201767,Golan; Tal,0,7,40,40
1683682214408,LIFR 1C,A00,185961,Staff,6,0,20,14
1683682215435,LIFR 1CX,A00,185962,Staff,7,0,20,13
1683682216459,LIFR 1D,A00,185963,Staff,7,0,20,13
1683682217482,LIFR 1DX,A00,185964,Staff,7,0,20,13
1683682218510,LIGN 101,A01,186039,Staff,43,0,50,7
1683682219534,LIGN 165,A00,186040,Staff,15,0,50,35
1683682220559,LTCS 108,A00,186041,Staff,5,0,10,5
1683682221584,LTCS 119,A00,186042,Staff,15,0,20,5
1683682222609,LTCS 130,A00,186043,Wesling; Megan E.,15,0,25,10
1683682224661,LTEA 138,A00,186119,Staff,14,0,40,26
1683682225689,LTEN 124,A00,186148,Staff,5,0,25,20
1683682226716,LTEN 178,A00,186149,Staff,6,0,15,9
1683682227744,LTEN 181,A00,186150,Blanco; John D,34,0,40,6
1683682228771,LTWL 120,A00,186160,Staff,19,0,25,6
1683682229798,LTWL 165,A00,186161,Staff,22,0,25,3
1683682230822,LTWR 100,A00,186162,Staff,0,5,15,15
1683682231846,LTWR 102,A00,186163,Doller; Ben,5,0,15,10
1683682232872,MAE 8,A01,186412,Staff,0,1,0,0
1683682233897,MAE 30B,A00,186445,Bahadori; Mohammad Yousef,81,0,100,19
1683682234921,MAE 40,A00,186592,Bewley; Thomas R,10,0,50,40
1683682235947,MAE 101B,A00,186593,Bahadori; Mohammad Yousef,80,0,100,20
1683682236975,MAE 105,A00,186594,Bandaru; Prabhakar,10,0,50,40
1683682238001,MAE 107,A00,186599,Pham; Hieu Tan,0,7,120,120
1683682239026,MAE 148,A01,186660,Silberman; Jack,3,0,16,13
1683682240051,MATH 10A,A01,188095,Staff,0,6,35,35
1683682241076,MATH 10B,A01,188097,Bowers; Adam R.,0,12,30,30
1683682241076,MATH 10B,A02,188099,Bowers; Adam R.,0,11,30,30
1683682241076,MATH 10B,B01,188104,Bowers; Adam R.,0,10,30,30
1683682241076,MATH 10B,B02,188106,Bowers; Adam R.,1,9,30,29
1683682242101,MATH 10C,A01,188111,Staff,0,20,30,30
1683682242101,MATH 10C,A02,188127,Staff,0,19,30,30
1683682242101,MATH 10C,A03,188131,Staff,0,19,30,30
1683682242101,MATH 10C,B01,188218,Staff,17,0,30,13
1683682242101,MATH 10C,B02,188244,Staff,13,0,30,17
1683682242101,MATH 10C,B03,188277,Staff,14,0,30,16
1683682243127,MATH 18,A01,188344,Bach; Quang Tran,18,0,30,12
1683682243127,MATH 18,A02,188345,Bach; Quang Tran,11,0,30,19
1683682243127,MATH 18,B01,188353,Bach; Quang Tran,11,0,30,19
1683682243127,MATH 18,B02,188354,Bach; Quang Tran,19,0,30,11
1683682244155,MATH 20A,A01,188374,Staff,11,0,35,24
1683682245183,MATH 20B,A01,188382,Ohm; Ko Woon,7,0,30,23
1683682245183,MATH 20B,A02,188383,Ohm; Ko Woon,22,0,30,8
1683682245183,MATH 20B,B01,188385,Ohm; Ko Woon,7,0,30,23
1683682245183,MATH 20B,B02,188392,Ohm; Ko Woon,22,0,30,8
1683682246212,MATH 20C,A01,188394,Harel; Guershon,10,0,30,20
1683682246212,MATH 20C,A02,188395,Harel; Guershon,13,0,30,17
1683682246212,MATH 20C,B01,188404,Harel; Guershon,5,0,30,25
1683682246212,MATH 20C,B02,188405,Harel; Guershon,18,0,30,12
1683682247246,MATH 20D,A01,188414,Hammock; Frances H,0,1,30,30
1683682247246,MATH 20D,A02,188415,Hammock; Frances H,0,1,30,30
1683682247246,MATH 20D,B01,188447,Hammock; Frances H,0,1,30,30
1683682247246,MATH 20D,B02,188486,Hammock; Frances H,3,0,30,27
1683682248271,MATH 20E,A01,188649,Staff,21,0,30,9
1683682248271,MATH 20E,A02,188650,Staff,20,0,30,10
1683682248271,MATH 20E,A03,188673,Staff,0,0,30,30
1683682249295,MATH 102,A01,188675,Staff,0,39,35,35
1683682250320,MATH 103B,A01,188681,Staff,3,0,35,32
1683682250320,MATH 103B,B01,188692,Staff,5,0,35,30
1683682251343,MATH 109,A01,188695,Salehi Golsefidy; Alireza,24,0,35,11
1683682251343,MATH 109,A02,188696,Salehi Golsefidy; Alireza,25,0,35,10
1683682252368,MATH 120A,A01,188698,Eggers; John Dietrich,7,0,35,28
1683682253398,MATH 142B,A01,188736,Ioana; Adrian,1,1,30,29
1683682253398,MATH 142B,A02,188741,Ioana; Adrian,0,1,30,30
1683682253398,MATH 142B,A03,188743,Ioana; Adrian,0,1,30,30
1683682254425,MATH 168A,A01,188790,Staff,0,11,35,35
1683682255448,MATH 170A,A01,188803,Nie; Jiawang,0,2,35,35
1683682255448,MATH 170A,A02,188811,Nie; Jiawang,0,1,35,35
1683682255448,MATH 170A,A03,188814,Nie; Jiawang,0,0,35,35
1683682255448,MATH 170A,A04,188815,Nie; Jiawang,6,0,35,29
1683682256472,MATH 193B,A01,188817,Staff,0,0,35,35
1683682256472,MATH 193B,A02,188818,Staff,5,0,35,30
1683682257497,MGT 4,A01,202857,Anderson; John Charles,60,0,80,20
1683682258521,MGT 12,A00,202858,Lindenberger; Wade Douglas,40,0,90,50
1683682259545,MGT 18,A00,202859,Staff,74,0,90,16
1683682260570,MGT 18GS,A00,202860,McKay; Michael J,13,0,28,15
1683682261603,MGT 45,A00,202861,Pecore; Joseph P.,8,0,90,82
1683682262631,MGT 100,A00,202863,Yavorsky; Daniel Ryan,28,0,90,62
1683682263659,MGT 103,A00,202864,Ehrich; Kristine R,0,18,90,90
1683682264684,MGT 112,A00,202865,Ehrich; Kristine R,15,0,90,75
1683682265709,MGT 121A,A00,202868,Staff,90,20,90,0
1683682266733,MGT 131B,A00,202869,Anderson; John Charles,59,0,90,31
1683682267757,MGT 136,A00,202871,Lindenberger; Wade Douglas,83,0,90,7
1683682268785,MGT 164,A00,202873,Staff,0,68,90,91
1683682269808,MGT 164GS,A00,202874,McKay; Mary A,13,0,28,15
1683682270838,MGT 180,A00,202875,Staff,0,51,90,91
1683682271865,MMW 11R,A01,205019,Herbst; Matthew,0,0,30,30
1683682271865,MMW 11R,A02,205026,Herbst; Matthew,29,0,30,1
1683682272894,MMW 15,A01,193512,Chang; Edmond Yi-Teh,0,8,28,28
1683682272894,MMW 15,A02,193513,Chang; Edmond Yi-Teh,0,5,28,28
1683682272894,MMW 15,A03,193514,Chang; Edmond Yi-Teh,0,5,28,28
1683682272894,MMW 15,A04,193515,Chang; Edmond Yi-Teh,0,5,28,28
1683682272894,MMW 15,A05,193516,Chang; Edmond Yi-Teh,0,5,28,28
1683682272894,MMW 15,A06,193517,Chang; Edmond Yi-Teh,0,6,28,28
1683682272894,MMW 15,B01,193519,Chang; Edmond Yi-Teh,0,5,28,28
1683682272894,MMW 15,B02,193520,Chang; Edmond Yi-Teh,0,5,28,28
1683682272894,MMW 15,B03,193521,Chang; Edmond Yi-Teh,0,5,28,28
1683682272894,MMW 15,B04,193522,Chang; Edmond Yi-Teh,0,6,28,28
1683682272894,MMW 15,B05,193523,Chang; Edmond Yi-Teh,0,5,28,28
1683682272894,MMW 15,B06,193524,Chang; Edmond Yi-Teh,0,5,28,28
1683682273918,MMW 122,A01,193526,Rahimi; Babak,0,16,28,28
1683682273918,MMW 122,A02,193527,Rahimi; Babak,0,15,28,28
1683682273918,MMW 122,A03,193528,Rahimi; Babak,0,0,0,0
1683682273918,MMW 122,A04,193529,Rahimi; Babak,0,0,0,0
1683682274942,MUS 1A,A01,186663,Staff,1,19,35,34
1683682275965,MUS 4,A01,186715,Staff,0,12,35,35
1683682276992,MUS 5R,A01,186796,Dubnov; Shlomo,0,17,35,35
1683682278020,MUS 6,A01,186798,Staff,1,5,25,24
1683682279046,MUS 7,A01,186830,Staff,11,0,35,24
1683682280072,MUS 8,A01,186930,Staff,0,27,35,35
1683682281097,MUS 15,A01,186932,Staff,0,15,35,35
1683682281097,MUS 15,B01,186934,Staff,1,17,35,34
1683682282120,MUS 80,A00,186935,Staff,0,0,20,20
1683682282120,MUS 80,B00,186936,Staff,24,0,25,1
1683682283145,NANO 11,A00,204702,Lipomi; Darren John,0,0,0,0
1683682284168,NANO 15,A01,204709,Yang; Kesong,0,1,0,0
1683682285194,NANO 114,A00,202069,Jahed Motlagh; Zeinab,3,0,10,7
1683682286218,PHIL 1,A00,186955,Grush; Rick Scott,31,0,40,9
1683682287242,PHIL 10,A01,186973,Grush; Rick Scott,27,0,35,8
1683682287242,PHIL 10,A02,186974,Grush; Rick Scott,33,0,35,2
1683682288266,PHIL 13,A01,186976,Staff,1,0,35,34
1683682288266,PHIL 13,A02,186977,Staff,16,0,35,19
1683682289291,PHIL 14,A01,186979,Staff,31,0,35,4
1683682289291,PHIL 14,A02,186986,Staff,32,0,35,3
1683682290319,PHIL 28,A01,186988,Staff,16,0,30,14
1683682290319,PHIL 28,A02,186989,Staff,1,0,30,29
1683682290319,PHIL 28,A03,186990,Staff,10,0,30,20
1683682290319,PHIL 28,A04,186991,Staff,26,0,30,4
1683682291346,PHIL 120,A00,186997,Staff,23,0,40,17
1683682292374,PHIL 137,A00,187003,Staff,7,0,40,33
1683682293398,PHIL 150,A00,187015,Staff,47,0,70,23
1683682294422,PHIL 167,A00,187021,Lamey; Andy M.,34,0,40,6
1683682295447,PHIL 174,A01,202226,Staff,17,0,20,3
1683682295447,PHIL 174,A02,202235,Staff,20,0,20,0
1683682296472,PHIL 191A,A00,258918,Staff,0,0,1,1
1683682297498,PHYS 1A,A00,187028,Staff,26,0,60,34
1683682298526,PHYS 1AL,001,187036,Staff,3,0,30,27
1683682298526,PHYS 1AL,002,187049,Staff,18,0,30,12
1683682299633,PHYS 1B,A00,187058,Staff,22,0,60,38
1683682300661,PHYS 1BL,001,187064,Staff,0,1,30,30
1683682300661,PHYS 1BL,002,187070,Staff,4,0,30,26
1683682301688,PHYS 1C,A00,187082,Staff,29,0,120,91
1683682302712,PHYS 1CL,001,187088,Staff,0,9,30,30
1683682302712,PHYS 1CL,002,187089,Staff,0,1,30,30
1683682302712,PHYS 1CL,009,262693,Staff,9,0,30,21
1683682303737,PHYS 2B,A01,187097,Staff,55,0,115,60
1683682304765,PHYS 2C,A01,187099,Staff,63,0,115,52
1683682305789,PHYS 2CL,A01,187101,Staff,5,0,28,23
1683682305789,PHYS 2CL,A02,187102,Staff,15,0,28,13
1683682306818,PHYS 2D,A01,187123,Shotwell; Brian,95,0,115,20
1683682307842,PHYS 4B,A01,187133,Grinstein; Benjamin,35,0,50,15
1683682308867,POLI 10,A00,188819,Staff,0,4,50,50
1683682309892,POLI 11,A00,188827,Staff,43,0,50,7
1683682310920,POLI 13R,A00,188828,Staff,0,1,20,20
1683682311944,POLI 27,A01,188830,Elgin; Samuel Zincke,0,2,70,70
1683682312968,POLI 30,A00,188832,Desposato; Scott,30,0,50,20
1683682313993,POLI 102F,A00,188834,Staff,1,0,40,39
1683682315017,POLI 104A,A00,188852,Staff,12,0,30,18
1683682316042,POLI 104I,A00,188853,Staff,0,8,20,20
1683682317070,POLI 110B,A00,188854,Wiens; David,6,0,20,14
1683682318097,POLI 112A,A00,188855,Wiens; David,3,0,30,27
1683682319124,POLI 117R,A00,188856,Forman; Fonna,0,12,20,20
1683682320152,POLI 118,A00,188857,Ingham; Sean,8,0,20,12
1683682321177,POLI 120G,A00,188858,Staff,8,0,30,22
1683682322205,POLI 131CR,A00,188863,Hoston; Germaine,20,0,50,30
1683682323234,POLI 133,A00,188864,Nellis; Gareth Hb,44,0,50,6
1683682324257,POLI 134D,A00,188865,Desposato; Scott,27,0,30,3
1683682325280,POLI 142A,A00,188871,Gartzke; Erik,21,0,50,29
1683682326306,POLI 142K,A00,188874,Staff,38,0,50,12
1683682327331,POLI 143,A00,188940,Gartzke; Erik,16,0,30,14
1683682328356,POLI 153,A00,188943,Staff,2,0,20,18
1683682329383,POLI 160AA,A00,188944,Staff,10,0,40,30
1683682330407,POLI 170A,A00,188945,Staff,10,0,30,20
1683682332457,PSYC 1,A00,188952,Staff,36,0,90,54
1683682333481,PSYC 2,B00,188953,Staff,19,0,35,16
1683682334505,PSYC 6,A00,188970,Staff,47,0,60,13
1683682335528,PSYC 7,A00,188973,Staff,35,0,45,10
1683682336553,PSYC 60,A01,188980,Rickard; Timothy C.,42,0,60,18
1683682337577,PSYC 70,A01,189001,Steiner; Eric Tomas,21,0,45,24
1683682338600,PSYC 100,A00,189005,Lacefield; Katharine I,0,99,120,120
1683682339624,PSYC 102,A00,189008,Staff,7,0,30,23
1683682340651,PSYC 106,B00,189026,Gorman; Michael R.,27,0,60,33
1683682341678,PSYC 114,B01,189033,Winkielman; Piotr,0,31,30,30
1683682342703,PSYC 131,A00,189036,Anagnostaras; Stephan,0,43,60,60
1683682343728,PSYC 136,A00,189041,Lowe; Angela Beth,0,7,25,25
1683682344754,PSYC 137,A00,189057,Winkielman; Piotr,1,37,25,24
1683682345778,PSYC 144,A00,189107,Wixted; John T,0,11,50,50
1683682347835,PSYC 162,A00,189142,Staff,0,9,85,85
1683682348860,PSYC 172,A00,189144,Gorman; Michael R.,0,6,30,30
1683682350912,PSYC 179,A00,189146,Lacefield; Katharine I,0,87,120,120
1683682351935,PSYC 181,A00,189147,Anagnostaras; Stephan,0,44,90,90
1683682352960,PSYC 190R,A00,189148,Barner; David A.,0,23,80,80
1683682353984,PSYC 191,A00,189275,Rickard; Timothy C.,0,10,25,25
1683682355008,PSYC 193,A00,189276,Chapman; Eddie Nathaniel,0,1,0,4
1683682356037,PSYC 193L,A01,189281,Lowe; Angela Beth,8,0,20,12
1683682356037,PSYC 193L,B01,189285,Staff,28,0,35,7
1683682357065,RELI 149,A00,187137,Rahimi; Babak,7,0,40,33
1683682358090,SE 9,A01,187315,Staff,0,2,18,18
1683682359117,SE 101B,A00,187409,Staff,24,0,30,6
1683682360140,SE 110B,A00,187444,Staff,10,0,40,30
1683682361163,SE 130B,A00,187449,Staff,31,0,40,9
1683682362189,SE 150A,A00,187516,Staff,8,0,20,12
1683682363214,SE 154,A00,187528,Staff,29,0,50,21
1683682364237,SIO 3,A01,258171,Staff,35,0,40,5
1683682365261,SIO 10,A00,187144,Cook; Geoffrey W,1,7,75,74
1683682366285,SIO 45,A00,187152,Cook; Geoffrey W,0,7,100,100
1683682367310,SIO 109R,A00,194486,Staff,0,4,20,20
1683682369362,SIO 187,A01,187233,Kacev; David,12,0,40,28
1683682370392,SOCI 1,A01,258656,Thorpe; Charles Robert,28,0,30,2
1683682370392,SOCI 1,A02,258658,Thorpe; Charles Robert,30,0,30,0
1683682370392,SOCI 1,A03,258661,Thorpe; Charles Robert,25,0,25,0
1683682370392,SOCI 1,A04,258666,Thorpe; Charles Robert,22,0,25,3
1683682370392,SOCI 1,A05,258897,Thorpe; Charles Robert,22,0,25,3
1683682370392,SOCI 1,A06,258898,Thorpe; Charles Robert,25,0,25,0
1683682371418,SOCI 30,A01,258903,Pardo Guerra; Juan Pablo,14,0,30,16
1683682372441,SOCI 102,A00,258904,Staff,9,0,25,16
1683682373470,SOCI 106,A00,258905,Staff,19,0,25,6
1683682374497,SOCI 111,A00,258907,Ribas Norris; Janet Vanesa,26,0,30,4
1683682375521,SOCI 121R,A00,258908,Pardo Guerra; Juan Pablo,8,0,30,22
1683682376546,SOCI 126,A01,203330,Staff,14,0,20,6
1683682377567,SOCI 131,A00,258909,Thorpe; Charles Robert,30,0,60,30
1683682378591,SOCI 135,A00,258910,Payne; Christine Anna,0,12,30,30
1683682379615,SOCI 157,A00,258911,Staff,11,0,30,19
1683682380643,SOCI 184,A00,258912,Staff,25,0,30,5
1683682381667,SOCI 188D,A00,258913,Staff,22,0,30,8
1683682382694,SYN 2,001,187529,Staff,9,0,16,7
1683682382694,SYN 2,002,201452,Staff,1,20,16,15
1683682382694,SYN 2,003,201469,Staff,1,0,16,15
1683682383717,SYN 100,A01,187531,Staff,0,9,20,20
1683682383717,SYN 100,B01,201491,Staff,0,10,20,20
1683682384742,TDAC 1,A00,189286,Walsh; Kim C.,3,0,20,17
1683682384742,TDAC 1,B00,189287,Harting; Carla Kelso,10,0,20,10
1683682385770,TDAC 101,A00,189300,Walsh; Kim C.,16,0,20,4
1683682385770,TDAC 101,B00,189301,Harting; Carla Kelso,18,0,20,2
1683682386794,TDAC 102,A00,189304,Basso; Beatrice,14,0,20,6
1683682387822,TDAC 108,A00,189305,Staff,18,0,20,2
1683682388849,TDDE 131,A00,189310,Staff,19,0,20,1
1683682388849,TDDE 131,B00,189314,Staff,19,0,20,1
1683682388849,TDDE 131,C00,189315,Staff,48,0,50,2
1683682388849,TDDE 131,D00,189316,Staff,14,0,15,1
1683682388849,TDDE 131,E00,204841,Staff,20,0,20,0
1683682389873,TDGE 10,A00,189289,Staff,27,0,50,23
1683682389873,TDGE 10,B00,189290,Havis; Allan,0,1,50,50
1683682390903,TDGE 11,A00,189291,Fulton; Julia,0,4,50,50
1683682390903,TDGE 11,B00,189292,Staff,20,0,25,5
1683682390903,TDGE 11,C00,260270,Staff,0,0,0,0
1683682391926,TDGE 25,A00,189294,Staff,1,0,20,19
1683682392950,TDGE 124,A00,189318,Fulton; Julia,0,8,50,50
1683682393978,TDGE 125,A00,189319,Staff,13,0,25,12
1683682393978,TDGE 125,B00,189320,Staff,23,0,25,2
1683682395005,TDGE 127,A00,189322,Havis; Allan,0,0,50,50
1683682396033,TDHT 101,A00,189323,Staff,18,0,25,7
1683682396033,TDHT 101,B00,189324,Staff,25,0,25,0
1683682397060,TDHT 102,A00,189325,Staff,49,0,50,1
1683682398088,TDMV 1,A00,189295,Arcidiacono; Kristin,20,0,30,10
1683682398088,TDMV 1,B00,189296,Caligagan; Maria T.,24,0,30,6
1683682399117,TDMV 2,A00,189297,Sammartano; Tonnie,27,0,30,3
1683682399117,TDMV 2,B00,189299,Arcidiacono; Kristin,23,0,30,7
1683682400142,TDMV 3,A00,204998,Rincon; Alicia,22,0,30,8
1683682401167,TDMV 120,A00,189458,Sammartano; Tonnie,28,0,30,2
1683682402191,TDMV 138,A00,189541,Jun; Grace Shin Hae,20,0,40,20
1683682403270,TDMV 142,A00,189717,Caligagan; Tony,25,0,30,5
1683682403270,TDMV 142,B00,189718,Caligagan; Maria T.,25,0,30,5
1683682404297,TMC 2,A01,187533,Staff,25,0,25,0
1683682404297,TMC 2,A02,187534,Staff,25,0,25,0
1683682405328,USP 1,A01,187536,Kwak; Nancy,0,16,25,25
1683682406356,USP 5,A01,187538,Staff,8,0,25,17
1683682407383,USP 101,A00,199253,Staff,0,4,0,0
1683682408407,USP 124,A00,187562,Boomhower; Matthew Charles,0,0,30,30
1683682409429,USP 138,A00,187582,Staff,19,0,25,6
1683682410453,USP 152,A01,187597,Staff,3,0,25,22
1683682411489,USP 153,A00,187598,Staff,18,0,25,7
1683682412513,USP 168,A00,187607,Kwak; Nancy,2,0,5,3
1683682413538,USP 173,A00,187619,Staff,4,0,25,21
1683682414561,USP 181,A00,187638,Staff,0,4,25,25
1683682415585,VIS 103,A00,187650,Cruz; Edwin Teddy,17,0,75,58
1683682416613,VIS 110D,A00,187669,Staff,13,0,22,9
1683682417638,VIS 127C,A00,187720,Shen; Kuiyi,67,0,146,79
1683682418666,VIS 149,A00,187731,Yoldas; Pinar,1,14,22,21
1683682419690,VIS 151,A01,188091,Staff,22,0,34,12
1683682419690,VIS 151,A02,188092,Staff,11,0,34,23
1683682420714,VIS 160B,A00,188093,Stalbaum; Brett,0,1,10,10
1683682422763,WCWP 10B,A00,201720,Staff,0,0,5,5
1683682422763,WCWP 10B,B00,201722,Staff,0,0,6,6
1683682423789,WCWP 100,A00,201725,Gagnon; Jeffrey C,0,0,2,2
1683682423789,WCWP 100,B00,201727,Staff,0,4,15,15
1683682426874,ANBI 133,A00,258401,Wilder; Linnea Lorene,34,0,40,6
1683682427898,ANBI 140,A00,258395,Hrvoj Mihic; Branka,18,0,25,7
1683682428922,ANSC 120,A00,258402,Bialecki; Jon Anthony,26,0,40,14
1683682429947,ANSC 144,A00,258400,Staff,12,0,40,28
1683682432000,ANSC 166,A00,258396,Parish; Steven Martin,156,0,175,19
1683682433026,ANSC 180,A00,193533,Staff,8,0,20,12
1683682434052,ANSC 188,A00,258397,Jassal; Aftab,34,0,40,6
1683682435081,ANTH 3,A01,258316,Staff,23,0,30,7
1683682436108,ANTH 5,A00,258394,Semendeferi; Ekaterini,16,0,20,4
1683682437136,ANTH 21,A01,258331,Staff,4,0,40,36
1683682438160,ANTH 103,A00,258398,Varma; Saiba,15,0,25,10
1683682439188,AWP 10,001,202034,Staff,0,0,0,0
1683682439188,AWP 10,002,202035,Staff,0,0,0,0
1683682439188,AWP 10,003,202036,Staff,0,0,0,0
1683682439188,AWP 10,004,202037,Staff,0,0,0,0
1683682439188,AWP 10,005,202038,Staff,0,0,0,0
1683682439188,AWP 10,006,202039,Staff,0,0,0,0
1683682439188,AWP 10,007,202040,Staff,0,0,0,0
1683682439188,AWP 10,008,202041,Staff,0,0,0,0
1683682439188,AWP 10,009,202042,Staff,0,0,0,0
1683682439188,AWP 10,010,202043,Staff,0,0,0,0
1683682439188,AWP 10,011,202044,Staff,0,0,0,0
1683682439188,AWP 10,012,202045,Staff,0,0,0,0
1683682439188,AWP 10,013,202046,Staff,0,0,0,0
1683682439188,AWP 10,014,202047,Staff,0,0,0,0
1683682439188,AWP 10,015,202048,Staff,0,0,0,0
1683682439188,AWP 10,016,202049,Staff,0,0,0,0
1683682439188,AWP 10,017,202050,Staff,0,0,0,0
1683682439188,AWP 10,018,202051,Staff,0,0,0,0
1683682439188,AWP 10,019,202052,Staff,0,0,0,0
1683682439188,AWP 10,020,202053,Staff,0,0,0,0
1683682439188,AWP 10,021,202054,Staff,0,0,0,0
1683682439188,AWP 10,022,202055,Staff,0,0,0,0
1683682439188,AWP 10,023,202056,Staff,0,0,0,0
1683682439188,AWP 10,024,202057,Staff,0,0,0,0
1683682439188,AWP 10,025,202058,Staff,0,0,0,0
1683682439188,AWP 10,026,202059,Staff,0,0,0,0
1683682440213,AWP 102,001,202032,Staff,0,0,0,0
1683682440213,AWP 102,002,202033,Staff,0,0,0,0
1683682441238,BENG 100,A01,254234,Taylor Amos; Alyssa C,31,0,40,9
1683682442261,BENG 196,001,270013,Engler; Adam J.,9999,0,9999,0
1683682443287,BICD 100R,A01,202018,Smith; Laurie,0,7,32,32
1683682443287,BICD 100R,A02,202019,Smith; Laurie,0,3,32,32
1683682443287,BICD 100R,A03,202020,Smith; Laurie,0,1,32,32
1683682443287,BICD 100R,A04,202021,Smith; Laurie,6,0,32,26
1683682443287,BICD 100R,A05,202022,Smith; Laurie,10,0,32,22
1683682444315,BICD 136,A01,193242,Gustafson-Brown; Cindy,0,2,32,32
1683682444315,BICD 136,A02,193244,Gustafson-Brown; Cindy,13,0,32,19
1683682445339,BIEB 102,A01,193249,Butler; Shannon Rhey,1,1,32,31
1683682445339,BIEB 102,A02,193251,Butler; Shannon Rhey,0,0,32,32
1683682445339,BIEB 102,A03,193253,Butler; Shannon Rhey,0,0,32,32
1683682445339,BIEB 102,A04,193255,Butler; Shannon Rhey,13,0,32,19
1683682445339,BIEB 102,A05,193265,Butler; Shannon Rhey,25,0,32,7
1683682445339,BIEB 102,A06,193269,Butler; Shannon Rhey,13,0,32,19
1683682447385,BIEB 150,A01,193274,Staff,0,0,32,32
1683682447385,BIEB 150,A02,193285,Staff,24,0,32,8
1683682448409,BIEB 194,A00,193286,Kurle; Carolyn M.,19,0,32,13
1683682449433,BILD 1,A01,192291,Staff,15,0,32,17
1683682449433,BILD 1,A02,192292,Staff,30,0,32,2
1683682449433,BILD 1,B01,192520,Reuther; Keefe,0,1,0,0
1683682449433,BILD 1,B02,192532,Reuther; Keefe,0,1,0,0
1683682450462,BILD 3,A01,192556,Butler; Shannon Rhey,0,0,32,32
1683682450462,BILD 3,A02,192581,Butler; Shannon Rhey,0,1,32,32
1683682450462,BILD 3,A03,192611,Butler; Shannon Rhey,19,0,32,13
1683682450462,BILD 3,A04,192612,Butler; Shannon Rhey,24,0,32,8
1683682450462,BILD 3,A05,192613,Butler; Shannon Rhey,26,0,32,6
1683682450462,BILD 3,A06,192679,Butler; Shannon Rhey,27,0,32,5
1683682450462,BILD 3,A07,192682,Butler; Shannon Rhey,20,0,32,12
1683682451490,BILD 4,A01,192836,Reuther; Keefe,1,0,24,23
1683682451490,BILD 4,A02,193044,Reuther; Keefe,4,0,24,20
1683682452518,BILD 10,A01,193142,Gustafson-Brown; Cindy,29,0,32,3
1683682452518,BILD 10,A02,193149,Gustafson-Brown; Cindy,31,0,32,1
1683682453546,BIMM 100,A01,193301,Staff,0,6,32,32
1683682453546,BIMM 100,A02,193312,Staff,0,7,32,32
1683682453546,BIMM 100,A03,193323,Staff,0,10,32,32
1683682454574,BIMM 101,A01,193329,McDonnell; Lisa Marie,1,4,24,23
1683682454574,BIMM 101,A02,193339,McDonnell; Lisa Marie,1,4,24,23
1683682454574,BIMM 101,B01,193354,McDonnell; Lisa Marie,0,4,24,24
1683682454574,BIMM 101,B02,193357,McDonnell; Lisa Marie,0,3,24,24
1683682455597,BIMM 110,A01,193377,Tat; John,0,11,32,32
1683682455597,BIMM 110,A02,193378,Tat; John,0,11,32,32
1683682456622,BIMM 120,A01,206116,Staff,0,0,32,32
1683682456622,BIMM 120,A02,206117,Staff,7,0,32,25
1683682456622,BIMM 120,A03,206121,Staff,21,0,32,11
1683682457653,BIPN 100,A01,193393,Park; Ji Young,0,15,32,32
1683682457653,BIPN 100,A02,193402,Park; Ji Young,0,14,32,32
1683682457653,BIPN 100,A03,193413,Park; Ji Young,0,14,32,32
1683682457653,BIPN 100,A04,193414,Park; Ji Young,0,13,32,32
1683682458681,BIPN 102,A01,193429,Staff,0,0,32,32
1683682458681,BIPN 102,A02,193438,Staff,18,0,32,14
1683682459706,BIPN 106,A01,193450,Reyes Gonzalez; Catalina,0,2,40,40
1683682460733,BIPN 134,A01,193465,Cooke; James Edward,0,0,32,32
1683682460733,BIPN 134,A02,193474,Cooke; James Edward,25,0,32,7
1683682460733,BIPN 134,A03,193485,Cooke; James Edward,29,0,32,3
1683682460733,BIPN 134,A04,193486,Cooke; James Edward,20,0,32,12
1683682460733,BIPN 134,A05,193491,Cooke; James Edward,31,0,32,1
1683682460733,BIPN 134,A06,193501,Cooke; James Edward,30,0,32,2
1683682460733,BIPN 134,A07,193510,Cooke; James Edward,29,0,32,3
1683682462784,BISP 194,A00,222522,Staff,14,0,32,18
1683682463808,CAT 124,A01,202407,Staff,19,0,25,6
1683682464836,CAT 125,A00,202408,Marchisotto; Jennifer Anne,2,0,20,18
1683682465866,CAT 125R,A00,202409,Smith; Lauryn Alissa,0,11,20,20
1683682465866,CAT 125R,B00,202410,Morales; Celeste Georgianna,0,11,20,20
1683682465866,CAT 125R,C00,202411,Irwin; Matthew Joseph,0,12,20,20
1683682466890,CENG 15,A01,204712,Yang; Kesong,0,1,0,0
1683682467914,CENG 114,A00,202070,Jahed Motlagh; Zeinab,5,0,20,15
1683682468942,CGS 105,A00,185477,Wesling; Megan E.,24,0,40,16
1683682469969,CGS 106,A00,185494,Staff,11,0,22,11
1683682470996,CGS 108,A00,185495,Staff,14,0,20,6
1683682472019,CGS 114,A00,185496,Staff,13,0,18,5
1683682473043,CGS 119,A00,185501,Staff,15,0,20,5
1683682474067,CGS 120,A00,185511,Staff,12,0,20,8
1683682475094,CHEM 4,A01,184675,Bussey; Thomas J,97,0,100,3
1683682476118,CHEM 6A,A01,184677,Staff,32,0,60,28
1683682477142,CHEM 6B,A01,184679,Staff,63,0,100,37
1683682478166,CHEM 6C,A01,184681,Bussey; Thomas J,0,0,50,50
1683682478166,CHEM 6C,A02,184682,Bussey; Thomas J,32,0,50,18
1683682479191,CHEM 40A,A01,184684,Albizati; Kim F.,33,0,100,67
1683682480214,CHEM 40B,A01,184686,Albizati; Kim F.,0,22,100,100
1683682481238,CHEM 41B,A01,184690,Staff,51,0,100,49
1683682482261,COGS 3,A01,184715,Boyle; Mary E. T.,0,27,40,40
1683682483285,COGS 14B,A01,185172,Staff,0,14,38,38
1683682484310,COGS 18,A01,184736,Staff,14,0,80,66
1683682485333,COGS 100,A01,184932,Staff,0,8,73,73
1683682486359,COGS 101A,A01,184935,Staff,0,40,30,30
1683682487384,COGS 101B,A01,184944,Staff,0,2,30,30
1683682488409,COGS 101C,A01,184946,Staff,0,10,30,30
1683682489432,COGS 102A,A01,184951,Johnson; Christine M.,1,0,40,39
1683682490459,COGS 107B,A01,184953,Mooshagian; Eric Frederick,0,52,40,40
1683682491483,COGS 118B,A01,184959,Gupta; Anjum,0,50,40,40
1683682492510,COGS 153,A00,184961,Staff,0,16,30,30
1683682493535,COGS 177,A00,184962,Staff,1,21,30,29
1683682494564,COGS 187A,A01,184969,Boyle; Mary E. T.,0,19,40,40
1683682495587,COMM 10,A01,185174,Staff,0,5,25,25
1683682495587,COMM 10,A02,185189,Staff,0,2,25,25
1683682495587,COMM 10,A03,269821,Staff,0,1,0,0
1683682496615,COMM 100B,A02,185476,Staff,10,0,25,15
1683682496615,COMM 100B,A03,277340,Staff,25,0,25,0
1683682497643,COMM 100C,A01,185314,Staff,1,0,25,24
1683682497643,COMM 100C,A02,185327,Staff,17,0,25,8
1683682498670,COMM 110M,A00,185349,Staff,0,0,40,40
1683682499695,COMM 113T,A00,185352,Staff,25,0,40,15
1683682500719,COMM 114I,A00,185353,Staff,31,0,40,9
1683682501747,COMM 131,A00,185354,Staff,17,0,30,13
1683682502771,CSE 8A,A50,185358,Cao; Yingjun,0,46,10,10
1683682503800,CSE 8B,A01,185362,Staff,0,48,50,50
1683682504831,CSE 11,A01,185416,Cao; Yingjun,0,91,10,10
1683682505858,CSE 20,A01,185445,Briones; Jor-el Thomas Caparas,3,0,25,22
1683682506943,CSE 21,A01,185447,Staff,9,0,50,41
1683682507967,CSE 101,A01,185451,Staff,0,13,50,50
1683682507967,CSE 101,B01,185453,Jones; Miles E,0,14,50,50
1683682510015,CSE 141,A01,185458,Eldon; John,16,0,100,84
1683682511040,CSE 141L,A01,185461,Eldon; John,8,0,100,92
1683682512065,CSE 142,A01,185463,Staff,34,0,60,26
1683682512065,CSE 142,B01,201355,Staff,0,7,60,60
1683682513094,CSE 142L,A01,185470,Staff,34,0,60,26
1683682513094,CSE 142L,B01,201417,Staff,0,6,60,60
1683682514119,CSE 190,A00,201433,Staff,32,0,49,17
1683682515144,DOC 1,A01,259136,Strom; Megan C.,7,0,15,8
1683682515144,DOC 1,A02,259137,Strom; Megan C.,14,0,15,1
1683682515144,DOC 1,A03,259138,Strom; Megan C.,14,0,15,1
1683682515144,DOC 1,A04,259139,Strom; Megan C.,14,0,15,1
1683682516171,DOC 100D,A00,259140,Pass; Natalye Joann,14,0,25,11
1683682517195,DSGN 1,A01,184749,Rill; Bryan,0,26,30,30
1683682518217,DSGN 100,A01,185168,Staff,0,2,25,25
1683682519243,ECE 5,A01,185626,Morris; Karcher William,0,12,0,0
1683682520271,ECE 101,A01,185628,Staff,14,0,70,56
1683682521297,ECE 107,A01,185635,Baghdadchi; Saharnaz,0,0,20,20
1683682521297,ECE 107,A02,185638,Baghdadchi; Saharnaz,1,0,20,19
1683682522322,ECE 148,A01,185647,Silberman; Jack,0,0,16,16
1683682523349,ECON 1,A01,185537,Crane; Meredith Helen,54,0,70,16
1683682524374,ECON 3,A01,185549,Crane; Meredith Helen,30,0,70,40
1683682525401,ECON 4,A01,203354,Anderson; John Charles,0,5,10,10
1683682526427,ECON 100A,A01,185574,Staff,0,5,40,40
1683682527454,ECON 100B,A01,185576,Staff,0,12,50,50
1683682528479,ECON 100C,A01,185589,Newhouse; Herbert S,30,0,70,40
1683682529506,ECON 105,A00,185608,Vespa; Emanuel Ignacio,19,0,35,16
1683682530530,ECON 109,A01,185610,Shishkin; Denis,9,0,35,26
1683682531555,ECON 110A,A01,185612,Staff,9,0,40,31
1683682532578,ECON 120A,A01,185615,Staff,19,0,40,21
1683682533602,ECON 120C,A01,185617,Sun; Yixiao,0,21,70,70
1683682534627,ECON 144,A00,203346,Squires; Dale E,2,0,35,33
1683682535650,ECON 171,A01,203349,Newhouse; Herbert S,0,1,35,35
1683682536674,ECON 173A,A01,185621,Toda; Alexis Akira,21,0,35,14
1683682537704,EDS 25,A01,202413,Staff,0,1,0,0
1683682537704,EDS 25,A02,202414,Staff,0,1,0,0
1683682537704,EDS 25,A03,202415,Staff,0,0,0,0
1683682537704,EDS 25,A04,202416,Staff,0,1,0,0
1683682537704,EDS 25,A05,202439,Staff,0,0,0,0
1683682537704,EDS 25,A06,202440,Staff,0,0,0,0
1683682537704,EDS 25,B01,202631,Staff,0,0,0,0
1683682537704,EDS 25,B02,202632,Staff,0,0,0,0
1683682537704,EDS 25,B03,202639,Staff,0,0,0,0
1683682537704,EDS 25,B04,202640,Staff,0,0,0,0
1683682537704,EDS 25,B05,202643,Staff,0,0,0,0
1683682537704,EDS 25,B06,202644,Staff,0,0,0,0
1683682538730,EDS 38,A01,202659,Black; Alison Michelle,24,0,25,1
1683682539753,EDS 115,A00,202652,Staff,18,0,30,12
1683682540781,EDS 125,A00,202649,Staff,13,0,30,17
1683682541806,EDS 126,A01,203332,Staff,30,0,30,0
1683682542830,EDS 139,A00,202838,Staff,16,0,25,9
1683682543853,EDS 146,A01,202655,Staff,14,0,25,11
1683682544877,ENG 15,A00,185667,Staff,0,1,0,0
1683682544877,ENG 15,B00,185672,Staff,0,0,0,0
1683682544877,ENG 15,C00,185675,Staff,0,0,0,0
1683682544877,ENG 15,D00,185682,Staff,0,0,0,0
1683682544877,ENG 15,E00,185684,Staff,0,0,0,0
1683682545901,ETHN 103,A00,185710,Staff,0,8,35,35
1683682546925,ETHN 103A,A00,199228,Man; Simeon S,0,0,9,9
1683682547949,ETHN 109,A00,185711,Staff,15,0,35,20
1683682548973,ETHN 142,A00,185726,Staff,0,4,30,30
1683682550002,ETHN 163J,A00,199229,Man; Simeon S,5,0,8,3
1683682551026,ETHN 168,A00,185727,Staff,7,0,10,3
1683682552054,ETHN 182,A00,185728,Staff,0,0,35,35
1683682553078,ETHN 183,A00,185737,Staff,9,0,18,9
1683682554102,GLBH 111,A01,209361,Burgos; Jose L.,0,0,0,0
1683682556151,HIEU 104,A00,185792,Staff,14,0,20,6
1683682557176,HIEU 115,A00,185800,Staff,0,0,20,20
1683682558205,HIEU 128,A00,185801,Staff,0,9,20,20
1683682559231,HIEU 147,A00,185802,Staff,15,0,20,5
1683682560258,HIEU 154,A00,185823,Staff,11,0,20,9
1683682561285,HILA 102,A00,185826,Staff,14,0,20,6
1683682562312,HILD 2C,A01,185778,Staff,0,13,20,20
1683682563336,HILD 7B,A01,185780,Kwak; Nancy,0,17,32,32
1683682563336,HILD 7B,A02,185781,Kwak; Nancy,0,18,32,32
1683682564358,HILD 30,A01,185791,Staff,12,0,20,8
1683682565382,HISC 119,A00,185830,Golan; Tal,0,10,20,20
1683682566408,HITO 156GS,A00,185831,Patterson; Patrick H.,0,0,0,23
1683682567432,HIUS 103,A00,185832,Man; Simeon S,0,4,20,20
1683682568459,HIUS 117,A00,185836,Kwak; Nancy,2,0,20,18
1683682569486,HIUS 125,A00,185840,Man; Simeon S,0,2,23,23
1683682570511,HIUS 149,A00,185845,Staff,1,0,20,19
1683682571542,HUM 3,A01,185882,Zavodny; Tatiana Sophia,0,8,50,50
1683682571542,HUM 3,B01,185899,Caldwell; Michael Alan,0,18,50,50
1683682572566,HUM 3GS,A00,185900,Patterson; Patrick H.,0,0,0,23
1683682573591,HUM 4,A01,185938,Zroka; Amy Liane,28,0,50,22
1683682573591,HUM 4,B01,185956,Watkins; Eric,0,6,50,50
1683682573591,HUM 4,B02,202209,Watkins; Eric,0,5,50,50
1683682573591,HUM 4,B03,202210,Watkins; Eric,0,5,50,50
1683682574618,HUM 5,A01,185958,West; Geoffrey Scott,0,0,50,50
1683682574618,HUM 5,A02,202215,West; Geoffrey Scott,0,0,50,50
1683682575642,INTL 190,A00,185959,Gagnon; Jeffrey C,0,0,0,9
1683682575642,INTL 190,B00,185960,Lettieri; Michael Joseph,0,0,0,2
1683682576677,JAPN 180,A00,254509,Staff,5,0,30,25
1683682577705,LATI 10,A01,202853,Kennemore; Amy Michelle,4,0,35,31
1683682577705,LATI 10,A02,202854,Kennemore; Amy Michelle,3,0,35,32
1683682577705,LATI 10,A03,270054,Kennemore; Amy Michelle,30,0,30,0
1683682578739,LATI 180,A00,202855,Kennemore; Amy Michelle,11,0,20,9
1683682579764,LAWS 101,A00,201767,Golan; Tal,0,7,40,40
1683682580788,LIFR 1C,A00,185961,Staff,6,0,20,14
1683682581812,LIFR 1CX,A00,185962,Staff,7,0,20,13
1683682582837,LIFR 1D,A00,185963,Staff,7,0,20,13
1683682583862,LIFR 1DX,A00,185964,Staff,7,0,20,13
1683682584885,LIGN 101,A01,186039,Staff,43,0,50,7
1683682585914,LIGN 165,A00,186040,Staff,15,0,50,35
1683682586937,LTCS 108,A00,186041,Staff,5,0,10,5
1683682587962,LTCS 119,A00,186042,Staff,15,0,20,5
1683682588991,LTCS 130,A00,186043,Wesling; Megan E.,15,0,25,10
1683682591041,LTEA 138,A00,186119,Staff,14,0,40,26
1683682592066,LTEN 124,A00,186148,Staff,5,0,25,20
1683682593091,LTEN 178,A00,186149,Staff,6,0,15,9
1683682594119,LTEN 181,A00,186150,Blanco; John D,34,0,40,6
1683682595144,LTWL 120,A00,186160,Staff,19,0,25,6
1683682596171,LTWL 165,A00,186161,Staff,22,0,25,3
1683682597196,LTWR 100,A00,186162,Staff,0,5,15,15
1683682598219,LTWR 102,A00,186163,Doller; Ben,5,0,15,10
1683682599246,MAE 8,A01,186412,Staff,0,1,0,0
1683682600270,MAE 30B,A00,186445,Bahadori; Mohammad Yousef,81,0,100,19
1683682601297,MAE 40,A00,186592,Bewley; Thomas R,10,0,50,40
1683682602326,MAE 101B,A00,186593,Bahadori; Mohammad Yousef,80,0,100,20
1683682603351,MAE 105,A00,186594,Bandaru; Prabhakar,10,0,50,40
1683682604377,MAE 107,A00,186599,Pham; Hieu Tan,0,7,120,120
1683682605406,MAE 148,A01,186660,Silberman; Jack,3,0,16,13
1683682606435,MATH 10A,A01,188095,Staff,0,6,35,35
1683682607463,MATH 10B,A01,188097,Bowers; Adam R.,0,12,30,30
1683682607463,MATH 10B,A02,188099,Bowers; Adam R.,0,11,30,30
1683682607463,MATH 10B,B01,188104,Bowers; Adam R.,0,10,30,30
1683682607463,MATH 10B,B02,188106,Bowers; Adam R.,1,9,30,29
1683682608493,MATH 10C,A01,188111,Staff,0,20,30,30
1683682608493,MATH 10C,A02,188127,Staff,0,19,30,30
1683682608493,MATH 10C,A03,188131,Staff,0,19,30,30
1683682608493,MATH 10C,B01,188218,Staff,17,0,30,13
1683682608493,MATH 10C,B02,188244,Staff,13,0,30,17
1683682608493,MATH 10C,B03,188277,Staff,14,0,30,16
1683682609519,MATH 18,A01,188344,Bach; Quang Tran,18,0,30,12
1683682609519,MATH 18,A02,188345,Bach; Quang Tran,11,0,30,19
1683682609519,MATH 18,B01,188353,Bach; Quang Tran,11,0,30,19
1683682609519,MATH 18,B02,188354,Bach; Quang Tran,19,0,30,11
1683682610600,MATH 20A,A01,188374,Staff,11,0,35,24
1683682611629,MATH 20B,A01,188382,Ohm; Ko Woon,7,0,30,23
1683682611629,MATH 20B,A02,188383,Ohm; Ko Woon,22,0,30,8
1683682611629,MATH 20B,B01,188385,Ohm; Ko Woon,7,0,30,23
1683682611629,MATH 20B,B02,188392,Ohm; Ko Woon,22,0,30,8
1683682612653,MATH 20C,A01,188394,Harel; Guershon,10,0,30,20
1683682612653,MATH 20C,A02,188395,Harel; Guershon,13,0,30,17
1683682612653,MATH 20C,B01,188404,Harel; Guershon,5,0,30,25
1683682612653,MATH 20C,B02,188405,Harel; Guershon,18,0,30,12
1683682613681,MATH 20D,A01,188414,Hammock; Frances H,0,1,30,30
1683682613681,MATH 20D,A02,188415,Hammock; Frances H,0,1,30,30
1683682613681,MATH 20D,B01,188447,Hammock; Frances H,0,1,30,30
1683682613681,MATH 20D,B02,188486,Hammock; Frances H,3,0,30,27
1683682614706,MATH 20E,A01,188649,Staff,21,0,30,9
1683682614706,MATH 20E,A02,188650,Staff,20,0,30,10
1683682614706,MATH 20E,A03,188673,Staff,0,0,30,30
1683682615730,MATH 102,A01,188675,Staff,0,39,35,35
1683682616758,MATH 103B,A01,188681,Staff,3,0,35,32
1683682616758,MATH 103B,B01,188692,Staff,5,0,35,30
1683682617784,MATH 109,A01,188695,Salehi Golsefidy; Alireza,24,0,35,11
1683682617784,MATH 109,A02,188696,Salehi Golsefidy; Alireza,25,0,35,10
1683682618811,MATH 120A,A01,188698,Eggers; John Dietrich,7,0,35,28
1683682619836,MATH 142B,A01,188736,Ioana; Adrian,1,1,30,29
1683682619836,MATH 142B,A02,188741,Ioana; Adrian,0,1,30,30
1683682619836,MATH 142B,A03,188743,Ioana; Adrian,0,1,30,30
1683682620860,MATH 168A,A01,188790,Staff,0,11,35,35
1683682621884,MATH 170A,A01,188803,Nie; Jiawang,0,2,35,35
1683682621884,MATH 170A,A02,188811,Nie; Jiawang,0,1,35,35
1683682621884,MATH 170A,A03,188814,Nie; Jiawang,0,0,35,35
1683682621884,MATH 170A,A04,188815,Nie; Jiawang,6,0,35,29
1683682622910,MATH 193B,A01,188817,Staff,0,0,35,35
1683682622910,MATH 193B,A02,188818,Staff,5,0,35,30
1683682623935,MGT 4,A01,202857,Anderson; John Charles,59,0,80,21
1683682624960,MGT 12,A00,202858,Lindenberger; Wade Douglas,40,0,90,50
1683682625985,MGT 18,A00,202859,Staff,74,0,90,16
1683682627013,MGT 18GS,A00,202860,McKay; Michael J,13,0,28,15
1683682628036,MGT 45,A00,202861,Pecore; Joseph P.,8,0,90,82
1683682629060,MGT 100,A00,202863,Yavorsky; Daniel Ryan,28,0,90,62
1683682630084,MGT 103,A00,202864,Ehrich; Kristine R,0,19,90,90
1683682631111,MGT 112,A00,202865,Ehrich; Kristine R,15,0,90,75
1683682632141,MGT 121A,A00,202868,Staff,90,20,90,0
1683682633165,MGT 131B,A00,202869,Anderson; John Charles,59,0,90,31
1683682634190,MGT 136,A00,202871,Lindenberger; Wade Douglas,83,0,90,7
1683682635215,MGT 164,A00,202873,Staff,0,68,90,91
1683682636239,MGT 164GS,A00,202874,McKay; Mary A,13,0,28,15
1683682637266,MGT 180,A00,202875,Staff,0,51,90,91
1683682638290,MMW 11R,A01,205019,Herbst; Matthew,0,0,30,30
1683682638290,MMW 11R,A02,205026,Herbst; Matthew,29,0,30,1
1683682639316,MMW 15,A01,193512,Chang; Edmond Yi-Teh,0,8,28,28
1683682639316,MMW 15,A02,193513,Chang; Edmond Yi-Teh,0,5,28,28
1683682639316,MMW 15,A03,193514,Chang; Edmond Yi-Teh,0,5,28,28
1683682639316,MMW 15,A04,193515,Chang; Edmond Yi-Teh,0,5,28,28
1683682639316,MMW 15,A05,193516,Chang; Edmond Yi-Teh,0,5,28,28
1683682639316,MMW 15,A06,193517,Chang; Edmond Yi-Teh,0,6,28,28
1683682639316,MMW 15,B01,193519,Chang; Edmond Yi-Teh,0,5,28,28
1683682639316,MMW 15,B02,193520,Chang; Edmond Yi-Teh,0,5,28,28
1683682639316,MMW 15,B03,193521,Chang; Edmond Yi-Teh,0,5,28,28
1683682639316,MMW 15,B04,193522,Chang; Edmond Yi-Teh,0,6,28,28
1683682639316,MMW 15,B05,193523,Chang; Edmond Yi-Teh,0,5,28,28
1683682639316,MMW 15,B06,193524,Chang; Edmond Yi-Teh,0,5,28,28
1683682640343,MMW 122,A01,193526,Rahimi; Babak,0,16,28,28
1683682640343,MMW 122,A02,193527,Rahimi; Babak,0,15,28,28
1683682640343,MMW 122,A03,193528,Rahimi; Babak,0,0,0,0
1683682640343,MMW 122,A04,193529,Rahimi; Babak,0,0,0,0
1683682641370,MUS 1A,A01,186663,Staff,1,19,35,34
1683682642394,MUS 4,A01,186715,Staff,0,12,35,35
1683682643421,MUS 5R,A01,186796,Dubnov; Shlomo,0,17,35,35
1683682644444,MUS 6,A01,186798,Staff,1,5,25,24
1683682645469,MUS 7,A01,186830,Staff,11,0,35,24
1683682646493,MUS 8,A01,186930,Staff,0,27,35,35
1683682647522,MUS 15,A01,186932,Staff,0,15,35,35
1683682647522,MUS 15,B01,186934,Staff,1,17,35,34
1683682648547,MUS 80,A00,186935,Staff,0,0,20,20
1683682648547,MUS 80,B00,186936,Staff,24,0,25,1
1683682649572,NANO 11,A00,204702,Lipomi; Darren John,0,0,0,0
1683682650598,NANO 15,A01,204709,Yang; Kesong,0,1,0,0
1683682651625,NANO 114,A00,202069,Jahed Motlagh; Zeinab,3,0,10,7
1683682652651,PHIL 1,A00,186955,Grush; Rick Scott,31,0,40,9
1683682653678,PHIL 10,A01,186973,Grush; Rick Scott,27,0,35,8
1683682653678,PHIL 10,A02,186974,Grush; Rick Scott,33,0,35,2
1683682654703,PHIL 13,A01,186976,Staff,1,0,35,34
1683682654703,PHIL 13,A02,186977,Staff,16,0,35,19
1683682655727,PHIL 14,A01,186979,Staff,31,0,35,4
1683682655727,PHIL 14,A02,186986,Staff,32,0,35,3
1683682656753,PHIL 28,A01,186988,Staff,16,0,30,14
1683682656753,PHIL 28,A02,186989,Staff,1,0,30,29
1683682656753,PHIL 28,A03,186990,Staff,10,0,30,20
1683682656753,PHIL 28,A04,186991,Staff,26,0,30,4
1683682657777,PHIL 120,A00,186997,Staff,23,0,40,17
1683682658804,PHIL 137,A00,187003,Staff,7,0,40,33
1683682659829,PHIL 150,A00,187015,Staff,47,0,70,23
1683682660854,PHIL 167,A00,187021,Lamey; Andy M.,34,0,40,6
1683682661881,PHIL 174,A01,202226,Staff,17,0,20,3
1683682661881,PHIL 174,A02,202235,Staff,20,0,20,0
1683682662905,PHIL 191A,A00,258918,Staff,0,0,1,1
1683682663933,PHYS 1A,A00,187028,Staff,26,0,60,34
1683682664958,PHYS 1AL,001,187036,Staff,3,0,30,27
1683682664958,PHYS 1AL,002,187049,Staff,18,0,30,12
1683682665980,PHYS 1B,A00,187058,Staff,22,0,60,38
1683682667005,PHYS 1BL,001,187064,Staff,0,1,30,30
1683682667005,PHYS 1BL,002,187070,Staff,4,0,30,26
1683682668032,PHYS 1C,A00,187082,Staff,29,0,120,91
1683682669056,PHYS 1CL,001,187088,Staff,0,9,30,30
1683682669056,PHYS 1CL,002,187089,Staff,0,1,30,30
1683682669056,PHYS 1CL,009,262693,Staff,9,0,30,21
1683682670081,PHYS 2B,A01,187097,Staff,55,0,115,60
1683682671108,PHYS 2C,A01,187099,Staff,63,0,115,52
1683682672135,PHYS 2CL,A01,187101,Staff,5,0,28,23
1683682672135,PHYS 2CL,A02,187102,Staff,15,0,28,13
1683682673159,PHYS 2D,A01,187123,Shotwell; Brian,95,0,115,20
1683682674184,PHYS 4B,A01,187133,Grinstein; Benjamin,35,0,50,15
1683682675210,POLI 10,A00,188819,Staff,0,4,50,50
1683682676235,POLI 11,A00,188827,Staff,43,0,50,7
1683682677258,POLI 13R,A00,188828,Staff,0,1,20,20
1683682678281,POLI 27,A01,188830,Elgin; Samuel Zincke,0,2,70,70
1683682679306,POLI 30,A00,188832,Desposato; Scott,30,0,50,20
1683682680329,POLI 102F,A00,188834,Staff,1,0,40,39
1683682681352,POLI 104A,A00,188852,Staff,12,0,30,18
1683682682378,POLI 104I,A00,188853,Staff,0,8,20,20
1683682683404,POLI 110B,A00,188854,Wiens; David,6,0,20,14
1683682684427,POLI 112A,A00,188855,Wiens; David,3,0,30,27
1683682685451,POLI 117R,A00,188856,Forman; Fonna,0,12,20,20
1683682686475,POLI 118,A00,188857,Ingham; Sean,8,0,20,12
1683682687502,POLI 120G,A00,188858,Staff,8,0,30,22
1683682688527,POLI 131CR,A00,188863,Hoston; Germaine,20,0,50,30
1683682689554,POLI 133,A00,188864,Nellis; Gareth Hb,44,0,50,6
1683682690578,POLI 134D,A00,188865,Desposato; Scott,27,0,30,3
1683682691603,POLI 142A,A00,188871,Gartzke; Erik,21,0,50,29
1683682692631,POLI 142K,A00,188874,Staff,38,0,50,12
1683682693656,POLI 143,A00,188940,Gartzke; Erik,16,0,30,14
1683682694683,POLI 153,A00,188943,Staff,2,0,20,18
1683682695706,POLI 160AA,A00,188944,Staff,10,0,40,30
1683682696731,POLI 170A,A00,188945,Staff,10,0,30,20
1683682698787,PSYC 1,A00,188952,Staff,36,0,90,54
1683682699814,PSYC 2,B00,188953,Staff,19,0,35,16
1683682700838,PSYC 6,A00,188970,Staff,47,0,60,13
1683682701863,PSYC 7,A00,188973,Staff,35,0,45,10
1683682702891,PSYC 60,A01,188980,Rickard; Timothy C.,42,0,60,18
1683682703919,PSYC 70,A01,189001,Steiner; Eric Tomas,21,0,45,24
1683682704944,PSYC 100,A00,189005,Lacefield; Katharine I,0,99,120,120
1683682705970,PSYC 102,A00,189008,Staff,7,0,30,23
1683682706999,PSYC 106,B00,189026,Gorman; Michael R.,27,0,60,33
1683682708026,PSYC 114,B01,189033,Winkielman; Piotr,0,31,30,30
1683682709049,PSYC 131,A00,189036,Anagnostaras; Stephan,0,43,60,60
1683682710077,PSYC 136,A00,189041,Lowe; Angela Beth,0,7,25,25
1683682711103,PSYC 137,A00,189057,Winkielman; Piotr,1,37,25,24
1683682712128,PSYC 144,A00,189107,Wixted; John T,0,11,50,50
1683682714234,PSYC 162,A00,189142,Staff,0,9,85,85
1683682715258,PSYC 172,A00,189144,Gorman; Michael R.,0,6,30,30
1683682717309,PSYC 179,A00,189146,Lacefield; Katharine I,0,87,120,120
1683682718340,PSYC 181,A00,189147,Anagnostaras; Stephan,0,44,90,90
1683682719366,PSYC 190R,A00,189148,Barner; David A.,0,23,80,80
1683682720392,PSYC 191,A00,189275,Rickard; Timothy C.,0,10,25,25
1683682721420,PSYC 193,A00,189276,Chapman; Eddie Nathaniel,0,1,0,4
1683682722444,PSYC 193L,A01,189281,Lowe; Angela Beth,8,0,20,12
1683682722444,PSYC 193L,B01,189285,Staff,28,0,35,7
1683682723472,RELI 149,A00,187137,Rahimi; Babak,7,0,40,33
1683682724497,SE 9,A01,187315,Staff,0,2,18,18
1683682725522,SE 101B,A00,187409,Staff,24,0,30,6
1683682726548,SE 110B,A00,187444,Staff,10,0,40,30
1683682727574,SE 130B,A00,187449,Staff,31,0,40,9
1683682728597,SE 150A,A00,187516,Staff,8,0,20,12
1683682729621,SE 154,A00,187528,Staff,29,0,50,21
1683682730645,SIO 3,A01,258171,Staff,35,0,40,5
1683682731669,SIO 10,A00,187144,Cook; Geoffrey W,1,7,75,74
1683682732692,SIO 45,A00,187152,Cook; Geoffrey W,0,7,100,100
1683682733717,SIO 109R,A00,194486,Staff,0,4,20,20
1683682735768,SIO 187,A01,187233,Kacev; David,12,0,40,28
1683682736797,SOCI 1,A01,258656,Thorpe; Charles Robert,28,0,30,2
1683682736797,SOCI 1,A02,258658,Thorpe; Charles Robert,30,0,30,0
1683682736797,SOCI 1,A03,258661,Thorpe; Charles Robert,25,0,25,0
1683682736797,SOCI 1,A04,258666,Thorpe; Charles Robert,22,0,25,3
1683682736797,SOCI 1,A05,258897,Thorpe; Charles Robert,22,0,25,3
1683682736797,SOCI 1,A06,258898,Thorpe; Charles Robert,25,0,25,0
1683682737821,SOCI 30,A01,258903,Pardo Guerra; Juan Pablo,14,0,30,16
1683682738848,SOCI 102,A00,258904,Staff,9,0,25,16
1683682739872,SOCI 106,A00,258905,Staff,19,0,25,6
1683682740895,SOCI 111,A00,258907,Ribas Norris; Janet Vanesa,26,0,30,4
1683682741918,SOCI 121R,A00,258908,Pardo Guerra; Juan Pablo,8,0,30,22
1683682742945,SOCI 126,A01,203330,Staff,14,0,20,6
1683682743970,SOCI 131,A00,258909,Thorpe; Charles Robert,30,0,60,30
1683682744997,SOCI 135,A00,258910,Payne; Christine Anna,0,12,30,30
1683682746024,SOCI 157,A00,258911,Staff,11,0,30,19
1683682747052,SOCI 184,A00,258912,Staff,25,0,30,5
1683682748078,SOCI 188D,A00,258913,Staff,22,0,30,8
1683682749105,SYN 2,001,187529,Staff,9,0,16,7
1683682749105,SYN 2,002,201452,Staff,1,20,16,15
1683682749105,SYN 2,003,201469,Staff,1,0,16,15
1683682750128,SYN 100,A01,187531,Staff,0,9,20,20
1683682750128,SYN 100,B01,201491,Staff,0,10,20,20
1683682751156,TDAC 1,A00,189286,Walsh; Kim C.,3,0,20,17
1683682751156,TDAC 1,B00,189287,Harting; Carla Kelso,10,0,20,10
1683682752179,TDAC 101,A00,189300,Walsh; Kim C.,16,0,20,4
1683682752179,TDAC 101,B00,189301,Harting; Carla Kelso,18,0,20,2
1683682753202,TDAC 102,A00,189304,Basso; Beatrice,14,0,20,6
1683682754227,TDAC 108,A00,189305,Staff,18,0,20,2
1683682755261,TDDE 131,A00,189310,Staff,19,0,20,1
1683682755261,TDDE 131,B00,189314,Staff,19,0,20,1
1683682755261,TDDE 131,C00,189315,Staff,48,0,50,2
1683682755261,TDDE 131,D00,189316,Staff,14,0,15,1
1683682755261,TDDE 131,E00,204841,Staff,20,0,20,0
1683682756285,TDGE 10,A00,189289,Staff,27,0,50,23
1683682756285,TDGE 10,B00,189290,Havis; Allan,0,1,50,50
1683682757313,TDGE 11,A00,189291,Fulton; Julia,0,4,50,50
1683682757313,TDGE 11,B00,189292,Staff,20,0,25,5
1683682757313,TDGE 11,C00,260270,Staff,0,0,0,0
1683682758341,TDGE 25,A00,189294,Staff,1,0,20,19
1683682759367,TDGE 124,A00,189318,Fulton; Julia,0,8,50,50
1683682760394,TDGE 125,A00,189319,Staff,13,0,25,12
1683682760394,TDGE 125,B00,189320,Staff,23,0,25,2
1683682761419,TDGE 127,A00,189322,Havis; Allan,0,0,50,50
1683682762442,TDHT 101,A00,189323,Staff,18,0,25,7
1683682762442,TDHT 101,B00,189324,Staff,25,0,25,0
1683682763469,TDHT 102,A00,189325,Staff,49,0,50,1
1683682764493,TDMV 1,A00,189295,Arcidiacono; Kristin,20,0,30,10
1683682764493,TDMV 1,B00,189296,Caligagan; Maria T.,24,0,30,6
1683682765517,TDMV 2,A00,189297,Sammartano; Tonnie,27,0,30,3
1683682765517,TDMV 2,B00,189299,Arcidiacono; Kristin,23,0,30,7
1683682766541,TDMV 3,A00,204998,Rincon; Alicia,22,0,30,8
1683682767565,TDMV 120,A00,189458,Sammartano; Tonnie,28,0,30,2
1683682768589,TDMV 138,A00,189541,Jun; Grace Shin Hae,20,0,40,20
1683682769613,TDMV 142,A00,189717,Caligagan; Tony,25,0,30,5
1683682769613,TDMV 142,B00,189718,Caligagan; Maria T.,25,0,30,5
1683682770637,TMC 2,A01,187533,Staff,25,0,25,0
1683682770637,TMC 2,A02,187534,Staff,25,0,25,0
1683682771661,USP 1,A01,187536,Kwak; Nancy,0,16,25,25
1683682772685,USP 5,A01,187538,Staff,8,0,25,17
1683682773708,USP 101,A00,199253,Staff,0,4,0,0
1683682774732,USP 124,A00,187562,Boomhower; Matthew Charles,0,0,30,30
1683682775756,USP 138,A00,187582,Staff,19,0,25,6
1683682776783,USP 152,A01,187597,Staff,3,0,25,22
1683682777808,USP 153,A00,187598,Staff,18,0,25,7
1683682778831,USP 168,A00,187607,Kwak; Nancy,2,0,5,3
1683682779860,USP 173,A00,187619,Staff,4,0,25,21
1683682780888,USP 181,A00,187638,Staff,0,4,25,25
1683682781913,VIS 103,A00,187650,Cruz; Edwin Teddy,17,0,75,58
1683682782938,VIS 110D,A00,187669,Staff,13,0,22,9
1683682783963,VIS 127C,A00,187720,Shen; Kuiyi,67,0,146,79
1683682784987,VIS 149,A00,187731,Yoldas; Pinar,1,14,22,21
1683682786012,VIS 151,A01,188091,Staff,22,0,34,12
1683682786012,VIS 151,A02,188092,Staff,11,0,34,23
1683682787035,VIS 160B,A00,188093,Stalbaum; Brett,0,1,10,10
1683682789087,WCWP 10B,A00,201720,Staff,0,0,5,5
1683682789087,WCWP 10B,B00,201722,Staff,0,0,6,6
1683682790113,WCWP 100,A00,201725,Gagnon; Jeffrey C,0,0,2,2
1683682790113,WCWP 100,B00,201727,Staff,0,4,15,15
1683682793222,ANBI 133,A00,258401,Wilder; Linnea Lorene,34,0,40,6
1683682794249,ANBI 140,A00,258395,Hrvoj Mihic; Branka,18,0,25,7
1683682795274,ANSC 120,A00,258402,Bialecki; Jon Anthony,26,0,40,14
1683682796303,ANSC 144,A00,258400,Staff,12,0,40,28
1683682798349,ANSC 166,A00,258396,Parish; Steven Martin,156,0,175,19
1683682799374,ANSC 180,A00,193533,Staff,8,0,20,12
1683682800398,ANSC 188,A00,258397,Jassal; Aftab,34,0,40,6
1683682801423,ANTH 3,A01,258316,Staff,23,0,30,7
1683682802448,ANTH 5,A00,258394,Semendeferi; Ekaterini,16,0,20,4
1683682803477,ANTH 21,A01,258331,Staff,4,0,40,36
1683682804500,ANTH 103,A00,258398,Varma; Saiba,15,0,25,10
1683682805526,AWP 10,001,202034,Staff,0,0,0,0
1683682805526,AWP 10,002,202035,Staff,0,0,0,0
1683682805526,AWP 10,003,202036,Staff,0,0,0,0
1683682805526,AWP 10,004,202037,Staff,0,0,0,0
1683682805526,AWP 10,005,202038,Staff,0,0,0,0
1683682805526,AWP 10,006,202039,Staff,0,0,0,0
1683682805526,AWP 10,007,202040,Staff,0,0,0,0
1683682805526,AWP 10,008,202041,Staff,0,0,0,0
1683682805526,AWP 10,009,202042,Staff,0,0,0,0
1683682805526,AWP 10,010,202043,Staff,0,0,0,0
1683682805526,AWP 10,011,202044,Staff,0,0,0,0
1683682805526,AWP 10,012,202045,Staff,0,0,0,0
1683682805526,AWP 10,013,202046,Staff,0,0,0,0
1683682805526,AWP 10,014,202047,Staff,0,0,0,0
1683682805526,AWP 10,015,202048,Staff,0,0,0,0
1683682805526,AWP 10,016,202049,Staff,0,0,0,0
1683682805526,AWP 10,017,202050,Staff,0,0,0,0
1683682805526,AWP 10,018,202051,Staff,0,0,0,0
1683682805526,AWP 10,019,202052,Staff,0,0,0,0
1683682805526,AWP 10,020,202053,Staff,0,0,0,0
1683682805526,AWP 10,021,202054,Staff,0,0,0,0
1683682805526,AWP 10,022,202055,Staff,0,0,0,0
1683682805526,AWP 10,023,202056,Staff,0,0,0,0
1683682805526,AWP 10,024,202057,Staff,0,0,0,0
1683682805526,AWP 10,025,202058,Staff,0,0,0,0
1683682805526,AWP 10,026,202059,Staff,0,0,0,0
1683682806551,AWP 102,001,202032,Staff,0,0,0,0
1683682806551,AWP 102,002,202033,Staff,0,0,0,0
1683682807576,BENG 100,A01,254234,Taylor Amos; Alyssa C,31,0,40,9
1683682808600,BENG 196,001,270013,Engler; Adam J.,9999,0,9999,0
1683682809630,BICD 100R,A01,202018,Smith; Laurie,0,7,32,32
1683682809630,BICD 100R,A02,202019,Smith; Laurie,0,3,32,32
1683682809630,BICD 100R,A03,202020,Smith; Laurie,0,1,32,32
1683682809630,BICD 100R,A04,202021,Smith; Laurie,6,0,32,26
1683682809630,BICD 100R,A05,202022,Smith; Laurie,10,0,32,22
1683682810657,BICD 136,A01,193242,Gustafson-Brown; Cindy,0,2,32,32
1683682810657,BICD 136,A02,193244,Gustafson-Brown; Cindy,13,0,32,19
1683682811683,BIEB 102,A01,193249,Butler; Shannon Rhey,1,1,32,31
1683682811683,BIEB 102,A02,193251,Butler; Shannon Rhey,0,0,32,32
1683682811683,BIEB 102,A03,193253,Butler; Shannon Rhey,0,0,32,32
1683682811683,BIEB 102,A04,193255,Butler; Shannon Rhey,13,0,32,19
1683682811683,BIEB 102,A05,193265,Butler; Shannon Rhey,25,0,32,7
1683682811683,BIEB 102,A06,193269,Butler; Shannon Rhey,13,0,32,19
1683682813734,BIEB 150,A01,193274,Staff,0,0,32,32
1683682813734,BIEB 150,A02,193285,Staff,24,0,32,8
1683682814758,BIEB 194,A00,193286,Kurle; Carolyn M.,19,0,32,13
1683682815786,BILD 1,A01,192291,Staff,15,0,32,17
1683682815786,BILD 1,A02,192292,Staff,30,0,32,2
1683682815786,BILD 1,B01,192520,Reuther; Keefe,0,1,0,0
1683682815786,BILD 1,B02,192532,Reuther; Keefe,0,1,0,0
1683682816810,BILD 3,A01,192556,Butler; Shannon Rhey,0,0,32,32
1683682816810,BILD 3,A02,192581,Butler; Shannon Rhey,0,1,32,32
1683682816810,BILD 3,A03,192611,Butler; Shannon Rhey,19,0,32,13
1683682816810,BILD 3,A04,192612,Butler; Shannon Rhey,24,0,32,8
1683682816810,BILD 3,A05,192613,Butler; Shannon Rhey,26,0,32,6
1683682816810,BILD 3,A06,192679,Butler; Shannon Rhey,27,0,32,5
1683682816810,BILD 3,A07,192682,Butler; Shannon Rhey,20,0,32,12
1683682817910,BILD 4,A01,192836,Reuther; Keefe,1,0,24,23
1683682817910,BILD 4,A02,193044,Reuther; Keefe,4,0,24,20
1683682818938,BILD 10,A01,193142,Gustafson-Brown; Cindy,29,0,32,3
1683682818938,BILD 10,A02,193149,Gustafson-Brown; Cindy,31,0,32,1
1683682819966,BIMM 100,A01,193301,Staff,0,6,32,32
1683682819966,BIMM 100,A02,193312,Staff,0,7,32,32
1683682819966,BIMM 100,A03,193323,Staff,0,10,32,32
1683682820991,BIMM 101,A01,193329,McDonnell; Lisa Marie,1,4,24,23
1683682820991,BIMM 101,A02,193339,McDonnell; Lisa Marie,1,4,24,23
1683682820991,BIMM 101,B01,193354,McDonnell; Lisa Marie,0,4,24,24
1683682820991,BIMM 101,B02,193357,McDonnell; Lisa Marie,0,3,24,24
1683682822014,BIMM 110,A01,193377,Tat; John,0,11,32,32
1683682822014,BIMM 110,A02,193378,Tat; John,0,11,32,32
1683682823039,BIMM 120,A01,206116,Staff,0,0,32,32
1683682823039,BIMM 120,A02,206117,Staff,7,0,32,25
1683682823039,BIMM 120,A03,206121,Staff,21,0,32,11
1683682824068,BIPN 100,A01,193393,Park; Ji Young,0,15,32,32
1683682824068,BIPN 100,A02,193402,Park; Ji Young,0,14,32,32
1683682824068,BIPN 100,A03,193413,Park; Ji Young,0,14,32,32
1683682824068,BIPN 100,A04,193414,Park; Ji Young,0,13,32,32
1683682825092,BIPN 102,A01,193429,Staff,0,0,32,32
1683682825092,BIPN 102,A02,193438,Staff,18,0,32,14
1683682826120,BIPN 106,A01,193450,Reyes Gonzalez; Catalina,0,2,40,40
1683682827148,BIPN 134,A01,193465,Cooke; James Edward,0,0,32,32
1683682827148,BIPN 134,A02,193474,Cooke; James Edward,25,0,32,7
1683682827148,BIPN 134,A03,193485,Cooke; James Edward,29,0,32,3
1683682827148,BIPN 134,A04,193486,Cooke; James Edward,20,0,32,12
1683682827148,BIPN 134,A05,193491,Cooke; James Edward,31,0,32,1
1683682827148,BIPN 134,A06,193501,Cooke; James Edward,30,0,32,2
1683682827148,BIPN 134,A07,193510,Cooke; James Edward,29,0,32,3
1683682829197,BISP 194,A00,222522,Staff,14,0,32,18
1683682830223,CAT 124,A01,202407,Staff,19,0,25,6
1683682831247,CAT 125,A00,202408,Marchisotto; Jennifer Anne,2,0,20,18
1683682832273,CAT 125R,A00,202409,Smith; Lauryn Alissa,0,11,20,20
1683682832273,CAT 125R,B00,202410,Morales; Celeste Georgianna,0,11,20,20
1683682832273,CAT 125R,C00,202411,Irwin; Matthew Joseph,0,12,20,20
1683682833300,CENG 15,A01,204712,Yang; Kesong,0,1,0,0
1683682834327,CENG 114,A00,202070,Jahed Motlagh; Zeinab,5,0,20,15
1683682835352,CGS 105,A00,185477,Wesling; Megan E.,24,0,40,16
1683682836377,CGS 106,A00,185494,Staff,11,0,22,11
1683682837400,CGS 108,A00,185495,Staff,14,0,20,6
1683682838425,CGS 114,A00,185496,Staff,13,0,18,5
1683682839452,CGS 119,A00,185501,Staff,15,0,20,5
1683682840476,CGS 120,A00,185511,Staff,12,0,20,8
1683682841501,CHEM 4,A01,184675,Bussey; Thomas J,97,0,100,3
1683682842525,CHEM 6A,A01,184677,Staff,32,0,60,28
1683682843549,CHEM 6B,A01,184679,Staff,63,0,100,37
1683682844578,CHEM 6C,A01,184681,Bussey; Thomas J,0,0,50,50
1683682844578,CHEM 6C,A02,184682,Bussey; Thomas J,32,0,50,18
1683682845606,CHEM 40A,A01,184684,Albizati; Kim F.,33,0,100,67
1683682846633,CHEM 40B,A01,184686,Albizati; Kim F.,0,22,100,100
1683682847660,CHEM 41B,A01,184690,Staff,51,0,100,49
1683682848685,COGS 3,A01,184715,Boyle; Mary E. T.,0,27,40,40
1683682849713,COGS 14B,A01,185172,Staff,0,14,38,38
1683682850741,COGS 18,A01,184736,Staff,14,0,80,66
1683682851768,COGS 100,A01,184932,Staff,0,8,73,73
1683682852793,COGS 101A,A01,184935,Staff,0,40,30,30
1683682853817,COGS 101B,A01,184944,Staff,0,2,30,30
1683682854842,COGS 101C,A01,184946,Staff,0,10,30,30
1683682855866,COGS 102A,A01,184951,Johnson; Christine M.,1,0,40,39
1683682856892,COGS 107B,A01,184953,Mooshagian; Eric Frederick,0,52,40,40
1683682857919,COGS 118B,A01,184959,Gupta; Anjum,0,50,40,40
1683682858942,COGS 153,A00,184961,Staff,0,16,30,30
1683682859966,COGS 177,A00,184962,Staff,1,21,30,29
1683682860993,COGS 187A,A01,184969,Boyle; Mary E. T.,0,19,40,40
1683682862018,COMM 10,A01,185174,Staff,0,5,25,25
1683682862018,COMM 10,A02,185189,Staff,0,2,25,25
1683682862018,COMM 10,A03,269821,Staff,0,1,0,0
1683682863047,COMM 100B,A02,185476,Staff,10,0,25,15
1683682863047,COMM 100B,A03,277340,Staff,25,0,25,0
1683682864076,COMM 100C,A01,185314,Staff,1,0,25,24
1683682864076,COMM 100C,A02,185327,Staff,17,0,25,8
1683682865100,COMM 110M,A00,185349,Staff,0,0,40,40
1683682866127,COMM 113T,A00,185352,Staff,25,0,40,15
1683682867153,COMM 114I,A00,185353,Staff,31,0,40,9
1683682868177,COMM 131,A00,185354,Staff,17,0,30,13
1683682869202,CSE 8A,A50,185358,Cao; Yingjun,0,46,10,10
1683682870226,CSE 8B,A01,185362,Staff,0,48,50,50
1683682871250,CSE 11,A01,185416,Cao; Yingjun,0,91,10,10
1683682872278,CSE 20,A01,185445,Briones; Jor-el Thomas Caparas,3,0,25,22
1683682873304,CSE 21,A01,185447,Staff,9,0,50,41
1683682874333,CSE 101,A01,185451,Staff,0,13,50,50
1683682874333,CSE 101,B01,185453,Jones; Miles E,0,14,50,50
1683682876383,CSE 141,A01,185458,Eldon; John,16,0,100,84
1683682877408,CSE 141L,A01,185461,Eldon; John,8,0,100,92
1683682878433,CSE 142,A01,185463,Staff,34,0,60,26
1683682878433,CSE 142,B01,201355,Staff,0,7,60,60
1683682879458,CSE 142L,A01,185470,Staff,34,0,60,26
1683682879458,CSE 142L,B01,201417,Staff,0,6,60,60
1683682880488,CSE 190,A00,201433,Staff,32,0,49,17
1683682881516,DOC 1,A01,259136,Strom; Megan C.,7,0,15,8
1683682881516,DOC 1,A02,259137,Strom; Megan C.,14,0,15,1
1683682881516,DOC 1,A03,259138,Strom; Megan C.,14,0,15,1
1683682881516,DOC 1,A04,259139,Strom; Megan C.,14,0,15,1
1683682882541,DOC 100D,A00,259140,Pass; Natalye Joann,14,0,25,11
1683682883570,DSGN 1,A01,184749,Rill; Bryan,0,26,30,30
1683682884594,DSGN 100,A01,185168,Staff,0,2,25,25
1683682885619,ECE 5,A01,185626,Morris; Karcher William,0,12,0,0
1683682886643,ECE 101,A01,185628,Staff,14,0,70,56
1683682887683,ECE 107,A01,185635,Baghdadchi; Saharnaz,0,0,20,20
1683682887683,ECE 107,A02,185638,Baghdadchi; Saharnaz,1,0,20,19
1683682888705,ECE 148,A01,185647,Silberman; Jack,0,0,16,16
1683682889730,ECON 1,A01,185537,Crane; Meredith Helen,54,0,70,16
1683682890758,ECON 3,A01,185549,Crane; Meredith Helen,30,0,70,40
1683682891782,ECON 4,A01,203354,Anderson; John Charles,0,5,10,10
1683682892807,ECON 100A,A01,185574,Staff,0,5,40,40
1683682893829,ECON 100B,A01,185576,Staff,0,12,50,50
1683682894897,ECON 100C,A01,185589,Newhouse; Herbert S,30,0,70,40
1683682895921,ECON 105,A00,185608,Vespa; Emanuel Ignacio,19,0,35,16
1683682896943,ECON 109,A01,185610,Shishkin; Denis,9,0,35,26
1683682897970,ECON 110A,A01,185612,Staff,9,0,40,31
1683682898994,ECON 120A,A01,185615,Staff,19,0,40,21
1683682900019,ECON 120C,A01,185617,Sun; Yixiao,0,21,70,70
1683682901047,ECON 144,A00,203346,Squires; Dale E,2,0,35,33
1683682902076,ECON 171,A01,203349,Newhouse; Herbert S,0,1,35,35
1683682903104,ECON 173A,A01,185621,Toda; Alexis Akira,21,0,35,14
1683682904134,EDS 25,A01,202413,Staff,0,1,0,0
1683682904134,EDS 25,A02,202414,Staff,0,1,0,0
1683682904134,EDS 25,A03,202415,Staff,0,0,0,0
1683682904134,EDS 25,A04,202416,Staff,0,1,0,0
1683682904134,EDS 25,A05,202439,Staff,0,0,0,0
1683682904134,EDS 25,A06,202440,Staff,0,0,0,0
1683682904134,EDS 25,B01,202631,Staff,0,0,0,0
1683682904134,EDS 25,B02,202632,Staff,0,0,0,0
1683682904134,EDS 25,B03,202639,Staff,0,0,0,0
1683682904134,EDS 25,B04,202640,Staff,0,0,0,0
1683682904134,EDS 25,B05,202643,Staff,0,0,0,0
1683682904134,EDS 25,B06,202644,Staff,0,0,0,0
1683682905159,EDS 38,A01,202659,Black; Alison Michelle,24,0,25,1
1683682906182,EDS 115,A00,202652,Staff,18,0,30,12
1683682907207,EDS 125,A00,202649,Staff,13,0,30,17
1683682908231,EDS 126,A01,203332,Staff,30,0,30,0
1683682909257,EDS 139,A00,202838,Staff,16,0,25,9
1683682910284,EDS 146,A01,202655,Staff,14,0,25,11
1683682911312,ENG 15,A00,185667,Staff,0,1,0,0
1683682911312,ENG 15,B00,185672,Staff,0,0,0,0
1683682911312,ENG 15,C00,185675,Staff,0,0,0,0
1683682911312,ENG 15,D00,185682,Staff,0,0,0,0
1683682911312,ENG 15,E00,185684,Staff,0,0,0,0
1683682912336,ETHN 103,A00,185710,Staff,0,8,35,35
1683682913361,ETHN 103A,A00,199228,Man; Simeon S,0,0,9,9
1683682914388,ETHN 109,A00,185711,Staff,15,0,35,20
1683682915415,ETHN 142,A00,185726,Staff,0,4,30,30
1683682916442,ETHN 163J,A00,199229,Man; Simeon S,5,0,8,3
1683682917467,ETHN 168,A00,185727,Staff,7,0,10,3
1683682918494,ETHN 182,A00,185728,Staff,0,0,35,35
1683682919521,ETHN 183,A00,185737,Staff,9,0,18,9
1683682920546,GLBH 111,A01,209361,Burgos; Jose L.,0,0,0,0
1683682922659,HIEU 104,A00,185792,Staff,14,0,20,6
1683682923687,HIEU 115,A00,185800,Staff,0,0,20,20
1683682924714,HIEU 128,A00,185801,Staff,0,9,20,20
1683682925743,HIEU 147,A00,185802,Staff,15,0,20,5
1683682926768,HIEU 154,A00,185823,Staff,11,0,20,9
1683682927795,HILA 102,A00,185826,Staff,14,0,20,6
1683682928822,HILD 2C,A01,185778,Staff,0,13,20,20
1683682929847,HILD 7B,A01,185780,Kwak; Nancy,0,17,32,32
1683682929847,HILD 7B,A02,185781,Kwak; Nancy,0,18,32,32
1683682930875,HILD 30,A01,185791,Staff,12,0,20,8
1683682931902,HISC 119,A00,185830,Golan; Tal,0,10,20,20
1683682932930,HITO 156GS,A00,185831,Patterson; Patrick H.,0,0,0,23
1683682933953,HIUS 103,A00,185832,Man; Simeon S,0,4,20,20
1683682934978,HIUS 117,A00,185836,Kwak; Nancy,2,0,20,18
1683682936005,HIUS 125,A00,185840,Man; Simeon S,0,2,23,23
1683682937030,HIUS 149,A00,185845,Staff,1,0,20,19
1683682938055,HUM 3,A01,185882,Zavodny; Tatiana Sophia,0,8,50,50
1683682938055,HUM 3,B01,185899,Caldwell; Michael Alan,0,18,50,50
1683682939078,HUM 3GS,A00,185900,Patterson; Patrick H.,0,0,0,23
1683682940102,HUM 4,A01,185938,Zroka; Amy Liane,28,0,50,22
1683682940102,HUM 4,B01,185956,Watkins; Eric,0,6,50,50
1683682940102,HUM 4,B02,202209,Watkins; Eric,0,5,50,50
1683682940102,HUM 4,B03,202210,Watkins; Eric,0,5,50,50
1683682941126,HUM 5,A01,185958,West; Geoffrey Scott,0,0,50,50
1683682941126,HUM 5,A02,202215,West; Geoffrey Scott,0,0,50,50
1683682942154,INTL 190,A00,185959,Gagnon; Jeffrey C,0,0,0,9
1683682942154,INTL 190,B00,185960,Lettieri; Michael Joseph,0,0,0,2
1683682943177,JAPN 180,A00,254509,Staff,5,0,30,25
1683682944204,LATI 10,A01,202853,Kennemore; Amy Michelle,4,0,35,31
1683682944204,LATI 10,A02,202854,Kennemore; Amy Michelle,3,0,35,32
1683682944204,LATI 10,A03,270054,Kennemore; Amy Michelle,30,0,30,0
1683682945227,LATI 180,A00,202855,Kennemore; Amy Michelle,11,0,20,9
1683682946252,LAWS 101,A00,201767,Golan; Tal,0,7,40,40
1683682947276,LIFR 1C,A00,185961,Staff,6,0,20,14
1683682948303,LIFR 1CX,A00,185962,Staff,7,0,20,13
1683682949330,LIFR 1D,A00,185963,Staff,7,0,20,13
1683682950358,LIFR 1DX,A00,185964,Staff,7,0,20,13
1683682951382,LIGN 101,A01,186039,Staff,43,0,50,7
1683682952407,LIGN 165,A00,186040,Staff,15,0,50,35
1683682953431,LTCS 108,A00,186041,Staff,5,0,10,5
1683682954456,LTCS 119,A00,186042,Staff,15,0,20,5
1683682955483,LTCS 130,A00,186043,Wesling; Megan E.,15,0,25,10
1683682957535,LTEA 138,A00,186119,Staff,14,0,40,26
1683682958562,LTEN 124,A00,186148,Staff,5,0,25,20
1683682959594,LTEN 178,A00,186149,Staff,6,0,15,9
1683682960619,LTEN 181,A00,186150,Blanco; John D,34,0,40,6
1683682961647,LTWL 120,A00,186160,Staff,19,0,25,6
1683682962673,LTWL 165,A00,186161,Staff,22,0,25,3
1683682963695,LTWR 100,A00,186162,Staff,0,5,15,15
1683682964722,LTWR 102,A00,186163,Doller; Ben,5,0,15,10
1683682965747,MAE 8,A01,186412,Staff,0,1,0,0
1683682966772,MAE 30B,A00,186445,Bahadori; Mohammad Yousef,81,0,100,19
1683682967797,MAE 40,A00,186592,Bewley; Thomas R,10,0,50,40
1683682968825,MAE 101B,A00,186593,Bahadori; Mohammad Yousef,80,0,100,20
1683682969851,MAE 105,A00,186594,Bandaru; Prabhakar,10,0,50,40
1683682970878,MAE 107,A00,186599,Pham; Hieu Tan,0,7,120,120
1683682971903,MAE 148,A01,186660,Silberman; Jack,3,0,16,13
1683682972928,MATH 10A,A01,188095,Staff,0,6,35,35
1683682973953,MATH 10B,A01,188097,Bowers; Adam R.,0,12,30,30
1683682973953,MATH 10B,A02,188099,Bowers; Adam R.,0,11,30,30
1683682973953,MATH 10B,B01,188104,Bowers; Adam R.,0,10,30,30
1683682973953,MATH 10B,B02,188106,Bowers; Adam R.,1,9,30,29
1683682974977,MATH 10C,A01,188111,Staff,0,20,30,30
1683682974977,MATH 10C,A02,188127,Staff,0,19,30,30
1683682974977,MATH 10C,A03,188131,Staff,0,19,30,30
1683682974977,MATH 10C,B01,188218,Staff,17,0,30,13
1683682974977,MATH 10C,B02,188244,Staff,13,0,30,17
1683682974977,MATH 10C,B03,188277,Staff,14,0,30,16
1683682976001,MATH 18,A01,188344,Bach; Quang Tran,18,0,30,12
1683682976001,MATH 18,A02,188345,Bach; Quang Tran,11,0,30,19
1683682976001,MATH 18,B01,188353,Bach; Quang Tran,11,0,30,19
1683682976001,MATH 18,B02,188354,Bach; Quang Tran,19,0,30,11
1683682977025,MATH 20A,A01,188374,Staff,11,0,35,24
1683682978050,MATH 20B,A01,188382,Ohm; Ko Woon,7,0,30,23
1683682978050,MATH 20B,A02,188383,Ohm; Ko Woon,22,0,30,8
1683682978050,MATH 20B,B01,188385,Ohm; Ko Woon,7,0,30,23
1683682978050,MATH 20B,B02,188392,Ohm; Ko Woon,22,0,30,8
1683682979080,MATH 20C,A01,188394,Harel; Guershon,10,0,30,20
1683682979080,MATH 20C,A02,188395,Harel; Guershon,13,0,30,17
1683682979080,MATH 20C,B01,188404,Harel; Guershon,5,0,30,25
1683682979080,MATH 20C,B02,188405,Harel; Guershon,18,0,30,12
1683682980110,MATH 20D,A01,188414,Hammock; Frances H,0,1,30,30
1683682980110,MATH 20D,A02,188415,Hammock; Frances H,0,1,30,30
1683682980110,MATH 20D,B01,188447,Hammock; Frances H,0,1,30,30
1683682980110,MATH 20D,B02,188486,Hammock; Frances H,3,0,30,27
1683682981135,MATH 20E,A01,188649,Staff,21,0,30,9
1683682981135,MATH 20E,A02,188650,Staff,20,0,30,10
1683682981135,MATH 20E,A03,188673,Staff,0,0,30,30
1683682982162,MATH 102,A01,188675,Staff,0,39,35,35
1683682983186,MATH 103B,A01,188681,Staff,3,0,35,32
1683682983186,MATH 103B,B01,188692,Staff,5,0,35,30
1683682984215,MATH 109,A01,188695,Salehi Golsefidy; Alireza,24,0,35,11
1683682984215,MATH 109,A02,188696,Salehi Golsefidy; Alireza,25,0,35,10
1683682985244,MATH 120A,A01,188698,Eggers; John Dietrich,7,0,35,28
1683682986269,MATH 142B,A01,188736,Ioana; Adrian,1,1,30,29
1683682986269,MATH 142B,A02,188741,Ioana; Adrian,0,1,30,30
1683682986269,MATH 142B,A03,188743,Ioana; Adrian,0,1,30,30
1683682987293,MATH 168A,A01,188790,Staff,0,11,35,35
1683682988318,MATH 170A,A01,188803,Nie; Jiawang,0,2,35,35
1683682988318,MATH 170A,A02,188811,Nie; Jiawang,0,1,35,35
1683682988318,MATH 170A,A03,188814,Nie; Jiawang,0,0,35,35
1683682988318,MATH 170A,A04,188815,Nie; Jiawang,6,0,35,29
1683682989341,MATH 193B,A01,188817,Staff,0,0,35,35
1683682989341,MATH 193B,A02,188818,Staff,5,0,35,30
1683682990365,MGT 4,A01,202857,Anderson; John Charles,59,0,80,21
1683682991392,MGT 12,A00,202858,Lindenberger; Wade Douglas,40,0,90,50
1683682992416,MGT 18,A00,202859,Staff,74,0,90,16
1683682993440,MGT 18GS,A00,202860,McKay; Michael J,13,0,28,15
1683682994463,MGT 45,A00,202861,Pecore; Joseph P.,8,0,90,82
1683682995488,MGT 100,A00,202863,Yavorsky; Daniel Ryan,28,0,90,62
1683682996516,MGT 103,A00,202864,Ehrich; Kristine R,0,19,90,90
1683682997543,MGT 112,A00,202865,Ehrich; Kristine R,15,0,90,75
1683682998568,MGT 121A,A00,202868,Staff,90,20,90,0
1683682999592,MGT 131B,A00,202869,Anderson; John Charles,59,0,90,31
1683683000619,MGT 136,A00,202871,Lindenberger; Wade Douglas,83,0,90,7
1683683001646,MGT 164,A00,202873,Staff,0,68,90,91
1683683002673,MGT 164GS,A00,202874,McKay; Mary A,13,0,28,15
1683683003701,MGT 180,A00,202875,Staff,0,51,90,91
1683683004727,MMW 11R,A01,205019,Herbst; Matthew,0,0,30,30
1683683004727,MMW 11R,A02,205026,Herbst; Matthew,29,0,30,1
1683683005753,MMW 15,A01,193512,Chang; Edmond Yi-Teh,0,8,28,28
1683683005753,MMW 15,A02,193513,Chang; Edmond Yi-Teh,0,5,28,28
1683683005753,MMW 15,A03,193514,Chang; Edmond Yi-Teh,0,5,28,28
1683683005753,MMW 15,A04,193515,Chang; Edmond Yi-Teh,0,5,28,28
1683683005753,MMW 15,A05,193516,Chang; Edmond Yi-Teh,0,5,28,28
1683683005753,MMW 15,A06,193517,Chang; Edmond Yi-Teh,0,6,28,28
1683683005753,MMW 15,B01,193519,Chang; Edmond Yi-Teh,0,5,28,28
1683683005753,MMW 15,B02,193520,Chang; Edmond Yi-Teh,0,5,28,28
1683683005753,MMW 15,B03,193521,Chang; Edmond Yi-Teh,0,5,28,28
1683683005753,MMW 15,B04,193522,Chang; Edmond Yi-Teh,0,6,28,28
1683683005753,MMW 15,B05,193523,Chang; Edmond Yi-Teh,0,5,28,28
1683683005753,MMW 15,B06,193524,Chang; Edmond Yi-Teh,0,5,28,28
1683683006777,MMW 122,A01,193526,Rahimi; Babak,0,16,28,28
1683683006777,MMW 122,A02,193527,Rahimi; Babak,0,15,28,28
1683683006777,MMW 122,A03,193528,Rahimi; Babak,0,0,0,0
1683683006777,MMW 122,A04,193529,Rahimi; Babak,0,0,0,0
1683683007801,MUS 1A,A01,186663,Staff,1,19,35,34
1683683008829,MUS 4,A01,186715,Staff,0,12,35,35
1683683009856,MUS 5R,A01,186796,Dubnov; Shlomo,0,17,35,35
1683683010880,MUS 6,A01,186798,Staff,1,5,25,24
1683683011902,MUS 7,A01,186830,Staff,11,0,35,24
1683683012930,MUS 8,A01,186930,Staff,0,27,35,35
1683683013954,MUS 15,A01,186932,Staff,0,15,35,35
1683683013954,MUS 15,B01,186934,Staff,1,17,35,34
1683683014977,MUS 80,A00,186935,Staff,0,0,20,20
1683683014977,MUS 80,B00,186936,Staff,24,0,25,1
1683683016002,NANO 11,A00,204702,Lipomi; Darren John,0,0,0,0
1683683017027,NANO 15,A01,204709,Yang; Kesong,0,1,0,0
1683683018052,NANO 114,A00,202069,Jahed Motlagh; Zeinab,3,0,10,7
1683683019078,PHIL 1,A00,186955,Grush; Rick Scott,31,0,40,9
1683683020102,PHIL 10,A01,186973,Grush; Rick Scott,27,0,35,8
1683683020102,PHIL 10,A02,186974,Grush; Rick Scott,33,0,35,2
1683683021130,PHIL 13,A01,186976,Staff,1,0,35,34
1683683021130,PHIL 13,A02,186977,Staff,16,0,35,19
1683683022156,PHIL 14,A01,186979,Staff,31,0,35,4
1683683022156,PHIL 14,A02,186986,Staff,32,0,35,3
1683683023182,PHIL 28,A01,186988,Staff,16,0,30,14
1683683023182,PHIL 28,A02,186989,Staff,1,0,30,29
1683683023182,PHIL 28,A03,186990,Staff,10,0,30,20
1683683023182,PHIL 28,A04,186991,Staff,26,0,30,4
1683683024206,PHIL 120,A00,186997,Staff,23,0,40,17
1683683025294,PHIL 137,A00,187003,Staff,7,0,40,33
1683683026320,PHIL 150,A00,187015,Staff,47,0,70,23
1683683027347,PHIL 167,A00,187021,Lamey; Andy M.,34,0,40,6
1683683028371,PHIL 174,A01,202226,Staff,17,0,20,3
1683683028371,PHIL 174,A02,202235,Staff,20,0,20,0
1683683029397,PHIL 191A,A00,258918,Staff,0,0,1,1
1683683030425,PHYS 1A,A00,187028,Staff,26,0,60,34
1683683031452,PHYS 1AL,001,187036,Staff,3,0,30,27
1683683031452,PHYS 1AL,002,187049,Staff,18,0,30,12
1683683032479,PHYS 1B,A00,187058,Staff,22,0,60,38
1683683033504,PHYS 1BL,001,187064,Staff,0,1,30,30
1683683033504,PHYS 1BL,002,187070,Staff,4,0,30,26
1683683034530,PHYS 1C,A00,187082,Staff,29,0,120,91
1683683035559,PHYS 1CL,001,187088,Staff,0,9,30,30
1683683035559,PHYS 1CL,002,187089,Staff,0,1,30,30
1683683035559,PHYS 1CL,009,262693,Staff,9,0,30,21
1683683036587,PHYS 2B,A01,187097,Staff,55,0,115,60
1683683037611,PHYS 2C,A01,187099,Staff,63,0,115,52
1683683038636,PHYS 2CL,A01,187101,Staff,5,0,28,23
1683683038636,PHYS 2CL,A02,187102,Staff,15,0,28,13
1683683039660,PHYS 2D,A01,187123,Shotwell; Brian,95,0,115,20
1683683040687,PHYS 4B,A01,187133,Grinstein; Benjamin,35,0,50,15
1683683041712,POLI 10,A00,188819,Staff,0,4,50,50
1683683042737,POLI 11,A00,188827,Staff,43,0,50,7
1683683043764,POLI 13R,A00,188828,Staff,0,1,20,20
1683683044791,POLI 27,A01,188830,Elgin; Samuel Zincke,0,2,70,70
1683683045815,POLI 30,A00,188832,Desposato; Scott,30,0,50,20
1683683046847,POLI 102F,A00,188834,Staff,1,0,40,39
1683683047871,POLI 104A,A00,188852,Staff,12,0,30,18
1683683048895,POLI 104I,A00,188853,Staff,0,8,20,20
1683683049919,POLI 110B,A00,188854,Wiens; David,6,0,20,14
1683683050942,POLI 112A,A00,188855,Wiens; David,3,0,30,27
1683683051966,POLI 117R,A00,188856,Forman; Fonna,0,12,20,20
1683683052991,POLI 118,A00,188857,Ingham; Sean,8,0,20,12
1683683054018,POLI 120G,A00,188858,Staff,8,0,30,22
1683683055042,POLI 131CR,A00,188863,Hoston; Germaine,20,0,50,30
1683683056069,POLI 133,A00,188864,Nellis; Gareth Hb,44,0,50,6
1683683057093,POLI 134D,A00,188865,Desposato; Scott,27,0,30,3
1683683058116,POLI 142A,A00,188871,Gartzke; Erik,21,0,50,29
1683683059138,POLI 142K,A00,188874,Staff,38,0,50,12
1683683060164,POLI 143,A00,188940,Gartzke; Erik,16,0,30,14
1683683061191,POLI 153,A00,188943,Staff,2,0,20,18
1683683062214,POLI 160AA,A00,188944,Staff,10,0,40,30
1683683063239,POLI 170A,A00,188945,Staff,10,0,30,20
1683683065291,PSYC 1,A00,188952,Staff,36,0,90,54
1683683066320,PSYC 2,B00,188953,Staff,19,0,35,16
1683683067347,PSYC 6,A00,188970,Staff,47,0,60,13
1683683068375,PSYC 7,A00,188973,Staff,35,0,45,10
1683683069400,PSYC 60,A01,188980,Rickard; Timothy C.,42,0,60,18
1683683070426,PSYC 70,A01,189001,Steiner; Eric Tomas,21,0,45,24
1683683071450,PSYC 100,A00,189005,Lacefield; Katharine I,0,99,120,120
1683683072474,PSYC 102,A00,189008,Staff,7,0,30,23
1683683073499,PSYC 106,B00,189026,Gorman; Michael R.,27,0,60,33
1683683074527,PSYC 114,B01,189033,Winkielman; Piotr,0,31,30,30
1683683075551,PSYC 131,A00,189036,Anagnostaras; Stephan,0,43,60,60
1683683076577,PSYC 136,A00,189041,Lowe; Angela Beth,0,7,25,25
1683683077601,PSYC 137,A00,189057,Winkielman; Piotr,1,37,25,24
1683683078625,PSYC 144,A00,189107,Wixted; John T,0,11,50,50
1683683080691,PSYC 162,A00,189142,Staff,0,9,85,85
1683683081716,PSYC 172,A00,189144,Gorman; Michael R.,0,6,30,30
1683683083766,PSYC 179,A00,189146,Lacefield; Katharine I,0,87,120,120
1683683084794,PSYC 181,A00,189147,Anagnostaras; Stephan,0,44,90,90
1683683085822,PSYC 190R,A00,189148,Barner; David A.,0,23,80,80
1683683086849,PSYC 191,A00,189275,Rickard; Timothy C.,0,10,25,25
1683683087873,PSYC 193,A00,189276,Chapman; Eddie Nathaniel,0,1,0,4
1683683088897,PSYC 193L,A01,189281,Lowe; Angela Beth,8,0,20,12
1683683088897,PSYC 193L,B01,189285,Staff,28,0,35,7
1683683089921,RELI 149,A00,187137,Rahimi; Babak,7,0,40,33
1683683090946,SE 9,A01,187315,Staff,0,2,18,18
1683683091970,SE 101B,A00,187409,Staff,24,0,30,6
1683683092995,SE 110B,A00,187444,Staff,10,0,40,30
1683683094019,SE 130B,A00,187449,Staff,31,0,40,9
1683683095043,SE 150A,A00,187516,Staff,8,0,20,12
1683683096070,SE 154,A00,187528,Staff,29,0,50,21
1683683097096,SIO 3,A01,258171,Staff,35,0,40,5
1683683098124,SIO 10,A00,187144,Cook; Geoffrey W,1,7,75,74
1683683099151,SIO 45,A00,187152,Cook; Geoffrey W,0,7,100,100
1683683100178,SIO 109R,A00,194486,Staff,0,4,20,20
1683683102231,SIO 187,A01,187233,Kacev; David,12,0,40,28
1683683103256,SOCI 1,A01,258656,Thorpe; Charles Robert,28,0,30,2
1683683103256,SOCI 1,A02,258658,Thorpe; Charles Robert,30,0,30,0
1683683103256,SOCI 1,A03,258661,Thorpe; Charles Robert,25,0,25,0
1683683103256,SOCI 1,A04,258666,Thorpe; Charles Robert,22,0,25,3
1683683103256,SOCI 1,A05,258897,Thorpe; Charles Robert,22,0,25,3
1683683103256,SOCI 1,A06,258898,Thorpe; Charles Robert,25,0,25,0
1683683104279,SOCI 30,A01,258903,Pardo Guerra; Juan Pablo,14,0,30,16
1683683105307,SOCI 102,A00,258904,Staff,9,0,25,16
1683683106331,SOCI 106,A00,258905,Staff,19,0,25,6
1683683107358,SOCI 111,A00,258907,Ribas Norris; Janet Vanesa,26,0,30,4
1683683108385,SOCI 121R,A00,258908,Pardo Guerra; Juan Pablo,8,0,30,22
1683683109412,SOCI 126,A01,203330,Staff,14,0,20,6
1683683110438,SOCI 131,A00,258909,Thorpe; Charles Robert,30,0,60,30
1683683111461,SOCI 135,A00,258910,Payne; Christine Anna,0,12,30,30
1683683112484,SOCI 157,A00,258911,Staff,11,0,30,19
1683683113510,SOCI 184,A00,258912,Staff,25,0,30,5
1683683114538,SOCI 188D,A00,258913,Staff,22,0,30,8
1683683115566,SYN 2,001,187529,Staff,9,0,16,7
1683683115566,SYN 2,002,201452,Staff,1,20,16,15
1683683115566,SYN 2,003,201469,Staff,1,0,16,15
1683683116590,SYN 100,A01,187531,Staff,0,9,20,20
1683683116590,SYN 100,B01,201491,Staff,0,10,20,20
1683683117614,TDAC 1,A00,189286,Walsh; Kim C.,3,0,20,17
1683683117614,TDAC 1,B00,189287,Harting; Carla Kelso,10,0,20,10
1683683118643,TDAC 101,A00,189300,Walsh; Kim C.,16,0,20,4
1683683118643,TDAC 101,B00,189301,Harting; Carla Kelso,18,0,20,2
1683683119668,TDAC 102,A00,189304,Basso; Beatrice,14,0,20,6
1683683120695,TDAC 108,A00,189305,Staff,18,0,20,2
1683683121720,TDDE 131,A00,189310,Staff,19,0,20,1
1683683121720,TDDE 131,B00,189314,Staff,19,0,20,1
1683683121720,TDDE 131,C00,189315,Staff,48,0,50,2
1683683121720,TDDE 131,D00,189316,Staff,14,0,15,1
1683683121720,TDDE 131,E00,204841,Staff,20,0,20,0
1683683122748,TDGE 10,A00,189289,Staff,27,0,50,23
1683683122748,TDGE 10,B00,189290,Havis; Allan,0,1,50,50
1683683123775,TDGE 11,A00,189291,Fulton; Julia,0,4,50,50
1683683123775,TDGE 11,B00,189292,Staff,20,0,25,5
1683683123775,TDGE 11,C00,260270,Staff,0,0,0,0
1683683124800,TDGE 25,A00,189294,Staff,1,0,20,19
1683683125822,TDGE 124,A00,189318,Fulton; Julia,0,8,50,50
1683683126847,TDGE 125,A00,189319,Staff,13,0,25,12
1683683126847,TDGE 125,B00,189320,Staff,23,0,25,2
1683683127871,TDGE 127,A00,189322,Havis; Allan,0,0,50,50
1683683128959,TDHT 101,A00,189323,Staff,18,0,25,7
1683683128959,TDHT 101,B00,189324,Staff,25,0,25,0
1683683129984,TDHT 102,A00,189325,Staff,49,0,50,1
1683683131009,TDMV 1,A00,189295,Arcidiacono; Kristin,20,0,30,10
1683683131009,TDMV 1,B00,189296,Caligagan; Maria T.,24,0,30,6
1683683132034,TDMV 2,A00,189297,Sammartano; Tonnie,27,0,30,3
1683683132034,TDMV 2,B00,189299,Arcidiacono; Kristin,23,0,30,7
1683683133059,TDMV 3,A00,204998,Rincon; Alicia,22,0,30,8
1683683134087,TDMV 120,A00,189458,Sammartano; Tonnie,28,0,30,2
1683683135111,TDMV 138,A00,189541,Jun; Grace Shin Hae,20,0,40,20
1683683136135,TDMV 142,A00,189717,Caligagan; Tony,25,0,30,5
1683683136135,TDMV 142,B00,189718,Caligagan; Maria T.,25,0,30,5
1683683137160,TMC 2,A01,187533,Staff,25,0,25,0
1683683137160,TMC 2,A02,187534,Staff,25,0,25,0
1683683138187,USP 1,A01,187536,Kwak; Nancy,0,16,25,25
1683683139214,USP 5,A01,187538,Staff,8,0,25,17
1683683140240,USP 101,A00,199253,Staff,0,4,0,0
1683683141265,USP 124,A00,187562,Boomhower; Matthew Charles,0,0,30,30
1683683142292,USP 138,A00,187582,Staff,19,0,25,6
1683683143318,USP 152,A01,187597,Staff,3,0,25,22
1683683144345,USP 153,A00,187598,Staff,18,0,25,7
1683683145369,USP 168,A00,187607,Kwak; Nancy,2,0,5,3
1683683146393,USP 173,A00,187619,Staff,4,0,25,21
1683683147416,USP 181,A00,187638,Staff,0,4,25,25
1683683148442,VIS 103,A00,187650,Cruz; Edwin Teddy,17,0,75,58
1683683149466,VIS 110D,A00,187669,Staff,13,0,22,9
1683683150490,VIS 127C,A00,187720,Shen; Kuiyi,67,0,146,79
1683683151515,VIS 149,A00,187731,Yoldas; Pinar,1,14,22,21
1683683152540,VIS 151,A01,188091,Staff,22,0,34,12
1683683152540,VIS 151,A02,188092,Staff,11,0,34,23
1683683153565,VIS 160B,A00,188093,Stalbaum; Brett,0,1,10,10
1683683155615,WCWP 10B,A00,201720,Staff,0,0,5,5
1683683155615,WCWP 10B,B00,201722,Staff,0,0,6,6
1683683156639,WCWP 100,A00,201725,Gagnon; Jeffrey C,0,0,2,2
1683683156639,WCWP 100,B00,201727,Staff,0,4,15,15
1683683159741,ANBI 133,A00,258401,Wilder; Linnea Lorene,34,0,40,6
1683683160771,ANBI 140,A00,258395,Hrvoj Mihic; Branka,18,0,25,7
1683683161799,ANSC 120,A00,258402,Bialecki; Jon Anthony,26,0,40,14
1683683162826,ANSC 144,A00,258400,Staff,12,0,40,28
1683683164884,ANSC 166,A00,258396,Parish; Steven Martin,156,0,175,19
1683683165911,ANSC 180,A00,193533,Staff,8,0,20,12
1683683166938,ANSC 188,A00,258397,Jassal; Aftab,34,0,40,6
1683683167963,ANTH 3,A01,258316,Staff,23,0,30,7
1683683168994,ANTH 5,A00,258394,Semendeferi; Ekaterini,16,0,20,4
1683683170019,ANTH 21,A01,258331,Staff,4,0,40,36
1683683171044,ANTH 103,A00,258398,Varma; Saiba,15,0,25,10
1683683172069,AWP 10,001,202034,Staff,0,0,0,0
1683683172069,AWP 10,002,202035,Staff,0,0,0,0
1683683172069,AWP 10,003,202036,Staff,0,0,0,0
1683683172069,AWP 10,004,202037,Staff,0,0,0,0
1683683172069,AWP 10,005,202038,Staff,0,0,0,0
1683683172069,AWP 10,006,202039,Staff,0,0,0,0
1683683172069,AWP 10,007,202040,Staff,0,0,0,0
1683683172069,AWP 10,008,202041,Staff,0,0,0,0
1683683172069,AWP 10,009,202042,Staff,0,0,0,0
1683683172069,AWP 10,010,202043,Staff,0,0,0,0
1683683172069,AWP 10,011,202044,Staff,0,0,0,0
1683683172069,AWP 10,012,202045,Staff,0,0,0,0
1683683172069,AWP 10,013,202046,Staff,0,0,0,0
1683683172069,AWP 10,014,202047,Staff,0,0,0,0
1683683172069,AWP 10,015,202048,Staff,0,0,0,0
1683683172069,AWP 10,016,202049,Staff,0,0,0,0
1683683172069,AWP 10,017,202050,Staff,0,0,0,0
1683683172069,AWP 10,018,202051,Staff,0,0,0,0
1683683172069,AWP 10,019,202052,Staff,0,0,0,0
1683683172069,AWP 10,020,202053,Staff,0,0,0,0
1683683172069,AWP 10,021,202054,Staff,0,0,0,0
1683683172069,AWP 10,022,202055,Staff,0,0,0,0
1683683172069,AWP 10,023,202056,Staff,0,0,0,0
1683683172069,AWP 10,024,202057,Staff,0,0,0,0
1683683172069,AWP 10,025,202058,Staff,0,0,0,0
1683683172069,AWP 10,026,202059,Staff,0,0,0,0
1683683173095,AWP 102,001,202032,Staff,0,0,0,0
1683683173095,AWP 102,002,202033,Staff,0,0,0,0
1683683174123,BENG 100,A01,254234,Taylor Amos; Alyssa C,31,0,40,9
1683683175147,BENG 196,001,270013,Engler; Adam J.,9999,0,9999,0
1683683176173,BICD 100R,A01,202018,Smith; Laurie,0,7,32,32
1683683176173,BICD 100R,A02,202019,Smith; Laurie,0,3,32,32
1683683176173,BICD 100R,A03,202020,Smith; Laurie,0,1,32,32
1683683176173,BICD 100R,A04,202021,Smith; Laurie,6,0,32,26
1683683176173,BICD 100R,A05,202022,Smith; Laurie,10,0,32,22
1683683177198,BICD 136,A01,193242,Gustafson-Brown; Cindy,0,2,32,32
1683683177198,BICD 136,A02,193244,Gustafson-Brown; Cindy,13,0,32,19
1683683178223,BIEB 102,A01,193249,Butler; Shannon Rhey,1,1,32,31
1683683178223,BIEB 102,A02,193251,Butler; Shannon Rhey,0,0,32,32
1683683178223,BIEB 102,A03,193253,Butler; Shannon Rhey,0,0,32,32
1683683178223,BIEB 102,A04,193255,Butler; Shannon Rhey,13,0,32,19
1683683178223,BIEB 102,A05,193265,Butler; Shannon Rhey,25,0,32,7
1683683178223,BIEB 102,A06,193269,Butler; Shannon Rhey,13,0,32,19
1683683180271,BIEB 150,A01,193274,Staff,0,0,32,32
1683683180271,BIEB 150,A02,193285,Staff,24,0,32,8
1683683181296,BIEB 194,A00,193286,Kurle; Carolyn M.,19,0,32,13
1683683182320,BILD 1,A01,192291,Staff,15,0,32,17
1683683182320,BILD 1,A02,192292,Staff,30,0,32,2
1683683182320,BILD 1,B01,192520,Reuther; Keefe,0,1,0,0
1683683182320,BILD 1,B02,192532,Reuther; Keefe,0,1,0,0
1683683183346,BILD 3,A01,192556,Butler; Shannon Rhey,0,0,32,32
1683683183346,BILD 3,A02,192581,Butler; Shannon Rhey,0,1,32,32
1683683183346,BILD 3,A03,192611,Butler; Shannon Rhey,19,0,32,13
1683683183346,BILD 3,A04,192612,Butler; Shannon Rhey,24,0,32,8
1683683183346,BILD 3,A05,192613,Butler; Shannon Rhey,26,0,32,6
1683683183346,BILD 3,A06,192679,Butler; Shannon Rhey,27,0,32,5
1683683183346,BILD 3,A07,192682,Butler; Shannon Rhey,20,0,32,12
1683683184375,BILD 4,A01,192836,Reuther; Keefe,1,0,24,23
1683683184375,BILD 4,A02,193044,Reuther; Keefe,4,0,24,20
1683683185398,BILD 10,A01,193142,Gustafson-Brown; Cindy,29,0,32,3
1683683185398,BILD 10,A02,193149,Gustafson-Brown; Cindy,31,0,32,1
1683683186422,BIMM 100,A01,193301,Staff,0,6,32,32
1683683186422,BIMM 100,A02,193312,Staff,0,7,32,32
1683683186422,BIMM 100,A03,193323,Staff,0,10,32,32
1683683187447,BIMM 101,A01,193329,McDonnell; Lisa Marie,1,4,24,23
1683683187447,BIMM 101,A02,193339,McDonnell; Lisa Marie,1,4,24,23
1683683187447,BIMM 101,B01,193354,McDonnell; Lisa Marie,0,4,24,24
1683683187447,BIMM 101,B02,193357,McDonnell; Lisa Marie,0,3,24,24
1683683188475,BIMM 110,A01,193377,Tat; John,0,11,32,32
1683683188475,BIMM 110,A02,193378,Tat; John,0,11,32,32
1683683189500,BIMM 120,A01,206116,Staff,0,0,32,32
1683683189500,BIMM 120,A02,206117,Staff,7,0,32,25
1683683189500,BIMM 120,A03,206121,Staff,21,0,32,11
1683683190526,BIPN 100,A01,193393,Park; Ji Young,0,15,32,32
1683683190526,BIPN 100,A02,193402,Park; Ji Young,0,14,32,32
1683683190526,BIPN 100,A03,193413,Park; Ji Young,0,14,32,32
1683683190526,BIPN 100,A04,193414,Park; Ji Young,0,13,32,32
1683683191552,BIPN 102,A01,193429,Staff,0,0,32,32
1683683191552,BIPN 102,A02,193438,Staff,18,0,32,14
1683683192576,BIPN 106,A01,193450,Reyes Gonzalez; Catalina,0,2,40,40
1683683193606,BIPN 134,A01,193465,Cooke; James Edward,0,0,32,32
1683683193606,BIPN 134,A02,193474,Cooke; James Edward,25,0,32,7
1683683193606,BIPN 134,A03,193485,Cooke; James Edward,29,0,32,3
1683683193606,BIPN 134,A04,193486,Cooke; James Edward,20,0,32,12
1683683193606,BIPN 134,A05,193491,Cooke; James Edward,31,0,32,1
1683683193606,BIPN 134,A06,193501,Cooke; James Edward,30,0,32,2
1683683193606,BIPN 134,A07,193510,Cooke; James Edward,29,0,32,3
1683683195656,BISP 194,A00,222522,Staff,14,0,32,18
1683683196681,CAT 124,A01,202407,Staff,19,0,25,6
1683683197705,CAT 125,A00,202408,Marchisotto; Jennifer Anne,2,0,20,18
1683683198731,CAT 125R,A00,202409,Smith; Lauryn Alissa,0,11,20,20
1683683198731,CAT 125R,B00,202410,Morales; Celeste Georgianna,0,11,20,20
1683683198731,CAT 125R,C00,202411,Irwin; Matthew Joseph,0,12,20,20
1683683199756,CENG 15,A01,204712,Yang; Kesong,0,1,0,0
1683683200784,CENG 114,A00,202070,Jahed Motlagh; Zeinab,5,0,20,15
1683683201808,CGS 105,A00,185477,Wesling; Megan E.,24,0,40,16
1683683202831,CGS 106,A00,185494,Staff,11,0,22,11
1683683203858,CGS 108,A00,185495,Staff,14,0,20,6
1683683204881,CGS 114,A00,185496,Staff,13,0,18,5
1683683205911,CGS 119,A00,185501,Staff,15,0,20,5
1683683206937,CGS 120,A00,185511,Staff,12,0,20,8
1683683207963,CHEM 4,A01,184675,Bussey; Thomas J,97,0,100,3
1683683208990,CHEM 6A,A01,184677,Staff,32,0,60,28
1683683210015,CHEM 6B,A01,184679,Staff,63,0,100,37
1683683211042,CHEM 6C,A01,184681,Bussey; Thomas J,0,0,50,50
1683683211042,CHEM 6C,A02,184682,Bussey; Thomas J,32,0,50,18
1683683212066,CHEM 40A,A01,184684,Albizati; Kim F.,33,0,100,67
1683683213091,CHEM 40B,A01,184686,Albizati; Kim F.,0,22,100,100
1683683214114,CHEM 41B,A01,184690,Staff,51,0,100,49
1683683215139,COGS 3,A01,184715,Boyle; Mary E. T.,0,27,40,40
1683683216163,COGS 14B,A01,185172,Staff,0,14,38,38
1683683217188,COGS 18,A01,184736,Staff,14,0,80,66
1683683218212,COGS 100,A01,184932,Staff,0,8,73,73
1683683219236,COGS 101A,A01,184935,Staff,0,40,30,30
1683683220262,COGS 101B,A01,184944,Staff,0,2,30,30
1683683221287,COGS 101C,A01,184946,Staff,0,10,30,30
1683683222313,COGS 102A,A01,184951,Johnson; Christine M.,1,0,40,39
1683683223338,COGS 107B,A01,184953,Mooshagian; Eric Frederick,0,52,40,40
1683683224362,COGS 118B,A01,184959,Gupta; Anjum,0,50,40,40
1683683225385,COGS 153,A00,184961,Staff,0,16,30,30
1683683226411,COGS 177,A00,184962,Staff,1,21,30,29
1683683227434,COGS 187A,A01,184969,Boyle; Mary E. T.,0,19,40,40
1683683228461,COMM 10,A01,185174,Staff,0,5,25,25
1683683228461,COMM 10,A02,185189,Staff,0,2,25,25
1683683228461,COMM 10,A03,269821,Staff,0,1,0,0
1683683229489,COMM 100B,A02,185476,Staff,10,0,25,15
1683683229489,COMM 100B,A03,277340,Staff,25,0,25,0
1683683230513,COMM 100C,A01,185314,Staff,1,0,25,24
1683683230513,COMM 100C,A02,185327,Staff,17,0,25,8
1683683231540,COMM 110M,A00,185349,Staff,0,0,40,40
1683683232625,COMM 113T,A00,185352,Staff,25,0,40,15
1683683233651,COMM 114I,A00,185353,Staff,31,0,40,9
1683683234679,COMM 131,A00,185354,Staff,17,0,30,13
1683683235707,CSE 8A,A50,185358,Cao; Yingjun,0,46,10,10
1683683236733,CSE 8B,A01,185362,Staff,0,48,50,50
1683683237759,CSE 11,A01,185416,Cao; Yingjun,0,91,10,10
1683683238784,CSE 20,A01,185445,Briones; Jor-el Thomas Caparas,3,0,25,22
1683683239809,CSE 21,A01,185447,Staff,9,0,50,41
1683683240835,CSE 101,A01,185451,Staff,0,13,50,50
1683683240835,CSE 101,B01,185453,Jones; Miles E,0,14,50,50
1683683242896,CSE 141,A01,185458,Eldon; John,16,0,100,84
1683683243928,CSE 141L,A01,185461,Eldon; John,8,0,100,92
1683683244959,CSE 142,A01,185463,Staff,34,0,60,26
1683683244959,CSE 142,B01,201355,Staff,0,7,60,60
1683683245984,CSE 142L,A01,185470,Staff,34,0,60,26
1683683245984,CSE 142L,B01,201417,Staff,0,6,60,60
1683683247011,CSE 190,A00,201433,Staff,32,0,49,17
1683683248040,DOC 1,A01,259136,Strom; Megan C.,7,0,15,8
1683683248040,DOC 1,A02,259137,Strom; Megan C.,14,0,15,1
1683683248040,DOC 1,A03,259138,Strom; Megan C.,14,0,15,1
1683683248040,DOC 1,A04,259139,Strom; Megan C.,14,0,15,1
1683683249068,DOC 100D,A00,259140,Pass; Natalye Joann,14,0,25,11
1683683250097,DSGN 1,A01,184749,Rill; Bryan,0,26,30,30
1683683251121,DSGN 100,A01,185168,Staff,0,2,25,25
1683683252149,ECE 5,A01,185626,Morris; Karcher William,0,12,0,0
1683683253174,ECE 101,A01,185628,Staff,14,0,70,56
1683683254201,ECE 107,A01,185635,Baghdadchi; Saharnaz,0,0,20,20
1683683254201,ECE 107,A02,185638,Baghdadchi; Saharnaz,1,0,20,19
1683683255226,ECE 148,A01,185647,Silberman; Jack,0,0,16,16
1683683256251,ECON 1,A01,185537,Crane; Meredith Helen,54,0,70,16
1683683257285,ECON 3,A01,185549,Crane; Meredith Helen,30,0,70,40
1683683258328,ECON 4,A01,203354,Anderson; John Charles,0,5,10,10
1683683259372,ECON 100A,A01,185574,Staff,0,5,40,40
1683683260403,ECON 100B,A01,185576,Staff,0,12,50,50
1683683261432,ECON 100C,A01,185589,Newhouse; Herbert S,30,0,70,40
1683683262467,ECON 105,A00,185608,Vespa; Emanuel Ignacio,19,0,35,16
1683683263492,ECON 109,A01,185610,Shishkin; Denis,9,0,35,26
1683683264517,ECON 110A,A01,185612,Staff,9,0,40,31
1683683265542,ECON 120A,A01,185615,Staff,19,0,40,21
1683683266566,ECON 120C,A01,185617,Sun; Yixiao,0,21,70,70
1683683267595,ECON 144,A00,203346,Squires; Dale E,2,0,35,33
1683683268621,ECON 171,A01,203349,Newhouse; Herbert S,0,1,35,35
1683683269648,ECON 173A,A01,185621,Toda; Alexis Akira,21,0,35,14
1683683270678,EDS 25,A01,202413,Staff,0,1,0,0
1683683270678,EDS 25,A02,202414,Staff,0,1,0,0
1683683270678,EDS 25,A03,202415,Staff,0,0,0,0
1683683270678,EDS 25,A04,202416,Staff,0,1,0,0
1683683270678,EDS 25,A05,202439,Staff,0,0,0,0
1683683270678,EDS 25,A06,202440,Staff,0,0,0,0
1683683270678,EDS 25,B01,202631,Staff,0,0,0,0
1683683270678,EDS 25,B02,202632,Staff,0,0,0,0
1683683270678,EDS 25,B03,202639,Staff,0,0,0,0
1683683270678,EDS 25,B04,202640,Staff,0,0,0,0
1683683270678,EDS 25,B05,202643,Staff,0,0,0,0
1683683270678,EDS 25,B06,202644,Staff,0,0,0,0
1683683271701,EDS 38,A01,202659,Black; Alison Michelle,24,0,25,1
1683683272728,EDS 115,A00,202652,Staff,18,0,30,12
1683683273757,EDS 125,A00,202649,Staff,13,0,30,17
1683683274784,EDS 126,A01,203332,Staff,30,0,30,0
1683683275808,EDS 139,A00,202838,Staff,16,0,25,9
1683683276833,EDS 146,A01,202655,Staff,14,0,25,11
1683683277858,ENG 15,A00,185667,Staff,0,1,0,0
1683683277858,ENG 15,B00,185672,Staff,0,0,0,0
1683683277858,ENG 15,C00,185675,Staff,0,0,0,0
1683683277858,ENG 15,D00,185682,Staff,0,0,0,0
1683683277858,ENG 15,E00,185684,Staff,0,0,0,0
1683683278885,ETHN 103,A00,185710,Staff,0,8,35,35
1683683279910,ETHN 103A,A00,199228,Man; Simeon S,0,0,9,9
1683683280941,ETHN 109,A00,185711,Staff,15,0,35,20
1683683281971,ETHN 142,A00,185726,Staff,0,4,30,30
1683683282996,ETHN 163J,A00,199229,Man; Simeon S,5,0,8,3
1683683284021,ETHN 168,A00,185727,Staff,7,0,10,3
1683683285043,ETHN 182,A00,185728,Staff,0,0,35,35
1683683286068,ETHN 183,A00,185737,Staff,9,0,18,9
1683683287093,GLBH 111,A01,209361,Burgos; Jose L.,0,0,0,0
1683683289144,HIEU 104,A00,185792,Staff,14,0,20,6
1683683290168,HIEU 115,A00,185800,Staff,0,0,20,20
1683683291195,HIEU 128,A00,185801,Staff,0,9,20,20
1683683292219,HIEU 147,A00,185802,Staff,15,0,20,5
1683683293243,HIEU 154,A00,185823,Staff,11,0,20,9
1683683294268,HILA 102,A00,185826,Staff,14,0,20,6
1683683295296,HILD 2C,A01,185778,Staff,0,13,20,20
1683683296325,HILD 7B,A01,185780,Kwak; Nancy,0,17,32,32
1683683296325,HILD 7B,A02,185781,Kwak; Nancy,0,18,32,32
1683683297352,HILD 30,A01,185791,Staff,12,0,20,8
1683683298377,HISC 119,A00,185830,Golan; Tal,0,10,20,20
1683683299413,HITO 156GS,A00,185831,Patterson; Patrick H.,0,0,0,23
1683683300437,HIUS 103,A00,185832,Man; Simeon S,0,4,20,20
1683683301466,HIUS 117,A00,185836,Kwak; Nancy,2,0,20,18
1683683302490,HIUS 125,A00,185840,Man; Simeon S,0,2,23,23
1683683303514,HIUS 149,A00,185845,Staff,1,0,20,19
1683683304539,HUM 3,A01,185882,Zavodny; Tatiana Sophia,0,8,50,50
1683683304539,HUM 3,B01,185899,Caldwell; Michael Alan,0,18,50,50
1683683305566,HUM 3GS,A00,185900,Patterson; Patrick H.,0,0,0,23
1683683306590,HUM 4,A01,185938,Zroka; Amy Liane,28,0,50,22
1683683306590,HUM 4,B01,185956,Watkins; Eric,0,6,50,50
1683683306590,HUM 4,B02,202209,Watkins; Eric,0,5,50,50
1683683306590,HUM 4,B03,202210,Watkins; Eric,0,5,50,50
1683683307619,HUM 5,A01,185958,West; Geoffrey Scott,0,0,50,50
1683683307619,HUM 5,A02,202215,West; Geoffrey Scott,0,0,50,50
1683683308643,INTL 190,A00,185959,Gagnon; Jeffrey C,0,0,0,9
1683683308643,INTL 190,B00,185960,Lettieri; Michael Joseph,0,0,0,2
1683683309667,JAPN 180,A00,254509,Staff,5,0,30,25
1683683310696,LATI 10,A01,202853,Kennemore; Amy Michelle,4,0,35,31
1683683310696,LATI 10,A02,202854,Kennemore; Amy Michelle,3,0,35,32
1683683310696,LATI 10,A03,270054,Kennemore; Amy Michelle,30,0,30,0
1683683311723,LATI 180,A00,202855,Kennemore; Amy Michelle,11,0,20,9
1683683312748,LAWS 101,A00,201767,Golan; Tal,0,7,40,40
1683683313777,LIFR 1C,A00,185961,Staff,6,0,20,14
1683683314803,LIFR 1CX,A00,185962,Staff,7,0,20,13
1683683315831,LIFR 1D,A00,185963,Staff,7,0,20,13
1683683316856,LIFR 1DX,A00,185964,Staff,7,0,20,13
1683683317880,LIGN 101,A01,186039,Staff,43,0,50,7
1683683318906,LIGN 165,A00,186040,Staff,15,0,50,35
1683683319931,LTCS 108,A00,186041,Staff,5,0,10,5
1683683320956,LTCS 119,A00,186042,Staff,15,0,20,5
1683683321981,LTCS 130,A00,186043,Wesling; Megan E.,15,0,25,10
1683683324033,LTEA 138,A00,186119,Staff,14,0,40,26
1683683325056,LTEN 124,A00,186148,Staff,5,0,25,20
1683683326082,LTEN 178,A00,186149,Staff,6,0,15,9
1683683327110,LTEN 181,A00,186150,Blanco; John D,34,0,40,6
1683683328134,LTWL 120,A00,186160,Staff,19,0,25,6
1683683329158,LTWL 165,A00,186161,Staff,22,0,25,3
1683683330182,LTWR 100,A00,186162,Staff,0,5,15,15
1683683331205,LTWR 102,A00,186163,Doller; Ben,5,0,15,10
1683683332228,MAE 8,A01,186412,Staff,0,1,0,0
1683683333252,MAE 30B,A00,186445,Bahadori; Mohammad Yousef,81,0,100,19
1683683334276,MAE 40,A00,186592,Bewley; Thomas R,10,0,50,40
1683683335300,MAE 101B,A00,186593,Bahadori; Mohammad Yousef,80,0,100,20
1683683336384,MAE 105,A00,186594,Bandaru; Prabhakar,10,0,50,40
1683683337408,MAE 107,A00,186599,Pham; Hieu Tan,0,7,120,120
1683683338434,MAE 148,A01,186660,Silberman; Jack,3,0,16,13
1683683339457,MATH 10A,A01,188095,Staff,0,6,35,35
1683683340482,MATH 10B,A01,188097,Bowers; Adam R.,0,12,30,30
1683683340482,MATH 10B,A02,188099,Bowers; Adam R.,0,11,30,30
1683683340482,MATH 10B,B01,188104,Bowers; Adam R.,0,10,30,30
1683683340482,MATH 10B,B02,188106,Bowers; Adam R.,1,9,30,29
1683683341505,MATH 10C,A01,188111,Staff,0,20,30,30
1683683341505,MATH 10C,A02,188127,Staff,0,19,30,30
1683683341505,MATH 10C,A03,188131,Staff,0,19,30,30
1683683341505,MATH 10C,B01,188218,Staff,17,0,30,13
1683683341505,MATH 10C,B02,188244,Staff,13,0,30,17
1683683341505,MATH 10C,B03,188277,Staff,14,0,30,16
1683683342646,MATH 18,A01,188344,Bach; Quang Tran,18,0,30,12
1683683342646,MATH 18,A02,188345,Bach; Quang Tran,11,0,30,19
1683683342646,MATH 18,B01,188353,Bach; Quang Tran,11,0,30,19
1683683342646,MATH 18,B02,188354,Bach; Quang Tran,19,0,30,11
1683683343671,MATH 20A,A01,188374,Staff,11,0,35,24
1683683344695,MATH 20B,A01,188382,Ohm; Ko Woon,7,0,30,23
1683683344695,MATH 20B,A02,188383,Ohm; Ko Woon,22,0,30,8
1683683344695,MATH 20B,B01,188385,Ohm; Ko Woon,7,0,30,23
1683683344695,MATH 20B,B02,188392,Ohm; Ko Woon,22,0,30,8
1683683345724,MATH 20C,A01,188394,Harel; Guershon,10,0,30,20
1683683345724,MATH 20C,A02,188395,Harel; Guershon,13,0,30,17
1683683345724,MATH 20C,B01,188404,Harel; Guershon,5,0,30,25
1683683345724,MATH 20C,B02,188405,Harel; Guershon,18,0,30,12
1683683346756,MATH 20D,A01,188414,Hammock; Frances H,0,1,30,30
1683683346756,MATH 20D,A02,188415,Hammock; Frances H,0,1,30,30
1683683346756,MATH 20D,B01,188447,Hammock; Frances H,0,1,30,30
1683683346756,MATH 20D,B02,188486,Hammock; Frances H,3,0,30,27
1683683347783,MATH 20E,A01,188649,Staff,21,0,30,9
1683683347783,MATH 20E,A02,188650,Staff,20,0,30,10
1683683347783,MATH 20E,A03,188673,Staff,0,0,30,30
1683683348809,MATH 102,A01,188675,Staff,0,39,35,35
1683683349838,MATH 103B,A01,188681,Staff,3,0,35,32
1683683349838,MATH 103B,B01,188692,Staff,5,0,35,30
1683683350867,MATH 109,A01,188695,Salehi Golsefidy; Alireza,24,0,35,11
1683683350867,MATH 109,A02,188696,Salehi Golsefidy; Alireza,25,0,35,10
1683683351892,MATH 120A,A01,188698,Eggers; John Dietrich,7,0,35,28
1683683352917,MATH 142B,A01,188736,Ioana; Adrian,1,1,30,29
1683683352917,MATH 142B,A02,188741,Ioana; Adrian,0,1,30,30
1683683352917,MATH 142B,A03,188743,Ioana; Adrian,0,1,30,30
1683683353941,MATH 168A,A01,188790,Staff,0,11,35,35
1683683354970,MATH 170A,A01,188803,Nie; Jiawang,0,2,35,35
1683683354970,MATH 170A,A02,188811,Nie; Jiawang,0,1,35,35
1683683354970,MATH 170A,A03,188814,Nie; Jiawang,0,0,35,35
1683683354970,MATH 170A,A04,188815,Nie; Jiawang,6,0,35,29
1683683355998,MATH 193B,A01,188817,Staff,0,0,35,35
1683683355998,MATH 193B,A02,188818,Staff,5,0,35,30
1683683357024,MGT 4,A01,202857,Anderson; John Charles,59,0,80,21
1683683358051,MGT 12,A00,202858,Lindenberger; Wade Douglas,40,0,90,50
1683683359079,MGT 18,A00,202859,Staff,74,0,90,16
1683683360103,MGT 18GS,A00,202860,McKay; Michael J,13,0,28,15
1683683361129,MGT 45,A00,202861,Pecore; Joseph P.,8,0,90,82
1683683362152,MGT 100,A00,202863,Yavorsky; Daniel Ryan,28,0,90,62
1683683363177,MGT 103,A00,202864,Ehrich; Kristine R,0,19,90,90
1683683364202,MGT 112,A00,202865,Ehrich; Kristine R,15,0,90,75
1683683365227,MGT 121A,A00,202868,Staff,90,20,90,0
1683683366254,MGT 131B,A00,202869,Anderson; John Charles,59,0,90,31
1683683367277,MGT 136,A00,202871,Lindenberger; Wade Douglas,83,0,90,7
1683683368305,MGT 164,A00,202873,Staff,0,68,90,91
1683683369333,MGT 164GS,A00,202874,McKay; Mary A,13,0,28,15
1683683370357,MGT 180,A00,202875,Staff,0,51,90,91
1683683371386,MMW 11R,A01,205019,Herbst; Matthew,0,0,30,30
1683683371386,MMW 11R,A02,205026,Herbst; Matthew,29,0,30,1
1683683372415,MMW 15,A01,193512,Chang; Edmond Yi-Teh,0,8,28,28
1683683372415,MMW 15,A02,193513,Chang; Edmond Yi-Teh,0,5,28,28
1683683372415,MMW 15,A03,193514,Chang; Edmond Yi-Teh,0,5,28,28
1683683372415,MMW 15,A04,193515,Chang; Edmond Yi-Teh,0,5,28,28
1683683372415,MMW 15,A05,193516,Chang; Edmond Yi-Teh,0,5,28,28
1683683372415,MMW 15,A06,193517,Chang; Edmond Yi-Teh,0,6,28,28
1683683372415,MMW 15,B01,193519,Chang; Edmond Yi-Teh,0,5,28,28
1683683372415,MMW 15,B02,193520,Chang; Edmond Yi-Teh,0,5,28,28
1683683372415,MMW 15,B03,193521,Chang; Edmond Yi-Teh,0,5,28,28
1683683372415,MMW 15,B04,193522,Chang; Edmond Yi-Teh,0,6,28,28
1683683372415,MMW 15,B05,193523,Chang; Edmond Yi-Teh,0,5,28,28
1683683372415,MMW 15,B06,193524,Chang; Edmond Yi-Teh,0,5,28,28
1683683373438,MMW 122,A01,193526,Rahimi; Babak,0,16,28,28
1683683373438,MMW 122,A02,193527,Rahimi; Babak,0,15,28,28
1683683373438,MMW 122,A03,193528,Rahimi; Babak,0,0,0,0
1683683373438,MMW 122,A04,193529,Rahimi; Babak,0,0,0,0
1683683374465,MUS 1A,A01,186663,Staff,1,19,35,34
1683683375493,MUS 4,A01,186715,Staff,0,12,35,35
1683683376520,MUS 5R,A01,186796,Dubnov; Shlomo,0,17,35,35
1683683377544,MUS 6,A01,186798,Staff,1,5,25,24
1683683378569,MUS 7,A01,186830,Staff,11,0,35,24
1683683379593,MUS 8,A01,186930,Staff,0,27,35,35
1683683380622,MUS 15,A01,186932,Staff,0,15,35,35
1683683380622,MUS 15,B01,186934,Staff,1,17,35,34
1683683381647,MUS 80,A00,186935,Staff,0,0,20,20
1683683381647,MUS 80,B00,186936,Staff,24,0,25,1
1683683382674,NANO 11,A00,204702,Lipomi; Darren John,0,0,0,0
1683683383700,NANO 15,A01,204709,Yang; Kesong,0,1,0,0
1683683384724,NANO 114,A00,202069,Jahed Motlagh; Zeinab,3,0,10,7
1683683385751,PHIL 1,A00,186955,Grush; Rick Scott,31,0,40,9
1683683386775,PHIL 10,A01,186973,Grush; Rick Scott,27,0,35,8
1683683386775,PHIL 10,A02,186974,Grush; Rick Scott,33,0,35,2
1683683387798,PHIL 13,A01,186976,Staff,1,0,35,34
1683683387798,PHIL 13,A02,186977,Staff,16,0,35,19
1683683388826,PHIL 14,A01,186979,Staff,31,0,35,4
1683683388826,PHIL 14,A02,186986,Staff,32,0,35,3
1683683389861,PHIL 28,A01,186988,Staff,16,0,30,14
1683683389861,PHIL 28,A02,186989,Staff,1,0,30,29
1683683389861,PHIL 28,A03,186990,Staff,10,0,30,20
1683683389861,PHIL 28,A04,186991,Staff,26,0,30,4
1683683390890,PHIL 120,A00,186997,Staff,23,0,40,17
1683683391914,PHIL 137,A00,187003,Staff,7,0,40,33
1683683392938,PHIL 150,A00,187015,Staff,47,0,70,23
1683683393967,PHIL 167,A00,187021,Lamey; Andy M.,34,0,40,6
1683683394994,PHIL 174,A01,202226,Staff,17,0,20,3
1683683394994,PHIL 174,A02,202235,Staff,20,0,20,0
1683683396017,PHIL 191A,A00,258918,Staff,0,0,1,1
1683683397042,PHYS 1A,A00,187028,Staff,26,0,60,34
1683683398065,PHYS 1AL,001,187036,Staff,3,0,30,27
1683683398065,PHYS 1AL,002,187049,Staff,18,0,30,12
1683683399091,PHYS 1B,A00,187058,Staff,22,0,60,38
1683683400117,PHYS 1BL,001,187064,Staff,0,1,30,30
1683683400117,PHYS 1BL,002,187070,Staff,4,0,30,26
1683683401140,PHYS 1C,A00,187082,Staff,29,0,120,91
1683683402165,PHYS 1CL,001,187088,Staff,0,9,30,30
1683683402165,PHYS 1CL,002,187089,Staff,0,1,30,30
1683683402165,PHYS 1CL,009,262693,Staff,9,0,30,21
1683683403192,PHYS 2B,A01,187097,Staff,55,0,115,60
1683683404215,PHYS 2C,A01,187099,Staff,63,0,115,52
1683683405244,PHYS 2CL,A01,187101,Staff,5,0,28,23
1683683405244,PHYS 2CL,A02,187102,Staff,15,0,28,13
1683683406271,PHYS 2D,A01,187123,Shotwell; Brian,95,0,115,20
1683683407296,PHYS 4B,A01,187133,Grinstein; Benjamin,35,0,50,15
1683683408322,POLI 10,A00,188819,Staff,0,4,50,50
1683683409347,POLI 11,A00,188827,Staff,43,0,50,7
1683683410375,POLI 13R,A00,188828,Staff,0,1,20,20
1683683411405,POLI 27,A01,188830,Elgin; Samuel Zincke,0,2,70,70
1683683412429,POLI 30,A00,188832,Desposato; Scott,30,0,50,20
1683683413453,POLI 102F,A00,188834,Staff,1,0,40,39
1683683414476,POLI 104A,A00,188852,Staff,12,0,30,18
1683683415503,POLI 104I,A00,188853,Staff,0,8,20,20
1683683416527,POLI 110B,A00,188854,Wiens; David,6,0,20,14
1683683417557,POLI 112A,A00,188855,Wiens; David,3,0,30,27
1683683418585,POLI 117R,A00,188856,Forman; Fonna,0,12,20,20
1683683419610,POLI 118,A00,188857,Ingham; Sean,8,0,20,12
1683683420640,POLI 120G,A00,188858,Staff,8,0,30,22
1683683421667,POLI 131CR,A00,188863,Hoston; Germaine,20,0,50,30
1683683422695,POLI 133,A00,188864,Nellis; Gareth Hb,44,0,50,6
1683683423723,POLI 134D,A00,188865,Desposato; Scott,27,0,30,3
1683683424746,POLI 142A,A00,188871,Gartzke; Erik,21,0,50,29
1683683425769,POLI 142K,A00,188874,Staff,38,0,50,12
1683683426796,POLI 143,A00,188940,Gartzke; Erik,16,0,30,14
1683683427821,POLI 153,A00,188943,Staff,2,0,20,18
1683683428848,POLI 160AA,A00,188944,Staff,10,0,40,30
1683683429875,POLI 170A,A00,188945,Staff,10,0,30,20
1683683431925,PSYC 1,A00,188952,Staff,36,0,90,54
1683683432947,PSYC 2,B00,188953,Staff,19,0,35,16
1683683433972,PSYC 6,A00,188970,Staff,47,0,60,13
1683683434999,PSYC 7,A00,188973,Staff,35,0,45,10
1683683436030,PSYC 60,A01,188980,Rickard; Timothy C.,42,0,60,18
1683683437058,PSYC 70,A01,189001,Steiner; Eric Tomas,21,0,45,24
1683683438083,PSYC 100,A00,189005,Lacefield; Katharine I,0,99,120,120
1683683439111,PSYC 102,A00,189008,Staff,7,0,30,23
1683683440190,PSYC 106,B00,189026,Gorman; Michael R.,27,0,60,33
1683683441217,PSYC 114,B01,189033,Winkielman; Piotr,0,31,30,30
1683683442243,PSYC 131,A00,189036,Anagnostaras; Stephan,0,43,60,60
1683683443266,PSYC 136,A00,189041,Lowe; Angela Beth,0,7,25,25
1683683444292,PSYC 137,A00,189057,Winkielman; Piotr,1,37,25,24
1683683445317,PSYC 144,A00,189107,Wixted; John T,0,11,50,50
1683683447372,PSYC 162,A00,189142,Staff,0,9,85,85
1683683448400,PSYC 172,A00,189144,Gorman; Michael R.,0,6,30,30
1683683450448,PSYC 179,A00,189146,Lacefield; Katharine I,0,87,120,120
1683683451476,PSYC 181,A00,189147,Anagnostaras; Stephan,0,44,90,90
1683683452504,PSYC 190R,A00,189148,Barner; David A.,0,23,80,80
1683683453528,PSYC 191,A00,189275,Rickard; Timothy C.,0,10,25,25
1683683454556,PSYC 193,A00,189276,Chapman; Eddie Nathaniel,0,1,0,4
1683683455581,PSYC 193L,A01,189281,Lowe; Angela Beth,8,0,20,12
1683683455581,PSYC 193L,B01,189285,Staff,28,0,35,7
1683683456606,RELI 149,A00,187137,Rahimi; Babak,7,0,40,33
1683683457634,SE 9,A01,187315,Staff,0,2,18,18
1683683458657,SE 101B,A00,187409,Staff,24,0,30,6
1683683459685,SE 110B,A00,187444,Staff,10,0,40,30
1683683460710,SE 130B,A00,187449,Staff,31,0,40,9
1683683461734,SE 150A,A00,187516,Staff,8,0,20,12
1683683462757,SE 154,A00,187528,Staff,29,0,50,21
1683683463783,SIO 3,A01,258171,Staff,35,0,40,5
1683683464810,SIO 10,A00,187144,Cook; Geoffrey W,1,7,75,74
1683683465834,SIO 45,A00,187152,Cook; Geoffrey W,0,7,100,100
1683683466860,SIO 109R,A00,194486,Staff,0,4,20,20
1683683468913,SIO 187,A01,187233,Kacev; David,12,0,40,28
1683683469937,SOCI 1,A01,258656,Thorpe; Charles Robert,28,0,30,2
1683683469937,SOCI 1,A02,258658,Thorpe; Charles Robert,30,0,30,0
1683683469937,SOCI 1,A03,258661,Thorpe; Charles Robert,25,0,25,0
1683683469937,SOCI 1,A04,258666,Thorpe; Charles Robert,22,0,25,3
1683683469937,SOCI 1,A05,258897,Thorpe; Charles Robert,22,0,25,3
1683683469937,SOCI 1,A06,258898,Thorpe; Charles Robert,25,0,25,0
1683683470962,SOCI 30,A01,258903,Pardo Guerra; Juan Pablo,14,0,30,16
1683683471987,SOCI 102,A00,258904,Staff,9,0,25,16
1683683473013,SOCI 106,A00,258905,Staff,19,0,25,6
1683683474041,SOCI 111,A00,258907,Ribas Norris; Janet Vanesa,26,0,30,4
1683683475066,SOCI 121R,A00,258908,Pardo Guerra; Juan Pablo,8,0,30,22
1683683476091,SOCI 126,A01,203330,Staff,14,0,20,6
1683683477121,SOCI 131,A00,258909,Thorpe; Charles Robert,30,0,60,30
1683683478144,SOCI 135,A00,258910,Payne; Christine Anna,0,12,30,30
1683683479170,SOCI 157,A00,258911,Staff,11,0,30,19
1683683480195,SOCI 184,A00,258912,Staff,25,0,30,5
1683683481223,SOCI 188D,A00,258913,Staff,22,0,30,8
1683683482251,SYN 2,001,187529,Staff,9,0,16,7
1683683482251,SYN 2,002,201452,Staff,1,20,16,15
1683683482251,SYN 2,003,201469,Staff,1,0,16,15
1683683483278,SYN 100,A01,187531,Staff,0,9,20,20
1683683483278,SYN 100,B01,201491,Staff,0,10,20,20
1683683484304,TDAC 1,A00,189286,Walsh; Kim C.,3,0,20,17
1683683484304,TDAC 1,B00,189287,Harting; Carla Kelso,10,0,20,10
1683683485330,TDAC 101,A00,189300,Walsh; Kim C.,16,0,20,4
1683683485330,TDAC 101,B00,189301,Harting; Carla Kelso,18,0,20,2
1683683486354,TDAC 102,A00,189304,Basso; Beatrice,14,0,20,6
1683683487377,TDAC 108,A00,189305,Staff,18,0,20,2
1683683488402,TDDE 131,A00,189310,Staff,19,0,20,1
1683683488402,TDDE 131,B00,189314,Staff,19,0,20,1
1683683488402,TDDE 131,C00,189315,Staff,48,0,50,2
1683683488402,TDDE 131,D00,189316,Staff,14,0,15,1
1683683488402,TDDE 131,E00,204841,Staff,20,0,20,0
1683683489427,TDGE 10,A00,189289,Staff,27,0,50,23
1683683489427,TDGE 10,B00,189290,Havis; Allan,0,1,50,50
1683683490453,TDGE 11,A00,189291,Fulton; Julia,0,4,50,50
1683683490453,TDGE 11,B00,189292,Staff,20,0,25,5
1683683490453,TDGE 11,C00,260270,Staff,0,0,0,0
1683683491477,TDGE 25,A00,189294,Staff,1,0,20,19
1683683492501,TDGE 124,A00,189318,Fulton; Julia,0,8,50,50
1683683493525,TDGE 125,A00,189319,Staff,13,0,25,12
1683683493525,TDGE 125,B00,189320,Staff,23,0,25,2
1683683494553,TDGE 127,A00,189322,Havis; Allan,0,0,50,50
1683683495578,TDHT 101,A00,189323,Staff,18,0,25,7
1683683495578,TDHT 101,B00,189324,Staff,25,0,25,0
1683683496605,TDHT 102,A00,189325,Staff,49,0,50,1
1683683497631,TDMV 1,A00,189295,Arcidiacono; Kristin,20,0,30,10
1683683497631,TDMV 1,B00,189296,Caligagan; Maria T.,24,0,30,6
1683683498657,TDMV 2,A00,189297,Sammartano; Tonnie,27,0,30,3
1683683498657,TDMV 2,B00,189299,Arcidiacono; Kristin,23,0,30,7
1683683499681,TDMV 3,A00,204998,Rincon; Alicia,22,0,30,8
1683683500706,TDMV 120,A00,189458,Sammartano; Tonnie,28,0,30,2
1683683501734,TDMV 138,A00,189541,Jun; Grace Shin Hae,20,0,40,20
1683683502759,TDMV 142,A00,189717,Caligagan; Tony,25,0,30,5
1683683502759,TDMV 142,B00,189718,Caligagan; Maria T.,25,0,30,5
1683683503785,TMC 2,A01,187533,Staff,25,0,25,0
1683683503785,TMC 2,A02,187534,Staff,25,0,25,0
1683683504810,USP 1,A01,187536,Kwak; Nancy,0,16,25,25
1683683505837,USP 5,A01,187538,Staff,8,0,25,17
1683683506862,USP 101,A00,199253,Staff,0,4,0,0
1683683507887,USP 124,A00,187562,Boomhower; Matthew Charles,0,0,30,30
1683683508910,USP 138,A00,187582,Staff,19,0,25,6
1683683509956,USP 152,A01,187597,Staff,3,0,25,22
1683683510983,USP 153,A00,187598,Staff,18,0,25,7
1683683512019,USP 168,A00,187607,Kwak; Nancy,2,0,5,3
1683683513044,USP 173,A00,187619,Staff,4,0,25,21
1683683514069,USP 181,A00,187638,Staff,0,4,25,25
1683683515095,VIS 103,A00,187650,Cruz; Edwin Teddy,17,0,75,58
1683683516119,VIS 110D,A00,187669,Staff,13,0,22,9
1683683517144,VIS 127C,A00,187720,Shen; Kuiyi,67,0,146,79
1683683518170,VIS 149,A00,187731,Yoldas; Pinar,1,14,22,21
1683683519194,VIS 151,A01,188091,Staff,22,0,34,12
1683683519194,VIS 151,A02,188092,Staff,11,0,34,23
1683683520218,VIS 160B,A00,188093,Stalbaum; Brett,0,1,10,10
1683683522268,WCWP 10B,A00,201720,Staff,0,0,5,5
1683683522268,WCWP 10B,B00,201722,Staff,0,0,6,6
1683683523295,WCWP 100,A00,201725,Gagnon; Jeffrey C,0,0,2,2
1683683523295,WCWP 100,B00,201727,Staff,0,4,15,15
1683683526425,ANBI 133,A00,258401,Wilder; Linnea Lorene,34,0,40,6
1683683527446,ANBI 140,A00,258395,Hrvoj Mihic; Branka,18,0,25,7
1683683528480,ANSC 120,A00,258402,Bialecki; Jon Anthony,26,0,40,14
1683683529507,ANSC 144,A00,258400,Staff,12,0,40,28
1683683531558,ANSC 166,A00,258396,Parish; Steven Martin,156,0,175,19
1683683532584,ANSC 180,A00,193533,Staff,8,0,20,12
1683683533611,ANSC 188,A00,258397,Jassal; Aftab,34,0,40,6
1683683534638,ANTH 3,A01,258316,Staff,23,0,30,7
1683683535663,ANTH 5,A00,258394,Semendeferi; Ekaterini,16,0,20,4
1683683536691,ANTH 21,A01,258331,Staff,4,0,40,36
1683683537718,ANTH 103,A00,258398,Varma; Saiba,15,0,25,10
1683683538748,AWP 10,001,202034,Staff,0,0,0,0
1683683538748,AWP 10,002,202035,Staff,0,0,0,0
1683683538748,AWP 10,003,202036,Staff,0,0,0,0
1683683538748,AWP 10,004,202037,Staff,0,0,0,0
1683683538748,AWP 10,005,202038,Staff,0,0,0,0
1683683538748,AWP 10,006,202039,Staff,0,0,0,0
1683683538748,AWP 10,007,202040,Staff,0,0,0,0
1683683538748,AWP 10,008,202041,Staff,0,0,0,0
1683683538748,AWP 10,009,202042,Staff,0,0,0,0
1683683538748,AWP 10,010,202043,Staff,0,0,0,0
1683683538748,AWP 10,011,202044,Staff,0,0,0,0
1683683538748,AWP 10,012,202045,Staff,0,0,0,0
1683683538748,AWP 10,013,202046,Staff,0,0,0,0
1683683538748,AWP 10,014,202047,Staff,0,0,0,0
1683683538748,AWP 10,015,202048,Staff,0,0,0,0
1683683538748,AWP 10,016,202049,Staff,0,0,0,0
1683683538748,AWP 10,017,202050,Staff,0,0,0,0
1683683538748,AWP 10,018,202051,Staff,0,0,0,0
1683683538748,AWP 10,019,202052,Staff,0,0,0,0
1683683538748,AWP 10,020,202053,Staff,0,0,0,0
1683683538748,AWP 10,021,202054,Staff,0,0,0,0
1683683538748,AWP 10,022,202055,Staff,0,0,0,0
1683683538748,AWP 10,023,202056,Staff,0,0,0,0
1683683538748,AWP 10,024,202057,Staff,0,0,0,0
1683683538748,AWP 10,025,202058,Staff,0,0,0,0
1683683538748,AWP 10,026,202059,Staff,0,0,0,0
1683683539772,AWP 102,001,202032,Staff,0,0,0,0
1683683539772,AWP 102,002,202033,Staff,0,0,0,0
1683683540799,BENG 100,A01,254234,Taylor Amos; Alyssa C,31,0,40,9
1683683541822,BENG 196,001,270013,Engler; Adam J.,9999,0,9999,0
1683683542852,BICD 100R,A01,202018,Smith; Laurie,0,7,32,32
1683683542852,BICD 100R,A02,202019,Smith; Laurie,0,3,32,32
1683683542852,BICD 100R,A03,202020,Smith; Laurie,0,1,32,32
1683683542852,BICD 100R,A04,202021,Smith; Laurie,6,0,32,26
1683683542852,BICD 100R,A05,202022,Smith; Laurie,10,0,32,22
1683683543959,BICD 136,A01,193242,Gustafson-Brown; Cindy,0,2,32,32
1683683543959,BICD 136,A02,193244,Gustafson-Brown; Cindy,13,0,32,19
1683683544983,BIEB 102,A01,193249,Butler; Shannon Rhey,1,1,32,31
1683683544983,BIEB 102,A02,193251,Butler; Shannon Rhey,0,0,32,32
1683683544983,BIEB 102,A03,193253,Butler; Shannon Rhey,0,0,32,32
1683683544983,BIEB 102,A04,193255,Butler; Shannon Rhey,13,0,32,19
1683683544983,BIEB 102,A05,193265,Butler; Shannon Rhey,25,0,32,7
1683683544983,BIEB 102,A06,193269,Butler; Shannon Rhey,13,0,32,19
1683683547036,BIEB 150,A01,193274,Staff,0,0,32,32
1683683547036,BIEB 150,A02,193285,Staff,24,0,32,8
1683683548060,BIEB 194,A00,193286,Kurle; Carolyn M.,19,0,32,13
1683683549089,BILD 1,A01,192291,Staff,15,0,32,17
1683683549089,BILD 1,A02,192292,Staff,30,0,32,2
1683683549089,BILD 1,B01,192520,Reuther; Keefe,0,1,0,0
1683683549089,BILD 1,B02,192532,Reuther; Keefe,0,1,0,0
1683683550114,BILD 3,A01,192556,Butler; Shannon Rhey,0,0,32,32
1683683550114,BILD 3,A02,192581,Butler; Shannon Rhey,0,1,32,32
1683683550114,BILD 3,A03,192611,Butler; Shannon Rhey,19,0,32,13
1683683550114,BILD 3,A04,192612,Butler; Shannon Rhey,24,0,32,8
1683683550114,BILD 3,A05,192613,Butler; Shannon Rhey,26,0,32,6
1683683550114,BILD 3,A06,192679,Butler; Shannon Rhey,27,0,32,5
1683683550114,BILD 3,A07,192682,Butler; Shannon Rhey,20,0,32,12
1683683551140,BILD 4,A01,192836,Reuther; Keefe,1,0,24,23
1683683551140,BILD 4,A02,193044,Reuther; Keefe,4,0,24,20
1683683552165,BILD 10,A01,193142,Gustafson-Brown; Cindy,29,0,32,3
1683683552165,BILD 10,A02,193149,Gustafson-Brown; Cindy,31,0,32,1
1683683553195,BIMM 100,A01,193301,Staff,0,6,32,32
1683683553195,BIMM 100,A02,193312,Staff,0,7,32,32
1683683553195,BIMM 100,A03,193323,Staff,0,10,32,32
1683683554221,BIMM 101,A01,193329,McDonnell; Lisa Marie,1,4,24,23
1683683554221,BIMM 101,A02,193339,McDonnell; Lisa Marie,1,4,24,23
1683683554221,BIMM 101,B01,193354,McDonnell; Lisa Marie,0,4,24,24
1683683554221,BIMM 101,B02,193357,McDonnell; Lisa Marie,0,3,24,24
1683683555245,BIMM 110,A01,193377,Tat; John,0,11,32,32
1683683555245,BIMM 110,A02,193378,Tat; John,0,11,32,32
1683683556271,BIMM 120,A01,206116,Staff,0,0,32,32
1683683556271,BIMM 120,A02,206117,Staff,7,0,32,25
1683683556271,BIMM 120,A03,206121,Staff,21,0,32,11
1683683557296,BIPN 100,A01,193393,Park; Ji Young,0,15,32,32
1683683557296,BIPN 100,A02,193402,Park; Ji Young,0,14,32,32
1683683557296,BIPN 100,A03,193413,Park; Ji Young,0,14,32,32
1683683557296,BIPN 100,A04,193414,Park; Ji Young,0,13,32,32
1683683558321,BIPN 102,A01,193429,Staff,0,0,32,32
1683683558321,BIPN 102,A02,193438,Staff,18,0,32,14
1683683559345,BIPN 106,A01,193450,Reyes Gonzalez; Catalina,0,2,40,40
1683683560375,BIPN 134,A01,193465,Cooke; James Edward,0,0,32,32
1683683560375,BIPN 134,A02,193474,Cooke; James Edward,25,0,32,7
1683683560375,BIPN 134,A03,193485,Cooke; James Edward,29,0,32,3
1683683560375,BIPN 134,A04,193486,Cooke; James Edward,20,0,32,12
1683683560375,BIPN 134,A05,193491,Cooke; James Edward,31,0,32,1
1683683560375,BIPN 134,A06,193501,Cooke; James Edward,30,0,32,2
1683683560375,BIPN 134,A07,193510,Cooke; James Edward,29,0,32,3
1683683562429,BISP 194,A00,222522,Staff,14,0,32,18
1683683563456,CAT 124,A01,202407,Staff,19,0,25,6
1683683564480,CAT 125,A00,202408,Marchisotto; Jennifer Anne,2,0,20,18
1683683565512,CAT 125R,A00,202409,Smith; Lauryn Alissa,0,11,20,20
1683683565512,CAT 125R,B00,202410,Morales; Celeste Georgianna,0,11,20,20
1683683565512,CAT 125R,C00,202411,Irwin; Matthew Joseph,0,12,20,20
1683683566536,CENG 15,A01,204712,Yang; Kesong,0,1,0,0
1683683567564,CENG 114,A00,202070,Jahed Motlagh; Zeinab,5,0,20,15
1683683568588,CGS 105,A00,185477,Wesling; Megan E.,24,0,40,16
1683683569616,CGS 106,A00,185494,Staff,11,0,22,11
1683683570641,CGS 108,A00,185495,Staff,14,0,20,6
1683683571667,CGS 114,A00,185496,Staff,13,0,18,5
1683683572690,CGS 119,A00,185501,Staff,15,0,20,5
1683683573717,CGS 120,A00,185511,Staff,12,0,20,8
1683683574742,CHEM 4,A01,184675,Bussey; Thomas J,97,0,100,3
1683683575768,CHEM 6A,A01,184677,Staff,32,0,60,28
1683683576795,CHEM 6B,A01,184679,Staff,63,0,100,37
1683683577820,CHEM 6C,A01,184681,Bussey; Thomas J,0,0,50,50
1683683577820,CHEM 6C,A02,184682,Bussey; Thomas J,32,0,50,18
1683683578850,CHEM 40A,A01,184684,Albizati; Kim F.,33,0,100,67
1683683579874,CHEM 40B,A01,184686,Albizati; Kim F.,0,22,100,100
1683683580898,CHEM 41B,A01,184690,Staff,51,0,100,49
1683683581929,COGS 3,A01,184715,Boyle; Mary E. T.,0,27,40,40
1683683582957,COGS 14B,A01,185172,Staff,0,14,38,38
1683683583985,COGS 18,A01,184736,Staff,14,0,80,66
1683683585009,COGS 100,A01,184932,Staff,0,8,73,73
1683683586033,COGS 101A,A01,184935,Staff,0,40,30,30
1683683587057,COGS 101B,A01,184944,Staff,0,2,30,30
1683683588082,COGS 101C,A01,184946,Staff,0,10,30,30
1683683589106,COGS 102A,A01,184951,Johnson; Christine M.,1,0,40,39
1683683590132,COGS 107B,A01,184953,Mooshagian; Eric Frederick,0,52,40,40
1683683591158,COGS 118B,A01,184959,Gupta; Anjum,0,50,40,40
1683683592182,COGS 153,A00,184961,Staff,0,16,30,30
1683683593205,COGS 177,A00,184962,Staff,1,21,30,29
1683683594233,COGS 187A,A01,184969,Boyle; Mary E. T.,0,19,40,40
1683683595261,COMM 10,A01,185174,Staff,0,5,25,25
1683683595261,COMM 10,A02,185189,Staff,0,2,25,25
1683683595261,COMM 10,A03,269821,Staff,0,1,0,0
1683683596292,COMM 100B,A02,185476,Staff,10,0,25,15
1683683596292,COMM 100B,A03,277340,Staff,25,0,25,0
1683683597316,COMM 100C,A01,185314,Staff,1,0,25,24
1683683597316,COMM 100C,A02,185327,Staff,17,0,25,8
1683683598341,COMM 110M,A00,185349,Staff,0,0,40,40
1683683599367,COMM 113T,A00,185352,Staff,25,0,40,15
1683683600396,COMM 114I,A00,185353,Staff,31,0,40,9
1683683601422,COMM 131,A00,185354,Staff,17,0,30,13
1683683602445,CSE 8A,A50,185358,Cao; Yingjun,0,46,10,10
1683683603470,CSE 8B,A01,185362,Staff,0,48,50,50
1683683604494,CSE 11,A01,185416,Cao; Yingjun,0,91,10,10
1683683605522,CSE 20,A01,185445,Briones; Jor-el Thomas Caparas,3,0,25,22
1683683606546,CSE 21,A01,185447,Staff,9,0,50,41
1683683607571,CSE 101,A01,185451,Staff,0,13,50,50
1683683607571,CSE 101,B01,185453,Jones; Miles E,0,14,50,50
1683683609626,CSE 141,A01,185458,Eldon; John,16,0,100,84
1683683610653,CSE 141L,A01,185461,Eldon; John,8,0,100,92
1683683611684,CSE 142,A01,185463,Staff,34,0,60,26
1683683611684,CSE 142,B01,201355,Staff,0,7,60,60
1683683612708,CSE 142L,A01,185470,Staff,34,0,60,26
1683683612708,CSE 142L,B01,201417,Staff,0,6,60,60
1683683613732,CSE 190,A00,201433,Staff,32,0,49,17
1683683614757,DOC 1,A01,259136,Strom; Megan C.,7,0,15,8
1683683614757,DOC 1,A02,259137,Strom; Megan C.,14,0,15,1
1683683614757,DOC 1,A03,259138,Strom; Megan C.,14,0,15,1
1683683614757,DOC 1,A04,259139,Strom; Megan C.,14,0,15,1
1683683615781,DOC 100D,A00,259140,Pass; Natalye Joann,14,0,25,11
1683683616808,DSGN 1,A01,184749,Rill; Bryan,0,26,30,30
1683683617835,DSGN 100,A01,185168,Staff,0,2,25,25
1683683618859,ECE 5,A01,185626,Morris; Karcher William,0,12,0,0
1683683619887,ECE 101,A01,185628,Staff,14,0,70,56
1683683620918,ECE 107,A01,185635,Baghdadchi; Saharnaz,0,0,20,20
1683683620918,ECE 107,A02,185638,Baghdadchi; Saharnaz,1,0,20,19
1683683621942,ECE 148,A01,185647,Silberman; Jack,0,0,16,16
1683683622966,ECON 1,A01,185537,Crane; Meredith Helen,54,0,70,16
1683683623990,ECON 3,A01,185549,Crane; Meredith Helen,30,0,70,40
1683683625017,ECON 4,A01,203354,Anderson; John Charles,0,5,10,10
1683683626039,ECON 100A,A01,185574,Staff,0,5,40,40
1683683627063,ECON 100B,A01,185576,Staff,0,12,50,50
1683683628087,ECON 100C,A01,185589,Newhouse; Herbert S,30,0,70,40
1683683629112,ECON 105,A00,185608,Vespa; Emanuel Ignacio,19,0,35,16
1683683630136,ECON 109,A01,185610,Shishkin; Denis,9,0,35,26
1683683631164,ECON 110A,A01,185612,Staff,9,0,40,31
1683683632191,ECON 120A,A01,185615,Staff,19,0,40,21
1683683633214,ECON 120C,A01,185617,Sun; Yixiao,0,21,70,70
1683683634238,ECON 144,A00,203346,Squires; Dale E,2,0,35,33
1683683635391,ECON 171,A01,203349,Newhouse; Herbert S,0,1,35,35
1683683636416,ECON 173A,A01,185621,Toda; Alexis Akira,21,0,35,14
1683683637447,EDS 25,A01,202413,Staff,0,1,0,0
1683683637447,EDS 25,A02,202414,Staff,0,1,0,0
1683683637447,EDS 25,A03,202415,Staff,0,0,0,0
1683683637447,EDS 25,A04,202416,Staff,0,1,0,0
1683683637447,EDS 25,A05,202439,Staff,0,0,0,0
1683683637447,EDS 25,A06,202440,Staff,0,0,0,0
1683683637447,EDS 25,B01,202631,Staff,0,0,0,0
1683683637447,EDS 25,B02,202632,Staff,0,0,0,0
1683683637447,EDS 25,B03,202639,Staff,0,0,0,0
1683683637447,EDS 25,B04,202640,Staff,0,0,0,0
1683683637447,EDS 25,B05,202643,Staff,0,0,0,0
1683683637447,EDS 25,B06,202644,Staff,0,0,0,0
1683683638475,EDS 38,A01,202659,Black; Alison Michelle,24,0,25,1
1683683639499,EDS 115,A00,202652,Staff,18,0,30,12
1683683640522,EDS 125,A00,202649,Staff,13,0,30,17
1683683641547,EDS 126,A01,203332,Staff,30,0,30,0
1683683642572,EDS 139,A00,202838,Staff,16,0,25,9
1683683643596,EDS 146,A01,202655,Staff,14,0,25,11
1683683644621,ENG 15,A00,185667,Staff,0,1,0,0
1683683644621,ENG 15,B00,185672,Staff,0,0,0,0
1683683644621,ENG 15,C00,185675,Staff,0,0,0,0
1683683644621,ENG 15,D00,185682,Staff,0,0,0,0
1683683644621,ENG 15,E00,185684,Staff,0,0,0,0
1683683645644,ETHN 103,A00,185710,Staff,0,8,35,35
1683683646672,ETHN 103A,A00,199228,Man; Simeon S,0,0,9,9
1683683647753,ETHN 109,A00,185711,Staff,15,0,35,20
1683683648777,ETHN 142,A00,185726,Staff,0,4,30,30
1683683649807,ETHN 163J,A00,199229,Man; Simeon S,5,0,8,3
1683683650830,ETHN 168,A00,185727,Staff,7,0,10,3
1683683651856,ETHN 182,A00,185728,Staff,0,0,35,35
1683683652880,ETHN 183,A00,185737,Staff,9,0,18,9
1683683653906,GLBH 111,A01,209361,Burgos; Jose L.,0,0,0,0
1683683655959,HIEU 104,A00,185792,Staff,14,0,20,6
1683683656982,HIEU 115,A00,185800,Staff,0,0,20,20
1683683658009,HIEU 128,A00,185801,Staff,0,9,20,20
1683683659042,HIEU 147,A00,185802,Staff,15,0,20,5
1683683660065,HIEU 154,A00,185823,Staff,11,0,20,9
1683683661089,HILA 102,A00,185826,Staff,14,0,20,6
1683683662115,HILD 2C,A01,185778,Staff,0,13,20,20
1683683663142,HILD 7B,A01,185780,Kwak; Nancy,0,17,32,32
1683683663142,HILD 7B,A02,185781,Kwak; Nancy,0,18,32,32
1683683664169,HILD 30,A01,185791,Staff,12,0,20,8
1683683665195,HISC 119,A00,185830,Golan; Tal,0,10,20,20
1683683666219,HITO 156GS,A00,185831,Patterson; Patrick H.,0,0,0,23
1683683667246,HIUS 103,A00,185832,Man; Simeon S,0,4,20,20
1683683668268,HIUS 117,A00,185836,Kwak; Nancy,2,0,20,18
1683683669292,HIUS 125,A00,185840,Man; Simeon S,0,2,23,23
1683683670316,HIUS 149,A00,185845,Staff,1,0,20,19
1683683671344,HUM 3,A01,185882,Zavodny; Tatiana Sophia,0,8,50,50
1683683671344,HUM 3,B01,185899,Caldwell; Michael Alan,0,18,50,50
1683683672368,HUM 3GS,A00,185900,Patterson; Patrick H.,0,0,0,23
1683683673396,HUM 4,A01,185938,Zroka; Amy Liane,28,0,50,22
1683683673396,HUM 4,B01,185956,Watkins; Eric,0,6,50,50
1683683673396,HUM 4,B02,202209,Watkins; Eric,0,5,50,50
1683683673396,HUM 4,B03,202210,Watkins; Eric,0,5,50,50
1683683674421,HUM 5,A01,185958,West; Geoffrey Scott,0,0,50,50
1683683674421,HUM 5,A02,202215,West; Geoffrey Scott,0,0,50,50
1683683675448,INTL 190,A00,185959,Gagnon; Jeffrey C,0,0,0,9
1683683675448,INTL 190,B00,185960,Lettieri; Michael Joseph,0,0,0,2
1683683676475,JAPN 180,A00,254509,Staff,5,0,30,25
1683683677500,LATI 10,A01,202853,Kennemore; Amy Michelle,4,0,35,31
1683683677500,LATI 10,A02,202854,Kennemore; Amy Michelle,3,0,35,32
1683683677500,LATI 10,A03,270054,Kennemore; Amy Michelle,30,0,30,0
1683683678525,LATI 180,A00,202855,Kennemore; Amy Michelle,11,0,20,9
1683683679553,LAWS 101,A00,201767,Golan; Tal,0,7,40,40
1683683680578,LIFR 1C,A00,185961,Staff,6,0,20,14
1683683681605,LIFR 1CX,A00,185962,Staff,7,0,20,13
1683683682630,LIFR 1D,A00,185963,Staff,7,0,20,13
1683683683657,LIFR 1DX,A00,185964,Staff,7,0,20,13
1683683684682,LIGN 101,A01,186039,Staff,43,0,50,7
1683683685706,LIGN 165,A00,186040,Staff,15,0,50,35
1683683686730,LTCS 108,A00,186041,Staff,5,0,10,5
1683683687755,LTCS 119,A00,186042,Staff,15,0,20,5
1683683688779,LTCS 130,A00,186043,Wesling; Megan E.,15,0,25,10
1683683690827,LTEA 138,A00,186119,Staff,14,0,40,26
1683683691855,LTEN 124,A00,186148,Staff,5,0,25,20
1683683692881,LTEN 178,A00,186149,Staff,6,0,15,9
1683683693906,LTEN 181,A00,186150,Blanco; John D,34,0,40,6
1683683694931,LTWL 120,A00,186160,Staff,19,0,25,6
1683683695958,LTWL 165,A00,186161,Staff,22,0,25,3
1683683696983,LTWR 100,A00,186162,Staff,0,5,15,15
1683683698009,LTWR 102,A00,186163,Doller; Ben,5,0,15,10
1683683699034,MAE 8,A01,186412,Staff,0,1,0,0
1683683700058,MAE 30B,A00,186445,Bahadori; Mohammad Yousef,81,0,100,19
1683683701089,MAE 40,A00,186592,Bewley; Thomas R,10,0,50,40
1683683702114,MAE 101B,A00,186593,Bahadori; Mohammad Yousef,80,0,100,20
1683683703146,MAE 105,A00,186594,Bandaru; Prabhakar,10,0,50,40
1683683704172,MAE 107,A00,186599,Pham; Hieu Tan,0,7,120,120
1683683705197,MAE 148,A01,186660,Silberman; Jack,3,0,16,13
1683683706221,MATH 10A,A01,188095,Staff,0,6,35,35
1683683707244,MATH 10B,A01,188097,Bowers; Adam R.,0,12,30,30
1683683707244,MATH 10B,A02,188099,Bowers; Adam R.,0,11,30,30
1683683707244,MATH 10B,B01,188104,Bowers; Adam R.,0,10,30,30
1683683707244,MATH 10B,B02,188106,Bowers; Adam R.,1,9,30,29
1683683708272,MATH 10C,A01,188111,Staff,0,20,30,30
1683683708272,MATH 10C,A02,188127,Staff,0,19,30,30
1683683708272,MATH 10C,A03,188131,Staff,0,19,30,30
1683683708272,MATH 10C,B01,188218,Staff,17,0,30,13
1683683708272,MATH 10C,B02,188244,Staff,13,0,30,17
1683683708272,MATH 10C,B03,188277,Staff,14,0,30,16
1683683709296,MATH 18,A01,188344,Bach; Quang Tran,18,0,30,12
1683683709296,MATH 18,A02,188345,Bach; Quang Tran,11,0,30,19
1683683709296,MATH 18,B01,188353,Bach; Quang Tran,11,0,30,19
1683683709296,MATH 18,B02,188354,Bach; Quang Tran,19,0,30,11
1683683710322,MATH 20A,A01,188374,Staff,11,0,35,24
1683683711345,MATH 20B,A01,188382,Ohm; Ko Woon,7,0,30,23
1683683711345,MATH 20B,A02,188383,Ohm; Ko Woon,22,0,30,8
1683683711345,MATH 20B,B01,188385,Ohm; Ko Woon,7,0,30,23
1683683711345,MATH 20B,B02,188392,Ohm; Ko Woon,22,0,30,8
1683683712373,MATH 20C,A01,188394,Harel; Guershon,10,0,30,20
1683683712373,MATH 20C,A02,188395,Harel; Guershon,13,0,30,17
1683683712373,MATH 20C,B01,188404,Harel; Guershon,5,0,30,25
1683683712373,MATH 20C,B02,188405,Harel; Guershon,18,0,30,12
1683683713397,MATH 20D,A01,188414,Hammock; Frances H,0,1,30,30
1683683713397,MATH 20D,A02,188415,Hammock; Frances H,0,1,30,30
1683683713397,MATH 20D,B01,188447,Hammock; Frances H,0,1,30,30
1683683713397,MATH 20D,B02,188486,Hammock; Frances H,3,0,30,27
1683683714425,MATH 20E,A01,188649,Staff,21,0,30,9
1683683714425,MATH 20E,A02,188650,Staff,20,0,30,10
1683683714425,MATH 20E,A03,188673,Staff,0,0,30,30
1683683715450,MATH 102,A01,188675,Staff,0,39,35,35
1683683716475,MATH 103B,A01,188681,Staff,3,0,35,32
1683683716475,MATH 103B,B01,188692,Staff,5,0,35,30
1683683717503,MATH 109,A01,188695,Salehi Golsefidy; Alireza,24,0,35,11
1683683717503,MATH 109,A02,188696,Salehi Golsefidy; Alireza,25,0,35,10
1683683718528,MATH 120A,A01,188698,Eggers; John Dietrich,7,0,35,28
1683683719552,MATH 142B,A01,188736,Ioana; Adrian,1,1,30,29
1683683719552,MATH 142B,A02,188741,Ioana; Adrian,0,1,30,30
1683683719552,MATH 142B,A03,188743,Ioana; Adrian,0,1,30,30
1683683720573,MATH 168A,A01,188790,Staff,0,11,35,35
1683683721602,MATH 170A,A01,188803,Nie; Jiawang,0,2,35,35
1683683721602,MATH 170A,A02,188811,Nie; Jiawang,0,1,35,35
1683683721602,MATH 170A,A03,188814,Nie; Jiawang,0,0,35,35
1683683721602,MATH 170A,A04,188815,Nie; Jiawang,6,0,35,29
1683683722627,MATH 193B,A01,188817,Staff,0,0,35,35
1683683722627,MATH 193B,A02,188818,Staff,5,0,35,30
1683683723654,MGT 4,A01,202857,Anderson; John Charles,59,0,80,21
1683683724680,MGT 12,A00,202858,Lindenberger; Wade Douglas,40,0,90,50
1683683725706,MGT 18,A00,202859,Staff,74,0,90,16
1683683726730,MGT 18GS,A00,202860,McKay; Michael J,13,0,28,15
1683683727756,MGT 45,A00,202861,Pecore; Joseph P.,8,0,90,82
1683683728780,MGT 100,A00,202863,Yavorsky; Daniel Ryan,28,0,90,62
1683683729808,MGT 103,A00,202864,Ehrich; Kristine R,0,19,90,90
1683683730831,MGT 112,A00,202865,Ehrich; Kristine R,15,0,90,75
1683683731855,MGT 121A,A00,202868,Staff,90,20,90,0
1683683732878,MGT 131B,A00,202869,Anderson; John Charles,59,0,90,31
1683683733903,MGT 136,A00,202871,Lindenberger; Wade Douglas,83,0,90,7
1683683734929,MGT 164,A00,202873,Staff,0,68,90,91
1683683735956,MGT 164GS,A00,202874,McKay; Mary A,13,0,28,15
1683683736983,MGT 180,A00,202875,Staff,0,51,90,91
1683683738008,MMW 11R,A01,205019,Herbst; Matthew,0,0,30,30
1683683738008,MMW 11R,A02,205026,Herbst; Matthew,29,0,30,1
1683683739038,MMW 15,A01,193512,Chang; Edmond Yi-Teh,0,8,28,28
1683683739038,MMW 15,A02,193513,Chang; Edmond Yi-Teh,0,5,28,28
1683683739038,MMW 15,A03,193514,Chang; Edmond Yi-Teh,0,5,28,28
1683683739038,MMW 15,A04,193515,Chang; Edmond Yi-Teh,0,5,28,28
1683683739038,MMW 15,A05,193516,Chang; Edmond Yi-Teh,0,5,28,28
1683683739038,MMW 15,A06,193517,Chang; Edmond Yi-Teh,0,6,28,28
1683683739038,MMW 15,B01,193519,Chang; Edmond Yi-Teh,0,5,28,28
1683683739038,MMW 15,B02,193520,Chang; Edmond Yi-Teh,0,5,28,28
1683683739038,MMW 15,B03,193521,Chang; Edmond Yi-Teh,0,5,28,28
1683683739038,MMW 15,B04,193522,Chang; Edmond Yi-Teh,0,6,28,28
1683683739038,MMW 15,B05,193523,Chang; Edmond Yi-Teh,0,5,28,28
1683683739038,MMW 15,B06,193524,Chang; Edmond Yi-Teh,0,5,28,28
1683683740076,MMW 122,A01,193526,Rahimi; Babak,0,16,28,28
1683683740076,MMW 122,A02,193527,Rahimi; Babak,0,15,28,28
1683683740076,MMW 122,A03,193528,Rahimi; Babak,0,0,0,0
1683683740076,MMW 122,A04,193529,Rahimi; Babak,0,0,0,0
1683683741099,MUS 1A,A01,186663,Staff,1,19,35,34
1683683742121,MUS 4,A01,186715,Staff,0,12,35,35
1683683743148,MUS 5R,A01,186796,Dubnov; Shlomo,0,17,35,35
1683683744171,MUS 6,A01,186798,Staff,1,5,25,24
1683683745195,MUS 7,A01,186830,Staff,11,0,35,24
1683683746222,MUS 8,A01,186930,Staff,0,27,35,35
1683683747246,MUS 15,A01,186932,Staff,0,15,35,35
1683683747246,MUS 15,B01,186934,Staff,1,17,35,34
1683683748271,MUS 80,A00,186935,Staff,0,0,20,20
1683683748271,MUS 80,B00,186936,Staff,24,0,25,1
1683683749294,NANO 11,A00,204702,Lipomi; Darren John,0,0,0,0
1683683750319,NANO 15,A01,204709,Yang; Kesong,0,1,0,0
1683683751418,NANO 114,A00,202069,Jahed Motlagh; Zeinab,3,0,10,7
1683683752446,PHIL 1,A00,186955,Grush; Rick Scott,31,0,40,9
1683683753469,PHIL 10,A01,186973,Grush; Rick Scott,27,0,35,8
1683683753469,PHIL 10,A02,186974,Grush; Rick Scott,33,0,35,2
1683683754496,PHIL 13,A01,186976,Staff,1,0,35,34
1683683754496,PHIL 13,A02,186977,Staff,16,0,35,19
1683683755523,PHIL 14,A01,186979,Staff,31,0,35,4
1683683755523,PHIL 14,A02,186986,Staff,32,0,35,3
1683683756548,PHIL 28,A01,186988,Staff,16,0,30,14
1683683756548,PHIL 28,A02,186989,Staff,1,0,30,29
1683683756548,PHIL 28,A03,186990,Staff,10,0,30,20
1683683756548,PHIL 28,A04,186991,Staff,26,0,30,4
1683683757573,PHIL 120,A00,186997,Staff,23,0,40,17
1683683758598,PHIL 137,A00,187003,Staff,7,0,40,33
1683683759626,PHIL 150,A00,187015,Staff,47,0,70,23
1683683760653,PHIL 167,A00,187021,Lamey; Andy M.,34,0,40,6
1683683761677,PHIL 174,A01,202226,Staff,17,0,20,3
1683683761677,PHIL 174,A02,202235,Staff,20,0,20,0
1683683762704,PHIL 191A,A00,258918,Staff,0,0,1,1
1683683763731,PHYS 1A,A00,187028,Staff,26,0,60,34
1683683764755,PHYS 1AL,001,187036,Staff,3,0,30,27
1683683764755,PHYS 1AL,002,187049,Staff,18,0,30,12
1683683765779,PHYS 1B,A00,187058,Staff,22,0,60,38
1683683766806,PHYS 1BL,001,187064,Staff,0,1,30,30
1683683766806,PHYS 1BL,002,187070,Staff,4,0,30,26
1683683767831,PHYS 1C,A00,187082,Staff,29,0,120,91
1683683768857,PHYS 1CL,001,187088,Staff,0,9,30,30
1683683768857,PHYS 1CL,002,187089,Staff,0,1,30,30
1683683768857,PHYS 1CL,009,262693,Staff,9,0,30,21
1683683769883,PHYS 2B,A01,187097,Staff,55,0,115,60
1683683770910,PHYS 2C,A01,187099,Staff,63,0,115,52
1683683771939,PHYS 2CL,A01,187101,Staff,5,0,28,23
1683683771939,PHYS 2CL,A02,187102,Staff,15,0,28,13
1683683772963,PHYS 2D,A01,187123,Shotwell; Brian,95,0,115,20
1683683773990,PHYS 4B,A01,187133,Grinstein; Benjamin,35,0,50,15
1683683775014,POLI 10,A00,188819,Staff,0,4,50,50
1683683776038,POLI 11,A00,188827,Staff,43,0,50,7
1683683777065,POLI 13R,A00,188828,Staff,0,1,20,20
1683683778090,POLI 27,A01,188830,Elgin; Samuel Zincke,0,2,70,70
1683683779116,POLI 30,A00,188832,Desposato; Scott,30,0,50,20
1683683780142,POLI 102F,A00,188834,Staff,1,0,40,39
1683683781170,POLI 104A,A00,188852,Staff,12,0,30,18
1683683782192,POLI 104I,A00,188853,Staff,0,8,20,20
1683683783216,POLI 110B,A00,188854,Wiens; David,6,0,20,14
1683683784244,POLI 112A,A00,188855,Wiens; David,3,0,30,27
1683683785270,POLI 117R,A00,188856,Forman; Fonna,0,12,20,20
1683683786297,POLI 118,A00,188857,Ingham; Sean,8,0,20,12
1683683787321,POLI 120G,A00,188858,Staff,8,0,30,22
1683683788345,POLI 131CR,A00,188863,Hoston; Germaine,20,0,50,30
1683683789369,POLI 133,A00,188864,Nellis; Gareth Hb,44,0,50,6
1683683790396,POLI 134D,A00,188865,Desposato; Scott,27,0,30,3
1683683791420,POLI 142A,A00,188871,Gartzke; Erik,21,0,50,29
1683683792444,POLI 142K,A00,188874,Staff,38,0,50,12
1683683793469,POLI 143,A00,188940,Gartzke; Erik,16,0,30,14
1683683794494,POLI 153,A00,188943,Staff,2,0,20,18
1683683795517,POLI 160AA,A00,188944,Staff,10,0,40,30
1683683796543,POLI 170A,A00,188945,Staff,10,0,30,20
1683683798593,PSYC 1,A00,188952,Staff,36,0,90,54
1683683799618,PSYC 2,B00,188953,Staff,19,0,35,16
1683683800645,PSYC 6,A00,188970,Staff,47,0,60,13
1683683801672,PSYC 7,A00,188973,Staff,35,0,45,10
1683683802699,PSYC 60,A01,188980,Rickard; Timothy C.,42,0,60,18
1683683803731,PSYC 70,A01,189001,Steiner; Eric Tomas,21,0,45,24
1683683804759,PSYC 100,A00,189005,Lacefield; Katharine I,0,99,120,120
1683683805787,PSYC 102,A00,189008,Staff,7,0,30,23
1683683806817,PSYC 106,B00,189026,Gorman; Michael R.,27,0,60,33
1683683807845,PSYC 114,B01,189033,Winkielman; Piotr,0,31,30,30
1683683808873,PSYC 131,A00,189036,Anagnostaras; Stephan,0,43,60,60
1683683809897,PSYC 136,A00,189041,Lowe; Angela Beth,0,7,25,25
1683683810923,PSYC 137,A00,189057,Winkielman; Piotr,1,37,25,24
1683683811947,PSYC 144,A00,189107,Wixted; John T,0,11,50,50
1683683813998,PSYC 162,A00,189142,Staff,0,9,85,85
1683683815021,PSYC 172,A00,189144,Gorman; Michael R.,0,6,30,30
1683683817072,PSYC 179,A00,189146,Lacefield; Katharine I,0,87,120,120
1683683818096,PSYC 181,A00,189147,Anagnostaras; Stephan,0,44,90,90
1683683819124,PSYC 190R,A00,189148,Barner; David A.,0,23,80,80
1683683820148,PSYC 191,A00,189275,Rickard; Timothy C.,0,10,25,25
1683683821176,PSYC 193,A00,189276,Chapman; Eddie Nathaniel,0,1,0,4
1683683822201,PSYC 193L,A01,189281,Lowe; Angela Beth,8,0,20,12
1683683822201,PSYC 193L,B01,189285,Staff,28,0,35,7
1683683823226,RELI 149,A00,187137,Rahimi; Babak,7,0,40,33
1683683824253,SE 9,A01,187315,Staff,0,2,18,18
1683683825281,SE 101B,A00,187409,Staff,24,0,30,6
1683683826307,SE 110B,A00,187444,Staff,10,0,40,30
1683683827334,SE 130B,A00,187449,Staff,31,0,40,9
1683683828359,SE 150A,A00,187516,Staff,8,0,20,12
1683683829384,SE 154,A00,187528,Staff,29,0,50,21
1683683830410,SIO 3,A01,258171,Staff,35,0,40,5
1683683831435,SIO 10,A00,187144,Cook; Geoffrey W,1,7,75,74
1683683832460,SIO 45,A00,187152,Cook; Geoffrey W,0,7,100,100
1683683833484,SIO 109R,A00,194486,Staff,0,4,20,20
1683683835535,SIO 187,A01,187233,Kacev; David,12,0,40,28
1683683836560,SOCI 1,A01,258656,Thorpe; Charles Robert,28,0,30,2
1683683836560,SOCI 1,A02,258658,Thorpe; Charles Robert,30,0,30,0
1683683836560,SOCI 1,A03,258661,Thorpe; Charles Robert,25,0,25,0
1683683836560,SOCI 1,A04,258666,Thorpe; Charles Robert,22,0,25,3
1683683836560,SOCI 1,A05,258897,Thorpe; Charles Robert,22,0,25,3
1683683836560,SOCI 1,A06,258898,Thorpe; Charles Robert,25,0,25,0
1683683837584,SOCI 30,A01,258903,Pardo Guerra; Juan Pablo,14,0,30,16
1683683838611,SOCI 102,A00,258904,Staff,9,0,25,16
1683683839638,SOCI 106,A00,258905,Staff,19,0,25,6
1683683840661,SOCI 111,A00,258907,Ribas Norris; Janet Vanesa,26,0,30,4
1683683841685,SOCI 121R,A00,258908,Pardo Guerra; Juan Pablo,8,0,30,22
1683683842712,SOCI 126,A01,203330,Staff,14,0,20,6
1683683843736,SOCI 131,A00,258909,Thorpe; Charles Robert,30,0,60,30
1683683844759,SOCI 135,A00,258910,Payne; Christine Anna,0,12,30,30
1683683845783,SOCI 157,A00,258911,Staff,11,0,30,19
1683683846810,SOCI 184,A00,258912,Staff,25,0,30,5
1683683847836,SOCI 188D,A00,258913,Staff,22,0,30,8
1683683848860,SYN 2,001,187529,Staff,9,0,16,7
1683683848860,SYN 2,002,201452,Staff,1,20,16,15
1683683848860,SYN 2,003,201469,Staff,1,0,16,15
1683683849889,SYN 100,A01,187531,Staff,0,9,20,20
1683683849889,SYN 100,B01,201491,Staff,0,10,20,20
1683683850914,TDAC 1,A00,189286,Walsh; Kim C.,3,0,20,17
1683683850914,TDAC 1,B00,189287,Harting; Carla Kelso,10,0,20,10
1683683851941,TDAC 101,A00,189300,Walsh; Kim C.,16,0,20,4
1683683851941,TDAC 101,B00,189301,Harting; Carla Kelso,18,0,20,2
1683683852966,TDAC 102,A00,189304,Basso; Beatrice,14,0,20,6
1683683853990,TDAC 108,A00,189305,Staff,18,0,20,2
1683683855071,TDDE 131,A00,189310,Staff,19,0,20,1
1683683855071,TDDE 131,B00,189314,Staff,19,0,20,1
1683683855071,TDDE 131,C00,189315,Staff,48,0,50,2
1683683855071,TDDE 131,D00,189316,Staff,14,0,15,1
1683683855071,TDDE 131,E00,204841,Staff,20,0,20,0
1683683856099,TDGE 10,A00,189289,Staff,27,0,50,23
1683683856099,TDGE 10,B00,189290,Havis; Allan,0,1,50,50
1683683857125,TDGE 11,A00,189291,Fulton; Julia,0,4,50,50
1683683857125,TDGE 11,B00,189292,Staff,20,0,25,5
1683683857125,TDGE 11,C00,260270,Staff,0,0,0,0
1683683858152,TDGE 25,A00,189294,Staff,1,0,20,19
1683683859179,TDGE 124,A00,189318,Fulton; Julia,0,8,50,50
1683683860205,TDGE 125,A00,189319,Staff,13,0,25,12
1683683860205,TDGE 125,B00,189320,Staff,23,0,25,2
1683683861230,TDGE 127,A00,189322,Havis; Allan,0,0,50,50
1683683862252,TDHT 101,A00,189323,Staff,18,0,25,7
1683683862252,TDHT 101,B00,189324,Staff,25,0,25,0
1683683863277,TDHT 102,A00,189325,Staff,49,0,50,1
1683683864303,TDMV 1,A00,189295,Arcidiacono; Kristin,20,0,30,10
1683683864303,TDMV 1,B00,189296,Caligagan; Maria T.,24,0,30,6
1683683865328,TDMV 2,A00,189297,Sammartano; Tonnie,27,0,30,3
1683683865328,TDMV 2,B00,189299,Arcidiacono; Kristin,23,0,30,7
1683683866352,TDMV 3,A00,204998,Rincon; Alicia,22,0,30,8
1683683867379,TDMV 120,A00,189458,Sammartano; Tonnie,28,0,30,2
1683683868404,TDMV 138,A00,189541,Jun; Grace Shin Hae,20,0,40,20
1683683869428,TDMV 142,A00,189717,Caligagan; Tony,25,0,30,5
1683683869428,TDMV 142,B00,189718,Caligagan; Maria T.,25,0,30,5
1683683870455,TMC 2,A01,187533,Staff,25,0,25,0
1683683870455,TMC 2,A02,187534,Staff,25,0,25,0
1683683871484,USP 1,A01,187536,Kwak; Nancy,0,16,25,25
1683683872508,USP 5,A01,187538,Staff,8,0,25,17
1683683873534,USP 101,A00,199253,Staff,0,4,0,0
1683683874562,USP 124,A00,187562,Boomhower; Matthew Charles,0,0,30,30
1683683875590,USP 138,A00,187582,Staff,19,0,25,6
1683683876615,USP 152,A01,187597,Staff,3,0,25,22
1683683877639,USP 153,A00,187598,Staff,18,0,25,7
1683683878663,USP 168,A00,187607,Kwak; Nancy,2,0,5,3
1683683879686,USP 173,A00,187619,Staff,4,0,25,21
1683683880710,USP 181,A00,187638,Staff,0,4,25,25
1683683881737,VIS 103,A00,187650,Cruz; Edwin Teddy,17,0,75,58
1683683882762,VIS 110D,A00,187669,Staff,13,0,22,9
1683683883788,VIS 127C,A00,187720,Shen; Kuiyi,67,0,146,79
1683683884812,VIS 149,A00,187731,Yoldas; Pinar,1,14,22,21
1683683885837,VIS 151,A01,188091,Staff,22,0,34,12
1683683885837,VIS 151,A02,188092,Staff,11,0,34,23
1683683886865,VIS 160B,A00,188093,Stalbaum; Brett,0,1,10,10
1683683888917,WCWP 10B,A00,201720,Staff,0,0,5,5
1683683888917,WCWP 10B,B00,201722,Staff,0,0,6,6
1683683889942,WCWP 100,A00,201725,Gagnon; Jeffrey C,0,0,2,2
1683683889942,WCWP 100,B00,201727,Staff,0,4,15,15
1683683893089,ANBI 133,A00,258401,Wilder; Linnea Lorene,34,0,40,6
1683683894113,ANBI 140,A00,258395,Hrvoj Mihic; Branka,18,0,25,7
1683683895141,ANSC 120,A00,258402,Bialecki; Jon Anthony,26,0,40,14
1683683896167,ANSC 144,A00,258400,Staff,12,0,40,28
1683683898217,ANSC 166,A00,258396,Parish; Steven Martin,156,0,175,19
1683683899242,ANSC 180,A00,193533,Staff,8,0,20,12
1683683900270,ANSC 188,A00,258397,Jassal; Aftab,34,0,40,6
1683683901295,ANTH 3,A01,258316,Staff,23,0,30,7
1683683902318,ANTH 5,A00,258394,Semendeferi; Ekaterini,16,0,20,4
1683683903346,ANTH 21,A01,258331,Staff,4,0,40,36
1683683904373,ANTH 103,A00,258398,Varma; Saiba,15,0,25,10
1683683905400,AWP 10,001,202034,Staff,0,0,0,0
1683683905400,AWP 10,002,202035,Staff,0,0,0,0
1683683905400,AWP 10,003,202036,Staff,0,0,0,0
1683683905400,AWP 10,004,202037,Staff,0,0,0,0
1683683905400,AWP 10,005,202038,Staff,0,0,0,0
1683683905400,AWP 10,006,202039,Staff,0,0,0,0
1683683905400,AWP 10,007,202040,Staff,0,0,0,0
1683683905400,AWP 10,008,202041,Staff,0,0,0,0
1683683905400,AWP 10,009,202042,Staff,0,0,0,0
1683683905400,AWP 10,010,202043,Staff,0,0,0,0
1683683905400,AWP 10,011,202044,Staff,0,0,0,0
1683683905400,AWP 10,012,202045,Staff,0,0,0,0
1683683905400,AWP 10,013,202046,Staff,0,0,0,0
1683683905400,AWP 10,014,202047,Staff,0,0,0,0
1683683905400,AWP 10,015,202048,Staff,0,0,0,0
1683683905400,AWP 10,016,202049,Staff,0,0,0,0
1683683905400,AWP 10,017,202050,Staff,0,0,0,0
1683683905400,AWP 10,018,202051,Staff,0,0,0,0
1683683905400,AWP 10,019,202052,Staff,0,0,0,0
1683683905400,AWP 10,020,202053,Staff,0,0,0,0
1683683905400,AWP 10,021,202054,Staff,0,0,0,0
1683683905400,AWP 10,022,202055,Staff,0,0,0,0
1683683905400,AWP 10,023,202056,Staff,0,0,0,0
1683683905400,AWP 10,024,202057,Staff,0,0,0,0
1683683905400,AWP 10,025,202058,Staff,0,0,0,0
1683683905400,AWP 10,026,202059,Staff,0,0,0,0
1683683906427,AWP 102,001,202032,Staff,0,0,0,0
1683683906427,AWP 102,002,202033,Staff,0,0,0,0
1683683907456,BENG 100,A01,254234,Taylor Amos; Alyssa C,31,0,40,9
1683683908480,BENG 196,001,270013,Engler; Adam J.,9999,0,9999,0
1683683909510,BICD 100R,A01,202018,Smith; Laurie,0,7,32,32
1683683909510,BICD 100R,A02,202019,Smith; Laurie,0,3,32,32
1683683909510,BICD 100R,A03,202020,Smith; Laurie,0,1,32,32
1683683909510,BICD 100R,A04,202021,Smith; Laurie,6,0,32,26
1683683909510,BICD 100R,A05,202022,Smith; Laurie,10,0,32,22
1683683910535,BICD 136,A01,193242,Gustafson-Brown; Cindy,0,2,32,32
1683683910535,BICD 136,A02,193244,Gustafson-Brown; Cindy,13,0,32,19
1683683911565,BIEB 102,A01,193249,Butler; Shannon Rhey,1,1,32,31
1683683911565,BIEB 102,A02,193251,Butler; Shannon Rhey,0,0,32,32
1683683911565,BIEB 102,A03,193253,Butler; Shannon Rhey,0,0,32,32
1683683911565,BIEB 102,A04,193255,Butler; Shannon Rhey,13,0,32,19
1683683911565,BIEB 102,A05,193265,Butler; Shannon Rhey,25,0,32,7
1683683911565,BIEB 102,A06,193269,Butler; Shannon Rhey,13,0,32,19
1683683913617,BIEB 150,A01,193274,Staff,0,0,32,32
1683683913617,BIEB 150,A02,193285,Staff,24,0,32,8
1683683914641,BIEB 194,A00,193286,Kurle; Carolyn M.,19,0,32,13
1683683915667,BILD 1,A01,192291,Staff,15,0,32,17
1683683915667,BILD 1,A02,192292,Staff,30,0,32,2
1683683915667,BILD 1,B01,192520,Reuther; Keefe,0,1,0,0
1683683915667,BILD 1,B02,192532,Reuther; Keefe,0,1,0,0
1683683916691,BILD 3,A01,192556,Butler; Shannon Rhey,0,0,32,32
1683683916691,BILD 3,A02,192581,Butler; Shannon Rhey,0,1,32,32
1683683916691,BILD 3,A03,192611,Butler; Shannon Rhey,19,0,32,13
1683683916691,BILD 3,A04,192612,Butler; Shannon Rhey,24,0,32,8
1683683916691,BILD 3,A05,192613,Butler; Shannon Rhey,26,0,32,6
1683683916691,BILD 3,A06,192679,Butler; Shannon Rhey,27,0,32,5
1683683916691,BILD 3,A07,192682,Butler; Shannon Rhey,20,0,32,12
1683683917720,BILD 4,A01,192836,Reuther; Keefe,1,0,24,23
1683683917720,BILD 4,A02,193044,Reuther; Keefe,4,0,24,20
1683683918748,BILD 10,A01,193142,Gustafson-Brown; Cindy,29,0,32,3
1683683918748,BILD 10,A02,193149,Gustafson-Brown; Cindy,31,0,32,1
1683683919778,BIMM 100,A01,193301,Staff,0,6,32,32
1683683919778,BIMM 100,A02,193312,Staff,0,7,32,32
1683683919778,BIMM 100,A03,193323,Staff,0,10,32,32
1683683920804,BIMM 101,A01,193329,McDonnell; Lisa Marie,1,4,24,23
1683683920804,BIMM 101,A02,193339,McDonnell; Lisa Marie,1,4,24,23
1683683920804,BIMM 101,B01,193354,McDonnell; Lisa Marie,0,4,24,24
1683683920804,BIMM 101,B02,193357,McDonnell; Lisa Marie,0,3,24,24
1683683921829,BIMM 110,A01,193377,Tat; John,0,11,32,32
1683683921829,BIMM 110,A02,193378,Tat; John,0,11,32,32
1683683922854,BIMM 120,A01,206116,Staff,0,0,32,32
1683683922854,BIMM 120,A02,206117,Staff,7,0,32,25
1683683922854,BIMM 120,A03,206121,Staff,21,0,32,11
1683683923879,BIPN 100,A01,193393,Park; Ji Young,0,15,32,32
1683683923879,BIPN 100,A02,193402,Park; Ji Young,0,14,32,32
1683683923879,BIPN 100,A03,193413,Park; Ji Young,0,14,32,32
1683683923879,BIPN 100,A04,193414,Park; Ji Young,0,13,32,32
1683683924907,BIPN 102,A01,193429,Staff,0,0,32,32
1683683924907,BIPN 102,A02,193438,Staff,18,0,32,14
1683683925935,BIPN 106,A01,193450,Reyes Gonzalez; Catalina,0,2,40,40
1683683926964,BIPN 134,A01,193465,Cooke; James Edward,0,0,32,32
1683683926964,BIPN 134,A02,193474,Cooke; James Edward,25,0,32,7
1683683926964,BIPN 134,A03,193485,Cooke; James Edward,29,0,32,3
1683683926964,BIPN 134,A04,193486,Cooke; James Edward,20,0,32,12
1683683926964,BIPN 134,A05,193491,Cooke; James Edward,31,0,32,1
1683683926964,BIPN 134,A06,193501,Cooke; James Edward,30,0,32,2
1683683926964,BIPN 134,A07,193510,Cooke; James Edward,29,0,32,3
1683683929014,BISP 194,A00,222522,Staff,14,0,32,18
1683683930041,CAT 124,A01,202407,Staff,19,0,25,6
1683683931066,CAT 125,A00,202408,Marchisotto; Jennifer Anne,2,0,20,18
1683683932090,CAT 125R,A00,202409,Smith; Lauryn Alissa,0,11,20,20
1683683932090,CAT 125R,B00,202410,Morales; Celeste Georgianna,0,11,20,20
1683683932090,CAT 125R,C00,202411,Irwin; Matthew Joseph,0,12,20,20
1683683933120,CENG 15,A01,204712,Yang; Kesong,0,1,0,0
1683683934147,CENG 114,A00,202070,Jahed Motlagh; Zeinab,5,0,20,15
1683683935171,CGS 105,A00,185477,Wesling; Megan E.,24,0,40,16
1683683936199,CGS 106,A00,185494,Staff,11,0,22,11
1683683937224,CGS 108,A00,185495,Staff,14,0,20,6
1683683938247,CGS 114,A00,185496,Staff,13,0,18,5
1683683939272,CGS 119,A00,185501,Staff,15,0,20,5
1683683940294,CGS 120,A00,185511,Staff,12,0,20,8
1683683941322,CHEM 4,A01,184675,Bussey; Thomas J,97,0,100,3
1683683942346,CHEM 6A,A01,184677,Staff,32,0,60,28
1683683943370,CHEM 6B,A01,184679,Staff,63,0,100,37
1683683944396,CHEM 6C,A01,184681,Bussey; Thomas J,0,0,50,50
1683683944396,CHEM 6C,A02,184682,Bussey; Thomas J,32,0,50,18
1683683945420,CHEM 40A,A01,184684,Albizati; Kim F.,33,0,100,67
1683683946444,CHEM 40B,A01,184686,Albizati; Kim F.,0,22,100,100
1683683947470,CHEM 41B,A01,184690,Staff,51,0,100,49
1683683948494,COGS 3,A01,184715,Boyle; Mary E. T.,0,27,40,40
1683683949517,COGS 14B,A01,185172,Staff,0,14,38,38
1683683950542,COGS 18,A01,184736,Staff,14,0,80,66
1683683951565,COGS 100,A01,184932,Staff,0,8,73,73
1683683952597,COGS 101A,A01,184935,Staff,0,40,30,30
1683683953625,COGS 101B,A01,184944,Staff,0,2,30,30
1683683954649,COGS 101C,A01,184946,Staff,0,10,30,30
1683683955673,COGS 102A,A01,184951,Johnson; Christine M.,1,0,40,39
1683683956697,COGS 107B,A01,184953,Mooshagian; Eric Frederick,0,52,40,40
1683683957725,COGS 118B,A01,184959,Gupta; Anjum,0,50,40,40
1683683958812,COGS 153,A00,184961,Staff,0,16,30,30
1683683959836,COGS 177,A00,184962,Staff,1,21,30,29
1683683960860,COGS 187A,A01,184969,Boyle; Mary E. T.,0,19,40,40
1683683961885,COMM 10,A01,185174,Staff,0,5,25,25
1683683961885,COMM 10,A02,185189,Staff,0,2,25,25
1683683961885,COMM 10,A03,269821,Staff,0,1,0,0
1683683962910,COMM 100B,A02,185476,Staff,10,0,25,15
1683683962910,COMM 100B,A03,277340,Staff,25,0,25,0
1683683963934,COMM 100C,A01,185314,Staff,1,0,25,24
1683683963934,COMM 100C,A02,185327,Staff,17,0,25,8
1683683964962,COMM 110M,A00,185349,Staff,0,0,40,40
1683683965986,COMM 113T,A00,185352,Staff,25,0,40,15
1683683967009,COMM 114I,A00,185353,Staff,31,0,40,9
1683683968035,COMM 131,A00,185354,Staff,17,0,30,13
1683683969064,CSE 8A,A50,185358,Cao; Yingjun,0,46,10,10
1683683970091,CSE 8B,A01,185362,Staff,0,48,50,50
1683683971117,CSE 11,A01,185416,Cao; Yingjun,0,91,10,10
1683683972141,CSE 20,A01,185445,Briones; Jor-el Thomas Caparas,3,0,25,22
1683683973165,CSE 21,A01,185447,Staff,9,0,50,41
1683683974192,CSE 101,A01,185451,Staff,0,13,50,50
1683683974192,CSE 101,B01,185453,Jones; Miles E,0,14,50,50
1683683976245,CSE 141,A01,185458,Eldon; John,16,0,100,84
1683683977272,CSE 141L,A01,185461,Eldon; John,8,0,100,92
1683683978298,CSE 142,A01,185463,Staff,34,0,60,26
1683683978298,CSE 142,B01,201355,Staff,0,7,60,60
1683683979322,CSE 142L,A01,185470,Staff,34,0,60,26
1683683979322,CSE 142L,B01,201417,Staff,0,6,60,60
1683683980346,CSE 190,A00,201433,Staff,32,0,49,17
1683683981374,DOC 1,A01,259136,Strom; Megan C.,7,0,15,8
1683683981374,DOC 1,A02,259137,Strom; Megan C.,14,0,15,1
1683683981374,DOC 1,A03,259138,Strom; Megan C.,14,0,15,1
1683683981374,DOC 1,A04,259139,Strom; Megan C.,14,0,15,1
1683683982398,DOC 100D,A00,259140,Pass; Natalye Joann,14,0,25,11
1683683983422,DSGN 1,A01,184749,Rill; Bryan,0,26,30,30
1683683984444,DSGN 100,A01,185168,Staff,0,2,25,25
1683683985468,ECE 5,A01,185626,Morris; Karcher William,0,12,0,0
1683683986496,ECE 101,A01,185628,Staff,14,0,70,56
1683683987520,ECE 107,A01,185635,Baghdadchi; Saharnaz,0,0,20,20
1683683987520,ECE 107,A02,185638,Baghdadchi; Saharnaz,1,0,20,19
1683683988546,ECE 148,A01,185647,Silberman; Jack,0,0,16,16
1683683989570,ECON 1,A01,185537,Crane; Meredith Helen,54,0,70,16
1683683990598,ECON 3,A01,185549,Crane; Meredith Helen,30,0,70,40
1683683991623,ECON 4,A01,203354,Anderson; John Charles,0,5,10,10
1683683992650,ECON 100A,A01,185574,Staff,0,5,40,40
1683683993677,ECON 100B,A01,185576,Staff,0,12,50,50
1683683994704,ECON 100C,A01,185589,Newhouse; Herbert S,30,0,70,40
1683683995728,ECON 105,A00,185608,Vespa; Emanuel Ignacio,19,0,35,16
1683683996758,ECON 109,A01,185610,Shishkin; Denis,9,0,35,26
1683683997783,ECON 110A,A01,185612,Staff,9,0,40,31
1683683998808,ECON 120A,A01,185615,Staff,19,0,40,21
1683683999833,ECON 120C,A01,185617,Sun; Yixiao,0,21,70,70
1683684000857,ECON 144,A00,203346,Squires; Dale E,2,0,35,33
1683684001881,ECON 171,A01,203349,Newhouse; Herbert S,0,1,35,35
1683684002905,ECON 173A,A01,185621,Toda; Alexis Akira,21,0,35,14
1683684003929,EDS 25,A01,202413,Staff,0,1,0,0
1683684003929,EDS 25,A02,202414,Staff,0,1,0,0
1683684003929,EDS 25,A03,202415,Staff,0,0,0,0
1683684003929,EDS 25,A04,202416,Staff,0,1,0,0
1683684003929,EDS 25,A05,202439,Staff,0,0,0,0
1683684003929,EDS 25,A06,202440,Staff,0,0,0,0
1683684003929,EDS 25,B01,202631,Staff,0,0,0,0
1683684003929,EDS 25,B02,202632,Staff,0,0,0,0
1683684003929,EDS 25,B03,202639,Staff,0,0,0,0
1683684003929,EDS 25,B04,202640,Staff,0,0,0,0
1683684003929,EDS 25,B05,202643,Staff,0,0,0,0
1683684003929,EDS 25,B06,202644,Staff,0,0,0,0
1683684004954,EDS 38,A01,202659,Black; Alison Michelle,24,0,25,1
1683684005979,EDS 115,A00,202652,Staff,18,0,30,12
1683684007005,EDS 125,A00,202649,Staff,13,0,30,17
1683684008029,EDS 126,A01,203332,Staff,30,0,30,0
1683684009053,EDS 139,A00,202838,Staff,16,0,25,9
1683684010076,EDS 146,A01,202655,Staff,14,0,25,11
1683684011101,ENG 15,A00,185667,Staff,0,1,0,0
1683684011101,ENG 15,B00,185672,Staff,0,0,0,0
1683684011101,ENG 15,C00,185675,Staff,0,0,0,0
1683684011101,ENG 15,D00,185682,Staff,0,0,0,0
1683684011101,ENG 15,E00,185684,Staff,0,0,0,0
1683684012128,ETHN 103,A00,185710,Staff,0,8,35,35
1683684013154,ETHN 103A,A00,199228,Man; Simeon S,0,0,9,9
1683684014181,ETHN 109,A00,185711,Staff,15,0,35,20
1683684015206,ETHN 142,A00,185726,Staff,0,4,30,30
1683684016229,ETHN 163J,A00,199229,Man; Simeon S,5,0,8,3
1683684017256,ETHN 168,A00,185727,Staff,7,0,10,3
1683684018278,ETHN 182,A00,185728,Staff,0,0,35,35
1683684019305,ETHN 183,A00,185737,Staff,9,0,18,9
1683684020332,GLBH 111,A01,209361,Burgos; Jose L.,0,0,0,0
1683684022382,HIEU 104,A00,185792,Staff,14,0,20,6
1683684023409,HIEU 115,A00,185800,Staff,0,0,20,20
1683684024433,HIEU 128,A00,185801,Staff,0,9,20,20
1683684025456,HIEU 147,A00,185802,Staff,15,0,20,5
1683684026481,HIEU 154,A00,185823,Staff,11,0,20,9
1683684027505,HILA 102,A00,185826,Staff,14,0,20,6
1683684028533,HILD 2C,A01,185778,Staff,0,13,20,20
1683684029558,HILD 7B,A01,185780,Kwak; Nancy,0,17,32,32
1683684029558,HILD 7B,A02,185781,Kwak; Nancy,0,18,32,32
1683684030581,HILD 30,A01,185791,Staff,12,0,20,8
1683684031606,HISC 119,A00,185830,Golan; Tal,0,10,20,20
1683684032630,HITO 156GS,A00,185831,Patterson; Patrick H.,0,0,0,23
1683684033660,HIUS 103,A00,185832,Man; Simeon S,0,4,20,20
1683684034684,HIUS 117,A00,185836,Kwak; Nancy,2,0,20,18
1683684035709,HIUS 125,A00,185840,Man; Simeon S,0,2,23,23
1683684036736,HIUS 149,A00,185845,Staff,1,0,20,19
1683684037764,HUM 3,A01,185882,Zavodny; Tatiana Sophia,0,8,50,50
1683684037764,HUM 3,B01,185899,Caldwell; Michael Alan,0,18,50,50
1683684038792,HUM 3GS,A00,185900,Patterson; Patrick H.,0,0,0,23
1683684039825,HUM 4,A01,185938,Zroka; Amy Liane,28,0,50,22
1683684039825,HUM 4,B01,185956,Watkins; Eric,0,6,50,50
1683684039825,HUM 4,B02,202209,Watkins; Eric,0,5,50,50
1683684039825,HUM 4,B03,202210,Watkins; Eric,0,5,50,50
1683684040849,HUM 5,A01,185958,West; Geoffrey Scott,0,0,50,50
1683684040849,HUM 5,A02,202215,West; Geoffrey Scott,0,0,50,50
1683684041872,INTL 190,A00,185959,Gagnon; Jeffrey C,0,0,0,9
1683684041872,INTL 190,B00,185960,Lettieri; Michael Joseph,0,0,0,2
1683684042896,JAPN 180,A00,254509,Staff,5,0,30,25
1683684043926,LATI 10,A01,202853,Kennemore; Amy Michelle,4,0,35,31
1683684043926,LATI 10,A02,202854,Kennemore; Amy Michelle,3,0,35,32
1683684043926,LATI 10,A03,270054,Kennemore; Amy Michelle,30,0,30,0
1683684044950,LATI 180,A00,202855,Kennemore; Amy Michelle,11,0,20,9
1683684045976,LAWS 101,A00,201767,Golan; Tal,0,7,40,40
1683684047006,LIFR 1C,A00,185961,Staff,6,0,20,14
1683684048034,LIFR 1CX,A00,185962,Staff,7,0,20,13
1683684049063,LIFR 1D,A00,185963,Staff,7,0,20,13
1683684050090,LIFR 1DX,A00,185964,Staff,7,0,20,13
1683684051114,LIGN 101,A01,186039,Staff,43,0,50,7
1683684052141,LIGN 165,A00,186040,Staff,15,0,50,35
1683684053165,LTCS 108,A00,186041,Staff,5,0,10,5
1683684054190,LTCS 119,A00,186042,Staff,15,0,20,5
1683684055216,LTCS 130,A00,186043,Wesling; Megan E.,15,0,25,10
1683684057262,LTEA 138,A00,186119,Staff,14,0,40,26
1683684058285,LTEN 124,A00,186148,Staff,5,0,25,20
1683684059310,LTEN 178,A00,186149,Staff,6,0,15,9
1683684060338,LTEN 181,A00,186150,Blanco; John D,34,0,40,6
1683684061366,LTWL 120,A00,186160,Staff,19,0,25,6
1683684062455,LTWL 165,A00,186161,Staff,22,0,25,3
1683684063479,LTWR 100,A00,186162,Staff,0,5,15,15
1683684064506,LTWR 102,A00,186163,Doller; Ben,5,0,15,10
1683684065536,MAE 8,A01,186412,Staff,0,1,0,0
1683684066562,MAE 30B,A00,186445,Bahadori; Mohammad Yousef,81,0,100,19
1683684067588,MAE 40,A00,186592,Bewley; Thomas R,10,0,50,40
1683684068613,MAE 101B,A00,186593,Bahadori; Mohammad Yousef,80,0,100,20
1683684069643,MAE 105,A00,186594,Bandaru; Prabhakar,10,0,50,40
1683684070674,MAE 107,A00,186599,Pham; Hieu Tan,0,7,120,120
1683684071703,MAE 148,A01,186660,Silberman; Jack,3,0,16,13
1683684072732,MATH 10A,A01,188095,Staff,0,6,35,35
1683684073758,MATH 10B,A01,188097,Bowers; Adam R.,0,12,30,30
1683684073758,MATH 10B,A02,188099,Bowers; Adam R.,0,11,30,30
1683684073758,MATH 10B,B01,188104,Bowers; Adam R.,0,10,30,30
1683684073758,MATH 10B,B02,188106,Bowers; Adam R.,1,9,30,29
1683684074783,MATH 10C,A01,188111,Staff,0,20,30,30
1683684074783,MATH 10C,A02,188127,Staff,0,19,30,30
1683684074783,MATH 10C,A03,188131,Staff,0,19,30,30
1683684074783,MATH 10C,B01,188218,Staff,17,0,30,13
1683684074783,MATH 10C,B02,188244,Staff,13,0,30,17
1683684074783,MATH 10C,B03,188277,Staff,14,0,30,16
1683684075809,MATH 18,A01,188344,Bach; Quang Tran,18,0,30,12
1683684075809,MATH 18,A02,188345,Bach; Quang Tran,11,0,30,19
1683684075809,MATH 18,B01,188353,Bach; Quang Tran,11,0,30,19
1683684075809,MATH 18,B02,188354,Bach; Quang Tran,19,0,30,11
1683684076833,MATH 20A,A01,188374,Staff,11,0,35,24
1683684077862,MATH 20B,A01,188382,Ohm; Ko Woon,7,0,30,23
1683684077862,MATH 20B,A02,188383,Ohm; Ko Woon,22,0,30,8
1683684077862,MATH 20B,B01,188385,Ohm; Ko Woon,7,0,30,23
1683684077862,MATH 20B,B02,188392,Ohm; Ko Woon,22,0,30,8
1683684078887,MATH 20C,A01,188394,Harel; Guershon,10,0,30,20
1683684078887,MATH 20C,A02,188395,Harel; Guershon,13,0,30,17
1683684078887,MATH 20C,B01,188404,Harel; Guershon,5,0,30,25
1683684078887,MATH 20C,B02,188405,Harel; Guershon,18,0,30,12
1683684079917,MATH 20D,A01,188414,Hammock; Frances H,0,1,30,30
1683684079917,MATH 20D,A02,188415,Hammock; Frances H,0,1,30,30
1683684079917,MATH 20D,B01,188447,Hammock; Frances H,0,1,30,30
1683684079917,MATH 20D,B02,188486,Hammock; Frances H,3,0,30,27
1683684080946,MATH 20E,A01,188649,Staff,21,0,30,9
1683684080946,MATH 20E,A02,188650,Staff,20,0,30,10
1683684080946,MATH 20E,A03,188673,Staff,0,0,30,30
1683684081971,MATH 102,A01,188675,Staff,0,39,35,35
1683684083002,MATH 103B,A01,188681,Staff,3,0,35,32
1683684083002,MATH 103B,B01,188692,Staff,5,0,35,30
1683684084027,MATH 109,A01,188695,Salehi Golsefidy; Alireza,24,0,35,11
1683684084027,MATH 109,A02,188696,Salehi Golsefidy; Alireza,25,0,35,10
1683684085057,MATH 120A,A01,188698,Eggers; John Dietrich,7,0,35,28
1683684086087,MATH 142B,A01,188736,Ioana; Adrian,1,1,30,29
1683684086087,MATH 142B,A02,188741,Ioana; Adrian,0,1,30,30
1683684086087,MATH 142B,A03,188743,Ioana; Adrian,0,1,30,30
1683684087115,MATH 168A,A01,188790,Staff,0,11,35,35
1683684088142,MATH 170A,A01,188803,Nie; Jiawang,0,2,35,35
1683684088142,MATH 170A,A02,188811,Nie; Jiawang,0,1,35,35
1683684088142,MATH 170A,A03,188814,Nie; Jiawang,0,0,35,35
1683684088142,MATH 170A,A04,188815,Nie; Jiawang,6,0,35,29
1683684089167,MATH 193B,A01,188817,Staff,0,0,35,35
1683684089167,MATH 193B,A02,188818,Staff,5,0,35,30
1683684090196,MGT 4,A01,202857,Anderson; John Charles,59,0,80,21
1683684091245,MGT 12,A00,202858,Lindenberger; Wade Douglas,40,0,90,50
1683684092271,MGT 18,A00,202859,Staff,74,0,90,16
1683684093302,MGT 18GS,A00,202860,McKay; Michael J,13,0,28,15
1683684094330,MGT 45,A00,202861,Pecore; Joseph P.,8,0,90,82
1683684095358,MGT 100,A00,202863,Yavorsky; Daniel Ryan,28,0,90,62
1683684096384,MGT 103,A00,202864,Ehrich; Kristine R,0,19,90,90
1683684097408,MGT 112,A00,202865,Ehrich; Kristine R,15,0,90,75
1683684098434,MGT 121A,A00,202868,Staff,90,20,90,0
1683684099460,MGT 131B,A00,202869,Anderson; John Charles,59,0,90,31
1683684100488,MGT 136,A00,202871,Lindenberger; Wade Douglas,83,0,90,7
1683684101521,MGT 164,A00,202873,Staff,0,68,90,91
1683684102545,MGT 164GS,A00,202874,McKay; Mary A,13,0,28,15
1683684103570,MGT 180,A00,202875,Staff,0,51,90,91
1683684104599,MMW 11R,A01,205019,Herbst; Matthew,0,0,30,30
1683684104599,MMW 11R,A02,205026,Herbst; Matthew,29,0,30,1
1683684105629,MMW 15,A01,193512,Chang; Edmond Yi-Teh,0,8,28,28
1683684105629,MMW 15,A02,193513,Chang; Edmond Yi-Teh,0,5,28,28
1683684105629,MMW 15,A03,193514,Chang; Edmond Yi-Teh,0,5,28,28
1683684105629,MMW 15,A04,193515,Chang; Edmond Yi-Teh,0,5,28,28
1683684105629,MMW 15,A05,193516,Chang; Edmond Yi-Teh,0,5,28,28
1683684105629,MMW 15,A06,193517,Chang; Edmond Yi-Teh,0,6,28,28
1683684105629,MMW 15,B01,193519,Chang; Edmond Yi-Teh,0,5,28,28
1683684105629,MMW 15,B02,193520,Chang; Edmond Yi-Teh,0,5,28,28
1683684105629,MMW 15,B03,193521,Chang; Edmond Yi-Teh,0,5,28,28
1683684105629,MMW 15,B04,193522,Chang; Edmond Yi-Teh,0,6,28,28
1683684105629,MMW 15,B05,193523,Chang; Edmond Yi-Teh,0,5,28,28
1683684105629,MMW 15,B06,193524,Chang; Edmond Yi-Teh,0,5,28,28
1683684106654,MMW 122,A01,193526,Rahimi; Babak,0,16,28,28
1683684106654,MMW 122,A02,193527,Rahimi; Babak,0,15,28,28
1683684106654,MMW 122,A03,193528,Rahimi; Babak,0,0,0,0
1683684106654,MMW 122,A04,193529,Rahimi; Babak,0,0,0,0
1683684107679,MUS 1A,A01,186663,Staff,1,19,35,34
1683684108708,MUS 4,A01,186715,Staff,0,12,35,35
1683684109747,MUS 5R,A01,186796,Dubnov; Shlomo,0,17,35,35
1683684110770,MUS 6,A01,186798,Staff,1,5,25,24
1683684111796,MUS 7,A01,186830,Staff,11,0,35,24
1683684112822,MUS 8,A01,186930,Staff,0,27,35,35
1683684113849,MUS 15,A01,186932,Staff,0,15,35,35
1683684113849,MUS 15,B01,186934,Staff,1,17,35,34
1683684114874,MUS 80,A00,186935,Staff,0,0,20,20
1683684114874,MUS 80,B00,186936,Staff,24,0,25,1
1683684115899,NANO 11,A00,204702,Lipomi; Darren John,0,0,0,0
1683684116922,NANO 15,A01,204709,Yang; Kesong,0,1,0,0
1683684117946,NANO 114,A00,202069,Jahed Motlagh; Zeinab,3,0,10,7
1683684118973,PHIL 1,A00,186955,Grush; Rick Scott,31,0,40,9
1683684120002,PHIL 10,A01,186973,Grush; Rick Scott,27,0,35,8
1683684120002,PHIL 10,A02,186974,Grush; Rick Scott,33,0,35,2
1683684121027,PHIL 13,A01,186976,Staff,1,0,35,34
1683684121027,PHIL 13,A02,186977,Staff,16,0,35,19
1683684122057,PHIL 14,A01,186979,Staff,31,0,35,4
1683684122057,PHIL 14,A02,186986,Staff,32,0,35,3
1683684123083,PHIL 28,A01,186988,Staff,16,0,30,14
1683684123083,PHIL 28,A02,186989,Staff,1,0,30,29
1683684123083,PHIL 28,A03,186990,Staff,10,0,30,20
1683684123083,PHIL 28,A04,186991,Staff,26,0,30,4
1683684124109,PHIL 120,A00,186997,Staff,23,0,40,17
1683684125135,PHIL 137,A00,187003,Staff,7,0,40,33
1683684126163,PHIL 150,A00,187015,Staff,47,0,70,23
1683684127188,PHIL 167,A00,187021,Lamey; Andy M.,34,0,40,6
1683684128216,PHIL 174,A01,202226,Staff,17,0,20,3
1683684128216,PHIL 174,A02,202235,Staff,20,0,20,0
1683684129242,PHIL 191A,A00,258918,Staff,0,0,1,1
1683684130265,PHYS 1A,A00,187028,Staff,26,0,60,34
1683684131291,PHYS 1AL,001,187036,Staff,3,0,30,27
1683684131291,PHYS 1AL,002,187049,Staff,18,0,30,12
1683684132318,PHYS 1B,A00,187058,Staff,22,0,60,38
1683684133349,PHYS 1BL,001,187064,Staff,0,1,30,30
1683684133349,PHYS 1BL,002,187070,Staff,4,0,30,26
1683684134373,PHYS 1C,A00,187082,Staff,29,0,120,91
1683684135402,PHYS 1CL,001,187088,Staff,0,9,30,30
1683684135402,PHYS 1CL,002,187089,Staff,0,1,30,30
1683684135402,PHYS 1CL,009,262693,Staff,9,0,30,21
1683684136426,PHYS 2B,A01,187097,Staff,55,0,115,60
1683684137451,PHYS 2C,A01,187099,Staff,63,0,115,52
1683684138479,PHYS 2CL,A01,187101,Staff,5,0,28,23
1683684138479,PHYS 2CL,A02,187102,Staff,15,0,28,13
1683684139508,PHYS 2D,A01,187123,Shotwell; Brian,95,0,115,20
1683684140533,PHYS 4B,A01,187133,Grinstein; Benjamin,35,0,50,15
1683684141560,POLI 10,A00,188819,Staff,0,4,50,50
1683684142584,POLI 11,A00,188827,Staff,43,0,50,7
1683684143608,POLI 13R,A00,188828,Staff,0,1,20,20
1683684144634,POLI 27,A01,188830,Elgin; Samuel Zincke,0,2,70,70
1683684145663,POLI 30,A00,188832,Desposato; Scott,30,0,50,20
1683684146696,POLI 102F,A00,188834,Staff,1,0,40,39
1683684147728,POLI 104A,A00,188852,Staff,12,0,30,18
1683684148752,POLI 104I,A00,188853,Staff,0,8,20,20
1683684149777,POLI 110B,A00,188854,Wiens; David,6,0,20,14
1683684150802,POLI 112A,A00,188855,Wiens; David,3,0,30,27
1683684151826,POLI 117R,A00,188856,Forman; Fonna,0,12,20,20
1683684152852,POLI 118,A00,188857,Ingham; Sean,8,0,20,12
1683684153876,POLI 120G,A00,188858,Staff,8,0,30,22
1683684154905,POLI 131CR,A00,188863,Hoston; Germaine,20,0,50,30
1683684155932,POLI 133,A00,188864,Nellis; Gareth Hb,44,0,50,6
1683684156956,POLI 134D,A00,188865,Desposato; Scott,27,0,30,3
1683684157984,POLI 142A,A00,188871,Gartzke; Erik,21,0,50,29
1683684159007,POLI 142K,A00,188874,Staff,38,0,50,12
1683684160032,POLI 143,A00,188940,Gartzke; Erik,16,0,30,14
1683684161056,POLI 153,A00,188943,Staff,2,0,20,18
1683684162081,POLI 160AA,A00,188944,Staff,10,0,40,30
1683684163105,POLI 170A,A00,188945,Staff,10,0,30,20
1683684165161,PSYC 1,A00,188952,Staff,36,0,90,54
1683684166242,PSYC 2,B00,188953,Staff,19,0,35,16
1683684167267,PSYC 6,A00,188970,Staff,47,0,60,13
1683684168291,PSYC 7,A00,188973,Staff,35,0,45,10
1683684169317,PSYC 60,A01,188980,Rickard; Timothy C.,42,0,60,18
1683684170348,PSYC 70,A01,189001,Steiner; Eric Tomas,21,0,45,24
1683684171373,PSYC 100,A00,189005,Lacefield; Katharine I,0,99,120,120
1683684172396,PSYC 102,A00,189008,Staff,7,0,30,23
1683684173425,PSYC 106,B00,189026,Gorman; Michael R.,27,0,60,33
1683684174454,PSYC 114,B01,189033,Winkielman; Piotr,0,31,30,30
1683684175492,PSYC 131,A00,189036,Anagnostaras; Stephan,0,43,60,60
1683684176518,PSYC 136,A00,189041,Lowe; Angela Beth,0,7,25,25
1683684177547,PSYC 137,A00,189057,Winkielman; Piotr,1,37,25,24
1683684178576,PSYC 144,A00,189107,Wixted; John T,0,11,50,50
1683684180629,PSYC 162,A00,189142,Staff,0,9,85,85
1683684181653,PSYC 172,A00,189144,Gorman; Michael R.,0,6,30,30
1683684183710,PSYC 179,A00,189146,Lacefield; Katharine I,0,87,120,120
1683684184738,PSYC 181,A00,189147,Anagnostaras; Stephan,0,44,90,90
1683684185766,PSYC 190R,A00,189148,Barner; David A.,0,23,80,80
1683684186790,PSYC 191,A00,189275,Rickard; Timothy C.,0,10,25,25
1683684187816,PSYC 193,A00,189276,Chapman; Eddie Nathaniel,0,1,0,4
1683684188841,PSYC 193L,A01,189281,Lowe; Angela Beth,8,0,20,12
1683684188841,PSYC 193L,B01,189285,Staff,28,0,35,7
1683684189866,RELI 149,A00,187137,Rahimi; Babak,7,0,40,33
1683684190891,SE 9,A01,187315,Staff,0,2,18,18
1683684191918,SE 101B,A00,187409,Staff,24,0,30,6
1683684192943,SE 110B,A00,187444,Staff,10,0,40,30
1683684193967,SE 130B,A00,187449,Staff,31,0,40,9
1683684194991,SE 150A,A00,187516,Staff,8,0,20,12
1683684196019,SE 154,A00,187528,Staff,29,0,50,21
1683684197045,SIO 3,A01,258171,Staff,35,0,40,5
1683684198070,SIO 10,A00,187144,Cook; Geoffrey W,1,7,75,74
1683684199094,SIO 45,A00,187152,Cook; Geoffrey W,0,7,100,100
1683684200118,SIO 109R,A00,194486,Staff,0,4,20,20
1683684202170,SIO 187,A01,187233,Kacev; David,12,0,40,28
1683684203197,SOCI 1,A01,258656,Thorpe; Charles Robert,28,0,30,2
1683684203197,SOCI 1,A02,258658,Thorpe; Charles Robert,30,0,30,0
1683684203197,SOCI 1,A03,258661,Thorpe; Charles Robert,25,0,25,0
1683684203197,SOCI 1,A04,258666,Thorpe; Charles Robert,22,0,25,3
1683684203197,SOCI 1,A05,258897,Thorpe; Charles Robert,22,0,25,3
1683684203197,SOCI 1,A06,258898,Thorpe; Charles Robert,25,0,25,0
1683684204226,SOCI 30,A01,258903,Pardo Guerra; Juan Pablo,14,0,30,16
1683684205252,SOCI 102,A00,258904,Staff,9,0,25,16
1683684206280,SOCI 106,A00,258905,Staff,19,0,25,6
1683684207307,SOCI 111,A00,258907,Ribas Norris; Janet Vanesa,26,0,30,4
1683684208334,SOCI 121R,A00,258908,Pardo Guerra; Juan Pablo,8,0,30,22
1683684209358,SOCI 126,A01,203330,Staff,14,0,20,6
1683684210382,SOCI 131,A00,258909,Thorpe; Charles Robert,30,0,60,30
1683684211406,SOCI 135,A00,258910,Payne; Christine Anna,0,12,30,30
1683684212430,SOCI 157,A00,258911,Staff,11,0,30,19
1683684213460,SOCI 184,A00,258912,Staff,25,0,30,5
1683684214485,SOCI 188D,A00,258913,Staff,22,0,30,8
1683684215512,SYN 2,001,187529,Staff,9,0,16,7
1683684215512,SYN 2,002,201452,Staff,1,20,16,15
1683684215512,SYN 2,003,201469,Staff,1,0,16,15
1683684216536,SYN 100,A01,187531,Staff,0,9,20,20
1683684216536,SYN 100,B01,201491,Staff,0,10,20,20
1683684217577,TDAC 1,A00,189286,Walsh; Kim C.,3,0,20,17
1683684217577,TDAC 1,B00,189287,Harting; Carla Kelso,10,0,20,10
1683684218603,TDAC 101,A00,189300,Walsh; Kim C.,16,0,20,4
1683684218603,TDAC 101,B00,189301,Harting; Carla Kelso,18,0,20,2
1683684219629,TDAC 102,A00,189304,Basso; Beatrice,14,0,20,6
1683684220656,TDAC 108,A00,189305,Staff,18,0,20,2
1683684221685,TDDE 131,A00,189310,Staff,19,0,20,1
1683684221685,TDDE 131,B00,189314,Staff,19,0,20,1
1683684221685,TDDE 131,C00,189315,Staff,48,0,50,2
1683684221685,TDDE 131,D00,189316,Staff,14,0,15,1
1683684221685,TDDE 131,E00,204841,Staff,20,0,20,0
1683684222711,TDGE 10,A00,189289,Staff,27,0,50,23
1683684222711,TDGE 10,B00,189290,Havis; Allan,0,1,50,50
1683684223737,TDGE 11,A00,189291,Fulton; Julia,0,4,50,50
1683684223737,TDGE 11,B00,189292,Staff,20,0,25,5
1683684223737,TDGE 11,C00,260270,Staff,0,0,0,0
1683684224761,TDGE 25,A00,189294,Staff,1,0,20,19
1683684225784,TDGE 124,A00,189318,Fulton; Julia,0,8,50,50
1683684226811,TDGE 125,A00,189319,Staff,13,0,25,12
1683684226811,TDGE 125,B00,189320,Staff,23,0,25,2
1683684227834,TDGE 127,A00,189322,Havis; Allan,0,0,50,50
1683684228857,TDHT 101,A00,189323,Staff,18,0,25,7
1683684228857,TDHT 101,B00,189324,Staff,25,0,25,0
1683684229884,TDHT 102,A00,189325,Staff,49,0,50,1
1683684230907,TDMV 1,A00,189295,Arcidiacono; Kristin,20,0,30,10
1683684230907,TDMV 1,B00,189296,Caligagan; Maria T.,24,0,30,6
1683684231930,TDMV 2,A00,189297,Sammartano; Tonnie,27,0,30,3
1683684231930,TDMV 2,B00,189299,Arcidiacono; Kristin,23,0,30,7
1683684232955,TDMV 3,A00,204998,Rincon; Alicia,22,0,30,8
1683684233982,TDMV 120,A00,189458,Sammartano; Tonnie,28,0,30,2
1683684235009,TDMV 138,A00,189541,Jun; Grace Shin Hae,20,0,40,20
1683684236034,TDMV 142,A00,189717,Caligagan; Tony,25,0,30,5
1683684236034,TDMV 142,B00,189718,Caligagan; Maria T.,25,0,30,5
1683684237058,TMC 2,A01,187533,Staff,25,0,25,0
1683684237058,TMC 2,A02,187534,Staff,25,0,25,0
1683684238085,USP 1,A01,187536,Kwak; Nancy,0,16,25,25
1683684239112,USP 5,A01,187538,Staff,8,0,25,17
1683684240139,USP 101,A00,199253,Staff,0,4,0,0
1683684241164,USP 124,A00,187562,Boomhower; Matthew Charles,0,0,30,30
1683684242189,USP 138,A00,187582,Staff,19,0,25,6
1683684243212,USP 152,A01,187597,Staff,3,0,25,22
1683684244238,USP 153,A00,187598,Staff,18,0,25,7
1683684245266,USP 168,A00,187607,Kwak; Nancy,2,0,5,3
1683684246293,USP 173,A00,187619,Staff,4,0,25,21
1683684247317,USP 181,A00,187638,Staff,0,4,25,25
1683684248341,VIS 103,A00,187650,Cruz; Edwin Teddy,17,0,75,58
1683684249365,VIS 110D,A00,187669,Staff,13,0,22,9
1683684250395,VIS 127C,A00,187720,Shen; Kuiyi,67,0,146,79
1683684251423,VIS 149,A00,187731,Yoldas; Pinar,1,14,22,21
1683684252448,VIS 151,A01,188091,Staff,22,0,34,12
1683684252448,VIS 151,A02,188092,Staff,11,0,34,23
1683684253476,VIS 160B,A00,188093,Stalbaum; Brett,0,1,10,10
1683684255524,WCWP 10B,A00,201720,Staff,0,0,5,5
1683684255524,WCWP 10B,B00,201722,Staff,0,0,6,6
1683684256549,WCWP 100,A00,201725,Gagnon; Jeffrey C,0,0,2,2
1683684256549,WCWP 100,B00,201727,Staff,0,4,15,15
1683684259680,ANBI 133,A00,258401,Wilder; Linnea Lorene,34,0,40,6
1683684260705,ANBI 140,A00,258395,Hrvoj Mihic; Branka,18,0,25,7
1683684261731,ANSC 120,A00,258402,Bialecki; Jon Anthony,26,0,40,14
1683684262757,ANSC 144,A00,258400,Staff,12,0,40,28
1683684264806,ANSC 166,A00,258396,Parish; Steven Martin,156,0,175,19
1683684265832,ANSC 180,A00,193533,Staff,8,0,20,12
1683684266857,ANSC 188,A00,258397,Jassal; Aftab,34,0,40,6
1683684267885,ANTH 3,A01,258316,Staff,23,0,30,7
1683684268912,ANTH 5,A00,258394,Semendeferi; Ekaterini,16,0,20,4
1683684270011,ANTH 21,A01,258331,Staff,4,0,40,36
1683684271038,ANTH 103,A00,258398,Varma; Saiba,15,0,25,10
1683684272063,AWP 10,001,202034,Staff,0,0,0,0
1683684272063,AWP 10,002,202035,Staff,0,0,0,0
1683684272063,AWP 10,003,202036,Staff,0,0,0,0
1683684272063,AWP 10,004,202037,Staff,0,0,0,0
1683684272063,AWP 10,005,202038,Staff,0,0,0,0
1683684272063,AWP 10,006,202039,Staff,0,0,0,0
1683684272063,AWP 10,007,202040,Staff,0,0,0,0
1683684272063,AWP 10,008,202041,Staff,0,0,0,0
1683684272063,AWP 10,009,202042,Staff,0,0,0,0
1683684272063,AWP 10,010,202043,Staff,0,0,0,0
1683684272063,AWP 10,011,202044,Staff,0,0,0,0
1683684272063,AWP 10,012,202045,Staff,0,0,0,0
1683684272063,AWP 10,013,202046,Staff,0,0,0,0
1683684272063,AWP 10,014,202047,Staff,0,0,0,0
1683684272063,AWP 10,015,202048,Staff,0,0,0,0
1683684272063,AWP 10,016,202049,Staff,0,0,0,0
1683684272063,AWP 10,017,202050,Staff,0,0,0,0
1683684272063,AWP 10,018,202051,Staff,0,0,0,0
1683684272063,AWP 10,019,202052,Staff,0,0,0,0
1683684272063,AWP 10,020,202053,Staff,0,0,0,0
1683684272063,AWP 10,021,202054,Staff,0,0,0,0
1683684272063,AWP 10,022,202055,Staff,0,0,0,0
1683684272063,AWP 10,023,202056,Staff,0,0,0,0
1683684272063,AWP 10,024,202057,Staff,0,0,0,0
1683684272063,AWP 10,025,202058,Staff,0,0,0,0
1683684272063,AWP 10,026,202059,Staff,0,0,0,0
1683684273091,AWP 102,001,202032,Staff,0,0,0,0
1683684273091,AWP 102,002,202033,Staff,0,0,0,0
1683684274118,BENG 100,A01,254234,Taylor Amos; Alyssa C,31,0,40,9
1683684275142,BENG 196,001,270013,Engler; Adam J.,9999,0,9999,0
1683684276166,BICD 100R,A01,202018,Smith; Laurie,0,7,32,32
1683684276166,BICD 100R,A02,202019,Smith; Laurie,0,3,32,32
1683684276166,BICD 100R,A03,202020,Smith; Laurie,0,1,32,32
1683684276166,BICD 100R,A04,202021,Smith; Laurie,6,0,32,26
1683684276166,BICD 100R,A05,202022,Smith; Laurie,10,0,32,22
1683684277192,BICD 136,A01,193242,Gustafson-Brown; Cindy,0,2,32,32
1683684277192,BICD 136,A02,193244,Gustafson-Brown; Cindy,13,0,32,19
1683684278217,BIEB 102,A01,193249,Butler; Shannon Rhey,1,1,32,31
1683684278217,BIEB 102,A02,193251,Butler; Shannon Rhey,0,0,32,32
1683684278217,BIEB 102,A03,193253,Butler; Shannon Rhey,0,0,32,32
1683684278217,BIEB 102,A04,193255,Butler; Shannon Rhey,13,0,32,19
1683684278217,BIEB 102,A05,193265,Butler; Shannon Rhey,25,0,32,7
1683684278217,BIEB 102,A06,193269,Butler; Shannon Rhey,13,0,32,19
1683684280271,BIEB 150,A01,193274,Staff,0,0,32,32
1683684280271,BIEB 150,A02,193285,Staff,24,0,32,8
1683684281297,BIEB 194,A00,193286,Kurle; Carolyn M.,19,0,32,13
1683684282322,BILD 1,A01,192291,Staff,15,0,32,17
1683684282322,BILD 1,A02,192292,Staff,30,0,32,2
1683684282322,BILD 1,B01,192520,Reuther; Keefe,0,1,0,0
1683684282322,BILD 1,B02,192532,Reuther; Keefe,0,1,0,0
1683684283354,BILD 3,A01,192556,Butler; Shannon Rhey,0,0,32,32
1683684283354,BILD 3,A02,192581,Butler; Shannon Rhey,0,1,32,32
1683684283354,BILD 3,A03,192611,Butler; Shannon Rhey,19,0,32,13
1683684283354,BILD 3,A04,192612,Butler; Shannon Rhey,24,0,32,8
1683684283354,BILD 3,A05,192613,Butler; Shannon Rhey,26,0,32,6
1683684283354,BILD 3,A06,192679,Butler; Shannon Rhey,27,0,32,5
1683684283354,BILD 3,A07,192682,Butler; Shannon Rhey,20,0,32,12
1683684284379,BILD 4,A01,192836,Reuther; Keefe,1,0,24,23
1683684284379,BILD 4,A02,193044,Reuther; Keefe,4,0,24,20
1683684285408,BILD 10,A01,193142,Gustafson-Brown; Cindy,29,0,32,3
1683684285408,BILD 10,A02,193149,Gustafson-Brown; Cindy,31,0,32,1
1683684286433,BIMM 100,A01,193301,Staff,0,6,32,32
1683684286433,BIMM 100,A02,193312,Staff,0,7,32,32
1683684286433,BIMM 100,A03,193323,Staff,0,10,32,32
1683684287463,BIMM 101,A01,193329,McDonnell; Lisa Marie,1,4,24,23
1683684287463,BIMM 101,A02,193339,McDonnell; Lisa Marie,1,4,24,23
1683684287463,BIMM 101,B01,193354,McDonnell; Lisa Marie,0,4,24,24
1683684287463,BIMM 101,B02,193357,McDonnell; Lisa Marie,0,3,24,24
1683684288492,BIMM 110,A01,193377,Tat; John,0,11,32,32
1683684288492,BIMM 110,A02,193378,Tat; John,0,11,32,32
1683684289521,BIMM 120,A01,206116,Staff,0,0,32,32
1683684289521,BIMM 120,A02,206117,Staff,7,0,32,25
1683684289521,BIMM 120,A03,206121,Staff,21,0,32,11
1683684290549,BIPN 100,A01,193393,Park; Ji Young,0,15,32,32
1683684290549,BIPN 100,A02,193402,Park; Ji Young,0,14,32,32
1683684290549,BIPN 100,A03,193413,Park; Ji Young,0,14,32,32
1683684290549,BIPN 100,A04,193414,Park; Ji Young,0,13,32,32
1683684291574,BIPN 102,A01,193429,Staff,0,0,32,32
1683684291574,BIPN 102,A02,193438,Staff,18,0,32,14
1683684292599,BIPN 106,A01,193450,Reyes Gonzalez; Catalina,0,2,40,40
1683684293628,BIPN 134,A01,193465,Cooke; James Edward,0,0,32,32
1683684293628,BIPN 134,A02,193474,Cooke; James Edward,25,0,32,7
1683684293628,BIPN 134,A03,193485,Cooke; James Edward,29,0,32,3
1683684293628,BIPN 134,A04,193486,Cooke; James Edward,20,0,32,12
1683684293628,BIPN 134,A05,193491,Cooke; James Edward,31,0,32,1
1683684293628,BIPN 134,A06,193501,Cooke; James Edward,30,0,32,2
1683684293628,BIPN 134,A07,193510,Cooke; James Edward,29,0,32,3
1683684295678,BISP 194,A00,222522,Staff,14,0,32,18
1683684296705,CAT 124,A01,202407,Staff,19,0,25,6
1683684297731,CAT 125,A00,202408,Marchisotto; Jennifer Anne,2,0,20,18
1683684298758,CAT 125R,A00,202409,Smith; Lauryn Alissa,0,11,20,20
1683684298758,CAT 125R,B00,202410,Morales; Celeste Georgianna,0,11,20,20
1683684298758,CAT 125R,C00,202411,Irwin; Matthew Joseph,0,12,20,20
1683684299782,CENG 15,A01,204712,Yang; Kesong,0,1,0,0
1683684300811,CENG 114,A00,202070,Jahed Motlagh; Zeinab,5,0,20,15
1683684301837,CGS 105,A00,185477,Wesling; Megan E.,24,0,40,16
1683684302865,CGS 106,A00,185494,Staff,11,0,22,11
1683684303891,CGS 108,A00,185495,Staff,14,0,20,6
1683684304918,CGS 114,A00,185496,Staff,13,0,18,5
1683684305944,CGS 119,A00,185501,Staff,15,0,20,5
1683684306968,CGS 120,A00,185511,Staff,12,0,20,8
1683684307997,CHEM 4,A01,184675,Bussey; Thomas J,97,0,100,3
1683684309022,CHEM 6A,A01,184677,Staff,32,0,60,28
1683684310050,CHEM 6B,A01,184679,Staff,63,0,100,37
1683684311076,CHEM 6C,A01,184681,Bussey; Thomas J,0,0,50,50
1683684311076,CHEM 6C,A02,184682,Bussey; Thomas J,32,0,50,18
1683684312104,CHEM 40A,A01,184684,Albizati; Kim F.,33,0,100,67
1683684313128,CHEM 40B,A01,184686,Albizati; Kim F.,0,22,100,100
1683684314154,CHEM 41B,A01,184690,Staff,51,0,100,49
1683684315183,COGS 3,A01,184715,Boyle; Mary E. T.,0,27,40,40
1683684316207,COGS 14B,A01,185172,Staff,0,14,38,38
1683684317232,COGS 18,A01,184736,Staff,14,0,80,66
1683684318258,COGS 100,A01,184932,Staff,0,8,73,73
1683684319291,COGS 101A,A01,184935,Staff,0,40,30,30
1683684320315,COGS 101B,A01,184944,Staff,0,2,30,30
1683684321344,COGS 101C,A01,184946,Staff,0,10,30,30
1683684322372,COGS 102A,A01,184951,Johnson; Christine M.,1,0,40,39
1683684323400,COGS 107B,A01,184953,Mooshagian; Eric Frederick,0,52,40,40
1683684324425,COGS 118B,A01,184959,Gupta; Anjum,0,50,40,40
1683684325449,COGS 153,A00,184961,Staff,0,16,30,30
1683684326474,COGS 177,A00,184962,Staff,1,21,30,29
1683684327502,COGS 187A,A01,184969,Boyle; Mary E. T.,0,19,40,40
1683684328529,COMM 10,A01,185174,Staff,0,5,25,25
1683684328529,COMM 10,A02,185189,Staff,0,2,25,25
1683684328529,COMM 10,A03,269821,Staff,0,1,0,0
1683684329565,COMM 100B,A02,185476,Staff,10,0,25,15
1683684329565,COMM 100B,A03,277340,Staff,25,0,25,0
1683684330589,COMM 100C,A01,185314,Staff,1,0,25,24
1683684330589,COMM 100C,A02,185327,Staff,17,0,25,8
1683684331617,COMM 110M,A00,185349,Staff,0,0,40,40
1683684332640,COMM 113T,A00,185352,Staff,25,0,40,15
1683684333666,COMM 114I,A00,185353,Staff,31,0,40,9
1683684334691,COMM 131,A00,185354,Staff,17,0,30,13
1683684335721,CSE 8A,A50,185358,Cao; Yingjun,0,46,10,10
1683684336750,CSE 8B,A01,185362,Staff,0,48,50,50
1683684337776,CSE 11,A01,185416,Cao; Yingjun,0,91,10,10
1683684338801,CSE 20,A01,185445,Briones; Jor-el Thomas Caparas,3,0,25,22
1683684339825,CSE 21,A01,185447,Staff,9,0,50,41
1683684340855,CSE 101,A01,185451,Staff,0,13,50,50
1683684340855,CSE 101,B01,185453,Jones; Miles E,0,14,50,50
1683684342908,CSE 141,A01,185458,Eldon; John,16,0,100,84
1683684343933,CSE 141L,A01,185461,Eldon; John,8,0,100,92
1683684344959,CSE 142,A01,185463,Staff,34,0,60,26
1683684344959,CSE 142,B01,201355,Staff,0,7,60,60
1683684345986,CSE 142L,A01,185470,Staff,34,0,60,26
1683684345986,CSE 142L,B01,201417,Staff,0,6,60,60
1683684347013,CSE 190,A00,201433,Staff,32,0,49,17
1683684348037,DOC 1,A01,259136,Strom; Megan C.,7,0,15,8
1683684348037,DOC 1,A02,259137,Strom; Megan C.,14,0,15,1
1683684348037,DOC 1,A03,259138,Strom; Megan C.,14,0,15,1
1683684348037,DOC 1,A04,259139,Strom; Megan C.,14,0,15,1
1683684349063,DOC 100D,A00,259140,Pass; Natalye Joann,14,0,25,11
1683684350087,DSGN 1,A01,184749,Rill; Bryan,0,26,30,30
1683684351112,DSGN 100,A01,185168,Staff,0,2,25,25
1683684352139,ECE 5,A01,185626,Morris; Karcher William,0,12,0,0
1683684353166,ECE 101,A01,185628,Staff,14,0,70,56
1683684354194,ECE 107,A01,185635,Baghdadchi; Saharnaz,0,0,20,20
1683684354194,ECE 107,A02,185638,Baghdadchi; Saharnaz,1,0,20,19
1683684355220,ECE 148,A01,185647,Silberman; Jack,0,0,16,16
1683684356246,ECON 1,A01,185537,Crane; Meredith Helen,54,0,70,16
1683684357269,ECON 3,A01,185549,Crane; Meredith Helen,30,0,70,40
1683684358298,ECON 4,A01,203354,Anderson; John Charles,0,5,10,10
1683684359322,ECON 100A,A01,185574,Staff,0,5,40,40
1683684360346,ECON 100B,A01,185576,Staff,0,12,50,50
1683684361371,ECON 100C,A01,185589,Newhouse; Herbert S,30,0,70,40
1683684362397,ECON 105,A00,185608,Vespa; Emanuel Ignacio,19,0,35,16
1683684363424,ECON 109,A01,185610,Shishkin; Denis,9,0,35,26
1683684364450,ECON 110A,A01,185612,Staff,9,0,40,31
1683684365478,ECON 120A,A01,185615,Staff,19,0,40,21
1683684366501,ECON 120C,A01,185617,Sun; Yixiao,0,21,70,70
1683684367530,ECON 144,A00,203346,Squires; Dale E,2,0,35,33
1683684368559,ECON 171,A01,203349,Newhouse; Herbert S,0,1,35,35
1683684369583,ECON 173A,A01,185621,Toda; Alexis Akira,21,0,35,14
1683684370614,EDS 25,A01,202413,Staff,0,1,0,0
1683684370614,EDS 25,A02,202414,Staff,0,1,0,0
1683684370614,EDS 25,A03,202415,Staff,0,0,0,0
1683684370614,EDS 25,A04,202416,Staff,0,1,0,0
1683684370614,EDS 25,A05,202439,Staff,0,0,0,0
1683684370614,EDS 25,A06,202440,Staff,0,0,0,0
1683684370614,EDS 25,B01,202631,Staff,0,0,0,0
1683684370614,EDS 25,B02,202632,Staff,0,0,0,0
1683684370614,EDS 25,B03,202639,Staff,0,0,0,0
1683684370614,EDS 25,B04,202640,Staff,0,0,0,0
1683684370614,EDS 25,B05,202643,Staff,0,0,0,0
1683684370614,EDS 25,B06,202644,Staff,0,0,0,0
1683684371641,EDS 38,A01,202659,Black; Alison Michelle,24,0,25,1
1683684372669,EDS 115,A00,202652,Staff,18,0,30,12
1683684373751,EDS 125,A00,202649,Staff,13,0,30,17
1683684374778,EDS 126,A01,203332,Staff,30,0,30,0
1683684375806,EDS 139,A00,202838,Staff,16,0,25,9
1683684376830,EDS 146,A01,202655,Staff,14,0,25,11
1683684377858,ENG 15,A00,185667,Staff,0,1,0,0
1683684377858,ENG 15,B00,185672,Staff,0,0,0,0
1683684377858,ENG 15,C00,185675,Staff,0,0,0,0
1683684377858,ENG 15,D00,185682,Staff,0,0,0,0
1683684377858,ENG 15,E00,185684,Staff,0,0,0,0
1683684378883,ETHN 103,A00,185710,Staff,0,8,35,35
1683684379907,ETHN 103A,A00,199228,Man; Simeon S,0,0,9,9
1683684380934,ETHN 109,A00,185711,Staff,15,0,35,20
1683684381957,ETHN 142,A00,185726,Staff,0,4,30,30
1683684382981,ETHN 163J,A00,199229,Man; Simeon S,5,0,8,3
1683684384003,ETHN 168,A00,185727,Staff,7,0,10,3
1683684385028,ETHN 182,A00,185728,Staff,0,0,35,35
1683684386057,ETHN 183,A00,185737,Staff,9,0,18,9
1683684387080,GLBH 111,A01,209361,Burgos; Jose L.,0,0,0,0
1683684389134,HIEU 104,A00,185792,Staff,14,0,20,6
1683684390159,HIEU 115,A00,185800,Staff,0,0,20,20
1683684391185,HIEU 128,A00,185801,Staff,0,9,20,20
1683684392208,HIEU 147,A00,185802,Staff,15,0,20,5
1683684393231,HIEU 154,A00,185823,Staff,11,0,20,9
1683684394259,HILA 102,A00,185826,Staff,14,0,20,6
1683684395281,HILD 2C,A01,185778,Staff,0,13,20,20
1683684396306,HILD 7B,A01,185780,Kwak; Nancy,0,17,32,32
1683684396306,HILD 7B,A02,185781,Kwak; Nancy,0,18,32,32
1683684397330,HILD 30,A01,185791,Staff,12,0,20,8
1683684398362,HISC 119,A00,185830,Golan; Tal,0,10,20,20
1683684399387,HITO 156GS,A00,185831,Patterson; Patrick H.,0,0,0,23
1683684400414,HIUS 103,A00,185832,Man; Simeon S,0,4,20,20
1683684401438,HIUS 117,A00,185836,Kwak; Nancy,2,0,20,18
1683684402460,HIUS 125,A00,185840,Man; Simeon S,0,2,23,23
1683684403485,HIUS 149,A00,185845,Staff,1,0,20,19
1683684404513,HUM 3,A01,185882,Zavodny; Tatiana Sophia,0,8,50,50
1683684404513,HUM 3,B01,185899,Caldwell; Michael Alan,0,18,50,50
1683684405536,HUM 3GS,A00,185900,Patterson; Patrick H.,0,0,0,23
1683684406565,HUM 4,A01,185938,Zroka; Amy Liane,28,0,50,22
1683684406565,HUM 4,B01,185956,Watkins; Eric,0,6,50,50
1683684406565,HUM 4,B02,202209,Watkins; Eric,0,5,50,50
1683684406565,HUM 4,B03,202210,Watkins; Eric,0,5,50,50
1683684407592,HUM 5,A01,185958,West; Geoffrey Scott,0,0,50,50
1683684407592,HUM 5,A02,202215,West; Geoffrey Scott,0,0,50,50
1683684408620,INTL 190,A00,185959,Gagnon; Jeffrey C,0,0,0,9
1683684408620,INTL 190,B00,185960,Lettieri; Michael Joseph,0,0,0,2
1683684409647,JAPN 180,A00,254509,Staff,5,0,30,25
1683684410674,LATI 10,A01,202853,Kennemore; Amy Michelle,4,0,35,31
1683684410674,LATI 10,A02,202854,Kennemore; Amy Michelle,3,0,35,32
1683684410674,LATI 10,A03,270054,Kennemore; Amy Michelle,30,0,30,0
1683684411701,LATI 180,A00,202855,Kennemore; Amy Michelle,11,0,20,9
1683684412728,LAWS 101,A00,201767,Golan; Tal,0,7,40,40
1683684413754,LIFR 1C,A00,185961,Staff,6,0,20,14
1683684414779,LIFR 1CX,A00,185962,Staff,7,0,20,13
1683684415807,LIFR 1D,A00,185963,Staff,7,0,20,13
1683684416834,LIFR 1DX,A00,185964,Staff,7,0,20,13
1683684417858,LIGN 101,A01,186039,Staff,43,0,50,7
1683684418882,LIGN 165,A00,186040,Staff,15,0,50,35
1683684419905,LTCS 108,A00,186041,Staff,5,0,10,5
1683684420928,LTCS 119,A00,186042,Staff,15,0,20,5
1683684421956,LTCS 130,A00,186043,Wesling; Megan E.,15,0,25,10
1683684424005,LTEA 138,A00,186119,Staff,14,0,40,26
1683684425030,LTEN 124,A00,186148,Staff,5,0,25,20
1683684426055,LTEN 178,A00,186149,Staff,6,0,15,9
1683684427080,LTEN 181,A00,186150,Blanco; John D,34,0,40,6
1683684428112,LTWL 120,A00,186160,Staff,19,0,25,6
1683684429136,LTWL 165,A00,186161,Staff,22,0,25,3
1683684430160,LTWR 100,A00,186162,Staff,0,5,15,15
1683684431185,LTWR 102,A00,186163,Doller; Ben,5,0,15,10
1683684432211,MAE 8,A01,186412,Staff,0,1,0,0
1683684433234,MAE 30B,A00,186445,Bahadori; Mohammad Yousef,81,0,100,19
1683684434257,MAE 40,A00,186592,Bewley; Thomas R,10,0,50,40
1683684435282,MAE 101B,A00,186593,Bahadori; Mohammad Yousef,80,0,100,20
1683684436310,MAE 105,A00,186594,Bandaru; Prabhakar,10,0,50,40
1683684437334,MAE 107,A00,186599,Pham; Hieu Tan,0,7,120,120
1683684438359,MAE 148,A01,186660,Silberman; Jack,3,0,16,13
1683684439386,MATH 10A,A01,188095,Staff,0,6,35,35
1683684440420,MATH 10B,A01,188097,Bowers; Adam R.,0,12,30,30
1683684440420,MATH 10B,A02,188099,Bowers; Adam R.,0,11,30,30
1683684440420,MATH 10B,B01,188104,Bowers; Adam R.,0,10,30,30
1683684440420,MATH 10B,B02,188106,Bowers; Adam R.,1,9,30,29
1683684441448,MATH 10C,A01,188111,Staff,0,20,30,30
1683684441448,MATH 10C,A02,188127,Staff,0,19,30,30
1683684441448,MATH 10C,A03,188131,Staff,0,19,30,30
1683684441448,MATH 10C,B01,188218,Staff,17,0,30,13
1683684441448,MATH 10C,B02,188244,Staff,13,0,30,17
1683684441448,MATH 10C,B03,188277,Staff,14,0,30,16
1683684442479,MATH 18,A01,188344,Bach; Quang Tran,18,0,30,12
1683684442479,MATH 18,A02,188345,Bach; Quang Tran,11,0,30,19
1683684442479,MATH 18,B01,188353,Bach; Quang Tran,11,0,30,19
1683684442479,MATH 18,B02,188354,Bach; Quang Tran,19,0,30,11
1683684443504,MATH 20A,A01,188374,Staff,11,0,35,24
1683684444533,MATH 20B,A01,188382,Ohm; Ko Woon,7,0,30,23
1683684444533,MATH 20B,A02,188383,Ohm; Ko Woon,22,0,30,8
1683684444533,MATH 20B,B01,188385,Ohm; Ko Woon,7,0,30,23
1683684444533,MATH 20B,B02,188392,Ohm; Ko Woon,22,0,30,8
1683684445558,MATH 20C,A01,188394,Harel; Guershon,10,0,30,20
1683684445558,MATH 20C,A02,188395,Harel; Guershon,13,0,30,17
1683684445558,MATH 20C,B01,188404,Harel; Guershon,5,0,30,25
1683684445558,MATH 20C,B02,188405,Harel; Guershon,18,0,30,12
1683684446588,MATH 20D,A01,188414,Hammock; Frances H,0,1,30,30
1683684446588,MATH 20D,A02,188415,Hammock; Frances H,0,1,30,30
1683684446588,MATH 20D,B01,188447,Hammock; Frances H,0,1,30,30
1683684446588,MATH 20D,B02,188486,Hammock; Frances H,3,0,30,27
1683684447614,MATH 20E,A01,188649,Staff,21,0,30,9
1683684447614,MATH 20E,A02,188650,Staff,20,0,30,10
1683684447614,MATH 20E,A03,188673,Staff,0,0,30,30
1683684448642,MATH 102,A01,188675,Staff,0,39,35,35
1683684449676,MATH 103B,A01,188681,Staff,3,0,35,32
1683684449676,MATH 103B,B01,188692,Staff,5,0,35,30
1683684450699,MATH 109,A01,188695,Salehi Golsefidy; Alireza,24,0,35,11
1683684450699,MATH 109,A02,188696,Salehi Golsefidy; Alireza,25,0,35,10
1683684451724,MATH 120A,A01,188698,Eggers; John Dietrich,7,0,35,28
1683684452747,MATH 142B,A01,188736,Ioana; Adrian,1,1,30,29
1683684452747,MATH 142B,A02,188741,Ioana; Adrian,0,1,30,30
1683684452747,MATH 142B,A03,188743,Ioana; Adrian,0,1,30,30
1683684453770,MATH 168A,A01,188790,Staff,0,11,35,35
1683684454798,MATH 170A,A01,188803,Nie; Jiawang,0,2,35,35
1683684454798,MATH 170A,A02,188811,Nie; Jiawang,0,1,35,35
1683684454798,MATH 170A,A03,188814,Nie; Jiawang,0,0,35,35
1683684454798,MATH 170A,A04,188815,Nie; Jiawang,6,0,35,29
1683684455823,MATH 193B,A01,188817,Staff,0,0,35,35
1683684455823,MATH 193B,A02,188818,Staff,5,0,35,30
1683684456850,MGT 4,A01,202857,Anderson; John Charles,59,0,80,21
1683684457875,MGT 12,A00,202858,Lindenberger; Wade Douglas,40,0,90,50
1683684458899,MGT 18,A00,202859,Staff,74,0,90,16
1683684459923,MGT 18GS,A00,202860,McKay; Michael J,13,0,28,15
1683684460950,MGT 45,A00,202861,Pecore; Joseph P.,8,0,90,82
1683684461978,MGT 100,A00,202863,Yavorsky; Daniel Ryan,28,0,90,62
1683684463002,MGT 103,A00,202864,Ehrich; Kristine R,0,19,90,90
1683684464026,MGT 112,A00,202865,Ehrich; Kristine R,15,0,90,75
1683684465051,MGT 121A,A00,202868,Staff,90,20,90,0
1683684466075,MGT 131B,A00,202869,Anderson; John Charles,59,0,90,31
1683684467100,MGT 136,A00,202871,Lindenberger; Wade Douglas,83,0,90,7
1683684468123,MGT 164,A00,202873,Staff,0,68,90,91
1683684469148,MGT 164GS,A00,202874,McKay; Mary A,13,0,28,15
1683684470175,MGT 180,A00,202875,Staff,0,51,90,91
1683684471201,MMW 11R,A01,205019,Herbst; Matthew,0,0,30,30
1683684471201,MMW 11R,A02,205026,Herbst; Matthew,29,0,30,1
1683684472229,MMW 15,A01,193512,Chang; Edmond Yi-Teh,0,8,28,28
1683684472229,MMW 15,A02,193513,Chang; Edmond Yi-Teh,0,5,28,28
1683684472229,MMW 15,A03,193514,Chang; Edmond Yi-Teh,0,5,28,28
1683684472229,MMW 15,A04,193515,Chang; Edmond Yi-Teh,0,5,28,28
1683684472229,MMW 15,A05,193516,Chang; Edmond Yi-Teh,0,5,28,28
1683684472229,MMW 15,A06,193517,Chang; Edmond Yi-Teh,0,6,28,28
1683684472229,MMW 15,B01,193519,Chang; Edmond Yi-Teh,0,5,28,28
1683684472229,MMW 15,B02,193520,Chang; Edmond Yi-Teh,0,5,28,28
1683684472229,MMW 15,B03,193521,Chang; Edmond Yi-Teh,0,5,28,28
1683684472229,MMW 15,B04,193522,Chang; Edmond Yi-Teh,0,6,28,28
1683684472229,MMW 15,B05,193523,Chang; Edmond Yi-Teh,0,5,28,28
1683684472229,MMW 15,B06,193524,Chang; Edmond Yi-Teh,0,5,28,28
1683684473254,MMW 122,A01,193526,Rahimi; Babak,0,16,28,28
1683684473254,MMW 122,A02,193527,Rahimi; Babak,0,15,28,28
1683684473254,MMW 122,A03,193528,Rahimi; Babak,0,0,0,0
1683684473254,MMW 122,A04,193529,Rahimi; Babak,0,0,0,0
1683684474277,MUS 1A,A01,186663,Staff,1,19,35,34
1683684475300,MUS 4,A01,186715,Staff,0,12,35,35
1683684476325,MUS 5R,A01,186796,Dubnov; Shlomo,0,17,35,35
1683684477406,MUS 6,A01,186798,Staff,1,5,25,24
1683684478430,MUS 7,A01,186830,Staff,11,0,35,24
1683684479454,MUS 8,A01,186930,Staff,0,27,35,35
1683684480479,MUS 15,A01,186932,Staff,0,15,35,35
1683684480479,MUS 15,B01,186934,Staff,1,17,35,34
1683684481505,MUS 80,A00,186935,Staff,0,0,20,20
1683684481505,MUS 80,B00,186936,Staff,24,0,25,1
1683684482530,NANO 11,A00,204702,Lipomi; Darren John,0,0,0,0
1683684483554,NANO 15,A01,204709,Yang; Kesong,0,1,0,0
1683684484582,NANO 114,A00,202069,Jahed Motlagh; Zeinab,3,0,10,7
1683684485606,PHIL 1,A00,186955,Grush; Rick Scott,31,0,40,9
1683684486630,PHIL 10,A01,186973,Grush; Rick Scott,27,0,35,8
1683684486630,PHIL 10,A02,186974,Grush; Rick Scott,33,0,35,2
1683684487660,PHIL 13,A01,186976,Staff,1,0,35,34
1683684487660,PHIL 13,A02,186977,Staff,16,0,35,19
1683684488685,PHIL 14,A01,186979,Staff,31,0,35,4
1683684488685,PHIL 14,A02,186986,Staff,32,0,35,3
1683684489714,PHIL 28,A01,186988,Staff,16,0,30,14
1683684489714,PHIL 28,A02,186989,Staff,1,0,30,29
1683684489714,PHIL 28,A03,186990,Staff,10,0,30,20
1683684489714,PHIL 28,A04,186991,Staff,26,0,30,4
1683684490736,PHIL 120,A00,186997,Staff,23,0,40,17
1683684491760,PHIL 137,A00,187003,Staff,7,0,40,33
1683684492787,PHIL 150,A00,187015,Staff,47,0,70,23
1683684493813,PHIL 167,A00,187021,Lamey; Andy M.,34,0,40,6
1683684494838,PHIL 174,A01,202226,Staff,17,0,20,3
1683684494838,PHIL 174,A02,202235,Staff,20,0,20,0
1683684495865,PHIL 191A,A00,258918,Staff,0,0,1,1
1683684496888,PHYS 1A,A00,187028,Staff,26,0,60,34
1683684497916,PHYS 1AL,001,187036,Staff,3,0,30,27
1683684497916,PHYS 1AL,002,187049,Staff,18,0,30,12
1683684498940,PHYS 1B,A00,187058,Staff,22,0,60,38
1683684499963,PHYS 1BL,001,187064,Staff,0,1,30,30
1683684499963,PHYS 1BL,002,187070,Staff,4,0,30,26
1683684500988,PHYS 1C,A00,187082,Staff,29,0,120,91
1683684502015,PHYS 1CL,001,187088,Staff,0,9,30,30
1683684502015,PHYS 1CL,002,187089,Staff,0,1,30,30
1683684502015,PHYS 1CL,009,262693,Staff,9,0,30,21
1683684503040,PHYS 2B,A01,187097,Staff,55,0,115,60
1683684504067,PHYS 2C,A01,187099,Staff,63,0,115,52
1683684505093,PHYS 2CL,A01,187101,Staff,5,0,28,23
1683684505093,PHYS 2CL,A02,187102,Staff,15,0,28,13
1683684506117,PHYS 2D,A01,187123,Shotwell; Brian,95,0,115,20
1683684507141,PHYS 4B,A01,187133,Grinstein; Benjamin,35,0,50,15
1683684508170,POLI 10,A00,188819,Staff,0,4,50,50
1683684509196,POLI 11,A00,188827,Staff,43,0,50,7
1683684510223,POLI 13R,A00,188828,Staff,0,1,20,20
1683684511246,POLI 27,A01,188830,Elgin; Samuel Zincke,0,2,70,70
1683684512270,POLI 30,A00,188832,Desposato; Scott,30,0,50,20
1683684513293,POLI 102F,A00,188834,Staff,1,0,40,39
1683684514321,POLI 104A,A00,188852,Staff,12,0,30,18
1683684515349,POLI 104I,A00,188853,Staff,0,8,20,20
1683684516374,POLI 110B,A00,188854,Wiens; David,6,0,20,14
1683684517398,POLI 112A,A00,188855,Wiens; David,3,0,30,27
1683684518423,POLI 117R,A00,188856,Forman; Fonna,0,12,20,20
1683684519451,POLI 118,A00,188857,Ingham; Sean,8,0,20,12
1683684520476,POLI 120G,A00,188858,Staff,8,0,30,22
1683684521500,POLI 131CR,A00,188863,Hoston; Germaine,20,0,50,30
1683684522528,POLI 133,A00,188864,Nellis; Gareth Hb,44,0,50,6
1683684523552,POLI 134D,A00,188865,Desposato; Scott,27,0,30,3
1683684524575,POLI 142A,A00,188871,Gartzke; Erik,21,0,50,29
1683684525599,POLI 142K,A00,188874,Staff,38,0,50,12
1683684526627,POLI 143,A00,188940,Gartzke; Erik,16,0,30,14
1683684527654,POLI 153,A00,188943,Staff,2,0,20,18
1683684528680,POLI 160AA,A00,188944,Staff,10,0,40,30
1683684529707,POLI 170A,A00,188945,Staff,10,0,30,20
1683684531762,PSYC 1,A00,188952,Staff,36,0,90,54
1683684532786,PSYC 2,B00,188953,Staff,19,0,35,16
1683684533813,PSYC 6,A00,188970,Staff,47,0,60,13
1683684534838,PSYC 7,A00,188973,Staff,35,0,45,10
1683684535864,PSYC 60,A01,188980,Rickard; Timothy C.,42,0,60,18
1683684536892,PSYC 70,A01,189001,Steiner; Eric Tomas,21,0,45,24
1683684537917,PSYC 100,A00,189005,Lacefield; Katharine I,0,99,120,120
1683684538940,PSYC 102,A00,189008,Staff,7,0,30,23
1683684539964,PSYC 106,B00,189026,Gorman; Michael R.,27,0,60,33
1683684540992,PSYC 114,B01,189033,Winkielman; Piotr,0,31,30,30
1683684542019,PSYC 131,A00,189036,Anagnostaras; Stephan,0,43,60,60
1683684543043,PSYC 136,A00,189041,Lowe; Angela Beth,0,7,25,25
1683684544070,PSYC 137,A00,189057,Winkielman; Piotr,1,37,25,24
1683684545097,PSYC 144,A00,189107,Wixted; John T,0,11,50,50
1683684547148,PSYC 162,A00,189142,Staff,0,9,85,85
1683684548173,PSYC 172,A00,189144,Gorman; Michael R.,0,6,30,30
1683684550223,PSYC 179,A00,189146,Lacefield; Katharine I,0,87,120,120
1683684551251,PSYC 181,A00,189147,Anagnostaras; Stephan,0,44,90,90
1683684552273,PSYC 190R,A00,189148,Barner; David A.,0,23,80,80
1683684553297,PSYC 191,A00,189275,Rickard; Timothy C.,0,10,25,25
1683684554324,PSYC 193,A00,189276,Chapman; Eddie Nathaniel,0,1,0,4
1683684555347,PSYC 193L,A01,189281,Lowe; Angela Beth,8,0,20,12
1683684555347,PSYC 193L,B01,189285,Staff,28,0,35,7
1683684556371,RELI 149,A00,187137,Rahimi; Babak,6,0,40,34
1683684557396,SE 9,A01,187315,Staff,0,2,18,18
1683684558419,SE 101B,A00,187409,Staff,24,0,30,6
1683684559444,SE 110B,A00,187444,Staff,10,0,40,30
1683684560475,SE 130B,A00,187449,Staff,31,0,40,9
1683684561502,SE 150A,A00,187516,Staff,8,0,20,12
1683684562527,SE 154,A00,187528,Staff,29,0,50,21
1683684563551,SIO 3,A01,258171,Staff,35,0,40,5
1683684564576,SIO 10,A00,187144,Cook; Geoffrey W,1,7,75,74
1683684565600,SIO 45,A00,187152,Cook; Geoffrey W,0,7,100,100
1683684566627,SIO 109R,A00,194486,Staff,0,4,20,20
1683684568676,SIO 187,A01,187233,Kacev; David,12,0,40,28
1683684569706,SOCI 1,A01,258656,Thorpe; Charles Robert,28,0,30,2
1683684569706,SOCI 1,A02,258658,Thorpe; Charles Robert,30,0,30,0
1683684569706,SOCI 1,A03,258661,Thorpe; Charles Robert,25,0,25,0
1683684569706,SOCI 1,A04,258666,Thorpe; Charles Robert,22,0,25,3
1683684569706,SOCI 1,A05,258897,Thorpe; Charles Robert,22,0,25,3
1683684569706,SOCI 1,A06,258898,Thorpe; Charles Robert,25,0,25,0
1683684570731,SOCI 30,A01,258903,Pardo Guerra; Juan Pablo,14,0,30,16
1683684571754,SOCI 102,A00,258904,Staff,9,0,25,16
1683684572777,SOCI 106,A00,258905,Staff,19,0,25,6
1683684573805,SOCI 111,A00,258907,Ribas Norris; Janet Vanesa,26,0,30,4
1683684574828,SOCI 121R,A00,258908,Pardo Guerra; Juan Pablo,8,0,30,22
1683684575853,SOCI 126,A01,203330,Staff,14,0,20,6
1683684576878,SOCI 131,A00,258909,Thorpe; Charles Robert,30,0,60,30
1683684577907,SOCI 135,A00,258910,Payne; Christine Anna,0,12,30,30
1683684578934,SOCI 157,A00,258911,Staff,11,0,30,19
1683684579959,SOCI 184,A00,258912,Staff,25,0,30,5
1683684581058,SOCI 188D,A00,258913,Staff,22,0,30,8
1683684582082,SYN 2,001,187529,Staff,9,0,16,7
1683684582082,SYN 2,002,201452,Staff,1,20,16,15
1683684582082,SYN 2,003,201469,Staff,1,0,16,15
1683684583105,SYN 100,A01,187531,Staff,0,9,20,20
1683684583105,SYN 100,B01,201491,Staff,0,10,20,20
1683684584130,TDAC 1,A00,189286,Walsh; Kim C.,3,0,20,17
1683684584130,TDAC 1,B00,189287,Harting; Carla Kelso,10,0,20,10
1683684585157,TDAC 101,A00,189300,Walsh; Kim C.,16,0,20,4
1683684585157,TDAC 101,B00,189301,Harting; Carla Kelso,18,0,20,2
1683684586181,TDAC 102,A00,189304,Basso; Beatrice,14,0,20,6
1683684587205,TDAC 108,A00,189305,Staff,18,0,20,2
1683684588230,TDDE 131,A00,189310,Staff,19,0,20,1
1683684588230,TDDE 131,B00,189314,Staff,19,0,20,1
1683684588230,TDDE 131,C00,189315,Staff,48,0,50,2
1683684588230,TDDE 131,D00,189316,Staff,14,0,15,1
1683684588230,TDDE 131,E00,204841,Staff,20,0,20,0
1683684589254,TDGE 10,A00,189289,Staff,27,0,50,23
1683684589254,TDGE 10,B00,189290,Havis; Allan,0,1,50,50
1683684590281,TDGE 11,A00,189291,Fulton; Julia,0,4,50,50
1683684590281,TDGE 11,B00,189292,Staff,20,0,25,5
1683684590281,TDGE 11,C00,260270,Staff,0,0,0,0
1683684591306,TDGE 25,A00,189294,Staff,1,0,20,19
1683684592333,TDGE 124,A00,189318,Fulton; Julia,0,8,50,50
1683684593361,TDGE 125,A00,189319,Staff,13,0,25,12
1683684593361,TDGE 125,B00,189320,Staff,23,0,25,2
1683684594388,TDGE 127,A00,189322,Havis; Allan,0,0,50,50
1683684595412,TDHT 101,A00,189323,Staff,18,0,25,7
1683684595412,TDHT 101,B00,189324,Staff,25,0,25,0
1683684596436,TDHT 102,A00,189325,Staff,49,0,50,1
1683684597463,TDMV 1,A00,189295,Arcidiacono; Kristin,20,0,30,10
1683684597463,TDMV 1,B00,189296,Caligagan; Maria T.,24,0,30,6
1683684598488,TDMV 2,A00,189297,Sammartano; Tonnie,27,0,30,3
1683684598488,TDMV 2,B00,189299,Arcidiacono; Kristin,23,0,30,7
1683684599513,TDMV 3,A00,204998,Rincon; Alicia,22,0,30,8
1683684600536,TDMV 120,A00,189458,Sammartano; Tonnie,28,0,30,2
1683684601561,TDMV 138,A00,189541,Jun; Grace Shin Hae,20,0,40,20
1683684602586,TDMV 142,A00,189717,Caligagan; Tony,25,0,30,5
1683684602586,TDMV 142,B00,189718,Caligagan; Maria T.,25,0,30,5
1683684603612,TMC 2,A01,187533,Staff,25,0,25,0
1683684603612,TMC 2,A02,187534,Staff,25,0,25,0
1683684604636,USP 1,A01,187536,Kwak; Nancy,0,16,25,25
1683684605661,USP 5,A01,187538,Staff,8,0,25,17
1683684606688,USP 101,A00,199253,Staff,0,4,0,0
1683684607711,USP 124,A00,187562,Boomhower; Matthew Charles,0,0,30,30
1683684608734,USP 138,A00,187582,Staff,19,0,25,6
1683684609759,USP 152,A01,187597,Staff,3,0,25,22
1683684610785,USP 153,A00,187598,Staff,18,0,25,7
1683684611810,USP 168,A00,187607,Kwak; Nancy,2,0,5,3
1683684612838,USP 173,A00,187619,Staff,4,0,25,21
1683684613862,USP 181,A00,187638,Staff,0,4,25,25
1683684614885,VIS 103,A00,187650,Cruz; Edwin Teddy,17,0,75,58
1683684615909,VIS 110D,A00,187669,Staff,13,0,22,9
1683684616932,VIS 127C,A00,187720,Shen; Kuiyi,67,0,146,79
1683684617959,VIS 149,A00,187731,Yoldas; Pinar,1,14,22,21
1683684618983,VIS 151,A01,188091,Staff,22,0,34,12
1683684618983,VIS 151,A02,188092,Staff,11,0,34,23
1683684620006,VIS 160B,A00,188093,Stalbaum; Brett,0,1,10,10
1683684622055,WCWP 10B,A00,201720,Staff,0,0,5,5
1683684622055,WCWP 10B,B00,201722,Staff,0,0,6,6
1683684623078,WCWP 100,A00,201725,Gagnon; Jeffrey C,0,0,2,2
1683684623078,WCWP 100,B00,201727,Staff,0,4,15,15
1683684626174,ANBI 133,A00,258401,Wilder; Linnea Lorene,34,0,40,6
1683684627200,ANBI 140,A00,258395,Hrvoj Mihic; Branka,18,0,25,7
1683684628226,ANSC 120,A00,258402,Bialecki; Jon Anthony,26,0,40,14
1683684629250,ANSC 144,A00,258400,Staff,12,0,40,28
1683684631303,ANSC 166,A00,258396,Parish; Steven Martin,156,0,175,19
1683684632334,ANSC 180,A00,193533,Staff,8,0,20,12
1683684633359,ANSC 188,A00,258397,Jassal; Aftab,34,0,40,6
1683684634383,ANTH 3,A01,258316,Staff,23,0,30,7
1683684635406,ANTH 5,A00,258394,Semendeferi; Ekaterini,16,0,20,4
1683684636430,ANTH 21,A01,258331,Staff,4,0,40,36
1683684637458,ANTH 103,A00,258398,Varma; Saiba,15,0,25,10
1683684638491,AWP 10,001,202034,Staff,0,0,0,0
1683684638491,AWP 10,002,202035,Staff,0,0,0,0
1683684638491,AWP 10,003,202036,Staff,0,0,0,0
1683684638491,AWP 10,004,202037,Staff,0,0,0,0
1683684638491,AWP 10,005,202038,Staff,0,0,0,0
1683684638491,AWP 10,006,202039,Staff,0,0,0,0
1683684638491,AWP 10,007,202040,Staff,0,0,0,0
1683684638491,AWP 10,008,202041,Staff,0,0,0,0
1683684638491,AWP 10,009,202042,Staff,0,0,0,0
1683684638491,AWP 10,010,202043,Staff,0,0,0,0
1683684638491,AWP 10,011,202044,Staff,0,0,0,0
1683684638491,AWP 10,012,202045,Staff,0,0,0,0
1683684638491,AWP 10,013,202046,Staff,0,0,0,0
1683684638491,AWP 10,014,202047,Staff,0,0,0,0
1683684638491,AWP 10,015,202048,Staff,0,0,0,0
1683684638491,AWP 10,016,202049,Staff,0,0,0,0
1683684638491,AWP 10,017,202050,Staff,0,0,0,0
1683684638491,AWP 10,018,202051,Staff,0,0,0,0
1683684638491,AWP 10,019,202052,Staff,0,0,0,0
1683684638491,AWP 10,020,202053,Staff,0,0,0,0
1683684638491,AWP 10,021,202054,Staff,0,0,0,0
1683684638491,AWP 10,022,202055,Staff,0,0,0,0
1683684638491,AWP 10,023,202056,Staff,0,0,0,0
1683684638491,AWP 10,024,202057,Staff,0,0,0,0
1683684638491,AWP 10,025,202058,Staff,0,0,0,0
1683684638491,AWP 10,026,202059,Staff,0,0,0,0
1683684639518,AWP 102,001,202032,Staff,0,0,0,0
1683684639518,AWP 102,002,202033,Staff,0,0,0,0
1683684640543,BENG 100,A01,254234,Taylor Amos; Alyssa C,31,0,40,9
1683684641569,BENG 196,001,270013,Engler; Adam J.,9999,0,9999,0
1683684642593,BICD 100R,A01,202018,Smith; Laurie,0,7,32,32
1683684642593,BICD 100R,A02,202019,Smith; Laurie,0,3,32,32
1683684642593,BICD 100R,A03,202020,Smith; Laurie,0,1,32,32
1683684642593,BICD 100R,A04,202021,Smith; Laurie,6,0,32,26
1683684642593,BICD 100R,A05,202022,Smith; Laurie,10,0,32,22
1683684643619,BICD 136,A01,193242,Gustafson-Brown; Cindy,0,2,32,32
1683684643619,BICD 136,A02,193244,Gustafson-Brown; Cindy,13,0,32,19
1683684644644,BIEB 102,A01,193249,Butler; Shannon Rhey,1,1,32,31
1683684644644,BIEB 102,A02,193251,Butler; Shannon Rhey,0,0,32,32
1683684644644,BIEB 102,A03,193253,Butler; Shannon Rhey,0,0,32,32
1683684644644,BIEB 102,A04,193255,Butler; Shannon Rhey,13,0,32,19
1683684644644,BIEB 102,A05,193265,Butler; Shannon Rhey,25,0,32,7
1683684644644,BIEB 102,A06,193269,Butler; Shannon Rhey,13,0,32,19
1683684646700,BIEB 150,A01,193274,Staff,0,0,32,32
1683684646700,BIEB 150,A02,193285,Staff,24,0,32,8
1683684647725,BIEB 194,A00,193286,Kurle; Carolyn M.,19,0,32,13
1683684648755,BILD 1,A01,192291,Staff,15,0,32,17
1683684648755,BILD 1,A02,192292,Staff,30,0,32,2
1683684648755,BILD 1,B01,192520,Reuther; Keefe,0,1,0,0
1683684648755,BILD 1,B02,192532,Reuther; Keefe,0,1,0,0
1683684649780,BILD 3,A01,192556,Butler; Shannon Rhey,0,0,32,32
1683684649780,BILD 3,A02,192581,Butler; Shannon Rhey,0,1,32,32
1683684649780,BILD 3,A03,192611,Butler; Shannon Rhey,19,0,32,13
1683684649780,BILD 3,A04,192612,Butler; Shannon Rhey,24,0,32,8
1683684649780,BILD 3,A05,192613,Butler; Shannon Rhey,26,0,32,6
1683684649780,BILD 3,A06,192679,Butler; Shannon Rhey,27,0,32,5
1683684649780,BILD 3,A07,192682,Butler; Shannon Rhey,20,0,32,12
1683684650805,BILD 4,A01,192836,Reuther; Keefe,1,0,24,23
1683684650805,BILD 4,A02,193044,Reuther; Keefe,4,0,24,20
1683684651828,BILD 10,A01,193142,Gustafson-Brown; Cindy,29,0,32,3
1683684651828,BILD 10,A02,193149,Gustafson-Brown; Cindy,31,0,32,1
1683684652853,BIMM 100,A01,193301,Staff,0,6,32,32
1683684652853,BIMM 100,A02,193312,Staff,0,7,32,32
1683684652853,BIMM 100,A03,193323,Staff,0,10,32,32
1683684653879,BIMM 101,A01,193329,McDonnell; Lisa Marie,1,4,24,23
1683684653879,BIMM 101,A02,193339,McDonnell; Lisa Marie,1,4,24,23
1683684653879,BIMM 101,B01,193354,McDonnell; Lisa Marie,0,4,24,24
1683684653879,BIMM 101,B02,193357,McDonnell; Lisa Marie,0,3,24,24
1683684654906,BIMM 110,A01,193377,Tat; John,0,11,32,32
1683684654906,BIMM 110,A02,193378,Tat; John,0,11,32,32
1683684655934,BIMM 120,A01,206116,Staff,0,0,32,32
1683684655934,BIMM 120,A02,206117,Staff,7,0,32,25
1683684655934,BIMM 120,A03,206121,Staff,21,0,32,11
1683684656958,BIPN 100,A01,193393,Park; Ji Young,0,15,32,32
1683684656958,BIPN 100,A02,193402,Park; Ji Young,0,14,32,32
1683684656958,BIPN 100,A03,193413,Park; Ji Young,0,14,32,32
1683684656958,BIPN 100,A04,193414,Park; Ji Young,0,13,32,32
1683684657986,BIPN 102,A01,193429,Staff,0,0,32,32
1683684657986,BIPN 102,A02,193438,Staff,18,0,32,14
1683684659009,BIPN 106,A01,193450,Reyes Gonzalez; Catalina,0,2,40,40
1683684660039,BIPN 134,A01,193465,Cooke; James Edward,0,0,32,32
1683684660039,BIPN 134,A02,193474,Cooke; James Edward,25,0,32,7
1683684660039,BIPN 134,A03,193485,Cooke; James Edward,29,0,32,3
1683684660039,BIPN 134,A04,193486,Cooke; James Edward,20,0,32,12
1683684660039,BIPN 134,A05,193491,Cooke; James Edward,31,0,32,1
1683684660039,BIPN 134,A06,193501,Cooke; James Edward,30,0,32,2
1683684660039,BIPN 134,A07,193510,Cooke; James Edward,29,0,32,3
1683684662089,BISP 194,A00,222522,Staff,14,0,32,18
1683684663113,CAT 124,A01,202407,Staff,19,0,25,6
1683684664140,CAT 125,A00,202408,Marchisotto; Jennifer Anne,2,0,20,18
1683684665171,CAT 125R,A00,202409,Smith; Lauryn Alissa,0,11,20,20
1683684665171,CAT 125R,B00,202410,Morales; Celeste Georgianna,0,11,20,20
1683684665171,CAT 125R,C00,202411,Irwin; Matthew Joseph,0,12,20,20
1683684666199,CENG 15,A01,204712,Yang; Kesong,0,1,0,0
1683684667227,CENG 114,A00,202070,Jahed Motlagh; Zeinab,5,0,20,15
1683684668254,CGS 105,A00,185477,Wesling; Megan E.,24,0,40,16
1683684669280,CGS 106,A00,185494,Staff,11,0,22,11
1683684670304,CGS 108,A00,185495,Staff,14,0,20,6
1683684671331,CGS 114,A00,185496,Staff,13,0,18,5
1683684672356,CGS 119,A00,185501,Staff,15,0,20,5
1683684673384,CGS 120,A00,185511,Staff,12,0,20,8
1683684674410,CHEM 4,A01,184675,Bussey; Thomas J,97,0,100,3
1683684675437,CHEM 6A,A01,184677,Staff,32,0,60,28
1683684676464,CHEM 6B,A01,184679,Staff,63,0,100,37
1683684677493,CHEM 6C,A01,184681,Bussey; Thomas J,0,0,50,50
1683684677493,CHEM 6C,A02,184682,Bussey; Thomas J,32,0,50,18
1683684678517,CHEM 40A,A01,184684,Albizati; Kim F.,33,0,100,67
1683684679542,CHEM 40B,A01,184686,Albizati; Kim F.,0,22,100,100
1683684680566,CHEM 41B,A01,184690,Staff,51,0,100,49
1683684681590,COGS 3,A01,184715,Boyle; Mary E. T.,0,27,40,40
1683684682618,COGS 14B,A01,185172,Staff,0,14,38,38
1683684683646,COGS 18,A01,184736,Staff,14,0,80,66
1683684684731,COGS 100,A01,184932,Staff,0,8,73,73
1683684685755,COGS 101A,A01,184935,Staff,0,40,30,30
1683684686780,COGS 101B,A01,184944,Staff,0,2,30,30
1683684687805,COGS 101C,A01,184946,Staff,0,10,30,30
1683684688831,COGS 102A,A01,184951,Johnson; Christine M.,1,0,40,39
1683684689858,COGS 107B,A01,184953,Mooshagian; Eric Frederick,0,52,40,40
1683684690883,COGS 118B,A01,184959,Gupta; Anjum,0,50,40,40
1683684691909,COGS 153,A00,184961,Staff,0,16,30,30
1683684692933,COGS 177,A00,184962,Staff,1,21,30,29
1683684693956,COGS 187A,A01,184969,Boyle; Mary E. T.,0,19,40,40
1683684694980,COMM 10,A01,185174,Staff,0,5,25,25
1683684694980,COMM 10,A02,185189,Staff,0,2,25,25
1683684694980,COMM 10,A03,269821,Staff,0,1,0,0
1683684696012,COMM 100B,A02,185476,Staff,10,0,25,15
1683684696012,COMM 100B,A03,277340,Staff,25,0,25,0
1683684697038,COMM 100C,A01,185314,Staff,1,0,25,24
1683684697038,COMM 100C,A02,185327,Staff,17,0,25,8
1683684698062,COMM 110M,A00,185349,Staff,0,0,40,40
1683684699084,COMM 113T,A00,185352,Staff,25,0,40,15
1683684700112,COMM 114I,A00,185353,Staff,31,0,40,9
1683684701140,COMM 131,A00,185354,Staff,17,0,30,13
1683684702166,CSE 8A,A50,185358,Cao; Yingjun,0,46,10,10
1683684703195,CSE 8B,A01,185362,Staff,0,48,50,50
1683684704217,CSE 11,A01,185416,Cao; Yingjun,0,91,10,10
1683684705242,CSE 20,A01,185445,Briones; Jor-el Thomas Caparas,3,0,25,22
1683684706264,CSE 21,A01,185447,Staff,9,0,50,41
1683684707289,CSE 101,A01,185451,Staff,0,13,50,50
1683684707289,CSE 101,B01,185453,Jones; Miles E,0,14,50,50
1683684709340,CSE 141,A01,185458,Eldon; John,16,0,100,84
1683684710363,CSE 141L,A01,185461,Eldon; John,8,0,100,92
1683684711386,CSE 142,A01,185463,Staff,34,0,60,26
1683684711386,CSE 142,B01,201355,Staff,0,7,60,60
1683684712414,CSE 142L,A01,185470,Staff,34,0,60,26
1683684712414,CSE 142L,B01,201417,Staff,0,6,60,60
1683684713438,CSE 190,A00,201433,Staff,32,0,49,17
1683684714462,DOC 1,A01,259136,Strom; Megan C.,7,0,15,8
1683684714462,DOC 1,A02,259137,Strom; Megan C.,14,0,15,1
1683684714462,DOC 1,A03,259138,Strom; Megan C.,14,0,15,1
1683684714462,DOC 1,A04,259139,Strom; Megan C.,14,0,15,1
1683684715486,DOC 100D,A00,259140,Pass; Natalye Joann,14,0,25,11
1683684716510,DSGN 1,A01,184749,Rill; Bryan,0,26,30,30
1683684717534,DSGN 100,A01,185168,Staff,0,2,25,25
1683684718562,ECE 5,A01,185626,Morris; Karcher William,0,12,0,0
1683684719589,ECE 101,A01,185628,Staff,14,0,70,56
1683684720613,ECE 107,A01,185635,Baghdadchi; Saharnaz,0,0,20,20
1683684720613,ECE 107,A02,185638,Baghdadchi; Saharnaz,1,0,20,19
1683684721640,ECE 148,A01,185647,Silberman; Jack,0,0,16,16
1683684722667,ECON 1,A01,185537,Crane; Meredith Helen,54,0,70,16
1683684723695,ECON 3,A01,185549,Crane; Meredith Helen,30,0,70,40
1683684724719,ECON 4,A01,203354,Anderson; John Charles,0,5,10,10
1683684725743,ECON 100A,A01,185574,Staff,0,5,40,40
1683684726771,ECON 100B,A01,185576,Staff,0,12,50,50
1683684727796,ECON 100C,A01,185589,Newhouse; Herbert S,30,0,70,40
1683684728822,ECON 105,A00,185608,Vespa; Emanuel Ignacio,19,0,35,16
1683684729847,ECON 109,A01,185610,Shishkin; Denis,9,0,35,26
1683684730872,ECON 110A,A01,185612,Staff,8,0,40,32
1683684731895,ECON 120A,A01,185615,Staff,19,0,40,21
1683684732924,ECON 120C,A01,185617,Sun; Yixiao,0,21,70,70
1683684733947,ECON 144,A00,203346,Squires; Dale E,2,0,35,33
1683684734971,ECON 171,A01,203349,Newhouse; Herbert S,0,1,35,35
1683684735999,ECON 173A,A01,185621,Toda; Alexis Akira,21,0,35,14
1683684737028,EDS 25,A01,202413,Staff,0,1,0,0
1683684737028,EDS 25,A02,202414,Staff,0,1,0,0
1683684737028,EDS 25,A03,202415,Staff,0,0,0,0
1683684737028,EDS 25,A04,202416,Staff,0,1,0,0
1683684737028,EDS 25,A05,202439,Staff,0,0,0,0
1683684737028,EDS 25,A06,202440,Staff,0,0,0,0
1683684737028,EDS 25,B01,202631,Staff,0,0,0,0
1683684737028,EDS 25,B02,202632,Staff,0,0,0,0
1683684737028,EDS 25,B03,202639,Staff,0,0,0,0
1683684737028,EDS 25,B04,202640,Staff,0,0,0,0
1683684737028,EDS 25,B05,202643,Staff,0,0,0,0
1683684737028,EDS 25,B06,202644,Staff,0,0,0,0
1683684738052,EDS 38,A01,202659,Black; Alison Michelle,24,0,25,1
1683684739080,EDS 115,A00,202652,Staff,18,0,30,12
1683684740104,EDS 125,A00,202649,Staff,13,0,30,17
1683684741132,EDS 126,A01,203332,Staff,30,0,30,0
1683684742160,EDS 139,A00,202838,Staff,16,0,25,9
1683684743185,EDS 146,A01,202655,Staff,14,0,25,11
1683684744210,ENG 15,A00,185667,Staff,0,1,0,0
1683684744210,ENG 15,B00,185672,Staff,0,0,0,0
1683684744210,ENG 15,C00,185675,Staff,0,0,0,0
1683684744210,ENG 15,D00,185682,Staff,0,0,0,0
1683684744210,ENG 15,E00,185684,Staff,0,0,0,0
1683684745238,ETHN 103,A00,185710,Staff,0,8,35,35
1683684746263,ETHN 103A,A00,199228,Man; Simeon S,0,0,9,9
1683684747289,ETHN 109,A00,185711,Staff,15,0,35,20
1683684748312,ETHN 142,A00,185726,Staff,0,4,30,30
1683684749339,ETHN 163J,A00,199229,Man; Simeon S,5,0,8,3
1683684750363,ETHN 168,A00,185727,Staff,7,0,10,3
1683684751387,ETHN 182,A00,185728,Staff,0,0,35,35
1683684752411,ETHN 183,A00,185737,Staff,9,0,18,9
1683684753439,GLBH 111,A01,209361,Burgos; Jose L.,0,0,0,0
1683684755489,HIEU 104,A00,185792,Staff,14,0,20,6
1683684756515,HIEU 115,A00,185800,Staff,0,0,20,20
1683684757542,HIEU 128,A00,185801,Staff,0,9,20,20
1683684758565,HIEU 147,A00,185802,Staff,15,0,20,5
1683684759589,HIEU 154,A00,185823,Staff,11,0,20,9
1683684760617,HILA 102,A00,185826,Staff,14,0,20,6
1683684761644,HILD 2C,A01,185778,Staff,0,13,20,20
1683684762670,HILD 7B,A01,185780,Kwak; Nancy,0,17,32,32
1683684762670,HILD 7B,A02,185781,Kwak; Nancy,0,18,32,32
1683684763695,HILD 30,A01,185791,Staff,12,0,20,8
1683684764720,HISC 119,A00,185830,Golan; Tal,0,10,20,20
1683684765744,HITO 156GS,A00,185831,Patterson; Patrick H.,0,0,0,23
1683684766769,HIUS 103,A00,185832,Man; Simeon S,0,4,20,20
1683684767796,HIUS 117,A00,185836,Kwak; Nancy,2,0,20,18
1683684768820,HIUS 125,A00,185840,Man; Simeon S,0,2,23,23
1683684769844,HIUS 149,A00,185845,Staff,1,0,20,19
1683684770869,HUM 3,A01,185882,Zavodny; Tatiana Sophia,0,8,50,50
1683684770869,HUM 3,B01,185899,Caldwell; Michael Alan,0,18,50,50
1683684771896,HUM 3GS,A00,185900,Patterson; Patrick H.,0,0,0,23
1683684772923,HUM 4,A01,185938,Zroka; Amy Liane,28,0,50,22
1683684772923,HUM 4,B01,185956,Watkins; Eric,0,6,50,50
1683684772923,HUM 4,B02,202209,Watkins; Eric,0,5,50,50
1683684772923,HUM 4,B03,202210,Watkins; Eric,0,5,50,50
1683684773949,HUM 5,A01,185958,West; Geoffrey Scott,0,0,50,50
1683684773949,HUM 5,A02,202215,West; Geoffrey Scott,0,0,50,50
1683684774976,INTL 190,A00,185959,Gagnon; Jeffrey C,0,0,0,9
1683684774976,INTL 190,B00,185960,Lettieri; Michael Joseph,0,0,0,2
1683684776002,JAPN 180,A00,254509,Staff,5,0,30,25
1683684777027,LATI 10,A01,202853,Kennemore; Amy Michelle,4,0,35,31
1683684777027,LATI 10,A02,202854,Kennemore; Amy Michelle,3,0,35,32
1683684777027,LATI 10,A03,270054,Kennemore; Amy Michelle,30,0,30,0
1683684778049,LATI 180,A00,202855,Kennemore; Amy Michelle,11,0,20,9
1683684779073,LAWS 101,A00,201767,Golan; Tal,0,7,40,40
1683684780096,LIFR 1C,A00,185961,Staff,6,0,20,14
1683684781120,LIFR 1CX,A00,185962,Staff,7,0,20,13
1683684782143,LIFR 1D,A00,185963,Staff,7,0,20,13
1683684783166,LIFR 1DX,A00,185964,Staff,7,0,20,13
1683684784193,LIGN 101,A01,186039,Staff,43,0,50,7
1683684785218,LIGN 165,A00,186040,Staff,15,0,50,35
1683684786245,LTCS 108,A00,186041,Staff,5,0,10,5
1683684787271,LTCS 119,A00,186042,Staff,15,0,20,5
1683684788361,LTCS 130,A00,186043,Wesling; Megan E.,15,0,25,10
1683684790414,LTEA 138,A00,186119,Staff,14,0,40,26
1683684791438,LTEN 124,A00,186148,Staff,5,0,25,20
1683684792462,LTEN 178,A00,186149,Staff,6,0,15,9
1683684793487,LTEN 181,A00,186150,Blanco; John D,34,0,40,6
1683684794512,LTWL 120,A00,186160,Staff,19,0,25,6
1683684795539,LTWL 165,A00,186161,Staff,22,0,25,3
1683684796566,LTWR 100,A00,186162,Staff,0,5,15,15
1683684797591,LTWR 102,A00,186163,Doller; Ben,5,0,15,10
1683684798616,MAE 8,A01,186412,Staff,0,1,0,0
1683684799641,MAE 30B,A00,186445,Bahadori; Mohammad Yousef,81,0,100,19
1683684800665,MAE 40,A00,186592,Bewley; Thomas R,10,0,50,40
1683684801693,MAE 101B,A00,186593,Bahadori; Mohammad Yousef,80,0,100,20
1683684802718,MAE 105,A00,186594,Bandaru; Prabhakar,10,0,50,40
1683684803742,MAE 107,A00,186599,Pham; Hieu Tan,0,7,120,120
1683684804768,MAE 148,A01,186660,Silberman; Jack,3,0,16,13
1683684805795,MATH 10A,A01,188095,Staff,0,6,35,35
1683684806820,MATH 10B,A01,188097,Bowers; Adam R.,0,12,30,30
1683684806820,MATH 10B,A02,188099,Bowers; Adam R.,0,11,30,30
1683684806820,MATH 10B,B01,188104,Bowers; Adam R.,0,10,30,30
1683684806820,MATH 10B,B02,188106,Bowers; Adam R.,1,9,30,29
1683684807844,MATH 10C,A01,188111,Staff,0,20,30,30
1683684807844,MATH 10C,A02,188127,Staff,0,19,30,30
1683684807844,MATH 10C,A03,188131,Staff,0,19,30,30
1683684807844,MATH 10C,B01,188218,Staff,17,0,30,13
1683684807844,MATH 10C,B02,188244,Staff,13,0,30,17
1683684807844,MATH 10C,B03,188277,Staff,14,0,30,16
1683684808868,MATH 18,A01,188344,Bach; Quang Tran,18,0,30,12
1683684808868,MATH 18,A02,188345,Bach; Quang Tran,11,0,30,19
1683684808868,MATH 18,B01,188353,Bach; Quang Tran,11,0,30,19
1683684808868,MATH 18,B02,188354,Bach; Quang Tran,19,0,30,11
1683684809895,MATH 20A,A01,188374,Staff,11,0,35,24
1683684810921,MATH 20B,A01,188382,Ohm; Ko Woon,7,0,30,23
1683684810921,MATH 20B,A02,188383,Ohm; Ko Woon,22,0,30,8
1683684810921,MATH 20B,B01,188385,Ohm; Ko Woon,7,0,30,23
1683684810921,MATH 20B,B02,188392,Ohm; Ko Woon,22,0,30,8
1683684811946,MATH 20C,A01,188394,Harel; Guershon,10,0,30,20
1683684811946,MATH 20C,A02,188395,Harel; Guershon,13,0,30,17
1683684811946,MATH 20C,B01,188404,Harel; Guershon,5,0,30,25
1683684811946,MATH 20C,B02,188405,Harel; Guershon,18,0,30,12
1683684812977,MATH 20D,A01,188414,Hammock; Frances H,0,1,30,30
1683684812977,MATH 20D,A02,188415,Hammock; Frances H,0,1,30,30
1683684812977,MATH 20D,B01,188447,Hammock; Frances H,0,1,30,30
1683684812977,MATH 20D,B02,188486,Hammock; Frances H,3,0,30,27
1683684814005,MATH 20E,A01,188649,Staff,21,0,30,9
1683684814005,MATH 20E,A02,188650,Staff,20,0,30,10
1683684814005,MATH 20E,A03,188673,Staff,0,0,30,30
1683684815029,MATH 102,A01,188675,Staff,0,39,35,35
1683684816059,MATH 103B,A01,188681,Staff,3,0,35,32
1683684816059,MATH 103B,B01,188692,Staff,5,0,35,30
1683684817085,MATH 109,A01,188695,Salehi Golsefidy; Alireza,24,0,35,11
1683684817085,MATH 109,A02,188696,Salehi Golsefidy; Alireza,25,0,35,10
1683684818110,MATH 120A,A01,188698,Eggers; John Dietrich,7,0,35,28
1683684819136,MATH 142B,A01,188736,Ioana; Adrian,1,1,30,29
1683684819136,MATH 142B,A02,188741,Ioana; Adrian,0,1,30,30
1683684819136,MATH 142B,A03,188743,Ioana; Adrian,0,1,30,30
1683684820164,MATH 168A,A01,188790,Staff,0,11,35,35
1683684821192,MATH 170A,A01,188803,Nie; Jiawang,0,2,35,35
1683684821192,MATH 170A,A02,188811,Nie; Jiawang,0,1,35,35
1683684821192,MATH 170A,A03,188814,Nie; Jiawang,0,0,35,35
1683684821192,MATH 170A,A04,188815,Nie; Jiawang,6,0,35,29
1683684822220,MATH 193B,A01,188817,Staff,0,0,35,35
1683684822220,MATH 193B,A02,188818,Staff,5,0,35,30
1683684823243,MGT 4,A01,202857,Anderson; John Charles,59,0,80,21
1683684824267,MGT 12,A00,202858,Lindenberger; Wade Douglas,40,0,90,50
1683684825291,MGT 18,A00,202859,Staff,74,0,90,16
1683684826318,MGT 18GS,A00,202860,McKay; Michael J,13,0,28,15
1683684827347,MGT 45,A00,202861,Pecore; Joseph P.,8,0,90,82
1683684828370,MGT 100,A00,202863,Yavorsky; Daniel Ryan,28,0,90,62
1683684829399,MGT 103,A00,202864,Ehrich; Kristine R,0,19,90,90
1683684830423,MGT 112,A00,202865,Ehrich; Kristine R,15,0,90,75
1683684831449,MGT 121A,A00,202868,Staff,90,20,90,0
1683684832473,MGT 131B,A00,202869,Anderson; John Charles,59,0,90,31
1683684833497,MGT 136,A00,202871,Lindenberger; Wade Douglas,83,0,90,7
1683684834521,MGT 164,A00,202873,Staff,0,68,90,91
1683684835545,MGT 164GS,A00,202874,McKay; Mary A,13,0,28,15
1683684836568,MGT 180,A00,202875,Staff,0,51,90,91
1683684837592,MMW 11R,A01,205019,Herbst; Matthew,0,0,30,30
1683684837592,MMW 11R,A02,205026,Herbst; Matthew,29,0,30,1
1683684838617,MMW 15,A01,193512,Chang; Edmond Yi-Teh,0,8,28,28
1683684838617,MMW 15,A02,193513,Chang; Edmond Yi-Teh,0,5,28,28
1683684838617,MMW 15,A03,193514,Chang; Edmond Yi-Teh,0,5,28,28
1683684838617,MMW 15,A04,193515,Chang; Edmond Yi-Teh,0,5,28,28
1683684838617,MMW 15,A05,193516,Chang; Edmond Yi-Teh,0,5,28,28
1683684838617,MMW 15,A06,193517,Chang; Edmond Yi-Teh,0,6,28,28
1683684838617,MMW 15,B01,193519,Chang; Edmond Yi-Teh,0,5,28,28
1683684838617,MMW 15,B02,193520,Chang; Edmond Yi-Teh,0,5,28,28
1683684838617,MMW 15,B03,193521,Chang; Edmond Yi-Teh,0,5,28,28
1683684838617,MMW 15,B04,193522,Chang; Edmond Yi-Teh,0,6,28,28
1683684838617,MMW 15,B05,193523,Chang; Edmond Yi-Teh,0,5,28,28
1683684838617,MMW 15,B06,193524,Chang; Edmond Yi-Teh,0,5,28,28
1683684839641,MMW 122,A01,193526,Rahimi; Babak,0,16,28,28
1683684839641,MMW 122,A02,193527,Rahimi; Babak,0,15,28,28
1683684839641,MMW 122,A03,193528,Rahimi; Babak,0,0,0,0
1683684839641,MMW 122,A04,193529,Rahimi; Babak,0,0,0,0
1683684840664,MUS 1A,A01,186663,Staff,1,19,35,34
1683684841692,MUS 4,A01,186715,Staff,0,12,35,35
1683684842714,MUS 5R,A01,186796,Dubnov; Shlomo,0,17,35,35
1683684843741,MUS 6,A01,186798,Staff,1,5,25,24
1683684844765,MUS 7,A01,186830,Staff,11,0,35,24
1683684845792,MUS 8,A01,186930,Staff,0,27,35,35
1683684846820,MUS 15,A01,186932,Staff,0,15,35,35
1683684846820,MUS 15,B01,186934,Staff,1,17,35,34
1683684847846,MUS 80,A00,186935,Staff,0,0,20,20
1683684847846,MUS 80,B00,186936,Staff,24,0,25,1
1683684848874,NANO 11,A00,204702,Lipomi; Darren John,0,0,0,0
1683684849897,NANO 15,A01,204709,Yang; Kesong,0,1,0,0
1683684850924,NANO 114,A00,202069,Jahed Motlagh; Zeinab,3,0,10,7
1683684851950,PHIL 1,A00,186955,Grush; Rick Scott,31,0,40,9
1683684852978,PHIL 10,A01,186973,Grush; Rick Scott,27,0,35,8
1683684852978,PHIL 10,A02,186974,Grush; Rick Scott,33,0,35,2
1683684854005,PHIL 13,A01,186976,Staff,1,0,35,34
1683684854005,PHIL 13,A02,186977,Staff,16,0,35,19
1683684855029,PHIL 14,A01,186979,Staff,31,0,35,4
1683684855029,PHIL 14,A02,186986,Staff,32,0,35,3
1683684856058,PHIL 28,A01,186988,Staff,16,0,30,14
1683684856058,PHIL 28,A02,186989,Staff,1,0,30,29
1683684856058,PHIL 28,A03,186990,Staff,10,0,30,20
1683684856058,PHIL 28,A04,186991,Staff,26,0,30,4
1683684857083,PHIL 120,A00,186997,Staff,23,0,40,17
1683684858108,PHIL 137,A00,187003,Staff,7,0,40,33
1683684859134,PHIL 150,A00,187015,Staff,47,0,70,23
1683684860160,PHIL 167,A00,187021,Lamey; Andy M.,34,0,40,6
1683684861183,PHIL 174,A01,202226,Staff,17,0,20,3
1683684861183,PHIL 174,A02,202235,Staff,20,0,20,0
1683684862204,PHIL 191A,A00,258918,Staff,0,0,1,1
1683684863228,PHYS 1A,A00,187028,Staff,26,0,60,34
1683684864253,PHYS 1AL,001,187036,Staff,3,0,30,27
1683684864253,PHYS 1AL,002,187049,Staff,18,0,30,12
1683684865278,PHYS 1B,A00,187058,Staff,22,0,60,38
1683684866306,PHYS 1BL,001,187064,Staff,0,1,30,30
1683684866306,PHYS 1BL,002,187070,Staff,4,0,30,26
1683684867330,PHYS 1C,A00,187082,Staff,29,0,120,91
1683684868353,PHYS 1CL,001,187088,Staff,0,9,30,30
1683684868353,PHYS 1CL,002,187089,Staff,0,1,30,30
1683684868353,PHYS 1CL,009,262693,Staff,9,0,30,21
1683684869376,PHYS 2B,A01,187097,Staff,55,0,115,60
1683684870400,PHYS 2C,A01,187099,Staff,63,0,115,52
1683684871428,PHYS 2CL,A01,187101,Staff,5,0,28,23
1683684871428,PHYS 2CL,A02,187102,Staff,15,0,28,13
1683684872452,PHYS 2D,A01,187123,Shotwell; Brian,95,0,115,20
1683684873477,PHYS 4B,A01,187133,Grinstein; Benjamin,35,0,50,15
1683684874501,POLI 10,A00,188819,Staff,0,4,50,50
1683684875524,POLI 11,A00,188827,Staff,43,0,50,7
1683684876551,POLI 13R,A00,188828,Staff,0,1,20,20
1683684877578,POLI 27,A01,188830,Elgin; Samuel Zincke,0,2,70,70
1683684878604,POLI 30,A00,188832,Desposato; Scott,30,0,50,20
1683684879632,POLI 102F,A00,188834,Staff,1,0,40,39
1683684880656,POLI 104A,A00,188852,Staff,12,0,30,18
1683684881683,POLI 104I,A00,188853,Staff,0,8,20,20
1683684882706,POLI 110B,A00,188854,Wiens; David,6,0,20,14
1683684883733,POLI 112A,A00,188855,Wiens; David,3,0,30,27
1683684884760,POLI 117R,A00,188856,Forman; Fonna,0,12,20,20
1683684885787,POLI 118,A00,188857,Ingham; Sean,8,0,20,12
1683684886814,POLI 120G,A00,188858,Staff,8,0,30,22
1683684887838,POLI 131CR,A00,188863,Hoston; Germaine,20,0,50,30
1683684888866,POLI 133,A00,188864,Nellis; Gareth Hb,44,0,50,6
1683684889897,POLI 134D,A00,188865,Desposato; Scott,27,0,30,3
1683684890927,POLI 142A,A00,188871,Gartzke; Erik,21,0,50,29
1683684892006,POLI 142K,A00,188874,Staff,38,0,50,12
1683684893032,POLI 143,A00,188940,Gartzke; Erik,16,0,30,14
1683684894057,POLI 153,A00,188943,Staff,2,0,20,18
1683684895085,POLI 160AA,A00,188944,Staff,10,0,40,30
1683684896111,POLI 170A,A00,188945,Staff,10,0,30,20
1683684898164,PSYC 1,A00,188952,Staff,36,0,90,54
1683684899191,PSYC 2,B00,188953,Staff,19,0,35,16
1683684900214,PSYC 6,A00,188970,Staff,47,0,60,13
1683684901238,PSYC 7,A00,188973,Staff,35,0,45,10
1683684902264,PSYC 60,A01,188980,Rickard; Timothy C.,42,0,60,18
1683684903288,PSYC 70,A01,189001,Steiner; Eric Tomas,21,0,45,24
1683684904312,PSYC 100,A00,189005,Lacefield; Katharine I,0,99,120,120
1683684905339,PSYC 102,A00,189008,Staff,7,0,30,23
1683684906366,PSYC 106,B00,189026,Gorman; Michael R.,27,0,60,33
1683684907394,PSYC 114,B01,189033,Winkielman; Piotr,0,31,30,30
1683684908422,PSYC 131,A00,189036,Anagnostaras; Stephan,0,43,60,60
1683684909448,PSYC 136,A00,189041,Lowe; Angela Beth,0,7,25,25
1683684910474,PSYC 137,A00,189057,Winkielman; Piotr,1,37,25,24
1683684911498,PSYC 144,A00,189107,Wixted; John T,0,11,50,50
1683684913545,PSYC 162,A00,189142,Staff,0,9,85,85
1683684914569,PSYC 172,A00,189144,Gorman; Michael R.,0,6,30,30
1683684916621,PSYC 179,A00,189146,Lacefield; Katharine I,0,87,120,120
1683684917644,PSYC 181,A00,189147,Anagnostaras; Stephan,0,44,90,90
1683684918667,PSYC 190R,A00,189148,Barner; David A.,0,23,80,80
1683684919691,PSYC 191,A00,189275,Rickard; Timothy C.,0,10,25,25
1683684920719,PSYC 193,A00,189276,Chapman; Eddie Nathaniel,0,1,0,4
1683684921744,PSYC 193L,A01,189281,Lowe; Angela Beth,8,0,20,12
1683684921744,PSYC 193L,B01,189285,Staff,28,0,35,7
1683684922768,RELI 149,A00,187137,Rahimi; Babak,6,0,40,34
1683684923795,SE 9,A01,187315,Staff,0,2,18,18
1683684924824,SE 101B,A00,187409,Staff,24,0,30,6
1683684925850,SE 110B,A00,187444,Staff,10,0,40,30
1683684926875,SE 130B,A00,187449,Staff,31,0,40,9
1683684927898,SE 150A,A00,187516,Staff,8,0,20,12
1683684928928,SE 154,A00,187528,Staff,29,0,50,21
1683684929952,SIO 3,A01,258171,Staff,35,0,40,5
1683684930980,SIO 10,A00,187144,Cook; Geoffrey W,1,7,75,74
1683684932006,SIO 45,A00,187152,Cook; Geoffrey W,0,7,100,100
1683684933030,SIO 109R,A00,194486,Staff,0,4,20,20
1683684935079,SIO 187,A01,187233,Kacev; David,12,0,40,28
1683684936109,SOCI 1,A01,258656,Thorpe; Charles Robert,28,0,30,2
1683684936109,SOCI 1,A02,258658,Thorpe; Charles Robert,30,0,30,0
1683684936109,SOCI 1,A03,258661,Thorpe; Charles Robert,25,0,25,0
1683684936109,SOCI 1,A04,258666,Thorpe; Charles Robert,22,0,25,3
1683684936109,SOCI 1,A05,258897,Thorpe; Charles Robert,22,0,25,3
1683684936109,SOCI 1,A06,258898,Thorpe; Charles Robert,25,0,25,0
1683684937137,SOCI 30,A01,258903,Pardo Guerra; Juan Pablo,14,0,30,16
1683684938161,SOCI 102,A00,258904,Staff,9,0,25,16
1683684939186,SOCI 106,A00,258905,Staff,19,0,25,6
1683684940207,SOCI 111,A00,258907,Ribas Norris; Janet Vanesa,26,0,30,4
1683684941232,SOCI 121R,A00,258908,Pardo Guerra; Juan Pablo,8,0,30,22
1683684942256,SOCI 126,A01,203330,Staff,14,0,20,6
1683684943279,SOCI 131,A00,258909,Thorpe; Charles Robert,30,0,60,30
1683684944304,SOCI 135,A00,258910,Payne; Christine Anna,0,12,30,30
1683684945328,SOCI 157,A00,258911,Staff,11,0,30,19
1683684946353,SOCI 184,A00,258912,Staff,25,0,30,5
1683684947381,SOCI 188D,A00,258913,Staff,22,0,30,8
1683684948406,SYN 2,001,187529,Staff,9,0,16,7
1683684948406,SYN 2,002,201452,Staff,1,20,16,15
1683684948406,SYN 2,003,201469,Staff,1,0,16,15
1683684949433,SYN 100,A01,187531,Staff,0,9,20,20
1683684949433,SYN 100,B01,201491,Staff,0,10,20,20
1683684950461,TDAC 1,A00,189286,Walsh; Kim C.,3,0,20,17
1683684950461,TDAC 1,B00,189287,Harting; Carla Kelso,10,0,20,10
1683684951488,TDAC 101,A00,189300,Walsh; Kim C.,16,0,20,4
1683684951488,TDAC 101,B00,189301,Harting; Carla Kelso,18,0,20,2
1683684952513,TDAC 102,A00,189304,Basso; Beatrice,14,0,20,6
1683684953537,TDAC 108,A00,189305,Staff,18,0,20,2
1683684954567,TDDE 131,A00,189310,Staff,19,0,20,1
1683684954567,TDDE 131,B00,189314,Staff,19,0,20,1
1683684954567,TDDE 131,C00,189315,Staff,48,0,50,2
1683684954567,TDDE 131,D00,189316,Staff,14,0,15,1
1683684954567,TDDE 131,E00,204841,Staff,20,0,20,0
1683684955592,TDGE 10,A00,189289,Staff,27,0,50,23
1683684955592,TDGE 10,B00,189290,Havis; Allan,0,1,50,50
1683684956618,TDGE 11,A00,189291,Fulton; Julia,0,4,50,50
1683684956618,TDGE 11,B00,189292,Staff,20,0,25,5
1683684956618,TDGE 11,C00,260270,Staff,0,0,0,0
1683684957643,TDGE 25,A00,189294,Staff,1,0,20,19
1683684958668,TDGE 124,A00,189318,Fulton; Julia,0,8,50,50
1683684959696,TDGE 125,A00,189319,Staff,13,0,25,12
1683684959696,TDGE 125,B00,189320,Staff,23,0,25,2
1683684960721,TDGE 127,A00,189322,Havis; Allan,0,0,50,50
1683684961749,TDHT 101,A00,189323,Staff,18,0,25,7
1683684961749,TDHT 101,B00,189324,Staff,25,0,25,0
1683684962773,TDHT 102,A00,189325,Staff,49,0,50,1
1683684963797,TDMV 1,A00,189295,Arcidiacono; Kristin,20,0,30,10
1683684963797,TDMV 1,B00,189296,Caligagan; Maria T.,24,0,30,6
1683684964821,TDMV 2,A00,189297,Sammartano; Tonnie,27,0,30,3
1683684964821,TDMV 2,B00,189299,Arcidiacono; Kristin,23,0,30,7
1683684965849,TDMV 3,A00,204998,Rincon; Alicia,22,0,30,8
1683684966878,TDMV 120,A00,189458,Sammartano; Tonnie,28,0,30,2
1683684967904,TDMV 138,A00,189541,Jun; Grace Shin Hae,20,0,40,20
1683684968928,TDMV 142,A00,189717,Caligagan; Tony,25,0,30,5
1683684968928,TDMV 142,B00,189718,Caligagan; Maria T.,25,0,30,5
1683684969953,TMC 2,A01,187533,Staff,25,0,25,0
1683684969953,TMC 2,A02,187534,Staff,25,0,25,0
1683684970978,USP 1,A01,187536,Kwak; Nancy,0,16,25,25
1683684972006,USP 5,A01,187538,Staff,8,0,25,17
1683684973031,USP 101,A00,199253,Staff,0,4,0,0
1683684974056,USP 124,A00,187562,Boomhower; Matthew Charles,0,0,30,30
1683684975082,USP 138,A00,187582,Staff,19,0,25,6
1683684976105,USP 152,A01,187597,Staff,3,0,25,22
1683684977131,USP 153,A00,187598,Staff,18,0,25,7
1683684978157,USP 168,A00,187607,Kwak; Nancy,2,0,5,3
1683684979183,USP 173,A00,187619,Staff,4,0,25,21
1683684980212,USP 181,A00,187638,Staff,0,4,25,25
1683684981237,VIS 103,A00,187650,Cruz; Edwin Teddy,17,0,75,58
1683684982259,VIS 110D,A00,187669,Staff,13,0,22,9
1683684983285,VIS 127C,A00,187720,Shen; Kuiyi,67,0,146,79
1683684984310,VIS 149,A00,187731,Yoldas; Pinar,1,14,22,21
1683684985334,VIS 151,A01,188091,Staff,22,0,34,12
1683684985334,VIS 151,A02,188092,Staff,11,0,34,23
1683684986358,VIS 160B,A00,188093,Stalbaum; Brett,0,1,10,10
1683684988410,WCWP 10B,A00,201720,Staff,0,0,5,5
1683684988410,WCWP 10B,B00,201722,Staff,0,0,6,6
1683684989433,WCWP 100,A00,201725,Gagnon; Jeffrey C,0,0,2,2
1683684989433,WCWP 100,B00,201727,Staff,0,4,15,15
1683684992528,ANBI 133,A00,258401,Wilder; Linnea Lorene,34,0,40,6
1683684993552,ANBI 140,A00,258395,Hrvoj Mihic; Branka,18,0,25,7
1683684994576,ANSC 120,A00,258402,Bialecki; Jon Anthony,26,0,40,14
1683684995661,ANSC 144,A00,258400,Staff,12,0,40,28
1683684997714,ANSC 166,A00,258396,Parish; Steven Martin,156,0,175,19
1683684998738,ANSC 180,A00,193533,Staff,8,0,20,12
1683684999766,ANSC 188,A00,258397,Jassal; Aftab,34,0,40,6
1683685000789,ANTH 3,A01,258316,Staff,23,0,30,7
1683685001818,ANTH 5,A00,258394,Semendeferi; Ekaterini,16,0,20,4
1683685002842,ANTH 21,A01,258331,Staff,4,0,40,36
1683685003869,ANTH 103,A00,258398,Varma; Saiba,15,0,25,10
1683685004896,AWP 10,001,202034,Staff,0,0,0,0
1683685004896,AWP 10,002,202035,Staff,0,0,0,0
1683685004896,AWP 10,003,202036,Staff,0,0,0,0
1683685004896,AWP 10,004,202037,Staff,0,0,0,0
1683685004896,AWP 10,005,202038,Staff,0,0,0,0
1683685004896,AWP 10,006,202039,Staff,0,0,0,0
1683685004896,AWP 10,007,202040,Staff,0,0,0,0
1683685004896,AWP 10,008,202041,Staff,0,0,0,0
1683685004896,AWP 10,009,202042,Staff,0,0,0,0
1683685004896,AWP 10,010,202043,Staff,0,0,0,0
1683685004896,AWP 10,011,202044,Staff,0,0,0,0
1683685004896,AWP 10,012,202045,Staff,0,0,0,0
1683685004896,AWP 10,013,202046,Staff,0,0,0,0
1683685004896,AWP 10,014,202047,Staff,0,0,0,0
1683685004896,AWP 10,015,202048,Staff,0,0,0,0
1683685004896,AWP 10,016,202049,Staff,0,0,0,0
1683685004896,AWP 10,017,202050,Staff,0,0,0,0
1683685004896,AWP 10,018,202051,Staff,0,0,0,0
1683685004896,AWP 10,019,202052,Staff,0,0,0,0
1683685004896,AWP 10,020,202053,Staff,0,0,0,0
1683685004896,AWP 10,021,202054,Staff,0,0,0,0
1683685004896,AWP 10,022,202055,Staff,0,0,0,0
1683685004896,AWP 10,023,202056,Staff,0,0,0,0
1683685004896,AWP 10,024,202057,Staff,0,0,0,0
1683685004896,AWP 10,025,202058,Staff,0,0,0,0
1683685004896,AWP 10,026,202059,Staff,0,0,0,0
1683685005921,AWP 102,001,202032,Staff,0,0,0,0
1683685005921,AWP 102,002,202033,Staff,0,0,0,0
1683685006948,BENG 100,A01,254234,Taylor Amos; Alyssa C,31,0,40,9
1683685007977,BENG 196,001,270013,Engler; Adam J.,9999,0,9999,0
1683685009000,BICD 100R,A01,202018,Smith; Laurie,0,7,32,32
1683685009000,BICD 100R,A02,202019,Smith; Laurie,0,3,32,32
1683685009000,BICD 100R,A03,202020,Smith; Laurie,0,1,32,32
1683685009000,BICD 100R,A04,202021,Smith; Laurie,6,0,32,26
1683685009000,BICD 100R,A05,202022,Smith; Laurie,10,0,32,22
1683685010027,BICD 136,A01,193242,Gustafson-Brown; Cindy,0,2,32,32
1683685010027,BICD 136,A02,193244,Gustafson-Brown; Cindy,13,0,32,19
1683685011057,BIEB 102,A01,193249,Butler; Shannon Rhey,1,1,32,31
1683685011057,BIEB 102,A02,193251,Butler; Shannon Rhey,0,0,32,32
1683685011057,BIEB 102,A03,193253,Butler; Shannon Rhey,0,0,32,32
1683685011057,BIEB 102,A04,193255,Butler; Shannon Rhey,13,0,32,19
1683685011057,BIEB 102,A05,193265,Butler; Shannon Rhey,25,0,32,7
1683685011057,BIEB 102,A06,193269,Butler; Shannon Rhey,13,0,32,19
1683685013109,BIEB 150,A01,193274,Staff,0,0,32,32
1683685013109,BIEB 150,A02,193285,Staff,24,0,32,8
1683685014136,BIEB 194,A00,193286,Kurle; Carolyn M.,19,0,32,13
1683685015166,BILD 1,A01,192291,Staff,15,0,32,17
1683685015166,BILD 1,A02,192292,Staff,30,0,32,2
1683685015166,BILD 1,B01,192520,Reuther; Keefe,0,1,0,0
1683685015166,BILD 1,B02,192532,Reuther; Keefe,0,1,0,0
1683685016196,BILD 3,A01,192556,Butler; Shannon Rhey,0,0,32,32
1683685016196,BILD 3,A02,192581,Butler; Shannon Rhey,0,1,32,32
1683685016196,BILD 3,A03,192611,Butler; Shannon Rhey,19,0,32,13
1683685016196,BILD 3,A04,192612,Butler; Shannon Rhey,24,0,32,8
1683685016196,BILD 3,A05,192613,Butler; Shannon Rhey,26,0,32,6
1683685016196,BILD 3,A06,192679,Butler; Shannon Rhey,27,0,32,5
1683685016196,BILD 3,A07,192682,Butler; Shannon Rhey,20,0,32,12
1683685017221,BILD 4,A01,192836,Reuther; Keefe,1,0,24,23
1683685017221,BILD 4,A02,193044,Reuther; Keefe,4,0,24,20
1683685018244,BILD 10,A01,193142,Gustafson-Brown; Cindy,29,0,32,3
1683685018244,BILD 10,A02,193149,Gustafson-Brown; Cindy,31,0,32,1
1683685019274,BIMM 100,A01,193301,Staff,0,6,32,32
1683685019274,BIMM 100,A02,193312,Staff,0,7,32,32
1683685019274,BIMM 100,A03,193323,Staff,0,10,32,32
1683685020302,BIMM 101,A01,193329,McDonnell; Lisa Marie,1,4,24,23
1683685020302,BIMM 101,A02,193339,McDonnell; Lisa Marie,1,4,24,23
1683685020302,BIMM 101,B01,193354,McDonnell; Lisa Marie,0,4,24,24
1683685020302,BIMM 101,B02,193357,McDonnell; Lisa Marie,0,3,24,24
1683685021328,BIMM 110,A01,193377,Tat; John,0,11,32,32
1683685021328,BIMM 110,A02,193378,Tat; John,0,11,32,32
1683685022362,BIMM 120,A01,206116,Staff,0,0,32,32
1683685022362,BIMM 120,A02,206117,Staff,7,0,32,25
1683685022362,BIMM 120,A03,206121,Staff,21,0,32,11
1683685023390,BIPN 100,A01,193393,Park; Ji Young,0,15,32,32
1683685023390,BIPN 100,A02,193402,Park; Ji Young,0,14,32,32
1683685023390,BIPN 100,A03,193413,Park; Ji Young,0,14,32,32
1683685023390,BIPN 100,A04,193414,Park; Ji Young,0,13,32,32
1683685024415,BIPN 102,A01,193429,Staff,0,0,32,32
1683685024415,BIPN 102,A02,193438,Staff,18,0,32,14
1683685025441,BIPN 106,A01,193450,Reyes Gonzalez; Catalina,0,2,40,40
1683685026471,BIPN 134,A01,193465,Cooke; James Edward,0,0,32,32
1683685026471,BIPN 134,A02,193474,Cooke; James Edward,25,0,32,7
1683685026471,BIPN 134,A03,193485,Cooke; James Edward,29,0,32,3
1683685026471,BIPN 134,A04,193486,Cooke; James Edward,20,0,32,12
1683685026471,BIPN 134,A05,193491,Cooke; James Edward,31,0,32,1
1683685026471,BIPN 134,A06,193501,Cooke; James Edward,30,0,32,2
1683685026471,BIPN 134,A07,193510,Cooke; James Edward,29,0,32,3
1683685028519,BISP 194,A00,222522,Staff,14,0,32,18
1683685029547,CAT 124,A01,202407,Staff,19,0,25,6
1683685030574,CAT 125,A00,202408,Marchisotto; Jennifer Anne,2,0,20,18
1683685031670,CAT 125R,A00,202409,Smith; Lauryn Alissa,0,11,20,20
1683685031670,CAT 125R,B00,202410,Morales; Celeste Georgianna,0,11,20,20
1683685031670,CAT 125R,C00,202411,Irwin; Matthew Joseph,0,12,20,20
1683685032696,CENG 15,A01,204712,Yang; Kesong,0,1,0,0
1683685033721,CENG 114,A00,202070,Jahed Motlagh; Zeinab,5,0,20,15
1683685034743,CGS 105,A00,185477,Wesling; Megan E.,24,0,40,16
1683685035806,CGS 106,A00,185494,Staff,11,0,22,11
1683685036831,CGS 108,A00,185495,Staff,14,0,20,6
1683685037855,CGS 114,A00,185496,Staff,13,0,18,5
1683685038880,CGS 119,A00,185501,Staff,15,0,20,5
1683685039904,CGS 120,A00,185511,Staff,12,0,20,8
1683685040930,CHEM 4,A01,184675,Bussey; Thomas J,97,0,100,3
1683685041955,CHEM 6A,A01,184677,Staff,32,0,60,28
1683685042983,CHEM 6B,A01,184679,Staff,63,0,100,37
1683685044008,CHEM 6C,A01,184681,Bussey; Thomas J,0,0,50,50
1683685044008,CHEM 6C,A02,184682,Bussey; Thomas J,32,0,50,18
1683685045032,CHEM 40A,A01,184684,Albizati; Kim F.,33,0,100,67
1683685046059,CHEM 40B,A01,184686,Albizati; Kim F.,0,22,100,100
1683685047088,CHEM 41B,A01,184690,Staff,51,0,100,49
1683685048111,COGS 3,A01,184715,Boyle; Mary E. T.,0,27,40,40
1683685049136,COGS 14B,A01,185172,Staff,0,14,38,38
1683685050160,COGS 18,A01,184736,Staff,14,0,80,66
1683685051188,COGS 100,A01,184932,Staff,0,8,73,73
1683685052219,COGS 101A,A01,184935,Staff,0,40,30,30
1683685053244,COGS 101B,A01,184944,Staff,0,2,30,30
1683685054268,COGS 101C,A01,184946,Staff,0,10,30,30
1683685055293,COGS 102A,A01,184951,Johnson; Christine M.,1,0,40,39
1683685056316,COGS 107B,A01,184953,Mooshagian; Eric Frederick,0,52,40,40
1683685057349,COGS 118B,A01,184959,Gupta; Anjum,0,50,40,40
1683685058377,COGS 153,A00,184961,Staff,0,16,30,30
1683685059405,COGS 177,A00,184962,Staff,1,21,30,29
1683685060426,COGS 187A,A01,184969,Boyle; Mary E. T.,0,19,40,40
1683685061454,COMM 10,A01,185174,Staff,0,5,25,25
1683685061454,COMM 10,A02,185189,Staff,0,2,25,25
1683685061454,COMM 10,A03,269821,Staff,0,1,0,0
1683685062480,COMM 100B,A02,185476,Staff,10,0,25,15
1683685062480,COMM 100B,A03,277340,Staff,25,0,25,0
1683685063505,COMM 100C,A01,185314,Staff,1,0,25,24
1683685063505,COMM 100C,A02,185327,Staff,17,0,25,8
1683685064545,COMM 110M,A00,185349,Staff,0,0,40,40
1683685065569,COMM 113T,A00,185352,Staff,25,0,40,15
1683685066596,COMM 114I,A00,185353,Staff,31,0,40,9
1683685067625,COMM 131,A00,185354,Staff,17,0,30,13
1683685068650,CSE 8A,A50,185358,Cao; Yingjun,0,46,10,10
1683685069678,CSE 8B,A01,185362,Staff,0,48,50,50
1683685070709,CSE 11,A01,185416,Cao; Yingjun,0,91,10,10
1683685071735,CSE 20,A01,185445,Briones; Jor-el Thomas Caparas,3,0,25,22
1683685072762,CSE 21,A01,185447,Staff,9,0,50,41
1683685073787,CSE 101,A01,185451,Staff,0,13,50,50
1683685073787,CSE 101,B01,185453,Jones; Miles E,0,14,50,50
1683685075837,CSE 141,A01,185458,Eldon; John,16,0,100,84
1683685076863,CSE 141L,A01,185461,Eldon; John,8,0,100,92
1683685077887,CSE 142,A01,185463,Staff,34,0,60,26
1683685077887,CSE 142,B01,201355,Staff,0,7,60,60
1683685078914,CSE 142L,A01,185470,Staff,34,0,60,26
1683685078914,CSE 142L,B01,201417,Staff,0,6,60,60
1683685079938,CSE 190,A00,201433,Staff,32,0,49,17
1683685080962,DOC 1,A01,259136,Strom; Megan C.,7,0,15,8
1683685080962,DOC 1,A02,259137,Strom; Megan C.,14,0,15,1
1683685080962,DOC 1,A03,259138,Strom; Megan C.,14,0,15,1
1683685080962,DOC 1,A04,259139,Strom; Megan C.,14,0,15,1
1683685081985,DOC 100D,A00,259140,Pass; Natalye Joann,14,0,25,11
1683685083010,DSGN 1,A01,184749,Rill; Bryan,0,26,30,30
1683685084034,DSGN 100,A01,185168,Staff,0,2,25,25
1683685085058,ECE 5,A01,185626,Morris; Karcher William,0,12,0,0
1683685086084,ECE 101,A01,185628,Staff,14,0,70,56
1683685087107,ECE 107,A01,185635,Baghdadchi; Saharnaz,0,0,20,20
1683685087107,ECE 107,A02,185638,Baghdadchi; Saharnaz,1,0,20,19
1683685088130,ECE 148,A01,185647,Silberman; Jack,0,0,16,16
1683685089158,ECON 1,A01,185537,Crane; Meredith Helen,54,0,70,16
1683685090186,ECON 3,A01,185549,Crane; Meredith Helen,30,0,70,40
1683685091210,ECON 4,A01,203354,Anderson; John Charles,0,5,10,10
1683685092238,ECON 100A,A01,185574,Staff,0,5,40,40
1683685093263,ECON 100B,A01,185576,Staff,0,12,50,50
1683685094288,ECON 100C,A01,185589,Newhouse; Herbert S,30,0,70,40
1683685095315,ECON 105,A00,185608,Vespa; Emanuel Ignacio,19,0,35,16
1683685096340,ECON 109,A01,185610,Shishkin; Denis,9,0,35,26
1683685097364,ECON 110A,A01,185612,Staff,8,0,40,32
1683685098389,ECON 120A,A01,185615,Staff,19,0,40,21
1683685099486,ECON 120C,A01,185617,Sun; Yixiao,0,21,70,70
1683685100510,ECON 144,A00,203346,Squires; Dale E,2,0,35,33
1683685101536,ECON 171,A01,203349,Newhouse; Herbert S,0,1,35,35
1683685102559,ECON 173A,A01,185621,Toda; Alexis Akira,21,0,35,14
1683685103584,EDS 25,A01,202413,Staff,0,1,0,0
1683685103584,EDS 25,A02,202414,Staff,0,1,0,0
1683685103584,EDS 25,A03,202415,Staff,0,0,0,0
1683685103584,EDS 25,A04,202416,Staff,0,1,0,0
1683685103584,EDS 25,A05,202439,Staff,0,0,0,0
1683685103584,EDS 25,A06,202440,Staff,0,0,0,0
1683685103584,EDS 25,B01,202631,Staff,0,0,0,0
1683685103584,EDS 25,B02,202632,Staff,0,0,0,0
1683685103584,EDS 25,B03,202639,Staff,0,0,0,0
1683685103584,EDS 25,B04,202640,Staff,0,0,0,0
1683685103584,EDS 25,B05,202643,Staff,0,0,0,0
1683685103584,EDS 25,B06,202644,Staff,0,0,0,0
1683685104610,EDS 38,A01,202659,Black; Alison Michelle,24,0,25,1
1683685105636,EDS 115,A00,202652,Staff,18,0,30,12
1683685106661,EDS 125,A00,202649,Staff,13,0,30,17
1683685107686,EDS 126,A01,203332,Staff,30,0,30,0
1683685108708,EDS 139,A00,202838,Staff,16,0,25,9
1683685109736,EDS 146,A01,202655,Staff,14,0,25,11
1683685110768,ENG 15,A00,185667,Staff,0,1,0,0
1683685110768,ENG 15,B00,185672,Staff,0,0,0,0
1683685110768,ENG 15,C00,185675,Staff,0,0,0,0
1683685110768,ENG 15,D00,185682,Staff,0,0,0,0
1683685110768,ENG 15,E00,185684,Staff,0,0,0,0
1683685111793,ETHN 103,A00,185710,Staff,0,8,35,35
1683685112819,ETHN 103A,A00,199228,Man; Simeon S,0,0,9,9
1683685113842,ETHN 109,A00,185711,Staff,15,0,35,20
1683685114875,ETHN 142,A00,185726,Staff,0,4,30,30
1683685115899,ETHN 163J,A00,199229,Man; Simeon S,5,0,8,3
1683685116924,ETHN 168,A00,185727,Staff,7,0,10,3
1683685117951,ETHN 182,A00,185728,Staff,0,0,35,35
1683685118976,ETHN 183,A00,185737,Staff,9,0,18,9
1683685120003,GLBH 111,A01,209361,Burgos; Jose L.,0,0,0,0
1683685122053,HIEU 104,A00,185792,Staff,14,0,20,6
1683685123080,HIEU 115,A00,185800,Staff,0,0,20,20
1683685124103,HIEU 128,A00,185801,Staff,0,9,20,20
1683685125128,HIEU 147,A00,185802,Staff,15,0,20,5
1683685126155,HIEU 154,A00,185823,Staff,11,0,20,9
1683685127179,HILA 102,A00,185826,Staff,14,0,20,6
1683685128205,HILD 2C,A01,185778,Staff,0,13,20,20
1683685129231,HILD 7B,A01,185780,Kwak; Nancy,0,17,32,32
1683685129231,HILD 7B,A02,185781,Kwak; Nancy,0,18,32,32
1683685130255,HILD 30,A01,185791,Staff,12,0,20,8
1683685131279,HISC 119,A00,185830,Golan; Tal,0,10,20,20
1683685132307,HITO 156GS,A00,185831,Patterson; Patrick H.,0,0,0,23
1683685133333,HIUS 103,A00,185832,Man; Simeon S,0,4,20,20
1683685134361,HIUS 117,A00,185836,Kwak; Nancy,2,0,20,18
1683685135384,HIUS 125,A00,185840,Man; Simeon S,0,2,23,23
1683685136408,HIUS 149,A00,185845,Staff,1,0,20,19
1683685137433,HUM 3,A01,185882,Zavodny; Tatiana Sophia,0,8,50,50
1683685137433,HUM 3,B01,185899,Caldwell; Michael Alan,0,18,50,50
1683685138455,HUM 3GS,A00,185900,Patterson; Patrick H.,0,0,0,23
1683685139480,HUM 4,A01,185938,Zroka; Amy Liane,28,0,50,22
1683685139480,HUM 4,B01,185956,Watkins; Eric,0,6,50,50
1683685139480,HUM 4,B02,202209,Watkins; Eric,0,5,50,50
1683685139480,HUM 4,B03,202210,Watkins; Eric,0,5,50,50
1683685140507,HUM 5,A01,185958,West; Geoffrey Scott,0,0,50,50
1683685140507,HUM 5,A02,202215,West; Geoffrey Scott,0,0,50,50
1683685141530,INTL 190,A00,185959,Gagnon; Jeffrey C,0,0,0,9
1683685141530,INTL 190,B00,185960,Lettieri; Michael Joseph,0,0,0,2
1683685142555,JAPN 180,A00,254509,Staff,5,0,30,25
1683685143583,LATI 10,A01,202853,Kennemore; Amy Michelle,4,0,35,31
1683685143583,LATI 10,A02,202854,Kennemore; Amy Michelle,3,0,35,32
1683685143583,LATI 10,A03,270054,Kennemore; Amy Michelle,30,0,30,0
1683685144606,LATI 180,A00,202855,Kennemore; Amy Michelle,11,0,20,9
1683685145636,LAWS 101,A00,201767,Golan; Tal,0,7,40,40
1683685146661,LIFR 1C,A00,185961,Staff,6,0,20,14
1683685147685,LIFR 1CX,A00,185962,Staff,7,0,20,13
1683685148712,LIFR 1D,A00,185963,Staff,7,0,20,13
1683685149738,LIFR 1DX,A00,185964,Staff,7,0,20,13
1683685150771,LIGN 101,A01,186039,Staff,43,0,50,7
1683685151797,LIGN 165,A00,186040,Staff,15,0,50,35
1683685152823,LTCS 108,A00,186041,Staff,5,0,10,5
1683685153847,LTCS 119,A00,186042,Staff,15,0,20,5
1683685154874,LTCS 130,A00,186043,Wesling; Megan E.,15,0,25,10
1683685156921,LTEA 138,A00,186119,Staff,14,0,40,26
1683685157946,LTEN 124,A00,186148,Staff,5,0,25,20
1683685158972,LTEN 178,A00,186149,Staff,6,0,15,9
1683685160002,LTEN 181,A00,186150,Blanco; John D,34,0,40,6
1683685161029,LTWL 120,A00,186160,Staff,19,0,25,6
1683685162056,LTWL 165,A00,186161,Staff,22,0,25,3
1683685163080,LTWR 100,A00,186162,Staff,0,5,15,15
1683685164104,LTWR 102,A00,186163,Doller; Ben,5,0,15,10
1683685165131,MAE 8,A01,186412,Staff,0,1,0,0
1683685166155,MAE 30B,A00,186445,Bahadori; Mohammad Yousef,81,0,100,19
1683685167182,MAE 40,A00,186592,Bewley; Thomas R,10,0,50,40
1683685168204,MAE 101B,A00,186593,Bahadori; Mohammad Yousef,80,0,100,20
1683685169232,MAE 105,A00,186594,Bandaru; Prabhakar,10,0,50,40
1683685170257,MAE 107,A00,186599,Pham; Hieu Tan,0,7,120,120
1683685171280,MAE 148,A01,186660,Silberman; Jack,3,0,16,13
1683685172306,MATH 10A,A01,188095,Staff,0,6,35,35
1683685173336,MATH 10B,A01,188097,Bowers; Adam R.,0,12,30,30
1683685173336,MATH 10B,A02,188099,Bowers; Adam R.,0,11,30,30
1683685173336,MATH 10B,B01,188104,Bowers; Adam R.,0,10,30,30
1683685173336,MATH 10B,B02,188106,Bowers; Adam R.,1,9,30,29
1683685174360,MATH 10C,A01,188111,Staff,0,20,30,30
1683685174360,MATH 10C,A02,188127,Staff,0,19,30,30
1683685174360,MATH 10C,A03,188131,Staff,0,19,30,30
1683685174360,MATH 10C,B01,188218,Staff,17,0,30,13
1683685174360,MATH 10C,B02,188244,Staff,13,0,30,17
1683685174360,MATH 10C,B03,188277,Staff,14,0,30,16
1683685175390,MATH 18,A01,188344,Bach; Quang Tran,18,0,30,12
1683685175390,MATH 18,A02,188345,Bach; Quang Tran,11,0,30,19
1683685175390,MATH 18,B01,188353,Bach; Quang Tran,11,0,30,19
1683685175390,MATH 18,B02,188354,Bach; Quang Tran,19,0,30,11
1683685176417,MATH 20A,A01,188374,Staff,11,0,35,24
1683685177442,MATH 20B,A01,188382,Ohm; Ko Woon,7,0,30,23
1683685177442,MATH 20B,A02,188383,Ohm; Ko Woon,22,0,30,8
1683685177442,MATH 20B,B01,188385,Ohm; Ko Woon,7,0,30,23
1683685177442,MATH 20B,B02,188392,Ohm; Ko Woon,22,0,30,8
1683685178470,MATH 20C,A01,188394,Harel; Guershon,10,0,30,20
1683685178470,MATH 20C,A02,188395,Harel; Guershon,13,0,30,17
1683685178470,MATH 20C,B01,188404,Harel; Guershon,5,0,30,25
1683685178470,MATH 20C,B02,188405,Harel; Guershon,18,0,30,12
1683685179498,MATH 20D,A01,188414,Hammock; Frances H,0,1,30,30
1683685179498,MATH 20D,A02,188415,Hammock; Frances H,0,1,30,30
1683685179498,MATH 20D,B01,188447,Hammock; Frances H,0,1,30,30
1683685179498,MATH 20D,B02,188486,Hammock; Frances H,3,0,30,27
1683685180527,MATH 20E,A01,188649,Staff,21,0,30,9
1683685180527,MATH 20E,A02,188650,Staff,20,0,30,10
1683685180527,MATH 20E,A03,188673,Staff,0,0,30,30
1683685181555,MATH 102,A01,188675,Staff,0,39,35,35
1683685182592,MATH 103B,A01,188681,Staff,3,0,35,32
1683685182592,MATH 103B,B01,188692,Staff,5,0,35,30
1683685183617,MATH 109,A01,188695,Salehi Golsefidy; Alireza,24,0,35,11
1683685183617,MATH 109,A02,188696,Salehi Golsefidy; Alireza,25,0,35,10
1683685184642,MATH 120A,A01,188698,Eggers; John Dietrich,7,0,35,28
1683685185666,MATH 142B,A01,188736,Ioana; Adrian,1,1,30,29
1683685185666,MATH 142B,A02,188741,Ioana; Adrian,0,1,30,30
1683685185666,MATH 142B,A03,188743,Ioana; Adrian,0,1,30,30
1683685186689,MATH 168A,A01,188790,Staff,0,11,35,35
1683685187714,MATH 170A,A01,188803,Nie; Jiawang,0,2,35,35
1683685187714,MATH 170A,A02,188811,Nie; Jiawang,0,1,35,35
1683685187714,MATH 170A,A03,188814,Nie; Jiawang,0,0,35,35
1683685187714,MATH 170A,A04,188815,Nie; Jiawang,6,0,35,29
1683685188743,MATH 193B,A01,188817,Staff,0,0,35,35
1683685188743,MATH 193B,A02,188818,Staff,5,0,35,30
1683685189767,MGT 4,A01,202857,Anderson; John Charles,59,0,80,21
1683685190793,MGT 12,A00,202858,Lindenberger; Wade Douglas,40,0,90,50
1683685191817,MGT 18,A00,202859,Staff,74,0,90,16
1683685192842,MGT 18GS,A00,202860,McKay; Michael J,13,0,28,15
1683685193866,MGT 45,A00,202861,Pecore; Joseph P.,8,0,90,82
1683685194892,MGT 100,A00,202863,Yavorsky; Daniel Ryan,28,0,90,62
1683685195919,MGT 103,A00,202864,Ehrich; Kristine R,0,19,90,90
1683685196944,MGT 112,A00,202865,Ehrich; Kristine R,15,0,90,75
1683685197968,MGT 121A,A00,202868,Staff,90,20,90,0
1683685198991,MGT 131B,A00,202869,Anderson; John Charles,59,0,90,31
1683685200020,MGT 136,A00,202871,Lindenberger; Wade Douglas,83,0,90,7
1683685201046,MGT 164,A00,202873,Staff,0,68,90,91
1683685202073,MGT 164GS,A00,202874,McKay; Mary A,13,0,28,15
1683685203169,MGT 180,A00,202875,Staff,0,51,90,91
1683685204194,MMW 11R,A01,205019,Herbst; Matthew,0,0,30,30
1683685204194,MMW 11R,A02,205026,Herbst; Matthew,29,0,30,1
1683685205220,MMW 15,A01,193512,Chang; Edmond Yi-Teh,0,8,28,28
1683685205220,MMW 15,A02,193513,Chang; Edmond Yi-Teh,0,5,28,28
1683685205220,MMW 15,A03,193514,Chang; Edmond Yi-Teh,0,5,28,28
1683685205220,MMW 15,A04,193515,Chang; Edmond Yi-Teh,0,5,28,28
1683685205220,MMW 15,A05,193516,Chang; Edmond Yi-Teh,0,5,28,28
1683685205220,MMW 15,A06,193517,Chang; Edmond Yi-Teh,0,6,28,28
1683685205220,MMW 15,B01,193519,Chang; Edmond Yi-Teh,0,5,28,28
1683685205220,MMW 15,B02,193520,Chang; Edmond Yi-Teh,0,5,28,28
1683685205220,MMW 15,B03,193521,Chang; Edmond Yi-Teh,0,5,28,28
1683685205220,MMW 15,B04,193522,Chang; Edmond Yi-Teh,0,6,28,28
1683685205220,MMW 15,B05,193523,Chang; Edmond Yi-Teh,0,5,28,28
1683685205220,MMW 15,B06,193524,Chang; Edmond Yi-Teh,0,5,28,28
1683685206248,MMW 122,A01,193526,Rahimi; Babak,0,16,28,28
1683685206248,MMW 122,A02,193527,Rahimi; Babak,0,15,28,28
1683685206248,MMW 122,A03,193528,Rahimi; Babak,0,0,0,0
1683685206248,MMW 122,A04,193529,Rahimi; Babak,0,0,0,0
1683685207271,MUS 1A,A01,186663,Staff,1,19,35,34
1683685208298,MUS 4,A01,186715,Staff,0,12,35,35
1683685209324,MUS 5R,A01,186796,Dubnov; Shlomo,0,17,35,35
1683685210351,MUS 6,A01,186798,Staff,1,5,25,24
1683685211375,MUS 7,A01,186830,Staff,11,0,35,24
1683685212398,MUS 8,A01,186930,Staff,0,27,35,35
1683685213423,MUS 15,A01,186932,Staff,0,15,35,35
1683685213423,MUS 15,B01,186934,Staff,1,17,35,34
1683685214447,MUS 80,A00,186935,Staff,0,0,20,20
1683685214447,MUS 80,B00,186936,Staff,24,0,25,1
1683685215469,NANO 11,A00,204702,Lipomi; Darren John,0,0,0,0
1683685216496,NANO 15,A01,204709,Yang; Kesong,0,1,0,0
1683685217520,NANO 114,A00,202069,Jahed Motlagh; Zeinab,3,0,10,7
1683685218544,PHIL 1,A00,186955,Grush; Rick Scott,31,0,40,9
1683685219572,PHIL 10,A01,186973,Grush; Rick Scott,27,0,35,8
1683685219572,PHIL 10,A02,186974,Grush; Rick Scott,33,0,35,2
1683685220597,PHIL 13,A01,186976,Staff,1,0,35,34
1683685220597,PHIL 13,A02,186977,Staff,16,0,35,19
1683685221622,PHIL 14,A01,186979,Staff,31,0,35,4
1683685221622,PHIL 14,A02,186986,Staff,32,0,35,3
1683685222650,PHIL 28,A01,186988,Staff,16,0,30,14
1683685222650,PHIL 28,A02,186989,Staff,1,0,30,29
1683685222650,PHIL 28,A03,186990,Staff,10,0,30,20
1683685222650,PHIL 28,A04,186991,Staff,26,0,30,4
1683685223674,PHIL 120,A00,186997,Staff,23,0,40,17
1683685224703,PHIL 137,A00,187003,Staff,7,0,40,33
1683685225727,PHIL 150,A00,187015,Staff,47,0,70,23
1683685226754,PHIL 167,A00,187021,Lamey; Andy M.,34,0,40,6
1683685227781,PHIL 174,A01,202226,Staff,17,0,20,3
1683685227781,PHIL 174,A02,202235,Staff,20,0,20,0
1683685228807,PHIL 191A,A00,258918,Staff,0,0,1,1
1683685229830,PHYS 1A,A00,187028,Staff,26,0,60,34
1683685230859,PHYS 1AL,001,187036,Staff,3,0,30,27
1683685230859,PHYS 1AL,002,187049,Staff,18,0,30,12
1683685231887,PHYS 1B,A00,187058,Staff,22,0,60,38
1683685232915,PHYS 1BL,001,187064,Staff,0,1,30,30
1683685232915,PHYS 1BL,002,187070,Staff,4,0,30,26
1683685233942,PHYS 1C,A00,187082,Staff,29,0,120,91
1683685234966,PHYS 1CL,001,187088,Staff,0,9,30,30
1683685234966,PHYS 1CL,002,187089,Staff,0,1,30,30
1683685234966,PHYS 1CL,009,262693,Staff,9,0,30,21
1683685235990,PHYS 2B,A01,187097,Staff,55,0,115,60
1683685237014,PHYS 2C,A01,187099,Staff,63,0,115,52
1683685238039,PHYS 2CL,A01,187101,Staff,5,0,28,23
1683685238039,PHYS 2CL,A02,187102,Staff,15,0,28,13
1683685239063,PHYS 2D,A01,187123,Shotwell; Brian,95,0,115,20
1683685240088,PHYS 4B,A01,187133,Grinstein; Benjamin,35,0,50,15
1683685241112,POLI 10,A00,188819,Staff,0,4,50,50
1683685242136,POLI 11,A00,188827,Staff,43,0,50,7
1683685243161,POLI 13R,A00,188828,Staff,0,1,20,20
1683685244189,POLI 27,A01,188830,Elgin; Samuel Zincke,0,2,70,70
1683685245216,POLI 30,A00,188832,Desposato; Scott,30,0,50,20
1683685246242,POLI 102F,A00,188834,Staff,1,0,40,39
1683685247267,POLI 104A,A00,188852,Staff,12,0,30,18
1683685248291,POLI 104I,A00,188853,Staff,0,8,20,20
1683685249319,POLI 110B,A00,188854,Wiens; David,6,0,20,14
1683685250347,POLI 112A,A00,188855,Wiens; David,3,0,30,27
1683685251372,POLI 117R,A00,188856,Forman; Fonna,0,12,20,20
1683685252398,POLI 118,A00,188857,Ingham; Sean,8,0,20,12
1683685253425,POLI 120G,A00,188858,Staff,8,0,30,22
1683685254451,POLI 131CR,A00,188863,Hoston; Germaine,20,0,50,30
1683685255475,POLI 133,A00,188864,Nellis; Gareth Hb,44,0,50,6
1683685256501,POLI 134D,A00,188865,Desposato; Scott,27,0,30,3
1683685257527,POLI 142A,A00,188871,Gartzke; Erik,21,0,50,29
1683685258556,POLI 142K,A00,188874,Staff,38,0,50,12
1683685259581,POLI 143,A00,188940,Gartzke; Erik,16,0,30,14
1683685260605,POLI 153,A00,188943,Staff,2,0,20,18
1683685261630,POLI 160AA,A00,188944,Staff,10,0,40,30
1683685262657,POLI 170A,A00,188945,Staff,10,0,30,20
1683685264707,PSYC 1,A00,188952,Staff,36,0,90,54
1683685265732,PSYC 2,B00,188953,Staff,19,0,35,16
1683685266758,PSYC 6,A00,188970,Staff,47,0,60,13
1683685267782,PSYC 7,A00,188973,Staff,35,0,45,10
1683685268807,PSYC 60,A01,188980,Rickard; Timothy C.,42,0,60,18
1683685269834,PSYC 70,A01,189001,Steiner; Eric Tomas,21,0,45,24
1683685270857,PSYC 100,A00,189005,Lacefield; Katharine I,0,99,120,120
1683685271884,PSYC 102,A00,189008,Staff,7,0,30,23
1683685272911,PSYC 106,B00,189026,Gorman; Michael R.,27,0,60,33
1683685273935,PSYC 114,B01,189033,Winkielman; Piotr,0,31,30,30
1683685274959,PSYC 131,A00,189036,Anagnostaras; Stephan,0,43,60,60
1683685275984,PSYC 136,A00,189041,Lowe; Angela Beth,0,7,25,25
1683685277007,PSYC 137,A00,189057,Winkielman; Piotr,1,37,25,24
1683685278031,PSYC 144,A00,189107,Wixted; John T,0,11,50,50
1683685280079,PSYC 162,A00,189142,Staff,0,9,85,85
1683685281106,PSYC 172,A00,189144,Gorman; Michael R.,0,6,30,30
1683685283158,PSYC 179,A00,189146,Lacefield; Katharine I,0,87,120,120
1683685284186,PSYC 181,A00,189147,Anagnostaras; Stephan,0,44,90,90
1683685285209,PSYC 190R,A00,189148,Barner; David A.,0,23,80,80
1683685286234,PSYC 191,A00,189275,Rickard; Timothy C.,0,10,25,25
1683685287262,PSYC 193,A00,189276,Chapman; Eddie Nathaniel,0,1,0,4
1683685288287,PSYC 193L,A01,189281,Lowe; Angela Beth,8,0,20,12
1683685288287,PSYC 193L,B01,189285,Staff,28,0,35,7
1683685289312,RELI 149,A00,187137,Rahimi; Babak,6,0,40,34
1683685290336,SE 9,A01,187315,Staff,0,2,18,18
1683685291362,SE 101B,A00,187409,Staff,24,0,30,6
1683685292387,SE 110B,A00,187444,Staff,10,0,40,30
1683685293413,SE 130B,A00,187449,Staff,31,0,40,9
1683685294439,SE 150A,A00,187516,Staff,8,0,20,12
1683685295461,SE 154,A00,187528,Staff,29,0,50,21
1683685296485,SIO 3,A01,258171,Staff,35,0,40,5
1683685297509,SIO 10,A00,187144,Cook; Geoffrey W,1,7,75,74
1683685298534,SIO 45,A00,187152,Cook; Geoffrey W,0,7,100,100
1683685299558,SIO 109R,A00,194486,Staff,0,4,20,20
1683685301609,SIO 187,A01,187233,Kacev; David,12,0,40,28
1683685302635,SOCI 1,A01,258656,Thorpe; Charles Robert,28,0,30,2
1683685302635,SOCI 1,A02,258658,Thorpe; Charles Robert,30,0,30,0
1683685302635,SOCI 1,A03,258661,Thorpe; Charles Robert,25,0,25,0
1683685302635,SOCI 1,A04,258666,Thorpe; Charles Robert,22,0,25,3
1683685302635,SOCI 1,A05,258897,Thorpe; Charles Robert,22,0,25,3
1683685302635,SOCI 1,A06,258898,Thorpe; Charles Robert,25,0,25,0
1683685303660,SOCI 30,A01,258903,Pardo Guerra; Juan Pablo,14,0,30,16
1683685304686,SOCI 102,A00,258904,Staff,9,0,25,16
1683685305710,SOCI 106,A00,258905,Staff,19,0,25,6
1683685306785,SOCI 111,A00,258907,Ribas Norris; Janet Vanesa,26,0,30,4
1683685307807,SOCI 121R,A00,258908,Pardo Guerra; Juan Pablo,8,0,30,22
1683685308834,SOCI 126,A01,203330,Staff,14,0,20,6
1683685309859,SOCI 131,A00,258909,Thorpe; Charles Robert,30,0,60,30
1683685310890,SOCI 135,A00,258910,Payne; Christine Anna,0,12,30,30
1683685311914,SOCI 157,A00,258911,Staff,11,0,30,19
1683685312942,SOCI 184,A00,258912,Staff,25,0,30,5
1683685313965,SOCI 188D,A00,258913,Staff,22,0,30,8
1683685314990,SYN 2,001,187529,Staff,9,0,16,7
1683685314990,SYN 2,002,201452,Staff,1,20,16,15
1683685314990,SYN 2,003,201469,Staff,1,0,16,15
1683685316012,SYN 100,A01,187531,Staff,0,9,20,20
1683685316012,SYN 100,B01,201491,Staff,0,10,20,20
1683685317036,TDAC 1,A00,189286,Walsh; Kim C.,3,0,20,17
1683685317036,TDAC 1,B00,189287,Harting; Carla Kelso,10,0,20,10
1683685318058,TDAC 101,A00,189300,Walsh; Kim C.,16,0,20,4
1683685318058,TDAC 101,B00,189301,Harting; Carla Kelso,18,0,20,2
1683685319086,TDAC 102,A00,189304,Basso; Beatrice,14,0,20,6
1683685320109,TDAC 108,A00,189305,Staff,18,0,20,2
1683685321138,TDDE 131,A00,189310,Staff,19,0,20,1
1683685321138,TDDE 131,B00,189314,Staff,19,0,20,1
1683685321138,TDDE 131,C00,189315,Staff,48,0,50,2
1683685321138,TDDE 131,D00,189316,Staff,14,0,15,1
1683685321138,TDDE 131,E00,204841,Staff,20,0,20,0
1683685322161,TDGE 10,A00,189289,Staff,27,0,50,23
1683685322161,TDGE 10,B00,189290,Havis; Allan,0,1,50,50
1683685323184,TDGE 11,A00,189291,Fulton; Julia,0,4,50,50
1683685323184,TDGE 11,B00,189292,Staff,20,0,25,5
1683685323184,TDGE 11,C00,260270,Staff,0,0,0,0
1683685324211,TDGE 25,A00,189294,Staff,1,0,20,19
1683685325238,TDGE 124,A00,189318,Fulton; Julia,0,8,50,50
1683685326266,TDGE 125,A00,189319,Staff,13,0,25,12
1683685326266,TDGE 125,B00,189320,Staff,23,0,25,2
1683685327291,TDGE 127,A00,189322,Havis; Allan,0,0,50,50
1683685328317,TDHT 101,A00,189323,Staff,18,0,25,7
1683685328317,TDHT 101,B00,189324,Staff,25,0,25,0
1683685329341,TDHT 102,A00,189325,Staff,49,0,50,1
1683685330369,TDMV 1,A00,189295,Arcidiacono; Kristin,20,0,30,10
1683685330369,TDMV 1,B00,189296,Caligagan; Maria T.,24,0,30,6
1683685331394,TDMV 2,A00,189297,Sammartano; Tonnie,27,0,30,3
1683685331394,TDMV 2,B00,189299,Arcidiacono; Kristin,23,0,30,7
1683685332420,TDMV 3,A00,204998,Rincon; Alicia,22,0,30,8
1683685333444,TDMV 120,A00,189458,Sammartano; Tonnie,28,0,30,2
1683685334470,TDMV 138,A00,189541,Jun; Grace Shin Hae,20,0,40,20
1683685335496,TDMV 142,A00,189717,Caligagan; Tony,25,0,30,5
1683685335496,TDMV 142,B00,189718,Caligagan; Maria T.,25,0,30,5
1683685336519,TMC 2,A01,187533,Staff,25,0,25,0
1683685336519,TMC 2,A02,187534,Staff,25,0,25,0
1683685337547,USP 1,A01,187536,Kwak; Nancy,0,16,25,25
1683685338573,USP 5,A01,187538,Staff,8,0,25,17
1683685339597,USP 101,A00,199253,Staff,0,4,0,0
1683685340623,USP 124,A00,187562,Boomhower; Matthew Charles,0,0,30,30
1683685341649,USP 138,A00,187582,Staff,19,0,25,6
1683685342675,USP 152,A01,187597,Staff,3,0,25,22
1683685343702,USP 153,A00,187598,Staff,18,0,25,7
1683685344728,USP 168,A00,187607,Kwak; Nancy,2,0,5,3
1683685345755,USP 173,A00,187619,Staff,4,0,25,21
1683685346780,USP 181,A00,187638,Staff,0,4,25,25
1683685347805,VIS 103,A00,187650,Cruz; Edwin Teddy,17,0,75,58
1683685348836,VIS 110D,A00,187669,Staff,13,0,22,9
1683685349859,VIS 127C,A00,187720,Shen; Kuiyi,67,0,146,79
1683685350921,VIS 149,A00,187731,Yoldas; Pinar,1,14,22,21
1683685351949,VIS 151,A01,188091,Staff,22,0,34,12
1683685351949,VIS 151,A02,188092,Staff,11,0,34,23
1683685352974,VIS 160B,A00,188093,Stalbaum; Brett,0,1,10,10
1683685355026,WCWP 10B,A00,201720,Staff,0,0,5,5
1683685355026,WCWP 10B,B00,201722,Staff,0,0,6,6
1683685356050,WCWP 100,A00,201725,Gagnon; Jeffrey C,0,0,2,2
1683685356050,WCWP 100,B00,201727,Staff,0,4,15,15
1683685359186,ANBI 133,A00,258401,Wilder; Linnea Lorene,34,0,40,6
1683685360210,ANBI 140,A00,258395,Hrvoj Mihic; Branka,18,0,25,7
1683685361234,ANSC 120,A00,258402,Bialecki; Jon Anthony,26,0,40,14
1683685362256,ANSC 144,A00,258400,Staff,12,0,40,28
1683685364308,ANSC 166,A00,258396,Parish; Steven Martin,156,0,175,19
1683685365334,ANSC 180,A00,193533,Staff,8,0,20,12
1683685366363,ANSC 188,A00,258397,Jassal; Aftab,34,0,40,6
1683685367388,ANTH 3,A01,258316,Staff,23,0,30,7
1683685368416,ANTH 5,A00,258394,Semendeferi; Ekaterini,16,0,20,4
1683685369439,ANTH 21,A01,258331,Staff,4,0,40,36
1683685370466,ANTH 103,A00,258398,Varma; Saiba,15,0,25,10
1683685371493,AWP 10,001,202034,Staff,0,0,0,0
1683685371493,AWP 10,002,202035,Staff,0,0,0,0
1683685371493,AWP 10,003,202036,Staff,0,0,0,0
1683685371493,AWP 10,004,202037,Staff,0,0,0,0
1683685371493,AWP 10,005,202038,Staff,0,0,0,0
1683685371493,AWP 10,006,202039,Staff,0,0,0,0
1683685371493,AWP 10,007,202040,Staff,0,0,0,0
1683685371493,AWP 10,008,202041,Staff,0,0,0,0
1683685371493,AWP 10,009,202042,Staff,0,0,0,0
1683685371493,AWP 10,010,202043,Staff,0,0,0,0
1683685371493,AWP 10,011,202044,Staff,0,0,0,0
1683685371493,AWP 10,012,202045,Staff,0,0,0,0
1683685371493,AWP 10,013,202046,Staff,0,0,0,0
1683685371493,AWP 10,014,202047,Staff,0,0,0,0
1683685371493,AWP 10,015,202048,Staff,0,0,0,0
1683685371493,AWP 10,016,202049,Staff,0,0,0,0
1683685371493,AWP 10,017,202050,Staff,0,0,0,0
1683685371493,AWP 10,018,202051,Staff,0,0,0,0
1683685371493,AWP 10,019,202052,Staff,0,0,0,0
1683685371493,AWP 10,020,202053,Staff,0,0,0,0
1683685371493,AWP 10,021,202054,Staff,0,0,0,0
1683685371493,AWP 10,022,202055,Staff,0,0,0,0
1683685371493,AWP 10,023,202056,Staff,0,0,0,0
1683685371493,AWP 10,024,202057,Staff,0,0,0,0
1683685371493,AWP 10,025,202058,Staff,0,0,0,0
1683685371493,AWP 10,026,202059,Staff,0,0,0,0
1683685372519,AWP 102,001,202032,Staff,0,0,0,0
1683685372519,AWP 102,002,202033,Staff,0,0,0,0
1683685373550,BENG 100,A01,254234,Taylor Amos; Alyssa C,31,0,40,9
1683685374573,BENG 196,001,270013,Engler; Adam J.,9999,0,9999,0
1683685375603,BICD 100R,A01,202018,Smith; Laurie,0,7,32,32
1683685375603,BICD 100R,A02,202019,Smith; Laurie,0,3,32,32
1683685375603,BICD 100R,A03,202020,Smith; Laurie,0,1,32,32
1683685375603,BICD 100R,A04,202021,Smith; Laurie,6,0,32,26
1683685375603,BICD 100R,A05,202022,Smith; Laurie,10,0,32,22
1683685376628,BICD 136,A01,193242,Gustafson-Brown; Cindy,0,2,32,32
1683685376628,BICD 136,A02,193244,Gustafson-Brown; Cindy,13,0,32,19
1683685377657,BIEB 102,A01,193249,Butler; Shannon Rhey,1,1,32,31
1683685377657,BIEB 102,A02,193251,Butler; Shannon Rhey,0,0,32,32
1683685377657,BIEB 102,A03,193253,Butler; Shannon Rhey,0,0,32,32
1683685377657,BIEB 102,A04,193255,Butler; Shannon Rhey,13,0,32,19
1683685377657,BIEB 102,A05,193265,Butler; Shannon Rhey,25,0,32,7
1683685377657,BIEB 102,A06,193269,Butler; Shannon Rhey,13,0,32,19
1683685379718,BIEB 150,A01,193274,Staff,0,0,32,32
1683685379718,BIEB 150,A02,193285,Staff,24,0,32,8
1683685380741,BIEB 194,A00,193286,Kurle; Carolyn M.,19,0,32,13
1683685381772,BILD 1,A01,192291,Staff,15,0,32,17
1683685381772,BILD 1,A02,192292,Staff,30,0,32,2
1683685381772,BILD 1,B01,192520,Reuther; Keefe,0,1,0,0
1683685381772,BILD 1,B02,192532,Reuther; Keefe,0,1,0,0
1683685382802,BILD 3,A01,192556,Butler; Shannon Rhey,0,0,32,32
1683685382802,BILD 3,A02,192581,Butler; Shannon Rhey,0,1,32,32
1683685382802,BILD 3,A03,192611,Butler; Shannon Rhey,19,0,32,13
1683685382802,BILD 3,A04,192612,Butler; Shannon Rhey,24,0,32,8
1683685382802,BILD 3,A05,192613,Butler; Shannon Rhey,26,0,32,6
1683685382802,BILD 3,A06,192679,Butler; Shannon Rhey,27,0,32,5
1683685382802,BILD 3,A07,192682,Butler; Shannon Rhey,20,0,32,12
1683685383830,BILD 4,A01,192836,Reuther; Keefe,1,0,24,23
1683685383830,BILD 4,A02,193044,Reuther; Keefe,4,0,24,20
1683685384855,BILD 10,A01,193142,Gustafson-Brown; Cindy,29,0,32,3
1683685384855,BILD 10,A02,193149,Gustafson-Brown; Cindy,31,0,32,1
1683685385881,BIMM 100,A01,193301,Staff,0,6,32,32
1683685385881,BIMM 100,A02,193312,Staff,0,7,32,32
1683685385881,BIMM 100,A03,193323,Staff,0,10,32,32
1683685386912,BIMM 101,A01,193329,McDonnell; Lisa Marie,1,4,24,23
1683685386912,BIMM 101,A02,193339,McDonnell; Lisa Marie,1,4,24,23
1683685386912,BIMM 101,B01,193354,McDonnell; Lisa Marie,0,4,24,24
1683685386912,BIMM 101,B02,193357,McDonnell; Lisa Marie,0,3,24,24
1683685387936,BIMM 110,A01,193377,Tat; John,0,11,32,32
1683685387936,BIMM 110,A02,193378,Tat; John,0,11,32,32
1683685388961,BIMM 120,A01,206116,Staff,0,0,32,32
1683685388961,BIMM 120,A02,206117,Staff,7,0,32,25
1683685388961,BIMM 120,A03,206121,Staff,21,0,32,11
1683685389986,BIPN 100,A01,193393,Park; Ji Young,0,15,32,32
1683685389986,BIPN 100,A02,193402,Park; Ji Young,0,14,32,32
1683685389986,BIPN 100,A03,193413,Park; Ji Young,0,14,32,32
1683685389986,BIPN 100,A04,193414,Park; Ji Young,0,13,32,32
1683685391015,BIPN 102,A01,193429,Staff,0,0,32,32
1683685391015,BIPN 102,A02,193438,Staff,18,0,32,14
1683685392042,BIPN 106,A01,193450,Reyes Gonzalez; Catalina,0,2,40,40
1683685393072,BIPN 134,A01,193465,Cooke; James Edward,0,0,32,32
1683685393072,BIPN 134,A02,193474,Cooke; James Edward,25,0,32,7
1683685393072,BIPN 134,A03,193485,Cooke; James Edward,29,0,32,3
1683685393072,BIPN 134,A04,193486,Cooke; James Edward,20,0,32,12
1683685393072,BIPN 134,A05,193491,Cooke; James Edward,31,0,32,1
1683685393072,BIPN 134,A06,193501,Cooke; James Edward,30,0,32,2
1683685393072,BIPN 134,A07,193510,Cooke; James Edward,29,0,32,3
1683685395122,BISP 194,A00,222522,Staff,14,0,32,18
1683685396145,CAT 124,A01,202407,Staff,19,0,25,6
1683685397169,CAT 125,A00,202408,Marchisotto; Jennifer Anne,2,0,20,18
1683685398192,CAT 125R,A00,202409,Smith; Lauryn Alissa,0,11,20,20
1683685398192,CAT 125R,B00,202410,Morales; Celeste Georgianna,0,11,20,20
1683685398192,CAT 125R,C00,202411,Irwin; Matthew Joseph,0,12,20,20
1683685399219,CENG 15,A01,204712,Yang; Kesong,0,1,0,0
1683685400242,CENG 114,A00,202070,Jahed Motlagh; Zeinab,5,0,20,15
1683685401270,CGS 105,A00,185477,Wesling; Megan E.,24,0,40,16
1683685402294,CGS 106,A00,185494,Staff,11,0,22,11
1683685403318,CGS 108,A00,185495,Staff,14,0,20,6
1683685404342,CGS 114,A00,185496,Staff,13,0,18,5
1683685405368,CGS 119,A00,185501,Staff,15,0,20,5
1683685406392,CGS 120,A00,185511,Staff,12,0,20,8
1683685407416,CHEM 4,A01,184675,Bussey; Thomas J,97,0,100,3
1683685408439,CHEM 6A,A01,184677,Staff,32,0,60,28
1683685409464,CHEM 6B,A01,184679,Staff,63,0,100,37
1683685410548,CHEM 6C,A01,184681,Bussey; Thomas J,0,0,50,50
1683685410548,CHEM 6C,A02,184682,Bussey; Thomas J,32,0,50,18
1683685411682,CHEM 40A,A01,184684,Albizati; Kim F.,33,0,100,67
1683685412708,CHEM 40B,A01,184686,Albizati; Kim F.,0,22,100,100
1683685413733,CHEM 41B,A01,184690,Staff,51,0,100,49
1683685414761,COGS 3,A01,184715,Boyle; Mary E. T.,0,27,40,40
1683685415789,COGS 14B,A01,185172,Staff,0,14,38,38
1683685416814,COGS 18,A01,184736,Staff,14,0,80,66
1683685417839,COGS 100,A01,184932,Staff,0,8,73,73
1683685418867,COGS 101A,A01,184935,Staff,0,40,30,30
1683685419892,COGS 101B,A01,184944,Staff,0,2,30,30
1683685420928,COGS 101C,A01,184946,Staff,0,10,30,30
1683685421955,COGS 102A,A01,184951,Johnson; Christine M.,1,0,40,39
1683685422985,COGS 107B,A01,184953,Mooshagian; Eric Frederick,0,52,40,40
1683685424011,COGS 118B,A01,184959,Gupta; Anjum,0,50,40,40
1683685425035,COGS 153,A00,184961,Staff,0,16,30,30
1683685426062,COGS 177,A00,184962,Staff,1,21,30,29
1683685427090,COGS 187A,A01,184969,Boyle; Mary E. T.,0,19,40,40
1683685428115,COMM 10,A01,185174,Staff,0,5,25,25
1683685428115,COMM 10,A02,185189,Staff,0,2,25,25
1683685428115,COMM 10,A03,269821,Staff,0,1,0,0
1683685429139,COMM 100B,A02,185476,Staff,10,0,25,15
1683685429139,COMM 100B,A03,277340,Staff,25,0,25,0
1683685430166,COMM 100C,A01,185314,Staff,1,0,25,24
1683685430166,COMM 100C,A02,185327,Staff,17,0,25,8
1683685431191,COMM 110M,A00,185349,Staff,0,0,40,40
1683685432213,COMM 113T,A00,185352,Staff,25,0,40,15
1683685433240,COMM 114I,A00,185353,Staff,31,0,40,9
1683685434267,COMM 131,A00,185354,Staff,17,0,30,13
1683685435298,CSE 8A,A50,185358,Cao; Yingjun,0,46,10,10
1683685436323,CSE 8B,A01,185362,Staff,0,48,50,50
1683685437347,CSE 11,A01,185416,Cao; Yingjun,0,91,10,10
1683685438370,CSE 20,A01,185445,Briones; Jor-el Thomas Caparas,3,0,25,22
1683685439401,CSE 21,A01,185447,Staff,9,0,50,41
1683685440426,CSE 101,A01,185451,Staff,0,13,50,50
1683685440426,CSE 101,B01,185453,Jones; Miles E,0,14,50,50
1683685442483,CSE 141,A01,185458,Eldon; John,16,0,100,84
1683685443507,CSE 141L,A01,185461,Eldon; John,8,0,100,92
1683685444537,CSE 142,A01,185463,Staff,34,0,60,26
1683685444537,CSE 142,B01,201355,Staff,0,7,60,60
1683685445563,CSE 142L,A01,185470,Staff,34,0,60,26
1683685445563,CSE 142L,B01,201417,Staff,0,6,60,60
1683685446589,CSE 190,A00,201433,Staff,32,0,49,17
1683685447615,DOC 1,A01,259136,Strom; Megan C.,7,0,15,8
1683685447615,DOC 1,A02,259137,Strom; Megan C.,14,0,15,1
1683685447615,DOC 1,A03,259138,Strom; Megan C.,14,0,15,1
1683685447615,DOC 1,A04,259139,Strom; Megan C.,14,0,15,1
1683685448640,DOC 100D,A00,259140,Pass; Natalye Joann,14,0,25,11
1683685449667,DSGN 1,A01,184749,Rill; Bryan,0,26,30,30
1683685450692,DSGN 100,A01,185168,Staff,0,2,25,25
1683685451720,ECE 5,A01,185626,Morris; Karcher William,0,12,0,0
1683685452746,ECE 101,A01,185628,Staff,14,0,70,56
1683685453776,ECE 107,A01,185635,Baghdadchi; Saharnaz,0,0,20,20
1683685453776,ECE 107,A02,185638,Baghdadchi; Saharnaz,1,0,20,19
1683685454799,ECE 148,A01,185647,Silberman; Jack,0,0,16,16
1683685455823,ECON 1,A01,185537,Crane; Meredith Helen,54,0,70,16
1683685456850,ECON 3,A01,185549,Crane; Meredith Helen,30,0,70,40
1683685457875,ECON 4,A01,203354,Anderson; John Charles,0,5,10,10
1683685458901,ECON 100A,A01,185574,Staff,0,5,40,40
1683685459927,ECON 100B,A01,185576,Staff,0,12,50,50
1683685460954,ECON 100C,A01,185589,Newhouse; Herbert S,30,0,70,40
1683685461978,ECON 105,A00,185608,Vespa; Emanuel Ignacio,19,0,35,16
1683685463002,ECON 109,A01,185610,Shishkin; Denis,9,0,35,26
1683685464028,ECON 110A,A01,185612,Staff,8,0,40,32
1683685465052,ECON 120A,A01,185615,Staff,19,0,40,21
1683685466074,ECON 120C,A01,185617,Sun; Yixiao,0,21,70,70
1683685467098,ECON 144,A00,203346,Squires; Dale E,2,0,35,33
1683685468124,ECON 171,A01,203349,Newhouse; Herbert S,0,1,35,35
1683685469153,ECON 173A,A01,185621,Toda; Alexis Akira,21,0,35,14
1683685470184,EDS 25,A01,202413,Staff,0,1,0,0
1683685470184,EDS 25,A02,202414,Staff,0,1,0,0
1683685470184,EDS 25,A03,202415,Staff,0,0,0,0
1683685470184,EDS 25,A04,202416,Staff,0,1,0,0
1683685470184,EDS 25,A05,202439,Staff,0,0,0,0
1683685470184,EDS 25,A06,202440,Staff,0,0,0,0
1683685470184,EDS 25,B01,202631,Staff,0,0,0,0
1683685470184,EDS 25,B02,202632,Staff,0,0,0,0
1683685470184,EDS 25,B03,202639,Staff,0,0,0,0
1683685470184,EDS 25,B04,202640,Staff,0,0,0,0
1683685470184,EDS 25,B05,202643,Staff,0,0,0,0
1683685470184,EDS 25,B06,202644,Staff,0,0,0,0
1683685471212,EDS 38,A01,202659,Black; Alison Michelle,24,0,25,1
1683685472236,EDS 115,A00,202652,Staff,18,0,30,12
1683685473265,EDS 125,A00,202649,Staff,13,0,30,17
1683685474289,EDS 126,A01,203332,Staff,30,0,30,0
1683685475313,EDS 139,A00,202838,Staff,16,0,25,9
1683685476338,EDS 146,A01,202655,Staff,14,0,25,11
1683685477362,ENG 15,A00,185667,Staff,0,1,0,0
1683685477362,ENG 15,B00,185672,Staff,0,0,0,0
1683685477362,ENG 15,C00,185675,Staff,0,0,0,0
1683685477362,ENG 15,D00,185682,Staff,0,0,0,0
1683685477362,ENG 15,E00,185684,Staff,0,0,0,0
1683685478389,ETHN 103,A00,185710,Staff,0,8,35,35
1683685479416,ETHN 103A,A00,199228,Man; Simeon S,0,0,9,9
1683685480443,ETHN 109,A00,185711,Staff,15,0,35,20
1683685481467,ETHN 142,A00,185726,Staff,0,4,30,30
1683685482492,ETHN 163J,A00,199229,Man; Simeon S,5,0,8,3
1683685483516,ETHN 168,A00,185727,Staff,7,0,10,3
1683685484541,ETHN 182,A00,185728,Staff,0,0,35,35
1683685485566,ETHN 183,A00,185737,Staff,9,0,18,9
1683685486590,GLBH 111,A01,209361,Burgos; Jose L.,0,0,0,0
1683685488645,HIEU 104,A00,185792,Staff,14,0,20,6
1683685489670,HIEU 115,A00,185800,Staff,0,0,20,20
1683685490698,HIEU 128,A00,185801,Staff,0,9,20,20
1683685491726,HIEU 147,A00,185802,Staff,15,0,20,5
1683685492752,HIEU 154,A00,185823,Staff,11,0,20,9
1683685493780,HILA 102,A00,185826,Staff,14,0,20,6
1683685494806,HILD 2C,A01,185778,Staff,0,13,20,20
1683685495831,HILD 7B,A01,185780,Kwak; Nancy,0,17,32,32
1683685495831,HILD 7B,A02,185781,Kwak; Nancy,0,18,32,32
1683685496855,HILD 30,A01,185791,Staff,12,0,20,8
1683685497882,HISC 119,A00,185830,Golan; Tal,0,10,20,20
1683685498908,HITO 156GS,A00,185831,Patterson; Patrick H.,0,0,0,23
1683685499934,HIUS 103,A00,185832,Man; Simeon S,0,4,20,20
1683685500987,HIUS 117,A00,185836,Kwak; Nancy,2,0,20,18
1683685502021,HIUS 125,A00,185840,Man; Simeon S,0,2,23,23
1683685503047,HIUS 149,A00,185845,Staff,1,0,20,19
1683685504072,HUM 3,A01,185882,Zavodny; Tatiana Sophia,0,8,50,50
1683685504072,HUM 3,B01,185899,Caldwell; Michael Alan,0,18,50,50
1683685505097,HUM 3GS,A00,185900,Patterson; Patrick H.,0,0,0,23
1683685506122,HUM 4,A01,185938,Zroka; Amy Liane,28,0,50,22
1683685506122,HUM 4,B01,185956,Watkins; Eric,0,6,50,50
1683685506122,HUM 4,B02,202209,Watkins; Eric,0,5,50,50
1683685506122,HUM 4,B03,202210,Watkins; Eric,0,5,50,50
1683685507147,HUM 5,A01,185958,West; Geoffrey Scott,0,0,50,50
1683685507147,HUM 5,A02,202215,West; Geoffrey Scott,0,0,50,50
1683685508172,INTL 190,A00,185959,Gagnon; Jeffrey C,0,0,0,9
1683685508172,INTL 190,B00,185960,Lettieri; Michael Joseph,0,0,0,2
1683685509195,JAPN 180,A00,254509,Staff,5,0,30,25
1683685510222,LATI 10,A01,202853,Kennemore; Amy Michelle,4,0,35,31
1683685510222,LATI 10,A02,202854,Kennemore; Amy Michelle,3,0,35,32
1683685510222,LATI 10,A03,270054,Kennemore; Amy Michelle,30,0,30,0
1683685511247,LATI 180,A00,202855,Kennemore; Amy Michelle,11,0,20,9
1683685512271,LAWS 101,A00,201767,Golan; Tal,0,7,40,40
1683685513297,LIFR 1C,A00,185961,Staff,6,0,20,14
1683685514379,LIFR 1CX,A00,185962,Staff,7,0,20,13
1683685515406,LIFR 1D,A00,185963,Staff,7,0,20,13
1683685516431,LIFR 1DX,A00,185964,Staff,7,0,20,13
1683685517454,LIGN 101,A01,186039,Staff,43,0,50,7
1683685518480,LIGN 165,A00,186040,Staff,15,0,50,35
1683685519505,LTCS 108,A00,186041,Staff,5,0,10,5
1683685520527,LTCS 119,A00,186042,Staff,15,0,20,5
1683685521557,LTCS 130,A00,186043,Wesling; Megan E.,15,0,25,10
1683685523611,LTEA 138,A00,186119,Staff,14,0,40,26
1683685524635,LTEN 124,A00,186148,Staff,5,0,25,20
1683685525660,LTEN 178,A00,186149,Staff,6,0,15,9
1683685526684,LTEN 181,A00,186150,Blanco; John D,34,0,40,6
1683685527711,LTWL 120,A00,186160,Staff,19,0,25,6
1683685528739,LTWL 165,A00,186161,Staff,22,0,25,3
1683685529763,LTWR 100,A00,186162,Staff,0,5,15,15
1683685530788,LTWR 102,A00,186163,Doller; Ben,5,0,15,10
1683685531812,MAE 8,A01,186412,Staff,0,1,0,0
1683685532839,MAE 30B,A00,186445,Bahadori; Mohammad Yousef,81,0,100,19
1683685533864,MAE 40,A00,186592,Bewley; Thomas R,10,0,50,40
1683685534888,MAE 101B,A00,186593,Bahadori; Mohammad Yousef,80,0,100,20
1683685535912,MAE 105,A00,186594,Bandaru; Prabhakar,10,0,50,40
1683685536940,MAE 107,A00,186599,Pham; Hieu Tan,0,7,120,120
1683685537964,MAE 148,A01,186660,Silberman; Jack,3,0,16,13
1683685538993,MATH 10A,A01,188095,Staff,0,6,35,35
1683685540021,MATH 10B,A01,188097,Bowers; Adam R.,0,12,30,30
1683685540021,MATH 10B,A02,188099,Bowers; Adam R.,0,11,30,30
1683685540021,MATH 10B,B01,188104,Bowers; Adam R.,0,10,30,30
1683685540021,MATH 10B,B02,188106,Bowers; Adam R.,1,9,30,29
1683685541046,MATH 10C,A01,188111,Staff,0,20,30,30
1683685541046,MATH 10C,A02,188127,Staff,0,19,30,30
1683685541046,MATH 10C,A03,188131,Staff,0,19,30,30
1683685541046,MATH 10C,B01,188218,Staff,17,0,30,13
1683685541046,MATH 10C,B02,188244,Staff,13,0,30,17
1683685541046,MATH 10C,B03,188277,Staff,14,0,30,16
1683685542070,MATH 18,A01,188344,Bach; Quang Tran,18,0,30,12
1683685542070,MATH 18,A02,188345,Bach; Quang Tran,11,0,30,19
1683685542070,MATH 18,B01,188353,Bach; Quang Tran,11,0,30,19
1683685542070,MATH 18,B02,188354,Bach; Quang Tran,19,0,30,11
1683685543095,MATH 20A,A01,188374,Staff,11,0,35,24
1683685544125,MATH 20B,A01,188382,Ohm; Ko Woon,7,0,30,23
1683685544125,MATH 20B,A02,188383,Ohm; Ko Woon,22,0,30,8
1683685544125,MATH 20B,B01,188385,Ohm; Ko Woon,7,0,30,23
1683685544125,MATH 20B,B02,188392,Ohm; Ko Woon,22,0,30,8
1683685545150,MATH 20C,A01,188394,Harel; Guershon,10,0,30,20
1683685545150,MATH 20C,A02,188395,Harel; Guershon,13,0,30,17
1683685545150,MATH 20C,B01,188404,Harel; Guershon,5,0,30,25
1683685545150,MATH 20C,B02,188405,Harel; Guershon,18,0,30,12
1683685546181,MATH 20D,A01,188414,Hammock; Frances H,0,1,30,30
1683685546181,MATH 20D,A02,188415,Hammock; Frances H,0,1,30,30
1683685546181,MATH 20D,B01,188447,Hammock; Frances H,0,1,30,30
1683685546181,MATH 20D,B02,188486,Hammock; Frances H,3,0,30,27
1683685547207,MATH 20E,A01,188649,Staff,21,0,30,9
1683685547207,MATH 20E,A02,188650,Staff,20,0,30,10
1683685547207,MATH 20E,A03,188673,Staff,0,0,30,30
1683685548252,MATH 102,A01,188675,Staff,0,39,35,35
1683685549277,MATH 103B,A01,188681,Staff,3,0,35,32
1683685549277,MATH 103B,B01,188692,Staff,5,0,35,30
1683685550303,MATH 109,A01,188695,Salehi Golsefidy; Alireza,24,0,35,11
1683685550303,MATH 109,A02,188696,Salehi Golsefidy; Alireza,25,0,35,10
1683685551328,MATH 120A,A01,188698,Eggers; John Dietrich,7,0,35,28
1683685552352,MATH 142B,A01,188736,Ioana; Adrian,1,1,30,29
1683685552352,MATH 142B,A02,188741,Ioana; Adrian,0,1,30,30
1683685552352,MATH 142B,A03,188743,Ioana; Adrian,0,1,30,30
1683685553380,MATH 168A,A01,188790,Staff,0,11,35,35
1683685554409,MATH 170A,A01,188803,Nie; Jiawang,0,2,35,35
1683685554409,MATH 170A,A02,188811,Nie; Jiawang,0,1,35,35
1683685554409,MATH 170A,A03,188814,Nie; Jiawang,0,0,35,35
1683685554409,MATH 170A,A04,188815,Nie; Jiawang,6,0,35,29
1683685555436,MATH 193B,A01,188817,Staff,0,0,35,35
1683685555436,MATH 193B,A02,188818,Staff,5,0,35,30
1683685556460,MGT 4,A01,202857,Anderson; John Charles,59,0,80,21
1683685557483,MGT 12,A00,202858,Lindenberger; Wade Douglas,40,0,90,50
1683685558510,MGT 18,A00,202859,Staff,74,0,90,16
1683685559534,MGT 18GS,A00,202860,McKay; Michael J,13,0,28,15
1683685560558,MGT 45,A00,202861,Pecore; Joseph P.,8,0,90,82
1683685561584,MGT 100,A00,202863,Yavorsky; Daniel Ryan,28,0,90,62
1683685562610,MGT 103,A00,202864,Ehrich; Kristine R,0,19,90,90
1683685563634,MGT 112,A00,202865,Ehrich; Kristine R,15,0,90,75
1683685564662,MGT 121A,A00,202868,Staff,90,20,90,0
1683685565687,MGT 131B,A00,202869,Anderson; John Charles,59,0,90,31
1683685566716,MGT 136,A00,202871,Lindenberger; Wade Douglas,83,0,90,7
1683685567744,MGT 164,A00,202873,Staff,0,68,90,91
1683685568768,MGT 164GS,A00,202874,McKay; Mary A,13,0,28,15
1683685569790,MGT 180,A00,202875,Staff,0,51,90,91
1683685570815,MMW 11R,A01,205019,Herbst; Matthew,0,0,30,30
1683685570815,MMW 11R,A02,205026,Herbst; Matthew,29,0,30,1
1683685571844,MMW 15,A01,193512,Chang; Edmond Yi-Teh,0,8,28,28
1683685571844,MMW 15,A02,193513,Chang; Edmond Yi-Teh,0,5,28,28
1683685571844,MMW 15,A03,193514,Chang; Edmond Yi-Teh,0,5,28,28
1683685571844,MMW 15,A04,193515,Chang; Edmond Yi-Teh,0,5,28,28
1683685571844,MMW 15,A05,193516,Chang; Edmond Yi-Teh,0,5,28,28
1683685571844,MMW 15,A06,193517,Chang; Edmond Yi-Teh,0,6,28,28
1683685571844,MMW 15,B01,193519,Chang; Edmond Yi-Teh,0,5,28,28
1683685571844,MMW 15,B02,193520,Chang; Edmond Yi-Teh,0,5,28,28
1683685571844,MMW 15,B03,193521,Chang; Edmond Yi-Teh,0,5,28,28
1683685571844,MMW 15,B04,193522,Chang; Edmond Yi-Teh,0,6,28,28
1683685571844,MMW 15,B05,193523,Chang; Edmond Yi-Teh,0,5,28,28
1683685571844,MMW 15,B06,193524,Chang; Edmond Yi-Teh,0,5,28,28
1683685572871,MMW 122,A01,193526,Rahimi; Babak,0,16,28,28
1683685572871,MMW 122,A02,193527,Rahimi; Babak,0,15,28,28
1683685572871,MMW 122,A03,193528,Rahimi; Babak,0,0,0,0
1683685572871,MMW 122,A04,193529,Rahimi; Babak,0,0,0,0
1683685573896,MUS 1A,A01,186663,Staff,1,19,35,34
1683685574922,MUS 4,A01,186715,Staff,0,12,35,35
1683685575951,MUS 5R,A01,186796,Dubnov; Shlomo,0,17,35,35
1683685576974,MUS 6,A01,186798,Staff,1,5,25,24
1683685577998,MUS 7,A01,186830,Staff,11,0,35,24
1683685579021,MUS 8,A01,186930,Staff,0,27,35,35
1683685580050,MUS 15,A01,186932,Staff,0,15,35,35
1683685580050,MUS 15,B01,186934,Staff,1,17,35,34
1683685581074,MUS 80,A00,186935,Staff,0,0,20,20
1683685581074,MUS 80,B00,186936,Staff,24,0,25,1
1683685582100,NANO 11,A00,204702,Lipomi; Darren John,0,0,0,0
1683685583124,NANO 15,A01,204709,Yang; Kesong,0,1,0,0
1683685584148,NANO 114,A00,202069,Jahed Motlagh; Zeinab,3,0,10,7
1683685585174,PHIL 1,A00,186955,Grush; Rick Scott,31,0,40,9
1683685586198,PHIL 10,A01,186973,Grush; Rick Scott,27,0,35,8
1683685586198,PHIL 10,A02,186974,Grush; Rick Scott,33,0,35,2
1683685587222,PHIL 13,A01,186976,Staff,1,0,35,34
1683685587222,PHIL 13,A02,186977,Staff,16,0,35,19
1683685588246,PHIL 14,A01,186979,Staff,31,0,35,4
1683685588246,PHIL 14,A02,186986,Staff,32,0,35,3
1683685589270,PHIL 28,A01,186988,Staff,16,0,30,14
1683685589270,PHIL 28,A02,186989,Staff,1,0,30,29
1683685589270,PHIL 28,A03,186990,Staff,10,0,30,20
1683685589270,PHIL 28,A04,186991,Staff,26,0,30,4
1683685590295,PHIL 120,A00,186997,Staff,23,0,40,17
1683685591320,PHIL 137,A00,187003,Staff,7,0,40,33
1683685592346,PHIL 150,A00,187015,Staff,47,0,70,23
1683685593374,PHIL 167,A00,187021,Lamey; Andy M.,34,0,40,6
1683685594403,PHIL 174,A01,202226,Staff,17,0,20,3
1683685594403,PHIL 174,A02,202235,Staff,20,0,20,0
1683685595430,PHIL 191A,A00,258918,Staff,0,0,1,1
1683685596457,PHYS 1A,A00,187028,Staff,26,0,60,34
1683685597481,PHYS 1AL,001,187036,Staff,3,0,30,27
1683685597481,PHYS 1AL,002,187049,Staff,18,0,30,12
1683685598504,PHYS 1B,A00,187058,Staff,22,0,60,38
1683685599531,PHYS 1BL,001,187064,Staff,0,1,30,30
1683685599531,PHYS 1BL,002,187070,Staff,4,0,30,26
1683685600558,PHYS 1C,A00,187082,Staff,29,0,120,91
1683685601583,PHYS 1CL,001,187088,Staff,0,9,30,30
1683685601583,PHYS 1CL,002,187089,Staff,0,1,30,30
1683685601583,PHYS 1CL,009,262693,Staff,9,0,30,21
1683685602607,PHYS 2B,A01,187097,Staff,55,0,115,60
1683685603634,PHYS 2C,A01,187099,Staff,63,0,115,52
1683685604661,PHYS 2CL,A01,187101,Staff,5,0,28,23
1683685604661,PHYS 2CL,A02,187102,Staff,15,0,28,13
1683685605686,PHYS 2D,A01,187123,Shotwell; Brian,95,0,115,20
1683685606712,PHYS 4B,A01,187133,Grinstein; Benjamin,35,0,50,15
1683685607738,POLI 10,A00,188819,Staff,0,4,50,50
1683685608764,POLI 11,A00,188827,Staff,43,0,50,7
1683685609788,POLI 13R,A00,188828,Staff,0,1,20,20
1683685610815,POLI 27,A01,188830,Elgin; Samuel Zincke,0,2,70,70
1683685611841,POLI 30,A00,188832,Desposato; Scott,30,0,50,20
1683685612866,POLI 102F,A00,188834,Staff,1,0,40,39
1683685613890,POLI 104A,A00,188852,Staff,12,0,30,18
1683685614914,POLI 104I,A00,188853,Staff,0,8,20,20
1683685615941,POLI 110B,A00,188854,Wiens; David,6,0,20,14
1683685616966,POLI 112A,A00,188855,Wiens; David,3,0,30,27
1683685618055,POLI 117R,A00,188856,Forman; Fonna,0,12,20,20
1683685619080,POLI 118,A00,188857,Ingham; Sean,8,0,20,12
1683685620103,POLI 120G,A00,188858,Staff,8,0,30,22
1683685621127,POLI 131CR,A00,188863,Hoston; Germaine,20,0,50,30
1683685622154,POLI 133,A00,188864,Nellis; Gareth Hb,44,0,50,6
1683685623179,POLI 134D,A00,188865,Desposato; Scott,27,0,30,3
1683685624209,POLI 142A,A00,188871,Gartzke; Erik,21,0,50,29
1683685625236,POLI 142K,A00,188874,Staff,38,0,50,12
1683685626263,POLI 143,A00,188940,Gartzke; Erik,16,0,30,14
1683685627288,POLI 153,A00,188943,Staff,2,0,20,18
1683685628311,POLI 160AA,A00,188944,Staff,10,0,40,30
1683685629336,POLI 170A,A00,188945,Staff,10,0,30,20
1683685631390,PSYC 1,A00,188952,Staff,36,0,90,54
1683685632414,PSYC 2,B00,188953,Staff,19,0,35,16
1683685633440,PSYC 6,A00,188970,Staff,47,0,60,13
1683685634464,PSYC 7,A00,188973,Staff,35,0,45,10
1683685635487,PSYC 60,A01,188980,Rickard; Timothy C.,42,0,60,18
1683685636516,PSYC 70,A01,189001,Steiner; Eric Tomas,21,0,45,24
1683685637541,PSYC 100,A00,189005,Lacefield; Katharine I,0,99,120,120
1683685638564,PSYC 102,A00,189008,Staff,7,0,30,23
1683685639590,PSYC 106,B00,189026,Gorman; Michael R.,27,0,60,33
1683685640618,PSYC 114,B01,189033,Winkielman; Piotr,0,31,30,30
1683685641645,PSYC 131,A00,189036,Anagnostaras; Stephan,0,43,60,60
1683685642671,PSYC 136,A00,189041,Lowe; Angela Beth,0,7,25,25
1683685643697,PSYC 137,A00,189057,Winkielman; Piotr,1,37,25,24
1683685644725,PSYC 144,A00,189107,Wixted; John T,0,11,50,50
1683685646772,PSYC 162,A00,189142,Staff,0,9,85,85
1683685647796,PSYC 172,A00,189144,Gorman; Michael R.,0,6,30,30
1683685649850,PSYC 179,A00,189146,Lacefield; Katharine I,0,87,120,120
1683685650874,PSYC 181,A00,189147,Anagnostaras; Stephan,0,44,90,90
1683685651901,PSYC 190R,A00,189148,Barner; David A.,0,23,80,80
1683685652928,PSYC 191,A00,189275,Rickard; Timothy C.,0,10,25,25
1683685653956,PSYC 193,A00,189276,Chapman; Eddie Nathaniel,0,1,0,4
1683685654984,PSYC 193L,A01,189281,Lowe; Angela Beth,8,0,20,12
1683685654984,PSYC 193L,B01,189285,Staff,28,0,35,7
1683685656009,RELI 149,A00,187137,Rahimi; Babak,6,0,40,34
1683685657037,SE 9,A01,187315,Staff,0,2,18,18
1683685658063,SE 101B,A00,187409,Staff,24,0,30,6
1683685659090,SE 110B,A00,187444,Staff,10,0,40,30
1683685660116,SE 130B,A00,187449,Staff,31,0,40,9
1683685661139,SE 150A,A00,187516,Staff,8,0,20,12
1683685662164,SE 154,A00,187528,Staff,29,0,50,21
1683685663187,SIO 3,A01,258171,Staff,35,0,40,5
1683685664211,SIO 10,A00,187144,Cook; Geoffrey W,1,7,75,74
1683685665235,SIO 45,A00,187152,Cook; Geoffrey W,0,7,100,100
1683685666257,SIO 109R,A00,194486,Staff,0,4,20,20
1683685668313,SIO 187,A01,187233,Kacev; David,12,0,40,28
1683685669339,SOCI 1,A01,258656,Thorpe; Charles Robert,28,0,30,2
1683685669339,SOCI 1,A02,258658,Thorpe; Charles Robert,30,0,30,0
1683685669339,SOCI 1,A03,258661,Thorpe; Charles Robert,25,0,25,0
1683685669339,SOCI 1,A04,258666,Thorpe; Charles Robert,22,0,25,3
1683685669339,SOCI 1,A05,258897,Thorpe; Charles Robert,22,0,25,3
1683685669339,SOCI 1,A06,258898,Thorpe; Charles Robert,25,0,25,0
1683685670366,SOCI 30,A01,258903,Pardo Guerra; Juan Pablo,14,0,30,16
1683685671397,SOCI 102,A00,258904,Staff,9,0,25,16
1683685672422,SOCI 106,A00,258905,Staff,19,0,25,6
1683685673448,SOCI 111,A00,258907,Ribas Norris; Janet Vanesa,26,0,30,4
1683685674471,SOCI 121R,A00,258908,Pardo Guerra; Juan Pablo,8,0,30,22
1683685675498,SOCI 126,A01,203330,Staff,14,0,20,6
1683685676525,SOCI 131,A00,258909,Thorpe; Charles Robert,30,0,60,30
1683685677551,SOCI 135,A00,258910,Payne; Christine Anna,0,12,30,30
1683685678575,SOCI 157,A00,258911,Staff,11,0,30,19
1683685679600,SOCI 184,A00,258912,Staff,25,0,30,5
1683685680623,SOCI 188D,A00,258913,Staff,22,0,30,8
1683685681646,SYN 2,001,187529,Staff,9,0,16,7
1683685681646,SYN 2,002,201452,Staff,1,20,16,15
1683685681646,SYN 2,003,201469,Staff,1,0,16,15
1683685682672,SYN 100,A01,187531,Staff,0,9,20,20
1683685682672,SYN 100,B01,201491,Staff,0,10,20,20
1683685683698,TDAC 1,A00,189286,Walsh; Kim C.,3,0,20,17
1683685683698,TDAC 1,B00,189287,Harting; Carla Kelso,10,0,20,10
1683685684724,TDAC 101,A00,189300,Walsh; Kim C.,16,0,20,4
1683685684724,TDAC 101,B00,189301,Harting; Carla Kelso,18,0,20,2
1683685685748,TDAC 102,A00,189304,Basso; Beatrice,14,0,20,6
1683685686771,TDAC 108,A00,189305,Staff,18,0,20,2
1683685687798,TDDE 131,A00,189310,Staff,19,0,20,1
1683685687798,TDDE 131,B00,189314,Staff,19,0,20,1
1683685687798,TDDE 131,C00,189315,Staff,48,0,50,2
1683685687798,TDDE 131,D00,189316,Staff,14,0,15,1
1683685687798,TDDE 131,E00,204841,Staff,20,0,20,0
1683685688825,TDGE 10,A00,189289,Staff,27,0,50,23
1683685688825,TDGE 10,B00,189290,Havis; Allan,0,1,50,50
1683685689848,TDGE 11,A00,189291,Fulton; Julia,0,4,50,50
1683685689848,TDGE 11,B00,189292,Staff,20,0,25,5
1683685689848,TDGE 11,C00,260270,Staff,0,0,0,0
1683685690873,TDGE 25,A00,189294,Staff,1,0,20,19
1683685691897,TDGE 124,A00,189318,Fulton; Julia,0,8,50,50
1683685692920,TDGE 125,A00,189319,Staff,13,0,25,12
1683685692920,TDGE 125,B00,189320,Staff,23,0,25,2
1683685693946,TDGE 127,A00,189322,Havis; Allan,0,0,50,50
1683685694969,TDHT 101,A00,189323,Staff,18,0,25,7
1683685694969,TDHT 101,B00,189324,Staff,25,0,25,0
1683685695992,TDHT 102,A00,189325,Staff,49,0,50,1
1683685697020,TDMV 1,A00,189295,Arcidiacono; Kristin,20,0,30,10
1683685697020,TDMV 1,B00,189296,Caligagan; Maria T.,24,0,30,6
1683685698050,TDMV 2,A00,189297,Sammartano; Tonnie,27,0,30,3
1683685698050,TDMV 2,B00,189299,Arcidiacono; Kristin,23,0,30,7
1683685699073,TDMV 3,A00,204998,Rincon; Alicia,22,0,30,8
1683685700096,TDMV 120,A00,189458,Sammartano; Tonnie,28,0,30,2
1683685701119,TDMV 138,A00,189541,Jun; Grace Shin Hae,20,0,40,20
1683685702143,TDMV 142,A00,189717,Caligagan; Tony,25,0,30,5
1683685702143,TDMV 142,B00,189718,Caligagan; Maria T.,25,0,30,5
1683685703167,TMC 2,A01,187533,Staff,25,0,25,0
1683685703167,TMC 2,A02,187534,Staff,25,0,25,0
1683685704194,USP 1,A01,187536,Kwak; Nancy,0,16,25,25
1683685705219,USP 5,A01,187538,Staff,8,0,25,17
1683685706246,USP 101,A00,199253,Staff,0,4,0,0
1683685707274,USP 124,A00,187562,Boomhower; Matthew Charles,0,0,30,30
1683685708298,USP 138,A00,187582,Staff,19,0,25,6
1683685709324,USP 152,A01,187597,Staff,3,0,25,22
1683685710351,USP 153,A00,187598,Staff,18,0,25,7
1683685711379,USP 168,A00,187607,Kwak; Nancy,2,0,5,3
1683685712406,USP 173,A00,187619,Staff,4,0,25,21
1683685713430,USP 181,A00,187638,Staff,0,4,25,25
1683685714455,VIS 103,A00,187650,Cruz; Edwin Teddy,17,0,75,58
1683685715480,VIS 110D,A00,187669,Staff,13,0,22,9
1683685716504,VIS 127C,A00,187720,Shen; Kuiyi,67,0,146,79
1683685717528,VIS 149,A00,187731,Yoldas; Pinar,1,14,22,21
1683685718555,VIS 151,A01,188091,Staff,22,0,34,12
1683685718555,VIS 151,A02,188092,Staff,11,0,34,23
1683685719581,VIS 160B,A00,188093,Stalbaum; Brett,0,1,10,10
1683685721689,WCWP 10B,A00,201720,Staff,0,0,5,5
1683685721689,WCWP 10B,B00,201722,Staff,0,0,6,6
1683685722714,WCWP 100,A00,201725,Gagnon; Jeffrey C,0,0,2,2
1683685722714,WCWP 100,B00,201727,Staff,0,4,15,15
1683685725838,ANBI 133,A00,258401,Wilder; Linnea Lorene,34,0,40,6
1683685726862,ANBI 140,A00,258395,Hrvoj Mihic; Branka,18,0,25,7
1683685727887,ANSC 120,A00,258402,Bialecki; Jon Anthony,26,0,40,14
1683685728911,ANSC 144,A00,258400,Staff,12,0,40,28
1683685730959,ANSC 166,A00,258396,Parish; Steven Martin,156,0,175,19
1683685731984,ANSC 180,A00,193533,Staff,8,0,20,12
1683685733008,ANSC 188,A00,258397,Jassal; Aftab,34,0,40,6
1683685734035,ANTH 3,A01,258316,Staff,23,0,30,7
1683685735063,ANTH 5,A00,258394,Semendeferi; Ekaterini,16,0,20,4
1683685736092,ANTH 21,A01,258331,Staff,4,0,40,36
1683685737116,ANTH 103,A00,258398,Varma; Saiba,15,0,25,10
1683685738148,AWP 10,001,202034,Staff,0,0,0,0
1683685738148,AWP 10,002,202035,Staff,0,0,0,0
1683685738148,AWP 10,003,202036,Staff,0,0,0,0
1683685738148,AWP 10,004,202037,Staff,0,0,0,0
1683685738148,AWP 10,005,202038,Staff,0,0,0,0
1683685738148,AWP 10,006,202039,Staff,0,0,0,0
1683685738148,AWP 10,007,202040,Staff,0,0,0,0
1683685738148,AWP 10,008,202041,Staff,0,0,0,0
1683685738148,AWP 10,009,202042,Staff,0,0,0,0
1683685738148,AWP 10,010,202043,Staff,0,0,0,0
1683685738148,AWP 10,011,202044,Staff,0,0,0,0
1683685738148,AWP 10,012,202045,Staff,0,0,0,0
1683685738148,AWP 10,013,202046,Staff,0,0,0,0
1683685738148,AWP 10,014,202047,Staff,0,0,0,0
1683685738148,AWP 10,015,202048,Staff,0,0,0,0
1683685738148,AWP 10,016,202049,Staff,0,0,0,0
1683685738148,AWP 10,017,202050,Staff,0,0,0,0
1683685738148,AWP 10,018,202051,Staff,0,0,0,0
1683685738148,AWP 10,019,202052,Staff,0,0,0,0
1683685738148,AWP 10,020,202053,Staff,0,0,0,0
1683685738148,AWP 10,021,202054,Staff,0,0,0,0
1683685738148,AWP 10,022,202055,Staff,0,0,0,0
1683685738148,AWP 10,023,202056,Staff,0,0,0,0
1683685738148,AWP 10,024,202057,Staff,0,0,0,0
1683685738148,AWP 10,025,202058,Staff,0,0,0,0
1683685738148,AWP 10,026,202059,Staff,0,0,0,0
1683685739174,AWP 102,001,202032,Staff,0,0,0,0
1683685739174,AWP 102,002,202033,Staff,0,0,0,0
1683685740197,BENG 100,A01,254234,Taylor Amos; Alyssa C,31,0,40,9
1683685741219,BENG 196,001,270013,Engler; Adam J.,9999,0,9999,0
1683685742248,BICD 100R,A01,202018,Smith; Laurie,0,7,32,32
1683685742248,BICD 100R,A02,202019,Smith; Laurie,0,3,32,32
1683685742248,BICD 100R,A03,202020,Smith; Laurie,0,1,32,32
1683685742248,BICD 100R,A04,202021,Smith; Laurie,6,0,32,26
1683685742248,BICD 100R,A05,202022,Smith; Laurie,10,0,32,22
1683685743273,BICD 136,A01,193242,Gustafson-Brown; Cindy,0,2,32,32
1683685743273,BICD 136,A02,193244,Gustafson-Brown; Cindy,13,0,32,19
1683685744298,BIEB 102,A01,193249,Butler; Shannon Rhey,1,1,32,31
1683685744298,BIEB 102,A02,193251,Butler; Shannon Rhey,0,0,32,32
1683685744298,BIEB 102,A03,193253,Butler; Shannon Rhey,0,0,32,32
1683685744298,BIEB 102,A04,193255,Butler; Shannon Rhey,13,0,32,19
1683685744298,BIEB 102,A05,193265,Butler; Shannon Rhey,25,0,32,7
1683685744298,BIEB 102,A06,193269,Butler; Shannon Rhey,13,0,32,19
1683685746351,BIEB 150,A01,193274,Staff,0,0,32,32
1683685746351,BIEB 150,A02,193285,Staff,24,0,32,8
1683685747376,BIEB 194,A00,193286,Kurle; Carolyn M.,19,0,32,13
1683685748400,BILD 1,A01,192291,Staff,15,0,32,17
1683685748400,BILD 1,A02,192292,Staff,30,0,32,2
1683685748400,BILD 1,B01,192520,Reuther; Keefe,0,1,0,0
1683685748400,BILD 1,B02,192532,Reuther; Keefe,0,1,0,0
1683685749425,BILD 3,A01,192556,Butler; Shannon Rhey,0,0,32,32
1683685749425,BILD 3,A02,192581,Butler; Shannon Rhey,0,1,32,32
1683685749425,BILD 3,A03,192611,Butler; Shannon Rhey,19,0,32,13
1683685749425,BILD 3,A04,192612,Butler; Shannon Rhey,24,0,32,8
1683685749425,BILD 3,A05,192613,Butler; Shannon Rhey,26,0,32,6
1683685749425,BILD 3,A06,192679,Butler; Shannon Rhey,27,0,32,5
1683685749425,BILD 3,A07,192682,Butler; Shannon Rhey,20,0,32,12
1683685750450,BILD 4,A01,192836,Reuther; Keefe,1,0,24,23
1683685750450,BILD 4,A02,193044,Reuther; Keefe,4,0,24,20
1683685751477,BILD 10,A01,193142,Gustafson-Brown; Cindy,29,0,32,3
1683685751477,BILD 10,A02,193149,Gustafson-Brown; Cindy,31,0,32,1
1683685752503,BIMM 100,A01,193301,Staff,0,6,32,32
1683685752503,BIMM 100,A02,193312,Staff,0,7,32,32
1683685752503,BIMM 100,A03,193323,Staff,0,10,32,32
1683685753527,BIMM 101,A01,193329,McDonnell; Lisa Marie,1,4,24,23
1683685753527,BIMM 101,A02,193339,McDonnell; Lisa Marie,1,4,24,23
1683685753527,BIMM 101,B01,193354,McDonnell; Lisa Marie,0,4,24,24
1683685753527,BIMM 101,B02,193357,McDonnell; Lisa Marie,0,3,24,24
1683685754554,BIMM 110,A01,193377,Tat; John,0,11,32,32
1683685754554,BIMM 110,A02,193378,Tat; John,0,11,32,32
1683685755579,BIMM 120,A01,206116,Staff,0,0,32,32
1683685755579,BIMM 120,A02,206117,Staff,7,0,32,25
1683685755579,BIMM 120,A03,206121,Staff,21,0,32,11
1683685756607,BIPN 100,A01,193393,Park; Ji Young,0,15,32,32
1683685756607,BIPN 100,A02,193402,Park; Ji Young,0,14,32,32
1683685756607,BIPN 100,A03,193413,Park; Ji Young,0,14,32,32
1683685756607,BIPN 100,A04,193414,Park; Ji Young,0,13,32,32
1683685757634,BIPN 102,A01,193429,Staff,0,0,32,32
1683685757634,BIPN 102,A02,193438,Staff,18,0,32,14
1683685758658,BIPN 106,A01,193450,Reyes Gonzalez; Catalina,0,2,40,40
1683685759687,BIPN 134,A01,193465,Cooke; James Edward,0,0,32,32
1683685759687,BIPN 134,A02,193474,Cooke; James Edward,25,0,32,7
1683685759687,BIPN 134,A03,193485,Cooke; James Edward,29,0,32,3
1683685759687,BIPN 134,A04,193486,Cooke; James Edward,20,0,32,12
1683685759687,BIPN 134,A05,193491,Cooke; James Edward,31,0,32,1
1683685759687,BIPN 134,A06,193501,Cooke; James Edward,30,0,32,2
1683685759687,BIPN 134,A07,193510,Cooke; James Edward,29,0,32,3
1683685761742,BISP 194,A00,222522,Staff,14,0,32,18
1683685762769,CAT 124,A01,202407,Staff,19,0,25,6
1683685763796,CAT 125,A00,202408,Marchisotto; Jennifer Anne,2,0,20,18
1683685764827,CAT 125R,A00,202409,Smith; Lauryn Alissa,0,11,20,20
1683685764827,CAT 125R,B00,202410,Morales; Celeste Georgianna,0,11,20,20
1683685764827,CAT 125R,C00,202411,Irwin; Matthew Joseph,0,12,20,20
1683685765855,CENG 15,A01,204712,Yang; Kesong,0,1,0,0
1683685766879,CENG 114,A00,202070,Jahed Motlagh; Zeinab,5,0,20,15
1683685767904,CGS 105,A00,185477,Wesling; Megan E.,24,0,40,16
1683685768929,CGS 106,A00,185494,Staff,11,0,22,11
1683685769956,CGS 108,A00,185495,Staff,14,0,20,6
1683685770980,CGS 114,A00,185496,Staff,13,0,18,5
1683685772005,CGS 119,A00,185501,Staff,15,0,20,5
1683685773033,CGS 120,A00,185511,Staff,12,0,20,8
1683685774058,CHEM 4,A01,184675,Bussey; Thomas J,97,0,100,3
1683685775082,CHEM 6A,A01,184677,Staff,32,0,60,28
1683685776106,CHEM 6B,A01,184679,Staff,63,0,100,37
1683685777133,CHEM 6C,A01,184681,Bussey; Thomas J,0,0,50,50
1683685777133,CHEM 6C,A02,184682,Bussey; Thomas J,32,0,50,18
1683685778159,CHEM 40A,A01,184684,Albizati; Kim F.,33,0,100,67
1683685779184,CHEM 40B,A01,184686,Albizati; Kim F.,0,22,100,100
1683685780208,CHEM 41B,A01,184690,Staff,51,0,100,49
1683685781234,COGS 3,A01,184715,Boyle; Mary E. T.,0,27,40,40
1683685782260,COGS 14B,A01,185172,Staff,0,14,38,38
1683685783288,COGS 18,A01,184736,Staff,14,0,80,66
1683685784315,COGS 100,A01,184932,Staff,0,8,73,73
1683685785342,COGS 101A,A01,184935,Staff,0,40,30,30
1683685786366,COGS 101B,A01,184944,Staff,0,2,30,30
1683685787391,COGS 101C,A01,184946,Staff,0,10,30,30
1683685788423,COGS 102A,A01,184951,Johnson; Christine M.,1,0,40,39
1683685789450,COGS 107B,A01,184953,Mooshagian; Eric Frederick,0,52,40,40
1683685790476,COGS 118B,A01,184959,Gupta; Anjum,0,50,40,40
1683685791502,COGS 153,A00,184961,Staff,0,16,30,30
1683685792526,COGS 177,A00,184962,Staff,1,21,30,29
1683685793551,COGS 187A,A01,184969,Boyle; Mary E. T.,0,19,40,40
1683685794576,COMM 10,A01,185174,Staff,0,5,25,25
1683685794576,COMM 10,A02,185189,Staff,0,2,25,25
1683685794576,COMM 10,A03,269821,Staff,0,1,0,0
1683685795602,COMM 100B,A02,185476,Staff,10,0,25,15
1683685795602,COMM 100B,A03,277340,Staff,25,0,25,0
1683685796627,COMM 100C,A01,185314,Staff,1,0,25,24
1683685796627,COMM 100C,A02,185327,Staff,17,0,25,8
1683685797651,COMM 110M,A00,185349,Staff,0,0,40,40
1683685798676,COMM 113T,A00,185352,Staff,25,0,40,15
1683685799704,COMM 114I,A00,185353,Staff,31,0,40,9
1683685800732,COMM 131,A00,185354,Staff,17,0,30,13
1683685801762,CSE 8A,A50,185358,Cao; Yingjun,0,46,10,10
1683685802788,CSE 8B,A01,185362,Staff,0,48,50,50
1683685803815,CSE 11,A01,185416,Cao; Yingjun,0,91,10,10
1683685804845,CSE 20,A01,185445,Briones; Jor-el Thomas Caparas,3,0,25,22
1683685805872,CSE 21,A01,185447,Staff,9,0,50,41
1683685806901,CSE 101,A01,185451,Staff,0,13,50,50
1683685806901,CSE 101,B01,185453,Jones; Miles E,0,14,50,50
1683685808951,CSE 141,A01,185458,Eldon; John,16,0,100,84
1683685809980,CSE 141L,A01,185461,Eldon; John,8,0,100,92
1683685811008,CSE 142,A01,185463,Staff,34,0,60,26
1683685811008,CSE 142,B01,201355,Staff,0,7,60,60
1683685812036,CSE 142L,A01,185470,Staff,34,0,60,26
1683685812036,CSE 142L,B01,201417,Staff,0,6,60,60
1683685813061,CSE 190,A00,201433,Staff,32,0,49,17
1683685814086,DOC 1,A01,259136,Strom; Megan C.,7,0,15,8
1683685814086,DOC 1,A02,259137,Strom; Megan C.,14,0,15,1
1683685814086,DOC 1,A03,259138,Strom; Megan C.,14,0,15,1
1683685814086,DOC 1,A04,259139,Strom; Megan C.,14,0,15,1
1683685815109,DOC 100D,A00,259140,Pass; Natalye Joann,14,0,25,11
1683685816135,DSGN 1,A01,184749,Rill; Bryan,0,26,30,30
1683685817161,DSGN 100,A01,185168,Staff,0,2,25,25
1683685818184,ECE 5,A01,185626,Morris; Karcher William,0,12,0,0
1683685819211,ECE 101,A01,185628,Staff,14,0,70,56
1683685820236,ECE 107,A01,185635,Baghdadchi; Saharnaz,0,0,20,20
1683685820236,ECE 107,A02,185638,Baghdadchi; Saharnaz,1,0,20,19
1683685821260,ECE 148,A01,185647,Silberman; Jack,0,0,16,16
1683685822287,ECON 1,A01,185537,Crane; Meredith Helen,54,0,70,16
1683685823313,ECON 3,A01,185549,Crane; Meredith Helen,30,0,70,40
1683685824337,ECON 4,A01,203354,Anderson; John Charles,0,5,10,10
1683685825416,ECON 100A,A01,185574,Staff,0,5,40,40
1683685826440,ECON 100B,A01,185576,Staff,0,12,50,50
1683685827465,ECON 100C,A01,185589,Newhouse; Herbert S,30,0,70,40
1683685828487,ECON 105,A00,185608,Vespa; Emanuel Ignacio,19,0,35,16
1683685829520,ECON 109,A01,185610,Shishkin; Denis,9,0,35,26
1683685830544,ECON 110A,A01,185612,Staff,8,0,40,32
1683685831568,ECON 120A,A01,185615,Staff,19,0,40,21
1683685832595,ECON 120C,A01,185617,Sun; Yixiao,0,21,70,70
1683685833618,ECON 144,A00,203346,Squires; Dale E,2,0,35,33
1683685834642,ECON 171,A01,203349,Newhouse; Herbert S,0,1,35,35
1683685835666,ECON 173A,A01,185621,Toda; Alexis Akira,21,0,35,14
1683685836697,EDS 25,A01,202413,Staff,0,1,0,0
1683685836697,EDS 25,A02,202414,Staff,0,1,0,0
1683685836697,EDS 25,A03,202415,Staff,0,0,0,0
1683685836697,EDS 25,A04,202416,Staff,0,1,0,0
1683685836697,EDS 25,A05,202439,Staff,0,0,0,0
1683685836697,EDS 25,A06,202440,Staff,0,0,0,0
1683685836697,EDS 25,B01,202631,Staff,0,0,0,0
1683685836697,EDS 25,B02,202632,Staff,0,0,0,0
1683685836697,EDS 25,B03,202639,Staff,0,0,0,0
1683685836697,EDS 25,B04,202640,Staff,0,0,0,0
1683685836697,EDS 25,B05,202643,Staff,0,0,0,0
1683685836697,EDS 25,B06,202644,Staff,0,0,0,0
1683685837724,EDS 38,A01,202659,Black; Alison Michelle,24,0,25,1
1683685838748,EDS 115,A00,202652,Staff,18,0,30,12
1683685839772,EDS 125,A00,202649,Staff,13,0,30,17
1683685840799,EDS 126,A01,203332,Staff,30,0,30,0
1683685841823,EDS 139,A00,202838,Staff,16,0,25,9
1683685842848,EDS 146,A01,202655,Staff,14,0,25,11
1683685843872,ENG 15,A00,185667,Staff,0,1,0,0
1683685843872,ENG 15,B00,185672,Staff,0,0,0,0
1683685843872,ENG 15,C00,185675,Staff,0,0,0,0
1683685843872,ENG 15,D00,185682,Staff,0,0,0,0
1683685843872,ENG 15,E00,185684,Staff,0,0,0,0
1683685844899,ETHN 103,A00,185710,Staff,0,8,35,35
1683685845923,ETHN 103A,A00,199228,Man; Simeon S,0,0,9,9
1683685846948,ETHN 109,A00,185711,Staff,15,0,35,20
1683685847972,ETHN 142,A00,185726,Staff,0,4,30,30
1683685848996,ETHN 163J,A00,199229,Man; Simeon S,5,0,8,3
1683685850022,ETHN 168,A00,185727,Staff,7,0,10,3
1683685851045,ETHN 182,A00,185728,Staff,0,0,35,35
1683685852070,ETHN 183,A00,185737,Staff,9,0,18,9
1683685853094,GLBH 111,A01,209361,Burgos; Jose L.,0,0,0,0
1683685855144,HIEU 104,A00,185792,Staff,14,0,20,6
1683685856171,HIEU 115,A00,185800,Staff,0,0,20,20
1683685857196,HIEU 128,A00,185801,Staff,0,9,20,20
1683685858220,HIEU 147,A00,185802,Staff,15,0,20,5
1683685859244,HIEU 154,A00,185823,Staff,11,0,20,9
1683685860270,HILA 102,A00,185826,Staff,14,0,20,6
1683685861294,HILD 2C,A01,185778,Staff,0,13,20,20
1683685862318,HILD 7B,A01,185780,Kwak; Nancy,0,17,32,32
1683685862318,HILD 7B,A02,185781,Kwak; Nancy,0,18,32,32
1683685863342,HILD 30,A01,185791,Staff,12,0,20,8
1683685864366,HISC 119,A00,185830,Golan; Tal,0,10,20,20
1683685865392,HITO 156GS,A00,185831,Patterson; Patrick H.,0,0,0,23
1683685866418,HIUS 103,A00,185832,Man; Simeon S,0,4,20,20
1683685867442,HIUS 117,A00,185836,Kwak; Nancy,2,0,20,18
1683685868466,HIUS 125,A00,185840,Man; Simeon S,0,2,23,23
1683685869494,HIUS 149,A00,185845,Staff,1,0,20,19
1683685870522,HUM 3,A01,185882,Zavodny; Tatiana Sophia,0,8,50,50
1683685870522,HUM 3,B01,185899,Caldwell; Michael Alan,0,18,50,50
1683685871548,HUM 3GS,A00,185900,Patterson; Patrick H.,0,0,0,23
1683685872577,HUM 4,A01,185938,Zroka; Amy Liane,28,0,50,22
1683685872577,HUM 4,B01,185956,Watkins; Eric,0,6,50,50
1683685872577,HUM 4,B02,202209,Watkins; Eric,0,5,50,50
1683685872577,HUM 4,B03,202210,Watkins; Eric,0,5,50,50
1683685873605,HUM 5,A01,185958,West; Geoffrey Scott,0,0,50,50
1683685873605,HUM 5,A02,202215,West; Geoffrey Scott,0,0,50,50
1683685874630,INTL 190,A00,185959,Gagnon; Jeffrey C,0,0,0,9
1683685874630,INTL 190,B00,185960,Lettieri; Michael Joseph,0,0,0,2
1683685875656,JAPN 180,A00,254509,Staff,5,0,30,25
1683685876684,LATI 10,A01,202853,Kennemore; Amy Michelle,4,0,35,31
1683685876684,LATI 10,A02,202854,Kennemore; Amy Michelle,3,0,35,32
1683685876684,LATI 10,A03,270054,Kennemore; Amy Michelle,30,0,30,0
1683685877709,LATI 180,A00,202855,Kennemore; Amy Michelle,11,0,20,9
1683685878736,LAWS 101,A00,201767,Golan; Tal,0,7,40,40
1683685879760,LIFR 1C,A00,185961,Staff,6,0,20,14
1683685880790,LIFR 1CX,A00,185962,Staff,7,0,20,13
1683685881817,LIFR 1D,A00,185963,Staff,7,0,20,13
1683685882842,LIFR 1DX,A00,185964,Staff,7,0,20,13
1683685883866,LIGN 101,A01,186039,Staff,43,0,50,7
1683685884890,LIGN 165,A00,186040,Staff,15,0,50,35
1683685885914,LTCS 108,A00,186041,Staff,5,0,10,5
1683685886938,LTCS 119,A00,186042,Staff,15,0,20,5
1683685887962,LTCS 130,A00,186043,Wesling; Megan E.,15,0,25,10
1683685890012,LTEA 138,A00,186119,Staff,14,0,40,26
1683685891040,LTEN 124,A00,186148,Staff,5,0,25,20
1683685892064,LTEN 178,A00,186149,Staff,6,0,15,9
1683685893091,LTEN 181,A00,186150,Blanco; John D,34,0,40,6
1683685894119,LTWL 120,A00,186160,Staff,19,0,25,6
1683685895147,LTWL 165,A00,186161,Staff,22,0,25,3
1683685896175,LTWR 100,A00,186162,Staff,0,5,15,15
1683685897199,LTWR 102,A00,186163,Doller; Ben,5,0,15,10
1683685898224,MAE 8,A01,186412,Staff,0,1,0,0
1683685899248,MAE 30B,A00,186445,Bahadori; Mohammad Yousef,81,0,100,19
1683685900271,MAE 40,A00,186592,Bewley; Thomas R,10,0,50,40
1683685901295,MAE 101B,A00,186593,Bahadori; Mohammad Yousef,80,0,100,20
1683685902319,MAE 105,A00,186594,Bandaru; Prabhakar,10,0,50,40
1683685903347,MAE 107,A00,186599,Pham; Hieu Tan,0,7,120,120
1683685904374,MAE 148,A01,186660,Silberman; Jack,3,0,16,13
1683685905398,MATH 10A,A01,188095,Staff,0,6,35,35
1683685906426,MATH 10B,A01,188097,Bowers; Adam R.,0,12,30,30
1683685906426,MATH 10B,A02,188099,Bowers; Adam R.,0,11,30,30
1683685906426,MATH 10B,B01,188104,Bowers; Adam R.,0,10,30,30
1683685906426,MATH 10B,B02,188106,Bowers; Adam R.,1,9,30,29
1683685907450,MATH 10C,A01,188111,Staff,0,20,30,30
1683685907450,MATH 10C,A02,188127,Staff,0,19,30,30
1683685907450,MATH 10C,A03,188131,Staff,0,19,30,30
1683685907450,MATH 10C,B01,188218,Staff,17,0,30,13
1683685907450,MATH 10C,B02,188244,Staff,13,0,30,17
1683685907450,MATH 10C,B03,188277,Staff,14,0,30,16
1683685908480,MATH 18,A01,188344,Bach; Quang Tran,18,0,30,12
1683685908480,MATH 18,A02,188345,Bach; Quang Tran,11,0,30,19
1683685908480,MATH 18,B01,188353,Bach; Quang Tran,11,0,30,19
1683685908480,MATH 18,B02,188354,Bach; Quang Tran,19,0,30,11
1683685909505,MATH 20A,A01,188374,Staff,11,0,35,24
1683685910529,MATH 20B,A01,188382,Ohm; Ko Woon,7,0,30,23
1683685910529,MATH 20B,A02,188383,Ohm; Ko Woon,22,0,30,8
1683685910529,MATH 20B,B01,188385,Ohm; Ko Woon,7,0,30,23
1683685910529,MATH 20B,B02,188392,Ohm; Ko Woon,22,0,30,8
1683685911558,MATH 20C,A01,188394,Harel; Guershon,10,0,30,20
1683685911558,MATH 20C,A02,188395,Harel; Guershon,13,0,30,17
1683685911558,MATH 20C,B01,188404,Harel; Guershon,5,0,30,25
1683685911558,MATH 20C,B02,188405,Harel; Guershon,18,0,30,12
1683685912583,MATH 20D,A01,188414,Hammock; Frances H,0,1,30,30
1683685912583,MATH 20D,A02,188415,Hammock; Frances H,0,1,30,30
1683685912583,MATH 20D,B01,188447,Hammock; Frances H,0,1,30,30
1683685912583,MATH 20D,B02,188486,Hammock; Frances H,3,0,30,27
1683685913607,MATH 20E,A01,188649,Staff,21,0,30,9
1683685913607,MATH 20E,A02,188650,Staff,20,0,30,10
1683685913607,MATH 20E,A03,188673,Staff,0,0,30,30
1683685914636,MATH 102,A01,188675,Staff,0,39,35,35
1683685915661,MATH 103B,A01,188681,Staff,3,0,35,32
1683685915661,MATH 103B,B01,188692,Staff,5,0,35,30
1683685916689,MATH 109,A01,188695,Salehi Golsefidy; Alireza,24,0,35,11
1683685916689,MATH 109,A02,188696,Salehi Golsefidy; Alireza,25,0,35,10
1683685917714,MATH 120A,A01,188698,Eggers; John Dietrich,7,0,35,28
1683685918737,MATH 142B,A01,188736,Ioana; Adrian,1,1,30,29
1683685918737,MATH 142B,A02,188741,Ioana; Adrian,0,1,30,30
1683685918737,MATH 142B,A03,188743,Ioana; Adrian,0,1,30,30
1683685919761,MATH 168A,A01,188790,Staff,0,11,35,35
1683685920785,MATH 170A,A01,188803,Nie; Jiawang,0,2,35,35
1683685920785,MATH 170A,A02,188811,Nie; Jiawang,0,1,35,35
1683685920785,MATH 170A,A03,188814,Nie; Jiawang,0,0,35,35
1683685920785,MATH 170A,A04,188815,Nie; Jiawang,6,0,35,29
1683685921814,MATH 193B,A01,188817,Staff,0,0,35,35
1683685921814,MATH 193B,A02,188818,Staff,5,0,35,30
1683685922838,MGT 4,A01,202857,Anderson; John Charles,59,0,80,21
1683685923865,MGT 12,A00,202858,Lindenberger; Wade Douglas,40,0,90,50
1683685924892,MGT 18,A00,202859,Staff,74,0,90,16
1683685925917,MGT 18GS,A00,202860,McKay; Michael J,13,0,28,15
1683685926944,MGT 45,A00,202861,Pecore; Joseph P.,8,0,90,82
1683685927971,MGT 100,A00,202863,Yavorsky; Daniel Ryan,27,0,90,63
1683685929071,MGT 103,A00,202864,Ehrich; Kristine R,0,19,90,90
1683685930096,MGT 112,A00,202865,Ehrich; Kristine R,15,0,90,75
1683685931119,MGT 121A,A00,202868,Staff,90,20,90,0
1683685932145,MGT 131B,A00,202869,Anderson; John Charles,59,0,90,31
1683685933169,MGT 136,A00,202871,Lindenberger; Wade Douglas,83,0,90,7
1683685934194,MGT 164,A00,202873,Staff,0,68,90,91
1683685935221,MGT 164GS,A00,202874,McKay; Mary A,13,0,28,15
1683685936244,MGT 180,A00,202875,Staff,0,51,90,91
1683685937271,MMW 11R,A01,205019,Herbst; Matthew,0,0,30,30
1683685937271,MMW 11R,A02,205026,Herbst; Matthew,29,0,30,1
1683685938302,MMW 15,A01,193512,Chang; Edmond Yi-Teh,0,8,28,28
1683685938302,MMW 15,A02,193513,Chang; Edmond Yi-Teh,0,5,28,28
1683685938302,MMW 15,A03,193514,Chang; Edmond Yi-Teh,0,5,28,28
1683685938302,MMW 15,A04,193515,Chang; Edmond Yi-Teh,0,5,28,28
1683685938302,MMW 15,A05,193516,Chang; Edmond Yi-Teh,0,5,28,28
1683685938302,MMW 15,A06,193517,Chang; Edmond Yi-Teh,0,6,28,28
1683685938302,MMW 15,B01,193519,Chang; Edmond Yi-Teh,0,5,28,28
1683685938302,MMW 15,B02,193520,Chang; Edmond Yi-Teh,0,5,28,28
1683685938302,MMW 15,B03,193521,Chang; Edmond Yi-Teh,0,5,28,28
1683685938302,MMW 15,B04,193522,Chang; Edmond Yi-Teh,0,6,28,28
1683685938302,MMW 15,B05,193523,Chang; Edmond Yi-Teh,0,5,28,28
1683685938302,MMW 15,B06,193524,Chang; Edmond Yi-Teh,0,5,28,28
1683685939327,MMW 122,A01,193526,Rahimi; Babak,0,16,28,28
1683685939327,MMW 122,A02,193527,Rahimi; Babak,0,15,28,28
1683685939327,MMW 122,A03,193528,Rahimi; Babak,0,0,0,0
1683685939327,MMW 122,A04,193529,Rahimi; Babak,0,0,0,0
1683685940355,MUS 1A,A01,186663,Staff,1,19,35,34
1683685941380,MUS 4,A01,186715,Staff,0,12,35,35
1683685942402,MUS 5R,A01,186796,Dubnov; Shlomo,0,17,35,35
1683685943427,MUS 6,A01,186798,Staff,1,5,25,24
1683685944450,MUS 7,A01,186830,Staff,11,0,35,24
1683685945478,MUS 8,A01,186930,Staff,0,27,35,35
1683685946502,MUS 15,A01,186932,Staff,0,15,35,35
1683685946502,MUS 15,B01,186934,Staff,1,17,35,34
1683685947529,MUS 80,A00,186935,Staff,0,0,20,20
1683685947529,MUS 80,B00,186936,Staff,24,0,25,1
1683685948553,NANO 11,A00,204702,Lipomi; Darren John,0,0,0,0
1683685949579,NANO 15,A01,204709,Yang; Kesong,0,1,0,0
1683685950604,NANO 114,A00,202069,Jahed Motlagh; Zeinab,2,0,10,8
1683685951636,PHIL 1,A00,186955,Grush; Rick Scott,31,0,40,9
1683685952664,PHIL 10,A01,186973,Grush; Rick Scott,27,0,35,8
1683685952664,PHIL 10,A02,186974,Grush; Rick Scott,33,0,35,2
1683685953688,PHIL 13,A01,186976,Staff,1,0,35,34
1683685953688,PHIL 13,A02,186977,Staff,16,0,35,19
1683685954715,PHIL 14,A01,186979,Staff,31,0,35,4
1683685954715,PHIL 14,A02,186986,Staff,32,0,35,3
1683685955742,PHIL 28,A01,186988,Staff,16,0,30,14
1683685955742,PHIL 28,A02,186989,Staff,1,0,30,29
1683685955742,PHIL 28,A03,186990,Staff,10,0,30,20
1683685955742,PHIL 28,A04,186991,Staff,26,0,30,4
1683685956768,PHIL 120,A00,186997,Staff,23,0,40,17
1683685957792,PHIL 137,A00,187003,Staff,7,0,40,33
1683685958816,PHIL 150,A00,187015,Staff,47,0,70,23
1683685959842,PHIL 167,A00,187021,Lamey; Andy M.,34,0,40,6
1683685960867,PHIL 174,A01,202226,Staff,17,0,20,3
1683685960867,PHIL 174,A02,202235,Staff,20,0,20,0
1683685961890,PHIL 191A,A00,258918,Staff,0,0,1,1
1683685962914,PHYS 1A,A00,187028,Staff,26,0,60,34
1683685963945,PHYS 1AL,001,187036,Staff,3,0,30,27
1683685963945,PHYS 1AL,002,187049,Staff,18,0,30,12
1683685964968,PHYS 1B,A00,187058,Staff,22,0,60,38
1683685965993,PHYS 1BL,001,187064,Staff,0,1,30,30
1683685965993,PHYS 1BL,002,187070,Staff,4,0,30,26
1683685967017,PHYS 1C,A00,187082,Staff,29,0,120,91
1683685968044,PHYS 1CL,001,187088,Staff,0,9,30,30
1683685968044,PHYS 1CL,002,187089,Staff,0,1,30,30
1683685968044,PHYS 1CL,009,262693,Staff,9,0,30,21
1683685969067,PHYS 2B,A01,187097,Staff,55,0,115,60
1683685970092,PHYS 2C,A01,187099,Staff,63,0,115,52
1683685971115,PHYS 2CL,A01,187101,Staff,5,0,28,23
1683685971115,PHYS 2CL,A02,187102,Staff,15,0,28,13
1683685972140,PHYS 2D,A01,187123,Shotwell; Brian,95,0,115,20
1683685973167,PHYS 4B,A01,187133,Grinstein; Benjamin,35,0,50,15
1683685974190,POLI 10,A00,188819,Staff,0,4,50,50
1683685975216,POLI 11,A00,188827,Staff,43,0,50,7
1683685976242,POLI 13R,A00,188828,Staff,0,1,20,20
1683685977266,POLI 27,A01,188830,Elgin; Samuel Zincke,0,2,70,70
1683685978292,POLI 30,A00,188832,Desposato; Scott,30,0,50,20
1683685979316,POLI 102F,A00,188834,Staff,1,0,40,39
1683685980345,POLI 104A,A00,188852,Staff,12,0,30,18
1683685981370,POLI 104I,A00,188853,Staff,0,8,20,20
1683685982393,POLI 110B,A00,188854,Wiens; David,6,0,20,14
1683685983418,POLI 112A,A00,188855,Wiens; David,3,0,30,27
1683685984442,POLI 117R,A00,188856,Forman; Fonna,0,12,20,20
1683685985469,POLI 118,A00,188857,Ingham; Sean,8,0,20,12
1683685986494,POLI 120G,A00,188858,Staff,8,0,30,22
1683685987521,POLI 131CR,A00,188863,Hoston; Germaine,20,0,50,30
1683685988547,POLI 133,A00,188864,Nellis; Gareth Hb,44,0,50,6
1683685989570,POLI 134D,A00,188865,Desposato; Scott,27,0,30,3
1683685990593,POLI 142A,A00,188871,Gartzke; Erik,21,0,50,29
1683685991617,POLI 142K,A00,188874,Staff,38,0,50,12
1683685992644,POLI 143,A00,188940,Gartzke; Erik,16,0,30,14
1683685993671,POLI 153,A00,188943,Staff,2,0,20,18
1683685994695,POLI 160AA,A00,188944,Staff,10,0,40,30
1683685995720,POLI 170A,A00,188945,Staff,10,0,30,20
1683685997768,PSYC 1,A00,188952,Staff,36,0,90,54
1683685998798,PSYC 2,B00,188953,Staff,19,0,35,16
1683685999823,PSYC 6,A00,188970,Staff,47,0,60,13
1683686000848,PSYC 7,A00,188973,Staff,35,0,45,10
1683686001875,PSYC 60,A01,188980,Rickard; Timothy C.,42,0,60,18
1683686002899,PSYC 70,A01,189001,Steiner; Eric Tomas,21,0,45,24
1683686003926,PSYC 100,A00,189005,Lacefield; Katharine I,0,99,120,120
1683686004949,PSYC 102,A00,189008,Staff,7,0,30,23
1683686005972,PSYC 106,B00,189026,Gorman; Michael R.,27,0,60,33
1683686006999,PSYC 114,B01,189033,Winkielman; Piotr,0,31,30,30
1683686008023,PSYC 131,A00,189036,Anagnostaras; Stephan,0,43,60,60
1683686009050,PSYC 136,A00,189041,Lowe; Angela Beth,0,7,25,25
1683686010077,PSYC 137,A00,189057,Winkielman; Piotr,1,37,25,24
1683686011099,PSYC 144,A00,189107,Wixted; John T,0,11,50,50
1683686013181,PSYC 162,A00,189142,Staff,0,9,85,85
1683686014215,PSYC 172,A00,189144,Gorman; Michael R.,0,6,30,30
1683686016264,PSYC 179,A00,189146,Lacefield; Katharine I,0,87,120,120
1683686017291,PSYC 181,A00,189147,Anagnostaras; Stephan,0,44,90,90
1683686018315,PSYC 190R,A00,189148,Barner; David A.,0,23,80,80
1683686019339,PSYC 191,A00,189275,Rickard; Timothy C.,0,10,25,25
1683686020366,PSYC 193,A00,189276,Chapman; Eddie Nathaniel,0,1,0,4
1683686021391,PSYC 193L,A01,189281,Lowe; Angela Beth,8,0,20,12
1683686021391,PSYC 193L,B01,189285,Staff,28,0,35,7
1683686022419,RELI 149,A00,187137,Rahimi; Babak,6,0,40,34
1683686023442,SE 9,A01,187315,Staff,0,2,18,18
1683686024466,SE 101B,A00,187409,Staff,24,0,30,6
1683686025491,SE 110B,A00,187444,Staff,10,0,40,30
1683686026514,SE 130B,A00,187449,Staff,31,0,40,9
1683686027538,SE 150A,A00,187516,Staff,8,0,20,12
1683686028561,SE 154,A00,187528,Staff,29,0,50,21
1683686029586,SIO 3,A01,258171,Staff,35,0,40,5
1683686030614,SIO 10,A00,187144,Cook; Geoffrey W,1,7,75,74
1683686031642,SIO 45,A00,187152,Cook; Geoffrey W,0,7,100,100
1683686032726,SIO 109R,A00,194486,Staff,0,4,20,20
1683686034776,SIO 187,A01,187233,Kacev; David,12,0,40,28
1683686035810,SOCI 1,A01,258656,Thorpe; Charles Robert,28,0,30,2
1683686035810,SOCI 1,A02,258658,Thorpe; Charles Robert,30,0,30,0
1683686035810,SOCI 1,A03,258661,Thorpe; Charles Robert,25,0,25,0
1683686035810,SOCI 1,A04,258666,Thorpe; Charles Robert,22,0,25,3
1683686035810,SOCI 1,A05,258897,Thorpe; Charles Robert,22,0,25,3
1683686035810,SOCI 1,A06,258898,Thorpe; Charles Robert,25,0,25,0
1683686036837,SOCI 30,A01,258903,Pardo Guerra; Juan Pablo,14,0,30,16
1683686037867,SOCI 102,A00,258904,Staff,9,0,25,16
1683686038890,SOCI 106,A00,258905,Staff,19,0,25,6
1683686039919,SOCI 111,A00,258907,Ribas Norris; Janet Vanesa,26,0,30,4
1683686040943,SOCI 121R,A00,258908,Pardo Guerra; Juan Pablo,8,0,30,22
1683686041971,SOCI 126,A01,203330,Staff,14,0,20,6
1683686042999,SOCI 131,A00,258909,Thorpe; Charles Robert,30,0,60,30
1683686044025,SOCI 135,A00,258910,Payne; Christine Anna,0,12,30,30
1683686045049,SOCI 157,A00,258911,Staff,11,0,30,19
1683686046074,SOCI 184,A00,258912,Staff,25,0,30,5
1683686047099,SOCI 188D,A00,258913,Staff,22,0,30,8
1683686048128,SYN 2,001,187529,Staff,9,0,16,7
1683686048128,SYN 2,002,201452,Staff,1,20,16,15
1683686048128,SYN 2,003,201469,Staff,1,0,16,15
1683686049153,SYN 100,A01,187531,Staff,0,9,20,20
1683686049153,SYN 100,B01,201491,Staff,0,10,20,20
1683686050182,TDAC 1,A00,189286,Walsh; Kim C.,3,0,20,17
1683686050182,TDAC 1,B00,189287,Harting; Carla Kelso,10,0,20,10
1683686051207,TDAC 101,A00,189300,Walsh; Kim C.,16,0,20,4
1683686051207,TDAC 101,B00,189301,Harting; Carla Kelso,18,0,20,2
1683686052234,TDAC 102,A00,189304,Basso; Beatrice,14,0,20,6
1683686053257,TDAC 108,A00,189305,Staff,18,0,20,2
1683686054288,TDDE 131,A00,189310,Staff,19,0,20,1
1683686054288,TDDE 131,B00,189314,Staff,19,0,20,1
1683686054288,TDDE 131,C00,189315,Staff,48,0,50,2
1683686054288,TDDE 131,D00,189316,Staff,14,0,15,1
1683686054288,TDDE 131,E00,204841,Staff,20,0,20,0
1683686055314,TDGE 10,A00,189289,Staff,27,0,50,23
1683686055314,TDGE 10,B00,189290,Havis; Allan,0,1,50,50
1683686056341,TDGE 11,A00,189291,Fulton; Julia,0,4,50,50
1683686056341,TDGE 11,B00,189292,Staff,20,0,25,5
1683686056341,TDGE 11,C00,260270,Staff,0,0,0,0
1683686057365,TDGE 25,A00,189294,Staff,1,0,20,19
1683686058388,TDGE 124,A00,189318,Fulton; Julia,0,8,50,50
1683686059414,TDGE 125,A00,189319,Staff,13,0,25,12
1683686059414,TDGE 125,B00,189320,Staff,23,0,25,2
1683686060438,TDGE 127,A00,189322,Havis; Allan,0,0,50,50
1683686061465,TDHT 101,A00,189323,Staff,18,0,25,7
1683686061465,TDHT 101,B00,189324,Staff,25,0,25,0
1683686062493,TDHT 102,A00,189325,Staff,49,0,50,1
1683686063522,TDMV 1,A00,189295,Arcidiacono; Kristin,20,0,30,10
1683686063522,TDMV 1,B00,189296,Caligagan; Maria T.,24,0,30,6
1683686064547,TDMV 2,A00,189297,Sammartano; Tonnie,27,0,30,3
1683686064547,TDMV 2,B00,189299,Arcidiacono; Kristin,23,0,30,7
1683686065577,TDMV 3,A00,204998,Rincon; Alicia,22,0,30,8
1683686066602,TDMV 120,A00,189458,Sammartano; Tonnie,28,0,30,2
1683686067630,TDMV 138,A00,189541,Jun; Grace Shin Hae,20,0,40,20
1683686068657,TDMV 142,A00,189717,Caligagan; Tony,25,0,30,5
1683686068657,TDMV 142,B00,189718,Caligagan; Maria T.,25,0,30,5
1683686069687,TMC 2,A01,187533,Staff,25,0,25,0
1683686069687,TMC 2,A02,187534,Staff,25,0,25,0
1683686070711,USP 1,A01,187536,Kwak; Nancy,0,16,25,25
1683686071738,USP 5,A01,187538,Staff,8,0,25,17
1683686072762,USP 101,A00,199253,Staff,0,4,0,0
1683686073787,USP 124,A00,187562,Boomhower; Matthew Charles,0,0,30,30
1683686074814,USP 138,A00,187582,Staff,19,0,25,6
1683686075841,USP 152,A01,187597,Staff,3,0,25,22
1683686076865,USP 153,A00,187598,Staff,18,0,25,7
1683686077894,USP 168,A00,187607,Kwak; Nancy,2,0,5,3
1683686078917,USP 173,A00,187619,Staff,4,0,25,21
1683686079944,USP 181,A00,187638,Staff,0,4,25,25
1683686080973,VIS 103,A00,187650,Cruz; Edwin Teddy,17,0,75,58
1683686081996,VIS 110D,A00,187669,Staff,13,0,22,9
1683686083023,VIS 127C,A00,187720,Shen; Kuiyi,67,0,146,79
1683686084049,VIS 149,A00,187731,Yoldas; Pinar,1,14,22,21
1683686085072,VIS 151,A01,188091,Staff,22,0,34,12
1683686085072,VIS 151,A02,188092,Staff,11,0,34,23
1683686086101,VIS 160B,A00,188093,Stalbaum; Brett,0,1,10,10
1683686088150,WCWP 10B,A00,201720,Staff,0,0,5,5
1683686088150,WCWP 10B,B00,201722,Staff,0,0,6,6
1683686089178,WCWP 100,A00,201725,Gagnon; Jeffrey C,0,0,2,2
1683686089178,WCWP 100,B00,201727,Staff,0,4,15,15
1683686092306,ANBI 133,A00,258401,Wilder; Linnea Lorene,34,0,40,6
1683686093334,ANBI 140,A00,258395,Hrvoj Mihic; Branka,18,0,25,7
1683686094394,ANSC 120,A00,258402,Bialecki; Jon Anthony,26,0,40,14
1683686095417,ANSC 144,A00,258400,Staff,12,0,40,28
1683686097468,ANSC 166,A00,258396,Parish; Steven Martin,156,0,175,19
1683686098493,ANSC 180,A00,193533,Staff,8,0,20,12
1683686099521,ANSC 188,A00,258397,Jassal; Aftab,34,0,40,6
1683686100548,ANTH 3,A01,258316,Staff,23,0,30,7
1683686101577,ANTH 5,A00,258394,Semendeferi; Ekaterini,16,0,20,4
1683686102601,ANTH 21,A01,258331,Staff,4,0,40,36
1683686103627,ANTH 103,A00,258398,Varma; Saiba,15,0,25,10
1683686104656,AWP 10,001,202034,Staff,0,0,0,0
1683686104656,AWP 10,002,202035,Staff,0,0,0,0
1683686104656,AWP 10,003,202036,Staff,0,0,0,0
1683686104656,AWP 10,004,202037,Staff,0,0,0,0
1683686104656,AWP 10,005,202038,Staff,0,0,0,0
1683686104656,AWP 10,006,202039,Staff,0,0,0,0
1683686104656,AWP 10,007,202040,Staff,0,0,0,0
1683686104656,AWP 10,008,202041,Staff,0,0,0,0
1683686104656,AWP 10,009,202042,Staff,0,0,0,0
1683686104656,AWP 10,010,202043,Staff,0,0,0,0
1683686104656,AWP 10,011,202044,Staff,0,0,0,0
1683686104656,AWP 10,012,202045,Staff,0,0,0,0
1683686104656,AWP 10,013,202046,Staff,0,0,0,0
1683686104656,AWP 10,014,202047,Staff,0,0,0,0
1683686104656,AWP 10,015,202048,Staff,0,0,0,0
1683686104656,AWP 10,016,202049,Staff,0,0,0,0
1683686104656,AWP 10,017,202050,Staff,0,0,0,0
1683686104656,AWP 10,018,202051,Staff,0,0,0,0
1683686104656,AWP 10,019,202052,Staff,0,0,0,0
1683686104656,AWP 10,020,202053,Staff,0,0,0,0
1683686104656,AWP 10,021,202054,Staff,0,0,0,0
1683686104656,AWP 10,022,202055,Staff,0,0,0,0
1683686104656,AWP 10,023,202056,Staff,0,0,0,0
1683686104656,AWP 10,024,202057,Staff,0,0,0,0
1683686104656,AWP 10,025,202058,Staff,0,0,0,0
1683686104656,AWP 10,026,202059,Staff,0,0,0,0
1683686105681,AWP 102,001,202032,Staff,0,0,0,0
1683686105681,AWP 102,002,202033,Staff,0,0,0,0
1683686106705,BENG 100,A01,254234,Taylor Amos; Alyssa C,31,0,40,9
1683686107732,BENG 196,001,270013,Engler; Adam J.,9999,0,9999,0
1683686108758,BICD 100R,A01,202018,Smith; Laurie,0,7,32,32
1683686108758,BICD 100R,A02,202019,Smith; Laurie,0,3,32,32
1683686108758,BICD 100R,A03,202020,Smith; Laurie,0,1,32,32
1683686108758,BICD 100R,A04,202021,Smith; Laurie,6,0,32,26
1683686108758,BICD 100R,A05,202022,Smith; Laurie,10,0,32,22
1683686109783,BICD 136,A01,193242,Gustafson-Brown; Cindy,0,2,32,32
1683686109783,BICD 136,A02,193244,Gustafson-Brown; Cindy,13,0,32,19
1683686110810,BIEB 102,A01,193249,Butler; Shannon Rhey,1,1,32,31
1683686110810,BIEB 102,A02,193251,Butler; Shannon Rhey,0,0,32,32
1683686110810,BIEB 102,A03,193253,Butler; Shannon Rhey,0,0,32,32
1683686110810,BIEB 102,A04,193255,Butler; Shannon Rhey,13,0,32,19
1683686110810,BIEB 102,A05,193265,Butler; Shannon Rhey,25,0,32,7
1683686110810,BIEB 102,A06,193269,Butler; Shannon Rhey,13,0,32,19
1683686112859,BIEB 150,A01,193274,Staff,0,0,32,32
1683686112859,BIEB 150,A02,193285,Staff,24,0,32,8
1683686113884,BIEB 194,A00,193286,Kurle; Carolyn M.,19,0,32,13
1683686114910,BILD 1,A01,192291,Staff,15,0,32,17
1683686114910,BILD 1,A02,192292,Staff,30,0,32,2
1683686114910,BILD 1,B01,192520,Reuther; Keefe,0,1,0,0
1683686114910,BILD 1,B02,192532,Reuther; Keefe,0,1,0,0
1683686115934,BILD 3,A01,192556,Butler; Shannon Rhey,0,0,32,32
1683686115934,BILD 3,A02,192581,Butler; Shannon Rhey,0,1,32,32
1683686115934,BILD 3,A03,192611,Butler; Shannon Rhey,19,0,32,13
1683686115934,BILD 3,A04,192612,Butler; Shannon Rhey,24,0,32,8
1683686115934,BILD 3,A05,192613,Butler; Shannon Rhey,26,0,32,6
1683686115934,BILD 3,A06,192679,Butler; Shannon Rhey,27,0,32,5
1683686115934,BILD 3,A07,192682,Butler; Shannon Rhey,20,0,32,12
1683686116959,BILD 4,A01,192836,Reuther; Keefe,1,0,24,23
1683686116959,BILD 4,A02,193044,Reuther; Keefe,4,0,24,20
1683686117982,BILD 10,A01,193142,Gustafson-Brown; Cindy,29,0,32,3
1683686117982,BILD 10,A02,193149,Gustafson-Brown; Cindy,31,0,32,1
1683686119007,BIMM 100,A01,193301,Staff,0,6,32,32
1683686119007,BIMM 100,A02,193312,Staff,0,7,32,32
1683686119007,BIMM 100,A03,193323,Staff,0,10,32,32
1683686120032,BIMM 101,A01,193329,McDonnell; Lisa Marie,1,4,24,23
1683686120032,BIMM 101,A02,193339,McDonnell; Lisa Marie,1,4,24,23
1683686120032,BIMM 101,B01,193354,McDonnell; Lisa Marie,0,4,24,24
1683686120032,BIMM 101,B02,193357,McDonnell; Lisa Marie,0,3,24,24
1683686121061,BIMM 110,A01,193377,Tat; John,0,11,32,32
1683686121061,BIMM 110,A02,193378,Tat; John,0,11,32,32
1683686122086,BIMM 120,A01,206116,Staff,0,0,32,32
1683686122086,BIMM 120,A02,206117,Staff,7,0,32,25
1683686122086,BIMM 120,A03,206121,Staff,21,0,32,11
1683686123117,BIPN 100,A01,193393,Park; Ji Young,0,15,32,32
1683686123117,BIPN 100,A02,193402,Park; Ji Young,0,14,32,32
1683686123117,BIPN 100,A03,193413,Park; Ji Young,0,14,32,32
1683686123117,BIPN 100,A04,193414,Park; Ji Young,0,13,32,32
1683686124143,BIPN 102,A01,193429,Staff,0,0,32,32
1683686124143,BIPN 102,A02,193438,Staff,18,0,32,14
1683686125168,BIPN 106,A01,193450,Reyes Gonzalez; Catalina,0,2,40,40
1683686126196,BIPN 134,A01,193465,Cooke; James Edward,0,0,32,32
1683686126196,BIPN 134,A02,193474,Cooke; James Edward,25,0,32,7
1683686126196,BIPN 134,A03,193485,Cooke; James Edward,29,0,32,3
1683686126196,BIPN 134,A04,193486,Cooke; James Edward,20,0,32,12
1683686126196,BIPN 134,A05,193491,Cooke; James Edward,31,0,32,1
1683686126196,BIPN 134,A06,193501,Cooke; James Edward,30,0,32,2
1683686126196,BIPN 134,A07,193510,Cooke; James Edward,29,0,32,3
1683686128248,BISP 194,A00,222522,Staff,14,0,32,18
1683686129272,CAT 124,A01,202407,Staff,19,0,25,6
1683686130297,CAT 125,A00,202408,Marchisotto; Jennifer Anne,2,0,20,18
1683686131363,CAT 125R,A00,202409,Smith; Lauryn Alissa,0,11,20,20
1683686131363,CAT 125R,B00,202410,Morales; Celeste Georgianna,0,11,20,20
1683686131363,CAT 125R,C00,202411,Irwin; Matthew Joseph,0,12,20,20
1683686132391,CENG 15,A01,204712,Yang; Kesong,0,1,0,0
1683686133418,CENG 114,A00,202070,Jahed Motlagh; Zeinab,5,0,20,15
1683686134444,CGS 105,A00,185477,Wesling; Megan E.,24,0,40,16
1683686135469,CGS 106,A00,185494,Staff,11,0,22,11
1683686136550,CGS 108,A00,185495,Staff,14,0,20,6
1683686137577,CGS 114,A00,185496,Staff,13,0,18,5
1683686138602,CGS 119,A00,185501,Staff,15,0,20,5
1683686139629,CGS 120,A00,185511,Staff,12,0,20,8
1683686140655,CHEM 4,A01,184675,Bussey; Thomas J,97,0,100,3
1683686141683,CHEM 6A,A01,184677,Staff,32,0,60,28
1683686142707,CHEM 6B,A01,184679,Staff,63,0,100,37
1683686143736,CHEM 6C,A01,184681,Bussey; Thomas J,0,0,50,50
1683686143736,CHEM 6C,A02,184682,Bussey; Thomas J,32,0,50,18
1683686144761,CHEM 40A,A01,184684,Albizati; Kim F.,33,0,100,67
1683686145787,CHEM 40B,A01,184686,Albizati; Kim F.,0,22,100,100
1683686146812,CHEM 41B,A01,184690,Staff,51,0,100,49
1683686147837,COGS 3,A01,184715,Boyle; Mary E. T.,0,27,40,40
1683686148865,COGS 14B,A01,185172,Staff,0,14,38,38
1683686149890,COGS 18,A01,184736,Staff,14,0,80,66
1683686150916,COGS 100,A01,184932,Staff,0,8,73,73
1683686151940,COGS 101A,A01,184935,Staff,0,40,30,30
1683686152964,COGS 101B,A01,184944,Staff,0,2,30,30
1683686153987,COGS 101C,A01,184946,Staff,0,10,30,30
1683686155014,COGS 102A,A01,184951,Johnson; Christine M.,1,0,40,39
1683686156040,COGS 107B,A01,184953,Mooshagian; Eric Frederick,0,52,40,40
1683686157065,COGS 118B,A01,184959,Gupta; Anjum,0,50,40,40
1683686158087,COGS 153,A00,184961,Staff,0,16,30,30
1683686159111,COGS 177,A00,184962,Staff,1,21,30,29
1683686160171,COGS 187A,A01,184969,Boyle; Mary E. T.,0,19,40,40
1683686161199,COMM 10,A01,185174,Staff,0,5,25,25
1683686161199,COMM 10,A02,185189,Staff,0,2,25,25
1683686161199,COMM 10,A03,269821,Staff,0,1,0,0
1683686162226,COMM 100B,A02,185476,Staff,10,0,25,15
1683686162226,COMM 100B,A03,277340,Staff,25,0,25,0
1683686163254,COMM 100C,A01,185314,Staff,1,0,25,24
1683686163254,COMM 100C,A02,185327,Staff,17,0,25,8
1683686164280,COMM 110M,A00,185349,Staff,0,0,40,40
1683686165308,COMM 113T,A00,185352,Staff,25,0,40,15
1683686166332,COMM 114I,A00,185353,Staff,31,0,40,9
1683686167358,COMM 131,A00,185354,Staff,17,0,30,13
1683686168387,CSE 8A,A50,185358,Cao; Yingjun,0,46,10,10
1683686169414,CSE 8B,A01,185362,Staff,0,48,50,50
1683686170438,CSE 11,A01,185416,Cao; Yingjun,0,91,10,10
1683686171466,CSE 20,A01,185445,Briones; Jor-el Thomas Caparas,3,0,25,22
1683686172490,CSE 21,A01,185447,Staff,9,0,50,41
1683686173519,CSE 101,A01,185451,Staff,0,13,50,50
1683686173519,CSE 101,B01,185453,Jones; Miles E,0,14,50,50
1683686175568,CSE 141,A01,185458,Eldon; John,16,0,100,84
1683686176595,CSE 141L,A01,185461,Eldon; John,8,0,100,92
1683686177619,CSE 142,A01,185463,Staff,34,0,60,26
1683686177619,CSE 142,B01,201355,Staff,0,7,60,60
1683686178641,CSE 142L,A01,185470,Staff,34,0,60,26
1683686178641,CSE 142L,B01,201417,Staff,0,6,60,60
1683686179666,CSE 190,A00,201433,Staff,32,0,49,17
1683686180694,DOC 1,A01,259136,Strom; Megan C.,7,0,15,8
1683686180694,DOC 1,A02,259137,Strom; Megan C.,14,0,15,1
1683686180694,DOC 1,A03,259138,Strom; Megan C.,14,0,15,1
1683686180694,DOC 1,A04,259139,Strom; Megan C.,14,0,15,1
1683686181718,DOC 100D,A00,259140,Pass; Natalye Joann,14,0,25,11
1683686182742,DSGN 1,A01,184749,Rill; Bryan,0,26,30,30
1683686183766,DSGN 100,A01,185168,Staff,0,2,25,25
1683686184791,ECE 5,A01,185626,Morris; Karcher William,0,12,0,0
1683686185816,ECE 101,A01,185628,Staff,14,0,70,56
1683686186840,ECE 107,A01,185635,Baghdadchi; Saharnaz,0,0,20,20
1683686186840,ECE 107,A02,185638,Baghdadchi; Saharnaz,1,0,20,19
1683686187867,ECE 148,A01,185647,Silberman; Jack,0,0,16,16
1683686188894,ECON 1,A01,185537,Crane; Meredith Helen,54,0,70,16
1683686189919,ECON 3,A01,185549,Crane; Meredith Helen,30,0,70,40
1683686190947,ECON 4,A01,203354,Anderson; John Charles,0,5,10,10
1683686191971,ECON 100A,A01,185574,Staff,0,5,40,40
1683686192998,ECON 100B,A01,185576,Staff,0,12,50,50
1683686194024,ECON 100C,A01,185589,Newhouse; Herbert S,30,0,70,40
1683686195048,ECON 105,A00,185608,Vespa; Emanuel Ignacio,19,0,35,16
1683686196071,ECON 109,A01,185610,Shishkin; Denis,9,0,35,26
1683686197099,ECON 110A,A01,185612,Staff,8,0,40,32
1683686198123,ECON 120A,A01,185615,Staff,19,0,40,21
1683686199151,ECON 120C,A01,185617,Sun; Yixiao,0,21,70,70
1683686200175,ECON 144,A00,203346,Squires; Dale E,2,0,35,33
1683686201199,ECON 171,A01,203349,Newhouse; Herbert S,0,1,35,35
1683686202224,ECON 173A,A01,185621,Toda; Alexis Akira,21,0,35,14
1683686203251,EDS 25,A01,202413,Staff,0,1,0,0
1683686203251,EDS 25,A02,202414,Staff,0,1,0,0
1683686203251,EDS 25,A03,202415,Staff,0,0,0,0
1683686203251,EDS 25,A04,202416,Staff,0,1,0,0
1683686203251,EDS 25,A05,202439,Staff,0,0,0,0
1683686203251,EDS 25,A06,202440,Staff,0,0,0,0
1683686203251,EDS 25,B01,202631,Staff,0,0,0,0
1683686203251,EDS 25,B02,202632,Staff,0,0,0,0
1683686203251,EDS 25,B03,202639,Staff,0,0,0,0
1683686203251,EDS 25,B04,202640,Staff,0,0,0,0
1683686203251,EDS 25,B05,202643,Staff,0,0,0,0
1683686203251,EDS 25,B06,202644,Staff,0,0,0,0
1683686204279,EDS 38,A01,202659,Black; Alison Michelle,24,0,25,1
1683686205303,EDS 115,A00,202652,Staff,18,0,30,12
1683686206327,EDS 125,A00,202649,Staff,13,0,30,17
1683686207354,EDS 126,A01,203332,Staff,30,0,30,0
1683686208377,EDS 139,A00,202838,Staff,16,0,25,9
1683686209405,EDS 146,A01,202655,Staff,14,0,25,11
1683686210433,ENG 15,A00,185667,Staff,0,1,0,0
1683686210433,ENG 15,B00,185672,Staff,0,0,0,0
1683686210433,ENG 15,C00,185675,Staff,0,0,0,0
1683686210433,ENG 15,D00,185682,Staff,0,0,0,0
1683686210433,ENG 15,E00,185684,Staff,0,0,0,0
1683686211460,ETHN 103,A00,185710,Staff,0,8,35,35
1683686212484,ETHN 103A,A00,199228,Man; Simeon S,0,0,9,9
1683686213512,ETHN 109,A00,185711,Staff,15,0,35,20
1683686214537,ETHN 142,A00,185726,Staff,0,4,30,30
1683686215565,ETHN 163J,A00,199229,Man; Simeon S,5,0,8,3
1683686216593,ETHN 168,A00,185727,Staff,7,0,10,3
1683686217618,ETHN 182,A00,185728,Staff,0,0,35,35
1683686218643,ETHN 183,A00,185737,Staff,9,0,18,9
1683686219667,GLBH 111,A01,209361,Burgos; Jose L.,0,0,0,0
1683686221722,HIEU 104,A00,185792,Staff,14,0,20,6
1683686222747,HIEU 115,A00,185800,Staff,0,0,20,20
1683686223775,HIEU 128,A00,185801,Staff,0,9,20,20
1683686224803,HIEU 147,A00,185802,Staff,15,0,20,5
1683686225827,HIEU 154,A00,185823,Staff,11,0,20,9
1683686226853,HILA 102,A00,185826,Staff,14,0,20,6
1683686227879,HILD 2C,A01,185778,Staff,0,13,20,20
1683686228906,HILD 7B,A01,185780,Kwak; Nancy,0,17,32,32
1683686228906,HILD 7B,A02,185781,Kwak; Nancy,0,18,32,32
1683686229934,HILD 30,A01,185791,Staff,12,0,20,8
1683686230958,HISC 119,A00,185830,Golan; Tal,0,10,20,20
1683686231985,HITO 156GS,A00,185831,Patterson; Patrick H.,0,0,0,23
1683686233011,HIUS 103,A00,185832,Man; Simeon S,0,4,20,20
1683686234037,HIUS 117,A00,185836,Kwak; Nancy,2,0,20,18
1683686235061,HIUS 125,A00,185840,Man; Simeon S,0,2,23,23
1683686236087,HIUS 149,A00,185845,Staff,1,0,20,19
1683686237117,HUM 3,A01,185882,Zavodny; Tatiana Sophia,0,8,50,50
1683686237117,HUM 3,B01,185899,Caldwell; Michael Alan,0,18,50,50
1683686238141,HUM 3GS,A00,185900,Patterson; Patrick H.,0,0,0,23
1683686239176,HUM 4,A01,185938,Zroka; Amy Liane,28,0,50,22
1683686239176,HUM 4,B01,185956,Watkins; Eric,0,6,50,50
1683686239176,HUM 4,B02,202209,Watkins; Eric,0,5,50,50
1683686239176,HUM 4,B03,202210,Watkins; Eric,0,5,50,50
1683686240258,HUM 5,A01,185958,West; Geoffrey Scott,0,0,50,50
1683686240258,HUM 5,A02,202215,West; Geoffrey Scott,0,0,50,50
1683686241285,INTL 190,A00,185959,Gagnon; Jeffrey C,0,0,0,9
1683686241285,INTL 190,B00,185960,Lettieri; Michael Joseph,0,0,0,2
1683686242309,JAPN 180,A00,254509,Staff,5,0,30,25
1683686243334,LATI 10,A01,202853,Kennemore; Amy Michelle,4,0,35,31
1683686243334,LATI 10,A02,202854,Kennemore; Amy Michelle,3,0,35,32
1683686243334,LATI 10,A03,270054,Kennemore; Amy Michelle,30,0,30,0
1683686244358,LATI 180,A00,202855,Kennemore; Amy Michelle,11,0,20,9
1683686245384,LAWS 101,A00,201767,Golan; Tal,0,7,40,40
1683686246407,LIFR 1C,A00,185961,Staff,6,0,20,14
1683686247435,LIFR 1CX,A00,185962,Staff,7,0,20,13
1683686248459,LIFR 1D,A00,185963,Staff,7,0,20,13
1683686249486,LIFR 1DX,A00,185964,Staff,7,0,20,13
1683686250510,LIGN 101,A01,186039,Staff,43,0,50,7
1683686251535,LIGN 165,A00,186040,Staff,15,0,50,35
1683686252557,LTCS 108,A00,186041,Staff,5,0,10,5
1683686253581,LTCS 119,A00,186042,Staff,15,0,20,5
1683686254605,LTCS 130,A00,186043,Wesling; Megan E.,15,0,25,10
1683686256653,LTEA 138,A00,186119,Staff,14,0,40,26
1683686257680,LTEN 124,A00,186148,Staff,5,0,25,20
1683686258705,LTEN 178,A00,186149,Staff,6,0,15,9
1683686259734,LTEN 181,A00,186150,Blanco; John D,34,0,40,6
1683686260758,LTWL 120,A00,186160,Staff,19,0,25,6
1683686261785,LTWL 165,A00,186161,Staff,22,0,25,3
1683686262812,LTWR 100,A00,186162,Staff,0,5,15,15
1683686263836,LTWR 102,A00,186163,Doller; Ben,5,0,15,10
1683686264859,MAE 8,A01,186412,Staff,0,1,0,0
1683686265882,MAE 30B,A00,186445,Bahadori; Mohammad Yousef,81,0,100,19
1683686266907,MAE 40,A00,186592,Bewley; Thomas R,10,0,50,40
1683686267935,MAE 101B,A00,186593,Bahadori; Mohammad Yousef,80,0,100,20
1683686268962,MAE 105,A00,186594,Bandaru; Prabhakar,10,0,50,40
1683686269990,MAE 107,A00,186599,Pham; Hieu Tan,0,7,120,120
1683686271015,MAE 148,A01,186660,Silberman; Jack,3,0,16,13
1683686272042,MATH 10A,A01,188095,Staff,0,6,35,35
1683686273068,MATH 10B,A01,188097,Bowers; Adam R.,0,12,30,30
1683686273068,MATH 10B,A02,188099,Bowers; Adam R.,0,11,30,30
1683686273068,MATH 10B,B01,188104,Bowers; Adam R.,0,10,30,30
1683686273068,MATH 10B,B02,188106,Bowers; Adam R.,1,9,30,29
1683686274094,MATH 10C,A01,188111,Staff,0,20,30,30
1683686274094,MATH 10C,A02,188127,Staff,0,19,30,30
1683686274094,MATH 10C,A03,188131,Staff,0,19,30,30
1683686274094,MATH 10C,B01,188218,Staff,17,0,30,13
1683686274094,MATH 10C,B02,188244,Staff,13,0,30,17
1683686274094,MATH 10C,B03,188277,Staff,14,0,30,16
1683686275119,MATH 18,A01,188344,Bach; Quang Tran,18,0,30,12
1683686275119,MATH 18,A02,188345,Bach; Quang Tran,11,0,30,19
1683686275119,MATH 18,B01,188353,Bach; Quang Tran,11,0,30,19
1683686275119,MATH 18,B02,188354,Bach; Quang Tran,19,0,30,11
1683686276145,MATH 20A,A01,188374,Staff,11,0,35,24
1683686277170,MATH 20B,A01,188382,Ohm; Ko Woon,7,0,30,23
1683686277170,MATH 20B,A02,188383,Ohm; Ko Woon,22,0,30,8
1683686277170,MATH 20B,B01,188385,Ohm; Ko Woon,7,0,30,23
1683686277170,MATH 20B,B02,188392,Ohm; Ko Woon,22,0,30,8
1683686278197,MATH 20C,A01,188394,Harel; Guershon,10,0,30,20
1683686278197,MATH 20C,A02,188395,Harel; Guershon,13,0,30,17
1683686278197,MATH 20C,B01,188404,Harel; Guershon,5,0,30,25
1683686278197,MATH 20C,B02,188405,Harel; Guershon,18,0,30,12
1683686279226,MATH 20D,A01,188414,Hammock; Frances H,0,1,30,30
1683686279226,MATH 20D,A02,188415,Hammock; Frances H,0,1,30,30
1683686279226,MATH 20D,B01,188447,Hammock; Frances H,0,1,30,30
1683686279226,MATH 20D,B02,188486,Hammock; Frances H,2,0,30,28
1683686280254,MATH 20E,A01,188649,Staff,21,0,30,9
1683686280254,MATH 20E,A02,188650,Staff,20,0,30,10
1683686280254,MATH 20E,A03,188673,Staff,0,0,30,30
1683686281281,MATH 102,A01,188675,Staff,0,39,35,35
1683686282315,MATH 103B,A01,188681,Staff,3,0,35,32
1683686282315,MATH 103B,B01,188692,Staff,5,0,35,30
1683686283344,MATH 109,A01,188695,Salehi Golsefidy; Alireza,24,0,35,11
1683686283344,MATH 109,A02,188696,Salehi Golsefidy; Alireza,25,0,35,10
1683686284369,MATH 120A,A01,188698,Eggers; John Dietrich,7,0,35,28
1683686285398,MATH 142B,A01,188736,Ioana; Adrian,1,1,30,29
1683686285398,MATH 142B,A02,188741,Ioana; Adrian,0,1,30,30
1683686285398,MATH 142B,A03,188743,Ioana; Adrian,0,1,30,30
1683686286424,MATH 168A,A01,188790,Staff,0,11,35,35
1683686287454,MATH 170A,A01,188803,Nie; Jiawang,0,2,35,35
1683686287454,MATH 170A,A02,188811,Nie; Jiawang,0,1,35,35
1683686287454,MATH 170A,A03,188814,Nie; Jiawang,0,0,35,35
1683686287454,MATH 170A,A04,188815,Nie; Jiawang,6,0,35,29
1683686288477,MATH 193B,A01,188817,Staff,0,0,35,35
1683686288477,MATH 193B,A02,188818,Staff,5,0,35,30
1683686289501,MGT 4,A01,202857,Anderson; John Charles,59,0,80,21
1683686290526,MGT 12,A00,202858,Lindenberger; Wade Douglas,40,0,90,50
1683686291556,MGT 18,A00,202859,Staff,74,0,90,16
1683686292581,MGT 18GS,A00,202860,McKay; Michael J,13,0,28,15
1683686293606,MGT 45,A00,202861,Pecore; Joseph P.,8,0,90,82
1683686294634,MGT 100,A00,202863,Yavorsky; Daniel Ryan,27,0,90,63
1683686295658,MGT 103,A00,202864,Ehrich; Kristine R,0,19,90,90
1683686296686,MGT 112,A00,202865,Ehrich; Kristine R,15,0,90,75
1683686297712,MGT 121A,A00,202868,Staff,90,20,90,0
1683686298735,MGT 131B,A00,202869,Anderson; John Charles,59,0,90,31
1683686299763,MGT 136,A00,202871,Lindenberger; Wade Douglas,83,0,90,7
1683686300786,MGT 164,A00,202873,Staff,0,68,90,91
1683686301809,MGT 164GS,A00,202874,McKay; Mary A,13,0,28,15
1683686302836,MGT 180,A00,202875,Staff,0,51,90,91
1683686303859,MMW 11R,A01,205019,Herbst; Matthew,0,0,30,30
1683686303859,MMW 11R,A02,205026,Herbst; Matthew,29,0,30,1
1683686304888,MMW 15,A01,193512,Chang; Edmond Yi-Teh,0,8,28,28
1683686304888,MMW 15,A02,193513,Chang; Edmond Yi-Teh,0,5,28,28
1683686304888,MMW 15,A03,193514,Chang; Edmond Yi-Teh,0,5,28,28
1683686304888,MMW 15,A04,193515,Chang; Edmond Yi-Teh,0,5,28,28
1683686304888,MMW 15,A05,193516,Chang; Edmond Yi-Teh,0,5,28,28
1683686304888,MMW 15,A06,193517,Chang; Edmond Yi-Teh,0,6,28,28
1683686304888,MMW 15,B01,193519,Chang; Edmond Yi-Teh,0,5,28,28
1683686304888,MMW 15,B02,193520,Chang; Edmond Yi-Teh,0,5,28,28
1683686304888,MMW 15,B03,193521,Chang; Edmond Yi-Teh,0,5,28,28
1683686304888,MMW 15,B04,193522,Chang; Edmond Yi-Teh,0,6,28,28
1683686304888,MMW 15,B05,193523,Chang; Edmond Yi-Teh,0,5,28,28
1683686304888,MMW 15,B06,193524,Chang; Edmond Yi-Teh,0,5,28,28
1683686305914,MMW 122,A01,193526,Rahimi; Babak,0,16,28,28
1683686305914,MMW 122,A02,193527,Rahimi; Babak,0,15,28,28
1683686305914,MMW 122,A03,193528,Rahimi; Babak,0,0,0,0
1683686305914,MMW 122,A04,193529,Rahimi; Babak,0,0,0,0
1683686306942,MUS 1A,A01,186663,Staff,1,19,35,34
1683686307990,MUS 4,A01,186715,Staff,0,12,35,35
1683686309018,MUS 5R,A01,186796,Dubnov; Shlomo,0,17,35,35
1683686310045,MUS 6,A01,186798,Staff,1,5,25,24
1683686311069,MUS 7,A01,186830,Staff,11,0,35,24
1683686312093,MUS 8,A01,186930,Staff,0,27,35,35
1683686313119,MUS 15,A01,186932,Staff,0,15,35,35
1683686313119,MUS 15,B01,186934,Staff,1,17,35,34
1683686314144,MUS 80,A00,186935,Staff,0,0,20,20
1683686314144,MUS 80,B00,186936,Staff,24,0,25,1
1683686315171,NANO 11,A00,204702,Lipomi; Darren John,0,0,0,0
1683686316199,NANO 15,A01,204709,Yang; Kesong,0,1,0,0
1683686317225,NANO 114,A00,202069,Jahed Motlagh; Zeinab,2,0,10,8
1683686318250,PHIL 1,A00,186955,Grush; Rick Scott,31,0,40,9
1683686319275,PHIL 10,A01,186973,Grush; Rick Scott,27,0,35,8
1683686319275,PHIL 10,A02,186974,Grush; Rick Scott,33,0,35,2
1683686320301,PHIL 13,A01,186976,Staff,1,0,35,34
1683686320301,PHIL 13,A02,186977,Staff,16,0,35,19
1683686321328,PHIL 14,A01,186979,Staff,31,0,35,4
1683686321328,PHIL 14,A02,186986,Staff,32,0,35,3
1683686322354,PHIL 28,A01,186988,Staff,16,0,30,14
1683686322354,PHIL 28,A02,186989,Staff,1,0,30,29
1683686322354,PHIL 28,A03,186990,Staff,10,0,30,20
1683686322354,PHIL 28,A04,186991,Staff,26,0,30,4
1683686323377,PHIL 120,A00,186997,Staff,23,0,40,17
1683686324404,PHIL 137,A00,187003,Staff,7,0,40,33
1683686325426,PHIL 150,A00,187015,Staff,47,0,70,23
1683686326451,PHIL 167,A00,187021,Lamey; Andy M.,34,0,40,6
1683686327483,PHIL 174,A01,202226,Staff,17,0,20,3
1683686327483,PHIL 174,A02,202235,Staff,20,0,20,0
1683686328509,PHIL 191A,A00,258918,Staff,0,0,1,1
1683686329534,PHYS 1A,A00,187028,Staff,26,0,60,34
1683686330559,PHYS 1AL,001,187036,Staff,3,0,30,27
1683686330559,PHYS 1AL,002,187049,Staff,18,0,30,12
1683686331586,PHYS 1B,A00,187058,Staff,22,0,60,38
1683686332617,PHYS 1BL,001,187064,Staff,0,1,30,30
1683686332617,PHYS 1BL,002,187070,Staff,4,0,30,26
1683686333642,PHYS 1C,A00,187082,Staff,29,0,120,91
1683686334667,PHYS 1CL,001,187088,Staff,0,9,30,30
1683686334667,PHYS 1CL,002,187089,Staff,0,1,30,30
1683686334667,PHYS 1CL,009,262693,Staff,9,0,30,21
1683686335695,PHYS 2B,A01,187097,Staff,55,0,115,60
1683686336721,PHYS 2C,A01,187099,Staff,63,0,115,52
1683686337746,PHYS 2CL,A01,187101,Staff,5,0,28,23
1683686337746,PHYS 2CL,A02,187102,Staff,15,0,28,13
1683686338772,PHYS 2D,A01,187123,Shotwell; Brian,95,0,115,20
1683686339801,PHYS 4B,A01,187133,Grinstein; Benjamin,35,0,50,15
1683686340824,POLI 10,A00,188819,Staff,0,4,50,50
1683686341852,POLI 11,A00,188827,Staff,43,0,50,7
1683686342875,POLI 13R,A00,188828,Staff,0,1,20,20
1683686343958,POLI 27,A01,188830,Elgin; Samuel Zincke,0,2,70,70
1683686344983,POLI 30,A00,188832,Desposato; Scott,30,0,50,20
1683686346011,POLI 102F,A00,188834,Staff,1,0,40,39
1683686347034,POLI 104A,A00,188852,Staff,12,0,30,18
1683686348060,POLI 104I,A00,188853,Staff,0,8,20,20
1683686349085,POLI 110B,A00,188854,Wiens; David,6,0,20,14
1683686350108,POLI 112A,A00,188855,Wiens; David,3,0,30,27
1683686351131,POLI 117R,A00,188856,Forman; Fonna,0,12,20,20
1683686352156,POLI 118,A00,188857,Ingham; Sean,8,0,20,12
1683686353183,POLI 120G,A00,188858,Staff,8,0,30,22
1683686354211,POLI 131CR,A00,188863,Hoston; Germaine,20,0,50,30
1683686355238,POLI 133,A00,188864,Nellis; Gareth Hb,44,0,50,6
1683686356262,POLI 134D,A00,188865,Desposato; Scott,27,0,30,3
1683686357286,POLI 142A,A00,188871,Gartzke; Erik,21,0,50,29
1683686358313,POLI 142K,A00,188874,Staff,38,0,50,12
1683686359336,POLI 143,A00,188940,Gartzke; Erik,16,0,30,14
1683686360364,POLI 153,A00,188943,Staff,2,0,20,18
1683686361391,POLI 160AA,A00,188944,Staff,10,0,40,30
1683686362415,POLI 170A,A00,188945,Staff,10,0,30,20
1683686364465,PSYC 1,A00,188952,Staff,36,0,90,54
1683686365491,PSYC 2,B00,188953,Staff,19,0,35,16
1683686366518,PSYC 6,A00,188970,Staff,47,0,60,13
1683686367542,PSYC 7,A00,188973,Staff,35,0,45,10
1683686368571,PSYC 60,A01,188980,Rickard; Timothy C.,42,0,60,18
1683686369599,PSYC 70,A01,189001,Steiner; Eric Tomas,21,0,45,24
1683686370626,PSYC 100,A00,189005,Lacefield; Katharine I,0,99,120,120
1683686371654,PSYC 102,A00,189008,Staff,7,0,30,23
1683686372681,PSYC 106,B00,189026,Gorman; Michael R.,27,0,60,33
1683686373706,PSYC 114,B01,189033,Winkielman; Piotr,0,31,30,30
1683686374733,PSYC 131,A00,189036,Anagnostaras; Stephan,0,43,60,60
1683686375760,PSYC 136,A00,189041,Lowe; Angela Beth,0,7,25,25
1683686376784,PSYC 137,A00,189057,Winkielman; Piotr,1,37,25,24
1683686377808,PSYC 144,A00,189107,Wixted; John T,0,11,50,50
1683686379859,PSYC 162,A00,189142,Staff,0,9,85,85
1683686380883,PSYC 172,A00,189144,Gorman; Michael R.,0,6,30,30
1683686382932,PSYC 179,A00,189146,Lacefield; Katharine I,0,87,120,120
1683686383958,PSYC 181,A00,189147,Anagnostaras; Stephan,0,44,90,90
1683686384985,PSYC 190R,A00,189148,Barner; David A.,0,23,80,80
1683686386010,PSYC 191,A00,189275,Rickard; Timothy C.,0,10,25,25
1683686387037,PSYC 193,A00,189276,Chapman; Eddie Nathaniel,0,1,0,4
1683686388064,PSYC 193L,A01,189281,Lowe; Angela Beth,8,0,20,12
1683686388064,PSYC 193L,B01,189285,Staff,28,0,35,7
1683686389088,RELI 149,A00,187137,Rahimi; Babak,6,0,40,34
1683686390112,SE 9,A01,187315,Staff,0,2,18,18
1683686391136,SE 101B,A00,187409,Staff,24,0,30,6
1683686392159,SE 110B,A00,187444,Staff,10,0,40,30
1683686393184,SE 130B,A00,187449,Staff,31,0,40,9
1683686394212,SE 150A,A00,187516,Staff,8,0,20,12
1683686395238,SE 154,A00,187528,Staff,29,0,50,21
1683686396262,SIO 3,A01,258171,Staff,35,0,40,5
1683686397285,SIO 10,A00,187144,Cook; Geoffrey W,1,7,75,74
1683686398307,SIO 45,A00,187152,Cook; Geoffrey W,0,7,100,100
1683686399335,SIO 109R,A00,194486,Staff,0,4,20,20
1683686401383,SIO 187,A01,187233,Kacev; David,12,0,40,28
1683686402413,SOCI 1,A01,258656,Thorpe; Charles Robert,28,0,30,2
1683686402413,SOCI 1,A02,258658,Thorpe; Charles Robert,30,0,30,0
1683686402413,SOCI 1,A03,258661,Thorpe; Charles Robert,25,0,25,0
1683686402413,SOCI 1,A04,258666,Thorpe; Charles Robert,22,0,25,3
1683686402413,SOCI 1,A05,258897,Thorpe; Charles Robert,22,0,25,3
1683686402413,SOCI 1,A06,258898,Thorpe; Charles Robert,25,0,25,0
1683686403436,SOCI 30,A01,258903,Pardo Guerra; Juan Pablo,14,0,30,16
1683686404461,SOCI 102,A00,258904,Staff,9,0,25,16
1683686405488,SOCI 106,A00,258905,Staff,19,0,25,6
1683686406512,SOCI 111,A00,258907,Ribas Norris; Janet Vanesa,26,0,30,4
1683686407538,SOCI 121R,A00,258908,Pardo Guerra; Juan Pablo,8,0,30,22
1683686408562,SOCI 126,A01,203330,Staff,14,0,20,6
1683686409587,SOCI 131,A00,258909,Thorpe; Charles Robert,30,0,60,30
1683686410612,SOCI 135,A00,258910,Payne; Christine Anna,0,12,30,30
1683686411637,SOCI 157,A00,258911,Staff,11,0,30,19
1683686412660,SOCI 184,A00,258912,Staff,25,0,30,5
1683686413683,SOCI 188D,A00,258913,Staff,22,0,30,8
1683686414711,SYN 2,001,187529,Staff,9,0,16,7
1683686414711,SYN 2,002,201452,Staff,1,20,16,15
1683686414711,SYN 2,003,201469,Staff,1,0,16,15
1683686415739,SYN 100,A01,187531,Staff,0,9,20,20
1683686415739,SYN 100,B01,201491,Staff,0,10,20,20
1683686416763,TDAC 1,A00,189286,Walsh; Kim C.,3,0,20,17
1683686416763,TDAC 1,B00,189287,Harting; Carla Kelso,10,0,20,10
1683686417787,TDAC 101,A00,189300,Walsh; Kim C.,16,0,20,4
1683686417787,TDAC 101,B00,189301,Harting; Carla Kelso,18,0,20,2
1683686418809,TDAC 102,A00,189304,Basso; Beatrice,14,0,20,6
1683686419834,TDAC 108,A00,189305,Staff,18,0,20,2
1683686420859,TDDE 131,A00,189310,Staff,19,0,20,1
1683686420859,TDDE 131,B00,189314,Staff,19,0,20,1
1683686420859,TDDE 131,C00,189315,Staff,48,0,50,2
1683686420859,TDDE 131,D00,189316,Staff,14,0,15,1
1683686420859,TDDE 131,E00,204841,Staff,20,0,20,0
1683686421888,TDGE 10,A00,189289,Staff,27,0,50,23
1683686421888,TDGE 10,B00,189290,Havis; Allan,0,1,50,50
1683686422920,TDGE 11,A00,189291,Fulton; Julia,0,4,50,50
1683686422920,TDGE 11,B00,189292,Staff,20,0,25,5
1683686422920,TDGE 11,C00,260270,Staff,0,0,0,0
1683686423944,TDGE 25,A00,189294,Staff,1,0,20,19
1683686424968,TDGE 124,A00,189318,Fulton; Julia,1,8,50,49
1683686425992,TDGE 125,A00,189319,Staff,13,0,25,12
1683686425992,TDGE 125,B00,189320,Staff,23,0,25,2
1683686427016,TDGE 127,A00,189322,Havis; Allan,0,0,50,50
1683686428043,TDHT 101,A00,189323,Staff,18,0,25,7
1683686428043,TDHT 101,B00,189324,Staff,25,0,25,0
1683686429066,TDHT 102,A00,189325,Staff,49,0,50,1
1683686430090,TDMV 1,A00,189295,Arcidiacono; Kristin,20,0,30,10
1683686430090,TDMV 1,B00,189296,Caligagan; Maria T.,24,0,30,6
1683686431118,TDMV 2,A00,189297,Sammartano; Tonnie,27,0,30,3
1683686431118,TDMV 2,B00,189299,Arcidiacono; Kristin,23,0,30,7
1683686432144,TDMV 3,A00,204998,Rincon; Alicia,22,0,30,8
1683686433166,TDMV 120,A00,189458,Sammartano; Tonnie,28,0,30,2
1683686434189,TDMV 138,A00,189541,Jun; Grace Shin Hae,20,0,40,20
1683686435212,TDMV 142,A00,189717,Caligagan; Tony,25,0,30,5
1683686435212,TDMV 142,B00,189718,Caligagan; Maria T.,25,0,30,5
1683686436235,TMC 2,A01,187533,Staff,25,0,25,0
1683686436235,TMC 2,A02,187534,Staff,25,0,25,0
1683686437259,USP 1,A01,187536,Kwak; Nancy,0,16,25,25
1683686438287,USP 5,A01,187538,Staff,8,0,25,17
1683686439310,USP 101,A00,199253,Staff,0,4,0,0
1683686440334,USP 124,A00,187562,Boomhower; Matthew Charles,0,0,30,30
1683686441358,USP 138,A00,187582,Staff,19,0,25,6
1683686442385,USP 152,A01,187597,Staff,3,0,25,22
1683686443408,USP 153,A00,187598,Staff,18,0,25,7
1683686444432,USP 168,A00,187607,Kwak; Nancy,2,0,5,3
1683686445460,USP 173,A00,187619,Staff,4,0,25,21
1683686446487,USP 181,A00,187638,Staff,0,4,25,25
1683686447589,VIS 103,A00,187650,Cruz; Edwin Teddy,17,0,75,58
1683686448613,VIS 110D,A00,187669,Staff,13,0,22,9
1683686449641,VIS 127C,A00,187720,Shen; Kuiyi,67,0,146,79
1683686450668,VIS 149,A00,187731,Yoldas; Pinar,1,14,22,21
1683686451692,VIS 151,A01,188091,Staff,22,0,34,12
1683686451692,VIS 151,A02,188092,Staff,11,0,34,23
1683686452716,VIS 160B,A00,188093,Stalbaum; Brett,0,1,10,10
1683686454768,WCWP 10B,A00,201720,Staff,0,0,5,5
1683686454768,WCWP 10B,B00,201722,Staff,0,0,6,6
1683686455794,WCWP 100,A00,201725,Gagnon; Jeffrey C,0,0,2,2
1683686455794,WCWP 100,B00,201727,Staff,0,4,15,15
1683686458889,ANBI 133,A00,258401,Wilder; Linnea Lorene,34,0,40,6
1683686459912,ANBI 140,A00,258395,Hrvoj Mihic; Branka,18,0,25,7
1683686460935,ANSC 120,A00,258402,Bialecki; Jon Anthony,26,0,40,14
1683686461961,ANSC 144,A00,258400,Staff,12,0,40,28
1683686464010,ANSC 166,A00,258396,Parish; Steven Martin,156,0,175,19
1683686465038,ANSC 180,A00,193533,Staff,8,0,20,12
1683686466066,ANSC 188,A00,258397,Jassal; Aftab,34,0,40,6
1683686467090,ANTH 3,A01,258316,Staff,23,0,30,7
1683686468115,ANTH 5,A00,258394,Semendeferi; Ekaterini,16,0,20,4
1683686469139,ANTH 21,A01,258331,Staff,4,0,40,36
1683686470162,ANTH 103,A00,258398,Varma; Saiba,15,0,25,10
1683686471194,AWP 10,001,202034,Staff,0,0,0,0
1683686471194,AWP 10,002,202035,Staff,0,0,0,0
1683686471194,AWP 10,003,202036,Staff,0,0,0,0
1683686471194,AWP 10,004,202037,Staff,0,0,0,0
1683686471194,AWP 10,005,202038,Staff,0,0,0,0
1683686471194,AWP 10,006,202039,Staff,0,0,0,0
1683686471194,AWP 10,007,202040,Staff,0,0,0,0
1683686471194,AWP 10,008,202041,Staff,0,0,0,0
1683686471194,AWP 10,009,202042,Staff,0,0,0,0
1683686471194,AWP 10,010,202043,Staff,0,0,0,0
1683686471194,AWP 10,011,202044,Staff,0,0,0,0
1683686471194,AWP 10,012,202045,Staff,0,0,0,0
1683686471194,AWP 10,013,202046,Staff,0,0,0,0
1683686471194,AWP 10,014,202047,Staff,0,0,0,0
1683686471194,AWP 10,015,202048,Staff,0,0,0,0
1683686471194,AWP 10,016,202049,Staff,0,0,0,0
1683686471194,AWP 10,017,202050,Staff,0,0,0,0
1683686471194,AWP 10,018,202051,Staff,0,0,0,0
1683686471194,AWP 10,019,202052,Staff,0,0,0,0
1683686471194,AWP 10,020,202053,Staff,0,0,0,0
1683686471194,AWP 10,021,202054,Staff,0,0,0,0
1683686471194,AWP 10,022,202055,Staff,0,0,0,0
1683686471194,AWP 10,023,202056,Staff,0,0,0,0
1683686471194,AWP 10,024,202057,Staff,0,0,0,0
1683686471194,AWP 10,025,202058,Staff,0,0,0,0
1683686471194,AWP 10,026,202059,Staff,0,0,0,0
1683686472220,AWP 102,001,202032,Staff,0,0,0,0
1683686472220,AWP 102,002,202033,Staff,0,0,0,0
1683686473244,BENG 100,A01,254234,Taylor Amos; Alyssa C,31,0,40,9
1683686474270,BENG 196,001,270013,Engler; Adam J.,9999,0,9999,0
1683686475294,BICD 100R,A01,202018,Smith; Laurie,0,7,32,32
1683686475294,BICD 100R,A02,202019,Smith; Laurie,0,3,32,32
1683686475294,BICD 100R,A03,202020,Smith; Laurie,0,1,32,32
1683686475294,BICD 100R,A04,202021,Smith; Laurie,6,0,32,26
1683686475294,BICD 100R,A05,202022,Smith; Laurie,10,0,32,22
1683686476325,BICD 136,A01,193242,Gustafson-Brown; Cindy,0,2,32,32
1683686476325,BICD 136,A02,193244,Gustafson-Brown; Cindy,13,0,32,19
1683686477350,BIEB 102,A01,193249,Butler; Shannon Rhey,1,1,32,31
1683686477350,BIEB 102,A02,193251,Butler; Shannon Rhey,0,0,32,32
1683686477350,BIEB 102,A03,193253,Butler; Shannon Rhey,0,0,32,32
1683686477350,BIEB 102,A04,193255,Butler; Shannon Rhey,13,0,32,19
1683686477350,BIEB 102,A05,193265,Butler; Shannon Rhey,25,0,32,7
1683686477350,BIEB 102,A06,193269,Butler; Shannon Rhey,13,0,32,19
1683686479399,BIEB 150,A01,193274,Staff,0,0,32,32
1683686479399,BIEB 150,A02,193285,Staff,24,0,32,8
1683686480424,BIEB 194,A00,193286,Kurle; Carolyn M.,19,0,32,13
1683686481449,BILD 1,A01,192291,Staff,15,0,32,17
1683686481449,BILD 1,A02,192292,Staff,30,0,32,2
1683686481449,BILD 1,B01,192520,Reuther; Keefe,0,1,0,0
1683686481449,BILD 1,B02,192532,Reuther; Keefe,0,1,0,0
1683686482477,BILD 3,A01,192556,Butler; Shannon Rhey,0,0,32,32
1683686482477,BILD 3,A02,192581,Butler; Shannon Rhey,0,1,32,32
1683686482477,BILD 3,A03,192611,Butler; Shannon Rhey,19,0,32,13
1683686482477,BILD 3,A04,192612,Butler; Shannon Rhey,24,0,32,8
1683686482477,BILD 3,A05,192613,Butler; Shannon Rhey,26,0,32,6
1683686482477,BILD 3,A06,192679,Butler; Shannon Rhey,27,0,32,5
1683686482477,BILD 3,A07,192682,Butler; Shannon Rhey,20,0,32,12
1683686483501,BILD 4,A01,192836,Reuther; Keefe,1,0,24,23
1683686483501,BILD 4,A02,193044,Reuther; Keefe,4,0,24,20
1683686484525,BILD 10,A01,193142,Gustafson-Brown; Cindy,29,0,32,3
1683686484525,BILD 10,A02,193149,Gustafson-Brown; Cindy,31,0,32,1
1683686485553,BIMM 100,A01,193301,Staff,0,6,32,32
1683686485553,BIMM 100,A02,193312,Staff,0,7,32,32
1683686485553,BIMM 100,A03,193323,Staff,0,10,32,32
1683686486578,BIMM 101,A01,193329,McDonnell; Lisa Marie,1,4,24,23
1683686486578,BIMM 101,A02,193339,McDonnell; Lisa Marie,1,4,24,23
1683686486578,BIMM 101,B01,193354,McDonnell; Lisa Marie,0,4,24,24
1683686486578,BIMM 101,B02,193357,McDonnell; Lisa Marie,0,3,24,24
1683686487600,BIMM 110,A01,193377,Tat; John,0,11,32,32
1683686487600,BIMM 110,A02,193378,Tat; John,0,11,32,32
1683686488628,BIMM 120,A01,206116,Staff,0,0,32,32
1683686488628,BIMM 120,A02,206117,Staff,7,0,32,25
1683686488628,BIMM 120,A03,206121,Staff,21,0,32,11
1683686489658,BIPN 100,A01,193393,Park; Ji Young,0,15,32,32
1683686489658,BIPN 100,A02,193402,Park; Ji Young,0,14,32,32
1683686489658,BIPN 100,A03,193413,Park; Ji Young,0,14,32,32
1683686489658,BIPN 100,A04,193414,Park; Ji Young,0,13,32,32
1683686490684,BIPN 102,A01,193429,Staff,0,0,32,32
1683686490684,BIPN 102,A02,193438,Staff,18,0,32,14
1683686491709,BIPN 106,A01,193450,Reyes Gonzalez; Catalina,0,2,40,40
1683686492734,BIPN 134,A01,193465,Cooke; James Edward,0,0,32,32
1683686492734,BIPN 134,A02,193474,Cooke; James Edward,25,0,32,7
1683686492734,BIPN 134,A03,193485,Cooke; James Edward,29,0,32,3
1683686492734,BIPN 134,A04,193486,Cooke; James Edward,20,0,32,12
1683686492734,BIPN 134,A05,193491,Cooke; James Edward,31,0,32,1
1683686492734,BIPN 134,A06,193501,Cooke; James Edward,30,0,32,2
1683686492734,BIPN 134,A07,193510,Cooke; James Edward,29,0,32,3
1683686494782,BISP 194,A00,222522,Staff,14,0,32,18
1683686495808,CAT 124,A01,202407,Staff,19,0,25,6
1683686496833,CAT 125,A00,202408,Marchisotto; Jennifer Anne,2,0,20,18
1683686497863,CAT 125R,A00,202409,Smith; Lauryn Alissa,0,11,20,20
1683686497863,CAT 125R,B00,202410,Morales; Celeste Georgianna,0,11,20,20
1683686497863,CAT 125R,C00,202411,Irwin; Matthew Joseph,0,12,20,20
1683686498891,CENG 15,A01,204712,Yang; Kesong,0,1,0,0
1683686499918,CENG 114,A00,202070,Jahed Motlagh; Zeinab,5,0,20,15
1683686500942,CGS 105,A00,185477,Wesling; Megan E.,24,0,40,16
1683686501969,CGS 106,A00,185494,Staff,11,0,22,11
1683686502995,CGS 108,A00,185495,Staff,14,0,20,6
1683686504022,CGS 114,A00,185496,Staff,13,0,18,5
1683686505047,CGS 119,A00,185501,Staff,15,0,20,5
1683686506075,CGS 120,A00,185511,Staff,12,0,20,8
1683686507100,CHEM 4,A01,184675,Bussey; Thomas J,97,0,100,3
1683686508128,CHEM 6A,A01,184677,Staff,32,0,60,28
1683686509151,CHEM 6B,A01,184679,Staff,63,0,100,37
1683686510177,CHEM 6C,A01,184681,Bussey; Thomas J,0,0,50,50
1683686510177,CHEM 6C,A02,184682,Bussey; Thomas J,32,0,50,18
1683686511204,CHEM 40A,A01,184684,Albizati; Kim F.,33,0,100,67
1683686512231,CHEM 40B,A01,184686,Albizati; Kim F.,0,22,100,100
1683686513259,CHEM 41B,A01,184690,Staff,51,0,100,49
1683686514283,COGS 3,A01,184715,Boyle; Mary E. T.,0,27,40,40
1683686515311,COGS 14B,A01,185172,Staff,0,14,38,38
1683686516340,COGS 18,A01,184736,Staff,14,0,80,66
1683686517367,COGS 100,A01,184932,Staff,0,8,73,73
1683686518391,COGS 101A,A01,184935,Staff,0,40,30,30
1683686519415,COGS 101B,A01,184944,Staff,0,2,30,30
1683686520439,COGS 101C,A01,184946,Staff,0,10,30,30
1683686521467,COGS 102A,A01,184951,Johnson; Christine M.,1,0,40,39
1683686522492,COGS 107B,A01,184953,Mooshagian; Eric Frederick,0,52,40,40
1683686523519,COGS 118B,A01,184959,Gupta; Anjum,0,50,40,40
1683686524544,COGS 153,A00,184961,Staff,0,16,30,30
1683686525582,COGS 177,A00,184962,Staff,1,21,30,29
1683686526606,COGS 187A,A01,184969,Boyle; Mary E. T.,0,19,40,40
1683686527635,COMM 10,A01,185174,Staff,0,5,25,25
1683686527635,COMM 10,A02,185189,Staff,0,2,25,25
1683686527635,COMM 10,A03,269821,Staff,0,1,0,0
1683686528664,COMM 100B,A02,185476,Staff,10,0,25,15
1683686528664,COMM 100B,A03,277340,Staff,25,0,25,0
1683686529689,COMM 100C,A01,185314,Staff,1,0,25,24
1683686529689,COMM 100C,A02,185327,Staff,17,0,25,8
1683686530713,COMM 110M,A00,185349,Staff,0,0,40,40
1683686531737,COMM 113T,A00,185352,Staff,25,0,40,15
1683686532761,COMM 114I,A00,185353,Staff,31,0,40,9
1683686533785,COMM 131,A00,185354,Staff,17,0,30,13
1683686534809,CSE 8A,A50,185358,Cao; Yingjun,0,46,10,10
1683686535832,CSE 8B,A01,185362,Staff,0,48,50,50
1683686536858,CSE 11,A01,185416,Cao; Yingjun,0,91,10,10
1683686537886,CSE 20,A01,185445,Briones; Jor-el Thomas Caparas,3,0,25,22
1683686538910,CSE 21,A01,185447,Staff,9,0,50,41
1683686539935,CSE 101,A01,185451,Staff,0,13,50,50
1683686539935,CSE 101,B01,185453,Jones; Miles E,0,14,50,50
1683686541984,CSE 141,A01,185458,Eldon; John,16,0,100,84
1683686543009,CSE 141L,A01,185461,Eldon; John,8,0,100,92
1683686544035,CSE 142,A01,185463,Staff,34,0,60,26
1683686544035,CSE 142,B01,201355,Staff,0,7,60,60
1683686545060,CSE 142L,A01,185470,Staff,34,0,60,26
1683686545060,CSE 142L,B01,201417,Staff,0,6,60,60
1683686546085,CSE 190,A00,201433,Staff,32,0,49,17
1683686547110,DOC 1,A01,259136,Strom; Megan C.,7,0,15,8
1683686547110,DOC 1,A02,259137,Strom; Megan C.,14,0,15,1
1683686547110,DOC 1,A03,259138,Strom; Megan C.,14,0,15,1
1683686547110,DOC 1,A04,259139,Strom; Megan C.,14,0,15,1
1683686548134,DOC 100D,A00,259140,Pass; Natalye Joann,14,0,25,11
1683686549159,DSGN 1,A01,184749,Rill; Bryan,0,26,30,30
1683686550187,DSGN 100,A01,185168,Staff,0,2,25,25
1683686551266,ECE 5,A01,185626,Morris; Karcher William,0,12,0,0
1683686552293,ECE 101,A01,185628,Staff,14,0,70,56
1683686553318,ECE 107,A01,185635,Baghdadchi; Saharnaz,0,0,20,20
1683686553318,ECE 107,A02,185638,Baghdadchi; Saharnaz,1,0,20,19
1683686554342,ECE 148,A01,185647,Silberman; Jack,0,0,16,16
1683686555369,ECON 1,A01,185537,Crane; Meredith Helen,54,0,70,16
1683686556397,ECON 3,A01,185549,Crane; Meredith Helen,30,0,70,40
1683686557427,ECON 4,A01,203354,Anderson; John Charles,0,5,10,10
1683686558451,ECON 100A,A01,185574,Staff,0,5,40,40
1683686559476,ECON 100B,A01,185576,Staff,0,12,50,50
1683686560503,ECON 100C,A01,185589,Newhouse; Herbert S,30,0,70,40
1683686561528,ECON 105,A00,185608,Vespa; Emanuel Ignacio,19,0,35,16
1683686562554,ECON 109,A01,185610,Shishkin; Denis,9,0,35,26
1683686563578,ECON 110A,A01,185612,Staff,8,0,40,32
1683686564602,ECON 120A,A01,185615,Staff,19,0,40,21
1683686565628,ECON 120C,A01,185617,Sun; Yixiao,0,21,70,70
1683686566652,ECON 144,A00,203346,Squires; Dale E,2,0,35,33
1683686567680,ECON 171,A01,203349,Newhouse; Herbert S,0,1,35,35
1683686568705,ECON 173A,A01,185621,Toda; Alexis Akira,21,0,35,14
1683686569735,EDS 25,A01,202413,Staff,0,1,0,0
1683686569735,EDS 25,A02,202414,Staff,0,1,0,0
1683686569735,EDS 25,A03,202415,Staff,0,0,0,0
1683686569735,EDS 25,A04,202416,Staff,0,1,0,0
1683686569735,EDS 25,A05,202439,Staff,0,0,0,0
1683686569735,EDS 25,A06,202440,Staff,0,0,0,0
1683686569735,EDS 25,B01,202631,Staff,0,0,0,0
1683686569735,EDS 25,B02,202632,Staff,0,0,0,0
1683686569735,EDS 25,B03,202639,Staff,0,0,0,0
1683686569735,EDS 25,B04,202640,Staff,0,0,0,0
1683686569735,EDS 25,B05,202643,Staff,0,0,0,0
1683686569735,EDS 25,B06,202644,Staff,0,0,0,0
1683686570763,EDS 38,A01,202659,Black; Alison Michelle,24,0,25,1
1683686571786,EDS 115,A00,202652,Staff,18,0,30,12
1683686572812,EDS 125,A00,202649,Staff,13,0,30,17
1683686573836,EDS 126,A01,203332,Staff,30,0,30,0
1683686574863,EDS 139,A00,202838,Staff,16,0,25,9
1683686575891,EDS 146,A01,202655,Staff,14,0,25,11
1683686576917,ENG 15,A00,185667,Staff,0,1,0,0
1683686576917,ENG 15,B00,185672,Staff,0,0,0,0
1683686576917,ENG 15,C00,185675,Staff,0,0,0,0
1683686576917,ENG 15,D00,185682,Staff,0,0,0,0
1683686576917,ENG 15,E00,185684,Staff,0,0,0,0
1683686577944,ETHN 103,A00,185710,Staff,0,8,35,35
1683686578970,ETHN 103A,A00,199228,Man; Simeon S,0,0,9,9
1683686580000,ETHN 109,A00,185711,Staff,15,0,35,20
1683686581030,ETHN 142,A00,185726,Staff,0,4,30,30
1683686582054,ETHN 163J,A00,199229,Man; Simeon S,5,0,8,3
1683686583081,ETHN 168,A00,185727,Staff,7,0,10,3
1683686584110,ETHN 182,A00,185728,Staff,0,0,35,35
1683686585133,ETHN 183,A00,185737,Staff,9,0,18,9
1683686586160,GLBH 111,A01,209361,Burgos; Jose L.,0,0,0,0
1683686588211,HIEU 104,A00,185792,Staff,14,0,20,6
1683686589236,HIEU 115,A00,185800,Staff,0,0,20,20
1683686590260,HIEU 128,A00,185801,Staff,0,9,20,20
1683686591284,HIEU 147,A00,185802,Staff,15,0,20,5
1683686592308,HIEU 154,A00,185823,Staff,11,0,20,9
1683686593338,HILA 102,A00,185826,Staff,14,0,20,6
1683686594363,HILD 2C,A01,185778,Staff,0,13,20,20
1683686595390,HILD 7B,A01,185780,Kwak; Nancy,0,17,32,32
1683686595390,HILD 7B,A02,185781,Kwak; Nancy,0,18,32,32
1683686596414,HILD 30,A01,185791,Staff,12,0,20,8
1683686597441,HISC 119,A00,185830,Golan; Tal,0,10,20,20
1683686598466,HITO 156GS,A00,185831,Patterson; Patrick H.,0,0,0,23
1683686599495,HIUS 103,A00,185832,Man; Simeon S,0,4,20,20
1683686600522,HIUS 117,A00,185836,Kwak; Nancy,2,0,20,18
1683686601550,HIUS 125,A00,185840,Man; Simeon S,0,2,23,23
1683686602575,HIUS 149,A00,185845,Staff,1,0,20,19
1683686603599,HUM 3,A01,185882,Zavodny; Tatiana Sophia,0,8,50,50
1683686603599,HUM 3,B01,185899,Caldwell; Michael Alan,0,18,50,50
1683686604625,HUM 3GS,A00,185900,Patterson; Patrick H.,0,0,0,23
1683686605650,HUM 4,A01,185938,Zroka; Amy Liane,28,0,50,22
1683686605650,HUM 4,B01,185956,Watkins; Eric,0,6,50,50
1683686605650,HUM 4,B02,202209,Watkins; Eric,0,5,50,50
1683686605650,HUM 4,B03,202210,Watkins; Eric,0,5,50,50
1683686606674,HUM 5,A01,185958,West; Geoffrey Scott,0,0,50,50
1683686606674,HUM 5,A02,202215,West; Geoffrey Scott,0,0,50,50
1683686607698,INTL 190,A00,185959,Gagnon; Jeffrey C,0,0,0,9
1683686607698,INTL 190,B00,185960,Lettieri; Michael Joseph,0,0,0,2
1683686608721,JAPN 180,A00,254509,Staff,5,0,30,25
1683686609750,LATI 10,A01,202853,Kennemore; Amy Michelle,4,0,35,31
1683686609750,LATI 10,A02,202854,Kennemore; Amy Michelle,3,0,35,32
1683686609750,LATI 10,A03,270054,Kennemore; Amy Michelle,30,0,30,0
1683686610778,LATI 180,A00,202855,Kennemore; Amy Michelle,11,0,20,9
1683686611801,LAWS 101,A00,201767,Golan; Tal,0,7,40,40
1683686612825,LIFR 1C,A00,185961,Staff,6,0,20,14
1683686613849,LIFR 1CX,A00,185962,Staff,7,0,20,13
1683686614874,LIFR 1D,A00,185963,Staff,7,0,20,13
1683686615899,LIFR 1DX,A00,185964,Staff,7,0,20,13
1683686616927,LIGN 101,A01,186039,Staff,43,0,50,7
1683686617951,LIGN 165,A00,186040,Staff,15,0,50,35
1683686618977,LTCS 108,A00,186041,Staff,5,0,10,5
1683686620005,LTCS 119,A00,186042,Staff,15,0,20,5
1683686621029,LTCS 130,A00,186043,Wesling; Megan E.,15,0,25,10
1683686623083,LTEA 138,A00,186119,Staff,14,0,40,26
1683686624106,LTEN 124,A00,186148,Staff,5,0,25,20
1683686625131,LTEN 178,A00,186149,Staff,6,0,15,9
1683686626159,LTEN 181,A00,186150,Blanco; John D,34,0,40,6
1683686627184,LTWL 120,A00,186160,Staff,19,0,25,6
1683686628209,LTWL 165,A00,186161,Staff,22,0,25,3
1683686629232,LTWR 100,A00,186162,Staff,0,5,15,15
1683686630256,LTWR 102,A00,186163,Doller; Ben,5,0,15,10
1683686631284,MAE 8,A01,186412,Staff,0,1,0,0
1683686632311,MAE 30B,A00,186445,Bahadori; Mohammad Yousef,81,0,100,19
1683686633336,MAE 40,A00,186592,Bewley; Thomas R,10,0,50,40
1683686634364,MAE 101B,A00,186593,Bahadori; Mohammad Yousef,80,0,100,20
1683686635398,MAE 105,A00,186594,Bandaru; Prabhakar,10,0,50,40
1683686636425,MAE 107,A00,186599,Pham; Hieu Tan,0,7,120,120
1683686637448,MAE 148,A01,186660,Silberman; Jack,3,0,16,13
1683686638478,MATH 10A,A01,188095,Staff,0,6,35,35
1683686639505,MATH 10B,A01,188097,Bowers; Adam R.,0,12,30,30
1683686639505,MATH 10B,A02,188099,Bowers; Adam R.,0,11,30,30
1683686639505,MATH 10B,B01,188104,Bowers; Adam R.,0,10,30,30
1683686639505,MATH 10B,B02,188106,Bowers; Adam R.,1,9,30,29
1683686640531,MATH 10C,A01,188111,Staff,0,20,30,30
1683686640531,MATH 10C,A02,188127,Staff,0,19,30,30
1683686640531,MATH 10C,A03,188131,Staff,0,19,30,30
1683686640531,MATH 10C,B01,188218,Staff,17,0,30,13
1683686640531,MATH 10C,B02,188244,Staff,13,0,30,17
1683686640531,MATH 10C,B03,188277,Staff,14,0,30,16
1683686641559,MATH 18,A01,188344,Bach; Quang Tran,18,0,30,12
1683686641559,MATH 18,A02,188345,Bach; Quang Tran,11,0,30,19
1683686641559,MATH 18,B01,188353,Bach; Quang Tran,11,0,30,19
1683686641559,MATH 18,B02,188354,Bach; Quang Tran,19,0,30,11
1683686642585,MATH 20A,A01,188374,Staff,11,0,35,24
1683686643610,MATH 20B,A01,188382,Ohm; Ko Woon,7,0,30,23
1683686643610,MATH 20B,A02,188383,Ohm; Ko Woon,22,0,30,8
1683686643610,MATH 20B,B01,188385,Ohm; Ko Woon,7,0,30,23
1683686643610,MATH 20B,B02,188392,Ohm; Ko Woon,22,0,30,8
1683686644635,MATH 20C,A01,188394,Harel; Guershon,10,0,30,20
1683686644635,MATH 20C,A02,188395,Harel; Guershon,13,0,30,17
1683686644635,MATH 20C,B01,188404,Harel; Guershon,5,0,30,25
1683686644635,MATH 20C,B02,188405,Harel; Guershon,18,0,30,12
1683686645659,MATH 20D,A01,188414,Hammock; Frances H,0,1,30,30
1683686645659,MATH 20D,A02,188415,Hammock; Frances H,0,1,30,30
1683686645659,MATH 20D,B01,188447,Hammock; Frances H,0,1,30,30
1683686645659,MATH 20D,B02,188486,Hammock; Frances H,2,0,30,28
1683686646688,MATH 20E,A01,188649,Staff,21,0,30,9
1683686646688,MATH 20E,A02,188650,Staff,20,0,30,10
1683686646688,MATH 20E,A03,188673,Staff,0,0,30,30
1683686647713,MATH 102,A01,188675,Staff,0,39,35,35
1683686648741,MATH 103B,A01,188681,Staff,3,0,35,32
1683686648741,MATH 103B,B01,188692,Staff,5,0,35,30
1683686649768,MATH 109,A01,188695,Salehi Golsefidy; Alireza,24,0,35,11
1683686649768,MATH 109,A02,188696,Salehi Golsefidy; Alireza,25,0,35,10
1683686650792,MATH 120A,A01,188698,Eggers; John Dietrich,7,0,35,28
1683686651816,MATH 142B,A01,188736,Ioana; Adrian,1,1,30,29
1683686651816,MATH 142B,A02,188741,Ioana; Adrian,0,1,30,30
1683686651816,MATH 142B,A03,188743,Ioana; Adrian,0,1,30,30
1683686652842,MATH 168A,A01,188790,Staff,0,11,35,35
1683686653870,MATH 170A,A01,188803,Nie; Jiawang,0,2,35,35
1683686653870,MATH 170A,A02,188811,Nie; Jiawang,0,1,35,35
1683686653870,MATH 170A,A03,188814,Nie; Jiawang,0,0,35,35
1683686653870,MATH 170A,A04,188815,Nie; Jiawang,6,0,35,29
1683686654949,MATH 193B,A01,188817,Staff,0,0,35,35
1683686654949,MATH 193B,A02,188818,Staff,5,0,35,30
1683686655980,MGT 4,A01,202857,Anderson; John Charles,59,0,80,21
1683686657014,MGT 12,A00,202858,Lindenberger; Wade Douglas,40,0,90,50
1683686658039,MGT 18,A00,202859,Staff,74,0,90,16
1683686659062,MGT 18GS,A00,202860,McKay; Michael J,13,0,28,15
1683686660085,MGT 45,A00,202861,Pecore; Joseph P.,8,0,90,82
1683686661109,MGT 100,A00,202863,Yavorsky; Daniel Ryan,27,0,90,63
1683686662136,MGT 103,A00,202864,Ehrich; Kristine R,0,19,90,90
1683686663162,MGT 112,A00,202865,Ehrich; Kristine R,15,0,90,75
1683686664187,MGT 121A,A00,202868,Staff,90,20,90,0
1683686665211,MGT 131B,A00,202869,Anderson; John Charles,59,0,90,31
1683686666237,MGT 136,A00,202871,Lindenberger; Wade Douglas,83,0,90,7
1683686667261,MGT 164,A00,202873,Staff,0,68,90,91
1683686668284,MGT 164GS,A00,202874,McKay; Mary A,13,0,28,15
1683686669307,MGT 180,A00,202875,Staff,0,51,90,91
1683686670335,MMW 11R,A01,205019,Herbst; Matthew,0,0,30,30
1683686670335,MMW 11R,A02,205026,Herbst; Matthew,29,0,30,1
1683686671359,MMW 15,A01,193512,Chang; Edmond Yi-Teh,0,8,28,28
1683686671359,MMW 15,A02,193513,Chang; Edmond Yi-Teh,0,5,28,28
1683686671359,MMW 15,A03,193514,Chang; Edmond Yi-Teh,0,5,28,28
1683686671359,MMW 15,A04,193515,Chang; Edmond Yi-Teh,0,5,28,28
1683686671359,MMW 15,A05,193516,Chang; Edmond Yi-Teh,0,5,28,28
1683686671359,MMW 15,A06,193517,Chang; Edmond Yi-Teh,0,6,28,28
1683686671359,MMW 15,B01,193519,Chang; Edmond Yi-Teh,0,5,28,28
1683686671359,MMW 15,B02,193520,Chang; Edmond Yi-Teh,0,5,28,28
1683686671359,MMW 15,B03,193521,Chang; Edmond Yi-Teh,0,5,28,28
1683686671359,MMW 15,B04,193522,Chang; Edmond Yi-Teh,0,6,28,28
1683686671359,MMW 15,B05,193523,Chang; Edmond Yi-Teh,0,5,28,28
1683686671359,MMW 15,B06,193524,Chang; Edmond Yi-Teh,0,5,28,28
1683686672386,MMW 122,A01,193526,Rahimi; Babak,0,16,28,28
1683686672386,MMW 122,A02,193527,Rahimi; Babak,0,15,28,28
1683686672386,MMW 122,A03,193528,Rahimi; Babak,0,0,0,0
1683686672386,MMW 122,A04,193529,Rahimi; Babak,0,0,0,0
1683686673409,MUS 1A,A01,186663,Staff,1,19,35,34
1683686674436,MUS 4,A01,186715,Staff,0,12,35,35
1683686675462,MUS 5R,A01,186796,Dubnov; Shlomo,0,17,35,35
1683686676487,MUS 6,A01,186798,Staff,1,5,25,24
1683686677510,MUS 7,A01,186830,Staff,11,0,35,24
1683686678538,MUS 8,A01,186930,Staff,0,27,35,35
1683686679566,MUS 15,A01,186932,Staff,0,15,35,35
1683686679566,MUS 15,B01,186934,Staff,1,17,35,34
1683686680591,MUS 80,A00,186935,Staff,0,0,20,20
1683686680591,MUS 80,B00,186936,Staff,24,0,25,1
1683686681616,NANO 11,A00,204702,Lipomi; Darren John,0,0,0,0
1683686682640,NANO 15,A01,204709,Yang; Kesong,0,1,0,0
1683686683667,NANO 114,A00,202069,Jahed Motlagh; Zeinab,2,0,10,8
1683686684691,PHIL 1,A00,186955,Grush; Rick Scott,31,0,40,9
1683686685715,PHIL 10,A01,186973,Grush; Rick Scott,27,0,35,8
1683686685715,PHIL 10,A02,186974,Grush; Rick Scott,33,0,35,2
1683686686743,PHIL 13,A01,186976,Staff,1,0,35,34
1683686686743,PHIL 13,A02,186977,Staff,16,0,35,19
1683686687774,PHIL 14,A01,186979,Staff,31,0,35,4
1683686687774,PHIL 14,A02,186986,Staff,32,0,35,3
1683686688801,PHIL 28,A01,186988,Staff,16,0,30,14
1683686688801,PHIL 28,A02,186989,Staff,1,0,30,29
1683686688801,PHIL 28,A03,186990,Staff,10,0,30,20
1683686688801,PHIL 28,A04,186991,Staff,26,0,30,4
1683686689826,PHIL 120,A00,186997,Staff,23,0,40,17
1683686690851,PHIL 137,A00,187003,Staff,7,0,40,33
1683686691878,PHIL 150,A00,187015,Staff,47,0,70,23
1683686692902,PHIL 167,A00,187021,Lamey; Andy M.,34,0,40,6
1683686693927,PHIL 174,A01,202226,Staff,17,0,20,3
1683686693927,PHIL 174,A02,202235,Staff,20,0,20,0
1683686694952,PHIL 191A,A00,258918,Staff,0,0,1,1
1683686695979,PHYS 1A,A00,187028,Staff,26,0,60,34
1683686697008,PHYS 1AL,001,187036,Staff,3,0,30,27
1683686697008,PHYS 1AL,002,187049,Staff,18,0,30,12
1683686698035,PHYS 1B,A00,187058,Staff,22,0,60,38
1683686699060,PHYS 1BL,001,187064,Staff,0,1,30,30
1683686699060,PHYS 1BL,002,187070,Staff,4,0,30,26
1683686700089,PHYS 1C,A00,187082,Staff,29,0,120,91
1683686701115,PHYS 1CL,001,187088,Staff,0,9,30,30
1683686701115,PHYS 1CL,002,187089,Staff,0,1,30,30
1683686701115,PHYS 1CL,009,262693,Staff,9,0,30,21
1683686702140,PHYS 2B,A01,187097,Staff,55,0,115,60
1683686703168,PHYS 2C,A01,187099,Staff,63,0,115,52
1683686704191,PHYS 2CL,A01,187101,Staff,5,0,28,23
1683686704191,PHYS 2CL,A02,187102,Staff,15,0,28,13
1683686705215,PHYS 2D,A01,187123,Shotwell; Brian,95,0,115,20
1683686706239,PHYS 4B,A01,187133,Grinstein; Benjamin,35,0,50,15
1683686707264,POLI 10,A00,188819,Staff,0,4,50,50
1683686708291,POLI 11,A00,188827,Staff,43,0,50,7
1683686709316,POLI 13R,A00,188828,Staff,0,1,20,20
1683686710343,POLI 27,A01,188830,Elgin; Samuel Zincke,0,2,70,70
1683686711373,POLI 30,A00,188832,Desposato; Scott,30,0,50,20
1683686712400,POLI 102F,A00,188834,Staff,1,0,40,39
1683686713423,POLI 104A,A00,188852,Staff,12,0,30,18
1683686714448,POLI 104I,A00,188853,Staff,0,8,20,20
1683686715476,POLI 110B,A00,188854,Wiens; David,6,0,20,14
1683686716501,POLI 112A,A00,188855,Wiens; David,3,0,30,27
1683686717527,POLI 117R,A00,188856,Forman; Fonna,0,12,20,20
1683686718554,POLI 118,A00,188857,Ingham; Sean,8,0,20,12
1683686719577,POLI 120G,A00,188858,Staff,8,0,30,22
1683686720604,POLI 131CR,A00,188863,Hoston; Germaine,20,0,50,30
1683686721628,POLI 133,A00,188864,Nellis; Gareth Hb,44,0,50,6
1683686722658,POLI 134D,A00,188865,Desposato; Scott,27,0,30,3
1683686723683,POLI 142A,A00,188871,Gartzke; Erik,21,0,50,29
1683686724710,POLI 142K,A00,188874,Staff,38,0,50,12
1683686725737,POLI 143,A00,188940,Gartzke; Erik,16,0,30,14
1683686726762,POLI 153,A00,188943,Staff,2,0,20,18
1683686727788,POLI 160AA,A00,188944,Staff,10,0,40,30
1683686728814,POLI 170A,A00,188945,Staff,10,0,30,20
1683686730864,PSYC 1,A00,188952,Staff,36,0,90,54
1683686731891,PSYC 2,B00,188953,Staff,19,0,35,16
1683686732918,PSYC 6,A00,188970,Staff,47,0,60,13
1683686733947,PSYC 7,A00,188973,Staff,35,0,45,10
1683686734971,PSYC 60,A01,188980,Rickard; Timothy C.,42,0,60,18
1683686735996,PSYC 70,A01,189001,Steiner; Eric Tomas,21,0,45,24
1683686737021,PSYC 100,A00,189005,Lacefield; Katharine I,0,99,120,120
1683686738047,PSYC 102,A00,189008,Staff,7,0,30,23
1683686739072,PSYC 106,B00,189026,Gorman; Michael R.,27,0,60,33
1683686740096,PSYC 114,B01,189033,Winkielman; Piotr,0,31,30,30
1683686741119,PSYC 131,A00,189036,Anagnostaras; Stephan,0,43,60,60
1683686742142,PSYC 136,A00,189041,Lowe; Angela Beth,0,7,25,25
1683686743166,PSYC 137,A00,189057,Winkielman; Piotr,1,37,25,24
1683686744190,PSYC 144,A00,189107,Wixted; John T,0,11,50,50
1683686746238,PSYC 162,A00,189142,Staff,0,9,85,85
1683686747263,PSYC 172,A00,189144,Gorman; Michael R.,0,6,30,30
1683686749312,PSYC 179,A00,189146,Lacefield; Katharine I,0,87,120,120
1683686750335,PSYC 181,A00,189147,Anagnostaras; Stephan,0,44,90,90
1683686751360,PSYC 190R,A00,189148,Barner; David A.,0,23,80,80
1683686752384,PSYC 191,A00,189275,Rickard; Timothy C.,0,10,25,25
1683686753412,PSYC 193,A00,189276,Chapman; Eddie Nathaniel,0,1,0,4
1683686754442,PSYC 193L,A01,189281,Lowe; Angela Beth,8,0,20,12
1683686754442,PSYC 193L,B01,189285,Staff,28,0,35,7
1683686755469,RELI 149,A00,187137,Rahimi; Babak,6,0,40,34
1683686756492,SE 9,A01,187315,Staff,0,2,18,18
1683686757519,SE 101B,A00,187409,Staff,24,0,30,6
1683686758604,SE 110B,A00,187444,Staff,10,0,40,30
1683686759629,SE 130B,A00,187449,Staff,31,0,40,9
1683686760655,SE 150A,A00,187516,Staff,8,0,20,12
1683686761679,SE 154,A00,187528,Staff,29,0,50,21
1683686762703,SIO 3,A01,258171,Staff,35,0,40,5
1683686763729,SIO 10,A00,187144,Cook; Geoffrey W,1,7,75,74
1683686764758,SIO 45,A00,187152,Cook; Geoffrey W,0,7,100,100
1683686765785,SIO 109R,A00,194486,Staff,0,4,20,20
1683686767833,SIO 187,A01,187233,Kacev; David,12,0,40,28
1683686768859,SOCI 1,A01,258656,Thorpe; Charles Robert,28,0,30,2
1683686768859,SOCI 1,A02,258658,Thorpe; Charles Robert,30,0,30,0
1683686768859,SOCI 1,A03,258661,Thorpe; Charles Robert,25,0,25,0
1683686768859,SOCI 1,A04,258666,Thorpe; Charles Robert,22,0,25,3
1683686768859,SOCI 1,A05,258897,Thorpe; Charles Robert,22,0,25,3
1683686768859,SOCI 1,A06,258898,Thorpe; Charles Robert,25,0,25,0
1683686769885,SOCI 30,A01,258903,Pardo Guerra; Juan Pablo,14,0,30,16
1683686770909,SOCI 102,A00,258904,Staff,9,0,25,16
1683686771935,SOCI 106,A00,258905,Staff,19,0,25,6
1683686772958,SOCI 111,A00,258907,Ribas Norris; Janet Vanesa,26,0,30,4
1683686773982,SOCI 121R,A00,258908,Pardo Guerra; Juan Pablo,8,0,30,22
1683686775008,SOCI 126,A01,203330,Staff,14,0,20,6
1683686776032,SOCI 131,A00,258909,Thorpe; Charles Robert,30,0,60,30
1683686777055,SOCI 135,A00,258910,Payne; Christine Anna,0,12,30,30
1683686778082,SOCI 157,A00,258911,Staff,11,0,30,19
1683686779106,SOCI 184,A00,258912,Staff,25,0,30,5
1683686780132,SOCI 188D,A00,258913,Staff,22,0,30,8
1683686781155,SYN 2,001,187529,Staff,9,0,16,7
1683686781155,SYN 2,002,201452,Staff,1,20,16,15
1683686781155,SYN 2,003,201469,Staff,1,0,16,15
1683686782180,SYN 100,A01,187531,Staff,0,9,20,20
1683686782180,SYN 100,B01,201491,Staff,0,10,20,20
1683686783207,TDAC 1,A00,189286,Walsh; Kim C.,3,0,20,17
1683686783207,TDAC 1,B00,189287,Harting; Carla Kelso,10,0,20,10
1683686784231,TDAC 101,A00,189300,Walsh; Kim C.,16,0,20,4
1683686784231,TDAC 101,B00,189301,Harting; Carla Kelso,18,0,20,2
1683686785255,TDAC 102,A00,189304,Basso; Beatrice,14,0,20,6
1683686786280,TDAC 108,A00,189305,Staff,18,0,20,2
1683686787312,TDDE 131,A00,189310,Staff,19,0,20,1
1683686787312,TDDE 131,B00,189314,Staff,19,0,20,1
1683686787312,TDDE 131,C00,189315,Staff,48,0,50,2
1683686787312,TDDE 131,D00,189316,Staff,14,0,15,1
1683686787312,TDDE 131,E00,204841,Staff,20,0,20,0
1683686788340,TDGE 10,A00,189289,Staff,27,0,50,23
1683686788340,TDGE 10,B00,189290,Havis; Allan,0,1,50,50
1683686789370,TDGE 11,A00,189291,Fulton; Julia,0,4,50,50
1683686789370,TDGE 11,B00,189292,Staff,20,0,25,5
1683686789370,TDGE 11,C00,260270,Staff,0,0,0,0
1683686790395,TDGE 25,A00,189294,Staff,1,0,20,19
1683686791418,TDGE 124,A00,189318,Fulton; Julia,1,8,50,49
1683686792444,TDGE 125,A00,189319,Staff,13,0,25,12
1683686792444,TDGE 125,B00,189320,Staff,23,0,25,2
1683686793474,TDGE 127,A00,189322,Havis; Allan,0,0,50,50
1683686794499,TDHT 101,A00,189323,Staff,18,0,25,7
1683686794499,TDHT 101,B00,189324,Staff,25,0,25,0
1683686795526,TDHT 102,A00,189325,Staff,49,0,50,1
1683686796554,TDMV 1,A00,189295,Arcidiacono; Kristin,20,0,30,10
1683686796554,TDMV 1,B00,189296,Caligagan; Maria T.,24,0,30,6
1683686797579,TDMV 2,A00,189297,Sammartano; Tonnie,27,0,30,3
1683686797579,TDMV 2,B00,189299,Arcidiacono; Kristin,23,0,30,7
1683686798608,TDMV 3,A00,204998,Rincon; Alicia,22,0,30,8
1683686799635,TDMV 120,A00,189458,Sammartano; Tonnie,28,0,30,2
1683686800661,TDMV 138,A00,189541,Jun; Grace Shin Hae,20,0,40,20
1683686801688,TDMV 142,A00,189717,Caligagan; Tony,25,0,30,5
1683686801688,TDMV 142,B00,189718,Caligagan; Maria T.,25,0,30,5
1683686802715,TMC 2,A01,187533,Staff,25,0,25,0
1683686802715,TMC 2,A02,187534,Staff,25,0,25,0
1683686803738,USP 1,A01,187536,Kwak; Nancy,0,16,25,25
1683686804764,USP 5,A01,187538,Staff,8,0,25,17
1683686805788,USP 101,A00,199253,Staff,0,4,0,0
1683686806817,USP 124,A00,187562,Boomhower; Matthew Charles,0,0,30,30
1683686807841,USP 138,A00,187582,Staff,19,0,25,6
1683686808869,USP 152,A01,187597,Staff,3,0,25,22
1683686809897,USP 153,A00,187598,Staff,18,0,25,7
1683686810924,USP 168,A00,187607,Kwak; Nancy,2,0,5,3
1683686811950,USP 173,A00,187619,Staff,4,0,25,21
1683686812972,USP 181,A00,187638,Staff,0,4,25,25
1683686813996,VIS 103,A00,187650,Cruz; Edwin Teddy,17,0,75,58
1683686815023,VIS 110D,A00,187669,Staff,13,0,22,9
1683686816048,VIS 127C,A00,187720,Shen; Kuiyi,67,0,146,79
1683686817071,VIS 149,A00,187731,Yoldas; Pinar,1,14,22,21
1683686818097,VIS 151,A01,188091,Staff,22,0,34,12
1683686818097,VIS 151,A02,188092,Staff,11,0,34,23
1683686819127,VIS 160B,A00,188093,Stalbaum; Brett,0,1,10,10
1683686821183,WCWP 10B,A00,201720,Staff,0,0,5,5
1683686821183,WCWP 10B,B00,201722,Staff,0,0,6,6
1683686822210,WCWP 100,A00,201725,Gagnon; Jeffrey C,0,0,2,2
1683686822210,WCWP 100,B00,201727,Staff,0,4,15,15
1683686825313,ANBI 133,A00,258401,Wilder; Linnea Lorene,34,0,40,6
1683686826341,ANBI 140,A00,258395,Hrvoj Mihic; Branka,18,0,25,7
1683686827366,ANSC 120,A00,258402,Bialecki; Jon Anthony,26,0,40,14
1683686828389,ANSC 144,A00,258400,Staff,12,0,40,28
1683686830440,ANSC 166,A00,258396,Parish; Steven Martin,156,0,175,19
1683686831471,ANSC 180,A00,193533,Staff,8,0,20,12
1683686832496,ANSC 188,A00,258397,Jassal; Aftab,34,0,40,6
1683686833524,ANTH 3,A01,258316,Staff,23,0,30,7
1683686834547,ANTH 5,A00,258394,Semendeferi; Ekaterini,16,0,20,4
1683686835572,ANTH 21,A01,258331,Staff,4,0,40,36
1683686836597,ANTH 103,A00,258398,Varma; Saiba,15,0,25,10
1683686837623,AWP 10,001,202034,Staff,0,0,0,0
1683686837623,AWP 10,002,202035,Staff,0,0,0,0
1683686837623,AWP 10,003,202036,Staff,0,0,0,0
1683686837623,AWP 10,004,202037,Staff,0,0,0,0
1683686837623,AWP 10,005,202038,Staff,0,0,0,0
1683686837623,AWP 10,006,202039,Staff,0,0,0,0
1683686837623,AWP 10,007,202040,Staff,0,0,0,0
1683686837623,AWP 10,008,202041,Staff,0,0,0,0
1683686837623,AWP 10,009,202042,Staff,0,0,0,0
1683686837623,AWP 10,010,202043,Staff,0,0,0,0
1683686837623,AWP 10,011,202044,Staff,0,0,0,0
1683686837623,AWP 10,012,202045,Staff,0,0,0,0
1683686837623,AWP 10,013,202046,Staff,0,0,0,0
1683686837623,AWP 10,014,202047,Staff,0,0,0,0
1683686837623,AWP 10,015,202048,Staff,0,0,0,0
1683686837623,AWP 10,016,202049,Staff,0,0,0,0
1683686837623,AWP 10,017,202050,Staff,0,0,0,0
1683686837623,AWP 10,018,202051,Staff,0,0,0,0
1683686837623,AWP 10,019,202052,Staff,0,0,0,0
1683686837623,AWP 10,020,202053,Staff,0,0,0,0
1683686837623,AWP 10,021,202054,Staff,0,0,0,0
1683686837623,AWP 10,022,202055,Staff,0,0,0,0
1683686837623,AWP 10,023,202056,Staff,0,0,0,0
1683686837623,AWP 10,024,202057,Staff,0,0,0,0
1683686837623,AWP 10,025,202058,Staff,0,0,0,0
1683686837623,AWP 10,026,202059,Staff,0,0,0,0
1683686838649,AWP 102,001,202032,Staff,0,0,0,0
1683686838649,AWP 102,002,202033,Staff,0,0,0,0
1683686839673,BENG 100,A01,254234,Taylor Amos; Alyssa C,31,0,40,9
1683686840697,BENG 196,001,270013,Engler; Adam J.,9999,0,9999,0
1683686841723,BICD 100R,A01,202018,Smith; Laurie,0,7,32,32
1683686841723,BICD 100R,A02,202019,Smith; Laurie,0,3,32,32
1683686841723,BICD 100R,A03,202020,Smith; Laurie,0,1,32,32
1683686841723,BICD 100R,A04,202021,Smith; Laurie,6,0,32,26
1683686841723,BICD 100R,A05,202022,Smith; Laurie,10,0,32,22
1683686842753,BICD 136,A01,193242,Gustafson-Brown; Cindy,0,2,32,32
1683686842753,BICD 136,A02,193244,Gustafson-Brown; Cindy,13,0,32,19
1683686843777,BIEB 102,A01,193249,Butler; Shannon Rhey,1,1,32,31
1683686843777,BIEB 102,A02,193251,Butler; Shannon Rhey,0,0,32,32
1683686843777,BIEB 102,A03,193253,Butler; Shannon Rhey,0,0,32,32
1683686843777,BIEB 102,A04,193255,Butler; Shannon Rhey,13,0,32,19
1683686843777,BIEB 102,A05,193265,Butler; Shannon Rhey,25,0,32,7
1683686843777,BIEB 102,A06,193269,Butler; Shannon Rhey,13,0,32,19
1683686845825,BIEB 150,A01,193274,Staff,0,0,32,32
1683686845825,BIEB 150,A02,193285,Staff,24,0,32,8
1683686846848,BIEB 194,A00,193286,Kurle; Carolyn M.,19,0,32,13
1683686847878,BILD 1,A01,192291,Staff,15,0,32,17
1683686847878,BILD 1,A02,192292,Staff,30,0,32,2
1683686847878,BILD 1,B01,192520,Reuther; Keefe,0,1,0,0
1683686847878,BILD 1,B02,192532,Reuther; Keefe,0,1,0,0
1683686848904,BILD 3,A01,192556,Butler; Shannon Rhey,0,0,32,32
1683686848904,BILD 3,A02,192581,Butler; Shannon Rhey,0,1,32,32
1683686848904,BILD 3,A03,192611,Butler; Shannon Rhey,19,0,32,13
1683686848904,BILD 3,A04,192612,Butler; Shannon Rhey,24,0,32,8
1683686848904,BILD 3,A05,192613,Butler; Shannon Rhey,26,0,32,6
1683686848904,BILD 3,A06,192679,Butler; Shannon Rhey,27,0,32,5
1683686848904,BILD 3,A07,192682,Butler; Shannon Rhey,20,0,32,12
1683686849933,BILD 4,A01,192836,Reuther; Keefe,1,0,24,23
1683686849933,BILD 4,A02,193044,Reuther; Keefe,4,0,24,20
1683686850958,BILD 10,A01,193142,Gustafson-Brown; Cindy,29,0,32,3
1683686850958,BILD 10,A02,193149,Gustafson-Brown; Cindy,31,0,32,1
1683686851986,BIMM 100,A01,193301,Staff,0,6,32,32
1683686851986,BIMM 100,A02,193312,Staff,0,7,32,32
1683686851986,BIMM 100,A03,193323,Staff,0,10,32,32
1683686853012,BIMM 101,A01,193329,McDonnell; Lisa Marie,1,4,24,23
1683686853012,BIMM 101,A02,193339,McDonnell; Lisa Marie,1,4,24,23
1683686853012,BIMM 101,B01,193354,McDonnell; Lisa Marie,0,4,24,24
1683686853012,BIMM 101,B02,193357,McDonnell; Lisa Marie,0,3,24,24
1683686854037,BIMM 110,A01,193377,Tat; John,0,11,32,32
1683686854037,BIMM 110,A02,193378,Tat; John,0,11,32,32
1683686855062,BIMM 120,A01,206116,Staff,0,0,32,32
1683686855062,BIMM 120,A02,206117,Staff,7,0,32,25
1683686855062,BIMM 120,A03,206121,Staff,21,0,32,11
1683686856090,BIPN 100,A01,193393,Park; Ji Young,0,15,32,32
1683686856090,BIPN 100,A02,193402,Park; Ji Young,0,14,32,32
1683686856090,BIPN 100,A03,193413,Park; Ji Young,0,14,32,32
1683686856090,BIPN 100,A04,193414,Park; Ji Young,0,13,32,32
1683686857114,BIPN 102,A01,193429,Staff,0,0,32,32
1683686857114,BIPN 102,A02,193438,Staff,18,0,32,14
1683686858140,BIPN 106,A01,193450,Reyes Gonzalez; Catalina,0,2,40,40
1683686859167,BIPN 134,A01,193465,Cooke; James Edward,0,0,32,32
1683686859167,BIPN 134,A02,193474,Cooke; James Edward,25,0,32,7
1683686859167,BIPN 134,A03,193485,Cooke; James Edward,29,0,32,3
1683686859167,BIPN 134,A04,193486,Cooke; James Edward,20,0,32,12
1683686859167,BIPN 134,A05,193491,Cooke; James Edward,31,0,32,1
1683686859167,BIPN 134,A06,193501,Cooke; James Edward,30,0,32,2
1683686859167,BIPN 134,A07,193510,Cooke; James Edward,29,0,32,3
1683686861223,BISP 194,A00,222522,Staff,14,0,32,18
1683686862309,CAT 124,A01,202407,Staff,19,0,25,6
1683686863334,CAT 125,A00,202408,Marchisotto; Jennifer Anne,2,0,20,18
1683686864359,CAT 125R,A00,202409,Smith; Lauryn Alissa,0,11,20,20
1683686864359,CAT 125R,B00,202410,Morales; Celeste Georgianna,0,11,20,20
1683686864359,CAT 125R,C00,202411,Irwin; Matthew Joseph,0,12,20,20
1683686865387,CENG 15,A01,204712,Yang; Kesong,0,1,0,0
1683686866415,CENG 114,A00,202070,Jahed Motlagh; Zeinab,5,0,20,15
1683686867440,CGS 105,A00,185477,Wesling; Megan E.,24,0,40,16
1683686868464,CGS 106,A00,185494,Staff,11,0,22,11
1683686869489,CGS 108,A00,185495,Staff,14,0,20,6
1683686870513,CGS 114,A00,185496,Staff,13,0,18,5
1683686871538,CGS 119,A00,185501,Staff,15,0,20,5
1683686872562,CGS 120,A00,185511,Staff,12,0,20,8
1683686873586,CHEM 4,A01,184675,Bussey; Thomas J,97,0,100,3
1683686874614,CHEM 6A,A01,184677,Staff,32,0,60,28
1683686875641,CHEM 6B,A01,184679,Staff,63,0,100,37
1683686876666,CHEM 6C,A01,184681,Bussey; Thomas J,0,0,50,50
1683686876666,CHEM 6C,A02,184682,Bussey; Thomas J,32,0,50,18
1683686877693,CHEM 40A,A01,184684,Albizati; Kim F.,33,0,100,67
1683686878718,CHEM 40B,A01,184686,Albizati; Kim F.,0,22,100,100
1683686879745,CHEM 41B,A01,184690,Staff,51,0,100,49
1683686880770,COGS 3,A01,184715,Boyle; Mary E. T.,0,27,40,40
1683686881810,COGS 14B,A01,185172,Staff,0,14,38,38
1683686882834,COGS 18,A01,184736,Staff,14,0,80,66
1683686883863,COGS 100,A01,184932,Staff,0,8,73,73
1683686884890,COGS 101A,A01,184935,Staff,0,40,30,30
1683686885916,COGS 101B,A01,184944,Staff,0,2,30,30
1683686886943,COGS 101C,A01,184946,Staff,0,10,30,30
1683686887968,COGS 102A,A01,184951,Johnson; Christine M.,1,0,40,39
1683686888993,COGS 107B,A01,184953,Mooshagian; Eric Frederick,0,52,40,40
1683686890018,COGS 118B,A01,184959,Gupta; Anjum,0,50,40,40
1683686891041,COGS 153,A00,184961,Staff,0,16,30,30
1683686892065,COGS 177,A00,184962,Staff,1,21,30,29
1683686893092,COGS 187A,A01,184969,Boyle; Mary E. T.,0,19,40,40
1683686894116,COMM 10,A01,185174,Staff,0,5,25,25
1683686894116,COMM 10,A02,185189,Staff,0,2,25,25
1683686894116,COMM 10,A03,269821,Staff,0,1,0,0
1683686895143,COMM 100B,A02,185476,Staff,10,0,25,15
1683686895143,COMM 100B,A03,277340,Staff,25,0,25,0
1683686896171,COMM 100C,A01,185314,Staff,1,0,25,24
1683686896171,COMM 100C,A02,185327,Staff,17,0,25,8
1683686897195,COMM 110M,A00,185349,Staff,0,0,40,40
1683686898219,COMM 113T,A00,185352,Staff,25,0,40,15
1683686899244,COMM 114I,A00,185353,Staff,31,0,40,9
1683686900268,COMM 131,A00,185354,Staff,17,0,30,13
1683686901293,CSE 8A,A50,185358,Cao; Yingjun,0,46,10,10
1683686902316,CSE 8B,A01,185362,Staff,0,48,50,50
1683686903342,CSE 11,A01,185416,Cao; Yingjun,0,91,10,10
1683686904366,CSE 20,A01,185445,Briones; Jor-el Thomas Caparas,3,0,25,22
1683686905394,CSE 21,A01,185447,Staff,9,0,50,41
1683686906418,CSE 101,A01,185451,Staff,0,13,50,50
1683686906418,CSE 101,B01,185453,Jones; Miles E,0,14,50,50
1683686908473,CSE 141,A01,185458,Eldon; John,16,0,100,84
1683686909497,CSE 141L,A01,185461,Eldon; John,8,0,100,92
1683686910522,CSE 142,A01,185463,Staff,34,0,60,26
1683686910522,CSE 142,B01,201355,Staff,0,7,60,60
1683686911548,CSE 142L,A01,185470,Staff,34,0,60,26
1683686911548,CSE 142L,B01,201417,Staff,0,6,60,60
1683686912574,CSE 190,A00,201433,Staff,32,0,49,17
1683686913599,DOC 1,A01,259136,Strom; Megan C.,7,0,15,8
1683686913599,DOC 1,A02,259137,Strom; Megan C.,14,0,15,1
1683686913599,DOC 1,A03,259138,Strom; Megan C.,14,0,15,1
1683686913599,DOC 1,A04,259139,Strom; Megan C.,14,0,15,1
1683686914625,DOC 100D,A00,259140,Pass; Natalye Joann,14,0,25,11
1683686915651,DSGN 1,A01,184749,Rill; Bryan,0,26,30,30
1683686916677,DSGN 100,A01,185168,Staff,0,2,25,25
1683686917701,ECE 5,A01,185626,Morris; Karcher William,0,12,0,0
1683686918726,ECE 101,A01,185628,Staff,14,0,70,56
1683686919751,ECE 107,A01,185635,Baghdadchi; Saharnaz,0,0,20,20
1683686919751,ECE 107,A02,185638,Baghdadchi; Saharnaz,1,0,20,19
1683686920773,ECE 148,A01,185647,Silberman; Jack,0,0,16,16
1683686921812,ECON 1,A01,185537,Crane; Meredith Helen,54,0,70,16
1683686922840,ECON 3,A01,185549,Crane; Meredith Helen,30,0,70,40
1683686923867,ECON 4,A01,203354,Anderson; John Charles,0,5,10,10
1683686924894,ECON 100A,A01,185574,Staff,0,5,40,40
1683686925920,ECON 100B,A01,185576,Staff,0,12,50,50
1683686926944,ECON 100C,A01,185589,Newhouse; Herbert S,30,0,70,40
1683686927969,ECON 105,A00,185608,Vespa; Emanuel Ignacio,19,0,35,16
1683686928996,ECON 109,A01,185610,Shishkin; Denis,9,0,35,26
1683686930020,ECON 110A,A01,185612,Staff,8,0,40,32
1683686931045,ECON 120A,A01,185615,Staff,19,0,40,21
1683686932071,ECON 120C,A01,185617,Sun; Yixiao,0,21,70,70
1683686933095,ECON 144,A00,203346,Squires; Dale E,2,0,35,33
1683686934119,ECON 171,A01,203349,Newhouse; Herbert S,0,1,35,35
1683686935143,ECON 173A,A01,185621,Toda; Alexis Akira,21,0,35,14
1683686936168,EDS 25,A01,202413,Staff,0,1,0,0
1683686936168,EDS 25,A02,202414,Staff,0,1,0,0
1683686936168,EDS 25,A03,202415,Staff,0,0,0,0
1683686936168,EDS 25,A04,202416,Staff,0,1,0,0
1683686936168,EDS 25,A05,202439,Staff,0,0,0,0
1683686936168,EDS 25,A06,202440,Staff,0,0,0,0
1683686936168,EDS 25,B01,202631,Staff,0,0,0,0
1683686936168,EDS 25,B02,202632,Staff,0,0,0,0
1683686936168,EDS 25,B03,202639,Staff,0,0,0,0
1683686936168,EDS 25,B04,202640,Staff,0,0,0,0
1683686936168,EDS 25,B05,202643,Staff,0,0,0,0
1683686936168,EDS 25,B06,202644,Staff,0,0,0,0
1683686937196,EDS 38,A01,202659,Black; Alison Michelle,24,0,25,1
1683686938220,EDS 115,A00,202652,Staff,18,0,30,12
1683686939244,EDS 125,A00,202649,Staff,13,0,30,17
1683686940271,EDS 126,A01,203332,Staff,30,0,30,0
1683686941294,EDS 139,A00,202838,Staff,16,0,25,9
1683686942318,EDS 146,A01,202655,Staff,14,0,25,11
1683686943342,ENG 15,A00,185667,Staff,0,1,0,0
1683686943342,ENG 15,B00,185672,Staff,0,0,0,0
1683686943342,ENG 15,C00,185675,Staff,0,0,0,0
1683686943342,ENG 15,D00,185682,Staff,0,0,0,0
1683686943342,ENG 15,E00,185684,Staff,0,0,0,0
1683686944369,ETHN 103,A00,185710,Staff,0,8,35,35
1683686945395,ETHN 103A,A00,199228,Man; Simeon S,0,0,9,9
1683686946421,ETHN 109,A00,185711,Staff,15,0,35,20
1683686947444,ETHN 142,A00,185726,Staff,0,4,30,30
1683686948469,ETHN 163J,A00,199229,Man; Simeon S,5,0,8,3
1683686949493,ETHN 168,A00,185727,Staff,7,0,10,3
1683686950517,ETHN 182,A00,185728,Staff,0,0,35,35
1683686951541,ETHN 183,A00,185737,Staff,9,0,18,9
1683686952566,GLBH 111,A01,209361,Burgos; Jose L.,0,0,0,0
1683686954616,HIEU 104,A00,185792,Staff,14,0,20,6
1683686955640,HIEU 115,A00,185800,Staff,0,0,20,20
1683686956666,HIEU 128,A00,185801,Staff,0,9,20,20
1683686957690,HIEU 147,A00,185802,Staff,15,0,20,5
1683686958713,HIEU 154,A00,185823,Staff,11,0,20,9
1683686959737,HILA 102,A00,185826,Staff,14,0,20,6
1683686960764,HILD 2C,A01,185778,Staff,0,13,20,20
1683686961788,HILD 7B,A01,185780,Kwak; Nancy,0,17,32,32
1683686961788,HILD 7B,A02,185781,Kwak; Nancy,0,18,32,32
1683686962815,HILD 30,A01,185791,Staff,12,0,20,8
1683686963842,HISC 119,A00,185830,Golan; Tal,0,10,20,20
1683686964867,HITO 156GS,A00,185831,Patterson; Patrick H.,0,0,0,23
1683686965963,HIUS 103,A00,185832,Man; Simeon S,0,4,20,20
1683686966986,HIUS 117,A00,185836,Kwak; Nancy,2,0,20,18
1683686968010,HIUS 125,A00,185840,Man; Simeon S,0,2,23,23
1683686969036,HIUS 149,A00,185845,Staff,1,0,20,19
1683686970064,HUM 3,A01,185882,Zavodny; Tatiana Sophia,0,8,50,50
1683686970064,HUM 3,B01,185899,Caldwell; Michael Alan,0,18,50,50
1683686971090,HUM 3GS,A00,185900,Patterson; Patrick H.,0,0,0,23
1683686972117,HUM 4,A01,185938,Zroka; Amy Liane,28,0,50,22
1683686972117,HUM 4,B01,185956,Watkins; Eric,0,6,50,50
1683686972117,HUM 4,B02,202209,Watkins; Eric,0,5,50,50
1683686972117,HUM 4,B03,202210,Watkins; Eric,0,5,50,50
1683686973144,HUM 5,A01,185958,West; Geoffrey Scott,0,0,50,50
1683686973144,HUM 5,A02,202215,West; Geoffrey Scott,0,0,50,50
1683686974171,INTL 190,A00,185959,Gagnon; Jeffrey C,0,0,0,9
1683686974171,INTL 190,B00,185960,Lettieri; Michael Joseph,0,0,0,2
1683686975196,JAPN 180,A00,254509,Staff,5,0,30,25
1683686976221,LATI 10,A01,202853,Kennemore; Amy Michelle,4,0,35,31
1683686976221,LATI 10,A02,202854,Kennemore; Amy Michelle,3,0,35,32
1683686976221,LATI 10,A03,270054,Kennemore; Amy Michelle,30,0,30,0
1683686977245,LATI 180,A00,202855,Kennemore; Amy Michelle,11,0,20,9
1683686978269,LAWS 101,A00,201767,Golan; Tal,0,7,40,40
1683686979294,LIFR 1C,A00,185961,Staff,6,0,20,14
1683686980317,LIFR 1CX,A00,185962,Staff,7,0,20,13
1683686981345,LIFR 1D,A00,185963,Staff,7,0,20,13
1683686982372,LIFR 1DX,A00,185964,Staff,7,0,20,13
1683686983399,LIGN 101,A01,186039,Staff,43,0,50,7
1683686984423,LIGN 165,A00,186040,Staff,15,0,50,35
1683686985448,LTCS 108,A00,186041,Staff,5,0,10,5
1683686986475,LTCS 119,A00,186042,Staff,15,0,20,5
1683686987503,LTCS 130,A00,186043,Wesling; Megan E.,15,0,25,10
1683686989554,LTEA 138,A00,186119,Staff,14,0,40,26
1683686990580,LTEN 124,A00,186148,Staff,5,0,25,20
1683686991603,LTEN 178,A00,186149,Staff,6,0,15,9
1683686992631,LTEN 181,A00,186150,Blanco; John D,34,0,40,6
1683686993658,LTWL 120,A00,186160,Staff,19,0,25,6
1683686994686,LTWL 165,A00,186161,Staff,22,0,25,3
1683686995709,LTWR 100,A00,186162,Staff,0,5,15,15
1683686996732,LTWR 102,A00,186163,Doller; Ben,5,0,15,10
1683686997756,MAE 8,A01,186412,Staff,0,1,0,0
1683686998783,MAE 30B,A00,186445,Bahadori; Mohammad Yousef,81,0,100,19
1683686999809,MAE 40,A00,186592,Bewley; Thomas R,10,0,50,40
1683687000832,MAE 101B,A00,186593,Bahadori; Mohammad Yousef,80,0,100,20
1683687001861,MAE 105,A00,186594,Bandaru; Prabhakar,10,0,50,40
1683687002888,MAE 107,A00,186599,Pham; Hieu Tan,0,7,120,120
1683687003912,MAE 148,A01,186660,Silberman; Jack,3,0,16,13
1683687004940,MATH 10A,A01,188095,Staff,0,6,35,35
1683687005963,MATH 10B,A01,188097,Bowers; Adam R.,0,12,30,30
1683687005963,MATH 10B,A02,188099,Bowers; Adam R.,0,11,30,30
1683687005963,MATH 10B,B01,188104,Bowers; Adam R.,0,10,30,30
1683687005963,MATH 10B,B02,188106,Bowers; Adam R.,1,9,30,29
1683687006991,MATH 10C,A01,188111,Staff,0,20,30,30
1683687006991,MATH 10C,A02,188127,Staff,0,19,30,30
1683687006991,MATH 10C,A03,188131,Staff,0,19,30,30
1683687006991,MATH 10C,B01,188218,Staff,17,0,30,13
1683687006991,MATH 10C,B02,188244,Staff,13,0,30,17
1683687006991,MATH 10C,B03,188277,Staff,14,0,30,16
1683687008019,MATH 18,A01,188344,Bach; Quang Tran,18,0,30,12
1683687008019,MATH 18,A02,188345,Bach; Quang Tran,11,0,30,19
1683687008019,MATH 18,B01,188353,Bach; Quang Tran,11,0,30,19
1683687008019,MATH 18,B02,188354,Bach; Quang Tran,19,0,30,11
1683687009042,MATH 20A,A01,188374,Staff,11,0,35,24
1683687010068,MATH 20B,A01,188382,Ohm; Ko Woon,7,0,30,23
1683687010068,MATH 20B,A02,188383,Ohm; Ko Woon,22,0,30,8
1683687010068,MATH 20B,B01,188385,Ohm; Ko Woon,7,0,30,23
1683687010068,MATH 20B,B02,188392,Ohm; Ko Woon,22,0,30,8
1683687011093,MATH 20C,A01,188394,Harel; Guershon,10,0,30,20
1683687011093,MATH 20C,A02,188395,Harel; Guershon,13,0,30,17
1683687011093,MATH 20C,B01,188404,Harel; Guershon,5,0,30,25
1683687011093,MATH 20C,B02,188405,Harel; Guershon,18,0,30,12
1683687012117,MATH 20D,A01,188414,Hammock; Frances H,0,1,30,30
1683687012117,MATH 20D,A02,188415,Hammock; Frances H,0,1,30,30
1683687012117,MATH 20D,B01,188447,Hammock; Frances H,0,1,30,30
1683687012117,MATH 20D,B02,188486,Hammock; Frances H,2,0,30,28
1683687013140,MATH 20E,A01,188649,Staff,21,0,30,9
1683687013140,MATH 20E,A02,188650,Staff,20,0,30,10
1683687013140,MATH 20E,A03,188673,Staff,0,0,30,30
1683687014164,MATH 102,A01,188675,Staff,0,40,35,35
1683687015193,MATH 103B,A01,188681,Staff,3,0,35,32
1683687015193,MATH 103B,B01,188692,Staff,5,0,35,30
1683687016217,MATH 109,A01,188695,Salehi Golsefidy; Alireza,24,0,35,11
1683687016217,MATH 109,A02,188696,Salehi Golsefidy; Alireza,25,0,35,10
1683687017244,MATH 120A,A01,188698,Eggers; John Dietrich,7,0,35,28
1683687018272,MATH 142B,A01,188736,Ioana; Adrian,1,1,30,29
1683687018272,MATH 142B,A02,188741,Ioana; Adrian,0,1,30,30
1683687018272,MATH 142B,A03,188743,Ioana; Adrian,0,2,30,30
1683687019298,MATH 168A,A01,188790,Staff,0,11,35,35
1683687020323,MATH 170A,A01,188803,Nie; Jiawang,0,2,35,35
1683687020323,MATH 170A,A02,188811,Nie; Jiawang,0,1,35,35
1683687020323,MATH 170A,A03,188814,Nie; Jiawang,0,0,35,35
1683687020323,MATH 170A,A04,188815,Nie; Jiawang,5,0,35,30
1683687021349,MATH 193B,A01,188817,Staff,0,0,35,35
1683687021349,MATH 193B,A02,188818,Staff,6,0,35,29
1683687022373,MGT 4,A01,202857,Anderson; John Charles,59,0,80,21
1683687023399,MGT 12,A00,202858,Lindenberger; Wade Douglas,40,0,90,50
1683687024423,MGT 18,A00,202859,Staff,74,0,90,16
1683687025450,MGT 18GS,A00,202860,McKay; Michael J,13,0,28,15
1683687026476,MGT 45,A00,202861,Pecore; Joseph P.,8,0,90,82
1683687027499,MGT 100,A00,202863,Yavorsky; Daniel Ryan,27,0,90,63
1683687028526,MGT 103,A00,202864,Ehrich; Kristine R,0,19,90,90
1683687029552,MGT 112,A00,202865,Ehrich; Kristine R,15,0,90,75
1683687030578,MGT 121A,A00,202868,Staff,90,20,90,0
1683687031601,MGT 131B,A00,202869,Anderson; John Charles,59,0,90,31
1683687032625,MGT 136,A00,202871,Lindenberger; Wade Douglas,83,0,90,7
1683687033652,MGT 164,A00,202873,Staff,0,68,90,91
1683687034676,MGT 164GS,A00,202874,McKay; Mary A,13,0,28,15
1683687035701,MGT 180,A00,202875,Staff,0,51,90,91
1683687036724,MMW 11R,A01,205019,Herbst; Matthew,0,0,30,30
1683687036724,MMW 11R,A02,205026,Herbst; Matthew,29,0,30,1
1683687037748,MMW 15,A01,193512,Chang; Edmond Yi-Teh,0,8,28,28
1683687037748,MMW 15,A02,193513,Chang; Edmond Yi-Teh,0,5,28,28
1683687037748,MMW 15,A03,193514,Chang; Edmond Yi-Teh,0,5,28,28
1683687037748,MMW 15,A04,193515,Chang; Edmond Yi-Teh,0,5,28,28
1683687037748,MMW 15,A05,193516,Chang; Edmond Yi-Teh,0,5,28,28
1683687037748,MMW 15,A06,193517,Chang; Edmond Yi-Teh,0,6,28,28
1683687037748,MMW 15,B01,193519,Chang; Edmond Yi-Teh,0,5,28,28
1683687037748,MMW 15,B02,193520,Chang; Edmond Yi-Teh,0,5,28,28
1683687037748,MMW 15,B03,193521,Chang; Edmond Yi-Teh,0,5,28,28
1683687037748,MMW 15,B04,193522,Chang; Edmond Yi-Teh,0,6,28,28
1683687037748,MMW 15,B05,193523,Chang; Edmond Yi-Teh,0,5,28,28
1683687037748,MMW 15,B06,193524,Chang; Edmond Yi-Teh,0,5,28,28
1683687038776,MMW 122,A01,193526,Rahimi; Babak,0,16,28,28
1683687038776,MMW 122,A02,193527,Rahimi; Babak,0,15,28,28
1683687038776,MMW 122,A03,193528,Rahimi; Babak,0,0,0,0
1683687038776,MMW 122,A04,193529,Rahimi; Babak,0,0,0,0
1683687039802,MUS 1A,A01,186663,Staff,1,19,35,34
1683687040826,MUS 4,A01,186715,Staff,0,12,35,35
1683687041850,MUS 5R,A01,186796,Dubnov; Shlomo,0,17,35,35
1683687042878,MUS 6,A01,186798,Staff,1,5,25,24
1683687043906,MUS 7,A01,186830,Staff,11,0,35,24
1683687044931,MUS 8,A01,186930,Staff,0,27,35,35
1683687045955,MUS 15,A01,186932,Staff,0,15,35,35
1683687045955,MUS 15,B01,186934,Staff,1,17,35,34
1683687046980,MUS 80,A00,186935,Staff,0,0,20,20
1683687046980,MUS 80,B00,186936,Staff,24,0,25,1
1683687048008,NANO 11,A00,204702,Lipomi; Darren John,0,0,0,0
1683687049033,NANO 15,A01,204709,Yang; Kesong,0,1,0,0
1683687050057,NANO 114,A00,202069,Jahed Motlagh; Zeinab,2,0,10,8
1683687051081,PHIL 1,A00,186955,Grush; Rick Scott,31,0,40,9
1683687052108,PHIL 10,A01,186973,Grush; Rick Scott,27,0,35,8
1683687052108,PHIL 10,A02,186974,Grush; Rick Scott,33,0,35,2
1683687053132,PHIL 13,A01,186976,Staff,1,0,35,34
1683687053132,PHIL 13,A02,186977,Staff,16,0,35,19
1683687054156,PHIL 14,A01,186979,Staff,31,0,35,4
1683687054156,PHIL 14,A02,186986,Staff,32,0,35,3
1683687055180,PHIL 28,A01,186988,Staff,16,0,30,14
1683687055180,PHIL 28,A02,186989,Staff,1,0,30,29
1683687055180,PHIL 28,A03,186990,Staff,10,0,30,20
1683687055180,PHIL 28,A04,186991,Staff,26,0,30,4
1683687056204,PHIL 120,A00,186997,Staff,23,0,40,17
1683687057227,PHIL 137,A00,187003,Staff,7,0,40,33
1683687058250,PHIL 150,A00,187015,Staff,47,0,70,23
1683687059273,PHIL 167,A00,187021,Lamey; Andy M.,34,0,40,6
1683687060298,PHIL 174,A01,202226,Staff,17,0,20,3
1683687060298,PHIL 174,A02,202235,Staff,20,0,20,0
1683687061322,PHIL 191A,A00,258918,Staff,0,0,1,1
1683687062349,PHYS 1A,A00,187028,Staff,26,0,60,34
1683687063377,PHYS 1AL,001,187036,Staff,3,0,30,27
1683687063377,PHYS 1AL,002,187049,Staff,18,0,30,12
1683687064405,PHYS 1B,A00,187058,Staff,22,0,60,38
1683687065430,PHYS 1BL,001,187064,Staff,0,1,30,30
1683687065430,PHYS 1BL,002,187070,Staff,4,0,30,26
1683687066455,PHYS 1C,A00,187082,Staff,29,0,120,91
1683687067484,PHYS 1CL,001,187088,Staff,0,9,30,30
1683687067484,PHYS 1CL,002,187089,Staff,0,1,30,30
1683687067484,PHYS 1CL,009,262693,Staff,9,0,30,21
1683687068508,PHYS 2B,A01,187097,Staff,55,0,115,60
1683687069591,PHYS 2C,A01,187099,Staff,63,0,115,52
1683687070622,PHYS 2CL,A01,187101,Staff,5,0,28,23
1683687070622,PHYS 2CL,A02,187102,Staff,15,0,28,13
1683687071650,PHYS 2D,A01,187123,Shotwell; Brian,95,0,115,20
1683687072677,PHYS 4B,A01,187133,Grinstein; Benjamin,35,0,50,15
1683687073705,POLI 10,A00,188819,Staff,0,4,50,50
1683687074730,POLI 11,A00,188827,Staff,43,0,50,7
1683687075754,POLI 13R,A00,188828,Staff,0,1,20,20
1683687076779,POLI 27,A01,188830,Elgin; Samuel Zincke,0,2,70,70
1683687077804,POLI 30,A00,188832,Desposato; Scott,30,0,50,20
1683687078829,POLI 102F,A00,188834,Staff,1,0,40,39
1683687079853,POLI 104A,A00,188852,Staff,12,0,30,18
1683687080880,POLI 104I,A00,188853,Staff,0,8,20,20
1683687081907,POLI 110B,A00,188854,Wiens; David,6,0,20,14
1683687082930,POLI 112A,A00,188855,Wiens; David,3,0,30,27
1683687083960,POLI 117R,A00,188856,Forman; Fonna,0,12,20,20
1683687084984,POLI 118,A00,188857,Ingham; Sean,8,0,20,12
1683687086008,POLI 120G,A00,188858,Staff,8,0,30,22
1683687087036,POLI 131CR,A00,188863,Hoston; Germaine,20,0,50,30
1683687088061,POLI 133,A00,188864,Nellis; Gareth Hb,44,0,50,6
1683687089086,POLI 134D,A00,188865,Desposato; Scott,27,0,30,3
1683687090108,POLI 142A,A00,188871,Gartzke; Erik,21,0,50,29
1683687091134,POLI 142K,A00,188874,Staff,38,0,50,12
1683687092161,POLI 143,A00,188940,Gartzke; Erik,16,0,30,14
1683687093189,POLI 153,A00,188943,Staff,2,0,20,18
1683687094211,POLI 160AA,A00,188944,Staff,10,0,40,30
1683687095238,POLI 170A,A00,188945,Staff,10,0,30,20
1683687097293,PSYC 1,A00,188952,Staff,36,0,90,54
1683687098318,PSYC 2,B00,188953,Staff,19,0,35,16
1683687099342,PSYC 6,A00,188970,Staff,47,0,60,13
1683687100366,PSYC 7,A00,188973,Staff,35,0,45,10
1683687101390,PSYC 60,A01,188980,Rickard; Timothy C.,42,0,60,18
1683687102414,PSYC 70,A01,189001,Steiner; Eric Tomas,21,0,45,24
1683687103438,PSYC 100,A00,189005,Lacefield; Katharine I,0,99,120,120
1683687104461,PSYC 102,A00,189008,Staff,7,0,30,23
1683687105487,PSYC 106,B00,189026,Gorman; Michael R.,27,0,60,33
1683687106515,PSYC 114,B01,189033,Winkielman; Piotr,0,31,30,30
1683687107537,PSYC 131,A00,189036,Anagnostaras; Stephan,0,43,60,60
1683687108564,PSYC 136,A00,189041,Lowe; Angela Beth,0,7,25,25
1683687109592,PSYC 137,A00,189057,Winkielman; Piotr,1,37,25,24
1683687110616,PSYC 144,A00,189107,Wixted; John T,0,11,50,50
1683687112668,PSYC 162,A00,189142,Staff,0,9,85,85
1683687113693,PSYC 172,A00,189144,Gorman; Michael R.,0,6,30,30
1683687115743,PSYC 179,A00,189146,Lacefield; Katharine I,0,87,120,120
1683687116771,PSYC 181,A00,189147,Anagnostaras; Stephan,0,44,90,90
1683687117796,PSYC 190R,A00,189148,Barner; David A.,0,23,80,80
1683687118826,PSYC 191,A00,189275,Rickard; Timothy C.,0,10,25,25
1683687119852,PSYC 193,A00,189276,Chapman; Eddie Nathaniel,0,1,0,4
1683687120876,PSYC 193L,A01,189281,Lowe; Angela Beth,8,0,20,12
1683687120876,PSYC 193L,B01,189285,Staff,28,0,35,7
1683687121903,RELI 149,A00,187137,Rahimi; Babak,6,0,40,34
1683687122926,SE 9,A01,187315,Staff,0,2,18,18
1683687123950,SE 101B,A00,187409,Staff,24,0,30,6
1683687124973,SE 110B,A00,187444,Staff,10,0,40,30
1683687126001,SE 130B,A00,187449,Staff,31,0,40,9
1683687127027,SE 150A,A00,187516,Staff,8,0,20,12
1683687128057,SE 154,A00,187528,Staff,29,0,50,21
1683687129081,SIO 3,A01,258171,Staff,35,0,40,5
1683687130105,SIO 10,A00,187144,Cook; Geoffrey W,1,7,75,74
1683687131128,SIO 45,A00,187152,Cook; Geoffrey W,0,7,100,100
1683687132152,SIO 109R,A00,194486,Staff,0,4,20,20
1683687134201,SIO 187,A01,187233,Kacev; David,12,0,40,28
1683687135230,SOCI 1,A01,258656,Thorpe; Charles Robert,28,0,30,2
1683687135230,SOCI 1,A02,258658,Thorpe; Charles Robert,30,0,30,0
1683687135230,SOCI 1,A03,258661,Thorpe; Charles Robert,25,0,25,0
1683687135230,SOCI 1,A04,258666,Thorpe; Charles Robert,22,0,25,3
1683687135230,SOCI 1,A05,258897,Thorpe; Charles Robert,22,0,25,3
1683687135230,SOCI 1,A06,258898,Thorpe; Charles Robert,25,0,25,0
1683687136255,SOCI 30,A01,258903,Pardo Guerra; Juan Pablo,14,0,30,16
1683687137280,SOCI 102,A00,258904,Staff,9,0,25,16
1683687138308,SOCI 106,A00,258905,Staff,19,0,25,6
1683687139335,SOCI 111,A00,258907,Ribas Norris; Janet Vanesa,26,0,30,4
1683687140362,SOCI 121R,A00,258908,Pardo Guerra; Juan Pablo,8,0,30,22
1683687141388,SOCI 126,A01,203330,Staff,14,0,20,6
1683687142416,SOCI 131,A00,258909,Thorpe; Charles Robert,30,0,60,30
1683687153993,SOCI 135,A00,258910,Payne; Christine Anna,0,12,30,30
1683687155016,SOCI 157,A00,258911,Staff,11,0,30,19
1683687156042,SOCI 184,A00,258912,Staff,25,0,30,5
1683687157066,SOCI 188D,A00,258913,Staff,22,0,30,8
1683687158089,SYN 2,001,187529,Staff,9,0,16,7
1683687158089,SYN 2,002,201452,Staff,1,20,16,15
1683687158089,SYN 2,003,201469,Staff,1,0,16,15
1683687159113,SYN 100,A01,187531,Staff,0,9,20,20
1683687159113,SYN 100,B01,201491,Staff,0,10,20,20
1683687160138,TDAC 1,A00,189286,Walsh; Kim C.,3,0,20,17
1683687160138,TDAC 1,B00,189287,Harting; Carla Kelso,10,0,20,10
1683687161163,TDAC 101,A00,189300,Walsh; Kim C.,16,0,20,4
1683687161163,TDAC 101,B00,189301,Harting; Carla Kelso,18,0,20,2
1683687162189,TDAC 102,A00,189304,Basso; Beatrice,14,0,20,6
1683687163218,TDAC 108,A00,189305,Staff,18,0,20,2
1683687164243,TDDE 131,A00,189310,Staff,19,0,20,1
1683687164243,TDDE 131,B00,189314,Staff,19,0,20,1
1683687164243,TDDE 131,C00,189315,Staff,48,0,50,2
1683687164243,TDDE 131,D00,189316,Staff,14,0,15,1
1683687164243,TDDE 131,E00,204841,Staff,20,0,20,0
1683687165269,TDGE 10,A00,189289,Staff,27,0,50,23
1683687165269,TDGE 10,B00,189290,Havis; Allan,0,1,50,50
1683687166294,TDGE 11,A00,189291,Fulton; Julia,0,4,50,50
1683687166294,TDGE 11,B00,189292,Staff,20,0,25,5
1683687166294,TDGE 11,C00,260270,Staff,0,0,0,0
1683687167321,TDGE 25,A00,189294,Staff,1,0,20,19
1683687168346,TDGE 124,A00,189318,Fulton; Julia,1,8,50,49
1683687169374,TDGE 125,A00,189319,Staff,13,0,25,12
1683687169374,TDGE 125,B00,189320,Staff,23,0,25,2
1683687170403,TDGE 127,A00,189322,Havis; Allan,0,0,50,50
1683687171427,TDHT 101,A00,189323,Staff,18,0,25,7
1683687171427,TDHT 101,B00,189324,Staff,25,0,25,0
1683687172451,TDHT 102,A00,189325,Staff,49,0,50,1
1683687173479,TDMV 1,A00,189295,Arcidiacono; Kristin,20,0,30,10
1683687173479,TDMV 1,B00,189296,Caligagan; Maria T.,24,0,30,6
1683687174504,TDMV 2,A00,189297,Sammartano; Tonnie,27,0,30,3
1683687174504,TDMV 2,B00,189299,Arcidiacono; Kristin,23,0,30,7
1683687175529,TDMV 3,A00,204998,Rincon; Alicia,22,0,30,8
1683687176554,TDMV 120,A00,189458,Sammartano; Tonnie,28,0,30,2
1683687177581,TDMV 138,A00,189541,Jun; Grace Shin Hae,20,0,40,20
1683687178606,TDMV 142,A00,189717,Caligagan; Tony,25,0,30,5
1683687178606,TDMV 142,B00,189718,Caligagan; Maria T.,25,0,30,5
1683687179633,TMC 2,A01,187533,Staff,25,0,25,0
1683687179633,TMC 2,A02,187534,Staff,25,0,25,0
1683687180656,USP 1,A01,187536,Kwak; Nancy,0,16,25,25
1683687181683,USP 5,A01,187538,Staff,8,0,25,17
1683687182708,USP 101,A00,199253,Staff,0,4,0,0
1683687183791,USP 124,A00,187562,Boomhower; Matthew Charles,0,0,30,30
1683687184814,USP 138,A00,187582,Staff,19,0,25,6
1683687185838,USP 152,A01,187597,Staff,3,0,25,22
1683687186863,USP 153,A00,187598,Staff,18,0,25,7
1683687187884,USP 168,A00,187607,Kwak; Nancy,2,0,5,3
1683687188912,USP 173,A00,187619,Staff,4,0,25,21
1683687189939,USP 181,A00,187638,Staff,0,4,25,25
1683687190966,VIS 103,A00,187650,Cruz; Edwin Teddy,17,0,75,58
1683687191990,VIS 110D,A00,187669,Staff,13,0,22,9
1683687193016,VIS 127C,A00,187720,Shen; Kuiyi,67,0,146,79
1683687194046,VIS 149,A00,187731,Yoldas; Pinar,1,14,22,21
1683687195068,VIS 151,A01,188091,Staff,22,0,34,12
1683687195068,VIS 151,A02,188092,Staff,11,0,34,23
1683687196091,VIS 160B,A00,188093,Stalbaum; Brett,0,1,10,10
1683687198145,WCWP 10B,A00,201720,Staff,0,0,5,5
1683687198145,WCWP 10B,B00,201722,Staff,0,0,6,6
1683687199176,WCWP 100,A00,201725,Gagnon; Jeffrey C,0,0,2,2
1683687199176,WCWP 100,B00,201727,Staff,0,4,15,15
1683687202263,ANBI 133,A00,258401,Wilder; Linnea Lorene,34,0,40,6
1683687203291,ANBI 140,A00,258395,Hrvoj Mihic; Branka,18,0,25,7
1683687204315,ANSC 120,A00,258402,Bialecki; Jon Anthony,26,0,40,14
1683687205340,ANSC 144,A00,258400,Staff,12,0,40,28
1683687207395,ANSC 166,A00,258396,Parish; Steven Martin,156,0,175,19
1683687208421,ANSC 180,A00,193533,Staff,8,0,20,12
1683687209448,ANSC 188,A00,258397,Jassal; Aftab,34,0,40,6
1683687210471,ANTH 3,A01,258316,Staff,23,0,30,7
1683687211498,ANTH 5,A00,258394,Semendeferi; Ekaterini,16,0,20,4
1683687212524,ANTH 21,A01,258331,Staff,4,0,40,36
1683687213549,ANTH 103,A00,258398,Varma; Saiba,15,0,25,10
1683687214576,AWP 10,001,202034,Staff,0,0,0,0
1683687214576,AWP 10,002,202035,Staff,0,0,0,0
1683687214576,AWP 10,003,202036,Staff,0,0,0,0
1683687214576,AWP 10,004,202037,Staff,0,0,0,0
1683687214576,AWP 10,005,202038,Staff,0,0,0,0
1683687214576,AWP 10,006,202039,Staff,0,0,0,0
1683687214576,AWP 10,007,202040,Staff,0,0,0,0
1683687214576,AWP 10,008,202041,Staff,0,0,0,0
1683687214576,AWP 10,009,202042,Staff,0,0,0,0
1683687214576,AWP 10,010,202043,Staff,0,0,0,0
1683687214576,AWP 10,011,202044,Staff,0,0,0,0
1683687214576,AWP 10,012,202045,Staff,0,0,0,0
1683687214576,AWP 10,013,202046,Staff,0,0,0,0
1683687214576,AWP 10,014,202047,Staff,0,0,0,0
1683687214576,AWP 10,015,202048,Staff,0,0,0,0
1683687214576,AWP 10,016,202049,Staff,0,0,0,0
1683687214576,AWP 10,017,202050,Staff,0,0,0,0
1683687214576,AWP 10,018,202051,Staff,0,0,0,0
1683687214576,AWP 10,019,202052,Staff,0,0,0,0
1683687214576,AWP 10,020,202053,Staff,0,0,0,0
1683687214576,AWP 10,021,202054,Staff,0,0,0,0
1683687214576,AWP 10,022,202055,Staff,0,0,0,0
1683687214576,AWP 10,023,202056,Staff,0,0,0,0
1683687214576,AWP 10,024,202057,Staff,0,0,0,0
1683687214576,AWP 10,025,202058,Staff,0,0,0,0
1683687214576,AWP 10,026,202059,Staff,0,0,0,0
1683687215599,AWP 102,001,202032,Staff,0,0,0,0
1683687215599,AWP 102,002,202033,Staff,0,0,0,0
1683687216623,BENG 100,A01,254234,Taylor Amos; Alyssa C,31,0,40,9
1683687217649,BENG 196,001,270013,Engler; Adam J.,9999,0,9999,0
1683687218677,BICD 100R,A01,202018,Smith; Laurie,0,7,32,32
1683687218677,BICD 100R,A02,202019,Smith; Laurie,0,3,32,32
1683687218677,BICD 100R,A03,202020,Smith; Laurie,0,1,32,32
1683687218677,BICD 100R,A04,202021,Smith; Laurie,6,0,32,26
1683687218677,BICD 100R,A05,202022,Smith; Laurie,10,0,32,22
1683687219700,BICD 136,A01,193242,Gustafson-Brown; Cindy,0,2,32,32
1683687219700,BICD 136,A02,193244,Gustafson-Brown; Cindy,13,0,32,19
1683687220730,BIEB 102,A01,193249,Butler; Shannon Rhey,1,1,32,31
1683687220730,BIEB 102,A02,193251,Butler; Shannon Rhey,0,0,32,32
1683687220730,BIEB 102,A03,193253,Butler; Shannon Rhey,0,0,32,32
1683687220730,BIEB 102,A04,193255,Butler; Shannon Rhey,13,0,32,19
1683687220730,BIEB 102,A05,193265,Butler; Shannon Rhey,25,0,32,7
1683687220730,BIEB 102,A06,193269,Butler; Shannon Rhey,13,0,32,19
1683687222781,BIEB 150,A01,193274,Staff,0,0,32,32
1683687222781,BIEB 150,A02,193285,Staff,24,0,32,8
1683687223812,BIEB 194,A00,193286,Kurle; Carolyn M.,19,0,32,13
1683687224836,BILD 1,A01,192291,Staff,15,0,32,17
1683687224836,BILD 1,A02,192292,Staff,30,0,32,2
1683687224836,BILD 1,B01,192520,Reuther; Keefe,0,1,0,0
1683687224836,BILD 1,B02,192532,Reuther; Keefe,0,1,0,0
1683687225864,BILD 3,A01,192556,Butler; Shannon Rhey,0,0,32,32
1683687225864,BILD 3,A02,192581,Butler; Shannon Rhey,0,1,32,32
1683687225864,BILD 3,A03,192611,Butler; Shannon Rhey,19,0,32,13
1683687225864,BILD 3,A04,192612,Butler; Shannon Rhey,24,0,32,8
1683687225864,BILD 3,A05,192613,Butler; Shannon Rhey,26,0,32,6
1683687225864,BILD 3,A06,192679,Butler; Shannon Rhey,27,0,32,5
1683687225864,BILD 3,A07,192682,Butler; Shannon Rhey,20,0,32,12
1683687226892,BILD 4,A01,192836,Reuther; Keefe,1,0,24,23
1683687226892,BILD 4,A02,193044,Reuther; Keefe,4,0,24,20
1683687227919,BILD 10,A01,193142,Gustafson-Brown; Cindy,29,0,32,3
1683687227919,BILD 10,A02,193149,Gustafson-Brown; Cindy,31,0,32,1
1683687228947,BIMM 100,A01,193301,Staff,0,6,32,32
1683687228947,BIMM 100,A02,193312,Staff,0,7,32,32
1683687228947,BIMM 100,A03,193323,Staff,0,10,32,32
1683687229973,BIMM 101,A01,193329,McDonnell; Lisa Marie,1,4,24,23
1683687229973,BIMM 101,A02,193339,McDonnell; Lisa Marie,1,4,24,23
1683687229973,BIMM 101,B01,193354,McDonnell; Lisa Marie,0,4,24,24
1683687229973,BIMM 101,B02,193357,McDonnell; Lisa Marie,0,3,24,24
1683687231002,BIMM 110,A01,193377,Tat; John,0,11,32,32
1683687231002,BIMM 110,A02,193378,Tat; John,0,11,32,32
1683687232028,BIMM 120,A01,206116,Staff,0,0,32,32
1683687232028,BIMM 120,A02,206117,Staff,7,0,32,25
1683687232028,BIMM 120,A03,206121,Staff,21,0,32,11
1683687233052,BIPN 100,A01,193393,Park; Ji Young,0,15,32,32
1683687233052,BIPN 100,A02,193402,Park; Ji Young,0,14,32,32
1683687233052,BIPN 100,A03,193413,Park; Ji Young,0,14,32,32
1683687233052,BIPN 100,A04,193414,Park; Ji Young,0,13,32,32
1683687234078,BIPN 102,A01,193429,Staff,0,0,32,32
1683687234078,BIPN 102,A02,193438,Staff,18,0,32,14
1683687235102,BIPN 106,A01,193450,Reyes Gonzalez; Catalina,0,2,40,40
1683687236126,BIPN 134,A01,193465,Cooke; James Edward,0,0,32,32
1683687236126,BIPN 134,A02,193474,Cooke; James Edward,25,0,32,7
1683687236126,BIPN 134,A03,193485,Cooke; James Edward,29,0,32,3
1683687236126,BIPN 134,A04,193486,Cooke; James Edward,20,0,32,12
1683687236126,BIPN 134,A05,193491,Cooke; James Edward,31,0,32,1
1683687236126,BIPN 134,A06,193501,Cooke; James Edward,30,0,32,2
1683687236126,BIPN 134,A07,193510,Cooke; James Edward,29,0,32,3
1683687238177,BISP 194,A00,222522,Staff,14,0,32,18
1683687239204,CAT 124,A01,202407,Staff,19,0,25,6
1683687240231,CAT 125,A00,202408,Marchisotto; Jennifer Anne,2,0,20,18
1683687241253,CAT 125R,A00,202409,Smith; Lauryn Alissa,0,11,20,20
1683687241253,CAT 125R,B00,202410,Morales; Celeste Georgianna,0,11,20,20
1683687241253,CAT 125R,C00,202411,Irwin; Matthew Joseph,0,12,20,20
1683687242281,CENG 15,A01,204712,Yang; Kesong,0,1,0,0
1683687243311,CENG 114,A00,202070,Jahed Motlagh; Zeinab,5,0,20,15
1683687244334,CGS 105,A00,185477,Wesling; Megan E.,24,0,40,16
1683687245361,CGS 106,A00,185494,Staff,11,0,22,11
1683687246387,CGS 108,A00,185495,Staff,14,0,20,6
1683687247411,CGS 114,A00,185496,Staff,13,0,18,5
1683687248434,CGS 119,A00,185501,Staff,15,0,20,5
1683687249460,CGS 120,A00,185511,Staff,12,0,20,8
1683687250488,CHEM 4,A01,184675,Bussey; Thomas J,97,0,100,3
1683687251514,CHEM 6A,A01,184677,Staff,32,0,60,28
1683687252538,CHEM 6B,A01,184679,Staff,63,0,100,37
1683687253566,CHEM 6C,A01,184681,Bussey; Thomas J,0,0,50,50
1683687253566,CHEM 6C,A02,184682,Bussey; Thomas J,32,0,50,18
1683687254590,CHEM 40A,A01,184684,Albizati; Kim F.,33,0,100,67
1683687255614,CHEM 40B,A01,184686,Albizati; Kim F.,0,22,100,100
1683687256638,CHEM 41B,A01,184690,Staff,51,0,100,49
1683687257665,COGS 3,A01,184715,Boyle; Mary E. T.,0,27,40,40
1683687258689,COGS 14B,A01,185172,Staff,0,14,38,38
1683687259712,COGS 18,A01,184736,Staff,14,0,80,66
1683687260739,COGS 100,A01,184932,Staff,0,8,73,73
1683687261765,COGS 101A,A01,184935,Staff,0,40,30,30
1683687262792,COGS 101B,A01,184944,Staff,0,2,30,30
1683687263817,COGS 101C,A01,184946,Staff,0,10,30,30
1683687264844,COGS 102A,A01,184951,Johnson; Christine M.,1,0,40,39
1683687265867,COGS 107B,A01,184953,Mooshagian; Eric Frederick,0,52,40,40
1683687266890,COGS 118B,A01,184959,Gupta; Anjum,0,50,40,40
1683687267919,COGS 153,A00,184961,Staff,0,16,30,30
1683687268945,COGS 177,A00,184962,Staff,1,21,30,29
1683687269970,COGS 187A,A01,184969,Boyle; Mary E. T.,0,19,40,40
1683687270995,COMM 10,A01,185174,Staff,0,5,25,25
1683687270995,COMM 10,A02,185189,Staff,0,2,25,25
1683687270995,COMM 10,A03,269821,Staff,0,1,0,0
1683687272022,COMM 100B,A02,185476,Staff,10,0,25,15
1683687272022,COMM 100B,A03,277340,Staff,25,0,25,0
1683687273046,COMM 100C,A01,185314,Staff,1,0,25,24
1683687273046,COMM 100C,A02,185327,Staff,17,0,25,8
1683687274073,COMM 110M,A00,185349,Staff,0,0,40,40
1683687275096,COMM 113T,A00,185352,Staff,25,0,40,15
1683687276122,COMM 114I,A00,185353,Staff,31,0,40,9
1683687277146,COMM 131,A00,185354,Staff,17,0,30,13
1683687278170,CSE 8A,A50,185358,Cao; Yingjun,0,46,10,10
1683687279194,CSE 8B,A01,185362,Staff,0,48,50,50
1683687280220,CSE 11,A01,185416,Cao; Yingjun,0,91,10,10
1683687281246,CSE 20,A01,185445,Briones; Jor-el Thomas Caparas,3,0,25,22
1683687282270,CSE 21,A01,185447,Staff,9,0,50,41
1683687283296,CSE 101,A01,185451,Staff,0,13,50,50
1683687283296,CSE 101,B01,185453,Jones; Miles E,0,14,50,50
1683687285342,CSE 141,A01,185458,Eldon; John,16,0,100,84
1683687286368,CSE 141L,A01,185461,Eldon; John,8,0,100,92
1683687287451,CSE 142,A01,185463,Staff,34,0,60,26
1683687287451,CSE 142,B01,201355,Staff,0,7,60,60
1683687288478,CSE 142L,A01,185470,Staff,34,0,60,26
1683687288478,CSE 142L,B01,201417,Staff,0,6,60,60
1683687289502,CSE 190,A00,201433,Staff,32,0,49,17
1683687290530,DOC 1,A01,259136,Strom; Megan C.,7,0,15,8
1683687290530,DOC 1,A02,259137,Strom; Megan C.,14,0,15,1
1683687290530,DOC 1,A03,259138,Strom; Megan C.,14,0,15,1
1683687290530,DOC 1,A04,259139,Strom; Megan C.,14,0,15,1
1683687291557,DOC 100D,A00,259140,Pass; Natalye Joann,14,0,25,11
1683687292581,DSGN 1,A01,184749,Rill; Bryan,0,26,30,30
1683687293608,DSGN 100,A01,185168,Staff,0,2,25,25
1683687294632,ECE 5,A01,185626,Morris; Karcher William,0,12,0,0
1683687295656,ECE 101,A01,185628,Staff,14,0,70,56
1683687296680,ECE 107,A01,185635,Baghdadchi; Saharnaz,0,0,20,20
1683687296680,ECE 107,A02,185638,Baghdadchi; Saharnaz,1,0,20,19
1683687297705,ECE 148,A01,185647,Silberman; Jack,0,0,16,16
1683687298732,ECON 1,A01,185537,Crane; Meredith Helen,54,0,70,16
1683687299759,ECON 3,A01,185549,Crane; Meredith Helen,30,0,70,40
1683687300782,ECON 4,A01,203354,Anderson; John Charles,0,5,10,10
1683687301810,ECON 100A,A01,185574,Staff,0,5,40,40
1683687302834,ECON 100B,A01,185576,Staff,0,12,50,50
1683687303862,ECON 100C,A01,185589,Newhouse; Herbert S,30,0,70,40
1683687304888,ECON 105,A00,185608,Vespa; Emanuel Ignacio,19,0,35,16
1683687305914,ECON 109,A01,185610,Shishkin; Denis,9,0,35,26
1683687306938,ECON 110A,A01,185612,Staff,8,0,40,32
1683687307964,ECON 120A,A01,185615,Staff,19,0,40,21
1683687308988,ECON 120C,A01,185617,Sun; Yixiao,0,21,70,70
1683687310017,ECON 144,A00,203346,Squires; Dale E,2,0,35,33
1683687311045,ECON 171,A01,203349,Newhouse; Herbert S,0,1,35,35
1683687312069,ECON 173A,A01,185621,Toda; Alexis Akira,21,0,35,14
1683687313099,EDS 25,A01,202413,Staff,0,1,0,0
1683687313099,EDS 25,A02,202414,Staff,0,1,0,0
1683687313099,EDS 25,A03,202415,Staff,0,0,0,0
1683687313099,EDS 25,A04,202416,Staff,0,1,0,0
1683687313099,EDS 25,A05,202439,Staff,0,0,0,0
1683687313099,EDS 25,A06,202440,Staff,0,0,0,0
1683687313099,EDS 25,B01,202631,Staff,0,0,0,0
1683687313099,EDS 25,B02,202632,Staff,0,0,0,0
1683687313099,EDS 25,B03,202639,Staff,0,0,0,0
1683687313099,EDS 25,B04,202640,Staff,0,0,0,0
1683687313099,EDS 25,B05,202643,Staff,0,0,0,0
1683687313099,EDS 25,B06,202644,Staff,0,0,0,0
1683687314125,EDS 38,A01,202659,Black; Alison Michelle,24,0,25,1
1683687315151,EDS 115,A00,202652,Staff,18,0,30,12
1683687316174,EDS 125,A00,202649,Staff,13,0,30,17
1683687317198,EDS 126,A01,203332,Staff,30,0,30,0
1683687318223,EDS 139,A00,202838,Staff,16,0,25,9
1683687319246,EDS 146,A01,202655,Staff,14,0,25,11
1683687320281,ENG 15,A00,185667,Staff,0,1,0,0
1683687320281,ENG 15,B00,185672,Staff,0,0,0,0
1683687320281,ENG 15,C00,185675,Staff,0,0,0,0
1683687320281,ENG 15,D00,185682,Staff,0,0,0,0
1683687320281,ENG 15,E00,185684,Staff,0,0,0,0
1683687321311,ETHN 103,A00,185710,Staff,0,8,35,35
1683687322339,ETHN 103A,A00,199228,Man; Simeon S,0,0,9,9
1683687323366,ETHN 109,A00,185711,Staff,15,0,35,20
1683687324389,ETHN 142,A00,185726,Staff,0,4,30,30
1683687325415,ETHN 163J,A00,199229,Man; Simeon S,5,0,8,3
1683687326439,ETHN 168,A00,185727,Staff,7,0,10,3
1683687327466,ETHN 182,A00,185728,Staff,0,0,35,35
1683687328492,ETHN 183,A00,185737,Staff,9,0,18,9
1683687329518,GLBH 111,A01,209361,Burgos; Jose L.,0,0,0,0
1683687331569,HIEU 104,A00,185792,Staff,14,0,20,6
1683687332594,HIEU 115,A00,185800,Staff,0,0,20,20
1683687333619,HIEU 128,A00,185801,Staff,0,9,20,20
1683687334643,HIEU 147,A00,185802,Staff,15,0,20,5
1683687335667,HIEU 154,A00,185823,Staff,11,0,20,9
1683687336692,HILA 102,A00,185826,Staff,14,0,20,6
1683687337719,HILD 2C,A01,185778,Staff,0,13,20,20
1683687338747,HILD 7B,A01,185780,Kwak; Nancy,0,17,32,32
1683687338747,HILD 7B,A02,185781,Kwak; Nancy,0,18,32,32
1683687339770,HILD 30,A01,185791,Staff,12,0,20,8
1683687340797,HISC 119,A00,185830,Golan; Tal,0,10,20,20
1683687341823,HITO 156GS,A00,185831,Patterson; Patrick H.,0,0,0,23
1683687342847,HIUS 103,A00,185832,Man; Simeon S,0,4,20,20
1683687343871,HIUS 117,A00,185836,Kwak; Nancy,2,0,20,18
1683687344895,HIUS 125,A00,185840,Man; Simeon S,0,2,23,23
1683687345922,HIUS 149,A00,185845,Staff,1,0,20,19
1683687346947,HUM 3,A01,185882,Zavodny; Tatiana Sophia,0,8,50,50
1683687346947,HUM 3,B01,185899,Caldwell; Michael Alan,0,18,50,50
1683687347971,HUM 3GS,A00,185900,Patterson; Patrick H.,0,0,0,23
1683687348995,HUM 4,A01,185938,Zroka; Amy Liane,28,0,50,22
1683687348995,HUM 4,B01,185956,Watkins; Eric,0,6,50,50
1683687348995,HUM 4,B02,202209,Watkins; Eric,0,5,50,50
1683687348995,HUM 4,B03,202210,Watkins; Eric,0,5,50,50
1683687350019,HUM 5,A01,185958,West; Geoffrey Scott,0,0,50,50
1683687350019,HUM 5,A02,202215,West; Geoffrey Scott,0,0,50,50
1683687351044,INTL 190,A00,185959,Gagnon; Jeffrey C,0,0,0,9
1683687351044,INTL 190,B00,185960,Lettieri; Michael Joseph,0,0,0,2
1683687352068,JAPN 180,A00,254509,Staff,5,0,30,25
1683687353092,LATI 10,A01,202853,Kennemore; Amy Michelle,4,0,35,31
1683687353092,LATI 10,A02,202854,Kennemore; Amy Michelle,3,0,35,32
1683687353092,LATI 10,A03,270054,Kennemore; Amy Michelle,30,0,30,0
1683687354116,LATI 180,A00,202855,Kennemore; Amy Michelle,11,0,20,9
1683687355143,LAWS 101,A00,201767,Golan; Tal,0,7,40,40
1683687356169,LIFR 1C,A00,185961,Staff,6,0,20,14
1683687357194,LIFR 1CX,A00,185962,Staff,7,0,20,13
1683687358215,LIFR 1D,A00,185963,Staff,7,0,20,13
1683687359239,LIFR 1DX,A00,185964,Staff,7,0,20,13
1683687360265,LIGN 101,A01,186039,Staff,43,0,50,7
1683687361288,LIGN 165,A00,186040,Staff,15,0,50,35
1683687362315,LTCS 108,A00,186041,Staff,5,0,10,5
1683687363341,LTCS 119,A00,186042,Staff,15,0,20,5
1683687364363,LTCS 130,A00,186043,Wesling; Megan E.,15,0,25,10
1683687366409,LTEA 138,A00,186119,Staff,14,0,40,26
1683687367434,LTEN 124,A00,186148,Staff,5,0,25,20
1683687368462,LTEN 178,A00,186149,Staff,6,0,15,9
1683687369488,LTEN 181,A00,186150,Blanco; John D,34,0,40,6
1683687370514,LTWL 120,A00,186160,Staff,19,0,25,6
1683687371539,LTWL 165,A00,186161,Staff,22,0,25,3
1683687372564,LTWR 100,A00,186162,Staff,0,5,15,15
1683687373588,LTWR 102,A00,186163,Doller; Ben,5,0,15,10
1683687374615,MAE 8,A01,186412,Staff,0,1,0,0
1683687375639,MAE 30B,A00,186445,Bahadori; Mohammad Yousef,81,0,100,19
1683687376663,MAE 40,A00,186592,Bewley; Thomas R,10,0,50,40
1683687377690,MAE 101B,A00,186593,Bahadori; Mohammad Yousef,80,0,100,20
1683687378715,MAE 105,A00,186594,Bandaru; Prabhakar,10,0,50,40
1683687379738,MAE 107,A00,186599,Pham; Hieu Tan,0,7,120,120
1683687380762,MAE 148,A01,186660,Silberman; Jack,3,0,16,13
1683687381789,MATH 10A,A01,188095,Staff,0,6,35,35
1683687382817,MATH 10B,A01,188097,Bowers; Adam R.,0,12,30,30
1683687382817,MATH 10B,A02,188099,Bowers; Adam R.,0,11,30,30
1683687382817,MATH 10B,B01,188104,Bowers; Adam R.,0,10,30,30
1683687382817,MATH 10B,B02,188106,Bowers; Adam R.,1,9,30,29
1683687383843,MATH 10C,A01,188111,Staff,0,20,30,30
1683687383843,MATH 10C,A02,188127,Staff,0,19,30,30
1683687383843,MATH 10C,A03,188131,Staff,0,19,30,30
1683687383843,MATH 10C,B01,188218,Staff,17,0,30,13
1683687383843,MATH 10C,B02,188244,Staff,13,0,30,17
1683687383843,MATH 10C,B03,188277,Staff,14,0,30,16
1683687384868,MATH 18,A01,188344,Bach; Quang Tran,18,0,30,12
1683687384868,MATH 18,A02,188345,Bach; Quang Tran,11,0,30,19
1683687384868,MATH 18,B01,188353,Bach; Quang Tran,11,0,30,19
1683687384868,MATH 18,B02,188354,Bach; Quang Tran,19,0,30,11
1683687385892,MATH 20A,A01,188374,Staff,11,0,35,24
1683687386920,MATH 20B,A01,188382,Ohm; Ko Woon,7,0,30,23
1683687386920,MATH 20B,A02,188383,Ohm; Ko Woon,22,0,30,8
1683687386920,MATH 20B,B01,188385,Ohm; Ko Woon,7,0,30,23
1683687386920,MATH 20B,B02,188392,Ohm; Ko Woon,22,0,30,8
1683687387945,MATH 20C,A01,188394,Harel; Guershon,10,0,30,20
1683687387945,MATH 20C,A02,188395,Harel; Guershon,13,0,30,17
1683687387945,MATH 20C,B01,188404,Harel; Guershon,5,0,30,25
1683687387945,MATH 20C,B02,188405,Harel; Guershon,18,0,30,12
1683687388968,MATH 20D,A01,188414,Hammock; Frances H,0,1,30,30
1683687388968,MATH 20D,A02,188415,Hammock; Frances H,0,1,30,30
1683687388968,MATH 20D,B01,188447,Hammock; Frances H,0,1,30,30
1683687388968,MATH 20D,B02,188486,Hammock; Frances H,2,0,30,28
1683687389993,MATH 20E,A01,188649,Staff,21,0,30,9
1683687389993,MATH 20E,A02,188650,Staff,20,0,30,10
1683687389993,MATH 20E,A03,188673,Staff,0,0,30,30
1683687391076,MATH 102,A01,188675,Staff,0,40,35,35
1683687392099,MATH 103B,A01,188681,Staff,3,0,35,32
1683687392099,MATH 103B,B01,188692,Staff,5,0,35,30
1683687393122,MATH 109,A01,188695,Salehi Golsefidy; Alireza,24,0,35,11
1683687393122,MATH 109,A02,188696,Salehi Golsefidy; Alireza,25,0,35,10
1683687394146,MATH 120A,A01,188698,Eggers; John Dietrich,7,0,35,28
1683687395175,MATH 142B,A01,188736,Ioana; Adrian,1,1,30,29
1683687395175,MATH 142B,A02,188741,Ioana; Adrian,0,1,30,30
1683687395175,MATH 142B,A03,188743,Ioana; Adrian,0,2,30,30
1683687396197,MATH 168A,A01,188790,Staff,0,11,35,35
1683687397221,MATH 170A,A01,188803,Nie; Jiawang,0,2,35,35
1683687397221,MATH 170A,A02,188811,Nie; Jiawang,0,1,35,35
1683687397221,MATH 170A,A03,188814,Nie; Jiawang,0,0,35,35
1683687397221,MATH 170A,A04,188815,Nie; Jiawang,5,0,35,30
1683687398245,MATH 193B,A01,188817,Staff,0,0,35,35
1683687398245,MATH 193B,A02,188818,Staff,6,0,35,29
1683687399270,MGT 4,A01,202857,Anderson; John Charles,59,0,80,21
1683687400295,MGT 12,A00,202858,Lindenberger; Wade Douglas,40,0,90,50
1683687401319,MGT 18,A00,202859,Staff,74,0,90,16
1683687402346,MGT 18GS,A00,202860,McKay; Michael J,13,0,28,15
1683687403370,MGT 45,A00,202861,Pecore; Joseph P.,8,0,90,82
1683687404395,MGT 100,A00,202863,Yavorsky; Daniel Ryan,27,0,90,63
1683687405419,MGT 103,A00,202864,Ehrich; Kristine R,0,19,90,90
1683687406444,MGT 112,A00,202865,Ehrich; Kristine R,15,0,90,75
1683687407468,MGT 121A,A00,202868,Staff,90,20,90,0
1683687408495,MGT 131B,A00,202869,Anderson; John Charles,59,0,90,31
1683687409520,MGT 136,A00,202871,Lindenberger; Wade Douglas,83,0,90,7
1683687410545,MGT 164,A00,202873,Staff,0,67,90,91
1683687411570,MGT 164GS,A00,202874,McKay; Mary A,13,0,28,15
1683687412599,MGT 180,A00,202875,Staff,0,51,90,91
1683687413624,MMW 11R,A01,205019,Herbst; Matthew,0,0,30,30
1683687413624,MMW 11R,A02,205026,Herbst; Matthew,29,0,30,1
1683687414653,MMW 15,A01,193512,Chang; Edmond Yi-Teh,0,8,28,28
1683687414653,MMW 15,A02,193513,Chang; Edmond Yi-Teh,0,5,28,28
1683687414653,MMW 15,A03,193514,Chang; Edmond Yi-Teh,0,5,28,28
1683687414653,MMW 15,A04,193515,Chang; Edmond Yi-Teh,0,5,28,28
1683687414653,MMW 15,A05,193516,Chang; Edmond Yi-Teh,0,5,28,28
1683687414653,MMW 15,A06,193517,Chang; Edmond Yi-Teh,0,6,28,28
1683687414653,MMW 15,B01,193519,Chang; Edmond Yi-Teh,0,5,28,28
1683687414653,MMW 15,B02,193520,Chang; Edmond Yi-Teh,0,5,28,28
1683687414653,MMW 15,B03,193521,Chang; Edmond Yi-Teh,0,5,28,28
1683687414653,MMW 15,B04,193522,Chang; Edmond Yi-Teh,0,6,28,28
1683687414653,MMW 15,B05,193523,Chang; Edmond Yi-Teh,0,5,28,28
1683687414653,MMW 15,B06,193524,Chang; Edmond Yi-Teh,0,5,28,28
1683687415679,MMW 122,A01,193526,Rahimi; Babak,0,16,28,28
1683687415679,MMW 122,A02,193527,Rahimi; Babak,0,15,28,28
1683687415679,MMW 122,A03,193528,Rahimi; Babak,0,0,0,0
1683687415679,MMW 122,A04,193529,Rahimi; Babak,0,0,0,0
1683687416704,MUS 1A,A01,186663,Staff,1,19,35,34
1683687417729,MUS 4,A01,186715,Staff,0,12,35,35
1683687418754,MUS 5R,A01,186796,Dubnov; Shlomo,0,17,35,35
1683687419781,MUS 6,A01,186798,Staff,1,5,25,24
1683687420805,MUS 7,A01,186830,Staff,11,0,35,24
1683687421830,MUS 8,A01,186930,Staff,0,27,35,35
1683687422857,MUS 15,A01,186932,Staff,0,15,35,35
1683687422857,MUS 15,B01,186934,Staff,1,17,35,34
1683687423887,MUS 80,A00,186935,Staff,0,0,20,20
1683687423887,MUS 80,B00,186936,Staff,24,0,25,1
1683687424914,NANO 11,A00,204702,Lipomi; Darren John,0,0,0,0
1683687425945,NANO 15,A01,204709,Yang; Kesong,0,1,0,0
1683687426969,NANO 114,A00,202069,Jahed Motlagh; Zeinab,2,0,10,8
1683687427994,PHIL 1,A00,186955,Grush; Rick Scott,31,0,40,9
1683687429019,PHIL 10,A01,186973,Grush; Rick Scott,27,0,35,8
1683687429019,PHIL 10,A02,186974,Grush; Rick Scott,33,0,35,2
1683687430044,PHIL 13,A01,186976,Staff,1,0,35,34
1683687430044,PHIL 13,A02,186977,Staff,16,0,35,19
1683687431074,PHIL 14,A01,186979,Staff,31,0,35,4
1683687431074,PHIL 14,A02,186986,Staff,32,0,35,3
1683687432107,PHIL 28,A01,186988,Staff,16,0,30,14
1683687432107,PHIL 28,A02,186989,Staff,1,0,30,29
1683687432107,PHIL 28,A03,186990,Staff,10,0,30,20
1683687432107,PHIL 28,A04,186991,Staff,26,0,30,4
1683687433130,PHIL 120,A00,186997,Staff,23,0,40,17
1683687434155,PHIL 137,A00,187003,Staff,7,0,40,33
1683687435180,PHIL 150,A00,187015,Staff,47,0,70,23
1683687436204,PHIL 167,A00,187021,Lamey; Andy M.,34,0,40,6
1683687437228,PHIL 174,A01,202226,Staff,17,0,20,3
1683687437228,PHIL 174,A02,202235,Staff,20,0,20,0
1683687438255,PHIL 191A,A00,258918,Staff,0,0,1,1
1683687439281,PHYS 1A,A00,187028,Staff,26,0,60,34
1683687440307,PHYS 1AL,001,187036,Staff,3,0,30,27
1683687440307,PHYS 1AL,002,187049,Staff,18,0,30,12
1683687441334,PHYS 1B,A00,187058,Staff,22,0,60,38
1683687442360,PHYS 1BL,001,187064,Staff,0,1,30,30
1683687442360,PHYS 1BL,002,187070,Staff,4,0,30,26
1683687443384,PHYS 1C,A00,187082,Staff,29,0,120,91
1683687444409,PHYS 1CL,001,187088,Staff,0,9,30,30
1683687444409,PHYS 1CL,002,187089,Staff,0,1,30,30
1683687444409,PHYS 1CL,009,262693,Staff,9,0,30,21
1683687445434,PHYS 2B,A01,187097,Staff,55,0,115,60
1683687446458,PHYS 2C,A01,187099,Staff,63,0,115,52
1683687447483,PHYS 2CL,A01,187101,Staff,5,0,28,23
1683687447483,PHYS 2CL,A02,187102,Staff,15,0,28,13
1683687448512,PHYS 2D,A01,187123,Shotwell; Brian,95,0,115,20
1683687449536,PHYS 4B,A01,187133,Grinstein; Benjamin,35,0,50,15
1683687450562,POLI 10,A00,188819,Staff,0,4,50,50
1683687451586,POLI 11,A00,188827,Staff,43,0,50,7
1683687452612,POLI 13R,A00,188828,Staff,0,1,20,20
1683687453637,POLI 27,A01,188830,Elgin; Samuel Zincke,0,2,70,70
1683687454661,POLI 30,A00,188832,Desposato; Scott,30,0,50,20
1683687455685,POLI 102F,A00,188834,Staff,1,0,40,39
1683687456710,POLI 104A,A00,188852,Staff,12,0,30,18
1683687457734,POLI 104I,A00,188853,Staff,0,8,20,20
1683687458757,POLI 110B,A00,188854,Wiens; David,6,0,20,14
1683687459782,POLI 112A,A00,188855,Wiens; David,3,0,30,27
1683687460809,POLI 117R,A00,188856,Forman; Fonna,0,12,20,20
1683687461834,POLI 118,A00,188857,Ingham; Sean,8,0,20,12
1683687462858,POLI 120G,A00,188858,Staff,8,0,30,22
1683687463882,POLI 131CR,A00,188863,Hoston; Germaine,20,0,50,30
1683687464909,POLI 133,A00,188864,Nellis; Gareth Hb,44,0,50,6
1683687465934,POLI 134D,A00,188865,Desposato; Scott,27,0,30,3
1683687466959,POLI 142A,A00,188871,Gartzke; Erik,21,0,50,29
1683687467986,POLI 142K,A00,188874,Staff,38,0,50,12
1683687469016,POLI 143,A00,188940,Gartzke; Erik,16,0,30,14
1683687470040,POLI 153,A00,188943,Staff,2,0,20,18
1683687471069,POLI 160AA,A00,188944,Staff,10,0,40,30
1683687472100,POLI 170A,A00,188945,Staff,10,0,30,20
1683687474147,PSYC 1,A00,188952,Staff,36,0,90,54
1683687475171,PSYC 2,B00,188953,Staff,19,0,35,16
1683687476194,PSYC 6,A00,188970,Staff,47,0,60,13
1683687477222,PSYC 7,A00,188973,Staff,35,0,45,10
1683687478248,PSYC 60,A01,188980,Rickard; Timothy C.,42,0,60,18
1683687479274,PSYC 70,A01,189001,Steiner; Eric Tomas,21,0,45,24
1683687480301,PSYC 100,A00,189005,Lacefield; Katharine I,0,99,120,120
1683687481328,PSYC 102,A00,189008,Staff,7,0,30,23
1683687482356,PSYC 106,B00,189026,Gorman; Michael R.,27,0,60,33
1683687483381,PSYC 114,B01,189033,Winkielman; Piotr,0,31,30,30
1683687484404,PSYC 131,A00,189036,Anagnostaras; Stephan,0,43,60,60
1683687485426,PSYC 136,A00,189041,Lowe; Angela Beth,0,7,25,25
1683687486449,PSYC 137,A00,189057,Winkielman; Piotr,1,37,25,24
1683687487478,PSYC 144,A00,189107,Wixted; John T,0,11,50,50
1683687489528,PSYC 162,A00,189142,Staff,0,9,85,85
1683687490552,PSYC 172,A00,189144,Gorman; Michael R.,0,6,30,30
1683687492604,PSYC 179,A00,189146,Lacefield; Katharine I,0,87,120,120
1683687493632,PSYC 181,A00,189147,Anagnostaras; Stephan,0,44,90,90
1683687494728,PSYC 190R,A00,189148,Barner; David A.,0,23,80,80
1683687495752,PSYC 191,A00,189275,Rickard; Timothy C.,0,10,25,25
1683687496776,PSYC 193,A00,189276,Chapman; Eddie Nathaniel,0,1,0,4
1683687497801,PSYC 193L,A01,189281,Lowe; Angela Beth,8,0,20,12
1683687497801,PSYC 193L,B01,189285,Staff,28,0,35,7
1683687498829,RELI 149,A00,187137,Rahimi; Babak,6,0,40,34
1683687499856,SE 9,A01,187315,Staff,0,2,18,18
1683687500879,SE 101B,A00,187409,Staff,24,0,30,6
1683687501907,SE 110B,A00,187444,Staff,10,0,40,30
1683687502935,SE 130B,A00,187449,Staff,31,0,40,9
1683687503959,SE 150A,A00,187516,Staff,8,0,20,12
1683687504997,SE 154,A00,187528,Staff,29,0,50,21
1683687506022,SIO 3,A01,258171,Staff,35,0,40,5
1683687507046,SIO 10,A00,187144,Cook; Geoffrey W,1,7,75,74
1683687508073,SIO 45,A00,187152,Cook; Geoffrey W,0,7,100,100
1683687509100,SIO 109R,A00,194486,Staff,0,4,20,20
1683687511147,SIO 187,A01,187233,Kacev; David,12,0,40,28
1683687512172,SOCI 1,A01,258656,Thorpe; Charles Robert,28,0,30,2
1683687512172,SOCI 1,A02,258658,Thorpe; Charles Robert,30,0,30,0
1683687512172,SOCI 1,A03,258661,Thorpe; Charles Robert,25,0,25,0
1683687512172,SOCI 1,A04,258666,Thorpe; Charles Robert,22,0,25,3
1683687512172,SOCI 1,A05,258897,Thorpe; Charles Robert,22,0,25,3
1683687512172,SOCI 1,A06,258898,Thorpe; Charles Robert,25,0,25,0
1683687513200,SOCI 30,A01,258903,Pardo Guerra; Juan Pablo,14,0,30,16
1683687514222,SOCI 102,A00,258904,Staff,9,0,25,16
1683687515249,SOCI 106,A00,258905,Staff,19,0,25,6
1683687516273,SOCI 111,A00,258907,Ribas Norris; Janet Vanesa,26,0,30,4
1683687517298,SOCI 121R,A00,258908,Pardo Guerra; Juan Pablo,8,0,30,22
1683687518323,SOCI 126,A01,203330,Staff,14,0,20,6
1683687519351,SOCI 131,A00,258909,Thorpe; Charles Robert,30,0,60,30
1683687520378,SOCI 135,A00,258910,Payne; Christine Anna,0,12,30,30
1683687521401,SOCI 157,A00,258911,Staff,11,0,30,19
1683687522426,SOCI 184,A00,258912,Staff,25,0,30,5
1683687523454,SOCI 188D,A00,258913,Staff,22,0,30,8
1683687524478,SYN 2,001,187529,Staff,9,0,16,7
1683687524478,SYN 2,002,201452,Staff,1,20,16,15
1683687524478,SYN 2,003,201469,Staff,1,0,16,15
1683687525503,SYN 100,A01,187531,Staff,0,9,20,20
1683687525503,SYN 100,B01,201491,Staff,0,10,20,20
1683687526542,TDAC 1,A00,189286,Walsh; Kim C.,3,0,20,17
1683687526542,TDAC 1,B00,189287,Harting; Carla Kelso,10,0,20,10
1683687527569,TDAC 101,A00,189300,Walsh; Kim C.,16,0,20,4
1683687527569,TDAC 101,B00,189301,Harting; Carla Kelso,18,0,20,2
1683687528594,TDAC 102,A00,189304,Basso; Beatrice,14,0,20,6
1683687529620,TDAC 108,A00,189305,Staff,18,0,20,2
1683687530650,TDDE 131,A00,189310,Staff,19,0,20,1
1683687530650,TDDE 131,B00,189314,Staff,19,0,20,1
1683687530650,TDDE 131,C00,189315,Staff,48,0,50,2
1683687530650,TDDE 131,D00,189316,Staff,14,0,15,1
1683687530650,TDDE 131,E00,204841,Staff,20,0,20,0
1683687531675,TDGE 10,A00,189289,Staff,27,0,50,23
1683687531675,TDGE 10,B00,189290,Havis; Allan,0,1,50,50
1683687532700,TDGE 11,A00,189291,Fulton; Julia,0,4,50,50
1683687532700,TDGE 11,B00,189292,Staff,20,0,25,5
1683687532700,TDGE 11,C00,260270,Staff,0,0,0,0
1683687533724,TDGE 25,A00,189294,Staff,1,0,20,19
1683687534750,TDGE 124,A00,189318,Fulton; Julia,1,8,50,49
1683687535777,TDGE 125,A00,189319,Staff,13,0,25,12
1683687535777,TDGE 125,B00,189320,Staff,23,0,25,2
1683687536803,TDGE 127,A00,189322,Havis; Allan,0,0,50,50
1683687537827,TDHT 101,A00,189323,Staff,18,0,25,7
1683687537827,TDHT 101,B00,189324,Staff,25,0,25,0
1683687538850,TDHT 102,A00,189325,Staff,49,0,50,1
1683687539874,TDMV 1,A00,189295,Arcidiacono; Kristin,20,0,30,10
1683687539874,TDMV 1,B00,189296,Caligagan; Maria T.,24,0,30,6
1683687540900,TDMV 2,A00,189297,Sammartano; Tonnie,27,0,30,3
1683687540900,TDMV 2,B00,189299,Arcidiacono; Kristin,23,0,30,7
1683687541927,TDMV 3,A00,204998,Rincon; Alicia,22,0,30,8
1683687542953,TDMV 120,A00,189458,Sammartano; Tonnie,28,0,30,2
1683687543979,TDMV 138,A00,189541,Jun; Grace Shin Hae,20,0,40,20
1683687545004,TDMV 142,A00,189717,Caligagan; Tony,25,0,30,5
1683687545004,TDMV 142,B00,189718,Caligagan; Maria T.,25,0,30,5
1683687546027,TMC 2,A01,187533,Staff,25,0,25,0
1683687546027,TMC 2,A02,187534,Staff,25,0,25,0
1683687547050,USP 1,A01,187536,Kwak; Nancy,0,16,25,25
1683687548076,USP 5,A01,187538,Staff,8,0,25,17
1683687549099,USP 101,A00,199253,Staff,0,4,0,0
1683687550124,USP 124,A00,187562,Boomhower; Matthew Charles,0,0,30,30
1683687551152,USP 138,A00,187582,Staff,19,0,25,6
1683687552187,USP 152,A01,187597,Staff,3,0,25,22
1683687553220,USP 153,A00,187598,Staff,18,0,25,7
1683687554248,USP 168,A00,187607,Kwak; Nancy,2,0,5,3
1683687555271,USP 173,A00,187619,Staff,4,0,25,21
1683687556294,USP 181,A00,187638,Staff,0,4,25,25
1683687557317,VIS 103,A00,187650,Cruz; Edwin Teddy,17,0,75,58
1683687558342,VIS 110D,A00,187669,Staff,13,0,22,9
1683687559366,VIS 127C,A00,187720,Shen; Kuiyi,67,0,146,79
1683687560390,VIS 149,A00,187731,Yoldas; Pinar,1,14,22,21
1683687561414,VIS 151,A01,188091,Staff,22,0,34,12
1683687561414,VIS 151,A02,188092,Staff,11,0,34,23
1683687562438,VIS 160B,A00,188093,Stalbaum; Brett,0,1,10,10
1683687564488,WCWP 10B,A00,201720,Staff,0,0,5,5
1683687564488,WCWP 10B,B00,201722,Staff,0,0,6,6
1683687565512,WCWP 100,A00,201725,Gagnon; Jeffrey C,0,0,2,2
1683687565512,WCWP 100,B00,201727,Staff,0,4,15,15
1683687568611,ANBI 133,A00,258401,Wilder; Linnea Lorene,34,0,40,6
1683687569635,ANBI 140,A00,258395,Hrvoj Mihic; Branka,18,0,25,7
1683687570662,ANSC 120,A00,258402,Bialecki; Jon Anthony,26,0,40,14
1683687571686,ANSC 144,A00,258400,Staff,12,0,40,28
1683687573736,ANSC 166,A00,258396,Parish; Steven Martin,156,0,175,19
1683687574760,ANSC 180,A00,193533,Staff,8,0,20,12
1683687575790,ANSC 188,A00,258397,Jassal; Aftab,34,0,40,6
1683687576816,ANTH 3,A01,258316,Staff,23,0,30,7
1683687577841,ANTH 5,A00,258394,Semendeferi; Ekaterini,16,0,20,4
1683687578868,ANTH 21,A01,258331,Staff,4,0,40,36
1683687579892,ANTH 103,A00,258398,Varma; Saiba,15,0,25,10
1683687580916,AWP 10,001,202034,Staff,0,0,0,0
1683687580916,AWP 10,002,202035,Staff,0,0,0,0
1683687580916,AWP 10,003,202036,Staff,0,0,0,0
1683687580916,AWP 10,004,202037,Staff,0,0,0,0
1683687580916,AWP 10,005,202038,Staff,0,0,0,0
1683687580916,AWP 10,006,202039,Staff,0,0,0,0
1683687580916,AWP 10,007,202040,Staff,0,0,0,0
1683687580916,AWP 10,008,202041,Staff,0,0,0,0
1683687580916,AWP 10,009,202042,Staff,0,0,0,0
1683687580916,AWP 10,010,202043,Staff,0,0,0,0
1683687580916,AWP 10,011,202044,Staff,0,0,0,0
1683687580916,AWP 10,012,202045,Staff,0,0,0,0
1683687580916,AWP 10,013,202046,Staff,0,0,0,0
1683687580916,AWP 10,014,202047,Staff,0,0,0,0
1683687580916,AWP 10,015,202048,Staff,0,0,0,0
1683687580916,AWP 10,016,202049,Staff,0,0,0,0
1683687580916,AWP 10,017,202050,Staff,0,0,0,0
1683687580916,AWP 10,018,202051,Staff,0,0,0,0
1683687580916,AWP 10,019,202052,Staff,0,0,0,0
1683687580916,AWP 10,020,202053,Staff,0,0,0,0
1683687580916,AWP 10,021,202054,Staff,0,0,0,0
1683687580916,AWP 10,022,202055,Staff,0,0,0,0
1683687580916,AWP 10,023,202056,Staff,0,0,0,0
1683687580916,AWP 10,024,202057,Staff,0,0,0,0
1683687580916,AWP 10,025,202058,Staff,0,0,0,0
1683687580916,AWP 10,026,202059,Staff,0,0,0,0
1683687581940,AWP 102,001,202032,Staff,0,0,0,0
1683687581940,AWP 102,002,202033,Staff,0,0,0,0
1683687582965,BENG 100,A01,254234,Taylor Amos; Alyssa C,31,0,40,9
1683687583990,BENG 196,001,270013,Engler; Adam J.,9999,0,9999,0
1683687585015,BICD 100R,A01,202018,Smith; Laurie,0,7,32,32
1683687585015,BICD 100R,A02,202019,Smith; Laurie,0,3,32,32
1683687585015,BICD 100R,A03,202020,Smith; Laurie,0,1,32,32
1683687585015,BICD 100R,A04,202021,Smith; Laurie,6,0,32,26
1683687585015,BICD 100R,A05,202022,Smith; Laurie,10,0,32,22
1683687586039,BICD 136,A01,193242,Gustafson-Brown; Cindy,0,2,32,32
1683687586039,BICD 136,A02,193244,Gustafson-Brown; Cindy,13,0,32,19
1683687587064,BIEB 102,A01,193249,Butler; Shannon Rhey,1,1,32,31
1683687587064,BIEB 102,A02,193251,Butler; Shannon Rhey,0,0,32,32
1683687587064,BIEB 102,A03,193253,Butler; Shannon Rhey,0,0,32,32
1683687587064,BIEB 102,A04,193255,Butler; Shannon Rhey,13,0,32,19
1683687587064,BIEB 102,A05,193265,Butler; Shannon Rhey,25,0,32,7
1683687587064,BIEB 102,A06,193269,Butler; Shannon Rhey,13,0,32,19
1683687589115,BIEB 150,A01,193274,Staff,0,0,32,32
1683687589115,BIEB 150,A02,193285,Staff,24,0,32,8
1683687590144,BIEB 194,A00,193286,Kurle; Carolyn M.,19,0,32,13
1683687591169,BILD 1,A01,192291,Staff,15,0,32,17
1683687591169,BILD 1,A02,192292,Staff,30,0,32,2
1683687591169,BILD 1,B01,192520,Reuther; Keefe,0,1,0,0
1683687591169,BILD 1,B02,192532,Reuther; Keefe,0,1,0,0
1683687592202,BILD 3,A01,192556,Butler; Shannon Rhey,0,0,32,32
1683687592202,BILD 3,A02,192581,Butler; Shannon Rhey,0,1,32,32
1683687592202,BILD 3,A03,192611,Butler; Shannon Rhey,19,0,32,13
1683687592202,BILD 3,A04,192612,Butler; Shannon Rhey,24,0,32,8
1683687592202,BILD 3,A05,192613,Butler; Shannon Rhey,26,0,32,6
1683687592202,BILD 3,A06,192679,Butler; Shannon Rhey,27,0,32,5
1683687592202,BILD 3,A07,192682,Butler; Shannon Rhey,20,0,32,12
1683687593227,BILD 4,A01,192836,Reuther; Keefe,1,0,24,23
1683687593227,BILD 4,A02,193044,Reuther; Keefe,4,0,24,20
1683687594254,BILD 10,A01,193142,Gustafson-Brown; Cindy,29,0,32,3
1683687594254,BILD 10,A02,193149,Gustafson-Brown; Cindy,31,0,32,1
1683687595278,BIMM 100,A01,193301,Staff,0,6,32,32
1683687595278,BIMM 100,A02,193312,Staff,0,7,32,32
1683687595278,BIMM 100,A03,193323,Staff,0,10,32,32
1683687596304,BIMM 101,A01,193329,McDonnell; Lisa Marie,1,4,24,23
1683687596304,BIMM 101,A02,193339,McDonnell; Lisa Marie,1,4,24,23
1683687596304,BIMM 101,B01,193354,McDonnell; Lisa Marie,0,4,24,24
1683687596304,BIMM 101,B02,193357,McDonnell; Lisa Marie,0,3,24,24
1683687597330,BIMM 110,A01,193377,Tat; John,0,11,32,32
1683687597330,BIMM 110,A02,193378,Tat; John,0,11,32,32
1683687598413,BIMM 120,A01,206116,Staff,0,0,32,32
1683687598413,BIMM 120,A02,206117,Staff,7,0,32,25
1683687598413,BIMM 120,A03,206121,Staff,21,0,32,11
1683687599441,BIPN 100,A01,193393,Park; Ji Young,0,15,32,32
1683687599441,BIPN 100,A02,193402,Park; Ji Young,0,14,32,32
1683687599441,BIPN 100,A03,193413,Park; Ji Young,0,14,32,32
1683687599441,BIPN 100,A04,193414,Park; Ji Young,0,13,32,32
1683687600468,BIPN 102,A01,193429,Staff,0,0,32,32
1683687600468,BIPN 102,A02,193438,Staff,18,0,32,14
1683687601492,BIPN 106,A01,193450,Reyes Gonzalez; Catalina,0,2,40,40
1683687602517,BIPN 134,A01,193465,Cooke; James Edward,0,0,32,32
1683687602517,BIPN 134,A02,193474,Cooke; James Edward,25,0,32,7
1683687602517,BIPN 134,A03,193485,Cooke; James Edward,29,0,32,3
1683687602517,BIPN 134,A04,193486,Cooke; James Edward,20,0,32,12
1683687602517,BIPN 134,A05,193491,Cooke; James Edward,31,0,32,1
1683687602517,BIPN 134,A06,193501,Cooke; James Edward,30,0,32,2
1683687602517,BIPN 134,A07,193510,Cooke; James Edward,29,0,32,3
1683687604565,BISP 194,A00,222522,Staff,14,0,32,18
1683687605589,CAT 124,A01,202407,Staff,19,0,25,6
1683687606612,CAT 125,A00,202408,Marchisotto; Jennifer Anne,2,0,20,18
1683687607641,CAT 125R,A00,202409,Smith; Lauryn Alissa,0,11,20,20
1683687607641,CAT 125R,B00,202410,Morales; Celeste Georgianna,0,11,20,20
1683687607641,CAT 125R,C00,202411,Irwin; Matthew Joseph,0,12,20,20
1683687608668,CENG 15,A01,204712,Yang; Kesong,0,1,0,0
1683687609693,CENG 114,A00,202070,Jahed Motlagh; Zeinab,5,0,20,15
1683687610717,CGS 105,A00,185477,Wesling; Megan E.,24,0,40,16
1683687611744,CGS 106,A00,185494,Staff,11,0,22,11
1683687612770,CGS 108,A00,185495,Staff,14,0,20,6
1683687613794,CGS 114,A00,185496,Staff,13,0,18,5
1683687614818,CGS 119,A00,185501,Staff,15,0,20,5
1683687615841,CGS 120,A00,185511,Staff,12,0,20,8
1683687616868,CHEM 4,A01,184675,Bussey; Thomas J,97,0,100,3
1683687617894,CHEM 6A,A01,184677,Staff,32,0,60,28
1683687618918,CHEM 6B,A01,184679,Staff,63,0,100,37
1683687619942,CHEM 6C,A01,184681,Bussey; Thomas J,0,0,50,50
1683687619942,CHEM 6C,A02,184682,Bussey; Thomas J,32,0,50,18
1683687620970,CHEM 40A,A01,184684,Albizati; Kim F.,33,0,100,67
1683687621993,CHEM 40B,A01,184686,Albizati; Kim F.,0,22,100,100
1683687623017,CHEM 41B,A01,184690,Staff,51,0,100,49
1683687624048,COGS 3,A01,184715,Boyle; Mary E. T.,0,27,40,40
1683687625075,COGS 14B,A01,185172,Staff,0,14,38,38
1683687626099,COGS 18,A01,184736,Staff,14,0,80,66
1683687627124,COGS 100,A01,184932,Staff,0,8,73,73
1683687628148,COGS 101A,A01,184935,Staff,0,40,30,30
1683687629174,COGS 101B,A01,184944,Staff,0,2,30,30
1683687630200,COGS 101C,A01,184946,Staff,0,10,30,30
1683687631226,COGS 102A,A01,184951,Johnson; Christine M.,1,0,40,39
1683687632252,COGS 107B,A01,184953,Mooshagian; Eric Frederick,0,52,40,40
1683687633276,COGS 118B,A01,184959,Gupta; Anjum,0,50,40,40
1683687634300,COGS 153,A00,184961,Staff,0,16,30,30
1683687635322,COGS 177,A00,184962,Staff,1,21,30,29
1683687636348,COGS 187A,A01,184969,Boyle; Mary E. T.,0,19,40,40
1683687637377,COMM 10,A01,185174,Staff,0,5,25,25
1683687637377,COMM 10,A02,185189,Staff,0,2,25,25
1683687637377,COMM 10,A03,269821,Staff,0,1,0,0
1683687638404,COMM 100B,A02,185476,Staff,10,0,25,15
1683687638404,COMM 100B,A03,277340,Staff,25,0,25,0
1683687639427,COMM 100C,A01,185314,Staff,1,0,25,24
1683687639427,COMM 100C,A02,185327,Staff,17,0,25,8
1683687640451,COMM 110M,A00,185349,Staff,0,0,40,40
1683687641478,COMM 113T,A00,185352,Staff,25,0,40,15
1683687642502,COMM 114I,A00,185353,Staff,31,0,40,9
1683687643526,COMM 131,A00,185354,Staff,17,0,30,13
1683687644550,CSE 8A,A50,185358,Cao; Yingjun,0,46,10,10
1683687645574,CSE 8B,A01,185362,Staff,0,48,50,50
1683687646602,CSE 11,A01,185416,Cao; Yingjun,0,91,10,10
1683687647626,CSE 20,A01,185445,Briones; Jor-el Thomas Caparas,3,0,25,22
1683687648654,CSE 21,A01,185447,Staff,9,0,50,41
1683687649682,CSE 101,A01,185451,Staff,0,13,50,50
1683687649682,CSE 101,B01,185453,Jones; Miles E,0,14,50,50
1683687651733,CSE 141,A01,185458,Eldon; John,16,0,100,84
1683687652757,CSE 141L,A01,185461,Eldon; John,8,0,100,92
1683687653785,CSE 142,A01,185463,Staff,34,0,60,26
1683687653785,CSE 142,B01,201355,Staff,0,7,60,60
1683687654810,CSE 142L,A01,185470,Staff,34,0,60,26
1683687654810,CSE 142L,B01,201417,Staff,0,6,60,60
1683687655838,CSE 190,A00,201433,Staff,32,0,49,17
1683687656862,DOC 1,A01,259136,Strom; Megan C.,7,0,15,8
1683687656862,DOC 1,A02,259137,Strom; Megan C.,14,0,15,1
1683687656862,DOC 1,A03,259138,Strom; Megan C.,14,0,15,1
1683687656862,DOC 1,A04,259139,Strom; Megan C.,14,0,15,1
1683687657888,DOC 100D,A00,259140,Pass; Natalye Joann,14,0,25,11
1683687658915,DSGN 1,A01,184749,Rill; Bryan,0,26,30,30
1683687659943,DSGN 100,A01,185168,Staff,0,2,25,25
1683687660969,ECE 5,A01,185626,Morris; Karcher William,0,12,0,0
1683687661997,ECE 101,A01,185628,Staff,14,0,70,56
1683687663022,ECE 107,A01,185635,Baghdadchi; Saharnaz,0,0,20,20
1683687663022,ECE 107,A02,185638,Baghdadchi; Saharnaz,1,0,20,19
1683687664047,ECE 148,A01,185647,Silberman; Jack,0,0,16,16
1683687665073,ECON 1,A01,185537,Crane; Meredith Helen,54,0,70,16
1683687666098,ECON 3,A01,185549,Crane; Meredith Helen,30,0,70,40
1683687667128,ECON 4,A01,203354,Anderson; John Charles,0,5,10,10
1683687668152,ECON 100A,A01,185574,Staff,0,5,40,40
1683687669180,ECON 100B,A01,185576,Staff,0,12,50,50
1683687670207,ECON 100C,A01,185589,Newhouse; Herbert S,30,0,70,40
1683687671235,ECON 105,A00,185608,Vespa; Emanuel Ignacio,19,0,35,16
1683687672276,ECON 109,A01,185610,Shishkin; Denis,9,0,35,26
1683687673299,ECON 110A,A01,185612,Staff,8,0,40,32
1683687674322,ECON 120A,A01,185615,Staff,19,0,40,21
1683687675354,ECON 120C,A01,185617,Sun; Yixiao,0,21,70,70
1683687676379,ECON 144,A00,203346,Squires; Dale E,2,0,35,33
1683687677403,ECON 171,A01,203349,Newhouse; Herbert S,0,1,35,35
1683687678432,ECON 173A,A01,185621,Toda; Alexis Akira,21,0,35,14
1683687679461,EDS 25,A01,202413,Staff,0,1,0,0
1683687679461,EDS 25,A02,202414,Staff,0,1,0,0
1683687679461,EDS 25,A03,202415,Staff,0,0,0,0
1683687679461,EDS 25,A04,202416,Staff,0,1,0,0
1683687679461,EDS 25,A05,202439,Staff,0,0,0,0
1683687679461,EDS 25,A06,202440,Staff,0,0,0,0
1683687679461,EDS 25,B01,202631,Staff,0,0,0,0
1683687679461,EDS 25,B02,202632,Staff,0,0,0,0
1683687679461,EDS 25,B03,202639,Staff,0,0,0,0
1683687679461,EDS 25,B04,202640,Staff,0,0,0,0
1683687679461,EDS 25,B05,202643,Staff,0,0,0,0
1683687679461,EDS 25,B06,202644,Staff,0,0,0,0
1683687680490,EDS 38,A01,202659,Black; Alison Michelle,24,0,25,1
1683687681515,EDS 115,A00,202652,Staff,18,0,30,12
1683687682539,EDS 125,A00,202649,Staff,13,0,30,17
1683687686407,EDS 126,A01,203332,Staff,30,0,30,0
1683687687430,EDS 139,A00,202838,Staff,16,0,25,9
1683687688458,EDS 146,A01,202655,Staff,14,0,25,11
1683687689486,ENG 15,A00,185667,Staff,0,1,0,0
1683687689486,ENG 15,B00,185672,Staff,0,0,0,0
1683687689486,ENG 15,C00,185675,Staff,0,0,0,0
1683687689486,ENG 15,D00,185682,Staff,0,0,0,0
1683687689486,ENG 15,E00,185684,Staff,0,0,0,0
1683687690512,ETHN 103,A00,185710,Staff,0,8,35,35
1683687691543,ETHN 103A,A00,199228,Man; Simeon S,0,0,9,9
1683687692570,ETHN 109,A00,185711,Staff,15,0,35,20
1683687693595,ETHN 142,A00,185726,Staff,0,4,30,30
1683687694623,ETHN 163J,A00,199229,Man; Simeon S,5,0,8,3
1683687695650,ETHN 168,A00,185727,Staff,7,0,10,3
1683687696677,ETHN 182,A00,185728,Staff,0,0,35,35
1683687697703,ETHN 183,A00,185737,Staff,9,0,18,9
1683687698728,GLBH 111,A01,209361,Burgos; Jose L.,0,0,0,0
1683687700777,HIEU 104,A00,185792,Staff,14,0,20,6
1683687701804,HIEU 115,A00,185800,Staff,0,0,20,20
1683687702831,HIEU 128,A00,185801,Staff,0,9,20,20
1683687703856,HIEU 147,A00,185802,Staff,15,0,20,5
1683687704941,HIEU 154,A00,185823,Staff,11,0,20,9
1683687705965,HILA 102,A00,185826,Staff,14,0,20,6
1683687706995,HILD 2C,A01,185778,Staff,0,13,20,20
1683687708019,HILD 7B,A01,185780,Kwak; Nancy,0,17,32,32
1683687708019,HILD 7B,A02,185781,Kwak; Nancy,0,18,32,32
1683687709046,HILD 30,A01,185791,Staff,12,0,20,8
1683687710071,HISC 119,A00,185830,Golan; Tal,0,10,20,20
1683687711098,HITO 156GS,A00,185831,Patterson; Patrick H.,0,0,0,23
1683687712122,HIUS 103,A00,185832,Man; Simeon S,0,4,20,20
1683687713147,HIUS 117,A00,185836,Kwak; Nancy,2,0,20,18
1683687714175,HIUS 125,A00,185840,Man; Simeon S,0,2,23,23
1683687715202,HIUS 149,A00,185845,Staff,1,0,20,19
1683687716236,HUM 3,A01,185882,Zavodny; Tatiana Sophia,0,8,50,50
1683687716236,HUM 3,B01,185899,Caldwell; Michael Alan,0,18,50,50
1683687717264,HUM 3GS,A00,185900,Patterson; Patrick H.,0,0,0,23
1683687718289,HUM 4,A01,185938,Zroka; Amy Liane,28,0,50,22
1683687718289,HUM 4,B01,185956,Watkins; Eric,0,6,50,50
1683687718289,HUM 4,B02,202209,Watkins; Eric,0,5,50,50
1683687718289,HUM 4,B03,202210,Watkins; Eric,0,5,50,50
1683687719314,HUM 5,A01,185958,West; Geoffrey Scott,0,0,50,50
1683687719314,HUM 5,A02,202215,West; Geoffrey Scott,0,0,50,50
1683687720343,INTL 190,A00,185959,Gagnon; Jeffrey C,0,0,0,9
1683687720343,INTL 190,B00,185960,Lettieri; Michael Joseph,0,0,0,2
1683687721369,JAPN 180,A00,254509,Staff,5,0,30,25
1683687722396,LATI 10,A01,202853,Kennemore; Amy Michelle,4,0,35,31
1683687722396,LATI 10,A02,202854,Kennemore; Amy Michelle,3,0,35,32
1683687722396,LATI 10,A03,270054,Kennemore; Amy Michelle,30,0,30,0
1683687723423,LATI 180,A00,202855,Kennemore; Amy Michelle,11,0,20,9
1683687724448,LAWS 101,A00,201767,Golan; Tal,0,7,40,40
1683687725475,LIFR 1C,A00,185961,Staff,6,0,20,14
1683687726500,LIFR 1CX,A00,185962,Staff,7,0,20,13
1683687727526,LIFR 1D,A00,185963,Staff,7,0,20,13
1683687728551,LIFR 1DX,A00,185964,Staff,7,0,20,13
1683687729579,LIGN 101,A01,186039,Staff,43,0,50,7
1683687730604,LIGN 165,A00,186040,Staff,15,0,50,35
1683687731631,LTCS 108,A00,186041,Staff,5,0,10,5
1683687732654,LTCS 119,A00,186042,Staff,15,0,20,5
1683687733679,LTCS 130,A00,186043,Wesling; Megan E.,15,0,25,10
1683687735732,LTEA 138,A00,186119,Staff,14,0,40,26
1683687736756,LTEN 124,A00,186148,Staff,5,0,25,20
1683687737781,LTEN 178,A00,186149,Staff,6,0,15,9
1683687738810,LTEN 181,A00,186150,Blanco; John D,34,0,40,6
1683687739838,LTWL 120,A00,186160,Staff,19,0,25,6
1683687740865,LTWL 165,A00,186161,Staff,22,0,25,3
1683687741892,LTWR 100,A00,186162,Staff,0,5,15,15
1683687742920,LTWR 102,A00,186163,Doller; Ben,5,0,15,10
1683687743944,MAE 8,A01,186412,Staff,0,1,0,0
1683687744970,MAE 30B,A00,186445,Bahadori; Mohammad Yousef,81,0,100,19
1683687745994,MAE 40,A00,186592,Bewley; Thomas R,10,0,50,40
1683687747023,MAE 101B,A00,186593,Bahadori; Mohammad Yousef,80,0,100,20
1683687748050,MAE 105,A00,186594,Bandaru; Prabhakar,10,0,50,40
1683687749079,MAE 107,A00,186599,Pham; Hieu Tan,0,7,120,120
1683687750102,MAE 148,A01,186660,Silberman; Jack,3,0,16,13
1683687751127,MATH 10A,A01,188095,Staff,0,6,35,35
1683687752154,MATH 10B,A01,188097,Bowers; Adam R.,0,12,30,30
1683687752154,MATH 10B,A02,188099,Bowers; Adam R.,0,11,30,30
1683687752154,MATH 10B,B01,188104,Bowers; Adam R.,0,10,30,30
1683687752154,MATH 10B,B02,188106,Bowers; Adam R.,1,9,30,29
1683687753180,MATH 10C,A01,188111,Staff,0,20,30,30
1683687753180,MATH 10C,A02,188127,Staff,0,19,30,30
1683687753180,MATH 10C,A03,188131,Staff,0,19,30,30
1683687753180,MATH 10C,B01,188218,Staff,17,0,30,13
1683687753180,MATH 10C,B02,188244,Staff,13,0,30,17
1683687753180,MATH 10C,B03,188277,Staff,14,0,30,16
1683687754204,MATH 18,A01,188344,Bach; Quang Tran,18,0,30,12
1683687754204,MATH 18,A02,188345,Bach; Quang Tran,11,0,30,19
1683687754204,MATH 18,B01,188353,Bach; Quang Tran,11,0,30,19
1683687754204,MATH 18,B02,188354,Bach; Quang Tran,19,0,30,11
1683687755230,MATH 20A,A01,188374,Staff,11,0,35,24
1683687756256,MATH 20B,A01,188382,Ohm; Ko Woon,7,0,30,23
1683687756256,MATH 20B,A02,188383,Ohm; Ko Woon,22,0,30,8
1683687756256,MATH 20B,B01,188385,Ohm; Ko Woon,7,0,30,23
1683687756256,MATH 20B,B02,188392,Ohm; Ko Woon,22,0,30,8
1683687757279,MATH 20C,A01,188394,Harel; Guershon,10,0,30,20
1683687757279,MATH 20C,A02,188395,Harel; Guershon,13,0,30,17
1683687757279,MATH 20C,B01,188404,Harel; Guershon,5,0,30,25
1683687757279,MATH 20C,B02,188405,Harel; Guershon,18,0,30,12
1683687758307,MATH 20D,A01,188414,Hammock; Frances H,0,1,30,30
1683687758307,MATH 20D,A02,188415,Hammock; Frances H,0,1,30,30
1683687758307,MATH 20D,B01,188447,Hammock; Frances H,0,1,30,30
1683687758307,MATH 20D,B02,188486,Hammock; Frances H,2,0,30,28
1683687759332,MATH 20E,A01,188649,Staff,21,0,30,9
1683687759332,MATH 20E,A02,188650,Staff,20,0,30,10
1683687759332,MATH 20E,A03,188673,Staff,0,0,30,30
1683687760358,MATH 102,A01,188675,Staff,0,40,35,35
1683687761384,MATH 103B,A01,188681,Staff,3,0,35,32
1683687761384,MATH 103B,B01,188692,Staff,5,0,35,30
1683687762412,MATH 109,A01,188695,Salehi Golsefidy; Alireza,24,0,35,11
1683687762412,MATH 109,A02,188696,Salehi Golsefidy; Alireza,25,0,35,10
1683687763440,MATH 120A,A01,188698,Eggers; John Dietrich,7,0,35,28
1683687764466,MATH 142B,A01,188736,Ioana; Adrian,1,1,30,29
1683687764466,MATH 142B,A02,188741,Ioana; Adrian,0,1,30,30
1683687764466,MATH 142B,A03,188743,Ioana; Adrian,0,2,30,30
1683687765494,MATH 168A,A01,188790,Staff,0,11,35,35
1683687766520,MATH 170A,A01,188803,Nie; Jiawang,0,2,35,35
1683687766520,MATH 170A,A02,188811,Nie; Jiawang,0,1,35,35
1683687766520,MATH 170A,A03,188814,Nie; Jiawang,0,0,35,35
1683687766520,MATH 170A,A04,188815,Nie; Jiawang,5,0,35,30
1683687767546,MATH 193B,A01,188817,Staff,0,0,35,35
1683687767546,MATH 193B,A02,188818,Staff,6,0,35,29
1683687768573,MGT 4,A01,202857,Anderson; John Charles,59,0,80,21
1683687769601,MGT 12,A00,202858,Lindenberger; Wade Douglas,40,0,90,50
1683687770626,MGT 18,A00,202859,Staff,74,0,90,16
1683687771653,MGT 18GS,A00,202860,McKay; Michael J,13,0,28,15
1683687772679,MGT 45,A00,202861,Pecore; Joseph P.,8,0,90,82
1683687773707,MGT 100,A00,202863,Yavorsky; Daniel Ryan,27,0,90,63
1683687774736,MGT 103,A00,202864,Ehrich; Kristine R,0,19,90,90
1683687775763,MGT 112,A00,202865,Ehrich; Kristine R,15,0,90,75
1683687776792,MGT 121A,A00,202868,Staff,90,20,90,0
1683687777818,MGT 131B,A00,202869,Anderson; John Charles,59,0,90,31
1683687778843,MGT 136,A00,202871,Lindenberger; Wade Douglas,83,0,90,7
1683687779867,MGT 164,A00,202873,Staff,0,67,90,91
1683687780891,MGT 164GS,A00,202874,McKay; Mary A,13,0,28,15
1683687781919,MGT 180,A00,202875,Staff,0,51,90,91
1683687782946,MMW 11R,A01,205019,Herbst; Matthew,0,0,30,30
1683687782946,MMW 11R,A02,205026,Herbst; Matthew,29,0,30,1
1683687783972,MMW 15,A01,193512,Chang; Edmond Yi-Teh,0,8,28,28
1683687783972,MMW 15,A02,193513,Chang; Edmond Yi-Teh,0,5,28,28
1683687783972,MMW 15,A03,193514,Chang; Edmond Yi-Teh,0,5,28,28
1683687783972,MMW 15,A04,193515,Chang; Edmond Yi-Teh,0,5,28,28
1683687783972,MMW 15,A05,193516,Chang; Edmond Yi-Teh,0,5,28,28
1683687783972,MMW 15,A06,193517,Chang; Edmond Yi-Teh,0,6,28,28
1683687783972,MMW 15,B01,193519,Chang; Edmond Yi-Teh,0,5,28,28
1683687783972,MMW 15,B02,193520,Chang; Edmond Yi-Teh,0,5,28,28
1683687783972,MMW 15,B03,193521,Chang; Edmond Yi-Teh,0,5,28,28
1683687783972,MMW 15,B04,193522,Chang; Edmond Yi-Teh,0,6,28,28
1683687783972,MMW 15,B05,193523,Chang; Edmond Yi-Teh,0,5,28,28
1683687783972,MMW 15,B06,193524,Chang; Edmond Yi-Teh,0,5,28,28
1683687785004,MMW 122,A01,193526,Rahimi; Babak,0,16,28,28
1683687785004,MMW 122,A02,193527,Rahimi; Babak,0,15,28,28
1683687785004,MMW 122,A03,193528,Rahimi; Babak,0,0,0,0
1683687785004,MMW 122,A04,193529,Rahimi; Babak,0,0,0,0
1683687786028,MUS 1A,A01,186663,Staff,1,19,35,34
1683687787053,MUS 4,A01,186715,Staff,0,12,35,35
1683687788078,MUS 5R,A01,186796,Dubnov; Shlomo,0,17,35,35
1683687789103,MUS 6,A01,186798,Staff,1,5,25,24
1683687790127,MUS 7,A01,186830,Staff,11,0,35,24
1683687791151,MUS 8,A01,186930,Staff,0,27,35,35
1683687792180,MUS 15,A01,186932,Staff,0,15,35,35
1683687792180,MUS 15,B01,186934,Staff,1,17,35,34
1683687793207,MUS 80,A00,186935,Staff,0,0,20,20
1683687793207,MUS 80,B00,186936,Staff,24,0,25,1
1683687794238,NANO 11,A00,204702,Lipomi; Darren John,0,0,0,0
1683687795266,NANO 15,A01,204709,Yang; Kesong,0,1,0,0
1683687796291,NANO 114,A00,202069,Jahed Motlagh; Zeinab,2,0,10,8
1683687797318,PHIL 1,A00,186955,Grush; Rick Scott,31,0,40,9
1683687798347,PHIL 10,A01,186973,Grush; Rick Scott,27,0,35,8
1683687798347,PHIL 10,A02,186974,Grush; Rick Scott,33,0,35,2
1683687799370,PHIL 13,A01,186976,Staff,1,0,35,34
1683687799370,PHIL 13,A02,186977,Staff,16,0,35,19
1683687800395,PHIL 14,A01,186979,Staff,31,0,35,4
1683687800395,PHIL 14,A02,186986,Staff,32,0,35,3
1683687801420,PHIL 28,A01,186988,Staff,16,0,30,14
1683687801420,PHIL 28,A02,186989,Staff,1,0,30,29
1683687801420,PHIL 28,A03,186990,Staff,10,0,30,20
1683687801420,PHIL 28,A04,186991,Staff,26,0,30,4
1683687802442,PHIL 120,A00,186997,Staff,23,0,40,17
1683687803466,PHIL 137,A00,187003,Staff,7,0,40,33
1683687804490,PHIL 150,A00,187015,Staff,47,0,70,23
1683687805514,PHIL 167,A00,187021,Lamey; Andy M.,34,0,40,6
1683687806540,PHIL 174,A01,202226,Staff,17,0,20,3
1683687806540,PHIL 174,A02,202235,Staff,20,0,20,0
1683687807565,PHIL 191A,A00,258918,Staff,0,0,1,1
1683687808651,PHYS 1A,A00,187028,Staff,26,0,60,34
1683687809675,PHYS 1AL,001,187036,Staff,3,0,30,27
1683687809675,PHYS 1AL,002,187049,Staff,18,0,30,12
1683687810703,PHYS 1B,A00,187058,Staff,22,0,60,38
1683687811734,PHYS 1BL,001,187064,Staff,0,1,30,30
1683687811734,PHYS 1BL,002,187070,Staff,4,0,30,26
1683687812759,PHYS 1C,A00,187082,Staff,29,0,120,91
1683687813782,PHYS 1CL,001,187088,Staff,0,9,30,30
1683687813782,PHYS 1CL,002,187089,Staff,0,1,30,30
1683687813782,PHYS 1CL,009,262693,Staff,9,0,30,21
1683687814805,PHYS 2B,A01,187097,Staff,55,0,115,60
1683687815834,PHYS 2C,A01,187099,Staff,63,0,115,52
1683687816862,PHYS 2CL,A01,187101,Staff,5,0,28,23
1683687816862,PHYS 2CL,A02,187102,Staff,15,0,28,13
1683687817886,PHYS 2D,A01,187123,Shotwell; Brian,95,0,115,20
1683687818913,PHYS 4B,A01,187133,Grinstein; Benjamin,35,0,50,15
1683687819936,POLI 10,A00,188819,Staff,0,4,50,50
1683687820963,POLI 11,A00,188827,Staff,43,0,50,7
1683687821990,POLI 13R,A00,188828,Staff,0,1,20,20
1683687823014,POLI 27,A01,188830,Elgin; Samuel Zincke,0,2,70,70
1683687824040,POLI 30,A00,188832,Desposato; Scott,30,0,50,20
1683687825066,POLI 102F,A00,188834,Staff,1,0,40,39
1683687826088,POLI 104A,A00,188852,Staff,12,0,30,18
1683687827110,POLI 104I,A00,188853,Staff,0,8,20,20
1683687828134,POLI 110B,A00,188854,Wiens; David,6,0,20,14
1683687829157,POLI 112A,A00,188855,Wiens; David,3,0,30,27
1683687830180,POLI 117R,A00,188856,Forman; Fonna,0,12,20,20
1683687831205,POLI 118,A00,188857,Ingham; Sean,8,0,20,12
1683687832229,POLI 120G,A00,188858,Staff,8,0,30,22
1683687833251,POLI 131CR,A00,188863,Hoston; Germaine,20,0,50,30
1683687834274,POLI 133,A00,188864,Nellis; Gareth Hb,44,0,50,6
1683687835299,POLI 134D,A00,188865,Desposato; Scott,27,0,30,3
1683687836322,POLI 142A,A00,188871,Gartzke; Erik,21,0,50,29
1683687837348,POLI 142K,A00,188874,Staff,38,0,50,12
1683687838374,POLI 143,A00,188940,Gartzke; Erik,16,0,30,14
1683687839400,POLI 153,A00,188943,Staff,2,0,20,18
1683687840426,POLI 160AA,A00,188944,Staff,10,0,40,30
1683687841452,POLI 170A,A00,188945,Staff,10,0,30,20
1683687843506,PSYC 1,A00,188952,Staff,36,0,90,54
1683687844529,PSYC 2,B00,188953,Staff,19,0,35,16
1683687845555,PSYC 6,A00,188970,Staff,47,0,60,13
1683687846578,PSYC 7,A00,188973,Staff,35,0,45,10
1683687847604,PSYC 60,A01,188980,Rickard; Timothy C.,42,0,60,18
1683687848632,PSYC 70,A01,189001,Steiner; Eric Tomas,21,0,45,24
1683687849659,PSYC 100,A00,189005,Lacefield; Katharine I,0,99,120,120
1683687850686,PSYC 102,A00,189008,Staff,7,0,30,23
1683687851711,PSYC 106,B00,189026,Gorman; Michael R.,27,0,60,33
1683687852739,PSYC 114,B01,189033,Winkielman; Piotr,0,31,30,30
1683687853766,PSYC 131,A00,189036,Anagnostaras; Stephan,0,43,60,60
1683687854792,PSYC 136,A00,189041,Lowe; Angela Beth,0,7,25,25
1683687855816,PSYC 137,A00,189057,Winkielman; Piotr,1,37,25,24
1683687856840,PSYC 144,A00,189107,Wixted; John T,0,11,50,50
1683687858899,PSYC 162,A00,189142,Staff,0,9,85,85
1683687859928,PSYC 172,A00,189144,Gorman; Michael R.,0,6,30,30
1683687861976,PSYC 179,A00,189146,Lacefield; Katharine I,0,88,120,120
1683687863006,PSYC 181,A00,189147,Anagnostaras; Stephan,0,44,90,90
1683687864030,PSYC 190R,A00,189148,Barner; David A.,0,23,80,80
1683687865059,PSYC 191,A00,189275,Rickard; Timothy C.,0,11,25,25
1683687866086,PSYC 193,A00,189276,Chapman; Eddie Nathaniel,0,1,0,4
1683687867113,PSYC 193L,A01,189281,Lowe; Angela Beth,8,0,20,12
1683687867113,PSYC 193L,B01,189285,Staff,28,0,35,7
1683687868137,RELI 149,A00,187137,Rahimi; Babak,6,0,40,34
1683687869164,SE 9,A01,187315,Staff,0,2,18,18
1683687870187,SE 101B,A00,187409,Staff,24,0,30,6
1683687871213,SE 110B,A00,187444,Staff,10,0,40,30
1683687872237,SE 130B,A00,187449,Staff,31,0,40,9
1683687873264,SE 150A,A00,187516,Staff,8,0,20,12
1683687874290,SE 154,A00,187528,Staff,29,0,50,21
1683687875319,SIO 3,A01,258171,Staff,35,0,40,5
1683687876342,SIO 10,A00,187144,Cook; Geoffrey W,1,7,75,74
1683687877367,SIO 45,A00,187152,Cook; Geoffrey W,0,7,100,100
1683687878394,SIO 109R,A00,194486,Staff,0,4,20,20
1683687880447,SIO 187,A01,187233,Kacev; David,12,0,40,28
1683687881473,SOCI 1,A01,258656,Thorpe; Charles Robert,28,0,30,2
1683687881473,SOCI 1,A02,258658,Thorpe; Charles Robert,30,0,30,0
1683687881473,SOCI 1,A03,258661,Thorpe; Charles Robert,25,0,25,0
1683687881473,SOCI 1,A04,258666,Thorpe; Charles Robert,22,0,25,3
1683687881473,SOCI 1,A05,258897,Thorpe; Charles Robert,22,0,25,3
1683687881473,SOCI 1,A06,258898,Thorpe; Charles Robert,25,0,25,0
1683687882500,SOCI 30,A01,258903,Pardo Guerra; Juan Pablo,14,0,30,16
1683687883526,SOCI 102,A00,258904,Staff,9,0,25,16
1683687884552,SOCI 106,A00,258905,Staff,19,0,25,6
1683687885580,SOCI 111,A00,258907,Ribas Norris; Janet Vanesa,26,0,30,4
1683687886604,SOCI 121R,A00,258908,Pardo Guerra; Juan Pablo,8,0,30,22
1683687887630,SOCI 126,A01,203330,Staff,14,0,20,6
1683687888654,SOCI 131,A00,258909,Thorpe; Charles Robert,30,0,60,30
1683687889677,SOCI 135,A00,258910,Payne; Christine Anna,0,12,30,30
1683687890701,SOCI 157,A00,258911,Staff,11,0,30,19
1683687891725,SOCI 184,A00,258912,Staff,25,0,30,5
1683687892748,SOCI 188D,A00,258913,Staff,22,0,30,8
1683687893776,SYN 2,001,187529,Staff,9,0,16,7
1683687893776,SYN 2,002,201452,Staff,1,20,16,15
1683687893776,SYN 2,003,201469,Staff,1,0,16,15
1683687894800,SYN 100,A01,187531,Staff,0,9,20,20
1683687894800,SYN 100,B01,201491,Staff,0,10,20,20
1683687895827,TDAC 1,A00,189286,Walsh; Kim C.,3,0,20,17
1683687895827,TDAC 1,B00,189287,Harting; Carla Kelso,10,0,20,10
1683687896854,TDAC 101,A00,189300,Walsh; Kim C.,16,0,20,4
1683687896854,TDAC 101,B00,189301,Harting; Carla Kelso,18,0,20,2
1683687897877,TDAC 102,A00,189304,Basso; Beatrice,14,0,20,6
1683687898900,TDAC 108,A00,189305,Staff,18,0,20,2
1683687899929,TDDE 131,A00,189310,Staff,19,0,20,1
1683687899929,TDDE 131,B00,189314,Staff,19,0,20,1
1683687899929,TDDE 131,C00,189315,Staff,48,0,50,2
1683687899929,TDDE 131,D00,189316,Staff,14,0,15,1
1683687899929,TDDE 131,E00,204841,Staff,20,0,20,0
1683687900952,TDGE 10,A00,189289,Staff,27,0,50,23
1683687900952,TDGE 10,B00,189290,Havis; Allan,0,1,50,50
1683687901975,TDGE 11,A00,189291,Fulton; Julia,0,4,50,50
1683687901975,TDGE 11,B00,189292,Staff,20,0,25,5
1683687901975,TDGE 11,C00,260270,Staff,0,0,0,0
1683687902999,TDGE 25,A00,189294,Staff,1,0,20,19
1683687904023,TDGE 124,A00,189318,Fulton; Julia,1,8,50,49
1683687905047,TDGE 125,A00,189319,Staff,13,0,25,12
1683687905047,TDGE 125,B00,189320,Staff,23,0,25,2
1683687906071,TDGE 127,A00,189322,Havis; Allan,0,0,50,50
1683687907095,TDHT 101,A00,189323,Staff,18,0,25,7
1683687907095,TDHT 101,B00,189324,Staff,25,0,25,0
1683687908119,TDHT 102,A00,189325,Staff,49,0,50,1
1683687909147,TDMV 1,A00,189295,Arcidiacono; Kristin,20,0,30,10
1683687909147,TDMV 1,B00,189296,Caligagan; Maria T.,24,0,30,6
1683687910173,TDMV 2,A00,189297,Sammartano; Tonnie,27,0,30,3
1683687910173,TDMV 2,B00,189299,Arcidiacono; Kristin,23,0,30,7
1683687911198,TDMV 3,A00,204998,Rincon; Alicia,22,0,30,8
1683687912279,TDMV 120,A00,189458,Sammartano; Tonnie,28,0,30,2
1683687913303,TDMV 138,A00,189541,Jun; Grace Shin Hae,20,0,40,20
1683687914333,TDMV 142,A00,189717,Caligagan; Tony,25,0,30,5
1683687914333,TDMV 142,B00,189718,Caligagan; Maria T.,25,0,30,5
1683687915359,TMC 2,A01,187533,Staff,25,0,25,0
1683687915359,TMC 2,A02,187534,Staff,25,0,25,0
1683687916385,USP 1,A01,187536,Kwak; Nancy,0,16,25,25
1683687917407,USP 5,A01,187538,Staff,8,0,25,17
1683687918434,USP 101,A00,199253,Staff,0,4,0,0
1683687919515,USP 124,A00,187562,Boomhower; Matthew Charles,0,0,30,30
1683687920542,USP 138,A00,187582,Staff,19,0,25,6
1683687921566,USP 152,A01,187597,Staff,3,0,25,22
1683687922587,USP 153,A00,187598,Staff,18,0,25,7
1683687923615,USP 168,A00,187607,Kwak; Nancy,2,0,5,3
1683687924640,USP 173,A00,187619,Staff,4,0,25,21
1683687925666,USP 181,A00,187638,Staff,0,4,25,25
1683687926691,VIS 103,A00,187650,Cruz; Edwin Teddy,17,0,75,58
1683687927714,VIS 110D,A00,187669,Staff,13,0,22,9
1683687928737,VIS 127C,A00,187720,Shen; Kuiyi,67,0,146,79
1683687929761,VIS 149,A00,187731,Yoldas; Pinar,1,14,22,21
1683687930788,VIS 151,A01,188091,Staff,22,0,34,12
1683687930788,VIS 151,A02,188092,Staff,11,0,34,23
1683687931816,VIS 160B,A00,188093,Stalbaum; Brett,0,1,10,10
1683687933865,WCWP 10B,A00,201720,Staff,0,0,5,5
1683687933865,WCWP 10B,B00,201722,Staff,0,0,6,6
1683687934889,WCWP 100,A00,201725,Gagnon; Jeffrey C,0,0,2,2
1683687934889,WCWP 100,B00,201727,Staff,0,4,15,15
1683687937977,ANBI 133,A00,258401,Wilder; Linnea Lorene,34,0,40,6
1683687939004,ANBI 140,A00,258395,Hrvoj Mihic; Branka,18,0,25,7
1683687940032,ANSC 120,A00,258402,Bialecki; Jon Anthony,26,0,40,14
1683687941055,ANSC 144,A00,258400,Staff,12,0,40,28
1683687943103,ANSC 166,A00,258396,Parish; Steven Martin,156,0,175,19
1683687944127,ANSC 180,A00,193533,Staff,8,0,20,12
1683687945151,ANSC 188,A00,258397,Jassal; Aftab,34,0,40,6
1683687946173,ANTH 3,A01,258316,Staff,23,0,30,7
1683687947201,ANTH 5,A00,258394,Semendeferi; Ekaterini,16,0,20,4
1683687948226,ANTH 21,A01,258331,Staff,4,0,40,36
1683687949253,ANTH 103,A00,258398,Varma; Saiba,15,0,25,10
1683687950286,AWP 10,001,202034,Staff,0,0,0,0
1683687950286,AWP 10,002,202035,Staff,0,0,0,0
1683687950286,AWP 10,003,202036,Staff,0,0,0,0
1683687950286,AWP 10,004,202037,Staff,0,0,0,0
1683687950286,AWP 10,005,202038,Staff,0,0,0,0
1683687950286,AWP 10,006,202039,Staff,0,0,0,0
1683687950286,AWP 10,007,202040,Staff,0,0,0,0
1683687950286,AWP 10,008,202041,Staff,0,0,0,0
1683687950286,AWP 10,009,202042,Staff,0,0,0,0
1683687950286,AWP 10,010,202043,Staff,0,0,0,0
1683687950286,AWP 10,011,202044,Staff,0,0,0,0
1683687950286,AWP 10,012,202045,Staff,0,0,0,0
1683687950286,AWP 10,013,202046,Staff,0,0,0,0
1683687950286,AWP 10,014,202047,Staff,0,0,0,0
1683687950286,AWP 10,015,202048,Staff,0,0,0,0
1683687950286,AWP 10,016,202049,Staff,0,0,0,0
1683687950286,AWP 10,017,202050,Staff,0,0,0,0
1683687950286,AWP 10,018,202051,Staff,0,0,0,0
1683687950286,AWP 10,019,202052,Staff,0,0,0,0
1683687950286,AWP 10,020,202053,Staff,0,0,0,0
1683687950286,AWP 10,021,202054,Staff,0,0,0,0
1683687950286,AWP 10,022,202055,Staff,0,0,0,0
1683687950286,AWP 10,023,202056,Staff,0,0,0,0
1683687950286,AWP 10,024,202057,Staff,0,0,0,0
1683687950286,AWP 10,025,202058,Staff,0,0,0,0
1683687950286,AWP 10,026,202059,Staff,0,0,0,0
1683687951308,AWP 102,001,202032,Staff,0,0,0,0
1683687951308,AWP 102,002,202033,Staff,0,0,0,0
1683687952334,BENG 100,A01,254234,Taylor Amos; Alyssa C,31,0,40,9
1683687953358,BENG 196,001,270013,Engler; Adam J.,9999,0,9999,0
1683687954382,BICD 100R,A01,202018,Smith; Laurie,0,7,32,32
1683687954382,BICD 100R,A02,202019,Smith; Laurie,0,3,32,32
1683687954382,BICD 100R,A03,202020,Smith; Laurie,0,1,32,32
1683687954382,BICD 100R,A04,202021,Smith; Laurie,6,0,32,26
1683687954382,BICD 100R,A05,202022,Smith; Laurie,10,0,32,22
1683687955406,BICD 136,A01,193242,Gustafson-Brown; Cindy,0,2,32,32
1683687955406,BICD 136,A02,193244,Gustafson-Brown; Cindy,13,0,32,19
1683687956435,BIEB 102,A01,193249,Butler; Shannon Rhey,1,1,32,31
1683687956435,BIEB 102,A02,193251,Butler; Shannon Rhey,0,0,32,32
1683687956435,BIEB 102,A03,193253,Butler; Shannon Rhey,0,0,32,32
1683687956435,BIEB 102,A04,193255,Butler; Shannon Rhey,13,0,32,19
1683687956435,BIEB 102,A05,193265,Butler; Shannon Rhey,25,0,32,7
1683687956435,BIEB 102,A06,193269,Butler; Shannon Rhey,13,0,32,19
1683687958490,BIEB 150,A01,193274,Staff,0,0,32,32
1683687958490,BIEB 150,A02,193285,Staff,24,0,32,8
1683687959515,BIEB 194,A00,193286,Kurle; Carolyn M.,19,0,32,13
1683687960541,BILD 1,A01,192291,Staff,15,0,32,17
1683687960541,BILD 1,A02,192292,Staff,30,0,32,2
1683687960541,BILD 1,B01,192520,Reuther; Keefe,0,1,0,0
1683687960541,BILD 1,B02,192532,Reuther; Keefe,0,1,0,0
1683687961567,BILD 3,A01,192556,Butler; Shannon Rhey,0,0,32,32
1683687961567,BILD 3,A02,192581,Butler; Shannon Rhey,0,1,32,32
1683687961567,BILD 3,A03,192611,Butler; Shannon Rhey,19,0,32,13
1683687961567,BILD 3,A04,192612,Butler; Shannon Rhey,24,0,32,8
1683687961567,BILD 3,A05,192613,Butler; Shannon Rhey,26,0,32,6
1683687961567,BILD 3,A06,192679,Butler; Shannon Rhey,27,0,32,5
1683687961567,BILD 3,A07,192682,Butler; Shannon Rhey,20,0,32,12
1683687962606,BILD 4,A01,192836,Reuther; Keefe,1,0,24,23
1683687962606,BILD 4,A02,193044,Reuther; Keefe,4,0,24,20
1683687963630,BILD 10,A01,193142,Gustafson-Brown; Cindy,29,0,32,3
1683687963630,BILD 10,A02,193149,Gustafson-Brown; Cindy,31,0,32,1
1683687964658,BIMM 100,A01,193301,Staff,0,6,32,32
1683687964658,BIMM 100,A02,193312,Staff,0,7,32,32
1683687964658,BIMM 100,A03,193323,Staff,0,10,32,32
1683687965687,BIMM 101,A01,193329,McDonnell; Lisa Marie,1,4,24,23
1683687965687,BIMM 101,A02,193339,McDonnell; Lisa Marie,1,4,24,23
1683687965687,BIMM 101,B01,193354,McDonnell; Lisa Marie,0,4,24,24
1683687965687,BIMM 101,B02,193357,McDonnell; Lisa Marie,0,3,24,24
1683687966711,BIMM 110,A01,193377,Tat; John,0,11,32,32
1683687966711,BIMM 110,A02,193378,Tat; John,0,11,32,32
1683687967736,BIMM 120,A01,206116,Staff,0,0,32,32
1683687967736,BIMM 120,A02,206117,Staff,7,0,32,25
1683687967736,BIMM 120,A03,206121,Staff,21,0,32,11
1683687968761,BIPN 100,A01,193393,Park; Ji Young,0,15,32,32
1683687968761,BIPN 100,A02,193402,Park; Ji Young,0,14,32,32
1683687968761,BIPN 100,A03,193413,Park; Ji Young,0,14,32,32
1683687968761,BIPN 100,A04,193414,Park; Ji Young,0,13,32,32
1683687969789,BIPN 102,A01,193429,Staff,0,0,32,32
1683687969789,BIPN 102,A02,193438,Staff,18,0,32,14
1683687970812,BIPN 106,A01,193450,Reyes Gonzalez; Catalina,0,2,40,40
1683687971838,BIPN 134,A01,193465,Cooke; James Edward,0,0,32,32
1683687971838,BIPN 134,A02,193474,Cooke; James Edward,25,0,32,7
1683687971838,BIPN 134,A03,193485,Cooke; James Edward,29,0,32,3
1683687971838,BIPN 134,A04,193486,Cooke; James Edward,20,0,32,12
1683687971838,BIPN 134,A05,193491,Cooke; James Edward,31,0,32,1
1683687971838,BIPN 134,A06,193501,Cooke; James Edward,30,0,32,2
1683687971838,BIPN 134,A07,193510,Cooke; James Edward,29,0,32,3
1683687973888,BISP 194,A00,222522,Staff,14,0,32,18
1683687974915,CAT 124,A01,202407,Staff,19,0,25,6
1683687975942,CAT 125,A00,202408,Marchisotto; Jennifer Anne,2,0,20,18
1683687976965,CAT 125R,A00,202409,Smith; Lauryn Alissa,0,11,20,20
1683687976965,CAT 125R,B00,202410,Morales; Celeste Georgianna,0,11,20,20
1683687976965,CAT 125R,C00,202411,Irwin; Matthew Joseph,0,12,20,20
1683687977990,CENG 15,A01,204712,Yang; Kesong,0,1,0,0
1683687979019,CENG 114,A00,202070,Jahed Motlagh; Zeinab,5,0,20,15
1683687980044,CGS 105,A00,185477,Wesling; Megan E.,24,0,40,16
1683687981067,CGS 106,A00,185494,Staff,11,0,22,11
1683687982092,CGS 108,A00,185495,Staff,14,0,20,6
1683687983117,CGS 114,A00,185496,Staff,13,0,18,5
1683687984144,CGS 119,A00,185501,Staff,15,0,20,5
1683687985168,CGS 120,A00,185511,Staff,12,0,20,8
1683687986193,CHEM 4,A01,184675,Bussey; Thomas J,97,0,100,3
1683687987218,CHEM 6A,A01,184677,Staff,32,0,60,28
1683687988241,CHEM 6B,A01,184679,Staff,63,0,100,37
1683687989265,CHEM 6C,A01,184681,Bussey; Thomas J,0,0,50,50
1683687989265,CHEM 6C,A02,184682,Bussey; Thomas J,32,0,50,18
1683687990292,CHEM 40A,A01,184684,Albizati; Kim F.,33,0,100,67
1683687991317,CHEM 40B,A01,184686,Albizati; Kim F.,0,22,100,100
1683687992340,CHEM 41B,A01,184690,Staff,51,0,100,49
1683687993364,COGS 3,A01,184715,Boyle; Mary E. T.,0,27,40,40
1683687994390,COGS 14B,A01,185172,Staff,0,14,38,38
1683687995415,COGS 18,A01,184736,Staff,14,0,80,66
1683687996440,COGS 100,A01,184932,Staff,0,8,73,73
1683687997466,COGS 101A,A01,184935,Staff,0,40,30,30
1683687998499,COGS 101B,A01,184944,Staff,0,2,30,30
1683687999523,COGS 101C,A01,184946,Staff,0,10,30,30
1683688000551,COGS 102A,A01,184951,Johnson; Christine M.,1,0,40,39
1683688001574,COGS 107B,A01,184953,Mooshagian; Eric Frederick,0,52,40,40
1683688002599,COGS 118B,A01,184959,Gupta; Anjum,0,50,40,40
1683688003623,COGS 153,A00,184961,Staff,0,16,30,30
1683688004651,COGS 177,A00,184962,Staff,1,21,30,29
1683688005675,COGS 187A,A01,184969,Boyle; Mary E. T.,0,19,40,40
1683688006700,COMM 10,A01,185174,Staff,0,5,25,25
1683688006700,COMM 10,A02,185189,Staff,0,2,25,25
1683688006700,COMM 10,A03,269821,Staff,0,1,0,0
1683688007726,COMM 100B,A02,185476,Staff,10,0,25,15
1683688007726,COMM 100B,A03,277340,Staff,25,0,25,0
1683688008755,COMM 100C,A01,185314,Staff,1,0,25,24
1683688008755,COMM 100C,A02,185327,Staff,17,0,25,8
1683688009779,COMM 110M,A00,185349,Staff,0,0,40,40
1683688010804,COMM 113T,A00,185352,Staff,25,0,40,15
1683688011831,COMM 114I,A00,185353,Staff,31,0,40,9
1683688012858,COMM 131,A00,185354,Staff,17,0,30,13
1683688013885,CSE 8A,A50,185358,Cao; Yingjun,0,46,10,10
1683688014913,CSE 8B,A01,185362,Staff,0,48,50,50
1683688016011,CSE 11,A01,185416,Cao; Yingjun,0,91,10,10
1683688017035,CSE 20,A01,185445,Briones; Jor-el Thomas Caparas,3,0,25,22
1683688018059,CSE 21,A01,185447,Staff,9,0,50,41
1683688019083,CSE 101,A01,185451,Staff,0,13,50,50
1683688019083,CSE 101,B01,185453,Jones; Miles E,0,14,50,50
1683688021135,CSE 141,A01,185458,Eldon; John,16,0,100,84
1683688022159,CSE 141L,A01,185461,Eldon; John,8,0,100,92
1683688023185,CSE 142,A01,185463,Staff,34,0,60,26
1683688023185,CSE 142,B01,201355,Staff,0,7,60,60
1683688024214,CSE 142L,A01,185470,Staff,34,0,60,26
1683688024214,CSE 142L,B01,201417,Staff,0,6,60,60
1683688025238,CSE 190,A00,201433,Staff,32,0,49,17
1683688026262,DOC 1,A01,259136,Strom; Megan C.,7,0,15,8
1683688026262,DOC 1,A02,259137,Strom; Megan C.,14,0,15,1
1683688026262,DOC 1,A03,259138,Strom; Megan C.,14,0,15,1
1683688026262,DOC 1,A04,259139,Strom; Megan C.,14,0,15,1
1683688027286,DOC 100D,A00,259140,Pass; Natalye Joann,14,0,25,11
1683688028311,DSGN 1,A01,184749,Rill; Bryan,0,26,30,30
1683688029338,DSGN 100,A01,185168,Staff,0,2,25,25
1683688030363,ECE 5,A01,185626,Morris; Karcher William,0,12,0,0
1683688031390,ECE 101,A01,185628,Staff,14,0,70,56
1683688032414,ECE 107,A01,185635,Baghdadchi; Saharnaz,0,0,20,20
1683688032414,ECE 107,A02,185638,Baghdadchi; Saharnaz,1,0,20,19
1683688033437,ECE 148,A01,185647,Silberman; Jack,0,0,16,16
1683688034462,ECON 1,A01,185537,Crane; Meredith Helen,54,0,70,16
1683688035490,ECON 3,A01,185549,Crane; Meredith Helen,30,0,70,40
1683688036515,ECON 4,A01,203354,Anderson; John Charles,0,5,10,10
1683688037539,ECON 100A,A01,185574,Staff,0,5,40,40
1683688038564,ECON 100B,A01,185576,Staff,0,12,50,50
1683688039590,ECON 100C,A01,185589,Newhouse; Herbert S,30,0,70,40
1683688040617,ECON 105,A00,185608,Vespa; Emanuel Ignacio,19,0,35,16
1683688041644,ECON 109,A01,185610,Shishkin; Denis,9,0,35,26
1683688042669,ECON 110A,A01,185612,Staff,8,0,40,32
1683688043697,ECON 120A,A01,185615,Staff,19,0,40,21
1683688044720,ECON 120C,A01,185617,Sun; Yixiao,0,21,70,70
1683688045745,ECON 144,A00,203346,Squires; Dale E,2,0,35,33
1683688046774,ECON 171,A01,203349,Newhouse; Herbert S,0,1,35,35
1683688047801,ECON 173A,A01,185621,Toda; Alexis Akira,21,0,35,14
1683688048829,EDS 25,A01,202413,Staff,0,1,0,0
1683688048829,EDS 25,A02,202414,Staff,0,1,0,0
1683688048829,EDS 25,A03,202415,Staff,0,0,0,0
1683688048829,EDS 25,A04,202416,Staff,0,1,0,0
1683688048829,EDS 25,A05,202439,Staff,0,0,0,0
1683688048829,EDS 25,A06,202440,Staff,0,0,0,0
1683688048829,EDS 25,B01,202631,Staff,0,0,0,0
1683688048829,EDS 25,B02,202632,Staff,0,0,0,0
1683688048829,EDS 25,B03,202639,Staff,0,0,0,0
1683688048829,EDS 25,B04,202640,Staff,0,0,0,0
1683688048829,EDS 25,B05,202643,Staff,0,0,0,0
1683688048829,EDS 25,B06,202644,Staff,0,0,0,0
1683688049857,EDS 38,A01,202659,Black; Alison Michelle,24,0,25,1
1683688050885,EDS 115,A00,202652,Staff,18,0,30,12
1683688051909,EDS 125,A00,202649,Staff,13,0,30,17
1683688052937,EDS 126,A01,203332,Staff,30,0,30,0
1683688053960,EDS 139,A00,202838,Staff,16,0,25,9
1683688054985,EDS 146,A01,202655,Staff,14,0,25,11
1683688056008,ENG 15,A00,185667,Staff,0,1,0,0
1683688056008,ENG 15,B00,185672,Staff,0,0,0,0
1683688056008,ENG 15,C00,185675,Staff,0,0,0,0
1683688056008,ENG 15,D00,185682,Staff,0,0,0,0
1683688056008,ENG 15,E00,185684,Staff,0,0,0,0
1683688057035,ETHN 103,A00,185710,Staff,0,8,35,35
1683688058059,ETHN 103A,A00,199228,Man; Simeon S,0,0,9,9
1683688059084,ETHN 109,A00,185711,Staff,15,0,35,20
1683688060108,ETHN 142,A00,185726,Staff,0,4,30,30
1683688061133,ETHN 163J,A00,199229,Man; Simeon S,5,0,8,3
1683688062157,ETHN 168,A00,185727,Staff,7,0,10,3
1683688063182,ETHN 182,A00,185728,Staff,0,0,35,35
1683688064207,ETHN 183,A00,185737,Staff,9,0,18,9
1683688065232,GLBH 111,A01,209361,Burgos; Jose L.,0,0,0,0
1683688067283,HIEU 104,A00,185792,Staff,14,0,20,6
1683688068308,HIEU 115,A00,185800,Staff,0,0,20,20
1683688069336,HIEU 128,A00,185801,Staff,0,9,20,20
1683688070360,HIEU 147,A00,185802,Staff,15,0,20,5
1683688071385,HIEU 154,A00,185823,Staff,11,0,20,9
1683688072412,HILA 102,A00,185826,Staff,14,0,20,6
1683688073439,HILD 2C,A01,185778,Staff,0,13,20,20
1683688074464,HILD 7B,A01,185780,Kwak; Nancy,0,17,32,32
1683688074464,HILD 7B,A02,185781,Kwak; Nancy,0,18,32,32
1683688075488,HILD 30,A01,185791,Staff,12,0,20,8
1683688076512,HISC 119,A00,185830,Golan; Tal,0,10,20,20
1683688077536,HITO 156GS,A00,185831,Patterson; Patrick H.,0,0,0,23
1683688078568,HIUS 103,A00,185832,Man; Simeon S,0,4,20,20
1683688079593,HIUS 117,A00,185836,Kwak; Nancy,2,0,20,18
1683688080619,HIUS 125,A00,185840,Man; Simeon S,0,2,23,23
1683688081643,HIUS 149,A00,185845,Staff,1,0,20,19
1683688082672,HUM 3,A01,185882,Zavodny; Tatiana Sophia,0,8,50,50
1683688082672,HUM 3,B01,185899,Caldwell; Michael Alan,0,18,50,50
1683688083699,HUM 3GS,A00,185900,Patterson; Patrick H.,0,0,0,23
1683688084725,HUM 4,A01,185938,Zroka; Amy Liane,28,0,50,22
1683688084725,HUM 4,B01,185956,Watkins; Eric,0,6,50,50
1683688084725,HUM 4,B02,202209,Watkins; Eric,0,5,50,50
1683688084725,HUM 4,B03,202210,Watkins; Eric,0,5,50,50
1683688085751,HUM 5,A01,185958,West; Geoffrey Scott,0,0,50,50
1683688085751,HUM 5,A02,202215,West; Geoffrey Scott,0,0,50,50
1683688086775,INTL 190,A00,185959,Gagnon; Jeffrey C,0,0,0,9
1683688086775,INTL 190,B00,185960,Lettieri; Michael Joseph,0,0,0,2
1683688087802,JAPN 180,A00,254509,Staff,5,0,30,25
1683688088833,LATI 10,A01,202853,Kennemore; Amy Michelle,4,0,35,31
1683688088833,LATI 10,A02,202854,Kennemore; Amy Michelle,3,0,35,32
1683688088833,LATI 10,A03,270054,Kennemore; Amy Michelle,30,0,30,0
1683688089858,LATI 180,A00,202855,Kennemore; Amy Michelle,11,0,20,9
1683688090886,LAWS 101,A00,201767,Golan; Tal,0,7,40,40
1683688091911,LIFR 1C,A00,185961,Staff,6,0,20,14
1683688092935,LIFR 1CX,A00,185962,Staff,7,0,20,13
1683688093959,LIFR 1D,A00,185963,Staff,7,0,20,13
1683688094984,LIFR 1DX,A00,185964,Staff,7,0,20,13
1683688096008,LIGN 101,A01,186039,Staff,43,0,50,7
1683688097037,LIGN 165,A00,186040,Staff,15,0,50,35
1683688098060,LTCS 108,A00,186041,Staff,5,0,10,5
1683688099085,LTCS 119,A00,186042,Staff,15,0,20,5
1683688100111,LTCS 130,A00,186043,Wesling; Megan E.,15,0,25,10
1683688102162,LTEA 138,A00,186119,Staff,14,0,40,26
1683688103187,LTEN 124,A00,186148,Staff,5,0,25,20
1683688104217,LTEN 178,A00,186149,Staff,6,0,15,9
1683688105241,LTEN 181,A00,186150,Blanco; John D,34,0,40,6
1683688106269,LTWL 120,A00,186160,Staff,19,0,25,6
1683688107293,LTWL 165,A00,186161,Staff,22,0,25,3
1683688108319,LTWR 100,A00,186162,Staff,0,5,15,15
1683688109347,LTWR 102,A00,186163,Doller; Ben,5,0,15,10
1683688110372,MAE 8,A01,186412,Staff,0,1,0,0
1683688111397,MAE 30B,A00,186445,Bahadori; Mohammad Yousef,81,0,100,19
1683688112425,MAE 40,A00,186592,Bewley; Thomas R,10,0,50,40
1683688113449,MAE 101B,A00,186593,Bahadori; Mohammad Yousef,80,0,100,20
1683688114472,MAE 105,A00,186594,Bandaru; Prabhakar,10,0,50,40
1683688115497,MAE 107,A00,186599,Pham; Hieu Tan,0,7,120,120
1683688116521,MAE 148,A01,186660,Silberman; Jack,3,0,16,13
1683688117546,MATH 10A,A01,188095,Staff,0,6,35,35
1683688118572,MATH 10B,A01,188097,Bowers; Adam R.,0,12,30,30
1683688118572,MATH 10B,A02,188099,Bowers; Adam R.,0,11,30,30
1683688118572,MATH 10B,B01,188104,Bowers; Adam R.,0,10,30,30
1683688118572,MATH 10B,B02,188106,Bowers; Adam R.,1,9,30,29
1683688119655,MATH 10C,A01,188111,Staff,0,20,30,30
1683688119655,MATH 10C,A02,188127,Staff,0,19,30,30
1683688119655,MATH 10C,A03,188131,Staff,0,19,30,30
1683688119655,MATH 10C,B01,188218,Staff,17,0,30,13
1683688119655,MATH 10C,B02,188244,Staff,13,0,30,17
1683688119655,MATH 10C,B03,188277,Staff,14,0,30,16
1683688120680,MATH 18,A01,188344,Bach; Quang Tran,18,0,30,12
1683688120680,MATH 18,A02,188345,Bach; Quang Tran,11,0,30,19
1683688120680,MATH 18,B01,188353,Bach; Quang Tran,11,0,30,19
1683688120680,MATH 18,B02,188354,Bach; Quang Tran,19,0,30,11
1683688121708,MATH 20A,A01,188374,Staff,11,0,35,24
1683688122733,MATH 20B,A01,188382,Ohm; Ko Woon,7,0,30,23
1683688122733,MATH 20B,A02,188383,Ohm; Ko Woon,22,0,30,8
1683688122733,MATH 20B,B01,188385,Ohm; Ko Woon,7,0,30,23
1683688122733,MATH 20B,B02,188392,Ohm; Ko Woon,22,0,30,8
1683688123760,MATH 20C,A01,188394,Harel; Guershon,10,0,30,20
1683688123760,MATH 20C,A02,188395,Harel; Guershon,13,0,30,17
1683688123760,MATH 20C,B01,188404,Harel; Guershon,5,0,30,25
1683688123760,MATH 20C,B02,188405,Harel; Guershon,18,0,30,12
1683688124786,MATH 20D,A01,188414,Hammock; Frances H,0,1,30,30
1683688124786,MATH 20D,A02,188415,Hammock; Frances H,0,1,30,30
1683688124786,MATH 20D,B01,188447,Hammock; Frances H,0,1,30,30
1683688124786,MATH 20D,B02,188486,Hammock; Frances H,2,0,30,28
1683688125812,MATH 20E,A01,188649,Staff,21,0,30,9
1683688125812,MATH 20E,A02,188650,Staff,20,0,30,10
1683688125812,MATH 20E,A03,188673,Staff,0,0,30,30
1683688126842,MATH 102,A01,188675,Staff,0,40,35,35
1683688127867,MATH 103B,A01,188681,Staff,3,0,35,32
1683688127867,MATH 103B,B01,188692,Staff,5,0,35,30
1683688128894,MATH 109,A01,188695,Salehi Golsefidy; Alireza,24,0,35,11
1683688128894,MATH 109,A02,188696,Salehi Golsefidy; Alireza,25,0,35,10
1683688129921,MATH 120A,A01,188698,Eggers; John Dietrich,7,0,35,28
1683688130948,MATH 142B,A01,188736,Ioana; Adrian,1,1,30,29
1683688130948,MATH 142B,A02,188741,Ioana; Adrian,0,1,30,30
1683688130948,MATH 142B,A03,188743,Ioana; Adrian,0,2,30,30
1683688131976,MATH 168A,A01,188790,Staff,0,11,35,35
1683688133002,MATH 170A,A01,188803,Nie; Jiawang,0,2,35,35
1683688133002,MATH 170A,A02,188811,Nie; Jiawang,0,1,35,35
1683688133002,MATH 170A,A03,188814,Nie; Jiawang,0,0,35,35
1683688133002,MATH 170A,A04,188815,Nie; Jiawang,5,0,35,30
1683688134026,MATH 193B,A01,188817,Staff,0,0,35,35
1683688134026,MATH 193B,A02,188818,Staff,6,0,35,29
1683688135051,MGT 4,A01,202857,Anderson; John Charles,59,0,80,21
1683688136075,MGT 12,A00,202858,Lindenberger; Wade Douglas,40,0,90,50
1683688137102,MGT 18,A00,202859,Staff,74,0,90,16
1683688138126,MGT 18GS,A00,202860,McKay; Michael J,13,0,28,15
1683688139155,MGT 45,A00,202861,Pecore; Joseph P.,8,0,90,82
1683688140182,MGT 100,A00,202863,Yavorsky; Daniel Ryan,27,0,90,63
1683688141207,MGT 103,A00,202864,Ehrich; Kristine R,0,19,90,90
1683688142235,MGT 112,A00,202865,Ehrich; Kristine R,15,0,90,75
1683688143262,MGT 121A,A00,202868,Staff,90,20,90,0
1683688144292,MGT 131B,A00,202869,Anderson; John Charles,59,0,90,31
1683688145319,MGT 136,A00,202871,Lindenberger; Wade Douglas,83,0,90,7
1683688146347,MGT 164,A00,202873,Staff,0,67,90,91
1683688147374,MGT 164GS,A00,202874,McKay; Mary A,13,0,28,15
1683688148399,MGT 180,A00,202875,Staff,0,51,90,91
1683688149425,MMW 11R,A01,205019,Herbst; Matthew,0,0,30,30
1683688149425,MMW 11R,A02,205026,Herbst; Matthew,29,0,30,1
1683688150451,MMW 15,A01,193512,Chang; Edmond Yi-Teh,0,8,28,28
1683688150451,MMW 15,A02,193513,Chang; Edmond Yi-Teh,0,5,28,28
1683688150451,MMW 15,A03,193514,Chang; Edmond Yi-Teh,0,5,28,28
1683688150451,MMW 15,A04,193515,Chang; Edmond Yi-Teh,0,5,28,28
1683688150451,MMW 15,A05,193516,Chang; Edmond Yi-Teh,0,5,28,28
1683688150451,MMW 15,A06,193517,Chang; Edmond Yi-Teh,0,6,28,28
1683688150451,MMW 15,B01,193519,Chang; Edmond Yi-Teh,0,5,28,28
1683688150451,MMW 15,B02,193520,Chang; Edmond Yi-Teh,0,5,28,28
1683688150451,MMW 15,B03,193521,Chang; Edmond Yi-Teh,0,5,28,28
1683688150451,MMW 15,B04,193522,Chang; Edmond Yi-Teh,0,6,28,28
1683688150451,MMW 15,B05,193523,Chang; Edmond Yi-Teh,0,5,28,28
1683688150451,MMW 15,B06,193524,Chang; Edmond Yi-Teh,0,5,28,28
1683688151475,MMW 122,A01,193526,Rahimi; Babak,0,16,28,28
1683688151475,MMW 122,A02,193527,Rahimi; Babak,0,15,28,28
1683688151475,MMW 122,A03,193528,Rahimi; Babak,0,0,0,0
1683688151475,MMW 122,A04,193529,Rahimi; Babak,0,0,0,0
1683688152499,MUS 1A,A01,186663,Staff,1,19,35,34
1683688153523,MUS 4,A01,186715,Staff,0,12,35,35
1683688154548,MUS 5R,A01,186796,Dubnov; Shlomo,0,17,35,35
1683688155573,MUS 6,A01,186798,Staff,1,5,25,24
1683688156597,MUS 7,A01,186830,Staff,11,0,35,24
1683688157624,MUS 8,A01,186930,Staff,0,27,35,35
1683688158650,MUS 15,A01,186932,Staff,0,15,35,35
1683688158650,MUS 15,B01,186934,Staff,1,17,35,34
1683688159675,MUS 80,A00,186935,Staff,0,0,20,20
1683688159675,MUS 80,B00,186936,Staff,24,0,25,1
1683688160702,NANO 11,A00,204702,Lipomi; Darren John,0,0,0,0
1683688161728,NANO 15,A01,204709,Yang; Kesong,0,1,0,0
1683688162752,NANO 114,A00,202069,Jahed Motlagh; Zeinab,2,0,10,8
1683688163776,PHIL 1,A00,186955,Grush; Rick Scott,31,0,40,9
1683688164800,PHIL 10,A01,186973,Grush; Rick Scott,27,0,35,8
1683688164800,PHIL 10,A02,186974,Grush; Rick Scott,33,0,35,2
1683688165827,PHIL 13,A01,186976,Staff,1,0,35,34
1683688165827,PHIL 13,A02,186977,Staff,16,0,35,19
1683688166851,PHIL 14,A01,186979,Staff,31,0,35,4
1683688166851,PHIL 14,A02,186986,Staff,32,0,35,3
1683688167876,PHIL 28,A01,186988,Staff,16,0,30,14
1683688167876,PHIL 28,A02,186989,Staff,1,0,30,29
1683688167876,PHIL 28,A03,186990,Staff,10,0,30,20
1683688167876,PHIL 28,A04,186991,Staff,26,0,30,4
1683688168898,PHIL 120,A00,186997,Staff,23,0,40,17
1683688169921,PHIL 137,A00,187003,Staff,7,0,40,33
1683688170948,PHIL 150,A00,187015,Staff,47,0,70,23
1683688171973,PHIL 167,A00,187021,Lamey; Andy M.,34,0,40,6
1683688172997,PHIL 174,A01,202226,Staff,17,0,20,3
1683688172997,PHIL 174,A02,202235,Staff,20,0,20,0
1683688174024,PHIL 191A,A00,258918,Staff,0,0,1,1
1683688175052,PHYS 1A,A00,187028,Staff,26,0,60,34
1683688176076,PHYS 1AL,001,187036,Staff,3,0,30,27
1683688176076,PHYS 1AL,002,187049,Staff,18,0,30,12
1683688177104,PHYS 1B,A00,187058,Staff,22,0,60,38
1683688178131,PHYS 1BL,001,187064,Staff,0,1,30,30
1683688178131,PHYS 1BL,002,187070,Staff,4,0,30,26
1683688179157,PHYS 1C,A00,187082,Staff,29,0,120,91
1683688180185,PHYS 1CL,001,187088,Staff,0,9,30,30
1683688180185,PHYS 1CL,002,187089,Staff,0,1,30,30
1683688180185,PHYS 1CL,009,262693,Staff,9,0,30,21
1683688181211,PHYS 2B,A01,187097,Staff,55,0,115,60
1683688182238,PHYS 2C,A01,187099,Staff,63,0,115,52
1683688183265,PHYS 2CL,A01,187101,Staff,5,0,28,23
1683688183265,PHYS 2CL,A02,187102,Staff,15,0,28,13
1683688184289,PHYS 2D,A01,187123,Shotwell; Brian,95,0,115,20
1683688185316,PHYS 4B,A01,187133,Grinstein; Benjamin,35,0,50,15
1683688186341,POLI 10,A00,188819,Staff,0,4,50,50
1683688187365,POLI 11,A00,188827,Staff,43,0,50,7
1683688188390,POLI 13R,A00,188828,Staff,0,1,20,20
1683688189412,POLI 27,A01,188830,Elgin; Samuel Zincke,0,2,70,70
1683688190439,POLI 30,A00,188832,Desposato; Scott,30,0,50,20
1683688191463,POLI 102F,A00,188834,Staff,1,0,40,39
1683688192487,POLI 104A,A00,188852,Staff,12,0,30,18
1683688193514,POLI 104I,A00,188853,Staff,0,8,20,20
1683688194538,POLI 110B,A00,188854,Wiens; David,6,0,20,14
1683688195563,POLI 112A,A00,188855,Wiens; David,3,0,30,27
1683688196591,POLI 117R,A00,188856,Forman; Fonna,0,12,20,20
1683688197619,POLI 118,A00,188857,Ingham; Sean,8,0,20,12
1683688198647,POLI 120G,A00,188858,Staff,8,0,30,22
1683688199674,POLI 131CR,A00,188863,Hoston; Germaine,20,0,50,30
1683688200699,POLI 133,A00,188864,Nellis; Gareth Hb,44,0,50,6
1683688201722,POLI 134D,A00,188865,Desposato; Scott,27,0,30,3
1683688202747,POLI 142A,A00,188871,Gartzke; Erik,21,0,50,29
1683688203775,POLI 142K,A00,188874,Staff,38,0,50,12
1683688204803,POLI 143,A00,188940,Gartzke; Erik,16,0,30,14
1683688205827,POLI 153,A00,188943,Staff,2,0,20,18
1683688206855,POLI 160AA,A00,188944,Staff,10,0,40,30
1683688207882,POLI 170A,A00,188945,Staff,10,0,30,20
1683688209936,PSYC 1,A00,188952,Staff,36,0,90,54
1683688210963,PSYC 2,B00,188953,Staff,19,0,35,16
1683688211990,PSYC 6,A00,188970,Staff,47,0,60,13
1683688213014,PSYC 7,A00,188973,Staff,35,0,45,10
1683688214041,PSYC 60,A01,188980,Rickard; Timothy C.,42,0,60,18
1683688215065,PSYC 70,A01,189001,Steiner; Eric Tomas,21,0,45,24
1683688216088,PSYC 100,A00,189005,Lacefield; Katharine I,0,99,120,120
1683688217113,PSYC 102,A00,189008,Staff,7,0,30,23
1683688218140,PSYC 106,B00,189026,Gorman; Michael R.,27,0,60,33
1683688219165,PSYC 114,B01,189033,Winkielman; Piotr,0,31,30,30
1683688220189,PSYC 131,A00,189036,Anagnostaras; Stephan,0,43,60,60
1683688221214,PSYC 136,A00,189041,Lowe; Angela Beth,0,7,25,25
1683688222238,PSYC 137,A00,189057,Winkielman; Piotr,1,37,25,24
1683688223324,PSYC 144,A00,189107,Wixted; John T,0,11,50,50
1683688225375,PSYC 162,A00,189142,Staff,0,9,85,85
1683688226402,PSYC 172,A00,189144,Gorman; Michael R.,0,6,30,30
1683688228457,PSYC 179,A00,189146,Lacefield; Katharine I,0,88,120,120
1683688229485,PSYC 181,A00,189147,Anagnostaras; Stephan,0,44,90,90
1683688230509,PSYC 190R,A00,189148,Barner; David A.,0,23,80,80
1683688231532,PSYC 191,A00,189275,Rickard; Timothy C.,0,11,25,25
1683688232556,PSYC 193,A00,189276,Chapman; Eddie Nathaniel,0,1,0,4
1683688233582,PSYC 193L,A01,189281,Lowe; Angela Beth,8,0,20,12
1683688233582,PSYC 193L,B01,189285,Staff,28,0,35,7
1683688234610,RELI 149,A00,187137,Rahimi; Babak,6,0,40,34
1683688235639,SE 9,A01,187315,Staff,0,2,18,18
1683688236666,SE 101B,A00,187409,Staff,24,0,30,6
1683688237690,SE 110B,A00,187444,Staff,10,0,40,30
1683688238715,SE 130B,A00,187449,Staff,31,0,40,9
1683688239738,SE 150A,A00,187516,Staff,8,0,20,12
1683688240767,SE 154,A00,187528,Staff,29,0,50,21
1683688241791,SIO 3,A01,258171,Staff,35,0,40,5
1683688242818,SIO 10,A00,187144,Cook; Geoffrey W,1,7,75,74
1683688243845,SIO 45,A00,187152,Cook; Geoffrey W,0,7,100,100
1683688244870,SIO 109R,A00,194486,Staff,0,4,20,20
1683688246923,SIO 187,A01,187233,Kacev; David,12,0,40,28
1683688247948,SOCI 1,A01,258656,Thorpe; Charles Robert,28,0,30,2
1683688247948,SOCI 1,A02,258658,Thorpe; Charles Robert,30,0,30,0
1683688247948,SOCI 1,A03,258661,Thorpe; Charles Robert,25,0,25,0
1683688247948,SOCI 1,A04,258666,Thorpe; Charles Robert,22,0,25,3
1683688247948,SOCI 1,A05,258897,Thorpe; Charles Robert,22,0,25,3
1683688247948,SOCI 1,A06,258898,Thorpe; Charles Robert,25,0,25,0
1683688248972,SOCI 30,A01,258903,Pardo Guerra; Juan Pablo,14,0,30,16
1683688249997,SOCI 102,A00,258904,Staff,9,0,25,16
1683688251022,SOCI 106,A00,258905,Staff,19,0,25,6
1683688252047,SOCI 111,A00,258907,Ribas Norris; Janet Vanesa,26,0,30,4
1683688253071,SOCI 121R,A00,258908,Pardo Guerra; Juan Pablo,8,0,30,22
1683688254099,SOCI 126,A01,203330,Staff,14,0,20,6
1683688255128,SOCI 131,A00,258909,Thorpe; Charles Robert,30,0,60,30
1683688256152,SOCI 135,A00,258910,Payne; Christine Anna,0,12,30,30
1683688257176,SOCI 157,A00,258911,Staff,11,0,30,19
1683688258202,SOCI 184,A00,258912,Staff,25,0,30,5
1683688259225,SOCI 188D,A00,258913,Staff,22,0,30,8
1683688260250,SYN 2,001,187529,Staff,9,0,16,7
1683688260250,SYN 2,002,201452,Staff,1,20,16,15
1683688260250,SYN 2,003,201469,Staff,1,0,16,15
1683688261274,SYN 100,A01,187531,Staff,0,9,20,20
1683688261274,SYN 100,B01,201491,Staff,0,10,20,20
1683688262302,TDAC 1,A00,189286,Walsh; Kim C.,3,0,20,17
1683688262302,TDAC 1,B00,189287,Harting; Carla Kelso,10,0,20,10
1683688263326,TDAC 101,A00,189300,Walsh; Kim C.,16,0,20,4
1683688263326,TDAC 101,B00,189301,Harting; Carla Kelso,18,0,20,2
1683688264354,TDAC 102,A00,189304,Basso; Beatrice,14,0,20,6
1683688265380,TDAC 108,A00,189305,Staff,18,0,20,2
1683688266406,TDDE 131,A00,189310,Staff,19,0,20,1
1683688266406,TDDE 131,B00,189314,Staff,19,0,20,1
1683688266406,TDDE 131,C00,189315,Staff,48,0,50,2
1683688266406,TDDE 131,D00,189316,Staff,14,0,15,1
1683688266406,TDDE 131,E00,204841,Staff,20,0,20,0
1683688267430,TDGE 10,A00,189289,Staff,27,0,50,23
1683688267430,TDGE 10,B00,189290,Havis; Allan,0,1,50,50
1683688268460,TDGE 11,A00,189291,Fulton; Julia,0,4,50,50
1683688268460,TDGE 11,B00,189292,Staff,20,0,25,5
1683688268460,TDGE 11,C00,260270,Staff,0,0,0,0
1683688269485,TDGE 25,A00,189294,Staff,1,0,20,19
1683688270508,TDGE 124,A00,189318,Fulton; Julia,1,8,50,49
1683688271532,TDGE 125,A00,189319,Staff,13,0,25,12
1683688271532,TDGE 125,B00,189320,Staff,23,0,25,2
1683688272557,TDGE 127,A00,189322,Havis; Allan,0,0,50,50
1683688273586,TDHT 101,A00,189323,Staff,18,0,25,7
1683688273586,TDHT 101,B00,189324,Staff,25,0,25,0
1683688274617,TDHT 102,A00,189325,Staff,49,0,50,1
1683688275641,TDMV 1,A00,189295,Arcidiacono; Kristin,20,0,30,10
1683688275641,TDMV 1,B00,189296,Caligagan; Maria T.,24,0,30,6
1683688276666,TDMV 2,A00,189297,Sammartano; Tonnie,27,0,30,3
1683688276666,TDMV 2,B00,189299,Arcidiacono; Kristin,23,0,30,7
1683688277689,TDMV 3,A00,204998,Rincon; Alicia,22,0,30,8
1683688278713,TDMV 120,A00,189458,Sammartano; Tonnie,28,0,30,2
1683688279741,TDMV 138,A00,189541,Jun; Grace Shin Hae,20,0,40,20
1683688280765,TDMV 142,A00,189717,Caligagan; Tony,25,0,30,5
1683688280765,TDMV 142,B00,189718,Caligagan; Maria T.,25,0,30,5
1683688281789,TMC 2,A01,187533,Staff,25,0,25,0
1683688281789,TMC 2,A02,187534,Staff,25,0,25,0
1683688282818,USP 1,A01,187536,Kwak; Nancy,0,16,25,25
1683688283846,USP 5,A01,187538,Staff,8,0,25,17
1683688284870,USP 101,A00,199253,Staff,0,4,0,0
1683688285894,USP 124,A00,187562,Boomhower; Matthew Charles,0,0,30,30
1683688286918,USP 138,A00,187582,Staff,19,0,25,6
1683688287942,USP 152,A01,187597,Staff,3,0,25,22
1683688288965,USP 153,A00,187598,Staff,18,0,25,7
1683688289990,USP 168,A00,187607,Kwak; Nancy,2,0,5,3
1683688291014,USP 173,A00,187619,Staff,4,0,25,21
1683688292037,USP 181,A00,187638,Staff,0,4,25,25
1683688293065,VIS 103,A00,187650,Cruz; Edwin Teddy,17,0,75,58
1683688294088,VIS 110D,A00,187669,Staff,13,0,22,9
1683688295113,VIS 127C,A00,187720,Shen; Kuiyi,67,0,146,79
1683688296140,VIS 149,A00,187731,Yoldas; Pinar,1,14,22,21
1683688297163,VIS 151,A01,188091,Staff,22,0,34,12
1683688297163,VIS 151,A02,188092,Staff,11,0,34,23
1683688298186,VIS 160B,A00,188093,Stalbaum; Brett,0,1,10,10
1683688300235,WCWP 10B,A00,201720,Staff,0,0,5,5
1683688300235,WCWP 10B,B00,201722,Staff,0,0,6,6
1683688301259,WCWP 100,A00,201725,Gagnon; Jeffrey C,0,0,2,2
1683688301259,WCWP 100,B00,201727,Staff,0,4,15,15
1683688304388,ANBI 133,A00,258401,Wilder; Linnea Lorene,34,0,40,6
1683688305413,ANBI 140,A00,258395,Hrvoj Mihic; Branka,18,0,25,7
1683688306437,ANSC 120,A00,258402,Bialecki; Jon Anthony,26,0,40,14
1683688307461,ANSC 144,A00,258400,Staff,12,0,40,28
1683688309508,ANSC 166,A00,258396,Parish; Steven Martin,156,0,175,19
1683688310532,ANSC 180,A00,193533,Staff,8,0,20,12
1683688311556,ANSC 188,A00,258397,Jassal; Aftab,34,0,40,6
1683688312585,ANTH 3,A01,258316,Staff,23,0,30,7
1683688313609,ANTH 5,A00,258394,Semendeferi; Ekaterini,16,0,20,4
1683688314634,ANTH 21,A01,258331,Staff,4,0,40,36
1683688315663,ANTH 103,A00,258398,Varma; Saiba,15,0,25,10
1683688316696,AWP 10,001,202034,Staff,0,0,0,0
1683688316696,AWP 10,002,202035,Staff,0,0,0,0
1683688316696,AWP 10,003,202036,Staff,0,0,0,0
1683688316696,AWP 10,004,202037,Staff,0,0,0,0
1683688316696,AWP 10,005,202038,Staff,0,0,0,0
1683688316696,AWP 10,006,202039,Staff,0,0,0,0
1683688316696,AWP 10,007,202040,Staff,0,0,0,0
1683688316696,AWP 10,008,202041,Staff,0,0,0,0
1683688316696,AWP 10,009,202042,Staff,0,0,0,0
1683688316696,AWP 10,010,202043,Staff,0,0,0,0
1683688316696,AWP 10,011,202044,Staff,0,0,0,0
1683688316696,AWP 10,012,202045,Staff,0,0,0,0
1683688316696,AWP 10,013,202046,Staff,0,0,0,0
1683688316696,AWP 10,014,202047,Staff,0,0,0,0
1683688316696,AWP 10,015,202048,Staff,0,0,0,0
1683688316696,AWP 10,016,202049,Staff,0,0,0,0
1683688316696,AWP 10,017,202050,Staff,0,0,0,0
1683688316696,AWP 10,018,202051,Staff,0,0,0,0
1683688316696,AWP 10,019,202052,Staff,0,0,0,0
1683688316696,AWP 10,020,202053,Staff,0,0,0,0
1683688316696,AWP 10,021,202054,Staff,0,0,0,0
1683688316696,AWP 10,022,202055,Staff,0,0,0,0
1683688316696,AWP 10,023,202056,Staff,0,0,0,0
1683688316696,AWP 10,024,202057,Staff,0,0,0,0
1683688316696,AWP 10,025,202058,Staff,0,0,0,0
1683688316696,AWP 10,026,202059,Staff,0,0,0,0
1683688317720,AWP 102,001,202032,Staff,0,0,0,0
1683688317720,AWP 102,002,202033,Staff,0,0,0,0
1683688318744,BENG 100,A01,254234,Taylor Amos; Alyssa C,31,0,40,9
1683688319767,BENG 196,001,270013,Engler; Adam J.,9999,0,9999,0
1683688320791,BICD 100R,A01,202018,Smith; Laurie,0,7,32,32
1683688320791,BICD 100R,A02,202019,Smith; Laurie,0,3,32,32
1683688320791,BICD 100R,A03,202020,Smith; Laurie,0,1,32,32
1683688320791,BICD 100R,A04,202021,Smith; Laurie,6,0,32,26
1683688320791,BICD 100R,A05,202022,Smith; Laurie,10,0,32,22
1683688321814,BICD 136,A01,193242,Gustafson-Brown; Cindy,0,2,32,32
1683688321814,BICD 136,A02,193244,Gustafson-Brown; Cindy,13,0,32,19
1683688322838,BIEB 102,A01,193249,Butler; Shannon Rhey,1,1,32,31
1683688322838,BIEB 102,A02,193251,Butler; Shannon Rhey,0,0,32,32
1683688322838,BIEB 102,A03,193253,Butler; Shannon Rhey,0,0,32,32
1683688322838,BIEB 102,A04,193255,Butler; Shannon Rhey,13,0,32,19
1683688322838,BIEB 102,A05,193265,Butler; Shannon Rhey,25,0,32,7
1683688322838,BIEB 102,A06,193269,Butler; Shannon Rhey,13,0,32,19
1683688324893,BIEB 150,A01,193274,Staff,0,0,32,32
1683688324893,BIEB 150,A02,193285,Staff,24,0,32,8
1683688325919,BIEB 194,A00,193286,Kurle; Carolyn M.,19,0,32,13
1683688327006,BILD 1,A01,192291,Staff,15,0,32,17
1683688327006,BILD 1,A02,192292,Staff,30,0,32,2
1683688327006,BILD 1,B01,192520,Reuther; Keefe,0,1,0,0
1683688327006,BILD 1,B02,192532,Reuther; Keefe,0,1,0,0
1683688328036,BILD 3,A01,192556,Butler; Shannon Rhey,0,0,32,32
1683688328036,BILD 3,A02,192581,Butler; Shannon Rhey,0,1,32,32
1683688328036,BILD 3,A03,192611,Butler; Shannon Rhey,19,0,32,13
1683688328036,BILD 3,A04,192612,Butler; Shannon Rhey,24,0,32,8
1683688328036,BILD 3,A05,192613,Butler; Shannon Rhey,26,0,32,6
1683688328036,BILD 3,A06,192679,Butler; Shannon Rhey,27,0,32,5
1683688328036,BILD 3,A07,192682,Butler; Shannon Rhey,20,0,32,12
1683688329064,BILD 4,A01,192836,Reuther; Keefe,1,0,24,23
1683688329064,BILD 4,A02,193044,Reuther; Keefe,4,0,24,20
1683688330092,BILD 10,A01,193142,Gustafson-Brown; Cindy,29,0,32,3
1683688330092,BILD 10,A02,193149,Gustafson-Brown; Cindy,31,0,32,1
1683688331117,BIMM 100,A01,193301,Staff,0,6,32,32
1683688331117,BIMM 100,A02,193312,Staff,0,7,32,32
1683688331117,BIMM 100,A03,193323,Staff,0,10,32,32
1683688332140,BIMM 101,A01,193329,McDonnell; Lisa Marie,1,4,24,23
1683688332140,BIMM 101,A02,193339,McDonnell; Lisa Marie,1,4,24,23
1683688332140,BIMM 101,B01,193354,McDonnell; Lisa Marie,0,4,24,24
1683688332140,BIMM 101,B02,193357,McDonnell; Lisa Marie,0,3,24,24
1683688333169,BIMM 110,A01,193377,Tat; John,0,11,32,32
1683688333169,BIMM 110,A02,193378,Tat; John,0,11,32,32
1683688334194,BIMM 120,A01,206116,Staff,0,0,32,32
1683688334194,BIMM 120,A02,206117,Staff,7,0,32,25
1683688334194,BIMM 120,A03,206121,Staff,21,0,32,11
1683688335218,BIPN 100,A01,193393,Park; Ji Young,0,15,32,32
1683688335218,BIPN 100,A02,193402,Park; Ji Young,0,14,32,32
1683688335218,BIPN 100,A03,193413,Park; Ji Young,0,14,32,32
1683688335218,BIPN 100,A04,193414,Park; Ji Young,0,13,32,32
1683688336248,BIPN 102,A01,193429,Staff,0,0,32,32
1683688336248,BIPN 102,A02,193438,Staff,18,0,32,14
1683688337276,BIPN 106,A01,193450,Reyes Gonzalez; Catalina,0,2,40,40
1683688338302,BIPN 134,A01,193465,Cooke; James Edward,0,0,32,32
1683688338302,BIPN 134,A02,193474,Cooke; James Edward,25,0,32,7
1683688338302,BIPN 134,A03,193485,Cooke; James Edward,29,0,32,3
1683688338302,BIPN 134,A04,193486,Cooke; James Edward,20,0,32,12
1683688338302,BIPN 134,A05,193491,Cooke; James Edward,31,0,32,1
1683688338302,BIPN 134,A06,193501,Cooke; James Edward,30,0,32,2
1683688338302,BIPN 134,A07,193510,Cooke; James Edward,29,0,32,3
1683688340355,BISP 194,A00,222522,Staff,14,0,32,18
1683688341382,CAT 124,A01,202407,Staff,19,0,25,6
1683688342410,CAT 125,A00,202408,Marchisotto; Jennifer Anne,2,0,20,18
1683688343439,CAT 125R,A00,202409,Smith; Lauryn Alissa,0,11,20,20
1683688343439,CAT 125R,B00,202410,Morales; Celeste Georgianna,0,11,20,20
1683688343439,CAT 125R,C00,202411,Irwin; Matthew Joseph,0,12,20,20
1683688344463,CENG 15,A01,204712,Yang; Kesong,0,1,0,0
1683688345488,CENG 114,A00,202070,Jahed Motlagh; Zeinab,5,0,20,15
1683688346514,CGS 105,A00,185477,Wesling; Megan E.,24,0,40,16
1683688347539,CGS 106,A00,185494,Staff,11,0,22,11
1683688348564,CGS 108,A00,185495,Staff,14,0,20,6
1683688349590,CGS 114,A00,185496,Staff,13,0,18,5
1683688350615,CGS 119,A00,185501,Staff,15,0,20,5
1683688351642,CGS 120,A00,185511,Staff,12,0,20,8
1683688352666,CHEM 4,A01,184675,Bussey; Thomas J,97,0,100,3
1683688353691,CHEM 6A,A01,184677,Staff,32,0,60,28
1683688354716,CHEM 6B,A01,184679,Staff,63,0,100,37
1683688355742,CHEM 6C,A01,184681,Bussey; Thomas J,0,0,50,50
1683688355742,CHEM 6C,A02,184682,Bussey; Thomas J,32,0,50,18
1683688356766,CHEM 40A,A01,184684,Albizati; Kim F.,33,0,100,67
1683688357795,CHEM 40B,A01,184686,Albizati; Kim F.,0,22,100,100
1683688358820,CHEM 41B,A01,184690,Staff,51,0,100,49
1683688359844,COGS 3,A01,184715,Boyle; Mary E. T.,0,27,40,40
1683688360872,COGS 14B,A01,185172,Staff,0,14,38,38
1683688361900,COGS 18,A01,184736,Staff,14,0,80,66
1683688362927,COGS 100,A01,184932,Staff,0,8,73,73
1683688363952,COGS 101A,A01,184935,Staff,0,40,30,30
1683688364979,COGS 101B,A01,184944,Staff,0,2,30,30
1683688366008,COGS 101C,A01,184946,Staff,0,10,30,30
1683688367032,COGS 102A,A01,184951,Johnson; Christine M.,1,0,40,39
1683688368057,COGS 107B,A01,184953,Mooshagian; Eric Frederick,0,52,40,40
1683688369082,COGS 118B,A01,184959,Gupta; Anjum,0,50,40,40
1683688370106,COGS 153,A00,184961,Staff,0,16,30,30
1683688371130,COGS 177,A00,184962,Staff,1,21,30,29
1683688372155,COGS 187A,A01,184969,Boyle; Mary E. T.,0,19,40,40
1683688373180,COMM 10,A01,185174,Staff,0,5,25,25
1683688373180,COMM 10,A02,185189,Staff,0,2,25,25
1683688373180,COMM 10,A03,269821,Staff,0,1,0,0
1683688374208,COMM 100B,A02,185476,Staff,10,0,25,15
1683688374208,COMM 100B,A03,277340,Staff,25,0,25,0
1683688375232,COMM 100C,A01,185314,Staff,1,0,25,24
1683688375232,COMM 100C,A02,185327,Staff,17,0,25,8
1683688376258,COMM 110M,A00,185349,Staff,0,0,40,40
1683688377283,COMM 113T,A00,185352,Staff,25,0,40,15
1683688378306,COMM 114I,A00,185353,Staff,31,0,40,9
1683688379331,COMM 131,A00,185354,Staff,17,0,30,13
1683688380354,CSE 8A,A50,185358,Cao; Yingjun,0,46,10,10
1683688381381,CSE 8B,A01,185362,Staff,0,48,50,50
1683688382410,CSE 11,A01,185416,Cao; Yingjun,0,91,10,10
1683688383435,CSE 20,A01,185445,Briones; Jor-el Thomas Caparas,3,0,25,22
1683688384459,CSE 21,A01,185447,Staff,9,0,50,41
1683688385486,CSE 101,A01,185451,Staff,0,13,50,50
1683688385486,CSE 101,B01,185453,Jones; Miles E,0,14,50,50
1683688387543,CSE 141,A01,185458,Eldon; John,16,0,100,84
1683688388571,CSE 141L,A01,185461,Eldon; John,8,0,100,92
1683688389596,CSE 142,A01,185463,Staff,34,0,60,26
1683688389596,CSE 142,B01,201355,Staff,0,7,60,60
1683688390624,CSE 142L,A01,185470,Staff,34,0,60,26
1683688390624,CSE 142L,B01,201417,Staff,0,6,60,60
1683688391653,CSE 190,A00,201433,Staff,32,0,49,17
1683688392679,DOC 1,A01,259136,Strom; Megan C.,7,0,15,8
1683688392679,DOC 1,A02,259137,Strom; Megan C.,14,0,15,1
1683688392679,DOC 1,A03,259138,Strom; Megan C.,14,0,15,1
1683688392679,DOC 1,A04,259139,Strom; Megan C.,14,0,15,1
1683688393703,DOC 100D,A00,259140,Pass; Natalye Joann,14,0,25,11
1683688394731,DSGN 1,A01,184749,Rill; Bryan,0,26,30,30
1683688395756,DSGN 100,A01,185168,Staff,0,2,25,25
1683688396782,ECE 5,A01,185626,Morris; Karcher William,0,12,0,0
1683688397808,ECE 101,A01,185628,Staff,14,0,70,56
1683688398832,ECE 107,A01,185635,Baghdadchi; Saharnaz,0,0,20,20
1683688398832,ECE 107,A02,185638,Baghdadchi; Saharnaz,1,0,20,19
1683688399857,ECE 148,A01,185647,Silberman; Jack,0,0,16,16
1683688400880,ECON 1,A01,185537,Crane; Meredith Helen,54,0,70,16
1683688401906,ECON 3,A01,185549,Crane; Meredith Helen,30,0,70,40
1683688402933,ECON 4,A01,203354,Anderson; John Charles,0,5,10,10
1683688403956,ECON 100A,A01,185574,Staff,0,5,40,40
1683688404979,ECON 100B,A01,185576,Staff,0,12,50,50
1683688406004,ECON 100C,A01,185589,Newhouse; Herbert S,30,0,70,40
1683688407033,ECON 105,A00,185608,Vespa; Emanuel Ignacio,19,0,35,16
1683688408058,ECON 109,A01,185610,Shishkin; Denis,9,0,35,26
1683688409083,ECON 110A,A01,185612,Staff,8,0,40,32
1683688410110,ECON 120A,A01,185615,Staff,19,0,40,21
1683688411137,ECON 120C,A01,185617,Sun; Yixiao,0,21,70,70
1683688412166,ECON 144,A00,203346,Squires; Dale E,2,0,35,33
1683688413191,ECON 171,A01,203349,Newhouse; Herbert S,0,1,35,35
1683688414214,ECON 173A,A01,185621,Toda; Alexis Akira,21,0,35,14
1683688415240,EDS 25,A01,202413,Staff,0,1,0,0
1683688415240,EDS 25,A02,202414,Staff,0,1,0,0
1683688415240,EDS 25,A03,202415,Staff,0,0,0,0
1683688415240,EDS 25,A04,202416,Staff,0,1,0,0
1683688415240,EDS 25,A05,202439,Staff,0,0,0,0
1683688415240,EDS 25,A06,202440,Staff,0,0,0,0
1683688415240,EDS 25,B01,202631,Staff,0,0,0,0
1683688415240,EDS 25,B02,202632,Staff,0,0,0,0
1683688415240,EDS 25,B03,202639,Staff,0,0,0,0
1683688415240,EDS 25,B04,202640,Staff,0,0,0,0
1683688415240,EDS 25,B05,202643,Staff,0,0,0,0
1683688415240,EDS 25,B06,202644,Staff,0,0,0,0
1683688416264,EDS 38,A01,202659,Black; Alison Michelle,24,0,25,1
1683688417288,EDS 115,A00,202652,Staff,18,0,30,12
1683688418312,EDS 125,A00,202649,Staff,13,0,30,17
1683688419340,EDS 126,A01,203332,Staff,30,0,30,0
1683688420364,EDS 139,A00,202838,Staff,16,0,25,9
1683688421392,EDS 146,A01,202655,Staff,14,0,25,11
1683688422418,ENG 15,A00,185667,Staff,0,1,0,0
1683688422418,ENG 15,B00,185672,Staff,0,0,0,0
1683688422418,ENG 15,C00,185675,Staff,0,0,0,0
1683688422418,ENG 15,D00,185682,Staff,0,0,0,0
1683688422418,ENG 15,E00,185684,Staff,0,0,0,0
1683688423442,ETHN 103,A00,185710,Staff,0,8,35,35
1683688424470,ETHN 103A,A00,199228,Man; Simeon S,0,0,9,9
1683688425495,ETHN 109,A00,185711,Staff,15,0,35,20
1683688426517,ETHN 142,A00,185726,Staff,0,4,30,30
1683688427542,ETHN 163J,A00,199229,Man; Simeon S,5,0,8,3
1683688428566,ETHN 168,A00,185727,Staff,7,0,10,3
1683688429594,ETHN 182,A00,185728,Staff,0,0,35,35
1683688430682,ETHN 183,A00,185737,Staff,9,0,18,9
1683688431706,GLBH 111,A01,209361,Burgos; Jose L.,0,0,0,0
1683688433760,HIEU 104,A00,185792,Staff,14,0,20,6
1683688434784,HIEU 115,A00,185800,Staff,0,0,20,20
1683688435809,HIEU 128,A00,185801,Staff,0,9,20,20
1683688436834,HIEU 147,A00,185802,Staff,15,0,20,5
1683688437858,HIEU 154,A00,185823,Staff,11,0,20,9
1683688438886,HILA 102,A00,185826,Staff,14,0,20,6
1683688439910,HILD 2C,A01,185778,Staff,0,13,20,20
1683688440934,HILD 7B,A01,185780,Kwak; Nancy,0,17,32,32
1683688440934,HILD 7B,A02,185781,Kwak; Nancy,0,18,32,32
1683688441957,HILD 30,A01,185791,Staff,12,0,20,8
1683688442981,HISC 119,A00,185830,Golan; Tal,0,10,20,20
1683688444006,HITO 156GS,A00,185831,Patterson; Patrick H.,0,0,0,23
1683688445028,HIUS 103,A00,185832,Man; Simeon S,0,4,20,20
1683688446051,HIUS 117,A00,185836,Kwak; Nancy,2,0,20,18
1683688447077,HIUS 125,A00,185840,Man; Simeon S,0,2,23,23
1683688448104,HIUS 149,A00,185845,Staff,1,0,20,19
1683688449132,HUM 3,A01,185882,Zavodny; Tatiana Sophia,0,8,50,50
1683688449132,HUM 3,B01,185899,Caldwell; Michael Alan,0,18,50,50
1683688450158,HUM 3GS,A00,185900,Patterson; Patrick H.,0,0,0,23
1683688451182,HUM 4,A01,185938,Zroka; Amy Liane,28,0,50,22
1683688451182,HUM 4,B01,185956,Watkins; Eric,0,6,50,50
1683688451182,HUM 4,B02,202209,Watkins; Eric,0,5,50,50
1683688451182,HUM 4,B03,202210,Watkins; Eric,0,5,50,50
1683688452211,HUM 5,A01,185958,West; Geoffrey Scott,0,0,50,50
1683688452211,HUM 5,A02,202215,West; Geoffrey Scott,0,0,50,50
1683688453237,INTL 190,A00,185959,Gagnon; Jeffrey C,0,0,0,9
1683688453237,INTL 190,B00,185960,Lettieri; Michael Joseph,0,0,0,2
1683688454264,JAPN 180,A00,254509,Staff,5,0,30,25
1683688455288,LATI 10,A01,202853,Kennemore; Amy Michelle,4,0,35,31
1683688455288,LATI 10,A02,202854,Kennemore; Amy Michelle,3,0,35,32
1683688455288,LATI 10,A03,270054,Kennemore; Amy Michelle,30,0,30,0
1683688456313,LATI 180,A00,202855,Kennemore; Amy Michelle,11,0,20,9
1683688457337,LAWS 101,A00,201767,Golan; Tal,0,7,40,40
1683688458360,LIFR 1C,A00,185961,Staff,6,0,20,14
1683688459384,LIFR 1CX,A00,185962,Staff,7,0,20,13
1683688460410,LIFR 1D,A00,185963,Staff,7,0,20,13
1683688461437,LIFR 1DX,A00,185964,Staff,7,0,20,13
1683688462463,LIGN 101,A01,186039,Staff,43,0,50,7
1683688463487,LIGN 165,A00,186040,Staff,15,0,50,35
1683688464511,LTCS 108,A00,186041,Staff,5,0,10,5
1683688465536,LTCS 119,A00,186042,Staff,15,0,20,5
1683688466560,LTCS 130,A00,186043,Wesling; Megan E.,15,0,25,10
1683688468606,LTEA 138,A00,186119,Staff,14,0,40,26
1683688469629,LTEN 124,A00,186148,Staff,5,0,25,20
1683688470653,LTEN 178,A00,186149,Staff,6,0,15,9
1683688471677,LTEN 181,A00,186150,Blanco; John D,34,0,40,6
1683688472704,LTWL 120,A00,186160,Staff,19,0,25,6
1683688473729,LTWL 165,A00,186161,Staff,22,0,25,3
1683688474756,LTWR 100,A00,186162,Staff,0,5,15,15
1683688475781,LTWR 102,A00,186163,Doller; Ben,5,0,15,10
1683688476807,MAE 8,A01,186412,Staff,0,1,0,0
1683688477831,MAE 30B,A00,186445,Bahadori; Mohammad Yousef,81,0,100,19
1683688478857,MAE 40,A00,186592,Bewley; Thomas R,10,0,50,40
1683688479882,MAE 101B,A00,186593,Bahadori; Mohammad Yousef,80,0,100,20
1683688480910,MAE 105,A00,186594,Bandaru; Prabhakar,10,0,50,40
1683688481934,MAE 107,A00,186599,Pham; Hieu Tan,0,7,120,120
1683688482958,MAE 148,A01,186660,Silberman; Jack,3,0,16,13
1683688483985,MATH 10A,A01,188095,Staff,0,6,35,35
1683688485013,MATH 10B,A01,188097,Bowers; Adam R.,0,12,30,30
1683688485013,MATH 10B,A02,188099,Bowers; Adam R.,0,11,30,30
1683688485013,MATH 10B,B01,188104,Bowers; Adam R.,0,10,30,30
1683688485013,MATH 10B,B02,188106,Bowers; Adam R.,1,9,30,29
1683688486038,MATH 10C,A01,188111,Staff,0,20,30,30
1683688486038,MATH 10C,A02,188127,Staff,0,19,30,30
1683688486038,MATH 10C,A03,188131,Staff,0,19,30,30
1683688486038,MATH 10C,B01,188218,Staff,17,0,30,13
1683688486038,MATH 10C,B02,188244,Staff,13,0,30,17
1683688486038,MATH 10C,B03,188277,Staff,14,0,30,16
1683688487062,MATH 18,A01,188344,Bach; Quang Tran,18,0,30,12
1683688487062,MATH 18,A02,188345,Bach; Quang Tran,11,0,30,19
1683688487062,MATH 18,B01,188353,Bach; Quang Tran,11,0,30,19
1683688487062,MATH 18,B02,188354,Bach; Quang Tran,19,0,30,11
1683688488086,MATH 20A,A01,188374,Staff,11,0,35,24
1683688489115,MATH 20B,A01,188382,Ohm; Ko Woon,7,0,30,23
1683688489115,MATH 20B,A02,188383,Ohm; Ko Woon,22,0,30,8
1683688489115,MATH 20B,B01,188385,Ohm; Ko Woon,7,0,30,23
1683688489115,MATH 20B,B02,188392,Ohm; Ko Woon,22,0,30,8
1683688490140,MATH 20C,A01,188394,Harel; Guershon,10,0,30,20
1683688490140,MATH 20C,A02,188395,Harel; Guershon,13,0,30,17
1683688490140,MATH 20C,B01,188404,Harel; Guershon,5,0,30,25
1683688490140,MATH 20C,B02,188405,Harel; Guershon,18,0,30,12
1683688491166,MATH 20D,A01,188414,Hammock; Frances H,0,1,30,30
1683688491166,MATH 20D,A02,188415,Hammock; Frances H,0,1,30,30
1683688491166,MATH 20D,B01,188447,Hammock; Frances H,0,1,30,30
1683688491166,MATH 20D,B02,188486,Hammock; Frances H,2,0,30,28
1683688492190,MATH 20E,A01,188649,Staff,21,0,30,9
1683688492190,MATH 20E,A02,188650,Staff,20,0,30,10
1683688492190,MATH 20E,A03,188673,Staff,0,0,30,30
1683688493217,MATH 102,A01,188675,Staff,0,40,35,35
1683688494243,MATH 103B,A01,188681,Staff,3,0,35,32
1683688494243,MATH 103B,B01,188692,Staff,5,0,35,30
1683688495267,MATH 109,A01,188695,Salehi Golsefidy; Alireza,24,0,35,11
1683688495267,MATH 109,A02,188696,Salehi Golsefidy; Alireza,25,0,35,10
1683688496294,MATH 120A,A01,188698,Eggers; John Dietrich,7,0,35,28
1683688497319,MATH 142B,A01,188736,Ioana; Adrian,1,1,30,29
1683688497319,MATH 142B,A02,188741,Ioana; Adrian,0,1,30,30
1683688497319,MATH 142B,A03,188743,Ioana; Adrian,0,2,30,30
1683688498342,MATH 168A,A01,188790,Staff,0,11,35,35
1683688499367,MATH 170A,A01,188803,Nie; Jiawang,0,2,35,35
1683688499367,MATH 170A,A02,188811,Nie; Jiawang,0,1,35,35
1683688499367,MATH 170A,A03,188814,Nie; Jiawang,0,0,35,35
1683688499367,MATH 170A,A04,188815,Nie; Jiawang,5,0,35,30
1683688500395,MATH 193B,A01,188817,Staff,0,0,35,35
1683688500395,MATH 193B,A02,188818,Staff,6,0,35,29
1683688501425,MGT 4,A01,202857,Anderson; John Charles,59,0,80,21
1683688502449,MGT 12,A00,202858,Lindenberger; Wade Douglas,40,0,90,50
1683688503473,MGT 18,A00,202859,Staff,74,0,90,16
1683688504501,MGT 18GS,A00,202860,McKay; Michael J,13,0,28,15
1683688505525,MGT 45,A00,202861,Pecore; Joseph P.,8,0,90,82
1683688506551,MGT 100,A00,202863,Yavorsky; Daniel Ryan,27,0,90,63
1683688507574,MGT 103,A00,202864,Ehrich; Kristine R,0,19,90,90
1683688508600,MGT 112,A00,202865,Ehrich; Kristine R,15,0,90,75
1683688509624,MGT 121A,A00,202868,Staff,90,20,90,0
1683688510652,MGT 131B,A00,202869,Anderson; John Charles,59,0,90,31
1683688511687,MGT 136,A00,202871,Lindenberger; Wade Douglas,83,0,90,7
1683688512715,MGT 164,A00,202873,Staff,0,67,90,91
1683688513740,MGT 164GS,A00,202874,McKay; Mary A,13,0,28,15
1683688514764,MGT 180,A00,202875,Staff,0,51,90,91
1683688515788,MMW 11R,A01,205019,Herbst; Matthew,0,0,30,30
1683688515788,MMW 11R,A02,205026,Herbst; Matthew,29,0,30,1
1683688516814,MMW 15,A01,193512,Chang; Edmond Yi-Teh,0,8,28,28
1683688516814,MMW 15,A02,193513,Chang; Edmond Yi-Teh,0,5,28,28
1683688516814,MMW 15,A03,193514,Chang; Edmond Yi-Teh,0,5,28,28
1683688516814,MMW 15,A04,193515,Chang; Edmond Yi-Teh,0,5,28,28
1683688516814,MMW 15,A05,193516,Chang; Edmond Yi-Teh,0,5,28,28
1683688516814,MMW 15,A06,193517,Chang; Edmond Yi-Teh,0,6,28,28
1683688516814,MMW 15,B01,193519,Chang; Edmond Yi-Teh,0,5,28,28
1683688516814,MMW 15,B02,193520,Chang; Edmond Yi-Teh,0,5,28,28
1683688516814,MMW 15,B03,193521,Chang; Edmond Yi-Teh,0,5,28,28
1683688516814,MMW 15,B04,193522,Chang; Edmond Yi-Teh,0,6,28,28
1683688516814,MMW 15,B05,193523,Chang; Edmond Yi-Teh,0,5,28,28
1683688516814,MMW 15,B06,193524,Chang; Edmond Yi-Teh,0,5,28,28
1683688517838,MMW 122,A01,193526,Rahimi; Babak,0,16,28,28
1683688517838,MMW 122,A02,193527,Rahimi; Babak,0,15,28,28
1683688517838,MMW 122,A03,193528,Rahimi; Babak,0,0,0,0
1683688517838,MMW 122,A04,193529,Rahimi; Babak,0,0,0,0
1683688518861,MUS 1A,A01,186663,Staff,1,19,35,34
1683688519887,MUS 4,A01,186715,Staff,0,12,35,35
1683688520910,MUS 5R,A01,186796,Dubnov; Shlomo,0,17,35,35
1683688521937,MUS 6,A01,186798,Staff,1,5,25,24
1683688522961,MUS 7,A01,186830,Staff,11,0,35,24
1683688523984,MUS 8,A01,186930,Staff,0,27,35,35
1683688525013,MUS 15,A01,186932,Staff,0,15,35,35
1683688525013,MUS 15,B01,186934,Staff,1,17,35,34
1683688526037,MUS 80,A00,186935,Staff,0,0,20,20
1683688526037,MUS 80,B00,186936,Staff,24,0,25,1
1683688527064,NANO 11,A00,204702,Lipomi; Darren John,0,0,0,0
1683688528091,NANO 15,A01,204709,Yang; Kesong,0,1,0,0
1683688529118,NANO 114,A00,202069,Jahed Motlagh; Zeinab,2,0,10,8
1683688530143,PHIL 1,A00,186955,Grush; Rick Scott,31,0,40,9
1683688531166,PHIL 10,A01,186973,Grush; Rick Scott,27,0,35,8
1683688531166,PHIL 10,A02,186974,Grush; Rick Scott,33,0,35,2
1683688532189,PHIL 13,A01,186976,Staff,1,0,35,34
1683688532189,PHIL 13,A02,186977,Staff,16,0,35,19
1683688533214,PHIL 14,A01,186979,Staff,31,0,35,4
1683688533214,PHIL 14,A02,186986,Staff,32,0,35,3
1683688534299,PHIL 28,A01,186988,Staff,16,0,30,14
1683688534299,PHIL 28,A02,186989,Staff,1,0,30,29
1683688534299,PHIL 28,A03,186990,Staff,10,0,30,20
1683688534299,PHIL 28,A04,186991,Staff,26,0,30,4
1683688535322,PHIL 120,A00,186997,Staff,23,0,40,17
1683688536346,PHIL 137,A00,187003,Staff,7,0,40,33
1683688537369,PHIL 150,A00,187015,Staff,47,0,70,23
1683688538394,PHIL 167,A00,187021,Lamey; Andy M.,34,0,40,6
1683688539421,PHIL 174,A01,202226,Staff,17,0,20,3
1683688539421,PHIL 174,A02,202235,Staff,20,0,20,0
1683688540448,PHIL 191A,A00,258918,Staff,0,0,1,1
1683688541472,PHYS 1A,A00,187028,Staff,26,0,60,34
1683688542500,PHYS 1AL,001,187036,Staff,3,0,30,27
1683688542500,PHYS 1AL,002,187049,Staff,18,0,30,12
1683688543524,PHYS 1B,A00,187058,Staff,22,0,60,38
1683688544549,PHYS 1BL,001,187064,Staff,0,1,30,30
1683688544549,PHYS 1BL,002,187070,Staff,4,0,30,26
1683688545573,PHYS 1C,A00,187082,Staff,29,0,120,91
1683688546603,PHYS 1CL,001,187088,Staff,0,9,30,30
1683688546603,PHYS 1CL,002,187089,Staff,0,1,30,30
1683688546603,PHYS 1CL,009,262693,Staff,9,0,30,21
1683688547631,PHYS 2B,A01,187097,Staff,55,0,115,60
1683688548658,PHYS 2C,A01,187099,Staff,63,0,115,52
1683688549683,PHYS 2CL,A01,187101,Staff,5,0,28,23
1683688549683,PHYS 2CL,A02,187102,Staff,15,0,28,13
1683688550721,PHYS 2D,A01,187123,Shotwell; Brian,95,0,115,20
1683688551749,PHYS 4B,A01,187133,Grinstein; Benjamin,35,0,50,15
1683688552776,POLI 10,A00,188819,Staff,0,4,50,50
1683688553800,POLI 11,A00,188827,Staff,43,0,50,7
1683688554824,POLI 13R,A00,188828,Staff,0,1,20,20
1683688555853,POLI 27,A01,188830,Elgin; Samuel Zincke,0,2,70,70
1683688556878,POLI 30,A00,188832,Desposato; Scott,30,0,50,20
1683688557903,POLI 102F,A00,188834,Staff,1,0,40,39
1683688558926,POLI 104A,A00,188852,Staff,12,0,30,18
1683688559949,POLI 104I,A00,188853,Staff,0,8,20,20
1683688560977,POLI 110B,A00,188854,Wiens; David,6,0,20,14
1683688562004,POLI 112A,A00,188855,Wiens; David,3,0,30,27
1683688563032,POLI 117R,A00,188856,Forman; Fonna,0,12,20,20
1683688564061,POLI 118,A00,188857,Ingham; Sean,8,0,20,12
1683688565084,POLI 120G,A00,188858,Staff,8,0,30,22
1683688566109,POLI 131CR,A00,188863,Hoston; Germaine,20,0,50,30
1683688567136,POLI 133,A00,188864,Nellis; Gareth Hb,44,0,50,6
1683688568160,POLI 134D,A00,188865,Desposato; Scott,27,0,30,3
1683688569185,POLI 142A,A00,188871,Gartzke; Erik,21,0,50,29
1683688570216,POLI 142K,A00,188874,Staff,38,0,50,12
1683688571242,POLI 143,A00,188940,Gartzke; Erik,16,0,30,14
1683688572267,POLI 153,A00,188943,Staff,2,0,20,18
1683688573292,POLI 160AA,A00,188944,Staff,10,0,40,30
1683688574324,POLI 170A,A00,188945,Staff,10,0,30,20
1683688576374,PSYC 1,A00,188952,Staff,36,0,90,54
1683688577398,PSYC 2,B00,188953,Staff,19,0,35,16
1683688578425,PSYC 6,A00,188970,Staff,47,0,60,13
1683688579452,PSYC 7,A00,188973,Staff,35,0,45,10
1683688580476,PSYC 60,A01,188980,Rickard; Timothy C.,42,0,60,18
1683688581502,PSYC 70,A01,189001,Steiner; Eric Tomas,21,0,45,24
1683688582529,PSYC 100,A00,189005,Lacefield; Katharine I,0,99,120,120
1683688583556,PSYC 102,A00,189008,Staff,7,0,30,23
1683688584580,PSYC 106,B00,189026,Gorman; Michael R.,27,0,60,33
1683688585609,PSYC 114,B01,189033,Winkielman; Piotr,0,31,30,30
1683688586634,PSYC 131,A00,189036,Anagnostaras; Stephan,0,43,60,60
1683688587662,PSYC 136,A00,189041,Lowe; Angela Beth,0,7,25,25
1683688588687,PSYC 137,A00,189057,Winkielman; Piotr,1,37,25,24
1683688589711,PSYC 144,A00,189107,Wixted; John T,0,11,50,50
1683688591759,PSYC 162,A00,189142,Staff,0,9,85,85
1683688592785,PSYC 172,A00,189144,Gorman; Michael R.,0,6,30,30
1683688594832,PSYC 179,A00,189146,Lacefield; Katharine I,0,88,120,120
1683688595858,PSYC 181,A00,189147,Anagnostaras; Stephan,0,44,90,90
1683688596883,PSYC 190R,A00,189148,Barner; David A.,0,23,80,80
1683688597908,PSYC 191,A00,189275,Rickard; Timothy C.,0,11,25,25
1683688598937,PSYC 193,A00,189276,Chapman; Eddie Nathaniel,0,1,0,4
1683688599960,PSYC 193L,A01,189281,Lowe; Angela Beth,8,0,20,12
1683688599960,PSYC 193L,B01,189285,Staff,28,0,35,7
1683688600984,RELI 149,A00,187137,Rahimi; Babak,6,0,40,34
1683688602013,SE 9,A01,187315,Staff,0,2,18,18
1683688603037,SE 101B,A00,187409,Staff,24,0,30,6
1683688604061,SE 110B,A00,187444,Staff,10,0,40,30
1683688605085,SE 130B,A00,187449,Staff,31,0,40,9
1683688606110,SE 150A,A00,187516,Staff,8,0,20,12
1683688607135,SE 154,A00,187528,Staff,29,0,50,21
1683688608162,SIO 3,A01,258171,Staff,35,0,40,5
1683688609191,SIO 10,A00,187144,Cook; Geoffrey W,1,7,75,74
1683688610219,SIO 45,A00,187152,Cook; Geoffrey W,0,7,100,100
1683688611243,SIO 109R,A00,194486,Staff,0,4,20,20
1683688613291,SIO 187,A01,187233,Kacev; David,12,0,40,28
1683688614316,SOCI 1,A01,258656,Thorpe; Charles Robert,28,0,30,2
1683688614316,SOCI 1,A02,258658,Thorpe; Charles Robert,30,0,30,0
1683688614316,SOCI 1,A03,258661,Thorpe; Charles Robert,25,0,25,0
1683688614316,SOCI 1,A04,258666,Thorpe; Charles Robert,22,0,25,3
1683688614316,SOCI 1,A05,258897,Thorpe; Charles Robert,22,0,25,3
1683688614316,SOCI 1,A06,258898,Thorpe; Charles Robert,25,0,25,0
1683688615339,SOCI 30,A01,258903,Pardo Guerra; Juan Pablo,14,0,30,16
1683688616367,SOCI 102,A00,258904,Staff,9,0,25,16
1683688617394,SOCI 106,A00,258905,Staff,19,0,25,6
1683688618423,SOCI 111,A00,258907,Ribas Norris; Janet Vanesa,26,0,30,4
1683688619445,SOCI 121R,A00,258908,Pardo Guerra; Juan Pablo,8,0,30,22
1683688620469,SOCI 126,A01,203330,Staff,14,0,20,6
1683688621494,SOCI 131,A00,258909,Thorpe; Charles Robert,30,0,60,30
1683688622520,SOCI 135,A00,258910,Payne; Christine Anna,0,12,30,30
1683688623544,SOCI 157,A00,258911,Staff,11,0,30,19
1683688624567,SOCI 184,A00,258912,Staff,25,0,30,5
1683688625591,SOCI 188D,A00,258913,Staff,22,0,30,8
1683688626616,SYN 2,001,187529,Staff,9,0,16,7
1683688626616,SYN 2,002,201452,Staff,1,20,16,15
1683688626616,SYN 2,003,201469,Staff,1,0,16,15
1683688627644,SYN 100,A01,187531,Staff,0,9,20,20
1683688627644,SYN 100,B01,201491,Staff,0,10,20,20
1683688628668,TDAC 1,A00,189286,Walsh; Kim C.,3,0,20,17
1683688628668,TDAC 1,B00,189287,Harting; Carla Kelso,10,0,20,10
1683688629693,TDAC 101,A00,189300,Walsh; Kim C.,16,0,20,4
1683688629693,TDAC 101,B00,189301,Harting; Carla Kelso,18,0,20,2
1683688630718,TDAC 102,A00,189304,Basso; Beatrice,14,0,20,6
1683688631743,TDAC 108,A00,189305,Staff,18,0,20,2
1683688632768,TDDE 131,A00,189310,Staff,19,0,20,1
1683688632768,TDDE 131,B00,189314,Staff,19,0,20,1
1683688632768,TDDE 131,C00,189315,Staff,48,0,50,2
1683688632768,TDDE 131,D00,189316,Staff,14,0,15,1
1683688632768,TDDE 131,E00,204841,Staff,20,0,20,0
1683688633794,TDGE 10,A00,189289,Staff,27,0,50,23
1683688633794,TDGE 10,B00,189290,Havis; Allan,0,1,50,50
1683688634819,TDGE 11,A00,189291,Fulton; Julia,0,4,50,50
1683688634819,TDGE 11,B00,189292,Staff,20,0,25,5
1683688634819,TDGE 11,C00,260270,Staff,0,0,0,0
1683688635846,TDGE 25,A00,189294,Staff,1,0,20,19
1683688636871,TDGE 124,A00,189318,Fulton; Julia,1,8,50,49
1683688637950,TDGE 125,A00,189319,Staff,13,0,25,12
1683688637950,TDGE 125,B00,189320,Staff,23,0,25,2
1683688638974,TDGE 127,A00,189322,Havis; Allan,0,0,50,50
1683688640003,TDHT 101,A00,189323,Staff,18,0,25,7
1683688640003,TDHT 101,B00,189324,Staff,25,0,25,0
1683688641026,TDHT 102,A00,189325,Staff,49,0,50,1
1683688642051,TDMV 1,A00,189295,Arcidiacono; Kristin,20,0,30,10
1683688642051,TDMV 1,B00,189296,Caligagan; Maria T.,24,0,30,6
1683688643079,TDMV 2,A00,189297,Sammartano; Tonnie,27,0,30,3
1683688643079,TDMV 2,B00,189299,Arcidiacono; Kristin,23,0,30,7
1683688644105,TDMV 3,A00,204998,Rincon; Alicia,22,0,30,8
1683688645129,TDMV 120,A00,189458,Sammartano; Tonnie,28,0,30,2
1683688646154,TDMV 138,A00,189541,Jun; Grace Shin Hae,20,0,40,20
1683688647180,TDMV 142,A00,189717,Caligagan; Tony,25,0,30,5
1683688647180,TDMV 142,B00,189718,Caligagan; Maria T.,25,0,30,5
1683688648203,TMC 2,A01,187533,Staff,25,0,25,0
1683688648203,TMC 2,A02,187534,Staff,25,0,25,0
1683688649228,USP 1,A01,187536,Kwak; Nancy,0,16,25,25
1683688650255,USP 5,A01,187538,Staff,8,0,25,17
1683688651278,USP 101,A00,199253,Staff,0,4,0,0
1683688652306,USP 124,A00,187562,Boomhower; Matthew Charles,0,0,30,30
1683688653330,USP 138,A00,187582,Staff,19,0,25,6
1683688654354,USP 152,A01,187597,Staff,3,0,25,22
1683688655377,USP 153,A00,187598,Staff,18,0,25,7
1683688656402,USP 168,A00,187607,Kwak; Nancy,2,0,5,3
1683688657430,USP 173,A00,187619,Staff,4,0,25,21
1683688658455,USP 181,A00,187638,Staff,0,4,25,25
1683688659482,VIS 103,A00,187650,Cruz; Edwin Teddy,17,0,75,58
1683688660506,VIS 110D,A00,187669,Staff,13,0,22,9
1683688661530,VIS 127C,A00,187720,Shen; Kuiyi,67,0,146,79
1683688662555,VIS 149,A00,187731,Yoldas; Pinar,1,14,22,21
1683688663579,VIS 151,A01,188091,Staff,22,0,34,12
1683688663579,VIS 151,A02,188092,Staff,11,0,34,23
1683688664608,VIS 160B,A00,188093,Stalbaum; Brett,0,1,10,10
1683688666659,WCWP 10B,A00,201720,Staff,0,0,5,5
1683688666659,WCWP 10B,B00,201722,Staff,0,0,6,6
1683688667705,WCWP 100,A00,201725,Gagnon; Jeffrey C,0,0,2,2
1683688667705,WCWP 100,B00,201727,Staff,0,4,15,15
1683688670831,ANBI 133,A00,258401,Wilder; Linnea Lorene,34,0,40,6
1683688671856,ANBI 140,A00,258395,Hrvoj Mihic; Branka,18,0,25,7
1683688672880,ANSC 120,A00,258402,Bialecki; Jon Anthony,26,0,40,14
1683688673904,ANSC 144,A00,258400,Staff,12,0,40,28
1683688675955,ANSC 166,A00,258396,Parish; Steven Martin,156,0,175,19
1683688676979,ANSC 180,A00,193533,Staff,8,0,20,12
1683688678002,ANSC 188,A00,258397,Jassal; Aftab,34,0,40,6
1683688679026,ANTH 3,A01,258316,Staff,23,0,30,7
1683688680054,ANTH 5,A00,258394,Semendeferi; Ekaterini,16,0,20,4
1683688681077,ANTH 21,A01,258331,Staff,4,0,40,36
1683688682104,ANTH 103,A00,258398,Varma; Saiba,15,0,25,10
1683688683136,AWP 10,001,202034,Staff,0,0,0,0
1683688683136,AWP 10,002,202035,Staff,0,0,0,0
1683688683136,AWP 10,003,202036,Staff,0,0,0,0
1683688683136,AWP 10,004,202037,Staff,0,0,0,0
1683688683136,AWP 10,005,202038,Staff,0,0,0,0
1683688683136,AWP 10,006,202039,Staff,0,0,0,0
1683688683136,AWP 10,007,202040,Staff,0,0,0,0
1683688683136,AWP 10,008,202041,Staff,0,0,0,0
1683688683136,AWP 10,009,202042,Staff,0,0,0,0
1683688683136,AWP 10,010,202043,Staff,0,0,0,0
1683688683136,AWP 10,011,202044,Staff,0,0,0,0
1683688683136,AWP 10,012,202045,Staff,0,0,0,0
1683688683136,AWP 10,013,202046,Staff,0,0,0,0
1683688683136,AWP 10,014,202047,Staff,0,0,0,0
1683688683136,AWP 10,015,202048,Staff,0,0,0,0
1683688683136,AWP 10,016,202049,Staff,0,0,0,0
1683688683136,AWP 10,017,202050,Staff,0,0,0,0
1683688683136,AWP 10,018,202051,Staff,0,0,0,0
1683688683136,AWP 10,019,202052,Staff,0,0,0,0
1683688683136,AWP 10,020,202053,Staff,0,0,0,0
1683688683136,AWP 10,021,202054,Staff,0,0,0,0
1683688683136,AWP 10,022,202055,Staff,0,0,0,0
1683688683136,AWP 10,023,202056,Staff,0,0,0,0
1683688683136,AWP 10,024,202057,Staff,0,0,0,0
1683688683136,AWP 10,025,202058,Staff,0,0,0,0
1683688683136,AWP 10,026,202059,Staff,0,0,0,0
1683688684163,AWP 102,001,202032,Staff,0,0,0,0
1683688684163,AWP 102,002,202033,Staff,0,0,0,0
1683688685193,BENG 100,A01,254234,Taylor Amos; Alyssa C,31,0,40,9
1683688686216,BENG 196,001,270013,Engler; Adam J.,9999,0,9999,0
1683688687243,BICD 100R,A01,202018,Smith; Laurie,0,7,32,32
1683688687243,BICD 100R,A02,202019,Smith; Laurie,0,3,32,32
1683688687243,BICD 100R,A03,202020,Smith; Laurie,0,1,32,32
1683688687243,BICD 100R,A04,202021,Smith; Laurie,6,0,32,26
1683688687243,BICD 100R,A05,202022,Smith; Laurie,10,0,32,22
1683688688267,BICD 136,A01,193242,Gustafson-Brown; Cindy,0,2,32,32
1683688688267,BICD 136,A02,193244,Gustafson-Brown; Cindy,13,0,32,19
1683688689294,BIEB 102,A01,193249,Butler; Shannon Rhey,1,1,32,31
1683688689294,BIEB 102,A02,193251,Butler; Shannon Rhey,0,0,32,32
1683688689294,BIEB 102,A03,193253,Butler; Shannon Rhey,0,0,32,32
1683688689294,BIEB 102,A04,193255,Butler; Shannon Rhey,13,0,32,19
1683688689294,BIEB 102,A05,193265,Butler; Shannon Rhey,25,0,32,7
1683688689294,BIEB 102,A06,193269,Butler; Shannon Rhey,13,0,32,19
1683688691348,BIEB 150,A01,193274,Staff,0,0,32,32
1683688691348,BIEB 150,A02,193285,Staff,24,0,32,8
1683688692372,BIEB 194,A00,193286,Kurle; Carolyn M.,19,0,32,13
1683688693397,BILD 1,A01,192291,Staff,15,0,32,17
1683688693397,BILD 1,A02,192292,Staff,30,0,32,2
1683688693397,BILD 1,B01,192520,Reuther; Keefe,0,1,0,0
1683688693397,BILD 1,B02,192532,Reuther; Keefe,0,1,0,0
1683688694422,BILD 3,A01,192556,Butler; Shannon Rhey,0,0,32,32
1683688694422,BILD 3,A02,192581,Butler; Shannon Rhey,0,1,32,32
1683688694422,BILD 3,A03,192611,Butler; Shannon Rhey,19,0,32,13
1683688694422,BILD 3,A04,192612,Butler; Shannon Rhey,24,0,32,8
1683688694422,BILD 3,A05,192613,Butler; Shannon Rhey,26,0,32,6
1683688694422,BILD 3,A06,192679,Butler; Shannon Rhey,27,0,32,5
1683688694422,BILD 3,A07,192682,Butler; Shannon Rhey,20,0,32,12
1683688695447,BILD 4,A01,192836,Reuther; Keefe,1,0,24,23
1683688695447,BILD 4,A02,193044,Reuther; Keefe,4,0,24,20
1683688696476,BILD 10,A01,193142,Gustafson-Brown; Cindy,29,0,32,3
1683688696476,BILD 10,A02,193149,Gustafson-Brown; Cindy,31,0,32,1
1683688697501,BIMM 100,A01,193301,Staff,0,6,32,32
1683688697501,BIMM 100,A02,193312,Staff,0,7,32,32
1683688697501,BIMM 100,A03,193323,Staff,0,10,32,32
1683688698530,BIMM 101,A01,193329,McDonnell; Lisa Marie,1,4,24,23
1683688698530,BIMM 101,A02,193339,McDonnell; Lisa Marie,1,4,24,23
1683688698530,BIMM 101,B01,193354,McDonnell; Lisa Marie,0,4,24,24
1683688698530,BIMM 101,B02,193357,McDonnell; Lisa Marie,0,3,24,24
1683688699555,BIMM 110,A01,193377,Tat; John,0,11,32,32
1683688699555,BIMM 110,A02,193378,Tat; John,0,11,32,32
1683688700579,BIMM 120,A01,206116,Staff,0,0,32,32
1683688700579,BIMM 120,A02,206117,Staff,7,0,32,25
1683688700579,BIMM 120,A03,206121,Staff,21,0,32,11
1683688701603,BIPN 100,A01,193393,Park; Ji Young,0,15,32,32
1683688701603,BIPN 100,A02,193402,Park; Ji Young,0,14,32,32
1683688701603,BIPN 100,A03,193413,Park; Ji Young,0,14,32,32
1683688701603,BIPN 100,A04,193414,Park; Ji Young,0,13,32,32
1683688702632,BIPN 102,A01,193429,Staff,0,0,32,32
1683688702632,BIPN 102,A02,193438,Staff,18,0,32,14
1683688703656,BIPN 106,A01,193450,Reyes Gonzalez; Catalina,0,2,40,40
1683688704681,BIPN 134,A01,193465,Cooke; James Edward,0,0,32,32
1683688704681,BIPN 134,A02,193474,Cooke; James Edward,25,0,32,7
1683688704681,BIPN 134,A03,193485,Cooke; James Edward,29,0,32,3
1683688704681,BIPN 134,A04,193486,Cooke; James Edward,20,0,32,12
1683688704681,BIPN 134,A05,193491,Cooke; James Edward,31,0,32,1
1683688704681,BIPN 134,A06,193501,Cooke; James Edward,30,0,32,2
1683688704681,BIPN 134,A07,193510,Cooke; James Edward,29,0,32,3
1683688706731,BISP 194,A00,222522,Staff,14,0,32,18
1683688707755,CAT 124,A01,202407,Staff,19,0,25,6
1683688708782,CAT 125,A00,202408,Marchisotto; Jennifer Anne,2,0,20,18
1683688709806,CAT 125R,A00,202409,Smith; Lauryn Alissa,0,11,20,20
1683688709806,CAT 125R,B00,202410,Morales; Celeste Georgianna,0,11,20,20
1683688709806,CAT 125R,C00,202411,Irwin; Matthew Joseph,0,12,20,20
1683688710828,CENG 15,A01,204712,Yang; Kesong,0,1,0,0
1683688711852,CENG 114,A00,202070,Jahed Motlagh; Zeinab,5,0,20,15
1683688712876,CGS 105,A00,185477,Wesling; Megan E.,24,0,40,16
1683688713904,CGS 106,A00,185494,Staff,11,0,22,11
1683688714934,CGS 108,A00,185495,Staff,14,0,20,6
1683688715960,CGS 114,A00,185496,Staff,13,0,18,5
1683688716986,CGS 119,A00,185501,Staff,15,0,20,5
1683688718011,CGS 120,A00,185511,Staff,12,0,20,8
1683688719036,CHEM 4,A01,184675,Bussey; Thomas J,97,0,100,3
1683688720061,CHEM 6A,A01,184677,Staff,32,0,60,28
1683688721087,CHEM 6B,A01,184679,Staff,63,0,100,37
1683688722116,CHEM 6C,A01,184681,Bussey; Thomas J,0,0,50,50
1683688722116,CHEM 6C,A02,184682,Bussey; Thomas J,32,0,50,18
1683688723142,CHEM 40A,A01,184684,Albizati; Kim F.,33,0,100,67
1683688724167,CHEM 40B,A01,184686,Albizati; Kim F.,0,22,100,100
1683688725192,CHEM 41B,A01,184690,Staff,51,0,100,49
1683688726215,COGS 3,A01,184715,Boyle; Mary E. T.,0,27,40,40
1683688727238,COGS 14B,A01,185172,Staff,0,14,38,38
1683688728265,COGS 18,A01,184736,Staff,14,0,80,66
1683688729295,COGS 100,A01,184932,Staff,0,8,73,73
1683688730322,COGS 101A,A01,184935,Staff,0,40,30,30
1683688731347,COGS 101B,A01,184944,Staff,0,2,30,30
1683688732370,COGS 101C,A01,184946,Staff,0,10,30,30
1683688733394,COGS 102A,A01,184951,Johnson; Christine M.,1,0,40,39
1683688734419,COGS 107B,A01,184953,Mooshagian; Eric Frederick,0,52,40,40
1683688735443,COGS 118B,A01,184959,Gupta; Anjum,0,50,40,40
1683688736466,COGS 153,A00,184961,Staff,0,16,30,30
1683688737491,COGS 177,A00,184962,Staff,1,21,30,29
1683688738519,COGS 187A,A01,184969,Boyle; Mary E. T.,0,19,40,40
1683688739544,COMM 10,A01,185174,Staff,0,5,25,25
1683688739544,COMM 10,A02,185189,Staff,0,2,25,25
1683688739544,COMM 10,A03,269821,Staff,0,1,0,0
1683688740570,COMM 100B,A02,185476,Staff,10,0,25,15
1683688740570,COMM 100B,A03,277340,Staff,25,0,25,0
1683688741657,COMM 100C,A01,185314,Staff,1,0,25,24
1683688741657,COMM 100C,A02,185327,Staff,17,0,25,8
1683688742684,COMM 110M,A00,185349,Staff,0,0,40,40
1683688743712,COMM 113T,A00,185352,Staff,25,0,40,15
1683688744736,COMM 114I,A00,185353,Staff,31,0,40,9
1683688745759,COMM 131,A00,185354,Staff,17,0,30,13
1683688746783,CSE 8A,A50,185358,Cao; Yingjun,0,46,10,10
1683688747811,CSE 8B,A01,185362,Staff,0,48,50,50
1683688748835,CSE 11,A01,185416,Cao; Yingjun,0,91,10,10
1683688749863,CSE 20,A01,185445,Briones; Jor-el Thomas Caparas,3,0,25,22
1683688750890,CSE 21,A01,185447,Staff,9,0,50,41
1683688751914,CSE 101,A01,185451,Staff,0,13,50,50
1683688751914,CSE 101,B01,185453,Jones; Miles E,0,14,50,50
1683688753975,CSE 141,A01,185458,Eldon; John,16,0,100,84
1683688754999,CSE 141L,A01,185461,Eldon; John,8,0,100,92
1683688756023,CSE 142,A01,185463,Staff,34,0,60,26
1683688756023,CSE 142,B01,201355,Staff,0,7,60,60
1683688757051,CSE 142L,A01,185470,Staff,34,0,60,26
1683688757051,CSE 142L,B01,201417,Staff,0,6,60,60
1683688758076,CSE 190,A00,201433,Staff,32,0,49,17
1683688759099,DOC 1,A01,259136,Strom; Megan C.,7,0,15,8
1683688759099,DOC 1,A02,259137,Strom; Megan C.,14,0,15,1
1683688759099,DOC 1,A03,259138,Strom; Megan C.,14,0,15,1
1683688759099,DOC 1,A04,259139,Strom; Megan C.,14,0,15,1
1683688760128,DOC 100D,A00,259140,Pass; Natalye Joann,14,0,25,11
1683688761156,DSGN 1,A01,184749,Rill; Bryan,0,26,30,30
1683688762179,DSGN 100,A01,185168,Staff,0,2,25,25
1683688763212,ECE 5,A01,185626,Morris; Karcher William,0,12,0,0
1683688764238,ECE 101,A01,185628,Staff,14,0,70,56
1683688765262,ECE 107,A01,185635,Baghdadchi; Saharnaz,0,0,20,20
1683688765262,ECE 107,A02,185638,Baghdadchi; Saharnaz,1,0,20,19
1683688766286,ECE 148,A01,185647,Silberman; Jack,0,0,16,16
1683688767310,ECON 1,A01,185537,Crane; Meredith Helen,54,0,70,16
1683688768332,ECON 3,A01,185549,Crane; Meredith Helen,30,0,70,40
1683688769358,ECON 4,A01,203354,Anderson; John Charles,0,5,10,10
1683688770382,ECON 100A,A01,185574,Staff,0,5,40,40
1683688771405,ECON 100B,A01,185576,Staff,0,12,50,50
1683688772431,ECON 100C,A01,185589,Newhouse; Herbert S,30,0,70,40
1683688773456,ECON 105,A00,185608,Vespa; Emanuel Ignacio,19,0,35,16
1683688774484,ECON 109,A01,185610,Shishkin; Denis,9,0,35,26
1683688775510,ECON 110A,A01,185612,Staff,8,0,40,32
1683688776536,ECON 120A,A01,185615,Staff,19,0,40,21
1683688777567,ECON 120C,A01,185617,Sun; Yixiao,0,21,70,70
1683688778594,ECON 144,A00,203346,Squires; Dale E,2,0,35,33
1683688779617,ECON 171,A01,203349,Newhouse; Herbert S,0,1,35,35
1683688780644,ECON 173A,A01,185621,Toda; Alexis Akira,21,0,35,14
1683688781669,EDS 25,A01,202413,Staff,0,1,0,0
1683688781669,EDS 25,A02,202414,Staff,0,1,0,0
1683688781669,EDS 25,A03,202415,Staff,0,0,0,0
1683688781669,EDS 25,A04,202416,Staff,0,1,0,0
1683688781669,EDS 25,A05,202439,Staff,0,0,0,0
1683688781669,EDS 25,A06,202440,Staff,0,0,0,0
1683688781669,EDS 25,B01,202631,Staff,0,0,0,0
1683688781669,EDS 25,B02,202632,Staff,0,0,0,0
1683688781669,EDS 25,B03,202639,Staff,0,0,0,0
1683688781669,EDS 25,B04,202640,Staff,0,0,0,0
1683688781669,EDS 25,B05,202643,Staff,0,0,0,0
1683688781669,EDS 25,B06,202644,Staff,0,0,0,0
1683688782693,EDS 38,A01,202659,Black; Alison Michelle,24,0,25,1
1683688783717,EDS 115,A00,202652,Staff,18,0,30,12
1683688784742,EDS 125,A00,202649,Staff,13,0,30,17
1683688785766,EDS 126,A01,203332,Staff,30,0,30,0
1683688786789,EDS 139,A00,202838,Staff,16,0,25,9
1683688787815,EDS 146,A01,202655,Staff,14,0,25,11
1683688788840,ENG 15,A00,185667,Staff,0,1,0,0
1683688788840,ENG 15,B00,185672,Staff,0,0,0,0
1683688788840,ENG 15,C00,185675,Staff,0,0,0,0
1683688788840,ENG 15,D00,185682,Staff,0,0,0,0
1683688788840,ENG 15,E00,185684,Staff,0,0,0,0
1683688789863,ETHN 103,A00,185710,Staff,0,8,35,35
1683688790887,ETHN 103A,A00,199228,Man; Simeon S,0,0,9,9
1683688791911,ETHN 109,A00,185711,Staff,15,0,35,20
1683688792934,ETHN 142,A00,185726,Staff,0,4,30,30
1683688793958,ETHN 163J,A00,199229,Man; Simeon S,5,0,8,3
1683688794982,ETHN 168,A00,185727,Staff,7,0,10,3
1683688796006,ETHN 182,A00,185728,Staff,0,0,35,35
1683688797029,ETHN 183,A00,185737,Staff,9,0,18,9
1683688798057,GLBH 111,A01,209361,Burgos; Jose L.,0,0,0,0
1683688800104,HIEU 104,A00,185792,Staff,14,0,20,6
1683688801130,HIEU 115,A00,185800,Staff,0,0,20,20
1683688802154,HIEU 128,A00,185801,Staff,0,9,20,20
1683688803176,HIEU 147,A00,185802,Staff,15,0,20,5
1683688804203,HIEU 154,A00,185823,Staff,11,0,20,9
1683688805226,HILA 102,A00,185826,Staff,14,0,20,6
1683688806253,HILD 2C,A01,185778,Staff,0,13,20,20
1683688807280,HILD 7B,A01,185780,Kwak; Nancy,0,17,32,32
1683688807280,HILD 7B,A02,185781,Kwak; Nancy,0,18,32,32
1683688808304,HILD 30,A01,185791,Staff,12,0,20,8
1683688809331,HISC 119,A00,185830,Golan; Tal,0,10,20,20
1683688810357,HITO 156GS,A00,185831,Patterson; Patrick H.,0,0,0,23
1683688811387,HIUS 103,A00,185832,Man; Simeon S,0,4,20,20
1683688812414,HIUS 117,A00,185836,Kwak; Nancy,2,0,20,18
1683688813443,HIUS 125,A00,185840,Man; Simeon S,0,2,23,23
1683688814470,HIUS 149,A00,185845,Staff,1,0,20,19
1683688815498,HUM 3,A01,185882,Zavodny; Tatiana Sophia,0,8,50,50
1683688815498,HUM 3,B01,185899,Caldwell; Michael Alan,0,18,50,50
1683688816524,HUM 3GS,A00,185900,Patterson; Patrick H.,0,0,0,23
1683688817556,HUM 4,A01,185938,Zroka; Amy Liane,28,0,50,22
1683688817556,HUM 4,B01,185956,Watkins; Eric,0,6,50,50
1683688817556,HUM 4,B02,202209,Watkins; Eric,0,5,50,50
1683688817556,HUM 4,B03,202210,Watkins; Eric,0,5,50,50
1683688818582,HUM 5,A01,185958,West; Geoffrey Scott,0,0,50,50
1683688818582,HUM 5,A02,202215,West; Geoffrey Scott,0,0,50,50
1683688819608,INTL 190,A00,185959,Gagnon; Jeffrey C,0,0,0,9
1683688819608,INTL 190,B00,185960,Lettieri; Michael Joseph,0,0,0,2
1683688820634,JAPN 180,A00,254509,Staff,5,0,30,25
1683688821658,LATI 10,A01,202853,Kennemore; Amy Michelle,4,0,35,31
1683688821658,LATI 10,A02,202854,Kennemore; Amy Michelle,3,0,35,32
1683688821658,LATI 10,A03,270054,Kennemore; Amy Michelle,30,0,30,0
1683688822685,LATI 180,A00,202855,Kennemore; Amy Michelle,11,0,20,9
1683688823709,LAWS 101,A00,201767,Golan; Tal,0,7,40,40
1683688824744,LIFR 1C,A00,185961,Staff,6,0,20,14
1683688825771,LIFR 1CX,A00,185962,Staff,7,0,20,13
1683688826797,LIFR 1D,A00,185963,Staff,7,0,20,13
1683688827822,LIFR 1DX,A00,185964,Staff,7,0,20,13
1683688828847,LIGN 101,A01,186039,Staff,43,0,50,7
1683688829871,LIGN 165,A00,186040,Staff,15,0,50,35
1683688830894,LTCS 108,A00,186041,Staff,5,0,10,5
1683688831919,LTCS 119,A00,186042,Staff,15,0,20,5
1683688832959,LTCS 130,A00,186043,Wesling; Megan E.,15,0,25,10
1683688835007,LTEA 138,A00,186119,Staff,14,0,40,26
1683688836036,LTEN 124,A00,186148,Staff,5,0,25,20
1683688837060,LTEN 178,A00,186149,Staff,6,0,15,9
1683688838084,LTEN 181,A00,186150,Blanco; John D,34,0,40,6
1683688839112,LTWL 120,A00,186160,Staff,19,0,25,6
1683688840134,LTWL 165,A00,186161,Staff,22,0,25,3
1683688841158,LTWR 100,A00,186162,Staff,0,5,15,15
1683688842181,LTWR 102,A00,186163,Doller; Ben,5,0,15,10
1683688843205,MAE 8,A01,186412,Staff,0,1,0,0
1683688844229,MAE 30B,A00,186445,Bahadori; Mohammad Yousef,81,0,100,19
1683688845308,MAE 40,A00,186592,Bewley; Thomas R,10,0,50,40
1683688846332,MAE 101B,A00,186593,Bahadori; Mohammad Yousef,80,0,100,20
1683688847357,MAE 105,A00,186594,Bandaru; Prabhakar,10,0,50,40
1683688848381,MAE 107,A00,186599,Pham; Hieu Tan,0,7,120,120
1683688849404,MAE 148,A01,186660,Silberman; Jack,3,0,16,13
1683688850428,MATH 10A,A01,188095,Staff,0,6,35,35
1683688851452,MATH 10B,A01,188097,Bowers; Adam R.,0,12,30,30
1683688851452,MATH 10B,A02,188099,Bowers; Adam R.,0,11,30,30
1683688851452,MATH 10B,B01,188104,Bowers; Adam R.,0,10,30,30
1683688851452,MATH 10B,B02,188106,Bowers; Adam R.,1,9,30,29
1683688852477,MATH 10C,A01,188111,Staff,0,20,30,30
1683688852477,MATH 10C,A02,188127,Staff,0,19,30,30
1683688852477,MATH 10C,A03,188131,Staff,0,19,30,30
1683688852477,MATH 10C,B01,188218,Staff,17,0,30,13
1683688852477,MATH 10C,B02,188244,Staff,13,0,30,17
1683688852477,MATH 10C,B03,188277,Staff,14,0,30,16
1683688853502,MATH 18,A01,188344,Bach; Quang Tran,18,0,30,12
1683688853502,MATH 18,A02,188345,Bach; Quang Tran,11,0,30,19
1683688853502,MATH 18,B01,188353,Bach; Quang Tran,11,0,30,19
1683688853502,MATH 18,B02,188354,Bach; Quang Tran,19,0,30,11
1683688854526,MATH 20A,A01,188374,Staff,11,0,35,24
1683688855552,MATH 20B,A01,188382,Ohm; Ko Woon,7,0,30,23
1683688855552,MATH 20B,A02,188383,Ohm; Ko Woon,22,0,30,8
1683688855552,MATH 20B,B01,188385,Ohm; Ko Woon,7,0,30,23
1683688855552,MATH 20B,B02,188392,Ohm; Ko Woon,22,0,30,8
1683688856581,MATH 20C,A01,188394,Harel; Guershon,10,0,30,20
1683688856581,MATH 20C,A02,188395,Harel; Guershon,13,0,30,17
1683688856581,MATH 20C,B01,188404,Harel; Guershon,5,0,30,25
1683688856581,MATH 20C,B02,188405,Harel; Guershon,18,0,30,12
1683688857607,MATH 20D,A01,188414,Hammock; Frances H,0,1,30,30
1683688857607,MATH 20D,A02,188415,Hammock; Frances H,0,1,30,30
1683688857607,MATH 20D,B01,188447,Hammock; Frances H,0,1,30,30
1683688857607,MATH 20D,B02,188486,Hammock; Frances H,2,0,30,28
1683688858636,MATH 20E,A01,188649,Staff,21,0,30,9
1683688858636,MATH 20E,A02,188650,Staff,20,0,30,10
1683688858636,MATH 20E,A03,188673,Staff,0,0,30,30
1683688859661,MATH 102,A01,188675,Staff,0,40,35,35
1683688860686,MATH 103B,A01,188681,Staff,3,0,35,32
1683688860686,MATH 103B,B01,188692,Staff,5,0,35,30
1683688861713,MATH 109,A01,188695,Salehi Golsefidy; Alireza,24,0,35,11
1683688861713,MATH 109,A02,188696,Salehi Golsefidy; Alireza,25,0,35,10
1683688862738,MATH 120A,A01,188698,Eggers; John Dietrich,7,0,35,28
1683688863765,MATH 142B,A01,188736,Ioana; Adrian,1,1,30,29
1683688863765,MATH 142B,A02,188741,Ioana; Adrian,0,1,30,30
1683688863765,MATH 142B,A03,188743,Ioana; Adrian,0,2,30,30
1683688864790,MATH 168A,A01,188790,Staff,0,11,35,35
1683688865815,MATH 170A,A01,188803,Nie; Jiawang,0,2,35,35
1683688865815,MATH 170A,A02,188811,Nie; Jiawang,0,1,35,35
1683688865815,MATH 170A,A03,188814,Nie; Jiawang,0,0,35,35
1683688865815,MATH 170A,A04,188815,Nie; Jiawang,5,0,35,30
1683688866839,MATH 193B,A01,188817,Staff,0,0,35,35
1683688866839,MATH 193B,A02,188818,Staff,6,0,35,29
1683688867864,MGT 4,A01,202857,Anderson; John Charles,59,0,80,21
1683688868889,MGT 12,A00,202858,Lindenberger; Wade Douglas,40,0,90,50
1683688869916,MGT 18,A00,202859,Staff,74,0,90,16
1683688870941,MGT 18GS,A00,202860,McKay; Michael J,13,0,28,15
1683688871965,MGT 45,A00,202861,Pecore; Joseph P.,8,0,90,82
1683688873031,MGT 100,A00,202863,Yavorsky; Daniel Ryan,27,0,90,63
1683688874055,MGT 103,A00,202864,Ehrich; Kristine R,0,19,90,90
1683688875080,MGT 112,A00,202865,Ehrich; Kristine R,15,0,90,75
1683688876104,MGT 121A,A00,202868,Staff,90,20,90,0
1683688877219,MGT 131B,A00,202869,Anderson; John Charles,59,0,90,31
1683688878244,MGT 136,A00,202871,Lindenberger; Wade Douglas,83,0,90,7
1683688879271,MGT 164,A00,202873,Staff,0,67,90,91
1683688880298,MGT 164GS,A00,202874,McKay; Mary A,13,0,28,15
1683688881323,MGT 180,A00,202875,Staff,0,51,90,91
1683688882346,MMW 11R,A01,205019,Herbst; Matthew,0,0,30,30
1683688882346,MMW 11R,A02,205026,Herbst; Matthew,29,0,30,1
1683688883374,MMW 15,A01,193512,Chang; Edmond Yi-Teh,0,8,28,28
1683688883374,MMW 15,A02,193513,Chang; Edmond Yi-Teh,0,5,28,28
1683688883374,MMW 15,A03,193514,Chang; Edmond Yi-Teh,0,5,28,28
1683688883374,MMW 15,A04,193515,Chang; Edmond Yi-Teh,0,5,28,28
1683688883374,MMW 15,A05,193516,Chang; Edmond Yi-Teh,0,5,28,28
1683688883374,MMW 15,A06,193517,Chang; Edmond Yi-Teh,0,6,28,28
1683688883374,MMW 15,B01,193519,Chang; Edmond Yi-Teh,0,5,28,28
1683688883374,MMW 15,B02,193520,Chang; Edmond Yi-Teh,0,5,28,28
1683688883374,MMW 15,B03,193521,Chang; Edmond Yi-Teh,0,5,28,28
1683688883374,MMW 15,B04,193522,Chang; Edmond Yi-Teh,0,6,28,28
1683688883374,MMW 15,B05,193523,Chang; Edmond Yi-Teh,0,5,28,28
1683688883374,MMW 15,B06,193524,Chang; Edmond Yi-Teh,0,5,28,28
1683688884399,MMW 122,A01,193526,Rahimi; Babak,0,16,28,28
1683688884399,MMW 122,A02,193527,Rahimi; Babak,0,15,28,28
1683688884399,MMW 122,A03,193528,Rahimi; Babak,0,0,0,0
1683688884399,MMW 122,A04,193529,Rahimi; Babak,0,0,0,0
1683688885423,MUS 1A,A01,186663,Staff,1,19,35,34
1683688886446,MUS 4,A01,186715,Staff,0,12,35,35
1683688887471,MUS 5R,A01,186796,Dubnov; Shlomo,0,17,35,35
1683688888498,MUS 6,A01,186798,Staff,1,5,25,24
1683688889524,MUS 7,A01,186830,Staff,11,0,35,24
1683688890549,MUS 8,A01,186930,Staff,0,27,35,35
1683688891572,MUS 15,A01,186932,Staff,0,15,35,35
1683688891572,MUS 15,B01,186934,Staff,1,17,35,34
1683688892600,MUS 80,A00,186935,Staff,0,0,20,20
1683688892600,MUS 80,B00,186936,Staff,24,0,25,1
1683688893626,NANO 11,A00,204702,Lipomi; Darren John,0,0,0,0
1683688894649,NANO 15,A01,204709,Yang; Kesong,0,1,0,0
1683688895673,NANO 114,A00,202069,Jahed Motlagh; Zeinab,2,0,10,8
1683688896697,PHIL 1,A00,186955,Grush; Rick Scott,31,0,40,9
1683688897726,PHIL 10,A01,186973,Grush; Rick Scott,27,0,35,8
1683688897726,PHIL 10,A02,186974,Grush; Rick Scott,33,0,35,2
1683688898753,PHIL 13,A01,186976,Staff,1,0,35,34
1683688898753,PHIL 13,A02,186977,Staff,16,0,35,19
1683688899780,PHIL 14,A01,186979,Staff,31,0,35,4
1683688899780,PHIL 14,A02,186986,Staff,32,0,35,3
1683688900809,PHIL 28,A01,186988,Staff,16,0,30,14
1683688900809,PHIL 28,A02,186989,Staff,1,0,30,29
1683688900809,PHIL 28,A03,186990,Staff,10,0,30,20
1683688900809,PHIL 28,A04,186991,Staff,26,0,30,4
1683688901836,PHIL 120,A00,186997,Staff,23,0,40,17
1683688902862,PHIL 137,A00,187003,Staff,7,0,40,33
1683688903890,PHIL 150,A00,187015,Staff,47,0,70,23
1683688904919,PHIL 167,A00,187021,Lamey; Andy M.,34,0,40,6
1683688905944,PHIL 174,A01,202226,Staff,17,0,20,3
1683688905944,PHIL 174,A02,202235,Staff,20,0,20,0
1683688906968,PHIL 191A,A00,258918,Staff,0,0,1,1
1683688907997,PHYS 1A,A00,187028,Staff,26,0,60,34
1683688909022,PHYS 1AL,001,187036,Staff,3,0,30,27
1683688909022,PHYS 1AL,002,187049,Staff,18,0,30,12
1683688910050,PHYS 1B,A00,187058,Staff,22,0,60,38
1683688911078,PHYS 1BL,001,187064,Staff,0,1,30,30
1683688911078,PHYS 1BL,002,187070,Staff,4,0,30,26
1683688912106,PHYS 1C,A00,187082,Staff,29,0,120,91
1683688913134,PHYS 1CL,001,187088,Staff,0,9,30,30
1683688913134,PHYS 1CL,002,187089,Staff,0,1,30,30
1683688913134,PHYS 1CL,009,262693,Staff,9,0,30,21
1683688914161,PHYS 2B,A01,187097,Staff,55,0,115,60
1683688915189,PHYS 2C,A01,187099,Staff,63,0,115,52
1683688916214,PHYS 2CL,A01,187101,Staff,5,0,28,23
1683688916214,PHYS 2CL,A02,187102,Staff,15,0,28,13
1683688917240,PHYS 2D,A01,187123,Shotwell; Brian,95,0,115,20
1683688918267,PHYS 4B,A01,187133,Grinstein; Benjamin,35,0,50,15
1683688919292,POLI 10,A00,188819,Staff,0,4,50,50
1683688920320,POLI 11,A00,188827,Staff,43,0,50,7
1683688921348,POLI 13R,A00,188828,Staff,0,1,20,20
1683688922375,POLI 27,A01,188830,Elgin; Samuel Zincke,0,2,70,70
1683688923399,POLI 30,A00,188832,Desposato; Scott,30,0,50,20
1683688924422,POLI 102F,A00,188834,Staff,1,0,40,39
1683688925447,POLI 104A,A00,188852,Staff,12,0,30,18
1683688926472,POLI 104I,A00,188853,Staff,0,8,20,20
1683688927497,POLI 110B,A00,188854,Wiens; David,6,0,20,14
1683688928522,POLI 112A,A00,188855,Wiens; David,3,0,30,27
1683688929547,POLI 117R,A00,188856,Forman; Fonna,0,12,20,20
1683688930570,POLI 118,A00,188857,Ingham; Sean,8,0,20,12
1683688931599,POLI 120G,A00,188858,Staff,8,0,30,22
1683688932623,POLI 131CR,A00,188863,Hoston; Germaine,20,0,50,30
1683688933650,POLI 133,A00,188864,Nellis; Gareth Hb,44,0,50,6
1683688934674,POLI 134D,A00,188865,Desposato; Scott,27,0,30,3
1683688935699,POLI 142A,A00,188871,Gartzke; Erik,21,0,50,29
1683688936725,POLI 142K,A00,188874,Staff,38,0,50,12
1683688937750,POLI 143,A00,188940,Gartzke; Erik,16,0,30,14
1683688938777,POLI 153,A00,188943,Staff,2,0,20,18
1683688939804,POLI 160AA,A00,188944,Staff,10,0,40,30
1683688940828,POLI 170A,A00,188945,Staff,10,0,30,20
1683688942884,PSYC 1,A00,188952,Staff,36,0,90,54
1683688943911,PSYC 2,B00,188953,Staff,19,0,35,16
1683688944935,PSYC 6,A00,188970,Staff,47,0,60,13
1683688945962,PSYC 7,A00,188973,Staff,35,0,45,10
1683688946987,PSYC 60,A01,188980,Rickard; Timothy C.,42,0,60,18
1683688948015,PSYC 70,A01,189001,Steiner; Eric Tomas,21,0,45,24
1683688949094,PSYC 100,A00,189005,Lacefield; Katharine I,0,99,120,120
1683688950119,PSYC 102,A00,189008,Staff,7,0,30,23
1683688951145,PSYC 106,B00,189026,Gorman; Michael R.,27,0,60,33
1683688952170,PSYC 114,B01,189033,Winkielman; Piotr,0,31,30,30
1683688953198,PSYC 131,A00,189036,Anagnostaras; Stephan,0,43,60,60
1683688954223,PSYC 136,A00,189041,Lowe; Angela Beth,0,7,25,25
1683688955248,PSYC 137,A00,189057,Winkielman; Piotr,1,37,25,24
1683688956276,PSYC 144,A00,189107,Wixted; John T,0,11,50,50
1683688958325,PSYC 162,A00,189142,Staff,0,9,85,85
1683688959350,PSYC 172,A00,189144,Gorman; Michael R.,0,6,30,30
1683688961402,PSYC 179,A00,189146,Lacefield; Katharine I,0,88,120,120
1683688962429,PSYC 181,A00,189147,Anagnostaras; Stephan,0,44,90,90
1683688963454,PSYC 190R,A00,189148,Barner; David A.,0,23,80,80
1683688964478,PSYC 191,A00,189275,Rickard; Timothy C.,0,11,25,25
1683688965503,PSYC 193,A00,189276,Chapman; Eddie Nathaniel,0,1,0,4
1683688966533,PSYC 193L,A01,189281,Lowe; Angela Beth,8,0,20,12
1683688966533,PSYC 193L,B01,189285,Staff,28,0,35,7
1683688967557,RELI 149,A00,187137,Rahimi; Babak,6,0,40,34
1683688968583,SE 9,A01,187315,Staff,0,2,18,18
1683688969608,SE 101B,A00,187409,Staff,24,0,30,6
1683688970635,SE 110B,A00,187444,Staff,10,0,40,30
1683688971659,SE 130B,A00,187449,Staff,31,0,40,9
1683688972681,SE 150A,A00,187516,Staff,8,0,20,12
1683688973710,SE 154,A00,187528,Staff,29,0,50,21
1683688974736,SIO 3,A01,258171,Staff,35,0,40,5
1683688975760,SIO 10,A00,187144,Cook; Geoffrey W,1,7,75,74
1683688976785,SIO 45,A00,187152,Cook; Geoffrey W,0,7,100,100
1683688977809,SIO 109R,A00,194486,Staff,0,4,20,20
1683688979864,SIO 187,A01,187233,Kacev; David,12,0,40,28
1683688980892,SOCI 1,A01,258656,Thorpe; Charles Robert,28,0,30,2
1683688980892,SOCI 1,A02,258658,Thorpe; Charles Robert,30,0,30,0
1683688980892,SOCI 1,A03,258661,Thorpe; Charles Robert,25,0,25,0
1683688980892,SOCI 1,A04,258666,Thorpe; Charles Robert,22,0,25,3
1683688980892,SOCI 1,A05,258897,Thorpe; Charles Robert,22,0,25,3
1683688980892,SOCI 1,A06,258898,Thorpe; Charles Robert,25,0,25,0
1683688981920,SOCI 30,A01,258903,Pardo Guerra; Juan Pablo,14,0,30,16
1683688982948,SOCI 102,A00,258904,Staff,9,0,25,16
1683688983972,SOCI 106,A00,258905,Staff,19,0,25,6
1683688985000,SOCI 111,A00,258907,Ribas Norris; Janet Vanesa,26,0,30,4
1683688986027,SOCI 121R,A00,258908,Pardo Guerra; Juan Pablo,8,0,30,22
1683688987055,SOCI 126,A01,203330,Staff,14,0,20,6
1683688988079,SOCI 131,A00,258909,Thorpe; Charles Robert,30,0,60,30
1683688989103,SOCI 135,A00,258910,Payne; Christine Anna,0,12,30,30
1683688990131,SOCI 157,A00,258911,Staff,11,0,30,19
1683688991155,SOCI 184,A00,258912,Staff,25,0,30,5
1683688992179,SOCI 188D,A00,258913,Staff,22,0,30,8
1683688993202,SYN 2,001,187529,Staff,9,0,16,7
1683688993202,SYN 2,002,201452,Staff,1,20,16,15
1683688993202,SYN 2,003,201469,Staff,1,0,16,15
1683688994227,SYN 100,A01,187531,Staff,0,9,20,20
1683688994227,SYN 100,B01,201491,Staff,0,10,20,20
1683688995250,TDAC 1,A00,189286,Walsh; Kim C.,3,0,20,17
1683688995250,TDAC 1,B00,189287,Harting; Carla Kelso,10,0,20,10
1683688996276,TDAC 101,A00,189300,Walsh; Kim C.,16,0,20,4
1683688996276,TDAC 101,B00,189301,Harting; Carla Kelso,18,0,20,2
1683688997300,TDAC 102,A00,189304,Basso; Beatrice,14,0,20,6
1683688998327,TDAC 108,A00,189305,Staff,18,0,20,2
1683688999354,TDDE 131,A00,189310,Staff,19,0,20,1
1683688999354,TDDE 131,B00,189314,Staff,19,0,20,1
1683688999354,TDDE 131,C00,189315,Staff,48,0,50,2
1683688999354,TDDE 131,D00,189316,Staff,14,0,15,1
1683688999354,TDDE 131,E00,204841,Staff,20,0,20,0
1683689000380,TDGE 10,A00,189289,Staff,27,0,50,23
1683689000380,TDGE 10,B00,189290,Havis; Allan,0,1,50,50
1683689001409,TDGE 11,A00,189291,Fulton; Julia,0,4,50,50
1683689001409,TDGE 11,B00,189292,Staff,20,0,25,5
1683689001409,TDGE 11,C00,260270,Staff,0,0,0,0
1683689002436,TDGE 25,A00,189294,Staff,1,0,20,19
1683689003459,TDGE 124,A00,189318,Fulton; Julia,1,8,50,49
1683689004485,TDGE 125,A00,189319,Staff,13,0,25,12
1683689004485,TDGE 125,B00,189320,Staff,23,0,25,2
1683689005511,TDGE 127,A00,189322,Havis; Allan,0,0,50,50
1683689006537,TDHT 101,A00,189323,Staff,18,0,25,7
1683689006537,TDHT 101,B00,189324,Staff,25,0,25,0
1683689007565,TDHT 102,A00,189325,Staff,49,0,50,1
1683689008590,TDMV 1,A00,189295,Arcidiacono; Kristin,20,0,30,10
1683689008590,TDMV 1,B00,189296,Caligagan; Maria T.,24,0,30,6
1683689009614,TDMV 2,A00,189297,Sammartano; Tonnie,27,0,30,3
1683689009614,TDMV 2,B00,189299,Arcidiacono; Kristin,23,0,30,7
1683689010638,TDMV 3,A00,204998,Rincon; Alicia,22,0,30,8
1683689011665,TDMV 120,A00,189458,Sammartano; Tonnie,28,0,30,2
1683689012690,TDMV 138,A00,189541,Jun; Grace Shin Hae,20,0,40,20
1683689013715,TDMV 142,A00,189717,Caligagan; Tony,25,0,30,5
1683689013715,TDMV 142,B00,189718,Caligagan; Maria T.,25,0,30,5
1683689014740,TMC 2,A01,187533,Staff,25,0,25,0
1683689014740,TMC 2,A02,187534,Staff,25,0,25,0
1683689015765,USP 1,A01,187536,Kwak; Nancy,0,16,25,25
1683689016792,USP 5,A01,187538,Staff,8,0,25,17
1683689017818,USP 101,A00,199253,Staff,0,4,0,0
1683689018845,USP 124,A00,187562,Boomhower; Matthew Charles,0,0,30,30
1683689019870,USP 138,A00,187582,Staff,19,0,25,6
1683689020894,USP 152,A01,187597,Staff,3,0,25,22
1683689021918,USP 153,A00,187598,Staff,18,0,25,7
1683689022942,USP 168,A00,187607,Kwak; Nancy,2,0,5,3
1683689023967,USP 173,A00,187619,Staff,4,0,25,21
1683689024992,USP 181,A00,187638,Staff,0,4,25,25
1683689026019,VIS 103,A00,187650,Cruz; Edwin Teddy,17,0,75,58
1683689027044,VIS 110D,A00,187669,Staff,13,0,22,9
1683689028071,VIS 127C,A00,187720,Shen; Kuiyi,67,0,146,79
1683689029094,VIS 149,A00,187731,Yoldas; Pinar,1,14,22,21
1683689030117,VIS 151,A01,188091,Staff,22,0,34,12
1683689030117,VIS 151,A02,188092,Staff,11,0,34,23
1683689031144,VIS 160B,A00,188093,Stalbaum; Brett,0,1,10,10
1683689033192,WCWP 10B,A00,201720,Staff,0,0,5,5
1683689033192,WCWP 10B,B00,201722,Staff,0,0,6,6
1683689034216,WCWP 100,A00,201725,Gagnon; Jeffrey C,0,0,2,2
1683689034216,WCWP 100,B00,201727,Staff,0,4,15,15
1683689037307,ANBI 133,A00,258401,Wilder; Linnea Lorene,34,0,40,6
1683689038332,ANBI 140,A00,258395,Hrvoj Mihic; Branka,18,0,25,7
1683689039359,ANSC 120,A00,258402,Bialecki; Jon Anthony,26,0,40,14
1683689040386,ANSC 144,A00,258400,Staff,12,0,40,28
1683689042444,ANSC 166,A00,258396,Parish; Steven Martin,156,0,175,19
1683689043468,ANSC 180,A00,193533,Staff,8,0,20,12
1683689044494,ANSC 188,A00,258397,Jassal; Aftab,34,0,40,6
1683689045518,ANTH 3,A01,258316,Staff,23,0,30,7
1683689046546,ANTH 5,A00,258394,Semendeferi; Ekaterini,16,0,20,4
1683689047572,ANTH 21,A01,258331,Staff,4,0,40,36
1683689048596,ANTH 103,A00,258398,Varma; Saiba,15,0,25,10
1683689049623,AWP 10,001,202034,Staff,0,0,0,0
1683689049623,AWP 10,002,202035,Staff,0,0,0,0
1683689049623,AWP 10,003,202036,Staff,0,0,0,0
1683689049623,AWP 10,004,202037,Staff,0,0,0,0
1683689049623,AWP 10,005,202038,Staff,0,0,0,0
1683689049623,AWP 10,006,202039,Staff,0,0,0,0
1683689049623,AWP 10,007,202040,Staff,0,0,0,0
1683689049623,AWP 10,008,202041,Staff,0,0,0,0
1683689049623,AWP 10,009,202042,Staff,0,0,0,0
1683689049623,AWP 10,010,202043,Staff,0,0,0,0
1683689049623,AWP 10,011,202044,Staff,0,0,0,0
1683689049623,AWP 10,012,202045,Staff,0,0,0,0
1683689049623,AWP 10,013,202046,Staff,0,0,0,0
1683689049623,AWP 10,014,202047,Staff,0,0,0,0
1683689049623,AWP 10,015,202048,Staff,0,0,0,0
1683689049623,AWP 10,016,202049,Staff,0,0,0,0
1683689049623,AWP 10,017,202050,Staff,0,0,0,0
1683689049623,AWP 10,018,202051,Staff,0,0,0,0
1683689049623,AWP 10,019,202052,Staff,0,0,0,0
1683689049623,AWP 10,020,202053,Staff,0,0,0,0
1683689049623,AWP 10,021,202054,Staff,0,0,0,0
1683689049623,AWP 10,022,202055,Staff,0,0,0,0
1683689049623,AWP 10,023,202056,Staff,0,0,0,0
1683689049623,AWP 10,024,202057,Staff,0,0,0,0
1683689049623,AWP 10,025,202058,Staff,0,0,0,0
1683689049623,AWP 10,026,202059,Staff,0,0,0,0
1683689050647,AWP 102,001,202032,Staff,0,0,0,0
1683689050647,AWP 102,002,202033,Staff,0,0,0,0
1683689051669,BENG 100,A01,254234,Taylor Amos; Alyssa C,31,0,40,9
1683689052771,BENG 196,001,270013,Engler; Adam J.,9999,0,9999,0
1683689053798,BICD 100R,A01,202018,Smith; Laurie,0,7,32,32
1683689053798,BICD 100R,A02,202019,Smith; Laurie,0,3,32,32
1683689053798,BICD 100R,A03,202020,Smith; Laurie,0,1,32,32
1683689053798,BICD 100R,A04,202021,Smith; Laurie,6,0,32,26
1683689053798,BICD 100R,A05,202022,Smith; Laurie,10,0,32,22
1683689054829,BICD 136,A01,193242,Gustafson-Brown; Cindy,0,2,32,32
1683689054829,BICD 136,A02,193244,Gustafson-Brown; Cindy,13,0,32,19
1683689055854,BIEB 102,A01,193249,Butler; Shannon Rhey,1,1,32,31
1683689055854,BIEB 102,A02,193251,Butler; Shannon Rhey,0,0,32,32
1683689055854,BIEB 102,A03,193253,Butler; Shannon Rhey,0,0,32,32
1683689055854,BIEB 102,A04,193255,Butler; Shannon Rhey,13,0,32,19
1683689055854,BIEB 102,A05,193265,Butler; Shannon Rhey,25,0,32,7
1683689055854,BIEB 102,A06,193269,Butler; Shannon Rhey,13,0,32,19
1683689057908,BIEB 150,A01,193274,Staff,0,0,32,32
1683689057908,BIEB 150,A02,193285,Staff,24,0,32,8
1683689058933,BIEB 194,A00,193286,Kurle; Carolyn M.,19,0,32,13
1683689059962,BILD 1,A01,192291,Staff,15,0,32,17
1683689059962,BILD 1,A02,192292,Staff,30,0,32,2
1683689059962,BILD 1,B01,192520,Reuther; Keefe,0,1,0,0
1683689059962,BILD 1,B02,192532,Reuther; Keefe,0,1,0,0
1683689060992,BILD 3,A01,192556,Butler; Shannon Rhey,0,0,32,32
1683689060992,BILD 3,A02,192581,Butler; Shannon Rhey,0,1,32,32
1683689060992,BILD 3,A03,192611,Butler; Shannon Rhey,19,0,32,13
1683689060992,BILD 3,A04,192612,Butler; Shannon Rhey,24,0,32,8
1683689060992,BILD 3,A05,192613,Butler; Shannon Rhey,26,0,32,6
1683689060992,BILD 3,A06,192679,Butler; Shannon Rhey,27,0,32,5
1683689060992,BILD 3,A07,192682,Butler; Shannon Rhey,20,0,32,12
1683689062022,BILD 4,A01,192836,Reuther; Keefe,1,0,24,23
1683689062022,BILD 4,A02,193044,Reuther; Keefe,4,0,24,20
1683689063049,BILD 10,A01,193142,Gustafson-Brown; Cindy,29,0,32,3
1683689063049,BILD 10,A02,193149,Gustafson-Brown; Cindy,31,0,32,1
1683689064077,BIMM 100,A01,193301,Staff,0,6,32,32
1683689064077,BIMM 100,A02,193312,Staff,0,7,32,32
1683689064077,BIMM 100,A03,193323,Staff,0,10,32,32
1683689065101,BIMM 101,A01,193329,McDonnell; Lisa Marie,1,4,24,23
1683689065101,BIMM 101,A02,193339,McDonnell; Lisa Marie,1,4,24,23
1683689065101,BIMM 101,B01,193354,McDonnell; Lisa Marie,0,4,24,24
1683689065101,BIMM 101,B02,193357,McDonnell; Lisa Marie,0,3,24,24
1683689066128,BIMM 110,A01,193377,Tat; John,0,11,32,32
1683689066128,BIMM 110,A02,193378,Tat; John,0,11,32,32
1683689067158,BIMM 120,A01,206116,Staff,0,0,32,32
1683689067158,BIMM 120,A02,206117,Staff,7,0,32,25
1683689067158,BIMM 120,A03,206121,Staff,21,0,32,11
1683689068182,BIPN 100,A01,193393,Park; Ji Young,0,15,32,32
1683689068182,BIPN 100,A02,193402,Park; Ji Young,0,14,32,32
1683689068182,BIPN 100,A03,193413,Park; Ji Young,0,14,32,32
1683689068182,BIPN 100,A04,193414,Park; Ji Young,0,13,32,32
1683689069210,BIPN 102,A01,193429,Staff,0,0,32,32
1683689069210,BIPN 102,A02,193438,Staff,18,0,32,14
1683689070233,BIPN 106,A01,193450,Reyes Gonzalez; Catalina,0,2,40,40
1683689071256,BIPN 134,A01,193465,Cooke; James Edward,0,0,32,32
1683689071256,BIPN 134,A02,193474,Cooke; James Edward,25,0,32,7
1683689071256,BIPN 134,A03,193485,Cooke; James Edward,29,0,32,3
1683689071256,BIPN 134,A04,193486,Cooke; James Edward,20,0,32,12
1683689071256,BIPN 134,A05,193491,Cooke; James Edward,31,0,32,1
1683689071256,BIPN 134,A06,193501,Cooke; James Edward,30,0,32,2
1683689071256,BIPN 134,A07,193510,Cooke; James Edward,29,0,32,3
1683689073307,BISP 194,A00,222522,Staff,14,0,32,18
1683689074335,CAT 124,A01,202407,Staff,19,0,25,6
1683689075359,CAT 125,A00,202408,Marchisotto; Jennifer Anne,2,0,20,18
1683689076382,CAT 125R,A00,202409,Smith; Lauryn Alissa,0,11,20,20
1683689076382,CAT 125R,B00,202410,Morales; Celeste Georgianna,0,11,20,20
1683689076382,CAT 125R,C00,202411,Irwin; Matthew Joseph,0,12,20,20
1683689077410,CENG 15,A01,204712,Yang; Kesong,0,1,0,0
1683689078438,CENG 114,A00,202070,Jahed Motlagh; Zeinab,5,0,20,15
1683689079463,CGS 105,A00,185477,Wesling; Megan E.,24,0,40,16
1683689080488,CGS 106,A00,185494,Staff,11,0,22,11
1683689081513,CGS 108,A00,185495,Staff,14,0,20,6
1683689082538,CGS 114,A00,185496,Staff,13,0,18,5
1683689083564,CGS 119,A00,185501,Staff,15,0,20,5
1683689084591,CGS 120,A00,185511,Staff,12,0,20,8
1683689085617,CHEM 4,A01,184675,Bussey; Thomas J,97,0,100,3
1683689086642,CHEM 6A,A01,184677,Staff,32,0,60,28
1683689087669,CHEM 6B,A01,184679,Staff,63,0,100,37
1683689088698,CHEM 6C,A01,184681,Bussey; Thomas J,0,0,50,50
1683689088698,CHEM 6C,A02,184682,Bussey; Thomas J,32,0,50,18
1683689089722,CHEM 40A,A01,184684,Albizati; Kim F.,33,0,100,67
1683689090752,CHEM 40B,A01,184686,Albizati; Kim F.,0,22,100,100
1683689091778,CHEM 41B,A01,184690,Staff,51,0,100,49
1683689092803,COGS 3,A01,184715,Boyle; Mary E. T.,0,27,40,40
1683689093826,COGS 14B,A01,185172,Staff,0,14,38,38
1683689094851,COGS 18,A01,184736,Staff,14,0,80,66
1683689095874,COGS 100,A01,184932,Staff,0,8,73,73
1683689096898,COGS 101A,A01,184935,Staff,0,40,30,30
1683689097922,COGS 101B,A01,184944,Staff,0,2,30,30
1683689098946,COGS 101C,A01,184946,Staff,0,10,30,30
1683689099971,COGS 102A,A01,184951,Johnson; Christine M.,1,0,40,39
1683689101000,COGS 107B,A01,184953,Mooshagian; Eric Frederick,0,52,40,40
1683689102031,COGS 118B,A01,184959,Gupta; Anjum,0,50,40,40
1683689103061,COGS 153,A00,184961,Staff,0,16,30,30
1683689104086,COGS 177,A00,184962,Staff,1,21,30,29
1683689105112,COGS 187A,A01,184969,Boyle; Mary E. T.,0,19,40,40
1683689106137,COMM 10,A01,185174,Staff,0,5,25,25
1683689106137,COMM 10,A02,185189,Staff,0,2,25,25
1683689106137,COMM 10,A03,269821,Staff,0,1,0,0
1683689107165,COMM 100B,A02,185476,Staff,10,0,25,15
1683689107165,COMM 100B,A03,277340,Staff,25,0,25,0
1683689108192,COMM 100C,A01,185314,Staff,1,0,25,24
1683689108192,COMM 100C,A02,185327,Staff,17,0,25,8
1683689109219,COMM 110M,A00,185349,Staff,0,0,40,40
1683689110242,COMM 113T,A00,185352,Staff,25,0,40,15
1683689111266,COMM 114I,A00,185353,Staff,31,0,40,9
1683689112290,COMM 131,A00,185354,Staff,17,0,30,13
1683689113318,CSE 8A,A50,185358,Cao; Yingjun,0,46,10,10
1683689114343,CSE 8B,A01,185362,Staff,0,48,50,50
1683689115367,CSE 11,A01,185416,Cao; Yingjun,0,91,10,10
1683689116391,CSE 20,A01,185445,Briones; Jor-el Thomas Caparas,3,0,25,22
1683689117415,CSE 21,A01,185447,Staff,9,0,50,41
1683689118444,CSE 101,A01,185451,Staff,0,13,50,50
1683689118444,CSE 101,B01,185453,Jones; Miles E,0,14,50,50
1683689120491,CSE 141,A01,185458,Eldon; John,16,0,100,84
1683689121515,CSE 141L,A01,185461,Eldon; John,8,0,100,92
1683689122539,CSE 142,A01,185463,Staff,34,0,60,26
1683689122539,CSE 142,B01,201355,Staff,0,7,60,60
1683689123563,CSE 142L,A01,185470,Staff,34,0,60,26
1683689123563,CSE 142L,B01,201417,Staff,0,6,60,60
1683689124587,CSE 190,A00,201433,Staff,32,0,49,17
1683689125612,DOC 1,A01,259136,Strom; Megan C.,7,0,15,8
1683689125612,DOC 1,A02,259137,Strom; Megan C.,14,0,15,1
1683689125612,DOC 1,A03,259138,Strom; Megan C.,14,0,15,1
1683689125612,DOC 1,A04,259139,Strom; Megan C.,14,0,15,1
1683689126637,DOC 100D,A00,259140,Pass; Natalye Joann,14,0,25,11
1683689127665,DSGN 1,A01,184749,Rill; Bryan,0,26,30,30
1683689128690,DSGN 100,A01,185168,Staff,0,2,25,25
1683689129713,ECE 5,A01,185626,Morris; Karcher William,0,12,0,0
1683689130738,ECE 101,A01,185628,Staff,14,0,70,56
1683689131767,ECE 107,A01,185635,Baghdadchi; Saharnaz,0,0,20,20
1683689131767,ECE 107,A02,185638,Baghdadchi; Saharnaz,1,0,20,19
1683689132794,ECE 148,A01,185647,Silberman; Jack,0,0,16,16
1683689133821,ECON 1,A01,185537,Crane; Meredith Helen,54,0,70,16
1683689134844,ECON 3,A01,185549,Crane; Meredith Helen,30,0,70,40
1683689135868,ECON 4,A01,203354,Anderson; John Charles,0,5,10,10
1683689136891,ECON 100A,A01,185574,Staff,0,5,40,40
1683689137923,ECON 100B,A01,185576,Staff,0,12,50,50
1683689138950,ECON 100C,A01,185589,Newhouse; Herbert S,30,0,70,40
1683689139976,ECON 105,A00,185608,Vespa; Emanuel Ignacio,19,0,35,16
1683689141001,ECON 109,A01,185610,Shishkin; Denis,9,0,35,26
1683689142025,ECON 110A,A01,185612,Staff,8,0,40,32
1683689143050,ECON 120A,A01,185615,Staff,19,0,40,21
1683689144077,ECON 120C,A01,185617,Sun; Yixiao,0,21,70,70
1683689145102,ECON 144,A00,203346,Squires; Dale E,2,0,35,33
1683689146126,ECON 171,A01,203349,Newhouse; Herbert S,0,1,35,35
1683689147151,ECON 173A,A01,185621,Toda; Alexis Akira,21,0,35,14
1683689148175,EDS 25,A01,202413,Staff,0,1,0,0
1683689148175,EDS 25,A02,202414,Staff,0,1,0,0
1683689148175,EDS 25,A03,202415,Staff,0,0,0,0
1683689148175,EDS 25,A04,202416,Staff,0,1,0,0
1683689148175,EDS 25,A05,202439,Staff,0,0,0,0
1683689148175,EDS 25,A06,202440,Staff,0,0,0,0
1683689148175,EDS 25,B01,202631,Staff,0,0,0,0
1683689148175,EDS 25,B02,202632,Staff,0,0,0,0
1683689148175,EDS 25,B03,202639,Staff,0,0,0,0
1683689148175,EDS 25,B04,202640,Staff,0,0,0,0
1683689148175,EDS 25,B05,202643,Staff,0,0,0,0
1683689148175,EDS 25,B06,202644,Staff,0,0,0,0
1683689149199,EDS 38,A01,202659,Black; Alison Michelle,24,0,25,1
1683689150223,EDS 115,A00,202652,Staff,18,0,30,12
1683689151251,EDS 125,A00,202649,Staff,13,0,30,17
1683689152276,EDS 126,A01,203332,Staff,30,0,30,0
1683689153303,EDS 139,A00,202838,Staff,16,0,25,9
1683689154330,EDS 146,A01,202655,Staff,14,0,25,11
1683689155358,ENG 15,A00,185667,Staff,0,1,0,0
1683689155358,ENG 15,B00,185672,Staff,0,0,0,0
1683689155358,ENG 15,C00,185675,Staff,0,0,0,0
1683689155358,ENG 15,D00,185682,Staff,0,0,0,0
1683689155358,ENG 15,E00,185684,Staff,0,0,0,0
1683689156440,ETHN 103,A00,185710,Staff,0,8,35,35
1683689157466,ETHN 103A,A00,199228,Man; Simeon S,0,0,9,9
1683689158494,ETHN 109,A00,185711,Staff,15,0,35,20
1683689159521,ETHN 142,A00,185726,Staff,0,4,30,30
1683689160545,ETHN 163J,A00,199229,Man; Simeon S,5,0,8,3
1683689161573,ETHN 168,A00,185727,Staff,7,0,10,3
1683689162600,ETHN 182,A00,185728,Staff,0,0,35,35
1683689163625,ETHN 183,A00,185737,Staff,9,0,18,9
1683689164650,GLBH 111,A01,209361,Burgos; Jose L.,0,0,0,0
1683689166707,HIEU 104,A00,185792,Staff,14,0,20,6
1683689167734,HIEU 115,A00,185800,Staff,0,0,20,20
1683689168761,HIEU 128,A00,185801,Staff,0,9,20,20
1683689169786,HIEU 147,A00,185802,Staff,15,0,20,5
1683689170812,HIEU 154,A00,185823,Staff,11,0,20,9
1683689171843,HILA 102,A00,185826,Staff,14,0,20,6
1683689172868,HILD 2C,A01,185778,Staff,0,13,20,20
1683689173893,HILD 7B,A01,185780,Kwak; Nancy,0,17,32,32
1683689173893,HILD 7B,A02,185781,Kwak; Nancy,0,18,32,32
1683689174918,HILD 30,A01,185791,Staff,12,0,20,8
1683689175943,HISC 119,A00,185830,Golan; Tal,0,10,20,20
1683689176968,HITO 156GS,A00,185831,Patterson; Patrick H.,0,0,0,23
1683689177993,HIUS 103,A00,185832,Man; Simeon S,0,4,20,20
1683689179021,HIUS 117,A00,185836,Kwak; Nancy,2,0,20,18
1683689180049,HIUS 125,A00,185840,Man; Simeon S,0,2,23,23
1683689181076,HIUS 149,A00,185845,Staff,1,0,20,19
1683689182103,HUM 3,A01,185882,Zavodny; Tatiana Sophia,0,8,50,50
1683689182103,HUM 3,B01,185899,Caldwell; Michael Alan,0,18,50,50
1683689183131,HUM 3GS,A00,185900,Patterson; Patrick H.,0,0,0,23
1683689184156,HUM 4,A01,185938,Zroka; Amy Liane,28,0,50,22
1683689184156,HUM 4,B01,185956,Watkins; Eric,0,6,50,50
1683689184156,HUM 4,B02,202209,Watkins; Eric,0,5,50,50
1683689184156,HUM 4,B03,202210,Watkins; Eric,0,5,50,50
1683689185179,HUM 5,A01,185958,West; Geoffrey Scott,0,0,50,50
1683689185179,HUM 5,A02,202215,West; Geoffrey Scott,0,1,50,50
1683689186210,INTL 190,A00,185959,Gagnon; Jeffrey C,0,0,0,9
1683689186210,INTL 190,B00,185960,Lettieri; Michael Joseph,0,0,0,2
1683689187238,JAPN 180,A00,254509,Staff,5,0,30,25
1683689188264,LATI 10,A01,202853,Kennemore; Amy Michelle,4,0,35,31
1683689188264,LATI 10,A02,202854,Kennemore; Amy Michelle,3,0,35,32
1683689188264,LATI 10,A03,270054,Kennemore; Amy Michelle,30,0,30,0
1683689189288,LATI 180,A00,202855,Kennemore; Amy Michelle,11,0,20,9
1683689190316,LAWS 101,A00,201767,Golan; Tal,0,7,40,40
1683689191340,LIFR 1C,A00,185961,Staff,6,0,20,14
1683689192364,LIFR 1CX,A00,185962,Staff,7,0,20,13
1683689193388,LIFR 1D,A00,185963,Staff,7,0,20,13
1683689194416,LIFR 1DX,A00,185964,Staff,7,0,20,13
1683689195441,LIGN 101,A01,186039,Staff,43,0,50,7
1683689196466,LIGN 165,A00,186040,Staff,15,0,50,35
1683689197493,LTCS 108,A00,186041,Staff,5,0,10,5
1683689198517,LTCS 119,A00,186042,Staff,15,0,20,5
1683689199540,LTCS 130,A00,186043,Wesling; Megan E.,15,0,25,10
1683689201597,LTEA 138,A00,186119,Staff,14,0,40,26
1683689202625,LTEN 124,A00,186148,Staff,5,0,25,20
1683689203650,LTEN 178,A00,186149,Staff,6,0,15,9
1683689204675,LTEN 181,A00,186150,Blanco; John D,34,0,40,6
1683689205700,LTWL 120,A00,186160,Staff,19,0,25,6
1683689206722,LTWL 165,A00,186161,Staff,22,0,25,3
1683689207747,LTWR 100,A00,186162,Staff,0,5,15,15
1683689208775,LTWR 102,A00,186163,Doller; Ben,5,0,15,10
1683689209799,MAE 8,A01,186412,Staff,0,1,0,0
1683689210825,MAE 30B,A00,186445,Bahadori; Mohammad Yousef,81,0,100,19
1683689211854,MAE 40,A00,186592,Bewley; Thomas R,10,0,50,40
1683689212881,MAE 101B,A00,186593,Bahadori; Mohammad Yousef,80,0,100,20
1683689213906,MAE 105,A00,186594,Bandaru; Prabhakar,10,0,50,40
1683689214935,MAE 107,A00,186599,Pham; Hieu Tan,0,7,120,120
1683689215963,MAE 148,A01,186660,Silberman; Jack,3,0,16,13
1683689216988,MATH 10A,A01,188095,Staff,0,6,35,35
1683689218019,MATH 10B,A01,188097,Bowers; Adam R.,0,12,30,30
1683689218019,MATH 10B,A02,188099,Bowers; Adam R.,0,11,30,30
1683689218019,MATH 10B,B01,188104,Bowers; Adam R.,0,10,30,30
1683689218019,MATH 10B,B02,188106,Bowers; Adam R.,1,9,30,29
1683689219050,MATH 10C,A01,188111,Staff,0,20,30,30
1683689219050,MATH 10C,A02,188127,Staff,0,19,30,30
1683689219050,MATH 10C,A03,188131,Staff,0,19,30,30
1683689219050,MATH 10C,B01,188218,Staff,17,0,30,13
1683689219050,MATH 10C,B02,188244,Staff,13,0,30,17
1683689219050,MATH 10C,B03,188277,Staff,14,0,30,16
1683689220075,MATH 18,A01,188344,Bach; Quang Tran,18,0,30,12
1683689220075,MATH 18,A02,188345,Bach; Quang Tran,11,0,30,19
1683689220075,MATH 18,B01,188353,Bach; Quang Tran,11,0,30,19
1683689220075,MATH 18,B02,188354,Bach; Quang Tran,19,0,30,11
1683689221101,MATH 20A,A01,188374,Staff,11,0,35,24
1683689222127,MATH 20B,A01,188382,Ohm; Ko Woon,7,0,30,23
1683689222127,MATH 20B,A02,188383,Ohm; Ko Woon,22,0,30,8
1683689222127,MATH 20B,B01,188385,Ohm; Ko Woon,7,0,30,23
1683689222127,MATH 20B,B02,188392,Ohm; Ko Woon,22,0,30,8
1683689223151,MATH 20C,A01,188394,Harel; Guershon,10,0,30,20
1683689223151,MATH 20C,A02,188395,Harel; Guershon,13,0,30,17
1683689223151,MATH 20C,B01,188404,Harel; Guershon,5,0,30,25
1683689223151,MATH 20C,B02,188405,Harel; Guershon,18,0,30,12
1683689224181,MATH 20D,A01,188414,Hammock; Frances H,0,1,30,30
1683689224181,MATH 20D,A02,188415,Hammock; Frances H,0,1,30,30
1683689224181,MATH 20D,B01,188447,Hammock; Frances H,0,1,30,30
1683689224181,MATH 20D,B02,188486,Hammock; Frances H,2,0,30,28
1683689225209,MATH 20E,A01,188649,Staff,21,0,30,9
1683689225209,MATH 20E,A02,188650,Staff,20,0,30,10
1683689225209,MATH 20E,A03,188673,Staff,0,0,30,30
1683689226237,MATH 102,A01,188675,Staff,0,40,35,35
1683689227260,MATH 103B,A01,188681,Staff,3,0,35,32
1683689227260,MATH 103B,B01,188692,Staff,5,0,35,30
1683689228284,MATH 109,A01,188695,Salehi Golsefidy; Alireza,24,0,35,11
1683689228284,MATH 109,A02,188696,Salehi Golsefidy; Alireza,25,0,35,10
1683689229311,MATH 120A,A01,188698,Eggers; John Dietrich,7,0,35,28
1683689230339,MATH 142B,A01,188736,Ioana; Adrian,1,1,30,29
1683689230339,MATH 142B,A02,188741,Ioana; Adrian,0,1,30,30
1683689230339,MATH 142B,A03,188743,Ioana; Adrian,0,2,30,30
1683689231364,MATH 168A,A01,188790,Staff,0,11,35,35
1683689232394,MATH 170A,A01,188803,Nie; Jiawang,0,2,35,35
1683689232394,MATH 170A,A02,188811,Nie; Jiawang,0,1,35,35
1683689232394,MATH 170A,A03,188814,Nie; Jiawang,0,0,35,35
1683689232394,MATH 170A,A04,188815,Nie; Jiawang,5,0,35,30
1683689233417,MATH 193B,A01,188817,Staff,0,0,35,35
1683689233417,MATH 193B,A02,188818,Staff,6,0,35,29
1683689234441,MGT 4,A01,202857,Anderson; John Charles,59,0,80,21
1683689235465,MGT 12,A00,202858,Lindenberger; Wade Douglas,40,0,90,50
1683689236488,MGT 18,A00,202859,Staff,74,0,90,16
1683689237515,MGT 18GS,A00,202860,McKay; Michael J,13,0,28,15
1683689238543,MGT 45,A00,202861,Pecore; Joseph P.,8,0,90,82
1683689239567,MGT 100,A00,202863,Yavorsky; Daniel Ryan,27,0,90,63
1683689240595,MGT 103,A00,202864,Ehrich; Kristine R,0,19,90,90
1683689241623,MGT 112,A00,202865,Ehrich; Kristine R,15,0,90,75
1683689242647,MGT 121A,A00,202868,Staff,90,20,90,0
1683689243675,MGT 131B,A00,202869,Anderson; John Charles,58,0,90,32
1683689244698,MGT 136,A00,202871,Lindenberger; Wade Douglas,83,0,90,7
1683689245721,MGT 164,A00,202873,Staff,0,67,90,91
1683689246746,MGT 164GS,A00,202874,McKay; Mary A,13,0,28,15
1683689247773,MGT 180,A00,202875,Staff,0,51,90,91
1683689248805,MMW 11R,A01,205019,Herbst; Matthew,0,0,30,30
1683689248805,MMW 11R,A02,205026,Herbst; Matthew,29,0,30,1
1683689249830,MMW 15,A01,193512,Chang; Edmond Yi-Teh,0,8,28,28
1683689249830,MMW 15,A02,193513,Chang; Edmond Yi-Teh,0,5,28,28
1683689249830,MMW 15,A03,193514,Chang; Edmond Yi-Teh,0,5,28,28
1683689249830,MMW 15,A04,193515,Chang; Edmond Yi-Teh,0,5,28,28
1683689249830,MMW 15,A05,193516,Chang; Edmond Yi-Teh,0,5,28,28
1683689249830,MMW 15,A06,193517,Chang; Edmond Yi-Teh,0,6,28,28
1683689249830,MMW 15,B01,193519,Chang; Edmond Yi-Teh,0,5,28,28
1683689249830,MMW 15,B02,193520,Chang; Edmond Yi-Teh,0,5,28,28
1683689249830,MMW 15,B03,193521,Chang; Edmond Yi-Teh,0,5,28,28
1683689249830,MMW 15,B04,193522,Chang; Edmond Yi-Teh,0,6,28,28
1683689249830,MMW 15,B05,193523,Chang; Edmond Yi-Teh,0,5,28,28
1683689249830,MMW 15,B06,193524,Chang; Edmond Yi-Teh,0,5,28,28
1683689250854,MMW 122,A01,193526,Rahimi; Babak,0,16,28,28
1683689250854,MMW 122,A02,193527,Rahimi; Babak,0,15,28,28
1683689250854,MMW 122,A03,193528,Rahimi; Babak,0,0,0,0
1683689250854,MMW 122,A04,193529,Rahimi; Babak,0,0,0,0
1683689251879,MUS 1A,A01,186663,Staff,1,19,35,34
1683689252903,MUS 4,A01,186715,Staff,0,12,35,35
1683689253927,MUS 5R,A01,186796,Dubnov; Shlomo,0,17,35,35
1683689254951,MUS 6,A01,186798,Staff,1,5,25,24
1683689255977,MUS 7,A01,186830,Staff,11,0,35,24
1683689257004,MUS 8,A01,186930,Staff,0,27,35,35
1683689258028,MUS 15,A01,186932,Staff,0,15,35,35
1683689258028,MUS 15,B01,186934,Staff,1,17,35,34
1683689259052,MUS 80,A00,186935,Staff,0,0,20,20
1683689259052,MUS 80,B00,186936,Staff,24,0,25,1
1683689260132,NANO 11,A00,204702,Lipomi; Darren John,0,0,0,0
1683689261162,NANO 15,A01,204709,Yang; Kesong,0,1,0,0
1683689262186,NANO 114,A00,202069,Jahed Motlagh; Zeinab,2,0,10,8
1683689263217,PHIL 1,A00,186955,Grush; Rick Scott,31,0,40,9
1683689264243,PHIL 10,A01,186973,Grush; Rick Scott,27,0,35,8
1683689264243,PHIL 10,A02,186974,Grush; Rick Scott,33,0,35,2
1683689265271,PHIL 13,A01,186976,Staff,1,0,35,34
1683689265271,PHIL 13,A02,186977,Staff,16,0,35,19
1683689266296,PHIL 14,A01,186979,Staff,31,0,35,4
1683689266296,PHIL 14,A02,186986,Staff,32,0,35,3
1683689267324,PHIL 28,A01,186988,Staff,16,0,30,14
1683689267324,PHIL 28,A02,186989,Staff,1,0,30,29
1683689267324,PHIL 28,A03,186990,Staff,10,0,30,20
1683689267324,PHIL 28,A04,186991,Staff,26,0,30,4
1683689268348,PHIL 120,A00,186997,Staff,23,0,40,17
1683689269373,PHIL 137,A00,187003,Staff,7,0,40,33
1683689270400,PHIL 150,A00,187015,Staff,47,0,70,23
1683689271423,PHIL 167,A00,187021,Lamey; Andy M.,34,0,40,6
1683689272449,PHIL 174,A01,202226,Staff,17,0,20,3
1683689272449,PHIL 174,A02,202235,Staff,20,0,20,0
1683689273476,PHIL 191A,A00,258918,Staff,0,0,1,1
1683689274505,PHYS 1A,A00,187028,Staff,26,0,60,34
1683689275528,PHYS 1AL,001,187036,Staff,3,0,30,27
1683689275528,PHYS 1AL,002,187049,Staff,18,0,30,12
1683689276554,PHYS 1B,A00,187058,Staff,22,0,60,38
1683689277578,PHYS 1BL,001,187064,Staff,0,1,30,30
1683689277578,PHYS 1BL,002,187070,Staff,4,0,30,26
1683689278602,PHYS 1C,A00,187082,Staff,29,0,120,91
1683689279627,PHYS 1CL,001,187088,Staff,0,9,30,30
1683689279627,PHYS 1CL,002,187089,Staff,0,1,30,30
1683689279627,PHYS 1CL,009,262693,Staff,9,0,30,21
1683689280652,PHYS 2B,A01,187097,Staff,55,0,115,60
1683689281676,PHYS 2C,A01,187099,Staff,63,0,115,52
1683689282703,PHYS 2CL,A01,187101,Staff,5,0,28,23
1683689282703,PHYS 2CL,A02,187102,Staff,15,0,28,13
1683689283735,PHYS 2D,A01,187123,Shotwell; Brian,95,0,115,20
1683689284757,PHYS 4B,A01,187133,Grinstein; Benjamin,35,0,50,15
1683689285785,POLI 10,A00,188819,Staff,0,4,50,50
1683689286810,POLI 11,A00,188827,Staff,43,0,50,7
1683689287834,POLI 13R,A00,188828,Staff,0,1,20,20
1683689288863,POLI 27,A01,188830,Elgin; Samuel Zincke,0,2,70,70
1683689289888,POLI 30,A00,188832,Desposato; Scott,30,0,50,20
1683689290913,POLI 102F,A00,188834,Staff,1,0,40,39
1683689291937,POLI 104A,A00,188852,Staff,12,0,30,18
1683689292965,POLI 104I,A00,188853,Staff,0,8,20,20
1683689293989,POLI 110B,A00,188854,Wiens; David,6,0,20,14
1683689295018,POLI 112A,A00,188855,Wiens; David,3,0,30,27
1683689296042,POLI 117R,A00,188856,Forman; Fonna,0,12,20,20
1683689297070,POLI 118,A00,188857,Ingham; Sean,8,0,20,12
1683689298098,POLI 120G,A00,188858,Staff,8,0,30,22
1683689299122,POLI 131CR,A00,188863,Hoston; Germaine,20,0,50,30
1683689300146,POLI 133,A00,188864,Nellis; Gareth Hb,44,0,50,6
1683689301173,POLI 134D,A00,188865,Desposato; Scott,27,0,30,3
1683689302199,POLI 142A,A00,188871,Gartzke; Erik,21,0,50,29
1683689303225,POLI 142K,A00,188874,Staff,38,0,50,12
1683689304249,POLI 143,A00,188940,Gartzke; Erik,16,0,30,14
1683689305275,POLI 153,A00,188943,Staff,2,0,20,18
1683689306304,POLI 160AA,A00,188944,Staff,10,0,40,30
1683689307329,POLI 170A,A00,188945,Staff,10,0,30,20
1683689309377,PSYC 1,A00,188952,Staff,36,0,90,54
1683689310401,PSYC 2,B00,188953,Staff,19,0,35,16
1683689311426,PSYC 6,A00,188970,Staff,47,0,60,13
1683689312450,PSYC 7,A00,188973,Staff,35,0,45,10
1683689313478,PSYC 60,A01,188980,Rickard; Timothy C.,42,0,60,18
1683689314506,PSYC 70,A01,189001,Steiner; Eric Tomas,21,0,45,24
1683689315534,PSYC 100,A00,189005,Lacefield; Katharine I,0,99,120,120
1683689316562,PSYC 102,A00,189008,Staff,7,0,30,23
1683689317589,PSYC 106,B00,189026,Gorman; Michael R.,27,0,60,33
1683689318613,PSYC 114,B01,189033,Winkielman; Piotr,0,31,30,30
1683689319640,PSYC 131,A00,189036,Anagnostaras; Stephan,0,43,60,60
1683689320668,PSYC 136,A00,189041,Lowe; Angela Beth,0,7,25,25
1683689321693,PSYC 137,A00,189057,Winkielman; Piotr,1,37,25,24
1683689322716,PSYC 144,A00,189107,Wixted; John T,0,11,50,50
1683689324765,PSYC 162,A00,189142,Staff,0,9,85,85
1683689325789,PSYC 172,A00,189144,Gorman; Michael R.,0,6,30,30
1683689327837,PSYC 179,A00,189146,Lacefield; Katharine I,0,88,120,120
1683689328861,PSYC 181,A00,189147,Anagnostaras; Stephan,0,44,90,90
1683689329884,PSYC 190R,A00,189148,Barner; David A.,0,23,80,80
1683689330908,PSYC 191,A00,189275,Rickard; Timothy C.,0,11,25,25
1683689331932,PSYC 193,A00,189276,Chapman; Eddie Nathaniel,0,1,0,4
1683689332960,PSYC 193L,A01,189281,Lowe; Angela Beth,8,0,20,12
1683689332960,PSYC 193L,B01,189285,Staff,28,0,35,7
1683689333985,RELI 149,A00,187137,Rahimi; Babak,6,0,40,34
1683689335010,SE 9,A01,187315,Staff,0,2,18,18
1683689336035,SE 101B,A00,187409,Staff,24,0,30,6
1683689337058,SE 110B,A00,187444,Staff,10,0,40,30
1683689338082,SE 130B,A00,187449,Staff,31,0,40,9
1683689339109,SE 150A,A00,187516,Staff,8,0,20,12
1683689340137,SE 154,A00,187528,Staff,29,0,50,21
1683689341161,SIO 3,A01,258171,Staff,35,0,40,5
1683689342189,SIO 10,A00,187144,Cook; Geoffrey W,1,7,75,74
1683689343213,SIO 45,A00,187152,Cook; Geoffrey W,0,7,100,100
1683689344236,SIO 109R,A00,194486,Staff,0,4,20,20
1683689346283,SIO 187,A01,187233,Kacev; David,12,0,40,28
1683689347308,SOCI 1,A01,258656,Thorpe; Charles Robert,28,0,30,2
1683689347308,SOCI 1,A02,258658,Thorpe; Charles Robert,30,0,30,0
1683689347308,SOCI 1,A03,258661,Thorpe; Charles Robert,25,0,25,0
1683689347308,SOCI 1,A04,258666,Thorpe; Charles Robert,22,0,25,3
1683689347308,SOCI 1,A05,258897,Thorpe; Charles Robert,22,0,25,3
1683689347308,SOCI 1,A06,258898,Thorpe; Charles Robert,25,0,25,0
1683689348335,SOCI 30,A01,258903,Pardo Guerra; Juan Pablo,14,0,30,16
1683689349360,SOCI 102,A00,258904,Staff,9,0,25,16
1683689350383,SOCI 106,A00,258905,Staff,19,0,25,6
1683689351407,SOCI 111,A00,258907,Ribas Norris; Janet Vanesa,26,0,30,4
1683689352434,SOCI 121R,A00,258908,Pardo Guerra; Juan Pablo,8,0,30,22
1683689353457,SOCI 126,A01,203330,Staff,14,0,20,6
1683689354483,SOCI 131,A00,258909,Thorpe; Charles Robert,30,0,60,30
1683689355507,SOCI 135,A00,258910,Payne; Christine Anna,0,12,30,30
1683689356531,SOCI 157,A00,258911,Staff,11,0,30,19
1683689357556,SOCI 184,A00,258912,Staff,25,0,30,5
1683689358580,SOCI 188D,A00,258913,Staff,22,0,30,8
1683689359604,SYN 2,001,187529,Staff,9,0,16,7
1683689359604,SYN 2,002,201452,Staff,1,20,16,15
1683689359604,SYN 2,003,201469,Staff,1,0,16,15
1683689360631,SYN 100,A01,187531,Staff,0,9,20,20
1683689360631,SYN 100,B01,201491,Staff,0,10,20,20
1683689361655,TDAC 1,A00,189286,Walsh; Kim C.,3,0,20,17
1683689361655,TDAC 1,B00,189287,Harting; Carla Kelso,10,0,20,10
1683689362681,TDAC 101,A00,189300,Walsh; Kim C.,16,0,20,4
1683689362681,TDAC 101,B00,189301,Harting; Carla Kelso,18,0,20,2
1683689363762,TDAC 102,A00,189304,Basso; Beatrice,14,0,20,6
1683689364788,TDAC 108,A00,189305,Staff,18,0,20,2
1683689365817,TDDE 131,A00,189310,Staff,19,0,20,1
1683689365817,TDDE 131,B00,189314,Staff,19,0,20,1
1683689365817,TDDE 131,C00,189315,Staff,48,0,50,2
1683689365817,TDDE 131,D00,189316,Staff,14,0,15,1
1683689365817,TDDE 131,E00,204841,Staff,20,0,20,0
1683689366843,TDGE 10,A00,189289,Staff,27,0,50,23
1683689366843,TDGE 10,B00,189290,Havis; Allan,0,1,50,50
1683689367867,TDGE 11,A00,189291,Fulton; Julia,0,4,50,50
1683689367867,TDGE 11,B00,189292,Staff,20,0,25,5
1683689367867,TDGE 11,C00,260270,Staff,0,0,0,0
1683689368890,TDGE 25,A00,189294,Staff,1,0,20,19
1683689369913,TDGE 124,A00,189318,Fulton; Julia,1,8,50,49
1683689370937,TDGE 125,A00,189319,Staff,13,0,25,12
1683689370937,TDGE 125,B00,189320,Staff,23,0,25,2
1683689371961,TDGE 127,A00,189322,Havis; Allan,0,0,50,50
1683689372985,TDHT 101,A00,189323,Staff,18,0,25,7
1683689372985,TDHT 101,B00,189324,Staff,25,0,25,0
1683689374012,TDHT 102,A00,189325,Staff,49,0,50,1
1683689375041,TDMV 1,A00,189295,Arcidiacono; Kristin,20,0,30,10
1683689375041,TDMV 1,B00,189296,Caligagan; Maria T.,24,0,30,6
1683689376065,TDMV 2,A00,189297,Sammartano; Tonnie,27,0,30,3
1683689376065,TDMV 2,B00,189299,Arcidiacono; Kristin,23,0,30,7
1683689377088,TDMV 3,A00,204998,Rincon; Alicia,22,0,30,8
1683689378111,TDMV 120,A00,189458,Sammartano; Tonnie,28,0,30,2
1683689379134,TDMV 138,A00,189541,Jun; Grace Shin Hae,20,0,40,20
1683689380162,TDMV 142,A00,189717,Caligagan; Tony,25,0,30,5
1683689380162,TDMV 142,B00,189718,Caligagan; Maria T.,25,0,30,5
1683689381186,TMC 2,A01,187533,Staff,25,0,25,0
1683689381186,TMC 2,A02,187534,Staff,25,0,25,0
1683689382210,USP 1,A01,187536,Kwak; Nancy,0,16,25,25
1683689383236,USP 5,A01,187538,Staff,8,0,25,17
1683689384263,USP 101,A00,199253,Staff,0,4,0,0
1683689385292,USP 124,A00,187562,Boomhower; Matthew Charles,0,0,30,30
1683689386317,USP 138,A00,187582,Staff,19,0,25,6
1683689387344,USP 152,A01,187597,Staff,3,0,25,22
1683689388368,USP 153,A00,187598,Staff,18,0,25,7
1683689389391,USP 168,A00,187607,Kwak; Nancy,2,0,5,3
1683689390415,USP 173,A00,187619,Staff,4,0,25,21
1683689391442,USP 181,A00,187638,Staff,0,4,25,25
1683689392469,VIS 103,A00,187650,Cruz; Edwin Teddy,17,0,75,58
1683689393494,VIS 110D,A00,187669,Staff,13,0,22,9
1683689394518,VIS 127C,A00,187720,Shen; Kuiyi,67,0,146,79
1683689395545,VIS 149,A00,187731,Yoldas; Pinar,1,14,22,21
1683689396575,VIS 151,A01,188091,Staff,22,0,34,12
1683689396575,VIS 151,A02,188092,Staff,11,0,34,23
1683689397599,VIS 160B,A00,188093,Stalbaum; Brett,0,1,10,10
1683689399651,WCWP 10B,A00,201720,Staff,0,0,5,5
1683689399651,WCWP 10B,B00,201722,Staff,0,0,6,6
1683689400689,WCWP 100,A00,201725,Gagnon; Jeffrey C,0,0,2,2
1683689400689,WCWP 100,B00,201727,Staff,0,4,15,15
1683689403829,ANBI 133,A00,258401,Wilder; Linnea Lorene,34,0,40,6
1683689404859,ANBI 140,A00,258395,Hrvoj Mihic; Branka,18,0,25,7
1683689405883,ANSC 120,A00,258402,Bialecki; Jon Anthony,26,0,40,14
1683689406910,ANSC 144,A00,258400,Staff,12,0,40,28
1683689408960,ANSC 166,A00,258396,Parish; Steven Martin,156,0,175,19
1683689409987,ANSC 180,A00,193533,Staff,8,0,20,12
1683689411014,ANSC 188,A00,258397,Jassal; Aftab,34,0,40,6
1683689412039,ANTH 3,A01,258316,Staff,23,0,30,7
1683689413064,ANTH 5,A00,258394,Semendeferi; Ekaterini,16,0,20,4
1683689414090,ANTH 21,A01,258331,Staff,4,0,40,36
1683689415117,ANTH 103,A00,258398,Varma; Saiba,15,0,25,10
1683689416143,AWP 10,001,202034,Staff,0,0,0,0
1683689416143,AWP 10,002,202035,Staff,0,0,0,0
1683689416143,AWP 10,003,202036,Staff,0,0,0,0
1683689416143,AWP 10,004,202037,Staff,0,0,0,0
1683689416143,AWP 10,005,202038,Staff,0,0,0,0
1683689416143,AWP 10,006,202039,Staff,0,0,0,0
1683689416143,AWP 10,007,202040,Staff,0,0,0,0
1683689416143,AWP 10,008,202041,Staff,0,0,0,0
1683689416143,AWP 10,009,202042,Staff,0,0,0,0
1683689416143,AWP 10,010,202043,Staff,0,0,0,0
1683689416143,AWP 10,011,202044,Staff,0,0,0,0
1683689416143,AWP 10,012,202045,Staff,0,0,0,0
1683689416143,AWP 10,013,202046,Staff,0,0,0,0
1683689416143,AWP 10,014,202047,Staff,0,0,0,0
1683689416143,AWP 10,015,202048,Staff,0,0,0,0
1683689416143,AWP 10,016,202049,Staff,0,0,0,0
1683689416143,AWP 10,017,202050,Staff,0,0,0,0
1683689416143,AWP 10,018,202051,Staff,0,0,0,0
1683689416143,AWP 10,019,202052,Staff,0,0,0,0
1683689416143,AWP 10,020,202053,Staff,0,0,0,0
1683689416143,AWP 10,021,202054,Staff,0,0,0,0
1683689416143,AWP 10,022,202055,Staff,0,0,0,0
1683689416143,AWP 10,023,202056,Staff,0,0,0,0
1683689416143,AWP 10,024,202057,Staff,0,0,0,0
1683689416143,AWP 10,025,202058,Staff,0,0,0,0
1683689416143,AWP 10,026,202059,Staff,0,0,0,0
1683689417167,AWP 102,001,202032,Staff,0,0,0,0
1683689417167,AWP 102,002,202033,Staff,0,0,0,0
1683689418191,BENG 100,A01,254234,Taylor Amos; Alyssa C,31,0,40,9
1683689419214,BENG 196,001,270013,Engler; Adam J.,9999,0,9999,0
1683689420239,BICD 100R,A01,202018,Smith; Laurie,0,7,32,32
1683689420239,BICD 100R,A02,202019,Smith; Laurie,0,3,32,32
1683689420239,BICD 100R,A03,202020,Smith; Laurie,0,1,32,32
1683689420239,BICD 100R,A04,202021,Smith; Laurie,6,0,32,26
1683689420239,BICD 100R,A05,202022,Smith; Laurie,10,0,32,22
1683689421264,BICD 136,A01,193242,Gustafson-Brown; Cindy,0,2,32,32
1683689421264,BICD 136,A02,193244,Gustafson-Brown; Cindy,13,0,32,19
1683689422290,BIEB 102,A01,193249,Butler; Shannon Rhey,1,1,32,31
1683689422290,BIEB 102,A02,193251,Butler; Shannon Rhey,0,0,32,32
1683689422290,BIEB 102,A03,193253,Butler; Shannon Rhey,0,0,32,32
1683689422290,BIEB 102,A04,193255,Butler; Shannon Rhey,13,0,32,19
1683689422290,BIEB 102,A05,193265,Butler; Shannon Rhey,25,0,32,7
1683689422290,BIEB 102,A06,193269,Butler; Shannon Rhey,13,0,32,19
1683689424344,BIEB 150,A01,193274,Staff,0,0,32,32
1683689424344,BIEB 150,A02,193285,Staff,24,0,32,8
1683689425368,BIEB 194,A00,193286,Kurle; Carolyn M.,19,0,32,13
1683689426395,BILD 1,A01,192291,Staff,15,0,32,17
1683689426395,BILD 1,A02,192292,Staff,30,0,32,2
1683689426395,BILD 1,B01,192520,Reuther; Keefe,0,1,0,0
1683689426395,BILD 1,B02,192532,Reuther; Keefe,0,1,0,0
1683689427421,BILD 3,A01,192556,Butler; Shannon Rhey,0,0,32,32
1683689427421,BILD 3,A02,192581,Butler; Shannon Rhey,0,1,32,32
1683689427421,BILD 3,A03,192611,Butler; Shannon Rhey,19,0,32,13
1683689427421,BILD 3,A04,192612,Butler; Shannon Rhey,24,0,32,8
1683689427421,BILD 3,A05,192613,Butler; Shannon Rhey,26,0,32,6
1683689427421,BILD 3,A06,192679,Butler; Shannon Rhey,27,0,32,5
1683689427421,BILD 3,A07,192682,Butler; Shannon Rhey,20,0,32,12
1683689428444,BILD 4,A01,192836,Reuther; Keefe,1,0,24,23
1683689428444,BILD 4,A02,193044,Reuther; Keefe,4,0,24,20
1683689429468,BILD 10,A01,193142,Gustafson-Brown; Cindy,29,0,32,3
1683689429468,BILD 10,A02,193149,Gustafson-Brown; Cindy,31,0,32,1
1683689430495,BIMM 100,A01,193301,Staff,0,6,32,32
1683689430495,BIMM 100,A02,193312,Staff,0,7,32,32
1683689430495,BIMM 100,A03,193323,Staff,0,10,32,32
1683689431524,BIMM 101,A01,193329,McDonnell; Lisa Marie,1,4,24,23
1683689431524,BIMM 101,A02,193339,McDonnell; Lisa Marie,1,4,24,23
1683689431524,BIMM 101,B01,193354,McDonnell; Lisa Marie,0,4,24,24
1683689431524,BIMM 101,B02,193357,McDonnell; Lisa Marie,0,3,24,24
1683689432547,BIMM 110,A01,193377,Tat; John,0,11,32,32
1683689432547,BIMM 110,A02,193378,Tat; John,0,11,32,32
1683689433574,BIMM 120,A01,206116,Staff,0,0,32,32
1683689433574,BIMM 120,A02,206117,Staff,7,0,32,25
1683689433574,BIMM 120,A03,206121,Staff,21,0,32,11
1683689434598,BIPN 100,A01,193393,Park; Ji Young,0,15,32,32
1683689434598,BIPN 100,A02,193402,Park; Ji Young,0,14,32,32
1683689434598,BIPN 100,A03,193413,Park; Ji Young,0,14,32,32
1683689434598,BIPN 100,A04,193414,Park; Ji Young,0,13,32,32
1683689435623,BIPN 102,A01,193429,Staff,0,0,32,32
1683689435623,BIPN 102,A02,193438,Staff,18,0,32,14
1683689436646,BIPN 106,A01,193450,Reyes Gonzalez; Catalina,0,2,40,40
1683689437677,BIPN 134,A01,193465,Cooke; James Edward,0,0,32,32
1683689437677,BIPN 134,A02,193474,Cooke; James Edward,25,0,32,7
1683689437677,BIPN 134,A03,193485,Cooke; James Edward,29,0,32,3
1683689437677,BIPN 134,A04,193486,Cooke; James Edward,20,0,32,12
1683689437677,BIPN 134,A05,193491,Cooke; James Edward,31,0,32,1
1683689437677,BIPN 134,A06,193501,Cooke; James Edward,30,0,32,2
1683689437677,BIPN 134,A07,193510,Cooke; James Edward,29,0,32,3
1683689439730,BISP 194,A00,222522,Staff,14,0,32,18
1683689440757,CAT 124,A01,202407,Staff,19,0,25,6
1683689441783,CAT 125,A00,202408,Marchisotto; Jennifer Anne,2,0,20,18
1683689442807,CAT 125R,A00,202409,Smith; Lauryn Alissa,0,11,20,20
1683689442807,CAT 125R,B00,202410,Morales; Celeste Georgianna,0,11,20,20
1683689442807,CAT 125R,C00,202411,Irwin; Matthew Joseph,0,12,20,20
1683689443832,CENG 15,A01,204712,Yang; Kesong,0,1,0,0
1683689444855,CENG 114,A00,202070,Jahed Motlagh; Zeinab,5,0,20,15
1683689445882,CGS 105,A00,185477,Wesling; Megan E.,24,0,40,16
1683689446907,CGS 106,A00,185494,Staff,11,0,22,11
1683689447931,CGS 108,A00,185495,Staff,14,0,20,6
1683689448958,CGS 114,A00,185496,Staff,13,0,18,5
1683689449981,CGS 119,A00,185501,Staff,15,0,20,5
1683689451005,CGS 120,A00,185511,Staff,12,0,20,8
1683689452034,CHEM 4,A01,184675,Bussey; Thomas J,97,0,100,3
1683689453059,CHEM 6A,A01,184677,Staff,32,0,60,28
1683689454087,CHEM 6B,A01,184679,Staff,63,0,100,37
1683689455115,CHEM 6C,A01,184681,Bussey; Thomas J,0,0,50,50
1683689455115,CHEM 6C,A02,184682,Bussey; Thomas J,32,0,50,18
1683689456143,CHEM 40A,A01,184684,Albizati; Kim F.,33,0,100,67
1683689457170,CHEM 40B,A01,184686,Albizati; Kim F.,0,22,100,100
1683689458194,CHEM 41B,A01,184690,Staff,51,0,100,49
1683689459220,COGS 3,A01,184715,Boyle; Mary E. T.,0,27,40,40
1683689460248,COGS 14B,A01,185172,Staff,0,14,38,38
1683689461272,COGS 18,A01,184736,Staff,14,0,80,66
1683689462300,COGS 100,A01,184932,Staff,0,8,73,73
1683689463325,COGS 101A,A01,184935,Staff,0,40,30,30
1683689464350,COGS 101B,A01,184944,Staff,0,2,30,30
1683689465375,COGS 101C,A01,184946,Staff,0,10,30,30
1683689466404,COGS 102A,A01,184951,Johnson; Christine M.,1,0,40,39
1683689467481,COGS 107B,A01,184953,Mooshagian; Eric Frederick,0,52,40,40
1683689468505,COGS 118B,A01,184959,Gupta; Anjum,0,50,40,40
1683689469529,COGS 153,A00,184961,Staff,0,16,30,30
1683689470556,COGS 177,A00,184962,Staff,1,21,30,29
1683689471580,COGS 187A,A01,184969,Boyle; Mary E. T.,0,19,40,40
1683689472608,COMM 10,A01,185174,Staff,0,5,25,25
1683689472608,COMM 10,A02,185189,Staff,0,2,25,25
1683689472608,COMM 10,A03,269821,Staff,0,1,0,0
1683689473632,COMM 100B,A02,185476,Staff,10,0,25,15
1683689473632,COMM 100B,A03,277340,Staff,25,0,25,0
1683689474658,COMM 100C,A01,185314,Staff,1,0,25,24
1683689474658,COMM 100C,A02,185327,Staff,17,0,25,8
1683689475684,COMM 110M,A00,185349,Staff,0,0,40,40
1683689476708,COMM 113T,A00,185352,Staff,25,0,40,15
1683689477732,COMM 114I,A00,185353,Staff,31,0,40,9
1683689478756,COMM 131,A00,185354,Staff,17,0,30,13
1683689479780,CSE 8A,A50,185358,Cao; Yingjun,0,46,10,10
1683689480805,CSE 8B,A01,185362,Staff,0,48,50,50
1683689481833,CSE 11,A01,185416,Cao; Yingjun,0,91,10,10
1683689482858,CSE 20,A01,185445,Briones; Jor-el Thomas Caparas,3,0,25,22
1683689483887,CSE 21,A01,185447,Staff,9,0,50,41
1683689484916,CSE 101,A01,185451,Staff,0,13,50,50
1683689484916,CSE 101,B01,185453,Jones; Miles E,0,14,50,50
1683689486967,CSE 141,A01,185458,Eldon; John,16,0,100,84
1683689487993,CSE 141L,A01,185461,Eldon; John,8,0,100,92
1683689489017,CSE 142,A01,185463,Staff,34,0,60,26
1683689489017,CSE 142,B01,201355,Staff,0,7,60,60
1683689490042,CSE 142L,A01,185470,Staff,34,0,60,26
1683689490042,CSE 142L,B01,201417,Staff,0,6,60,60
1683689491069,CSE 190,A00,201433,Staff,32,0,49,17
1683689492097,DOC 1,A01,259136,Strom; Megan C.,7,0,15,8
1683689492097,DOC 1,A02,259137,Strom; Megan C.,14,0,15,1
1683689492097,DOC 1,A03,259138,Strom; Megan C.,14,0,15,1
1683689492097,DOC 1,A04,259139,Strom; Megan C.,14,0,15,1
1683689493121,DOC 100D,A00,259140,Pass; Natalye Joann,14,0,25,11
1683689494146,DSGN 1,A01,184749,Rill; Bryan,0,26,30,30
1683689495171,DSGN 100,A01,185168,Staff,0,2,25,25
1683689496196,ECE 5,A01,185626,Morris; Karcher William,0,12,0,0
1683689497220,ECE 101,A01,185628,Staff,14,0,70,56
1683689498251,ECE 107,A01,185635,Baghdadchi; Saharnaz,0,0,20,20
1683689498251,ECE 107,A02,185638,Baghdadchi; Saharnaz,1,0,20,19
1683689499275,ECE 148,A01,185647,Silberman; Jack,0,0,16,16
1683689500303,ECON 1,A01,185537,Crane; Meredith Helen,54,0,70,16
1683689501332,ECON 3,A01,185549,Crane; Meredith Helen,30,0,70,40
1683689502359,ECON 4,A01,203354,Anderson; John Charles,0,5,10,10
1683689503384,ECON 100A,A01,185574,Staff,0,5,40,40
1683689504411,ECON 100B,A01,185576,Staff,0,12,50,50
1683689505436,ECON 100C,A01,185589,Newhouse; Herbert S,30,0,70,40
1683689506461,ECON 105,A00,185608,Vespa; Emanuel Ignacio,19,0,35,16
1683689507486,ECON 109,A01,185610,Shishkin; Denis,9,0,35,26
1683689508509,ECON 110A,A01,185612,Staff,8,0,40,32
1683689509533,ECON 120A,A01,185615,Staff,19,0,40,21
1683689510558,ECON 120C,A01,185617,Sun; Yixiao,0,21,70,70
1683689511583,ECON 144,A00,203346,Squires; Dale E,2,0,35,33
1683689512611,ECON 171,A01,203349,Newhouse; Herbert S,0,1,35,35
1683689513638,ECON 173A,A01,185621,Toda; Alexis Akira,21,0,35,14
1683689514668,EDS 25,A01,202413,Staff,0,1,0,0
1683689514668,EDS 25,A02,202414,Staff,0,1,0,0
1683689514668,EDS 25,A03,202415,Staff,0,0,0,0
1683689514668,EDS 25,A04,202416,Staff,0,1,0,0
1683689514668,EDS 25,A05,202439,Staff,0,0,0,0
1683689514668,EDS 25,A06,202440,Staff,0,0,0,0
1683689514668,EDS 25,B01,202631,Staff,0,0,0,0
1683689514668,EDS 25,B02,202632,Staff,0,0,0,0
1683689514668,EDS 25,B03,202639,Staff,0,0,0,0
1683689514668,EDS 25,B04,202640,Staff,0,0,0,0
1683689514668,EDS 25,B05,202643,Staff,0,0,0,0
1683689514668,EDS 25,B06,202644,Staff,0,0,0,0
1683689515696,EDS 38,A01,202659,Black; Alison Michelle,24,0,25,1
1683689516723,EDS 115,A00,202652,Staff,18,0,30,12
1683689517748,EDS 125,A00,202649,Staff,13,0,30,17
1683689518773,EDS 126,A01,203332,Staff,30,0,30,0
1683689519798,EDS 139,A00,202838,Staff,16,0,25,9
1683689520825,EDS 146,A01,202655,Staff,14,0,25,11
1683689521851,ENG 15,A00,185667,Staff,0,1,0,0
1683689521851,ENG 15,B00,185672,Staff,0,0,0,0
1683689521851,ENG 15,C00,185675,Staff,0,0,0,0
1683689521851,ENG 15,D00,185682,Staff,0,0,0,0
1683689521851,ENG 15,E00,185684,Staff,0,0,0,0
1683689522872,ETHN 103,A00,185710,Staff,0,8,35,35
1683689523897,ETHN 103A,A00,199228,Man; Simeon S,0,0,9,9
1683689524922,ETHN 109,A00,185711,Staff,15,0,35,20
1683689525949,ETHN 142,A00,185726,Staff,0,4,30,30
1683689526973,ETHN 163J,A00,199229,Man; Simeon S,5,0,8,3
1683689527997,ETHN 168,A00,185727,Staff,7,0,10,3
1683689529023,ETHN 182,A00,185728,Staff,0,0,35,35
1683689530050,ETHN 183,A00,185737,Staff,9,0,18,9
1683689531077,GLBH 111,A01,209361,Burgos; Jose L.,0,0,0,0
1683689533126,HIEU 104,A00,185792,Staff,14,0,20,6
1683689534153,HIEU 115,A00,185800,Staff,0,0,20,20
1683689535178,HIEU 128,A00,185801,Staff,0,9,20,20
1683689536206,HIEU 147,A00,185802,Staff,15,0,20,5
1683689537229,HIEU 154,A00,185823,Staff,11,0,20,9
1683689538253,HILA 102,A00,185826,Staff,14,0,20,6
1683689539281,HILD 2C,A01,185778,Staff,0,13,20,20
1683689540309,HILD 7B,A01,185780,Kwak; Nancy,0,17,32,32
1683689540309,HILD 7B,A02,185781,Kwak; Nancy,0,18,32,32
1683689541336,HILD 30,A01,185791,Staff,12,0,20,8
1683689542363,HISC 119,A00,185830,Golan; Tal,0,10,20,20
1683689543387,HITO 156GS,A00,185831,Patterson; Patrick H.,0,0,0,23
1683689544414,HIUS 103,A00,185832,Man; Simeon S,0,4,20,20
1683689545438,HIUS 117,A00,185836,Kwak; Nancy,2,0,20,18
1683689546465,HIUS 125,A00,185840,Man; Simeon S,0,2,23,23
1683689547491,HIUS 149,A00,185845,Staff,1,0,20,19
1683689548520,HUM 3,A01,185882,Zavodny; Tatiana Sophia,0,8,50,50
1683689548520,HUM 3,B01,185899,Caldwell; Michael Alan,0,18,50,50
1683689549545,HUM 3GS,A00,185900,Patterson; Patrick H.,0,0,0,23
1683689550574,HUM 4,A01,185938,Zroka; Amy Liane,28,0,50,22
1683689550574,HUM 4,B01,185956,Watkins; Eric,0,6,50,50
1683689550574,HUM 4,B02,202209,Watkins; Eric,0,5,50,50
1683689550574,HUM 4,B03,202210,Watkins; Eric,0,5,50,50
1683689551598,HUM 5,A01,185958,West; Geoffrey Scott,0,0,50,50
1683689551598,HUM 5,A02,202215,West; Geoffrey Scott,0,1,50,50
1683689552625,INTL 190,A00,185959,Gagnon; Jeffrey C,0,0,0,9
1683689552625,INTL 190,B00,185960,Lettieri; Michael Joseph,0,0,0,2
1683689553652,JAPN 180,A00,254509,Staff,5,0,30,25
1683689554681,LATI 10,A01,202853,Kennemore; Amy Michelle,4,0,35,31
1683689554681,LATI 10,A02,202854,Kennemore; Amy Michelle,3,0,35,32
1683689554681,LATI 10,A03,270054,Kennemore; Amy Michelle,30,0,30,0
1683689555709,LATI 180,A00,202855,Kennemore; Amy Michelle,11,0,20,9
1683689556736,LAWS 101,A00,201767,Golan; Tal,0,7,40,40
1683689557761,LIFR 1C,A00,185961,Staff,6,0,20,14
1683689558785,LIFR 1CX,A00,185962,Staff,7,0,20,13
1683689559809,LIFR 1D,A00,185963,Staff,7,0,20,13
1683689560835,LIFR 1DX,A00,185964,Staff,7,0,20,13
1683689561861,LIGN 101,A01,186039,Staff,43,0,50,7
1683689562886,LIGN 165,A00,186040,Staff,15,0,50,35
1683689563914,LTCS 108,A00,186041,Staff,5,0,10,5
1683689564938,LTCS 119,A00,186042,Staff,15,0,20,5
1683689565966,LTCS 130,A00,186043,Wesling; Megan E.,15,0,25,10
1683689568014,LTEA 138,A00,186119,Staff,14,0,40,26
1683689569039,LTEN 124,A00,186148,Staff,5,0,25,20
1683689570064,LTEN 178,A00,186149,Staff,6,0,15,9
1683689571161,LTEN 181,A00,186150,Blanco; John D,34,0,40,6
1683689572185,LTWL 120,A00,186160,Staff,19,0,25,6
1683689573211,LTWL 165,A00,186161,Staff,22,0,25,3
1683689574237,LTWR 100,A00,186162,Staff,0,5,15,15
1683689575261,LTWR 102,A00,186163,Doller; Ben,5,0,15,10
1683689576288,MAE 8,A01,186412,Staff,0,1,0,0
1683689577315,MAE 30B,A00,186445,Bahadori; Mohammad Yousef,81,0,100,19
1683689578342,MAE 40,A00,186592,Bewley; Thomas R,10,0,50,40
1683689579367,MAE 101B,A00,186593,Bahadori; Mohammad Yousef,80,0,100,20
1683689580392,MAE 105,A00,186594,Bandaru; Prabhakar,10,0,50,40
1683689581418,MAE 107,A00,186599,Pham; Hieu Tan,0,7,120,120
1683689582442,MAE 148,A01,186660,Silberman; Jack,3,0,16,13
1683689583469,MATH 10A,A01,188095,Staff,0,6,35,35
1683689584498,MATH 10B,A01,188097,Bowers; Adam R.,0,12,30,30
1683689584498,MATH 10B,A02,188099,Bowers; Adam R.,0,11,30,30
1683689584498,MATH 10B,B01,188104,Bowers; Adam R.,0,10,30,30
1683689584498,MATH 10B,B02,188106,Bowers; Adam R.,1,9,30,29
1683689585521,MATH 10C,A01,188111,Staff,0,20,30,30
1683689585521,MATH 10C,A02,188127,Staff,0,19,30,30
1683689585521,MATH 10C,A03,188131,Staff,0,19,30,30
1683689585521,MATH 10C,B01,188218,Staff,17,0,30,13
1683689585521,MATH 10C,B02,188244,Staff,13,0,30,17
1683689585521,MATH 10C,B03,188277,Staff,14,0,30,16
1683689586545,MATH 18,A01,188344,Bach; Quang Tran,18,0,30,12
1683689586545,MATH 18,A02,188345,Bach; Quang Tran,11,0,30,19
1683689586545,MATH 18,B01,188353,Bach; Quang Tran,11,0,30,19
1683689586545,MATH 18,B02,188354,Bach; Quang Tran,19,0,30,11
1683689587573,MATH 20A,A01,188374,Staff,11,0,35,24
1683689588602,MATH 20B,A01,188382,Ohm; Ko Woon,7,0,30,23
1683689588602,MATH 20B,A02,188383,Ohm; Ko Woon,22,0,30,8
1683689588602,MATH 20B,B01,188385,Ohm; Ko Woon,7,0,30,23
1683689588602,MATH 20B,B02,188392,Ohm; Ko Woon,22,0,30,8
1683689589631,MATH 20C,A01,188394,Harel; Guershon,10,0,30,20
1683689589631,MATH 20C,A02,188395,Harel; Guershon,13,0,30,17
1683689589631,MATH 20C,B01,188404,Harel; Guershon,5,0,30,25
1683689589631,MATH 20C,B02,188405,Harel; Guershon,18,0,30,12
1683689590656,MATH 20D,A01,188414,Hammock; Frances H,0,1,30,30
1683689590656,MATH 20D,A02,188415,Hammock; Frances H,0,1,30,30
1683689590656,MATH 20D,B01,188447,Hammock; Frances H,0,1,30,30
1683689590656,MATH 20D,B02,188486,Hammock; Frances H,2,0,30,28
1683689591691,MATH 20E,A01,188649,Staff,21,0,30,9
1683689591691,MATH 20E,A02,188650,Staff,20,0,30,10
1683689591691,MATH 20E,A03,188673,Staff,0,0,30,30
1683689592716,MATH 102,A01,188675,Staff,0,40,35,35
1683689593747,MATH 103B,A01,188681,Staff,3,0,35,32
1683689593747,MATH 103B,B01,188692,Staff,5,0,35,30
1683689594775,MATH 109,A01,188695,Salehi Golsefidy; Alireza,24,0,35,11
1683689594775,MATH 109,A02,188696,Salehi Golsefidy; Alireza,25,0,35,10
1683689595800,MATH 120A,A01,188698,Eggers; John Dietrich,7,0,35,28
1683689596824,MATH 142B,A01,188736,Ioana; Adrian,1,1,30,29
1683689596824,MATH 142B,A02,188741,Ioana; Adrian,0,1,30,30
1683689596824,MATH 142B,A03,188743,Ioana; Adrian,0,2,30,30
1683689597851,MATH 168A,A01,188790,Staff,0,11,35,35
1683689598878,MATH 170A,A01,188803,Nie; Jiawang,0,2,35,35
1683689598878,MATH 170A,A02,188811,Nie; Jiawang,0,1,35,35
1683689598878,MATH 170A,A03,188814,Nie; Jiawang,0,0,35,35
1683689598878,MATH 170A,A04,188815,Nie; Jiawang,5,0,35,30
1683689599903,MATH 193B,A01,188817,Staff,0,0,35,35
1683689599903,MATH 193B,A02,188818,Staff,6,0,35,29
1683689600931,MGT 4,A01,202857,Anderson; John Charles,59,0,80,21
1683689601956,MGT 12,A00,202858,Lindenberger; Wade Douglas,40,0,90,50
1683689602983,MGT 18,A00,202859,Staff,74,0,90,16
1683689604010,MGT 18GS,A00,202860,McKay; Michael J,13,0,28,15
1683689605037,MGT 45,A00,202861,Pecore; Joseph P.,8,0,90,82
1683689606063,MGT 100,A00,202863,Yavorsky; Daniel Ryan,27,0,90,63
1683689607090,MGT 103,A00,202864,Ehrich; Kristine R,0,19,90,90
1683689608113,MGT 112,A00,202865,Ehrich; Kristine R,15,0,90,75
1683689609141,MGT 121A,A00,202868,Staff,90,20,90,0
1683689610169,MGT 131B,A00,202869,Anderson; John Charles,58,0,90,32
1683689611197,MGT 136,A00,202871,Lindenberger; Wade Douglas,83,0,90,7
1683689612225,MGT 164,A00,202873,Staff,0,67,90,91
1683689613250,MGT 164GS,A00,202874,McKay; Mary A,13,0,28,15
1683689614273,MGT 180,A00,202875,Staff,0,51,90,91
1683689615298,MMW 11R,A01,205019,Herbst; Matthew,0,0,30,30
1683689615298,MMW 11R,A02,205026,Herbst; Matthew,29,0,30,1
1683689616324,MMW 15,A01,193512,Chang; Edmond Yi-Teh,0,8,28,28
1683689616324,MMW 15,A02,193513,Chang; Edmond Yi-Teh,0,5,28,28
1683689616324,MMW 15,A03,193514,Chang; Edmond Yi-Teh,0,5,28,28
1683689616324,MMW 15,A04,193515,Chang; Edmond Yi-Teh,0,5,28,28
1683689616324,MMW 15,A05,193516,Chang; Edmond Yi-Teh,0,5,28,28
1683689616324,MMW 15,A06,193517,Chang; Edmond Yi-Teh,0,6,28,28
1683689616324,MMW 15,B01,193519,Chang; Edmond Yi-Teh,0,5,28,28
1683689616324,MMW 15,B02,193520,Chang; Edmond Yi-Teh,0,5,28,28
1683689616324,MMW 15,B03,193521,Chang; Edmond Yi-Teh,0,5,28,28
1683689616324,MMW 15,B04,193522,Chang; Edmond Yi-Teh,0,6,28,28
1683689616324,MMW 15,B05,193523,Chang; Edmond Yi-Teh,0,5,28,28
1683689616324,MMW 15,B06,193524,Chang; Edmond Yi-Teh,0,5,28,28
1683689617348,MMW 122,A01,193526,Rahimi; Babak,0,16,28,28
1683689617348,MMW 122,A02,193527,Rahimi; Babak,0,15,28,28
1683689617348,MMW 122,A03,193528,Rahimi; Babak,0,0,0,0
1683689617348,MMW 122,A04,193529,Rahimi; Babak,0,0,0,0
1683689618372,MUS 1A,A01,186663,Staff,1,19,35,34
1683689619397,MUS 4,A01,186715,Staff,0,12,35,35
1683689620421,MUS 5R,A01,186796,Dubnov; Shlomo,0,17,35,35
1683689621450,MUS 6,A01,186798,Staff,1,5,25,24
1683689622478,MUS 7,A01,186830,Staff,11,0,35,24
1683689623503,MUS 8,A01,186930,Staff,0,27,35,35
1683689624528,MUS 15,A01,186932,Staff,0,15,35,35
1683689624528,MUS 15,B01,186934,Staff,1,17,35,34
1683689625558,MUS 80,A00,186935,Staff,0,0,20,20
1683689625558,MUS 80,B00,186936,Staff,24,0,25,1
1683689626581,NANO 11,A00,204702,Lipomi; Darren John,0,0,0,0
1683689627609,NANO 15,A01,204709,Yang; Kesong,0,1,0,0
1683689628635,NANO 114,A00,202069,Jahed Motlagh; Zeinab,2,0,10,8
1683689629662,PHIL 1,A00,186955,Grush; Rick Scott,31,0,40,9
1683689630686,PHIL 10,A01,186973,Grush; Rick Scott,27,0,35,8
1683689630686,PHIL 10,A02,186974,Grush; Rick Scott,33,0,35,2
1683689631714,PHIL 13,A01,186976,Staff,1,0,35,34
1683689631714,PHIL 13,A02,186977,Staff,16,0,35,19
1683689632738,PHIL 14,A01,186979,Staff,31,0,35,4
1683689632738,PHIL 14,A02,186986,Staff,32,0,35,3
1683689633762,PHIL 28,A01,186988,Staff,16,0,30,14
1683689633762,PHIL 28,A02,186989,Staff,1,0,30,29
1683689633762,PHIL 28,A03,186990,Staff,10,0,30,20
1683689633762,PHIL 28,A04,186991,Staff,26,0,30,4
1683689634786,PHIL 120,A00,186997,Staff,23,0,40,17
1683689635810,PHIL 137,A00,187003,Staff,7,0,40,33
1683689636835,PHIL 150,A00,187015,Staff,47,0,70,23
1683689637858,PHIL 167,A00,187021,Lamey; Andy M.,34,0,40,6
1683689638881,PHIL 174,A01,202226,Staff,17,0,20,3
1683689638881,PHIL 174,A02,202235,Staff,20,0,20,0
1683689639906,PHIL 191A,A00,258918,Staff,0,0,1,1
1683689640928,PHYS 1A,A00,187028,Staff,26,0,60,34
1683689641955,PHYS 1AL,001,187036,Staff,3,0,30,27
1683689641955,PHYS 1AL,002,187049,Staff,18,0,30,12
1683689642982,PHYS 1B,A00,187058,Staff,22,0,60,38
1683689644009,PHYS 1BL,001,187064,Staff,0,1,30,30
1683689644009,PHYS 1BL,002,187070,Staff,4,0,30,26
1683689645034,PHYS 1C,A00,187082,Staff,29,0,120,91
1683689646060,PHYS 1CL,001,187088,Staff,0,9,30,30
1683689646060,PHYS 1CL,002,187089,Staff,0,1,30,30
1683689646060,PHYS 1CL,009,262693,Staff,9,0,30,21
1683689647083,PHYS 2B,A01,187097,Staff,55,0,115,60
1683689648108,PHYS 2C,A01,187099,Staff,63,0,115,52
1683689649133,PHYS 2CL,A01,187101,Staff,5,0,28,23
1683689649133,PHYS 2CL,A02,187102,Staff,15,0,28,13
1683689650159,PHYS 2D,A01,187123,Shotwell; Brian,95,0,115,20
1683689651187,PHYS 4B,A01,187133,Grinstein; Benjamin,35,0,50,15
1683689652214,POLI 10,A00,188819,Staff,0,4,50,50
1683689653241,POLI 11,A00,188827,Staff,43,0,50,7
1683689654265,POLI 13R,A00,188828,Staff,0,1,20,20
1683689655289,POLI 27,A01,188830,Elgin; Samuel Zincke,0,2,70,70
1683689656313,POLI 30,A00,188832,Desposato; Scott,30,0,50,20
1683689657341,POLI 102F,A00,188834,Staff,1,0,40,39
1683689658367,POLI 104A,A00,188852,Staff,12,0,30,18
1683689659393,POLI 104I,A00,188853,Staff,0,8,20,20
1683689660420,POLI 110B,A00,188854,Wiens; David,6,0,20,14
1683689661447,POLI 112A,A00,188855,Wiens; David,3,0,30,27
1683689662474,POLI 117R,A00,188856,Forman; Fonna,0,12,20,20
1683689663500,POLI 118,A00,188857,Ingham; Sean,8,0,20,12
1683689664522,POLI 120G,A00,188858,Staff,8,0,30,22
1683689665546,POLI 131CR,A00,188863,Hoston; Germaine,20,0,50,30
1683689666570,POLI 133,A00,188864,Nellis; Gareth Hb,44,0,50,6
1683689667594,POLI 134D,A00,188865,Desposato; Scott,27,0,30,3
1683689668619,POLI 142A,A00,188871,Gartzke; Erik,21,0,50,29
1683689669643,POLI 142K,A00,188874,Staff,38,0,50,12
1683689670666,POLI 143,A00,188940,Gartzke; Erik,16,0,30,14
1683689671690,POLI 153,A00,188943,Staff,2,0,20,18
1683689672714,POLI 160AA,A00,188944,Staff,10,0,40,30
1683689673743,POLI 170A,A00,188945,Staff,10,0,30,20
1683689675853,PSYC 1,A00,188952,Staff,36,0,90,54
1683689676878,PSYC 2,B00,188953,Staff,19,0,35,16
1683689677902,PSYC 6,A00,188970,Staff,47,0,60,13
1683689678926,PSYC 7,A00,188973,Staff,35,0,45,10
1683689679950,PSYC 60,A01,188980,Rickard; Timothy C.,42,0,60,18
1683689680973,PSYC 70,A01,189001,Steiner; Eric Tomas,21,0,45,24
1683689681996,PSYC 100,A00,189005,Lacefield; Katharine I,0,99,120,120
1683689683019,PSYC 102,A00,189008,Staff,7,0,30,23
1683689684043,PSYC 106,B00,189026,Gorman; Michael R.,27,0,60,33
1683689685069,PSYC 114,B01,189033,Winkielman; Piotr,0,31,30,30
1683689686096,PSYC 131,A00,189036,Anagnostaras; Stephan,0,43,60,60
1683689687121,PSYC 136,A00,189041,Lowe; Angela Beth,0,7,25,25
1683689688145,PSYC 137,A00,189057,Winkielman; Piotr,1,37,25,24
1683689689171,PSYC 144,A00,189107,Wixted; John T,0,11,50,50
1683689691218,PSYC 162,A00,189142,Staff,0,9,85,85
1683689692241,PSYC 172,A00,189144,Gorman; Michael R.,0,6,30,30
1683689694294,PSYC 179,A00,189146,Lacefield; Katharine I,0,88,120,120
1683689695317,PSYC 181,A00,189147,Anagnostaras; Stephan,0,44,90,90
1683689696341,PSYC 190R,A00,189148,Barner; David A.,0,23,80,80
1683689697369,PSYC 191,A00,189275,Rickard; Timothy C.,0,11,25,25
1683689698392,PSYC 193,A00,189276,Chapman; Eddie Nathaniel,0,1,0,4
1683689699417,PSYC 193L,A01,189281,Lowe; Angela Beth,8,0,20,12
1683689699417,PSYC 193L,B01,189285,Staff,28,0,35,7
1683689700441,RELI 149,A00,187137,Rahimi; Babak,6,0,40,34
1683689701465,SE 9,A01,187315,Staff,0,2,18,18
1683689702492,SE 101B,A00,187409,Staff,24,0,30,6
1683689703517,SE 110B,A00,187444,Staff,10,0,40,30
1683689704542,SE 130B,A00,187449,Staff,31,0,40,9
1683689705567,SE 150A,A00,187516,Staff,8,0,20,12
1683689706591,SE 154,A00,187528,Staff,29,0,50,21
1683689707619,SIO 3,A01,258171,Staff,35,0,40,5
1683689708643,SIO 10,A00,187144,Cook; Geoffrey W,1,7,75,74
1683689709667,SIO 45,A00,187152,Cook; Geoffrey W,0,7,100,100
1683689710690,SIO 109R,A00,194486,Staff,0,4,20,20
1683689712743,SIO 187,A01,187233,Kacev; David,12,0,40,28
1683689713765,SOCI 1,A01,258656,Thorpe; Charles Robert,28,0,30,2
1683689713765,SOCI 1,A02,258658,Thorpe; Charles Robert,30,0,30,0
1683689713765,SOCI 1,A03,258661,Thorpe; Charles Robert,25,0,25,0
1683689713765,SOCI 1,A04,258666,Thorpe; Charles Robert,22,0,25,3
1683689713765,SOCI 1,A05,258897,Thorpe; Charles Robert,22,0,25,3
1683689713765,SOCI 1,A06,258898,Thorpe; Charles Robert,25,0,25,0
1683689714794,SOCI 30,A01,258903,Pardo Guerra; Juan Pablo,14,0,30,16
1683689715817,SOCI 102,A00,258904,Staff,9,0,25,16
1683689716841,SOCI 106,A00,258905,Staff,19,0,25,6
1683689717867,SOCI 111,A00,258907,Ribas Norris; Janet Vanesa,26,0,30,4
1683689718891,SOCI 121R,A00,258908,Pardo Guerra; Juan Pablo,8,0,30,22
1683689719915,SOCI 126,A01,203330,Staff,14,0,20,6
1683689720942,SOCI 131,A00,258909,Thorpe; Charles Robert,30,0,60,30
1683689721965,SOCI 135,A00,258910,Payne; Christine Anna,0,13,30,30
1683689722991,SOCI 157,A00,258911,Staff,11,0,30,19
1683689724015,SOCI 184,A00,258912,Staff,25,0,30,5
1683689725040,SOCI 188D,A00,258913,Staff,22,0,30,8
1683689726063,SYN 2,001,187529,Staff,9,0,16,7
1683689726063,SYN 2,002,201452,Staff,1,20,16,15
1683689726063,SYN 2,003,201469,Staff,1,0,16,15
1683689727090,SYN 100,A01,187531,Staff,0,9,20,20
1683689727090,SYN 100,B01,201491,Staff,0,10,20,20
1683689728116,TDAC 1,A00,189286,Walsh; Kim C.,3,0,20,17
1683689728116,TDAC 1,B00,189287,Harting; Carla Kelso,10,0,20,10
1683689729140,TDAC 101,A00,189300,Walsh; Kim C.,16,0,20,4
1683689729140,TDAC 101,B00,189301,Harting; Carla Kelso,18,0,20,2
1683689730173,TDAC 102,A00,189304,Basso; Beatrice,14,0,20,6
1683689731196,TDAC 108,A00,189305,Staff,18,0,20,2
1683689732222,TDDE 131,A00,189310,Staff,19,0,20,1
1683689732222,TDDE 131,B00,189314,Staff,19,0,20,1
1683689732222,TDDE 131,C00,189315,Staff,48,0,50,2
1683689732222,TDDE 131,D00,189316,Staff,14,0,15,1
1683689732222,TDDE 131,E00,204841,Staff,20,0,20,0
1683689733245,TDGE 10,A00,189289,Staff,27,0,50,23
1683689733245,TDGE 10,B00,189290,Havis; Allan,0,1,50,50
1683689734271,TDGE 11,A00,189291,Fulton; Julia,0,4,50,50
1683689734271,TDGE 11,B00,189292,Staff,20,0,25,5
1683689734271,TDGE 11,C00,260270,Staff,0,0,0,0
1683689735300,TDGE 25,A00,189294,Staff,1,0,20,19
1683689736327,TDGE 124,A00,189318,Fulton; Julia,1,8,50,49
1683689737355,TDGE 125,A00,189319,Staff,13,0,25,12
1683689737355,TDGE 125,B00,189320,Staff,23,0,25,2
1683689738382,TDGE 127,A00,189322,Havis; Allan,0,0,50,50
1683689739404,TDHT 101,A00,189323,Staff,18,0,25,7
1683689739404,TDHT 101,B00,189324,Staff,25,0,25,0
1683689740428,TDHT 102,A00,189325,Staff,49,0,50,1
1683689741456,TDMV 1,A00,189295,Arcidiacono; Kristin,20,0,30,10
1683689741456,TDMV 1,B00,189296,Caligagan; Maria T.,24,0,30,6
1683689742483,TDMV 2,A00,189297,Sammartano; Tonnie,27,0,30,3
1683689742483,TDMV 2,B00,189299,Arcidiacono; Kristin,23,0,30,7
1683689743505,TDMV 3,A00,204998,Rincon; Alicia,22,0,30,8
1683689744532,TDMV 120,A00,189458,Sammartano; Tonnie,28,0,30,2
1683689745560,TDMV 138,A00,189541,Jun; Grace Shin Hae,20,0,40,20
1683689746585,TDMV 142,A00,189717,Caligagan; Tony,25,0,30,5
1683689746585,TDMV 142,B00,189718,Caligagan; Maria T.,25,0,30,5
1683689747612,TMC 2,A01,187533,Staff,25,0,25,0
1683689747612,TMC 2,A02,187534,Staff,25,0,25,0
1683689748640,USP 1,A01,187536,Kwak; Nancy,0,16,25,25
1683689749666,USP 5,A01,187538,Staff,8,0,25,17
1683689750690,USP 101,A00,199253,Staff,0,4,0,0
1683689751718,USP 124,A00,187562,Boomhower; Matthew Charles,0,0,30,30
1683689752744,USP 138,A00,187582,Staff,19,0,25,6
1683689753772,USP 152,A01,187597,Staff,3,0,25,22
1683689754796,USP 153,A00,187598,Staff,18,0,25,7
1683689755820,USP 168,A00,187607,Kwak; Nancy,2,0,5,3
1683689756844,USP 173,A00,187619,Staff,4,0,25,21
1683689757869,USP 181,A00,187638,Staff,0,4,25,25
1683689758893,VIS 103,A00,187650,Cruz; Edwin Teddy,17,0,75,58
1683689759918,VIS 110D,A00,187669,Staff,13,0,22,9
1683689760941,VIS 127C,A00,187720,Shen; Kuiyi,67,0,146,79
1683689761968,VIS 149,A00,187731,Yoldas; Pinar,1,14,22,21
1683689762992,VIS 151,A01,188091,Staff,22,0,34,12
1683689762992,VIS 151,A02,188092,Staff,11,0,34,23
1683689764017,VIS 160B,A00,188093,Stalbaum; Brett,0,1,10,10
1683689766066,WCWP 10B,A00,201720,Staff,0,0,5,5
1683689766066,WCWP 10B,B00,201722,Staff,0,0,6,6
1683689767090,WCWP 100,A00,201725,Gagnon; Jeffrey C,0,0,2,2
1683689767090,WCWP 100,B00,201727,Staff,0,4,15,15
1683689770190,ANBI 133,A00,258401,Wilder; Linnea Lorene,34,0,40,6
1683689771213,ANBI 140,A00,258395,Hrvoj Mihic; Branka,18,0,25,7
1683689772237,ANSC 120,A00,258402,Bialecki; Jon Anthony,26,0,40,14
1683689773259,ANSC 144,A00,258400,Staff,12,0,40,28
1683689775311,ANSC 166,A00,258396,Parish; Steven Martin,156,0,175,19
1683689776337,ANSC 180,A00,193533,Staff,8,0,20,12
1683689777360,ANSC 188,A00,258397,Jassal; Aftab,34,0,40,6
1683689778441,ANTH 3,A01,258316,Staff,23,0,30,7
1683689779468,ANTH 5,A00,258394,Semendeferi; Ekaterini,16,0,20,4
1683689780494,ANTH 21,A01,258331,Staff,4,0,40,36
1683689781519,ANTH 103,A00,258398,Varma; Saiba,15,0,25,10
1683689782544,AWP 10,001,202034,Staff,0,0,0,0
1683689782544,AWP 10,002,202035,Staff,0,0,0,0
1683689782544,AWP 10,003,202036,Staff,0,0,0,0
1683689782544,AWP 10,004,202037,Staff,0,0,0,0
1683689782544,AWP 10,005,202038,Staff,0,0,0,0
1683689782544,AWP 10,006,202039,Staff,0,0,0,0
1683689782544,AWP 10,007,202040,Staff,0,0,0,0
1683689782544,AWP 10,008,202041,Staff,0,0,0,0
1683689782544,AWP 10,009,202042,Staff,0,0,0,0
1683689782544,AWP 10,010,202043,Staff,0,0,0,0
1683689782544,AWP 10,011,202044,Staff,0,0,0,0
1683689782544,AWP 10,012,202045,Staff,0,0,0,0
1683689782544,AWP 10,013,202046,Staff,0,0,0,0
1683689782544,AWP 10,014,202047,Staff,0,0,0,0
1683689782544,AWP 10,015,202048,Staff,0,0,0,0
1683689782544,AWP 10,016,202049,Staff,0,0,0,0
1683689782544,AWP 10,017,202050,Staff,0,0,0,0
1683689782544,AWP 10,018,202051,Staff,0,0,0,0
1683689782544,AWP 10,019,202052,Staff,0,0,0,0
1683689782544,AWP 10,020,202053,Staff,0,0,0,0
1683689782544,AWP 10,021,202054,Staff,0,0,0,0
1683689782544,AWP 10,022,202055,Staff,0,0,0,0
1683689782544,AWP 10,023,202056,Staff,0,0,0,0
1683689782544,AWP 10,024,202057,Staff,0,0,0,0
1683689782544,AWP 10,025,202058,Staff,0,0,0,0
1683689782544,AWP 10,026,202059,Staff,0,0,0,0
1683689783572,AWP 102,001,202032,Staff,0,0,0,0
1683689783572,AWP 102,002,202033,Staff,0,0,0,0
1683689784598,BENG 100,A01,254234,Taylor Amos; Alyssa C,31,0,40,9
1683689785626,BENG 196,001,270013,Engler; Adam J.,9999,0,9999,0
1683689786654,BICD 100R,A01,202018,Smith; Laurie,0,7,32,32
1683689786654,BICD 100R,A02,202019,Smith; Laurie,0,3,32,32
1683689786654,BICD 100R,A03,202020,Smith; Laurie,0,1,32,32
1683689786654,BICD 100R,A04,202021,Smith; Laurie,6,0,32,26
1683689786654,BICD 100R,A05,202022,Smith; Laurie,10,0,32,22
1683689787682,BICD 136,A01,193242,Gustafson-Brown; Cindy,0,2,32,32
1683689787682,BICD 136,A02,193244,Gustafson-Brown; Cindy,13,0,32,19
1683689788710,BIEB 102,A01,193249,Butler; Shannon Rhey,1,1,32,31
1683689788710,BIEB 102,A02,193251,Butler; Shannon Rhey,0,0,32,32
1683689788710,BIEB 102,A03,193253,Butler; Shannon Rhey,0,0,32,32
1683689788710,BIEB 102,A04,193255,Butler; Shannon Rhey,13,0,32,19
1683689788710,BIEB 102,A05,193265,Butler; Shannon Rhey,25,0,32,7
1683689788710,BIEB 102,A06,193269,Butler; Shannon Rhey,13,0,32,19
1683689790762,BIEB 150,A01,193274,Staff,0,0,32,32
1683689790762,BIEB 150,A02,193285,Staff,24,0,32,8
1683689791788,BIEB 194,A00,193286,Kurle; Carolyn M.,19,0,32,13
1683689792812,BILD 1,A01,192291,Staff,15,0,32,17
1683689792812,BILD 1,A02,192292,Staff,30,0,32,2
1683689792812,BILD 1,B01,192520,Reuther; Keefe,0,1,0,0
1683689792812,BILD 1,B02,192532,Reuther; Keefe,0,1,0,0
1683689793836,BILD 3,A01,192556,Butler; Shannon Rhey,0,0,32,32
1683689793836,BILD 3,A02,192581,Butler; Shannon Rhey,0,1,32,32
1683689793836,BILD 3,A03,192611,Butler; Shannon Rhey,19,0,32,13
1683689793836,BILD 3,A04,192612,Butler; Shannon Rhey,24,0,32,8
1683689793836,BILD 3,A05,192613,Butler; Shannon Rhey,26,0,32,6
1683689793836,BILD 3,A06,192679,Butler; Shannon Rhey,27,0,32,5
1683689793836,BILD 3,A07,192682,Butler; Shannon Rhey,20,0,32,12
1683689794860,BILD 4,A01,192836,Reuther; Keefe,1,0,24,23
1683689794860,BILD 4,A02,193044,Reuther; Keefe,4,0,24,20
1683689795887,BILD 10,A01,193142,Gustafson-Brown; Cindy,29,0,32,3
1683689795887,BILD 10,A02,193149,Gustafson-Brown; Cindy,31,0,32,1
1683689796914,BIMM 100,A01,193301,Staff,0,6,32,32
1683689796914,BIMM 100,A02,193312,Staff,0,7,32,32
1683689796914,BIMM 100,A03,193323,Staff,0,10,32,32
1683689797938,BIMM 101,A01,193329,McDonnell; Lisa Marie,1,4,24,23
1683689797938,BIMM 101,A02,193339,McDonnell; Lisa Marie,1,4,24,23
1683689797938,BIMM 101,B01,193354,McDonnell; Lisa Marie,0,4,24,24
1683689797938,BIMM 101,B02,193357,McDonnell; Lisa Marie,0,3,24,24
1683689798963,BIMM 110,A01,193377,Tat; John,0,11,32,32
1683689798963,BIMM 110,A02,193378,Tat; John,0,11,32,32
1683689799988,BIMM 120,A01,206116,Staff,0,0,32,32
1683689799988,BIMM 120,A02,206117,Staff,7,0,32,25
1683689799988,BIMM 120,A03,206121,Staff,21,0,32,11
1683689801016,BIPN 100,A01,193393,Park; Ji Young,0,15,32,32
1683689801016,BIPN 100,A02,193402,Park; Ji Young,0,14,32,32
1683689801016,BIPN 100,A03,193413,Park; Ji Young,0,14,32,32
1683689801016,BIPN 100,A04,193414,Park; Ji Young,0,13,32,32
1683689802044,BIPN 102,A01,193429,Staff,0,0,32,32
1683689802044,BIPN 102,A02,193438,Staff,18,0,32,14
1683689803068,BIPN 106,A01,193450,Reyes Gonzalez; Catalina,0,2,40,40
1683689804092,BIPN 134,A01,193465,Cooke; James Edward,0,0,32,32
1683689804092,BIPN 134,A02,193474,Cooke; James Edward,25,0,32,7
1683689804092,BIPN 134,A03,193485,Cooke; James Edward,29,0,32,3
1683689804092,BIPN 134,A04,193486,Cooke; James Edward,20,0,32,12
1683689804092,BIPN 134,A05,193491,Cooke; James Edward,31,0,32,1
1683689804092,BIPN 134,A06,193501,Cooke; James Edward,30,0,32,2
1683689804092,BIPN 134,A07,193510,Cooke; James Edward,29,0,32,3
1683689806142,BISP 194,A00,222522,Staff,14,0,32,18
1683689807166,CAT 124,A01,202407,Staff,19,0,25,6
1683689808202,CAT 125,A00,202408,Marchisotto; Jennifer Anne,2,0,20,18
1683689809229,CAT 125R,A00,202409,Smith; Lauryn Alissa,0,11,20,20
1683689809229,CAT 125R,B00,202410,Morales; Celeste Georgianna,0,11,20,20
1683689809229,CAT 125R,C00,202411,Irwin; Matthew Joseph,0,12,20,20
1683689810253,CENG 15,A01,204712,Yang; Kesong,0,1,0,0
1683689811279,CENG 114,A00,202070,Jahed Motlagh; Zeinab,5,0,20,15
1683689812304,CGS 105,A00,185477,Wesling; Megan E.,24,0,40,16
1683689813332,CGS 106,A00,185494,Staff,11,0,22,11
1683689814355,CGS 108,A00,185495,Staff,14,0,20,6
1683689815378,CGS 114,A00,185496,Staff,13,0,18,5
1683689816402,CGS 119,A00,185501,Staff,15,0,20,5
1683689817428,CGS 120,A00,185511,Staff,12,0,20,8
1683689818450,CHEM 4,A01,184675,Bussey; Thomas J,97,0,100,3
1683689819478,CHEM 6A,A01,184677,Staff,32,0,60,28
1683689820501,CHEM 6B,A01,184679,Staff,63,0,100,37
1683689821526,CHEM 6C,A01,184681,Bussey; Thomas J,0,0,50,50
1683689821526,CHEM 6C,A02,184682,Bussey; Thomas J,32,0,50,18
1683689822553,CHEM 40A,A01,184684,Albizati; Kim F.,33,0,100,67
1683689823577,CHEM 40B,A01,184686,Albizati; Kim F.,0,22,100,100
1683689824606,CHEM 41B,A01,184690,Staff,51,0,100,49
1683689825633,COGS 3,A01,184715,Boyle; Mary E. T.,0,27,40,40
1683689826659,COGS 14B,A01,185172,Staff,0,14,38,38
1683689827688,COGS 18,A01,184736,Staff,14,0,80,66
1683689828711,COGS 100,A01,184932,Staff,0,8,73,73
1683689829740,COGS 101A,A01,184935,Staff,0,40,30,30
1683689830768,COGS 101B,A01,184944,Staff,0,2,30,30
1683689831793,COGS 101C,A01,184946,Staff,0,10,30,30
1683689832816,COGS 102A,A01,184951,Johnson; Christine M.,1,0,40,39
1683689833842,COGS 107B,A01,184953,Mooshagian; Eric Frederick,0,52,40,40
1683689834870,COGS 118B,A01,184959,Gupta; Anjum,0,50,40,40
1683689835894,COGS 153,A00,184961,Staff,0,16,30,30
1683689836921,COGS 177,A00,184962,Staff,1,21,30,29
1683689837947,COGS 187A,A01,184969,Boyle; Mary E. T.,0,19,40,40
1683689838975,COMM 10,A01,185174,Staff,0,5,25,25
1683689838975,COMM 10,A02,185189,Staff,0,2,25,25
1683689838975,COMM 10,A03,269821,Staff,0,1,0,0
1683689840000,COMM 100B,A02,185476,Staff,10,0,25,15
1683689840000,COMM 100B,A03,277340,Staff,25,0,25,0
1683689841025,COMM 100C,A01,185314,Staff,1,0,25,24
1683689841025,COMM 100C,A02,185327,Staff,17,0,25,8
1683689842053,COMM 110M,A00,185349,Staff,0,0,40,40
1683689843081,COMM 113T,A00,185352,Staff,25,0,40,15
1683689844107,COMM 114I,A00,185353,Staff,31,0,40,9
1683689845130,COMM 131,A00,185354,Staff,17,0,30,13
1683689846154,CSE 8A,A50,185358,Cao; Yingjun,0,46,10,10
1683689847180,CSE 8B,A01,185362,Staff,0,48,50,50
1683689848204,CSE 11,A01,185416,Cao; Yingjun,0,91,10,10
1683689849228,CSE 20,A01,185445,Briones; Jor-el Thomas Caparas,3,0,25,22
1683689850253,CSE 21,A01,185447,Staff,9,0,50,41
1683689851282,CSE 101,A01,185451,Staff,0,13,50,50
1683689851282,CSE 101,B01,185453,Jones; Miles E,0,14,50,50
1683689853334,CSE 141,A01,185458,Eldon; John,16,0,100,84
1683689854358,CSE 141L,A01,185461,Eldon; John,8,0,100,92
1683689855386,CSE 142,A01,185463,Staff,34,0,60,26
1683689855386,CSE 142,B01,201355,Staff,0,7,60,60
1683689856414,CSE 142L,A01,185470,Staff,34,0,60,26
1683689856414,CSE 142L,B01,201417,Staff,0,6,60,60
1683689857437,CSE 190,A00,201433,Staff,32,0,49,17
1683689858462,DOC 1,A01,259136,Strom; Megan C.,7,0,15,8
1683689858462,DOC 1,A02,259137,Strom; Megan C.,14,0,15,1
1683689858462,DOC 1,A03,259138,Strom; Megan C.,14,0,15,1
1683689858462,DOC 1,A04,259139,Strom; Megan C.,14,0,15,1
1683689859486,DOC 100D,A00,259140,Pass; Natalye Joann,14,0,25,11
1683689860514,DSGN 1,A01,184749,Rill; Bryan,0,26,30,30
1683689861542,DSGN 100,A01,185168,Staff,0,2,25,25
1683689862569,ECE 5,A01,185626,Morris; Karcher William,0,12,0,0
1683689863593,ECE 101,A01,185628,Staff,14,0,70,56
1683689864617,ECE 107,A01,185635,Baghdadchi; Saharnaz,0,0,20,20
1683689864617,ECE 107,A02,185638,Baghdadchi; Saharnaz,1,0,20,19
1683689865645,ECE 148,A01,185647,Silberman; Jack,0,0,16,16
1683689866669,ECON 1,A01,185537,Crane; Meredith Helen,54,0,70,16
1683689867693,ECON 3,A01,185549,Crane; Meredith Helen,30,0,70,40
1683689868718,ECON 4,A01,203354,Anderson; John Charles,0,5,10,10
1683689869746,ECON 100A,A01,185574,Staff,0,5,40,40
1683689870773,ECON 100B,A01,185576,Staff,0,12,50,50
1683689871798,ECON 100C,A01,185589,Newhouse; Herbert S,30,0,70,40
1683689872822,ECON 105,A00,185608,Vespa; Emanuel Ignacio,19,0,35,16
1683689873849,ECON 109,A01,185610,Shishkin; Denis,9,0,35,26
1683689874876,ECON 110A,A01,185612,Staff,8,0,40,32
1683689875902,ECON 120A,A01,185615,Staff,19,0,40,21
1683689876926,ECON 120C,A01,185617,Sun; Yixiao,0,21,70,70
1683689877951,ECON 144,A00,203346,Squires; Dale E,2,0,35,33
1683689878976,ECON 171,A01,203349,Newhouse; Herbert S,0,1,35,35
1683689880003,ECON 173A,A01,185621,Toda; Alexis Akira,21,0,35,14
1683689881035,EDS 25,A01,202413,Staff,0,1,0,0
1683689881035,EDS 25,A02,202414,Staff,0,1,0,0
1683689881035,EDS 25,A03,202415,Staff,0,0,0,0
1683689881035,EDS 25,A04,202416,Staff,0,1,0,0
1683689881035,EDS 25,A05,202439,Staff,0,0,0,0
1683689881035,EDS 25,A06,202440,Staff,0,0,0,0
1683689881035,EDS 25,B01,202631,Staff,0,0,0,0
1683689881035,EDS 25,B02,202632,Staff,0,0,0,0
1683689881035,EDS 25,B03,202639,Staff,0,0,0,0
1683689881035,EDS 25,B04,202640,Staff,0,0,0,0
1683689881035,EDS 25,B05,202643,Staff,0,0,0,0
1683689881035,EDS 25,B06,202644,Staff,0,0,0,0
1683689882121,EDS 38,A01,202659,Black; Alison Michelle,24,0,25,1
1683689883146,EDS 115,A00,202652,Staff,18,0,30,12
1683689884171,EDS 125,A00,202649,Staff,13,0,30,17
1683689885199,EDS 126,A01,203332,Staff,30,0,30,0
1683689886226,EDS 139,A00,202838,Staff,16,0,25,9
1683689887253,EDS 146,A01,202655,Staff,14,0,25,11
1683689888282,ENG 15,A00,185667,Staff,0,1,0,0
1683689888282,ENG 15,B00,185672,Staff,0,0,0,0
1683689888282,ENG 15,C00,185675,Staff,0,0,0,0
1683689888282,ENG 15,D00,185682,Staff,0,0,0,0
1683689888282,ENG 15,E00,185684,Staff,0,0,0,0
1683689889310,ETHN 103,A00,185710,Staff,0,8,35,35
1683689890336,ETHN 103A,A00,199228,Man; Simeon S,0,0,9,9
1683689891360,ETHN 109,A00,185711,Staff,15,0,35,20
1683689892394,ETHN 142,A00,185726,Staff,0,4,30,30
1683689893421,ETHN 163J,A00,199229,Man; Simeon S,5,0,8,3
1683689894445,ETHN 168,A00,185727,Staff,7,0,10,3
1683689895470,ETHN 182,A00,185728,Staff,0,0,35,35
1683689896495,ETHN 183,A00,185737,Staff,9,0,18,9
1683689897519,GLBH 111,A01,209361,Burgos; Jose L.,0,0,0,0
1683689899567,HIEU 104,A00,185792,Staff,14,0,20,6
1683689900592,HIEU 115,A00,185800,Staff,0,0,20,20
1683689901619,HIEU 128,A00,185801,Staff,0,9,20,20
1683689902646,HIEU 147,A00,185802,Staff,15,0,20,5
1683689903671,HIEU 154,A00,185823,Staff,11,0,20,9
1683689904696,HILA 102,A00,185826,Staff,14,0,20,6
1683689905721,HILD 2C,A01,185778,Staff,0,13,20,20
1683689906744,HILD 7B,A01,185780,Kwak; Nancy,0,17,32,32
1683689906744,HILD 7B,A02,185781,Kwak; Nancy,0,18,32,32
1683689907769,HILD 30,A01,185791,Staff,12,0,20,8
1683689908797,HISC 119,A00,185830,Golan; Tal,0,11,20,20
1683689909825,HITO 156GS,A00,185831,Patterson; Patrick H.,0,0,0,23
1683689910849,HIUS 103,A00,185832,Man; Simeon S,0,4,20,20
1683689911873,HIUS 117,A00,185836,Kwak; Nancy,2,0,20,18
1683689912898,HIUS 125,A00,185840,Man; Simeon S,0,2,23,23
1683689913921,HIUS 149,A00,185845,Staff,1,0,20,19
1683689914946,HUM 3,A01,185882,Zavodny; Tatiana Sophia,0,8,50,50
1683689914946,HUM 3,B01,185899,Caldwell; Michael Alan,0,18,50,50
1683689915971,HUM 3GS,A00,185900,Patterson; Patrick H.,0,0,0,23
1683689916996,HUM 4,A01,185938,Zroka; Amy Liane,28,0,50,22
1683689916996,HUM 4,B01,185956,Watkins; Eric,0,6,50,50
1683689916996,HUM 4,B02,202209,Watkins; Eric,0,5,50,50
1683689916996,HUM 4,B03,202210,Watkins; Eric,0,5,50,50
1683689918025,HUM 5,A01,185958,West; Geoffrey Scott,0,0,50,50
1683689918025,HUM 5,A02,202215,West; Geoffrey Scott,0,1,50,50
1683689919050,INTL 190,A00,185959,Gagnon; Jeffrey C,0,0,0,9
1683689919050,INTL 190,B00,185960,Lettieri; Michael Joseph,0,0,0,2
1683689920075,JAPN 180,A00,254509,Staff,5,0,30,25
1683689921100,LATI 10,A01,202853,Kennemore; Amy Michelle,4,0,35,31
1683689921100,LATI 10,A02,202854,Kennemore; Amy Michelle,3,0,35,32
1683689921100,LATI 10,A03,270054,Kennemore; Amy Michelle,30,0,30,0
1683689922124,LATI 180,A00,202855,Kennemore; Amy Michelle,11,0,20,9
1683689923147,LAWS 101,A00,201767,Golan; Tal,0,7,40,40
1683689924172,LIFR 1C,A00,185961,Staff,6,0,20,14
1683689925199,LIFR 1CX,A00,185962,Staff,7,0,20,13
1683689926222,LIFR 1D,A00,185963,Staff,7,0,20,13
1683689927246,LIFR 1DX,A00,185964,Staff,7,0,20,13
1683689928270,LIGN 101,A01,186039,Staff,43,0,50,7
1683689929294,LIGN 165,A00,186040,Staff,15,0,50,35
1683689930321,LTCS 108,A00,186041,Staff,5,0,10,5
1683689931348,LTCS 119,A00,186042,Staff,15,0,20,5
1683689932375,LTCS 130,A00,186043,Wesling; Megan E.,15,0,25,10
1683689934426,LTEA 138,A00,186119,Staff,14,0,40,26
1683689935450,LTEN 124,A00,186148,Staff,5,0,25,20
1683689936474,LTEN 178,A00,186149,Staff,6,0,15,9
1683689937498,LTEN 181,A00,186150,Blanco; John D,34,0,40,6
1683689938525,LTWL 120,A00,186160,Staff,19,0,25,6
1683689939552,LTWL 165,A00,186161,Staff,22,0,25,3
1683689940579,LTWR 100,A00,186162,Staff,0,5,15,15
1683689941606,LTWR 102,A00,186163,Doller; Ben,5,0,15,10
1683689942629,MAE 8,A01,186412,Staff,0,1,0,0
1683689943657,MAE 30B,A00,186445,Bahadori; Mohammad Yousef,81,0,100,19
1683689944685,MAE 40,A00,186592,Bewley; Thomas R,10,0,50,40
1683689945709,MAE 101B,A00,186593,Bahadori; Mohammad Yousef,80,0,100,20
1683689946734,MAE 105,A00,186594,Bandaru; Prabhakar,10,0,50,40
1683689947761,MAE 107,A00,186599,Pham; Hieu Tan,0,7,120,120
1683689948788,MAE 148,A01,186660,Silberman; Jack,3,0,16,13
1683689949815,MATH 10A,A01,188095,Staff,0,6,35,35
1683689950842,MATH 10B,A01,188097,Bowers; Adam R.,0,12,30,30
1683689950842,MATH 10B,A02,188099,Bowers; Adam R.,0,11,30,30
1683689950842,MATH 10B,B01,188104,Bowers; Adam R.,0,10,30,30
1683689950842,MATH 10B,B02,188106,Bowers; Adam R.,1,9,30,29
1683689951871,MATH 10C,A01,188111,Staff,0,20,30,30
1683689951871,MATH 10C,A02,188127,Staff,0,19,30,30
1683689951871,MATH 10C,A03,188131,Staff,0,19,30,30
1683689951871,MATH 10C,B01,188218,Staff,17,0,30,13
1683689951871,MATH 10C,B02,188244,Staff,13,0,30,17
1683689951871,MATH 10C,B03,188277,Staff,14,0,30,16
1683689952900,MATH 18,A01,188344,Bach; Quang Tran,18,0,30,12
1683689952900,MATH 18,A02,188345,Bach; Quang Tran,11,0,30,19
1683689952900,MATH 18,B01,188353,Bach; Quang Tran,11,0,30,19
1683689952900,MATH 18,B02,188354,Bach; Quang Tran,19,0,30,11
1683689953929,MATH 20A,A01,188374,Staff,11,0,35,24
1683689954955,MATH 20B,A01,188382,Ohm; Ko Woon,7,0,30,23
1683689954955,MATH 20B,A02,188383,Ohm; Ko Woon,22,0,30,8
1683689954955,MATH 20B,B01,188385,Ohm; Ko Woon,7,0,30,23
1683689954955,MATH 20B,B02,188392,Ohm; Ko Woon,22,0,30,8
1683689955979,MATH 20C,A01,188394,Harel; Guershon,10,0,30,20
1683689955979,MATH 20C,A02,188395,Harel; Guershon,13,0,30,17
1683689955979,MATH 20C,B01,188404,Harel; Guershon,5,0,30,25
1683689955979,MATH 20C,B02,188405,Harel; Guershon,18,0,30,12
1683689957004,MATH 20D,A01,188414,Hammock; Frances H,0,1,30,30
1683689957004,MATH 20D,A02,188415,Hammock; Frances H,0,1,30,30
1683689957004,MATH 20D,B01,188447,Hammock; Frances H,0,1,30,30
1683689957004,MATH 20D,B02,188486,Hammock; Frances H,2,0,30,28
1683689958032,MATH 20E,A01,188649,Staff,21,0,30,9
1683689958032,MATH 20E,A02,188650,Staff,20,0,30,10
1683689958032,MATH 20E,A03,188673,Staff,0,0,30,30
1683689959055,MATH 102,A01,188675,Staff,0,40,35,35
1683689960079,MATH 103B,A01,188681,Staff,3,0,35,32
1683689960079,MATH 103B,B01,188692,Staff,5,0,35,30
1683689961104,MATH 109,A01,188695,Salehi Golsefidy; Alireza,24,0,35,11
1683689961104,MATH 109,A02,188696,Salehi Golsefidy; Alireza,25,0,35,10
1683689962128,MATH 120A,A01,188698,Eggers; John Dietrich,7,0,35,28
1683689963152,MATH 142B,A01,188736,Ioana; Adrian,1,1,30,29
1683689963152,MATH 142B,A02,188741,Ioana; Adrian,0,1,30,30
1683689963152,MATH 142B,A03,188743,Ioana; Adrian,0,2,30,30
1683689964177,MATH 168A,A01,188790,Staff,0,11,35,35
1683689965206,MATH 170A,A01,188803,Nie; Jiawang,0,2,35,35
1683689965206,MATH 170A,A02,188811,Nie; Jiawang,0,1,35,35
1683689965206,MATH 170A,A03,188814,Nie; Jiawang,0,0,35,35
1683689965206,MATH 170A,A04,188815,Nie; Jiawang,5,0,35,30
1683689966233,MATH 193B,A01,188817,Staff,0,0,35,35
1683689966233,MATH 193B,A02,188818,Staff,6,0,35,29
1683689967260,MGT 4,A01,202857,Anderson; John Charles,59,0,80,21
1683689968286,MGT 12,A00,202858,Lindenberger; Wade Douglas,40,0,90,50
1683689969313,MGT 18,A00,202859,Staff,74,0,90,16
1683689970339,MGT 18GS,A00,202860,McKay; Michael J,13,0,28,15
1683689971364,MGT 45,A00,202861,Pecore; Joseph P.,8,0,90,82
1683689972389,MGT 100,A00,202863,Yavorsky; Daniel Ryan,27,0,90,63
1683689973415,MGT 103,A00,202864,Ehrich; Kristine R,0,19,90,90
1683689974441,MGT 112,A00,202865,Ehrich; Kristine R,15,0,90,75
1683689975465,MGT 121A,A00,202868,Staff,90,20,90,0
1683689976491,MGT 131B,A00,202869,Anderson; John Charles,58,0,90,32
1683689977514,MGT 136,A00,202871,Lindenberger; Wade Douglas,83,0,90,7
1683689978537,MGT 164,A00,202873,Staff,0,67,90,91
1683689979560,MGT 164GS,A00,202874,McKay; Mary A,13,0,28,15
1683689980584,MGT 180,A00,202875,Staff,0,51,90,91
1683689981609,MMW 11R,A01,205019,Herbst; Matthew,0,0,30,30
1683689981609,MMW 11R,A02,205026,Herbst; Matthew,29,0,30,1
1683689982639,MMW 15,A01,193512,Chang; Edmond Yi-Teh,0,8,28,28
1683689982639,MMW 15,A02,193513,Chang; Edmond Yi-Teh,0,5,28,28
1683689982639,MMW 15,A03,193514,Chang; Edmond Yi-Teh,0,5,28,28
1683689982639,MMW 15,A04,193515,Chang; Edmond Yi-Teh,0,5,28,28
1683689982639,MMW 15,A05,193516,Chang; Edmond Yi-Teh,0,5,28,28
1683689982639,MMW 15,A06,193517,Chang; Edmond Yi-Teh,0,6,28,28
1683689982639,MMW 15,B01,193519,Chang; Edmond Yi-Teh,0,5,28,28
1683689982639,MMW 15,B02,193520,Chang; Edmond Yi-Teh,0,5,28,28
1683689982639,MMW 15,B03,193521,Chang; Edmond Yi-Teh,0,5,28,28
1683689982639,MMW 15,B04,193522,Chang; Edmond Yi-Teh,0,6,28,28
1683689982639,MMW 15,B05,193523,Chang; Edmond Yi-Teh,0,5,28,28
1683689982639,MMW 15,B06,193524,Chang; Edmond Yi-Teh,0,5,28,28
1683689983668,MMW 122,A01,193526,Rahimi; Babak,0,16,28,28
1683689983668,MMW 122,A02,193527,Rahimi; Babak,0,15,28,28
1683689983668,MMW 122,A03,193528,Rahimi; Babak,0,0,0,0
1683689983668,MMW 122,A04,193529,Rahimi; Babak,0,0,0,0
1683689984693,MUS 1A,A01,186663,Staff,1,19,35,34
1683689985777,MUS 4,A01,186715,Staff,0,12,35,35
1683689986801,MUS 5R,A01,186796,Dubnov; Shlomo,0,17,35,35
1683689987828,MUS 6,A01,186798,Staff,1,5,25,24
1683689988851,MUS 7,A01,186830,Staff,11,0,35,24
1683689989875,MUS 8,A01,186930,Staff,0,27,35,35
1683689990899,MUS 15,A01,186932,Staff,0,15,35,35
1683689990899,MUS 15,B01,186934,Staff,1,17,35,34
1683689991936,MUS 80,A00,186935,Staff,0,0,20,20
1683689991936,MUS 80,B00,186936,Staff,24,0,25,1
1683689992962,NANO 11,A00,204702,Lipomi; Darren John,0,0,0,0
1683689993991,NANO 15,A01,204709,Yang; Kesong,0,1,0,0
1683689995015,NANO 114,A00,202069,Jahed Motlagh; Zeinab,2,0,10,8
1683689996041,PHIL 1,A00,186955,Grush; Rick Scott,31,0,40,9
1683689997068,PHIL 10,A01,186973,Grush; Rick Scott,27,0,35,8
1683689997068,PHIL 10,A02,186974,Grush; Rick Scott,33,0,35,2
1683689998094,PHIL 13,A01,186976,Staff,1,0,35,34
1683689998094,PHIL 13,A02,186977,Staff,16,0,35,19
1683689999121,PHIL 14,A01,186979,Staff,31,0,35,4
1683689999121,PHIL 14,A02,186986,Staff,32,0,35,3
1683690000149,PHIL 28,A01,186988,Staff,16,0,30,14
1683690000149,PHIL 28,A02,186989,Staff,1,0,30,29
1683690000149,PHIL 28,A03,186990,Staff,10,0,30,20
1683690000149,PHIL 28,A04,186991,Staff,26,0,30,4
1683690001171,PHIL 120,A00,186997,Staff,23,0,40,17
1683690002196,PHIL 137,A00,187003,Staff,7,0,40,33
1683690003220,PHIL 150,A00,187015,Staff,47,0,70,23
1683690004246,PHIL 167,A00,187021,Lamey; Andy M.,34,0,40,6
1683690005272,PHIL 174,A01,202226,Staff,17,0,20,3
1683690005272,PHIL 174,A02,202235,Staff,20,0,20,0
1683690006298,PHIL 191A,A00,258918,Staff,0,0,1,1
1683690007322,PHYS 1A,A00,187028,Staff,26,0,60,34
1683690008345,PHYS 1AL,001,187036,Staff,3,0,30,27
1683690008345,PHYS 1AL,002,187049,Staff,18,0,30,12
1683690009371,PHYS 1B,A00,187058,Staff,22,0,60,38
1683690010394,PHYS 1BL,001,187064,Staff,0,1,30,30
1683690010394,PHYS 1BL,002,187070,Staff,4,0,30,26
1683690011422,PHYS 1C,A00,187082,Staff,29,0,120,91
1683690012450,PHYS 1CL,001,187088,Staff,0,9,30,30
1683690012450,PHYS 1CL,002,187089,Staff,0,1,30,30
1683690012450,PHYS 1CL,009,262693,Staff,9,0,30,21
1683690013476,PHYS 2B,A01,187097,Staff,55,0,115,60
1683690014503,PHYS 2C,A01,187099,Staff,63,0,115,52
1683690015527,PHYS 2CL,A01,187101,Staff,5,0,28,23
1683690015527,PHYS 2CL,A02,187102,Staff,15,0,28,13
1683690016554,PHYS 2D,A01,187123,Shotwell; Brian,95,0,115,20
1683690017576,PHYS 4B,A01,187133,Grinstein; Benjamin,35,0,50,15
1683690018600,POLI 10,A00,188819,Staff,0,4,50,50
1683690019623,POLI 11,A00,188827,Staff,43,0,50,7
1683690020645,POLI 13R,A00,188828,Staff,0,1,20,20
1683690021668,POLI 27,A01,188830,Elgin; Samuel Zincke,0,2,70,70
1683690022692,POLI 30,A00,188832,Desposato; Scott,30,0,50,20
1683690023715,POLI 102F,A00,188834,Staff,1,0,40,39
1683690024743,POLI 104A,A00,188852,Staff,12,0,30,18
1683690025770,POLI 104I,A00,188853,Staff,0,8,20,20
1683690026794,POLI 110B,A00,188854,Wiens; David,6,0,20,14
1683690027818,POLI 112A,A00,188855,Wiens; David,3,0,30,27
1683690028842,POLI 117R,A00,188856,Forman; Fonna,0,12,20,20
1683690029870,POLI 118,A00,188857,Ingham; Sean,8,0,20,12
1683690030897,POLI 120G,A00,188858,Staff,8,0,30,22
1683690031925,POLI 131CR,A00,188863,Hoston; Germaine,20,0,50,30
1683690032949,POLI 133,A00,188864,Nellis; Gareth Hb,44,0,50,6
1683690033973,POLI 134D,A00,188865,Desposato; Scott,27,0,30,3
1683690034996,POLI 142A,A00,188871,Gartzke; Erik,21,0,50,29
1683690036022,POLI 142K,A00,188874,Staff,38,0,50,12
1683690037045,POLI 143,A00,188940,Gartzke; Erik,16,0,30,14
1683690038071,POLI 153,A00,188943,Staff,2,0,20,18
1683690039094,POLI 160AA,A00,188944,Staff,10,0,40,30
1683690040120,POLI 170A,A00,188945,Staff,10,0,30,20
1683690042171,PSYC 1,A00,188952,Staff,36,0,90,54
1683690043198,PSYC 2,B00,188953,Staff,19,0,35,16
1683690044221,PSYC 6,A00,188970,Staff,47,0,60,13
1683690045248,PSYC 7,A00,188973,Staff,35,0,45,10
1683690046271,PSYC 60,A01,188980,Rickard; Timothy C.,42,0,60,18
1683690047297,PSYC 70,A01,189001,Steiner; Eric Tomas,21,0,45,24
1683690048324,PSYC 100,A00,189005,Lacefield; Katharine I,0,99,120,120
1683690049350,PSYC 102,A00,189008,Staff,7,0,30,23
1683690050377,PSYC 106,B00,189026,Gorman; Michael R.,27,0,60,33
1683690051401,PSYC 114,B01,189033,Winkielman; Piotr,0,31,30,30
1683690052427,PSYC 131,A00,189036,Anagnostaras; Stephan,0,43,60,60
1683690053454,PSYC 136,A00,189041,Lowe; Angela Beth,0,7,25,25
1683690054481,PSYC 137,A00,189057,Winkielman; Piotr,1,37,25,24
1683690055508,PSYC 144,A00,189107,Wixted; John T,0,11,50,50
1683690057560,PSYC 162,A00,189142,Staff,0,9,85,85
1683690058583,PSYC 172,A00,189144,Gorman; Michael R.,0,6,30,30
1683690060630,PSYC 179,A00,189146,Lacefield; Katharine I,0,88,120,120
1683690061654,PSYC 181,A00,189147,Anagnostaras; Stephan,0,44,90,90
1683690062682,PSYC 190R,A00,189148,Barner; David A.,0,23,80,80
1683690063710,PSYC 191,A00,189275,Rickard; Timothy C.,0,11,25,25
1683690064733,PSYC 193,A00,189276,Chapman; Eddie Nathaniel,0,1,0,4
1683690065762,PSYC 193L,A01,189281,Lowe; Angela Beth,8,0,20,12
1683690065762,PSYC 193L,B01,189285,Staff,28,0,35,7
1683690066784,RELI 149,A00,187137,Rahimi; Babak,6,0,40,34
1683690067811,SE 9,A01,187315,Staff,0,2,18,18
1683690068835,SE 101B,A00,187409,Staff,24,0,30,6
1683690069862,SE 110B,A00,187444,Staff,10,0,40,30
1683690070886,SE 130B,A00,187449,Staff,31,0,40,9
1683690071912,SE 150A,A00,187516,Staff,8,0,20,12
1683690072938,SE 154,A00,187528,Staff,29,0,50,21
1683690073961,SIO 3,A01,258171,Staff,35,0,40,5
1683690074988,SIO 10,A00,187144,Cook; Geoffrey W,1,7,75,74
1683690076014,SIO 45,A00,187152,Cook; Geoffrey W,0,7,100,100
1683690077040,SIO 109R,A00,194486,Staff,0,4,20,20
1683690079094,SIO 187,A01,187233,Kacev; David,12,0,40,28
1683690080118,SOCI 1,A01,258656,Thorpe; Charles Robert,28,0,30,2
1683690080118,SOCI 1,A02,258658,Thorpe; Charles Robert,30,0,30,0
1683690080118,SOCI 1,A03,258661,Thorpe; Charles Robert,25,0,25,0
1683690080118,SOCI 1,A04,258666,Thorpe; Charles Robert,22,0,25,3
1683690080118,SOCI 1,A05,258897,Thorpe; Charles Robert,22,0,25,3
1683690080118,SOCI 1,A06,258898,Thorpe; Charles Robert,25,0,25,0
1683690081142,SOCI 30,A01,258903,Pardo Guerra; Juan Pablo,14,0,30,16
1683690082166,SOCI 102,A00,258904,Staff,9,0,25,16
1683690083193,SOCI 106,A00,258905,Staff,19,0,25,6
1683690084220,SOCI 111,A00,258907,Ribas Norris; Janet Vanesa,26,0,30,4
1683690085248,SOCI 121R,A00,258908,Pardo Guerra; Juan Pablo,8,0,30,22
1683690086273,SOCI 126,A01,203330,Staff,14,0,20,6
1683690087298,SOCI 131,A00,258909,Thorpe; Charles Robert,30,0,60,30
1683690088321,SOCI 135,A00,258910,Payne; Christine Anna,0,13,30,30
1683690089402,SOCI 157,A00,258911,Staff,11,0,30,19
1683690090431,SOCI 184,A00,258912,Staff,25,0,30,5
1683690091455,SOCI 188D,A00,258913,Staff,22,0,30,8
1683690092479,SYN 2,001,187529,Staff,9,0,16,7
1683690092479,SYN 2,002,201452,Staff,1,20,16,15
1683690092479,SYN 2,003,201469,Staff,1,0,16,15
1683690093503,SYN 100,A01,187531,Staff,0,9,20,20
1683690093503,SYN 100,B01,201491,Staff,0,10,20,20
1683690094529,TDAC 1,A00,189286,Walsh; Kim C.,3,0,20,17
1683690094529,TDAC 1,B00,189287,Harting; Carla Kelso,10,0,20,10
1683690095557,TDAC 101,A00,189300,Walsh; Kim C.,16,0,20,4
1683690095557,TDAC 101,B00,189301,Harting; Carla Kelso,18,0,20,2
1683690096585,TDAC 102,A00,189304,Basso; Beatrice,14,0,20,6
1683690097608,TDAC 108,A00,189305,Staff,18,0,20,2
1683690098635,TDDE 131,A00,189310,Staff,19,0,20,1
1683690098635,TDDE 131,B00,189314,Staff,19,0,20,1
1683690098635,TDDE 131,C00,189315,Staff,48,0,50,2
1683690098635,TDDE 131,D00,189316,Staff,14,0,15,1
1683690098635,TDDE 131,E00,204841,Staff,20,0,20,0
1683690099664,TDGE 10,A00,189289,Staff,27,0,50,23
1683690099664,TDGE 10,B00,189290,Havis; Allan,0,1,50,50
1683690100689,TDGE 11,A00,189291,Fulton; Julia,0,4,50,50
1683690100689,TDGE 11,B00,189292,Staff,20,0,25,5
1683690100689,TDGE 11,C00,260270,Staff,0,0,0,0
1683690101715,TDGE 25,A00,189294,Staff,1,0,20,19
1683690102739,TDGE 124,A00,189318,Fulton; Julia,1,8,50,49
1683690103762,TDGE 125,A00,189319,Staff,13,0,25,12
1683690103762,TDGE 125,B00,189320,Staff,23,0,25,2
1683690104790,TDGE 127,A00,189322,Havis; Allan,0,0,50,50
1683690105824,TDHT 101,A00,189323,Staff,18,0,25,7
1683690105824,TDHT 101,B00,189324,Staff,25,0,25,0
1683690106847,TDHT 102,A00,189325,Staff,49,0,50,1
1683690107871,TDMV 1,A00,189295,Arcidiacono; Kristin,20,0,30,10
1683690107871,TDMV 1,B00,189296,Caligagan; Maria T.,24,0,30,6
1683690108897,TDMV 2,A00,189297,Sammartano; Tonnie,27,0,30,3
1683690108897,TDMV 2,B00,189299,Arcidiacono; Kristin,23,0,30,7
1683690109922,TDMV 3,A00,204998,Rincon; Alicia,22,0,30,8
1683690110946,TDMV 120,A00,189458,Sammartano; Tonnie,28,0,30,2
1683690111971,TDMV 138,A00,189541,Jun; Grace Shin Hae,20,0,40,20
1683690112995,TDMV 142,A00,189717,Caligagan; Tony,25,0,30,5
1683690112995,TDMV 142,B00,189718,Caligagan; Maria T.,25,0,30,5
1683690114023,TMC 2,A01,187533,Staff,25,0,25,0
1683690114023,TMC 2,A02,187534,Staff,25,0,25,0
1683690115050,USP 1,A01,187536,Kwak; Nancy,0,16,25,25
1683690116076,USP 5,A01,187538,Staff,8,0,25,17
1683690117103,USP 101,A00,199253,Staff,0,4,0,0
1683690118127,USP 124,A00,187562,Boomhower; Matthew Charles,0,0,30,30
1683690119152,USP 138,A00,187582,Staff,19,0,25,6
1683690120176,USP 152,A01,187597,Staff,3,0,25,22
1683690121203,USP 153,A00,187598,Staff,18,0,25,7
1683690122228,USP 168,A00,187607,Kwak; Nancy,2,0,5,3
1683690123253,USP 173,A00,187619,Staff,4,0,25,21
1683690124277,USP 181,A00,187638,Staff,0,4,25,25
1683690125303,VIS 103,A00,187650,Cruz; Edwin Teddy,17,0,75,58
1683690126326,VIS 110D,A00,187669,Staff,13,0,22,9
1683690127349,VIS 127C,A00,187720,Shen; Kuiyi,67,0,146,79
1683690128372,VIS 149,A00,187731,Yoldas; Pinar,1,14,22,21
1683690129397,VIS 151,A01,188091,Staff,22,0,34,12
1683690129397,VIS 151,A02,188092,Staff,11,0,34,23
1683690130424,VIS 160B,A00,188093,Stalbaum; Brett,0,1,10,10
1683690132472,WCWP 10B,A00,201720,Staff,0,0,5,5
1683690132472,WCWP 10B,B00,201722,Staff,0,0,6,6
1683690133498,WCWP 100,A00,201725,Gagnon; Jeffrey C,0,0,2,2
1683690133498,WCWP 100,B00,201727,Staff,0,4,15,15
1683690136591,ANBI 133,A00,258401,Wilder; Linnea Lorene,34,0,40,6
1683690137615,ANBI 140,A00,258395,Hrvoj Mihic; Branka,18,0,25,7
1683690138640,ANSC 120,A00,258402,Bialecki; Jon Anthony,26,0,40,14
1683690139664,ANSC 144,A00,258400,Staff,12,0,40,28
1683690141711,ANSC 166,A00,258396,Parish; Steven Martin,156,0,175,19
1683690142735,ANSC 180,A00,193533,Staff,8,0,20,12
1683690143762,ANSC 188,A00,258397,Jassal; Aftab,34,0,40,6
1683690144787,ANTH 3,A01,258316,Staff,23,0,30,7
1683690145814,ANTH 5,A00,258394,Semendeferi; Ekaterini,16,0,20,4
1683690146841,ANTH 21,A01,258331,Staff,4,0,40,36
1683690147866,ANTH 103,A00,258398,Varma; Saiba,15,0,25,10
1683690148896,AWP 10,001,202034,Staff,0,0,0,0
1683690148896,AWP 10,002,202035,Staff,0,0,0,0
1683690148896,AWP 10,003,202036,Staff,0,0,0,0
1683690148896,AWP 10,004,202037,Staff,0,0,0,0
1683690148896,AWP 10,005,202038,Staff,0,0,0,0
1683690148896,AWP 10,006,202039,Staff,0,0,0,0
1683690148896,AWP 10,007,202040,Staff,0,0,0,0
1683690148896,AWP 10,008,202041,Staff,0,0,0,0
1683690148896,AWP 10,009,202042,Staff,0,0,0,0
1683690148896,AWP 10,010,202043,Staff,0,0,0,0
1683690148896,AWP 10,011,202044,Staff,0,0,0,0
1683690148896,AWP 10,012,202045,Staff,0,0,0,0
1683690148896,AWP 10,013,202046,Staff,0,0,0,0
1683690148896,AWP 10,014,202047,Staff,0,0,0,0
1683690148896,AWP 10,015,202048,Staff,0,0,0,0
1683690148896,AWP 10,016,202049,Staff,0,0,0,0
1683690148896,AWP 10,017,202050,Staff,0,0,0,0
1683690148896,AWP 10,018,202051,Staff,0,0,0,0
1683690148896,AWP 10,019,202052,Staff,0,0,0,0
1683690148896,AWP 10,020,202053,Staff,0,0,0,0
1683690148896,AWP 10,021,202054,Staff,0,0,0,0
1683690148896,AWP 10,022,202055,Staff,0,0,0,0
1683690148896,AWP 10,023,202056,Staff,0,0,0,0
1683690148896,AWP 10,024,202057,Staff,0,0,0,0
1683690148896,AWP 10,025,202058,Staff,0,0,0,0
1683690148896,AWP 10,026,202059,Staff,0,0,0,0
1683690149921,AWP 102,001,202032,Staff,0,0,0,0
1683690149921,AWP 102,002,202033,Staff,0,0,0,0
1683690150946,BENG 100,A01,254234,Taylor Amos; Alyssa C,31,0,40,9
1683690151973,BENG 196,001,270013,Engler; Adam J.,9999,0,9999,0
1683690152998,BICD 100R,A01,202018,Smith; Laurie,0,7,32,32
1683690152998,BICD 100R,A02,202019,Smith; Laurie,0,3,32,32
1683690152998,BICD 100R,A03,202020,Smith; Laurie,0,1,32,32
1683690152998,BICD 100R,A04,202021,Smith; Laurie,6,0,32,26
1683690152998,BICD 100R,A05,202022,Smith; Laurie,10,0,32,22
1683690154026,BICD 136,A01,193242,Gustafson-Brown; Cindy,0,2,32,32
1683690154026,BICD 136,A02,193244,Gustafson-Brown; Cindy,13,0,32,19
1683690155056,BIEB 102,A01,193249,Butler; Shannon Rhey,1,1,32,31
1683690155056,BIEB 102,A02,193251,Butler; Shannon Rhey,0,0,32,32
1683690155056,BIEB 102,A03,193253,Butler; Shannon Rhey,0,0,32,32
1683690155056,BIEB 102,A04,193255,Butler; Shannon Rhey,13,0,32,19
1683690155056,BIEB 102,A05,193265,Butler; Shannon Rhey,25,0,32,7
1683690155056,BIEB 102,A06,193269,Butler; Shannon Rhey,13,0,32,19
1683690157110,BIEB 150,A01,193274,Staff,0,0,32,32
1683690157110,BIEB 150,A02,193285,Staff,24,0,32,8
1683690158135,BIEB 194,A00,193286,Kurle; Carolyn M.,19,0,32,13
1683690159168,BILD 1,A01,192291,Staff,15,0,32,17
1683690159168,BILD 1,A02,192292,Staff,30,0,32,2
1683690159168,BILD 1,B01,192520,Reuther; Keefe,0,1,0,0
1683690159168,BILD 1,B02,192532,Reuther; Keefe,0,1,0,0
1683690160199,BILD 3,A01,192556,Butler; Shannon Rhey,0,0,32,32
1683690160199,BILD 3,A02,192581,Butler; Shannon Rhey,0,1,32,32
1683690160199,BILD 3,A03,192611,Butler; Shannon Rhey,19,0,32,13
1683690160199,BILD 3,A04,192612,Butler; Shannon Rhey,24,0,32,8
1683690160199,BILD 3,A05,192613,Butler; Shannon Rhey,26,0,32,6
1683690160199,BILD 3,A06,192679,Butler; Shannon Rhey,27,0,32,5
1683690160199,BILD 3,A07,192682,Butler; Shannon Rhey,20,0,32,12
1683690161224,BILD 4,A01,192836,Reuther; Keefe,1,0,24,23
1683690161224,BILD 4,A02,193044,Reuther; Keefe,4,0,24,20
1683690162249,BILD 10,A01,193142,Gustafson-Brown; Cindy,29,0,32,3
1683690162249,BILD 10,A02,193149,Gustafson-Brown; Cindy,31,0,32,1
1683690163272,BIMM 100,A01,193301,Staff,0,6,32,32
1683690163272,BIMM 100,A02,193312,Staff,0,7,32,32
1683690163272,BIMM 100,A03,193323,Staff,0,10,32,32
1683690164297,BIMM 101,A01,193329,McDonnell; Lisa Marie,1,4,24,23
1683690164297,BIMM 101,A02,193339,McDonnell; Lisa Marie,1,4,24,23
1683690164297,BIMM 101,B01,193354,McDonnell; Lisa Marie,0,4,24,24
1683690164297,BIMM 101,B02,193357,McDonnell; Lisa Marie,0,3,24,24
1683690165325,BIMM 110,A01,193377,Tat; John,0,11,32,32
1683690165325,BIMM 110,A02,193378,Tat; John,0,11,32,32
1683690166350,BIMM 120,A01,206116,Staff,0,0,32,32
1683690166350,BIMM 120,A02,206117,Staff,7,0,32,25
1683690166350,BIMM 120,A03,206121,Staff,21,0,32,11
1683690167375,BIPN 100,A01,193393,Park; Ji Young,0,15,32,32
1683690167375,BIPN 100,A02,193402,Park; Ji Young,0,14,32,32
1683690167375,BIPN 100,A03,193413,Park; Ji Young,0,14,32,32
1683690167375,BIPN 100,A04,193414,Park; Ji Young,0,13,32,32
1683690168401,BIPN 102,A01,193429,Staff,0,0,32,32
1683690168401,BIPN 102,A02,193438,Staff,18,0,32,14
1683690169428,BIPN 106,A01,193450,Reyes Gonzalez; Catalina,0,2,40,40
1683690170452,BIPN 134,A01,193465,Cooke; James Edward,0,0,32,32
1683690170452,BIPN 134,A02,193474,Cooke; James Edward,25,0,32,7
1683690170452,BIPN 134,A03,193485,Cooke; James Edward,29,0,32,3
1683690170452,BIPN 134,A04,193486,Cooke; James Edward,20,0,32,12
1683690170452,BIPN 134,A05,193491,Cooke; James Edward,31,0,32,1
1683690170452,BIPN 134,A06,193501,Cooke; James Edward,30,0,32,2
1683690170452,BIPN 134,A07,193510,Cooke; James Edward,29,0,32,3
1683690172506,BISP 194,A00,222522,Staff,14,0,32,18
1683690173533,CAT 124,A01,202407,Staff,19,0,25,6
1683690174557,CAT 125,A00,202408,Marchisotto; Jennifer Anne,2,0,20,18
1683690175581,CAT 125R,A00,202409,Smith; Lauryn Alissa,0,11,20,20
1683690175581,CAT 125R,B00,202410,Morales; Celeste Georgianna,0,11,20,20
1683690175581,CAT 125R,C00,202411,Irwin; Matthew Joseph,0,12,20,20
1683690176605,CENG 15,A01,204712,Yang; Kesong,0,1,0,0
1683690177632,CENG 114,A00,202070,Jahed Motlagh; Zeinab,5,0,20,15
1683690178659,CGS 105,A00,185477,Wesling; Megan E.,24,0,40,16
1683690179687,CGS 106,A00,185494,Staff,11,0,22,11
1683690180713,CGS 108,A00,185495,Staff,14,0,20,6
1683690181740,CGS 114,A00,185496,Staff,13,0,18,5
1683690182764,CGS 119,A00,185501,Staff,15,0,20,5
1683690183788,CGS 120,A00,185511,Staff,12,0,20,8
1683690184812,CHEM 4,A01,184675,Bussey; Thomas J,97,0,100,3
1683690185836,CHEM 6A,A01,184677,Staff,32,0,60,28
1683690186859,CHEM 6B,A01,184679,Staff,63,0,100,37
1683690187884,CHEM 6C,A01,184681,Bussey; Thomas J,0,0,50,50
1683690187884,CHEM 6C,A02,184682,Bussey; Thomas J,32,0,50,18
1683690188909,CHEM 40A,A01,184684,Albizati; Kim F.,33,0,100,67
1683690189935,CHEM 40B,A01,184686,Albizati; Kim F.,0,22,100,100
1683690190960,CHEM 41B,A01,184690,Staff,51,0,100,49
1683690191984,COGS 3,A01,184715,Boyle; Mary E. T.,0,27,40,40
1683690193068,COGS 14B,A01,185172,Staff,0,14,38,38
1683690194092,COGS 18,A01,184736,Staff,14,0,80,66
1683690195120,COGS 100,A01,184932,Staff,0,8,73,73
1683690196143,COGS 101A,A01,184935,Staff,0,40,30,30
1683690197167,COGS 101B,A01,184944,Staff,0,2,30,30
1683690198194,COGS 101C,A01,184946,Staff,0,10,30,30
1683690199219,COGS 102A,A01,184951,Johnson; Christine M.,1,0,40,39
1683690200244,COGS 107B,A01,184953,Mooshagian; Eric Frederick,0,52,40,40
1683690201274,COGS 118B,A01,184959,Gupta; Anjum,0,50,40,40
1683690202303,COGS 153,A00,184961,Staff,0,16,30,30
1683690203326,COGS 177,A00,184962,Staff,1,21,30,29
1683690204350,COGS 187A,A01,184969,Boyle; Mary E. T.,0,19,40,40
1683690205378,COMM 10,A01,185174,Staff,0,5,25,25
1683690205378,COMM 10,A02,185189,Staff,0,2,25,25
1683690205378,COMM 10,A03,269821,Staff,0,1,0,0
1683690206402,COMM 100B,A02,185476,Staff,10,0,25,15
1683690206402,COMM 100B,A03,277340,Staff,25,0,25,0
1683690207427,COMM 100C,A01,185314,Staff,1,0,25,24
1683690207427,COMM 100C,A02,185327,Staff,17,0,25,8
1683690208451,COMM 110M,A00,185349,Staff,0,0,40,40
1683690209478,COMM 113T,A00,185352,Staff,25,0,40,15
1683690210506,COMM 114I,A00,185353,Staff,31,0,40,9
1683690211530,COMM 131,A00,185354,Staff,17,0,30,13
1683690212553,CSE 8A,A50,185358,Cao; Yingjun,0,46,10,10
1683690213584,CSE 8B,A01,185362,Staff,0,48,50,50
1683690214613,CSE 11,A01,185416,Cao; Yingjun,0,91,10,10
1683690215638,CSE 20,A01,185445,Briones; Jor-el Thomas Caparas,3,0,25,22
1683690216665,CSE 21,A01,185447,Staff,9,0,50,41
1683690217693,CSE 101,A01,185451,Staff,0,13,50,50
1683690217693,CSE 101,B01,185453,Jones; Miles E,0,14,50,50
1683690219748,CSE 141,A01,185458,Eldon; John,16,0,100,84
1683690220772,CSE 141L,A01,185461,Eldon; John,8,0,100,92
1683690221798,CSE 142,A01,185463,Staff,34,0,60,26
1683690221798,CSE 142,B01,201355,Staff,0,7,60,60
1683690222825,CSE 142L,A01,185470,Staff,34,0,60,26
1683690222825,CSE 142L,B01,201417,Staff,0,6,60,60
1683690223847,CSE 190,A00,201433,Staff,32,0,49,17
1683690224874,DOC 1,A01,259136,Strom; Megan C.,7,0,15,8
1683690224874,DOC 1,A02,259137,Strom; Megan C.,14,0,15,1
1683690224874,DOC 1,A03,259138,Strom; Megan C.,14,0,15,1
1683690224874,DOC 1,A04,259139,Strom; Megan C.,14,0,15,1
1683690225900,DOC 100D,A00,259140,Pass; Natalye Joann,14,0,25,11
1683690226924,DSGN 1,A01,184749,Rill; Bryan,0,26,30,30
1683690227950,DSGN 100,A01,185168,Staff,0,2,25,25
1683690228978,ECE 5,A01,185626,Morris; Karcher William,0,12,0,0
1683690230003,ECE 101,A01,185628,Staff,14,0,70,56
1683690231026,ECE 107,A01,185635,Baghdadchi; Saharnaz,0,0,20,20
1683690231026,ECE 107,A02,185638,Baghdadchi; Saharnaz,1,0,20,19
1683690232054,ECE 148,A01,185647,Silberman; Jack,0,0,16,16
1683690233079,ECON 1,A01,185537,Crane; Meredith Helen,54,0,70,16
1683690234107,ECON 3,A01,185549,Crane; Meredith Helen,30,0,70,40
1683690235133,ECON 4,A01,203354,Anderson; John Charles,0,5,10,10
1683690236158,ECON 100A,A01,185574,Staff,0,5,40,40
1683690237183,ECON 100B,A01,185576,Staff,0,12,50,50
1683690238209,ECON 100C,A01,185589,Newhouse; Herbert S,30,0,70,40
1683690239233,ECON 105,A00,185608,Vespa; Emanuel Ignacio,19,0,35,16
1683690240258,ECON 109,A01,185610,Shishkin; Denis,9,0,35,26
1683690241280,ECON 110A,A01,185612,Staff,8,0,40,32
1683690242305,ECON 120A,A01,185615,Staff,19,0,40,21
1683690243329,ECON 120C,A01,185617,Sun; Yixiao,0,21,70,70
1683690244354,ECON 144,A00,203346,Squires; Dale E,2,0,35,33
1683690245379,ECON 171,A01,203349,Newhouse; Herbert S,0,1,35,35
1683690246408,ECON 173A,A01,185621,Toda; Alexis Akira,21,0,35,14
1683690247433,EDS 25,A01,202413,Staff,0,1,0,0
1683690247433,EDS 25,A02,202414,Staff,0,1,0,0
1683690247433,EDS 25,A03,202415,Staff,0,0,0,0
1683690247433,EDS 25,A04,202416,Staff,0,1,0,0
1683690247433,EDS 25,A05,202439,Staff,0,0,0,0
1683690247433,EDS 25,A06,202440,Staff,0,0,0,0
1683690247433,EDS 25,B01,202631,Staff,0,0,0,0
1683690247433,EDS 25,B02,202632,Staff,0,0,0,0
1683690247433,EDS 25,B03,202639,Staff,0,0,0,0
1683690247433,EDS 25,B04,202640,Staff,0,0,0,0
1683690247433,EDS 25,B05,202643,Staff,0,0,0,0
1683690247433,EDS 25,B06,202644,Staff,0,0,0,0
1683690248457,EDS 38,A01,202659,Black; Alison Michelle,24,0,25,1
1683690249482,EDS 115,A00,202652,Staff,18,0,30,12
1683690250507,EDS 125,A00,202649,Staff,13,0,30,17
1683690251534,EDS 126,A01,203332,Staff,30,0,30,0
1683690252562,EDS 139,A00,202838,Staff,16,0,25,9
1683690253586,EDS 146,A01,202655,Staff,14,0,25,11
1683690254609,ENG 15,A00,185667,Staff,0,1,0,0
1683690254609,ENG 15,B00,185672,Staff,0,0,0,0
1683690254609,ENG 15,C00,185675,Staff,0,0,0,0
1683690254609,ENG 15,D00,185682,Staff,0,0,0,0
1683690254609,ENG 15,E00,185684,Staff,0,0,0,0
1683690255633,ETHN 103,A00,185710,Staff,0,8,35,35
1683690256661,ETHN 103A,A00,199228,Man; Simeon S,0,0,9,9
1683690257686,ETHN 109,A00,185711,Staff,15,0,35,20
1683690258711,ETHN 142,A00,185726,Staff,0,4,30,30
1683690259734,ETHN 163J,A00,199229,Man; Simeon S,5,0,8,3
1683690260758,ETHN 168,A00,185727,Staff,7,0,10,3
1683690261782,ETHN 182,A00,185728,Staff,0,0,35,35
1683690262805,ETHN 183,A00,185737,Staff,9,0,18,9
1683690263831,GLBH 111,A01,209361,Burgos; Jose L.,0,0,0,0
1683690265878,HIEU 104,A00,185792,Staff,14,0,20,6
1683690266902,HIEU 115,A00,185800,Staff,0,0,20,20
1683690267924,HIEU 128,A00,185801,Staff,0,9,20,20
1683690268948,HIEU 147,A00,185802,Staff,15,0,20,5
1683690269972,HIEU 154,A00,185823,Staff,11,0,20,9
1683690270997,HILA 102,A00,185826,Staff,14,0,20,6
1683690272020,HILD 2C,A01,185778,Staff,0,13,20,20
1683690273044,HILD 7B,A01,185780,Kwak; Nancy,0,17,32,32
1683690273044,HILD 7B,A02,185781,Kwak; Nancy,0,18,32,32
1683690274069,HILD 30,A01,185791,Staff,12,0,20,8
1683690275091,HISC 119,A00,185830,Golan; Tal,0,11,20,20
1683690276115,HITO 156GS,A00,185831,Patterson; Patrick H.,0,0,0,23
1683690277140,HIUS 103,A00,185832,Man; Simeon S,0,4,20,20
1683690278163,HIUS 117,A00,185836,Kwak; Nancy,2,0,20,18
1683690279190,HIUS 125,A00,185840,Man; Simeon S,0,3,23,23
1683690280216,HIUS 149,A00,185845,Staff,1,0,20,19
1683690281240,HUM 3,A01,185882,Zavodny; Tatiana Sophia,0,8,50,50
1683690281240,HUM 3,B01,185899,Caldwell; Michael Alan,0,18,50,50
1683690282268,HUM 3GS,A00,185900,Patterson; Patrick H.,0,0,0,23
1683690283293,HUM 4,A01,185938,Zroka; Amy Liane,28,0,50,22
1683690283293,HUM 4,B01,185956,Watkins; Eric,0,6,50,50
1683690283293,HUM 4,B02,202209,Watkins; Eric,0,5,50,50
1683690283293,HUM 4,B03,202210,Watkins; Eric,0,5,50,50
1683690284321,HUM 5,A01,185958,West; Geoffrey Scott,0,0,50,50
1683690284321,HUM 5,A02,202215,West; Geoffrey Scott,0,1,50,50
1683690285345,INTL 190,A00,185959,Gagnon; Jeffrey C,0,0,0,9
1683690285345,INTL 190,B00,185960,Lettieri; Michael Joseph,0,0,0,2
1683690286371,JAPN 180,A00,254509,Staff,5,0,30,25
1683690287395,LATI 10,A01,202853,Kennemore; Amy Michelle,4,0,35,31
1683690287395,LATI 10,A02,202854,Kennemore; Amy Michelle,3,0,35,32
1683690287395,LATI 10,A03,270054,Kennemore; Amy Michelle,30,0,30,0
1683690288423,LATI 180,A00,202855,Kennemore; Amy Michelle,11,0,20,9
1683690289450,LAWS 101,A00,201767,Golan; Tal,0,7,40,40
1683690290476,LIFR 1C,A00,185961,Staff,6,0,20,14
1683690291499,LIFR 1CX,A00,185962,Staff,7,0,20,13
1683690292525,LIFR 1D,A00,185963,Staff,7,0,20,13
1683690293549,LIFR 1DX,A00,185964,Staff,7,0,20,13
1683690294573,LIGN 101,A01,186039,Staff,43,0,50,7
1683690295596,LIGN 165,A00,186040,Staff,15,0,50,35
1683690296675,LTCS 108,A00,186041,Staff,5,0,10,5
1683690297699,LTCS 119,A00,186042,Staff,15,0,20,5
1683690298723,LTCS 130,A00,186043,Wesling; Megan E.,15,0,25,10
1683690300770,LTEA 138,A00,186119,Staff,14,0,40,26
1683690301794,LTEN 124,A00,186148,Staff,5,0,25,20
1683690302819,LTEN 178,A00,186149,Staff,6,0,15,9
1683690303843,LTEN 181,A00,186150,Blanco; John D,34,0,40,6
1683690304866,LTWL 120,A00,186160,Staff,19,0,25,6
1683690305893,LTWL 165,A00,186161,Staff,22,0,25,3
1683690306916,LTWR 100,A00,186162,Staff,0,5,15,15
1683690307944,LTWR 102,A00,186163,Doller; Ben,5,0,15,10
1683690308968,MAE 8,A01,186412,Staff,0,1,0,0
1683690309996,MAE 30B,A00,186445,Bahadori; Mohammad Yousef,81,0,100,19
1683690311024,MAE 40,A00,186592,Bewley; Thomas R,10,0,50,40
1683690312051,MAE 101B,A00,186593,Bahadori; Mohammad Yousef,80,0,100,20
1683690313077,MAE 105,A00,186594,Bandaru; Prabhakar,10,0,50,40
1683690314103,MAE 107,A00,186599,Pham; Hieu Tan,0,7,120,120
1683690315126,MAE 148,A01,186660,Silberman; Jack,3,0,16,13
1683690316149,MATH 10A,A01,188095,Staff,0,6,35,35
1683690317173,MATH 10B,A01,188097,Bowers; Adam R.,0,12,30,30
1683690317173,MATH 10B,A02,188099,Bowers; Adam R.,0,11,30,30
1683690317173,MATH 10B,B01,188104,Bowers; Adam R.,0,10,30,30
1683690317173,MATH 10B,B02,188106,Bowers; Adam R.,1,9,30,29
1683690318201,MATH 10C,A01,188111,Staff,0,20,30,30
1683690318201,MATH 10C,A02,188127,Staff,0,19,30,30
1683690318201,MATH 10C,A03,188131,Staff,0,19,30,30
1683690318201,MATH 10C,B01,188218,Staff,17,0,30,13
1683690318201,MATH 10C,B02,188244,Staff,13,0,30,17
1683690318201,MATH 10C,B03,188277,Staff,14,0,30,16
1683690319224,MATH 18,A01,188344,Bach; Quang Tran,18,0,30,12
1683690319224,MATH 18,A02,188345,Bach; Quang Tran,11,0,30,19
1683690319224,MATH 18,B01,188353,Bach; Quang Tran,11,0,30,19
1683690319224,MATH 18,B02,188354,Bach; Quang Tran,19,0,30,11
1683690320251,MATH 20A,A01,188374,Staff,11,0,35,24
1683690321276,MATH 20B,A01,188382,Ohm; Ko Woon,7,0,30,23
1683690321276,MATH 20B,A02,188383,Ohm; Ko Woon,22,0,30,8
1683690321276,MATH 20B,B01,188385,Ohm; Ko Woon,7,0,30,23
1683690321276,MATH 20B,B02,188392,Ohm; Ko Woon,22,0,30,8
1683690322303,MATH 20C,A01,188394,Harel; Guershon,10,0,30,20
1683690322303,MATH 20C,A02,188395,Harel; Guershon,13,0,30,17
1683690322303,MATH 20C,B01,188404,Harel; Guershon,5,0,30,25
1683690322303,MATH 20C,B02,188405,Harel; Guershon,18,0,30,12
1683690323331,MATH 20D,A01,188414,Hammock; Frances H,0,1,30,30
1683690323331,MATH 20D,A02,188415,Hammock; Frances H,0,1,30,30
1683690323331,MATH 20D,B01,188447,Hammock; Frances H,0,1,30,30
1683690323331,MATH 20D,B02,188486,Hammock; Frances H,2,0,30,28
1683690324370,MATH 20E,A01,188649,Staff,21,0,30,9
1683690324370,MATH 20E,A02,188650,Staff,20,0,30,10
1683690324370,MATH 20E,A03,188673,Staff,0,0,30,30
1683690325393,MATH 102,A01,188675,Staff,0,40,35,35
1683690326420,MATH 103B,A01,188681,Staff,3,0,35,32
1683690326420,MATH 103B,B01,188692,Staff,5,0,35,30
1683690327448,MATH 109,A01,188695,Salehi Golsefidy; Alireza,24,0,35,11
1683690327448,MATH 109,A02,188696,Salehi Golsefidy; Alireza,25,0,35,10
1683690328472,MATH 120A,A01,188698,Eggers; John Dietrich,7,0,35,28
1683690329497,MATH 142B,A01,188736,Ioana; Adrian,1,1,30,29
1683690329497,MATH 142B,A02,188741,Ioana; Adrian,0,1,30,30
1683690329497,MATH 142B,A03,188743,Ioana; Adrian,0,2,30,30
1683690330521,MATH 168A,A01,188790,Staff,0,11,35,35
1683690331550,MATH 170A,A01,188803,Nie; Jiawang,0,2,35,35
1683690331550,MATH 170A,A02,188811,Nie; Jiawang,0,1,35,35
1683690331550,MATH 170A,A03,188814,Nie; Jiawang,0,0,35,35
1683690331550,MATH 170A,A04,188815,Nie; Jiawang,5,0,35,30
1683690332575,MATH 193B,A01,188817,Staff,0,0,35,35
1683690332575,MATH 193B,A02,188818,Staff,6,0,35,29
1683690333599,MGT 4,A01,202857,Anderson; John Charles,59,0,80,21
1683690334623,MGT 12,A00,202858,Lindenberger; Wade Douglas,40,0,90,50
1683690335647,MGT 18,A00,202859,Staff,74,0,90,16
1683690336671,MGT 18GS,A00,202860,McKay; Michael J,13,0,28,15
1683690337699,MGT 45,A00,202861,Pecore; Joseph P.,8,0,90,82
1683690338723,MGT 100,A00,202863,Yavorsky; Daniel Ryan,27,0,90,63
1683690339748,MGT 103,A00,202864,Ehrich; Kristine R,0,19,90,90
1683690340771,MGT 112,A00,202865,Ehrich; Kristine R,15,0,90,75
1683690341795,MGT 121A,A00,202868,Staff,90,20,90,0
1683690342819,MGT 131B,A00,202869,Anderson; John Charles,58,0,90,32
1683690343844,MGT 136,A00,202871,Lindenberger; Wade Douglas,83,0,90,7
1683690344867,MGT 164,A00,202873,Staff,0,67,90,91
1683690345894,MGT 164GS,A00,202874,McKay; Mary A,13,0,28,15
1683690346918,MGT 180,A00,202875,Staff,0,51,90,91
1683690347941,MMW 11R,A01,205019,Herbst; Matthew,0,0,30,30
1683690347941,MMW 11R,A02,205026,Herbst; Matthew,29,0,30,1
1683690348965,MMW 15,A01,193512,Chang; Edmond Yi-Teh,0,8,28,28
1683690348965,MMW 15,A02,193513,Chang; Edmond Yi-Teh,0,5,28,28
1683690348965,MMW 15,A03,193514,Chang; Edmond Yi-Teh,0,5,28,28
1683690348965,MMW 15,A04,193515,Chang; Edmond Yi-Teh,0,5,28,28
1683690348965,MMW 15,A05,193516,Chang; Edmond Yi-Teh,0,5,28,28
1683690348965,MMW 15,A06,193517,Chang; Edmond Yi-Teh,0,6,28,28
1683690348965,MMW 15,B01,193519,Chang; Edmond Yi-Teh,0,5,28,28
1683690348965,MMW 15,B02,193520,Chang; Edmond Yi-Teh,0,5,28,28
1683690348965,MMW 15,B03,193521,Chang; Edmond Yi-Teh,0,5,28,28
1683690348965,MMW 15,B04,193522,Chang; Edmond Yi-Teh,0,6,28,28
1683690348965,MMW 15,B05,193523,Chang; Edmond Yi-Teh,0,5,28,28
1683690348965,MMW 15,B06,193524,Chang; Edmond Yi-Teh,0,5,28,28
1683690349990,MMW 122,A01,193526,Rahimi; Babak,0,16,28,28
1683690349990,MMW 122,A02,193527,Rahimi; Babak,0,15,28,28
1683690349990,MMW 122,A03,193528,Rahimi; Babak,0,0,0,0
1683690349990,MMW 122,A04,193529,Rahimi; Babak,0,0,0,0
1683690351014,MUS 1A,A01,186663,Staff,1,19,35,34
1683690352039,MUS 4,A01,186715,Staff,0,12,35,35
1683690353062,MUS 5R,A01,186796,Dubnov; Shlomo,0,17,35,35
1683690354085,MUS 6,A01,186798,Staff,1,5,25,24
1683690355113,MUS 7,A01,186830,Staff,11,0,35,24
1683690356136,MUS 8,A01,186930,Staff,0,27,35,35
1683690357162,MUS 15,A01,186932,Staff,0,15,35,35
1683690357162,MUS 15,B01,186934,Staff,1,17,35,34
1683690358189,MUS 80,A00,186935,Staff,0,0,20,20
1683690358189,MUS 80,B00,186936,Staff,24,0,25,1
1683690359217,NANO 11,A00,204702,Lipomi; Darren John,0,0,0,0
1683690360245,NANO 15,A01,204709,Yang; Kesong,0,1,0,0
1683690361273,NANO 114,A00,202069,Jahed Motlagh; Zeinab,2,0,10,8
1683690362298,PHIL 1,A00,186955,Grush; Rick Scott,31,0,40,9
1683690363323,PHIL 10,A01,186973,Grush; Rick Scott,27,0,35,8
1683690363323,PHIL 10,A02,186974,Grush; Rick Scott,33,0,35,2
1683690364347,PHIL 13,A01,186976,Staff,1,0,35,34
1683690364347,PHIL 13,A02,186977,Staff,16,0,35,19
1683690365375,PHIL 14,A01,186979,Staff,31,0,35,4
1683690365375,PHIL 14,A02,186986,Staff,32,0,35,3
1683690366403,PHIL 28,A01,186988,Staff,16,0,30,14
1683690366403,PHIL 28,A02,186989,Staff,1,0,30,29
1683690366403,PHIL 28,A03,186990,Staff,10,0,30,20
1683690366403,PHIL 28,A04,186991,Staff,26,0,30,4
1683690367426,PHIL 120,A00,186997,Staff,23,0,40,17
1683690368453,PHIL 137,A00,187003,Staff,7,0,40,33
1683690369477,PHIL 150,A00,187015,Staff,47,0,70,23
1683690370504,PHIL 167,A00,187021,Lamey; Andy M.,34,0,40,6
1683690371531,PHIL 174,A01,202226,Staff,17,0,20,3
1683690371531,PHIL 174,A02,202235,Staff,20,0,20,0
1683690372559,PHIL 191A,A00,258918,Staff,0,0,1,1
1683690373584,PHYS 1A,A00,187028,Staff,26,0,60,34
1683690374609,PHYS 1AL,001,187036,Staff,3,0,30,27
1683690374609,PHYS 1AL,002,187049,Staff,18,0,30,12
1683690375632,PHYS 1B,A00,187058,Staff,22,0,60,38
1683690376656,PHYS 1BL,001,187064,Staff,0,1,30,30
1683690376656,PHYS 1BL,002,187070,Staff,4,0,30,26
1683690377681,PHYS 1C,A00,187082,Staff,29,0,120,91
1683690378707,PHYS 1CL,001,187088,Staff,0,9,30,30
1683690378707,PHYS 1CL,002,187089,Staff,0,1,30,30
1683690378707,PHYS 1CL,009,262693,Staff,9,0,30,21
1683690379732,PHYS 2B,A01,187097,Staff,55,0,115,60
1683690380758,PHYS 2C,A01,187099,Staff,63,0,115,52
1683690381785,PHYS 2CL,A01,187101,Staff,5,0,28,23
1683690381785,PHYS 2CL,A02,187102,Staff,15,0,28,13
1683690382809,PHYS 2D,A01,187123,Shotwell; Brian,95,0,115,20
1683690383837,PHYS 4B,A01,187133,Grinstein; Benjamin,35,0,50,15
1683690384862,POLI 10,A00,188819,Staff,0,4,50,50
1683690385887,POLI 11,A00,188827,Staff,43,0,50,7
1683690386915,POLI 13R,A00,188828,Staff,0,1,20,20
1683690387939,POLI 27,A01,188830,Elgin; Samuel Zincke,0,2,70,70
1683690388961,POLI 30,A00,188832,Desposato; Scott,30,0,50,20
1683690389984,POLI 102F,A00,188834,Staff,1,0,40,39
1683690391010,POLI 104A,A00,188852,Staff,12,0,30,18
1683690392034,POLI 104I,A00,188853,Staff,0,8,20,20
1683690393057,POLI 110B,A00,188854,Wiens; David,6,0,20,14
1683690394080,POLI 112A,A00,188855,Wiens; David,3,0,30,27
1683690395107,POLI 117R,A00,188856,Forman; Fonna,0,12,20,20
1683690396133,POLI 118,A00,188857,Ingham; Sean,8,0,20,12
1683690397157,POLI 120G,A00,188858,Staff,8,0,30,22
1683690398180,POLI 131CR,A00,188863,Hoston; Germaine,20,0,50,30
1683690399206,POLI 133,A00,188864,Nellis; Gareth Hb,44,0,50,6
1683690400287,POLI 134D,A00,188865,Desposato; Scott,27,0,30,3
1683690401311,POLI 142A,A00,188871,Gartzke; Erik,21,0,50,29
1683690402335,POLI 142K,A00,188874,Staff,38,0,50,12
1683690403362,POLI 143,A00,188940,Gartzke; Erik,16,0,30,14
1683690404388,POLI 153,A00,188943,Staff,2,0,20,18
1683690405413,POLI 160AA,A00,188944,Staff,10,0,40,30
1683690406439,POLI 170A,A00,188945,Staff,10,0,30,20
1683690408496,PSYC 1,A00,188952,Staff,36,0,90,54
1683690409521,PSYC 2,B00,188953,Staff,19,0,35,16
1683690410546,PSYC 6,A00,188970,Staff,47,0,60,13
1683690411570,PSYC 7,A00,188973,Staff,35,0,45,10
1683690412593,PSYC 60,A01,188980,Rickard; Timothy C.,42,0,60,18
1683690413616,PSYC 70,A01,189001,Steiner; Eric Tomas,21,0,45,24
1683690414640,PSYC 100,A00,189005,Lacefield; Katharine I,0,99,120,120
1683690415668,PSYC 102,A00,189008,Staff,7,0,30,23
1683690416692,PSYC 106,B00,189026,Gorman; Michael R.,27,0,60,33
1683690417717,PSYC 114,B01,189033,Winkielman; Piotr,0,31,30,30
1683690418742,PSYC 131,A00,189036,Anagnostaras; Stephan,0,43,60,60
1683690419766,PSYC 136,A00,189041,Lowe; Angela Beth,0,7,25,25
1683690420791,PSYC 137,A00,189057,Winkielman; Piotr,1,37,25,24
1683690421816,PSYC 144,A00,189107,Wixted; John T,0,11,50,50
1683690423864,PSYC 162,A00,189142,Staff,0,9,85,85
1683690424889,PSYC 172,A00,189144,Gorman; Michael R.,0,6,30,30
1683690426939,PSYC 179,A00,189146,Lacefield; Katharine I,0,88,120,120
1683690427964,PSYC 181,A00,189147,Anagnostaras; Stephan,0,44,90,90
1683690428992,PSYC 190R,A00,189148,Barner; David A.,0,23,80,80
1683690430020,PSYC 191,A00,189275,Rickard; Timothy C.,0,11,25,25
1683690431044,PSYC 193,A00,189276,Chapman; Eddie Nathaniel,0,1,0,4
1683690432069,PSYC 193L,A01,189281,Lowe; Angela Beth,8,0,20,12
1683690432069,PSYC 193L,B01,189285,Staff,28,0,35,7
1683690433092,RELI 149,A00,187137,Rahimi; Babak,6,0,40,34
1683690434116,SE 9,A01,187315,Staff,0,2,18,18
1683690435139,SE 101B,A00,187409,Staff,24,0,30,6
1683690436166,SE 110B,A00,187444,Staff,10,0,40,30
1683690437190,SE 130B,A00,187449,Staff,31,0,40,9
1683690438214,SE 150A,A00,187516,Staff,8,0,20,12
1683690439253,SE 154,A00,187528,Staff,29,0,50,21
1683690440279,SIO 3,A01,258171,Staff,35,0,40,5
1683690441308,SIO 10,A00,187144,Cook; Geoffrey W,1,7,75,74
1683690442335,SIO 45,A00,187152,Cook; Geoffrey W,0,7,100,100
1683690443359,SIO 109R,A00,194486,Staff,0,4,20,20
1683690445409,SIO 187,A01,187233,Kacev; David,12,0,40,28
1683690446434,SOCI 1,A01,258656,Thorpe; Charles Robert,28,0,30,2
1683690446434,SOCI 1,A02,258658,Thorpe; Charles Robert,30,0,30,0
1683690446434,SOCI 1,A03,258661,Thorpe; Charles Robert,25,0,25,0
1683690446434,SOCI 1,A04,258666,Thorpe; Charles Robert,22,0,25,3
1683690446434,SOCI 1,A05,258897,Thorpe; Charles Robert,22,0,25,3
1683690446434,SOCI 1,A06,258898,Thorpe; Charles Robert,25,0,25,0
1683690447457,SOCI 30,A01,258903,Pardo Guerra; Juan Pablo,14,0,30,16
1683690448484,SOCI 102,A00,258904,Staff,9,0,25,16
1683690449509,SOCI 106,A00,258905,Staff,19,0,25,6
1683690450533,SOCI 111,A00,258907,Ribas Norris; Janet Vanesa,26,0,30,4
1683690451559,SOCI 121R,A00,258908,Pardo Guerra; Juan Pablo,8,0,30,22
1683690452583,SOCI 126,A01,203330,Staff,14,0,20,6
1683690453607,SOCI 131,A00,258909,Thorpe; Charles Robert,30,0,60,30
1683690454635,SOCI 135,A00,258910,Payne; Christine Anna,0,13,30,30
1683690455663,SOCI 157,A00,258911,Staff,11,0,30,19
1683690456690,SOCI 184,A00,258912,Staff,25,0,30,5
1683690457717,SOCI 188D,A00,258913,Staff,22,0,30,8
1683690458740,SYN 2,001,187529,Staff,9,0,16,7
1683690458740,SYN 2,002,201452,Staff,1,20,16,15
1683690458740,SYN 2,003,201469,Staff,1,0,16,15
1683690459764,SYN 100,A01,187531,Staff,0,9,20,20
1683690459764,SYN 100,B01,201491,Staff,0,10,20,20
1683690460793,TDAC 1,A00,189286,Walsh; Kim C.,3,0,20,17
1683690460793,TDAC 1,B00,189287,Harting; Carla Kelso,10,0,20,10
1683690461819,TDAC 101,A00,189300,Walsh; Kim C.,16,0,20,4
1683690461819,TDAC 101,B00,189301,Harting; Carla Kelso,18,0,20,2
1683690462843,TDAC 102,A00,189304,Basso; Beatrice,14,0,20,6
1683690463872,TDAC 108,A00,189305,Staff,18,0,20,2
1683690464898,TDDE 131,A00,189310,Staff,19,0,20,1
1683690464898,TDDE 131,B00,189314,Staff,19,0,20,1
1683690464898,TDDE 131,C00,189315,Staff,48,0,50,2
1683690464898,TDDE 131,D00,189316,Staff,14,0,15,1
1683690464898,TDDE 131,E00,204841,Staff,20,0,20,0
1683690465926,TDGE 10,A00,189289,Staff,27,0,50,23
1683690465926,TDGE 10,B00,189290,Havis; Allan,0,1,50,50
1683690466952,TDGE 11,A00,189291,Fulton; Julia,0,4,50,50
1683690466952,TDGE 11,B00,189292,Staff,20,0,25,5
1683690466952,TDGE 11,C00,260270,Staff,0,0,0,0
1683690467978,TDGE 25,A00,189294,Staff,1,0,20,19
1683690469002,TDGE 124,A00,189318,Fulton; Julia,1,8,50,49
1683690470027,TDGE 125,A00,189319,Staff,13,0,25,12
1683690470027,TDGE 125,B00,189320,Staff,23,0,25,2
1683690471055,TDGE 127,A00,189322,Havis; Allan,0,0,50,50
1683690472081,TDHT 101,A00,189323,Staff,18,0,25,7
1683690472081,TDHT 101,B00,189324,Staff,25,0,25,0
1683690473105,TDHT 102,A00,189325,Staff,49,0,50,1
1683690474131,TDMV 1,A00,189295,Arcidiacono; Kristin,20,0,30,10
1683690474131,TDMV 1,B00,189296,Caligagan; Maria T.,24,0,30,6
1683690475154,TDMV 2,A00,189297,Sammartano; Tonnie,27,0,30,3
1683690475154,TDMV 2,B00,189299,Arcidiacono; Kristin,23,0,30,7
1683690476182,TDMV 3,A00,204998,Rincon; Alicia,22,0,30,8
1683690477207,TDMV 120,A00,189458,Sammartano; Tonnie,28,0,30,2
1683690478231,TDMV 138,A00,189541,Jun; Grace Shin Hae,20,0,40,20
1683690479260,TDMV 142,A00,189717,Caligagan; Tony,25,0,30,5
1683690479260,TDMV 142,B00,189718,Caligagan; Maria T.,25,0,30,5
1683690480287,TMC 2,A01,187533,Staff,25,0,25,0
1683690480287,TMC 2,A02,187534,Staff,25,0,25,0
1683690481310,USP 1,A01,187536,Kwak; Nancy,0,16,25,25
1683690482339,USP 5,A01,187538,Staff,8,0,25,17
1683690483363,USP 101,A00,199253,Staff,0,4,0,0
1683690484386,USP 124,A00,187562,Boomhower; Matthew Charles,0,0,30,30
1683690485418,USP 138,A00,187582,Staff,19,0,25,6
1683690486444,USP 152,A01,187597,Staff,3,0,25,22
1683690487469,USP 153,A00,187598,Staff,18,0,25,7
1683690488498,USP 168,A00,187607,Kwak; Nancy,2,0,5,3
1683690489526,USP 173,A00,187619,Staff,4,0,25,21
1683690490550,USP 181,A00,187638,Staff,0,4,25,25
1683690491572,VIS 103,A00,187650,Cruz; Edwin Teddy,17,0,75,58
1683690492597,VIS 110D,A00,187669,Staff,13,0,22,9
1683690493624,VIS 127C,A00,187720,Shen; Kuiyi,67,0,146,79
1683690494650,VIS 149,A00,187731,Yoldas; Pinar,1,14,22,21
1683690495679,VIS 151,A01,188091,Staff,22,0,34,12
1683690495679,VIS 151,A02,188092,Staff,11,0,34,23
1683690496706,VIS 160B,A00,188093,Stalbaum; Brett,0,1,10,10
1683690498753,WCWP 10B,A00,201720,Staff,0,0,5,5
1683690498753,WCWP 10B,B00,201722,Staff,0,0,6,6
1683690499782,WCWP 100,A00,201725,Gagnon; Jeffrey C,0,0,2,2
1683690499782,WCWP 100,B00,201727,Staff,0,4,15,15
1683690502878,ANBI 133,A00,258401,Wilder; Linnea Lorene,34,0,40,6
1683690503958,ANBI 140,A00,258395,Hrvoj Mihic; Branka,18,0,25,7
1683690504982,ANSC 120,A00,258402,Bialecki; Jon Anthony,26,0,40,14
1683690506007,ANSC 144,A00,258400,Staff,12,0,40,28
1683690508061,ANSC 166,A00,258396,Parish; Steven Martin,156,0,175,19
1683690509087,ANSC 180,A00,193533,Staff,8,0,20,12
1683690510115,ANSC 188,A00,258397,Jassal; Aftab,34,0,40,6
1683690511137,ANTH 3,A01,258316,Staff,23,0,30,7
1683690512161,ANTH 5,A00,258394,Semendeferi; Ekaterini,16,0,20,4
1683690513189,ANTH 21,A01,258331,Staff,4,0,40,36
1683690514211,ANTH 103,A00,258398,Varma; Saiba,15,0,25,10
1683690515242,AWP 10,001,202034,Staff,0,0,0,0
1683690515242,AWP 10,002,202035,Staff,0,0,0,0
1683690515242,AWP 10,003,202036,Staff,0,0,0,0
1683690515242,AWP 10,004,202037,Staff,0,0,0,0
1683690515242,AWP 10,005,202038,Staff,0,0,0,0
1683690515242,AWP 10,006,202039,Staff,0,0,0,0
1683690515242,AWP 10,007,202040,Staff,0,0,0,0
1683690515242,AWP 10,008,202041,Staff,0,0,0,0
1683690515242,AWP 10,009,202042,Staff,0,0,0,0
1683690515242,AWP 10,010,202043,Staff,0,0,0,0
1683690515242,AWP 10,011,202044,Staff,0,0,0,0
1683690515242,AWP 10,012,202045,Staff,0,0,0,0
1683690515242,AWP 10,013,202046,Staff,0,0,0,0
1683690515242,AWP 10,014,202047,Staff,0,0,0,0
1683690515242,AWP 10,015,202048,Staff,0,0,0,0
1683690515242,AWP 10,016,202049,Staff,0,0,0,0
1683690515242,AWP 10,017,202050,Staff,0,0,0,0
1683690515242,AWP 10,018,202051,Staff,0,0,0,0
1683690515242,AWP 10,019,202052,Staff,0,0,0,0
1683690515242,AWP 10,020,202053,Staff,0,0,0,0
1683690515242,AWP 10,021,202054,Staff,0,0,0,0
1683690515242,AWP 10,022,202055,Staff,0,0,0,0
1683690515242,AWP 10,023,202056,Staff,0,0,0,0
1683690515242,AWP 10,024,202057,Staff,0,0,0,0
1683690515242,AWP 10,025,202058,Staff,0,0,0,0
1683690515242,AWP 10,026,202059,Staff,0,0,0,0
1683690516269,AWP 102,001,202032,Staff,0,0,0,0
1683690516269,AWP 102,002,202033,Staff,0,0,0,0
1683690517292,BENG 100,A01,254234,Taylor Amos; Alyssa C,31,0,40,9
1683690518315,BENG 196,001,270013,Engler; Adam J.,9999,0,9999,0
1683690519344,BICD 100R,A01,202018,Smith; Laurie,0,7,32,32
1683690519344,BICD 100R,A02,202019,Smith; Laurie,0,3,32,32
1683690519344,BICD 100R,A03,202020,Smith; Laurie,0,1,32,32
1683690519344,BICD 100R,A04,202021,Smith; Laurie,6,0,32,26
1683690519344,BICD 100R,A05,202022,Smith; Laurie,10,0,32,22
1683690520372,BICD 136,A01,193242,Gustafson-Brown; Cindy,0,2,32,32
1683690520372,BICD 136,A02,193244,Gustafson-Brown; Cindy,13,0,32,19
1683690521397,BIEB 102,A01,193249,Butler; Shannon Rhey,1,1,32,31
1683690521397,BIEB 102,A02,193251,Butler; Shannon Rhey,0,0,32,32
1683690521397,BIEB 102,A03,193253,Butler; Shannon Rhey,0,0,32,32
1683690521397,BIEB 102,A04,193255,Butler; Shannon Rhey,13,0,32,19
1683690521397,BIEB 102,A05,193265,Butler; Shannon Rhey,25,0,32,7
1683690521397,BIEB 102,A06,193269,Butler; Shannon Rhey,13,0,32,19
1683690523447,BIEB 150,A01,193274,Staff,0,0,32,32
1683690523447,BIEB 150,A02,193285,Staff,24,0,32,8
1683690524474,BIEB 194,A00,193286,Kurle; Carolyn M.,19,0,32,13
1683690525498,BILD 1,A01,192291,Staff,15,0,32,17
1683690525498,BILD 1,A02,192292,Staff,30,0,32,2
1683690525498,BILD 1,B01,192520,Reuther; Keefe,0,1,0,0
1683690525498,BILD 1,B02,192532,Reuther; Keefe,0,1,0,0
1683690526521,BILD 3,A01,192556,Butler; Shannon Rhey,0,0,32,32
1683690526521,BILD 3,A02,192581,Butler; Shannon Rhey,0,1,32,32
1683690526521,BILD 3,A03,192611,Butler; Shannon Rhey,19,0,32,13
1683690526521,BILD 3,A04,192612,Butler; Shannon Rhey,24,0,32,8
1683690526521,BILD 3,A05,192613,Butler; Shannon Rhey,26,0,32,6
1683690526521,BILD 3,A06,192679,Butler; Shannon Rhey,27,0,32,5
1683690526521,BILD 3,A07,192682,Butler; Shannon Rhey,20,0,32,12
1683690527549,BILD 4,A01,192836,Reuther; Keefe,1,0,24,23
1683690527549,BILD 4,A02,193044,Reuther; Keefe,4,0,24,20
1683690528573,BILD 10,A01,193142,Gustafson-Brown; Cindy,29,0,32,3
1683690528573,BILD 10,A02,193149,Gustafson-Brown; Cindy,31,0,32,1
1683690529601,BIMM 100,A01,193301,Staff,0,6,32,32
1683690529601,BIMM 100,A02,193312,Staff,0,7,32,32
1683690529601,BIMM 100,A03,193323,Staff,0,10,32,32
1683690530629,BIMM 101,A01,193329,McDonnell; Lisa Marie,1,4,24,23
1683690530629,BIMM 101,A02,193339,McDonnell; Lisa Marie,1,4,24,23
1683690530629,BIMM 101,B01,193354,McDonnell; Lisa Marie,0,4,24,24
1683690530629,BIMM 101,B02,193357,McDonnell; Lisa Marie,0,3,24,24
1683690531654,BIMM 110,A01,193377,Tat; John,0,11,32,32
1683690531654,BIMM 110,A02,193378,Tat; John,0,11,32,32
1683690532679,BIMM 120,A01,206116,Staff,0,0,32,32
1683690532679,BIMM 120,A02,206117,Staff,7,0,32,25
1683690532679,BIMM 120,A03,206121,Staff,21,0,32,11
1683690533708,BIPN 100,A01,193393,Park; Ji Young,0,15,32,32
1683690533708,BIPN 100,A02,193402,Park; Ji Young,0,14,32,32
1683690533708,BIPN 100,A03,193413,Park; Ji Young,0,14,32,32
1683690533708,BIPN 100,A04,193414,Park; Ji Young,0,13,32,32
1683690534732,BIPN 102,A01,193429,Staff,0,0,32,32
1683690534732,BIPN 102,A02,193438,Staff,18,0,32,14
1683690535756,BIPN 106,A01,193450,Reyes Gonzalez; Catalina,0,2,40,40
1683690536782,BIPN 134,A01,193465,Cooke; James Edward,0,0,32,32
1683690536782,BIPN 134,A02,193474,Cooke; James Edward,25,0,32,7
1683690536782,BIPN 134,A03,193485,Cooke; James Edward,29,0,32,3
1683690536782,BIPN 134,A04,193486,Cooke; James Edward,20,0,32,12
1683690536782,BIPN 134,A05,193491,Cooke; James Edward,31,0,32,1
1683690536782,BIPN 134,A06,193501,Cooke; James Edward,30,0,32,2
1683690536782,BIPN 134,A07,193510,Cooke; James Edward,29,0,32,3
1683690538830,BISP 194,A00,222522,Staff,14,0,32,18
1683690539855,CAT 124,A01,202407,Staff,19,0,25,6
1683690540879,CAT 125,A00,202408,Marchisotto; Jennifer Anne,2,0,20,18
1683690541905,CAT 125R,A00,202409,Smith; Lauryn Alissa,0,11,20,20
1683690541905,CAT 125R,B00,202410,Morales; Celeste Georgianna,0,11,20,20
1683690541905,CAT 125R,C00,202411,Irwin; Matthew Joseph,0,12,20,20
1683690542929,CENG 15,A01,204712,Yang; Kesong,0,1,0,0
1683690543953,CENG 114,A00,202070,Jahed Motlagh; Zeinab,5,0,20,15
1683690544981,CGS 105,A00,185477,Wesling; Megan E.,24,0,40,16
1683690546004,CGS 106,A00,185494,Staff,11,0,22,11
1683690547027,CGS 108,A00,185495,Staff,14,0,20,6
1683690548055,CGS 114,A00,185496,Staff,13,0,18,5
1683690549081,CGS 119,A00,185501,Staff,15,0,20,5
1683690550105,CGS 120,A00,185511,Staff,12,0,20,8
1683690551133,CHEM 4,A01,184675,Bussey; Thomas J,97,0,100,3
1683690552158,CHEM 6A,A01,184677,Staff,32,0,60,28
1683690553185,CHEM 6B,A01,184679,Staff,63,0,100,37
1683690554213,CHEM 6C,A01,184681,Bussey; Thomas J,0,0,50,50
1683690554213,CHEM 6C,A02,184682,Bussey; Thomas J,32,0,50,18
1683690555240,CHEM 40A,A01,184684,Albizati; Kim F.,33,0,100,67
1683690556263,CHEM 40B,A01,184686,Albizati; Kim F.,0,22,100,100
1683690557289,CHEM 41B,A01,184690,Staff,51,0,100,49
1683690558313,COGS 3,A01,184715,Boyle; Mary E. T.,0,27,40,40
1683690559337,COGS 14B,A01,185172,Staff,0,14,38,38
1683690560361,COGS 18,A01,184736,Staff,14,0,80,66
1683690561385,COGS 100,A01,184932,Staff,0,8,73,73
1683690562413,COGS 101A,A01,184935,Staff,0,40,30,30
1683690563439,COGS 101B,A01,184944,Staff,0,2,30,30
1683690564468,COGS 101C,A01,184946,Staff,0,10,30,30
1683690565494,COGS 102A,A01,184951,Johnson; Christine M.,1,0,40,39
1683690566522,COGS 107B,A01,184953,Mooshagian; Eric Frederick,0,52,40,40
1683690567550,COGS 118B,A01,184959,Gupta; Anjum,0,50,40,40
1683690568573,COGS 153,A00,184961,Staff,0,16,30,30
1683690569600,COGS 177,A00,184962,Staff,1,21,30,29
1683690570628,COGS 187A,A01,184969,Boyle; Mary E. T.,0,19,40,40
1683690571650,COMM 10,A01,185174,Staff,0,5,25,25
1683690571650,COMM 10,A02,185189,Staff,0,2,25,25
1683690571650,COMM 10,A03,269821,Staff,0,1,0,0
1683690572674,COMM 100B,A02,185476,Staff,10,0,25,15
1683690572674,COMM 100B,A03,277340,Staff,25,0,25,0
1683690573701,COMM 100C,A01,185314,Staff,1,0,25,24
1683690573701,COMM 100C,A02,185327,Staff,17,0,25,8
1683690574724,COMM 110M,A00,185349,Staff,0,0,40,40
1683690575748,COMM 113T,A00,185352,Staff,25,0,40,15
1683690576772,COMM 114I,A00,185353,Staff,31,0,40,9
1683690577798,COMM 131,A00,185354,Staff,17,0,30,13
1683690578823,CSE 8A,A50,185358,Cao; Yingjun,0,46,10,10
1683690579846,CSE 8B,A01,185362,Staff,0,48,50,50
1683690580870,CSE 11,A01,185416,Cao; Yingjun,0,91,10,10
1683690581893,CSE 20,A01,185445,Briones; Jor-el Thomas Caparas,3,0,25,22
1683690582917,CSE 21,A01,185447,Staff,9,0,50,41
1683690583941,CSE 101,A01,185451,Staff,0,13,50,50
1683690583941,CSE 101,B01,185453,Jones; Miles E,0,14,50,50
1683690585991,CSE 141,A01,185458,Eldon; John,16,0,100,84
1683690587018,CSE 141L,A01,185461,Eldon; John,8,0,100,92
1683690588045,CSE 142,A01,185463,Staff,34,0,60,26
1683690588045,CSE 142,B01,201355,Staff,0,7,60,60
1683690589069,CSE 142L,A01,185470,Staff,34,0,60,26
1683690589069,CSE 142L,B01,201417,Staff,0,6,60,60
1683690590093,CSE 190,A00,201433,Staff,32,0,49,17
1683690591118,DOC 1,A01,259136,Strom; Megan C.,7,0,15,8
1683690591118,DOC 1,A02,259137,Strom; Megan C.,14,0,15,1
1683690591118,DOC 1,A03,259138,Strom; Megan C.,14,0,15,1
1683690591118,DOC 1,A04,259139,Strom; Megan C.,14,0,15,1
1683690592141,DOC 100D,A00,259140,Pass; Natalye Joann,14,0,25,11
1683690593165,DSGN 1,A01,184749,Rill; Bryan,0,26,30,30
1683690594188,DSGN 100,A01,185168,Staff,0,2,25,25
1683690595215,ECE 5,A01,185626,Morris; Karcher William,0,12,0,0
1683690596241,ECE 101,A01,185628,Staff,14,0,70,56
1683690597269,ECE 107,A01,185635,Baghdadchi; Saharnaz,0,0,20,20
1683690597269,ECE 107,A02,185638,Baghdadchi; Saharnaz,1,0,20,19
1683690598295,ECE 148,A01,185647,Silberman; Jack,0,0,16,16
1683690599319,ECON 1,A01,185537,Crane; Meredith Helen,54,0,70,16
1683690600344,ECON 3,A01,185549,Crane; Meredith Helen,30,0,70,40
1683690601371,ECON 4,A01,203354,Anderson; John Charles,0,5,10,10
1683690602398,ECON 100A,A01,185574,Staff,0,5,40,40
1683690603425,ECON 100B,A01,185576,Staff,0,12,50,50
1683690604453,ECON 100C,A01,185589,Newhouse; Herbert S,30,0,70,40
1683690605480,ECON 105,A00,185608,Vespa; Emanuel Ignacio,19,0,35,16
1683690606503,ECON 109,A01,185610,Shishkin; Denis,9,0,35,26
1683690607590,ECON 110A,A01,185612,Staff,8,0,40,32
1683690608615,ECON 120A,A01,185615,Staff,19,0,40,21
1683690609643,ECON 120C,A01,185617,Sun; Yixiao,0,21,70,70
1683690610667,ECON 144,A00,203346,Squires; Dale E,2,0,35,33
1683690611691,ECON 171,A01,203349,Newhouse; Herbert S,0,1,35,35
1683690612715,ECON 173A,A01,185621,Toda; Alexis Akira,21,0,35,14
1683690613741,EDS 25,A01,202413,Staff,0,1,0,0
1683690613741,EDS 25,A02,202414,Staff,0,1,0,0
1683690613741,EDS 25,A03,202415,Staff,0,0,0,0
1683690613741,EDS 25,A04,202416,Staff,0,1,0,0
1683690613741,EDS 25,A05,202439,Staff,0,0,0,0
1683690613741,EDS 25,A06,202440,Staff,0,0,0,0
1683690613741,EDS 25,B01,202631,Staff,0,0,0,0
1683690613741,EDS 25,B02,202632,Staff,0,0,0,0
1683690613741,EDS 25,B03,202639,Staff,0,0,0,0
1683690613741,EDS 25,B04,202640,Staff,0,0,0,0
1683690613741,EDS 25,B05,202643,Staff,0,0,0,0
1683690613741,EDS 25,B06,202644,Staff,0,0,0,0
1683690614765,EDS 38,A01,202659,Black; Alison Michelle,24,0,25,1
1683690615791,EDS 115,A00,202652,Staff,18,0,30,12
1683690616817,EDS 125,A00,202649,Staff,13,0,30,17
1683690617844,EDS 126,A01,203332,Staff,30,0,30,0
1683690618867,EDS 139,A00,202838,Staff,16,0,25,9
1683690619890,EDS 146,A01,202655,Staff,14,0,25,11
1683690620914,ENG 15,A00,185667,Staff,0,1,0,0
1683690620914,ENG 15,B00,185672,Staff,0,0,0,0
1683690620914,ENG 15,C00,185675,Staff,0,0,0,0
1683690620914,ENG 15,D00,185682,Staff,0,0,0,0
1683690620914,ENG 15,E00,185684,Staff,0,0,0,0
1683690621940,ETHN 103,A00,185710,Staff,0,8,35,35
1683690622966,ETHN 103A,A00,199228,Man; Simeon S,0,0,9,9
1683690623992,ETHN 109,A00,185711,Staff,15,0,35,20
1683690625018,ETHN 142,A00,185726,Staff,0,4,30,30
1683690626042,ETHN 163J,A00,199229,Man; Simeon S,5,0,8,3
1683690627070,ETHN 168,A00,185727,Staff,7,0,10,3
1683690628096,ETHN 182,A00,185728,Staff,0,0,35,35
1683690629120,ETHN 183,A00,185737,Staff,9,0,18,9
1683690630146,GLBH 111,A01,209361,Burgos; Jose L.,0,0,0,0
1683690632194,HIEU 104,A00,185792,Staff,14,0,20,6
1683690633221,HIEU 115,A00,185800,Staff,0,0,20,20
1683690634245,HIEU 128,A00,185801,Staff,0,9,20,20
1683690635270,HIEU 147,A00,185802,Staff,15,0,20,5
1683690636294,HIEU 154,A00,185823,Staff,11,0,20,9
1683690637317,HILA 102,A00,185826,Staff,14,0,20,6
1683690638344,HILD 2C,A01,185778,Staff,0,13,20,20
1683690639371,HILD 7B,A01,185780,Kwak; Nancy,0,17,32,32
1683690639371,HILD 7B,A02,185781,Kwak; Nancy,0,18,32,32
1683690640397,HILD 30,A01,185791,Staff,12,0,20,8
1683690641421,HISC 119,A00,185830,Golan; Tal,0,11,20,20
1683690642445,HITO 156GS,A00,185831,Patterson; Patrick H.,0,0,0,23
1683690643468,HIUS 103,A00,185832,Man; Simeon S,0,4,20,20
1683690644494,HIUS 117,A00,185836,Kwak; Nancy,2,0,20,18
1683690645516,HIUS 125,A00,185840,Man; Simeon S,0,3,23,23
1683690646539,HIUS 149,A00,185845,Staff,1,0,20,19
1683690647563,HUM 3,A01,185882,Zavodny; Tatiana Sophia,0,8,50,50
1683690647563,HUM 3,B01,185899,Caldwell; Michael Alan,0,18,50,50
1683690648586,HUM 3GS,A00,185900,Patterson; Patrick H.,0,0,0,23
1683690649615,HUM 4,A01,185938,Zroka; Amy Liane,28,0,50,22
1683690649615,HUM 4,B01,185956,Watkins; Eric,0,6,50,50
1683690649615,HUM 4,B02,202209,Watkins; Eric,0,5,50,50
1683690649615,HUM 4,B03,202210,Watkins; Eric,0,5,50,50
1683690650644,HUM 5,A01,185958,West; Geoffrey Scott,0,0,50,50
1683690650644,HUM 5,A02,202215,West; Geoffrey Scott,0,1,50,50
1683690651671,INTL 190,A00,185959,Gagnon; Jeffrey C,0,0,0,9
1683690651671,INTL 190,B00,185960,Lettieri; Michael Joseph,0,0,0,2
1683690652697,JAPN 180,A00,254509,Staff,5,0,30,25
1683690653725,LATI 10,A01,202853,Kennemore; Amy Michelle,4,0,35,31
1683690653725,LATI 10,A02,202854,Kennemore; Amy Michelle,3,0,35,32
1683690653725,LATI 10,A03,270054,Kennemore; Amy Michelle,30,0,30,0
1683690654750,LATI 180,A00,202855,Kennemore; Amy Michelle,11,0,20,9
1683690655777,LAWS 101,A00,201767,Golan; Tal,0,7,40,40
1683690656801,LIFR 1C,A00,185961,Staff,6,0,20,14
1683690657825,LIFR 1CX,A00,185962,Staff,7,0,20,13
1683690658851,LIFR 1D,A00,185963,Staff,7,0,20,13
1683690659876,LIFR 1DX,A00,185964,Staff,7,0,20,13
1683690660900,LIGN 101,A01,186039,Staff,43,0,50,7
1683690661924,LIGN 165,A00,186040,Staff,15,0,50,35
1683690662949,LTCS 108,A00,186041,Staff,5,0,10,5
1683690663973,LTCS 119,A00,186042,Staff,15,0,20,5
1683690664998,LTCS 130,A00,186043,Wesling; Megan E.,15,0,25,10
1683690667049,LTEA 138,A00,186119,Staff,14,0,40,26
1683690668073,LTEN 124,A00,186148,Staff,5,0,25,20
1683690669096,LTEN 178,A00,186149,Staff,6,0,15,9
1683690670124,LTEN 181,A00,186150,Blanco; John D,34,0,40,6
1683690671148,LTWL 120,A00,186160,Staff,19,0,25,6
1683690672173,LTWL 165,A00,186161,Staff,22,0,25,3
1683690673199,LTWR 100,A00,186162,Staff,0,5,15,15
1683690674226,LTWR 102,A00,186163,Doller; Ben,5,0,15,10
1683690675251,MAE 8,A01,186412,Staff,0,1,0,0
1683690676274,MAE 30B,A00,186445,Bahadori; Mohammad Yousef,81,0,100,19
1683690677299,MAE 40,A00,186592,Bewley; Thomas R,10,0,50,40
1683690678326,MAE 101B,A00,186593,Bahadori; Mohammad Yousef,80,0,100,20
1683690679354,MAE 105,A00,186594,Bandaru; Prabhakar,10,0,50,40
1683690680377,MAE 107,A00,186599,Pham; Hieu Tan,0,7,120,120
1683690681405,MAE 148,A01,186660,Silberman; Jack,3,0,16,13
1683690682432,MATH 10A,A01,188095,Staff,0,6,35,35
1683690683461,MATH 10B,A01,188097,Bowers; Adam R.,0,12,30,30
1683690683461,MATH 10B,A02,188099,Bowers; Adam R.,0,11,30,30
1683690683461,MATH 10B,B01,188104,Bowers; Adam R.,0,10,30,30
1683690683461,MATH 10B,B02,188106,Bowers; Adam R.,1,9,30,29
1683690684493,MATH 10C,A01,188111,Staff,0,20,30,30
1683690684493,MATH 10C,A02,188127,Staff,0,19,30,30
1683690684493,MATH 10C,A03,188131,Staff,0,19,30,30
1683690684493,MATH 10C,B01,188218,Staff,17,0,30,13
1683690684493,MATH 10C,B02,188244,Staff,13,0,30,17
1683690684493,MATH 10C,B03,188277,Staff,14,0,30,16
1683690685518,MATH 18,A01,188344,Bach; Quang Tran,18,0,30,12
1683690685518,MATH 18,A02,188345,Bach; Quang Tran,11,0,30,19
1683690685518,MATH 18,B01,188353,Bach; Quang Tran,11,0,30,19
1683690685518,MATH 18,B02,188354,Bach; Quang Tran,19,0,30,11
1683690686541,MATH 20A,A01,188374,Staff,11,0,35,24
1683690687568,MATH 20B,A01,188382,Ohm; Ko Woon,7,0,30,23
1683690687568,MATH 20B,A02,188383,Ohm; Ko Woon,22,0,30,8
1683690687568,MATH 20B,B01,188385,Ohm; Ko Woon,7,0,30,23
1683690687568,MATH 20B,B02,188392,Ohm; Ko Woon,22,0,30,8
1683690688596,MATH 20C,A01,188394,Harel; Guershon,10,0,30,20
1683690688596,MATH 20C,A02,188395,Harel; Guershon,13,0,30,17
1683690688596,MATH 20C,B01,188404,Harel; Guershon,5,0,30,25
1683690688596,MATH 20C,B02,188405,Harel; Guershon,18,0,30,12
1683690689620,MATH 20D,A01,188414,Hammock; Frances H,0,1,30,30
1683690689620,MATH 20D,A02,188415,Hammock; Frances H,0,1,30,30
1683690689620,MATH 20D,B01,188447,Hammock; Frances H,0,1,30,30
1683690689620,MATH 20D,B02,188486,Hammock; Frances H,2,0,30,28
1683690690644,MATH 20E,A01,188649,Staff,21,0,30,9
1683690690644,MATH 20E,A02,188650,Staff,20,0,30,10
1683690690644,MATH 20E,A03,188673,Staff,0,0,30,30
1683690691669,MATH 102,A01,188675,Staff,0,40,35,35
1683690692695,MATH 103B,A01,188681,Staff,3,0,35,32
1683690692695,MATH 103B,B01,188692,Staff,5,0,35,30
1683690693719,MATH 109,A01,188695,Salehi Golsefidy; Alireza,24,0,35,11
1683690693719,MATH 109,A02,188696,Salehi Golsefidy; Alireza,25,0,35,10
1683690694743,MATH 120A,A01,188698,Eggers; John Dietrich,7,0,35,28
1683690695771,MATH 142B,A01,188736,Ioana; Adrian,1,1,30,29
1683690695771,MATH 142B,A02,188741,Ioana; Adrian,0,1,30,30
1683690695771,MATH 142B,A03,188743,Ioana; Adrian,0,2,30,30
1683690696796,MATH 168A,A01,188790,Staff,0,11,35,35
1683690697821,MATH 170A,A01,188803,Nie; Jiawang,0,2,35,35
1683690697821,MATH 170A,A02,188811,Nie; Jiawang,0,1,35,35
1683690697821,MATH 170A,A03,188814,Nie; Jiawang,0,0,35,35
1683690697821,MATH 170A,A04,188815,Nie; Jiawang,5,0,35,30
1683690698845,MATH 193B,A01,188817,Staff,0,0,35,35
1683690698845,MATH 193B,A02,188818,Staff,6,0,35,29
1683690699870,MGT 4,A01,202857,Anderson; John Charles,59,0,80,21
1683690700897,MGT 12,A00,202858,Lindenberger; Wade Douglas,40,0,90,50
1683690701922,MGT 18,A00,202859,Staff,74,0,90,16
1683690702953,MGT 18GS,A00,202860,McKay; Michael J,13,0,28,15
1683690703980,MGT 45,A00,202861,Pecore; Joseph P.,8,0,90,82
1683690705007,MGT 100,A00,202863,Yavorsky; Daniel Ryan,27,0,90,63
1683690706034,MGT 103,A00,202864,Ehrich; Kristine R,0,19,90,90
1683690707057,MGT 112,A00,202865,Ehrich; Kristine R,15,0,90,75
1683690708081,MGT 121A,A00,202868,Staff,90,20,90,0
1683690709107,MGT 131B,A00,202869,Anderson; John Charles,58,0,90,32
1683690710134,MGT 136,A00,202871,Lindenberger; Wade Douglas,83,0,90,7
1683690711212,MGT 164,A00,202873,Staff,0,67,90,91
1683690712239,MGT 164GS,A00,202874,McKay; Mary A,13,0,28,15
1683690713267,MGT 180,A00,202875,Staff,0,51,90,91
1683690714291,MMW 11R,A01,205019,Herbst; Matthew,0,0,30,30
1683690714291,MMW 11R,A02,205026,Herbst; Matthew,29,0,30,1
1683690715322,MMW 15,A01,193512,Chang; Edmond Yi-Teh,0,8,28,28
1683690715322,MMW 15,A02,193513,Chang; Edmond Yi-Teh,0,5,28,28
1683690715322,MMW 15,A03,193514,Chang; Edmond Yi-Teh,0,5,28,28
1683690715322,MMW 15,A04,193515,Chang; Edmond Yi-Teh,0,5,28,28
1683690715322,MMW 15,A05,193516,Chang; Edmond Yi-Teh,0,5,28,28
1683690715322,MMW 15,A06,193517,Chang; Edmond Yi-Teh,0,6,28,28
1683690715322,MMW 15,B01,193519,Chang; Edmond Yi-Teh,0,5,28,28
1683690715322,MMW 15,B02,193520,Chang; Edmond Yi-Teh,0,5,28,28
1683690715322,MMW 15,B03,193521,Chang; Edmond Yi-Teh,0,5,28,28
1683690715322,MMW 15,B04,193522,Chang; Edmond Yi-Teh,0,6,28,28
1683690715322,MMW 15,B05,193523,Chang; Edmond Yi-Teh,0,5,28,28
1683690715322,MMW 15,B06,193524,Chang; Edmond Yi-Teh,0,5,28,28
1683690716348,MMW 122,A01,193526,Rahimi; Babak,0,16,28,28
1683690716348,MMW 122,A02,193527,Rahimi; Babak,0,15,28,28
1683690716348,MMW 122,A03,193528,Rahimi; Babak,0,0,0,0
1683690716348,MMW 122,A04,193529,Rahimi; Babak,0,0,0,0
1683690717375,MUS 1A,A01,186663,Staff,1,19,35,34
1683690718400,MUS 4,A01,186715,Staff,0,12,35,35
1683690719424,MUS 5R,A01,186796,Dubnov; Shlomo,0,17,35,35
1683690720454,MUS 6,A01,186798,Staff,1,5,25,24
1683690721480,MUS 7,A01,186830,Staff,11,0,35,24
1683690722503,MUS 8,A01,186930,Staff,0,27,35,35
1683690723531,MUS 15,A01,186932,Staff,0,15,35,35
1683690723531,MUS 15,B01,186934,Staff,1,17,35,34
1683690724560,MUS 80,A00,186935,Staff,0,0,20,20
1683690724560,MUS 80,B00,186936,Staff,24,0,25,1
1683690725584,NANO 11,A00,204702,Lipomi; Darren John,0,0,0,0
1683690726609,NANO 15,A01,204709,Yang; Kesong,0,1,0,0
1683690727632,NANO 114,A00,202069,Jahed Motlagh; Zeinab,2,0,10,8
1683690728659,PHIL 1,A00,186955,Grush; Rick Scott,31,0,40,9
1683690729687,PHIL 10,A01,186973,Grush; Rick Scott,27,0,35,8
1683690729687,PHIL 10,A02,186974,Grush; Rick Scott,33,0,35,2
1683690730714,PHIL 13,A01,186976,Staff,1,0,35,34
1683690730714,PHIL 13,A02,186977,Staff,16,0,35,19
1683690731740,PHIL 14,A01,186979,Staff,31,0,35,4
1683690731740,PHIL 14,A02,186986,Staff,32,0,35,3
1683690732765,PHIL 28,A01,186988,Staff,16,0,30,14
1683690732765,PHIL 28,A02,186989,Staff,1,0,30,29
1683690732765,PHIL 28,A03,186990,Staff,10,0,30,20
1683690732765,PHIL 28,A04,186991,Staff,26,0,30,4
1683690733789,PHIL 120,A00,186997,Staff,23,0,40,17
1683690734814,PHIL 137,A00,187003,Staff,7,0,40,33
1683690735837,PHIL 150,A00,187015,Staff,47,0,70,23
1683690736861,PHIL 167,A00,187021,Lamey; Andy M.,34,0,40,6
1683690737885,PHIL 174,A01,202226,Staff,17,0,20,3
1683690737885,PHIL 174,A02,202235,Staff,20,0,20,0
1683690738908,PHIL 191A,A00,258918,Staff,0,0,1,1
1683690739936,PHYS 1A,A00,187028,Staff,26,0,60,34
1683690740963,PHYS 1AL,001,187036,Staff,3,0,30,27
1683690740963,PHYS 1AL,002,187049,Staff,18,0,30,12
1683690741987,PHYS 1B,A00,187058,Staff,22,0,60,38
1683690743011,PHYS 1BL,001,187064,Staff,0,1,30,30
1683690743011,PHYS 1BL,002,187070,Staff,4,0,30,26
1683690744038,PHYS 1C,A00,187082,Staff,29,0,120,91
1683690745065,PHYS 1CL,001,187088,Staff,0,9,30,30
1683690745065,PHYS 1CL,002,187089,Staff,0,1,30,30
1683690745065,PHYS 1CL,009,262693,Staff,9,0,30,21
1683690746089,PHYS 2B,A01,187097,Staff,55,0,115,60
1683690747112,PHYS 2C,A01,187099,Staff,63,0,115,52
1683690748139,PHYS 2CL,A01,187101,Staff,5,0,28,23
1683690748139,PHYS 2CL,A02,187102,Staff,15,0,28,13
1683690749164,PHYS 2D,A01,187123,Shotwell; Brian,95,0,115,20
1683690750189,PHYS 4B,A01,187133,Grinstein; Benjamin,35,0,50,15
1683690751215,POLI 10,A00,188819,Staff,0,4,50,50
1683690752244,POLI 11,A00,188827,Staff,43,0,50,7
1683690753271,POLI 13R,A00,188828,Staff,0,1,20,20
1683690754293,POLI 27,A01,188830,Elgin; Samuel Zincke,0,2,70,70
1683690755321,POLI 30,A00,188832,Desposato; Scott,30,0,50,20
1683690756348,POLI 102F,A00,188834,Staff,1,0,40,39
1683690757374,POLI 104A,A00,188852,Staff,12,0,30,18
1683690758398,POLI 104I,A00,188853,Staff,0,8,20,20
1683690759424,POLI 110B,A00,188854,Wiens; David,6,0,20,14
1683690760448,POLI 112A,A00,188855,Wiens; David,3,0,30,27
1683690761474,POLI 117R,A00,188856,Forman; Fonna,0,12,20,20
1683690762500,POLI 118,A00,188857,Ingham; Sean,8,0,20,12
1683690763524,POLI 120G,A00,188858,Staff,8,0,30,22
1683690764548,POLI 131CR,A00,188863,Hoston; Germaine,20,0,50,30
1683690765573,POLI 133,A00,188864,Nellis; Gareth Hb,44,0,50,6
1683690766597,POLI 134D,A00,188865,Desposato; Scott,27,0,30,3
1683690767621,POLI 142A,A00,188871,Gartzke; Erik,21,0,50,29
1683690768644,POLI 142K,A00,188874,Staff,38,0,50,12
1683690769671,POLI 143,A00,188940,Gartzke; Erik,16,0,30,14
1683690770696,POLI 153,A00,188943,Staff,2,0,20,18
1683690771731,POLI 160AA,A00,188944,Staff,10,0,40,30
1683690772757,POLI 170A,A00,188945,Staff,10,0,30,20
1683690774813,PSYC 1,A00,188952,Staff,36,0,90,54
1683690775841,PSYC 2,B00,188953,Staff,19,0,35,16
1683690776865,PSYC 6,A00,188970,Staff,47,0,60,13
1683690777889,PSYC 7,A00,188973,Staff,35,0,45,10
1683690778913,PSYC 60,A01,188980,Rickard; Timothy C.,42,0,60,18
1683690779941,PSYC 70,A01,189001,Steiner; Eric Tomas,21,0,45,24
1683690780966,PSYC 100,A00,189005,Lacefield; Katharine I,0,99,120,120
1683690781993,PSYC 102,A00,189008,Staff,7,0,30,23
1683690783021,PSYC 106,B00,189026,Gorman; Michael R.,27,0,60,33
1683690784045,PSYC 114,B01,189033,Winkielman; Piotr,0,31,30,30
1683690785068,PSYC 131,A00,189036,Anagnostaras; Stephan,0,43,60,60
1683690786095,PSYC 136,A00,189041,Lowe; Angela Beth,0,7,25,25
1683690787121,PSYC 137,A00,189057,Winkielman; Piotr,1,37,25,24
1683690788148,PSYC 144,A00,189107,Wixted; John T,0,11,50,50
1683690790195,PSYC 162,A00,189142,Staff,0,9,85,85
1683690791223,PSYC 172,A00,189144,Gorman; Michael R.,0,6,30,30
1683690793271,PSYC 179,A00,189146,Lacefield; Katharine I,0,88,120,120
1683690794298,PSYC 181,A00,189147,Anagnostaras; Stephan,0,44,90,90
1683690795323,PSYC 190R,A00,189148,Barner; David A.,0,23,80,80
1683690796347,PSYC 191,A00,189275,Rickard; Timothy C.,0,11,25,25
1683690797371,PSYC 193,A00,189276,Chapman; Eddie Nathaniel,0,1,0,4
1683690798400,PSYC 193L,A01,189281,Lowe; Angela Beth,8,0,20,12
1683690798400,PSYC 193L,B01,189285,Staff,28,0,35,7
1683690799423,RELI 149,A00,187137,Rahimi; Babak,6,0,40,34
1683690800451,SE 9,A01,187315,Staff,0,2,18,18
1683690801475,SE 101B,A00,187409,Staff,24,0,30,6
1683690802502,SE 110B,A00,187444,Staff,10,0,40,30
1683690803527,SE 130B,A00,187449,Staff,31,0,40,9
1683690804551,SE 150A,A00,187516,Staff,8,0,20,12
1683690805576,SE 154,A00,187528,Staff,29,0,50,21
1683690806601,SIO 3,A01,258171,Staff,35,0,40,5
1683690807626,SIO 10,A00,187144,Cook; Geoffrey W,1,7,75,74
1683690808652,SIO 45,A00,187152,Cook; Geoffrey W,0,7,100,100
1683690809677,SIO 109R,A00,194486,Staff,0,4,20,20
1683690811731,SIO 187,A01,187233,Kacev; David,12,0,40,28
1683690812759,SOCI 1,A01,258656,Thorpe; Charles Robert,28,0,30,2
1683690812759,SOCI 1,A02,258658,Thorpe; Charles Robert,30,0,30,0
1683690812759,SOCI 1,A03,258661,Thorpe; Charles Robert,25,0,25,0
1683690812759,SOCI 1,A04,258666,Thorpe; Charles Robert,22,0,25,3
1683690812759,SOCI 1,A05,258897,Thorpe; Charles Robert,22,0,25,3
1683690812759,SOCI 1,A06,258898,Thorpe; Charles Robert,25,0,25,0
1683690813784,SOCI 30,A01,258903,Pardo Guerra; Juan Pablo,14,0,30,16
1683690814870,SOCI 102,A00,258904,Staff,9,0,25,16
1683690815895,SOCI 106,A00,258905,Staff,19,0,25,6
1683690816921,SOCI 111,A00,258907,Ribas Norris; Janet Vanesa,26,0,30,4
1683690817948,SOCI 121R,A00,258908,Pardo Guerra; Juan Pablo,8,0,30,22
1683690818972,SOCI 126,A01,203330,Staff,14,0,20,6
1683690820000,SOCI 131,A00,258909,Thorpe; Charles Robert,30,0,60,30
1683690821024,SOCI 135,A00,258910,Payne; Christine Anna,0,13,30,30
1683690822051,SOCI 157,A00,258911,Staff,11,0,30,19
1683690823076,SOCI 184,A00,258912,Staff,25,0,30,5
1683690824101,SOCI 188D,A00,258913,Staff,22,0,30,8
1683690825129,SYN 2,001,187529,Staff,9,0,16,7
1683690825129,SYN 2,002,201452,Staff,1,20,16,15
1683690825129,SYN 2,003,201469,Staff,1,0,16,15
1683690826154,SYN 100,A01,187531,Staff,0,9,20,20
1683690826154,SYN 100,B01,201491,Staff,0,10,20,20
1683690827181,TDAC 1,A00,189286,Walsh; Kim C.,3,0,20,17
1683690827181,TDAC 1,B00,189287,Harting; Carla Kelso,10,0,20,10
1683690828208,TDAC 101,A00,189300,Walsh; Kim C.,16,0,20,4
1683690828208,TDAC 101,B00,189301,Harting; Carla Kelso,18,0,20,2
1683690829234,TDAC 102,A00,189304,Basso; Beatrice,14,0,20,6
1683690830259,TDAC 108,A00,189305,Staff,18,0,20,2
1683690831284,TDDE 131,A00,189310,Staff,19,0,20,1
1683690831284,TDDE 131,B00,189314,Staff,19,0,20,1
1683690831284,TDDE 131,C00,189315,Staff,48,0,50,2
1683690831284,TDDE 131,D00,189316,Staff,14,0,15,1
1683690831284,TDDE 131,E00,204841,Staff,20,0,20,0
1683690832311,TDGE 10,A00,189289,Staff,27,0,50,23
1683690832311,TDGE 10,B00,189290,Havis; Allan,0,1,50,50
1683690833334,TDGE 11,A00,189291,Fulton; Julia,0,4,50,50
1683690833334,TDGE 11,B00,189292,Staff,20,0,25,5
1683690833334,TDGE 11,C00,260270,Staff,0,0,0,0
1683690834362,TDGE 25,A00,189294,Staff,1,0,20,19
1683690835390,TDGE 124,A00,189318,Fulton; Julia,1,8,50,49
1683690836415,TDGE 125,A00,189319,Staff,13,0,25,12
1683690836415,TDGE 125,B00,189320,Staff,23,0,25,2
1683690837440,TDGE 127,A00,189322,Havis; Allan,0,0,50,50
1683690838467,TDHT 101,A00,189323,Staff,18,0,25,7
1683690838467,TDHT 101,B00,189324,Staff,25,0,25,0
1683690839491,TDHT 102,A00,189325,Staff,49,0,50,1
1683690840516,TDMV 1,A00,189295,Arcidiacono; Kristin,20,0,30,10
1683690840516,TDMV 1,B00,189296,Caligagan; Maria T.,24,0,30,6
1683690841544,TDMV 2,A00,189297,Sammartano; Tonnie,27,0,30,3
1683690841544,TDMV 2,B00,189299,Arcidiacono; Kristin,23,0,30,7
1683690842567,TDMV 3,A00,204998,Rincon; Alicia,22,0,30,8
1683690843592,TDMV 120,A00,189458,Sammartano; Tonnie,28,0,30,2
1683690844621,TDMV 138,A00,189541,Jun; Grace Shin Hae,20,0,40,20
1683690845646,TDMV 142,A00,189717,Caligagan; Tony,25,0,30,5
1683690845646,TDMV 142,B00,189718,Caligagan; Maria T.,25,0,30,5
1683690846670,TMC 2,A01,187533,Staff,25,0,25,0
1683690846670,TMC 2,A02,187534,Staff,25,0,25,0
1683690847694,USP 1,A01,187536,Kwak; Nancy,0,16,25,25
1683690848718,USP 5,A01,187538,Staff,8,0,25,17
1683690849742,USP 101,A00,199253,Staff,0,4,0,0
1683690850769,USP 124,A00,187562,Boomhower; Matthew Charles,0,0,30,30
1683690851793,USP 138,A00,187582,Staff,19,0,25,6
1683690852820,USP 152,A01,187597,Staff,3,0,25,22
1683690853844,USP 153,A00,187598,Staff,18,0,25,7
1683690854869,USP 168,A00,187607,Kwak; Nancy,2,0,5,3
1683690855893,USP 173,A00,187619,Staff,4,0,25,21
1683690856921,USP 181,A00,187638,Staff,0,4,25,25
1683690857944,VIS 103,A00,187650,Cruz; Edwin Teddy,17,0,75,58
1683690858971,VIS 110D,A00,187669,Staff,13,0,22,9
1683690859997,VIS 127C,A00,187720,Shen; Kuiyi,67,0,146,79
1683690861023,VIS 149,A00,187731,Yoldas; Pinar,1,14,22,21
1683690862050,VIS 151,A01,188091,Staff,22,0,34,12
1683690862050,VIS 151,A02,188092,Staff,11,0,34,23
1683690863082,VIS 160B,A00,188093,Stalbaum; Brett,0,1,10,10
1683690865131,WCWP 10B,A00,201720,Staff,0,0,5,5
1683690865131,WCWP 10B,B00,201722,Staff,0,0,6,6
1683690866155,WCWP 100,A00,201725,Gagnon; Jeffrey C,0,0,2,2
1683690866155,WCWP 100,B00,201727,Staff,0,4,15,15
1683690869279,ANBI 133,A00,258401,Wilder; Linnea Lorene,34,0,40,6
1683690870306,ANBI 140,A00,258395,Hrvoj Mihic; Branka,18,0,25,7
1683690871334,ANSC 120,A00,258402,Bialecki; Jon Anthony,26,0,40,14
1683690872356,ANSC 144,A00,258400,Staff,12,0,40,28
1683690874407,ANSC 166,A00,258396,Parish; Steven Martin,156,0,175,19
1683690875431,ANSC 180,A00,193533,Staff,8,0,20,12
1683690876457,ANSC 188,A00,258397,Jassal; Aftab,34,0,40,6
1683690877484,ANTH 3,A01,258316,Staff,23,0,30,7
1683690878508,ANTH 5,A00,258394,Semendeferi; Ekaterini,16,0,20,4
1683690879530,ANTH 21,A01,258331,Staff,4,0,40,36
1683690880554,ANTH 103,A00,258398,Varma; Saiba,15,0,25,10
1683690881586,AWP 10,001,202034,Staff,0,0,0,0
1683690881586,AWP 10,002,202035,Staff,0,0,0,0
1683690881586,AWP 10,003,202036,Staff,0,0,0,0
1683690881586,AWP 10,004,202037,Staff,0,0,0,0
1683690881586,AWP 10,005,202038,Staff,0,0,0,0
1683690881586,AWP 10,006,202039,Staff,0,0,0,0
1683690881586,AWP 10,007,202040,Staff,0,0,0,0
1683690881586,AWP 10,008,202041,Staff,0,0,0,0
1683690881586,AWP 10,009,202042,Staff,0,0,0,0
1683690881586,AWP 10,010,202043,Staff,0,0,0,0
1683690881586,AWP 10,011,202044,Staff,0,0,0,0
1683690881586,AWP 10,012,202045,Staff,0,0,0,0
1683690881586,AWP 10,013,202046,Staff,0,0,0,0
1683690881586,AWP 10,014,202047,Staff,0,0,0,0
1683690881586,AWP 10,015,202048,Staff,0,0,0,0
1683690881586,AWP 10,016,202049,Staff,0,0,0,0
1683690881586,AWP 10,017,202050,Staff,0,0,0,0
1683690881586,AWP 10,018,202051,Staff,0,0,0,0
1683690881586,AWP 10,019,202052,Staff,0,0,0,0
1683690881586,AWP 10,020,202053,Staff,0,0,0,0
1683690881586,AWP 10,021,202054,Staff,0,0,0,0
1683690881586,AWP 10,022,202055,Staff,0,0,0,0
1683690881586,AWP 10,023,202056,Staff,0,0,0,0
1683690881586,AWP 10,024,202057,Staff,0,0,0,0
1683690881586,AWP 10,025,202058,Staff,0,0,0,0
1683690881586,AWP 10,026,202059,Staff,0,0,0,0
1683690882611,AWP 102,001,202032,Staff,0,0,0,0
1683690882611,AWP 102,002,202033,Staff,0,0,0,0
1683690883635,BENG 100,A01,254234,Taylor Amos; Alyssa C,31,0,40,9
1683690884658,BENG 196,001,270013,Engler; Adam J.,9999,0,9999,0
1683690885683,BICD 100R,A01,202018,Smith; Laurie,0,7,32,32
1683690885683,BICD 100R,A02,202019,Smith; Laurie,0,3,32,32
1683690885683,BICD 100R,A03,202020,Smith; Laurie,0,1,32,32
1683690885683,BICD 100R,A04,202021,Smith; Laurie,6,0,32,26
1683690885683,BICD 100R,A05,202022,Smith; Laurie,10,0,32,22
1683690886706,BICD 136,A01,193242,Gustafson-Brown; Cindy,0,2,32,32
1683690886706,BICD 136,A02,193244,Gustafson-Brown; Cindy,13,0,32,19
1683690887738,BIEB 102,A01,193249,Butler; Shannon Rhey,1,1,32,31
1683690887738,BIEB 102,A02,193251,Butler; Shannon Rhey,0,0,32,32
1683690887738,BIEB 102,A03,193253,Butler; Shannon Rhey,0,0,32,32
1683690887738,BIEB 102,A04,193255,Butler; Shannon Rhey,13,0,32,19
1683690887738,BIEB 102,A05,193265,Butler; Shannon Rhey,25,0,32,7
1683690887738,BIEB 102,A06,193269,Butler; Shannon Rhey,13,0,32,19
1683690889789,BIEB 150,A01,193274,Staff,0,0,32,32
1683690889789,BIEB 150,A02,193285,Staff,24,0,32,8
1683690890817,BIEB 194,A00,193286,Kurle; Carolyn M.,19,0,32,13
1683690891846,BILD 1,A01,192291,Staff,15,0,32,17
1683690891846,BILD 1,A02,192292,Staff,30,0,32,2
1683690891846,BILD 1,B01,192520,Reuther; Keefe,0,1,0,0
1683690891846,BILD 1,B02,192532,Reuther; Keefe,0,1,0,0
1683690892875,BILD 3,A01,192556,Butler; Shannon Rhey,0,0,32,32
1683690892875,BILD 3,A02,192581,Butler; Shannon Rhey,0,1,32,32
1683690892875,BILD 3,A03,192611,Butler; Shannon Rhey,19,0,32,13
1683690892875,BILD 3,A04,192612,Butler; Shannon Rhey,24,0,32,8
1683690892875,BILD 3,A05,192613,Butler; Shannon Rhey,26,0,32,6
1683690892875,BILD 3,A06,192679,Butler; Shannon Rhey,27,0,32,5
1683690892875,BILD 3,A07,192682,Butler; Shannon Rhey,20,0,32,12
1683690893900,BILD 4,A01,192836,Reuther; Keefe,1,0,24,23
1683690893900,BILD 4,A02,193044,Reuther; Keefe,4,0,24,20
1683690894924,BILD 10,A01,193142,Gustafson-Brown; Cindy,29,0,32,3
1683690894924,BILD 10,A02,193149,Gustafson-Brown; Cindy,31,0,32,1
1683690895949,BIMM 100,A01,193301,Staff,0,6,32,32
1683690895949,BIMM 100,A02,193312,Staff,0,7,32,32
1683690895949,BIMM 100,A03,193323,Staff,0,10,32,32
1683690896978,BIMM 101,A01,193329,McDonnell; Lisa Marie,1,4,24,23
1683690896978,BIMM 101,A02,193339,McDonnell; Lisa Marie,1,4,24,23
1683690896978,BIMM 101,B01,193354,McDonnell; Lisa Marie,0,4,24,24
1683690896978,BIMM 101,B02,193357,McDonnell; Lisa Marie,0,3,24,24
1683690898002,BIMM 110,A01,193377,Tat; John,0,11,32,32
1683690898002,BIMM 110,A02,193378,Tat; John,0,11,32,32
1683690899027,BIMM 120,A01,206116,Staff,0,0,32,32
1683690899027,BIMM 120,A02,206117,Staff,7,0,32,25
1683690899027,BIMM 120,A03,206121,Staff,21,0,32,11
1683690900056,BIPN 100,A01,193393,Park; Ji Young,0,15,32,32
1683690900056,BIPN 100,A02,193402,Park; Ji Young,0,14,32,32
1683690900056,BIPN 100,A03,193413,Park; Ji Young,0,14,32,32
1683690900056,BIPN 100,A04,193414,Park; Ji Young,0,13,32,32
1683690901086,BIPN 102,A01,193429,Staff,0,0,32,32
1683690901086,BIPN 102,A02,193438,Staff,18,0,32,14
1683690902116,BIPN 106,A01,193450,Reyes Gonzalez; Catalina,0,2,40,40
1683690903143,BIPN 134,A01,193465,Cooke; James Edward,0,0,32,32
1683690903143,BIPN 134,A02,193474,Cooke; James Edward,25,0,32,7
1683690903143,BIPN 134,A03,193485,Cooke; James Edward,29,0,32,3
1683690903143,BIPN 134,A04,193486,Cooke; James Edward,20,0,32,12
1683690903143,BIPN 134,A05,193491,Cooke; James Edward,31,0,32,1
1683690903143,BIPN 134,A06,193501,Cooke; James Edward,30,0,32,2
1683690903143,BIPN 134,A07,193510,Cooke; James Edward,29,0,32,3
1683690905198,BISP 194,A00,222522,Staff,14,0,32,18
1683690906223,CAT 124,A01,202407,Staff,19,0,25,6
1683690907245,CAT 125,A00,202408,Marchisotto; Jennifer Anne,2,0,20,18
1683690908269,CAT 125R,A00,202409,Smith; Lauryn Alissa,0,11,20,20
1683690908269,CAT 125R,B00,202410,Morales; Celeste Georgianna,0,11,20,20
1683690908269,CAT 125R,C00,202411,Irwin; Matthew Joseph,0,12,20,20
1683690909294,CENG 15,A01,204712,Yang; Kesong,0,1,0,0
1683690910317,CENG 114,A00,202070,Jahed Motlagh; Zeinab,5,0,20,15
1683690911343,CGS 105,A00,185477,Wesling; Megan E.,24,0,40,16
1683690912367,CGS 106,A00,185494,Staff,11,0,22,11
1683690913390,CGS 108,A00,185495,Staff,14,0,20,6
1683690914416,CGS 114,A00,185496,Staff,13,0,18,5
1683690915440,CGS 119,A00,185501,Staff,15,0,20,5
1683690916463,CGS 120,A00,185511,Staff,12,0,20,8
1683690917488,CHEM 4,A01,184675,Bussey; Thomas J,97,0,100,3
1683690918571,CHEM 6A,A01,184677,Staff,32,0,60,28
1683690919597,CHEM 6B,A01,184679,Staff,63,0,100,37
1683690920621,CHEM 6C,A01,184681,Bussey; Thomas J,0,0,50,50
1683690920621,CHEM 6C,A02,184682,Bussey; Thomas J,32,0,50,18
1683690921645,CHEM 40A,A01,184684,Albizati; Kim F.,33,0,100,67
1683690922676,CHEM 40B,A01,184686,Albizati; Kim F.,0,22,100,100
1683690923704,CHEM 41B,A01,184690,Staff,51,0,100,49
1683690924727,COGS 3,A01,184715,Boyle; Mary E. T.,0,27,40,40
1683690925752,COGS 14B,A01,185172,Staff,0,14,38,38
1683690926776,COGS 18,A01,184736,Staff,14,0,80,66
1683690927800,COGS 100,A01,184932,Staff,0,8,73,73
1683690928824,COGS 101A,A01,184935,Staff,0,40,30,30
1683690929852,COGS 101B,A01,184944,Staff,0,2,30,30
1683690930875,COGS 101C,A01,184946,Staff,0,10,30,30
1683690931902,COGS 102A,A01,184951,Johnson; Christine M.,1,0,40,39
1683690932927,COGS 107B,A01,184953,Mooshagian; Eric Frederick,0,52,40,40
1683690933951,COGS 118B,A01,184959,Gupta; Anjum,0,50,40,40
1683690934979,COGS 153,A00,184961,Staff,0,16,30,30
1683690936006,COGS 177,A00,184962,Staff,1,21,30,29
1683690937029,COGS 187A,A01,184969,Boyle; Mary E. T.,0,19,40,40
1683690938055,COMM 10,A01,185174,Staff,0,5,25,25
1683690938055,COMM 10,A02,185189,Staff,0,2,25,25
1683690938055,COMM 10,A03,269821,Staff,0,1,0,0
1683690939079,COMM 100B,A02,185476,Staff,10,0,25,15
1683690939079,COMM 100B,A03,277340,Staff,25,0,25,0
1683690940105,COMM 100C,A01,185314,Staff,1,0,25,24
1683690940105,COMM 100C,A02,185327,Staff,17,0,25,8
1683690941129,COMM 110M,A00,185349,Staff,0,0,40,40
1683690942155,COMM 113T,A00,185352,Staff,25,0,40,15
1683690943181,COMM 114I,A00,185353,Staff,31,0,40,9
1683690944208,COMM 131,A00,185354,Staff,17,0,30,13
1683690945236,CSE 8A,A50,185358,Cao; Yingjun,0,46,10,10
1683690946259,CSE 8B,A01,185362,Staff,0,48,50,50
1683690947284,CSE 11,A01,185416,Cao; Yingjun,0,91,10,10
1683690948308,CSE 20,A01,185445,Briones; Jor-el Thomas Caparas,3,0,25,22
1683690949334,CSE 21,A01,185447,Staff,9,0,50,41
1683690950359,CSE 101,A01,185451,Staff,0,13,50,50
1683690950359,CSE 101,B01,185453,Jones; Miles E,0,14,50,50
1683690952414,CSE 141,A01,185458,Eldon; John,16,0,100,84
1683690953438,CSE 141L,A01,185461,Eldon; John,8,0,100,92
1683690954467,CSE 142,A01,185463,Staff,34,0,60,26
1683690954467,CSE 142,B01,201355,Staff,0,7,60,60
1683690955495,CSE 142L,A01,185470,Staff,34,0,60,26
1683690955495,CSE 142L,B01,201417,Staff,0,6,60,60
1683690956519,CSE 190,A00,201433,Staff,32,0,49,17
1683690957548,DOC 1,A01,259136,Strom; Megan C.,7,0,15,8
1683690957548,DOC 1,A02,259137,Strom; Megan C.,14,0,15,1
1683690957548,DOC 1,A03,259138,Strom; Megan C.,14,0,15,1
1683690957548,DOC 1,A04,259139,Strom; Megan C.,14,0,15,1
1683690958572,DOC 100D,A00,259140,Pass; Natalye Joann,14,0,25,11
1683690959600,DSGN 1,A01,184749,Rill; Bryan,0,26,30,30
1683690960625,DSGN 100,A01,185168,Staff,0,2,25,25
1683690961650,ECE 5,A01,185626,Morris; Karcher William,0,12,0,0
1683690962675,ECE 101,A01,185628,Staff,14,0,70,56
1683690963699,ECE 107,A01,185635,Baghdadchi; Saharnaz,0,0,20,20
1683690963699,ECE 107,A02,185638,Baghdadchi; Saharnaz,1,0,20,19
1683690964724,ECE 148,A01,185647,Silberman; Jack,0,0,16,16
1683690965747,ECON 1,A01,185537,Crane; Meredith Helen,54,0,70,16
1683690966772,ECON 3,A01,185549,Crane; Meredith Helen,30,0,70,40
1683690967801,ECON 4,A01,203354,Anderson; John Charles,0,5,10,10
1683690968827,ECON 100A,A01,185574,Staff,0,5,40,40
1683690969853,ECON 100B,A01,185576,Staff,0,12,50,50
1683690970881,ECON 100C,A01,185589,Newhouse; Herbert S,30,0,70,40
1683690971906,ECON 105,A00,185608,Vespa; Emanuel Ignacio,19,0,35,16
1683690972931,ECON 109,A01,185610,Shishkin; Denis,9,0,35,26
1683690973953,ECON 110A,A01,185612,Staff,8,0,40,32
1683690974979,ECON 120A,A01,185615,Staff,19,0,40,21
1683690976005,ECON 120C,A01,185617,Sun; Yixiao,0,21,70,70
1683690977034,ECON 144,A00,203346,Squires; Dale E,2,0,35,33
1683690978058,ECON 171,A01,203349,Newhouse; Herbert S,0,1,35,35
1683690979086,ECON 173A,A01,185621,Toda; Alexis Akira,21,0,35,14
1683690980112,EDS 25,A01,202413,Staff,0,1,0,0
1683690980112,EDS 25,A02,202414,Staff,0,1,0,0
1683690980112,EDS 25,A03,202415,Staff,0,0,0,0
1683690980112,EDS 25,A04,202416,Staff,0,1,0,0
1683690980112,EDS 25,A05,202439,Staff,0,0,0,0
1683690980112,EDS 25,A06,202440,Staff,0,0,0,0
1683690980112,EDS 25,B01,202631,Staff,0,0,0,0
1683690980112,EDS 25,B02,202632,Staff,0,0,0,0
1683690980112,EDS 25,B03,202639,Staff,0,0,0,0
1683690980112,EDS 25,B04,202640,Staff,0,0,0,0
1683690980112,EDS 25,B05,202643,Staff,0,0,0,0
1683690980112,EDS 25,B06,202644,Staff,0,0,0,0
1683690981138,EDS 38,A01,202659,Black; Alison Michelle,24,0,25,1
1683690982164,EDS 115,A00,202652,Staff,18,0,30,12
1683690983189,EDS 125,A00,202649,Staff,13,0,30,17
1683690984214,EDS 126,A01,203332,Staff,30,0,30,0
1683690985236,EDS 139,A00,202838,Staff,16,0,25,9
1683690986261,EDS 146,A01,202655,Staff,14,0,25,11
1683690987286,ENG 15,A00,185667,Staff,0,1,0,0
1683690987286,ENG 15,B00,185672,Staff,0,0,0,0
1683690987286,ENG 15,C00,185675,Staff,0,0,0,0
1683690987286,ENG 15,D00,185682,Staff,0,0,0,0
1683690987286,ENG 15,E00,185684,Staff,0,0,0,0
1683690988309,ETHN 103,A00,185710,Staff,0,8,35,35
1683690989334,ETHN 103A,A00,199228,Man; Simeon S,0,0,9,9
1683690990358,ETHN 109,A00,185711,Staff,15,0,35,20
1683690991384,ETHN 142,A00,185726,Staff,0,4,30,30
1683690992411,ETHN 163J,A00,199229,Man; Simeon S,5,0,8,3
1683690993438,ETHN 168,A00,185727,Staff,7,0,10,3
1683690994465,ETHN 182,A00,185728,Staff,0,0,35,35
1683690995489,ETHN 183,A00,185737,Staff,9,0,18,9
1683690996513,GLBH 111,A01,209361,Burgos; Jose L.,0,0,0,0
1683690998563,HIEU 104,A00,185792,Staff,14,0,20,6
1683690999589,HIEU 115,A00,185800,Staff,0,0,20,20
1683691000613,HIEU 128,A00,185801,Staff,0,9,20,20
1683691001641,HIEU 147,A00,185802,Staff,15,0,20,5
1683691002665,HIEU 154,A00,185823,Staff,11,0,20,9
1683691003691,HILA 102,A00,185826,Staff,14,0,20,6
1683691004715,HILD 2C,A01,185778,Staff,0,13,20,20
1683691005740,HILD 7B,A01,185780,Kwak; Nancy,0,17,32,32
1683691005740,HILD 7B,A02,185781,Kwak; Nancy,0,18,32,32
1683691006765,HILD 30,A01,185791,Staff,12,0,20,8
1683691007789,HISC 119,A00,185830,Golan; Tal,0,11,20,20
1683691008812,HITO 156GS,A00,185831,Patterson; Patrick H.,0,0,0,23
1683691009836,HIUS 103,A00,185832,Man; Simeon S,0,4,20,20
1683691010861,HIUS 117,A00,185836,Kwak; Nancy,2,0,20,18
1683691011886,HIUS 125,A00,185840,Man; Simeon S,0,3,23,23
1683691012911,HIUS 149,A00,185845,Staff,1,0,20,19
1683691013940,HUM 3,A01,185882,Zavodny; Tatiana Sophia,0,8,50,50
1683691013940,HUM 3,B01,185899,Caldwell; Michael Alan,0,18,50,50
1683691014964,HUM 3GS,A00,185900,Patterson; Patrick H.,0,0,0,23
1683691015989,HUM 4,A01,185938,Zroka; Amy Liane,28,0,50,22
1683691015989,HUM 4,B01,185956,Watkins; Eric,0,6,50,50
1683691015989,HUM 4,B02,202209,Watkins; Eric,0,5,50,50
1683691015989,HUM 4,B03,202210,Watkins; Eric,0,5,50,50
1683691017014,HUM 5,A01,185958,West; Geoffrey Scott,0,0,50,50
1683691017014,HUM 5,A02,202215,West; Geoffrey Scott,0,1,50,50
1683691018038,INTL 190,A00,185959,Gagnon; Jeffrey C,0,0,0,9
1683691018038,INTL 190,B00,185960,Lettieri; Michael Joseph,0,0,0,2
1683691019063,JAPN 180,A00,254509,Staff,5,0,30,25
1683691020088,LATI 10,A01,202853,Kennemore; Amy Michelle,4,0,35,31
1683691020088,LATI 10,A02,202854,Kennemore; Amy Michelle,3,0,35,32
1683691020088,LATI 10,A03,270054,Kennemore; Amy Michelle,30,0,30,0
1683691021113,LATI 180,A00,202855,Kennemore; Amy Michelle,11,0,20,9
1683691022193,LAWS 101,A00,201767,Golan; Tal,0,7,40,40
1683691023218,LIFR 1C,A00,185961,Staff,6,0,20,14
1683691024241,LIFR 1CX,A00,185962,Staff,7,0,20,13
1683691025265,LIFR 1D,A00,185963,Staff,7,0,20,13
1683691026289,LIFR 1DX,A00,185964,Staff,7,0,20,13
1683691027314,LIGN 101,A01,186039,Staff,43,0,50,7
1683691028342,LIGN 165,A00,186040,Staff,15,0,50,35
1683691029368,LTCS 108,A00,186041,Staff,5,0,10,5
1683691030397,LTCS 119,A00,186042,Staff,15,0,20,5
1683691031425,LTCS 130,A00,186043,Wesling; Megan E.,15,0,25,10
1683691033472,LTEA 138,A00,186119,Staff,14,0,40,26
1683691034496,LTEN 124,A00,186148,Staff,5,0,25,20
1683691035521,LTEN 178,A00,186149,Staff,6,0,15,9
1683691036543,LTEN 181,A00,186150,Blanco; John D,34,0,40,6
1683691037572,LTWL 120,A00,186160,Staff,19,0,25,6
1683691038596,LTWL 165,A00,186161,Staff,22,0,25,3
1683691039622,LTWR 100,A00,186162,Staff,0,5,15,15
1683691040647,LTWR 102,A00,186163,Doller; Ben,5,0,15,10
1683691041674,MAE 8,A01,186412,Staff,0,1,0,0
1683691042702,MAE 30B,A00,186445,Bahadori; Mohammad Yousef,81,0,100,19
1683691043726,MAE 40,A00,186592,Bewley; Thomas R,10,0,50,40
1683691044752,MAE 101B,A00,186593,Bahadori; Mohammad Yousef,80,0,100,20
1683691045780,MAE 105,A00,186594,Bandaru; Prabhakar,10,0,50,40
1683691046804,MAE 107,A00,186599,Pham; Hieu Tan,0,7,120,120
1683691047833,MAE 148,A01,186660,Silberman; Jack,3,0,16,13
1683691048861,MATH 10A,A01,188095,Staff,0,6,35,35
1683691049889,MATH 10B,A01,188097,Bowers; Adam R.,0,12,30,30
1683691049889,MATH 10B,A02,188099,Bowers; Adam R.,0,11,30,30
1683691049889,MATH 10B,B01,188104,Bowers; Adam R.,0,10,30,30
1683691049889,MATH 10B,B02,188106,Bowers; Adam R.,1,10,30,29
1683691050914,MATH 10C,A01,188111,Staff,0,20,30,30
1683691050914,MATH 10C,A02,188127,Staff,0,19,30,30
1683691050914,MATH 10C,A03,188131,Staff,0,19,30,30
1683691050914,MATH 10C,B01,188218,Staff,17,0,30,13
1683691050914,MATH 10C,B02,188244,Staff,13,0,30,17
1683691050914,MATH 10C,B03,188277,Staff,14,0,30,16
1683691051944,MATH 18,A01,188344,Bach; Quang Tran,18,0,30,12
1683691051944,MATH 18,A02,188345,Bach; Quang Tran,11,0,30,19
1683691051944,MATH 18,B01,188353,Bach; Quang Tran,11,0,30,19
1683691051944,MATH 18,B02,188354,Bach; Quang Tran,19,0,30,11
1683691052970,MATH 20A,A01,188374,Staff,11,0,35,24
1683691053998,MATH 20B,A01,188382,Ohm; Ko Woon,7,0,30,23
1683691053998,MATH 20B,A02,188383,Ohm; Ko Woon,22,0,30,8
1683691053998,MATH 20B,B01,188385,Ohm; Ko Woon,7,0,30,23
1683691053998,MATH 20B,B02,188392,Ohm; Ko Woon,22,0,30,8
1683691055022,MATH 20C,A01,188394,Harel; Guershon,10,0,30,20
1683691055022,MATH 20C,A02,188395,Harel; Guershon,13,0,30,17
1683691055022,MATH 20C,B01,188404,Harel; Guershon,5,0,30,25
1683691055022,MATH 20C,B02,188405,Harel; Guershon,18,0,30,12
1683691056053,MATH 20D,A01,188414,Hammock; Frances H,0,1,30,30
1683691056053,MATH 20D,A02,188415,Hammock; Frances H,0,1,30,30
1683691056053,MATH 20D,B01,188447,Hammock; Frances H,0,1,30,30
1683691056053,MATH 20D,B02,188486,Hammock; Frances H,2,0,30,28
1683691057081,MATH 20E,A01,188649,Staff,21,0,30,9
1683691057081,MATH 20E,A02,188650,Staff,20,0,30,10
1683691057081,MATH 20E,A03,188673,Staff,0,0,30,30
1683691058108,MATH 102,A01,188675,Staff,0,40,35,35
1683691059137,MATH 103B,A01,188681,Staff,3,0,35,32
1683691059137,MATH 103B,B01,188692,Staff,5,0,35,30
1683691060162,MATH 109,A01,188695,Salehi Golsefidy; Alireza,24,0,35,11
1683691060162,MATH 109,A02,188696,Salehi Golsefidy; Alireza,25,0,35,10
1683691061190,MATH 120A,A01,188698,Eggers; John Dietrich,7,0,35,28
1683691062217,MATH 142B,A01,188736,Ioana; Adrian,1,1,30,29
1683691062217,MATH 142B,A02,188741,Ioana; Adrian,0,1,30,30
1683691062217,MATH 142B,A03,188743,Ioana; Adrian,0,2,30,30
1683691063241,MATH 168A,A01,188790,Staff,0,11,35,35
1683691064268,MATH 170A,A01,188803,Nie; Jiawang,0,2,35,35
1683691064268,MATH 170A,A02,188811,Nie; Jiawang,0,1,35,35
1683691064268,MATH 170A,A03,188814,Nie; Jiawang,0,0,35,35
1683691064268,MATH 170A,A04,188815,Nie; Jiawang,5,0,35,30
1683691065295,MATH 193B,A01,188817,Staff,0,0,35,35
1683691065295,MATH 193B,A02,188818,Staff,6,0,35,29
1683691066320,MGT 4,A01,202857,Anderson; John Charles,59,0,80,21
1683691067348,MGT 12,A00,202858,Lindenberger; Wade Douglas,40,0,90,50
1683691068372,MGT 18,A00,202859,Staff,74,0,90,16
1683691069397,MGT 18GS,A00,202860,McKay; Michael J,13,0,28,15
1683691070423,MGT 45,A00,202861,Pecore; Joseph P.,8,0,90,82
1683691071451,MGT 100,A00,202863,Yavorsky; Daniel Ryan,27,0,90,63
1683691072475,MGT 103,A00,202864,Ehrich; Kristine R,0,19,90,90
1683691073499,MGT 112,A00,202865,Ehrich; Kristine R,15,0,90,75
1683691074524,MGT 121A,A00,202868,Staff,90,20,90,0
1683691075549,MGT 131B,A00,202869,Anderson; John Charles,58,0,90,32
1683691076577,MGT 136,A00,202871,Lindenberger; Wade Douglas,83,0,90,7
1683691077601,MGT 164,A00,202873,Staff,0,67,90,91
1683691078625,MGT 164GS,A00,202874,McKay; Mary A,13,0,28,15
1683691079650,MGT 180,A00,202875,Staff,0,51,90,91
1683691080674,MMW 11R,A01,205019,Herbst; Matthew,0,0,30,30
1683691080674,MMW 11R,A02,205026,Herbst; Matthew,29,0,30,1
1683691081703,MMW 15,A01,193512,Chang; Edmond Yi-Teh,0,8,28,28
1683691081703,MMW 15,A02,193513,Chang; Edmond Yi-Teh,0,5,28,28
1683691081703,MMW 15,A03,193514,Chang; Edmond Yi-Teh,0,5,28,28
1683691081703,MMW 15,A04,193515,Chang; Edmond Yi-Teh,0,5,28,28
1683691081703,MMW 15,A05,193516,Chang; Edmond Yi-Teh,0,5,28,28
1683691081703,MMW 15,A06,193517,Chang; Edmond Yi-Teh,0,6,28,28
1683691081703,MMW 15,B01,193519,Chang; Edmond Yi-Teh,0,5,28,28
1683691081703,MMW 15,B02,193520,Chang; Edmond Yi-Teh,0,5,28,28
1683691081703,MMW 15,B03,193521,Chang; Edmond Yi-Teh,0,5,28,28
1683691081703,MMW 15,B04,193522,Chang; Edmond Yi-Teh,0,6,28,28
1683691081703,MMW 15,B05,193523,Chang; Edmond Yi-Teh,0,5,28,28
1683691081703,MMW 15,B06,193524,Chang; Edmond Yi-Teh,0,5,28,28
1683691082728,MMW 122,A01,193526,Rahimi; Babak,0,16,28,28
1683691082728,MMW 122,A02,193527,Rahimi; Babak,0,15,28,28
1683691082728,MMW 122,A03,193528,Rahimi; Babak,0,0,0,0
1683691082728,MMW 122,A04,193529,Rahimi; Babak,0,0,0,0
1683691083757,MUS 1A,A01,186663,Staff,1,19,35,34
1683691084781,MUS 4,A01,186715,Staff,0,12,35,35
1683691085806,MUS 5R,A01,186796,Dubnov; Shlomo,0,17,35,35
1683691086830,MUS 6,A01,186798,Staff,1,5,25,24
1683691087858,MUS 7,A01,186830,Staff,11,0,35,24
1683691088881,MUS 8,A01,186930,Staff,0,27,35,35
1683691089905,MUS 15,A01,186932,Staff,0,15,35,35
1683691089905,MUS 15,B01,186934,Staff,1,17,35,34
1683691090930,MUS 80,A00,186935,Staff,0,0,20,20
1683691090930,MUS 80,B00,186936,Staff,24,0,25,1
1683691091958,NANO 11,A00,204702,Lipomi; Darren John,0,0,0,0
1683691092985,NANO 15,A01,204709,Yang; Kesong,0,1,0,0
1683691094009,NANO 114,A00,202069,Jahed Motlagh; Zeinab,2,0,10,8
1683691095042,PHIL 1,A00,186955,Grush; Rick Scott,31,0,40,9
1683691096067,PHIL 10,A01,186973,Grush; Rick Scott,27,0,35,8
1683691096067,PHIL 10,A02,186974,Grush; Rick Scott,33,0,35,2
1683691097092,PHIL 13,A01,186976,Staff,1,0,35,34
1683691097092,PHIL 13,A02,186977,Staff,16,0,35,19
1683691098116,PHIL 14,A01,186979,Staff,31,0,35,4
1683691098116,PHIL 14,A02,186986,Staff,32,0,35,3
1683691099142,PHIL 28,A01,186988,Staff,16,0,30,14
1683691099142,PHIL 28,A02,186989,Staff,1,0,30,29
1683691099142,PHIL 28,A03,186990,Staff,10,0,30,20
1683691099142,PHIL 28,A04,186991,Staff,26,0,30,4
1683691100166,PHIL 120,A00,186997,Staff,23,0,40,17
1683691101190,PHIL 137,A00,187003,Staff,7,0,40,33
1683691102214,PHIL 150,A00,187015,Staff,47,0,70,23
1683691103242,PHIL 167,A00,187021,Lamey; Andy M.,34,0,40,6
1683691104266,PHIL 174,A01,202226,Staff,17,0,20,3
1683691104266,PHIL 174,A02,202235,Staff,20,0,20,0
1683691105291,PHIL 191A,A00,258918,Staff,0,0,1,1
1683691106318,PHYS 1A,A00,187028,Staff,26,0,60,34
1683691107345,PHYS 1AL,001,187036,Staff,3,0,30,27
1683691107345,PHYS 1AL,002,187049,Staff,18,0,30,12
1683691108370,PHYS 1B,A00,187058,Staff,22,0,60,38
1683691109399,PHYS 1BL,001,187064,Staff,0,1,30,30
1683691109399,PHYS 1BL,002,187070,Staff,4,0,30,26
1683691110425,PHYS 1C,A00,187082,Staff,29,0,120,91
1683691111450,PHYS 1CL,001,187088,Staff,0,9,30,30
1683691111450,PHYS 1CL,002,187089,Staff,0,1,30,30
1683691111450,PHYS 1CL,009,262693,Staff,9,0,30,21
1683691112475,PHYS 2B,A01,187097,Staff,55,0,115,60
1683691113503,PHYS 2C,A01,187099,Staff,63,0,115,52
1683691114532,PHYS 2CL,A01,187101,Staff,5,0,28,23
1683691114532,PHYS 2CL,A02,187102,Staff,15,0,28,13
1683691115561,PHYS 2D,A01,187123,Shotwell; Brian,95,0,115,20
1683691116589,PHYS 4B,A01,187133,Grinstein; Benjamin,35,0,50,15
1683691117613,POLI 10,A00,188819,Staff,0,4,50,50
1683691118638,POLI 11,A00,188827,Staff,43,0,50,7
1683691119662,POLI 13R,A00,188828,Staff,0,1,20,20
1683691120687,POLI 27,A01,188830,Elgin; Samuel Zincke,0,2,70,70
1683691121712,POLI 30,A00,188832,Desposato; Scott,30,0,50,20
1683691122740,POLI 102F,A00,188834,Staff,1,0,40,39
1683691123768,POLI 104A,A00,188852,Staff,12,0,30,18
1683691124795,POLI 104I,A00,188853,Staff,0,8,20,20
1683691125893,POLI 110B,A00,188854,Wiens; David,6,0,20,14
1683691126921,POLI 112A,A00,188855,Wiens; David,3,0,30,27
1683691127947,POLI 117R,A00,188856,Forman; Fonna,0,12,20,20
1683691128972,POLI 118,A00,188857,Ingham; Sean,8,0,20,12
1683691129996,POLI 120G,A00,188858,Staff,8,0,30,22
1683691131021,POLI 131CR,A00,188863,Hoston; Germaine,20,0,50,30
1683691132045,POLI 133,A00,188864,Nellis; Gareth Hb,44,0,50,6
1683691133069,POLI 134D,A00,188865,Desposato; Scott,27,0,30,3
1683691134101,POLI 142A,A00,188871,Gartzke; Erik,21,0,50,29
1683691135127,POLI 142K,A00,188874,Staff,38,0,50,12
1683691136153,POLI 143,A00,188940,Gartzke; Erik,16,0,30,14
1683691137177,POLI 153,A00,188943,Staff,2,0,20,18
1683691138200,POLI 160AA,A00,188944,Staff,10,0,40,30
1683691139226,POLI 170A,A00,188945,Staff,10,0,30,20
1683691141274,PSYC 1,A00,188952,Staff,36,0,90,54
1683691142299,PSYC 2,B00,188953,Staff,19,0,35,16
1683691143326,PSYC 6,A00,188970,Staff,47,0,60,13
1683691144350,PSYC 7,A00,188973,Staff,35,0,45,10
1683691145374,PSYC 60,A01,188980,Rickard; Timothy C.,42,0,60,18
1683691146399,PSYC 70,A01,189001,Steiner; Eric Tomas,21,0,45,24
1683691147426,PSYC 100,A00,189005,Lacefield; Katharine I,0,99,120,120
1683691148451,PSYC 102,A00,189008,Staff,7,0,30,23
1683691149475,PSYC 106,B00,189026,Gorman; Michael R.,27,0,60,33
1683691150499,PSYC 114,B01,189033,Winkielman; Piotr,0,31,30,30
1683691151523,PSYC 131,A00,189036,Anagnostaras; Stephan,0,43,60,60
1683691152549,PSYC 136,A00,189041,Lowe; Angela Beth,0,7,25,25
1683691153576,PSYC 137,A00,189057,Winkielman; Piotr,1,37,25,24
1683691154604,PSYC 144,A00,189107,Wixted; John T,0,11,50,50
1683691156656,PSYC 162,A00,189142,Staff,0,9,85,85
1683691157681,PSYC 172,A00,189144,Gorman; Michael R.,0,6,30,30
1683691159731,PSYC 179,A00,189146,Lacefield; Katharine I,0,88,120,120
1683691160755,PSYC 181,A00,189147,Anagnostaras; Stephan,0,44,90,90
1683691161779,PSYC 190R,A00,189148,Barner; David A.,0,23,80,80
1683691162808,PSYC 191,A00,189275,Rickard; Timothy C.,0,11,25,25
1683691163843,PSYC 193,A00,189276,Chapman; Eddie Nathaniel,0,1,0,4
1683691164868,PSYC 193L,A01,189281,Lowe; Angela Beth,8,0,20,12
1683691164868,PSYC 193L,B01,189285,Staff,28,0,35,7
1683691165894,RELI 149,A00,187137,Rahimi; Babak,6,0,40,34
1683691166919,SE 9,A01,187315,Staff,0,2,18,18
1683691167942,SE 101B,A00,187409,Staff,24,0,30,6
1683691168967,SE 110B,A00,187444,Staff,10,0,40,30
1683691169994,SE 130B,A00,187449,Staff,31,0,40,9
1683691171018,SE 150A,A00,187516,Staff,8,0,20,12
1683691172042,SE 154,A00,187528,Staff,29,0,50,21
1683691173067,SIO 3,A01,258171,Staff,35,0,40,5
1683691174101,SIO 10,A00,187144,Cook; Geoffrey W,1,7,75,74
1683691175127,SIO 45,A00,187152,Cook; Geoffrey W,0,7,100,100
1683691176151,SIO 109R,A00,194486,Staff,0,4,20,20
1683691178200,SIO 187,A01,187233,Kacev; David,12,0,40,28
1683691179224,SOCI 1,A01,258656,Thorpe; Charles Robert,28,0,30,2
1683691179224,SOCI 1,A02,258658,Thorpe; Charles Robert,30,0,30,0
1683691179224,SOCI 1,A03,258661,Thorpe; Charles Robert,25,0,25,0
1683691179224,SOCI 1,A04,258666,Thorpe; Charles Robert,22,0,25,3
1683691179224,SOCI 1,A05,258897,Thorpe; Charles Robert,22,0,25,3
1683691179224,SOCI 1,A06,258898,Thorpe; Charles Robert,25,0,25,0
1683691180249,SOCI 30,A01,258903,Pardo Guerra; Juan Pablo,14,0,30,16
1683691181275,SOCI 102,A00,258904,Staff,9,0,25,16
1683691182299,SOCI 106,A00,258905,Staff,19,0,25,6
1683691183322,SOCI 111,A00,258907,Ribas Norris; Janet Vanesa,26,0,30,4
1683691184349,SOCI 121R,A00,258908,Pardo Guerra; Juan Pablo,8,0,30,22
1683691185374,SOCI 126,A01,203330,Staff,14,0,20,6
1683691186401,SOCI 131,A00,258909,Thorpe; Charles Robert,30,0,60,30
1683691187424,SOCI 135,A00,258910,Payne; Christine Anna,0,13,30,30
1683691188448,SOCI 157,A00,258911,Staff,11,0,30,19
1683691189477,SOCI 184,A00,258912,Staff,25,0,30,5
1683691190505,SOCI 188D,A00,258913,Staff,22,0,30,8
1683691191532,SYN 2,001,187529,Staff,9,0,16,7
1683691191532,SYN 2,002,201452,Staff,1,20,16,15
1683691191532,SYN 2,003,201469,Staff,1,0,16,15
1683691192555,SYN 100,A01,187531,Staff,0,9,20,20
1683691192555,SYN 100,B01,201491,Staff,0,10,20,20
1683691193579,TDAC 1,A00,189286,Walsh; Kim C.,3,0,20,17
1683691193579,TDAC 1,B00,189287,Harting; Carla Kelso,10,0,20,10
1683691194603,TDAC 101,A00,189300,Walsh; Kim C.,16,0,20,4
1683691194603,TDAC 101,B00,189301,Harting; Carla Kelso,18,0,20,2
1683691195628,TDAC 102,A00,189304,Basso; Beatrice,14,0,20,6
1683691196652,TDAC 108,A00,189305,Staff,18,0,20,2
1683691197678,TDDE 131,A00,189310,Staff,19,0,20,1
1683691197678,TDDE 131,B00,189314,Staff,19,0,20,1
1683691197678,TDDE 131,C00,189315,Staff,48,0,50,2
1683691197678,TDDE 131,D00,189316,Staff,14,0,15,1
1683691197678,TDDE 131,E00,204841,Staff,20,0,20,0
1683691198705,TDGE 10,A00,189289,Staff,27,0,50,23
1683691198705,TDGE 10,B00,189290,Havis; Allan,0,1,50,50
1683691199733,TDGE 11,A00,189291,Fulton; Julia,0,4,50,50
1683691199733,TDGE 11,B00,189292,Staff,20,0,25,5
1683691199733,TDGE 11,C00,260270,Staff,0,0,0,0
1683691200756,TDGE 25,A00,189294,Staff,1,0,20,19
1683691201781,TDGE 124,A00,189318,Fulton; Julia,1,8,50,49
1683691202805,TDGE 125,A00,189319,Staff,13,0,25,12
1683691202805,TDGE 125,B00,189320,Staff,23,0,25,2
1683691203829,TDGE 127,A00,189322,Havis; Allan,0,0,50,50
1683691204857,TDHT 101,A00,189323,Staff,18,0,25,7
1683691204857,TDHT 101,B00,189324,Staff,25,0,25,0
1683691205882,TDHT 102,A00,189325,Staff,49,0,50,1
1683691206908,TDMV 1,A00,189295,Arcidiacono; Kristin,20,0,30,10
1683691206908,TDMV 1,B00,189296,Caligagan; Maria T.,24,0,30,6
1683691207936,TDMV 2,A00,189297,Sammartano; Tonnie,27,0,30,3
1683691207936,TDMV 2,B00,189299,Arcidiacono; Kristin,23,0,30,7
1683691208963,TDMV 3,A00,204998,Rincon; Alicia,22,0,30,8
1683691209986,TDMV 120,A00,189458,Sammartano; Tonnie,28,0,30,2
1683691211014,TDMV 138,A00,189541,Jun; Grace Shin Hae,20,0,40,20
1683691212038,TDMV 142,A00,189717,Caligagan; Tony,25,0,30,5
1683691212038,TDMV 142,B00,189718,Caligagan; Maria T.,25,0,30,5
1683691213065,TMC 2,A01,187533,Staff,25,0,25,0
1683691213065,TMC 2,A02,187534,Staff,25,0,25,0
1683691214088,USP 1,A01,187536,Kwak; Nancy,0,16,25,25
1683691215115,USP 5,A01,187538,Staff,8,0,25,17
1683691216138,USP 101,A00,199253,Staff,0,4,0,0
1683691217165,USP 124,A00,187562,Boomhower; Matthew Charles,0,0,30,30
1683691218188,USP 138,A00,187582,Staff,19,0,25,6
1683691219212,USP 152,A01,187597,Staff,3,0,25,22
1683691220235,USP 153,A00,187598,Staff,18,0,25,7
1683691221262,USP 168,A00,187607,Kwak; Nancy,2,0,5,3
1683691222286,USP 173,A00,187619,Staff,4,0,25,21
1683691223309,USP 181,A00,187638,Staff,0,4,25,25
1683691224335,VIS 103,A00,187650,Cruz; Edwin Teddy,17,0,75,58
1683691225361,VIS 110D,A00,187669,Staff,13,0,22,9
1683691226384,VIS 127C,A00,187720,Shen; Kuiyi,67,0,146,79
1683691227408,VIS 149,A00,187731,Yoldas; Pinar,1,14,22,21
1683691228434,VIS 151,A01,188091,Staff,22,0,34,12
1683691228434,VIS 151,A02,188092,Staff,11,0,34,23
1683691229514,VIS 160B,A00,188093,Stalbaum; Brett,0,1,10,10
1683691231564,WCWP 10B,A00,201720,Staff,0,0,5,5
1683691231564,WCWP 10B,B00,201722,Staff,0,0,6,6
1683691232591,WCWP 100,A00,201725,Gagnon; Jeffrey C,0,0,2,2
1683691232591,WCWP 100,B00,201727,Staff,0,4,15,15
1683691235714,ANBI 133,A00,258401,Wilder; Linnea Lorene,34,0,40,6
1683691236737,ANBI 140,A00,258395,Hrvoj Mihic; Branka,18,0,25,7
1683691237761,ANSC 120,A00,258402,Bialecki; Jon Anthony,26,0,40,14
1683691238785,ANSC 144,A00,258400,Staff,12,0,40,28
1683691240833,ANSC 166,A00,258396,Parish; Steven Martin,156,0,175,19
1683691241857,ANSC 180,A00,193533,Staff,8,0,20,12
1683691242881,ANSC 188,A00,258397,Jassal; Aftab,34,0,40,6
1683691243909,ANTH 3,A01,258316,Staff,23,0,30,7
1683691244935,ANTH 5,A00,258394,Semendeferi; Ekaterini,16,0,20,4
1683691245962,ANTH 21,A01,258331,Staff,4,0,40,36
1683691246986,ANTH 103,A00,258398,Varma; Saiba,15,0,25,10
1683691248013,AWP 10,001,202034,Staff,0,0,0,0
1683691248013,AWP 10,002,202035,Staff,0,0,0,0
1683691248013,AWP 10,003,202036,Staff,0,0,0,0
1683691248013,AWP 10,004,202037,Staff,0,0,0,0
1683691248013,AWP 10,005,202038,Staff,0,0,0,0
1683691248013,AWP 10,006,202039,Staff,0,0,0,0
1683691248013,AWP 10,007,202040,Staff,0,0,0,0
1683691248013,AWP 10,008,202041,Staff,0,0,0,0
1683691248013,AWP 10,009,202042,Staff,0,0,0,0
1683691248013,AWP 10,010,202043,Staff,0,0,0,0
1683691248013,AWP 10,011,202044,Staff,0,0,0,0
1683691248013,AWP 10,012,202045,Staff,0,0,0,0
1683691248013,AWP 10,013,202046,Staff,0,0,0,0
1683691248013,AWP 10,014,202047,Staff,0,0,0,0
1683691248013,AWP 10,015,202048,Staff,0,0,0,0
1683691248013,AWP 10,016,202049,Staff,0,0,0,0
1683691248013,AWP 10,017,202050,Staff,0,0,0,0
1683691248013,AWP 10,018,202051,Staff,0,0,0,0
1683691248013,AWP 10,019,202052,Staff,0,0,0,0
1683691248013,AWP 10,020,202053,Staff,0,0,0,0
1683691248013,AWP 10,021,202054,Staff,0,0,0,0
1683691248013,AWP 10,022,202055,Staff,0,0,0,0
1683691248013,AWP 10,023,202056,Staff,0,0,0,0
1683691248013,AWP 10,024,202057,Staff,0,0,0,0
1683691248013,AWP 10,025,202058,Staff,0,0,0,0
1683691248013,AWP 10,026,202059,Staff,0,0,0,0
1683691249040,AWP 102,001,202032,Staff,0,0,0,0
1683691249040,AWP 102,002,202033,Staff,0,0,0,0
1683691250068,BENG 100,A01,254234,Taylor Amos; Alyssa C,31,0,40,9
1683691251093,BENG 196,001,270013,Engler; Adam J.,9999,0,9999,0
1683691252118,BICD 100R,A01,202018,Smith; Laurie,0,7,32,32
1683691252118,BICD 100R,A02,202019,Smith; Laurie,0,3,32,32
1683691252118,BICD 100R,A03,202020,Smith; Laurie,0,1,32,32
1683691252118,BICD 100R,A04,202021,Smith; Laurie,6,0,32,26
1683691252118,BICD 100R,A05,202022,Smith; Laurie,10,0,32,22
1683691253146,BICD 136,A01,193242,Gustafson-Brown; Cindy,0,2,32,32
1683691253146,BICD 136,A02,193244,Gustafson-Brown; Cindy,13,0,32,19
1683691254177,BIEB 102,A01,193249,Butler; Shannon Rhey,1,1,32,31
1683691254177,BIEB 102,A02,193251,Butler; Shannon Rhey,0,0,32,32
1683691254177,BIEB 102,A03,193253,Butler; Shannon Rhey,0,0,32,32
1683691254177,BIEB 102,A04,193255,Butler; Shannon Rhey,13,0,32,19
1683691254177,BIEB 102,A05,193265,Butler; Shannon Rhey,25,0,32,7
1683691254177,BIEB 102,A06,193269,Butler; Shannon Rhey,13,0,32,19
1683691256229,BIEB 150,A01,193274,Staff,0,0,32,32
1683691256229,BIEB 150,A02,193285,Staff,24,0,32,8
1683691257253,BIEB 194,A00,193286,Kurle; Carolyn M.,19,0,32,13
1683691258276,BILD 1,A01,192291,Staff,15,0,32,17
1683691258276,BILD 1,A02,192292,Staff,30,0,32,2
1683691258276,BILD 1,B01,192520,Reuther; Keefe,0,1,0,0
1683691258276,BILD 1,B02,192532,Reuther; Keefe,0,1,0,0
1683691259306,BILD 3,A01,192556,Butler; Shannon Rhey,0,0,32,32
1683691259306,BILD 3,A02,192581,Butler; Shannon Rhey,0,1,32,32
1683691259306,BILD 3,A03,192611,Butler; Shannon Rhey,19,0,32,13
1683691259306,BILD 3,A04,192612,Butler; Shannon Rhey,23,0,32,9
1683691259306,BILD 3,A05,192613,Butler; Shannon Rhey,26,0,32,6
1683691259306,BILD 3,A06,192679,Butler; Shannon Rhey,27,0,32,5
1683691259306,BILD 3,A07,192682,Butler; Shannon Rhey,20,0,32,12
1683691260331,BILD 4,A01,192836,Reuther; Keefe,1,0,24,23
1683691260331,BILD 4,A02,193044,Reuther; Keefe,4,0,24,20
1683691261358,BILD 10,A01,193142,Gustafson-Brown; Cindy,29,0,32,3
1683691261358,BILD 10,A02,193149,Gustafson-Brown; Cindy,31,0,32,1
1683691262386,BIMM 100,A01,193301,Staff,0,6,32,32
1683691262386,BIMM 100,A02,193312,Staff,0,7,32,32
1683691262386,BIMM 100,A03,193323,Staff,0,10,32,32
1683691263412,BIMM 101,A01,193329,McDonnell; Lisa Marie,1,4,24,23
1683691263412,BIMM 101,A02,193339,McDonnell; Lisa Marie,1,4,24,23
1683691263412,BIMM 101,B01,193354,McDonnell; Lisa Marie,0,4,24,24
1683691263412,BIMM 101,B02,193357,McDonnell; Lisa Marie,0,3,24,24
1683691264440,BIMM 110,A01,193377,Tat; John,0,11,32,32
1683691264440,BIMM 110,A02,193378,Tat; John,0,11,32,32
1683691265464,BIMM 120,A01,206116,Staff,0,0,32,32
1683691265464,BIMM 120,A02,206117,Staff,7,0,32,25
1683691265464,BIMM 120,A03,206121,Staff,21,0,32,11
1683691266489,BIPN 100,A01,193393,Park; Ji Young,0,15,32,32
1683691266489,BIPN 100,A02,193402,Park; Ji Young,0,14,32,32
1683691266489,BIPN 100,A03,193413,Park; Ji Young,0,14,32,32
1683691266489,BIPN 100,A04,193414,Park; Ji Young,0,13,32,32
1683691267512,BIPN 102,A01,193429,Staff,0,0,32,32
1683691267512,BIPN 102,A02,193438,Staff,18,0,32,14
1683691268536,BIPN 106,A01,193450,Reyes Gonzalez; Catalina,0,2,40,40
1683691269565,BIPN 134,A01,193465,Cooke; James Edward,0,0,32,32
1683691269565,BIPN 134,A02,193474,Cooke; James Edward,25,0,32,7
1683691269565,BIPN 134,A03,193485,Cooke; James Edward,29,0,32,3
1683691269565,BIPN 134,A04,193486,Cooke; James Edward,20,0,32,12
1683691269565,BIPN 134,A05,193491,Cooke; James Edward,31,0,32,1
1683691269565,BIPN 134,A06,193501,Cooke; James Edward,30,0,32,2
1683691269565,BIPN 134,A07,193510,Cooke; James Edward,29,0,32,3
1683691271615,BISP 194,A00,222522,Staff,14,0,32,18
1683691272642,CAT 124,A01,202407,Staff,19,0,25,6
1683691273668,CAT 125,A00,202408,Marchisotto; Jennifer Anne,2,0,20,18
1683691274693,CAT 125R,A00,202409,Smith; Lauryn Alissa,0,11,20,20
1683691274693,CAT 125R,B00,202410,Morales; Celeste Georgianna,0,11,20,20
1683691274693,CAT 125R,C00,202411,Irwin; Matthew Joseph,0,12,20,20
1683691275717,CENG 15,A01,204712,Yang; Kesong,0,1,0,0
1683691276741,CENG 114,A00,202070,Jahed Motlagh; Zeinab,5,0,20,15
1683691277767,CGS 105,A00,185477,Wesling; Megan E.,24,0,40,16
1683691278790,CGS 106,A00,185494,Staff,11,0,22,11
1683691279814,CGS 108,A00,185495,Staff,14,0,20,6
1683691280841,CGS 114,A00,185496,Staff,13,0,18,5
1683691281865,CGS 119,A00,185501,Staff,15,0,20,5
1683691282892,CGS 120,A00,185511,Staff,12,0,20,8
1683691283917,CHEM 4,A01,184675,Bussey; Thomas J,97,0,100,3
1683691284944,CHEM 6A,A01,184677,Staff,32,0,60,28
1683691285969,CHEM 6B,A01,184679,Staff,63,0,100,37
1683691286994,CHEM 6C,A01,184681,Bussey; Thomas J,0,0,50,50
1683691286994,CHEM 6C,A02,184682,Bussey; Thomas J,32,0,50,18
1683691288022,CHEM 40A,A01,184684,Albizati; Kim F.,33,0,100,67
1683691289046,CHEM 40B,A01,184686,Albizati; Kim F.,0,22,100,100
1683691290068,CHEM 41B,A01,184690,Staff,51,0,100,49
1683691291093,COGS 3,A01,184715,Boyle; Mary E. T.,0,27,40,40
1683691292117,COGS 14B,A01,185172,Staff,0,14,38,38
1683691293143,COGS 18,A01,184736,Staff,14,0,80,66
1683691294181,COGS 100,A01,184932,Staff,0,8,73,73
1683691295204,COGS 101A,A01,184935,Staff,0,40,30,30
1683691296228,COGS 101B,A01,184944,Staff,0,2,30,30
1683691297251,COGS 101C,A01,184946,Staff,0,10,30,30
1683691298275,COGS 102A,A01,184951,Johnson; Christine M.,1,0,40,39
1683691299300,COGS 107B,A01,184953,Mooshagian; Eric Frederick,0,52,40,40
1683691300326,COGS 118B,A01,184959,Gupta; Anjum,0,50,40,40
1683691301349,COGS 153,A00,184961,Staff,0,16,30,30
1683691302377,COGS 177,A00,184962,Staff,1,21,30,29
1683691303404,COGS 187A,A01,184969,Boyle; Mary E. T.,0,19,40,40
1683691304431,COMM 10,A01,185174,Staff,0,5,25,25
1683691304431,COMM 10,A02,185189,Staff,0,2,25,25
1683691304431,COMM 10,A03,269821,Staff,0,1,0,0
1683691305456,COMM 100B,A02,185476,Staff,10,0,25,15
1683691305456,COMM 100B,A03,277340,Staff,25,0,25,0
1683691306485,COMM 100C,A01,185314,Staff,1,0,25,24
1683691306485,COMM 100C,A02,185327,Staff,17,0,25,8
1683691307511,COMM 110M,A00,185349,Staff,0,0,40,40
1683691308535,COMM 113T,A00,185352,Staff,25,0,40,15
1683691309562,COMM 114I,A00,185353,Staff,31,0,40,9
1683691310586,COMM 131,A00,185354,Staff,17,0,30,13
1683691311613,CSE 8A,A50,185358,Cao; Yingjun,0,46,10,10
1683691312637,CSE 8B,A01,185362,Staff,0,48,50,50
1683691313666,CSE 11,A01,185416,Cao; Yingjun,0,91,10,10
1683691314694,CSE 20,A01,185445,Briones; Jor-el Thomas Caparas,3,0,25,22
1683691315718,CSE 21,A01,185447,Staff,9,0,50,41
1683691316745,CSE 101,A01,185451,Staff,0,13,50,50
1683691316745,CSE 101,B01,185453,Jones; Miles E,0,14,50,50
1683691318793,CSE 141,A01,185458,Eldon; John,16,0,100,84
1683691319821,CSE 141L,A01,185461,Eldon; John,8,0,100,92
1683691320848,CSE 142,A01,185463,Staff,34,0,60,26
1683691320848,CSE 142,B01,201355,Staff,0,7,60,60
1683691321874,CSE 142L,A01,185470,Staff,34,0,60,26
1683691321874,CSE 142L,B01,201417,Staff,0,6,60,60
1683691322901,CSE 190,A00,201433,Staff,32,0,49,17
1683691323931,DOC 1,A01,259136,Strom; Megan C.,7,0,15,8
1683691323931,DOC 1,A02,259137,Strom; Megan C.,14,0,15,1
1683691323931,DOC 1,A03,259138,Strom; Megan C.,14,0,15,1
1683691323931,DOC 1,A04,259139,Strom; Megan C.,14,0,15,1
1683691324956,DOC 100D,A00,259140,Pass; Natalye Joann,14,0,25,11
1683691325983,DSGN 1,A01,184749,Rill; Bryan,0,26,30,30
1683691327009,DSGN 100,A01,185168,Staff,0,2,25,25
1683691328033,ECE 5,A01,185626,Morris; Karcher William,0,12,0,0
1683691329060,ECE 101,A01,185628,Staff,14,0,70,56
1683691330084,ECE 107,A01,185635,Baghdadchi; Saharnaz,0,0,20,20
1683691330084,ECE 107,A02,185638,Baghdadchi; Saharnaz,1,0,20,19
1683691331111,ECE 148,A01,185647,Silberman; Jack,0,0,16,16
1683691332138,ECON 1,A01,185537,Crane; Meredith Helen,54,0,70,16
1683691333221,ECON 3,A01,185549,Crane; Meredith Helen,30,0,70,40
1683691334246,ECON 4,A01,203354,Anderson; John Charles,0,5,10,10
1683691335273,ECON 100A,A01,185574,Staff,0,5,40,40
1683691336300,ECON 100B,A01,185576,Staff,0,12,50,50
1683691337328,ECON 100C,A01,185589,Newhouse; Herbert S,30,0,70,40
1683691338355,ECON 105,A00,185608,Vespa; Emanuel Ignacio,19,0,35,16
1683691339380,ECON 109,A01,185610,Shishkin; Denis,9,0,35,26
1683691340404,ECON 110A,A01,185612,Staff,8,0,40,32
1683691341432,ECON 120A,A01,185615,Staff,19,0,40,21
1683691342456,ECON 120C,A01,185617,Sun; Yixiao,0,21,70,70
1683691343483,ECON 144,A00,203346,Squires; Dale E,2,0,35,33
1683691344508,ECON 171,A01,203349,Newhouse; Herbert S,0,1,35,35
1683691345533,ECON 173A,A01,185621,Toda; Alexis Akira,21,0,35,14
1683691346561,EDS 25,A01,202413,Staff,0,1,0,0
1683691346561,EDS 25,A02,202414,Staff,0,1,0,0
1683691346561,EDS 25,A03,202415,Staff,0,0,0,0
1683691346561,EDS 25,A04,202416,Staff,0,1,0,0
1683691346561,EDS 25,A05,202439,Staff,0,0,0,0
1683691346561,EDS 25,A06,202440,Staff,0,0,0,0
1683691346561,EDS 25,B01,202631,Staff,0,0,0,0
1683691346561,EDS 25,B02,202632,Staff,0,0,0,0
1683691346561,EDS 25,B03,202639,Staff,0,0,0,0
1683691346561,EDS 25,B04,202640,Staff,0,0,0,0
1683691346561,EDS 25,B05,202643,Staff,0,0,0,0
1683691346561,EDS 25,B06,202644,Staff,0,0,0,0
1683691347586,EDS 38,A01,202659,Black; Alison Michelle,24,0,25,1
1683691348613,EDS 115,A00,202652,Staff,18,0,30,12
1683691349640,EDS 125,A00,202649,Staff,13,0,30,17
1683691350664,EDS 126,A01,203332,Staff,30,0,30,0
1683691351687,EDS 139,A00,202838,Staff,16,0,25,9
1683691352715,EDS 146,A01,202655,Staff,14,0,25,11
1683691353749,ENG 15,A00,185667,Staff,0,1,0,0
1683691353749,ENG 15,B00,185672,Staff,0,0,0,0
1683691353749,ENG 15,C00,185675,Staff,0,0,0,0
1683691353749,ENG 15,D00,185682,Staff,0,0,0,0
1683691353749,ENG 15,E00,185684,Staff,0,0,0,0
1683691354775,ETHN 103,A00,185710,Staff,0,8,35,35
1683691355803,ETHN 103A,A00,199228,Man; Simeon S,0,0,9,9
1683691356826,ETHN 109,A00,185711,Staff,15,0,35,20
1683691357850,ETHN 142,A00,185726,Staff,0,4,30,30
1683691358875,ETHN 163J,A00,199229,Man; Simeon S,5,0,8,3
1683691359899,ETHN 168,A00,185727,Staff,7,0,10,3
1683691360923,ETHN 182,A00,185728,Staff,0,0,35,35
1683691361946,ETHN 183,A00,185737,Staff,9,0,18,9
1683691362971,GLBH 111,A01,209361,Burgos; Jose L.,0,0,0,0
1683691365017,HIEU 104,A00,185792,Staff,14,0,20,6
1683691366042,HIEU 115,A00,185800,Staff,0,0,20,20
1683691367065,HIEU 128,A00,185801,Staff,0,9,20,20
1683691368095,HIEU 147,A00,185802,Staff,15,0,20,5
1683691369119,HIEU 154,A00,185823,Staff,11,0,20,9
1683691370145,HILA 102,A00,185826,Staff,14,0,20,6
1683691371169,HILD 2C,A01,185778,Staff,0,13,20,20
1683691372194,HILD 7B,A01,185780,Kwak; Nancy,0,17,32,32
1683691372194,HILD 7B,A02,185781,Kwak; Nancy,0,18,32,32
1683691373224,HILD 30,A01,185791,Staff,12,0,20,8
1683691374250,HISC 119,A00,185830,Golan; Tal,0,11,20,20
1683691375276,HITO 156GS,A00,185831,Patterson; Patrick H.,0,0,0,23
1683691376304,HIUS 103,A00,185832,Man; Simeon S,0,4,20,20
1683691377330,HIUS 117,A00,185836,Kwak; Nancy,2,0,20,18
1683691378355,HIUS 125,A00,185840,Man; Simeon S,0,3,23,23
1683691379381,HIUS 149,A00,185845,Staff,1,0,20,19
1683691380408,HUM 3,A01,185882,Zavodny; Tatiana Sophia,0,8,50,50
1683691380408,HUM 3,B01,185899,Caldwell; Michael Alan,0,18,50,50
1683691381433,HUM 3GS,A00,185900,Patterson; Patrick H.,0,0,0,23
1683691382463,HUM 4,A01,185938,Zroka; Amy Liane,28,0,50,22
1683691382463,HUM 4,B01,185956,Watkins; Eric,0,6,50,50
1683691382463,HUM 4,B02,202209,Watkins; Eric,0,5,50,50
1683691382463,HUM 4,B03,202210,Watkins; Eric,0,5,50,50
1683691383491,HUM 5,A01,185958,West; Geoffrey Scott,0,0,50,50
1683691383491,HUM 5,A02,202215,West; Geoffrey Scott,0,1,50,50
1683691384516,INTL 190,A00,185959,Gagnon; Jeffrey C,0,0,0,9
1683691384516,INTL 190,B00,185960,Lettieri; Michael Joseph,0,0,0,2
1683691385541,JAPN 180,A00,254509,Staff,5,0,30,25
1683691386565,LATI 10,A01,202853,Kennemore; Amy Michelle,4,0,35,31
1683691386565,LATI 10,A02,202854,Kennemore; Amy Michelle,3,0,35,32
1683691386565,LATI 10,A03,270054,Kennemore; Amy Michelle,30,0,30,0
1683691387589,LATI 180,A00,202855,Kennemore; Amy Michelle,11,0,20,9
1683691388613,LAWS 101,A00,201767,Golan; Tal,0,7,40,40
1683691389636,LIFR 1C,A00,185961,Staff,6,0,20,14
1683691390659,LIFR 1CX,A00,185962,Staff,7,0,20,13
1683691391683,LIFR 1D,A00,185963,Staff,7,0,20,13
1683691392710,LIFR 1DX,A00,185964,Staff,7,0,20,13
1683691393738,LIGN 101,A01,186039,Staff,43,0,50,7
1683691394766,LIGN 165,A00,186040,Staff,15,0,50,35
1683691395789,LTCS 108,A00,186041,Staff,5,0,10,5
1683691396813,LTCS 119,A00,186042,Staff,15,0,20,5
1683691397838,LTCS 130,A00,186043,Wesling; Megan E.,15,0,25,10
1683691399892,LTEA 138,A00,186119,Staff,14,0,40,26
1683691400922,LTEN 124,A00,186148,Staff,5,0,25,20
1683691401949,LTEN 178,A00,186149,Staff,6,0,15,9
1683691402977,LTEN 181,A00,186150,Blanco; John D,34,0,40,6
1683691404001,LTWL 120,A00,186160,Staff,19,0,25,6
1683691405024,LTWL 165,A00,186161,Staff,22,0,25,3
1683691406048,LTWR 100,A00,186162,Staff,0,5,15,15
1683691407071,LTWR 102,A00,186163,Doller; Ben,5,0,15,10
1683691408099,MAE 8,A01,186412,Staff,0,1,0,0
1683691409122,MAE 30B,A00,186445,Bahadori; Mohammad Yousef,81,0,100,19
1683691410146,MAE 40,A00,186592,Bewley; Thomas R,10,0,50,40
1683691411171,MAE 101B,A00,186593,Bahadori; Mohammad Yousef,80,0,100,20
1683691412194,MAE 105,A00,186594,Bandaru; Prabhakar,10,0,50,40
1683691413217,MAE 107,A00,186599,Pham; Hieu Tan,0,7,120,120
1683691414247,MAE 148,A01,186660,Silberman; Jack,3,0,16,13
1683691415275,MATH 10A,A01,188095,Staff,0,6,35,35
1683691416300,MATH 10B,A01,188097,Bowers; Adam R.,0,12,30,30
1683691416300,MATH 10B,A02,188099,Bowers; Adam R.,0,11,30,30
1683691416300,MATH 10B,B01,188104,Bowers; Adam R.,0,10,30,30
1683691416300,MATH 10B,B02,188106,Bowers; Adam R.,1,10,30,29
1683691417330,MATH 10C,A01,188111,Staff,0,20,30,30
1683691417330,MATH 10C,A02,188127,Staff,0,19,30,30
1683691417330,MATH 10C,A03,188131,Staff,0,19,30,30
1683691417330,MATH 10C,B01,188218,Staff,17,0,30,13
1683691417330,MATH 10C,B02,188244,Staff,13,0,30,17
1683691417330,MATH 10C,B03,188277,Staff,14,0,30,16
1683691418354,MATH 18,A01,188344,Bach; Quang Tran,18,0,30,12
1683691418354,MATH 18,A02,188345,Bach; Quang Tran,11,0,30,19
1683691418354,MATH 18,B01,188353,Bach; Quang Tran,11,0,30,19
1683691418354,MATH 18,B02,188354,Bach; Quang Tran,19,0,30,11
1683691419381,MATH 20A,A01,188374,Staff,11,0,35,24
1683691420406,MATH 20B,A01,188382,Ohm; Ko Woon,7,0,30,23
1683691420406,MATH 20B,A02,188383,Ohm; Ko Woon,22,0,30,8
1683691420406,MATH 20B,B01,188385,Ohm; Ko Woon,7,0,30,23
1683691420406,MATH 20B,B02,188392,Ohm; Ko Woon,22,0,30,8
1683691421434,MATH 20C,A01,188394,Harel; Guershon,10,0,30,20
1683691421434,MATH 20C,A02,188395,Harel; Guershon,13,0,30,17
1683691421434,MATH 20C,B01,188404,Harel; Guershon,5,0,30,25
1683691421434,MATH 20C,B02,188405,Harel; Guershon,18,0,30,12
1683691422461,MATH 20D,A01,188414,Hammock; Frances H,0,1,30,30
1683691422461,MATH 20D,A02,188415,Hammock; Frances H,0,1,30,30
1683691422461,MATH 20D,B01,188447,Hammock; Frances H,0,1,30,30
1683691422461,MATH 20D,B02,188486,Hammock; Frances H,2,0,30,28
1683691423490,MATH 20E,A01,188649,Staff,21,0,30,9
1683691423490,MATH 20E,A02,188650,Staff,20,0,30,10
1683691423490,MATH 20E,A03,188673,Staff,0,0,30,30
1683691424515,MATH 102,A01,188675,Staff,0,40,35,35
1683691425541,MATH 103B,A01,188681,Staff,3,0,35,32
1683691425541,MATH 103B,B01,188692,Staff,5,0,35,30
1683691426570,MATH 109,A01,188695,Salehi Golsefidy; Alireza,24,0,35,11
1683691426570,MATH 109,A02,188696,Salehi Golsefidy; Alireza,25,0,35,10
1683691427597,MATH 120A,A01,188698,Eggers; John Dietrich,7,0,35,28
1683691428625,MATH 142B,A01,188736,Ioana; Adrian,1,1,30,29
1683691428625,MATH 142B,A02,188741,Ioana; Adrian,0,1,30,30
1683691428625,MATH 142B,A03,188743,Ioana; Adrian,0,2,30,30
1683691429648,MATH 168A,A01,188790,Staff,0,11,35,35
1683691430674,MATH 170A,A01,188803,Nie; Jiawang,0,2,35,35
1683691430674,MATH 170A,A02,188811,Nie; Jiawang,0,1,35,35
1683691430674,MATH 170A,A03,188814,Nie; Jiawang,0,0,35,35
1683691430674,MATH 170A,A04,188815,Nie; Jiawang,5,0,35,30
1683691431700,MATH 193B,A01,188817,Staff,0,0,35,35
1683691431700,MATH 193B,A02,188818,Staff,6,0,35,29
1683691432727,MGT 4,A01,202857,Anderson; John Charles,59,0,80,21
1683691433751,MGT 12,A00,202858,Lindenberger; Wade Douglas,40,0,90,50
1683691434775,MGT 18,A00,202859,Staff,74,0,90,16
1683691435799,MGT 18GS,A00,202860,McKay; Michael J,13,0,28,15
1683691436879,MGT 45,A00,202861,Pecore; Joseph P.,8,0,90,82
1683691437909,MGT 100,A00,202863,Yavorsky; Daniel Ryan,27,0,90,63
1683691438946,MGT 103,A00,202864,Ehrich; Kristine R,0,19,90,90
1683691439973,MGT 112,A00,202865,Ehrich; Kristine R,15,0,90,75
1683691441000,MGT 121A,A00,202868,Staff,90,20,90,0
1683691442028,MGT 131B,A00,202869,Anderson; John Charles,58,0,90,32
1683691443056,MGT 136,A00,202871,Lindenberger; Wade Douglas,83,0,90,7
1683691444080,MGT 164,A00,202873,Staff,0,67,90,91
1683691445104,MGT 164GS,A00,202874,McKay; Mary A,13,0,28,15
1683691446128,MGT 180,A00,202875,Staff,0,51,90,91
1683691447152,MMW 11R,A01,205019,Herbst; Matthew,0,0,30,30
1683691447152,MMW 11R,A02,205026,Herbst; Matthew,29,0,30,1
1683691448178,MMW 15,A01,193512,Chang; Edmond Yi-Teh,0,8,28,28
1683691448178,MMW 15,A02,193513,Chang; Edmond Yi-Teh,0,5,28,28
1683691448178,MMW 15,A03,193514,Chang; Edmond Yi-Teh,0,5,28,28
1683691448178,MMW 15,A04,193515,Chang; Edmond Yi-Teh,0,5,28,28
1683691448178,MMW 15,A05,193516,Chang; Edmond Yi-Teh,0,5,28,28
1683691448178,MMW 15,A06,193517,Chang; Edmond Yi-Teh,0,6,28,28
1683691448178,MMW 15,B01,193519,Chang; Edmond Yi-Teh,0,5,28,28
1683691448178,MMW 15,B02,193520,Chang; Edmond Yi-Teh,0,5,28,28
1683691448178,MMW 15,B03,193521,Chang; Edmond Yi-Teh,0,5,28,28
1683691448178,MMW 15,B04,193522,Chang; Edmond Yi-Teh,0,6,28,28
1683691448178,MMW 15,B05,193523,Chang; Edmond Yi-Teh,0,5,28,28
1683691448178,MMW 15,B06,193524,Chang; Edmond Yi-Teh,0,5,28,28
1683691449203,MMW 122,A01,193526,Rahimi; Babak,0,16,28,28
1683691449203,MMW 122,A02,193527,Rahimi; Babak,0,15,28,28
1683691449203,MMW 122,A03,193528,Rahimi; Babak,0,0,0,0
1683691449203,MMW 122,A04,193529,Rahimi; Babak,0,0,0,0
1683691450226,MUS 1A,A01,186663,Staff,1,19,35,34
1683691451253,MUS 4,A01,186715,Staff,0,12,35,35
1683691452282,MUS 5R,A01,186796,Dubnov; Shlomo,0,17,35,35
1683691453310,MUS 6,A01,186798,Staff,1,5,25,24
1683691454334,MUS 7,A01,186830,Staff,11,0,35,24
1683691455361,MUS 8,A01,186930,Staff,0,27,35,35
1683691456385,MUS 15,A01,186932,Staff,0,15,35,35
1683691456385,MUS 15,B01,186934,Staff,1,17,35,34
1683691457413,MUS 80,A00,186935,Staff,0,0,20,20
1683691457413,MUS 80,B00,186936,Staff,24,0,25,1
1683691458436,NANO 11,A00,204702,Lipomi; Darren John,0,0,0,0
1683691459464,NANO 15,A01,204709,Yang; Kesong,0,1,0,0
1683691460493,NANO 114,A00,202069,Jahed Motlagh; Zeinab,2,0,10,8
1683691461518,PHIL 1,A00,186955,Grush; Rick Scott,31,0,40,9
1683691462543,PHIL 10,A01,186973,Grush; Rick Scott,27,0,35,8
1683691462543,PHIL 10,A02,186974,Grush; Rick Scott,33,0,35,2
1683691463568,PHIL 13,A01,186976,Staff,1,0,35,34
1683691463568,PHIL 13,A02,186977,Staff,16,0,35,19
1683691464596,PHIL 14,A01,186979,Staff,31,0,35,4
1683691464596,PHIL 14,A02,186986,Staff,32,0,35,3
1683691465619,PHIL 28,A01,186988,Staff,16,0,30,14
1683691465619,PHIL 28,A02,186989,Staff,1,0,30,29
1683691465619,PHIL 28,A03,186990,Staff,10,0,30,20
1683691465619,PHIL 28,A04,186991,Staff,26,0,30,4
1683691466643,PHIL 120,A00,186997,Staff,23,0,40,17
1683691467670,PHIL 137,A00,187003,Staff,7,0,40,33
1683691468694,PHIL 150,A00,187015,Staff,47,0,70,23
1683691469718,PHIL 167,A00,187021,Lamey; Andy M.,34,0,40,6
1683691470745,PHIL 174,A01,202226,Staff,17,0,20,3
1683691470745,PHIL 174,A02,202235,Staff,20,0,20,0
1683691471769,PHIL 191A,A00,258918,Staff,0,0,1,1
1683691472792,PHYS 1A,A00,187028,Staff,26,0,60,34
1683691473817,PHYS 1AL,001,187036,Staff,3,0,30,27
1683691473817,PHYS 1AL,002,187049,Staff,18,0,30,12
1683691474841,PHYS 1B,A00,187058,Staff,22,0,60,38
1683691475868,PHYS 1BL,001,187064,Staff,0,1,30,30
1683691475868,PHYS 1BL,002,187070,Staff,4,0,30,26
1683691476892,PHYS 1C,A00,187082,Staff,29,0,120,91
1683691477915,PHYS 1CL,001,187088,Staff,0,9,30,30
1683691477915,PHYS 1CL,002,187089,Staff,0,1,30,30
1683691477915,PHYS 1CL,009,262693,Staff,9,0,30,21
1683691478939,PHYS 2B,A01,187097,Staff,55,0,115,60
1683691479966,PHYS 2C,A01,187099,Staff,63,0,115,52
1683691480991,PHYS 2CL,A01,187101,Staff,5,0,28,23
1683691480991,PHYS 2CL,A02,187102,Staff,15,0,28,13
1683691482015,PHYS 2D,A01,187123,Shotwell; Brian,95,0,115,20
1683691483042,PHYS 4B,A01,187133,Grinstein; Benjamin,35,0,50,15
1683691484069,POLI 10,A00,188819,Staff,0,4,50,50
1683691485096,POLI 11,A00,188827,Staff,43,0,50,7
1683691486120,POLI 13R,A00,188828,Staff,0,1,20,20
1683691487145,POLI 27,A01,188830,Elgin; Samuel Zincke,0,2,70,70
1683691488170,POLI 30,A00,188832,Desposato; Scott,30,0,50,20
1683691489194,POLI 102F,A00,188834,Staff,1,0,40,39
1683691490221,POLI 104A,A00,188852,Staff,12,0,30,18
1683691491245,POLI 104I,A00,188853,Staff,0,8,20,20
1683691492270,POLI 110B,A00,188854,Wiens; David,6,0,20,14
1683691493297,POLI 112A,A00,188855,Wiens; David,3,0,30,27
1683691494324,POLI 117R,A00,188856,Forman; Fonna,0,12,20,20
1683691495349,POLI 118,A00,188857,Ingham; Sean,8,0,20,12
1683691496373,POLI 120G,A00,188858,Staff,8,0,30,22
1683691497401,POLI 131CR,A00,188863,Hoston; Germaine,20,0,50,30
1683691498425,POLI 133,A00,188864,Nellis; Gareth Hb,44,0,50,6
1683691499450,POLI 134D,A00,188865,Desposato; Scott,27,0,30,3
1683691500472,POLI 142A,A00,188871,Gartzke; Erik,21,0,50,29
1683691501496,POLI 142K,A00,188874,Staff,38,0,50,12
1683691502519,POLI 143,A00,188940,Gartzke; Erik,16,0,30,14
1683691503543,POLI 153,A00,188943,Staff,2,0,20,18
1683691504571,POLI 160AA,A00,188944,Staff,10,0,40,30
1683691505598,POLI 170A,A00,188945,Staff,10,0,30,20
1683691507651,PSYC 1,A00,188952,Staff,36,0,90,54
1683691508678,PSYC 2,B00,188953,Staff,19,0,35,16
1683691509702,PSYC 6,A00,188970,Staff,47,0,60,13
1683691510729,PSYC 7,A00,188973,Staff,35,0,45,10
1683691511753,PSYC 60,A01,188980,Rickard; Timothy C.,42,0,60,18
1683691512781,PSYC 70,A01,189001,Steiner; Eric Tomas,21,0,45,24
1683691513808,PSYC 100,A00,189005,Lacefield; Katharine I,0,99,120,120
1683691514835,PSYC 102,A00,189008,Staff,7,0,30,23
1683691515863,PSYC 106,B00,189026,Gorman; Michael R.,27,0,60,33
1683691516891,PSYC 114,B01,189033,Winkielman; Piotr,0,31,30,30
1683691517919,PSYC 131,A00,189036,Anagnostaras; Stephan,0,43,60,60
1683691518945,PSYC 136,A00,189041,Lowe; Angela Beth,0,7,25,25
1683691519968,PSYC 137,A00,189057,Winkielman; Piotr,1,37,25,24
1683691520993,PSYC 144,A00,189107,Wixted; John T,0,11,50,50
1683691523040,PSYC 162,A00,189142,Staff,0,9,85,85
1683691524065,PSYC 172,A00,189144,Gorman; Michael R.,0,6,30,30
1683691526117,PSYC 179,A00,189146,Lacefield; Katharine I,0,88,120,120
1683691527142,PSYC 181,A00,189147,Anagnostaras; Stephan,0,44,90,90
1683691528166,PSYC 190R,A00,189148,Barner; David A.,0,23,80,80
1683691529194,PSYC 191,A00,189275,Rickard; Timothy C.,0,11,25,25
1683691530222,PSYC 193,A00,189276,Chapman; Eddie Nathaniel,0,1,0,4
1683691531246,PSYC 193L,A01,189281,Lowe; Angela Beth,8,0,20,12
1683691531246,PSYC 193L,B01,189285,Staff,28,0,35,7
1683691532269,RELI 149,A00,187137,Rahimi; Babak,6,0,40,34
1683691533296,SE 9,A01,187315,Staff,0,2,18,18
1683691534321,SE 101B,A00,187409,Staff,24,0,30,6
1683691535345,SE 110B,A00,187444,Staff,10,0,40,30
1683691536372,SE 130B,A00,187449,Staff,31,0,40,9
1683691537398,SE 150A,A00,187516,Staff,8,0,20,12
1683691538425,SE 154,A00,187528,Staff,29,0,50,21
1683691539452,SIO 3,A01,258171,Staff,35,0,40,5
1683691540534,SIO 10,A00,187144,Cook; Geoffrey W,1,7,75,74
1683691541562,SIO 45,A00,187152,Cook; Geoffrey W,0,7,100,100
1683691542587,SIO 109R,A00,194486,Staff,0,4,20,20
1683691544641,SIO 187,A01,187233,Kacev; David,12,0,40,28
1683691545670,SOCI 1,A01,258656,Thorpe; Charles Robert,28,0,30,2
1683691545670,SOCI 1,A02,258658,Thorpe; Charles Robert,30,0,30,0
1683691545670,SOCI 1,A03,258661,Thorpe; Charles Robert,25,0,25,0
1683691545670,SOCI 1,A04,258666,Thorpe; Charles Robert,22,0,25,3
1683691545670,SOCI 1,A05,258897,Thorpe; Charles Robert,22,0,25,3
1683691545670,SOCI 1,A06,258898,Thorpe; Charles Robert,25,0,25,0
1683691546695,SOCI 30,A01,258903,Pardo Guerra; Juan Pablo,14,0,30,16
1683691547719,SOCI 102,A00,258904,Staff,9,0,25,16
1683691548745,SOCI 106,A00,258905,Staff,19,0,25,6
1683691549777,SOCI 111,A00,258907,Ribas Norris; Janet Vanesa,26,0,30,4
1683691550805,SOCI 121R,A00,258908,Pardo Guerra; Juan Pablo,8,0,30,22
1683691551831,SOCI 126,A01,203330,Staff,14,0,20,6
1683691552855,SOCI 131,A00,258909,Thorpe; Charles Robert,30,0,60,30
1683691553883,SOCI 135,A00,258910,Payne; Christine Anna,0,13,30,30
1683691554906,SOCI 157,A00,258911,Staff,11,0,30,19
1683691555931,SOCI 184,A00,258912,Staff,25,0,30,5
1683691556955,SOCI 188D,A00,258913,Staff,22,0,30,8
1683691557983,SYN 2,001,187529,Staff,9,0,16,7
1683691557983,SYN 2,002,201452,Staff,1,20,16,15
1683691557983,SYN 2,003,201469,Staff,1,0,16,15
1683691559007,SYN 100,A01,187531,Staff,0,9,20,20
1683691559007,SYN 100,B01,201491,Staff,0,10,20,20
1683691560037,TDAC 1,A00,189286,Walsh; Kim C.,3,0,20,17
1683691560037,TDAC 1,B00,189287,Harting; Carla Kelso,10,0,20,10
1683691561065,TDAC 101,A00,189300,Walsh; Kim C.,16,0,20,4
1683691561065,TDAC 101,B00,189301,Harting; Carla Kelso,18,0,20,2
1683691562095,TDAC 102,A00,189304,Basso; Beatrice,14,0,20,6
1683691563121,TDAC 108,A00,189305,Staff,18,0,20,2
1683691564152,TDDE 131,A00,189310,Staff,19,0,20,1
1683691564152,TDDE 131,B00,189314,Staff,19,0,20,1
1683691564152,TDDE 131,C00,189315,Staff,48,0,50,2
1683691564152,TDDE 131,D00,189316,Staff,14,0,15,1
1683691564152,TDDE 131,E00,204841,Staff,20,0,20,0
1683691565180,TDGE 10,A00,189289,Staff,27,0,50,23
1683691565180,TDGE 10,B00,189290,Havis; Allan,0,1,50,50
1683691566206,TDGE 11,A00,189291,Fulton; Julia,0,4,50,50
1683691566206,TDGE 11,B00,189292,Staff,20,0,25,5
1683691566206,TDGE 11,C00,260270,Staff,0,0,0,0
1683691567229,TDGE 25,A00,189294,Staff,1,0,20,19
1683691568255,TDGE 124,A00,189318,Fulton; Julia,1,8,50,49
1683691569279,TDGE 125,A00,189319,Staff,13,0,25,12
1683691569279,TDGE 125,B00,189320,Staff,23,0,25,2
1683691570305,TDGE 127,A00,189322,Havis; Allan,0,0,50,50
1683691571328,TDHT 101,A00,189323,Staff,18,0,25,7
1683691571328,TDHT 101,B00,189324,Staff,25,0,25,0
1683691572354,TDHT 102,A00,189325,Staff,49,0,50,1
1683691573380,TDMV 1,A00,189295,Arcidiacono; Kristin,20,0,30,10
1683691573380,TDMV 1,B00,189296,Caligagan; Maria T.,24,0,30,6
1683691574406,TDMV 2,A00,189297,Sammartano; Tonnie,27,0,30,3
1683691574406,TDMV 2,B00,189299,Arcidiacono; Kristin,23,0,30,7
1683691575431,TDMV 3,A00,204998,Rincon; Alicia,22,0,30,8
1683691576455,TDMV 120,A00,189458,Sammartano; Tonnie,28,0,30,2
1683691577482,TDMV 138,A00,189541,Jun; Grace Shin Hae,20,0,40,20
1683691578511,TDMV 142,A00,189717,Caligagan; Tony,25,0,30,5
1683691578511,TDMV 142,B00,189718,Caligagan; Maria T.,25,0,30,5
1683691579535,TMC 2,A01,187533,Staff,25,0,25,0
1683691579535,TMC 2,A02,187534,Staff,25,0,25,0
1683691580563,USP 1,A01,187536,Kwak; Nancy,0,16,25,25
1683691581588,USP 5,A01,187538,Staff,8,0,25,17
1683691582612,USP 101,A00,199253,Staff,0,4,0,0
1683691583640,USP 124,A00,187562,Boomhower; Matthew Charles,0,0,30,30
1683691584668,USP 138,A00,187582,Staff,19,0,25,6
1683691585693,USP 152,A01,187597,Staff,3,0,25,22
1683691586718,USP 153,A00,187598,Staff,18,0,25,7
1683691587742,USP 168,A00,187607,Kwak; Nancy,2,0,5,3
1683691588766,USP 173,A00,187619,Staff,4,0,25,21
1683691589794,USP 181,A00,187638,Staff,0,4,25,25
1683691590820,VIS 103,A00,187650,Cruz; Edwin Teddy,17,0,75,58
1683691591845,VIS 110D,A00,187669,Staff,13,0,22,9
1683691592869,VIS 127C,A00,187720,Shen; Kuiyi,67,0,146,79
1683691593894,VIS 149,A00,187731,Yoldas; Pinar,1,14,22,21
1683691594919,VIS 151,A01,188091,Staff,22,0,34,12
1683691594919,VIS 151,A02,188092,Staff,11,0,34,23
1683691595943,VIS 160B,A00,188093,Stalbaum; Brett,0,1,10,10
1683691597991,WCWP 10B,A00,201720,Staff,0,0,5,5
1683691597991,WCWP 10B,B00,201722,Staff,0,0,6,6
1683691599015,WCWP 100,A00,201725,Gagnon; Jeffrey C,0,0,2,2
1683691599015,WCWP 100,B00,201727,Staff,0,4,15,15
1683691602134,ANBI 133,A00,258401,Wilder; Linnea Lorene,34,0,40,6
1683691603157,ANBI 140,A00,258395,Hrvoj Mihic; Branka,18,0,25,7
1683691604181,ANSC 120,A00,258402,Bialecki; Jon Anthony,26,0,40,14
1683691605207,ANSC 144,A00,258400,Staff,12,0,40,28
1683691607259,ANSC 166,A00,258396,Parish; Steven Martin,156,0,175,19
1683691608282,ANSC 180,A00,193533,Staff,8,0,20,12
1683691609307,ANSC 188,A00,258397,Jassal; Aftab,34,0,40,6
1683691610336,ANTH 3,A01,258316,Staff,23,0,30,7
1683691611362,ANTH 5,A00,258394,Semendeferi; Ekaterini,16,0,20,4
1683691612389,ANTH 21,A01,258331,Staff,4,0,40,36
1683691613411,ANTH 103,A00,258398,Varma; Saiba,15,0,25,10
1683691614444,AWP 10,001,202034,Staff,0,0,0,0
1683691614444,AWP 10,002,202035,Staff,0,0,0,0
1683691614444,AWP 10,003,202036,Staff,0,0,0,0
1683691614444,AWP 10,004,202037,Staff,0,0,0,0
1683691614444,AWP 10,005,202038,Staff,0,0,0,0
1683691614444,AWP 10,006,202039,Staff,0,0,0,0
1683691614444,AWP 10,007,202040,Staff,0,0,0,0
1683691614444,AWP 10,008,202041,Staff,0,0,0,0
1683691614444,AWP 10,009,202042,Staff,0,0,0,0
1683691614444,AWP 10,010,202043,Staff,0,0,0,0
1683691614444,AWP 10,011,202044,Staff,0,0,0,0
1683691614444,AWP 10,012,202045,Staff,0,0,0,0
1683691614444,AWP 10,013,202046,Staff,0,0,0,0
1683691614444,AWP 10,014,202047,Staff,0,0,0,0
1683691614444,AWP 10,015,202048,Staff,0,0,0,0
1683691614444,AWP 10,016,202049,Staff,0,0,0,0
1683691614444,AWP 10,017,202050,Staff,0,0,0,0
1683691614444,AWP 10,018,202051,Staff,0,0,0,0
1683691614444,AWP 10,019,202052,Staff,0,0,0,0
1683691614444,AWP 10,020,202053,Staff,0,0,0,0
1683691614444,AWP 10,021,202054,Staff,0,0,0,0
1683691614444,AWP 10,022,202055,Staff,0,0,0,0
1683691614444,AWP 10,023,202056,Staff,0,0,0,0
1683691614444,AWP 10,024,202057,Staff,0,0,0,0
1683691614444,AWP 10,025,202058,Staff,0,0,0,0
1683691614444,AWP 10,026,202059,Staff,0,0,0,0
1683691615468,AWP 102,001,202032,Staff,0,0,0,0
1683691615468,AWP 102,002,202033,Staff,0,0,0,0
1683691616495,BENG 100,A01,254234,Taylor Amos; Alyssa C,31,0,40,9
1683691617522,BENG 196,001,270013,Engler; Adam J.,9999,0,9999,0
1683691618548,BICD 100R,A01,202018,Smith; Laurie,0,7,32,32
1683691618548,BICD 100R,A02,202019,Smith; Laurie,0,3,32,32
1683691618548,BICD 100R,A03,202020,Smith; Laurie,0,1,32,32
1683691618548,BICD 100R,A04,202021,Smith; Laurie,6,0,32,26
1683691618548,BICD 100R,A05,202022,Smith; Laurie,10,0,32,22
1683691619573,BICD 136,A01,193242,Gustafson-Brown; Cindy,0,2,32,32
1683691619573,BICD 136,A02,193244,Gustafson-Brown; Cindy,13,0,32,19
1683691620599,BIEB 102,A01,193249,Butler; Shannon Rhey,1,1,32,31
1683691620599,BIEB 102,A02,193251,Butler; Shannon Rhey,0,0,32,32
1683691620599,BIEB 102,A03,193253,Butler; Shannon Rhey,0,0,32,32
1683691620599,BIEB 102,A04,193255,Butler; Shannon Rhey,13,0,32,19
1683691620599,BIEB 102,A05,193265,Butler; Shannon Rhey,25,0,32,7
1683691620599,BIEB 102,A06,193269,Butler; Shannon Rhey,13,0,32,19
1683691622650,BIEB 150,A01,193274,Staff,0,0,32,32
1683691622650,BIEB 150,A02,193285,Staff,24,0,32,8
1683691623675,BIEB 194,A00,193286,Kurle; Carolyn M.,19,0,32,13
1683691624704,BILD 1,A01,192291,Staff,15,0,32,17
1683691624704,BILD 1,A02,192292,Staff,30,0,32,2
1683691624704,BILD 1,B01,192520,Reuther; Keefe,0,1,0,0
1683691624704,BILD 1,B02,192532,Reuther; Keefe,0,1,0,0
1683691625730,BILD 3,A01,192556,Butler; Shannon Rhey,0,0,32,32
1683691625730,BILD 3,A02,192581,Butler; Shannon Rhey,0,1,32,32
1683691625730,BILD 3,A03,192611,Butler; Shannon Rhey,19,0,32,13
1683691625730,BILD 3,A04,192612,Butler; Shannon Rhey,23,0,32,9
1683691625730,BILD 3,A05,192613,Butler; Shannon Rhey,26,0,32,6
1683691625730,BILD 3,A06,192679,Butler; Shannon Rhey,27,0,32,5
1683691625730,BILD 3,A07,192682,Butler; Shannon Rhey,20,0,32,12
1683691626759,BILD 4,A01,192836,Reuther; Keefe,1,0,24,23
1683691626759,BILD 4,A02,193044,Reuther; Keefe,4,0,24,20
1683691627784,BILD 10,A01,193142,Gustafson-Brown; Cindy,29,0,32,3
1683691627784,BILD 10,A02,193149,Gustafson-Brown; Cindy,31,0,32,1
1683691628809,BIMM 100,A01,193301,Staff,0,6,32,32
1683691628809,BIMM 100,A02,193312,Staff,0,7,32,32
1683691628809,BIMM 100,A03,193323,Staff,0,10,32,32
1683691629835,BIMM 101,A01,193329,McDonnell; Lisa Marie,1,4,24,23
1683691629835,BIMM 101,A02,193339,McDonnell; Lisa Marie,1,4,24,23
1683691629835,BIMM 101,B01,193354,McDonnell; Lisa Marie,0,4,24,24
1683691629835,BIMM 101,B02,193357,McDonnell; Lisa Marie,0,3,24,24
1683691630863,BIMM 110,A01,193377,Tat; John,0,11,32,32
1683691630863,BIMM 110,A02,193378,Tat; John,0,11,32,32
1683691631888,BIMM 120,A01,206116,Staff,0,0,32,32
1683691631888,BIMM 120,A02,206117,Staff,7,0,32,25
1683691631888,BIMM 120,A03,206121,Staff,21,0,32,11
1683691632916,BIPN 100,A01,193393,Park; Ji Young,0,15,32,32
1683691632916,BIPN 100,A02,193402,Park; Ji Young,0,14,32,32
1683691632916,BIPN 100,A03,193413,Park; Ji Young,0,14,32,32
1683691632916,BIPN 100,A04,193414,Park; Ji Young,0,13,32,32
1683691633944,BIPN 102,A01,193429,Staff,0,0,32,32
1683691633944,BIPN 102,A02,193438,Staff,18,0,32,14
1683691634967,BIPN 106,A01,193450,Reyes Gonzalez; Catalina,0,2,40,40
1683691635992,BIPN 134,A01,193465,Cooke; James Edward,0,0,32,32
1683691635992,BIPN 134,A02,193474,Cooke; James Edward,25,0,32,7
1683691635992,BIPN 134,A03,193485,Cooke; James Edward,29,0,32,3
1683691635992,BIPN 134,A04,193486,Cooke; James Edward,20,0,32,12
1683691635992,BIPN 134,A05,193491,Cooke; James Edward,31,0,32,1
1683691635992,BIPN 134,A06,193501,Cooke; James Edward,30,0,32,2
1683691635992,BIPN 134,A07,193510,Cooke; James Edward,29,0,32,3
1683691638040,BISP 194,A00,222522,Staff,14,0,32,18
1683691639067,CAT 124,A01,202407,Staff,19,0,25,6
1683691640095,CAT 125,A00,202408,Marchisotto; Jennifer Anne,2,0,20,18
1683691641119,CAT 125R,A00,202409,Smith; Lauryn Alissa,0,11,20,20
1683691641119,CAT 125R,B00,202410,Morales; Celeste Georgianna,0,11,20,20
1683691641119,CAT 125R,C00,202411,Irwin; Matthew Joseph,0,12,20,20
1683691642146,CENG 15,A01,204712,Yang; Kesong,0,1,0,0
1683691643174,CENG 114,A00,202070,Jahed Motlagh; Zeinab,5,0,20,15
1683691644268,CGS 105,A00,185477,Wesling; Megan E.,24,0,40,16
1683691645292,CGS 106,A00,185494,Staff,11,0,22,11
1683691646315,CGS 108,A00,185495,Staff,14,0,20,6
1683691647342,CGS 114,A00,185496,Staff,13,0,18,5
1683691648365,CGS 119,A00,185501,Staff,15,0,20,5
1683691649388,CGS 120,A00,185511,Staff,12,0,20,8
1683691650412,CHEM 4,A01,184675,Bussey; Thomas J,97,0,100,3
1683691651435,CHEM 6A,A01,184677,Staff,32,0,60,28
1683691652459,CHEM 6B,A01,184679,Staff,63,0,100,37
1683691653487,CHEM 6C,A01,184681,Bussey; Thomas J,0,0,50,50
1683691653487,CHEM 6C,A02,184682,Bussey; Thomas J,32,0,50,18
1683691654511,CHEM 40A,A01,184684,Albizati; Kim F.,33,0,100,67
1683691655535,CHEM 40B,A01,184686,Albizati; Kim F.,0,22,100,100
1683691656564,CHEM 41B,A01,184690,Staff,51,0,100,49
1683691657589,COGS 3,A01,184715,Boyle; Mary E. T.,0,27,40,40
1683691658621,COGS 14B,A01,185172,Staff,0,14,38,38
1683691659649,COGS 18,A01,184736,Staff,14,0,80,66
1683691660676,COGS 100,A01,184932,Staff,0,8,73,73
1683691661705,COGS 101A,A01,184935,Staff,0,40,30,30
1683691662730,COGS 101B,A01,184944,Staff,0,2,30,30
1683691663754,COGS 101C,A01,184946,Staff,0,10,30,30
1683691664779,COGS 102A,A01,184951,Johnson; Christine M.,1,0,40,39
1683691665807,COGS 107B,A01,184953,Mooshagian; Eric Frederick,0,52,40,40
1683691666831,COGS 118B,A01,184959,Gupta; Anjum,0,50,40,40
1683691667859,COGS 153,A00,184961,Staff,0,16,30,30
1683691668884,COGS 177,A00,184962,Staff,1,21,30,29
1683691669910,COGS 187A,A01,184969,Boyle; Mary E. T.,0,19,40,40
1683691670938,COMM 10,A01,185174,Staff,0,5,25,25
1683691670938,COMM 10,A02,185189,Staff,0,2,25,25
1683691670938,COMM 10,A03,269821,Staff,0,1,0,0
1683691671966,COMM 100B,A02,185476,Staff,10,0,25,15
1683691671966,COMM 100B,A03,277340,Staff,25,0,25,0
1683691672990,COMM 100C,A01,185314,Staff,1,0,25,24
1683691672990,COMM 100C,A02,185327,Staff,17,0,25,8
1683691674015,COMM 110M,A00,185349,Staff,0,0,40,40
1683691675039,COMM 113T,A00,185352,Staff,25,0,40,15
1683691676065,COMM 114I,A00,185353,Staff,31,0,40,9
1683691677090,COMM 131,A00,185354,Staff,17,0,30,13
1683691678112,CSE 8A,A50,185358,Cao; Yingjun,0,46,10,10
1683691679136,CSE 8B,A01,185362,Staff,0,48,50,50
1683691680160,CSE 11,A01,185416,Cao; Yingjun,0,91,10,10
1683691681186,CSE 20,A01,185445,Briones; Jor-el Thomas Caparas,3,0,25,22
1683691682211,CSE 21,A01,185447,Staff,9,0,50,41
1683691683236,CSE 101,A01,185451,Staff,0,13,50,50
1683691683236,CSE 101,B01,185453,Jones; Miles E,0,14,50,50
1683691685290,CSE 141,A01,185458,Eldon; John,16,0,100,84
1683691686319,CSE 141L,A01,185461,Eldon; John,8,0,100,92
1683691687343,CSE 142,A01,185463,Staff,34,0,60,26
1683691687343,CSE 142,B01,201355,Staff,0,7,60,60
1683691688371,CSE 142L,A01,185470,Staff,34,0,60,26
1683691688371,CSE 142L,B01,201417,Staff,0,6,60,60
1683691689393,CSE 190,A00,201433,Staff,32,0,49,17
1683691690418,DOC 1,A01,259136,Strom; Megan C.,7,0,15,8
1683691690418,DOC 1,A02,259137,Strom; Megan C.,14,0,15,1
1683691690418,DOC 1,A03,259138,Strom; Megan C.,14,0,15,1
1683691690418,DOC 1,A04,259139,Strom; Megan C.,14,0,15,1
1683691691442,DOC 100D,A00,259140,Pass; Natalye Joann,14,0,25,11
1683691692468,DSGN 1,A01,184749,Rill; Bryan,0,26,30,30
1683691693492,DSGN 100,A01,185168,Staff,0,2,25,25
1683691694517,ECE 5,A01,185626,Morris; Karcher William,0,12,0,0
1683691695542,ECE 101,A01,185628,Staff,14,0,70,56
1683691696567,ECE 107,A01,185635,Baghdadchi; Saharnaz,0,0,20,20
1683691696567,ECE 107,A02,185638,Baghdadchi; Saharnaz,1,0,20,19
1683691697591,ECE 148,A01,185647,Silberman; Jack,0,0,16,16
1683691698617,ECON 1,A01,185537,Crane; Meredith Helen,54,0,70,16
1683691699645,ECON 3,A01,185549,Crane; Meredith Helen,30,0,70,40
1683691700669,ECON 4,A01,203354,Anderson; John Charles,0,5,10,10
1683691701693,ECON 100A,A01,185574,Staff,0,5,40,40
1683691702717,ECON 100B,A01,185576,Staff,0,12,50,50
1683691703742,ECON 100C,A01,185589,Newhouse; Herbert S,30,0,70,40
1683691704766,ECON 105,A00,185608,Vespa; Emanuel Ignacio,19,0,35,16
1683691705798,ECON 109,A01,185610,Shishkin; Denis,9,0,35,26
1683691706822,ECON 110A,A01,185612,Staff,8,0,40,32
1683691707850,ECON 120A,A01,185615,Staff,19,0,40,21
1683691708878,ECON 120C,A01,185617,Sun; Yixiao,0,21,70,70
1683691709903,ECON 144,A00,203346,Squires; Dale E,2,0,35,33
1683691710929,ECON 171,A01,203349,Newhouse; Herbert S,0,1,35,35
1683691711954,ECON 173A,A01,185621,Toda; Alexis Akira,21,0,35,14
1683691712981,EDS 25,A01,202413,Staff,0,1,0,0
1683691712981,EDS 25,A02,202414,Staff,0,1,0,0
1683691712981,EDS 25,A03,202415,Staff,0,0,0,0
1683691712981,EDS 25,A04,202416,Staff,0,1,0,0
1683691712981,EDS 25,A05,202439,Staff,0,0,0,0
1683691712981,EDS 25,A06,202440,Staff,0,0,0,0
1683691712981,EDS 25,B01,202631,Staff,0,0,0,0
1683691712981,EDS 25,B02,202632,Staff,0,0,0,0
1683691712981,EDS 25,B03,202639,Staff,0,0,0,0
1683691712981,EDS 25,B04,202640,Staff,0,0,0,0
1683691712981,EDS 25,B05,202643,Staff,0,0,0,0
1683691712981,EDS 25,B06,202644,Staff,0,0,0,0
1683691714011,EDS 38,A01,202659,Black; Alison Michelle,24,0,25,1
1683691715041,EDS 115,A00,202652,Staff,18,0,30,12
1683691716065,EDS 125,A00,202649,Staff,13,0,30,17
1683691717088,EDS 126,A01,203332,Staff,30,0,30,0
1683691718112,EDS 139,A00,202838,Staff,16,0,25,9
1683691719138,EDS 146,A01,202655,Staff,14,0,25,11
1683691720162,ENG 15,A00,185667,Staff,0,1,0,0
1683691720162,ENG 15,B00,185672,Staff,0,0,0,0
1683691720162,ENG 15,C00,185675,Staff,0,0,0,0
1683691720162,ENG 15,D00,185682,Staff,0,0,0,0
1683691720162,ENG 15,E00,185684,Staff,0,0,0,0
1683691721190,ETHN 103,A00,185710,Staff,0,8,35,35
1683691722216,ETHN 103A,A00,199228,Man; Simeon S,0,0,9,9
1683691723242,ETHN 109,A00,185711,Staff,15,0,35,20
1683691724268,ETHN 142,A00,185726,Staff,0,4,30,30
1683691725294,ETHN 163J,A00,199229,Man; Simeon S,5,0,8,3
1683691726320,ETHN 168,A00,185727,Staff,7,0,10,3
1683691727344,ETHN 182,A00,185728,Staff,0,0,35,35
1683691728368,ETHN 183,A00,185737,Staff,9,0,18,9
1683691729394,GLBH 111,A01,209361,Burgos; Jose L.,0,0,0,0
1683691731445,HIEU 104,A00,185792,Staff,14,0,20,6
1683691732472,HIEU 115,A00,185800,Staff,0,0,20,20
1683691733499,HIEU 128,A00,185801,Staff,0,9,20,20
1683691734523,HIEU 147,A00,185802,Staff,15,0,20,5
1683691735546,HIEU 154,A00,185823,Staff,11,0,20,9
1683691736571,HILA 102,A00,185826,Staff,14,0,20,6
1683691737598,HILD 2C,A01,185778,Staff,0,13,20,20
1683691738625,HILD 7B,A01,185780,Kwak; Nancy,0,17,32,32
1683691738625,HILD 7B,A02,185781,Kwak; Nancy,0,18,32,32
1683691739650,HILD 30,A01,185791,Staff,12,0,20,8
1683691740675,HISC 119,A00,185830,Golan; Tal,0,11,20,20
1683691741698,HITO 156GS,A00,185831,Patterson; Patrick H.,0,0,0,23
1683691742725,HIUS 103,A00,185832,Man; Simeon S,0,4,20,20
1683691743754,HIUS 117,A00,185836,Kwak; Nancy,2,0,20,18
1683691744778,HIUS 125,A00,185840,Man; Simeon S,0,3,23,23
1683691745805,HIUS 149,A00,185845,Staff,1,0,20,19
1683691746830,HUM 3,A01,185882,Zavodny; Tatiana Sophia,0,8,50,50
1683691746830,HUM 3,B01,185899,Caldwell; Michael Alan,0,18,50,50
1683691747910,HUM 3GS,A00,185900,Patterson; Patrick H.,0,0,0,23
1683691748940,HUM 4,A01,185938,Zroka; Amy Liane,28,0,50,22
1683691748940,HUM 4,B01,185956,Watkins; Eric,0,6,50,50
1683691748940,HUM 4,B02,202209,Watkins; Eric,0,5,50,50
1683691748940,HUM 4,B03,202210,Watkins; Eric,0,5,50,50
1683691749974,HUM 5,A01,185958,West; Geoffrey Scott,0,0,50,50
1683691749974,HUM 5,A02,202215,West; Geoffrey Scott,0,1,50,50
1683691751001,INTL 190,A00,185959,Gagnon; Jeffrey C,0,0,0,9
1683691751001,INTL 190,B00,185960,Lettieri; Michael Joseph,0,0,0,2
1683691752027,JAPN 180,A00,254509,Staff,5,0,30,25
1683691753055,LATI 10,A01,202853,Kennemore; Amy Michelle,4,0,35,31
1683691753055,LATI 10,A02,202854,Kennemore; Amy Michelle,3,0,35,32
1683691753055,LATI 10,A03,270054,Kennemore; Amy Michelle,30,0,30,0
1683691754079,LATI 180,A00,202855,Kennemore; Amy Michelle,11,0,20,9
1683691755103,LAWS 101,A00,201767,Golan; Tal,0,7,40,40
1683691756130,LIFR 1C,A00,185961,Staff,6,0,20,14
1683691757157,LIFR 1CX,A00,185962,Staff,7,0,20,13
1683691758183,LIFR 1D,A00,185963,Staff,7,0,20,13
1683691759206,LIFR 1DX,A00,185964,Staff,7,0,20,13
1683691760230,LIGN 101,A01,186039,Staff,43,0,50,7
1683691761254,LIGN 165,A00,186040,Staff,15,0,50,35
1683691762279,LTCS 108,A00,186041,Staff,5,0,10,5
1683691763306,LTCS 119,A00,186042,Staff,15,0,20,5
1683691764331,LTCS 130,A00,186043,Wesling; Megan E.,15,0,25,10
1683691766379,LTEA 138,A00,186119,Staff,14,0,40,26
1683691767403,LTEN 124,A00,186148,Staff,5,0,25,20
1683691768426,LTEN 178,A00,186149,Staff,6,0,15,9
1683691769450,LTEN 181,A00,186150,Blanco; John D,34,0,40,6
1683691770474,LTWL 120,A00,186160,Staff,19,0,25,6
1683691771501,LTWL 165,A00,186161,Staff,22,0,25,3
1683691772524,LTWR 100,A00,186162,Staff,0,5,15,15
1683691773549,LTWR 102,A00,186163,Doller; Ben,5,0,15,10
1683691774575,MAE 8,A01,186412,Staff,0,1,0,0
1683691775600,MAE 30B,A00,186445,Bahadori; Mohammad Yousef,81,0,100,19
1683691776623,MAE 40,A00,186592,Bewley; Thomas R,10,0,50,40
1683691777646,MAE 101B,A00,186593,Bahadori; Mohammad Yousef,80,0,100,20
1683691778670,MAE 105,A00,186594,Bandaru; Prabhakar,10,0,50,40
1683691779694,MAE 107,A00,186599,Pham; Hieu Tan,0,7,120,120
1683691780718,MAE 148,A01,186660,Silberman; Jack,3,0,16,13
1683691781741,MATH 10A,A01,188095,Staff,0,6,35,35
1683691782766,MATH 10B,A01,188097,Bowers; Adam R.,0,12,30,30
1683691782766,MATH 10B,A02,188099,Bowers; Adam R.,0,11,30,30
1683691782766,MATH 10B,B01,188104,Bowers; Adam R.,0,10,30,30
1683691782766,MATH 10B,B02,188106,Bowers; Adam R.,1,10,30,29
1683691783790,MATH 10C,A01,188111,Staff,0,20,30,30
1683691783790,MATH 10C,A02,188127,Staff,0,19,30,30
1683691783790,MATH 10C,A03,188131,Staff,0,19,30,30
1683691783790,MATH 10C,B01,188218,Staff,17,0,30,13
1683691783790,MATH 10C,B02,188244,Staff,13,0,30,17
1683691783790,MATH 10C,B03,188277,Staff,14,0,30,16
1683691784819,MATH 18,A01,188344,Bach; Quang Tran,18,0,30,12
1683691784819,MATH 18,A02,188345,Bach; Quang Tran,11,0,30,19
1683691784819,MATH 18,B01,188353,Bach; Quang Tran,11,0,30,19
1683691784819,MATH 18,B02,188354,Bach; Quang Tran,19,0,30,11
1683691785846,MATH 20A,A01,188374,Staff,11,0,35,24
1683691786873,MATH 20B,A01,188382,Ohm; Ko Woon,7,0,30,23
1683691786873,MATH 20B,A02,188383,Ohm; Ko Woon,22,0,30,8
1683691786873,MATH 20B,B01,188385,Ohm; Ko Woon,7,0,30,23
1683691786873,MATH 20B,B02,188392,Ohm; Ko Woon,22,0,30,8
1683691787897,MATH 20C,A01,188394,Harel; Guershon,10,0,30,20
1683691787897,MATH 20C,A02,188395,Harel; Guershon,13,0,30,17
1683691787897,MATH 20C,B01,188404,Harel; Guershon,5,0,30,25
1683691787897,MATH 20C,B02,188405,Harel; Guershon,18,0,30,12
1683691788922,MATH 20D,A01,188414,Hammock; Frances H,0,1,30,30
1683691788922,MATH 20D,A02,188415,Hammock; Frances H,0,1,30,30
1683691788922,MATH 20D,B01,188447,Hammock; Frances H,0,1,30,30
1683691788922,MATH 20D,B02,188486,Hammock; Frances H,2,0,30,28
1683691789946,MATH 20E,A01,188649,Staff,21,0,30,9
1683691789946,MATH 20E,A02,188650,Staff,20,0,30,10
1683691789946,MATH 20E,A03,188673,Staff,0,0,30,30
1683691790970,MATH 102,A01,188675,Staff,0,40,35,35
1683691791997,MATH 103B,A01,188681,Staff,3,0,35,32
1683691791997,MATH 103B,B01,188692,Staff,5,0,35,30
1683691793025,MATH 109,A01,188695,Salehi Golsefidy; Alireza,24,0,35,11
1683691793025,MATH 109,A02,188696,Salehi Golsefidy; Alireza,25,0,35,10
1683691794057,MATH 120A,A01,188698,Eggers; John Dietrich,7,0,35,28
1683691795086,MATH 142B,A01,188736,Ioana; Adrian,1,1,30,29
1683691795086,MATH 142B,A02,188741,Ioana; Adrian,0,1,30,30
1683691795086,MATH 142B,A03,188743,Ioana; Adrian,0,2,30,30
1683691796114,MATH 168A,A01,188790,Staff,0,11,35,35
1683691797138,MATH 170A,A01,188803,Nie; Jiawang,0,2,35,35
1683691797138,MATH 170A,A02,188811,Nie; Jiawang,0,1,35,35
1683691797138,MATH 170A,A03,188814,Nie; Jiawang,0,0,35,35
1683691797138,MATH 170A,A04,188815,Nie; Jiawang,5,0,35,30
1683691798164,MATH 193B,A01,188817,Staff,0,0,35,35
1683691798164,MATH 193B,A02,188818,Staff,6,0,35,29
1683691799188,MGT 4,A01,202857,Anderson; John Charles,59,0,80,21
1683691800211,MGT 12,A00,202858,Lindenberger; Wade Douglas,40,0,90,50
1683691801234,MGT 18,A00,202859,Staff,74,0,90,16
1683691802261,MGT 18GS,A00,202860,McKay; Michael J,13,0,28,15
1683691803285,MGT 45,A00,202861,Pecore; Joseph P.,8,0,90,82
1683691804310,MGT 100,A00,202863,Yavorsky; Daniel Ryan,27,0,90,63
1683691805335,MGT 103,A00,202864,Ehrich; Kristine R,0,19,90,90
1683691806363,MGT 112,A00,202865,Ehrich; Kristine R,15,0,90,75
1683691807390,MGT 121A,A00,202868,Staff,90,20,90,0
1683691808418,MGT 131B,A00,202869,Anderson; John Charles,58,0,90,32
1683691809443,MGT 136,A00,202871,Lindenberger; Wade Douglas,83,0,90,7
1683691810467,MGT 164,A00,202873,Staff,0,67,90,91
1683691811494,MGT 164GS,A00,202874,McKay; Mary A,13,0,28,15
1683691812522,MGT 180,A00,202875,Staff,0,51,90,91
1683691813550,MMW 11R,A01,205019,Herbst; Matthew,0,0,30,30
1683691813550,MMW 11R,A02,205026,Herbst; Matthew,29,0,30,1
1683691814579,MMW 15,A01,193512,Chang; Edmond Yi-Teh,0,8,28,28
1683691814579,MMW 15,A02,193513,Chang; Edmond Yi-Teh,0,5,28,28
1683691814579,MMW 15,A03,193514,Chang; Edmond Yi-Teh,0,5,28,28
1683691814579,MMW 15,A04,193515,Chang; Edmond Yi-Teh,0,5,28,28
1683691814579,MMW 15,A05,193516,Chang; Edmond Yi-Teh,0,5,28,28
1683691814579,MMW 15,A06,193517,Chang; Edmond Yi-Teh,0,6,28,28
1683691814579,MMW 15,B01,193519,Chang; Edmond Yi-Teh,0,5,28,28
1683691814579,MMW 15,B02,193520,Chang; Edmond Yi-Teh,0,5,28,28
1683691814579,MMW 15,B03,193521,Chang; Edmond Yi-Teh,0,5,28,28
1683691814579,MMW 15,B04,193522,Chang; Edmond Yi-Teh,0,6,28,28
1683691814579,MMW 15,B05,193523,Chang; Edmond Yi-Teh,0,5,28,28
1683691814579,MMW 15,B06,193524,Chang; Edmond Yi-Teh,0,5,28,28
1683691815605,MMW 122,A01,193526,Rahimi; Babak,0,16,28,28
1683691815605,MMW 122,A02,193527,Rahimi; Babak,0,15,28,28
1683691815605,MMW 122,A03,193528,Rahimi; Babak,0,0,0,0
1683691815605,MMW 122,A04,193529,Rahimi; Babak,0,0,0,0
1683691816628,MUS 1A,A01,186663,Staff,1,19,35,34
1683691817651,MUS 4,A01,186715,Staff,0,12,35,35
1683691818681,MUS 5R,A01,186796,Dubnov; Shlomo,0,17,35,35
1683691819707,MUS 6,A01,186798,Staff,1,5,25,24
1683691820733,MUS 7,A01,186830,Staff,11,0,35,24
1683691821756,MUS 8,A01,186930,Staff,0,27,35,35
1683691822779,MUS 15,A01,186932,Staff,0,15,35,35
1683691822779,MUS 15,B01,186934,Staff,1,17,35,34
1683691823802,MUS 80,A00,186935,Staff,0,0,20,20
1683691823802,MUS 80,B00,186936,Staff,24,0,25,1
1683691824826,NANO 11,A00,204702,Lipomi; Darren John,0,0,0,0
1683691825851,NANO 15,A01,204709,Yang; Kesong,0,1,0,0
1683691826875,NANO 114,A00,202069,Jahed Motlagh; Zeinab,2,0,10,8
1683691827899,PHIL 1,A00,186955,Grush; Rick Scott,31,0,40,9
1683691828930,PHIL 10,A01,186973,Grush; Rick Scott,27,0,35,8
1683691828930,PHIL 10,A02,186974,Grush; Rick Scott,33,0,35,2
1683691829953,PHIL 13,A01,186976,Staff,1,0,35,34
1683691829953,PHIL 13,A02,186977,Staff,16,0,35,19
1683691830980,PHIL 14,A01,186979,Staff,31,0,35,4
1683691830980,PHIL 14,A02,186986,Staff,32,0,35,3
1683691832006,PHIL 28,A01,186988,Staff,16,0,30,14
1683691832006,PHIL 28,A02,186989,Staff,1,0,30,29
1683691832006,PHIL 28,A03,186990,Staff,10,0,30,20
1683691832006,PHIL 28,A04,186991,Staff,26,0,30,4
1683691833031,PHIL 120,A00,186997,Staff,23,0,40,17
1683691834057,PHIL 137,A00,187003,Staff,7,0,40,33
1683691835080,PHIL 150,A00,187015,Staff,47,0,70,23
1683691836105,PHIL 167,A00,187021,Lamey; Andy M.,34,0,40,6
1683691837129,PHIL 174,A01,202226,Staff,17,0,20,3
1683691837129,PHIL 174,A02,202235,Staff,20,0,20,0
1683691838153,PHIL 191A,A00,258918,Staff,0,0,1,1
1683691839178,PHYS 1A,A00,187028,Staff,26,0,60,34
1683691840205,PHYS 1AL,001,187036,Staff,3,0,30,27
1683691840205,PHYS 1AL,002,187049,Staff,18,0,30,12
1683691841229,PHYS 1B,A00,187058,Staff,22,0,60,38
1683691842257,PHYS 1BL,001,187064,Staff,0,1,30,30
1683691842257,PHYS 1BL,002,187070,Staff,4,0,30,26
1683691843282,PHYS 1C,A00,187082,Staff,29,0,120,91
1683691844306,PHYS 1CL,001,187088,Staff,0,9,30,30
1683691844306,PHYS 1CL,002,187089,Staff,0,1,30,30
1683691844306,PHYS 1CL,009,262693,Staff,9,0,30,21
1683691845331,PHYS 2B,A01,187097,Staff,55,0,115,60
1683691846357,PHYS 2C,A01,187099,Staff,63,0,115,52
1683691847385,PHYS 2CL,A01,187101,Staff,5,0,28,23
1683691847385,PHYS 2CL,A02,187102,Staff,15,0,28,13
1683691848409,PHYS 2D,A01,187123,Shotwell; Brian,95,0,115,20
1683691849437,PHYS 4B,A01,187133,Grinstein; Benjamin,35,0,50,15
1683691850464,POLI 10,A00,188819,Staff,0,4,50,50
1683691851548,POLI 11,A00,188827,Staff,43,0,50,7
1683691852572,POLI 13R,A00,188828,Staff,0,1,20,20
1683691853599,POLI 27,A01,188830,Elgin; Samuel Zincke,0,2,70,70
1683691854624,POLI 30,A00,188832,Desposato; Scott,30,0,50,20
1683691855651,POLI 102F,A00,188834,Staff,1,0,40,39
1683691856678,POLI 104A,A00,188852,Staff,12,0,30,18
1683691857704,POLI 104I,A00,188853,Staff,0,8,20,20
1683691858732,POLI 110B,A00,188854,Wiens; David,6,0,20,14
1683691859760,POLI 112A,A00,188855,Wiens; David,3,0,30,27
1683691860786,POLI 117R,A00,188856,Forman; Fonna,0,12,20,20
1683691861814,POLI 118,A00,188857,Ingham; Sean,8,0,20,12
1683691862839,POLI 120G,A00,188858,Staff,8,0,30,22
1683691863874,POLI 131CR,A00,188863,Hoston; Germaine,20,0,50,30
1683691864901,POLI 133,A00,188864,Nellis; Gareth Hb,44,0,50,6
1683691865925,POLI 134D,A00,188865,Desposato; Scott,27,0,30,3
1683691866948,POLI 142A,A00,188871,Gartzke; Erik,21,0,50,29
1683691867976,POLI 142K,A00,188874,Staff,38,0,50,12
1683691869003,POLI 143,A00,188940,Gartzke; Erik,16,0,30,14
1683691870025,POLI 153,A00,188943,Staff,2,0,20,18
1683691871048,POLI 160AA,A00,188944,Staff,10,0,40,30
1683691872075,POLI 170A,A00,188945,Staff,10,0,30,20
1683691874125,PSYC 1,A00,188952,Staff,36,0,90,54
1683691875152,PSYC 2,B00,188953,Staff,19,0,35,16
1683691876180,PSYC 6,A00,188970,Staff,47,0,60,13
1683691877206,PSYC 7,A00,188973,Staff,35,0,45,10
1683691878233,PSYC 60,A01,188980,Rickard; Timothy C.,42,0,60,18
1683691879256,PSYC 70,A01,189001,Steiner; Eric Tomas,21,0,45,24
1683691880283,PSYC 100,A00,189005,Lacefield; Katharine I,0,99,120,120
1683691881306,PSYC 102,A00,189008,Staff,7,0,30,23
1683691882329,PSYC 106,B00,189026,Gorman; Michael R.,27,0,60,33
1683691883353,PSYC 114,B01,189033,Winkielman; Piotr,0,31,30,30
1683691884377,PSYC 131,A00,189036,Anagnostaras; Stephan,0,43,60,60
1683691885401,PSYC 136,A00,189041,Lowe; Angela Beth,0,7,25,25
1683691886424,PSYC 137,A00,189057,Winkielman; Piotr,1,37,25,24
1683691887449,PSYC 144,A00,189107,Wixted; John T,0,11,50,50
1683691889500,PSYC 162,A00,189142,Staff,0,9,85,85
1683691890527,PSYC 172,A00,189144,Gorman; Michael R.,0,6,30,30
1683691892575,PSYC 179,A00,189146,Lacefield; Katharine I,0,88,120,120
1683691893602,PSYC 181,A00,189147,Anagnostaras; Stephan,0,44,90,90
1683691894637,PSYC 190R,A00,189148,Barner; David A.,0,23,80,80
1683691895661,PSYC 191,A00,189275,Rickard; Timothy C.,0,11,25,25
1683691896688,PSYC 193,A00,189276,Chapman; Eddie Nathaniel,0,1,0,4
1683691897713,PSYC 193L,A01,189281,Lowe; Angela Beth,8,0,20,12
1683691897713,PSYC 193L,B01,189285,Staff,28,0,35,7
1683691898740,RELI 149,A00,187137,Rahimi; Babak,6,0,40,34
1683691899767,SE 9,A01,187315,Staff,0,2,18,18
1683691900793,SE 101B,A00,187409,Staff,24,0,30,6
1683691901817,SE 110B,A00,187444,Staff,10,0,40,30
1683691902840,SE 130B,A00,187449,Staff,31,0,40,9
1683691903863,SE 150A,A00,187516,Staff,8,0,20,12
1683691904889,SE 154,A00,187528,Staff,29,0,50,21
1683691905913,SIO 3,A01,258171,Staff,35,0,40,5
1683691906940,SIO 10,A00,187144,Cook; Geoffrey W,1,7,75,74
1683691907968,SIO 45,A00,187152,Cook; Geoffrey W,0,7,100,100
1683691908992,SIO 109R,A00,194486,Staff,0,4,20,20
1683691911044,SIO 187,A01,187233,Kacev; David,12,0,40,28
1683691912069,SOCI 1,A01,258656,Thorpe; Charles Robert,28,0,30,2
1683691912069,SOCI 1,A02,258658,Thorpe; Charles Robert,30,0,30,0
1683691912069,SOCI 1,A03,258661,Thorpe; Charles Robert,25,0,25,0
1683691912069,SOCI 1,A04,258666,Thorpe; Charles Robert,22,0,25,3
1683691912069,SOCI 1,A05,258897,Thorpe; Charles Robert,22,0,25,3
1683691912069,SOCI 1,A06,258898,Thorpe; Charles Robert,25,0,25,0
1683691913094,SOCI 30,A01,258903,Pardo Guerra; Juan Pablo,14,0,30,16
1683691914120,SOCI 102,A00,258904,Staff,9,0,25,16
1683691915143,SOCI 106,A00,258905,Staff,19,0,25,6
1683691916169,SOCI 111,A00,258907,Ribas Norris; Janet Vanesa,26,0,30,4
1683691917196,SOCI 121R,A00,258908,Pardo Guerra; Juan Pablo,8,0,30,22
1683691918222,SOCI 126,A01,203330,Staff,14,0,20,6
1683691919247,SOCI 131,A00,258909,Thorpe; Charles Robert,30,0,60,30
1683691920275,SOCI 135,A00,258910,Payne; Christine Anna,0,13,30,30
1683691921298,SOCI 157,A00,258911,Staff,11,0,30,19
1683691922322,SOCI 184,A00,258912,Staff,25,0,30,5
1683691923346,SOCI 188D,A00,258913,Staff,22,0,30,8
1683691924372,SYN 2,001,187529,Staff,9,0,16,7
1683691924372,SYN 2,002,201452,Staff,1,20,16,15
1683691924372,SYN 2,003,201469,Staff,1,0,16,15
1683691925396,SYN 100,A01,187531,Staff,0,9,20,20
1683691925396,SYN 100,B01,201491,Staff,0,10,20,20
1683691926424,TDAC 1,A00,189286,Walsh; Kim C.,3,0,20,17
1683691926424,TDAC 1,B00,189287,Harting; Carla Kelso,10,0,20,10
1683691927451,TDAC 101,A00,189300,Walsh; Kim C.,16,0,20,4
1683691927451,TDAC 101,B00,189301,Harting; Carla Kelso,18,0,20,2
1683691928478,TDAC 102,A00,189304,Basso; Beatrice,14,0,20,6
1683691929504,TDAC 108,A00,189305,Staff,18,0,20,2
1683691930532,TDDE 131,A00,189310,Staff,19,0,20,1
1683691930532,TDDE 131,B00,189314,Staff,19,0,20,1
1683691930532,TDDE 131,C00,189315,Staff,48,0,50,2
1683691930532,TDDE 131,D00,189316,Staff,14,0,15,1
1683691930532,TDDE 131,E00,204841,Staff,20,0,20,0
1683691931561,TDGE 10,A00,189289,Staff,27,0,50,23
1683691931561,TDGE 10,B00,189290,Havis; Allan,0,1,50,50
1683691932584,TDGE 11,A00,189291,Fulton; Julia,0,4,50,50
1683691932584,TDGE 11,B00,189292,Staff,20,0,25,5
1683691932584,TDGE 11,C00,260270,Staff,0,0,0,0
1683691933609,TDGE 25,A00,189294,Staff,1,0,20,19
1683691934634,TDGE 124,A00,189318,Fulton; Julia,1,8,50,49
1683691935661,TDGE 125,A00,189319,Staff,13,0,25,12
1683691935661,TDGE 125,B00,189320,Staff,23,0,25,2
1683691936691,TDGE 127,A00,189322,Havis; Allan,0,0,50,50
1683691937720,TDHT 101,A00,189323,Staff,18,0,25,7
1683691937720,TDHT 101,B00,189324,Staff,25,0,25,0
1683691938745,TDHT 102,A00,189325,Staff,49,0,50,1
1683691939770,TDMV 1,A00,189295,Arcidiacono; Kristin,20,0,30,10
1683691939770,TDMV 1,B00,189296,Caligagan; Maria T.,24,0,30,6
1683691940799,TDMV 2,A00,189297,Sammartano; Tonnie,27,0,30,3
1683691940799,TDMV 2,B00,189299,Arcidiacono; Kristin,23,0,30,7
1683691941822,TDMV 3,A00,204998,Rincon; Alicia,22,0,30,8
1683691942850,TDMV 120,A00,189458,Sammartano; Tonnie,28,0,30,2
1683691943876,TDMV 138,A00,189541,Jun; Grace Shin Hae,20,0,40,20
1683691944900,TDMV 142,A00,189717,Caligagan; Tony,25,0,30,5
1683691944900,TDMV 142,B00,189718,Caligagan; Maria T.,25,0,30,5
1683691945925,TMC 2,A01,187533,Staff,25,0,25,0
1683691945925,TMC 2,A02,187534,Staff,25,0,25,0
1683691946951,USP 1,A01,187536,Kwak; Nancy,0,16,25,25
1683691947979,USP 5,A01,187538,Staff,8,0,25,17
1683691949008,USP 101,A00,199253,Staff,0,4,0,0
1683691950036,USP 124,A00,187562,Boomhower; Matthew Charles,0,0,30,30
1683691951060,USP 138,A00,187582,Staff,19,0,25,6
1683691952085,USP 152,A01,187597,Staff,3,0,25,22
1683691953110,USP 153,A00,187598,Staff,18,0,25,7
1683691954138,USP 168,A00,187607,Kwak; Nancy,2,0,5,3
1683691955221,USP 173,A00,187619,Staff,4,0,25,21
1683691956247,USP 181,A00,187638,Staff,0,4,25,25
1683691957274,VIS 103,A00,187650,Cruz; Edwin Teddy,17,0,75,58
1683691958299,VIS 110D,A00,187669,Staff,13,0,22,9
1683691959324,VIS 127C,A00,187720,Shen; Kuiyi,67,0,146,79
1683691960352,VIS 149,A00,187731,Yoldas; Pinar,2,14,22,20
1683691961380,VIS 151,A01,188091,Staff,22,0,34,12
1683691961380,VIS 151,A02,188092,Staff,11,0,34,23
1683691962407,VIS 160B,A00,188093,Stalbaum; Brett,0,1,10,10
1683691964456,WCWP 10B,A00,201720,Staff,0,0,5,5
1683691964456,WCWP 10B,B00,201722,Staff,0,0,6,6
1683691965484,WCWP 100,A00,201725,Gagnon; Jeffrey C,0,0,2,2
1683691965484,WCWP 100,B00,201727,Staff,0,4,15,15
1683691968609,ANBI 133,A00,258401,Wilder; Linnea Lorene,34,0,40,6
1683691969633,ANBI 140,A00,258395,Hrvoj Mihic; Branka,18,0,25,7
1683691970657,ANSC 120,A00,258402,Bialecki; Jon Anthony,26,0,40,14
1683691971683,ANSC 144,A00,258400,Staff,12,0,40,28
1683691973734,ANSC 166,A00,258396,Parish; Steven Martin,156,0,175,19
1683691974761,ANSC 180,A00,193533,Staff,8,0,20,12
1683691975786,ANSC 188,A00,258397,Jassal; Aftab,34,0,40,6
1683691976811,ANTH 3,A01,258316,Staff,23,0,30,7
1683691977836,ANTH 5,A00,258394,Semendeferi; Ekaterini,16,0,20,4
1683691978864,ANTH 21,A01,258331,Staff,4,0,40,36
1683691979889,ANTH 103,A00,258398,Varma; Saiba,15,0,25,10
1683691980917,AWP 10,001,202034,Staff,0,0,0,0
1683691980917,AWP 10,002,202035,Staff,0,0,0,0
1683691980917,AWP 10,003,202036,Staff,0,0,0,0
1683691980917,AWP 10,004,202037,Staff,0,0,0,0
1683691980917,AWP 10,005,202038,Staff,0,0,0,0
1683691980917,AWP 10,006,202039,Staff,0,0,0,0
1683691980917,AWP 10,007,202040,Staff,0,0,0,0
1683691980917,AWP 10,008,202041,Staff,0,0,0,0
1683691980917,AWP 10,009,202042,Staff,0,0,0,0
1683691980917,AWP 10,010,202043,Staff,0,0,0,0
1683691980917,AWP 10,011,202044,Staff,0,0,0,0
1683691980917,AWP 10,012,202045,Staff,0,0,0,0
1683691980917,AWP 10,013,202046,Staff,0,0,0,0
1683691980917,AWP 10,014,202047,Staff,0,0,0,0
1683691980917,AWP 10,015,202048,Staff,0,0,0,0
1683691980917,AWP 10,016,202049,Staff,0,0,0,0
1683691980917,AWP 10,017,202050,Staff,0,0,0,0
1683691980917,AWP 10,018,202051,Staff,0,0,0,0
1683691980917,AWP 10,019,202052,Staff,0,0,0,0
1683691980917,AWP 10,020,202053,Staff,0,0,0,0
1683691980917,AWP 10,021,202054,Staff,0,0,0,0
1683691980917,AWP 10,022,202055,Staff,0,0,0,0
1683691980917,AWP 10,023,202056,Staff,0,0,0,0
1683691980917,AWP 10,024,202057,Staff,0,0,0,0
1683691980917,AWP 10,025,202058,Staff,0,0,0,0
1683691980917,AWP 10,026,202059,Staff,0,0,0,0
1683691981941,AWP 102,001,202032,Staff,0,0,0,0
1683691981941,AWP 102,002,202033,Staff,0,0,0,0
1683691982965,BENG 100,A01,254234,Taylor Amos; Alyssa C,31,0,40,9
1683691983989,BENG 196,001,270013,Engler; Adam J.,9999,0,9999,0
1683691985013,BICD 100R,A01,202018,Smith; Laurie,0,7,32,32
1683691985013,BICD 100R,A02,202019,Smith; Laurie,0,3,32,32
1683691985013,BICD 100R,A03,202020,Smith; Laurie,0,1,32,32
1683691985013,BICD 100R,A04,202021,Smith; Laurie,6,0,32,26
1683691985013,BICD 100R,A05,202022,Smith; Laurie,10,0,32,22
1683691986038,BICD 136,A01,193242,Gustafson-Brown; Cindy,0,2,32,32
1683691986038,BICD 136,A02,193244,Gustafson-Brown; Cindy,13,0,32,19
1683691987068,BIEB 102,A01,193249,Butler; Shannon Rhey,1,1,32,31
1683691987068,BIEB 102,A02,193251,Butler; Shannon Rhey,0,0,32,32
1683691987068,BIEB 102,A03,193253,Butler; Shannon Rhey,0,0,32,32
1683691987068,BIEB 102,A04,193255,Butler; Shannon Rhey,13,0,32,19
1683691987068,BIEB 102,A05,193265,Butler; Shannon Rhey,25,0,32,7
1683691987068,BIEB 102,A06,193269,Butler; Shannon Rhey,13,0,32,19
1683691989117,BIEB 150,A01,193274,Staff,0,0,32,32
1683691989117,BIEB 150,A02,193285,Staff,24,0,32,8
1683691990146,BIEB 194,A00,193286,Kurle; Carolyn M.,19,0,32,13
1683691991174,BILD 1,A01,192291,Staff,15,0,32,17
1683691991174,BILD 1,A02,192292,Staff,30,0,32,2
1683691991174,BILD 1,B01,192520,Reuther; Keefe,0,1,0,0
1683691991174,BILD 1,B02,192532,Reuther; Keefe,0,1,0,0
1683691992208,BILD 3,A01,192556,Butler; Shannon Rhey,0,0,32,32
1683691992208,BILD 3,A02,192581,Butler; Shannon Rhey,0,1,32,32
1683691992208,BILD 3,A03,192611,Butler; Shannon Rhey,19,0,32,13
1683691992208,BILD 3,A04,192612,Butler; Shannon Rhey,23,0,32,9
1683691992208,BILD 3,A05,192613,Butler; Shannon Rhey,26,0,32,6
1683691992208,BILD 3,A06,192679,Butler; Shannon Rhey,27,0,32,5
1683691992208,BILD 3,A07,192682,Butler; Shannon Rhey,20,0,32,12
1683691993237,BILD 4,A01,192836,Reuther; Keefe,1,0,24,23
1683691993237,BILD 4,A02,193044,Reuther; Keefe,4,0,24,20
1683691994265,BILD 10,A01,193142,Gustafson-Brown; Cindy,29,0,32,3
1683691994265,BILD 10,A02,193149,Gustafson-Brown; Cindy,31,0,32,1
1683691995290,BIMM 100,A01,193301,Staff,0,6,32,32
1683691995290,BIMM 100,A02,193312,Staff,0,7,32,32
1683691995290,BIMM 100,A03,193323,Staff,0,10,32,32
1683691996315,BIMM 101,A01,193329,McDonnell; Lisa Marie,1,4,24,23
1683691996315,BIMM 101,A02,193339,McDonnell; Lisa Marie,1,4,24,23
1683691996315,BIMM 101,B01,193354,McDonnell; Lisa Marie,0,4,24,24
1683691996315,BIMM 101,B02,193357,McDonnell; Lisa Marie,0,3,24,24
1683691997344,BIMM 110,A01,193377,Tat; John,0,11,32,32
1683691997344,BIMM 110,A02,193378,Tat; John,0,11,32,32
1683691998371,BIMM 120,A01,206116,Staff,0,0,32,32
1683691998371,BIMM 120,A02,206117,Staff,7,0,32,25
1683691998371,BIMM 120,A03,206121,Staff,21,0,32,11
1683691999400,BIPN 100,A01,193393,Park; Ji Young,0,15,32,32
1683691999400,BIPN 100,A02,193402,Park; Ji Young,0,14,32,32
1683691999400,BIPN 100,A03,193413,Park; Ji Young,0,14,32,32
1683691999400,BIPN 100,A04,193414,Park; Ji Young,0,13,32,32
1683692000424,BIPN 102,A01,193429,Staff,0,0,32,32
1683692000424,BIPN 102,A02,193438,Staff,18,0,32,14
1683692001449,BIPN 106,A01,193450,Reyes Gonzalez; Catalina,0,2,40,40
1683692002472,BIPN 134,A01,193465,Cooke; James Edward,0,0,32,32
1683692002472,BIPN 134,A02,193474,Cooke; James Edward,25,0,32,7
1683692002472,BIPN 134,A03,193485,Cooke; James Edward,29,0,32,3
1683692002472,BIPN 134,A04,193486,Cooke; James Edward,20,0,32,12
1683692002472,BIPN 134,A05,193491,Cooke; James Edward,31,0,32,1
1683692002472,BIPN 134,A06,193501,Cooke; James Edward,30,0,32,2
1683692002472,BIPN 134,A07,193510,Cooke; James Edward,29,0,32,3
1683692004519,BISP 194,A00,222522,Staff,14,0,32,18
1683692005543,CAT 124,A01,202407,Staff,19,0,25,6
1683692006568,CAT 125,A00,202408,Marchisotto; Jennifer Anne,2,0,20,18
1683692007597,CAT 125R,A00,202409,Smith; Lauryn Alissa,0,11,20,20
1683692007597,CAT 125R,B00,202410,Morales; Celeste Georgianna,0,11,20,20
1683692007597,CAT 125R,C00,202411,Irwin; Matthew Joseph,0,12,20,20
1683692008621,CENG 15,A01,204712,Yang; Kesong,0,1,0,0
1683692009643,CENG 114,A00,202070,Jahed Motlagh; Zeinab,5,0,20,15
1683692010669,CGS 105,A00,185477,Wesling; Megan E.,24,0,40,16
1683692011693,CGS 106,A00,185494,Staff,11,0,22,11
1683692012721,CGS 108,A00,185495,Staff,14,0,20,6
1683692013749,CGS 114,A00,185496,Staff,13,0,18,5
1683692014776,CGS 119,A00,185501,Staff,15,0,20,5
1683692015802,CGS 120,A00,185511,Staff,12,0,20,8
1683692016830,CHEM 4,A01,184675,Bussey; Thomas J,97,0,100,3
1683692017857,CHEM 6A,A01,184677,Staff,32,0,60,28
1683692018881,CHEM 6B,A01,184679,Staff,63,0,100,37
1683692019906,CHEM 6C,A01,184681,Bussey; Thomas J,0,0,50,50
1683692019906,CHEM 6C,A02,184682,Bussey; Thomas J,32,0,50,18
1683692020931,CHEM 40A,A01,184684,Albizati; Kim F.,33,0,100,67
1683692021954,CHEM 40B,A01,184686,Albizati; Kim F.,0,22,100,100
1683692022982,CHEM 41B,A01,184690,Staff,51,0,100,49
1683692024010,COGS 3,A01,184715,Boyle; Mary E. T.,0,27,40,40
1683692025034,COGS 14B,A01,185172,Staff,0,14,38,38
1683692026059,COGS 18,A01,184736,Staff,14,0,80,66
1683692027083,COGS 100,A01,184932,Staff,0,8,73,73
1683692028110,COGS 101A,A01,184935,Staff,0,40,30,30
1683692029133,COGS 101B,A01,184944,Staff,0,2,30,30
1683692030157,COGS 101C,A01,184946,Staff,0,10,30,30
1683692031181,COGS 102A,A01,184951,Johnson; Christine M.,1,0,40,39
1683692032204,COGS 107B,A01,184953,Mooshagian; Eric Frederick,0,52,40,40
1683692033229,COGS 118B,A01,184959,Gupta; Anjum,0,50,40,40
1683692034252,COGS 153,A00,184961,Staff,0,16,30,30
1683692035276,COGS 177,A00,184962,Staff,1,21,30,29
1683692036300,COGS 187A,A01,184969,Boyle; Mary E. T.,0,19,40,40
1683692037326,COMM 10,A01,185174,Staff,0,5,25,25
1683692037326,COMM 10,A02,185189,Staff,0,2,25,25
1683692037326,COMM 10,A03,269821,Staff,0,1,0,0
1683692038352,COMM 100B,A02,185476,Staff,10,0,25,15
1683692038352,COMM 100B,A03,277340,Staff,25,0,25,0
1683692039378,COMM 100C,A01,185314,Staff,1,0,25,24
1683692039378,COMM 100C,A02,185327,Staff,17,0,25,8
1683692040402,COMM 110M,A00,185349,Staff,0,0,40,40
1683692041429,COMM 113T,A00,185352,Staff,25,0,40,15
1683692042454,COMM 114I,A00,185353,Staff,31,0,40,9
1683692043478,COMM 131,A00,185354,Staff,17,0,30,13
1683692044505,CSE 8A,A50,185358,Cao; Yingjun,0,46,10,10
1683692045529,CSE 8B,A01,185362,Staff,0,48,50,50
1683692046553,CSE 11,A01,185416,Cao; Yingjun,0,91,10,10
1683692047580,CSE 20,A01,185445,Briones; Jor-el Thomas Caparas,3,0,25,22
1683692048607,CSE 21,A01,185447,Staff,9,0,50,41
1683692049631,CSE 101,A01,185451,Staff,0,13,50,50
1683692049631,CSE 101,B01,185453,Jones; Miles E,0,14,50,50
1683692051682,CSE 141,A01,185458,Eldon; John,16,0,100,84
1683692052710,CSE 141L,A01,185461,Eldon; John,8,0,100,92
1683692053739,CSE 142,A01,185463,Staff,34,0,60,26
1683692053739,CSE 142,B01,201355,Staff,0,7,60,60
1683692054766,CSE 142L,A01,185470,Staff,34,0,60,26
1683692054766,CSE 142L,B01,201417,Staff,0,6,60,60
1683692055792,CSE 190,A00,201433,Staff,32,0,49,17
1683692056817,DOC 1,A01,259136,Strom; Megan C.,7,0,15,8
1683692056817,DOC 1,A02,259137,Strom; Megan C.,14,0,15,1
1683692056817,DOC 1,A03,259138,Strom; Megan C.,14,0,15,1
1683692056817,DOC 1,A04,259139,Strom; Megan C.,14,0,15,1
1683692057840,DOC 100D,A00,259140,Pass; Natalye Joann,14,0,25,11
1683692058925,DSGN 1,A01,184749,Rill; Bryan,0,26,30,30
1683692059949,DSGN 100,A01,185168,Staff,0,2,25,25
1683692060972,ECE 5,A01,185626,Morris; Karcher William,0,12,0,0
1683692061995,ECE 101,A01,185628,Staff,14,0,70,56
1683692063021,ECE 107,A01,185635,Baghdadchi; Saharnaz,0,0,20,20
1683692063021,ECE 107,A02,185638,Baghdadchi; Saharnaz,1,0,20,19
1683692064048,ECE 148,A01,185647,Silberman; Jack,0,0,16,16
1683692065074,ECON 1,A01,185537,Crane; Meredith Helen,54,0,70,16
1683692066101,ECON 3,A01,185549,Crane; Meredith Helen,30,0,70,40
1683692067127,ECON 4,A01,203354,Anderson; John Charles,0,5,10,10
1683692068153,ECON 100A,A01,185574,Staff,0,5,40,40
1683692069177,ECON 100B,A01,185576,Staff,0,12,50,50
1683692070204,ECON 100C,A01,185589,Newhouse; Herbert S,30,0,70,40
1683692071230,ECON 105,A00,185608,Vespa; Emanuel Ignacio,19,0,35,16
1683692072255,ECON 109,A01,185610,Shishkin; Denis,9,0,35,26
1683692073282,ECON 110A,A01,185612,Staff,8,0,40,32
1683692074308,ECON 120A,A01,185615,Staff,19,0,40,21
1683692075336,ECON 120C,A01,185617,Sun; Yixiao,0,21,70,70
1683692076360,ECON 144,A00,203346,Squires; Dale E,2,0,35,33
1683692077384,ECON 171,A01,203349,Newhouse; Herbert S,0,1,35,35
1683692078412,ECON 173A,A01,185621,Toda; Alexis Akira,21,0,35,14
1683692079438,EDS 25,A01,202413,Staff,0,1,0,0
1683692079438,EDS 25,A02,202414,Staff,0,1,0,0
1683692079438,EDS 25,A03,202415,Staff,0,0,0,0
1683692079438,EDS 25,A04,202416,Staff,0,1,0,0
1683692079438,EDS 25,A05,202439,Staff,0,0,0,0
1683692079438,EDS 25,A06,202440,Staff,0,0,0,0
1683692079438,EDS 25,B01,202631,Staff,0,0,0,0
1683692079438,EDS 25,B02,202632,Staff,0,0,0,0
1683692079438,EDS 25,B03,202639,Staff,0,0,0,0
1683692079438,EDS 25,B04,202640,Staff,0,0,0,0
1683692079438,EDS 25,B05,202643,Staff,0,0,0,0
1683692079438,EDS 25,B06,202644,Staff,0,0,0,0
1683692080461,EDS 38,A01,202659,Black; Alison Michelle,24,0,25,1
1683692081485,EDS 115,A00,202652,Staff,18,0,30,12
1683692082508,EDS 125,A00,202649,Staff,13,0,30,17
1683692083536,EDS 126,A01,203332,Staff,30,0,30,0
1683692084560,EDS 139,A00,202838,Staff,16,0,25,9
1683692085586,EDS 146,A01,202655,Staff,14,0,25,11
1683692086614,ENG 15,A00,185667,Staff,0,1,0,0
1683692086614,ENG 15,B00,185672,Staff,0,0,0,0
1683692086614,ENG 15,C00,185675,Staff,0,0,0,0
1683692086614,ENG 15,D00,185682,Staff,0,0,0,0
1683692086614,ENG 15,E00,185684,Staff,0,0,0,0
1683692087639,ETHN 103,A00,185710,Staff,0,8,35,35
1683692088661,ETHN 103A,A00,199228,Man; Simeon S,0,0,9,9
1683692089687,ETHN 109,A00,185711,Staff,15,0,35,20
1683692090714,ETHN 142,A00,185726,Staff,0,4,30,30
1683692091739,ETHN 163J,A00,199229,Man; Simeon S,5,0,8,3
1683692092765,ETHN 168,A00,185727,Staff,7,0,10,3
1683692093791,ETHN 182,A00,185728,Staff,0,0,35,35
1683692094815,ETHN 183,A00,185737,Staff,9,0,18,9
1683692095842,GLBH 111,A01,209361,Burgos; Jose L.,0,0,0,0
1683692097889,HIEU 104,A00,185792,Staff,14,0,20,6
1683692098916,HIEU 115,A00,185800,Staff,0,0,20,20
1683692099941,HIEU 128,A00,185801,Staff,0,9,20,20
1683692100968,HIEU 147,A00,185802,Staff,15,0,20,5
1683692101990,HIEU 154,A00,185823,Staff,11,0,20,9
1683692103015,HILA 102,A00,185826,Staff,14,0,20,6
1683692104040,HILD 2C,A01,185778,Staff,0,13,20,20
1683692105064,HILD 7B,A01,185780,Kwak; Nancy,0,17,32,32
1683692105064,HILD 7B,A02,185781,Kwak; Nancy,0,18,32,32
1683692106090,HILD 30,A01,185791,Staff,12,0,20,8
1683692107114,HISC 119,A00,185830,Golan; Tal,0,11,20,20
1683692108138,HITO 156GS,A00,185831,Patterson; Patrick H.,0,0,0,23
1683692109165,HIUS 103,A00,185832,Man; Simeon S,0,4,20,20
1683692110192,HIUS 117,A00,185836,Kwak; Nancy,2,0,20,18
1683692111216,HIUS 125,A00,185840,Man; Simeon S,0,3,23,23
1683692112239,HIUS 149,A00,185845,Staff,1,0,20,19
1683692113263,HUM 3,A01,185882,Zavodny; Tatiana Sophia,0,8,50,50
1683692113263,HUM 3,B01,185899,Caldwell; Michael Alan,0,18,50,50
1683692114288,HUM 3GS,A00,185900,Patterson; Patrick H.,0,0,0,23
1683692115318,HUM 4,A01,185938,Zroka; Amy Liane,28,0,50,22
1683692115318,HUM 4,B01,185956,Watkins; Eric,0,6,50,50
1683692115318,HUM 4,B02,202209,Watkins; Eric,0,5,50,50
1683692115318,HUM 4,B03,202210,Watkins; Eric,0,5,50,50
1683692116342,HUM 5,A01,185958,West; Geoffrey Scott,0,0,50,50
1683692116342,HUM 5,A02,202215,West; Geoffrey Scott,0,1,50,50
1683692117366,INTL 190,A00,185959,Gagnon; Jeffrey C,0,0,0,9
1683692117366,INTL 190,B00,185960,Lettieri; Michael Joseph,0,0,0,2
1683692118391,JAPN 180,A00,254509,Staff,5,0,30,25
1683692119419,LATI 10,A01,202853,Kennemore; Amy Michelle,4,0,35,31
1683692119419,LATI 10,A02,202854,Kennemore; Amy Michelle,3,0,35,32
1683692119419,LATI 10,A03,270054,Kennemore; Amy Michelle,30,0,30,0
1683692120445,LATI 180,A00,202855,Kennemore; Amy Michelle,11,0,20,9
1683692121473,LAWS 101,A00,201767,Golan; Tal,0,7,40,40
1683692122497,LIFR 1C,A00,185961,Staff,6,0,20,14
1683692123521,LIFR 1CX,A00,185962,Staff,7,0,20,13
1683692124547,LIFR 1D,A00,185963,Staff,7,0,20,13
1683692125570,LIFR 1DX,A00,185964,Staff,7,0,20,13
1683692126595,LIGN 101,A01,186039,Staff,43,0,50,7
1683692127619,LIGN 165,A00,186040,Staff,15,0,50,35
1683692128643,LTCS 108,A00,186041,Staff,5,0,10,5
1683692129666,LTCS 119,A00,186042,Staff,15,0,20,5
1683692130693,LTCS 130,A00,186043,Wesling; Megan E.,15,0,25,10
1683692132745,LTEA 138,A00,186119,Staff,14,0,40,26
1683692133769,LTEN 124,A00,186148,Staff,5,0,25,20
1683692134793,LTEN 178,A00,186149,Staff,6,0,15,9
1683692135817,LTEN 181,A00,186150,Blanco; John D,34,0,40,6
1683692136843,LTWL 120,A00,186160,Staff,19,0,25,6
1683692137866,LTWL 165,A00,186161,Staff,22,0,25,3
1683692138891,LTWR 100,A00,186162,Staff,0,5,15,15
1683692139913,LTWR 102,A00,186163,Doller; Ben,5,0,15,10
1683692140939,MAE 8,A01,186412,Staff,0,1,0,0
1683692141963,MAE 30B,A00,186445,Bahadori; Mohammad Yousef,81,0,100,19
1683692142987,MAE 40,A00,186592,Bewley; Thomas R,10,0,50,40
1683692144014,MAE 101B,A00,186593,Bahadori; Mohammad Yousef,80,0,100,20
1683692145042,MAE 105,A00,186594,Bandaru; Prabhakar,10,0,50,40
1683692146066,MAE 107,A00,186599,Pham; Hieu Tan,0,7,120,120
1683692147093,MAE 148,A01,186660,Silberman; Jack,3,0,16,13
1683692148118,MATH 10A,A01,188095,Staff,0,6,35,35
1683692149141,MATH 10B,A01,188097,Bowers; Adam R.,0,12,30,30
1683692149141,MATH 10B,A02,188099,Bowers; Adam R.,0,11,30,30
1683692149141,MATH 10B,B01,188104,Bowers; Adam R.,0,10,30,30
1683692149141,MATH 10B,B02,188106,Bowers; Adam R.,1,10,30,29
1683692150166,MATH 10C,A01,188111,Staff,0,20,30,30
1683692150166,MATH 10C,A02,188127,Staff,0,19,30,30
1683692150166,MATH 10C,A03,188131,Staff,0,19,30,30
1683692150166,MATH 10C,B01,188218,Staff,17,0,30,13
1683692150166,MATH 10C,B02,188244,Staff,13,0,30,17
1683692150166,MATH 10C,B03,188277,Staff,14,0,30,16
1683692151195,MATH 18,A01,188344,Bach; Quang Tran,18,0,30,12
1683692151195,MATH 18,A02,188345,Bach; Quang Tran,11,0,30,19
1683692151195,MATH 18,B01,188353,Bach; Quang Tran,11,0,30,19
1683692151195,MATH 18,B02,188354,Bach; Quang Tran,19,0,30,11
1683692152219,MATH 20A,A01,188374,Staff,11,0,35,24
1683692153247,MATH 20B,A01,188382,Ohm; Ko Woon,7,0,30,23
1683692153247,MATH 20B,A02,188383,Ohm; Ko Woon,22,0,30,8
1683692153247,MATH 20B,B01,188385,Ohm; Ko Woon,7,0,30,23
1683692153247,MATH 20B,B02,188392,Ohm; Ko Woon,22,0,30,8
1683692154276,MATH 20C,A01,188394,Harel; Guershon,10,0,30,20
1683692154276,MATH 20C,A02,188395,Harel; Guershon,13,0,30,17
1683692154276,MATH 20C,B01,188404,Harel; Guershon,5,0,30,25
1683692154276,MATH 20C,B02,188405,Harel; Guershon,18,0,30,12
1683692155300,MATH 20D,A01,188414,Hammock; Frances H,0,1,30,30
1683692155300,MATH 20D,A02,188415,Hammock; Frances H,0,1,30,30
1683692155300,MATH 20D,B01,188447,Hammock; Frances H,0,1,30,30
1683692155300,MATH 20D,B02,188486,Hammock; Frances H,2,0,30,28
1683692156324,MATH 20E,A01,188649,Staff,21,0,30,9
1683692156324,MATH 20E,A02,188650,Staff,20,0,30,10
1683692156324,MATH 20E,A03,188673,Staff,0,0,30,30
1683692157349,MATH 102,A01,188675,Staff,0,40,35,35
1683692158374,MATH 103B,A01,188681,Staff,3,0,35,32
1683692158374,MATH 103B,B01,188692,Staff,5,0,35,30
1683692159403,MATH 109,A01,188695,Salehi Golsefidy; Alireza,24,0,35,11
1683692159403,MATH 109,A02,188696,Salehi Golsefidy; Alireza,25,0,35,10
1683692160431,MATH 120A,A01,188698,Eggers; John Dietrich,7,0,35,28
1683692161458,MATH 142B,A01,188736,Ioana; Adrian,1,1,30,29
1683692161458,MATH 142B,A02,188741,Ioana; Adrian,0,1,30,30
1683692161458,MATH 142B,A03,188743,Ioana; Adrian,0,2,30,30
1683692162539,MATH 168A,A01,188790,Staff,0,11,35,35
1683692163568,MATH 170A,A01,188803,Nie; Jiawang,0,2,35,35
1683692163568,MATH 170A,A02,188811,Nie; Jiawang,0,1,35,35
1683692163568,MATH 170A,A03,188814,Nie; Jiawang,0,0,35,35
1683692163568,MATH 170A,A04,188815,Nie; Jiawang,5,0,35,30
1683692164593,MATH 193B,A01,188817,Staff,0,0,35,35
1683692164593,MATH 193B,A02,188818,Staff,6,0,35,29
1683692165618,MGT 4,A01,202857,Anderson; John Charles,59,0,80,21
1683692166643,MGT 12,A00,202858,Lindenberger; Wade Douglas,40,0,90,50
1683692167668,MGT 18,A00,202859,Staff,74,0,90,16
1683692168692,MGT 18GS,A00,202860,McKay; Michael J,13,0,28,15
1683692169719,MGT 45,A00,202861,Pecore; Joseph P.,8,0,90,82
1683692170743,MGT 100,A00,202863,Yavorsky; Daniel Ryan,27,0,90,63
1683692171766,MGT 103,A00,202864,Ehrich; Kristine R,0,19,90,90
1683692172793,MGT 112,A00,202865,Ehrich; Kristine R,15,0,90,75
1683692173819,MGT 121A,A00,202868,Staff,90,20,90,0
1683692174843,MGT 131B,A00,202869,Anderson; John Charles,58,0,90,32
1683692175868,MGT 136,A00,202871,Lindenberger; Wade Douglas,83,0,90,7
1683692176892,MGT 164,A00,202873,Staff,0,67,90,91
1683692177919,MGT 164GS,A00,202874,McKay; Mary A,13,0,28,15
1683692178943,MGT 180,A00,202875,Staff,0,51,90,91
1683692179968,MMW 11R,A01,205019,Herbst; Matthew,0,0,30,30
1683692179968,MMW 11R,A02,205026,Herbst; Matthew,29,0,30,1
1683692180997,MMW 15,A01,193512,Chang; Edmond Yi-Teh,0,8,28,28
1683692180997,MMW 15,A02,193513,Chang; Edmond Yi-Teh,0,5,28,28
1683692180997,MMW 15,A03,193514,Chang; Edmond Yi-Teh,0,5,28,28
1683692180997,MMW 15,A04,193515,Chang; Edmond Yi-Teh,0,5,28,28
1683692180997,MMW 15,A05,193516,Chang; Edmond Yi-Teh,0,5,28,28
1683692180997,MMW 15,A06,193517,Chang; Edmond Yi-Teh,0,6,28,28
1683692180997,MMW 15,B01,193519,Chang; Edmond Yi-Teh,0,5,28,28
1683692180997,MMW 15,B02,193520,Chang; Edmond Yi-Teh,0,5,28,28
1683692180997,MMW 15,B03,193521,Chang; Edmond Yi-Teh,0,5,28,28
1683692180997,MMW 15,B04,193522,Chang; Edmond Yi-Teh,0,6,28,28
1683692180997,MMW 15,B05,193523,Chang; Edmond Yi-Teh,0,5,28,28
1683692180997,MMW 15,B06,193524,Chang; Edmond Yi-Teh,0,5,28,28
1683692182024,MMW 122,A01,193526,Rahimi; Babak,0,16,28,28
1683692182024,MMW 122,A02,193527,Rahimi; Babak,0,15,28,28
1683692182024,MMW 122,A03,193528,Rahimi; Babak,0,0,0,0
1683692182024,MMW 122,A04,193529,Rahimi; Babak,0,0,0,0
1683692183049,MUS 1A,A01,186663,Staff,1,19,35,34
1683692184072,MUS 4,A01,186715,Staff,0,12,35,35
1683692185098,MUS 5R,A01,186796,Dubnov; Shlomo,0,17,35,35
1683692186122,MUS 6,A01,186798,Staff,1,5,25,24
1683692187146,MUS 7,A01,186830,Staff,11,0,35,24
1683692188170,MUS 8,A01,186930,Staff,0,27,35,35
1683692189195,MUS 15,A01,186932,Staff,0,15,35,35
1683692189195,MUS 15,B01,186934,Staff,1,17,35,34
1683692190220,MUS 80,A00,186935,Staff,0,0,20,20
1683692190220,MUS 80,B00,186936,Staff,24,0,25,1
1683692191248,NANO 11,A00,204702,Lipomi; Darren John,0,0,0,0
1683692192271,NANO 15,A01,204709,Yang; Kesong,0,1,0,0
1683692193298,NANO 114,A00,202069,Jahed Motlagh; Zeinab,2,0,10,8
1683692194324,PHIL 1,A00,186955,Grush; Rick Scott,31,0,40,9
1683692195349,PHIL 10,A01,186973,Grush; Rick Scott,27,0,35,8
1683692195349,PHIL 10,A02,186974,Grush; Rick Scott,33,0,35,2
1683692196371,PHIL 13,A01,186976,Staff,1,0,35,34
1683692196371,PHIL 13,A02,186977,Staff,16,0,35,19
1683692197396,PHIL 14,A01,186979,Staff,31,0,35,4
1683692197396,PHIL 14,A02,186986,Staff,32,0,35,3
1683692198421,PHIL 28,A01,186988,Staff,16,0,30,14
1683692198421,PHIL 28,A02,186989,Staff,1,0,30,29
1683692198421,PHIL 28,A03,186990,Staff,10,0,30,20
1683692198421,PHIL 28,A04,186991,Staff,26,0,30,4
1683692199446,PHIL 120,A00,186997,Staff,23,0,40,17
1683692200470,PHIL 137,A00,187003,Staff,7,0,40,33
1683692201493,PHIL 150,A00,187015,Staff,47,0,70,23
1683692202517,PHIL 167,A00,187021,Lamey; Andy M.,34,0,40,6
1683692203541,PHIL 174,A01,202226,Staff,17,0,20,3
1683692203541,PHIL 174,A02,202235,Staff,20,0,20,0
1683692204565,PHIL 191A,A00,258918,Staff,0,0,1,1
1683692205592,PHYS 1A,A00,187028,Staff,26,0,60,34
1683692206619,PHYS 1AL,001,187036,Staff,3,0,30,27
1683692206619,PHYS 1AL,002,187049,Staff,18,0,30,12
1683692207645,PHYS 1B,A00,187058,Staff,22,0,60,38
1683692208667,PHYS 1BL,001,187064,Staff,0,1,30,30
1683692208667,PHYS 1BL,002,187070,Staff,4,0,30,26
1683692209691,PHYS 1C,A00,187082,Staff,29,0,120,91
1683692210715,PHYS 1CL,001,187088,Staff,0,9,30,30
1683692210715,PHYS 1CL,002,187089,Staff,0,1,30,30
1683692210715,PHYS 1CL,009,262693,Staff,9,0,30,21
1683692211741,PHYS 2B,A01,187097,Staff,55,0,115,60
1683692212767,PHYS 2C,A01,187099,Staff,63,0,115,52
1683692213791,PHYS 2CL,A01,187101,Staff,5,0,28,23
1683692213791,PHYS 2CL,A02,187102,Staff,15,0,28,13
1683692214815,PHYS 2D,A01,187123,Shotwell; Brian,95,0,115,20
1683692215840,PHYS 4B,A01,187133,Grinstein; Benjamin,35,0,50,15
1683692216866,POLI 10,A00,188819,Staff,0,4,50,50
1683692217890,POLI 11,A00,188827,Staff,43,0,50,7
1683692218914,POLI 13R,A00,188828,Staff,0,1,20,20
1683692219938,POLI 27,A01,188830,Elgin; Samuel Zincke,0,2,70,70
1683692220963,POLI 30,A00,188832,Desposato; Scott,30,0,50,20
1683692221989,POLI 102F,A00,188834,Staff,1,0,40,39
1683692223015,POLI 104A,A00,188852,Staff,12,0,30,18
1683692224038,POLI 104I,A00,188853,Staff,0,8,20,20
1683692225060,POLI 110B,A00,188854,Wiens; David,6,0,20,14
1683692226084,POLI 112A,A00,188855,Wiens; David,3,0,30,27
1683692227110,POLI 117R,A00,188856,Forman; Fonna,0,12,20,20
1683692228137,POLI 118,A00,188857,Ingham; Sean,8,0,20,12
1683692229162,POLI 120G,A00,188858,Staff,8,0,30,22
1683692230186,POLI 131CR,A00,188863,Hoston; Germaine,20,0,50,30
1683692231214,POLI 133,A00,188864,Nellis; Gareth Hb,44,0,50,6
1683692232239,POLI 134D,A00,188865,Desposato; Scott,27,0,30,3
1683692233266,POLI 142A,A00,188871,Gartzke; Erik,21,0,50,29
1683692234289,POLI 142K,A00,188874,Staff,38,0,50,12
1683692235313,POLI 143,A00,188940,Gartzke; Erik,16,0,30,14
1683692236337,POLI 153,A00,188943,Staff,2,0,20,18
1683692237362,POLI 160AA,A00,188944,Staff,10,0,40,30
1683692238390,POLI 170A,A00,188945,Staff,10,0,30,20
1683692240444,PSYC 1,A00,188952,Staff,36,0,90,54
1683692241472,PSYC 2,B00,188953,Staff,19,0,35,16
1683692242497,PSYC 6,A00,188970,Staff,47,0,60,13
1683692243522,PSYC 7,A00,188973,Staff,35,0,45,10
1683692244547,PSYC 60,A01,188980,Rickard; Timothy C.,42,0,60,18
1683692245575,PSYC 70,A01,189001,Steiner; Eric Tomas,21,0,45,24
1683692246599,PSYC 100,A00,189005,Lacefield; Katharine I,0,99,120,120
1683692247623,PSYC 102,A00,189008,Staff,7,0,30,23
1683692248648,PSYC 106,B00,189026,Gorman; Michael R.,27,0,60,33
1683692249671,PSYC 114,B01,189033,Winkielman; Piotr,0,31,30,30
1683692250695,PSYC 131,A00,189036,Anagnostaras; Stephan,0,43,60,60
1683692251719,PSYC 136,A00,189041,Lowe; Angela Beth,0,7,25,25
1683692252744,PSYC 137,A00,189057,Winkielman; Piotr,1,37,25,24
1683692253770,PSYC 144,A00,189107,Wixted; John T,0,11,50,50
1683692255820,PSYC 162,A00,189142,Staff,0,9,85,85
1683692256844,PSYC 172,A00,189144,Gorman; Michael R.,0,6,30,30
1683692258896,PSYC 179,A00,189146,Lacefield; Katharine I,0,88,120,120
1683692259924,PSYC 181,A00,189147,Anagnostaras; Stephan,0,44,90,90
1683692260947,PSYC 190R,A00,189148,Barner; David A.,0,23,80,80
1683692261988,PSYC 191,A00,189275,Rickard; Timothy C.,0,11,25,25
1683692263014,PSYC 193,A00,189276,Chapman; Eddie Nathaniel,0,1,0,4
1683692264037,PSYC 193L,A01,189281,Lowe; Angela Beth,8,0,20,12
1683692264037,PSYC 193L,B01,189285,Staff,28,0,35,7
1683692265061,RELI 149,A00,187137,Rahimi; Babak,6,0,40,34
1683692266139,SE 9,A01,187315,Staff,0,2,18,18
1683692267162,SE 101B,A00,187409,Staff,24,0,30,6
1683692268187,SE 110B,A00,187444,Staff,10,0,40,30
1683692269212,SE 130B,A00,187449,Staff,31,0,40,9
1683692270242,SE 150A,A00,187516,Staff,8,0,20,12
1683692271265,SE 154,A00,187528,Staff,29,0,50,21
1683692272290,SIO 3,A01,258171,Staff,35,0,40,5
1683692273317,SIO 10,A00,187144,Cook; Geoffrey W,1,7,75,74
1683692274346,SIO 45,A00,187152,Cook; Geoffrey W,0,7,100,100
1683692275373,SIO 109R,A00,194486,Staff,0,4,20,20
1683692277424,SIO 187,A01,187233,Kacev; David,12,0,40,28
1683692278449,SOCI 1,A01,258656,Thorpe; Charles Robert,28,0,30,2
1683692278449,SOCI 1,A02,258658,Thorpe; Charles Robert,30,0,30,0
1683692278449,SOCI 1,A03,258661,Thorpe; Charles Robert,25,0,25,0
1683692278449,SOCI 1,A04,258666,Thorpe; Charles Robert,22,0,25,3
1683692278449,SOCI 1,A05,258897,Thorpe; Charles Robert,22,0,25,3
1683692278449,SOCI 1,A06,258898,Thorpe; Charles Robert,25,0,25,0
1683692279473,SOCI 30,A01,258903,Pardo Guerra; Juan Pablo,14,0,30,16
1683692280497,SOCI 102,A00,258904,Staff,9,0,25,16
1683692281525,SOCI 106,A00,258905,Staff,19,0,25,6
1683692282552,SOCI 111,A00,258907,Ribas Norris; Janet Vanesa,26,0,30,4
1683692283576,SOCI 121R,A00,258908,Pardo Guerra; Juan Pablo,8,0,30,22
1683692284606,SOCI 126,A01,203330,Staff,14,0,20,6
1683692285629,SOCI 131,A00,258909,Thorpe; Charles Robert,30,0,60,30
1683692286658,SOCI 135,A00,258910,Payne; Christine Anna,0,13,30,30
1683692287682,SOCI 157,A00,258911,Staff,11,0,30,19
1683692288710,SOCI 184,A00,258912,Staff,25,0,30,5
1683692289738,SOCI 188D,A00,258913,Staff,22,0,30,8
1683692290765,SYN 2,001,187529,Staff,9,0,16,7
1683692290765,SYN 2,002,201452,Staff,1,20,16,15
1683692290765,SYN 2,003,201469,Staff,1,0,16,15
1683692291789,SYN 100,A01,187531,Staff,0,9,20,20
1683692291789,SYN 100,B01,201491,Staff,0,10,20,20
1683692292816,TDAC 1,A00,189286,Walsh; Kim C.,3,0,20,17
1683692292816,TDAC 1,B00,189287,Harting; Carla Kelso,10,0,20,10
1683692293839,TDAC 101,A00,189300,Walsh; Kim C.,16,0,20,4
1683692293839,TDAC 101,B00,189301,Harting; Carla Kelso,18,0,20,2
1683692294868,TDAC 102,A00,189304,Basso; Beatrice,14,0,20,6
1683692295894,TDAC 108,A00,189305,Staff,18,0,20,2
1683692296919,TDDE 131,A00,189310,Staff,19,0,20,1
1683692296919,TDDE 131,B00,189314,Staff,19,0,20,1
1683692296919,TDDE 131,C00,189315,Staff,48,0,50,2
1683692296919,TDDE 131,D00,189316,Staff,14,0,15,1
1683692296919,TDDE 131,E00,204841,Staff,20,0,20,0
1683692297944,TDGE 10,A00,189289,Staff,27,0,50,23
1683692297944,TDGE 10,B00,189290,Havis; Allan,0,1,50,50
1683692298969,TDGE 11,A00,189291,Fulton; Julia,0,4,50,50
1683692298969,TDGE 11,B00,189292,Staff,20,0,25,5
1683692298969,TDGE 11,C00,260270,Staff,0,0,0,0
1683692299994,TDGE 25,A00,189294,Staff,1,0,20,19
1683692301019,TDGE 124,A00,189318,Fulton; Julia,1,8,50,49
1683692302042,TDGE 125,A00,189319,Staff,13,0,25,12
1683692302042,TDGE 125,B00,189320,Staff,23,0,25,2
1683692303069,TDGE 127,A00,189322,Havis; Allan,0,0,50,50
1683692304093,TDHT 101,A00,189323,Staff,18,0,25,7
1683692304093,TDHT 101,B00,189324,Staff,25,0,25,0
1683692305120,TDHT 102,A00,189325,Staff,49,0,50,1
1683692306143,TDMV 1,A00,189295,Arcidiacono; Kristin,20,0,30,10
1683692306143,TDMV 1,B00,189296,Caligagan; Maria T.,24,0,30,6
1683692307169,TDMV 2,A00,189297,Sammartano; Tonnie,27,0,30,3
1683692307169,TDMV 2,B00,189299,Arcidiacono; Kristin,23,0,30,7
1683692308191,TDMV 3,A00,204998,Rincon; Alicia,22,0,30,8
1683692309216,TDMV 120,A00,189458,Sammartano; Tonnie,28,0,30,2
1683692310239,TDMV 138,A00,189541,Jun; Grace Shin Hae,20,0,40,20
1683692311265,TDMV 142,A00,189717,Caligagan; Tony,25,0,30,5
1683692311265,TDMV 142,B00,189718,Caligagan; Maria T.,25,0,30,5
1683692312293,TMC 2,A01,187533,Staff,25,0,25,0
1683692312293,TMC 2,A02,187534,Staff,25,0,25,0
1683692313317,USP 1,A01,187536,Kwak; Nancy,0,16,25,25
1683692314344,USP 5,A01,187538,Staff,8,0,25,17
1683692315367,USP 101,A00,199253,Staff,0,4,0,0
1683692316392,USP 124,A00,187562,Boomhower; Matthew Charles,0,0,30,30
1683692317416,USP 138,A00,187582,Staff,19,0,25,6
1683692318440,USP 152,A01,187597,Staff,3,0,25,22
1683692319467,USP 153,A00,187598,Staff,18,0,25,7
1683692320495,USP 168,A00,187607,Kwak; Nancy,2,0,5,3
1683692321518,USP 173,A00,187619,Staff,4,0,25,21
1683692322543,USP 181,A00,187638,Staff,0,4,25,25
1683692323569,VIS 103,A00,187650,Cruz; Edwin Teddy,17,0,75,58
1683692324594,VIS 110D,A00,187669,Staff,13,0,22,9
1683692325618,VIS 127C,A00,187720,Shen; Kuiyi,67,0,146,79
1683692326641,VIS 149,A00,187731,Yoldas; Pinar,2,14,22,20
1683692327668,VIS 151,A01,188091,Staff,22,0,34,12
1683692327668,VIS 151,A02,188092,Staff,11,0,34,23
1683692328695,VIS 160B,A00,188093,Stalbaum; Brett,0,1,10,10
1683692330748,WCWP 10B,A00,201720,Staff,0,0,5,5
1683692330748,WCWP 10B,B00,201722,Staff,0,0,6,6
1683692331775,WCWP 100,A00,201725,Gagnon; Jeffrey C,0,0,2,2
1683692331775,WCWP 100,B00,201727,Staff,0,4,15,15
1683692334904,ANBI 133,A00,258401,Wilder; Linnea Lorene,34,0,40,6
1683692335931,ANBI 140,A00,258395,Hrvoj Mihic; Branka,18,0,25,7
1683692336958,ANSC 120,A00,258402,Bialecki; Jon Anthony,26,0,40,14
1683692337983,ANSC 144,A00,258400,Staff,12,0,40,28
1683692340035,ANSC 166,A00,258396,Parish; Steven Martin,156,0,175,19
1683692341061,ANSC 180,A00,193533,Staff,8,0,20,12
1683692342083,ANSC 188,A00,258397,Jassal; Aftab,34,0,40,6
1683692343109,ANTH 3,A01,258316,Staff,23,0,30,7
1683692344133,ANTH 5,A00,258394,Semendeferi; Ekaterini,16,0,20,4
1683692345160,ANTH 21,A01,258331,Staff,4,0,40,36
1683692346188,ANTH 103,A00,258398,Varma; Saiba,15,0,25,10
1683692347220,AWP 10,001,202034,Staff,0,0,0,0
1683692347220,AWP 10,002,202035,Staff,0,0,0,0
1683692347220,AWP 10,003,202036,Staff,0,0,0,0
1683692347220,AWP 10,004,202037,Staff,0,0,0,0
1683692347220,AWP 10,005,202038,Staff,0,0,0,0
1683692347220,AWP 10,006,202039,Staff,0,0,0,0
1683692347220,AWP 10,007,202040,Staff,0,0,0,0
1683692347220,AWP 10,008,202041,Staff,0,0,0,0
1683692347220,AWP 10,009,202042,Staff,0,0,0,0
1683692347220,AWP 10,010,202043,Staff,0,0,0,0
1683692347220,AWP 10,011,202044,Staff,0,0,0,0
1683692347220,AWP 10,012,202045,Staff,0,0,0,0
1683692347220,AWP 10,013,202046,Staff,0,0,0,0
1683692347220,AWP 10,014,202047,Staff,0,0,0,0
1683692347220,AWP 10,015,202048,Staff,0,0,0,0
1683692347220,AWP 10,016,202049,Staff,0,0,0,0
1683692347220,AWP 10,017,202050,Staff,0,0,0,0
1683692347220,AWP 10,018,202051,Staff,0,0,0,0
1683692347220,AWP 10,019,202052,Staff,0,0,0,0
1683692347220,AWP 10,020,202053,Staff,0,0,0,0
1683692347220,AWP 10,021,202054,Staff,0,0,0,0
1683692347220,AWP 10,022,202055,Staff,0,0,0,0
1683692347220,AWP 10,023,202056,Staff,0,0,0,0
1683692347220,AWP 10,024,202057,Staff,0,0,0,0
1683692347220,AWP 10,025,202058,Staff,0,0,0,0
1683692347220,AWP 10,026,202059,Staff,0,0,0,0
1683692348244,AWP 102,001,202032,Staff,0,0,0,0
1683692348244,AWP 102,002,202033,Staff,0,0,0,0
1683692349271,BENG 100,A01,254234,Taylor Amos; Alyssa C,31,0,40,9
1683692350294,BENG 196,001,270013,Engler; Adam J.,9999,0,9999,0
1683692351319,BICD 100R,A01,202018,Smith; Laurie,0,7,32,32
1683692351319,BICD 100R,A02,202019,Smith; Laurie,0,3,32,32
1683692351319,BICD 100R,A03,202020,Smith; Laurie,0,1,32,32
1683692351319,BICD 100R,A04,202021,Smith; Laurie,6,0,32,26
1683692351319,BICD 100R,A05,202022,Smith; Laurie,10,0,32,22
1683692352344,BICD 136,A01,193242,Gustafson-Brown; Cindy,0,2,32,32
1683692352344,BICD 136,A02,193244,Gustafson-Brown; Cindy,13,0,32,19
1683692353369,BIEB 102,A01,193249,Butler; Shannon Rhey,1,1,32,31
1683692353369,BIEB 102,A02,193251,Butler; Shannon Rhey,0,0,32,32
1683692353369,BIEB 102,A03,193253,Butler; Shannon Rhey,0,0,32,32
1683692353369,BIEB 102,A04,193255,Butler; Shannon Rhey,13,0,32,19
1683692353369,BIEB 102,A05,193265,Butler; Shannon Rhey,25,0,32,7
1683692353369,BIEB 102,A06,193269,Butler; Shannon Rhey,13,0,32,19
1683692355419,BIEB 150,A01,193274,Staff,0,0,32,32
1683692355419,BIEB 150,A02,193285,Staff,24,0,32,8
1683692356442,BIEB 194,A00,193286,Kurle; Carolyn M.,19,0,32,13
1683692357466,BILD 1,A01,192291,Staff,15,0,32,17
1683692357466,BILD 1,A02,192292,Staff,30,0,32,2
1683692357466,BILD 1,B01,192520,Reuther; Keefe,0,1,0,0
1683692357466,BILD 1,B02,192532,Reuther; Keefe,0,1,0,0
1683692358496,BILD 3,A01,192556,Butler; Shannon Rhey,0,0,32,32
1683692358496,BILD 3,A02,192581,Butler; Shannon Rhey,0,1,32,32
1683692358496,BILD 3,A03,192611,Butler; Shannon Rhey,19,0,32,13
1683692358496,BILD 3,A04,192612,Butler; Shannon Rhey,23,0,32,9
1683692358496,BILD 3,A05,192613,Butler; Shannon Rhey,26,0,32,6
1683692358496,BILD 3,A06,192679,Butler; Shannon Rhey,27,0,32,5
1683692358496,BILD 3,A07,192682,Butler; Shannon Rhey,20,0,32,12
1683692359521,BILD 4,A01,192836,Reuther; Keefe,1,0,24,23
1683692359521,BILD 4,A02,193044,Reuther; Keefe,4,0,24,20
1683692360545,BILD 10,A01,193142,Gustafson-Brown; Cindy,29,0,32,3
1683692360545,BILD 10,A02,193149,Gustafson-Brown; Cindy,31,0,32,1
1683692361570,BIMM 100,A01,193301,Staff,0,6,32,32
1683692361570,BIMM 100,A02,193312,Staff,0,7,32,32
1683692361570,BIMM 100,A03,193323,Staff,0,10,32,32
1683692362595,BIMM 101,A01,193329,McDonnell; Lisa Marie,1,4,24,23
1683692362595,BIMM 101,A02,193339,McDonnell; Lisa Marie,1,4,24,23
1683692362595,BIMM 101,B01,193354,McDonnell; Lisa Marie,0,4,24,24
1683692362595,BIMM 101,B02,193357,McDonnell; Lisa Marie,0,3,24,24
1683692363621,BIMM 110,A01,193377,Tat; John,0,11,32,32
1683692363621,BIMM 110,A02,193378,Tat; John,0,11,32,32
1683692364649,BIMM 120,A01,206116,Staff,0,0,32,32
1683692364649,BIMM 120,A02,206117,Staff,7,0,32,25
1683692364649,BIMM 120,A03,206121,Staff,21,0,32,11
1683692365674,BIPN 100,A01,193393,Park; Ji Young,0,15,32,32
1683692365674,BIPN 100,A02,193402,Park; Ji Young,0,14,32,32
1683692365674,BIPN 100,A03,193413,Park; Ji Young,0,14,32,32
1683692365674,BIPN 100,A04,193414,Park; Ji Young,0,13,32,32
1683692366702,BIPN 102,A01,193429,Staff,0,0,32,32
1683692366702,BIPN 102,A02,193438,Staff,18,0,32,14
1683692367729,BIPN 106,A01,193450,Reyes Gonzalez; Catalina,0,2,40,40
1683692368757,BIPN 134,A01,193465,Cooke; James Edward,0,0,32,32
1683692368757,BIPN 134,A02,193474,Cooke; James Edward,25,0,32,7
1683692368757,BIPN 134,A03,193485,Cooke; James Edward,29,0,32,3
1683692368757,BIPN 134,A04,193486,Cooke; James Edward,20,0,32,12
1683692368757,BIPN 134,A05,193491,Cooke; James Edward,31,0,32,1
1683692368757,BIPN 134,A06,193501,Cooke; James Edward,30,0,32,2
1683692368757,BIPN 134,A07,193510,Cooke; James Edward,29,0,32,3
1683692370859,BISP 194,A00,222522,Staff,14,0,32,18
1683692371884,CAT 124,A01,202407,Staff,19,0,25,6
1683692372908,CAT 125,A00,202408,Marchisotto; Jennifer Anne,2,0,20,18
1683692373932,CAT 125R,A00,202409,Smith; Lauryn Alissa,0,11,20,20
1683692373932,CAT 125R,B00,202410,Morales; Celeste Georgianna,0,11,20,20
1683692373932,CAT 125R,C00,202411,Irwin; Matthew Joseph,0,12,20,20
1683692374957,CENG 15,A01,204712,Yang; Kesong,0,1,0,0
1683692375981,CENG 114,A00,202070,Jahed Motlagh; Zeinab,5,0,20,15
1683692377007,CGS 105,A00,185477,Wesling; Megan E.,24,0,40,16
1683692378034,CGS 106,A00,185494,Staff,11,0,22,11
1683692379057,CGS 108,A00,185495,Staff,14,0,20,6
1683692380081,CGS 114,A00,185496,Staff,13,0,18,5
1683692381105,CGS 119,A00,185501,Staff,15,0,20,5
1683692382131,CGS 120,A00,185511,Staff,12,0,20,8
1683692383156,CHEM 4,A01,184675,Bussey; Thomas J,97,0,100,3
1683692384183,CHEM 6A,A01,184677,Staff,32,0,60,28
1683692385210,CHEM 6B,A01,184679,Staff,63,0,100,37
1683692386233,CHEM 6C,A01,184681,Bussey; Thomas J,0,0,50,50
1683692386233,CHEM 6C,A02,184682,Bussey; Thomas J,32,0,50,18
1683692387257,CHEM 40A,A01,184684,Albizati; Kim F.,33,0,100,67
1683692388281,CHEM 40B,A01,184686,Albizati; Kim F.,0,22,100,100
1683692389307,CHEM 41B,A01,184690,Staff,51,0,100,49
1683692390331,COGS 3,A01,184715,Boyle; Mary E. T.,0,27,40,40
1683692391355,COGS 14B,A01,185172,Staff,0,14,38,38
1683692392379,COGS 18,A01,184736,Staff,14,0,80,66
1683692393404,COGS 100,A01,184932,Staff,0,8,73,73
1683692394431,COGS 101A,A01,184935,Staff,0,40,30,30
1683692395457,COGS 101B,A01,184944,Staff,0,2,30,30
1683692396481,COGS 101C,A01,184946,Staff,0,10,30,30
1683692397506,COGS 102A,A01,184951,Johnson; Christine M.,1,0,40,39
1683692398531,COGS 107B,A01,184953,Mooshagian; Eric Frederick,0,52,40,40
1683692399557,COGS 118B,A01,184959,Gupta; Anjum,0,50,40,40
1683692400584,COGS 153,A00,184961,Staff,0,16,30,30
1683692401612,COGS 177,A00,184962,Staff,1,21,30,29
1683692402639,COGS 187A,A01,184969,Boyle; Mary E. T.,0,19,40,40
1683692403663,COMM 10,A01,185174,Staff,0,5,25,25
1683692403663,COMM 10,A02,185189,Staff,0,2,25,25
1683692403663,COMM 10,A03,269821,Staff,0,1,0,0
1683692404688,COMM 100B,A02,185476,Staff,10,0,25,15
1683692404688,COMM 100B,A03,277340,Staff,25,0,25,0
1683692405713,COMM 100C,A01,185314,Staff,1,0,25,24
1683692405713,COMM 100C,A02,185327,Staff,17,0,25,8
1683692406739,COMM 110M,A00,185349,Staff,0,0,40,40
1683692407765,COMM 113T,A00,185352,Staff,25,0,40,15
1683692408792,COMM 114I,A00,185353,Staff,31,0,40,9
1683692409817,COMM 131,A00,185354,Staff,17,0,30,13
1683692410841,CSE 8A,A50,185358,Cao; Yingjun,0,46,10,10
1683692411868,CSE 8B,A01,185362,Staff,0,48,50,50
1683692412892,CSE 11,A01,185416,Cao; Yingjun,0,91,10,10
1683692413917,CSE 20,A01,185445,Briones; Jor-el Thomas Caparas,3,0,25,22
1683692414941,CSE 21,A01,185447,Staff,9,0,50,41
1683692415966,CSE 101,A01,185451,Staff,0,13,50,50
1683692415966,CSE 101,B01,185453,Jones; Miles E,0,14,50,50
1683692418014,CSE 141,A01,185458,Eldon; John,16,0,100,84
1683692419039,CSE 141L,A01,185461,Eldon; John,8,0,100,92
1683692420063,CSE 142,A01,185463,Staff,34,0,60,26
1683692420063,CSE 142,B01,201355,Staff,0,7,60,60
1683692421086,CSE 142L,A01,185470,Staff,34,0,60,26
1683692421086,CSE 142L,B01,201417,Staff,0,6,60,60
1683692422111,CSE 190,A00,201433,Staff,32,0,49,17
1683692423135,DOC 1,A01,259136,Strom; Megan C.,7,0,15,8
1683692423135,DOC 1,A02,259137,Strom; Megan C.,14,0,15,1
1683692423135,DOC 1,A03,259138,Strom; Megan C.,14,0,15,1
1683692423135,DOC 1,A04,259139,Strom; Megan C.,14,0,15,1
1683692424160,DOC 100D,A00,259140,Pass; Natalye Joann,14,0,25,11
1683692425183,DSGN 1,A01,184749,Rill; Bryan,0,26,30,30
1683692426206,DSGN 100,A01,185168,Staff,0,2,25,25
1683692427234,ECE 5,A01,185626,Morris; Karcher William,0,12,0,0
1683692428257,ECE 101,A01,185628,Staff,14,0,70,56
1683692429282,ECE 107,A01,185635,Baghdadchi; Saharnaz,0,0,20,20
1683692429282,ECE 107,A02,185638,Baghdadchi; Saharnaz,1,0,20,19
1683692430306,ECE 148,A01,185647,Silberman; Jack,0,0,16,16
1683692431330,ECON 1,A01,185537,Crane; Meredith Helen,54,0,70,16
1683692432354,ECON 3,A01,185549,Crane; Meredith Helen,30,0,70,40
1683692433378,ECON 4,A01,203354,Anderson; John Charles,0,5,10,10
1683692434402,ECON 100A,A01,185574,Staff,0,5,40,40
1683692435425,ECON 100B,A01,185576,Staff,0,12,50,50
1683692436448,ECON 100C,A01,185589,Newhouse; Herbert S,30,0,70,40
1683692437470,ECON 105,A00,185608,Vespa; Emanuel Ignacio,19,0,35,16
1683692438494,ECON 109,A01,185610,Shishkin; Denis,9,0,35,26
1683692439517,ECON 110A,A01,185612,Staff,8,0,40,32
1683692440541,ECON 120A,A01,185615,Staff,19,0,40,21
1683692441569,ECON 120C,A01,185617,Sun; Yixiao,0,21,70,70
1683692442593,ECON 144,A00,203346,Squires; Dale E,2,0,35,33
1683692443621,ECON 171,A01,203349,Newhouse; Herbert S,0,1,35,35
1683692444644,ECON 173A,A01,185621,Toda; Alexis Akira,21,0,35,14
1683692445676,EDS 25,A01,202413,Staff,0,1,0,0
1683692445676,EDS 25,A02,202414,Staff,0,1,0,0
1683692445676,EDS 25,A03,202415,Staff,0,0,0,0
1683692445676,EDS 25,A04,202416,Staff,0,1,0,0
1683692445676,EDS 25,A05,202439,Staff,0,0,0,0
1683692445676,EDS 25,A06,202440,Staff,0,0,0,0
1683692445676,EDS 25,B01,202631,Staff,0,0,0,0
1683692445676,EDS 25,B02,202632,Staff,0,0,0,0
1683692445676,EDS 25,B03,202639,Staff,0,0,0,0
1683692445676,EDS 25,B04,202640,Staff,0,0,0,0
1683692445676,EDS 25,B05,202643,Staff,0,0,0,0
1683692445676,EDS 25,B06,202644,Staff,0,0,0,0
1683692446700,EDS 38,A01,202659,Black; Alison Michelle,24,0,25,1
1683692447725,EDS 115,A00,202652,Staff,18,0,30,12
1683692448749,EDS 125,A00,202649,Staff,13,0,30,17
1683692449776,EDS 126,A01,203332,Staff,30,0,30,0
1683692450798,EDS 139,A00,202838,Staff,16,0,25,9
1683692451826,EDS 146,A01,202655,Staff,14,0,25,11
1683692452852,ENG 15,A00,185667,Staff,0,1,0,0
1683692452852,ENG 15,B00,185672,Staff,0,0,0,0
1683692452852,ENG 15,C00,185675,Staff,0,0,0,0
1683692452852,ENG 15,D00,185682,Staff,0,0,0,0
1683692452852,ENG 15,E00,185684,Staff,0,0,0,0
1683692453877,ETHN 103,A00,185710,Staff,0,8,35,35
1683692454904,ETHN 103A,A00,199228,Man; Simeon S,0,0,9,9
1683692455928,ETHN 109,A00,185711,Staff,15,0,35,20
1683692456954,ETHN 142,A00,185726,Staff,0,4,30,30
1683692457978,ETHN 163J,A00,199229,Man; Simeon S,5,0,8,3
1683692459001,ETHN 168,A00,185727,Staff,7,0,10,3
1683692460025,ETHN 182,A00,185728,Staff,0,0,35,35
1683692461049,ETHN 183,A00,185737,Staff,9,0,18,9
1683692462073,GLBH 111,A01,209361,Burgos; Jose L.,0,0,0,0
1683692464121,HIEU 104,A00,185792,Staff,14,0,20,6
1683692465145,HIEU 115,A00,185800,Staff,0,0,20,20
1683692466170,HIEU 128,A00,185801,Staff,0,9,20,20
1683692467197,HIEU 147,A00,185802,Staff,15,0,20,5
1683692468222,HIEU 154,A00,185823,Staff,11,0,20,9
1683692469247,HILA 102,A00,185826,Staff,14,0,20,6
1683692470275,HILD 2C,A01,185778,Staff,0,13,20,20
1683692471303,HILD 7B,A01,185780,Kwak; Nancy,0,17,32,32
1683692471303,HILD 7B,A02,185781,Kwak; Nancy,0,18,32,32
1683692472332,HILD 30,A01,185791,Staff,12,0,20,8
1683692473418,HISC 119,A00,185830,Golan; Tal,0,11,20,20
1683692474444,HITO 156GS,A00,185831,Patterson; Patrick H.,0,0,0,23
1683692475468,HIUS 103,A00,185832,Man; Simeon S,0,4,20,20
1683692476494,HIUS 117,A00,185836,Kwak; Nancy,2,0,20,18
1683692477518,HIUS 125,A00,185840,Man; Simeon S,0,3,23,23
1683692478543,HIUS 149,A00,185845,Staff,1,0,20,19
1683692479568,HUM 3,A01,185882,Zavodny; Tatiana Sophia,0,8,50,50
1683692479568,HUM 3,B01,185899,Caldwell; Michael Alan,0,18,50,50
1683692480595,HUM 3GS,A00,185900,Patterson; Patrick H.,0,0,0,23
1683692481620,HUM 4,A01,185938,Zroka; Amy Liane,28,0,50,22
1683692481620,HUM 4,B01,185956,Watkins; Eric,0,6,50,50
1683692481620,HUM 4,B02,202209,Watkins; Eric,0,5,50,50
1683692481620,HUM 4,B03,202210,Watkins; Eric,0,5,50,50
1683692482647,HUM 5,A01,185958,West; Geoffrey Scott,0,0,50,50
1683692482647,HUM 5,A02,202215,West; Geoffrey Scott,0,1,50,50
1683692483674,INTL 190,A00,185959,Gagnon; Jeffrey C,0,0,0,9
1683692483674,INTL 190,B00,185960,Lettieri; Michael Joseph,0,0,0,2
1683692484701,JAPN 180,A00,254509,Staff,5,0,30,25
1683692485725,LATI 10,A01,202853,Kennemore; Amy Michelle,4,0,35,31
1683692485725,LATI 10,A02,202854,Kennemore; Amy Michelle,3,0,35,32
1683692485725,LATI 10,A03,270054,Kennemore; Amy Michelle,30,0,30,0
1683692486750,LATI 180,A00,202855,Kennemore; Amy Michelle,11,0,20,9
1683692487776,LAWS 101,A00,201767,Golan; Tal,0,7,40,40
1683692488801,LIFR 1C,A00,185961,Staff,6,0,20,14
1683692489822,LIFR 1CX,A00,185962,Staff,7,0,20,13
1683692490846,LIFR 1D,A00,185963,Staff,7,0,20,13
1683692491870,LIFR 1DX,A00,185964,Staff,7,0,20,13
1683692492894,LIGN 101,A01,186039,Staff,43,0,50,7
1683692493922,LIGN 165,A00,186040,Staff,15,0,50,35
1683692494946,LTCS 108,A00,186041,Staff,5,0,10,5
1683692495971,LTCS 119,A00,186042,Staff,15,0,20,5
1683692496999,LTCS 130,A00,186043,Wesling; Megan E.,15,0,25,10
1683692499049,LTEA 138,A00,186119,Staff,14,0,40,26
1683692500075,LTEN 124,A00,186148,Staff,5,0,25,20
1683692501102,LTEN 178,A00,186149,Staff,6,0,15,9
1683692502128,LTEN 181,A00,186150,Blanco; John D,34,0,40,6
1683692503150,LTWL 120,A00,186160,Staff,19,0,25,6
1683692504177,LTWL 165,A00,186161,Staff,22,0,25,3
1683692505204,LTWR 100,A00,186162,Staff,0,5,15,15
1683692506229,LTWR 102,A00,186163,Doller; Ben,5,0,15,10
1683692507253,MAE 8,A01,186412,Staff,0,1,0,0
1683692508277,MAE 30B,A00,186445,Bahadori; Mohammad Yousef,81,0,100,19
1683692509301,MAE 40,A00,186592,Bewley; Thomas R,10,0,50,40
1683692510326,MAE 101B,A00,186593,Bahadori; Mohammad Yousef,80,0,100,20
1683692511351,MAE 105,A00,186594,Bandaru; Prabhakar,10,0,50,40
1683692512379,MAE 107,A00,186599,Pham; Hieu Tan,0,7,120,120
1683692513402,MAE 148,A01,186660,Silberman; Jack,3,0,16,13
1683692514428,MATH 10A,A01,188095,Staff,0,6,35,35
1683692515453,MATH 10B,A01,188097,Bowers; Adam R.,0,12,30,30
1683692515453,MATH 10B,A02,188099,Bowers; Adam R.,0,11,30,30
1683692515453,MATH 10B,B01,188104,Bowers; Adam R.,0,10,30,30
1683692515453,MATH 10B,B02,188106,Bowers; Adam R.,1,10,30,29
1683692516482,MATH 10C,A01,188111,Staff,0,20,30,30
1683692516482,MATH 10C,A02,188127,Staff,0,19,30,30
1683692516482,MATH 10C,A03,188131,Staff,0,19,30,30
1683692516482,MATH 10C,B01,188218,Staff,17,0,30,13
1683692516482,MATH 10C,B02,188244,Staff,13,0,30,17
1683692516482,MATH 10C,B03,188277,Staff,14,0,30,16
1683692517508,MATH 18,A01,188344,Bach; Quang Tran,18,0,30,12
1683692517508,MATH 18,A02,188345,Bach; Quang Tran,11,0,30,19
1683692517508,MATH 18,B01,188353,Bach; Quang Tran,11,0,30,19
1683692517508,MATH 18,B02,188354,Bach; Quang Tran,19,0,30,11
1683692518533,MATH 20A,A01,188374,Staff,11,0,35,24
1683692519558,MATH 20B,A01,188382,Ohm; Ko Woon,7,0,30,23
1683692519558,MATH 20B,A02,188383,Ohm; Ko Woon,22,0,30,8
1683692519558,MATH 20B,B01,188385,Ohm; Ko Woon,7,0,30,23
1683692519558,MATH 20B,B02,188392,Ohm; Ko Woon,22,0,30,8
1683692520583,MATH 20C,A01,188394,Harel; Guershon,10,0,30,20
1683692520583,MATH 20C,A02,188395,Harel; Guershon,13,0,30,17
1683692520583,MATH 20C,B01,188404,Harel; Guershon,5,0,30,25
1683692520583,MATH 20C,B02,188405,Harel; Guershon,18,0,30,12
1683692521608,MATH 20D,A01,188414,Hammock; Frances H,0,1,30,30
1683692521608,MATH 20D,A02,188415,Hammock; Frances H,0,1,30,30
1683692521608,MATH 20D,B01,188447,Hammock; Frances H,0,1,30,30
1683692521608,MATH 20D,B02,188486,Hammock; Frances H,2,0,30,28
1683692522633,MATH 20E,A01,188649,Staff,21,0,30,9
1683692522633,MATH 20E,A02,188650,Staff,20,0,30,10
1683692522633,MATH 20E,A03,188673,Staff,0,0,30,30
1683692523660,MATH 102,A01,188675,Staff,0,40,35,35
1683692524689,MATH 103B,A01,188681,Staff,3,0,35,32
1683692524689,MATH 103B,B01,188692,Staff,5,0,35,30
1683692525713,MATH 109,A01,188695,Salehi Golsefidy; Alireza,24,0,35,11
1683692525713,MATH 109,A02,188696,Salehi Golsefidy; Alireza,25,0,35,10
1683692526741,MATH 120A,A01,188698,Eggers; John Dietrich,7,0,35,28
1683692527766,MATH 142B,A01,188736,Ioana; Adrian,1,1,30,29
1683692527766,MATH 142B,A02,188741,Ioana; Adrian,0,1,30,30
1683692527766,MATH 142B,A03,188743,Ioana; Adrian,0,2,30,30
1683692528791,MATH 168A,A01,188790,Staff,0,11,35,35
1683692529816,MATH 170A,A01,188803,Nie; Jiawang,0,2,35,35
1683692529816,MATH 170A,A02,188811,Nie; Jiawang,0,1,35,35
1683692529816,MATH 170A,A03,188814,Nie; Jiawang,0,0,35,35
1683692529816,MATH 170A,A04,188815,Nie; Jiawang,5,0,35,30
1683692530841,MATH 193B,A01,188817,Staff,0,0,35,35
1683692530841,MATH 193B,A02,188818,Staff,6,0,35,29
1683692531866,MGT 4,A01,202857,Anderson; John Charles,59,0,80,21
1683692532891,MGT 12,A00,202858,Lindenberger; Wade Douglas,40,0,90,50
1683692533916,MGT 18,A00,202859,Staff,74,0,90,16
1683692534940,MGT 18GS,A00,202860,McKay; Michael J,13,0,28,15
1683692535964,MGT 45,A00,202861,Pecore; Joseph P.,8,0,90,82
1683692536989,MGT 100,A00,202863,Yavorsky; Daniel Ryan,27,0,90,63
1683692538013,MGT 103,A00,202864,Ehrich; Kristine R,0,19,90,90
1683692539038,MGT 112,A00,202865,Ehrich; Kristine R,15,0,90,75
1683692540067,MGT 121A,A00,202868,Staff,90,20,90,0
1683692541094,MGT 131B,A00,202869,Anderson; John Charles,58,0,90,32
1683692542121,MGT 136,A00,202871,Lindenberger; Wade Douglas,83,0,90,7
1683692543145,MGT 164,A00,202873,Staff,0,67,90,91
1683692544170,MGT 164GS,A00,202874,McKay; Mary A,13,0,28,15
1683692545195,MGT 180,A00,202875,Staff,0,51,90,91
1683692546221,MMW 11R,A01,205019,Herbst; Matthew,0,0,30,30
1683692546221,MMW 11R,A02,205026,Herbst; Matthew,29,0,30,1
1683692547251,MMW 15,A01,193512,Chang; Edmond Yi-Teh,0,8,28,28
1683692547251,MMW 15,A02,193513,Chang; Edmond Yi-Teh,0,5,28,28
1683692547251,MMW 15,A03,193514,Chang; Edmond Yi-Teh,0,5,28,28
1683692547251,MMW 15,A04,193515,Chang; Edmond Yi-Teh,0,5,28,28
1683692547251,MMW 15,A05,193516,Chang; Edmond Yi-Teh,0,5,28,28
1683692547251,MMW 15,A06,193517,Chang; Edmond Yi-Teh,0,6,28,28
1683692547251,MMW 15,B01,193519,Chang; Edmond Yi-Teh,0,5,28,28
1683692547251,MMW 15,B02,193520,Chang; Edmond Yi-Teh,0,5,28,28
1683692547251,MMW 15,B03,193521,Chang; Edmond Yi-Teh,0,5,28,28
1683692547251,MMW 15,B04,193522,Chang; Edmond Yi-Teh,0,6,28,28
1683692547251,MMW 15,B05,193523,Chang; Edmond Yi-Teh,0,5,28,28
1683692547251,MMW 15,B06,193524,Chang; Edmond Yi-Teh,0,5,28,28
1683692548274,MMW 122,A01,193526,Rahimi; Babak,0,16,28,28
1683692548274,MMW 122,A02,193527,Rahimi; Babak,0,15,28,28
1683692548274,MMW 122,A03,193528,Rahimi; Babak,0,0,0,0
1683692548274,MMW 122,A04,193529,Rahimi; Babak,0,0,0,0
1683692549302,MUS 1A,A01,186663,Staff,1,19,35,34
1683692550326,MUS 4,A01,186715,Staff,0,12,35,35
1683692551352,MUS 5R,A01,186796,Dubnov; Shlomo,0,17,35,35
1683692552379,MUS 6,A01,186798,Staff,1,5,25,24
1683692553404,MUS 7,A01,186830,Staff,11,0,35,24
1683692554428,MUS 8,A01,186930,Staff,0,27,35,35
1683692555453,MUS 15,A01,186932,Staff,0,15,35,35
1683692555453,MUS 15,B01,186934,Staff,1,17,35,34
1683692556478,MUS 80,A00,186935,Staff,0,0,20,20
1683692556478,MUS 80,B00,186936,Staff,24,0,25,1
1683692557501,NANO 11,A00,204702,Lipomi; Darren John,0,0,0,0
1683692558526,NANO 15,A01,204709,Yang; Kesong,0,1,0,0
1683692559550,NANO 114,A00,202069,Jahed Motlagh; Zeinab,2,0,10,8
1683692560574,PHIL 1,A00,186955,Grush; Rick Scott,31,0,40,9
1683692561602,PHIL 10,A01,186973,Grush; Rick Scott,27,0,35,8
1683692561602,PHIL 10,A02,186974,Grush; Rick Scott,33,0,35,2
1683692562627,PHIL 13,A01,186976,Staff,1,0,35,34
1683692562627,PHIL 13,A02,186977,Staff,16,0,35,19
1683692563656,PHIL 14,A01,186979,Staff,31,0,35,4
1683692563656,PHIL 14,A02,186986,Staff,32,0,35,3
1683692564682,PHIL 28,A01,186988,Staff,16,0,30,14
1683692564682,PHIL 28,A02,186989,Staff,1,0,30,29
1683692564682,PHIL 28,A03,186990,Staff,10,0,30,20
1683692564682,PHIL 28,A04,186991,Staff,26,0,30,4
1683692565705,PHIL 120,A00,186997,Staff,23,0,40,17
1683692566729,PHIL 137,A00,187003,Staff,7,0,40,33
1683692567754,PHIL 150,A00,187015,Staff,47,0,70,23
1683692568777,PHIL 167,A00,187021,Lamey; Andy M.,34,0,40,6
1683692569807,PHIL 174,A01,202226,Staff,17,0,20,3
1683692569807,PHIL 174,A02,202235,Staff,20,0,20,0
1683692570832,PHIL 191A,A00,258918,Staff,0,0,1,1
1683692571859,PHYS 1A,A00,187028,Staff,26,0,60,34
1683692572887,PHYS 1AL,001,187036,Staff,3,0,30,27
1683692572887,PHYS 1AL,002,187049,Staff,18,0,30,12
1683692573915,PHYS 1B,A00,187058,Staff,22,0,60,38
1683692574942,PHYS 1BL,001,187064,Staff,0,1,30,30
1683692574942,PHYS 1BL,002,187070,Staff,4,0,30,26
1683692575966,PHYS 1C,A00,187082,Staff,29,0,120,91
1683692577054,PHYS 1CL,001,187088,Staff,0,9,30,30
1683692577054,PHYS 1CL,002,187089,Staff,0,1,30,30
1683692577054,PHYS 1CL,009,262693,Staff,9,0,30,21
1683692578082,PHYS 2B,A01,187097,Staff,55,0,115,60
1683692579105,PHYS 2C,A01,187099,Staff,63,0,115,52
1683692580129,PHYS 2CL,A01,187101,Staff,5,0,28,23
1683692580129,PHYS 2CL,A02,187102,Staff,15,0,28,13
1683692581153,PHYS 2D,A01,187123,Shotwell; Brian,95,0,115,20
1683692582179,PHYS 4B,A01,187133,Grinstein; Benjamin,35,0,50,15
1683692583206,POLI 10,A00,188819,Staff,0,4,50,50
1683692584238,POLI 11,A00,188827,Staff,43,0,50,7
1683692585264,POLI 13R,A00,188828,Staff,0,1,20,20
1683692586289,POLI 27,A01,188830,Elgin; Samuel Zincke,0,2,70,70
1683692587314,POLI 30,A00,188832,Desposato; Scott,30,0,50,20
1683692588341,POLI 102F,A00,188834,Staff,1,0,40,39
1683692589367,POLI 104A,A00,188852,Staff,12,0,30,18
1683692590394,POLI 104I,A00,188853,Staff,0,8,20,20
1683692591418,POLI 110B,A00,188854,Wiens; David,6,0,20,14
1683692592443,POLI 112A,A00,188855,Wiens; David,3,0,30,27
1683692593467,POLI 117R,A00,188856,Forman; Fonna,0,12,20,20
1683692594493,POLI 118,A00,188857,Ingham; Sean,8,0,20,12
1683692595521,POLI 120G,A00,188858,Staff,8,0,30,22
1683692596549,POLI 131CR,A00,188863,Hoston; Germaine,20,0,50,30
1683692597573,POLI 133,A00,188864,Nellis; Gareth Hb,44,0,50,6
1683692598602,POLI 134D,A00,188865,Desposato; Scott,27,0,30,3
1683692599630,POLI 142A,A00,188871,Gartzke; Erik,21,0,50,29
1683692600654,POLI 142K,A00,188874,Staff,38,0,50,12
1683692601679,POLI 143,A00,188940,Gartzke; Erik,16,0,30,14
1683692602706,POLI 153,A00,188943,Staff,2,0,20,18
1683692603730,POLI 160AA,A00,188944,Staff,10,0,40,30
1683692604757,POLI 170A,A00,188945,Staff,10,0,30,20
1683692606811,PSYC 1,A00,188952,Staff,36,0,90,54
1683692607839,PSYC 2,B00,188953,Staff,19,0,35,16
1683692608864,PSYC 6,A00,188970,Staff,47,0,60,13
1683692609889,PSYC 7,A00,188973,Staff,35,0,45,10
1683692610916,PSYC 60,A01,188980,Rickard; Timothy C.,42,0,60,18
1683692611941,PSYC 70,A01,189001,Steiner; Eric Tomas,21,0,45,24
1683692612970,PSYC 100,A00,189005,Lacefield; Katharine I,0,99,120,120
1683692613995,PSYC 102,A00,189008,Staff,7,0,30,23
1683692615020,PSYC 106,B00,189026,Gorman; Michael R.,27,0,60,33
1683692616045,PSYC 114,B01,189033,Winkielman; Piotr,0,31,30,30
1683692617072,PSYC 131,A00,189036,Anagnostaras; Stephan,0,43,60,60
1683692618100,PSYC 136,A00,189041,Lowe; Angela Beth,0,7,25,25
1683692619124,PSYC 137,A00,189057,Winkielman; Piotr,1,37,25,24
1683692620150,PSYC 144,A00,189107,Wixted; John T,0,11,50,50
1683692622201,PSYC 162,A00,189142,Staff,0,9,85,85
1683692623225,PSYC 172,A00,189144,Gorman; Michael R.,0,6,30,30
1683692625276,PSYC 179,A00,189146,Lacefield; Katharine I,0,88,120,120
1683692626300,PSYC 181,A00,189147,Anagnostaras; Stephan,0,44,90,90
1683692627324,PSYC 190R,A00,189148,Barner; David A.,0,23,80,80
1683692628353,PSYC 191,A00,189275,Rickard; Timothy C.,0,11,25,25
1683692629378,PSYC 193,A00,189276,Chapman; Eddie Nathaniel,0,1,0,4
1683692630402,PSYC 193L,A01,189281,Lowe; Angela Beth,8,0,20,12
1683692630402,PSYC 193L,B01,189285,Staff,28,0,35,7
1683692631426,RELI 149,A00,187137,Rahimi; Babak,6,0,40,34
1683692632450,SE 9,A01,187315,Staff,0,2,18,18
1683692633476,SE 101B,A00,187409,Staff,24,0,30,6
1683692634499,SE 110B,A00,187444,Staff,10,0,40,30
1683692635527,SE 130B,A00,187449,Staff,31,0,40,9
1683692636551,SE 150A,A00,187516,Staff,8,0,20,12
1683692637578,SE 154,A00,187528,Staff,29,0,50,21
1683692638602,SIO 3,A01,258171,Staff,35,0,40,5
1683692639629,SIO 10,A00,187144,Cook; Geoffrey W,1,7,75,74
1683692640651,SIO 45,A00,187152,Cook; Geoffrey W,0,7,100,100
1683692641675,SIO 109R,A00,194486,Staff,0,4,20,20
1683692643726,SIO 187,A01,187233,Kacev; David,12,0,40,28
1683692644751,SOCI 1,A01,258656,Thorpe; Charles Robert,28,0,30,2
1683692644751,SOCI 1,A02,258658,Thorpe; Charles Robert,30,0,30,0
1683692644751,SOCI 1,A03,258661,Thorpe; Charles Robert,25,0,25,0
1683692644751,SOCI 1,A04,258666,Thorpe; Charles Robert,22,0,25,3
1683692644751,SOCI 1,A05,258897,Thorpe; Charles Robert,22,0,25,3
1683692644751,SOCI 1,A06,258898,Thorpe; Charles Robert,25,0,25,0
1683692645778,SOCI 30,A01,258903,Pardo Guerra; Juan Pablo,14,0,30,16
1683692646802,SOCI 102,A00,258904,Staff,9,0,25,16
1683692647828,SOCI 106,A00,258905,Staff,19,0,25,6
1683692648852,SOCI 111,A00,258907,Ribas Norris; Janet Vanesa,26,0,30,4
1683692649875,SOCI 121R,A00,258908,Pardo Guerra; Juan Pablo,8,0,30,22
1683692650899,SOCI 126,A01,203330,Staff,14,0,20,6
1683692651923,SOCI 131,A00,258909,Thorpe; Charles Robert,30,0,60,30
1683692652950,SOCI 135,A00,258910,Payne; Christine Anna,0,13,30,30
1683692653974,SOCI 157,A00,258911,Staff,11,0,30,19
1683692655005,SOCI 184,A00,258912,Staff,25,0,30,5
1683692656032,SOCI 188D,A00,258913,Staff,22,0,30,8
1683692657057,SYN 2,001,187529,Staff,9,0,16,7
1683692657057,SYN 2,002,201452,Staff,1,20,16,15
1683692657057,SYN 2,003,201469,Staff,1,0,16,15
1683692658084,SYN 100,A01,187531,Staff,0,9,20,20
1683692658084,SYN 100,B01,201491,Staff,0,10,20,20
1683692659111,TDAC 1,A00,189286,Walsh; Kim C.,3,0,20,17
1683692659111,TDAC 1,B00,189287,Harting; Carla Kelso,10,0,20,10
1683692660136,TDAC 101,A00,189300,Walsh; Kim C.,16,0,20,4
1683692660136,TDAC 101,B00,189301,Harting; Carla Kelso,18,0,20,2
1683692661160,TDAC 102,A00,189304,Basso; Beatrice,14,0,20,6
1683692662187,TDAC 108,A00,189305,Staff,18,0,20,2
1683692663216,TDDE 131,A00,189310,Staff,19,0,20,1
1683692663216,TDDE 131,B00,189314,Staff,19,0,20,1
1683692663216,TDDE 131,C00,189315,Staff,48,0,50,2
1683692663216,TDDE 131,D00,189316,Staff,14,0,15,1
1683692663216,TDDE 131,E00,204841,Staff,20,0,20,0
1683692664240,TDGE 10,A00,189289,Staff,27,0,50,23
1683692664240,TDGE 10,B00,189290,Havis; Allan,0,1,50,50
1683692665268,TDGE 11,A00,189291,Fulton; Julia,0,4,50,50
1683692665268,TDGE 11,B00,189292,Staff,20,0,25,5
1683692665268,TDGE 11,C00,260270,Staff,0,0,0,0
1683692666293,TDGE 25,A00,189294,Staff,1,0,20,19
1683692667315,TDGE 124,A00,189318,Fulton; Julia,1,8,50,49
1683692668341,TDGE 125,A00,189319,Staff,13,0,25,12
1683692668341,TDGE 125,B00,189320,Staff,23,0,25,2
1683692669366,TDGE 127,A00,189322,Havis; Allan,0,0,50,50
1683692670390,TDHT 101,A00,189323,Staff,18,0,25,7
1683692670390,TDHT 101,B00,189324,Staff,25,0,25,0
1683692671412,TDHT 102,A00,189325,Staff,49,0,50,1
1683692672436,TDMV 1,A00,189295,Arcidiacono; Kristin,20,0,30,10
1683692672436,TDMV 1,B00,189296,Caligagan; Maria T.,24,0,30,6
1683692673459,TDMV 2,A00,189297,Sammartano; Tonnie,27,0,30,3
1683692673459,TDMV 2,B00,189299,Arcidiacono; Kristin,23,0,30,7
1683692674483,TDMV 3,A00,204998,Rincon; Alicia,22,0,30,8
1683692675509,TDMV 120,A00,189458,Sammartano; Tonnie,28,0,30,2
1683692676533,TDMV 138,A00,189541,Jun; Grace Shin Hae,20,0,40,20
1683692677557,TDMV 142,A00,189717,Caligagan; Tony,25,0,30,5
1683692677557,TDMV 142,B00,189718,Caligagan; Maria T.,25,0,30,5
1683692678581,TMC 2,A01,187533,Staff,25,0,25,0
1683692678581,TMC 2,A02,187534,Staff,25,0,25,0
1683692679609,USP 1,A01,187536,Kwak; Nancy,0,16,25,25
1683692680694,USP 5,A01,187538,Staff,8,0,25,17
1683692681717,USP 101,A00,199253,Staff,0,4,0,0
1683692682744,USP 124,A00,187562,Boomhower; Matthew Charles,0,0,30,30
1683692683771,USP 138,A00,187582,Staff,19,0,25,6
1683692684795,USP 152,A01,187597,Staff,3,0,25,22
1683692685818,USP 153,A00,187598,Staff,18,0,25,7
1683692686842,USP 168,A00,187607,Kwak; Nancy,2,0,5,3
1683692687868,USP 173,A00,187619,Staff,4,0,25,21
1683692688892,USP 181,A00,187638,Staff,0,4,25,25
1683692689915,VIS 103,A00,187650,Cruz; Edwin Teddy,17,0,75,58
1683692690939,VIS 110D,A00,187669,Staff,13,0,22,9
1683692691965,VIS 127C,A00,187720,Shen; Kuiyi,67,0,146,79
1683692692991,VIS 149,A00,187731,Yoldas; Pinar,2,14,22,20
1683692694015,VIS 151,A01,188091,Staff,22,0,34,12
1683692694015,VIS 151,A02,188092,Staff,11,0,34,23
1683692695043,VIS 160B,A00,188093,Stalbaum; Brett,0,1,10,10
1683692697093,WCWP 10B,A00,201720,Staff,0,0,5,5
1683692697093,WCWP 10B,B00,201722,Staff,0,0,6,6
1683692698118,WCWP 100,A00,201725,Gagnon; Jeffrey C,0,0,2,2
1683692698118,WCWP 100,B00,201727,Staff,0,4,15,15
1683692701212,ANBI 133,A00,258401,Wilder; Linnea Lorene,34,0,40,6
1683692702236,ANBI 140,A00,258395,Hrvoj Mihic; Branka,18,0,25,7
1683692703260,ANSC 120,A00,258402,Bialecki; Jon Anthony,26,0,40,14
1683692704288,ANSC 144,A00,258400,Staff,12,0,40,28
1683692706338,ANSC 166,A00,258396,Parish; Steven Martin,156,0,175,19
1683692707362,ANSC 180,A00,193533,Staff,8,0,20,12
1683692708389,ANSC 188,A00,258397,Jassal; Aftab,34,0,40,6
1683692709413,ANTH 3,A01,258316,Staff,23,0,30,7
1683692710439,ANTH 5,A00,258394,Semendeferi; Ekaterini,16,0,20,4
1683692711463,ANTH 21,A01,258331,Staff,4,0,40,36
1683692712487,ANTH 103,A00,258398,Varma; Saiba,15,0,25,10
1683692713517,AWP 10,001,202034,Staff,0,0,0,0
1683692713517,AWP 10,002,202035,Staff,0,0,0,0
1683692713517,AWP 10,003,202036,Staff,0,0,0,0
1683692713517,AWP 10,004,202037,Staff,0,0,0,0
1683692713517,AWP 10,005,202038,Staff,0,0,0,0
1683692713517,AWP 10,006,202039,Staff,0,0,0,0
1683692713517,AWP 10,007,202040,Staff,0,0,0,0
1683692713517,AWP 10,008,202041,Staff,0,0,0,0
1683692713517,AWP 10,009,202042,Staff,0,0,0,0
1683692713517,AWP 10,010,202043,Staff,0,0,0,0
1683692713517,AWP 10,011,202044,Staff,0,0,0,0
1683692713517,AWP 10,012,202045,Staff,0,0,0,0
1683692713517,AWP 10,013,202046,Staff,0,0,0,0
1683692713517,AWP 10,014,202047,Staff,0,0,0,0
1683692713517,AWP 10,015,202048,Staff,0,0,0,0
1683692713517,AWP 10,016,202049,Staff,0,0,0,0
1683692713517,AWP 10,017,202050,Staff,0,0,0,0
1683692713517,AWP 10,018,202051,Staff,0,0,0,0
1683692713517,AWP 10,019,202052,Staff,0,0,0,0
1683692713517,AWP 10,020,202053,Staff,0,0,0,0
1683692713517,AWP 10,021,202054,Staff,0,0,0,0
1683692713517,AWP 10,022,202055,Staff,0,0,0,0
1683692713517,AWP 10,023,202056,Staff,0,0,0,0
1683692713517,AWP 10,024,202057,Staff,0,0,0,0
1683692713517,AWP 10,025,202058,Staff,0,0,0,0
1683692713517,AWP 10,026,202059,Staff,0,0,0,0
1683692714540,AWP 102,001,202032,Staff,0,0,0,0
1683692714540,AWP 102,002,202033,Staff,0,0,0,0
1683692715564,BENG 100,A01,254234,Taylor Amos; Alyssa C,31,0,40,9
1683692716588,BENG 196,001,270013,Engler; Adam J.,9999,0,9999,0
1683692717613,BICD 100R,A01,202018,Smith; Laurie,0,7,32,32
1683692717613,BICD 100R,A02,202019,Smith; Laurie,0,3,32,32
1683692717613,BICD 100R,A03,202020,Smith; Laurie,0,1,32,32
1683692717613,BICD 100R,A04,202021,Smith; Laurie,6,0,32,26
1683692717613,BICD 100R,A05,202022,Smith; Laurie,10,0,32,22
1683692718638,BICD 136,A01,193242,Gustafson-Brown; Cindy,0,2,32,32
1683692718638,BICD 136,A02,193244,Gustafson-Brown; Cindy,13,0,32,19
1683692719667,BIEB 102,A01,193249,Butler; Shannon Rhey,1,1,32,31
1683692719667,BIEB 102,A02,193251,Butler; Shannon Rhey,0,0,32,32
1683692719667,BIEB 102,A03,193253,Butler; Shannon Rhey,0,0,32,32
1683692719667,BIEB 102,A04,193255,Butler; Shannon Rhey,13,0,32,19
1683692719667,BIEB 102,A05,193265,Butler; Shannon Rhey,25,0,32,7
1683692719667,BIEB 102,A06,193269,Butler; Shannon Rhey,13,0,32,19
1683692721714,BIEB 150,A01,193274,Staff,0,0,32,32
1683692721714,BIEB 150,A02,193285,Staff,24,0,32,8
1683692722739,BIEB 194,A00,193286,Kurle; Carolyn M.,19,0,32,13
1683692723768,BILD 1,A01,192291,Staff,15,0,32,17
1683692723768,BILD 1,A02,192292,Staff,30,0,32,2
1683692723768,BILD 1,B01,192520,Reuther; Keefe,0,1,0,0
1683692723768,BILD 1,B02,192532,Reuther; Keefe,0,1,0,0
1683692724796,BILD 3,A01,192556,Butler; Shannon Rhey,0,0,32,32
1683692724796,BILD 3,A02,192581,Butler; Shannon Rhey,0,1,32,32
1683692724796,BILD 3,A03,192611,Butler; Shannon Rhey,19,0,32,13
1683692724796,BILD 3,A04,192612,Butler; Shannon Rhey,23,0,32,9
1683692724796,BILD 3,A05,192613,Butler; Shannon Rhey,26,0,32,6
1683692724796,BILD 3,A06,192679,Butler; Shannon Rhey,27,0,32,5
1683692724796,BILD 3,A07,192682,Butler; Shannon Rhey,20,0,32,12
1683692725820,BILD 4,A01,192836,Reuther; Keefe,1,0,24,23
1683692725820,BILD 4,A02,193044,Reuther; Keefe,4,0,24,20
1683692726845,BILD 10,A01,193142,Gustafson-Brown; Cindy,29,0,32,3
1683692726845,BILD 10,A02,193149,Gustafson-Brown; Cindy,31,0,32,1
1683692727871,BIMM 100,A01,193301,Staff,0,6,32,32
1683692727871,BIMM 100,A02,193312,Staff,0,7,32,32
1683692727871,BIMM 100,A03,193323,Staff,0,10,32,32
1683692728895,BIMM 101,A01,193329,McDonnell; Lisa Marie,1,4,24,23
1683692728895,BIMM 101,A02,193339,McDonnell; Lisa Marie,1,4,24,23
1683692728895,BIMM 101,B01,193354,McDonnell; Lisa Marie,0,4,24,24
1683692728895,BIMM 101,B02,193357,McDonnell; Lisa Marie,0,3,24,24
1683692729920,BIMM 110,A01,193377,Tat; John,0,11,32,32
1683692729920,BIMM 110,A02,193378,Tat; John,0,11,32,32
1683692730944,BIMM 120,A01,206116,Staff,0,0,32,32
1683692730944,BIMM 120,A02,206117,Staff,7,0,32,25
1683692730944,BIMM 120,A03,206121,Staff,21,0,32,11
1683692731974,BIPN 100,A01,193393,Park; Ji Young,0,15,32,32
1683692731974,BIPN 100,A02,193402,Park; Ji Young,0,14,32,32
1683692731974,BIPN 100,A03,193413,Park; Ji Young,0,14,32,32
1683692731974,BIPN 100,A04,193414,Park; Ji Young,0,13,32,32
1683692732999,BIPN 102,A01,193429,Staff,0,0,32,32
1683692732999,BIPN 102,A02,193438,Staff,18,0,32,14
1683692734027,BIPN 106,A01,193450,Reyes Gonzalez; Catalina,0,2,40,40
1683692735052,BIPN 134,A01,193465,Cooke; James Edward,0,0,32,32
1683692735052,BIPN 134,A02,193474,Cooke; James Edward,25,0,32,7
1683692735052,BIPN 134,A03,193485,Cooke; James Edward,29,0,32,3
1683692735052,BIPN 134,A04,193486,Cooke; James Edward,20,0,32,12
1683692735052,BIPN 134,A05,193491,Cooke; James Edward,31,0,32,1
1683692735052,BIPN 134,A06,193501,Cooke; James Edward,30,0,32,2
1683692735052,BIPN 134,A07,193510,Cooke; James Edward,29,0,32,3
1683692737100,BISP 194,A00,222522,Staff,14,0,32,18
1683692738127,CAT 124,A01,202407,Staff,19,0,25,6
1683692739150,CAT 125,A00,202408,Marchisotto; Jennifer Anne,2,0,20,18
1683692740177,CAT 125R,A00,202409,Smith; Lauryn Alissa,0,11,20,20
1683692740177,CAT 125R,B00,202410,Morales; Celeste Georgianna,0,11,20,20
1683692740177,CAT 125R,C00,202411,Irwin; Matthew Joseph,0,12,20,20
1683692741200,CENG 15,A01,204712,Yang; Kesong,0,1,0,0
1683692742224,CENG 114,A00,202070,Jahed Motlagh; Zeinab,5,0,20,15
1683692743252,CGS 105,A00,185477,Wesling; Megan E.,24,0,40,16
1683692744276,CGS 106,A00,185494,Staff,11,0,22,11
1683692745300,CGS 108,A00,185495,Staff,14,0,20,6
1683692746324,CGS 114,A00,185496,Staff,13,0,18,5
1683692747352,CGS 119,A00,185501,Staff,15,0,20,5
1683692748377,CGS 120,A00,185511,Staff,12,0,20,8
1683692749400,CHEM 4,A01,184675,Bussey; Thomas J,97,0,100,3
1683692750426,CHEM 6A,A01,184677,Staff,32,0,60,28
1683692751453,CHEM 6B,A01,184679,Staff,63,0,100,37
1683692752484,CHEM 6C,A01,184681,Bussey; Thomas J,0,0,50,50
1683692752484,CHEM 6C,A02,184682,Bussey; Thomas J,32,0,50,18
1683692753513,CHEM 40A,A01,184684,Albizati; Kim F.,33,0,100,67
1683692754538,CHEM 40B,A01,184686,Albizati; Kim F.,0,22,100,100
1683692755562,CHEM 41B,A01,184690,Staff,51,0,100,49
1683692756589,COGS 3,A01,184715,Boyle; Mary E. T.,0,27,40,40
1683692757614,COGS 14B,A01,185172,Staff,0,14,38,38
1683692758638,COGS 18,A01,184736,Staff,14,0,80,66
1683692759663,COGS 100,A01,184932,Staff,0,8,73,73
1683692760691,COGS 101A,A01,184935,Staff,0,40,30,30
1683692761715,COGS 101B,A01,184944,Staff,0,2,30,30
1683692762748,COGS 101C,A01,184946,Staff,0,10,30,30
1683692763772,COGS 102A,A01,184951,Johnson; Christine M.,1,0,40,39
1683692764796,COGS 107B,A01,184953,Mooshagian; Eric Frederick,0,52,40,40
1683692765820,COGS 118B,A01,184959,Gupta; Anjum,0,50,40,40
1683692766847,COGS 153,A00,184961,Staff,0,16,30,30
1683692767872,COGS 177,A00,184962,Staff,1,21,30,29
1683692768897,COGS 187A,A01,184969,Boyle; Mary E. T.,0,19,40,40
1683692769922,COMM 10,A01,185174,Staff,0,5,25,25
1683692769922,COMM 10,A02,185189,Staff,0,2,25,25
1683692769922,COMM 10,A03,269821,Staff,0,1,0,0
1683692770947,COMM 100B,A02,185476,Staff,10,0,25,15
1683692770947,COMM 100B,A03,277340,Staff,25,0,25,0
1683692771971,COMM 100C,A01,185314,Staff,1,0,25,24
1683692771971,COMM 100C,A02,185327,Staff,17,0,25,8
1683692772996,COMM 110M,A00,185349,Staff,0,0,40,40
1683692774024,COMM 113T,A00,185352,Staff,25,0,40,15
1683692775052,COMM 114I,A00,185353,Staff,31,0,40,9
1683692776078,COMM 131,A00,185354,Staff,17,0,30,13
1683692777107,CSE 8A,A50,185358,Cao; Yingjun,0,46,10,10
1683692778131,CSE 8B,A01,185362,Staff,0,48,50,50
1683692779155,CSE 11,A01,185416,Cao; Yingjun,0,91,10,10
1683692780182,CSE 20,A01,185445,Briones; Jor-el Thomas Caparas,3,0,25,22
1683692781207,CSE 21,A01,185447,Staff,9,0,50,41
1683692782230,CSE 101,A01,185451,Staff,0,13,50,50
1683692782230,CSE 101,B01,185453,Jones; Miles E,0,14,50,50
1683692784337,CSE 141,A01,185458,Eldon; John,16,0,100,84
1683692785365,CSE 141L,A01,185461,Eldon; John,8,0,100,92
1683692786393,CSE 142,A01,185463,Staff,34,0,60,26
1683692786393,CSE 142,B01,201355,Staff,0,7,60,60
1683692787421,CSE 142L,A01,185470,Staff,34,0,60,26
1683692787421,CSE 142L,B01,201417,Staff,0,6,60,60
1683692788445,CSE 190,A00,201433,Staff,32,0,49,17
1683692789472,DOC 1,A01,259136,Strom; Megan C.,7,0,15,8
1683692789472,DOC 1,A02,259137,Strom; Megan C.,14,0,15,1
1683692789472,DOC 1,A03,259138,Strom; Megan C.,14,0,15,1
1683692789472,DOC 1,A04,259139,Strom; Megan C.,14,0,15,1
1683692790497,DOC 100D,A00,259140,Pass; Natalye Joann,14,0,25,11
1683692791520,DSGN 1,A01,184749,Rill; Bryan,0,26,30,30
1683692792547,DSGN 100,A01,185168,Staff,0,2,25,25
1683692793572,ECE 5,A01,185626,Morris; Karcher William,0,12,0,0
1683692794598,ECE 101,A01,185628,Staff,14,0,70,56
1683692795623,ECE 107,A01,185635,Baghdadchi; Saharnaz,0,0,20,20
1683692795623,ECE 107,A02,185638,Baghdadchi; Saharnaz,1,0,20,19
1683692796652,ECE 148,A01,185647,Silberman; Jack,0,0,16,16
1683692797679,ECON 1,A01,185537,Crane; Meredith Helen,54,0,70,16
1683692798707,ECON 3,A01,185549,Crane; Meredith Helen,30,0,70,40
1683692799732,ECON 4,A01,203354,Anderson; John Charles,0,5,10,10
1683692800757,ECON 100A,A01,185574,Staff,0,5,40,40
1683692801781,ECON 100B,A01,185576,Staff,0,12,50,50
1683692802805,ECON 100C,A01,185589,Newhouse; Herbert S,30,0,70,40
1683692803829,ECON 105,A00,185608,Vespa; Emanuel Ignacio,19,0,35,16
1683692804853,ECON 109,A01,185610,Shishkin; Denis,9,0,35,26
1683692805878,ECON 110A,A01,185612,Staff,8,0,40,32
1683692806906,ECON 120A,A01,185615,Staff,19,0,40,21
1683692807930,ECON 120C,A01,185617,Sun; Yixiao,0,21,70,70
1683692808955,ECON 144,A00,203346,Squires; Dale E,2,0,35,33
1683692809983,ECON 171,A01,203349,Newhouse; Herbert S,0,1,35,35
1683692811007,ECON 173A,A01,185621,Toda; Alexis Akira,21,0,35,14
1683692812032,EDS 25,A01,202413,Staff,0,1,0,0
1683692812032,EDS 25,A02,202414,Staff,0,1,0,0
1683692812032,EDS 25,A03,202415,Staff,0,0,0,0
1683692812032,EDS 25,A04,202416,Staff,0,1,0,0
1683692812032,EDS 25,A05,202439,Staff,0,0,0,0
1683692812032,EDS 25,A06,202440,Staff,0,0,0,0
1683692812032,EDS 25,B01,202631,Staff,0,0,0,0
1683692812032,EDS 25,B02,202632,Staff,0,0,0,0
1683692812032,EDS 25,B03,202639,Staff,0,0,0,0
1683692812032,EDS 25,B04,202640,Staff,0,0,0,0
1683692812032,EDS 25,B05,202643,Staff,0,0,0,0
1683692812032,EDS 25,B06,202644,Staff,0,0,0,0
1683692813059,EDS 38,A01,202659,Black; Alison Michelle,24,0,25,1
1683692814086,EDS 115,A00,202652,Staff,18,0,30,12
1683692815112,EDS 125,A00,202649,Staff,13,0,30,17
1683692816136,EDS 126,A01,203332,Staff,30,0,30,0
1683692817162,EDS 139,A00,202838,Staff,16,0,25,9
1683692818187,EDS 146,A01,202655,Staff,14,0,25,11
1683692819212,ENG 15,A00,185667,Staff,0,1,0,0
1683692819212,ENG 15,B00,185672,Staff,0,0,0,0
1683692819212,ENG 15,C00,185675,Staff,0,0,0,0
1683692819212,ENG 15,D00,185682,Staff,0,0,0,0
1683692819212,ENG 15,E00,185684,Staff,0,0,0,0
1683692820237,ETHN 103,A00,185710,Staff,0,8,35,35
1683692821266,ETHN 103A,A00,199228,Man; Simeon S,0,0,9,9
1683692822292,ETHN 109,A00,185711,Staff,15,0,35,20
1683692823317,ETHN 142,A00,185726,Staff,0,4,30,30
1683692824342,ETHN 163J,A00,199229,Man; Simeon S,5,0,8,3
1683692825365,ETHN 168,A00,185727,Staff,7,0,10,3
1683692826389,ETHN 182,A00,185728,Staff,0,0,35,35
1683692827414,ETHN 183,A00,185737,Staff,9,0,18,9
1683692828438,GLBH 111,A01,209361,Burgos; Jose L.,0,0,0,0
1683692830487,HIEU 104,A00,185792,Staff,14,0,20,6
1683692831513,HIEU 115,A00,185800,Staff,0,0,20,20
1683692832539,HIEU 128,A00,185801,Staff,0,9,20,20
1683692833566,HIEU 147,A00,185802,Staff,15,0,20,5
1683692834593,HIEU 154,A00,185823,Staff,11,0,20,9
1683692835620,HILA 102,A00,185826,Staff,14,0,20,6
1683692836647,HILD 2C,A01,185778,Staff,0,13,20,20
1683692837674,HILD 7B,A01,185780,Kwak; Nancy,0,17,32,32
1683692837674,HILD 7B,A02,185781,Kwak; Nancy,0,18,32,32
1683692838697,HILD 30,A01,185791,Staff,12,0,20,8
1683692839721,HISC 119,A00,185830,Golan; Tal,0,11,20,20
1683692840748,HITO 156GS,A00,185831,Patterson; Patrick H.,0,0,0,23
1683692841773,HIUS 103,A00,185832,Man; Simeon S,0,4,20,20
1683692842801,HIUS 117,A00,185836,Kwak; Nancy,2,0,20,18
1683692843825,HIUS 125,A00,185840,Man; Simeon S,0,2,23,23
1683692844851,HIUS 149,A00,185845,Staff,1,0,20,19
1683692845876,HUM 3,A01,185882,Zavodny; Tatiana Sophia,0,8,50,50
1683692845876,HUM 3,B01,185899,Caldwell; Michael Alan,0,18,50,50
1683692846904,HUM 3GS,A00,185900,Patterson; Patrick H.,0,0,0,23
1683692847929,HUM 4,A01,185938,Zroka; Amy Liane,28,0,50,22
1683692847929,HUM 4,B01,185956,Watkins; Eric,0,6,50,50
1683692847929,HUM 4,B02,202209,Watkins; Eric,0,5,50,50
1683692847929,HUM 4,B03,202210,Watkins; Eric,0,5,50,50
1683692848954,HUM 5,A01,185958,West; Geoffrey Scott,0,0,50,50
1683692848954,HUM 5,A02,202215,West; Geoffrey Scott,0,1,50,50
1683692849979,INTL 190,A00,185959,Gagnon; Jeffrey C,0,0,0,9
1683692849979,INTL 190,B00,185960,Lettieri; Michael Joseph,0,0,0,2
1683692851006,JAPN 180,A00,254509,Staff,5,0,30,25
1683692852038,LATI 10,A01,202853,Kennemore; Amy Michelle,4,0,35,31
1683692852038,LATI 10,A02,202854,Kennemore; Amy Michelle,3,0,35,32
1683692852038,LATI 10,A03,270054,Kennemore; Amy Michelle,30,0,30,0
1683692853065,LATI 180,A00,202855,Kennemore; Amy Michelle,11,0,20,9
1683692854093,LAWS 101,A00,201767,Golan; Tal,0,7,40,40
1683692855118,LIFR 1C,A00,185961,Staff,6,0,20,14
1683692856145,LIFR 1CX,A00,185962,Staff,7,0,20,13
1683692857172,LIFR 1D,A00,185963,Staff,7,0,20,13
1683692858195,LIFR 1DX,A00,185964,Staff,7,0,20,13
1683692859220,LIGN 101,A01,186039,Staff,43,0,50,7
1683692860245,LIGN 165,A00,186040,Staff,15,0,50,35
1683692861272,LTCS 108,A00,186041,Staff,5,0,10,5
1683692862296,LTCS 119,A00,186042,Staff,15,0,20,5
1683692863320,LTCS 130,A00,186043,Wesling; Megan E.,15,0,25,10
1683692865372,LTEA 138,A00,186119,Staff,14,0,40,26
1683692866397,LTEN 124,A00,186148,Staff,5,0,25,20
1683692867425,LTEN 178,A00,186149,Staff,6,0,15,9
1683692868449,LTEN 181,A00,186150,Blanco; John D,34,0,40,6
1683692869474,LTWL 120,A00,186160,Staff,19,0,25,6
1683692870498,LTWL 165,A00,186161,Staff,22,0,25,3
1683692871525,LTWR 100,A00,186162,Staff,0,5,15,15
1683692872552,LTWR 102,A00,186163,Doller; Ben,5,0,15,10
1683692873579,MAE 8,A01,186412,Staff,0,1,0,0
1683692874606,MAE 30B,A00,186445,Bahadori; Mohammad Yousef,81,0,100,19
1683692875634,MAE 40,A00,186592,Bewley; Thomas R,10,0,50,40
1683692876659,MAE 101B,A00,186593,Bahadori; Mohammad Yousef,80,0,100,20
1683692877687,MAE 105,A00,186594,Bandaru; Prabhakar,10,0,50,40
1683692878714,MAE 107,A00,186599,Pham; Hieu Tan,0,7,120,120
1683692879741,MAE 148,A01,186660,Silberman; Jack,3,0,16,13
1683692880766,MATH 10A,A01,188095,Staff,0,6,35,35
1683692881796,MATH 10B,A01,188097,Bowers; Adam R.,0,12,30,30
1683692881796,MATH 10B,A02,188099,Bowers; Adam R.,0,11,30,30
1683692881796,MATH 10B,B01,188104,Bowers; Adam R.,0,10,30,30
1683692881796,MATH 10B,B02,188106,Bowers; Adam R.,1,10,30,29
1683692882820,MATH 10C,A01,188111,Staff,0,20,30,30
1683692882820,MATH 10C,A02,188127,Staff,0,19,30,30
1683692882820,MATH 10C,A03,188131,Staff,0,19,30,30
1683692882820,MATH 10C,B01,188218,Staff,17,0,30,13
1683692882820,MATH 10C,B02,188244,Staff,13,0,30,17
1683692882820,MATH 10C,B03,188277,Staff,14,0,30,16
1683692883855,MATH 18,A01,188344,Bach; Quang Tran,18,0,30,12
1683692883855,MATH 18,A02,188345,Bach; Quang Tran,11,0,30,19
1683692883855,MATH 18,B01,188353,Bach; Quang Tran,11,0,30,19
1683692883855,MATH 18,B02,188354,Bach; Quang Tran,19,0,30,11
1683692884881,MATH 20A,A01,188374,Staff,11,0,35,24
1683692885906,MATH 20B,A01,188382,Ohm; Ko Woon,7,0,30,23
1683692885906,MATH 20B,A02,188383,Ohm; Ko Woon,22,0,30,8
1683692885906,MATH 20B,B01,188385,Ohm; Ko Woon,7,0,30,23
1683692885906,MATH 20B,B02,188392,Ohm; Ko Woon,22,0,30,8
1683692886934,MATH 20C,A01,188394,Harel; Guershon,10,0,30,20
1683692886934,MATH 20C,A02,188395,Harel; Guershon,13,0,30,17
1683692886934,MATH 20C,B01,188404,Harel; Guershon,5,0,30,25
1683692886934,MATH 20C,B02,188405,Harel; Guershon,18,0,30,12
1683692888035,MATH 20D,A01,188414,Hammock; Frances H,0,1,30,30
1683692888035,MATH 20D,A02,188415,Hammock; Frances H,0,1,30,30
1683692888035,MATH 20D,B01,188447,Hammock; Frances H,0,1,30,30
1683692888035,MATH 20D,B02,188486,Hammock; Frances H,2,0,30,28
1683692889061,MATH 20E,A01,188649,Staff,21,0,30,9
1683692889061,MATH 20E,A02,188650,Staff,20,0,30,10
1683692889061,MATH 20E,A03,188673,Staff,0,0,30,30
1683692890084,MATH 102,A01,188675,Staff,0,40,35,35
1683692891109,MATH 103B,A01,188681,Staff,3,0,35,32
1683692891109,MATH 103B,B01,188692,Staff,5,0,35,30
1683692892134,MATH 109,A01,188695,Salehi Golsefidy; Alireza,24,0,35,11
1683692892134,MATH 109,A02,188696,Salehi Golsefidy; Alireza,25,0,35,10
1683692893157,MATH 120A,A01,188698,Eggers; John Dietrich,7,0,35,28
1683692894183,MATH 142B,A01,188736,Ioana; Adrian,1,1,30,29
1683692894183,MATH 142B,A02,188741,Ioana; Adrian,0,1,30,30
1683692894183,MATH 142B,A03,188743,Ioana; Adrian,0,2,30,30
1683692895207,MATH 168A,A01,188790,Staff,0,11,35,35
1683692896232,MATH 170A,A01,188803,Nie; Jiawang,0,2,35,35
1683692896232,MATH 170A,A02,188811,Nie; Jiawang,0,1,35,35
1683692896232,MATH 170A,A03,188814,Nie; Jiawang,0,0,35,35
1683692896232,MATH 170A,A04,188815,Nie; Jiawang,5,0,35,30
1683692897259,MATH 193B,A01,188817,Staff,0,0,35,35
1683692897259,MATH 193B,A02,188818,Staff,6,0,35,29
1683692898285,MGT 4,A01,202857,Anderson; John Charles,59,0,80,21
1683692899310,MGT 12,A00,202858,Lindenberger; Wade Douglas,40,0,90,50
1683692900337,MGT 18,A00,202859,Staff,74,0,90,16
1683692901364,MGT 18GS,A00,202860,McKay; Michael J,13,0,28,15
1683692902388,MGT 45,A00,202861,Pecore; Joseph P.,8,0,90,82
1683692903414,MGT 100,A00,202863,Yavorsky; Daniel Ryan,27,0,90,63
1683692904440,MGT 103,A00,202864,Ehrich; Kristine R,0,19,90,90
1683692905465,MGT 112,A00,202865,Ehrich; Kristine R,15,0,90,75
1683692906489,MGT 121A,A00,202868,Staff,90,20,90,0
1683692907519,MGT 131B,A00,202869,Anderson; John Charles,58,0,90,32
1683692908545,MGT 136,A00,202871,Lindenberger; Wade Douglas,83,0,90,7
1683692909572,MGT 164,A00,202873,Staff,0,67,90,91
1683692910597,MGT 164GS,A00,202874,McKay; Mary A,13,0,28,15
1683692911626,MGT 180,A00,202875,Staff,0,51,90,91
1683692912650,MMW 11R,A01,205019,Herbst; Matthew,0,0,30,30
1683692912650,MMW 11R,A02,205026,Herbst; Matthew,29,0,30,1
1683692913674,MMW 15,A01,193512,Chang; Edmond Yi-Teh,0,8,28,28
1683692913674,MMW 15,A02,193513,Chang; Edmond Yi-Teh,0,5,28,28
1683692913674,MMW 15,A03,193514,Chang; Edmond Yi-Teh,0,5,28,28
1683692913674,MMW 15,A04,193515,Chang; Edmond Yi-Teh,0,5,28,28
1683692913674,MMW 15,A05,193516,Chang; Edmond Yi-Teh,0,5,28,28
1683692913674,MMW 15,A06,193517,Chang; Edmond Yi-Teh,0,6,28,28
1683692913674,MMW 15,B01,193519,Chang; Edmond Yi-Teh,0,5,28,28
1683692913674,MMW 15,B02,193520,Chang; Edmond Yi-Teh,0,5,28,28
1683692913674,MMW 15,B03,193521,Chang; Edmond Yi-Teh,0,5,28,28
1683692913674,MMW 15,B04,193522,Chang; Edmond Yi-Teh,0,6,28,28
1683692913674,MMW 15,B05,193523,Chang; Edmond Yi-Teh,0,5,28,28
1683692913674,MMW 15,B06,193524,Chang; Edmond Yi-Teh,0,5,28,28
1683692914810,MMW 122,A01,193526,Rahimi; Babak,0,16,28,28
1683692914810,MMW 122,A02,193527,Rahimi; Babak,0,15,28,28
1683692914810,MMW 122,A03,193528,Rahimi; Babak,0,0,0,0
1683692914810,MMW 122,A04,193529,Rahimi; Babak,0,0,0,0
1683692915838,MUS 1A,A01,186663,Staff,1,19,35,34
1683692916864,MUS 4,A01,186715,Staff,0,12,35,35
1683692917889,MUS 5R,A01,186796,Dubnov; Shlomo,0,17,35,35
1683692918914,MUS 6,A01,186798,Staff,1,5,25,24
1683692919941,MUS 7,A01,186830,Staff,11,0,35,24
1683692920965,MUS 8,A01,186930,Staff,0,27,35,35
1683692921991,MUS 15,A01,186932,Staff,0,15,35,35
1683692921991,MUS 15,B01,186934,Staff,1,17,35,34
1683692923016,MUS 80,A00,186935,Staff,0,0,20,20
1683692923016,MUS 80,B00,186936,Staff,24,0,25,1
1683692924040,NANO 11,A00,204702,Lipomi; Darren John,0,0,0,0
1683692925063,NANO 15,A01,204709,Yang; Kesong,0,1,0,0
1683692926087,NANO 114,A00,202069,Jahed Motlagh; Zeinab,2,0,10,8
1683692927115,PHIL 1,A00,186955,Grush; Rick Scott,31,0,40,9
1683692928139,PHIL 10,A01,186973,Grush; Rick Scott,27,0,35,8
1683692928139,PHIL 10,A02,186974,Grush; Rick Scott,33,0,35,2
1683692929164,PHIL 13,A01,186976,Staff,1,0,35,34
1683692929164,PHIL 13,A02,186977,Staff,16,0,35,19
1683692930188,PHIL 14,A01,186979,Staff,31,0,35,4
1683692930188,PHIL 14,A02,186986,Staff,32,0,35,3
1683692931212,PHIL 28,A01,186988,Staff,16,0,30,14
1683692931212,PHIL 28,A02,186989,Staff,1,0,30,29
1683692931212,PHIL 28,A03,186990,Staff,10,0,30,20
1683692931212,PHIL 28,A04,186991,Staff,26,0,30,4
1683692932234,PHIL 120,A00,186997,Staff,23,0,40,17
1683692933258,PHIL 137,A00,187003,Staff,7,0,40,33
1683692934285,PHIL 150,A00,187015,Staff,47,0,70,23
1683692935311,PHIL 167,A00,187021,Lamey; Andy M.,34,0,40,6
1683692936335,PHIL 174,A01,202226,Staff,17,0,20,3
1683692936335,PHIL 174,A02,202235,Staff,20,0,20,0
1683692937359,PHIL 191A,A00,258918,Staff,0,0,1,1
1683692938385,PHYS 1A,A00,187028,Staff,26,0,60,34
1683692939412,PHYS 1AL,001,187036,Staff,3,0,30,27
1683692939412,PHYS 1AL,002,187049,Staff,18,0,30,12
1683692940438,PHYS 1B,A00,187058,Staff,22,0,60,38
1683692941465,PHYS 1BL,001,187064,Staff,0,1,30,30
1683692941465,PHYS 1BL,002,187070,Staff,4,0,30,26
1683692942488,PHYS 1C,A00,187082,Staff,29,0,120,91
1683692943511,PHYS 1CL,001,187088,Staff,0,9,30,30
1683692943511,PHYS 1CL,002,187089,Staff,0,1,30,30
1683692943511,PHYS 1CL,009,262693,Staff,9,0,30,21
1683692944535,PHYS 2B,A01,187097,Staff,55,0,115,60
1683692945560,PHYS 2C,A01,187099,Staff,63,0,115,52
1683692946584,PHYS 2CL,A01,187101,Staff,5,0,28,23
1683692946584,PHYS 2CL,A02,187102,Staff,15,0,28,13
1683692947612,PHYS 2D,A01,187123,Shotwell; Brian,95,0,115,20
1683692948635,PHYS 4B,A01,187133,Grinstein; Benjamin,35,0,50,15
1683692949658,POLI 10,A00,188819,Staff,0,4,50,50
1683692950683,POLI 11,A00,188827,Staff,43,0,50,7
1683692951707,POLI 13R,A00,188828,Staff,0,1,20,20
1683692952735,POLI 27,A01,188830,Elgin; Samuel Zincke,0,2,70,70
1683692953760,POLI 30,A00,188832,Desposato; Scott,30,0,50,20
1683692954785,POLI 102F,A00,188834,Staff,1,0,40,39
1683692955808,POLI 104A,A00,188852,Staff,12,0,30,18
1683692956830,POLI 104I,A00,188853,Staff,0,8,20,20
1683692957854,POLI 110B,A00,188854,Wiens; David,6,0,20,14
1683692958879,POLI 112A,A00,188855,Wiens; David,3,0,30,27
1683692959906,POLI 117R,A00,188856,Forman; Fonna,0,12,20,20
1683692960931,POLI 118,A00,188857,Ingham; Sean,8,0,20,12
1683692961954,POLI 120G,A00,188858,Staff,8,0,30,22
1683692962980,POLI 131CR,A00,188863,Hoston; Germaine,20,0,50,30
1683692964004,POLI 133,A00,188864,Nellis; Gareth Hb,44,0,50,6
1683692965031,POLI 134D,A00,188865,Desposato; Scott,27,0,30,3
1683692966054,POLI 142A,A00,188871,Gartzke; Erik,21,0,50,29
1683692967080,POLI 142K,A00,188874,Staff,38,0,50,12
1683692968104,POLI 143,A00,188940,Gartzke; Erik,16,0,30,14
1683692969128,POLI 153,A00,188943,Staff,2,0,20,18
1683692970151,POLI 160AA,A00,188944,Staff,10,0,40,30
1683692971173,POLI 170A,A00,188945,Staff,10,0,30,20
1683692973225,PSYC 1,A00,188952,Staff,36,0,90,54
1683692974248,PSYC 2,B00,188953,Staff,19,0,35,16
1683692975275,PSYC 6,A00,188970,Staff,47,0,60,13
1683692976300,PSYC 7,A00,188973,Staff,35,0,45,10
1683692977323,PSYC 60,A01,188980,Rickard; Timothy C.,42,0,60,18
1683692978346,PSYC 70,A01,189001,Steiner; Eric Tomas,21,0,45,24
1683692979373,PSYC 100,A00,189005,Lacefield; Katharine I,0,99,120,120
1683692980397,PSYC 102,A00,189008,Staff,7,0,30,23
1683692981421,PSYC 106,B00,189026,Gorman; Michael R.,27,0,60,33
1683692982448,PSYC 114,B01,189033,Winkielman; Piotr,0,31,30,30
1683692983472,PSYC 131,A00,189036,Anagnostaras; Stephan,0,43,60,60
1683692984496,PSYC 136,A00,189041,Lowe; Angela Beth,0,7,25,25
1683692985520,PSYC 137,A00,189057,Winkielman; Piotr,1,37,25,24
1683692986544,PSYC 144,A00,189107,Wixted; John T,0,11,50,50
1683692988593,PSYC 162,A00,189142,Staff,0,9,85,85
1683692989617,PSYC 172,A00,189144,Gorman; Michael R.,0,6,30,30
1683692991722,PSYC 179,A00,189146,Lacefield; Katharine I,0,88,120,120
1683692992746,PSYC 181,A00,189147,Anagnostaras; Stephan,0,44,90,90
1683692993770,PSYC 190R,A00,189148,Barner; David A.,0,23,80,80
1683692994796,PSYC 191,A00,189275,Rickard; Timothy C.,0,11,25,25
1683692995823,PSYC 193,A00,189276,Chapman; Eddie Nathaniel,0,1,0,4
1683692996850,PSYC 193L,A01,189281,Lowe; Angela Beth,8,0,20,12
1683692996850,PSYC 193L,B01,189285,Staff,28,0,35,7
1683692997874,RELI 149,A00,187137,Rahimi; Babak,6,0,40,34
1683692998902,SE 9,A01,187315,Staff,0,2,18,18
1683692999929,SE 101B,A00,187409,Staff,24,0,30,6
1683693000953,SE 110B,A00,187444,Staff,10,0,40,30
1683693001979,SE 130B,A00,187449,Staff,31,0,40,9
1683693003005,SE 150A,A00,187516,Staff,8,0,20,12
1683693004029,SE 154,A00,187528,Staff,29,0,50,21
1683693005052,SIO 3,A01,258171,Staff,35,0,40,5
1683693006081,SIO 10,A00,187144,Cook; Geoffrey W,1,7,75,74
1683693007108,SIO 45,A00,187152,Cook; Geoffrey W,0,7,100,100
1683693008134,SIO 109R,A00,194486,Staff,0,4,20,20
1683693010189,SIO 187,A01,187233,Kacev; David,12,0,40,28
1683693011217,SOCI 1,A01,258656,Thorpe; Charles Robert,28,0,30,2
1683693011217,SOCI 1,A02,258658,Thorpe; Charles Robert,30,0,30,0
1683693011217,SOCI 1,A03,258661,Thorpe; Charles Robert,25,0,25,0
1683693011217,SOCI 1,A04,258666,Thorpe; Charles Robert,22,0,25,3
1683693011217,SOCI 1,A05,258897,Thorpe; Charles Robert,22,0,25,3
1683693011217,SOCI 1,A06,258898,Thorpe; Charles Robert,25,0,25,0
1683693012241,SOCI 30,A01,258903,Pardo Guerra; Juan Pablo,14,0,30,16
1683693013267,SOCI 102,A00,258904,Staff,9,0,25,16
1683693014296,SOCI 106,A00,258905,Staff,19,0,25,6
1683693015323,SOCI 111,A00,258907,Ribas Norris; Janet Vanesa,25,0,30,5
1683693016351,SOCI 121R,A00,258908,Pardo Guerra; Juan Pablo,8,0,30,22
1683693017374,SOCI 126,A01,203330,Staff,14,0,20,6
1683693018400,SOCI 131,A00,258909,Thorpe; Charles Robert,30,0,60,30
1683693019424,SOCI 135,A00,258910,Payne; Christine Anna,0,13,30,30
1683693020446,SOCI 157,A00,258911,Staff,11,0,30,19
1683693021471,SOCI 184,A00,258912,Staff,25,0,30,5
1683693022494,SOCI 188D,A00,258913,Staff,22,0,30,8
1683693023517,SYN 2,001,187529,Staff,9,0,16,7
1683693023517,SYN 2,002,201452,Staff,1,20,16,15
1683693023517,SYN 2,003,201469,Staff,1,0,16,15
1683693024540,SYN 100,A01,187531,Staff,0,9,20,20
1683693024540,SYN 100,B01,201491,Staff,0,10,20,20
1683693025563,TDAC 1,A00,189286,Walsh; Kim C.,3,0,20,17
1683693025563,TDAC 1,B00,189287,Harting; Carla Kelso,10,0,20,10
1683693026591,TDAC 101,A00,189300,Walsh; Kim C.,16,0,20,4
1683693026591,TDAC 101,B00,189301,Harting; Carla Kelso,18,0,20,2
1683693027617,TDAC 102,A00,189304,Basso; Beatrice,14,0,20,6
1683693028642,TDAC 108,A00,189305,Staff,18,0,20,2
1683693029672,TDDE 131,A00,189310,Staff,19,0,20,1
1683693029672,TDDE 131,B00,189314,Staff,19,0,20,1
1683693029672,TDDE 131,C00,189315,Staff,48,0,50,2
1683693029672,TDDE 131,D00,189316,Staff,14,0,15,1
1683693029672,TDDE 131,E00,204841,Staff,20,0,20,0
1683693030696,TDGE 10,A00,189289,Staff,27,0,50,23
1683693030696,TDGE 10,B00,189290,Havis; Allan,0,1,50,50
1683693031721,TDGE 11,A00,189291,Fulton; Julia,0,4,50,50
1683693031721,TDGE 11,B00,189292,Staff,20,0,25,5
1683693031721,TDGE 11,C00,260270,Staff,0,0,0,0
1683693032745,TDGE 25,A00,189294,Staff,1,0,20,19
1683693033769,TDGE 124,A00,189318,Fulton; Julia,1,8,50,49
1683693034794,TDGE 125,A00,189319,Staff,13,0,25,12
1683693034794,TDGE 125,B00,189320,Staff,23,0,25,2
1683693035818,TDGE 127,A00,189322,Havis; Allan,0,0,50,50
1683693036842,TDHT 101,A00,189323,Staff,18,0,25,7
1683693036842,TDHT 101,B00,189324,Staff,25,0,25,0
1683693037866,TDHT 102,A00,189325,Staff,49,0,50,1
1683693038890,TDMV 1,A00,189295,Arcidiacono; Kristin,20,0,30,10
1683693038890,TDMV 1,B00,189296,Caligagan; Maria T.,24,0,30,6
1683693039916,TDMV 2,A00,189297,Sammartano; Tonnie,27,0,30,3
1683693039916,TDMV 2,B00,189299,Arcidiacono; Kristin,23,0,30,7
1683693040944,TDMV 3,A00,204998,Rincon; Alicia,22,0,30,8
1683693041967,TDMV 120,A00,189458,Sammartano; Tonnie,28,0,30,2
1683693042995,TDMV 138,A00,189541,Jun; Grace Shin Hae,20,0,40,20
1683693044022,TDMV 142,A00,189717,Caligagan; Tony,25,0,30,5
1683693044022,TDMV 142,B00,189718,Caligagan; Maria T.,25,0,30,5
1683693045049,TMC 2,A01,187533,Staff,25,0,25,0
1683693045049,TMC 2,A02,187534,Staff,25,0,25,0
1683693046072,USP 1,A01,187536,Kwak; Nancy,0,16,25,25
1683693047096,USP 5,A01,187538,Staff,8,0,25,17
1683693048121,USP 101,A00,199253,Staff,0,4,0,0
1683693049146,USP 124,A00,187562,Boomhower; Matthew Charles,0,0,30,30
1683693050170,USP 138,A00,187582,Staff,19,0,25,6
1683693051197,USP 152,A01,187597,Staff,3,0,25,22
1683693052220,USP 153,A00,187598,Staff,18,0,25,7
1683693053243,USP 168,A00,187607,Kwak; Nancy,2,0,5,3
1683693054266,USP 173,A00,187619,Staff,4,0,25,21
1683693055290,USP 181,A00,187638,Staff,0,4,25,25
1683693056314,VIS 103,A00,187650,Cruz; Edwin Teddy,17,0,75,58
1683693057337,VIS 110D,A00,187669,Staff,13,0,22,9
1683693058365,VIS 127C,A00,187720,Shen; Kuiyi,67,0,146,79
1683693059389,VIS 149,A00,187731,Yoldas; Pinar,2,14,22,20
1683693060413,VIS 151,A01,188091,Staff,22,0,34,12
1683693060413,VIS 151,A02,188092,Staff,11,0,34,23
1683693061441,VIS 160B,A00,188093,Stalbaum; Brett,0,1,10,10
1683693063492,WCWP 10B,A00,201720,Staff,0,0,5,5
1683693063492,WCWP 10B,B00,201722,Staff,0,0,6,6
1683693064519,WCWP 100,A00,201725,Gagnon; Jeffrey C,0,0,2,2
1683693064519,WCWP 100,B00,201727,Staff,0,4,15,15
1683693067650,ANBI 133,A00,258401,Wilder; Linnea Lorene,34,0,40,6
1683693068674,ANBI 140,A00,258395,Hrvoj Mihic; Branka,18,0,25,7
1683693069699,ANSC 120,A00,258402,Bialecki; Jon Anthony,26,0,40,14
1683693070726,ANSC 144,A00,258400,Staff,12,0,40,28
1683693072777,ANSC 166,A00,258396,Parish; Steven Martin,156,0,175,19
1683693073806,ANSC 180,A00,193533,Staff,8,0,20,12
1683693074830,ANSC 188,A00,258397,Jassal; Aftab,34,0,40,6
1683693075858,ANTH 3,A01,258316,Staff,23,0,30,7
1683693076882,ANTH 5,A00,258394,Semendeferi; Ekaterini,16,0,20,4
1683693077907,ANTH 21,A01,258331,Staff,4,0,40,36
1683693078930,ANTH 103,A00,258398,Varma; Saiba,15,0,25,10
1683693079962,AWP 10,001,202034,Staff,0,0,0,0
1683693079962,AWP 10,002,202035,Staff,0,0,0,0
1683693079962,AWP 10,003,202036,Staff,0,0,0,0
1683693079962,AWP 10,004,202037,Staff,0,0,0,0
1683693079962,AWP 10,005,202038,Staff,0,0,0,0
1683693079962,AWP 10,006,202039,Staff,0,0,0,0
1683693079962,AWP 10,007,202040,Staff,0,0,0,0
1683693079962,AWP 10,008,202041,Staff,0,0,0,0
1683693079962,AWP 10,009,202042,Staff,0,0,0,0
1683693079962,AWP 10,010,202043,Staff,0,0,0,0
1683693079962,AWP 10,011,202044,Staff,0,0,0,0
1683693079962,AWP 10,012,202045,Staff,0,0,0,0
1683693079962,AWP 10,013,202046,Staff,0,0,0,0
1683693079962,AWP 10,014,202047,Staff,0,0,0,0
1683693079962,AWP 10,015,202048,Staff,0,0,0,0
1683693079962,AWP 10,016,202049,Staff,0,0,0,0
1683693079962,AWP 10,017,202050,Staff,0,0,0,0
1683693079962,AWP 10,018,202051,Staff,0,0,0,0
1683693079962,AWP 10,019,202052,Staff,0,0,0,0
1683693079962,AWP 10,020,202053,Staff,0,0,0,0
1683693079962,AWP 10,021,202054,Staff,0,0,0,0
1683693079962,AWP 10,022,202055,Staff,0,0,0,0
1683693079962,AWP 10,023,202056,Staff,0,0,0,0
1683693079962,AWP 10,024,202057,Staff,0,0,0,0
1683693079962,AWP 10,025,202058,Staff,0,0,0,0
1683693079962,AWP 10,026,202059,Staff,0,0,0,0
1683693080988,AWP 102,001,202032,Staff,0,0,0,0
1683693080988,AWP 102,002,202033,Staff,0,0,0,0
1683693082018,BENG 100,A01,254234,Taylor Amos; Alyssa C,31,0,40,9
1683693083045,BENG 196,001,270013,Engler; Adam J.,9999,0,9999,0
1683693084076,BICD 100R,A01,202018,Smith; Laurie,0,7,32,32
1683693084076,BICD 100R,A02,202019,Smith; Laurie,0,3,32,32
1683693084076,BICD 100R,A03,202020,Smith; Laurie,0,1,32,32
1683693084076,BICD 100R,A04,202021,Smith; Laurie,6,0,32,26
1683693084076,BICD 100R,A05,202022,Smith; Laurie,10,0,32,22
1683693085101,BICD 136,A01,193242,Gustafson-Brown; Cindy,0,2,32,32
1683693085101,BICD 136,A02,193244,Gustafson-Brown; Cindy,13,0,32,19
1683693086127,BIEB 102,A01,193249,Butler; Shannon Rhey,1,1,32,31
1683693086127,BIEB 102,A02,193251,Butler; Shannon Rhey,0,0,32,32
1683693086127,BIEB 102,A03,193253,Butler; Shannon Rhey,0,0,32,32
1683693086127,BIEB 102,A04,193255,Butler; Shannon Rhey,13,0,32,19
1683693086127,BIEB 102,A05,193265,Butler; Shannon Rhey,25,0,32,7
1683693086127,BIEB 102,A06,193269,Butler; Shannon Rhey,13,0,32,19
1683693088176,BIEB 150,A01,193274,Staff,0,0,32,32
1683693088176,BIEB 150,A02,193285,Staff,24,0,32,8
1683693089204,BIEB 194,A00,193286,Kurle; Carolyn M.,19,0,32,13
1683693090235,BILD 1,A01,192291,Staff,15,0,32,17
1683693090235,BILD 1,A02,192292,Staff,30,0,32,2
1683693090235,BILD 1,B01,192520,Reuther; Keefe,0,1,0,0
1683693090235,BILD 1,B02,192532,Reuther; Keefe,0,1,0,0
1683693091265,BILD 3,A01,192556,Butler; Shannon Rhey,0,0,32,32
1683693091265,BILD 3,A02,192581,Butler; Shannon Rhey,0,1,32,32
1683693091265,BILD 3,A03,192611,Butler; Shannon Rhey,19,0,32,13
1683693091265,BILD 3,A04,192612,Butler; Shannon Rhey,23,0,32,9
1683693091265,BILD 3,A05,192613,Butler; Shannon Rhey,26,0,32,6
1683693091265,BILD 3,A06,192679,Butler; Shannon Rhey,27,0,32,5
1683693091265,BILD 3,A07,192682,Butler; Shannon Rhey,20,0,32,12
1683693092291,BILD 4,A01,192836,Reuther; Keefe,1,0,24,23
1683693092291,BILD 4,A02,193044,Reuther; Keefe,4,0,24,20
1683693093322,BILD 10,A01,193142,Gustafson-Brown; Cindy,29,0,32,3
1683693093322,BILD 10,A02,193149,Gustafson-Brown; Cindy,31,0,32,1
1683693094350,BIMM 100,A01,193301,Staff,0,6,32,32
1683693094350,BIMM 100,A02,193312,Staff,0,7,32,32
1683693094350,BIMM 100,A03,193323,Staff,0,10,32,32
1683693095434,BIMM 101,A01,193329,McDonnell; Lisa Marie,1,4,24,23
1683693095434,BIMM 101,A02,193339,McDonnell; Lisa Marie,1,4,24,23
1683693095434,BIMM 101,B01,193354,McDonnell; Lisa Marie,0,4,24,24
1683693095434,BIMM 101,B02,193357,McDonnell; Lisa Marie,0,3,24,24
1683693096463,BIMM 110,A01,193377,Tat; John,0,11,32,32
1683693096463,BIMM 110,A02,193378,Tat; John,0,11,32,32
1683693097488,BIMM 120,A01,206116,Staff,0,0,32,32
1683693097488,BIMM 120,A02,206117,Staff,7,0,32,25
1683693097488,BIMM 120,A03,206121,Staff,21,0,32,11
1683693098511,BIPN 100,A01,193393,Park; Ji Young,0,15,32,32
1683693098511,BIPN 100,A02,193402,Park; Ji Young,0,14,32,32
1683693098511,BIPN 100,A03,193413,Park; Ji Young,0,14,32,32
1683693098511,BIPN 100,A04,193414,Park; Ji Young,0,13,32,32
1683693099538,BIPN 102,A01,193429,Staff,0,0,32,32
1683693099538,BIPN 102,A02,193438,Staff,18,0,32,14
1683693100564,BIPN 106,A01,193450,Reyes Gonzalez; Catalina,0,2,40,40
1683693101594,BIPN 134,A01,193465,Cooke; James Edward,0,0,32,32
1683693101594,BIPN 134,A02,193474,Cooke; James Edward,25,0,32,7
1683693101594,BIPN 134,A03,193485,Cooke; James Edward,29,0,32,3
1683693101594,BIPN 134,A04,193486,Cooke; James Edward,20,0,32,12
1683693101594,BIPN 134,A05,193491,Cooke; James Edward,31,0,32,1
1683693101594,BIPN 134,A06,193501,Cooke; James Edward,30,0,32,2
1683693101594,BIPN 134,A07,193510,Cooke; James Edward,29,0,32,3
1683693103643,BISP 194,A00,222522,Staff,14,0,32,18
1683693104670,CAT 124,A01,202407,Staff,19,0,25,6
1683693105702,CAT 125,A00,202408,Marchisotto; Jennifer Anne,2,0,20,18
1683693106731,CAT 125R,A00,202409,Smith; Lauryn Alissa,0,11,20,20
1683693106731,CAT 125R,B00,202410,Morales; Celeste Georgianna,0,11,20,20
1683693106731,CAT 125R,C00,202411,Irwin; Matthew Joseph,0,12,20,20
1683693107756,CENG 15,A01,204712,Yang; Kesong,0,1,0,0
1683693108781,CENG 114,A00,202070,Jahed Motlagh; Zeinab,5,0,20,15
1683693109805,CGS 105,A00,185477,Wesling; Megan E.,24,0,40,16
1683693110829,CGS 106,A00,185494,Staff,11,0,22,11
1683693111856,CGS 108,A00,185495,Staff,14,0,20,6
1683693112881,CGS 114,A00,185496,Staff,13,0,18,5
1683693113909,CGS 119,A00,185501,Staff,15,0,20,5
1683693114932,CGS 120,A00,185511,Staff,12,0,20,8
1683693115957,CHEM 4,A01,184675,Bussey; Thomas J,97,0,100,3
1683693116982,CHEM 6A,A01,184677,Staff,32,0,60,28
1683693118007,CHEM 6B,A01,184679,Staff,63,0,100,37
1683693119032,CHEM 6C,A01,184681,Bussey; Thomas J,0,0,50,50
1683693119032,CHEM 6C,A02,184682,Bussey; Thomas J,32,0,50,18
1683693120061,CHEM 40A,A01,184684,Albizati; Kim F.,33,0,100,67
1683693121087,CHEM 40B,A01,184686,Albizati; Kim F.,0,22,100,100
1683693122113,CHEM 41B,A01,184690,Staff,51,0,100,49
1683693123138,COGS 3,A01,184715,Boyle; Mary E. T.,0,27,40,40
1683693124163,COGS 14B,A01,185172,Staff,0,14,38,38
1683693125185,COGS 18,A01,184736,Staff,14,0,80,66
1683693126212,COGS 100,A01,184932,Staff,0,8,73,73
1683693127236,COGS 101A,A01,184935,Staff,0,40,30,30
1683693128263,COGS 101B,A01,184944,Staff,0,2,30,30
1683693129290,COGS 101C,A01,184946,Staff,0,10,30,30
1683693130323,COGS 102A,A01,184951,Johnson; Christine M.,1,0,40,39
1683693131347,COGS 107B,A01,184953,Mooshagian; Eric Frederick,0,52,40,40
1683693132372,COGS 118B,A01,184959,Gupta; Anjum,0,50,40,40
1683693133396,COGS 153,A00,184961,Staff,0,16,30,30
1683693134420,COGS 177,A00,184962,Staff,1,21,30,29
1683693135449,COGS 187A,A01,184969,Boyle; Mary E. T.,0,19,40,40
1683693136477,COMM 10,A01,185174,Staff,0,5,25,25
1683693136477,COMM 10,A02,185189,Staff,0,2,25,25
1683693136477,COMM 10,A03,269821,Staff,0,1,0,0
1683693137505,COMM 100B,A02,185476,Staff,10,0,25,15
1683693137505,COMM 100B,A03,277340,Staff,25,0,25,0
1683693138532,COMM 100C,A01,185314,Staff,1,0,25,24
1683693138532,COMM 100C,A02,185327,Staff,17,0,25,8
1683693139559,COMM 110M,A00,185349,Staff,0,0,40,40
1683693140586,COMM 113T,A00,185352,Staff,25,0,40,15
1683693141611,COMM 114I,A00,185353,Staff,31,0,40,9
1683693142635,COMM 131,A00,185354,Staff,17,0,30,13
1683693143660,CSE 8A,A50,185358,Cao; Yingjun,0,46,10,10
1683693144684,CSE 8B,A01,185362,Staff,0,48,50,50
1683693145711,CSE 11,A01,185416,Cao; Yingjun,0,91,10,10
1683693146739,CSE 20,A01,185445,Briones; Jor-el Thomas Caparas,3,0,25,22
1683693147763,CSE 21,A01,185447,Staff,9,0,50,41
1683693148789,CSE 101,A01,185451,Staff,0,13,50,50
1683693148789,CSE 101,B01,185453,Jones; Miles E,0,14,50,50
1683693150839,CSE 141,A01,185458,Eldon; John,16,0,100,84
1683693151868,CSE 141L,A01,185461,Eldon; John,8,0,100,92
1683693152895,CSE 142,A01,185463,Staff,34,0,60,26
1683693152895,CSE 142,B01,201355,Staff,0,7,60,60
1683693153920,CSE 142L,A01,185470,Staff,34,0,60,26
1683693153920,CSE 142L,B01,201417,Staff,0,6,60,60
1683693154949,CSE 190,A00,201433,Staff,32,0,49,17
1683693155976,DOC 1,A01,259136,Strom; Megan C.,7,0,15,8
1683693155976,DOC 1,A02,259137,Strom; Megan C.,14,0,15,1
1683693155976,DOC 1,A03,259138,Strom; Megan C.,14,0,15,1
1683693155976,DOC 1,A04,259139,Strom; Megan C.,14,0,15,1
1683693157000,DOC 100D,A00,259140,Pass; Natalye Joann,14,0,25,11
1683693158025,DSGN 1,A01,184749,Rill; Bryan,0,26,30,30
1683693159052,DSGN 100,A01,185168,Staff,0,2,25,25
1683693160080,ECE 5,A01,185626,Morris; Karcher William,0,12,0,0
1683693161105,ECE 101,A01,185628,Staff,14,0,70,56
1683693162129,ECE 107,A01,185635,Baghdadchi; Saharnaz,0,0,20,20
1683693162129,ECE 107,A02,185638,Baghdadchi; Saharnaz,1,0,20,19
1683693163152,ECE 148,A01,185647,Silberman; Jack,0,0,16,16
1683693164176,ECON 1,A01,185537,Crane; Meredith Helen,54,0,70,16
1683693165203,ECON 3,A01,185549,Crane; Meredith Helen,30,0,70,40
1683693166228,ECON 4,A01,203354,Anderson; John Charles,0,5,10,10
1683693167253,ECON 100A,A01,185574,Staff,0,5,40,40
1683693168278,ECON 100B,A01,185576,Staff,0,12,50,50
1683693169303,ECON 100C,A01,185589,Newhouse; Herbert S,30,0,70,40
1683693170327,ECON 105,A00,185608,Vespa; Emanuel Ignacio,19,0,35,16
1683693171352,ECON 109,A01,185610,Shishkin; Denis,9,0,35,26
1683693172381,ECON 110A,A01,185612,Staff,8,0,40,32
1683693173406,ECON 120A,A01,185615,Staff,19,0,40,21
1683693174431,ECON 120C,A01,185617,Sun; Yixiao,0,21,70,70
1683693175456,ECON 144,A00,203346,Squires; Dale E,2,0,35,33
1683693176481,ECON 171,A01,203349,Newhouse; Herbert S,0,1,35,35
1683693177504,ECON 173A,A01,185621,Toda; Alexis Akira,21,0,35,14
1683693178535,EDS 25,A01,202413,Staff,0,1,0,0
1683693178535,EDS 25,A02,202414,Staff,0,1,0,0
1683693178535,EDS 25,A03,202415,Staff,0,0,0,0
1683693178535,EDS 25,A04,202416,Staff,0,1,0,0
1683693178535,EDS 25,A05,202439,Staff,0,0,0,0
1683693178535,EDS 25,A06,202440,Staff,0,0,0,0
1683693178535,EDS 25,B01,202631,Staff,0,0,0,0
1683693178535,EDS 25,B02,202632,Staff,0,0,0,0
1683693178535,EDS 25,B03,202639,Staff,0,0,0,0
1683693178535,EDS 25,B04,202640,Staff,0,0,0,0
1683693178535,EDS 25,B05,202643,Staff,0,0,0,0
1683693178535,EDS 25,B06,202644,Staff,0,0,0,0
1683693179561,EDS 38,A01,202659,Black; Alison Michelle,24,0,25,1
1683693180587,EDS 115,A00,202652,Staff,18,0,30,12
1683693181610,EDS 125,A00,202649,Staff,13,0,30,17
1683693182635,EDS 126,A01,203332,Staff,30,0,30,0
1683693183659,EDS 139,A00,202838,Staff,16,0,25,9
1683693184684,EDS 146,A01,202655,Staff,14,0,25,11
1683693185712,ENG 15,A00,185667,Staff,0,1,0,0
1683693185712,ENG 15,B00,185672,Staff,0,0,0,0
1683693185712,ENG 15,C00,185675,Staff,0,0,0,0
1683693185712,ENG 15,D00,185682,Staff,0,0,0,0
1683693185712,ENG 15,E00,185684,Staff,0,0,0,0
1683693186737,ETHN 103,A00,185710,Staff,0,8,35,35
1683693187764,ETHN 103A,A00,199228,Man; Simeon S,0,0,9,9
1683693188788,ETHN 109,A00,185711,Staff,15,0,35,20
1683693189813,ETHN 142,A00,185726,Staff,0,4,30,30
1683693190838,ETHN 163J,A00,199229,Man; Simeon S,5,0,8,3
1683693191862,ETHN 168,A00,185727,Staff,7,0,10,3
1683693192886,ETHN 182,A00,185728,Staff,0,0,35,35
1683693193914,ETHN 183,A00,185737,Staff,9,0,18,9
1683693194942,GLBH 111,A01,209361,Burgos; Jose L.,0,0,0,0
1683693197004,HIEU 104,A00,185792,Staff,14,0,20,6
1683693198034,HIEU 115,A00,185800,Staff,0,0,20,20
1683693199117,HIEU 128,A00,185801,Staff,0,9,20,20
1683693200140,HIEU 147,A00,185802,Staff,15,0,20,5
1683693201165,HIEU 154,A00,185823,Staff,11,0,20,9
1683693202188,HILA 102,A00,185826,Staff,14,0,20,6
1683693203212,HILD 2C,A01,185778,Staff,0,13,20,20
1683693204237,HILD 7B,A01,185780,Kwak; Nancy,0,17,32,32
1683693204237,HILD 7B,A02,185781,Kwak; Nancy,0,18,32,32
1683693205272,HILD 30,A01,185791,Staff,12,0,20,8
1683693206299,HISC 119,A00,185830,Golan; Tal,0,11,20,20
1683693207323,HITO 156GS,A00,185831,Patterson; Patrick H.,0,0,0,23
1683693208351,HIUS 103,A00,185832,Man; Simeon S,0,4,20,20
1683693209379,HIUS 117,A00,185836,Kwak; Nancy,2,0,20,18
1683693210403,HIUS 125,A00,185840,Man; Simeon S,0,2,23,23
1683693211427,HIUS 149,A00,185845,Staff,1,0,20,19
1683693212452,HUM 3,A01,185882,Zavodny; Tatiana Sophia,0,8,50,50
1683693212452,HUM 3,B01,185899,Caldwell; Michael Alan,0,18,50,50
1683693213476,HUM 3GS,A00,185900,Patterson; Patrick H.,0,0,0,23
1683693214506,HUM 4,A01,185938,Zroka; Amy Liane,28,0,50,22
1683693214506,HUM 4,B01,185956,Watkins; Eric,0,6,50,50
1683693214506,HUM 4,B02,202209,Watkins; Eric,0,5,50,50
1683693214506,HUM 4,B03,202210,Watkins; Eric,0,5,50,50
1683693215530,HUM 5,A01,185958,West; Geoffrey Scott,0,0,50,50
1683693215530,HUM 5,A02,202215,West; Geoffrey Scott,0,1,50,50
1683693216555,INTL 190,A00,185959,Gagnon; Jeffrey C,0,0,0,9
1683693216555,INTL 190,B00,185960,Lettieri; Michael Joseph,0,0,0,2
1683693217579,JAPN 180,A00,254509,Staff,5,0,30,25
1683693218608,LATI 10,A01,202853,Kennemore; Amy Michelle,4,0,35,31
1683693218608,LATI 10,A02,202854,Kennemore; Amy Michelle,3,0,35,32
1683693218608,LATI 10,A03,270054,Kennemore; Amy Michelle,30,0,30,0
1683693219636,LATI 180,A00,202855,Kennemore; Amy Michelle,11,0,20,9
1683693220664,LAWS 101,A00,201767,Golan; Tal,0,7,40,40
1683693221688,LIFR 1C,A00,185961,Staff,6,0,20,14
1683693222712,LIFR 1CX,A00,185962,Staff,7,0,20,13
1683693223736,LIFR 1D,A00,185963,Staff,7,0,20,13
1683693224761,LIFR 1DX,A00,185964,Staff,7,0,20,13
1683693225786,LIGN 101,A01,186039,Staff,43,0,50,7
1683693226809,LIGN 165,A00,186040,Staff,15,0,50,35
1683693227832,LTCS 108,A00,186041,Staff,5,0,10,5
1683693228857,LTCS 119,A00,186042,Staff,15,0,20,5
1683693229880,LTCS 130,A00,186043,Wesling; Megan E.,15,0,25,10
1683693231934,LTEA 138,A00,186119,Staff,14,0,40,26
1683693232957,LTEN 124,A00,186148,Staff,5,0,25,20
1683693233980,LTEN 178,A00,186149,Staff,6,0,15,9
1683693235007,LTEN 181,A00,186150,Blanco; John D,34,0,40,6
1683693236033,LTWL 120,A00,186160,Staff,19,0,25,6
1683693237060,LTWL 165,A00,186161,Staff,22,0,25,3
1683693238087,LTWR 100,A00,186162,Staff,0,5,15,15
1683693239112,LTWR 102,A00,186163,Doller; Ben,5,0,15,10
1683693240135,MAE 8,A01,186412,Staff,0,1,0,0
1683693241158,MAE 30B,A00,186445,Bahadori; Mohammad Yousef,81,0,100,19
1683693242185,MAE 40,A00,186592,Bewley; Thomas R,10,0,50,40
1683693243209,MAE 101B,A00,186593,Bahadori; Mohammad Yousef,80,0,100,20
1683693244236,MAE 105,A00,186594,Bandaru; Prabhakar,10,0,50,40
1683693245264,MAE 107,A00,186599,Pham; Hieu Tan,0,7,120,120
1683693246290,MAE 148,A01,186660,Silberman; Jack,3,0,16,13
1683693247317,MATH 10A,A01,188095,Staff,0,6,35,35
1683693248345,MATH 10B,A01,188097,Bowers; Adam R.,0,12,30,30
1683693248345,MATH 10B,A02,188099,Bowers; Adam R.,0,11,30,30
1683693248345,MATH 10B,B01,188104,Bowers; Adam R.,0,10,30,30
1683693248345,MATH 10B,B02,188106,Bowers; Adam R.,1,10,30,29
1683693249369,MATH 10C,A01,188111,Staff,0,20,30,30
1683693249369,MATH 10C,A02,188127,Staff,0,19,30,30
1683693249369,MATH 10C,A03,188131,Staff,0,19,30,30
1683693249369,MATH 10C,B01,188218,Staff,17,0,30,13
1683693249369,MATH 10C,B02,188244,Staff,13,0,30,17
1683693249369,MATH 10C,B03,188277,Staff,14,0,30,16
1683693250393,MATH 18,A01,188344,Bach; Quang Tran,18,0,30,12
1683693250393,MATH 18,A02,188345,Bach; Quang Tran,11,0,30,19
1683693250393,MATH 18,B01,188353,Bach; Quang Tran,11,0,30,19
1683693250393,MATH 18,B02,188354,Bach; Quang Tran,19,0,30,11
1683693251420,MATH 20A,A01,188374,Staff,11,0,35,24
1683693252447,MATH 20B,A01,188382,Ohm; Ko Woon,7,0,30,23
1683693252447,MATH 20B,A02,188383,Ohm; Ko Woon,22,0,30,8
1683693252447,MATH 20B,B01,188385,Ohm; Ko Woon,7,0,30,23
1683693252447,MATH 20B,B02,188392,Ohm; Ko Woon,22,0,30,8
1683693253473,MATH 20C,A01,188394,Harel; Guershon,10,0,30,20
1683693253473,MATH 20C,A02,188395,Harel; Guershon,13,0,30,17
1683693253473,MATH 20C,B01,188404,Harel; Guershon,5,0,30,25
1683693253473,MATH 20C,B02,188405,Harel; Guershon,18,0,30,12
1683693254500,MATH 20D,A01,188414,Hammock; Frances H,0,1,30,30
1683693254500,MATH 20D,A02,188415,Hammock; Frances H,0,1,30,30
1683693254500,MATH 20D,B01,188447,Hammock; Frances H,0,1,30,30
1683693254500,MATH 20D,B02,188486,Hammock; Frances H,2,0,30,28
1683693255525,MATH 20E,A01,188649,Staff,21,0,30,9
1683693255525,MATH 20E,A02,188650,Staff,20,0,30,10
1683693255525,MATH 20E,A03,188673,Staff,0,0,30,30
1683693256552,MATH 102,A01,188675,Staff,0,40,35,35
1683693257580,MATH 103B,A01,188681,Staff,3,0,35,32
1683693257580,MATH 103B,B01,188692,Staff,5,0,35,30
1683693258606,MATH 109,A01,188695,Salehi Golsefidy; Alireza,24,0,35,11
1683693258606,MATH 109,A02,188696,Salehi Golsefidy; Alireza,25,0,35,10
1683693259634,MATH 120A,A01,188698,Eggers; John Dietrich,7,0,35,28
1683693260662,MATH 142B,A01,188736,Ioana; Adrian,1,1,30,29
1683693260662,MATH 142B,A02,188741,Ioana; Adrian,0,1,30,30
1683693260662,MATH 142B,A03,188743,Ioana; Adrian,0,2,30,30
1683693261689,MATH 168A,A01,188790,Staff,0,11,35,35
1683693262714,MATH 170A,A01,188803,Nie; Jiawang,0,2,35,35
1683693262714,MATH 170A,A02,188811,Nie; Jiawang,0,1,35,35
1683693262714,MATH 170A,A03,188814,Nie; Jiawang,0,0,35,35
1683693262714,MATH 170A,A04,188815,Nie; Jiawang,5,0,35,30
1683693263737,MATH 193B,A01,188817,Staff,0,0,35,35
1683693263737,MATH 193B,A02,188818,Staff,6,0,35,29
1683693264762,MGT 4,A01,202857,Anderson; John Charles,59,0,80,21
1683693265789,MGT 12,A00,202858,Lindenberger; Wade Douglas,40,0,90,50
1683693266812,MGT 18,A00,202859,Staff,74,0,90,16
1683693267836,MGT 18GS,A00,202860,McKay; Michael J,13,0,28,15
1683693268867,MGT 45,A00,202861,Pecore; Joseph P.,8,0,90,82
1683693269894,MGT 100,A00,202863,Yavorsky; Daniel Ryan,27,0,90,63
1683693270923,MGT 103,A00,202864,Ehrich; Kristine R,0,19,90,90
1683693271950,MGT 112,A00,202865,Ehrich; Kristine R,15,0,90,75
1683693272979,MGT 121A,A00,202868,Staff,90,20,90,0
1683693274002,MGT 131B,A00,202869,Anderson; John Charles,58,0,90,32
1683693275029,MGT 136,A00,202871,Lindenberger; Wade Douglas,83,0,90,7
1683693276053,MGT 164,A00,202873,Staff,0,67,90,91
1683693277083,MGT 164GS,A00,202874,McKay; Mary A,13,0,28,15
1683693278109,MGT 180,A00,202875,Staff,0,51,90,91
1683693279132,MMW 11R,A01,205019,Herbst; Matthew,0,0,30,30
1683693279132,MMW 11R,A02,205026,Herbst; Matthew,29,0,30,1
1683693280156,MMW 15,A01,193512,Chang; Edmond Yi-Teh,0,8,28,28
1683693280156,MMW 15,A02,193513,Chang; Edmond Yi-Teh,0,5,28,28
1683693280156,MMW 15,A03,193514,Chang; Edmond Yi-Teh,0,5,28,28
1683693280156,MMW 15,A04,193515,Chang; Edmond Yi-Teh,0,5,28,28
1683693280156,MMW 15,A05,193516,Chang; Edmond Yi-Teh,0,5,28,28
1683693280156,MMW 15,A06,193517,Chang; Edmond Yi-Teh,0,6,28,28
1683693280156,MMW 15,B01,193519,Chang; Edmond Yi-Teh,0,5,28,28
1683693280156,MMW 15,B02,193520,Chang; Edmond Yi-Teh,0,5,28,28
1683693280156,MMW 15,B03,193521,Chang; Edmond Yi-Teh,0,5,28,28
1683693280156,MMW 15,B04,193522,Chang; Edmond Yi-Teh,0,6,28,28
1683693280156,MMW 15,B05,193523,Chang; Edmond Yi-Teh,0,5,28,28
1683693280156,MMW 15,B06,193524,Chang; Edmond Yi-Teh,0,5,28,28
1683693281180,MMW 122,A01,193526,Rahimi; Babak,0,16,28,28
1683693281180,MMW 122,A02,193527,Rahimi; Babak,0,15,28,28
1683693281180,MMW 122,A03,193528,Rahimi; Babak,0,0,0,0
1683693281180,MMW 122,A04,193529,Rahimi; Babak,0,0,0,0
1683693282204,MUS 1A,A01,186663,Staff,1,19,35,34
1683693283231,MUS 4,A01,186715,Staff,0,12,35,35
1683693284255,MUS 5R,A01,186796,Dubnov; Shlomo,0,17,35,35
1683693285278,MUS 6,A01,186798,Staff,1,5,25,24
1683693286301,MUS 7,A01,186830,Staff,11,0,35,24
1683693287327,MUS 8,A01,186930,Staff,0,27,35,35
1683693288356,MUS 15,A01,186932,Staff,0,15,35,35
1683693288356,MUS 15,B01,186934,Staff,1,17,35,34
1683693289385,MUS 80,A00,186935,Staff,0,0,20,20
1683693289385,MUS 80,B00,186936,Staff,24,0,25,1
1683693290409,NANO 11,A00,204702,Lipomi; Darren John,0,0,0,0
1683693291434,NANO 15,A01,204709,Yang; Kesong,0,1,0,0
1683693292458,NANO 114,A00,202069,Jahed Motlagh; Zeinab,2,0,10,8
1683693293482,PHIL 1,A00,186955,Grush; Rick Scott,31,0,40,9
1683693294509,PHIL 10,A01,186973,Grush; Rick Scott,27,0,35,8
1683693294509,PHIL 10,A02,186974,Grush; Rick Scott,33,0,35,2
1683693295535,PHIL 13,A01,186976,Staff,1,0,35,34
1683693295535,PHIL 13,A02,186977,Staff,16,0,35,19
1683693296561,PHIL 14,A01,186979,Staff,31,0,35,4
1683693296561,PHIL 14,A02,186986,Staff,32,0,35,3
1683693297586,PHIL 28,A01,186988,Staff,16,0,30,14
1683693297586,PHIL 28,A02,186989,Staff,1,0,30,29
1683693297586,PHIL 28,A03,186990,Staff,10,0,30,20
1683693297586,PHIL 28,A04,186991,Staff,26,0,30,4
1683693298611,PHIL 120,A00,186997,Staff,23,0,40,17
1683693299637,PHIL 137,A00,187003,Staff,7,0,40,33
1683693300663,PHIL 150,A00,187015,Staff,47,0,70,23
1683693301689,PHIL 167,A00,187021,Lamey; Andy M.,34,0,40,6
1683693302770,PHIL 174,A01,202226,Staff,17,0,20,3
1683693302770,PHIL 174,A02,202235,Staff,20,0,20,0
1683693303794,PHIL 191A,A00,258918,Staff,0,0,1,1
1683693304822,PHYS 1A,A00,187028,Staff,26,0,60,34
1683693305847,PHYS 1AL,001,187036,Staff,3,0,30,27
1683693305847,PHYS 1AL,002,187049,Staff,18,0,30,12
1683693306878,PHYS 1B,A00,187058,Staff,22,0,60,38
1683693307906,PHYS 1BL,001,187064,Staff,0,1,30,30
1683693307906,PHYS 1BL,002,187070,Staff,4,0,30,26
1683693308933,PHYS 1C,A00,187082,Staff,29,0,120,91
1683693309957,PHYS 1CL,001,187088,Staff,0,9,30,30
1683693309957,PHYS 1CL,002,187089,Staff,0,1,30,30
1683693309957,PHYS 1CL,009,262693,Staff,9,0,30,21
1683693310985,PHYS 2B,A01,187097,Staff,55,0,115,60
1683693312009,PHYS 2C,A01,187099,Staff,63,0,115,52
1683693313039,PHYS 2CL,A01,187101,Staff,5,0,28,23
1683693313039,PHYS 2CL,A02,187102,Staff,15,0,28,13
1683693314061,PHYS 2D,A01,187123,Shotwell; Brian,95,0,115,20
1683693315088,PHYS 4B,A01,187133,Grinstein; Benjamin,35,0,50,15
1683693316113,POLI 10,A00,188819,Staff,0,4,50,50
1683693317137,POLI 11,A00,188827,Staff,43,0,50,7
1683693318163,POLI 13R,A00,188828,Staff,0,1,20,20
1683693319186,POLI 27,A01,188830,Elgin; Samuel Zincke,0,2,70,70
1683693320211,POLI 30,A00,188832,Desposato; Scott,30,0,50,20
1683693321234,POLI 102F,A00,188834,Staff,1,0,40,39
1683693322257,POLI 104A,A00,188852,Staff,12,0,30,18
1683693323281,POLI 104I,A00,188853,Staff,0,8,20,20
1683693324307,POLI 110B,A00,188854,Wiens; David,6,0,20,14
1683693325331,POLI 112A,A00,188855,Wiens; David,3,0,30,27
1683693326355,POLI 117R,A00,188856,Forman; Fonna,0,12,20,20
1683693327379,POLI 118,A00,188857,Ingham; Sean,8,0,20,12
1683693328402,POLI 120G,A00,188858,Staff,8,0,30,22
1683693329425,POLI 131CR,A00,188863,Hoston; Germaine,20,0,50,30
1683693330449,POLI 133,A00,188864,Nellis; Gareth Hb,44,0,50,6
1683693331473,POLI 134D,A00,188865,Desposato; Scott,27,0,30,3
1683693332496,POLI 142A,A00,188871,Gartzke; Erik,21,0,50,29
1683693333523,POLI 142K,A00,188874,Staff,38,0,50,12
1683693334550,POLI 143,A00,188940,Gartzke; Erik,16,0,30,14
1683693335577,POLI 153,A00,188943,Staff,2,0,20,18
1683693336600,POLI 160AA,A00,188944,Staff,10,0,40,30
1683693337623,POLI 170A,A00,188945,Staff,10,0,30,20
1683693339670,PSYC 1,A00,188952,Staff,36,0,90,54
1683693340697,PSYC 2,B00,188953,Staff,19,0,35,16
1683693341721,PSYC 6,A00,188970,Staff,47,0,60,13
1683693342744,PSYC 7,A00,188973,Staff,35,0,45,10
1683693343771,PSYC 60,A01,188980,Rickard; Timothy C.,42,0,60,18
1683693344796,PSYC 70,A01,189001,Steiner; Eric Tomas,21,0,45,24
1683693345823,PSYC 100,A00,189005,Lacefield; Katharine I,0,99,120,120
1683693346848,PSYC 102,A00,189008,Staff,7,0,30,23
1683693347872,PSYC 106,B00,189026,Gorman; Michael R.,27,0,60,33
1683693348899,PSYC 114,B01,189033,Winkielman; Piotr,0,31,30,30
1683693349924,PSYC 131,A00,189036,Anagnostaras; Stephan,0,43,60,60
1683693350948,PSYC 136,A00,189041,Lowe; Angela Beth,0,7,25,25
1683693351972,PSYC 137,A00,189057,Winkielman; Piotr,1,37,25,24
1683693352998,PSYC 144,A00,189107,Wixted; John T,0,11,50,50
1683693355049,PSYC 162,A00,189142,Staff,0,9,85,85
1683693356074,PSYC 172,A00,189144,Gorman; Michael R.,0,6,30,30
1683693358123,PSYC 179,A00,189146,Lacefield; Katharine I,0,88,120,120
1683693359148,PSYC 181,A00,189147,Anagnostaras; Stephan,0,44,90,90
1683693360172,PSYC 190R,A00,189148,Barner; David A.,0,23,80,80
1683693361197,PSYC 191,A00,189275,Rickard; Timothy C.,0,11,25,25
1683693362225,PSYC 193,A00,189276,Chapman; Eddie Nathaniel,0,1,0,4
1683693363250,PSYC 193L,A01,189281,Lowe; Angela Beth,8,0,20,12
1683693363250,PSYC 193L,B01,189285,Staff,28,0,35,7
1683693364275,RELI 149,A00,187137,Rahimi; Babak,6,0,40,34
1683693365301,SE 9,A01,187315,Staff,0,2,18,18
1683693366329,SE 101B,A00,187409,Staff,24,0,30,6
1683693367354,SE 110B,A00,187444,Staff,10,0,40,30
1683693368377,SE 130B,A00,187449,Staff,31,0,40,9
1683693369405,SE 150A,A00,187516,Staff,8,0,20,12
1683693370430,SE 154,A00,187528,Staff,29,0,50,21
1683693371454,SIO 3,A01,258171,Staff,35,0,40,5
1683693372478,SIO 10,A00,187144,Cook; Geoffrey W,1,7,75,74
1683693373504,SIO 45,A00,187152,Cook; Geoffrey W,0,7,100,100
1683693374529,SIO 109R,A00,194486,Staff,0,4,20,20
1683693376602,SIO 187,A01,187233,Kacev; David,12,0,40,28
1683693377627,SOCI 1,A01,258656,Thorpe; Charles Robert,28,0,30,2
1683693377627,SOCI 1,A02,258658,Thorpe; Charles Robert,30,0,30,0
1683693377627,SOCI 1,A03,258661,Thorpe; Charles Robert,25,0,25,0
1683693377627,SOCI 1,A04,258666,Thorpe; Charles Robert,22,0,25,3
1683693377627,SOCI 1,A05,258897,Thorpe; Charles Robert,22,0,25,3
1683693377627,SOCI 1,A06,258898,Thorpe; Charles Robert,25,0,25,0
1683693378652,SOCI 30,A01,258903,Pardo Guerra; Juan Pablo,14,0,30,16
1683693379680,SOCI 102,A00,258904,Staff,9,0,25,16
1683693380706,SOCI 106,A00,258905,Staff,19,0,25,6
1683693381731,SOCI 111,A00,258907,Ribas Norris; Janet Vanesa,25,0,30,5
1683693382759,SOCI 121R,A00,258908,Pardo Guerra; Juan Pablo,8,0,30,22
1683693383786,SOCI 126,A01,203330,Staff,14,0,20,6
1683693384811,SOCI 131,A00,258909,Thorpe; Charles Robert,30,0,60,30
1683693385836,SOCI 135,A00,258910,Payne; Christine Anna,0,13,30,30
1683693386860,SOCI 157,A00,258911,Staff,11,0,30,19
1683693387887,SOCI 184,A00,258912,Staff,25,0,30,5
1683693388915,SOCI 188D,A00,258913,Staff,22,0,30,8
1683693389943,SYN 2,001,187529,Staff,9,0,16,7
1683693389943,SYN 2,002,201452,Staff,1,20,16,15
1683693389943,SYN 2,003,201469,Staff,1,0,16,15
1683693390969,SYN 100,A01,187531,Staff,0,9,20,20
1683693390969,SYN 100,B01,201491,Staff,0,10,20,20
1683693391999,TDAC 1,A00,189286,Walsh; Kim C.,3,0,20,17
1683693391999,TDAC 1,B00,189287,Harting; Carla Kelso,10,0,20,10
1683693393025,TDAC 101,A00,189300,Walsh; Kim C.,16,0,20,4
1683693393025,TDAC 101,B00,189301,Harting; Carla Kelso,18,0,20,2
1683693394049,TDAC 102,A00,189304,Basso; Beatrice,14,0,20,6
1683693395076,TDAC 108,A00,189305,Staff,18,0,20,2
1683693396100,TDDE 131,A00,189310,Staff,19,0,20,1
1683693396100,TDDE 131,B00,189314,Staff,19,0,20,1
1683693396100,TDDE 131,C00,189315,Staff,48,0,50,2
1683693396100,TDDE 131,D00,189316,Staff,14,0,15,1
1683693396100,TDDE 131,E00,204841,Staff,20,0,20,0
1683693397129,TDGE 10,A00,189289,Staff,27,0,50,23
1683693397129,TDGE 10,B00,189290,Havis; Allan,0,1,50,50
1683693398157,TDGE 11,A00,189291,Fulton; Julia,0,4,50,50
1683693398157,TDGE 11,B00,189292,Staff,20,0,25,5
1683693398157,TDGE 11,C00,260270,Staff,0,0,0,0
1683693399184,TDGE 25,A00,189294,Staff,1,0,20,19
1683693400214,TDGE 124,A00,189318,Fulton; Julia,1,8,50,49
1683693401238,TDGE 125,A00,189319,Staff,13,0,25,12
1683693401238,TDGE 125,B00,189320,Staff,23,0,25,2
1683693402262,TDGE 127,A00,189322,Havis; Allan,0,0,50,50
1683693403291,TDHT 101,A00,189323,Staff,18,0,25,7
1683693403291,TDHT 101,B00,189324,Staff,25,0,25,0
1683693404316,TDHT 102,A00,189325,Staff,49,0,50,1
1683693405341,TDMV 1,A00,189295,Arcidiacono; Kristin,20,0,30,10
1683693405341,TDMV 1,B00,189296,Caligagan; Maria T.,24,0,30,6
1683693406436,TDMV 2,A00,189297,Sammartano; Tonnie,27,0,30,3
1683693406436,TDMV 2,B00,189299,Arcidiacono; Kristin,23,0,30,7
1683693407460,TDMV 3,A00,204998,Rincon; Alicia,22,0,30,8
1683693408483,TDMV 120,A00,189458,Sammartano; Tonnie,28,0,30,2
1683693409508,TDMV 138,A00,189541,Jun; Grace Shin Hae,20,0,40,20
1683693410535,TDMV 142,A00,189717,Caligagan; Tony,25,0,30,5
1683693410535,TDMV 142,B00,189718,Caligagan; Maria T.,25,0,30,5
1683693411562,TMC 2,A01,187533,Staff,25,0,25,0
1683693411562,TMC 2,A02,187534,Staff,25,0,25,0
1683693412589,USP 1,A01,187536,Kwak; Nancy,0,16,25,25
1683693413617,USP 5,A01,187538,Staff,8,0,25,17
1683693414642,USP 101,A00,199253,Staff,0,4,0,0
1683693415666,USP 124,A00,187562,Boomhower; Matthew Charles,0,0,30,30
1683693416693,USP 138,A00,187582,Staff,19,0,25,6
1683693417716,USP 152,A01,187597,Staff,3,0,25,22
1683693418739,USP 153,A00,187598,Staff,18,0,25,7
1683693419764,USP 168,A00,187607,Kwak; Nancy,2,0,5,3
1683693420788,USP 173,A00,187619,Staff,4,0,25,21
1683693421812,USP 181,A00,187638,Staff,0,4,25,25
1683693422840,VIS 103,A00,187650,Cruz; Edwin Teddy,17,0,75,58
1683693423864,VIS 110D,A00,187669,Staff,13,0,22,9
1683693424888,VIS 127C,A00,187720,Shen; Kuiyi,67,0,146,79
1683693425913,VIS 149,A00,187731,Yoldas; Pinar,2,14,22,20
1683693426938,VIS 151,A01,188091,Staff,22,0,34,12
1683693426938,VIS 151,A02,188092,Staff,11,0,34,23
1683693427966,VIS 160B,A00,188093,Stalbaum; Brett,0,1,10,10
1683693430013,WCWP 10B,A00,201720,Staff,0,0,5,5
1683693430013,WCWP 10B,B00,201722,Staff,0,0,6,6
1683693431038,WCWP 100,A00,201725,Gagnon; Jeffrey C,0,0,2,2
1683693431038,WCWP 100,B00,201727,Staff,0,4,15,15
1683693434127,ANBI 133,A00,258401,Wilder; Linnea Lorene,34,0,40,6
1683693435155,ANBI 140,A00,258395,Hrvoj Mihic; Branka,18,0,25,7
1683693436182,ANSC 120,A00,258402,Bialecki; Jon Anthony,26,0,40,14
1683693437203,ANSC 144,A00,258400,Staff,12,0,40,28
1683693439253,ANSC 166,A00,258396,Parish; Steven Martin,156,0,175,19
1683693440279,ANSC 180,A00,193533,Staff,8,0,20,12
1683693441302,ANSC 188,A00,258397,Jassal; Aftab,34,0,40,6
1683693442327,ANTH 3,A01,258316,Staff,23,0,30,7
1683693443351,ANTH 5,A00,258394,Semendeferi; Ekaterini,16,0,20,4
1683693444378,ANTH 21,A01,258331,Staff,4,0,40,36
1683693445404,ANTH 103,A00,258398,Varma; Saiba,15,0,25,10
1683693446435,AWP 10,001,202034,Staff,0,0,0,0
1683693446435,AWP 10,002,202035,Staff,0,0,0,0
1683693446435,AWP 10,003,202036,Staff,0,0,0,0
1683693446435,AWP 10,004,202037,Staff,0,0,0,0
1683693446435,AWP 10,005,202038,Staff,0,0,0,0
1683693446435,AWP 10,006,202039,Staff,0,0,0,0
1683693446435,AWP 10,007,202040,Staff,0,0,0,0
1683693446435,AWP 10,008,202041,Staff,0,0,0,0
1683693446435,AWP 10,009,202042,Staff,0,0,0,0
1683693446435,AWP 10,010,202043,Staff,0,0,0,0
1683693446435,AWP 10,011,202044,Staff,0,0,0,0
1683693446435,AWP 10,012,202045,Staff,0,0,0,0
1683693446435,AWP 10,013,202046,Staff,0,0,0,0
1683693446435,AWP 10,014,202047,Staff,0,0,0,0
1683693446435,AWP 10,015,202048,Staff,0,0,0,0
1683693446435,AWP 10,016,202049,Staff,0,0,0,0
1683693446435,AWP 10,017,202050,Staff,0,0,0,0
1683693446435,AWP 10,018,202051,Staff,0,0,0,0
1683693446435,AWP 10,019,202052,Staff,0,0,0,0
1683693446435,AWP 10,020,202053,Staff,0,0,0,0
1683693446435,AWP 10,021,202054,Staff,0,0,0,0
1683693446435,AWP 10,022,202055,Staff,0,0,0,0
1683693446435,AWP 10,023,202056,Staff,0,0,0,0
1683693446435,AWP 10,024,202057,Staff,0,0,0,0
1683693446435,AWP 10,025,202058,Staff,0,0,0,0
1683693446435,AWP 10,026,202059,Staff,0,0,0,0
1683693447461,AWP 102,001,202032,Staff,0,0,0,0
1683693447461,AWP 102,002,202033,Staff,0,0,0,0
1683693448486,BENG 100,A01,254234,Taylor Amos; Alyssa C,31,0,40,9
1683693449513,BENG 196,001,270013,Engler; Adam J.,9999,0,9999,0
1683693450539,BICD 100R,A01,202018,Smith; Laurie,0,7,32,32
1683693450539,BICD 100R,A02,202019,Smith; Laurie,0,3,32,32
1683693450539,BICD 100R,A03,202020,Smith; Laurie,0,1,32,32
1683693450539,BICD 100R,A04,202021,Smith; Laurie,6,0,32,26
1683693450539,BICD 100R,A05,202022,Smith; Laurie,10,0,32,22
1683693451566,BICD 136,A01,193242,Gustafson-Brown; Cindy,0,2,32,32
1683693451566,BICD 136,A02,193244,Gustafson-Brown; Cindy,13,0,32,19
1683693452596,BIEB 102,A01,193249,Butler; Shannon Rhey,1,1,32,31
1683693452596,BIEB 102,A02,193251,Butler; Shannon Rhey,0,0,32,32
1683693452596,BIEB 102,A03,193253,Butler; Shannon Rhey,0,0,32,32
1683693452596,BIEB 102,A04,193255,Butler; Shannon Rhey,13,0,32,19
1683693452596,BIEB 102,A05,193265,Butler; Shannon Rhey,25,0,32,7
1683693452596,BIEB 102,A06,193269,Butler; Shannon Rhey,13,0,32,19
1683693454646,BIEB 150,A01,193274,Staff,0,0,32,32
1683693454646,BIEB 150,A02,193285,Staff,24,0,32,8
1683693455670,BIEB 194,A00,193286,Kurle; Carolyn M.,19,0,32,13
1683693456696,BILD 1,A01,192291,Staff,15,0,32,17
1683693456696,BILD 1,A02,192292,Staff,30,0,32,2
1683693456696,BILD 1,B01,192520,Reuther; Keefe,0,1,0,0
1683693456696,BILD 1,B02,192532,Reuther; Keefe,0,1,0,0
1683693457721,BILD 3,A01,192556,Butler; Shannon Rhey,0,0,32,32
1683693457721,BILD 3,A02,192581,Butler; Shannon Rhey,0,1,32,32
1683693457721,BILD 3,A03,192611,Butler; Shannon Rhey,19,0,32,13
1683693457721,BILD 3,A04,192612,Butler; Shannon Rhey,23,0,32,9
1683693457721,BILD 3,A05,192613,Butler; Shannon Rhey,26,0,32,6
1683693457721,BILD 3,A06,192679,Butler; Shannon Rhey,27,0,32,5
1683693457721,BILD 3,A07,192682,Butler; Shannon Rhey,20,0,32,12
1683693458746,BILD 4,A01,192836,Reuther; Keefe,1,0,24,23
1683693458746,BILD 4,A02,193044,Reuther; Keefe,4,0,24,20
1683693459772,BILD 10,A01,193142,Gustafson-Brown; Cindy,29,0,32,3
1683693459772,BILD 10,A02,193149,Gustafson-Brown; Cindy,31,0,32,1
1683693460797,BIMM 100,A01,193301,Staff,0,6,32,32
1683693460797,BIMM 100,A02,193312,Staff,0,7,32,32
1683693460797,BIMM 100,A03,193323,Staff,0,10,32,32
1683693461823,BIMM 101,A01,193329,McDonnell; Lisa Marie,1,4,24,23
1683693461823,BIMM 101,A02,193339,McDonnell; Lisa Marie,1,4,24,23
1683693461823,BIMM 101,B01,193354,McDonnell; Lisa Marie,0,4,24,24
1683693461823,BIMM 101,B02,193357,McDonnell; Lisa Marie,0,3,24,24
1683693462848,BIMM 110,A01,193377,Tat; John,0,11,32,32
1683693462848,BIMM 110,A02,193378,Tat; John,0,11,32,32
1683693463877,BIMM 120,A01,206116,Staff,0,0,32,32
1683693463877,BIMM 120,A02,206117,Staff,7,0,32,25
1683693463877,BIMM 120,A03,206121,Staff,21,0,32,11
1683693464904,BIPN 100,A01,193393,Park; Ji Young,0,15,32,32
1683693464904,BIPN 100,A02,193402,Park; Ji Young,0,14,32,32
1683693464904,BIPN 100,A03,193413,Park; Ji Young,0,14,32,32
1683693464904,BIPN 100,A04,193414,Park; Ji Young,0,13,32,32
1683693465931,BIPN 102,A01,193429,Staff,0,0,32,32
1683693465931,BIPN 102,A02,193438,Staff,18,0,32,14
1683693466956,BIPN 106,A01,193450,Reyes Gonzalez; Catalina,0,2,40,40
1683693467985,BIPN 134,A01,193465,Cooke; James Edward,0,0,32,32
1683693467985,BIPN 134,A02,193474,Cooke; James Edward,25,0,32,7
1683693467985,BIPN 134,A03,193485,Cooke; James Edward,29,0,32,3
1683693467985,BIPN 134,A04,193486,Cooke; James Edward,20,0,32,12
1683693467985,BIPN 134,A05,193491,Cooke; James Edward,31,0,32,1
1683693467985,BIPN 134,A06,193501,Cooke; James Edward,30,0,32,2
1683693467985,BIPN 134,A07,193510,Cooke; James Edward,29,0,32,3
1683693470036,BISP 194,A00,222522,Staff,14,0,32,18
1683693471064,CAT 124,A01,202407,Staff,19,0,25,6
1683693472089,CAT 125,A00,202408,Marchisotto; Jennifer Anne,2,0,20,18
1683693473117,CAT 125R,A00,202409,Smith; Lauryn Alissa,0,11,20,20
1683693473117,CAT 125R,B00,202410,Morales; Celeste Georgianna,0,11,20,20
1683693473117,CAT 125R,C00,202411,Irwin; Matthew Joseph,0,12,20,20
1683693474142,CENG 15,A01,204712,Yang; Kesong,0,1,0,0
1683693475164,CENG 114,A00,202070,Jahed Motlagh; Zeinab,5,0,20,15
1683693476188,CGS 105,A00,185477,Wesling; Megan E.,24,0,40,16
1683693477211,CGS 106,A00,185494,Staff,11,0,22,11
1683693478235,CGS 108,A00,185495,Staff,14,0,20,6
1683693479262,CGS 114,A00,185496,Staff,13,0,18,5
1683693480286,CGS 119,A00,185501,Staff,15,0,20,5
1683693481316,CGS 120,A00,185511,Staff,12,0,20,8
1683693482339,CHEM 4,A01,184675,Bussey; Thomas J,97,0,100,3
1683693483365,CHEM 6A,A01,184677,Staff,32,0,60,28
1683693484389,CHEM 6B,A01,184679,Staff,63,0,100,37
1683693485413,CHEM 6C,A01,184681,Bussey; Thomas J,0,0,50,50
1683693485413,CHEM 6C,A02,184682,Bussey; Thomas J,32,0,50,18
1683693486437,CHEM 40A,A01,184684,Albizati; Kim F.,33,0,100,67
1683693487461,CHEM 40B,A01,184686,Albizati; Kim F.,0,22,100,100
1683693488488,CHEM 41B,A01,184690,Staff,51,0,100,49
1683693489516,COGS 3,A01,184715,Boyle; Mary E. T.,0,27,40,40
1683693490539,COGS 14B,A01,185172,Staff,0,14,38,38
1683693491564,COGS 18,A01,184736,Staff,14,0,80,66
1683693492589,COGS 100,A01,184932,Staff,0,8,73,73
1683693493614,COGS 101A,A01,184935,Staff,0,40,30,30
1683693494637,COGS 101B,A01,184944,Staff,0,2,30,30
1683693495662,COGS 101C,A01,184946,Staff,0,10,30,30
1683693496687,COGS 102A,A01,184951,Johnson; Christine M.,1,0,40,39
1683693497717,COGS 107B,A01,184953,Mooshagian; Eric Frederick,0,52,40,40
1683693498748,COGS 118B,A01,184959,Gupta; Anjum,0,50,40,40
1683693499776,COGS 153,A00,184961,Staff,0,16,30,30
1683693500802,COGS 177,A00,184962,Staff,1,21,30,29
1683693501827,COGS 187A,A01,184969,Boyle; Mary E. T.,0,19,40,40
1683693502854,COMM 10,A01,185174,Staff,0,5,25,25
1683693502854,COMM 10,A02,185189,Staff,0,2,25,25
1683693502854,COMM 10,A03,269821,Staff,0,1,0,0
1683693503877,COMM 100B,A02,185476,Staff,10,0,25,15
1683693503877,COMM 100B,A03,277340,Staff,25,0,25,0
1683693504906,COMM 100C,A01,185314,Staff,1,0,25,24
1683693504906,COMM 100C,A02,185327,Staff,17,0,25,8
1683693505934,COMM 110M,A00,185349,Staff,0,0,40,40
1683693506959,COMM 113T,A00,185352,Staff,25,0,40,15
1683693507982,COMM 114I,A00,185353,Staff,31,0,40,9
1683693509009,COMM 131,A00,185354,Staff,17,0,30,13
1683693510092,CSE 8A,A50,185358,Cao; Yingjun,0,46,10,10
1683693511116,CSE 8B,A01,185362,Staff,0,48,50,50
1683693512140,CSE 11,A01,185416,Cao; Yingjun,0,91,10,10
1683693513168,CSE 20,A01,185445,Briones; Jor-el Thomas Caparas,3,0,25,22
1683693514195,CSE 21,A01,185447,Staff,9,0,50,41
1683693515224,CSE 101,A01,185451,Staff,0,13,50,50
1683693515224,CSE 101,B01,185453,Jones; Miles E,0,14,50,50
1683693517274,CSE 141,A01,185458,Eldon; John,16,0,100,84
1683693518302,CSE 141L,A01,185461,Eldon; John,8,0,100,92
1683693519330,CSE 142,A01,185463,Staff,34,0,60,26
1683693519330,CSE 142,B01,201355,Staff,0,7,60,60
1683693520356,CSE 142L,A01,185470,Staff,34,0,60,26
1683693520356,CSE 142L,B01,201417,Staff,0,6,60,60
1683693521383,CSE 190,A00,201433,Staff,32,0,49,17
1683693522412,DOC 1,A01,259136,Strom; Megan C.,7,0,15,8
1683693522412,DOC 1,A02,259137,Strom; Megan C.,14,0,15,1
1683693522412,DOC 1,A03,259138,Strom; Megan C.,14,0,15,1
1683693522412,DOC 1,A04,259139,Strom; Megan C.,14,0,15,1
1683693523439,DOC 100D,A00,259140,Pass; Natalye Joann,14,0,25,11
1683693524466,DSGN 1,A01,184749,Rill; Bryan,0,26,30,30
1683693525500,DSGN 100,A01,185168,Staff,0,2,25,25
1683693526525,ECE 5,A01,185626,Morris; Karcher William,0,12,0,0
1683693527548,ECE 101,A01,185628,Staff,14,0,70,56
1683693528576,ECE 107,A01,185635,Baghdadchi; Saharnaz,0,0,20,20
1683693528576,ECE 107,A02,185638,Baghdadchi; Saharnaz,1,0,20,19
1683693529601,ECE 148,A01,185647,Silberman; Jack,0,0,16,16
1683693530625,ECON 1,A01,185537,Crane; Meredith Helen,54,0,70,16
1683693531651,ECON 3,A01,185549,Crane; Meredith Helen,30,0,70,40
1683693532674,ECON 4,A01,203354,Anderson; John Charles,0,5,10,10
1683693533698,ECON 100A,A01,185574,Staff,0,5,40,40
1683693534723,ECON 100B,A01,185576,Staff,0,12,50,50
1683693535750,ECON 100C,A01,185589,Newhouse; Herbert S,30,0,70,40
1683693536778,ECON 105,A00,185608,Vespa; Emanuel Ignacio,19,0,35,16
1683693537808,ECON 109,A01,185610,Shishkin; Denis,9,0,35,26
1683693538832,ECON 110A,A01,185612,Staff,8,0,40,32
1683693539857,ECON 120A,A01,185615,Staff,19,0,40,21
1683693540886,ECON 120C,A01,185617,Sun; Yixiao,0,21,70,70
1683693541909,ECON 144,A00,203346,Squires; Dale E,2,0,35,33
1683693542937,ECON 171,A01,203349,Newhouse; Herbert S,0,1,35,35
1683693543964,ECON 173A,A01,185621,Toda; Alexis Akira,21,0,35,14
1683693544989,EDS 25,A01,202413,Staff,0,1,0,0
1683693544989,EDS 25,A02,202414,Staff,0,1,0,0
1683693544989,EDS 25,A03,202415,Staff,0,0,0,0
1683693544989,EDS 25,A04,202416,Staff,0,1,0,0
1683693544989,EDS 25,A05,202439,Staff,0,0,0,0
1683693544989,EDS 25,A06,202440,Staff,0,0,0,0
1683693544989,EDS 25,B01,202631,Staff,0,0,0,0
1683693544989,EDS 25,B02,202632,Staff,0,0,0,0
1683693544989,EDS 25,B03,202639,Staff,0,0,0,0
1683693544989,EDS 25,B04,202640,Staff,0,0,0,0
1683693544989,EDS 25,B05,202643,Staff,0,0,0,0
1683693544989,EDS 25,B06,202644,Staff,0,0,0,0
1683693546016,EDS 38,A01,202659,Black; Alison Michelle,24,0,25,1
1683693547041,EDS 115,A00,202652,Staff,18,0,30,12
1683693548068,EDS 125,A00,202649,Staff,13,0,30,17
1683693549097,EDS 126,A01,203332,Staff,30,0,30,0
1683693550122,EDS 139,A00,202838,Staff,16,0,25,9
1683693551149,EDS 146,A01,202655,Staff,14,0,25,11
1683693552177,ENG 15,A00,185667,Staff,0,1,0,0
1683693552177,ENG 15,B00,185672,Staff,0,0,0,0
1683693552177,ENG 15,C00,185675,Staff,0,0,0,0
1683693552177,ENG 15,D00,185682,Staff,0,0,0,0
1683693552177,ENG 15,E00,185684,Staff,0,0,0,0
1683693553205,ETHN 103,A00,185710,Staff,0,8,35,35
1683693554228,ETHN 103A,A00,199228,Man; Simeon S,0,0,9,9
1683693555252,ETHN 109,A00,185711,Staff,15,0,35,20
1683693556279,ETHN 142,A00,185726,Staff,0,4,30,30
1683693557303,ETHN 163J,A00,199229,Man; Simeon S,5,0,8,3
1683693558326,ETHN 168,A00,185727,Staff,7,0,10,3
1683693559349,ETHN 182,A00,185728,Staff,0,0,35,35
1683693560373,ETHN 183,A00,185737,Staff,9,0,18,9
1683693561396,GLBH 111,A01,209361,Burgos; Jose L.,0,0,0,0
1683693563445,HIEU 104,A00,185792,Staff,14,0,20,6
1683693564473,HIEU 115,A00,185800,Staff,0,0,20,20
1683693565501,HIEU 128,A00,185801,Staff,0,9,20,20
1683693566530,HIEU 147,A00,185802,Staff,15,0,20,5
1683693567558,HIEU 154,A00,185823,Staff,11,0,20,9
1683693568585,HILA 102,A00,185826,Staff,14,0,20,6
1683693569609,HILD 2C,A01,185778,Staff,0,13,20,20
1683693570637,HILD 7B,A01,185780,Kwak; Nancy,0,17,32,32
1683693570637,HILD 7B,A02,185781,Kwak; Nancy,0,18,32,32
1683693571665,HILD 30,A01,185791,Staff,12,0,20,8
1683693572689,HISC 119,A00,185830,Golan; Tal,0,10,20,20
1683693573714,HITO 156GS,A00,185831,Patterson; Patrick H.,0,0,0,23
1683693574739,HIUS 103,A00,185832,Man; Simeon S,0,4,20,20
1683693575763,HIUS 117,A00,185836,Kwak; Nancy,2,0,20,18
1683693576790,HIUS 125,A00,185840,Man; Simeon S,0,2,23,23
1683693577814,HIUS 149,A00,185845,Staff,1,0,20,19
1683693578838,HUM 3,A01,185882,Zavodny; Tatiana Sophia,0,8,50,50
1683693578838,HUM 3,B01,185899,Caldwell; Michael Alan,0,18,50,50
1683693579865,HUM 3GS,A00,185900,Patterson; Patrick H.,0,0,0,23
1683693580893,HUM 4,A01,185938,Zroka; Amy Liane,28,0,50,22
1683693580893,HUM 4,B01,185956,Watkins; Eric,0,6,50,50
1683693580893,HUM 4,B02,202209,Watkins; Eric,0,5,50,50
1683693580893,HUM 4,B03,202210,Watkins; Eric,0,5,50,50
1683693581923,HUM 5,A01,185958,West; Geoffrey Scott,0,0,50,50
1683693581923,HUM 5,A02,202215,West; Geoffrey Scott,0,1,50,50
1683693582946,INTL 190,A00,185959,Gagnon; Jeffrey C,0,0,0,9
1683693582946,INTL 190,B00,185960,Lettieri; Michael Joseph,0,0,0,2
1683693583972,JAPN 180,A00,254509,Staff,5,0,30,25
1683693585000,LATI 10,A01,202853,Kennemore; Amy Michelle,4,0,35,31
1683693585000,LATI 10,A02,202854,Kennemore; Amy Michelle,3,0,35,32
1683693585000,LATI 10,A03,270054,Kennemore; Amy Michelle,30,0,30,0
1683693586027,LATI 180,A00,202855,Kennemore; Amy Michelle,11,0,20,9
1683693587051,LAWS 101,A00,201767,Golan; Tal,0,7,40,40
1683693588074,LIFR 1C,A00,185961,Staff,6,0,20,14
1683693589096,LIFR 1CX,A00,185962,Staff,7,0,20,13
1683693590123,LIFR 1D,A00,185963,Staff,7,0,20,13
1683693591147,LIFR 1DX,A00,185964,Staff,7,0,20,13
1683693592170,LIGN 101,A01,186039,Staff,43,0,50,7
1683693593196,LIGN 165,A00,186040,Staff,15,0,50,35
1683693594223,LTCS 108,A00,186041,Staff,5,0,10,5
1683693595250,LTCS 119,A00,186042,Staff,15,0,20,5
1683693596276,LTCS 130,A00,186043,Wesling; Megan E.,15,0,25,10
1683693598327,LTEA 138,A00,186119,Staff,14,0,40,26
1683693599354,LTEN 124,A00,186148,Staff,5,0,25,20
1683693600376,LTEN 178,A00,186149,Staff,6,0,15,9
1683693601405,LTEN 181,A00,186150,Blanco; John D,34,0,40,6
1683693602428,LTWL 120,A00,186160,Staff,19,0,25,6
1683693603452,LTWL 165,A00,186161,Staff,22,0,25,3
1683693604478,LTWR 100,A00,186162,Staff,0,5,15,15
1683693605506,LTWR 102,A00,186163,Doller; Ben,5,0,15,10
1683693606530,MAE 8,A01,186412,Staff,0,1,0,0
1683693607556,MAE 30B,A00,186445,Bahadori; Mohammad Yousef,81,0,100,19
1683693608583,MAE 40,A00,186592,Bewley; Thomas R,10,0,50,40
1683693609607,MAE 101B,A00,186593,Bahadori; Mohammad Yousef,80,0,100,20
1683693610631,MAE 105,A00,186594,Bandaru; Prabhakar,10,0,50,40
1683693611656,MAE 107,A00,186599,Pham; Hieu Tan,0,7,120,120
1683693612683,MAE 148,A01,186660,Silberman; Jack,3,0,16,13
1683693613765,MATH 10A,A01,188095,Staff,0,6,35,35
1683693614789,MATH 10B,A01,188097,Bowers; Adam R.,0,12,30,30
1683693614789,MATH 10B,A02,188099,Bowers; Adam R.,0,11,30,30
1683693614789,MATH 10B,B01,188104,Bowers; Adam R.,0,10,30,30
1683693614789,MATH 10B,B02,188106,Bowers; Adam R.,1,10,30,29
1683693615814,MATH 10C,A01,188111,Staff,0,20,30,30
1683693615814,MATH 10C,A02,188127,Staff,0,19,30,30
1683693615814,MATH 10C,A03,188131,Staff,0,19,30,30
1683693615814,MATH 10C,B01,188218,Staff,17,0,30,13
1683693615814,MATH 10C,B02,188244,Staff,13,0,30,17
1683693615814,MATH 10C,B03,188277,Staff,14,0,30,16
1683693616839,MATH 18,A01,188344,Bach; Quang Tran,18,0,30,12
1683693616839,MATH 18,A02,188345,Bach; Quang Tran,11,0,30,19
1683693616839,MATH 18,B01,188353,Bach; Quang Tran,11,0,30,19
1683693616839,MATH 18,B02,188354,Bach; Quang Tran,19,0,30,11
1683693617864,MATH 20A,A01,188374,Staff,11,0,35,24
1683693618893,MATH 20B,A01,188382,Ohm; Ko Woon,7,0,30,23
1683693618893,MATH 20B,A02,188383,Ohm; Ko Woon,22,0,30,8
1683693618893,MATH 20B,B01,188385,Ohm; Ko Woon,7,0,30,23
1683693618893,MATH 20B,B02,188392,Ohm; Ko Woon,22,0,30,8
1683693619921,MATH 20C,A01,188394,Harel; Guershon,10,0,30,20
1683693619921,MATH 20C,A02,188395,Harel; Guershon,13,0,30,17
1683693619921,MATH 20C,B01,188404,Harel; Guershon,5,0,30,25
1683693619921,MATH 20C,B02,188405,Harel; Guershon,18,0,30,12
1683693620948,MATH 20D,A01,188414,Hammock; Frances H,0,1,30,30
1683693620948,MATH 20D,A02,188415,Hammock; Frances H,0,1,30,30
1683693620948,MATH 20D,B01,188447,Hammock; Frances H,0,1,30,30
1683693620948,MATH 20D,B02,188486,Hammock; Frances H,2,0,30,28
1683693621971,MATH 20E,A01,188649,Staff,21,0,30,9
1683693621971,MATH 20E,A02,188650,Staff,20,0,30,10
1683693621971,MATH 20E,A03,188673,Staff,0,0,30,30
1683693622996,MATH 102,A01,188675,Staff,0,40,35,35
1683693624020,MATH 103B,A01,188681,Staff,3,0,35,32
1683693624020,MATH 103B,B01,188692,Staff,5,0,35,30
1683693625049,MATH 109,A01,188695,Salehi Golsefidy; Alireza,24,0,35,11
1683693625049,MATH 109,A02,188696,Salehi Golsefidy; Alireza,25,0,35,10
1683693626071,MATH 120A,A01,188698,Eggers; John Dietrich,7,0,35,28
1683693627099,MATH 142B,A01,188736,Ioana; Adrian,1,1,30,29
1683693627099,MATH 142B,A02,188741,Ioana; Adrian,0,1,30,30
1683693627099,MATH 142B,A03,188743,Ioana; Adrian,0,2,30,30
1683693628125,MATH 168A,A01,188790,Staff,0,11,35,35
1683693629152,MATH 170A,A01,188803,Nie; Jiawang,0,2,35,35
1683693629152,MATH 170A,A02,188811,Nie; Jiawang,0,1,35,35
1683693629152,MATH 170A,A03,188814,Nie; Jiawang,0,0,35,35
1683693629152,MATH 170A,A04,188815,Nie; Jiawang,5,0,35,30
1683693630179,MATH 193B,A01,188817,Staff,0,0,35,35
1683693630179,MATH 193B,A02,188818,Staff,6,0,35,29
1683693631202,MGT 4,A01,202857,Anderson; John Charles,59,0,80,21
1683693632230,MGT 12,A00,202858,Lindenberger; Wade Douglas,40,0,90,50
1683693633254,MGT 18,A00,202859,Staff,74,0,90,16
1683693634280,MGT 18GS,A00,202860,McKay; Michael J,13,0,28,15
1683693635307,MGT 45,A00,202861,Pecore; Joseph P.,8,0,90,82
1683693636331,MGT 100,A00,202863,Yavorsky; Daniel Ryan,27,0,90,63
1683693637359,MGT 103,A00,202864,Ehrich; Kristine R,0,19,90,90
1683693638383,MGT 112,A00,202865,Ehrich; Kristine R,15,0,90,75
1683693639410,MGT 121A,A00,202868,Staff,90,20,90,0
1683693640438,MGT 131B,A00,202869,Anderson; John Charles,58,0,90,32
1683693641466,MGT 136,A00,202871,Lindenberger; Wade Douglas,83,0,90,7
1683693642490,MGT 164,A00,202873,Staff,0,67,90,91
1683693643517,MGT 164GS,A00,202874,McKay; Mary A,13,0,28,15
1683693644543,MGT 180,A00,202875,Staff,0,51,90,91
1683693645567,MMW 11R,A01,205019,Herbst; Matthew,0,0,30,30
1683693645567,MMW 11R,A02,205026,Herbst; Matthew,29,0,30,1
1683693646593,MMW 15,A01,193512,Chang; Edmond Yi-Teh,0,8,28,28
1683693646593,MMW 15,A02,193513,Chang; Edmond Yi-Teh,0,5,28,28
1683693646593,MMW 15,A03,193514,Chang; Edmond Yi-Teh,0,5,28,28
1683693646593,MMW 15,A04,193515,Chang; Edmond Yi-Teh,0,5,28,28
1683693646593,MMW 15,A05,193516,Chang; Edmond Yi-Teh,0,5,28,28
1683693646593,MMW 15,A06,193517,Chang; Edmond Yi-Teh,0,6,28,28
1683693646593,MMW 15,B01,193519,Chang; Edmond Yi-Teh,0,5,28,28
1683693646593,MMW 15,B02,193520,Chang; Edmond Yi-Teh,0,5,28,28
1683693646593,MMW 15,B03,193521,Chang; Edmond Yi-Teh,0,5,28,28
1683693646593,MMW 15,B04,193522,Chang; Edmond Yi-Teh,0,6,28,28
1683693646593,MMW 15,B05,193523,Chang; Edmond Yi-Teh,0,5,28,28
1683693646593,MMW 15,B06,193524,Chang; Edmond Yi-Teh,0,5,28,28
1683693647621,MMW 122,A01,193526,Rahimi; Babak,0,16,28,28
1683693647621,MMW 122,A02,193527,Rahimi; Babak,0,15,28,28
1683693647621,MMW 122,A03,193528,Rahimi; Babak,0,0,0,0
1683693647621,MMW 122,A04,193529,Rahimi; Babak,0,0,0,0
1683693648648,MUS 1A,A01,186663,Staff,1,19,35,34
1683693649675,MUS 4,A01,186715,Staff,0,12,35,35
1683693650702,MUS 5R,A01,186796,Dubnov; Shlomo,0,17,35,35
1683693651724,MUS 6,A01,186798,Staff,1,5,25,24
1683693652751,MUS 7,A01,186830,Staff,11,0,35,24
1683693653778,MUS 8,A01,186930,Staff,0,27,35,35
1683693654808,MUS 15,A01,186932,Staff,0,15,35,35
1683693654808,MUS 15,B01,186934,Staff,1,17,35,34
1683693655832,MUS 80,A00,186935,Staff,0,0,20,20
1683693655832,MUS 80,B00,186936,Staff,24,0,25,1
1683693656856,NANO 11,A00,204702,Lipomi; Darren John,0,0,0,0
1683693657884,NANO 15,A01,204709,Yang; Kesong,0,1,0,0
1683693658910,NANO 114,A00,202069,Jahed Motlagh; Zeinab,2,0,10,8
1683693659933,PHIL 1,A00,186955,Grush; Rick Scott,31,0,40,9
1683693660961,PHIL 10,A01,186973,Grush; Rick Scott,27,0,35,8
1683693660961,PHIL 10,A02,186974,Grush; Rick Scott,33,0,35,2
1683693661990,PHIL 13,A01,186976,Staff,1,0,35,34
1683693661990,PHIL 13,A02,186977,Staff,16,0,35,19
1683693663018,PHIL 14,A01,186979,Staff,31,0,35,4
1683693663018,PHIL 14,A02,186986,Staff,32,0,35,3
1683693664043,PHIL 28,A01,186988,Staff,16,0,30,14
1683693664043,PHIL 28,A02,186989,Staff,1,0,30,29
1683693664043,PHIL 28,A03,186990,Staff,10,0,30,20
1683693664043,PHIL 28,A04,186991,Staff,26,0,30,4
1683693665067,PHIL 120,A00,186997,Staff,23,0,40,17
1683693666092,PHIL 137,A00,187003,Staff,7,0,40,33
1683693667117,PHIL 150,A00,187015,Staff,47,0,70,23
1683693668145,PHIL 167,A00,187021,Lamey; Andy M.,34,0,40,6
1683693669173,PHIL 174,A01,202226,Staff,17,0,20,3
1683693669173,PHIL 174,A02,202235,Staff,20,0,20,0
1683693670196,PHIL 191A,A00,258918,Staff,0,0,1,1
1683693671221,PHYS 1A,A00,187028,Staff,26,0,60,34
1683693672249,PHYS 1AL,001,187036,Staff,3,0,30,27
1683693672249,PHYS 1AL,002,187049,Staff,18,0,30,12
1683693673274,PHYS 1B,A00,187058,Staff,22,0,60,38
1683693674301,PHYS 1BL,001,187064,Staff,0,1,30,30
1683693674301,PHYS 1BL,002,187070,Staff,4,0,30,26
1683693675326,PHYS 1C,A00,187082,Staff,29,0,120,91
1683693676352,PHYS 1CL,001,187088,Staff,0,9,30,30
1683693676352,PHYS 1CL,002,187089,Staff,0,1,30,30
1683693676352,PHYS 1CL,009,262693,Staff,9,0,30,21
1683693677377,PHYS 2B,A01,187097,Staff,55,0,115,60
1683693678407,PHYS 2C,A01,187099,Staff,63,0,115,52
1683693679434,PHYS 2CL,A01,187101,Staff,5,0,28,23
1683693679434,PHYS 2CL,A02,187102,Staff,15,0,28,13
1683693680462,PHYS 2D,A01,187123,Shotwell; Brian,95,0,115,20
1683693681490,PHYS 4B,A01,187133,Grinstein; Benjamin,35,0,50,15
1683693682514,POLI 10,A00,188819,Staff,0,4,50,50
1683693683541,POLI 11,A00,188827,Staff,43,0,50,7
1683693684565,POLI 13R,A00,188828,Staff,0,1,20,20
1683693685591,POLI 27,A01,188830,Elgin; Samuel Zincke,0,2,70,70
1683693686619,POLI 30,A00,188832,Desposato; Scott,30,0,50,20
1683693687644,POLI 102F,A00,188834,Staff,1,0,40,39
1683693688668,POLI 104A,A00,188852,Staff,12,0,30,18
1683693689692,POLI 104I,A00,188853,Staff,0,8,20,20
1683693690718,POLI 110B,A00,188854,Wiens; David,6,0,20,14
1683693691742,POLI 112A,A00,188855,Wiens; David,3,0,30,27
1683693692766,POLI 117R,A00,188856,Forman; Fonna,0,12,20,20
1683693693793,POLI 118,A00,188857,Ingham; Sean,8,0,20,12
1683693694819,POLI 120G,A00,188858,Staff,8,0,30,22
1683693695844,POLI 131CR,A00,188863,Hoston; Germaine,20,0,50,30
1683693696872,POLI 133,A00,188864,Nellis; Gareth Hb,44,0,50,6
1683693697901,POLI 134D,A00,188865,Desposato; Scott,27,0,30,3
1683693698928,POLI 142A,A00,188871,Gartzke; Erik,21,0,50,29
1683693699953,POLI 142K,A00,188874,Staff,38,0,50,12
1683693700978,POLI 143,A00,188940,Gartzke; Erik,16,0,30,14
1683693702002,POLI 153,A00,188943,Staff,2,0,20,18
1683693703031,POLI 160AA,A00,188944,Staff,10,0,40,30
1683693704056,POLI 170A,A00,188945,Staff,10,0,30,20
1683693706103,PSYC 1,A00,188952,Staff,36,0,90,54
1683693707128,PSYC 2,B00,188953,Staff,19,0,35,16
1683693708152,PSYC 6,A00,188970,Staff,47,0,60,13
1683693709180,PSYC 7,A00,188973,Staff,35,0,45,10
1683693710206,PSYC 60,A01,188980,Rickard; Timothy C.,42,0,60,18
1683693711236,PSYC 70,A01,189001,Steiner; Eric Tomas,21,0,45,24
1683693712265,PSYC 100,A00,189005,Lacefield; Katharine I,0,99,120,120
1683693713289,PSYC 102,A00,189008,Staff,7,0,30,23
1683693714314,PSYC 106,B00,189026,Gorman; Michael R.,27,0,60,33
1683693715342,PSYC 114,B01,189033,Winkielman; Piotr,0,31,30,30
1683693716369,PSYC 131,A00,189036,Anagnostaras; Stephan,0,43,60,60
1683693717453,PSYC 136,A00,189041,Lowe; Angela Beth,0,7,25,25
1683693718477,PSYC 137,A00,189057,Winkielman; Piotr,1,37,25,24
1683693719501,PSYC 144,A00,189107,Wixted; John T,0,11,50,50
1683693721547,PSYC 162,A00,189142,Staff,0,9,85,85
1683693722574,PSYC 172,A00,189144,Gorman; Michael R.,0,6,30,30
1683693724628,PSYC 179,A00,189146,Lacefield; Katharine I,0,88,120,120
1683693725656,PSYC 181,A00,189147,Anagnostaras; Stephan,0,44,90,90
1683693726681,PSYC 190R,A00,189148,Barner; David A.,0,23,80,80
1683693727705,PSYC 191,A00,189275,Rickard; Timothy C.,0,11,25,25
1683693728729,PSYC 193,A00,189276,Chapman; Eddie Nathaniel,0,1,0,4
1683693729753,PSYC 193L,A01,189281,Lowe; Angela Beth,8,0,20,12
1683693729753,PSYC 193L,B01,189285,Staff,28,0,35,7
1683693730780,RELI 149,A00,187137,Rahimi; Babak,6,0,40,34
1683693731808,SE 9,A01,187315,Staff,0,2,18,18
1683693732835,SE 101B,A00,187409,Staff,24,0,30,6
1683693733860,SE 110B,A00,187444,Staff,10,0,40,30
1683693734885,SE 130B,A00,187449,Staff,31,0,40,9
1683693735909,SE 150A,A00,187516,Staff,8,0,20,12
1683693736933,SE 154,A00,187528,Staff,29,0,50,21
1683693737960,SIO 3,A01,258171,Staff,35,0,40,5
1683693738984,SIO 10,A00,187144,Cook; Geoffrey W,1,7,75,74
1683693740008,SIO 45,A00,187152,Cook; Geoffrey W,0,7,100,100
1683693741035,SIO 109R,A00,194486,Staff,0,4,20,20
1683693743091,SIO 187,A01,187233,Kacev; David,12,0,40,28
1683693744117,SOCI 1,A01,258656,Thorpe; Charles Robert,28,0,30,2
1683693744117,SOCI 1,A02,258658,Thorpe; Charles Robert,30,0,30,0
1683693744117,SOCI 1,A03,258661,Thorpe; Charles Robert,25,0,25,0
1683693744117,SOCI 1,A04,258666,Thorpe; Charles Robert,22,0,25,3
1683693744117,SOCI 1,A05,258897,Thorpe; Charles Robert,22,0,25,3
1683693744117,SOCI 1,A06,258898,Thorpe; Charles Robert,25,0,25,0
1683693745143,SOCI 30,A01,258903,Pardo Guerra; Juan Pablo,14,0,30,16
1683693746165,SOCI 102,A00,258904,Staff,9,0,25,16
1683693747191,SOCI 106,A00,258905,Staff,19,0,25,6
1683693748214,SOCI 111,A00,258907,Ribas Norris; Janet Vanesa,25,0,30,5
1683693749239,SOCI 121R,A00,258908,Pardo Guerra; Juan Pablo,7,0,30,23
1683693750268,SOCI 126,A01,203330,Staff,14,0,20,6
1683693751295,SOCI 131,A00,258909,Thorpe; Charles Robert,30,0,60,30
1683693752320,SOCI 135,A00,258910,Payne; Christine Anna,0,13,30,30
1683693753349,SOCI 157,A00,258911,Staff,11,0,30,19
1683693754372,SOCI 184,A00,258912,Staff,25,0,30,5
1683693755396,SOCI 188D,A00,258913,Staff,22,0,30,8
1683693756423,SYN 2,001,187529,Staff,9,0,16,7
1683693756423,SYN 2,002,201452,Staff,1,20,16,15
1683693756423,SYN 2,003,201469,Staff,1,0,16,15
1683693757451,SYN 100,A01,187531,Staff,0,9,20,20
1683693757451,SYN 100,B01,201491,Staff,0,10,20,20
1683693758478,TDAC 1,A00,189286,Walsh; Kim C.,3,0,20,17
1683693758478,TDAC 1,B00,189287,Harting; Carla Kelso,10,0,20,10
1683693759504,TDAC 101,A00,189300,Walsh; Kim C.,16,0,20,4
1683693759504,TDAC 101,B00,189301,Harting; Carla Kelso,18,0,20,2
1683693760530,TDAC 102,A00,189304,Basso; Beatrice,14,0,20,6
1683693761556,TDAC 108,A00,189305,Staff,18,0,20,2
1683693762591,TDDE 131,A00,189310,Staff,19,0,20,1
1683693762591,TDDE 131,B00,189314,Staff,19,0,20,1
1683693762591,TDDE 131,C00,189315,Staff,48,0,50,2
1683693762591,TDDE 131,D00,189316,Staff,14,0,15,1
1683693762591,TDDE 131,E00,204841,Staff,20,0,20,0
1683693763618,TDGE 10,A00,189289,Staff,27,0,50,23
1683693763618,TDGE 10,B00,189290,Havis; Allan,0,1,50,50
1683693764647,TDGE 11,A00,189291,Fulton; Julia,0,4,50,50
1683693764647,TDGE 11,B00,189292,Staff,20,0,25,5
1683693764647,TDGE 11,C00,260270,Staff,0,0,0,0
1683693765675,TDGE 25,A00,189294,Staff,1,0,20,19
1683693766703,TDGE 124,A00,189318,Fulton; Julia,1,8,50,49
1683693767732,TDGE 125,A00,189319,Staff,13,0,25,12
1683693767732,TDGE 125,B00,189320,Staff,23,0,25,2
1683693768757,TDGE 127,A00,189322,Havis; Allan,0,0,50,50
1683693769783,TDHT 101,A00,189323,Staff,18,0,25,7
1683693769783,TDHT 101,B00,189324,Staff,25,0,25,0
1683693770806,TDHT 102,A00,189325,Staff,49,0,50,1
1683693771829,TDMV 1,A00,189295,Arcidiacono; Kristin,20,0,30,10
1683693771829,TDMV 1,B00,189296,Caligagan; Maria T.,24,0,30,6
1683693772853,TDMV 2,A00,189297,Sammartano; Tonnie,27,0,30,3
1683693772853,TDMV 2,B00,189299,Arcidiacono; Kristin,23,0,30,7
1683693773881,TDMV 3,A00,204998,Rincon; Alicia,22,0,30,8
1683693774905,TDMV 120,A00,189458,Sammartano; Tonnie,28,0,30,2
1683693775931,TDMV 138,A00,189541,Jun; Grace Shin Hae,20,0,40,20
1683693776960,TDMV 142,A00,189717,Caligagan; Tony,25,0,30,5
1683693776960,TDMV 142,B00,189718,Caligagan; Maria T.,25,0,30,5
1683693777984,TMC 2,A01,187533,Staff,25,0,25,0
1683693777984,TMC 2,A02,187534,Staff,25,0,25,0
1683693779007,USP 1,A01,187536,Kwak; Nancy,0,16,25,25
1683693780031,USP 5,A01,187538,Staff,8,0,25,17
1683693781068,USP 101,A00,199253,Staff,0,4,0,0
1683693782094,USP 124,A00,187562,Boomhower; Matthew Charles,0,0,30,30
1683693783118,USP 138,A00,187582,Staff,19,0,25,6
1683693784163,USP 152,A01,187597,Staff,3,0,25,22
1683693785188,USP 153,A00,187598,Staff,18,0,25,7
1683693786212,USP 168,A00,187607,Kwak; Nancy,2,0,5,3
1683693787238,USP 173,A00,187619,Staff,4,0,25,21
1683693788267,USP 181,A00,187638,Staff,0,4,25,25
1683693789291,VIS 103,A00,187650,Cruz; Edwin Teddy,17,0,75,58
1683693790319,VIS 110D,A00,187669,Staff,13,0,22,9
1683693791343,VIS 127C,A00,187720,Shen; Kuiyi,67,0,146,79
1683693792369,VIS 149,A00,187731,Yoldas; Pinar,2,14,22,20
1683693793393,VIS 151,A01,188091,Staff,22,0,34,12
1683693793393,VIS 151,A02,188092,Staff,11,0,34,23
1683693794419,VIS 160B,A00,188093,Stalbaum; Brett,0,1,10,10
1683693796483,WCWP 10B,A00,201720,Staff,0,0,5,5
1683693796483,WCWP 10B,B00,201722,Staff,0,0,6,6
1683693797508,WCWP 100,A00,201725,Gagnon; Jeffrey C,0,0,2,2
1683693797508,WCWP 100,B00,201727,Staff,0,4,15,15
1683693800601,ANBI 133,A00,258401,Wilder; Linnea Lorene,34,0,40,6
1683693801626,ANBI 140,A00,258395,Hrvoj Mihic; Branka,18,0,25,7
1683693802649,ANSC 120,A00,258402,Bialecki; Jon Anthony,26,0,40,14
1683693803673,ANSC 144,A00,258400,Staff,12,0,40,28
1683693805726,ANSC 166,A00,258396,Parish; Steven Martin,156,0,175,19
1683693806749,ANSC 180,A00,193533,Staff,8,0,20,12
1683693807773,ANSC 188,A00,258397,Jassal; Aftab,34,0,40,6
1683693808797,ANTH 3,A01,258316,Staff,23,0,30,7
1683693809824,ANTH 5,A00,258394,Semendeferi; Ekaterini,16,0,20,4
1683693810852,ANTH 21,A01,258331,Staff,4,0,40,36
1683693811876,ANTH 103,A00,258398,Varma; Saiba,15,0,25,10
1683693812902,AWP 10,001,202034,Staff,0,0,0,0
1683693812902,AWP 10,002,202035,Staff,0,0,0,0
1683693812902,AWP 10,003,202036,Staff,0,0,0,0
1683693812902,AWP 10,004,202037,Staff,0,0,0,0
1683693812902,AWP 10,005,202038,Staff,0,0,0,0
1683693812902,AWP 10,006,202039,Staff,0,0,0,0
1683693812902,AWP 10,007,202040,Staff,0,0,0,0
1683693812902,AWP 10,008,202041,Staff,0,0,0,0
1683693812902,AWP 10,009,202042,Staff,0,0,0,0
1683693812902,AWP 10,010,202043,Staff,0,0,0,0
1683693812902,AWP 10,011,202044,Staff,0,0,0,0
1683693812902,AWP 10,012,202045,Staff,0,0,0,0
1683693812902,AWP 10,013,202046,Staff,0,0,0,0
1683693812902,AWP 10,014,202047,Staff,0,0,0,0
1683693812902,AWP 10,015,202048,Staff,0,0,0,0
1683693812902,AWP 10,016,202049,Staff,0,0,0,0
1683693812902,AWP 10,017,202050,Staff,0,0,0,0
1683693812902,AWP 10,018,202051,Staff,0,0,0,0
1683693812902,AWP 10,019,202052,Staff,0,0,0,0
1683693812902,AWP 10,020,202053,Staff,0,0,0,0
1683693812902,AWP 10,021,202054,Staff,0,0,0,0
1683693812902,AWP 10,022,202055,Staff,0,0,0,0
1683693812902,AWP 10,023,202056,Staff,0,0,0,0
1683693812902,AWP 10,024,202057,Staff,0,0,0,0
1683693812902,AWP 10,025,202058,Staff,0,0,0,0
1683693812902,AWP 10,026,202059,Staff,0,0,0,0
1683693813926,AWP 102,001,202032,Staff,0,0,0,0
1683693813926,AWP 102,002,202033,Staff,0,0,0,0
1683693814953,BENG 100,A01,254234,Taylor Amos; Alyssa C,31,0,40,9
1683693815979,BENG 196,001,270013,Engler; Adam J.,9999,0,9999,0
1683693817009,BICD 100R,A01,202018,Smith; Laurie,0,7,32,32
1683693817009,BICD 100R,A02,202019,Smith; Laurie,0,3,32,32
1683693817009,BICD 100R,A03,202020,Smith; Laurie,0,1,32,32
1683693817009,BICD 100R,A04,202021,Smith; Laurie,6,0,32,26
1683693817009,BICD 100R,A05,202022,Smith; Laurie,10,0,32,22
1683693818034,BICD 136,A01,193242,Gustafson-Brown; Cindy,0,2,32,32
1683693818034,BICD 136,A02,193244,Gustafson-Brown; Cindy,13,0,32,19
1683693819063,BIEB 102,A01,193249,Butler; Shannon Rhey,1,1,32,31
1683693819063,BIEB 102,A02,193251,Butler; Shannon Rhey,0,0,32,32
1683693819063,BIEB 102,A03,193253,Butler; Shannon Rhey,0,0,32,32
1683693819063,BIEB 102,A04,193255,Butler; Shannon Rhey,13,0,32,19
1683693819063,BIEB 102,A05,193265,Butler; Shannon Rhey,25,0,32,7
1683693819063,BIEB 102,A06,193269,Butler; Shannon Rhey,13,0,32,19
1683693821166,BIEB 150,A01,193274,Staff,0,0,32,32
1683693821166,BIEB 150,A02,193285,Staff,24,0,32,8
1683693822196,BIEB 194,A00,193286,Kurle; Carolyn M.,19,0,32,13
1683693823223,BILD 1,A01,192291,Staff,15,0,32,17
1683693823223,BILD 1,A02,192292,Staff,30,0,32,2
1683693823223,BILD 1,B01,192520,Reuther; Keefe,0,1,0,0
1683693823223,BILD 1,B02,192532,Reuther; Keefe,0,1,0,0
1683693824253,BILD 3,A01,192556,Butler; Shannon Rhey,0,0,32,32
1683693824253,BILD 3,A02,192581,Butler; Shannon Rhey,0,1,32,32
1683693824253,BILD 3,A03,192611,Butler; Shannon Rhey,19,0,32,13
1683693824253,BILD 3,A04,192612,Butler; Shannon Rhey,23,0,32,9
1683693824253,BILD 3,A05,192613,Butler; Shannon Rhey,26,0,32,6
1683693824253,BILD 3,A06,192679,Butler; Shannon Rhey,27,0,32,5
1683693824253,BILD 3,A07,192682,Butler; Shannon Rhey,20,0,32,12
1683693825278,BILD 4,A01,192836,Reuther; Keefe,1,0,24,23
1683693825278,BILD 4,A02,193044,Reuther; Keefe,4,0,24,20
1683693826306,BILD 10,A01,193142,Gustafson-Brown; Cindy,29,0,32,3
1683693826306,BILD 10,A02,193149,Gustafson-Brown; Cindy,31,0,32,1
1683693827334,BIMM 100,A01,193301,Staff,0,6,32,32
1683693827334,BIMM 100,A02,193312,Staff,0,7,32,32
1683693827334,BIMM 100,A03,193323,Staff,0,10,32,32
1683693828358,BIMM 101,A01,193329,McDonnell; Lisa Marie,1,4,24,23
1683693828358,BIMM 101,A02,193339,McDonnell; Lisa Marie,1,4,24,23
1683693828358,BIMM 101,B01,193354,McDonnell; Lisa Marie,0,4,24,24
1683693828358,BIMM 101,B02,193357,McDonnell; Lisa Marie,0,3,24,24
1683693829385,BIMM 110,A01,193377,Tat; John,0,11,32,32
1683693829385,BIMM 110,A02,193378,Tat; John,0,11,32,32
1683693830410,BIMM 120,A01,206116,Staff,0,0,32,32
1683693830410,BIMM 120,A02,206117,Staff,7,0,32,25
1683693830410,BIMM 120,A03,206121,Staff,21,0,32,11
1683693831435,BIPN 100,A01,193393,Park; Ji Young,0,15,32,32
1683693831435,BIPN 100,A02,193402,Park; Ji Young,0,14,32,32
1683693831435,BIPN 100,A03,193413,Park; Ji Young,0,14,32,32
1683693831435,BIPN 100,A04,193414,Park; Ji Young,0,13,32,32
1683693832460,BIPN 102,A01,193429,Staff,0,0,32,32
1683693832460,BIPN 102,A02,193438,Staff,18,0,32,14
1683693833487,BIPN 106,A01,193450,Reyes Gonzalez; Catalina,0,2,40,40
1683693834512,BIPN 134,A01,193465,Cooke; James Edward,0,0,32,32
1683693834512,BIPN 134,A02,193474,Cooke; James Edward,25,0,32,7
1683693834512,BIPN 134,A03,193485,Cooke; James Edward,29,0,32,3
1683693834512,BIPN 134,A04,193486,Cooke; James Edward,20,0,32,12
1683693834512,BIPN 134,A05,193491,Cooke; James Edward,31,0,32,1
1683693834512,BIPN 134,A06,193501,Cooke; James Edward,30,0,32,2
1683693834512,BIPN 134,A07,193510,Cooke; James Edward,29,0,32,3
1683693836560,BISP 194,A00,222522,Staff,14,0,32,18
1683693837585,CAT 124,A01,202407,Staff,19,0,25,6
1683693838610,CAT 125,A00,202408,Marchisotto; Jennifer Anne,2,0,20,18
1683693839635,CAT 125R,A00,202409,Smith; Lauryn Alissa,0,11,20,20
1683693839635,CAT 125R,B00,202410,Morales; Celeste Georgianna,0,11,20,20
1683693839635,CAT 125R,C00,202411,Irwin; Matthew Joseph,0,12,20,20
1683693840660,CENG 15,A01,204712,Yang; Kesong,0,1,0,0
1683693841687,CENG 114,A00,202070,Jahed Motlagh; Zeinab,5,0,20,15
1683693842713,CGS 105,A00,185477,Wesling; Megan E.,24,0,40,16
1683693843743,CGS 106,A00,185494,Staff,11,0,22,11
1683693844766,CGS 108,A00,185495,Staff,14,0,20,6
1683693845790,CGS 114,A00,185496,Staff,13,0,18,5
1683693846816,CGS 119,A00,185501,Staff,15,0,20,5
1683693847842,CGS 120,A00,185511,Staff,12,0,20,8
1683693848869,CHEM 4,A01,184675,Bussey; Thomas J,97,0,100,3
1683693849897,CHEM 6A,A01,184677,Staff,32,0,60,28
1683693850925,CHEM 6B,A01,184679,Staff,63,0,100,37
1683693851950,CHEM 6C,A01,184681,Bussey; Thomas J,0,0,50,50
1683693851950,CHEM 6C,A02,184682,Bussey; Thomas J,32,0,50,18
1683693852975,CHEM 40A,A01,184684,Albizati; Kim F.,33,0,100,67
1683693854002,CHEM 40B,A01,184686,Albizati; Kim F.,0,22,100,100
1683693855027,CHEM 41B,A01,184690,Staff,51,0,100,49
1683693856055,COGS 3,A01,184715,Boyle; Mary E. T.,0,27,40,40
1683693857083,COGS 14B,A01,185172,Staff,0,14,38,38
1683693858110,COGS 18,A01,184736,Staff,14,0,80,66
1683693859133,COGS 100,A01,184932,Staff,0,8,73,73
1683693860158,COGS 101A,A01,184935,Staff,0,40,30,30
1683693861181,COGS 101B,A01,184944,Staff,0,2,30,30
1683693862205,COGS 101C,A01,184946,Staff,0,10,30,30
1683693863231,COGS 102A,A01,184951,Johnson; Christine M.,1,0,40,39
1683693864259,COGS 107B,A01,184953,Mooshagian; Eric Frederick,0,52,40,40
1683693865284,COGS 118B,A01,184959,Gupta; Anjum,0,50,40,40
1683693866308,COGS 153,A00,184961,Staff,0,16,30,30
1683693867333,COGS 177,A00,184962,Staff,1,21,30,29
1683693868359,COGS 187A,A01,184969,Boyle; Mary E. T.,0,19,40,40
1683693869384,COMM 10,A01,185174,Staff,0,5,25,25
1683693869384,COMM 10,A02,185189,Staff,0,2,25,25
1683693869384,COMM 10,A03,269821,Staff,0,1,0,0
1683693870411,COMM 100B,A02,185476,Staff,10,0,25,15
1683693870411,COMM 100B,A03,277340,Staff,25,0,25,0
1683693871437,COMM 100C,A01,185314,Staff,1,0,25,24
1683693871437,COMM 100C,A02,185327,Staff,17,0,25,8
1683693872461,COMM 110M,A00,185349,Staff,0,0,40,40
1683693873486,COMM 113T,A00,185352,Staff,25,0,40,15
1683693874510,COMM 114I,A00,185353,Staff,31,0,40,9
1683693875537,COMM 131,A00,185354,Staff,17,0,30,13
1683693876564,CSE 8A,A50,185358,Cao; Yingjun,0,46,10,10
1683693877591,CSE 8B,A01,185362,Staff,0,48,50,50
1683693878615,CSE 11,A01,185416,Cao; Yingjun,0,91,10,10
1683693879642,CSE 20,A01,185445,Briones; Jor-el Thomas Caparas,3,0,25,22
1683693880666,CSE 21,A01,185447,Staff,9,0,50,41
1683693881691,CSE 101,A01,185451,Staff,0,13,50,50
1683693881691,CSE 101,B01,185453,Jones; Miles E,0,14,50,50
1683693883743,CSE 141,A01,185458,Eldon; John,16,0,100,84
1683693884772,CSE 141L,A01,185461,Eldon; John,8,0,100,92
1683693885801,CSE 142,A01,185463,Staff,34,0,60,26
1683693885801,CSE 142,B01,201355,Staff,0,7,60,60
1683693886824,CSE 142L,A01,185470,Staff,34,0,60,26
1683693886824,CSE 142L,B01,201417,Staff,0,6,60,60
1683693887848,CSE 190,A00,201433,Staff,32,0,49,17
1683693888873,DOC 1,A01,259136,Strom; Megan C.,7,0,15,8
1683693888873,DOC 1,A02,259137,Strom; Megan C.,14,0,15,1
1683693888873,DOC 1,A03,259138,Strom; Megan C.,14,0,15,1
1683693888873,DOC 1,A04,259139,Strom; Megan C.,14,0,15,1
1683693889900,DOC 100D,A00,259140,Pass; Natalye Joann,14,0,25,11
1683693890923,DSGN 1,A01,184749,Rill; Bryan,0,26,30,30
1683693891948,DSGN 100,A01,185168,Staff,0,2,25,25
1683693892974,ECE 5,A01,185626,Morris; Karcher William,0,12,0,0
1683693894000,ECE 101,A01,185628,Staff,14,0,70,56
1683693895025,ECE 107,A01,185635,Baghdadchi; Saharnaz,0,0,20,20
1683693895025,ECE 107,A02,185638,Baghdadchi; Saharnaz,1,0,20,19
1683693896049,ECE 148,A01,185647,Silberman; Jack,0,0,16,16
1683693897078,ECON 1,A01,185537,Crane; Meredith Helen,54,0,70,16
1683693898101,ECON 3,A01,185549,Crane; Meredith Helen,30,0,70,40
1683693899125,ECON 4,A01,203354,Anderson; John Charles,0,5,10,10
1683693900149,ECON 100A,A01,185574,Staff,0,5,40,40
1683693901174,ECON 100B,A01,185576,Staff,0,12,50,50
1683693902202,ECON 100C,A01,185589,Newhouse; Herbert S,30,0,70,40
1683693903230,ECON 105,A00,185608,Vespa; Emanuel Ignacio,19,0,35,16
1683693904253,ECON 109,A01,185610,Shishkin; Denis,9,0,35,26
1683693905277,ECON 110A,A01,185612,Staff,8,0,40,32
1683693906299,ECON 120A,A01,185615,Staff,19,0,40,21
1683693907321,ECON 120C,A01,185617,Sun; Yixiao,0,21,70,70
1683693908345,ECON 144,A00,203346,Squires; Dale E,2,0,35,33
1683693909376,ECON 171,A01,203349,Newhouse; Herbert S,0,1,35,35
1683693910400,ECON 173A,A01,185621,Toda; Alexis Akira,21,0,35,14
1683693911425,EDS 25,A01,202413,Staff,0,1,0,0
1683693911425,EDS 25,A02,202414,Staff,0,1,0,0
1683693911425,EDS 25,A03,202415,Staff,0,0,0,0
1683693911425,EDS 25,A04,202416,Staff,0,1,0,0
1683693911425,EDS 25,A05,202439,Staff,0,0,0,0
1683693911425,EDS 25,A06,202440,Staff,0,0,0,0
1683693911425,EDS 25,B01,202631,Staff,0,0,0,0
1683693911425,EDS 25,B02,202632,Staff,0,0,0,0
1683693911425,EDS 25,B03,202639,Staff,0,0,0,0
1683693911425,EDS 25,B04,202640,Staff,0,0,0,0
1683693911425,EDS 25,B05,202643,Staff,0,0,0,0
1683693911425,EDS 25,B06,202644,Staff,0,0,0,0
1683693912450,EDS 38,A01,202659,Black; Alison Michelle,24,0,25,1
1683693913473,EDS 115,A00,202652,Staff,18,0,30,12
1683693914497,EDS 125,A00,202649,Staff,13,0,30,17
1683693915524,EDS 126,A01,203332,Staff,30,0,30,0
1683693916546,EDS 139,A00,202838,Staff,16,0,25,9
1683693917572,EDS 146,A01,202655,Staff,14,0,25,11
1683693918597,ENG 15,A00,185667,Staff,0,1,0,0
1683693918597,ENG 15,B00,185672,Staff,0,0,0,0
1683693918597,ENG 15,C00,185675,Staff,0,0,0,0
1683693918597,ENG 15,D00,185682,Staff,0,0,0,0
1683693918597,ENG 15,E00,185684,Staff,0,0,0,0
1683693919622,ETHN 103,A00,185710,Staff,0,8,35,35
1683693920645,ETHN 103A,A00,199228,Man; Simeon S,0,0,9,9
1683693921668,ETHN 109,A00,185711,Staff,15,0,35,20
1683693922691,ETHN 142,A00,185726,Staff,0,4,30,30
1683693923718,ETHN 163J,A00,199229,Man; Simeon S,5,0,8,3
1683693924814,ETHN 168,A00,185727,Staff,7,0,10,3
1683693925838,ETHN 182,A00,185728,Staff,0,0,35,35
1683693926866,ETHN 183,A00,185737,Staff,9,0,18,9
1683693927891,GLBH 111,A01,209361,Burgos; Jose L.,0,0,0,0
1683693929947,HIEU 104,A00,185792,Staff,14,0,20,6
1683693930974,HIEU 115,A00,185800,Staff,0,0,20,20
1683693932000,HIEU 128,A00,185801,Staff,0,9,20,20
1683693933031,HIEU 147,A00,185802,Staff,15,0,20,5
1683693934057,HIEU 154,A00,185823,Staff,11,0,20,9
1683693935083,HILA 102,A00,185826,Staff,14,0,20,6
1683693936105,HILD 2C,A01,185778,Staff,0,13,20,20
1683693937132,HILD 7B,A01,185780,Kwak; Nancy,0,17,32,32
1683693937132,HILD 7B,A02,185781,Kwak; Nancy,0,18,32,32
1683693938156,HILD 30,A01,185791,Staff,12,0,20,8
1683693939181,HISC 119,A00,185830,Golan; Tal,0,10,20,20
1683693940204,HITO 156GS,A00,185831,Patterson; Patrick H.,0,0,0,23
1683693941232,HIUS 103,A00,185832,Man; Simeon S,0,4,20,20
1683693942260,HIUS 117,A00,185836,Kwak; Nancy,2,0,20,18
1683693943287,HIUS 125,A00,185840,Man; Simeon S,0,2,23,23
1683693944311,HIUS 149,A00,185845,Staff,1,0,20,19
1683693945523,HUM 3,A01,185882,Zavodny; Tatiana Sophia,0,8,50,50
1683693945523,HUM 3,B01,185899,Caldwell; Michael Alan,0,18,50,50
1683693946546,HUM 3GS,A00,185900,Patterson; Patrick H.,0,0,0,23
1683693947574,HUM 4,A01,185938,Zroka; Amy Liane,28,0,50,22
1683693947574,HUM 4,B01,185956,Watkins; Eric,0,6,50,50
1683693947574,HUM 4,B02,202209,Watkins; Eric,0,5,50,50
1683693947574,HUM 4,B03,202210,Watkins; Eric,0,5,50,50
1683693948603,HUM 5,A01,185958,West; Geoffrey Scott,0,0,50,50
1683693948603,HUM 5,A02,202215,West; Geoffrey Scott,0,1,50,50
1683693949626,INTL 190,A00,185959,Gagnon; Jeffrey C,0,0,0,9
1683693949626,INTL 190,B00,185960,Lettieri; Michael Joseph,0,0,0,2
1683693950652,JAPN 180,A00,254509,Staff,5,0,30,25
1683693951677,LATI 10,A01,202853,Kennemore; Amy Michelle,4,0,35,31
1683693951677,LATI 10,A02,202854,Kennemore; Amy Michelle,3,0,35,32
1683693951677,LATI 10,A03,270054,Kennemore; Amy Michelle,30,0,30,0
1683693952705,LATI 180,A00,202855,Kennemore; Amy Michelle,11,0,20,9
1683693953730,LAWS 101,A00,201767,Golan; Tal,0,7,40,40
1683693954755,LIFR 1C,A00,185961,Staff,6,0,20,14
1683693955781,LIFR 1CX,A00,185962,Staff,7,0,20,13
1683693956806,LIFR 1D,A00,185963,Staff,7,0,20,13
1683693957833,LIFR 1DX,A00,185964,Staff,7,0,20,13
1683693958859,LIGN 101,A01,186039,Staff,43,0,50,7
1683693959885,LIGN 165,A00,186040,Staff,15,0,50,35
1683693960909,LTCS 108,A00,186041,Staff,5,0,10,5
1683693961936,LTCS 119,A00,186042,Staff,15,0,20,5
1683693962960,LTCS 130,A00,186043,Wesling; Megan E.,15,0,25,10
1683693965011,LTEA 138,A00,186119,Staff,14,0,40,26
1683693966035,LTEN 124,A00,186148,Staff,5,0,25,20
1683693967062,LTEN 178,A00,186149,Staff,6,0,15,9
1683693968088,LTEN 181,A00,186150,Blanco; John D,34,0,40,6
1683693969115,LTWL 120,A00,186160,Staff,19,0,25,6
1683693970142,LTWL 165,A00,186161,Staff,22,0,25,3
1683693971168,LTWR 100,A00,186162,Staff,0,5,15,15
1683693972192,LTWR 102,A00,186163,Doller; Ben,5,0,15,10
1683693973214,MAE 8,A01,186412,Staff,0,1,0,0
1683693974238,MAE 30B,A00,186445,Bahadori; Mohammad Yousef,81,0,100,19
1683693975264,MAE 40,A00,186592,Bewley; Thomas R,10,0,50,40
1683693976290,MAE 101B,A00,186593,Bahadori; Mohammad Yousef,80,0,100,20
1683693977318,MAE 105,A00,186594,Bandaru; Prabhakar,10,0,50,40
1683693978345,MAE 107,A00,186599,Pham; Hieu Tan,0,7,120,120
1683693979372,MAE 148,A01,186660,Silberman; Jack,3,0,16,13
1683693980394,MATH 10A,A01,188095,Staff,0,6,35,35
1683693981420,MATH 10B,A01,188097,Bowers; Adam R.,0,12,30,30
1683693981420,MATH 10B,A02,188099,Bowers; Adam R.,0,11,30,30
1683693981420,MATH 10B,B01,188104,Bowers; Adam R.,0,10,30,30
1683693981420,MATH 10B,B02,188106,Bowers; Adam R.,1,10,30,29
1683693982446,MATH 10C,A01,188111,Staff,0,20,30,30
1683693982446,MATH 10C,A02,188127,Staff,0,19,30,30
1683693982446,MATH 10C,A03,188131,Staff,0,19,30,30
1683693982446,MATH 10C,B01,188218,Staff,17,0,30,13
1683693982446,MATH 10C,B02,188244,Staff,13,0,30,17
1683693982446,MATH 10C,B03,188277,Staff,14,0,30,16
1683693983472,MATH 18,A01,188344,Bach; Quang Tran,18,0,30,12
1683693983472,MATH 18,A02,188345,Bach; Quang Tran,11,0,30,19
1683693983472,MATH 18,B01,188353,Bach; Quang Tran,11,0,30,19
1683693983472,MATH 18,B02,188354,Bach; Quang Tran,19,0,30,11
1683693984496,MATH 20A,A01,188374,Staff,11,0,35,24
1683693985521,MATH 20B,A01,188382,Ohm; Ko Woon,7,0,30,23
1683693985521,MATH 20B,A02,188383,Ohm; Ko Woon,22,0,30,8
1683693985521,MATH 20B,B01,188385,Ohm; Ko Woon,7,0,30,23
1683693985521,MATH 20B,B02,188392,Ohm; Ko Woon,22,0,30,8
1683693986552,MATH 20C,A01,188394,Harel; Guershon,10,0,30,20
1683693986552,MATH 20C,A02,188395,Harel; Guershon,13,0,30,17
1683693986552,MATH 20C,B01,188404,Harel; Guershon,5,0,30,25
1683693986552,MATH 20C,B02,188405,Harel; Guershon,18,0,30,12
1683693987578,MATH 20D,A01,188414,Hammock; Frances H,0,1,30,30
1683693987578,MATH 20D,A02,188415,Hammock; Frances H,0,1,30,30
1683693987578,MATH 20D,B01,188447,Hammock; Frances H,0,1,30,30
1683693987578,MATH 20D,B02,188486,Hammock; Frances H,2,0,30,28
1683693988603,MATH 20E,A01,188649,Staff,21,0,30,9
1683693988603,MATH 20E,A02,188650,Staff,20,0,30,10
1683693988603,MATH 20E,A03,188673,Staff,0,0,30,30
1683693989628,MATH 102,A01,188675,Staff,0,40,35,35
1683693990654,MATH 103B,A01,188681,Staff,3,0,35,32
1683693990654,MATH 103B,B01,188692,Staff,5,0,35,30
1683693991679,MATH 109,A01,188695,Salehi Golsefidy; Alireza,24,0,35,11
1683693991679,MATH 109,A02,188696,Salehi Golsefidy; Alireza,25,0,35,10
1683693992703,MATH 120A,A01,188698,Eggers; John Dietrich,7,0,35,28
1683693993731,MATH 142B,A01,188736,Ioana; Adrian,1,1,30,29
1683693993731,MATH 142B,A02,188741,Ioana; Adrian,0,1,30,30
1683693993731,MATH 142B,A03,188743,Ioana; Adrian,0,2,30,30
1683693994759,MATH 168A,A01,188790,Staff,0,11,35,35
1683693995797,MATH 170A,A01,188803,Nie; Jiawang,0,2,35,35
1683693995797,MATH 170A,A02,188811,Nie; Jiawang,0,1,35,35
1683693995797,MATH 170A,A03,188814,Nie; Jiawang,0,0,35,35
1683693995797,MATH 170A,A04,188815,Nie; Jiawang,5,0,35,30
1683693996828,MATH 193B,A01,188817,Staff,0,0,35,35
1683693996828,MATH 193B,A02,188818,Staff,6,0,35,29
1683693997853,MGT 4,A01,202857,Anderson; John Charles,59,0,80,21
1683693998878,MGT 12,A00,202858,Lindenberger; Wade Douglas,40,0,90,50
1683693999904,MGT 18,A00,202859,Staff,74,0,90,16
1683694000930,MGT 18GS,A00,202860,McKay; Michael J,13,0,28,15
1683694001957,MGT 45,A00,202861,Pecore; Joseph P.,8,0,90,82
1683694002983,MGT 100,A00,202863,Yavorsky; Daniel Ryan,27,0,90,63
1683694004011,MGT 103,A00,202864,Ehrich; Kristine R,0,19,90,90
1683694005035,MGT 112,A00,202865,Ehrich; Kristine R,15,0,90,75
1683694006060,MGT 121A,A00,202868,Staff,90,20,90,0
1683694007083,MGT 131B,A00,202869,Anderson; John Charles,58,0,90,32
1683694008109,MGT 136,A00,202871,Lindenberger; Wade Douglas,83,0,90,7
1683694009133,MGT 164,A00,202873,Staff,0,67,90,91
1683694010158,MGT 164GS,A00,202874,McKay; Mary A,13,0,28,15
1683694011181,MGT 180,A00,202875,Staff,0,51,90,91
1683694012206,MMW 11R,A01,205019,Herbst; Matthew,0,0,30,30
1683694012206,MMW 11R,A02,205026,Herbst; Matthew,29,0,30,1
1683694013239,MMW 15,A01,193512,Chang; Edmond Yi-Teh,0,8,28,28
1683694013239,MMW 15,A02,193513,Chang; Edmond Yi-Teh,0,5,28,28
1683694013239,MMW 15,A03,193514,Chang; Edmond Yi-Teh,0,5,28,28
1683694013239,MMW 15,A04,193515,Chang; Edmond Yi-Teh,0,5,28,28
1683694013239,MMW 15,A05,193516,Chang; Edmond Yi-Teh,0,5,28,28
1683694013239,MMW 15,A06,193517,Chang; Edmond Yi-Teh,0,6,28,28
1683694013239,MMW 15,B01,193519,Chang; Edmond Yi-Teh,0,5,28,28
1683694013239,MMW 15,B02,193520,Chang; Edmond Yi-Teh,0,5,28,28
1683694013239,MMW 15,B03,193521,Chang; Edmond Yi-Teh,0,5,28,28
1683694013239,MMW 15,B04,193522,Chang; Edmond Yi-Teh,0,6,28,28
1683694013239,MMW 15,B05,193523,Chang; Edmond Yi-Teh,0,5,28,28
1683694013239,MMW 15,B06,193524,Chang; Edmond Yi-Teh,0,5,28,28
1683694014269,MMW 122,A01,193526,Rahimi; Babak,0,16,28,28
1683694014269,MMW 122,A02,193527,Rahimi; Babak,0,15,28,28
1683694014269,MMW 122,A03,193528,Rahimi; Babak,0,0,0,0
1683694014269,MMW 122,A04,193529,Rahimi; Babak,0,0,0,0
1683694015296,MUS 1A,A01,186663,Staff,1,19,35,34
1683694016323,MUS 4,A01,186715,Staff,0,12,35,35
1683694017346,MUS 5R,A01,186796,Dubnov; Shlomo,0,17,35,35
1683694018369,MUS 6,A01,186798,Staff,1,5,25,24
1683694019396,MUS 7,A01,186830,Staff,11,0,35,24
1683694020420,MUS 8,A01,186930,Staff,0,27,35,35
1683694021443,MUS 15,A01,186932,Staff,0,15,35,35
1683694021443,MUS 15,B01,186934,Staff,1,17,35,34
1683694022473,MUS 80,A00,186935,Staff,0,0,20,20
1683694022473,MUS 80,B00,186936,Staff,24,0,25,1
1683694023501,NANO 11,A00,204702,Lipomi; Darren John,0,0,0,0
1683694024531,NANO 15,A01,204709,Yang; Kesong,0,1,0,0
1683694025561,NANO 114,A00,202069,Jahed Motlagh; Zeinab,2,0,10,8
1683694026585,PHIL 1,A00,186955,Grush; Rick Scott,31,0,40,9
1683694027608,PHIL 10,A01,186973,Grush; Rick Scott,27,0,35,8
1683694027608,PHIL 10,A02,186974,Grush; Rick Scott,33,0,35,2
1683694028694,PHIL 13,A01,186976,Staff,1,0,35,34
1683694028694,PHIL 13,A02,186977,Staff,16,0,35,19
1683694029719,PHIL 14,A01,186979,Staff,31,0,35,4
1683694029719,PHIL 14,A02,186986,Staff,32,0,35,3
1683694030747,PHIL 28,A01,186988,Staff,16,0,30,14
1683694030747,PHIL 28,A02,186989,Staff,1,0,30,29
1683694030747,PHIL 28,A03,186990,Staff,10,0,30,20
1683694030747,PHIL 28,A04,186991,Staff,26,0,30,4
1683694031773,PHIL 120,A00,186997,Staff,23,0,40,17
1683694032801,PHIL 137,A00,187003,Staff,7,0,40,33
1683694033825,PHIL 150,A00,187015,Staff,47,0,70,23
1683694034850,PHIL 167,A00,187021,Lamey; Andy M.,34,0,40,6
1683694035877,PHIL 174,A01,202226,Staff,17,0,20,3
1683694035877,PHIL 174,A02,202235,Staff,20,0,20,0
1683694036904,PHIL 191A,A00,258918,Staff,0,0,1,1
1683694037934,PHYS 1A,A00,187028,Staff,26,0,60,34
1683694038962,PHYS 1AL,001,187036,Staff,3,0,30,27
1683694038962,PHYS 1AL,002,187049,Staff,18,0,30,12
1683694039990,PHYS 1B,A00,187058,Staff,22,0,60,38
1683694041019,PHYS 1BL,001,187064,Staff,0,1,30,30
1683694041019,PHYS 1BL,002,187070,Staff,4,0,30,26
1683694042042,PHYS 1C,A00,187082,Staff,29,0,120,91
1683694043068,PHYS 1CL,001,187088,Staff,0,9,30,30
1683694043068,PHYS 1CL,002,187089,Staff,0,1,30,30
1683694043068,PHYS 1CL,009,262693,Staff,9,0,30,21
1683694044096,PHYS 2B,A01,187097,Staff,55,0,115,60
1683694045118,PHYS 2C,A01,187099,Staff,63,0,115,52
1683694046146,PHYS 2CL,A01,187101,Staff,5,0,28,23
1683694046146,PHYS 2CL,A02,187102,Staff,15,0,28,13
1683694047172,PHYS 2D,A01,187123,Shotwell; Brian,95,0,115,20
1683694048201,PHYS 4B,A01,187133,Grinstein; Benjamin,35,0,50,15
1683694049227,POLI 10,A00,188819,Staff,0,4,50,50
1683694050255,POLI 11,A00,188827,Staff,43,0,50,7
1683694051279,POLI 13R,A00,188828,Staff,0,1,20,20
1683694052305,POLI 27,A01,188830,Elgin; Samuel Zincke,0,2,70,70
1683694053328,POLI 30,A00,188832,Desposato; Scott,30,0,50,20
1683694054355,POLI 102F,A00,188834,Staff,1,0,40,39
1683694055383,POLI 104A,A00,188852,Staff,12,0,30,18
1683694056408,POLI 104I,A00,188853,Staff,0,8,20,20
1683694057431,POLI 110B,A00,188854,Wiens; David,6,0,20,14
1683694058456,POLI 112A,A00,188855,Wiens; David,3,0,30,27
1683694059481,POLI 117R,A00,188856,Forman; Fonna,0,12,20,20
1683694060504,POLI 118,A00,188857,Ingham; Sean,8,0,20,12
1683694061532,POLI 120G,A00,188858,Staff,8,0,30,22
1683694062557,POLI 131CR,A00,188863,Hoston; Germaine,20,0,50,30
1683694063582,POLI 133,A00,188864,Nellis; Gareth Hb,44,0,50,6
1683694064606,POLI 134D,A00,188865,Desposato; Scott,27,0,30,3
1683694065631,POLI 142A,A00,188871,Gartzke; Erik,21,0,50,29
1683694066660,POLI 142K,A00,188874,Staff,38,0,50,12
1683694067685,POLI 143,A00,188940,Gartzke; Erik,16,0,30,14
1683694068710,POLI 153,A00,188943,Staff,2,0,20,18
1683694069737,POLI 160AA,A00,188944,Staff,10,0,40,30
1683694070764,POLI 170A,A00,188945,Staff,10,0,30,20
1683694072819,PSYC 1,A00,188952,Staff,36,0,90,54
1683694073845,PSYC 2,B00,188953,Staff,19,0,35,16
1683694074872,PSYC 6,A00,188970,Staff,47,0,60,13
1683694075897,PSYC 7,A00,188973,Staff,35,0,45,10
1683694076921,PSYC 60,A01,188980,Rickard; Timothy C.,42,0,60,18
1683694077945,PSYC 70,A01,189001,Steiner; Eric Tomas,21,0,45,24
1683694078969,PSYC 100,A00,189005,Lacefield; Katharine I,0,99,120,120
1683694079993,PSYC 102,A00,189008,Staff,7,0,30,23
1683694081025,PSYC 106,B00,189026,Gorman; Michael R.,27,0,60,33
1683694082053,PSYC 114,B01,189033,Winkielman; Piotr,0,31,30,30
1683694083075,PSYC 131,A00,189036,Anagnostaras; Stephan,0,43,60,60
1683694084101,PSYC 136,A00,189041,Lowe; Angela Beth,0,7,25,25
1683694085125,PSYC 137,A00,189057,Winkielman; Piotr,1,37,25,24
1683694086152,PSYC 144,A00,189107,Wixted; John T,0,11,50,50
1683694088200,PSYC 162,A00,189142,Staff,0,9,85,85
1683694089225,PSYC 172,A00,189144,Gorman; Michael R.,0,6,30,30
1683694091278,PSYC 179,A00,189146,Lacefield; Katharine I,0,88,120,120
1683694092306,PSYC 181,A00,189147,Anagnostaras; Stephan,0,44,90,90
1683694093333,PSYC 190R,A00,189148,Barner; David A.,0,23,80,80
1683694094358,PSYC 191,A00,189275,Rickard; Timothy C.,0,11,25,25
1683694095382,PSYC 193,A00,189276,Chapman; Eddie Nathaniel,0,1,0,4
1683694096409,PSYC 193L,A01,189281,Lowe; Angela Beth,8,0,20,12
1683694096409,PSYC 193L,B01,189285,Staff,28,0,35,7
1683694097434,RELI 149,A00,187137,Rahimi; Babak,6,0,40,34
1683694098458,SE 9,A01,187315,Staff,0,2,18,18
1683694099485,SE 101B,A00,187409,Staff,24,0,30,6
1683694100508,SE 110B,A00,187444,Staff,10,0,40,30
1683694101535,SE 130B,A00,187449,Staff,31,0,40,9
1683694102560,SE 150A,A00,187516,Staff,8,0,20,12
1683694103587,SE 154,A00,187528,Staff,29,0,50,21
1683694104611,SIO 3,A01,258171,Staff,35,0,40,5
1683694105638,SIO 10,A00,187144,Cook; Geoffrey W,1,7,75,74
1683694106662,SIO 45,A00,187152,Cook; Geoffrey W,0,7,100,100
1683694107686,SIO 109R,A00,194486,Staff,0,4,20,20
1683694109737,SIO 187,A01,187233,Kacev; David,12,0,40,28
1683694110764,SOCI 1,A01,258656,Thorpe; Charles Robert,28,0,30,2
1683694110764,SOCI 1,A02,258658,Thorpe; Charles Robert,30,0,30,0
1683694110764,SOCI 1,A03,258661,Thorpe; Charles Robert,25,0,25,0
1683694110764,SOCI 1,A04,258666,Thorpe; Charles Robert,22,0,25,3
1683694110764,SOCI 1,A05,258897,Thorpe; Charles Robert,22,0,25,3
1683694110764,SOCI 1,A06,258898,Thorpe; Charles Robert,25,0,25,0
1683694111792,SOCI 30,A01,258903,Pardo Guerra; Juan Pablo,14,0,30,16
1683694112821,SOCI 102,A00,258904,Staff,9,0,25,16
1683694113848,SOCI 106,A00,258905,Staff,19,0,25,6
1683694114873,SOCI 111,A00,258907,Ribas Norris; Janet Vanesa,25,0,30,5
1683694115898,SOCI 121R,A00,258908,Pardo Guerra; Juan Pablo,7,0,30,23
1683694116924,SOCI 126,A01,203330,Staff,14,0,20,6
1683694117949,SOCI 131,A00,258909,Thorpe; Charles Robert,30,0,60,30
1683694118973,SOCI 135,A00,258910,Payne; Christine Anna,0,13,30,30
1683694119998,SOCI 157,A00,258911,Staff,11,0,30,19
1683694121022,SOCI 184,A00,258912,Staff,25,0,30,5
1683694122049,SOCI 188D,A00,258913,Staff,22,0,30,8
1683694123075,SYN 2,001,187529,Staff,9,0,16,7
1683694123075,SYN 2,002,201452,Staff,1,20,16,15
1683694123075,SYN 2,003,201469,Staff,1,0,16,15
1683694124101,SYN 100,A01,187531,Staff,0,9,20,20
1683694124101,SYN 100,B01,201491,Staff,0,10,20,20
1683694125126,TDAC 1,A00,189286,Walsh; Kim C.,3,0,20,17
1683694125126,TDAC 1,B00,189287,Harting; Carla Kelso,10,0,20,10
1683694126151,TDAC 101,A00,189300,Walsh; Kim C.,16,0,20,4
1683694126151,TDAC 101,B00,189301,Harting; Carla Kelso,18,0,20,2
1683694127179,TDAC 102,A00,189304,Basso; Beatrice,14,0,20,6
1683694128208,TDAC 108,A00,189305,Staff,18,0,20,2
1683694129236,TDDE 131,A00,189310,Staff,19,0,20,1
1683694129236,TDDE 131,B00,189314,Staff,19,0,20,1
1683694129236,TDDE 131,C00,189315,Staff,48,0,50,2
1683694129236,TDDE 131,D00,189316,Staff,14,0,15,1
1683694129236,TDDE 131,E00,204841,Staff,20,0,20,0
1683694130264,TDGE 10,A00,189289,Staff,27,0,50,23
1683694130264,TDGE 10,B00,189290,Havis; Allan,0,1,50,50
1683694131294,TDGE 11,A00,189291,Fulton; Julia,0,4,50,50
1683694131294,TDGE 11,B00,189292,Staff,20,0,25,5
1683694131294,TDGE 11,C00,260270,Staff,0,0,0,0
1683694132376,TDGE 25,A00,189294,Staff,1,0,20,19
1683694133404,TDGE 124,A00,189318,Fulton; Julia,1,8,50,49
1683694134428,TDGE 125,A00,189319,Staff,13,0,25,12
1683694134428,TDGE 125,B00,189320,Staff,23,0,25,2
1683694135452,TDGE 127,A00,189322,Havis; Allan,0,0,50,50
1683694136476,TDHT 101,A00,189323,Staff,18,0,25,7
1683694136476,TDHT 101,B00,189324,Staff,25,0,25,0
1683694137500,TDHT 102,A00,189325,Staff,49,0,50,1
1683694138525,TDMV 1,A00,189295,Arcidiacono; Kristin,20,0,30,10
1683694138525,TDMV 1,B00,189296,Caligagan; Maria T.,24,0,30,6
1683694139552,TDMV 2,A00,189297,Sammartano; Tonnie,27,0,30,3
1683694139552,TDMV 2,B00,189299,Arcidiacono; Kristin,23,0,30,7
1683694140576,TDMV 3,A00,204998,Rincon; Alicia,22,0,30,8
1683694141600,TDMV 120,A00,189458,Sammartano; Tonnie,28,0,30,2
1683694142625,TDMV 138,A00,189541,Jun; Grace Shin Hae,20,0,40,20
1683694143650,TDMV 142,A00,189717,Caligagan; Tony,25,0,30,5
1683694143650,TDMV 142,B00,189718,Caligagan; Maria T.,25,0,30,5
1683694144677,TMC 2,A01,187533,Staff,25,0,25,0
1683694144677,TMC 2,A02,187534,Staff,25,0,25,0
1683694145701,USP 1,A01,187536,Kwak; Nancy,0,16,25,25
1683694146728,USP 5,A01,187538,Staff,8,0,25,17
1683694147754,USP 101,A00,199253,Staff,0,4,0,0
1683694148778,USP 124,A00,187562,Boomhower; Matthew Charles,0,0,30,30
1683694149804,USP 138,A00,187582,Staff,19,0,25,6
1683694150830,USP 152,A01,187597,Staff,3,0,25,22
1683694151854,USP 153,A00,187598,Staff,18,0,25,7
1683694152878,USP 168,A00,187607,Kwak; Nancy,2,0,5,3
1683694153903,USP 173,A00,187619,Staff,4,0,25,21
1683694154926,USP 181,A00,187638,Staff,0,4,25,25
1683694155953,VIS 103,A00,187650,Cruz; Edwin Teddy,17,0,75,58
1683694156980,VIS 110D,A00,187669,Staff,13,0,22,9
1683694158003,VIS 127C,A00,187720,Shen; Kuiyi,67,0,146,79
1683694159030,VIS 149,A00,187731,Yoldas; Pinar,2,14,22,20
1683694160058,VIS 151,A01,188091,Staff,22,0,34,12
1683694160058,VIS 151,A02,188092,Staff,11,0,34,23
1683694161082,VIS 160B,A00,188093,Stalbaum; Brett,0,1,10,10
1683694163134,WCWP 10B,A00,201720,Staff,0,0,5,5
1683694163134,WCWP 10B,B00,201722,Staff,0,0,6,6
1683694164158,WCWP 100,A00,201725,Gagnon; Jeffrey C,0,0,2,2
1683694164158,WCWP 100,B00,201727,Staff,0,4,15,15
1683694167244,ANBI 133,A00,258401,Wilder; Linnea Lorene,34,0,40,6
1683694168270,ANBI 140,A00,258395,Hrvoj Mihic; Branka,18,0,25,7
1683694169294,ANSC 120,A00,258402,Bialecki; Jon Anthony,26,0,40,14
1683694170320,ANSC 144,A00,258400,Staff,12,0,40,28
1683694172368,ANSC 166,A00,258396,Parish; Steven Martin,156,0,175,19
1683694173392,ANSC 180,A00,193533,Staff,8,0,20,12
1683694174415,ANSC 188,A00,258397,Jassal; Aftab,34,0,40,6
1683694175439,ANTH 3,A01,258316,Staff,23,0,30,7
1683694176466,ANTH 5,A00,258394,Semendeferi; Ekaterini,16,0,20,4
1683694177491,ANTH 21,A01,258331,Staff,4,0,40,36
1683694178513,ANTH 103,A00,258398,Varma; Saiba,15,0,25,10
1683694179546,AWP 10,001,202034,Staff,0,0,0,0
1683694179546,AWP 10,002,202035,Staff,0,0,0,0
1683694179546,AWP 10,003,202036,Staff,0,0,0,0
1683694179546,AWP 10,004,202037,Staff,0,0,0,0
1683694179546,AWP 10,005,202038,Staff,0,0,0,0
1683694179546,AWP 10,006,202039,Staff,0,0,0,0
1683694179546,AWP 10,007,202040,Staff,0,0,0,0
1683694179546,AWP 10,008,202041,Staff,0,0,0,0
1683694179546,AWP 10,009,202042,Staff,0,0,0,0
1683694179546,AWP 10,010,202043,Staff,0,0,0,0
1683694179546,AWP 10,011,202044,Staff,0,0,0,0
1683694179546,AWP 10,012,202045,Staff,0,0,0,0
1683694179546,AWP 10,013,202046,Staff,0,0,0,0
1683694179546,AWP 10,014,202047,Staff,0,0,0,0
1683694179546,AWP 10,015,202048,Staff,0,0,0,0
1683694179546,AWP 10,016,202049,Staff,0,0,0,0
1683694179546,AWP 10,017,202050,Staff,0,0,0,0
1683694179546,AWP 10,018,202051,Staff,0,0,0,0
1683694179546,AWP 10,019,202052,Staff,0,0,0,0
1683694179546,AWP 10,020,202053,Staff,0,0,0,0
1683694179546,AWP 10,021,202054,Staff,0,0,0,0
1683694179546,AWP 10,022,202055,Staff,0,0,0,0
1683694179546,AWP 10,023,202056,Staff,0,0,0,0
1683694179546,AWP 10,024,202057,Staff,0,0,0,0
1683694179546,AWP 10,025,202058,Staff,0,0,0,0
1683694179546,AWP 10,026,202059,Staff,0,0,0,0
1683694180571,AWP 102,001,202032,Staff,0,0,0,0
1683694180571,AWP 102,002,202033,Staff,0,0,0,0
1683694181598,BENG 100,A01,254234,Taylor Amos; Alyssa C,31,0,40,9
1683694182623,BENG 196,001,270013,Engler; Adam J.,9999,0,9999,0
1683694183651,BICD 100R,A01,202018,Smith; Laurie,0,7,32,32
1683694183651,BICD 100R,A02,202019,Smith; Laurie,0,3,32,32
1683694183651,BICD 100R,A03,202020,Smith; Laurie,0,1,32,32
1683694183651,BICD 100R,A04,202021,Smith; Laurie,6,0,32,26
1683694183651,BICD 100R,A05,202022,Smith; Laurie,10,0,32,22
1683694184674,BICD 136,A01,193242,Gustafson-Brown; Cindy,0,2,32,32
1683694184674,BICD 136,A02,193244,Gustafson-Brown; Cindy,13,0,32,19
1683694185700,BIEB 102,A01,193249,Butler; Shannon Rhey,1,1,32,31
1683694185700,BIEB 102,A02,193251,Butler; Shannon Rhey,0,0,32,32
1683694185700,BIEB 102,A03,193253,Butler; Shannon Rhey,0,0,32,32
1683694185700,BIEB 102,A04,193255,Butler; Shannon Rhey,13,0,32,19
1683694185700,BIEB 102,A05,193265,Butler; Shannon Rhey,25,0,32,7
1683694185700,BIEB 102,A06,193269,Butler; Shannon Rhey,13,0,32,19
1683694187751,BIEB 150,A01,193274,Staff,0,0,32,32
1683694187751,BIEB 150,A02,193285,Staff,24,0,32,8
1683694188775,BIEB 194,A00,193286,Kurle; Carolyn M.,19,0,32,13
1683694189804,BILD 1,A01,192291,Staff,15,0,32,17
1683694189804,BILD 1,A02,192292,Staff,30,0,32,2
1683694189804,BILD 1,B01,192520,Reuther; Keefe,0,1,0,0
1683694189804,BILD 1,B02,192532,Reuther; Keefe,0,1,0,0
1683694190833,BILD 3,A01,192556,Butler; Shannon Rhey,0,0,32,32
1683694190833,BILD 3,A02,192581,Butler; Shannon Rhey,0,1,32,32
1683694190833,BILD 3,A03,192611,Butler; Shannon Rhey,19,0,32,13
1683694190833,BILD 3,A04,192612,Butler; Shannon Rhey,23,0,32,9
1683694190833,BILD 3,A05,192613,Butler; Shannon Rhey,26,0,32,6
1683694190833,BILD 3,A06,192679,Butler; Shannon Rhey,27,0,32,5
1683694190833,BILD 3,A07,192682,Butler; Shannon Rhey,20,0,32,12
1683694191857,BILD 4,A01,192836,Reuther; Keefe,1,0,24,23
1683694191857,BILD 4,A02,193044,Reuther; Keefe,4,0,24,20
1683694192886,BILD 10,A01,193142,Gustafson-Brown; Cindy,29,0,32,3
1683694192886,BILD 10,A02,193149,Gustafson-Brown; Cindy,31,0,32,1
1683694193911,BIMM 100,A01,193301,Staff,0,6,32,32
1683694193911,BIMM 100,A02,193312,Staff,0,7,32,32
1683694193911,BIMM 100,A03,193323,Staff,0,10,32,32
1683694194936,BIMM 101,A01,193329,McDonnell; Lisa Marie,1,4,24,23
1683694194936,BIMM 101,A02,193339,McDonnell; Lisa Marie,1,4,24,23
1683694194936,BIMM 101,B01,193354,McDonnell; Lisa Marie,0,4,24,24
1683694194936,BIMM 101,B02,193357,McDonnell; Lisa Marie,0,3,24,24
1683694195964,BIMM 110,A01,193377,Tat; John,0,11,32,32
1683694195964,BIMM 110,A02,193378,Tat; John,0,11,32,32
1683694196991,BIMM 120,A01,206116,Staff,0,0,32,32
1683694196991,BIMM 120,A02,206117,Staff,7,0,32,25
1683694196991,BIMM 120,A03,206121,Staff,21,0,32,11
1683694198021,BIPN 100,A01,193393,Park; Ji Young,0,15,32,32
1683694198021,BIPN 100,A02,193402,Park; Ji Young,0,14,32,32
1683694198021,BIPN 100,A03,193413,Park; Ji Young,0,14,32,32
1683694198021,BIPN 100,A04,193414,Park; Ji Young,0,13,32,32
1683694199043,BIPN 102,A01,193429,Staff,0,0,32,32
1683694199043,BIPN 102,A02,193438,Staff,18,0,32,14
1683694200069,BIPN 106,A01,193450,Reyes Gonzalez; Catalina,0,2,40,40
1683694201097,BIPN 134,A01,193465,Cooke; James Edward,0,0,32,32
1683694201097,BIPN 134,A02,193474,Cooke; James Edward,25,0,32,7
1683694201097,BIPN 134,A03,193485,Cooke; James Edward,29,0,32,3
1683694201097,BIPN 134,A04,193486,Cooke; James Edward,20,0,32,12
1683694201097,BIPN 134,A05,193491,Cooke; James Edward,31,0,32,1
1683694201097,BIPN 134,A06,193501,Cooke; James Edward,30,0,32,2
1683694201097,BIPN 134,A07,193510,Cooke; James Edward,29,0,32,3
1683694203146,BISP 194,A00,222522,Staff,14,0,32,18
1683694204175,CAT 124,A01,202407,Staff,19,0,25,6
1683694205198,CAT 125,A00,202408,Marchisotto; Jennifer Anne,2,0,20,18
1683694206223,CAT 125R,A00,202409,Smith; Lauryn Alissa,0,11,20,20
1683694206223,CAT 125R,B00,202410,Morales; Celeste Georgianna,0,11,20,20
1683694206223,CAT 125R,C00,202411,Irwin; Matthew Joseph,0,12,20,20
1683694207246,CENG 15,A01,204712,Yang; Kesong,0,1,0,0
1683694208271,CENG 114,A00,202070,Jahed Motlagh; Zeinab,5,0,20,15
1683694209298,CGS 105,A00,185477,Wesling; Megan E.,24,0,40,16
1683694210322,CGS 106,A00,185494,Staff,11,0,22,11
1683694211346,CGS 108,A00,185495,Staff,14,0,20,6
1683694212370,CGS 114,A00,185496,Staff,13,0,18,5
1683694213392,CGS 119,A00,185501,Staff,15,0,20,5
1683694214419,CGS 120,A00,185511,Staff,12,0,20,8
1683694215442,CHEM 4,A01,184675,Bussey; Thomas J,97,0,100,3
1683694216466,CHEM 6A,A01,184677,Staff,32,0,60,28
1683694217490,CHEM 6B,A01,184679,Staff,63,0,100,37
1683694218514,CHEM 6C,A01,184681,Bussey; Thomas J,0,0,50,50
1683694218514,CHEM 6C,A02,184682,Bussey; Thomas J,32,0,50,18
1683694219542,CHEM 40A,A01,184684,Albizati; Kim F.,33,0,100,67
1683694220567,CHEM 40B,A01,184686,Albizati; Kim F.,0,22,100,100
1683694221590,CHEM 41B,A01,184690,Staff,51,0,100,49
1683694222617,COGS 3,A01,184715,Boyle; Mary E. T.,0,27,40,40
1683694223642,COGS 14B,A01,185172,Staff,0,14,38,38
1683694224670,COGS 18,A01,184736,Staff,14,0,80,66
1683694225695,COGS 100,A01,184932,Staff,0,8,73,73
1683694226719,COGS 101A,A01,184935,Staff,0,40,30,30
1683694227743,COGS 101B,A01,184944,Staff,0,2,30,30
1683694228767,COGS 101C,A01,184946,Staff,0,10,30,30
1683694229790,COGS 102A,A01,184951,Johnson; Christine M.,1,0,40,39
1683694230818,COGS 107B,A01,184953,Mooshagian; Eric Frederick,0,52,40,40
1683694231841,COGS 118B,A01,184959,Gupta; Anjum,0,50,40,40
1683694232871,COGS 153,A00,184961,Staff,0,16,30,30
1683694233897,COGS 177,A00,184962,Staff,1,21,30,29
1683694234925,COGS 187A,A01,184969,Boyle; Mary E. T.,0,19,40,40
1683694236008,COMM 10,A01,185174,Staff,0,5,25,25
1683694236008,COMM 10,A02,185189,Staff,0,2,25,25
1683694236008,COMM 10,A03,269821,Staff,0,1,0,0
1683694237033,COMM 100B,A02,185476,Staff,10,0,25,15
1683694237033,COMM 100B,A03,277340,Staff,25,0,25,0
1683694238061,COMM 100C,A01,185314,Staff,1,0,25,24
1683694238061,COMM 100C,A02,185327,Staff,17,0,25,8
1683694239085,COMM 110M,A00,185349,Staff,0,0,40,40
1683694240115,COMM 113T,A00,185352,Staff,25,0,40,15
1683694241139,COMM 114I,A00,185353,Staff,31,0,40,9
1683694242162,COMM 131,A00,185354,Staff,17,0,30,13
1683694243185,CSE 8A,A50,185358,Cao; Yingjun,0,46,10,10
1683694244212,CSE 8B,A01,185362,Staff,0,48,50,50
1683694245239,CSE 11,A01,185416,Cao; Yingjun,0,91,10,10
1683694246265,CSE 20,A01,185445,Briones; Jor-el Thomas Caparas,3,0,25,22
1683694247293,CSE 21,A01,185447,Staff,9,0,50,41
1683694248323,CSE 101,A01,185451,Staff,0,13,50,50
1683694248323,CSE 101,B01,185453,Jones; Miles E,0,14,50,50
1683694250372,CSE 141,A01,185458,Eldon; John,16,0,100,84
1683694251397,CSE 141L,A01,185461,Eldon; John,8,0,100,92
1683694252426,CSE 142,A01,185463,Staff,34,0,60,26
1683694252426,CSE 142,B01,201355,Staff,0,7,60,60
1683694253455,CSE 142L,A01,185470,Staff,34,0,60,26
1683694253455,CSE 142L,B01,201417,Staff,0,6,60,60
1683694254483,CSE 190,A00,201433,Staff,32,0,49,17
1683694255511,DOC 1,A01,259136,Strom; Megan C.,7,0,15,8
1683694255511,DOC 1,A02,259137,Strom; Megan C.,14,0,15,1
1683694255511,DOC 1,A03,259138,Strom; Megan C.,14,0,15,1
1683694255511,DOC 1,A04,259139,Strom; Megan C.,14,0,15,1
1683694256538,DOC 100D,A00,259140,Pass; Natalye Joann,14,0,25,11
1683694257566,DSGN 1,A01,184749,Rill; Bryan,0,26,30,30
1683694258593,DSGN 100,A01,185168,Staff,0,2,25,25
1683694259618,ECE 5,A01,185626,Morris; Karcher William,0,12,0,0
1683694260641,ECE 101,A01,185628,Staff,14,0,70,56
1683694261666,ECE 107,A01,185635,Baghdadchi; Saharnaz,0,0,20,20
1683694261666,ECE 107,A02,185638,Baghdadchi; Saharnaz,1,0,20,19
1683694262693,ECE 148,A01,185647,Silberman; Jack,0,0,16,16
1683694263716,ECON 1,A01,185537,Crane; Meredith Helen,54,0,70,16
1683694264739,ECON 3,A01,185549,Crane; Meredith Helen,30,0,70,40
1683694265763,ECON 4,A01,203354,Anderson; John Charles,0,5,10,10
1683694266787,ECON 100A,A01,185574,Staff,0,5,40,40
1683694267815,ECON 100B,A01,185576,Staff,0,12,50,50
1683694268840,ECON 100C,A01,185589,Newhouse; Herbert S,30,0,70,40
1683694269865,ECON 105,A00,185608,Vespa; Emanuel Ignacio,19,0,35,16
1683694270890,ECON 109,A01,185610,Shishkin; Denis,9,0,35,26
1683694271915,ECON 110A,A01,185612,Staff,8,0,40,32
1683694272940,ECON 120A,A01,185615,Staff,19,0,40,21
1683694273964,ECON 120C,A01,185617,Sun; Yixiao,0,21,70,70
1683694274989,ECON 144,A00,203346,Squires; Dale E,2,0,35,33
1683694276014,ECON 171,A01,203349,Newhouse; Herbert S,0,1,35,35
1683694277039,ECON 173A,A01,185621,Toda; Alexis Akira,21,0,35,14
1683694278065,EDS 25,A01,202413,Staff,0,1,0,0
1683694278065,EDS 25,A02,202414,Staff,0,1,0,0
1683694278065,EDS 25,A03,202415,Staff,0,0,0,0
1683694278065,EDS 25,A04,202416,Staff,0,1,0,0
1683694278065,EDS 25,A05,202439,Staff,0,0,0,0
1683694278065,EDS 25,A06,202440,Staff,0,0,0,0
1683694278065,EDS 25,B01,202631,Staff,0,0,0,0
1683694278065,EDS 25,B02,202632,Staff,0,0,0,0
1683694278065,EDS 25,B03,202639,Staff,0,0,0,0
1683694278065,EDS 25,B04,202640,Staff,0,0,0,0
1683694278065,EDS 25,B05,202643,Staff,0,0,0,0
1683694278065,EDS 25,B06,202644,Staff,0,0,0,0
1683694279089,EDS 38,A01,202659,Black; Alison Michelle,24,0,25,1
1683694280119,EDS 115,A00,202652,Staff,18,0,30,12
1683694281146,EDS 125,A00,202649,Staff,13,0,30,17
1683694282171,EDS 126,A01,203332,Staff,30,0,30,0
1683694283195,EDS 139,A00,202838,Staff,16,0,25,9
1683694284218,EDS 146,A01,202655,Staff,14,0,25,11
1683694285244,ENG 15,A00,185667,Staff,0,1,0,0
1683694285244,ENG 15,B00,185672,Staff,0,0,0,0
1683694285244,ENG 15,C00,185675,Staff,0,0,0,0
1683694285244,ENG 15,D00,185682,Staff,0,0,0,0
1683694285244,ENG 15,E00,185684,Staff,0,0,0,0
1683694286268,ETHN 103,A00,185710,Staff,0,8,35,35
1683694287296,ETHN 103A,A00,199228,Man; Simeon S,0,0,9,9
1683694288325,ETHN 109,A00,185711,Staff,15,0,35,20
1683694289351,ETHN 142,A00,185726,Staff,0,4,30,30
1683694290378,ETHN 163J,A00,199229,Man; Simeon S,5,0,8,3
1683694291402,ETHN 168,A00,185727,Staff,7,0,10,3
1683694292427,ETHN 182,A00,185728,Staff,0,0,35,35
1683694293451,ETHN 183,A00,185737,Staff,9,0,18,9
1683694294475,GLBH 111,A01,209361,Burgos; Jose L.,0,0,0,0
1683694296523,HIEU 104,A00,185792,Staff,14,0,20,6
1683694297550,HIEU 115,A00,185800,Staff,0,0,20,20
1683694298575,HIEU 128,A00,185801,Staff,0,9,20,20
1683694299598,HIEU 147,A00,185802,Staff,15,0,20,5
1683694300626,HIEU 154,A00,185823,Staff,11,0,20,9
1683694301654,HILA 102,A00,185826,Staff,14,0,20,6
1683694302681,HILD 2C,A01,185778,Staff,0,13,20,20
1683694303707,HILD 7B,A01,185780,Kwak; Nancy,0,17,32,32
1683694303707,HILD 7B,A02,185781,Kwak; Nancy,0,18,32,32
1683694304735,HILD 30,A01,185791,Staff,12,0,20,8
1683694305758,HISC 119,A00,185830,Golan; Tal,0,10,20,20
1683694306783,HITO 156GS,A00,185831,Patterson; Patrick H.,0,0,0,23
1683694307808,HIUS 103,A00,185832,Man; Simeon S,0,4,20,20
1683694308834,HIUS 117,A00,185836,Kwak; Nancy,2,0,20,18
1683694309863,HIUS 125,A00,185840,Man; Simeon S,0,2,23,23
1683694310890,HIUS 149,A00,185845,Staff,1,0,20,19
1683694311914,HUM 3,A01,185882,Zavodny; Tatiana Sophia,0,8,50,50
1683694311914,HUM 3,B01,185899,Caldwell; Michael Alan,0,18,50,50
1683694312941,HUM 3GS,A00,185900,Patterson; Patrick H.,0,0,0,23
1683694313968,HUM 4,A01,185938,Zroka; Amy Liane,28,0,50,22
1683694313968,HUM 4,B01,185956,Watkins; Eric,0,6,50,50
1683694313968,HUM 4,B02,202209,Watkins; Eric,0,5,50,50
1683694313968,HUM 4,B03,202210,Watkins; Eric,0,5,50,50
1683694314996,HUM 5,A01,185958,West; Geoffrey Scott,0,0,50,50
1683694314996,HUM 5,A02,202215,West; Geoffrey Scott,0,1,50,50
1683694316021,INTL 190,A00,185959,Gagnon; Jeffrey C,0,0,0,9
1683694316021,INTL 190,B00,185960,Lettieri; Michael Joseph,0,0,0,2
1683694317047,JAPN 180,A00,254509,Staff,5,0,30,25
1683694318075,LATI 10,A01,202853,Kennemore; Amy Michelle,4,0,35,31
1683694318075,LATI 10,A02,202854,Kennemore; Amy Michelle,3,0,35,32
1683694318075,LATI 10,A03,270054,Kennemore; Amy Michelle,30,0,30,0
1683694319101,LATI 180,A00,202855,Kennemore; Amy Michelle,11,0,20,9
1683694320126,LAWS 101,A00,201767,Golan; Tal,0,7,40,40
1683694321154,LIFR 1C,A00,185961,Staff,6,0,20,14
1683694322181,LIFR 1CX,A00,185962,Staff,7,0,20,13
1683694323205,LIFR 1D,A00,185963,Staff,7,0,20,13
1683694324231,LIFR 1DX,A00,185964,Staff,7,0,20,13
1683694325256,LIGN 101,A01,186039,Staff,43,0,50,7
1683694326282,LIGN 165,A00,186040,Staff,15,0,50,35
1683694327306,LTCS 108,A00,186041,Staff,5,0,10,5
1683694328330,LTCS 119,A00,186042,Staff,15,0,20,5
1683694329354,LTCS 130,A00,186043,Wesling; Megan E.,15,0,25,10
1683694331404,LTEA 138,A00,186119,Staff,14,0,40,26
1683694332428,LTEN 124,A00,186148,Staff,5,0,25,20
1683694333451,LTEN 178,A00,186149,Staff,6,0,15,9
1683694334476,LTEN 181,A00,186150,Blanco; John D,34,0,40,6
1683694335504,LTWL 120,A00,186160,Staff,19,0,25,6
1683694336530,LTWL 165,A00,186161,Staff,22,0,25,3
1683694337554,LTWR 100,A00,186162,Staff,0,5,15,15
1683694338578,LTWR 102,A00,186163,Doller; Ben,5,0,15,10
1683694339657,MAE 8,A01,186412,Staff,0,1,0,0
1683694340682,MAE 30B,A00,186445,Bahadori; Mohammad Yousef,81,0,100,19
1683694341707,MAE 40,A00,186592,Bewley; Thomas R,10,0,50,40
1683694342733,MAE 101B,A00,186593,Bahadori; Mohammad Yousef,80,0,100,20
1683694343758,MAE 105,A00,186594,Bandaru; Prabhakar,10,0,50,40
1683694344782,MAE 107,A00,186599,Pham; Hieu Tan,0,7,120,120
1683694345809,MAE 148,A01,186660,Silberman; Jack,3,0,16,13
1683694346836,MATH 10A,A01,188095,Staff,0,6,35,35
1683694347861,MATH 10B,A01,188097,Bowers; Adam R.,0,12,30,30
1683694347861,MATH 10B,A02,188099,Bowers; Adam R.,0,11,30,30
1683694347861,MATH 10B,B01,188104,Bowers; Adam R.,0,10,30,30
1683694347861,MATH 10B,B02,188106,Bowers; Adam R.,1,10,30,29
1683694348887,MATH 10C,A01,188111,Staff,0,20,30,30
1683694348887,MATH 10C,A02,188127,Staff,0,19,30,30
1683694348887,MATH 10C,A03,188131,Staff,0,19,30,30
1683694348887,MATH 10C,B01,188218,Staff,17,0,30,13
1683694348887,MATH 10C,B02,188244,Staff,13,0,30,17
1683694348887,MATH 10C,B03,188277,Staff,14,0,30,16
1683694349917,MATH 18,A01,188344,Bach; Quang Tran,18,0,30,12
1683694349917,MATH 18,A02,188345,Bach; Quang Tran,11,0,30,19
1683694349917,MATH 18,B01,188353,Bach; Quang Tran,11,0,30,19
1683694349917,MATH 18,B02,188354,Bach; Quang Tran,19,0,30,11
1683694350944,MATH 20A,A01,188374,Staff,11,0,35,24
1683694351973,MATH 20B,A01,188382,Ohm; Ko Woon,7,0,30,23
1683694351973,MATH 20B,A02,188383,Ohm; Ko Woon,22,0,30,8
1683694351973,MATH 20B,B01,188385,Ohm; Ko Woon,7,0,30,23
1683694351973,MATH 20B,B02,188392,Ohm; Ko Woon,22,0,30,8
1683694353003,MATH 20C,A01,188394,Harel; Guershon,10,0,30,20
1683694353003,MATH 20C,A02,188395,Harel; Guershon,13,0,30,17
1683694353003,MATH 20C,B01,188404,Harel; Guershon,5,0,30,25
1683694353003,MATH 20C,B02,188405,Harel; Guershon,18,0,30,12
1683694354028,MATH 20D,A01,188414,Hammock; Frances H,0,1,30,30
1683694354028,MATH 20D,A02,188415,Hammock; Frances H,0,1,30,30
1683694354028,MATH 20D,B01,188447,Hammock; Frances H,0,1,30,30
1683694354028,MATH 20D,B02,188486,Hammock; Frances H,2,0,30,28
1683694355055,MATH 20E,A01,188649,Staff,21,0,30,9
1683694355055,MATH 20E,A02,188650,Staff,20,0,30,10
1683694355055,MATH 20E,A03,188673,Staff,0,0,30,30
1683694356079,MATH 102,A01,188675,Staff,0,40,35,35
1683694357104,MATH 103B,A01,188681,Staff,3,0,35,32
1683694357104,MATH 103B,B01,188692,Staff,5,0,35,30
1683694358132,MATH 109,A01,188695,Salehi Golsefidy; Alireza,24,0,35,11
1683694358132,MATH 109,A02,188696,Salehi Golsefidy; Alireza,25,0,35,10
1683694359158,MATH 120A,A01,188698,Eggers; John Dietrich,7,0,35,28
1683694360183,MATH 142B,A01,188736,Ioana; Adrian,1,1,30,29
1683694360183,MATH 142B,A02,188741,Ioana; Adrian,0,1,30,30
1683694360183,MATH 142B,A03,188743,Ioana; Adrian,0,2,30,30
1683694361205,MATH 168A,A01,188790,Staff,0,11,35,35
1683694362230,MATH 170A,A01,188803,Nie; Jiawang,0,2,35,35
1683694362230,MATH 170A,A02,188811,Nie; Jiawang,0,1,35,35
1683694362230,MATH 170A,A03,188814,Nie; Jiawang,0,0,35,35
1683694362230,MATH 170A,A04,188815,Nie; Jiawang,5,0,35,30
1683694363253,MATH 193B,A01,188817,Staff,0,0,35,35
1683694363253,MATH 193B,A02,188818,Staff,6,0,35,29
1683694364281,MGT 4,A01,202857,Anderson; John Charles,59,0,80,21
1683694365306,MGT 12,A00,202858,Lindenberger; Wade Douglas,40,0,90,50
1683694366330,MGT 18,A00,202859,Staff,74,0,90,16
1683694367353,MGT 18GS,A00,202860,McKay; Michael J,13,0,28,15
1683694368378,MGT 45,A00,202861,Pecore; Joseph P.,8,0,90,82
1683694369402,MGT 100,A00,202863,Yavorsky; Daniel Ryan,27,0,90,63
1683694370430,MGT 103,A00,202864,Ehrich; Kristine R,0,19,90,90
1683694371455,MGT 112,A00,202865,Ehrich; Kristine R,15,0,90,75
1683694372483,MGT 121A,A00,202868,Staff,90,20,90,0
1683694373508,MGT 131B,A00,202869,Anderson; John Charles,58,0,90,32
1683694374536,MGT 136,A00,202871,Lindenberger; Wade Douglas,83,0,90,7
1683694375561,MGT 164,A00,202873,Staff,0,67,90,91
1683694376586,MGT 164GS,A00,202874,McKay; Mary A,13,0,28,15
1683694377610,MGT 180,A00,202875,Staff,0,51,90,91
1683694378634,MMW 11R,A01,205019,Herbst; Matthew,0,0,30,30
1683694378634,MMW 11R,A02,205026,Herbst; Matthew,29,0,30,1
1683694379662,MMW 15,A01,193512,Chang; Edmond Yi-Teh,0,8,28,28
1683694379662,MMW 15,A02,193513,Chang; Edmond Yi-Teh,0,5,28,28
1683694379662,MMW 15,A03,193514,Chang; Edmond Yi-Teh,0,5,28,28
1683694379662,MMW 15,A04,193515,Chang; Edmond Yi-Teh,0,5,28,28
1683694379662,MMW 15,A05,193516,Chang; Edmond Yi-Teh,0,5,28,28
1683694379662,MMW 15,A06,193517,Chang; Edmond Yi-Teh,0,6,28,28
1683694379662,MMW 15,B01,193519,Chang; Edmond Yi-Teh,0,5,28,28
1683694379662,MMW 15,B02,193520,Chang; Edmond Yi-Teh,0,5,28,28
1683694379662,MMW 15,B03,193521,Chang; Edmond Yi-Teh,0,5,28,28
1683694379662,MMW 15,B04,193522,Chang; Edmond Yi-Teh,0,6,28,28
1683694379662,MMW 15,B05,193523,Chang; Edmond Yi-Teh,0,5,28,28
1683694379662,MMW 15,B06,193524,Chang; Edmond Yi-Teh,0,5,28,28
1683694380686,MMW 122,A01,193526,Rahimi; Babak,0,16,28,28
1683694380686,MMW 122,A02,193527,Rahimi; Babak,0,15,28,28
1683694380686,MMW 122,A03,193528,Rahimi; Babak,0,0,0,0
1683694380686,MMW 122,A04,193529,Rahimi; Babak,0,0,0,0
1683694381710,MUS 1A,A01,186663,Staff,1,19,35,34
1683694382734,MUS 4,A01,186715,Staff,0,12,35,35
1683694383758,MUS 5R,A01,186796,Dubnov; Shlomo,0,17,35,35
1683694384782,MUS 6,A01,186798,Staff,1,5,25,24
1683694385811,MUS 7,A01,186830,Staff,11,0,35,24
1683694386838,MUS 8,A01,186930,Staff,0,27,35,35
1683694387863,MUS 15,A01,186932,Staff,0,15,35,35
1683694387863,MUS 15,B01,186934,Staff,1,17,35,34
1683694388887,MUS 80,A00,186935,Staff,0,0,20,20
1683694388887,MUS 80,B00,186936,Staff,24,0,25,1
1683694389912,NANO 11,A00,204702,Lipomi; Darren John,0,0,0,0
1683694390936,NANO 15,A01,204709,Yang; Kesong,0,1,0,0
1683694391964,NANO 114,A00,202069,Jahed Motlagh; Zeinab,2,0,10,8
1683694392991,PHIL 1,A00,186955,Grush; Rick Scott,31,0,40,9
1683694394019,PHIL 10,A01,186973,Grush; Rick Scott,27,0,35,8
1683694394019,PHIL 10,A02,186974,Grush; Rick Scott,33,0,35,2
1683694395047,PHIL 13,A01,186976,Staff,1,0,35,34
1683694395047,PHIL 13,A02,186977,Staff,16,0,35,19
1683694396090,PHIL 14,A01,186979,Staff,31,0,35,4
1683694396090,PHIL 14,A02,186986,Staff,32,0,35,3
1683694397118,PHIL 28,A01,186988,Staff,16,0,30,14
1683694397118,PHIL 28,A02,186989,Staff,1,0,30,29
1683694397118,PHIL 28,A03,186990,Staff,10,0,30,20
1683694397118,PHIL 28,A04,186991,Staff,26,0,30,4
1683694398142,PHIL 120,A00,186997,Staff,23,0,40,17
1683694399166,PHIL 137,A00,187003,Staff,7,0,40,33
1683694400191,PHIL 150,A00,187015,Staff,47,0,70,23
1683694401217,PHIL 167,A00,187021,Lamey; Andy M.,34,0,40,6
1683694402241,PHIL 174,A01,202226,Staff,17,0,20,3
1683694402241,PHIL 174,A02,202235,Staff,20,0,20,0
1683694403265,PHIL 191A,A00,258918,Staff,0,0,1,1
1683694404293,PHYS 1A,A00,187028,Staff,26,0,60,34
1683694405322,PHYS 1AL,001,187036,Staff,3,0,30,27
1683694405322,PHYS 1AL,002,187049,Staff,18,0,30,12
1683694406347,PHYS 1B,A00,187058,Staff,22,0,60,38
1683694407371,PHYS 1BL,001,187064,Staff,0,1,30,30
1683694407371,PHYS 1BL,002,187070,Staff,4,0,30,26
1683694408398,PHYS 1C,A00,187082,Staff,29,0,120,91
1683694409428,PHYS 1CL,001,187088,Staff,0,9,30,30
1683694409428,PHYS 1CL,002,187089,Staff,0,1,30,30
1683694409428,PHYS 1CL,009,262693,Staff,9,0,30,21
1683694410453,PHYS 2B,A01,187097,Staff,55,0,115,60
1683694411480,PHYS 2C,A01,187099,Staff,63,0,115,52
1683694412507,PHYS 2CL,A01,187101,Staff,5,0,28,23
1683694412507,PHYS 2CL,A02,187102,Staff,15,0,28,13
1683694413534,PHYS 2D,A01,187123,Shotwell; Brian,95,0,115,20
1683694414561,PHYS 4B,A01,187133,Grinstein; Benjamin,35,0,50,15
1683694415586,POLI 10,A00,188819,Staff,0,4,50,50
1683694416610,POLI 11,A00,188827,Staff,43,0,50,7
1683694417635,POLI 13R,A00,188828,Staff,0,1,20,20
1683694418658,POLI 27,A01,188830,Elgin; Samuel Zincke,0,2,70,70
1683694419682,POLI 30,A00,188832,Desposato; Scott,30,0,50,20
1683694420710,POLI 102F,A00,188834,Staff,1,0,40,39
1683694421735,POLI 104A,A00,188852,Staff,12,0,30,18
1683694422759,POLI 104I,A00,188853,Staff,0,8,20,20
1683694423787,POLI 110B,A00,188854,Wiens; David,6,0,20,14
1683694424816,POLI 112A,A00,188855,Wiens; David,3,0,30,27
1683694425839,POLI 117R,A00,188856,Forman; Fonna,0,12,20,20
1683694426863,POLI 118,A00,188857,Ingham; Sean,8,0,20,12
1683694427887,POLI 120G,A00,188858,Staff,8,0,30,22
1683694428918,POLI 131CR,A00,188863,Hoston; Germaine,20,0,50,30
1683694429945,POLI 133,A00,188864,Nellis; Gareth Hb,44,0,50,6
1683694430973,POLI 134D,A00,188865,Desposato; Scott,27,0,30,3
1683694431998,POLI 142A,A00,188871,Gartzke; Erik,21,0,50,29
1683694433021,POLI 142K,A00,188874,Staff,38,0,50,12
1683694434048,POLI 143,A00,188940,Gartzke; Erik,16,0,30,14
1683694435074,POLI 153,A00,188943,Staff,2,0,20,18
1683694436100,POLI 160AA,A00,188944,Staff,10,0,40,30
1683694437124,POLI 170A,A00,188945,Staff,10,0,30,20
1683694439174,PSYC 1,A00,188952,Staff,36,0,90,54
1683694440201,PSYC 2,B00,188953,Staff,19,0,35,16
1683694441227,PSYC 6,A00,188970,Staff,47,0,60,13
1683694442252,PSYC 7,A00,188973,Staff,35,0,45,10
1683694443348,PSYC 60,A01,188980,Rickard; Timothy C.,42,0,60,18
1683694444374,PSYC 70,A01,189001,Steiner; Eric Tomas,21,0,45,24
1683694445399,PSYC 100,A00,189005,Lacefield; Katharine I,0,99,120,120
1683694446423,PSYC 102,A00,189008,Staff,7,0,30,23
1683694447447,PSYC 106,B00,189026,Gorman; Michael R.,27,0,60,33
1683694448471,PSYC 114,B01,189033,Winkielman; Piotr,0,31,30,30
1683694449498,PSYC 131,A00,189036,Anagnostaras; Stephan,0,43,60,60
1683694450523,PSYC 136,A00,189041,Lowe; Angela Beth,0,7,25,25
1683694451550,PSYC 137,A00,189057,Winkielman; Piotr,1,37,25,24
1683694452574,PSYC 144,A00,189107,Wixted; John T,0,11,50,50
1683694454630,PSYC 162,A00,189142,Staff,0,9,85,85
1683694455657,PSYC 172,A00,189144,Gorman; Michael R.,0,6,30,30
1683694457707,PSYC 179,A00,189146,Lacefield; Katharine I,0,88,120,120
1683694458731,PSYC 181,A00,189147,Anagnostaras; Stephan,0,44,90,90
1683694459756,PSYC 190R,A00,189148,Barner; David A.,0,23,80,80
1683694460780,PSYC 191,A00,189275,Rickard; Timothy C.,0,11,25,25
1683694461806,PSYC 193,A00,189276,Chapman; Eddie Nathaniel,0,1,0,4
1683694462830,PSYC 193L,A01,189281,Lowe; Angela Beth,8,0,20,12
1683694462830,PSYC 193L,B01,189285,Staff,28,0,35,7
1683694463858,RELI 149,A00,187137,Rahimi; Babak,6,0,40,34
1683694464881,SE 9,A01,187315,Staff,0,2,18,18
1683694465989,SE 101B,A00,187409,Staff,24,0,30,6
1683694467015,SE 110B,A00,187444,Staff,10,0,40,30
1683694468038,SE 130B,A00,187449,Staff,31,0,40,9
1683694469063,SE 150A,A00,187516,Staff,8,0,20,12
1683694470093,SE 154,A00,187528,Staff,29,0,50,21
1683694471119,SIO 3,A01,258171,Staff,35,0,40,5
1683694472146,SIO 10,A00,187144,Cook; Geoffrey W,1,7,75,74
1683694473177,SIO 45,A00,187152,Cook; Geoffrey W,0,7,100,100
1683694474205,SIO 109R,A00,194486,Staff,0,4,20,20
1683694476256,SIO 187,A01,187233,Kacev; David,12,0,40,28
1683694477280,SOCI 1,A01,258656,Thorpe; Charles Robert,28,0,30,2
1683694477280,SOCI 1,A02,258658,Thorpe; Charles Robert,30,0,30,0
1683694477280,SOCI 1,A03,258661,Thorpe; Charles Robert,25,0,25,0
1683694477280,SOCI 1,A04,258666,Thorpe; Charles Robert,22,0,25,3
1683694477280,SOCI 1,A05,258897,Thorpe; Charles Robert,22,0,25,3
1683694477280,SOCI 1,A06,258898,Thorpe; Charles Robert,25,0,25,0
1683694478304,SOCI 30,A01,258903,Pardo Guerra; Juan Pablo,14,0,30,16
1683694479334,SOCI 102,A00,258904,Staff,9,0,25,16
1683694480358,SOCI 106,A00,258905,Staff,19,0,25,6
1683694481382,SOCI 111,A00,258907,Ribas Norris; Janet Vanesa,25,0,30,5
1683694482407,SOCI 121R,A00,258908,Pardo Guerra; Juan Pablo,7,0,30,23
1683694483430,SOCI 126,A01,203330,Staff,14,0,20,6
1683694484459,SOCI 131,A00,258909,Thorpe; Charles Robert,30,0,60,30
1683694485487,SOCI 135,A00,258910,Payne; Christine Anna,0,13,30,30
1683694486513,SOCI 157,A00,258911,Staff,11,0,30,19
1683694487540,SOCI 184,A00,258912,Staff,25,0,30,5
1683694488566,SOCI 188D,A00,258913,Staff,22,0,30,8
1683694489591,SYN 2,001,187529,Staff,9,0,16,7
1683694489591,SYN 2,002,201452,Staff,1,20,16,15
1683694489591,SYN 2,003,201469,Staff,1,0,16,15
1683694490614,SYN 100,A01,187531,Staff,0,9,20,20
1683694490614,SYN 100,B01,201491,Staff,0,10,20,20
1683694491639,TDAC 1,A00,189286,Walsh; Kim C.,3,0,20,17
1683694491639,TDAC 1,B00,189287,Harting; Carla Kelso,10,0,20,10
1683694492664,TDAC 101,A00,189300,Walsh; Kim C.,16,0,20,4
1683694492664,TDAC 101,B00,189301,Harting; Carla Kelso,18,0,20,2
1683694493687,TDAC 102,A00,189304,Basso; Beatrice,14,0,20,6
1683694494711,TDAC 108,A00,189305,Staff,18,0,20,2
1683694495740,TDDE 131,A00,189310,Staff,19,0,20,1
1683694495740,TDDE 131,B00,189314,Staff,19,0,20,1
1683694495740,TDDE 131,C00,189315,Staff,48,0,50,2
1683694495740,TDDE 131,D00,189316,Staff,14,0,15,1
1683694495740,TDDE 131,E00,204841,Staff,20,0,20,0
1683694496765,TDGE 10,A00,189289,Staff,27,0,50,23
1683694496765,TDGE 10,B00,189290,Havis; Allan,0,1,50,50
1683694497789,TDGE 11,A00,189291,Fulton; Julia,0,4,50,50
1683694497789,TDGE 11,B00,189292,Staff,20,0,25,5
1683694497789,TDGE 11,C00,260270,Staff,0,0,0,0
1683694498813,TDGE 25,A00,189294,Staff,1,0,20,19
1683694499837,TDGE 124,A00,189318,Fulton; Julia,1,8,50,49
1683694500862,TDGE 125,A00,189319,Staff,13,0,25,12
1683694500862,TDGE 125,B00,189320,Staff,23,0,25,2
1683694501896,TDGE 127,A00,189322,Havis; Allan,0,0,50,50
1683694502919,TDHT 101,A00,189323,Staff,18,0,25,7
1683694502919,TDHT 101,B00,189324,Staff,25,0,25,0
1683694503947,TDHT 102,A00,189325,Staff,49,0,50,1
1683694504972,TDMV 1,A00,189295,Arcidiacono; Kristin,20,0,30,10
1683694504972,TDMV 1,B00,189296,Caligagan; Maria T.,24,0,30,6
1683694505995,TDMV 2,A00,189297,Sammartano; Tonnie,27,0,30,3
1683694505995,TDMV 2,B00,189299,Arcidiacono; Kristin,23,0,30,7
1683694507021,TDMV 3,A00,204998,Rincon; Alicia,22,0,30,8
1683694508048,TDMV 120,A00,189458,Sammartano; Tonnie,28,0,30,2
1683694509075,TDMV 138,A00,189541,Jun; Grace Shin Hae,20,0,40,20
1683694510100,TDMV 142,A00,189717,Caligagan; Tony,25,0,30,5
1683694510100,TDMV 142,B00,189718,Caligagan; Maria T.,25,0,30,5
1683694511126,TMC 2,A01,187533,Staff,25,0,25,0
1683694511126,TMC 2,A02,187534,Staff,25,0,25,0
1683694512153,USP 1,A01,187536,Kwak; Nancy,0,16,25,25
1683694513177,USP 5,A01,187538,Staff,8,0,25,17
1683694514201,USP 101,A00,199253,Staff,0,4,0,0
1683694515229,USP 124,A00,187562,Boomhower; Matthew Charles,0,0,30,30
1683694516253,USP 138,A00,187582,Staff,19,0,25,6
1683694517278,USP 152,A01,187597,Staff,3,0,25,22
1683694518305,USP 153,A00,187598,Staff,18,0,25,7
1683694519328,USP 168,A00,187607,Kwak; Nancy,2,0,5,3
1683694520353,USP 173,A00,187619,Staff,4,0,25,21
1683694521377,USP 181,A00,187638,Staff,0,4,25,25
1683694522399,VIS 103,A00,187650,Cruz; Edwin Teddy,17,0,75,58
1683694523423,VIS 110D,A00,187669,Staff,13,0,22,9
1683694524447,VIS 127C,A00,187720,Shen; Kuiyi,67,0,146,79
1683694525470,VIS 149,A00,187731,Yoldas; Pinar,2,14,22,20
1683694526497,VIS 151,A01,188091,Staff,22,0,34,12
1683694526497,VIS 151,A02,188092,Staff,11,0,34,23
1683694527521,VIS 160B,A00,188093,Stalbaum; Brett,0,1,10,10
1683694529574,WCWP 10B,A00,201720,Staff,0,0,5,5
1683694529574,WCWP 10B,B00,201722,Staff,0,0,6,6
1683694530599,WCWP 100,A00,201725,Gagnon; Jeffrey C,0,0,2,2
1683694530599,WCWP 100,B00,201727,Staff,0,4,15,15
1683694533695,ANBI 133,A00,258401,Wilder; Linnea Lorene,34,0,40,6
1683694534721,ANBI 140,A00,258395,Hrvoj Mihic; Branka,18,0,25,7
1683694535749,ANSC 120,A00,258402,Bialecki; Jon Anthony,26,0,40,14
1683694536776,ANSC 144,A00,258400,Staff,12,0,40,28
1683694538829,ANSC 166,A00,258396,Parish; Steven Martin,156,0,175,19
1683694539854,ANSC 180,A00,193533,Staff,8,0,20,12
1683694540884,ANSC 188,A00,258397,Jassal; Aftab,34,0,40,6
1683694541909,ANTH 3,A01,258316,Staff,23,0,30,7
1683694542935,ANTH 5,A00,258394,Semendeferi; Ekaterini,16,0,20,4
1683694543960,ANTH 21,A01,258331,Staff,4,0,40,36
1683694544983,ANTH 103,A00,258398,Varma; Saiba,15,0,25,10
1683694546015,AWP 10,001,202034,Staff,0,0,0,0
1683694546015,AWP 10,002,202035,Staff,0,0,0,0
1683694546015,AWP 10,003,202036,Staff,0,0,0,0
1683694546015,AWP 10,004,202037,Staff,0,0,0,0
1683694546015,AWP 10,005,202038,Staff,0,0,0,0
1683694546015,AWP 10,006,202039,Staff,0,0,0,0
1683694546015,AWP 10,007,202040,Staff,0,0,0,0
1683694546015,AWP 10,008,202041,Staff,0,0,0,0
1683694546015,AWP 10,009,202042,Staff,0,0,0,0
1683694546015,AWP 10,010,202043,Staff,0,0,0,0
1683694546015,AWP 10,011,202044,Staff,0,0,0,0
1683694546015,AWP 10,012,202045,Staff,0,0,0,0
1683694546015,AWP 10,013,202046,Staff,0,0,0,0
1683694546015,AWP 10,014,202047,Staff,0,0,0,0
1683694546015,AWP 10,015,202048,Staff,0,0,0,0
1683694546015,AWP 10,016,202049,Staff,0,0,0,0
1683694546015,AWP 10,017,202050,Staff,0,0,0,0
1683694546015,AWP 10,018,202051,Staff,0,0,0,0
1683694546015,AWP 10,019,202052,Staff,0,0,0,0
1683694546015,AWP 10,020,202053,Staff,0,0,0,0
1683694546015,AWP 10,021,202054,Staff,0,0,0,0
1683694546015,AWP 10,022,202055,Staff,0,0,0,0
1683694546015,AWP 10,023,202056,Staff,0,0,0,0
1683694546015,AWP 10,024,202057,Staff,0,0,0,0
1683694546015,AWP 10,025,202058,Staff,0,0,0,0
1683694546015,AWP 10,026,202059,Staff,0,0,0,0
1683694547114,AWP 102,001,202032,Staff,0,0,0,0
1683694547114,AWP 102,002,202033,Staff,0,0,0,0
1683694548140,BENG 100,A01,254234,Taylor Amos; Alyssa C,31,0,40,9
1683694549163,BENG 196,001,270013,Engler; Adam J.,9999,0,9999,0
1683694550188,BICD 100R,A01,202018,Smith; Laurie,0,7,32,32
1683694550188,BICD 100R,A02,202019,Smith; Laurie,0,3,32,32
1683694550188,BICD 100R,A03,202020,Smith; Laurie,0,1,32,32
1683694550188,BICD 100R,A04,202021,Smith; Laurie,6,0,32,26
1683694550188,BICD 100R,A05,202022,Smith; Laurie,10,0,32,22
1683694551213,BICD 136,A01,193242,Gustafson-Brown; Cindy,0,2,32,32
1683694551213,BICD 136,A02,193244,Gustafson-Brown; Cindy,13,0,32,19
1683694552242,BIEB 102,A01,193249,Butler; Shannon Rhey,1,1,32,31
1683694552242,BIEB 102,A02,193251,Butler; Shannon Rhey,0,0,32,32
1683694552242,BIEB 102,A03,193253,Butler; Shannon Rhey,0,0,32,32
1683694552242,BIEB 102,A04,193255,Butler; Shannon Rhey,13,0,32,19
1683694552242,BIEB 102,A05,193265,Butler; Shannon Rhey,25,0,32,7
1683694552242,BIEB 102,A06,193269,Butler; Shannon Rhey,13,0,32,19
1683694554293,BIEB 150,A01,193274,Staff,0,0,32,32
1683694554293,BIEB 150,A02,193285,Staff,24,0,32,8
1683694555322,BIEB 194,A00,193286,Kurle; Carolyn M.,19,0,32,13
1683694556347,BILD 1,A01,192291,Staff,15,0,32,17
1683694556347,BILD 1,A02,192292,Staff,30,0,32,2
1683694556347,BILD 1,B01,192520,Reuther; Keefe,0,1,0,0
1683694556347,BILD 1,B02,192532,Reuther; Keefe,0,1,0,0
1683694557373,BILD 3,A01,192556,Butler; Shannon Rhey,0,0,32,32
1683694557373,BILD 3,A02,192581,Butler; Shannon Rhey,0,1,32,32
1683694557373,BILD 3,A03,192611,Butler; Shannon Rhey,19,0,32,13
1683694557373,BILD 3,A04,192612,Butler; Shannon Rhey,23,0,32,9
1683694557373,BILD 3,A05,192613,Butler; Shannon Rhey,26,0,32,6
1683694557373,BILD 3,A06,192679,Butler; Shannon Rhey,27,0,32,5
1683694557373,BILD 3,A07,192682,Butler; Shannon Rhey,20,0,32,12
1683694558397,BILD 4,A01,192836,Reuther; Keefe,1,0,24,23
1683694558397,BILD 4,A02,193044,Reuther; Keefe,4,0,24,20
1683694559426,BILD 10,A01,193142,Gustafson-Brown; Cindy,29,0,32,3
1683694559426,BILD 10,A02,193149,Gustafson-Brown; Cindy,31,0,32,1
1683694560454,BIMM 100,A01,193301,Staff,0,6,32,32
1683694560454,BIMM 100,A02,193312,Staff,0,7,32,32
1683694560454,BIMM 100,A03,193323,Staff,0,10,32,32
1683694561484,BIMM 101,A01,193329,McDonnell; Lisa Marie,1,4,24,23
1683694561484,BIMM 101,A02,193339,McDonnell; Lisa Marie,1,4,24,23
1683694561484,BIMM 101,B01,193354,McDonnell; Lisa Marie,0,4,24,24
1683694561484,BIMM 101,B02,193357,McDonnell; Lisa Marie,0,3,24,24
1683694562513,BIMM 110,A01,193377,Tat; John,0,11,32,32
1683694562513,BIMM 110,A02,193378,Tat; John,0,11,32,32
1683694563540,BIMM 120,A01,206116,Staff,0,0,32,32
1683694563540,BIMM 120,A02,206117,Staff,7,0,32,25
1683694563540,BIMM 120,A03,206121,Staff,21,0,32,11
1683694564565,BIPN 100,A01,193393,Park; Ji Young,0,15,32,32
1683694564565,BIPN 100,A02,193402,Park; Ji Young,0,14,32,32
1683694564565,BIPN 100,A03,193413,Park; Ji Young,0,14,32,32
1683694564565,BIPN 100,A04,193414,Park; Ji Young,0,13,32,32
1683694565590,BIPN 102,A01,193429,Staff,0,0,32,32
1683694565590,BIPN 102,A02,193438,Staff,18,0,32,14
1683694566615,BIPN 106,A01,193450,Reyes Gonzalez; Catalina,0,2,40,40
1683694567645,BIPN 134,A01,193465,Cooke; James Edward,0,0,32,32
1683694567645,BIPN 134,A02,193474,Cooke; James Edward,25,0,32,7
1683694567645,BIPN 134,A03,193485,Cooke; James Edward,29,0,32,3
1683694567645,BIPN 134,A04,193486,Cooke; James Edward,20,0,32,12
1683694567645,BIPN 134,A05,193491,Cooke; James Edward,31,0,32,1
1683694567645,BIPN 134,A06,193501,Cooke; James Edward,30,0,32,2
1683694567645,BIPN 134,A07,193510,Cooke; James Edward,29,0,32,3
1683694569692,BISP 194,A00,222522,Staff,14,0,32,18
1683694570720,CAT 124,A01,202407,Staff,19,0,25,6
1683694571745,CAT 125,A00,202408,Marchisotto; Jennifer Anne,2,0,20,18
1683694572780,CAT 125R,A00,202409,Smith; Lauryn Alissa,0,11,20,20
1683694572780,CAT 125R,B00,202410,Morales; Celeste Georgianna,0,11,20,20
1683694572780,CAT 125R,C00,202411,Irwin; Matthew Joseph,0,12,20,20
1683694573814,CENG 15,A01,204712,Yang; Kesong,0,1,0,0
1683694574839,CENG 114,A00,202070,Jahed Motlagh; Zeinab,5,0,20,15
1683694575863,CGS 105,A00,185477,Wesling; Megan E.,24,0,40,16
1683694576890,CGS 106,A00,185494,Staff,11,0,22,11
1683694577917,CGS 108,A00,185495,Staff,14,0,20,6
1683694578945,CGS 114,A00,185496,Staff,13,0,18,5
1683694579974,CGS 119,A00,185501,Staff,15,0,20,5
1683694580999,CGS 120,A00,185511,Staff,12,0,20,8
1683694582025,CHEM 4,A01,184675,Bussey; Thomas J,97,0,100,3
1683694583051,CHEM 6A,A01,184677,Staff,32,0,60,28
1683694584074,CHEM 6B,A01,184679,Staff,63,0,100,37
1683694585099,CHEM 6C,A01,184681,Bussey; Thomas J,0,0,50,50
1683694585099,CHEM 6C,A02,184682,Bussey; Thomas J,32,0,50,18
1683694586124,CHEM 40A,A01,184684,Albizati; Kim F.,33,0,100,67
1683694587149,CHEM 40B,A01,184686,Albizati; Kim F.,0,22,100,100
1683694588175,CHEM 41B,A01,184690,Staff,51,0,100,49
1683694589202,COGS 3,A01,184715,Boyle; Mary E. T.,0,27,40,40
1683694590230,COGS 14B,A01,185172,Staff,0,14,38,38
1683694591255,COGS 18,A01,184736,Staff,14,0,80,66
1683694592282,COGS 100,A01,184932,Staff,0,8,73,73
1683694593307,COGS 101A,A01,184935,Staff,0,40,30,30
1683694594335,COGS 101B,A01,184944,Staff,0,2,30,30
1683694595361,COGS 101C,A01,184946,Staff,0,10,30,30
1683694596386,COGS 102A,A01,184951,Johnson; Christine M.,1,0,40,39
1683694597410,COGS 107B,A01,184953,Mooshagian; Eric Frederick,0,52,40,40
1683694598435,COGS 118B,A01,184959,Gupta; Anjum,0,50,40,40
1683694599460,COGS 153,A00,184961,Staff,0,16,30,30
1683694600482,COGS 177,A00,184962,Staff,1,21,30,29
1683694601506,COGS 187A,A01,184969,Boyle; Mary E. T.,0,19,40,40
1683694602535,COMM 10,A01,185174,Staff,0,5,25,25
1683694602535,COMM 10,A02,185189,Staff,0,2,25,25
1683694602535,COMM 10,A03,269821,Staff,0,1,0,0
1683694603559,COMM 100B,A02,185476,Staff,10,0,25,15
1683694603559,COMM 100B,A03,277340,Staff,25,0,25,0
1683694604583,COMM 100C,A01,185314,Staff,2,0,25,23
1683694604583,COMM 100C,A02,185327,Staff,17,0,25,8
1683694605610,COMM 110M,A00,185349,Staff,0,0,40,40
1683694606637,COMM 113T,A00,185352,Staff,25,0,40,15
1683694607664,COMM 114I,A00,185353,Staff,31,0,40,9
1683694608691,COMM 131,A00,185354,Staff,17,0,30,13
1683694609721,CSE 8A,A50,185358,Cao; Yingjun,0,46,10,10
1683694610746,CSE 8B,A01,185362,Staff,0,48,50,50
1683694611774,CSE 11,A01,185416,Cao; Yingjun,0,91,10,10
1683694612798,CSE 20,A01,185445,Briones; Jor-el Thomas Caparas,3,0,25,22
1683694613827,CSE 21,A01,185447,Staff,9,0,50,41
1683694614858,CSE 101,A01,185451,Staff,0,13,50,50
1683694614858,CSE 101,B01,185453,Jones; Miles E,0,14,50,50
1683694616906,CSE 141,A01,185458,Eldon; John,16,0,100,84
1683694617931,CSE 141L,A01,185461,Eldon; John,8,0,100,92
1683694618959,CSE 142,A01,185463,Staff,34,0,60,26
1683694618959,CSE 142,B01,201355,Staff,0,7,60,60
1683694619983,CSE 142L,A01,185470,Staff,34,0,60,26
1683694619983,CSE 142L,B01,201417,Staff,0,6,60,60
1683694621007,CSE 190,A00,201433,Staff,32,0,49,17
1683694622035,DOC 1,A01,259136,Strom; Megan C.,7,0,15,8
1683694622035,DOC 1,A02,259137,Strom; Megan C.,14,0,15,1
1683694622035,DOC 1,A03,259138,Strom; Megan C.,14,0,15,1
1683694622035,DOC 1,A04,259139,Strom; Megan C.,14,0,15,1
1683694623062,DOC 100D,A00,259140,Pass; Natalye Joann,14,0,25,11
1683694624085,DSGN 1,A01,184749,Rill; Bryan,0,26,30,30
1683694625109,DSGN 100,A01,185168,Staff,0,2,25,25
1683694626133,ECE 5,A01,185626,Morris; Karcher William,0,12,0,0
1683694627160,ECE 101,A01,185628,Staff,14,0,70,56
1683694628186,ECE 107,A01,185635,Baghdadchi; Saharnaz,0,0,20,20
1683694628186,ECE 107,A02,185638,Baghdadchi; Saharnaz,1,0,20,19
1683694629214,ECE 148,A01,185647,Silberman; Jack,0,0,16,16
1683694630240,ECON 1,A01,185537,Crane; Meredith Helen,54,0,70,16
1683694631264,ECON 3,A01,185549,Crane; Meredith Helen,30,0,70,40
1683694632291,ECON 4,A01,203354,Anderson; John Charles,0,5,10,10
1683694633320,ECON 100A,A01,185574,Staff,0,5,40,40
1683694634343,ECON 100B,A01,185576,Staff,0,12,50,50
1683694635371,ECON 100C,A01,185589,Newhouse; Herbert S,30,0,70,40
1683694636395,ECON 105,A00,185608,Vespa; Emanuel Ignacio,19,0,35,16
1683694637425,ECON 109,A01,185610,Shishkin; Denis,9,0,35,26
1683694638449,ECON 110A,A01,185612,Staff,8,0,40,32
1683694639473,ECON 120A,A01,185615,Staff,19,0,40,21
1683694640501,ECON 120C,A01,185617,Sun; Yixiao,0,21,70,70
1683694641526,ECON 144,A00,203346,Squires; Dale E,2,0,35,33
1683694642554,ECON 171,A01,203349,Newhouse; Herbert S,0,1,35,35
1683694643579,ECON 173A,A01,185621,Toda; Alexis Akira,21,0,35,14
1683694644605,EDS 25,A01,202413,Staff,0,1,0,0
1683694644605,EDS 25,A02,202414,Staff,0,1,0,0
1683694644605,EDS 25,A03,202415,Staff,0,0,0,0
1683694644605,EDS 25,A04,202416,Staff,0,1,0,0
1683694644605,EDS 25,A05,202439,Staff,0,0,0,0
1683694644605,EDS 25,A06,202440,Staff,0,0,0,0
1683694644605,EDS 25,B01,202631,Staff,0,0,0,0
1683694644605,EDS 25,B02,202632,Staff,0,0,0,0
1683694644605,EDS 25,B03,202639,Staff,0,0,0,0
1683694644605,EDS 25,B04,202640,Staff,0,0,0,0
1683694644605,EDS 25,B05,202643,Staff,0,0,0,0
1683694644605,EDS 25,B06,202644,Staff,0,0,0,0
1683694645630,EDS 38,A01,202659,Black; Alison Michelle,24,0,25,1
1683694646655,EDS 115,A00,202652,Staff,18,0,30,12
1683694647680,EDS 125,A00,202649,Staff,13,0,30,17
1683694648706,EDS 126,A01,203332,Staff,30,0,30,0
1683694649729,EDS 139,A00,202838,Staff,16,0,25,9
1683694650813,EDS 146,A01,202655,Staff,14,0,25,11
1683694651839,ENG 15,A00,185667,Staff,0,1,0,0
1683694651839,ENG 15,B00,185672,Staff,0,0,0,0
1683694651839,ENG 15,C00,185675,Staff,0,0,0,0
1683694651839,ENG 15,D00,185682,Staff,0,0,0,0
1683694651839,ENG 15,E00,185684,Staff,0,0,0,0
1683694652862,ETHN 103,A00,185710,Staff,0,8,35,35
1683694653889,ETHN 103A,A00,199228,Man; Simeon S,0,0,9,9
1683694654916,ETHN 109,A00,185711,Staff,15,0,35,20
1683694655941,ETHN 142,A00,185726,Staff,0,4,30,30
1683694656969,ETHN 163J,A00,199229,Man; Simeon S,5,0,8,3
1683694657992,ETHN 168,A00,185727,Staff,7,0,10,3
1683694659019,ETHN 182,A00,185728,Staff,0,0,35,35
1683694660046,ETHN 183,A00,185737,Staff,9,0,18,9
1683694661073,GLBH 111,A01,209361,Burgos; Jose L.,0,0,0,0
1683694663126,HIEU 104,A00,185792,Staff,14,0,20,6
1683694664153,HIEU 115,A00,185800,Staff,0,0,20,20
1683694665178,HIEU 128,A00,185801,Staff,0,9,20,20
1683694666208,HIEU 147,A00,185802,Staff,15,0,20,5
1683694667232,HIEU 154,A00,185823,Staff,11,0,20,9
1683694668256,HILA 102,A00,185826,Staff,14,0,20,6
1683694669280,HILD 2C,A01,185778,Staff,0,13,20,20
1683694670307,HILD 7B,A01,185780,Kwak; Nancy,0,17,32,32
1683694670307,HILD 7B,A02,185781,Kwak; Nancy,0,18,32,32
1683694671330,HILD 30,A01,185791,Staff,12,0,20,8
1683694672357,HISC 119,A00,185830,Golan; Tal,0,10,20,20
1683694673383,HITO 156GS,A00,185831,Patterson; Patrick H.,0,0,0,23
1683694674407,HIUS 103,A00,185832,Man; Simeon S,0,4,20,20
1683694675434,HIUS 117,A00,185836,Kwak; Nancy,2,0,20,18
1683694676461,HIUS 125,A00,185840,Man; Simeon S,0,2,23,23
1683694677486,HIUS 149,A00,185845,Staff,1,0,20,19
1683694678515,HUM 3,A01,185882,Zavodny; Tatiana Sophia,0,8,50,50
1683694678515,HUM 3,B01,185899,Caldwell; Michael Alan,0,18,50,50
1683694679539,HUM 3GS,A00,185900,Patterson; Patrick H.,0,0,0,23
1683694680564,HUM 4,A01,185938,Zroka; Amy Liane,28,0,50,22
1683694680564,HUM 4,B01,185956,Watkins; Eric,0,6,50,50
1683694680564,HUM 4,B02,202209,Watkins; Eric,0,5,50,50
1683694680564,HUM 4,B03,202210,Watkins; Eric,0,5,50,50
1683694681589,HUM 5,A01,185958,West; Geoffrey Scott,0,0,50,50
1683694681589,HUM 5,A02,202215,West; Geoffrey Scott,0,1,50,50
1683694682614,INTL 190,A00,185959,Gagnon; Jeffrey C,0,0,0,9
1683694682614,INTL 190,B00,185960,Lettieri; Michael Joseph,0,0,0,2
1683694683638,JAPN 180,A00,254509,Staff,5,0,30,25
1683694684663,LATI 10,A01,202853,Kennemore; Amy Michelle,4,0,35,31
1683694684663,LATI 10,A02,202854,Kennemore; Amy Michelle,3,0,35,32
1683694684663,LATI 10,A03,270054,Kennemore; Amy Michelle,30,0,30,0
1683694685691,LATI 180,A00,202855,Kennemore; Amy Michelle,11,0,20,9
1683694686718,LAWS 101,A00,201767,Golan; Tal,0,7,40,40
1683694687746,LIFR 1C,A00,185961,Staff,6,0,20,14
1683694688773,LIFR 1CX,A00,185962,Staff,7,0,20,13
1683694689797,LIFR 1D,A00,185963,Staff,7,0,20,13
1683694690820,LIFR 1DX,A00,185964,Staff,7,0,20,13
1683694691845,LIGN 101,A01,186039,Staff,43,0,50,7
1683694692872,LIGN 165,A00,186040,Staff,15,0,50,35
1683694693899,LTCS 108,A00,186041,Staff,5,0,10,5
1683694694921,LTCS 119,A00,186042,Staff,15,0,20,5
1683694695948,LTCS 130,A00,186043,Wesling; Megan E.,15,0,25,10
1683694698000,LTEA 138,A00,186119,Staff,14,0,40,26
1683694699024,LTEN 124,A00,186148,Staff,5,0,25,20
1683694700048,LTEN 178,A00,186149,Staff,6,0,15,9
1683694701073,LTEN 181,A00,186150,Blanco; John D,34,0,40,6
1683694702100,LTWL 120,A00,186160,Staff,19,0,25,6
1683694703124,LTWL 165,A00,186161,Staff,22,0,25,3
1683694704149,LTWR 100,A00,186162,Staff,0,5,15,15
1683694705177,LTWR 102,A00,186163,Doller; Ben,5,0,15,10
1683694706202,MAE 8,A01,186412,Staff,0,1,0,0
1683694707230,MAE 30B,A00,186445,Bahadori; Mohammad Yousef,81,0,100,19
1683694708252,MAE 40,A00,186592,Bewley; Thomas R,10,0,50,40
1683694709276,MAE 101B,A00,186593,Bahadori; Mohammad Yousef,80,0,100,20
1683694710301,MAE 105,A00,186594,Bandaru; Prabhakar,10,0,50,40
1683694711324,MAE 107,A00,186599,Pham; Hieu Tan,0,7,120,120
1683694712352,MAE 148,A01,186660,Silberman; Jack,3,0,16,13
1683694713378,MATH 10A,A01,188095,Staff,0,6,35,35
1683694714406,MATH 10B,A01,188097,Bowers; Adam R.,0,12,30,30
1683694714406,MATH 10B,A02,188099,Bowers; Adam R.,0,11,30,30
1683694714406,MATH 10B,B01,188104,Bowers; Adam R.,0,10,30,30
1683694714406,MATH 10B,B02,188106,Bowers; Adam R.,1,10,30,29
1683694715431,MATH 10C,A01,188111,Staff,0,20,30,30
1683694715431,MATH 10C,A02,188127,Staff,0,19,30,30
1683694715431,MATH 10C,A03,188131,Staff,0,19,30,30
1683694715431,MATH 10C,B01,188218,Staff,17,0,30,13
1683694715431,MATH 10C,B02,188244,Staff,13,0,30,17
1683694715431,MATH 10C,B03,188277,Staff,14,0,30,16
1683694716456,MATH 18,A01,188344,Bach; Quang Tran,18,0,30,12
1683694716456,MATH 18,A02,188345,Bach; Quang Tran,11,0,30,19
1683694716456,MATH 18,B01,188353,Bach; Quang Tran,11,0,30,19
1683694716456,MATH 18,B02,188354,Bach; Quang Tran,19,0,30,11
1683694717484,MATH 20A,A01,188374,Staff,11,0,35,24
1683694718513,MATH 20B,A01,188382,Ohm; Ko Woon,7,0,30,23
1683694718513,MATH 20B,A02,188383,Ohm; Ko Woon,22,0,30,8
1683694718513,MATH 20B,B01,188385,Ohm; Ko Woon,7,0,30,23
1683694718513,MATH 20B,B02,188392,Ohm; Ko Woon,22,0,30,8
1683694719541,MATH 20C,A01,188394,Harel; Guershon,10,0,30,20
1683694719541,MATH 20C,A02,188395,Harel; Guershon,13,0,30,17
1683694719541,MATH 20C,B01,188404,Harel; Guershon,5,0,30,25
1683694719541,MATH 20C,B02,188405,Harel; Guershon,18,0,30,12
1683694720570,MATH 20D,A01,188414,Hammock; Frances H,0,1,30,30
1683694720570,MATH 20D,A02,188415,Hammock; Frances H,0,1,30,30
1683694720570,MATH 20D,B01,188447,Hammock; Frances H,0,1,30,30
1683694720570,MATH 20D,B02,188486,Hammock; Frances H,2,0,30,28
1683694721596,MATH 20E,A01,188649,Staff,21,0,30,9
1683694721596,MATH 20E,A02,188650,Staff,20,0,30,10
1683694721596,MATH 20E,A03,188673,Staff,0,0,30,30
1683694722623,MATH 102,A01,188675,Staff,0,40,35,35
1683694723649,MATH 103B,A01,188681,Staff,3,0,35,32
1683694723649,MATH 103B,B01,188692,Staff,5,0,35,30
1683694724674,MATH 109,A01,188695,Salehi Golsefidy; Alireza,24,0,35,11
1683694724674,MATH 109,A02,188696,Salehi Golsefidy; Alireza,25,0,35,10
1683694725701,MATH 120A,A01,188698,Eggers; John Dietrich,7,0,35,28
1683694726731,MATH 142B,A01,188736,Ioana; Adrian,1,1,30,29
1683694726731,MATH 142B,A02,188741,Ioana; Adrian,0,1,30,30
1683694726731,MATH 142B,A03,188743,Ioana; Adrian,0,2,30,30
1683694727759,MATH 168A,A01,188790,Staff,0,11,35,35
1683694728784,MATH 170A,A01,188803,Nie; Jiawang,0,2,35,35
1683694728784,MATH 170A,A02,188811,Nie; Jiawang,0,1,35,35
1683694728784,MATH 170A,A03,188814,Nie; Jiawang,0,0,35,35
1683694728784,MATH 170A,A04,188815,Nie; Jiawang,5,0,35,30
1683694729808,MATH 193B,A01,188817,Staff,0,0,35,35
1683694729808,MATH 193B,A02,188818,Staff,6,0,35,29
1683694730832,MGT 4,A01,202857,Anderson; John Charles,59,0,80,21
1683694731857,MGT 12,A00,202858,Lindenberger; Wade Douglas,40,0,90,50
1683694732882,MGT 18,A00,202859,Staff,74,0,90,16
1683694733906,MGT 18GS,A00,202860,McKay; Michael J,13,0,28,15
1683694734930,MGT 45,A00,202861,Pecore; Joseph P.,8,0,90,82
1683694735953,MGT 100,A00,202863,Yavorsky; Daniel Ryan,27,0,90,63
1683694736977,MGT 103,A00,202864,Ehrich; Kristine R,0,19,90,90
1683694738004,MGT 112,A00,202865,Ehrich; Kristine R,15,0,90,75
1683694739031,MGT 121A,A00,202868,Staff,90,20,90,0
1683694740055,MGT 131B,A00,202869,Anderson; John Charles,58,0,90,32
1683694741081,MGT 136,A00,202871,Lindenberger; Wade Douglas,83,0,90,7
1683694742105,MGT 164,A00,202873,Staff,0,67,90,91
1683694743128,MGT 164GS,A00,202874,McKay; Mary A,13,0,28,15
1683694744154,MGT 180,A00,202875,Staff,0,51,90,91
1683694745179,MMW 11R,A01,205019,Herbst; Matthew,0,0,30,30
1683694745179,MMW 11R,A02,205026,Herbst; Matthew,29,0,30,1
1683694746209,MMW 15,A01,193512,Chang; Edmond Yi-Teh,0,8,28,28
1683694746209,MMW 15,A02,193513,Chang; Edmond Yi-Teh,0,5,28,28
1683694746209,MMW 15,A03,193514,Chang; Edmond Yi-Teh,0,5,28,28
1683694746209,MMW 15,A04,193515,Chang; Edmond Yi-Teh,0,5,28,28
1683694746209,MMW 15,A05,193516,Chang; Edmond Yi-Teh,0,5,28,28
1683694746209,MMW 15,A06,193517,Chang; Edmond Yi-Teh,0,6,28,28
1683694746209,MMW 15,B01,193519,Chang; Edmond Yi-Teh,0,5,28,28
1683694746209,MMW 15,B02,193520,Chang; Edmond Yi-Teh,0,5,28,28
1683694746209,MMW 15,B03,193521,Chang; Edmond Yi-Teh,0,5,28,28
1683694746209,MMW 15,B04,193522,Chang; Edmond Yi-Teh,0,6,28,28
1683694746209,MMW 15,B05,193523,Chang; Edmond Yi-Teh,0,5,28,28
1683694746209,MMW 15,B06,193524,Chang; Edmond Yi-Teh,0,5,28,28
1683694747237,MMW 122,A01,193526,Rahimi; Babak,0,16,28,28
1683694747237,MMW 122,A02,193527,Rahimi; Babak,0,15,28,28
1683694747237,MMW 122,A03,193528,Rahimi; Babak,0,0,0,0
1683694747237,MMW 122,A04,193529,Rahimi; Babak,0,0,0,0
1683694748264,MUS 1A,A01,186663,Staff,1,19,35,34
1683694749288,MUS 4,A01,186715,Staff,0,12,35,35
1683694750312,MUS 5R,A01,186796,Dubnov; Shlomo,0,17,35,35
1683694751339,MUS 6,A01,186798,Staff,1,5,25,24
1683694752364,MUS 7,A01,186830,Staff,11,0,35,24
1683694753390,MUS 8,A01,186930,Staff,0,27,35,35
1683694754476,MUS 15,A01,186932,Staff,0,15,35,35
1683694754476,MUS 15,B01,186934,Staff,1,17,35,34
1683694755499,MUS 80,A00,186935,Staff,0,0,20,20
1683694755499,MUS 80,B00,186936,Staff,24,0,25,1
1683694756523,NANO 11,A00,204702,Lipomi; Darren John,0,0,0,0
1683694757548,NANO 15,A01,204709,Yang; Kesong,0,1,0,0
1683694758574,NANO 114,A00,202069,Jahed Motlagh; Zeinab,2,0,10,8
1683694759598,PHIL 1,A00,186955,Grush; Rick Scott,31,0,40,9
1683694760621,PHIL 10,A01,186973,Grush; Rick Scott,27,0,35,8
1683694760621,PHIL 10,A02,186974,Grush; Rick Scott,33,0,35,2
1683694761649,PHIL 13,A01,186976,Staff,1,0,35,34
1683694761649,PHIL 13,A02,186977,Staff,16,0,35,19
1683694762676,PHIL 14,A01,186979,Staff,31,0,35,4
1683694762676,PHIL 14,A02,186986,Staff,32,0,35,3
1683694763704,PHIL 28,A01,186988,Staff,16,0,30,14
1683694763704,PHIL 28,A02,186989,Staff,1,0,30,29
1683694763704,PHIL 28,A03,186990,Staff,10,0,30,20
1683694763704,PHIL 28,A04,186991,Staff,26,0,30,4
1683694764727,PHIL 120,A00,186997,Staff,23,0,40,17
1683694765754,PHIL 137,A00,187003,Staff,7,0,40,33
1683694766779,PHIL 150,A00,187015,Staff,47,0,70,23
1683694767802,PHIL 167,A00,187021,Lamey; Andy M.,34,0,40,6
1683694768829,PHIL 174,A01,202226,Staff,17,0,20,3
1683694768829,PHIL 174,A02,202235,Staff,20,0,20,0
1683694769853,PHIL 191A,A00,258918,Staff,0,0,1,1
1683694770877,PHYS 1A,A00,187028,Staff,26,0,60,34
1683694771900,PHYS 1AL,001,187036,Staff,3,0,30,27
1683694771900,PHYS 1AL,002,187049,Staff,18,0,30,12
1683694772925,PHYS 1B,A00,187058,Staff,22,0,60,38
1683694773949,PHYS 1BL,001,187064,Staff,0,1,30,30
1683694773949,PHYS 1BL,002,187070,Staff,4,0,30,26
1683694774973,PHYS 1C,A00,187082,Staff,29,0,120,91
1683694775998,PHYS 1CL,001,187088,Staff,0,9,30,30
1683694775998,PHYS 1CL,002,187089,Staff,0,1,30,30
1683694775998,PHYS 1CL,009,262693,Staff,9,0,30,21
1683694777022,PHYS 2B,A01,187097,Staff,55,0,115,60
1683694778046,PHYS 2C,A01,187099,Staff,63,0,115,52
1683694779069,PHYS 2CL,A01,187101,Staff,5,0,28,23
1683694779069,PHYS 2CL,A02,187102,Staff,15,0,28,13
1683694780092,PHYS 2D,A01,187123,Shotwell; Brian,95,0,115,20
1683694781116,PHYS 4B,A01,187133,Grinstein; Benjamin,35,0,50,15
1683694782140,POLI 10,A00,188819,Staff,0,4,50,50
1683694783165,POLI 11,A00,188827,Staff,43,0,50,7
1683694784187,POLI 13R,A00,188828,Staff,0,1,20,20
1683694785215,POLI 27,A01,188830,Elgin; Samuel Zincke,0,2,70,70
1683694786241,POLI 30,A00,188832,Desposato; Scott,30,0,50,20
1683694787265,POLI 102F,A00,188834,Staff,1,0,40,39
1683694788290,POLI 104A,A00,188852,Staff,12,0,30,18
1683694789313,POLI 104I,A00,188853,Staff,0,8,20,20
1683694790339,POLI 110B,A00,188854,Wiens; David,6,0,20,14
1683694791363,POLI 112A,A00,188855,Wiens; David,3,0,30,27
1683694792387,POLI 117R,A00,188856,Forman; Fonna,0,12,20,20
1683694793415,POLI 118,A00,188857,Ingham; Sean,8,0,20,12
1683694794441,POLI 120G,A00,188858,Staff,8,0,30,22
1683694795467,POLI 131CR,A00,188863,Hoston; Germaine,20,0,50,30
1683694796494,POLI 133,A00,188864,Nellis; Gareth Hb,44,0,50,6
1683694797521,POLI 134D,A00,188865,Desposato; Scott,27,0,30,3
1683694798548,POLI 142A,A00,188871,Gartzke; Erik,21,0,50,29
1683694799575,POLI 142K,A00,188874,Staff,38,0,50,12
1683694800600,POLI 143,A00,188940,Gartzke; Erik,16,0,30,14
1683694801627,POLI 153,A00,188943,Staff,2,0,20,18
1683694802654,POLI 160AA,A00,188944,Staff,10,0,40,30
1683694803681,POLI 170A,A00,188945,Staff,10,0,30,20
1683694805734,PSYC 1,A00,188952,Staff,36,0,90,54
1683694806758,PSYC 2,B00,188953,Staff,19,0,35,16
1683694807781,PSYC 6,A00,188970,Staff,47,0,60,13
1683694808813,PSYC 7,A00,188973,Staff,35,0,45,10
1683694809837,PSYC 60,A01,188980,Rickard; Timothy C.,42,0,60,18
1683694810861,PSYC 70,A01,189001,Steiner; Eric Tomas,21,0,45,24
1683694811884,PSYC 100,A00,189005,Lacefield; Katharine I,0,99,120,120
1683694812910,PSYC 102,A00,189008,Staff,7,0,30,23
1683694813933,PSYC 106,B00,189026,Gorman; Michael R.,27,0,60,33
1683694814957,PSYC 114,B01,189033,Winkielman; Piotr,0,31,30,30
1683694815981,PSYC 131,A00,189036,Anagnostaras; Stephan,0,43,60,60
1683694817007,PSYC 136,A00,189041,Lowe; Angela Beth,0,7,25,25
1683694818031,PSYC 137,A00,189057,Winkielman; Piotr,1,37,25,24
1683694819062,PSYC 144,A00,189107,Wixted; John T,0,11,50,50
1683694821111,PSYC 162,A00,189142,Staff,0,9,85,85
1683694822135,PSYC 172,A00,189144,Gorman; Michael R.,0,6,30,30
1683694824183,PSYC 179,A00,189146,Lacefield; Katharine I,0,88,120,120
1683694825206,PSYC 181,A00,189147,Anagnostaras; Stephan,0,44,90,90
1683694826233,PSYC 190R,A00,189148,Barner; David A.,0,23,80,80
1683694827258,PSYC 191,A00,189275,Rickard; Timothy C.,0,11,25,25
1683694828284,PSYC 193,A00,189276,Chapman; Eddie Nathaniel,0,1,0,4
1683694829308,PSYC 193L,A01,189281,Lowe; Angela Beth,8,0,20,12
1683694829308,PSYC 193L,B01,189285,Staff,28,0,35,7
1683694830333,RELI 149,A00,187137,Rahimi; Babak,6,0,40,34
1683694831357,SE 9,A01,187315,Staff,0,2,18,18
1683694832381,SE 101B,A00,187409,Staff,24,0,30,6
1683694833405,SE 110B,A00,187444,Staff,10,0,40,30
1683694834433,SE 130B,A00,187449,Staff,31,0,40,9
1683694835457,SE 150A,A00,187516,Staff,8,0,20,12
1683694836482,SE 154,A00,187528,Staff,29,0,50,21
1683694837506,SIO 3,A01,258171,Staff,35,0,40,5
1683694838530,SIO 10,A00,187144,Cook; Geoffrey W,1,7,75,74
1683694839553,SIO 45,A00,187152,Cook; Geoffrey W,0,7,100,100
1683694840577,SIO 109R,A00,194486,Staff,0,4,20,20
1683694842626,SIO 187,A01,187233,Kacev; David,12,0,40,28
1683694843653,SOCI 1,A01,258656,Thorpe; Charles Robert,28,0,30,2
1683694843653,SOCI 1,A02,258658,Thorpe; Charles Robert,30,0,30,0
1683694843653,SOCI 1,A03,258661,Thorpe; Charles Robert,25,0,25,0
1683694843653,SOCI 1,A04,258666,Thorpe; Charles Robert,22,0,25,3
1683694843653,SOCI 1,A05,258897,Thorpe; Charles Robert,22,0,25,3
1683694843653,SOCI 1,A06,258898,Thorpe; Charles Robert,25,0,25,0
1683694844677,SOCI 30,A01,258903,Pardo Guerra; Juan Pablo,14,0,30,16
1683694845702,SOCI 102,A00,258904,Staff,9,0,25,16
1683694846728,SOCI 106,A00,258905,Staff,19,0,25,6
1683694847752,SOCI 111,A00,258907,Ribas Norris; Janet Vanesa,25,0,30,5
1683694848780,SOCI 121R,A00,258908,Pardo Guerra; Juan Pablo,7,0,30,23
1683694849804,SOCI 126,A01,203330,Staff,14,0,20,6
1683694850831,SOCI 131,A00,258909,Thorpe; Charles Robert,30,0,60,30
1683694851856,SOCI 135,A00,258910,Payne; Christine Anna,0,13,30,30
1683694852883,SOCI 157,A00,258911,Staff,11,0,30,19
1683694853907,SOCI 184,A00,258912,Staff,25,0,30,5
1683694854936,SOCI 188D,A00,258913,Staff,22,0,30,8
1683694855960,SYN 2,001,187529,Staff,9,0,16,7
1683694855960,SYN 2,002,201452,Staff,1,20,16,15
1683694855960,SYN 2,003,201469,Staff,1,0,16,15
1683694856986,SYN 100,A01,187531,Staff,0,9,20,20
1683694856986,SYN 100,B01,201491,Staff,0,10,20,20
1683694858067,TDAC 1,A00,189286,Walsh; Kim C.,3,0,20,17
1683694858067,TDAC 1,B00,189287,Harting; Carla Kelso,10,0,20,10
1683694859092,TDAC 101,A00,189300,Walsh; Kim C.,16,0,20,4
1683694859092,TDAC 101,B00,189301,Harting; Carla Kelso,18,0,20,2
1683694860117,TDAC 102,A00,189304,Basso; Beatrice,14,0,20,6
1683694861142,TDAC 108,A00,189305,Staff,18,0,20,2
1683694862169,TDDE 131,A00,189310,Staff,19,0,20,1
1683694862169,TDDE 131,B00,189314,Staff,19,0,20,1
1683694862169,TDDE 131,C00,189315,Staff,48,0,50,2
1683694862169,TDDE 131,D00,189316,Staff,14,0,15,1
1683694862169,TDDE 131,E00,204841,Staff,20,0,20,0
1683694863198,TDGE 10,A00,189289,Staff,27,0,50,23
1683694863198,TDGE 10,B00,189290,Havis; Allan,0,1,50,50
1683694864222,TDGE 11,A00,189291,Fulton; Julia,0,4,50,50
1683694864222,TDGE 11,B00,189292,Staff,20,0,25,5
1683694864222,TDGE 11,C00,260270,Staff,0,0,0,0
1683694865246,TDGE 25,A00,189294,Staff,1,0,20,19
1683694866274,TDGE 124,A00,189318,Fulton; Julia,1,8,50,49
1683694867301,TDGE 125,A00,189319,Staff,13,0,25,12
1683694867301,TDGE 125,B00,189320,Staff,23,0,25,2
1683694868326,TDGE 127,A00,189322,Havis; Allan,0,0,50,50
1683694869356,TDHT 101,A00,189323,Staff,18,0,25,7
1683694869356,TDHT 101,B00,189324,Staff,25,0,25,0
1683694870383,TDHT 102,A00,189325,Staff,49,0,50,1
1683694871411,TDMV 1,A00,189295,Arcidiacono; Kristin,20,0,30,10
1683694871411,TDMV 1,B00,189296,Caligagan; Maria T.,24,0,30,6
1683694872435,TDMV 2,A00,189297,Sammartano; Tonnie,27,0,30,3
1683694872435,TDMV 2,B00,189299,Arcidiacono; Kristin,23,0,30,7
1683694873459,TDMV 3,A00,204998,Rincon; Alicia,22,0,30,8
1683694874486,TDMV 120,A00,189458,Sammartano; Tonnie,28,0,30,2
1683694875514,TDMV 138,A00,189541,Jun; Grace Shin Hae,20,0,40,20
1683694876542,TDMV 142,A00,189717,Caligagan; Tony,25,0,30,5
1683694876542,TDMV 142,B00,189718,Caligagan; Maria T.,25,0,30,5
1683694877565,TMC 2,A01,187533,Staff,25,0,25,0
1683694877565,TMC 2,A02,187534,Staff,25,0,25,0
1683694878589,USP 1,A01,187536,Kwak; Nancy,0,16,25,25
1683694879617,USP 5,A01,187538,Staff,8,0,25,17
1683694880648,USP 101,A00,199253,Staff,0,4,0,0
1683694881674,USP 124,A00,187562,Boomhower; Matthew Charles,0,0,30,30
1683694882699,USP 138,A00,187582,Staff,19,0,25,6
1683694883724,USP 152,A01,187597,Staff,3,0,25,22
1683694884748,USP 153,A00,187598,Staff,18,0,25,7
1683694885772,USP 168,A00,187607,Kwak; Nancy,2,0,5,3
1683694886797,USP 173,A00,187619,Staff,4,0,25,21
1683694887821,USP 181,A00,187638,Staff,0,4,25,25
1683694888847,VIS 103,A00,187650,Cruz; Edwin Teddy,17,0,75,58
1683694889873,VIS 110D,A00,187669,Staff,13,0,22,9
1683694890902,VIS 127C,A00,187720,Shen; Kuiyi,67,0,146,79
1683694891926,VIS 149,A00,187731,Yoldas; Pinar,2,14,22,20
1683694892950,VIS 151,A01,188091,Staff,22,0,34,12
1683694892950,VIS 151,A02,188092,Staff,11,0,34,23
1683694893976,VIS 160B,A00,188093,Stalbaum; Brett,0,1,10,10
1683694896028,WCWP 10B,A00,201720,Staff,0,0,5,5
1683694896028,WCWP 10B,B00,201722,Staff,0,0,6,6
1683694897059,WCWP 100,A00,201725,Gagnon; Jeffrey C,0,0,2,2
1683694897059,WCWP 100,B00,201727,Staff,0,4,15,15
1683694900153,ANBI 133,A00,258401,Wilder; Linnea Lorene,34,0,40,6
1683694901181,ANBI 140,A00,258395,Hrvoj Mihic; Branka,18,0,25,7
1683694902205,ANSC 120,A00,258402,Bialecki; Jon Anthony,26,0,40,14
1683694903231,ANSC 144,A00,258400,Staff,12,0,40,28
1683694905282,ANSC 166,A00,258396,Parish; Steven Martin,156,0,175,19
1683694906310,ANSC 180,A00,193533,Staff,8,0,20,12
1683694907334,ANSC 188,A00,258397,Jassal; Aftab,34,0,40,6
1683694908358,ANTH 3,A01,258316,Staff,23,0,30,7
1683694909381,ANTH 5,A00,258394,Semendeferi; Ekaterini,16,0,20,4
1683694910406,ANTH 21,A01,258331,Staff,4,0,40,36
1683694911431,ANTH 103,A00,258398,Varma; Saiba,15,0,25,10
1683694912459,AWP 10,001,202034,Staff,0,0,0,0
1683694912459,AWP 10,002,202035,Staff,0,0,0,0
1683694912459,AWP 10,003,202036,Staff,0,0,0,0
1683694912459,AWP 10,004,202037,Staff,0,0,0,0
1683694912459,AWP 10,005,202038,Staff,0,0,0,0
1683694912459,AWP 10,006,202039,Staff,0,0,0,0
1683694912459,AWP 10,007,202040,Staff,0,0,0,0
1683694912459,AWP 10,008,202041,Staff,0,0,0,0
1683694912459,AWP 10,009,202042,Staff,0,0,0,0
1683694912459,AWP 10,010,202043,Staff,0,0,0,0
1683694912459,AWP 10,011,202044,Staff,0,0,0,0
1683694912459,AWP 10,012,202045,Staff,0,0,0,0
1683694912459,AWP 10,013,202046,Staff,0,0,0,0
1683694912459,AWP 10,014,202047,Staff,0,0,0,0
1683694912459,AWP 10,015,202048,Staff,0,0,0,0
1683694912459,AWP 10,016,202049,Staff,0,0,0,0
1683694912459,AWP 10,017,202050,Staff,0,0,0,0
1683694912459,AWP 10,018,202051,Staff,0,0,0,0
1683694912459,AWP 10,019,202052,Staff,0,0,0,0
1683694912459,AWP 10,020,202053,Staff,0,0,0,0
1683694912459,AWP 10,021,202054,Staff,0,0,0,0
1683694912459,AWP 10,022,202055,Staff,0,0,0,0
1683694912459,AWP 10,023,202056,Staff,0,0,0,0
1683694912459,AWP 10,024,202057,Staff,0,0,0,0
1683694912459,AWP 10,025,202058,Staff,0,0,0,0
1683694912459,AWP 10,026,202059,Staff,0,0,0,0
1683694913482,AWP 102,001,202032,Staff,0,0,0,0
1683694913482,AWP 102,002,202033,Staff,0,0,0,0
1683694914507,BENG 100,A01,254234,Taylor Amos; Alyssa C,31,0,40,9
1683694915531,BENG 196,001,270013,Engler; Adam J.,9999,0,9999,0
1683694916564,BICD 100R,A01,202018,Smith; Laurie,0,7,32,32
1683694916564,BICD 100R,A02,202019,Smith; Laurie,0,3,32,32
1683694916564,BICD 100R,A03,202020,Smith; Laurie,0,1,32,32
1683694916564,BICD 100R,A04,202021,Smith; Laurie,6,0,32,26
1683694916564,BICD 100R,A05,202022,Smith; Laurie,10,0,32,22
1683694917592,BICD 136,A01,193242,Gustafson-Brown; Cindy,0,2,32,32
1683694917592,BICD 136,A02,193244,Gustafson-Brown; Cindy,13,0,32,19
1683694918618,BIEB 102,A01,193249,Butler; Shannon Rhey,1,1,32,31
1683694918618,BIEB 102,A02,193251,Butler; Shannon Rhey,0,0,32,32
1683694918618,BIEB 102,A03,193253,Butler; Shannon Rhey,0,0,32,32
1683694918618,BIEB 102,A04,193255,Butler; Shannon Rhey,13,0,32,19
1683694918618,BIEB 102,A05,193265,Butler; Shannon Rhey,25,0,32,7
1683694918618,BIEB 102,A06,193269,Butler; Shannon Rhey,12,0,32,20
1683694920676,BIEB 150,A01,193274,Staff,0,0,32,32
1683694920676,BIEB 150,A02,193285,Staff,24,0,32,8
1683694921705,BIEB 194,A00,193286,Kurle; Carolyn M.,19,0,32,13
1683694922732,BILD 1,A01,192291,Staff,15,0,32,17
1683694922732,BILD 1,A02,192292,Staff,30,0,32,2
1683694922732,BILD 1,B01,192520,Reuther; Keefe,0,1,0,0
1683694922732,BILD 1,B02,192532,Reuther; Keefe,0,1,0,0
1683694923757,BILD 3,A01,192556,Butler; Shannon Rhey,0,0,32,32
1683694923757,BILD 3,A02,192581,Butler; Shannon Rhey,0,1,32,32
1683694923757,BILD 3,A03,192611,Butler; Shannon Rhey,19,0,32,13
1683694923757,BILD 3,A04,192612,Butler; Shannon Rhey,23,0,32,9
1683694923757,BILD 3,A05,192613,Butler; Shannon Rhey,26,0,32,6
1683694923757,BILD 3,A06,192679,Butler; Shannon Rhey,27,0,32,5
1683694923757,BILD 3,A07,192682,Butler; Shannon Rhey,20,0,32,12
1683694924787,BILD 4,A01,192836,Reuther; Keefe,1,0,24,23
1683694924787,BILD 4,A02,193044,Reuther; Keefe,4,0,24,20
1683694925811,BILD 10,A01,193142,Gustafson-Brown; Cindy,29,0,32,3
1683694925811,BILD 10,A02,193149,Gustafson-Brown; Cindy,31,0,32,1
1683694926837,BIMM 100,A01,193301,Staff,0,6,32,32
1683694926837,BIMM 100,A02,193312,Staff,0,7,32,32
1683694926837,BIMM 100,A03,193323,Staff,0,10,32,32
1683694927862,BIMM 101,A01,193329,McDonnell; Lisa Marie,1,4,24,23
1683694927862,BIMM 101,A02,193339,McDonnell; Lisa Marie,1,4,24,23
1683694927862,BIMM 101,B01,193354,McDonnell; Lisa Marie,0,4,24,24
1683694927862,BIMM 101,B02,193357,McDonnell; Lisa Marie,0,3,24,24
1683694928885,BIMM 110,A01,193377,Tat; John,0,11,32,32
1683694928885,BIMM 110,A02,193378,Tat; John,0,11,32,32
1683694929910,BIMM 120,A01,206116,Staff,0,0,32,32
1683694929910,BIMM 120,A02,206117,Staff,7,0,32,25
1683694929910,BIMM 120,A03,206121,Staff,21,0,32,11
1683694930940,BIPN 100,A01,193393,Park; Ji Young,0,15,32,32
1683694930940,BIPN 100,A02,193402,Park; Ji Young,0,14,32,32
1683694930940,BIPN 100,A03,193413,Park; Ji Young,0,14,32,32
1683694930940,BIPN 100,A04,193414,Park; Ji Young,0,13,32,32
1683694931966,BIPN 102,A01,193429,Staff,0,0,32,32
1683694931966,BIPN 102,A02,193438,Staff,18,0,32,14
1683694932994,BIPN 106,A01,193450,Reyes Gonzalez; Catalina,0,2,40,40
1683694934024,BIPN 134,A01,193465,Cooke; James Edward,0,0,32,32
1683694934024,BIPN 134,A02,193474,Cooke; James Edward,25,0,32,7
1683694934024,BIPN 134,A03,193485,Cooke; James Edward,29,0,32,3
1683694934024,BIPN 134,A04,193486,Cooke; James Edward,20,0,32,12
1683694934024,BIPN 134,A05,193491,Cooke; James Edward,31,0,32,1
1683694934024,BIPN 134,A06,193501,Cooke; James Edward,30,0,32,2
1683694934024,BIPN 134,A07,193510,Cooke; James Edward,29,0,32,3
1683694936076,BISP 194,A00,222522,Staff,14,0,32,18
1683694937104,CAT 124,A01,202407,Staff,19,0,25,6
1683694938131,CAT 125,A00,202408,Marchisotto; Jennifer Anne,2,0,20,18
1683694939164,CAT 125R,A00,202409,Smith; Lauryn Alissa,0,11,20,20
1683694939164,CAT 125R,B00,202410,Morales; Celeste Georgianna,0,11,20,20
1683694939164,CAT 125R,C00,202411,Irwin; Matthew Joseph,0,12,20,20
1683694940194,CENG 15,A01,204712,Yang; Kesong,0,1,0,0
1683694941217,CENG 114,A00,202070,Jahed Motlagh; Zeinab,5,0,20,15
1683694942242,CGS 105,A00,185477,Wesling; Megan E.,24,0,40,16
1683694943265,CGS 106,A00,185494,Staff,11,0,22,11
1683694944291,CGS 108,A00,185495,Staff,14,0,20,6
1683694945315,CGS 114,A00,185496,Staff,13,0,18,5
1683694946360,CGS 119,A00,185501,Staff,15,0,20,5
1683694947387,CGS 120,A00,185511,Staff,12,0,20,8
1683694948414,CHEM 4,A01,184675,Bussey; Thomas J,97,0,100,3
1683694949438,CHEM 6A,A01,184677,Staff,32,0,60,28
1683694950461,CHEM 6B,A01,184679,Staff,63,0,100,37
1683694951488,CHEM 6C,A01,184681,Bussey; Thomas J,0,0,50,50
1683694951488,CHEM 6C,A02,184682,Bussey; Thomas J,32,0,50,18
1683694952511,CHEM 40A,A01,184684,Albizati; Kim F.,33,0,100,67
1683694953538,CHEM 40B,A01,184686,Albizati; Kim F.,0,22,100,100
1683694954563,CHEM 41B,A01,184690,Staff,51,0,100,49
1683694955591,COGS 3,A01,184715,Boyle; Mary E. T.,0,27,40,40
1683694956619,COGS 14B,A01,185172,Staff,0,14,38,38
1683694957642,COGS 18,A01,184736,Staff,14,0,80,66
1683694958665,COGS 100,A01,184932,Staff,0,8,73,73
1683694959691,COGS 101A,A01,184935,Staff,0,40,30,30
1683694960718,COGS 101B,A01,184944,Staff,0,2,30,30
1683694961827,COGS 101C,A01,184946,Staff,0,10,30,30
1683694962855,COGS 102A,A01,184951,Johnson; Christine M.,1,0,40,39
1683694963882,COGS 107B,A01,184953,Mooshagian; Eric Frederick,0,52,40,40
1683694964907,COGS 118B,A01,184959,Gupta; Anjum,0,50,40,40
1683694965933,COGS 153,A00,184961,Staff,0,16,30,30
1683694966961,COGS 177,A00,184962,Staff,1,21,30,29
1683694967989,COGS 187A,A01,184969,Boyle; Mary E. T.,0,19,40,40
1683694969013,COMM 10,A01,185174,Staff,0,5,25,25
1683694969013,COMM 10,A02,185189,Staff,0,2,25,25
1683694969013,COMM 10,A03,269821,Staff,0,1,0,0
1683694970037,COMM 100B,A02,185476,Staff,10,0,25,15
1683694970037,COMM 100B,A03,277340,Staff,25,0,25,0
1683694971063,COMM 100C,A01,185314,Staff,2,0,25,23
1683694971063,COMM 100C,A02,185327,Staff,17,0,25,8
1683694972090,COMM 110M,A00,185349,Staff,0,0,40,40
1683694973115,COMM 113T,A00,185352,Staff,25,0,40,15
1683694974139,COMM 114I,A00,185353,Staff,31,0,40,9
1683694975166,COMM 131,A00,185354,Staff,17,0,30,13
1683694976191,CSE 8A,A50,185358,Cao; Yingjun,0,46,10,10
1683694977217,CSE 8B,A01,185362,Staff,0,48,50,50
1683694978240,CSE 11,A01,185416,Cao; Yingjun,0,91,10,10
1683694979263,CSE 20,A01,185445,Briones; Jor-el Thomas Caparas,3,0,25,22
1683694980287,CSE 21,A01,185447,Staff,9,0,50,41
1683694981313,CSE 101,A01,185451,Staff,0,13,50,50
1683694981313,CSE 101,B01,185453,Jones; Miles E,0,14,50,50
1683694983367,CSE 141,A01,185458,Eldon; John,16,0,100,84
1683694984395,CSE 141L,A01,185461,Eldon; John,8,0,100,92
1683694985419,CSE 142,A01,185463,Staff,34,0,60,26
1683694985419,CSE 142,B01,201355,Staff,0,7,60,60
1683694986447,CSE 142L,A01,185470,Staff,34,0,60,26
1683694986447,CSE 142L,B01,201417,Staff,0,6,60,60
1683694987472,CSE 190,A00,201433,Staff,32,0,49,17
1683694988498,DOC 1,A01,259136,Strom; Megan C.,7,0,15,8
1683694988498,DOC 1,A02,259137,Strom; Megan C.,14,0,15,1
1683694988498,DOC 1,A03,259138,Strom; Megan C.,14,0,15,1
1683694988498,DOC 1,A04,259139,Strom; Megan C.,14,0,15,1
1683694989523,DOC 100D,A00,259140,Pass; Natalye Joann,14,0,25,11
1683694990547,DSGN 1,A01,184749,Rill; Bryan,0,26,30,30
1683694991571,DSGN 100,A01,185168,Staff,0,2,25,25
1683694992598,ECE 5,A01,185626,Morris; Karcher William,0,12,0,0
1683694993625,ECE 101,A01,185628,Staff,14,0,70,56
1683694994652,ECE 107,A01,185635,Baghdadchi; Saharnaz,0,0,20,20
1683694994652,ECE 107,A02,185638,Baghdadchi; Saharnaz,1,0,20,19
1683694995678,ECE 148,A01,185647,Silberman; Jack,0,0,16,16
1683694996702,ECON 1,A01,185537,Crane; Meredith Helen,54,0,70,16
1683694997728,ECON 3,A01,185549,Crane; Meredith Helen,30,0,70,40
1683694998757,ECON 4,A01,203354,Anderson; John Charles,0,5,10,10
1683694999781,ECON 100A,A01,185574,Staff,0,5,40,40
1683695000806,ECON 100B,A01,185576,Staff,0,12,50,50
1683695001831,ECON 100C,A01,185589,Newhouse; Herbert S,30,0,70,40
1683695002855,ECON 105,A00,185608,Vespa; Emanuel Ignacio,19,0,35,16
1683695003881,ECON 109,A01,185610,Shishkin; Denis,9,0,35,26
1683695004904,ECON 110A,A01,185612,Staff,8,0,40,32
1683695005928,ECON 120A,A01,185615,Staff,19,0,40,21
1683695006952,ECON 120C,A01,185617,Sun; Yixiao,0,21,70,70
1683695007977,ECON 144,A00,203346,Squires; Dale E,2,0,35,33
1683695009008,ECON 171,A01,203349,Newhouse; Herbert S,0,1,35,35
1683695010033,ECON 173A,A01,185621,Toda; Alexis Akira,21,0,35,14
1683695011059,EDS 25,A01,202413,Staff,0,1,0,0
1683695011059,EDS 25,A02,202414,Staff,0,1,0,0
1683695011059,EDS 25,A03,202415,Staff,0,0,0,0
1683695011059,EDS 25,A04,202416,Staff,0,1,0,0
1683695011059,EDS 25,A05,202439,Staff,0,0,0,0
1683695011059,EDS 25,A06,202440,Staff,0,0,0,0
1683695011059,EDS 25,B01,202631,Staff,0,0,0,0
1683695011059,EDS 25,B02,202632,Staff,0,0,0,0
1683695011059,EDS 25,B03,202639,Staff,0,0,0,0
1683695011059,EDS 25,B04,202640,Staff,0,0,0,0
1683695011059,EDS 25,B05,202643,Staff,0,0,0,0
1683695011059,EDS 25,B06,202644,Staff,0,0,0,0
1683695012088,EDS 38,A01,202659,Black; Alison Michelle,24,0,25,1
1683695013112,EDS 115,A00,202652,Staff,18,0,30,12
1683695014140,EDS 125,A00,202649,Staff,13,0,30,17
1683695015167,EDS 126,A01,203332,Staff,30,0,30,0
1683695016191,EDS 139,A00,202838,Staff,16,0,25,9
1683695017216,EDS 146,A01,202655,Staff,14,0,25,11
1683695018240,ENG 15,A00,185667,Staff,0,1,0,0
1683695018240,ENG 15,B00,185672,Staff,0,0,0,0
1683695018240,ENG 15,C00,185675,Staff,0,0,0,0
1683695018240,ENG 15,D00,185682,Staff,0,0,0,0
1683695018240,ENG 15,E00,185684,Staff,0,0,0,0
1683695019264,ETHN 103,A00,185710,Staff,0,8,35,35
1683695020286,ETHN 103A,A00,199228,Man; Simeon S,0,0,9,9
1683695021313,ETHN 109,A00,185711,Staff,15,0,35,20
1683695022339,ETHN 142,A00,185726,Staff,0,4,30,30
1683695023366,ETHN 163J,A00,199229,Man; Simeon S,5,0,8,3
1683695024393,ETHN 168,A00,185727,Staff,7,0,10,3
1683695025419,ETHN 182,A00,185728,Staff,0,0,35,35
1683695026447,ETHN 183,A00,185737,Staff,9,0,18,9
1683695027470,GLBH 111,A01,209361,Burgos; Jose L.,0,0,0,0
1683695029518,HIEU 104,A00,185792,Staff,14,0,20,6
1683695030541,HIEU 115,A00,185800,Staff,0,0,20,20
1683695031569,HIEU 128,A00,185801,Staff,0,9,20,20
1683695032593,HIEU 147,A00,185802,Staff,15,0,20,5
1683695033617,HIEU 154,A00,185823,Staff,11,0,20,9
1683695034641,HILA 102,A00,185826,Staff,14,0,20,6
1683695035669,HILD 2C,A01,185778,Staff,0,13,20,20
1683695036693,HILD 7B,A01,185780,Kwak; Nancy,0,17,32,32
1683695036693,HILD 7B,A02,185781,Kwak; Nancy,0,18,32,32
1683695037719,HILD 30,A01,185791,Staff,12,0,20,8
1683695038743,HISC 119,A00,185830,Golan; Tal,0,10,20,20
1683695039769,HITO 156GS,A00,185831,Patterson; Patrick H.,0,0,0,23
1683695040796,HIUS 103,A00,185832,Man; Simeon S,0,4,20,20
1683695041822,HIUS 117,A00,185836,Kwak; Nancy,2,0,20,18
1683695042846,HIUS 125,A00,185840,Man; Simeon S,0,2,23,23
1683695043870,HIUS 149,A00,185845,Staff,1,0,20,19
1683695044895,HUM 3,A01,185882,Zavodny; Tatiana Sophia,0,8,50,50
1683695044895,HUM 3,B01,185899,Caldwell; Michael Alan,0,18,50,50
1683695045921,HUM 3GS,A00,185900,Patterson; Patrick H.,0,0,0,23
1683695046946,HUM 4,A01,185938,Zroka; Amy Liane,28,0,50,22
1683695046946,HUM 4,B01,185956,Watkins; Eric,0,6,50,50
1683695046946,HUM 4,B02,202209,Watkins; Eric,0,5,50,50
1683695046946,HUM 4,B03,202210,Watkins; Eric,0,5,50,50
1683695047969,HUM 5,A01,185958,West; Geoffrey Scott,0,0,50,50
1683695047969,HUM 5,A02,202215,West; Geoffrey Scott,0,1,50,50
1683695048993,INTL 190,A00,185959,Gagnon; Jeffrey C,0,0,0,9
1683695048993,INTL 190,B00,185960,Lettieri; Michael Joseph,0,0,0,2
1683695050019,JAPN 180,A00,254509,Staff,5,0,30,25
1683695051043,LATI 10,A01,202853,Kennemore; Amy Michelle,4,0,35,31
1683695051043,LATI 10,A02,202854,Kennemore; Amy Michelle,3,0,35,32
1683695051043,LATI 10,A03,270054,Kennemore; Amy Michelle,30,0,30,0
1683695052065,LATI 180,A00,202855,Kennemore; Amy Michelle,11,0,20,9
1683695053089,LAWS 101,A00,201767,Golan; Tal,0,7,40,40
1683695054113,LIFR 1C,A00,185961,Staff,6,0,20,14
1683695055137,LIFR 1CX,A00,185962,Staff,7,0,20,13
1683695056162,LIFR 1D,A00,185963,Staff,7,0,20,13
1683695057188,LIFR 1DX,A00,185964,Staff,7,0,20,13
1683695058217,LIGN 101,A01,186039,Staff,43,0,50,7
1683695059248,LIGN 165,A00,186040,Staff,15,0,50,35
1683695060273,LTCS 108,A00,186041,Staff,5,0,10,5
1683695061300,LTCS 119,A00,186042,Staff,15,0,20,5
1683695062328,LTCS 130,A00,186043,Wesling; Megan E.,15,0,25,10
1683695064382,LTEA 138,A00,186119,Staff,14,0,40,26
1683695065465,LTEN 124,A00,186148,Staff,5,0,25,20
1683695066493,LTEN 178,A00,186149,Staff,6,0,15,9
1683695067519,LTEN 181,A00,186150,Blanco; John D,34,0,40,6
1683695068547,LTWL 120,A00,186160,Staff,19,0,25,6
1683695069570,LTWL 165,A00,186161,Staff,22,0,25,3
1683695070594,LTWR 100,A00,186162,Staff,0,5,15,15
1683695071617,LTWR 102,A00,186163,Doller; Ben,5,0,15,10
1683695072639,MAE 8,A01,186412,Staff,0,1,0,0
1683695073663,MAE 30B,A00,186445,Bahadori; Mohammad Yousef,81,0,100,19
1683695074690,MAE 40,A00,186592,Bewley; Thomas R,10,0,50,40
1683695075717,MAE 101B,A00,186593,Bahadori; Mohammad Yousef,80,0,100,20
1683695076750,MAE 105,A00,186594,Bandaru; Prabhakar,10,0,50,40
1683695077773,MAE 107,A00,186599,Pham; Hieu Tan,0,7,120,120
1683695078797,MAE 148,A01,186660,Silberman; Jack,3,0,16,13
1683695079824,MATH 10A,A01,188095,Staff,0,6,35,35
1683695080854,MATH 10B,A01,188097,Bowers; Adam R.,0,12,30,30
1683695080854,MATH 10B,A02,188099,Bowers; Adam R.,0,11,30,30
1683695080854,MATH 10B,B01,188104,Bowers; Adam R.,0,10,30,30
1683695080854,MATH 10B,B02,188106,Bowers; Adam R.,1,10,30,29
1683695081883,MATH 10C,A01,188111,Staff,0,20,30,30
1683695081883,MATH 10C,A02,188127,Staff,0,19,30,30
1683695081883,MATH 10C,A03,188131,Staff,0,19,30,30
1683695081883,MATH 10C,B01,188218,Staff,17,0,30,13
1683695081883,MATH 10C,B02,188244,Staff,13,0,30,17
1683695081883,MATH 10C,B03,188277,Staff,14,0,30,16
1683695082909,MATH 18,A01,188344,Bach; Quang Tran,18,0,30,12
1683695082909,MATH 18,A02,188345,Bach; Quang Tran,11,0,30,19
1683695082909,MATH 18,B01,188353,Bach; Quang Tran,11,0,30,19
1683695082909,MATH 18,B02,188354,Bach; Quang Tran,19,0,30,11
1683695083942,MATH 20A,A01,188374,Staff,11,0,35,24
1683695084966,MATH 20B,A01,188382,Ohm; Ko Woon,7,0,30,23
1683695084966,MATH 20B,A02,188383,Ohm; Ko Woon,22,0,30,8
1683695084966,MATH 20B,B01,188385,Ohm; Ko Woon,7,0,30,23
1683695084966,MATH 20B,B02,188392,Ohm; Ko Woon,22,0,30,8
1683695085990,MATH 20C,A01,188394,Harel; Guershon,10,0,30,20
1683695085990,MATH 20C,A02,188395,Harel; Guershon,13,0,30,17
1683695085990,MATH 20C,B01,188404,Harel; Guershon,5,0,30,25
1683695085990,MATH 20C,B02,188405,Harel; Guershon,18,0,30,12
1683695087015,MATH 20D,A01,188414,Hammock; Frances H,0,1,30,30
1683695087015,MATH 20D,A02,188415,Hammock; Frances H,0,1,30,30
1683695087015,MATH 20D,B01,188447,Hammock; Frances H,0,1,30,30
1683695087015,MATH 20D,B02,188486,Hammock; Frances H,2,0,30,28
1683695088040,MATH 20E,A01,188649,Staff,21,0,30,9
1683695088040,MATH 20E,A02,188650,Staff,20,0,30,10
1683695088040,MATH 20E,A03,188673,Staff,0,0,30,30
1683695089065,MATH 102,A01,188675,Staff,0,40,35,35
1683695090092,MATH 103B,A01,188681,Staff,3,0,35,32
1683695090092,MATH 103B,B01,188692,Staff,5,0,35,30
1683695091116,MATH 109,A01,188695,Salehi Golsefidy; Alireza,24,0,35,11
1683695091116,MATH 109,A02,188696,Salehi Golsefidy; Alireza,25,0,35,10
1683695092140,MATH 120A,A01,188698,Eggers; John Dietrich,7,0,35,28
1683695093165,MATH 142B,A01,188736,Ioana; Adrian,1,1,30,29
1683695093165,MATH 142B,A02,188741,Ioana; Adrian,0,1,30,30
1683695093165,MATH 142B,A03,188743,Ioana; Adrian,0,2,30,30
1683695094190,MATH 168A,A01,188790,Staff,0,11,35,35
1683695095214,MATH 170A,A01,188803,Nie; Jiawang,0,2,35,35
1683695095214,MATH 170A,A02,188811,Nie; Jiawang,0,1,35,35
1683695095214,MATH 170A,A03,188814,Nie; Jiawang,0,0,35,35
1683695095214,MATH 170A,A04,188815,Nie; Jiawang,5,0,35,30
1683695096240,MATH 193B,A01,188817,Staff,0,0,35,35
1683695096240,MATH 193B,A02,188818,Staff,6,0,35,29
1683695097265,MGT 4,A01,202857,Anderson; John Charles,59,0,80,21
1683695098289,MGT 12,A00,202858,Lindenberger; Wade Douglas,40,0,90,50
1683695099311,MGT 18,A00,202859,Staff,74,0,90,16
1683695100338,MGT 18GS,A00,202860,McKay; Michael J,13,0,28,15
1683695101365,MGT 45,A00,202861,Pecore; Joseph P.,8,0,90,82
1683695102392,MGT 100,A00,202863,Yavorsky; Daniel Ryan,27,0,90,63
1683695103420,MGT 103,A00,202864,Ehrich; Kristine R,0,19,90,90
1683695104443,MGT 112,A00,202865,Ehrich; Kristine R,15,0,90,75
1683695105472,MGT 121A,A00,202868,Staff,90,20,90,0
1683695106496,MGT 131B,A00,202869,Anderson; John Charles,58,0,90,32
1683695107521,MGT 136,A00,202871,Lindenberger; Wade Douglas,83,0,90,7
1683695108549,MGT 164,A00,202873,Staff,0,67,90,91
1683695109575,MGT 164GS,A00,202874,McKay; Mary A,13,0,28,15
1683695110599,MGT 180,A00,202875,Staff,0,51,90,91
1683695111625,MMW 11R,A01,205019,Herbst; Matthew,0,0,30,30
1683695111625,MMW 11R,A02,205026,Herbst; Matthew,29,0,30,1
1683695112654,MMW 15,A01,193512,Chang; Edmond Yi-Teh,0,8,28,28
1683695112654,MMW 15,A02,193513,Chang; Edmond Yi-Teh,0,5,28,28
1683695112654,MMW 15,A03,193514,Chang; Edmond Yi-Teh,0,5,28,28
1683695112654,MMW 15,A04,193515,Chang; Edmond Yi-Teh,0,5,28,28
1683695112654,MMW 15,A05,193516,Chang; Edmond Yi-Teh,0,5,28,28
1683695112654,MMW 15,A06,193517,Chang; Edmond Yi-Teh,0,6,28,28
1683695112654,MMW 15,B01,193519,Chang; Edmond Yi-Teh,0,5,28,28
1683695112654,MMW 15,B02,193520,Chang; Edmond Yi-Teh,0,5,28,28
1683695112654,MMW 15,B03,193521,Chang; Edmond Yi-Teh,0,5,28,28
1683695112654,MMW 15,B04,193522,Chang; Edmond Yi-Teh,0,6,28,28
1683695112654,MMW 15,B05,193523,Chang; Edmond Yi-Teh,0,5,28,28
1683695112654,MMW 15,B06,193524,Chang; Edmond Yi-Teh,0,5,28,28
1683695113682,MMW 122,A01,193526,Rahimi; Babak,0,16,28,28
1683695113682,MMW 122,A02,193527,Rahimi; Babak,0,15,28,28
1683695113682,MMW 122,A03,193528,Rahimi; Babak,0,0,0,0
1683695113682,MMW 122,A04,193529,Rahimi; Babak,0,0,0,0
1683695114711,MUS 1A,A01,186663,Staff,1,19,35,34
1683695115737,MUS 4,A01,186715,Staff,0,12,35,35
1683695116761,MUS 5R,A01,186796,Dubnov; Shlomo,0,17,35,35
1683695117784,MUS 6,A01,186798,Staff,1,5,25,24
1683695118807,MUS 7,A01,186830,Staff,11,0,35,24
1683695119831,MUS 8,A01,186930,Staff,0,27,35,35
1683695120859,MUS 15,A01,186932,Staff,0,15,35,35
1683695120859,MUS 15,B01,186934,Staff,1,17,35,34
1683695121886,MUS 80,A00,186935,Staff,0,0,20,20
1683695121886,MUS 80,B00,186936,Staff,24,0,25,1
1683695122913,NANO 11,A00,204702,Lipomi; Darren John,0,0,0,0
1683695123942,NANO 15,A01,204709,Yang; Kesong,0,1,0,0
1683695124968,NANO 114,A00,202069,Jahed Motlagh; Zeinab,2,0,10,8
1683695125995,PHIL 1,A00,186955,Grush; Rick Scott,31,0,40,9
1683695127021,PHIL 10,A01,186973,Grush; Rick Scott,27,0,35,8
1683695127021,PHIL 10,A02,186974,Grush; Rick Scott,33,0,35,2
1683695128048,PHIL 13,A01,186976,Staff,1,0,35,34
1683695128048,PHIL 13,A02,186977,Staff,16,0,35,19
1683695129077,PHIL 14,A01,186979,Staff,31,0,35,4
1683695129077,PHIL 14,A02,186986,Staff,32,0,35,3
1683695130104,PHIL 28,A01,186988,Staff,16,0,30,14
1683695130104,PHIL 28,A02,186989,Staff,1,0,30,29
1683695130104,PHIL 28,A03,186990,Staff,10,0,30,20
1683695130104,PHIL 28,A04,186991,Staff,26,0,30,4
1683695131130,PHIL 120,A00,186997,Staff,23,0,40,17
1683695132156,PHIL 137,A00,187003,Staff,7,0,40,33
1683695133181,PHIL 150,A00,187015,Staff,47,0,70,23
1683695134209,PHIL 167,A00,187021,Lamey; Andy M.,34,0,40,6
1683695135235,PHIL 174,A01,202226,Staff,17,0,20,3
1683695135235,PHIL 174,A02,202235,Staff,20,0,20,0
1683695136262,PHIL 191A,A00,258918,Staff,0,0,1,1
1683695137291,PHYS 1A,A00,187028,Staff,26,0,60,34
1683695138318,PHYS 1AL,001,187036,Staff,3,0,30,27
1683695138318,PHYS 1AL,002,187049,Staff,18,0,30,12
1683695139341,PHYS 1B,A00,187058,Staff,22,0,60,38
1683695140366,PHYS 1BL,001,187064,Staff,0,1,30,30
1683695140366,PHYS 1BL,002,187070,Staff,4,0,30,26
1683695141393,PHYS 1C,A00,187082,Staff,29,0,120,91
1683695142421,PHYS 1CL,001,187088,Staff,0,9,30,30
1683695142421,PHYS 1CL,002,187089,Staff,0,1,30,30
1683695142421,PHYS 1CL,009,262693,Staff,9,0,30,21
1683695143450,PHYS 2B,A01,187097,Staff,55,0,115,60
1683695144477,PHYS 2C,A01,187099,Staff,63,0,115,52
1683695145503,PHYS 2CL,A01,187101,Staff,5,0,28,23
1683695145503,PHYS 2CL,A02,187102,Staff,15,0,28,13
1683695146531,PHYS 2D,A01,187123,Shotwell; Brian,95,0,115,20
1683695147555,PHYS 4B,A01,187133,Grinstein; Benjamin,35,0,50,15
1683695148583,POLI 10,A00,188819,Staff,0,4,50,50
1683695149609,POLI 11,A00,188827,Staff,43,0,50,7
1683695150633,POLI 13R,A00,188828,Staff,0,1,20,20
1683695151661,POLI 27,A01,188830,Elgin; Samuel Zincke,0,2,70,70
1683695152686,POLI 30,A00,188832,Desposato; Scott,30,0,50,20
1683695153709,POLI 102F,A00,188834,Staff,1,0,40,39
1683695154737,POLI 104A,A00,188852,Staff,12,0,30,18
1683695155762,POLI 104I,A00,188853,Staff,0,8,20,20
1683695156789,POLI 110B,A00,188854,Wiens; David,6,0,20,14
1683695157814,POLI 112A,A00,188855,Wiens; David,3,0,30,27
1683695158839,POLI 117R,A00,188856,Forman; Fonna,0,12,20,20
1683695159868,POLI 118,A00,188857,Ingham; Sean,8,0,20,12
1683695160893,POLI 120G,A00,188858,Staff,8,0,30,22
1683695161920,POLI 131CR,A00,188863,Hoston; Germaine,20,0,50,30
1683695162948,POLI 133,A00,188864,Nellis; Gareth Hb,44,0,50,6
1683695163973,POLI 134D,A00,188865,Desposato; Scott,27,0,30,3
1683695164998,POLI 142A,A00,188871,Gartzke; Erik,21,0,50,29
1683695166026,POLI 142K,A00,188874,Staff,38,0,50,12
1683695167051,POLI 143,A00,188940,Gartzke; Erik,16,0,30,14
1683695168075,POLI 153,A00,188943,Staff,2,0,20,18
1683695169162,POLI 160AA,A00,188944,Staff,10,0,40,30
1683695170185,POLI 170A,A00,188945,Staff,10,0,30,20
1683695172240,PSYC 1,A00,188952,Staff,36,0,90,54
1683695173268,PSYC 2,B00,188953,Staff,19,0,35,16
1683695174294,PSYC 6,A00,188970,Staff,47,0,60,13
1683695175318,PSYC 7,A00,188973,Staff,35,0,45,10
1683695176342,PSYC 60,A01,188980,Rickard; Timothy C.,42,0,60,18
1683695177366,PSYC 70,A01,189001,Steiner; Eric Tomas,21,0,45,24
1683695178391,PSYC 100,A00,189005,Lacefield; Katharine I,0,99,120,120
1683695179418,PSYC 102,A00,189008,Staff,7,0,30,23
1683695180447,PSYC 106,B00,189026,Gorman; Michael R.,27,0,60,33
1683695181473,PSYC 114,B01,189033,Winkielman; Piotr,0,31,30,30
1683695182500,PSYC 131,A00,189036,Anagnostaras; Stephan,0,43,60,60
1683695183526,PSYC 136,A00,189041,Lowe; Angela Beth,0,7,25,25
1683695184551,PSYC 137,A00,189057,Winkielman; Piotr,1,37,25,24
1683695185575,PSYC 144,A00,189107,Wixted; John T,0,11,50,50
1683695187624,PSYC 162,A00,189142,Staff,0,9,85,85
1683695188650,PSYC 172,A00,189144,Gorman; Michael R.,0,6,30,30
1683695190703,PSYC 179,A00,189146,Lacefield; Katharine I,0,88,120,120
1683695191732,PSYC 181,A00,189147,Anagnostaras; Stephan,0,44,90,90
1683695192757,PSYC 190R,A00,189148,Barner; David A.,0,23,80,80
1683695193783,PSYC 191,A00,189275,Rickard; Timothy C.,0,11,25,25
1683695194807,PSYC 193,A00,189276,Chapman; Eddie Nathaniel,0,1,0,4
1683695195837,PSYC 193L,A01,189281,Lowe; Angela Beth,8,0,20,12
1683695195837,PSYC 193L,B01,189285,Staff,28,0,35,7
1683695196861,RELI 149,A00,187137,Rahimi; Babak,6,0,40,34
1683695197885,SE 9,A01,187315,Staff,0,2,18,18
1683695198909,SE 101B,A00,187409,Staff,24,0,30,6
1683695199937,SE 110B,A00,187444,Staff,10,0,40,30
1683695200966,SE 130B,A00,187449,Staff,31,0,40,9
1683695201989,SE 150A,A00,187516,Staff,8,0,20,12
1683695203014,SE 154,A00,187528,Staff,29,0,50,21
1683695204038,SIO 3,A01,258171,Staff,35,0,40,5
1683695205062,SIO 10,A00,187144,Cook; Geoffrey W,1,7,75,74
1683695206086,SIO 45,A00,187152,Cook; Geoffrey W,0,7,100,100
1683695207110,SIO 109R,A00,194486,Staff,0,4,20,20
1683695209161,SIO 187,A01,187233,Kacev; David,12,0,40,28
1683695210185,SOCI 1,A01,258656,Thorpe; Charles Robert,28,0,30,2
1683695210185,SOCI 1,A02,258658,Thorpe; Charles Robert,30,0,30,0
1683695210185,SOCI 1,A03,258661,Thorpe; Charles Robert,25,0,25,0
1683695210185,SOCI 1,A04,258666,Thorpe; Charles Robert,22,0,25,3
1683695210185,SOCI 1,A05,258897,Thorpe; Charles Robert,22,0,25,3
1683695210185,SOCI 1,A06,258898,Thorpe; Charles Robert,25,0,25,0
1683695211209,SOCI 30,A01,258903,Pardo Guerra; Juan Pablo,14,0,30,16
1683695212236,SOCI 102,A00,258904,Staff,9,0,25,16
1683695213274,SOCI 106,A00,258905,Staff,19,0,25,6
1683695214299,SOCI 111,A00,258907,Ribas Norris; Janet Vanesa,26,0,30,4
1683695215327,SOCI 121R,A00,258908,Pardo Guerra; Juan Pablo,7,0,30,23
1683695216357,SOCI 126,A01,203330,Staff,14,0,20,6
1683695217381,SOCI 131,A00,258909,Thorpe; Charles Robert,30,0,60,30
1683695218404,SOCI 135,A00,258910,Payne; Christine Anna,0,13,30,30
1683695219428,SOCI 157,A00,258911,Staff,10,0,30,20
1683695220455,SOCI 184,A00,258912,Staff,25,0,30,5
1683695221481,SOCI 188D,A00,258913,Staff,22,0,30,8
1683695222505,SYN 2,001,187529,Staff,9,0,16,7
1683695222505,SYN 2,002,201452,Staff,1,21,16,15
1683695222505,SYN 2,003,201469,Staff,1,0,16,15
1683695223529,SYN 100,A01,187531,Staff,0,9,20,20
1683695223529,SYN 100,B01,201491,Staff,0,10,20,20
1683695224553,TDAC 1,A00,189286,Walsh; Kim C.,3,0,20,17
1683695224553,TDAC 1,B00,189287,Harting; Carla Kelso,10,0,20,10
1683695225583,TDAC 101,A00,189300,Walsh; Kim C.,16,0,20,4
1683695225583,TDAC 101,B00,189301,Harting; Carla Kelso,18,0,20,2
1683695226610,TDAC 102,A00,189304,Basso; Beatrice,14,0,20,6
1683695227637,TDAC 108,A00,189305,Staff,18,0,20,2
1683695228667,TDDE 131,A00,189310,Staff,19,0,20,1
1683695228667,TDDE 131,B00,189314,Staff,19,0,20,1
1683695228667,TDDE 131,C00,189315,Staff,48,0,50,2
1683695228667,TDDE 131,D00,189316,Staff,14,0,15,1
1683695228667,TDDE 131,E00,204841,Staff,20,0,20,0
1683695229692,TDGE 10,A00,189289,Staff,27,0,50,23
1683695229692,TDGE 10,B00,189290,Havis; Allan,0,1,50,50
1683695230717,TDGE 11,A00,189291,Fulton; Julia,0,4,50,50
1683695230717,TDGE 11,B00,189292,Staff,20,0,25,5
1683695230717,TDGE 11,C00,260270,Staff,0,0,0,0
1683695231742,TDGE 25,A00,189294,Staff,1,0,20,19
1683695232764,TDGE 124,A00,189318,Fulton; Julia,1,8,50,49
1683695233790,TDGE 125,A00,189319,Staff,13,0,25,12
1683695233790,TDGE 125,B00,189320,Staff,23,0,25,2
1683695234814,TDGE 127,A00,189322,Havis; Allan,0,0,50,50
1683695235838,TDHT 101,A00,189323,Staff,18,0,25,7
1683695235838,TDHT 101,B00,189324,Staff,25,0,25,0
1683695236868,TDHT 102,A00,189325,Staff,49,0,50,1
1683695237892,TDMV 1,A00,189295,Arcidiacono; Kristin,20,0,30,10
1683695237892,TDMV 1,B00,189296,Caligagan; Maria T.,24,0,30,6
1683695238916,TDMV 2,A00,189297,Sammartano; Tonnie,27,0,30,3
1683695238916,TDMV 2,B00,189299,Arcidiacono; Kristin,23,0,30,7
1683695239941,TDMV 3,A00,204998,Rincon; Alicia,22,0,30,8
1683695240965,TDMV 120,A00,189458,Sammartano; Tonnie,28,0,30,2
1683695241990,TDMV 138,A00,189541,Jun; Grace Shin Hae,20,0,40,20
1683695243013,TDMV 142,A00,189717,Caligagan; Tony,25,0,30,5
1683695243013,TDMV 142,B00,189718,Caligagan; Maria T.,25,0,30,5
1683695244038,TMC 2,A01,187533,Staff,25,0,25,0
1683695244038,TMC 2,A02,187534,Staff,25,0,25,0
1683695245061,USP 1,A01,187536,Kwak; Nancy,0,16,25,25
1683695246086,USP 5,A01,187538,Staff,8,0,25,17
1683695247110,USP 101,A00,199253,Staff,0,4,0,0
1683695248133,USP 124,A00,187562,Boomhower; Matthew Charles,0,0,30,30
1683695249157,USP 138,A00,187582,Staff,19,0,25,6
1683695250184,USP 152,A01,187597,Staff,3,0,25,22
1683695251209,USP 153,A00,187598,Staff,18,0,25,7
1683695252233,USP 168,A00,187607,Kwak; Nancy,2,0,5,3
1683695253261,USP 173,A00,187619,Staff,4,0,25,21
1683695254286,USP 181,A00,187638,Staff,0,4,25,25
1683695255314,VIS 103,A00,187650,Cruz; Edwin Teddy,17,0,75,58
1683695256339,VIS 110D,A00,187669,Staff,13,0,22,9
1683695257366,VIS 127C,A00,187720,Shen; Kuiyi,67,0,146,79
1683695258394,VIS 149,A00,187731,Yoldas; Pinar,2,14,22,20
1683695259420,VIS 151,A01,188091,Staff,22,0,34,12
1683695259420,VIS 151,A02,188092,Staff,11,0,34,23
1683695260446,VIS 160B,A00,188093,Stalbaum; Brett,0,1,10,10
1683695262495,WCWP 10B,A00,201720,Staff,0,0,5,5
1683695262495,WCWP 10B,B00,201722,Staff,0,0,6,6
1683695263522,WCWP 100,A00,201725,Gagnon; Jeffrey C,0,0,2,2
1683695263522,WCWP 100,B00,201727,Staff,0,4,15,15
1683695266653,ANBI 133,A00,258401,Wilder; Linnea Lorene,34,0,40,6
1683695267676,ANBI 140,A00,258395,Hrvoj Mihic; Branka,18,0,25,7
1683695268701,ANSC 120,A00,258402,Bialecki; Jon Anthony,26,0,40,14
1683695269729,ANSC 144,A00,258400,Staff,12,0,40,28
1683695271782,ANSC 166,A00,258396,Parish; Steven Martin,156,0,175,19
1683695272865,ANSC 180,A00,193533,Staff,8,0,20,12
1683695273891,ANSC 188,A00,258397,Jassal; Aftab,34,0,40,6
1683695274918,ANTH 3,A01,258316,Staff,23,0,30,7
1683695275943,ANTH 5,A00,258394,Semendeferi; Ekaterini,16,0,20,4
1683695276968,ANTH 21,A01,258331,Staff,4,0,40,36
1683695277993,ANTH 103,A00,258398,Varma; Saiba,15,0,25,10
1683695279018,AWP 10,001,202034,Staff,0,0,0,0
1683695279018,AWP 10,002,202035,Staff,0,0,0,0
1683695279018,AWP 10,003,202036,Staff,0,0,0,0
1683695279018,AWP 10,004,202037,Staff,0,0,0,0
1683695279018,AWP 10,005,202038,Staff,0,0,0,0
1683695279018,AWP 10,006,202039,Staff,0,0,0,0
1683695279018,AWP 10,007,202040,Staff,0,0,0,0
1683695279018,AWP 10,008,202041,Staff,0,0,0,0
1683695279018,AWP 10,009,202042,Staff,0,0,0,0
1683695279018,AWP 10,010,202043,Staff,0,0,0,0
1683695279018,AWP 10,011,202044,Staff,0,0,0,0
1683695279018,AWP 10,012,202045,Staff,0,0,0,0
1683695279018,AWP 10,013,202046,Staff,0,0,0,0
1683695279018,AWP 10,014,202047,Staff,0,0,0,0
1683695279018,AWP 10,015,202048,Staff,0,0,0,0
1683695279018,AWP 10,016,202049,Staff,0,0,0,0
1683695279018,AWP 10,017,202050,Staff,0,0,0,0
1683695279018,AWP 10,018,202051,Staff,0,0,0,0
1683695279018,AWP 10,019,202052,Staff,0,0,0,0
1683695279018,AWP 10,020,202053,Staff,0,0,0,0
1683695279018,AWP 10,021,202054,Staff,0,0,0,0
1683695279018,AWP 10,022,202055,Staff,0,0,0,0
1683695279018,AWP 10,023,202056,Staff,0,0,0,0
1683695279018,AWP 10,024,202057,Staff,0,0,0,0
1683695279018,AWP 10,025,202058,Staff,0,0,0,0
1683695279018,AWP 10,026,202059,Staff,0,0,0,0
1683695280042,AWP 102,001,202032,Staff,0,0,0,0
1683695280042,AWP 102,002,202033,Staff,0,0,0,0
1683695281066,BENG 100,A01,254234,Taylor Amos; Alyssa C,31,0,40,9
1683695282090,BENG 196,001,270013,Engler; Adam J.,9999,0,9999,0
1683695283115,BICD 100R,A01,202018,Smith; Laurie,0,7,32,32
1683695283115,BICD 100R,A02,202019,Smith; Laurie,0,3,32,32
1683695283115,BICD 100R,A03,202020,Smith; Laurie,0,1,32,32
1683695283115,BICD 100R,A04,202021,Smith; Laurie,6,0,32,26
1683695283115,BICD 100R,A05,202022,Smith; Laurie,10,0,32,22
1683695284142,BICD 136,A01,193242,Gustafson-Brown; Cindy,0,2,32,32
1683695284142,BICD 136,A02,193244,Gustafson-Brown; Cindy,13,0,32,19
1683695285171,BIEB 102,A01,193249,Butler; Shannon Rhey,1,1,32,31
1683695285171,BIEB 102,A02,193251,Butler; Shannon Rhey,0,0,32,32
1683695285171,BIEB 102,A03,193253,Butler; Shannon Rhey,0,0,32,32
1683695285171,BIEB 102,A04,193255,Butler; Shannon Rhey,13,0,32,19
1683695285171,BIEB 102,A05,193265,Butler; Shannon Rhey,25,0,32,7
1683695285171,BIEB 102,A06,193269,Butler; Shannon Rhey,12,0,32,20
1683695287222,BIEB 150,A01,193274,Staff,0,0,32,32
1683695287222,BIEB 150,A02,193285,Staff,24,0,32,8
1683695288245,BIEB 194,A00,193286,Kurle; Carolyn M.,19,0,32,13
1683695289270,BILD 1,A01,192291,Staff,15,0,32,17
1683695289270,BILD 1,A02,192292,Staff,30,0,32,2
1683695289270,BILD 1,B01,192520,Reuther; Keefe,0,1,0,0
1683695289270,BILD 1,B02,192532,Reuther; Keefe,0,1,0,0
1683695290305,BILD 3,A01,192556,Butler; Shannon Rhey,0,0,32,32
1683695290305,BILD 3,A02,192581,Butler; Shannon Rhey,0,1,32,32
1683695290305,BILD 3,A03,192611,Butler; Shannon Rhey,19,0,32,13
1683695290305,BILD 3,A04,192612,Butler; Shannon Rhey,23,0,32,9
1683695290305,BILD 3,A05,192613,Butler; Shannon Rhey,26,0,32,6
1683695290305,BILD 3,A06,192679,Butler; Shannon Rhey,27,0,32,5
1683695290305,BILD 3,A07,192682,Butler; Shannon Rhey,20,0,32,12
1683695291333,BILD 4,A01,192836,Reuther; Keefe,1,0,24,23
1683695291333,BILD 4,A02,193044,Reuther; Keefe,4,0,24,20
1683695292358,BILD 10,A01,193142,Gustafson-Brown; Cindy,29,0,32,3
1683695292358,BILD 10,A02,193149,Gustafson-Brown; Cindy,31,0,32,1
1683695293382,BIMM 100,A01,193301,Staff,0,6,32,32
1683695293382,BIMM 100,A02,193312,Staff,0,7,32,32
1683695293382,BIMM 100,A03,193323,Staff,0,10,32,32
1683695294410,BIMM 101,A01,193329,McDonnell; Lisa Marie,1,4,24,23
1683695294410,BIMM 101,A02,193339,McDonnell; Lisa Marie,1,4,24,23
1683695294410,BIMM 101,B01,193354,McDonnell; Lisa Marie,0,4,24,24
1683695294410,BIMM 101,B02,193357,McDonnell; Lisa Marie,0,3,24,24
1683695295439,BIMM 110,A01,193377,Tat; John,0,11,32,32
1683695295439,BIMM 110,A02,193378,Tat; John,0,11,32,32
1683695296463,BIMM 120,A01,206116,Staff,0,0,32,32
1683695296463,BIMM 120,A02,206117,Staff,7,0,32,25
1683695296463,BIMM 120,A03,206121,Staff,21,0,32,11
1683695297492,BIPN 100,A01,193393,Park; Ji Young,0,15,32,32
1683695297492,BIPN 100,A02,193402,Park; Ji Young,0,14,32,32
1683695297492,BIPN 100,A03,193413,Park; Ji Young,0,14,32,32
1683695297492,BIPN 100,A04,193414,Park; Ji Young,0,13,32,32
1683695298517,BIPN 102,A01,193429,Staff,0,0,32,32
1683695298517,BIPN 102,A02,193438,Staff,18,0,32,14
1683695299545,BIPN 106,A01,193450,Reyes Gonzalez; Catalina,0,2,40,40
1683695300570,BIPN 134,A01,193465,Cooke; James Edward,0,0,32,32
1683695300570,BIPN 134,A02,193474,Cooke; James Edward,25,0,32,7
1683695300570,BIPN 134,A03,193485,Cooke; James Edward,29,0,32,3
1683695300570,BIPN 134,A04,193486,Cooke; James Edward,20,0,32,12
1683695300570,BIPN 134,A05,193491,Cooke; James Edward,31,0,32,1
1683695300570,BIPN 134,A06,193501,Cooke; James Edward,30,0,32,2
1683695300570,BIPN 134,A07,193510,Cooke; James Edward,29,0,32,3
1683695302623,BISP 194,A00,222522,Staff,14,0,32,18
1683695303650,CAT 124,A01,202407,Staff,19,0,25,6
1683695304678,CAT 125,A00,202408,Marchisotto; Jennifer Anne,2,0,20,18
1683695305703,CAT 125R,A00,202409,Smith; Lauryn Alissa,0,11,20,20
1683695305703,CAT 125R,B00,202410,Morales; Celeste Georgianna,0,11,20,20
1683695305703,CAT 125R,C00,202411,Irwin; Matthew Joseph,0,12,20,20
1683695306729,CENG 15,A01,204712,Yang; Kesong,0,1,0,0
1683695307756,CENG 114,A00,202070,Jahed Motlagh; Zeinab,5,0,20,15
1683695308783,CGS 105,A00,185477,Wesling; Megan E.,24,0,40,16
1683695309807,CGS 106,A00,185494,Staff,11,0,22,11
1683695310832,CGS 108,A00,185495,Staff,14,0,20,6
1683695311857,CGS 114,A00,185496,Staff,13,0,18,5
1683695312881,CGS 119,A00,185501,Staff,15,0,20,5
1683695313904,CGS 120,A00,185511,Staff,12,0,20,8
1683695314930,CHEM 4,A01,184675,Bussey; Thomas J,97,0,100,3
1683695315958,CHEM 6A,A01,184677,Staff,32,0,60,28
1683695316985,CHEM 6B,A01,184679,Staff,63,0,100,37
1683695318010,CHEM 6C,A01,184681,Bussey; Thomas J,0,0,50,50
1683695318010,CHEM 6C,A02,184682,Bussey; Thomas J,32,0,50,18
1683695319035,CHEM 40A,A01,184684,Albizati; Kim F.,33,0,100,67
1683695320060,CHEM 40B,A01,184686,Albizati; Kim F.,0,22,100,100
1683695321090,CHEM 41B,A01,184690,Staff,51,0,100,49
1683695322117,COGS 3,A01,184715,Boyle; Mary E. T.,0,27,40,40
1683695323141,COGS 14B,A01,185172,Staff,0,14,38,38
1683695324164,COGS 18,A01,184736,Staff,14,0,80,66
1683695325188,COGS 100,A01,184932,Staff,0,8,73,73
1683695326211,COGS 101A,A01,184935,Staff,0,40,30,30
1683695327239,COGS 101B,A01,184944,Staff,0,2,30,30
1683695328266,COGS 101C,A01,184946,Staff,0,10,30,30
1683695329296,COGS 102A,A01,184951,Johnson; Christine M.,1,0,40,39
1683695330321,COGS 107B,A01,184953,Mooshagian; Eric Frederick,0,52,40,40
1683695331347,COGS 118B,A01,184959,Gupta; Anjum,0,50,40,40
1683695332374,COGS 153,A00,184961,Staff,0,16,30,30
1683695333399,COGS 177,A00,184962,Staff,1,21,30,29
1683695334425,COGS 187A,A01,184969,Boyle; Mary E. T.,0,19,40,40
1683695335450,COMM 10,A01,185174,Staff,0,5,25,25
1683695335450,COMM 10,A02,185189,Staff,0,2,25,25
1683695335450,COMM 10,A03,269821,Staff,0,1,0,0
1683695336474,COMM 100B,A02,185476,Staff,10,0,25,15
1683695336474,COMM 100B,A03,277340,Staff,25,0,25,0
1683695337500,COMM 100C,A01,185314,Staff,2,0,25,23
1683695337500,COMM 100C,A02,185327,Staff,17,0,25,8
1683695338525,COMM 110M,A00,185349,Staff,0,0,40,40
1683695339549,COMM 113T,A00,185352,Staff,25,0,40,15
1683695340572,COMM 114I,A00,185353,Staff,31,0,40,9
1683695341595,COMM 131,A00,185354,Staff,17,0,30,13
1683695342622,CSE 8A,A50,185358,Cao; Yingjun,0,46,10,10
1683695343647,CSE 8B,A01,185362,Staff,0,48,50,50
1683695344672,CSE 11,A01,185416,Cao; Yingjun,0,91,10,10
1683695345699,CSE 20,A01,185445,Briones; Jor-el Thomas Caparas,3,0,25,22
1683695346723,CSE 21,A01,185447,Staff,9,0,50,41
1683695347747,CSE 101,A01,185451,Staff,0,13,50,50
1683695347747,CSE 101,B01,185453,Jones; Miles E,0,14,50,50
1683695349794,CSE 141,A01,185458,Eldon; John,16,0,100,84
1683695350822,CSE 141L,A01,185461,Eldon; John,8,0,100,92
1683695351847,CSE 142,A01,185463,Staff,34,0,60,26
1683695351847,CSE 142,B01,201355,Staff,0,7,60,60
1683695352870,CSE 142L,A01,185470,Staff,34,0,60,26
1683695352870,CSE 142L,B01,201417,Staff,0,6,60,60
1683695353893,CSE 190,A00,201433,Staff,32,0,49,17
1683695354917,DOC 1,A01,259136,Strom; Megan C.,7,0,15,8
1683695354917,DOC 1,A02,259137,Strom; Megan C.,14,0,15,1
1683695354917,DOC 1,A03,259138,Strom; Megan C.,14,0,15,1
1683695354917,DOC 1,A04,259139,Strom; Megan C.,14,0,15,1
1683695355941,DOC 100D,A00,259140,Pass; Natalye Joann,14,0,25,11
1683695356965,DSGN 1,A01,184749,Rill; Bryan,0,26,30,30
1683695357989,DSGN 100,A01,185168,Staff,0,2,25,25
1683695359016,ECE 5,A01,185626,Morris; Karcher William,0,12,0,0
1683695360042,ECE 101,A01,185628,Staff,14,0,70,56
1683695361068,ECE 107,A01,185635,Baghdadchi; Saharnaz,0,0,20,20
1683695361068,ECE 107,A02,185638,Baghdadchi; Saharnaz,1,0,20,19
1683695362095,ECE 148,A01,185647,Silberman; Jack,0,0,16,16
1683695363121,ECON 1,A01,185537,Crane; Meredith Helen,54,0,70,16
1683695364149,ECON 3,A01,185549,Crane; Meredith Helen,30,0,70,40
1683695365175,ECON 4,A01,203354,Anderson; John Charles,0,5,10,10
1683695366200,ECON 100A,A01,185574,Staff,0,5,40,40
1683695367224,ECON 100B,A01,185576,Staff,0,12,50,50
1683695368250,ECON 100C,A01,185589,Newhouse; Herbert S,30,0,70,40
1683695369276,ECON 105,A00,185608,Vespa; Emanuel Ignacio,19,0,35,16
1683695370299,ECON 109,A01,185610,Shishkin; Denis,9,0,35,26
1683695371322,ECON 110A,A01,185612,Staff,8,0,40,32
1683695372350,ECON 120A,A01,185615,Staff,19,0,40,21
1683695373375,ECON 120C,A01,185617,Sun; Yixiao,0,21,70,70
1683695374398,ECON 144,A00,203346,Squires; Dale E,2,0,35,33
1683695375423,ECON 171,A01,203349,Newhouse; Herbert S,0,1,35,35
1683695376504,ECON 173A,A01,185621,Toda; Alexis Akira,21,0,35,14
1683695377529,EDS 25,A01,202413,Staff,0,1,0,0
1683695377529,EDS 25,A02,202414,Staff,0,1,0,0
1683695377529,EDS 25,A03,202415,Staff,0,0,0,0
1683695377529,EDS 25,A04,202416,Staff,0,1,0,0
1683695377529,EDS 25,A05,202439,Staff,0,0,0,0
1683695377529,EDS 25,A06,202440,Staff,0,0,0,0
1683695377529,EDS 25,B01,202631,Staff,0,0,0,0
1683695377529,EDS 25,B02,202632,Staff,0,0,0,0
1683695377529,EDS 25,B03,202639,Staff,0,0,0,0
1683695377529,EDS 25,B04,202640,Staff,0,0,0,0
1683695377529,EDS 25,B05,202643,Staff,0,0,0,0
1683695377529,EDS 25,B06,202644,Staff,0,0,0,0
1683695378554,EDS 38,A01,202659,Black; Alison Michelle,24,0,25,1
1683695379579,EDS 115,A00,202652,Staff,18,0,30,12
1683695380603,EDS 125,A00,202649,Staff,13,0,30,17
1683695381627,EDS 126,A01,203332,Staff,30,0,30,0
1683695382653,EDS 139,A00,202838,Staff,16,0,25,9
1683695383677,EDS 146,A01,202655,Staff,14,0,25,11
1683695384705,ENG 15,A00,185667,Staff,0,1,0,0
1683695384705,ENG 15,B00,185672,Staff,0,0,0,0
1683695384705,ENG 15,C00,185675,Staff,0,0,0,0
1683695384705,ENG 15,D00,185682,Staff,0,0,0,0
1683695384705,ENG 15,E00,185684,Staff,0,0,0,0
1683695385730,ETHN 103,A00,185710,Staff,0,8,35,35
1683695386755,ETHN 103A,A00,199228,Man; Simeon S,0,0,9,9
1683695387781,ETHN 109,A00,185711,Staff,15,0,35,20
1683695388811,ETHN 142,A00,185726,Staff,0,4,30,30
1683695389838,ETHN 163J,A00,199229,Man; Simeon S,5,0,8,3
1683695390861,ETHN 168,A00,185727,Staff,7,0,10,3
1683695391884,ETHN 182,A00,185728,Staff,0,0,35,35
1683695392908,ETHN 183,A00,185737,Staff,9,0,18,9
1683695393934,GLBH 111,A01,209361,Burgos; Jose L.,0,0,0,0
1683695395984,HIEU 104,A00,185792,Staff,14,0,20,6
1683695397011,HIEU 115,A00,185800,Staff,0,0,20,20
1683695398038,HIEU 128,A00,185801,Staff,0,9,20,20
1683695399066,HIEU 147,A00,185802,Staff,15,0,20,5
1683695400095,HIEU 154,A00,185823,Staff,11,0,20,9
1683695401118,HILA 102,A00,185826,Staff,14,0,20,6
1683695402146,HILD 2C,A01,185778,Staff,0,13,20,20
1683695403174,HILD 7B,A01,185780,Kwak; Nancy,0,17,32,32
1683695403174,HILD 7B,A02,185781,Kwak; Nancy,0,18,32,32
1683695404198,HILD 30,A01,185791,Staff,12,0,20,8
1683695405225,HISC 119,A00,185830,Golan; Tal,0,10,20,20
1683695406251,HITO 156GS,A00,185831,Patterson; Patrick H.,0,0,0,23
1683695407280,HIUS 103,A00,185832,Man; Simeon S,0,4,20,20
1683695408307,HIUS 117,A00,185836,Kwak; Nancy,2,0,20,18
1683695409333,HIUS 125,A00,185840,Man; Simeon S,0,2,23,23
1683695410360,HIUS 149,A00,185845,Staff,1,0,20,19
1683695411386,HUM 3,A01,185882,Zavodny; Tatiana Sophia,0,8,50,50
1683695411386,HUM 3,B01,185899,Caldwell; Michael Alan,0,18,50,50
1683695412410,HUM 3GS,A00,185900,Patterson; Patrick H.,0,0,0,23
1683695413433,HUM 4,A01,185938,Zroka; Amy Liane,28,0,50,22
1683695413433,HUM 4,B01,185956,Watkins; Eric,0,6,50,50
1683695413433,HUM 4,B02,202209,Watkins; Eric,0,5,50,50
1683695413433,HUM 4,B03,202210,Watkins; Eric,0,5,50,50
1683695414461,HUM 5,A01,185958,West; Geoffrey Scott,0,0,50,50
1683695414461,HUM 5,A02,202215,West; Geoffrey Scott,0,1,50,50
1683695415488,INTL 190,A00,185959,Gagnon; Jeffrey C,0,0,0,9
1683695415488,INTL 190,B00,185960,Lettieri; Michael Joseph,0,0,0,2
1683695416510,JAPN 180,A00,254509,Staff,5,0,30,25
1683695417539,LATI 10,A01,202853,Kennemore; Amy Michelle,4,0,35,31
1683695417539,LATI 10,A02,202854,Kennemore; Amy Michelle,3,0,35,32
1683695417539,LATI 10,A03,270054,Kennemore; Amy Michelle,30,0,30,0
1683695418563,LATI 180,A00,202855,Kennemore; Amy Michelle,11,0,20,9
1683695419591,LAWS 101,A00,201767,Golan; Tal,0,7,40,40
1683695420622,LIFR 1C,A00,185961,Staff,6,0,20,14
1683695421646,LIFR 1CX,A00,185962,Staff,7,0,20,13
1683695422670,LIFR 1D,A00,185963,Staff,7,0,20,13
1683695423693,LIFR 1DX,A00,185964,Staff,7,0,20,13
1683695424722,LIGN 101,A01,186039,Staff,43,0,50,7
1683695425745,LIGN 165,A00,186040,Staff,15,0,50,35
1683695426770,LTCS 108,A00,186041,Staff,5,0,10,5
1683695427797,LTCS 119,A00,186042,Staff,15,0,20,5
1683695428822,LTCS 130,A00,186043,Wesling; Megan E.,15,0,25,10
1683695430873,LTEA 138,A00,186119,Staff,14,0,40,26
1683695431901,LTEN 124,A00,186148,Staff,5,0,25,20
1683695432926,LTEN 178,A00,186149,Staff,6,0,15,9
1683695433952,LTEN 181,A00,186150,Blanco; John D,34,0,40,6
1683695434980,LTWL 120,A00,186160,Staff,19,0,25,6
1683695436002,LTWL 165,A00,186161,Staff,22,0,25,3
1683695437025,LTWR 100,A00,186162,Staff,0,5,15,15
1683695438049,LTWR 102,A00,186163,Doller; Ben,5,0,15,10
1683695439073,MAE 8,A01,186412,Staff,0,1,0,0
1683695440096,MAE 30B,A00,186445,Bahadori; Mohammad Yousef,81,0,100,19
1683695441260,MAE 40,A00,186592,Bewley; Thomas R,10,0,50,40
1683695442285,MAE 101B,A00,186593,Bahadori; Mohammad Yousef,80,0,100,20
1683695443310,MAE 105,A00,186594,Bandaru; Prabhakar,10,0,50,40
1683695444334,MAE 107,A00,186599,Pham; Hieu Tan,0,7,120,120
1683695445357,MAE 148,A01,186660,Silberman; Jack,3,0,16,13
1683695446384,MATH 10A,A01,188095,Staff,0,6,35,35
1683695447413,MATH 10B,A01,188097,Bowers; Adam R.,0,12,30,30
1683695447413,MATH 10B,A02,188099,Bowers; Adam R.,0,11,30,30
1683695447413,MATH 10B,B01,188104,Bowers; Adam R.,0,10,30,30
1683695447413,MATH 10B,B02,188106,Bowers; Adam R.,1,10,30,29
1683695448440,MATH 10C,A01,188111,Staff,0,20,30,30
1683695448440,MATH 10C,A02,188127,Staff,0,19,30,30
1683695448440,MATH 10C,A03,188131,Staff,0,19,30,30
1683695448440,MATH 10C,B01,188218,Staff,17,0,30,13
1683695448440,MATH 10C,B02,188244,Staff,13,0,30,17
1683695448440,MATH 10C,B03,188277,Staff,14,0,30,16
1683695449470,MATH 18,A01,188344,Bach; Quang Tran,18,0,30,12
1683695449470,MATH 18,A02,188345,Bach; Quang Tran,11,0,30,19
1683695449470,MATH 18,B01,188353,Bach; Quang Tran,11,0,30,19
1683695449470,MATH 18,B02,188354,Bach; Quang Tran,19,0,30,11
1683695450493,MATH 20A,A01,188374,Staff,11,0,35,24
1683695451518,MATH 20B,A01,188382,Ohm; Ko Woon,7,0,30,23
1683695451518,MATH 20B,A02,188383,Ohm; Ko Woon,22,0,30,8
1683695451518,MATH 20B,B01,188385,Ohm; Ko Woon,7,0,30,23
1683695451518,MATH 20B,B02,188392,Ohm; Ko Woon,22,0,30,8
1683695452543,MATH 20C,A01,188394,Harel; Guershon,10,0,30,20
1683695452543,MATH 20C,A02,188395,Harel; Guershon,13,0,30,17
1683695452543,MATH 20C,B01,188404,Harel; Guershon,5,0,30,25
1683695452543,MATH 20C,B02,188405,Harel; Guershon,18,0,30,12
1683695453570,MATH 20D,A01,188414,Hammock; Frances H,0,1,30,30
1683695453570,MATH 20D,A02,188415,Hammock; Frances H,0,1,30,30
1683695453570,MATH 20D,B01,188447,Hammock; Frances H,0,1,30,30
1683695453570,MATH 20D,B02,188486,Hammock; Frances H,2,0,30,28
1683695454599,MATH 20E,A01,188649,Staff,21,0,30,9
1683695454599,MATH 20E,A02,188650,Staff,20,0,30,10
1683695454599,MATH 20E,A03,188673,Staff,0,0,30,30
1683695455623,MATH 102,A01,188675,Staff,0,40,35,35
1683695456647,MATH 103B,A01,188681,Staff,3,0,35,32
1683695456647,MATH 103B,B01,188692,Staff,5,0,35,30
1683695457674,MATH 109,A01,188695,Salehi Golsefidy; Alireza,24,0,35,11
1683695457674,MATH 109,A02,188696,Salehi Golsefidy; Alireza,25,0,35,10
1683695458699,MATH 120A,A01,188698,Eggers; John Dietrich,7,0,35,28
1683695459725,MATH 142B,A01,188736,Ioana; Adrian,1,1,30,29
1683695459725,MATH 142B,A02,188741,Ioana; Adrian,0,1,30,30
1683695459725,MATH 142B,A03,188743,Ioana; Adrian,0,2,30,30
1683695460749,MATH 168A,A01,188790,Staff,0,11,35,35
1683695461778,MATH 170A,A01,188803,Nie; Jiawang,0,2,35,35
1683695461778,MATH 170A,A02,188811,Nie; Jiawang,0,1,35,35
1683695461778,MATH 170A,A03,188814,Nie; Jiawang,0,0,35,35
1683695461778,MATH 170A,A04,188815,Nie; Jiawang,5,0,35,30
1683695462805,MATH 193B,A01,188817,Staff,0,0,35,35
1683695462805,MATH 193B,A02,188818,Staff,6,0,35,29
1683695463828,MGT 4,A01,202857,Anderson; John Charles,59,0,80,21
1683695464856,MGT 12,A00,202858,Lindenberger; Wade Douglas,40,0,90,50
1683695465882,MGT 18,A00,202859,Staff,74,0,90,16
1683695466911,MGT 18GS,A00,202860,McKay; Michael J,13,0,28,15
1683695467934,MGT 45,A00,202861,Pecore; Joseph P.,8,0,90,82
1683695468956,MGT 100,A00,202863,Yavorsky; Daniel Ryan,27,0,90,63
1683695469980,MGT 103,A00,202864,Ehrich; Kristine R,0,19,90,90
1683695471007,MGT 112,A00,202865,Ehrich; Kristine R,15,0,90,75
1683695472031,MGT 121A,A00,202868,Staff,90,20,90,0
1683695473058,MGT 131B,A00,202869,Anderson; John Charles,58,0,90,32
1683695474083,MGT 136,A00,202871,Lindenberger; Wade Douglas,83,0,90,7
1683695475107,MGT 164,A00,202873,Staff,0,67,90,91
1683695476131,MGT 164GS,A00,202874,McKay; Mary A,13,0,28,15
1683695477160,MGT 180,A00,202875,Staff,0,51,90,91
1683695478185,MMW 11R,A01,205019,Herbst; Matthew,0,0,30,30
1683695478185,MMW 11R,A02,205026,Herbst; Matthew,29,0,30,1
1683695479210,MMW 15,A01,193512,Chang; Edmond Yi-Teh,0,8,28,28
1683695479210,MMW 15,A02,193513,Chang; Edmond Yi-Teh,0,5,28,28
1683695479210,MMW 15,A03,193514,Chang; Edmond Yi-Teh,0,5,28,28
1683695479210,MMW 15,A04,193515,Chang; Edmond Yi-Teh,0,5,28,28
1683695479210,MMW 15,A05,193516,Chang; Edmond Yi-Teh,0,5,28,28
1683695479210,MMW 15,A06,193517,Chang; Edmond Yi-Teh,0,6,28,28
1683695479210,MMW 15,B01,193519,Chang; Edmond Yi-Teh,0,5,28,28
1683695479210,MMW 15,B02,193520,Chang; Edmond Yi-Teh,0,5,28,28
1683695479210,MMW 15,B03,193521,Chang; Edmond Yi-Teh,0,5,28,28
1683695479210,MMW 15,B04,193522,Chang; Edmond Yi-Teh,0,6,28,28
1683695479210,MMW 15,B05,193523,Chang; Edmond Yi-Teh,0,5,28,28
1683695479210,MMW 15,B06,193524,Chang; Edmond Yi-Teh,0,5,28,28
1683695480305,MMW 122,A01,193526,Rahimi; Babak,0,16,28,28
1683695480305,MMW 122,A02,193527,Rahimi; Babak,0,15,28,28
1683695480305,MMW 122,A03,193528,Rahimi; Babak,0,0,0,0
1683695480305,MMW 122,A04,193529,Rahimi; Babak,0,0,0,0
1683695481333,MUS 1A,A01,186663,Staff,1,19,35,34
1683695482359,MUS 4,A01,186715,Staff,0,12,35,35
1683695483387,MUS 5R,A01,186796,Dubnov; Shlomo,0,17,35,35
1683695484413,MUS 6,A01,186798,Staff,1,5,25,24
1683695485439,MUS 7,A01,186830,Staff,11,0,35,24
1683695486465,MUS 8,A01,186930,Staff,0,27,35,35
1683695487490,MUS 15,A01,186932,Staff,0,15,35,35
1683695487490,MUS 15,B01,186934,Staff,1,17,35,34
1683695488513,MUS 80,A00,186935,Staff,0,0,20,20
1683695488513,MUS 80,B00,186936,Staff,24,0,25,1
1683695489540,NANO 11,A00,204702,Lipomi; Darren John,0,0,0,0
1683695490564,NANO 15,A01,204709,Yang; Kesong,0,1,0,0
1683695491588,NANO 114,A00,202069,Jahed Motlagh; Zeinab,2,0,10,8
1683695492614,PHIL 1,A00,186955,Grush; Rick Scott,31,0,40,9
1683695493641,PHIL 10,A01,186973,Grush; Rick Scott,27,0,35,8
1683695493641,PHIL 10,A02,186974,Grush; Rick Scott,33,0,35,2
1683695494668,PHIL 13,A01,186976,Staff,1,0,35,34
1683695494668,PHIL 13,A02,186977,Staff,16,0,35,19
1683695495693,PHIL 14,A01,186979,Staff,31,0,35,4
1683695495693,PHIL 14,A02,186986,Staff,32,0,35,3
1683695496723,PHIL 28,A01,186988,Staff,16,0,30,14
1683695496723,PHIL 28,A02,186989,Staff,1,0,30,29
1683695496723,PHIL 28,A03,186990,Staff,10,0,30,20
1683695496723,PHIL 28,A04,186991,Staff,26,0,30,4
1683695497747,PHIL 120,A00,186997,Staff,23,0,40,17
1683695498771,PHIL 137,A00,187003,Staff,7,0,40,33
1683695499796,PHIL 150,A00,187015,Staff,47,0,70,23
1683695500824,PHIL 167,A00,187021,Lamey; Andy M.,34,0,40,6
1683695501852,PHIL 174,A01,202226,Staff,17,0,20,3
1683695501852,PHIL 174,A02,202235,Staff,20,0,20,0
1683695502876,PHIL 191A,A00,258918,Staff,0,0,1,1
1683695503902,PHYS 1A,A00,187028,Staff,26,0,60,34
1683695504931,PHYS 1AL,001,187036,Staff,3,0,30,27
1683695504931,PHYS 1AL,002,187049,Staff,18,0,30,12
1683695505958,PHYS 1B,A00,187058,Staff,22,0,60,38
1683695506984,PHYS 1BL,001,187064,Staff,0,1,30,30
1683695506984,PHYS 1BL,002,187070,Staff,4,0,30,26
1683695508008,PHYS 1C,A00,187082,Staff,29,0,120,91
1683695509033,PHYS 1CL,001,187088,Staff,0,9,30,30
1683695509033,PHYS 1CL,002,187089,Staff,0,1,30,30
1683695509033,PHYS 1CL,009,262693,Staff,9,0,30,21
1683695510057,PHYS 2B,A01,187097,Staff,55,0,115,60
1683695511081,PHYS 2C,A01,187099,Staff,63,0,115,52
1683695512105,PHYS 2CL,A01,187101,Staff,5,0,28,23
1683695512105,PHYS 2CL,A02,187102,Staff,15,0,28,13
1683695513130,PHYS 2D,A01,187123,Shotwell; Brian,95,0,115,20
1683695514155,PHYS 4B,A01,187133,Grinstein; Benjamin,35,0,50,15
1683695515177,POLI 10,A00,188819,Staff,0,4,50,50
1683695516204,POLI 11,A00,188827,Staff,43,0,50,7
1683695517230,POLI 13R,A00,188828,Staff,0,1,20,20
1683695518257,POLI 27,A01,188830,Elgin; Samuel Zincke,0,2,70,70
1683695519284,POLI 30,A00,188832,Desposato; Scott,30,0,50,20
1683695520308,POLI 102F,A00,188834,Staff,1,0,40,39
1683695521332,POLI 104A,A00,188852,Staff,12,0,30,18
1683695522361,POLI 104I,A00,188853,Staff,0,8,20,20
1683695523387,POLI 110B,A00,188854,Wiens; David,6,0,20,14
1683695524413,POLI 112A,A00,188855,Wiens; David,3,0,30,27
1683695525437,POLI 117R,A00,188856,Forman; Fonna,0,12,20,20
1683695526460,POLI 118,A00,188857,Ingham; Sean,8,0,20,12
1683695527483,POLI 120G,A00,188858,Staff,8,0,30,22
1683695528510,POLI 131CR,A00,188863,Hoston; Germaine,20,0,50,30
1683695529536,POLI 133,A00,188864,Nellis; Gareth Hb,44,0,50,6
1683695530563,POLI 134D,A00,188865,Desposato; Scott,27,0,30,3
1683695531587,POLI 142A,A00,188871,Gartzke; Erik,21,0,50,29
1683695532611,POLI 142K,A00,188874,Staff,38,0,50,12
1683695533635,POLI 143,A00,188940,Gartzke; Erik,16,0,30,14
1683695534662,POLI 153,A00,188943,Staff,2,0,20,18
1683695535689,POLI 160AA,A00,188944,Staff,10,0,40,30
1683695536750,POLI 170A,A00,188945,Staff,10,0,30,20
1683695538798,PSYC 1,A00,188952,Staff,36,0,90,54
1683695539826,PSYC 2,B00,188953,Staff,19,0,35,16
1683695540849,PSYC 6,A00,188970,Staff,47,0,60,13
1683695541877,PSYC 7,A00,188973,Staff,35,0,45,10
1683695542901,PSYC 60,A01,188980,Rickard; Timothy C.,42,0,60,18
1683695543926,PSYC 70,A01,189001,Steiner; Eric Tomas,21,0,45,24
1683695544951,PSYC 100,A00,189005,Lacefield; Katharine I,0,99,120,120
1683695545978,PSYC 102,A00,189008,Staff,7,0,30,23
1683695547002,PSYC 106,B00,189026,Gorman; Michael R.,27,0,60,33
1683695548030,PSYC 114,B01,189033,Winkielman; Piotr,0,31,30,30
1683695549054,PSYC 131,A00,189036,Anagnostaras; Stephan,0,43,60,60
1683695550079,PSYC 136,A00,189041,Lowe; Angela Beth,0,7,25,25
1683695551104,PSYC 137,A00,189057,Winkielman; Piotr,1,37,25,24
1683695552127,PSYC 144,A00,189107,Wixted; John T,0,11,50,50
1683695554178,PSYC 162,A00,189142,Staff,0,9,85,85
1683695555202,PSYC 172,A00,189144,Gorman; Michael R.,0,6,30,30
1683695557255,PSYC 179,A00,189146,Lacefield; Katharine I,0,88,120,120
1683695558281,PSYC 181,A00,189147,Anagnostaras; Stephan,0,44,90,90
1683695559310,PSYC 190R,A00,189148,Barner; David A.,0,23,80,80
1683695560335,PSYC 191,A00,189275,Rickard; Timothy C.,0,11,25,25
1683695561359,PSYC 193,A00,189276,Chapman; Eddie Nathaniel,0,1,0,4
1683695562385,PSYC 193L,A01,189281,Lowe; Angela Beth,8,0,20,12
1683695562385,PSYC 193L,B01,189285,Staff,28,0,35,7
1683695563410,RELI 149,A00,187137,Rahimi; Babak,6,0,40,34
1683695564437,SE 9,A01,187315,Staff,0,2,18,18
1683695565463,SE 101B,A00,187409,Staff,24,0,30,6
1683695566486,SE 110B,A00,187444,Staff,10,0,40,30
1683695567510,SE 130B,A00,187449,Staff,31,0,40,9
1683695568535,SE 150A,A00,187516,Staff,8,0,20,12
1683695569563,SE 154,A00,187528,Staff,29,0,50,21
1683695570588,SIO 3,A01,258171,Staff,35,0,40,5
1683695571611,SIO 10,A00,187144,Cook; Geoffrey W,1,7,75,74
1683695572635,SIO 45,A00,187152,Cook; Geoffrey W,0,7,100,100
1683695573660,SIO 109R,A00,194486,Staff,0,4,20,20
1683695575714,SIO 187,A01,187233,Kacev; David,12,0,40,28
1683695576742,SOCI 1,A01,258656,Thorpe; Charles Robert,28,0,30,2
1683695576742,SOCI 1,A02,258658,Thorpe; Charles Robert,30,0,30,0
1683695576742,SOCI 1,A03,258661,Thorpe; Charles Robert,25,0,25,0
1683695576742,SOCI 1,A04,258666,Thorpe; Charles Robert,22,0,25,3
1683695576742,SOCI 1,A05,258897,Thorpe; Charles Robert,22,0,25,3
1683695576742,SOCI 1,A06,258898,Thorpe; Charles Robert,25,0,25,0
1683695577769,SOCI 30,A01,258903,Pardo Guerra; Juan Pablo,14,0,30,16
1683695578792,SOCI 102,A00,258904,Staff,9,0,25,16
1683695579822,SOCI 106,A00,258905,Staff,19,0,25,6
1683695580846,SOCI 111,A00,258907,Ribas Norris; Janet Vanesa,26,0,30,4
1683695581871,SOCI 121R,A00,258908,Pardo Guerra; Juan Pablo,7,0,30,23
1683695582898,SOCI 126,A01,203330,Staff,14,0,20,6
1683695583989,SOCI 131,A00,258909,Thorpe; Charles Robert,30,0,60,30
1683695585014,SOCI 135,A00,258910,Payne; Christine Anna,0,13,30,30
1683695586037,SOCI 157,A00,258911,Staff,10,0,30,20
1683695587060,SOCI 184,A00,258912,Staff,25,0,30,5
1683695588083,SOCI 188D,A00,258913,Staff,22,0,30,8
1683695589112,SYN 2,001,187529,Staff,9,0,16,7
1683695589112,SYN 2,002,201452,Staff,1,21,16,15
1683695589112,SYN 2,003,201469,Staff,1,0,16,15
1683695590135,SYN 100,A01,187531,Staff,0,9,20,20
1683695590135,SYN 100,B01,201491,Staff,0,10,20,20
1683695591161,TDAC 1,A00,189286,Walsh; Kim C.,3,0,20,17
1683695591161,TDAC 1,B00,189287,Harting; Carla Kelso,10,0,20,10
1683695592186,TDAC 101,A00,189300,Walsh; Kim C.,16,0,20,4
1683695592186,TDAC 101,B00,189301,Harting; Carla Kelso,18,0,20,2
1683695593210,TDAC 102,A00,189304,Basso; Beatrice,14,0,20,6
1683695594234,TDAC 108,A00,189305,Staff,18,0,20,2
1683695595259,TDDE 131,A00,189310,Staff,19,0,20,1
1683695595259,TDDE 131,B00,189314,Staff,19,0,20,1
1683695595259,TDDE 131,C00,189315,Staff,48,0,50,2
1683695595259,TDDE 131,D00,189316,Staff,14,0,15,1
1683695595259,TDDE 131,E00,204841,Staff,20,0,20,0
1683695596286,TDGE 10,A00,189289,Staff,27,0,50,23
1683695596286,TDGE 10,B00,189290,Havis; Allan,0,1,50,50
1683695597311,TDGE 11,A00,189291,Fulton; Julia,0,4,50,50
1683695597311,TDGE 11,B00,189292,Staff,20,0,25,5
1683695597311,TDGE 11,C00,260270,Staff,0,0,0,0
1683695598335,TDGE 25,A00,189294,Staff,1,0,20,19
1683695599359,TDGE 124,A00,189318,Fulton; Julia,1,8,50,49
1683695600385,TDGE 125,A00,189319,Staff,13,0,25,12
1683695600385,TDGE 125,B00,189320,Staff,23,0,25,2
1683695601410,TDGE 127,A00,189322,Havis; Allan,0,0,50,50
1683695602434,TDHT 101,A00,189323,Staff,18,0,25,7
1683695602434,TDHT 101,B00,189324,Staff,25,0,25,0
1683695603461,TDHT 102,A00,189325,Staff,49,0,50,1
1683695604488,TDMV 1,A00,189295,Arcidiacono; Kristin,20,0,30,10
1683695604488,TDMV 1,B00,189296,Caligagan; Maria T.,24,0,30,6
1683695605514,TDMV 2,A00,189297,Sammartano; Tonnie,27,0,30,3
1683695605514,TDMV 2,B00,189299,Arcidiacono; Kristin,23,0,30,7
1683695606538,TDMV 3,A00,204998,Rincon; Alicia,22,0,30,8
1683695607563,TDMV 120,A00,189458,Sammartano; Tonnie,28,0,30,2
1683695608591,TDMV 138,A00,189541,Jun; Grace Shin Hae,20,0,40,20
1683695609617,TDMV 142,A00,189717,Caligagan; Tony,25,0,30,5
1683695609617,TDMV 142,B00,189718,Caligagan; Maria T.,25,0,30,5
1683695610645,TMC 2,A01,187533,Staff,25,0,25,0
1683695610645,TMC 2,A02,187534,Staff,25,0,25,0
1683695611673,USP 1,A01,187536,Kwak; Nancy,0,16,25,25
1683695612703,USP 5,A01,187538,Staff,8,0,25,17
1683695613728,USP 101,A00,199253,Staff,0,4,0,0
1683695614758,USP 124,A00,187562,Boomhower; Matthew Charles,0,0,30,30
1683695615785,USP 138,A00,187582,Staff,19,0,25,6
1683695616817,USP 152,A01,187597,Staff,3,0,25,22
1683695617842,USP 153,A00,187598,Staff,18,0,25,7
1683695618866,USP 168,A00,187607,Kwak; Nancy,2,0,5,3
1683695619889,USP 173,A00,187619,Staff,4,0,25,21
1683695620912,USP 181,A00,187638,Staff,0,4,25,25
1683695621936,VIS 103,A00,187650,Cruz; Edwin Teddy,17,0,75,58
1683695622959,VIS 110D,A00,187669,Staff,13,0,22,9
1683695623983,VIS 127C,A00,187720,Shen; Kuiyi,67,0,146,79
1683695625007,VIS 149,A00,187731,Yoldas; Pinar,2,14,22,20
1683695626032,VIS 151,A01,188091,Staff,22,0,34,12
1683695626032,VIS 151,A02,188092,Staff,11,0,34,23
1683695627060,VIS 160B,A00,188093,Stalbaum; Brett,0,1,10,10
1683695629114,WCWP 10B,A00,201720,Staff,0,0,5,5
1683695629114,WCWP 10B,B00,201722,Staff,0,0,6,6
1683695630142,WCWP 100,A00,201725,Gagnon; Jeffrey C,0,0,2,2
1683695630142,WCWP 100,B00,201727,Staff,0,4,15,15
1683695633266,ANBI 133,A00,258401,Wilder; Linnea Lorene,34,0,40,6
1683695634290,ANBI 140,A00,258395,Hrvoj Mihic; Branka,18,0,25,7
1683695635318,ANSC 120,A00,258402,Bialecki; Jon Anthony,26,0,40,14
1683695636343,ANSC 144,A00,258400,Staff,12,0,40,28
1683695638391,ANSC 166,A00,258396,Parish; Steven Martin,156,0,175,19
1683695639415,ANSC 180,A00,193533,Staff,8,0,20,12
1683695640442,ANSC 188,A00,258397,Jassal; Aftab,34,0,40,6
1683695641469,ANTH 3,A01,258316,Staff,23,0,30,7
1683695642495,ANTH 5,A00,258394,Semendeferi; Ekaterini,16,0,20,4
1683695643518,ANTH 21,A01,258331,Staff,4,0,40,36
1683695644542,ANTH 103,A00,258398,Varma; Saiba,15,0,25,10
1683695645567,AWP 10,001,202034,Staff,0,0,0,0
1683695645567,AWP 10,002,202035,Staff,0,0,0,0
1683695645567,AWP 10,003,202036,Staff,0,0,0,0
1683695645567,AWP 10,004,202037,Staff,0,0,0,0
1683695645567,AWP 10,005,202038,Staff,0,0,0,0
1683695645567,AWP 10,006,202039,Staff,0,0,0,0
1683695645567,AWP 10,007,202040,Staff,0,0,0,0
1683695645567,AWP 10,008,202041,Staff,0,0,0,0
1683695645567,AWP 10,009,202042,Staff,0,0,0,0
1683695645567,AWP 10,010,202043,Staff,0,0,0,0
1683695645567,AWP 10,011,202044,Staff,0,0,0,0
1683695645567,AWP 10,012,202045,Staff,0,0,0,0
1683695645567,AWP 10,013,202046,Staff,0,0,0,0
1683695645567,AWP 10,014,202047,Staff,0,0,0,0
1683695645567,AWP 10,015,202048,Staff,0,0,0,0
1683695645567,AWP 10,016,202049,Staff,0,0,0,0
1683695645567,AWP 10,017,202050,Staff,0,0,0,0
1683695645567,AWP 10,018,202051,Staff,0,0,0,0
1683695645567,AWP 10,019,202052,Staff,0,0,0,0
1683695645567,AWP 10,020,202053,Staff,0,0,0,0
1683695645567,AWP 10,021,202054,Staff,0,0,0,0
1683695645567,AWP 10,022,202055,Staff,0,0,0,0
1683695645567,AWP 10,023,202056,Staff,0,0,0,0
1683695645567,AWP 10,024,202057,Staff,0,0,0,0
1683695645567,AWP 10,025,202058,Staff,0,0,0,0
1683695645567,AWP 10,026,202059,Staff,0,0,0,0
1683695646593,AWP 102,001,202032,Staff,0,0,0,0
1683695646593,AWP 102,002,202033,Staff,0,0,0,0
1683695647620,BENG 100,A01,254234,Taylor Amos; Alyssa C,31,0,40,9
1683695648643,BENG 196,001,270013,Engler; Adam J.,9999,0,9999,0
1683695649669,BICD 100R,A01,202018,Smith; Laurie,0,7,32,32
1683695649669,BICD 100R,A02,202019,Smith; Laurie,0,3,32,32
1683695649669,BICD 100R,A03,202020,Smith; Laurie,0,1,32,32
1683695649669,BICD 100R,A04,202021,Smith; Laurie,6,0,32,26
1683695649669,BICD 100R,A05,202022,Smith; Laurie,10,0,32,22
1683695650694,BICD 136,A01,193242,Gustafson-Brown; Cindy,0,2,32,32
1683695650694,BICD 136,A02,193244,Gustafson-Brown; Cindy,13,0,32,19
1683695651717,BIEB 102,A01,193249,Butler; Shannon Rhey,1,1,32,31
1683695651717,BIEB 102,A02,193251,Butler; Shannon Rhey,0,0,32,32
1683695651717,BIEB 102,A03,193253,Butler; Shannon Rhey,0,0,32,32
1683695651717,BIEB 102,A04,193255,Butler; Shannon Rhey,13,0,32,19
1683695651717,BIEB 102,A05,193265,Butler; Shannon Rhey,25,0,32,7
1683695651717,BIEB 102,A06,193269,Butler; Shannon Rhey,12,0,32,20
1683695653767,BIEB 150,A01,193274,Staff,0,0,32,32
1683695653767,BIEB 150,A02,193285,Staff,24,0,32,8
1683695654795,BIEB 194,A00,193286,Kurle; Carolyn M.,19,0,32,13
1683695655822,BILD 1,A01,192291,Staff,15,0,32,17
1683695655822,BILD 1,A02,192292,Staff,30,0,32,2
1683695655822,BILD 1,B01,192520,Reuther; Keefe,0,1,0,0
1683695655822,BILD 1,B02,192532,Reuther; Keefe,0,1,0,0
1683695656846,BILD 3,A01,192556,Butler; Shannon Rhey,0,0,32,32
1683695656846,BILD 3,A02,192581,Butler; Shannon Rhey,0,1,32,32
1683695656846,BILD 3,A03,192611,Butler; Shannon Rhey,19,0,32,13
1683695656846,BILD 3,A04,192612,Butler; Shannon Rhey,23,0,32,9
1683695656846,BILD 3,A05,192613,Butler; Shannon Rhey,26,0,32,6
1683695656846,BILD 3,A06,192679,Butler; Shannon Rhey,27,0,32,5
1683695656846,BILD 3,A07,192682,Butler; Shannon Rhey,20,0,32,12
1683695657875,BILD 4,A01,192836,Reuther; Keefe,1,0,24,23
1683695657875,BILD 4,A02,193044,Reuther; Keefe,4,0,24,20
1683695658900,BILD 10,A01,193142,Gustafson-Brown; Cindy,29,0,32,3
1683695658900,BILD 10,A02,193149,Gustafson-Brown; Cindy,31,0,32,1
1683695659924,BIMM 100,A01,193301,Staff,0,6,32,32
1683695659924,BIMM 100,A02,193312,Staff,0,7,32,32
1683695659924,BIMM 100,A03,193323,Staff,0,10,32,32
1683695660948,BIMM 101,A01,193329,McDonnell; Lisa Marie,1,4,24,23
1683695660948,BIMM 101,A02,193339,McDonnell; Lisa Marie,1,4,24,23
1683695660948,BIMM 101,B01,193354,McDonnell; Lisa Marie,0,4,24,24
1683695660948,BIMM 101,B02,193357,McDonnell; Lisa Marie,0,3,24,24
1683695661972,BIMM 110,A01,193377,Tat; John,0,11,32,32
1683695661972,BIMM 110,A02,193378,Tat; John,0,11,32,32
1683695663000,BIMM 120,A01,206116,Staff,0,0,32,32
1683695663000,BIMM 120,A02,206117,Staff,7,0,32,25
1683695663000,BIMM 120,A03,206121,Staff,21,0,32,11
1683695664025,BIPN 100,A01,193393,Park; Ji Young,0,15,32,32
1683695664025,BIPN 100,A02,193402,Park; Ji Young,0,14,32,32
1683695664025,BIPN 100,A03,193413,Park; Ji Young,0,14,32,32
1683695664025,BIPN 100,A04,193414,Park; Ji Young,0,13,32,32
1683695665049,BIPN 102,A01,193429,Staff,0,0,32,32
1683695665049,BIPN 102,A02,193438,Staff,18,0,32,14
1683695666073,BIPN 106,A01,193450,Reyes Gonzalez; Catalina,0,2,40,40
1683695667102,BIPN 134,A01,193465,Cooke; James Edward,0,0,32,32
1683695667102,BIPN 134,A02,193474,Cooke; James Edward,25,0,32,7
1683695667102,BIPN 134,A03,193485,Cooke; James Edward,29,0,32,3
1683695667102,BIPN 134,A04,193486,Cooke; James Edward,20,0,32,12
1683695667102,BIPN 134,A05,193491,Cooke; James Edward,31,0,32,1
1683695667102,BIPN 134,A06,193501,Cooke; James Edward,30,0,32,2
1683695667102,BIPN 134,A07,193510,Cooke; James Edward,29,0,32,3
1683695669154,BISP 194,A00,222522,Staff,14,0,32,18
1683695670178,CAT 124,A01,202407,Staff,19,0,25,6
1683695671200,CAT 125,A00,202408,Marchisotto; Jennifer Anne,2,0,20,18
1683695672224,CAT 125R,A00,202409,Smith; Lauryn Alissa,0,11,20,20
1683695672224,CAT 125R,B00,202410,Morales; Celeste Georgianna,0,11,20,20
1683695672224,CAT 125R,C00,202411,Irwin; Matthew Joseph,0,12,20,20
1683695673249,CENG 15,A01,204712,Yang; Kesong,0,1,0,0
1683695674273,CENG 114,A00,202070,Jahed Motlagh; Zeinab,5,0,20,15
1683695675295,CGS 105,A00,185477,Wesling; Megan E.,24,0,40,16
1683695676320,CGS 106,A00,185494,Staff,11,0,22,11
1683695677348,CGS 108,A00,185495,Staff,14,0,20,6
1683695678372,CGS 114,A00,185496,Staff,13,0,18,5
1683695679394,CGS 119,A00,185501,Staff,15,0,20,5
1683695680420,CGS 120,A00,185511,Staff,12,0,20,8
1683695681445,CHEM 4,A01,184675,Bussey; Thomas J,97,0,100,3
1683695682469,CHEM 6A,A01,184677,Staff,32,0,60,28
1683695683493,CHEM 6B,A01,184679,Staff,63,0,100,37
1683695684521,CHEM 6C,A01,184681,Bussey; Thomas J,0,0,50,50
1683695684521,CHEM 6C,A02,184682,Bussey; Thomas J,32,0,50,18
1683695685545,CHEM 40A,A01,184684,Albizati; Kim F.,33,0,100,67
1683695686573,CHEM 40B,A01,184686,Albizati; Kim F.,0,22,100,100
1683695687654,CHEM 41B,A01,184690,Staff,51,0,100,49
1683695688676,COGS 3,A01,184715,Boyle; Mary E. T.,0,27,40,40
1683695689701,COGS 14B,A01,185172,Staff,0,14,38,38
1683695690729,COGS 18,A01,184736,Staff,14,0,80,66
1683695691753,COGS 100,A01,184932,Staff,0,8,73,73
1683695692776,COGS 101A,A01,184935,Staff,0,40,30,30
1683695693801,COGS 101B,A01,184944,Staff,0,2,30,30
1683695694828,COGS 101C,A01,184946,Staff,0,10,30,30
1683695695853,COGS 102A,A01,184951,Johnson; Christine M.,1,0,40,39
1683695696877,COGS 107B,A01,184953,Mooshagian; Eric Frederick,0,52,40,40
1683695697901,COGS 118B,A01,184959,Gupta; Anjum,0,50,40,40
1683695698925,COGS 153,A00,184961,Staff,0,16,30,30
1683695699952,COGS 177,A00,184962,Staff,1,21,30,29
1683695700981,COGS 187A,A01,184969,Boyle; Mary E. T.,0,19,40,40
1683695702011,COMM 10,A01,185174,Staff,0,5,25,25
1683695702011,COMM 10,A02,185189,Staff,0,2,25,25
1683695702011,COMM 10,A03,269821,Staff,0,1,0,0
1683695703038,COMM 100B,A02,185476,Staff,10,0,25,15
1683695703038,COMM 100B,A03,277340,Staff,25,0,25,0
1683695704065,COMM 100C,A01,185314,Staff,2,0,25,23
1683695704065,COMM 100C,A02,185327,Staff,17,0,25,8
1683695705091,COMM 110M,A00,185349,Staff,0,0,40,40
1683695706120,COMM 113T,A00,185352,Staff,25,0,40,15
1683695707147,COMM 114I,A00,185353,Staff,31,0,40,9
1683695708174,COMM 131,A00,185354,Staff,17,0,30,13
1683695709198,CSE 8A,A50,185358,Cao; Yingjun,0,46,10,10
1683695710221,CSE 8B,A01,185362,Staff,0,48,50,50
1683695711245,CSE 11,A01,185416,Cao; Yingjun,0,91,10,10
1683695712272,CSE 20,A01,185445,Briones; Jor-el Thomas Caparas,3,0,25,22
1683695713298,CSE 21,A01,185447,Staff,9,0,50,41
1683695714324,CSE 101,A01,185451,Staff,0,13,50,50
1683695714324,CSE 101,B01,185453,Jones; Miles E,0,14,50,50
1683695716374,CSE 141,A01,185458,Eldon; John,16,0,100,84
1683695717402,CSE 141L,A01,185461,Eldon; John,8,0,100,92
1683695718430,CSE 142,A01,185463,Staff,34,0,60,26
1683695718430,CSE 142,B01,201355,Staff,0,7,60,60
1683695719456,CSE 142L,A01,185470,Staff,34,0,60,26
1683695719456,CSE 142L,B01,201417,Staff,0,6,60,60
1683695720487,CSE 190,A00,201433,Staff,32,0,49,17
1683695721515,DOC 1,A01,259136,Strom; Megan C.,7,0,15,8
1683695721515,DOC 1,A02,259137,Strom; Megan C.,14,0,15,1
1683695721515,DOC 1,A03,259138,Strom; Megan C.,14,0,15,1
1683695721515,DOC 1,A04,259139,Strom; Megan C.,14,0,15,1
1683695722543,DOC 100D,A00,259140,Pass; Natalye Joann,14,0,25,11
1683695723566,DSGN 1,A01,184749,Rill; Bryan,0,26,30,30
1683695724592,DSGN 100,A01,185168,Staff,0,2,25,25
1683695725618,ECE 5,A01,185626,Morris; Karcher William,0,12,0,0
1683695726641,ECE 101,A01,185628,Staff,14,0,70,56
1683695727668,ECE 107,A01,185635,Baghdadchi; Saharnaz,0,0,20,20
1683695727668,ECE 107,A02,185638,Baghdadchi; Saharnaz,1,0,20,19
1683695728696,ECE 148,A01,185647,Silberman; Jack,0,0,16,16
1683695729720,ECON 1,A01,185537,Crane; Meredith Helen,54,0,70,16
1683695730749,ECON 3,A01,185549,Crane; Meredith Helen,30,0,70,40
1683695731773,ECON 4,A01,203354,Anderson; John Charles,0,5,10,10
1683695732797,ECON 100A,A01,185574,Staff,0,5,40,40
1683695733822,ECON 100B,A01,185576,Staff,0,12,50,50
1683695734849,ECON 100C,A01,185589,Newhouse; Herbert S,30,0,70,40
1683695735873,ECON 105,A00,185608,Vespa; Emanuel Ignacio,19,0,35,16
1683695736900,ECON 109,A01,185610,Shishkin; Denis,9,0,35,26
1683695737928,ECON 110A,A01,185612,Staff,8,0,40,32
1683695738950,ECON 120A,A01,185615,Staff,19,0,40,21
1683695739973,ECON 120C,A01,185617,Sun; Yixiao,0,21,70,70
1683695741003,ECON 144,A00,203346,Squires; Dale E,2,0,35,33
1683695742028,ECON 171,A01,203349,Newhouse; Herbert S,0,1,35,35
1683695743055,ECON 173A,A01,185621,Toda; Alexis Akira,21,0,35,14
1683695744080,EDS 25,A01,202413,Staff,0,1,0,0
1683695744080,EDS 25,A02,202414,Staff,0,1,0,0
1683695744080,EDS 25,A03,202415,Staff,0,0,0,0
1683695744080,EDS 25,A04,202416,Staff,0,1,0,0
1683695744080,EDS 25,A05,202439,Staff,0,0,0,0
1683695744080,EDS 25,A06,202440,Staff,0,0,0,0
1683695744080,EDS 25,B01,202631,Staff,0,0,0,0
1683695744080,EDS 25,B02,202632,Staff,0,0,0,0
1683695744080,EDS 25,B03,202639,Staff,0,0,0,0
1683695744080,EDS 25,B04,202640,Staff,0,0,0,0
1683695744080,EDS 25,B05,202643,Staff,0,0,0,0
1683695744080,EDS 25,B06,202644,Staff,0,0,0,0
1683695745104,EDS 38,A01,202659,Black; Alison Michelle,24,0,25,1
1683695746131,EDS 115,A00,202652,Staff,18,0,30,12
1683695747155,EDS 125,A00,202649,Staff,13,0,30,17
1683695748180,EDS 126,A01,203332,Staff,30,0,30,0
1683695749208,EDS 139,A00,202838,Staff,16,0,25,9
1683695750234,EDS 146,A01,202655,Staff,14,0,25,11
1683695751264,ENG 15,A00,185667,Staff,0,1,0,0
1683695751264,ENG 15,B00,185672,Staff,0,0,0,0
1683695751264,ENG 15,C00,185675,Staff,0,0,0,0
1683695751264,ENG 15,D00,185682,Staff,0,0,0,0
1683695751264,ENG 15,E00,185684,Staff,0,0,0,0
1683695752286,ETHN 103,A00,185710,Staff,0,8,35,35
1683695753310,ETHN 103A,A00,199228,Man; Simeon S,0,0,9,9
1683695754334,ETHN 109,A00,185711,Staff,15,0,35,20
1683695755358,ETHN 142,A00,185726,Staff,0,4,30,30
1683695756382,ETHN 163J,A00,199229,Man; Simeon S,5,0,8,3
1683695757409,ETHN 168,A00,185727,Staff,7,0,10,3
1683695758433,ETHN 182,A00,185728,Staff,0,0,35,35
1683695759461,ETHN 183,A00,185737,Staff,9,0,18,9
1683695760485,GLBH 111,A01,209361,Burgos; Jose L.,0,0,0,0
1683695762534,HIEU 104,A00,185792,Staff,14,0,20,6
1683695763558,HIEU 115,A00,185800,Staff,0,0,20,20
1683695764585,HIEU 128,A00,185801,Staff,0,9,20,20
1683695765608,HIEU 147,A00,185802,Staff,15,0,20,5
1683695766633,HIEU 154,A00,185823,Staff,11,0,20,9
1683695767661,HILA 102,A00,185826,Staff,14,0,20,6
1683695768685,HILD 2C,A01,185778,Staff,0,13,20,20
1683695769709,HILD 7B,A01,185780,Kwak; Nancy,0,17,32,32
1683695769709,HILD 7B,A02,185781,Kwak; Nancy,0,18,32,32
1683695770736,HILD 30,A01,185791,Staff,12,0,20,8
1683695771760,HISC 119,A00,185830,Golan; Tal,0,10,20,20
1683695772788,HITO 156GS,A00,185831,Patterson; Patrick H.,0,0,0,23
1683695773812,HIUS 103,A00,185832,Man; Simeon S,0,4,20,20
1683695774840,HIUS 117,A00,185836,Kwak; Nancy,2,0,20,18
1683695775869,HIUS 125,A00,185840,Man; Simeon S,0,2,23,23
1683695776901,HIUS 149,A00,185845,Staff,1,0,20,19
1683695777930,HUM 3,A01,185882,Zavodny; Tatiana Sophia,0,8,50,50
1683695777930,HUM 3,B01,185899,Caldwell; Michael Alan,0,18,50,50
1683695778955,HUM 3GS,A00,185900,Patterson; Patrick H.,0,0,0,23
1683695779980,HUM 4,A01,185938,Zroka; Amy Liane,28,0,50,22
1683695779980,HUM 4,B01,185956,Watkins; Eric,0,6,50,50
1683695779980,HUM 4,B02,202209,Watkins; Eric,0,5,50,50
1683695779980,HUM 4,B03,202210,Watkins; Eric,0,5,50,50
1683695781008,HUM 5,A01,185958,West; Geoffrey Scott,0,0,50,50
1683695781008,HUM 5,A02,202215,West; Geoffrey Scott,0,1,50,50
1683695782031,INTL 190,A00,185959,Gagnon; Jeffrey C,0,0,0,9
1683695782031,INTL 190,B00,185960,Lettieri; Michael Joseph,0,0,0,2
1683695783057,JAPN 180,A00,254509,Staff,5,0,30,25
1683695784082,LATI 10,A01,202853,Kennemore; Amy Michelle,4,0,35,31
1683695784082,LATI 10,A02,202854,Kennemore; Amy Michelle,3,0,35,32
1683695784082,LATI 10,A03,270054,Kennemore; Amy Michelle,30,0,30,0
1683695785110,LATI 180,A00,202855,Kennemore; Amy Michelle,11,0,20,9
1683695786133,LAWS 101,A00,201767,Golan; Tal,0,7,40,40
1683695787157,LIFR 1C,A00,185961,Staff,6,0,20,14
1683695788182,LIFR 1CX,A00,185962,Staff,7,0,20,13
1683695789204,LIFR 1D,A00,185963,Staff,7,0,20,13
1683695790233,LIFR 1DX,A00,185964,Staff,7,0,20,13
1683695791335,LIGN 101,A01,186039,Staff,43,0,50,7
1683695792363,LIGN 165,A00,186040,Staff,15,0,50,35
1683695793387,LTCS 108,A00,186041,Staff,5,0,10,5
1683695794412,LTCS 119,A00,186042,Staff,15,0,20,5
1683695795437,LTCS 130,A00,186043,Wesling; Megan E.,15,0,25,10
1683695797484,LTEA 138,A00,186119,Staff,14,0,40,26
1683695798511,LTEN 124,A00,186148,Staff,5,0,25,20
1683695799537,LTEN 178,A00,186149,Staff,6,0,15,9
1683695800560,LTEN 181,A00,186150,Blanco; John D,34,0,40,6
1683695801585,LTWL 120,A00,186160,Staff,19,0,25,6
1683695802612,LTWL 165,A00,186161,Staff,22,0,25,3
1683695803634,LTWR 100,A00,186162,Staff,0,5,15,15
1683695804658,LTWR 102,A00,186163,Doller; Ben,5,0,15,10
1683695805683,MAE 8,A01,186412,Staff,0,1,0,0
1683695806710,MAE 30B,A00,186445,Bahadori; Mohammad Yousef,81,0,100,19
1683695807737,MAE 40,A00,186592,Bewley; Thomas R,10,0,50,40
1683695808764,MAE 101B,A00,186593,Bahadori; Mohammad Yousef,80,0,100,20
1683695809792,MAE 105,A00,186594,Bandaru; Prabhakar,10,0,50,40
1683695810820,MAE 107,A00,186599,Pham; Hieu Tan,0,7,120,120
1683695811843,MAE 148,A01,186660,Silberman; Jack,3,0,16,13
1683695812871,MATH 10A,A01,188095,Staff,0,6,35,35
1683695813895,MATH 10B,A01,188097,Bowers; Adam R.,0,12,30,30
1683695813895,MATH 10B,A02,188099,Bowers; Adam R.,0,11,30,30
1683695813895,MATH 10B,B01,188104,Bowers; Adam R.,0,10,30,30
1683695813895,MATH 10B,B02,188106,Bowers; Adam R.,1,10,30,29
1683695814921,MATH 10C,A01,188111,Staff,0,20,30,30
1683695814921,MATH 10C,A02,188127,Staff,0,19,30,30
1683695814921,MATH 10C,A03,188131,Staff,0,19,30,30
1683695814921,MATH 10C,B01,188218,Staff,17,0,30,13
1683695814921,MATH 10C,B02,188244,Staff,13,0,30,17
1683695814921,MATH 10C,B03,188277,Staff,14,0,30,16
1683695815947,MATH 18,A01,188344,Bach; Quang Tran,18,0,30,12
1683695815947,MATH 18,A02,188345,Bach; Quang Tran,11,0,30,19
1683695815947,MATH 18,B01,188353,Bach; Quang Tran,11,0,30,19
1683695815947,MATH 18,B02,188354,Bach; Quang Tran,19,0,30,11
1683695816972,MATH 20A,A01,188374,Staff,11,0,35,24
1683695817998,MATH 20B,A01,188382,Ohm; Ko Woon,7,0,30,23
1683695817998,MATH 20B,A02,188383,Ohm; Ko Woon,22,0,30,8
1683695817998,MATH 20B,B01,188385,Ohm; Ko Woon,7,0,30,23
1683695817998,MATH 20B,B02,188392,Ohm; Ko Woon,22,0,30,8
1683695819027,MATH 20C,A01,188394,Harel; Guershon,10,0,30,20
1683695819027,MATH 20C,A02,188395,Harel; Guershon,13,0,30,17
1683695819027,MATH 20C,B01,188404,Harel; Guershon,5,0,30,25
1683695819027,MATH 20C,B02,188405,Harel; Guershon,18,0,30,12
1683695820056,MATH 20D,A01,188414,Hammock; Frances H,0,1,30,30
1683695820056,MATH 20D,A02,188415,Hammock; Frances H,0,1,30,30
1683695820056,MATH 20D,B01,188447,Hammock; Frances H,0,1,30,30
1683695820056,MATH 20D,B02,188486,Hammock; Frances H,2,0,30,28
1683695821083,MATH 20E,A01,188649,Staff,21,0,30,9
1683695821083,MATH 20E,A02,188650,Staff,20,0,30,10
1683695821083,MATH 20E,A03,188673,Staff,0,0,30,30
1683695822109,MATH 102,A01,188675,Staff,0,40,35,35
1683695823134,MATH 103B,A01,188681,Staff,3,0,35,32
1683695823134,MATH 103B,B01,188692,Staff,5,0,35,30
1683695824157,MATH 109,A01,188695,Salehi Golsefidy; Alireza,24,0,35,11
1683695824157,MATH 109,A02,188696,Salehi Golsefidy; Alireza,25,0,35,10
1683695825181,MATH 120A,A01,188698,Eggers; John Dietrich,7,0,35,28
1683695826205,MATH 142B,A01,188736,Ioana; Adrian,1,1,30,29
1683695826205,MATH 142B,A02,188741,Ioana; Adrian,0,1,30,30
1683695826205,MATH 142B,A03,188743,Ioana; Adrian,0,2,30,30
1683695827227,MATH 168A,A01,188790,Staff,0,11,35,35
1683695828252,MATH 170A,A01,188803,Nie; Jiawang,0,2,35,35
1683695828252,MATH 170A,A02,188811,Nie; Jiawang,0,1,35,35
1683695828252,MATH 170A,A03,188814,Nie; Jiawang,0,0,35,35
1683695828252,MATH 170A,A04,188815,Nie; Jiawang,5,0,35,30
1683695829276,MATH 193B,A01,188817,Staff,0,0,35,35
1683695829276,MATH 193B,A02,188818,Staff,6,0,35,29
1683695830300,MGT 4,A01,202857,Anderson; John Charles,59,0,80,21
1683695831324,MGT 12,A00,202858,Lindenberger; Wade Douglas,40,0,90,50
1683695832351,MGT 18,A00,202859,Staff,74,0,90,16
1683695833376,MGT 18GS,A00,202860,McKay; Michael J,13,0,28,15
1683695834401,MGT 45,A00,202861,Pecore; Joseph P.,8,0,90,82
1683695835426,MGT 100,A00,202863,Yavorsky; Daniel Ryan,27,0,90,63
1683695836453,MGT 103,A00,202864,Ehrich; Kristine R,0,19,90,90
1683695837481,MGT 112,A00,202865,Ehrich; Kristine R,15,0,90,75
1683695838509,MGT 121A,A00,202868,Staff,90,20,90,0
1683695839534,MGT 131B,A00,202869,Anderson; John Charles,58,0,90,32
1683695840564,MGT 136,A00,202871,Lindenberger; Wade Douglas,83,0,90,7
1683695841590,MGT 164,A00,202873,Staff,0,67,90,91
1683695842623,MGT 164GS,A00,202874,McKay; Mary A,13,0,28,15
1683695843648,MGT 180,A00,202875,Staff,0,51,90,91
1683695844671,MMW 11R,A01,205019,Herbst; Matthew,0,0,30,30
1683695844671,MMW 11R,A02,205026,Herbst; Matthew,29,0,30,1
1683695845696,MMW 15,A01,193512,Chang; Edmond Yi-Teh,0,8,28,28
1683695845696,MMW 15,A02,193513,Chang; Edmond Yi-Teh,0,5,28,28
1683695845696,MMW 15,A03,193514,Chang; Edmond Yi-Teh,0,5,28,28
1683695845696,MMW 15,A04,193515,Chang; Edmond Yi-Teh,0,5,28,28
1683695845696,MMW 15,A05,193516,Chang; Edmond Yi-Teh,0,5,28,28
1683695845696,MMW 15,A06,193517,Chang; Edmond Yi-Teh,0,6,28,28
1683695845696,MMW 15,B01,193519,Chang; Edmond Yi-Teh,0,5,28,28
1683695845696,MMW 15,B02,193520,Chang; Edmond Yi-Teh,0,5,28,28
1683695845696,MMW 15,B03,193521,Chang; Edmond Yi-Teh,0,5,28,28
1683695845696,MMW 15,B04,193522,Chang; Edmond Yi-Teh,0,6,28,28
1683695845696,MMW 15,B05,193523,Chang; Edmond Yi-Teh,0,5,28,28
1683695845696,MMW 15,B06,193524,Chang; Edmond Yi-Teh,0,5,28,28
1683695846724,MMW 122,A01,193526,Rahimi; Babak,0,16,28,28
1683695846724,MMW 122,A02,193527,Rahimi; Babak,0,15,28,28
1683695846724,MMW 122,A03,193528,Rahimi; Babak,0,0,0,0
1683695846724,MMW 122,A04,193529,Rahimi; Babak,0,0,0,0
1683695847751,MUS 1A,A01,186663,Staff,1,19,35,34
1683695848776,MUS 4,A01,186715,Staff,0,12,35,35
1683695849800,MUS 5R,A01,186796,Dubnov; Shlomo,0,17,35,35
1683695850829,MUS 6,A01,186798,Staff,1,5,25,24
1683695851856,MUS 7,A01,186830,Staff,11,0,35,24
1683695852880,MUS 8,A01,186930,Staff,0,27,35,35
1683695853905,MUS 15,A01,186932,Staff,0,15,35,35
1683695853905,MUS 15,B01,186934,Staff,1,17,35,34
1683695854928,MUS 80,A00,186935,Staff,0,0,20,20
1683695854928,MUS 80,B00,186936,Staff,24,0,25,1
1683695855955,NANO 11,A00,204702,Lipomi; Darren John,0,0,0,0
1683695856980,NANO 15,A01,204709,Yang; Kesong,0,1,0,0
1683695858004,NANO 114,A00,202069,Jahed Motlagh; Zeinab,2,0,10,8
1683695859028,PHIL 1,A00,186955,Grush; Rick Scott,31,0,40,9
1683695860056,PHIL 10,A01,186973,Grush; Rick Scott,27,0,35,8
1683695860056,PHIL 10,A02,186974,Grush; Rick Scott,33,0,35,2
1683695861085,PHIL 13,A01,186976,Staff,1,0,35,34
1683695861085,PHIL 13,A02,186977,Staff,16,0,35,19
1683695862112,PHIL 14,A01,186979,Staff,31,0,35,4
1683695862112,PHIL 14,A02,186986,Staff,32,0,35,3
1683695863137,PHIL 28,A01,186988,Staff,16,0,30,14
1683695863137,PHIL 28,A02,186989,Staff,1,0,30,29
1683695863137,PHIL 28,A03,186990,Staff,10,0,30,20
1683695863137,PHIL 28,A04,186991,Staff,26,0,30,4
1683695864162,PHIL 120,A00,186997,Staff,23,0,40,17
1683695865186,PHIL 137,A00,187003,Staff,7,0,40,33
1683695866211,PHIL 150,A00,187015,Staff,47,0,70,23
1683695867235,PHIL 167,A00,187021,Lamey; Andy M.,34,0,40,6
1683695868262,PHIL 174,A01,202226,Staff,17,0,20,3
1683695868262,PHIL 174,A02,202235,Staff,20,0,20,0
1683695869286,PHIL 191A,A00,258918,Staff,0,0,1,1
1683695870311,PHYS 1A,A00,187028,Staff,26,0,60,34
1683695871340,PHYS 1AL,001,187036,Staff,3,0,30,27
1683695871340,PHYS 1AL,002,187049,Staff,18,0,30,12
1683695872364,PHYS 1B,A00,187058,Staff,22,0,60,38
1683695873389,PHYS 1BL,001,187064,Staff,0,1,30,30
1683695873389,PHYS 1BL,002,187070,Staff,4,0,30,26
1683695874415,PHYS 1C,A00,187082,Staff,29,0,120,91
1683695875445,PHYS 1CL,001,187088,Staff,0,9,30,30
1683695875445,PHYS 1CL,002,187089,Staff,0,1,30,30
1683695875445,PHYS 1CL,009,262693,Staff,9,0,30,21
1683695876473,PHYS 2B,A01,187097,Staff,55,0,115,60
1683695877498,PHYS 2C,A01,187099,Staff,63,0,115,52
1683695878522,PHYS 2CL,A01,187101,Staff,5,0,28,23
1683695878522,PHYS 2CL,A02,187102,Staff,15,0,28,13
1683695879549,PHYS 2D,A01,187123,Shotwell; Brian,95,0,115,20
1683695880573,PHYS 4B,A01,187133,Grinstein; Benjamin,35,0,50,15
1683695881597,POLI 10,A00,188819,Staff,0,4,50,50
1683695882627,POLI 11,A00,188827,Staff,43,0,50,7
1683695883651,POLI 13R,A00,188828,Staff,0,1,20,20
1683695884678,POLI 27,A01,188830,Elgin; Samuel Zincke,0,2,70,70
1683695885707,POLI 30,A00,188832,Desposato; Scott,30,0,50,20
1683695886734,POLI 102F,A00,188834,Staff,1,0,40,39
1683695887760,POLI 104A,A00,188852,Staff,12,0,30,18
1683695888785,POLI 104I,A00,188853,Staff,0,8,20,20
1683695889814,POLI 110B,A00,188854,Wiens; David,6,0,20,14
1683695890839,POLI 112A,A00,188855,Wiens; David,3,0,30,27
1683695891863,POLI 117R,A00,188856,Forman; Fonna,0,12,20,20
1683695892887,POLI 118,A00,188857,Ingham; Sean,8,0,20,12
1683695893910,POLI 120G,A00,188858,Staff,8,0,30,22
1683695894991,POLI 131CR,A00,188863,Hoston; Germaine,20,0,50,30
1683695896016,POLI 133,A00,188864,Nellis; Gareth Hb,44,0,50,6
1683695897040,POLI 134D,A00,188865,Desposato; Scott,27,0,30,3
1683695898065,POLI 142A,A00,188871,Gartzke; Erik,21,0,50,29
1683695899089,POLI 142K,A00,188874,Staff,38,0,50,12
1683695900116,POLI 143,A00,188940,Gartzke; Erik,16,0,30,14
1683695901140,POLI 153,A00,188943,Staff,2,0,20,18
1683695902168,POLI 160AA,A00,188944,Staff,10,0,40,30
1683695903195,POLI 170A,A00,188945,Staff,10,0,30,20
1683695905247,PSYC 1,A00,188952,Staff,36,0,90,54
1683695906272,PSYC 2,B00,188953,Staff,19,0,35,16
1683695907296,PSYC 6,A00,188970,Staff,47,0,60,13
1683695908319,PSYC 7,A00,188973,Staff,35,0,45,10
1683695909343,PSYC 60,A01,188980,Rickard; Timothy C.,42,0,60,18
1683695910373,PSYC 70,A01,189001,Steiner; Eric Tomas,21,0,45,24
1683695911397,PSYC 100,A00,189005,Lacefield; Katharine I,0,99,120,120
1683695912424,PSYC 102,A00,189008,Staff,7,0,30,23
1683695913450,PSYC 106,B00,189026,Gorman; Michael R.,27,0,60,33
1683695914474,PSYC 114,B01,189033,Winkielman; Piotr,0,31,30,30
1683695915498,PSYC 131,A00,189036,Anagnostaras; Stephan,0,43,60,60
1683695916524,PSYC 136,A00,189041,Lowe; Angela Beth,0,7,25,25
1683695917547,PSYC 137,A00,189057,Winkielman; Piotr,1,37,25,24
1683695918571,PSYC 144,A00,189107,Wixted; John T,0,11,50,50
1683695920622,PSYC 162,A00,189142,Staff,0,9,85,85
1683695921645,PSYC 172,A00,189144,Gorman; Michael R.,0,6,30,30
1683695923695,PSYC 179,A00,189146,Lacefield; Katharine I,0,88,120,120
1683695924722,PSYC 181,A00,189147,Anagnostaras; Stephan,0,44,90,90
1683695925749,PSYC 190R,A00,189148,Barner; David A.,0,23,80,80
1683695926776,PSYC 191,A00,189275,Rickard; Timothy C.,0,11,25,25
1683695927806,PSYC 193,A00,189276,Chapman; Eddie Nathaniel,0,1,0,4
1683695928831,PSYC 193L,A01,189281,Lowe; Angela Beth,8,0,20,12
1683695928831,PSYC 193L,B01,189285,Staff,28,0,35,7
1683695929858,RELI 149,A00,187137,Rahimi; Babak,6,0,40,34
1683695930884,SE 9,A01,187315,Staff,0,2,18,18
1683695931912,SE 101B,A00,187409,Staff,24,0,30,6
1683695932938,SE 110B,A00,187444,Staff,10,0,40,30
1683695933965,SE 130B,A00,187449,Staff,31,0,40,9
1683695934991,SE 150A,A00,187516,Staff,8,0,20,12
1683695936015,SE 154,A00,187528,Staff,29,0,50,21
1683695937039,SIO 3,A01,258171,Staff,35,0,40,5
1683695938061,SIO 10,A00,187144,Cook; Geoffrey W,1,7,75,74
1683695939085,SIO 45,A00,187152,Cook; Geoffrey W,0,7,100,100
1683695940109,SIO 109R,A00,194486,Staff,0,4,20,20
1683695942164,SIO 187,A01,187233,Kacev; David,12,0,40,28
1683695943187,SOCI 1,A01,258656,Thorpe; Charles Robert,28,0,30,2
1683695943187,SOCI 1,A02,258658,Thorpe; Charles Robert,30,0,30,0
1683695943187,SOCI 1,A03,258661,Thorpe; Charles Robert,25,0,25,0
1683695943187,SOCI 1,A04,258666,Thorpe; Charles Robert,22,0,25,3
1683695943187,SOCI 1,A05,258897,Thorpe; Charles Robert,22,0,25,3
1683695943187,SOCI 1,A06,258898,Thorpe; Charles Robert,25,0,25,0
1683695944212,SOCI 30,A01,258903,Pardo Guerra; Juan Pablo,14,0,30,16
1683695945239,SOCI 102,A00,258904,Staff,9,0,25,16
1683695946267,SOCI 106,A00,258905,Staff,19,0,25,6
1683695947294,SOCI 111,A00,258907,Ribas Norris; Janet Vanesa,26,0,30,4
1683695948317,SOCI 121R,A00,258908,Pardo Guerra; Juan Pablo,7,0,30,23
1683695949343,SOCI 126,A01,203330,Staff,14,0,20,6
1683695950367,SOCI 131,A00,258909,Thorpe; Charles Robert,30,0,60,30
1683695951391,SOCI 135,A00,258910,Payne; Christine Anna,0,13,30,30
1683695952413,SOCI 157,A00,258911,Staff,10,0,30,20
1683695953436,SOCI 184,A00,258912,Staff,25,0,30,5
1683695954460,SOCI 188D,A00,258913,Staff,22,0,30,8
1683695955488,SYN 2,001,187529,Staff,9,0,16,7
1683695955488,SYN 2,002,201452,Staff,1,21,16,15
1683695955488,SYN 2,003,201469,Staff,1,0,16,15
1683695956512,SYN 100,A01,187531,Staff,0,9,20,20
1683695956512,SYN 100,B01,201491,Staff,0,10,20,20
1683695957535,TDAC 1,A00,189286,Walsh; Kim C.,3,0,20,17
1683695957535,TDAC 1,B00,189287,Harting; Carla Kelso,10,0,20,10
1683695958562,TDAC 101,A00,189300,Walsh; Kim C.,16,0,20,4
1683695958562,TDAC 101,B00,189301,Harting; Carla Kelso,18,0,20,2
1683695959586,TDAC 102,A00,189304,Basso; Beatrice,14,0,20,6
1683695960608,TDAC 108,A00,189305,Staff,18,0,20,2
1683695961636,TDDE 131,A00,189310,Staff,19,0,20,1
1683695961636,TDDE 131,B00,189314,Staff,19,0,20,1
1683695961636,TDDE 131,C00,189315,Staff,48,0,50,2
1683695961636,TDDE 131,D00,189316,Staff,14,0,15,1
1683695961636,TDDE 131,E00,204841,Staff,20,0,20,0
1683695962666,TDGE 10,A00,189289,Staff,27,0,50,23
1683695962666,TDGE 10,B00,189290,Havis; Allan,0,1,50,50
1683695963694,TDGE 11,A00,189291,Fulton; Julia,0,4,50,50
1683695963694,TDGE 11,B00,189292,Staff,20,0,25,5
1683695963694,TDGE 11,C00,260270,Staff,0,0,0,0
1683695964721,TDGE 25,A00,189294,Staff,1,0,20,19
1683695965745,TDGE 124,A00,189318,Fulton; Julia,1,8,50,49
1683695966769,TDGE 125,A00,189319,Staff,13,0,25,12
1683695966769,TDGE 125,B00,189320,Staff,23,0,25,2
1683695967793,TDGE 127,A00,189322,Havis; Allan,0,0,50,50
1683695968818,TDHT 101,A00,189323,Staff,18,0,25,7
1683695968818,TDHT 101,B00,189324,Staff,25,0,25,0
1683695969842,TDHT 102,A00,189325,Staff,49,0,50,1
1683695970866,TDMV 1,A00,189295,Arcidiacono; Kristin,20,0,30,10
1683695970866,TDMV 1,B00,189296,Caligagan; Maria T.,24,0,30,6
1683695971889,TDMV 2,A00,189297,Sammartano; Tonnie,27,0,30,3
1683695971889,TDMV 2,B00,189299,Arcidiacono; Kristin,23,0,30,7
1683695972913,TDMV 3,A00,204998,Rincon; Alicia,22,0,30,8
1683695973944,TDMV 120,A00,189458,Sammartano; Tonnie,28,0,30,2
1683695974966,TDMV 138,A00,189541,Jun; Grace Shin Hae,20,0,40,20
1683695975990,TDMV 142,A00,189717,Caligagan; Tony,25,0,30,5
1683695975990,TDMV 142,B00,189718,Caligagan; Maria T.,25,0,30,5
1683695977013,TMC 2,A01,187533,Staff,25,0,25,0
1683695977013,TMC 2,A02,187534,Staff,25,0,25,0
1683695978037,USP 1,A01,187536,Kwak; Nancy,0,16,25,25
1683695979062,USP 5,A01,187538,Staff,8,0,25,17
1683695980086,USP 101,A00,199253,Staff,0,4,0,0
1683695981111,USP 124,A00,187562,Boomhower; Matthew Charles,0,0,30,30
1683695982136,USP 138,A00,187582,Staff,19,0,25,6
1683695983160,USP 152,A01,187597,Staff,3,0,25,22
1683695984185,USP 153,A00,187598,Staff,18,0,25,7
1683695985211,USP 168,A00,187607,Kwak; Nancy,2,0,5,3
1683695986238,USP 173,A00,187619,Staff,4,0,25,21
1683695987262,USP 181,A00,187638,Staff,0,4,25,25
1683695988286,VIS 103,A00,187650,Cruz; Edwin Teddy,17,0,75,58
1683695989313,VIS 110D,A00,187669,Staff,13,0,22,9
1683695990338,VIS 127C,A00,187720,Shen; Kuiyi,67,0,146,79
1683695991365,VIS 149,A00,187731,Yoldas; Pinar,2,14,22,20
1683695992391,VIS 151,A01,188091,Staff,22,0,34,12
1683695992391,VIS 151,A02,188092,Staff,11,0,34,23
1683695993418,VIS 160B,A00,188093,Stalbaum; Brett,0,1,10,10
1683695995472,WCWP 10B,A00,201720,Staff,0,0,5,5
1683695995472,WCWP 10B,B00,201722,Staff,0,0,6,6
1683695996505,WCWP 100,A00,201725,Gagnon; Jeffrey C,0,0,2,2
1683695996505,WCWP 100,B00,201727,Staff,0,4,15,15
1683695999688,ANBI 133,A00,258401,Wilder; Linnea Lorene,34,0,40,6
1683696000716,ANBI 140,A00,258395,Hrvoj Mihic; Branka,18,0,25,7
1683696001743,ANSC 120,A00,258402,Bialecki; Jon Anthony,26,0,40,14
1683696002770,ANSC 144,A00,258400,Staff,12,0,40,28
1683696004822,ANSC 166,A00,258396,Parish; Steven Martin,156,0,175,19
1683696005849,ANSC 180,A00,193533,Staff,8,0,20,12
1683696006881,ANSC 188,A00,258397,Jassal; Aftab,34,0,40,6
1683696007909,ANTH 3,A01,258316,Staff,23,0,30,7
1683696008936,ANTH 5,A00,258394,Semendeferi; Ekaterini,16,0,20,4
1683696009961,ANTH 21,A01,258331,Staff,4,0,40,36
1683696010988,ANTH 103,A00,258398,Varma; Saiba,15,0,25,10
1683696012013,AWP 10,001,202034,Staff,0,0,0,0
1683696012013,AWP 10,002,202035,Staff,0,0,0,0
1683696012013,AWP 10,003,202036,Staff,0,0,0,0
1683696012013,AWP 10,004,202037,Staff,0,0,0,0
1683696012013,AWP 10,005,202038,Staff,0,0,0,0
1683696012013,AWP 10,006,202039,Staff,0,0,0,0
1683696012013,AWP 10,007,202040,Staff,0,0,0,0
1683696012013,AWP 10,008,202041,Staff,0,0,0,0
1683696012013,AWP 10,009,202042,Staff,0,0,0,0
1683696012013,AWP 10,010,202043,Staff,0,0,0,0
1683696012013,AWP 10,011,202044,Staff,0,0,0,0
1683696012013,AWP 10,012,202045,Staff,0,0,0,0
1683696012013,AWP 10,013,202046,Staff,0,0,0,0
1683696012013,AWP 10,014,202047,Staff,0,0,0,0
1683696012013,AWP 10,015,202048,Staff,0,0,0,0
1683696012013,AWP 10,016,202049,Staff,0,0,0,0
1683696012013,AWP 10,017,202050,Staff,0,0,0,0
1683696012013,AWP 10,018,202051,Staff,0,0,0,0
1683696012013,AWP 10,019,202052,Staff,0,0,0,0
1683696012013,AWP 10,020,202053,Staff,0,0,0,0
1683696012013,AWP 10,021,202054,Staff,0,0,0,0
1683696012013,AWP 10,022,202055,Staff,0,0,0,0
1683696012013,AWP 10,023,202056,Staff,0,0,0,0
1683696012013,AWP 10,024,202057,Staff,0,0,0,0
1683696012013,AWP 10,025,202058,Staff,0,0,0,0
1683696012013,AWP 10,026,202059,Staff,0,0,0,0
1683696013037,AWP 102,001,202032,Staff,0,0,0,0
1683696013037,AWP 102,002,202033,Staff,0,0,0,0
1683696014062,BENG 100,A01,254234,Taylor Amos; Alyssa C,31,0,40,9
1683696015089,BENG 196,001,270013,Engler; Adam J.,9999,0,9999,0
1683696016113,BICD 100R,A01,202018,Smith; Laurie,0,7,32,32
1683696016113,BICD 100R,A02,202019,Smith; Laurie,0,3,32,32
1683696016113,BICD 100R,A03,202020,Smith; Laurie,0,1,32,32
1683696016113,BICD 100R,A04,202021,Smith; Laurie,6,0,32,26
1683696016113,BICD 100R,A05,202022,Smith; Laurie,10,0,32,22
1683696017141,BICD 136,A01,193242,Gustafson-Brown; Cindy,0,2,32,32
1683696017141,BICD 136,A02,193244,Gustafson-Brown; Cindy,13,0,32,19
1683696018169,BIEB 102,A01,193249,Butler; Shannon Rhey,1,1,32,31
1683696018169,BIEB 102,A02,193251,Butler; Shannon Rhey,0,0,32,32
1683696018169,BIEB 102,A03,193253,Butler; Shannon Rhey,0,0,32,32
1683696018169,BIEB 102,A04,193255,Butler; Shannon Rhey,13,0,32,19
1683696018169,BIEB 102,A05,193265,Butler; Shannon Rhey,25,0,32,7
1683696018169,BIEB 102,A06,193269,Butler; Shannon Rhey,12,0,32,20
1683696020219,BIEB 150,A01,193274,Staff,0,0,32,32
1683696020219,BIEB 150,A02,193285,Staff,24,0,32,8
1683696021243,BIEB 194,A00,193286,Kurle; Carolyn M.,19,0,32,13
1683696022273,BILD 1,A01,192291,Staff,15,0,32,17
1683696022273,BILD 1,A02,192292,Staff,30,0,32,2
1683696022273,BILD 1,B01,192520,Reuther; Keefe,0,1,0,0
1683696022273,BILD 1,B02,192532,Reuther; Keefe,0,1,0,0
1683696023302,BILD 3,A01,192556,Butler; Shannon Rhey,0,0,32,32
1683696023302,BILD 3,A02,192581,Butler; Shannon Rhey,0,1,32,32
1683696023302,BILD 3,A03,192611,Butler; Shannon Rhey,19,0,32,13
1683696023302,BILD 3,A04,192612,Butler; Shannon Rhey,23,0,32,9
1683696023302,BILD 3,A05,192613,Butler; Shannon Rhey,26,0,32,6
1683696023302,BILD 3,A06,192679,Butler; Shannon Rhey,27,0,32,5
1683696023302,BILD 3,A07,192682,Butler; Shannon Rhey,20,0,32,12
1683696024329,BILD 4,A01,192836,Reuther; Keefe,1,0,24,23
1683696024329,BILD 4,A02,193044,Reuther; Keefe,4,0,24,20
1683696025352,BILD 10,A01,193142,Gustafson-Brown; Cindy,29,0,32,3
1683696025352,BILD 10,A02,193149,Gustafson-Brown; Cindy,31,0,32,1
1683696026376,BIMM 100,A01,193301,Staff,0,6,32,32
1683696026376,BIMM 100,A02,193312,Staff,0,7,32,32
1683696026376,BIMM 100,A03,193323,Staff,0,10,32,32
1683696027420,BIMM 101,A01,193329,McDonnell; Lisa Marie,1,4,24,23
1683696027420,BIMM 101,A02,193339,McDonnell; Lisa Marie,1,4,24,23
1683696027420,BIMM 101,B01,193354,McDonnell; Lisa Marie,0,4,24,24
1683696027420,BIMM 101,B02,193357,McDonnell; Lisa Marie,0,3,24,24
1683696028446,BIMM 110,A01,193377,Tat; John,0,11,32,32
1683696028446,BIMM 110,A02,193378,Tat; John,0,11,32,32
1683696029474,BIMM 120,A01,206116,Staff,0,0,32,32
1683696029474,BIMM 120,A02,206117,Staff,7,0,32,25
1683696029474,BIMM 120,A03,206121,Staff,21,0,32,11
1683696030498,BIPN 100,A01,193393,Park; Ji Young,0,15,32,32
1683696030498,BIPN 100,A02,193402,Park; Ji Young,0,14,32,32
1683696030498,BIPN 100,A03,193413,Park; Ji Young,0,14,32,32
1683696030498,BIPN 100,A04,193414,Park; Ji Young,0,13,32,32
1683696031523,BIPN 102,A01,193429,Staff,0,0,32,32
1683696031523,BIPN 102,A02,193438,Staff,18,0,32,14
1683696032546,BIPN 106,A01,193450,Reyes Gonzalez; Catalina,0,2,40,40
1683696033575,BIPN 134,A01,193465,Cooke; James Edward,0,0,32,32
1683696033575,BIPN 134,A02,193474,Cooke; James Edward,25,0,32,7
1683696033575,BIPN 134,A03,193485,Cooke; James Edward,29,0,32,3
1683696033575,BIPN 134,A04,193486,Cooke; James Edward,20,0,32,12
1683696033575,BIPN 134,A05,193491,Cooke; James Edward,31,0,32,1
1683696033575,BIPN 134,A06,193501,Cooke; James Edward,30,0,32,2
1683696033575,BIPN 134,A07,193510,Cooke; James Edward,29,0,32,3
1683696035627,BISP 194,A00,222522,Staff,14,0,32,18
1683696036651,CAT 124,A01,202407,Staff,19,0,25,6
1683696037675,CAT 125,A00,202408,Marchisotto; Jennifer Anne,2,0,20,18
1683696038703,CAT 125R,A00,202409,Smith; Lauryn Alissa,0,11,20,20
1683696038703,CAT 125R,B00,202410,Morales; Celeste Georgianna,0,11,20,20
1683696038703,CAT 125R,C00,202411,Irwin; Matthew Joseph,0,12,20,20
1683696039729,CENG 15,A01,204712,Yang; Kesong,0,1,0,0
1683696040756,CENG 114,A00,202070,Jahed Motlagh; Zeinab,5,0,20,15
1683696041782,CGS 105,A00,185477,Wesling; Megan E.,24,0,40,16
1683696042812,CGS 106,A00,185494,Staff,11,0,22,11
1683696043836,CGS 108,A00,185495,Staff,14,0,20,6
1683696044864,CGS 114,A00,185496,Staff,13,0,18,5
1683696045889,CGS 119,A00,185501,Staff,15,0,20,5
1683696046912,CGS 120,A00,185511,Staff,12,0,20,8
1683696047941,CHEM 4,A01,184675,Bussey; Thomas J,97,0,100,3
1683696048964,CHEM 6A,A01,184677,Staff,32,0,60,28
1683696049989,CHEM 6B,A01,184679,Staff,63,0,100,37
1683696051013,CHEM 6C,A01,184681,Bussey; Thomas J,0,0,50,50
1683696051013,CHEM 6C,A02,184682,Bussey; Thomas J,32,0,50,18
1683696052041,CHEM 40A,A01,184684,Albizati; Kim F.,33,0,100,67
1683696053069,CHEM 40B,A01,184686,Albizati; Kim F.,0,22,100,100
1683696054097,CHEM 41B,A01,184690,Staff,51,0,100,49
1683696055120,COGS 3,A01,184715,Boyle; Mary E. T.,0,27,40,40
1683696056144,COGS 14B,A01,185172,Staff,0,14,38,38
1683696057172,COGS 18,A01,184736,Staff,14,0,80,66
1683696058198,COGS 100,A01,184932,Staff,0,8,73,73
1683696059221,COGS 101A,A01,184935,Staff,0,40,30,30
1683696060244,COGS 101B,A01,184944,Staff,0,2,30,30
1683696061274,COGS 101C,A01,184946,Staff,0,10,30,30
1683696062300,COGS 102A,A01,184951,Johnson; Christine M.,1,0,40,39
1683696063323,COGS 107B,A01,184953,Mooshagian; Eric Frederick,0,52,40,40
1683696064346,COGS 118B,A01,184959,Gupta; Anjum,0,50,40,40
1683696065374,COGS 153,A00,184961,Staff,0,16,30,30
1683696066401,COGS 177,A00,184962,Staff,1,21,30,29
1683696067428,COGS 187A,A01,184969,Boyle; Mary E. T.,0,19,40,40
1683696068453,COMM 10,A01,185174,Staff,0,5,25,25
1683696068453,COMM 10,A02,185189,Staff,0,2,25,25
1683696068453,COMM 10,A03,269821,Staff,0,1,0,0
1683696069478,COMM 100B,A02,185476,Staff,10,0,25,15
1683696069478,COMM 100B,A03,277340,Staff,25,0,25,0
1683696070510,COMM 100C,A01,185314,Staff,2,0,25,23
1683696070510,COMM 100C,A02,185327,Staff,17,0,25,8
1683696071535,COMM 110M,A00,185349,Staff,0,0,40,40
1683696072560,COMM 113T,A00,185352,Staff,25,0,40,15
1683696073585,COMM 114I,A00,185353,Staff,31,0,40,9
1683696074608,COMM 131,A00,185354,Staff,17,0,30,13
1683696075633,CSE 8A,A50,185358,Cao; Yingjun,0,46,10,10
1683696076661,CSE 8B,A01,185362,Staff,0,48,50,50
1683696077685,CSE 11,A01,185416,Cao; Yingjun,0,91,10,10
1683696078712,CSE 20,A01,185445,Briones; Jor-el Thomas Caparas,3,0,25,22
1683696079741,CSE 21,A01,185447,Staff,9,0,50,41
1683696080766,CSE 101,A01,185451,Staff,0,13,50,50
1683696080766,CSE 101,B01,185453,Jones; Miles E,0,14,50,50
1683696082815,CSE 141,A01,185458,Eldon; John,16,0,100,84
1683696083840,CSE 141L,A01,185461,Eldon; John,8,0,100,92
1683696084865,CSE 142,A01,185463,Staff,34,0,60,26
1683696084865,CSE 142,B01,201355,Staff,0,7,60,60
1683696085894,CSE 142L,A01,185470,Staff,34,0,60,26
1683696085894,CSE 142L,B01,201417,Staff,0,6,60,60
1683696086920,CSE 190,A00,201433,Staff,32,0,49,17
1683696087945,DOC 1,A01,259136,Strom; Megan C.,7,0,15,8
1683696087945,DOC 1,A02,259137,Strom; Megan C.,14,0,15,1
1683696087945,DOC 1,A03,259138,Strom; Megan C.,14,0,15,1
1683696087945,DOC 1,A04,259139,Strom; Megan C.,14,0,15,1
1683696088973,DOC 100D,A00,259140,Pass; Natalye Joann,14,0,25,11
1683696089997,DSGN 1,A01,184749,Rill; Bryan,0,26,30,30
1683696091025,DSGN 100,A01,185168,Staff,0,2,25,25
1683696092049,ECE 5,A01,185626,Morris; Karcher William,0,12,0,0
1683696093075,ECE 101,A01,185628,Staff,14,0,70,56
1683696094098,ECE 107,A01,185635,Baghdadchi; Saharnaz,0,0,20,20
1683696094098,ECE 107,A02,185638,Baghdadchi; Saharnaz,1,0,20,19
1683696095126,ECE 148,A01,185647,Silberman; Jack,0,0,16,16
1683696096154,ECON 1,A01,185537,Crane; Meredith Helen,54,0,70,16
1683696097186,ECON 3,A01,185549,Crane; Meredith Helen,30,0,70,40
1683696098210,ECON 4,A01,203354,Anderson; John Charles,0,5,10,10
1683696099238,ECON 100A,A01,185574,Staff,0,5,40,40
1683696100262,ECON 100B,A01,185576,Staff,0,12,50,50
1683696101290,ECON 100C,A01,185589,Newhouse; Herbert S,30,0,70,40
1683696102372,ECON 105,A00,185608,Vespa; Emanuel Ignacio,19,0,35,16
1683696103395,ECON 109,A01,185610,Shishkin; Denis,9,0,35,26
1683696104419,ECON 110A,A01,185612,Staff,8,0,40,32
1683696105444,ECON 120A,A01,185615,Staff,19,0,40,21
1683696106469,ECON 120C,A01,185617,Sun; Yixiao,0,21,70,70
1683696107494,ECON 144,A00,203346,Squires; Dale E,2,0,35,33
1683696108519,ECON 171,A01,203349,Newhouse; Herbert S,0,1,35,35
1683696109543,ECON 173A,A01,185621,Toda; Alexis Akira,21,0,35,14
1683696110570,EDS 25,A01,202413,Staff,0,1,0,0
1683696110570,EDS 25,A02,202414,Staff,0,1,0,0
1683696110570,EDS 25,A03,202415,Staff,0,0,0,0
1683696110570,EDS 25,A04,202416,Staff,0,1,0,0
1683696110570,EDS 25,A05,202439,Staff,0,0,0,0
1683696110570,EDS 25,A06,202440,Staff,0,0,0,0
1683696110570,EDS 25,B01,202631,Staff,0,0,0,0
1683696110570,EDS 25,B02,202632,Staff,0,0,0,0
1683696110570,EDS 25,B03,202639,Staff,0,0,0,0
1683696110570,EDS 25,B04,202640,Staff,0,0,0,0
1683696110570,EDS 25,B05,202643,Staff,0,0,0,0
1683696110570,EDS 25,B06,202644,Staff,0,0,0,0
1683696111595,EDS 38,A01,202659,Black; Alison Michelle,24,0,25,1
1683696112619,EDS 115,A00,202652,Staff,18,0,30,12
1683696113647,EDS 125,A00,202649,Staff,13,0,30,17
1683696114671,EDS 126,A01,203332,Staff,30,0,30,0
1683696115695,EDS 139,A00,202838,Staff,16,0,25,9
1683696116719,EDS 146,A01,202655,Staff,14,0,25,11
1683696117744,ENG 15,A00,185667,Staff,0,1,0,0
1683696117744,ENG 15,B00,185672,Staff,0,0,0,0
1683696117744,ENG 15,C00,185675,Staff,0,0,0,0
1683696117744,ENG 15,D00,185682,Staff,0,0,0,0
1683696117744,ENG 15,E00,185684,Staff,0,0,0,0
1683696118768,ETHN 103,A00,185710,Staff,0,8,35,35
1683696119792,ETHN 103A,A00,199228,Man; Simeon S,0,0,9,9
1683696120816,ETHN 109,A00,185711,Staff,15,0,35,20
1683696121843,ETHN 142,A00,185726,Staff,0,4,30,30
1683696122866,ETHN 163J,A00,199229,Man; Simeon S,5,0,8,3
1683696123892,ETHN 168,A00,185727,Staff,7,0,10,3
1683696124917,ETHN 182,A00,185728,Staff,0,0,35,35
1683696125944,ETHN 183,A00,185737,Staff,9,0,18,9
1683696126971,GLBH 111,A01,209361,Burgos; Jose L.,0,0,0,0
1683696129022,HIEU 104,A00,185792,Staff,14,0,20,6
1683696130045,HIEU 115,A00,185800,Staff,0,0,20,20
1683696131072,HIEU 128,A00,185801,Staff,0,9,20,20
1683696132097,HIEU 147,A00,185802,Staff,15,0,20,5
1683696133121,HIEU 154,A00,185823,Staff,11,0,20,9
1683696134148,HILA 102,A00,185826,Staff,14,0,20,6
1683696135173,HILD 2C,A01,185778,Staff,0,13,20,20
1683696136201,HILD 7B,A01,185780,Kwak; Nancy,0,17,32,32
1683696136201,HILD 7B,A02,185781,Kwak; Nancy,0,18,32,32
1683696137226,HILD 30,A01,185791,Staff,12,0,20,8
1683696138250,HISC 119,A00,185830,Golan; Tal,0,10,20,20
1683696139272,HITO 156GS,A00,185831,Patterson; Patrick H.,0,0,0,23
1683696140299,HIUS 103,A00,185832,Man; Simeon S,0,4,20,20
1683696141323,HIUS 117,A00,185836,Kwak; Nancy,2,0,20,18
1683696142347,HIUS 125,A00,185840,Man; Simeon S,0,2,23,23
1683696143373,HIUS 149,A00,185845,Staff,1,0,20,19
1683696144397,HUM 3,A01,185882,Zavodny; Tatiana Sophia,0,8,50,50
1683696144397,HUM 3,B01,185899,Caldwell; Michael Alan,0,18,50,50
1683696145421,HUM 3GS,A00,185900,Patterson; Patrick H.,0,0,0,23
1683696146444,HUM 4,A01,185938,Zroka; Amy Liane,28,0,50,22
1683696146444,HUM 4,B01,185956,Watkins; Eric,0,6,50,50
1683696146444,HUM 4,B02,202209,Watkins; Eric,0,5,50,50
1683696146444,HUM 4,B03,202210,Watkins; Eric,0,5,50,50
1683696147469,HUM 5,A01,185958,West; Geoffrey Scott,0,0,50,50
1683696147469,HUM 5,A02,202215,West; Geoffrey Scott,0,1,50,50
1683696148493,INTL 190,A00,185959,Gagnon; Jeffrey C,0,0,0,9
1683696148493,INTL 190,B00,185960,Lettieri; Michael Joseph,0,0,0,2
1683696149518,JAPN 180,A00,254509,Staff,5,0,30,25
1683696150543,LATI 10,A01,202853,Kennemore; Amy Michelle,4,0,35,31
1683696150543,LATI 10,A02,202854,Kennemore; Amy Michelle,3,0,35,32
1683696150543,LATI 10,A03,270054,Kennemore; Amy Michelle,30,0,30,0
1683696151568,LATI 180,A00,202855,Kennemore; Amy Michelle,11,0,20,9
1683696152592,LAWS 101,A00,201767,Golan; Tal,0,7,40,40
1683696153616,LIFR 1C,A00,185961,Staff,6,0,20,14
1683696154639,LIFR 1CX,A00,185962,Staff,7,0,20,13
1683696155665,LIFR 1D,A00,185963,Staff,7,0,20,13
1683696156693,LIFR 1DX,A00,185964,Staff,7,0,20,13
1683696157721,LIGN 101,A01,186039,Staff,43,0,50,7
1683696158746,LIGN 165,A00,186040,Staff,15,0,50,35
1683696159773,LTCS 108,A00,186041,Staff,5,0,10,5
1683696160800,LTCS 119,A00,186042,Staff,15,0,20,5
1683696161830,LTCS 130,A00,186043,Wesling; Megan E.,15,0,25,10
1683696163881,LTEA 138,A00,186119,Staff,14,0,40,26
1683696164906,LTEN 124,A00,186148,Staff,5,0,25,20
1683696165933,LTEN 178,A00,186149,Staff,6,0,15,9
1683696166957,LTEN 181,A00,186150,Blanco; John D,34,0,40,6
1683696167980,LTWL 120,A00,186160,Staff,19,0,25,6
1683696169011,LTWL 165,A00,186161,Staff,22,0,25,3
1683696170035,LTWR 100,A00,186162,Staff,0,5,15,15
1683696171060,LTWR 102,A00,186163,Doller; Ben,5,0,15,10
1683696172085,MAE 8,A01,186412,Staff,0,1,0,0
1683696173113,MAE 30B,A00,186445,Bahadori; Mohammad Yousef,81,0,100,19
1683696174139,MAE 40,A00,186592,Bewley; Thomas R,10,0,50,40
1683696175167,MAE 101B,A00,186593,Bahadori; Mohammad Yousef,80,0,100,20
1683696176194,MAE 105,A00,186594,Bandaru; Prabhakar,10,0,50,40
1683696177219,MAE 107,A00,186599,Pham; Hieu Tan,0,7,120,120
1683696178242,MAE 148,A01,186660,Silberman; Jack,3,0,16,13
1683696179266,MATH 10A,A01,188095,Staff,0,6,35,35
1683696180296,MATH 10B,A01,188097,Bowers; Adam R.,0,12,30,30
1683696180296,MATH 10B,A02,188099,Bowers; Adam R.,0,11,30,30
1683696180296,MATH 10B,B01,188104,Bowers; Adam R.,0,10,30,30
1683696180296,MATH 10B,B02,188106,Bowers; Adam R.,1,10,30,29
1683696181322,MATH 10C,A01,188111,Staff,0,20,30,30
1683696181322,MATH 10C,A02,188127,Staff,0,19,30,30
1683696181322,MATH 10C,A03,188131,Staff,0,19,30,30
1683696181322,MATH 10C,B01,188218,Staff,17,0,30,13
1683696181322,MATH 10C,B02,188244,Staff,13,0,30,17
1683696181322,MATH 10C,B03,188277,Staff,14,0,30,16
1683696182348,MATH 18,A01,188344,Bach; Quang Tran,18,0,30,12
1683696182348,MATH 18,A02,188345,Bach; Quang Tran,11,0,30,19
1683696182348,MATH 18,B01,188353,Bach; Quang Tran,11,0,30,19
1683696182348,MATH 18,B02,188354,Bach; Quang Tran,19,0,30,11
1683696183371,MATH 20A,A01,188374,Staff,11,0,35,24
1683696184396,MATH 20B,A01,188382,Ohm; Ko Woon,7,0,30,23
1683696184396,MATH 20B,A02,188383,Ohm; Ko Woon,22,0,30,8
1683696184396,MATH 20B,B01,188385,Ohm; Ko Woon,7,0,30,23
1683696184396,MATH 20B,B02,188392,Ohm; Ko Woon,22,0,30,8
1683696185420,MATH 20C,A01,188394,Harel; Guershon,10,0,30,20
1683696185420,MATH 20C,A02,188395,Harel; Guershon,13,0,30,17
1683696185420,MATH 20C,B01,188404,Harel; Guershon,5,0,30,25
1683696185420,MATH 20C,B02,188405,Harel; Guershon,18,0,30,12
1683696186451,MATH 20D,A01,188414,Hammock; Frances H,0,1,30,30
1683696186451,MATH 20D,A02,188415,Hammock; Frances H,0,1,30,30
1683696186451,MATH 20D,B01,188447,Hammock; Frances H,0,1,30,30
1683696186451,MATH 20D,B02,188486,Hammock; Frances H,2,0,30,28
1683696187481,MATH 20E,A01,188649,Staff,21,0,30,9
1683696187481,MATH 20E,A02,188650,Staff,20,0,30,10
1683696187481,MATH 20E,A03,188673,Staff,0,0,30,30
1683696188506,MATH 102,A01,188675,Staff,0,40,35,35
1683696189532,MATH 103B,A01,188681,Staff,3,0,35,32
1683696189532,MATH 103B,B01,188692,Staff,5,0,35,30
1683696190557,MATH 109,A01,188695,Salehi Golsefidy; Alireza,24,0,35,11
1683696190557,MATH 109,A02,188696,Salehi Golsefidy; Alireza,25,0,35,10
1683696191582,MATH 120A,A01,188698,Eggers; John Dietrich,7,0,35,28
1683696192610,MATH 142B,A01,188736,Ioana; Adrian,1,1,30,29
1683696192610,MATH 142B,A02,188741,Ioana; Adrian,0,1,30,30
1683696192610,MATH 142B,A03,188743,Ioana; Adrian,0,2,30,30
1683696193635,MATH 168A,A01,188790,Staff,0,11,35,35
1683696194659,MATH 170A,A01,188803,Nie; Jiawang,0,2,35,35
1683696194659,MATH 170A,A02,188811,Nie; Jiawang,0,1,35,35
1683696194659,MATH 170A,A03,188814,Nie; Jiawang,0,0,35,35
1683696194659,MATH 170A,A04,188815,Nie; Jiawang,5,0,35,30
1683696195685,MATH 193B,A01,188817,Staff,0,0,35,35
1683696195685,MATH 193B,A02,188818,Staff,6,0,35,29
1683696196708,MGT 4,A01,202857,Anderson; John Charles,59,0,80,21
1683696197732,MGT 12,A00,202858,Lindenberger; Wade Douglas,40,0,90,50
1683696198755,MGT 18,A00,202859,Staff,74,0,90,16
1683696199780,MGT 18GS,A00,202860,McKay; Michael J,13,0,28,15
1683696200807,MGT 45,A00,202861,Pecore; Joseph P.,8,0,90,82
1683696201833,MGT 100,A00,202863,Yavorsky; Daniel Ryan,27,0,90,63
1683696202859,MGT 103,A00,202864,Ehrich; Kristine R,0,19,90,90
1683696203887,MGT 112,A00,202865,Ehrich; Kristine R,15,0,90,75
1683696204926,MGT 121A,A00,202868,Staff,90,20,90,0
1683696206011,MGT 131B,A00,202869,Anderson; John Charles,58,0,90,32
1683696207038,MGT 136,A00,202871,Lindenberger; Wade Douglas,83,0,90,7
1683696208065,MGT 164,A00,202873,Staff,0,67,90,91
1683696209092,MGT 164GS,A00,202874,McKay; Mary A,13,0,28,15
1683696210117,MGT 180,A00,202875,Staff,0,51,90,91
1683696211139,MMW 11R,A01,205019,Herbst; Matthew,0,0,30,30
1683696211139,MMW 11R,A02,205026,Herbst; Matthew,29,0,30,1
1683696212163,MMW 15,A01,193512,Chang; Edmond Yi-Teh,0,8,28,28
1683696212163,MMW 15,A02,193513,Chang; Edmond Yi-Teh,0,5,28,28
1683696212163,MMW 15,A03,193514,Chang; Edmond Yi-Teh,0,5,28,28
1683696212163,MMW 15,A04,193515,Chang; Edmond Yi-Teh,0,5,28,28
1683696212163,MMW 15,A05,193516,Chang; Edmond Yi-Teh,0,5,28,28
1683696212163,MMW 15,A06,193517,Chang; Edmond Yi-Teh,0,6,28,28
1683696212163,MMW 15,B01,193519,Chang; Edmond Yi-Teh,0,5,28,28
1683696212163,MMW 15,B02,193520,Chang; Edmond Yi-Teh,0,5,28,28
1683696212163,MMW 15,B03,193521,Chang; Edmond Yi-Teh,0,5,28,28
1683696212163,MMW 15,B04,193522,Chang; Edmond Yi-Teh,0,6,28,28
1683696212163,MMW 15,B05,193523,Chang; Edmond Yi-Teh,0,5,28,28
1683696212163,MMW 15,B06,193524,Chang; Edmond Yi-Teh,0,5,28,28
1683696213189,MMW 122,A01,193526,Rahimi; Babak,0,16,28,28
1683696213189,MMW 122,A02,193527,Rahimi; Babak,0,15,28,28
1683696213189,MMW 122,A03,193528,Rahimi; Babak,0,0,0,0
1683696213189,MMW 122,A04,193529,Rahimi; Babak,0,0,0,0
1683696214213,MUS 1A,A01,186663,Staff,1,19,35,34
1683696215240,MUS 4,A01,186715,Staff,0,12,35,35
1683696216264,MUS 5R,A01,186796,Dubnov; Shlomo,0,17,35,35
1683696217289,MUS 6,A01,186798,Staff,1,5,25,24
1683696218316,MUS 7,A01,186830,Staff,11,0,35,24
1683696219343,MUS 8,A01,186930,Staff,0,27,35,35
1683696220371,MUS 15,A01,186932,Staff,0,15,35,35
1683696220371,MUS 15,B01,186934,Staff,1,17,35,34
1683696221399,MUS 80,A00,186935,Staff,0,0,20,20
1683696221399,MUS 80,B00,186936,Staff,24,0,25,1
1683696222427,NANO 11,A00,204702,Lipomi; Darren John,0,0,0,0
1683696223455,NANO 15,A01,204709,Yang; Kesong,0,1,0,0
1683696224479,NANO 114,A00,202069,Jahed Motlagh; Zeinab,2,0,10,8
1683696225506,PHIL 1,A00,186955,Grush; Rick Scott,31,0,40,9
1683696226532,PHIL 10,A01,186973,Grush; Rick Scott,27,0,35,8
1683696226532,PHIL 10,A02,186974,Grush; Rick Scott,33,0,35,2
1683696227556,PHIL 13,A01,186976,Staff,1,0,35,34
1683696227556,PHIL 13,A02,186977,Staff,16,0,35,19
1683696228579,PHIL 14,A01,186979,Staff,31,0,35,4
1683696228579,PHIL 14,A02,186986,Staff,32,0,35,3
1683696229606,PHIL 28,A01,186988,Staff,16,0,30,14
1683696229606,PHIL 28,A02,186989,Staff,1,0,30,29
1683696229606,PHIL 28,A03,186990,Staff,10,0,30,20
1683696229606,PHIL 28,A04,186991,Staff,26,0,30,4
1683696230632,PHIL 120,A00,186997,Staff,23,0,40,17
1683696231655,PHIL 137,A00,187003,Staff,7,0,40,33
1683696232680,PHIL 150,A00,187015,Staff,47,0,70,23
1683696233705,PHIL 167,A00,187021,Lamey; Andy M.,34,0,40,6
1683696234733,PHIL 174,A01,202226,Staff,17,0,20,3
1683696234733,PHIL 174,A02,202235,Staff,20,0,20,0
1683696235758,PHIL 191A,A00,258918,Staff,0,0,1,1
1683696236785,PHYS 1A,A00,187028,Staff,26,0,60,34
1683696237809,PHYS 1AL,001,187036,Staff,3,0,30,27
1683696237809,PHYS 1AL,002,187049,Staff,18,0,30,12
1683696238836,PHYS 1B,A00,187058,Staff,22,0,60,38
1683696239860,PHYS 1BL,001,187064,Staff,0,1,30,30
1683696239860,PHYS 1BL,002,187070,Staff,4,0,30,26
1683696240883,PHYS 1C,A00,187082,Staff,29,0,120,91
1683696241908,PHYS 1CL,001,187088,Staff,0,9,30,30
1683696241908,PHYS 1CL,002,187089,Staff,0,1,30,30
1683696241908,PHYS 1CL,009,262693,Staff,9,0,30,21
1683696242932,PHYS 2B,A01,187097,Staff,55,0,115,60
1683696243956,PHYS 2C,A01,187099,Staff,63,0,115,52
1683696244980,PHYS 2CL,A01,187101,Staff,5,0,28,23
1683696244980,PHYS 2CL,A02,187102,Staff,15,0,28,13
1683696246005,PHYS 2D,A01,187123,Shotwell; Brian,95,0,115,20
1683696247028,PHYS 4B,A01,187133,Grinstein; Benjamin,35,0,50,15
1683696248055,POLI 10,A00,188819,Staff,0,4,50,50
1683696249079,POLI 11,A00,188827,Staff,43,0,50,7
1683696250106,POLI 13R,A00,188828,Staff,0,1,20,20
1683696251133,POLI 27,A01,188830,Elgin; Samuel Zincke,0,2,70,70
1683696252159,POLI 30,A00,188832,Desposato; Scott,30,0,50,20
1683696253185,POLI 102F,A00,188834,Staff,1,0,40,39
1683696254212,POLI 104A,A00,188852,Staff,12,0,30,18
1683696255236,POLI 104I,A00,188853,Staff,0,8,20,20
1683696256261,POLI 110B,A00,188854,Wiens; David,6,0,20,14
1683696257284,POLI 112A,A00,188855,Wiens; David,3,0,30,27
1683696258311,POLI 117R,A00,188856,Forman; Fonna,0,12,20,20
1683696259338,POLI 118,A00,188857,Ingham; Sean,8,0,20,12
1683696260364,POLI 120G,A00,188858,Staff,8,0,30,22
1683696261386,POLI 131CR,A00,188863,Hoston; Germaine,20,0,50,30
1683696262413,POLI 133,A00,188864,Nellis; Gareth Hb,44,0,50,6
1683696263437,POLI 134D,A00,188865,Desposato; Scott,27,0,30,3
1683696264461,POLI 142A,A00,188871,Gartzke; Erik,21,0,50,29
1683696265489,POLI 142K,A00,188874,Staff,38,0,50,12
1683696266513,POLI 143,A00,188940,Gartzke; Erik,16,0,30,14
1683696267538,POLI 153,A00,188943,Staff,2,0,20,18
1683696268562,POLI 160AA,A00,188944,Staff,10,0,40,30
1683696269586,POLI 170A,A00,188945,Staff,10,0,30,20
1683696271634,PSYC 1,A00,188952,Staff,36,0,90,54
1683696272661,PSYC 2,B00,188953,Staff,19,0,35,16
1683696273684,PSYC 6,A00,188970,Staff,47,0,60,13
1683696274708,PSYC 7,A00,188973,Staff,35,0,45,10
1683696275735,PSYC 60,A01,188980,Rickard; Timothy C.,42,0,60,18
1683696276759,PSYC 70,A01,189001,Steiner; Eric Tomas,21,0,45,24
1683696277791,PSYC 100,A00,189005,Lacefield; Katharine I,0,99,120,120
1683696278823,PSYC 102,A00,189008,Staff,7,0,30,23
1683696279848,PSYC 106,B00,189026,Gorman; Michael R.,27,0,60,33
1683696280872,PSYC 114,B01,189033,Winkielman; Piotr,0,31,30,30
1683696281897,PSYC 131,A00,189036,Anagnostaras; Stephan,0,44,60,60
1683696282921,PSYC 136,A00,189041,Lowe; Angela Beth,0,7,25,25
1683696283943,PSYC 137,A00,189057,Winkielman; Piotr,1,37,25,24
1683696284966,PSYC 144,A00,189107,Wixted; John T,0,11,50,50
1683696287015,PSYC 162,A00,189142,Staff,0,9,85,85
1683696288040,PSYC 172,A00,189144,Gorman; Michael R.,0,6,30,30
1683696290090,PSYC 179,A00,189146,Lacefield; Katharine I,0,89,120,120
1683696291115,PSYC 181,A00,189147,Anagnostaras; Stephan,0,44,90,90
1683696292143,PSYC 190R,A00,189148,Barner; David A.,0,23,80,80
1683696293167,PSYC 191,A00,189275,Rickard; Timothy C.,0,11,25,25
1683696294192,PSYC 193,A00,189276,Chapman; Eddie Nathaniel,0,1,0,4
1683696295216,PSYC 193L,A01,189281,Lowe; Angela Beth,8,0,20,12
1683696295216,PSYC 193L,B01,189285,Staff,28,0,35,7
1683696296242,RELI 149,A00,187137,Rahimi; Babak,6,0,40,34
1683696297266,SE 9,A01,187315,Staff,0,2,18,18
1683696298289,SE 101B,A00,187409,Staff,24,0,30,6
1683696299313,SE 110B,A00,187444,Staff,10,0,40,30
1683696300338,SE 130B,A00,187449,Staff,31,0,40,9
1683696301362,SE 150A,A00,187516,Staff,8,0,20,12
1683696302386,SE 154,A00,187528,Staff,29,0,50,21
1683696303412,SIO 3,A01,258171,Staff,35,0,40,5
1683696304436,SIO 10,A00,187144,Cook; Geoffrey W,1,7,75,74
1683696305461,SIO 45,A00,187152,Cook; Geoffrey W,0,7,100,100
1683696306484,SIO 109R,A00,194486,Staff,0,4,20,20
1683696308534,SIO 187,A01,187233,Kacev; David,12,0,40,28
1683696309624,SOCI 1,A01,258656,Thorpe; Charles Robert,28,0,30,2
1683696309624,SOCI 1,A02,258658,Thorpe; Charles Robert,30,0,30,0
1683696309624,SOCI 1,A03,258661,Thorpe; Charles Robert,25,0,25,0
1683696309624,SOCI 1,A04,258666,Thorpe; Charles Robert,22,0,25,3
1683696309624,SOCI 1,A05,258897,Thorpe; Charles Robert,22,0,25,3
1683696309624,SOCI 1,A06,258898,Thorpe; Charles Robert,25,0,25,0
1683696310647,SOCI 30,A01,258903,Pardo Guerra; Juan Pablo,14,0,30,16
1683696311670,SOCI 102,A00,258904,Staff,9,0,25,16
1683696312697,SOCI 106,A00,258905,Staff,19,0,25,6
1683696313720,SOCI 111,A00,258907,Ribas Norris; Janet Vanesa,26,0,30,4
1683696314745,SOCI 121R,A00,258908,Pardo Guerra; Juan Pablo,7,0,30,23
1683696315769,SOCI 126,A01,203330,Staff,14,0,20,6
1683696316795,SOCI 131,A00,258909,Thorpe; Charles Robert,30,0,60,30
1683696317821,SOCI 135,A00,258910,Payne; Christine Anna,0,13,30,30
1683696318847,SOCI 157,A00,258911,Staff,10,0,30,20
1683696319869,SOCI 184,A00,258912,Staff,25,0,30,5
1683696320893,SOCI 188D,A00,258913,Staff,22,0,30,8
1683696321917,SYN 2,001,187529,Staff,9,0,16,7
1683696321917,SYN 2,002,201452,Staff,1,21,16,15
1683696321917,SYN 2,003,201469,Staff,1,0,16,15
1683696322940,SYN 100,A01,187531,Staff,0,9,20,20
1683696322940,SYN 100,B01,201491,Staff,0,10,20,20
1683696323967,TDAC 1,A00,189286,Walsh; Kim C.,3,0,20,17
1683696323967,TDAC 1,B00,189287,Harting; Carla Kelso,10,0,20,10
1683696324995,TDAC 101,A00,189300,Walsh; Kim C.,16,0,20,4
1683696324995,TDAC 101,B00,189301,Harting; Carla Kelso,18,0,20,2
1683696326025,TDAC 102,A00,189304,Basso; Beatrice,14,0,20,6
1683696327047,TDAC 108,A00,189305,Staff,18,0,20,2
1683696328074,TDDE 131,A00,189310,Staff,19,0,20,1
1683696328074,TDDE 131,B00,189314,Staff,19,0,20,1
1683696328074,TDDE 131,C00,189315,Staff,48,0,50,2
1683696328074,TDDE 131,D00,189316,Staff,14,0,15,1
1683696328074,TDDE 131,E00,204841,Staff,20,0,20,0
1683696329097,TDGE 10,A00,189289,Staff,27,0,50,23
1683696329097,TDGE 10,B00,189290,Havis; Allan,0,1,50,50
1683696330121,TDGE 11,A00,189291,Fulton; Julia,0,4,50,50
1683696330121,TDGE 11,B00,189292,Staff,20,0,25,5
1683696330121,TDGE 11,C00,260270,Staff,0,0,0,0
1683696331144,TDGE 25,A00,189294,Staff,1,0,20,19
1683696332167,TDGE 124,A00,189318,Fulton; Julia,1,8,50,49
1683696333190,TDGE 125,A00,189319,Staff,13,0,25,12
1683696333190,TDGE 125,B00,189320,Staff,23,0,25,2
1683696334214,TDGE 127,A00,189322,Havis; Allan,0,0,50,50
1683696335241,TDHT 101,A00,189323,Staff,18,0,25,7
1683696335241,TDHT 101,B00,189324,Staff,25,0,25,0
1683696346743,TDHT 102,A00,189325,Staff,49,0,50,1
1683696347772,TDMV 1,A00,189295,Arcidiacono; Kristin,20,0,30,10
1683696347772,TDMV 1,B00,189296,Caligagan; Maria T.,24,0,30,6
1683696348807,TDMV 2,A00,189297,Sammartano; Tonnie,27,0,30,3
1683696348807,TDMV 2,B00,189299,Arcidiacono; Kristin,23,0,30,7
1683696349831,TDMV 3,A00,204998,Rincon; Alicia,22,0,30,8
1683696350856,TDMV 120,A00,189458,Sammartano; Tonnie,28,0,30,2
1683696351884,TDMV 138,A00,189541,Jun; Grace Shin Hae,20,0,40,20
1683696352911,TDMV 142,A00,189717,Caligagan; Tony,25,0,30,5
1683696352911,TDMV 142,B00,189718,Caligagan; Maria T.,25,0,30,5
1683696353938,TMC 2,A01,187533,Staff,25,0,25,0
1683696353938,TMC 2,A02,187534,Staff,25,0,25,0
1683696354965,USP 1,A01,187536,Kwak; Nancy,0,16,25,25
1683696355993,USP 5,A01,187538,Staff,8,0,25,17
1683696357019,USP 101,A00,199253,Staff,0,4,0,0
1683696358043,USP 124,A00,187562,Boomhower; Matthew Charles,0,0,30,30
1683696359067,USP 138,A00,187582,Staff,19,0,25,6
1683696360092,USP 152,A01,187597,Staff,3,0,25,22
1683696361115,USP 153,A00,187598,Staff,18,0,25,7
1683696362143,USP 168,A00,187607,Kwak; Nancy,2,0,5,3
1683696363170,USP 173,A00,187619,Staff,4,0,25,21
1683696364195,USP 181,A00,187638,Staff,0,4,25,25
1683696365219,VIS 103,A00,187650,Cruz; Edwin Teddy,17,0,75,58
1683696366247,VIS 110D,A00,187669,Staff,13,0,22,9
1683696367272,VIS 127C,A00,187720,Shen; Kuiyi,67,0,146,79
1683696368297,VIS 149,A00,187731,Yoldas; Pinar,2,14,22,20
1683696369324,VIS 151,A01,188091,Staff,22,0,34,12
1683696369324,VIS 151,A02,188092,Staff,11,0,34,23
1683696370351,VIS 160B,A00,188093,Stalbaum; Brett,0,1,10,10
1683696372406,WCWP 10B,A00,201720,Staff,0,0,5,5
1683696372406,WCWP 10B,B00,201722,Staff,0,0,6,6
1683696373433,WCWP 100,A00,201725,Gagnon; Jeffrey C,0,0,2,2
1683696373433,WCWP 100,B00,201727,Staff,0,4,15,15
1683696376560,ANBI 133,A00,258401,Wilder; Linnea Lorene,34,0,40,6
1683696377583,ANBI 140,A00,258395,Hrvoj Mihic; Branka,18,0,25,7
1683696378607,ANSC 120,A00,258402,Bialecki; Jon Anthony,26,0,40,14
1683696379635,ANSC 144,A00,258400,Staff,12,0,40,28
1683696381683,ANSC 166,A00,258396,Parish; Steven Martin,156,0,175,19
1683696382712,ANSC 180,A00,193533,Staff,8,0,20,12
1683696383735,ANSC 188,A00,258397,Jassal; Aftab,34,0,40,6
1683696384763,ANTH 3,A01,258316,Staff,23,0,30,7
1683696385792,ANTH 5,A00,258394,Semendeferi; Ekaterini,16,0,20,4
1683696386817,ANTH 21,A01,258331,Staff,4,0,40,36
1683696387840,ANTH 103,A00,258398,Varma; Saiba,15,0,25,10
1683696388869,AWP 10,001,202034,Staff,0,0,0,0
1683696388869,AWP 10,002,202035,Staff,0,0,0,0
1683696388869,AWP 10,003,202036,Staff,0,0,0,0
1683696388869,AWP 10,004,202037,Staff,0,0,0,0
1683696388869,AWP 10,005,202038,Staff,0,0,0,0
1683696388869,AWP 10,006,202039,Staff,0,0,0,0
1683696388869,AWP 10,007,202040,Staff,0,0,0,0
1683696388869,AWP 10,008,202041,Staff,0,0,0,0
1683696388869,AWP 10,009,202042,Staff,0,0,0,0
1683696388869,AWP 10,010,202043,Staff,0,0,0,0
1683696388869,AWP 10,011,202044,Staff,0,0,0,0
1683696388869,AWP 10,012,202045,Staff,0,0,0,0
1683696388869,AWP 10,013,202046,Staff,0,0,0,0
1683696388869,AWP 10,014,202047,Staff,0,0,0,0
1683696388869,AWP 10,015,202048,Staff,0,0,0,0
1683696388869,AWP 10,016,202049,Staff,0,0,0,0
1683696388869,AWP 10,017,202050,Staff,0,0,0,0
1683696388869,AWP 10,018,202051,Staff,0,0,0,0
1683696388869,AWP 10,019,202052,Staff,0,0,0,0
1683696388869,AWP 10,020,202053,Staff,0,0,0,0
1683696388869,AWP 10,021,202054,Staff,0,0,0,0
1683696388869,AWP 10,022,202055,Staff,0,0,0,0
1683696388869,AWP 10,023,202056,Staff,0,0,0,0
1683696388869,AWP 10,024,202057,Staff,0,0,0,0
1683696388869,AWP 10,025,202058,Staff,0,0,0,0
1683696388869,AWP 10,026,202059,Staff,0,0,0,0
1683696389894,AWP 102,001,202032,Staff,0,0,0,0
1683696389894,AWP 102,002,202033,Staff,0,0,0,0
1683696390919,BENG 100,A01,254234,Taylor Amos; Alyssa C,31,0,40,9
1683696391945,BENG 196,001,270013,Engler; Adam J.,9999,0,9999,0
1683696392973,BICD 100R,A01,202018,Smith; Laurie,0,7,32,32
1683696392973,BICD 100R,A02,202019,Smith; Laurie,0,3,32,32
1683696392973,BICD 100R,A03,202020,Smith; Laurie,0,1,32,32
1683696392973,BICD 100R,A04,202021,Smith; Laurie,6,0,32,26
1683696392973,BICD 100R,A05,202022,Smith; Laurie,10,0,32,22
1683696393998,BICD 136,A01,193242,Gustafson-Brown; Cindy,0,2,32,32
1683696393998,BICD 136,A02,193244,Gustafson-Brown; Cindy,13,0,32,19
1683696395028,BIEB 102,A01,193249,Butler; Shannon Rhey,0,0,32,32
1683696395028,BIEB 102,A02,193251,Butler; Shannon Rhey,0,0,32,32
1683696395028,BIEB 102,A03,193253,Butler; Shannon Rhey,0,0,32,32
1683696395028,BIEB 102,A04,193255,Butler; Shannon Rhey,13,0,32,19
1683696395028,BIEB 102,A05,193265,Butler; Shannon Rhey,25,0,32,7
1683696395028,BIEB 102,A06,193269,Butler; Shannon Rhey,12,0,32,20
1683696397085,BIEB 150,A01,193274,Staff,0,0,32,32
1683696397085,BIEB 150,A02,193285,Staff,24,0,32,8
1683696398108,BIEB 194,A00,193286,Kurle; Carolyn M.,19,0,32,13
1683696399133,BILD 1,A01,192291,Staff,15,0,32,17
1683696399133,BILD 1,A02,192292,Staff,30,0,32,2
1683696399133,BILD 1,B01,192520,Reuther; Keefe,0,1,0,0
1683696399133,BILD 1,B02,192532,Reuther; Keefe,0,1,0,0
1683696400173,BILD 3,A01,192556,Butler; Shannon Rhey,0,0,32,32
1683696400173,BILD 3,A02,192581,Butler; Shannon Rhey,0,1,32,32
1683696400173,BILD 3,A03,192611,Butler; Shannon Rhey,19,0,32,13
1683696400173,BILD 3,A04,192612,Butler; Shannon Rhey,23,0,32,9
1683696400173,BILD 3,A05,192613,Butler; Shannon Rhey,26,0,32,6
1683696400173,BILD 3,A06,192679,Butler; Shannon Rhey,27,0,32,5
1683696400173,BILD 3,A07,192682,Butler; Shannon Rhey,20,0,32,12
1683696401202,BILD 4,A01,192836,Reuther; Keefe,1,0,24,23
1683696401202,BILD 4,A02,193044,Reuther; Keefe,4,0,24,20
1683696402225,BILD 10,A01,193142,Gustafson-Brown; Cindy,29,0,32,3
1683696402225,BILD 10,A02,193149,Gustafson-Brown; Cindy,31,0,32,1
1683696403250,BIMM 100,A01,193301,Staff,0,6,32,32
1683696403250,BIMM 100,A02,193312,Staff,0,7,32,32
1683696403250,BIMM 100,A03,193323,Staff,0,10,32,32
1683696404275,BIMM 101,A01,193329,McDonnell; Lisa Marie,0,3,24,24
1683696404275,BIMM 101,A02,193339,McDonnell; Lisa Marie,0,3,24,24
1683696404275,BIMM 101,B01,193354,McDonnell; Lisa Marie,0,4,24,24
1683696404275,BIMM 101,B02,193357,McDonnell; Lisa Marie,0,3,24,24
1683696405304,BIMM 110,A01,193377,Tat; John,0,11,32,32
1683696405304,BIMM 110,A02,193378,Tat; John,0,11,32,32
1683696406328,BIMM 120,A01,206116,Staff,0,0,32,32
1683696406328,BIMM 120,A02,206117,Staff,7,0,32,25
1683696406328,BIMM 120,A03,206121,Staff,21,0,32,11
1683696407357,BIPN 100,A01,193393,Park; Ji Young,0,15,32,32
1683696407357,BIPN 100,A02,193402,Park; Ji Young,0,14,32,32
1683696407357,BIPN 100,A03,193413,Park; Ji Young,0,14,32,32
1683696407357,BIPN 100,A04,193414,Park; Ji Young,0,13,32,32
1683696408381,BIPN 102,A01,193429,Staff,0,0,32,32
1683696408381,BIPN 102,A02,193438,Staff,18,0,32,14
1683696409404,BIPN 106,A01,193450,Reyes Gonzalez; Catalina,0,2,40,40
1683696410430,BIPN 134,A01,193465,Cooke; James Edward,0,0,32,32
1683696410430,BIPN 134,A02,193474,Cooke; James Edward,25,0,32,7
1683696410430,BIPN 134,A03,193485,Cooke; James Edward,29,0,32,3
1683696410430,BIPN 134,A04,193486,Cooke; James Edward,20,0,32,12
1683696410430,BIPN 134,A05,193491,Cooke; James Edward,31,0,32,1
1683696410430,BIPN 134,A06,193501,Cooke; James Edward,30,0,32,2
1683696410430,BIPN 134,A07,193510,Cooke; James Edward,29,0,32,3
1683696412481,BISP 194,A00,222522,Staff,14,0,32,18
1683696413507,CAT 124,A01,202407,Staff,19,0,25,6
1683696414534,CAT 125,A00,202408,Marchisotto; Jennifer Anne,2,0,20,18
1683696415563,CAT 125R,A00,202409,Smith; Lauryn Alissa,0,11,20,20
1683696415563,CAT 125R,B00,202410,Morales; Celeste Georgianna,0,11,20,20
1683696415563,CAT 125R,C00,202411,Irwin; Matthew Joseph,0,12,20,20
1683696416587,CENG 15,A01,204712,Yang; Kesong,0,1,0,0
1683696417610,CENG 114,A00,202070,Jahed Motlagh; Zeinab,5,0,20,15
1683696418634,CGS 105,A00,185477,Wesling; Megan E.,24,0,40,16
1683696419658,CGS 106,A00,185494,Staff,11,0,22,11
1683696420681,CGS 108,A00,185495,Staff,14,0,20,6
1683696421705,CGS 114,A00,185496,Staff,13,0,18,5
1683696422728,CGS 119,A00,185501,Staff,15,0,20,5
1683696423811,CGS 120,A00,185511,Staff,12,0,20,8
1683696424835,CHEM 4,A01,184675,Bussey; Thomas J,97,0,100,3
1683696425860,CHEM 6A,A01,184677,Staff,32,0,60,28
1683696426884,CHEM 6B,A01,184679,Staff,63,0,100,37
1683696427913,CHEM 6C,A01,184681,Bussey; Thomas J,0,0,50,50
1683696427913,CHEM 6C,A02,184682,Bussey; Thomas J,32,0,50,18
1683696428936,CHEM 40A,A01,184684,Albizati; Kim F.,33,0,100,67
1683696429964,CHEM 40B,A01,184686,Albizati; Kim F.,0,22,100,100
1683696430989,CHEM 41B,A01,184690,Staff,51,0,100,49
1683696432018,COGS 3,A01,184715,Boyle; Mary E. T.,0,27,40,40
1683696433045,COGS 14B,A01,185172,Staff,0,14,38,38
1683696434072,COGS 18,A01,184736,Staff,14,0,80,66
1683696435096,COGS 100,A01,184932,Staff,0,8,73,73
1683696436121,COGS 101A,A01,184935,Staff,0,40,30,30
1683696437145,COGS 101B,A01,184944,Staff,0,2,30,30
1683696438172,COGS 101C,A01,184946,Staff,0,10,30,30
1683696439206,COGS 102A,A01,184951,Johnson; Christine M.,1,0,40,39
1683696440232,COGS 107B,A01,184953,Mooshagian; Eric Frederick,0,52,40,40
1683696441256,COGS 118B,A01,184959,Gupta; Anjum,0,50,40,40
1683696442279,COGS 153,A00,184961,Staff,0,16,30,30
1683696443305,COGS 177,A00,184962,Staff,0,20,30,30
1683696444330,COGS 187A,A01,184969,Boyle; Mary E. T.,0,19,40,40
1683696445355,COMM 10,A01,185174,Staff,0,5,25,25
1683696445355,COMM 10,A02,185189,Staff,0,2,25,25
1683696445355,COMM 10,A03,269821,Staff,0,1,0,0
1683696446379,COMM 100B,A02,185476,Staff,10,0,25,15
1683696446379,COMM 100B,A03,277340,Staff,25,0,25,0
1683696447403,COMM 100C,A01,185314,Staff,2,0,25,23
1683696447403,COMM 100C,A02,185327,Staff,17,0,25,8
1683696448428,COMM 110M,A00,185349,Staff,0,0,40,40
1683696449456,COMM 113T,A00,185352,Staff,25,0,40,15
1683696450481,COMM 114I,A00,185353,Staff,31,0,40,9
1683696451507,COMM 131,A00,185354,Staff,17,0,30,13
1683696452530,CSE 8A,A50,185358,Cao; Yingjun,0,46,10,10
1683696453558,CSE 8B,A01,185362,Staff,0,48,50,50
1683696454586,CSE 11,A01,185416,Cao; Yingjun,0,91,10,10
1683696455613,CSE 20,A01,185445,Briones; Jor-el Thomas Caparas,3,0,25,22
1683696456637,CSE 21,A01,185447,Staff,9,0,50,41
1683696457665,CSE 101,A01,185451,Staff,0,13,50,50
1683696457665,CSE 101,B01,185453,Jones; Miles E,0,14,50,50
1683696459715,CSE 141,A01,185458,Eldon; John,16,0,100,84
1683696460740,CSE 141L,A01,185461,Eldon; John,8,0,100,92
1683696461764,CSE 142,A01,185463,Staff,34,0,60,26
1683696461764,CSE 142,B01,201355,Staff,0,7,60,60
1683696462793,CSE 142L,A01,185470,Staff,34,0,60,26
1683696462793,CSE 142L,B01,201417,Staff,0,6,60,60
1683696463819,CSE 190,A00,201433,Staff,32,0,49,17
1683696464847,DOC 1,A01,259136,Strom; Megan C.,7,0,15,8
1683696464847,DOC 1,A02,259137,Strom; Megan C.,14,0,15,1
1683696464847,DOC 1,A03,259138,Strom; Megan C.,14,0,15,1
1683696464847,DOC 1,A04,259139,Strom; Megan C.,14,0,15,1
1683696465875,DOC 100D,A00,259140,Pass; Natalye Joann,14,0,25,11
1683696466900,DSGN 1,A01,184749,Rill; Bryan,0,26,30,30
1683696467925,DSGN 100,A01,185168,Staff,0,2,25,25
1683696468952,ECE 5,A01,185626,Morris; Karcher William,0,12,0,0
1683696469979,ECE 101,A01,185628,Staff,14,0,70,56
1683696471004,ECE 107,A01,185635,Baghdadchi; Saharnaz,0,0,20,20
1683696471004,ECE 107,A02,185638,Baghdadchi; Saharnaz,1,0,20,19
1683696472029,ECE 148,A01,185647,Silberman; Jack,0,0,16,16
1683696473053,ECON 1,A01,185537,Crane; Meredith Helen,54,0,70,16
1683696474078,ECON 3,A01,185549,Crane; Meredith Helen,30,0,70,40
1683696475105,ECON 4,A01,203354,Anderson; John Charles,0,5,10,10
1683696476132,ECON 100A,A01,185574,Staff,0,5,40,40
1683696477158,ECON 100B,A01,185576,Staff,0,12,50,50
1683696478185,ECON 100C,A01,185589,Newhouse; Herbert S,30,0,70,40
1683696479207,ECON 105,A00,185608,Vespa; Emanuel Ignacio,19,0,35,16
1683696480235,ECON 109,A01,185610,Shishkin; Denis,9,0,35,26
1683696481262,ECON 110A,A01,185612,Staff,8,0,40,32
1683696482290,ECON 120A,A01,185615,Staff,19,0,40,21
1683696483313,ECON 120C,A01,185617,Sun; Yixiao,0,21,70,70
1683696484341,ECON 144,A00,203346,Squires; Dale E,2,0,35,33
1683696485369,ECON 171,A01,203349,Newhouse; Herbert S,0,1,35,35
1683696486396,ECON 173A,A01,185621,Toda; Alexis Akira,21,0,35,14
1683696487420,EDS 25,A01,202413,Staff,0,1,0,0
1683696487420,EDS 25,A02,202414,Staff,0,1,0,0
1683696487420,EDS 25,A03,202415,Staff,0,0,0,0
1683696487420,EDS 25,A04,202416,Staff,0,1,0,0
1683696487420,EDS 25,A05,202439,Staff,0,0,0,0
1683696487420,EDS 25,A06,202440,Staff,0,0,0,0
1683696487420,EDS 25,B01,202631,Staff,0,0,0,0
1683696487420,EDS 25,B02,202632,Staff,0,0,0,0
1683696487420,EDS 25,B03,202639,Staff,0,0,0,0
1683696487420,EDS 25,B04,202640,Staff,0,0,0,0
1683696487420,EDS 25,B05,202643,Staff,0,0,0,0
1683696487420,EDS 25,B06,202644,Staff,0,0,0,0
1683696488443,EDS 38,A01,202659,Black; Alison Michelle,24,0,25,1
1683696489467,EDS 115,A00,202652,Staff,18,0,30,12
1683696490493,EDS 125,A00,202649,Staff,13,0,30,17
1683696491520,EDS 126,A01,203332,Staff,30,0,30,0
1683696492545,EDS 139,A00,202838,Staff,16,0,25,9
1683696493573,EDS 146,A01,202655,Staff,14,0,25,11
1683696494597,ENG 15,A00,185667,Staff,0,1,0,0
1683696494597,ENG 15,B00,185672,Staff,0,0,0,0
1683696494597,ENG 15,C00,185675,Staff,0,0,0,0
1683696494597,ENG 15,D00,185682,Staff,0,0,0,0
1683696494597,ENG 15,E00,185684,Staff,0,0,0,0
1683696495625,ETHN 103,A00,185710,Staff,0,8,35,35
1683696496651,ETHN 103A,A00,199228,Man; Simeon S,0,0,9,9
1683696497675,ETHN 109,A00,185711,Staff,15,0,35,20
1683696498699,ETHN 142,A00,185726,Staff,0,4,30,30
1683696499727,ETHN 163J,A00,199229,Man; Simeon S,5,0,8,3
1683696500752,ETHN 168,A00,185727,Staff,7,0,10,3
1683696501775,ETHN 182,A00,185728,Staff,0,0,35,35
1683696502803,ETHN 183,A00,185737,Staff,9,0,18,9
1683696503827,GLBH 111,A01,209361,Burgos; Jose L.,0,0,0,0
1683696505882,HIEU 104,A00,185792,Staff,14,0,20,6
1683696506906,HIEU 115,A00,185800,Staff,0,0,20,20
1683696507931,HIEU 128,A00,185801,Staff,0,9,20,20
1683696508958,HIEU 147,A00,185802,Staff,15,0,20,5
1683696509981,HIEU 154,A00,185823,Staff,11,0,20,9
1683696511007,HILA 102,A00,185826,Staff,14,0,20,6
1683696512032,HILD 2C,A01,185778,Staff,0,13,20,20
1683696513060,HILD 7B,A01,185780,Kwak; Nancy,0,17,32,32
1683696513060,HILD 7B,A02,185781,Kwak; Nancy,0,18,32,32
1683696514085,HILD 30,A01,185791,Staff,12,0,20,8
1683696515109,HISC 119,A00,185830,Golan; Tal,0,10,20,20
1683696516135,HITO 156GS,A00,185831,Patterson; Patrick H.,0,0,0,23
1683696517157,HIUS 103,A00,185832,Man; Simeon S,0,4,20,20
1683696518181,HIUS 117,A00,185836,Kwak; Nancy,2,0,20,18
1683696519209,HIUS 125,A00,185840,Man; Simeon S,0,2,23,23
1683696520233,HIUS 149,A00,185845,Staff,1,0,20,19
1683696521260,HUM 3,A01,185882,Zavodny; Tatiana Sophia,0,8,50,50
1683696521260,HUM 3,B01,185899,Caldwell; Michael Alan,0,18,50,50
1683696522283,HUM 3GS,A00,185900,Patterson; Patrick H.,0,0,0,23
1683696523309,HUM 4,A01,185938,Zroka; Amy Liane,28,0,50,22
1683696523309,HUM 4,B01,185956,Watkins; Eric,0,6,50,50
1683696523309,HUM 4,B02,202209,Watkins; Eric,0,5,50,50
1683696523309,HUM 4,B03,202210,Watkins; Eric,0,5,50,50
1683696524334,HUM 5,A01,185958,West; Geoffrey Scott,0,0,50,50
1683696524334,HUM 5,A02,202215,West; Geoffrey Scott,0,1,50,50
1683696525356,INTL 190,A00,185959,Gagnon; Jeffrey C,0,0,0,9
1683696525356,INTL 190,B00,185960,Lettieri; Michael Joseph,0,0,0,2
1683696526378,JAPN 180,A00,254509,Staff,5,0,30,25
1683696527457,LATI 10,A01,202853,Kennemore; Amy Michelle,4,0,35,31
1683696527457,LATI 10,A02,202854,Kennemore; Amy Michelle,3,0,35,32
1683696527457,LATI 10,A03,270054,Kennemore; Amy Michelle,30,0,30,0
1683696528483,LATI 180,A00,202855,Kennemore; Amy Michelle,11,0,20,9
1683696529509,LAWS 101,A00,201767,Golan; Tal,0,7,40,40
1683696530533,LIFR 1C,A00,185961,Staff,6,0,20,14
1683696531557,LIFR 1CX,A00,185962,Staff,7,0,20,13
1683696532584,LIFR 1D,A00,185963,Staff,7,0,20,13
1683696533608,LIFR 1DX,A00,185964,Staff,7,0,20,13
1683696534633,LIGN 101,A01,186039,Staff,43,0,50,7
1683696535656,LIGN 165,A00,186040,Staff,15,0,50,35
1683696536683,LTCS 108,A00,186041,Staff,5,0,10,5
1683696537707,LTCS 119,A00,186042,Staff,15,0,20,5
1683696538733,LTCS 130,A00,186043,Wesling; Megan E.,15,0,25,10
1683696540786,LTEA 138,A00,186119,Staff,14,0,40,26
1683696541810,LTEN 124,A00,186148,Staff,5,0,25,20
1683696542834,LTEN 178,A00,186149,Staff,6,0,15,9
1683696543860,LTEN 181,A00,186150,Blanco; John D,34,0,40,6
1683696544888,LTWL 120,A00,186160,Staff,19,0,25,6
1683696545914,LTWL 165,A00,186161,Staff,22,0,25,3
1683696546937,LTWR 100,A00,186162,Staff,0,5,15,15
1683696547967,LTWR 102,A00,186163,Doller; Ben,5,0,15,10
1683696548997,MAE 8,A01,186412,Staff,0,1,0,0
1683696550020,MAE 30B,A00,186445,Bahadori; Mohammad Yousef,81,0,100,19
1683696551044,MAE 40,A00,186592,Bewley; Thomas R,10,0,50,40
1683696552070,MAE 101B,A00,186593,Bahadori; Mohammad Yousef,80,0,100,20
1683696553094,MAE 105,A00,186594,Bandaru; Prabhakar,10,0,50,40
1683696554120,MAE 107,A00,186599,Pham; Hieu Tan,0,8,120,120
1683696555147,MAE 148,A01,186660,Silberman; Jack,3,0,16,13
1683696556171,MATH 10A,A01,188095,Staff,0,6,35,35
1683696557196,MATH 10B,A01,188097,Bowers; Adam R.,0,12,30,30
1683696557196,MATH 10B,A02,188099,Bowers; Adam R.,0,11,30,30
1683696557196,MATH 10B,B01,188104,Bowers; Adam R.,0,10,30,30
1683696557196,MATH 10B,B02,188106,Bowers; Adam R.,0,9,30,30
1683696558221,MATH 10C,A01,188111,Staff,0,20,30,30
1683696558221,MATH 10C,A02,188127,Staff,0,19,30,30
1683696558221,MATH 10C,A03,188131,Staff,0,19,30,30
1683696558221,MATH 10C,B01,188218,Staff,17,0,30,13
1683696558221,MATH 10C,B02,188244,Staff,13,0,30,17
1683696558221,MATH 10C,B03,188277,Staff,14,0,30,16
1683696559245,MATH 18,A01,188344,Bach; Quang Tran,18,0,30,12
1683696559245,MATH 18,A02,188345,Bach; Quang Tran,11,0,30,19
1683696559245,MATH 18,B01,188353,Bach; Quang Tran,11,0,30,19
1683696559245,MATH 18,B02,188354,Bach; Quang Tran,19,0,30,11
1683696560270,MATH 20A,A01,188374,Staff,11,0,35,24
1683696561298,MATH 20B,A01,188382,Ohm; Ko Woon,7,0,30,23
1683696561298,MATH 20B,A02,188383,Ohm; Ko Woon,22,0,30,8
1683696561298,MATH 20B,B01,188385,Ohm; Ko Woon,7,0,30,23
1683696561298,MATH 20B,B02,188392,Ohm; Ko Woon,22,0,30,8
1683696562323,MATH 20C,A01,188394,Harel; Guershon,10,0,30,20
1683696562323,MATH 20C,A02,188395,Harel; Guershon,13,0,30,17
1683696562323,MATH 20C,B01,188404,Harel; Guershon,5,0,30,25
1683696562323,MATH 20C,B02,188405,Harel; Guershon,18,0,30,12
1683696563357,MATH 20D,A01,188414,Hammock; Frances H,0,1,30,30
1683696563357,MATH 20D,A02,188415,Hammock; Frances H,0,1,30,30
1683696563357,MATH 20D,B01,188447,Hammock; Frances H,0,1,30,30
1683696563357,MATH 20D,B02,188486,Hammock; Frances H,2,0,30,28
1683696564382,MATH 20E,A01,188649,Staff,21,0,30,9
1683696564382,MATH 20E,A02,188650,Staff,20,0,30,10
1683696564382,MATH 20E,A03,188673,Staff,0,0,30,30
1683696565408,MATH 102,A01,188675,Staff,0,40,35,35
1683696566436,MATH 103B,A01,188681,Staff,3,0,35,32
1683696566436,MATH 103B,B01,188692,Staff,5,0,35,30
1683696567465,MATH 109,A01,188695,Salehi Golsefidy; Alireza,24,0,35,11
1683696567465,MATH 109,A02,188696,Salehi Golsefidy; Alireza,25,0,35,10
1683696568492,MATH 120A,A01,188698,Eggers; John Dietrich,7,0,35,28
1683696569515,MATH 142B,A01,188736,Ioana; Adrian,0,0,30,30
1683696569515,MATH 142B,A02,188741,Ioana; Adrian,0,1,30,30
1683696569515,MATH 142B,A03,188743,Ioana; Adrian,0,2,30,30
1683696570542,MATH 168A,A01,188790,Staff,0,11,35,35
1683696571567,MATH 170A,A01,188803,Nie; Jiawang,0,2,35,35
1683696571567,MATH 170A,A02,188811,Nie; Jiawang,0,1,35,35
1683696571567,MATH 170A,A03,188814,Nie; Jiawang,0,0,35,35
1683696571567,MATH 170A,A04,188815,Nie; Jiawang,5,0,35,30
1683696572591,MATH 193B,A01,188817,Staff,0,0,35,35
1683696572591,MATH 193B,A02,188818,Staff,6,0,35,29
1683696573619,MGT 4,A01,202857,Anderson; John Charles,59,0,80,21
1683696574643,MGT 12,A00,202858,Lindenberger; Wade Douglas,40,0,90,50
1683696575667,MGT 18,A00,202859,Staff,74,0,90,16
1683696576694,MGT 18GS,A00,202860,McKay; Michael J,13,0,28,15
1683696577724,MGT 45,A00,202861,Pecore; Joseph P.,8,0,90,82
1683696578751,MGT 100,A00,202863,Yavorsky; Daniel Ryan,27,0,90,63
1683696579775,MGT 103,A00,202864,Ehrich; Kristine R,0,19,90,90
1683696580799,MGT 112,A00,202865,Ehrich; Kristine R,15,0,90,75
1683696581824,MGT 121A,A00,202868,Staff,70,0,90,20
1683696582850,MGT 131B,A00,202869,Anderson; John Charles,58,0,90,32
1683696583874,MGT 136,A00,202871,Lindenberger; Wade Douglas,83,0,90,7
1683696584901,MGT 164,A00,202873,Staff,0,67,90,91
1683696585929,MGT 164GS,A00,202874,McKay; Mary A,13,0,28,15
1683696586953,MGT 180,A00,202875,Staff,0,51,90,91
1683696587977,MMW 11R,A01,205019,Herbst; Matthew,0,0,30,30
1683696587977,MMW 11R,A02,205026,Herbst; Matthew,29,0,30,1
1683696589006,MMW 15,A01,193512,Chang; Edmond Yi-Teh,0,8,28,28
1683696589006,MMW 15,A02,193513,Chang; Edmond Yi-Teh,0,5,28,28
1683696589006,MMW 15,A03,193514,Chang; Edmond Yi-Teh,0,5,28,28
1683696589006,MMW 15,A04,193515,Chang; Edmond Yi-Teh,0,5,28,28
1683696589006,MMW 15,A05,193516,Chang; Edmond Yi-Teh,0,5,28,28
1683696589006,MMW 15,A06,193517,Chang; Edmond Yi-Teh,0,6,28,28
1683696589006,MMW 15,B01,193519,Chang; Edmond Yi-Teh,0,5,28,28
1683696589006,MMW 15,B02,193520,Chang; Edmond Yi-Teh,0,5,28,28
1683696589006,MMW 15,B03,193521,Chang; Edmond Yi-Teh,0,5,28,28
1683696589006,MMW 15,B04,193522,Chang; Edmond Yi-Teh,0,6,28,28
1683696589006,MMW 15,B05,193523,Chang; Edmond Yi-Teh,0,5,28,28
1683696589006,MMW 15,B06,193524,Chang; Edmond Yi-Teh,0,5,28,28
1683696590030,MMW 122,A01,193526,Rahimi; Babak,0,16,28,28
1683696590030,MMW 122,A02,193527,Rahimi; Babak,0,15,28,28
1683696590030,MMW 122,A03,193528,Rahimi; Babak,0,0,0,0
1683696590030,MMW 122,A04,193529,Rahimi; Babak,0,0,0,0
1683696591058,MUS 1A,A01,186663,Staff,0,18,35,35
1683696592080,MUS 4,A01,186715,Staff,0,12,35,35
1683696593107,MUS 5R,A01,186796,Dubnov; Shlomo,0,17,35,35
1683696594131,MUS 6,A01,186798,Staff,0,4,25,25
1683696595158,MUS 7,A01,186830,Staff,11,0,35,24
1683696596181,MUS 8,A01,186930,Staff,0,27,35,35
1683696597206,MUS 15,A01,186932,Staff,0,15,35,35
1683696597206,MUS 15,B01,186934,Staff,0,16,35,35
1683696598232,MUS 80,A00,186935,Staff,0,0,20,20
1683696598232,MUS 80,B00,186936,Staff,24,0,25,1
1683696599257,NANO 11,A00,204702,Lipomi; Darren John,0,0,0,0
1683696600281,NANO 15,A01,204709,Yang; Kesong,0,1,0,0
1683696601308,NANO 114,A00,202069,Jahed Motlagh; Zeinab,2,0,10,8
1683696602336,PHIL 1,A00,186955,Grush; Rick Scott,31,0,40,9
1683696603361,PHIL 10,A01,186973,Grush; Rick Scott,27,0,35,8
1683696603361,PHIL 10,A02,186974,Grush; Rick Scott,33,0,35,2
1683696604385,PHIL 13,A01,186976,Staff,1,0,35,34
1683696604385,PHIL 13,A02,186977,Staff,16,0,35,19
1683696605407,PHIL 14,A01,186979,Staff,31,0,35,4
1683696605407,PHIL 14,A02,186986,Staff,32,0,35,3
1683696606434,PHIL 28,A01,186988,Staff,16,0,30,14
1683696606434,PHIL 28,A02,186989,Staff,1,0,30,29
1683696606434,PHIL 28,A03,186990,Staff,10,0,30,20
1683696606434,PHIL 28,A04,186991,Staff,26,0,30,4
1683696607461,PHIL 120,A00,186997,Staff,23,0,40,17
1683696608487,PHIL 137,A00,187003,Staff,7,0,40,33
1683696609514,PHIL 150,A00,187015,Staff,47,0,70,23
1683696610537,PHIL 167,A00,187021,Lamey; Andy M.,34,0,40,6
1683696611564,PHIL 174,A01,202226,Staff,17,0,20,3
1683696611564,PHIL 174,A02,202235,Staff,20,0,20,0
1683696612590,PHIL 191A,A00,258918,Staff,0,0,1,1
1683696613614,PHYS 1A,A00,187028,Staff,26,0,60,34
1683696614641,PHYS 1AL,001,187036,Staff,3,0,30,27
1683696614641,PHYS 1AL,002,187049,Staff,18,0,30,12
1683696615667,PHYS 1B,A00,187058,Staff,22,0,60,38
1683696616694,PHYS 1BL,001,187064,Staff,0,1,30,30
1683696616694,PHYS 1BL,002,187070,Staff,4,0,30,26
1683696617718,PHYS 1C,A00,187082,Staff,29,0,120,91
1683696618745,PHYS 1CL,001,187088,Staff,0,9,30,30
1683696618745,PHYS 1CL,002,187089,Staff,0,1,30,30
1683696618745,PHYS 1CL,009,262693,Staff,9,0,30,21
1683696619774,PHYS 2B,A01,187097,Staff,55,0,115,60
1683696620796,PHYS 2C,A01,187099,Staff,63,0,115,52
1683696621824,PHYS 2CL,A01,187101,Staff,5,0,28,23
1683696621824,PHYS 2CL,A02,187102,Staff,15,0,28,13
1683696622851,PHYS 2D,A01,187123,Shotwell; Brian,95,0,115,20
1683696623878,PHYS 4B,A01,187133,Grinstein; Benjamin,35,0,50,15
1683696624905,POLI 10,A00,188819,Staff,0,4,50,50
1683696625932,POLI 11,A00,188827,Staff,43,0,50,7
1683696626959,POLI 13R,A00,188828,Staff,0,1,20,20
1683696627982,POLI 27,A01,188830,Elgin; Samuel Zincke,0,2,70,70
1683696629006,POLI 30,A00,188832,Desposato; Scott,30,0,50,20
1683696630030,POLI 102F,A00,188834,Staff,1,0,40,39
1683696631111,POLI 104A,A00,188852,Staff,12,0,30,18
1683696632135,POLI 104I,A00,188853,Staff,0,8,20,20
1683696633160,POLI 110B,A00,188854,Wiens; David,6,0,20,14
1683696634186,POLI 112A,A00,188855,Wiens; David,3,0,30,27
1683696635213,POLI 117R,A00,188856,Forman; Fonna,0,12,20,20
1683696636238,POLI 118,A00,188857,Ingham; Sean,8,0,20,12
1683696637265,POLI 120G,A00,188858,Staff,8,0,30,22
1683696638316,POLI 131CR,A00,188863,Hoston; Germaine,20,0,50,30
1683696639343,POLI 133,A00,188864,Nellis; Gareth Hb,44,0,50,6
1683696640369,POLI 134D,A00,188865,Desposato; Scott,27,0,30,3
1683696641396,POLI 142A,A00,188871,Gartzke; Erik,21,0,50,29
1683696642419,POLI 142K,A00,188874,Staff,38,0,50,12
1683696643444,POLI 143,A00,188940,Gartzke; Erik,16,0,30,14
1683696644471,POLI 153,A00,188943,Staff,2,0,20,18
1683696645495,POLI 160AA,A00,188944,Staff,10,0,40,30
1683696646523,POLI 170A,A00,188945,Staff,10,0,30,20
1683696648577,PSYC 1,A00,188952,Staff,36,0,90,54
1683696649602,PSYC 2,B00,188953,Staff,19,0,35,16
1683696650628,PSYC 6,A00,188970,Staff,47,0,60,13
1683696651655,PSYC 7,A00,188973,Staff,35,0,45,10
1683696652679,PSYC 60,A01,188980,Rickard; Timothy C.,42,0,60,18
1683696653705,PSYC 70,A01,189001,Steiner; Eric Tomas,21,0,45,24
1683696654730,PSYC 100,A00,189005,Lacefield; Katharine I,0,99,120,120
1683696655756,PSYC 102,A00,189008,Staff,7,0,30,23
1683696656784,PSYC 106,B00,189026,Gorman; Michael R.,27,0,60,33
1683696657809,PSYC 114,B01,189033,Winkielman; Piotr,0,31,30,30
1683696658833,PSYC 131,A00,189036,Anagnostaras; Stephan,0,44,60,60
1683696659861,PSYC 136,A00,189041,Lowe; Angela Beth,0,7,25,25
1683696660886,PSYC 137,A00,189057,Winkielman; Piotr,0,36,25,25
1683696661911,PSYC 144,A00,189107,Wixted; John T,0,11,50,50
1683696663969,PSYC 162,A00,189142,Staff,0,9,85,85
1683696664997,PSYC 172,A00,189144,Gorman; Michael R.,0,6,30,30
1683696667053,PSYC 179,A00,189146,Lacefield; Katharine I,0,88,120,120
1683696668081,PSYC 181,A00,189147,Anagnostaras; Stephan,0,45,90,90
1683696669109,PSYC 190R,A00,189148,Barner; David A.,0,23,80,80
1683696670134,PSYC 191,A00,189275,Rickard; Timothy C.,0,11,25,25
1683696671158,PSYC 193,A00,189276,Chapman; Eddie Nathaniel,0,1,0,4
1683696672182,PSYC 193L,A01,189281,Lowe; Angela Beth,8,0,20,12
1683696672182,PSYC 193L,B01,189285,Staff,28,0,35,7
1683696673208,RELI 149,A00,187137,Rahimi; Babak,6,0,40,34
1683696674236,SE 9,A01,187315,Staff,0,2,18,18
1683696675263,SE 101B,A00,187409,Staff,24,0,30,6
1683696676298,SE 110B,A00,187444,Staff,10,0,40,30
1683696677323,SE 130B,A00,187449,Staff,31,0,40,9
1683696678345,SE 150A,A00,187516,Staff,8,0,20,12
1683696679369,SE 154,A00,187528,Staff,29,0,50,21
1683696680398,SIO 3,A01,258171,Staff,35,0,40,5
1683696681423,SIO 10,A00,187144,Cook; Geoffrey W,0,6,75,75
1683696682447,SIO 45,A00,187152,Cook; Geoffrey W,0,7,100,100
1683696683475,SIO 109R,A00,194486,Staff,0,4,20,20
1683696685528,SIO 187,A01,187233,Kacev; David,12,0,40,28
1683696686559,SOCI 1,A01,258656,Thorpe; Charles Robert,28,0,30,2
1683696686559,SOCI 1,A02,258658,Thorpe; Charles Robert,30,0,30,0
1683696686559,SOCI 1,A03,258661,Thorpe; Charles Robert,25,0,25,0
1683696686559,SOCI 1,A04,258666,Thorpe; Charles Robert,22,0,25,3
1683696686559,SOCI 1,A05,258897,Thorpe; Charles Robert,22,0,25,3
1683696686559,SOCI 1,A06,258898,Thorpe; Charles Robert,25,0,25,0
1683696687584,SOCI 30,A01,258903,Pardo Guerra; Juan Pablo,14,0,30,16
1683696688608,SOCI 102,A00,258904,Staff,9,0,25,16
1683696689632,SOCI 106,A00,258905,Staff,19,0,25,6
1683696690657,SOCI 111,A00,258907,Ribas Norris; Janet Vanesa,26,0,30,4
1683696691682,SOCI 121R,A00,258908,Pardo Guerra; Juan Pablo,7,0,30,23
1683696692710,SOCI 126,A01,203330,Staff,14,0,20,6
1683696693734,SOCI 131,A00,258909,Thorpe; Charles Robert,30,0,60,30
1683696694758,SOCI 135,A00,258910,Payne; Christine Anna,0,13,30,30
1683696695787,SOCI 157,A00,258911,Staff,10,0,30,20
1683696696811,SOCI 184,A00,258912,Staff,25,0,30,5
1683696697835,SOCI 188D,A00,258913,Staff,22,0,30,8
1683696698858,SYN 2,001,187529,Staff,9,0,16,7
1683696698858,SYN 2,002,201452,Staff,0,20,16,16
1683696698858,SYN 2,003,201469,Staff,1,0,16,15
1683696699883,SYN 100,A01,187531,Staff,0,9,20,20
1683696699883,SYN 100,B01,201491,Staff,0,10,20,20
1683696700908,TDAC 1,A00,189286,Walsh; Kim C.,3,0,20,17
1683696700908,TDAC 1,B00,189287,Harting; Carla Kelso,10,0,20,10
1683696701937,TDAC 101,A00,189300,Walsh; Kim C.,16,0,20,4
1683696701937,TDAC 101,B00,189301,Harting; Carla Kelso,18,0,20,2
1683696702961,TDAC 102,A00,189304,Basso; Beatrice,14,0,20,6
1683696703985,TDAC 108,A00,189305,Staff,18,0,20,2
1683696705011,TDDE 131,A00,189310,Staff,19,0,20,1
1683696705011,TDDE 131,B00,189314,Staff,19,0,20,1
1683696705011,TDDE 131,C00,189315,Staff,48,0,50,2
1683696705011,TDDE 131,D00,189316,Staff,14,0,15,1
1683696705011,TDDE 131,E00,204841,Staff,20,0,20,0
1683696706039,TDGE 10,A00,189289,Staff,27,0,50,23
1683696706039,TDGE 10,B00,189290,Havis; Allan,0,1,50,50
1683696707067,TDGE 11,A00,189291,Fulton; Julia,0,4,50,50
1683696707067,TDGE 11,B00,189292,Staff,20,0,25,5
1683696707067,TDGE 11,C00,260270,Staff,0,0,0,0
1683696708094,TDGE 25,A00,189294,Staff,1,0,20,19
1683696709119,TDGE 124,A00,189318,Fulton; Julia,0,7,50,50
1683696710145,TDGE 125,A00,189319,Staff,13,0,25,12
1683696710145,TDGE 125,B00,189320,Staff,23,0,25,2
1683696711170,TDGE 127,A00,189322,Havis; Allan,0,0,50,50
1683696712195,TDHT 101,A00,189323,Staff,18,0,25,7
1683696712195,TDHT 101,B00,189324,Staff,25,0,25,0
1683696713220,TDHT 102,A00,189325,Staff,49,0,50,1
1683696714243,TDMV 1,A00,189295,Arcidiacono; Kristin,20,0,30,10
1683696714243,TDMV 1,B00,189296,Caligagan; Maria T.,24,0,30,6
1683696715268,TDMV 2,A00,189297,Sammartano; Tonnie,27,0,30,3
1683696715268,TDMV 2,B00,189299,Arcidiacono; Kristin,23,0,30,7
1683696716295,TDMV 3,A00,204998,Rincon; Alicia,22,0,30,8
1683696717322,TDMV 120,A00,189458,Sammartano; Tonnie,28,0,30,2
1683696718347,TDMV 138,A00,189541,Jun; Grace Shin Hae,20,0,40,20
1683696719371,TDMV 142,A00,189717,Caligagan; Tony,25,0,30,5
1683696719371,TDMV 142,B00,189718,Caligagan; Maria T.,25,0,30,5
1683696720397,TMC 2,A01,187533,Staff,25,0,25,0
1683696720397,TMC 2,A02,187534,Staff,25,0,25,0
1683696721425,USP 1,A01,187536,Kwak; Nancy,0,16,25,25
1683696722453,USP 5,A01,187538,Staff,8,0,25,17
1683696723480,USP 101,A00,199253,Staff,0,4,0,0
1683696724505,USP 124,A00,187562,Boomhower; Matthew Charles,0,0,30,30
1683696725528,USP 138,A00,187582,Staff,19,0,25,6
1683696726555,USP 152,A01,187597,Staff,3,0,25,22
1683696727578,USP 153,A00,187598,Staff,18,0,25,7
1683696728606,USP 168,A00,187607,Kwak; Nancy,2,0,5,3
1683696729631,USP 173,A00,187619,Staff,4,0,25,21
1683696730657,USP 181,A00,187638,Staff,0,4,25,25
1683696731681,VIS 103,A00,187650,Cruz; Edwin Teddy,17,0,75,58
1683696732705,VIS 110D,A00,187669,Staff,13,0,22,9
1683696733730,VIS 127C,A00,187720,Shen; Kuiyi,67,0,146,79
1683696734813,VIS 149,A00,187731,Yoldas; Pinar,0,12,22,22
1683696735836,VIS 151,A01,188091,Staff,22,0,34,12
1683696735836,VIS 151,A02,188092,Staff,11,0,34,23
1683696736866,VIS 160B,A00,188093,Stalbaum; Brett,0,1,10,10
1683696738915,WCWP 10B,A00,201720,Staff,0,0,5,5
1683696738915,WCWP 10B,B00,201722,Staff,0,0,6,6
1683696739941,WCWP 100,A00,201725,Gagnon; Jeffrey C,0,0,2,2
1683696739941,WCWP 100,B00,201727,Staff,0,4,15,15
1683696743034,ANBI 133,A00,258401,Wilder; Linnea Lorene,34,0,40,6
1683696744059,ANBI 140,A00,258395,Hrvoj Mihic; Branka,18,0,25,7
1683696745085,ANSC 120,A00,258402,Bialecki; Jon Anthony,26,0,40,14
1683696746110,ANSC 144,A00,258400,Staff,12,0,40,28
1683696748162,ANSC 166,A00,258396,Parish; Steven Martin,156,0,175,19
1683696749187,ANSC 180,A00,193533,Staff,8,0,20,12
1683696750213,ANSC 188,A00,258397,Jassal; Aftab,34,0,40,6
1683696751238,ANTH 3,A01,258316,Staff,23,0,30,7
1683696752266,ANTH 5,A00,258394,Semendeferi; Ekaterini,16,0,20,4
1683696753293,ANTH 21,A01,258331,Staff,4,0,40,36
1683696754318,ANTH 103,A00,258398,Varma; Saiba,15,0,25,10
1683696755350,AWP 10,001,202034,Staff,0,0,0,0
1683696755350,AWP 10,002,202035,Staff,0,0,0,0
1683696755350,AWP 10,003,202036,Staff,0,0,0,0
1683696755350,AWP 10,004,202037,Staff,0,0,0,0
1683696755350,AWP 10,005,202038,Staff,0,0,0,0
1683696755350,AWP 10,006,202039,Staff,0,0,0,0
1683696755350,AWP 10,007,202040,Staff,0,0,0,0
1683696755350,AWP 10,008,202041,Staff,0,0,0,0
1683696755350,AWP 10,009,202042,Staff,0,0,0,0
1683696755350,AWP 10,010,202043,Staff,0,0,0,0
1683696755350,AWP 10,011,202044,Staff,0,0,0,0
1683696755350,AWP 10,012,202045,Staff,0,0,0,0
1683696755350,AWP 10,013,202046,Staff,0,0,0,0
1683696755350,AWP 10,014,202047,Staff,0,0,0,0
1683696755350,AWP 10,015,202048,Staff,0,0,0,0
1683696755350,AWP 10,016,202049,Staff,0,0,0,0
1683696755350,AWP 10,017,202050,Staff,0,0,0,0
1683696755350,AWP 10,018,202051,Staff,0,0,0,0
1683696755350,AWP 10,019,202052,Staff,0,0,0,0
1683696755350,AWP 10,020,202053,Staff,0,0,0,0
1683696755350,AWP 10,021,202054,Staff,0,0,0,0
1683696755350,AWP 10,022,202055,Staff,0,0,0,0
1683696755350,AWP 10,023,202056,Staff,0,0,0,0
1683696755350,AWP 10,024,202057,Staff,0,0,0,0
1683696755350,AWP 10,025,202058,Staff,0,0,0,0
1683696755350,AWP 10,026,202059,Staff,0,0,0,0
1683696756376,AWP 102,001,202032,Staff,0,0,0,0
1683696756376,AWP 102,002,202033,Staff,0,0,0,0
1683696757410,BENG 100,A01,254234,Taylor Amos; Alyssa C,31,0,40,9
1683696758436,BENG 196,001,270013,Engler; Adam J.,9999,0,9999,0
1683696759464,BICD 100R,A01,202018,Smith; Laurie,0,7,32,32
1683696759464,BICD 100R,A02,202019,Smith; Laurie,0,3,32,32
1683696759464,BICD 100R,A03,202020,Smith; Laurie,0,1,32,32
1683696759464,BICD 100R,A04,202021,Smith; Laurie,6,0,32,26
1683696759464,BICD 100R,A05,202022,Smith; Laurie,10,0,32,22
1683696760494,BICD 136,A01,193242,Gustafson-Brown; Cindy,0,2,32,32
1683696760494,BICD 136,A02,193244,Gustafson-Brown; Cindy,13,0,32,19
1683696761521,BIEB 102,A01,193249,Butler; Shannon Rhey,0,0,32,32
1683696761521,BIEB 102,A02,193251,Butler; Shannon Rhey,0,0,32,32
1683696761521,BIEB 102,A03,193253,Butler; Shannon Rhey,0,0,32,32
1683696761521,BIEB 102,A04,193255,Butler; Shannon Rhey,13,0,32,19
1683696761521,BIEB 102,A05,193265,Butler; Shannon Rhey,25,0,32,7
1683696761521,BIEB 102,A06,193269,Butler; Shannon Rhey,12,0,32,20
1683696763571,BIEB 150,A01,193274,Staff,0,0,32,32
1683696763571,BIEB 150,A02,193285,Staff,24,0,32,8
1683696764597,BIEB 194,A00,193286,Kurle; Carolyn M.,19,0,32,13
1683696765623,BILD 1,A01,192291,Staff,15,0,32,17
1683696765623,BILD 1,A02,192292,Staff,30,0,32,2
1683696765623,BILD 1,B01,192520,Reuther; Keefe,0,1,0,0
1683696765623,BILD 1,B02,192532,Reuther; Keefe,0,1,0,0
1683696766651,BILD 3,A01,192556,Butler; Shannon Rhey,0,0,32,32
1683696766651,BILD 3,A02,192581,Butler; Shannon Rhey,0,1,32,32
1683696766651,BILD 3,A03,192611,Butler; Shannon Rhey,19,0,32,13
1683696766651,BILD 3,A04,192612,Butler; Shannon Rhey,23,0,32,9
1683696766651,BILD 3,A05,192613,Butler; Shannon Rhey,26,0,32,6
1683696766651,BILD 3,A06,192679,Butler; Shannon Rhey,27,0,32,5
1683696766651,BILD 3,A07,192682,Butler; Shannon Rhey,20,0,32,12
1683696767678,BILD 4,A01,192836,Reuther; Keefe,1,0,24,23
1683696767678,BILD 4,A02,193044,Reuther; Keefe,4,0,24,20
1683696768703,BILD 10,A01,193142,Gustafson-Brown; Cindy,29,0,32,3
1683696768703,BILD 10,A02,193149,Gustafson-Brown; Cindy,31,0,32,1
1683696769729,BIMM 100,A01,193301,Staff,0,6,32,32
1683696769729,BIMM 100,A02,193312,Staff,0,7,32,32
1683696769729,BIMM 100,A03,193323,Staff,0,10,32,32
1683696770754,BIMM 101,A01,193329,McDonnell; Lisa Marie,0,3,24,24
1683696770754,BIMM 101,A02,193339,McDonnell; Lisa Marie,0,3,24,24
1683696770754,BIMM 101,B01,193354,McDonnell; Lisa Marie,0,4,24,24
1683696770754,BIMM 101,B02,193357,McDonnell; Lisa Marie,0,3,24,24
1683696771784,BIMM 110,A01,193377,Tat; John,0,11,32,32
1683696771784,BIMM 110,A02,193378,Tat; John,0,11,32,32
1683696772813,BIMM 120,A01,206116,Staff,0,0,32,32
1683696772813,BIMM 120,A02,206117,Staff,7,0,32,25
1683696772813,BIMM 120,A03,206121,Staff,21,0,32,11
1683696773839,BIPN 100,A01,193393,Park; Ji Young,0,15,32,32
1683696773839,BIPN 100,A02,193402,Park; Ji Young,0,14,32,32
1683696773839,BIPN 100,A03,193413,Park; Ji Young,0,14,32,32
1683696773839,BIPN 100,A04,193414,Park; Ji Young,0,13,32,32
1683696774863,BIPN 102,A01,193429,Staff,0,0,32,32
1683696774863,BIPN 102,A02,193438,Staff,18,0,32,14
1683696775892,BIPN 106,A01,193450,Reyes Gonzalez; Catalina,0,2,40,40
1683696776918,BIPN 134,A01,193465,Cooke; James Edward,0,0,32,32
1683696776918,BIPN 134,A02,193474,Cooke; James Edward,25,0,32,7
1683696776918,BIPN 134,A03,193485,Cooke; James Edward,29,0,32,3
1683696776918,BIPN 134,A04,193486,Cooke; James Edward,20,0,32,12
1683696776918,BIPN 134,A05,193491,Cooke; James Edward,31,0,32,1
1683696776918,BIPN 134,A06,193501,Cooke; James Edward,30,0,32,2
1683696776918,BIPN 134,A07,193510,Cooke; James Edward,29,0,32,3
1683696778969,BISP 194,A00,222522,Staff,14,0,32,18
1683696779996,CAT 124,A01,202407,Staff,19,0,25,6
1683696781020,CAT 125,A00,202408,Marchisotto; Jennifer Anne,2,0,20,18
1683696782043,CAT 125R,A00,202409,Smith; Lauryn Alissa,0,11,20,20
1683696782043,CAT 125R,B00,202410,Morales; Celeste Georgianna,0,11,20,20
1683696782043,CAT 125R,C00,202411,Irwin; Matthew Joseph,0,12,20,20
1683696783067,CENG 15,A01,204712,Yang; Kesong,0,1,0,0
1683696784092,CENG 114,A00,202070,Jahed Motlagh; Zeinab,5,0,20,15
1683696785117,CGS 105,A00,185477,Wesling; Megan E.,24,0,40,16
1683696786141,CGS 106,A00,185494,Staff,11,0,22,11
1683696787164,CGS 108,A00,185495,Staff,14,0,20,6
1683696788189,CGS 114,A00,185496,Staff,13,0,18,5
1683696789213,CGS 119,A00,185501,Staff,15,0,20,5
1683696790235,CGS 120,A00,185511,Staff,12,0,20,8
1683696791261,CHEM 4,A01,184675,Bussey; Thomas J,97,0,100,3
1683696792307,CHEM 6A,A01,184677,Staff,32,0,60,28
1683696793335,CHEM 6B,A01,184679,Staff,63,0,100,37
1683696794368,CHEM 6C,A01,184681,Bussey; Thomas J,0,0,50,50
1683696794368,CHEM 6C,A02,184682,Bussey; Thomas J,32,0,50,18
1683696795396,CHEM 40A,A01,184684,Albizati; Kim F.,33,0,100,67
1683696796420,CHEM 40B,A01,184686,Albizati; Kim F.,0,22,100,100
1683696797448,CHEM 41B,A01,184690,Staff,51,0,100,49
1683696798476,COGS 3,A01,184715,Boyle; Mary E. T.,0,27,40,40
1683696799504,COGS 14B,A01,185172,Staff,0,14,38,38
1683696800528,COGS 18,A01,184736,Staff,14,0,80,66
1683696801555,COGS 100,A01,184932,Staff,0,8,73,73
1683696802582,COGS 101A,A01,184935,Staff,0,40,30,30
1683696803607,COGS 101B,A01,184944,Staff,0,2,30,30
1683696804635,COGS 101C,A01,184946,Staff,0,10,30,30
1683696805663,COGS 102A,A01,184951,Johnson; Christine M.,1,0,40,39
1683696806689,COGS 107B,A01,184953,Mooshagian; Eric Frederick,0,52,40,40
1683696807717,COGS 118B,A01,184959,Gupta; Anjum,0,50,40,40
1683696808740,COGS 153,A00,184961,Staff,1,16,30,29
1683696809763,COGS 177,A00,184962,Staff,0,20,30,30
1683696810788,COGS 187A,A01,184969,Boyle; Mary E. T.,0,19,40,40
1683696811816,COMM 10,A01,185174,Staff,0,5,25,25
1683696811816,COMM 10,A02,185189,Staff,0,2,25,25
1683696811816,COMM 10,A03,269821,Staff,0,1,0,0
1683696812840,COMM 100B,A02,185476,Staff,10,0,25,15
1683696812840,COMM 100B,A03,277340,Staff,25,0,25,0
1683696813869,COMM 100C,A01,185314,Staff,2,0,25,23
1683696813869,COMM 100C,A02,185327,Staff,17,0,25,8
1683696814895,COMM 110M,A00,185349,Staff,0,0,40,40
1683696815917,COMM 113T,A00,185352,Staff,25,0,40,15
1683696816940,COMM 114I,A00,185353,Staff,31,0,40,9
1683696817967,COMM 131,A00,185354,Staff,17,0,30,13
1683696818992,CSE 8A,A50,185358,Cao; Yingjun,0,46,10,10
1683696820016,CSE 8B,A01,185362,Staff,0,48,50,50
1683696821040,CSE 11,A01,185416,Cao; Yingjun,0,91,10,10
1683696822066,CSE 20,A01,185445,Briones; Jor-el Thomas Caparas,3,0,25,22
1683696823094,CSE 21,A01,185447,Staff,9,0,50,41
1683696824123,CSE 101,A01,185451,Staff,0,13,50,50
1683696824123,CSE 101,B01,185453,Jones; Miles E,0,14,50,50
1683696826173,CSE 141,A01,185458,Eldon; John,16,0,100,84
1683696827200,CSE 141L,A01,185461,Eldon; John,8,0,100,92
1683696828229,CSE 142,A01,185463,Staff,34,0,60,26
1683696828229,CSE 142,B01,201355,Staff,0,7,60,60
1683696829256,CSE 142L,A01,185470,Staff,34,0,60,26
1683696829256,CSE 142L,B01,201417,Staff,0,6,60,60
1683696830282,CSE 190,A00,201433,Staff,32,0,49,17
1683696831310,DOC 1,A01,259136,Strom; Megan C.,7,0,15,8
1683696831310,DOC 1,A02,259137,Strom; Megan C.,14,0,15,1
1683696831310,DOC 1,A03,259138,Strom; Megan C.,14,0,15,1
1683696831310,DOC 1,A04,259139,Strom; Megan C.,14,0,15,1
1683696832334,DOC 100D,A00,259140,Pass; Natalye Joann,14,0,25,11
1683696833359,DSGN 1,A01,184749,Rill; Bryan,0,26,30,30
1683696834387,DSGN 100,A01,185168,Staff,0,2,25,25
1683696835413,ECE 5,A01,185626,Morris; Karcher William,0,12,0,0
1683696836437,ECE 101,A01,185628,Staff,14,0,70,56
1683696837471,ECE 107,A01,185635,Baghdadchi; Saharnaz,0,0,20,20
1683696837471,ECE 107,A02,185638,Baghdadchi; Saharnaz,1,0,20,19
1683696838549,ECE 148,A01,185647,Silberman; Jack,0,0,16,16
1683696839576,ECON 1,A01,185537,Crane; Meredith Helen,54,0,70,16
1683696840605,ECON 3,A01,185549,Crane; Meredith Helen,30,0,70,40
1683696841632,ECON 4,A01,203354,Anderson; John Charles,0,5,10,10
1683696842657,ECON 100A,A01,185574,Staff,0,5,40,40
1683696843687,ECON 100B,A01,185576,Staff,0,12,50,50
1683696844715,ECON 100C,A01,185589,Newhouse; Herbert S,30,0,70,40
1683696845738,ECON 105,A00,185608,Vespa; Emanuel Ignacio,19,0,35,16
1683696846765,ECON 109,A01,185610,Shishkin; Denis,9,0,35,26
1683696847791,ECON 110A,A01,185612,Staff,8,0,40,32
1683696848819,ECON 120A,A01,185615,Staff,19,0,40,21
1683696849843,ECON 120C,A01,185617,Sun; Yixiao,0,21,70,70
1683696850871,ECON 144,A00,203346,Squires; Dale E,2,0,35,33
1683696851898,ECON 171,A01,203349,Newhouse; Herbert S,0,1,35,35
1683696852925,ECON 173A,A01,185621,Toda; Alexis Akira,21,0,35,14
1683696853949,EDS 25,A01,202413,Staff,0,1,0,0
1683696853949,EDS 25,A02,202414,Staff,0,1,0,0
1683696853949,EDS 25,A03,202415,Staff,0,0,0,0
1683696853949,EDS 25,A04,202416,Staff,0,1,0,0
1683696853949,EDS 25,A05,202439,Staff,0,0,0,0
1683696853949,EDS 25,A06,202440,Staff,0,0,0,0
1683696853949,EDS 25,B01,202631,Staff,0,0,0,0
1683696853949,EDS 25,B02,202632,Staff,0,0,0,0
1683696853949,EDS 25,B03,202639,Staff,0,0,0,0
1683696853949,EDS 25,B04,202640,Staff,0,0,0,0
1683696853949,EDS 25,B05,202643,Staff,0,0,0,0
1683696853949,EDS 25,B06,202644,Staff,0,0,0,0
1683696854973,EDS 38,A01,202659,Black; Alison Michelle,24,0,25,1
1683696855997,EDS 115,A00,202652,Staff,18,0,30,12
1683696857025,EDS 125,A00,202649,Staff,13,0,30,17
1683696858051,EDS 126,A01,203332,Staff,30,0,30,0
1683696859076,EDS 139,A00,202838,Staff,16,0,25,9
1683696860100,EDS 146,A01,202655,Staff,14,0,25,11
1683696861125,ENG 15,A00,185667,Staff,0,1,0,0
1683696861125,ENG 15,B00,185672,Staff,0,0,0,0
1683696861125,ENG 15,C00,185675,Staff,0,0,0,0
1683696861125,ENG 15,D00,185682,Staff,0,0,0,0
1683696861125,ENG 15,E00,185684,Staff,0,0,0,0
1683696862152,ETHN 103,A00,185710,Staff,0,8,35,35
1683696863180,ETHN 103A,A00,199228,Man; Simeon S,0,0,9,9
1683696864203,ETHN 109,A00,185711,Staff,15,0,35,20
1683696865226,ETHN 142,A00,185726,Staff,0,4,30,30
1683696866253,ETHN 163J,A00,199229,Man; Simeon S,5,0,8,3
1683696867277,ETHN 168,A00,185727,Staff,7,0,10,3
1683696868299,ETHN 182,A00,185728,Staff,0,0,35,35
1683696869323,ETHN 183,A00,185737,Staff,9,0,18,9
1683696870350,GLBH 111,A01,209361,Burgos; Jose L.,0,0,0,0
1683696872399,HIEU 104,A00,185792,Staff,14,0,20,6
1683696873427,HIEU 115,A00,185800,Staff,0,0,20,20
1683696874453,HIEU 128,A00,185801,Staff,0,9,20,20
1683696875477,HIEU 147,A00,185802,Staff,15,0,20,5
1683696876501,HIEU 154,A00,185823,Staff,11,0,20,9
1683696877525,HILA 102,A00,185826,Staff,14,0,20,6
1683696878553,HILD 2C,A01,185778,Staff,0,13,20,20
1683696879582,HILD 7B,A01,185780,Kwak; Nancy,0,17,32,32
1683696879582,HILD 7B,A02,185781,Kwak; Nancy,0,18,32,32
1683696880607,HILD 30,A01,185791,Staff,12,0,20,8
1683696881630,HISC 119,A00,185830,Golan; Tal,0,10,20,20
1683696882656,HITO 156GS,A00,185831,Patterson; Patrick H.,0,0,0,23
1683696883683,HIUS 103,A00,185832,Man; Simeon S,0,4,20,20
1683696884706,HIUS 117,A00,185836,Kwak; Nancy,2,0,20,18
1683696885733,HIUS 125,A00,185840,Man; Simeon S,0,2,23,23
1683696886756,HIUS 149,A00,185845,Staff,1,0,20,19
1683696887784,HUM 3,A01,185882,Zavodny; Tatiana Sophia,0,8,50,50
1683696887784,HUM 3,B01,185899,Caldwell; Michael Alan,0,18,50,50
1683696888810,HUM 3GS,A00,185900,Patterson; Patrick H.,0,0,0,23
1683696889839,HUM 4,A01,185938,Zroka; Amy Liane,28,0,50,22
1683696889839,HUM 4,B01,185956,Watkins; Eric,0,6,50,50
1683696889839,HUM 4,B02,202209,Watkins; Eric,0,5,50,50
1683696889839,HUM 4,B03,202210,Watkins; Eric,0,5,50,50
1683696890864,HUM 5,A01,185958,West; Geoffrey Scott,0,0,50,50
1683696890864,HUM 5,A02,202215,West; Geoffrey Scott,0,1,50,50
1683696891888,INTL 190,A00,185959,Gagnon; Jeffrey C,0,0,0,9
1683696891888,INTL 190,B00,185960,Lettieri; Michael Joseph,0,0,0,2
1683696892914,JAPN 180,A00,254509,Staff,5,0,30,25
1683696893943,LATI 10,A01,202853,Kennemore; Amy Michelle,4,0,35,31
1683696893943,LATI 10,A02,202854,Kennemore; Amy Michelle,3,0,35,32
1683696893943,LATI 10,A03,270054,Kennemore; Amy Michelle,30,0,30,0
1683696894970,LATI 180,A00,202855,Kennemore; Amy Michelle,11,0,20,9
1683696896006,LAWS 101,A00,201767,Golan; Tal,0,7,40,40
1683696897030,LIFR 1C,A00,185961,Staff,6,0,20,14
1683696898056,LIFR 1CX,A00,185962,Staff,7,0,20,13
1683696899081,LIFR 1D,A00,185963,Staff,7,0,20,13
1683696900105,LIFR 1DX,A00,185964,Staff,7,0,20,13
1683696901129,LIGN 101,A01,186039,Staff,43,0,50,7
1683696902156,LIGN 165,A00,186040,Staff,15,0,50,35
1683696903180,LTCS 108,A00,186041,Staff,5,0,10,5
1683696904204,LTCS 119,A00,186042,Staff,15,0,20,5
1683696905232,LTCS 130,A00,186043,Wesling; Megan E.,15,0,25,10
1683696907283,LTEA 138,A00,186119,Staff,14,0,40,26
1683696908308,LTEN 124,A00,186148,Staff,5,0,25,20
1683696909331,LTEN 178,A00,186149,Staff,6,0,15,9
1683696910355,LTEN 181,A00,186150,Blanco; John D,34,0,40,6
1683696911379,LTWL 120,A00,186160,Staff,19,0,25,6
1683696912406,LTWL 165,A00,186161,Staff,22,0,25,3
1683696913430,LTWR 100,A00,186162,Staff,0,5,15,15
1683696914458,LTWR 102,A00,186163,Doller; Ben,5,0,15,10
1683696915482,MAE 8,A01,186412,Staff,0,1,0,0
1683696916506,MAE 30B,A00,186445,Bahadori; Mohammad Yousef,81,0,100,19
1683696917531,MAE 40,A00,186592,Bewley; Thomas R,10,0,50,40
1683696918558,MAE 101B,A00,186593,Bahadori; Mohammad Yousef,80,0,100,20
1683696919585,MAE 105,A00,186594,Bandaru; Prabhakar,10,0,50,40
1683696920609,MAE 107,A00,186599,Pham; Hieu Tan,0,8,120,120
1683696921636,MAE 148,A01,186660,Silberman; Jack,3,0,16,13
1683696922663,MATH 10A,A01,188095,Staff,0,6,35,35
1683696923690,MATH 10B,A01,188097,Bowers; Adam R.,0,12,30,30
1683696923690,MATH 10B,A02,188099,Bowers; Adam R.,0,11,30,30
1683696923690,MATH 10B,B01,188104,Bowers; Adam R.,0,10,30,30
1683696923690,MATH 10B,B02,188106,Bowers; Adam R.,0,9,30,30
1683696924713,MATH 10C,A01,188111,Staff,0,20,30,30
1683696924713,MATH 10C,A02,188127,Staff,0,19,30,30
1683696924713,MATH 10C,A03,188131,Staff,0,19,30,30
1683696924713,MATH 10C,B01,188218,Staff,17,0,30,13
1683696924713,MATH 10C,B02,188244,Staff,13,0,30,17
1683696924713,MATH 10C,B03,188277,Staff,14,0,30,16
1683696925737,MATH 18,A01,188344,Bach; Quang Tran,18,0,30,12
1683696925737,MATH 18,A02,188345,Bach; Quang Tran,11,0,30,19
1683696925737,MATH 18,B01,188353,Bach; Quang Tran,11,0,30,19
1683696925737,MATH 18,B02,188354,Bach; Quang Tran,19,0,30,11
1683696926761,MATH 20A,A01,188374,Staff,11,0,35,24
1683696927787,MATH 20B,A01,188382,Ohm; Ko Woon,7,0,30,23
1683696927787,MATH 20B,A02,188383,Ohm; Ko Woon,22,0,30,8
1683696927787,MATH 20B,B01,188385,Ohm; Ko Woon,7,0,30,23
1683696927787,MATH 20B,B02,188392,Ohm; Ko Woon,22,0,30,8
1683696928812,MATH 20C,A01,188394,Harel; Guershon,10,0,30,20
1683696928812,MATH 20C,A02,188395,Harel; Guershon,13,0,30,17
1683696928812,MATH 20C,B01,188404,Harel; Guershon,5,0,30,25
1683696928812,MATH 20C,B02,188405,Harel; Guershon,18,0,30,12
1683696929842,MATH 20D,A01,188414,Hammock; Frances H,0,1,30,30
1683696929842,MATH 20D,A02,188415,Hammock; Frances H,0,1,30,30
1683696929842,MATH 20D,B01,188447,Hammock; Frances H,0,1,30,30
1683696929842,MATH 20D,B02,188486,Hammock; Frances H,2,0,30,28
1683696930870,MATH 20E,A01,188649,Staff,21,0,30,9
1683696930870,MATH 20E,A02,188650,Staff,20,0,30,10
1683696930870,MATH 20E,A03,188673,Staff,0,0,30,30
1683696931897,MATH 102,A01,188675,Staff,0,40,35,35
1683696932921,MATH 103B,A01,188681,Staff,3,0,35,32
1683696932921,MATH 103B,B01,188692,Staff,5,0,35,30
1683696933948,MATH 109,A01,188695,Salehi Golsefidy; Alireza,24,0,35,11
1683696933948,MATH 109,A02,188696,Salehi Golsefidy; Alireza,25,0,35,10
1683696934977,MATH 120A,A01,188698,Eggers; John Dietrich,7,0,35,28
1683696936005,MATH 142B,A01,188736,Ioana; Adrian,0,0,30,30
1683696936005,MATH 142B,A02,188741,Ioana; Adrian,0,1,30,30
1683696936005,MATH 142B,A03,188743,Ioana; Adrian,0,2,30,30
1683696937034,MATH 168A,A01,188790,Staff,0,11,35,35
1683696938062,MATH 170A,A01,188803,Nie; Jiawang,0,2,35,35
1683696938062,MATH 170A,A02,188811,Nie; Jiawang,0,1,35,35
1683696938062,MATH 170A,A03,188814,Nie; Jiawang,0,0,35,35
1683696938062,MATH 170A,A04,188815,Nie; Jiawang,5,0,35,30
1683696939089,MATH 193B,A01,188817,Staff,0,0,35,35
1683696939089,MATH 193B,A02,188818,Staff,6,0,35,29
1683696940113,MGT 4,A01,202857,Anderson; John Charles,59,0,80,21
1683696941137,MGT 12,A00,202858,Lindenberger; Wade Douglas,40,0,90,50
1683696942215,MGT 18,A00,202859,Staff,74,0,90,16
1683696943240,MGT 18GS,A00,202860,McKay; Michael J,13,0,28,15
1683696944263,MGT 45,A00,202861,Pecore; Joseph P.,8,0,90,82
1683696945286,MGT 100,A00,202863,Yavorsky; Daniel Ryan,27,0,90,63
1683696946310,MGT 103,A00,202864,Ehrich; Kristine R,0,19,90,90
1683696947334,MGT 112,A00,202865,Ehrich; Kristine R,15,0,90,75
1683696948358,MGT 121A,A00,202868,Staff,70,0,90,20
1683696949381,MGT 131B,A00,202869,Anderson; John Charles,58,0,90,32
1683696950405,MGT 136,A00,202871,Lindenberger; Wade Douglas,83,0,90,7
1683696951430,MGT 164,A00,202873,Staff,0,67,90,91
1683696952451,MGT 164GS,A00,202874,McKay; Mary A,13,0,28,15
1683696953476,MGT 180,A00,202875,Staff,0,51,90,91
1683696954500,MMW 11R,A01,205019,Herbst; Matthew,0,0,30,30
1683696954500,MMW 11R,A02,205026,Herbst; Matthew,29,0,30,1
1683696955529,MMW 15,A01,193512,Chang; Edmond Yi-Teh,0,8,28,28
1683696955529,MMW 15,A02,193513,Chang; Edmond Yi-Teh,0,5,28,28
1683696955529,MMW 15,A03,193514,Chang; Edmond Yi-Teh,0,5,28,28
1683696955529,MMW 15,A04,193515,Chang; Edmond Yi-Teh,0,5,28,28
1683696955529,MMW 15,A05,193516,Chang; Edmond Yi-Teh,0,5,28,28
1683696955529,MMW 15,A06,193517,Chang; Edmond Yi-Teh,0,6,28,28
1683696955529,MMW 15,B01,193519,Chang; Edmond Yi-Teh,0,5,28,28
1683696955529,MMW 15,B02,193520,Chang; Edmond Yi-Teh,0,5,28,28
1683696955529,MMW 15,B03,193521,Chang; Edmond Yi-Teh,0,5,28,28
1683696955529,MMW 15,B04,193522,Chang; Edmond Yi-Teh,0,6,28,28
1683696955529,MMW 15,B05,193523,Chang; Edmond Yi-Teh,0,5,28,28
1683696955529,MMW 15,B06,193524,Chang; Edmond Yi-Teh,0,5,28,28
1683696956557,MMW 122,A01,193526,Rahimi; Babak,0,16,28,28
1683696956557,MMW 122,A02,193527,Rahimi; Babak,0,15,28,28
1683696956557,MMW 122,A03,193528,Rahimi; Babak,0,0,0,0
1683696956557,MMW 122,A04,193529,Rahimi; Babak,0,0,0,0
1683696957584,MUS 1A,A01,186663,Staff,0,18,35,35
1683696958608,MUS 4,A01,186715,Staff,0,12,35,35
1683696959633,MUS 5R,A01,186796,Dubnov; Shlomo,0,17,35,35
1683696960657,MUS 6,A01,186798,Staff,0,4,25,25
1683696961679,MUS 7,A01,186830,Staff,11,0,35,24
1683696962708,MUS 8,A01,186930,Staff,0,27,35,35
1683696963735,MUS 15,A01,186932,Staff,0,15,35,35
1683696963735,MUS 15,B01,186934,Staff,0,16,35,35
1683696964759,MUS 80,A00,186935,Staff,0,0,20,20
1683696964759,MUS 80,B00,186936,Staff,24,0,25,1
1683696965783,NANO 11,A00,204702,Lipomi; Darren John,0,0,0,0
1683696966808,NANO 15,A01,204709,Yang; Kesong,0,1,0,0
1683696967832,NANO 114,A00,202069,Jahed Motlagh; Zeinab,2,0,10,8
1683696968860,PHIL 1,A00,186955,Grush; Rick Scott,31,0,40,9
1683696969889,PHIL 10,A01,186973,Grush; Rick Scott,27,0,35,8
1683696969889,PHIL 10,A02,186974,Grush; Rick Scott,33,0,35,2
1683696970911,PHIL 13,A01,186976,Staff,1,0,35,34
1683696970911,PHIL 13,A02,186977,Staff,16,0,35,19
1683696971934,PHIL 14,A01,186979,Staff,31,0,35,4
1683696971934,PHIL 14,A02,186986,Staff,32,0,35,3
1683696972963,PHIL 28,A01,186988,Staff,16,0,30,14
1683696972963,PHIL 28,A02,186989,Staff,1,0,30,29
1683696972963,PHIL 28,A03,186990,Staff,10,0,30,20
1683696972963,PHIL 28,A04,186991,Staff,26,0,30,4
1683696973987,PHIL 120,A00,186997,Staff,23,0,40,17
1683696975014,PHIL 137,A00,187003,Staff,7,0,40,33
1683696976041,PHIL 150,A00,187015,Staff,47,0,70,23
1683696977068,PHIL 167,A00,187021,Lamey; Andy M.,34,0,40,6
1683696978095,PHIL 174,A01,202226,Staff,17,0,20,3
1683696978095,PHIL 174,A02,202235,Staff,20,0,20,0
1683696979118,PHIL 191A,A00,258918,Staff,0,0,1,1
1683696980142,PHYS 1A,A00,187028,Staff,26,0,60,34
1683696981166,PHYS 1AL,001,187036,Staff,3,0,30,27
1683696981166,PHYS 1AL,002,187049,Staff,18,0,30,12
1683696982190,PHYS 1B,A00,187058,Staff,22,0,60,38
1683696983215,PHYS 1BL,001,187064,Staff,0,1,30,30
1683696983215,PHYS 1BL,002,187070,Staff,4,0,30,26
1683696984240,PHYS 1C,A00,187082,Staff,29,0,120,91
1683696985264,PHYS 1CL,001,187088,Staff,0,9,30,30
1683696985264,PHYS 1CL,002,187089,Staff,0,1,30,30
1683696985264,PHYS 1CL,009,262693,Staff,9,0,30,21
1683696986290,PHYS 2B,A01,187097,Staff,55,0,115,60
1683696987317,PHYS 2C,A01,187099,Staff,63,0,115,52
1683696988341,PHYS 2CL,A01,187101,Staff,5,0,28,23
1683696988341,PHYS 2CL,A02,187102,Staff,15,0,28,13
1683696989367,PHYS 2D,A01,187123,Shotwell; Brian,95,0,115,20
1683696990391,PHYS 4B,A01,187133,Grinstein; Benjamin,35,0,50,15
1683696991416,POLI 10,A00,188819,Staff,0,4,50,50
1683696992443,POLI 11,A00,188827,Staff,43,0,50,7
1683696993470,POLI 13R,A00,188828,Staff,0,1,20,20
1683696994497,POLI 27,A01,188830,Elgin; Samuel Zincke,0,2,70,70
1683696995523,POLI 30,A00,188832,Desposato; Scott,30,0,50,20
1683696996550,POLI 102F,A00,188834,Staff,1,0,40,39
1683696997578,POLI 104A,A00,188852,Staff,12,0,30,18
1683696998602,POLI 104I,A00,188853,Staff,0,8,20,20
1683696999626,POLI 110B,A00,188854,Wiens; David,6,0,20,14
1683697000652,POLI 112A,A00,188855,Wiens; David,3,0,30,27
1683697001679,POLI 117R,A00,188856,Forman; Fonna,0,12,20,20
1683697002704,POLI 118,A00,188857,Ingham; Sean,8,0,20,12
1683697003732,POLI 120G,A00,188858,Staff,8,0,30,22
1683697004758,POLI 131CR,A00,188863,Hoston; Germaine,20,0,50,30
1683697005785,POLI 133,A00,188864,Nellis; Gareth Hb,44,0,50,6
1683697006810,POLI 134D,A00,188865,Desposato; Scott,27,0,30,3
1683697007834,POLI 142A,A00,188871,Gartzke; Erik,21,0,50,29
1683697008863,POLI 142K,A00,188874,Staff,38,0,50,12
1683697009888,POLI 143,A00,188940,Gartzke; Erik,16,0,30,14
1683697010912,POLI 153,A00,188943,Staff,2,0,20,18
1683697011939,POLI 160AA,A00,188944,Staff,10,0,40,30
1683697012963,POLI 170A,A00,188945,Staff,10,0,30,20
1683697015013,PSYC 1,A00,188952,Staff,36,0,90,54
1683697016037,PSYC 2,B00,188953,Staff,19,0,35,16
1683697017062,PSYC 6,A00,188970,Staff,47,0,60,13
1683697018086,PSYC 7,A00,188973,Staff,35,0,45,10
1683697019114,PSYC 60,A01,188980,Rickard; Timothy C.,42,0,60,18
1683697020137,PSYC 70,A01,189001,Steiner; Eric Tomas,21,0,45,24
1683697021167,PSYC 100,A00,189005,Lacefield; Katharine I,0,99,120,120
1683697022190,PSYC 102,A00,189008,Staff,6,0,30,24
1683697023218,PSYC 106,B00,189026,Gorman; Michael R.,27,0,60,33
1683697024245,PSYC 114,B01,189033,Winkielman; Piotr,0,31,30,30
1683697025269,PSYC 131,A00,189036,Anagnostaras; Stephan,0,44,60,60
1683697026294,PSYC 136,A00,189041,Lowe; Angela Beth,0,7,25,25
1683697027322,PSYC 137,A00,189057,Winkielman; Piotr,0,36,25,25
1683697028349,PSYC 144,A00,189107,Wixted; John T,0,11,50,50
1683697030398,PSYC 162,A00,189142,Staff,0,9,85,85
1683697031422,PSYC 172,A00,189144,Gorman; Michael R.,0,6,30,30
1683697033470,PSYC 179,A00,189146,Lacefield; Katharine I,0,88,120,120
1683697034494,PSYC 181,A00,189147,Anagnostaras; Stephan,0,45,90,90
1683697035521,PSYC 190R,A00,189148,Barner; David A.,0,23,80,80
1683697036548,PSYC 191,A00,189275,Rickard; Timothy C.,0,11,25,25
1683697037573,PSYC 193,A00,189276,Chapman; Eddie Nathaniel,0,1,0,4
1683697038598,PSYC 193L,A01,189281,Lowe; Angela Beth,8,0,20,12
1683697038598,PSYC 193L,B01,189285,Staff,28,0,35,7
1683697039625,RELI 149,A00,187137,Rahimi; Babak,6,0,40,34
1683697040649,SE 9,A01,187315,Staff,0,2,18,18
1683697041675,SE 101B,A00,187409,Staff,24,0,30,6
1683697042701,SE 110B,A00,187444,Staff,10,0,40,30
1683697043730,SE 130B,A00,187449,Staff,31,0,40,9
1683697044758,SE 150A,A00,187516,Staff,8,0,20,12
1683697045842,SE 154,A00,187528,Staff,29,0,50,21
1683697046869,SIO 3,A01,258171,Staff,35,0,40,5
1683697047896,SIO 10,A00,187144,Cook; Geoffrey W,0,6,75,75
1683697048926,SIO 45,A00,187152,Cook; Geoffrey W,0,7,100,100
1683697049952,SIO 109R,A00,194486,Staff,0,4,20,20
1683697052003,SIO 187,A01,187233,Kacev; David,12,0,40,28
1683697053032,SOCI 1,A01,258656,Thorpe; Charles Robert,28,0,30,2
1683697053032,SOCI 1,A02,258658,Thorpe; Charles Robert,30,0,30,0
1683697053032,SOCI 1,A03,258661,Thorpe; Charles Robert,25,0,25,0
1683697053032,SOCI 1,A04,258666,Thorpe; Charles Robert,22,0,25,3
1683697053032,SOCI 1,A05,258897,Thorpe; Charles Robert,22,0,25,3
1683697053032,SOCI 1,A06,258898,Thorpe; Charles Robert,25,0,25,0
1683697054058,SOCI 30,A01,258903,Pardo Guerra; Juan Pablo,14,0,30,16
1683697055082,SOCI 102,A00,258904,Staff,9,0,25,16
1683697056107,SOCI 106,A00,258905,Staff,19,0,25,6
1683697057134,SOCI 111,A00,258907,Ribas Norris; Janet Vanesa,26,0,30,4
1683697058157,SOCI 121R,A00,258908,Pardo Guerra; Juan Pablo,7,0,30,23
1683697059182,SOCI 126,A01,203330,Staff,14,0,20,6
1683697060206,SOCI 131,A00,258909,Thorpe; Charles Robert,30,0,60,30
1683697061229,SOCI 135,A00,258910,Payne; Christine Anna,0,13,30,30
1683697062256,SOCI 157,A00,258911,Staff,10,0,30,20
1683697063281,SOCI 184,A00,258912,Staff,25,0,30,5
1683697064308,SOCI 188D,A00,258913,Staff,22,0,30,8
1683697065331,SYN 2,001,187529,Staff,9,0,16,7
1683697065331,SYN 2,002,201452,Staff,0,20,16,16
1683697065331,SYN 2,003,201469,Staff,1,0,16,15
1683697066359,SYN 100,A01,187531,Staff,0,9,20,20
1683697066359,SYN 100,B01,201491,Staff,0,10,20,20
1683697067385,TDAC 1,A00,189286,Walsh; Kim C.,3,0,20,17
1683697067385,TDAC 1,B00,189287,Harting; Carla Kelso,10,0,20,10
1683697068410,TDAC 101,A00,189300,Walsh; Kim C.,16,0,20,4
1683697068410,TDAC 101,B00,189301,Harting; Carla Kelso,18,0,20,2
1683697069433,TDAC 102,A00,189304,Basso; Beatrice,14,0,20,6
1683697070461,TDAC 108,A00,189305,Staff,18,0,20,2
1683697071494,TDDE 131,A00,189310,Staff,19,0,20,1
1683697071494,TDDE 131,B00,189314,Staff,19,0,20,1
1683697071494,TDDE 131,C00,189315,Staff,48,0,50,2
1683697071494,TDDE 131,D00,189316,Staff,14,0,15,1
1683697071494,TDDE 131,E00,204841,Staff,20,0,20,0
1683697072519,TDGE 10,A00,189289,Staff,27,0,50,23
1683697072519,TDGE 10,B00,189290,Havis; Allan,0,1,50,50
1683697073544,TDGE 11,A00,189291,Fulton; Julia,0,4,50,50
1683697073544,TDGE 11,B00,189292,Staff,20,0,25,5
1683697073544,TDGE 11,C00,260270,Staff,0,0,0,0
1683697074570,TDGE 25,A00,189294,Staff,1,0,20,19
1683697075595,TDGE 124,A00,189318,Fulton; Julia,0,7,50,50
1683697076620,TDGE 125,A00,189319,Staff,13,0,25,12
1683697076620,TDGE 125,B00,189320,Staff,23,0,25,2
1683697077644,TDGE 127,A00,189322,Havis; Allan,0,0,50,50
1683697078667,TDHT 101,A00,189323,Staff,18,0,25,7
1683697078667,TDHT 101,B00,189324,Staff,25,0,25,0
1683697079695,TDHT 102,A00,189325,Staff,49,0,50,1
1683697080724,TDMV 1,A00,189295,Arcidiacono; Kristin,20,0,30,10
1683697080724,TDMV 1,B00,189296,Caligagan; Maria T.,24,0,30,6
1683697081751,TDMV 2,A00,189297,Sammartano; Tonnie,27,0,30,3
1683697081751,TDMV 2,B00,189299,Arcidiacono; Kristin,23,0,30,7
1683697082776,TDMV 3,A00,204998,Rincon; Alicia,22,0,30,8
1683697083804,TDMV 120,A00,189458,Sammartano; Tonnie,28,0,30,2
1683697084830,TDMV 138,A00,189541,Jun; Grace Shin Hae,20,0,40,20
1683697085854,TDMV 142,A00,189717,Caligagan; Tony,25,0,30,5
1683697085854,TDMV 142,B00,189718,Caligagan; Maria T.,25,0,30,5
1683697086878,TMC 2,A01,187533,Staff,25,0,25,0
1683697086878,TMC 2,A02,187534,Staff,25,0,25,0
1683697087906,USP 1,A01,187536,Kwak; Nancy,0,16,25,25
1683697088935,USP 5,A01,187538,Staff,8,0,25,17
1683697089960,USP 101,A00,199253,Staff,0,4,0,0
1683697090984,USP 124,A00,187562,Boomhower; Matthew Charles,0,0,30,30
1683697092009,USP 138,A00,187582,Staff,19,0,25,6
1683697093037,USP 152,A01,187597,Staff,3,0,25,22
1683697094062,USP 153,A00,187598,Staff,18,0,25,7
1683697095090,USP 168,A00,187607,Kwak; Nancy,2,0,5,3
1683697096111,USP 173,A00,187619,Staff,4,0,25,21
1683697097135,USP 181,A00,187638,Staff,0,4,25,25
1683697098159,VIS 103,A00,187650,Cruz; Edwin Teddy,17,0,75,58
1683697099182,VIS 110D,A00,187669,Staff,13,0,22,9
1683697100207,VIS 127C,A00,187720,Shen; Kuiyi,67,0,146,79
1683697101232,VIS 149,A00,187731,Yoldas; Pinar,0,12,22,22
1683697102256,VIS 151,A01,188091,Staff,22,0,34,12
1683697102256,VIS 151,A02,188092,Staff,11,0,34,23
1683697103284,VIS 160B,A00,188093,Stalbaum; Brett,0,1,10,10
1683697105335,WCWP 10B,A00,201720,Staff,0,0,5,5
1683697105335,WCWP 10B,B00,201722,Staff,0,0,6,6
1683697106359,WCWP 100,A00,201725,Gagnon; Jeffrey C,0,0,2,2
1683697106359,WCWP 100,B00,201727,Staff,0,4,15,15
1683697109455,ANBI 133,A00,258401,Wilder; Linnea Lorene,34,0,40,6
1683697110482,ANBI 140,A00,258395,Hrvoj Mihic; Branka,18,0,25,7
1683697111505,ANSC 120,A00,258402,Bialecki; Jon Anthony,26,0,40,14
1683697112529,ANSC 144,A00,258400,Staff,12,0,40,28
1683697114577,ANSC 166,A00,258396,Parish; Steven Martin,156,0,175,19
1683697115601,ANSC 180,A00,193533,Staff,8,0,20,12
1683697116625,ANSC 188,A00,258397,Jassal; Aftab,34,0,40,6
1683697117653,ANTH 3,A01,258316,Staff,23,0,30,7
1683697118677,ANTH 5,A00,258394,Semendeferi; Ekaterini,16,0,20,4
1683697119705,ANTH 21,A01,258331,Staff,4,0,40,36
1683697120729,ANTH 103,A00,258398,Varma; Saiba,15,0,25,10
1683697121761,AWP 10,001,202034,Staff,0,0,0,0
1683697121761,AWP 10,002,202035,Staff,0,0,0,0
1683697121761,AWP 10,003,202036,Staff,0,0,0,0
1683697121761,AWP 10,004,202037,Staff,0,0,0,0
1683697121761,AWP 10,005,202038,Staff,0,0,0,0
1683697121761,AWP 10,006,202039,Staff,0,0,0,0
1683697121761,AWP 10,007,202040,Staff,0,0,0,0
1683697121761,AWP 10,008,202041,Staff,0,0,0,0
1683697121761,AWP 10,009,202042,Staff,0,0,0,0
1683697121761,AWP 10,010,202043,Staff,0,0,0,0
1683697121761,AWP 10,011,202044,Staff,0,0,0,0
1683697121761,AWP 10,012,202045,Staff,0,0,0,0
1683697121761,AWP 10,013,202046,Staff,0,0,0,0
1683697121761,AWP 10,014,202047,Staff,0,0,0,0
1683697121761,AWP 10,015,202048,Staff,0,0,0,0
1683697121761,AWP 10,016,202049,Staff,0,0,0,0
1683697121761,AWP 10,017,202050,Staff,0,0,0,0
1683697121761,AWP 10,018,202051,Staff,0,0,0,0
1683697121761,AWP 10,019,202052,Staff,0,0,0,0
1683697121761,AWP 10,020,202053,Staff,0,0,0,0
1683697121761,AWP 10,021,202054,Staff,0,0,0,0
1683697121761,AWP 10,022,202055,Staff,0,0,0,0
1683697121761,AWP 10,023,202056,Staff,0,0,0,0
1683697121761,AWP 10,024,202057,Staff,0,0,0,0
1683697121761,AWP 10,025,202058,Staff,0,0,0,0
1683697121761,AWP 10,026,202059,Staff,0,0,0,0
1683697122785,AWP 102,001,202032,Staff,0,0,0,0
1683697122785,AWP 102,002,202033,Staff,0,0,0,0
1683697123809,BENG 100,A01,254234,Taylor Amos; Alyssa C,31,0,40,9
1683697124832,BENG 196,001,270013,Engler; Adam J.,9999,0,9999,0
1683697125861,BICD 100R,A01,202018,Smith; Laurie,0,7,32,32
1683697125861,BICD 100R,A02,202019,Smith; Laurie,0,3,32,32
1683697125861,BICD 100R,A03,202020,Smith; Laurie,0,1,32,32
1683697125861,BICD 100R,A04,202021,Smith; Laurie,6,0,32,26
1683697125861,BICD 100R,A05,202022,Smith; Laurie,10,0,32,22
1683697126888,BICD 136,A01,193242,Gustafson-Brown; Cindy,0,2,32,32
1683697126888,BICD 136,A02,193244,Gustafson-Brown; Cindy,13,0,32,19
1683697127913,BIEB 102,A01,193249,Butler; Shannon Rhey,0,0,32,32
1683697127913,BIEB 102,A02,193251,Butler; Shannon Rhey,0,0,32,32
1683697127913,BIEB 102,A03,193253,Butler; Shannon Rhey,0,0,32,32
1683697127913,BIEB 102,A04,193255,Butler; Shannon Rhey,13,0,32,19
1683697127913,BIEB 102,A05,193265,Butler; Shannon Rhey,25,0,32,7
1683697127913,BIEB 102,A06,193269,Butler; Shannon Rhey,12,0,32,20
1683697129963,BIEB 150,A01,193274,Staff,0,0,32,32
1683697129963,BIEB 150,A02,193285,Staff,24,0,32,8
1683697130988,BIEB 194,A00,193286,Kurle; Carolyn M.,19,0,32,13
1683697132013,BILD 1,A01,192291,Staff,15,0,32,17
1683697132013,BILD 1,A02,192292,Staff,30,0,32,2
1683697132013,BILD 1,B01,192520,Reuther; Keefe,0,1,0,0
1683697132013,BILD 1,B02,192532,Reuther; Keefe,0,1,0,0
1683697133043,BILD 3,A01,192556,Butler; Shannon Rhey,0,0,32,32
1683697133043,BILD 3,A02,192581,Butler; Shannon Rhey,0,1,32,32
1683697133043,BILD 3,A03,192611,Butler; Shannon Rhey,19,0,32,13
1683697133043,BILD 3,A04,192612,Butler; Shannon Rhey,23,0,32,9
1683697133043,BILD 3,A05,192613,Butler; Shannon Rhey,26,0,32,6
1683697133043,BILD 3,A06,192679,Butler; Shannon Rhey,27,0,32,5
1683697133043,BILD 3,A07,192682,Butler; Shannon Rhey,20,0,32,12
1683697134071,BILD 4,A01,192836,Reuther; Keefe,1,0,24,23
1683697134071,BILD 4,A02,193044,Reuther; Keefe,4,0,24,20
1683697135099,BILD 10,A01,193142,Gustafson-Brown; Cindy,29,0,32,3
1683697135099,BILD 10,A02,193149,Gustafson-Brown; Cindy,31,0,32,1
1683697136123,BIMM 100,A01,193301,Staff,0,6,32,32
1683697136123,BIMM 100,A02,193312,Staff,0,7,32,32
1683697136123,BIMM 100,A03,193323,Staff,0,10,32,32
1683697137146,BIMM 101,A01,193329,McDonnell; Lisa Marie,0,3,24,24
1683697137146,BIMM 101,A02,193339,McDonnell; Lisa Marie,0,3,24,24
1683697137146,BIMM 101,B01,193354,McDonnell; Lisa Marie,0,4,24,24
1683697137146,BIMM 101,B02,193357,McDonnell; Lisa Marie,0,3,24,24
1683697138173,BIMM 110,A01,193377,Tat; John,0,11,32,32
1683697138173,BIMM 110,A02,193378,Tat; John,0,11,32,32
1683697139198,BIMM 120,A01,206116,Staff,0,0,32,32
1683697139198,BIMM 120,A02,206117,Staff,7,0,32,25
1683697139198,BIMM 120,A03,206121,Staff,21,0,32,11
1683697140227,BIPN 100,A01,193393,Park; Ji Young,0,15,32,32
1683697140227,BIPN 100,A02,193402,Park; Ji Young,0,14,32,32
1683697140227,BIPN 100,A03,193413,Park; Ji Young,0,14,32,32
1683697140227,BIPN 100,A04,193414,Park; Ji Young,0,13,32,32
1683697141251,BIPN 102,A01,193429,Staff,0,0,32,32
1683697141251,BIPN 102,A02,193438,Staff,18,0,32,14
1683697142280,BIPN 106,A01,193450,Reyes Gonzalez; Catalina,0,2,40,40
1683697143310,BIPN 134,A01,193465,Cooke; James Edward,0,0,32,32
1683697143310,BIPN 134,A02,193474,Cooke; James Edward,25,0,32,7
1683697143310,BIPN 134,A03,193485,Cooke; James Edward,29,0,32,3
1683697143310,BIPN 134,A04,193486,Cooke; James Edward,20,0,32,12
1683697143310,BIPN 134,A05,193491,Cooke; James Edward,31,0,32,1
1683697143310,BIPN 134,A06,193501,Cooke; James Edward,30,0,32,2
1683697143310,BIPN 134,A07,193510,Cooke; James Edward,29,0,32,3
1683697145366,BISP 194,A00,222522,Staff,14,0,32,18
1683697146390,CAT 124,A01,202407,Staff,19,0,25,6
1683697147415,CAT 125,A00,202408,Marchisotto; Jennifer Anne,2,0,20,18
1683697148438,CAT 125R,A00,202409,Smith; Lauryn Alissa,0,11,20,20
1683697148438,CAT 125R,B00,202410,Morales; Celeste Georgianna,0,11,20,20
1683697148438,CAT 125R,C00,202411,Irwin; Matthew Joseph,0,12,20,20
1683697149534,CENG 15,A01,204712,Yang; Kesong,0,1,0,0
1683697150558,CENG 114,A00,202070,Jahed Motlagh; Zeinab,5,0,20,15
1683697151583,CGS 105,A00,185477,Wesling; Megan E.,24,0,40,16
1683697152609,CGS 106,A00,185494,Staff,11,0,22,11
1683697153635,CGS 108,A00,185495,Staff,14,0,20,6
1683697154659,CGS 114,A00,185496,Staff,13,0,18,5
1683697155683,CGS 119,A00,185501,Staff,15,0,20,5
1683697156707,CGS 120,A00,185511,Staff,12,0,20,8
1683697157732,CHEM 4,A01,184675,Bussey; Thomas J,97,0,100,3
1683697158759,CHEM 6A,A01,184677,Staff,32,0,60,28
1683697159787,CHEM 6B,A01,184679,Staff,63,0,100,37
1683697160812,CHEM 6C,A01,184681,Bussey; Thomas J,0,0,50,50
1683697160812,CHEM 6C,A02,184682,Bussey; Thomas J,32,0,50,18
1683697161838,CHEM 40A,A01,184684,Albizati; Kim F.,33,0,100,67
1683697162866,CHEM 40B,A01,184686,Albizati; Kim F.,0,22,100,100
1683697163892,CHEM 41B,A01,184690,Staff,51,0,100,49
1683697164919,COGS 3,A01,184715,Boyle; Mary E. T.,0,27,40,40
1683697165946,COGS 14B,A01,185172,Staff,0,14,38,38
1683697166970,COGS 18,A01,184736,Staff,14,0,80,66
1683697167997,COGS 100,A01,184932,Staff,0,8,73,73
1683697169025,COGS 101A,A01,184935,Staff,0,40,30,30
1683697170052,COGS 101B,A01,184944,Staff,0,2,30,30
1683697171075,COGS 101C,A01,184946,Staff,0,10,30,30
1683697172099,COGS 102A,A01,184951,Johnson; Christine M.,1,0,40,39
1683697173124,COGS 107B,A01,184953,Mooshagian; Eric Frederick,0,52,40,40
1683697174147,COGS 118B,A01,184959,Gupta; Anjum,0,50,40,40
1683697175171,COGS 153,A00,184961,Staff,1,16,30,29
1683697176198,COGS 177,A00,184962,Staff,0,20,30,30
1683697177224,COGS 187A,A01,184969,Boyle; Mary E. T.,0,19,40,40
1683697178251,COMM 10,A01,185174,Staff,0,5,25,25
1683697178251,COMM 10,A02,185189,Staff,0,2,25,25
1683697178251,COMM 10,A03,269821,Staff,0,1,0,0
1683697179279,COMM 100B,A02,185476,Staff,10,0,25,15
1683697179279,COMM 100B,A03,277340,Staff,25,0,25,0
1683697180307,COMM 100C,A01,185314,Staff,2,0,25,23
1683697180307,COMM 100C,A02,185327,Staff,17,0,25,8
1683697181334,COMM 110M,A00,185349,Staff,0,0,40,40
1683697182358,COMM 113T,A00,185352,Staff,25,0,40,15
1683697183391,COMM 114I,A00,185353,Staff,31,0,40,9
1683697184416,COMM 131,A00,185354,Staff,17,0,30,13
1683697185444,CSE 8A,A50,185358,Cao; Yingjun,0,46,10,10
1683697186468,CSE 8B,A01,185362,Staff,0,48,50,50
1683697187495,CSE 11,A01,185416,Cao; Yingjun,0,91,10,10
1683697188519,CSE 20,A01,185445,Briones; Jor-el Thomas Caparas,3,0,25,22
1683697189544,CSE 21,A01,185447,Staff,9,0,50,41
1683697190569,CSE 101,A01,185451,Staff,0,13,50,50
1683697190569,CSE 101,B01,185453,Jones; Miles E,0,14,50,50
1683697192619,CSE 141,A01,185458,Eldon; John,16,0,100,84
1683697193643,CSE 141L,A01,185461,Eldon; John,8,0,100,92
1683697194671,CSE 142,A01,185463,Staff,34,0,60,26
1683697194671,CSE 142,B01,201355,Staff,0,7,60,60
1683697195698,CSE 142L,A01,185470,Staff,34,0,60,26
1683697195698,CSE 142L,B01,201417,Staff,0,6,60,60
1683697196721,CSE 190,A00,201433,Staff,32,0,49,17
1683697197745,DOC 1,A01,259136,Strom; Megan C.,7,0,15,8
1683697197745,DOC 1,A02,259137,Strom; Megan C.,14,0,15,1
1683697197745,DOC 1,A03,259138,Strom; Megan C.,14,0,15,1
1683697197745,DOC 1,A04,259139,Strom; Megan C.,14,0,15,1
1683697198769,DOC 100D,A00,259140,Pass; Natalye Joann,14,0,25,11
1683697199794,DSGN 1,A01,184749,Rill; Bryan,0,26,30,30
1683697200819,DSGN 100,A01,185168,Staff,0,2,25,25
1683697201845,ECE 5,A01,185626,Morris; Karcher William,0,12,0,0
1683697202869,ECE 101,A01,185628,Staff,14,0,70,56
1683697203893,ECE 107,A01,185635,Baghdadchi; Saharnaz,0,0,20,20
1683697203893,ECE 107,A02,185638,Baghdadchi; Saharnaz,1,0,20,19
1683697204917,ECE 148,A01,185647,Silberman; Jack,0,0,16,16
1683697205941,ECON 1,A01,185537,Crane; Meredith Helen,54,0,70,16
1683697206967,ECON 3,A01,185549,Crane; Meredith Helen,30,0,70,40
1683697207994,ECON 4,A01,203354,Anderson; John Charles,0,5,10,10
1683697209019,ECON 100A,A01,185574,Staff,0,5,40,40
1683697210043,ECON 100B,A01,185576,Staff,0,12,50,50
1683697211068,ECON 100C,A01,185589,Newhouse; Herbert S,30,0,70,40
1683697212093,ECON 105,A00,185608,Vespa; Emanuel Ignacio,19,0,35,16
1683697213117,ECON 109,A01,185610,Shishkin; Denis,9,0,35,26
1683697214145,ECON 110A,A01,185612,Staff,8,0,40,32
1683697215170,ECON 120A,A01,185615,Staff,19,0,40,21
1683697216193,ECON 120C,A01,185617,Sun; Yixiao,0,21,70,70
1683697217221,ECON 144,A00,203346,Squires; Dale E,2,0,35,33
1683697218245,ECON 171,A01,203349,Newhouse; Herbert S,0,1,35,35
1683697219269,ECON 173A,A01,185621,Toda; Alexis Akira,21,0,35,14
1683697220294,EDS 25,A01,202413,Staff,0,1,0,0
1683697220294,EDS 25,A02,202414,Staff,0,1,0,0
1683697220294,EDS 25,A03,202415,Staff,0,0,0,0
1683697220294,EDS 25,A04,202416,Staff,0,1,0,0
1683697220294,EDS 25,A05,202439,Staff,0,0,0,0
1683697220294,EDS 25,A06,202440,Staff,0,0,0,0
1683697220294,EDS 25,B01,202631,Staff,0,0,0,0
1683697220294,EDS 25,B02,202632,Staff,0,0,0,0
1683697220294,EDS 25,B03,202639,Staff,0,0,0,0
1683697220294,EDS 25,B04,202640,Staff,0,0,0,0
1683697220294,EDS 25,B05,202643,Staff,0,0,0,0
1683697220294,EDS 25,B06,202644,Staff,0,0,0,0
1683697221319,EDS 38,A01,202659,Black; Alison Michelle,24,0,25,1
1683697222342,EDS 115,A00,202652,Staff,18,0,30,12
1683697223368,EDS 125,A00,202649,Staff,13,0,30,17
1683697224392,EDS 126,A01,203332,Staff,30,0,30,0
1683697225417,EDS 139,A00,202838,Staff,16,0,25,9
1683697226444,EDS 146,A01,202655,Staff,14,0,25,11
1683697227468,ENG 15,A00,185667,Staff,0,1,0,0
1683697227468,ENG 15,B00,185672,Staff,0,0,0,0
1683697227468,ENG 15,C00,185675,Staff,0,0,0,0
1683697227468,ENG 15,D00,185682,Staff,0,0,0,0
1683697227468,ENG 15,E00,185684,Staff,0,0,0,0
1683697228494,ETHN 103,A00,185710,Staff,0,8,35,35
1683697229521,ETHN 103A,A00,199228,Man; Simeon S,0,0,9,9
1683697230546,ETHN 109,A00,185711,Staff,15,0,35,20
1683697231570,ETHN 142,A00,185726,Staff,0,4,30,30
1683697232594,ETHN 163J,A00,199229,Man; Simeon S,5,0,8,3
1683697233621,ETHN 168,A00,185727,Staff,7,0,10,3
1683697234645,ETHN 182,A00,185728,Staff,0,0,35,35
1683697235669,ETHN 183,A00,185737,Staff,9,0,18,9
1683697236693,GLBH 111,A01,209361,Burgos; Jose L.,0,0,0,0
1683697238740,HIEU 104,A00,185792,Staff,14,0,20,6
1683697239766,HIEU 115,A00,185800,Staff,0,0,20,20
1683697240789,HIEU 128,A00,185801,Staff,0,9,20,20
1683697241817,HIEU 147,A00,185802,Staff,15,0,20,5
1683697242840,HIEU 154,A00,185823,Staff,11,0,20,9
1683697243866,HILA 102,A00,185826,Staff,14,0,20,6
1683697244892,HILD 2C,A01,185778,Staff,0,13,20,20
1683697245922,HILD 7B,A01,185780,Kwak; Nancy,0,17,32,32
1683697245922,HILD 7B,A02,185781,Kwak; Nancy,0,18,32,32
1683697246948,HILD 30,A01,185791,Staff,12,0,20,8
1683697247977,HISC 119,A00,185830,Golan; Tal,0,10,20,20
1683697249001,HITO 156GS,A00,185831,Patterson; Patrick H.,0,0,0,23
1683697250026,HIUS 103,A00,185832,Man; Simeon S,0,4,20,20
1683697251050,HIUS 117,A00,185836,Kwak; Nancy,2,0,20,18
1683697252079,HIUS 125,A00,185840,Man; Simeon S,0,2,23,23
1683697253158,HIUS 149,A00,185845,Staff,1,0,20,19
1683697254186,HUM 3,A01,185882,Zavodny; Tatiana Sophia,0,8,50,50
1683697254186,HUM 3,B01,185899,Caldwell; Michael Alan,0,18,50,50
1683697255213,HUM 3GS,A00,185900,Patterson; Patrick H.,0,0,0,23
1683697256243,HUM 4,A01,185938,Zroka; Amy Liane,28,0,50,22
1683697256243,HUM 4,B01,185956,Watkins; Eric,0,6,50,50
1683697256243,HUM 4,B02,202209,Watkins; Eric,0,5,50,50
1683697256243,HUM 4,B03,202210,Watkins; Eric,0,5,50,50
1683697257268,HUM 5,A01,185958,West; Geoffrey Scott,0,0,50,50
1683697257268,HUM 5,A02,202215,West; Geoffrey Scott,0,1,50,50
1683697258294,INTL 190,A00,185959,Gagnon; Jeffrey C,0,0,0,9
1683697258294,INTL 190,B00,185960,Lettieri; Michael Joseph,0,0,0,2
1683697259318,JAPN 180,A00,254509,Staff,5,0,30,25
1683697260348,LATI 10,A01,202853,Kennemore; Amy Michelle,4,0,35,31
1683697260348,LATI 10,A02,202854,Kennemore; Amy Michelle,3,0,35,32
1683697260348,LATI 10,A03,270054,Kennemore; Amy Michelle,30,0,30,0
1683697261375,LATI 180,A00,202855,Kennemore; Amy Michelle,11,0,20,9
1683697262399,LAWS 101,A00,201767,Golan; Tal,0,7,40,40
1683697263424,LIFR 1C,A00,185961,Staff,6,0,20,14
1683697264449,LIFR 1CX,A00,185962,Staff,7,0,20,13
1683697265474,LIFR 1D,A00,185963,Staff,7,0,20,13
1683697266498,LIFR 1DX,A00,185964,Staff,7,0,20,13
1683697267521,LIGN 101,A01,186039,Staff,43,0,50,7
1683697268545,LIGN 165,A00,186040,Staff,15,0,50,35
1683697269570,LTCS 108,A00,186041,Staff,5,0,10,5
1683697270593,LTCS 119,A00,186042,Staff,15,0,20,5
1683697271618,LTCS 130,A00,186043,Wesling; Megan E.,15,0,25,10
1683697273668,LTEA 138,A00,186119,Staff,14,0,40,26
1683697274690,LTEN 124,A00,186148,Staff,5,0,25,20
1683697275715,LTEN 178,A00,186149,Staff,6,0,15,9
1683697276738,LTEN 181,A00,186150,Blanco; John D,34,0,40,6
1683697277764,LTWL 120,A00,186160,Staff,19,0,25,6
1683697278791,LTWL 165,A00,186161,Staff,22,0,25,3
1683697279816,LTWR 100,A00,186162,Staff,0,5,15,15
1683697280840,LTWR 102,A00,186163,Doller; Ben,5,0,15,10
1683697281867,MAE 8,A01,186412,Staff,0,1,0,0
1683697282895,MAE 30B,A00,186445,Bahadori; Mohammad Yousef,81,0,100,19
1683697283923,MAE 40,A00,186592,Bewley; Thomas R,10,0,50,40
1683697284946,MAE 101B,A00,186593,Bahadori; Mohammad Yousef,80,0,100,20
1683697285974,MAE 105,A00,186594,Bandaru; Prabhakar,10,0,50,40
1683697287003,MAE 107,A00,186599,Pham; Hieu Tan,0,8,120,120
1683697288032,MAE 148,A01,186660,Silberman; Jack,3,0,16,13
1683697289056,MATH 10A,A01,188095,Staff,0,6,35,35
1683697290080,MATH 10B,A01,188097,Bowers; Adam R.,0,12,30,30
1683697290080,MATH 10B,A02,188099,Bowers; Adam R.,0,11,30,30
1683697290080,MATH 10B,B01,188104,Bowers; Adam R.,0,10,30,30
1683697290080,MATH 10B,B02,188106,Bowers; Adam R.,0,9,30,30
1683697291110,MATH 10C,A01,188111,Staff,0,20,30,30
1683697291110,MATH 10C,A02,188127,Staff,0,19,30,30
1683697291110,MATH 10C,A03,188131,Staff,0,19,30,30
1683697291110,MATH 10C,B01,188218,Staff,17,0,30,13
1683697291110,MATH 10C,B02,188244,Staff,13,0,30,17
1683697291110,MATH 10C,B03,188277,Staff,14,0,30,16
1683697292138,MATH 18,A01,188344,Bach; Quang Tran,18,0,30,12
1683697292138,MATH 18,A02,188345,Bach; Quang Tran,11,0,30,19
1683697292138,MATH 18,B01,188353,Bach; Quang Tran,11,0,30,19
1683697292138,MATH 18,B02,188354,Bach; Quang Tran,19,0,30,11
1683697293163,MATH 20A,A01,188374,Staff,11,0,35,24
1683697294189,MATH 20B,A01,188382,Ohm; Ko Woon,7,0,30,23
1683697294189,MATH 20B,A02,188383,Ohm; Ko Woon,22,0,30,8
1683697294189,MATH 20B,B01,188385,Ohm; Ko Woon,7,0,30,23
1683697294189,MATH 20B,B02,188392,Ohm; Ko Woon,22,0,30,8
1683697295215,MATH 20C,A01,188394,Harel; Guershon,10,0,30,20
1683697295215,MATH 20C,A02,188395,Harel; Guershon,13,0,30,17
1683697295215,MATH 20C,B01,188404,Harel; Guershon,5,0,30,25
1683697295215,MATH 20C,B02,188405,Harel; Guershon,18,0,30,12
1683697296240,MATH 20D,A01,188414,Hammock; Frances H,0,1,30,30
1683697296240,MATH 20D,A02,188415,Hammock; Frances H,0,1,30,30
1683697296240,MATH 20D,B01,188447,Hammock; Frances H,0,1,30,30
1683697296240,MATH 20D,B02,188486,Hammock; Frances H,2,0,30,28
1683697297263,MATH 20E,A01,188649,Staff,21,0,30,9
1683697297263,MATH 20E,A02,188650,Staff,20,0,30,10
1683697297263,MATH 20E,A03,188673,Staff,0,0,30,30
1683697298291,MATH 102,A01,188675,Staff,0,40,35,35
1683697299320,MATH 103B,A01,188681,Staff,3,0,35,32
1683697299320,MATH 103B,B01,188692,Staff,5,0,35,30
1683697300347,MATH 109,A01,188695,Salehi Golsefidy; Alireza,24,0,35,11
1683697300347,MATH 109,A02,188696,Salehi Golsefidy; Alireza,25,0,35,10
1683697301375,MATH 120A,A01,188698,Eggers; John Dietrich,7,0,35,28
1683697302403,MATH 142B,A01,188736,Ioana; Adrian,0,0,30,30
1683697302403,MATH 142B,A02,188741,Ioana; Adrian,0,1,30,30
1683697302403,MATH 142B,A03,188743,Ioana; Adrian,0,2,30,30
1683697303425,MATH 168A,A01,188790,Staff,0,11,35,35
1683697304478,MATH 170A,A01,188803,Nie; Jiawang,0,2,35,35
1683697304478,MATH 170A,A02,188811,Nie; Jiawang,0,1,35,35
1683697304478,MATH 170A,A03,188814,Nie; Jiawang,0,0,35,35
1683697304478,MATH 170A,A04,188815,Nie; Jiawang,5,0,35,30
1683697305503,MATH 193B,A01,188817,Staff,0,0,35,35
1683697305503,MATH 193B,A02,188818,Staff,6,0,35,29
1683697306529,MGT 4,A01,202857,Anderson; John Charles,59,0,80,21
1683697307556,MGT 12,A00,202858,Lindenberger; Wade Douglas,40,0,90,50
1683697308581,MGT 18,A00,202859,Staff,74,0,90,16
1683697309607,MGT 18GS,A00,202860,McKay; Michael J,13,0,28,15
1683697310635,MGT 45,A00,202861,Pecore; Joseph P.,8,0,90,82
1683697311662,MGT 100,A00,202863,Yavorsky; Daniel Ryan,27,0,90,63
1683697312688,MGT 103,A00,202864,Ehrich; Kristine R,0,19,90,90
1683697313713,MGT 112,A00,202865,Ehrich; Kristine R,15,0,90,75
1683697314742,MGT 121A,A00,202868,Staff,70,0,90,20
1683697315770,MGT 131B,A00,202869,Anderson; John Charles,58,0,90,32
1683697316796,MGT 136,A00,202871,Lindenberger; Wade Douglas,83,0,90,7
1683697317821,MGT 164,A00,202873,Staff,0,67,90,91
1683697318846,MGT 164GS,A00,202874,McKay; Mary A,13,0,28,15
1683697319870,MGT 180,A00,202875,Staff,0,51,90,91
1683697320898,MMW 11R,A01,205019,Herbst; Matthew,0,0,30,30
1683697320898,MMW 11R,A02,205026,Herbst; Matthew,29,0,30,1
1683697321928,MMW 15,A01,193512,Chang; Edmond Yi-Teh,0,8,28,28
1683697321928,MMW 15,A02,193513,Chang; Edmond Yi-Teh,0,5,28,28
1683697321928,MMW 15,A03,193514,Chang; Edmond Yi-Teh,0,5,28,28
1683697321928,MMW 15,A04,193515,Chang; Edmond Yi-Teh,0,5,28,28
1683697321928,MMW 15,A05,193516,Chang; Edmond Yi-Teh,0,5,28,28
1683697321928,MMW 15,A06,193517,Chang; Edmond Yi-Teh,0,6,28,28
1683697321928,MMW 15,B01,193519,Chang; Edmond Yi-Teh,0,5,28,28
1683697321928,MMW 15,B02,193520,Chang; Edmond Yi-Teh,0,5,28,28
1683697321928,MMW 15,B03,193521,Chang; Edmond Yi-Teh,0,5,28,28
1683697321928,MMW 15,B04,193522,Chang; Edmond Yi-Teh,0,6,28,28
1683697321928,MMW 15,B05,193523,Chang; Edmond Yi-Teh,0,5,28,28
1683697321928,MMW 15,B06,193524,Chang; Edmond Yi-Teh,0,5,28,28
1683697322956,MMW 122,A01,193526,Rahimi; Babak,0,16,28,28
1683697322956,MMW 122,A02,193527,Rahimi; Babak,0,15,28,28
1683697322956,MMW 122,A03,193528,Rahimi; Babak,0,0,0,0
1683697322956,MMW 122,A04,193529,Rahimi; Babak,0,0,0,0
1683697323981,MUS 1A,A01,186663,Staff,0,18,35,35
1683697325004,MUS 4,A01,186715,Staff,0,12,35,35
1683697326030,MUS 5R,A01,186796,Dubnov; Shlomo,0,17,35,35
1683697327058,MUS 6,A01,186798,Staff,0,4,25,25
1683697328084,MUS 7,A01,186830,Staff,11,0,35,24
1683697329108,MUS 8,A01,186930,Staff,0,27,35,35
1683697330136,MUS 15,A01,186932,Staff,0,15,35,35
1683697330136,MUS 15,B01,186934,Staff,0,16,35,35
1683697331164,MUS 80,A00,186935,Staff,0,0,20,20
1683697331164,MUS 80,B00,186936,Staff,24,0,25,1
1683697332192,NANO 11,A00,204702,Lipomi; Darren John,0,0,0,0
1683697333222,NANO 15,A01,204709,Yang; Kesong,0,1,0,0
1683697334250,NANO 114,A00,202069,Jahed Motlagh; Zeinab,2,0,10,8
1683697335277,PHIL 1,A00,186955,Grush; Rick Scott,31,0,40,9
1683697336303,PHIL 10,A01,186973,Grush; Rick Scott,27,0,35,8
1683697336303,PHIL 10,A02,186974,Grush; Rick Scott,33,0,35,2
1683697337331,PHIL 13,A01,186976,Staff,1,0,35,34
1683697337331,PHIL 13,A02,186977,Staff,16,0,35,19
1683697338354,PHIL 14,A01,186979,Staff,31,0,35,4
1683697338354,PHIL 14,A02,186986,Staff,32,0,35,3
1683697339379,PHIL 28,A01,186988,Staff,16,0,30,14
1683697339379,PHIL 28,A02,186989,Staff,1,0,30,29
1683697339379,PHIL 28,A03,186990,Staff,10,0,30,20
1683697339379,PHIL 28,A04,186991,Staff,26,0,30,4
1683697340429,PHIL 120,A00,186997,Staff,23,0,40,17
1683697341457,PHIL 137,A00,187003,Staff,7,0,40,33
1683697342480,PHIL 150,A00,187015,Staff,47,0,70,23
1683697343504,PHIL 167,A00,187021,Lamey; Andy M.,34,0,40,6
1683697344529,PHIL 174,A01,202226,Staff,17,0,20,3
1683697344529,PHIL 174,A02,202235,Staff,20,0,20,0
1683697345554,PHIL 191A,A00,258918,Staff,0,0,1,1
1683697346580,PHYS 1A,A00,187028,Staff,26,0,60,34
1683697347608,PHYS 1AL,001,187036,Staff,3,0,30,27
1683697347608,PHYS 1AL,002,187049,Staff,18,0,30,12
1683697348633,PHYS 1B,A00,187058,Staff,22,0,60,38
1683697349658,PHYS 1BL,001,187064,Staff,0,1,30,30
1683697349658,PHYS 1BL,002,187070,Staff,4,0,30,26
1683697350680,PHYS 1C,A00,187082,Staff,29,0,120,91
1683697351709,PHYS 1CL,001,187088,Staff,0,9,30,30
1683697351709,PHYS 1CL,002,187089,Staff,0,1,30,30
1683697351709,PHYS 1CL,009,262693,Staff,9,0,30,21
1683697352733,PHYS 2B,A01,187097,Staff,55,0,115,60
1683697353757,PHYS 2C,A01,187099,Staff,63,0,115,52
1683697354786,PHYS 2CL,A01,187101,Staff,5,0,28,23
1683697354786,PHYS 2CL,A02,187102,Staff,15,0,28,13
1683697355814,PHYS 2D,A01,187123,Shotwell; Brian,95,0,115,20
1683697356913,PHYS 4B,A01,187133,Grinstein; Benjamin,35,0,50,15
1683697357937,POLI 10,A00,188819,Staff,0,4,50,50
1683697358960,POLI 11,A00,188827,Staff,43,0,50,7
1683697359984,POLI 13R,A00,188828,Staff,0,1,20,20
1683697361008,POLI 27,A01,188830,Elgin; Samuel Zincke,0,2,70,70
1683697362032,POLI 30,A00,188832,Desposato; Scott,30,0,50,20
1683697363056,POLI 102F,A00,188834,Staff,1,0,40,39
1683697364084,POLI 104A,A00,188852,Staff,12,0,30,18
1683697365108,POLI 104I,A00,188853,Staff,0,8,20,20
1683697366131,POLI 110B,A00,188854,Wiens; David,6,0,20,14
1683697367158,POLI 112A,A00,188855,Wiens; David,3,0,30,27
1683697368183,POLI 117R,A00,188856,Forman; Fonna,0,12,20,20
1683697369209,POLI 118,A00,188857,Ingham; Sean,8,0,20,12
1683697370236,POLI 120G,A00,188858,Staff,8,0,30,22
1683697371264,POLI 131CR,A00,188863,Hoston; Germaine,20,0,50,30
1683697372289,POLI 133,A00,188864,Nellis; Gareth Hb,44,0,50,6
1683697373313,POLI 134D,A00,188865,Desposato; Scott,27,0,30,3
1683697374337,POLI 142A,A00,188871,Gartzke; Erik,21,0,50,29
1683697375362,POLI 142K,A00,188874,Staff,38,0,50,12
1683697376390,POLI 143,A00,188940,Gartzke; Erik,16,0,30,14
1683697377414,POLI 153,A00,188943,Staff,2,0,20,18
1683697378441,POLI 160AA,A00,188944,Staff,10,0,40,30
1683697379466,POLI 170A,A00,188945,Staff,10,0,30,20
1683697381518,PSYC 1,A00,188952,Staff,36,0,90,54
1683697382545,PSYC 2,B00,188953,Staff,19,0,35,16
1683697383569,PSYC 6,A00,188970,Staff,47,0,60,13
1683697384594,PSYC 7,A00,188973,Staff,35,0,45,10
1683697385617,PSYC 60,A01,188980,Rickard; Timothy C.,42,0,60,18
1683697386645,PSYC 70,A01,189001,Steiner; Eric Tomas,21,0,45,24
1683697387671,PSYC 100,A00,189005,Lacefield; Katharine I,0,98,120,120
1683697388698,PSYC 102,A00,189008,Staff,6,0,30,24
1683697389730,PSYC 106,B00,189026,Gorman; Michael R.,27,0,60,33
1683697390754,PSYC 114,B01,189033,Winkielman; Piotr,0,31,30,30
1683697391781,PSYC 131,A00,189036,Anagnostaras; Stephan,0,44,60,60
1683697392808,PSYC 136,A00,189041,Lowe; Angela Beth,0,7,25,25
1683697393832,PSYC 137,A00,189057,Winkielman; Piotr,0,36,25,25
1683697394855,PSYC 144,A00,189107,Wixted; John T,0,11,50,50
1683697396908,PSYC 162,A00,189142,Staff,0,9,85,85
1683697397932,PSYC 172,A00,189144,Gorman; Michael R.,0,6,30,30
1683697399983,PSYC 179,A00,189146,Lacefield; Katharine I,0,88,120,120
1683697401008,PSYC 181,A00,189147,Anagnostaras; Stephan,0,45,90,90
1683697402033,PSYC 190R,A00,189148,Barner; David A.,0,23,80,80
1683697403057,PSYC 191,A00,189275,Rickard; Timothy C.,0,11,25,25
1683697404085,PSYC 193,A00,189276,Chapman; Eddie Nathaniel,0,1,0,4
1683697405114,PSYC 193L,A01,189281,Lowe; Angela Beth,8,0,20,12
1683697405114,PSYC 193L,B01,189285,Staff,28,0,35,7
1683697406138,RELI 149,A00,187137,Rahimi; Babak,6,0,40,34
1683697407166,SE 9,A01,187315,Staff,0,2,18,18
1683697408191,SE 101B,A00,187409,Staff,24,0,30,6
1683697409216,SE 110B,A00,187444,Staff,10,0,40,30
1683697410239,SE 130B,A00,187449,Staff,31,0,40,9
1683697411261,SE 150A,A00,187516,Staff,8,0,20,12
1683697412287,SE 154,A00,187528,Staff,29,0,50,21
1683697413313,SIO 3,A01,258171,Staff,35,0,40,5
1683697414340,SIO 10,A00,187144,Cook; Geoffrey W,0,6,75,75
1683697415364,SIO 45,A00,187152,Cook; Geoffrey W,0,7,100,100
1683697416390,SIO 109R,A00,194486,Staff,0,4,20,20
1683697418440,SIO 187,A01,187233,Kacev; David,12,0,40,28
1683697419464,SOCI 1,A01,258656,Thorpe; Charles Robert,28,0,30,2
1683697419464,SOCI 1,A02,258658,Thorpe; Charles Robert,30,0,30,0
1683697419464,SOCI 1,A03,258661,Thorpe; Charles Robert,25,0,25,0
1683697419464,SOCI 1,A04,258666,Thorpe; Charles Robert,22,0,25,3
1683697419464,SOCI 1,A05,258897,Thorpe; Charles Robert,22,0,25,3
1683697419464,SOCI 1,A06,258898,Thorpe; Charles Robert,25,0,25,0
1683697420488,SOCI 30,A01,258903,Pardo Guerra; Juan Pablo,14,0,30,16
1683697421516,SOCI 102,A00,258904,Staff,9,0,25,16
1683697422540,SOCI 106,A00,258905,Staff,19,0,25,6
1683697423563,SOCI 111,A00,258907,Ribas Norris; Janet Vanesa,26,0,30,4
1683697424589,SOCI 121R,A00,258908,Pardo Guerra; Juan Pablo,7,0,30,23
1683697425611,SOCI 126,A01,203330,Staff,14,0,20,6
1683697426635,SOCI 131,A00,258909,Thorpe; Charles Robert,30,0,60,30
1683697427664,SOCI 135,A00,258910,Payne; Christine Anna,0,13,30,30
1683697428696,SOCI 157,A00,258911,Staff,10,0,30,20
1683697429722,SOCI 184,A00,258912,Staff,25,0,30,5
1683697430752,SOCI 188D,A00,258913,Staff,22,0,30,8
1683697431778,SYN 2,001,187529,Staff,9,0,16,7
1683697431778,SYN 2,002,201452,Staff,0,20,16,16
1683697431778,SYN 2,003,201469,Staff,1,0,16,15
1683697432803,SYN 100,A01,187531,Staff,0,9,20,20
1683697432803,SYN 100,B01,201491,Staff,0,10,20,20
1683697433828,TDAC 1,A00,189286,Walsh; Kim C.,3,0,20,17
1683697433828,TDAC 1,B00,189287,Harting; Carla Kelso,10,0,20,10
1683697434851,TDAC 101,A00,189300,Walsh; Kim C.,16,0,20,4
1683697434851,TDAC 101,B00,189301,Harting; Carla Kelso,18,0,20,2
1683697435875,TDAC 102,A00,189304,Basso; Beatrice,14,0,20,6
1683697436900,TDAC 108,A00,189305,Staff,18,0,20,2
1683697437925,TDDE 131,A00,189310,Staff,19,0,20,1
1683697437925,TDDE 131,B00,189314,Staff,19,0,20,1
1683697437925,TDDE 131,C00,189315,Staff,48,0,50,2
1683697437925,TDDE 131,D00,189316,Staff,14,0,15,1
1683697437925,TDDE 131,E00,204841,Staff,20,0,20,0
1683697438948,TDGE 10,A00,189289,Staff,27,0,50,23
1683697438948,TDGE 10,B00,189290,Havis; Allan,0,1,50,50
1683697439971,TDGE 11,A00,189291,Fulton; Julia,0,4,50,50
1683697439971,TDGE 11,B00,189292,Staff,20,0,25,5
1683697439971,TDGE 11,C00,260270,Staff,0,0,0,0
1683697440999,TDGE 25,A00,189294,Staff,1,0,20,19
1683697442023,TDGE 124,A00,189318,Fulton; Julia,0,7,50,50
1683697443050,TDGE 125,A00,189319,Staff,13,0,25,12
1683697443050,TDGE 125,B00,189320,Staff,23,0,25,2
1683697444074,TDGE 127,A00,189322,Havis; Allan,0,0,50,50
1683697445101,TDHT 101,A00,189323,Staff,18,0,25,7
1683697445101,TDHT 101,B00,189324,Staff,25,0,25,0
1683697446127,TDHT 102,A00,189325,Staff,49,0,50,1
1683697447156,TDMV 1,A00,189295,Arcidiacono; Kristin,20,0,30,10
1683697447156,TDMV 1,B00,189296,Caligagan; Maria T.,24,0,30,6
1683697448184,TDMV 2,A00,189297,Sammartano; Tonnie,27,0,30,3
1683697448184,TDMV 2,B00,189299,Arcidiacono; Kristin,23,0,30,7
1683697449208,TDMV 3,A00,204998,Rincon; Alicia,22,0,30,8
1683697450234,TDMV 120,A00,189458,Sammartano; Tonnie,28,0,30,2
1683697451262,TDMV 138,A00,189541,Jun; Grace Shin Hae,20,0,40,20
1683697452289,TDMV 142,A00,189717,Caligagan; Tony,25,0,30,5
1683697452289,TDMV 142,B00,189718,Caligagan; Maria T.,25,0,30,5
1683697453313,TMC 2,A01,187533,Staff,25,0,25,0
1683697453313,TMC 2,A02,187534,Staff,25,0,25,0
1683697454338,USP 1,A01,187536,Kwak; Nancy,0,16,25,25
1683697455362,USP 5,A01,187538,Staff,8,0,25,17
1683697456389,USP 101,A00,199253,Staff,0,4,0,0
1683697457412,USP 124,A00,187562,Boomhower; Matthew Charles,0,0,30,30
1683697458437,USP 138,A00,187582,Staff,19,0,25,6
1683697459464,USP 152,A01,187597,Staff,3,0,25,22
1683697460542,USP 153,A00,187598,Staff,18,0,25,7
1683697461569,USP 168,A00,187607,Kwak; Nancy,2,0,5,3
1683697462592,USP 173,A00,187619,Staff,4,0,25,21
1683697463615,USP 181,A00,187638,Staff,0,4,25,25
1683697464638,VIS 103,A00,187650,Cruz; Edwin Teddy,17,0,75,58
1683697465664,VIS 110D,A00,187669,Staff,13,0,22,9
1683697466687,VIS 127C,A00,187720,Shen; Kuiyi,67,0,146,79
1683697467712,VIS 149,A00,187731,Yoldas; Pinar,0,12,22,22
1683697468736,VIS 151,A01,188091,Staff,22,0,34,12
1683697468736,VIS 151,A02,188092,Staff,11,0,34,23
1683697469760,VIS 160B,A00,188093,Stalbaum; Brett,0,1,10,10
1683697471815,WCWP 10B,A00,201720,Staff,0,0,5,5
1683697471815,WCWP 10B,B00,201722,Staff,0,0,6,6
1683697472839,WCWP 100,A00,201725,Gagnon; Jeffrey C,0,0,2,2
1683697472839,WCWP 100,B00,201727,Staff,0,4,15,15
1683697475928,ANBI 133,A00,258401,Wilder; Linnea Lorene,34,0,40,6
1683697476952,ANBI 140,A00,258395,Hrvoj Mihic; Branka,18,0,25,7
1683697477978,ANSC 120,A00,258402,Bialecki; Jon Anthony,26,0,40,14
1683697479005,ANSC 144,A00,258400,Staff,12,0,40,28
1683697481051,ANSC 166,A00,258396,Parish; Steven Martin,156,0,175,19
1683697482074,ANSC 180,A00,193533,Staff,8,0,20,12
1683697483098,ANSC 188,A00,258397,Jassal; Aftab,34,0,40,6
1683697484122,ANTH 3,A01,258316,Staff,23,0,30,7
1683697485146,ANTH 5,A00,258394,Semendeferi; Ekaterini,16,0,20,4
1683697486171,ANTH 21,A01,258331,Staff,4,0,40,36
1683697487196,ANTH 103,A00,258398,Varma; Saiba,15,0,25,10
1683697488227,AWP 10,001,202034,Staff,0,0,0,0
1683697488227,AWP 10,002,202035,Staff,0,0,0,0
1683697488227,AWP 10,003,202036,Staff,0,0,0,0
1683697488227,AWP 10,004,202037,Staff,0,0,0,0
1683697488227,AWP 10,005,202038,Staff,0,0,0,0
1683697488227,AWP 10,006,202039,Staff,0,0,0,0
1683697488227,AWP 10,007,202040,Staff,0,0,0,0
1683697488227,AWP 10,008,202041,Staff,0,0,0,0
1683697488227,AWP 10,009,202042,Staff,0,0,0,0
1683697488227,AWP 10,010,202043,Staff,0,0,0,0
1683697488227,AWP 10,011,202044,Staff,0,0,0,0
1683697488227,AWP 10,012,202045,Staff,0,0,0,0
1683697488227,AWP 10,013,202046,Staff,0,0,0,0
1683697488227,AWP 10,014,202047,Staff,0,0,0,0
1683697488227,AWP 10,015,202048,Staff,0,0,0,0
1683697488227,AWP 10,016,202049,Staff,0,0,0,0
1683697488227,AWP 10,017,202050,Staff,0,0,0,0
1683697488227,AWP 10,018,202051,Staff,0,0,0,0
1683697488227,AWP 10,019,202052,Staff,0,0,0,0
1683697488227,AWP 10,020,202053,Staff,0,0,0,0
1683697488227,AWP 10,021,202054,Staff,0,0,0,0
1683697488227,AWP 10,022,202055,Staff,0,0,0,0
1683697488227,AWP 10,023,202056,Staff,0,0,0,0
1683697488227,AWP 10,024,202057,Staff,0,0,0,0
1683697488227,AWP 10,025,202058,Staff,0,0,0,0
1683697488227,AWP 10,026,202059,Staff,0,0,0,0
1683697489253,AWP 102,001,202032,Staff,0,0,0,0
1683697489253,AWP 102,002,202033,Staff,0,0,0,0
1683697490278,BENG 100,A01,254234,Taylor Amos; Alyssa C,31,0,40,9
1683697491306,BENG 196,001,270013,Engler; Adam J.,9999,0,9999,0
1683697492335,BICD 100R,A01,202018,Smith; Laurie,0,7,32,32
1683697492335,BICD 100R,A02,202019,Smith; Laurie,0,3,32,32
1683697492335,BICD 100R,A03,202020,Smith; Laurie,0,1,32,32
1683697492335,BICD 100R,A04,202021,Smith; Laurie,6,0,32,26
1683697492335,BICD 100R,A05,202022,Smith; Laurie,10,0,32,22
1683697493359,BICD 136,A01,193242,Gustafson-Brown; Cindy,0,2,32,32
1683697493359,BICD 136,A02,193244,Gustafson-Brown; Cindy,13,0,32,19
1683697494384,BIEB 102,A01,193249,Butler; Shannon Rhey,0,0,32,32
1683697494384,BIEB 102,A02,193251,Butler; Shannon Rhey,0,0,32,32
1683697494384,BIEB 102,A03,193253,Butler; Shannon Rhey,0,0,32,32
1683697494384,BIEB 102,A04,193255,Butler; Shannon Rhey,13,0,32,19
1683697494384,BIEB 102,A05,193265,Butler; Shannon Rhey,25,0,32,7
1683697494384,BIEB 102,A06,193269,Butler; Shannon Rhey,12,0,32,20
1683697496434,BIEB 150,A01,193274,Staff,0,0,32,32
1683697496434,BIEB 150,A02,193285,Staff,24,0,32,8
1683697497458,BIEB 194,A00,193286,Kurle; Carolyn M.,19,0,32,13
1683697498486,BILD 1,A01,192291,Staff,15,0,32,17
1683697498486,BILD 1,A02,192292,Staff,30,0,32,2
1683697498486,BILD 1,B01,192520,Reuther; Keefe,0,1,0,0
1683697498486,BILD 1,B02,192532,Reuther; Keefe,0,1,0,0
1683697499512,BILD 3,A01,192556,Butler; Shannon Rhey,0,0,32,32
1683697499512,BILD 3,A02,192581,Butler; Shannon Rhey,0,1,32,32
1683697499512,BILD 3,A03,192611,Butler; Shannon Rhey,19,0,32,13
1683697499512,BILD 3,A04,192612,Butler; Shannon Rhey,23,0,32,9
1683697499512,BILD 3,A05,192613,Butler; Shannon Rhey,26,0,32,6
1683697499512,BILD 3,A06,192679,Butler; Shannon Rhey,27,0,32,5
1683697499512,BILD 3,A07,192682,Butler; Shannon Rhey,20,0,32,12
1683697500535,BILD 4,A01,192836,Reuther; Keefe,1,0,24,23
1683697500535,BILD 4,A02,193044,Reuther; Keefe,4,0,24,20
1683697501565,BILD 10,A01,193142,Gustafson-Brown; Cindy,29,0,32,3
1683697501565,BILD 10,A02,193149,Gustafson-Brown; Cindy,31,0,32,1
1683697502591,BIMM 100,A01,193301,Staff,0,6,32,32
1683697502591,BIMM 100,A02,193312,Staff,0,7,32,32
1683697502591,BIMM 100,A03,193323,Staff,0,10,32,32
1683697503618,BIMM 101,A01,193329,McDonnell; Lisa Marie,0,3,24,24
1683697503618,BIMM 101,A02,193339,McDonnell; Lisa Marie,0,3,24,24
1683697503618,BIMM 101,B01,193354,McDonnell; Lisa Marie,0,4,24,24
1683697503618,BIMM 101,B02,193357,McDonnell; Lisa Marie,0,3,24,24
1683697504645,BIMM 110,A01,193377,Tat; John,0,11,32,32
1683697504645,BIMM 110,A02,193378,Tat; John,0,11,32,32
1683697505669,BIMM 120,A01,206116,Staff,0,0,32,32
1683697505669,BIMM 120,A02,206117,Staff,7,0,32,25
1683697505669,BIMM 120,A03,206121,Staff,21,0,32,11
1683697506697,BIPN 100,A01,193393,Park; Ji Young,0,15,32,32
1683697506697,BIPN 100,A02,193402,Park; Ji Young,0,14,32,32
1683697506697,BIPN 100,A03,193413,Park; Ji Young,0,14,32,32
1683697506697,BIPN 100,A04,193414,Park; Ji Young,0,13,32,32
1683697507721,BIPN 102,A01,193429,Staff,0,0,32,32
1683697507721,BIPN 102,A02,193438,Staff,18,0,32,14
1683697508748,BIPN 106,A01,193450,Reyes Gonzalez; Catalina,0,2,40,40
1683697509778,BIPN 134,A01,193465,Cooke; James Edward,0,0,32,32
1683697509778,BIPN 134,A02,193474,Cooke; James Edward,25,0,32,7
1683697509778,BIPN 134,A03,193485,Cooke; James Edward,29,0,32,3
1683697509778,BIPN 134,A04,193486,Cooke; James Edward,20,0,32,12
1683697509778,BIPN 134,A05,193491,Cooke; James Edward,31,0,32,1
1683697509778,BIPN 134,A06,193501,Cooke; James Edward,30,0,32,2
1683697509778,BIPN 134,A07,193510,Cooke; James Edward,29,0,32,3
1683697511825,BISP 194,A00,222522,Staff,14,0,32,18
1683697512851,CAT 124,A01,202407,Staff,19,0,25,6
1683697513875,CAT 125,A00,202408,Marchisotto; Jennifer Anne,2,0,20,18
1683697514899,CAT 125R,A00,202409,Smith; Lauryn Alissa,0,11,20,20
1683697514899,CAT 125R,B00,202410,Morales; Celeste Georgianna,0,11,20,20
1683697514899,CAT 125R,C00,202411,Irwin; Matthew Joseph,0,12,20,20
1683697515924,CENG 15,A01,204712,Yang; Kesong,0,1,0,0
1683697516948,CENG 114,A00,202070,Jahed Motlagh; Zeinab,5,0,20,15
1683697517972,CGS 105,A00,185477,Wesling; Megan E.,24,0,40,16
1683697518996,CGS 106,A00,185494,Staff,11,0,22,11
1683697520020,CGS 108,A00,185495,Staff,14,0,20,6
1683697521044,CGS 114,A00,185496,Staff,13,0,18,5
1683697522068,CGS 119,A00,185501,Staff,15,0,20,5
1683697523094,CGS 120,A00,185511,Staff,12,0,20,8
1683697524122,CHEM 4,A01,184675,Bussey; Thomas J,97,0,100,3
1683697525149,CHEM 6A,A01,184677,Staff,32,0,60,28
1683697526175,CHEM 6B,A01,184679,Staff,63,0,100,37
1683697527206,CHEM 6C,A01,184681,Bussey; Thomas J,0,0,50,50
1683697527206,CHEM 6C,A02,184682,Bussey; Thomas J,32,0,50,18
1683697528229,CHEM 40A,A01,184684,Albizati; Kim F.,33,0,100,67
1683697529254,CHEM 40B,A01,184686,Albizati; Kim F.,0,22,100,100
1683697530281,CHEM 41B,A01,184690,Staff,51,0,100,49
1683697531313,COGS 3,A01,184715,Boyle; Mary E. T.,0,27,40,40
1683697532340,COGS 14B,A01,185172,Staff,0,14,38,38
1683697533367,COGS 18,A01,184736,Staff,14,0,80,66
1683697534393,COGS 100,A01,184932,Staff,0,8,73,73
1683697535418,COGS 101A,A01,184935,Staff,0,40,30,30
1683697536441,COGS 101B,A01,184944,Staff,0,2,30,30
1683697537467,COGS 101C,A01,184946,Staff,0,10,30,30
1683697538492,COGS 102A,A01,184951,Johnson; Christine M.,1,0,40,39
1683697539515,COGS 107B,A01,184953,Mooshagian; Eric Frederick,0,52,40,40
1683697540542,COGS 118B,A01,184959,Gupta; Anjum,0,50,40,40
1683697541566,COGS 153,A00,184961,Staff,1,16,30,29
1683697542590,COGS 177,A00,184962,Staff,0,20,30,30
1683697543618,COGS 187A,A01,184969,Boyle; Mary E. T.,0,19,40,40
1683697544643,COMM 10,A01,185174,Staff,0,5,25,25
1683697544643,COMM 10,A02,185189,Staff,0,2,25,25
1683697544643,COMM 10,A03,269821,Staff,0,1,0,0
1683697545671,COMM 100B,A02,185476,Staff,10,0,25,15
1683697545671,COMM 100B,A03,277340,Staff,25,0,25,0
1683697546700,COMM 100C,A01,185314,Staff,2,0,25,23
1683697546700,COMM 100C,A02,185327,Staff,17,0,25,8
1683697547728,COMM 110M,A00,185349,Staff,0,0,40,40
1683697548753,COMM 113T,A00,185352,Staff,25,0,40,15
1683697549777,COMM 114I,A00,185353,Staff,31,0,40,9
1683697550801,COMM 131,A00,185354,Staff,17,0,30,13
1683697551830,CSE 8A,A50,185358,Cao; Yingjun,0,46,10,10
1683697552854,CSE 8B,A01,185362,Staff,0,48,50,50
1683697553883,CSE 11,A01,185416,Cao; Yingjun,0,91,10,10
1683697554912,CSE 20,A01,185445,Briones; Jor-el Thomas Caparas,3,0,25,22
1683697555939,CSE 21,A01,185447,Staff,9,0,50,41
1683697556968,CSE 101,A01,185451,Staff,0,13,50,50
1683697556968,CSE 101,B01,185453,Jones; Miles E,0,14,50,50
1683697559020,CSE 141,A01,185458,Eldon; John,16,0,100,84
1683697560045,CSE 141L,A01,185461,Eldon; John,8,0,100,92
1683697561082,CSE 142,A01,185463,Staff,34,0,60,26
1683697561082,CSE 142,B01,201355,Staff,0,7,60,60
1683697562108,CSE 142L,A01,185470,Staff,34,0,60,26
1683697562108,CSE 142L,B01,201417,Staff,0,6,60,60
1683697563134,CSE 190,A00,201433,Staff,32,0,49,17
1683697564216,DOC 1,A01,259136,Strom; Megan C.,7,0,15,8
1683697564216,DOC 1,A02,259137,Strom; Megan C.,14,0,15,1
1683697564216,DOC 1,A03,259138,Strom; Megan C.,14,0,15,1
1683697564216,DOC 1,A04,259139,Strom; Megan C.,14,0,15,1
1683697565244,DOC 100D,A00,259140,Pass; Natalye Joann,14,0,25,11
1683697566273,DSGN 1,A01,184749,Rill; Bryan,0,26,30,30
1683697567301,DSGN 100,A01,185168,Staff,0,2,25,25
1683697568329,ECE 5,A01,185626,Morris; Karcher William,0,12,0,0
1683697569353,ECE 101,A01,185628,Staff,14,0,70,56
1683697570376,ECE 107,A01,185635,Baghdadchi; Saharnaz,0,0,20,20
1683697570376,ECE 107,A02,185638,Baghdadchi; Saharnaz,1,0,20,19
1683697571408,ECE 148,A01,185647,Silberman; Jack,0,0,16,16
1683697572433,ECON 1,A01,185537,Crane; Meredith Helen,54,0,70,16
1683697573456,ECON 3,A01,185549,Crane; Meredith Helen,30,0,70,40
1683697574483,ECON 4,A01,203354,Anderson; John Charles,0,5,10,10
1683697575510,ECON 100A,A01,185574,Staff,0,5,40,40
1683697576533,ECON 100B,A01,185576,Staff,0,12,50,50
1683697577557,ECON 100C,A01,185589,Newhouse; Herbert S,30,0,70,40
1683697578582,ECON 105,A00,185608,Vespa; Emanuel Ignacio,19,0,35,16
1683697579611,ECON 109,A01,185610,Shishkin; Denis,9,0,35,26
1683697580635,ECON 110A,A01,185612,Staff,8,0,40,32
1683697581663,ECON 120A,A01,185615,Staff,19,0,40,21
1683697582691,ECON 120C,A01,185617,Sun; Yixiao,0,21,70,70
1683697583714,ECON 144,A00,203346,Squires; Dale E,2,0,35,33
1683697584738,ECON 171,A01,203349,Newhouse; Herbert S,0,1,35,35
1683697585766,ECON 173A,A01,185621,Toda; Alexis Akira,21,0,35,14
1683697586796,EDS 25,A01,202413,Staff,0,1,0,0
1683697586796,EDS 25,A02,202414,Staff,0,1,0,0
1683697586796,EDS 25,A03,202415,Staff,0,0,0,0
1683697586796,EDS 25,A04,202416,Staff,0,1,0,0
1683697586796,EDS 25,A05,202439,Staff,0,0,0,0
1683697586796,EDS 25,A06,202440,Staff,0,0,0,0
1683697586796,EDS 25,B01,202631,Staff,0,0,0,0
1683697586796,EDS 25,B02,202632,Staff,0,0,0,0
1683697586796,EDS 25,B03,202639,Staff,0,0,0,0
1683697586796,EDS 25,B04,202640,Staff,0,0,0,0
1683697586796,EDS 25,B05,202643,Staff,0,0,0,0
1683697586796,EDS 25,B06,202644,Staff,0,0,0,0
1683697587820,EDS 38,A01,202659,Black; Alison Michelle,24,0,25,1
1683697588848,EDS 115,A00,202652,Staff,18,0,30,12
1683697589875,EDS 125,A00,202649,Staff,13,0,30,17
1683697590902,EDS 126,A01,203332,Staff,30,0,30,0
1683697591927,EDS 139,A00,202838,Staff,16,0,25,9
1683697592952,EDS 146,A01,202655,Staff,14,0,25,11
1683697593976,ENG 15,A00,185667,Staff,0,1,0,0
1683697593976,ENG 15,B00,185672,Staff,0,0,0,0
1683697593976,ENG 15,C00,185675,Staff,0,0,0,0
1683697593976,ENG 15,D00,185682,Staff,0,0,0,0
1683697593976,ENG 15,E00,185684,Staff,0,0,0,0
1683697594999,ETHN 103,A00,185710,Staff,0,8,35,35
1683697596023,ETHN 103A,A00,199228,Man; Simeon S,0,0,9,9
1683697597048,ETHN 109,A00,185711,Staff,15,0,35,20
1683697598072,ETHN 142,A00,185726,Staff,0,4,30,30
1683697599097,ETHN 163J,A00,199229,Man; Simeon S,5,0,8,3
1683697600121,ETHN 168,A00,185727,Staff,7,0,10,3
1683697601146,ETHN 182,A00,185728,Staff,0,0,35,35
1683697602168,ETHN 183,A00,185737,Staff,9,0,18,9
1683697603193,GLBH 111,A01,209361,Burgos; Jose L.,0,0,0,0
1683697605243,HIEU 104,A00,185792,Staff,14,0,20,6
1683697606271,HIEU 115,A00,185800,Staff,0,0,20,20
1683697607295,HIEU 128,A00,185801,Staff,0,9,20,20
1683697608319,HIEU 147,A00,185802,Staff,15,0,20,5
1683697609342,HIEU 154,A00,185823,Staff,11,0,20,9
1683697610366,HILA 102,A00,185826,Staff,14,0,20,6
1683697611394,HILD 2C,A01,185778,Staff,0,13,20,20
1683697612417,HILD 7B,A01,185780,Kwak; Nancy,0,17,32,32
1683697612417,HILD 7B,A02,185781,Kwak; Nancy,0,18,32,32
1683697613441,HILD 30,A01,185791,Staff,12,0,20,8
1683697614466,HISC 119,A00,185830,Golan; Tal,0,10,20,20
1683697615490,HITO 156GS,A00,185831,Patterson; Patrick H.,0,0,0,23
1683697616517,HIUS 103,A00,185832,Man; Simeon S,0,4,20,20
1683697617544,HIUS 117,A00,185836,Kwak; Nancy,2,0,20,18
1683697618568,HIUS 125,A00,185840,Man; Simeon S,0,2,23,23
1683697619594,HIUS 149,A00,185845,Staff,1,0,20,19
1683697620620,HUM 3,A01,185882,Zavodny; Tatiana Sophia,0,8,50,50
1683697620620,HUM 3,B01,185899,Caldwell; Michael Alan,0,18,50,50
1683697621649,HUM 3GS,A00,185900,Patterson; Patrick H.,0,0,0,23
1683697622675,HUM 4,A01,185938,Zroka; Amy Liane,28,0,50,22
1683697622675,HUM 4,B01,185956,Watkins; Eric,0,6,50,50
1683697622675,HUM 4,B02,202209,Watkins; Eric,0,5,50,50
1683697622675,HUM 4,B03,202210,Watkins; Eric,0,5,50,50
1683697623705,HUM 5,A01,185958,West; Geoffrey Scott,0,0,50,50
1683697623705,HUM 5,A02,202215,West; Geoffrey Scott,0,1,50,50
1683697624729,INTL 190,A00,185959,Gagnon; Jeffrey C,0,0,0,9
1683697624729,INTL 190,B00,185960,Lettieri; Michael Joseph,0,0,0,2
1683697625752,JAPN 180,A00,254509,Staff,5,0,30,25
1683697626778,LATI 10,A01,202853,Kennemore; Amy Michelle,4,0,35,31
1683697626778,LATI 10,A02,202854,Kennemore; Amy Michelle,3,0,35,32
1683697626778,LATI 10,A03,270054,Kennemore; Amy Michelle,30,0,30,0
1683697627809,LATI 180,A00,202855,Kennemore; Amy Michelle,11,0,20,9
1683697628833,LAWS 101,A00,201767,Golan; Tal,0,7,40,40
1683697629861,LIFR 1C,A00,185961,Staff,6,0,20,14
1683697630887,LIFR 1CX,A00,185962,Staff,7,0,20,13
1683697631914,LIFR 1D,A00,185963,Staff,7,0,20,13
1683697632941,LIFR 1DX,A00,185964,Staff,7,0,20,13
1683697633965,LIGN 101,A01,186039,Staff,43,0,50,7
1683697634990,LIGN 165,A00,186040,Staff,15,0,50,35
1683697636017,LTCS 108,A00,186041,Staff,5,0,10,5
1683697637044,LTCS 119,A00,186042,Staff,15,0,20,5
1683697638067,LTCS 130,A00,186043,Wesling; Megan E.,15,0,25,10
1683697640116,LTEA 138,A00,186119,Staff,14,0,40,26
1683697641139,LTEN 124,A00,186148,Staff,5,0,25,20
1683697642165,LTEN 178,A00,186149,Staff,6,0,15,9
1683697643191,LTEN 181,A00,186150,Blanco; John D,34,0,40,6
1683697644218,LTWL 120,A00,186160,Staff,19,0,25,6
1683697645246,LTWL 165,A00,186161,Staff,22,0,25,3
1683697646271,LTWR 100,A00,186162,Staff,0,5,15,15
1683697647296,LTWR 102,A00,186163,Doller; Ben,5,0,15,10
1683697648319,MAE 8,A01,186412,Staff,0,1,0,0
1683697649343,MAE 30B,A00,186445,Bahadori; Mohammad Yousef,81,0,100,19
1683697650368,MAE 40,A00,186592,Bewley; Thomas R,10,0,50,40
1683697651394,MAE 101B,A00,186593,Bahadori; Mohammad Yousef,80,0,100,20
1683697652420,MAE 105,A00,186594,Bandaru; Prabhakar,10,0,50,40
1683697653445,MAE 107,A00,186599,Pham; Hieu Tan,0,8,120,120
1683697654468,MAE 148,A01,186660,Silberman; Jack,3,0,16,13
1683697655495,MATH 10A,A01,188095,Staff,0,6,35,35
1683697656524,MATH 10B,A01,188097,Bowers; Adam R.,0,12,30,30
1683697656524,MATH 10B,A02,188099,Bowers; Adam R.,0,11,30,30
1683697656524,MATH 10B,B01,188104,Bowers; Adam R.,0,10,30,30
1683697656524,MATH 10B,B02,188106,Bowers; Adam R.,0,9,30,30
1683697657549,MATH 10C,A01,188111,Staff,0,20,30,30
1683697657549,MATH 10C,A02,188127,Staff,0,19,30,30
1683697657549,MATH 10C,A03,188131,Staff,0,19,30,30
1683697657549,MATH 10C,B01,188218,Staff,17,0,30,13
1683697657549,MATH 10C,B02,188244,Staff,13,0,30,17
1683697657549,MATH 10C,B03,188277,Staff,14,0,30,16
1683697658574,MATH 18,A01,188344,Bach; Quang Tran,18,0,30,12
1683697658574,MATH 18,A02,188345,Bach; Quang Tran,11,0,30,19
1683697658574,MATH 18,B01,188353,Bach; Quang Tran,11,0,30,19
1683697658574,MATH 18,B02,188354,Bach; Quang Tran,19,0,30,11
1683697659601,MATH 20A,A01,188374,Staff,11,0,35,24
1683697660630,MATH 20B,A01,188382,Ohm; Ko Woon,7,0,30,23
1683697660630,MATH 20B,A02,188383,Ohm; Ko Woon,22,0,30,8
1683697660630,MATH 20B,B01,188385,Ohm; Ko Woon,7,0,30,23
1683697660630,MATH 20B,B02,188392,Ohm; Ko Woon,22,0,30,8
1683697661655,MATH 20C,A01,188394,Harel; Guershon,10,0,30,20
1683697661655,MATH 20C,A02,188395,Harel; Guershon,13,0,30,17
1683697661655,MATH 20C,B01,188404,Harel; Guershon,5,0,30,25
1683697661655,MATH 20C,B02,188405,Harel; Guershon,18,0,30,12
1683697662685,MATH 20D,A01,188414,Hammock; Frances H,0,1,30,30
1683697662685,MATH 20D,A02,188415,Hammock; Frances H,0,1,30,30
1683697662685,MATH 20D,B01,188447,Hammock; Frances H,0,1,30,30
1683697662685,MATH 20D,B02,188486,Hammock; Frances H,2,0,30,28
1683697663710,MATH 20E,A01,188649,Staff,21,0,30,9
1683697663710,MATH 20E,A02,188650,Staff,20,0,30,10
1683697663710,MATH 20E,A03,188673,Staff,0,0,30,30
1683697664736,MATH 102,A01,188675,Staff,0,40,35,35
1683697665761,MATH 103B,A01,188681,Staff,3,0,35,32
1683697665761,MATH 103B,B01,188692,Staff,5,0,35,30
1683697666786,MATH 109,A01,188695,Salehi Golsefidy; Alireza,24,0,35,11
1683697666786,MATH 109,A02,188696,Salehi Golsefidy; Alireza,25,0,35,10
1683697667866,MATH 120A,A01,188698,Eggers; John Dietrich,7,0,35,28
1683697668895,MATH 142B,A01,188736,Ioana; Adrian,0,0,30,30
1683697668895,MATH 142B,A02,188741,Ioana; Adrian,0,1,30,30
1683697668895,MATH 142B,A03,188743,Ioana; Adrian,0,2,30,30
1683697669920,MATH 168A,A01,188790,Staff,0,11,35,35
1683697670945,MATH 170A,A01,188803,Nie; Jiawang,0,2,35,35
1683697670945,MATH 170A,A02,188811,Nie; Jiawang,0,1,35,35
1683697670945,MATH 170A,A03,188814,Nie; Jiawang,0,0,35,35
1683697670945,MATH 170A,A04,188815,Nie; Jiawang,5,0,35,30
1683697671970,MATH 193B,A01,188817,Staff,0,0,35,35
1683697671970,MATH 193B,A02,188818,Staff,6,0,35,29
1683697672998,MGT 4,A01,202857,Anderson; John Charles,59,0,80,21
1683697674025,MGT 12,A00,202858,Lindenberger; Wade Douglas,40,0,90,50
1683697675049,MGT 18,A00,202859,Staff,74,0,90,16
1683697676074,MGT 18GS,A00,202860,McKay; Michael J,13,0,28,15
1683697677097,MGT 45,A00,202861,Pecore; Joseph P.,8,0,90,82
1683697678120,MGT 100,A00,202863,Yavorsky; Daniel Ryan,27,0,90,63
1683697679146,MGT 103,A00,202864,Ehrich; Kristine R,0,19,90,90
1683697680171,MGT 112,A00,202865,Ehrich; Kristine R,15,0,90,75
1683697681194,MGT 121A,A00,202868,Staff,70,0,90,20
1683697682219,MGT 131B,A00,202869,Anderson; John Charles,58,0,90,32
1683697683243,MGT 136,A00,202871,Lindenberger; Wade Douglas,83,0,90,7
1683697684269,MGT 164,A00,202873,Staff,0,67,90,91
1683697685293,MGT 164GS,A00,202874,McKay; Mary A,13,0,28,15
1683697686321,MGT 180,A00,202875,Staff,0,51,90,91
1683697687348,MMW 11R,A01,205019,Herbst; Matthew,0,0,30,30
1683697687348,MMW 11R,A02,205026,Herbst; Matthew,29,0,30,1
1683697688373,MMW 15,A01,193512,Chang; Edmond Yi-Teh,0,8,28,28
1683697688373,MMW 15,A02,193513,Chang; Edmond Yi-Teh,0,5,28,28
1683697688373,MMW 15,A03,193514,Chang; Edmond Yi-Teh,0,5,28,28
1683697688373,MMW 15,A04,193515,Chang; Edmond Yi-Teh,0,5,28,28
1683697688373,MMW 15,A05,193516,Chang; Edmond Yi-Teh,0,5,28,28
1683697688373,MMW 15,A06,193517,Chang; Edmond Yi-Teh,0,6,28,28
1683697688373,MMW 15,B01,193519,Chang; Edmond Yi-Teh,0,5,28,28
1683697688373,MMW 15,B02,193520,Chang; Edmond Yi-Teh,0,5,28,28
1683697688373,MMW 15,B03,193521,Chang; Edmond Yi-Teh,0,5,28,28
1683697688373,MMW 15,B04,193522,Chang; Edmond Yi-Teh,0,6,28,28
1683697688373,MMW 15,B05,193523,Chang; Edmond Yi-Teh,0,5,28,28
1683697688373,MMW 15,B06,193524,Chang; Edmond Yi-Teh,0,5,28,28
1683697689401,MMW 122,A01,193526,Rahimi; Babak,0,16,28,28
1683697689401,MMW 122,A02,193527,Rahimi; Babak,0,15,28,28
1683697689401,MMW 122,A03,193528,Rahimi; Babak,0,0,0,0
1683697689401,MMW 122,A04,193529,Rahimi; Babak,0,0,0,0
1683697690428,MUS 1A,A01,186663,Staff,0,18,35,35
1683697691455,MUS 4,A01,186715,Staff,0,12,35,35
1683697692482,MUS 5R,A01,186796,Dubnov; Shlomo,0,17,35,35
1683697693510,MUS 6,A01,186798,Staff,0,4,25,25
1683697694537,MUS 7,A01,186830,Staff,11,0,35,24
1683697695562,MUS 8,A01,186930,Staff,0,27,35,35
1683697696589,MUS 15,A01,186932,Staff,0,15,35,35
1683697696589,MUS 15,B01,186934,Staff,0,16,35,35
1683697697614,MUS 80,A00,186935,Staff,0,0,20,20
1683697697614,MUS 80,B00,186936,Staff,24,0,25,1
1683697698639,NANO 11,A00,204702,Lipomi; Darren John,0,0,0,0
1683697699664,NANO 15,A01,204709,Yang; Kesong,0,1,0,0
1683697700693,NANO 114,A00,202069,Jahed Motlagh; Zeinab,2,0,10,8
1683697701715,PHIL 1,A00,186955,Grush; Rick Scott,31,0,40,9
1683697702740,PHIL 10,A01,186973,Grush; Rick Scott,27,0,35,8
1683697702740,PHIL 10,A02,186974,Grush; Rick Scott,33,0,35,2
1683697703768,PHIL 13,A01,186976,Staff,1,0,35,34
1683697703768,PHIL 13,A02,186977,Staff,16,0,35,19
1683697704793,PHIL 14,A01,186979,Staff,31,0,35,4
1683697704793,PHIL 14,A02,186986,Staff,32,0,35,3
1683697705819,PHIL 28,A01,186988,Staff,16,0,30,14
1683697705819,PHIL 28,A02,186989,Staff,1,0,30,29
1683697705819,PHIL 28,A03,186990,Staff,10,0,30,20
1683697705819,PHIL 28,A04,186991,Staff,26,0,30,4
1683697706846,PHIL 120,A00,186997,Staff,23,0,40,17
1683697707871,PHIL 137,A00,187003,Staff,7,0,40,33
1683697708895,PHIL 150,A00,187015,Staff,47,0,70,23
1683697709919,PHIL 167,A00,187021,Lamey; Andy M.,34,0,40,6
1683697710945,PHIL 174,A01,202226,Staff,17,0,20,3
1683697710945,PHIL 174,A02,202235,Staff,20,0,20,0
1683697711970,PHIL 191A,A00,258918,Staff,0,0,1,1
1683697712997,PHYS 1A,A00,187028,Staff,26,0,60,34
1683697714023,PHYS 1AL,001,187036,Staff,3,0,30,27
1683697714023,PHYS 1AL,002,187049,Staff,18,0,30,12
1683697715048,PHYS 1B,A00,187058,Staff,22,0,60,38
1683697716076,PHYS 1BL,001,187064,Staff,0,1,30,30
1683697716076,PHYS 1BL,002,187070,Staff,4,0,30,26
1683697717100,PHYS 1C,A00,187082,Staff,29,0,120,91
1683697718125,PHYS 1CL,001,187088,Staff,0,9,30,30
1683697718125,PHYS 1CL,002,187089,Staff,0,1,30,30
1683697718125,PHYS 1CL,009,262693,Staff,9,0,30,21
1683697719150,PHYS 2B,A01,187097,Staff,55,0,115,60
1683697720178,PHYS 2C,A01,187099,Staff,63,0,115,52
1683697721203,PHYS 2CL,A01,187101,Staff,5,0,28,23
1683697721203,PHYS 2CL,A02,187102,Staff,15,0,28,13
1683697722229,PHYS 2D,A01,187123,Shotwell; Brian,95,0,115,20
1683697723256,PHYS 4B,A01,187133,Grinstein; Benjamin,35,0,50,15
1683697724281,POLI 10,A00,188819,Staff,0,4,50,50
1683697725307,POLI 11,A00,188827,Staff,43,0,50,7
1683697726330,POLI 13R,A00,188828,Staff,0,1,20,20
1683697727358,POLI 27,A01,188830,Elgin; Samuel Zincke,0,2,70,70
1683697728383,POLI 30,A00,188832,Desposato; Scott,30,0,50,20
1683697729407,POLI 102F,A00,188834,Staff,1,0,40,39
1683697730431,POLI 104A,A00,188852,Staff,12,0,30,18
1683697731458,POLI 104I,A00,188853,Staff,0,8,20,20
1683697732482,POLI 110B,A00,188854,Wiens; David,6,0,20,14
1683697733506,POLI 112A,A00,188855,Wiens; David,3,0,30,27
1683697734530,POLI 117R,A00,188856,Forman; Fonna,0,12,20,20
1683697735557,POLI 118,A00,188857,Ingham; Sean,8,0,20,12
1683697736584,POLI 120G,A00,188858,Staff,8,0,30,22
1683697737611,POLI 131CR,A00,188863,Hoston; Germaine,20,0,50,30
1683697738639,POLI 133,A00,188864,Nellis; Gareth Hb,44,0,50,6
1683697739666,POLI 134D,A00,188865,Desposato; Scott,27,0,30,3
1683697740693,POLI 142A,A00,188871,Gartzke; Erik,21,0,50,29
1683697741721,POLI 142K,A00,188874,Staff,38,0,50,12
1683697742745,POLI 143,A00,188940,Gartzke; Erik,16,0,30,14
1683697743770,POLI 153,A00,188943,Staff,2,0,20,18
1683697744797,POLI 160AA,A00,188944,Staff,10,0,40,30
1683697745825,POLI 170A,A00,188945,Staff,10,0,30,20
1683697747873,PSYC 1,A00,188952,Staff,36,0,90,54
1683697748900,PSYC 2,B00,188953,Staff,19,0,35,16
1683697749924,PSYC 6,A00,188970,Staff,47,0,60,13
1683697750952,PSYC 7,A00,188973,Staff,35,0,45,10
1683697751981,PSYC 60,A01,188980,Rickard; Timothy C.,42,0,60,18
1683697753004,PSYC 70,A01,189001,Steiner; Eric Tomas,21,0,45,24
1683697754029,PSYC 100,A00,189005,Lacefield; Katharine I,0,98,120,120
1683697755053,PSYC 102,A00,189008,Staff,6,0,30,24
1683697756082,PSYC 106,B00,189026,Gorman; Michael R.,27,0,60,33
1683697757108,PSYC 114,B01,189033,Winkielman; Piotr,0,31,30,30
1683697758134,PSYC 131,A00,189036,Anagnostaras; Stephan,0,44,60,60
1683697759160,PSYC 136,A00,189041,Lowe; Angela Beth,0,7,25,25
1683697760187,PSYC 137,A00,189057,Winkielman; Piotr,0,36,25,25
1683697761214,PSYC 144,A00,189107,Wixted; John T,0,11,50,50
1683697763263,PSYC 162,A00,189142,Staff,0,9,85,85
1683697764289,PSYC 172,A00,189144,Gorman; Michael R.,0,6,30,30
1683697766341,PSYC 179,A00,189146,Lacefield; Katharine I,0,88,120,120
1683697767365,PSYC 181,A00,189147,Anagnostaras; Stephan,0,45,90,90
1683697768391,PSYC 190R,A00,189148,Barner; David A.,0,23,80,80
1683697769419,PSYC 191,A00,189275,Rickard; Timothy C.,0,11,25,25
1683697770446,PSYC 193,A00,189276,Chapman; Eddie Nathaniel,0,1,0,4
1683697771530,PSYC 193L,A01,189281,Lowe; Angela Beth,8,0,20,12
1683697771530,PSYC 193L,B01,189285,Staff,28,0,35,7
1683697772557,RELI 149,A00,187137,Rahimi; Babak,6,0,40,34
1683697773581,SE 9,A01,187315,Staff,0,2,18,18
1683697774608,SE 101B,A00,187409,Staff,24,0,30,6
1683697775632,SE 110B,A00,187444,Staff,10,0,40,30
1683697776657,SE 130B,A00,187449,Staff,31,0,40,9
1683697777682,SE 150A,A00,187516,Staff,8,0,20,12
1683697778706,SE 154,A00,187528,Staff,29,0,50,21
1683697779730,SIO 3,A01,258171,Staff,35,0,40,5
1683697780754,SIO 10,A00,187144,Cook; Geoffrey W,0,6,75,75
1683697781781,SIO 45,A00,187152,Cook; Geoffrey W,0,7,100,100
1683697782805,SIO 109R,A00,194486,Staff,0,4,20,20
1683697784861,SIO 187,A01,187233,Kacev; David,12,0,40,28
1683697785885,SOCI 1,A01,258656,Thorpe; Charles Robert,28,0,30,2
1683697785885,SOCI 1,A02,258658,Thorpe; Charles Robert,30,0,30,0
1683697785885,SOCI 1,A03,258661,Thorpe; Charles Robert,25,0,25,0
1683697785885,SOCI 1,A04,258666,Thorpe; Charles Robert,22,0,25,3
1683697785885,SOCI 1,A05,258897,Thorpe; Charles Robert,22,0,25,3
1683697785885,SOCI 1,A06,258898,Thorpe; Charles Robert,25,0,25,0
1683697786909,SOCI 30,A01,258903,Pardo Guerra; Juan Pablo,14,0,30,16
1683697787931,SOCI 102,A00,258904,Staff,9,0,25,16
1683697788956,SOCI 106,A00,258905,Staff,19,0,25,6
1683697789980,SOCI 111,A00,258907,Ribas Norris; Janet Vanesa,26,0,30,4
1683697791003,SOCI 121R,A00,258908,Pardo Guerra; Juan Pablo,7,0,30,23
1683697792029,SOCI 126,A01,203330,Staff,14,0,20,6
1683697793053,SOCI 131,A00,258909,Thorpe; Charles Robert,30,0,60,30
1683697794077,SOCI 135,A00,258910,Payne; Christine Anna,0,13,30,30
1683697795100,SOCI 157,A00,258911,Staff,10,0,30,20
1683697796125,SOCI 184,A00,258912,Staff,25,0,30,5
1683697797149,SOCI 188D,A00,258913,Staff,22,0,30,8
1683697798172,SYN 2,001,187529,Staff,9,0,16,7
1683697798172,SYN 2,002,201452,Staff,0,20,16,16
1683697798172,SYN 2,003,201469,Staff,1,0,16,15
1683697799199,SYN 100,A01,187531,Staff,0,9,20,20
1683697799199,SYN 100,B01,201491,Staff,0,10,20,20
1683697800223,TDAC 1,A00,189286,Walsh; Kim C.,3,0,20,17
1683697800223,TDAC 1,B00,189287,Harting; Carla Kelso,10,0,20,10
1683697801250,TDAC 101,A00,189300,Walsh; Kim C.,16,0,20,4
1683697801250,TDAC 101,B00,189301,Harting; Carla Kelso,18,0,20,2
1683697802274,TDAC 102,A00,189304,Basso; Beatrice,14,0,20,6
1683697803303,TDAC 108,A00,189305,Staff,18,0,20,2
1683697804328,TDDE 131,A00,189310,Staff,19,0,20,1
1683697804328,TDDE 131,B00,189314,Staff,19,0,20,1
1683697804328,TDDE 131,C00,189315,Staff,48,0,50,2
1683697804328,TDDE 131,D00,189316,Staff,14,0,15,1
1683697804328,TDDE 131,E00,204841,Staff,20,0,20,0
1683697805352,TDGE 10,A00,189289,Staff,27,0,50,23
1683697805352,TDGE 10,B00,189290,Havis; Allan,0,1,50,50
1683697806381,TDGE 11,A00,189291,Fulton; Julia,0,4,50,50
1683697806381,TDGE 11,B00,189292,Staff,20,0,25,5
1683697806381,TDGE 11,C00,260270,Staff,0,0,0,0
1683697807407,TDGE 25,A00,189294,Staff,1,0,20,19
1683697808431,TDGE 124,A00,189318,Fulton; Julia,0,7,50,50
1683697809459,TDGE 125,A00,189319,Staff,13,0,25,12
1683697809459,TDGE 125,B00,189320,Staff,23,0,25,2
1683697810484,TDGE 127,A00,189322,Havis; Allan,0,0,50,50
1683697811509,TDHT 101,A00,189323,Staff,18,0,25,7
1683697811509,TDHT 101,B00,189324,Staff,25,0,25,0
1683697812532,TDHT 102,A00,189325,Staff,49,0,50,1
1683697813557,TDMV 1,A00,189295,Arcidiacono; Kristin,20,0,30,10
1683697813557,TDMV 1,B00,189296,Caligagan; Maria T.,24,0,30,6
1683697814581,TDMV 2,A00,189297,Sammartano; Tonnie,27,0,30,3
1683697814581,TDMV 2,B00,189299,Arcidiacono; Kristin,23,0,30,7
1683697815608,TDMV 3,A00,204998,Rincon; Alicia,22,0,30,8
1683697816632,TDMV 120,A00,189458,Sammartano; Tonnie,28,0,30,2
1683697817656,TDMV 138,A00,189541,Jun; Grace Shin Hae,20,0,40,20
1683697818683,TDMV 142,A00,189717,Caligagan; Tony,25,0,30,5
1683697818683,TDMV 142,B00,189718,Caligagan; Maria T.,25,0,30,5
1683697819710,TMC 2,A01,187533,Staff,25,0,25,0
1683697819710,TMC 2,A02,187534,Staff,25,0,25,0
1683697820737,USP 1,A01,187536,Kwak; Nancy,0,16,25,25
1683697821762,USP 5,A01,187538,Staff,8,0,25,17
1683697822785,USP 101,A00,199253,Staff,0,4,0,0
1683697823813,USP 124,A00,187562,Boomhower; Matthew Charles,0,0,30,30
1683697824837,USP 138,A00,187582,Staff,19,0,25,6
1683697825863,USP 152,A01,187597,Staff,3,0,25,22
1683697826888,USP 153,A00,187598,Staff,18,0,25,7
1683697827912,USP 168,A00,187607,Kwak; Nancy,2,0,5,3
1683697828936,USP 173,A00,187619,Staff,4,0,25,21
1683697829960,USP 181,A00,187638,Staff,0,4,25,25
1683697830986,VIS 103,A00,187650,Cruz; Edwin Teddy,17,0,75,58
1683697832010,VIS 110D,A00,187669,Staff,13,0,22,9
1683697833033,VIS 127C,A00,187720,Shen; Kuiyi,67,0,146,79
1683697834060,VIS 149,A00,187731,Yoldas; Pinar,0,12,22,22
1683697835084,VIS 151,A01,188091,Staff,22,0,34,12
1683697835084,VIS 151,A02,188092,Staff,11,0,34,23
1683697836108,VIS 160B,A00,188093,Stalbaum; Brett,0,1,10,10
1683697838156,WCWP 10B,A00,201720,Staff,0,0,5,5
1683697838156,WCWP 10B,B00,201722,Staff,0,0,6,6
1683697839180,WCWP 100,A00,201725,Gagnon; Jeffrey C,0,0,2,2
1683697839180,WCWP 100,B00,201727,Staff,0,4,15,15
1683697842273,ANBI 133,A00,258401,Wilder; Linnea Lorene,34,0,40,6
1683697843298,ANBI 140,A00,258395,Hrvoj Mihic; Branka,18,0,25,7
1683697844325,ANSC 120,A00,258402,Bialecki; Jon Anthony,26,0,40,14
1683697845350,ANSC 144,A00,258400,Staff,12,0,40,28
1683697847401,ANSC 166,A00,258396,Parish; Steven Martin,156,0,175,19
1683697848425,ANSC 180,A00,193533,Staff,8,0,20,12
1683697849451,ANSC 188,A00,258397,Jassal; Aftab,34,0,40,6
1683697850478,ANTH 3,A01,258316,Staff,23,0,30,7
1683697851506,ANTH 5,A00,258394,Semendeferi; Ekaterini,16,0,20,4
1683697852531,ANTH 21,A01,258331,Staff,4,0,40,36
1683697853555,ANTH 103,A00,258398,Varma; Saiba,15,0,25,10
1683697854585,AWP 10,001,202034,Staff,0,0,0,0
1683697854585,AWP 10,002,202035,Staff,0,0,0,0
1683697854585,AWP 10,003,202036,Staff,0,0,0,0
1683697854585,AWP 10,004,202037,Staff,0,0,0,0
1683697854585,AWP 10,005,202038,Staff,0,0,0,0
1683697854585,AWP 10,006,202039,Staff,0,0,0,0
1683697854585,AWP 10,007,202040,Staff,0,0,0,0
1683697854585,AWP 10,008,202041,Staff,0,0,0,0
1683697854585,AWP 10,009,202042,Staff,0,0,0,0
1683697854585,AWP 10,010,202043,Staff,0,0,0,0
1683697854585,AWP 10,011,202044,Staff,0,0,0,0
1683697854585,AWP 10,012,202045,Staff,0,0,0,0
1683697854585,AWP 10,013,202046,Staff,0,0,0,0
1683697854585,AWP 10,014,202047,Staff,0,0,0,0
1683697854585,AWP 10,015,202048,Staff,0,0,0,0
1683697854585,AWP 10,016,202049,Staff,0,0,0,0
1683697854585,AWP 10,017,202050,Staff,0,0,0,0
1683697854585,AWP 10,018,202051,Staff,0,0,0,0
1683697854585,AWP 10,019,202052,Staff,0,0,0,0
1683697854585,AWP 10,020,202053,Staff,0,0,0,0
1683697854585,AWP 10,021,202054,Staff,0,0,0,0
1683697854585,AWP 10,022,202055,Staff,0,0,0,0
1683697854585,AWP 10,023,202056,Staff,0,0,0,0
1683697854585,AWP 10,024,202057,Staff,0,0,0,0
1683697854585,AWP 10,025,202058,Staff,0,0,0,0
1683697854585,AWP 10,026,202059,Staff,0,0,0,0
1683697855612,AWP 102,001,202032,Staff,0,0,0,0
1683697855612,AWP 102,002,202033,Staff,0,0,0,0
1683697856636,BENG 100,A01,254234,Taylor Amos; Alyssa C,31,0,40,9
1683697857661,BENG 196,001,270013,Engler; Adam J.,9999,0,9999,0
1683697858686,BICD 100R,A01,202018,Smith; Laurie,0,7,32,32
1683697858686,BICD 100R,A02,202019,Smith; Laurie,0,3,32,32
1683697858686,BICD 100R,A03,202020,Smith; Laurie,0,1,32,32
1683697858686,BICD 100R,A04,202021,Smith; Laurie,6,0,32,26
1683697858686,BICD 100R,A05,202022,Smith; Laurie,10,0,32,22
1683697859710,BICD 136,A01,193242,Gustafson-Brown; Cindy,0,2,32,32
1683697859710,BICD 136,A02,193244,Gustafson-Brown; Cindy,13,0,32,19
1683697860735,BIEB 102,A01,193249,Butler; Shannon Rhey,0,0,32,32
1683697860735,BIEB 102,A02,193251,Butler; Shannon Rhey,0,0,32,32
1683697860735,BIEB 102,A03,193253,Butler; Shannon Rhey,0,0,32,32
1683697860735,BIEB 102,A04,193255,Butler; Shannon Rhey,13,0,32,19
1683697860735,BIEB 102,A05,193265,Butler; Shannon Rhey,25,0,32,7
1683697860735,BIEB 102,A06,193269,Butler; Shannon Rhey,12,0,32,20
1683697862798,BIEB 150,A01,193274,Staff,0,0,32,32
1683697862798,BIEB 150,A02,193285,Staff,24,0,32,8
1683697863822,BIEB 194,A00,193286,Kurle; Carolyn M.,19,0,32,13
1683697864847,BILD 1,A01,192291,Staff,15,0,32,17
1683697864847,BILD 1,A02,192292,Staff,30,0,32,2
1683697864847,BILD 1,B01,192520,Reuther; Keefe,0,1,0,0
1683697864847,BILD 1,B02,192532,Reuther; Keefe,0,1,0,0
1683697865872,BILD 3,A01,192556,Butler; Shannon Rhey,0,0,32,32
1683697865872,BILD 3,A02,192581,Butler; Shannon Rhey,0,1,32,32
1683697865872,BILD 3,A03,192611,Butler; Shannon Rhey,19,0,32,13
1683697865872,BILD 3,A04,192612,Butler; Shannon Rhey,23,0,32,9
1683697865872,BILD 3,A05,192613,Butler; Shannon Rhey,26,0,32,6
1683697865872,BILD 3,A06,192679,Butler; Shannon Rhey,27,0,32,5
1683697865872,BILD 3,A07,192682,Butler; Shannon Rhey,20,0,32,12
1683697866901,BILD 4,A01,192836,Reuther; Keefe,1,0,24,23
1683697866901,BILD 4,A02,193044,Reuther; Keefe,4,0,24,20
1683697867929,BILD 10,A01,193142,Gustafson-Brown; Cindy,29,0,32,3
1683697867929,BILD 10,A02,193149,Gustafson-Brown; Cindy,31,0,32,1
1683697868954,BIMM 100,A01,193301,Staff,0,6,32,32
1683697868954,BIMM 100,A02,193312,Staff,0,7,32,32
1683697868954,BIMM 100,A03,193323,Staff,0,10,32,32
1683697869981,BIMM 101,A01,193329,McDonnell; Lisa Marie,0,3,24,24
1683697869981,BIMM 101,A02,193339,McDonnell; Lisa Marie,0,3,24,24
1683697869981,BIMM 101,B01,193354,McDonnell; Lisa Marie,0,4,24,24
1683697869981,BIMM 101,B02,193357,McDonnell; Lisa Marie,0,3,24,24
1683697871010,BIMM 110,A01,193377,Tat; John,0,11,32,32
1683697871010,BIMM 110,A02,193378,Tat; John,0,11,32,32
1683697872041,BIMM 120,A01,206116,Staff,0,0,32,32
1683697872041,BIMM 120,A02,206117,Staff,7,0,32,25
1683697872041,BIMM 120,A03,206121,Staff,21,0,32,11
1683697873066,BIPN 100,A01,193393,Park; Ji Young,0,15,32,32
1683697873066,BIPN 100,A02,193402,Park; Ji Young,0,14,32,32
1683697873066,BIPN 100,A03,193413,Park; Ji Young,0,14,32,32
1683697873066,BIPN 100,A04,193414,Park; Ji Young,0,13,32,32
1683697874091,BIPN 102,A01,193429,Staff,0,0,32,32
1683697874091,BIPN 102,A02,193438,Staff,18,0,32,14
1683697875188,BIPN 106,A01,193450,Reyes Gonzalez; Catalina,0,2,40,40
1683697876213,BIPN 134,A01,193465,Cooke; James Edward,0,0,32,32
1683697876213,BIPN 134,A02,193474,Cooke; James Edward,25,0,32,7
1683697876213,BIPN 134,A03,193485,Cooke; James Edward,29,0,32,3
1683697876213,BIPN 134,A04,193486,Cooke; James Edward,20,0,32,12
1683697876213,BIPN 134,A05,193491,Cooke; James Edward,31,0,32,1
1683697876213,BIPN 134,A06,193501,Cooke; James Edward,30,0,32,2
1683697876213,BIPN 134,A07,193510,Cooke; James Edward,29,0,32,3
1683697878267,BISP 194,A00,222522,Staff,14,0,32,18
1683697879297,CAT 124,A01,202407,Staff,19,0,25,6
1683697880325,CAT 125,A00,202408,Marchisotto; Jennifer Anne,2,0,20,18
1683697881349,CAT 125R,A00,202409,Smith; Lauryn Alissa,0,11,20,20
1683697881349,CAT 125R,B00,202410,Morales; Celeste Georgianna,0,11,20,20
1683697881349,CAT 125R,C00,202411,Irwin; Matthew Joseph,0,12,20,20
1683697882376,CENG 15,A01,204712,Yang; Kesong,0,1,0,0
1683697883409,CENG 114,A00,202070,Jahed Motlagh; Zeinab,5,0,20,15
1683697884438,CGS 105,A00,185477,Wesling; Megan E.,24,0,40,16
1683697885464,CGS 106,A00,185494,Staff,11,0,22,11
1683697886489,CGS 108,A00,185495,Staff,14,0,20,6
1683697887514,CGS 114,A00,185496,Staff,13,0,18,5
1683697888538,CGS 119,A00,185501,Staff,15,0,20,5
1683697889562,CGS 120,A00,185511,Staff,12,0,20,8
1683697890590,CHEM 4,A01,184675,Bussey; Thomas J,97,0,100,3
1683697891613,CHEM 6A,A01,184677,Staff,32,0,60,28
1683697892640,CHEM 6B,A01,184679,Staff,63,0,100,37
1683697893669,CHEM 6C,A01,184681,Bussey; Thomas J,0,0,50,50
1683697893669,CHEM 6C,A02,184682,Bussey; Thomas J,32,0,50,18
1683697894694,CHEM 40A,A01,184684,Albizati; Kim F.,33,0,100,67
1683697895718,CHEM 40B,A01,184686,Albizati; Kim F.,0,22,100,100
1683697896742,CHEM 41B,A01,184690,Staff,51,0,100,49
1683697897771,COGS 3,A01,184715,Boyle; Mary E. T.,0,27,40,40
1683697898797,COGS 14B,A01,185172,Staff,0,14,38,38
1683697899826,COGS 18,A01,184736,Staff,14,0,80,66
1683697900855,COGS 100,A01,184932,Staff,0,8,73,73
1683697901881,COGS 101A,A01,184935,Staff,0,40,30,30
1683697902907,COGS 101B,A01,184944,Staff,0,2,30,30
1683697903931,COGS 101C,A01,184946,Staff,0,10,30,30
1683697904956,COGS 102A,A01,184951,Johnson; Christine M.,1,0,40,39
1683697905982,COGS 107B,A01,184953,Mooshagian; Eric Frederick,0,52,40,40
1683697907007,COGS 118B,A01,184959,Gupta; Anjum,0,50,40,40
1683697908036,COGS 153,A00,184961,Staff,1,16,30,29
1683697909062,COGS 177,A00,184962,Staff,0,20,30,30
1683697910086,COGS 187A,A01,184969,Boyle; Mary E. T.,0,19,40,40
1683697911111,COMM 10,A01,185174,Staff,0,5,25,25
1683697911111,COMM 10,A02,185189,Staff,0,2,25,25
1683697911111,COMM 10,A03,269821,Staff,0,1,0,0
1683697912137,COMM 100B,A02,185476,Staff,10,0,25,15
1683697912137,COMM 100B,A03,277340,Staff,25,0,25,0
1683697913165,COMM 100C,A01,185314,Staff,2,0,25,23
1683697913165,COMM 100C,A02,185327,Staff,17,0,25,8
1683697914193,COMM 110M,A00,185349,Staff,0,0,40,40
1683697915222,COMM 113T,A00,185352,Staff,25,0,40,15
1683697916246,COMM 114I,A00,185353,Staff,31,0,40,9
1683697917271,COMM 131,A00,185354,Staff,17,0,30,13
1683697918293,CSE 8A,A50,185358,Cao; Yingjun,0,46,10,10
1683697919320,CSE 8B,A01,185362,Staff,0,48,50,50
1683697920347,CSE 11,A01,185416,Cao; Yingjun,0,91,10,10
1683697921369,CSE 20,A01,185445,Briones; Jor-el Thomas Caparas,3,0,25,22
1683697922397,CSE 21,A01,185447,Staff,9,0,50,41
1683697923422,CSE 101,A01,185451,Staff,0,13,50,50
1683697923422,CSE 101,B01,185453,Jones; Miles E,0,14,50,50
1683697925474,CSE 141,A01,185458,Eldon; John,16,0,100,84
1683697926498,CSE 141L,A01,185461,Eldon; John,8,0,100,92
1683697927523,CSE 142,A01,185463,Staff,34,0,60,26
1683697927523,CSE 142,B01,201355,Staff,0,7,60,60
1683697928548,CSE 142L,A01,185470,Staff,34,0,60,26
1683697928548,CSE 142L,B01,201417,Staff,0,6,60,60
1683697929573,CSE 190,A00,201433,Staff,32,0,49,17
1683697930599,DOC 1,A01,259136,Strom; Megan C.,7,0,15,8
1683697930599,DOC 1,A02,259137,Strom; Megan C.,14,0,15,1
1683697930599,DOC 1,A03,259138,Strom; Megan C.,14,0,15,1
1683697930599,DOC 1,A04,259139,Strom; Megan C.,14,0,15,1
1683697931625,DOC 100D,A00,259140,Pass; Natalye Joann,14,0,25,11
1683697932650,DSGN 1,A01,184749,Rill; Bryan,0,26,30,30
1683697933678,DSGN 100,A01,185168,Staff,0,2,25,25
1683697934705,ECE 5,A01,185626,Morris; Karcher William,0,12,0,0
1683697935729,ECE 101,A01,185628,Staff,14,0,70,56
1683697936758,ECE 107,A01,185635,Baghdadchi; Saharnaz,0,0,20,20
1683697936758,ECE 107,A02,185638,Baghdadchi; Saharnaz,1,0,20,19
1683697937785,ECE 148,A01,185647,Silberman; Jack,0,0,16,16
1683697938812,ECON 1,A01,185537,Crane; Meredith Helen,54,0,70,16
1683697939841,ECON 3,A01,185549,Crane; Meredith Helen,30,0,70,40
1683697940869,ECON 4,A01,203354,Anderson; John Charles,0,5,10,10
1683697941896,ECON 100A,A01,185574,Staff,0,5,40,40
1683697942922,ECON 100B,A01,185576,Staff,0,12,50,50
1683697943946,ECON 100C,A01,185589,Newhouse; Herbert S,30,0,70,40
1683697944974,ECON 105,A00,185608,Vespa; Emanuel Ignacio,19,0,35,16
1683697946000,ECON 109,A01,185610,Shishkin; Denis,9,0,35,26
1683697947029,ECON 110A,A01,185612,Staff,8,0,40,32
1683697948053,ECON 120A,A01,185615,Staff,19,0,40,21
1683697949080,ECON 120C,A01,185617,Sun; Yixiao,0,21,70,70
1683697950105,ECON 144,A00,203346,Squires; Dale E,2,0,35,33
1683697951137,ECON 171,A01,203349,Newhouse; Herbert S,0,1,35,35
1683697952162,ECON 173A,A01,185621,Toda; Alexis Akira,21,0,35,14
1683697953189,EDS 25,A01,202413,Staff,0,1,0,0
1683697953189,EDS 25,A02,202414,Staff,0,1,0,0
1683697953189,EDS 25,A03,202415,Staff,0,0,0,0
1683697953189,EDS 25,A04,202416,Staff,0,1,0,0
1683697953189,EDS 25,A05,202439,Staff,0,0,0,0
1683697953189,EDS 25,A06,202440,Staff,0,0,0,0
1683697953189,EDS 25,B01,202631,Staff,0,0,0,0
1683697953189,EDS 25,B02,202632,Staff,0,0,0,0
1683697953189,EDS 25,B03,202639,Staff,0,0,0,0
1683697953189,EDS 25,B04,202640,Staff,0,0,0,0
1683697953189,EDS 25,B05,202643,Staff,0,0,0,0
1683697953189,EDS 25,B06,202644,Staff,0,0,0,0
1683697954211,EDS 38,A01,202659,Black; Alison Michelle,24,0,25,1
1683697955237,EDS 115,A00,202652,Staff,18,0,30,12
1683697956261,EDS 125,A00,202649,Staff,13,0,30,17
1683697957285,EDS 126,A01,203332,Staff,30,0,30,0
1683697958312,EDS 139,A00,202838,Staff,16,0,25,9
1683697959336,EDS 146,A01,202655,Staff,14,0,25,11
1683697960364,ENG 15,A00,185667,Staff,0,1,0,0
1683697960364,ENG 15,B00,185672,Staff,0,0,0,0
1683697960364,ENG 15,C00,185675,Staff,0,0,0,0
1683697960364,ENG 15,D00,185682,Staff,0,0,0,0
1683697960364,ENG 15,E00,185684,Staff,0,0,0,0
1683697961387,ETHN 103,A00,185710,Staff,0,8,35,35
1683697962411,ETHN 103A,A00,199228,Man; Simeon S,0,0,9,9
1683697963434,ETHN 109,A00,185711,Staff,15,0,35,20
1683697964456,ETHN 142,A00,185726,Staff,0,4,30,30
1683697965483,ETHN 163J,A00,199229,Man; Simeon S,5,0,8,3
1683697966507,ETHN 168,A00,185727,Staff,7,0,10,3
1683697967533,ETHN 182,A00,185728,Staff,0,0,35,35
1683697968557,ETHN 183,A00,185737,Staff,9,0,18,9
1683697969582,GLBH 111,A01,209361,Burgos; Jose L.,0,0,0,0
1683697971632,HIEU 104,A00,185792,Staff,14,0,20,6
1683697972658,HIEU 115,A00,185800,Staff,0,0,20,20
1683697973682,HIEU 128,A00,185801,Staff,0,9,20,20
1683697974706,HIEU 147,A00,185802,Staff,15,0,20,5
1683697975730,HIEU 154,A00,185823,Staff,11,0,20,9
1683697976757,HILA 102,A00,185826,Staff,14,0,20,6
1683697977784,HILD 2C,A01,185778,Staff,0,13,20,20
1683697978862,HILD 7B,A01,185780,Kwak; Nancy,0,17,32,32
1683697978862,HILD 7B,A02,185781,Kwak; Nancy,0,18,32,32
1683697979888,HILD 30,A01,185791,Staff,12,0,20,8
1683697980916,HISC 119,A00,185830,Golan; Tal,0,10,20,20
1683697981943,HITO 156GS,A00,185831,Patterson; Patrick H.,0,0,0,23
1683697982968,HIUS 103,A00,185832,Man; Simeon S,0,4,20,20
1683697983996,HIUS 117,A00,185836,Kwak; Nancy,2,0,20,18
1683697985019,HIUS 125,A00,185840,Man; Simeon S,0,2,23,23
1683697986044,HIUS 149,A00,185845,Staff,1,0,20,19
1683697987068,HUM 3,A01,185882,Zavodny; Tatiana Sophia,0,8,50,50
1683697987068,HUM 3,B01,185899,Caldwell; Michael Alan,0,18,50,50
1683697988092,HUM 3GS,A00,185900,Patterson; Patrick H.,0,0,0,23
1683697989117,HUM 4,A01,185938,Zroka; Amy Liane,28,0,50,22
1683697989117,HUM 4,B01,185956,Watkins; Eric,0,6,50,50
1683697989117,HUM 4,B02,202209,Watkins; Eric,0,5,50,50
1683697989117,HUM 4,B03,202210,Watkins; Eric,0,5,50,50
1683697990145,HUM 5,A01,185958,West; Geoffrey Scott,0,0,50,50
1683697990145,HUM 5,A02,202215,West; Geoffrey Scott,0,1,50,50
1683697991170,INTL 190,A00,185959,Gagnon; Jeffrey C,0,0,0,9
1683697991170,INTL 190,B00,185960,Lettieri; Michael Joseph,0,0,0,2
1683697992192,JAPN 180,A00,254509,Staff,5,0,30,25
1683697993219,LATI 10,A01,202853,Kennemore; Amy Michelle,4,0,35,31
1683697993219,LATI 10,A02,202854,Kennemore; Amy Michelle,3,0,35,32
1683697993219,LATI 10,A03,270054,Kennemore; Amy Michelle,30,0,30,0
1683697994242,LATI 180,A00,202855,Kennemore; Amy Michelle,11,0,20,9
1683697995268,LAWS 101,A00,201767,Golan; Tal,0,7,40,40
1683697996291,LIFR 1C,A00,185961,Staff,6,0,20,14
1683697997318,LIFR 1CX,A00,185962,Staff,7,0,20,13
1683697998342,LIFR 1D,A00,185963,Staff,7,0,20,13
1683697999370,LIFR 1DX,A00,185964,Staff,7,0,20,13
1683698000397,LIGN 101,A01,186039,Staff,43,0,50,7
1683698001422,LIGN 165,A00,186040,Staff,15,0,50,35
1683698002446,LTCS 108,A00,186041,Staff,5,0,10,5
1683698003470,LTCS 119,A00,186042,Staff,15,0,20,5
1683698004495,LTCS 130,A00,186043,Wesling; Megan E.,15,0,25,10
1683698006545,LTEA 138,A00,186119,Staff,14,0,40,26
1683698007569,LTEN 124,A00,186148,Staff,5,0,25,20
1683698008595,LTEN 178,A00,186149,Staff,6,0,15,9
1683698009620,LTEN 181,A00,186150,Blanco; John D,34,0,40,6
1683698010642,LTWL 120,A00,186160,Staff,19,0,25,6
1683698011666,LTWL 165,A00,186161,Staff,22,0,25,3
1683698012691,LTWR 100,A00,186162,Staff,0,5,15,15
1683698013718,LTWR 102,A00,186163,Doller; Ben,5,0,15,10
1683698014742,MAE 8,A01,186412,Staff,0,1,0,0
1683698015767,MAE 30B,A00,186445,Bahadori; Mohammad Yousef,81,0,100,19
1683698016793,MAE 40,A00,186592,Bewley; Thomas R,10,0,50,40
1683698017821,MAE 101B,A00,186593,Bahadori; Mohammad Yousef,80,0,100,20
1683698018846,MAE 105,A00,186594,Bandaru; Prabhakar,10,0,50,40
1683698019870,MAE 107,A00,186599,Pham; Hieu Tan,0,8,120,120
1683698020895,MAE 148,A01,186660,Silberman; Jack,3,0,16,13
1683698021923,MATH 10A,A01,188095,Staff,0,6,35,35
1683698022953,MATH 10B,A01,188097,Bowers; Adam R.,0,12,30,30
1683698022953,MATH 10B,A02,188099,Bowers; Adam R.,0,11,30,30
1683698022953,MATH 10B,B01,188104,Bowers; Adam R.,0,10,30,30
1683698022953,MATH 10B,B02,188106,Bowers; Adam R.,0,9,30,30
1683698023982,MATH 10C,A01,188111,Staff,0,20,30,30
1683698023982,MATH 10C,A02,188127,Staff,0,19,30,30
1683698023982,MATH 10C,A03,188131,Staff,0,19,30,30
1683698023982,MATH 10C,B01,188218,Staff,17,0,30,13
1683698023982,MATH 10C,B02,188244,Staff,13,0,30,17
1683698023982,MATH 10C,B03,188277,Staff,14,0,30,16
1683698025011,MATH 18,A01,188344,Bach; Quang Tran,18,0,30,12
1683698025011,MATH 18,A02,188345,Bach; Quang Tran,11,0,30,19
1683698025011,MATH 18,B01,188353,Bach; Quang Tran,11,0,30,19
1683698025011,MATH 18,B02,188354,Bach; Quang Tran,19,0,30,11
1683698026038,MATH 20A,A01,188374,Staff,11,0,35,24
1683698027068,MATH 20B,A01,188382,Ohm; Ko Woon,7,0,30,23
1683698027068,MATH 20B,A02,188383,Ohm; Ko Woon,22,0,30,8
1683698027068,MATH 20B,B01,188385,Ohm; Ko Woon,7,0,30,23
1683698027068,MATH 20B,B02,188392,Ohm; Ko Woon,22,0,30,8
1683698028093,MATH 20C,A01,188394,Harel; Guershon,10,0,30,20
1683698028093,MATH 20C,A02,188395,Harel; Guershon,13,0,30,17
1683698028093,MATH 20C,B01,188404,Harel; Guershon,5,0,30,25
1683698028093,MATH 20C,B02,188405,Harel; Guershon,18,0,30,12
1683698029122,MATH 20D,A01,188414,Hammock; Frances H,0,1,30,30
1683698029122,MATH 20D,A02,188415,Hammock; Frances H,0,1,30,30
1683698029122,MATH 20D,B01,188447,Hammock; Frances H,0,1,30,30
1683698029122,MATH 20D,B02,188486,Hammock; Frances H,2,0,30,28
1683698030149,MATH 20E,A01,188649,Staff,21,0,30,9
1683698030149,MATH 20E,A02,188650,Staff,20,0,30,10
1683698030149,MATH 20E,A03,188673,Staff,0,0,30,30
1683698031172,MATH 102,A01,188675,Staff,0,40,35,35
1683698032198,MATH 103B,A01,188681,Staff,3,0,35,32
1683698032198,MATH 103B,B01,188692,Staff,5,0,35,30
1683698033221,MATH 109,A01,188695,Salehi Golsefidy; Alireza,24,0,35,11
1683698033221,MATH 109,A02,188696,Salehi Golsefidy; Alireza,25,0,35,10
1683698034246,MATH 120A,A01,188698,Eggers; John Dietrich,7,0,35,28
1683698035270,MATH 142B,A01,188736,Ioana; Adrian,0,0,30,30
1683698035270,MATH 142B,A02,188741,Ioana; Adrian,0,1,30,30
1683698035270,MATH 142B,A03,188743,Ioana; Adrian,0,2,30,30
1683698036298,MATH 168A,A01,188790,Staff,0,11,35,35
1683698037322,MATH 170A,A01,188803,Nie; Jiawang,0,2,35,35
1683698037322,MATH 170A,A02,188811,Nie; Jiawang,0,1,35,35
1683698037322,MATH 170A,A03,188814,Nie; Jiawang,0,0,35,35
1683698037322,MATH 170A,A04,188815,Nie; Jiawang,5,0,35,30
1683698038345,MATH 193B,A01,188817,Staff,0,0,35,35
1683698038345,MATH 193B,A02,188818,Staff,6,0,35,29
1683698039371,MGT 4,A01,202857,Anderson; John Charles,59,0,80,21
1683698040396,MGT 12,A00,202858,Lindenberger; Wade Douglas,40,0,90,50
1683698041424,MGT 18,A00,202859,Staff,74,0,90,16
1683698042447,MGT 18GS,A00,202860,McKay; Michael J,13,0,28,15
1683698043470,MGT 45,A00,202861,Pecore; Joseph P.,8,0,90,82
1683698044497,MGT 100,A00,202863,Yavorsky; Daniel Ryan,27,0,90,63
1683698045524,MGT 103,A00,202864,Ehrich; Kristine R,0,19,90,90
1683698046546,MGT 112,A00,202865,Ehrich; Kristine R,15,0,90,75
1683698047574,MGT 121A,A00,202868,Staff,70,0,90,20
1683698048602,MGT 131B,A00,202869,Anderson; John Charles,58,0,90,32
1683698049626,MGT 136,A00,202871,Lindenberger; Wade Douglas,83,0,90,7
1683698050649,MGT 164,A00,202873,Staff,0,67,90,91
1683698051674,MGT 164GS,A00,202874,McKay; Mary A,13,0,28,15
1683698052699,MGT 180,A00,202875,Staff,0,51,90,91
1683698053722,MMW 11R,A01,205019,Herbst; Matthew,0,0,30,30
1683698053722,MMW 11R,A02,205026,Herbst; Matthew,29,0,30,1
1683698054751,MMW 15,A01,193512,Chang; Edmond Yi-Teh,0,8,28,28
1683698054751,MMW 15,A02,193513,Chang; Edmond Yi-Teh,0,5,28,28
1683698054751,MMW 15,A03,193514,Chang; Edmond Yi-Teh,0,5,28,28
1683698054751,MMW 15,A04,193515,Chang; Edmond Yi-Teh,0,5,28,28
1683698054751,MMW 15,A05,193516,Chang; Edmond Yi-Teh,0,5,28,28
1683698054751,MMW 15,A06,193517,Chang; Edmond Yi-Teh,0,6,28,28
1683698054751,MMW 15,B01,193519,Chang; Edmond Yi-Teh,0,5,28,28
1683698054751,MMW 15,B02,193520,Chang; Edmond Yi-Teh,0,5,28,28
1683698054751,MMW 15,B03,193521,Chang; Edmond Yi-Teh,0,5,28,28
1683698054751,MMW 15,B04,193522,Chang; Edmond Yi-Teh,0,6,28,28
1683698054751,MMW 15,B05,193523,Chang; Edmond Yi-Teh,0,5,28,28
1683698054751,MMW 15,B06,193524,Chang; Edmond Yi-Teh,0,5,28,28
1683698055778,MMW 122,A01,193526,Rahimi; Babak,0,16,28,28
1683698055778,MMW 122,A02,193527,Rahimi; Babak,0,15,28,28
1683698055778,MMW 122,A03,193528,Rahimi; Babak,0,0,0,0
1683698055778,MMW 122,A04,193529,Rahimi; Babak,0,0,0,0
1683698056802,MUS 1A,A01,186663,Staff,0,18,35,35
1683698057826,MUS 4,A01,186715,Staff,0,12,35,35
1683698058850,MUS 5R,A01,186796,Dubnov; Shlomo,0,17,35,35
1683698059874,MUS 6,A01,186798,Staff,0,4,25,25
1683698060901,MUS 7,A01,186830,Staff,11,0,35,24
1683698061929,MUS 8,A01,186930,Staff,0,27,35,35
1683698062954,MUS 15,A01,186932,Staff,0,15,35,35
1683698062954,MUS 15,B01,186934,Staff,0,16,35,35
1683698063984,MUS 80,A00,186935,Staff,0,0,20,20
1683698063984,MUS 80,B00,186936,Staff,24,0,25,1
1683698065008,NANO 11,A00,204702,Lipomi; Darren John,0,0,0,0
1683698066046,NANO 15,A01,204709,Yang; Kesong,0,1,0,0
1683698067071,NANO 114,A00,202069,Jahed Motlagh; Zeinab,2,0,10,8
1683698068094,PHIL 1,A00,186955,Grush; Rick Scott,31,0,40,9
1683698069121,PHIL 10,A01,186973,Grush; Rick Scott,27,0,35,8
1683698069121,PHIL 10,A02,186974,Grush; Rick Scott,33,0,35,2
1683698070146,PHIL 13,A01,186976,Staff,1,0,35,34
1683698070146,PHIL 13,A02,186977,Staff,16,0,35,19
1683698071174,PHIL 14,A01,186979,Staff,31,0,35,4
1683698071174,PHIL 14,A02,186986,Staff,32,0,35,3
1683698072198,PHIL 28,A01,186988,Staff,16,0,30,14
1683698072198,PHIL 28,A02,186989,Staff,1,0,30,29
1683698072198,PHIL 28,A03,186990,Staff,10,0,30,20
1683698072198,PHIL 28,A04,186991,Staff,26,0,30,4
1683698073227,PHIL 120,A00,186997,Staff,23,0,40,17
1683698074252,PHIL 137,A00,187003,Staff,7,0,40,33
1683698075279,PHIL 150,A00,187015,Staff,47,0,70,23
1683698076310,PHIL 167,A00,187021,Lamey; Andy M.,34,0,40,6
1683698077336,PHIL 174,A01,202226,Staff,17,0,20,3
1683698077336,PHIL 174,A02,202235,Staff,20,0,20,0
1683698078359,PHIL 191A,A00,258918,Staff,0,0,1,1
1683698079386,PHYS 1A,A00,187028,Staff,26,0,60,34
1683698080411,PHYS 1AL,001,187036,Staff,3,0,30,27
1683698080411,PHYS 1AL,002,187049,Staff,18,0,30,12
1683698081434,PHYS 1B,A00,187058,Staff,21,0,60,39
1683698082514,PHYS 1BL,001,187064,Staff,0,1,30,30
1683698082514,PHYS 1BL,002,187070,Staff,4,0,30,26
1683698083538,PHYS 1C,A00,187082,Staff,30,0,120,90
1683698084563,PHYS 1CL,001,187088,Staff,0,9,30,30
1683698084563,PHYS 1CL,002,187089,Staff,0,1,30,30
1683698084563,PHYS 1CL,009,262693,Staff,9,0,30,21
1683698085588,PHYS 2B,A01,187097,Staff,55,0,115,60
1683698086615,PHYS 2C,A01,187099,Staff,63,0,115,52
1683698087638,PHYS 2CL,A01,187101,Staff,5,0,28,23
1683698087638,PHYS 2CL,A02,187102,Staff,15,0,28,13
1683698088665,PHYS 2D,A01,187123,Shotwell; Brian,95,0,115,20
1683698089689,PHYS 4B,A01,187133,Grinstein; Benjamin,35,0,50,15
1683698090716,POLI 10,A00,188819,Staff,0,4,50,50
1683698091739,POLI 11,A00,188827,Staff,43,0,50,7
1683698092766,POLI 13R,A00,188828,Staff,0,1,20,20
1683698093793,POLI 27,A01,188830,Elgin; Samuel Zincke,0,2,70,70
1683698094821,POLI 30,A00,188832,Desposato; Scott,30,0,50,20
1683698095846,POLI 102F,A00,188834,Staff,1,0,40,39
1683698096871,POLI 104A,A00,188852,Staff,12,0,30,18
1683698097894,POLI 104I,A00,188853,Staff,0,8,20,20
1683698098918,POLI 110B,A00,188854,Wiens; David,6,0,20,14
1683698099941,POLI 112A,A00,188855,Wiens; David,3,0,30,27
1683698100968,POLI 117R,A00,188856,Forman; Fonna,0,12,20,20
1683698101996,POLI 118,A00,188857,Ingham; Sean,8,0,20,12
1683698103024,POLI 120G,A00,188858,Staff,8,0,30,22
1683698104053,POLI 131CR,A00,188863,Hoston; Germaine,20,0,50,30
1683698105081,POLI 133,A00,188864,Nellis; Gareth Hb,44,0,50,6
1683698106109,POLI 134D,A00,188865,Desposato; Scott,27,0,30,3
1683698107135,POLI 142A,A00,188871,Gartzke; Erik,21,0,50,29
1683698108160,POLI 142K,A00,188874,Staff,38,0,50,12
1683698109184,POLI 143,A00,188940,Gartzke; Erik,16,0,30,14
1683698110210,POLI 153,A00,188943,Staff,2,0,20,18
1683698111236,POLI 160AA,A00,188944,Staff,10,0,40,30
1683698112262,POLI 170A,A00,188945,Staff,10,0,30,20
1683698114310,PSYC 1,A00,188952,Staff,36,0,90,54
1683698115333,PSYC 2,B00,188953,Staff,19,0,35,16
1683698116358,PSYC 6,A00,188970,Staff,47,0,60,13
1683698117383,PSYC 7,A00,188973,Staff,35,0,45,10
1683698118407,PSYC 60,A01,188980,Rickard; Timothy C.,42,0,60,18
1683698119435,PSYC 70,A01,189001,Steiner; Eric Tomas,21,0,45,24
1683698120462,PSYC 100,A00,189005,Lacefield; Katharine I,0,98,120,120
1683698121486,PSYC 102,A00,189008,Staff,6,0,30,24
1683698122513,PSYC 106,B00,189026,Gorman; Michael R.,27,0,60,33
1683698123542,PSYC 114,B01,189033,Winkielman; Piotr,0,31,30,30
1683698124565,PSYC 131,A00,189036,Anagnostaras; Stephan,0,44,60,60
1683698125589,PSYC 136,A00,189041,Lowe; Angela Beth,0,7,25,25
1683698126613,PSYC 137,A00,189057,Winkielman; Piotr,0,36,25,25
1683698127640,PSYC 144,A00,189107,Wixted; John T,0,11,50,50
1683698129688,PSYC 162,A00,189142,Staff,0,9,85,85
1683698130716,PSYC 172,A00,189144,Gorman; Michael R.,0,6,30,30
1683698132767,PSYC 179,A00,189146,Lacefield; Katharine I,0,88,120,120
1683698133790,PSYC 181,A00,189147,Anagnostaras; Stephan,0,45,90,90
1683698134841,PSYC 190R,A00,189148,Barner; David A.,0,23,80,80
1683698135864,PSYC 191,A00,189275,Rickard; Timothy C.,0,11,25,25
1683698136888,PSYC 193,A00,189276,Chapman; Eddie Nathaniel,0,1,0,4
1683698137913,PSYC 193L,A01,189281,Lowe; Angela Beth,8,0,20,12
1683698137913,PSYC 193L,B01,189285,Staff,28,0,35,7
1683698138938,RELI 149,A00,187137,Rahimi; Babak,6,0,40,34
1683698139965,SE 9,A01,187315,Staff,0,2,18,18
1683698140990,SE 101B,A00,187409,Staff,24,0,30,6
1683698142013,SE 110B,A00,187444,Staff,10,0,40,30
1683698143038,SE 130B,A00,187449,Staff,31,0,40,9
1683698144061,SE 150A,A00,187516,Staff,8,0,20,12
1683698145084,SE 154,A00,187528,Staff,29,0,50,21
1683698146108,SIO 3,A01,258171,Staff,35,0,40,5
1683698147133,SIO 10,A00,187144,Cook; Geoffrey W,0,6,75,75
1683698148157,SIO 45,A00,187152,Cook; Geoffrey W,0,7,100,100
1683698149181,SIO 109R,A00,194486,Staff,0,4,20,20
1683698151229,SIO 187,A01,187233,Kacev; David,12,0,40,28
1683698152253,SOCI 1,A01,258656,Thorpe; Charles Robert,28,0,30,2
1683698152253,SOCI 1,A02,258658,Thorpe; Charles Robert,30,0,30,0
1683698152253,SOCI 1,A03,258661,Thorpe; Charles Robert,25,0,25,0
1683698152253,SOCI 1,A04,258666,Thorpe; Charles Robert,22,0,25,3
1683698152253,SOCI 1,A05,258897,Thorpe; Charles Robert,22,0,25,3
1683698152253,SOCI 1,A06,258898,Thorpe; Charles Robert,25,0,25,0
1683698153277,SOCI 30,A01,258903,Pardo Guerra; Juan Pablo,14,0,30,16
1683698154304,SOCI 102,A00,258904,Staff,9,0,25,16
1683698155327,SOCI 106,A00,258905,Staff,19,0,25,6
1683698156355,SOCI 111,A00,258907,Ribas Norris; Janet Vanesa,26,0,30,4
1683698157379,SOCI 121R,A00,258908,Pardo Guerra; Juan Pablo,7,0,30,23
1683698158402,SOCI 126,A01,203330,Staff,14,0,20,6
1683698159428,SOCI 131,A00,258909,Thorpe; Charles Robert,30,0,60,30
1683698160453,SOCI 135,A00,258910,Payne; Christine Anna,0,13,30,30
1683698161477,SOCI 157,A00,258911,Staff,10,0,30,20
1683698162501,SOCI 184,A00,258912,Staff,25,0,30,5
1683698163526,SOCI 188D,A00,258913,Staff,22,0,30,8
1683698164550,SYN 2,001,187529,Staff,9,0,16,7
1683698164550,SYN 2,002,201452,Staff,0,20,16,16
1683698164550,SYN 2,003,201469,Staff,1,0,16,15
1683698165577,SYN 100,A01,187531,Staff,0,9,20,20
1683698165577,SYN 100,B01,201491,Staff,0,10,20,20
1683698166601,TDAC 1,A00,189286,Walsh; Kim C.,3,0,20,17
1683698166601,TDAC 1,B00,189287,Harting; Carla Kelso,10,0,20,10
1683698167629,TDAC 101,A00,189300,Walsh; Kim C.,16,0,20,4
1683698167629,TDAC 101,B00,189301,Harting; Carla Kelso,18,0,20,2
1683698168657,TDAC 102,A00,189304,Basso; Beatrice,14,0,20,6
1683698169684,TDAC 108,A00,189305,Staff,18,0,20,2
1683698170713,TDDE 131,A00,189310,Staff,19,0,20,1
1683698170713,TDDE 131,B00,189314,Staff,19,0,20,1
1683698170713,TDDE 131,C00,189315,Staff,48,0,50,2
1683698170713,TDDE 131,D00,189316,Staff,14,0,15,1
1683698170713,TDDE 131,E00,204841,Staff,20,0,20,0
1683698171734,TDGE 10,A00,189289,Staff,27,0,50,23
1683698171734,TDGE 10,B00,189290,Havis; Allan,0,1,50,50
1683698172759,TDGE 11,A00,189291,Fulton; Julia,0,4,50,50
1683698172759,TDGE 11,B00,189292,Staff,20,0,25,5
1683698172759,TDGE 11,C00,260270,Staff,0,0,0,0
1683698173787,TDGE 25,A00,189294,Staff,1,0,20,19
1683698174813,TDGE 124,A00,189318,Fulton; Julia,0,7,50,50
1683698175838,TDGE 125,A00,189319,Staff,13,0,25,12
1683698175838,TDGE 125,B00,189320,Staff,23,0,25,2
1683698176862,TDGE 127,A00,189322,Havis; Allan,0,0,50,50
1683698177887,TDHT 101,A00,189323,Staff,18,0,25,7
1683698177887,TDHT 101,B00,189324,Staff,25,0,25,0
1683698178912,TDHT 102,A00,189325,Staff,49,0,50,1
1683698179937,TDMV 1,A00,189295,Arcidiacono; Kristin,20,0,30,10
1683698179937,TDMV 1,B00,189296,Caligagan; Maria T.,24,0,30,6
1683698180962,TDMV 2,A00,189297,Sammartano; Tonnie,27,0,30,3
1683698180962,TDMV 2,B00,189299,Arcidiacono; Kristin,23,0,30,7
1683698181989,TDMV 3,A00,204998,Rincon; Alicia,22,0,30,8
1683698183017,TDMV 120,A00,189458,Sammartano; Tonnie,28,0,30,2
1683698184041,TDMV 138,A00,189541,Jun; Grace Shin Hae,20,0,40,20
1683698185066,TDMV 142,A00,189717,Caligagan; Tony,25,0,30,5
1683698185066,TDMV 142,B00,189718,Caligagan; Maria T.,25,0,30,5
1683698186149,TMC 2,A01,187533,Staff,25,0,25,0
1683698186149,TMC 2,A02,187534,Staff,25,0,25,0
1683698187176,USP 1,A01,187536,Kwak; Nancy,0,16,25,25
1683698188199,USP 5,A01,187538,Staff,8,0,25,17
1683698189228,USP 101,A00,199253,Staff,0,4,0,0
1683698190252,USP 124,A00,187562,Boomhower; Matthew Charles,0,0,30,30
1683698191352,USP 138,A00,187582,Staff,19,0,25,6
1683698192378,USP 152,A01,187597,Staff,3,0,25,22
1683698193404,USP 153,A00,187598,Staff,18,0,25,7
1683698194427,USP 168,A00,187607,Kwak; Nancy,2,0,5,3
1683698195454,USP 173,A00,187619,Staff,4,0,25,21
1683698196479,USP 181,A00,187638,Staff,0,4,25,25
1683698197503,VIS 103,A00,187650,Cruz; Edwin Teddy,17,0,75,58
1683698198532,VIS 110D,A00,187669,Staff,13,0,22,9
1683698199559,VIS 127C,A00,187720,Shen; Kuiyi,67,0,146,79
1683698200583,VIS 149,A00,187731,Yoldas; Pinar,0,12,22,22
1683698201612,VIS 151,A01,188091,Staff,22,0,34,12
1683698201612,VIS 151,A02,188092,Staff,11,0,34,23
1683698202639,VIS 160B,A00,188093,Stalbaum; Brett,0,1,10,10
1683698204689,WCWP 10B,A00,201720,Staff,0,0,5,5
1683698204689,WCWP 10B,B00,201722,Staff,0,0,6,6
1683698205714,WCWP 100,A00,201725,Gagnon; Jeffrey C,0,0,2,2
1683698205714,WCWP 100,B00,201727,Staff,0,4,15,15
1683698208807,ANBI 133,A00,258401,Wilder; Linnea Lorene,34,0,40,6
1683698209831,ANBI 140,A00,258395,Hrvoj Mihic; Branka,18,0,25,7
1683698210855,ANSC 120,A00,258402,Bialecki; Jon Anthony,26,0,40,14
1683698211882,ANSC 144,A00,258400,Staff,12,0,40,28
1683698213933,ANSC 166,A00,258396,Parish; Steven Martin,156,0,175,19
1683698214957,ANSC 180,A00,193533,Staff,8,0,20,12
1683698215981,ANSC 188,A00,258397,Jassal; Aftab,34,0,40,6
1683698217005,ANTH 3,A01,258316,Staff,23,0,30,7
1683698218030,ANTH 5,A00,258394,Semendeferi; Ekaterini,16,0,20,4
1683698219058,ANTH 21,A01,258331,Staff,4,0,40,36
1683698220081,ANTH 103,A00,258398,Varma; Saiba,15,0,25,10
1683698221115,AWP 10,001,202034,Staff,0,0,0,0
1683698221115,AWP 10,002,202035,Staff,0,0,0,0
1683698221115,AWP 10,003,202036,Staff,0,0,0,0
1683698221115,AWP 10,004,202037,Staff,0,0,0,0
1683698221115,AWP 10,005,202038,Staff,0,0,0,0
1683698221115,AWP 10,006,202039,Staff,0,0,0,0
1683698221115,AWP 10,007,202040,Staff,0,0,0,0
1683698221115,AWP 10,008,202041,Staff,0,0,0,0
1683698221115,AWP 10,009,202042,Staff,0,0,0,0
1683698221115,AWP 10,010,202043,Staff,0,0,0,0
1683698221115,AWP 10,011,202044,Staff,0,0,0,0
1683698221115,AWP 10,012,202045,Staff,0,0,0,0
1683698221115,AWP 10,013,202046,Staff,0,0,0,0
1683698221115,AWP 10,014,202047,Staff,0,0,0,0
1683698221115,AWP 10,015,202048,Staff,0,0,0,0
1683698221115,AWP 10,016,202049,Staff,0,0,0,0
1683698221115,AWP 10,017,202050,Staff,0,0,0,0
1683698221115,AWP 10,018,202051,Staff,0,0,0,0
1683698221115,AWP 10,019,202052,Staff,0,0,0,0
1683698221115,AWP 10,020,202053,Staff,0,0,0,0
1683698221115,AWP 10,021,202054,Staff,0,0,0,0
1683698221115,AWP 10,022,202055,Staff,0,0,0,0
1683698221115,AWP 10,023,202056,Staff,0,0,0,0
1683698221115,AWP 10,024,202057,Staff,0,0,0,0
1683698221115,AWP 10,025,202058,Staff,0,0,0,0
1683698221115,AWP 10,026,202059,Staff,0,0,0,0
1683698222139,AWP 102,001,202032,Staff,0,0,0,0
1683698222139,AWP 102,002,202033,Staff,0,0,0,0
1683698223163,BENG 100,A01,254234,Taylor Amos; Alyssa C,31,0,40,9
1683698224186,BENG 196,001,270013,Engler; Adam J.,9999,0,9999,0
1683698225211,BICD 100R,A01,202018,Smith; Laurie,0,7,32,32
1683698225211,BICD 100R,A02,202019,Smith; Laurie,0,3,32,32
1683698225211,BICD 100R,A03,202020,Smith; Laurie,0,1,32,32
1683698225211,BICD 100R,A04,202021,Smith; Laurie,6,0,32,26
1683698225211,BICD 100R,A05,202022,Smith; Laurie,10,0,32,22
1683698226235,BICD 136,A01,193242,Gustafson-Brown; Cindy,0,2,32,32
1683698226235,BICD 136,A02,193244,Gustafson-Brown; Cindy,13,0,32,19
1683698227261,BIEB 102,A01,193249,Butler; Shannon Rhey,0,0,32,32
1683698227261,BIEB 102,A02,193251,Butler; Shannon Rhey,0,0,32,32
1683698227261,BIEB 102,A03,193253,Butler; Shannon Rhey,0,0,32,32
1683698227261,BIEB 102,A04,193255,Butler; Shannon Rhey,13,0,32,19
1683698227261,BIEB 102,A05,193265,Butler; Shannon Rhey,25,0,32,7
1683698227261,BIEB 102,A06,193269,Butler; Shannon Rhey,12,0,32,20
1683698229309,BIEB 150,A01,193274,Staff,0,0,32,32
1683698229309,BIEB 150,A02,193285,Staff,24,0,32,8
1683698230333,BIEB 194,A00,193286,Kurle; Carolyn M.,19,0,32,13
1683698231361,BILD 1,A01,192291,Staff,15,0,32,17
1683698231361,BILD 1,A02,192292,Staff,30,0,32,2
1683698231361,BILD 1,B01,192520,Reuther; Keefe,0,1,0,0
1683698231361,BILD 1,B02,192532,Reuther; Keefe,0,1,0,0
1683698232390,BILD 3,A01,192556,Butler; Shannon Rhey,0,0,32,32
1683698232390,BILD 3,A02,192581,Butler; Shannon Rhey,0,1,32,32
1683698232390,BILD 3,A03,192611,Butler; Shannon Rhey,19,0,32,13
1683698232390,BILD 3,A04,192612,Butler; Shannon Rhey,23,0,32,9
1683698232390,BILD 3,A05,192613,Butler; Shannon Rhey,26,0,32,6
1683698232390,BILD 3,A06,192679,Butler; Shannon Rhey,27,0,32,5
1683698232390,BILD 3,A07,192682,Butler; Shannon Rhey,20,0,32,12
1683698233419,BILD 4,A01,192836,Reuther; Keefe,1,0,24,23
1683698233419,BILD 4,A02,193044,Reuther; Keefe,4,0,24,20
1683698234444,BILD 10,A01,193142,Gustafson-Brown; Cindy,29,0,32,3
1683698234444,BILD 10,A02,193149,Gustafson-Brown; Cindy,31,0,32,1
1683698235469,BIMM 100,A01,193301,Staff,0,6,32,32
1683698235469,BIMM 100,A02,193312,Staff,0,7,32,32
1683698235469,BIMM 100,A03,193323,Staff,0,10,32,32
1683698236499,BIMM 101,A01,193329,McDonnell; Lisa Marie,0,3,24,24
1683698236499,BIMM 101,A02,193339,McDonnell; Lisa Marie,0,3,24,24
1683698236499,BIMM 101,B01,193354,McDonnell; Lisa Marie,0,4,24,24
1683698236499,BIMM 101,B02,193357,McDonnell; Lisa Marie,0,3,24,24
1683698237524,BIMM 110,A01,193377,Tat; John,0,11,32,32
1683698237524,BIMM 110,A02,193378,Tat; John,0,11,32,32
1683698238552,BIMM 120,A01,206116,Staff,0,0,32,32
1683698238552,BIMM 120,A02,206117,Staff,7,0,32,25
1683698238552,BIMM 120,A03,206121,Staff,21,0,32,11
1683698239577,BIPN 100,A01,193393,Park; Ji Young,0,15,32,32
1683698239577,BIPN 100,A02,193402,Park; Ji Young,0,14,32,32
1683698239577,BIPN 100,A03,193413,Park; Ji Young,0,14,32,32
1683698239577,BIPN 100,A04,193414,Park; Ji Young,0,13,32,32
1683698240602,BIPN 102,A01,193429,Staff,0,0,32,32
1683698240602,BIPN 102,A02,193438,Staff,18,0,32,14
1683698241626,BIPN 106,A01,193450,Reyes Gonzalez; Catalina,0,2,40,40
1683698242651,BIPN 134,A01,193465,Cooke; James Edward,0,0,32,32
1683698242651,BIPN 134,A02,193474,Cooke; James Edward,25,0,32,7
1683698242651,BIPN 134,A03,193485,Cooke; James Edward,29,0,32,3
1683698242651,BIPN 134,A04,193486,Cooke; James Edward,20,0,32,12
1683698242651,BIPN 134,A05,193491,Cooke; James Edward,31,0,32,1
1683698242651,BIPN 134,A06,193501,Cooke; James Edward,30,0,32,2
1683698242651,BIPN 134,A07,193510,Cooke; James Edward,29,0,32,3
1683698244704,BISP 194,A00,222522,Staff,14,0,32,18
1683698245728,CAT 124,A01,202407,Staff,19,0,25,6
1683698246751,CAT 125,A00,202408,Marchisotto; Jennifer Anne,2,0,20,18
1683698247779,CAT 125R,A00,202409,Smith; Lauryn Alissa,0,11,20,20
1683698247779,CAT 125R,B00,202410,Morales; Celeste Georgianna,0,11,20,20
1683698247779,CAT 125R,C00,202411,Irwin; Matthew Joseph,0,12,20,20
1683698248807,CENG 15,A01,204712,Yang; Kesong,0,1,0,0
1683698249836,CENG 114,A00,202070,Jahed Motlagh; Zeinab,5,0,20,15
1683698250863,CGS 105,A00,185477,Wesling; Megan E.,24,0,40,16
1683698251886,CGS 106,A00,185494,Staff,11,0,22,11
1683698252913,CGS 108,A00,185495,Staff,14,0,20,6
1683698253939,CGS 114,A00,185496,Staff,13,0,18,5
1683698254963,CGS 119,A00,185501,Staff,15,0,20,5
1683698255988,CGS 120,A00,185511,Staff,12,0,20,8
1683698257012,CHEM 4,A01,184675,Bussey; Thomas J,97,0,100,3
1683698258037,CHEM 6A,A01,184677,Staff,32,0,60,28
1683698259062,CHEM 6B,A01,184679,Staff,63,0,100,37
1683698260086,CHEM 6C,A01,184681,Bussey; Thomas J,0,0,50,50
1683698260086,CHEM 6C,A02,184682,Bussey; Thomas J,32,0,50,18
1683698261112,CHEM 40A,A01,184684,Albizati; Kim F.,33,0,100,67
1683698262137,CHEM 40B,A01,184686,Albizati; Kim F.,0,22,100,100
1683698263165,CHEM 41B,A01,184690,Staff,51,0,100,49
1683698264190,COGS 3,A01,184715,Boyle; Mary E. T.,0,27,40,40
1683698265217,COGS 14B,A01,185172,Staff,0,14,38,38
1683698266244,COGS 18,A01,184736,Staff,14,0,80,66
1683698267271,COGS 100,A01,184932,Staff,0,8,73,73
1683698268296,COGS 101A,A01,184935,Staff,0,40,30,30
1683698269320,COGS 101B,A01,184944,Staff,0,2,30,30
1683698270346,COGS 101C,A01,184946,Staff,0,10,30,30
1683698271374,COGS 102A,A01,184951,Johnson; Christine M.,1,0,40,39
1683698272402,COGS 107B,A01,184953,Mooshagian; Eric Frederick,0,52,40,40
1683698273430,COGS 118B,A01,184959,Gupta; Anjum,0,50,40,40
1683698274455,COGS 153,A00,184961,Staff,1,16,30,29
1683698275480,COGS 177,A00,184962,Staff,0,20,30,30
1683698276505,COGS 187A,A01,184969,Boyle; Mary E. T.,0,19,40,40
1683698277537,COMM 10,A01,185174,Staff,0,5,25,25
1683698277537,COMM 10,A02,185189,Staff,0,2,25,25
1683698277537,COMM 10,A03,269821,Staff,0,1,0,0
1683698278566,COMM 100B,A02,185476,Staff,10,0,25,15
1683698278566,COMM 100B,A03,277340,Staff,25,0,25,0
1683698279592,COMM 100C,A01,185314,Staff,2,0,25,23
1683698279592,COMM 100C,A02,185327,Staff,17,0,25,8
1683698280618,COMM 110M,A00,185349,Staff,0,0,40,40
1683698281641,COMM 113T,A00,185352,Staff,25,0,40,15
1683698282665,COMM 114I,A00,185353,Staff,31,0,40,9
1683698283688,COMM 131,A00,185354,Staff,17,0,30,13
1683698284712,CSE 8A,A50,185358,Cao; Yingjun,0,46,10,10
1683698285736,CSE 8B,A01,185362,Staff,0,48,50,50
1683698286761,CSE 11,A01,185416,Cao; Yingjun,0,91,10,10
1683698287784,CSE 20,A01,185445,Briones; Jor-el Thomas Caparas,3,0,25,22
1683698288809,CSE 21,A01,185447,Staff,9,0,50,41
1683698289888,CSE 101,A01,185451,Staff,0,13,50,50
1683698289888,CSE 101,B01,185453,Jones; Miles E,0,14,50,50
1683698291939,CSE 141,A01,185458,Eldon; John,16,0,100,84
1683698292963,CSE 141L,A01,185461,Eldon; John,8,0,100,92
1683698293989,CSE 142,A01,185463,Staff,34,0,60,26
1683698293989,CSE 142,B01,201355,Staff,0,7,60,60
1683698295013,CSE 142L,A01,185470,Staff,34,0,60,26
1683698295013,CSE 142L,B01,201417,Staff,0,6,60,60
1683698296038,CSE 190,A00,201433,Staff,32,0,49,17
1683698297063,DOC 1,A01,259136,Strom; Megan C.,7,0,15,8
1683698297063,DOC 1,A02,259137,Strom; Megan C.,14,0,15,1
1683698297063,DOC 1,A03,259138,Strom; Megan C.,14,0,15,1
1683698297063,DOC 1,A04,259139,Strom; Megan C.,14,0,15,1
1683698298088,DOC 100D,A00,259140,Pass; Natalye Joann,14,0,25,11
1683698299113,DSGN 1,A01,184749,Rill; Bryan,0,26,30,30
1683698300138,DSGN 100,A01,185168,Staff,0,2,25,25
1683698301162,ECE 5,A01,185626,Morris; Karcher William,0,12,0,0
1683698302190,ECE 101,A01,185628,Staff,14,0,70,56
1683698303218,ECE 107,A01,185635,Baghdadchi; Saharnaz,0,0,20,20
1683698303218,ECE 107,A02,185638,Baghdadchi; Saharnaz,1,0,20,19
1683698304242,ECE 148,A01,185647,Silberman; Jack,0,0,16,16
1683698305266,ECON 1,A01,185537,Crane; Meredith Helen,54,0,70,16
1683698306290,ECON 3,A01,185549,Crane; Meredith Helen,30,0,70,40
1683698307318,ECON 4,A01,203354,Anderson; John Charles,0,5,10,10
1683698308341,ECON 100A,A01,185574,Staff,0,5,40,40
1683698309370,ECON 100B,A01,185576,Staff,0,12,50,50
1683698310395,ECON 100C,A01,185589,Newhouse; Herbert S,30,0,70,40
1683698311417,ECON 105,A00,185608,Vespa; Emanuel Ignacio,19,0,35,16
1683698312440,ECON 109,A01,185610,Shishkin; Denis,9,0,35,26
1683698313464,ECON 110A,A01,185612,Staff,8,0,40,32
1683698314491,ECON 120A,A01,185615,Staff,19,0,40,21
1683698315515,ECON 120C,A01,185617,Sun; Yixiao,0,21,70,70
1683698316542,ECON 144,A00,203346,Squires; Dale E,2,0,35,33
1683698317566,ECON 171,A01,203349,Newhouse; Herbert S,0,1,35,35
1683698318589,ECON 173A,A01,185621,Toda; Alexis Akira,21,0,35,14
1683698319619,EDS 25,A01,202413,Staff,0,1,0,0
1683698319619,EDS 25,A02,202414,Staff,0,1,0,0
1683698319619,EDS 25,A03,202415,Staff,0,0,0,0
1683698319619,EDS 25,A04,202416,Staff,0,1,0,0
1683698319619,EDS 25,A05,202439,Staff,0,0,0,0
1683698319619,EDS 25,A06,202440,Staff,0,0,0,0
1683698319619,EDS 25,B01,202631,Staff,0,0,0,0
1683698319619,EDS 25,B02,202632,Staff,0,0,0,0
1683698319619,EDS 25,B03,202639,Staff,0,0,0,0
1683698319619,EDS 25,B04,202640,Staff,0,0,0,0
1683698319619,EDS 25,B05,202643,Staff,0,0,0,0
1683698319619,EDS 25,B06,202644,Staff,0,0,0,0
1683698320646,EDS 38,A01,202659,Black; Alison Michelle,24,0,25,1
1683698321669,EDS 115,A00,202652,Staff,18,0,30,12
1683698322693,EDS 125,A00,202649,Staff,13,0,30,17
1683698323721,EDS 126,A01,203332,Staff,30,0,30,0
1683698324744,EDS 139,A00,202838,Staff,16,0,25,9
1683698325768,EDS 146,A01,202655,Staff,14,0,25,11
1683698326793,ENG 15,A00,185667,Staff,0,1,0,0
1683698326793,ENG 15,B00,185672,Staff,0,0,0,0
1683698326793,ENG 15,C00,185675,Staff,0,0,0,0
1683698326793,ENG 15,D00,185682,Staff,0,0,0,0
1683698326793,ENG 15,E00,185684,Staff,0,0,0,0
1683698327817,ETHN 103,A00,185710,Staff,0,8,35,35
1683698328840,ETHN 103A,A00,199228,Man; Simeon S,0,0,9,9
1683698329865,ETHN 109,A00,185711,Staff,15,0,35,20
1683698330889,ETHN 142,A00,185726,Staff,0,4,30,30
1683698331914,ETHN 163J,A00,199229,Man; Simeon S,5,0,8,3
1683698332938,ETHN 168,A00,185727,Staff,7,0,10,3
1683698333963,ETHN 182,A00,185728,Staff,0,0,35,35
1683698334986,ETHN 183,A00,185737,Staff,9,0,18,9
1683698336014,GLBH 111,A01,209361,Burgos; Jose L.,0,0,0,0
1683698338064,HIEU 104,A00,185792,Staff,14,0,20,6
1683698339090,HIEU 115,A00,185800,Staff,0,0,20,20
1683698340117,HIEU 128,A00,185801,Staff,0,9,20,20
1683698341141,HIEU 147,A00,185802,Staff,15,0,20,5
1683698342166,HIEU 154,A00,185823,Staff,11,0,20,9
1683698343190,HILA 102,A00,185826,Staff,14,0,20,6
1683698344215,HILD 2C,A01,185778,Staff,0,13,20,20
1683698345242,HILD 7B,A01,185780,Kwak; Nancy,0,17,32,32
1683698345242,HILD 7B,A02,185781,Kwak; Nancy,0,18,32,32
1683698346270,HILD 30,A01,185791,Staff,12,0,20,8
1683698347298,HISC 119,A00,185830,Golan; Tal,0,10,20,20
1683698348321,HITO 156GS,A00,185831,Patterson; Patrick H.,0,0,0,23
1683698349348,HIUS 103,A00,185832,Man; Simeon S,0,4,20,20
1683698350376,HIUS 117,A00,185836,Kwak; Nancy,2,0,20,18
1683698351401,HIUS 125,A00,185840,Man; Simeon S,0,2,23,23
1683698352426,HIUS 149,A00,185845,Staff,1,0,20,19
1683698353457,HUM 3,A01,185882,Zavodny; Tatiana Sophia,0,8,50,50
1683698353457,HUM 3,B01,185899,Caldwell; Michael Alan,0,18,50,50
1683698354482,HUM 3GS,A00,185900,Patterson; Patrick H.,0,0,0,23
1683698355511,HUM 4,A01,185938,Zroka; Amy Liane,28,0,50,22
1683698355511,HUM 4,B01,185956,Watkins; Eric,0,6,50,50
1683698355511,HUM 4,B02,202209,Watkins; Eric,0,5,50,50
1683698355511,HUM 4,B03,202210,Watkins; Eric,0,5,50,50
1683698356540,HUM 5,A01,185958,West; Geoffrey Scott,0,0,50,50
1683698356540,HUM 5,A02,202215,West; Geoffrey Scott,0,1,50,50
1683698357566,INTL 190,A00,185959,Gagnon; Jeffrey C,0,0,0,9
1683698357566,INTL 190,B00,185960,Lettieri; Michael Joseph,0,0,0,2
1683698358593,JAPN 180,A00,254509,Staff,5,0,30,25
1683698359618,LATI 10,A01,202853,Kennemore; Amy Michelle,4,0,35,31
1683698359618,LATI 10,A02,202854,Kennemore; Amy Michelle,3,0,35,32
1683698359618,LATI 10,A03,270054,Kennemore; Amy Michelle,30,0,30,0
1683698360642,LATI 180,A00,202855,Kennemore; Amy Michelle,11,0,20,9
1683698361668,LAWS 101,A00,201767,Golan; Tal,0,7,40,40
1683698362692,LIFR 1C,A00,185961,Staff,6,0,20,14
1683698363718,LIFR 1CX,A00,185962,Staff,7,0,20,13
1683698364744,LIFR 1D,A00,185963,Staff,7,0,20,13
1683698365769,LIFR 1DX,A00,185964,Staff,7,0,20,13
1683698366793,LIGN 101,A01,186039,Staff,43,0,50,7
1683698367820,LIGN 165,A00,186040,Staff,15,0,50,35
1683698368846,LTCS 108,A00,186041,Staff,5,0,10,5
1683698369872,LTCS 119,A00,186042,Staff,15,0,20,5
1683698370899,LTCS 130,A00,186043,Wesling; Megan E.,15,0,25,10
1683698372947,LTEA 138,A00,186119,Staff,14,0,40,26
1683698373972,LTEN 124,A00,186148,Staff,5,0,25,20
1683698374996,LTEN 178,A00,186149,Staff,6,0,15,9
1683698376019,LTEN 181,A00,186150,Blanco; John D,34,0,40,6
1683698377041,LTWL 120,A00,186160,Staff,19,0,25,6
1683698378068,LTWL 165,A00,186161,Staff,22,0,25,3
1683698379095,LTWR 100,A00,186162,Staff,0,5,15,15
1683698380122,LTWR 102,A00,186163,Doller; Ben,5,0,15,10
1683698381146,MAE 8,A01,186412,Staff,0,1,0,0
1683698382170,MAE 30B,A00,186445,Bahadori; Mohammad Yousef,81,0,100,19
1683698383193,MAE 40,A00,186592,Bewley; Thomas R,10,0,50,40
1683698384226,MAE 101B,A00,186593,Bahadori; Mohammad Yousef,80,0,100,20
1683698385249,MAE 105,A00,186594,Bandaru; Prabhakar,10,0,50,40
1683698386274,MAE 107,A00,186599,Pham; Hieu Tan,0,8,120,120
1683698387303,MAE 148,A01,186660,Silberman; Jack,3,0,16,13
1683698388332,MATH 10A,A01,188095,Staff,0,6,35,35
1683698389357,MATH 10B,A01,188097,Bowers; Adam R.,0,12,30,30
1683698389357,MATH 10B,A02,188099,Bowers; Adam R.,0,11,30,30
1683698389357,MATH 10B,B01,188104,Bowers; Adam R.,0,10,30,30
1683698389357,MATH 10B,B02,188106,Bowers; Adam R.,0,9,30,30
1683698390386,MATH 10C,A01,188111,Staff,0,20,30,30
1683698390386,MATH 10C,A02,188127,Staff,0,19,30,30
1683698390386,MATH 10C,A03,188131,Staff,0,19,30,30
1683698390386,MATH 10C,B01,188218,Staff,17,0,30,13
1683698390386,MATH 10C,B02,188244,Staff,13,0,30,17
1683698390386,MATH 10C,B03,188277,Staff,14,0,30,16
1683698391415,MATH 18,A01,188344,Bach; Quang Tran,18,0,30,12
1683698391415,MATH 18,A02,188345,Bach; Quang Tran,11,0,30,19
1683698391415,MATH 18,B01,188353,Bach; Quang Tran,11,0,30,19
1683698391415,MATH 18,B02,188354,Bach; Quang Tran,19,0,30,11
1683698392440,MATH 20A,A01,188374,Staff,11,0,35,24
1683698393535,MATH 20B,A01,188382,Ohm; Ko Woon,7,0,30,23
1683698393535,MATH 20B,A02,188383,Ohm; Ko Woon,22,0,30,8
1683698393535,MATH 20B,B01,188385,Ohm; Ko Woon,7,0,30,23
1683698393535,MATH 20B,B02,188392,Ohm; Ko Woon,22,0,30,8
1683698394564,MATH 20C,A01,188394,Harel; Guershon,10,0,30,20
1683698394564,MATH 20C,A02,188395,Harel; Guershon,13,0,30,17
1683698394564,MATH 20C,B01,188404,Harel; Guershon,5,0,30,25
1683698394564,MATH 20C,B02,188405,Harel; Guershon,18,0,30,12
1683698395589,MATH 20D,A01,188414,Hammock; Frances H,0,1,30,30
1683698395589,MATH 20D,A02,188415,Hammock; Frances H,0,1,30,30
1683698395589,MATH 20D,B01,188447,Hammock; Frances H,0,1,30,30
1683698395589,MATH 20D,B02,188486,Hammock; Frances H,2,0,30,28
1683698396614,MATH 20E,A01,188649,Staff,21,0,30,9
1683698396614,MATH 20E,A02,188650,Staff,20,0,30,10
1683698396614,MATH 20E,A03,188673,Staff,0,0,30,30
1683698397639,MATH 102,A01,188675,Staff,0,40,35,35
1683698398667,MATH 103B,A01,188681,Staff,3,0,35,32
1683698398667,MATH 103B,B01,188692,Staff,5,0,35,30
1683698399690,MATH 109,A01,188695,Salehi Golsefidy; Alireza,24,0,35,11
1683698399690,MATH 109,A02,188696,Salehi Golsefidy; Alireza,25,0,35,10
1683698400715,MATH 120A,A01,188698,Eggers; John Dietrich,7,0,35,28
1683698401744,MATH 142B,A01,188736,Ioana; Adrian,0,0,30,30
1683698401744,MATH 142B,A02,188741,Ioana; Adrian,0,1,30,30
1683698401744,MATH 142B,A03,188743,Ioana; Adrian,0,2,30,30
1683698402769,MATH 168A,A01,188790,Staff,0,11,35,35
1683698403794,MATH 170A,A01,188803,Nie; Jiawang,0,2,35,35
1683698403794,MATH 170A,A02,188811,Nie; Jiawang,0,1,35,35
1683698403794,MATH 170A,A03,188814,Nie; Jiawang,0,0,35,35
1683698403794,MATH 170A,A04,188815,Nie; Jiawang,5,0,35,30
1683698404822,MATH 193B,A01,188817,Staff,0,0,35,35
1683698404822,MATH 193B,A02,188818,Staff,6,0,35,29
1683698405844,MGT 4,A01,202857,Anderson; John Charles,59,0,80,21
1683698406870,MGT 12,A00,202858,Lindenberger; Wade Douglas,40,0,90,50
1683698407896,MGT 18,A00,202859,Staff,74,0,90,16
1683698408921,MGT 18GS,A00,202860,McKay; Michael J,13,0,28,15
1683698409942,MGT 45,A00,202861,Pecore; Joseph P.,8,0,90,82
1683698410967,MGT 100,A00,202863,Yavorsky; Daniel Ryan,27,0,90,63
1683698411998,MGT 103,A00,202864,Ehrich; Kristine R,0,19,90,90
1683698413025,MGT 112,A00,202865,Ehrich; Kristine R,15,0,90,75
1683698414053,MGT 121A,A00,202868,Staff,70,0,90,20
1683698415079,MGT 131B,A00,202869,Anderson; John Charles,58,0,90,32
1683698416103,MGT 136,A00,202871,Lindenberger; Wade Douglas,83,0,90,7
1683698417129,MGT 164,A00,202873,Staff,0,67,90,91
1683698418165,MGT 164GS,A00,202874,McKay; Mary A,13,0,28,15
1683698419188,MGT 180,A00,202875,Staff,0,51,90,91
1683698420212,MMW 11R,A01,205019,Herbst; Matthew,0,0,30,30
1683698420212,MMW 11R,A02,205026,Herbst; Matthew,29,0,30,1
1683698421241,MMW 15,A01,193512,Chang; Edmond Yi-Teh,0,8,28,28
1683698421241,MMW 15,A02,193513,Chang; Edmond Yi-Teh,0,5,28,28
1683698421241,MMW 15,A03,193514,Chang; Edmond Yi-Teh,0,5,28,28
1683698421241,MMW 15,A04,193515,Chang; Edmond Yi-Teh,0,5,28,28
1683698421241,MMW 15,A05,193516,Chang; Edmond Yi-Teh,0,5,28,28
1683698421241,MMW 15,A06,193517,Chang; Edmond Yi-Teh,0,6,28,28
1683698421241,MMW 15,B01,193519,Chang; Edmond Yi-Teh,0,5,28,28
1683698421241,MMW 15,B02,193520,Chang; Edmond Yi-Teh,0,5,28,28
1683698421241,MMW 15,B03,193521,Chang; Edmond Yi-Teh,0,5,28,28
1683698421241,MMW 15,B04,193522,Chang; Edmond Yi-Teh,0,6,28,28
1683698421241,MMW 15,B05,193523,Chang; Edmond Yi-Teh,0,5,28,28
1683698421241,MMW 15,B06,193524,Chang; Edmond Yi-Teh,0,5,28,28
1683698422268,MMW 122,A01,193526,Rahimi; Babak,0,16,28,28
1683698422268,MMW 122,A02,193527,Rahimi; Babak,0,15,28,28
1683698422268,MMW 122,A03,193528,Rahimi; Babak,0,0,0,0
1683698422268,MMW 122,A04,193529,Rahimi; Babak,0,0,0,0
1683698423294,MUS 1A,A01,186663,Staff,0,18,35,35
1683698424316,MUS 4,A01,186715,Staff,0,12,35,35
1683698425344,MUS 5R,A01,186796,Dubnov; Shlomo,0,17,35,35
1683698426367,MUS 6,A01,186798,Staff,0,4,25,25
1683698427394,MUS 7,A01,186830,Staff,11,0,35,24
1683698428418,MUS 8,A01,186930,Staff,0,27,35,35
1683698429445,MUS 15,A01,186932,Staff,0,15,35,35
1683698429445,MUS 15,B01,186934,Staff,0,16,35,35
1683698430468,MUS 80,A00,186935,Staff,0,0,20,20
1683698430468,MUS 80,B00,186936,Staff,24,0,25,1
1683698431493,NANO 11,A00,204702,Lipomi; Darren John,0,0,0,0
1683698432517,NANO 15,A01,204709,Yang; Kesong,0,1,0,0
1683698433543,NANO 114,A00,202069,Jahed Motlagh; Zeinab,2,0,10,8
1683698434566,PHIL 1,A00,186955,Grush; Rick Scott,31,0,40,9
1683698435589,PHIL 10,A01,186973,Grush; Rick Scott,27,0,35,8
1683698435589,PHIL 10,A02,186974,Grush; Rick Scott,33,0,35,2
1683698436613,PHIL 13,A01,186976,Staff,1,0,35,34
1683698436613,PHIL 13,A02,186977,Staff,16,0,35,19
1683698437642,PHIL 14,A01,186979,Staff,31,0,35,4
1683698437642,PHIL 14,A02,186986,Staff,32,0,35,3
1683698438670,PHIL 28,A01,186988,Staff,16,0,30,14
1683698438670,PHIL 28,A02,186989,Staff,1,0,30,29
1683698438670,PHIL 28,A03,186990,Staff,10,0,30,20
1683698438670,PHIL 28,A04,186991,Staff,26,0,30,4
1683698439696,PHIL 120,A00,186997,Staff,23,0,40,17
1683698440722,PHIL 137,A00,187003,Staff,7,0,40,33
1683698441750,PHIL 150,A00,187015,Staff,47,0,70,23
1683698442776,PHIL 167,A00,187021,Lamey; Andy M.,34,0,40,6
1683698443798,PHIL 174,A01,202226,Staff,17,0,20,3
1683698443798,PHIL 174,A02,202235,Staff,20,0,20,0
1683698444820,PHIL 191A,A00,258918,Staff,0,0,1,1
1683698445843,PHYS 1A,A00,187028,Staff,26,0,60,34
1683698446866,PHYS 1AL,001,187036,Staff,3,0,30,27
1683698446866,PHYS 1AL,002,187049,Staff,18,0,30,12
1683698447893,PHYS 1B,A00,187058,Staff,21,0,60,39
1683698448921,PHYS 1BL,001,187064,Staff,0,1,30,30
1683698448921,PHYS 1BL,002,187070,Staff,4,0,30,26
1683698449945,PHYS 1C,A00,187082,Staff,30,0,120,90
1683698450969,PHYS 1CL,001,187088,Staff,0,9,30,30
1683698450969,PHYS 1CL,002,187089,Staff,0,1,30,30
1683698450969,PHYS 1CL,009,262693,Staff,9,0,30,21
1683698451994,PHYS 2B,A01,187097,Staff,55,0,115,60
1683698453021,PHYS 2C,A01,187099,Staff,63,0,115,52
1683698454049,PHYS 2CL,A01,187101,Staff,5,0,28,23
1683698454049,PHYS 2CL,A02,187102,Staff,15,0,28,13
1683698455077,PHYS 2D,A01,187123,Shotwell; Brian,95,0,115,20
1683698456102,PHYS 4B,A01,187133,Grinstein; Benjamin,35,0,50,15
1683698457125,POLI 10,A00,188819,Staff,0,4,50,50
1683698458150,POLI 11,A00,188827,Staff,43,0,50,7
1683698459173,POLI 13R,A00,188828,Staff,0,1,20,20
1683698460201,POLI 27,A01,188830,Elgin; Samuel Zincke,0,2,70,70
1683698461227,POLI 30,A00,188832,Desposato; Scott,30,0,50,20
1683698462254,POLI 102F,A00,188834,Staff,1,0,40,39
1683698463282,POLI 104A,A00,188852,Staff,12,0,30,18
1683698464315,POLI 104I,A00,188853,Staff,0,8,20,20
1683698465340,POLI 110B,A00,188854,Wiens; David,6,0,20,14
1683698466377,POLI 112A,A00,188855,Wiens; David,3,0,30,27
1683698467402,POLI 117R,A00,188856,Forman; Fonna,0,12,20,20
1683698468428,POLI 118,A00,188857,Ingham; Sean,8,0,20,12
1683698469453,POLI 120G,A00,188858,Staff,8,0,30,22
1683698470477,POLI 131CR,A00,188863,Hoston; Germaine,20,0,50,30
1683698471500,POLI 133,A00,188864,Nellis; Gareth Hb,44,0,50,6
1683698472529,POLI 134D,A00,188865,Desposato; Scott,27,0,30,3
1683698473574,POLI 142A,A00,188871,Gartzke; Erik,21,0,50,29
1683698474597,POLI 142K,A00,188874,Staff,38,0,50,12
1683698475621,POLI 143,A00,188940,Gartzke; Erik,16,0,30,14
1683698476648,POLI 153,A00,188943,Staff,2,0,20,18
1683698477674,POLI 160AA,A00,188944,Staff,10,0,40,30
1683698478702,POLI 170A,A00,188945,Staff,10,0,30,20
1683698480755,PSYC 1,A00,188952,Staff,36,0,90,54
1683698481781,PSYC 2,B00,188953,Staff,19,0,35,16
1683698482807,PSYC 6,A00,188970,Staff,47,0,60,13
1683698483840,PSYC 7,A00,188973,Staff,35,0,45,10
1683698484865,PSYC 60,A01,188980,Rickard; Timothy C.,42,0,60,18
1683698485890,PSYC 70,A01,189001,Steiner; Eric Tomas,21,0,45,24
1683698486916,PSYC 100,A00,189005,Lacefield; Katharine I,0,98,120,120
1683698487940,PSYC 102,A00,189008,Staff,6,0,30,24
1683698488967,PSYC 106,B00,189026,Gorman; Michael R.,27,0,60,33
1683698489993,PSYC 114,B01,189033,Winkielman; Piotr,0,31,30,30
1683698491021,PSYC 131,A00,189036,Anagnostaras; Stephan,0,44,60,60
1683698492046,PSYC 136,A00,189041,Lowe; Angela Beth,0,7,25,25
1683698493068,PSYC 137,A00,189057,Winkielman; Piotr,0,36,25,25
1683698494091,PSYC 144,A00,189107,Wixted; John T,0,11,50,50
1683698496149,PSYC 162,A00,189142,Staff,0,9,85,85
1683698497226,PSYC 172,A00,189144,Gorman; Michael R.,0,6,30,30
1683698499274,PSYC 179,A00,189146,Lacefield; Katharine I,0,88,120,120
1683698500298,PSYC 181,A00,189147,Anagnostaras; Stephan,0,45,90,90
1683698501325,PSYC 190R,A00,189148,Barner; David A.,0,23,80,80
1683698502350,PSYC 191,A00,189275,Rickard; Timothy C.,0,11,25,25
1683698503376,PSYC 193,A00,189276,Chapman; Eddie Nathaniel,0,1,0,4
1683698504404,PSYC 193L,A01,189281,Lowe; Angela Beth,8,0,20,12
1683698504404,PSYC 193L,B01,189285,Staff,28,0,35,7
1683698505427,RELI 149,A00,187137,Rahimi; Babak,6,0,40,34
1683698506452,SE 9,A01,187315,Staff,0,2,18,18
1683698507477,SE 101B,A00,187409,Staff,24,0,30,6
1683698508505,SE 110B,A00,187444,Staff,10,0,40,30
1683698509532,SE 130B,A00,187449,Staff,31,0,40,9
1683698510579,SE 150A,A00,187516,Staff,8,0,20,12
1683698511604,SE 154,A00,187528,Staff,29,0,50,21
1683698512627,SIO 3,A01,258171,Staff,35,0,40,5
1683698513650,SIO 10,A00,187144,Cook; Geoffrey W,0,6,75,75
1683698514674,SIO 45,A00,187152,Cook; Geoffrey W,0,7,100,100
1683698515701,SIO 109R,A00,194486,Staff,0,4,20,20
1683698517753,SIO 187,A01,187233,Kacev; David,12,0,40,28
1683698518779,SOCI 1,A01,258656,Thorpe; Charles Robert,28,0,30,2
1683698518779,SOCI 1,A02,258658,Thorpe; Charles Robert,30,0,30,0
1683698518779,SOCI 1,A03,258661,Thorpe; Charles Robert,25,0,25,0
1683698518779,SOCI 1,A04,258666,Thorpe; Charles Robert,22,0,25,3
1683698518779,SOCI 1,A05,258897,Thorpe; Charles Robert,22,0,25,3
1683698518779,SOCI 1,A06,258898,Thorpe; Charles Robert,25,0,25,0
1683698519807,SOCI 30,A01,258903,Pardo Guerra; Juan Pablo,14,0,30,16
1683698520832,SOCI 102,A00,258904,Staff,9,0,25,16
1683698521860,SOCI 106,A00,258905,Staff,19,0,25,6
1683698522884,SOCI 111,A00,258907,Ribas Norris; Janet Vanesa,26,0,30,4
1683698523906,SOCI 121R,A00,258908,Pardo Guerra; Juan Pablo,7,0,30,23
1683698524941,SOCI 126,A01,203330,Staff,14,0,20,6
1683698525971,SOCI 131,A00,258909,Thorpe; Charles Robert,30,0,60,30
1683698526995,SOCI 135,A00,258910,Payne; Christine Anna,0,13,30,30
1683698528027,SOCI 157,A00,258911,Staff,10,0,30,20
1683698529054,SOCI 184,A00,258912,Staff,25,0,30,5
1683698530079,SOCI 188D,A00,258913,Staff,22,0,30,8
1683698531103,SYN 2,001,187529,Staff,9,0,16,7
1683698531103,SYN 2,002,201452,Staff,0,20,16,16
1683698531103,SYN 2,003,201469,Staff,1,0,16,15
1683698532132,SYN 100,A01,187531,Staff,0,9,20,20
1683698532132,SYN 100,B01,201491,Staff,0,10,20,20
1683698533160,TDAC 1,A00,189286,Walsh; Kim C.,3,0,20,17
1683698533160,TDAC 1,B00,189287,Harting; Carla Kelso,10,0,20,10
1683698534192,TDAC 101,A00,189300,Walsh; Kim C.,16,0,20,4
1683698534192,TDAC 101,B00,189301,Harting; Carla Kelso,18,0,20,2
1683698535216,TDAC 102,A00,189304,Basso; Beatrice,14,0,20,6
1683698536239,TDAC 108,A00,189305,Staff,18,0,20,2
1683698537265,TDDE 131,A00,189310,Staff,19,0,20,1
1683698537265,TDDE 131,B00,189314,Staff,19,0,20,1
1683698537265,TDDE 131,C00,189315,Staff,48,0,50,2
1683698537265,TDDE 131,D00,189316,Staff,14,0,15,1
1683698537265,TDDE 131,E00,204841,Staff,20,0,20,0
1683698538293,TDGE 10,A00,189289,Staff,27,0,50,23
1683698538293,TDGE 10,B00,189290,Havis; Allan,0,1,50,50
1683698539318,TDGE 11,A00,189291,Fulton; Julia,0,4,50,50
1683698539318,TDGE 11,B00,189292,Staff,20,0,25,5
1683698539318,TDGE 11,C00,260270,Staff,0,0,0,0
1683698540345,TDGE 25,A00,189294,Staff,1,0,20,19
1683698541373,TDGE 124,A00,189318,Fulton; Julia,0,7,50,50
1683698542409,TDGE 125,A00,189319,Staff,13,0,25,12
1683698542409,TDGE 125,B00,189320,Staff,23,0,25,2
1683698543434,TDGE 127,A00,189322,Havis; Allan,0,0,50,50
1683698544463,TDHT 101,A00,189323,Staff,18,0,25,7
1683698544463,TDHT 101,B00,189324,Staff,25,0,25,0
1683698545497,TDHT 102,A00,189325,Staff,49,0,50,1
1683698546524,TDMV 1,A00,189295,Arcidiacono; Kristin,20,0,30,10
1683698546524,TDMV 1,B00,189296,Caligagan; Maria T.,24,0,30,6
1683698547574,TDMV 2,A00,189297,Sammartano; Tonnie,27,0,30,3
1683698547574,TDMV 2,B00,189299,Arcidiacono; Kristin,23,0,30,7
1683698548601,TDMV 3,A00,204998,Rincon; Alicia,22,0,30,8
1683698549626,TDMV 120,A00,189458,Sammartano; Tonnie,28,0,30,2
1683698550650,TDMV 138,A00,189541,Jun; Grace Shin Hae,20,0,40,20
1683698551675,TDMV 142,A00,189717,Caligagan; Tony,25,0,30,5
1683698551675,TDMV 142,B00,189718,Caligagan; Maria T.,25,0,30,5
1683698552700,TMC 2,A01,187533,Staff,25,0,25,0
1683698552700,TMC 2,A02,187534,Staff,25,0,25,0
1683698553724,USP 1,A01,187536,Kwak; Nancy,0,16,25,25
1683698554749,USP 5,A01,187538,Staff,8,0,25,17
1683698555773,USP 101,A00,199253,Staff,0,4,0,0
1683698556911,USP 124,A00,187562,Boomhower; Matthew Charles,0,0,30,30
1683698557936,USP 138,A00,187582,Staff,19,0,25,6
1683698558963,USP 152,A01,187597,Staff,3,0,25,22
1683698559991,USP 153,A00,187598,Staff,18,0,25,7
1683698561020,USP 168,A00,187607,Kwak; Nancy,2,0,5,3
1683698562046,USP 173,A00,187619,Staff,4,0,25,21
1683698563069,USP 181,A00,187638,Staff,0,4,25,25
1683698564098,VIS 103,A00,187650,Cruz; Edwin Teddy,17,0,75,58
1683698565123,VIS 110D,A00,187669,Staff,13,0,22,9
1683698566147,VIS 127C,A00,187720,Shen; Kuiyi,67,0,146,79
1683698567173,VIS 149,A00,187731,Yoldas; Pinar,0,12,22,22
1683698568198,VIS 151,A01,188091,Staff,22,0,34,12
1683698568198,VIS 151,A02,188092,Staff,11,0,34,23
1683698569224,VIS 160B,A00,188093,Stalbaum; Brett,0,1,10,10
1683698571287,WCWP 10B,A00,201720,Staff,0,0,5,5
1683698571287,WCWP 10B,B00,201722,Staff,0,0,6,6
1683698572316,WCWP 100,A00,201725,Gagnon; Jeffrey C,0,0,2,2
1683698572316,WCWP 100,B00,201727,Staff,0,4,15,15
1683698575475,ANBI 133,A00,258401,Wilder; Linnea Lorene,34,0,40,6
1683698576501,ANBI 140,A00,258395,Hrvoj Mihic; Branka,18,0,25,7
1683698577525,ANSC 120,A00,258402,Bialecki; Jon Anthony,26,0,40,14
1683698578550,ANSC 144,A00,258400,Staff,12,0,40,28
1683698580613,ANSC 166,A00,258396,Parish; Steven Martin,156,0,175,19
1683698581640,ANSC 180,A00,193533,Staff,8,0,20,12
1683698582670,ANSC 188,A00,258397,Jassal; Aftab,34,0,40,6
1683698583694,ANTH 3,A01,258316,Staff,23,0,30,7
1683698584718,ANTH 5,A00,258394,Semendeferi; Ekaterini,16,0,20,4
1683698585749,ANTH 21,A01,258331,Staff,4,0,40,36
1683698586777,ANTH 103,A00,258398,Varma; Saiba,15,0,25,10
1683698587813,AWP 10,001,202034,Staff,0,0,0,0
1683698587813,AWP 10,002,202035,Staff,0,0,0,0
1683698587813,AWP 10,003,202036,Staff,0,0,0,0
1683698587813,AWP 10,004,202037,Staff,0,0,0,0
1683698587813,AWP 10,005,202038,Staff,0,0,0,0
1683698587813,AWP 10,006,202039,Staff,0,0,0,0
1683698587813,AWP 10,007,202040,Staff,0,0,0,0
1683698587813,AWP 10,008,202041,Staff,0,0,0,0
1683698587813,AWP 10,009,202042,Staff,0,0,0,0
1683698587813,AWP 10,010,202043,Staff,0,0,0,0
1683698587813,AWP 10,011,202044,Staff,0,0,0,0
1683698587813,AWP 10,012,202045,Staff,0,0,0,0
1683698587813,AWP 10,013,202046,Staff,0,0,0,0
1683698587813,AWP 10,014,202047,Staff,0,0,0,0
1683698587813,AWP 10,015,202048,Staff,0,0,0,0
1683698587813,AWP 10,016,202049,Staff,0,0,0,0
1683698587813,AWP 10,017,202050,Staff,0,0,0,0
1683698587813,AWP 10,018,202051,Staff,0,0,0,0
1683698587813,AWP 10,019,202052,Staff,0,0,0,0
1683698587813,AWP 10,020,202053,Staff,0,0,0,0
1683698587813,AWP 10,021,202054,Staff,0,0,0,0
1683698587813,AWP 10,022,202055,Staff,0,0,0,0
1683698587813,AWP 10,023,202056,Staff,0,0,0,0
1683698587813,AWP 10,024,202057,Staff,0,0,0,0
1683698587813,AWP 10,025,202058,Staff,0,0,0,0
1683698587813,AWP 10,026,202059,Staff,0,0,0,0
1683698588840,AWP 102,001,202032,Staff,0,0,0,0
1683698588840,AWP 102,002,202033,Staff,0,0,0,0
1683698589867,BENG 100,A01,254234,Taylor Amos; Alyssa C,31,0,40,9
1683698590896,BENG 196,001,270013,Engler; Adam J.,9999,0,9999,0
1683698591930,BICD 100R,A01,202018,Smith; Laurie,0,7,32,32
1683698591930,BICD 100R,A02,202019,Smith; Laurie,0,3,32,32
1683698591930,BICD 100R,A03,202020,Smith; Laurie,0,1,32,32
1683698591930,BICD 100R,A04,202021,Smith; Laurie,6,0,32,26
1683698591930,BICD 100R,A05,202022,Smith; Laurie,10,0,32,22
1683698592954,BICD 136,A01,193242,Gustafson-Brown; Cindy,0,2,32,32
1683698592954,BICD 136,A02,193244,Gustafson-Brown; Cindy,13,0,32,19
1683698593985,BIEB 102,A01,193249,Butler; Shannon Rhey,0,0,32,32
1683698593985,BIEB 102,A02,193251,Butler; Shannon Rhey,0,0,32,32
1683698593985,BIEB 102,A03,193253,Butler; Shannon Rhey,0,0,32,32
1683698593985,BIEB 102,A04,193255,Butler; Shannon Rhey,13,0,32,19
1683698593985,BIEB 102,A05,193265,Butler; Shannon Rhey,25,0,32,7
1683698593985,BIEB 102,A06,193269,Butler; Shannon Rhey,12,0,32,20
1683698596034,BIEB 150,A01,193274,Staff,0,0,32,32
1683698596034,BIEB 150,A02,193285,Staff,24,0,32,8
1683698597062,BIEB 194,A00,193286,Kurle; Carolyn M.,19,0,32,13
1683698598095,BILD 1,A01,192291,Staff,15,0,32,17
1683698598095,BILD 1,A02,192292,Staff,30,0,32,2
1683698598095,BILD 1,B01,192520,Reuther; Keefe,0,1,0,0
1683698598095,BILD 1,B02,192532,Reuther; Keefe,0,1,0,0
1683698599127,BILD 3,A01,192556,Butler; Shannon Rhey,0,0,32,32
1683698599127,BILD 3,A02,192581,Butler; Shannon Rhey,0,1,32,32
1683698599127,BILD 3,A03,192611,Butler; Shannon Rhey,19,0,32,13
1683698599127,BILD 3,A04,192612,Butler; Shannon Rhey,23,0,32,9
1683698599127,BILD 3,A05,192613,Butler; Shannon Rhey,26,0,32,6
1683698599127,BILD 3,A06,192679,Butler; Shannon Rhey,27,0,32,5
1683698599127,BILD 3,A07,192682,Butler; Shannon Rhey,20,0,32,12
1683698600153,BILD 4,A01,192836,Reuther; Keefe,1,0,24,23
1683698600153,BILD 4,A02,193044,Reuther; Keefe,4,0,24,20
1683698601242,BILD 10,A01,193142,Gustafson-Brown; Cindy,29,0,32,3
1683698601242,BILD 10,A02,193149,Gustafson-Brown; Cindy,31,0,32,1
1683698602272,BIMM 100,A01,193301,Staff,0,6,32,32
1683698602272,BIMM 100,A02,193312,Staff,0,7,32,32
1683698602272,BIMM 100,A03,193323,Staff,0,10,32,32
1683698603301,BIMM 101,A01,193329,McDonnell; Lisa Marie,0,3,24,24
1683698603301,BIMM 101,A02,193339,McDonnell; Lisa Marie,0,3,24,24
1683698603301,BIMM 101,B01,193354,McDonnell; Lisa Marie,0,4,24,24
1683698603301,BIMM 101,B02,193357,McDonnell; Lisa Marie,0,3,24,24
1683698604330,BIMM 110,A01,193377,Tat; John,0,11,32,32
1683698604330,BIMM 110,A02,193378,Tat; John,0,11,32,32
1683698605358,BIMM 120,A01,206116,Staff,0,0,32,32
1683698605358,BIMM 120,A02,206117,Staff,7,0,32,25
1683698605358,BIMM 120,A03,206121,Staff,21,0,32,11
1683698606383,BIPN 100,A01,193393,Park; Ji Young,0,15,32,32
1683698606383,BIPN 100,A02,193402,Park; Ji Young,0,14,32,32
1683698606383,BIPN 100,A03,193413,Park; Ji Young,0,14,32,32
1683698606383,BIPN 100,A04,193414,Park; Ji Young,0,13,32,32
1683698607407,BIPN 102,A01,193429,Staff,0,0,32,32
1683698607407,BIPN 102,A02,193438,Staff,18,0,32,14
1683698608435,BIPN 106,A01,193450,Reyes Gonzalez; Catalina,0,2,40,40
1683698609464,BIPN 134,A01,193465,Cooke; James Edward,0,0,32,32
1683698609464,BIPN 134,A02,193474,Cooke; James Edward,25,0,32,7
1683698609464,BIPN 134,A03,193485,Cooke; James Edward,29,0,32,3
1683698609464,BIPN 134,A04,193486,Cooke; James Edward,20,0,32,12
1683698609464,BIPN 134,A05,193491,Cooke; James Edward,31,0,32,1
1683698609464,BIPN 134,A06,193501,Cooke; James Edward,30,0,32,2
1683698609464,BIPN 134,A07,193510,Cooke; James Edward,29,0,32,3
1683698611520,BISP 194,A00,222522,Staff,14,0,32,18
1683698612548,CAT 124,A01,202407,Staff,19,0,25,6
1683698613696,CAT 125,A00,202408,Marchisotto; Jennifer Anne,2,0,20,18
1683698614719,CAT 125R,A00,202409,Smith; Lauryn Alissa,0,11,20,20
1683698614719,CAT 125R,B00,202410,Morales; Celeste Georgianna,0,11,20,20
1683698614719,CAT 125R,C00,202411,Irwin; Matthew Joseph,0,12,20,20
1683698615758,CENG 15,A01,204712,Yang; Kesong,0,1,0,0
1683698616783,CENG 114,A00,202070,Jahed Motlagh; Zeinab,5,0,20,15
1683698617810,CGS 105,A00,185477,Wesling; Megan E.,24,0,40,16
1683698618835,CGS 106,A00,185494,Staff,11,0,22,11
1683698619862,CGS 108,A00,185495,Staff,14,0,20,6
1683698620887,CGS 114,A00,185496,Staff,13,0,18,5
1683698621917,CGS 119,A00,185501,Staff,15,0,20,5
1683698622941,CGS 120,A00,185511,Staff,12,0,20,8
1683698623966,CHEM 4,A01,184675,Bussey; Thomas J,97,0,100,3
1683698624995,CHEM 6A,A01,184677,Staff,32,0,60,28
1683698626023,CHEM 6B,A01,184679,Staff,63,0,100,37
1683698627050,CHEM 6C,A01,184681,Bussey; Thomas J,0,0,50,50
1683698627050,CHEM 6C,A02,184682,Bussey; Thomas J,32,0,50,18
1683698628075,CHEM 40A,A01,184684,Albizati; Kim F.,33,0,100,67
1683698629101,CHEM 40B,A01,184686,Albizati; Kim F.,0,22,100,100
1683698630125,CHEM 41B,A01,184690,Staff,51,0,100,49
1683698631152,COGS 3,A01,184715,Boyle; Mary E. T.,0,27,40,40
1683698632181,COGS 14B,A01,185172,Staff,0,14,38,38
1683698633215,COGS 18,A01,184736,Staff,14,0,80,66
1683698634247,COGS 100,A01,184932,Staff,0,8,73,73
1683698635274,COGS 101A,A01,184935,Staff,0,40,30,30
1683698636310,COGS 101B,A01,184944,Staff,0,2,30,30
1683698637338,COGS 101C,A01,184946,Staff,0,10,30,30
1683698638366,COGS 102A,A01,184951,Johnson; Christine M.,1,0,40,39
1683698639393,COGS 107B,A01,184953,Mooshagian; Eric Frederick,0,52,40,40
1683698640418,COGS 118B,A01,184959,Gupta; Anjum,0,50,40,40
1683698641441,COGS 153,A00,184961,Staff,1,16,30,29
1683698642467,COGS 177,A00,184962,Staff,0,20,30,30
1683698643497,COGS 187A,A01,184969,Boyle; Mary E. T.,0,19,40,40
1683698644525,COMM 10,A01,185174,Staff,0,5,25,25
1683698644525,COMM 10,A02,185189,Staff,0,2,25,25
1683698644525,COMM 10,A03,269821,Staff,0,1,0,0
1683698645552,COMM 100B,A02,185476,Staff,10,0,25,15
1683698645552,COMM 100B,A03,277340,Staff,25,0,25,0
1683698646580,COMM 100C,A01,185314,Staff,2,0,25,23
1683698646580,COMM 100C,A02,185327,Staff,17,0,25,8
1683698647605,COMM 110M,A00,185349,Staff,0,0,40,40
1683698648630,COMM 113T,A00,185352,Staff,25,0,40,15
1683698649659,COMM 114I,A00,185353,Staff,31,0,40,9
1683698650686,COMM 131,A00,185354,Staff,17,0,30,13
1683698651712,CSE 8A,A50,185358,Cao; Yingjun,0,46,10,10
1683698652741,CSE 8B,A01,185362,Staff,0,48,50,50
1683698653766,CSE 11,A01,185416,Cao; Yingjun,0,91,10,10
1683698654790,CSE 20,A01,185445,Briones; Jor-el Thomas Caparas,3,0,25,22
1683698655813,CSE 21,A01,185447,Staff,9,0,50,41
1683698656838,CSE 101,A01,185451,Staff,0,13,50,50
1683698656838,CSE 101,B01,185453,Jones; Miles E,0,14,50,50
1683698658886,CSE 141,A01,185458,Eldon; John,16,0,100,84
1683698659913,CSE 141L,A01,185461,Eldon; John,8,0,100,92
1683698660938,CSE 142,A01,185463,Staff,34,0,60,26
1683698660938,CSE 142,B01,201355,Staff,0,7,60,60
1683698661968,CSE 142L,A01,185470,Staff,34,0,60,26
1683698661968,CSE 142L,B01,201417,Staff,0,6,60,60
1683698662991,CSE 190,A00,201433,Staff,32,0,49,17
1683698664016,DOC 1,A01,259136,Strom; Megan C.,7,0,15,8
1683698664016,DOC 1,A02,259137,Strom; Megan C.,14,0,15,1
1683698664016,DOC 1,A03,259138,Strom; Megan C.,14,0,15,1
1683698664016,DOC 1,A04,259139,Strom; Megan C.,14,0,15,1
1683698665040,DOC 100D,A00,259140,Pass; Natalye Joann,14,0,25,11
1683698666064,DSGN 1,A01,184749,Rill; Bryan,0,26,30,30
1683698667088,DSGN 100,A01,185168,Staff,0,2,25,25
1683698668111,ECE 5,A01,185626,Morris; Karcher William,0,12,0,0
1683698669137,ECE 101,A01,185628,Staff,14,0,70,56
1683698670161,ECE 107,A01,185635,Baghdadchi; Saharnaz,0,0,20,20
1683698670161,ECE 107,A02,185638,Baghdadchi; Saharnaz,1,0,20,19
1683698671185,ECE 148,A01,185647,Silberman; Jack,0,0,16,16
1683698672209,ECON 1,A01,185537,Crane; Meredith Helen,54,0,70,16
1683698673239,ECON 3,A01,185549,Crane; Meredith Helen,30,0,70,40
1683698674261,ECON 4,A01,203354,Anderson; John Charles,0,5,10,10
1683698675285,ECON 100A,A01,185574,Staff,0,5,40,40
1683698676310,ECON 100B,A01,185576,Staff,0,12,50,50
1683698677333,ECON 100C,A01,185589,Newhouse; Herbert S,30,0,70,40
1683698678358,ECON 105,A00,185608,Vespa; Emanuel Ignacio,19,0,35,16
1683698679385,ECON 109,A01,185610,Shishkin; Denis,9,0,35,26
1683698680412,ECON 110A,A01,185612,Staff,8,0,40,32
1683698681435,ECON 120A,A01,185615,Staff,19,0,40,21
1683698682458,ECON 120C,A01,185617,Sun; Yixiao,0,21,70,70
1683698683483,ECON 144,A00,203346,Squires; Dale E,2,0,35,33
1683698684510,ECON 171,A01,203349,Newhouse; Herbert S,0,1,35,35
1683698685542,ECON 173A,A01,185621,Toda; Alexis Akira,21,0,35,14
1683698686579,EDS 25,A01,202413,Staff,0,1,0,0
1683698686579,EDS 25,A02,202414,Staff,0,1,0,0
1683698686579,EDS 25,A03,202415,Staff,0,0,0,0
1683698686579,EDS 25,A04,202416,Staff,0,1,0,0
1683698686579,EDS 25,A05,202439,Staff,0,0,0,0
1683698686579,EDS 25,A06,202440,Staff,0,0,0,0
1683698686579,EDS 25,B01,202631,Staff,0,0,0,0
1683698686579,EDS 25,B02,202632,Staff,0,0,0,0
1683698686579,EDS 25,B03,202639,Staff,0,0,0,0
1683698686579,EDS 25,B04,202640,Staff,0,0,0,0
1683698686579,EDS 25,B05,202643,Staff,0,0,0,0
1683698686579,EDS 25,B06,202644,Staff,0,0,0,0
1683698687609,EDS 38,A01,202659,Black; Alison Michelle,24,0,25,1
1683698688638,EDS 115,A00,202652,Staff,18,0,30,12
1683698689662,EDS 125,A00,202649,Staff,13,0,30,17
1683698690688,EDS 126,A01,203332,Staff,30,0,30,0
1683698691718,EDS 139,A00,202838,Staff,16,0,25,9
1683698692742,EDS 146,A01,202655,Staff,14,0,25,11
1683698693776,ENG 15,A00,185667,Staff,0,1,0,0
1683698693776,ENG 15,B00,185672,Staff,0,0,0,0
1683698693776,ENG 15,C00,185675,Staff,0,0,0,0
1683698693776,ENG 15,D00,185682,Staff,0,0,0,0
1683698693776,ENG 15,E00,185684,Staff,0,0,0,0
1683698694800,ETHN 103,A00,185710,Staff,0,8,35,35
1683698695829,ETHN 103A,A00,199228,Man; Simeon S,0,0,9,9
1683698696854,ETHN 109,A00,185711,Staff,15,0,35,20
1683698697882,ETHN 142,A00,185726,Staff,0,4,30,30
1683698698911,ETHN 163J,A00,199229,Man; Simeon S,5,0,8,3
1683698699937,ETHN 168,A00,185727,Staff,7,0,10,3
1683698700964,ETHN 182,A00,185728,Staff,0,0,35,35
1683698701990,ETHN 183,A00,185737,Staff,9,0,18,9
1683698703014,GLBH 111,A01,209361,Burgos; Jose L.,0,0,0,0
1683698705123,HIEU 104,A00,185792,Staff,14,0,20,6
1683698706149,HIEU 115,A00,185800,Staff,0,0,20,20
1683698707177,HIEU 128,A00,185801,Staff,0,9,20,20
1683698708204,HIEU 147,A00,185802,Staff,15,0,20,5
1683698709228,HIEU 154,A00,185823,Staff,11,0,20,9
1683698710261,HILA 102,A00,185826,Staff,14,0,20,6
1683698711288,HILD 2C,A01,185778,Staff,0,13,20,20
1683698712313,HILD 7B,A01,185780,Kwak; Nancy,0,17,32,32
1683698712313,HILD 7B,A02,185781,Kwak; Nancy,0,18,32,32
1683698713338,HILD 30,A01,185791,Staff,12,0,20,8
1683698714361,HISC 119,A00,185830,Golan; Tal,0,10,20,20
1683698715386,HITO 156GS,A00,185831,Patterson; Patrick H.,0,0,0,23
1683698716410,HIUS 103,A00,185832,Man; Simeon S,0,4,20,20
1683698717434,HIUS 117,A00,185836,Kwak; Nancy,2,0,20,18
1683698718458,HIUS 125,A00,185840,Man; Simeon S,0,2,23,23
1683698719486,HIUS 149,A00,185845,Staff,1,0,20,19
1683698720515,HUM 3,A01,185882,Zavodny; Tatiana Sophia,0,8,50,50
1683698720515,HUM 3,B01,185899,Caldwell; Michael Alan,0,18,50,50
1683698721542,HUM 3GS,A00,185900,Patterson; Patrick H.,0,0,0,23
1683698722573,HUM 4,A01,185938,Zroka; Amy Liane,28,0,50,22
1683698722573,HUM 4,B01,185956,Watkins; Eric,0,6,50,50
1683698722573,HUM 4,B02,202209,Watkins; Eric,0,5,50,50
1683698722573,HUM 4,B03,202210,Watkins; Eric,0,5,50,50
1683698723598,HUM 5,A01,185958,West; Geoffrey Scott,0,0,50,50
1683698723598,HUM 5,A02,202215,West; Geoffrey Scott,0,1,50,50
1683698724623,INTL 190,A00,185959,Gagnon; Jeffrey C,0,0,0,9
1683698724623,INTL 190,B00,185960,Lettieri; Michael Joseph,0,0,0,2
1683698725647,JAPN 180,A00,254509,Staff,5,0,30,25
1683698726672,LATI 10,A01,202853,Kennemore; Amy Michelle,4,0,35,31
1683698726672,LATI 10,A02,202854,Kennemore; Amy Michelle,3,0,35,32
1683698726672,LATI 10,A03,270054,Kennemore; Amy Michelle,30,0,30,0
1683698727699,LATI 180,A00,202855,Kennemore; Amy Michelle,11,0,20,9
1683698728727,LAWS 101,A00,201767,Golan; Tal,0,7,40,40
1683698729753,LIFR 1C,A00,185961,Staff,6,0,20,14
1683698730777,LIFR 1CX,A00,185962,Staff,7,0,20,13
1683698731802,LIFR 1D,A00,185963,Staff,7,0,20,13
1683698732825,LIFR 1DX,A00,185964,Staff,7,0,20,13
1683698733849,LIGN 101,A01,186039,Staff,43,0,50,7
1683698734873,LIGN 165,A00,186040,Staff,15,0,50,35
1683698735900,LTCS 108,A00,186041,Staff,5,0,10,5
1683698736927,LTCS 119,A00,186042,Staff,15,0,20,5
1683698737951,LTCS 130,A00,186043,Wesling; Megan E.,15,0,25,10
1683698740004,LTEA 138,A00,186119,Staff,14,0,40,26
1683698741032,LTEN 124,A00,186148,Staff,5,0,25,20
1683698742059,LTEN 178,A00,186149,Staff,6,0,15,9
1683698743088,LTEN 181,A00,186150,Blanco; John D,34,0,40,6
1683698744115,LTWL 120,A00,186160,Staff,19,0,25,6
1683698745142,LTWL 165,A00,186161,Staff,22,0,25,3
1683698746167,LTWR 100,A00,186162,Staff,0,5,15,15
1683698747191,LTWR 102,A00,186163,Doller; Ben,5,0,15,10
1683698748218,MAE 8,A01,186412,Staff,0,1,0,0
1683698749246,MAE 30B,A00,186445,Bahadori; Mohammad Yousef,81,0,100,19
1683698750274,MAE 40,A00,186592,Bewley; Thomas R,10,0,50,40
1683698751301,MAE 101B,A00,186593,Bahadori; Mohammad Yousef,80,0,100,20
1683698752329,MAE 105,A00,186594,Bandaru; Prabhakar,10,0,50,40
1683698753354,MAE 107,A00,186599,Pham; Hieu Tan,0,8,120,120
1683698754378,MAE 148,A01,186660,Silberman; Jack,3,0,16,13
1683698755404,MATH 10A,A01,188095,Staff,0,6,35,35
1683698756430,MATH 10B,A01,188097,Bowers; Adam R.,0,12,30,30
1683698756430,MATH 10B,A02,188099,Bowers; Adam R.,0,11,30,30
1683698756430,MATH 10B,B01,188104,Bowers; Adam R.,0,10,30,30
1683698756430,MATH 10B,B02,188106,Bowers; Adam R.,0,9,30,30
1683698757455,MATH 10C,A01,188111,Staff,0,20,30,30
1683698757455,MATH 10C,A02,188127,Staff,0,19,30,30
1683698757455,MATH 10C,A03,188131,Staff,0,19,30,30
1683698757455,MATH 10C,B01,188218,Staff,17,0,30,13
1683698757455,MATH 10C,B02,188244,Staff,13,0,30,17
1683698757455,MATH 10C,B03,188277,Staff,14,0,30,16
1683698758480,MATH 18,A01,188344,Bach; Quang Tran,18,0,30,12
1683698758480,MATH 18,A02,188345,Bach; Quang Tran,11,0,30,19
1683698758480,MATH 18,B01,188353,Bach; Quang Tran,11,0,30,19
1683698758480,MATH 18,B02,188354,Bach; Quang Tran,19,0,30,11
1683698759506,MATH 20A,A01,188374,Staff,11,0,35,24
1683698760531,MATH 20B,A01,188382,Ohm; Ko Woon,7,0,30,23
1683698760531,MATH 20B,A02,188383,Ohm; Ko Woon,22,0,30,8
1683698760531,MATH 20B,B01,188385,Ohm; Ko Woon,7,0,30,23
1683698760531,MATH 20B,B02,188392,Ohm; Ko Woon,22,0,30,8
1683698761557,MATH 20C,A01,188394,Harel; Guershon,10,0,30,20
1683698761557,MATH 20C,A02,188395,Harel; Guershon,13,0,30,17
1683698761557,MATH 20C,B01,188404,Harel; Guershon,5,0,30,25
1683698761557,MATH 20C,B02,188405,Harel; Guershon,18,0,30,12
1683698762584,MATH 20D,A01,188414,Hammock; Frances H,0,1,30,30
1683698762584,MATH 20D,A02,188415,Hammock; Frances H,0,1,30,30
1683698762584,MATH 20D,B01,188447,Hammock; Frances H,0,1,30,30
1683698762584,MATH 20D,B02,188486,Hammock; Frances H,2,0,30,28
1683698763610,MATH 20E,A01,188649,Staff,21,0,30,9
1683698763610,MATH 20E,A02,188650,Staff,20,0,30,10
1683698763610,MATH 20E,A03,188673,Staff,0,0,30,30
1683698764634,MATH 102,A01,188675,Staff,0,40,35,35
1683698765660,MATH 103B,A01,188681,Staff,3,0,35,32
1683698765660,MATH 103B,B01,188692,Staff,5,0,35,30
1683698766686,MATH 109,A01,188695,Salehi Golsefidy; Alireza,24,0,35,11
1683698766686,MATH 109,A02,188696,Salehi Golsefidy; Alireza,25,0,35,10
1683698767712,MATH 120A,A01,188698,Eggers; John Dietrich,7,0,35,28
1683698768738,MATH 142B,A01,188736,Ioana; Adrian,0,0,30,30
1683698768738,MATH 142B,A02,188741,Ioana; Adrian,0,1,30,30
1683698768738,MATH 142B,A03,188743,Ioana; Adrian,0,2,30,30
1683698769765,MATH 168A,A01,188790,Staff,0,11,35,35
1683698770795,MATH 170A,A01,188803,Nie; Jiawang,0,2,35,35
1683698770795,MATH 170A,A02,188811,Nie; Jiawang,0,1,35,35
1683698770795,MATH 170A,A03,188814,Nie; Jiawang,0,0,35,35
1683698770795,MATH 170A,A04,188815,Nie; Jiawang,5,0,35,30
1683698771821,MATH 193B,A01,188817,Staff,0,0,35,35
1683698771821,MATH 193B,A02,188818,Staff,6,0,35,29
1683698772852,MGT 4,A01,202857,Anderson; John Charles,59,0,80,21
1683698773880,MGT 12,A00,202858,Lindenberger; Wade Douglas,40,0,90,50
1683698774907,MGT 18,A00,202859,Staff,74,0,90,16
1683698775932,MGT 18GS,A00,202860,McKay; Michael J,13,0,28,15
1683698776960,MGT 45,A00,202861,Pecore; Joseph P.,8,0,90,82
1683698777990,MGT 100,A00,202863,Yavorsky; Daniel Ryan,27,0,90,63
1683698779013,MGT 103,A00,202864,Ehrich; Kristine R,0,19,90,90
1683698780041,MGT 112,A00,202865,Ehrich; Kristine R,15,0,90,75
1683698781069,MGT 121A,A00,202868,Staff,70,0,90,20
1683698782093,MGT 131B,A00,202869,Anderson; John Charles,58,0,90,32
1683698783117,MGT 136,A00,202871,Lindenberger; Wade Douglas,83,0,90,7
1683698784149,MGT 164,A00,202873,Staff,0,67,90,91
1683698785176,MGT 164GS,A00,202874,McKay; Mary A,13,0,28,15
1683698786203,MGT 180,A00,202875,Staff,0,51,90,91
1683698787228,MMW 11R,A01,205019,Herbst; Matthew,0,0,30,30
1683698787228,MMW 11R,A02,205026,Herbst; Matthew,29,0,30,1
1683698788253,MMW 15,A01,193512,Chang; Edmond Yi-Teh,0,8,28,28
1683698788253,MMW 15,A02,193513,Chang; Edmond Yi-Teh,0,5,28,28
1683698788253,MMW 15,A03,193514,Chang; Edmond Yi-Teh,0,5,28,28
1683698788253,MMW 15,A04,193515,Chang; Edmond Yi-Teh,0,5,28,28
1683698788253,MMW 15,A05,193516,Chang; Edmond Yi-Teh,0,5,28,28
1683698788253,MMW 15,A06,193517,Chang; Edmond Yi-Teh,0,6,28,28
1683698788253,MMW 15,B01,193519,Chang; Edmond Yi-Teh,0,5,28,28
1683698788253,MMW 15,B02,193520,Chang; Edmond Yi-Teh,0,5,28,28
1683698788253,MMW 15,B03,193521,Chang; Edmond Yi-Teh,0,5,28,28
1683698788253,MMW 15,B04,193522,Chang; Edmond Yi-Teh,0,6,28,28
1683698788253,MMW 15,B05,193523,Chang; Edmond Yi-Teh,0,5,28,28
1683698788253,MMW 15,B06,193524,Chang; Edmond Yi-Teh,0,5,28,28
1683698789278,MMW 122,A01,193526,Rahimi; Babak,0,16,28,28
1683698789278,MMW 122,A02,193527,Rahimi; Babak,0,15,28,28
1683698789278,MMW 122,A03,193528,Rahimi; Babak,0,0,0,0
1683698789278,MMW 122,A04,193529,Rahimi; Babak,0,0,0,0
1683698790307,MUS 1A,A01,186663,Staff,0,18,35,35
1683698791333,MUS 4,A01,186715,Staff,0,12,35,35
1683698792361,MUS 5R,A01,186796,Dubnov; Shlomo,0,17,35,35
1683698793385,MUS 6,A01,186798,Staff,0,4,25,25
1683698794411,MUS 7,A01,186830,Staff,11,0,35,24
1683698795440,MUS 8,A01,186930,Staff,0,27,35,35
1683698796465,MUS 15,A01,186932,Staff,0,15,35,35
1683698796465,MUS 15,B01,186934,Staff,0,16,35,35
1683698797489,MUS 80,A00,186935,Staff,0,0,20,20
1683698797489,MUS 80,B00,186936,Staff,24,0,25,1
1683698798521,NANO 11,A00,204702,Lipomi; Darren John,0,0,0,0
1683698799546,NANO 15,A01,204709,Yang; Kesong,0,1,0,0
1683698800575,NANO 114,A00,202069,Jahed Motlagh; Zeinab,2,0,10,8
1683698801603,PHIL 1,A00,186955,Grush; Rick Scott,31,0,40,9
1683698802633,PHIL 10,A01,186973,Grush; Rick Scott,27,0,35,8
1683698802633,PHIL 10,A02,186974,Grush; Rick Scott,33,0,35,2
1683698803656,PHIL 13,A01,186976,Staff,1,0,35,34
1683698803656,PHIL 13,A02,186977,Staff,16,0,35,19
1683698804681,PHIL 14,A01,186979,Staff,31,0,35,4
1683698804681,PHIL 14,A02,186986,Staff,32,0,35,3
1683698805705,PHIL 28,A01,186988,Staff,16,0,30,14
1683698805705,PHIL 28,A02,186989,Staff,1,0,30,29
1683698805705,PHIL 28,A03,186990,Staff,10,0,30,20
1683698805705,PHIL 28,A04,186991,Staff,26,0,30,4
1683698806733,PHIL 120,A00,186997,Staff,23,0,40,17
1683698807758,PHIL 137,A00,187003,Staff,7,0,40,33
1683698808849,PHIL 150,A00,187015,Staff,47,0,70,23
1683698809878,PHIL 167,A00,187021,Lamey; Andy M.,34,0,40,6
1683698810911,PHIL 174,A01,202226,Staff,17,0,20,3
1683698810911,PHIL 174,A02,202235,Staff,20,0,20,0
1683698811938,PHIL 191A,A00,258918,Staff,0,0,1,1
1683698812963,PHYS 1A,A00,187028,Staff,26,0,60,34
1683698813991,PHYS 1AL,001,187036,Staff,3,0,30,27
1683698813991,PHYS 1AL,002,187049,Staff,18,0,30,12
1683698815014,PHYS 1B,A00,187058,Staff,21,0,60,39
1683698816040,PHYS 1BL,001,187064,Staff,0,1,30,30
1683698816040,PHYS 1BL,002,187070,Staff,4,0,30,26
1683698817069,PHYS 1C,A00,187082,Staff,30,0,120,90
1683698818094,PHYS 1CL,001,187088,Staff,0,9,30,30
1683698818094,PHYS 1CL,002,187089,Staff,0,1,30,30
1683698818094,PHYS 1CL,009,262693,Staff,9,0,30,21
1683698819122,PHYS 2B,A01,187097,Staff,55,0,115,60
1683698820146,PHYS 2C,A01,187099,Staff,63,0,115,52
1683698821169,PHYS 2CL,A01,187101,Staff,5,0,28,23
1683698821169,PHYS 2CL,A02,187102,Staff,15,0,28,13
1683698822194,PHYS 2D,A01,187123,Shotwell; Brian,95,0,115,20
1683698823222,PHYS 4B,A01,187133,Grinstein; Benjamin,35,0,50,15
1683698824245,POLI 10,A00,188819,Staff,0,4,50,50
1683698825269,POLI 11,A00,188827,Staff,43,0,50,7
1683698826296,POLI 13R,A00,188828,Staff,0,1,20,20
1683698827326,POLI 27,A01,188830,Elgin; Samuel Zincke,0,2,70,70
1683698828350,POLI 30,A00,188832,Desposato; Scott,30,0,50,20
1683698829374,POLI 102F,A00,188834,Staff,1,0,40,39
1683698830399,POLI 104A,A00,188852,Staff,12,0,30,18
1683698831423,POLI 104I,A00,188853,Staff,0,8,20,20
1683698832447,POLI 110B,A00,188854,Wiens; David,6,0,20,14
1683698833471,POLI 112A,A00,188855,Wiens; David,3,0,30,27
1683698834496,POLI 117R,A00,188856,Forman; Fonna,0,12,20,20
1683698835524,POLI 118,A00,188857,Ingham; Sean,8,0,20,12
1683698836548,POLI 120G,A00,188858,Staff,8,0,30,22
1683698837577,POLI 131CR,A00,188863,Hoston; Germaine,20,0,50,30
1683698838605,POLI 133,A00,188864,Nellis; Gareth Hb,44,0,50,6
1683698839632,POLI 134D,A00,188865,Desposato; Scott,27,0,30,3
1683698840657,POLI 142A,A00,188871,Gartzke; Erik,21,0,50,29
1683698841681,POLI 142K,A00,188874,Staff,38,0,50,12
1683698842706,POLI 143,A00,188940,Gartzke; Erik,16,0,30,14
1683698843734,POLI 153,A00,188943,Staff,2,0,20,18
1683698844761,POLI 160AA,A00,188944,Staff,10,0,40,30
1683698845787,POLI 170A,A00,188945,Staff,10,0,30,20
1683698847841,PSYC 1,A00,188952,Staff,36,0,90,54
1683698848866,PSYC 2,B00,188953,Staff,19,0,35,16
1683698849891,PSYC 6,A00,188970,Staff,47,0,60,13
1683698850914,PSYC 7,A00,188973,Staff,35,0,45,10
1683698851941,PSYC 60,A01,188980,Rickard; Timothy C.,42,0,60,18
1683698852964,PSYC 70,A01,189001,Steiner; Eric Tomas,21,0,45,24
1683698853993,PSYC 100,A00,189005,Lacefield; Katharine I,0,98,120,120
1683698855020,PSYC 102,A00,189008,Staff,6,0,30,24
1683698856045,PSYC 106,B00,189026,Gorman; Michael R.,27,0,60,33
1683698857069,PSYC 114,B01,189033,Winkielman; Piotr,0,31,30,30
1683698858094,PSYC 131,A00,189036,Anagnostaras; Stephan,0,44,60,60
1683698859121,PSYC 136,A00,189041,Lowe; Angela Beth,0,7,25,25
1683698860149,PSYC 137,A00,189057,Winkielman; Piotr,0,36,25,25
1683698861176,PSYC 144,A00,189107,Wixted; John T,0,11,50,50
1683698863227,PSYC 162,A00,189142,Staff,0,9,85,85
1683698864250,PSYC 172,A00,189144,Gorman; Michael R.,0,6,30,30
1683698866301,PSYC 179,A00,189146,Lacefield; Katharine I,0,88,120,120
1683698867325,PSYC 181,A00,189147,Anagnostaras; Stephan,0,45,90,90
1683698868349,PSYC 190R,A00,189148,Barner; David A.,0,23,80,80
1683698869373,PSYC 191,A00,189275,Rickard; Timothy C.,0,11,25,25
1683698870398,PSYC 193,A00,189276,Chapman; Eddie Nathaniel,0,1,0,4
1683698871427,PSYC 193L,A01,189281,Lowe; Angela Beth,8,0,20,12
1683698871427,PSYC 193L,B01,189285,Staff,28,0,35,7
1683698872451,RELI 149,A00,187137,Rahimi; Babak,6,0,40,34
1683698873474,SE 9,A01,187315,Staff,0,2,18,18
1683698874502,SE 101B,A00,187409,Staff,24,0,30,6
1683698875529,SE 110B,A00,187444,Staff,10,0,40,30
1683698876554,SE 130B,A00,187449,Staff,31,0,40,9
1683698877580,SE 150A,A00,187516,Staff,8,0,20,12
1683698878605,SE 154,A00,187528,Staff,29,0,50,21
1683698879628,SIO 3,A01,258171,Staff,35,0,40,5
1683698880650,SIO 10,A00,187144,Cook; Geoffrey W,0,6,75,75
1683698881675,SIO 45,A00,187152,Cook; Geoffrey W,0,7,100,100
1683698882702,SIO 109R,A00,194486,Staff,0,4,20,20
1683698884752,SIO 187,A01,187233,Kacev; David,12,0,40,28
1683698885777,SOCI 1,A01,258656,Thorpe; Charles Robert,28,0,30,2
1683698885777,SOCI 1,A02,258658,Thorpe; Charles Robert,30,0,30,0
1683698885777,SOCI 1,A03,258661,Thorpe; Charles Robert,25,0,25,0
1683698885777,SOCI 1,A04,258666,Thorpe; Charles Robert,22,0,25,3
1683698885777,SOCI 1,A05,258897,Thorpe; Charles Robert,22,0,25,3
1683698885777,SOCI 1,A06,258898,Thorpe; Charles Robert,25,0,25,0
1683698886801,SOCI 30,A01,258903,Pardo Guerra; Juan Pablo,14,0,30,16
1683698887825,SOCI 102,A00,258904,Staff,9,0,25,16
1683698888853,SOCI 106,A00,258905,Staff,19,0,25,6
1683698889889,SOCI 111,A00,258907,Ribas Norris; Janet Vanesa,26,0,30,4
1683698890913,SOCI 121R,A00,258908,Pardo Guerra; Juan Pablo,7,0,30,23
1683698891938,SOCI 126,A01,203330,Staff,14,0,20,6
1683698892969,SOCI 131,A00,258909,Thorpe; Charles Robert,30,0,60,30
1683698893998,SOCI 135,A00,258910,Payne; Christine Anna,0,13,30,30
1683698895025,SOCI 157,A00,258911,Staff,10,0,30,20
1683698896051,SOCI 184,A00,258912,Staff,25,0,30,5
1683698897079,SOCI 188D,A00,258913,Staff,22,0,30,8
1683698898102,SYN 2,001,187529,Staff,9,0,16,7
1683698898102,SYN 2,002,201452,Staff,0,20,16,16
1683698898102,SYN 2,003,201469,Staff,1,0,16,15
1683698899127,SYN 100,A01,187531,Staff,0,9,20,20
1683698899127,SYN 100,B01,201491,Staff,0,10,20,20
1683698900155,TDAC 1,A00,189286,Walsh; Kim C.,3,0,20,17
1683698900155,TDAC 1,B00,189287,Harting; Carla Kelso,10,0,20,10
1683698901178,TDAC 101,A00,189300,Walsh; Kim C.,16,0,20,4
1683698901178,TDAC 101,B00,189301,Harting; Carla Kelso,18,0,20,2
1683698902206,TDAC 102,A00,189304,Basso; Beatrice,14,0,20,6
1683698903235,TDAC 108,A00,189305,Staff,18,0,20,2
1683698904264,TDDE 131,A00,189310,Staff,19,0,20,1
1683698904264,TDDE 131,B00,189314,Staff,19,0,20,1
1683698904264,TDDE 131,C00,189315,Staff,48,0,50,2
1683698904264,TDDE 131,D00,189316,Staff,14,0,15,1
1683698904264,TDDE 131,E00,204841,Staff,20,0,20,0
1683698905289,TDGE 10,A00,189289,Staff,27,0,50,23
1683698905289,TDGE 10,B00,189290,Havis; Allan,0,1,50,50
1683698906314,TDGE 11,A00,189291,Fulton; Julia,0,4,50,50
1683698906314,TDGE 11,B00,189292,Staff,20,0,25,5
1683698906314,TDGE 11,C00,260270,Staff,0,0,0,0
1683698907337,TDGE 25,A00,189294,Staff,1,0,20,19
1683698908364,TDGE 124,A00,189318,Fulton; Julia,0,7,50,50
1683698909401,TDGE 125,A00,189319,Staff,13,0,25,12
1683698909401,TDGE 125,B00,189320,Staff,23,0,25,2
1683698910425,TDGE 127,A00,189322,Havis; Allan,0,0,50,50
1683698911449,TDHT 101,A00,189323,Staff,18,0,25,7
1683698911449,TDHT 101,B00,189324,Staff,25,0,25,0
1683698912536,TDHT 102,A00,189325,Staff,49,0,50,1
1683698913561,TDMV 1,A00,189295,Arcidiacono; Kristin,20,0,30,10
1683698913561,TDMV 1,B00,189296,Caligagan; Maria T.,24,0,30,6
1683698914591,TDMV 2,A00,189297,Sammartano; Tonnie,27,0,30,3
1683698914591,TDMV 2,B00,189299,Arcidiacono; Kristin,23,0,30,7
1683698915616,TDMV 3,A00,204998,Rincon; Alicia,22,0,30,8
1683698916641,TDMV 120,A00,189458,Sammartano; Tonnie,28,0,30,2
1683698917665,TDMV 138,A00,189541,Jun; Grace Shin Hae,20,0,40,20
1683698918694,TDMV 142,A00,189717,Caligagan; Tony,25,0,30,5
1683698918694,TDMV 142,B00,189718,Caligagan; Maria T.,25,0,30,5
1683698919718,TMC 2,A01,187533,Staff,25,0,25,0
1683698919718,TMC 2,A02,187534,Staff,25,0,25,0
1683698920746,USP 1,A01,187536,Kwak; Nancy,0,16,25,25
1683698921770,USP 5,A01,187538,Staff,8,0,25,17
1683698922797,USP 101,A00,199253,Staff,0,4,0,0
1683698923831,USP 124,A00,187562,Boomhower; Matthew Charles,0,0,30,30
1683698924855,USP 138,A00,187582,Staff,19,0,25,6
1683698925885,USP 152,A01,187597,Staff,3,0,25,22
1683698926909,USP 153,A00,187598,Staff,18,0,25,7
1683698927933,USP 168,A00,187607,Kwak; Nancy,2,0,5,3
1683698928956,USP 173,A00,187619,Staff,4,0,25,21
1683698929981,USP 181,A00,187638,Staff,0,4,25,25
1683698931008,VIS 103,A00,187650,Cruz; Edwin Teddy,17,0,75,58
1683698932036,VIS 110D,A00,187669,Staff,13,0,22,9
1683698933060,VIS 127C,A00,187720,Shen; Kuiyi,67,0,146,79
1683698934086,VIS 149,A00,187731,Yoldas; Pinar,0,12,22,22
1683698935109,VIS 151,A01,188091,Staff,22,0,34,12
1683698935109,VIS 151,A02,188092,Staff,11,0,34,23
1683698936138,VIS 160B,A00,188093,Stalbaum; Brett,0,1,10,10
1683698938191,WCWP 10B,A00,201720,Staff,0,0,5,5
1683698938191,WCWP 10B,B00,201722,Staff,0,0,6,6
1683698939219,WCWP 100,A00,201725,Gagnon; Jeffrey C,0,0,2,2
1683698939219,WCWP 100,B00,201727,Staff,0,4,15,15
1683698942345,ANBI 133,A00,258401,Wilder; Linnea Lorene,34,0,40,6
1683698943371,ANBI 140,A00,258395,Hrvoj Mihic; Branka,18,0,25,7
1683698944395,ANSC 120,A00,258402,Bialecki; Jon Anthony,26,0,40,14
1683698945420,ANSC 144,A00,258400,Staff,12,0,40,28
1683698947477,ANSC 166,A00,258396,Parish; Steven Martin,156,0,175,19
1683698948506,ANSC 180,A00,193533,Staff,8,0,20,12
1683698949531,ANSC 188,A00,258397,Jassal; Aftab,34,0,40,6
1683698950555,ANTH 3,A01,258316,Staff,23,0,30,7
1683698951579,ANTH 5,A00,258394,Semendeferi; Ekaterini,16,0,20,4
1683698952607,ANTH 21,A01,258331,Staff,4,0,40,36
1683698953639,ANTH 103,A00,258398,Varma; Saiba,15,0,25,10
1683698954664,AWP 10,001,202034,Staff,0,0,0,0
1683698954664,AWP 10,002,202035,Staff,0,0,0,0
1683698954664,AWP 10,003,202036,Staff,0,0,0,0
1683698954664,AWP 10,004,202037,Staff,0,0,0,0
1683698954664,AWP 10,005,202038,Staff,0,0,0,0
1683698954664,AWP 10,006,202039,Staff,0,0,0,0
1683698954664,AWP 10,007,202040,Staff,0,0,0,0
1683698954664,AWP 10,008,202041,Staff,0,0,0,0
1683698954664,AWP 10,009,202042,Staff,0,0,0,0
1683698954664,AWP 10,010,202043,Staff,0,0,0,0
1683698954664,AWP 10,011,202044,Staff,0,0,0,0
1683698954664,AWP 10,012,202045,Staff,0,0,0,0
1683698954664,AWP 10,013,202046,Staff,0,0,0,0
1683698954664,AWP 10,014,202047,Staff,0,0,0,0
1683698954664,AWP 10,015,202048,Staff,0,0,0,0
1683698954664,AWP 10,016,202049,Staff,0,0,0,0
1683698954664,AWP 10,017,202050,Staff,0,0,0,0
1683698954664,AWP 10,018,202051,Staff,0,0,0,0
1683698954664,AWP 10,019,202052,Staff,0,0,0,0
1683698954664,AWP 10,020,202053,Staff,0,0,0,0
1683698954664,AWP 10,021,202054,Staff,0,0,0,0
1683698954664,AWP 10,022,202055,Staff,0,0,0,0
1683698954664,AWP 10,023,202056,Staff,0,0,0,0
1683698954664,AWP 10,024,202057,Staff,0,0,0,0
1683698954664,AWP 10,025,202058,Staff,0,0,0,0
1683698954664,AWP 10,026,202059,Staff,0,0,0,0
1683698955691,AWP 102,001,202032,Staff,0,0,0,0
1683698955691,AWP 102,002,202033,Staff,0,0,0,0
1683698956718,BENG 100,A01,254234,Taylor Amos; Alyssa C,31,0,40,9
1683698957745,BENG 196,001,270013,Engler; Adam J.,9999,0,9999,0
1683698958773,BICD 100R,A01,202018,Smith; Laurie,0,7,32,32
1683698958773,BICD 100R,A02,202019,Smith; Laurie,0,3,32,32
1683698958773,BICD 100R,A03,202020,Smith; Laurie,0,1,32,32
1683698958773,BICD 100R,A04,202021,Smith; Laurie,6,0,32,26
1683698958773,BICD 100R,A05,202022,Smith; Laurie,10,0,32,22
1683698959798,BICD 136,A01,193242,Gustafson-Brown; Cindy,0,2,32,32
1683698959798,BICD 136,A02,193244,Gustafson-Brown; Cindy,13,0,32,19
1683698960829,BIEB 102,A01,193249,Butler; Shannon Rhey,0,0,32,32
1683698960829,BIEB 102,A02,193251,Butler; Shannon Rhey,0,0,32,32
1683698960829,BIEB 102,A03,193253,Butler; Shannon Rhey,0,0,32,32
1683698960829,BIEB 102,A04,193255,Butler; Shannon Rhey,13,0,32,19
1683698960829,BIEB 102,A05,193265,Butler; Shannon Rhey,25,0,32,7
1683698960829,BIEB 102,A06,193269,Butler; Shannon Rhey,12,0,32,20
1683698962880,BIEB 150,A01,193274,Staff,0,0,32,32
1683698962880,BIEB 150,A02,193285,Staff,24,0,32,8
1683698963905,BIEB 194,A00,193286,Kurle; Carolyn M.,19,0,32,13
1683698964931,BILD 1,A01,192291,Staff,15,0,32,17
1683698964931,BILD 1,A02,192292,Staff,30,0,32,2
1683698964931,BILD 1,B01,192520,Reuther; Keefe,0,1,0,0
1683698964931,BILD 1,B02,192532,Reuther; Keefe,0,1,0,0
1683698965957,BILD 3,A01,192556,Butler; Shannon Rhey,0,0,32,32
1683698965957,BILD 3,A02,192581,Butler; Shannon Rhey,0,1,32,32
1683698965957,BILD 3,A03,192611,Butler; Shannon Rhey,19,0,32,13
1683698965957,BILD 3,A04,192612,Butler; Shannon Rhey,23,0,32,9
1683698965957,BILD 3,A05,192613,Butler; Shannon Rhey,26,0,32,6
1683698965957,BILD 3,A06,192679,Butler; Shannon Rhey,27,0,32,5
1683698965957,BILD 3,A07,192682,Butler; Shannon Rhey,20,0,32,12
1683698966984,BILD 4,A01,192836,Reuther; Keefe,1,0,24,23
1683698966984,BILD 4,A02,193044,Reuther; Keefe,4,0,24,20
1683698968009,BILD 10,A01,193142,Gustafson-Brown; Cindy,29,0,32,3
1683698968009,BILD 10,A02,193149,Gustafson-Brown; Cindy,31,0,32,1
1683698969037,BIMM 100,A01,193301,Staff,0,6,32,32
1683698969037,BIMM 100,A02,193312,Staff,0,7,32,32
1683698969037,BIMM 100,A03,193323,Staff,0,10,32,32
1683698970069,BIMM 101,A01,193329,McDonnell; Lisa Marie,0,3,24,24
1683698970069,BIMM 101,A02,193339,McDonnell; Lisa Marie,0,3,24,24
1683698970069,BIMM 101,B01,193354,McDonnell; Lisa Marie,0,4,24,24
1683698970069,BIMM 101,B02,193357,McDonnell; Lisa Marie,0,3,24,24
1683698971096,BIMM 110,A01,193377,Tat; John,0,11,32,32
1683698971096,BIMM 110,A02,193378,Tat; John,0,11,32,32
1683698972122,BIMM 120,A01,206116,Staff,0,0,32,32
1683698972122,BIMM 120,A02,206117,Staff,7,0,32,25
1683698972122,BIMM 120,A03,206121,Staff,21,0,32,11
1683698973153,BIPN 100,A01,193393,Park; Ji Young,0,15,32,32
1683698973153,BIPN 100,A02,193402,Park; Ji Young,0,14,32,32
1683698973153,BIPN 100,A03,193413,Park; Ji Young,0,14,32,32
1683698973153,BIPN 100,A04,193414,Park; Ji Young,0,13,32,32
1683698974177,BIPN 102,A01,193429,Staff,0,0,32,32
1683698974177,BIPN 102,A02,193438,Staff,18,0,32,14
1683698975201,BIPN 106,A01,193450,Reyes Gonzalez; Catalina,0,2,40,40
1683698976230,BIPN 134,A01,193465,Cooke; James Edward,0,0,32,32
1683698976230,BIPN 134,A02,193474,Cooke; James Edward,25,0,32,7
1683698976230,BIPN 134,A03,193485,Cooke; James Edward,29,0,32,3
1683698976230,BIPN 134,A04,193486,Cooke; James Edward,20,0,32,12
1683698976230,BIPN 134,A05,193491,Cooke; James Edward,31,0,32,1
1683698976230,BIPN 134,A06,193501,Cooke; James Edward,30,0,32,2
1683698976230,BIPN 134,A07,193510,Cooke; James Edward,29,0,32,3
1683698978280,BISP 194,A00,222522,Staff,14,0,32,18
1683698979306,CAT 124,A01,202407,Staff,19,0,25,6
1683698980332,CAT 125,A00,202408,Marchisotto; Jennifer Anne,2,0,20,18
1683698981356,CAT 125R,A00,202409,Smith; Lauryn Alissa,0,11,20,20
1683698981356,CAT 125R,B00,202410,Morales; Celeste Georgianna,0,11,20,20
1683698981356,CAT 125R,C00,202411,Irwin; Matthew Joseph,0,12,20,20
1683698982386,CENG 15,A01,204712,Yang; Kesong,0,1,0,0
1683698983409,CENG 114,A00,202070,Jahed Motlagh; Zeinab,5,0,20,15
1683698984434,CGS 105,A00,185477,Wesling; Megan E.,24,0,40,16
1683698985458,CGS 106,A00,185494,Staff,11,0,22,11
1683698986482,CGS 108,A00,185495,Staff,14,0,20,6
1683698987507,CGS 114,A00,185496,Staff,13,0,18,5
1683698988530,CGS 119,A00,185501,Staff,15,0,20,5
1683698989557,CGS 120,A00,185511,Staff,12,0,20,8
1683698990582,CHEM 4,A01,184675,Bussey; Thomas J,97,0,100,3
1683698991609,CHEM 6A,A01,184677,Staff,32,0,60,28
1683698992637,CHEM 6B,A01,184679,Staff,63,0,100,37
1683698993661,CHEM 6C,A01,184681,Bussey; Thomas J,0,0,50,50
1683698993661,CHEM 6C,A02,184682,Bussey; Thomas J,32,0,50,18
1683698994685,CHEM 40A,A01,184684,Albizati; Kim F.,33,0,100,67
1683698995709,CHEM 40B,A01,184686,Albizati; Kim F.,0,22,100,100
1683698996740,CHEM 41B,A01,184690,Staff,51,0,100,49
1683698997765,COGS 3,A01,184715,Boyle; Mary E. T.,0,27,40,40
1683698998790,COGS 14B,A01,185172,Staff,0,14,38,38
1683698999818,COGS 18,A01,184736,Staff,14,0,80,66
1683699000846,COGS 100,A01,184932,Staff,0,8,73,73
1683699001871,COGS 101A,A01,184935,Staff,0,40,30,30
1683699002899,COGS 101B,A01,184944,Staff,0,2,30,30
1683699003927,COGS 101C,A01,184946,Staff,0,10,30,30
1683699004953,COGS 102A,A01,184951,Johnson; Christine M.,1,0,40,39
1683699005979,COGS 107B,A01,184953,Mooshagian; Eric Frederick,0,52,40,40
1683699007002,COGS 118B,A01,184959,Gupta; Anjum,0,50,40,40
1683699008026,COGS 153,A00,184961,Staff,1,16,30,29
1683699009051,COGS 177,A00,184962,Staff,0,20,30,30
1683699010077,COGS 187A,A01,184969,Boyle; Mary E. T.,0,19,40,40
1683699011106,COMM 10,A01,185174,Staff,0,5,25,25
1683699011106,COMM 10,A02,185189,Staff,0,2,25,25
1683699011106,COMM 10,A03,269821,Staff,0,1,0,0
1683699012131,COMM 100B,A02,185476,Staff,10,0,25,15
1683699012131,COMM 100B,A03,277340,Staff,25,0,25,0
1683699013154,COMM 100C,A01,185314,Staff,2,0,25,23
1683699013154,COMM 100C,A02,185327,Staff,17,0,25,8
1683699014178,COMM 110M,A00,185349,Staff,0,0,40,40
1683699015202,COMM 113T,A00,185352,Staff,25,0,40,15
1683699016281,COMM 114I,A00,185353,Staff,31,0,40,9
1683699017304,COMM 131,A00,185354,Staff,17,0,30,13
1683699018332,CSE 8A,A50,185358,Cao; Yingjun,0,46,10,10
1683699019359,CSE 8B,A01,185362,Staff,0,48,50,50
1683699020384,CSE 11,A01,185416,Cao; Yingjun,0,91,10,10
1683699021411,CSE 20,A01,185445,Briones; Jor-el Thomas Caparas,3,0,25,22
1683699022436,CSE 21,A01,185447,Staff,9,0,50,41
1683699023467,CSE 101,A01,185451,Staff,0,13,50,50
1683699023467,CSE 101,B01,185453,Jones; Miles E,0,14,50,50
1683699025520,CSE 141,A01,185458,Eldon; John,16,0,100,84
1683699026547,CSE 141L,A01,185461,Eldon; John,8,0,100,92
1683699027574,CSE 142,A01,185463,Staff,34,0,60,26
1683699027574,CSE 142,B01,201355,Staff,0,7,60,60
1683699028599,CSE 142L,A01,185470,Staff,34,0,60,26
1683699028599,CSE 142L,B01,201417,Staff,0,6,60,60
1683699029623,CSE 190,A00,201433,Staff,32,0,49,17
1683699030652,DOC 1,A01,259136,Strom; Megan C.,7,0,15,8
1683699030652,DOC 1,A02,259137,Strom; Megan C.,14,0,15,1
1683699030652,DOC 1,A03,259138,Strom; Megan C.,14,0,15,1
1683699030652,DOC 1,A04,259139,Strom; Megan C.,14,0,15,1
1683699031675,DOC 100D,A00,259140,Pass; Natalye Joann,14,0,25,11
1683699032703,DSGN 1,A01,184749,Rill; Bryan,0,26,30,30
1683699033731,DSGN 100,A01,185168,Staff,0,2,25,25
1683699034756,ECE 5,A01,185626,Morris; Karcher William,0,12,0,0
1683699035788,ECE 101,A01,185628,Staff,14,0,70,56
1683699036816,ECE 107,A01,185635,Baghdadchi; Saharnaz,0,0,20,20
1683699036816,ECE 107,A02,185638,Baghdadchi; Saharnaz,1,0,20,19
1683699037842,ECE 148,A01,185647,Silberman; Jack,0,0,16,16
1683699038870,ECON 1,A01,185537,Crane; Meredith Helen,54,0,70,16
1683699039898,ECON 3,A01,185549,Crane; Meredith Helen,30,0,70,40
1683699040922,ECON 4,A01,203354,Anderson; John Charles,0,5,10,10
1683699041945,ECON 100A,A01,185574,Staff,0,5,40,40
1683699042971,ECON 100B,A01,185576,Staff,0,12,50,50
1683699044001,ECON 100C,A01,185589,Newhouse; Herbert S,30,0,70,40
1683699045025,ECON 105,A00,185608,Vespa; Emanuel Ignacio,19,0,35,16
1683699046049,ECON 109,A01,185610,Shishkin; Denis,9,0,35,26
1683699047076,ECON 110A,A01,185612,Staff,8,0,40,32
1683699048099,ECON 120A,A01,185615,Staff,19,0,40,21
1683699049126,ECON 120C,A01,185617,Sun; Yixiao,0,21,70,70
1683699050157,ECON 144,A00,203346,Squires; Dale E,2,0,35,33
1683699051182,ECON 171,A01,203349,Newhouse; Herbert S,0,1,35,35
1683699052209,ECON 173A,A01,185621,Toda; Alexis Akira,21,0,35,14
1683699053237,EDS 25,A01,202413,Staff,0,1,0,0
1683699053237,EDS 25,A02,202414,Staff,0,1,0,0
1683699053237,EDS 25,A03,202415,Staff,0,0,0,0
1683699053237,EDS 25,A04,202416,Staff,0,1,0,0
1683699053237,EDS 25,A05,202439,Staff,0,0,0,0
1683699053237,EDS 25,A06,202440,Staff,0,0,0,0
1683699053237,EDS 25,B01,202631,Staff,0,0,0,0
1683699053237,EDS 25,B02,202632,Staff,0,0,0,0
1683699053237,EDS 25,B03,202639,Staff,0,0,0,0
1683699053237,EDS 25,B04,202640,Staff,0,0,0,0
1683699053237,EDS 25,B05,202643,Staff,0,0,0,0
1683699053237,EDS 25,B06,202644,Staff,0,0,0,0
1683699054261,EDS 38,A01,202659,Black; Alison Michelle,24,0,25,1
1683699055286,EDS 115,A00,202652,Staff,18,0,30,12
1683699056314,EDS 125,A00,202649,Staff,13,0,30,17
1683699057339,EDS 126,A01,203332,Staff,30,0,30,0
1683699058363,EDS 139,A00,202838,Staff,16,0,25,9
1683699059386,EDS 146,A01,202655,Staff,14,0,25,11
1683699060415,ENG 15,A00,185667,Staff,0,1,0,0
1683699060415,ENG 15,B00,185672,Staff,0,0,0,0
1683699060415,ENG 15,C00,185675,Staff,0,0,0,0
1683699060415,ENG 15,D00,185682,Staff,0,0,0,0
1683699060415,ENG 15,E00,185684,Staff,0,0,0,0
1683699061438,ETHN 103,A00,185710,Staff,0,8,35,35
1683699062462,ETHN 103A,A00,199228,Man; Simeon S,0,0,9,9
1683699063487,ETHN 109,A00,185711,Staff,15,0,35,20
1683699064510,ETHN 142,A00,185726,Staff,0,4,30,30
1683699065537,ETHN 163J,A00,199229,Man; Simeon S,5,0,8,3
1683699066561,ETHN 168,A00,185727,Staff,7,0,10,3
1683699067590,ETHN 182,A00,185728,Staff,0,0,35,35
1683699068618,ETHN 183,A00,185737,Staff,9,0,18,9
1683699069644,GLBH 111,A01,209361,Burgos; Jose L.,0,0,0,0
1683699071699,HIEU 104,A00,185792,Staff,14,0,20,6
1683699072723,HIEU 115,A00,185800,Staff,0,0,20,20
1683699073747,HIEU 128,A00,185801,Staff,0,9,20,20
1683699074775,HIEU 147,A00,185802,Staff,15,0,20,5
1683699075799,HIEU 154,A00,185823,Staff,11,0,20,9
1683699076823,HILA 102,A00,185826,Staff,14,0,20,6
1683699077850,HILD 2C,A01,185778,Staff,0,13,20,20
1683699078875,HILD 7B,A01,185780,Kwak; Nancy,0,17,32,32
1683699078875,HILD 7B,A02,185781,Kwak; Nancy,0,18,32,32
1683699079901,HILD 30,A01,185791,Staff,12,0,20,8
1683699080927,HISC 119,A00,185830,Golan; Tal,0,10,20,20
1683699081954,HITO 156GS,A00,185831,Patterson; Patrick H.,0,0,0,23
1683699082982,HIUS 103,A00,185832,Man; Simeon S,0,4,20,20
1683699084010,HIUS 117,A00,185836,Kwak; Nancy,2,0,20,18
1683699085035,HIUS 125,A00,185840,Man; Simeon S,0,2,23,23
1683699086063,HIUS 149,A00,185845,Staff,1,0,20,19
1683699087092,HUM 3,A01,185882,Zavodny; Tatiana Sophia,0,8,50,50
1683699087092,HUM 3,B01,185899,Caldwell; Michael Alan,0,18,50,50
1683699088115,HUM 3GS,A00,185900,Patterson; Patrick H.,0,0,0,23
1683699089138,HUM 4,A01,185938,Zroka; Amy Liane,28,0,50,22
1683699089138,HUM 4,B01,185956,Watkins; Eric,0,6,50,50
1683699089138,HUM 4,B02,202209,Watkins; Eric,0,5,50,50
1683699089138,HUM 4,B03,202210,Watkins; Eric,0,5,50,50
1683699090201,HUM 5,A01,185958,West; Geoffrey Scott,0,0,50,50
1683699090201,HUM 5,A02,202215,West; Geoffrey Scott,0,1,50,50
1683699091225,INTL 190,A00,185959,Gagnon; Jeffrey C,0,0,0,9
1683699091225,INTL 190,B00,185960,Lettieri; Michael Joseph,0,0,0,2
1683699092249,JAPN 180,A00,254509,Staff,5,0,30,25
1683699093275,LATI 10,A01,202853,Kennemore; Amy Michelle,4,0,35,31
1683699093275,LATI 10,A02,202854,Kennemore; Amy Michelle,3,0,35,32
1683699093275,LATI 10,A03,270054,Kennemore; Amy Michelle,30,0,30,0
1683699094302,LATI 180,A00,202855,Kennemore; Amy Michelle,11,0,20,9
1683699095326,LAWS 101,A00,201767,Golan; Tal,0,7,40,40
1683699096352,LIFR 1C,A00,185961,Staff,6,0,20,14
1683699097376,LIFR 1CX,A00,185962,Staff,7,0,20,13
1683699098402,LIFR 1D,A00,185963,Staff,7,0,20,13
1683699099429,LIFR 1DX,A00,185964,Staff,7,0,20,13
1683699100457,LIGN 101,A01,186039,Staff,43,0,50,7
1683699101484,LIGN 165,A00,186040,Staff,15,0,50,35
1683699102508,LTCS 108,A00,186041,Staff,5,0,10,5
1683699103536,LTCS 119,A00,186042,Staff,15,0,20,5
1683699104560,LTCS 130,A00,186043,Wesling; Megan E.,15,0,25,10
1683699106614,LTEA 138,A00,186119,Staff,14,0,40,26
1683699107640,LTEN 124,A00,186148,Staff,5,0,25,20
1683699108665,LTEN 178,A00,186149,Staff,6,0,15,9
1683699109689,LTEN 181,A00,186150,Blanco; John D,34,0,40,6
1683699110713,LTWL 120,A00,186160,Staff,19,0,25,6
1683699111736,LTWL 165,A00,186161,Staff,22,0,25,3
1683699112763,LTWR 100,A00,186162,Staff,0,5,15,15
1683699113789,LTWR 102,A00,186163,Doller; Ben,5,0,15,10
1683699114813,MAE 8,A01,186412,Staff,0,1,0,0
1683699115838,MAE 30B,A00,186445,Bahadori; Mohammad Yousef,81,0,100,19
1683699116869,MAE 40,A00,186592,Bewley; Thomas R,10,0,50,40
1683699117897,MAE 101B,A00,186593,Bahadori; Mohammad Yousef,80,0,100,20
1683699118922,MAE 105,A00,186594,Bandaru; Prabhakar,10,0,50,40
1683699120004,MAE 107,A00,186599,Pham; Hieu Tan,0,8,120,120
1683699121027,MAE 148,A01,186660,Silberman; Jack,3,0,16,13
1683699122052,MATH 10A,A01,188095,Staff,0,6,35,35
1683699123084,MATH 10B,A01,188097,Bowers; Adam R.,0,12,30,30
1683699123084,MATH 10B,A02,188099,Bowers; Adam R.,0,11,30,30
1683699123084,MATH 10B,B01,188104,Bowers; Adam R.,0,10,30,30
1683699123084,MATH 10B,B02,188106,Bowers; Adam R.,0,9,30,30
1683699124109,MATH 10C,A01,188111,Staff,0,20,30,30
1683699124109,MATH 10C,A02,188127,Staff,0,19,30,30
1683699124109,MATH 10C,A03,188131,Staff,0,19,30,30
1683699124109,MATH 10C,B01,188218,Staff,17,0,30,13
1683699124109,MATH 10C,B02,188244,Staff,13,0,30,17
1683699124109,MATH 10C,B03,188277,Staff,14,0,30,16
1683699125133,MATH 18,A01,188344,Bach; Quang Tran,18,0,30,12
1683699125133,MATH 18,A02,188345,Bach; Quang Tran,11,0,30,19
1683699125133,MATH 18,B01,188353,Bach; Quang Tran,11,0,30,19
1683699125133,MATH 18,B02,188354,Bach; Quang Tran,19,0,30,11
1683699126159,MATH 20A,A01,188374,Staff,11,0,35,24
1683699127186,MATH 20B,A01,188382,Ohm; Ko Woon,7,0,30,23
1683699127186,MATH 20B,A02,188383,Ohm; Ko Woon,22,0,30,8
1683699127186,MATH 20B,B01,188385,Ohm; Ko Woon,7,0,30,23
1683699127186,MATH 20B,B02,188392,Ohm; Ko Woon,22,0,30,8
1683699128218,MATH 20C,A01,188394,Harel; Guershon,10,0,30,20
1683699128218,MATH 20C,A02,188395,Harel; Guershon,13,0,30,17
1683699128218,MATH 20C,B01,188404,Harel; Guershon,5,0,30,25
1683699128218,MATH 20C,B02,188405,Harel; Guershon,18,0,30,12
1683699129247,MATH 20D,A01,188414,Hammock; Frances H,0,1,30,30
1683699129247,MATH 20D,A02,188415,Hammock; Frances H,0,1,30,30
1683699129247,MATH 20D,B01,188447,Hammock; Frances H,0,1,30,30
1683699129247,MATH 20D,B02,188486,Hammock; Frances H,2,0,30,28
1683699130272,MATH 20E,A01,188649,Staff,21,0,30,9
1683699130272,MATH 20E,A02,188650,Staff,20,0,30,10
1683699130272,MATH 20E,A03,188673,Staff,0,0,30,30
1683699131297,MATH 102,A01,188675,Staff,0,40,35,35
1683699132326,MATH 103B,A01,188681,Staff,3,0,35,32
1683699132326,MATH 103B,B01,188692,Staff,5,0,35,30
1683699133353,MATH 109,A01,188695,Salehi Golsefidy; Alireza,24,0,35,11
1683699133353,MATH 109,A02,188696,Salehi Golsefidy; Alireza,25,0,35,10
1683699134381,MATH 120A,A01,188698,Eggers; John Dietrich,7,0,35,28
1683699135410,MATH 142B,A01,188736,Ioana; Adrian,0,0,30,30
1683699135410,MATH 142B,A02,188741,Ioana; Adrian,0,1,30,30
1683699135410,MATH 142B,A03,188743,Ioana; Adrian,0,2,30,30
1683699136433,MATH 168A,A01,188790,Staff,0,11,35,35
1683699137462,MATH 170A,A01,188803,Nie; Jiawang,0,2,35,35
1683699137462,MATH 170A,A02,188811,Nie; Jiawang,0,1,35,35
1683699137462,MATH 170A,A03,188814,Nie; Jiawang,0,0,35,35
1683699137462,MATH 170A,A04,188815,Nie; Jiawang,5,0,35,30
1683699138493,MATH 193B,A01,188817,Staff,0,0,35,35
1683699138493,MATH 193B,A02,188818,Staff,6,0,35,29
1683699139517,MGT 4,A01,202857,Anderson; John Charles,59,0,80,21
1683699140545,MGT 12,A00,202858,Lindenberger; Wade Douglas,40,0,90,50
1683699141572,MGT 18,A00,202859,Staff,74,0,90,16
1683699142598,MGT 18GS,A00,202860,McKay; Michael J,13,0,28,15
1683699143625,MGT 45,A00,202861,Pecore; Joseph P.,8,0,90,82
1683699144649,MGT 100,A00,202863,Yavorsky; Daniel Ryan,27,0,90,63
1683699145675,MGT 103,A00,202864,Ehrich; Kristine R,0,19,90,90
1683699146699,MGT 112,A00,202865,Ehrich; Kristine R,15,0,90,75
1683699147727,MGT 121A,A00,202868,Staff,70,0,90,20
1683699148751,MGT 131B,A00,202869,Anderson; John Charles,58,0,90,32
1683699149775,MGT 136,A00,202871,Lindenberger; Wade Douglas,83,0,90,7
1683699150803,MGT 164,A00,202873,Staff,0,67,90,91
1683699151827,MGT 164GS,A00,202874,McKay; Mary A,13,0,28,15
1683699152851,MGT 180,A00,202875,Staff,0,51,90,91
1683699153875,MMW 11R,A01,205019,Herbst; Matthew,0,0,30,30
1683699153875,MMW 11R,A02,205026,Herbst; Matthew,29,0,30,1
1683699154901,MMW 15,A01,193512,Chang; Edmond Yi-Teh,0,8,28,28
1683699154901,MMW 15,A02,193513,Chang; Edmond Yi-Teh,0,5,28,28
1683699154901,MMW 15,A03,193514,Chang; Edmond Yi-Teh,0,5,28,28
1683699154901,MMW 15,A04,193515,Chang; Edmond Yi-Teh,0,5,28,28
1683699154901,MMW 15,A05,193516,Chang; Edmond Yi-Teh,0,5,28,28
1683699154901,MMW 15,A06,193517,Chang; Edmond Yi-Teh,0,6,28,28
1683699154901,MMW 15,B01,193519,Chang; Edmond Yi-Teh,0,5,28,28
1683699154901,MMW 15,B02,193520,Chang; Edmond Yi-Teh,0,5,28,28
1683699154901,MMW 15,B03,193521,Chang; Edmond Yi-Teh,0,5,28,28
1683699154901,MMW 15,B04,193522,Chang; Edmond Yi-Teh,0,6,28,28
1683699154901,MMW 15,B05,193523,Chang; Edmond Yi-Teh,0,5,28,28
1683699154901,MMW 15,B06,193524,Chang; Edmond Yi-Teh,0,5,28,28
1683699155926,MMW 122,A01,193526,Rahimi; Babak,0,16,28,28
1683699155926,MMW 122,A02,193527,Rahimi; Babak,0,15,28,28
1683699155926,MMW 122,A03,193528,Rahimi; Babak,0,0,0,0
1683699155926,MMW 122,A04,193529,Rahimi; Babak,0,0,0,0
1683699156954,MUS 1A,A01,186663,Staff,0,18,35,35
1683699157981,MUS 4,A01,186715,Staff,0,12,35,35
1683699159009,MUS 5R,A01,186796,Dubnov; Shlomo,0,17,35,35
1683699160034,MUS 6,A01,186798,Staff,0,4,25,25
1683699161058,MUS 7,A01,186830,Staff,11,0,35,24
1683699162082,MUS 8,A01,186930,Staff,0,27,35,35
1683699163110,MUS 15,A01,186932,Staff,0,15,35,35
1683699163110,MUS 15,B01,186934,Staff,0,16,35,35
1683699164136,MUS 80,A00,186935,Staff,0,0,20,20
1683699164136,MUS 80,B00,186936,Staff,24,0,25,1
1683699165161,NANO 11,A00,204702,Lipomi; Darren John,0,0,0,0
1683699166186,NANO 15,A01,204709,Yang; Kesong,0,1,0,0
1683699167214,NANO 114,A00,202069,Jahed Motlagh; Zeinab,2,0,10,8
1683699168237,PHIL 1,A00,186955,Grush; Rick Scott,31,0,40,9
1683699169265,PHIL 10,A01,186973,Grush; Rick Scott,27,0,35,8
1683699169265,PHIL 10,A02,186974,Grush; Rick Scott,33,0,35,2
1683699170290,PHIL 13,A01,186976,Staff,1,0,35,34
1683699170290,PHIL 13,A02,186977,Staff,16,0,35,19
1683699171319,PHIL 14,A01,186979,Staff,31,0,35,4
1683699171319,PHIL 14,A02,186986,Staff,32,0,35,3
1683699172343,PHIL 28,A01,186988,Staff,16,0,30,14
1683699172343,PHIL 28,A02,186989,Staff,1,0,30,29
1683699172343,PHIL 28,A03,186990,Staff,10,0,30,20
1683699172343,PHIL 28,A04,186991,Staff,26,0,30,4
1683699173367,PHIL 120,A00,186997,Staff,23,0,40,17
1683699174390,PHIL 137,A00,187003,Staff,7,0,40,33
1683699175417,PHIL 150,A00,187015,Staff,47,0,70,23
1683699176443,PHIL 167,A00,187021,Lamey; Andy M.,34,0,40,6
1683699177466,PHIL 174,A01,202226,Staff,17,0,20,3
1683699177466,PHIL 174,A02,202235,Staff,20,0,20,0
1683699178490,PHIL 191A,A00,258918,Staff,0,0,1,1
1683699179514,PHYS 1A,A00,187028,Staff,26,0,60,34
1683699180538,PHYS 1AL,001,187036,Staff,3,0,30,27
1683699180538,PHYS 1AL,002,187049,Staff,18,0,30,12
1683699181560,PHYS 1B,A00,187058,Staff,21,0,60,39
1683699182588,PHYS 1BL,001,187064,Staff,0,1,30,30
1683699182588,PHYS 1BL,002,187070,Staff,4,0,30,26
1683699183613,PHYS 1C,A00,187082,Staff,30,0,120,90
1683699184638,PHYS 1CL,001,187088,Staff,0,9,30,30
1683699184638,PHYS 1CL,002,187089,Staff,0,1,30,30
1683699184638,PHYS 1CL,009,262693,Staff,9,0,30,21
1683699185662,PHYS 2B,A01,187097,Staff,55,0,115,60
1683699186685,PHYS 2C,A01,187099,Staff,63,0,115,52
1683699187712,PHYS 2CL,A01,187101,Staff,5,0,28,23
1683699187712,PHYS 2CL,A02,187102,Staff,15,0,28,13
1683699188740,PHYS 2D,A01,187123,Shotwell; Brian,95,0,115,20
1683699189763,PHYS 4B,A01,187133,Grinstein; Benjamin,35,0,50,15
1683699190786,POLI 10,A00,188819,Staff,0,4,50,50
1683699191810,POLI 11,A00,188827,Staff,43,0,50,7
1683699192834,POLI 13R,A00,188828,Staff,0,1,20,20
1683699193860,POLI 27,A01,188830,Elgin; Samuel Zincke,0,2,70,70
1683699194886,POLI 30,A00,188832,Desposato; Scott,30,0,50,20
1683699195913,POLI 102F,A00,188834,Staff,1,0,40,39
1683699196937,POLI 104A,A00,188852,Staff,12,0,30,18
1683699197962,POLI 104I,A00,188853,Staff,0,8,20,20
1683699198989,POLI 110B,A00,188854,Wiens; David,6,0,20,14
1683699200015,POLI 112A,A00,188855,Wiens; David,3,0,30,27
1683699201039,POLI 117R,A00,188856,Forman; Fonna,0,12,20,20
1683699202066,POLI 118,A00,188857,Ingham; Sean,8,0,20,12
1683699203093,POLI 120G,A00,188858,Staff,8,0,30,22
1683699204119,POLI 131CR,A00,188863,Hoston; Germaine,20,0,50,30
1683699205143,POLI 133,A00,188864,Nellis; Gareth Hb,44,0,50,6
1683699206167,POLI 134D,A00,188865,Desposato; Scott,27,0,30,3
1683699207200,POLI 142A,A00,188871,Gartzke; Erik,21,0,50,29
1683699208226,POLI 142K,A00,188874,Staff,38,0,50,12
1683699209252,POLI 143,A00,188940,Gartzke; Erik,16,0,30,14
1683699210277,POLI 153,A00,188943,Staff,2,0,20,18
1683699211303,POLI 160AA,A00,188944,Staff,10,0,40,30
1683699212327,POLI 170A,A00,188945,Staff,10,0,30,20
1683699214375,PSYC 1,A00,188952,Staff,36,0,90,54
1683699215399,PSYC 2,B00,188953,Staff,19,0,35,16
1683699216421,PSYC 6,A00,188970,Staff,47,0,60,13
1683699217447,PSYC 7,A00,188973,Staff,35,0,45,10
1683699218474,PSYC 60,A01,188980,Rickard; Timothy C.,42,0,60,18
1683699219499,PSYC 70,A01,189001,Steiner; Eric Tomas,21,0,45,24
1683699220523,PSYC 100,A00,189005,Lacefield; Katharine I,0,98,120,120
1683699221548,PSYC 102,A00,189008,Staff,6,0,30,24
1683699222576,PSYC 106,B00,189026,Gorman; Michael R.,27,0,60,33
1683699223659,PSYC 114,B01,189033,Winkielman; Piotr,0,31,30,30
1683699224686,PSYC 131,A00,189036,Anagnostaras; Stephan,0,44,60,60
1683699225709,PSYC 136,A00,189041,Lowe; Angela Beth,0,7,25,25
1683699226733,PSYC 137,A00,189057,Winkielman; Piotr,0,36,25,25
1683699227757,PSYC 144,A00,189107,Wixted; John T,0,11,50,50
1683699229805,PSYC 162,A00,189142,Staff,0,9,85,85
1683699230833,PSYC 172,A00,189144,Gorman; Michael R.,0,6,30,30
1683699232885,PSYC 179,A00,189146,Lacefield; Katharine I,0,88,120,120
1683699233914,PSYC 181,A00,189147,Anagnostaras; Stephan,0,45,90,90
1683699234942,PSYC 190R,A00,189148,Barner; David A.,0,23,80,80
1683699235968,PSYC 191,A00,189275,Rickard; Timothy C.,0,11,25,25
1683699236991,PSYC 193,A00,189276,Chapman; Eddie Nathaniel,0,1,0,4
1683699238020,PSYC 193L,A01,189281,Lowe; Angela Beth,8,0,20,12
1683699238020,PSYC 193L,B01,189285,Staff,28,0,35,7
1683699239048,RELI 149,A00,187137,Rahimi; Babak,6,0,40,34
1683699240072,SE 9,A01,187315,Staff,0,2,18,18
1683699241099,SE 101B,A00,187409,Staff,24,0,30,6
1683699242123,SE 110B,A00,187444,Staff,10,0,40,30
1683699243149,SE 130B,A00,187449,Staff,31,0,40,9
1683699244174,SE 150A,A00,187516,Staff,8,0,20,12
1683699245199,SE 154,A00,187528,Staff,29,0,50,21
1683699246222,SIO 3,A01,258171,Staff,35,0,40,5
1683699247246,SIO 10,A00,187144,Cook; Geoffrey W,0,6,75,75
1683699248272,SIO 45,A00,187152,Cook; Geoffrey W,0,7,100,100
1683699249299,SIO 109R,A00,194486,Staff,0,4,20,20
1683699251352,SIO 187,A01,187233,Kacev; David,12,0,40,28
1683699252375,SOCI 1,A01,258656,Thorpe; Charles Robert,28,0,30,2
1683699252375,SOCI 1,A02,258658,Thorpe; Charles Robert,30,0,30,0
1683699252375,SOCI 1,A03,258661,Thorpe; Charles Robert,25,0,25,0
1683699252375,SOCI 1,A04,258666,Thorpe; Charles Robert,22,0,25,3
1683699252375,SOCI 1,A05,258897,Thorpe; Charles Robert,22,0,25,3
1683699252375,SOCI 1,A06,258898,Thorpe; Charles Robert,25,0,25,0
1683699253403,SOCI 30,A01,258903,Pardo Guerra; Juan Pablo,14,0,30,16
1683699254428,SOCI 102,A00,258904,Staff,9,0,25,16
1683699255452,SOCI 106,A00,258905,Staff,19,0,25,6
1683699256478,SOCI 111,A00,258907,Ribas Norris; Janet Vanesa,26,0,30,4
1683699257503,SOCI 121R,A00,258908,Pardo Guerra; Juan Pablo,7,0,30,23
1683699258527,SOCI 126,A01,203330,Staff,14,0,20,6
1683699259555,SOCI 131,A00,258909,Thorpe; Charles Robert,30,0,60,30
1683699260578,SOCI 135,A00,258910,Payne; Christine Anna,0,13,30,30
1683699261603,SOCI 157,A00,258911,Staff,10,0,30,20
1683699262628,SOCI 184,A00,258912,Staff,25,0,30,5
1683699263656,SOCI 188D,A00,258913,Staff,22,0,30,8
1683699264680,SYN 2,001,187529,Staff,9,0,16,7
1683699264680,SYN 2,002,201452,Staff,0,20,16,16
1683699264680,SYN 2,003,201469,Staff,1,0,16,15
1683699265703,SYN 100,A01,187531,Staff,0,9,20,20
1683699265703,SYN 100,B01,201491,Staff,0,10,20,20
1683699266727,TDAC 1,A00,189286,Walsh; Kim C.,3,0,20,17
1683699266727,TDAC 1,B00,189287,Harting; Carla Kelso,10,0,20,10
1683699267751,TDAC 101,A00,189300,Walsh; Kim C.,16,0,20,4
1683699267751,TDAC 101,B00,189301,Harting; Carla Kelso,18,0,20,2
1683699268775,TDAC 102,A00,189304,Basso; Beatrice,14,0,20,6
1683699269803,TDAC 108,A00,189305,Staff,18,0,20,2
1683699270831,TDDE 131,A00,189310,Staff,19,0,20,1
1683699270831,TDDE 131,B00,189314,Staff,19,0,20,1
1683699270831,TDDE 131,C00,189315,Staff,48,0,50,2
1683699270831,TDDE 131,D00,189316,Staff,14,0,15,1
1683699270831,TDDE 131,E00,204841,Staff,20,0,20,0
1683699271855,TDGE 10,A00,189289,Staff,27,0,50,23
1683699271855,TDGE 10,B00,189290,Havis; Allan,0,1,50,50
1683699272880,TDGE 11,A00,189291,Fulton; Julia,0,4,50,50
1683699272880,TDGE 11,B00,189292,Staff,20,0,25,5
1683699272880,TDGE 11,C00,260270,Staff,0,0,0,0
1683699273903,TDGE 25,A00,189294,Staff,1,0,20,19
1683699274934,TDGE 124,A00,189318,Fulton; Julia,0,7,50,50
1683699275961,TDGE 125,A00,189319,Staff,13,0,25,12
1683699275961,TDGE 125,B00,189320,Staff,23,0,25,2
1683699276989,TDGE 127,A00,189322,Havis; Allan,1,0,50,49
1683699278015,TDHT 101,A00,189323,Staff,18,0,25,7
1683699278015,TDHT 101,B00,189324,Staff,25,0,25,0
1683699279042,TDHT 102,A00,189325,Staff,49,0,50,1
1683699280069,TDMV 1,A00,189295,Arcidiacono; Kristin,20,0,30,10
1683699280069,TDMV 1,B00,189296,Caligagan; Maria T.,24,0,30,6
1683699281096,TDMV 2,A00,189297,Sammartano; Tonnie,27,0,30,3
1683699281096,TDMV 2,B00,189299,Arcidiacono; Kristin,23,0,30,7
1683699282123,TDMV 3,A00,204998,Rincon; Alicia,22,0,30,8
1683699283150,TDMV 120,A00,189458,Sammartano; Tonnie,28,0,30,2
1683699284174,TDMV 138,A00,189541,Jun; Grace Shin Hae,20,0,40,20
1683699285201,TDMV 142,A00,189717,Caligagan; Tony,25,0,30,5
1683699285201,TDMV 142,B00,189718,Caligagan; Maria T.,25,0,30,5
1683699286224,TMC 2,A01,187533,Staff,25,0,25,0
1683699286224,TMC 2,A02,187534,Staff,25,0,25,0
1683699287251,USP 1,A01,187536,Kwak; Nancy,0,16,25,25
1683699288279,USP 5,A01,187538,Staff,8,0,25,17
1683699289308,USP 101,A00,199253,Staff,0,4,0,0
1683699290335,USP 124,A00,187562,Boomhower; Matthew Charles,0,0,30,30
1683699291365,USP 138,A00,187582,Staff,19,0,25,6
1683699292388,USP 152,A01,187597,Staff,3,0,25,22
1683699293415,USP 153,A00,187598,Staff,18,0,25,7
1683699294441,USP 168,A00,187607,Kwak; Nancy,2,0,5,3
1683699295468,USP 173,A00,187619,Staff,4,0,25,21
1683699296491,USP 181,A00,187638,Staff,0,4,25,25
1683699297517,VIS 103,A00,187650,Cruz; Edwin Teddy,17,0,75,58
1683699298546,VIS 110D,A00,187669,Staff,13,0,22,9
1683699299571,VIS 127C,A00,187720,Shen; Kuiyi,67,0,146,79
1683699300595,VIS 149,A00,187731,Yoldas; Pinar,0,12,22,22
1683699301622,VIS 151,A01,188091,Staff,22,0,34,12
1683699301622,VIS 151,A02,188092,Staff,11,0,34,23
1683699302648,VIS 160B,A00,188093,Stalbaum; Brett,0,1,10,10
1683699304702,WCWP 10B,A00,201720,Staff,0,0,5,5
1683699304702,WCWP 10B,B00,201722,Staff,0,0,6,6
1683699305729,WCWP 100,A00,201725,Gagnon; Jeffrey C,0,0,2,2
1683699305729,WCWP 100,B00,201727,Staff,0,4,15,15
1683699308822,ANBI 133,A00,258401,Wilder; Linnea Lorene,34,0,40,6
1683699309849,ANBI 140,A00,258395,Hrvoj Mihic; Branka,18,0,25,7
1683699310873,ANSC 120,A00,258402,Bialecki; Jon Anthony,26,0,40,14
1683699311896,ANSC 144,A00,258400,Staff,12,0,40,28
1683699313947,ANSC 166,A00,258396,Parish; Steven Martin,156,0,175,19
1683699314970,ANSC 180,A00,193533,Staff,8,0,20,12
1683699315994,ANSC 188,A00,258397,Jassal; Aftab,34,0,40,6
1683699317018,ANTH 3,A01,258316,Staff,23,0,30,7
1683699318042,ANTH 5,A00,258394,Semendeferi; Ekaterini,16,0,20,4
1683699319069,ANTH 21,A01,258331,Staff,4,0,40,36
1683699320104,ANTH 103,A00,258398,Varma; Saiba,15,0,25,10
1683699321132,AWP 10,001,202034,Staff,0,0,0,0
1683699321132,AWP 10,002,202035,Staff,0,0,0,0
1683699321132,AWP 10,003,202036,Staff,0,0,0,0
1683699321132,AWP 10,004,202037,Staff,0,0,0,0
1683699321132,AWP 10,005,202038,Staff,0,0,0,0
1683699321132,AWP 10,006,202039,Staff,0,0,0,0
1683699321132,AWP 10,007,202040,Staff,0,0,0,0
1683699321132,AWP 10,008,202041,Staff,0,0,0,0
1683699321132,AWP 10,009,202042,Staff,0,0,0,0
1683699321132,AWP 10,010,202043,Staff,0,0,0,0
1683699321132,AWP 10,011,202044,Staff,0,0,0,0
1683699321132,AWP 10,012,202045,Staff,0,0,0,0
1683699321132,AWP 10,013,202046,Staff,0,0,0,0
1683699321132,AWP 10,014,202047,Staff,0,0,0,0
1683699321132,AWP 10,015,202048,Staff,0,0,0,0
1683699321132,AWP 10,016,202049,Staff,0,0,0,0
1683699321132,AWP 10,017,202050,Staff,0,0,0,0
1683699321132,AWP 10,018,202051,Staff,0,0,0,0
1683699321132,AWP 10,019,202052,Staff,0,0,0,0
1683699321132,AWP 10,020,202053,Staff,0,0,0,0
1683699321132,AWP 10,021,202054,Staff,0,0,0,0
1683699321132,AWP 10,022,202055,Staff,0,0,0,0
1683699321132,AWP 10,023,202056,Staff,0,0,0,0
1683699321132,AWP 10,024,202057,Staff,0,0,0,0
1683699321132,AWP 10,025,202058,Staff,0,0,0,0
1683699321132,AWP 10,026,202059,Staff,0,0,0,0
1683699322158,AWP 102,001,202032,Staff,0,0,0,0
1683699322158,AWP 102,002,202033,Staff,0,0,0,0
1683699323182,BENG 100,A01,254234,Taylor Amos; Alyssa C,31,0,40,9
1683699324209,BENG 196,001,270013,Engler; Adam J.,9999,0,9999,0
1683699325233,BICD 100R,A01,202018,Smith; Laurie,0,7,32,32
1683699325233,BICD 100R,A02,202019,Smith; Laurie,0,3,32,32
1683699325233,BICD 100R,A03,202020,Smith; Laurie,0,1,32,32
1683699325233,BICD 100R,A04,202021,Smith; Laurie,6,0,32,26
1683699325233,BICD 100R,A05,202022,Smith; Laurie,10,0,32,22
1683699326262,BICD 136,A01,193242,Gustafson-Brown; Cindy,0,2,32,32
1683699326262,BICD 136,A02,193244,Gustafson-Brown; Cindy,13,0,32,19
1683699327349,BIEB 102,A01,193249,Butler; Shannon Rhey,0,0,32,32
1683699327349,BIEB 102,A02,193251,Butler; Shannon Rhey,0,0,32,32
1683699327349,BIEB 102,A03,193253,Butler; Shannon Rhey,0,0,32,32
1683699327349,BIEB 102,A04,193255,Butler; Shannon Rhey,13,0,32,19
1683699327349,BIEB 102,A05,193265,Butler; Shannon Rhey,25,0,32,7
1683699327349,BIEB 102,A06,193269,Butler; Shannon Rhey,12,0,32,20
1683699329396,BIEB 150,A01,193274,Staff,0,0,32,32
1683699329396,BIEB 150,A02,193285,Staff,24,0,32,8
1683699330424,BIEB 194,A00,193286,Kurle; Carolyn M.,19,0,32,13
1683699331449,BILD 1,A01,192291,Staff,15,0,32,17
1683699331449,BILD 1,A02,192292,Staff,30,0,32,2
1683699331449,BILD 1,B01,192520,Reuther; Keefe,0,1,0,0
1683699331449,BILD 1,B02,192532,Reuther; Keefe,0,1,0,0
1683699332474,BILD 3,A01,192556,Butler; Shannon Rhey,0,0,32,32
1683699332474,BILD 3,A02,192581,Butler; Shannon Rhey,0,1,32,32
1683699332474,BILD 3,A03,192611,Butler; Shannon Rhey,19,0,32,13
1683699332474,BILD 3,A04,192612,Butler; Shannon Rhey,23,0,32,9
1683699332474,BILD 3,A05,192613,Butler; Shannon Rhey,26,0,32,6
1683699332474,BILD 3,A06,192679,Butler; Shannon Rhey,27,0,32,5
1683699332474,BILD 3,A07,192682,Butler; Shannon Rhey,20,0,32,12
1683699333497,BILD 4,A01,192836,Reuther; Keefe,1,0,24,23
1683699333497,BILD 4,A02,193044,Reuther; Keefe,4,0,24,20
1683699334528,BILD 10,A01,193142,Gustafson-Brown; Cindy,29,0,32,3
1683699334528,BILD 10,A02,193149,Gustafson-Brown; Cindy,31,0,32,1
1683699335553,BIMM 100,A01,193301,Staff,0,6,32,32
1683699335553,BIMM 100,A02,193312,Staff,0,7,32,32
1683699335553,BIMM 100,A03,193323,Staff,0,10,32,32
1683699336577,BIMM 101,A01,193329,McDonnell; Lisa Marie,0,3,24,24
1683699336577,BIMM 101,A02,193339,McDonnell; Lisa Marie,0,3,24,24
1683699336577,BIMM 101,B01,193354,McDonnell; Lisa Marie,0,4,24,24
1683699336577,BIMM 101,B02,193357,McDonnell; Lisa Marie,0,3,24,24
1683699337601,BIMM 110,A01,193377,Tat; John,0,11,32,32
1683699337601,BIMM 110,A02,193378,Tat; John,0,11,32,32
1683699338625,BIMM 120,A01,206116,Staff,0,0,32,32
1683699338625,BIMM 120,A02,206117,Staff,7,0,32,25
1683699338625,BIMM 120,A03,206121,Staff,21,0,32,11
1683699339655,BIPN 100,A01,193393,Park; Ji Young,0,15,32,32
1683699339655,BIPN 100,A02,193402,Park; Ji Young,0,14,32,32
1683699339655,BIPN 100,A03,193413,Park; Ji Young,0,14,32,32
1683699339655,BIPN 100,A04,193414,Park; Ji Young,0,13,32,32
1683699340679,BIPN 102,A01,193429,Staff,0,0,32,32
1683699340679,BIPN 102,A02,193438,Staff,18,0,32,14
1683699341704,BIPN 106,A01,193450,Reyes Gonzalez; Catalina,0,2,40,40
1683699342734,BIPN 134,A01,193465,Cooke; James Edward,0,0,32,32
1683699342734,BIPN 134,A02,193474,Cooke; James Edward,25,0,32,7
1683699342734,BIPN 134,A03,193485,Cooke; James Edward,29,0,32,3
1683699342734,BIPN 134,A04,193486,Cooke; James Edward,20,0,32,12
1683699342734,BIPN 134,A05,193491,Cooke; James Edward,31,0,32,1
1683699342734,BIPN 134,A06,193501,Cooke; James Edward,30,0,32,2
1683699342734,BIPN 134,A07,193510,Cooke; James Edward,29,0,32,3
1683699344783,BISP 194,A00,222522,Staff,14,0,32,18
1683699345809,CAT 124,A01,202407,Staff,19,0,25,6
1683699346833,CAT 125,A00,202408,Marchisotto; Jennifer Anne,2,0,20,18
1683699347858,CAT 125R,A00,202409,Smith; Lauryn Alissa,0,11,20,20
1683699347858,CAT 125R,B00,202410,Morales; Celeste Georgianna,0,11,20,20
1683699347858,CAT 125R,C00,202411,Irwin; Matthew Joseph,0,12,20,20
1683699348886,CENG 15,A01,204712,Yang; Kesong,0,1,0,0
1683699349914,CENG 114,A00,202070,Jahed Motlagh; Zeinab,5,0,20,15
1683699350940,CGS 105,A00,185477,Wesling; Megan E.,24,0,40,16
1683699351964,CGS 106,A00,185494,Staff,11,0,22,11
1683699352988,CGS 108,A00,185495,Staff,14,0,20,6
1683699354015,CGS 114,A00,185496,Staff,13,0,18,5
1683699355041,CGS 119,A00,185501,Staff,15,0,20,5
1683699356069,CGS 120,A00,185511,Staff,12,0,20,8
1683699357092,CHEM 4,A01,184675,Bussey; Thomas J,97,0,100,3
1683699358123,CHEM 6A,A01,184677,Staff,32,0,60,28
1683699359149,CHEM 6B,A01,184679,Staff,63,0,100,37
1683699360174,CHEM 6C,A01,184681,Bussey; Thomas J,0,0,50,50
1683699360174,CHEM 6C,A02,184682,Bussey; Thomas J,32,0,50,18
1683699361198,CHEM 40A,A01,184684,Albizati; Kim F.,33,0,100,67
1683699362228,CHEM 40B,A01,184686,Albizati; Kim F.,0,22,100,100
1683699363254,CHEM 41B,A01,184690,Staff,51,0,100,49
1683699364278,COGS 3,A01,184715,Boyle; Mary E. T.,0,27,40,40
1683699365305,COGS 14B,A01,185172,Staff,0,14,38,38
1683699366328,COGS 18,A01,184736,Staff,14,0,80,66
1683699367354,COGS 100,A01,184932,Staff,0,8,73,73
1683699368382,COGS 101A,A01,184935,Staff,0,40,30,30
1683699369413,COGS 101B,A01,184944,Staff,0,2,30,30
1683699370441,COGS 101C,A01,184946,Staff,0,10,30,30
1683699371473,COGS 102A,A01,184951,Johnson; Christine M.,1,0,40,39
1683699372498,COGS 107B,A01,184953,Mooshagian; Eric Frederick,0,52,40,40
1683699373528,COGS 118B,A01,184959,Gupta; Anjum,0,50,40,40
1683699374557,COGS 153,A00,184961,Staff,1,16,30,29
1683699375581,COGS 177,A00,184962,Staff,0,20,30,30
1683699376609,COGS 187A,A01,184969,Boyle; Mary E. T.,0,19,40,40
1683699377638,COMM 10,A01,185174,Staff,0,5,25,25
1683699377638,COMM 10,A02,185189,Staff,0,2,25,25
1683699377638,COMM 10,A03,269821,Staff,0,1,0,0
1683699378662,COMM 100B,A02,185476,Staff,10,0,25,15
1683699378662,COMM 100B,A03,277340,Staff,25,0,25,0
1683699379687,COMM 100C,A01,185314,Staff,2,0,25,23
1683699379687,COMM 100C,A02,185327,Staff,17,0,25,8
1683699380712,COMM 110M,A00,185349,Staff,0,0,40,40
1683699381736,COMM 113T,A00,185352,Staff,25,0,40,15
1683699382763,COMM 114I,A00,185353,Staff,31,0,40,9
1683699383791,COMM 131,A00,185354,Staff,17,0,30,13
1683699384820,CSE 8A,A50,185358,Cao; Yingjun,0,46,10,10
1683699385844,CSE 8B,A01,185362,Staff,0,48,50,50
1683699386873,CSE 11,A01,185416,Cao; Yingjun,0,91,10,10
1683699387897,CSE 20,A01,185445,Briones; Jor-el Thomas Caparas,3,0,25,22
1683699388921,CSE 21,A01,185447,Staff,9,0,50,41
1683699389945,CSE 101,A01,185451,Staff,0,13,50,50
1683699389945,CSE 101,B01,185453,Jones; Miles E,0,14,50,50
1683699391997,CSE 141,A01,185458,Eldon; John,16,0,100,84
1683699393028,CSE 141L,A01,185461,Eldon; John,8,0,100,92
1683699394053,CSE 142,A01,185463,Staff,34,0,60,26
1683699394053,CSE 142,B01,201355,Staff,0,7,60,60
1683699395078,CSE 142L,A01,185470,Staff,34,0,60,26
1683699395078,CSE 142L,B01,201417,Staff,0,6,60,60
1683699396105,CSE 190,A00,201433,Staff,32,0,49,17
1683699397129,DOC 1,A01,259136,Strom; Megan C.,7,0,15,8
1683699397129,DOC 1,A02,259137,Strom; Megan C.,14,0,15,1
1683699397129,DOC 1,A03,259138,Strom; Megan C.,14,0,15,1
1683699397129,DOC 1,A04,259139,Strom; Megan C.,14,0,15,1
1683699398153,DOC 100D,A00,259140,Pass; Natalye Joann,14,0,25,11
1683699399178,DSGN 1,A01,184749,Rill; Bryan,0,26,30,30
1683699400201,DSGN 100,A01,185168,Staff,0,2,25,25
1683699401225,ECE 5,A01,185626,Morris; Karcher William,0,12,0,0
1683699402253,ECE 101,A01,185628,Staff,14,0,70,56
1683699403281,ECE 107,A01,185635,Baghdadchi; Saharnaz,0,0,20,20
1683699403281,ECE 107,A02,185638,Baghdadchi; Saharnaz,1,0,20,19
1683699404308,ECE 148,A01,185647,Silberman; Jack,0,0,16,16
1683699405333,ECON 1,A01,185537,Crane; Meredith Helen,54,0,70,16
1683699406355,ECON 3,A01,185549,Crane; Meredith Helen,30,0,70,40
1683699407382,ECON 4,A01,203354,Anderson; John Charles,0,5,10,10
1683699408409,ECON 100A,A01,185574,Staff,0,5,40,40
1683699409433,ECON 100B,A01,185576,Staff,0,12,50,50
1683699410458,ECON 100C,A01,185589,Newhouse; Herbert S,30,0,70,40
1683699411483,ECON 105,A00,185608,Vespa; Emanuel Ignacio,19,0,35,16
1683699412507,ECON 109,A01,185610,Shishkin; Denis,9,0,35,26
1683699413531,ECON 110A,A01,185612,Staff,8,0,40,32
1683699414559,ECON 120A,A01,185615,Staff,19,0,40,21
1683699415587,ECON 120C,A01,185617,Sun; Yixiao,0,21,70,70
1683699416617,ECON 144,A00,203346,Squires; Dale E,2,0,35,33
1683699417643,ECON 171,A01,203349,Newhouse; Herbert S,0,1,35,35
1683699418674,ECON 173A,A01,185621,Toda; Alexis Akira,21,0,35,14
1683699419700,EDS 25,A01,202413,Staff,0,1,0,0
1683699419700,EDS 25,A02,202414,Staff,0,1,0,0
1683699419700,EDS 25,A03,202415,Staff,0,0,0,0
1683699419700,EDS 25,A04,202416,Staff,0,1,0,0
1683699419700,EDS 25,A05,202439,Staff,0,0,0,0
1683699419700,EDS 25,A06,202440,Staff,0,0,0,0
1683699419700,EDS 25,B01,202631,Staff,0,0,0,0
1683699419700,EDS 25,B02,202632,Staff,0,0,0,0
1683699419700,EDS 25,B03,202639,Staff,0,0,0,0
1683699419700,EDS 25,B04,202640,Staff,0,0,0,0
1683699419700,EDS 25,B05,202643,Staff,0,0,0,0
1683699419700,EDS 25,B06,202644,Staff,0,0,0,0
1683699420725,EDS 38,A01,202659,Black; Alison Michelle,24,0,25,1
1683699421751,EDS 115,A00,202652,Staff,18,0,30,12
1683699422779,EDS 125,A00,202649,Staff,13,0,30,17
1683699423805,EDS 126,A01,203332,Staff,30,0,30,0
1683699424829,EDS 139,A00,202838,Staff,16,0,25,9
1683699425853,EDS 146,A01,202655,Staff,14,0,25,11
1683699426877,ENG 15,A00,185667,Staff,0,1,0,0
1683699426877,ENG 15,B00,185672,Staff,0,0,0,0
1683699426877,ENG 15,C00,185675,Staff,0,0,0,0
1683699426877,ENG 15,D00,185682,Staff,0,0,0,0
1683699426877,ENG 15,E00,185684,Staff,0,0,0,0
1683699427901,ETHN 103,A00,185710,Staff,0,8,35,35
1683699428926,ETHN 103A,A00,199228,Man; Simeon S,0,0,9,9
1683699429953,ETHN 109,A00,185711,Staff,15,0,35,20
1683699431038,ETHN 142,A00,185726,Staff,0,4,30,30
1683699432063,ETHN 163J,A00,199229,Man; Simeon S,5,0,8,3
1683699433088,ETHN 168,A00,185727,Staff,7,0,10,3
1683699434116,ETHN 182,A00,185728,Staff,0,0,35,35
1683699435140,ETHN 183,A00,185737,Staff,9,0,18,9
1683699436166,GLBH 111,A01,209361,Burgos; Jose L.,0,0,0,0
1683699438217,HIEU 104,A00,185792,Staff,14,0,20,6
1683699439246,HIEU 115,A00,185800,Staff,0,0,20,20
1683699440273,HIEU 128,A00,185801,Staff,0,9,20,20
1683699441301,HIEU 147,A00,185802,Staff,15,0,20,5
1683699442324,HIEU 154,A00,185823,Staff,11,0,20,9
1683699443349,HILA 102,A00,185826,Staff,14,0,20,6
1683699444375,HILD 2C,A01,185778,Staff,0,13,20,20
1683699445399,HILD 7B,A01,185780,Kwak; Nancy,0,17,32,32
1683699445399,HILD 7B,A02,185781,Kwak; Nancy,0,18,32,32
1683699446427,HILD 30,A01,185791,Staff,12,0,20,8
1683699447454,HISC 119,A00,185830,Golan; Tal,0,10,20,20
1683699448478,HITO 156GS,A00,185831,Patterson; Patrick H.,0,0,0,23
1683699449501,HIUS 103,A00,185832,Man; Simeon S,0,4,20,20
1683699450529,HIUS 117,A00,185836,Kwak; Nancy,2,0,20,18
1683699451557,HIUS 125,A00,185840,Man; Simeon S,0,2,23,23
1683699452585,HIUS 149,A00,185845,Staff,1,0,20,19
1683699453610,HUM 3,A01,185882,Zavodny; Tatiana Sophia,0,8,50,50
1683699453610,HUM 3,B01,185899,Caldwell; Michael Alan,0,18,50,50
1683699454634,HUM 3GS,A00,185900,Patterson; Patrick H.,0,0,0,23
1683699455659,HUM 4,A01,185938,Zroka; Amy Liane,28,0,50,22
1683699455659,HUM 4,B01,185956,Watkins; Eric,0,6,50,50
1683699455659,HUM 4,B02,202209,Watkins; Eric,0,5,50,50
1683699455659,HUM 4,B03,202210,Watkins; Eric,0,5,50,50
1683699456683,HUM 5,A01,185958,West; Geoffrey Scott,0,0,50,50
1683699456683,HUM 5,A02,202215,West; Geoffrey Scott,0,1,50,50
1683699457706,INTL 190,A00,185959,Gagnon; Jeffrey C,0,0,0,9
1683699457706,INTL 190,B00,185960,Lettieri; Michael Joseph,0,0,0,2
1683699458731,JAPN 180,A00,254509,Staff,5,0,30,25
1683699459755,LATI 10,A01,202853,Kennemore; Amy Michelle,4,0,35,31
1683699459755,LATI 10,A02,202854,Kennemore; Amy Michelle,3,0,35,32
1683699459755,LATI 10,A03,270054,Kennemore; Amy Michelle,30,0,30,0
1683699460782,LATI 180,A00,202855,Kennemore; Amy Michelle,11,0,20,9
1683699461809,LAWS 101,A00,201767,Golan; Tal,0,7,40,40
1683699462836,LIFR 1C,A00,185961,Staff,6,0,20,14
1683699463861,LIFR 1CX,A00,185962,Staff,7,0,20,13
1683699464885,LIFR 1D,A00,185963,Staff,7,0,20,13
1683699465908,LIFR 1DX,A00,185964,Staff,7,0,20,13
1683699466936,LIGN 101,A01,186039,Staff,43,0,50,7
1683699467964,LIGN 165,A00,186040,Staff,14,0,50,36
1683699468991,LTCS 108,A00,186041,Staff,5,0,10,5
1683699470015,LTCS 119,A00,186042,Staff,15,0,20,5
1683699471040,LTCS 130,A00,186043,Wesling; Megan E.,15,0,25,10
1683699473092,LTEA 138,A00,186119,Staff,14,0,40,26
1683699474115,LTEN 124,A00,186148,Staff,5,0,25,20
1683699475140,LTEN 178,A00,186149,Staff,6,0,15,9
1683699476164,LTEN 181,A00,186150,Blanco; John D,34,0,40,6
1683699477192,LTWL 120,A00,186160,Staff,19,0,25,6
1683699478215,LTWL 165,A00,186161,Staff,22,0,25,3
1683699479241,LTWR 100,A00,186162,Staff,0,5,15,15
1683699480269,LTWR 102,A00,186163,Doller; Ben,5,0,15,10
1683699481294,MAE 8,A01,186412,Staff,0,1,0,0
1683699482321,MAE 30B,A00,186445,Bahadori; Mohammad Yousef,81,0,100,19
1683699483346,MAE 40,A00,186592,Bewley; Thomas R,10,0,50,40
1683699484374,MAE 101B,A00,186593,Bahadori; Mohammad Yousef,80,0,100,20
1683699485402,MAE 105,A00,186594,Bandaru; Prabhakar,10,0,50,40
1683699486429,MAE 107,A00,186599,Pham; Hieu Tan,0,8,120,120
1683699487456,MAE 148,A01,186660,Silberman; Jack,3,0,16,13
1683699488485,MATH 10A,A01,188095,Staff,0,6,35,35
1683699489510,MATH 10B,A01,188097,Bowers; Adam R.,0,12,30,30
1683699489510,MATH 10B,A02,188099,Bowers; Adam R.,0,11,30,30
1683699489510,MATH 10B,B01,188104,Bowers; Adam R.,0,10,30,30
1683699489510,MATH 10B,B02,188106,Bowers; Adam R.,0,9,30,30
1683699490536,MATH 10C,A01,188111,Staff,0,20,30,30
1683699490536,MATH 10C,A02,188127,Staff,0,19,30,30
1683699490536,MATH 10C,A03,188131,Staff,0,19,30,30
1683699490536,MATH 10C,B01,188218,Staff,17,0,30,13
1683699490536,MATH 10C,B02,188244,Staff,13,0,30,17
1683699490536,MATH 10C,B03,188277,Staff,14,0,30,16
1683699491566,MATH 18,A01,188344,Bach; Quang Tran,18,0,30,12
1683699491566,MATH 18,A02,188345,Bach; Quang Tran,11,0,30,19
1683699491566,MATH 18,B01,188353,Bach; Quang Tran,11,0,30,19
1683699491566,MATH 18,B02,188354,Bach; Quang Tran,19,0,30,11
1683699492594,MATH 20A,A01,188374,Staff,11,0,35,24
1683699493620,MATH 20B,A01,188382,Ohm; Ko Woon,7,0,30,23
1683699493620,MATH 20B,A02,188383,Ohm; Ko Woon,22,0,30,8
1683699493620,MATH 20B,B01,188385,Ohm; Ko Woon,7,0,30,23
1683699493620,MATH 20B,B02,188392,Ohm; Ko Woon,22,0,30,8
1683699494650,MATH 20C,A01,188394,Harel; Guershon,10,0,30,20
1683699494650,MATH 20C,A02,188395,Harel; Guershon,13,0,30,17
1683699494650,MATH 20C,B01,188404,Harel; Guershon,5,0,30,25
1683699494650,MATH 20C,B02,188405,Harel; Guershon,18,0,30,12
1683699495676,MATH 20D,A01,188414,Hammock; Frances H,0,1,30,30
1683699495676,MATH 20D,A02,188415,Hammock; Frances H,0,1,30,30
1683699495676,MATH 20D,B01,188447,Hammock; Frances H,0,1,30,30
1683699495676,MATH 20D,B02,188486,Hammock; Frances H,2,0,30,28
1683699496701,MATH 20E,A01,188649,Staff,21,0,30,9
1683699496701,MATH 20E,A02,188650,Staff,20,0,30,10
1683699496701,MATH 20E,A03,188673,Staff,0,0,30,30
1683699497726,MATH 102,A01,188675,Staff,0,40,35,35
1683699498752,MATH 103B,A01,188681,Staff,3,0,35,32
1683699498752,MATH 103B,B01,188692,Staff,5,0,35,30
1683699499777,MATH 109,A01,188695,Salehi Golsefidy; Alireza,24,0,35,11
1683699499777,MATH 109,A02,188696,Salehi Golsefidy; Alireza,25,0,35,10
1683699500807,MATH 120A,A01,188698,Eggers; John Dietrich,7,0,35,28
1683699501830,MATH 142B,A01,188736,Ioana; Adrian,0,0,30,30
1683699501830,MATH 142B,A02,188741,Ioana; Adrian,0,1,30,30
1683699501830,MATH 142B,A03,188743,Ioana; Adrian,0,2,30,30
1683699502860,MATH 168A,A01,188790,Staff,0,11,35,35
1683699503889,MATH 170A,A01,188803,Nie; Jiawang,0,2,35,35
1683699503889,MATH 170A,A02,188811,Nie; Jiawang,0,1,35,35
1683699503889,MATH 170A,A03,188814,Nie; Jiawang,0,0,35,35
1683699503889,MATH 170A,A04,188815,Nie; Jiawang,5,0,35,30
1683699504917,MATH 193B,A01,188817,Staff,0,0,35,35
1683699504917,MATH 193B,A02,188818,Staff,6,0,35,29
1683699505942,MGT 4,A01,202857,Anderson; John Charles,59,0,80,21
1683699506969,MGT 12,A00,202858,Lindenberger; Wade Douglas,40,0,90,50
1683699507993,MGT 18,A00,202859,Staff,74,0,90,16
1683699509025,MGT 18GS,A00,202860,McKay; Michael J,13,0,28,15
1683699510058,MGT 45,A00,202861,Pecore; Joseph P.,8,0,90,82
1683699511086,MGT 100,A00,202863,Yavorsky; Daniel Ryan,27,0,90,63
1683699512115,MGT 103,A00,202864,Ehrich; Kristine R,0,19,90,90
1683699513141,MGT 112,A00,202865,Ehrich; Kristine R,15,0,90,75
1683699514173,MGT 121A,A00,202868,Staff,70,0,90,20
1683699515198,MGT 131B,A00,202869,Anderson; John Charles,58,0,90,32
1683699516221,MGT 136,A00,202871,Lindenberger; Wade Douglas,83,0,90,7
1683699517245,MGT 164,A00,202873,Staff,0,67,90,91
1683699518273,MGT 164GS,A00,202874,McKay; Mary A,13,0,28,15
1683699519296,MGT 180,A00,202875,Staff,0,51,90,91
1683699520323,MMW 11R,A01,205019,Herbst; Matthew,0,0,30,30
1683699520323,MMW 11R,A02,205026,Herbst; Matthew,29,0,30,1
1683699521349,MMW 15,A01,193512,Chang; Edmond Yi-Teh,0,8,28,28
1683699521349,MMW 15,A02,193513,Chang; Edmond Yi-Teh,0,5,28,28
1683699521349,MMW 15,A03,193514,Chang; Edmond Yi-Teh,0,5,28,28
1683699521349,MMW 15,A04,193515,Chang; Edmond Yi-Teh,0,5,28,28
1683699521349,MMW 15,A05,193516,Chang; Edmond Yi-Teh,0,5,28,28
1683699521349,MMW 15,A06,193517,Chang; Edmond Yi-Teh,0,6,28,28
1683699521349,MMW 15,B01,193519,Chang; Edmond Yi-Teh,0,5,28,28
1683699521349,MMW 15,B02,193520,Chang; Edmond Yi-Teh,0,5,28,28
1683699521349,MMW 15,B03,193521,Chang; Edmond Yi-Teh,0,5,28,28
1683699521349,MMW 15,B04,193522,Chang; Edmond Yi-Teh,0,6,28,28
1683699521349,MMW 15,B05,193523,Chang; Edmond Yi-Teh,0,5,28,28
1683699521349,MMW 15,B06,193524,Chang; Edmond Yi-Teh,0,5,28,28
1683699522376,MMW 122,A01,193526,Rahimi; Babak,0,16,28,28
1683699522376,MMW 122,A02,193527,Rahimi; Babak,0,15,28,28
1683699522376,MMW 122,A03,193528,Rahimi; Babak,0,0,0,0
1683699522376,MMW 122,A04,193529,Rahimi; Babak,0,0,0,0
1683699523401,MUS 1A,A01,186663,Staff,0,18,35,35
1683699524427,MUS 4,A01,186715,Staff,0,12,35,35
1683699525451,MUS 5R,A01,186796,Dubnov; Shlomo,0,17,35,35
1683699526476,MUS 6,A01,186798,Staff,0,4,25,25
1683699527500,MUS 7,A01,186830,Staff,11,0,35,24
1683699528528,MUS 8,A01,186930,Staff,0,27,35,35
1683699529557,MUS 15,A01,186932,Staff,0,15,35,35
1683699529557,MUS 15,B01,186934,Staff,0,16,35,35
1683699530582,MUS 80,A00,186935,Staff,0,0,20,20
1683699530582,MUS 80,B00,186936,Staff,24,0,25,1
1683699531609,NANO 11,A00,204702,Lipomi; Darren John,0,0,0,0
1683699532637,NANO 15,A01,204709,Yang; Kesong,0,1,0,0
1683699533664,NANO 114,A00,202069,Jahed Motlagh; Zeinab,2,0,10,8
1683699534747,PHIL 1,A00,186955,Grush; Rick Scott,31,0,40,9
1683699535777,PHIL 10,A01,186973,Grush; Rick Scott,27,0,35,8
1683699535777,PHIL 10,A02,186974,Grush; Rick Scott,33,0,35,2
1683699536801,PHIL 13,A01,186976,Staff,1,0,35,34
1683699536801,PHIL 13,A02,186977,Staff,16,0,35,19
1683699537826,PHIL 14,A01,186979,Staff,31,0,35,4
1683699537826,PHIL 14,A02,186986,Staff,32,0,35,3
1683699538851,PHIL 28,A01,186988,Staff,16,0,30,14
1683699538851,PHIL 28,A02,186989,Staff,1,0,30,29
1683699538851,PHIL 28,A03,186990,Staff,10,0,30,20
1683699538851,PHIL 28,A04,186991,Staff,26,0,30,4
1683699539880,PHIL 120,A00,186997,Staff,23,0,40,17
1683699540903,PHIL 137,A00,187003,Staff,7,0,40,33
1683699541926,PHIL 150,A00,187015,Staff,47,0,70,23
1683699542955,PHIL 167,A00,187021,Lamey; Andy M.,34,0,40,6
1683699543981,PHIL 174,A01,202226,Staff,17,0,20,3
1683699543981,PHIL 174,A02,202235,Staff,20,0,20,0
1683699545004,PHIL 191A,A00,258918,Staff,0,0,1,1
1683699546029,PHYS 1A,A00,187028,Staff,26,0,60,34
1683699547055,PHYS 1AL,001,187036,Staff,3,0,30,27
1683699547055,PHYS 1AL,002,187049,Staff,18,0,30,12
1683699548078,PHYS 1B,A00,187058,Staff,21,0,60,39
1683699549108,PHYS 1BL,001,187064,Staff,0,1,30,30
1683699549108,PHYS 1BL,002,187070,Staff,4,0,30,26
1683699550135,PHYS 1C,A00,187082,Staff,30,0,120,90
1683699551164,PHYS 1CL,001,187088,Staff,0,9,30,30
1683699551164,PHYS 1CL,002,187089,Staff,0,1,30,30
1683699551164,PHYS 1CL,009,262693,Staff,9,0,30,21
1683699552190,PHYS 2B,A01,187097,Staff,55,0,115,60
1683699553215,PHYS 2C,A01,187099,Staff,63,0,115,52
1683699554245,PHYS 2CL,A01,187101,Staff,5,0,28,23
1683699554245,PHYS 2CL,A02,187102,Staff,15,0,28,13
1683699555272,PHYS 2D,A01,187123,Shotwell; Brian,95,0,115,20
1683699556296,PHYS 4B,A01,187133,Grinstein; Benjamin,35,0,50,15
1683699557325,POLI 10,A00,188819,Staff,0,4,50,50
1683699558352,POLI 11,A00,188827,Staff,43,0,50,7
1683699559379,POLI 13R,A00,188828,Staff,0,1,20,20
1683699560405,POLI 27,A01,188830,Elgin; Samuel Zincke,0,2,70,70
1683699561429,POLI 30,A00,188832,Desposato; Scott,30,0,50,20
1683699562453,POLI 102F,A00,188834,Staff,1,0,40,39
1683699563482,POLI 104A,A00,188852,Staff,12,0,30,18
1683699564510,POLI 104I,A00,188853,Staff,0,8,20,20
1683699565535,POLI 110B,A00,188854,Wiens; David,6,0,20,14
1683699566562,POLI 112A,A00,188855,Wiens; David,3,0,30,27
1683699567589,POLI 117R,A00,188856,Forman; Fonna,0,12,20,20
1683699568617,POLI 118,A00,188857,Ingham; Sean,8,0,20,12
1683699569642,POLI 120G,A00,188858,Staff,8,0,30,22
1683699570666,POLI 131CR,A00,188863,Hoston; Germaine,20,0,50,30
1683699571690,POLI 133,A00,188864,Nellis; Gareth Hb,44,0,50,6
1683699572718,POLI 134D,A00,188865,Desposato; Scott,27,0,30,3
1683699573743,POLI 142A,A00,188871,Gartzke; Erik,21,0,50,29
1683699574769,POLI 142K,A00,188874,Staff,38,0,50,12
1683699575793,POLI 143,A00,188940,Gartzke; Erik,16,0,30,14
1683699576817,POLI 153,A00,188943,Staff,2,0,20,18
1683699577845,POLI 160AA,A00,188944,Staff,10,0,40,30
1683699578870,POLI 170A,A00,188945,Staff,10,0,30,20
1683699580923,PSYC 1,A00,188952,Staff,36,0,90,54
1683699581951,PSYC 2,B00,188953,Staff,19,0,35,16
1683699582975,PSYC 6,A00,188970,Staff,47,0,60,13
1683699584004,PSYC 7,A00,188973,Staff,35,0,45,10
1683699585032,PSYC 60,A01,188980,Rickard; Timothy C.,42,0,60,18
1683699586060,PSYC 70,A01,189001,Steiner; Eric Tomas,21,0,45,24
1683699587084,PSYC 100,A00,189005,Lacefield; Katharine I,0,98,120,120
1683699588110,PSYC 102,A00,189008,Staff,6,0,30,24
1683699589135,PSYC 106,B00,189026,Gorman; Michael R.,27,0,60,33
1683699590158,PSYC 114,B01,189033,Winkielman; Piotr,0,31,30,30
1683699591187,PSYC 131,A00,189036,Anagnostaras; Stephan,0,44,60,60
1683699592211,PSYC 136,A00,189041,Lowe; Angela Beth,0,7,25,25
1683699593235,PSYC 137,A00,189057,Winkielman; Piotr,0,36,25,25
1683699594261,PSYC 144,A00,189107,Wixted; John T,0,11,50,50
1683699596310,PSYC 162,A00,189142,Staff,0,9,85,85
1683699597340,PSYC 172,A00,189144,Gorman; Michael R.,0,6,30,30
1683699599391,PSYC 179,A00,189146,Lacefield; Katharine I,0,88,120,120
1683699600419,PSYC 181,A00,189147,Anagnostaras; Stephan,0,45,90,90
1683699601447,PSYC 190R,A00,189148,Barner; David A.,0,23,80,80
1683699602482,PSYC 191,A00,189275,Rickard; Timothy C.,0,11,25,25
1683699603506,PSYC 193,A00,189276,Chapman; Eddie Nathaniel,0,1,0,4
1683699604531,PSYC 193L,A01,189281,Lowe; Angela Beth,8,0,20,12
1683699604531,PSYC 193L,B01,189285,Staff,28,0,35,7
1683699605559,RELI 149,A00,187137,Rahimi; Babak,6,0,40,34
1683699606584,SE 9,A01,187315,Staff,0,2,18,18
1683699607611,SE 101B,A00,187409,Staff,24,0,30,6
1683699608635,SE 110B,A00,187444,Staff,10,0,40,30
1683699609659,SE 130B,A00,187449,Staff,31,0,40,9
1683699610684,SE 150A,A00,187516,Staff,8,0,20,12
1683699611708,SE 154,A00,187528,Staff,29,0,50,21
1683699612735,SIO 3,A01,258171,Staff,35,0,40,5
1683699613758,SIO 10,A00,187144,Cook; Geoffrey W,0,6,75,75
1683699614783,SIO 45,A00,187152,Cook; Geoffrey W,0,7,100,100
1683699615806,SIO 109R,A00,194486,Staff,0,4,20,20
1683699617860,SIO 187,A01,187233,Kacev; David,12,0,40,28
1683699618885,SOCI 1,A01,258656,Thorpe; Charles Robert,28,0,30,2
1683699618885,SOCI 1,A02,258658,Thorpe; Charles Robert,30,0,30,0
1683699618885,SOCI 1,A03,258661,Thorpe; Charles Robert,25,0,25,0
1683699618885,SOCI 1,A04,258666,Thorpe; Charles Robert,22,0,25,3
1683699618885,SOCI 1,A05,258897,Thorpe; Charles Robert,22,0,25,3
1683699618885,SOCI 1,A06,258898,Thorpe; Charles Robert,25,0,25,0
1683699619911,SOCI 30,A01,258903,Pardo Guerra; Juan Pablo,14,0,30,16
1683699620934,SOCI 102,A00,258904,Staff,9,0,25,16
1683699621959,SOCI 106,A00,258905,Staff,19,0,25,6
1683699622988,SOCI 111,A00,258907,Ribas Norris; Janet Vanesa,26,0,30,4
1683699624013,SOCI 121R,A00,258908,Pardo Guerra; Juan Pablo,7,0,30,23
1683699625043,SOCI 126,A01,203330,Staff,14,0,20,6
1683699626067,SOCI 131,A00,258909,Thorpe; Charles Robert,30,0,60,30
1683699627093,SOCI 135,A00,258910,Payne; Christine Anna,0,13,30,30
1683699628119,SOCI 157,A00,258911,Staff,10,0,30,20
1683699629143,SOCI 184,A00,258912,Staff,25,0,30,5
1683699630168,SOCI 188D,A00,258913,Staff,22,0,30,8
1683699631191,SYN 2,001,187529,Staff,9,0,16,7
1683699631191,SYN 2,002,201452,Staff,0,20,16,16
1683699631191,SYN 2,003,201469,Staff,1,0,16,15
1683699632219,SYN 100,A01,187531,Staff,0,9,20,20
1683699632219,SYN 100,B01,201491,Staff,0,10,20,20
1683699633245,TDAC 1,A00,189286,Walsh; Kim C.,3,0,20,17
1683699633245,TDAC 1,B00,189287,Harting; Carla Kelso,10,0,20,10
1683699634269,TDAC 101,A00,189300,Walsh; Kim C.,16,0,20,4
1683699634269,TDAC 101,B00,189301,Harting; Carla Kelso,18,0,20,2
1683699635293,TDAC 102,A00,189304,Basso; Beatrice,14,0,20,6
1683699636317,TDAC 108,A00,189305,Staff,18,0,20,2
1683699637345,TDDE 131,A00,189310,Staff,19,0,20,1
1683699637345,TDDE 131,B00,189314,Staff,19,0,20,1
1683699637345,TDDE 131,C00,189315,Staff,48,0,50,2
1683699637345,TDDE 131,D00,189316,Staff,14,0,15,1
1683699637345,TDDE 131,E00,204841,Staff,20,0,20,0
1683699638428,TDGE 10,A00,189289,Staff,27,0,50,23
1683699638428,TDGE 10,B00,189290,Havis; Allan,0,1,50,50
1683699639468,TDGE 11,A00,189291,Fulton; Julia,0,4,50,50
1683699639468,TDGE 11,B00,189292,Staff,20,0,25,5
1683699639468,TDGE 11,C00,260270,Staff,0,0,0,0
1683699640492,TDGE 25,A00,189294,Staff,1,0,20,19
1683699641519,TDGE 124,A00,189318,Fulton; Julia,0,7,50,50
1683699642544,TDGE 125,A00,189319,Staff,13,0,25,12
1683699642544,TDGE 125,B00,189320,Staff,23,0,25,2
1683699643571,TDGE 127,A00,189322,Havis; Allan,1,0,50,49
1683699644594,TDHT 101,A00,189323,Staff,18,0,25,7
1683699644594,TDHT 101,B00,189324,Staff,25,0,25,0
1683699645618,TDHT 102,A00,189325,Staff,49,0,50,1
1683699646642,TDMV 1,A00,189295,Arcidiacono; Kristin,20,0,30,10
1683699646642,TDMV 1,B00,189296,Caligagan; Maria T.,24,0,30,6
1683699647669,TDMV 2,A00,189297,Sammartano; Tonnie,27,0,30,3
1683699647669,TDMV 2,B00,189299,Arcidiacono; Kristin,23,0,30,7
1683699648693,TDMV 3,A00,204998,Rincon; Alicia,22,0,30,8
1683699649721,TDMV 120,A00,189458,Sammartano; Tonnie,28,0,30,2
1683699650748,TDMV 138,A00,189541,Jun; Grace Shin Hae,20,0,40,20
1683699651782,TDMV 142,A00,189717,Caligagan; Tony,25,0,30,5
1683699651782,TDMV 142,B00,189718,Caligagan; Maria T.,25,0,30,5
1683699652807,TMC 2,A01,187533,Staff,25,0,25,0
1683699652807,TMC 2,A02,187534,Staff,25,0,25,0
1683699653835,USP 1,A01,187536,Kwak; Nancy,0,16,25,25
1683699654862,USP 5,A01,187538,Staff,8,0,25,17
1683699655886,USP 101,A00,199253,Staff,0,4,0,0
1683699656914,USP 124,A00,187562,Boomhower; Matthew Charles,0,0,30,30
1683699657938,USP 138,A00,187582,Staff,19,0,25,6
1683699658965,USP 152,A01,187597,Staff,3,0,25,22
1683699659992,USP 153,A00,187598,Staff,18,0,25,7
1683699661020,USP 168,A00,187607,Kwak; Nancy,2,0,5,3
1683699662045,USP 173,A00,187619,Staff,4,0,25,21
1683699663068,USP 181,A00,187638,Staff,0,4,25,25
1683699664095,VIS 103,A00,187650,Cruz; Edwin Teddy,17,0,75,58
1683699665119,VIS 110D,A00,187669,Staff,13,0,22,9
1683699666148,VIS 127C,A00,187720,Shen; Kuiyi,67,0,146,79
1683699667179,VIS 149,A00,187731,Yoldas; Pinar,0,12,22,22
1683699668206,VIS 151,A01,188091,Staff,22,0,34,12
1683699668206,VIS 151,A02,188092,Staff,11,0,34,23
1683699669234,VIS 160B,A00,188093,Stalbaum; Brett,0,1,10,10
1683699671285,WCWP 10B,A00,201720,Staff,0,0,5,5
1683699671285,WCWP 10B,B00,201722,Staff,0,0,6,6
1683699672309,WCWP 100,A00,201725,Gagnon; Jeffrey C,0,0,2,2
1683699672309,WCWP 100,B00,201727,Staff,0,4,15,15
1683699675397,ANBI 133,A00,258401,Wilder; Linnea Lorene,34,0,40,6
1683699676421,ANBI 140,A00,258395,Hrvoj Mihic; Branka,18,0,25,7
1683699677445,ANSC 120,A00,258402,Bialecki; Jon Anthony,26,0,40,14
1683699678473,ANSC 144,A00,258400,Staff,12,0,40,28
1683699680523,ANSC 166,A00,258396,Parish; Steven Martin,156,0,175,19
1683699681549,ANSC 180,A00,193533,Staff,8,0,20,12
1683699682573,ANSC 188,A00,258397,Jassal; Aftab,34,0,40,6
1683699683598,ANTH 3,A01,258316,Staff,23,0,30,7
1683699684625,ANTH 5,A00,258394,Semendeferi; Ekaterini,16,0,20,4
1683699685648,ANTH 21,A01,258331,Staff,4,0,40,36
1683699686672,ANTH 103,A00,258398,Varma; Saiba,15,0,25,10
1683699687703,AWP 10,001,202034,Staff,0,0,0,0
1683699687703,AWP 10,002,202035,Staff,0,0,0,0
1683699687703,AWP 10,003,202036,Staff,0,0,0,0
1683699687703,AWP 10,004,202037,Staff,0,0,0,0
1683699687703,AWP 10,005,202038,Staff,0,0,0,0
1683699687703,AWP 10,006,202039,Staff,0,0,0,0
1683699687703,AWP 10,007,202040,Staff,0,0,0,0
1683699687703,AWP 10,008,202041,Staff,0,0,0,0
1683699687703,AWP 10,009,202042,Staff,0,0,0,0
1683699687703,AWP 10,010,202043,Staff,0,0,0,0
1683699687703,AWP 10,011,202044,Staff,0,0,0,0
1683699687703,AWP 10,012,202045,Staff,0,0,0,0
1683699687703,AWP 10,013,202046,Staff,0,0,0,0
1683699687703,AWP 10,014,202047,Staff,0,0,0,0
1683699687703,AWP 10,015,202048,Staff,0,0,0,0
1683699687703,AWP 10,016,202049,Staff,0,0,0,0
1683699687703,AWP 10,017,202050,Staff,0,0,0,0
1683699687703,AWP 10,018,202051,Staff,0,0,0,0
1683699687703,AWP 10,019,202052,Staff,0,0,0,0
1683699687703,AWP 10,020,202053,Staff,0,0,0,0
1683699687703,AWP 10,021,202054,Staff,0,0,0,0
1683699687703,AWP 10,022,202055,Staff,0,0,0,0
1683699687703,AWP 10,023,202056,Staff,0,0,0,0
1683699687703,AWP 10,024,202057,Staff,0,0,0,0
1683699687703,AWP 10,025,202058,Staff,0,0,0,0
1683699687703,AWP 10,026,202059,Staff,0,0,0,0
1683699688727,AWP 102,001,202032,Staff,0,0,0,0
1683699688727,AWP 102,002,202033,Staff,0,0,0,0
1683699689785,BENG 100,A01,254234,Taylor Amos; Alyssa C,31,0,40,9
1683699690811,BENG 196,001,270013,Engler; Adam J.,9999,0,9999,0
1683699691835,BICD 100R,A01,202018,Smith; Laurie,0,7,32,32
1683699691835,BICD 100R,A02,202019,Smith; Laurie,0,3,32,32
1683699691835,BICD 100R,A03,202020,Smith; Laurie,0,1,32,32
1683699691835,BICD 100R,A04,202021,Smith; Laurie,6,0,32,26
1683699691835,BICD 100R,A05,202022,Smith; Laurie,10,0,32,22
1683699692859,BICD 136,A01,193242,Gustafson-Brown; Cindy,0,2,32,32
1683699692859,BICD 136,A02,193244,Gustafson-Brown; Cindy,13,0,32,19
1683699693891,BIEB 102,A01,193249,Butler; Shannon Rhey,0,0,32,32
1683699693891,BIEB 102,A02,193251,Butler; Shannon Rhey,0,0,32,32
1683699693891,BIEB 102,A03,193253,Butler; Shannon Rhey,0,0,32,32
1683699693891,BIEB 102,A04,193255,Butler; Shannon Rhey,13,0,32,19
1683699693891,BIEB 102,A05,193265,Butler; Shannon Rhey,25,0,32,7
1683699693891,BIEB 102,A06,193269,Butler; Shannon Rhey,12,0,32,20
1683699695943,BIEB 150,A01,193274,Staff,0,0,32,32
1683699695943,BIEB 150,A02,193285,Staff,24,0,32,8
1683699696967,BIEB 194,A00,193286,Kurle; Carolyn M.,19,0,32,13
1683699697995,BILD 1,A01,192291,Staff,15,0,32,17
1683699697995,BILD 1,A02,192292,Staff,30,0,32,2
1683699697995,BILD 1,B01,192520,Reuther; Keefe,0,1,0,0
1683699697995,BILD 1,B02,192532,Reuther; Keefe,0,1,0,0
1683699699024,BILD 3,A01,192556,Butler; Shannon Rhey,0,0,32,32
1683699699024,BILD 3,A02,192581,Butler; Shannon Rhey,0,1,32,32
1683699699024,BILD 3,A03,192611,Butler; Shannon Rhey,19,0,32,13
1683699699024,BILD 3,A04,192612,Butler; Shannon Rhey,23,0,32,9
1683699699024,BILD 3,A05,192613,Butler; Shannon Rhey,26,0,32,6
1683699699024,BILD 3,A06,192679,Butler; Shannon Rhey,27,0,32,5
1683699699024,BILD 3,A07,192682,Butler; Shannon Rhey,20,0,32,12
1683699700051,BILD 4,A01,192836,Reuther; Keefe,1,0,24,23
1683699700051,BILD 4,A02,193044,Reuther; Keefe,4,0,24,20
1683699701075,BILD 10,A01,193142,Gustafson-Brown; Cindy,29,0,32,3
1683699701075,BILD 10,A02,193149,Gustafson-Brown; Cindy,31,0,32,1
1683699702099,BIMM 100,A01,193301,Staff,0,6,32,32
1683699702099,BIMM 100,A02,193312,Staff,0,7,32,32
1683699702099,BIMM 100,A03,193323,Staff,0,10,32,32
1683699703125,BIMM 101,A01,193329,McDonnell; Lisa Marie,0,3,24,24
1683699703125,BIMM 101,A02,193339,McDonnell; Lisa Marie,0,3,24,24
1683699703125,BIMM 101,B01,193354,McDonnell; Lisa Marie,0,4,24,24
1683699703125,BIMM 101,B02,193357,McDonnell; Lisa Marie,0,3,24,24
1683699704148,BIMM 110,A01,193377,Tat; John,0,11,32,32
1683699704148,BIMM 110,A02,193378,Tat; John,0,11,32,32
1683699705176,BIMM 120,A01,206116,Staff,0,0,32,32
1683699705176,BIMM 120,A02,206117,Staff,7,0,32,25
1683699705176,BIMM 120,A03,206121,Staff,21,0,32,11
1683699706204,BIPN 100,A01,193393,Park; Ji Young,0,15,32,32
1683699706204,BIPN 100,A02,193402,Park; Ji Young,0,14,32,32
1683699706204,BIPN 100,A03,193413,Park; Ji Young,0,14,32,32
1683699706204,BIPN 100,A04,193414,Park; Ji Young,0,13,32,32
1683699707232,BIPN 102,A01,193429,Staff,0,0,32,32
1683699707232,BIPN 102,A02,193438,Staff,18,0,32,14
1683699708261,BIPN 106,A01,193450,Reyes Gonzalez; Catalina,0,2,40,40
1683699709289,BIPN 134,A01,193465,Cooke; James Edward,0,0,32,32
1683699709289,BIPN 134,A02,193474,Cooke; James Edward,25,0,32,7
1683699709289,BIPN 134,A03,193485,Cooke; James Edward,29,0,32,3
1683699709289,BIPN 134,A04,193486,Cooke; James Edward,20,0,32,12
1683699709289,BIPN 134,A05,193491,Cooke; James Edward,31,0,32,1
1683699709289,BIPN 134,A06,193501,Cooke; James Edward,30,0,32,2
1683699709289,BIPN 134,A07,193510,Cooke; James Edward,29,0,32,3
1683699711341,BISP 194,A00,222522,Staff,14,0,32,18
1683699712364,CAT 124,A01,202407,Staff,19,0,25,6
1683699713387,CAT 125,A00,202408,Marchisotto; Jennifer Anne,2,0,20,18
1683699714413,CAT 125R,A00,202409,Smith; Lauryn Alissa,0,11,20,20
1683699714413,CAT 125R,B00,202410,Morales; Celeste Georgianna,0,11,20,20
1683699714413,CAT 125R,C00,202411,Irwin; Matthew Joseph,0,12,20,20
1683699715437,CENG 15,A01,204712,Yang; Kesong,0,1,0,0
1683699716466,CENG 114,A00,202070,Jahed Motlagh; Zeinab,5,0,20,15
1683699717493,CGS 105,A00,185477,Wesling; Megan E.,24,0,40,16
1683699718519,CGS 106,A00,185494,Staff,11,0,22,11
1683699719546,CGS 108,A00,185495,Staff,14,0,20,6
1683699720577,CGS 114,A00,185496,Staff,13,0,18,5
1683699721601,CGS 119,A00,185501,Staff,15,0,20,5
1683699722625,CGS 120,A00,185511,Staff,12,0,20,8
1683699723652,CHEM 4,A01,184675,Bussey; Thomas J,97,0,100,3
1683699724680,CHEM 6A,A01,184677,Staff,32,0,60,28
1683699725705,CHEM 6B,A01,184679,Staff,63,0,100,37
1683699726735,CHEM 6C,A01,184681,Bussey; Thomas J,0,0,50,50
1683699726735,CHEM 6C,A02,184682,Bussey; Thomas J,32,0,50,18
1683699727759,CHEM 40A,A01,184684,Albizati; Kim F.,33,0,100,67
1683699728785,CHEM 40B,A01,184686,Albizati; Kim F.,0,22,100,100
1683699729813,CHEM 41B,A01,184690,Staff,51,0,100,49
1683699730838,COGS 3,A01,184715,Boyle; Mary E. T.,0,27,40,40
1683699731866,COGS 14B,A01,185172,Staff,0,14,38,38
1683699732889,COGS 18,A01,184736,Staff,14,0,80,66
1683699733914,COGS 100,A01,184932,Staff,0,8,73,73
1683699734938,COGS 101A,A01,184935,Staff,0,40,30,30
1683699735962,COGS 101B,A01,184944,Staff,0,2,30,30
1683699736988,COGS 101C,A01,184946,Staff,0,10,30,30
1683699738016,COGS 102A,A01,184951,Johnson; Christine M.,1,0,40,39
1683699739041,COGS 107B,A01,184953,Mooshagian; Eric Frederick,0,52,40,40
1683699740064,COGS 118B,A01,184959,Gupta; Anjum,0,50,40,40
1683699741088,COGS 153,A00,184961,Staff,1,16,30,29
1683699742170,COGS 177,A00,184962,Staff,0,20,30,30
1683699743202,COGS 187A,A01,184969,Boyle; Mary E. T.,0,19,40,40
1683699744227,COMM 10,A01,185174,Staff,0,5,25,25
1683699744227,COMM 10,A02,185189,Staff,0,2,25,25
1683699744227,COMM 10,A03,269821,Staff,0,1,0,0
1683699745252,COMM 100B,A02,185476,Staff,10,0,25,15
1683699745252,COMM 100B,A03,277340,Staff,25,0,25,0
1683699746279,COMM 100C,A01,185314,Staff,2,0,25,23
1683699746279,COMM 100C,A02,185327,Staff,17,0,25,8
1683699747304,COMM 110M,A00,185349,Staff,0,0,40,40
1683699748326,COMM 113T,A00,185352,Staff,25,0,40,15
1683699749349,COMM 114I,A00,185353,Staff,31,0,40,9
1683699750374,COMM 131,A00,185354,Staff,17,0,30,13
1683699751398,CSE 8A,A50,185358,Cao; Yingjun,0,46,10,10
1683699752422,CSE 8B,A01,185362,Staff,0,48,50,50
1683699753445,CSE 11,A01,185416,Cao; Yingjun,0,91,10,10
1683699754472,CSE 20,A01,185445,Briones; Jor-el Thomas Caparas,3,0,25,22
1683699755499,CSE 21,A01,185447,Staff,9,0,50,41
1683699756522,CSE 101,A01,185451,Staff,0,13,50,50
1683699756522,CSE 101,B01,185453,Jones; Miles E,0,14,50,50
1683699758571,CSE 141,A01,185458,Eldon; John,16,0,100,84
1683699759596,CSE 141L,A01,185461,Eldon; John,8,0,100,92
1683699760624,CSE 142,A01,185463,Staff,34,0,60,26
1683699760624,CSE 142,B01,201355,Staff,0,7,60,60
1683699761652,CSE 142L,A01,185470,Staff,34,0,60,26
1683699761652,CSE 142L,B01,201417,Staff,0,6,60,60
1683699762675,CSE 190,A00,201433,Staff,32,0,49,17
1683699763703,DOC 1,A01,259136,Strom; Megan C.,7,0,15,8
1683699763703,DOC 1,A02,259137,Strom; Megan C.,14,0,15,1
1683699763703,DOC 1,A03,259138,Strom; Megan C.,14,0,15,1
1683699763703,DOC 1,A04,259139,Strom; Megan C.,14,0,15,1
1683699764728,DOC 100D,A00,259140,Pass; Natalye Joann,14,0,25,11
1683699765753,DSGN 1,A01,184749,Rill; Bryan,0,26,30,30
1683699766777,DSGN 100,A01,185168,Staff,0,2,25,25
1683699767805,ECE 5,A01,185626,Morris; Karcher William,0,12,0,0
1683699768834,ECE 101,A01,185628,Staff,14,0,70,56
1683699769859,ECE 107,A01,185635,Baghdadchi; Saharnaz,0,0,20,20
1683699769859,ECE 107,A02,185638,Baghdadchi; Saharnaz,1,0,20,19
1683699770882,ECE 148,A01,185647,Silberman; Jack,0,0,16,16
1683699771907,ECON 1,A01,185537,Crane; Meredith Helen,54,0,70,16
1683699772935,ECON 3,A01,185549,Crane; Meredith Helen,30,0,70,40
1683699773963,ECON 4,A01,203354,Anderson; John Charles,0,5,10,10
1683699774987,ECON 100A,A01,185574,Staff,0,5,40,40
1683699776011,ECON 100B,A01,185576,Staff,0,12,50,50
1683699777037,ECON 100C,A01,185589,Newhouse; Herbert S,30,0,70,40
1683699778060,ECON 105,A00,185608,Vespa; Emanuel Ignacio,19,0,35,16
1683699779088,ECON 109,A01,185610,Shishkin; Denis,9,0,35,26
1683699780117,ECON 110A,A01,185612,Staff,8,0,40,32
1683699781145,ECON 120A,A01,185615,Staff,19,0,40,21
1683699782173,ECON 120C,A01,185617,Sun; Yixiao,0,21,70,70
1683699783201,ECON 144,A00,203346,Squires; Dale E,2,0,35,33
1683699784229,ECON 171,A01,203349,Newhouse; Herbert S,0,1,35,35
1683699785253,ECON 173A,A01,185621,Toda; Alexis Akira,21,0,35,14
1683699786284,EDS 25,A01,202413,Staff,0,1,0,0
1683699786284,EDS 25,A02,202414,Staff,0,1,0,0
1683699786284,EDS 25,A03,202415,Staff,0,0,0,0
1683699786284,EDS 25,A04,202416,Staff,0,1,0,0
1683699786284,EDS 25,A05,202439,Staff,0,0,0,0
1683699786284,EDS 25,A06,202440,Staff,0,0,0,0
1683699786284,EDS 25,B01,202631,Staff,0,0,0,0
1683699786284,EDS 25,B02,202632,Staff,0,0,0,0
1683699786284,EDS 25,B03,202639,Staff,0,0,0,0
1683699786284,EDS 25,B04,202640,Staff,0,0,0,0
1683699786284,EDS 25,B05,202643,Staff,0,0,0,0
1683699786284,EDS 25,B06,202644,Staff,0,0,0,0
1683699787310,EDS 38,A01,202659,Black; Alison Michelle,24,0,25,1
1683699788335,EDS 115,A00,202652,Staff,18,0,30,12
1683699789362,EDS 125,A00,202649,Staff,13,0,30,17
1683699790386,EDS 126,A01,203332,Staff,30,0,30,0
1683699791411,EDS 139,A00,202838,Staff,16,0,25,9
1683699792434,EDS 146,A01,202655,Staff,14,0,25,11
1683699793459,ENG 15,A00,185667,Staff,0,1,0,0
1683699793459,ENG 15,B00,185672,Staff,0,0,0,0
1683699793459,ENG 15,C00,185675,Staff,0,0,0,0
1683699793459,ENG 15,D00,185682,Staff,0,0,0,0
1683699793459,ENG 15,E00,185684,Staff,0,0,0,0
1683699794484,ETHN 103,A00,185710,Staff,0,8,35,35
1683699795509,ETHN 103A,A00,199228,Man; Simeon S,0,0,9,9
1683699796534,ETHN 109,A00,185711,Staff,15,0,35,20
1683699797562,ETHN 142,A00,185726,Staff,0,4,30,30
1683699798586,ETHN 163J,A00,199229,Man; Simeon S,5,0,8,3
1683699799613,ETHN 168,A00,185727,Staff,7,0,10,3
1683699800638,ETHN 182,A00,185728,Staff,0,0,35,35
1683699801662,ETHN 183,A00,185737,Staff,9,0,18,9
1683699802686,GLBH 111,A01,209361,Burgos; Jose L.,0,0,0,0
1683699804738,HIEU 104,A00,185792,Staff,14,0,20,6
1683699805761,HIEU 115,A00,185800,Staff,0,0,20,20
1683699806785,HIEU 128,A00,185801,Staff,0,9,20,20
1683699807814,HIEU 147,A00,185802,Staff,15,0,20,5
1683699808841,HIEU 154,A00,185823,Staff,11,0,20,9
1683699809868,HILA 102,A00,185826,Staff,14,0,20,6
1683699810892,HILD 2C,A01,185778,Staff,0,13,20,20
1683699811921,HILD 7B,A01,185780,Kwak; Nancy,0,17,32,32
1683699811921,HILD 7B,A02,185781,Kwak; Nancy,0,18,32,32
1683699812945,HILD 30,A01,185791,Staff,12,0,20,8
1683699813970,HISC 119,A00,185830,Golan; Tal,0,10,20,20
1683699814995,HITO 156GS,A00,185831,Patterson; Patrick H.,0,0,0,23
1683699816023,HIUS 103,A00,185832,Man; Simeon S,0,4,20,20
1683699817050,HIUS 117,A00,185836,Kwak; Nancy,2,0,20,18
1683699818075,HIUS 125,A00,185840,Man; Simeon S,0,2,23,23
1683699819101,HIUS 149,A00,185845,Staff,1,0,20,19
1683699820126,HUM 3,A01,185882,Zavodny; Tatiana Sophia,0,8,50,50
1683699820126,HUM 3,B01,185899,Caldwell; Michael Alan,0,18,50,50
1683699821151,HUM 3GS,A00,185900,Patterson; Patrick H.,0,0,0,23
1683699822179,HUM 4,A01,185938,Zroka; Amy Liane,28,0,50,22
1683699822179,HUM 4,B01,185956,Watkins; Eric,0,6,50,50
1683699822179,HUM 4,B02,202209,Watkins; Eric,0,5,50,50
1683699822179,HUM 4,B03,202210,Watkins; Eric,0,5,50,50
1683699823206,HUM 5,A01,185958,West; Geoffrey Scott,0,0,50,50
1683699823206,HUM 5,A02,202215,West; Geoffrey Scott,0,1,50,50
1683699824231,INTL 190,A00,185959,Gagnon; Jeffrey C,0,0,0,9
1683699824231,INTL 190,B00,185960,Lettieri; Michael Joseph,0,0,0,2
1683699825258,JAPN 180,A00,254509,Staff,5,0,30,25
1683699826282,LATI 10,A01,202853,Kennemore; Amy Michelle,4,0,35,31
1683699826282,LATI 10,A02,202854,Kennemore; Amy Michelle,3,0,35,32
1683699826282,LATI 10,A03,270054,Kennemore; Amy Michelle,30,0,30,0
1683699827306,LATI 180,A00,202855,Kennemore; Amy Michelle,11,0,20,9
1683699828329,LAWS 101,A00,201767,Golan; Tal,0,7,40,40
1683699829357,LIFR 1C,A00,185961,Staff,6,0,20,14
1683699830382,LIFR 1CX,A00,185962,Staff,7,0,20,13
1683699831406,LIFR 1D,A00,185963,Staff,7,0,20,13
1683699832431,LIFR 1DX,A00,185964,Staff,7,0,20,13
1683699833458,LIGN 101,A01,186039,Staff,43,0,50,7
1683699834482,LIGN 165,A00,186040,Staff,14,0,50,36
1683699835509,LTCS 108,A00,186041,Staff,5,0,10,5
1683699836536,LTCS 119,A00,186042,Staff,15,0,20,5
1683699837561,LTCS 130,A00,186043,Wesling; Megan E.,15,0,25,10
1683699839612,LTEA 138,A00,186119,Staff,14,0,40,26
1683699840635,LTEN 124,A00,186148,Staff,5,0,25,20
1683699841659,LTEN 178,A00,186149,Staff,6,0,15,9
1683699842686,LTEN 181,A00,186150,Blanco; John D,34,0,40,6
1683699843711,LTWL 120,A00,186160,Staff,19,0,25,6
1683699844737,LTWL 165,A00,186161,Staff,22,0,25,3
1683699845818,LTWR 100,A00,186162,Staff,0,5,15,15
1683699846842,LTWR 102,A00,186163,Doller; Ben,5,0,15,10
1683699847866,MAE 8,A01,186412,Staff,0,1,0,0
1683699848894,MAE 30B,A00,186445,Bahadori; Mohammad Yousef,81,0,100,19
1683699849921,MAE 40,A00,186592,Bewley; Thomas R,10,0,50,40
1683699850945,MAE 101B,A00,186593,Bahadori; Mohammad Yousef,80,0,100,20
1683699851970,MAE 105,A00,186594,Bandaru; Prabhakar,10,0,50,40
1683699852995,MAE 107,A00,186599,Pham; Hieu Tan,0,8,120,120
1683699854019,MAE 148,A01,186660,Silberman; Jack,3,0,16,13
1683699855046,MATH 10A,A01,188095,Staff,0,6,35,35
1683699856071,MATH 10B,A01,188097,Bowers; Adam R.,0,12,30,30
1683699856071,MATH 10B,A02,188099,Bowers; Adam R.,0,11,30,30
1683699856071,MATH 10B,B01,188104,Bowers; Adam R.,0,10,30,30
1683699856071,MATH 10B,B02,188106,Bowers; Adam R.,0,9,30,30
1683699857096,MATH 10C,A01,188111,Staff,0,20,30,30
1683699857096,MATH 10C,A02,188127,Staff,0,19,30,30
1683699857096,MATH 10C,A03,188131,Staff,0,19,30,30
1683699857096,MATH 10C,B01,188218,Staff,17,0,30,13
1683699857096,MATH 10C,B02,188244,Staff,13,0,30,17
1683699857096,MATH 10C,B03,188277,Staff,14,0,30,16
1683699858121,MATH 18,A01,188344,Bach; Quang Tran,18,0,30,12
1683699858121,MATH 18,A02,188345,Bach; Quang Tran,11,0,30,19
1683699858121,MATH 18,B01,188353,Bach; Quang Tran,11,0,30,19
1683699858121,MATH 18,B02,188354,Bach; Quang Tran,19,0,30,11
1683699859144,MATH 20A,A01,188374,Staff,11,0,35,24
1683699860169,MATH 20B,A01,188382,Ohm; Ko Woon,7,0,30,23
1683699860169,MATH 20B,A02,188383,Ohm; Ko Woon,22,0,30,8
1683699860169,MATH 20B,B01,188385,Ohm; Ko Woon,7,0,30,23
1683699860169,MATH 20B,B02,188392,Ohm; Ko Woon,22,0,30,8
1683699861192,MATH 20C,A01,188394,Harel; Guershon,10,0,30,20
1683699861192,MATH 20C,A02,188395,Harel; Guershon,13,0,30,17
1683699861192,MATH 20C,B01,188404,Harel; Guershon,5,0,30,25
1683699861192,MATH 20C,B02,188405,Harel; Guershon,18,0,30,12
1683699862221,MATH 20D,A01,188414,Hammock; Frances H,0,1,30,30
1683699862221,MATH 20D,A02,188415,Hammock; Frances H,0,1,30,30
1683699862221,MATH 20D,B01,188447,Hammock; Frances H,0,1,30,30
1683699862221,MATH 20D,B02,188486,Hammock; Frances H,2,0,30,28
1683699863245,MATH 20E,A01,188649,Staff,21,0,30,9
1683699863245,MATH 20E,A02,188650,Staff,20,0,30,10
1683699863245,MATH 20E,A03,188673,Staff,0,0,30,30
1683699864269,MATH 102,A01,188675,Staff,0,40,35,35
1683699865294,MATH 103B,A01,188681,Staff,3,0,35,32
1683699865294,MATH 103B,B01,188692,Staff,5,0,35,30
1683699866321,MATH 109,A01,188695,Salehi Golsefidy; Alireza,24,0,35,11
1683699866321,MATH 109,A02,188696,Salehi Golsefidy; Alireza,25,0,35,10
1683699867347,MATH 120A,A01,188698,Eggers; John Dietrich,7,0,35,28
1683699868374,MATH 142B,A01,188736,Ioana; Adrian,0,0,30,30
1683699868374,MATH 142B,A02,188741,Ioana; Adrian,0,1,30,30
1683699868374,MATH 142B,A03,188743,Ioana; Adrian,0,2,30,30
1683699869398,MATH 168A,A01,188790,Staff,0,11,35,35
1683699870427,MATH 170A,A01,188803,Nie; Jiawang,0,2,35,35
1683699870427,MATH 170A,A02,188811,Nie; Jiawang,0,1,35,35
1683699870427,MATH 170A,A03,188814,Nie; Jiawang,0,0,35,35
1683699870427,MATH 170A,A04,188815,Nie; Jiawang,5,0,35,30
1683699871455,MATH 193B,A01,188817,Staff,0,0,35,35
1683699871455,MATH 193B,A02,188818,Staff,6,0,35,29
1683699872478,MGT 4,A01,202857,Anderson; John Charles,59,0,80,21
1683699873503,MGT 12,A00,202858,Lindenberger; Wade Douglas,40,0,90,50
1683699874529,MGT 18,A00,202859,Staff,74,0,90,16
1683699875555,MGT 18GS,A00,202860,McKay; Michael J,13,0,28,15
1683699876581,MGT 45,A00,202861,Pecore; Joseph P.,8,0,90,82
1683699877608,MGT 100,A00,202863,Yavorsky; Daniel Ryan,27,0,90,63
1683699878631,MGT 103,A00,202864,Ehrich; Kristine R,0,19,90,90
1683699879655,MGT 112,A00,202865,Ehrich; Kristine R,15,0,90,75
1683699880680,MGT 121A,A00,202868,Staff,70,0,90,20
1683699881704,MGT 131B,A00,202869,Anderson; John Charles,58,0,90,32
1683699882729,MGT 136,A00,202871,Lindenberger; Wade Douglas,83,0,90,7
1683699883754,MGT 164,A00,202873,Staff,0,67,90,91
1683699884782,MGT 164GS,A00,202874,McKay; Mary A,13,0,28,15
1683699885807,MGT 180,A00,202875,Staff,0,51,90,91
1683699886833,MMW 11R,A01,205019,Herbst; Matthew,0,0,30,30
1683699886833,MMW 11R,A02,205026,Herbst; Matthew,29,0,30,1
1683699887858,MMW 15,A01,193512,Chang; Edmond Yi-Teh,0,8,28,28
1683699887858,MMW 15,A02,193513,Chang; Edmond Yi-Teh,0,5,28,28
1683699887858,MMW 15,A03,193514,Chang; Edmond Yi-Teh,0,5,28,28
1683699887858,MMW 15,A04,193515,Chang; Edmond Yi-Teh,0,5,28,28
1683699887858,MMW 15,A05,193516,Chang; Edmond Yi-Teh,0,5,28,28
1683699887858,MMW 15,A06,193517,Chang; Edmond Yi-Teh,0,6,28,28
1683699887858,MMW 15,B01,193519,Chang; Edmond Yi-Teh,0,5,28,28
1683699887858,MMW 15,B02,193520,Chang; Edmond Yi-Teh,0,5,28,28
1683699887858,MMW 15,B03,193521,Chang; Edmond Yi-Teh,0,5,28,28
1683699887858,MMW 15,B04,193522,Chang; Edmond Yi-Teh,0,6,28,28
1683699887858,MMW 15,B05,193523,Chang; Edmond Yi-Teh,0,5,28,28
1683699887858,MMW 15,B06,193524,Chang; Edmond Yi-Teh,0,5,28,28
1683699888883,MMW 122,A01,193526,Rahimi; Babak,0,16,28,28
1683699888883,MMW 122,A02,193527,Rahimi; Babak,0,15,28,28
1683699888883,MMW 122,A03,193528,Rahimi; Babak,0,0,0,0
1683699888883,MMW 122,A04,193529,Rahimi; Babak,0,0,0,0
1683699889908,MUS 1A,A01,186663,Staff,0,18,35,35
1683699890933,MUS 4,A01,186715,Staff,0,12,35,35
1683699891960,MUS 5R,A01,186796,Dubnov; Shlomo,0,17,35,35
1683699892984,MUS 6,A01,186798,Staff,0,4,25,25
1683699894007,MUS 7,A01,186830,Staff,11,0,35,24
1683699895032,MUS 8,A01,186930,Staff,0,27,35,35
1683699896056,MUS 15,A01,186932,Staff,0,15,35,35
1683699896056,MUS 15,B01,186934,Staff,0,16,35,35
1683699897081,MUS 80,A00,186935,Staff,0,0,20,20
1683699897081,MUS 80,B00,186936,Staff,24,0,25,1
1683699898108,NANO 11,A00,204702,Lipomi; Darren John,0,0,0,0
1683699899133,NANO 15,A01,204709,Yang; Kesong,0,1,0,0
1683699900157,NANO 114,A00,202069,Jahed Motlagh; Zeinab,2,0,10,8
1683699901184,PHIL 1,A00,186955,Grush; Rick Scott,31,0,40,9
1683699902208,PHIL 10,A01,186973,Grush; Rick Scott,27,0,35,8
1683699902208,PHIL 10,A02,186974,Grush; Rick Scott,33,0,35,2
1683699903234,PHIL 13,A01,186976,Staff,1,0,35,34
1683699903234,PHIL 13,A02,186977,Staff,16,0,35,19
1683699904259,PHIL 14,A01,186979,Staff,31,0,35,4
1683699904259,PHIL 14,A02,186986,Staff,32,0,35,3
1683699905289,PHIL 28,A01,186988,Staff,16,0,30,14
1683699905289,PHIL 28,A02,186989,Staff,1,0,30,29
1683699905289,PHIL 28,A03,186990,Staff,10,0,30,20
1683699905289,PHIL 28,A04,186991,Staff,26,0,30,4
1683699906336,PHIL 120,A00,186997,Staff,23,0,40,17
1683699907362,PHIL 137,A00,187003,Staff,7,0,40,33
1683699908388,PHIL 150,A00,187015,Staff,47,0,70,23
1683699909415,PHIL 167,A00,187021,Lamey; Andy M.,34,0,40,6
1683699910442,PHIL 174,A01,202226,Staff,17,0,20,3
1683699910442,PHIL 174,A02,202235,Staff,20,0,20,0
1683699911467,PHIL 191A,A00,258918,Staff,0,0,1,1
1683699912491,PHYS 1A,A00,187028,Staff,26,0,60,34
1683699913516,PHYS 1AL,001,187036,Staff,3,0,30,27
1683699913516,PHYS 1AL,002,187049,Staff,18,0,30,12
1683699914543,PHYS 1B,A00,187058,Staff,21,0,60,39
1683699915570,PHYS 1BL,001,187064,Staff,0,1,30,30
1683699915570,PHYS 1BL,002,187070,Staff,4,0,30,26
1683699916594,PHYS 1C,A00,187082,Staff,30,0,120,90
1683699917619,PHYS 1CL,001,187088,Staff,0,9,30,30
1683699917619,PHYS 1CL,002,187089,Staff,0,1,30,30
1683699917619,PHYS 1CL,009,262693,Staff,9,0,30,21
1683699918649,PHYS 2B,A01,187097,Staff,55,0,115,60
1683699919676,PHYS 2C,A01,187099,Staff,63,0,115,52
1683699920704,PHYS 2CL,A01,187101,Staff,5,0,28,23
1683699920704,PHYS 2CL,A02,187102,Staff,15,0,28,13
1683699921732,PHYS 2D,A01,187123,Shotwell; Brian,95,0,115,20
1683699922759,PHYS 4B,A01,187133,Grinstein; Benjamin,35,0,50,15
1683699923786,POLI 10,A00,188819,Staff,0,4,50,50
1683699924810,POLI 11,A00,188827,Staff,43,0,50,7
1683699925833,POLI 13R,A00,188828,Staff,0,1,20,20
1683699926857,POLI 27,A01,188830,Elgin; Samuel Zincke,0,2,70,70
1683699927884,POLI 30,A00,188832,Desposato; Scott,30,0,50,20
1683699928911,POLI 102F,A00,188834,Staff,1,0,40,39
1683699929937,POLI 104A,A00,188852,Staff,12,0,30,18
1683699930961,POLI 104I,A00,188853,Staff,0,8,20,20
1683699931986,POLI 110B,A00,188854,Wiens; David,6,0,20,14
1683699933010,POLI 112A,A00,188855,Wiens; David,3,0,30,27
1683699934034,POLI 117R,A00,188856,Forman; Fonna,0,12,20,20
1683699935061,POLI 118,A00,188857,Ingham; Sean,8,0,20,12
1683699936088,POLI 120G,A00,188858,Staff,8,0,30,22
1683699937112,POLI 131CR,A00,188863,Hoston; Germaine,20,0,50,30
1683699938136,POLI 133,A00,188864,Nellis; Gareth Hb,44,0,50,6
1683699939160,POLI 134D,A00,188865,Desposato; Scott,27,0,30,3
1683699940187,POLI 142A,A00,188871,Gartzke; Erik,21,0,50,29
1683699941213,POLI 142K,A00,188874,Staff,38,0,50,12
1683699942239,POLI 143,A00,188940,Gartzke; Erik,16,0,30,14
1683699943268,POLI 153,A00,188943,Staff,2,0,20,18
1683699944292,POLI 160AA,A00,188944,Staff,10,0,40,30
1683699945320,POLI 170A,A00,188945,Staff,10,0,30,20
1683699947371,PSYC 1,A00,188952,Staff,36,0,90,54
1683699948398,PSYC 2,B00,188953,Staff,19,0,35,16
1683699949499,PSYC 6,A00,188970,Staff,47,0,60,13
1683699950526,PSYC 7,A00,188973,Staff,35,0,45,10
1683699951553,PSYC 60,A01,188980,Rickard; Timothy C.,42,0,60,18
1683699952578,PSYC 70,A01,189001,Steiner; Eric Tomas,21,0,45,24
1683699953606,PSYC 100,A00,189005,Lacefield; Katharine I,0,98,120,120
1683699954633,PSYC 102,A00,189008,Staff,6,0,30,24
1683699955660,PSYC 106,B00,189026,Gorman; Michael R.,27,0,60,33
1683699956685,PSYC 114,B01,189033,Winkielman; Piotr,0,31,30,30
1683699957713,PSYC 131,A00,189036,Anagnostaras; Stephan,0,44,60,60
1683699958737,PSYC 136,A00,189041,Lowe; Angela Beth,0,7,25,25
1683699959762,PSYC 137,A00,189057,Winkielman; Piotr,0,36,25,25
1683699960787,PSYC 144,A00,189107,Wixted; John T,0,11,50,50
1683699962839,PSYC 162,A00,189142,Staff,0,9,85,85
1683699963863,PSYC 172,A00,189144,Gorman; Michael R.,0,6,30,30
1683699965922,PSYC 179,A00,189146,Lacefield; Katharine I,0,88,120,120
1683699966951,PSYC 181,A00,189147,Anagnostaras; Stephan,0,45,90,90
1683699967977,PSYC 190R,A00,189148,Barner; David A.,0,23,80,80
1683699969002,PSYC 191,A00,189275,Rickard; Timothy C.,0,11,25,25
1683699970029,PSYC 193,A00,189276,Chapman; Eddie Nathaniel,0,1,0,4
1683699971054,PSYC 193L,A01,189281,Lowe; Angela Beth,8,0,20,12
1683699971054,PSYC 193L,B01,189285,Staff,28,0,35,7
1683699972081,RELI 149,A00,187137,Rahimi; Babak,6,0,40,34
1683699973104,SE 9,A01,187315,Staff,0,2,18,18
1683699974132,SE 101B,A00,187409,Staff,24,0,30,6
1683699975156,SE 110B,A00,187444,Staff,10,0,40,30
1683699976180,SE 130B,A00,187449,Staff,31,0,40,9
1683699977208,SE 150A,A00,187516,Staff,8,0,20,12
1683699978236,SE 154,A00,187528,Staff,29,0,50,21
1683699979264,SIO 3,A01,258171,Staff,35,0,40,5
1683699980292,SIO 10,A00,187144,Cook; Geoffrey W,0,6,75,75
1683699981319,SIO 45,A00,187152,Cook; Geoffrey W,0,7,100,100
1683699982347,SIO 109R,A00,194486,Staff,0,4,20,20
1683699984401,SIO 187,A01,187233,Kacev; David,12,0,40,28
1683699985427,SOCI 1,A01,258656,Thorpe; Charles Robert,28,0,30,2
1683699985427,SOCI 1,A02,258658,Thorpe; Charles Robert,30,0,30,0
1683699985427,SOCI 1,A03,258661,Thorpe; Charles Robert,25,0,25,0
1683699985427,SOCI 1,A04,258666,Thorpe; Charles Robert,22,0,25,3
1683699985427,SOCI 1,A05,258897,Thorpe; Charles Robert,22,0,25,3
1683699985427,SOCI 1,A06,258898,Thorpe; Charles Robert,25,0,25,0
1683699986455,SOCI 30,A01,258903,Pardo Guerra; Juan Pablo,14,0,30,16
1683699987486,SOCI 102,A00,258904,Staff,9,0,25,16
1683699988511,SOCI 106,A00,258905,Staff,19,0,25,6
1683699989539,SOCI 111,A00,258907,Ribas Norris; Janet Vanesa,26,0,30,4
1683699990563,SOCI 121R,A00,258908,Pardo Guerra; Juan Pablo,7,0,30,23
1683699991590,SOCI 126,A01,203330,Staff,14,0,20,6
1683699992617,SOCI 131,A00,258909,Thorpe; Charles Robert,30,0,60,30
1683699993645,SOCI 135,A00,258910,Payne; Christine Anna,0,13,30,30
1683699994673,SOCI 157,A00,258911,Staff,10,0,30,20
1683699995699,SOCI 184,A00,258912,Staff,25,0,30,5
1683699996723,SOCI 188D,A00,258913,Staff,22,0,30,8
1683699997750,SYN 2,001,187529,Staff,9,0,16,7
1683699997750,SYN 2,002,201452,Staff,0,20,16,16
1683699997750,SYN 2,003,201469,Staff,1,0,16,15
1683699998775,SYN 100,A01,187531,Staff,0,9,20,20
1683699998775,SYN 100,B01,201491,Staff,0,10,20,20
1683699999799,TDAC 1,A00,189286,Walsh; Kim C.,3,0,20,17
1683699999799,TDAC 1,B00,189287,Harting; Carla Kelso,10,0,20,10
1683700000825,TDAC 101,A00,189300,Walsh; Kim C.,16,0,20,4
1683700000825,TDAC 101,B00,189301,Harting; Carla Kelso,18,0,20,2
1683700001851,TDAC 102,A00,189304,Basso; Beatrice,14,0,20,6
1683700002877,TDAC 108,A00,189305,Staff,18,0,20,2
1683700003901,TDDE 131,A00,189310,Staff,19,0,20,1
1683700003901,TDDE 131,B00,189314,Staff,19,0,20,1
1683700003901,TDDE 131,C00,189315,Staff,48,0,50,2
1683700003901,TDDE 131,D00,189316,Staff,14,0,15,1
1683700003901,TDDE 131,E00,204841,Staff,20,0,20,0
1683700004926,TDGE 10,A00,189289,Staff,27,0,50,23
1683700004926,TDGE 10,B00,189290,Havis; Allan,0,1,50,50
1683700005953,TDGE 11,A00,189291,Fulton; Julia,0,4,50,50
1683700005953,TDGE 11,B00,189292,Staff,20,0,25,5
1683700005953,TDGE 11,C00,260270,Staff,0,0,0,0
1683700006979,TDGE 25,A00,189294,Staff,1,0,20,19
1683700008003,TDGE 124,A00,189318,Fulton; Julia,0,7,50,50
1683700009028,TDGE 125,A00,189319,Staff,13,0,25,12
1683700009028,TDGE 125,B00,189320,Staff,23,0,25,2
1683700010054,TDGE 127,A00,189322,Havis; Allan,1,0,50,49
1683700011078,TDHT 101,A00,189323,Staff,18,0,25,7
1683700011078,TDHT 101,B00,189324,Staff,25,0,25,0
1683700012108,TDHT 102,A00,189325,Staff,49,0,50,1
1683700013135,TDMV 1,A00,189295,Arcidiacono; Kristin,20,0,30,10
1683700013135,TDMV 1,B00,189296,Caligagan; Maria T.,24,0,30,6
1683700014159,TDMV 2,A00,189297,Sammartano; Tonnie,27,0,30,3
1683700014159,TDMV 2,B00,189299,Arcidiacono; Kristin,23,0,30,7
1683700015189,TDMV 3,A00,204998,Rincon; Alicia,22,0,30,8
1683700016216,TDMV 120,A00,189458,Sammartano; Tonnie,28,0,30,2
1683700017241,TDMV 138,A00,189541,Jun; Grace Shin Hae,20,0,40,20
1683700018264,TDMV 142,A00,189717,Caligagan; Tony,25,0,30,5
1683700018264,TDMV 142,B00,189718,Caligagan; Maria T.,25,0,30,5
1683700019289,TMC 2,A01,187533,Staff,25,0,25,0
1683700019289,TMC 2,A02,187534,Staff,25,0,25,0
1683700020311,USP 1,A01,187536,Kwak; Nancy,0,16,25,25
1683700021336,USP 5,A01,187538,Staff,8,0,25,17
1683700022360,USP 101,A00,199253,Staff,0,4,0,0
1683700023385,USP 124,A00,187562,Boomhower; Matthew Charles,0,0,30,30
1683700024412,USP 138,A00,187582,Staff,19,0,25,6
1683700025438,USP 152,A01,187597,Staff,3,0,25,22
1683700026468,USP 153,A00,187598,Staff,18,0,25,7
1683700027495,USP 168,A00,187607,Kwak; Nancy,2,0,5,3
1683700028520,USP 173,A00,187619,Staff,4,0,25,21
1683700029547,USP 181,A00,187638,Staff,0,4,25,25
1683700030572,VIS 103,A00,187650,Cruz; Edwin Teddy,17,0,75,58
1683700031598,VIS 110D,A00,187669,Staff,13,0,22,9
1683700032622,VIS 127C,A00,187720,Shen; Kuiyi,67,0,146,79
1683700033652,VIS 149,A00,187731,Yoldas; Pinar,0,12,22,22
1683700034678,VIS 151,A01,188091,Staff,22,0,34,12
1683700034678,VIS 151,A02,188092,Staff,11,0,34,23
1683700035707,VIS 160B,A00,188093,Stalbaum; Brett,0,1,10,10
1683700037761,WCWP 10B,A00,201720,Staff,0,0,5,5
1683700037761,WCWP 10B,B00,201722,Staff,0,0,6,6
1683700038786,WCWP 100,A00,201725,Gagnon; Jeffrey C,0,0,2,2
1683700038786,WCWP 100,B00,201727,Staff,0,4,15,15
1683700041906,ANBI 133,A00,258401,Wilder; Linnea Lorene,34,0,40,6
1683700042931,ANBI 140,A00,258395,Hrvoj Mihic; Branka,18,0,25,7
1683700043962,ANSC 120,A00,258402,Bialecki; Jon Anthony,26,0,40,14
1683700044989,ANSC 144,A00,258400,Staff,12,0,40,28
1683700047036,ANSC 166,A00,258396,Parish; Steven Martin,156,0,175,19
1683700048062,ANSC 180,A00,193533,Staff,8,0,20,12
1683700049090,ANSC 188,A00,258397,Jassal; Aftab,34,0,40,6
1683700050118,ANTH 3,A01,258316,Staff,23,0,30,7
1683700051142,ANTH 5,A00,258394,Semendeferi; Ekaterini,16,0,20,4
1683700052170,ANTH 21,A01,258331,Staff,4,0,40,36
1683700053248,ANTH 103,A00,258398,Varma; Saiba,15,0,25,10
1683700054291,AWP 10,001,202034,Staff,0,0,0,0
1683700054291,AWP 10,002,202035,Staff,0,0,0,0
1683700054291,AWP 10,003,202036,Staff,0,0,0,0
1683700054291,AWP 10,004,202037,Staff,0,0,0,0
1683700054291,AWP 10,005,202038,Staff,0,0,0,0
1683700054291,AWP 10,006,202039,Staff,0,0,0,0
1683700054291,AWP 10,007,202040,Staff,0,0,0,0
1683700054291,AWP 10,008,202041,Staff,0,0,0,0
1683700054291,AWP 10,009,202042,Staff,0,0,0,0
1683700054291,AWP 10,010,202043,Staff,0,0,0,0
1683700054291,AWP 10,011,202044,Staff,0,0,0,0
1683700054291,AWP 10,012,202045,Staff,0,0,0,0
1683700054291,AWP 10,013,202046,Staff,0,0,0,0
1683700054291,AWP 10,014,202047,Staff,0,0,0,0
1683700054291,AWP 10,015,202048,Staff,0,0,0,0
1683700054291,AWP 10,016,202049,Staff,0,0,0,0
1683700054291,AWP 10,017,202050,Staff,0,0,0,0
1683700054291,AWP 10,018,202051,Staff,0,0,0,0
1683700054291,AWP 10,019,202052,Staff,0,0,0,0
1683700054291,AWP 10,020,202053,Staff,0,0,0,0
1683700054291,AWP 10,021,202054,Staff,0,0,0,0
1683700054291,AWP 10,022,202055,Staff,0,0,0,0
1683700054291,AWP 10,023,202056,Staff,0,0,0,0
1683700054291,AWP 10,024,202057,Staff,0,0,0,0
1683700054291,AWP 10,025,202058,Staff,0,0,0,0
1683700054291,AWP 10,026,202059,Staff,0,0,0,0
1683700055317,AWP 102,001,202032,Staff,0,0,0,0
1683700055317,AWP 102,002,202033,Staff,0,0,0,0
1683700056341,BENG 100,A01,254234,Taylor Amos; Alyssa C,31,0,40,9
1683700057364,BENG 196,001,270013,Engler; Adam J.,9999,0,9999,0
1683700058393,BICD 100R,A01,202018,Smith; Laurie,0,7,32,32
1683700058393,BICD 100R,A02,202019,Smith; Laurie,0,3,32,32
1683700058393,BICD 100R,A03,202020,Smith; Laurie,0,1,32,32
1683700058393,BICD 100R,A04,202021,Smith; Laurie,6,0,32,26
1683700058393,BICD 100R,A05,202022,Smith; Laurie,10,0,32,22
1683700059418,BICD 136,A01,193242,Gustafson-Brown; Cindy,0,2,32,32
1683700059418,BICD 136,A02,193244,Gustafson-Brown; Cindy,13,0,32,19
1683700060444,BIEB 102,A01,193249,Butler; Shannon Rhey,0,0,32,32
1683700060444,BIEB 102,A02,193251,Butler; Shannon Rhey,0,0,32,32
1683700060444,BIEB 102,A03,193253,Butler; Shannon Rhey,0,0,32,32
1683700060444,BIEB 102,A04,193255,Butler; Shannon Rhey,13,0,32,19
1683700060444,BIEB 102,A05,193265,Butler; Shannon Rhey,25,0,32,7
1683700060444,BIEB 102,A06,193269,Butler; Shannon Rhey,12,0,32,20
1683700062495,BIEB 150,A01,193274,Staff,0,0,32,32
1683700062495,BIEB 150,A02,193285,Staff,24,0,32,8
1683700063520,BIEB 194,A00,193286,Kurle; Carolyn M.,19,0,32,13
1683700064549,BILD 1,A01,192291,Staff,15,0,32,17
1683700064549,BILD 1,A02,192292,Staff,30,0,32,2
1683700064549,BILD 1,B01,192520,Reuther; Keefe,0,1,0,0
1683700064549,BILD 1,B02,192532,Reuther; Keefe,0,1,0,0
1683700065576,BILD 3,A01,192556,Butler; Shannon Rhey,0,0,32,32
1683700065576,BILD 3,A02,192581,Butler; Shannon Rhey,0,1,32,32
1683700065576,BILD 3,A03,192611,Butler; Shannon Rhey,19,0,32,13
1683700065576,BILD 3,A04,192612,Butler; Shannon Rhey,23,0,32,9
1683700065576,BILD 3,A05,192613,Butler; Shannon Rhey,26,0,32,6
1683700065576,BILD 3,A06,192679,Butler; Shannon Rhey,27,0,32,5
1683700065576,BILD 3,A07,192682,Butler; Shannon Rhey,20,0,32,12
1683700066602,BILD 4,A01,192836,Reuther; Keefe,1,0,24,23
1683700066602,BILD 4,A02,193044,Reuther; Keefe,4,0,24,20
1683700067631,BILD 10,A01,193142,Gustafson-Brown; Cindy,29,0,32,3
1683700067631,BILD 10,A02,193149,Gustafson-Brown; Cindy,31,0,32,1
1683700068659,BIMM 100,A01,193301,Staff,0,6,32,32
1683700068659,BIMM 100,A02,193312,Staff,0,7,32,32
1683700068659,BIMM 100,A03,193323,Staff,0,10,32,32
1683700069689,BIMM 101,A01,193329,McDonnell; Lisa Marie,0,3,24,24
1683700069689,BIMM 101,A02,193339,McDonnell; Lisa Marie,0,3,24,24
1683700069689,BIMM 101,B01,193354,McDonnell; Lisa Marie,0,4,24,24
1683700069689,BIMM 101,B02,193357,McDonnell; Lisa Marie,0,3,24,24
1683700070717,BIMM 110,A01,193377,Tat; John,0,11,32,32
1683700070717,BIMM 110,A02,193378,Tat; John,0,11,32,32
1683700071742,BIMM 120,A01,206116,Staff,0,0,32,32
1683700071742,BIMM 120,A02,206117,Staff,7,0,32,25
1683700071742,BIMM 120,A03,206121,Staff,21,0,32,11
1683700072771,BIPN 100,A01,193393,Park; Ji Young,0,15,32,32
1683700072771,BIPN 100,A02,193402,Park; Ji Young,0,14,32,32
1683700072771,BIPN 100,A03,193413,Park; Ji Young,0,14,32,32
1683700072771,BIPN 100,A04,193414,Park; Ji Young,0,13,32,32
1683700073795,BIPN 102,A01,193429,Staff,0,0,32,32
1683700073795,BIPN 102,A02,193438,Staff,18,0,32,14
1683700074819,BIPN 106,A01,193450,Reyes Gonzalez; Catalina,0,2,40,40
1683700075845,BIPN 134,A01,193465,Cooke; James Edward,0,0,32,32
1683700075845,BIPN 134,A02,193474,Cooke; James Edward,25,0,32,7
1683700075845,BIPN 134,A03,193485,Cooke; James Edward,29,0,32,3
1683700075845,BIPN 134,A04,193486,Cooke; James Edward,20,0,32,12
1683700075845,BIPN 134,A05,193491,Cooke; James Edward,31,0,32,1
1683700075845,BIPN 134,A06,193501,Cooke; James Edward,30,0,32,2
1683700075845,BIPN 134,A07,193510,Cooke; James Edward,29,0,32,3
1683700077900,BISP 194,A00,222522,Staff,14,0,32,18
1683700078927,CAT 124,A01,202407,Staff,19,0,25,6
1683700079951,CAT 125,A00,202408,Marchisotto; Jennifer Anne,2,0,20,18
1683700080982,CAT 125R,A00,202409,Smith; Lauryn Alissa,0,11,20,20
1683700080982,CAT 125R,B00,202410,Morales; Celeste Georgianna,0,11,20,20
1683700080982,CAT 125R,C00,202411,Irwin; Matthew Joseph,0,12,20,20
1683700082012,CENG 15,A01,204712,Yang; Kesong,0,1,0,0
1683700083039,CENG 114,A00,202070,Jahed Motlagh; Zeinab,5,0,20,15
1683700084065,CGS 105,A00,185477,Wesling; Megan E.,24,0,40,16
1683700085093,CGS 106,A00,185494,Staff,11,0,22,11
1683700086117,CGS 108,A00,185495,Staff,14,0,20,6
1683700087142,CGS 114,A00,185496,Staff,13,0,18,5
1683700088165,CGS 119,A00,185501,Staff,15,0,20,5
1683700089189,CGS 120,A00,185511,Staff,12,0,20,8
1683700090214,CHEM 4,A01,184675,Bussey; Thomas J,97,0,100,3
1683700091240,CHEM 6A,A01,184677,Staff,32,0,60,28
1683700092265,CHEM 6B,A01,184679,Staff,63,0,100,37
1683700093290,CHEM 6C,A01,184681,Bussey; Thomas J,0,0,50,50
1683700093290,CHEM 6C,A02,184682,Bussey; Thomas J,32,0,50,18
1683700094316,CHEM 40A,A01,184684,Albizati; Kim F.,33,0,100,67
1683700095341,CHEM 40B,A01,184686,Albizati; Kim F.,0,22,100,100
1683700096366,CHEM 41B,A01,184690,Staff,51,0,100,49
1683700097391,COGS 3,A01,184715,Boyle; Mary E. T.,0,27,40,40
1683700098416,COGS 14B,A01,185172,Staff,0,14,38,38
1683700099440,COGS 18,A01,184736,Staff,14,0,80,66
1683700100463,COGS 100,A01,184932,Staff,0,8,73,73
1683700101489,COGS 101A,A01,184935,Staff,0,40,30,30
1683700102514,COGS 101B,A01,184944,Staff,0,2,30,30
1683700103540,COGS 101C,A01,184946,Staff,0,10,30,30
1683700104569,COGS 102A,A01,184951,Johnson; Christine M.,1,0,40,39
1683700105594,COGS 107B,A01,184953,Mooshagian; Eric Frederick,0,52,40,40
1683700106623,COGS 118B,A01,184959,Gupta; Anjum,0,50,40,40
1683700107646,COGS 153,A00,184961,Staff,1,16,30,29
1683700108672,COGS 177,A00,184962,Staff,0,20,30,30
1683700109699,COGS 187A,A01,184969,Boyle; Mary E. T.,0,19,40,40
1683700110725,COMM 10,A01,185174,Staff,0,5,25,25
1683700110725,COMM 10,A02,185189,Staff,0,2,25,25
1683700110725,COMM 10,A03,269821,Staff,0,1,0,0
1683700111753,COMM 100B,A02,185476,Staff,10,0,25,15
1683700111753,COMM 100B,A03,277340,Staff,25,0,25,0
1683700112780,COMM 100C,A01,185314,Staff,2,0,25,23
1683700112780,COMM 100C,A02,185327,Staff,17,0,25,8
1683700113806,COMM 110M,A00,185349,Staff,0,0,40,40
1683700114830,COMM 113T,A00,185352,Staff,25,0,40,15
1683700115885,COMM 114I,A00,185353,Staff,31,0,40,9
1683700116913,COMM 131,A00,185354,Staff,17,0,30,13
1683700117936,CSE 8A,A50,185358,Cao; Yingjun,0,46,10,10
1683700118962,CSE 8B,A01,185362,Staff,0,48,50,50
1683700119987,CSE 11,A01,185416,Cao; Yingjun,0,91,10,10
1683700121010,CSE 20,A01,185445,Briones; Jor-el Thomas Caparas,3,0,25,22
1683700122035,CSE 21,A01,185447,Staff,9,0,50,41
1683700123061,CSE 101,A01,185451,Staff,0,13,50,50
1683700123061,CSE 101,B01,185453,Jones; Miles E,0,14,50,50
1683700125114,CSE 141,A01,185458,Eldon; John,16,0,100,84
1683700126140,CSE 141L,A01,185461,Eldon; John,8,0,100,92
1683700127169,CSE 142,A01,185463,Staff,34,0,60,26
1683700127169,CSE 142,B01,201355,Staff,0,7,60,60
1683700128198,CSE 142L,A01,185470,Staff,34,0,60,26
1683700128198,CSE 142L,B01,201417,Staff,0,6,60,60
1683700129225,CSE 190,A00,201433,Staff,32,0,49,17
1683700130254,DOC 1,A01,259136,Strom; Megan C.,7,0,15,8
1683700130254,DOC 1,A02,259137,Strom; Megan C.,14,0,15,1
1683700130254,DOC 1,A03,259138,Strom; Megan C.,14,0,15,1
1683700130254,DOC 1,A04,259139,Strom; Megan C.,14,0,15,1
1683700131278,DOC 100D,A00,259140,Pass; Natalye Joann,14,0,25,11
1683700132303,DSGN 1,A01,184749,Rill; Bryan,0,26,30,30
1683700133328,DSGN 100,A01,185168,Staff,0,2,25,25
1683700134356,ECE 5,A01,185626,Morris; Karcher William,0,12,0,0
1683700135382,ECE 101,A01,185628,Staff,14,0,70,56
1683700136408,ECE 107,A01,185635,Baghdadchi; Saharnaz,0,0,20,20
1683700136408,ECE 107,A02,185638,Baghdadchi; Saharnaz,1,0,20,19
1683700137432,ECE 148,A01,185647,Silberman; Jack,0,0,16,16
1683700138457,ECON 1,A01,185537,Crane; Meredith Helen,54,0,70,16
1683700139482,ECON 3,A01,185549,Crane; Meredith Helen,30,0,70,40
1683700140509,ECON 4,A01,203354,Anderson; John Charles,0,5,10,10
1683700141537,ECON 100A,A01,185574,Staff,0,5,40,40
1683700142561,ECON 100B,A01,185576,Staff,0,12,50,50
1683700143585,ECON 100C,A01,185589,Newhouse; Herbert S,30,0,70,40
1683700144615,ECON 105,A00,185608,Vespa; Emanuel Ignacio,19,0,35,16
1683700145640,ECON 109,A01,185610,Shishkin; Denis,9,0,35,26
1683700146664,ECON 110A,A01,185612,Staff,8,0,40,32
1683700147688,ECON 120A,A01,185615,Staff,19,0,40,21
1683700148715,ECON 120C,A01,185617,Sun; Yixiao,0,21,70,70
1683700149739,ECON 144,A00,203346,Squires; Dale E,2,0,35,33
1683700150763,ECON 171,A01,203349,Newhouse; Herbert S,0,1,35,35
1683700151786,ECON 173A,A01,185621,Toda; Alexis Akira,21,0,35,14
1683700152813,EDS 25,A01,202413,Staff,0,1,0,0
1683700152813,EDS 25,A02,202414,Staff,0,1,0,0
1683700152813,EDS 25,A03,202415,Staff,0,0,0,0
1683700152813,EDS 25,A04,202416,Staff,0,1,0,0
1683700152813,EDS 25,A05,202439,Staff,0,0,0,0
1683700152813,EDS 25,A06,202440,Staff,0,0,0,0
1683700152813,EDS 25,B01,202631,Staff,0,0,0,0
1683700152813,EDS 25,B02,202632,Staff,0,0,0,0
1683700152813,EDS 25,B03,202639,Staff,0,0,0,0
1683700152813,EDS 25,B04,202640,Staff,0,0,0,0
1683700152813,EDS 25,B05,202643,Staff,0,0,0,0
1683700152813,EDS 25,B06,202644,Staff,0,0,0,0
1683700153836,EDS 38,A01,202659,Black; Alison Michelle,24,0,25,1
1683700154859,EDS 115,A00,202652,Staff,18,0,30,12
1683700155886,EDS 125,A00,202649,Staff,13,0,30,17
1683700156968,EDS 126,A01,203332,Staff,30,0,30,0
1683700157994,EDS 139,A00,202838,Staff,16,0,25,9
1683700159021,EDS 146,A01,202655,Staff,14,0,25,11
1683700160045,ENG 15,A00,185667,Staff,0,1,0,0
1683700160045,ENG 15,B00,185672,Staff,0,0,0,0
1683700160045,ENG 15,C00,185675,Staff,0,0,0,0
1683700160045,ENG 15,D00,185682,Staff,0,0,0,0
1683700160045,ENG 15,E00,185684,Staff,0,0,0,0
1683700161070,ETHN 103,A00,185710,Staff,0,8,35,35
1683700162094,ETHN 103A,A00,199228,Man; Simeon S,0,0,9,9
1683700163121,ETHN 109,A00,185711,Staff,15,0,35,20
1683700164145,ETHN 142,A00,185726,Staff,0,4,30,30
1683700165172,ETHN 163J,A00,199229,Man; Simeon S,5,0,8,3
1683700166196,ETHN 168,A00,185727,Staff,7,0,10,3
1683700167220,ETHN 182,A00,185728,Staff,0,0,35,35
1683700168243,ETHN 183,A00,185737,Staff,9,0,18,9
1683700169270,GLBH 111,A01,209361,Burgos; Jose L.,0,0,0,0
1683700171321,HIEU 104,A00,185792,Staff,14,0,20,6
1683700172345,HIEU 115,A00,185800,Staff,0,0,20,20
1683700173373,HIEU 128,A00,185801,Staff,0,9,20,20
1683700174399,HIEU 147,A00,185802,Staff,15,0,20,5
1683700175422,HIEU 154,A00,185823,Staff,11,0,20,9
1683700176448,HILA 102,A00,185826,Staff,14,0,20,6
1683700177474,HILD 2C,A01,185778,Staff,0,13,20,20
1683700178498,HILD 7B,A01,185780,Kwak; Nancy,0,17,32,32
1683700178498,HILD 7B,A02,185781,Kwak; Nancy,0,18,32,32
1683700179522,HILD 30,A01,185791,Staff,12,0,20,8
1683700180546,HISC 119,A00,185830,Golan; Tal,0,10,20,20
1683700181570,HITO 156GS,A00,185831,Patterson; Patrick H.,0,0,0,23
1683700182597,HIUS 103,A00,185832,Man; Simeon S,0,4,20,20
1683700183626,HIUS 117,A00,185836,Kwak; Nancy,2,0,20,18
1683700184651,HIUS 125,A00,185840,Man; Simeon S,0,2,23,23
1683700185678,HIUS 149,A00,185845,Staff,1,0,20,19
1683700186703,HUM 3,A01,185882,Zavodny; Tatiana Sophia,0,8,50,50
1683700186703,HUM 3,B01,185899,Caldwell; Michael Alan,0,18,50,50
1683700187728,HUM 3GS,A00,185900,Patterson; Patrick H.,0,0,0,23
1683700188758,HUM 4,A01,185938,Zroka; Amy Liane,28,0,50,22
1683700188758,HUM 4,B01,185956,Watkins; Eric,0,6,50,50
1683700188758,HUM 4,B02,202209,Watkins; Eric,0,5,50,50
1683700188758,HUM 4,B03,202210,Watkins; Eric,0,5,50,50
1683700189785,HUM 5,A01,185958,West; Geoffrey Scott,0,0,50,50
1683700189785,HUM 5,A02,202215,West; Geoffrey Scott,0,1,50,50
1683700190811,INTL 190,A00,185959,Gagnon; Jeffrey C,0,0,0,9
1683700190811,INTL 190,B00,185960,Lettieri; Michael Joseph,0,0,0,2
1683700191835,JAPN 180,A00,254509,Staff,5,0,30,25
1683700192860,LATI 10,A01,202853,Kennemore; Amy Michelle,4,0,35,31
1683700192860,LATI 10,A02,202854,Kennemore; Amy Michelle,3,0,35,32
1683700192860,LATI 10,A03,270054,Kennemore; Amy Michelle,30,0,30,0
1683700193886,LATI 180,A00,202855,Kennemore; Amy Michelle,11,0,20,9
1683700194913,LAWS 101,A00,201767,Golan; Tal,0,7,40,40
1683700195939,LIFR 1C,A00,185961,Staff,6,0,20,14
1683700196963,LIFR 1CX,A00,185962,Staff,7,0,20,13
1683700197990,LIFR 1D,A00,185963,Staff,7,0,20,13
1683700199017,LIFR 1DX,A00,185964,Staff,7,0,20,13
1683700200041,LIGN 101,A01,186039,Staff,43,0,50,7
1683700201074,LIGN 165,A00,186040,Staff,14,0,50,36
1683700202099,LTCS 108,A00,186041,Staff,5,0,10,5
1683700203124,LTCS 119,A00,186042,Staff,15,0,20,5
1683700204146,LTCS 130,A00,186043,Wesling; Megan E.,15,0,25,10
1683700206197,LTEA 138,A00,186119,Staff,14,0,40,26
1683700207219,LTEN 124,A00,186148,Staff,5,0,25,20
1683700208243,LTEN 178,A00,186149,Staff,6,0,15,9
1683700209273,LTEN 181,A00,186150,Blanco; John D,34,0,40,6
1683700210300,LTWL 120,A00,186160,Staff,19,0,25,6
1683700211328,LTWL 165,A00,186161,Staff,22,0,25,3
1683700212352,LTWR 100,A00,186162,Staff,0,5,15,15
1683700213376,LTWR 102,A00,186163,Doller; Ben,5,0,15,10
1683700214401,MAE 8,A01,186412,Staff,0,1,0,0
1683700215424,MAE 30B,A00,186445,Bahadori; Mohammad Yousef,81,0,100,19
1683700216451,MAE 40,A00,186592,Bewley; Thomas R,10,0,50,40
1683700217475,MAE 101B,A00,186593,Bahadori; Mohammad Yousef,80,0,100,20
1683700218507,MAE 105,A00,186594,Bandaru; Prabhakar,10,0,50,40
1683700219533,MAE 107,A00,186599,Pham; Hieu Tan,0,8,120,120
1683700220563,MAE 148,A01,186660,Silberman; Jack,3,0,16,13
1683700221594,MATH 10A,A01,188095,Staff,0,6,35,35
1683700222623,MATH 10B,A01,188097,Bowers; Adam R.,0,12,30,30
1683700222623,MATH 10B,A02,188099,Bowers; Adam R.,0,11,30,30
1683700222623,MATH 10B,B01,188104,Bowers; Adam R.,0,10,30,30
1683700222623,MATH 10B,B02,188106,Bowers; Adam R.,0,9,30,30
1683700223648,MATH 10C,A01,188111,Staff,0,20,30,30
1683700223648,MATH 10C,A02,188127,Staff,0,19,30,30
1683700223648,MATH 10C,A03,188131,Staff,0,19,30,30
1683700223648,MATH 10C,B01,188218,Staff,17,0,30,13
1683700223648,MATH 10C,B02,188244,Staff,13,0,30,17
1683700223648,MATH 10C,B03,188277,Staff,14,0,30,16
1683700224673,MATH 18,A01,188344,Bach; Quang Tran,18,0,30,12
1683700224673,MATH 18,A02,188345,Bach; Quang Tran,11,0,30,19
1683700224673,MATH 18,B01,188353,Bach; Quang Tran,11,0,30,19
1683700224673,MATH 18,B02,188354,Bach; Quang Tran,19,0,30,11
1683700225705,MATH 20A,A01,188374,Staff,11,0,35,24
1683700226731,MATH 20B,A01,188382,Ohm; Ko Woon,7,0,30,23
1683700226731,MATH 20B,A02,188383,Ohm; Ko Woon,22,0,30,8
1683700226731,MATH 20B,B01,188385,Ohm; Ko Woon,7,0,30,23
1683700226731,MATH 20B,B02,188392,Ohm; Ko Woon,22,0,30,8
1683700227755,MATH 20C,A01,188394,Harel; Guershon,10,0,30,20
1683700227755,MATH 20C,A02,188395,Harel; Guershon,13,0,30,17
1683700227755,MATH 20C,B01,188404,Harel; Guershon,5,0,30,25
1683700227755,MATH 20C,B02,188405,Harel; Guershon,18,0,30,12
1683700228786,MATH 20D,A01,188414,Hammock; Frances H,0,1,30,30
1683700228786,MATH 20D,A02,188415,Hammock; Frances H,0,1,30,30
1683700228786,MATH 20D,B01,188447,Hammock; Frances H,0,1,30,30
1683700228786,MATH 20D,B02,188486,Hammock; Frances H,2,0,30,28
1683700229812,MATH 20E,A01,188649,Staff,21,0,30,9
1683700229812,MATH 20E,A02,188650,Staff,20,0,30,10
1683700229812,MATH 20E,A03,188673,Staff,0,0,30,30
1683700230841,MATH 102,A01,188675,Staff,0,40,35,35
1683700231866,MATH 103B,A01,188681,Staff,3,0,35,32
1683700231866,MATH 103B,B01,188692,Staff,5,0,35,30
1683700232890,MATH 109,A01,188695,Salehi Golsefidy; Alireza,24,0,35,11
1683700232890,MATH 109,A02,188696,Salehi Golsefidy; Alireza,25,0,35,10
1683700233915,MATH 120A,A01,188698,Eggers; John Dietrich,7,0,35,28
1683700234942,MATH 142B,A01,188736,Ioana; Adrian,0,0,30,30
1683700234942,MATH 142B,A02,188741,Ioana; Adrian,0,1,30,30
1683700234942,MATH 142B,A03,188743,Ioana; Adrian,0,2,30,30
1683700235966,MATH 168A,A01,188790,Staff,0,11,35,35
1683700236992,MATH 170A,A01,188803,Nie; Jiawang,0,2,35,35
1683700236992,MATH 170A,A02,188811,Nie; Jiawang,0,1,35,35
1683700236992,MATH 170A,A03,188814,Nie; Jiawang,0,0,35,35
1683700236992,MATH 170A,A04,188815,Nie; Jiawang,5,0,35,30
1683700238016,MATH 193B,A01,188817,Staff,0,0,35,35
1683700238016,MATH 193B,A02,188818,Staff,6,0,35,29
1683700239041,MGT 4,A01,202857,Anderson; John Charles,59,0,80,21
1683700240066,MGT 12,A00,202858,Lindenberger; Wade Douglas,40,0,90,50
1683700241090,MGT 18,A00,202859,Staff,74,0,90,16
1683700242115,MGT 18GS,A00,202860,McKay; Michael J,13,0,28,15
1683700243138,MGT 45,A00,202861,Pecore; Joseph P.,8,0,90,82
1683700244166,MGT 100,A00,202863,Yavorsky; Daniel Ryan,27,0,90,63
1683700245191,MGT 103,A00,202864,Ehrich; Kristine R,0,19,90,90
1683700246216,MGT 112,A00,202865,Ehrich; Kristine R,15,0,90,75
1683700247242,MGT 121A,A00,202868,Staff,70,0,90,20
1683700248267,MGT 131B,A00,202869,Anderson; John Charles,58,0,90,32
1683700249292,MGT 136,A00,202871,Lindenberger; Wade Douglas,83,0,90,7
1683700250317,MGT 164,A00,202873,Staff,0,67,90,91
1683700251341,MGT 164GS,A00,202874,McKay; Mary A,13,0,28,15
1683700252365,MGT 180,A00,202875,Staff,0,51,90,91
1683700253389,MMW 11R,A01,205019,Herbst; Matthew,0,0,30,30
1683700253389,MMW 11R,A02,205026,Herbst; Matthew,29,0,30,1
1683700254418,MMW 15,A01,193512,Chang; Edmond Yi-Teh,0,8,28,28
1683700254418,MMW 15,A02,193513,Chang; Edmond Yi-Teh,0,5,28,28
1683700254418,MMW 15,A03,193514,Chang; Edmond Yi-Teh,0,5,28,28
1683700254418,MMW 15,A04,193515,Chang; Edmond Yi-Teh,0,5,28,28
1683700254418,MMW 15,A05,193516,Chang; Edmond Yi-Teh,0,5,28,28
1683700254418,MMW 15,A06,193517,Chang; Edmond Yi-Teh,0,6,28,28
1683700254418,MMW 15,B01,193519,Chang; Edmond Yi-Teh,0,5,28,28
1683700254418,MMW 15,B02,193520,Chang; Edmond Yi-Teh,0,5,28,28
1683700254418,MMW 15,B03,193521,Chang; Edmond Yi-Teh,0,5,28,28
1683700254418,MMW 15,B04,193522,Chang; Edmond Yi-Teh,0,6,28,28
1683700254418,MMW 15,B05,193523,Chang; Edmond Yi-Teh,0,5,28,28
1683700254418,MMW 15,B06,193524,Chang; Edmond Yi-Teh,0,5,28,28
1683700255441,MMW 122,A01,193526,Rahimi; Babak,0,16,28,28
1683700255441,MMW 122,A02,193527,Rahimi; Babak,0,15,28,28
1683700255441,MMW 122,A03,193528,Rahimi; Babak,0,0,0,0
1683700255441,MMW 122,A04,193529,Rahimi; Babak,0,0,0,0
1683700256464,MUS 1A,A01,186663,Staff,0,18,35,35
1683700257489,MUS 4,A01,186715,Staff,0,12,35,35
1683700258517,MUS 5R,A01,186796,Dubnov; Shlomo,0,17,35,35
1683700259543,MUS 6,A01,186798,Staff,0,4,25,25
1683700260625,MUS 7,A01,186830,Staff,11,0,35,24
1683700261651,MUS 8,A01,186930,Staff,0,27,35,35
1683700262678,MUS 15,A01,186932,Staff,0,15,35,35
1683700262678,MUS 15,B01,186934,Staff,0,16,35,35
1683700263703,MUS 80,A00,186935,Staff,0,0,20,20
1683700263703,MUS 80,B00,186936,Staff,24,0,25,1
1683700264733,NANO 11,A00,204702,Lipomi; Darren John,0,0,0,0
1683700265758,NANO 15,A01,204709,Yang; Kesong,0,1,0,0
1683700266787,NANO 114,A00,202069,Jahed Motlagh; Zeinab,2,0,10,8
1683700267812,PHIL 1,A00,186955,Grush; Rick Scott,31,0,40,9
1683700268837,PHIL 10,A01,186973,Grush; Rick Scott,27,0,35,8
1683700268837,PHIL 10,A02,186974,Grush; Rick Scott,33,0,35,2
1683700269861,PHIL 13,A01,186976,Staff,1,0,35,34
1683700269861,PHIL 13,A02,186977,Staff,16,0,35,19
1683700270889,PHIL 14,A01,186979,Staff,30,0,35,5
1683700270889,PHIL 14,A02,186986,Staff,32,0,35,3
1683700271915,PHIL 28,A01,186988,Staff,16,0,30,14
1683700271915,PHIL 28,A02,186989,Staff,1,0,30,29
1683700271915,PHIL 28,A03,186990,Staff,10,0,30,20
1683700271915,PHIL 28,A04,186991,Staff,26,0,30,4
1683700272942,PHIL 120,A00,186997,Staff,23,0,40,17
1683700273966,PHIL 137,A00,187003,Staff,7,0,40,33
1683700274994,PHIL 150,A00,187015,Staff,47,0,70,23
1683700276022,PHIL 167,A00,187021,Lamey; Andy M.,34,0,40,6
1683700277050,PHIL 174,A01,202226,Staff,17,0,20,3
1683700277050,PHIL 174,A02,202235,Staff,20,0,20,0
1683700278073,PHIL 191A,A00,258918,Staff,0,0,1,1
1683700279096,PHYS 1A,A00,187028,Staff,26,0,60,34
1683700280119,PHYS 1AL,001,187036,Staff,3,0,30,27
1683700280119,PHYS 1AL,002,187049,Staff,18,0,30,12
1683700281146,PHYS 1B,A00,187058,Staff,21,0,60,39
1683700282170,PHYS 1BL,001,187064,Staff,0,1,30,30
1683700282170,PHYS 1BL,002,187070,Staff,4,0,30,26
1683700283199,PHYS 1C,A00,187082,Staff,30,0,120,90
1683700284224,PHYS 1CL,001,187088,Staff,0,9,30,30
1683700284224,PHYS 1CL,002,187089,Staff,0,1,30,30
1683700284224,PHYS 1CL,009,262693,Staff,9,0,30,21
1683700285248,PHYS 2B,A01,187097,Staff,55,0,115,60
1683700286275,PHYS 2C,A01,187099,Staff,63,0,115,52
1683700287301,PHYS 2CL,A01,187101,Staff,5,0,28,23
1683700287301,PHYS 2CL,A02,187102,Staff,15,0,28,13
1683700288327,PHYS 2D,A01,187123,Shotwell; Brian,95,0,115,20
1683700289356,PHYS 4B,A01,187133,Grinstein; Benjamin,35,0,50,15
1683700290383,POLI 10,A00,188819,Staff,0,4,50,50
1683700291407,POLI 11,A00,188827,Staff,43,0,50,7
1683700292431,POLI 13R,A00,188828,Staff,0,1,20,20
1683700293456,POLI 27,A01,188830,Elgin; Samuel Zincke,0,2,70,70
1683700294486,POLI 30,A00,188832,Desposato; Scott,30,0,50,20
1683700295510,POLI 102F,A00,188834,Staff,1,0,40,39
1683700296535,POLI 104A,A00,188852,Staff,12,0,30,18
1683700297559,POLI 104I,A00,188853,Staff,0,8,20,20
1683700298585,POLI 110B,A00,188854,Wiens; David,6,0,20,14
1683700299622,POLI 112A,A00,188855,Wiens; David,3,0,30,27
1683700300646,POLI 117R,A00,188856,Forman; Fonna,0,12,20,20
1683700301668,POLI 118,A00,188857,Ingham; Sean,8,0,20,12
1683700302691,POLI 120G,A00,188858,Staff,8,0,30,22
1683700303718,POLI 131CR,A00,188863,Hoston; Germaine,20,0,50,30
1683700304742,POLI 133,A00,188864,Nellis; Gareth Hb,44,0,50,6
1683700305767,POLI 134D,A00,188865,Desposato; Scott,27,0,30,3
1683700306795,POLI 142A,A00,188871,Gartzke; Erik,21,0,50,29
1683700307818,POLI 142K,A00,188874,Staff,38,0,50,12
1683700308842,POLI 143,A00,188940,Gartzke; Erik,15,0,30,15
1683700309866,POLI 153,A00,188943,Staff,2,0,20,18
1683700310891,POLI 160AA,A00,188944,Staff,10,0,40,30
1683700311915,POLI 170A,A00,188945,Staff,10,0,30,20
1683700313965,PSYC 1,A00,188952,Staff,36,0,90,54
1683700314991,PSYC 2,B00,188953,Staff,19,0,35,16
1683700316018,PSYC 6,A00,188970,Staff,47,0,60,13
1683700317043,PSYC 7,A00,188973,Staff,35,0,45,10
1683700318068,PSYC 60,A01,188980,Rickard; Timothy C.,42,0,60,18
1683700319101,PSYC 70,A01,189001,Steiner; Eric Tomas,21,0,45,24
1683700320126,PSYC 100,A00,189005,Lacefield; Katharine I,0,98,120,120
1683700321150,PSYC 102,A00,189008,Staff,6,0,30,24
1683700322172,PSYC 106,B00,189026,Gorman; Michael R.,27,0,60,33
1683700323195,PSYC 114,B01,189033,Winkielman; Piotr,0,31,30,30
1683700324220,PSYC 131,A00,189036,Anagnostaras; Stephan,0,44,60,60
1683700325245,PSYC 136,A00,189041,Lowe; Angela Beth,0,7,25,25
1683700326269,PSYC 137,A00,189057,Winkielman; Piotr,0,36,25,25
1683700327298,PSYC 144,A00,189107,Wixted; John T,0,11,50,50
1683700329350,PSYC 162,A00,189142,Staff,0,9,85,85
1683700330376,PSYC 172,A00,189144,Gorman; Michael R.,0,6,30,30
1683700332428,PSYC 179,A00,189146,Lacefield; Katharine I,0,88,120,120
1683700333453,PSYC 181,A00,189147,Anagnostaras; Stephan,0,45,90,90
1683700334484,PSYC 190R,A00,189148,Barner; David A.,0,23,80,80
1683700335508,PSYC 191,A00,189275,Rickard; Timothy C.,0,11,25,25
1683700336532,PSYC 193,A00,189276,Chapman; Eddie Nathaniel,0,1,0,4
1683700337556,PSYC 193L,A01,189281,Lowe; Angela Beth,8,0,20,12
1683700337556,PSYC 193L,B01,189285,Staff,28,0,35,7
1683700338585,RELI 149,A00,187137,Rahimi; Babak,6,0,40,34
1683700339613,SE 9,A01,187315,Staff,0,2,18,18
1683700340639,SE 101B,A00,187409,Staff,24,0,30,6
1683700341666,SE 110B,A00,187444,Staff,10,0,40,30
1683700342690,SE 130B,A00,187449,Staff,31,0,40,9
1683700343715,SE 150A,A00,187516,Staff,8,0,20,12
1683700344740,SE 154,A00,187528,Staff,29,0,50,21
1683700345765,SIO 3,A01,258171,Staff,35,0,40,5
1683700346794,SIO 10,A00,187144,Cook; Geoffrey W,0,6,75,75
1683700347821,SIO 45,A00,187152,Cook; Geoffrey W,0,7,100,100
1683700348851,SIO 109R,A00,194486,Staff,0,4,20,20
1683700350903,SIO 187,A01,187233,Kacev; David,12,0,40,28
1683700351933,SOCI 1,A01,258656,Thorpe; Charles Robert,28,0,30,2
1683700351933,SOCI 1,A02,258658,Thorpe; Charles Robert,30,0,30,0
1683700351933,SOCI 1,A03,258661,Thorpe; Charles Robert,25,0,25,0
1683700351933,SOCI 1,A04,258666,Thorpe; Charles Robert,22,0,25,3
1683700351933,SOCI 1,A05,258897,Thorpe; Charles Robert,22,0,25,3
1683700351933,SOCI 1,A06,258898,Thorpe; Charles Robert,25,0,25,0
1683700352958,SOCI 30,A01,258903,Pardo Guerra; Juan Pablo,14,0,30,16
1683700353982,SOCI 102,A00,258904,Staff,9,0,25,16
1683700355007,SOCI 106,A00,258905,Staff,19,0,25,6
1683700356035,SOCI 111,A00,258907,Ribas Norris; Janet Vanesa,26,0,30,4
1683700357061,SOCI 121R,A00,258908,Pardo Guerra; Juan Pablo,7,0,30,23
1683700358086,SOCI 126,A01,203330,Staff,14,0,20,6
1683700359111,SOCI 131,A00,258909,Thorpe; Charles Robert,30,0,60,30
1683700360135,SOCI 135,A00,258910,Payne; Christine Anna,0,13,30,30
1683700361159,SOCI 157,A00,258911,Staff,10,0,30,20
1683700362185,SOCI 184,A00,258912,Staff,25,0,30,5
1683700363210,SOCI 188D,A00,258913,Staff,22,0,30,8
1683700364289,SYN 2,001,187529,Staff,9,0,16,7
1683700364289,SYN 2,002,201452,Staff,0,20,16,16
1683700364289,SYN 2,003,201469,Staff,1,0,16,15
1683700365317,SYN 100,A01,187531,Staff,0,9,20,20
1683700365317,SYN 100,B01,201491,Staff,0,10,20,20
1683700366345,TDAC 1,A00,189286,Walsh; Kim C.,3,0,20,17
1683700366345,TDAC 1,B00,189287,Harting; Carla Kelso,10,0,20,10
1683700367370,TDAC 101,A00,189300,Walsh; Kim C.,16,0,20,4
1683700367370,TDAC 101,B00,189301,Harting; Carla Kelso,18,0,20,2
1683700368400,TDAC 102,A00,189304,Basso; Beatrice,14,0,20,6
1683700369424,TDAC 108,A00,189305,Staff,18,0,20,2
1683700370452,TDDE 131,A00,189310,Staff,19,0,20,1
1683700370452,TDDE 131,B00,189314,Staff,19,0,20,1
1683700370452,TDDE 131,C00,189315,Staff,48,0,50,2
1683700370452,TDDE 131,D00,189316,Staff,14,0,15,1
1683700370452,TDDE 131,E00,204841,Staff,20,0,20,0
1683700371479,TDGE 10,A00,189289,Staff,27,0,50,23
1683700371479,TDGE 10,B00,189290,Havis; Allan,0,1,50,50
1683700372504,TDGE 11,A00,189291,Fulton; Julia,0,4,50,50
1683700372504,TDGE 11,B00,189292,Staff,20,0,25,5
1683700372504,TDGE 11,C00,260270,Staff,0,0,0,0
1683700373529,TDGE 25,A00,189294,Staff,1,0,20,19
1683700374555,TDGE 124,A00,189318,Fulton; Julia,0,7,50,50
1683700375580,TDGE 125,A00,189319,Staff,13,0,25,12
1683700375580,TDGE 125,B00,189320,Staff,23,0,25,2
1683700376607,TDGE 127,A00,189322,Havis; Allan,1,0,50,49
1683700377632,TDHT 101,A00,189323,Staff,18,0,25,7
1683700377632,TDHT 101,B00,189324,Staff,25,0,25,0
1683700378657,TDHT 102,A00,189325,Staff,49,0,50,1
1683700379685,TDMV 1,A00,189295,Arcidiacono; Kristin,20,0,30,10
1683700379685,TDMV 1,B00,189296,Caligagan; Maria T.,24,0,30,6
1683700380711,TDMV 2,A00,189297,Sammartano; Tonnie,27,0,30,3
1683700380711,TDMV 2,B00,189299,Arcidiacono; Kristin,23,0,30,7
1683700381736,TDMV 3,A00,204998,Rincon; Alicia,22,0,30,8
1683700382760,TDMV 120,A00,189458,Sammartano; Tonnie,28,0,30,2
1683700383784,TDMV 138,A00,189541,Jun; Grace Shin Hae,20,0,40,20
1683700384814,TDMV 142,A00,189717,Caligagan; Tony,25,0,30,5
1683700384814,TDMV 142,B00,189718,Caligagan; Maria T.,25,0,30,5
1683700385840,TMC 2,A01,187533,Staff,25,0,25,0
1683700385840,TMC 2,A02,187534,Staff,25,0,25,0
1683700386869,USP 1,A01,187536,Kwak; Nancy,0,16,25,25
1683700387898,USP 5,A01,187538,Staff,8,0,25,17
1683700388923,USP 101,A00,199253,Staff,0,4,0,0
1683700389952,USP 124,A00,187562,Boomhower; Matthew Charles,0,0,30,30
1683700390976,USP 138,A00,187582,Staff,19,0,25,6
1683700392003,USP 152,A01,187597,Staff,3,0,25,22
1683700393031,USP 153,A00,187598,Staff,18,0,25,7
1683700394057,USP 168,A00,187607,Kwak; Nancy,2,0,5,3
1683700395082,USP 173,A00,187619,Staff,4,0,25,21
1683700396107,USP 181,A00,187638,Staff,0,4,25,25
1683700397135,VIS 103,A00,187650,Cruz; Edwin Teddy,17,0,75,58
1683700398160,VIS 110D,A00,187669,Staff,13,0,22,9
1683700399184,VIS 127C,A00,187720,Shen; Kuiyi,67,0,146,79
1683700400209,VIS 149,A00,187731,Yoldas; Pinar,0,12,22,22
1683700401237,VIS 151,A01,188091,Staff,22,0,34,12
1683700401237,VIS 151,A02,188092,Staff,11,0,34,23
1683700402261,VIS 160B,A00,188093,Stalbaum; Brett,0,1,10,10
1683700404313,WCWP 10B,A00,201720,Staff,0,0,5,5
1683700404313,WCWP 10B,B00,201722,Staff,0,0,6,6
1683700405337,WCWP 100,A00,201725,Gagnon; Jeffrey C,0,0,2,2
1683700405337,WCWP 100,B00,201727,Staff,0,4,15,15
1683700408429,ANBI 133,A00,258401,Wilder; Linnea Lorene,34,0,40,6
1683700409453,ANBI 140,A00,258395,Hrvoj Mihic; Branka,18,0,25,7
1683700410482,ANSC 120,A00,258402,Bialecki; Jon Anthony,26,0,40,14
1683700411507,ANSC 144,A00,258400,Staff,12,0,40,28
1683700413557,ANSC 166,A00,258396,Parish; Steven Martin,156,0,175,19
1683700414584,ANSC 180,A00,193533,Staff,8,0,20,12
1683700415608,ANSC 188,A00,258397,Jassal; Aftab,34,0,40,6
1683700416632,ANTH 3,A01,258316,Staff,23,0,30,7
1683700417659,ANTH 5,A00,258394,Semendeferi; Ekaterini,16,0,20,4
1683700418686,ANTH 21,A01,258331,Staff,4,0,40,36
1683700419714,ANTH 103,A00,258398,Varma; Saiba,15,0,25,10
1683700420744,AWP 10,001,202034,Staff,0,0,0,0
1683700420744,AWP 10,002,202035,Staff,0,0,0,0
1683700420744,AWP 10,003,202036,Staff,0,0,0,0
1683700420744,AWP 10,004,202037,Staff,0,0,0,0
1683700420744,AWP 10,005,202038,Staff,0,0,0,0
1683700420744,AWP 10,006,202039,Staff,0,0,0,0
1683700420744,AWP 10,007,202040,Staff,0,0,0,0
1683700420744,AWP 10,008,202041,Staff,0,0,0,0
1683700420744,AWP 10,009,202042,Staff,0,0,0,0
1683700420744,AWP 10,010,202043,Staff,0,0,0,0
1683700420744,AWP 10,011,202044,Staff,0,0,0,0
1683700420744,AWP 10,012,202045,Staff,0,0,0,0
1683700420744,AWP 10,013,202046,Staff,0,0,0,0
1683700420744,AWP 10,014,202047,Staff,0,0,0,0
1683700420744,AWP 10,015,202048,Staff,0,0,0,0
1683700420744,AWP 10,016,202049,Staff,0,0,0,0
1683700420744,AWP 10,017,202050,Staff,0,0,0,0
1683700420744,AWP 10,018,202051,Staff,0,0,0,0
1683700420744,AWP 10,019,202052,Staff,0,0,0,0
1683700420744,AWP 10,020,202053,Staff,0,0,0,0
1683700420744,AWP 10,021,202054,Staff,0,0,0,0
1683700420744,AWP 10,022,202055,Staff,0,0,0,0
1683700420744,AWP 10,023,202056,Staff,0,0,0,0
1683700420744,AWP 10,024,202057,Staff,0,0,0,0
1683700420744,AWP 10,025,202058,Staff,0,0,0,0
1683700420744,AWP 10,026,202059,Staff,0,0,0,0
1683700421770,AWP 102,001,202032,Staff,0,0,0,0
1683700421770,AWP 102,002,202033,Staff,0,0,0,0
1683700422796,BENG 100,A01,254234,Taylor Amos; Alyssa C,31,0,40,9
1683700423823,BENG 196,001,270013,Engler; Adam J.,9999,0,9999,0
1683700424848,BICD 100R,A01,202018,Smith; Laurie,0,7,32,32
1683700424848,BICD 100R,A02,202019,Smith; Laurie,0,3,32,32
1683700424848,BICD 100R,A03,202020,Smith; Laurie,0,1,32,32
1683700424848,BICD 100R,A04,202021,Smith; Laurie,6,0,32,26
1683700424848,BICD 100R,A05,202022,Smith; Laurie,10,0,32,22
1683700425872,BICD 136,A01,193242,Gustafson-Brown; Cindy,0,2,32,32
1683700425872,BICD 136,A02,193244,Gustafson-Brown; Cindy,13,0,32,19
1683700426897,BIEB 102,A01,193249,Butler; Shannon Rhey,0,0,32,32
1683700426897,BIEB 102,A02,193251,Butler; Shannon Rhey,0,0,32,32
1683700426897,BIEB 102,A03,193253,Butler; Shannon Rhey,0,0,32,32
1683700426897,BIEB 102,A04,193255,Butler; Shannon Rhey,13,0,32,19
1683700426897,BIEB 102,A05,193265,Butler; Shannon Rhey,25,0,32,7
1683700426897,BIEB 102,A06,193269,Butler; Shannon Rhey,12,0,32,20
1683700428946,BIEB 150,A01,193274,Staff,0,0,32,32
1683700428946,BIEB 150,A02,193285,Staff,24,0,32,8
1683700429974,BIEB 194,A00,193286,Kurle; Carolyn M.,19,0,32,13
1683700430997,BILD 1,A01,192291,Staff,15,0,32,17
1683700430997,BILD 1,A02,192292,Staff,30,0,32,2
1683700430997,BILD 1,B01,192520,Reuther; Keefe,0,1,0,0
1683700430997,BILD 1,B02,192532,Reuther; Keefe,0,1,0,0
1683700432022,BILD 3,A01,192556,Butler; Shannon Rhey,0,0,32,32
1683700432022,BILD 3,A02,192581,Butler; Shannon Rhey,0,1,32,32
1683700432022,BILD 3,A03,192611,Butler; Shannon Rhey,19,0,32,13
1683700432022,BILD 3,A04,192612,Butler; Shannon Rhey,23,0,32,9
1683700432022,BILD 3,A05,192613,Butler; Shannon Rhey,26,0,32,6
1683700432022,BILD 3,A06,192679,Butler; Shannon Rhey,27,0,32,5
1683700432022,BILD 3,A07,192682,Butler; Shannon Rhey,20,0,32,12
1683700433047,BILD 4,A01,192836,Reuther; Keefe,1,0,24,23
1683700433047,BILD 4,A02,193044,Reuther; Keefe,4,0,24,20
1683700434074,BILD 10,A01,193142,Gustafson-Brown; Cindy,29,0,32,3
1683700434074,BILD 10,A02,193149,Gustafson-Brown; Cindy,31,0,32,1
1683700435102,BIMM 100,A01,193301,Staff,0,6,32,32
1683700435102,BIMM 100,A02,193312,Staff,0,7,32,32
1683700435102,BIMM 100,A03,193323,Staff,0,10,32,32
1683700436129,BIMM 101,A01,193329,McDonnell; Lisa Marie,0,3,24,24
1683700436129,BIMM 101,A02,193339,McDonnell; Lisa Marie,0,3,24,24
1683700436129,BIMM 101,B01,193354,McDonnell; Lisa Marie,0,4,24,24
1683700436129,BIMM 101,B02,193357,McDonnell; Lisa Marie,0,3,24,24
1683700437151,BIMM 110,A01,193377,Tat; John,0,11,32,32
1683700437151,BIMM 110,A02,193378,Tat; John,0,11,32,32
1683700438181,BIMM 120,A01,206116,Staff,0,0,32,32
1683700438181,BIMM 120,A02,206117,Staff,7,0,32,25
1683700438181,BIMM 120,A03,206121,Staff,21,0,32,11
1683700439210,BIPN 100,A01,193393,Park; Ji Young,0,15,32,32
1683700439210,BIPN 100,A02,193402,Park; Ji Young,0,14,32,32
1683700439210,BIPN 100,A03,193413,Park; Ji Young,0,14,32,32
1683700439210,BIPN 100,A04,193414,Park; Ji Young,0,13,32,32
1683700440233,BIPN 102,A01,193429,Staff,0,0,32,32
1683700440233,BIPN 102,A02,193438,Staff,18,0,32,14
1683700441257,BIPN 106,A01,193450,Reyes Gonzalez; Catalina,0,2,40,40
1683700442285,BIPN 134,A01,193465,Cooke; James Edward,0,0,32,32
1683700442285,BIPN 134,A02,193474,Cooke; James Edward,25,0,32,7
1683700442285,BIPN 134,A03,193485,Cooke; James Edward,29,0,32,3
1683700442285,BIPN 134,A04,193486,Cooke; James Edward,20,0,32,12
1683700442285,BIPN 134,A05,193491,Cooke; James Edward,31,0,32,1
1683700442285,BIPN 134,A06,193501,Cooke; James Edward,30,0,32,2
1683700442285,BIPN 134,A07,193510,Cooke; James Edward,29,0,32,3
1683700444335,BISP 194,A00,222522,Staff,14,0,32,18
1683700445362,CAT 124,A01,202407,Staff,19,0,25,6
1683700446391,CAT 125,A00,202408,Marchisotto; Jennifer Anne,2,0,20,18
1683700447419,CAT 125R,A00,202409,Smith; Lauryn Alissa,0,11,20,20
1683700447419,CAT 125R,B00,202410,Morales; Celeste Georgianna,0,11,20,20
1683700447419,CAT 125R,C00,202411,Irwin; Matthew Joseph,0,12,20,20
1683700448443,CENG 15,A01,204712,Yang; Kesong,0,1,0,0
1683700449466,CENG 114,A00,202070,Jahed Motlagh; Zeinab,5,0,20,15
1683700450491,CGS 105,A00,185477,Wesling; Megan E.,24,0,40,16
1683700451514,CGS 106,A00,185494,Staff,11,0,22,11
1683700452540,CGS 108,A00,185495,Staff,14,0,20,6
1683700453568,CGS 114,A00,185496,Staff,13,0,18,5
1683700454595,CGS 119,A00,185501,Staff,15,0,20,5
1683700455619,CGS 120,A00,185511,Staff,12,0,20,8
1683700456654,CHEM 4,A01,184675,Bussey; Thomas J,97,0,100,3
1683700457681,CHEM 6A,A01,184677,Staff,32,0,60,28
1683700458706,CHEM 6B,A01,184679,Staff,63,0,100,37
1683700459731,CHEM 6C,A01,184681,Bussey; Thomas J,0,0,50,50
1683700459731,CHEM 6C,A02,184682,Bussey; Thomas J,32,0,50,18
1683700460759,CHEM 40A,A01,184684,Albizati; Kim F.,33,0,100,67
1683700461781,CHEM 40B,A01,184686,Albizati; Kim F.,0,22,100,100
1683700462809,CHEM 41B,A01,184690,Staff,51,0,100,49
1683700463837,COGS 3,A01,184715,Boyle; Mary E. T.,0,27,40,40
1683700464862,COGS 14B,A01,185172,Staff,0,14,38,38
1683700465887,COGS 18,A01,184736,Staff,14,0,80,66
1683700466915,COGS 100,A01,184932,Staff,0,8,73,73
1683700468016,COGS 101A,A01,184935,Staff,0,40,30,30
1683700469042,COGS 101B,A01,184944,Staff,0,2,30,30
1683700470069,COGS 101C,A01,184946,Staff,0,10,30,30
1683700471093,COGS 102A,A01,184951,Johnson; Christine M.,1,0,40,39
1683700472122,COGS 107B,A01,184953,Mooshagian; Eric Frederick,0,52,40,40
1683700473150,COGS 118B,A01,184959,Gupta; Anjum,0,50,40,40
1683700474174,COGS 153,A00,184961,Staff,1,16,30,29
1683700475200,COGS 177,A00,184962,Staff,0,20,30,30
1683700476225,COGS 187A,A01,184969,Boyle; Mary E. T.,0,19,40,40
1683700477250,COMM 10,A01,185174,Staff,0,5,25,25
1683700477250,COMM 10,A02,185189,Staff,0,2,25,25
1683700477250,COMM 10,A03,269821,Staff,0,1,0,0
1683700478275,COMM 100B,A02,185476,Staff,10,0,25,15
1683700478275,COMM 100B,A03,277340,Staff,25,0,25,0
1683700479300,COMM 100C,A01,185314,Staff,2,0,25,23
1683700479300,COMM 100C,A02,185327,Staff,17,0,25,8
1683700480327,COMM 110M,A00,185349,Staff,0,0,40,40
1683700481352,COMM 113T,A00,185352,Staff,25,0,40,15
1683700482376,COMM 114I,A00,185353,Staff,31,0,40,9
1683700483398,COMM 131,A00,185354,Staff,17,0,30,13
1683700484422,CSE 8A,A50,185358,Cao; Yingjun,0,46,10,10
1683700485449,CSE 8B,A01,185362,Staff,0,48,50,50
1683700486476,CSE 11,A01,185416,Cao; Yingjun,0,91,10,10
1683700487503,CSE 20,A01,185445,Briones; Jor-el Thomas Caparas,3,0,25,22
1683700488527,CSE 21,A01,185447,Staff,9,0,50,41
1683700489551,CSE 101,A01,185451,Staff,0,13,50,50
1683700489551,CSE 101,B01,185453,Jones; Miles E,0,14,50,50
1683700491606,CSE 141,A01,185458,Eldon; John,16,0,100,84
1683700492631,CSE 141L,A01,185461,Eldon; John,8,0,100,92
1683700493655,CSE 142,A01,185463,Staff,34,0,60,26
1683700493655,CSE 142,B01,201355,Staff,0,7,60,60
1683700494682,CSE 142L,A01,185470,Staff,34,0,60,26
1683700494682,CSE 142L,B01,201417,Staff,0,6,60,60
1683700495711,CSE 190,A00,201433,Staff,32,0,49,17
1683700496741,DOC 1,A01,259136,Strom; Megan C.,7,0,15,8
1683700496741,DOC 1,A02,259137,Strom; Megan C.,14,0,15,1
1683700496741,DOC 1,A03,259138,Strom; Megan C.,14,0,15,1
1683700496741,DOC 1,A04,259139,Strom; Megan C.,14,0,15,1
1683700497765,DOC 100D,A00,259140,Pass; Natalye Joann,14,0,25,11
1683700498793,DSGN 1,A01,184749,Rill; Bryan,0,26,30,30
1683700499821,DSGN 100,A01,185168,Staff,0,2,25,25
1683700500849,ECE 5,A01,185626,Morris; Karcher William,0,12,0,0
1683700501879,ECE 101,A01,185628,Staff,14,0,70,56
1683700502903,ECE 107,A01,185635,Baghdadchi; Saharnaz,0,0,20,20
1683700502903,ECE 107,A02,185638,Baghdadchi; Saharnaz,1,0,20,19
1683700503928,ECE 148,A01,185647,Silberman; Jack,0,0,16,16
1683700504958,ECON 1,A01,185537,Crane; Meredith Helen,54,0,70,16
1683700505987,ECON 3,A01,185549,Crane; Meredith Helen,30,0,70,40
1683700507014,ECON 4,A01,203354,Anderson; John Charles,0,5,10,10
1683700508041,ECON 100A,A01,185574,Staff,0,5,40,40
1683700509068,ECON 100B,A01,185576,Staff,0,12,50,50
1683700510092,ECON 100C,A01,185589,Newhouse; Herbert S,30,0,70,40
1683700511116,ECON 105,A00,185608,Vespa; Emanuel Ignacio,19,0,35,16
1683700512140,ECON 109,A01,185610,Shishkin; Denis,9,0,35,26
1683700513164,ECON 110A,A01,185612,Staff,8,0,40,32
1683700514187,ECON 120A,A01,185615,Staff,19,0,40,21
1683700515211,ECON 120C,A01,185617,Sun; Yixiao,0,21,70,70
1683700516239,ECON 144,A00,203346,Squires; Dale E,2,0,35,33
1683700517268,ECON 171,A01,203349,Newhouse; Herbert S,0,1,35,35
1683700518292,ECON 173A,A01,185621,Toda; Alexis Akira,21,0,35,14
1683700519318,EDS 25,A01,202413,Staff,0,1,0,0
1683700519318,EDS 25,A02,202414,Staff,0,1,0,0
1683700519318,EDS 25,A03,202415,Staff,0,0,0,0
1683700519318,EDS 25,A04,202416,Staff,0,1,0,0
1683700519318,EDS 25,A05,202439,Staff,0,0,0,0
1683700519318,EDS 25,A06,202440,Staff,0,0,0,0
1683700519318,EDS 25,B01,202631,Staff,0,0,0,0
1683700519318,EDS 25,B02,202632,Staff,0,0,0,0
1683700519318,EDS 25,B03,202639,Staff,0,0,0,0
1683700519318,EDS 25,B04,202640,Staff,0,0,0,0
1683700519318,EDS 25,B05,202643,Staff,0,0,0,0
1683700519318,EDS 25,B06,202644,Staff,0,0,0,0
1683700520342,EDS 38,A01,202659,Black; Alison Michelle,25,0,25,0
1683700521370,EDS 115,A00,202652,Staff,18,0,30,12
1683700522397,EDS 125,A00,202649,Staff,13,0,30,17
1683700523421,EDS 126,A01,203332,Staff,30,0,30,0
1683700524446,EDS 139,A00,202838,Staff,16,0,25,9
1683700525473,EDS 146,A01,202655,Staff,14,0,25,11
1683700526499,ENG 15,A00,185667,Staff,0,1,0,0
1683700526499,ENG 15,B00,185672,Staff,0,0,0,0
1683700526499,ENG 15,C00,185675,Staff,0,0,0,0
1683700526499,ENG 15,D00,185682,Staff,0,0,0,0
1683700526499,ENG 15,E00,185684,Staff,0,0,0,0
1683700527522,ETHN 103,A00,185710,Staff,0,8,35,35
1683700528549,ETHN 103A,A00,199228,Man; Simeon S,0,0,9,9
1683700529571,ETHN 109,A00,185711,Staff,15,0,35,20
1683700530596,ETHN 142,A00,185726,Staff,0,4,30,30
1683700531621,ETHN 163J,A00,199229,Man; Simeon S,5,0,8,3
1683700532647,ETHN 168,A00,185727,Staff,7,0,10,3
1683700533672,ETHN 182,A00,185728,Staff,0,0,35,35
1683700534695,ETHN 183,A00,185737,Staff,9,0,18,9
1683700535722,GLBH 111,A01,209361,Burgos; Jose L.,0,0,0,0
1683700537774,HIEU 104,A00,185792,Staff,14,0,20,6
1683700538798,HIEU 115,A00,185800,Staff,0,0,20,20
1683700539825,HIEU 128,A00,185801,Staff,0,9,20,20
1683700540854,HIEU 147,A00,185802,Staff,15,0,20,5
1683700541878,HIEU 154,A00,185823,Staff,11,0,20,9
1683700542906,HILA 102,A00,185826,Staff,14,0,20,6
1683700543933,HILD 2C,A01,185778,Staff,0,13,20,20
1683700544961,HILD 7B,A01,185780,Kwak; Nancy,0,17,32,32
1683700544961,HILD 7B,A02,185781,Kwak; Nancy,0,18,32,32
1683700545983,HILD 30,A01,185791,Staff,12,0,20,8
1683700547009,HISC 119,A00,185830,Golan; Tal,0,10,20,20
1683700548036,HITO 156GS,A00,185831,Patterson; Patrick H.,0,0,0,23
1683700549063,HIUS 103,A00,185832,Man; Simeon S,0,4,20,20
1683700550091,HIUS 117,A00,185836,Kwak; Nancy,2,0,20,18
1683700551115,HIUS 125,A00,185840,Man; Simeon S,0,2,23,23
1683700552138,HIUS 149,A00,185845,Staff,1,0,20,19
1683700553166,HUM 3,A01,185882,Zavodny; Tatiana Sophia,0,8,50,50
1683700553166,HUM 3,B01,185899,Caldwell; Michael Alan,0,18,50,50
1683700554192,HUM 3GS,A00,185900,Patterson; Patrick H.,0,0,0,23
1683700555216,HUM 4,A01,185938,Zroka; Amy Liane,28,0,50,22
1683700555216,HUM 4,B01,185956,Watkins; Eric,0,6,50,50
1683700555216,HUM 4,B02,202209,Watkins; Eric,0,5,50,50
1683700555216,HUM 4,B03,202210,Watkins; Eric,0,5,50,50
1683700556242,HUM 5,A01,185958,West; Geoffrey Scott,0,0,50,50
1683700556242,HUM 5,A02,202215,West; Geoffrey Scott,0,1,50,50
1683700557266,INTL 190,A00,185959,Gagnon; Jeffrey C,0,0,0,9
1683700557266,INTL 190,B00,185960,Lettieri; Michael Joseph,0,0,0,2
1683700558296,JAPN 180,A00,254509,Staff,5,0,30,25
1683700559321,LATI 10,A01,202853,Kennemore; Amy Michelle,4,0,35,31
1683700559321,LATI 10,A02,202854,Kennemore; Amy Michelle,3,0,35,32
1683700559321,LATI 10,A03,270054,Kennemore; Amy Michelle,30,0,30,0
1683700560346,LATI 180,A00,202855,Kennemore; Amy Michelle,11,0,20,9
1683700561370,LAWS 101,A00,201767,Golan; Tal,0,7,40,40
1683700562395,LIFR 1C,A00,185961,Staff,6,0,20,14
1683700563418,LIFR 1CX,A00,185962,Staff,7,0,20,13
1683700564444,LIFR 1D,A00,185963,Staff,7,0,20,13
1683700565469,LIFR 1DX,A00,185964,Staff,7,0,20,13
1683700566494,LIGN 101,A01,186039,Staff,43,0,50,7
1683700567522,LIGN 165,A00,186040,Staff,14,0,50,36
1683700568548,LTCS 108,A00,186041,Staff,5,0,10,5
1683700569573,LTCS 119,A00,186042,Staff,15,0,20,5
1683700570598,LTCS 130,A00,186043,Wesling; Megan E.,15,0,25,10
1683700572702,LTEA 138,A00,186119,Staff,14,0,40,26
1683700573726,LTEN 124,A00,186148,Staff,5,0,25,20
1683700574750,LTEN 178,A00,186149,Staff,6,0,15,9
1683700575777,LTEN 181,A00,186150,Blanco; John D,34,0,40,6
1683700576805,LTWL 120,A00,186160,Staff,19,0,25,6
1683700577832,LTWL 165,A00,186161,Staff,22,0,25,3
1683700578860,LTWR 100,A00,186162,Staff,0,5,15,15
1683700579888,LTWR 102,A00,186163,Doller; Ben,5,0,15,10
1683700580916,MAE 8,A01,186412,Staff,0,1,0,0
1683700581944,MAE 30B,A00,186445,Bahadori; Mohammad Yousef,81,0,100,19
1683700582969,MAE 40,A00,186592,Bewley; Thomas R,10,0,50,40
1683700583994,MAE 101B,A00,186593,Bahadori; Mohammad Yousef,80,0,100,20
1683700585020,MAE 105,A00,186594,Bandaru; Prabhakar,10,0,50,40
1683700586046,MAE 107,A00,186599,Pham; Hieu Tan,0,8,120,120
1683700587070,MAE 148,A01,186660,Silberman; Jack,3,0,16,13
1683700588098,MATH 10A,A01,188095,Staff,0,6,35,35
1683700589128,MATH 10B,A01,188097,Bowers; Adam R.,0,12,30,30
1683700589128,MATH 10B,A02,188099,Bowers; Adam R.,0,11,30,30
1683700589128,MATH 10B,B01,188104,Bowers; Adam R.,0,10,30,30
1683700589128,MATH 10B,B02,188106,Bowers; Adam R.,0,9,30,30
1683700590159,MATH 10C,A01,188111,Staff,0,20,30,30
1683700590159,MATH 10C,A02,188127,Staff,0,19,30,30
1683700590159,MATH 10C,A03,188131,Staff,0,19,30,30
1683700590159,MATH 10C,B01,188218,Staff,17,0,30,13
1683700590159,MATH 10C,B02,188244,Staff,13,0,30,17
1683700590159,MATH 10C,B03,188277,Staff,14,0,30,16
1683700591188,MATH 18,A01,188344,Bach; Quang Tran,18,0,30,12
1683700591188,MATH 18,A02,188345,Bach; Quang Tran,11,0,30,19
1683700591188,MATH 18,B01,188353,Bach; Quang Tran,11,0,30,19
1683700591188,MATH 18,B02,188354,Bach; Quang Tran,19,0,30,11
1683700592216,MATH 20A,A01,188374,Staff,11,0,35,24
1683700593247,MATH 20B,A01,188382,Ohm; Ko Woon,7,0,30,23
1683700593247,MATH 20B,A02,188383,Ohm; Ko Woon,22,0,30,8
1683700593247,MATH 20B,B01,188385,Ohm; Ko Woon,7,0,30,23
1683700593247,MATH 20B,B02,188392,Ohm; Ko Woon,22,0,30,8
1683700594273,MATH 20C,A01,188394,Harel; Guershon,10,0,30,20
1683700594273,MATH 20C,A02,188395,Harel; Guershon,13,0,30,17
1683700594273,MATH 20C,B01,188404,Harel; Guershon,5,0,30,25
1683700594273,MATH 20C,B02,188405,Harel; Guershon,18,0,30,12
1683700595298,MATH 20D,A01,188414,Hammock; Frances H,0,1,30,30
1683700595298,MATH 20D,A02,188415,Hammock; Frances H,0,1,30,30
1683700595298,MATH 20D,B01,188447,Hammock; Frances H,0,1,30,30
1683700595298,MATH 20D,B02,188486,Hammock; Frances H,2,0,30,28
1683700596325,MATH 20E,A01,188649,Staff,21,0,30,9
1683700596325,MATH 20E,A02,188650,Staff,20,0,30,10
1683700596325,MATH 20E,A03,188673,Staff,0,0,30,30
1683700597354,MATH 102,A01,188675,Staff,0,40,35,35
1683700598378,MATH 103B,A01,188681,Staff,3,0,35,32
1683700598378,MATH 103B,B01,188692,Staff,5,0,35,30
1683700599404,MATH 109,A01,188695,Salehi Golsefidy; Alireza,24,0,35,11
1683700599404,MATH 109,A02,188696,Salehi Golsefidy; Alireza,25,0,35,10
1683700600431,MATH 120A,A01,188698,Eggers; John Dietrich,7,0,35,28
1683700601459,MATH 142B,A01,188736,Ioana; Adrian,0,0,30,30
1683700601459,MATH 142B,A02,188741,Ioana; Adrian,0,1,30,30
1683700601459,MATH 142B,A03,188743,Ioana; Adrian,0,2,30,30
1683700602483,MATH 168A,A01,188790,Staff,0,11,35,35
1683700603511,MATH 170A,A01,188803,Nie; Jiawang,0,2,35,35
1683700603511,MATH 170A,A02,188811,Nie; Jiawang,0,1,35,35
1683700603511,MATH 170A,A03,188814,Nie; Jiawang,0,0,35,35
1683700603511,MATH 170A,A04,188815,Nie; Jiawang,5,0,35,30
1683700604535,MATH 193B,A01,188817,Staff,0,0,35,35
1683700604535,MATH 193B,A02,188818,Staff,6,0,35,29
1683700605564,MGT 4,A01,202857,Anderson; John Charles,59,0,80,21
1683700606589,MGT 12,A00,202858,Lindenberger; Wade Douglas,40,0,90,50
1683700607614,MGT 18,A00,202859,Staff,74,0,90,16
1683700608637,MGT 18GS,A00,202860,McKay; Michael J,13,0,28,15
1683700609661,MGT 45,A00,202861,Pecore; Joseph P.,8,0,90,82
1683700610685,MGT 100,A00,202863,Yavorsky; Daniel Ryan,27,0,90,63
1683700611709,MGT 103,A00,202864,Ehrich; Kristine R,0,19,90,90
1683700612733,MGT 112,A00,202865,Ehrich; Kristine R,15,0,90,75
1683700613761,MGT 121A,A00,202868,Staff,70,0,90,20
1683700614785,MGT 131B,A00,202869,Anderson; John Charles,58,0,90,32
1683700615813,MGT 136,A00,202871,Lindenberger; Wade Douglas,83,0,90,7
1683700616837,MGT 164,A00,202873,Staff,0,67,90,91
1683700617862,MGT 164GS,A00,202874,McKay; Mary A,13,0,28,15
1683700618886,MGT 180,A00,202875,Staff,0,51,90,91
1683700619914,MMW 11R,A01,205019,Herbst; Matthew,0,0,30,30
1683700619914,MMW 11R,A02,205026,Herbst; Matthew,29,0,30,1
1683700620938,MMW 15,A01,193512,Chang; Edmond Yi-Teh,0,8,28,28
1683700620938,MMW 15,A02,193513,Chang; Edmond Yi-Teh,0,5,28,28
1683700620938,MMW 15,A03,193514,Chang; Edmond Yi-Teh,0,5,28,28
1683700620938,MMW 15,A04,193515,Chang; Edmond Yi-Teh,0,5,28,28
1683700620938,MMW 15,A05,193516,Chang; Edmond Yi-Teh,0,5,28,28
1683700620938,MMW 15,A06,193517,Chang; Edmond Yi-Teh,0,6,28,28
1683700620938,MMW 15,B01,193519,Chang; Edmond Yi-Teh,0,5,28,28
1683700620938,MMW 15,B02,193520,Chang; Edmond Yi-Teh,0,5,28,28
1683700620938,MMW 15,B03,193521,Chang; Edmond Yi-Teh,0,5,28,28
1683700620938,MMW 15,B04,193522,Chang; Edmond Yi-Teh,0,6,28,28
1683700620938,MMW 15,B05,193523,Chang; Edmond Yi-Teh,0,5,28,28
1683700620938,MMW 15,B06,193524,Chang; Edmond Yi-Teh,0,5,28,28
1683700621967,MMW 122,A01,193526,Rahimi; Babak,0,16,28,28
1683700621967,MMW 122,A02,193527,Rahimi; Babak,0,15,28,28
1683700621967,MMW 122,A03,193528,Rahimi; Babak,0,0,0,0
1683700621967,MMW 122,A04,193529,Rahimi; Babak,0,0,0,0
1683700622993,MUS 1A,A01,186663,Staff,0,18,35,35
1683700624020,MUS 4,A01,186715,Staff,0,12,35,35
1683700625048,MUS 5R,A01,186796,Dubnov; Shlomo,0,17,35,35
1683700626072,MUS 6,A01,186798,Staff,0,4,25,25
1683700627100,MUS 7,A01,186830,Staff,11,0,35,24
1683700628123,MUS 8,A01,186930,Staff,0,27,35,35
1683700629149,MUS 15,A01,186932,Staff,0,15,35,35
1683700629149,MUS 15,B01,186934,Staff,0,16,35,35
1683700630177,MUS 80,A00,186935,Staff,0,0,20,20
1683700630177,MUS 80,B00,186936,Staff,24,0,25,1
1683700631202,NANO 11,A00,204702,Lipomi; Darren John,0,0,0,0
1683700632226,NANO 15,A01,204709,Yang; Kesong,0,1,0,0
1683700633250,NANO 114,A00,202069,Jahed Motlagh; Zeinab,2,0,10,8
1683700634274,PHIL 1,A00,186955,Grush; Rick Scott,31,0,40,9
1683700635299,PHIL 10,A01,186973,Grush; Rick Scott,27,0,35,8
1683700635299,PHIL 10,A02,186974,Grush; Rick Scott,33,0,35,2
1683700636321,PHIL 13,A01,186976,Staff,1,0,35,34
1683700636321,PHIL 13,A02,186977,Staff,16,0,35,19
1683700637347,PHIL 14,A01,186979,Staff,30,0,35,5
1683700637347,PHIL 14,A02,186986,Staff,32,0,35,3
1683700638372,PHIL 28,A01,186988,Staff,16,0,30,14
1683700638372,PHIL 28,A02,186989,Staff,1,0,30,29
1683700638372,PHIL 28,A03,186990,Staff,10,0,30,20
1683700638372,PHIL 28,A04,186991,Staff,26,0,30,4
1683700639394,PHIL 120,A00,186997,Staff,23,0,40,17
1683700640419,PHIL 137,A00,187003,Staff,7,0,40,33
1683700641446,PHIL 150,A00,187015,Staff,47,0,70,23
1683700642471,PHIL 167,A00,187021,Lamey; Andy M.,34,0,40,6
1683700643499,PHIL 174,A01,202226,Staff,17,0,20,3
1683700643499,PHIL 174,A02,202235,Staff,20,0,20,0
1683700644525,PHIL 191A,A00,258918,Staff,0,0,1,1
1683700645551,PHYS 1A,A00,187028,Staff,26,0,60,34
1683700646576,PHYS 1AL,001,187036,Staff,3,0,30,27
1683700646576,PHYS 1AL,002,187049,Staff,18,0,30,12
1683700647600,PHYS 1B,A00,187058,Staff,21,0,60,39
1683700648626,PHYS 1BL,001,187064,Staff,0,1,30,30
1683700648626,PHYS 1BL,002,187070,Staff,4,0,30,26
1683700649651,PHYS 1C,A00,187082,Staff,30,0,120,90
1683700650681,PHYS 1CL,001,187088,Staff,0,9,30,30
1683700650681,PHYS 1CL,002,187089,Staff,0,1,30,30
1683700650681,PHYS 1CL,009,262693,Staff,9,0,30,21
1683700651708,PHYS 2B,A01,187097,Staff,55,0,115,60
1683700652739,PHYS 2C,A01,187099,Staff,63,0,115,52
1683700653765,PHYS 2CL,A01,187101,Staff,5,0,28,23
1683700653765,PHYS 2CL,A02,187102,Staff,15,0,28,13
1683700654790,PHYS 2D,A01,187123,Shotwell; Brian,95,0,115,20
1683700655817,PHYS 4B,A01,187133,Grinstein; Benjamin,35,0,50,15
1683700656843,POLI 10,A00,188819,Staff,0,4,50,50
1683700657868,POLI 11,A00,188827,Staff,43,0,50,7
1683700658896,POLI 13R,A00,188828,Staff,0,1,20,20
1683700659926,POLI 27,A01,188830,Elgin; Samuel Zincke,0,2,70,70
1683700660951,POLI 30,A00,188832,Desposato; Scott,30,0,50,20
1683700661979,POLI 102F,A00,188834,Staff,1,0,40,39
1683700663003,POLI 104A,A00,188852,Staff,12,0,30,18
1683700664031,POLI 104I,A00,188853,Staff,0,8,20,20
1683700665056,POLI 110B,A00,188854,Wiens; David,6,0,20,14
1683700666080,POLI 112A,A00,188855,Wiens; David,3,0,30,27
1683700667103,POLI 117R,A00,188856,Forman; Fonna,0,12,20,20
1683700668130,POLI 118,A00,188857,Ingham; Sean,8,0,20,12
1683700669158,POLI 120G,A00,188858,Staff,8,0,30,22
1683700670189,POLI 131CR,A00,188863,Hoston; Germaine,20,0,50,30
1683700671214,POLI 133,A00,188864,Nellis; Gareth Hb,44,0,50,6
1683700672237,POLI 134D,A00,188865,Desposato; Scott,27,0,30,3
1683700673261,POLI 142A,A00,188871,Gartzke; Erik,21,0,50,29
1683700674290,POLI 142K,A00,188874,Staff,38,0,50,12
1683700675375,POLI 143,A00,188940,Gartzke; Erik,15,0,30,15
1683700676401,POLI 153,A00,188943,Staff,2,0,20,18
1683700677429,POLI 160AA,A00,188944,Staff,10,0,40,30
1683700678454,POLI 170A,A00,188945,Staff,10,0,30,20
1683700680502,PSYC 1,A00,188952,Staff,36,0,90,54
1683700681527,PSYC 2,B00,188953,Staff,19,0,35,16
1683700682555,PSYC 6,A00,188970,Staff,47,0,60,13
1683700683579,PSYC 7,A00,188973,Staff,35,0,45,10
1683700684605,PSYC 60,A01,188980,Rickard; Timothy C.,42,0,60,18
1683700685629,PSYC 70,A01,189001,Steiner; Eric Tomas,22,0,45,23
1683700686654,PSYC 100,A00,189005,Lacefield; Katharine I,0,98,120,120
1683700687679,PSYC 102,A00,189008,Staff,6,0,30,24
1683700688707,PSYC 106,B00,189026,Gorman; Michael R.,27,0,60,33
1683700689733,PSYC 114,B01,189033,Winkielman; Piotr,0,31,30,30
1683700690758,PSYC 131,A00,189036,Anagnostaras; Stephan,0,44,60,60
1683700691786,PSYC 136,A00,189041,Lowe; Angela Beth,0,7,25,25
1683700692811,PSYC 137,A00,189057,Winkielman; Piotr,0,36,25,25
1683700693836,PSYC 144,A00,189107,Wixted; John T,0,11,50,50
1683700695886,PSYC 162,A00,189142,Staff,0,9,85,85
1683700696911,PSYC 172,A00,189144,Gorman; Michael R.,0,6,30,30
1683700698961,PSYC 179,A00,189146,Lacefield; Katharine I,0,88,120,120
1683700699987,PSYC 181,A00,189147,Anagnostaras; Stephan,0,45,90,90
1683700701013,PSYC 190R,A00,189148,Barner; David A.,0,23,80,80
1683700702041,PSYC 191,A00,189275,Rickard; Timothy C.,0,11,25,25
1683700703068,PSYC 193,A00,189276,Chapman; Eddie Nathaniel,0,1,0,4
1683700704093,PSYC 193L,A01,189281,Lowe; Angela Beth,8,0,20,12
1683700704093,PSYC 193L,B01,189285,Staff,28,0,35,7
1683700705120,RELI 149,A00,187137,Rahimi; Babak,6,0,40,34
1683700706145,SE 9,A01,187315,Staff,0,2,18,18
1683700707170,SE 101B,A00,187409,Staff,24,0,30,6
1683700708194,SE 110B,A00,187444,Staff,10,0,40,30
1683700709226,SE 130B,A00,187449,Staff,31,0,40,9
1683700710251,SE 150A,A00,187516,Staff,8,0,20,12
1683700711276,SE 154,A00,187528,Staff,29,0,50,21
1683700712305,SIO 3,A01,258171,Staff,35,0,40,5
1683700713332,SIO 10,A00,187144,Cook; Geoffrey W,0,6,75,75
1683700714357,SIO 45,A00,187152,Cook; Geoffrey W,1,7,100,99
1683700715384,SIO 109R,A00,194486,Staff,0,4,20,20
1683700717436,SIO 187,A01,187233,Kacev; David,12,0,40,28
1683700718467,SOCI 1,A01,258656,Thorpe; Charles Robert,28,0,30,2
1683700718467,SOCI 1,A02,258658,Thorpe; Charles Robert,30,0,30,0
1683700718467,SOCI 1,A03,258661,Thorpe; Charles Robert,25,0,25,0
1683700718467,SOCI 1,A04,258666,Thorpe; Charles Robert,22,0,25,3
1683700718467,SOCI 1,A05,258897,Thorpe; Charles Robert,22,0,25,3
1683700718467,SOCI 1,A06,258898,Thorpe; Charles Robert,25,0,25,0
1683700719492,SOCI 30,A01,258903,Pardo Guerra; Juan Pablo,14,0,30,16
1683700720518,SOCI 102,A00,258904,Staff,9,0,25,16
1683700721543,SOCI 106,A00,258905,Staff,19,0,25,6
1683700722568,SOCI 111,A00,258907,Ribas Norris; Janet Vanesa,26,0,30,4
1683700723593,SOCI 121R,A00,258908,Pardo Guerra; Juan Pablo,7,0,30,23
1683700724617,SOCI 126,A01,203330,Staff,14,0,20,6
1683700725640,SOCI 131,A00,258909,Thorpe; Charles Robert,30,0,60,30
1683700726667,SOCI 135,A00,258910,Payne; Christine Anna,0,13,30,30
1683700727701,SOCI 157,A00,258911,Staff,10,0,30,20
1683700728725,SOCI 184,A00,258912,Staff,25,0,30,5
1683700729750,SOCI 188D,A00,258913,Staff,22,0,30,8
1683700730775,SYN 2,001,187529,Staff,9,0,16,7
1683700730775,SYN 2,002,201452,Staff,0,20,16,16
1683700730775,SYN 2,003,201469,Staff,1,0,16,15
1683700731800,SYN 100,A01,187531,Staff,0,9,20,20
1683700731800,SYN 100,B01,201491,Staff,0,10,20,20
1683700732824,TDAC 1,A00,189286,Walsh; Kim C.,3,0,20,17
1683700732824,TDAC 1,B00,189287,Harting; Carla Kelso,10,0,20,10
1683700733848,TDAC 101,A00,189300,Walsh; Kim C.,16,0,20,4
1683700733848,TDAC 101,B00,189301,Harting; Carla Kelso,18,0,20,2
1683700734873,TDAC 102,A00,189304,Basso; Beatrice,14,0,20,6
1683700735899,TDAC 108,A00,189305,Staff,18,0,20,2
1683700736928,TDDE 131,A00,189310,Staff,19,0,20,1
1683700736928,TDDE 131,B00,189314,Staff,19,0,20,1
1683700736928,TDDE 131,C00,189315,Staff,48,0,50,2
1683700736928,TDDE 131,D00,189316,Staff,14,0,15,1
1683700736928,TDDE 131,E00,204841,Staff,20,0,20,0
1683700737953,TDGE 10,A00,189289,Staff,27,0,50,23
1683700737953,TDGE 10,B00,189290,Havis; Allan,0,1,50,50
1683700738980,TDGE 11,A00,189291,Fulton; Julia,0,4,50,50
1683700738980,TDGE 11,B00,189292,Staff,20,0,25,5
1683700738980,TDGE 11,C00,260270,Staff,0,0,0,0
1683700740006,TDGE 25,A00,189294,Staff,1,0,20,19
1683700741031,TDGE 124,A00,189318,Fulton; Julia,0,7,50,50
1683700742060,TDGE 125,A00,189319,Staff,13,0,25,12
1683700742060,TDGE 125,B00,189320,Staff,23,0,25,2
1683700743084,TDGE 127,A00,189322,Havis; Allan,1,0,50,49
1683700744113,TDHT 101,A00,189323,Staff,18,0,25,7
1683700744113,TDHT 101,B00,189324,Staff,25,0,25,0
1683700745138,TDHT 102,A00,189325,Staff,49,0,50,1
1683700746162,TDMV 1,A00,189295,Arcidiacono; Kristin,20,0,30,10
1683700746162,TDMV 1,B00,189296,Caligagan; Maria T.,24,0,30,6
1683700747186,TDMV 2,A00,189297,Sammartano; Tonnie,27,0,30,3
1683700747186,TDMV 2,B00,189299,Arcidiacono; Kristin,23,0,30,7
1683700748210,TDMV 3,A00,204998,Rincon; Alicia,22,0,30,8
1683700749233,TDMV 120,A00,189458,Sammartano; Tonnie,28,0,30,2
1683700750256,TDMV 138,A00,189541,Jun; Grace Shin Hae,20,0,40,20
1683700751281,TDMV 142,A00,189717,Caligagan; Tony,25,0,30,5
1683700751281,TDMV 142,B00,189718,Caligagan; Maria T.,25,0,30,5
1683700752308,TMC 2,A01,187533,Staff,25,0,25,0
1683700752308,TMC 2,A02,187534,Staff,25,0,25,0
1683700753332,USP 1,A01,187536,Kwak; Nancy,0,16,25,25
1683700754355,USP 5,A01,187538,Staff,8,0,25,17
1683700755383,USP 101,A00,199253,Staff,0,4,0,0
1683700756407,USP 124,A00,187562,Boomhower; Matthew Charles,0,0,30,30
1683700757433,USP 138,A00,187582,Staff,19,0,25,6
1683700758460,USP 152,A01,187597,Staff,3,0,25,22
1683700759484,USP 153,A00,187598,Staff,18,0,25,7
1683700760508,USP 168,A00,187607,Kwak; Nancy,2,0,5,3
1683700761531,USP 173,A00,187619,Staff,4,0,25,21
1683700762555,USP 181,A00,187638,Staff,0,4,25,25
1683700763582,VIS 103,A00,187650,Cruz; Edwin Teddy,17,0,75,58
1683700764610,VIS 110D,A00,187669,Staff,13,0,22,9
1683700765637,VIS 127C,A00,187720,Shen; Kuiyi,67,0,146,79
1683700766664,VIS 149,A00,187731,Yoldas; Pinar,0,12,22,22
1683700767690,VIS 151,A01,188091,Staff,22,0,34,12
1683700767690,VIS 151,A02,188092,Staff,11,0,34,23
1683700768715,VIS 160B,A00,188093,Stalbaum; Brett,0,1,10,10
1683700770764,WCWP 10B,A00,201720,Staff,0,0,5,5
1683700770764,WCWP 10B,B00,201722,Staff,0,0,6,6
1683700771791,WCWP 100,A00,201725,Gagnon; Jeffrey C,0,0,2,2
1683700771791,WCWP 100,B00,201727,Staff,0,4,15,15
1683700774881,ANBI 133,A00,258401,Wilder; Linnea Lorene,34,0,40,6
1683700775908,ANBI 140,A00,258395,Hrvoj Mihic; Branka,18,0,25,7
1683700776935,ANSC 120,A00,258402,Bialecki; Jon Anthony,26,0,40,14
1683700777962,ANSC 144,A00,258400,Staff,12,0,40,28
1683700780067,ANSC 166,A00,258396,Parish; Steven Martin,156,0,175,19
1683700781091,ANSC 180,A00,193533,Staff,8,0,20,12
1683700782117,ANSC 188,A00,258397,Jassal; Aftab,34,0,40,6
1683700783141,ANTH 3,A01,258316,Staff,23,0,30,7
1683700784165,ANTH 5,A00,258394,Semendeferi; Ekaterini,16,0,20,4
1683700785189,ANTH 21,A01,258331,Staff,4,0,40,36
1683700786212,ANTH 103,A00,258398,Varma; Saiba,15,0,25,10
1683700787245,AWP 10,001,202034,Staff,0,0,0,0
1683700787245,AWP 10,002,202035,Staff,0,0,0,0
1683700787245,AWP 10,003,202036,Staff,0,0,0,0
1683700787245,AWP 10,004,202037,Staff,0,0,0,0
1683700787245,AWP 10,005,202038,Staff,0,0,0,0
1683700787245,AWP 10,006,202039,Staff,0,0,0,0
1683700787245,AWP 10,007,202040,Staff,0,0,0,0
1683700787245,AWP 10,008,202041,Staff,0,0,0,0
1683700787245,AWP 10,009,202042,Staff,0,0,0,0
1683700787245,AWP 10,010,202043,Staff,0,0,0,0
1683700787245,AWP 10,011,202044,Staff,0,0,0,0
1683700787245,AWP 10,012,202045,Staff,0,0,0,0
1683700787245,AWP 10,013,202046,Staff,0,0,0,0
1683700787245,AWP 10,014,202047,Staff,0,0,0,0
1683700787245,AWP 10,015,202048,Staff,0,0,0,0
1683700787245,AWP 10,016,202049,Staff,0,0,0,0
1683700787245,AWP 10,017,202050,Staff,0,0,0,0
1683700787245,AWP 10,018,202051,Staff,0,0,0,0
1683700787245,AWP 10,019,202052,Staff,0,0,0,0
1683700787245,AWP 10,020,202053,Staff,0,0,0,0
1683700787245,AWP 10,021,202054,Staff,0,0,0,0
1683700787245,AWP 10,022,202055,Staff,0,0,0,0
1683700787245,AWP 10,023,202056,Staff,0,0,0,0
1683700787245,AWP 10,024,202057,Staff,0,0,0,0
1683700787245,AWP 10,025,202058,Staff,0,0,0,0
1683700787245,AWP 10,026,202059,Staff,0,0,0,0
1683700788272,AWP 102,001,202032,Staff,0,0,0,0
1683700788272,AWP 102,002,202033,Staff,0,0,0,0
1683700789300,BENG 100,A01,254234,Taylor Amos; Alyssa C,31,0,40,9
1683700790328,BENG 196,001,270013,Engler; Adam J.,9999,0,9999,0
1683700791353,BICD 100R,A01,202018,Smith; Laurie,0,7,32,32
1683700791353,BICD 100R,A02,202019,Smith; Laurie,0,3,32,32
1683700791353,BICD 100R,A03,202020,Smith; Laurie,0,1,32,32
1683700791353,BICD 100R,A04,202021,Smith; Laurie,6,0,32,26
1683700791353,BICD 100R,A05,202022,Smith; Laurie,10,0,32,22
1683700792377,BICD 136,A01,193242,Gustafson-Brown; Cindy,0,2,32,32
1683700792377,BICD 136,A02,193244,Gustafson-Brown; Cindy,13,0,32,19
1683700793407,BIEB 102,A01,193249,Butler; Shannon Rhey,0,0,32,32
1683700793407,BIEB 102,A02,193251,Butler; Shannon Rhey,0,0,32,32
1683700793407,BIEB 102,A03,193253,Butler; Shannon Rhey,0,0,32,32
1683700793407,BIEB 102,A04,193255,Butler; Shannon Rhey,13,0,32,19
1683700793407,BIEB 102,A05,193265,Butler; Shannon Rhey,25,0,32,7
1683700793407,BIEB 102,A06,193269,Butler; Shannon Rhey,12,0,32,20
1683700795458,BIEB 150,A01,193274,Staff,0,0,32,32
1683700795458,BIEB 150,A02,193285,Staff,24,0,32,8
1683700796487,BIEB 194,A00,193286,Kurle; Carolyn M.,19,0,32,13
1683700797515,BILD 1,A01,192291,Staff,15,0,32,17
1683700797515,BILD 1,A02,192292,Staff,30,0,32,2
1683700797515,BILD 1,B01,192520,Reuther; Keefe,0,1,0,0
1683700797515,BILD 1,B02,192532,Reuther; Keefe,0,1,0,0
1683700798543,BILD 3,A01,192556,Butler; Shannon Rhey,0,0,32,32
1683700798543,BILD 3,A02,192581,Butler; Shannon Rhey,0,1,32,32
1683700798543,BILD 3,A03,192611,Butler; Shannon Rhey,19,0,32,13
1683700798543,BILD 3,A04,192612,Butler; Shannon Rhey,23,0,32,9
1683700798543,BILD 3,A05,192613,Butler; Shannon Rhey,26,0,32,6
1683700798543,BILD 3,A06,192679,Butler; Shannon Rhey,27,0,32,5
1683700798543,BILD 3,A07,192682,Butler; Shannon Rhey,20,0,32,12
1683700799571,BILD 4,A01,192836,Reuther; Keefe,1,0,24,23
1683700799571,BILD 4,A02,193044,Reuther; Keefe,4,0,24,20
1683700800597,BILD 10,A01,193142,Gustafson-Brown; Cindy,29,0,32,3
1683700800597,BILD 10,A02,193149,Gustafson-Brown; Cindy,31,0,32,1
1683700801625,BIMM 100,A01,193301,Staff,0,6,32,32
1683700801625,BIMM 100,A02,193312,Staff,0,7,32,32
1683700801625,BIMM 100,A03,193323,Staff,0,10,32,32
1683700802650,BIMM 101,A01,193329,McDonnell; Lisa Marie,0,3,24,24
1683700802650,BIMM 101,A02,193339,McDonnell; Lisa Marie,0,3,24,24
1683700802650,BIMM 101,B01,193354,McDonnell; Lisa Marie,0,4,24,24
1683700802650,BIMM 101,B02,193357,McDonnell; Lisa Marie,0,3,24,24
1683700803677,BIMM 110,A01,193377,Tat; John,0,11,32,32
1683700803677,BIMM 110,A02,193378,Tat; John,0,11,32,32
1683700804703,BIMM 120,A01,206116,Staff,0,0,32,32
1683700804703,BIMM 120,A02,206117,Staff,7,0,32,25
1683700804703,BIMM 120,A03,206121,Staff,21,0,32,11
1683700805731,BIPN 100,A01,193393,Park; Ji Young,0,15,32,32
1683700805731,BIPN 100,A02,193402,Park; Ji Young,0,14,32,32
1683700805731,BIPN 100,A03,193413,Park; Ji Young,0,14,32,32
1683700805731,BIPN 100,A04,193414,Park; Ji Young,0,13,32,32
1683700806761,BIPN 102,A01,193429,Staff,0,0,32,32
1683700806761,BIPN 102,A02,193438,Staff,18,0,32,14
1683700807788,BIPN 106,A01,193450,Reyes Gonzalez; Catalina,0,2,40,40
1683700808812,BIPN 134,A01,193465,Cooke; James Edward,0,0,32,32
1683700808812,BIPN 134,A02,193474,Cooke; James Edward,25,0,32,7
1683700808812,BIPN 134,A03,193485,Cooke; James Edward,29,0,32,3
1683700808812,BIPN 134,A04,193486,Cooke; James Edward,20,0,32,12
1683700808812,BIPN 134,A05,193491,Cooke; James Edward,31,0,32,1
1683700808812,BIPN 134,A06,193501,Cooke; James Edward,30,0,32,2
1683700808812,BIPN 134,A07,193510,Cooke; James Edward,29,0,32,3
1683700810870,BISP 194,A00,222522,Staff,14,0,32,18
1683700811902,CAT 124,A01,202407,Staff,19,0,25,6
1683700812929,CAT 125,A00,202408,Marchisotto; Jennifer Anne,2,0,20,18
1683700813953,CAT 125R,A00,202409,Smith; Lauryn Alissa,0,11,20,20
1683700813953,CAT 125R,B00,202410,Morales; Celeste Georgianna,0,11,20,20
1683700813953,CAT 125R,C00,202411,Irwin; Matthew Joseph,0,12,20,20
1683700814978,CENG 15,A01,204712,Yang; Kesong,0,1,0,0
1683700816005,CENG 114,A00,202070,Jahed Motlagh; Zeinab,5,0,20,15
1683700817029,CGS 105,A00,185477,Wesling; Megan E.,24,0,40,16
1683700818055,CGS 106,A00,185494,Staff,11,0,22,11
1683700819082,CGS 108,A00,185495,Staff,14,0,20,6
1683700820109,CGS 114,A00,185496,Staff,13,0,18,5
1683700821133,CGS 119,A00,185501,Staff,15,0,20,5
1683700822157,CGS 120,A00,185511,Staff,12,0,20,8
1683700823186,CHEM 4,A01,184675,Bussey; Thomas J,97,0,100,3
1683700824210,CHEM 6A,A01,184677,Staff,32,0,60,28
1683700825237,CHEM 6B,A01,184679,Staff,63,0,100,37
1683700826262,CHEM 6C,A01,184681,Bussey; Thomas J,0,0,50,50
1683700826262,CHEM 6C,A02,184682,Bussey; Thomas J,32,0,50,18
1683700827290,CHEM 40A,A01,184684,Albizati; Kim F.,33,0,100,67
1683700828316,CHEM 40B,A01,184686,Albizati; Kim F.,0,22,100,100
1683700829343,CHEM 41B,A01,184690,Staff,51,0,100,49
1683700830367,COGS 3,A01,184715,Boyle; Mary E. T.,0,27,40,40
1683700831390,COGS 14B,A01,185172,Staff,0,14,38,38
1683700832419,COGS 18,A01,184736,Staff,14,0,80,66
1683700833443,COGS 100,A01,184932,Staff,0,8,73,73
1683700834469,COGS 101A,A01,184935,Staff,0,40,30,30
1683700835494,COGS 101B,A01,184944,Staff,0,2,30,30
1683700836521,COGS 101C,A01,184946,Staff,0,10,30,30
1683700837548,COGS 102A,A01,184951,Johnson; Christine M.,1,0,40,39
1683700838572,COGS 107B,A01,184953,Mooshagian; Eric Frederick,0,52,40,40
1683700839599,COGS 118B,A01,184959,Gupta; Anjum,0,50,40,40
1683700840625,COGS 153,A00,184961,Staff,1,16,30,29
1683700841651,COGS 177,A00,184962,Staff,0,20,30,30
1683700842675,COGS 187A,A01,184969,Boyle; Mary E. T.,0,19,40,40
1683700843699,COMM 10,A01,185174,Staff,0,5,25,25
1683700843699,COMM 10,A02,185189,Staff,0,2,25,25
1683700843699,COMM 10,A03,269821,Staff,0,1,0,0
1683700844723,COMM 100B,A02,185476,Staff,10,0,25,15
1683700844723,COMM 100B,A03,277340,Staff,25,0,25,0
1683700845748,COMM 100C,A01,185314,Staff,2,0,25,23
1683700845748,COMM 100C,A02,185327,Staff,17,0,25,8
1683700846771,COMM 110M,A00,185349,Staff,0,0,40,40
1683700847795,COMM 113T,A00,185352,Staff,25,0,40,15
1683700848819,COMM 114I,A00,185353,Staff,31,0,40,9
1683700849843,COMM 131,A00,185354,Staff,17,0,30,13
1683700850871,CSE 8A,A50,185358,Cao; Yingjun,0,46,10,10
1683700851899,CSE 8B,A01,185362,Staff,0,48,50,50
1683700852922,CSE 11,A01,185416,Cao; Yingjun,0,91,10,10
1683700853946,CSE 20,A01,185445,Briones; Jor-el Thomas Caparas,3,0,25,22
1683700854970,CSE 21,A01,185447,Staff,9,0,50,41
1683700855995,CSE 101,A01,185451,Staff,0,13,50,50
1683700855995,CSE 101,B01,185453,Jones; Miles E,0,15,50,50
1683700858046,CSE 141,A01,185458,Eldon; John,16,0,100,84
1683700859070,CSE 141L,A01,185461,Eldon; John,8,0,100,92
1683700860094,CSE 142,A01,185463,Staff,34,0,60,26
1683700860094,CSE 142,B01,201355,Staff,0,7,60,60
1683700861119,CSE 142L,A01,185470,Staff,34,0,60,26
1683700861119,CSE 142L,B01,201417,Staff,0,6,60,60
1683700862147,CSE 190,A00,201433,Staff,32,0,49,17
1683700863172,DOC 1,A01,259136,Strom; Megan C.,7,0,15,8
1683700863172,DOC 1,A02,259137,Strom; Megan C.,14,0,15,1
1683700863172,DOC 1,A03,259138,Strom; Megan C.,14,0,15,1
1683700863172,DOC 1,A04,259139,Strom; Megan C.,14,0,15,1
1683700864217,DOC 100D,A00,259140,Pass; Natalye Joann,14,0,25,11
1683700865241,DSGN 1,A01,184749,Rill; Bryan,0,26,30,30
1683700866267,DSGN 100,A01,185168,Staff,0,2,25,25
1683700867294,ECE 5,A01,185626,Morris; Karcher William,0,12,0,0
1683700868318,ECE 101,A01,185628,Staff,14,0,70,56
1683700869343,ECE 107,A01,185635,Baghdadchi; Saharnaz,0,0,20,20
1683700869343,ECE 107,A02,185638,Baghdadchi; Saharnaz,1,0,20,19
1683700870373,ECE 148,A01,185647,Silberman; Jack,0,0,16,16
1683700871397,ECON 1,A01,185537,Crane; Meredith Helen,54,0,70,16
1683700872422,ECON 3,A01,185549,Crane; Meredith Helen,30,0,70,40
1683700873447,ECON 4,A01,203354,Anderson; John Charles,0,5,10,10
1683700874472,ECON 100A,A01,185574,Staff,0,5,40,40
1683700875497,ECON 100B,A01,185576,Staff,0,12,50,50
1683700876524,ECON 100C,A01,185589,Newhouse; Herbert S,30,0,70,40
1683700877555,ECON 105,A00,185608,Vespa; Emanuel Ignacio,19,0,35,16
1683700878580,ECON 109,A01,185610,Shishkin; Denis,9,0,35,26
1683700879607,ECON 110A,A01,185612,Staff,8,0,40,32
1683700880632,ECON 120A,A01,185615,Staff,19,0,40,21
1683700881659,ECON 120C,A01,185617,Sun; Yixiao,0,21,70,70
1683700882751,ECON 144,A00,203346,Squires; Dale E,2,0,35,33
1683700883785,ECON 171,A01,203349,Newhouse; Herbert S,0,1,35,35
1683700884810,ECON 173A,A01,185621,Toda; Alexis Akira,21,0,35,14
1683700885835,EDS 25,A01,202413,Staff,0,1,0,0
1683700885835,EDS 25,A02,202414,Staff,0,1,0,0
1683700885835,EDS 25,A03,202415,Staff,0,0,0,0
1683700885835,EDS 25,A04,202416,Staff,0,1,0,0
1683700885835,EDS 25,A05,202439,Staff,0,0,0,0
1683700885835,EDS 25,A06,202440,Staff,0,0,0,0
1683700885835,EDS 25,B01,202631,Staff,0,0,0,0
1683700885835,EDS 25,B02,202632,Staff,0,0,0,0
1683700885835,EDS 25,B03,202639,Staff,0,0,0,0
1683700885835,EDS 25,B04,202640,Staff,0,0,0,0
1683700885835,EDS 25,B05,202643,Staff,0,0,0,0
1683700885835,EDS 25,B06,202644,Staff,0,0,0,0
1683700886860,EDS 38,A01,202659,Black; Alison Michelle,25,0,25,0
1683700887886,EDS 115,A00,202652,Staff,18,0,30,12
1683700888911,EDS 125,A00,202649,Staff,13,0,30,17
1683700889936,EDS 126,A01,203332,Staff,30,0,30,0
1683700890961,EDS 139,A00,202838,Staff,16,0,25,9
1683700891986,EDS 146,A01,202655,Staff,14,0,25,11
1683700893011,ENG 15,A00,185667,Staff,0,1,0,0
1683700893011,ENG 15,B00,185672,Staff,0,0,0,0
1683700893011,ENG 15,C00,185675,Staff,0,0,0,0
1683700893011,ENG 15,D00,185682,Staff,0,0,0,0
1683700893011,ENG 15,E00,185684,Staff,0,0,0,0
1683700894035,ETHN 103,A00,185710,Staff,0,8,35,35
1683700895059,ETHN 103A,A00,199228,Man; Simeon S,0,0,9,9
1683700896084,ETHN 109,A00,185711,Staff,15,0,35,20
1683700897106,ETHN 142,A00,185726,Staff,0,4,30,30
1683700898129,ETHN 163J,A00,199229,Man; Simeon S,5,0,8,3
1683700899152,ETHN 168,A00,185727,Staff,7,0,10,3
1683700900176,ETHN 182,A00,185728,Staff,0,0,35,35
1683700901204,ETHN 183,A00,185737,Staff,9,0,18,9
1683700902228,GLBH 111,A01,209361,Burgos; Jose L.,0,0,0,0
1683700904280,HIEU 104,A00,185792,Staff,14,0,20,6
1683700905305,HIEU 115,A00,185800,Staff,0,0,20,20
1683700906329,HIEU 128,A00,185801,Staff,0,9,20,20
1683700907354,HIEU 147,A00,185802,Staff,15,0,20,5
1683700908378,HIEU 154,A00,185823,Staff,11,0,20,9
1683700909405,HILA 102,A00,185826,Staff,14,0,20,6
1683700910430,HILD 2C,A01,185778,Staff,0,13,20,20
1683700911455,HILD 7B,A01,185780,Kwak; Nancy,0,17,32,32
1683700911455,HILD 7B,A02,185781,Kwak; Nancy,0,18,32,32
1683700912481,HILD 30,A01,185791,Staff,12,0,20,8
1683700913504,HISC 119,A00,185830,Golan; Tal,0,10,20,20
1683700914528,HITO 156GS,A00,185831,Patterson; Patrick H.,0,0,0,23
1683700915558,HIUS 103,A00,185832,Man; Simeon S,0,4,20,20
1683700916586,HIUS 117,A00,185836,Kwak; Nancy,2,0,20,18
1683700917613,HIUS 125,A00,185840,Man; Simeon S,0,2,23,23
1683700918639,HIUS 149,A00,185845,Staff,1,0,20,19
1683700919668,HUM 3,A01,185882,Zavodny; Tatiana Sophia,0,8,50,50
1683700919668,HUM 3,B01,185899,Caldwell; Michael Alan,0,18,50,50
1683700920695,HUM 3GS,A00,185900,Patterson; Patrick H.,0,0,0,23
1683700921723,HUM 4,A01,185938,Zroka; Amy Liane,28,0,50,22
1683700921723,HUM 4,B01,185956,Watkins; Eric,0,6,50,50
1683700921723,HUM 4,B02,202209,Watkins; Eric,0,5,50,50
1683700921723,HUM 4,B03,202210,Watkins; Eric,0,5,50,50
1683700922747,HUM 5,A01,185958,West; Geoffrey Scott,0,0,50,50
1683700922747,HUM 5,A02,202215,West; Geoffrey Scott,0,1,50,50
1683700923777,INTL 190,A00,185959,Gagnon; Jeffrey C,0,0,0,9
1683700923777,INTL 190,B00,185960,Lettieri; Michael Joseph,0,0,0,2
1683700924807,JAPN 180,A00,254509,Staff,5,0,30,25
1683700925836,LATI 10,A01,202853,Kennemore; Amy Michelle,4,0,35,31
1683700925836,LATI 10,A02,202854,Kennemore; Amy Michelle,3,0,35,32
1683700925836,LATI 10,A03,270054,Kennemore; Amy Michelle,30,0,30,0
1683700926861,LATI 180,A00,202855,Kennemore; Amy Michelle,11,0,20,9
1683700927886,LAWS 101,A00,201767,Golan; Tal,0,7,40,40
1683700928915,LIFR 1C,A00,185961,Staff,6,0,20,14
1683700929942,LIFR 1CX,A00,185962,Staff,7,0,20,13
1683700930966,LIFR 1D,A00,185963,Staff,7,0,20,13
1683700931994,LIFR 1DX,A00,185964,Staff,7,0,20,13
1683700933019,LIGN 101,A01,186039,Staff,43,0,50,7
1683700934044,LIGN 165,A00,186040,Staff,14,0,50,36
1683700935069,LTCS 108,A00,186041,Staff,5,0,10,5
1683700936093,LTCS 119,A00,186042,Staff,15,0,20,5
1683700937120,LTCS 130,A00,186043,Wesling; Megan E.,15,0,25,10
1683700939171,LTEA 138,A00,186119,Staff,14,0,40,26
1683700940200,LTEN 124,A00,186148,Staff,5,0,25,20
1683700941225,LTEN 178,A00,186149,Staff,6,0,15,9
1683700942249,LTEN 181,A00,186150,Blanco; John D,34,0,40,6
1683700943278,LTWL 120,A00,186160,Staff,19,0,25,6
1683700944301,LTWL 165,A00,186161,Staff,22,0,25,3
1683700945324,LTWR 100,A00,186162,Staff,0,5,15,15
1683700946346,LTWR 102,A00,186163,Doller; Ben,5,0,15,10
1683700947375,MAE 8,A01,186412,Staff,0,1,0,0
1683700948402,MAE 30B,A00,186445,Bahadori; Mohammad Yousef,81,0,100,19
1683700949430,MAE 40,A00,186592,Bewley; Thomas R,10,0,50,40
1683700950457,MAE 101B,A00,186593,Bahadori; Mohammad Yousef,80,0,100,20
1683700951485,MAE 105,A00,186594,Bandaru; Prabhakar,10,0,50,40
1683700952509,MAE 107,A00,186599,Pham; Hieu Tan,0,8,120,120
1683700953533,MAE 148,A01,186660,Silberman; Jack,3,0,16,13
1683700954562,MATH 10A,A01,188095,Staff,0,6,35,35
1683700955591,MATH 10B,A01,188097,Bowers; Adam R.,0,12,30,30
1683700955591,MATH 10B,A02,188099,Bowers; Adam R.,0,11,30,30
1683700955591,MATH 10B,B01,188104,Bowers; Adam R.,0,10,30,30
1683700955591,MATH 10B,B02,188106,Bowers; Adam R.,0,9,30,30
1683700956617,MATH 10C,A01,188111,Staff,0,20,30,30
1683700956617,MATH 10C,A02,188127,Staff,0,19,30,30
1683700956617,MATH 10C,A03,188131,Staff,0,19,30,30
1683700956617,MATH 10C,B01,188218,Staff,17,0,30,13
1683700956617,MATH 10C,B02,188244,Staff,13,0,30,17
1683700956617,MATH 10C,B03,188277,Staff,14,0,30,16
1683700957643,MATH 18,A01,188344,Bach; Quang Tran,18,0,30,12
1683700957643,MATH 18,A02,188345,Bach; Quang Tran,11,0,30,19
1683700957643,MATH 18,B01,188353,Bach; Quang Tran,11,0,30,19
1683700957643,MATH 18,B02,188354,Bach; Quang Tran,19,0,30,11
1683700958673,MATH 20A,A01,188374,Staff,11,0,35,24
1683700959697,MATH 20B,A01,188382,Ohm; Ko Woon,7,0,30,23
1683700959697,MATH 20B,A02,188383,Ohm; Ko Woon,22,0,30,8
1683700959697,MATH 20B,B01,188385,Ohm; Ko Woon,7,0,30,23
1683700959697,MATH 20B,B02,188392,Ohm; Ko Woon,22,0,30,8
1683700960723,MATH 20C,A01,188394,Harel; Guershon,10,0,30,20
1683700960723,MATH 20C,A02,188395,Harel; Guershon,13,0,30,17
1683700960723,MATH 20C,B01,188404,Harel; Guershon,5,0,30,25
1683700960723,MATH 20C,B02,188405,Harel; Guershon,18,0,30,12
1683700961748,MATH 20D,A01,188414,Hammock; Frances H,0,1,30,30
1683700961748,MATH 20D,A02,188415,Hammock; Frances H,0,1,30,30
1683700961748,MATH 20D,B01,188447,Hammock; Frances H,0,1,30,30
1683700961748,MATH 20D,B02,188486,Hammock; Frances H,2,0,30,28
1683700962773,MATH 20E,A01,188649,Staff,21,0,30,9
1683700962773,MATH 20E,A02,188650,Staff,20,0,30,10
1683700962773,MATH 20E,A03,188673,Staff,0,0,30,30
1683700963798,MATH 102,A01,188675,Staff,0,40,35,35
1683700964823,MATH 103B,A01,188681,Staff,3,0,35,32
1683700964823,MATH 103B,B01,188692,Staff,5,0,35,30
1683700965848,MATH 109,A01,188695,Salehi Golsefidy; Alireza,24,0,35,11
1683700965848,MATH 109,A02,188696,Salehi Golsefidy; Alireza,25,0,35,10
1683700966877,MATH 120A,A01,188698,Eggers; John Dietrich,7,0,35,28
1683700967905,MATH 142B,A01,188736,Ioana; Adrian,0,0,30,30
1683700967905,MATH 142B,A02,188741,Ioana; Adrian,0,1,30,30
1683700967905,MATH 142B,A03,188743,Ioana; Adrian,0,2,30,30
1683700968933,MATH 168A,A01,188790,Staff,0,11,35,35
1683700969963,MATH 170A,A01,188803,Nie; Jiawang,0,2,35,35
1683700969963,MATH 170A,A02,188811,Nie; Jiawang,0,1,35,35
1683700969963,MATH 170A,A03,188814,Nie; Jiawang,0,0,35,35
1683700969963,MATH 170A,A04,188815,Nie; Jiawang,5,0,35,30
1683700970991,MATH 193B,A01,188817,Staff,0,0,35,35
1683700970991,MATH 193B,A02,188818,Staff,6,0,35,29
1683700972016,MGT 4,A01,202857,Anderson; John Charles,59,0,80,21
1683700973043,MGT 12,A00,202858,Lindenberger; Wade Douglas,40,0,90,50
1683700974070,MGT 18,A00,202859,Staff,74,0,90,16
1683700975097,MGT 18GS,A00,202860,McKay; Michael J,13,0,28,15
1683700976122,MGT 45,A00,202861,Pecore; Joseph P.,8,0,90,82
1683700977150,MGT 100,A00,202863,Yavorsky; Daniel Ryan,27,0,90,63
1683700978172,MGT 103,A00,202864,Ehrich; Kristine R,0,19,90,90
1683700979197,MGT 112,A00,202865,Ehrich; Kristine R,15,0,90,75
1683700980222,MGT 121A,A00,202868,Staff,70,0,90,20
1683700981246,MGT 131B,A00,202869,Anderson; John Charles,58,0,90,32
1683700982276,MGT 136,A00,202871,Lindenberger; Wade Douglas,83,0,90,7
1683700983303,MGT 164,A00,202873,Staff,0,67,90,91
1683700984328,MGT 164GS,A00,202874,McKay; Mary A,13,0,28,15
1683700985353,MGT 180,A00,202875,Staff,0,51,90,91
1683700986435,MMW 11R,A01,205019,Herbst; Matthew,0,0,30,30
1683700986435,MMW 11R,A02,205026,Herbst; Matthew,29,0,30,1
1683700987464,MMW 15,A01,193512,Chang; Edmond Yi-Teh,0,8,28,28
1683700987464,MMW 15,A02,193513,Chang; Edmond Yi-Teh,0,5,28,28
1683700987464,MMW 15,A03,193514,Chang; Edmond Yi-Teh,0,5,28,28
1683700987464,MMW 15,A04,193515,Chang; Edmond Yi-Teh,0,5,28,28
1683700987464,MMW 15,A05,193516,Chang; Edmond Yi-Teh,0,5,28,28
1683700987464,MMW 15,A06,193517,Chang; Edmond Yi-Teh,0,6,28,28
1683700987464,MMW 15,B01,193519,Chang; Edmond Yi-Teh,0,5,28,28
1683700987464,MMW 15,B02,193520,Chang; Edmond Yi-Teh,0,5,28,28
1683700987464,MMW 15,B03,193521,Chang; Edmond Yi-Teh,0,5,28,28
1683700987464,MMW 15,B04,193522,Chang; Edmond Yi-Teh,0,6,28,28
1683700987464,MMW 15,B05,193523,Chang; Edmond Yi-Teh,0,5,28,28
1683700987464,MMW 15,B06,193524,Chang; Edmond Yi-Teh,0,5,28,28
1683700988489,MMW 122,A01,193526,Rahimi; Babak,0,16,28,28
1683700988489,MMW 122,A02,193527,Rahimi; Babak,0,15,28,28
1683700988489,MMW 122,A03,193528,Rahimi; Babak,0,0,0,0
1683700988489,MMW 122,A04,193529,Rahimi; Babak,0,0,0,0
1683700989517,MUS 1A,A01,186663,Staff,0,18,35,35
1683700990546,MUS 4,A01,186715,Staff,0,12,35,35
1683700991572,MUS 5R,A01,186796,Dubnov; Shlomo,0,17,35,35
1683700992597,MUS 6,A01,186798,Staff,0,4,25,25
1683700993625,MUS 7,A01,186830,Staff,11,0,35,24
1683700994649,MUS 8,A01,186930,Staff,0,27,35,35
1683700995677,MUS 15,A01,186932,Staff,0,15,35,35
1683700995677,MUS 15,B01,186934,Staff,0,16,35,35
1683700996700,MUS 80,A00,186935,Staff,0,0,20,20
1683700996700,MUS 80,B00,186936,Staff,24,0,25,1
1683700997724,NANO 11,A00,204702,Lipomi; Darren John,0,0,0,0
1683700998754,NANO 15,A01,204709,Yang; Kesong,0,1,0,0
1683700999783,NANO 114,A00,202069,Jahed Motlagh; Zeinab,2,0,10,8
1683701000811,PHIL 1,A00,186955,Grush; Rick Scott,31,0,40,9
1683701001839,PHIL 10,A01,186973,Grush; Rick Scott,27,0,35,8
1683701001839,PHIL 10,A02,186974,Grush; Rick Scott,33,0,35,2
1683701002863,PHIL 13,A01,186976,Staff,1,0,35,34
1683701002863,PHIL 13,A02,186977,Staff,16,0,35,19
1683701003889,PHIL 14,A01,186979,Staff,30,0,35,5
1683701003889,PHIL 14,A02,186986,Staff,32,0,35,3
1683701004915,PHIL 28,A01,186988,Staff,16,0,30,14
1683701004915,PHIL 28,A02,186989,Staff,1,0,30,29
1683701004915,PHIL 28,A03,186990,Staff,10,0,30,20
1683701004915,PHIL 28,A04,186991,Staff,26,0,30,4
1683701005942,PHIL 120,A00,186997,Staff,23,0,40,17
1683701006965,PHIL 137,A00,187003,Staff,7,0,40,33
1683701007989,PHIL 150,A00,187015,Staff,47,0,70,23
1683701009016,PHIL 167,A00,187021,Lamey; Andy M.,34,0,40,6
1683701010044,PHIL 174,A01,202226,Staff,17,0,20,3
1683701010044,PHIL 174,A02,202235,Staff,20,0,20,0
1683701011070,PHIL 191A,A00,258918,Staff,0,0,1,1
1683701012097,PHYS 1A,A00,187028,Staff,26,0,60,34
1683701013121,PHYS 1AL,001,187036,Staff,3,0,30,27
1683701013121,PHYS 1AL,002,187049,Staff,18,0,30,12
1683701014144,PHYS 1B,A00,187058,Staff,21,0,60,39
1683701015169,PHYS 1BL,001,187064,Staff,0,1,30,30
1683701015169,PHYS 1BL,002,187070,Staff,4,0,30,26
1683701016193,PHYS 1C,A00,187082,Staff,30,0,120,90
1683701017218,PHYS 1CL,001,187088,Staff,0,9,30,30
1683701017218,PHYS 1CL,002,187089,Staff,0,1,30,30
1683701017218,PHYS 1CL,009,262693,Staff,9,0,30,21
1683701018243,PHYS 2B,A01,187097,Staff,55,0,115,60
1683701019267,PHYS 2C,A01,187099,Staff,63,0,115,52
1683701020291,PHYS 2CL,A01,187101,Staff,5,0,28,23
1683701020291,PHYS 2CL,A02,187102,Staff,15,0,28,13
1683701021317,PHYS 2D,A01,187123,Shotwell; Brian,95,0,115,20
1683701022342,PHYS 4B,A01,187133,Grinstein; Benjamin,35,0,50,15
1683701023371,POLI 10,A00,188819,Staff,0,4,50,50
1683701024396,POLI 11,A00,188827,Staff,43,0,50,7
1683701025426,POLI 13R,A00,188828,Staff,0,1,20,20
1683701026452,POLI 27,A01,188830,Elgin; Samuel Zincke,0,2,70,70
1683701027476,POLI 30,A00,188832,Desposato; Scott,30,0,50,20
1683701028503,POLI 102F,A00,188834,Staff,1,0,40,39
1683701029528,POLI 104A,A00,188852,Staff,12,0,30,18
1683701030551,POLI 104I,A00,188853,Staff,0,8,20,20
1683701031577,POLI 110B,A00,188854,Wiens; David,6,0,20,14
1683701032600,POLI 112A,A00,188855,Wiens; David,3,0,30,27
1683701033626,POLI 117R,A00,188856,Forman; Fonna,0,12,20,20
1683701034654,POLI 118,A00,188857,Ingham; Sean,8,0,20,12
1683701035683,POLI 120G,A00,188858,Staff,8,0,30,22
1683701036707,POLI 131CR,A00,188863,Hoston; Germaine,20,0,50,30
1683701037732,POLI 133,A00,188864,Nellis; Gareth Hb,44,0,50,6
1683701038758,POLI 134D,A00,188865,Desposato; Scott,27,0,30,3
1683701039783,POLI 142A,A00,188871,Gartzke; Erik,21,0,50,29
1683701040807,POLI 142K,A00,188874,Staff,38,0,50,12
1683701041831,POLI 143,A00,188940,Gartzke; Erik,15,0,30,15
1683701042858,POLI 153,A00,188943,Staff,2,0,20,18
1683701043884,POLI 160AA,A00,188944,Staff,10,0,40,30
1683701044910,POLI 170A,A00,188945,Staff,10,0,30,20
1683701046959,PSYC 1,A00,188952,Staff,36,0,90,54
1683701047982,PSYC 2,B00,188953,Staff,19,0,35,16
1683701049121,PSYC 6,A00,188970,Staff,47,0,60,13
1683701050156,PSYC 7,A00,188973,Staff,35,0,45,10
1683701051181,PSYC 60,A01,188980,Rickard; Timothy C.,42,0,60,18
1683701052207,PSYC 70,A01,189001,Steiner; Eric Tomas,22,0,45,23
1683701053232,PSYC 100,A00,189005,Lacefield; Katharine I,0,98,120,120
1683701054255,PSYC 102,A00,189008,Staff,6,0,30,24
1683701055280,PSYC 106,B00,189026,Gorman; Michael R.,27,0,60,33
1683701056304,PSYC 114,B01,189033,Winkielman; Piotr,0,31,30,30
1683701057332,PSYC 131,A00,189036,Anagnostaras; Stephan,0,44,60,60
1683701058357,PSYC 136,A00,189041,Lowe; Angela Beth,0,7,25,25
1683701059381,PSYC 137,A00,189057,Winkielman; Piotr,0,36,25,25
1683701060406,PSYC 144,A00,189107,Wixted; John T,0,11,50,50
1683701062452,PSYC 162,A00,189142,Staff,0,9,85,85
1683701063478,PSYC 172,A00,189144,Gorman; Michael R.,0,6,30,30
1683701065532,PSYC 179,A00,189146,Lacefield; Katharine I,0,88,120,120
1683701066561,PSYC 181,A00,189147,Anagnostaras; Stephan,0,45,90,90
1683701067589,PSYC 190R,A00,189148,Barner; David A.,0,23,80,80
1683701068612,PSYC 191,A00,189275,Rickard; Timothy C.,0,11,25,25
1683701069635,PSYC 193,A00,189276,Chapman; Eddie Nathaniel,0,1,0,4
1683701070660,PSYC 193L,A01,189281,Lowe; Angela Beth,8,0,20,12
1683701070660,PSYC 193L,B01,189285,Staff,28,0,35,7
1683701071685,RELI 149,A00,187137,Rahimi; Babak,6,0,40,34
1683701072711,SE 9,A01,187315,Staff,0,2,18,18
1683701073735,SE 101B,A00,187409,Staff,24,0,30,6
1683701074761,SE 110B,A00,187444,Staff,10,0,40,30
1683701075788,SE 130B,A00,187449,Staff,31,0,40,9
1683701076814,SE 150A,A00,187516,Staff,8,0,20,12
1683701077839,SE 154,A00,187528,Staff,29,0,50,21
1683701078863,SIO 3,A01,258171,Staff,35,0,40,5
1683701079890,SIO 10,A00,187144,Cook; Geoffrey W,0,6,75,75
1683701080917,SIO 45,A00,187152,Cook; Geoffrey W,1,7,100,99
1683701081941,SIO 109R,A00,194486,Staff,0,4,20,20
1683701083988,SIO 187,A01,187233,Kacev; David,12,0,40,28
1683701085016,SOCI 1,A01,258656,Thorpe; Charles Robert,28,0,30,2
1683701085016,SOCI 1,A02,258658,Thorpe; Charles Robert,30,0,30,0
1683701085016,SOCI 1,A03,258661,Thorpe; Charles Robert,25,0,25,0
1683701085016,SOCI 1,A04,258666,Thorpe; Charles Robert,22,0,25,3
1683701085016,SOCI 1,A05,258897,Thorpe; Charles Robert,22,0,25,3
1683701085016,SOCI 1,A06,258898,Thorpe; Charles Robert,25,0,25,0
1683701086042,SOCI 30,A01,258903,Pardo Guerra; Juan Pablo,14,0,30,16
1683701087066,SOCI 102,A00,258904,Staff,9,0,25,16
1683701088091,SOCI 106,A00,258905,Staff,19,0,25,6
1683701089115,SOCI 111,A00,258907,Ribas Norris; Janet Vanesa,26,0,30,4
1683701090198,SOCI 121R,A00,258908,Pardo Guerra; Juan Pablo,7,0,30,23
1683701091225,SOCI 126,A01,203330,Staff,14,0,20,6
1683701092251,SOCI 131,A00,258909,Thorpe; Charles Robert,30,0,60,30
1683701093278,SOCI 135,A00,258910,Payne; Christine Anna,0,13,30,30
1683701094307,SOCI 157,A00,258911,Staff,10,0,30,20
1683701095331,SOCI 184,A00,258912,Staff,25,0,30,5
1683701096359,SOCI 188D,A00,258913,Staff,22,0,30,8
1683701097388,SYN 2,001,187529,Staff,9,0,16,7
1683701097388,SYN 2,002,201452,Staff,0,20,16,16
1683701097388,SYN 2,003,201469,Staff,1,0,16,15
1683701098413,SYN 100,A01,187531,Staff,0,9,20,20
1683701098413,SYN 100,B01,201491,Staff,0,10,20,20
1683701099438,TDAC 1,A00,189286,Walsh; Kim C.,3,0,20,17
1683701099438,TDAC 1,B00,189287,Harting; Carla Kelso,10,0,20,10
1683701100461,TDAC 101,A00,189300,Walsh; Kim C.,16,0,20,4
1683701100461,TDAC 101,B00,189301,Harting; Carla Kelso,18,0,20,2
1683701101485,TDAC 102,A00,189304,Basso; Beatrice,14,0,20,6
1683701102508,TDAC 108,A00,189305,Staff,18,0,20,2
1683701103538,TDDE 131,A00,189310,Staff,19,0,20,1
1683701103538,TDDE 131,B00,189314,Staff,19,0,20,1
1683701103538,TDDE 131,C00,189315,Staff,48,0,50,2
1683701103538,TDDE 131,D00,189316,Staff,14,0,15,1
1683701103538,TDDE 131,E00,204841,Staff,20,0,20,0
1683701104561,TDGE 10,A00,189289,Staff,27,0,50,23
1683701104561,TDGE 10,B00,189290,Havis; Allan,0,1,50,50
1683701105586,TDGE 11,A00,189291,Fulton; Julia,0,4,50,50
1683701105586,TDGE 11,B00,189292,Staff,20,0,25,5
1683701105586,TDGE 11,C00,260270,Staff,0,0,0,0
1683701106611,TDGE 25,A00,189294,Staff,1,0,20,19
1683701107634,TDGE 124,A00,189318,Fulton; Julia,0,7,50,50
1683701108659,TDGE 125,A00,189319,Staff,13,0,25,12
1683701108659,TDGE 125,B00,189320,Staff,23,0,25,2
1683701109687,TDGE 127,A00,189322,Havis; Allan,1,0,50,49
1683701110711,TDHT 101,A00,189323,Staff,18,0,25,7
1683701110711,TDHT 101,B00,189324,Staff,25,0,25,0
1683701111736,TDHT 102,A00,189325,Staff,49,0,50,1
1683701112761,TDMV 1,A00,189295,Arcidiacono; Kristin,20,0,30,10
1683701112761,TDMV 1,B00,189296,Caligagan; Maria T.,24,0,30,6
1683701113786,TDMV 2,A00,189297,Sammartano; Tonnie,27,0,30,3
1683701113786,TDMV 2,B00,189299,Arcidiacono; Kristin,23,0,30,7
1683701114811,TDMV 3,A00,204998,Rincon; Alicia,22,0,30,8
1683701115836,TDMV 120,A00,189458,Sammartano; Tonnie,28,0,30,2
1683701116863,TDMV 138,A00,189541,Jun; Grace Shin Hae,20,0,40,20
1683701117888,TDMV 142,A00,189717,Caligagan; Tony,25,0,30,5
1683701117888,TDMV 142,B00,189718,Caligagan; Maria T.,25,0,30,5
1683701118911,TMC 2,A01,187533,Staff,25,0,25,0
1683701118911,TMC 2,A02,187534,Staff,25,0,25,0
1683701119935,USP 1,A01,187536,Kwak; Nancy,0,16,25,25
1683701120958,USP 5,A01,187538,Staff,8,0,25,17
1683701121983,USP 101,A00,199253,Staff,0,4,0,0
1683701123012,USP 124,A00,187562,Boomhower; Matthew Charles,0,0,30,30
1683701124036,USP 138,A00,187582,Staff,19,0,25,6
1683701125064,USP 152,A01,187597,Staff,3,0,25,22
1683701126089,USP 153,A00,187598,Staff,18,0,25,7
1683701127114,USP 168,A00,187607,Kwak; Nancy,2,0,5,3
1683701128141,USP 173,A00,187619,Staff,4,0,25,21
1683701129168,USP 181,A00,187638,Staff,0,4,25,25
1683701130199,VIS 103,A00,187650,Cruz; Edwin Teddy,17,0,75,58
1683701131223,VIS 110D,A00,187669,Staff,13,0,22,9
1683701132247,VIS 127C,A00,187720,Shen; Kuiyi,67,0,146,79
1683701133278,VIS 149,A00,187731,Yoldas; Pinar,0,12,22,22
1683701134309,VIS 151,A01,188091,Staff,22,0,34,12
1683701134309,VIS 151,A02,188092,Staff,11,0,34,23
1683701135333,VIS 160B,A00,188093,Stalbaum; Brett,0,1,10,10
1683701137383,WCWP 10B,A00,201720,Staff,0,0,5,5
1683701137383,WCWP 10B,B00,201722,Staff,0,0,6,6
1683701138408,WCWP 100,A00,201725,Gagnon; Jeffrey C,0,0,2,2
1683701138408,WCWP 100,B00,201727,Staff,0,4,15,15
1683701141536,ANBI 133,A00,258401,Wilder; Linnea Lorene,34,0,40,6
1683701142561,ANBI 140,A00,258395,Hrvoj Mihic; Branka,18,0,25,7
1683701143585,ANSC 120,A00,258402,Bialecki; Jon Anthony,26,0,40,14
1683701144610,ANSC 144,A00,258400,Staff,12,0,40,28
1683701146662,ANSC 166,A00,258396,Parish; Steven Martin,156,0,175,19
1683701147690,ANSC 180,A00,193533,Staff,8,0,20,12
1683701148715,ANSC 188,A00,258397,Jassal; Aftab,34,0,40,6
1683701149741,ANTH 3,A01,258316,Staff,23,0,30,7
1683701150769,ANTH 5,A00,258394,Semendeferi; Ekaterini,16,0,20,4
1683701151792,ANTH 21,A01,258331,Staff,4,0,40,36
1683701152820,ANTH 103,A00,258398,Varma; Saiba,15,0,25,10
1683701153847,AWP 10,001,202034,Staff,0,0,0,0
1683701153847,AWP 10,002,202035,Staff,0,0,0,0
1683701153847,AWP 10,003,202036,Staff,0,0,0,0
1683701153847,AWP 10,004,202037,Staff,0,0,0,0
1683701153847,AWP 10,005,202038,Staff,0,0,0,0
1683701153847,AWP 10,006,202039,Staff,0,0,0,0
1683701153847,AWP 10,007,202040,Staff,0,0,0,0
1683701153847,AWP 10,008,202041,Staff,0,0,0,0
1683701153847,AWP 10,009,202042,Staff,0,0,0,0
1683701153847,AWP 10,010,202043,Staff,0,0,0,0
1683701153847,AWP 10,011,202044,Staff,0,0,0,0
1683701153847,AWP 10,012,202045,Staff,0,0,0,0
1683701153847,AWP 10,013,202046,Staff,0,0,0,0
1683701153847,AWP 10,014,202047,Staff,0,0,0,0
1683701153847,AWP 10,015,202048,Staff,0,0,0,0
1683701153847,AWP 10,016,202049,Staff,0,0,0,0
1683701153847,AWP 10,017,202050,Staff,0,0,0,0
1683701153847,AWP 10,018,202051,Staff,0,0,0,0
1683701153847,AWP 10,019,202052,Staff,0,0,0,0
1683701153847,AWP 10,020,202053,Staff,0,0,0,0
1683701153847,AWP 10,021,202054,Staff,0,0,0,0
1683701153847,AWP 10,022,202055,Staff,0,0,0,0
1683701153847,AWP 10,023,202056,Staff,0,0,0,0
1683701153847,AWP 10,024,202057,Staff,0,0,0,0
1683701153847,AWP 10,025,202058,Staff,0,0,0,0
1683701153847,AWP 10,026,202059,Staff,0,0,0,0
1683701154871,AWP 102,001,202032,Staff,0,0,0,0
1683701154871,AWP 102,002,202033,Staff,0,0,0,0
1683701155896,BENG 100,A01,254234,Taylor Amos; Alyssa C,31,0,40,9
1683701156922,BENG 196,001,270013,Engler; Adam J.,9999,0,9999,0
1683701157948,BICD 100R,A01,202018,Smith; Laurie,0,7,32,32
1683701157948,BICD 100R,A02,202019,Smith; Laurie,0,3,32,32
1683701157948,BICD 100R,A03,202020,Smith; Laurie,0,1,32,32
1683701157948,BICD 100R,A04,202021,Smith; Laurie,6,0,32,26
1683701157948,BICD 100R,A05,202022,Smith; Laurie,10,0,32,22
1683701158974,BICD 136,A01,193242,Gustafson-Brown; Cindy,0,2,32,32
1683701158974,BICD 136,A02,193244,Gustafson-Brown; Cindy,13,0,32,19
1683701160002,BIEB 102,A01,193249,Butler; Shannon Rhey,0,0,32,32
1683701160002,BIEB 102,A02,193251,Butler; Shannon Rhey,0,0,32,32
1683701160002,BIEB 102,A03,193253,Butler; Shannon Rhey,0,0,32,32
1683701160002,BIEB 102,A04,193255,Butler; Shannon Rhey,13,0,32,19
1683701160002,BIEB 102,A05,193265,Butler; Shannon Rhey,25,0,32,7
1683701160002,BIEB 102,A06,193269,Butler; Shannon Rhey,12,0,32,20
1683701162054,BIEB 150,A01,193274,Staff,0,0,32,32
1683701162054,BIEB 150,A02,193285,Staff,24,0,32,8
1683701163078,BIEB 194,A00,193286,Kurle; Carolyn M.,19,0,32,13
1683701164110,BILD 1,A01,192291,Staff,15,0,32,17
1683701164110,BILD 1,A02,192292,Staff,30,0,32,2
1683701164110,BILD 1,B01,192520,Reuther; Keefe,0,1,0,0
1683701164110,BILD 1,B02,192532,Reuther; Keefe,0,1,0,0
1683701165139,BILD 3,A01,192556,Butler; Shannon Rhey,0,0,32,32
1683701165139,BILD 3,A02,192581,Butler; Shannon Rhey,0,1,32,32
1683701165139,BILD 3,A03,192611,Butler; Shannon Rhey,19,0,32,13
1683701165139,BILD 3,A04,192612,Butler; Shannon Rhey,23,0,32,9
1683701165139,BILD 3,A05,192613,Butler; Shannon Rhey,26,0,32,6
1683701165139,BILD 3,A06,192679,Butler; Shannon Rhey,27,0,32,5
1683701165139,BILD 3,A07,192682,Butler; Shannon Rhey,20,0,32,12
1683701166163,BILD 4,A01,192836,Reuther; Keefe,1,0,24,23
1683701166163,BILD 4,A02,193044,Reuther; Keefe,4,0,24,20
1683701167190,BILD 10,A01,193142,Gustafson-Brown; Cindy,29,0,32,3
1683701167190,BILD 10,A02,193149,Gustafson-Brown; Cindy,31,0,32,1
1683701168213,BIMM 100,A01,193301,Staff,0,6,32,32
1683701168213,BIMM 100,A02,193312,Staff,0,7,32,32
1683701168213,BIMM 100,A03,193323,Staff,0,10,32,32
1683701169239,BIMM 101,A01,193329,McDonnell; Lisa Marie,0,3,24,24
1683701169239,BIMM 101,A02,193339,McDonnell; Lisa Marie,0,3,24,24
1683701169239,BIMM 101,B01,193354,McDonnell; Lisa Marie,0,4,24,24
1683701169239,BIMM 101,B02,193357,McDonnell; Lisa Marie,0,3,24,24
1683701170263,BIMM 110,A01,193377,Tat; John,0,11,32,32
1683701170263,BIMM 110,A02,193378,Tat; John,0,11,32,32
1683701171288,BIMM 120,A01,206116,Staff,0,0,32,32
1683701171288,BIMM 120,A02,206117,Staff,7,0,32,25
1683701171288,BIMM 120,A03,206121,Staff,21,0,32,11
1683701172318,BIPN 100,A01,193393,Park; Ji Young,0,15,32,32
1683701172318,BIPN 100,A02,193402,Park; Ji Young,0,14,32,32
1683701172318,BIPN 100,A03,193413,Park; Ji Young,0,14,32,32
1683701172318,BIPN 100,A04,193414,Park; Ji Young,0,13,32,32
1683701173346,BIPN 102,A01,193429,Staff,0,0,32,32
1683701173346,BIPN 102,A02,193438,Staff,18,0,32,14
1683701174373,BIPN 106,A01,193450,Reyes Gonzalez; Catalina,0,2,40,40
1683701175401,BIPN 134,A01,193465,Cooke; James Edward,0,0,32,32
1683701175401,BIPN 134,A02,193474,Cooke; James Edward,25,0,32,7
1683701175401,BIPN 134,A03,193485,Cooke; James Edward,29,0,32,3
1683701175401,BIPN 134,A04,193486,Cooke; James Edward,20,0,32,12
1683701175401,BIPN 134,A05,193491,Cooke; James Edward,31,0,32,1
1683701175401,BIPN 134,A06,193501,Cooke; James Edward,30,0,32,2
1683701175401,BIPN 134,A07,193510,Cooke; James Edward,29,0,32,3
1683701177450,BISP 194,A00,222522,Staff,14,0,32,18
1683701178475,CAT 124,A01,202407,Staff,19,0,25,6
1683701179500,CAT 125,A00,202408,Marchisotto; Jennifer Anne,2,0,20,18
1683701180525,CAT 125R,A00,202409,Smith; Lauryn Alissa,0,11,20,20
1683701180525,CAT 125R,B00,202410,Morales; Celeste Georgianna,0,11,20,20
1683701180525,CAT 125R,C00,202411,Irwin; Matthew Joseph,0,12,20,20
1683701181550,CENG 15,A01,204712,Yang; Kesong,0,1,0,0
1683701182578,CENG 114,A00,202070,Jahed Motlagh; Zeinab,5,0,20,15
1683701183604,CGS 105,A00,185477,Wesling; Megan E.,24,0,40,16
1683701184627,CGS 106,A00,185494,Staff,11,0,22,11
1683701185650,CGS 108,A00,185495,Staff,14,0,20,6
1683701186674,CGS 114,A00,185496,Staff,13,0,18,5
1683701187699,CGS 119,A00,185501,Staff,15,0,20,5
1683701188724,CGS 120,A00,185511,Staff,12,0,20,8
1683701189757,CHEM 4,A01,184675,Bussey; Thomas J,97,0,100,3
1683701190783,CHEM 6A,A01,184677,Staff,32,0,60,28
1683701191807,CHEM 6B,A01,184679,Staff,63,0,100,37
1683701192832,CHEM 6C,A01,184681,Bussey; Thomas J,0,0,50,50
1683701192832,CHEM 6C,A02,184682,Bussey; Thomas J,32,0,50,18
1683701193912,CHEM 40A,A01,184684,Albizati; Kim F.,33,0,100,67
1683701194940,CHEM 40B,A01,184686,Albizati; Kim F.,0,22,100,100
1683701195965,CHEM 41B,A01,184690,Staff,51,0,100,49
1683701196993,COGS 3,A01,184715,Boyle; Mary E. T.,0,27,40,40
1683701198017,COGS 14B,A01,185172,Staff,0,14,38,38
1683701199044,COGS 18,A01,184736,Staff,14,0,80,66
1683701200071,COGS 100,A01,184932,Staff,0,8,73,73
1683701201095,COGS 101A,A01,184935,Staff,0,40,30,30
1683701202127,COGS 101B,A01,184944,Staff,0,2,30,30
1683701203151,COGS 101C,A01,184946,Staff,0,10,30,30
1683701204175,COGS 102A,A01,184951,Johnson; Christine M.,1,0,40,39
1683701205199,COGS 107B,A01,184953,Mooshagian; Eric Frederick,0,52,40,40
1683701206225,COGS 118B,A01,184959,Gupta; Anjum,0,50,40,40
1683701207253,COGS 153,A00,184961,Staff,1,16,30,29
1683701208277,COGS 177,A00,184962,Staff,0,20,30,30
1683701209301,COGS 187A,A01,184969,Boyle; Mary E. T.,0,19,40,40
1683701210326,COMM 10,A01,185174,Staff,0,5,25,25
1683701210326,COMM 10,A02,185189,Staff,0,2,25,25
1683701210326,COMM 10,A03,269821,Staff,0,1,0,0
1683701211350,COMM 100B,A02,185476,Staff,10,0,25,15
1683701211350,COMM 100B,A03,277340,Staff,25,0,25,0
1683701212377,COMM 100C,A01,185314,Staff,2,0,25,23
1683701212377,COMM 100C,A02,185327,Staff,17,0,25,8
1683701213404,COMM 110M,A00,185349,Staff,0,0,40,40
1683701214429,COMM 113T,A00,185352,Staff,25,0,40,15
1683701215455,COMM 114I,A00,185353,Staff,31,0,40,9
1683701216481,COMM 131,A00,185354,Staff,17,0,30,13
1683701217509,CSE 8A,A50,185358,Cao; Yingjun,0,46,10,10
1683701218533,CSE 8B,A01,185362,Staff,0,48,50,50
1683701219571,CSE 11,A01,185416,Cao; Yingjun,0,91,10,10
1683701220598,CSE 20,A01,185445,Briones; Jor-el Thomas Caparas,3,0,25,22
1683701221621,CSE 21,A01,185447,Staff,9,0,50,41
1683701222646,CSE 101,A01,185451,Staff,0,13,50,50
1683701222646,CSE 101,B01,185453,Jones; Miles E,0,15,50,50
1683701224695,CSE 141,A01,185458,Eldon; John,16,0,100,84
1683701225718,CSE 141L,A01,185461,Eldon; John,8,0,100,92
1683701226742,CSE 142,A01,185463,Staff,34,0,60,26
1683701226742,CSE 142,B01,201355,Staff,0,7,60,60
1683701227769,CSE 142L,A01,185470,Staff,34,0,60,26
1683701227769,CSE 142L,B01,201417,Staff,0,6,60,60
1683701228794,CSE 190,A00,201433,Staff,32,0,49,17
1683701229819,DOC 1,A01,259136,Strom; Megan C.,7,0,15,8
1683701229819,DOC 1,A02,259137,Strom; Megan C.,14,0,15,1
1683701229819,DOC 1,A03,259138,Strom; Megan C.,14,0,15,1
1683701229819,DOC 1,A04,259139,Strom; Megan C.,14,0,15,1
1683701230846,DOC 100D,A00,259140,Pass; Natalye Joann,14,0,25,11
1683701231872,DSGN 1,A01,184749,Rill; Bryan,0,26,30,30
1683701232897,DSGN 100,A01,185168,Staff,0,2,25,25
1683701233924,ECE 5,A01,185626,Morris; Karcher William,0,12,0,0
1683701234948,ECE 101,A01,185628,Staff,14,0,70,56
1683701235976,ECE 107,A01,185635,Baghdadchi; Saharnaz,0,0,20,20
1683701235976,ECE 107,A02,185638,Baghdadchi; Saharnaz,1,0,20,19
1683701237007,ECE 148,A01,185647,Silberman; Jack,0,0,16,16
1683701238030,ECON 1,A01,185537,Crane; Meredith Helen,54,0,70,16
1683701239055,ECON 3,A01,185549,Crane; Meredith Helen,30,0,70,40
1683701240080,ECON 4,A01,203354,Anderson; John Charles,0,5,10,10
1683701241102,ECON 100A,A01,185574,Staff,0,5,40,40
1683701242126,ECON 100B,A01,185576,Staff,0,12,50,50
1683701243150,ECON 100C,A01,185589,Newhouse; Herbert S,30,0,70,40
1683701244175,ECON 105,A00,185608,Vespa; Emanuel Ignacio,19,0,35,16
1683701245198,ECON 109,A01,185610,Shishkin; Denis,9,0,35,26
1683701246222,ECON 110A,A01,185612,Staff,8,0,40,32
1683701247246,ECON 120A,A01,185615,Staff,19,0,40,21
1683701248269,ECON 120C,A01,185617,Sun; Yixiao,0,21,70,70
1683701249294,ECON 144,A00,203346,Squires; Dale E,2,0,35,33
1683701250319,ECON 171,A01,203349,Newhouse; Herbert S,0,1,35,35
1683701251346,ECON 173A,A01,185621,Toda; Alexis Akira,21,0,35,14
1683701252372,EDS 25,A01,202413,Staff,0,1,0,0
1683701252372,EDS 25,A02,202414,Staff,0,1,0,0
1683701252372,EDS 25,A03,202415,Staff,0,0,0,0
1683701252372,EDS 25,A04,202416,Staff,0,1,0,0
1683701252372,EDS 25,A05,202439,Staff,0,0,0,0
1683701252372,EDS 25,A06,202440,Staff,0,0,0,0
1683701252372,EDS 25,B01,202631,Staff,0,0,0,0
1683701252372,EDS 25,B02,202632,Staff,0,0,0,0
1683701252372,EDS 25,B03,202639,Staff,0,0,0,0
1683701252372,EDS 25,B04,202640,Staff,0,0,0,0
1683701252372,EDS 25,B05,202643,Staff,0,0,0,0
1683701252372,EDS 25,B06,202644,Staff,0,0,0,0
1683701253399,EDS 38,A01,202659,Black; Alison Michelle,25,0,25,0
1683701254426,EDS 115,A00,202652,Staff,18,0,30,12
1683701255453,EDS 125,A00,202649,Staff,13,0,30,17
1683701256477,EDS 126,A01,203332,Staff,30,0,30,0
1683701257502,EDS 139,A00,202838,Staff,16,0,25,9
1683701258526,EDS 146,A01,202655,Staff,14,0,25,11
1683701259554,ENG 15,A00,185667,Staff,0,1,0,0
1683701259554,ENG 15,B00,185672,Staff,0,0,0,0
1683701259554,ENG 15,C00,185675,Staff,0,0,0,0
1683701259554,ENG 15,D00,185682,Staff,0,0,0,0
1683701259554,ENG 15,E00,185684,Staff,0,0,0,0
1683701260582,ETHN 103,A00,185710,Staff,0,8,35,35
1683701261606,ETHN 103A,A00,199228,Man; Simeon S,0,0,9,9
1683701262630,ETHN 109,A00,185711,Staff,15,0,35,20
1683701263657,ETHN 142,A00,185726,Staff,0,4,30,30
1683701264684,ETHN 163J,A00,199229,Man; Simeon S,5,0,8,3
1683701265708,ETHN 168,A00,185727,Staff,7,0,10,3
1683701266733,ETHN 182,A00,185728,Staff,0,0,35,35
1683701267756,ETHN 183,A00,185737,Staff,9,0,18,9
1683701268784,GLBH 111,A01,209361,Burgos; Jose L.,0,0,0,0
1683701270839,HIEU 104,A00,185792,Staff,14,0,20,6
1683701271865,HIEU 115,A00,185800,Staff,0,0,20,20
1683701272894,HIEU 128,A00,185801,Staff,0,9,20,20
1683701273919,HIEU 147,A00,185802,Staff,15,0,20,5
1683701274944,HIEU 154,A00,185823,Staff,11,0,20,9
1683701275969,HILA 102,A00,185826,Staff,14,0,20,6
1683701276993,HILD 2C,A01,185778,Staff,0,13,20,20
1683701278017,HILD 7B,A01,185780,Kwak; Nancy,0,17,32,32
1683701278017,HILD 7B,A02,185781,Kwak; Nancy,0,18,32,32
1683701279043,HILD 30,A01,185791,Staff,12,0,20,8
1683701280067,HISC 119,A00,185830,Golan; Tal,0,10,20,20
1683701281090,HITO 156GS,A00,185831,Patterson; Patrick H.,0,0,0,23
1683701282118,HIUS 103,A00,185832,Man; Simeon S,0,4,20,20
1683701283146,HIUS 117,A00,185836,Kwak; Nancy,2,0,20,18
1683701284171,HIUS 125,A00,185840,Man; Simeon S,0,2,23,23
1683701285199,HIUS 149,A00,185845,Staff,1,0,20,19
1683701286229,HUM 3,A01,185882,Zavodny; Tatiana Sophia,0,8,50,50
1683701286229,HUM 3,B01,185899,Caldwell; Michael Alan,0,18,50,50
1683701287251,HUM 3GS,A00,185900,Patterson; Patrick H.,0,0,0,23
1683701288281,HUM 4,A01,185938,Zroka; Amy Liane,28,0,50,22
1683701288281,HUM 4,B01,185956,Watkins; Eric,0,6,50,50
1683701288281,HUM 4,B02,202209,Watkins; Eric,0,5,50,50
1683701288281,HUM 4,B03,202210,Watkins; Eric,0,5,50,50
1683701289307,HUM 5,A01,185958,West; Geoffrey Scott,0,0,50,50
1683701289307,HUM 5,A02,202215,West; Geoffrey Scott,0,1,50,50
1683701290346,INTL 190,A00,185959,Gagnon; Jeffrey C,0,0,0,9
1683701290346,INTL 190,B00,185960,Lettieri; Michael Joseph,0,0,0,2
1683701291370,JAPN 180,A00,254509,Staff,5,0,30,25
1683701292395,LATI 10,A01,202853,Kennemore; Amy Michelle,4,0,35,31
1683701292395,LATI 10,A02,202854,Kennemore; Amy Michelle,3,0,35,32
1683701292395,LATI 10,A03,270054,Kennemore; Amy Michelle,30,0,30,0
1683701293422,LATI 180,A00,202855,Kennemore; Amy Michelle,11,0,20,9
1683701294447,LAWS 101,A00,201767,Golan; Tal,0,7,40,40
1683701295475,LIFR 1C,A00,185961,Staff,6,0,20,14
1683701296501,LIFR 1CX,A00,185962,Staff,7,0,20,13
1683701297583,LIFR 1D,A00,185963,Staff,7,0,20,13
1683701298611,LIFR 1DX,A00,185964,Staff,7,0,20,13
1683701299638,LIGN 101,A01,186039,Staff,43,0,50,7
1683701300665,LIGN 165,A00,186040,Staff,14,0,50,36
1683701301692,LTCS 108,A00,186041,Staff,5,0,10,5
1683701302717,LTCS 119,A00,186042,Staff,15,0,20,5
1683701303743,LTCS 130,A00,186043,Wesling; Megan E.,15,0,25,10
1683701305793,LTEA 138,A00,186119,Staff,14,0,40,26
1683701306820,LTEN 124,A00,186148,Staff,5,0,25,20
1683701307843,LTEN 178,A00,186149,Staff,6,0,15,9
1683701308867,LTEN 181,A00,186150,Blanco; John D,34,0,40,6
1683701309892,LTWL 120,A00,186160,Staff,19,0,25,6
1683701310920,LTWL 165,A00,186161,Staff,22,0,25,3
1683701311945,LTWR 100,A00,186162,Staff,0,5,15,15
1683701312972,LTWR 102,A00,186163,Doller; Ben,5,0,15,10
1683701314000,MAE 8,A01,186412,Staff,0,1,0,0
1683701315027,MAE 30B,A00,186445,Bahadori; Mohammad Yousef,81,0,100,19
1683701316054,MAE 40,A00,186592,Bewley; Thomas R,10,0,50,40
1683701317078,MAE 101B,A00,186593,Bahadori; Mohammad Yousef,80,0,100,20
1683701318105,MAE 105,A00,186594,Bandaru; Prabhakar,10,0,50,40
1683701319133,MAE 107,A00,186599,Pham; Hieu Tan,0,8,120,120
1683701320158,MAE 148,A01,186660,Silberman; Jack,3,0,16,13
1683701321183,MATH 10A,A01,188095,Staff,0,6,35,35
1683701322211,MATH 10B,A01,188097,Bowers; Adam R.,0,12,30,30
1683701322211,MATH 10B,A02,188099,Bowers; Adam R.,0,11,30,30
1683701322211,MATH 10B,B01,188104,Bowers; Adam R.,0,10,30,30
1683701322211,MATH 10B,B02,188106,Bowers; Adam R.,0,9,30,30
1683701323235,MATH 10C,A01,188111,Staff,0,20,30,30
1683701323235,MATH 10C,A02,188127,Staff,0,19,30,30
1683701323235,MATH 10C,A03,188131,Staff,0,19,30,30
1683701323235,MATH 10C,B01,188218,Staff,17,0,30,13
1683701323235,MATH 10C,B02,188244,Staff,13,0,30,17
1683701323235,MATH 10C,B03,188277,Staff,14,0,30,16
1683701324265,MATH 18,A01,188344,Bach; Quang Tran,18,0,30,12
1683701324265,MATH 18,A02,188345,Bach; Quang Tran,11,0,30,19
1683701324265,MATH 18,B01,188353,Bach; Quang Tran,11,0,30,19
1683701324265,MATH 18,B02,188354,Bach; Quang Tran,19,0,30,11
1683701325289,MATH 20A,A01,188374,Staff,11,0,35,24
1683701326314,MATH 20B,A01,188382,Ohm; Ko Woon,7,0,30,23
1683701326314,MATH 20B,A02,188383,Ohm; Ko Woon,22,0,30,8
1683701326314,MATH 20B,B01,188385,Ohm; Ko Woon,7,0,30,23
1683701326314,MATH 20B,B02,188392,Ohm; Ko Woon,22,0,30,8
1683701327339,MATH 20C,A01,188394,Harel; Guershon,10,0,30,20
1683701327339,MATH 20C,A02,188395,Harel; Guershon,13,0,30,17
1683701327339,MATH 20C,B01,188404,Harel; Guershon,5,0,30,25
1683701327339,MATH 20C,B02,188405,Harel; Guershon,18,0,30,12
1683701328364,MATH 20D,A01,188414,Hammock; Frances H,0,1,30,30
1683701328364,MATH 20D,A02,188415,Hammock; Frances H,0,1,30,30
1683701328364,MATH 20D,B01,188447,Hammock; Frances H,0,1,30,30
1683701328364,MATH 20D,B02,188486,Hammock; Frances H,2,0,30,28
1683701329392,MATH 20E,A01,188649,Staff,21,0,30,9
1683701329392,MATH 20E,A02,188650,Staff,20,0,30,10
1683701329392,MATH 20E,A03,188673,Staff,0,0,30,30
1683701330416,MATH 102,A01,188675,Staff,0,40,35,35
1683701331444,MATH 103B,A01,188681,Staff,3,0,35,32
1683701331444,MATH 103B,B01,188692,Staff,5,0,35,30
1683701332468,MATH 109,A01,188695,Salehi Golsefidy; Alireza,24,0,35,11
1683701332468,MATH 109,A02,188696,Salehi Golsefidy; Alireza,25,0,35,10
1683701333493,MATH 120A,A01,188698,Eggers; John Dietrich,7,0,35,28
1683701334521,MATH 142B,A01,188736,Ioana; Adrian,0,0,30,30
1683701334521,MATH 142B,A02,188741,Ioana; Adrian,0,1,30,30
1683701334521,MATH 142B,A03,188743,Ioana; Adrian,0,2,30,30
1683701335545,MATH 168A,A01,188790,Staff,0,11,35,35
1683701336575,MATH 170A,A01,188803,Nie; Jiawang,0,2,35,35
1683701336575,MATH 170A,A02,188811,Nie; Jiawang,0,1,35,35
1683701336575,MATH 170A,A03,188814,Nie; Jiawang,0,0,35,35
1683701336575,MATH 170A,A04,188815,Nie; Jiawang,5,0,35,30
1683701337599,MATH 193B,A01,188817,Staff,0,0,35,35
1683701337599,MATH 193B,A02,188818,Staff,6,0,35,29
1683701338628,MGT 4,A01,202857,Anderson; John Charles,59,0,80,21
1683701339660,MGT 12,A00,202858,Lindenberger; Wade Douglas,40,0,90,50
1683701340686,MGT 18,A00,202859,Staff,74,0,90,16
1683701341714,MGT 18GS,A00,202860,McKay; Michael J,13,0,28,15
1683701342739,MGT 45,A00,202861,Pecore; Joseph P.,8,0,90,82
1683701343764,MGT 100,A00,202863,Yavorsky; Daniel Ryan,27,0,90,63
1683701344787,MGT 103,A00,202864,Ehrich; Kristine R,0,19,90,90
1683701345811,MGT 112,A00,202865,Ehrich; Kristine R,15,0,90,75
1683701346835,MGT 121A,A00,202868,Staff,70,0,90,20
1683701347865,MGT 131B,A00,202869,Anderson; John Charles,58,0,90,32
1683701348892,MGT 136,A00,202871,Lindenberger; Wade Douglas,83,0,90,7
1683701349921,MGT 164,A00,202873,Staff,0,67,90,91
1683701350948,MGT 164GS,A00,202874,McKay; Mary A,13,0,28,15
1683701351971,MGT 180,A00,202875,Staff,0,51,90,91
1683701352998,MMW 11R,A01,205019,Herbst; Matthew,0,0,30,30
1683701352998,MMW 11R,A02,205026,Herbst; Matthew,29,0,30,1
1683701354028,MMW 15,A01,193512,Chang; Edmond Yi-Teh,0,8,28,28
1683701354028,MMW 15,A02,193513,Chang; Edmond Yi-Teh,0,5,28,28
1683701354028,MMW 15,A03,193514,Chang; Edmond Yi-Teh,0,5,28,28
1683701354028,MMW 15,A04,193515,Chang; Edmond Yi-Teh,0,5,28,28
1683701354028,MMW 15,A05,193516,Chang; Edmond Yi-Teh,0,5,28,28
1683701354028,MMW 15,A06,193517,Chang; Edmond Yi-Teh,0,6,28,28
1683701354028,MMW 15,B01,193519,Chang; Edmond Yi-Teh,0,5,28,28
1683701354028,MMW 15,B02,193520,Chang; Edmond Yi-Teh,0,5,28,28
1683701354028,MMW 15,B03,193521,Chang; Edmond Yi-Teh,0,5,28,28
1683701354028,MMW 15,B04,193522,Chang; Edmond Yi-Teh,0,6,28,28
1683701354028,MMW 15,B05,193523,Chang; Edmond Yi-Teh,0,5,28,28
1683701354028,MMW 15,B06,193524,Chang; Edmond Yi-Teh,0,5,28,28
1683701355056,MMW 122,A01,193526,Rahimi; Babak,0,16,28,28
1683701355056,MMW 122,A02,193527,Rahimi; Babak,0,15,28,28
1683701355056,MMW 122,A03,193528,Rahimi; Babak,0,0,0,0
1683701355056,MMW 122,A04,193529,Rahimi; Babak,0,0,0,0
1683701356079,MUS 1A,A01,186663,Staff,0,18,35,35
1683701357103,MUS 4,A01,186715,Staff,0,12,35,35
1683701358128,MUS 5R,A01,186796,Dubnov; Shlomo,0,17,35,35
1683701359153,MUS 6,A01,186798,Staff,0,4,25,25
1683701360177,MUS 7,A01,186830,Staff,11,0,35,24
1683701361205,MUS 8,A01,186930,Staff,0,27,35,35
1683701362227,MUS 15,A01,186932,Staff,0,15,35,35
1683701362227,MUS 15,B01,186934,Staff,0,16,35,35
1683701363253,MUS 80,A00,186935,Staff,0,0,20,20
1683701363253,MUS 80,B00,186936,Staff,24,0,25,1
1683701364282,NANO 11,A00,204702,Lipomi; Darren John,0,0,0,0
1683701365309,NANO 15,A01,204709,Yang; Kesong,0,1,0,0
1683701366336,NANO 114,A00,202069,Jahed Motlagh; Zeinab,2,0,10,8
1683701367360,PHIL 1,A00,186955,Grush; Rick Scott,31,0,40,9
1683701368383,PHIL 10,A01,186973,Grush; Rick Scott,27,0,35,8
1683701368383,PHIL 10,A02,186974,Grush; Rick Scott,33,0,35,2
1683701369408,PHIL 13,A01,186976,Staff,1,0,35,34
1683701369408,PHIL 13,A02,186977,Staff,16,0,35,19
1683701370431,PHIL 14,A01,186979,Staff,30,0,35,5
1683701370431,PHIL 14,A02,186986,Staff,32,0,35,3
1683701371458,PHIL 28,A01,186988,Staff,16,0,30,14
1683701371458,PHIL 28,A02,186989,Staff,1,0,30,29
1683701371458,PHIL 28,A03,186990,Staff,10,0,30,20
1683701371458,PHIL 28,A04,186991,Staff,26,0,30,4
1683701372483,PHIL 120,A00,186997,Staff,23,0,40,17
1683701373507,PHIL 137,A00,187003,Staff,7,0,40,33
1683701374532,PHIL 150,A00,187015,Staff,47,0,70,23
1683701375557,PHIL 167,A00,187021,Lamey; Andy M.,34,0,40,6
1683701376586,PHIL 174,A01,202226,Staff,17,0,20,3
1683701376586,PHIL 174,A02,202235,Staff,20,0,20,0
1683701377609,PHIL 191A,A00,258918,Staff,0,0,1,1
1683701378634,PHYS 1A,A00,187028,Staff,26,0,60,34
1683701379659,PHYS 1AL,001,187036,Staff,3,0,30,27
1683701379659,PHYS 1AL,002,187049,Staff,18,0,30,12
1683701380686,PHYS 1B,A00,187058,Staff,21,0,60,39
1683701381711,PHYS 1BL,001,187064,Staff,0,1,30,30
1683701381711,PHYS 1BL,002,187070,Staff,4,0,30,26
1683701382736,PHYS 1C,A00,187082,Staff,30,0,120,90
1683701383759,PHYS 1CL,001,187088,Staff,0,9,30,30
1683701383759,PHYS 1CL,002,187089,Staff,0,1,30,30
1683701383759,PHYS 1CL,009,262693,Staff,9,0,30,21
1683701384787,PHYS 2B,A01,187097,Staff,55,0,115,60
1683701385813,PHYS 2C,A01,187099,Staff,63,0,115,52
1683701386838,PHYS 2CL,A01,187101,Staff,5,0,28,23
1683701386838,PHYS 2CL,A02,187102,Staff,15,0,28,13
1683701387866,PHYS 2D,A01,187123,Shotwell; Brian,95,0,115,20
1683701388894,PHYS 4B,A01,187133,Grinstein; Benjamin,35,0,50,15
1683701389921,POLI 10,A00,188819,Staff,0,4,50,50
1683701390949,POLI 11,A00,188827,Staff,43,0,50,7
1683701391972,POLI 13R,A00,188828,Staff,0,1,20,20
1683701392997,POLI 27,A01,188830,Elgin; Samuel Zincke,0,2,70,70
1683701394024,POLI 30,A00,188832,Desposato; Scott,30,0,50,20
1683701395047,POLI 102F,A00,188834,Staff,1,0,40,39
1683701396070,POLI 104A,A00,188852,Staff,12,0,30,18
1683701397095,POLI 104I,A00,188853,Staff,0,8,20,20
1683701398119,POLI 110B,A00,188854,Wiens; David,6,0,20,14
1683701399143,POLI 112A,A00,188855,Wiens; David,3,0,30,27
1683701400167,POLI 117R,A00,188856,Forman; Fonna,0,12,20,20
1683701401248,POLI 118,A00,188857,Ingham; Sean,8,0,20,12
1683701402273,POLI 120G,A00,188858,Staff,8,0,30,22
1683701403298,POLI 131CR,A00,188863,Hoston; Germaine,20,0,50,30
1683701404329,POLI 133,A00,188864,Nellis; Gareth Hb,44,0,50,6
1683701405356,POLI 134D,A00,188865,Desposato; Scott,27,0,30,3
1683701406380,POLI 142A,A00,188871,Gartzke; Erik,21,0,50,29
1683701407403,POLI 142K,A00,188874,Staff,38,0,50,12
1683701408428,POLI 143,A00,188940,Gartzke; Erik,15,0,30,15
1683701409452,POLI 153,A00,188943,Staff,2,0,20,18
1683701410480,POLI 160AA,A00,188944,Staff,10,0,40,30
1683701411505,POLI 170A,A00,188945,Staff,10,0,30,20
1683701413559,PSYC 1,A00,188952,Staff,36,0,90,54
1683701414583,PSYC 2,B00,188953,Staff,19,0,35,16
1683701415610,PSYC 6,A00,188970,Staff,47,0,60,13
1683701416637,PSYC 7,A00,188973,Staff,35,0,45,10
1683701417666,PSYC 60,A01,188980,Rickard; Timothy C.,42,0,60,18
1683701418690,PSYC 70,A01,189001,Steiner; Eric Tomas,22,0,45,23
1683701419713,PSYC 100,A00,189005,Lacefield; Katharine I,0,98,120,120
1683701420741,PSYC 102,A00,189008,Staff,6,0,30,24
1683701421768,PSYC 106,B00,189026,Gorman; Michael R.,27,0,60,33
1683701422796,PSYC 114,B01,189033,Winkielman; Piotr,0,31,30,30
1683701423823,PSYC 131,A00,189036,Anagnostaras; Stephan,0,44,60,60
1683701424850,PSYC 136,A00,189041,Lowe; Angela Beth,0,7,25,25
1683701425874,PSYC 137,A00,189057,Winkielman; Piotr,0,36,25,25
1683701426899,PSYC 144,A00,189107,Wixted; John T,0,11,50,50
1683701428946,PSYC 162,A00,189142,Staff,0,9,85,85
1683701429970,PSYC 172,A00,189144,Gorman; Michael R.,0,6,30,30
1683701432020,PSYC 179,A00,189146,Lacefield; Katharine I,0,88,120,120
1683701433044,PSYC 181,A00,189147,Anagnostaras; Stephan,0,45,90,90
1683701434068,PSYC 190R,A00,189148,Barner; David A.,0,23,80,80
1683701435093,PSYC 191,A00,189275,Rickard; Timothy C.,0,11,25,25
1683701436117,PSYC 193,A00,189276,Chapman; Eddie Nathaniel,0,1,0,4
1683701437143,PSYC 193L,A01,189281,Lowe; Angela Beth,8,0,20,12
1683701437143,PSYC 193L,B01,189285,Staff,28,0,35,7
1683701438168,RELI 149,A00,187137,Rahimi; Babak,6,0,40,34
1683701439192,SE 9,A01,187315,Staff,0,2,18,18
1683701440218,SE 101B,A00,187409,Staff,24,0,30,6
1683701441246,SE 110B,A00,187444,Staff,10,0,40,30
1683701442276,SE 130B,A00,187449,Staff,31,0,40,9
1683701443302,SE 150A,A00,187516,Staff,8,0,20,12
1683701444329,SE 154,A00,187528,Staff,29,0,50,21
1683701445352,SIO 3,A01,258171,Staff,35,0,40,5
1683701446374,SIO 10,A00,187144,Cook; Geoffrey W,0,6,75,75
1683701447398,SIO 45,A00,187152,Cook; Geoffrey W,1,7,100,99
1683701448422,SIO 109R,A00,194486,Staff,0,4,20,20
1683701450472,SIO 187,A01,187233,Kacev; David,12,0,40,28
1683701451501,SOCI 1,A01,258656,Thorpe; Charles Robert,28,0,30,2
1683701451501,SOCI 1,A02,258658,Thorpe; Charles Robert,30,0,30,0
1683701451501,SOCI 1,A03,258661,Thorpe; Charles Robert,25,0,25,0
1683701451501,SOCI 1,A04,258666,Thorpe; Charles Robert,22,0,25,3
1683701451501,SOCI 1,A05,258897,Thorpe; Charles Robert,22,0,25,3
1683701451501,SOCI 1,A06,258898,Thorpe; Charles Robert,25,0,25,0
1683701452529,SOCI 30,A01,258903,Pardo Guerra; Juan Pablo,14,0,30,16
1683701453560,SOCI 102,A00,258904,Staff,9,0,25,16
1683701454585,SOCI 106,A00,258905,Staff,19,0,25,6
1683701455613,SOCI 111,A00,258907,Ribas Norris; Janet Vanesa,26,0,30,4
1683701456635,SOCI 121R,A00,258908,Pardo Guerra; Juan Pablo,7,0,30,23
1683701457659,SOCI 126,A01,203330,Staff,14,0,20,6
1683701458686,SOCI 131,A00,258909,Thorpe; Charles Robert,30,0,60,30
1683701459714,SOCI 135,A00,258910,Payne; Christine Anna,0,13,30,30
1683701460738,SOCI 157,A00,258911,Staff,10,0,30,20
1683701461798,SOCI 184,A00,258912,Staff,25,0,30,5
1683701462826,SOCI 188D,A00,258913,Staff,22,0,30,8
1683701463850,SYN 2,001,187529,Staff,9,0,16,7
1683701463850,SYN 2,002,201452,Staff,0,20,16,16
1683701463850,SYN 2,003,201469,Staff,1,0,16,15
1683701464873,SYN 100,A01,187531,Staff,0,9,20,20
1683701464873,SYN 100,B01,201491,Staff,0,10,20,20
1683701465901,TDAC 1,A00,189286,Walsh; Kim C.,3,0,20,17
1683701465901,TDAC 1,B00,189287,Harting; Carla Kelso,10,0,20,10
1683701466930,TDAC 101,A00,189300,Walsh; Kim C.,16,0,20,4
1683701466930,TDAC 101,B00,189301,Harting; Carla Kelso,18,0,20,2
1683701467955,TDAC 102,A00,189304,Basso; Beatrice,14,0,20,6
1683701468982,TDAC 108,A00,189305,Staff,18,0,20,2
1683701470014,TDDE 131,A00,189310,Staff,19,0,20,1
1683701470014,TDDE 131,B00,189314,Staff,19,0,20,1
1683701470014,TDDE 131,C00,189315,Staff,48,0,50,2
1683701470014,TDDE 131,D00,189316,Staff,14,0,15,1
1683701470014,TDDE 131,E00,204841,Staff,20,0,20,0
1683701471038,TDGE 10,A00,189289,Staff,27,0,50,23
1683701471038,TDGE 10,B00,189290,Havis; Allan,0,1,50,50
1683701472062,TDGE 11,A00,189291,Fulton; Julia,0,4,50,50
1683701472062,TDGE 11,B00,189292,Staff,20,0,25,5
1683701472062,TDGE 11,C00,260270,Staff,0,0,0,0
1683701473085,TDGE 25,A00,189294,Staff,1,0,20,19
1683701474111,TDGE 124,A00,189318,Fulton; Julia,0,7,50,50
1683701475136,TDGE 125,A00,189319,Staff,13,0,25,12
1683701475136,TDGE 125,B00,189320,Staff,23,0,25,2
1683701476158,TDGE 127,A00,189322,Havis; Allan,1,0,50,49
1683701477186,TDHT 101,A00,189323,Staff,18,0,25,7
1683701477186,TDHT 101,B00,189324,Staff,25,0,25,0
1683701478213,TDHT 102,A00,189325,Staff,49,0,50,1
1683701479240,TDMV 1,A00,189295,Arcidiacono; Kristin,20,0,30,10
1683701479240,TDMV 1,B00,189296,Caligagan; Maria T.,24,0,30,6
1683701480264,TDMV 2,A00,189297,Sammartano; Tonnie,27,0,30,3
1683701480264,TDMV 2,B00,189299,Arcidiacono; Kristin,23,0,30,7
1683701481289,TDMV 3,A00,204998,Rincon; Alicia,22,0,30,8
1683701482313,TDMV 120,A00,189458,Sammartano; Tonnie,28,0,30,2
1683701483337,TDMV 138,A00,189541,Jun; Grace Shin Hae,20,0,40,20
1683701484362,TDMV 142,A00,189717,Caligagan; Tony,25,0,30,5
1683701484362,TDMV 142,B00,189718,Caligagan; Maria T.,25,0,30,5
1683701485388,TMC 2,A01,187533,Staff,25,0,25,0
1683701485388,TMC 2,A02,187534,Staff,25,0,25,0
1683701486415,USP 1,A01,187536,Kwak; Nancy,0,16,25,25
1683701487439,USP 5,A01,187538,Staff,8,0,25,17
1683701488463,USP 101,A00,199253,Staff,0,4,0,0
1683701489489,USP 124,A00,187562,Boomhower; Matthew Charles,0,0,30,30
1683701490513,USP 138,A00,187582,Staff,19,0,25,6
1683701491537,USP 152,A01,187597,Staff,3,0,25,22
1683701492562,USP 153,A00,187598,Staff,18,0,25,7
1683701493586,USP 168,A00,187607,Kwak; Nancy,2,0,5,3
1683701494614,USP 173,A00,187619,Staff,4,0,25,21
1683701495641,USP 181,A00,187638,Staff,0,4,25,25
1683701496669,VIS 103,A00,187650,Cruz; Edwin Teddy,17,0,75,58
1683701497697,VIS 110D,A00,187669,Staff,13,0,22,9
1683701498721,VIS 127C,A00,187720,Shen; Kuiyi,67,0,146,79
1683701499750,VIS 149,A00,187731,Yoldas; Pinar,0,12,22,22
1683701500774,VIS 151,A01,188091,Staff,22,0,34,12
1683701500774,VIS 151,A02,188092,Staff,11,0,34,23
1683701501798,VIS 160B,A00,188093,Stalbaum; Brett,0,1,10,10
1683701503849,WCWP 10B,A00,201720,Staff,0,0,5,5
1683701503849,WCWP 10B,B00,201722,Staff,0,0,6,6
1683701504931,WCWP 100,A00,201725,Gagnon; Jeffrey C,0,0,2,2
1683701504931,WCWP 100,B00,201727,Staff,0,4,15,15
1683701508019,ANBI 133,A00,258401,Wilder; Linnea Lorene,34,0,40,6
1683701509046,ANBI 140,A00,258395,Hrvoj Mihic; Branka,18,0,25,7
1683701510071,ANSC 120,A00,258402,Bialecki; Jon Anthony,26,0,40,14
1683701511096,ANSC 144,A00,258400,Staff,12,0,40,28
1683701513143,ANSC 166,A00,258396,Parish; Steven Martin,156,0,175,19
1683701514185,ANSC 180,A00,193533,Staff,8,0,20,12
1683701515217,ANSC 188,A00,258397,Jassal; Aftab,34,0,40,6
1683701516246,ANTH 3,A01,258316,Staff,23,0,30,7
1683701517269,ANTH 5,A00,258394,Semendeferi; Ekaterini,16,0,20,4
1683701518292,ANTH 21,A01,258331,Staff,4,0,40,36
1683701519321,ANTH 103,A00,258398,Varma; Saiba,15,0,25,10
1683701520360,AWP 10,001,202034,Staff,0,0,0,0
1683701520360,AWP 10,002,202035,Staff,0,0,0,0
1683701520360,AWP 10,003,202036,Staff,0,0,0,0
1683701520360,AWP 10,004,202037,Staff,0,0,0,0
1683701520360,AWP 10,005,202038,Staff,0,0,0,0
1683701520360,AWP 10,006,202039,Staff,0,0,0,0
1683701520360,AWP 10,007,202040,Staff,0,0,0,0
1683701520360,AWP 10,008,202041,Staff,0,0,0,0
1683701520360,AWP 10,009,202042,Staff,0,0,0,0
1683701520360,AWP 10,010,202043,Staff,0,0,0,0
1683701520360,AWP 10,011,202044,Staff,0,0,0,0
1683701520360,AWP 10,012,202045,Staff,0,0,0,0
1683701520360,AWP 10,013,202046,Staff,0,0,0,0
1683701520360,AWP 10,014,202047,Staff,0,0,0,0
1683701520360,AWP 10,015,202048,Staff,0,0,0,0
1683701520360,AWP 10,016,202049,Staff,0,0,0,0
1683701520360,AWP 10,017,202050,Staff,0,0,0,0
1683701520360,AWP 10,018,202051,Staff,0,0,0,0
1683701520360,AWP 10,019,202052,Staff,0,0,0,0
1683701520360,AWP 10,020,202053,Staff,0,0,0,0
1683701520360,AWP 10,021,202054,Staff,0,0,0,0
1683701520360,AWP 10,022,202055,Staff,0,0,0,0
1683701520360,AWP 10,023,202056,Staff,0,0,0,0
1683701520360,AWP 10,024,202057,Staff,0,0,0,0
1683701520360,AWP 10,025,202058,Staff,0,0,0,0
1683701520360,AWP 10,026,202059,Staff,0,0,0,0
1683701521384,AWP 102,001,202032,Staff,0,0,0,0
1683701521384,AWP 102,002,202033,Staff,0,0,0,0
1683701522409,BENG 100,A01,254234,Taylor Amos; Alyssa C,31,0,40,9
1683701523445,BENG 196,001,270013,Engler; Adam J.,9999,0,9999,0
1683701524476,BICD 100R,A01,202018,Smith; Laurie,0,7,32,32
1683701524476,BICD 100R,A02,202019,Smith; Laurie,0,3,32,32
1683701524476,BICD 100R,A03,202020,Smith; Laurie,0,1,32,32
1683701524476,BICD 100R,A04,202021,Smith; Laurie,6,0,32,26
1683701524476,BICD 100R,A05,202022,Smith; Laurie,10,0,32,22
1683701525515,BICD 136,A01,193242,Gustafson-Brown; Cindy,0,2,32,32
1683701525515,BICD 136,A02,193244,Gustafson-Brown; Cindy,13,0,32,19
1683701526544,BIEB 102,A01,193249,Butler; Shannon Rhey,0,0,32,32
1683701526544,BIEB 102,A02,193251,Butler; Shannon Rhey,0,0,32,32
1683701526544,BIEB 102,A03,193253,Butler; Shannon Rhey,0,0,32,32
1683701526544,BIEB 102,A04,193255,Butler; Shannon Rhey,13,0,32,19
1683701526544,BIEB 102,A05,193265,Butler; Shannon Rhey,25,0,32,7
1683701526544,BIEB 102,A06,193269,Butler; Shannon Rhey,12,0,32,20
1683701528593,BIEB 150,A01,193274,Staff,0,0,32,32
1683701528593,BIEB 150,A02,193285,Staff,24,0,32,8
1683701529619,BIEB 194,A00,193286,Kurle; Carolyn M.,19,0,32,13
1683701530646,BILD 1,A01,192291,Staff,15,0,32,17
1683701530646,BILD 1,A02,192292,Staff,30,0,32,2
1683701530646,BILD 1,B01,192520,Reuther; Keefe,0,1,0,0
1683701530646,BILD 1,B02,192532,Reuther; Keefe,0,1,0,0
1683701531685,BILD 3,A01,192556,Butler; Shannon Rhey,0,0,32,32
1683701531685,BILD 3,A02,192581,Butler; Shannon Rhey,0,1,32,32
1683701531685,BILD 3,A03,192611,Butler; Shannon Rhey,19,0,32,13
1683701531685,BILD 3,A04,192612,Butler; Shannon Rhey,23,0,32,9
1683701531685,BILD 3,A05,192613,Butler; Shannon Rhey,26,0,32,6
1683701531685,BILD 3,A06,192679,Butler; Shannon Rhey,27,0,32,5
1683701531685,BILD 3,A07,192682,Butler; Shannon Rhey,20,0,32,12
1683701532712,BILD 4,A01,192836,Reuther; Keefe,1,0,24,23
1683701532712,BILD 4,A02,193044,Reuther; Keefe,4,0,24,20
1683701533740,BILD 10,A01,193142,Gustafson-Brown; Cindy,29,0,32,3
1683701533740,BILD 10,A02,193149,Gustafson-Brown; Cindy,31,0,32,1
1683701534771,BIMM 100,A01,193301,Staff,0,6,32,32
1683701534771,BIMM 100,A02,193312,Staff,0,7,32,32
1683701534771,BIMM 100,A03,193323,Staff,0,10,32,32
1683701535811,BIMM 101,A01,193329,McDonnell; Lisa Marie,0,3,24,24
1683701535811,BIMM 101,A02,193339,McDonnell; Lisa Marie,0,3,24,24
1683701535811,BIMM 101,B01,193354,McDonnell; Lisa Marie,0,4,24,24
1683701535811,BIMM 101,B02,193357,McDonnell; Lisa Marie,0,3,24,24
1683701536837,BIMM 110,A01,193377,Tat; John,0,11,32,32
1683701536837,BIMM 110,A02,193378,Tat; John,0,11,32,32
1683701537863,BIMM 120,A01,206116,Staff,0,0,32,32
1683701537863,BIMM 120,A02,206117,Staff,7,0,32,25
1683701537863,BIMM 120,A03,206121,Staff,21,0,32,11
1683701538887,BIPN 100,A01,193393,Park; Ji Young,0,15,32,32
1683701538887,BIPN 100,A02,193402,Park; Ji Young,0,14,32,32
1683701538887,BIPN 100,A03,193413,Park; Ji Young,0,14,32,32
1683701538887,BIPN 100,A04,193414,Park; Ji Young,0,13,32,32
1683701539917,BIPN 102,A01,193429,Staff,0,0,32,32
1683701539917,BIPN 102,A02,193438,Staff,18,0,32,14
1683701540941,BIPN 106,A01,193450,Reyes Gonzalez; Catalina,0,2,40,40
1683701541967,BIPN 134,A01,193465,Cooke; James Edward,0,0,32,32
1683701541967,BIPN 134,A02,193474,Cooke; James Edward,25,0,32,7
1683701541967,BIPN 134,A03,193485,Cooke; James Edward,29,0,32,3
1683701541967,BIPN 134,A04,193486,Cooke; James Edward,20,0,32,12
1683701541967,BIPN 134,A05,193491,Cooke; James Edward,31,0,32,1
1683701541967,BIPN 134,A06,193501,Cooke; James Edward,30,0,32,2
1683701541967,BIPN 134,A07,193510,Cooke; James Edward,29,0,32,3
1683701544021,BISP 194,A00,222522,Staff,14,0,32,18
1683701545049,CAT 124,A01,202407,Staff,19,0,25,6
1683701546074,CAT 125,A00,202408,Marchisotto; Jennifer Anne,2,0,20,18
1683701547103,CAT 125R,A00,202409,Smith; Lauryn Alissa,0,11,20,20
1683701547103,CAT 125R,B00,202410,Morales; Celeste Georgianna,0,11,20,20
1683701547103,CAT 125R,C00,202411,Irwin; Matthew Joseph,0,12,20,20
1683701548127,CENG 15,A01,204712,Yang; Kesong,0,1,0,0
1683701549153,CENG 114,A00,202070,Jahed Motlagh; Zeinab,5,0,20,15
1683701550178,CGS 105,A00,185477,Wesling; Megan E.,24,0,40,16
1683701551209,CGS 106,A00,185494,Staff,11,0,22,11
1683701552232,CGS 108,A00,185495,Staff,14,0,20,6
1683701553259,CGS 114,A00,185496,Staff,13,0,18,5
1683701554284,CGS 119,A00,185501,Staff,15,0,20,5
1683701555309,CGS 120,A00,185511,Staff,12,0,20,8
1683701556339,CHEM 4,A01,184675,Bussey; Thomas J,97,0,100,3
1683701557365,CHEM 6A,A01,184677,Staff,32,0,60,28
1683701558393,CHEM 6B,A01,184679,Staff,63,0,100,37
1683701559419,CHEM 6C,A01,184681,Bussey; Thomas J,0,0,50,50
1683701559419,CHEM 6C,A02,184682,Bussey; Thomas J,32,0,50,18
1683701560444,CHEM 40A,A01,184684,Albizati; Kim F.,33,0,100,67
1683701561471,CHEM 40B,A01,184686,Albizati; Kim F.,0,22,100,100
1683701562496,CHEM 41B,A01,184690,Staff,51,0,100,49
1683701563520,COGS 3,A01,184715,Boyle; Mary E. T.,0,27,40,40
1683701564545,COGS 14B,A01,185172,Staff,0,14,38,38
1683701565572,COGS 18,A01,184736,Staff,14,0,80,66
1683701566596,COGS 100,A01,184932,Staff,0,8,73,73
1683701567621,COGS 101A,A01,184935,Staff,0,40,30,30
1683701568649,COGS 101B,A01,184944,Staff,0,2,30,30
1683701569673,COGS 101C,A01,184946,Staff,0,10,30,30
1683701570701,COGS 102A,A01,184951,Johnson; Christine M.,1,0,40,39
1683701571728,COGS 107B,A01,184953,Mooshagian; Eric Frederick,0,52,40,40
1683701572754,COGS 118B,A01,184959,Gupta; Anjum,0,50,40,40
1683701573779,COGS 153,A00,184961,Staff,1,16,30,29
1683701574805,COGS 177,A00,184962,Staff,0,20,30,30
1683701575850,COGS 187A,A01,184969,Boyle; Mary E. T.,0,19,40,40
1683701576879,COMM 10,A01,185174,Staff,0,5,25,25
1683701576879,COMM 10,A02,185189,Staff,0,2,25,25
1683701576879,COMM 10,A03,269821,Staff,0,1,0,0
1683701577907,COMM 100B,A02,185476,Staff,10,0,25,15
1683701577907,COMM 100B,A03,277340,Staff,25,0,25,0
1683701578935,COMM 100C,A01,185314,Staff,2,0,25,23
1683701578935,COMM 100C,A02,185327,Staff,17,0,25,8
1683701579959,COMM 110M,A00,185349,Staff,0,0,40,40
1683701580989,COMM 113T,A00,185352,Staff,25,0,40,15
1683701582015,COMM 114I,A00,185353,Staff,31,0,40,9
1683701583042,COMM 131,A00,185354,Staff,17,0,30,13
1683701584071,CSE 8A,A50,185358,Cao; Yingjun,0,46,10,10
1683701585100,CSE 8B,A01,185362,Staff,0,48,50,50
1683701586126,CSE 11,A01,185416,Cao; Yingjun,0,91,10,10
1683701587150,CSE 20,A01,185445,Briones; Jor-el Thomas Caparas,3,0,25,22
1683701588180,CSE 21,A01,185447,Staff,9,0,50,41
1683701589208,CSE 101,A01,185451,Staff,0,13,50,50
1683701589208,CSE 101,B01,185453,Jones; Miles E,0,15,50,50
1683701591258,CSE 141,A01,185458,Eldon; John,16,0,100,84
1683701592282,CSE 141L,A01,185461,Eldon; John,8,0,100,92
1683701593310,CSE 142,A01,185463,Staff,34,0,60,26
1683701593310,CSE 142,B01,201355,Staff,0,7,60,60
1683701594335,CSE 142L,A01,185470,Staff,34,0,60,26
1683701594335,CSE 142L,B01,201417,Staff,0,6,60,60
1683701595360,CSE 190,A00,201433,Staff,32,0,49,17
1683701596386,DOC 1,A01,259136,Strom; Megan C.,7,0,15,8
1683701596386,DOC 1,A02,259137,Strom; Megan C.,14,0,15,1
1683701596386,DOC 1,A03,259138,Strom; Megan C.,14,0,15,1
1683701596386,DOC 1,A04,259139,Strom; Megan C.,14,0,15,1
1683701597414,DOC 100D,A00,259140,Pass; Natalye Joann,14,0,25,11
1683701598439,DSGN 1,A01,184749,Rill; Bryan,0,26,30,30
1683701599464,DSGN 100,A01,185168,Staff,0,2,25,25
1683701600489,ECE 5,A01,185626,Morris; Karcher William,0,12,0,0
1683701601518,ECE 101,A01,185628,Staff,14,0,70,56
1683701602545,ECE 107,A01,185635,Baghdadchi; Saharnaz,0,0,20,20
1683701602545,ECE 107,A02,185638,Baghdadchi; Saharnaz,1,0,20,19
1683701603571,ECE 148,A01,185647,Silberman; Jack,0,0,16,16
1683701604600,ECON 1,A01,185537,Crane; Meredith Helen,54,0,70,16
1683701605627,ECON 3,A01,185549,Crane; Meredith Helen,30,0,70,40
1683701606656,ECON 4,A01,203354,Anderson; John Charles,0,5,10,10
1683701607684,ECON 100A,A01,185574,Staff,0,5,40,40
1683701608766,ECON 100B,A01,185576,Staff,0,12,50,50
1683701609791,ECON 100C,A01,185589,Newhouse; Herbert S,30,0,70,40
1683701610833,ECON 105,A00,185608,Vespa; Emanuel Ignacio,19,0,35,16
1683701611861,ECON 109,A01,185610,Shishkin; Denis,9,0,35,26
1683701612886,ECON 110A,A01,185612,Staff,8,0,40,32
1683701613911,ECON 120A,A01,185615,Staff,19,0,40,21
1683701614939,ECON 120C,A01,185617,Sun; Yixiao,0,21,70,70
1683701615969,ECON 144,A00,203346,Squires; Dale E,2,0,35,33
1683701616997,ECON 171,A01,203349,Newhouse; Herbert S,0,1,35,35
1683701618021,ECON 173A,A01,185621,Toda; Alexis Akira,21,0,35,14
1683701619047,EDS 25,A01,202413,Staff,0,1,0,0
1683701619047,EDS 25,A02,202414,Staff,0,1,0,0
1683701619047,EDS 25,A03,202415,Staff,0,0,0,0
1683701619047,EDS 25,A04,202416,Staff,0,1,0,0
1683701619047,EDS 25,A05,202439,Staff,0,0,0,0
1683701619047,EDS 25,A06,202440,Staff,0,0,0,0
1683701619047,EDS 25,B01,202631,Staff,0,0,0,0
1683701619047,EDS 25,B02,202632,Staff,0,0,0,0
1683701619047,EDS 25,B03,202639,Staff,0,0,0,0
1683701619047,EDS 25,B04,202640,Staff,0,0,0,0
1683701619047,EDS 25,B05,202643,Staff,0,0,0,0
1683701619047,EDS 25,B06,202644,Staff,0,0,0,0
1683701620074,EDS 38,A01,202659,Black; Alison Michelle,25,0,25,0
1683701621098,EDS 115,A00,202652,Staff,18,0,30,12
1683701622122,EDS 125,A00,202649,Staff,13,0,30,17
1683701623146,EDS 126,A01,203332,Staff,30,0,30,0
1683701624171,EDS 139,A00,202838,Staff,16,0,25,9
1683701625200,EDS 146,A01,202655,Staff,14,0,25,11
1683701626230,ENG 15,A00,185667,Staff,0,1,0,0
1683701626230,ENG 15,B00,185672,Staff,0,0,0,0
1683701626230,ENG 15,C00,185675,Staff,0,0,0,0
1683701626230,ENG 15,D00,185682,Staff,0,0,0,0
1683701626230,ENG 15,E00,185684,Staff,0,0,0,0
1683701627257,ETHN 103,A00,185710,Staff,0,8,35,35
1683701628284,ETHN 103A,A00,199228,Man; Simeon S,0,0,9,9
1683701629309,ETHN 109,A00,185711,Staff,15,0,35,20
1683701630333,ETHN 142,A00,185726,Staff,0,4,30,30
1683701631359,ETHN 163J,A00,199229,Man; Simeon S,5,0,8,3
1683701632383,ETHN 168,A00,185727,Staff,7,0,10,3
1683701633407,ETHN 182,A00,185728,Staff,0,0,35,35
1683701634435,ETHN 183,A00,185737,Staff,9,0,18,9
1683701635463,GLBH 111,A01,209361,Burgos; Jose L.,0,0,0,0
1683701637510,HIEU 104,A00,185792,Staff,14,0,20,6
1683701638536,HIEU 115,A00,185800,Staff,0,0,20,20
1683701639560,HIEU 128,A00,185801,Staff,0,9,20,20
1683701640585,HIEU 147,A00,185802,Staff,15,0,20,5
1683701641609,HIEU 154,A00,185823,Staff,11,0,20,9
1683701642636,HILA 102,A00,185826,Staff,14,0,20,6
1683701643663,HILD 2C,A01,185778,Staff,0,13,20,20
1683701644687,HILD 7B,A01,185780,Kwak; Nancy,0,17,32,32
1683701644687,HILD 7B,A02,185781,Kwak; Nancy,0,18,32,32
1683701645715,HILD 30,A01,185791,Staff,12,0,20,8
1683701646739,HISC 119,A00,185830,Golan; Tal,0,10,20,20
1683701647763,HITO 156GS,A00,185831,Patterson; Patrick H.,0,0,0,23
1683701648788,HIUS 103,A00,185832,Man; Simeon S,0,4,20,20
1683701649815,HIUS 117,A00,185836,Kwak; Nancy,2,0,20,18
1683701650842,HIUS 125,A00,185840,Man; Simeon S,0,2,23,23
1683701651867,HIUS 149,A00,185845,Staff,1,0,20,19
1683701652891,HUM 3,A01,185882,Zavodny; Tatiana Sophia,0,8,50,50
1683701652891,HUM 3,B01,185899,Caldwell; Michael Alan,0,18,50,50
1683701653914,HUM 3GS,A00,185900,Patterson; Patrick H.,0,0,0,23
1683701654943,HUM 4,A01,185938,Zroka; Amy Liane,28,0,50,22
1683701654943,HUM 4,B01,185956,Watkins; Eric,0,6,50,50
1683701654943,HUM 4,B02,202209,Watkins; Eric,0,5,50,50
1683701654943,HUM 4,B03,202210,Watkins; Eric,0,5,50,50
1683701655967,HUM 5,A01,185958,West; Geoffrey Scott,0,0,50,50
1683701655967,HUM 5,A02,202215,West; Geoffrey Scott,0,1,50,50
1683701656993,INTL 190,A00,185959,Gagnon; Jeffrey C,0,0,0,9
1683701656993,INTL 190,B00,185960,Lettieri; Michael Joseph,0,0,0,2
1683701658020,JAPN 180,A00,254509,Staff,5,0,30,25
1683701659048,LATI 10,A01,202853,Kennemore; Amy Michelle,4,0,35,31
1683701659048,LATI 10,A02,202854,Kennemore; Amy Michelle,3,0,35,32
1683701659048,LATI 10,A03,270054,Kennemore; Amy Michelle,30,0,30,0
1683701660073,LATI 180,A00,202855,Kennemore; Amy Michelle,11,0,20,9
1683701661101,LAWS 101,A00,201767,Golan; Tal,0,7,40,40
1683701662128,LIFR 1C,A00,185961,Staff,6,0,20,14
1683701663152,LIFR 1CX,A00,185962,Staff,7,0,20,13
1683701664178,LIFR 1D,A00,185963,Staff,7,0,20,13
1683701665203,LIFR 1DX,A00,185964,Staff,7,0,20,13
1683701666229,LIGN 101,A01,186039,Staff,43,0,50,7
1683701667256,LIGN 165,A00,186040,Staff,14,0,50,36
1683701668278,LTCS 108,A00,186041,Staff,5,0,10,5
1683701669305,LTCS 119,A00,186042,Staff,15,0,20,5
1683701670336,LTCS 130,A00,186043,Wesling; Megan E.,15,0,25,10
1683701672387,LTEA 138,A00,186119,Staff,14,0,40,26
1683701673414,LTEN 124,A00,186148,Staff,5,0,25,20
1683701674440,LTEN 178,A00,186149,Staff,6,0,15,9
1683701675466,LTEN 181,A00,186150,Blanco; John D,34,0,40,6
1683701676493,LTWL 120,A00,186160,Staff,19,0,25,6
1683701677521,LTWL 165,A00,186161,Staff,22,0,25,3
1683701678545,LTWR 100,A00,186162,Staff,0,5,15,15
1683701679569,LTWR 102,A00,186163,Doller; Ben,5,0,15,10
1683701680594,MAE 8,A01,186412,Staff,0,1,0,0
1683701681621,MAE 30B,A00,186445,Bahadori; Mohammad Yousef,81,0,100,19
1683701682644,MAE 40,A00,186592,Bewley; Thomas R,10,0,50,40
1683701683673,MAE 101B,A00,186593,Bahadori; Mohammad Yousef,80,0,100,20
1683701684699,MAE 105,A00,186594,Bandaru; Prabhakar,10,0,50,40
1683701685726,MAE 107,A00,186599,Pham; Hieu Tan,0,8,120,120
1683701686753,MAE 148,A01,186660,Silberman; Jack,3,0,16,13
1683701687780,MATH 10A,A01,188095,Staff,0,6,35,35
1683701688806,MATH 10B,A01,188097,Bowers; Adam R.,0,12,30,30
1683701688806,MATH 10B,A02,188099,Bowers; Adam R.,0,11,30,30
1683701688806,MATH 10B,B01,188104,Bowers; Adam R.,0,10,30,30
1683701688806,MATH 10B,B02,188106,Bowers; Adam R.,0,9,30,30
1683701689837,MATH 10C,A01,188111,Staff,0,20,30,30
1683701689837,MATH 10C,A02,188127,Staff,0,19,30,30
1683701689837,MATH 10C,A03,188131,Staff,0,19,30,30
1683701689837,MATH 10C,B01,188218,Staff,17,0,30,13
1683701689837,MATH 10C,B02,188244,Staff,13,0,30,17
1683701689837,MATH 10C,B03,188277,Staff,14,0,30,16
1683701690867,MATH 18,A01,188344,Bach; Quang Tran,18,0,30,12
1683701690867,MATH 18,A02,188345,Bach; Quang Tran,11,0,30,19
1683701690867,MATH 18,B01,188353,Bach; Quang Tran,11,0,30,19
1683701690867,MATH 18,B02,188354,Bach; Quang Tran,19,0,30,11
1683701691890,MATH 20A,A01,188374,Staff,11,0,35,24
1683701692917,MATH 20B,A01,188382,Ohm; Ko Woon,7,0,30,23
1683701692917,MATH 20B,A02,188383,Ohm; Ko Woon,22,0,30,8
1683701692917,MATH 20B,B01,188385,Ohm; Ko Woon,7,0,30,23
1683701692917,MATH 20B,B02,188392,Ohm; Ko Woon,22,0,30,8
1683701693942,MATH 20C,A01,188394,Harel; Guershon,10,0,30,20
1683701693942,MATH 20C,A02,188395,Harel; Guershon,13,0,30,17
1683701693942,MATH 20C,B01,188404,Harel; Guershon,5,0,30,25
1683701693942,MATH 20C,B02,188405,Harel; Guershon,18,0,30,12
1683701694977,MATH 20D,A01,188414,Hammock; Frances H,0,1,30,30
1683701694977,MATH 20D,A02,188415,Hammock; Frances H,0,1,30,30
1683701694977,MATH 20D,B01,188447,Hammock; Frances H,0,1,30,30
1683701694977,MATH 20D,B02,188486,Hammock; Frances H,2,0,30,28
1683701696005,MATH 20E,A01,188649,Staff,21,0,30,9
1683701696005,MATH 20E,A02,188650,Staff,20,0,30,10
1683701696005,MATH 20E,A03,188673,Staff,0,0,30,30
1683701697033,MATH 102,A01,188675,Staff,0,40,35,35
1683701698060,MATH 103B,A01,188681,Staff,3,0,35,32
1683701698060,MATH 103B,B01,188692,Staff,5,0,35,30
1683701699086,MATH 109,A01,188695,Salehi Golsefidy; Alireza,24,0,35,11
1683701699086,MATH 109,A02,188696,Salehi Golsefidy; Alireza,25,0,35,10
1683701700110,MATH 120A,A01,188698,Eggers; John Dietrich,7,0,35,28
1683701701134,MATH 142B,A01,188736,Ioana; Adrian,0,0,30,30
1683701701134,MATH 142B,A02,188741,Ioana; Adrian,0,1,30,30
1683701701134,MATH 142B,A03,188743,Ioana; Adrian,0,2,30,30
1683701702162,MATH 168A,A01,188790,Staff,0,11,35,35
1683701703187,MATH 170A,A01,188803,Nie; Jiawang,0,2,35,35
1683701703187,MATH 170A,A02,188811,Nie; Jiawang,0,1,35,35
1683701703187,MATH 170A,A03,188814,Nie; Jiawang,0,0,35,35
1683701703187,MATH 170A,A04,188815,Nie; Jiawang,5,0,35,30
1683701704211,MATH 193B,A01,188817,Staff,0,0,35,35
1683701704211,MATH 193B,A02,188818,Staff,6,0,35,29
1683701705235,MGT 4,A01,202857,Anderson; John Charles,59,0,80,21
1683701706259,MGT 12,A00,202858,Lindenberger; Wade Douglas,40,0,90,50
1683701707284,MGT 18,A00,202859,Staff,74,0,90,16
1683701708308,MGT 18GS,A00,202860,McKay; Michael J,13,0,28,15
1683701709334,MGT 45,A00,202861,Pecore; Joseph P.,8,0,90,82
1683701710358,MGT 100,A00,202863,Yavorsky; Daniel Ryan,27,0,90,63
1683701711387,MGT 103,A00,202864,Ehrich; Kristine R,0,19,90,90
1683701712472,MGT 112,A00,202865,Ehrich; Kristine R,15,0,90,75
1683701713499,MGT 121A,A00,202868,Staff,70,0,90,20
1683701714524,MGT 131B,A00,202869,Anderson; John Charles,58,0,90,32
1683701715550,MGT 136,A00,202871,Lindenberger; Wade Douglas,83,0,90,7
1683701716574,MGT 164,A00,202873,Staff,0,67,90,91
1683701717598,MGT 164GS,A00,202874,McKay; Mary A,13,0,28,15
1683701718622,MGT 180,A00,202875,Staff,0,51,90,91
1683701719650,MMW 11R,A01,205019,Herbst; Matthew,0,0,30,30
1683701719650,MMW 11R,A02,205026,Herbst; Matthew,29,0,30,1
1683701720674,MMW 15,A01,193512,Chang; Edmond Yi-Teh,0,8,28,28
1683701720674,MMW 15,A02,193513,Chang; Edmond Yi-Teh,0,5,28,28
1683701720674,MMW 15,A03,193514,Chang; Edmond Yi-Teh,0,5,28,28
1683701720674,MMW 15,A04,193515,Chang; Edmond Yi-Teh,0,5,28,28
1683701720674,MMW 15,A05,193516,Chang; Edmond Yi-Teh,0,5,28,28
1683701720674,MMW 15,A06,193517,Chang; Edmond Yi-Teh,0,6,28,28
1683701720674,MMW 15,B01,193519,Chang; Edmond Yi-Teh,0,5,28,28
1683701720674,MMW 15,B02,193520,Chang; Edmond Yi-Teh,0,5,28,28
1683701720674,MMW 15,B03,193521,Chang; Edmond Yi-Teh,0,5,28,28
1683701720674,MMW 15,B04,193522,Chang; Edmond Yi-Teh,0,6,28,28
1683701720674,MMW 15,B05,193523,Chang; Edmond Yi-Teh,0,5,28,28
1683701720674,MMW 15,B06,193524,Chang; Edmond Yi-Teh,0,5,28,28
1683701721698,MMW 122,A01,193526,Rahimi; Babak,0,16,28,28
1683701721698,MMW 122,A02,193527,Rahimi; Babak,0,15,28,28
1683701721698,MMW 122,A03,193528,Rahimi; Babak,0,0,0,0
1683701721698,MMW 122,A04,193529,Rahimi; Babak,0,0,0,0
1683701722722,MUS 1A,A01,186663,Staff,0,18,35,35
1683701723749,MUS 4,A01,186715,Staff,0,12,35,35
1683701724779,MUS 5R,A01,186796,Dubnov; Shlomo,0,17,35,35
1683701725808,MUS 6,A01,186798,Staff,0,4,25,25
1683701726835,MUS 7,A01,186830,Staff,11,0,35,24
1683701727861,MUS 8,A01,186930,Staff,0,27,35,35
1683701728886,MUS 15,A01,186932,Staff,0,15,35,35
1683701728886,MUS 15,B01,186934,Staff,0,16,35,35
1683701729913,MUS 80,A00,186935,Staff,0,0,20,20
1683701729913,MUS 80,B00,186936,Staff,24,0,25,1
1683701730940,NANO 11,A00,204702,Lipomi; Darren John,0,0,0,0
1683701731967,NANO 15,A01,204709,Yang; Kesong,0,1,0,0
1683701732991,NANO 114,A00,202069,Jahed Motlagh; Zeinab,2,0,10,8
1683701734014,PHIL 1,A00,186955,Grush; Rick Scott,31,0,40,9
1683701735039,PHIL 10,A01,186973,Grush; Rick Scott,27,0,35,8
1683701735039,PHIL 10,A02,186974,Grush; Rick Scott,33,0,35,2
1683701736067,PHIL 13,A01,186976,Staff,1,0,35,34
1683701736067,PHIL 13,A02,186977,Staff,16,0,35,19
1683701737090,PHIL 14,A01,186979,Staff,30,0,35,5
1683701737090,PHIL 14,A02,186986,Staff,32,0,35,3
1683701738115,PHIL 28,A01,186988,Staff,16,0,30,14
1683701738115,PHIL 28,A02,186989,Staff,1,0,30,29
1683701738115,PHIL 28,A03,186990,Staff,10,0,30,20
1683701738115,PHIL 28,A04,186991,Staff,26,0,30,4
1683701739138,PHIL 120,A00,186997,Staff,23,0,40,17
1683701740165,PHIL 137,A00,187003,Staff,7,0,40,33
1683701741192,PHIL 150,A00,187015,Staff,47,0,70,23
1683701742217,PHIL 167,A00,187021,Lamey; Andy M.,34,0,40,6
1683701743242,PHIL 174,A01,202226,Staff,17,0,20,3
1683701743242,PHIL 174,A02,202235,Staff,20,0,20,0
1683701744269,PHIL 191A,A00,258918,Staff,0,0,1,1
1683701745294,PHYS 1A,A00,187028,Staff,26,0,60,34
1683701746321,PHYS 1AL,001,187036,Staff,3,0,30,27
1683701746321,PHYS 1AL,002,187049,Staff,18,0,30,12
1683701747348,PHYS 1B,A00,187058,Staff,21,0,60,39
1683701748376,PHYS 1BL,001,187064,Staff,0,1,30,30
1683701748376,PHYS 1BL,002,187070,Staff,4,0,30,26
1683701749400,PHYS 1C,A00,187082,Staff,30,0,120,90
1683701750429,PHYS 1CL,001,187088,Staff,0,9,30,30
1683701750429,PHYS 1CL,002,187089,Staff,0,1,30,30
1683701750429,PHYS 1CL,009,262693,Staff,9,0,30,21
1683701751453,PHYS 2B,A01,187097,Staff,55,0,115,60
1683701752477,PHYS 2C,A01,187099,Staff,63,0,115,52
1683701753504,PHYS 2CL,A01,187101,Staff,5,0,28,23
1683701753504,PHYS 2CL,A02,187102,Staff,15,0,28,13
1683701754531,PHYS 2D,A01,187123,Shotwell; Brian,95,0,115,20
1683701755555,PHYS 4B,A01,187133,Grinstein; Benjamin,35,0,50,15
1683701756579,POLI 10,A00,188819,Staff,0,4,50,50
1683701757607,POLI 11,A00,188827,Staff,43,0,50,7
1683701758632,POLI 13R,A00,188828,Staff,0,1,20,20
1683701759659,POLI 27,A01,188830,Elgin; Samuel Zincke,0,2,70,70
1683701760686,POLI 30,A00,188832,Desposato; Scott,30,0,50,20
1683701761715,POLI 102F,A00,188834,Staff,1,0,40,39
1683701762740,POLI 104A,A00,188852,Staff,12,0,30,18
1683701763766,POLI 104I,A00,188853,Staff,0,8,20,20
1683701764789,POLI 110B,A00,188854,Wiens; David,6,0,20,14
1683701765817,POLI 112A,A00,188855,Wiens; David,3,0,30,27
1683701766843,POLI 117R,A00,188856,Forman; Fonna,0,12,20,20
1683701767872,POLI 118,A00,188857,Ingham; Sean,8,0,20,12
1683701768897,POLI 120G,A00,188858,Staff,8,0,30,22
1683701769922,POLI 131CR,A00,188863,Hoston; Germaine,20,0,50,30
1683701770947,POLI 133,A00,188864,Nellis; Gareth Hb,44,0,50,6
1683701771972,POLI 134D,A00,188865,Desposato; Scott,27,0,30,3
1683701773001,POLI 142A,A00,188871,Gartzke; Erik,21,0,50,29
1683701774028,POLI 142K,A00,188874,Staff,38,0,50,12
1683701775057,POLI 143,A00,188940,Gartzke; Erik,15,0,30,15
1683701776084,POLI 153,A00,188943,Staff,2,0,20,18
1683701777111,POLI 160AA,A00,188944,Staff,10,0,40,30
1683701778138,POLI 170A,A00,188945,Staff,10,0,30,20
1683701780190,PSYC 1,A00,188952,Staff,36,0,90,54
1683701781215,PSYC 2,B00,188953,Staff,19,0,35,16
1683701782242,PSYC 6,A00,188970,Staff,47,0,60,13
1683701783267,PSYC 7,A00,188973,Staff,35,0,45,10
1683701784292,PSYC 60,A01,188980,Rickard; Timothy C.,42,0,60,18
1683701785317,PSYC 70,A01,189001,Steiner; Eric Tomas,22,0,45,23
1683701786342,PSYC 100,A00,189005,Lacefield; Katharine I,0,98,120,120
1683701787368,PSYC 102,A00,189008,Staff,6,0,30,24
1683701788393,PSYC 106,B00,189026,Gorman; Michael R.,27,0,60,33
1683701789421,PSYC 114,B01,189033,Winkielman; Piotr,0,31,30,30
1683701790455,PSYC 131,A00,189036,Anagnostaras; Stephan,0,44,60,60
1683701791480,PSYC 136,A00,189041,Lowe; Angela Beth,0,7,25,25
1683701792502,PSYC 137,A00,189057,Winkielman; Piotr,0,36,25,25
1683701793530,PSYC 144,A00,189107,Wixted; John T,0,11,50,50
1683701795583,PSYC 162,A00,189142,Staff,0,9,85,85
1683701796607,PSYC 172,A00,189144,Gorman; Michael R.,0,6,30,30
1683701798655,PSYC 179,A00,189146,Lacefield; Katharine I,0,88,120,120
1683701799682,PSYC 181,A00,189147,Anagnostaras; Stephan,0,45,90,90
1683701800709,PSYC 190R,A00,189148,Barner; David A.,0,23,80,80
1683701801735,PSYC 191,A00,189275,Rickard; Timothy C.,0,11,25,25
1683701802763,PSYC 193,A00,189276,Chapman; Eddie Nathaniel,0,1,0,4
1683701803788,PSYC 193L,A01,189281,Lowe; Angela Beth,8,0,20,12
1683701803788,PSYC 193L,B01,189285,Staff,28,0,35,7
1683701804812,RELI 149,A00,187137,Rahimi; Babak,6,0,40,34
1683701805839,SE 9,A01,187315,Staff,0,2,18,18
1683701806862,SE 101B,A00,187409,Staff,24,0,30,6
1683701807890,SE 110B,A00,187444,Staff,10,0,40,30
1683701808914,SE 130B,A00,187449,Staff,31,0,40,9
1683701809942,SE 150A,A00,187516,Staff,8,0,20,12
1683701810967,SE 154,A00,187528,Staff,29,0,50,21
1683701811990,SIO 3,A01,258171,Staff,35,0,40,5
1683701813015,SIO 10,A00,187144,Cook; Geoffrey W,0,6,75,75
1683701814039,SIO 45,A00,187152,Cook; Geoffrey W,1,7,100,99
1683701815064,SIO 109R,A00,194486,Staff,0,4,20,20
1683701817170,SIO 187,A01,187233,Kacev; David,12,0,40,28
1683701818193,SOCI 1,A01,258656,Thorpe; Charles Robert,28,0,30,2
1683701818193,SOCI 1,A02,258658,Thorpe; Charles Robert,30,0,30,0
1683701818193,SOCI 1,A03,258661,Thorpe; Charles Robert,25,0,25,0
1683701818193,SOCI 1,A04,258666,Thorpe; Charles Robert,22,0,25,3
1683701818193,SOCI 1,A05,258897,Thorpe; Charles Robert,22,0,25,3
1683701818193,SOCI 1,A06,258898,Thorpe; Charles Robert,25,0,25,0
1683701819222,SOCI 30,A01,258903,Pardo Guerra; Juan Pablo,14,0,30,16
1683701820247,SOCI 102,A00,258904,Staff,9,0,25,16
1683701821275,SOCI 106,A00,258905,Staff,19,0,25,6
1683701822305,SOCI 111,A00,258907,Ribas Norris; Janet Vanesa,26,0,30,4
1683701823332,SOCI 121R,A00,258908,Pardo Guerra; Juan Pablo,7,0,30,23
1683701824357,SOCI 126,A01,203330,Staff,14,0,20,6
1683701825385,SOCI 131,A00,258909,Thorpe; Charles Robert,30,0,60,30
1683701826413,SOCI 135,A00,258910,Payne; Christine Anna,0,13,30,30
1683701827436,SOCI 157,A00,258911,Staff,10,0,30,20
1683701828461,SOCI 184,A00,258912,Staff,25,0,30,5
1683701829486,SOCI 188D,A00,258913,Staff,22,0,30,8
1683701830509,SYN 2,001,187529,Staff,9,0,16,7
1683701830509,SYN 2,002,201452,Staff,0,20,16,16
1683701830509,SYN 2,003,201469,Staff,1,0,16,15
1683701831533,SYN 100,A01,187531,Staff,0,9,20,20
1683701831533,SYN 100,B01,201491,Staff,0,10,20,20
1683701832558,TDAC 1,A00,189286,Walsh; Kim C.,3,0,20,17
1683701832558,TDAC 1,B00,189287,Harting; Carla Kelso,10,0,20,10
1683701833583,TDAC 101,A00,189300,Walsh; Kim C.,16,0,20,4
1683701833583,TDAC 101,B00,189301,Harting; Carla Kelso,18,0,20,2
1683701834611,TDAC 102,A00,189304,Basso; Beatrice,14,0,20,6
1683701835638,TDAC 108,A00,189305,Staff,18,0,20,2
1683701836670,TDDE 131,A00,189310,Staff,19,0,20,1
1683701836670,TDDE 131,B00,189314,Staff,19,0,20,1
1683701836670,TDDE 131,C00,189315,Staff,48,0,50,2
1683701836670,TDDE 131,D00,189316,Staff,14,0,15,1
1683701836670,TDDE 131,E00,204841,Staff,20,0,20,0
1683701837697,TDGE 10,A00,189289,Staff,27,0,50,23
1683701837697,TDGE 10,B00,189290,Havis; Allan,0,1,50,50
1683701838725,TDGE 11,A00,189291,Fulton; Julia,0,4,50,50
1683701838725,TDGE 11,B00,189292,Staff,20,0,25,5
1683701838725,TDGE 11,C00,260270,Staff,0,0,0,0
1683701839753,TDGE 25,A00,189294,Staff,1,0,20,19
1683701840795,TDGE 124,A00,189318,Fulton; Julia,0,7,50,50
1683701841823,TDGE 125,A00,189319,Staff,13,0,25,12
1683701841823,TDGE 125,B00,189320,Staff,23,0,25,2
1683701842849,TDGE 127,A00,189322,Havis; Allan,1,0,50,49
1683701843877,TDHT 101,A00,189323,Staff,18,0,25,7
1683701843877,TDHT 101,B00,189324,Staff,25,0,25,0
1683701844902,TDHT 102,A00,189325,Staff,49,0,50,1
1683701845927,TDMV 1,A00,189295,Arcidiacono; Kristin,20,0,30,10
1683701845927,TDMV 1,B00,189296,Caligagan; Maria T.,24,0,30,6
1683701846951,TDMV 2,A00,189297,Sammartano; Tonnie,27,0,30,3
1683701846951,TDMV 2,B00,189299,Arcidiacono; Kristin,23,0,30,7
1683701847980,TDMV 3,A00,204998,Rincon; Alicia,22,0,30,8
1683701849009,TDMV 120,A00,189458,Sammartano; Tonnie,28,0,30,2
1683701850037,TDMV 138,A00,189541,Jun; Grace Shin Hae,20,0,40,20
1683701851061,TDMV 142,A00,189717,Caligagan; Tony,25,0,30,5
1683701851061,TDMV 142,B00,189718,Caligagan; Maria T.,25,0,30,5
1683701852090,TMC 2,A01,187533,Staff,25,0,25,0
1683701852090,TMC 2,A02,187534,Staff,25,0,25,0
1683701853114,USP 1,A01,187536,Kwak; Nancy,0,16,25,25
1683701854137,USP 5,A01,187538,Staff,8,0,25,17
1683701855162,USP 101,A00,199253,Staff,0,4,0,0
1683701856189,USP 124,A00,187562,Boomhower; Matthew Charles,0,0,30,30
1683701857220,USP 138,A00,187582,Staff,19,0,25,6
1683701858244,USP 152,A01,187597,Staff,3,0,25,22
1683701859268,USP 153,A00,187598,Staff,18,0,25,7
1683701860293,USP 168,A00,187607,Kwak; Nancy,2,0,5,3
1683701861319,USP 173,A00,187619,Staff,4,0,25,21
1683701862347,USP 181,A00,187638,Staff,0,4,25,25
1683701863370,VIS 103,A00,187650,Cruz; Edwin Teddy,17,0,75,58
1683701864394,VIS 110D,A00,187669,Staff,13,0,22,9
1683701865417,VIS 127C,A00,187720,Shen; Kuiyi,67,0,146,79
1683701866444,VIS 149,A00,187731,Yoldas; Pinar,0,12,22,22
1683701867471,VIS 151,A01,188091,Staff,22,0,34,12
1683701867471,VIS 151,A02,188092,Staff,11,0,34,23
1683701868498,VIS 160B,A00,188093,Stalbaum; Brett,0,1,10,10
1683701870548,WCWP 10B,A00,201720,Staff,0,0,5,5
1683701870548,WCWP 10B,B00,201722,Staff,0,0,6,6
1683701871573,WCWP 100,A00,201725,Gagnon; Jeffrey C,0,0,2,2
1683701871573,WCWP 100,B00,201727,Staff,0,4,15,15
1683701874707,ANBI 133,A00,258401,Wilder; Linnea Lorene,34,0,40,6
1683701875735,ANBI 140,A00,258395,Hrvoj Mihic; Branka,18,0,25,7
1683701876759,ANSC 120,A00,258402,Bialecki; Jon Anthony,26,0,40,14
1683701877788,ANSC 144,A00,258400,Staff,12,0,40,28
1683701879835,ANSC 166,A00,258396,Parish; Steven Martin,156,0,175,19
1683701880859,ANSC 180,A00,193533,Staff,8,0,20,12
1683701881882,ANSC 188,A00,258397,Jassal; Aftab,34,0,40,6
1683701882910,ANTH 3,A01,258316,Staff,23,0,30,7
1683701883934,ANTH 5,A00,258394,Semendeferi; Ekaterini,16,0,20,4
1683701884958,ANTH 21,A01,258331,Staff,4,0,40,36
1683701885982,ANTH 103,A00,258398,Varma; Saiba,15,0,25,10
1683701887015,AWP 10,001,202034,Staff,0,0,0,0
1683701887015,AWP 10,002,202035,Staff,0,0,0,0
1683701887015,AWP 10,003,202036,Staff,0,0,0,0
1683701887015,AWP 10,004,202037,Staff,0,0,0,0
1683701887015,AWP 10,005,202038,Staff,0,0,0,0
1683701887015,AWP 10,006,202039,Staff,0,0,0,0
1683701887015,AWP 10,007,202040,Staff,0,0,0,0
1683701887015,AWP 10,008,202041,Staff,0,0,0,0
1683701887015,AWP 10,009,202042,Staff,0,0,0,0
1683701887015,AWP 10,010,202043,Staff,0,0,0,0
1683701887015,AWP 10,011,202044,Staff,0,0,0,0
1683701887015,AWP 10,012,202045,Staff,0,0,0,0
1683701887015,AWP 10,013,202046,Staff,0,0,0,0
1683701887015,AWP 10,014,202047,Staff,0,0,0,0
1683701887015,AWP 10,015,202048,Staff,0,0,0,0
1683701887015,AWP 10,016,202049,Staff,0,0,0,0
1683701887015,AWP 10,017,202050,Staff,0,0,0,0
1683701887015,AWP 10,018,202051,Staff,0,0,0,0
1683701887015,AWP 10,019,202052,Staff,0,0,0,0
1683701887015,AWP 10,020,202053,Staff,0,0,0,0
1683701887015,AWP 10,021,202054,Staff,0,0,0,0
1683701887015,AWP 10,022,202055,Staff,0,0,0,0
1683701887015,AWP 10,023,202056,Staff,0,0,0,0
1683701887015,AWP 10,024,202057,Staff,0,0,0,0
1683701887015,AWP 10,025,202058,Staff,0,0,0,0
1683701887015,AWP 10,026,202059,Staff,0,0,0,0
1683701888042,AWP 102,001,202032,Staff,0,0,0,0
1683701888042,AWP 102,002,202033,Staff,0,0,0,0
1683701889073,BENG 100,A01,254234,Taylor Amos; Alyssa C,31,0,40,9
1683701890096,BENG 196,001,270013,Engler; Adam J.,9999,0,9999,0
1683701891125,BICD 100R,A01,202018,Smith; Laurie,0,7,32,32
1683701891125,BICD 100R,A02,202019,Smith; Laurie,0,3,32,32
1683701891125,BICD 100R,A03,202020,Smith; Laurie,0,1,32,32
1683701891125,BICD 100R,A04,202021,Smith; Laurie,6,0,32,26
1683701891125,BICD 100R,A05,202022,Smith; Laurie,10,0,32,22
1683701892153,BICD 136,A01,193242,Gustafson-Brown; Cindy,0,2,32,32
1683701892153,BICD 136,A02,193244,Gustafson-Brown; Cindy,13,0,32,19
1683701893182,BIEB 102,A01,193249,Butler; Shannon Rhey,0,0,32,32
1683701893182,BIEB 102,A02,193251,Butler; Shannon Rhey,0,0,32,32
1683701893182,BIEB 102,A03,193253,Butler; Shannon Rhey,0,0,32,32
1683701893182,BIEB 102,A04,193255,Butler; Shannon Rhey,13,0,32,19
1683701893182,BIEB 102,A05,193265,Butler; Shannon Rhey,25,0,32,7
1683701893182,BIEB 102,A06,193269,Butler; Shannon Rhey,12,0,32,20
1683701895234,BIEB 150,A01,193274,Staff,0,0,32,32
1683701895234,BIEB 150,A02,193285,Staff,24,0,32,8
1683701896259,BIEB 194,A00,193286,Kurle; Carolyn M.,19,0,32,13
1683701897285,BILD 1,A01,192291,Staff,15,0,32,17
1683701897285,BILD 1,A02,192292,Staff,30,0,32,2
1683701897285,BILD 1,B01,192520,Reuther; Keefe,0,1,0,0
1683701897285,BILD 1,B02,192532,Reuther; Keefe,0,1,0,0
1683701898310,BILD 3,A01,192556,Butler; Shannon Rhey,0,0,32,32
1683701898310,BILD 3,A02,192581,Butler; Shannon Rhey,0,1,32,32
1683701898310,BILD 3,A03,192611,Butler; Shannon Rhey,19,0,32,13
1683701898310,BILD 3,A04,192612,Butler; Shannon Rhey,23,0,32,9
1683701898310,BILD 3,A05,192613,Butler; Shannon Rhey,26,0,32,6
1683701898310,BILD 3,A06,192679,Butler; Shannon Rhey,27,0,32,5
1683701898310,BILD 3,A07,192682,Butler; Shannon Rhey,20,0,32,12
1683701899334,BILD 4,A01,192836,Reuther; Keefe,1,0,24,23
1683701899334,BILD 4,A02,193044,Reuther; Keefe,4,0,24,20
1683701900360,BILD 10,A01,193142,Gustafson-Brown; Cindy,29,0,32,3
1683701900360,BILD 10,A02,193149,Gustafson-Brown; Cindy,31,0,32,1
1683701901387,BIMM 100,A01,193301,Staff,0,6,32,32
1683701901387,BIMM 100,A02,193312,Staff,0,7,32,32
1683701901387,BIMM 100,A03,193323,Staff,0,10,32,32
1683701902411,BIMM 101,A01,193329,McDonnell; Lisa Marie,0,3,24,24
1683701902411,BIMM 101,A02,193339,McDonnell; Lisa Marie,0,3,24,24
1683701902411,BIMM 101,B01,193354,McDonnell; Lisa Marie,0,4,24,24
1683701902411,BIMM 101,B02,193357,McDonnell; Lisa Marie,0,3,24,24
1683701903439,BIMM 110,A01,193377,Tat; John,0,11,32,32
1683701903439,BIMM 110,A02,193378,Tat; John,0,11,32,32
1683701904467,BIMM 120,A01,206116,Staff,0,0,32,32
1683701904467,BIMM 120,A02,206117,Staff,7,0,32,25
1683701904467,BIMM 120,A03,206121,Staff,21,0,32,11
1683701905496,BIPN 100,A01,193393,Park; Ji Young,0,15,32,32
1683701905496,BIPN 100,A02,193402,Park; Ji Young,0,14,32,32
1683701905496,BIPN 100,A03,193413,Park; Ji Young,0,14,32,32
1683701905496,BIPN 100,A04,193414,Park; Ji Young,0,13,32,32
1683701906521,BIPN 102,A01,193429,Staff,0,0,32,32
1683701906521,BIPN 102,A02,193438,Staff,18,0,32,14
1683701907547,BIPN 106,A01,193450,Reyes Gonzalez; Catalina,0,2,40,40
1683701908578,BIPN 134,A01,193465,Cooke; James Edward,0,0,32,32
1683701908578,BIPN 134,A02,193474,Cooke; James Edward,25,0,32,7
1683701908578,BIPN 134,A03,193485,Cooke; James Edward,29,0,32,3
1683701908578,BIPN 134,A04,193486,Cooke; James Edward,20,0,32,12
1683701908578,BIPN 134,A05,193491,Cooke; James Edward,31,0,32,1
1683701908578,BIPN 134,A06,193501,Cooke; James Edward,30,0,32,2
1683701908578,BIPN 134,A07,193510,Cooke; James Edward,29,0,32,3
1683701910627,BISP 194,A00,222522,Staff,14,0,32,18
1683701911654,CAT 124,A01,202407,Staff,19,0,25,6
1683701912681,CAT 125,A00,202408,Marchisotto; Jennifer Anne,2,0,20,18
1683701913712,CAT 125R,A00,202409,Smith; Lauryn Alissa,0,11,20,20
1683701913712,CAT 125R,B00,202410,Morales; Celeste Georgianna,0,11,20,20
1683701913712,CAT 125R,C00,202411,Irwin; Matthew Joseph,0,12,20,20
1683701914737,CENG 15,A01,204712,Yang; Kesong,0,1,0,0
1683701915761,CENG 114,A00,202070,Jahed Motlagh; Zeinab,5,0,20,15
1683701916786,CGS 105,A00,185477,Wesling; Megan E.,24,0,40,16
1683701917811,CGS 106,A00,185494,Staff,11,0,22,11
1683701918839,CGS 108,A00,185495,Staff,14,0,20,6
1683701919923,CGS 114,A00,185496,Staff,12,0,18,6
1683701920951,CGS 119,A00,185501,Staff,15,0,20,5
1683701921975,CGS 120,A00,185511,Staff,12,0,20,8
1683701922999,CHEM 4,A01,184675,Bussey; Thomas J,97,0,100,3
1683701924024,CHEM 6A,A01,184677,Staff,32,0,60,28
1683701925051,CHEM 6B,A01,184679,Staff,63,0,100,37
1683701926075,CHEM 6C,A01,184681,Bussey; Thomas J,0,0,50,50
1683701926075,CHEM 6C,A02,184682,Bussey; Thomas J,32,0,50,18
1683701927100,CHEM 40A,A01,184684,Albizati; Kim F.,33,0,100,67
1683701928126,CHEM 40B,A01,184686,Albizati; Kim F.,0,22,100,100
1683701929150,CHEM 41B,A01,184690,Staff,51,0,100,49
1683701930176,COGS 3,A01,184715,Boyle; Mary E. T.,0,27,40,40
1683701931200,COGS 14B,A01,185172,Staff,0,14,38,38
1683701932223,COGS 18,A01,184736,Staff,14,0,80,66
1683701933251,COGS 100,A01,184932,Staff,0,8,73,73
1683701934278,COGS 101A,A01,184935,Staff,0,40,30,30
1683701935301,COGS 101B,A01,184944,Staff,0,2,30,30
1683701936328,COGS 101C,A01,184946,Staff,0,10,30,30
1683701937353,COGS 102A,A01,184951,Johnson; Christine M.,1,0,40,39
1683701938380,COGS 107B,A01,184953,Mooshagian; Eric Frederick,0,52,40,40
1683701939407,COGS 118B,A01,184959,Gupta; Anjum,0,50,40,40
1683701940435,COGS 153,A00,184961,Staff,1,16,30,29
1683701941462,COGS 177,A00,184962,Staff,0,20,30,30
1683701942489,COGS 187A,A01,184969,Boyle; Mary E. T.,0,19,40,40
1683701943512,COMM 10,A01,185174,Staff,0,5,25,25
1683701943512,COMM 10,A02,185189,Staff,0,2,25,25
1683701943512,COMM 10,A03,269821,Staff,0,1,0,0
1683701944541,COMM 100B,A02,185476,Staff,10,0,25,15
1683701944541,COMM 100B,A03,277340,Staff,25,0,25,0
1683701945565,COMM 100C,A01,185314,Staff,2,0,25,23
1683701945565,COMM 100C,A02,185327,Staff,17,0,25,8
1683701946589,COMM 110M,A00,185349,Staff,0,0,40,40
1683701947612,COMM 113T,A00,185352,Staff,25,0,40,15
1683701948641,COMM 114I,A00,185353,Staff,31,0,40,9
1683701949666,COMM 131,A00,185354,Staff,17,0,30,13
1683701950691,CSE 8A,A50,185358,Cao; Yingjun,0,46,10,10
1683701951716,CSE 8B,A01,185362,Staff,0,48,50,50
1683701952745,CSE 11,A01,185416,Cao; Yingjun,0,91,10,10
1683701953769,CSE 20,A01,185445,Briones; Jor-el Thomas Caparas,3,0,25,22
1683701954798,CSE 21,A01,185447,Staff,9,0,50,41
1683701955823,CSE 101,A01,185451,Staff,0,13,50,50
1683701955823,CSE 101,B01,185453,Jones; Miles E,0,15,50,50
1683701957871,CSE 141,A01,185458,Eldon; John,16,0,100,84
1683701958896,CSE 141L,A01,185461,Eldon; John,8,0,100,92
1683701959923,CSE 142,A01,185463,Staff,34,0,60,26
1683701959923,CSE 142,B01,201355,Staff,0,7,60,60
1683701960949,CSE 142L,A01,185470,Staff,34,0,60,26
1683701960949,CSE 142L,B01,201417,Staff,0,6,60,60
1683701961976,CSE 190,A00,201433,Staff,32,0,49,17
1683701963005,DOC 1,A01,259136,Strom; Megan C.,7,0,15,8
1683701963005,DOC 1,A02,259137,Strom; Megan C.,14,0,15,1
1683701963005,DOC 1,A03,259138,Strom; Megan C.,14,0,15,1
1683701963005,DOC 1,A04,259139,Strom; Megan C.,14,0,15,1
1683701964035,DOC 100D,A00,259140,Pass; Natalye Joann,14,0,25,11
1683701965060,DSGN 1,A01,184749,Rill; Bryan,0,26,30,30
1683701966086,DSGN 100,A01,185168,Staff,0,2,25,25
1683701967112,ECE 5,A01,185626,Morris; Karcher William,0,12,0,0
1683701968136,ECE 101,A01,185628,Staff,14,0,70,56
1683701969161,ECE 107,A01,185635,Baghdadchi; Saharnaz,0,0,20,20
1683701969161,ECE 107,A02,185638,Baghdadchi; Saharnaz,1,0,20,19
1683701970188,ECE 148,A01,185647,Silberman; Jack,0,0,16,16
1683701971214,ECON 1,A01,185537,Crane; Meredith Helen,54,0,70,16
1683701972242,ECON 3,A01,185549,Crane; Meredith Helen,30,0,70,40
1683701973270,ECON 4,A01,203354,Anderson; John Charles,0,5,10,10
1683701974294,ECON 100A,A01,185574,Staff,0,5,40,40
1683701975321,ECON 100B,A01,185576,Staff,0,12,50,50
1683701976343,ECON 100C,A01,185589,Newhouse; Herbert S,30,0,70,40
1683701977370,ECON 105,A00,185608,Vespa; Emanuel Ignacio,19,0,35,16
1683701978398,ECON 109,A01,185610,Shishkin; Denis,9,0,35,26
1683701979425,ECON 110A,A01,185612,Staff,8,0,40,32
1683701980452,ECON 120A,A01,185615,Staff,19,0,40,21
1683701981479,ECON 120C,A01,185617,Sun; Yixiao,0,21,70,70
1683701982504,ECON 144,A00,203346,Squires; Dale E,2,0,35,33
1683701983528,ECON 171,A01,203349,Newhouse; Herbert S,0,1,35,35
1683701984555,ECON 173A,A01,185621,Toda; Alexis Akira,21,0,35,14
1683701985580,EDS 25,A01,202413,Staff,0,1,0,0
1683701985580,EDS 25,A02,202414,Staff,0,1,0,0
1683701985580,EDS 25,A03,202415,Staff,0,0,0,0
1683701985580,EDS 25,A04,202416,Staff,0,1,0,0
1683701985580,EDS 25,A05,202439,Staff,0,0,0,0
1683701985580,EDS 25,A06,202440,Staff,0,0,0,0
1683701985580,EDS 25,B01,202631,Staff,0,0,0,0
1683701985580,EDS 25,B02,202632,Staff,0,0,0,0
1683701985580,EDS 25,B03,202639,Staff,0,0,0,0
1683701985580,EDS 25,B04,202640,Staff,0,0,0,0
1683701985580,EDS 25,B05,202643,Staff,0,0,0,0
1683701985580,EDS 25,B06,202644,Staff,0,0,0,0
1683701986609,EDS 38,A01,202659,Black; Alison Michelle,25,0,25,0
1683701987633,EDS 115,A00,202652,Staff,18,0,30,12
1683701988659,EDS 125,A00,202649,Staff,13,0,30,17
1683701989687,EDS 126,A01,203332,Staff,30,0,30,0
1683701990715,EDS 139,A00,202838,Staff,16,0,25,9
1683701991742,EDS 146,A01,202655,Staff,14,0,25,11
1683701992766,ENG 15,A00,185667,Staff,0,1,0,0
1683701992766,ENG 15,B00,185672,Staff,0,0,0,0
1683701992766,ENG 15,C00,185675,Staff,0,0,0,0
1683701992766,ENG 15,D00,185682,Staff,0,0,0,0
1683701992766,ENG 15,E00,185684,Staff,0,0,0,0
1683701993790,ETHN 103,A00,185710,Staff,0,8,35,35
1683701994817,ETHN 103A,A00,199228,Man; Simeon S,0,0,9,9
1683701995845,ETHN 109,A00,185711,Staff,15,0,35,20
1683701996869,ETHN 142,A00,185726,Staff,0,4,30,30
1683701997899,ETHN 163J,A00,199229,Man; Simeon S,5,0,8,3
1683701998923,ETHN 168,A00,185727,Staff,7,0,10,3
1683701999950,ETHN 182,A00,185728,Staff,0,0,35,35
1683702000976,ETHN 183,A00,185737,Staff,9,0,18,9
1683702002000,GLBH 111,A01,209361,Burgos; Jose L.,0,0,0,0
1683702004053,HIEU 104,A00,185792,Staff,14,0,20,6
1683702005076,HIEU 115,A00,185800,Staff,0,0,20,20
1683702006098,HIEU 128,A00,185801,Staff,0,9,20,20
1683702007121,HIEU 147,A00,185802,Staff,15,0,20,5
1683702008146,HIEU 154,A00,185823,Staff,11,0,20,9
1683702009171,HILA 102,A00,185826,Staff,14,0,20,6
1683702010198,HILD 2C,A01,185778,Staff,0,13,20,20
1683702011228,HILD 7B,A01,185780,Kwak; Nancy,0,17,32,32
1683702011228,HILD 7B,A02,185781,Kwak; Nancy,0,18,32,32
1683702012252,HILD 30,A01,185791,Staff,12,0,20,8
1683702013276,HISC 119,A00,185830,Golan; Tal,0,10,20,20
1683702014307,HITO 156GS,A00,185831,Patterson; Patrick H.,0,0,0,23
1683702015335,HIUS 103,A00,185832,Man; Simeon S,0,4,20,20
1683702016360,HIUS 117,A00,185836,Kwak; Nancy,2,0,20,18
1683702017386,HIUS 125,A00,185840,Man; Simeon S,0,2,23,23
1683702018413,HIUS 149,A00,185845,Staff,1,0,20,19
1683702019441,HUM 3,A01,185882,Zavodny; Tatiana Sophia,0,8,50,50
1683702019441,HUM 3,B01,185899,Caldwell; Michael Alan,0,18,50,50
1683702020464,HUM 3GS,A00,185900,Patterson; Patrick H.,0,0,0,23
1683702021489,HUM 4,A01,185938,Zroka; Amy Liane,28,0,50,22
1683702021489,HUM 4,B01,185956,Watkins; Eric,0,6,50,50
1683702021489,HUM 4,B02,202209,Watkins; Eric,0,5,50,50
1683702021489,HUM 4,B03,202210,Watkins; Eric,0,5,50,50
1683702022515,HUM 5,A01,185958,West; Geoffrey Scott,0,0,50,50
1683702022515,HUM 5,A02,202215,West; Geoffrey Scott,0,1,50,50
1683702023597,INTL 190,A00,185959,Gagnon; Jeffrey C,0,0,0,9
1683702023597,INTL 190,B00,185960,Lettieri; Michael Joseph,0,0,0,2
1683702024625,JAPN 180,A00,254509,Staff,5,0,30,25
1683702025650,LATI 10,A01,202853,Kennemore; Amy Michelle,4,0,35,31
1683702025650,LATI 10,A02,202854,Kennemore; Amy Michelle,3,0,35,32
1683702025650,LATI 10,A03,270054,Kennemore; Amy Michelle,30,0,30,0
1683702026676,LATI 180,A00,202855,Kennemore; Amy Michelle,11,0,20,9
1683702027707,LAWS 101,A00,201767,Golan; Tal,0,7,40,40
1683702028732,LIFR 1C,A00,185961,Staff,6,0,20,14
1683702029759,LIFR 1CX,A00,185962,Staff,7,0,20,13
1683702030789,LIFR 1D,A00,185963,Staff,7,0,20,13
1683702031818,LIFR 1DX,A00,185964,Staff,7,0,20,13
1683702032845,LIGN 101,A01,186039,Staff,43,0,50,7
1683702033870,LIGN 165,A00,186040,Staff,14,0,50,36
1683702034894,LTCS 108,A00,186041,Staff,5,0,10,5
1683702035922,LTCS 119,A00,186042,Staff,15,0,20,5
1683702036947,LTCS 130,A00,186043,Wesling; Megan E.,15,0,25,10
1683702038996,LTEA 138,A00,186119,Staff,14,0,40,26
1683702040037,LTEN 124,A00,186148,Staff,5,0,25,20
1683702041066,LTEN 178,A00,186149,Staff,6,0,15,9
1683702042091,LTEN 181,A00,186150,Blanco; John D,34,0,40,6
1683702043115,LTWL 120,A00,186160,Staff,19,0,25,6
1683702044143,LTWL 165,A00,186161,Staff,22,0,25,3
1683702045168,LTWR 100,A00,186162,Staff,0,5,15,15
1683702046192,LTWR 102,A00,186163,Doller; Ben,5,0,15,10
1683702047217,MAE 8,A01,186412,Staff,0,1,0,0
1683702048245,MAE 30B,A00,186445,Bahadori; Mohammad Yousef,81,0,100,19
1683702049270,MAE 40,A00,186592,Bewley; Thomas R,10,0,50,40
1683702050294,MAE 101B,A00,186593,Bahadori; Mohammad Yousef,80,0,100,20
1683702051321,MAE 105,A00,186594,Bandaru; Prabhakar,10,0,50,40
1683702052347,MAE 107,A00,186599,Pham; Hieu Tan,0,8,120,120
1683702053372,MAE 148,A01,186660,Silberman; Jack,3,0,16,13
1683702054400,MATH 10A,A01,188095,Staff,0,6,35,35
1683702055425,MATH 10B,A01,188097,Bowers; Adam R.,0,12,30,30
1683702055425,MATH 10B,A02,188099,Bowers; Adam R.,0,11,30,30
1683702055425,MATH 10B,B01,188104,Bowers; Adam R.,0,10,30,30
1683702055425,MATH 10B,B02,188106,Bowers; Adam R.,0,9,30,30
1683702056455,MATH 10C,A01,188111,Staff,0,20,30,30
1683702056455,MATH 10C,A02,188127,Staff,0,19,30,30
1683702056455,MATH 10C,A03,188131,Staff,0,19,30,30
1683702056455,MATH 10C,B01,188218,Staff,17,0,30,13
1683702056455,MATH 10C,B02,188244,Staff,13,0,30,17
1683702056455,MATH 10C,B03,188277,Staff,14,0,30,16
1683702057482,MATH 18,A01,188344,Bach; Quang Tran,18,0,30,12
1683702057482,MATH 18,A02,188345,Bach; Quang Tran,11,0,30,19
1683702057482,MATH 18,B01,188353,Bach; Quang Tran,11,0,30,19
1683702057482,MATH 18,B02,188354,Bach; Quang Tran,19,0,30,11
1683702058508,MATH 20A,A01,188374,Staff,11,0,35,24
1683702059534,MATH 20B,A01,188382,Ohm; Ko Woon,7,0,30,23
1683702059534,MATH 20B,A02,188383,Ohm; Ko Woon,22,0,30,8
1683702059534,MATH 20B,B01,188385,Ohm; Ko Woon,7,0,30,23
1683702059534,MATH 20B,B02,188392,Ohm; Ko Woon,22,0,30,8
1683702060559,MATH 20C,A01,188394,Harel; Guershon,10,0,30,20
1683702060559,MATH 20C,A02,188395,Harel; Guershon,13,0,30,17
1683702060559,MATH 20C,B01,188404,Harel; Guershon,5,0,30,25
1683702060559,MATH 20C,B02,188405,Harel; Guershon,18,0,30,12
1683702061583,MATH 20D,A01,188414,Hammock; Frances H,0,1,30,30
1683702061583,MATH 20D,A02,188415,Hammock; Frances H,0,1,30,30
1683702061583,MATH 20D,B01,188447,Hammock; Frances H,0,1,30,30
1683702061583,MATH 20D,B02,188486,Hammock; Frances H,2,0,30,28
1683702062613,MATH 20E,A01,188649,Staff,21,0,30,9
1683702062613,MATH 20E,A02,188650,Staff,20,0,30,10
1683702062613,MATH 20E,A03,188673,Staff,0,0,30,30
1683702063638,MATH 102,A01,188675,Staff,0,40,35,35
1683702064669,MATH 103B,A01,188681,Staff,3,0,35,32
1683702064669,MATH 103B,B01,188692,Staff,5,0,35,30
1683702065694,MATH 109,A01,188695,Salehi Golsefidy; Alireza,24,0,35,11
1683702065694,MATH 109,A02,188696,Salehi Golsefidy; Alireza,25,0,35,10
1683702066727,MATH 120A,A01,188698,Eggers; John Dietrich,7,0,35,28
1683702067757,MATH 142B,A01,188736,Ioana; Adrian,0,0,30,30
1683702067757,MATH 142B,A02,188741,Ioana; Adrian,0,1,30,30
1683702067757,MATH 142B,A03,188743,Ioana; Adrian,0,2,30,30
1683702068781,MATH 168A,A01,188790,Staff,0,11,35,35
1683702069806,MATH 170A,A01,188803,Nie; Jiawang,0,2,35,35
1683702069806,MATH 170A,A02,188811,Nie; Jiawang,0,1,35,35
1683702069806,MATH 170A,A03,188814,Nie; Jiawang,0,0,35,35
1683702069806,MATH 170A,A04,188815,Nie; Jiawang,5,0,35,30
1683702070835,MATH 193B,A01,188817,Staff,0,0,35,35
1683702070835,MATH 193B,A02,188818,Staff,6,0,35,29
1683702071859,MGT 4,A01,202857,Anderson; John Charles,59,0,80,21
1683702072884,MGT 12,A00,202858,Lindenberger; Wade Douglas,40,0,90,50
1683702073915,MGT 18,A00,202859,Staff,73,0,90,17
1683702074945,MGT 18GS,A00,202860,McKay; Michael J,13,0,28,15
1683702075975,MGT 45,A00,202861,Pecore; Joseph P.,8,0,90,82
1683702077007,MGT 100,A00,202863,Yavorsky; Daniel Ryan,27,0,90,63
1683702078039,MGT 103,A00,202864,Ehrich; Kristine R,0,19,90,90
1683702079063,MGT 112,A00,202865,Ehrich; Kristine R,15,0,90,75
1683702080089,MGT 121A,A00,202868,Staff,70,0,90,20
1683702081114,MGT 131B,A00,202869,Anderson; John Charles,58,0,90,32
1683702082138,MGT 136,A00,202871,Lindenberger; Wade Douglas,83,0,90,7
1683702083166,MGT 164,A00,202873,Staff,0,67,90,91
1683702084191,MGT 164GS,A00,202874,McKay; Mary A,13,0,28,15
1683702085220,MGT 180,A00,202875,Staff,0,51,90,91
1683702086245,MMW 11R,A01,205019,Herbst; Matthew,0,0,30,30
1683702086245,MMW 11R,A02,205026,Herbst; Matthew,29,0,30,1
1683702087274,MMW 15,A01,193512,Chang; Edmond Yi-Teh,0,8,28,28
1683702087274,MMW 15,A02,193513,Chang; Edmond Yi-Teh,0,5,28,28
1683702087274,MMW 15,A03,193514,Chang; Edmond Yi-Teh,0,5,28,28
1683702087274,MMW 15,A04,193515,Chang; Edmond Yi-Teh,0,5,28,28
1683702087274,MMW 15,A05,193516,Chang; Edmond Yi-Teh,0,5,28,28
1683702087274,MMW 15,A06,193517,Chang; Edmond Yi-Teh,0,6,28,28
1683702087274,MMW 15,B01,193519,Chang; Edmond Yi-Teh,0,5,28,28
1683702087274,MMW 15,B02,193520,Chang; Edmond Yi-Teh,0,5,28,28
1683702087274,MMW 15,B03,193521,Chang; Edmond Yi-Teh,0,5,28,28
1683702087274,MMW 15,B04,193522,Chang; Edmond Yi-Teh,0,6,28,28
1683702087274,MMW 15,B05,193523,Chang; Edmond Yi-Teh,0,5,28,28
1683702087274,MMW 15,B06,193524,Chang; Edmond Yi-Teh,0,5,28,28
1683702088301,MMW 122,A01,193526,Rahimi; Babak,0,16,28,28
1683702088301,MMW 122,A02,193527,Rahimi; Babak,0,15,28,28
1683702088301,MMW 122,A03,193528,Rahimi; Babak,0,0,0,0
1683702088301,MMW 122,A04,193529,Rahimi; Babak,0,0,0,0
1683702089327,MUS 1A,A01,186663,Staff,0,18,35,35
1683702090351,MUS 4,A01,186715,Staff,0,12,35,35
1683702091375,MUS 5R,A01,186796,Dubnov; Shlomo,0,17,35,35
1683702092399,MUS 6,A01,186798,Staff,0,4,25,25
1683702093428,MUS 7,A01,186830,Staff,11,0,35,24
1683702094453,MUS 8,A01,186930,Staff,0,27,35,35
1683702095484,MUS 15,A01,186932,Staff,0,15,35,35
1683702095484,MUS 15,B01,186934,Staff,0,16,35,35
1683702096515,MUS 80,A00,186935,Staff,0,0,20,20
1683702096515,MUS 80,B00,186936,Staff,24,0,25,1
1683702097544,NANO 11,A00,204702,Lipomi; Darren John,0,0,0,0
1683702098569,NANO 15,A01,204709,Yang; Kesong,0,1,0,0
1683702099598,NANO 114,A00,202069,Jahed Motlagh; Zeinab,2,0,10,8
1683702100625,PHIL 1,A00,186955,Grush; Rick Scott,31,0,40,9
1683702101651,PHIL 10,A01,186973,Grush; Rick Scott,27,0,35,8
1683702101651,PHIL 10,A02,186974,Grush; Rick Scott,33,0,35,2
1683702102681,PHIL 13,A01,186976,Staff,1,0,35,34
1683702102681,PHIL 13,A02,186977,Staff,16,0,35,19
1683702103706,PHIL 14,A01,186979,Staff,30,0,35,5
1683702103706,PHIL 14,A02,186986,Staff,32,0,35,3
1683702104732,PHIL 28,A01,186988,Staff,16,0,30,14
1683702104732,PHIL 28,A02,186989,Staff,1,0,30,29
1683702104732,PHIL 28,A03,186990,Staff,10,0,30,20
1683702104732,PHIL 28,A04,186991,Staff,26,0,30,4
1683702105758,PHIL 120,A00,186997,Staff,23,0,40,17
1683702106787,PHIL 137,A00,187003,Staff,7,0,40,33
1683702107815,PHIL 150,A00,187015,Staff,47,0,70,23
1683702108844,PHIL 167,A00,187021,Lamey; Andy M.,34,0,40,6
1683702109869,PHIL 174,A01,202226,Staff,17,0,20,3
1683702109869,PHIL 174,A02,202235,Staff,20,0,20,0
1683702110894,PHIL 191A,A00,258918,Staff,0,0,1,1
1683702111918,PHYS 1A,A00,187028,Staff,26,0,60,34
1683702112948,PHYS 1AL,001,187036,Staff,3,0,30,27
1683702112948,PHYS 1AL,002,187049,Staff,18,0,30,12
1683702113972,PHYS 1B,A00,187058,Staff,21,0,60,39
1683702114996,PHYS 1BL,001,187064,Staff,0,1,30,30
1683702114996,PHYS 1BL,002,187070,Staff,4,0,30,26
1683702116021,PHYS 1C,A00,187082,Staff,30,0,120,90
1683702117046,PHYS 1CL,001,187088,Staff,0,9,30,30
1683702117046,PHYS 1CL,002,187089,Staff,0,1,30,30
1683702117046,PHYS 1CL,009,262693,Staff,9,0,30,21
1683702118076,PHYS 2B,A01,187097,Staff,55,0,115,60
1683702119103,PHYS 2C,A01,187099,Staff,63,0,115,52
1683702120129,PHYS 2CL,A01,187101,Staff,5,0,28,23
1683702120129,PHYS 2CL,A02,187102,Staff,15,0,28,13
1683702121157,PHYS 2D,A01,187123,Shotwell; Brian,95,0,115,20
1683702122184,PHYS 4B,A01,187133,Grinstein; Benjamin,35,0,50,15
1683702123209,POLI 10,A00,188819,Staff,0,4,50,50
1683702124238,POLI 11,A00,188827,Staff,43,0,50,7
1683702125263,POLI 13R,A00,188828,Staff,0,1,20,20
1683702126293,POLI 27,A01,188830,Elgin; Samuel Zincke,0,2,70,70
1683702127378,POLI 30,A00,188832,Desposato; Scott,30,0,50,20
1683702128403,POLI 102F,A00,188834,Staff,1,0,40,39
1683702129432,POLI 104A,A00,188852,Staff,12,0,30,18
1683702130457,POLI 104I,A00,188853,Staff,0,8,20,20
1683702131485,POLI 110B,A00,188854,Wiens; David,6,0,20,14
1683702132514,POLI 112A,A00,188855,Wiens; David,3,0,30,27
1683702133540,POLI 117R,A00,188856,Forman; Fonna,0,12,20,20
1683702134565,POLI 118,A00,188857,Ingham; Sean,8,0,20,12
1683702135590,POLI 120G,A00,188858,Staff,8,0,30,22
1683702136617,POLI 131CR,A00,188863,Hoston; Germaine,20,0,50,30
1683702137645,POLI 133,A00,188864,Nellis; Gareth Hb,44,0,50,6
1683702138674,POLI 134D,A00,188865,Desposato; Scott,27,0,30,3
1683702139700,POLI 142A,A00,188871,Gartzke; Erik,21,0,50,29
1683702140725,POLI 142K,A00,188874,Staff,38,0,50,12
1683702141752,POLI 143,A00,188940,Gartzke; Erik,15,0,30,15
1683702142787,POLI 153,A00,188943,Staff,1,0,20,19
1683702143812,POLI 160AA,A00,188944,Staff,10,0,40,30
1683702144838,POLI 170A,A00,188945,Staff,10,0,30,20
1683702146894,PSYC 1,A00,188952,Staff,36,0,90,54
1683702147920,PSYC 2,B00,188953,Staff,19,0,35,16
1683702148944,PSYC 6,A00,188970,Staff,47,0,60,13
1683702149969,PSYC 7,A00,188973,Staff,35,0,45,10
1683702151015,PSYC 60,A01,188980,Rickard; Timothy C.,42,0,60,18
1683702152039,PSYC 70,A01,189001,Steiner; Eric Tomas,22,0,45,23
1683702153066,PSYC 100,A00,189005,Lacefield; Katharine I,0,98,120,120
1683702154090,PSYC 102,A00,189008,Staff,6,0,30,24
1683702155115,PSYC 106,B00,189026,Gorman; Michael R.,27,0,60,33
1683702156138,PSYC 114,B01,189033,Winkielman; Piotr,0,31,30,30
1683702157167,PSYC 131,A00,189036,Anagnostaras; Stephan,0,44,60,60
1683702158197,PSYC 136,A00,189041,Lowe; Angela Beth,0,7,25,25
1683702159221,PSYC 137,A00,189057,Winkielman; Piotr,0,36,25,25
1683702160245,PSYC 144,A00,189107,Wixted; John T,0,11,50,50
1683702162299,PSYC 162,A00,189142,Staff,0,9,85,85
1683702163325,PSYC 172,A00,189144,Gorman; Michael R.,0,6,30,30
1683702165381,PSYC 179,A00,189146,Lacefield; Katharine I,0,88,120,120
1683702166405,PSYC 181,A00,189147,Anagnostaras; Stephan,0,45,90,90
1683702167430,PSYC 190R,A00,189148,Barner; David A.,0,23,80,80
1683702168457,PSYC 191,A00,189275,Rickard; Timothy C.,0,11,25,25
1683702169482,PSYC 193,A00,189276,Chapman; Eddie Nathaniel,0,1,0,4
1683702170507,PSYC 193L,A01,189281,Lowe; Angela Beth,8,0,20,12
1683702170507,PSYC 193L,B01,189285,Staff,28,0,35,7
1683702171532,RELI 149,A00,187137,Rahimi; Babak,6,0,40,34
1683702172563,SE 9,A01,187315,Staff,0,2,18,18
1683702173586,SE 101B,A00,187409,Staff,24,0,30,6
1683702174611,SE 110B,A00,187444,Staff,10,0,40,30
1683702175636,SE 130B,A00,187449,Staff,31,0,40,9
1683702176665,SE 150A,A00,187516,Staff,8,0,20,12
1683702177690,SE 154,A00,187528,Staff,29,0,50,21
1683702178714,SIO 3,A01,258171,Staff,35,0,40,5
1683702179741,SIO 10,A00,187144,Cook; Geoffrey W,0,6,75,75
1683702180769,SIO 45,A00,187152,Cook; Geoffrey W,1,7,100,99
1683702181797,SIO 109R,A00,194486,Staff,0,4,20,20
1683702183853,SIO 187,A01,187233,Kacev; David,12,0,40,28
1683702184878,SOCI 1,A01,258656,Thorpe; Charles Robert,28,0,30,2
1683702184878,SOCI 1,A02,258658,Thorpe; Charles Robert,30,0,30,0
1683702184878,SOCI 1,A03,258661,Thorpe; Charles Robert,25,0,25,0
1683702184878,SOCI 1,A04,258666,Thorpe; Charles Robert,22,0,25,3
1683702184878,SOCI 1,A05,258897,Thorpe; Charles Robert,22,0,25,3
1683702184878,SOCI 1,A06,258898,Thorpe; Charles Robert,25,0,25,0
1683702185904,SOCI 30,A01,258903,Pardo Guerra; Juan Pablo,14,0,30,16
1683702186934,SOCI 102,A00,258904,Staff,9,0,25,16
1683702187960,SOCI 106,A00,258905,Staff,19,0,25,6
1683702188985,SOCI 111,A00,258907,Ribas Norris; Janet Vanesa,26,0,30,4
1683702190014,SOCI 121R,A00,258908,Pardo Guerra; Juan Pablo,7,0,30,23
1683702191044,SOCI 126,A01,203330,Staff,14,0,20,6
1683702192073,SOCI 131,A00,258909,Thorpe; Charles Robert,30,0,60,30
1683702193101,SOCI 135,A00,258910,Payne; Christine Anna,0,13,30,30
1683702194130,SOCI 157,A00,258911,Staff,10,0,30,20
1683702195156,SOCI 184,A00,258912,Staff,25,0,30,5
1683702196185,SOCI 188D,A00,258913,Staff,22,0,30,8
1683702197209,SYN 2,001,187529,Staff,9,0,16,7
1683702197209,SYN 2,002,201452,Staff,0,20,16,16
1683702197209,SYN 2,003,201469,Staff,1,0,16,15
1683702198232,SYN 100,A01,187531,Staff,0,9,20,20
1683702198232,SYN 100,B01,201491,Staff,0,10,20,20
1683702199255,TDAC 1,A00,189286,Walsh; Kim C.,3,0,20,17
1683702199255,TDAC 1,B00,189287,Harting; Carla Kelso,10,0,20,10
1683702200278,TDAC 101,A00,189300,Walsh; Kim C.,16,0,20,4
1683702200278,TDAC 101,B00,189301,Harting; Carla Kelso,18,0,20,2
1683702201302,TDAC 102,A00,189304,Basso; Beatrice,14,0,20,6
1683702202327,TDAC 108,A00,189305,Staff,18,0,20,2
1683702203351,TDDE 131,A00,189310,Staff,19,0,20,1
1683702203351,TDDE 131,B00,189314,Staff,19,0,20,1
1683702203351,TDDE 131,C00,189315,Staff,48,0,50,2
1683702203351,TDDE 131,D00,189316,Staff,14,0,15,1
1683702203351,TDDE 131,E00,204841,Staff,20,0,20,0
1683702204377,TDGE 10,A00,189289,Staff,27,0,50,23
1683702204377,TDGE 10,B00,189290,Havis; Allan,0,1,50,50
1683702205401,TDGE 11,A00,189291,Fulton; Julia,0,4,50,50
1683702205401,TDGE 11,B00,189292,Staff,20,0,25,5
1683702205401,TDGE 11,C00,260270,Staff,0,0,0,0
1683702206425,TDGE 25,A00,189294,Staff,1,0,20,19
1683702207450,TDGE 124,A00,189318,Fulton; Julia,0,7,50,50
1683702208475,TDGE 125,A00,189319,Staff,13,0,25,12
1683702208475,TDGE 125,B00,189320,Staff,23,0,25,2
1683702209505,TDGE 127,A00,189322,Havis; Allan,1,0,50,49
1683702210534,TDHT 101,A00,189323,Staff,18,0,25,7
1683702210534,TDHT 101,B00,189324,Staff,25,0,25,0
1683702211559,TDHT 102,A00,189325,Staff,49,0,50,1
1683702212583,TDMV 1,A00,189295,Arcidiacono; Kristin,20,0,30,10
1683702212583,TDMV 1,B00,189296,Caligagan; Maria T.,23,0,30,7
1683702213608,TDMV 2,A00,189297,Sammartano; Tonnie,27,0,30,3
1683702213608,TDMV 2,B00,189299,Arcidiacono; Kristin,23,0,30,7
1683702214634,TDMV 3,A00,204998,Rincon; Alicia,22,0,30,8
1683702215659,TDMV 120,A00,189458,Sammartano; Tonnie,28,0,30,2
1683702216692,TDMV 138,A00,189541,Jun; Grace Shin Hae,20,0,40,20
1683702217717,TDMV 142,A00,189717,Caligagan; Tony,25,0,30,5
1683702217717,TDMV 142,B00,189718,Caligagan; Maria T.,25,0,30,5
1683702218746,TMC 2,A01,187533,Staff,25,0,25,0
1683702218746,TMC 2,A02,187534,Staff,25,0,25,0
1683702219771,USP 1,A01,187536,Kwak; Nancy,0,16,25,25
1683702220796,USP 5,A01,187538,Staff,8,0,25,17
1683702221821,USP 101,A00,199253,Staff,0,4,0,0
1683702222846,USP 124,A00,187562,Boomhower; Matthew Charles,0,0,30,30
1683702223875,USP 138,A00,187582,Staff,19,0,25,6
1683702224899,USP 152,A01,187597,Staff,3,0,25,22
1683702225922,USP 153,A00,187598,Staff,18,0,25,7
1683702226945,USP 168,A00,187607,Kwak; Nancy,2,0,5,3
1683702227970,USP 173,A00,187619,Staff,4,0,25,21
1683702228995,USP 181,A00,187638,Staff,0,4,25,25
1683702230020,VIS 103,A00,187650,Cruz; Edwin Teddy,17,0,75,58
1683702231120,VIS 110D,A00,187669,Staff,13,0,22,9
1683702232144,VIS 127C,A00,187720,Shen; Kuiyi,67,0,146,79
1683702233173,VIS 149,A00,187731,Yoldas; Pinar,0,12,22,22
1683702234197,VIS 151,A01,188091,Staff,22,0,34,12
1683702234197,VIS 151,A02,188092,Staff,11,0,34,23
1683702235225,VIS 160B,A00,188093,Stalbaum; Brett,0,1,10,10
1683702237278,WCWP 10B,A00,201720,Staff,0,0,5,5
1683702237278,WCWP 10B,B00,201722,Staff,0,0,6,6
1683702238305,WCWP 100,A00,201725,Gagnon; Jeffrey C,0,0,2,2
1683702238305,WCWP 100,B00,201727,Staff,0,4,15,15
1683702241419,ANBI 133,A00,258401,Wilder; Linnea Lorene,34,0,40,6
1683702242449,ANBI 140,A00,258395,Hrvoj Mihic; Branka,18,0,25,7
1683702243479,ANSC 120,A00,258402,Bialecki; Jon Anthony,26,0,40,14
1683702244505,ANSC 144,A00,258400,Staff,12,0,40,28
1683702246555,ANSC 166,A00,258396,Parish; Steven Martin,156,0,175,19
1683702247579,ANSC 180,A00,193533,Staff,8,0,20,12
1683702248604,ANSC 188,A00,258397,Jassal; Aftab,34,0,40,6
1683702249633,ANTH 3,A01,258316,Staff,23,0,30,7
1683702250658,ANTH 5,A00,258394,Semendeferi; Ekaterini,16,0,20,4
1683702251686,ANTH 21,A01,258331,Staff,4,0,40,36
1683702252715,ANTH 103,A00,258398,Varma; Saiba,15,0,25,10
1683702253747,AWP 10,001,202034,Staff,0,0,0,0
1683702253747,AWP 10,002,202035,Staff,0,0,0,0
1683702253747,AWP 10,003,202036,Staff,0,0,0,0
1683702253747,AWP 10,004,202037,Staff,0,0,0,0
1683702253747,AWP 10,005,202038,Staff,0,0,0,0
1683702253747,AWP 10,006,202039,Staff,0,0,0,0
1683702253747,AWP 10,007,202040,Staff,0,0,0,0
1683702253747,AWP 10,008,202041,Staff,0,0,0,0
1683702253747,AWP 10,009,202042,Staff,0,0,0,0
1683702253747,AWP 10,010,202043,Staff,0,0,0,0
1683702253747,AWP 10,011,202044,Staff,0,0,0,0
1683702253747,AWP 10,012,202045,Staff,0,0,0,0
1683702253747,AWP 10,013,202046,Staff,0,0,0,0
1683702253747,AWP 10,014,202047,Staff,0,0,0,0
1683702253747,AWP 10,015,202048,Staff,0,0,0,0
1683702253747,AWP 10,016,202049,Staff,0,0,0,0
1683702253747,AWP 10,017,202050,Staff,0,0,0,0
1683702253747,AWP 10,018,202051,Staff,0,0,0,0
1683702253747,AWP 10,019,202052,Staff,0,0,0,0
1683702253747,AWP 10,020,202053,Staff,0,0,0,0
1683702253747,AWP 10,021,202054,Staff,0,0,0,0
1683702253747,AWP 10,022,202055,Staff,0,0,0,0
1683702253747,AWP 10,023,202056,Staff,0,0,0,0
1683702253747,AWP 10,024,202057,Staff,0,0,0,0
1683702253747,AWP 10,025,202058,Staff,0,0,0,0
1683702253747,AWP 10,026,202059,Staff,0,0,0,0
1683702254776,AWP 102,001,202032,Staff,0,0,0,0
1683702254776,AWP 102,002,202033,Staff,0,0,0,0
1683702255819,BENG 100,A01,254234,Taylor Amos; Alyssa C,31,0,40,9
1683702256846,BENG 196,001,270013,Engler; Adam J.,9999,0,9999,0
1683702257877,BICD 100R,A01,202018,Smith; Laurie,0,7,32,32
1683702257877,BICD 100R,A02,202019,Smith; Laurie,0,3,32,32
1683702257877,BICD 100R,A03,202020,Smith; Laurie,0,1,32,32
1683702257877,BICD 100R,A04,202021,Smith; Laurie,6,0,32,26
1683702257877,BICD 100R,A05,202022,Smith; Laurie,10,0,32,22
1683702258908,BICD 136,A01,193242,Gustafson-Brown; Cindy,0,2,32,32
1683702258908,BICD 136,A02,193244,Gustafson-Brown; Cindy,13,0,32,19
1683702259932,BIEB 102,A01,193249,Butler; Shannon Rhey,0,0,32,32
1683702259932,BIEB 102,A02,193251,Butler; Shannon Rhey,0,0,32,32
1683702259932,BIEB 102,A03,193253,Butler; Shannon Rhey,0,0,32,32
1683702259932,BIEB 102,A04,193255,Butler; Shannon Rhey,13,0,32,19
1683702259932,BIEB 102,A05,193265,Butler; Shannon Rhey,25,0,32,7
1683702259932,BIEB 102,A06,193269,Butler; Shannon Rhey,12,0,32,20
1683702261984,BIEB 150,A01,193274,Staff,0,0,32,32
1683702261984,BIEB 150,A02,193285,Staff,24,0,32,8
1683702263010,BIEB 194,A00,193286,Kurle; Carolyn M.,19,0,32,13
1683702264040,BILD 1,A01,192291,Staff,15,0,32,17
1683702264040,BILD 1,A02,192292,Staff,30,0,32,2
1683702264040,BILD 1,B01,192520,Reuther; Keefe,0,1,0,0
1683702264040,BILD 1,B02,192532,Reuther; Keefe,0,1,0,0
1683702265067,BILD 3,A01,192556,Butler; Shannon Rhey,0,0,32,32
1683702265067,BILD 3,A02,192581,Butler; Shannon Rhey,0,1,32,32
1683702265067,BILD 3,A03,192611,Butler; Shannon Rhey,19,0,32,13
1683702265067,BILD 3,A04,192612,Butler; Shannon Rhey,23,0,32,9
1683702265067,BILD 3,A05,192613,Butler; Shannon Rhey,26,0,32,6
1683702265067,BILD 3,A06,192679,Butler; Shannon Rhey,27,0,32,5
1683702265067,BILD 3,A07,192682,Butler; Shannon Rhey,20,0,32,12
1683702266092,BILD 4,A01,192836,Reuther; Keefe,1,0,24,23
1683702266092,BILD 4,A02,193044,Reuther; Keefe,4,0,24,20
1683702267118,BILD 10,A01,193142,Gustafson-Brown; Cindy,29,0,32,3
1683702267118,BILD 10,A02,193149,Gustafson-Brown; Cindy,31,0,32,1
1683702268142,BIMM 100,A01,193301,Staff,0,6,32,32
1683702268142,BIMM 100,A02,193312,Staff,0,7,32,32
1683702268142,BIMM 100,A03,193323,Staff,0,10,32,32
1683702269168,BIMM 101,A01,193329,McDonnell; Lisa Marie,0,3,24,24
1683702269168,BIMM 101,A02,193339,McDonnell; Lisa Marie,0,3,24,24
1683702269168,BIMM 101,B01,193354,McDonnell; Lisa Marie,0,4,24,24
1683702269168,BIMM 101,B02,193357,McDonnell; Lisa Marie,0,3,24,24
1683702270193,BIMM 110,A01,193377,Tat; John,0,11,32,32
1683702270193,BIMM 110,A02,193378,Tat; John,0,11,32,32
1683702271217,BIMM 120,A01,206116,Staff,0,0,32,32
1683702271217,BIMM 120,A02,206117,Staff,7,0,32,25
1683702271217,BIMM 120,A03,206121,Staff,21,0,32,11
1683702272249,BIPN 100,A01,193393,Park; Ji Young,0,15,32,32
1683702272249,BIPN 100,A02,193402,Park; Ji Young,0,14,32,32
1683702272249,BIPN 100,A03,193413,Park; Ji Young,0,14,32,32
1683702272249,BIPN 100,A04,193414,Park; Ji Young,0,13,32,32
1683702273275,BIPN 102,A01,193429,Staff,0,0,32,32
1683702273275,BIPN 102,A02,193438,Staff,18,0,32,14
1683702274298,BIPN 106,A01,193450,Reyes Gonzalez; Catalina,0,2,40,40
1683702275324,BIPN 134,A01,193465,Cooke; James Edward,0,0,32,32
1683702275324,BIPN 134,A02,193474,Cooke; James Edward,25,0,32,7
1683702275324,BIPN 134,A03,193485,Cooke; James Edward,29,0,32,3
1683702275324,BIPN 134,A04,193486,Cooke; James Edward,20,0,32,12
1683702275324,BIPN 134,A05,193491,Cooke; James Edward,31,0,32,1
1683702275324,BIPN 134,A06,193501,Cooke; James Edward,30,0,32,2
1683702275324,BIPN 134,A07,193510,Cooke; James Edward,29,0,32,3
1683702277377,BISP 194,A00,222522,Staff,14,0,32,18
1683702278403,CAT 124,A01,202407,Staff,19,0,25,6
1683702279430,CAT 125,A00,202408,Marchisotto; Jennifer Anne,2,0,20,18
1683702280453,CAT 125R,A00,202409,Smith; Lauryn Alissa,0,11,20,20
1683702280453,CAT 125R,B00,202410,Morales; Celeste Georgianna,0,11,20,20
1683702280453,CAT 125R,C00,202411,Irwin; Matthew Joseph,0,12,20,20
1683702281481,CENG 15,A01,204712,Yang; Kesong,0,1,0,0
1683702282510,CENG 114,A00,202070,Jahed Motlagh; Zeinab,5,0,20,15
1683702283538,CGS 105,A00,185477,Wesling; Megan E.,24,0,40,16
1683702284562,CGS 106,A00,185494,Staff,11,0,22,11
1683702285586,CGS 108,A00,185495,Staff,14,0,20,6
1683702286613,CGS 114,A00,185496,Staff,13,0,18,5
1683702287637,CGS 119,A00,185501,Staff,15,0,20,5
1683702288667,CGS 120,A00,185511,Staff,11,0,20,9
1683702289693,CHEM 4,A01,184675,Bussey; Thomas J,97,0,100,3
1683702290718,CHEM 6A,A01,184677,Staff,32,0,60,28
1683702291746,CHEM 6B,A01,184679,Staff,63,0,100,37
1683702292772,CHEM 6C,A01,184681,Bussey; Thomas J,0,0,50,50
1683702292772,CHEM 6C,A02,184682,Bussey; Thomas J,32,0,50,18
1683702293799,CHEM 40A,A01,184684,Albizati; Kim F.,33,0,100,67
1683702294824,CHEM 40B,A01,184686,Albizati; Kim F.,0,22,100,100
1683702295849,CHEM 41B,A01,184690,Staff,51,0,100,49
1683702296878,COGS 3,A01,184715,Boyle; Mary E. T.,0,27,40,40
1683702297906,COGS 14B,A01,185172,Staff,0,14,38,38
1683702298936,COGS 18,A01,184736,Staff,14,0,80,66
1683702299961,COGS 100,A01,184932,Staff,0,8,73,73
1683702300989,COGS 101A,A01,184935,Staff,0,40,30,30
1683702302015,COGS 101B,A01,184944,Staff,0,2,30,30
1683702303045,COGS 101C,A01,184946,Staff,0,10,30,30
1683702304071,COGS 102A,A01,184951,Johnson; Christine M.,1,0,40,39
1683702305094,COGS 107B,A01,184953,Mooshagian; Eric Frederick,0,52,40,40
1683702306118,COGS 118B,A01,184959,Gupta; Anjum,0,50,40,40
1683702307143,COGS 153,A00,184961,Staff,1,16,30,29
1683702308173,COGS 177,A00,184962,Staff,0,20,30,30
1683702309198,COGS 187A,A01,184969,Boyle; Mary E. T.,0,19,40,40
1683702310226,COMM 10,A01,185174,Staff,0,5,25,25
1683702310226,COMM 10,A02,185189,Staff,0,2,25,25
1683702310226,COMM 10,A03,269821,Staff,0,1,0,0
1683702311256,COMM 100B,A02,185476,Staff,10,0,25,15
1683702311256,COMM 100B,A03,277340,Staff,25,0,25,0
1683702312280,COMM 100C,A01,185314,Staff,2,0,25,23
1683702312280,COMM 100C,A02,185327,Staff,17,0,25,8
1683702313307,COMM 110M,A00,185349,Staff,0,0,40,40
1683702314330,COMM 113T,A00,185352,Staff,25,0,40,15
1683702315354,COMM 114I,A00,185353,Staff,31,0,40,9
1683702316386,COMM 131,A00,185354,Staff,17,0,30,13
1683702317412,CSE 8A,A50,185358,Cao; Yingjun,0,46,10,10
1683702318437,CSE 8B,A01,185362,Staff,0,48,50,50
1683702319462,CSE 11,A01,185416,Cao; Yingjun,0,91,10,10
1683702320486,CSE 20,A01,185445,Briones; Jor-el Thomas Caparas,3,0,25,22
1683702321512,CSE 21,A01,185447,Staff,9,0,50,41
1683702322538,CSE 101,A01,185451,Staff,0,13,50,50
1683702322538,CSE 101,B01,185453,Jones; Miles E,0,15,50,50
1683702324591,CSE 141,A01,185458,Eldon; John,16,0,100,84
1683702325626,CSE 141L,A01,185461,Eldon; John,8,0,100,92
1683702326651,CSE 142,A01,185463,Staff,34,0,60,26
1683702326651,CSE 142,B01,201355,Staff,0,7,60,60
1683702327676,CSE 142L,A01,185470,Staff,34,0,60,26
1683702327676,CSE 142L,B01,201417,Staff,0,6,60,60
1683702328704,CSE 190,A00,201433,Staff,32,0,49,17
1683702329729,DOC 1,A01,259136,Strom; Megan C.,7,0,15,8
1683702329729,DOC 1,A02,259137,Strom; Megan C.,14,0,15,1
1683702329729,DOC 1,A03,259138,Strom; Megan C.,14,0,15,1
1683702329729,DOC 1,A04,259139,Strom; Megan C.,14,0,15,1
1683702330753,DOC 100D,A00,259140,Pass; Natalye Joann,14,0,25,11
1683702331781,DSGN 1,A01,184749,Rill; Bryan,0,26,30,30
1683702332806,DSGN 100,A01,185168,Staff,0,2,25,25
1683702333833,ECE 5,A01,185626,Morris; Karcher William,0,12,0,0
1683702334913,ECE 101,A01,185628,Staff,14,0,70,56
1683702335942,ECE 107,A01,185635,Baghdadchi; Saharnaz,0,0,20,20
1683702335942,ECE 107,A02,185638,Baghdadchi; Saharnaz,1,0,20,19
1683702336972,ECE 148,A01,185647,Silberman; Jack,0,0,16,16
1683702337997,ECON 1,A01,185537,Crane; Meredith Helen,54,0,70,16
1683702339021,ECON 3,A01,185549,Crane; Meredith Helen,30,0,70,40
1683702340055,ECON 4,A01,203354,Anderson; John Charles,0,5,10,10
1683702341114,ECON 100A,A01,185574,Staff,0,5,40,40
1683702342139,ECON 100B,A01,185576,Staff,0,12,50,50
1683702343167,ECON 100C,A01,185589,Newhouse; Herbert S,30,0,70,40
1683702344192,ECON 105,A00,185608,Vespa; Emanuel Ignacio,19,0,35,16
1683702345217,ECON 109,A01,185610,Shishkin; Denis,9,0,35,26
1683702346244,ECON 110A,A01,185612,Staff,8,0,40,32
1683702347272,ECON 120A,A01,185615,Staff,19,0,40,21
1683702348297,ECON 120C,A01,185617,Sun; Yixiao,0,21,70,70
1683702349321,ECON 144,A00,203346,Squires; Dale E,2,0,35,33
1683702350345,ECON 171,A01,203349,Newhouse; Herbert S,0,1,35,35
1683702351370,ECON 173A,A01,185621,Toda; Alexis Akira,21,0,35,14
1683702352394,EDS 25,A01,202413,Staff,0,1,0,0
1683702352394,EDS 25,A02,202414,Staff,0,1,0,0
1683702352394,EDS 25,A03,202415,Staff,0,0,0,0
1683702352394,EDS 25,A04,202416,Staff,0,1,0,0
1683702352394,EDS 25,A05,202439,Staff,0,0,0,0
1683702352394,EDS 25,A06,202440,Staff,0,0,0,0
1683702352394,EDS 25,B01,202631,Staff,0,0,0,0
1683702352394,EDS 25,B02,202632,Staff,0,0,0,0
1683702352394,EDS 25,B03,202639,Staff,0,0,0,0
1683702352394,EDS 25,B04,202640,Staff,0,0,0,0
1683702352394,EDS 25,B05,202643,Staff,0,0,0,0
1683702352394,EDS 25,B06,202644,Staff,0,0,0,0
1683702353423,EDS 38,A01,202659,Black; Alison Michelle,25,0,25,0
1683702354449,EDS 115,A00,202652,Staff,18,0,30,12
1683702355479,EDS 125,A00,202649,Staff,13,0,30,17
1683702356504,EDS 126,A01,203332,Staff,30,0,30,0
1683702357528,EDS 139,A00,202838,Staff,16,0,25,9
1683702358554,EDS 146,A01,202655,Staff,14,0,25,11
1683702359583,ENG 15,A00,185667,Staff,0,1,0,0
1683702359583,ENG 15,B00,185672,Staff,0,0,0,0
1683702359583,ENG 15,C00,185675,Staff,0,0,0,0
1683702359583,ENG 15,D00,185682,Staff,0,0,0,0
1683702359583,ENG 15,E00,185684,Staff,0,0,0,0
1683702360612,ETHN 103,A00,185710,Staff,0,8,35,35
1683702361636,ETHN 103A,A00,199228,Man; Simeon S,0,0,9,9
1683702362665,ETHN 109,A00,185711,Staff,15,0,35,20
1683702363694,ETHN 142,A00,185726,Staff,0,4,30,30
1683702364716,ETHN 163J,A00,199229,Man; Simeon S,5,0,8,3
1683702365744,ETHN 168,A00,185727,Staff,7,0,10,3
1683702366769,ETHN 182,A00,185728,Staff,0,0,35,35
1683702367795,ETHN 183,A00,185737,Staff,9,0,18,9
1683702368824,GLBH 111,A01,209361,Burgos; Jose L.,0,0,0,0
1683702370878,HIEU 104,A00,185792,Staff,14,0,20,6
1683702371902,HIEU 115,A00,185800,Staff,0,0,20,20
1683702372927,HIEU 128,A00,185801,Staff,0,9,20,20
1683702373952,HIEU 147,A00,185802,Staff,15,0,20,5
1683702374974,HIEU 154,A00,185823,Staff,11,0,20,9
1683702375998,HILA 102,A00,185826,Staff,14,0,20,6
1683702377029,HILD 2C,A01,185778,Staff,0,13,20,20
1683702378058,HILD 7B,A01,185780,Kwak; Nancy,0,17,32,32
1683702378058,HILD 7B,A02,185781,Kwak; Nancy,0,18,32,32
1683702379081,HILD 30,A01,185791,Staff,12,0,20,8
1683702380110,HISC 119,A00,185830,Golan; Tal,0,10,20,20
1683702381174,HITO 156GS,A00,185831,Patterson; Patrick H.,0,0,0,23
1683702382197,HIUS 103,A00,185832,Man; Simeon S,0,4,20,20
1683702383228,HIUS 117,A00,185836,Kwak; Nancy,2,0,20,18
1683702384256,HIUS 125,A00,185840,Man; Simeon S,0,2,23,23
1683702385286,HIUS 149,A00,185845,Staff,1,0,20,19
1683702386312,HUM 3,A01,185882,Zavodny; Tatiana Sophia,0,8,50,50
1683702386312,HUM 3,B01,185899,Caldwell; Michael Alan,0,18,50,50
1683702387336,HUM 3GS,A00,185900,Patterson; Patrick H.,0,0,0,23
1683702388363,HUM 4,A01,185938,Zroka; Amy Liane,28,0,50,22
1683702388363,HUM 4,B01,185956,Watkins; Eric,0,6,50,50
1683702388363,HUM 4,B02,202209,Watkins; Eric,0,5,50,50
1683702388363,HUM 4,B03,202210,Watkins; Eric,0,5,50,50
1683702389386,HUM 5,A01,185958,West; Geoffrey Scott,0,0,50,50
1683702389386,HUM 5,A02,202215,West; Geoffrey Scott,0,1,50,50
1683702390415,INTL 190,A00,185959,Gagnon; Jeffrey C,0,0,0,9
1683702390415,INTL 190,B00,185960,Lettieri; Michael Joseph,0,0,0,2
1683702391443,JAPN 180,A00,254509,Staff,5,0,30,25
1683702392469,LATI 10,A01,202853,Kennemore; Amy Michelle,4,0,35,31
1683702392469,LATI 10,A02,202854,Kennemore; Amy Michelle,3,0,35,32
1683702392469,LATI 10,A03,270054,Kennemore; Amy Michelle,30,0,30,0
1683702393494,LATI 180,A00,202855,Kennemore; Amy Michelle,11,0,20,9
1683702394518,LAWS 101,A00,201767,Golan; Tal,0,7,40,40
1683702395544,LIFR 1C,A00,185961,Staff,6,0,20,14
1683702396568,LIFR 1CX,A00,185962,Staff,7,0,20,13
1683702397596,LIFR 1D,A00,185963,Staff,7,0,20,13
1683702398625,LIFR 1DX,A00,185964,Staff,7,0,20,13
1683702399650,LIGN 101,A01,186039,Staff,43,0,50,7
1683702400680,LIGN 165,A00,186040,Staff,14,0,50,36
1683702401705,LTCS 108,A00,186041,Staff,5,0,10,5
1683702402730,LTCS 119,A00,186042,Staff,15,0,20,5
1683702403754,LTCS 130,A00,186043,Wesling; Megan E.,15,0,25,10
1683702405802,LTEA 138,A00,186119,Staff,14,0,40,26
1683702406828,LTEN 124,A00,186148,Staff,5,0,25,20
1683702407857,LTEN 178,A00,186149,Staff,6,0,15,9
1683702408882,LTEN 181,A00,186150,Blanco; John D,34,0,40,6
1683702409907,LTWL 120,A00,186160,Staff,19,0,25,6
1683702410932,LTWL 165,A00,186161,Staff,22,0,25,3
1683702411957,LTWR 100,A00,186162,Staff,0,5,15,15
1683702412982,LTWR 102,A00,186163,Doller; Ben,5,0,15,10
1683702414006,MAE 8,A01,186412,Staff,0,1,0,0
1683702415032,MAE 30B,A00,186445,Bahadori; Mohammad Yousef,81,0,100,19
1683702416057,MAE 40,A00,186592,Bewley; Thomas R,10,0,50,40
1683702417081,MAE 101B,A00,186593,Bahadori; Mohammad Yousef,80,0,100,20
1683702418106,MAE 105,A00,186594,Bandaru; Prabhakar,10,0,50,40
1683702419130,MAE 107,A00,186599,Pham; Hieu Tan,0,8,120,120
1683702420158,MAE 148,A01,186660,Silberman; Jack,3,0,16,13
1683702421325,MATH 10A,A01,188095,Staff,0,6,35,35
1683702422351,MATH 10B,A01,188097,Bowers; Adam R.,0,12,30,30
1683702422351,MATH 10B,A02,188099,Bowers; Adam R.,0,11,30,30
1683702422351,MATH 10B,B01,188104,Bowers; Adam R.,0,10,30,30
1683702422351,MATH 10B,B02,188106,Bowers; Adam R.,0,9,30,30
1683702423376,MATH 10C,A01,188111,Staff,0,20,30,30
1683702423376,MATH 10C,A02,188127,Staff,0,19,30,30
1683702423376,MATH 10C,A03,188131,Staff,0,19,30,30
1683702423376,MATH 10C,B01,188218,Staff,17,0,30,13
1683702423376,MATH 10C,B02,188244,Staff,13,0,30,17
1683702423376,MATH 10C,B03,188277,Staff,14,0,30,16
1683702424413,MATH 18,A01,188344,Bach; Quang Tran,18,0,30,12
1683702424413,MATH 18,A02,188345,Bach; Quang Tran,11,0,30,19
1683702424413,MATH 18,B01,188353,Bach; Quang Tran,11,0,30,19
1683702424413,MATH 18,B02,188354,Bach; Quang Tran,19,0,30,11
1683702425437,MATH 20A,A01,188374,Staff,11,0,35,24
1683702426462,MATH 20B,A01,188382,Ohm; Ko Woon,7,0,30,23
1683702426462,MATH 20B,A02,188383,Ohm; Ko Woon,22,0,30,8
1683702426462,MATH 20B,B01,188385,Ohm; Ko Woon,7,0,30,23
1683702426462,MATH 20B,B02,188392,Ohm; Ko Woon,22,0,30,8
1683702427490,MATH 20C,A01,188394,Harel; Guershon,10,0,30,20
1683702427490,MATH 20C,A02,188395,Harel; Guershon,13,0,30,17
1683702427490,MATH 20C,B01,188404,Harel; Guershon,5,0,30,25
1683702427490,MATH 20C,B02,188405,Harel; Guershon,18,0,30,12
1683702428523,MATH 20D,A01,188414,Hammock; Frances H,0,1,30,30
1683702428523,MATH 20D,A02,188415,Hammock; Frances H,0,1,30,30
1683702428523,MATH 20D,B01,188447,Hammock; Frances H,0,1,30,30
1683702428523,MATH 20D,B02,188486,Hammock; Frances H,2,0,30,28
1683702429548,MATH 20E,A01,188649,Staff,21,0,30,9
1683702429548,MATH 20E,A02,188650,Staff,20,0,30,10
1683702429548,MATH 20E,A03,188673,Staff,0,0,30,30
1683702430572,MATH 102,A01,188675,Staff,0,40,35,35
1683702431601,MATH 103B,A01,188681,Staff,3,0,35,32
1683702431601,MATH 103B,B01,188692,Staff,5,0,35,30
1683702432636,MATH 109,A01,188695,Salehi Golsefidy; Alireza,24,0,35,11
1683702432636,MATH 109,A02,188696,Salehi Golsefidy; Alireza,25,0,35,10
1683702433661,MATH 120A,A01,188698,Eggers; John Dietrich,7,0,35,28
1683702434685,MATH 142B,A01,188736,Ioana; Adrian,0,0,30,30
1683702434685,MATH 142B,A02,188741,Ioana; Adrian,0,1,30,30
1683702434685,MATH 142B,A03,188743,Ioana; Adrian,0,2,30,30
1683702435712,MATH 168A,A01,188790,Staff,0,11,35,35
1683702436745,MATH 170A,A01,188803,Nie; Jiawang,0,2,35,35
1683702436745,MATH 170A,A02,188811,Nie; Jiawang,0,1,35,35
1683702436745,MATH 170A,A03,188814,Nie; Jiawang,0,0,35,35
1683702436745,MATH 170A,A04,188815,Nie; Jiawang,5,0,35,30
1683702437770,MATH 193B,A01,188817,Staff,0,0,35,35
1683702437770,MATH 193B,A02,188818,Staff,6,0,35,29
1683702438851,MGT 4,A01,202857,Anderson; John Charles,59,0,80,21
1683702439874,MGT 12,A00,202858,Lindenberger; Wade Douglas,40,0,90,50
1683702440898,MGT 18,A00,202859,Staff,73,0,90,17
1683702441922,MGT 18GS,A00,202860,McKay; Michael J,13,0,28,15
1683702442951,MGT 45,A00,202861,Pecore; Joseph P.,8,0,90,82
1683702443978,MGT 100,A00,202863,Yavorsky; Daniel Ryan,27,0,90,63
1683702445007,MGT 103,A00,202864,Ehrich; Kristine R,0,19,90,90
1683702446032,MGT 112,A00,202865,Ehrich; Kristine R,15,0,90,75
1683702447057,MGT 121A,A00,202868,Staff,70,0,90,20
1683702448080,MGT 131B,A00,202869,Anderson; John Charles,58,0,90,32
1683702449105,MGT 136,A00,202871,Lindenberger; Wade Douglas,83,0,90,7
1683702450130,MGT 164,A00,202873,Staff,0,67,90,91
1683702451156,MGT 164GS,A00,202874,McKay; Mary A,13,0,28,15
1683702452180,MGT 180,A00,202875,Staff,0,51,90,91
1683702453206,MMW 11R,A01,205019,Herbst; Matthew,0,0,30,30
1683702453206,MMW 11R,A02,205026,Herbst; Matthew,29,0,30,1
1683702454237,MMW 15,A01,193512,Chang; Edmond Yi-Teh,0,8,28,28
1683702454237,MMW 15,A02,193513,Chang; Edmond Yi-Teh,0,5,28,28
1683702454237,MMW 15,A03,193514,Chang; Edmond Yi-Teh,0,5,28,28
1683702454237,MMW 15,A04,193515,Chang; Edmond Yi-Teh,0,5,28,28
1683702454237,MMW 15,A05,193516,Chang; Edmond Yi-Teh,0,5,28,28
1683702454237,MMW 15,A06,193517,Chang; Edmond Yi-Teh,0,6,28,28
1683702454237,MMW 15,B01,193519,Chang; Edmond Yi-Teh,0,5,28,28
1683702454237,MMW 15,B02,193520,Chang; Edmond Yi-Teh,0,5,28,28
1683702454237,MMW 15,B03,193521,Chang; Edmond Yi-Teh,0,5,28,28
1683702454237,MMW 15,B04,193522,Chang; Edmond Yi-Teh,0,6,28,28
1683702454237,MMW 15,B05,193523,Chang; Edmond Yi-Teh,0,5,28,28
1683702454237,MMW 15,B06,193524,Chang; Edmond Yi-Teh,0,5,28,28
1683702455262,MMW 122,A01,193526,Rahimi; Babak,0,16,28,28
1683702455262,MMW 122,A02,193527,Rahimi; Babak,0,15,28,28
1683702455262,MMW 122,A03,193528,Rahimi; Babak,0,0,0,0
1683702455262,MMW 122,A04,193529,Rahimi; Babak,0,0,0,0
1683702456288,MUS 1A,A01,186663,Staff,0,18,35,35
1683702457317,MUS 4,A01,186715,Staff,0,12,35,35
1683702458344,MUS 5R,A01,186796,Dubnov; Shlomo,0,17,35,35
1683702459373,MUS 6,A01,186798,Staff,0,4,25,25
1683702460397,MUS 7,A01,186830,Staff,11,0,35,24
1683702461421,MUS 8,A01,186930,Staff,0,27,35,35
1683702462450,MUS 15,A01,186932,Staff,0,15,35,35
1683702462450,MUS 15,B01,186934,Staff,0,16,35,35
1683702463480,MUS 80,A00,186935,Staff,0,0,20,20
1683702463480,MUS 80,B00,186936,Staff,24,0,25,1
1683702464505,NANO 11,A00,204702,Lipomi; Darren John,0,0,0,0
1683702465535,NANO 15,A01,204709,Yang; Kesong,0,1,0,0
1683702466560,NANO 114,A00,202069,Jahed Motlagh; Zeinab,2,0,10,8
1683702467585,PHIL 1,A00,186955,Grush; Rick Scott,31,0,40,9
1683702468611,PHIL 10,A01,186973,Grush; Rick Scott,27,0,35,8
1683702468611,PHIL 10,A02,186974,Grush; Rick Scott,33,0,35,2
1683702469640,PHIL 13,A01,186976,Staff,1,0,35,34
1683702469640,PHIL 13,A02,186977,Staff,16,0,35,19
1683702470667,PHIL 14,A01,186979,Staff,30,0,35,5
1683702470667,PHIL 14,A02,186986,Staff,32,0,35,3
1683702471691,PHIL 28,A01,186988,Staff,16,0,30,14
1683702471691,PHIL 28,A02,186989,Staff,0,0,30,30
1683702471691,PHIL 28,A03,186990,Staff,10,0,30,20
1683702471691,PHIL 28,A04,186991,Staff,26,0,30,4
1683702472719,PHIL 120,A00,186997,Staff,23,0,40,17
1683702473749,PHIL 137,A00,187003,Staff,7,0,40,33
1683702474778,PHIL 150,A00,187015,Staff,47,0,70,23
1683702475806,PHIL 167,A00,187021,Lamey; Andy M.,34,0,40,6
1683702476834,PHIL 174,A01,202226,Staff,17,0,20,3
1683702476834,PHIL 174,A02,202235,Staff,20,0,20,0
1683702477859,PHIL 191A,A00,258918,Staff,0,0,1,1
1683702478884,PHYS 1A,A00,187028,Staff,26,0,60,34
1683702479909,PHYS 1AL,001,187036,Staff,3,0,30,27
1683702479909,PHYS 1AL,002,187049,Staff,18,0,30,12
1683702480933,PHYS 1B,A00,187058,Staff,21,0,60,39
1683702481960,PHYS 1BL,001,187064,Staff,0,1,30,30
1683702481960,PHYS 1BL,002,187070,Staff,4,0,30,26
1683702482989,PHYS 1C,A00,187082,Staff,30,0,120,90
1683702484020,PHYS 1CL,001,187088,Staff,0,9,30,30
1683702484020,PHYS 1CL,002,187089,Staff,0,1,30,30
1683702484020,PHYS 1CL,009,262693,Staff,9,0,30,21
1683702485048,PHYS 2B,A01,187097,Staff,55,0,115,60
1683702486073,PHYS 2C,A01,187099,Staff,63,0,115,52
1683702487104,PHYS 2CL,A01,187101,Staff,5,0,28,23
1683702487104,PHYS 2CL,A02,187102,Staff,15,0,28,13
1683702488127,PHYS 2D,A01,187123,Shotwell; Brian,95,0,115,20
1683702489152,PHYS 4B,A01,187133,Grinstein; Benjamin,35,0,50,15
1683702490177,POLI 10,A00,188819,Staff,0,4,50,50
1683702491202,POLI 11,A00,188827,Staff,43,0,50,7
1683702492231,POLI 13R,A00,188828,Staff,0,1,20,20
1683702493255,POLI 27,A01,188830,Elgin; Samuel Zincke,0,2,70,70
1683702494283,POLI 30,A00,188832,Desposato; Scott,30,0,50,20
1683702495308,POLI 102F,A00,188834,Staff,1,0,40,39
1683702496333,POLI 104A,A00,188852,Staff,12,0,30,18
1683702497361,POLI 104I,A00,188853,Staff,0,8,20,20
1683702498392,POLI 110B,A00,188854,Wiens; David,6,0,20,14
1683702499423,POLI 112A,A00,188855,Wiens; David,3,0,30,27
1683702500452,POLI 117R,A00,188856,Forman; Fonna,0,12,20,20
1683702501477,POLI 118,A00,188857,Ingham; Sean,8,0,20,12
1683702502501,POLI 120G,A00,188858,Staff,8,0,30,22
1683702503523,POLI 131CR,A00,188863,Hoston; Germaine,20,0,50,30
1683702504551,POLI 133,A00,188864,Nellis; Gareth Hb,44,0,50,6
1683702505580,POLI 134D,A00,188865,Desposato; Scott,27,0,30,3
1683702506606,POLI 142A,A00,188871,Gartzke; Erik,21,0,50,29
1683702507630,POLI 142K,A00,188874,Staff,38,0,50,12
1683702508655,POLI 143,A00,188940,Gartzke; Erik,15,0,30,15
1683702509683,POLI 153,A00,188943,Staff,1,0,20,19
1683702510710,POLI 160AA,A00,188944,Staff,10,0,40,30
1683702511739,POLI 170A,A00,188945,Staff,10,0,30,20
1683702513792,PSYC 1,A00,188952,Staff,36,0,90,54
1683702514816,PSYC 2,B00,188953,Staff,19,0,35,16
1683702515844,PSYC 6,A00,188970,Staff,47,0,60,13
1683702516868,PSYC 7,A00,188973,Staff,35,0,45,10
1683702517893,PSYC 60,A01,188980,Rickard; Timothy C.,42,0,60,18
1683702518922,PSYC 70,A01,189001,Steiner; Eric Tomas,22,0,45,23
1683702519951,PSYC 100,A00,189005,Lacefield; Katharine I,0,98,120,120
1683702520976,PSYC 102,A00,189008,Staff,6,0,30,24
1683702522000,PSYC 106,B00,189026,Gorman; Michael R.,27,0,60,33
1683702523027,PSYC 114,B01,189033,Winkielman; Piotr,0,31,30,30
1683702524052,PSYC 131,A00,189036,Anagnostaras; Stephan,0,44,60,60
1683702525077,PSYC 136,A00,189041,Lowe; Angela Beth,0,7,25,25
1683702526106,PSYC 137,A00,189057,Winkielman; Piotr,0,36,25,25
1683702527131,PSYC 144,A00,189107,Wixted; John T,0,11,50,50
1683702529179,PSYC 162,A00,189142,Staff,0,9,85,85
1683702530204,PSYC 172,A00,189144,Gorman; Michael R.,0,6,30,30
1683702532272,PSYC 179,A00,189146,Lacefield; Katharine I,0,88,120,120
1683702533295,PSYC 181,A00,189147,Anagnostaras; Stephan,0,45,90,90
1683702534323,PSYC 190R,A00,189148,Barner; David A.,0,23,80,80
1683702535349,PSYC 191,A00,189275,Rickard; Timothy C.,0,11,25,25
1683702536374,PSYC 193,A00,189276,Chapman; Eddie Nathaniel,0,1,0,4
1683702537399,PSYC 193L,A01,189281,Lowe; Angela Beth,8,0,20,12
1683702537399,PSYC 193L,B01,189285,Staff,28,0,35,7
1683702538427,RELI 149,A00,187137,Rahimi; Babak,6,0,40,34
1683702539455,SE 9,A01,187315,Staff,0,2,18,18
1683702540482,SE 101B,A00,187409,Staff,24,0,30,6
1683702541508,SE 110B,A00,187444,Staff,10,0,40,30
1683702542594,SE 130B,A00,187449,Staff,31,0,40,9
1683702543623,SE 150A,A00,187516,Staff,8,0,20,12
1683702544653,SE 154,A00,187528,Staff,29,0,50,21
1683702545679,SIO 3,A01,258171,Staff,35,0,40,5
1683702546706,SIO 10,A00,187144,Cook; Geoffrey W,0,6,75,75
1683702547731,SIO 45,A00,187152,Cook; Geoffrey W,1,7,100,99
1683702548755,SIO 109R,A00,194486,Staff,0,4,20,20
1683702550809,SIO 187,A01,187233,Kacev; David,12,0,40,28
1683702551841,SOCI 1,A01,258656,Thorpe; Charles Robert,28,0,30,2
1683702551841,SOCI 1,A02,258658,Thorpe; Charles Robert,30,0,30,0
1683702551841,SOCI 1,A03,258661,Thorpe; Charles Robert,25,0,25,0
1683702551841,SOCI 1,A04,258666,Thorpe; Charles Robert,22,0,25,3
1683702551841,SOCI 1,A05,258897,Thorpe; Charles Robert,22,0,25,3
1683702551841,SOCI 1,A06,258898,Thorpe; Charles Robert,25,0,25,0
1683702552867,SOCI 30,A01,258903,Pardo Guerra; Juan Pablo,14,0,30,16
1683702553896,SOCI 102,A00,258904,Staff,9,0,25,16
1683702554925,SOCI 106,A00,258905,Staff,19,0,25,6
1683702555948,SOCI 111,A00,258907,Ribas Norris; Janet Vanesa,26,0,30,4
1683702556978,SOCI 121R,A00,258908,Pardo Guerra; Juan Pablo,7,0,30,23
1683702558005,SOCI 126,A01,203330,Staff,14,0,20,6
1683702559030,SOCI 131,A00,258909,Thorpe; Charles Robert,30,0,60,30
1683702560059,SOCI 135,A00,258910,Payne; Christine Anna,0,13,30,30
1683702561087,SOCI 157,A00,258911,Staff,10,0,30,20
1683702562112,SOCI 184,A00,258912,Staff,25,0,30,5
1683702563140,SOCI 188D,A00,258913,Staff,22,0,30,8
1683702564167,SYN 2,001,187529,Staff,9,0,16,7
1683702564167,SYN 2,002,201452,Staff,0,20,16,16
1683702564167,SYN 2,003,201469,Staff,1,0,16,15
1683702565197,SYN 100,A01,187531,Staff,0,9,20,20
1683702565197,SYN 100,B01,201491,Staff,0,10,20,20
1683702566222,TDAC 1,A00,189286,Walsh; Kim C.,3,0,20,17
1683702566222,TDAC 1,B00,189287,Harting; Carla Kelso,10,0,20,10
1683702567248,TDAC 101,A00,189300,Walsh; Kim C.,16,0,20,4
1683702567248,TDAC 101,B00,189301,Harting; Carla Kelso,18,0,20,2
1683702568277,TDAC 102,A00,189304,Basso; Beatrice,14,0,20,6
1683702569305,TDAC 108,A00,189305,Staff,18,0,20,2
1683702570330,TDDE 131,A00,189310,Staff,19,0,20,1
1683702570330,TDDE 131,B00,189314,Staff,19,0,20,1
1683702570330,TDDE 131,C00,189315,Staff,48,0,50,2
1683702570330,TDDE 131,D00,189316,Staff,14,0,15,1
1683702570330,TDDE 131,E00,204841,Staff,20,0,20,0
1683702571355,TDGE 10,A00,189289,Staff,27,0,50,23
1683702571355,TDGE 10,B00,189290,Havis; Allan,0,1,50,50
1683702572379,TDGE 11,A00,189291,Fulton; Julia,0,4,50,50
1683702572379,TDGE 11,B00,189292,Staff,20,0,25,5
1683702572379,TDGE 11,C00,260270,Staff,0,0,0,0
1683702573406,TDGE 25,A00,189294,Staff,1,0,20,19
1683702574431,TDGE 124,A00,189318,Fulton; Julia,0,7,50,50
1683702575459,TDGE 125,A00,189319,Staff,13,0,25,12
1683702575459,TDGE 125,B00,189320,Staff,23,0,25,2
1683702576487,TDGE 127,A00,189322,Havis; Allan,1,0,50,49
1683702577511,TDHT 101,A00,189323,Staff,18,0,25,7
1683702577511,TDHT 101,B00,189324,Staff,25,0,25,0
1683702578539,TDHT 102,A00,189325,Staff,49,0,50,1
1683702579564,TDMV 1,A00,189295,Arcidiacono; Kristin,20,0,30,10
1683702579564,TDMV 1,B00,189296,Caligagan; Maria T.,23,0,30,7
1683702580589,TDMV 2,A00,189297,Sammartano; Tonnie,27,0,30,3
1683702580589,TDMV 2,B00,189299,Arcidiacono; Kristin,23,0,30,7
1683702581618,TDMV 3,A00,204998,Rincon; Alicia,22,0,30,8
1683702582642,TDMV 120,A00,189458,Sammartano; Tonnie,28,0,30,2
1683702583672,TDMV 138,A00,189541,Jun; Grace Shin Hae,20,0,40,20
1683702584696,TDMV 142,A00,189717,Caligagan; Tony,25,0,30,5
1683702584696,TDMV 142,B00,189718,Caligagan; Maria T.,25,0,30,5
1683702585724,TMC 2,A01,187533,Staff,25,0,25,0
1683702585724,TMC 2,A02,187534,Staff,25,0,25,0
1683702586748,USP 1,A01,187536,Kwak; Nancy,0,16,25,25
1683702587776,USP 5,A01,187538,Staff,8,0,25,17
1683702588800,USP 101,A00,199253,Staff,0,4,0,0
1683702589824,USP 124,A00,187562,Boomhower; Matthew Charles,0,0,30,30
1683702590852,USP 138,A00,187582,Staff,19,0,25,6
1683702591877,USP 152,A01,187597,Staff,3,0,25,22
1683702592901,USP 153,A00,187598,Staff,18,0,25,7
1683702593926,USP 168,A00,187607,Kwak; Nancy,2,0,5,3
1683702594956,USP 173,A00,187619,Staff,4,0,25,21
1683702595980,USP 181,A00,187638,Staff,0,4,25,25
1683702597005,VIS 103,A00,187650,Cruz; Edwin Teddy,17,0,75,58
1683702598029,VIS 110D,A00,187669,Staff,13,0,22,9
1683702599061,VIS 127C,A00,187720,Shen; Kuiyi,67,0,146,79
1683702600084,VIS 149,A00,187731,Yoldas; Pinar,0,12,22,22
1683702601108,VIS 151,A01,188091,Staff,22,0,34,12
1683702601108,VIS 151,A02,188092,Staff,11,0,34,23
1683702602133,VIS 160B,A00,188093,Stalbaum; Brett,0,1,10,10
1683702604185,WCWP 10B,A00,201720,Staff,0,0,5,5
1683702604185,WCWP 10B,B00,201722,Staff,0,0,6,6
1683702605214,WCWP 100,A00,201725,Gagnon; Jeffrey C,0,0,2,2
1683702605214,WCWP 100,B00,201727,Staff,0,4,15,15
1683702608309,ANBI 133,A00,258401,Wilder; Linnea Lorene,34,0,40,6
1683702609334,ANBI 140,A00,258395,Hrvoj Mihic; Branka,18,0,25,7
1683702610357,ANSC 120,A00,258402,Bialecki; Jon Anthony,26,0,40,14
1683702611382,ANSC 144,A00,258400,Staff,12,0,40,28
1683702613430,ANSC 166,A00,258396,Parish; Steven Martin,156,0,175,19
1683702614454,ANSC 180,A00,193533,Staff,8,0,20,12
1683702615482,ANSC 188,A00,258397,Jassal; Aftab,34,0,40,6
1683702616507,ANTH 3,A01,258316,Staff,23,0,30,7
1683702617532,ANTH 5,A00,258394,Semendeferi; Ekaterini,16,0,20,4
1683702618558,ANTH 21,A01,258331,Staff,4,0,40,36
1683702619588,ANTH 103,A00,258398,Varma; Saiba,15,0,25,10
1683702620616,AWP 10,001,202034,Staff,0,0,0,0
1683702620616,AWP 10,002,202035,Staff,0,0,0,0
1683702620616,AWP 10,003,202036,Staff,0,0,0,0
1683702620616,AWP 10,004,202037,Staff,0,0,0,0
1683702620616,AWP 10,005,202038,Staff,0,0,0,0
1683702620616,AWP 10,006,202039,Staff,0,0,0,0
1683702620616,AWP 10,007,202040,Staff,0,0,0,0
1683702620616,AWP 10,008,202041,Staff,0,0,0,0
1683702620616,AWP 10,009,202042,Staff,0,0,0,0
1683702620616,AWP 10,010,202043,Staff,0,0,0,0
1683702620616,AWP 10,011,202044,Staff,0,0,0,0
1683702620616,AWP 10,012,202045,Staff,0,0,0,0
1683702620616,AWP 10,013,202046,Staff,0,0,0,0
1683702620616,AWP 10,014,202047,Staff,0,0,0,0
1683702620616,AWP 10,015,202048,Staff,0,0,0,0
1683702620616,AWP 10,016,202049,Staff,0,0,0,0
1683702620616,AWP 10,017,202050,Staff,0,0,0,0
1683702620616,AWP 10,018,202051,Staff,0,0,0,0
1683702620616,AWP 10,019,202052,Staff,0,0,0,0
1683702620616,AWP 10,020,202053,Staff,0,0,0,0
1683702620616,AWP 10,021,202054,Staff,0,0,0,0
1683702620616,AWP 10,022,202055,Staff,0,0,0,0
1683702620616,AWP 10,023,202056,Staff,0,0,0,0
1683702620616,AWP 10,024,202057,Staff,0,0,0,0
1683702620616,AWP 10,025,202058,Staff,0,0,0,0
1683702620616,AWP 10,026,202059,Staff,0,0,0,0
1683702621640,AWP 102,001,202032,Staff,0,0,0,0
1683702621640,AWP 102,002,202033,Staff,0,0,0,0
1683702622671,BENG 100,A01,254234,Taylor Amos; Alyssa C,31,0,40,9
1683702623700,BENG 196,001,270013,Engler; Adam J.,9999,0,9999,0
1683702624729,BICD 100R,A01,202018,Smith; Laurie,0,7,32,32
1683702624729,BICD 100R,A02,202019,Smith; Laurie,0,3,32,32
1683702624729,BICD 100R,A03,202020,Smith; Laurie,0,1,32,32
1683702624729,BICD 100R,A04,202021,Smith; Laurie,6,0,32,26
1683702624729,BICD 100R,A05,202022,Smith; Laurie,10,0,32,22
1683702625753,BICD 136,A01,193242,Gustafson-Brown; Cindy,0,2,32,32
1683702625753,BICD 136,A02,193244,Gustafson-Brown; Cindy,13,0,32,19
1683702626783,BIEB 102,A01,193249,Butler; Shannon Rhey,0,0,32,32
1683702626783,BIEB 102,A02,193251,Butler; Shannon Rhey,0,0,32,32
1683702626783,BIEB 102,A03,193253,Butler; Shannon Rhey,0,0,32,32
1683702626783,BIEB 102,A04,193255,Butler; Shannon Rhey,13,0,32,19
1683702626783,BIEB 102,A05,193265,Butler; Shannon Rhey,25,0,32,7
1683702626783,BIEB 102,A06,193269,Butler; Shannon Rhey,12,0,32,20
1683702628834,BIEB 150,A01,193274,Staff,0,0,32,32
1683702628834,BIEB 150,A02,193285,Staff,24,0,32,8
1683702629862,BIEB 194,A00,193286,Kurle; Carolyn M.,19,0,32,13
1683702630894,BILD 1,A01,192291,Staff,15,0,32,17
1683702630894,BILD 1,A02,192292,Staff,30,0,32,2
1683702630894,BILD 1,B01,192520,Reuther; Keefe,0,1,0,0
1683702630894,BILD 1,B02,192532,Reuther; Keefe,0,1,0,0
1683702631925,BILD 3,A01,192556,Butler; Shannon Rhey,0,0,32,32
1683702631925,BILD 3,A02,192581,Butler; Shannon Rhey,0,1,32,32
1683702631925,BILD 3,A03,192611,Butler; Shannon Rhey,19,0,32,13
1683702631925,BILD 3,A04,192612,Butler; Shannon Rhey,23,0,32,9
1683702631925,BILD 3,A05,192613,Butler; Shannon Rhey,26,0,32,6
1683702631925,BILD 3,A06,192679,Butler; Shannon Rhey,27,0,32,5
1683702631925,BILD 3,A07,192682,Butler; Shannon Rhey,20,0,32,12
1683702632951,BILD 4,A01,192836,Reuther; Keefe,1,0,24,23
1683702632951,BILD 4,A02,193044,Reuther; Keefe,4,0,24,20
1683702633976,BILD 10,A01,193142,Gustafson-Brown; Cindy,29,0,32,3
1683702633976,BILD 10,A02,193149,Gustafson-Brown; Cindy,31,0,32,1
1683702635010,BIMM 100,A01,193301,Staff,0,6,32,32
1683702635010,BIMM 100,A02,193312,Staff,0,7,32,32
1683702635010,BIMM 100,A03,193323,Staff,0,10,32,32
1683702636040,BIMM 101,A01,193329,McDonnell; Lisa Marie,0,3,24,24
1683702636040,BIMM 101,A02,193339,McDonnell; Lisa Marie,0,3,24,24
1683702636040,BIMM 101,B01,193354,McDonnell; Lisa Marie,0,4,24,24
1683702636040,BIMM 101,B02,193357,McDonnell; Lisa Marie,0,3,24,24
1683702637069,BIMM 110,A01,193377,Tat; John,0,11,32,32
1683702637069,BIMM 110,A02,193378,Tat; John,0,11,32,32
1683702638094,BIMM 120,A01,206116,Staff,0,0,32,32
1683702638094,BIMM 120,A02,206117,Staff,7,0,32,25
1683702638094,BIMM 120,A03,206121,Staff,21,0,32,11
1683702639125,BIPN 100,A01,193393,Park; Ji Young,0,15,32,32
1683702639125,BIPN 100,A02,193402,Park; Ji Young,0,14,32,32
1683702639125,BIPN 100,A03,193413,Park; Ji Young,0,14,32,32
1683702639125,BIPN 100,A04,193414,Park; Ji Young,0,13,32,32
1683702640150,BIPN 102,A01,193429,Staff,0,0,32,32
1683702640150,BIPN 102,A02,193438,Staff,18,0,32,14
1683702641179,BIPN 106,A01,193450,Reyes Gonzalez; Catalina,0,2,40,40
1683702642203,BIPN 134,A01,193465,Cooke; James Edward,0,0,32,32
1683702642203,BIPN 134,A02,193474,Cooke; James Edward,25,0,32,7
1683702642203,BIPN 134,A03,193485,Cooke; James Edward,29,0,32,3
1683702642203,BIPN 134,A04,193486,Cooke; James Edward,20,0,32,12
1683702642203,BIPN 134,A05,193491,Cooke; James Edward,31,0,32,1
1683702642203,BIPN 134,A06,193501,Cooke; James Edward,30,0,32,2
1683702642203,BIPN 134,A07,193510,Cooke; James Edward,29,0,32,3
1683702644254,BISP 194,A00,222522,Staff,14,0,32,18
1683702645279,CAT 124,A01,202407,Staff,19,0,25,6
1683702646357,CAT 125,A00,202408,Marchisotto; Jennifer Anne,2,0,20,18
1683702647383,CAT 125R,A00,202409,Smith; Lauryn Alissa,0,11,20,20
1683702647383,CAT 125R,B00,202410,Morales; Celeste Georgianna,0,11,20,20
1683702647383,CAT 125R,C00,202411,Irwin; Matthew Joseph,0,12,20,20
1683702648413,CENG 15,A01,204712,Yang; Kesong,0,1,0,0
1683702649437,CENG 114,A00,202070,Jahed Motlagh; Zeinab,5,0,20,15
1683702650463,CGS 105,A00,185477,Wesling; Megan E.,24,0,40,16
1683702651487,CGS 106,A00,185494,Staff,11,0,22,11
1683702652512,CGS 108,A00,185495,Staff,14,0,20,6
1683702653540,CGS 114,A00,185496,Staff,13,0,18,5
1683702654565,CGS 119,A00,185501,Staff,15,0,20,5
1683702655590,CGS 120,A00,185511,Staff,11,0,20,9
1683702656615,CHEM 4,A01,184675,Bussey; Thomas J,97,0,100,3
1683702657641,CHEM 6A,A01,184677,Staff,32,0,60,28
1683702658666,CHEM 6B,A01,184679,Staff,63,0,100,37
1683702659692,CHEM 6C,A01,184681,Bussey; Thomas J,0,0,50,50
1683702659692,CHEM 6C,A02,184682,Bussey; Thomas J,32,0,50,18
1683702660717,CHEM 40A,A01,184684,Albizati; Kim F.,33,0,100,67
1683702661748,CHEM 40B,A01,184686,Albizati; Kim F.,0,22,100,100
1683702662776,CHEM 41B,A01,184690,Staff,51,0,100,49
1683702663802,COGS 3,A01,184715,Boyle; Mary E. T.,0,27,40,40
1683702664826,COGS 14B,A01,185172,Staff,0,14,38,38
1683702665850,COGS 18,A01,184736,Staff,14,0,80,66
1683702666877,COGS 100,A01,184932,Staff,0,8,73,73
1683702667907,COGS 101A,A01,184935,Staff,0,40,30,30
1683702668933,COGS 101B,A01,184944,Staff,0,2,30,30
1683702669962,COGS 101C,A01,184946,Staff,0,10,30,30
1683702670986,COGS 102A,A01,184951,Johnson; Christine M.,1,0,40,39
1683702672012,COGS 107B,A01,184953,Mooshagian; Eric Frederick,0,52,40,40
1683702673045,COGS 118B,A01,184959,Gupta; Anjum,0,50,40,40
1683702674076,COGS 153,A00,184961,Staff,1,16,30,29
1683702675100,COGS 177,A00,184962,Staff,0,20,30,30
1683702676135,COGS 187A,A01,184969,Boyle; Mary E. T.,0,19,40,40
1683702677160,COMM 10,A01,185174,Staff,0,5,25,25
1683702677160,COMM 10,A02,185189,Staff,0,2,25,25
1683702677160,COMM 10,A03,269821,Staff,0,1,0,0
1683702678193,COMM 100B,A02,185476,Staff,10,0,25,15
1683702678193,COMM 100B,A03,277340,Staff,25,0,25,0
1683702679217,COMM 100C,A01,185314,Staff,2,0,25,23
1683702679217,COMM 100C,A02,185327,Staff,17,0,25,8
1683702680247,COMM 110M,A00,185349,Staff,0,0,40,40
1683702681273,COMM 113T,A00,185352,Staff,25,0,40,15
1683702682308,COMM 114I,A00,185353,Staff,31,0,40,9
1683702683342,COMM 131,A00,185354,Staff,17,0,30,13
1683702684377,CSE 8A,A50,185358,Cao; Yingjun,0,46,10,10
1683702685407,CSE 8B,A01,185362,Staff,0,48,50,50
1683702686432,CSE 11,A01,185416,Cao; Yingjun,0,91,10,10
1683702687465,CSE 20,A01,185445,Briones; Jor-el Thomas Caparas,3,0,25,22
1683702688500,CSE 21,A01,185447,Staff,9,0,50,41
1683702689542,CSE 101,A01,185451,Staff,0,13,50,50
1683702689542,CSE 101,B01,185453,Jones; Miles E,0,15,50,50
1683702691627,CSE 141,A01,185458,Eldon; John,16,0,100,84
1683702692670,CSE 141L,A01,185461,Eldon; John,8,0,100,92
1683702693723,CSE 142,A01,185463,Staff,34,0,60,26
1683702693723,CSE 142,B01,201355,Staff,0,7,60,60
1683702694774,CSE 142L,A01,185470,Staff,34,0,60,26
1683702694774,CSE 142L,B01,201417,Staff,0,6,60,60
1683702695839,CSE 190,A00,201433,Staff,32,0,49,17
1683702696891,DOC 1,A01,259136,Strom; Megan C.,7,0,15,8
1683702696891,DOC 1,A02,259137,Strom; Megan C.,14,0,15,1
1683702696891,DOC 1,A03,259138,Strom; Megan C.,14,0,15,1
1683702696891,DOC 1,A04,259139,Strom; Megan C.,14,0,15,1
1683702697965,DOC 100D,A00,259140,Pass; Natalye Joann,14,0,25,11
1683702699085,DSGN 1,A01,184749,Rill; Bryan,0,26,30,30
1683702700115,DSGN 100,A01,185168,Staff,0,2,25,25
1683702701153,ECE 5,A01,185626,Morris; Karcher William,0,12,0,0
1683702702176,ECE 101,A01,185628,Staff,14,0,70,56
1683702703200,ECE 107,A01,185635,Baghdadchi; Saharnaz,0,0,20,20
1683702703200,ECE 107,A02,185638,Baghdadchi; Saharnaz,1,0,20,19
1683702704235,ECE 148,A01,185647,Silberman; Jack,0,0,16,16
1683702705268,ECON 1,A01,185537,Crane; Meredith Helen,54,0,70,16
1683702706309,ECON 3,A01,185549,Crane; Meredith Helen,30,0,70,40
1683702707345,ECON 4,A01,203354,Anderson; John Charles,0,5,10,10
1683702708372,ECON 100A,A01,185574,Staff,0,5,40,40
1683702709396,ECON 100B,A01,185576,Staff,0,12,50,50
1683702710422,ECON 100C,A01,185589,Newhouse; Herbert S,30,0,70,40
1683702711456,ECON 105,A00,185608,Vespa; Emanuel Ignacio,19,0,35,16
1683702712492,ECON 109,A01,185610,Shishkin; Denis,9,0,35,26
1683702713515,ECON 110A,A01,185612,Staff,8,0,40,32
1683702714553,ECON 120A,A01,185615,Staff,19,0,40,21
1683702715578,ECON 120C,A01,185617,Sun; Yixiao,0,21,70,70
1683702716603,ECON 144,A00,203346,Squires; Dale E,2,0,35,33
1683702717633,ECON 171,A01,203349,Newhouse; Herbert S,0,1,35,35
1683702718658,ECON 173A,A01,185621,Toda; Alexis Akira,21,0,35,14
1683702719688,EDS 25,A01,202413,Staff,0,1,0,0
1683702719688,EDS 25,A02,202414,Staff,0,1,0,0
1683702719688,EDS 25,A03,202415,Staff,0,0,0,0
1683702719688,EDS 25,A04,202416,Staff,0,1,0,0
1683702719688,EDS 25,A05,202439,Staff,0,0,0,0
1683702719688,EDS 25,A06,202440,Staff,0,0,0,0
1683702719688,EDS 25,B01,202631,Staff,0,0,0,0
1683702719688,EDS 25,B02,202632,Staff,0,0,0,0
1683702719688,EDS 25,B03,202639,Staff,0,0,0,0
1683702719688,EDS 25,B04,202640,Staff,0,0,0,0
1683702719688,EDS 25,B05,202643,Staff,0,0,0,0
1683702719688,EDS 25,B06,202644,Staff,0,0,0,0
1683702720721,EDS 38,A01,202659,Black; Alison Michelle,25,0,25,0
1683702721753,EDS 115,A00,202652,Staff,18,0,30,12
1683702722777,EDS 125,A00,202649,Staff,13,0,30,17
1683702723802,EDS 126,A01,203332,Staff,30,0,30,0
1683702724827,EDS 139,A00,202838,Staff,16,0,25,9
1683702725860,EDS 146,A01,202655,Staff,14,0,25,11
1683702726895,ENG 15,A00,185667,Staff,0,1,0,0
1683702726895,ENG 15,B00,185672,Staff,0,0,0,0
1683702726895,ENG 15,C00,185675,Staff,0,0,0,0
1683702726895,ENG 15,D00,185682,Staff,0,0,0,0
1683702726895,ENG 15,E00,185684,Staff,0,0,0,0
1683702727920,ETHN 103,A00,185710,Staff,0,8,35,35
1683702728951,ETHN 103A,A00,199228,Man; Simeon S,0,0,9,9
1683702729984,ETHN 109,A00,185711,Staff,15,0,35,20
1683702731021,ETHN 142,A00,185726,Staff,0,4,30,30
1683702732046,ETHN 163J,A00,199229,Man; Simeon S,5,0,8,3
1683702733078,ETHN 168,A00,185727,Staff,7,0,10,3
1683702734102,ETHN 182,A00,185728,Staff,0,0,35,35
1683702735127,ETHN 183,A00,185737,Staff,9,0,18,9
1683702736150,GLBH 111,A01,209361,Burgos; Jose L.,0,0,0,0
1683702738204,HIEU 104,A00,185792,Staff,14,0,20,6
1683702739228,HIEU 115,A00,185800,Staff,0,0,20,20
1683702740253,HIEU 128,A00,185801,Staff,0,9,20,20
1683702741278,HIEU 147,A00,185802,Staff,15,0,20,5
1683702742324,HIEU 154,A00,185823,Staff,11,0,20,9
1683702743355,HILA 102,A00,185826,Staff,14,0,20,6
1683702744379,HILD 2C,A01,185778,Staff,0,13,20,20
1683702745404,HILD 7B,A01,185780,Kwak; Nancy,0,17,32,32
1683702745404,HILD 7B,A02,185781,Kwak; Nancy,0,18,32,32
1683702746431,HILD 30,A01,185791,Staff,12,0,20,8
1683702747466,HISC 119,A00,185830,Golan; Tal,0,10,20,20
1683702748492,HITO 156GS,A00,185831,Patterson; Patrick H.,0,0,0,23
1683702749524,HIUS 103,A00,185832,Man; Simeon S,0,4,20,20
1683702750631,HIUS 117,A00,185836,Kwak; Nancy,2,0,20,18
1683702751674,HIUS 125,A00,185840,Man; Simeon S,0,2,23,23
1683702752700,HIUS 149,A00,185845,Staff,1,0,20,19
1683702753725,HUM 3,A01,185882,Zavodny; Tatiana Sophia,0,8,50,50
1683702753725,HUM 3,B01,185899,Caldwell; Michael Alan,0,18,50,50
1683702754755,HUM 3GS,A00,185900,Patterson; Patrick H.,0,0,0,23
1683702755782,HUM 4,A01,185938,Zroka; Amy Liane,28,0,50,22
1683702755782,HUM 4,B01,185956,Watkins; Eric,0,6,50,50
1683702755782,HUM 4,B02,202209,Watkins; Eric,0,5,50,50
1683702755782,HUM 4,B03,202210,Watkins; Eric,0,5,50,50
1683702756815,HUM 5,A01,185958,West; Geoffrey Scott,0,0,50,50
1683702756815,HUM 5,A02,202215,West; Geoffrey Scott,0,1,50,50
1683702757841,INTL 190,A00,185959,Gagnon; Jeffrey C,0,0,0,9
1683702757841,INTL 190,B00,185960,Lettieri; Michael Joseph,0,0,0,2
1683702758865,JAPN 180,A00,254509,Staff,5,0,30,25
1683702759890,LATI 10,A01,202853,Kennemore; Amy Michelle,4,0,35,31
1683702759890,LATI 10,A02,202854,Kennemore; Amy Michelle,3,0,35,32
1683702759890,LATI 10,A03,270054,Kennemore; Amy Michelle,30,0,30,0
1683702760916,LATI 180,A00,202855,Kennemore; Amy Michelle,11,0,20,9
1683702761951,LAWS 101,A00,201767,Golan; Tal,0,7,40,40
1683702762989,LIFR 1C,A00,185961,Staff,6,0,20,14
1683702764014,LIFR 1CX,A00,185962,Staff,7,0,20,13
1683702765038,LIFR 1D,A00,185963,Staff,7,0,20,13
1683702766063,LIFR 1DX,A00,185964,Staff,7,0,20,13
1683702767087,LIGN 101,A01,186039,Staff,43,0,50,7
1683702768121,LIGN 165,A00,186040,Staff,14,0,50,36
1683702769159,LTCS 108,A00,186041,Staff,5,0,10,5
1683702770194,LTCS 119,A00,186042,Staff,15,0,20,5
1683702771223,LTCS 130,A00,186043,Wesling; Megan E.,15,0,25,10
1683702773293,LTEA 138,A00,186119,Staff,14,0,40,26
1683702774319,LTEN 124,A00,186148,Staff,5,0,25,20
1683702775343,LTEN 178,A00,186149,Staff,6,0,15,9
1683702776369,LTEN 181,A00,186150,Blanco; John D,34,0,40,6
1683702777394,LTWL 120,A00,186160,Staff,19,0,25,6
1683702778430,LTWL 165,A00,186161,Staff,22,0,25,3
1683702779453,LTWR 100,A00,186162,Staff,0,5,15,15
1683702780497,LTWR 102,A00,186163,Doller; Ben,5,0,15,10
1683702781523,MAE 8,A01,186412,Staff,0,1,0,0
1683702782558,MAE 30B,A00,186445,Bahadori; Mohammad Yousef,81,0,100,19
1683702783584,MAE 40,A00,186592,Bewley; Thomas R,10,0,50,40
1683702784615,MAE 101B,A00,186593,Bahadori; Mohammad Yousef,80,0,100,20
1683702785648,MAE 105,A00,186594,Bandaru; Prabhakar,10,0,50,40
1683702786674,MAE 107,A00,186599,Pham; Hieu Tan,0,8,120,120
1683702787699,MAE 148,A01,186660,Silberman; Jack,3,0,16,13
1683702788730,MATH 10A,A01,188095,Staff,0,6,35,35
1683702789765,MATH 10B,A01,188097,Bowers; Adam R.,0,12,30,30
1683702789765,MATH 10B,A02,188099,Bowers; Adam R.,0,11,30,30
1683702789765,MATH 10B,B01,188104,Bowers; Adam R.,0,10,30,30
1683702789765,MATH 10B,B02,188106,Bowers; Adam R.,0,9,30,30
1683702790805,MATH 10C,A01,188111,Staff,0,20,30,30
1683702790805,MATH 10C,A02,188127,Staff,0,19,30,30
1683702790805,MATH 10C,A03,188131,Staff,0,19,30,30
1683702790805,MATH 10C,B01,188218,Staff,17,0,30,13
1683702790805,MATH 10C,B02,188244,Staff,13,0,30,17
1683702790805,MATH 10C,B03,188277,Staff,14,0,30,16
1683702791832,MATH 18,A01,188344,Bach; Quang Tran,18,0,30,12
1683702791832,MATH 18,A02,188345,Bach; Quang Tran,11,0,30,19
1683702791832,MATH 18,B01,188353,Bach; Quang Tran,11,0,30,19
1683702791832,MATH 18,B02,188354,Bach; Quang Tran,19,0,30,11
1683702792868,MATH 20A,A01,188374,Staff,11,0,35,24
1683702793893,MATH 20B,A01,188382,Ohm; Ko Woon,7,0,30,23
1683702793893,MATH 20B,A02,188383,Ohm; Ko Woon,22,0,30,8
1683702793893,MATH 20B,B01,188385,Ohm; Ko Woon,7,0,30,23
1683702793893,MATH 20B,B02,188392,Ohm; Ko Woon,22,0,30,8
1683702794919,MATH 20C,A01,188394,Harel; Guershon,10,0,30,20
1683702794919,MATH 20C,A02,188395,Harel; Guershon,13,0,30,17
1683702794919,MATH 20C,B01,188404,Harel; Guershon,5,0,30,25
1683702794919,MATH 20C,B02,188405,Harel; Guershon,18,0,30,12
1683702795944,MATH 20D,A01,188414,Hammock; Frances H,0,1,30,30
1683702795944,MATH 20D,A02,188415,Hammock; Frances H,0,1,30,30
1683702795944,MATH 20D,B01,188447,Hammock; Frances H,0,1,30,30
1683702795944,MATH 20D,B02,188486,Hammock; Frances H,2,0,30,28
1683702796978,MATH 20E,A01,188649,Staff,21,0,30,9
1683702796978,MATH 20E,A02,188650,Staff,20,0,30,10
1683702796978,MATH 20E,A03,188673,Staff,0,0,30,30
1683702798011,MATH 102,A01,188675,Staff,0,40,35,35
1683702799038,MATH 103B,A01,188681,Staff,3,0,35,32
1683702799038,MATH 103B,B01,188692,Staff,5,0,35,30
1683702800079,MATH 109,A01,188695,Salehi Golsefidy; Alireza,24,0,35,11
1683702800079,MATH 109,A02,188696,Salehi Golsefidy; Alireza,25,0,35,10
1683702801114,MATH 120A,A01,188698,Eggers; John Dietrich,7,0,35,28
1683702802138,MATH 142B,A01,188736,Ioana; Adrian,0,0,30,30
1683702802138,MATH 142B,A02,188741,Ioana; Adrian,0,1,30,30
1683702802138,MATH 142B,A03,188743,Ioana; Adrian,0,2,30,30
1683702803164,MATH 168A,A01,188790,Staff,0,11,35,35
1683702804190,MATH 170A,A01,188803,Nie; Jiawang,0,2,35,35
1683702804190,MATH 170A,A02,188811,Nie; Jiawang,0,1,35,35
1683702804190,MATH 170A,A03,188814,Nie; Jiawang,0,0,35,35
1683702804190,MATH 170A,A04,188815,Nie; Jiawang,5,0,35,30
1683702805225,MATH 193B,A01,188817,Staff,0,0,35,35
1683702805225,MATH 193B,A02,188818,Staff,6,0,35,29
1683702806258,MGT 4,A01,202857,Anderson; John Charles,59,0,80,21
1683702807281,MGT 12,A00,202858,Lindenberger; Wade Douglas,40,0,90,50
1683702808306,MGT 18,A00,202859,Staff,73,0,90,17
1683702809330,MGT 18GS,A00,202860,McKay; Michael J,13,0,28,15
1683702810360,MGT 45,A00,202861,Pecore; Joseph P.,8,0,90,82
1683702811385,MGT 100,A00,202863,Yavorsky; Daniel Ryan,27,0,90,63
1683702812411,MGT 103,A00,202864,Ehrich; Kristine R,0,19,90,90
1683702813441,MGT 112,A00,202865,Ehrich; Kristine R,15,0,90,75
1683702814476,MGT 121A,A00,202868,Staff,70,0,90,20
1683702815505,MGT 131B,A00,202869,Anderson; John Charles,58,0,90,32
1683702816530,MGT 136,A00,202871,Lindenberger; Wade Douglas,83,0,90,7
1683702817566,MGT 164,A00,202873,Staff,0,67,90,91
1683702818590,MGT 164GS,A00,202874,McKay; Mary A,13,0,28,15
1683702819621,MGT 180,A00,202875,Staff,0,51,90,91
1683702820656,MMW 11R,A01,205019,Herbst; Matthew,0,0,30,30
1683702820656,MMW 11R,A02,205026,Herbst; Matthew,29,0,30,1
1683702821686,MMW 15,A01,193512,Chang; Edmond Yi-Teh,0,8,28,28
1683702821686,MMW 15,A02,193513,Chang; Edmond Yi-Teh,0,5,28,28
1683702821686,MMW 15,A03,193514,Chang; Edmond Yi-Teh,0,5,28,28
1683702821686,MMW 15,A04,193515,Chang; Edmond Yi-Teh,0,5,28,28
1683702821686,MMW 15,A05,193516,Chang; Edmond Yi-Teh,0,5,28,28
1683702821686,MMW 15,A06,193517,Chang; Edmond Yi-Teh,0,6,28,28
1683702821686,MMW 15,B01,193519,Chang; Edmond Yi-Teh,0,5,28,28
1683702821686,MMW 15,B02,193520,Chang; Edmond Yi-Teh,0,5,28,28
1683702821686,MMW 15,B03,193521,Chang; Edmond Yi-Teh,0,5,28,28
1683702821686,MMW 15,B04,193522,Chang; Edmond Yi-Teh,0,6,28,28
1683702821686,MMW 15,B05,193523,Chang; Edmond Yi-Teh,0,5,28,28
1683702821686,MMW 15,B06,193524,Chang; Edmond Yi-Teh,0,5,28,28
1683702822720,MMW 122,A01,193526,Rahimi; Babak,0,16,28,28
1683702822720,MMW 122,A02,193527,Rahimi; Babak,0,15,28,28
1683702822720,MMW 122,A03,193528,Rahimi; Babak,0,0,0,0
1683702822720,MMW 122,A04,193529,Rahimi; Babak,0,0,0,0
1683702823749,MUS 1A,A01,186663,Staff,0,18,35,35
1683702824774,MUS 4,A01,186715,Staff,0,12,35,35
1683702825806,MUS 5R,A01,186796,Dubnov; Shlomo,0,17,35,35
1683702826834,MUS 6,A01,186798,Staff,0,4,25,25
1683702827860,MUS 7,A01,186830,Staff,11,0,35,24
1683702828885,MUS 8,A01,186930,Staff,0,27,35,35
1683702829920,MUS 15,A01,186932,Staff,0,15,35,35
1683702829920,MUS 15,B01,186934,Staff,0,16,35,35
1683702830945,MUS 80,A00,186935,Staff,0,0,20,20
1683702830945,MUS 80,B00,186936,Staff,24,0,25,1
1683702831970,NANO 11,A00,204702,Lipomi; Darren John,0,0,0,0
1683702833005,NANO 15,A01,204709,Yang; Kesong,0,1,0,0
1683702834032,NANO 114,A00,202069,Jahed Motlagh; Zeinab,2,0,10,8
1683702835065,PHIL 1,A00,186955,Grush; Rick Scott,31,0,40,9
1683702836093,PHIL 10,A01,186973,Grush; Rick Scott,27,0,35,8
1683702836093,PHIL 10,A02,186974,Grush; Rick Scott,33,0,35,2
1683702837120,PHIL 13,A01,186976,Staff,1,0,35,34
1683702837120,PHIL 13,A02,186977,Staff,16,0,35,19
1683702838150,PHIL 14,A01,186979,Staff,30,0,35,5
1683702838150,PHIL 14,A02,186986,Staff,32,0,35,3
1683702839177,PHIL 28,A01,186988,Staff,16,0,30,14
1683702839177,PHIL 28,A02,186989,Staff,0,0,30,30
1683702839177,PHIL 28,A03,186990,Staff,10,0,30,20
1683702839177,PHIL 28,A04,186991,Staff,26,0,30,4
1683702840208,PHIL 120,A00,186997,Staff,23,0,40,17
1683702841234,PHIL 137,A00,187003,Staff,7,0,40,33
1683702842263,PHIL 150,A00,187015,Staff,47,0,70,23
1683702843290,PHIL 167,A00,187021,Lamey; Andy M.,34,0,40,6
1683702844347,PHIL 174,A01,202226,Staff,17,0,20,3
1683702844347,PHIL 174,A02,202235,Staff,20,0,20,0
1683702845384,PHIL 191A,A00,258918,Staff,0,0,1,1
1683702846416,PHYS 1A,A00,187028,Staff,26,0,60,34
1683702847442,PHYS 1AL,001,187036,Staff,3,0,30,27
1683702847442,PHYS 1AL,002,187049,Staff,18,0,30,12
1683702848467,PHYS 1B,A00,187058,Staff,21,0,60,39
1683702849497,PHYS 1BL,001,187064,Staff,0,1,30,30
1683702849497,PHYS 1BL,002,187070,Staff,4,0,30,26
1683702850531,PHYS 1C,A00,187082,Staff,30,0,120,90
1683702851559,PHYS 1CL,001,187088,Staff,0,9,30,30
1683702851559,PHYS 1CL,002,187089,Staff,0,1,30,30
1683702851559,PHYS 1CL,009,262693,Staff,9,0,30,21
1683702852586,PHYS 2B,A01,187097,Staff,55,0,115,60
1683702853619,PHYS 2C,A01,187099,Staff,63,0,115,52
1683702854700,PHYS 2CL,A01,187101,Staff,5,0,28,23
1683702854700,PHYS 2CL,A02,187102,Staff,15,0,28,13
1683702855727,PHYS 2D,A01,187123,Shotwell; Brian,95,0,115,20
1683702856767,PHYS 4B,A01,187133,Grinstein; Benjamin,35,0,50,15
1683702857799,POLI 10,A00,188819,Staff,0,4,50,50
1683702858825,POLI 11,A00,188827,Staff,43,0,50,7
1683702859868,POLI 13R,A00,188828,Staff,0,1,20,20
1683702860899,POLI 27,A01,188830,Elgin; Samuel Zincke,0,2,70,70
1683702861930,POLI 30,A00,188832,Desposato; Scott,30,0,50,20
1683702862956,POLI 102F,A00,188834,Staff,1,0,40,39
1683702863981,POLI 104A,A00,188852,Staff,12,0,30,18
1683702865011,POLI 104I,A00,188853,Staff,0,8,20,20
1683702866038,POLI 110B,A00,188854,Wiens; David,6,0,20,14
1683702867066,POLI 112A,A00,188855,Wiens; David,3,0,30,27
1683702868094,POLI 117R,A00,188856,Forman; Fonna,0,12,20,20
1683702869120,POLI 118,A00,188857,Ingham; Sean,8,0,20,12
1683702870148,POLI 120G,A00,188858,Staff,7,0,30,23
1683702871172,POLI 131CR,A00,188863,Hoston; Germaine,20,0,50,30
1683702872198,POLI 133,A00,188864,Nellis; Gareth Hb,44,0,50,6
1683702873228,POLI 134D,A00,188865,Desposato; Scott,27,0,30,3
1683702874254,POLI 142A,A00,188871,Gartzke; Erik,21,0,50,29
1683702875281,POLI 142K,A00,188874,Staff,38,0,50,12
1683702876312,POLI 143,A00,188940,Gartzke; Erik,15,0,30,15
1683702877339,POLI 153,A00,188943,Staff,1,0,20,19
1683702878367,POLI 160AA,A00,188944,Staff,10,0,40,30
1683702879392,POLI 170A,A00,188945,Staff,10,0,30,20
1683702881451,PSYC 1,A00,188952,Staff,36,0,90,54
1683702882475,PSYC 2,B00,188953,Staff,19,0,35,16
1683702883501,PSYC 6,A00,188970,Staff,47,0,60,13
1683702884533,PSYC 7,A00,188973,Staff,35,0,45,10
1683702885566,PSYC 60,A01,188980,Rickard; Timothy C.,42,0,60,18
1683702886591,PSYC 70,A01,189001,Steiner; Eric Tomas,22,0,45,23
1683702887621,PSYC 100,A00,189005,Lacefield; Katharine I,0,98,120,120
1683702888647,PSYC 102,A00,189008,Staff,6,0,30,24
1683702889672,PSYC 106,B00,189026,Gorman; Michael R.,27,0,60,33
1683702890698,PSYC 114,B01,189033,Winkielman; Piotr,0,31,30,30
1683702891727,PSYC 131,A00,189036,Anagnostaras; Stephan,0,44,60,60
1683702892752,PSYC 136,A00,189041,Lowe; Angela Beth,0,7,25,25
1683702893782,PSYC 137,A00,189057,Winkielman; Piotr,0,36,25,25
1683702894813,PSYC 144,A00,189107,Wixted; John T,0,11,50,50
1683702896868,PSYC 162,A00,189142,Staff,0,9,85,85
1683702897899,PSYC 172,A00,189144,Gorman; Michael R.,0,6,30,30
1683702899961,PSYC 179,A00,189146,Lacefield; Katharine I,0,88,120,120
1683702900992,PSYC 181,A00,189147,Anagnostaras; Stephan,0,45,90,90
1683702902027,PSYC 190R,A00,189148,Barner; David A.,0,23,80,80
1683702903053,PSYC 191,A00,189275,Rickard; Timothy C.,0,11,25,25
1683702904080,PSYC 193,A00,189276,Chapman; Eddie Nathaniel,0,1,0,4
1683702905117,PSYC 193L,A01,189281,Lowe; Angela Beth,8,0,20,12
1683702905117,PSYC 193L,B01,189285,Staff,28,0,35,7
1683702906149,RELI 149,A00,187137,Rahimi; Babak,6,0,40,34
1683702907182,SE 9,A01,187315,Staff,0,2,18,18
1683702908215,SE 101B,A00,187409,Staff,24,0,30,6
1683702909241,SE 110B,A00,187444,Staff,10,0,40,30
1683702910272,SE 130B,A00,187449,Staff,31,0,40,9
1683702911298,SE 150A,A00,187516,Staff,8,0,20,12
1683702912322,SE 154,A00,187528,Staff,29,0,50,21
1683702913363,SIO 3,A01,258171,Staff,35,0,40,5
1683702914389,SIO 10,A00,187144,Cook; Geoffrey W,0,6,75,75
1683702915419,SIO 45,A00,187152,Cook; Geoffrey W,1,7,100,99
1683702916444,SIO 109R,A00,194486,Staff,0,4,20,20
1683702918497,SIO 187,A01,187233,Kacev; David,12,0,40,28
1683702919529,SOCI 1,A01,258656,Thorpe; Charles Robert,28,0,30,2
1683702919529,SOCI 1,A02,258658,Thorpe; Charles Robert,30,0,30,0
1683702919529,SOCI 1,A03,258661,Thorpe; Charles Robert,25,0,25,0
1683702919529,SOCI 1,A04,258666,Thorpe; Charles Robert,22,0,25,3
1683702919529,SOCI 1,A05,258897,Thorpe; Charles Robert,22,0,25,3
1683702919529,SOCI 1,A06,258898,Thorpe; Charles Robert,25,0,25,0
1683702920556,SOCI 30,A01,258903,Pardo Guerra; Juan Pablo,14,0,30,16
1683702921589,SOCI 102,A00,258904,Staff,9,0,25,16
1683702922613,SOCI 106,A00,258905,Staff,19,0,25,6
1683702923639,SOCI 111,A00,258907,Ribas Norris; Janet Vanesa,26,0,30,4
1683702924664,SOCI 121R,A00,258908,Pardo Guerra; Juan Pablo,7,0,30,23
1683702925690,SOCI 126,A01,203330,Staff,14,0,20,6
1683702926716,SOCI 131,A00,258909,Thorpe; Charles Robert,30,0,60,30
1683702927742,SOCI 135,A00,258910,Payne; Christine Anna,0,13,30,30
1683702928773,SOCI 157,A00,258911,Staff,10,0,30,20
1683702929797,SOCI 184,A00,258912,Staff,25,0,30,5
1683702930827,SOCI 188D,A00,258913,Staff,22,0,30,8
1683702931855,SYN 2,001,187529,Staff,9,0,16,7
1683702931855,SYN 2,002,201452,Staff,0,20,16,16
1683702931855,SYN 2,003,201469,Staff,1,0,16,15
1683702932880,SYN 100,A01,187531,Staff,0,9,20,20
1683702932880,SYN 100,B01,201491,Staff,0,10,20,20
1683702933908,TDAC 1,A00,189286,Walsh; Kim C.,3,0,20,17
1683702933908,TDAC 1,B00,189287,Harting; Carla Kelso,10,0,20,10
1683702934940,TDAC 101,A00,189300,Walsh; Kim C.,16,0,20,4
1683702934940,TDAC 101,B00,189301,Harting; Carla Kelso,18,0,20,2
1683702935965,TDAC 102,A00,189304,Basso; Beatrice,14,0,20,6
1683702936989,TDAC 108,A00,189305,Staff,18,0,20,2
1683702938015,TDDE 131,A00,189310,Staff,19,0,20,1
1683702938015,TDDE 131,B00,189314,Staff,19,0,20,1
1683702938015,TDDE 131,C00,189315,Staff,48,0,50,2
1683702938015,TDDE 131,D00,189316,Staff,14,0,15,1
1683702938015,TDDE 131,E00,204841,Staff,20,0,20,0
1683702939039,TDGE 10,A00,189289,Staff,27,0,50,23
1683702939039,TDGE 10,B00,189290,Havis; Allan,0,1,50,50
1683702940068,TDGE 11,A00,189291,Fulton; Julia,0,4,50,50
1683702940068,TDGE 11,B00,189292,Staff,20,0,25,5
1683702940068,TDGE 11,C00,260270,Staff,0,0,0,0
1683702941095,TDGE 25,A00,189294,Staff,1,0,20,19
1683702942120,TDGE 124,A00,189318,Fulton; Julia,0,7,50,50
1683702943146,TDGE 125,A00,189319,Staff,13,0,25,12
1683702943146,TDGE 125,B00,189320,Staff,23,0,25,2
1683702944173,TDGE 127,A00,189322,Havis; Allan,1,0,50,49
1683702945200,TDHT 101,A00,189323,Staff,18,0,25,7
1683702945200,TDHT 101,B00,189324,Staff,25,0,25,0
1683702946243,TDHT 102,A00,189325,Staff,49,0,50,1
1683702947270,TDMV 1,A00,189295,Arcidiacono; Kristin,20,0,30,10
1683702947270,TDMV 1,B00,189296,Caligagan; Maria T.,23,0,30,7
1683702948297,TDMV 2,A00,189297,Sammartano; Tonnie,27,0,30,3
1683702948297,TDMV 2,B00,189299,Arcidiacono; Kristin,23,0,30,7
1683702949325,TDMV 3,A00,204998,Rincon; Alicia,22,0,30,8
1683702950352,TDMV 120,A00,189458,Sammartano; Tonnie,28,0,30,2
1683702951384,TDMV 138,A00,189541,Jun; Grace Shin Hae,20,0,40,20
1683702952411,TDMV 142,A00,189717,Caligagan; Tony,25,0,30,5
1683702952411,TDMV 142,B00,189718,Caligagan; Maria T.,25,0,30,5
1683702953439,TMC 2,A01,187533,Staff,25,0,25,0
1683702953439,TMC 2,A02,187534,Staff,25,0,25,0
1683702954466,USP 1,A01,187536,Kwak; Nancy,0,16,25,25
1683702955492,USP 5,A01,187538,Staff,8,0,25,17
1683702956520,USP 101,A00,199253,Staff,0,4,0,0
1683702957546,USP 124,A00,187562,Boomhower; Matthew Charles,0,0,30,30
1683702958626,USP 138,A00,187582,Staff,19,0,25,6
1683702959655,USP 152,A01,187597,Staff,3,0,25,22
1683702960680,USP 153,A00,187598,Staff,18,0,25,7
1683702961705,USP 168,A00,187607,Kwak; Nancy,2,0,5,3
1683702962736,USP 173,A00,187619,Staff,4,0,25,21
1683702963769,USP 181,A00,187638,Staff,0,4,25,25
1683702964802,VIS 103,A00,187650,Cruz; Edwin Teddy,17,0,75,58
1683702965829,VIS 110D,A00,187669,Staff,13,0,22,9
1683702966862,VIS 127C,A00,187720,Shen; Kuiyi,67,0,146,79
1683702967889,VIS 149,A00,187731,Yoldas; Pinar,0,12,22,22
1683702968920,VIS 151,A01,188091,Staff,22,0,34,12
1683702968920,VIS 151,A02,188092,Staff,11,0,34,23
1683702969945,VIS 160B,A00,188093,Stalbaum; Brett,0,1,10,10
1683702972006,WCWP 10B,A00,201720,Staff,0,0,5,5
1683702972006,WCWP 10B,B00,201722,Staff,0,0,6,6
1683702973035,WCWP 100,A00,201725,Gagnon; Jeffrey C,0,0,2,2
1683702973035,WCWP 100,B00,201727,Staff,0,4,15,15
1683702976182,ANBI 133,A00,258401,Wilder; Linnea Lorene,34,0,40,6
1683702977211,ANBI 140,A00,258395,Hrvoj Mihic; Branka,18,0,25,7
1683702978242,ANSC 120,A00,258402,Bialecki; Jon Anthony,26,0,40,14
1683702979270,ANSC 144,A00,258400,Staff,12,0,40,28
1683702981321,ANSC 166,A00,258396,Parish; Steven Martin,156,0,175,19
1683702982353,ANSC 180,A00,193533,Staff,8,0,20,12
1683702983384,ANSC 188,A00,258397,Jassal; Aftab,34,0,40,6
1683702984417,ANTH 3,A01,258316,Staff,23,0,30,7
1683702985450,ANTH 5,A00,258394,Semendeferi; Ekaterini,16,0,20,4
1683702986475,ANTH 21,A01,258331,Staff,4,0,40,36
1683702987504,ANTH 103,A00,258398,Varma; Saiba,15,0,25,10
1683702988532,AWP 10,001,202034,Staff,0,0,0,0
1683702988532,AWP 10,002,202035,Staff,0,0,0,0
1683702988532,AWP 10,003,202036,Staff,0,0,0,0
1683702988532,AWP 10,004,202037,Staff,0,0,0,0
1683702988532,AWP 10,005,202038,Staff,0,0,0,0
1683702988532,AWP 10,006,202039,Staff,0,0,0,0
1683702988532,AWP 10,007,202040,Staff,0,0,0,0
1683702988532,AWP 10,008,202041,Staff,0,0,0,0
1683702988532,AWP 10,009,202042,Staff,0,0,0,0
1683702988532,AWP 10,010,202043,Staff,0,0,0,0
1683702988532,AWP 10,011,202044,Staff,0,0,0,0
1683702988532,AWP 10,012,202045,Staff,0,0,0,0
1683702988532,AWP 10,013,202046,Staff,0,0,0,0
1683702988532,AWP 10,014,202047,Staff,0,0,0,0
1683702988532,AWP 10,015,202048,Staff,0,0,0,0
1683702988532,AWP 10,016,202049,Staff,0,0,0,0
1683702988532,AWP 10,017,202050,Staff,0,0,0,0
1683702988532,AWP 10,018,202051,Staff,0,0,0,0
1683702988532,AWP 10,019,202052,Staff,0,0,0,0
1683702988532,AWP 10,020,202053,Staff,0,0,0,0
1683702988532,AWP 10,021,202054,Staff,0,0,0,0
1683702988532,AWP 10,022,202055,Staff,0,0,0,0
1683702988532,AWP 10,023,202056,Staff,0,0,0,0
1683702988532,AWP 10,024,202057,Staff,0,0,0,0
1683702988532,AWP 10,025,202058,Staff,0,0,0,0
1683702988532,AWP 10,026,202059,Staff,0,0,0,0
1683702989557,AWP 102,001,202032,Staff,0,0,0,0
1683702989557,AWP 102,002,202033,Staff,0,0,0,0
1683702990582,BENG 100,A01,254234,Taylor Amos; Alyssa C,31,0,40,9
1683702991611,BENG 196,001,270013,Engler; Adam J.,9999,0,9999,0
1683702992635,BICD 100R,A01,202018,Smith; Laurie,0,7,32,32
1683702992635,BICD 100R,A02,202019,Smith; Laurie,0,3,32,32
1683702992635,BICD 100R,A03,202020,Smith; Laurie,0,1,32,32
1683702992635,BICD 100R,A04,202021,Smith; Laurie,6,0,32,26
1683702992635,BICD 100R,A05,202022,Smith; Laurie,10,0,32,22
1683702993661,BICD 136,A01,193242,Gustafson-Brown; Cindy,0,2,32,32
1683702993661,BICD 136,A02,193244,Gustafson-Brown; Cindy,13,0,32,19
1683702994692,BIEB 102,A01,193249,Butler; Shannon Rhey,0,0,32,32
1683702994692,BIEB 102,A02,193251,Butler; Shannon Rhey,0,0,32,32
1683702994692,BIEB 102,A03,193253,Butler; Shannon Rhey,0,0,32,32
1683702994692,BIEB 102,A04,193255,Butler; Shannon Rhey,13,0,32,19
1683702994692,BIEB 102,A05,193265,Butler; Shannon Rhey,25,0,32,7
1683702994692,BIEB 102,A06,193269,Butler; Shannon Rhey,12,0,32,20
1683702996746,BIEB 150,A01,193274,Staff,0,0,32,32
1683702996746,BIEB 150,A02,193285,Staff,24,0,32,8
1683702997779,BIEB 194,A00,193286,Kurle; Carolyn M.,19,0,32,13
1683702998805,BILD 1,A01,192291,Staff,15,0,32,17
1683702998805,BILD 1,A02,192292,Staff,30,0,32,2
1683702998805,BILD 1,B01,192520,Reuther; Keefe,0,1,0,0
1683702998805,BILD 1,B02,192532,Reuther; Keefe,0,1,0,0
1683702999832,BILD 3,A01,192556,Butler; Shannon Rhey,0,0,32,32
1683702999832,BILD 3,A02,192581,Butler; Shannon Rhey,0,1,32,32
1683702999832,BILD 3,A03,192611,Butler; Shannon Rhey,19,0,32,13
1683702999832,BILD 3,A04,192612,Butler; Shannon Rhey,23,0,32,9
1683702999832,BILD 3,A05,192613,Butler; Shannon Rhey,26,0,32,6
1683702999832,BILD 3,A06,192679,Butler; Shannon Rhey,27,0,32,5
1683702999832,BILD 3,A07,192682,Butler; Shannon Rhey,20,0,32,12
1683703000859,BILD 4,A01,192836,Reuther; Keefe,1,0,24,23
1683703000859,BILD 4,A02,193044,Reuther; Keefe,4,0,24,20
1683703001891,BILD 10,A01,193142,Gustafson-Brown; Cindy,29,0,32,3
1683703001891,BILD 10,A02,193149,Gustafson-Brown; Cindy,31,0,32,1
1683703002918,BIMM 100,A01,193301,Staff,0,6,32,32
1683703002918,BIMM 100,A02,193312,Staff,0,7,32,32
1683703002918,BIMM 100,A03,193323,Staff,0,10,32,32
1683703003959,BIMM 101,A01,193329,McDonnell; Lisa Marie,0,3,24,24
1683703003959,BIMM 101,A02,193339,McDonnell; Lisa Marie,0,3,24,24
1683703003959,BIMM 101,B01,193354,McDonnell; Lisa Marie,0,4,24,24
1683703003959,BIMM 101,B02,193357,McDonnell; Lisa Marie,0,3,24,24
1683703004987,BIMM 110,A01,193377,Tat; John,0,11,32,32
1683703004987,BIMM 110,A02,193378,Tat; John,0,11,32,32
1683703006021,BIMM 120,A01,206116,Staff,0,0,32,32
1683703006021,BIMM 120,A02,206117,Staff,7,0,32,25
1683703006021,BIMM 120,A03,206121,Staff,21,0,32,11
1683703007046,BIPN 100,A01,193393,Park; Ji Young,0,15,32,32
1683703007046,BIPN 100,A02,193402,Park; Ji Young,0,14,32,32
1683703007046,BIPN 100,A03,193413,Park; Ji Young,0,14,32,32
1683703007046,BIPN 100,A04,193414,Park; Ji Young,0,13,32,32
1683703008080,BIPN 102,A01,193429,Staff,0,0,32,32
1683703008080,BIPN 102,A02,193438,Staff,18,0,32,14
1683703009105,BIPN 106,A01,193450,Reyes Gonzalez; Catalina,0,2,40,40
1683703010133,BIPN 134,A01,193465,Cooke; James Edward,0,0,32,32
1683703010133,BIPN 134,A02,193474,Cooke; James Edward,25,0,32,7
1683703010133,BIPN 134,A03,193485,Cooke; James Edward,29,0,32,3
1683703010133,BIPN 134,A04,193486,Cooke; James Edward,20,0,32,12
1683703010133,BIPN 134,A05,193491,Cooke; James Edward,31,0,32,1
1683703010133,BIPN 134,A06,193501,Cooke; James Edward,30,0,32,2
1683703010133,BIPN 134,A07,193510,Cooke; James Edward,29,0,32,3
1683703012183,BISP 194,A00,222522,Staff,14,0,32,18
1683703013210,CAT 124,A01,202407,Staff,19,0,25,6
1683703014236,CAT 125,A00,202408,Marchisotto; Jennifer Anne,2,0,20,18
1683703015262,CAT 125R,A00,202409,Smith; Lauryn Alissa,0,11,20,20
1683703015262,CAT 125R,B00,202410,Morales; Celeste Georgianna,0,11,20,20
1683703015262,CAT 125R,C00,202411,Irwin; Matthew Joseph,0,12,20,20
1683703016288,CENG 15,A01,204712,Yang; Kesong,0,1,0,0
1683703017312,CENG 114,A00,202070,Jahed Motlagh; Zeinab,5,0,20,15
1683703018340,CGS 105,A00,185477,Wesling; Megan E.,24,0,40,16
1683703019370,CGS 106,A00,185494,Staff,11,0,22,11
1683703020400,CGS 108,A00,185495,Staff,14,0,20,6
1683703021432,CGS 114,A00,185496,Staff,13,0,18,5
1683703022460,CGS 119,A00,185501,Staff,15,0,20,5
1683703023485,CGS 120,A00,185511,Staff,11,0,20,9
1683703024512,CHEM 4,A01,184675,Bussey; Thomas J,97,0,100,3
1683703025542,CHEM 6A,A01,184677,Staff,32,0,60,28
1683703026568,CHEM 6B,A01,184679,Staff,63,0,100,37
1683703027597,CHEM 6C,A01,184681,Bussey; Thomas J,0,0,50,50
1683703027597,CHEM 6C,A02,184682,Bussey; Thomas J,32,0,50,18
1683703028626,CHEM 40A,A01,184684,Albizati; Kim F.,33,0,100,67
1683703029652,CHEM 40B,A01,184686,Albizati; Kim F.,0,22,100,100
1683703030678,CHEM 41B,A01,184690,Staff,51,0,100,49
1683703031704,COGS 3,A01,184715,Boyle; Mary E. T.,0,27,40,40
1683703032729,COGS 14B,A01,185172,Staff,0,14,38,38
1683703033756,COGS 18,A01,184736,Staff,14,0,80,66
1683703034787,COGS 100,A01,184932,Staff,0,8,73,73
1683703035812,COGS 101A,A01,184935,Staff,0,40,30,30
1683703036838,COGS 101B,A01,184944,Staff,0,2,30,30
1683703037863,COGS 101C,A01,184946,Staff,0,10,30,30
1683703038894,COGS 102A,A01,184951,Johnson; Christine M.,1,0,40,39
1683703039929,COGS 107B,A01,184953,Mooshagian; Eric Frederick,0,52,40,40
1683703040971,COGS 118B,A01,184959,Gupta; Anjum,0,50,40,40
1683703041994,COGS 153,A00,184961,Staff,1,16,30,29
1683703043018,COGS 177,A00,184962,Staff,0,20,30,30
1683703044043,COGS 187A,A01,184969,Boyle; Mary E. T.,0,19,40,40
1683703045068,COMM 10,A01,185174,Staff,0,5,25,25
1683703045068,COMM 10,A02,185189,Staff,0,2,25,25
1683703045068,COMM 10,A03,269821,Staff,0,1,0,0
1683703046098,COMM 100B,A02,185476,Staff,10,0,25,15
1683703046098,COMM 100B,A03,277340,Staff,25,0,25,0
1683703047128,COMM 100C,A01,185314,Staff,2,0,25,23
1683703047128,COMM 100C,A02,185327,Staff,17,0,25,8
1683703048154,COMM 110M,A00,185349,Staff,0,0,40,40
1683703049180,COMM 113T,A00,185352,Staff,25,0,40,15
1683703050209,COMM 114I,A00,185353,Staff,31,0,40,9
1683703051243,COMM 131,A00,185354,Staff,17,0,30,13
1683703052275,CSE 8A,A50,185358,Cao; Yingjun,0,46,10,10
1683703053298,CSE 8B,A01,185362,Staff,0,48,50,50
1683703054329,CSE 11,A01,185416,Cao; Yingjun,0,91,10,10
1683703055353,CSE 20,A01,185445,Briones; Jor-el Thomas Caparas,3,0,25,22
1683703056387,CSE 21,A01,185447,Staff,9,0,50,41
1683703057418,CSE 101,A01,185451,Staff,0,13,50,50
1683703057418,CSE 101,B01,185453,Jones; Miles E,0,15,50,50
1683703059480,CSE 141,A01,185458,Eldon; John,16,0,100,84
1683703060505,CSE 141L,A01,185461,Eldon; John,8,0,100,92
1683703061532,CSE 142,A01,185463,Staff,34,0,60,26
1683703061532,CSE 142,B01,201355,Staff,0,7,60,60
1683703062614,CSE 142L,A01,185470,Staff,34,0,60,26
1683703062614,CSE 142L,B01,201417,Staff,0,6,60,60
1683703063643,CSE 190,A00,201433,Staff,32,0,49,17
1683703064669,DOC 1,A01,259136,Strom; Megan C.,7,0,15,8
1683703064669,DOC 1,A02,259137,Strom; Megan C.,14,0,15,1
1683703064669,DOC 1,A03,259138,Strom; Megan C.,14,0,15,1
1683703064669,DOC 1,A04,259139,Strom; Megan C.,14,0,15,1
1683703065703,DOC 100D,A00,259140,Pass; Natalye Joann,14,0,25,11
1683703066733,DSGN 1,A01,184749,Rill; Bryan,0,26,30,30
1683703067762,DSGN 100,A01,185168,Staff,0,2,25,25
1683703068794,ECE 5,A01,185626,Morris; Karcher William,0,12,0,0
1683703069827,ECE 101,A01,185628,Staff,14,0,70,56
1683703070853,ECE 107,A01,185635,Baghdadchi; Saharnaz,0,0,20,20
1683703070853,ECE 107,A02,185638,Baghdadchi; Saharnaz,1,0,20,19
1683703071878,ECE 148,A01,185647,Silberman; Jack,0,0,16,16
1683703072906,ECON 1,A01,185537,Crane; Meredith Helen,54,0,70,16
1683703073942,ECON 3,A01,185549,Crane; Meredith Helen,30,0,70,40
1683703074972,ECON 4,A01,203354,Anderson; John Charles,0,5,10,10
1683703076002,ECON 100A,A01,185574,Staff,0,5,40,40
1683703077029,ECON 100B,A01,185576,Staff,0,12,50,50
1683703078055,ECON 100C,A01,185589,Newhouse; Herbert S,30,0,70,40
1683703079083,ECON 105,A00,185608,Vespa; Emanuel Ignacio,19,0,35,16
1683703080108,ECON 109,A01,185610,Shishkin; Denis,9,0,35,26
1683703081133,ECON 110A,A01,185612,Staff,8,0,40,32
1683703082158,ECON 120A,A01,185615,Staff,19,0,40,21
1683703083191,ECON 120C,A01,185617,Sun; Yixiao,0,21,70,70
1683703084233,ECON 144,A00,203346,Squires; Dale E,2,0,35,33
1683703085266,ECON 171,A01,203349,Newhouse; Herbert S,0,1,35,35
1683703086294,ECON 173A,A01,185621,Toda; Alexis Akira,21,0,35,14
1683703087326,EDS 25,A01,202413,Staff,0,1,0,0
1683703087326,EDS 25,A02,202414,Staff,0,1,0,0
1683703087326,EDS 25,A03,202415,Staff,0,0,0,0
1683703087326,EDS 25,A04,202416,Staff,0,1,0,0
1683703087326,EDS 25,A05,202439,Staff,0,0,0,0
1683703087326,EDS 25,A06,202440,Staff,0,0,0,0
1683703087326,EDS 25,B01,202631,Staff,0,0,0,0
1683703087326,EDS 25,B02,202632,Staff,0,0,0,0
1683703087326,EDS 25,B03,202639,Staff,0,0,0,0
1683703087326,EDS 25,B04,202640,Staff,0,0,0,0
1683703087326,EDS 25,B05,202643,Staff,0,0,0,0
1683703087326,EDS 25,B06,202644,Staff,0,0,0,0
1683703088352,EDS 38,A01,202659,Black; Alison Michelle,25,0,25,0
1683703089394,EDS 115,A00,202652,Staff,18,0,30,12
1683703090418,EDS 125,A00,202649,Staff,13,0,30,17
1683703091448,EDS 126,A01,203332,Staff,30,0,30,0
1683703092473,EDS 139,A00,202838,Staff,16,0,25,9
1683703093502,EDS 146,A01,202655,Staff,14,0,25,11
1683703094538,ENG 15,A00,185667,Staff,0,1,0,0
1683703094538,ENG 15,B00,185672,Staff,0,0,0,0
1683703094538,ENG 15,C00,185675,Staff,0,0,0,0
1683703094538,ENG 15,D00,185682,Staff,0,0,0,0
1683703094538,ENG 15,E00,185684,Staff,0,0,0,0
1683703095567,ETHN 103,A00,185710,Staff,0,8,35,35
1683703096596,ETHN 103A,A00,199228,Man; Simeon S,0,0,9,9
1683703097625,ETHN 109,A00,185711,Staff,15,0,35,20
1683703098652,ETHN 142,A00,185726,Staff,0,4,30,30
1683703099680,ETHN 163J,A00,199229,Man; Simeon S,5,0,8,3
1683703100707,ETHN 168,A00,185727,Staff,7,0,10,3
1683703101732,ETHN 182,A00,185728,Staff,0,0,35,35
1683703102759,ETHN 183,A00,185737,Staff,9,0,18,9
1683703103787,GLBH 111,A01,209361,Burgos; Jose L.,0,0,0,0
1683703105841,HIEU 104,A00,185792,Staff,14,0,20,6
1683703106870,HIEU 115,A00,185800,Staff,0,0,20,20
1683703107896,HIEU 128,A00,185801,Staff,0,9,20,20
1683703108925,HIEU 147,A00,185802,Staff,15,0,20,5
1683703109954,HIEU 154,A00,185823,Staff,11,0,20,9
1683703110978,HILA 102,A00,185826,Staff,14,0,20,6
1683703112004,HILD 2C,A01,185778,Staff,0,13,20,20
1683703113030,HILD 7B,A01,185780,Kwak; Nancy,0,17,32,32
1683703113030,HILD 7B,A02,185781,Kwak; Nancy,0,18,32,32
1683703114061,HILD 30,A01,185791,Staff,12,0,20,8
1683703115093,HISC 119,A00,185830,Golan; Tal,0,10,20,20
1683703116118,HITO 156GS,A00,185831,Patterson; Patrick H.,0,0,0,23
1683703117147,HIUS 103,A00,185832,Man; Simeon S,0,4,20,20
1683703118180,HIUS 117,A00,185836,Kwak; Nancy,2,0,20,18
1683703119205,HIUS 125,A00,185840,Man; Simeon S,0,2,23,23
1683703120234,HIUS 149,A00,185845,Staff,1,0,20,19
1683703121261,HUM 3,A01,185882,Zavodny; Tatiana Sophia,0,8,50,50
1683703121261,HUM 3,B01,185899,Caldwell; Michael Alan,0,18,50,50
1683703122286,HUM 3GS,A00,185900,Patterson; Patrick H.,0,0,0,23
1683703123359,HUM 4,A01,185938,Zroka; Amy Liane,28,0,50,22
1683703123359,HUM 4,B01,185956,Watkins; Eric,0,6,50,50
1683703123359,HUM 4,B02,202209,Watkins; Eric,0,5,50,50
1683703123359,HUM 4,B03,202210,Watkins; Eric,0,5,50,50
1683703124403,HUM 5,A01,185958,West; Geoffrey Scott,0,0,50,50
1683703124403,HUM 5,A02,202215,West; Geoffrey Scott,0,1,50,50
1683703125437,INTL 190,A00,185959,Gagnon; Jeffrey C,0,0,0,9
1683703125437,INTL 190,B00,185960,Lettieri; Michael Joseph,0,0,0,2
1683703126467,JAPN 180,A00,254509,Staff,5,0,30,25
1683703127496,LATI 10,A01,202853,Kennemore; Amy Michelle,4,0,35,31
1683703127496,LATI 10,A02,202854,Kennemore; Amy Michelle,3,0,35,32
1683703127496,LATI 10,A03,270054,Kennemore; Amy Michelle,30,0,30,0
1683703128528,LATI 180,A00,202855,Kennemore; Amy Michelle,11,0,20,9
1683703129557,LAWS 101,A00,201767,Golan; Tal,0,7,40,40
1683703130588,LIFR 1C,A00,185961,Staff,6,0,20,14
1683703131636,LIFR 1CX,A00,185962,Staff,7,0,20,13
1683703132662,LIFR 1D,A00,185963,Staff,7,0,20,13
1683703133691,LIFR 1DX,A00,185964,Staff,7,0,20,13
1683703134719,LIGN 101,A01,186039,Staff,43,0,50,7
1683703135749,LIGN 165,A00,186040,Staff,14,0,50,36
1683703136776,LTCS 108,A00,186041,Staff,5,0,10,5
1683703137808,LTCS 119,A00,186042,Staff,15,0,20,5
1683703138836,LTCS 130,A00,186043,Wesling; Megan E.,15,0,25,10
1683703140890,LTEA 138,A00,186119,Staff,14,0,40,26
1683703141918,LTEN 124,A00,186148,Staff,5,0,25,20
1683703142942,LTEN 178,A00,186149,Staff,6,0,15,9
1683703143973,LTEN 181,A00,186150,Blanco; John D,34,0,40,6
1683703144998,LTWL 120,A00,186160,Staff,19,0,25,6
1683703146028,LTWL 165,A00,186161,Staff,22,0,25,3
1683703147059,LTWR 100,A00,186162,Staff,0,5,15,15
1683703148085,LTWR 102,A00,186163,Doller; Ben,5,0,15,10
1683703149113,MAE 8,A01,186412,Staff,0,1,0,0
1683703150149,MAE 30B,A00,186445,Bahadori; Mohammad Yousef,81,0,100,19
1683703151176,MAE 40,A00,186592,Bewley; Thomas R,10,0,50,40
1683703152209,MAE 101B,A00,186593,Bahadori; Mohammad Yousef,80,0,100,20
1683703153235,MAE 105,A00,186594,Bandaru; Prabhakar,10,0,50,40
1683703154261,MAE 107,A00,186599,Pham; Hieu Tan,0,8,120,120
1683703155295,MAE 148,A01,186660,Silberman; Jack,3,0,16,13
1683703156322,MATH 10A,A01,188095,Staff,0,6,35,35
1683703157349,MATH 10B,A01,188097,Bowers; Adam R.,0,12,30,30
1683703157349,MATH 10B,A02,188099,Bowers; Adam R.,0,11,30,30
1683703157349,MATH 10B,B01,188104,Bowers; Adam R.,0,10,30,30
1683703157349,MATH 10B,B02,188106,Bowers; Adam R.,0,9,30,30
1683703158393,MATH 10C,A01,188111,Staff,0,20,30,30
1683703158393,MATH 10C,A02,188127,Staff,0,19,30,30
1683703158393,MATH 10C,A03,188131,Staff,0,19,30,30
1683703158393,MATH 10C,B01,188218,Staff,17,0,30,13
1683703158393,MATH 10C,B02,188244,Staff,13,0,30,17
1683703158393,MATH 10C,B03,188277,Staff,14,0,30,16
1683703159420,MATH 18,A01,188344,Bach; Quang Tran,18,0,30,12
1683703159420,MATH 18,A02,188345,Bach; Quang Tran,11,0,30,19
1683703159420,MATH 18,B01,188353,Bach; Quang Tran,11,0,30,19
1683703159420,MATH 18,B02,188354,Bach; Quang Tran,19,0,30,11
1683703160452,MATH 20A,A01,188374,Staff,11,0,35,24
1683703161480,MATH 20B,A01,188382,Ohm; Ko Woon,7,0,30,23
1683703161480,MATH 20B,A02,188383,Ohm; Ko Woon,22,0,30,8
1683703161480,MATH 20B,B01,188385,Ohm; Ko Woon,7,0,30,23
1683703161480,MATH 20B,B02,188392,Ohm; Ko Woon,22,0,30,8
1683703162520,MATH 20C,A01,188394,Harel; Guershon,10,0,30,20
1683703162520,MATH 20C,A02,188395,Harel; Guershon,13,0,30,17
1683703162520,MATH 20C,B01,188404,Harel; Guershon,5,0,30,25
1683703162520,MATH 20C,B02,188405,Harel; Guershon,18,0,30,12
1683703163547,MATH 20D,A01,188414,Hammock; Frances H,0,1,30,30
1683703163547,MATH 20D,A02,188415,Hammock; Frances H,0,1,30,30
1683703163547,MATH 20D,B01,188447,Hammock; Frances H,0,1,30,30
1683703163547,MATH 20D,B02,188486,Hammock; Frances H,2,0,30,28
1683703164573,MATH 20E,A01,188649,Staff,21,0,30,9
1683703164573,MATH 20E,A02,188650,Staff,20,0,30,10
1683703164573,MATH 20E,A03,188673,Staff,0,0,30,30
1683703165603,MATH 102,A01,188675,Staff,0,40,35,35
1683703166684,MATH 103B,A01,188681,Staff,3,0,35,32
1683703166684,MATH 103B,B01,188692,Staff,5,0,35,30
1683703167710,MATH 109,A01,188695,Salehi Golsefidy; Alireza,24,0,35,11
1683703167710,MATH 109,A02,188696,Salehi Golsefidy; Alireza,25,0,35,10
1683703168741,MATH 120A,A01,188698,Eggers; John Dietrich,7,0,35,28
1683703169768,MATH 142B,A01,188736,Ioana; Adrian,0,0,30,30
1683703169768,MATH 142B,A02,188741,Ioana; Adrian,0,1,30,30
1683703169768,MATH 142B,A03,188743,Ioana; Adrian,0,2,30,30
1683703170801,MATH 168A,A01,188790,Staff,0,11,35,35
1683703171833,MATH 170A,A01,188803,Nie; Jiawang,0,2,35,35
1683703171833,MATH 170A,A02,188811,Nie; Jiawang,0,1,35,35
1683703171833,MATH 170A,A03,188814,Nie; Jiawang,0,0,35,35
1683703171833,MATH 170A,A04,188815,Nie; Jiawang,5,0,35,30
1683703172867,MATH 193B,A01,188817,Staff,0,0,35,35
1683703172867,MATH 193B,A02,188818,Staff,6,0,35,29
1683703173892,MGT 4,A01,202857,Anderson; John Charles,59,0,80,21
1683703174924,MGT 12,A00,202858,Lindenberger; Wade Douglas,40,0,90,50
1683703175952,MGT 18,A00,202859,Staff,73,0,90,17
1683703176978,MGT 18GS,A00,202860,McKay; Michael J,13,0,28,15
1683703178012,MGT 45,A00,202861,Pecore; Joseph P.,8,0,90,82
1683703179038,MGT 100,A00,202863,Yavorsky; Daniel Ryan,27,0,90,63
1683703180068,MGT 103,A00,202864,Ehrich; Kristine R,0,19,90,90
1683703181094,MGT 112,A00,202865,Ehrich; Kristine R,15,0,90,75
1683703182121,MGT 121A,A00,202868,Staff,70,0,90,20
1683703183147,MGT 131B,A00,202869,Anderson; John Charles,58,0,90,32
1683703184177,MGT 136,A00,202871,Lindenberger; Wade Douglas,83,0,90,7
1683703185203,MGT 164,A00,202873,Staff,0,67,90,91
1683703186233,MGT 164GS,A00,202874,McKay; Mary A,13,0,28,15
1683703187265,MGT 180,A00,202875,Staff,0,51,90,91
1683703188299,MMW 11R,A01,205019,Herbst; Matthew,0,0,30,30
1683703188299,MMW 11R,A02,205026,Herbst; Matthew,29,0,30,1
1683703189345,MMW 15,A01,193512,Chang; Edmond Yi-Teh,0,8,28,28
1683703189345,MMW 15,A02,193513,Chang; Edmond Yi-Teh,0,5,28,28
1683703189345,MMW 15,A03,193514,Chang; Edmond Yi-Teh,0,5,28,28
1683703189345,MMW 15,A04,193515,Chang; Edmond Yi-Teh,0,5,28,28
1683703189345,MMW 15,A05,193516,Chang; Edmond Yi-Teh,0,5,28,28
1683703189345,MMW 15,A06,193517,Chang; Edmond Yi-Teh,0,6,28,28
1683703189345,MMW 15,B01,193519,Chang; Edmond Yi-Teh,0,5,28,28
1683703189345,MMW 15,B02,193520,Chang; Edmond Yi-Teh,0,5,28,28
1683703189345,MMW 15,B03,193521,Chang; Edmond Yi-Teh,0,5,28,28
1683703189345,MMW 15,B04,193522,Chang; Edmond Yi-Teh,0,6,28,28
1683703189345,MMW 15,B05,193523,Chang; Edmond Yi-Teh,0,5,28,28
1683703189345,MMW 15,B06,193524,Chang; Edmond Yi-Teh,0,5,28,28
1683703190371,MMW 122,A01,193526,Rahimi; Babak,0,16,28,28
1683703190371,MMW 122,A02,193527,Rahimi; Babak,0,15,28,28
1683703190371,MMW 122,A03,193528,Rahimi; Babak,0,0,0,0
1683703190371,MMW 122,A04,193529,Rahimi; Babak,0,0,0,0
1683703191397,MUS 1A,A01,186663,Staff,0,18,35,35
1683703192426,MUS 4,A01,186715,Staff,0,12,35,35
1683703193458,MUS 5R,A01,186796,Dubnov; Shlomo,0,17,35,35
1683703194488,MUS 6,A01,186798,Staff,0,4,25,25
1683703195513,MUS 7,A01,186830,Staff,11,0,35,24
1683703196540,MUS 8,A01,186930,Staff,0,27,35,35
1683703197575,MUS 15,A01,186932,Staff,0,15,35,35
1683703197575,MUS 15,B01,186934,Staff,0,16,35,35
1683703198606,MUS 80,A00,186935,Staff,0,0,20,20
1683703198606,MUS 80,B00,186936,Staff,24,0,25,1
1683703199634,NANO 11,A00,204702,Lipomi; Darren John,0,0,0,0
1683703200664,NANO 15,A01,204709,Yang; Kesong,0,1,0,0
1683703201691,NANO 114,A00,202069,Jahed Motlagh; Zeinab,2,0,10,8
1683703202717,PHIL 1,A00,186955,Grush; Rick Scott,31,0,40,9
1683703203750,PHIL 10,A01,186973,Grush; Rick Scott,27,0,35,8
1683703203750,PHIL 10,A02,186974,Grush; Rick Scott,33,0,35,2
1683703204778,PHIL 13,A01,186976,Staff,1,0,35,34
1683703204778,PHIL 13,A02,186977,Staff,16,0,35,19
1683703205811,PHIL 14,A01,186979,Staff,30,0,35,5
1683703205811,PHIL 14,A02,186986,Staff,32,0,35,3
1683703206835,PHIL 28,A01,186988,Staff,16,0,30,14
1683703206835,PHIL 28,A02,186989,Staff,0,0,30,30
1683703206835,PHIL 28,A03,186990,Staff,10,0,30,20
1683703206835,PHIL 28,A04,186991,Staff,26,0,30,4
1683703207861,PHIL 120,A00,186997,Staff,23,0,40,17
1683703208893,PHIL 137,A00,187003,Staff,7,0,40,33
1683703209922,PHIL 150,A00,187015,Staff,47,0,70,23
1683703210947,PHIL 167,A00,187021,Lamey; Andy M.,34,0,40,6
1683703211973,PHIL 174,A01,202226,Staff,17,0,20,3
1683703211973,PHIL 174,A02,202235,Staff,20,0,20,0
1683703212998,PHIL 191A,A00,258918,Staff,0,0,1,1
1683703214040,PHYS 1A,A00,187028,Staff,26,0,60,34
1683703215066,PHYS 1AL,001,187036,Staff,3,0,30,27
1683703215066,PHYS 1AL,002,187049,Staff,18,0,30,12
1683703216096,PHYS 1B,A00,187058,Staff,21,0,60,39
1683703217129,PHYS 1BL,001,187064,Staff,0,1,30,30
1683703217129,PHYS 1BL,002,187070,Staff,4,0,30,26
1683703218160,PHYS 1C,A00,187082,Staff,30,0,120,90
1683703219187,PHYS 1CL,001,187088,Staff,0,9,30,30
1683703219187,PHYS 1CL,002,187089,Staff,0,1,30,30
1683703219187,PHYS 1CL,009,262693,Staff,9,0,30,21
1683703220214,PHYS 2B,A01,187097,Staff,55,0,115,60
1683703221240,PHYS 2C,A01,187099,Staff,63,0,115,52
1683703222274,PHYS 2CL,A01,187101,Staff,5,0,28,23
1683703222274,PHYS 2CL,A02,187102,Staff,15,0,28,13
1683703223299,PHYS 2D,A01,187123,Shotwell; Brian,95,0,115,20
1683703224330,PHYS 4B,A01,187133,Grinstein; Benjamin,35,0,50,15
1683703225357,POLI 10,A00,188819,Staff,0,4,50,50
1683703226385,POLI 11,A00,188827,Staff,43,0,50,7
1683703227409,POLI 13R,A00,188828,Staff,0,1,20,20
1683703228434,POLI 27,A01,188830,Elgin; Samuel Zincke,0,2,70,70
1683703229459,POLI 30,A00,188832,Desposato; Scott,30,0,50,20
1683703230491,POLI 102F,A00,188834,Staff,1,0,40,39
1683703231523,POLI 104A,A00,188852,Staff,12,0,30,18
1683703232548,POLI 104I,A00,188853,Staff,0,8,20,20
1683703233575,POLI 110B,A00,188854,Wiens; David,6,0,20,14
1683703234601,POLI 112A,A00,188855,Wiens; David,3,0,30,27
1683703235630,POLI 117R,A00,188856,Forman; Fonna,0,12,20,20
1683703236661,POLI 118,A00,188857,Ingham; Sean,8,0,20,12
1683703237691,POLI 120G,A00,188858,Staff,7,0,30,23
1683703238716,POLI 131CR,A00,188863,Hoston; Germaine,20,0,50,30
1683703239742,POLI 133,A00,188864,Nellis; Gareth Hb,44,0,50,6
1683703240773,POLI 134D,A00,188865,Desposato; Scott,27,0,30,3
1683703241801,POLI 142A,A00,188871,Gartzke; Erik,21,0,50,29
1683703242826,POLI 142K,A00,188874,Staff,38,0,50,12
1683703243851,POLI 143,A00,188940,Gartzke; Erik,15,0,30,15
1683703244877,POLI 153,A00,188943,Staff,1,0,20,19
1683703245906,POLI 160AA,A00,188944,Staff,10,0,40,30
1683703246930,POLI 170A,A00,188945,Staff,10,0,30,20
1683703248987,PSYC 1,A00,188952,Staff,36,0,90,54
1683703250013,PSYC 2,B00,188953,Staff,19,0,35,16
1683703251045,PSYC 6,A00,188970,Staff,47,0,60,13
1683703252081,PSYC 7,A00,188973,Staff,35,0,45,10
1683703253108,PSYC 60,A01,188980,Rickard; Timothy C.,42,0,60,18
1683703254140,PSYC 70,A01,189001,Steiner; Eric Tomas,22,0,45,23
1683703255172,PSYC 100,A00,189005,Lacefield; Katharine I,0,98,120,120
1683703256196,PSYC 102,A00,189008,Staff,6,0,30,24
1683703257222,PSYC 106,B00,189026,Gorman; Michael R.,27,0,60,33
1683703258250,PSYC 114,B01,189033,Winkielman; Piotr,0,31,30,30
1683703259284,PSYC 131,A00,189036,Anagnostaras; Stephan,0,44,60,60
1683703260317,PSYC 136,A00,189041,Lowe; Angela Beth,0,7,25,25
1683703261362,PSYC 137,A00,189057,Winkielman; Piotr,0,36,25,25
1683703262389,PSYC 144,A00,189107,Wixted; John T,0,11,50,50
1683703264447,PSYC 162,A00,189142,Staff,0,9,85,85
1683703265481,PSYC 172,A00,189144,Gorman; Michael R.,0,6,30,30
1683703267542,PSYC 179,A00,189146,Lacefield; Katharine I,0,88,120,120
1683703268568,PSYC 181,A00,189147,Anagnostaras; Stephan,0,45,90,90
1683703269600,PSYC 190R,A00,189148,Barner; David A.,0,23,80,80
1683703270697,PSYC 191,A00,189275,Rickard; Timothy C.,0,11,25,25
1683703271726,PSYC 193,A00,189276,Chapman; Eddie Nathaniel,0,1,0,4
1683703272757,PSYC 193L,A01,189281,Lowe; Angela Beth,8,0,20,12
1683703272757,PSYC 193L,B01,189285,Staff,28,0,35,7
1683703273784,RELI 149,A00,187137,Rahimi; Babak,6,0,40,34
1683703274810,SE 9,A01,187315,Staff,0,2,18,18
1683703275839,SE 101B,A00,187409,Staff,24,0,30,6
1683703276866,SE 110B,A00,187444,Staff,10,0,40,30
1683703277895,SE 130B,A00,187449,Staff,31,0,40,9
1683703278924,SE 150A,A00,187516,Staff,8,0,20,12
1683703279960,SE 154,A00,187528,Staff,29,0,50,21
1683703280986,SIO 3,A01,258171,Staff,35,0,40,5
1683703282016,SIO 10,A00,187144,Cook; Geoffrey W,0,6,75,75
1683703283044,SIO 45,A00,187152,Cook; Geoffrey W,1,7,100,99
1683703284069,SIO 109R,A00,194486,Staff,0,4,20,20
1683703286126,SIO 187,A01,187233,Kacev; David,12,0,40,28
1683703287160,SOCI 1,A01,258656,Thorpe; Charles Robert,28,0,30,2
1683703287160,SOCI 1,A02,258658,Thorpe; Charles Robert,30,0,30,0
1683703287160,SOCI 1,A03,258661,Thorpe; Charles Robert,25,0,25,0
1683703287160,SOCI 1,A04,258666,Thorpe; Charles Robert,22,0,25,3
1683703287160,SOCI 1,A05,258897,Thorpe; Charles Robert,22,0,25,3
1683703287160,SOCI 1,A06,258898,Thorpe; Charles Robert,25,0,25,0
1683703288187,SOCI 30,A01,258903,Pardo Guerra; Juan Pablo,14,0,30,16
1683703289215,SOCI 102,A00,258904,Staff,9,0,25,16
1683703290240,SOCI 106,A00,258905,Staff,19,0,25,6
1683703291264,SOCI 111,A00,258907,Ribas Norris; Janet Vanesa,26,0,30,4
1683703292286,SOCI 121R,A00,258908,Pardo Guerra; Juan Pablo,7,0,30,23
1683703293312,SOCI 126,A01,203330,Staff,14,0,20,6
1683703294335,SOCI 131,A00,258909,Thorpe; Charles Robert,30,0,60,30
1683703295358,SOCI 135,A00,258910,Payne; Christine Anna,0,13,30,30
1683703296383,SOCI 157,A00,258911,Staff,10,0,30,20
1683703297410,SOCI 184,A00,258912,Staff,25,0,30,5
1683703298435,SOCI 188D,A00,258913,Staff,22,0,30,8
1683703299466,SYN 2,001,187529,Staff,9,0,16,7
1683703299466,SYN 2,002,201452,Staff,0,20,16,16
1683703299466,SYN 2,003,201469,Staff,1,0,16,15
1683703300491,SYN 100,A01,187531,Staff,0,9,20,20
1683703300491,SYN 100,B01,201491,Staff,0,10,20,20
1683703301516,TDAC 1,A00,189286,Walsh; Kim C.,3,0,20,17
1683703301516,TDAC 1,B00,189287,Harting; Carla Kelso,10,0,20,10
1683703302545,TDAC 101,A00,189300,Walsh; Kim C.,16,0,20,4
1683703302545,TDAC 101,B00,189301,Harting; Carla Kelso,18,0,20,2
1683703303574,TDAC 102,A00,189304,Basso; Beatrice,14,0,20,6
1683703304603,TDAC 108,A00,189305,Staff,18,0,20,2
1683703305630,TDDE 131,A00,189310,Staff,19,0,20,1
1683703305630,TDDE 131,B00,189314,Staff,19,0,20,1
1683703305630,TDDE 131,C00,189315,Staff,48,0,50,2
1683703305630,TDDE 131,D00,189316,Staff,14,0,15,1
1683703305630,TDDE 131,E00,204841,Staff,20,0,20,0
1683703306660,TDGE 10,A00,189289,Staff,27,0,50,23
1683703306660,TDGE 10,B00,189290,Havis; Allan,0,1,50,50
1683703307688,TDGE 11,A00,189291,Fulton; Julia,0,4,50,50
1683703307688,TDGE 11,B00,189292,Staff,20,0,25,5
1683703307688,TDGE 11,C00,260270,Staff,0,0,0,0
1683703308717,TDGE 25,A00,189294,Staff,1,0,20,19
1683703309745,TDGE 124,A00,189318,Fulton; Julia,0,7,50,50
1683703310773,TDGE 125,A00,189319,Staff,13,0,25,12
1683703310773,TDGE 125,B00,189320,Staff,23,0,25,2
1683703311802,TDGE 127,A00,189322,Havis; Allan,1,0,50,49
1683703312828,TDHT 101,A00,189323,Staff,18,0,25,7
1683703312828,TDHT 101,B00,189324,Staff,25,0,25,0
1683703313857,TDHT 102,A00,189325,Staff,49,0,50,1
1683703314888,TDMV 1,A00,189295,Arcidiacono; Kristin,20,0,30,10
1683703314888,TDMV 1,B00,189296,Caligagan; Maria T.,23,0,30,7
1683703315913,TDMV 2,A00,189297,Sammartano; Tonnie,27,0,30,3
1683703315913,TDMV 2,B00,189299,Arcidiacono; Kristin,23,0,30,7
1683703316942,TDMV 3,A00,204998,Rincon; Alicia,22,0,30,8
1683703317971,TDMV 120,A00,189458,Sammartano; Tonnie,28,0,30,2
1683703318997,TDMV 138,A00,189541,Jun; Grace Shin Hae,20,0,40,20
1683703320023,TDMV 142,A00,189717,Caligagan; Tony,25,0,30,5
1683703320023,TDMV 142,B00,189718,Caligagan; Maria T.,25,0,30,5
1683703321054,TMC 2,A01,187533,Staff,25,0,25,0
1683703321054,TMC 2,A02,187534,Staff,25,0,25,0
1683703322084,USP 1,A01,187536,Kwak; Nancy,0,16,25,25
1683703323110,USP 5,A01,187538,Staff,8,0,25,17
1683703324136,USP 101,A00,199253,Staff,0,4,0,0
1683703325164,USP 124,A00,187562,Boomhower; Matthew Charles,0,0,30,30
1683703326188,USP 138,A00,187582,Staff,19,0,25,6
1683703327213,USP 152,A01,187597,Staff,3,0,25,22
1683703328242,USP 153,A00,187598,Staff,18,0,25,7
1683703329272,USP 168,A00,187607,Kwak; Nancy,2,0,5,3
1683703330299,USP 173,A00,187619,Staff,4,0,25,21
1683703331325,USP 181,A00,187638,Staff,0,4,25,25
1683703332356,VIS 103,A00,187650,Cruz; Edwin Teddy,17,0,75,58
1683703333381,VIS 110D,A00,187669,Staff,13,0,22,9
1683703334408,VIS 127C,A00,187720,Shen; Kuiyi,67,0,146,79
1683703335436,VIS 149,A00,187731,Yoldas; Pinar,0,12,22,22
1683703336461,VIS 151,A01,188091,Staff,22,0,34,12
1683703336461,VIS 151,A02,188092,Staff,11,0,34,23
1683703337491,VIS 160B,A00,188093,Stalbaum; Brett,0,1,10,10
1683703339545,WCWP 10B,A00,201720,Staff,0,0,5,5
1683703339545,WCWP 10B,B00,201722,Staff,0,0,6,6
1683703340570,WCWP 100,A00,201725,Gagnon; Jeffrey C,0,0,2,2
1683703340570,WCWP 100,B00,201727,Staff,0,4,15,15
1683703343725,ANBI 133,A00,258401,Wilder; Linnea Lorene,34,0,40,6
1683703344753,ANBI 140,A00,258395,Hrvoj Mihic; Branka,18,0,25,7
1683703345778,ANSC 120,A00,258402,Bialecki; Jon Anthony,26,0,40,14
1683703346803,ANSC 144,A00,258400,Staff,12,0,40,28
1683703348858,ANSC 166,A00,258396,Parish; Steven Martin,156,0,175,19
1683703349886,ANSC 180,A00,193533,Staff,8,0,20,12
1683703350917,ANSC 188,A00,258397,Jassal; Aftab,34,0,40,6
1683703351942,ANTH 3,A01,258316,Staff,23,0,30,7
1683703352969,ANTH 5,A00,258394,Semendeferi; Ekaterini,16,0,20,4
1683703353997,ANTH 21,A01,258331,Staff,4,0,40,36
1683703355026,ANTH 103,A00,258398,Varma; Saiba,15,0,25,10
1683703356065,AWP 10,001,202034,Staff,0,0,0,0
1683703356065,AWP 10,002,202035,Staff,0,0,0,0
1683703356065,AWP 10,003,202036,Staff,0,0,0,0
1683703356065,AWP 10,004,202037,Staff,0,0,0,0
1683703356065,AWP 10,005,202038,Staff,0,0,0,0
1683703356065,AWP 10,006,202039,Staff,0,0,0,0
1683703356065,AWP 10,007,202040,Staff,0,0,0,0
1683703356065,AWP 10,008,202041,Staff,0,0,0,0
1683703356065,AWP 10,009,202042,Staff,0,0,0,0
1683703356065,AWP 10,010,202043,Staff,0,0,0,0
1683703356065,AWP 10,011,202044,Staff,0,0,0,0
1683703356065,AWP 10,012,202045,Staff,0,0,0,0
1683703356065,AWP 10,013,202046,Staff,0,0,0,0
1683703356065,AWP 10,014,202047,Staff,0,0,0,0
1683703356065,AWP 10,015,202048,Staff,0,0,0,0
1683703356065,AWP 10,016,202049,Staff,0,0,0,0
1683703356065,AWP 10,017,202050,Staff,0,0,0,0
1683703356065,AWP 10,018,202051,Staff,0,0,0,0
1683703356065,AWP 10,019,202052,Staff,0,0,0,0
1683703356065,AWP 10,020,202053,Staff,0,0,0,0
1683703356065,AWP 10,021,202054,Staff,0,0,0,0
1683703356065,AWP 10,022,202055,Staff,0,0,0,0
1683703356065,AWP 10,023,202056,Staff,0,0,0,0
1683703356065,AWP 10,024,202057,Staff,0,0,0,0
1683703356065,AWP 10,025,202058,Staff,0,0,0,0
1683703356065,AWP 10,026,202059,Staff,0,0,0,0
1683703357093,AWP 102,001,202032,Staff,0,0,0,0
1683703357093,AWP 102,002,202033,Staff,0,0,0,0
1683703358123,BENG 100,A01,254234,Taylor Amos; Alyssa C,31,0,40,9
1683703359152,BENG 196,001,270013,Engler; Adam J.,9999,0,9999,0
1683703360184,BICD 100R,A01,202018,Smith; Laurie,0,7,32,32
1683703360184,BICD 100R,A02,202019,Smith; Laurie,0,3,32,32
1683703360184,BICD 100R,A03,202020,Smith; Laurie,0,1,32,32
1683703360184,BICD 100R,A04,202021,Smith; Laurie,6,0,32,26
1683703360184,BICD 100R,A05,202022,Smith; Laurie,10,0,32,22
1683703361214,BICD 136,A01,193242,Gustafson-Brown; Cindy,0,2,32,32
1683703361214,BICD 136,A02,193244,Gustafson-Brown; Cindy,13,0,32,19
1683703362247,BIEB 102,A01,193249,Butler; Shannon Rhey,0,0,32,32
1683703362247,BIEB 102,A02,193251,Butler; Shannon Rhey,0,0,32,32
1683703362247,BIEB 102,A03,193253,Butler; Shannon Rhey,0,0,32,32
1683703362247,BIEB 102,A04,193255,Butler; Shannon Rhey,13,0,32,19
1683703362247,BIEB 102,A05,193265,Butler; Shannon Rhey,25,0,32,7
1683703362247,BIEB 102,A06,193269,Butler; Shannon Rhey,12,0,32,20
1683703364300,BIEB 150,A01,193274,Staff,0,0,32,32
1683703364300,BIEB 150,A02,193285,Staff,24,0,32,8
1683703365329,BIEB 194,A00,193286,Kurle; Carolyn M.,19,0,32,13
1683703366365,BILD 1,A01,192291,Staff,15,0,32,17
1683703366365,BILD 1,A02,192292,Staff,30,0,32,2
1683703366365,BILD 1,B01,192520,Reuther; Keefe,0,1,0,0
1683703366365,BILD 1,B02,192532,Reuther; Keefe,0,1,0,0
1683703367398,BILD 3,A01,192556,Butler; Shannon Rhey,0,0,32,32
1683703367398,BILD 3,A02,192581,Butler; Shannon Rhey,0,1,32,32
1683703367398,BILD 3,A03,192611,Butler; Shannon Rhey,19,0,32,13
1683703367398,BILD 3,A04,192612,Butler; Shannon Rhey,23,0,32,9
1683703367398,BILD 3,A05,192613,Butler; Shannon Rhey,26,0,32,6
1683703367398,BILD 3,A06,192679,Butler; Shannon Rhey,27,0,32,5
1683703367398,BILD 3,A07,192682,Butler; Shannon Rhey,20,0,32,12
1683703368428,BILD 4,A01,192836,Reuther; Keefe,1,0,24,23
1683703368428,BILD 4,A02,193044,Reuther; Keefe,4,0,24,20
1683703369460,BILD 10,A01,193142,Gustafson-Brown; Cindy,29,0,32,3
1683703369460,BILD 10,A02,193149,Gustafson-Brown; Cindy,31,0,32,1
1683703370485,BIMM 100,A01,193301,Staff,0,6,32,32
1683703370485,BIMM 100,A02,193312,Staff,0,7,32,32
1683703370485,BIMM 100,A03,193323,Staff,0,10,32,32
1683703371512,BIMM 101,A01,193329,McDonnell; Lisa Marie,0,3,24,24
1683703371512,BIMM 101,A02,193339,McDonnell; Lisa Marie,0,3,24,24
1683703371512,BIMM 101,B01,193354,McDonnell; Lisa Marie,0,4,24,24
1683703371512,BIMM 101,B02,193357,McDonnell; Lisa Marie,0,3,24,24
1683703372538,BIMM 110,A01,193377,Tat; John,0,11,32,32
1683703372538,BIMM 110,A02,193378,Tat; John,0,11,32,32
1683703373569,BIMM 120,A01,206116,Staff,0,0,32,32
1683703373569,BIMM 120,A02,206117,Staff,7,0,32,25
1683703373569,BIMM 120,A03,206121,Staff,21,0,32,11
1683703374655,BIPN 100,A01,193393,Park; Ji Young,0,15,32,32
1683703374655,BIPN 100,A02,193402,Park; Ji Young,0,14,32,32
1683703374655,BIPN 100,A03,193413,Park; Ji Young,0,14,32,32
1683703374655,BIPN 100,A04,193414,Park; Ji Young,0,13,32,32
1683703375680,BIPN 102,A01,193429,Staff,0,0,32,32
1683703375680,BIPN 102,A02,193438,Staff,18,0,32,14
1683703376710,BIPN 106,A01,193450,Reyes Gonzalez; Catalina,0,2,40,40
1683703377743,BIPN 134,A01,193465,Cooke; James Edward,0,0,32,32
1683703377743,BIPN 134,A02,193474,Cooke; James Edward,25,0,32,7
1683703377743,BIPN 134,A03,193485,Cooke; James Edward,29,0,32,3
1683703377743,BIPN 134,A04,193486,Cooke; James Edward,20,0,32,12
1683703377743,BIPN 134,A05,193491,Cooke; James Edward,31,0,32,1
1683703377743,BIPN 134,A06,193501,Cooke; James Edward,30,0,32,2
1683703377743,BIPN 134,A07,193510,Cooke; James Edward,29,0,32,3
1683703379797,BISP 194,A00,222522,Staff,14,0,32,18
1683703380824,CAT 124,A01,202407,Staff,19,0,25,6
1683703381863,CAT 125,A00,202408,Marchisotto; Jennifer Anne,2,0,20,18
1683703382890,CAT 125R,A00,202409,Smith; Lauryn Alissa,0,11,20,20
1683703382890,CAT 125R,B00,202410,Morales; Celeste Georgianna,0,11,20,20
1683703382890,CAT 125R,C00,202411,Irwin; Matthew Joseph,0,12,20,20
1683703383924,CENG 15,A01,204712,Yang; Kesong,0,1,0,0
1683703384958,CENG 114,A00,202070,Jahed Motlagh; Zeinab,5,0,20,15
1683703385989,CGS 105,A00,185477,Wesling; Megan E.,24,0,40,16
1683703387020,CGS 106,A00,185494,Staff,11,0,22,11
1683703388046,CGS 108,A00,185495,Staff,14,0,20,6
1683703389072,CGS 114,A00,185496,Staff,13,0,18,5
1683703390101,CGS 119,A00,185501,Staff,15,0,20,5
1683703391130,CGS 120,A00,185511,Staff,11,0,20,9
1683703392157,CHEM 4,A01,184675,Bussey; Thomas J,97,0,100,3
1683703393182,CHEM 6A,A01,184677,Staff,32,0,60,28
1683703394208,CHEM 6B,A01,184679,Staff,63,0,100,37
1683703395237,CHEM 6C,A01,184681,Bussey; Thomas J,0,0,50,50
1683703395237,CHEM 6C,A02,184682,Bussey; Thomas J,32,0,50,18
1683703396265,CHEM 40A,A01,184684,Albizati; Kim F.,33,0,100,67
1683703397296,CHEM 40B,A01,184686,Albizati; Kim F.,0,22,100,100
1683703398320,CHEM 41B,A01,184690,Staff,51,0,100,49
1683703399344,COGS 3,A01,184715,Boyle; Mary E. T.,0,27,40,40
1683703400373,COGS 14B,A01,185172,Staff,0,14,38,38
1683703401404,COGS 18,A01,184736,Staff,14,0,80,66
1683703402430,COGS 100,A01,184932,Staff,0,8,73,73
1683703403456,COGS 101A,A01,184935,Staff,0,40,30,30
1683703404482,COGS 101B,A01,184944,Staff,0,2,30,30
1683703405506,COGS 101C,A01,184946,Staff,0,10,30,30
1683703406531,COGS 102A,A01,184951,Johnson; Christine M.,1,0,40,39
1683703407562,COGS 107B,A01,184953,Mooshagian; Eric Frederick,0,52,40,40
1683703408586,COGS 118B,A01,184959,Gupta; Anjum,0,50,40,40
1683703409610,COGS 153,A00,184961,Staff,1,16,30,29
1683703410640,COGS 177,A00,184962,Staff,0,20,30,30
1683703411664,COGS 187A,A01,184969,Boyle; Mary E. T.,0,19,40,40
1683703412690,COMM 10,A01,185174,Staff,0,5,25,25
1683703412690,COMM 10,A02,185189,Staff,0,2,25,25
1683703412690,COMM 10,A03,269821,Staff,0,1,0,0
1683703413718,COMM 100B,A02,185476,Staff,10,0,25,15
1683703413718,COMM 100B,A03,277340,Staff,25,0,25,0
1683703414744,COMM 100C,A01,185314,Staff,2,0,25,23
1683703414744,COMM 100C,A02,185327,Staff,17,0,25,8
1683703415772,COMM 110M,A00,185349,Staff,0,0,40,40
1683703416797,COMM 113T,A00,185352,Staff,25,0,40,15
1683703417824,COMM 114I,A00,185353,Staff,31,0,40,9
1683703418851,COMM 131,A00,185354,Staff,17,0,30,13
1683703419876,CSE 8A,A50,185358,Cao; Yingjun,0,46,10,10
1683703420903,CSE 8B,A01,185362,Staff,0,48,50,50
1683703421927,CSE 11,A01,185416,Cao; Yingjun,0,91,10,10
1683703422952,CSE 20,A01,185445,Briones; Jor-el Thomas Caparas,3,0,25,22
1683703423977,CSE 21,A01,185447,Staff,9,0,50,41
1683703425007,CSE 101,A01,185451,Staff,0,13,50,50
1683703425007,CSE 101,B01,185453,Jones; Miles E,0,15,50,50
1683703427057,CSE 141,A01,185458,Eldon; John,16,0,100,84
1683703428086,CSE 141L,A01,185461,Eldon; John,8,0,100,92
1683703429111,CSE 142,A01,185463,Staff,34,0,60,26
1683703429111,CSE 142,B01,201355,Staff,0,7,60,60
1683703430136,CSE 142L,A01,185470,Staff,34,0,60,26
1683703430136,CSE 142L,B01,201417,Staff,0,6,60,60
1683703431161,CSE 190,A00,201433,Staff,32,0,49,17
1683703432190,DOC 1,A01,259136,Strom; Megan C.,7,0,15,8
1683703432190,DOC 1,A02,259137,Strom; Megan C.,14,0,15,1
1683703432190,DOC 1,A03,259138,Strom; Megan C.,14,0,15,1
1683703432190,DOC 1,A04,259139,Strom; Megan C.,14,0,15,1
1683703433217,DOC 100D,A00,259140,Pass; Natalye Joann,14,0,25,11
1683703434244,DSGN 1,A01,184749,Rill; Bryan,0,26,30,30
1683703435268,DSGN 100,A01,185168,Staff,0,2,25,25
1683703436295,ECE 5,A01,185626,Morris; Karcher William,0,12,0,0
1683703437319,ECE 101,A01,185628,Staff,14,0,70,56
1683703438342,ECE 107,A01,185635,Baghdadchi; Saharnaz,0,0,20,20
1683703438342,ECE 107,A02,185638,Baghdadchi; Saharnaz,1,0,20,19
1683703439367,ECE 148,A01,185647,Silberman; Jack,0,0,16,16
1683703440393,ECON 1,A01,185537,Crane; Meredith Helen,54,0,70,16
1683703441417,ECON 3,A01,185549,Crane; Meredith Helen,30,0,70,40
1683703442443,ECON 4,A01,203354,Anderson; John Charles,0,5,10,10
1683703443472,ECON 100A,A01,185574,Staff,0,5,40,40
1683703444502,ECON 100B,A01,185576,Staff,0,12,50,50
1683703445530,ECON 100C,A01,185589,Newhouse; Herbert S,30,0,70,40
1683703446558,ECON 105,A00,185608,Vespa; Emanuel Ignacio,19,0,35,16
1683703447585,ECON 109,A01,185610,Shishkin; Denis,9,0,35,26
1683703448612,ECON 110A,A01,185612,Staff,8,0,40,32
1683703449642,ECON 120A,A01,185615,Staff,19,0,40,21
1683703450668,ECON 120C,A01,185617,Sun; Yixiao,0,21,70,70
1683703451697,ECON 144,A00,203346,Squires; Dale E,2,0,35,33
1683703452723,ECON 171,A01,203349,Newhouse; Herbert S,0,1,35,35
1683703453750,ECON 173A,A01,185621,Toda; Alexis Akira,21,0,35,14
1683703454783,EDS 25,A01,202413,Staff,0,1,0,0
1683703454783,EDS 25,A02,202414,Staff,0,1,0,0
1683703454783,EDS 25,A03,202415,Staff,0,0,0,0
1683703454783,EDS 25,A04,202416,Staff,0,1,0,0
1683703454783,EDS 25,A05,202439,Staff,0,0,0,0
1683703454783,EDS 25,A06,202440,Staff,0,0,0,0
1683703454783,EDS 25,B01,202631,Staff,0,0,0,0
1683703454783,EDS 25,B02,202632,Staff,0,0,0,0
1683703454783,EDS 25,B03,202639,Staff,0,0,0,0
1683703454783,EDS 25,B04,202640,Staff,0,0,0,0
1683703454783,EDS 25,B05,202643,Staff,0,0,0,0
1683703454783,EDS 25,B06,202644,Staff,0,0,0,0
1683703455815,EDS 38,A01,202659,Black; Alison Michelle,25,0,25,0
1683703456844,EDS 115,A00,202652,Staff,18,0,30,12
1683703457874,EDS 125,A00,202649,Staff,13,0,30,17
1683703458902,EDS 126,A01,203332,Staff,30,0,30,0
1683703459926,EDS 139,A00,202838,Staff,16,0,25,9
1683703460950,EDS 146,A01,202655,Staff,14,0,25,11
1683703461976,ENG 15,A00,185667,Staff,0,1,0,0
1683703461976,ENG 15,B00,185672,Staff,0,0,0,0
1683703461976,ENG 15,C00,185675,Staff,0,0,0,0
1683703461976,ENG 15,D00,185682,Staff,0,0,0,0
1683703461976,ENG 15,E00,185684,Staff,0,0,0,0
1683703463005,ETHN 103,A00,185710,Staff,0,8,35,35
1683703464029,ETHN 103A,A00,199228,Man; Simeon S,0,0,9,9
1683703465054,ETHN 109,A00,185711,Staff,15,0,35,20
1683703466083,ETHN 142,A00,185726,Staff,0,4,30,30
1683703467108,ETHN 163J,A00,199229,Man; Simeon S,5,0,8,3
1683703468137,ETHN 168,A00,185727,Staff,7,0,10,3
1683703469165,ETHN 182,A00,185728,Staff,0,0,35,35
1683703470191,ETHN 183,A00,185737,Staff,9,0,18,9
1683703471216,GLBH 111,A01,209361,Burgos; Jose L.,0,0,0,0
1683703473267,HIEU 104,A00,185792,Staff,14,0,20,6
1683703474292,HIEU 115,A00,185800,Staff,0,0,20,20
1683703475318,HIEU 128,A00,185801,Staff,0,9,20,20
1683703476343,HIEU 147,A00,185802,Staff,15,0,20,5
1683703477369,HIEU 154,A00,185823,Staff,11,0,20,9
1683703478449,HILA 102,A00,185826,Staff,14,0,20,6
1683703479474,HILD 2C,A01,185778,Staff,0,13,20,20
1683703480497,HILD 7B,A01,185780,Kwak; Nancy,0,17,32,32
1683703480497,HILD 7B,A02,185781,Kwak; Nancy,0,18,32,32
1683703481529,HILD 30,A01,185791,Staff,12,0,20,8
1683703482554,HISC 119,A00,185830,Golan; Tal,0,10,20,20
1683703483578,HITO 156GS,A00,185831,Patterson; Patrick H.,0,0,0,23
1683703484604,HIUS 103,A00,185832,Man; Simeon S,0,4,20,20
1683703485636,HIUS 117,A00,185836,Kwak; Nancy,2,0,20,18
1683703486659,HIUS 125,A00,185840,Man; Simeon S,0,2,23,23
1683703487685,HIUS 149,A00,185845,Staff,1,0,20,19
1683703488713,HUM 3,A01,185882,Zavodny; Tatiana Sophia,0,8,50,50
1683703488713,HUM 3,B01,185899,Caldwell; Michael Alan,0,18,50,50
1683703489737,HUM 3GS,A00,185900,Patterson; Patrick H.,0,0,0,23
1683703490763,HUM 4,A01,185938,Zroka; Amy Liane,28,0,50,22
1683703490763,HUM 4,B01,185956,Watkins; Eric,0,6,50,50
1683703490763,HUM 4,B02,202209,Watkins; Eric,0,5,50,50
1683703490763,HUM 4,B03,202210,Watkins; Eric,0,5,50,50
1683703491788,HUM 5,A01,185958,West; Geoffrey Scott,0,0,50,50
1683703491788,HUM 5,A02,202215,West; Geoffrey Scott,0,1,50,50
1683703492813,INTL 190,A00,185959,Gagnon; Jeffrey C,0,0,0,9
1683703492813,INTL 190,B00,185960,Lettieri; Michael Joseph,0,0,0,2
1683703493841,JAPN 180,A00,254509,Staff,5,0,30,25
1683703494870,LATI 10,A01,202853,Kennemore; Amy Michelle,4,0,35,31
1683703494870,LATI 10,A02,202854,Kennemore; Amy Michelle,3,0,35,32
1683703494870,LATI 10,A03,270054,Kennemore; Amy Michelle,30,0,30,0
1683703495894,LATI 180,A00,202855,Kennemore; Amy Michelle,11,0,20,9
1683703496926,LAWS 101,A00,201767,Golan; Tal,0,7,40,40
1683703497951,LIFR 1C,A00,185961,Staff,6,0,20,14
1683703498977,LIFR 1CX,A00,185962,Staff,7,0,20,13
1683703500002,LIFR 1D,A00,185963,Staff,7,0,20,13
1683703501029,LIFR 1DX,A00,185964,Staff,7,0,20,13
1683703502057,LIGN 101,A01,186039,Staff,43,0,50,7
1683703503085,LIGN 165,A00,186040,Staff,14,0,50,36
1683703504114,LTCS 108,A00,186041,Staff,5,0,10,5
1683703505145,LTCS 119,A00,186042,Staff,15,0,20,5
1683703506170,LTCS 130,A00,186043,Wesling; Megan E.,15,0,25,10
1683703508222,LTEA 138,A00,186119,Staff,14,0,40,26
1683703509246,LTEN 124,A00,186148,Staff,5,0,25,20
1683703510271,LTEN 178,A00,186149,Staff,6,0,15,9
1683703511297,LTEN 181,A00,186150,Blanco; John D,34,0,40,6
1683703512321,LTWL 120,A00,186160,Staff,19,0,25,6
1683703513350,LTWL 165,A00,186161,Staff,22,0,25,3
1683703514377,LTWR 100,A00,186162,Staff,0,5,15,15
1683703515402,LTWR 102,A00,186163,Doller; Ben,5,0,15,10
1683703516428,MAE 8,A01,186412,Staff,0,1,0,0
1683703517453,MAE 30B,A00,186445,Bahadori; Mohammad Yousef,81,0,100,19
1683703518478,MAE 40,A00,186592,Bewley; Thomas R,10,0,50,40
1683703519507,MAE 101B,A00,186593,Bahadori; Mohammad Yousef,80,0,100,20
1683703520534,MAE 105,A00,186594,Bandaru; Prabhakar,10,0,50,40
1683703521559,MAE 107,A00,186599,Pham; Hieu Tan,0,8,120,120
1683703522589,MAE 148,A01,186660,Silberman; Jack,3,0,16,13
1683703523618,MATH 10A,A01,188095,Staff,0,6,35,35
1683703524649,MATH 10B,A01,188097,Bowers; Adam R.,0,12,30,30
1683703524649,MATH 10B,A02,188099,Bowers; Adam R.,0,11,30,30
1683703524649,MATH 10B,B01,188104,Bowers; Adam R.,0,10,30,30
1683703524649,MATH 10B,B02,188106,Bowers; Adam R.,0,9,30,30
1683703525682,MATH 10C,A01,188111,Staff,0,20,30,30
1683703525682,MATH 10C,A02,188127,Staff,0,19,30,30
1683703525682,MATH 10C,A03,188131,Staff,0,19,30,30
1683703525682,MATH 10C,B01,188218,Staff,17,0,30,13
1683703525682,MATH 10C,B02,188244,Staff,13,0,30,17
1683703525682,MATH 10C,B03,188277,Staff,14,0,30,16
1683703526708,MATH 18,A01,188344,Bach; Quang Tran,18,0,30,12
1683703526708,MATH 18,A02,188345,Bach; Quang Tran,11,0,30,19
1683703526708,MATH 18,B01,188353,Bach; Quang Tran,11,0,30,19
1683703526708,MATH 18,B02,188354,Bach; Quang Tran,19,0,30,11
1683703527733,MATH 20A,A01,188374,Staff,11,0,35,24
1683703528761,MATH 20B,A01,188382,Ohm; Ko Woon,7,0,30,23
1683703528761,MATH 20B,A02,188383,Ohm; Ko Woon,22,0,30,8
1683703528761,MATH 20B,B01,188385,Ohm; Ko Woon,7,0,30,23
1683703528761,MATH 20B,B02,188392,Ohm; Ko Woon,22,0,30,8
1683703529787,MATH 20C,A01,188394,Harel; Guershon,10,0,30,20
1683703529787,MATH 20C,A02,188395,Harel; Guershon,13,0,30,17
1683703529787,MATH 20C,B01,188404,Harel; Guershon,5,0,30,25
1683703529787,MATH 20C,B02,188405,Harel; Guershon,18,0,30,12
1683703530813,MATH 20D,A01,188414,Hammock; Frances H,0,1,30,30
1683703530813,MATH 20D,A02,188415,Hammock; Frances H,0,1,30,30
1683703530813,MATH 20D,B01,188447,Hammock; Frances H,0,1,30,30
1683703530813,MATH 20D,B02,188486,Hammock; Frances H,2,0,30,28
1683703531844,MATH 20E,A01,188649,Staff,21,0,30,9
1683703531844,MATH 20E,A02,188650,Staff,20,0,30,10
1683703531844,MATH 20E,A03,188673,Staff,0,0,30,30
1683703532869,MATH 102,A01,188675,Staff,0,40,35,35
1683703533895,MATH 103B,A01,188681,Staff,3,0,35,32
1683703533895,MATH 103B,B01,188692,Staff,5,0,35,30
1683703534920,MATH 109,A01,188695,Salehi Golsefidy; Alireza,24,0,35,11
1683703534920,MATH 109,A02,188696,Salehi Golsefidy; Alireza,25,0,35,10
1683703535946,MATH 120A,A01,188698,Eggers; John Dietrich,7,0,35,28
1683703536970,MATH 142B,A01,188736,Ioana; Adrian,0,0,30,30
1683703536970,MATH 142B,A02,188741,Ioana; Adrian,0,1,30,30
1683703536970,MATH 142B,A03,188743,Ioana; Adrian,0,2,30,30
1683703537995,MATH 168A,A01,188790,Staff,0,11,35,35
1683703539027,MATH 170A,A01,188803,Nie; Jiawang,0,2,35,35
1683703539027,MATH 170A,A02,188811,Nie; Jiawang,0,1,35,35
1683703539027,MATH 170A,A03,188814,Nie; Jiawang,0,0,35,35
1683703539027,MATH 170A,A04,188815,Nie; Jiawang,5,0,35,30
1683703540053,MATH 193B,A01,188817,Staff,0,0,35,35
1683703540053,MATH 193B,A02,188818,Staff,6,0,35,29
1683703541077,MGT 4,A01,202857,Anderson; John Charles,59,0,80,21
1683703542102,MGT 12,A00,202858,Lindenberger; Wade Douglas,40,0,90,50
1683703543126,MGT 18,A00,202859,Staff,73,0,90,17
1683703544152,MGT 18GS,A00,202860,McKay; Michael J,13,0,28,15
1683703545176,MGT 45,A00,202861,Pecore; Joseph P.,8,0,90,82
1683703546201,MGT 100,A00,202863,Yavorsky; Daniel Ryan,27,0,90,63
1683703547228,MGT 103,A00,202864,Ehrich; Kristine R,0,19,90,90
1683703548253,MGT 112,A00,202865,Ehrich; Kristine R,15,0,90,75
1683703549282,MGT 121A,A00,202868,Staff,70,0,90,20
1683703550312,MGT 131B,A00,202869,Anderson; John Charles,58,0,90,32
1683703551341,MGT 136,A00,202871,Lindenberger; Wade Douglas,83,0,90,7
1683703552366,MGT 164,A00,202873,Staff,0,67,90,91
1683703553391,MGT 164GS,A00,202874,McKay; Mary A,13,0,28,15
1683703554419,MGT 180,A00,202875,Staff,0,51,90,91
1683703555449,MMW 11R,A01,205019,Herbst; Matthew,0,0,30,30
1683703555449,MMW 11R,A02,205026,Herbst; Matthew,29,0,30,1
1683703556479,MMW 15,A01,193512,Chang; Edmond Yi-Teh,0,8,28,28
1683703556479,MMW 15,A02,193513,Chang; Edmond Yi-Teh,0,5,28,28
1683703556479,MMW 15,A03,193514,Chang; Edmond Yi-Teh,0,5,28,28
1683703556479,MMW 15,A04,193515,Chang; Edmond Yi-Teh,0,5,28,28
1683703556479,MMW 15,A05,193516,Chang; Edmond Yi-Teh,0,5,28,28
1683703556479,MMW 15,A06,193517,Chang; Edmond Yi-Teh,0,6,28,28
1683703556479,MMW 15,B01,193519,Chang; Edmond Yi-Teh,0,5,28,28
1683703556479,MMW 15,B02,193520,Chang; Edmond Yi-Teh,0,5,28,28
1683703556479,MMW 15,B03,193521,Chang; Edmond Yi-Teh,0,5,28,28
1683703556479,MMW 15,B04,193522,Chang; Edmond Yi-Teh,0,6,28,28
1683703556479,MMW 15,B05,193523,Chang; Edmond Yi-Teh,0,5,28,28
1683703556479,MMW 15,B06,193524,Chang; Edmond Yi-Teh,0,5,28,28
1683703557504,MMW 122,A01,193526,Rahimi; Babak,0,16,28,28
1683703557504,MMW 122,A02,193527,Rahimi; Babak,0,15,28,28
1683703557504,MMW 122,A03,193528,Rahimi; Babak,0,0,0,0
1683703557504,MMW 122,A04,193529,Rahimi; Babak,0,0,0,0
1683703558529,MUS 1A,A01,186663,Staff,0,18,35,35
1683703559557,MUS 4,A01,186715,Staff,0,12,35,35
1683703560582,MUS 5R,A01,186796,Dubnov; Shlomo,0,17,35,35
1683703561611,MUS 6,A01,186798,Staff,0,4,25,25
1683703562640,MUS 7,A01,186830,Staff,11,0,35,24
1683703563666,MUS 8,A01,186930,Staff,0,27,35,35
1683703564691,MUS 15,A01,186932,Staff,0,15,35,35
1683703564691,MUS 15,B01,186934,Staff,0,16,35,35
1683703565723,MUS 80,A00,186935,Staff,0,0,20,20
1683703565723,MUS 80,B00,186936,Staff,24,0,25,1
1683703566754,NANO 11,A00,204702,Lipomi; Darren John,0,0,0,0
1683703567785,NANO 15,A01,204709,Yang; Kesong,0,1,0,0
1683703568814,NANO 114,A00,202069,Jahed Motlagh; Zeinab,2,0,10,8
1683703569844,PHIL 1,A00,186955,Grush; Rick Scott,31,0,40,9
1683703570868,PHIL 10,A01,186973,Grush; Rick Scott,27,0,35,8
1683703570868,PHIL 10,A02,186974,Grush; Rick Scott,33,0,35,2
1683703571916,PHIL 13,A01,186976,Staff,1,0,35,34
1683703571916,PHIL 13,A02,186977,Staff,16,0,35,19
1683703572944,PHIL 14,A01,186979,Staff,30,0,35,5
1683703572944,PHIL 14,A02,186986,Staff,32,0,35,3
1683703573970,PHIL 28,A01,186988,Staff,16,0,30,14
1683703573970,PHIL 28,A02,186989,Staff,0,0,30,30
1683703573970,PHIL 28,A03,186990,Staff,10,0,30,20
1683703573970,PHIL 28,A04,186991,Staff,26,0,30,4
1683703575003,PHIL 120,A00,186997,Staff,23,0,40,17
1683703576032,PHIL 137,A00,187003,Staff,7,0,40,33
1683703577061,PHIL 150,A00,187015,Staff,47,0,70,23
1683703578086,PHIL 167,A00,187021,Lamey; Andy M.,34,0,40,6
1683703579110,PHIL 174,A01,202226,Staff,17,0,20,3
1683703579110,PHIL 174,A02,202235,Staff,20,0,20,0
1683703580138,PHIL 191A,A00,258918,Staff,0,0,1,1
1683703581167,PHYS 1A,A00,187028,Staff,26,0,60,34
1683703582250,PHYS 1AL,001,187036,Staff,3,0,30,27
1683703582250,PHYS 1AL,002,187049,Staff,18,0,30,12
1683703583278,PHYS 1B,A00,187058,Staff,21,0,60,39
1683703584303,PHYS 1BL,001,187064,Staff,0,1,30,30
1683703584303,PHYS 1BL,002,187070,Staff,4,0,30,26
1683703585330,PHYS 1C,A00,187082,Staff,30,0,120,90
1683703586360,PHYS 1CL,001,187088,Staff,0,9,30,30
1683703586360,PHYS 1CL,002,187089,Staff,0,1,30,30
1683703586360,PHYS 1CL,009,262693,Staff,9,0,30,21
1683703587389,PHYS 2B,A01,187097,Staff,55,0,115,60
1683703588414,PHYS 2C,A01,187099,Staff,63,0,115,52
1683703589446,PHYS 2CL,A01,187101,Staff,5,0,28,23
1683703589446,PHYS 2CL,A02,187102,Staff,15,0,28,13
1683703590477,PHYS 2D,A01,187123,Shotwell; Brian,95,0,115,20
1683703591501,PHYS 4B,A01,187133,Grinstein; Benjamin,35,0,50,15
1683703592527,POLI 10,A00,188819,Staff,0,4,50,50
1683703593552,POLI 11,A00,188827,Staff,43,0,50,7
1683703594581,POLI 13R,A00,188828,Staff,0,1,20,20
1683703595610,POLI 27,A01,188830,Elgin; Samuel Zincke,0,2,70,70
1683703596635,POLI 30,A00,188832,Desposato; Scott,30,0,50,20
1683703597664,POLI 102F,A00,188834,Staff,1,0,40,39
1683703598689,POLI 104A,A00,188852,Staff,12,0,30,18
1683703599713,POLI 104I,A00,188853,Staff,0,8,20,20
1683703600744,POLI 110B,A00,188854,Wiens; David,6,0,20,14
1683703601769,POLI 112A,A00,188855,Wiens; David,3,0,30,27
1683703602794,POLI 117R,A00,188856,Forman; Fonna,0,12,20,20
1683703603817,POLI 118,A00,188857,Ingham; Sean,8,0,20,12
1683703604847,POLI 120G,A00,188858,Staff,7,0,30,23
1683703605877,POLI 131CR,A00,188863,Hoston; Germaine,20,0,50,30
1683703606903,POLI 133,A00,188864,Nellis; Gareth Hb,44,0,50,6
1683703607933,POLI 134D,A00,188865,Desposato; Scott,27,0,30,3
1683703608958,POLI 142A,A00,188871,Gartzke; Erik,21,0,50,29
1683703609990,POLI 142K,A00,188874,Staff,38,0,50,12
1683703611016,POLI 143,A00,188940,Gartzke; Erik,15,0,30,15
1683703612040,POLI 153,A00,188943,Staff,1,0,20,19
1683703613072,POLI 160AA,A00,188944,Staff,10,0,40,30
1683703614097,POLI 170A,A00,188945,Staff,10,0,30,20
1683703616152,PSYC 1,A00,188952,Staff,36,0,90,54
1683703617181,PSYC 2,B00,188953,Staff,19,0,35,16
1683703618204,PSYC 6,A00,188970,Staff,47,0,60,13
1683703619228,PSYC 7,A00,188973,Staff,35,0,45,10
1683703620254,PSYC 60,A01,188980,Rickard; Timothy C.,42,0,60,18
1683703621314,PSYC 70,A01,189001,Steiner; Eric Tomas,22,0,45,23
1683703622342,PSYC 100,A00,189005,Lacefield; Katharine I,0,98,120,120
1683703623373,PSYC 102,A00,189008,Staff,6,0,30,24
1683703624396,PSYC 106,B00,189026,Gorman; Michael R.,27,0,60,33
1683703625420,PSYC 114,B01,189033,Winkielman; Piotr,0,31,30,30
1683703626445,PSYC 131,A00,189036,Anagnostaras; Stephan,0,44,60,60
1683703627470,PSYC 136,A00,189041,Lowe; Angela Beth,0,7,25,25
1683703628496,PSYC 137,A00,189057,Winkielman; Piotr,0,36,25,25
1683703629521,PSYC 144,A00,189107,Wixted; John T,0,11,50,50
1683703631572,PSYC 162,A00,189142,Staff,0,9,85,85
1683703632597,PSYC 172,A00,189144,Gorman; Michael R.,0,6,30,30
1683703634648,PSYC 179,A00,189146,Lacefield; Katharine I,0,88,120,120
1683703635673,PSYC 181,A00,189147,Anagnostaras; Stephan,0,45,90,90
1683703636700,PSYC 190R,A00,189148,Barner; David A.,0,23,80,80
1683703637728,PSYC 191,A00,189275,Rickard; Timothy C.,0,11,25,25
1683703638756,PSYC 193,A00,189276,Chapman; Eddie Nathaniel,0,1,0,4
1683703639786,PSYC 193L,A01,189281,Lowe; Angela Beth,8,0,20,12
1683703639786,PSYC 193L,B01,189285,Staff,28,0,35,7
1683703640815,RELI 149,A00,187137,Rahimi; Babak,6,0,40,34
1683703641840,SE 9,A01,187315,Staff,0,2,18,18
1683703642865,SE 101B,A00,187409,Staff,24,0,30,6
1683703643896,SE 110B,A00,187444,Staff,10,0,40,30
1683703644922,SE 130B,A00,187449,Staff,31,0,40,9
1683703645947,SE 150A,A00,187516,Staff,8,0,20,12
1683703646976,SE 154,A00,187528,Staff,29,0,50,21
1683703648001,SIO 3,A01,258171,Staff,35,0,40,5
1683703649028,SIO 10,A00,187144,Cook; Geoffrey W,0,6,75,75
1683703650055,SIO 45,A00,187152,Cook; Geoffrey W,1,7,100,99
1683703651080,SIO 109R,A00,194486,Staff,0,4,20,20
1683703653130,SIO 187,A01,187233,Kacev; David,12,0,40,28
1683703654158,SOCI 1,A01,258656,Thorpe; Charles Robert,28,0,30,2
1683703654158,SOCI 1,A02,258658,Thorpe; Charles Robert,30,0,30,0
1683703654158,SOCI 1,A03,258661,Thorpe; Charles Robert,25,0,25,0
1683703654158,SOCI 1,A04,258666,Thorpe; Charles Robert,22,0,25,3
1683703654158,SOCI 1,A05,258897,Thorpe; Charles Robert,22,0,25,3
1683703654158,SOCI 1,A06,258898,Thorpe; Charles Robert,25,0,25,0
1683703655188,SOCI 30,A01,258903,Pardo Guerra; Juan Pablo,14,0,30,16
1683703656213,SOCI 102,A00,258904,Staff,9,0,25,16
1683703657236,SOCI 106,A00,258905,Staff,19,0,25,6
1683703658264,SOCI 111,A00,258907,Ribas Norris; Janet Vanesa,26,0,30,4
1683703659289,SOCI 121R,A00,258908,Pardo Guerra; Juan Pablo,7,0,30,23
1683703660318,SOCI 126,A01,203330,Staff,14,0,20,6
1683703661343,SOCI 131,A00,258909,Thorpe; Charles Robert,30,0,60,30
1683703662368,SOCI 135,A00,258910,Payne; Christine Anna,0,13,30,30
1683703663391,SOCI 157,A00,258911,Staff,10,0,30,20
1683703664417,SOCI 184,A00,258912,Staff,25,0,30,5
1683703665442,SOCI 188D,A00,258913,Staff,22,0,30,8
1683703666468,SYN 2,001,187529,Staff,9,0,16,7
1683703666468,SYN 2,002,201452,Staff,0,20,16,16
1683703666468,SYN 2,003,201469,Staff,1,0,16,15
1683703667497,SYN 100,A01,187531,Staff,0,9,20,20
1683703667497,SYN 100,B01,201491,Staff,0,10,20,20
1683703668524,TDAC 1,A00,189286,Walsh; Kim C.,3,0,20,17
1683703668524,TDAC 1,B00,189287,Harting; Carla Kelso,10,0,20,10
1683703669549,TDAC 101,A00,189300,Walsh; Kim C.,16,0,20,4
1683703669549,TDAC 101,B00,189301,Harting; Carla Kelso,18,0,20,2
1683703670580,TDAC 102,A00,189304,Basso; Beatrice,14,0,20,6
1683703671605,TDAC 108,A00,189305,Staff,18,0,20,2
1683703672632,TDDE 131,A00,189310,Staff,19,0,20,1
1683703672632,TDDE 131,B00,189314,Staff,19,0,20,1
1683703672632,TDDE 131,C00,189315,Staff,48,0,50,2
1683703672632,TDDE 131,D00,189316,Staff,14,0,15,1
1683703672632,TDDE 131,E00,204841,Staff,20,0,20,0
1683703673676,TDGE 10,A00,189289,Staff,27,0,50,23
1683703673676,TDGE 10,B00,189290,Havis; Allan,0,1,50,50
1683703674708,TDGE 11,A00,189291,Fulton; Julia,0,4,50,50
1683703674708,TDGE 11,B00,189292,Staff,20,0,25,5
1683703674708,TDGE 11,C00,260270,Staff,0,0,0,0
1683703675733,TDGE 25,A00,189294,Staff,1,0,20,19
1683703676757,TDGE 124,A00,189318,Fulton; Julia,0,7,50,50
1683703677791,TDGE 125,A00,189319,Staff,13,0,25,12
1683703677791,TDGE 125,B00,189320,Staff,23,0,25,2
1683703678815,TDGE 127,A00,189322,Havis; Allan,1,0,50,49
1683703679841,TDHT 101,A00,189323,Staff,18,0,25,7
1683703679841,TDHT 101,B00,189324,Staff,25,0,25,0
1683703680869,TDHT 102,A00,189325,Staff,49,0,50,1
1683703681892,TDMV 1,A00,189295,Arcidiacono; Kristin,20,0,30,10
1683703681892,TDMV 1,B00,189296,Caligagan; Maria T.,23,0,30,7
1683703682917,TDMV 2,A00,189297,Sammartano; Tonnie,27,0,30,3
1683703682917,TDMV 2,B00,189299,Arcidiacono; Kristin,23,0,30,7
1683703683947,TDMV 3,A00,204998,Rincon; Alicia,22,0,30,8
1683703684971,TDMV 120,A00,189458,Sammartano; Tonnie,28,0,30,2
1683703686052,TDMV 138,A00,189541,Jun; Grace Shin Hae,20,0,40,20
1683703687075,TDMV 142,A00,189717,Caligagan; Tony,25,0,30,5
1683703687075,TDMV 142,B00,189718,Caligagan; Maria T.,25,0,30,5
1683703688101,TMC 2,A01,187533,Staff,25,0,25,0
1683703688101,TMC 2,A02,187534,Staff,25,0,25,0
1683703689125,USP 1,A01,187536,Kwak; Nancy,0,16,25,25
1683703690149,USP 5,A01,187538,Staff,8,0,25,17
1683703691175,USP 101,A00,199253,Staff,0,4,0,0
1683703692203,USP 124,A00,187562,Boomhower; Matthew Charles,0,0,30,30
1683703693232,USP 138,A00,187582,Staff,19,0,25,6
1683703694258,USP 152,A01,187597,Staff,3,0,25,22
1683703695283,USP 153,A00,187598,Staff,18,0,25,7
1683703696313,USP 168,A00,187607,Kwak; Nancy,2,0,5,3
1683703697337,USP 173,A00,187619,Staff,4,0,25,21
1683703698363,USP 181,A00,187638,Staff,0,4,25,25
1683703699391,VIS 103,A00,187650,Cruz; Edwin Teddy,17,0,75,58
1683703700418,VIS 110D,A00,187669,Staff,13,0,22,9
1683703701446,VIS 127C,A00,187720,Shen; Kuiyi,67,0,146,79
1683703702472,VIS 149,A00,187731,Yoldas; Pinar,0,12,22,22
1683703703494,VIS 151,A01,188091,Staff,22,0,34,12
1683703703494,VIS 151,A02,188092,Staff,11,0,34,23
1683703704523,VIS 160B,A00,188093,Stalbaum; Brett,0,1,10,10
1683703706572,WCWP 10B,A00,201720,Staff,0,0,5,5
1683703706572,WCWP 10B,B00,201722,Staff,0,0,6,6
1683703707598,WCWP 100,A00,201725,Gagnon; Jeffrey C,0,0,2,2
1683703707598,WCWP 100,B00,201727,Staff,0,4,15,15
1683703710760,ANBI 133,A00,258401,Wilder; Linnea Lorene,34,0,40,6
1683703711785,ANBI 140,A00,258395,Hrvoj Mihic; Branka,18,0,25,7
1683703712811,ANSC 120,A00,258402,Bialecki; Jon Anthony,26,0,40,14
1683703713839,ANSC 144,A00,258400,Staff,12,0,40,28
1683703715890,ANSC 166,A00,258396,Parish; Steven Martin,156,0,175,19
1683703716918,ANSC 180,A00,193533,Staff,8,0,20,12
1683703717945,ANSC 188,A00,258397,Jassal; Aftab,34,0,40,6
1683703718968,ANTH 3,A01,258316,Staff,23,0,30,7
1683703719993,ANTH 5,A00,258394,Semendeferi; Ekaterini,16,0,20,4
1683703721017,ANTH 21,A01,258331,Staff,4,0,40,36
1683703722045,ANTH 103,A00,258398,Varma; Saiba,15,0,25,10
1683703723073,AWP 10,001,202034,Staff,0,0,0,0
1683703723073,AWP 10,002,202035,Staff,0,0,0,0
1683703723073,AWP 10,003,202036,Staff,0,0,0,0
1683703723073,AWP 10,004,202037,Staff,0,0,0,0
1683703723073,AWP 10,005,202038,Staff,0,0,0,0
1683703723073,AWP 10,006,202039,Staff,0,0,0,0
1683703723073,AWP 10,007,202040,Staff,0,0,0,0
1683703723073,AWP 10,008,202041,Staff,0,0,0,0
1683703723073,AWP 10,009,202042,Staff,0,0,0,0
1683703723073,AWP 10,010,202043,Staff,0,0,0,0
1683703723073,AWP 10,011,202044,Staff,0,0,0,0
1683703723073,AWP 10,012,202045,Staff,0,0,0,0
1683703723073,AWP 10,013,202046,Staff,0,0,0,0
1683703723073,AWP 10,014,202047,Staff,0,0,0,0
1683703723073,AWP 10,015,202048,Staff,0,0,0,0
1683703723073,AWP 10,016,202049,Staff,0,0,0,0
1683703723073,AWP 10,017,202050,Staff,0,0,0,0
1683703723073,AWP 10,018,202051,Staff,0,0,0,0
1683703723073,AWP 10,019,202052,Staff,0,0,0,0
1683703723073,AWP 10,020,202053,Staff,0,0,0,0
1683703723073,AWP 10,021,202054,Staff,0,0,0,0
1683703723073,AWP 10,022,202055,Staff,0,0,0,0
1683703723073,AWP 10,023,202056,Staff,0,0,0,0
1683703723073,AWP 10,024,202057,Staff,0,0,0,0
1683703723073,AWP 10,025,202058,Staff,0,0,0,0
1683703723073,AWP 10,026,202059,Staff,0,0,0,0
1683703724097,AWP 102,001,202032,Staff,0,0,0,0
1683703724097,AWP 102,002,202033,Staff,0,0,0,0
1683703725124,BENG 100,A01,254234,Taylor Amos; Alyssa C,31,0,40,9
1683703726158,BENG 196,001,270013,Engler; Adam J.,9999,0,9999,0
1683703727184,BICD 100R,A01,202018,Smith; Laurie,0,7,32,32
1683703727184,BICD 100R,A02,202019,Smith; Laurie,0,3,32,32
1683703727184,BICD 100R,A03,202020,Smith; Laurie,0,1,32,32
1683703727184,BICD 100R,A04,202021,Smith; Laurie,6,0,32,26
1683703727184,BICD 100R,A05,202022,Smith; Laurie,10,0,32,22
1683703728217,BICD 136,A01,193242,Gustafson-Brown; Cindy,0,2,32,32
1683703728217,BICD 136,A02,193244,Gustafson-Brown; Cindy,13,0,32,19
1683703729245,BIEB 102,A01,193249,Butler; Shannon Rhey,0,0,32,32
1683703729245,BIEB 102,A02,193251,Butler; Shannon Rhey,0,0,32,32
1683703729245,BIEB 102,A03,193253,Butler; Shannon Rhey,0,0,32,32
1683703729245,BIEB 102,A04,193255,Butler; Shannon Rhey,13,0,32,19
1683703729245,BIEB 102,A05,193265,Butler; Shannon Rhey,25,0,32,7
1683703729245,BIEB 102,A06,193269,Butler; Shannon Rhey,12,0,32,20
1683703731293,BIEB 150,A01,193274,Staff,0,0,32,32
1683703731293,BIEB 150,A02,193285,Staff,24,0,32,8
1683703732318,BIEB 194,A00,193286,Kurle; Carolyn M.,19,0,32,13
1683703733347,BILD 1,A01,192291,Staff,15,0,32,17
1683703733347,BILD 1,A02,192292,Staff,30,0,32,2
1683703733347,BILD 1,B01,192520,Reuther; Keefe,0,1,0,0
1683703733347,BILD 1,B02,192532,Reuther; Keefe,0,1,0,0
1683703734378,BILD 3,A01,192556,Butler; Shannon Rhey,0,0,32,32
1683703734378,BILD 3,A02,192581,Butler; Shannon Rhey,0,1,32,32
1683703734378,BILD 3,A03,192611,Butler; Shannon Rhey,19,0,32,13
1683703734378,BILD 3,A04,192612,Butler; Shannon Rhey,23,0,32,9
1683703734378,BILD 3,A05,192613,Butler; Shannon Rhey,26,0,32,6
1683703734378,BILD 3,A06,192679,Butler; Shannon Rhey,27,0,32,5
1683703734378,BILD 3,A07,192682,Butler; Shannon Rhey,20,0,32,12
1683703735409,BILD 4,A01,192836,Reuther; Keefe,1,0,24,23
1683703735409,BILD 4,A02,193044,Reuther; Keefe,4,0,24,20
1683703736433,BILD 10,A01,193142,Gustafson-Brown; Cindy,29,0,32,3
1683703736433,BILD 10,A02,193149,Gustafson-Brown; Cindy,31,0,32,1
1683703737459,BIMM 100,A01,193301,Staff,0,6,32,32
1683703737459,BIMM 100,A02,193312,Staff,0,7,32,32
1683703737459,BIMM 100,A03,193323,Staff,0,10,32,32
1683703738485,BIMM 101,A01,193329,McDonnell; Lisa Marie,0,3,24,24
1683703738485,BIMM 101,A02,193339,McDonnell; Lisa Marie,0,3,24,24
1683703738485,BIMM 101,B01,193354,McDonnell; Lisa Marie,0,4,24,24
1683703738485,BIMM 101,B02,193357,McDonnell; Lisa Marie,0,3,24,24
1683703739510,BIMM 110,A01,193377,Tat; John,0,11,32,32
1683703739510,BIMM 110,A02,193378,Tat; John,0,11,32,32
1683703740540,BIMM 120,A01,206116,Staff,0,0,32,32
1683703740540,BIMM 120,A02,206117,Staff,7,0,32,25
1683703740540,BIMM 120,A03,206121,Staff,21,0,32,11
1683703741566,BIPN 100,A01,193393,Park; Ji Young,0,15,32,32
1683703741566,BIPN 100,A02,193402,Park; Ji Young,0,14,32,32
1683703741566,BIPN 100,A03,193413,Park; Ji Young,0,14,32,32
1683703741566,BIPN 100,A04,193414,Park; Ji Young,0,13,32,32
1683703742592,BIPN 102,A01,193429,Staff,0,0,32,32
1683703742592,BIPN 102,A02,193438,Staff,18,0,32,14
1683703743624,BIPN 106,A01,193450,Reyes Gonzalez; Catalina,0,2,40,40
1683703744649,BIPN 134,A01,193465,Cooke; James Edward,0,0,32,32
1683703744649,BIPN 134,A02,193474,Cooke; James Edward,25,0,32,7
1683703744649,BIPN 134,A03,193485,Cooke; James Edward,29,0,32,3
1683703744649,BIPN 134,A04,193486,Cooke; James Edward,20,0,32,12
1683703744649,BIPN 134,A05,193491,Cooke; James Edward,31,0,32,1
1683703744649,BIPN 134,A06,193501,Cooke; James Edward,30,0,32,2
1683703744649,BIPN 134,A07,193510,Cooke; James Edward,29,0,32,3
1683703746699,BISP 194,A00,222522,Staff,14,0,32,18
1683703747723,CAT 124,A01,202407,Staff,19,0,25,6
1683703748748,CAT 125,A00,202408,Marchisotto; Jennifer Anne,2,0,20,18
1683703749779,CAT 125R,A00,202409,Smith; Lauryn Alissa,0,11,20,20
1683703749779,CAT 125R,B00,202410,Morales; Celeste Georgianna,0,11,20,20
1683703749779,CAT 125R,C00,202411,Irwin; Matthew Joseph,0,12,20,20
1683703750805,CENG 15,A01,204712,Yang; Kesong,0,1,0,0
1683703751830,CENG 114,A00,202070,Jahed Motlagh; Zeinab,5,0,20,15
1683703752865,CGS 105,A00,185477,Wesling; Megan E.,24,0,40,16
1683703753892,CGS 106,A00,185494,Staff,11,0,22,11
1683703754916,CGS 108,A00,185495,Staff,14,0,20,6
1683703755940,CGS 114,A00,185496,Staff,13,0,18,5
1683703756964,CGS 119,A00,185501,Staff,15,0,20,5
1683703757990,CGS 120,A00,185511,Staff,11,0,20,9
1683703759026,CHEM 4,A01,184675,Bussey; Thomas J,97,0,100,3
1683703760049,CHEM 6A,A01,184677,Staff,32,0,60,28
1683703761073,CHEM 6B,A01,184679,Staff,63,0,100,37
1683703762105,CHEM 6C,A01,184681,Bussey; Thomas J,0,0,50,50
1683703762105,CHEM 6C,A02,184682,Bussey; Thomas J,32,0,50,18
1683703763130,CHEM 40A,A01,184684,Albizati; Kim F.,33,0,100,67
1683703764156,CHEM 40B,A01,184686,Albizati; Kim F.,0,22,100,100
1683703765181,CHEM 41B,A01,184690,Staff,51,0,100,49
1683703766207,COGS 3,A01,184715,Boyle; Mary E. T.,0,27,40,40
1683703767235,COGS 14B,A01,185172,Staff,0,14,38,38
1683703768260,COGS 18,A01,184736,Staff,14,0,80,66
1683703769289,COGS 100,A01,184932,Staff,0,8,73,73
1683703770315,COGS 101A,A01,184935,Staff,0,40,30,30
1683703771340,COGS 101B,A01,184944,Staff,0,2,30,30
1683703772364,COGS 101C,A01,184946,Staff,0,10,30,30
1683703773391,COGS 102A,A01,184951,Johnson; Christine M.,1,0,40,39
1683703774416,COGS 107B,A01,184953,Mooshagian; Eric Frederick,0,52,40,40
1683703775443,COGS 118B,A01,184959,Gupta; Anjum,0,50,40,40
1683703776470,COGS 153,A00,184961,Staff,1,16,30,29
1683703777495,COGS 177,A00,184962,Staff,0,20,30,30
1683703778518,COGS 187A,A01,184969,Boyle; Mary E. T.,0,19,40,40
1683703779542,COMM 10,A01,185174,Staff,0,5,25,25
1683703779542,COMM 10,A02,185189,Staff,0,2,25,25
1683703779542,COMM 10,A03,269821,Staff,0,1,0,0
1683703780572,COMM 100B,A02,185476,Staff,10,0,25,15
1683703780572,COMM 100B,A03,277340,Staff,25,0,25,0
1683703781598,COMM 100C,A01,185314,Staff,2,0,25,23
1683703781598,COMM 100C,A02,185327,Staff,17,0,25,8
1683703782621,COMM 110M,A00,185349,Staff,0,0,40,40
1683703783645,COMM 113T,A00,185352,Staff,25,0,40,15
1683703784670,COMM 114I,A00,185353,Staff,31,0,40,9
1683703785695,COMM 131,A00,185354,Staff,17,0,30,13
1683703786719,CSE 8A,A50,185358,Cao; Yingjun,0,46,10,10
1683703787743,CSE 8B,A01,185362,Staff,0,48,50,50
1683703788770,CSE 11,A01,185416,Cao; Yingjun,0,91,10,10
1683703789856,CSE 20,A01,185445,Briones; Jor-el Thomas Caparas,3,0,25,22
1683703790883,CSE 21,A01,185447,Staff,9,0,50,41
1683703791911,CSE 101,A01,185451,Staff,0,13,50,50
1683703791911,CSE 101,B01,185453,Jones; Miles E,0,15,50,50
1683703793959,CSE 141,A01,185458,Eldon; John,16,0,100,84
1683703794982,CSE 141L,A01,185461,Eldon; John,8,0,100,92
1683703796006,CSE 142,A01,185463,Staff,34,0,60,26
1683703796006,CSE 142,B01,201355,Staff,0,7,60,60
1683703797034,CSE 142L,A01,185470,Staff,34,0,60,26
1683703797034,CSE 142L,B01,201417,Staff,0,6,60,60
1683703798058,CSE 190,A00,201433,Staff,32,0,49,17
1683703799098,DOC 1,A01,259136,Strom; Megan C.,7,0,15,8
1683703799098,DOC 1,A02,259137,Strom; Megan C.,14,0,15,1
1683703799098,DOC 1,A03,259138,Strom; Megan C.,14,0,15,1
1683703799098,DOC 1,A04,259139,Strom; Megan C.,14,0,15,1
1683703800125,DOC 100D,A00,259140,Pass; Natalye Joann,14,0,25,11
1683703801148,DSGN 1,A01,184749,Rill; Bryan,0,26,30,30
1683703802179,DSGN 100,A01,185168,Staff,0,2,25,25
1683703803203,ECE 5,A01,185626,Morris; Karcher William,0,12,0,0
1683703804226,ECE 101,A01,185628,Staff,14,0,70,56
1683703805257,ECE 107,A01,185635,Baghdadchi; Saharnaz,0,0,20,20
1683703805257,ECE 107,A02,185638,Baghdadchi; Saharnaz,1,0,20,19
1683703806282,ECE 148,A01,185647,Silberman; Jack,0,0,16,16
1683703807310,ECON 1,A01,185537,Crane; Meredith Helen,54,0,70,16
1683703808335,ECON 3,A01,185549,Crane; Meredith Helen,30,0,70,40
1683703809359,ECON 4,A01,203354,Anderson; John Charles,0,5,10,10
1683703810382,ECON 100A,A01,185574,Staff,0,5,40,40
1683703811410,ECON 100B,A01,185576,Staff,0,12,50,50
1683703812441,ECON 100C,A01,185589,Newhouse; Herbert S,30,0,70,40
1683703813465,ECON 105,A00,185608,Vespa; Emanuel Ignacio,19,0,35,16
1683703814490,ECON 109,A01,185610,Shishkin; Denis,9,0,35,26
1683703815515,ECON 110A,A01,185612,Staff,8,0,40,32
1683703816541,ECON 120A,A01,185615,Staff,19,0,40,21
1683703817570,ECON 120C,A01,185617,Sun; Yixiao,0,21,70,70
1683703818594,ECON 144,A00,203346,Squires; Dale E,2,0,35,33
1683703819622,ECON 171,A01,203349,Newhouse; Herbert S,0,1,35,35
1683703820646,ECON 173A,A01,185621,Toda; Alexis Akira,21,0,35,14
1683703821678,EDS 25,A01,202413,Staff,0,1,0,0
1683703821678,EDS 25,A02,202414,Staff,0,1,0,0
1683703821678,EDS 25,A03,202415,Staff,0,0,0,0
1683703821678,EDS 25,A04,202416,Staff,0,1,0,0
1683703821678,EDS 25,A05,202439,Staff,0,0,0,0
1683703821678,EDS 25,A06,202440,Staff,0,0,0,0
1683703821678,EDS 25,B01,202631,Staff,0,0,0,0
1683703821678,EDS 25,B02,202632,Staff,0,0,0,0
1683703821678,EDS 25,B03,202639,Staff,0,0,0,0
1683703821678,EDS 25,B04,202640,Staff,0,0,0,0
1683703821678,EDS 25,B05,202643,Staff,0,0,0,0
1683703821678,EDS 25,B06,202644,Staff,0,0,0,0
1683703822706,EDS 38,A01,202659,Black; Alison Michelle,25,0,25,0
1683703823736,EDS 115,A00,202652,Staff,18,0,30,12
1683703824761,EDS 125,A00,202649,Staff,13,0,30,17
1683703825786,EDS 126,A01,203332,Staff,30,0,30,0
1683703826812,EDS 139,A00,202838,Staff,16,0,25,9
1683703827840,EDS 146,A01,202655,Staff,14,0,25,11
1683703828863,ENG 15,A00,185667,Staff,0,1,0,0
1683703828863,ENG 15,B00,185672,Staff,0,0,0,0
1683703828863,ENG 15,C00,185675,Staff,0,0,0,0
1683703828863,ENG 15,D00,185682,Staff,0,0,0,0
1683703828863,ENG 15,E00,185684,Staff,0,0,0,0
1683703829886,ETHN 103,A00,185710,Staff,0,8,35,35
1683703830914,ETHN 103A,A00,199228,Man; Simeon S,0,0,9,9
1683703831939,ETHN 109,A00,185711,Staff,15,0,35,20
1683703832963,ETHN 142,A00,185726,Staff,0,4,30,30
1683703833987,ETHN 163J,A00,199229,Man; Simeon S,5,0,8,3
1683703835013,ETHN 168,A00,185727,Staff,7,0,10,3
1683703836038,ETHN 182,A00,185728,Staff,0,0,35,35
1683703837065,ETHN 183,A00,185737,Staff,9,0,18,9
1683703838092,GLBH 111,A01,209361,Burgos; Jose L.,0,0,0,0
1683703840143,HIEU 104,A00,185792,Staff,14,0,20,6
1683703841166,HIEU 115,A00,185800,Staff,0,0,20,20
1683703842192,HIEU 128,A00,185801,Staff,0,9,20,20
1683703843218,HIEU 147,A00,185802,Staff,15,0,20,5
1683703844243,HIEU 154,A00,185823,Staff,11,0,20,9
1683703845269,HILA 102,A00,185826,Staff,14,0,20,6
1683703846292,HILD 2C,A01,185778,Staff,0,13,20,20
1683703847318,HILD 7B,A01,185780,Kwak; Nancy,0,17,32,32
1683703847318,HILD 7B,A02,185781,Kwak; Nancy,0,18,32,32
1683703848349,HILD 30,A01,185791,Staff,12,0,20,8
1683703849378,HISC 119,A00,185830,Golan; Tal,0,10,20,20
1683703850402,HITO 156GS,A00,185831,Patterson; Patrick H.,0,0,0,23
1683703851430,HIUS 103,A00,185832,Man; Simeon S,0,4,20,20
1683703852454,HIUS 117,A00,185836,Kwak; Nancy,2,0,20,18
1683703853479,HIUS 125,A00,185840,Man; Simeon S,0,2,23,23
1683703854504,HIUS 149,A00,185845,Staff,1,0,20,19
1683703855534,HUM 3,A01,185882,Zavodny; Tatiana Sophia,0,8,50,50
1683703855534,HUM 3,B01,185899,Caldwell; Michael Alan,0,18,50,50
1683703856558,HUM 3GS,A00,185900,Patterson; Patrick H.,0,0,0,23
1683703857593,HUM 4,A01,185938,Zroka; Amy Liane,28,0,50,22
1683703857593,HUM 4,B01,185956,Watkins; Eric,0,6,50,50
1683703857593,HUM 4,B02,202209,Watkins; Eric,0,5,50,50
1683703857593,HUM 4,B03,202210,Watkins; Eric,0,5,50,50
1683703858618,HUM 5,A01,185958,West; Geoffrey Scott,0,0,50,50
1683703858618,HUM 5,A02,202215,West; Geoffrey Scott,0,1,50,50
1683703859646,INTL 190,A00,185959,Gagnon; Jeffrey C,0,0,0,9
1683703859646,INTL 190,B00,185960,Lettieri; Michael Joseph,0,0,0,2
1683703860672,JAPN 180,A00,254509,Staff,5,0,30,25
1683703861716,LATI 10,A01,202853,Kennemore; Amy Michelle,4,0,35,31
1683703861716,LATI 10,A02,202854,Kennemore; Amy Michelle,3,0,35,32
1683703861716,LATI 10,A03,270054,Kennemore; Amy Michelle,30,0,30,0
1683703862739,LATI 180,A00,202855,Kennemore; Amy Michelle,11,0,20,9
1683703863764,LAWS 101,A00,201767,Golan; Tal,0,7,40,40
1683703864789,LIFR 1C,A00,185961,Staff,6,0,20,14
1683703865814,LIFR 1CX,A00,185962,Staff,7,0,20,13
1683703866842,LIFR 1D,A00,185963,Staff,7,0,20,13
1683703867867,LIFR 1DX,A00,185964,Staff,7,0,20,13
1683703868892,LIGN 101,A01,186039,Staff,43,0,50,7
1683703869915,LIGN 165,A00,186040,Staff,14,0,50,36
1683703870942,LTCS 108,A00,186041,Staff,5,0,10,5
1683703871969,LTCS 119,A00,186042,Staff,15,0,20,5
1683703872993,LTCS 130,A00,186043,Wesling; Megan E.,15,0,25,10
1683703875043,LTEA 138,A00,186119,Staff,14,0,40,26
1683703876068,LTEN 124,A00,186148,Staff,5,0,25,20
1683703877092,LTEN 178,A00,186149,Staff,6,0,15,9
1683703878121,LTEN 181,A00,186150,Blanco; John D,34,0,40,6
1683703879147,LTWL 120,A00,186160,Staff,19,0,25,6
1683703880176,LTWL 165,A00,186161,Staff,22,0,25,3
1683703881201,LTWR 100,A00,186162,Staff,0,5,15,15
1683703882234,LTWR 102,A00,186163,Doller; Ben,5,0,15,10
1683703883265,MAE 8,A01,186412,Staff,0,1,0,0
1683703884290,MAE 30B,A00,186445,Bahadori; Mohammad Yousef,81,0,100,19
1683703885320,MAE 40,A00,186592,Bewley; Thomas R,10,0,50,40
1683703886349,MAE 101B,A00,186593,Bahadori; Mohammad Yousef,80,0,100,20
1683703887374,MAE 105,A00,186594,Bandaru; Prabhakar,10,0,50,40
1683703888397,MAE 107,A00,186599,Pham; Hieu Tan,0,8,120,120
1683703889426,MAE 148,A01,186660,Silberman; Jack,3,0,16,13
1683703890450,MATH 10A,A01,188095,Staff,0,6,35,35
1683703891490,MATH 10B,A01,188097,Bowers; Adam R.,0,12,30,30
1683703891490,MATH 10B,A02,188099,Bowers; Adam R.,0,11,30,30
1683703891490,MATH 10B,B01,188104,Bowers; Adam R.,0,10,30,30
1683703891490,MATH 10B,B02,188106,Bowers; Adam R.,0,9,30,30
1683703892522,MATH 10C,A01,188111,Staff,0,20,30,30
1683703892522,MATH 10C,A02,188127,Staff,0,19,30,30
1683703892522,MATH 10C,A03,188131,Staff,0,19,30,30
1683703892522,MATH 10C,B01,188218,Staff,17,0,30,13
1683703892522,MATH 10C,B02,188244,Staff,13,0,30,17
1683703892522,MATH 10C,B03,188277,Staff,14,0,30,16
1683703893607,MATH 18,A01,188344,Bach; Quang Tran,18,0,30,12
1683703893607,MATH 18,A02,188345,Bach; Quang Tran,11,0,30,19
1683703893607,MATH 18,B01,188353,Bach; Quang Tran,11,0,30,19
1683703893607,MATH 18,B02,188354,Bach; Quang Tran,19,0,30,11
1683703894632,MATH 20A,A01,188374,Staff,11,0,35,24
1683703895658,MATH 20B,A01,188382,Ohm; Ko Woon,7,0,30,23
1683703895658,MATH 20B,A02,188383,Ohm; Ko Woon,22,0,30,8
1683703895658,MATH 20B,B01,188385,Ohm; Ko Woon,7,0,30,23
1683703895658,MATH 20B,B02,188392,Ohm; Ko Woon,22,0,30,8
1683703896685,MATH 20C,A01,188394,Harel; Guershon,10,0,30,20
1683703896685,MATH 20C,A02,188395,Harel; Guershon,13,0,30,17
1683703896685,MATH 20C,B01,188404,Harel; Guershon,5,0,30,25
1683703896685,MATH 20C,B02,188405,Harel; Guershon,18,0,30,12
1683703897716,MATH 20D,A01,188414,Hammock; Frances H,0,1,30,30
1683703897716,MATH 20D,A02,188415,Hammock; Frances H,0,1,30,30
1683703897716,MATH 20D,B01,188447,Hammock; Frances H,0,1,30,30
1683703897716,MATH 20D,B02,188486,Hammock; Frances H,2,0,30,28
1683703898745,MATH 20E,A01,188649,Staff,21,0,30,9
1683703898745,MATH 20E,A02,188650,Staff,20,0,30,10
1683703898745,MATH 20E,A03,188673,Staff,0,0,30,30
1683703899776,MATH 102,A01,188675,Staff,0,40,35,35
1683703900801,MATH 103B,A01,188681,Staff,3,0,35,32
1683703900801,MATH 103B,B01,188692,Staff,5,0,35,30
1683703901827,MATH 109,A01,188695,Salehi Golsefidy; Alireza,24,0,35,11
1683703901827,MATH 109,A02,188696,Salehi Golsefidy; Alireza,25,0,35,10
1683703902875,MATH 120A,A01,188698,Eggers; John Dietrich,7,0,35,28
1683703903901,MATH 142B,A01,188736,Ioana; Adrian,0,0,30,30
1683703903901,MATH 142B,A02,188741,Ioana; Adrian,0,1,30,30
1683703903901,MATH 142B,A03,188743,Ioana; Adrian,0,2,30,30
1683703904930,MATH 168A,A01,188790,Staff,0,11,35,35
1683703905961,MATH 170A,A01,188803,Nie; Jiawang,0,2,35,35
1683703905961,MATH 170A,A02,188811,Nie; Jiawang,0,1,35,35
1683703905961,MATH 170A,A03,188814,Nie; Jiawang,0,0,35,35
1683703905961,MATH 170A,A04,188815,Nie; Jiawang,5,0,35,30
1683703906991,MATH 193B,A01,188817,Staff,0,0,35,35
1683703906991,MATH 193B,A02,188818,Staff,6,0,35,29
1683703908017,MGT 4,A01,202857,Anderson; John Charles,59,0,80,21
1683703909046,MGT 12,A00,202858,Lindenberger; Wade Douglas,40,0,90,50
1683703910071,MGT 18,A00,202859,Staff,73,0,90,17
1683703911097,MGT 18GS,A00,202860,McKay; Michael J,13,0,28,15
1683703912129,MGT 45,A00,202861,Pecore; Joseph P.,8,0,90,82
1683703913154,MGT 100,A00,202863,Yavorsky; Daniel Ryan,27,0,90,63
1683703914183,MGT 103,A00,202864,Ehrich; Kristine R,0,19,90,90
1683703915207,MGT 112,A00,202865,Ehrich; Kristine R,15,0,90,75
1683703916232,MGT 121A,A00,202868,Staff,70,0,90,20
1683703917257,MGT 131B,A00,202869,Anderson; John Charles,58,0,90,32
1683703918283,MGT 136,A00,202871,Lindenberger; Wade Douglas,83,0,90,7
1683703919309,MGT 164,A00,202873,Staff,0,67,90,91
1683703920333,MGT 164GS,A00,202874,McKay; Mary A,13,0,28,15
1683703921357,MGT 180,A00,202875,Staff,0,51,90,91
1683703922386,MMW 11R,A01,205019,Herbst; Matthew,0,0,30,30
1683703922386,MMW 11R,A02,205026,Herbst; Matthew,29,0,30,1
1683703923417,MMW 15,A01,193512,Chang; Edmond Yi-Teh,0,8,28,28
1683703923417,MMW 15,A02,193513,Chang; Edmond Yi-Teh,0,5,28,28
1683703923417,MMW 15,A03,193514,Chang; Edmond Yi-Teh,0,5,28,28
1683703923417,MMW 15,A04,193515,Chang; Edmond Yi-Teh,0,5,28,28
1683703923417,MMW 15,A05,193516,Chang; Edmond Yi-Teh,0,5,28,28
1683703923417,MMW 15,A06,193517,Chang; Edmond Yi-Teh,0,6,28,28
1683703923417,MMW 15,B01,193519,Chang; Edmond Yi-Teh,0,5,28,28
1683703923417,MMW 15,B02,193520,Chang; Edmond Yi-Teh,0,5,28,28
1683703923417,MMW 15,B03,193521,Chang; Edmond Yi-Teh,0,5,28,28
1683703923417,MMW 15,B04,193522,Chang; Edmond Yi-Teh,0,6,28,28
1683703923417,MMW 15,B05,193523,Chang; Edmond Yi-Teh,0,5,28,28
1683703923417,MMW 15,B06,193524,Chang; Edmond Yi-Teh,0,5,28,28
1683703924449,MMW 122,A01,193526,Rahimi; Babak,0,16,28,28
1683703924449,MMW 122,A02,193527,Rahimi; Babak,0,15,28,28
1683703924449,MMW 122,A03,193528,Rahimi; Babak,0,0,0,0
1683703924449,MMW 122,A04,193529,Rahimi; Babak,0,0,0,0
1683703926091,MUS 1A,A01,186663,Staff,0,18,35,35
1683703927121,MUS 4,A01,186715,Staff,0,12,35,35
1683703928159,MUS 5R,A01,186796,Dubnov; Shlomo,0,17,35,35
1683703929185,MUS 6,A01,186798,Staff,0,4,25,25
1683703930213,MUS 7,A01,186830,Staff,11,0,35,24
1683703931241,MUS 8,A01,186930,Staff,0,27,35,35
1683703932271,MUS 15,A01,186932,Staff,0,15,35,35
1683703932271,MUS 15,B01,186934,Staff,0,16,35,35
1683703933297,MUS 80,A00,186935,Staff,0,0,20,20
1683703933297,MUS 80,B00,186936,Staff,24,0,25,1
1683703934332,NANO 11,A00,204702,Lipomi; Darren John,0,0,0,0
1683703935361,NANO 15,A01,204709,Yang; Kesong,0,1,0,0
1683703936389,NANO 114,A00,202069,Jahed Motlagh; Zeinab,2,0,10,8
1683703937414,PHIL 1,A00,186955,Grush; Rick Scott,31,0,40,9
1683703938439,PHIL 10,A01,186973,Grush; Rick Scott,27,0,35,8
1683703938439,PHIL 10,A02,186974,Grush; Rick Scott,33,0,35,2
1683703939465,PHIL 13,A01,186976,Staff,1,0,35,34
1683703939465,PHIL 13,A02,186977,Staff,16,0,35,19
1683703940493,PHIL 14,A01,186979,Staff,30,0,35,5
1683703940493,PHIL 14,A02,186986,Staff,32,0,35,3
1683703941518,PHIL 28,A01,186988,Staff,16,0,30,14
1683703941518,PHIL 28,A02,186989,Staff,0,0,30,30
1683703941518,PHIL 28,A03,186990,Staff,10,0,30,20
1683703941518,PHIL 28,A04,186991,Staff,26,0,30,4
1683703942549,PHIL 120,A00,186997,Staff,23,0,40,17
1683703943577,PHIL 137,A00,187003,Staff,7,0,40,33
1683703944603,PHIL 150,A00,187015,Staff,47,0,70,23
1683703945630,PHIL 167,A00,187021,Lamey; Andy M.,34,0,40,6
1683703946655,PHIL 174,A01,202226,Staff,17,0,20,3
1683703946655,PHIL 174,A02,202235,Staff,20,0,20,0
1683703947683,PHIL 191A,A00,258918,Staff,0,0,1,1
1683703948710,PHYS 1A,A00,187028,Staff,26,0,60,34
1683703949741,PHYS 1AL,001,187036,Staff,3,0,30,27
1683703949741,PHYS 1AL,002,187049,Staff,18,0,30,12
1683703950763,PHYS 1B,A00,187058,Staff,21,0,60,39
1683703951789,PHYS 1BL,001,187064,Staff,0,1,30,30
1683703951789,PHYS 1BL,002,187070,Staff,4,0,30,26
1683703952818,PHYS 1C,A00,187082,Staff,30,0,120,90
1683703953850,PHYS 1CL,001,187088,Staff,0,9,30,30
1683703953850,PHYS 1CL,002,187089,Staff,0,1,30,30
1683703953850,PHYS 1CL,009,262693,Staff,9,0,30,21
1683703954875,PHYS 2B,A01,187097,Staff,55,0,115,60
1683703955905,PHYS 2C,A01,187099,Staff,63,0,115,52
1683703956933,PHYS 2CL,A01,187101,Staff,5,0,28,23
1683703956933,PHYS 2CL,A02,187102,Staff,15,0,28,13
1683703957962,PHYS 2D,A01,187123,Shotwell; Brian,95,0,115,20
1683703958987,PHYS 4B,A01,187133,Grinstein; Benjamin,35,0,50,15
1683703960017,POLI 10,A00,188819,Staff,0,4,50,50
1683703961042,POLI 11,A00,188827,Staff,43,0,50,7
1683703962066,POLI 13R,A00,188828,Staff,0,1,20,20
1683703963092,POLI 27,A01,188830,Elgin; Samuel Zincke,0,2,70,70
1683703964117,POLI 30,A00,188832,Desposato; Scott,30,0,50,20
1683703965145,POLI 102F,A00,188834,Staff,1,0,40,39
1683703966169,POLI 104A,A00,188852,Staff,12,0,30,18
1683703967193,POLI 104I,A00,188853,Staff,0,8,20,20
1683703968218,POLI 110B,A00,188854,Wiens; David,6,0,20,14
1683703969242,POLI 112A,A00,188855,Wiens; David,3,0,30,27
1683703970271,POLI 117R,A00,188856,Forman; Fonna,0,12,20,20
1683703971300,POLI 118,A00,188857,Ingham; Sean,8,0,20,12
1683703972325,POLI 120G,A00,188858,Staff,7,0,30,23
1683703973358,POLI 131CR,A00,188863,Hoston; Germaine,20,0,50,30
1683703974386,POLI 133,A00,188864,Nellis; Gareth Hb,44,0,50,6
1683703975413,POLI 134D,A00,188865,Desposato; Scott,27,0,30,3
1683703976439,POLI 142A,A00,188871,Gartzke; Erik,21,0,50,29
1683703977471,POLI 142K,A00,188874,Staff,38,0,50,12
1683703978497,POLI 143,A00,188940,Gartzke; Erik,15,0,30,15
1683703979521,POLI 153,A00,188943,Staff,1,0,20,19
1683703980545,POLI 160AA,A00,188944,Staff,10,0,40,30
1683703981569,POLI 170A,A00,188945,Staff,10,0,30,20
1683703983621,PSYC 1,A00,188952,Staff,36,0,90,54
1683703984645,PSYC 2,B00,188953,Staff,19,0,35,16
1683703985670,PSYC 6,A00,188970,Staff,47,0,60,13
1683703986696,PSYC 7,A00,188973,Staff,35,0,45,10
1683703988369,PSYC 60,A01,188980,Rickard; Timothy C.,42,0,60,18
1683703989395,PSYC 70,A01,189001,Steiner; Eric Tomas,22,0,45,23
1683703990424,PSYC 100,A00,189005,Lacefield; Katharine I,0,98,120,120
1683703991453,PSYC 102,A00,189008,Staff,6,0,30,24
1683703992479,PSYC 106,B00,189026,Gorman; Michael R.,27,0,60,33
1683703993504,PSYC 114,B01,189033,Winkielman; Piotr,0,31,30,30
1683703994533,PSYC 131,A00,189036,Anagnostaras; Stephan,0,44,60,60
1683703995558,PSYC 136,A00,189041,Lowe; Angela Beth,0,7,25,25
1683703996583,PSYC 137,A00,189057,Winkielman; Piotr,0,36,25,25
1683703997613,PSYC 144,A00,189107,Wixted; John T,0,11,50,50
1683703999726,PSYC 162,A00,189142,Staff,0,9,85,85
1683704000754,PSYC 172,A00,189144,Gorman; Michael R.,0,6,30,30
1683704002807,PSYC 179,A00,189146,Lacefield; Katharine I,0,88,120,120
1683704003832,PSYC 181,A00,189147,Anagnostaras; Stephan,0,45,90,90
1683704004858,PSYC 190R,A00,189148,Barner; David A.,0,23,80,80
1683704005888,PSYC 191,A00,189275,Rickard; Timothy C.,0,11,25,25
1683704006914,PSYC 193,A00,189276,Chapman; Eddie Nathaniel,0,1,0,4
1683704007944,PSYC 193L,A01,189281,Lowe; Angela Beth,8,0,20,12
1683704007944,PSYC 193L,B01,189285,Staff,28,0,35,7
1683704009535,RELI 149,A00,187137,Rahimi; Babak,6,0,40,34
1683704010560,SE 9,A01,187315,Staff,0,2,18,18
1683704011586,SE 101B,A00,187409,Staff,24,0,30,6
1683704012614,SE 110B,A00,187444,Staff,10,0,40,30
1683704013643,SE 130B,A00,187449,Staff,31,0,40,9
1683704014672,SE 150A,A00,187516,Staff,8,0,20,12
1683704015701,SE 154,A00,187528,Staff,29,0,50,21
1683704016726,SIO 3,A01,258171,Staff,35,0,40,5
1683704017752,SIO 10,A00,187144,Cook; Geoffrey W,0,6,75,75
1683704018781,SIO 45,A00,187152,Cook; Geoffrey W,1,7,100,99
1683704019809,SIO 109R,A00,194486,Staff,0,4,20,20
1683704021859,SIO 187,A01,187233,Kacev; David,12,0,40,28
1683704022887,SOCI 1,A01,258656,Thorpe; Charles Robert,28,0,30,2
1683704022887,SOCI 1,A02,258658,Thorpe; Charles Robert,30,0,30,0
1683704022887,SOCI 1,A03,258661,Thorpe; Charles Robert,25,0,25,0
1683704022887,SOCI 1,A04,258666,Thorpe; Charles Robert,22,0,25,3
1683704022887,SOCI 1,A05,258897,Thorpe; Charles Robert,22,0,25,3
1683704022887,SOCI 1,A06,258898,Thorpe; Charles Robert,25,0,25,0
1683704023913,SOCI 30,A01,258903,Pardo Guerra; Juan Pablo,14,0,30,16
1683704024938,SOCI 102,A00,258904,Staff,9,0,25,16
1683704025962,SOCI 106,A00,258905,Staff,19,0,25,6
1683704026986,SOCI 111,A00,258907,Ribas Norris; Janet Vanesa,26,0,30,4
1683704028013,SOCI 121R,A00,258908,Pardo Guerra; Juan Pablo,7,0,30,23
1683704029040,SOCI 126,A01,203330,Staff,14,0,20,6
1683704030072,SOCI 131,A00,258909,Thorpe; Charles Robert,30,0,60,30
1683704031103,SOCI 135,A00,258910,Payne; Christine Anna,0,13,30,30
1683704032128,SOCI 157,A00,258911,Staff,10,0,30,20
1683704033156,SOCI 184,A00,258912,Staff,25,0,30,5
1683704034181,SOCI 188D,A00,258913,Staff,22,0,30,8
1683704035206,SYN 2,001,187529,Staff,9,0,16,7
1683704035206,SYN 2,002,201452,Staff,0,20,16,16
1683704035206,SYN 2,003,201469,Staff,1,0,16,15
1683704036231,SYN 100,A01,187531,Staff,0,9,20,20
1683704036231,SYN 100,B01,201491,Staff,0,10,20,20
1683704037258,TDAC 1,A00,189286,Walsh; Kim C.,3,0,20,17
1683704037258,TDAC 1,B00,189287,Harting; Carla Kelso,10,0,20,10
1683704038281,TDAC 101,A00,189300,Walsh; Kim C.,16,0,20,4
1683704038281,TDAC 101,B00,189301,Harting; Carla Kelso,18,0,20,2
1683704039307,TDAC 102,A00,189304,Basso; Beatrice,14,0,20,6
1683704040336,TDAC 108,A00,189305,Staff,18,0,20,2
1683704041377,TDDE 131,A00,189310,Staff,19,0,20,1
1683704041377,TDDE 131,B00,189314,Staff,19,0,20,1
1683704041377,TDDE 131,C00,189315,Staff,48,0,50,2
1683704041377,TDDE 131,D00,189316,Staff,14,0,15,1
1683704041377,TDDE 131,E00,204841,Staff,20,0,20,0
1683704042408,TDGE 10,A00,189289,Staff,27,0,50,23
1683704042408,TDGE 10,B00,189290,Havis; Allan,0,1,50,50
1683704043440,TDGE 11,A00,189291,Fulton; Julia,0,4,50,50
1683704043440,TDGE 11,B00,189292,Staff,20,0,25,5
1683704043440,TDGE 11,C00,260270,Staff,0,0,0,0
1683704044469,TDGE 25,A00,189294,Staff,1,0,20,19
1683704045494,TDGE 124,A00,189318,Fulton; Julia,0,7,50,50
1683704046518,TDGE 125,A00,189319,Staff,13,0,25,12
1683704046518,TDGE 125,B00,189320,Staff,23,0,25,2
1683704047543,TDGE 127,A00,189322,Havis; Allan,1,0,50,49
1683704048572,TDHT 101,A00,189323,Staff,18,0,25,7
1683704048572,TDHT 101,B00,189324,Staff,25,0,25,0
1683704049601,TDHT 102,A00,189325,Staff,49,0,50,1
1683704050626,TDMV 1,A00,189295,Arcidiacono; Kristin,20,0,30,10
1683704050626,TDMV 1,B00,189296,Caligagan; Maria T.,23,0,30,7
1683704051651,TDMV 2,A00,189297,Sammartano; Tonnie,27,0,30,3
1683704051651,TDMV 2,B00,189299,Arcidiacono; Kristin,23,0,30,7
1683704052682,TDMV 3,A00,204998,Rincon; Alicia,22,0,30,8
1683704053707,TDMV 120,A00,189458,Sammartano; Tonnie,28,0,30,2
1683704054735,TDMV 138,A00,189541,Jun; Grace Shin Hae,20,0,40,20
1683704055763,TDMV 142,A00,189717,Caligagan; Tony,25,0,30,5
1683704055763,TDMV 142,B00,189718,Caligagan; Maria T.,25,0,30,5
1683704056794,TMC 2,A01,187533,Staff,25,0,25,0
1683704056794,TMC 2,A02,187534,Staff,25,0,25,0
1683704057819,USP 1,A01,187536,Kwak; Nancy,0,16,25,25
1683704058843,USP 5,A01,187538,Staff,8,0,25,17
1683704059868,USP 101,A00,199253,Staff,0,4,0,0
1683704060893,USP 124,A00,187562,Boomhower; Matthew Charles,0,0,30,30
1683704061917,USP 138,A00,187582,Staff,19,0,25,6
1683704062942,USP 152,A01,187597,Staff,3,0,25,22
1683704063967,USP 153,A00,187598,Staff,18,0,25,7
1683704064991,USP 168,A00,187607,Kwak; Nancy,2,0,5,3
1683704066017,USP 173,A00,187619,Staff,4,0,25,21
1683704067041,USP 181,A00,187638,Staff,0,4,25,25
1683704068064,VIS 103,A00,187650,Cruz; Edwin Teddy,17,0,75,58
1683704069088,VIS 110D,A00,187669,Staff,13,0,22,9
1683704070114,VIS 127C,A00,187720,Shen; Kuiyi,67,0,146,79
1683704071138,VIS 149,A00,187731,Yoldas; Pinar,0,12,22,22
1683704072164,VIS 151,A01,188091,Staff,22,0,34,12
1683704072164,VIS 151,A02,188092,Staff,11,0,34,23
1683704073195,VIS 160B,A00,188093,Stalbaum; Brett,0,1,10,10
1683704075246,WCWP 10B,A00,201720,Staff,0,0,5,5
1683704075246,WCWP 10B,B00,201722,Staff,0,0,6,6
1683704076276,WCWP 100,A00,201725,Gagnon; Jeffrey C,0,0,2,2
1683704076276,WCWP 100,B00,201727,Staff,0,4,15,15
1683704079463,ANBI 133,A00,258401,Wilder; Linnea Lorene,34,0,40,6
1683704080492,ANBI 140,A00,258395,Hrvoj Mihic; Branka,18,0,25,7
1683704081527,ANSC 120,A00,258402,Bialecki; Jon Anthony,26,0,40,14
1683704082552,ANSC 144,A00,258400,Staff,12,0,40,28
1683704084609,ANSC 166,A00,258396,Parish; Steven Martin,156,0,175,19
1683704085632,ANSC 180,A00,193533,Staff,8,0,20,12
1683704086661,ANSC 188,A00,258397,Jassal; Aftab,34,0,40,6
1683704087688,ANTH 3,A01,258316,Staff,23,0,30,7
1683704088712,ANTH 5,A00,258394,Semendeferi; Ekaterini,16,0,20,4
1683704089744,ANTH 21,A01,258331,Staff,4,0,40,36
1683704090768,ANTH 103,A00,258398,Varma; Saiba,15,0,25,10
1683704091797,AWP 10,001,202034,Staff,0,0,0,0
1683704091797,AWP 10,002,202035,Staff,0,0,0,0
1683704091797,AWP 10,003,202036,Staff,0,0,0,0
1683704091797,AWP 10,004,202037,Staff,0,0,0,0
1683704091797,AWP 10,005,202038,Staff,0,0,0,0
1683704091797,AWP 10,006,202039,Staff,0,0,0,0
1683704091797,AWP 10,007,202040,Staff,0,0,0,0
1683704091797,AWP 10,008,202041,Staff,0,0,0,0
1683704091797,AWP 10,009,202042,Staff,0,0,0,0
1683704091797,AWP 10,010,202043,Staff,0,0,0,0
1683704091797,AWP 10,011,202044,Staff,0,0,0,0
1683704091797,AWP 10,012,202045,Staff,0,0,0,0
1683704091797,AWP 10,013,202046,Staff,0,0,0,0
1683704091797,AWP 10,014,202047,Staff,0,0,0,0
1683704091797,AWP 10,015,202048,Staff,0,0,0,0
1683704091797,AWP 10,016,202049,Staff,0,0,0,0
1683704091797,AWP 10,017,202050,Staff,0,0,0,0
1683704091797,AWP 10,018,202051,Staff,0,0,0,0
1683704091797,AWP 10,019,202052,Staff,0,0,0,0
1683704091797,AWP 10,020,202053,Staff,0,0,0,0
1683704091797,AWP 10,021,202054,Staff,0,0,0,0
1683704091797,AWP 10,022,202055,Staff,0,0,0,0
1683704091797,AWP 10,023,202056,Staff,0,0,0,0
1683704091797,AWP 10,024,202057,Staff,0,0,0,0
1683704091797,AWP 10,025,202058,Staff,0,0,0,0
1683704091797,AWP 10,026,202059,Staff,0,0,0,0
1683704092821,AWP 102,001,202032,Staff,0,0,0,0
1683704092821,AWP 102,002,202033,Staff,0,0,0,0
1683704093848,BENG 100,A01,254234,Taylor Amos; Alyssa C,31,0,40,9
1683704095077,BENG 196,001,270013,Engler; Adam J.,9999,0,9999,0
1683704096110,BICD 100R,A01,202018,Smith; Laurie,0,7,32,32
1683704096110,BICD 100R,A02,202019,Smith; Laurie,0,3,32,32
1683704096110,BICD 100R,A03,202020,Smith; Laurie,0,1,32,32
1683704096110,BICD 100R,A04,202021,Smith; Laurie,6,0,32,26
1683704096110,BICD 100R,A05,202022,Smith; Laurie,10,0,32,22
1683704097139,BICD 136,A01,193242,Gustafson-Brown; Cindy,0,2,32,32
1683704097139,BICD 136,A02,193244,Gustafson-Brown; Cindy,13,0,32,19
1683704098172,BIEB 102,A01,193249,Butler; Shannon Rhey,0,0,32,32
1683704098172,BIEB 102,A02,193251,Butler; Shannon Rhey,0,0,32,32
1683704098172,BIEB 102,A03,193253,Butler; Shannon Rhey,0,0,32,32
1683704098172,BIEB 102,A04,193255,Butler; Shannon Rhey,13,0,32,19
1683704098172,BIEB 102,A05,193265,Butler; Shannon Rhey,25,0,32,7
1683704098172,BIEB 102,A06,193269,Butler; Shannon Rhey,12,0,32,20
1683704100228,BIEB 150,A01,193274,Staff,0,0,32,32
1683704100228,BIEB 150,A02,193285,Staff,24,0,32,8
1683704101272,BIEB 194,A00,193286,Kurle; Carolyn M.,19,0,32,13
1683704102302,BILD 1,A01,192291,Staff,15,0,32,17
1683704102302,BILD 1,A02,192292,Staff,30,0,32,2
1683704102302,BILD 1,B01,192520,Reuther; Keefe,0,1,0,0
1683704102302,BILD 1,B02,192532,Reuther; Keefe,0,1,0,0
1683704103393,BILD 3,A01,192556,Butler; Shannon Rhey,0,0,32,32
1683704103393,BILD 3,A02,192581,Butler; Shannon Rhey,0,1,32,32
1683704103393,BILD 3,A03,192611,Butler; Shannon Rhey,19,0,32,13
1683704103393,BILD 3,A04,192612,Butler; Shannon Rhey,23,0,32,9
1683704103393,BILD 3,A05,192613,Butler; Shannon Rhey,26,0,32,6
1683704103393,BILD 3,A06,192679,Butler; Shannon Rhey,27,0,32,5
1683704103393,BILD 3,A07,192682,Butler; Shannon Rhey,20,0,32,12
1683704104424,BILD 4,A01,192836,Reuther; Keefe,1,0,24,23
1683704104424,BILD 4,A02,193044,Reuther; Keefe,4,0,24,20
1683704105450,BILD 10,A01,193142,Gustafson-Brown; Cindy,29,0,32,3
1683704105450,BILD 10,A02,193149,Gustafson-Brown; Cindy,31,0,32,1
1683704106475,BIMM 100,A01,193301,Staff,0,6,32,32
1683704106475,BIMM 100,A02,193312,Staff,0,7,32,32
1683704106475,BIMM 100,A03,193323,Staff,0,10,32,32
1683704107507,BIMM 101,A01,193329,McDonnell; Lisa Marie,0,3,24,24
1683704107507,BIMM 101,A02,193339,McDonnell; Lisa Marie,0,3,24,24
1683704107507,BIMM 101,B01,193354,McDonnell; Lisa Marie,0,4,24,24
1683704107507,BIMM 101,B02,193357,McDonnell; Lisa Marie,0,3,24,24
1683704108540,BIMM 110,A01,193377,Tat; John,0,11,32,32
1683704108540,BIMM 110,A02,193378,Tat; John,0,11,32,32
1683704109570,BIMM 120,A01,206116,Staff,0,0,32,32
1683704109570,BIMM 120,A02,206117,Staff,7,0,32,25
1683704109570,BIMM 120,A03,206121,Staff,21,0,32,11
1683704110596,BIPN 100,A01,193393,Park; Ji Young,0,15,32,32
1683704110596,BIPN 100,A02,193402,Park; Ji Young,0,14,32,32
1683704110596,BIPN 100,A03,193413,Park; Ji Young,0,14,32,32
1683704110596,BIPN 100,A04,193414,Park; Ji Young,0,13,32,32
1683704111621,BIPN 102,A01,193429,Staff,0,0,32,32
1683704111621,BIPN 102,A02,193438,Staff,18,0,32,14
1683704112648,BIPN 106,A01,193450,Reyes Gonzalez; Catalina,0,2,40,40
1683704113680,BIPN 134,A01,193465,Cooke; James Edward,0,0,32,32
1683704113680,BIPN 134,A02,193474,Cooke; James Edward,25,0,32,7
1683704113680,BIPN 134,A03,193485,Cooke; James Edward,29,0,32,3
1683704113680,BIPN 134,A04,193486,Cooke; James Edward,20,0,32,12
1683704113680,BIPN 134,A05,193491,Cooke; James Edward,31,0,32,1
1683704113680,BIPN 134,A06,193501,Cooke; James Edward,30,0,32,2
1683704113680,BIPN 134,A07,193510,Cooke; James Edward,29,0,32,3
1683704115736,BISP 194,A00,222522,Staff,14,0,32,18
1683704116762,CAT 124,A01,202407,Staff,19,0,25,6
1683704117792,CAT 125,A00,202408,Marchisotto; Jennifer Anne,2,0,20,18
1683704118825,CAT 125R,A00,202409,Smith; Lauryn Alissa,0,11,20,20
1683704118825,CAT 125R,B00,202410,Morales; Celeste Georgianna,0,11,20,20
1683704118825,CAT 125R,C00,202411,Irwin; Matthew Joseph,0,12,20,20
1683704119852,CENG 15,A01,204712,Yang; Kesong,0,1,0,0
1683704120878,CENG 114,A00,202070,Jahed Motlagh; Zeinab,5,0,20,15
1683704121904,CGS 105,A00,185477,Wesling; Megan E.,24,0,40,16
1683704122928,CGS 106,A00,185494,Staff,11,0,22,11
1683704123954,CGS 108,A00,185495,Staff,14,0,20,6
1683704124982,CGS 114,A00,185496,Staff,13,0,18,5
1683704126008,CGS 119,A00,185501,Staff,15,0,20,5
1683704127033,CGS 120,A00,185511,Staff,11,0,20,9
1683704128060,CHEM 4,A01,184675,Bussey; Thomas J,97,0,100,3
1683704129085,CHEM 6A,A01,184677,Staff,32,0,60,28
1683704130110,CHEM 6B,A01,184679,Staff,63,0,100,37
1683704131135,CHEM 6C,A01,184681,Bussey; Thomas J,0,0,50,50
1683704131135,CHEM 6C,A02,184682,Bussey; Thomas J,32,0,50,18
1683704132161,CHEM 40A,A01,184684,Albizati; Kim F.,33,0,100,67
1683704133191,CHEM 40B,A01,184686,Albizati; Kim F.,0,22,100,100
1683704134214,CHEM 41B,A01,184690,Staff,51,0,100,49
1683704135240,COGS 3,A01,184715,Boyle; Mary E. T.,0,27,40,40
1683704136269,COGS 14B,A01,185172,Staff,0,14,38,38
1683704137297,COGS 18,A01,184736,Staff,14,0,80,66
1683704138323,COGS 100,A01,184932,Staff,0,8,73,73
1683704139348,COGS 101A,A01,184935,Staff,0,40,30,30
1683704140379,COGS 101B,A01,184944,Staff,0,2,30,30
1683704141404,COGS 101C,A01,184946,Staff,0,10,30,30
1683704142430,COGS 102A,A01,184951,Johnson; Christine M.,1,0,40,39
1683704143456,COGS 107B,A01,184953,Mooshagian; Eric Frederick,0,52,40,40
1683704144480,COGS 118B,A01,184959,Gupta; Anjum,0,50,40,40
1683704145509,COGS 153,A00,184961,Staff,1,16,30,29
1683704146539,COGS 177,A00,184962,Staff,0,20,30,30
1683704147567,COGS 187A,A01,184969,Boyle; Mary E. T.,0,19,40,40
1683704148593,COMM 10,A01,185174,Staff,0,5,25,25
1683704148593,COMM 10,A02,185189,Staff,0,2,25,25
1683704148593,COMM 10,A03,269821,Staff,0,1,0,0
1683704149625,COMM 100B,A02,185476,Staff,10,0,25,15
1683704149625,COMM 100B,A03,277340,Staff,25,0,25,0
1683704150650,COMM 100C,A01,185314,Staff,2,0,25,23
1683704150650,COMM 100C,A02,185327,Staff,17,0,25,8
1683704151675,COMM 110M,A00,185349,Staff,0,0,40,40
1683704152699,COMM 113T,A00,185352,Staff,25,0,40,15
1683704153724,COMM 114I,A00,185353,Staff,31,0,40,9
1683704154751,COMM 131,A00,185354,Staff,17,0,30,13
1683704155777,CSE 8A,A50,185358,Cao; Yingjun,0,46,10,10
1683704156809,CSE 8B,A01,185362,Staff,0,48,50,50
1683704157833,CSE 11,A01,185416,Cao; Yingjun,0,91,10,10
1683704158860,CSE 20,A01,185445,Briones; Jor-el Thomas Caparas,3,0,25,22
1683704159885,CSE 21,A01,185447,Staff,9,0,50,41
1683704160917,CSE 101,A01,185451,Staff,0,13,50,50
1683704160917,CSE 101,B01,185453,Jones; Miles E,0,15,50,50
1683704162971,CSE 141,A01,185458,Eldon; John,16,0,100,84
1683704163998,CSE 141L,A01,185461,Eldon; John,8,0,100,92
1683704165029,CSE 142,A01,185463,Staff,34,0,60,26
1683704165029,CSE 142,B01,201355,Staff,0,7,60,60
1683704166055,CSE 142L,A01,185470,Staff,34,0,60,26
1683704166055,CSE 142L,B01,201417,Staff,0,6,60,60
1683704167080,CSE 190,A00,201433,Staff,32,0,49,17
1683704168113,DOC 1,A01,259136,Strom; Megan C.,7,0,15,8
1683704168113,DOC 1,A02,259137,Strom; Megan C.,14,0,15,1
1683704168113,DOC 1,A03,259138,Strom; Megan C.,14,0,15,1
1683704168113,DOC 1,A04,259139,Strom; Megan C.,14,0,15,1
1683704169145,DOC 100D,A00,259140,Pass; Natalye Joann,14,0,25,11
1683704170171,DSGN 1,A01,184749,Rill; Bryan,0,26,30,30
1683704171196,DSGN 100,A01,185168,Staff,0,2,25,25
1683704172222,ECE 5,A01,185626,Morris; Karcher William,0,12,0,0
1683704173250,ECE 101,A01,185628,Staff,14,0,70,56
1683704174276,ECE 107,A01,185635,Baghdadchi; Saharnaz,0,0,20,20
1683704174276,ECE 107,A02,185638,Baghdadchi; Saharnaz,1,0,20,19
1683704175301,ECE 148,A01,185647,Silberman; Jack,0,0,16,16
1683704176328,ECON 1,A01,185537,Crane; Meredith Helen,54,0,70,16
1683704177358,ECON 3,A01,185549,Crane; Meredith Helen,30,0,70,40
1683704178389,ECON 4,A01,203354,Anderson; John Charles,0,5,10,10
1683704179413,ECON 100A,A01,185574,Staff,0,5,40,40
1683704180439,ECON 100B,A01,185576,Staff,0,12,50,50
1683704181468,ECON 100C,A01,185589,Newhouse; Herbert S,30,0,70,40
1683704182494,ECON 105,A00,185608,Vespa; Emanuel Ignacio,19,0,35,16
1683704183527,ECON 109,A01,185610,Shishkin; Denis,9,0,35,26
1683704184557,ECON 110A,A01,185612,Staff,8,0,40,32
1683704185581,ECON 120A,A01,185615,Staff,19,0,40,21
1683704186608,ECON 120C,A01,185617,Sun; Yixiao,0,21,70,70
1683704187641,ECON 144,A00,203346,Squires; Dale E,2,0,35,33
1683704188666,ECON 171,A01,203349,Newhouse; Herbert S,0,1,35,35
1683704189696,ECON 173A,A01,185621,Toda; Alexis Akira,21,0,35,14
1683704190745,EDS 25,A01,202413,Staff,0,1,0,0
1683704190745,EDS 25,A02,202414,Staff,0,1,0,0
1683704190745,EDS 25,A03,202415,Staff,0,0,0,0
1683704190745,EDS 25,A04,202416,Staff,0,1,0,0
1683704190745,EDS 25,A05,202439,Staff,0,0,0,0
1683704190745,EDS 25,A06,202440,Staff,0,0,0,0
1683704190745,EDS 25,B01,202631,Staff,0,0,0,0
1683704190745,EDS 25,B02,202632,Staff,0,0,0,0
1683704190745,EDS 25,B03,202639,Staff,0,0,0,0
1683704190745,EDS 25,B04,202640,Staff,0,0,0,0
1683704190745,EDS 25,B05,202643,Staff,0,0,0,0
1683704190745,EDS 25,B06,202644,Staff,0,0,0,0
1683704191770,EDS 38,A01,202659,Black; Alison Michelle,25,0,25,0
1683704192797,EDS 115,A00,202652,Staff,18,0,30,12
1683704193821,EDS 125,A00,202649,Staff,13,0,30,17
1683704194846,EDS 126,A01,203332,Staff,30,0,30,0
1683704195872,EDS 139,A00,202838,Staff,16,0,25,9
1683704196900,EDS 146,A01,202655,Staff,14,0,25,11
1683704197931,ENG 15,A00,185667,Staff,0,1,0,0
1683704197931,ENG 15,B00,185672,Staff,0,0,0,0
1683704197931,ENG 15,C00,185675,Staff,0,0,0,0
1683704197931,ENG 15,D00,185682,Staff,0,0,0,0
1683704197931,ENG 15,E00,185684,Staff,0,0,0,0
1683704198956,ETHN 103,A00,185710,Staff,0,8,35,35
1683704199981,ETHN 103A,A00,199228,Man; Simeon S,0,0,9,9
1683704201009,ETHN 109,A00,185711,Staff,15,0,35,20
1683704202038,ETHN 142,A00,185726,Staff,0,4,30,30
1683704203068,ETHN 163J,A00,199229,Man; Simeon S,5,0,8,3
1683704204097,ETHN 168,A00,185727,Staff,7,0,10,3
1683704205126,ETHN 182,A00,185728,Staff,0,0,35,35
1683704206150,ETHN 183,A00,185737,Staff,9,0,18,9
1683704207233,GLBH 111,A01,209361,Burgos; Jose L.,0,0,0,0
1683704209298,HIEU 104,A00,185792,Staff,14,0,20,6
1683704210326,HIEU 115,A00,185800,Staff,0,0,20,20
1683704211351,HIEU 128,A00,185801,Staff,0,9,20,20
1683704212375,HIEU 147,A00,185802,Staff,15,0,20,5
1683704213404,HIEU 154,A00,185823,Staff,11,0,20,9
1683704214429,HILA 102,A00,185826,Staff,14,0,20,6
1683704215458,HILD 2C,A01,185778,Staff,0,13,20,20
1683704216485,HILD 7B,A01,185780,Kwak; Nancy,0,17,32,32
1683704216485,HILD 7B,A02,185781,Kwak; Nancy,0,18,32,32
1683704217512,HILD 30,A01,185791,Staff,12,0,20,8
1683704218538,HISC 119,A00,185830,Golan; Tal,0,10,20,20
1683704219564,HITO 156GS,A00,185831,Patterson; Patrick H.,0,0,0,23
1683704220589,HIUS 103,A00,185832,Man; Simeon S,0,4,20,20
1683704221616,HIUS 117,A00,185836,Kwak; Nancy,2,0,20,18
1683704222644,HIUS 125,A00,185840,Man; Simeon S,0,2,23,23
1683704223672,HIUS 149,A00,185845,Staff,1,0,20,19
1683704224700,HUM 3,A01,185882,Zavodny; Tatiana Sophia,0,8,50,50
1683704224700,HUM 3,B01,185899,Caldwell; Michael Alan,0,18,50,50
1683704225725,HUM 3GS,A00,185900,Patterson; Patrick H.,0,0,0,23
1683704226752,HUM 4,A01,185938,Zroka; Amy Liane,28,0,50,22
1683704226752,HUM 4,B01,185956,Watkins; Eric,0,6,50,50
1683704226752,HUM 4,B02,202209,Watkins; Eric,0,5,50,50
1683704226752,HUM 4,B03,202210,Watkins; Eric,0,5,50,50
1683704227783,HUM 5,A01,185958,West; Geoffrey Scott,0,0,50,50
1683704227783,HUM 5,A02,202215,West; Geoffrey Scott,0,1,50,50
1683704228819,INTL 190,A00,185959,Gagnon; Jeffrey C,0,0,0,9
1683704228819,INTL 190,B00,185960,Lettieri; Michael Joseph,0,0,0,2
1683704229849,JAPN 180,A00,254509,Staff,5,0,30,25
1683704230883,LATI 10,A01,202853,Kennemore; Amy Michelle,4,0,35,31
1683704230883,LATI 10,A02,202854,Kennemore; Amy Michelle,3,0,35,32
1683704230883,LATI 10,A03,270054,Kennemore; Amy Michelle,30,0,30,0
1683704231912,LATI 180,A00,202855,Kennemore; Amy Michelle,11,0,20,9
1683704232938,LAWS 101,A00,201767,Golan; Tal,0,7,40,40
1683704233966,LIFR 1C,A00,185961,Staff,6,0,20,14
1683704234998,LIFR 1CX,A00,185962,Staff,7,0,20,13
1683704236027,LIFR 1D,A00,185963,Staff,7,0,20,13
1683704237053,LIFR 1DX,A00,185964,Staff,7,0,20,13
1683704238082,LIGN 101,A01,186039,Staff,43,0,50,7
1683704239110,LIGN 165,A00,186040,Staff,14,0,50,36
1683704240141,LTCS 108,A00,186041,Staff,5,0,10,5
1683704241168,LTCS 119,A00,186042,Staff,15,0,20,5
1683704242196,LTCS 130,A00,186043,Wesling; Megan E.,15,0,25,10
1683704244252,LTEA 138,A00,186119,Staff,14,0,40,26
1683704245280,LTEN 124,A00,186148,Staff,5,0,25,20
1683704246305,LTEN 178,A00,186149,Staff,6,0,15,9
1683704247331,LTEN 181,A00,186150,Blanco; John D,34,0,40,6
1683704248360,LTWL 120,A00,186160,Staff,19,0,25,6
1683704249388,LTWL 165,A00,186161,Staff,22,0,25,3
1683704250414,LTWR 100,A00,186162,Staff,0,5,15,15
1683704251443,LTWR 102,A00,186163,Doller; Ben,5,0,15,10
1683704252475,MAE 8,A01,186412,Staff,0,1,0,0
1683704253505,MAE 30B,A00,186445,Bahadori; Mohammad Yousef,81,0,100,19
1683704254530,MAE 40,A00,186592,Bewley; Thomas R,10,0,50,40
1683704255556,MAE 101B,A00,186593,Bahadori; Mohammad Yousef,80,0,100,20
1683704256585,MAE 105,A00,186594,Bandaru; Prabhakar,10,0,50,40
1683704257611,MAE 107,A00,186599,Pham; Hieu Tan,0,8,120,120
1683704258638,MAE 148,A01,186660,Silberman; Jack,3,0,16,13
1683704259669,MATH 10A,A01,188095,Staff,0,6,35,35
1683704260700,MATH 10B,A01,188097,Bowers; Adam R.,0,12,30,30
1683704260700,MATH 10B,A02,188099,Bowers; Adam R.,0,11,30,30
1683704260700,MATH 10B,B01,188104,Bowers; Adam R.,0,10,30,30
1683704260700,MATH 10B,B02,188106,Bowers; Adam R.,0,9,30,30
1683704261733,MATH 10C,A01,188111,Staff,0,20,30,30
1683704261733,MATH 10C,A02,188127,Staff,0,19,30,30
1683704261733,MATH 10C,A03,188131,Staff,0,19,30,30
1683704261733,MATH 10C,B01,188218,Staff,17,0,30,13
1683704261733,MATH 10C,B02,188244,Staff,13,0,30,17
1683704261733,MATH 10C,B03,188277,Staff,14,0,30,16
1683704262778,MATH 18,A01,188344,Bach; Quang Tran,18,0,30,12
1683704262778,MATH 18,A02,188345,Bach; Quang Tran,11,0,30,19
1683704262778,MATH 18,B01,188353,Bach; Quang Tran,11,0,30,19
1683704262778,MATH 18,B02,188354,Bach; Quang Tran,19,0,30,11
1683704263804,MATH 20A,A01,188374,Staff,11,0,35,24
1683704264830,MATH 20B,A01,188382,Ohm; Ko Woon,7,0,30,23
1683704264830,MATH 20B,A02,188383,Ohm; Ko Woon,22,0,30,8
1683704264830,MATH 20B,B01,188385,Ohm; Ko Woon,7,0,30,23
1683704264830,MATH 20B,B02,188392,Ohm; Ko Woon,22,0,30,8
1683704265858,MATH 20C,A01,188394,Harel; Guershon,10,0,30,20
1683704265858,MATH 20C,A02,188395,Harel; Guershon,13,0,30,17
1683704265858,MATH 20C,B01,188404,Harel; Guershon,5,0,30,25
1683704265858,MATH 20C,B02,188405,Harel; Guershon,18,0,30,12
1683704266890,MATH 20D,A01,188414,Hammock; Frances H,0,1,30,30
1683704266890,MATH 20D,A02,188415,Hammock; Frances H,0,1,30,30
1683704266890,MATH 20D,B01,188447,Hammock; Frances H,0,1,30,30
1683704266890,MATH 20D,B02,188486,Hammock; Frances H,2,0,30,28
1683704267917,MATH 20E,A01,188649,Staff,21,0,30,9
1683704267917,MATH 20E,A02,188650,Staff,20,0,30,10
1683704267917,MATH 20E,A03,188673,Staff,0,0,30,30
1683704268943,MATH 102,A01,188675,Staff,0,40,35,35
1683704269974,MATH 103B,A01,188681,Staff,3,0,35,32
1683704269974,MATH 103B,B01,188692,Staff,5,0,35,30
1683704271004,MATH 109,A01,188695,Salehi Golsefidy; Alireza,24,0,35,11
1683704271004,MATH 109,A02,188696,Salehi Golsefidy; Alireza,25,0,35,10
1683704272030,MATH 120A,A01,188698,Eggers; John Dietrich,7,0,35,28
1683704273056,MATH 142B,A01,188736,Ioana; Adrian,0,0,30,30
1683704273056,MATH 142B,A02,188741,Ioana; Adrian,0,1,30,30
1683704273056,MATH 142B,A03,188743,Ioana; Adrian,0,2,30,30
1683704274085,MATH 168A,A01,188790,Staff,0,11,35,35
1683704275111,MATH 170A,A01,188803,Nie; Jiawang,0,2,35,35
1683704275111,MATH 170A,A02,188811,Nie; Jiawang,0,1,35,35
1683704275111,MATH 170A,A03,188814,Nie; Jiawang,0,0,35,35
1683704275111,MATH 170A,A04,188815,Nie; Jiawang,5,0,35,30
1683704276136,MATH 193B,A01,188817,Staff,0,0,35,35
1683704276136,MATH 193B,A02,188818,Staff,6,0,35,29
1683704277164,MGT 4,A01,202857,Anderson; John Charles,59,0,80,21
1683704278187,MGT 12,A00,202858,Lindenberger; Wade Douglas,40,0,90,50
1683704279216,MGT 18,A00,202859,Staff,73,0,90,17
1683704280241,MGT 18GS,A00,202860,McKay; Michael J,13,0,28,15
1683704281268,MGT 45,A00,202861,Pecore; Joseph P.,8,0,90,82
1683704282302,MGT 100,A00,202863,Yavorsky; Daniel Ryan,27,0,90,63
1683704283330,MGT 103,A00,202864,Ehrich; Kristine R,0,19,90,90
1683704284361,MGT 112,A00,202865,Ehrich; Kristine R,15,0,90,75
1683704285388,MGT 121A,A00,202868,Staff,70,0,90,20
1683704286418,MGT 131B,A00,202869,Anderson; John Charles,58,0,90,32
1683704287444,MGT 136,A00,202871,Lindenberger; Wade Douglas,83,0,90,7
1683704288470,MGT 164,A00,202873,Staff,0,67,90,91
1683704289496,MGT 164GS,A00,202874,McKay; Mary A,13,0,28,15
1683704290522,MGT 180,A00,202875,Staff,0,51,90,91
1683704291552,MMW 11R,A01,205019,Herbst; Matthew,0,0,30,30
1683704291552,MMW 11R,A02,205026,Herbst; Matthew,29,0,30,1
1683704292582,MMW 15,A01,193512,Chang; Edmond Yi-Teh,0,8,28,28
1683704292582,MMW 15,A02,193513,Chang; Edmond Yi-Teh,0,5,28,28
1683704292582,MMW 15,A03,193514,Chang; Edmond Yi-Teh,0,5,28,28
1683704292582,MMW 15,A04,193515,Chang; Edmond Yi-Teh,0,5,28,28
1683704292582,MMW 15,A05,193516,Chang; Edmond Yi-Teh,0,5,28,28
1683704292582,MMW 15,A06,193517,Chang; Edmond Yi-Teh,0,6,28,28
1683704292582,MMW 15,B01,193519,Chang; Edmond Yi-Teh,0,5,28,28
1683704292582,MMW 15,B02,193520,Chang; Edmond Yi-Teh,0,5,28,28
1683704292582,MMW 15,B03,193521,Chang; Edmond Yi-Teh,0,5,28,28
1683704292582,MMW 15,B04,193522,Chang; Edmond Yi-Teh,0,6,28,28
1683704292582,MMW 15,B05,193523,Chang; Edmond Yi-Teh,0,5,28,28
1683704292582,MMW 15,B06,193524,Chang; Edmond Yi-Teh,0,5,28,28
1683704293612,MMW 122,A01,193526,Rahimi; Babak,0,16,28,28
1683704293612,MMW 122,A02,193527,Rahimi; Babak,0,15,28,28
1683704293612,MMW 122,A03,193528,Rahimi; Babak,0,0,0,0
1683704293612,MMW 122,A04,193529,Rahimi; Babak,0,0,0,0
1683704294637,MUS 1A,A01,186663,Staff,0,18,35,35
1683704295662,MUS 4,A01,186715,Staff,0,12,35,35
1683704296686,MUS 5R,A01,186796,Dubnov; Shlomo,0,17,35,35
1683704297716,MUS 6,A01,186798,Staff,0,4,25,25
1683704298741,MUS 7,A01,186830,Staff,11,0,35,24
1683704299770,MUS 8,A01,186930,Staff,0,27,35,35
1683704300800,MUS 15,A01,186932,Staff,0,15,35,35
1683704300800,MUS 15,B01,186934,Staff,0,16,35,35
1683704301830,MUS 80,A00,186935,Staff,0,0,20,20
1683704301830,MUS 80,B00,186936,Staff,24,0,25,1
1683704302861,NANO 11,A00,204702,Lipomi; Darren John,0,0,0,0
1683704303889,NANO 15,A01,204709,Yang; Kesong,0,1,0,0
1683704304924,NANO 114,A00,202069,Jahed Motlagh; Zeinab,2,0,10,8
1683704305949,PHIL 1,A00,186955,Grush; Rick Scott,31,0,40,9
1683704306975,PHIL 10,A01,186973,Grush; Rick Scott,27,0,35,8
1683704306975,PHIL 10,A02,186974,Grush; Rick Scott,33,0,35,2
1683704308000,PHIL 13,A01,186976,Staff,1,0,35,34
1683704308000,PHIL 13,A02,186977,Staff,16,0,35,19
1683704309024,PHIL 14,A01,186979,Staff,30,0,35,5
1683704309024,PHIL 14,A02,186986,Staff,32,0,35,3
1683704310051,PHIL 28,A01,186988,Staff,16,0,30,14
1683704310051,PHIL 28,A02,186989,Staff,0,0,30,30
1683704310051,PHIL 28,A03,186990,Staff,10,0,30,20
1683704310051,PHIL 28,A04,186991,Staff,26,0,30,4
1683704311133,PHIL 120,A00,186997,Staff,23,0,40,17
1683704312157,PHIL 137,A00,187003,Staff,7,0,40,33
1683704313184,PHIL 150,A00,187015,Staff,47,0,70,23
1683704314211,PHIL 167,A00,187021,Lamey; Andy M.,34,0,40,6
1683704315238,PHIL 174,A01,202226,Staff,17,0,20,3
1683704315238,PHIL 174,A02,202235,Staff,20,0,20,0
1683704316267,PHIL 191A,A00,258918,Staff,0,0,1,1
1683704317291,PHYS 1A,A00,187028,Staff,26,0,60,34
1683704318317,PHYS 1AL,001,187036,Staff,3,0,30,27
1683704318317,PHYS 1AL,002,187049,Staff,18,0,30,12
1683704319345,PHYS 1B,A00,187058,Staff,21,0,60,39
1683704320369,PHYS 1BL,001,187064,Staff,0,1,30,30
1683704320369,PHYS 1BL,002,187070,Staff,4,0,30,26
1683704321395,PHYS 1C,A00,187082,Staff,30,0,120,90
1683704322425,PHYS 1CL,001,187088,Staff,0,9,30,30
1683704322425,PHYS 1CL,002,187089,Staff,0,1,30,30
1683704322425,PHYS 1CL,009,262693,Staff,9,0,30,21
1683704323450,PHYS 2B,A01,187097,Staff,55,0,115,60
1683704324478,PHYS 2C,A01,187099,Staff,63,0,115,52
1683704325502,PHYS 2CL,A01,187101,Staff,5,0,28,23
1683704325502,PHYS 2CL,A02,187102,Staff,15,0,28,13
1683704326529,PHYS 2D,A01,187123,Shotwell; Brian,95,0,115,20
1683704327555,PHYS 4B,A01,187133,Grinstein; Benjamin,35,0,50,15
1683704328585,POLI 10,A00,188819,Staff,0,4,50,50
1683704329610,POLI 11,A00,188827,Staff,43,0,50,7
1683704330637,POLI 13R,A00,188828,Staff,0,1,20,20
1683704331664,POLI 27,A01,188830,Elgin; Samuel Zincke,0,2,70,70
1683704332689,POLI 30,A00,188832,Desposato; Scott,30,0,50,20
1683704333714,POLI 102F,A00,188834,Staff,1,0,40,39
1683704334738,POLI 104A,A00,188852,Staff,12,0,30,18
1683704335762,POLI 104I,A00,188853,Staff,0,8,20,20
1683704336791,POLI 110B,A00,188854,Wiens; David,6,0,20,14
1683704337816,POLI 112A,A00,188855,Wiens; David,3,0,30,27
1683704338844,POLI 117R,A00,188856,Forman; Fonna,0,12,20,20
1683704339869,POLI 118,A00,188857,Ingham; Sean,8,0,20,12
1683704340895,POLI 120G,A00,188858,Staff,7,0,30,23
1683704341924,POLI 131CR,A00,188863,Hoston; Germaine,20,0,50,30
1683704342948,POLI 133,A00,188864,Nellis; Gareth Hb,44,0,50,6
1683704343973,POLI 134D,A00,188865,Desposato; Scott,27,0,30,3
1683704345006,POLI 142A,A00,188871,Gartzke; Erik,21,0,50,29
1683704346031,POLI 142K,A00,188874,Staff,38,0,50,12
1683704347058,POLI 143,A00,188940,Gartzke; Erik,15,0,30,15
1683704348087,POLI 153,A00,188943,Staff,1,0,20,19
1683704349115,POLI 160AA,A00,188944,Staff,10,0,40,30
1683704350141,POLI 170A,A00,188945,Staff,10,0,30,20
1683704352197,PSYC 1,A00,188952,Staff,36,0,90,54
1683704353221,PSYC 2,B00,188953,Staff,19,0,35,16
1683704354250,PSYC 6,A00,188970,Staff,47,0,60,13
1683704355275,PSYC 7,A00,188973,Staff,35,0,45,10
1683704356302,PSYC 60,A01,188980,Rickard; Timothy C.,42,0,60,18
1683704357332,PSYC 70,A01,189001,Steiner; Eric Tomas,22,0,45,23
1683704358358,PSYC 100,A00,189005,Lacefield; Katharine I,1,98,120,119
1683704359385,PSYC 102,A00,189008,Staff,6,0,30,24
1683704360411,PSYC 106,B00,189026,Gorman; Michael R.,27,0,60,33
1683704361442,PSYC 114,B01,189033,Winkielman; Piotr,0,31,30,30
1683704362468,PSYC 131,A00,189036,Anagnostaras; Stephan,0,44,60,60
1683704363498,PSYC 136,A00,189041,Lowe; Angela Beth,0,7,25,25
1683704364525,PSYC 137,A00,189057,Winkielman; Piotr,0,36,25,25
1683704365555,PSYC 144,A00,189107,Wixted; John T,0,11,50,50
1683704367605,PSYC 162,A00,189142,Staff,0,9,85,85
1683704368631,PSYC 172,A00,189144,Gorman; Michael R.,0,6,30,30
1683704370684,PSYC 179,A00,189146,Lacefield; Katharine I,0,88,120,120
1683704371712,PSYC 181,A00,189147,Anagnostaras; Stephan,0,45,90,90
1683704372737,PSYC 190R,A00,189148,Barner; David A.,0,23,80,80
1683704373763,PSYC 191,A00,189275,Rickard; Timothy C.,0,11,25,25
1683704374790,PSYC 193,A00,189276,Chapman; Eddie Nathaniel,0,1,0,4
1683704375816,PSYC 193L,A01,189281,Lowe; Angela Beth,8,0,20,12
1683704375816,PSYC 193L,B01,189285,Staff,28,0,35,7
1683704376842,RELI 149,A00,187137,Rahimi; Babak,6,0,40,34
1683704377868,SE 9,A01,187315,Staff,0,2,18,18
1683704378895,SE 101B,A00,187409,Staff,24,0,30,6
1683704379921,SE 110B,A00,187444,Staff,10,0,40,30
1683704380951,SE 130B,A00,187449,Staff,31,0,40,9
1683704381976,SE 150A,A00,187516,Staff,8,0,20,12
1683704383001,SE 154,A00,187528,Staff,29,0,50,21
1683704384033,SIO 3,A01,258171,Staff,35,0,40,5
1683704385060,SIO 10,A00,187144,Cook; Geoffrey W,0,6,75,75
1683704386087,SIO 45,A00,187152,Cook; Geoffrey W,1,7,100,99
1683704387115,SIO 109R,A00,194486,Staff,0,4,20,20
1683704389163,SIO 187,A01,187233,Kacev; David,12,0,40,28
1683704390199,SOCI 1,A01,258656,Thorpe; Charles Robert,28,0,30,2
1683704390199,SOCI 1,A02,258658,Thorpe; Charles Robert,30,0,30,0
1683704390199,SOCI 1,A03,258661,Thorpe; Charles Robert,25,0,25,0
1683704390199,SOCI 1,A04,258666,Thorpe; Charles Robert,22,0,25,3
1683704390199,SOCI 1,A05,258897,Thorpe; Charles Robert,22,0,25,3
1683704390199,SOCI 1,A06,258898,Thorpe; Charles Robert,25,0,25,0
1683704391225,SOCI 30,A01,258903,Pardo Guerra; Juan Pablo,14,0,30,16
1683704392249,SOCI 102,A00,258904,Staff,9,0,25,16
1683704393278,SOCI 106,A00,258905,Staff,19,0,25,6
1683704394307,SOCI 111,A00,258907,Ribas Norris; Janet Vanesa,26,0,30,4
1683704395332,SOCI 121R,A00,258908,Pardo Guerra; Juan Pablo,7,0,30,23
1683704396358,SOCI 126,A01,203330,Staff,14,0,20,6
1683704397386,SOCI 131,A00,258909,Thorpe; Charles Robert,30,0,60,30
1683704398416,SOCI 135,A00,258910,Payne; Christine Anna,0,13,30,30
1683704399444,SOCI 157,A00,258911,Staff,10,0,30,20
1683704400469,SOCI 184,A00,258912,Staff,25,0,30,5
1683704401492,SOCI 188D,A00,258913,Staff,22,0,30,8
1683704402535,SYN 2,001,187529,Staff,9,0,16,7
1683704402535,SYN 2,002,201452,Staff,0,20,16,16
1683704402535,SYN 2,003,201469,Staff,1,0,16,15
1683704403564,SYN 100,A01,187531,Staff,0,9,20,20
1683704403564,SYN 100,B01,201491,Staff,0,10,20,20
1683704404590,TDAC 1,A00,189286,Walsh; Kim C.,3,0,20,17
1683704404590,TDAC 1,B00,189287,Harting; Carla Kelso,10,0,20,10
1683704405615,TDAC 101,A00,189300,Walsh; Kim C.,16,0,20,4
1683704405615,TDAC 101,B00,189301,Harting; Carla Kelso,18,0,20,2
1683704406647,TDAC 102,A00,189304,Basso; Beatrice,14,0,20,6
1683704407673,TDAC 108,A00,189305,Staff,18,0,20,2
1683704408701,TDDE 131,A00,189310,Staff,19,0,20,1
1683704408701,TDDE 131,B00,189314,Staff,19,0,20,1
1683704408701,TDDE 131,C00,189315,Staff,48,0,50,2
1683704408701,TDDE 131,D00,189316,Staff,14,0,15,1
1683704408701,TDDE 131,E00,204841,Staff,20,0,20,0
1683704409730,TDGE 10,A00,189289,Staff,27,0,50,23
1683704409730,TDGE 10,B00,189290,Havis; Allan,0,1,50,50
1683704410757,TDGE 11,A00,189291,Fulton; Julia,0,4,50,50
1683704410757,TDGE 11,B00,189292,Staff,20,0,25,5
1683704410757,TDGE 11,C00,260270,Staff,0,0,0,0
1683704411782,TDGE 25,A00,189294,Staff,1,0,20,19
1683704412811,TDGE 124,A00,189318,Fulton; Julia,0,7,50,50
1683704413840,TDGE 125,A00,189319,Staff,13,0,25,12
1683704413840,TDGE 125,B00,189320,Staff,23,0,25,2
1683704414925,TDGE 127,A00,189322,Havis; Allan,1,0,50,49
1683704415950,TDHT 101,A00,189323,Staff,18,0,25,7
1683704415950,TDHT 101,B00,189324,Staff,25,0,25,0
1683704416979,TDHT 102,A00,189325,Staff,49,0,50,1
1683704418012,TDMV 1,A00,189295,Arcidiacono; Kristin,20,0,30,10
1683704418012,TDMV 1,B00,189296,Caligagan; Maria T.,23,0,30,7
1683704419038,TDMV 2,A00,189297,Sammartano; Tonnie,27,0,30,3
1683704419038,TDMV 2,B00,189299,Arcidiacono; Kristin,23,0,30,7
1683704420068,TDMV 3,A00,204998,Rincon; Alicia,22,0,30,8
1683704421093,TDMV 120,A00,189458,Sammartano; Tonnie,28,0,30,2
1683704422119,TDMV 138,A00,189541,Jun; Grace Shin Hae,20,0,40,20
1683704423144,TDMV 142,A00,189717,Caligagan; Tony,25,0,30,5
1683704423144,TDMV 142,B00,189718,Caligagan; Maria T.,25,0,30,5
1683704424169,TMC 2,A01,187533,Staff,25,0,25,0
1683704424169,TMC 2,A02,187534,Staff,25,0,25,0
1683704425195,USP 1,A01,187536,Kwak; Nancy,0,16,25,25
1683704426221,USP 5,A01,187538,Staff,8,0,25,17
1683704427250,USP 101,A00,199253,Staff,0,4,0,0
1683704428382,USP 124,A00,187562,Boomhower; Matthew Charles,0,0,30,30
1683704429417,USP 138,A00,187582,Staff,19,0,25,6
1683704430480,USP 152,A01,187597,Staff,3,0,25,22
1683704431504,USP 153,A00,187598,Staff,18,0,25,7
1683704432607,USP 168,A00,187607,Kwak; Nancy,2,0,5,3
1683704433636,USP 173,A00,187619,Staff,4,0,25,21
1683704434660,USP 181,A00,187638,Staff,0,4,25,25
1683704435690,VIS 103,A00,187650,Cruz; Edwin Teddy,17,0,75,58
1683704436715,VIS 110D,A00,187669,Staff,13,0,22,9
1683704437739,VIS 127C,A00,187720,Shen; Kuiyi,67,0,146,79
1683704438770,VIS 149,A00,187731,Yoldas; Pinar,0,12,22,22
1683704439797,VIS 151,A01,188091,Staff,22,0,34,12
1683704439797,VIS 151,A02,188092,Staff,11,0,34,23
1683704440823,VIS 160B,A00,188093,Stalbaum; Brett,0,1,10,10
1683704442877,WCWP 10B,A00,201720,Staff,0,0,5,5
1683704442877,WCWP 10B,B00,201722,Staff,0,0,6,6
1683704443907,WCWP 100,A00,201725,Gagnon; Jeffrey C,0,0,2,2
1683704443907,WCWP 100,B00,201727,Staff,0,4,15,15
1683704447146,ANBI 133,A00,258401,Wilder; Linnea Lorene,34,0,40,6
1683704448188,ANBI 140,A00,258395,Hrvoj Mihic; Branka,18,0,25,7
1683704449214,ANSC 120,A00,258402,Bialecki; Jon Anthony,26,0,40,14
1683704450243,ANSC 144,A00,258400,Staff,12,0,40,28
1683704452296,ANSC 166,A00,258396,Parish; Steven Martin,156,0,175,19
1683704453325,ANSC 180,A00,193533,Staff,8,0,20,12
1683704454354,ANSC 188,A00,258397,Jassal; Aftab,34,0,40,6
1683704455377,ANTH 3,A01,258316,Staff,23,0,30,7
1683704456407,ANTH 5,A00,258394,Semendeferi; Ekaterini,16,0,20,4
1683704457432,ANTH 21,A01,258331,Staff,4,0,40,36
1683704458457,ANTH 103,A00,258398,Varma; Saiba,15,0,25,10
1683704459493,AWP 10,001,202034,Staff,0,0,0,0
1683704459493,AWP 10,002,202035,Staff,0,0,0,0
1683704459493,AWP 10,003,202036,Staff,0,0,0,0
1683704459493,AWP 10,004,202037,Staff,0,0,0,0
1683704459493,AWP 10,005,202038,Staff,0,0,0,0
1683704459493,AWP 10,006,202039,Staff,0,0,0,0
1683704459493,AWP 10,007,202040,Staff,0,0,0,0
1683704459493,AWP 10,008,202041,Staff,0,0,0,0
1683704459493,AWP 10,009,202042,Staff,0,0,0,0
1683704459493,AWP 10,010,202043,Staff,0,0,0,0
1683704459493,AWP 10,011,202044,Staff,0,0,0,0
1683704459493,AWP 10,012,202045,Staff,0,0,0,0
1683704459493,AWP 10,013,202046,Staff,0,0,0,0
1683704459493,AWP 10,014,202047,Staff,0,0,0,0
1683704459493,AWP 10,015,202048,Staff,0,0,0,0
1683704459493,AWP 10,016,202049,Staff,0,0,0,0
1683704459493,AWP 10,017,202050,Staff,0,0,0,0
1683704459493,AWP 10,018,202051,Staff,0,0,0,0
1683704459493,AWP 10,019,202052,Staff,0,0,0,0
1683704459493,AWP 10,020,202053,Staff,0,0,0,0
1683704459493,AWP 10,021,202054,Staff,0,0,0,0
1683704459493,AWP 10,022,202055,Staff,0,0,0,0
1683704459493,AWP 10,023,202056,Staff,0,0,0,0
1683704459493,AWP 10,024,202057,Staff,0,0,0,0
1683704459493,AWP 10,025,202058,Staff,0,0,0,0
1683704459493,AWP 10,026,202059,Staff,0,0,0,0
1683704460518,AWP 102,001,202032,Staff,0,0,0,0
1683704460518,AWP 102,002,202033,Staff,0,0,0,0
1683704461544,BENG 100,A01,254234,Taylor Amos; Alyssa C,31,0,40,9
1683704462591,BENG 196,001,270013,Engler; Adam J.,9999,0,9999,0
1683704463618,BICD 100R,A01,202018,Smith; Laurie,0,7,32,32
1683704463618,BICD 100R,A02,202019,Smith; Laurie,0,3,32,32
1683704463618,BICD 100R,A03,202020,Smith; Laurie,0,1,32,32
1683704463618,BICD 100R,A04,202021,Smith; Laurie,6,0,32,26
1683704463618,BICD 100R,A05,202022,Smith; Laurie,10,0,32,22
1683704464653,BICD 136,A01,193242,Gustafson-Brown; Cindy,0,2,32,32
1683704464653,BICD 136,A02,193244,Gustafson-Brown; Cindy,13,0,32,19
1683704465682,BIEB 102,A01,193249,Butler; Shannon Rhey,0,0,32,32
1683704465682,BIEB 102,A02,193251,Butler; Shannon Rhey,0,0,32,32
1683704465682,BIEB 102,A03,193253,Butler; Shannon Rhey,0,0,32,32
1683704465682,BIEB 102,A04,193255,Butler; Shannon Rhey,13,0,32,19
1683704465682,BIEB 102,A05,193265,Butler; Shannon Rhey,25,0,32,7
1683704465682,BIEB 102,A06,193269,Butler; Shannon Rhey,12,0,32,20
1683704467735,BIEB 150,A01,193274,Staff,0,0,32,32
1683704467735,BIEB 150,A02,193285,Staff,24,0,32,8
1683704468761,BIEB 194,A00,193286,Kurle; Carolyn M.,19,0,32,13
1683704469788,BILD 1,A01,192291,Staff,15,0,32,17
1683704469788,BILD 1,A02,192292,Staff,30,0,32,2
1683704469788,BILD 1,B01,192520,Reuther; Keefe,0,1,0,0
1683704469788,BILD 1,B02,192532,Reuther; Keefe,0,1,0,0
1683704470838,BILD 3,A01,192556,Butler; Shannon Rhey,0,0,32,32
1683704470838,BILD 3,A02,192581,Butler; Shannon Rhey,0,1,32,32
1683704470838,BILD 3,A03,192611,Butler; Shannon Rhey,19,0,32,13
1683704470838,BILD 3,A04,192612,Butler; Shannon Rhey,23,0,32,9
1683704470838,BILD 3,A05,192613,Butler; Shannon Rhey,26,0,32,6
1683704470838,BILD 3,A06,192679,Butler; Shannon Rhey,27,0,32,5
1683704470838,BILD 3,A07,192682,Butler; Shannon Rhey,20,0,32,12
1683704471864,BILD 4,A01,192836,Reuther; Keefe,1,0,24,23
1683704471864,BILD 4,A02,193044,Reuther; Keefe,4,0,24,20
1683704472888,BILD 10,A01,193142,Gustafson-Brown; Cindy,29,0,32,3
1683704472888,BILD 10,A02,193149,Gustafson-Brown; Cindy,31,0,32,1
1683704473917,BIMM 100,A01,193301,Staff,0,6,32,32
1683704473917,BIMM 100,A02,193312,Staff,0,7,32,32
1683704473917,BIMM 100,A03,193323,Staff,0,10,32,32
1683704474944,BIMM 101,A01,193329,McDonnell; Lisa Marie,0,3,24,24
1683704474944,BIMM 101,A02,193339,McDonnell; Lisa Marie,0,3,24,24
1683704474944,BIMM 101,B01,193354,McDonnell; Lisa Marie,0,4,24,24
1683704474944,BIMM 101,B02,193357,McDonnell; Lisa Marie,0,3,24,24
1683704475977,BIMM 110,A01,193377,Tat; John,0,11,32,32
1683704475977,BIMM 110,A02,193378,Tat; John,0,11,32,32
1683704477013,BIMM 120,A01,206116,Staff,0,0,32,32
1683704477013,BIMM 120,A02,206117,Staff,7,0,32,25
1683704477013,BIMM 120,A03,206121,Staff,21,0,32,11
1683704478039,BIPN 100,A01,193393,Park; Ji Young,0,15,32,32
1683704478039,BIPN 100,A02,193402,Park; Ji Young,0,14,32,32
1683704478039,BIPN 100,A03,193413,Park; Ji Young,0,14,32,32
1683704478039,BIPN 100,A04,193414,Park; Ji Young,0,13,32,32
1683704479068,BIPN 102,A01,193429,Staff,0,0,32,32
1683704479068,BIPN 102,A02,193438,Staff,18,0,32,14
1683704480097,BIPN 106,A01,193450,Reyes Gonzalez; Catalina,0,2,40,40
1683704481128,BIPN 134,A01,193465,Cooke; James Edward,0,0,32,32
1683704481128,BIPN 134,A02,193474,Cooke; James Edward,25,0,32,7
1683704481128,BIPN 134,A03,193485,Cooke; James Edward,29,0,32,3
1683704481128,BIPN 134,A04,193486,Cooke; James Edward,20,0,32,12
1683704481128,BIPN 134,A05,193491,Cooke; James Edward,31,0,32,1
1683704481128,BIPN 134,A06,193501,Cooke; James Edward,30,0,32,2
1683704481128,BIPN 134,A07,193510,Cooke; James Edward,29,0,32,3
1683704483183,BISP 194,A00,222522,Staff,14,0,32,18
1683704484207,CAT 124,A01,202407,Staff,19,0,25,6
1683704485232,CAT 125,A00,202408,Marchisotto; Jennifer Anne,2,0,20,18
1683704486264,CAT 125R,A00,202409,Smith; Lauryn Alissa,0,11,20,20
1683704486264,CAT 125R,B00,202410,Morales; Celeste Georgianna,0,11,20,20
1683704486264,CAT 125R,C00,202411,Irwin; Matthew Joseph,0,12,20,20
1683704487295,CENG 15,A01,204712,Yang; Kesong,0,1,0,0
1683704488322,CENG 114,A00,202070,Jahed Motlagh; Zeinab,5,0,20,15
1683704489348,CGS 105,A00,185477,Wesling; Megan E.,24,0,40,16
1683704490375,CGS 106,A00,185494,Staff,11,0,22,11
1683704491400,CGS 108,A00,185495,Staff,14,0,20,6
1683704492424,CGS 114,A00,185496,Staff,13,0,18,5
1683704493450,CGS 119,A00,185501,Staff,15,0,20,5
1683704494479,CGS 120,A00,185511,Staff,11,0,20,9
1683704495506,CHEM 4,A01,184675,Bussey; Thomas J,97,0,100,3
1683704496536,CHEM 6A,A01,184677,Staff,32,0,60,28
1683704497561,CHEM 6B,A01,184679,Staff,63,0,100,37
1683704498586,CHEM 6C,A01,184681,Bussey; Thomas J,0,0,50,50
1683704498586,CHEM 6C,A02,184682,Bussey; Thomas J,32,0,50,18
1683704499612,CHEM 40A,A01,184684,Albizati; Kim F.,33,0,100,67
1683704500638,CHEM 40B,A01,184686,Albizati; Kim F.,0,22,100,100
1683704501664,CHEM 41B,A01,184690,Staff,51,0,100,49
1683704502690,COGS 3,A01,184715,Boyle; Mary E. T.,0,27,40,40
1683704503720,COGS 14B,A01,185172,Staff,0,14,38,38
1683704504749,COGS 18,A01,184736,Staff,14,0,80,66
1683704505775,COGS 100,A01,184932,Staff,0,8,73,73
1683704506807,COGS 101A,A01,184935,Staff,0,40,30,30
1683704507832,COGS 101B,A01,184944,Staff,0,2,30,30
1683704508857,COGS 101C,A01,184946,Staff,0,10,30,30
1683704509883,COGS 102A,A01,184951,Johnson; Christine M.,1,0,40,39
1683704510909,COGS 107B,A01,184953,Mooshagian; Eric Frederick,0,52,40,40
1683704511936,COGS 118B,A01,184959,Gupta; Anjum,0,50,40,40
1683704512961,COGS 153,A00,184961,Staff,1,16,30,29
1683704513987,COGS 177,A00,184962,Staff,0,20,30,30
1683704515017,COGS 187A,A01,184969,Boyle; Mary E. T.,0,19,40,40
1683704516044,COMM 10,A01,185174,Staff,0,5,25,25
1683704516044,COMM 10,A02,185189,Staff,0,2,25,25
1683704516044,COMM 10,A03,269821,Staff,0,1,0,0
1683704517070,COMM 100B,A02,185476,Staff,10,0,25,15
1683704517070,COMM 100B,A03,277340,Staff,25,0,25,0
1683704518096,COMM 100C,A01,185314,Staff,2,0,25,23
1683704518096,COMM 100C,A02,185327,Staff,17,0,25,8
1683704519178,COMM 110M,A00,185349,Staff,0,0,40,40
1683704520203,COMM 113T,A00,185352,Staff,25,0,40,15
1683704521229,COMM 114I,A00,185353,Staff,31,0,40,9
1683704522257,COMM 131,A00,185354,Staff,17,0,30,13
1683704523283,CSE 8A,A50,185358,Cao; Yingjun,0,46,10,10
1683704524313,CSE 8B,A01,185362,Staff,0,48,50,50
1683704525338,CSE 11,A01,185416,Cao; Yingjun,0,91,10,10
1683704526364,CSE 20,A01,185445,Briones; Jor-el Thomas Caparas,3,0,25,22
1683704527393,CSE 21,A01,185447,Staff,9,0,50,41
1683704528422,CSE 101,A01,185451,Staff,0,13,50,50
1683704528422,CSE 101,B01,185453,Jones; Miles E,0,15,50,50
1683704530474,CSE 141,A01,185458,Eldon; John,16,0,100,84
1683704531503,CSE 141L,A01,185461,Eldon; John,8,0,100,92
1683704532529,CSE 142,A01,185463,Staff,34,0,60,26
1683704532529,CSE 142,B01,201355,Staff,0,7,60,60
1683704533555,CSE 142L,A01,185470,Staff,34,0,60,26
1683704533555,CSE 142L,B01,201417,Staff,0,6,60,60
1683704534581,CSE 190,A00,201433,Staff,32,0,49,17
1683704535605,DOC 1,A01,259136,Strom; Megan C.,7,0,15,8
1683704535605,DOC 1,A02,259137,Strom; Megan C.,14,0,15,1
1683704535605,DOC 1,A03,259138,Strom; Megan C.,14,0,15,1
1683704535605,DOC 1,A04,259139,Strom; Megan C.,14,0,15,1
1683704536635,DOC 100D,A00,259140,Pass; Natalye Joann,14,0,25,11
1683704537663,DSGN 1,A01,184749,Rill; Bryan,0,26,30,30
1683704538688,DSGN 100,A01,185168,Staff,0,2,25,25
1683704539719,ECE 5,A01,185626,Morris; Karcher William,0,12,0,0
1683704540747,ECE 101,A01,185628,Staff,14,0,70,56
1683704541773,ECE 107,A01,185635,Baghdadchi; Saharnaz,0,0,20,20
1683704541773,ECE 107,A02,185638,Baghdadchi; Saharnaz,1,0,20,19
1683704542801,ECE 148,A01,185647,Silberman; Jack,0,0,16,16
1683704543840,ECON 1,A01,185537,Crane; Meredith Helen,54,0,70,16
1683704544866,ECON 3,A01,185549,Crane; Meredith Helen,30,0,70,40
1683704545892,ECON 4,A01,203354,Anderson; John Charles,0,5,10,10
1683704546920,ECON 100A,A01,185574,Staff,0,5,40,40
1683704547946,ECON 100B,A01,185576,Staff,0,12,50,50
1683704548980,ECON 100C,A01,185589,Newhouse; Herbert S,30,0,70,40
1683704550006,ECON 105,A00,185608,Vespa; Emanuel Ignacio,19,0,35,16
1683704551033,ECON 109,A01,185610,Shishkin; Denis,9,0,35,26
1683704552059,ECON 110A,A01,185612,Staff,8,0,40,32
1683704553087,ECON 120A,A01,185615,Staff,19,0,40,21
1683704554113,ECON 120C,A01,185617,Sun; Yixiao,0,21,70,70
1683704555144,ECON 144,A00,203346,Squires; Dale E,2,0,35,33
1683704556171,ECON 171,A01,203349,Newhouse; Herbert S,0,1,35,35
1683704557198,ECON 173A,A01,185621,Toda; Alexis Akira,21,0,35,14
1683704558227,EDS 25,A01,202413,Staff,0,1,0,0
1683704558227,EDS 25,A02,202414,Staff,0,1,0,0
1683704558227,EDS 25,A03,202415,Staff,0,0,0,0
1683704558227,EDS 25,A04,202416,Staff,0,1,0,0
1683704558227,EDS 25,A05,202439,Staff,0,0,0,0
1683704558227,EDS 25,A06,202440,Staff,0,0,0,0
1683704558227,EDS 25,B01,202631,Staff,0,0,0,0
1683704558227,EDS 25,B02,202632,Staff,0,0,0,0
1683704558227,EDS 25,B03,202639,Staff,0,0,0,0
1683704558227,EDS 25,B04,202640,Staff,0,0,0,0
1683704558227,EDS 25,B05,202643,Staff,0,0,0,0
1683704558227,EDS 25,B06,202644,Staff,0,0,0,0
1683704559252,EDS 38,A01,202659,Black; Alison Michelle,25,0,25,0
1683704560278,EDS 115,A00,202652,Staff,18,0,30,12
1683704561304,EDS 125,A00,202649,Staff,13,0,30,17
1683704562332,EDS 126,A01,203332,Staff,30,0,30,0
1683704563359,EDS 139,A00,202838,Staff,16,0,25,9
1683704564384,EDS 146,A01,202655,Staff,14,0,25,11
1683704565410,ENG 15,A00,185667,Staff,0,1,0,0
1683704565410,ENG 15,B00,185672,Staff,0,0,0,0
1683704565410,ENG 15,C00,185675,Staff,0,0,0,0
1683704565410,ENG 15,D00,185682,Staff,0,0,0,0
1683704565410,ENG 15,E00,185684,Staff,0,0,0,0
1683704566436,ETHN 103,A00,185710,Staff,0,8,35,35
1683704567461,ETHN 103A,A00,199228,Man; Simeon S,0,0,9,9
1683704568486,ETHN 109,A00,185711,Staff,15,0,35,20
1683704569516,ETHN 142,A00,185726,Staff,0,4,30,30
1683704570542,ETHN 163J,A00,199229,Man; Simeon S,5,0,8,3
1683704571568,ETHN 168,A00,185727,Staff,7,0,10,3
1683704572616,ETHN 182,A00,185728,Staff,0,0,35,35
1683704573643,ETHN 183,A00,185737,Staff,9,0,18,9
1683704574672,GLBH 111,A01,209361,Burgos; Jose L.,0,0,0,0
1683704576722,HIEU 104,A00,185792,Staff,14,0,20,6
1683704577750,HIEU 115,A00,185800,Staff,0,0,20,20
1683704578777,HIEU 128,A00,185801,Staff,0,9,20,20
1683704579802,HIEU 147,A00,185802,Staff,15,0,20,5
1683704580830,HIEU 154,A00,185823,Staff,11,0,20,9
1683704581857,HILA 102,A00,185826,Staff,14,0,20,6
1683704582883,HILD 2C,A01,185778,Staff,0,13,20,20
1683704583909,HILD 7B,A01,185780,Kwak; Nancy,0,17,32,32
1683704583909,HILD 7B,A02,185781,Kwak; Nancy,0,18,32,32
1683704584938,HILD 30,A01,185791,Staff,12,0,20,8
1683704585963,HISC 119,A00,185830,Golan; Tal,0,10,20,20
1683704586988,HITO 156GS,A00,185831,Patterson; Patrick H.,0,0,0,23
1683704588013,HIUS 103,A00,185832,Man; Simeon S,0,4,20,20
1683704589036,HIUS 117,A00,185836,Kwak; Nancy,2,0,20,18
1683704590071,HIUS 125,A00,185840,Man; Simeon S,0,2,23,23
1683704591098,HIUS 149,A00,185845,Staff,1,0,20,19
1683704592123,HUM 3,A01,185882,Zavodny; Tatiana Sophia,0,8,50,50
1683704592123,HUM 3,B01,185899,Caldwell; Michael Alan,0,18,50,50
1683704593149,HUM 3GS,A00,185900,Patterson; Patrick H.,0,0,0,23
1683704594184,HUM 4,A01,185938,Zroka; Amy Liane,28,0,50,22
1683704594184,HUM 4,B01,185956,Watkins; Eric,0,6,50,50
1683704594184,HUM 4,B02,202209,Watkins; Eric,0,5,50,50
1683704594184,HUM 4,B03,202210,Watkins; Eric,0,5,50,50
1683704595209,HUM 5,A01,185958,West; Geoffrey Scott,0,0,50,50
1683704595209,HUM 5,A02,202215,West; Geoffrey Scott,0,1,50,50
1683704596235,INTL 190,A00,185959,Gagnon; Jeffrey C,0,0,0,9
1683704596235,INTL 190,B00,185960,Lettieri; Michael Joseph,0,0,0,2
1683704597261,JAPN 180,A00,254509,Staff,5,0,30,25
1683704598294,LATI 10,A01,202853,Kennemore; Amy Michelle,4,0,35,31
1683704598294,LATI 10,A02,202854,Kennemore; Amy Michelle,3,0,35,32
1683704598294,LATI 10,A03,270054,Kennemore; Amy Michelle,30,0,30,0
1683704599320,LATI 180,A00,202855,Kennemore; Amy Michelle,11,0,20,9
1683704600345,LAWS 101,A00,201767,Golan; Tal,0,7,40,40
1683704601369,LIFR 1C,A00,185961,Staff,6,0,20,14
1683704602394,LIFR 1CX,A00,185962,Staff,7,0,20,13
1683704603422,LIFR 1D,A00,185963,Staff,7,0,20,13
1683704604450,LIFR 1DX,A00,185964,Staff,7,0,20,13
1683704605476,LIGN 101,A01,186039,Staff,43,0,50,7
1683704606504,LIGN 165,A00,186040,Staff,14,0,50,36
1683704607533,LTCS 108,A00,186041,Staff,5,0,10,5
1683704608557,LTCS 119,A00,186042,Staff,15,0,20,5
1683704609584,LTCS 130,A00,186043,Wesling; Megan E.,15,0,25,10
1683704611635,LTEA 138,A00,186119,Staff,14,0,40,26
1683704612659,LTEN 124,A00,186148,Staff,5,0,25,20
1683704613687,LTEN 178,A00,186149,Staff,6,0,15,9
1683704614712,LTEN 181,A00,186150,Blanco; John D,34,0,40,6
1683704615740,LTWL 120,A00,186160,Staff,19,0,25,6
1683704616765,LTWL 165,A00,186161,Staff,22,0,25,3
1683704617793,LTWR 100,A00,186162,Staff,0,5,15,15
1683704618825,LTWR 102,A00,186163,Doller; Ben,5,0,15,10
1683704619852,MAE 8,A01,186412,Staff,0,1,0,0
1683704620880,MAE 30B,A00,186445,Bahadori; Mohammad Yousef,81,0,100,19
1683704621910,MAE 40,A00,186592,Bewley; Thomas R,10,0,50,40
1683704623015,MAE 101B,A00,186593,Bahadori; Mohammad Yousef,80,0,100,20
1683704624045,MAE 105,A00,186594,Bandaru; Prabhakar,10,0,50,40
1683704625071,MAE 107,A00,186599,Pham; Hieu Tan,0,8,120,120
1683704626096,MAE 148,A01,186660,Silberman; Jack,3,0,16,13
1683704627121,MATH 10A,A01,188095,Staff,0,6,35,35
1683704628148,MATH 10B,A01,188097,Bowers; Adam R.,0,12,30,30
1683704628148,MATH 10B,A02,188099,Bowers; Adam R.,0,11,30,30
1683704628148,MATH 10B,B01,188104,Bowers; Adam R.,0,10,30,30
1683704628148,MATH 10B,B02,188106,Bowers; Adam R.,0,9,30,30
1683704629173,MATH 10C,A01,188111,Staff,0,20,30,30
1683704629173,MATH 10C,A02,188127,Staff,0,19,30,30
1683704629173,MATH 10C,A03,188131,Staff,0,19,30,30
1683704629173,MATH 10C,B01,188218,Staff,17,0,30,13
1683704629173,MATH 10C,B02,188244,Staff,13,0,30,17
1683704629173,MATH 10C,B03,188277,Staff,14,0,30,16
1683704630200,MATH 18,A01,188344,Bach; Quang Tran,18,0,30,12
1683704630200,MATH 18,A02,188345,Bach; Quang Tran,11,0,30,19
1683704630200,MATH 18,B01,188353,Bach; Quang Tran,11,0,30,19
1683704630200,MATH 18,B02,188354,Bach; Quang Tran,19,0,30,11
1683704631224,MATH 20A,A01,188374,Staff,11,0,35,24
1683704632249,MATH 20B,A01,188382,Ohm; Ko Woon,7,0,30,23
1683704632249,MATH 20B,A02,188383,Ohm; Ko Woon,22,0,30,8
1683704632249,MATH 20B,B01,188385,Ohm; Ko Woon,7,0,30,23
1683704632249,MATH 20B,B02,188392,Ohm; Ko Woon,22,0,30,8
1683704633280,MATH 20C,A01,188394,Harel; Guershon,10,0,30,20
1683704633280,MATH 20C,A02,188395,Harel; Guershon,13,0,30,17
1683704633280,MATH 20C,B01,188404,Harel; Guershon,5,0,30,25
1683704633280,MATH 20C,B02,188405,Harel; Guershon,18,0,30,12
1683704634306,MATH 20D,A01,188414,Hammock; Frances H,0,1,30,30
1683704634306,MATH 20D,A02,188415,Hammock; Frances H,0,1,30,30
1683704634306,MATH 20D,B01,188447,Hammock; Frances H,0,1,30,30
1683704634306,MATH 20D,B02,188486,Hammock; Frances H,2,0,30,28
1683704635332,MATH 20E,A01,188649,Staff,21,0,30,9
1683704635332,MATH 20E,A02,188650,Staff,20,0,30,10
1683704635332,MATH 20E,A03,188673,Staff,0,0,30,30
1683704636357,MATH 102,A01,188675,Staff,0,40,35,35
1683704637386,MATH 103B,A01,188681,Staff,3,0,35,32
1683704637386,MATH 103B,B01,188692,Staff,5,0,35,30
1683704638416,MATH 109,A01,188695,Salehi Golsefidy; Alireza,24,0,35,11
1683704638416,MATH 109,A02,188696,Salehi Golsefidy; Alireza,25,0,35,10
1683704639440,MATH 120A,A01,188698,Eggers; John Dietrich,7,0,35,28
1683704640469,MATH 142B,A01,188736,Ioana; Adrian,0,0,30,30
1683704640469,MATH 142B,A02,188741,Ioana; Adrian,0,1,30,30
1683704640469,MATH 142B,A03,188743,Ioana; Adrian,0,2,30,30
1683704641493,MATH 168A,A01,188790,Staff,0,11,35,35
1683704642520,MATH 170A,A01,188803,Nie; Jiawang,0,2,35,35
1683704642520,MATH 170A,A02,188811,Nie; Jiawang,0,1,35,35
1683704642520,MATH 170A,A03,188814,Nie; Jiawang,0,0,35,35
1683704642520,MATH 170A,A04,188815,Nie; Jiawang,5,0,35,30
1683704643550,MATH 193B,A01,188817,Staff,0,0,35,35
1683704643550,MATH 193B,A02,188818,Staff,6,0,35,29
1683704644586,MGT 4,A01,202857,Anderson; John Charles,59,0,80,21
1683704645617,MGT 12,A00,202858,Lindenberger; Wade Douglas,40,0,90,50
1683704646644,MGT 18,A00,202859,Staff,73,0,90,17
1683704647673,MGT 18GS,A00,202860,McKay; Michael J,13,0,28,15
1683704648698,MGT 45,A00,202861,Pecore; Joseph P.,8,0,90,82
1683704649724,MGT 100,A00,202863,Yavorsky; Daniel Ryan,27,0,90,63
1683704650749,MGT 103,A00,202864,Ehrich; Kristine R,0,19,90,90
1683704651780,MGT 112,A00,202865,Ehrich; Kristine R,15,0,90,75
1683704652808,MGT 121A,A00,202868,Staff,70,0,90,20
1683704653834,MGT 131B,A00,202869,Anderson; John Charles,58,0,90,32
1683704654861,MGT 136,A00,202871,Lindenberger; Wade Douglas,83,0,90,7
1683704655890,MGT 164,A00,202873,Staff,0,67,90,91
1683704656915,MGT 164GS,A00,202874,McKay; Mary A,13,0,28,15
1683704657940,MGT 180,A00,202875,Staff,0,51,90,91
1683704658969,MMW 11R,A01,205019,Herbst; Matthew,0,0,30,30
1683704658969,MMW 11R,A02,205026,Herbst; Matthew,29,0,30,1
1683704659997,MMW 15,A01,193512,Chang; Edmond Yi-Teh,0,8,28,28
1683704659997,MMW 15,A02,193513,Chang; Edmond Yi-Teh,0,5,28,28
1683704659997,MMW 15,A03,193514,Chang; Edmond Yi-Teh,0,5,28,28
1683704659997,MMW 15,A04,193515,Chang; Edmond Yi-Teh,0,5,28,28
1683704659997,MMW 15,A05,193516,Chang; Edmond Yi-Teh,0,5,28,28
1683704659997,MMW 15,A06,193517,Chang; Edmond Yi-Teh,0,6,28,28
1683704659997,MMW 15,B01,193519,Chang; Edmond Yi-Teh,0,5,28,28
1683704659997,MMW 15,B02,193520,Chang; Edmond Yi-Teh,0,5,28,28
1683704659997,MMW 15,B03,193521,Chang; Edmond Yi-Teh,0,5,28,28
1683704659997,MMW 15,B04,193522,Chang; Edmond Yi-Teh,0,6,28,28
1683704659997,MMW 15,B05,193523,Chang; Edmond Yi-Teh,0,5,28,28
1683704659997,MMW 15,B06,193524,Chang; Edmond Yi-Teh,0,5,28,28
1683704661023,MMW 122,A01,193526,Rahimi; Babak,0,16,28,28
1683704661023,MMW 122,A02,193527,Rahimi; Babak,0,15,28,28
1683704661023,MMW 122,A03,193528,Rahimi; Babak,0,0,0,0
1683704661023,MMW 122,A04,193529,Rahimi; Babak,0,0,0,0
1683704662054,MUS 1A,A01,186663,Staff,0,18,35,35
1683704663078,MUS 4,A01,186715,Staff,0,12,35,35
1683704664104,MUS 5R,A01,186796,Dubnov; Shlomo,0,17,35,35
1683704665129,MUS 6,A01,186798,Staff,0,4,25,25
1683704666154,MUS 7,A01,186830,Staff,11,0,35,24
1683704667182,MUS 8,A01,186930,Staff,0,27,35,35
1683704668205,MUS 15,A01,186932,Staff,0,15,35,35
1683704668205,MUS 15,B01,186934,Staff,0,16,35,35
1683704669230,MUS 80,A00,186935,Staff,0,0,20,20
1683704669230,MUS 80,B00,186936,Staff,24,0,25,1
1683704670259,NANO 11,A00,204702,Lipomi; Darren John,0,0,0,0
1683704671296,NANO 15,A01,204709,Yang; Kesong,0,1,0,0
1683704672322,NANO 114,A00,202069,Jahed Motlagh; Zeinab,2,0,10,8
1683704673349,PHIL 1,A00,186955,Grush; Rick Scott,31,0,40,9
1683704674373,PHIL 10,A01,186973,Grush; Rick Scott,27,0,35,8
1683704674373,PHIL 10,A02,186974,Grush; Rick Scott,33,0,35,2
1683704675398,PHIL 13,A01,186976,Staff,1,0,35,34
1683704675398,PHIL 13,A02,186977,Staff,16,0,35,19
1683704676423,PHIL 14,A01,186979,Staff,30,0,35,5
1683704676423,PHIL 14,A02,186986,Staff,32,0,35,3
1683704677450,PHIL 28,A01,186988,Staff,16,0,30,14
1683704677450,PHIL 28,A02,186989,Staff,0,0,30,30
1683704677450,PHIL 28,A03,186990,Staff,10,0,30,20
1683704677450,PHIL 28,A04,186991,Staff,26,0,30,4
1683704678479,PHIL 120,A00,186997,Staff,23,0,40,17
1683704679507,PHIL 137,A00,187003,Staff,7,0,40,33
1683704680536,PHIL 150,A00,187015,Staff,47,0,70,23
1683704681562,PHIL 167,A00,187021,Lamey; Andy M.,34,0,40,6
1683704682591,PHIL 174,A01,202226,Staff,17,0,20,3
1683704682591,PHIL 174,A02,202235,Staff,20,0,20,0
1683704683617,PHIL 191A,A00,258918,Staff,0,0,1,1
1683704684648,PHYS 1A,A00,187028,Staff,26,0,60,34
1683704685674,PHYS 1AL,001,187036,Staff,3,0,30,27
1683704685674,PHYS 1AL,002,187049,Staff,18,0,30,12
1683704686698,PHYS 1B,A00,187058,Staff,21,0,60,39
1683704687727,PHYS 1BL,001,187064,Staff,0,1,30,30
1683704687727,PHYS 1BL,002,187070,Staff,4,0,30,26
1683704688752,PHYS 1C,A00,187082,Staff,30,0,120,90
1683704689784,PHYS 1CL,001,187088,Staff,0,9,30,30
1683704689784,PHYS 1CL,002,187089,Staff,0,1,30,30
1683704689784,PHYS 1CL,009,262693,Staff,9,0,30,21
1683704690810,PHYS 2B,A01,187097,Staff,55,0,115,60
1683704691838,PHYS 2C,A01,187099,Staff,63,0,115,52
1683704692864,PHYS 2CL,A01,187101,Staff,5,0,28,23
1683704692864,PHYS 2CL,A02,187102,Staff,15,0,28,13
1683704693890,PHYS 2D,A01,187123,Shotwell; Brian,95,0,115,20
1683704694917,PHYS 4B,A01,187133,Grinstein; Benjamin,35,0,50,15
1683704695943,POLI 10,A00,188819,Staff,0,4,50,50
1683704696971,POLI 11,A00,188827,Staff,43,0,50,7
1683704697997,POLI 13R,A00,188828,Staff,0,1,20,20
1683704699023,POLI 27,A01,188830,Elgin; Samuel Zincke,0,2,70,70
1683704700049,POLI 30,A00,188832,Desposato; Scott,30,0,50,20
1683704701078,POLI 102F,A00,188834,Staff,1,0,40,39
1683704702104,POLI 104A,A00,188852,Staff,12,0,30,18
1683704703128,POLI 104I,A00,188853,Staff,0,8,20,20
1683704704152,POLI 110B,A00,188854,Wiens; David,6,0,20,14
1683704705176,POLI 112A,A00,188855,Wiens; David,3,0,30,27
1683704706207,POLI 117R,A00,188856,Forman; Fonna,0,12,20,20
1683704707229,POLI 118,A00,188857,Ingham; Sean,8,0,20,12
1683704708257,POLI 120G,A00,188858,Staff,7,0,30,23
1683704709287,POLI 131CR,A00,188863,Hoston; Germaine,20,0,50,30
1683704710312,POLI 133,A00,188864,Nellis; Gareth Hb,44,0,50,6
1683704711338,POLI 134D,A00,188865,Desposato; Scott,27,0,30,3
1683704712367,POLI 142A,A00,188871,Gartzke; Erik,21,0,50,29
1683704713395,POLI 142K,A00,188874,Staff,38,0,50,12
1683704714420,POLI 143,A00,188940,Gartzke; Erik,15,0,30,15
1683704715445,POLI 153,A00,188943,Staff,1,0,20,19
1683704716470,POLI 160AA,A00,188944,Staff,10,0,40,30
1683704717498,POLI 170A,A00,188945,Staff,10,0,30,20
1683704719566,PSYC 1,A00,188952,Staff,36,0,90,54
1683704720591,PSYC 2,B00,188953,Staff,19,0,35,16
1683704721615,PSYC 6,A00,188970,Staff,47,0,60,13
1683704722639,PSYC 7,A00,188973,Staff,35,0,45,10
1683704723665,PSYC 60,A01,188980,Rickard; Timothy C.,42,0,60,18
1683704724695,PSYC 70,A01,189001,Steiner; Eric Tomas,22,0,45,23
1683704725720,PSYC 100,A00,189005,Lacefield; Katharine I,1,98,120,119
1683704726805,PSYC 102,A00,189008,Staff,6,0,30,24
1683704727837,PSYC 106,B00,189026,Gorman; Michael R.,27,0,60,33
1683704728864,PSYC 114,B01,189033,Winkielman; Piotr,0,31,30,30
1683704729888,PSYC 131,A00,189036,Anagnostaras; Stephan,0,44,60,60
1683704730919,PSYC 136,A00,189041,Lowe; Angela Beth,0,7,25,25
1683704731942,PSYC 137,A00,189057,Winkielman; Piotr,0,36,25,25
1683704732968,PSYC 144,A00,189107,Wixted; John T,0,11,50,50
1683704735021,PSYC 162,A00,189142,Staff,0,9,85,85
1683704736050,PSYC 172,A00,189144,Gorman; Michael R.,0,6,30,30
1683704738104,PSYC 179,A00,189146,Lacefield; Katharine I,0,88,120,120
1683704739130,PSYC 181,A00,189147,Anagnostaras; Stephan,0,45,90,90
1683704740160,PSYC 190R,A00,189148,Barner; David A.,0,23,80,80
1683704741184,PSYC 191,A00,189275,Rickard; Timothy C.,0,11,25,25
1683704742213,PSYC 193,A00,189276,Chapman; Eddie Nathaniel,0,1,0,4
1683704743244,PSYC 193L,A01,189281,Lowe; Angela Beth,8,0,20,12
1683704743244,PSYC 193L,B01,189285,Staff,28,0,35,7
1683704744274,RELI 149,A00,187137,Rahimi; Babak,6,0,40,34
1683704745307,SE 9,A01,187315,Staff,0,2,18,18
1683704746336,SE 101B,A00,187409,Staff,24,0,30,6
1683704747363,SE 110B,A00,187444,Staff,10,0,40,30
1683704748393,SE 130B,A00,187449,Staff,31,0,40,9
1683704749419,SE 150A,A00,187516,Staff,8,0,20,12
1683704750444,SE 154,A00,187528,Staff,29,0,50,21
1683704751469,SIO 3,A01,258171,Staff,35,0,40,5
1683704752495,SIO 10,A00,187144,Cook; Geoffrey W,0,6,75,75
1683704753520,SIO 45,A00,187152,Cook; Geoffrey W,1,7,100,99
1683704754549,SIO 109R,A00,194486,Staff,0,4,20,20
1683704756598,SIO 187,A01,187233,Kacev; David,12,0,40,28
1683704757631,SOCI 1,A01,258656,Thorpe; Charles Robert,28,0,30,2
1683704757631,SOCI 1,A02,258658,Thorpe; Charles Robert,30,0,30,0
1683704757631,SOCI 1,A03,258661,Thorpe; Charles Robert,25,0,25,0
1683704757631,SOCI 1,A04,258666,Thorpe; Charles Robert,22,0,25,3
1683704757631,SOCI 1,A05,258897,Thorpe; Charles Robert,22,0,25,3
1683704757631,SOCI 1,A06,258898,Thorpe; Charles Robert,25,0,25,0
1683704758660,SOCI 30,A01,258903,Pardo Guerra; Juan Pablo,14,0,30,16
1683704759685,SOCI 102,A00,258904,Staff,9,0,25,16
1683704760713,SOCI 106,A00,258905,Staff,19,0,25,6
1683704761744,SOCI 111,A00,258907,Ribas Norris; Janet Vanesa,26,0,30,4
1683704762774,SOCI 121R,A00,258908,Pardo Guerra; Juan Pablo,7,0,30,23
1683704763805,SOCI 126,A01,203330,Staff,14,0,20,6
1683704764830,SOCI 131,A00,258909,Thorpe; Charles Robert,30,0,60,30
1683704765859,SOCI 135,A00,258910,Payne; Christine Anna,0,13,30,30
1683704766888,SOCI 157,A00,258911,Staff,10,0,30,20
1683704767918,SOCI 184,A00,258912,Staff,25,0,30,5
1683704768944,SOCI 188D,A00,258913,Staff,22,0,30,8
1683704769971,SYN 2,001,187529,Staff,9,0,16,7
1683704769971,SYN 2,002,201452,Staff,0,20,16,16
1683704769971,SYN 2,003,201469,Staff,1,0,16,15
1683704770997,SYN 100,A01,187531,Staff,0,9,20,20
1683704770997,SYN 100,B01,201491,Staff,0,10,20,20
1683704772029,TDAC 1,A00,189286,Walsh; Kim C.,3,0,20,17
1683704772029,TDAC 1,B00,189287,Harting; Carla Kelso,10,0,20,10
1683704773054,TDAC 101,A00,189300,Walsh; Kim C.,16,0,20,4
1683704773054,TDAC 101,B00,189301,Harting; Carla Kelso,18,0,20,2
1683704774079,TDAC 102,A00,189304,Basso; Beatrice,14,0,20,6
1683704775104,TDAC 108,A00,189305,Staff,18,0,20,2
1683704776135,TDDE 131,A00,189310,Staff,19,0,20,1
1683704776135,TDDE 131,B00,189314,Staff,19,0,20,1
1683704776135,TDDE 131,C00,189315,Staff,48,0,50,2
1683704776135,TDDE 131,D00,189316,Staff,14,0,15,1
1683704776135,TDDE 131,E00,204841,Staff,20,0,20,0
1683704777160,TDGE 10,A00,189289,Staff,27,0,50,23
1683704777160,TDGE 10,B00,189290,Havis; Allan,0,1,50,50
1683704778194,TDGE 11,A00,189291,Fulton; Julia,0,4,50,50
1683704778194,TDGE 11,B00,189292,Staff,20,0,25,5
1683704778194,TDGE 11,C00,260270,Staff,0,0,0,0
1683704779218,TDGE 25,A00,189294,Staff,1,0,20,19
1683704780243,TDGE 124,A00,189318,Fulton; Julia,0,7,50,50
1683704781277,TDGE 125,A00,189319,Staff,13,0,25,12
1683704781277,TDGE 125,B00,189320,Staff,23,0,25,2
1683704782303,TDGE 127,A00,189322,Havis; Allan,1,0,50,49
1683704783332,TDHT 101,A00,189323,Staff,18,0,25,7
1683704783332,TDHT 101,B00,189324,Staff,25,0,25,0
1683704784357,TDHT 102,A00,189325,Staff,49,0,50,1
1683704785383,TDMV 1,A00,189295,Arcidiacono; Kristin,20,0,30,10
1683704785383,TDMV 1,B00,189296,Caligagan; Maria T.,23,0,30,7
1683704786409,TDMV 2,A00,189297,Sammartano; Tonnie,27,0,30,3
1683704786409,TDMV 2,B00,189299,Arcidiacono; Kristin,23,0,30,7
1683704787436,TDMV 3,A00,204998,Rincon; Alicia,22,0,30,8
1683704788462,TDMV 120,A00,189458,Sammartano; Tonnie,28,0,30,2
1683704789490,TDMV 138,A00,189541,Jun; Grace Shin Hae,20,0,40,20
1683704790516,TDMV 142,A00,189717,Caligagan; Tony,25,0,30,5
1683704790516,TDMV 142,B00,189718,Caligagan; Maria T.,25,0,30,5
1683704791542,TMC 2,A01,187533,Staff,25,0,25,0
1683704791542,TMC 2,A02,187534,Staff,25,0,25,0
1683704792572,USP 1,A01,187536,Kwak; Nancy,0,16,25,25
1683704793603,USP 5,A01,187538,Staff,8,0,25,17
1683704794628,USP 101,A00,199253,Staff,0,4,0,0
1683704795668,USP 124,A00,187562,Boomhower; Matthew Charles,0,0,30,30
1683704796692,USP 138,A00,187582,Staff,19,0,25,6
1683704797721,USP 152,A01,187597,Staff,3,0,25,22
1683704798749,USP 153,A00,187598,Staff,18,0,25,7
1683704799778,USP 168,A00,187607,Kwak; Nancy,2,0,5,3
1683704800806,USP 173,A00,187619,Staff,4,0,25,21
1683704801830,USP 181,A00,187638,Staff,0,4,25,25
1683704802862,VIS 103,A00,187650,Cruz; Edwin Teddy,17,0,75,58
1683704803891,VIS 110D,A00,187669,Staff,13,0,22,9
1683704804923,VIS 127C,A00,187720,Shen; Kuiyi,67,0,146,79
1683704805950,VIS 149,A00,187731,Yoldas; Pinar,0,12,22,22
1683704806978,VIS 151,A01,188091,Staff,22,0,34,12
1683704806978,VIS 151,A02,188092,Staff,11,0,34,23
1683704808002,VIS 160B,A00,188093,Stalbaum; Brett,0,1,10,10
1683704810061,WCWP 10B,A00,201720,Staff,0,0,5,5
1683704810061,WCWP 10B,B00,201722,Staff,0,0,6,6
1683704811101,WCWP 100,A00,201725,Gagnon; Jeffrey C,0,0,2,2
1683704811101,WCWP 100,B00,201727,Staff,0,4,15,15
1683704814299,ANBI 133,A00,258401,Wilder; Linnea Lorene,34,0,40,6
1683704815325,ANBI 140,A00,258395,Hrvoj Mihic; Branka,18,0,25,7
1683704816353,ANSC 120,A00,258402,Bialecki; Jon Anthony,26,0,40,14
1683704817383,ANSC 144,A00,258400,Staff,12,0,40,28
1683704819441,ANSC 166,A00,258396,Parish; Steven Martin,156,0,175,19
1683704820469,ANSC 180,A00,193533,Staff,8,0,20,12
1683704821495,ANSC 188,A00,258397,Jassal; Aftab,34,0,40,6
1683704822520,ANTH 3,A01,258316,Staff,23,0,30,7
1683704823545,ANTH 5,A00,258394,Semendeferi; Ekaterini,16,0,20,4
1683704824572,ANTH 21,A01,258331,Staff,4,0,40,36
1683704825598,ANTH 103,A00,258398,Varma; Saiba,15,0,25,10
1683704826628,AWP 10,001,202034,Staff,0,0,0,0
1683704826628,AWP 10,002,202035,Staff,0,0,0,0
1683704826628,AWP 10,003,202036,Staff,0,0,0,0
1683704826628,AWP 10,004,202037,Staff,0,0,0,0
1683704826628,AWP 10,005,202038,Staff,0,0,0,0
1683704826628,AWP 10,006,202039,Staff,0,0,0,0
1683704826628,AWP 10,007,202040,Staff,0,0,0,0
1683704826628,AWP 10,008,202041,Staff,0,0,0,0
1683704826628,AWP 10,009,202042,Staff,0,0,0,0
1683704826628,AWP 10,010,202043,Staff,0,0,0,0
1683704826628,AWP 10,011,202044,Staff,0,0,0,0
1683704826628,AWP 10,012,202045,Staff,0,0,0,0
1683704826628,AWP 10,013,202046,Staff,0,0,0,0
1683704826628,AWP 10,014,202047,Staff,0,0,0,0
1683704826628,AWP 10,015,202048,Staff,0,0,0,0
1683704826628,AWP 10,016,202049,Staff,0,0,0,0
1683704826628,AWP 10,017,202050,Staff,0,0,0,0
1683704826628,AWP 10,018,202051,Staff,0,0,0,0
1683704826628,AWP 10,019,202052,Staff,0,0,0,0
1683704826628,AWP 10,020,202053,Staff,0,0,0,0
1683704826628,AWP 10,021,202054,Staff,0,0,0,0
1683704826628,AWP 10,022,202055,Staff,0,0,0,0
1683704826628,AWP 10,023,202056,Staff,0,0,0,0
1683704826628,AWP 10,024,202057,Staff,0,0,0,0
1683704826628,AWP 10,025,202058,Staff,0,0,0,0
1683704826628,AWP 10,026,202059,Staff,0,0,0,0
1683704827656,AWP 102,001,202032,Staff,0,0,0,0
1683704827656,AWP 102,002,202033,Staff,0,0,0,0
1683704828683,BENG 100,A01,254234,Taylor Amos; Alyssa C,31,0,40,9
1683704829711,BENG 196,001,270013,Engler; Adam J.,9999,0,9999,0
1683704830794,BICD 100R,A01,202018,Smith; Laurie,0,7,32,32
1683704830794,BICD 100R,A02,202019,Smith; Laurie,0,3,32,32
1683704830794,BICD 100R,A03,202020,Smith; Laurie,0,1,32,32
1683704830794,BICD 100R,A04,202021,Smith; Laurie,6,0,32,26
1683704830794,BICD 100R,A05,202022,Smith; Laurie,10,0,32,22
1683704831827,BICD 136,A01,193242,Gustafson-Brown; Cindy,0,2,32,32
1683704831827,BICD 136,A02,193244,Gustafson-Brown; Cindy,13,0,32,19
1683704832867,BIEB 102,A01,193249,Butler; Shannon Rhey,0,0,32,32
1683704832867,BIEB 102,A02,193251,Butler; Shannon Rhey,0,0,32,32
1683704832867,BIEB 102,A03,193253,Butler; Shannon Rhey,0,0,32,32
1683704832867,BIEB 102,A04,193255,Butler; Shannon Rhey,13,0,32,19
1683704832867,BIEB 102,A05,193265,Butler; Shannon Rhey,25,0,32,7
1683704832867,BIEB 102,A06,193269,Butler; Shannon Rhey,12,0,32,20
1683704834919,BIEB 150,A01,193274,Staff,0,0,32,32
1683704834919,BIEB 150,A02,193285,Staff,24,0,32,8
1683704835948,BIEB 194,A00,193286,Kurle; Carolyn M.,19,0,32,13
1683704836980,BILD 1,A01,192291,Staff,15,0,32,17
1683704836980,BILD 1,A02,192292,Staff,30,0,32,2
1683704836980,BILD 1,B01,192520,Reuther; Keefe,0,1,0,0
1683704836980,BILD 1,B02,192532,Reuther; Keefe,0,1,0,0
1683704838016,BILD 3,A01,192556,Butler; Shannon Rhey,0,0,32,32
1683704838016,BILD 3,A02,192581,Butler; Shannon Rhey,0,1,32,32
1683704838016,BILD 3,A03,192611,Butler; Shannon Rhey,19,0,32,13
1683704838016,BILD 3,A04,192612,Butler; Shannon Rhey,23,0,32,9
1683704838016,BILD 3,A05,192613,Butler; Shannon Rhey,26,0,32,6
1683704838016,BILD 3,A06,192679,Butler; Shannon Rhey,27,0,32,5
1683704838016,BILD 3,A07,192682,Butler; Shannon Rhey,20,0,32,12
1683704839043,BILD 4,A01,192836,Reuther; Keefe,1,0,24,23
1683704839043,BILD 4,A02,193044,Reuther; Keefe,4,0,24,20
1683704840073,BILD 10,A01,193142,Gustafson-Brown; Cindy,29,0,32,3
1683704840073,BILD 10,A02,193149,Gustafson-Brown; Cindy,31,0,32,1
1683704841099,BIMM 100,A01,193301,Staff,0,6,32,32
1683704841099,BIMM 100,A02,193312,Staff,0,7,32,32
1683704841099,BIMM 100,A03,193323,Staff,0,10,32,32
1683704842127,BIMM 101,A01,193329,McDonnell; Lisa Marie,0,3,24,24
1683704842127,BIMM 101,A02,193339,McDonnell; Lisa Marie,0,3,24,24
1683704842127,BIMM 101,B01,193354,McDonnell; Lisa Marie,0,4,24,24
1683704842127,BIMM 101,B02,193357,McDonnell; Lisa Marie,0,3,24,24
1683704843154,BIMM 110,A01,193377,Tat; John,0,11,32,32
1683704843154,BIMM 110,A02,193378,Tat; John,0,11,32,32
1683704844191,BIMM 120,A01,206116,Staff,0,0,32,32
1683704844191,BIMM 120,A02,206117,Staff,7,0,32,25
1683704844191,BIMM 120,A03,206121,Staff,21,0,32,11
1683704845220,BIPN 100,A01,193393,Park; Ji Young,0,15,32,32
1683704845220,BIPN 100,A02,193402,Park; Ji Young,0,14,32,32
1683704845220,BIPN 100,A03,193413,Park; Ji Young,0,14,32,32
1683704845220,BIPN 100,A04,193414,Park; Ji Young,0,13,32,32
1683704846250,BIPN 102,A01,193429,Staff,0,0,32,32
1683704846250,BIPN 102,A02,193438,Staff,18,0,32,14
1683704847277,BIPN 106,A01,193450,Reyes Gonzalez; Catalina,0,2,40,40
1683704848301,BIPN 134,A01,193465,Cooke; James Edward,0,0,32,32
1683704848301,BIPN 134,A02,193474,Cooke; James Edward,25,0,32,7
1683704848301,BIPN 134,A03,193485,Cooke; James Edward,29,0,32,3
1683704848301,BIPN 134,A04,193486,Cooke; James Edward,20,0,32,12
1683704848301,BIPN 134,A05,193491,Cooke; James Edward,31,0,32,1
1683704848301,BIPN 134,A06,193501,Cooke; James Edward,30,0,32,2
1683704848301,BIPN 134,A07,193510,Cooke; James Edward,29,0,32,3
1683704850356,BISP 194,A00,222522,Staff,14,0,32,18
1683704851381,CAT 124,A01,202407,Staff,19,0,25,6
1683704852409,CAT 125,A00,202408,Marchisotto; Jennifer Anne,2,0,20,18
1683704853443,CAT 125R,A00,202409,Smith; Lauryn Alissa,0,11,20,20
1683704853443,CAT 125R,B00,202410,Morales; Celeste Georgianna,0,11,20,20
1683704853443,CAT 125R,C00,202411,Irwin; Matthew Joseph,0,12,20,20
1683704854471,CENG 15,A01,204712,Yang; Kesong,0,1,0,0
1683704855497,CENG 114,A00,202070,Jahed Motlagh; Zeinab,5,0,20,15
1683704856521,CGS 105,A00,185477,Wesling; Megan E.,24,0,40,16
1683704857549,CGS 106,A00,185494,Staff,11,0,22,11
1683704858576,CGS 108,A00,185495,Staff,14,0,20,6
1683704859600,CGS 114,A00,185496,Staff,13,0,18,5
1683704860625,CGS 119,A00,185501,Staff,15,0,20,5
1683704861650,CGS 120,A00,185511,Staff,11,0,20,9
1683704862677,CHEM 4,A01,184675,Bussey; Thomas J,97,0,100,3
1683704863706,CHEM 6A,A01,184677,Staff,32,0,60,28
1683704864732,CHEM 6B,A01,184679,Staff,63,0,100,37
1683704865757,CHEM 6C,A01,184681,Bussey; Thomas J,0,0,50,50
1683704865757,CHEM 6C,A02,184682,Bussey; Thomas J,32,0,50,18
1683704866789,CHEM 40A,A01,184684,Albizati; Kim F.,33,0,100,67
1683704867813,CHEM 40B,A01,184686,Albizati; Kim F.,0,22,100,100
1683704868841,CHEM 41B,A01,184690,Staff,51,0,100,49
1683704869867,COGS 3,A01,184715,Boyle; Mary E. T.,0,27,40,40
1683704870896,COGS 14B,A01,185172,Staff,0,14,38,38
1683704871925,COGS 18,A01,184736,Staff,14,0,80,66
1683704872967,COGS 100,A01,184932,Staff,0,8,73,73
1683704873996,COGS 101A,A01,184935,Staff,0,40,30,30
1683704875029,COGS 101B,A01,184944,Staff,0,2,30,30
1683704876054,COGS 101C,A01,184946,Staff,0,10,30,30
1683704877083,COGS 102A,A01,184951,Johnson; Christine M.,1,0,40,39
1683704878108,COGS 107B,A01,184953,Mooshagian; Eric Frederick,0,52,40,40
1683704879132,COGS 118B,A01,184959,Gupta; Anjum,0,50,40,40
1683704880158,COGS 153,A00,184961,Staff,1,16,30,29
1683704881196,COGS 177,A00,184962,Staff,0,20,30,30
1683704882221,COGS 187A,A01,184969,Boyle; Mary E. T.,0,19,40,40
1683704883252,COMM 10,A01,185174,Staff,0,5,25,25
1683704883252,COMM 10,A02,185189,Staff,0,2,25,25
1683704883252,COMM 10,A03,269821,Staff,0,1,0,0
1683704884278,COMM 100B,A02,185476,Staff,10,0,25,15
1683704884278,COMM 100B,A03,277340,Staff,25,0,25,0
1683704885308,COMM 100C,A01,185314,Staff,2,0,25,23
1683704885308,COMM 100C,A02,185327,Staff,17,0,25,8
1683704886334,COMM 110M,A00,185349,Staff,0,0,40,40
1683704887359,COMM 113T,A00,185352,Staff,25,0,40,15
1683704888382,COMM 114I,A00,185353,Staff,31,0,40,9
1683704889424,COMM 131,A00,185354,Staff,17,0,30,13
1683704890449,CSE 8A,A50,185358,Cao; Yingjun,0,46,10,10
1683704891473,CSE 8B,A01,185362,Staff,0,48,50,50
1683704892499,CSE 11,A01,185416,Cao; Yingjun,0,91,10,10
1683704893524,CSE 20,A01,185445,Briones; Jor-el Thomas Caparas,3,0,25,22
1683704894554,CSE 21,A01,185447,Staff,9,0,50,41
1683704895584,CSE 101,A01,185451,Staff,0,13,50,50
1683704895584,CSE 101,B01,185453,Jones; Miles E,0,15,50,50
1683704897635,CSE 141,A01,185458,Eldon; John,16,0,100,84
1683704898660,CSE 141L,A01,185461,Eldon; John,8,0,100,92
1683704899687,CSE 142,A01,185463,Staff,34,0,60,26
1683704899687,CSE 142,B01,201355,Staff,0,7,60,60
1683704900716,CSE 142L,A01,185470,Staff,34,0,60,26
1683704900716,CSE 142L,B01,201417,Staff,0,6,60,60
1683704901742,CSE 190,A00,201433,Staff,32,0,49,17
1683704902772,DOC 1,A01,259136,Strom; Megan C.,7,0,15,8
1683704902772,DOC 1,A02,259137,Strom; Megan C.,15,0,15,0
1683704902772,DOC 1,A03,259138,Strom; Megan C.,14,0,15,1
1683704902772,DOC 1,A04,259139,Strom; Megan C.,14,0,15,1
1683704903797,DOC 100D,A00,259140,Pass; Natalye Joann,14,0,25,11
1683704904834,DSGN 1,A01,184749,Rill; Bryan,0,26,30,30
1683704905863,DSGN 100,A01,185168,Staff,0,2,25,25
1683704906893,ECE 5,A01,185626,Morris; Karcher William,0,12,0,0
1683704907917,ECE 101,A01,185628,Staff,14,0,70,56
1683704908946,ECE 107,A01,185635,Baghdadchi; Saharnaz,0,0,20,20
1683704908946,ECE 107,A02,185638,Baghdadchi; Saharnaz,1,0,20,19
1683704909972,ECE 148,A01,185647,Silberman; Jack,0,0,16,16
1683704910997,ECON 1,A01,185537,Crane; Meredith Helen,54,0,70,16
1683704912025,ECON 3,A01,185549,Crane; Meredith Helen,30,0,70,40
1683704913056,ECON 4,A01,203354,Anderson; John Charles,0,5,10,10
1683704914084,ECON 100A,A01,185574,Staff,0,5,40,40
1683704915108,ECON 100B,A01,185576,Staff,0,12,50,50
1683704916134,ECON 100C,A01,185589,Newhouse; Herbert S,30,0,70,40
1683704917159,ECON 105,A00,185608,Vespa; Emanuel Ignacio,19,0,35,16
1683704918184,ECON 109,A01,185610,Shishkin; Denis,9,0,35,26
1683704919209,ECON 110A,A01,185612,Staff,8,0,40,32
1683704920236,ECON 120A,A01,185615,Staff,19,0,40,21
1683704921261,ECON 120C,A01,185617,Sun; Yixiao,0,21,70,70
1683704922287,ECON 144,A00,203346,Squires; Dale E,2,0,35,33
1683704923312,ECON 171,A01,203349,Newhouse; Herbert S,0,1,35,35
1683704924338,ECON 173A,A01,185621,Toda; Alexis Akira,21,0,35,14
1683704925374,EDS 25,A01,202413,Staff,0,1,0,0
1683704925374,EDS 25,A02,202414,Staff,0,1,0,0
1683704925374,EDS 25,A03,202415,Staff,0,0,0,0
1683704925374,EDS 25,A04,202416,Staff,0,1,0,0
1683704925374,EDS 25,A05,202439,Staff,0,0,0,0
1683704925374,EDS 25,A06,202440,Staff,0,0,0,0
1683704925374,EDS 25,B01,202631,Staff,0,0,0,0
1683704925374,EDS 25,B02,202632,Staff,0,0,0,0
1683704925374,EDS 25,B03,202639,Staff,0,0,0,0
1683704925374,EDS 25,B04,202640,Staff,0,0,0,0
1683704925374,EDS 25,B05,202643,Staff,0,0,0,0
1683704925374,EDS 25,B06,202644,Staff,0,0,0,0
1683704926400,EDS 38,A01,202659,Black; Alison Michelle,25,0,25,0
1683704927428,EDS 115,A00,202652,Staff,18,0,30,12
1683704928453,EDS 125,A00,202649,Staff,13,0,30,17
1683704929484,EDS 126,A01,203332,Staff,30,0,30,0
1683704930509,EDS 139,A00,202838,Staff,16,0,25,9
1683704931535,EDS 146,A01,202655,Staff,14,0,25,11
1683704932565,ENG 15,A00,185667,Staff,0,1,0,0
1683704932565,ENG 15,B00,185672,Staff,0,0,0,0
1683704932565,ENG 15,C00,185675,Staff,0,0,0,0
1683704932565,ENG 15,D00,185682,Staff,0,0,0,0
1683704932565,ENG 15,E00,185684,Staff,0,0,0,0
1683704933593,ETHN 103,A00,185710,Staff,0,8,35,35
1683704934674,ETHN 103A,A00,199228,Man; Simeon S,0,0,9,9
1683704935702,ETHN 109,A00,185711,Staff,15,0,35,20
1683704936730,ETHN 142,A00,185726,Staff,0,4,30,30
1683704937757,ETHN 163J,A00,199229,Man; Simeon S,5,0,8,3
1683704938782,ETHN 168,A00,185727,Staff,7,0,10,3
1683704939810,ETHN 182,A00,185728,Staff,0,0,35,35
1683704940834,ETHN 183,A00,185737,Staff,9,0,18,9
1683704941860,GLBH 111,A01,209361,Burgos; Jose L.,0,0,0,0
1683704943919,HIEU 104,A00,185792,Staff,14,0,20,6
1683704944944,HIEU 115,A00,185800,Staff,0,0,20,20
1683704945968,HIEU 128,A00,185801,Staff,0,9,20,20
1683704946995,HIEU 147,A00,185802,Staff,15,0,20,5
1683704948026,HIEU 154,A00,185823,Staff,11,0,20,9
1683704949054,HILA 102,A00,185826,Staff,14,0,20,6
1683704950078,HILD 2C,A01,185778,Staff,0,13,20,20
1683704951104,HILD 7B,A01,185780,Kwak; Nancy,0,17,32,32
1683704951104,HILD 7B,A02,185781,Kwak; Nancy,0,18,32,32
1683704952133,HILD 30,A01,185791,Staff,12,0,20,8
1683704953164,HISC 119,A00,185830,Golan; Tal,0,10,20,20
1683704954189,HITO 156GS,A00,185831,Patterson; Patrick H.,0,0,0,23
1683704955218,HIUS 103,A00,185832,Man; Simeon S,0,4,20,20
1683704956247,HIUS 117,A00,185836,Kwak; Nancy,2,0,20,18
1683704957275,HIUS 125,A00,185840,Man; Simeon S,0,2,23,23
1683704958306,HIUS 149,A00,185845,Staff,1,0,20,19
1683704959334,HUM 3,A01,185882,Zavodny; Tatiana Sophia,0,8,50,50
1683704959334,HUM 3,B01,185899,Caldwell; Michael Alan,0,18,50,50
1683704960362,HUM 3GS,A00,185900,Patterson; Patrick H.,0,0,0,23
1683704961391,HUM 4,A01,185938,Zroka; Amy Liane,28,0,50,22
1683704961391,HUM 4,B01,185956,Watkins; Eric,0,6,50,50
1683704961391,HUM 4,B02,202209,Watkins; Eric,0,5,50,50
1683704961391,HUM 4,B03,202210,Watkins; Eric,0,5,50,50
1683704962414,HUM 5,A01,185958,West; Geoffrey Scott,0,0,50,50
1683704962414,HUM 5,A02,202215,West; Geoffrey Scott,0,1,50,50
1683704963444,INTL 190,A00,185959,Gagnon; Jeffrey C,0,0,0,9
1683704963444,INTL 190,B00,185960,Lettieri; Michael Joseph,0,0,0,2
1683704964470,JAPN 180,A00,254509,Staff,5,0,30,25
1683704965498,LATI 10,A01,202853,Kennemore; Amy Michelle,4,0,35,31
1683704965498,LATI 10,A02,202854,Kennemore; Amy Michelle,3,0,35,32
1683704965498,LATI 10,A03,270054,Kennemore; Amy Michelle,30,0,30,0
1683704966526,LATI 180,A00,202855,Kennemore; Amy Michelle,11,0,20,9
1683704967560,LAWS 101,A00,201767,Golan; Tal,0,7,40,40
1683704968585,LIFR 1C,A00,185961,Staff,6,0,20,14
1683704969610,LIFR 1CX,A00,185962,Staff,7,0,20,13
1683704970634,LIFR 1D,A00,185963,Staff,7,0,20,13
1683704971658,LIFR 1DX,A00,185964,Staff,7,0,20,13
1683704972680,LIGN 101,A01,186039,Staff,43,0,50,7
1683704973705,LIGN 165,A00,186040,Staff,14,0,50,36
1683704974734,LTCS 108,A00,186041,Staff,5,0,10,5
1683704975759,LTCS 119,A00,186042,Staff,15,0,20,5
1683704976794,LTCS 130,A00,186043,Wesling; Megan E.,15,0,25,10
1683704978847,LTEA 138,A00,186119,Staff,14,0,40,26
1683704979872,LTEN 124,A00,186148,Staff,5,0,25,20
1683704980903,LTEN 178,A00,186149,Staff,6,0,15,9
1683704981929,LTEN 181,A00,186150,Blanco; John D,34,0,40,6
1683704982953,LTWL 120,A00,186160,Staff,19,0,25,6
1683704983980,LTWL 165,A00,186161,Staff,22,0,25,3
1683704985005,LTWR 100,A00,186162,Staff,0,5,15,15
1683704986034,LTWR 102,A00,186163,Doller; Ben,5,0,15,10
1683704987060,MAE 8,A01,186412,Staff,0,1,0,0
1683704988090,MAE 30B,A00,186445,Bahadori; Mohammad Yousef,81,0,100,19
1683704989121,MAE 40,A00,186592,Bewley; Thomas R,10,0,50,40
1683704990146,MAE 101B,A00,186593,Bahadori; Mohammad Yousef,80,0,100,20
1683704991176,MAE 105,A00,186594,Bandaru; Prabhakar,10,0,50,40
1683704992205,MAE 107,A00,186599,Pham; Hieu Tan,0,8,120,120
1683704993230,MAE 148,A01,186660,Silberman; Jack,3,0,16,13
1683704994255,MATH 10A,A01,188095,Staff,0,6,35,35
1683704995282,MATH 10B,A01,188097,Bowers; Adam R.,0,12,30,30
1683704995282,MATH 10B,A02,188099,Bowers; Adam R.,0,11,30,30
1683704995282,MATH 10B,B01,188104,Bowers; Adam R.,0,10,30,30
1683704995282,MATH 10B,B02,188106,Bowers; Adam R.,0,9,30,30
1683704996308,MATH 10C,A01,188111,Staff,0,20,30,30
1683704996308,MATH 10C,A02,188127,Staff,0,19,30,30
1683704996308,MATH 10C,A03,188131,Staff,0,19,30,30
1683704996308,MATH 10C,B01,188218,Staff,17,0,30,13
1683704996308,MATH 10C,B02,188244,Staff,13,0,30,17
1683704996308,MATH 10C,B03,188277,Staff,14,0,30,16
1683704997335,MATH 18,A01,188344,Bach; Quang Tran,18,0,30,12
1683704997335,MATH 18,A02,188345,Bach; Quang Tran,11,0,30,19
1683704997335,MATH 18,B01,188353,Bach; Quang Tran,11,0,30,19
1683704997335,MATH 18,B02,188354,Bach; Quang Tran,19,0,30,11
1683704998366,MATH 20A,A01,188374,Staff,11,0,35,24
1683704999400,MATH 20B,A01,188382,Ohm; Ko Woon,7,0,30,23
1683704999400,MATH 20B,A02,188383,Ohm; Ko Woon,22,0,30,8
1683704999400,MATH 20B,B01,188385,Ohm; Ko Woon,7,0,30,23
1683704999400,MATH 20B,B02,188392,Ohm; Ko Woon,22,0,30,8
1683705000431,MATH 20C,A01,188394,Harel; Guershon,10,0,30,20
1683705000431,MATH 20C,A02,188395,Harel; Guershon,13,0,30,17
1683705000431,MATH 20C,B01,188404,Harel; Guershon,5,0,30,25
1683705000431,MATH 20C,B02,188405,Harel; Guershon,18,0,30,12
1683705001460,MATH 20D,A01,188414,Hammock; Frances H,0,1,30,30
1683705001460,MATH 20D,A02,188415,Hammock; Frances H,0,1,30,30
1683705001460,MATH 20D,B01,188447,Hammock; Frances H,0,1,30,30
1683705001460,MATH 20D,B02,188486,Hammock; Frances H,2,0,30,28
1683705002485,MATH 20E,A01,188649,Staff,21,0,30,9
1683705002485,MATH 20E,A02,188650,Staff,20,0,30,10
1683705002485,MATH 20E,A03,188673,Staff,0,0,30,30
1683705003518,MATH 102,A01,188675,Staff,0,40,35,35
1683705004546,MATH 103B,A01,188681,Staff,3,0,35,32
1683705004546,MATH 103B,B01,188692,Staff,5,0,35,30
1683705005573,MATH 109,A01,188695,Salehi Golsefidy; Alireza,24,0,35,11
1683705005573,MATH 109,A02,188696,Salehi Golsefidy; Alireza,25,0,35,10
1683705006599,MATH 120A,A01,188698,Eggers; John Dietrich,7,0,35,28
1683705007628,MATH 142B,A01,188736,Ioana; Adrian,0,0,30,30
1683705007628,MATH 142B,A02,188741,Ioana; Adrian,0,1,30,30
1683705007628,MATH 142B,A03,188743,Ioana; Adrian,0,2,30,30
1683705008653,MATH 168A,A01,188790,Staff,0,11,35,35
1683705009679,MATH 170A,A01,188803,Nie; Jiawang,0,2,35,35
1683705009679,MATH 170A,A02,188811,Nie; Jiawang,0,1,35,35
1683705009679,MATH 170A,A03,188814,Nie; Jiawang,0,0,35,35
1683705009679,MATH 170A,A04,188815,Nie; Jiawang,5,0,35,30
1683705010709,MATH 193B,A01,188817,Staff,0,0,35,35
1683705010709,MATH 193B,A02,188818,Staff,6,0,35,29
1683705011755,MGT 4,A01,202857,Anderson; John Charles,59,0,80,21
1683705012788,MGT 12,A00,202858,Lindenberger; Wade Douglas,40,0,90,50
1683705013812,MGT 18,A00,202859,Staff,73,0,90,17
1683705014838,MGT 18GS,A00,202860,McKay; Michael J,13,0,28,15
1683705015863,MGT 45,A00,202861,Pecore; Joseph P.,8,0,90,82
1683705016888,MGT 100,A00,202863,Yavorsky; Daniel Ryan,27,0,90,63
1683705017918,MGT 103,A00,202864,Ehrich; Kristine R,0,19,90,90
1683705018945,MGT 112,A00,202865,Ehrich; Kristine R,15,0,90,75
1683705019978,MGT 121A,A00,202868,Staff,70,0,90,20
1683705021004,MGT 131B,A00,202869,Anderson; John Charles,58,0,90,32
1683705022031,MGT 136,A00,202871,Lindenberger; Wade Douglas,83,0,90,7
1683705023058,MGT 164,A00,202873,Staff,0,67,90,91
1683705024085,MGT 164GS,A00,202874,McKay; Mary A,13,0,28,15
1683705025112,MGT 180,A00,202875,Staff,0,51,90,91
1683705026140,MMW 11R,A01,205019,Herbst; Matthew,0,0,30,30
1683705026140,MMW 11R,A02,205026,Herbst; Matthew,29,0,30,1
1683705027167,MMW 15,A01,193512,Chang; Edmond Yi-Teh,0,8,28,28
1683705027167,MMW 15,A02,193513,Chang; Edmond Yi-Teh,0,5,28,28
1683705027167,MMW 15,A03,193514,Chang; Edmond Yi-Teh,0,5,28,28
1683705027167,MMW 15,A04,193515,Chang; Edmond Yi-Teh,0,5,28,28
1683705027167,MMW 15,A05,193516,Chang; Edmond Yi-Teh,0,5,28,28
1683705027167,MMW 15,A06,193517,Chang; Edmond Yi-Teh,0,6,28,28
1683705027167,MMW 15,B01,193519,Chang; Edmond Yi-Teh,0,5,28,28
1683705027167,MMW 15,B02,193520,Chang; Edmond Yi-Teh,0,5,28,28
1683705027167,MMW 15,B03,193521,Chang; Edmond Yi-Teh,0,5,28,28
1683705027167,MMW 15,B04,193522,Chang; Edmond Yi-Teh,0,6,28,28
1683705027167,MMW 15,B05,193523,Chang; Edmond Yi-Teh,0,5,28,28
1683705027167,MMW 15,B06,193524,Chang; Edmond Yi-Teh,0,5,28,28
1683705028192,MMW 122,A01,193526,Rahimi; Babak,0,16,28,28
1683705028192,MMW 122,A02,193527,Rahimi; Babak,0,15,28,28
1683705028192,MMW 122,A03,193528,Rahimi; Babak,0,0,0,0
1683705028192,MMW 122,A04,193529,Rahimi; Babak,0,0,0,0
1683705029219,MUS 1A,A01,186663,Staff,0,18,35,35
1683705030244,MUS 4,A01,186715,Staff,0,12,35,35
1683705031270,MUS 5R,A01,186796,Dubnov; Shlomo,0,17,35,35
1683705032295,MUS 6,A01,186798,Staff,0,4,25,25
1683705033320,MUS 7,A01,186830,Staff,11,0,35,24
1683705034351,MUS 8,A01,186930,Staff,0,27,35,35
1683705035380,MUS 15,A01,186932,Staff,0,15,35,35
1683705035380,MUS 15,B01,186934,Staff,0,16,35,35
1683705036410,MUS 80,A00,186935,Staff,0,0,20,20
1683705036410,MUS 80,B00,186936,Staff,24,0,25,1
1683705037440,NANO 11,A00,204702,Lipomi; Darren John,0,0,0,0
1683705038525,NANO 15,A01,204709,Yang; Kesong,0,1,0,0
1683705039553,NANO 114,A00,202069,Jahed Motlagh; Zeinab,2,0,10,8
1683705040599,PHIL 1,A00,186955,Grush; Rick Scott,31,0,40,9
1683705041629,PHIL 10,A01,186973,Grush; Rick Scott,27,0,35,8
1683705041629,PHIL 10,A02,186974,Grush; Rick Scott,33,0,35,2
1683705042657,PHIL 13,A01,186976,Staff,1,0,35,34
1683705042657,PHIL 13,A02,186977,Staff,16,0,35,19
1683705043682,PHIL 14,A01,186979,Staff,30,0,35,5
1683705043682,PHIL 14,A02,186986,Staff,32,0,35,3
1683705044710,PHIL 28,A01,186988,Staff,16,0,30,14
1683705044710,PHIL 28,A02,186989,Staff,0,0,30,30
1683705044710,PHIL 28,A03,186990,Staff,10,0,30,20
1683705044710,PHIL 28,A04,186991,Staff,26,0,30,4
1683705045738,PHIL 120,A00,186997,Staff,23,0,40,17
1683705046764,PHIL 137,A00,187003,Staff,7,0,40,33
1683705047794,PHIL 150,A00,187015,Staff,47,0,70,23
1683705048824,PHIL 167,A00,187021,Lamey; Andy M.,34,0,40,6
1683705049851,PHIL 174,A01,202226,Staff,17,0,20,3
1683705049851,PHIL 174,A02,202235,Staff,20,0,20,0
1683705050877,PHIL 191A,A00,258918,Staff,0,0,1,1
1683705051905,PHYS 1A,A00,187028,Staff,26,0,60,34
1683705052932,PHYS 1AL,001,187036,Staff,3,0,30,27
1683705052932,PHYS 1AL,002,187049,Staff,18,0,30,12
1683705053957,PHYS 1B,A00,187058,Staff,21,0,60,39
1683705054983,PHYS 1BL,001,187064,Staff,0,1,30,30
1683705054983,PHYS 1BL,002,187070,Staff,4,0,30,26
1683705056009,PHYS 1C,A00,187082,Staff,30,0,120,90
1683705057040,PHYS 1CL,001,187088,Staff,0,9,30,30
1683705057040,PHYS 1CL,002,187089,Staff,0,1,30,30
1683705057040,PHYS 1CL,009,262693,Staff,9,0,30,21
1683705058070,PHYS 2B,A01,187097,Staff,55,0,115,60
1683705059096,PHYS 2C,A01,187099,Staff,63,0,115,52
1683705060121,PHYS 2CL,A01,187101,Staff,5,0,28,23
1683705060121,PHYS 2CL,A02,187102,Staff,15,0,28,13
1683705061152,PHYS 2D,A01,187123,Shotwell; Brian,95,0,115,20
1683705062178,PHYS 4B,A01,187133,Grinstein; Benjamin,35,0,50,15
1683705063207,POLI 10,A00,188819,Staff,0,4,50,50
1683705064231,POLI 11,A00,188827,Staff,43,0,50,7
1683705065256,POLI 13R,A00,188828,Staff,0,1,20,20
1683705066287,POLI 27,A01,188830,Elgin; Samuel Zincke,0,2,70,70
1683705067315,POLI 30,A00,188832,Desposato; Scott,30,0,50,20
1683705068340,POLI 102F,A00,188834,Staff,1,0,40,39
1683705069364,POLI 104A,A00,188852,Staff,12,0,30,18
1683705070390,POLI 104I,A00,188853,Staff,0,8,20,20
1683705071416,POLI 110B,A00,188854,Wiens; David,6,0,20,14
1683705072444,POLI 112A,A00,188855,Wiens; David,3,0,30,27
1683705073471,POLI 117R,A00,188856,Forman; Fonna,0,12,20,20
1683705074504,POLI 118,A00,188857,Ingham; Sean,8,0,20,12
1683705075529,POLI 120G,A00,188858,Staff,7,0,30,23
1683705076555,POLI 131CR,A00,188863,Hoston; Germaine,20,0,50,30
1683705077584,POLI 133,A00,188864,Nellis; Gareth Hb,44,0,50,6
1683705078612,POLI 134D,A00,188865,Desposato; Scott,27,0,30,3
1683705079637,POLI 142A,A00,188871,Gartzke; Erik,21,0,50,29
1683705080665,POLI 142K,A00,188874,Staff,38,0,50,12
1683705081691,POLI 143,A00,188940,Gartzke; Erik,15,0,30,15
1683705082716,POLI 153,A00,188943,Staff,1,0,20,19
1683705083743,POLI 160AA,A00,188944,Staff,10,0,40,30
1683705084773,POLI 170A,A00,188945,Staff,10,0,30,20
1683705086831,PSYC 1,A00,188952,Staff,36,0,90,54
1683705087856,PSYC 2,B00,188953,Staff,19,0,35,16
1683705088883,PSYC 6,A00,188970,Staff,47,0,60,13
1683705089910,PSYC 7,A00,188973,Staff,35,0,45,10
1683705090937,PSYC 60,A01,188980,Rickard; Timothy C.,42,0,60,18
1683705091963,PSYC 70,A01,189001,Steiner; Eric Tomas,22,0,45,23
1683705092988,PSYC 100,A00,189005,Lacefield; Katharine I,1,98,120,119
1683705094017,PSYC 102,A00,189008,Staff,6,0,30,24
1683705095048,PSYC 106,B00,189026,Gorman; Michael R.,27,0,60,33
1683705096076,PSYC 114,B01,189033,Winkielman; Piotr,0,31,30,30
1683705097106,PSYC 131,A00,189036,Anagnostaras; Stephan,0,44,60,60
1683705098137,PSYC 136,A00,189041,Lowe; Angela Beth,0,7,25,25
1683705099163,PSYC 137,A00,189057,Winkielman; Piotr,0,36,25,25
1683705100189,PSYC 144,A00,189107,Wixted; John T,0,11,50,50
1683705102247,PSYC 162,A00,189142,Staff,0,9,85,85
1683705103277,PSYC 172,A00,189144,Gorman; Michael R.,0,6,30,30
1683705105333,PSYC 179,A00,189146,Lacefield; Katharine I,0,88,120,120
1683705106363,PSYC 181,A00,189147,Anagnostaras; Stephan,0,45,90,90
1683705107389,PSYC 190R,A00,189148,Barner; David A.,0,23,80,80
1683705108422,PSYC 191,A00,189275,Rickard; Timothy C.,0,11,25,25
1683705109446,PSYC 193,A00,189276,Chapman; Eddie Nathaniel,0,1,0,4
1683705110474,PSYC 193L,A01,189281,Lowe; Angela Beth,8,0,20,12
1683705110474,PSYC 193L,B01,189285,Staff,28,0,35,7
1683705111504,RELI 149,A00,187137,Rahimi; Babak,6,0,40,34
1683705112535,SE 9,A01,187315,Staff,0,2,18,18
1683705113562,SE 101B,A00,187409,Staff,24,0,30,6
1683705114587,SE 110B,A00,187444,Staff,10,0,40,30
1683705115614,SE 130B,A00,187449,Staff,31,0,40,9
1683705116641,SE 150A,A00,187516,Staff,8,0,20,12
1683705117666,SE 154,A00,187528,Staff,29,0,50,21
1683705118698,SIO 3,A01,258171,Staff,35,0,40,5
1683705119724,SIO 10,A00,187144,Cook; Geoffrey W,0,6,75,75
1683705120754,SIO 45,A00,187152,Cook; Geoffrey W,1,7,100,99
1683705121787,SIO 109R,A00,194486,Staff,0,4,20,20
1683705123838,SIO 187,A01,187233,Kacev; David,12,0,40,28
1683705124869,SOCI 1,A01,258656,Thorpe; Charles Robert,28,0,30,2
1683705124869,SOCI 1,A02,258658,Thorpe; Charles Robert,30,0,30,0
1683705124869,SOCI 1,A03,258661,Thorpe; Charles Robert,25,0,25,0
1683705124869,SOCI 1,A04,258666,Thorpe; Charles Robert,22,0,25,3
1683705124869,SOCI 1,A05,258897,Thorpe; Charles Robert,22,0,25,3
1683705124869,SOCI 1,A06,258898,Thorpe; Charles Robert,25,0,25,0
1683705125899,SOCI 30,A01,258903,Pardo Guerra; Juan Pablo,14,0,30,16
1683705126926,SOCI 102,A00,258904,Staff,9,0,25,16
1683705127950,SOCI 106,A00,258905,Staff,19,0,25,6
1683705128980,SOCI 111,A00,258907,Ribas Norris; Janet Vanesa,26,0,30,4
1683705130007,SOCI 121R,A00,258908,Pardo Guerra; Juan Pablo,7,0,30,23
1683705131045,SOCI 126,A01,203330,Staff,14,0,20,6
1683705132074,SOCI 131,A00,258909,Thorpe; Charles Robert,30,0,60,30
1683705133099,SOCI 135,A00,258910,Payne; Christine Anna,0,13,30,30
1683705134124,SOCI 157,A00,258911,Staff,10,0,30,20
1683705135150,SOCI 184,A00,258912,Staff,25,0,30,5
1683705136179,SOCI 188D,A00,258913,Staff,22,0,30,8
1683705137206,SYN 2,001,187529,Staff,9,0,16,7
1683705137206,SYN 2,002,201452,Staff,0,20,16,16
1683705137206,SYN 2,003,201469,Staff,1,0,16,15
1683705138231,SYN 100,A01,187531,Staff,0,9,20,20
1683705138231,SYN 100,B01,201491,Staff,0,10,20,20
1683705139263,TDAC 1,A00,189286,Walsh; Kim C.,3,0,20,17
1683705139263,TDAC 1,B00,189287,Harting; Carla Kelso,10,0,20,10
1683705140288,TDAC 101,A00,189300,Walsh; Kim C.,16,0,20,4
1683705140288,TDAC 101,B00,189301,Harting; Carla Kelso,18,0,20,2
1683705141319,TDAC 102,A00,189304,Basso; Beatrice,14,0,20,6
1683705142417,TDAC 108,A00,189305,Staff,18,0,20,2
1683705143453,TDDE 131,A00,189310,Staff,19,0,20,1
1683705143453,TDDE 131,B00,189314,Staff,19,0,20,1
1683705143453,TDDE 131,C00,189315,Staff,48,0,50,2
1683705143453,TDDE 131,D00,189316,Staff,14,0,15,1
1683705143453,TDDE 131,E00,204841,Staff,20,0,20,0
1683705144478,TDGE 10,A00,189289,Staff,27,0,50,23
1683705144478,TDGE 10,B00,189290,Havis; Allan,0,1,50,50
1683705145510,TDGE 11,A00,189291,Fulton; Julia,0,4,50,50
1683705145510,TDGE 11,B00,189292,Staff,20,0,25,5
1683705145510,TDGE 11,C00,260270,Staff,0,0,0,0
1683705146535,TDGE 25,A00,189294,Staff,1,0,20,19
1683705147564,TDGE 124,A00,189318,Fulton; Julia,0,7,50,50
1683705148593,TDGE 125,A00,189319,Staff,13,0,25,12
1683705148593,TDGE 125,B00,189320,Staff,23,0,25,2
1683705149620,TDGE 127,A00,189322,Havis; Allan,1,0,50,49
1683705150648,TDHT 101,A00,189323,Staff,18,0,25,7
1683705150648,TDHT 101,B00,189324,Staff,25,0,25,0
1683705151678,TDHT 102,A00,189325,Staff,49,0,50,1
1683705152710,TDMV 1,A00,189295,Arcidiacono; Kristin,20,0,30,10
1683705152710,TDMV 1,B00,189296,Caligagan; Maria T.,23,0,30,7
1683705153740,TDMV 2,A00,189297,Sammartano; Tonnie,27,0,30,3
1683705153740,TDMV 2,B00,189299,Arcidiacono; Kristin,23,0,30,7
1683705154772,TDMV 3,A00,204998,Rincon; Alicia,22,0,30,8
1683705155798,TDMV 120,A00,189458,Sammartano; Tonnie,28,0,30,2
1683705156825,TDMV 138,A00,189541,Jun; Grace Shin Hae,20,0,40,20
1683705157852,TDMV 142,A00,189717,Caligagan; Tony,25,0,30,5
1683705157852,TDMV 142,B00,189718,Caligagan; Maria T.,25,0,30,5
1683705158877,TMC 2,A01,187533,Staff,25,0,25,0
1683705158877,TMC 2,A02,187534,Staff,25,0,25,0
1683705159912,USP 1,A01,187536,Kwak; Nancy,0,16,25,25
1683705160944,USP 5,A01,187538,Staff,8,0,25,17
1683705161971,USP 101,A00,199253,Staff,0,4,0,0
1683705163002,USP 124,A00,187562,Boomhower; Matthew Charles,0,0,30,30
1683705164029,USP 138,A00,187582,Staff,19,0,25,6
1683705165057,USP 152,A01,187597,Staff,3,0,25,22
1683705166082,USP 153,A00,187598,Staff,18,0,25,7
1683705167114,USP 168,A00,187607,Kwak; Nancy,2,0,5,3
1683705168141,USP 173,A00,187619,Staff,4,0,25,21
1683705169171,USP 181,A00,187638,Staff,0,4,25,25
1683705170198,VIS 103,A00,187650,Cruz; Edwin Teddy,17,0,75,58
1683705171222,VIS 110D,A00,187669,Staff,13,0,22,9
1683705172251,VIS 127C,A00,187720,Shen; Kuiyi,67,0,146,79
1683705173282,VIS 149,A00,187731,Yoldas; Pinar,0,12,22,22
1683705174309,VIS 151,A01,188091,Staff,22,0,34,12
1683705174309,VIS 151,A02,188092,Staff,11,0,34,23
1683705175333,VIS 160B,A00,188093,Stalbaum; Brett,0,1,10,10
1683705177393,WCWP 10B,A00,201720,Staff,0,0,5,5
1683705177393,WCWP 10B,B00,201722,Staff,0,0,6,6
1683705178425,WCWP 100,A00,201725,Gagnon; Jeffrey C,0,0,2,2
1683705178425,WCWP 100,B00,201727,Staff,0,4,15,15
1683705181673,ANBI 133,A00,258401,Wilder; Linnea Lorene,34,0,40,6
1683705182701,ANBI 140,A00,258395,Hrvoj Mihic; Branka,18,0,25,7
1683705183727,ANSC 120,A00,258402,Bialecki; Jon Anthony,26,0,40,14
1683705184752,ANSC 144,A00,258400,Staff,12,0,40,28
1683705186812,ANSC 166,A00,258396,Parish; Steven Martin,156,0,175,19
1683705187842,ANSC 180,A00,193533,Staff,8,0,20,12
1683705188869,ANSC 188,A00,258397,Jassal; Aftab,34,0,40,6
1683705189901,ANTH 3,A01,258316,Staff,23,0,30,7
1683705190932,ANTH 5,A00,258394,Semendeferi; Ekaterini,16,0,20,4
1683705191960,ANTH 21,A01,258331,Staff,4,0,40,36
1683705192995,ANTH 103,A00,258398,Varma; Saiba,15,0,25,10
1683705194026,AWP 10,001,202034,Staff,0,0,0,0
1683705194026,AWP 10,002,202035,Staff,0,0,0,0
1683705194026,AWP 10,003,202036,Staff,0,0,0,0
1683705194026,AWP 10,004,202037,Staff,0,0,0,0
1683705194026,AWP 10,005,202038,Staff,0,0,0,0
1683705194026,AWP 10,006,202039,Staff,0,0,0,0
1683705194026,AWP 10,007,202040,Staff,0,0,0,0
1683705194026,AWP 10,008,202041,Staff,0,0,0,0
1683705194026,AWP 10,009,202042,Staff,0,0,0,0
1683705194026,AWP 10,010,202043,Staff,0,0,0,0
1683705194026,AWP 10,011,202044,Staff,0,0,0,0
1683705194026,AWP 10,012,202045,Staff,0,0,0,0
1683705194026,AWP 10,013,202046,Staff,0,0,0,0
1683705194026,AWP 10,014,202047,Staff,0,0,0,0
1683705194026,AWP 10,015,202048,Staff,0,0,0,0
1683705194026,AWP 10,016,202049,Staff,0,0,0,0
1683705194026,AWP 10,017,202050,Staff,0,0,0,0
1683705194026,AWP 10,018,202051,Staff,0,0,0,0
1683705194026,AWP 10,019,202052,Staff,0,0,0,0
1683705194026,AWP 10,020,202053,Staff,0,0,0,0
1683705194026,AWP 10,021,202054,Staff,0,0,0,0
1683705194026,AWP 10,022,202055,Staff,0,0,0,0
1683705194026,AWP 10,023,202056,Staff,0,0,0,0
1683705194026,AWP 10,024,202057,Staff,0,0,0,0
1683705194026,AWP 10,025,202058,Staff,0,0,0,0
1683705194026,AWP 10,026,202059,Staff,0,0,0,0
1683705195056,AWP 102,001,202032,Staff,0,0,0,0
1683705195056,AWP 102,002,202033,Staff,0,0,0,0
1683705196094,BENG 100,A01,254234,Taylor Amos; Alyssa C,31,0,40,9
1683705197118,BENG 196,001,270013,Engler; Adam J.,9999,0,9999,0
1683705198158,BICD 100R,A01,202018,Smith; Laurie,0,7,32,32
1683705198158,BICD 100R,A02,202019,Smith; Laurie,0,3,32,32
1683705198158,BICD 100R,A03,202020,Smith; Laurie,0,1,32,32
1683705198158,BICD 100R,A04,202021,Smith; Laurie,6,0,32,26
1683705198158,BICD 100R,A05,202022,Smith; Laurie,10,0,32,22
1683705199185,BICD 136,A01,193242,Gustafson-Brown; Cindy,0,2,32,32
1683705199185,BICD 136,A02,193244,Gustafson-Brown; Cindy,13,0,32,19
1683705200216,BIEB 102,A01,193249,Butler; Shannon Rhey,0,0,32,32
1683705200216,BIEB 102,A02,193251,Butler; Shannon Rhey,0,0,32,32
1683705200216,BIEB 102,A03,193253,Butler; Shannon Rhey,0,0,32,32
1683705200216,BIEB 102,A04,193255,Butler; Shannon Rhey,13,0,32,19
1683705200216,BIEB 102,A05,193265,Butler; Shannon Rhey,25,0,32,7
1683705200216,BIEB 102,A06,193269,Butler; Shannon Rhey,12,0,32,20
1683705202277,BIEB 150,A01,193274,Staff,0,0,32,32
1683705202277,BIEB 150,A02,193285,Staff,24,0,32,8
1683705203304,BIEB 194,A00,193286,Kurle; Carolyn M.,19,0,32,13
1683705204333,BILD 1,A01,192291,Staff,15,0,32,17
1683705204333,BILD 1,A02,192292,Staff,30,0,32,2
1683705204333,BILD 1,B01,192520,Reuther; Keefe,0,1,0,0
1683705204333,BILD 1,B02,192532,Reuther; Keefe,0,1,0,0
1683705205358,BILD 3,A01,192556,Butler; Shannon Rhey,0,0,32,32
1683705205358,BILD 3,A02,192581,Butler; Shannon Rhey,0,1,32,32
1683705205358,BILD 3,A03,192611,Butler; Shannon Rhey,19,0,32,13
1683705205358,BILD 3,A04,192612,Butler; Shannon Rhey,23,0,32,9
1683705205358,BILD 3,A05,192613,Butler; Shannon Rhey,26,0,32,6
1683705205358,BILD 3,A06,192679,Butler; Shannon Rhey,27,0,32,5
1683705205358,BILD 3,A07,192682,Butler; Shannon Rhey,20,0,32,12
1683705206384,BILD 4,A01,192836,Reuther; Keefe,1,0,24,23
1683705206384,BILD 4,A02,193044,Reuther; Keefe,4,0,24,20
1683705207416,BILD 10,A01,193142,Gustafson-Brown; Cindy,29,0,32,3
1683705207416,BILD 10,A02,193149,Gustafson-Brown; Cindy,31,0,32,1
1683705208440,BIMM 100,A01,193301,Staff,0,6,32,32
1683705208440,BIMM 100,A02,193312,Staff,0,7,32,32
1683705208440,BIMM 100,A03,193323,Staff,0,10,32,32
1683705209472,BIMM 101,A01,193329,McDonnell; Lisa Marie,0,3,24,24
1683705209472,BIMM 101,A02,193339,McDonnell; Lisa Marie,0,3,24,24
1683705209472,BIMM 101,B01,193354,McDonnell; Lisa Marie,0,4,24,24
1683705209472,BIMM 101,B02,193357,McDonnell; Lisa Marie,0,3,24,24
1683705210498,BIMM 110,A01,193377,Tat; John,0,11,32,32
1683705210498,BIMM 110,A02,193378,Tat; John,0,11,32,32
1683705211531,BIMM 120,A01,206116,Staff,0,0,32,32
1683705211531,BIMM 120,A02,206117,Staff,7,0,32,25
1683705211531,BIMM 120,A03,206121,Staff,21,0,32,11
1683705212565,BIPN 100,A01,193393,Park; Ji Young,0,15,32,32
1683705212565,BIPN 100,A02,193402,Park; Ji Young,0,14,32,32
1683705212565,BIPN 100,A03,193413,Park; Ji Young,0,14,32,32
1683705212565,BIPN 100,A04,193414,Park; Ji Young,0,13,32,32
1683705213597,BIPN 102,A01,193429,Staff,0,0,32,32
1683705213597,BIPN 102,A02,193438,Staff,18,0,32,14
1683705214624,BIPN 106,A01,193450,Reyes Gonzalez; Catalina,0,2,40,40
1683705215654,BIPN 134,A01,193465,Cooke; James Edward,0,0,32,32
1683705215654,BIPN 134,A02,193474,Cooke; James Edward,25,0,32,7
1683705215654,BIPN 134,A03,193485,Cooke; James Edward,29,0,32,3
1683705215654,BIPN 134,A04,193486,Cooke; James Edward,20,0,32,12
1683705215654,BIPN 134,A05,193491,Cooke; James Edward,31,0,32,1
1683705215654,BIPN 134,A06,193501,Cooke; James Edward,30,0,32,2
1683705215654,BIPN 134,A07,193510,Cooke; James Edward,29,0,32,3
1683705217712,BISP 194,A00,222522,Staff,14,0,32,18
1683705218735,CAT 124,A01,202407,Staff,19,0,25,6
1683705219767,CAT 125,A00,202408,Marchisotto; Jennifer Anne,2,0,20,18
1683705220795,CAT 125R,A00,202409,Smith; Lauryn Alissa,0,11,20,20
1683705220795,CAT 125R,B00,202410,Morales; Celeste Georgianna,0,11,20,20
1683705220795,CAT 125R,C00,202411,Irwin; Matthew Joseph,0,12,20,20
1683705221826,CENG 15,A01,204712,Yang; Kesong,0,1,0,0
1683705222854,CENG 114,A00,202070,Jahed Motlagh; Zeinab,5,0,20,15
1683705223880,CGS 105,A00,185477,Wesling; Megan E.,24,0,40,16
1683705224904,CGS 106,A00,185494,Staff,11,0,22,11
1683705225929,CGS 108,A00,185495,Staff,14,0,20,6
1683705226954,CGS 114,A00,185496,Staff,13,0,18,5
1683705227983,CGS 119,A00,185501,Staff,15,0,20,5
1683705229008,CGS 120,A00,185511,Staff,11,0,20,9
1683705230041,CHEM 4,A01,184675,Bussey; Thomas J,97,0,100,3
1683705231066,CHEM 6A,A01,184677,Staff,32,0,60,28
1683705232091,CHEM 6B,A01,184679,Staff,63,0,100,37
1683705233123,CHEM 6C,A01,184681,Bussey; Thomas J,0,0,50,50
1683705233123,CHEM 6C,A02,184682,Bussey; Thomas J,32,0,50,18
1683705234152,CHEM 40A,A01,184684,Albizati; Kim F.,33,0,100,67
1683705235177,CHEM 40B,A01,184686,Albizati; Kim F.,0,22,100,100
1683705236208,CHEM 41B,A01,184690,Staff,51,0,100,49
1683705237235,COGS 3,A01,184715,Boyle; Mary E. T.,0,27,40,40
1683705238260,COGS 14B,A01,185172,Staff,0,14,38,38
1683705239286,COGS 18,A01,184736,Staff,14,0,80,66
1683705240313,COGS 100,A01,184932,Staff,0,8,73,73
1683705241338,COGS 101A,A01,184935,Staff,0,40,30,30
1683705242365,COGS 101B,A01,184944,Staff,0,2,30,30
1683705243394,COGS 101C,A01,184946,Staff,0,10,30,30
1683705244420,COGS 102A,A01,184951,Johnson; Christine M.,1,0,40,39
1683705245455,COGS 107B,A01,184953,Mooshagian; Eric Frederick,0,52,40,40
1683705246540,COGS 118B,A01,184959,Gupta; Anjum,0,50,40,40
1683705247565,COGS 153,A00,184961,Staff,1,16,30,29
1683705248592,COGS 177,A00,184962,Staff,0,20,30,30
1683705249620,COGS 187A,A01,184969,Boyle; Mary E. T.,0,19,40,40
1683705250647,COMM 10,A01,185174,Staff,0,5,25,25
1683705250647,COMM 10,A02,185189,Staff,0,2,25,25
1683705250647,COMM 10,A03,269821,Staff,0,1,0,0
1683705251678,COMM 100B,A02,185476,Staff,10,0,25,15
1683705251678,COMM 100B,A03,277340,Staff,25,0,25,0
1683705252707,COMM 100C,A01,185314,Staff,2,0,25,23
1683705252707,COMM 100C,A02,185327,Staff,17,0,25,8
1683705253731,COMM 110M,A00,185349,Staff,0,0,40,40
1683705254759,COMM 113T,A00,185352,Staff,25,0,40,15
1683705255787,COMM 114I,A00,185353,Staff,31,0,40,9
1683705256815,COMM 131,A00,185354,Staff,17,0,30,13
1683705257847,CSE 8A,A50,185358,Cao; Yingjun,0,46,10,10
1683705258875,CSE 8B,A01,185362,Staff,0,48,50,50
1683705259905,CSE 11,A01,185416,Cao; Yingjun,0,91,10,10
1683705260933,CSE 20,A01,185445,Briones; Jor-el Thomas Caparas,3,0,25,22
1683705261961,CSE 21,A01,185447,Staff,9,0,50,41
1683705262993,CSE 101,A01,185451,Staff,0,13,50,50
1683705262993,CSE 101,B01,185453,Jones; Miles E,0,15,50,50
1683705265044,CSE 141,A01,185458,Eldon; John,16,0,100,84
1683705266072,CSE 141L,A01,185461,Eldon; John,8,0,100,92
1683705267102,CSE 142,A01,185463,Staff,34,0,60,26
1683705267102,CSE 142,B01,201355,Staff,0,7,60,60
1683705268130,CSE 142L,A01,185470,Staff,34,0,60,26
1683705268130,CSE 142L,B01,201417,Staff,0,6,60,60
1683705269155,CSE 190,A00,201433,Staff,32,0,49,17
1683705270182,DOC 1,A01,259136,Strom; Megan C.,7,0,15,8
1683705270182,DOC 1,A02,259137,Strom; Megan C.,15,0,15,0
1683705270182,DOC 1,A03,259138,Strom; Megan C.,14,0,15,1
1683705270182,DOC 1,A04,259139,Strom; Megan C.,14,0,15,1
1683705271205,DOC 100D,A00,259140,Pass; Natalye Joann,14,0,25,11
1683705272230,DSGN 1,A01,184749,Rill; Bryan,0,26,30,30
1683705273256,DSGN 100,A01,185168,Staff,0,2,25,25
1683705274287,ECE 5,A01,185626,Morris; Karcher William,0,12,0,0
1683705275312,ECE 101,A01,185628,Staff,14,0,70,56
1683705276338,ECE 107,A01,185635,Baghdadchi; Saharnaz,0,0,20,20
1683705276338,ECE 107,A02,185638,Baghdadchi; Saharnaz,1,0,20,19
1683705277364,ECE 148,A01,185647,Silberman; Jack,0,0,16,16
1683705278400,ECON 1,A01,185537,Crane; Meredith Helen,54,0,70,16
1683705279437,ECON 3,A01,185549,Crane; Meredith Helen,30,0,70,40
1683705280463,ECON 4,A01,203354,Anderson; John Charles,0,5,10,10
1683705281487,ECON 100A,A01,185574,Staff,0,5,40,40
1683705282514,ECON 100B,A01,185576,Staff,0,12,50,50
1683705283540,ECON 100C,A01,185589,Newhouse; Herbert S,30,0,70,40
1683705284565,ECON 105,A00,185608,Vespa; Emanuel Ignacio,19,0,35,16
1683705285591,ECON 109,A01,185610,Shishkin; Denis,9,0,35,26
1683705286616,ECON 110A,A01,185612,Staff,8,0,40,32
1683705287644,ECON 120A,A01,185615,Staff,19,0,40,21
1683705288674,ECON 120C,A01,185617,Sun; Yixiao,0,21,70,70
1683705289707,ECON 144,A00,203346,Squires; Dale E,2,0,35,33
1683705290736,ECON 171,A01,203349,Newhouse; Herbert S,0,1,35,35
1683705291763,ECON 173A,A01,185621,Toda; Alexis Akira,21,0,35,14
1683705292797,EDS 25,A01,202413,Staff,0,1,0,0
1683705292797,EDS 25,A02,202414,Staff,0,1,0,0
1683705292797,EDS 25,A03,202415,Staff,0,0,0,0
1683705292797,EDS 25,A04,202416,Staff,0,1,0,0
1683705292797,EDS 25,A05,202439,Staff,0,0,0,0
1683705292797,EDS 25,A06,202440,Staff,0,0,0,0
1683705292797,EDS 25,B01,202631,Staff,0,0,0,0
1683705292797,EDS 25,B02,202632,Staff,0,0,0,0
1683705292797,EDS 25,B03,202639,Staff,0,0,0,0
1683705292797,EDS 25,B04,202640,Staff,0,0,0,0
1683705292797,EDS 25,B05,202643,Staff,0,0,0,0
1683705292797,EDS 25,B06,202644,Staff,0,0,0,0
1683705293822,EDS 38,A01,202659,Black; Alison Michelle,25,0,25,0
1683705294850,EDS 115,A00,202652,Staff,18,0,30,12
1683705295876,EDS 125,A00,202649,Staff,13,0,30,17
1683705296901,EDS 126,A01,203332,Staff,30,0,30,0
1683705297925,EDS 139,A00,202838,Staff,16,0,25,9
1683705298956,EDS 146,A01,202655,Staff,14,0,25,11
1683705299987,ENG 15,A00,185667,Staff,0,1,0,0
1683705299987,ENG 15,B00,185672,Staff,0,0,0,0
1683705299987,ENG 15,C00,185675,Staff,0,0,0,0
1683705299987,ENG 15,D00,185682,Staff,0,0,0,0
1683705299987,ENG 15,E00,185684,Staff,0,0,0,0
1683705301018,ETHN 103,A00,185710,Staff,0,8,35,35
1683705302046,ETHN 103A,A00,199228,Man; Simeon S,0,0,9,9
1683705303073,ETHN 109,A00,185711,Staff,15,0,35,20
1683705304097,ETHN 142,A00,185726,Staff,0,4,30,30
1683705305128,ETHN 163J,A00,199229,Man; Simeon S,5,0,8,3
1683705306155,ETHN 168,A00,185727,Staff,7,0,10,3
1683705307184,ETHN 182,A00,185728,Staff,0,0,35,35
1683705308211,ETHN 183,A00,185737,Staff,9,0,18,9
1683705309241,GLBH 111,A01,209361,Burgos; Jose L.,0,0,0,0
1683705311296,HIEU 104,A00,185792,Staff,14,0,20,6
1683705312325,HIEU 115,A00,185800,Staff,0,0,20,20
1683705313353,HIEU 128,A00,185801,Staff,0,9,20,20
1683705314378,HIEU 147,A00,185802,Staff,15,0,20,5
1683705315403,HIEU 154,A00,185823,Staff,11,0,20,9
1683705316428,HILA 102,A00,185826,Staff,14,0,20,6
1683705317454,HILD 2C,A01,185778,Staff,0,13,20,20
1683705318479,HILD 7B,A01,185780,Kwak; Nancy,0,17,32,32
1683705318479,HILD 7B,A02,185781,Kwak; Nancy,0,18,32,32
1683705319504,HILD 30,A01,185791,Staff,12,0,20,8
1683705320530,HISC 119,A00,185830,Golan; Tal,0,10,20,20
1683705321556,HITO 156GS,A00,185831,Patterson; Patrick H.,0,0,0,23
1683705322585,HIUS 103,A00,185832,Man; Simeon S,0,4,20,20
1683705323612,HIUS 117,A00,185836,Kwak; Nancy,2,0,20,18
1683705324638,HIUS 125,A00,185840,Man; Simeon S,0,2,23,23
1683705325664,HIUS 149,A00,185845,Staff,1,0,20,19
1683705326698,HUM 3,A01,185882,Zavodny; Tatiana Sophia,0,8,50,50
1683705326698,HUM 3,B01,185899,Caldwell; Michael Alan,0,18,50,50
1683705327725,HUM 3GS,A00,185900,Patterson; Patrick H.,0,0,0,23
1683705328752,HUM 4,A01,185938,Zroka; Amy Liane,28,0,50,22
1683705328752,HUM 4,B01,185956,Watkins; Eric,0,6,50,50
1683705328752,HUM 4,B02,202209,Watkins; Eric,0,5,50,50
1683705328752,HUM 4,B03,202210,Watkins; Eric,0,5,50,50
1683705329782,HUM 5,A01,185958,West; Geoffrey Scott,0,0,50,50
1683705329782,HUM 5,A02,202215,West; Geoffrey Scott,0,1,50,50
1683705330809,INTL 190,A00,185959,Gagnon; Jeffrey C,0,0,0,9
1683705330809,INTL 190,B00,185960,Lettieri; Michael Joseph,0,0,0,2
1683705331833,JAPN 180,A00,254509,Staff,5,0,30,25
1683705332869,LATI 10,A01,202853,Kennemore; Amy Michelle,4,0,35,31
1683705332869,LATI 10,A02,202854,Kennemore; Amy Michelle,3,0,35,32
1683705332869,LATI 10,A03,270054,Kennemore; Amy Michelle,30,0,30,0
1683705333894,LATI 180,A00,202855,Kennemore; Amy Michelle,11,0,20,9
1683705334924,LAWS 101,A00,201767,Golan; Tal,0,7,40,40
1683705335953,LIFR 1C,A00,185961,Staff,6,0,20,14
1683705336982,LIFR 1CX,A00,185962,Staff,7,0,20,13
1683705338006,LIFR 1D,A00,185963,Staff,7,0,20,13
1683705339030,LIFR 1DX,A00,185964,Staff,7,0,20,13
1683705340057,LIGN 101,A01,186039,Staff,43,0,50,7
1683705341082,LIGN 165,A00,186040,Staff,14,0,50,36
1683705342110,LTCS 108,A00,186041,Staff,5,0,10,5
1683705343137,LTCS 119,A00,186042,Staff,15,0,20,5
1683705344163,LTCS 130,A00,186043,Wesling; Megan E.,15,0,25,10
1683705346219,LTEA 138,A00,186119,Staff,14,0,40,26
1683705347245,LTEN 124,A00,186148,Staff,5,0,25,20
1683705348270,LTEN 178,A00,186149,Staff,6,0,15,9
1683705349302,LTEN 181,A00,186150,Blanco; John D,34,0,40,6
1683705350387,LTWL 120,A00,186160,Staff,19,0,25,6
1683705351412,LTWL 165,A00,186161,Staff,22,0,25,3
1683705352436,LTWR 100,A00,186162,Staff,0,5,15,15
1683705353465,LTWR 102,A00,186163,Doller; Ben,5,0,15,10
1683705354496,MAE 8,A01,186412,Staff,0,1,0,0
1683705355523,MAE 30B,A00,186445,Bahadori; Mohammad Yousef,81,0,100,19
1683705356548,MAE 40,A00,186592,Bewley; Thomas R,10,0,50,40
1683705357574,MAE 101B,A00,186593,Bahadori; Mohammad Yousef,80,0,100,20
1683705358601,MAE 105,A00,186594,Bandaru; Prabhakar,10,0,50,40
1683705359627,MAE 107,A00,186599,Pham; Hieu Tan,0,8,120,120
1683705360659,MAE 148,A01,186660,Silberman; Jack,3,0,16,13
1683705361685,MATH 10A,A01,188095,Staff,0,6,35,35
1683705362713,MATH 10B,A01,188097,Bowers; Adam R.,0,12,30,30
1683705362713,MATH 10B,A02,188099,Bowers; Adam R.,0,11,30,30
1683705362713,MATH 10B,B01,188104,Bowers; Adam R.,0,10,30,30
1683705362713,MATH 10B,B02,188106,Bowers; Adam R.,0,9,30,30
1683705363747,MATH 10C,A01,188111,Staff,0,20,30,30
1683705363747,MATH 10C,A02,188127,Staff,0,19,30,30
1683705363747,MATH 10C,A03,188131,Staff,0,19,30,30
1683705363747,MATH 10C,B01,188218,Staff,17,0,30,13
1683705363747,MATH 10C,B02,188244,Staff,13,0,30,17
1683705363747,MATH 10C,B03,188277,Staff,14,0,30,16
1683705364773,MATH 18,A01,188344,Bach; Quang Tran,18,0,30,12
1683705364773,MATH 18,A02,188345,Bach; Quang Tran,11,0,30,19
1683705364773,MATH 18,B01,188353,Bach; Quang Tran,11,0,30,19
1683705364773,MATH 18,B02,188354,Bach; Quang Tran,19,0,30,11
1683705365803,MATH 20A,A01,188374,Staff,11,0,35,24
1683705366832,MATH 20B,A01,188382,Ohm; Ko Woon,7,0,30,23
1683705366832,MATH 20B,A02,188383,Ohm; Ko Woon,22,0,30,8
1683705366832,MATH 20B,B01,188385,Ohm; Ko Woon,7,0,30,23
1683705366832,MATH 20B,B02,188392,Ohm; Ko Woon,22,0,30,8
1683705367864,MATH 20C,A01,188394,Harel; Guershon,10,0,30,20
1683705367864,MATH 20C,A02,188395,Harel; Guershon,13,0,30,17
1683705367864,MATH 20C,B01,188404,Harel; Guershon,5,0,30,25
1683705367864,MATH 20C,B02,188405,Harel; Guershon,18,0,30,12
1683705368899,MATH 20D,A01,188414,Hammock; Frances H,0,1,30,30
1683705368899,MATH 20D,A02,188415,Hammock; Frances H,0,1,30,30
1683705368899,MATH 20D,B01,188447,Hammock; Frances H,0,1,30,30
1683705368899,MATH 20D,B02,188486,Hammock; Frances H,2,0,30,28
1683705369926,MATH 20E,A01,188649,Staff,21,0,30,9
1683705369926,MATH 20E,A02,188650,Staff,20,0,30,10
1683705369926,MATH 20E,A03,188673,Staff,0,0,30,30
1683705370956,MATH 102,A01,188675,Staff,0,40,35,35
1683705371987,MATH 103B,A01,188681,Staff,3,0,35,32
1683705371987,MATH 103B,B01,188692,Staff,5,0,35,30
1683705373014,MATH 109,A01,188695,Salehi Golsefidy; Alireza,24,0,35,11
1683705373014,MATH 109,A02,188696,Salehi Golsefidy; Alireza,25,0,35,10
1683705374041,MATH 120A,A01,188698,Eggers; John Dietrich,7,0,35,28
1683705375068,MATH 142B,A01,188736,Ioana; Adrian,0,0,30,30
1683705375068,MATH 142B,A02,188741,Ioana; Adrian,0,1,30,30
1683705375068,MATH 142B,A03,188743,Ioana; Adrian,0,2,30,30
1683705376095,MATH 168A,A01,188790,Staff,0,11,35,35
1683705377122,MATH 170A,A01,188803,Nie; Jiawang,0,2,35,35
1683705377122,MATH 170A,A02,188811,Nie; Jiawang,0,1,35,35
1683705377122,MATH 170A,A03,188814,Nie; Jiawang,0,0,35,35
1683705377122,MATH 170A,A04,188815,Nie; Jiawang,5,0,35,30
1683705378149,MATH 193B,A01,188817,Staff,0,0,35,35
1683705378149,MATH 193B,A02,188818,Staff,6,0,35,29
1683705379181,MGT 4,A01,202857,Anderson; John Charles,59,0,80,21
1683705380207,MGT 12,A00,202858,Lindenberger; Wade Douglas,40,0,90,50
1683705381234,MGT 18,A00,202859,Staff,73,0,90,17
1683705382264,MGT 18GS,A00,202860,McKay; Michael J,13,0,28,15
1683705383296,MGT 45,A00,202861,Pecore; Joseph P.,8,0,90,82
1683705384322,MGT 100,A00,202863,Yavorsky; Daniel Ryan,27,0,90,63
1683705385350,MGT 103,A00,202864,Ehrich; Kristine R,0,19,90,90
1683705386375,MGT 112,A00,202865,Ehrich; Kristine R,15,0,90,75
1683705387407,MGT 121A,A00,202868,Staff,70,0,90,20
1683705388434,MGT 131B,A00,202869,Anderson; John Charles,58,0,90,32
1683705389467,MGT 136,A00,202871,Lindenberger; Wade Douglas,83,0,90,7
1683705390495,MGT 164,A00,202873,Staff,0,67,90,91
1683705391525,MGT 164GS,A00,202874,McKay; Mary A,13,0,28,15
1683705392550,MGT 180,A00,202875,Staff,0,51,90,91
1683705393576,MMW 11R,A01,205019,Herbst; Matthew,0,0,30,30
1683705393576,MMW 11R,A02,205026,Herbst; Matthew,29,0,30,1
1683705394604,MMW 15,A01,193512,Chang; Edmond Yi-Teh,0,8,28,28
1683705394604,MMW 15,A02,193513,Chang; Edmond Yi-Teh,0,5,28,28
1683705394604,MMW 15,A03,193514,Chang; Edmond Yi-Teh,0,5,28,28
1683705394604,MMW 15,A04,193515,Chang; Edmond Yi-Teh,0,5,28,28
1683705394604,MMW 15,A05,193516,Chang; Edmond Yi-Teh,0,5,28,28
1683705394604,MMW 15,A06,193517,Chang; Edmond Yi-Teh,0,6,28,28
1683705394604,MMW 15,B01,193519,Chang; Edmond Yi-Teh,0,5,28,28
1683705394604,MMW 15,B02,193520,Chang; Edmond Yi-Teh,0,5,28,28
1683705394604,MMW 15,B03,193521,Chang; Edmond Yi-Teh,0,5,28,28
1683705394604,MMW 15,B04,193522,Chang; Edmond Yi-Teh,0,6,28,28
1683705394604,MMW 15,B05,193523,Chang; Edmond Yi-Teh,0,5,28,28
1683705394604,MMW 15,B06,193524,Chang; Edmond Yi-Teh,0,5,28,28
1683705395630,MMW 122,A01,193526,Rahimi; Babak,0,16,28,28
1683705395630,MMW 122,A02,193527,Rahimi; Babak,0,15,28,28
1683705395630,MMW 122,A03,193528,Rahimi; Babak,0,0,0,0
1683705395630,MMW 122,A04,193529,Rahimi; Babak,0,0,0,0
1683705396660,MUS 1A,A01,186663,Staff,0,18,35,35
1683705397690,MUS 4,A01,186715,Staff,0,12,35,35
1683705398716,MUS 5R,A01,186796,Dubnov; Shlomo,0,17,35,35
1683705399741,MUS 6,A01,186798,Staff,0,4,25,25
1683705400770,MUS 7,A01,186830,Staff,11,0,35,24
1683705401801,MUS 8,A01,186930,Staff,0,27,35,35
1683705402829,MUS 15,A01,186932,Staff,0,15,35,35
1683705402829,MUS 15,B01,186934,Staff,0,16,35,35
1683705403857,MUS 80,A00,186935,Staff,0,0,20,20
1683705403857,MUS 80,B00,186936,Staff,24,0,25,1
1683705404886,NANO 11,A00,204702,Lipomi; Darren John,0,0,0,0
1683705405917,NANO 15,A01,204709,Yang; Kesong,0,1,0,0
1683705406947,NANO 114,A00,202069,Jahed Motlagh; Zeinab,2,0,10,8
1683705407978,PHIL 1,A00,186955,Grush; Rick Scott,31,0,40,9
1683705409012,PHIL 10,A01,186973,Grush; Rick Scott,27,0,35,8
1683705409012,PHIL 10,A02,186974,Grush; Rick Scott,33,0,35,2
1683705410038,PHIL 13,A01,186976,Staff,1,0,35,34
1683705410038,PHIL 13,A02,186977,Staff,16,0,35,19
1683705411067,PHIL 14,A01,186979,Staff,30,0,35,5
1683705411067,PHIL 14,A02,186986,Staff,32,0,35,3
1683705412092,PHIL 28,A01,186988,Staff,16,0,30,14
1683705412092,PHIL 28,A02,186989,Staff,0,0,30,30
1683705412092,PHIL 28,A03,186990,Staff,10,0,30,20
1683705412092,PHIL 28,A04,186991,Staff,26,0,30,4
1683705413120,PHIL 120,A00,186997,Staff,23,0,40,17
1683705414151,PHIL 137,A00,187003,Staff,7,0,40,33
1683705415179,PHIL 150,A00,187015,Staff,47,0,70,23
1683705416206,PHIL 167,A00,187021,Lamey; Andy M.,34,0,40,6
1683705417231,PHIL 174,A01,202226,Staff,17,0,20,3
1683705417231,PHIL 174,A02,202235,Staff,20,0,20,0
1683705418255,PHIL 191A,A00,258918,Staff,0,0,1,1
1683705419279,PHYS 1A,A00,187028,Staff,26,0,60,34
1683705420306,PHYS 1AL,001,187036,Staff,3,0,30,27
1683705420306,PHYS 1AL,002,187049,Staff,18,0,30,12
1683705421334,PHYS 1B,A00,187058,Staff,21,0,60,39
1683705422366,PHYS 1BL,001,187064,Staff,0,1,30,30
1683705422366,PHYS 1BL,002,187070,Staff,4,0,30,26
1683705423397,PHYS 1C,A00,187082,Staff,30,0,120,90
1683705424422,PHYS 1CL,001,187088,Staff,0,9,30,30
1683705424422,PHYS 1CL,002,187089,Staff,0,1,30,30
1683705424422,PHYS 1CL,009,262693,Staff,9,0,30,21
1683705425454,PHYS 2B,A01,187097,Staff,55,0,115,60
1683705426481,PHYS 2C,A01,187099,Staff,63,0,115,52
1683705427508,PHYS 2CL,A01,187101,Staff,5,0,28,23
1683705427508,PHYS 2CL,A02,187102,Staff,15,0,28,13
1683705428542,PHYS 2D,A01,187123,Shotwell; Brian,95,0,115,20
1683705429575,PHYS 4B,A01,187133,Grinstein; Benjamin,35,0,50,15
1683705430601,POLI 10,A00,188819,Staff,0,4,50,50
1683705431625,POLI 11,A00,188827,Staff,43,0,50,7
1683705432651,POLI 13R,A00,188828,Staff,0,1,20,20
1683705433680,POLI 27,A01,188830,Elgin; Samuel Zincke,0,2,70,70
1683705434708,POLI 30,A00,188832,Desposato; Scott,30,0,50,20
1683705435737,POLI 102F,A00,188834,Staff,1,0,40,39
1683705436765,POLI 104A,A00,188852,Staff,12,0,30,18
1683705437793,POLI 104I,A00,188853,Staff,0,8,20,20
1683705438819,POLI 110B,A00,188854,Wiens; David,6,0,20,14
1683705439848,POLI 112A,A00,188855,Wiens; David,3,0,30,27
1683705440879,POLI 117R,A00,188856,Forman; Fonna,0,12,20,20
1683705441908,POLI 118,A00,188857,Ingham; Sean,8,0,20,12
1683705442934,POLI 120G,A00,188858,Staff,7,0,30,23
1683705443958,POLI 131CR,A00,188863,Hoston; Germaine,20,0,50,30
1683705444984,POLI 133,A00,188864,Nellis; Gareth Hb,44,0,50,6
1683705446013,POLI 134D,A00,188865,Desposato; Scott,27,0,30,3
1683705447048,POLI 142A,A00,188871,Gartzke; Erik,21,0,50,29
1683705448072,POLI 142K,A00,188874,Staff,38,0,50,12
1683705449098,POLI 143,A00,188940,Gartzke; Erik,15,0,30,15
1683705450124,POLI 153,A00,188943,Staff,1,0,20,19
1683705451151,POLI 160AA,A00,188944,Staff,10,0,40,30
1683705452180,POLI 170A,A00,188945,Staff,10,0,30,20
1683705454287,PSYC 1,A00,188952,Staff,36,0,90,54
1683705455312,PSYC 2,B00,188953,Staff,19,0,35,16
1683705456344,PSYC 6,A00,188970,Staff,47,0,60,13
1683705457374,PSYC 7,A00,188973,Staff,35,0,45,10
1683705458403,PSYC 60,A01,188980,Rickard; Timothy C.,42,0,60,18
1683705459430,PSYC 70,A01,189001,Steiner; Eric Tomas,22,0,45,23
1683705460457,PSYC 100,A00,189005,Lacefield; Katharine I,1,98,120,119
1683705461485,PSYC 102,A00,189008,Staff,6,0,30,24
1683705462510,PSYC 106,B00,189026,Gorman; Michael R.,27,0,60,33
1683705463535,PSYC 114,B01,189033,Winkielman; Piotr,0,31,30,30
1683705464564,PSYC 131,A00,189036,Anagnostaras; Stephan,0,44,60,60
1683705465594,PSYC 136,A00,189041,Lowe; Angela Beth,0,7,25,25
1683705466619,PSYC 137,A00,189057,Winkielman; Piotr,0,36,25,25
1683705467644,PSYC 144,A00,189107,Wixted; John T,0,11,50,50
1683705469695,PSYC 162,A00,189142,Staff,0,9,85,85
1683705470725,PSYC 172,A00,189144,Gorman; Michael R.,0,6,30,30
1683705472774,PSYC 179,A00,189146,Lacefield; Katharine I,0,88,120,120
1683705473801,PSYC 181,A00,189147,Anagnostaras; Stephan,0,45,90,90
1683705474827,PSYC 190R,A00,189148,Barner; David A.,0,23,80,80
1683705475853,PSYC 191,A00,189275,Rickard; Timothy C.,0,11,25,25
1683705476879,PSYC 193,A00,189276,Chapman; Eddie Nathaniel,0,1,0,4
1683705477905,PSYC 193L,A01,189281,Lowe; Angela Beth,8,0,20,12
1683705477905,PSYC 193L,B01,189285,Staff,28,0,35,7
1683705478933,RELI 149,A00,187137,Rahimi; Babak,6,0,40,34
1683705479957,SE 9,A01,187315,Staff,0,2,18,18
1683705480986,SE 101B,A00,187409,Staff,24,0,30,6
1683705482021,SE 110B,A00,187444,Staff,10,0,40,30
1683705483051,SE 130B,A00,187449,Staff,31,0,40,9
1683705484076,SE 150A,A00,187516,Staff,8,0,20,12
1683705485105,SE 154,A00,187528,Staff,29,0,50,21
1683705486132,SIO 3,A01,258171,Staff,35,0,40,5
1683705487161,SIO 10,A00,187144,Cook; Geoffrey W,0,6,75,75
1683705488186,SIO 45,A00,187152,Cook; Geoffrey W,1,7,100,99
1683705489220,SIO 109R,A00,194486,Staff,0,4,20,20
1683705491271,SIO 187,A01,187233,Kacev; David,12,0,40,28
1683705492308,SOCI 1,A01,258656,Thorpe; Charles Robert,28,0,30,2
1683705492308,SOCI 1,A02,258658,Thorpe; Charles Robert,30,0,30,0
1683705492308,SOCI 1,A03,258661,Thorpe; Charles Robert,25,0,25,0
1683705492308,SOCI 1,A04,258666,Thorpe; Charles Robert,22,0,25,3
1683705492308,SOCI 1,A05,258897,Thorpe; Charles Robert,22,0,25,3
1683705492308,SOCI 1,A06,258898,Thorpe; Charles Robert,25,0,25,0
1683705493334,SOCI 30,A01,258903,Pardo Guerra; Juan Pablo,14,0,30,16
1683705494362,SOCI 102,A00,258904,Staff,9,0,25,16
1683705495391,SOCI 106,A00,258905,Staff,19,0,25,6
1683705496416,SOCI 111,A00,258907,Ribas Norris; Janet Vanesa,26,0,30,4
1683705497442,SOCI 121R,A00,258908,Pardo Guerra; Juan Pablo,7,0,30,23
1683705498468,SOCI 126,A01,203330,Staff,14,0,20,6
1683705499502,SOCI 131,A00,258909,Thorpe; Charles Robert,30,0,60,30
1683705500532,SOCI 135,A00,258910,Payne; Christine Anna,0,13,30,30
1683705501557,SOCI 157,A00,258911,Staff,10,0,30,20
1683705502583,SOCI 184,A00,258912,Staff,25,0,30,5
1683705503607,SOCI 188D,A00,258913,Staff,22,0,30,8
1683705504641,SYN 2,001,187529,Staff,9,0,16,7
1683705504641,SYN 2,002,201452,Staff,0,20,16,16
1683705504641,SYN 2,003,201469,Staff,1,0,16,15
1683705505670,SYN 100,A01,187531,Staff,0,9,20,20
1683705505670,SYN 100,B01,201491,Staff,0,10,20,20
1683705506694,TDAC 1,A00,189286,Walsh; Kim C.,3,0,20,17
1683705506694,TDAC 1,B00,189287,Harting; Carla Kelso,10,0,20,10
1683705507723,TDAC 101,A00,189300,Walsh; Kim C.,16,0,20,4
1683705507723,TDAC 101,B00,189301,Harting; Carla Kelso,18,0,20,2
1683705508753,TDAC 102,A00,189304,Basso; Beatrice,14,0,20,6
1683705509781,TDAC 108,A00,189305,Staff,18,0,20,2
1683705510809,TDDE 131,A00,189310,Staff,19,0,20,1
1683705510809,TDDE 131,B00,189314,Staff,19,0,20,1
1683705510809,TDDE 131,C00,189315,Staff,48,0,50,2
1683705510809,TDDE 131,D00,189316,Staff,14,0,15,1
1683705510809,TDDE 131,E00,204841,Staff,20,0,20,0
1683705511840,TDGE 10,A00,189289,Staff,27,0,50,23
1683705511840,TDGE 10,B00,189290,Havis; Allan,0,1,50,50
1683705512867,TDGE 11,A00,189291,Fulton; Julia,0,4,50,50
1683705512867,TDGE 11,B00,189292,Staff,20,0,25,5
1683705512867,TDGE 11,C00,260270,Staff,0,0,0,0
1683705513895,TDGE 25,A00,189294,Staff,1,0,20,19
1683705514923,TDGE 124,A00,189318,Fulton; Julia,0,7,50,50
1683705515948,TDGE 125,A00,189319,Staff,13,0,25,12
1683705515948,TDGE 125,B00,189320,Staff,23,0,25,2
1683705516979,TDGE 127,A00,189322,Havis; Allan,1,0,50,49
1683705518007,TDHT 101,A00,189323,Staff,18,0,25,7
1683705518007,TDHT 101,B00,189324,Staff,25,0,25,0
1683705519039,TDHT 102,A00,189325,Staff,49,0,50,1
1683705520065,TDMV 1,A00,189295,Arcidiacono; Kristin,20,0,30,10
1683705520065,TDMV 1,B00,189296,Caligagan; Maria T.,23,0,30,7
1683705521094,TDMV 2,A00,189297,Sammartano; Tonnie,27,0,30,3
1683705521094,TDMV 2,B00,189299,Arcidiacono; Kristin,23,0,30,7
1683705522120,TDMV 3,A00,204998,Rincon; Alicia,22,0,30,8
1683705523145,TDMV 120,A00,189458,Sammartano; Tonnie,28,0,30,2
1683705524172,TDMV 138,A00,189541,Jun; Grace Shin Hae,20,0,40,20
1683705525196,TDMV 142,A00,189717,Caligagan; Tony,25,0,30,5
1683705525196,TDMV 142,B00,189718,Caligagan; Maria T.,25,0,30,5
1683705526222,TMC 2,A01,187533,Staff,25,0,25,0
1683705526222,TMC 2,A02,187534,Staff,25,0,25,0
1683705527249,USP 1,A01,187536,Kwak; Nancy,0,16,25,25
1683705528273,USP 5,A01,187538,Staff,8,0,25,17
1683705529298,USP 101,A00,199253,Staff,0,4,0,0
1683705530333,USP 124,A00,187562,Boomhower; Matthew Charles,0,0,30,30
1683705531364,USP 138,A00,187582,Staff,19,0,25,6
1683705532395,USP 152,A01,187597,Staff,3,0,25,22
1683705533420,USP 153,A00,187598,Staff,18,0,25,7
1683705534446,USP 168,A00,187607,Kwak; Nancy,2,0,5,3
1683705535474,USP 173,A00,187619,Staff,4,0,25,21
1683705536499,USP 181,A00,187638,Staff,0,4,25,25
1683705537530,VIS 103,A00,187650,Cruz; Edwin Teddy,17,0,75,58
1683705538556,VIS 110D,A00,187669,Staff,13,0,22,9
1683705539582,VIS 127C,A00,187720,Shen; Kuiyi,67,0,146,79
1683705540612,VIS 149,A00,187731,Yoldas; Pinar,0,12,22,22
1683705541640,VIS 151,A01,188091,Staff,22,0,34,12
1683705541640,VIS 151,A02,188092,Staff,11,0,34,23
1683705542665,VIS 160B,A00,188093,Stalbaum; Brett,0,1,10,10
1683705544729,WCWP 10B,A00,201720,Staff,0,0,5,5
1683705544729,WCWP 10B,B00,201722,Staff,0,0,6,6
1683705545755,WCWP 100,A00,201725,Gagnon; Jeffrey C,0,0,2,2
1683705545755,WCWP 100,B00,201727,Staff,0,4,15,15
1683705548948,ANBI 133,A00,258401,Wilder; Linnea Lorene,34,0,40,6
1683705549982,ANBI 140,A00,258395,Hrvoj Mihic; Branka,18,0,25,7
1683705551008,ANSC 120,A00,258402,Bialecki; Jon Anthony,26,0,40,14
1683705552032,ANSC 144,A00,258400,Staff,12,0,40,28
1683705554082,ANSC 166,A00,258396,Parish; Steven Martin,156,0,175,19
1683705555108,ANSC 180,A00,193533,Staff,8,0,20,12
1683705556137,ANSC 188,A00,258397,Jassal; Aftab,34,0,40,6
1683705557163,ANTH 3,A01,258316,Staff,23,0,30,7
1683705558244,ANTH 5,A00,258394,Semendeferi; Ekaterini,16,0,20,4
1683705559268,ANTH 21,A01,258331,Staff,4,0,40,36
1683705560294,ANTH 103,A00,258398,Varma; Saiba,15,0,25,10
1683705561325,AWP 10,001,202034,Staff,0,0,0,0
1683705561325,AWP 10,002,202035,Staff,0,0,0,0
1683705561325,AWP 10,003,202036,Staff,0,0,0,0
1683705561325,AWP 10,004,202037,Staff,0,0,0,0
1683705561325,AWP 10,005,202038,Staff,0,0,0,0
1683705561325,AWP 10,006,202039,Staff,0,0,0,0
1683705561325,AWP 10,007,202040,Staff,0,0,0,0
1683705561325,AWP 10,008,202041,Staff,0,0,0,0
1683705561325,AWP 10,009,202042,Staff,0,0,0,0
1683705561325,AWP 10,010,202043,Staff,0,0,0,0
1683705561325,AWP 10,011,202044,Staff,0,0,0,0
1683705561325,AWP 10,012,202045,Staff,0,0,0,0
1683705561325,AWP 10,013,202046,Staff,0,0,0,0
1683705561325,AWP 10,014,202047,Staff,0,0,0,0
1683705561325,AWP 10,015,202048,Staff,0,0,0,0
1683705561325,AWP 10,016,202049,Staff,0,0,0,0
1683705561325,AWP 10,017,202050,Staff,0,0,0,0
1683705561325,AWP 10,018,202051,Staff,0,0,0,0
1683705561325,AWP 10,019,202052,Staff,0,0,0,0
1683705561325,AWP 10,020,202053,Staff,0,0,0,0
1683705561325,AWP 10,021,202054,Staff,0,0,0,0
1683705561325,AWP 10,022,202055,Staff,0,0,0,0
1683705561325,AWP 10,023,202056,Staff,0,0,0,0
1683705561325,AWP 10,024,202057,Staff,0,0,0,0
1683705561325,AWP 10,025,202058,Staff,0,0,0,0
1683705561325,AWP 10,026,202059,Staff,0,0,0,0
1683705562349,AWP 102,001,202032,Staff,0,0,0,0
1683705562349,AWP 102,002,202033,Staff,0,0,0,0
1683705563380,BENG 100,A01,254234,Taylor Amos; Alyssa C,31,0,40,9
1683705564407,BENG 196,001,270013,Engler; Adam J.,9999,0,9999,0
1683705565440,BICD 100R,A01,202018,Smith; Laurie,0,7,32,32
1683705565440,BICD 100R,A02,202019,Smith; Laurie,0,3,32,32
1683705565440,BICD 100R,A03,202020,Smith; Laurie,0,1,32,32
1683705565440,BICD 100R,A04,202021,Smith; Laurie,6,0,32,26
1683705565440,BICD 100R,A05,202022,Smith; Laurie,10,0,32,22
1683705566467,BICD 136,A01,193242,Gustafson-Brown; Cindy,0,2,32,32
1683705566467,BICD 136,A02,193244,Gustafson-Brown; Cindy,13,0,32,19
1683705567494,BIEB 102,A01,193249,Butler; Shannon Rhey,0,0,32,32
1683705567494,BIEB 102,A02,193251,Butler; Shannon Rhey,0,0,32,32
1683705567494,BIEB 102,A03,193253,Butler; Shannon Rhey,0,0,32,32
1683705567494,BIEB 102,A04,193255,Butler; Shannon Rhey,13,0,32,19
1683705567494,BIEB 102,A05,193265,Butler; Shannon Rhey,25,0,32,7
1683705567494,BIEB 102,A06,193269,Butler; Shannon Rhey,12,0,32,20
1683705569548,BIEB 150,A01,193274,Staff,0,0,32,32
1683705569548,BIEB 150,A02,193285,Staff,24,0,32,8
1683705570580,BIEB 194,A00,193286,Kurle; Carolyn M.,19,0,32,13
1683705571614,BILD 1,A01,192291,Staff,15,0,32,17
1683705571614,BILD 1,A02,192292,Staff,30,0,32,2
1683705571614,BILD 1,B01,192520,Reuther; Keefe,0,1,0,0
1683705571614,BILD 1,B02,192532,Reuther; Keefe,0,1,0,0
1683705572646,BILD 3,A01,192556,Butler; Shannon Rhey,0,0,32,32
1683705572646,BILD 3,A02,192581,Butler; Shannon Rhey,0,1,32,32
1683705572646,BILD 3,A03,192611,Butler; Shannon Rhey,19,0,32,13
1683705572646,BILD 3,A04,192612,Butler; Shannon Rhey,23,0,32,9
1683705572646,BILD 3,A05,192613,Butler; Shannon Rhey,26,0,32,6
1683705572646,BILD 3,A06,192679,Butler; Shannon Rhey,27,0,32,5
1683705572646,BILD 3,A07,192682,Butler; Shannon Rhey,20,0,32,12
1683705573673,BILD 4,A01,192836,Reuther; Keefe,1,0,24,23
1683705573673,BILD 4,A02,193044,Reuther; Keefe,4,0,24,20
1683705574699,BILD 10,A01,193142,Gustafson-Brown; Cindy,29,0,32,3
1683705574699,BILD 10,A02,193149,Gustafson-Brown; Cindy,31,0,32,1
1683705575724,BIMM 100,A01,193301,Staff,0,6,32,32
1683705575724,BIMM 100,A02,193312,Staff,0,7,32,32
1683705575724,BIMM 100,A03,193323,Staff,0,10,32,32
1683705576756,BIMM 101,A01,193329,McDonnell; Lisa Marie,0,3,24,24
1683705576756,BIMM 101,A02,193339,McDonnell; Lisa Marie,0,3,24,24
1683705576756,BIMM 101,B01,193354,McDonnell; Lisa Marie,0,4,24,24
1683705576756,BIMM 101,B02,193357,McDonnell; Lisa Marie,0,3,24,24
1683705577787,BIMM 110,A01,193377,Tat; John,0,11,32,32
1683705577787,BIMM 110,A02,193378,Tat; John,0,11,32,32
1683705578814,BIMM 120,A01,206116,Staff,0,0,32,32
1683705578814,BIMM 120,A02,206117,Staff,7,0,32,25
1683705578814,BIMM 120,A03,206121,Staff,21,0,32,11
1683705579843,BIPN 100,A01,193393,Park; Ji Young,0,15,32,32
1683705579843,BIPN 100,A02,193402,Park; Ji Young,0,14,32,32
1683705579843,BIPN 100,A03,193413,Park; Ji Young,0,14,32,32
1683705579843,BIPN 100,A04,193414,Park; Ji Young,0,13,32,32
1683705580871,BIPN 102,A01,193429,Staff,0,0,32,32
1683705580871,BIPN 102,A02,193438,Staff,18,0,32,14
1683705581904,BIPN 106,A01,193450,Reyes Gonzalez; Catalina,0,2,40,40
1683705582929,BIPN 134,A01,193465,Cooke; James Edward,0,0,32,32
1683705582929,BIPN 134,A02,193474,Cooke; James Edward,25,0,32,7
1683705582929,BIPN 134,A03,193485,Cooke; James Edward,29,0,32,3
1683705582929,BIPN 134,A04,193486,Cooke; James Edward,20,0,32,12
1683705582929,BIPN 134,A05,193491,Cooke; James Edward,31,0,32,1
1683705582929,BIPN 134,A06,193501,Cooke; James Edward,30,0,32,2
1683705582929,BIPN 134,A07,193510,Cooke; James Edward,29,0,32,3
1683705584987,BISP 194,A00,222522,Staff,14,0,32,18
1683705586015,CAT 124,A01,202407,Staff,19,0,25,6
1683705587041,CAT 125,A00,202408,Marchisotto; Jennifer Anne,2,0,20,18
1683705588068,CAT 125R,A00,202409,Smith; Lauryn Alissa,0,11,20,20
1683705588068,CAT 125R,B00,202410,Morales; Celeste Georgianna,0,11,20,20
1683705588068,CAT 125R,C00,202411,Irwin; Matthew Joseph,0,12,20,20
1683705589100,CENG 15,A01,204712,Yang; Kesong,0,1,0,0
1683705590131,CENG 114,A00,202070,Jahed Motlagh; Zeinab,5,0,20,15
1683705591162,CGS 105,A00,185477,Wesling; Megan E.,24,0,40,16
1683705592186,CGS 106,A00,185494,Staff,11,0,22,11
1683705593211,CGS 108,A00,185495,Staff,14,0,20,6
1683705594239,CGS 114,A00,185496,Staff,13,0,18,5
1683705595263,CGS 119,A00,185501,Staff,15,0,20,5
1683705596288,CGS 120,A00,185511,Staff,11,0,20,9
1683705597316,CHEM 4,A01,184675,Bussey; Thomas J,97,0,100,3
1683705598341,CHEM 6A,A01,184677,Staff,32,0,60,28
1683705599370,CHEM 6B,A01,184679,Staff,63,0,100,37
1683705600396,CHEM 6C,A01,184681,Bussey; Thomas J,0,0,50,50
1683705600396,CHEM 6C,A02,184682,Bussey; Thomas J,32,0,50,18
1683705601425,CHEM 40A,A01,184684,Albizati; Kim F.,33,0,100,67
1683705602450,CHEM 40B,A01,184686,Albizati; Kim F.,0,22,100,100
1683705603475,CHEM 41B,A01,184690,Staff,51,0,100,49
1683705604507,COGS 3,A01,184715,Boyle; Mary E. T.,0,27,40,40
1683705605537,COGS 14B,A01,185172,Staff,0,14,38,38
1683705606565,COGS 18,A01,184736,Staff,14,0,80,66
1683705607594,COGS 100,A01,184932,Staff,0,8,73,73
1683705608622,COGS 101A,A01,184935,Staff,0,40,30,30
1683705609650,COGS 101B,A01,184944,Staff,0,2,30,30
1683705610687,COGS 101C,A01,184946,Staff,0,10,30,30
1683705611720,COGS 102A,A01,184951,Johnson; Christine M.,1,0,40,39
1683705612752,COGS 107B,A01,184953,Mooshagian; Eric Frederick,0,52,40,40
1683705613784,COGS 118B,A01,184959,Gupta; Anjum,0,50,40,40
1683705614811,COGS 153,A00,184961,Staff,1,16,30,29
1683705615839,COGS 177,A00,184962,Staff,0,20,30,30
1683705616866,COGS 187A,A01,184969,Boyle; Mary E. T.,0,19,40,40
1683705617898,COMM 10,A01,185174,Staff,0,5,25,25
1683705617898,COMM 10,A02,185189,Staff,0,2,25,25
1683705617898,COMM 10,A03,269821,Staff,0,1,0,0
1683705618925,COMM 100B,A02,185476,Staff,10,0,25,15
1683705618925,COMM 100B,A03,277340,Staff,25,0,25,0
1683705619951,COMM 100C,A01,185314,Staff,2,0,25,23
1683705619951,COMM 100C,A02,185327,Staff,17,0,25,8
1683705620976,COMM 110M,A00,185349,Staff,0,0,40,40
1683705622006,COMM 113T,A00,185352,Staff,25,0,40,15
1683705623039,COMM 114I,A00,185353,Staff,31,0,40,9
1683705624067,COMM 131,A00,185354,Staff,17,0,30,13
1683705625100,CSE 8A,A50,185358,Cao; Yingjun,0,46,10,10
1683705626126,CSE 8B,A01,185362,Staff,0,48,50,50
1683705627150,CSE 11,A01,185416,Cao; Yingjun,0,91,10,10
1683705628176,CSE 20,A01,185445,Briones; Jor-el Thomas Caparas,3,0,25,22
1683705629201,CSE 21,A01,185447,Staff,9,0,50,41
1683705630227,CSE 101,A01,185451,Staff,0,13,50,50
1683705630227,CSE 101,B01,185453,Jones; Miles E,0,15,50,50
1683705632278,CSE 141,A01,185458,Eldon; John,16,0,100,84
1683705633303,CSE 141L,A01,185461,Eldon; John,8,0,100,92
1683705634329,CSE 142,A01,185463,Staff,34,0,60,26
1683705634329,CSE 142,B01,201355,Staff,0,7,60,60
1683705635354,CSE 142L,A01,185470,Staff,34,0,60,26
1683705635354,CSE 142L,B01,201417,Staff,0,6,60,60
1683705636379,CSE 190,A00,201433,Staff,32,0,49,17
1683705637405,DOC 1,A01,259136,Strom; Megan C.,7,0,15,8
1683705637405,DOC 1,A02,259137,Strom; Megan C.,15,0,15,0
1683705637405,DOC 1,A03,259138,Strom; Megan C.,14,0,15,1
1683705637405,DOC 1,A04,259139,Strom; Megan C.,14,0,15,1
1683705638432,DOC 100D,A00,259140,Pass; Natalye Joann,14,0,25,11
1683705639456,DSGN 1,A01,184749,Rill; Bryan,0,26,30,30
1683705640481,DSGN 100,A01,185168,Staff,0,2,25,25
1683705641513,ECE 5,A01,185626,Morris; Karcher William,0,12,0,0
1683705642541,ECE 101,A01,185628,Staff,14,0,70,56
1683705643568,ECE 107,A01,185635,Baghdadchi; Saharnaz,0,0,20,20
1683705643568,ECE 107,A02,185638,Baghdadchi; Saharnaz,1,0,20,19
1683705644593,ECE 148,A01,185647,Silberman; Jack,0,0,16,16
1683705645618,ECON 1,A01,185537,Crane; Meredith Helen,54,0,70,16
1683705646647,ECON 3,A01,185549,Crane; Meredith Helen,30,0,70,40
1683705647673,ECON 4,A01,203354,Anderson; John Charles,0,5,10,10
1683705648702,ECON 100A,A01,185574,Staff,0,5,40,40
1683705649733,ECON 100B,A01,185576,Staff,0,12,50,50
1683705650766,ECON 100C,A01,185589,Newhouse; Herbert S,30,0,70,40
1683705651795,ECON 105,A00,185608,Vespa; Emanuel Ignacio,19,0,35,16
1683705652822,ECON 109,A01,185610,Shishkin; Denis,9,0,35,26
1683705653858,ECON 110A,A01,185612,Staff,8,0,40,32
1683705654890,ECON 120A,A01,185615,Staff,19,0,40,21
1683705655916,ECON 120C,A01,185617,Sun; Yixiao,0,21,70,70
1683705656950,ECON 144,A00,203346,Squires; Dale E,2,0,35,33
1683705657980,ECON 171,A01,203349,Newhouse; Herbert S,0,1,35,35
1683705659010,ECON 173A,A01,185621,Toda; Alexis Akira,21,0,35,14
1683705660045,EDS 25,A01,202413,Staff,0,1,0,0
1683705660045,EDS 25,A02,202414,Staff,0,1,0,0
1683705660045,EDS 25,A03,202415,Staff,0,0,0,0
1683705660045,EDS 25,A04,202416,Staff,0,1,0,0
1683705660045,EDS 25,A05,202439,Staff,0,0,0,0
1683705660045,EDS 25,A06,202440,Staff,0,0,0,0
1683705660045,EDS 25,B01,202631,Staff,0,0,0,0
1683705660045,EDS 25,B02,202632,Staff,0,0,0,0
1683705660045,EDS 25,B03,202639,Staff,0,0,0,0
1683705660045,EDS 25,B04,202640,Staff,0,0,0,0
1683705660045,EDS 25,B05,202643,Staff,0,0,0,0
1683705660045,EDS 25,B06,202644,Staff,0,0,0,0
1683705661246,EDS 38,A01,202659,Black; Alison Michelle,25,0,25,0
1683705662328,EDS 115,A00,202652,Staff,18,0,30,12
1683705663360,EDS 125,A00,202649,Staff,13,0,30,17
1683705664386,EDS 126,A01,203332,Staff,30,0,30,0
1683705665412,EDS 139,A00,202838,Staff,16,0,25,9
1683705666439,EDS 146,A01,202655,Staff,14,0,25,11
1683705667472,ENG 15,A00,185667,Staff,0,1,0,0
1683705667472,ENG 15,B00,185672,Staff,0,0,0,0
1683705667472,ENG 15,C00,185675,Staff,0,0,0,0
1683705667472,ENG 15,D00,185682,Staff,0,0,0,0
1683705667472,ENG 15,E00,185684,Staff,0,0,0,0
1683705668497,ETHN 103,A00,185710,Staff,0,8,35,35
1683705669523,ETHN 103A,A00,199228,Man; Simeon S,0,0,9,9
1683705670548,ETHN 109,A00,185711,Staff,15,0,35,20
1683705671575,ETHN 142,A00,185726,Staff,0,4,30,30
1683705672605,ETHN 163J,A00,199229,Man; Simeon S,5,0,8,3
1683705673633,ETHN 168,A00,185727,Staff,7,0,10,3
1683705674662,ETHN 182,A00,185728,Staff,0,0,35,35
1683705675687,ETHN 183,A00,185737,Staff,9,0,18,9
1683705676725,GLBH 111,A01,209361,Burgos; Jose L.,0,0,0,0
1683705678783,HIEU 104,A00,185792,Staff,14,0,20,6
1683705679814,HIEU 115,A00,185800,Staff,0,0,20,20
1683705680838,HIEU 128,A00,185801,Staff,0,9,20,20
1683705681863,HIEU 147,A00,185802,Staff,15,0,20,5
1683705682889,HIEU 154,A00,185823,Staff,11,0,20,9
1683705683916,HILA 102,A00,185826,Staff,14,0,20,6
1683705684943,HILD 2C,A01,185778,Staff,0,13,20,20
1683705685972,HILD 7B,A01,185780,Kwak; Nancy,0,17,32,32
1683705685972,HILD 7B,A02,185781,Kwak; Nancy,0,18,32,32
1683705687003,HILD 30,A01,185791,Staff,12,0,20,8
1683705688033,HISC 119,A00,185830,Golan; Tal,0,10,20,20
1683705689063,HITO 156GS,A00,185831,Patterson; Patrick H.,0,0,0,23
1683705690096,HIUS 103,A00,185832,Man; Simeon S,0,4,20,20
1683705691163,HIUS 117,A00,185836,Kwak; Nancy,2,0,20,18
1683705692212,HIUS 125,A00,185840,Man; Simeon S,0,2,23,23
1683705693237,HIUS 149,A00,185845,Staff,1,0,20,19
1683705694264,HUM 3,A01,185882,Zavodny; Tatiana Sophia,0,8,50,50
1683705694264,HUM 3,B01,185899,Caldwell; Michael Alan,0,18,50,50
1683705695291,HUM 3GS,A00,185900,Patterson; Patrick H.,0,0,0,23
1683705696327,HUM 4,A01,185938,Zroka; Amy Liane,28,0,50,22
1683705696327,HUM 4,B01,185956,Watkins; Eric,0,6,50,50
1683705696327,HUM 4,B02,202209,Watkins; Eric,0,5,50,50
1683705696327,HUM 4,B03,202210,Watkins; Eric,0,5,50,50
1683705697359,HUM 5,A01,185958,West; Geoffrey Scott,0,0,50,50
1683705697359,HUM 5,A02,202215,West; Geoffrey Scott,0,1,50,50
1683705698396,INTL 190,A00,185959,Gagnon; Jeffrey C,0,0,0,9
1683705698396,INTL 190,B00,185960,Lettieri; Michael Joseph,0,0,0,2
1683705699423,JAPN 180,A00,254509,Staff,5,0,30,25
1683705700456,LATI 10,A01,202853,Kennemore; Amy Michelle,4,0,35,31
1683705700456,LATI 10,A02,202854,Kennemore; Amy Michelle,3,0,35,32
1683705700456,LATI 10,A03,270054,Kennemore; Amy Michelle,30,0,30,0
1683705701483,LATI 180,A00,202855,Kennemore; Amy Michelle,11,0,20,9
1683705702509,LAWS 101,A00,201767,Golan; Tal,0,7,40,40
1683705703536,LIFR 1C,A00,185961,Staff,6,0,20,14
1683705704563,LIFR 1CX,A00,185962,Staff,7,0,20,13
1683705705593,LIFR 1D,A00,185963,Staff,7,0,20,13
1683705706621,LIFR 1DX,A00,185964,Staff,7,0,20,13
1683705707651,LIGN 101,A01,186039,Staff,43,0,50,7
1683705708679,LIGN 165,A00,186040,Staff,14,0,50,36
1683705709706,LTCS 108,A00,186041,Staff,5,0,10,5
1683705710733,LTCS 119,A00,186042,Staff,15,0,20,5
1683705711759,LTCS 130,A00,186043,Wesling; Megan E.,15,0,25,10
1683705713813,LTEA 138,A00,186119,Staff,14,0,40,26
1683705714855,LTEN 124,A00,186148,Staff,5,0,25,20
1683705715882,LTEN 178,A00,186149,Staff,6,0,15,9
1683705716915,LTEN 181,A00,186150,Blanco; John D,34,0,40,6
1683705717947,LTWL 120,A00,186160,Staff,19,0,25,6
1683705718973,LTWL 165,A00,186161,Staff,22,0,25,3
1683705720009,LTWR 100,A00,186162,Staff,0,5,15,15
1683705721077,LTWR 102,A00,186163,Doller; Ben,5,0,15,10
1683705722106,MAE 8,A01,186412,Staff,0,1,0,0
1683705723130,MAE 30B,A00,186445,Bahadori; Mohammad Yousef,81,0,100,19
1683705724162,MAE 40,A00,186592,Bewley; Thomas R,10,0,50,40
1683705725216,MAE 101B,A00,186593,Bahadori; Mohammad Yousef,80,0,100,20
1683705726245,MAE 105,A00,186594,Bandaru; Prabhakar,10,0,50,40
1683705727275,MAE 107,A00,186599,Pham; Hieu Tan,0,8,120,120
1683705728303,MAE 148,A01,186660,Silberman; Jack,3,0,16,13
1683705729335,MATH 10A,A01,188095,Staff,0,6,35,35
1683705730361,MATH 10B,A01,188097,Bowers; Adam R.,0,12,30,30
1683705730361,MATH 10B,A02,188099,Bowers; Adam R.,0,11,30,30
1683705730361,MATH 10B,B01,188104,Bowers; Adam R.,0,10,30,30
1683705730361,MATH 10B,B02,188106,Bowers; Adam R.,0,9,30,30
1683705731394,MATH 10C,A01,188111,Staff,0,20,30,30
1683705731394,MATH 10C,A02,188127,Staff,0,19,30,30
1683705731394,MATH 10C,A03,188131,Staff,0,19,30,30
1683705731394,MATH 10C,B01,188218,Staff,17,0,30,13
1683705731394,MATH 10C,B02,188244,Staff,13,0,30,17
1683705731394,MATH 10C,B03,188277,Staff,14,0,30,16
1683705732426,MATH 18,A01,188344,Bach; Quang Tran,18,0,30,12
1683705732426,MATH 18,A02,188345,Bach; Quang Tran,11,0,30,19
1683705732426,MATH 18,B01,188353,Bach; Quang Tran,11,0,30,19
1683705732426,MATH 18,B02,188354,Bach; Quang Tran,19,0,30,11
1683705733452,MATH 20A,A01,188374,Staff,11,0,35,24
1683705734485,MATH 20B,A01,188382,Ohm; Ko Woon,7,0,30,23
1683705734485,MATH 20B,A02,188383,Ohm; Ko Woon,22,0,30,8
1683705734485,MATH 20B,B01,188385,Ohm; Ko Woon,7,0,30,23
1683705734485,MATH 20B,B02,188392,Ohm; Ko Woon,22,0,30,8
1683705735517,MATH 20C,A01,188394,Harel; Guershon,10,0,30,20
1683705735517,MATH 20C,A02,188395,Harel; Guershon,13,0,30,17
1683705735517,MATH 20C,B01,188404,Harel; Guershon,5,0,30,25
1683705735517,MATH 20C,B02,188405,Harel; Guershon,18,0,30,12
1683705736555,MATH 20D,A01,188414,Hammock; Frances H,0,1,30,30
1683705736555,MATH 20D,A02,188415,Hammock; Frances H,0,1,30,30
1683705736555,MATH 20D,B01,188447,Hammock; Frances H,0,1,30,30
1683705736555,MATH 20D,B02,188486,Hammock; Frances H,2,0,30,28
1683705737587,MATH 20E,A01,188649,Staff,21,0,30,9
1683705737587,MATH 20E,A02,188650,Staff,20,0,30,10
1683705737587,MATH 20E,A03,188673,Staff,0,0,30,30
1683705738616,MATH 102,A01,188675,Staff,0,40,35,35
1683705739643,MATH 103B,A01,188681,Staff,3,0,35,32
1683705739643,MATH 103B,B01,188692,Staff,5,0,35,30
1683705740670,MATH 109,A01,188695,Salehi Golsefidy; Alireza,24,0,35,11
1683705740670,MATH 109,A02,188696,Salehi Golsefidy; Alireza,25,0,35,10
1683705741696,MATH 120A,A01,188698,Eggers; John Dietrich,7,0,35,28
1683705742722,MATH 142B,A01,188736,Ioana; Adrian,0,0,30,30
1683705742722,MATH 142B,A02,188741,Ioana; Adrian,0,1,30,30
1683705742722,MATH 142B,A03,188743,Ioana; Adrian,0,2,30,30
1683705743748,MATH 168A,A01,188790,Staff,0,11,35,35
1683705744775,MATH 170A,A01,188803,Nie; Jiawang,0,2,35,35
1683705744775,MATH 170A,A02,188811,Nie; Jiawang,0,1,35,35
1683705744775,MATH 170A,A03,188814,Nie; Jiawang,0,0,35,35
1683705744775,MATH 170A,A04,188815,Nie; Jiawang,5,0,35,30
1683705745800,MATH 193B,A01,188817,Staff,0,0,35,35
1683705745800,MATH 193B,A02,188818,Staff,6,0,35,29
1683705746834,MGT 4,A01,202857,Anderson; John Charles,59,0,80,21
1683705747861,MGT 12,A00,202858,Lindenberger; Wade Douglas,40,0,90,50
1683705748893,MGT 18,A00,202859,Staff,73,0,90,17
1683705749919,MGT 18GS,A00,202860,McKay; Michael J,13,0,28,15
1683705750948,MGT 45,A00,202861,Pecore; Joseph P.,8,0,90,82
1683705751981,MGT 100,A00,202863,Yavorsky; Daniel Ryan,27,0,90,63
1683705753009,MGT 103,A00,202864,Ehrich; Kristine R,0,19,90,90
1683705754036,MGT 112,A00,202865,Ehrich; Kristine R,15,0,90,75
1683705755063,MGT 121A,A00,202868,Staff,70,0,90,20
1683705756096,MGT 131B,A00,202869,Anderson; John Charles,58,0,90,32
1683705757123,MGT 136,A00,202871,Lindenberger; Wade Douglas,83,0,90,7
1683705758152,MGT 164,A00,202873,Staff,0,67,90,91
1683705759195,MGT 164GS,A00,202874,McKay; Mary A,13,0,28,15
1683705760220,MGT 180,A00,202875,Staff,0,51,90,91
1683705761249,MMW 11R,A01,205019,Herbst; Matthew,0,0,30,30
1683705761249,MMW 11R,A02,205026,Herbst; Matthew,29,0,30,1
1683705762287,MMW 15,A01,193512,Chang; Edmond Yi-Teh,0,8,28,28
1683705762287,MMW 15,A02,193513,Chang; Edmond Yi-Teh,0,5,28,28
1683705762287,MMW 15,A03,193514,Chang; Edmond Yi-Teh,0,5,28,28
1683705762287,MMW 15,A04,193515,Chang; Edmond Yi-Teh,0,5,28,28
1683705762287,MMW 15,A05,193516,Chang; Edmond Yi-Teh,0,5,28,28
1683705762287,MMW 15,A06,193517,Chang; Edmond Yi-Teh,0,6,28,28
1683705762287,MMW 15,B01,193519,Chang; Edmond Yi-Teh,0,5,28,28
1683705762287,MMW 15,B02,193520,Chang; Edmond Yi-Teh,0,5,28,28
1683705762287,MMW 15,B03,193521,Chang; Edmond Yi-Teh,0,5,28,28
1683705762287,MMW 15,B04,193522,Chang; Edmond Yi-Teh,0,6,28,28
1683705762287,MMW 15,B05,193523,Chang; Edmond Yi-Teh,0,5,28,28
1683705762287,MMW 15,B06,193524,Chang; Edmond Yi-Teh,0,5,28,28
1683705763313,MMW 122,A01,193526,Rahimi; Babak,0,16,28,28
1683705763313,MMW 122,A02,193527,Rahimi; Babak,0,15,28,28
1683705763313,MMW 122,A03,193528,Rahimi; Babak,0,0,0,0
1683705763313,MMW 122,A04,193529,Rahimi; Babak,0,0,0,0
1683705764339,MUS 1A,A01,186663,Staff,0,18,35,35
1683705765368,MUS 4,A01,186715,Staff,0,12,35,35
1683705766450,MUS 5R,A01,186796,Dubnov; Shlomo,0,17,35,35
1683705767476,MUS 6,A01,186798,Staff,0,4,25,25
1683705768501,MUS 7,A01,186830,Staff,11,0,35,24
1683705769528,MUS 8,A01,186930,Staff,0,27,35,35
1683705770556,MUS 15,A01,186932,Staff,0,15,35,35
1683705770556,MUS 15,B01,186934,Staff,0,16,35,35
1683705771587,MUS 80,A00,186935,Staff,0,0,20,20
1683705771587,MUS 80,B00,186936,Staff,24,0,25,1
1683705772613,NANO 11,A00,204702,Lipomi; Darren John,0,0,0,0
1683705773647,NANO 15,A01,204709,Yang; Kesong,0,1,0,0
1683705774683,NANO 114,A00,202069,Jahed Motlagh; Zeinab,2,0,10,8
1683705775709,PHIL 1,A00,186955,Grush; Rick Scott,31,0,40,9
1683705776743,PHIL 10,A01,186973,Grush; Rick Scott,27,0,35,8
1683705776743,PHIL 10,A02,186974,Grush; Rick Scott,33,0,35,2
1683705777772,PHIL 13,A01,186976,Staff,1,0,35,34
1683705777772,PHIL 13,A02,186977,Staff,16,0,35,19
1683705778800,PHIL 14,A01,186979,Staff,30,0,35,5
1683705778800,PHIL 14,A02,186986,Staff,32,0,35,3
1683705779825,PHIL 28,A01,186988,Staff,16,0,30,14
1683705779825,PHIL 28,A02,186989,Staff,0,0,30,30
1683705779825,PHIL 28,A03,186990,Staff,10,0,30,20
1683705779825,PHIL 28,A04,186991,Staff,26,0,30,4
1683705780851,PHIL 120,A00,186997,Staff,23,0,40,17
1683705781876,PHIL 137,A00,187003,Staff,7,0,40,33
1683705782904,PHIL 150,A00,187015,Staff,47,0,70,23
1683705783930,PHIL 167,A00,187021,Lamey; Andy M.,34,0,40,6
1683705784955,PHIL 174,A01,202226,Staff,17,0,20,3
1683705784955,PHIL 174,A02,202235,Staff,20,0,20,0
1683705785987,PHIL 191A,A00,258918,Staff,0,0,1,1
1683705787013,PHYS 1A,A00,187028,Staff,26,0,60,34
1683705788039,PHYS 1AL,001,187036,Staff,3,0,30,27
1683705788039,PHYS 1AL,002,187049,Staff,18,0,30,12
1683705789070,PHYS 1B,A00,187058,Staff,21,0,60,39
1683705790096,PHYS 1BL,001,187064,Staff,0,1,30,30
1683705790096,PHYS 1BL,002,187070,Staff,4,0,30,26
1683705791125,PHYS 1C,A00,187082,Staff,30,0,120,90
1683705792158,PHYS 1CL,001,187088,Staff,0,9,30,30
1683705792158,PHYS 1CL,002,187089,Staff,0,1,30,30
1683705792158,PHYS 1CL,009,262693,Staff,9,0,30,21
1683705793191,PHYS 2B,A01,187097,Staff,55,0,115,60
1683705794217,PHYS 2C,A01,187099,Staff,63,0,115,52
1683705795249,PHYS 2CL,A01,187101,Staff,5,0,28,23
1683705795249,PHYS 2CL,A02,187102,Staff,15,0,28,13
1683705796275,PHYS 2D,A01,187123,Shotwell; Brian,95,0,115,20
1683705797301,PHYS 4B,A01,187133,Grinstein; Benjamin,35,0,50,15
1683705798328,POLI 10,A00,188819,Staff,0,4,50,50
1683705799359,POLI 11,A00,188827,Staff,43,0,50,7
1683705800387,POLI 13R,A00,188828,Staff,0,1,20,20
1683705801419,POLI 27,A01,188830,Elgin; Samuel Zincke,0,2,70,70
1683705802453,POLI 30,A00,188832,Desposato; Scott,30,0,50,20
1683705803478,POLI 102F,A00,188834,Staff,1,0,40,39
1683705804503,POLI 104A,A00,188852,Staff,12,0,30,18
1683705805528,POLI 104I,A00,188853,Staff,0,8,20,20
1683705806558,POLI 110B,A00,188854,Wiens; David,6,0,20,14
1683705807599,POLI 112A,A00,188855,Wiens; David,3,0,30,27
1683705808628,POLI 117R,A00,188856,Forman; Fonna,0,12,20,20
1683705809658,POLI 118,A00,188857,Ingham; Sean,8,0,20,12
1683705810685,POLI 120G,A00,188858,Staff,7,0,30,23
1683705811711,POLI 131CR,A00,188863,Hoston; Germaine,20,0,50,30
1683705812740,POLI 133,A00,188864,Nellis; Gareth Hb,44,0,50,6
1683705813770,POLI 134D,A00,188865,Desposato; Scott,27,0,30,3
1683705814807,POLI 142A,A00,188871,Gartzke; Erik,21,0,50,29
1683705815834,POLI 142K,A00,188874,Staff,38,0,50,12
1683705816863,POLI 143,A00,188940,Gartzke; Erik,15,0,30,15
1683705817891,POLI 153,A00,188943,Staff,1,0,20,19
1683705818921,POLI 160AA,A00,188944,Staff,10,0,40,30
1683705819948,POLI 170A,A00,188945,Staff,10,0,30,20
1683705822002,PSYC 1,A00,188952,Staff,36,0,90,54
1683705823026,PSYC 2,B00,188953,Staff,19,0,35,16
1683705824052,PSYC 6,A00,188970,Staff,47,0,60,13
1683705825077,PSYC 7,A00,188973,Staff,35,0,45,10
1683705826108,PSYC 60,A01,188980,Rickard; Timothy C.,42,0,60,18
1683705827136,PSYC 70,A01,189001,Steiner; Eric Tomas,22,0,45,23
1683705828169,PSYC 100,A00,189005,Lacefield; Katharine I,1,98,120,119
1683705829200,PSYC 102,A00,189008,Staff,6,0,30,24
1683705830226,PSYC 106,B00,189026,Gorman; Michael R.,27,0,60,33
1683705831254,PSYC 114,B01,189033,Winkielman; Piotr,0,31,30,30
1683705832283,PSYC 131,A00,189036,Anagnostaras; Stephan,0,44,60,60
1683705833308,PSYC 136,A00,189041,Lowe; Angela Beth,0,7,25,25
1683705834336,PSYC 137,A00,189057,Winkielman; Piotr,0,36,25,25
1683705835367,PSYC 144,A00,189107,Wixted; John T,0,11,50,50
1683705837418,PSYC 162,A00,189142,Staff,0,9,85,85
1683705838443,PSYC 172,A00,189144,Gorman; Michael R.,0,6,30,30
1683705840491,PSYC 179,A00,189146,Lacefield; Katharine I,0,88,120,120
1683705841518,PSYC 181,A00,189147,Anagnostaras; Stephan,0,45,90,90
1683705842543,PSYC 190R,A00,189148,Barner; David A.,0,23,80,80
1683705843569,PSYC 191,A00,189275,Rickard; Timothy C.,0,11,25,25
1683705844599,PSYC 193,A00,189276,Chapman; Eddie Nathaniel,0,1,0,4
1683705845632,PSYC 193L,A01,189281,Lowe; Angela Beth,8,0,20,12
1683705845632,PSYC 193L,B01,189285,Staff,28,0,35,7
1683705846658,RELI 149,A00,187137,Rahimi; Babak,6,0,40,34
1683705847684,SE 9,A01,187315,Staff,0,2,18,18
1683705848711,SE 101B,A00,187409,Staff,24,0,30,6
1683705849737,SE 110B,A00,187444,Staff,10,0,40,30
1683705850765,SE 130B,A00,187449,Staff,31,0,40,9
1683705851790,SE 150A,A00,187516,Staff,8,0,20,12
1683705852814,SE 154,A00,187528,Staff,29,0,50,21
1683705853841,SIO 3,A01,258171,Staff,35,0,40,5
1683705854870,SIO 10,A00,187144,Cook; Geoffrey W,0,6,75,75
1683705855898,SIO 45,A00,187152,Cook; Geoffrey W,1,7,100,99
1683705856923,SIO 109R,A00,194486,Staff,0,4,20,20
1683705858974,SIO 187,A01,187233,Kacev; David,12,0,40,28
1683705860001,SOCI 1,A01,258656,Thorpe; Charles Robert,28,0,30,2
1683705860001,SOCI 1,A02,258658,Thorpe; Charles Robert,30,0,30,0
1683705860001,SOCI 1,A03,258661,Thorpe; Charles Robert,25,0,25,0
1683705860001,SOCI 1,A04,258666,Thorpe; Charles Robert,22,0,25,3
1683705860001,SOCI 1,A05,258897,Thorpe; Charles Robert,22,0,25,3
1683705860001,SOCI 1,A06,258898,Thorpe; Charles Robert,25,0,25,0
1683705861027,SOCI 30,A01,258903,Pardo Guerra; Juan Pablo,14,0,30,16
1683705862052,SOCI 102,A00,258904,Staff,9,0,25,16
1683705863078,SOCI 106,A00,258905,Staff,19,0,25,6
1683705864104,SOCI 111,A00,258907,Ribas Norris; Janet Vanesa,26,0,30,4
1683705865127,SOCI 121R,A00,258908,Pardo Guerra; Juan Pablo,7,0,30,23
1683705866152,SOCI 126,A01,203330,Staff,14,0,20,6
1683705867176,SOCI 131,A00,258909,Thorpe; Charles Robert,30,0,60,30
1683705868205,SOCI 135,A00,258910,Payne; Christine Anna,0,13,30,30
1683705869234,SOCI 157,A00,258911,Staff,10,0,30,20
1683705870313,SOCI 184,A00,258912,Staff,25,0,30,5
1683705871342,SOCI 188D,A00,258913,Staff,22,0,30,8
1683705872374,SYN 2,001,187529,Staff,9,0,16,7
1683705872374,SYN 2,002,201452,Staff,0,20,16,16
1683705872374,SYN 2,003,201469,Staff,1,0,16,15
1683705873402,SYN 100,A01,187531,Staff,0,9,20,20
1683705873402,SYN 100,B01,201491,Staff,0,10,20,20
1683705874432,TDAC 1,A00,189286,Walsh; Kim C.,3,0,20,17
1683705874432,TDAC 1,B00,189287,Harting; Carla Kelso,10,0,20,10
1683705875465,TDAC 101,A00,189300,Walsh; Kim C.,16,0,20,4
1683705875465,TDAC 101,B00,189301,Harting; Carla Kelso,18,0,20,2
1683705876491,TDAC 102,A00,189304,Basso; Beatrice,14,0,20,6
1683705877517,TDAC 108,A00,189305,Staff,18,0,20,2
1683705878552,TDDE 131,A00,189310,Staff,19,0,20,1
1683705878552,TDDE 131,B00,189314,Staff,19,0,20,1
1683705878552,TDDE 131,C00,189315,Staff,48,0,50,2
1683705878552,TDDE 131,D00,189316,Staff,14,0,15,1
1683705878552,TDDE 131,E00,204841,Staff,20,0,20,0
1683705879583,TDGE 10,A00,189289,Staff,27,0,50,23
1683705879583,TDGE 10,B00,189290,Havis; Allan,0,1,50,50
1683705880610,TDGE 11,A00,189291,Fulton; Julia,0,4,50,50
1683705880610,TDGE 11,B00,189292,Staff,20,0,25,5
1683705880610,TDGE 11,C00,260270,Staff,0,0,0,0
1683705881638,TDGE 25,A00,189294,Staff,1,0,20,19
1683705882663,TDGE 124,A00,189318,Fulton; Julia,0,7,50,50
1683705883692,TDGE 125,A00,189319,Staff,13,0,25,12
1683705883692,TDGE 125,B00,189320,Staff,23,0,25,2
1683705884719,TDGE 127,A00,189322,Havis; Allan,1,0,50,49
1683705885744,TDHT 101,A00,189323,Staff,18,0,25,7
1683705885744,TDHT 101,B00,189324,Staff,25,0,25,0
1683705886769,TDHT 102,A00,189325,Staff,49,0,50,1
1683705887802,TDMV 1,A00,189295,Arcidiacono; Kristin,20,0,30,10
1683705887802,TDMV 1,B00,189296,Caligagan; Maria T.,23,0,30,7
1683705888832,TDMV 2,A00,189297,Sammartano; Tonnie,27,0,30,3
1683705888832,TDMV 2,B00,189299,Arcidiacono; Kristin,23,0,30,7
1683705889857,TDMV 3,A00,204998,Rincon; Alicia,22,0,30,8
1683705890881,TDMV 120,A00,189458,Sammartano; Tonnie,28,0,30,2
1683705891913,TDMV 138,A00,189541,Jun; Grace Shin Hae,20,0,40,20
1683705892949,TDMV 142,A00,189717,Caligagan; Tony,25,0,30,5
1683705892949,TDMV 142,B00,189718,Caligagan; Maria T.,25,0,30,5
1683705893975,TMC 2,A01,187533,Staff,25,0,25,0
1683705893975,TMC 2,A02,187534,Staff,25,0,25,0
1683705894998,USP 1,A01,187536,Kwak; Nancy,0,16,25,25
1683705896025,USP 5,A01,187538,Staff,8,0,25,17
1683705897052,USP 101,A00,199253,Staff,0,4,0,0
1683705898080,USP 124,A00,187562,Boomhower; Matthew Charles,0,0,30,30
1683705899104,USP 138,A00,187582,Staff,19,0,25,6
1683705900136,USP 152,A01,187597,Staff,3,0,25,22
1683705901180,USP 153,A00,187598,Staff,18,0,25,7
1683705902207,USP 168,A00,187607,Kwak; Nancy,2,0,5,3
1683705903235,USP 173,A00,187619,Staff,4,0,25,21
1683705904264,USP 181,A00,187638,Staff,0,4,25,25
1683705905295,VIS 103,A00,187650,Cruz; Edwin Teddy,17,0,75,58
1683705906320,VIS 110D,A00,187669,Staff,13,0,22,9
1683705907350,VIS 127C,A00,187720,Shen; Kuiyi,67,0,146,79
1683705908374,VIS 149,A00,187731,Yoldas; Pinar,0,12,22,22
1683705909400,VIS 151,A01,188091,Staff,22,0,34,12
1683705909400,VIS 151,A02,188092,Staff,11,0,34,23
1683705910431,VIS 160B,A00,188093,Stalbaum; Brett,0,1,10,10
1683705912488,WCWP 10B,A00,201720,Staff,0,0,5,5
1683705912488,WCWP 10B,B00,201722,Staff,0,0,6,6
1683705913519,WCWP 100,A00,201725,Gagnon; Jeffrey C,0,0,2,2
1683705913519,WCWP 100,B00,201727,Staff,0,4,15,15
1683705916644,ANBI 133,A00,258401,Wilder; Linnea Lorene,34,0,40,6
1683705917674,ANBI 140,A00,258395,Hrvoj Mihic; Branka,18,0,25,7
1683705918699,ANSC 120,A00,258402,Bialecki; Jon Anthony,26,0,40,14
1683705919729,ANSC 144,A00,258400,Staff,12,0,40,28
1683705921780,ANSC 166,A00,258396,Parish; Steven Martin,156,0,175,19
1683705922805,ANSC 180,A00,193533,Staff,8,0,20,12
1683705923830,ANSC 188,A00,258397,Jassal; Aftab,34,0,40,6
1683705924859,ANTH 3,A01,258316,Staff,23,0,30,7
1683705925885,ANTH 5,A00,258394,Semendeferi; Ekaterini,16,0,20,4
1683705926918,ANTH 21,A01,258331,Staff,4,0,40,36
1683705927943,ANTH 103,A00,258398,Varma; Saiba,15,0,25,10
1683705928980,AWP 10,001,202034,Staff,0,0,0,0
1683705928980,AWP 10,002,202035,Staff,0,0,0,0
1683705928980,AWP 10,003,202036,Staff,0,0,0,0
1683705928980,AWP 10,004,202037,Staff,0,0,0,0
1683705928980,AWP 10,005,202038,Staff,0,0,0,0
1683705928980,AWP 10,006,202039,Staff,0,0,0,0
1683705928980,AWP 10,007,202040,Staff,0,0,0,0
1683705928980,AWP 10,008,202041,Staff,0,0,0,0
1683705928980,AWP 10,009,202042,Staff,0,0,0,0
1683705928980,AWP 10,010,202043,Staff,0,0,0,0
1683705928980,AWP 10,011,202044,Staff,0,0,0,0
1683705928980,AWP 10,012,202045,Staff,0,0,0,0
1683705928980,AWP 10,013,202046,Staff,0,0,0,0
1683705928980,AWP 10,014,202047,Staff,0,0,0,0
1683705928980,AWP 10,015,202048,Staff,0,0,0,0
1683705928980,AWP 10,016,202049,Staff,0,0,0,0
1683705928980,AWP 10,017,202050,Staff,0,0,0,0
1683705928980,AWP 10,018,202051,Staff,0,0,0,0
1683705928980,AWP 10,019,202052,Staff,0,0,0,0
1683705928980,AWP 10,020,202053,Staff,0,0,0,0
1683705928980,AWP 10,021,202054,Staff,0,0,0,0
1683705928980,AWP 10,022,202055,Staff,0,0,0,0
1683705928980,AWP 10,023,202056,Staff,0,0,0,0
1683705928980,AWP 10,024,202057,Staff,0,0,0,0
1683705928980,AWP 10,025,202058,Staff,0,0,0,0
1683705928980,AWP 10,026,202059,Staff,0,0,0,0
1683705930004,AWP 102,001,202032,Staff,0,0,0,0
1683705930004,AWP 102,002,202033,Staff,0,0,0,0
1683705931029,BENG 100,A01,254234,Taylor Amos; Alyssa C,31,0,40,9
1683705932054,BENG 196,001,270013,Engler; Adam J.,9999,0,9999,0
1683705933078,BICD 100R,A01,202018,Smith; Laurie,0,7,32,32
1683705933078,BICD 100R,A02,202019,Smith; Laurie,0,3,32,32
1683705933078,BICD 100R,A03,202020,Smith; Laurie,0,1,32,32
1683705933078,BICD 100R,A04,202021,Smith; Laurie,6,0,32,26
1683705933078,BICD 100R,A05,202022,Smith; Laurie,10,0,32,22
1683705934103,BICD 136,A01,193242,Gustafson-Brown; Cindy,0,2,32,32
1683705934103,BICD 136,A02,193244,Gustafson-Brown; Cindy,13,0,32,19
1683705935129,BIEB 102,A01,193249,Butler; Shannon Rhey,0,0,32,32
1683705935129,BIEB 102,A02,193251,Butler; Shannon Rhey,0,0,32,32
1683705935129,BIEB 102,A03,193253,Butler; Shannon Rhey,0,0,32,32
1683705935129,BIEB 102,A04,193255,Butler; Shannon Rhey,13,0,32,19
1683705935129,BIEB 102,A05,193265,Butler; Shannon Rhey,25,0,32,7
1683705935129,BIEB 102,A06,193269,Butler; Shannon Rhey,12,0,32,20
1683705937183,BIEB 150,A01,193274,Staff,0,0,32,32
1683705937183,BIEB 150,A02,193285,Staff,24,0,32,8
1683705938243,BIEB 194,A00,193286,Kurle; Carolyn M.,19,0,32,13
1683705939277,BILD 1,A01,192291,Staff,15,0,32,17
1683705939277,BILD 1,A02,192292,Staff,30,0,32,2
1683705939277,BILD 1,B01,192520,Reuther; Keefe,0,1,0,0
1683705939277,BILD 1,B02,192532,Reuther; Keefe,0,1,0,0
1683705940312,BILD 3,A01,192556,Butler; Shannon Rhey,0,0,32,32
1683705940312,BILD 3,A02,192581,Butler; Shannon Rhey,0,1,32,32
1683705940312,BILD 3,A03,192611,Butler; Shannon Rhey,19,0,32,13
1683705940312,BILD 3,A04,192612,Butler; Shannon Rhey,23,0,32,9
1683705940312,BILD 3,A05,192613,Butler; Shannon Rhey,26,0,32,6
1683705940312,BILD 3,A06,192679,Butler; Shannon Rhey,27,0,32,5
1683705940312,BILD 3,A07,192682,Butler; Shannon Rhey,20,0,32,12
1683705941347,BILD 4,A01,192836,Reuther; Keefe,1,0,24,23
1683705941347,BILD 4,A02,193044,Reuther; Keefe,4,0,24,20
1683705942385,BILD 10,A01,193142,Gustafson-Brown; Cindy,29,0,32,3
1683705942385,BILD 10,A02,193149,Gustafson-Brown; Cindy,31,0,32,1
1683705943412,BIMM 100,A01,193301,Staff,0,6,32,32
1683705943412,BIMM 100,A02,193312,Staff,0,7,32,32
1683705943412,BIMM 100,A03,193323,Staff,0,10,32,32
1683705944436,BIMM 101,A01,193329,McDonnell; Lisa Marie,0,3,24,24
1683705944436,BIMM 101,A02,193339,McDonnell; Lisa Marie,0,3,24,24
1683705944436,BIMM 101,B01,193354,McDonnell; Lisa Marie,0,4,24,24
1683705944436,BIMM 101,B02,193357,McDonnell; Lisa Marie,0,3,24,24
1683705945463,BIMM 110,A01,193377,Tat; John,0,11,32,32
1683705945463,BIMM 110,A02,193378,Tat; John,0,11,32,32
1683705946496,BIMM 120,A01,206116,Staff,0,0,32,32
1683705946496,BIMM 120,A02,206117,Staff,7,0,32,25
1683705946496,BIMM 120,A03,206121,Staff,21,0,32,11
1683705947526,BIPN 100,A01,193393,Park; Ji Young,0,15,32,32
1683705947526,BIPN 100,A02,193402,Park; Ji Young,0,14,32,32
1683705947526,BIPN 100,A03,193413,Park; Ji Young,0,14,32,32
1683705947526,BIPN 100,A04,193414,Park; Ji Young,0,13,32,32
1683705948551,BIPN 102,A01,193429,Staff,0,0,32,32
1683705948551,BIPN 102,A02,193438,Staff,18,0,32,14
1683705949580,BIPN 106,A01,193450,Reyes Gonzalez; Catalina,0,2,40,40
1683705950609,BIPN 134,A01,193465,Cooke; James Edward,0,0,32,32
1683705950609,BIPN 134,A02,193474,Cooke; James Edward,25,0,32,7
1683705950609,BIPN 134,A03,193485,Cooke; James Edward,29,0,32,3
1683705950609,BIPN 134,A04,193486,Cooke; James Edward,20,0,32,12
1683705950609,BIPN 134,A05,193491,Cooke; James Edward,31,0,32,1
1683705950609,BIPN 134,A06,193501,Cooke; James Edward,30,0,32,2
1683705950609,BIPN 134,A07,193510,Cooke; James Edward,29,0,32,3
1683705952666,BISP 194,A00,222522,Staff,14,0,32,18
1683705953693,CAT 124,A01,202407,Staff,19,0,25,6
1683705954720,CAT 125,A00,202408,Marchisotto; Jennifer Anne,2,0,20,18
1683705955759,CAT 125R,A00,202409,Smith; Lauryn Alissa,0,11,20,20
1683705955759,CAT 125R,B00,202410,Morales; Celeste Georgianna,0,11,20,20
1683705955759,CAT 125R,C00,202411,Irwin; Matthew Joseph,0,12,20,20
1683705956785,CENG 15,A01,204712,Yang; Kesong,0,1,0,0
1683705957811,CENG 114,A00,202070,Jahed Motlagh; Zeinab,5,0,20,15
1683705958837,CGS 105,A00,185477,Wesling; Megan E.,24,0,40,16
1683705959865,CGS 106,A00,185494,Staff,11,0,22,11
1683705960892,CGS 108,A00,185495,Staff,14,0,20,6
1683705961916,CGS 114,A00,185496,Staff,13,0,18,5
1683705962941,CGS 119,A00,185501,Staff,15,0,20,5
1683705963966,CGS 120,A00,185511,Staff,11,0,20,9
1683705964993,CHEM 4,A01,184675,Bussey; Thomas J,97,0,100,3
1683705966024,CHEM 6A,A01,184677,Staff,32,0,60,28
1683705967050,CHEM 6B,A01,184679,Staff,63,0,100,37
1683705968081,CHEM 6C,A01,184681,Bussey; Thomas J,0,0,50,50
1683705968081,CHEM 6C,A02,184682,Bussey; Thomas J,32,0,50,18
1683705969106,CHEM 40A,A01,184684,Albizati; Kim F.,33,0,100,67
1683705970134,CHEM 40B,A01,184686,Albizati; Kim F.,0,22,100,100
1683705971160,CHEM 41B,A01,184690,Staff,51,0,100,49
1683705972186,COGS 3,A01,184715,Boyle; Mary E. T.,0,27,40,40
1683705973217,COGS 14B,A01,185172,Staff,0,14,38,38
1683705974300,COGS 18,A01,184736,Staff,14,0,80,66
1683705975327,COGS 100,A01,184932,Staff,0,8,73,73
1683705976356,COGS 101A,A01,184935,Staff,0,40,30,30
1683705977381,COGS 101B,A01,184944,Staff,0,2,30,30
1683705978406,COGS 101C,A01,184946,Staff,0,10,30,30
1683705979435,COGS 102A,A01,184951,Johnson; Christine M.,1,0,40,39
1683705980470,COGS 107B,A01,184953,Mooshagian; Eric Frederick,0,52,40,40
1683705981502,COGS 118B,A01,184959,Gupta; Anjum,0,50,40,40
1683705982530,COGS 153,A00,184961,Staff,1,16,30,29
1683705983555,COGS 177,A00,184962,Staff,0,20,30,30
1683705984582,COGS 187A,A01,184969,Boyle; Mary E. T.,0,19,40,40
1683705985614,COMM 10,A01,185174,Staff,0,5,25,25
1683705985614,COMM 10,A02,185189,Staff,0,2,25,25
1683705985614,COMM 10,A03,269821,Staff,0,1,0,0
1683705986650,COMM 100B,A02,185476,Staff,10,0,25,15
1683705986650,COMM 100B,A03,277340,Staff,25,0,25,0
1683705987676,COMM 100C,A01,185314,Staff,2,0,25,23
1683705987676,COMM 100C,A02,185327,Staff,17,0,25,8
1683705988699,COMM 110M,A00,185349,Staff,0,0,40,40
1683705989724,COMM 113T,A00,185352,Staff,25,0,40,15
1683705990749,COMM 114I,A00,185353,Staff,31,0,40,9
1683705991778,COMM 131,A00,185354,Staff,17,0,30,13
1683705992826,CSE 8A,A50,185358,Cao; Yingjun,0,46,10,10
1683705993852,CSE 8B,A01,185362,Staff,0,48,50,50
1683705994877,CSE 11,A01,185416,Cao; Yingjun,0,91,10,10
1683705995910,CSE 20,A01,185445,Briones; Jor-el Thomas Caparas,3,0,25,22
1683705996936,CSE 21,A01,185447,Staff,9,0,50,41
1683705997972,CSE 101,A01,185451,Staff,0,13,50,50
1683705997972,CSE 101,B01,185453,Jones; Miles E,0,15,50,50
1683706000027,CSE 141,A01,185458,Eldon; John,16,0,100,84
1683706001057,CSE 141L,A01,185461,Eldon; John,8,0,100,92
1683706002083,CSE 142,A01,185463,Staff,34,0,60,26
1683706002083,CSE 142,B01,201355,Staff,0,7,60,60
1683706003108,CSE 142L,A01,185470,Staff,34,0,60,26
1683706003108,CSE 142L,B01,201417,Staff,0,6,60,60
1683706004136,CSE 190,A00,201433,Staff,32,0,49,17
1683706005168,DOC 1,A01,259136,Strom; Megan C.,7,0,15,8
1683706005168,DOC 1,A02,259137,Strom; Megan C.,15,0,15,0
1683706005168,DOC 1,A03,259138,Strom; Megan C.,14,0,15,1
1683706005168,DOC 1,A04,259139,Strom; Megan C.,14,0,15,1
1683706006195,DOC 100D,A00,259140,Pass; Natalye Joann,14,0,25,11
1683706007219,DSGN 1,A01,184749,Rill; Bryan,0,26,30,30
1683706008248,DSGN 100,A01,185168,Staff,0,2,25,25
1683706009275,ECE 5,A01,185626,Morris; Karcher William,0,12,0,0
1683706010300,ECE 101,A01,185628,Staff,14,0,70,56
1683706011327,ECE 107,A01,185635,Baghdadchi; Saharnaz,0,0,20,20
1683706011327,ECE 107,A02,185638,Baghdadchi; Saharnaz,1,0,20,19
1683706012355,ECE 148,A01,185647,Silberman; Jack,0,0,16,16
1683706013381,ECON 1,A01,185537,Crane; Meredith Helen,54,0,70,16
1683706014406,ECON 3,A01,185549,Crane; Meredith Helen,30,0,70,40
1683706015432,ECON 4,A01,203354,Anderson; John Charles,0,5,10,10
1683706016457,ECON 100A,A01,185574,Staff,0,5,40,40
1683706017483,ECON 100B,A01,185576,Staff,0,12,50,50
1683706018514,ECON 100C,A01,185589,Newhouse; Herbert S,30,0,70,40
1683706019539,ECON 105,A00,185608,Vespa; Emanuel Ignacio,19,0,35,16
1683706020565,ECON 109,A01,185610,Shishkin; Denis,9,0,35,26
1683706021591,ECON 110A,A01,185612,Staff,8,0,40,32
1683706022617,ECON 120A,A01,185615,Staff,19,0,40,21
1683706023646,ECON 120C,A01,185617,Sun; Yixiao,0,21,70,70
1683706024673,ECON 144,A00,203346,Squires; Dale E,2,0,35,33
1683706025704,ECON 171,A01,203349,Newhouse; Herbert S,0,1,35,35
1683706026735,ECON 173A,A01,185621,Toda; Alexis Akira,21,0,35,14
1683706027762,EDS 25,A01,202413,Staff,0,1,0,0
1683706027762,EDS 25,A02,202414,Staff,0,1,0,0
1683706027762,EDS 25,A03,202415,Staff,0,0,0,0
1683706027762,EDS 25,A04,202416,Staff,0,1,0,0
1683706027762,EDS 25,A05,202439,Staff,0,0,0,0
1683706027762,EDS 25,A06,202440,Staff,0,0,0,0
1683706027762,EDS 25,B01,202631,Staff,0,0,0,0
1683706027762,EDS 25,B02,202632,Staff,0,0,0,0
1683706027762,EDS 25,B03,202639,Staff,0,0,0,0
1683706027762,EDS 25,B04,202640,Staff,0,0,0,0
1683706027762,EDS 25,B05,202643,Staff,0,0,0,0
1683706027762,EDS 25,B06,202644,Staff,0,0,0,0
1683706028793,EDS 38,A01,202659,Black; Alison Michelle,25,0,25,0
1683706029818,EDS 115,A00,202652,Staff,18,0,30,12
1683706030848,EDS 125,A00,202649,Staff,13,0,30,17
1683706031874,EDS 126,A01,203332,Staff,30,0,30,0
1683706032900,EDS 139,A00,202838,Staff,16,0,25,9
1683706033929,EDS 146,A01,202655,Staff,14,0,25,11
1683706034961,ENG 15,A00,185667,Staff,0,1,0,0
1683706034961,ENG 15,B00,185672,Staff,0,0,0,0
1683706034961,ENG 15,C00,185675,Staff,0,0,0,0
1683706034961,ENG 15,D00,185682,Staff,0,0,0,0
1683706034961,ENG 15,E00,185684,Staff,0,0,0,0
1683706035992,ETHN 103,A00,185710,Staff,0,8,35,35
1683706037023,ETHN 103A,A00,199228,Man; Simeon S,0,0,9,9
1683706038050,ETHN 109,A00,185711,Staff,15,0,35,20
1683706039077,ETHN 142,A00,185726,Staff,0,4,30,30
1683706040103,ETHN 163J,A00,199229,Man; Simeon S,5,0,8,3
1683706041129,ETHN 168,A00,185727,Staff,7,0,10,3
1683706042157,ETHN 182,A00,185728,Staff,0,0,35,35
1683706043181,ETHN 183,A00,185737,Staff,9,0,18,9
1683706044209,GLBH 111,A01,209361,Burgos; Jose L.,0,0,0,0
1683706046264,HIEU 104,A00,185792,Staff,14,0,20,6
1683706047288,HIEU 115,A00,185800,Staff,0,0,20,20
1683706048311,HIEU 128,A00,185801,Staff,0,9,20,20
1683706049338,HIEU 147,A00,185802,Staff,15,0,20,5
1683706050363,HIEU 154,A00,185823,Staff,11,0,20,9
1683706051389,HILA 102,A00,185826,Staff,14,0,20,6
1683706052420,HILD 2C,A01,185778,Staff,0,13,20,20
1683706053445,HILD 7B,A01,185780,Kwak; Nancy,0,17,32,32
1683706053445,HILD 7B,A02,185781,Kwak; Nancy,0,18,32,32
1683706054475,HILD 30,A01,185791,Staff,12,0,20,8
1683706055505,HISC 119,A00,185830,Golan; Tal,0,10,20,20
1683706056530,HITO 156GS,A00,185831,Patterson; Patrick H.,0,0,0,23
1683706057554,HIUS 103,A00,185832,Man; Simeon S,0,4,20,20
1683706058578,HIUS 117,A00,185836,Kwak; Nancy,2,0,20,18
1683706059602,HIUS 125,A00,185840,Man; Simeon S,0,2,23,23
1683706060627,HIUS 149,A00,185845,Staff,1,0,20,19
1683706061662,HUM 3,A01,185882,Zavodny; Tatiana Sophia,0,8,50,50
1683706061662,HUM 3,B01,185899,Caldwell; Michael Alan,0,18,50,50
1683706062688,HUM 3GS,A00,185900,Patterson; Patrick H.,0,0,0,23
1683706063716,HUM 4,A01,185938,Zroka; Amy Liane,28,0,50,22
1683706063716,HUM 4,B01,185956,Watkins; Eric,0,6,50,50
1683706063716,HUM 4,B02,202209,Watkins; Eric,0,5,50,50
1683706063716,HUM 4,B03,202210,Watkins; Eric,0,5,50,50
1683706064747,HUM 5,A01,185958,West; Geoffrey Scott,0,0,50,50
1683706064747,HUM 5,A02,202215,West; Geoffrey Scott,0,1,50,50
1683706065773,INTL 190,A00,185959,Gagnon; Jeffrey C,0,0,0,9
1683706065773,INTL 190,B00,185960,Lettieri; Michael Joseph,0,0,0,2
1683706066802,JAPN 180,A00,254509,Staff,5,0,30,25
1683706067850,LATI 10,A01,202853,Kennemore; Amy Michelle,4,0,35,31
1683706067850,LATI 10,A02,202854,Kennemore; Amy Michelle,3,0,35,32
1683706067850,LATI 10,A03,270054,Kennemore; Amy Michelle,30,0,30,0
1683706068876,LATI 180,A00,202855,Kennemore; Amy Michelle,11,0,20,9
1683706069904,LAWS 101,A00,201767,Golan; Tal,0,7,40,40
1683706070930,LIFR 1C,A00,185961,Staff,6,0,20,14
1683706071959,LIFR 1CX,A00,185962,Staff,7,0,20,13
1683706072989,LIFR 1D,A00,185963,Staff,7,0,20,13
1683706074014,LIFR 1DX,A00,185964,Staff,7,0,20,13
1683706075040,LIGN 101,A01,186039,Staff,43,0,50,7
1683706076065,LIGN 165,A00,186040,Staff,14,0,50,36
1683706077091,LTCS 108,A00,186041,Staff,5,0,10,5
1683706078172,LTCS 119,A00,186042,Staff,15,0,20,5
1683706079198,LTCS 130,A00,186043,Wesling; Megan E.,15,0,25,10
1683706081253,LTEA 138,A00,186119,Staff,14,0,40,26
1683706082277,LTEN 124,A00,186148,Staff,5,0,25,20
1683706083306,LTEN 178,A00,186149,Staff,6,0,15,9
1683706084332,LTEN 181,A00,186150,Blanco; John D,34,0,40,6
1683706085358,LTWL 120,A00,186160,Staff,19,0,25,6
1683706086386,LTWL 165,A00,186161,Staff,22,0,25,3
1683706087411,LTWR 100,A00,186162,Staff,0,5,15,15
1683706088442,LTWR 102,A00,186163,Doller; Ben,5,0,15,10
1683706089468,MAE 8,A01,186412,Staff,0,1,0,0
1683706090496,MAE 30B,A00,186445,Bahadori; Mohammad Yousef,81,0,100,19
1683706091522,MAE 40,A00,186592,Bewley; Thomas R,10,0,50,40
1683706092556,MAE 101B,A00,186593,Bahadori; Mohammad Yousef,80,0,100,20
1683706093588,MAE 105,A00,186594,Bandaru; Prabhakar,10,0,50,40
1683706094614,MAE 107,A00,186599,Pham; Hieu Tan,0,8,120,120
1683706095638,MAE 148,A01,186660,Silberman; Jack,3,0,16,13
1683706096669,MATH 10A,A01,188095,Staff,0,6,35,35
1683706097706,MATH 10B,A01,188097,Bowers; Adam R.,0,12,30,30
1683706097706,MATH 10B,A02,188099,Bowers; Adam R.,0,11,30,30
1683706097706,MATH 10B,B01,188104,Bowers; Adam R.,0,10,30,30
1683706097706,MATH 10B,B02,188106,Bowers; Adam R.,0,9,30,30
1683706098740,MATH 10C,A01,188111,Staff,0,20,30,30
1683706098740,MATH 10C,A02,188127,Staff,0,19,30,30
1683706098740,MATH 10C,A03,188131,Staff,0,19,30,30
1683706098740,MATH 10C,B01,188218,Staff,17,0,30,13
1683706098740,MATH 10C,B02,188244,Staff,13,0,30,17
1683706098740,MATH 10C,B03,188277,Staff,14,0,30,16
1683706099775,MATH 18,A01,188344,Bach; Quang Tran,18,0,30,12
1683706099775,MATH 18,A02,188345,Bach; Quang Tran,11,0,30,19
1683706099775,MATH 18,B01,188353,Bach; Quang Tran,11,0,30,19
1683706099775,MATH 18,B02,188354,Bach; Quang Tran,19,0,30,11
1683706100803,MATH 20A,A01,188374,Staff,11,0,35,24
1683706101830,MATH 20B,A01,188382,Ohm; Ko Woon,7,0,30,23
1683706101830,MATH 20B,A02,188383,Ohm; Ko Woon,22,0,30,8
1683706101830,MATH 20B,B01,188385,Ohm; Ko Woon,7,0,30,23
1683706101830,MATH 20B,B02,188392,Ohm; Ko Woon,22,0,30,8
1683706102868,MATH 20C,A01,188394,Harel; Guershon,10,0,30,20
1683706102868,MATH 20C,A02,188395,Harel; Guershon,13,0,30,17
1683706102868,MATH 20C,B01,188404,Harel; Guershon,5,0,30,25
1683706102868,MATH 20C,B02,188405,Harel; Guershon,18,0,30,12
1683706103897,MATH 20D,A01,188414,Hammock; Frances H,0,1,30,30
1683706103897,MATH 20D,A02,188415,Hammock; Frances H,0,1,30,30
1683706103897,MATH 20D,B01,188447,Hammock; Frances H,0,1,30,30
1683706103897,MATH 20D,B02,188486,Hammock; Frances H,2,0,30,28
1683706104927,MATH 20E,A01,188649,Staff,21,0,30,9
1683706104927,MATH 20E,A02,188650,Staff,20,0,30,10
1683706104927,MATH 20E,A03,188673,Staff,0,0,30,30
1683706105958,MATH 102,A01,188675,Staff,0,40,35,35
1683706106984,MATH 103B,A01,188681,Staff,3,0,35,32
1683706106984,MATH 103B,B01,188692,Staff,5,0,35,30
1683706108010,MATH 109,A01,188695,Salehi Golsefidy; Alireza,24,0,35,11
1683706108010,MATH 109,A02,188696,Salehi Golsefidy; Alireza,25,0,35,10
1683706109042,MATH 120A,A01,188698,Eggers; John Dietrich,7,0,35,28
1683706110068,MATH 142B,A01,188736,Ioana; Adrian,0,0,30,30
1683706110068,MATH 142B,A02,188741,Ioana; Adrian,0,1,30,30
1683706110068,MATH 142B,A03,188743,Ioana; Adrian,0,2,30,30
1683706111099,MATH 168A,A01,188790,Staff,0,11,35,35
1683706112126,MATH 170A,A01,188803,Nie; Jiawang,0,2,35,35
1683706112126,MATH 170A,A02,188811,Nie; Jiawang,0,1,35,35
1683706112126,MATH 170A,A03,188814,Nie; Jiawang,0,0,35,35
1683706112126,MATH 170A,A04,188815,Nie; Jiawang,5,0,35,30
1683706113152,MATH 193B,A01,188817,Staff,0,0,35,35
1683706113152,MATH 193B,A02,188818,Staff,6,0,35,29
1683706114178,MGT 4,A01,202857,Anderson; John Charles,59,0,80,21
1683706115205,MGT 12,A00,202858,Lindenberger; Wade Douglas,40,0,90,50
1683706116232,MGT 18,A00,202859,Staff,73,0,90,17
1683706117256,MGT 18GS,A00,202860,McKay; Michael J,13,0,28,15
1683706118281,MGT 45,A00,202861,Pecore; Joseph P.,8,0,90,82
1683706119312,MGT 100,A00,202863,Yavorsky; Daniel Ryan,27,0,90,63
1683706120337,MGT 103,A00,202864,Ehrich; Kristine R,0,19,90,90
1683706121364,MGT 112,A00,202865,Ehrich; Kristine R,15,0,90,75
1683706122395,MGT 121A,A00,202868,Staff,70,0,90,20
1683706123423,MGT 131B,A00,202869,Anderson; John Charles,58,0,90,32
1683706124448,MGT 136,A00,202871,Lindenberger; Wade Douglas,83,0,90,7
1683706125472,MGT 164,A00,202873,Staff,0,67,90,91
1683706126497,MGT 164GS,A00,202874,McKay; Mary A,13,0,28,15
1683706127527,MGT 180,A00,202875,Staff,0,51,90,91
1683706128559,MMW 11R,A01,205019,Herbst; Matthew,0,0,30,30
1683706128559,MMW 11R,A02,205026,Herbst; Matthew,29,0,30,1
1683706129598,MMW 15,A01,193512,Chang; Edmond Yi-Teh,0,8,28,28
1683706129598,MMW 15,A02,193513,Chang; Edmond Yi-Teh,0,5,28,28
1683706129598,MMW 15,A03,193514,Chang; Edmond Yi-Teh,0,5,28,28
1683706129598,MMW 15,A04,193515,Chang; Edmond Yi-Teh,0,5,28,28
1683706129598,MMW 15,A05,193516,Chang; Edmond Yi-Teh,0,5,28,28
1683706129598,MMW 15,A06,193517,Chang; Edmond Yi-Teh,0,6,28,28
1683706129598,MMW 15,B01,193519,Chang; Edmond Yi-Teh,0,5,28,28
1683706129598,MMW 15,B02,193520,Chang; Edmond Yi-Teh,0,5,28,28
1683706129598,MMW 15,B03,193521,Chang; Edmond Yi-Teh,0,5,28,28
1683706129598,MMW 15,B04,193522,Chang; Edmond Yi-Teh,0,6,28,28
1683706129598,MMW 15,B05,193523,Chang; Edmond Yi-Teh,0,5,28,28
1683706129598,MMW 15,B06,193524,Chang; Edmond Yi-Teh,0,5,28,28
1683706130629,MMW 122,A01,193526,Rahimi; Babak,0,16,28,28
1683706130629,MMW 122,A02,193527,Rahimi; Babak,0,15,28,28
1683706130629,MMW 122,A03,193528,Rahimi; Babak,0,0,0,0
1683706130629,MMW 122,A04,193529,Rahimi; Babak,0,0,0,0
1683706131656,MUS 1A,A01,186663,Staff,0,18,35,35
1683706132687,MUS 4,A01,186715,Staff,0,12,35,35
1683706133714,MUS 5R,A01,186796,Dubnov; Shlomo,0,17,35,35
1683706134742,MUS 6,A01,186798,Staff,0,4,25,25
1683706135767,MUS 7,A01,186830,Staff,11,0,35,24
1683706136798,MUS 8,A01,186930,Staff,0,27,35,35
1683706137825,MUS 15,A01,186932,Staff,0,15,35,35
1683706137825,MUS 15,B01,186934,Staff,0,16,35,35
1683706138853,MUS 80,A00,186935,Staff,0,0,20,20
1683706138853,MUS 80,B00,186936,Staff,24,0,25,1
1683706139879,NANO 11,A00,204702,Lipomi; Darren John,0,0,0,0
1683706140923,NANO 15,A01,204709,Yang; Kesong,0,1,0,0
1683706141956,NANO 114,A00,202069,Jahed Motlagh; Zeinab,2,0,10,8
1683706142989,PHIL 1,A00,186955,Grush; Rick Scott,31,0,40,9
1683706144013,PHIL 10,A01,186973,Grush; Rick Scott,27,0,35,8
1683706144013,PHIL 10,A02,186974,Grush; Rick Scott,33,0,35,2
1683706145041,PHIL 13,A01,186976,Staff,1,0,35,34
1683706145041,PHIL 13,A02,186977,Staff,16,0,35,19
1683706146069,PHIL 14,A01,186979,Staff,30,0,35,5
1683706146069,PHIL 14,A02,186986,Staff,32,0,35,3
1683706147099,PHIL 28,A01,186988,Staff,16,0,30,14
1683706147099,PHIL 28,A02,186989,Staff,0,0,30,30
1683706147099,PHIL 28,A03,186990,Staff,10,0,30,20
1683706147099,PHIL 28,A04,186991,Staff,26,0,30,4
1683706148126,PHIL 120,A00,186997,Staff,23,0,40,17
1683706149157,PHIL 137,A00,187003,Staff,7,0,40,33
1683706150186,PHIL 150,A00,187015,Staff,47,0,70,23
1683706151212,PHIL 167,A00,187021,Lamey; Andy M.,34,0,40,6
1683706152239,PHIL 174,A01,202226,Staff,17,0,20,3
1683706152239,PHIL 174,A02,202235,Staff,20,0,20,0
1683706153264,PHIL 191A,A00,258918,Staff,0,0,1,1
1683706154296,PHYS 1A,A00,187028,Staff,26,0,60,34
1683706155326,PHYS 1AL,001,187036,Staff,3,0,30,27
1683706155326,PHYS 1AL,002,187049,Staff,18,0,30,12
1683706156351,PHYS 1B,A00,187058,Staff,21,0,60,39
1683706157377,PHYS 1BL,001,187064,Staff,0,1,30,30
1683706157377,PHYS 1BL,002,187070,Staff,4,0,30,26
1683706158409,PHYS 1C,A00,187082,Staff,30,0,120,90
1683706159436,PHYS 1CL,001,187088,Staff,0,9,30,30
1683706159436,PHYS 1CL,002,187089,Staff,0,1,30,30
1683706159436,PHYS 1CL,009,262693,Staff,9,0,30,21
1683706160460,PHYS 2B,A01,187097,Staff,55,0,115,60
1683706161486,PHYS 2C,A01,187099,Staff,63,0,115,52
1683706162512,PHYS 2CL,A01,187101,Staff,5,0,28,23
1683706162512,PHYS 2CL,A02,187102,Staff,15,0,28,13
1683706163536,PHYS 2D,A01,187123,Shotwell; Brian,95,0,115,20
1683706164562,PHYS 4B,A01,187133,Grinstein; Benjamin,35,0,50,15
1683706165590,POLI 10,A00,188819,Staff,0,4,50,50
1683706166619,POLI 11,A00,188827,Staff,43,0,50,7
1683706167645,POLI 13R,A00,188828,Staff,0,1,20,20
1683706168674,POLI 27,A01,188830,Elgin; Samuel Zincke,0,2,70,70
1683706169700,POLI 30,A00,188832,Desposato; Scott,30,0,50,20
1683706170724,POLI 102F,A00,188834,Staff,1,0,40,39
1683706171748,POLI 104A,A00,188852,Staff,12,0,30,18
1683706172776,POLI 104I,A00,188853,Staff,0,8,20,20
1683706173802,POLI 110B,A00,188854,Wiens; David,6,0,20,14
1683706174834,POLI 112A,A00,188855,Wiens; David,3,0,30,27
1683706175858,POLI 117R,A00,188856,Forman; Fonna,0,12,20,20
1683706176884,POLI 118,A00,188857,Ingham; Sean,8,0,20,12
1683706177910,POLI 120G,A00,188858,Staff,7,0,30,23
1683706178939,POLI 131CR,A00,188863,Hoston; Germaine,20,0,50,30
1683706179964,POLI 133,A00,188864,Nellis; Gareth Hb,44,0,50,6
1683706180994,POLI 134D,A00,188865,Desposato; Scott,27,0,30,3
1683706182078,POLI 142A,A00,188871,Gartzke; Erik,21,0,50,29
1683706183105,POLI 142K,A00,188874,Staff,38,0,50,12
1683706184129,POLI 143,A00,188940,Gartzke; Erik,15,0,30,15
1683706185162,POLI 153,A00,188943,Staff,1,0,20,19
1683706186186,POLI 160AA,A00,188944,Staff,10,0,40,30
1683706187216,POLI 170A,A00,188945,Staff,10,0,30,20
1683706189270,PSYC 1,A00,188952,Staff,36,0,90,54
1683706190297,PSYC 2,B00,188953,Staff,19,0,35,16
1683706191322,PSYC 6,A00,188970,Staff,47,0,60,13
1683706192350,PSYC 7,A00,188973,Staff,35,0,45,10
1683706193376,PSYC 60,A01,188980,Rickard; Timothy C.,42,0,60,18
1683706194420,PSYC 70,A01,189001,Steiner; Eric Tomas,22,0,45,23
1683706195446,PSYC 100,A00,189005,Lacefield; Katharine I,1,98,120,119
1683706196471,PSYC 102,A00,189008,Staff,6,0,30,24
1683706197496,PSYC 106,B00,189026,Gorman; Michael R.,27,0,60,33
1683706198528,PSYC 114,B01,189033,Winkielman; Piotr,0,31,30,30
1683706199554,PSYC 131,A00,189036,Anagnostaras; Stephan,0,44,60,60
1683706200586,PSYC 136,A00,189041,Lowe; Angela Beth,0,7,25,25
1683706201616,PSYC 137,A00,189057,Winkielman; Piotr,0,36,25,25
1683706202644,PSYC 144,A00,189107,Wixted; John T,0,11,50,50
1683706204695,PSYC 162,A00,189142,Staff,0,9,85,85
1683706205724,PSYC 172,A00,189144,Gorman; Michael R.,0,6,30,30
1683706207785,PSYC 179,A00,189146,Lacefield; Katharine I,0,88,120,120
1683706208810,PSYC 181,A00,189147,Anagnostaras; Stephan,0,45,90,90
1683706209842,PSYC 190R,A00,189148,Barner; David A.,0,23,80,80
1683706210873,PSYC 191,A00,189275,Rickard; Timothy C.,0,11,25,25
1683706211900,PSYC 193,A00,189276,Chapman; Eddie Nathaniel,0,1,0,4
1683706212925,PSYC 193L,A01,189281,Lowe; Angela Beth,8,0,20,12
1683706212925,PSYC 193L,B01,189285,Staff,28,0,35,7
1683706213954,RELI 149,A00,187137,Rahimi; Babak,6,0,40,34
1683706214986,SE 9,A01,187315,Staff,0,2,18,18
1683706216015,SE 101B,A00,187409,Staff,24,0,30,6
1683706217040,SE 110B,A00,187444,Staff,10,0,40,30
1683706218065,SE 130B,A00,187449,Staff,31,0,40,9
1683706219093,SE 150A,A00,187516,Staff,8,0,20,12
1683706220118,SE 154,A00,187528,Staff,29,0,50,21
1683706221164,SIO 3,A01,258171,Staff,35,0,40,5
1683706222194,SIO 10,A00,187144,Cook; Geoffrey W,0,6,75,75
1683706223225,SIO 45,A00,187152,Cook; Geoffrey W,1,7,100,99
1683706224268,SIO 109R,A00,194486,Staff,0,4,20,20
1683706226327,SIO 187,A01,187233,Kacev; David,12,0,40,28
1683706227355,SOCI 1,A01,258656,Thorpe; Charles Robert,28,0,30,2
1683706227355,SOCI 1,A02,258658,Thorpe; Charles Robert,30,0,30,0
1683706227355,SOCI 1,A03,258661,Thorpe; Charles Robert,25,0,25,0
1683706227355,SOCI 1,A04,258666,Thorpe; Charles Robert,22,0,25,3
1683706227355,SOCI 1,A05,258897,Thorpe; Charles Robert,22,0,25,3
1683706227355,SOCI 1,A06,258898,Thorpe; Charles Robert,25,0,25,0
1683706228384,SOCI 30,A01,258903,Pardo Guerra; Juan Pablo,14,0,30,16
1683706229409,SOCI 102,A00,258904,Staff,9,0,25,16
1683706230436,SOCI 106,A00,258905,Staff,19,0,25,6
1683706231467,SOCI 111,A00,258907,Ribas Norris; Janet Vanesa,26,0,30,4
1683706232492,SOCI 121R,A00,258908,Pardo Guerra; Juan Pablo,7,0,30,23
1683706233517,SOCI 126,A01,203330,Staff,14,0,20,6
1683706234544,SOCI 131,A00,258909,Thorpe; Charles Robert,30,0,60,30
1683706235570,SOCI 135,A00,258910,Payne; Christine Anna,0,13,30,30
1683706236599,SOCI 157,A00,258911,Staff,10,0,30,20
1683706237623,SOCI 184,A00,258912,Staff,25,0,30,5
1683706238648,SOCI 188D,A00,258913,Staff,22,0,30,8
1683706239676,SYN 2,001,187529,Staff,9,0,16,7
1683706239676,SYN 2,002,201452,Staff,0,20,16,16
1683706239676,SYN 2,003,201469,Staff,1,0,16,15
1683706240705,SYN 100,A01,187531,Staff,0,9,20,20
1683706240705,SYN 100,B01,201491,Staff,0,10,20,20
1683706241734,TDAC 1,A00,189286,Walsh; Kim C.,3,0,20,17
1683706241734,TDAC 1,B00,189287,Harting; Carla Kelso,10,0,20,10
1683706242759,TDAC 101,A00,189300,Walsh; Kim C.,16,0,20,4
1683706242759,TDAC 101,B00,189301,Harting; Carla Kelso,18,0,20,2
1683706243786,TDAC 102,A00,189304,Basso; Beatrice,14,0,20,6
1683706244813,TDAC 108,A00,189305,Staff,18,0,20,2
1683706245841,TDDE 131,A00,189310,Staff,19,0,20,1
1683706245841,TDDE 131,B00,189314,Staff,19,0,20,1
1683706245841,TDDE 131,C00,189315,Staff,48,0,50,2
1683706245841,TDDE 131,D00,189316,Staff,14,0,15,1
1683706245841,TDDE 131,E00,204841,Staff,20,0,20,0
1683706246868,TDGE 10,A00,189289,Staff,27,0,50,23
1683706246868,TDGE 10,B00,189290,Havis; Allan,0,1,50,50
1683706247896,TDGE 11,A00,189291,Fulton; Julia,0,4,50,50
1683706247896,TDGE 11,B00,189292,Staff,20,0,25,5
1683706247896,TDGE 11,C00,260270,Staff,0,0,0,0
1683706248925,TDGE 25,A00,189294,Staff,1,0,20,19
1683706249953,TDGE 124,A00,189318,Fulton; Julia,0,7,50,50
1683706250979,TDGE 125,A00,189319,Staff,13,0,25,12
1683706250979,TDGE 125,B00,189320,Staff,23,0,25,2
1683706252004,TDGE 127,A00,189322,Havis; Allan,1,0,50,49
1683706253037,TDHT 101,A00,189323,Staff,18,0,25,7
1683706253037,TDHT 101,B00,189324,Staff,25,0,25,0
1683706254063,TDHT 102,A00,189325,Staff,49,0,50,1
1683706255089,TDMV 1,A00,189295,Arcidiacono; Kristin,20,0,30,10
1683706255089,TDMV 1,B00,189296,Caligagan; Maria T.,23,0,30,7
1683706256117,TDMV 2,A00,189297,Sammartano; Tonnie,27,0,30,3
1683706256117,TDMV 2,B00,189299,Arcidiacono; Kristin,23,0,30,7
1683706257146,TDMV 3,A00,204998,Rincon; Alicia,22,0,30,8
1683706258171,TDMV 120,A00,189458,Sammartano; Tonnie,28,0,30,2
1683706259196,TDMV 138,A00,189541,Jun; Grace Shin Hae,20,0,40,20
1683706260223,TDMV 142,A00,189717,Caligagan; Tony,25,0,30,5
1683706260223,TDMV 142,B00,189718,Caligagan; Maria T.,25,0,30,5
1683706261268,TMC 2,A01,187533,Staff,25,0,25,0
1683706261268,TMC 2,A02,187534,Staff,25,0,25,0
1683706262293,USP 1,A01,187536,Kwak; Nancy,0,16,25,25
1683706263318,USP 5,A01,187538,Staff,8,0,25,17
1683706264344,USP 101,A00,199253,Staff,0,4,0,0
1683706265369,USP 124,A00,187562,Boomhower; Matthew Charles,0,0,30,30
1683706266400,USP 138,A00,187582,Staff,19,0,25,6
1683706267426,USP 152,A01,187597,Staff,3,0,25,22
1683706268450,USP 153,A00,187598,Staff,18,0,25,7
1683706269480,USP 168,A00,187607,Kwak; Nancy,2,0,5,3
1683706270508,USP 173,A00,187619,Staff,4,0,25,21
1683706271533,USP 181,A00,187638,Staff,0,4,25,25
1683706272561,VIS 103,A00,187650,Cruz; Edwin Teddy,17,0,75,58
1683706273587,VIS 110D,A00,187669,Staff,13,0,22,9
1683706274618,VIS 127C,A00,187720,Shen; Kuiyi,67,0,146,79
1683706275644,VIS 149,A00,187731,Yoldas; Pinar,0,12,22,22
1683706276670,VIS 151,A01,188091,Staff,22,0,34,12
1683706276670,VIS 151,A02,188092,Staff,11,0,34,23
1683706277696,VIS 160B,A00,188093,Stalbaum; Brett,0,1,10,10
1683706279755,WCWP 10B,A00,201720,Staff,0,0,5,5
1683706279755,WCWP 10B,B00,201722,Staff,0,0,6,6
1683706280789,WCWP 100,A00,201725,Gagnon; Jeffrey C,0,0,2,2
1683706280789,WCWP 100,B00,201727,Staff,0,4,15,15
1683706283956,ANBI 133,A00,258401,Wilder; Linnea Lorene,34,0,40,6
1683706284986,ANBI 140,A00,258395,Hrvoj Mihic; Branka,18,0,25,7
1683706286075,ANSC 120,A00,258402,Bialecki; Jon Anthony,26,0,40,14
1683706287101,ANSC 144,A00,258400,Staff,12,0,40,28
1683706289156,ANSC 166,A00,258396,Parish; Steven Martin,156,0,175,19
1683706290182,ANSC 180,A00,193533,Staff,8,0,20,12
1683706291213,ANSC 188,A00,258397,Jassal; Aftab,34,0,40,6
1683706292240,ANTH 3,A01,258316,Staff,23,0,30,7
1683706293266,ANTH 5,A00,258394,Semendeferi; Ekaterini,16,0,20,4
1683706294291,ANTH 21,A01,258331,Staff,4,0,40,36
1683706295317,ANTH 103,A00,258398,Varma; Saiba,15,0,25,10
1683706296348,AWP 10,001,202034,Staff,0,0,0,0
1683706296348,AWP 10,002,202035,Staff,0,0,0,0
1683706296348,AWP 10,003,202036,Staff,0,0,0,0
1683706296348,AWP 10,004,202037,Staff,0,0,0,0
1683706296348,AWP 10,005,202038,Staff,0,0,0,0
1683706296348,AWP 10,006,202039,Staff,0,0,0,0
1683706296348,AWP 10,007,202040,Staff,0,0,0,0
1683706296348,AWP 10,008,202041,Staff,0,0,0,0
1683706296348,AWP 10,009,202042,Staff,0,0,0,0
1683706296348,AWP 10,010,202043,Staff,0,0,0,0
1683706296348,AWP 10,011,202044,Staff,0,0,0,0
1683706296348,AWP 10,012,202045,Staff,0,0,0,0
1683706296348,AWP 10,013,202046,Staff,0,0,0,0
1683706296348,AWP 10,014,202047,Staff,0,0,0,0
1683706296348,AWP 10,015,202048,Staff,0,0,0,0
1683706296348,AWP 10,016,202049,Staff,0,0,0,0
1683706296348,AWP 10,017,202050,Staff,0,0,0,0
1683706296348,AWP 10,018,202051,Staff,0,0,0,0
1683706296348,AWP 10,019,202052,Staff,0,0,0,0
1683706296348,AWP 10,020,202053,Staff,0,0,0,0
1683706296348,AWP 10,021,202054,Staff,0,0,0,0
1683706296348,AWP 10,022,202055,Staff,0,0,0,0
1683706296348,AWP 10,023,202056,Staff,0,0,0,0
1683706296348,AWP 10,024,202057,Staff,0,0,0,0
1683706296348,AWP 10,025,202058,Staff,0,0,0,0
1683706296348,AWP 10,026,202059,Staff,0,0,0,0
1683706297376,AWP 102,001,202032,Staff,0,0,0,0
1683706297376,AWP 102,002,202033,Staff,0,0,0,0
1683706298407,BENG 100,A01,254234,Taylor Amos; Alyssa C,31,0,40,9
1683706299434,BENG 196,001,270013,Engler; Adam J.,9999,0,9999,0
1683706300467,BICD 100R,A01,202018,Smith; Laurie,0,7,32,32
1683706300467,BICD 100R,A02,202019,Smith; Laurie,0,3,32,32
1683706300467,BICD 100R,A03,202020,Smith; Laurie,0,1,32,32
1683706300467,BICD 100R,A04,202021,Smith; Laurie,6,0,32,26
1683706300467,BICD 100R,A05,202022,Smith; Laurie,10,0,32,22
1683706301499,BICD 136,A01,193242,Gustafson-Brown; Cindy,0,2,32,32
1683706301499,BICD 136,A02,193244,Gustafson-Brown; Cindy,13,0,32,19
1683706302530,BIEB 102,A01,193249,Butler; Shannon Rhey,0,0,32,32
1683706302530,BIEB 102,A02,193251,Butler; Shannon Rhey,0,0,32,32
1683706302530,BIEB 102,A03,193253,Butler; Shannon Rhey,0,0,32,32
1683706302530,BIEB 102,A04,193255,Butler; Shannon Rhey,13,0,32,19
1683706302530,BIEB 102,A05,193265,Butler; Shannon Rhey,25,0,32,7
1683706302530,BIEB 102,A06,193269,Butler; Shannon Rhey,12,0,32,20
1683706304582,BIEB 150,A01,193274,Staff,0,0,32,32
1683706304582,BIEB 150,A02,193285,Staff,24,0,32,8
1683706305613,BIEB 194,A00,193286,Kurle; Carolyn M.,19,0,32,13
1683706306642,BILD 1,A01,192291,Staff,15,0,32,17
1683706306642,BILD 1,A02,192292,Staff,30,0,32,2
1683706306642,BILD 1,B01,192520,Reuther; Keefe,0,1,0,0
1683706306642,BILD 1,B02,192532,Reuther; Keefe,0,1,0,0
1683706307675,BILD 3,A01,192556,Butler; Shannon Rhey,0,0,32,32
1683706307675,BILD 3,A02,192581,Butler; Shannon Rhey,0,1,32,32
1683706307675,BILD 3,A03,192611,Butler; Shannon Rhey,19,0,32,13
1683706307675,BILD 3,A04,192612,Butler; Shannon Rhey,23,0,32,9
1683706307675,BILD 3,A05,192613,Butler; Shannon Rhey,26,0,32,6
1683706307675,BILD 3,A06,192679,Butler; Shannon Rhey,27,0,32,5
1683706307675,BILD 3,A07,192682,Butler; Shannon Rhey,20,0,32,12
1683706308702,BILD 4,A01,192836,Reuther; Keefe,1,0,24,23
1683706308702,BILD 4,A02,193044,Reuther; Keefe,4,0,24,20
1683706309727,BILD 10,A01,193142,Gustafson-Brown; Cindy,29,0,32,3
1683706309727,BILD 10,A02,193149,Gustafson-Brown; Cindy,31,0,32,1
1683706310758,BIMM 100,A01,193301,Staff,0,6,32,32
1683706310758,BIMM 100,A02,193312,Staff,0,7,32,32
1683706310758,BIMM 100,A03,193323,Staff,0,10,32,32
1683706311792,BIMM 101,A01,193329,McDonnell; Lisa Marie,0,3,24,24
1683706311792,BIMM 101,A02,193339,McDonnell; Lisa Marie,0,3,24,24
1683706311792,BIMM 101,B01,193354,McDonnell; Lisa Marie,0,4,24,24
1683706311792,BIMM 101,B02,193357,McDonnell; Lisa Marie,0,3,24,24
1683706312825,BIMM 110,A01,193377,Tat; John,0,11,32,32
1683706312825,BIMM 110,A02,193378,Tat; John,0,11,32,32
1683706313860,BIMM 120,A01,206116,Staff,0,0,32,32
1683706313860,BIMM 120,A02,206117,Staff,7,0,32,25
1683706313860,BIMM 120,A03,206121,Staff,21,0,32,11
1683706314892,BIPN 100,A01,193393,Park; Ji Young,0,15,32,32
1683706314892,BIPN 100,A02,193402,Park; Ji Young,0,14,32,32
1683706314892,BIPN 100,A03,193413,Park; Ji Young,0,14,32,32
1683706314892,BIPN 100,A04,193414,Park; Ji Young,0,13,32,32
1683706315918,BIPN 102,A01,193429,Staff,0,0,32,32
1683706315918,BIPN 102,A02,193438,Staff,18,0,32,14
1683706316945,BIPN 106,A01,193450,Reyes Gonzalez; Catalina,0,2,40,40
1683706317978,BIPN 134,A01,193465,Cooke; James Edward,0,0,32,32
1683706317978,BIPN 134,A02,193474,Cooke; James Edward,25,0,32,7
1683706317978,BIPN 134,A03,193485,Cooke; James Edward,29,0,32,3
1683706317978,BIPN 134,A04,193486,Cooke; James Edward,20,0,32,12
1683706317978,BIPN 134,A05,193491,Cooke; James Edward,31,0,32,1
1683706317978,BIPN 134,A06,193501,Cooke; James Edward,30,0,32,2
1683706317978,BIPN 134,A07,193510,Cooke; James Edward,29,0,32,3
1683706320034,BISP 194,A00,222522,Staff,14,0,32,18
1683706321062,CAT 124,A01,202407,Staff,19,0,25,6
1683706322088,CAT 125,A00,202408,Marchisotto; Jennifer Anne,2,0,20,18
1683706323117,CAT 125R,A00,202409,Smith; Lauryn Alissa,0,11,20,20
1683706323117,CAT 125R,B00,202410,Morales; Celeste Georgianna,0,11,20,20
1683706323117,CAT 125R,C00,202411,Irwin; Matthew Joseph,0,12,20,20
1683706324148,CENG 15,A01,204712,Yang; Kesong,0,1,0,0
1683706325173,CENG 114,A00,202070,Jahed Motlagh; Zeinab,5,0,20,15
1683706326210,CGS 105,A00,185477,Wesling; Megan E.,24,0,40,16
1683706327236,CGS 106,A00,185494,Staff,11,0,22,11
1683706328262,CGS 108,A00,185495,Staff,14,0,20,6
1683706329288,CGS 114,A00,185496,Staff,13,0,18,5
1683706330315,CGS 119,A00,185501,Staff,15,0,20,5
1683706331341,CGS 120,A00,185511,Staff,11,0,20,9
1683706332370,CHEM 4,A01,184675,Bussey; Thomas J,97,0,100,3
1683706333399,CHEM 6A,A01,184677,Staff,32,0,60,28
1683706334425,CHEM 6B,A01,184679,Staff,63,0,100,37
1683706335450,CHEM 6C,A01,184681,Bussey; Thomas J,0,0,50,50
1683706335450,CHEM 6C,A02,184682,Bussey; Thomas J,32,0,50,18
1683706336482,CHEM 40A,A01,184684,Albizati; Kim F.,33,0,100,67
1683706337516,CHEM 40B,A01,184686,Albizati; Kim F.,0,22,100,100
1683706338542,CHEM 41B,A01,184690,Staff,51,0,100,49
1683706339575,COGS 3,A01,184715,Boyle; Mary E. T.,0,27,40,40
1683706340606,COGS 14B,A01,185172,Staff,0,14,38,38
1683706341634,COGS 18,A01,184736,Staff,14,0,80,66
1683706342662,COGS 100,A01,184932,Staff,0,8,73,73
1683706343688,COGS 101A,A01,184935,Staff,0,40,30,30
1683706344714,COGS 101B,A01,184944,Staff,0,2,30,30
1683706345739,COGS 101C,A01,184946,Staff,0,10,30,30
1683706346765,COGS 102A,A01,184951,Johnson; Christine M.,1,0,40,39
1683706347790,COGS 107B,A01,184953,Mooshagian; Eric Frederick,0,52,40,40
1683706348822,COGS 118B,A01,184959,Gupta; Anjum,0,50,40,40
1683706349850,COGS 153,A00,184961,Staff,1,16,30,29
1683706350875,COGS 177,A00,184962,Staff,0,20,30,30
1683706351906,COGS 187A,A01,184969,Boyle; Mary E. T.,0,19,40,40
1683706352940,COMM 10,A01,185174,Staff,0,5,25,25
1683706352940,COMM 10,A02,185189,Staff,0,2,25,25
1683706352940,COMM 10,A03,269821,Staff,0,1,0,0
1683706353974,COMM 100B,A02,185476,Staff,10,0,25,15
1683706353974,COMM 100B,A03,277340,Staff,25,0,25,0
1683706355006,COMM 100C,A01,185314,Staff,2,0,25,23
1683706355006,COMM 100C,A02,185327,Staff,17,0,25,8
1683706356034,COMM 110M,A00,185349,Staff,0,0,40,40
1683706357060,COMM 113T,A00,185352,Staff,25,0,40,15
1683706358089,COMM 114I,A00,185353,Staff,31,0,40,9
1683706359114,COMM 131,A00,185354,Staff,17,0,30,13
1683706360141,CSE 8A,A50,185358,Cao; Yingjun,0,46,10,10
1683706361174,CSE 8B,A01,185362,Staff,0,48,50,50
1683706362206,CSE 11,A01,185416,Cao; Yingjun,0,91,10,10
1683706363232,CSE 20,A01,185445,Briones; Jor-el Thomas Caparas,3,0,25,22
1683706364257,CSE 21,A01,185447,Staff,9,0,50,41
1683706365284,CSE 101,A01,185451,Staff,0,13,50,50
1683706365284,CSE 101,B01,185453,Jones; Miles E,0,15,50,50
1683706367342,CSE 141,A01,185458,Eldon; John,16,0,100,84
1683706368369,CSE 141L,A01,185461,Eldon; John,8,0,100,92
1683706369395,CSE 142,A01,185463,Staff,34,0,60,26
1683706369395,CSE 142,B01,201355,Staff,0,7,60,60
1683706370421,CSE 142L,A01,185470,Staff,34,0,60,26
1683706370421,CSE 142L,B01,201417,Staff,0,6,60,60
1683706371447,CSE 190,A00,201433,Staff,32,0,49,17
1683706372483,DOC 1,A01,259136,Strom; Megan C.,7,0,15,8
1683706372483,DOC 1,A02,259137,Strom; Megan C.,15,0,15,0
1683706372483,DOC 1,A03,259138,Strom; Megan C.,14,0,15,1
1683706372483,DOC 1,A04,259139,Strom; Megan C.,14,0,15,1
1683706373517,DOC 100D,A00,259140,Pass; Natalye Joann,14,0,25,11
1683706374545,DSGN 1,A01,184749,Rill; Bryan,0,26,30,30
1683706375571,DSGN 100,A01,185168,Staff,0,2,25,25
1683706376597,ECE 5,A01,185626,Morris; Karcher William,0,12,0,0
1683706377624,ECE 101,A01,185628,Staff,14,0,70,56
1683706378655,ECE 107,A01,185635,Baghdadchi; Saharnaz,0,0,20,20
1683706378655,ECE 107,A02,185638,Baghdadchi; Saharnaz,1,0,20,19
1683706379681,ECE 148,A01,185647,Silberman; Jack,0,0,16,16
1683706380707,ECON 1,A01,185537,Crane; Meredith Helen,54,0,70,16
1683706381733,ECON 3,A01,185549,Crane; Meredith Helen,30,0,70,40
1683706382759,ECON 4,A01,203354,Anderson; John Charles,0,5,10,10
1683706383785,ECON 100A,A01,185574,Staff,0,5,40,40
1683706384810,ECON 100B,A01,185576,Staff,0,12,50,50
1683706385840,ECON 100C,A01,185589,Newhouse; Herbert S,30,0,70,40
1683706386870,ECON 105,A00,185608,Vespa; Emanuel Ignacio,19,0,35,16
1683706387896,ECON 109,A01,185610,Shishkin; Denis,9,0,35,26
1683706388978,ECON 110A,A01,185612,Staff,8,0,40,32
1683706390069,ECON 120A,A01,185615,Staff,19,0,40,21
1683706391102,ECON 120C,A01,185617,Sun; Yixiao,0,21,70,70
1683706392133,ECON 144,A00,203346,Squires; Dale E,2,0,35,33
1683706393158,ECON 171,A01,203349,Newhouse; Herbert S,0,1,35,35
1683706394185,ECON 173A,A01,185621,Toda; Alexis Akira,21,0,35,14
1683706395217,EDS 25,A01,202413,Staff,0,1,0,0
1683706395217,EDS 25,A02,202414,Staff,0,1,0,0
1683706395217,EDS 25,A03,202415,Staff,0,0,0,0
1683706395217,EDS 25,A04,202416,Staff,0,1,0,0
1683706395217,EDS 25,A05,202439,Staff,0,0,0,0
1683706395217,EDS 25,A06,202440,Staff,0,0,0,0
1683706395217,EDS 25,B01,202631,Staff,0,0,0,0
1683706395217,EDS 25,B02,202632,Staff,0,0,0,0
1683706395217,EDS 25,B03,202639,Staff,0,0,0,0
1683706395217,EDS 25,B04,202640,Staff,0,0,0,0
1683706395217,EDS 25,B05,202643,Staff,0,0,0,0
1683706395217,EDS 25,B06,202644,Staff,0,0,0,0
1683706396247,EDS 38,A01,202659,Black; Alison Michelle,25,0,25,0
1683706397276,EDS 115,A00,202652,Staff,18,0,30,12
1683706398302,EDS 125,A00,202649,Staff,13,0,30,17
1683706399329,EDS 126,A01,203332,Staff,30,0,30,0
1683706400355,EDS 139,A00,202838,Staff,16,0,25,9
1683706401380,EDS 146,A01,202655,Staff,14,0,25,11
1683706402414,ENG 15,A00,185667,Staff,0,1,0,0
1683706402414,ENG 15,B00,185672,Staff,0,0,0,0
1683706402414,ENG 15,C00,185675,Staff,0,0,0,0
1683706402414,ENG 15,D00,185682,Staff,0,0,0,0
1683706402414,ENG 15,E00,185684,Staff,0,0,0,0
1683706403440,ETHN 103,A00,185710,Staff,0,8,35,35
1683706404471,ETHN 103A,A00,199228,Man; Simeon S,0,0,9,9
1683706405501,ETHN 109,A00,185711,Staff,15,0,35,20
1683706406528,ETHN 142,A00,185726,Staff,0,4,30,30
1683706407567,ETHN 163J,A00,199229,Man; Simeon S,5,0,8,3
1683706408592,ETHN 168,A00,185727,Staff,7,0,10,3
1683706409621,ETHN 182,A00,185728,Staff,0,0,35,35
1683706410646,ETHN 183,A00,185737,Staff,9,0,18,9
1683706411677,GLBH 111,A01,209361,Burgos; Jose L.,0,0,0,0
1683706413735,HIEU 104,A00,185792,Staff,14,0,20,6
1683706414761,HIEU 115,A00,185800,Staff,0,0,20,20
1683706415788,HIEU 128,A00,185801,Staff,0,9,20,20
1683706416814,HIEU 147,A00,185802,Staff,15,0,20,5
1683706417852,HIEU 154,A00,185823,Staff,11,0,20,9
1683706418880,HILA 102,A00,185826,Staff,14,0,20,6
1683706419910,HILD 2C,A01,185778,Staff,0,13,20,20
1683706420936,HILD 7B,A01,185780,Kwak; Nancy,0,17,32,32
1683706420936,HILD 7B,A02,185781,Kwak; Nancy,0,18,32,32
1683706421964,HILD 30,A01,185791,Staff,12,0,20,8
1683706422990,HISC 119,A00,185830,Golan; Tal,0,10,20,20
1683706424016,HITO 156GS,A00,185831,Patterson; Patrick H.,0,0,0,23
1683706425041,HIUS 103,A00,185832,Man; Simeon S,0,4,20,20
1683706426070,HIUS 117,A00,185836,Kwak; Nancy,2,0,20,18
1683706427098,HIUS 125,A00,185840,Man; Simeon S,0,2,23,23
1683706428125,HIUS 149,A00,185845,Staff,1,0,20,19
1683706429159,HUM 3,A01,185882,Zavodny; Tatiana Sophia,0,8,50,50
1683706429159,HUM 3,B01,185899,Caldwell; Michael Alan,0,18,50,50
1683706430187,HUM 3GS,A00,185900,Patterson; Patrick H.,0,0,0,23
1683706431223,HUM 4,A01,185938,Zroka; Amy Liane,28,0,50,22
1683706431223,HUM 4,B01,185956,Watkins; Eric,0,6,50,50
1683706431223,HUM 4,B02,202209,Watkins; Eric,0,5,50,50
1683706431223,HUM 4,B03,202210,Watkins; Eric,0,5,50,50
1683706432254,HUM 5,A01,185958,West; Geoffrey Scott,0,0,50,50
1683706432254,HUM 5,A02,202215,West; Geoffrey Scott,0,1,50,50
1683706433281,INTL 190,A00,185959,Gagnon; Jeffrey C,0,0,0,9
1683706433281,INTL 190,B00,185960,Lettieri; Michael Joseph,0,0,0,2
1683706434306,JAPN 180,A00,254509,Staff,5,0,30,25
1683706435334,LATI 10,A01,202853,Kennemore; Amy Michelle,4,0,35,31
1683706435334,LATI 10,A02,202854,Kennemore; Amy Michelle,3,0,35,32
1683706435334,LATI 10,A03,270054,Kennemore; Amy Michelle,30,0,30,0
1683706436363,LATI 180,A00,202855,Kennemore; Amy Michelle,11,0,20,9
1683706437394,LAWS 101,A00,201767,Golan; Tal,0,7,40,40
1683706438422,LIFR 1C,A00,185961,Staff,6,0,20,14
1683706439446,LIFR 1CX,A00,185962,Staff,7,0,20,13
1683706440471,LIFR 1D,A00,185963,Staff,7,0,20,13
1683706441499,LIFR 1DX,A00,185964,Staff,7,0,20,13
1683706442528,LIGN 101,A01,186039,Staff,43,0,50,7
1683706443556,LIGN 165,A00,186040,Staff,14,0,50,36
1683706444590,LTCS 108,A00,186041,Staff,5,0,10,5
1683706445616,LTCS 119,A00,186042,Staff,15,0,20,5
1683706446642,LTCS 130,A00,186043,Wesling; Megan E.,15,0,25,10
1683706448699,LTEA 138,A00,186119,Staff,14,0,40,26
1683706449724,LTEN 124,A00,186148,Staff,5,0,25,20
1683706450749,LTEN 178,A00,186149,Staff,6,0,15,9
1683706451773,LTEN 181,A00,186150,Blanco; John D,34,0,40,6
1683706452797,LTWL 120,A00,186160,Staff,19,0,25,6
1683706453823,LTWL 165,A00,186161,Staff,22,0,25,3
1683706454848,LTWR 100,A00,186162,Staff,0,5,15,15
1683706455880,LTWR 102,A00,186163,Doller; Ben,5,0,15,10
1683706456912,MAE 8,A01,186412,Staff,0,1,0,0
1683706457938,MAE 30B,A00,186445,Bahadori; Mohammad Yousef,81,0,100,19
1683706458965,MAE 40,A00,186592,Bewley; Thomas R,10,0,50,40
1683706459991,MAE 101B,A00,186593,Bahadori; Mohammad Yousef,80,0,100,20
1683706461024,MAE 105,A00,186594,Bandaru; Prabhakar,10,0,50,40
1683706462050,MAE 107,A00,186599,Pham; Hieu Tan,0,8,120,120
1683706463075,MAE 148,A01,186660,Silberman; Jack,3,0,16,13
1683706464108,MATH 10A,A01,188095,Staff,0,6,35,35
1683706465141,MATH 10B,A01,188097,Bowers; Adam R.,0,12,30,30
1683706465141,MATH 10B,A02,188099,Bowers; Adam R.,0,11,30,30
1683706465141,MATH 10B,B01,188104,Bowers; Adam R.,0,10,30,30
1683706465141,MATH 10B,B02,188106,Bowers; Adam R.,0,9,30,30
1683706466170,MATH 10C,A01,188111,Staff,0,20,30,30
1683706466170,MATH 10C,A02,188127,Staff,0,19,30,30
1683706466170,MATH 10C,A03,188131,Staff,0,19,30,30
1683706466170,MATH 10C,B01,188218,Staff,17,0,30,13
1683706466170,MATH 10C,B02,188244,Staff,13,0,30,17
1683706466170,MATH 10C,B03,188277,Staff,14,0,30,16
1683706467197,MATH 18,A01,188344,Bach; Quang Tran,18,0,30,12
1683706467197,MATH 18,A02,188345,Bach; Quang Tran,11,0,30,19
1683706467197,MATH 18,B01,188353,Bach; Quang Tran,11,0,30,19
1683706467197,MATH 18,B02,188354,Bach; Quang Tran,19,0,30,11
1683706468222,MATH 20A,A01,188374,Staff,11,0,35,24
1683706469254,MATH 20B,A01,188382,Ohm; Ko Woon,7,0,30,23
1683706469254,MATH 20B,A02,188383,Ohm; Ko Woon,22,0,30,8
1683706469254,MATH 20B,B01,188385,Ohm; Ko Woon,7,0,30,23
1683706469254,MATH 20B,B02,188392,Ohm; Ko Woon,22,0,30,8
1683706470280,MATH 20C,A01,188394,Harel; Guershon,10,0,30,20
1683706470280,MATH 20C,A02,188395,Harel; Guershon,13,0,30,17
1683706470280,MATH 20C,B01,188404,Harel; Guershon,5,0,30,25
1683706470280,MATH 20C,B02,188405,Harel; Guershon,18,0,30,12
1683706471308,MATH 20D,A01,188414,Hammock; Frances H,0,1,30,30
1683706471308,MATH 20D,A02,188415,Hammock; Frances H,0,1,30,30
1683706471308,MATH 20D,B01,188447,Hammock; Frances H,0,1,30,30
1683706471308,MATH 20D,B02,188486,Hammock; Frances H,2,0,30,28
1683706472337,MATH 20E,A01,188649,Staff,21,0,30,9
1683706472337,MATH 20E,A02,188650,Staff,20,0,30,10
1683706472337,MATH 20E,A03,188673,Staff,0,0,30,30
1683706473367,MATH 102,A01,188675,Staff,0,40,35,35
1683706474400,MATH 103B,A01,188681,Staff,3,0,35,32
1683706474400,MATH 103B,B01,188692,Staff,5,0,35,30
1683706475432,MATH 109,A01,188695,Salehi Golsefidy; Alireza,24,0,35,11
1683706475432,MATH 109,A02,188696,Salehi Golsefidy; Alireza,25,0,35,10
1683706476463,MATH 120A,A01,188698,Eggers; John Dietrich,7,0,35,28
1683706477489,MATH 142B,A01,188736,Ioana; Adrian,0,0,30,30
1683706477489,MATH 142B,A02,188741,Ioana; Adrian,0,1,30,30
1683706477489,MATH 142B,A03,188743,Ioana; Adrian,0,2,30,30
1683706478515,MATH 168A,A01,188790,Staff,0,11,35,35
1683706479542,MATH 170A,A01,188803,Nie; Jiawang,0,2,35,35
1683706479542,MATH 170A,A02,188811,Nie; Jiawang,0,1,35,35
1683706479542,MATH 170A,A03,188814,Nie; Jiawang,0,0,35,35
1683706479542,MATH 170A,A04,188815,Nie; Jiawang,5,0,35,30
1683706480571,MATH 193B,A01,188817,Staff,0,0,35,35
1683706480571,MATH 193B,A02,188818,Staff,6,0,35,29
1683706481596,MGT 4,A01,202857,Anderson; John Charles,59,0,80,21
1683706482622,MGT 12,A00,202858,Lindenberger; Wade Douglas,40,0,90,50
1683706483646,MGT 18,A00,202859,Staff,73,0,90,17
1683706484672,MGT 18GS,A00,202860,McKay; Michael J,13,0,28,15
1683706485703,MGT 45,A00,202861,Pecore; Joseph P.,8,0,90,82
1683706486729,MGT 100,A00,202863,Yavorsky; Daniel Ryan,27,0,90,63
1683706487759,MGT 103,A00,202864,Ehrich; Kristine R,0,19,90,90
1683706488788,MGT 112,A00,202865,Ehrich; Kristine R,15,0,90,75
1683706489819,MGT 121A,A00,202868,Staff,70,0,90,20
1683706490843,MGT 131B,A00,202869,Anderson; John Charles,58,0,90,32
1683706491869,MGT 136,A00,202871,Lindenberger; Wade Douglas,83,0,90,7
1683706492898,MGT 164,A00,202873,Staff,0,67,90,91
1683706493983,MGT 164GS,A00,202874,McKay; Mary A,13,0,28,15
1683706495013,MGT 180,A00,202875,Staff,0,51,90,91
1683706496042,MMW 11R,A01,205019,Herbst; Matthew,0,0,30,30
1683706496042,MMW 11R,A02,205026,Herbst; Matthew,29,0,30,1
1683706497069,MMW 15,A01,193512,Chang; Edmond Yi-Teh,0,8,28,28
1683706497069,MMW 15,A02,193513,Chang; Edmond Yi-Teh,0,5,28,28
1683706497069,MMW 15,A03,193514,Chang; Edmond Yi-Teh,0,5,28,28
1683706497069,MMW 15,A04,193515,Chang; Edmond Yi-Teh,0,5,28,28
1683706497069,MMW 15,A05,193516,Chang; Edmond Yi-Teh,0,5,28,28
1683706497069,MMW 15,A06,193517,Chang; Edmond Yi-Teh,0,6,28,28
1683706497069,MMW 15,B01,193519,Chang; Edmond Yi-Teh,0,5,28,28
1683706497069,MMW 15,B02,193520,Chang; Edmond Yi-Teh,0,5,28,28
1683706497069,MMW 15,B03,193521,Chang; Edmond Yi-Teh,0,5,28,28
1683706497069,MMW 15,B04,193522,Chang; Edmond Yi-Teh,0,6,28,28
1683706497069,MMW 15,B05,193523,Chang; Edmond Yi-Teh,0,5,28,28
1683706497069,MMW 15,B06,193524,Chang; Edmond Yi-Teh,0,5,28,28
1683706498094,MMW 122,A01,193526,Rahimi; Babak,0,16,28,28
1683706498094,MMW 122,A02,193527,Rahimi; Babak,0,15,28,28
1683706498094,MMW 122,A03,193528,Rahimi; Babak,0,0,0,0
1683706498094,MMW 122,A04,193529,Rahimi; Babak,0,0,0,0
1683706499120,MUS 1A,A01,186663,Staff,0,18,35,35
1683706500146,MUS 4,A01,186715,Staff,0,12,35,35
1683706501171,MUS 5R,A01,186796,Dubnov; Shlomo,0,17,35,35
1683706502197,MUS 6,A01,186798,Staff,0,4,25,25
1683706503222,MUS 7,A01,186830,Staff,11,0,35,24
1683706504248,MUS 8,A01,186930,Staff,0,27,35,35
1683706505279,MUS 15,A01,186932,Staff,0,15,35,35
1683706505279,MUS 15,B01,186934,Staff,0,16,35,35
1683706506305,MUS 80,A00,186935,Staff,0,0,20,20
1683706506305,MUS 80,B00,186936,Staff,24,0,25,1
1683706507330,NANO 11,A00,204702,Lipomi; Darren John,0,0,0,0
1683706508359,NANO 15,A01,204709,Yang; Kesong,0,1,0,0
1683706509385,NANO 114,A00,202069,Jahed Motlagh; Zeinab,2,0,10,8
1683706510419,PHIL 1,A00,186955,Grush; Rick Scott,31,0,40,9
1683706511445,PHIL 10,A01,186973,Grush; Rick Scott,27,0,35,8
1683706511445,PHIL 10,A02,186974,Grush; Rick Scott,33,0,35,2
1683706512471,PHIL 13,A01,186976,Staff,1,0,35,34
1683706512471,PHIL 13,A02,186977,Staff,16,0,35,19
1683706513496,PHIL 14,A01,186979,Staff,30,0,35,5
1683706513496,PHIL 14,A02,186986,Staff,32,0,35,3
1683706514528,PHIL 28,A01,186988,Staff,16,0,30,14
1683706514528,PHIL 28,A02,186989,Staff,0,0,30,30
1683706514528,PHIL 28,A03,186990,Staff,10,0,30,20
1683706514528,PHIL 28,A04,186991,Staff,26,0,30,4
1683706515554,PHIL 120,A00,186997,Staff,23,0,40,17
1683706516579,PHIL 137,A00,187003,Staff,7,0,40,33
1683706517615,PHIL 150,A00,187015,Staff,47,0,70,23
1683706518640,PHIL 167,A00,187021,Lamey; Andy M.,34,0,40,6
1683706519671,PHIL 174,A01,202226,Staff,17,0,20,3
1683706519671,PHIL 174,A02,202235,Staff,20,0,20,0
1683706520695,PHIL 191A,A00,258918,Staff,0,0,1,1
1683706521725,PHYS 1A,A00,187028,Staff,26,0,60,34
1683706522749,PHYS 1AL,001,187036,Staff,3,0,30,27
1683706522749,PHYS 1AL,002,187049,Staff,18,0,30,12
1683706523778,PHYS 1B,A00,187058,Staff,21,0,60,39
1683706524803,PHYS 1BL,001,187064,Staff,0,1,30,30
1683706524803,PHYS 1BL,002,187070,Staff,4,0,30,26
1683706525832,PHYS 1C,A00,187082,Staff,30,0,120,90
1683706526863,PHYS 1CL,001,187088,Staff,0,9,30,30
1683706526863,PHYS 1CL,002,187089,Staff,0,1,30,30
1683706526863,PHYS 1CL,009,262693,Staff,9,0,30,21
1683706527891,PHYS 2B,A01,187097,Staff,55,0,115,60
1683706528920,PHYS 2C,A01,187099,Staff,63,0,115,52
1683706529946,PHYS 2CL,A01,187101,Staff,5,0,28,23
1683706529946,PHYS 2CL,A02,187102,Staff,15,0,28,13
1683706530979,PHYS 2D,A01,187123,Shotwell; Brian,95,0,115,20
1683706532006,PHYS 4B,A01,187133,Grinstein; Benjamin,35,0,50,15
1683706533032,POLI 10,A00,188819,Staff,0,4,50,50
1683706534060,POLI 11,A00,188827,Staff,43,0,50,7
1683706535088,POLI 13R,A00,188828,Staff,0,1,20,20
1683706536118,POLI 27,A01,188830,Elgin; Samuel Zincke,0,2,70,70
1683706537149,POLI 30,A00,188832,Desposato; Scott,30,0,50,20
1683706538176,POLI 102F,A00,188834,Staff,1,0,40,39
1683706539204,POLI 104A,A00,188852,Staff,12,0,30,18
1683706540229,POLI 104I,A00,188853,Staff,0,8,20,20
1683706541258,POLI 110B,A00,188854,Wiens; David,6,0,20,14
1683706542283,POLI 112A,A00,188855,Wiens; David,3,0,30,27
1683706543312,POLI 117R,A00,188856,Forman; Fonna,0,12,20,20
1683706544337,POLI 118,A00,188857,Ingham; Sean,8,0,20,12
1683706545363,POLI 120G,A00,188858,Staff,7,0,30,23
1683706546388,POLI 131CR,A00,188863,Hoston; Germaine,20,0,50,30
1683706547425,POLI 133,A00,188864,Nellis; Gareth Hb,44,0,50,6
1683706548450,POLI 134D,A00,188865,Desposato; Scott,27,0,30,3
1683706549483,POLI 142A,A00,188871,Gartzke; Erik,21,0,50,29
1683706550509,POLI 142K,A00,188874,Staff,38,0,50,12
1683706551544,POLI 143,A00,188940,Gartzke; Erik,15,0,30,15
1683706552574,POLI 153,A00,188943,Staff,1,0,20,19
1683706553613,POLI 160AA,A00,188944,Staff,10,0,40,30
1683706554644,POLI 170A,A00,188945,Staff,10,0,30,20
1683706556697,PSYC 1,A00,188952,Staff,36,0,90,54
1683706557723,PSYC 2,B00,188953,Staff,19,0,35,16
1683706558749,PSYC 6,A00,188970,Staff,47,0,60,13
1683706559776,PSYC 7,A00,188973,Staff,35,0,45,10
1683706560809,PSYC 60,A01,188980,Rickard; Timothy C.,42,0,60,18
1683706561836,PSYC 70,A01,189001,Steiner; Eric Tomas,22,0,45,23
1683706562867,PSYC 100,A00,189005,Lacefield; Katharine I,1,98,120,119
1683706563897,PSYC 102,A00,189008,Staff,6,0,30,24
1683706564930,PSYC 106,B00,189026,Gorman; Michael R.,27,0,60,33
1683706565958,PSYC 114,B01,189033,Winkielman; Piotr,0,31,30,30
1683706566985,PSYC 131,A00,189036,Anagnostaras; Stephan,0,44,60,60
1683706568014,PSYC 136,A00,189041,Lowe; Angela Beth,0,7,25,25
1683706569038,PSYC 137,A00,189057,Winkielman; Piotr,0,36,25,25
1683706570070,PSYC 144,A00,189107,Wixted; John T,0,11,50,50
1683706572123,PSYC 162,A00,189142,Staff,0,9,85,85
1683706573149,PSYC 172,A00,189144,Gorman; Michael R.,0,6,30,30
1683706575215,PSYC 179,A00,189146,Lacefield; Katharine I,0,88,120,120
1683706576239,PSYC 181,A00,189147,Anagnostaras; Stephan,0,45,90,90
1683706577273,PSYC 190R,A00,189148,Barner; David A.,0,23,80,80
1683706578299,PSYC 191,A00,189275,Rickard; Timothy C.,0,11,25,25
1683706579325,PSYC 193,A00,189276,Chapman; Eddie Nathaniel,0,1,0,4
1683706580358,PSYC 193L,A01,189281,Lowe; Angela Beth,8,0,20,12
1683706580358,PSYC 193L,B01,189285,Staff,28,0,35,7
1683706581388,RELI 149,A00,187137,Rahimi; Babak,6,0,40,34
1683706582415,SE 9,A01,187315,Staff,0,2,18,18
1683706583444,SE 101B,A00,187409,Staff,24,0,30,6
1683706584474,SE 110B,A00,187444,Staff,10,0,40,30
1683706585500,SE 130B,A00,187449,Staff,31,0,40,9
1683706586530,SE 150A,A00,187516,Staff,8,0,20,12
1683706587556,SE 154,A00,187528,Staff,29,0,50,21
1683706588599,SIO 3,A01,258171,Staff,35,0,40,5
1683706589629,SIO 10,A00,187144,Cook; Geoffrey W,0,6,75,75
1683706590653,SIO 45,A00,187152,Cook; Geoffrey W,1,7,100,99
1683706591677,SIO 109R,A00,194486,Staff,0,4,20,20
1683706593735,SIO 187,A01,187233,Kacev; David,12,0,40,28
1683706594771,SOCI 1,A01,258656,Thorpe; Charles Robert,28,0,30,2
1683706594771,SOCI 1,A02,258658,Thorpe; Charles Robert,30,0,30,0
1683706594771,SOCI 1,A03,258661,Thorpe; Charles Robert,25,0,25,0
1683706594771,SOCI 1,A04,258666,Thorpe; Charles Robert,22,0,25,3
1683706594771,SOCI 1,A05,258897,Thorpe; Charles Robert,22,0,25,3
1683706594771,SOCI 1,A06,258898,Thorpe; Charles Robert,25,0,25,0
1683706595798,SOCI 30,A01,258903,Pardo Guerra; Juan Pablo,14,0,30,16
1683706596827,SOCI 102,A00,258904,Staff,9,0,25,16
1683706597913,SOCI 106,A00,258905,Staff,19,0,25,6
1683706598940,SOCI 111,A00,258907,Ribas Norris; Janet Vanesa,26,0,30,4
1683706599963,SOCI 121R,A00,258908,Pardo Guerra; Juan Pablo,7,0,30,23
1683706600988,SOCI 126,A01,203330,Staff,14,0,20,6
1683706602013,SOCI 131,A00,258909,Thorpe; Charles Robert,30,0,60,30
1683706603040,SOCI 135,A00,258910,Payne; Christine Anna,0,13,30,30
1683706604066,SOCI 157,A00,258911,Staff,10,0,30,20
1683706605095,SOCI 184,A00,258912,Staff,25,0,30,5
1683706606121,SOCI 188D,A00,258913,Staff,22,0,30,8
1683706607146,SYN 2,001,187529,Staff,9,0,16,7
1683706607146,SYN 2,002,201452,Staff,0,20,16,16
1683706607146,SYN 2,003,201469,Staff,1,0,16,15
1683706608174,SYN 100,A01,187531,Staff,0,9,20,20
1683706608174,SYN 100,B01,201491,Staff,0,10,20,20
1683706609200,TDAC 1,A00,189286,Walsh; Kim C.,3,0,20,17
1683706609200,TDAC 1,B00,189287,Harting; Carla Kelso,10,0,20,10
1683706610228,TDAC 101,A00,189300,Walsh; Kim C.,16,0,20,4
1683706610228,TDAC 101,B00,189301,Harting; Carla Kelso,18,0,20,2
1683706611253,TDAC 102,A00,189304,Basso; Beatrice,14,0,20,6
1683706612279,TDAC 108,A00,189305,Staff,18,0,20,2
1683706613306,TDDE 131,A00,189310,Staff,19,0,20,1
1683706613306,TDDE 131,B00,189314,Staff,19,0,20,1
1683706613306,TDDE 131,C00,189315,Staff,48,0,50,2
1683706613306,TDDE 131,D00,189316,Staff,14,0,15,1
1683706613306,TDDE 131,E00,204841,Staff,20,0,20,0
1683706614334,TDGE 10,A00,189289,Staff,27,0,50,23
1683706614334,TDGE 10,B00,189290,Havis; Allan,0,1,50,50
1683706615368,TDGE 11,A00,189291,Fulton; Julia,0,4,50,50
1683706615368,TDGE 11,B00,189292,Staff,20,0,25,5
1683706615368,TDGE 11,C00,260270,Staff,0,0,0,0
1683706616395,TDGE 25,A00,189294,Staff,1,0,20,19
1683706617428,TDGE 124,A00,189318,Fulton; Julia,0,7,50,50
1683706618454,TDGE 125,A00,189319,Staff,13,0,25,12
1683706618454,TDGE 125,B00,189320,Staff,23,0,25,2
1683706619478,TDGE 127,A00,189322,Havis; Allan,1,0,50,49
1683706620508,TDHT 101,A00,189323,Staff,18,0,25,7
1683706620508,TDHT 101,B00,189324,Staff,25,0,25,0
1683706621532,TDHT 102,A00,189325,Staff,49,0,50,1
1683706622559,TDMV 1,A00,189295,Arcidiacono; Kristin,20,0,30,10
1683706622559,TDMV 1,B00,189296,Caligagan; Maria T.,23,0,30,7
1683706623593,TDMV 2,A00,189297,Sammartano; Tonnie,27,0,30,3
1683706623593,TDMV 2,B00,189299,Arcidiacono; Kristin,23,0,30,7
1683706624630,TDMV 3,A00,204998,Rincon; Alicia,22,0,30,8
1683706625656,TDMV 120,A00,189458,Sammartano; Tonnie,28,0,30,2
1683706626683,TDMV 138,A00,189541,Jun; Grace Shin Hae,20,0,40,20
1683706627709,TDMV 142,A00,189717,Caligagan; Tony,25,0,30,5
1683706627709,TDMV 142,B00,189718,Caligagan; Maria T.,25,0,30,5
1683706628742,TMC 2,A01,187533,Staff,25,0,25,0
1683706628742,TMC 2,A02,187534,Staff,25,0,25,0
1683706629770,USP 1,A01,187536,Kwak; Nancy,0,16,25,25
1683706630799,USP 5,A01,187538,Staff,8,0,25,17
1683706631829,USP 101,A00,199253,Staff,0,4,0,0
1683706632857,USP 124,A00,187562,Boomhower; Matthew Charles,0,0,30,30
1683706633887,USP 138,A00,187582,Staff,19,0,25,6
1683706634912,USP 152,A01,187597,Staff,3,0,25,22
1683706635939,USP 153,A00,187598,Staff,18,0,25,7
1683706636963,USP 168,A00,187607,Kwak; Nancy,2,0,5,3
1683706637990,USP 173,A00,187619,Staff,4,0,25,21
1683706639020,USP 181,A00,187638,Staff,0,4,25,25
1683706640062,VIS 103,A00,187650,Cruz; Edwin Teddy,17,0,75,58
1683706641087,VIS 110D,A00,187669,Staff,13,0,22,9
1683706642116,VIS 127C,A00,187720,Shen; Kuiyi,67,0,146,79
1683706643142,VIS 149,A00,187731,Yoldas; Pinar,0,12,22,22
1683706644171,VIS 151,A01,188091,Staff,22,0,34,12
1683706644171,VIS 151,A02,188092,Staff,11,0,34,23
1683706645196,VIS 160B,A00,188093,Stalbaum; Brett,0,1,10,10
1683706647255,WCWP 10B,A00,201720,Staff,0,0,5,5
1683706647255,WCWP 10B,B00,201722,Staff,0,0,6,6
1683706648279,WCWP 100,A00,201725,Gagnon; Jeffrey C,0,0,2,2
1683706648279,WCWP 100,B00,201727,Staff,0,4,15,15
1683706651393,ANBI 133,A00,258401,Wilder; Linnea Lorene,34,0,40,6
1683706652419,ANBI 140,A00,258395,Hrvoj Mihic; Branka,18,0,25,7
1683706653445,ANSC 120,A00,258402,Bialecki; Jon Anthony,26,0,40,14
1683706654469,ANSC 144,A00,258400,Staff,12,0,40,28
1683706656529,ANSC 166,A00,258396,Parish; Steven Martin,156,0,175,19
1683706657557,ANSC 180,A00,193533,Staff,8,0,20,12
1683706658581,ANSC 188,A00,258397,Jassal; Aftab,34,0,40,6
1683706659609,ANTH 3,A01,258316,Staff,23,0,30,7
1683706660642,ANTH 5,A00,258394,Semendeferi; Ekaterini,16,0,20,4
1683706661672,ANTH 21,A01,258331,Staff,4,0,40,36
1683706662698,ANTH 103,A00,258398,Varma; Saiba,15,0,25,10
1683706663728,AWP 10,001,202034,Staff,0,0,0,0
1683706663728,AWP 10,002,202035,Staff,0,0,0,0
1683706663728,AWP 10,003,202036,Staff,0,0,0,0
1683706663728,AWP 10,004,202037,Staff,0,0,0,0
1683706663728,AWP 10,005,202038,Staff,0,0,0,0
1683706663728,AWP 10,006,202039,Staff,0,0,0,0
1683706663728,AWP 10,007,202040,Staff,0,0,0,0
1683706663728,AWP 10,008,202041,Staff,0,0,0,0
1683706663728,AWP 10,009,202042,Staff,0,0,0,0
1683706663728,AWP 10,010,202043,Staff,0,0,0,0
1683706663728,AWP 10,011,202044,Staff,0,0,0,0
1683706663728,AWP 10,012,202045,Staff,0,0,0,0
1683706663728,AWP 10,013,202046,Staff,0,0,0,0
1683706663728,AWP 10,014,202047,Staff,0,0,0,0
1683706663728,AWP 10,015,202048,Staff,0,0,0,0
1683706663728,AWP 10,016,202049,Staff,0,0,0,0
1683706663728,AWP 10,017,202050,Staff,0,0,0,0
1683706663728,AWP 10,018,202051,Staff,0,0,0,0
1683706663728,AWP 10,019,202052,Staff,0,0,0,0
1683706663728,AWP 10,020,202053,Staff,0,0,0,0
1683706663728,AWP 10,021,202054,Staff,0,0,0,0
1683706663728,AWP 10,022,202055,Staff,0,0,0,0
1683706663728,AWP 10,023,202056,Staff,0,0,0,0
1683706663728,AWP 10,024,202057,Staff,0,0,0,0
1683706663728,AWP 10,025,202058,Staff,0,0,0,0
1683706663728,AWP 10,026,202059,Staff,0,0,0,0
1683706664753,AWP 102,001,202032,Staff,0,0,0,0
1683706664753,AWP 102,002,202033,Staff,0,0,0,0
1683706665786,BENG 100,A01,254234,Taylor Amos; Alyssa C,31,0,40,9
1683706666812,BENG 196,001,270013,Engler; Adam J.,9999,0,9999,0
1683706667839,BICD 100R,A01,202018,Smith; Laurie,0,7,32,32
1683706667839,BICD 100R,A02,202019,Smith; Laurie,0,3,32,32
1683706667839,BICD 100R,A03,202020,Smith; Laurie,0,1,32,32
1683706667839,BICD 100R,A04,202021,Smith; Laurie,6,0,32,26
1683706667839,BICD 100R,A05,202022,Smith; Laurie,10,0,32,22
1683706668867,BICD 136,A01,193242,Gustafson-Brown; Cindy,0,2,32,32
1683706668867,BICD 136,A02,193244,Gustafson-Brown; Cindy,13,0,32,19
1683706669894,BIEB 102,A01,193249,Butler; Shannon Rhey,0,0,32,32
1683706669894,BIEB 102,A02,193251,Butler; Shannon Rhey,0,0,32,32
1683706669894,BIEB 102,A03,193253,Butler; Shannon Rhey,0,0,32,32
1683706669894,BIEB 102,A04,193255,Butler; Shannon Rhey,13,0,32,19
1683706669894,BIEB 102,A05,193265,Butler; Shannon Rhey,25,0,32,7
1683706669894,BIEB 102,A06,193269,Butler; Shannon Rhey,12,0,32,20
1683706671955,BIEB 150,A01,193274,Staff,0,0,32,32
1683706671955,BIEB 150,A02,193285,Staff,24,0,32,8
1683706672985,BIEB 194,A00,193286,Kurle; Carolyn M.,19,0,32,13
1683706674012,BILD 1,A01,192291,Staff,15,0,32,17
1683706674012,BILD 1,A02,192292,Staff,30,0,32,2
1683706674012,BILD 1,B01,192520,Reuther; Keefe,0,1,0,0
1683706674012,BILD 1,B02,192532,Reuther; Keefe,0,1,0,0
1683706675040,BILD 3,A01,192556,Butler; Shannon Rhey,0,0,32,32
1683706675040,BILD 3,A02,192581,Butler; Shannon Rhey,0,1,32,32
1683706675040,BILD 3,A03,192611,Butler; Shannon Rhey,19,0,32,13
1683706675040,BILD 3,A04,192612,Butler; Shannon Rhey,23,0,32,9
1683706675040,BILD 3,A05,192613,Butler; Shannon Rhey,26,0,32,6
1683706675040,BILD 3,A06,192679,Butler; Shannon Rhey,27,0,32,5
1683706675040,BILD 3,A07,192682,Butler; Shannon Rhey,20,0,32,12
1683706676066,BILD 4,A01,192836,Reuther; Keefe,1,0,24,23
1683706676066,BILD 4,A02,193044,Reuther; Keefe,4,0,24,20
1683706677096,BILD 10,A01,193142,Gustafson-Brown; Cindy,29,0,32,3
1683706677096,BILD 10,A02,193149,Gustafson-Brown; Cindy,31,0,32,1
1683706678120,BIMM 100,A01,193301,Staff,0,6,32,32
1683706678120,BIMM 100,A02,193312,Staff,0,7,32,32
1683706678120,BIMM 100,A03,193323,Staff,0,10,32,32
1683706679153,BIMM 101,A01,193329,McDonnell; Lisa Marie,0,3,24,24
1683706679153,BIMM 101,A02,193339,McDonnell; Lisa Marie,0,3,24,24
1683706679153,BIMM 101,B01,193354,McDonnell; Lisa Marie,0,4,24,24
1683706679153,BIMM 101,B02,193357,McDonnell; Lisa Marie,0,3,24,24
1683706680180,BIMM 110,A01,193377,Tat; John,0,11,32,32
1683706680180,BIMM 110,A02,193378,Tat; John,0,11,32,32
1683706681210,BIMM 120,A01,206116,Staff,0,0,32,32
1683706681210,BIMM 120,A02,206117,Staff,7,0,32,25
1683706681210,BIMM 120,A03,206121,Staff,21,0,32,11
1683706682238,BIPN 100,A01,193393,Park; Ji Young,0,15,32,32
1683706682238,BIPN 100,A02,193402,Park; Ji Young,0,14,32,32
1683706682238,BIPN 100,A03,193413,Park; Ji Young,0,14,32,32
1683706682238,BIPN 100,A04,193414,Park; Ji Young,0,13,32,32
1683706683269,BIPN 102,A01,193429,Staff,0,0,32,32
1683706683269,BIPN 102,A02,193438,Staff,18,0,32,14
1683706684302,BIPN 106,A01,193450,Reyes Gonzalez; Catalina,0,2,40,40
1683706685327,BIPN 134,A01,193465,Cooke; James Edward,0,0,32,32
1683706685327,BIPN 134,A02,193474,Cooke; James Edward,25,0,32,7
1683706685327,BIPN 134,A03,193485,Cooke; James Edward,29,0,32,3
1683706685327,BIPN 134,A04,193486,Cooke; James Edward,20,0,32,12
1683706685327,BIPN 134,A05,193491,Cooke; James Edward,31,0,32,1
1683706685327,BIPN 134,A06,193501,Cooke; James Edward,30,0,32,2
1683706685327,BIPN 134,A07,193510,Cooke; James Edward,29,0,32,3
1683706687387,BISP 194,A00,222522,Staff,14,0,32,18
1683706688412,CAT 124,A01,202407,Staff,19,0,25,6
1683706689441,CAT 125,A00,202408,Marchisotto; Jennifer Anne,2,0,20,18
1683706690473,CAT 125R,A00,202409,Smith; Lauryn Alissa,0,11,20,20
1683706690473,CAT 125R,B00,202410,Morales; Celeste Georgianna,0,11,20,20
1683706690473,CAT 125R,C00,202411,Irwin; Matthew Joseph,0,12,20,20
1683706691498,CENG 15,A01,204712,Yang; Kesong,0,1,0,0
1683706692525,CENG 114,A00,202070,Jahed Motlagh; Zeinab,5,0,20,15
1683706693551,CGS 105,A00,185477,Wesling; Megan E.,24,0,40,16
1683706694576,CGS 106,A00,185494,Staff,11,0,22,11
1683706695602,CGS 108,A00,185495,Staff,14,0,20,6
1683706696632,CGS 114,A00,185496,Staff,13,0,18,5
1683706697661,CGS 119,A00,185501,Staff,15,0,20,5
1683706698686,CGS 120,A00,185511,Staff,11,0,20,9
1683706699718,CHEM 4,A01,184675,Bussey; Thomas J,97,0,100,3
1683706700746,CHEM 6A,A01,184677,Staff,32,0,60,28
1683706701826,CHEM 6B,A01,184679,Staff,63,0,100,37
1683706702856,CHEM 6C,A01,184681,Bussey; Thomas J,0,0,50,50
1683706702856,CHEM 6C,A02,184682,Bussey; Thomas J,32,0,50,18
1683706703882,CHEM 40A,A01,184684,Albizati; Kim F.,33,0,100,67
1683706704907,CHEM 40B,A01,184686,Albizati; Kim F.,0,22,100,100
1683706705936,CHEM 41B,A01,184690,Staff,51,0,100,49
1683706706966,COGS 3,A01,184715,Boyle; Mary E. T.,0,27,40,40
1683706707993,COGS 14B,A01,185172,Staff,0,14,38,38
1683706709023,COGS 18,A01,184736,Staff,14,0,80,66
1683706710052,COGS 100,A01,184932,Staff,0,8,73,73
1683706711082,COGS 101A,A01,184935,Staff,0,40,30,30
1683706712107,COGS 101B,A01,184944,Staff,0,2,30,30
1683706713136,COGS 101C,A01,184946,Staff,0,10,30,30
1683706714161,COGS 102A,A01,184951,Johnson; Christine M.,1,0,40,39
1683706715192,COGS 107B,A01,184953,Mooshagian; Eric Frederick,0,52,40,40
1683706716217,COGS 118B,A01,184959,Gupta; Anjum,0,50,40,40
1683706717245,COGS 153,A00,184961,Staff,1,16,30,29
1683706718277,COGS 177,A00,184962,Staff,0,20,30,30
1683706719305,COGS 187A,A01,184969,Boyle; Mary E. T.,0,19,40,40
1683706720330,COMM 10,A01,185174,Staff,0,5,25,25
1683706720330,COMM 10,A02,185189,Staff,0,2,25,25
1683706720330,COMM 10,A03,269821,Staff,0,1,0,0
1683706721372,COMM 100B,A02,185476,Staff,10,0,25,15
1683706721372,COMM 100B,A03,277340,Staff,25,0,25,0
1683706722399,COMM 100C,A01,185314,Staff,2,0,25,23
1683706722399,COMM 100C,A02,185327,Staff,17,0,25,8
1683706723425,COMM 110M,A00,185349,Staff,0,0,40,40
1683706724451,COMM 113T,A00,185352,Staff,25,0,40,15
1683706725475,COMM 114I,A00,185353,Staff,31,0,40,9
1683706726504,COMM 131,A00,185354,Staff,17,0,30,13
1683706727529,CSE 8A,A50,185358,Cao; Yingjun,0,46,10,10
1683706728554,CSE 8B,A01,185362,Staff,0,48,50,50
1683706729579,CSE 11,A01,185416,Cao; Yingjun,0,91,10,10
1683706730605,CSE 20,A01,185445,Briones; Jor-el Thomas Caparas,3,0,25,22
1683706731635,CSE 21,A01,185447,Staff,9,0,50,41
1683706732660,CSE 101,A01,185451,Staff,0,13,50,50
1683706732660,CSE 101,B01,185453,Jones; Miles E,0,15,50,50
1683706734710,CSE 141,A01,185458,Eldon; John,16,0,100,84
1683706735735,CSE 141L,A01,185461,Eldon; John,8,0,100,92
1683706736759,CSE 142,A01,185463,Staff,34,0,60,26
1683706736759,CSE 142,B01,201355,Staff,0,7,60,60
1683706737786,CSE 142L,A01,185470,Staff,34,0,60,26
1683706737786,CSE 142L,B01,201417,Staff,0,6,60,60
1683706738815,CSE 190,A00,201433,Staff,32,0,49,17
1683706739842,DOC 1,A01,259136,Strom; Megan C.,7,0,15,8
1683706739842,DOC 1,A02,259137,Strom; Megan C.,15,0,15,0
1683706739842,DOC 1,A03,259138,Strom; Megan C.,14,0,15,1
1683706739842,DOC 1,A04,259139,Strom; Megan C.,14,0,15,1
1683706740867,DOC 100D,A00,259140,Pass; Natalye Joann,14,0,25,11
1683706741893,DSGN 1,A01,184749,Rill; Bryan,0,26,30,30
1683706742923,DSGN 100,A01,185168,Staff,0,2,25,25
1683706743956,ECE 5,A01,185626,Morris; Karcher William,0,12,0,0
1683706744982,ECE 101,A01,185628,Staff,14,0,70,56
1683706746007,ECE 107,A01,185635,Baghdadchi; Saharnaz,0,0,20,20
1683706746007,ECE 107,A02,185638,Baghdadchi; Saharnaz,1,0,20,19
1683706747032,ECE 148,A01,185647,Silberman; Jack,0,0,16,16
1683706748061,ECON 1,A01,185537,Crane; Meredith Helen,54,0,70,16
1683706749090,ECON 3,A01,185549,Crane; Meredith Helen,30,0,70,40
1683706750124,ECON 4,A01,203354,Anderson; John Charles,0,5,10,10
1683706751153,ECON 100A,A01,185574,Staff,0,5,40,40
1683706752181,ECON 100B,A01,185576,Staff,0,12,50,50
1683706753206,ECON 100C,A01,185589,Newhouse; Herbert S,30,0,70,40
1683706754232,ECON 105,A00,185608,Vespa; Emanuel Ignacio,19,0,35,16
1683706755257,ECON 109,A01,185610,Shishkin; Denis,9,0,35,26
1683706756282,ECON 110A,A01,185612,Staff,8,0,40,32
1683706757307,ECON 120A,A01,185615,Staff,19,0,40,21
1683706758335,ECON 120C,A01,185617,Sun; Yixiao,0,21,70,70
1683706759365,ECON 144,A00,203346,Squires; Dale E,2,0,35,33
1683706760390,ECON 171,A01,203349,Newhouse; Herbert S,0,1,35,35
1683706761415,ECON 173A,A01,185621,Toda; Alexis Akira,21,0,35,14
1683706762441,EDS 25,A01,202413,Staff,0,1,0,0
1683706762441,EDS 25,A02,202414,Staff,0,1,0,0
1683706762441,EDS 25,A03,202415,Staff,0,0,0,0
1683706762441,EDS 25,A04,202416,Staff,0,1,0,0
1683706762441,EDS 25,A05,202439,Staff,0,0,0,0
1683706762441,EDS 25,A06,202440,Staff,0,0,0,0
1683706762441,EDS 25,B01,202631,Staff,0,0,0,0
1683706762441,EDS 25,B02,202632,Staff,0,0,0,0
1683706762441,EDS 25,B03,202639,Staff,0,0,0,0
1683706762441,EDS 25,B04,202640,Staff,0,0,0,0
1683706762441,EDS 25,B05,202643,Staff,0,0,0,0
1683706762441,EDS 25,B06,202644,Staff,0,0,0,0
1683706763473,EDS 38,A01,202659,Black; Alison Michelle,25,0,25,0
1683706764500,EDS 115,A00,202652,Staff,18,0,30,12
1683706765533,EDS 125,A00,202649,Staff,13,0,30,17
1683706766564,EDS 126,A01,203332,Staff,30,0,30,0
1683706767589,EDS 139,A00,202838,Staff,16,0,25,9
1683706768629,EDS 146,A01,202655,Staff,14,0,25,11
1683706769658,ENG 15,A00,185667,Staff,0,1,0,0
1683706769658,ENG 15,B00,185672,Staff,0,0,0,0
1683706769658,ENG 15,C00,185675,Staff,0,0,0,0
1683706769658,ENG 15,D00,185682,Staff,0,0,0,0
1683706769658,ENG 15,E00,185684,Staff,0,0,0,0
1683706770682,ETHN 103,A00,185710,Staff,0,8,35,35
1683706771713,ETHN 103A,A00,199228,Man; Simeon S,0,0,9,9
1683706772738,ETHN 109,A00,185711,Staff,15,0,35,20
1683706773765,ETHN 142,A00,185726,Staff,0,4,30,30
1683706774791,ETHN 163J,A00,199229,Man; Simeon S,5,0,8,3
1683706775817,ETHN 168,A00,185727,Staff,7,0,10,3
1683706776843,ETHN 182,A00,185728,Staff,0,0,35,35
1683706777871,ETHN 183,A00,185737,Staff,9,0,18,9
1683706778897,GLBH 111,A01,209361,Burgos; Jose L.,0,0,0,0
1683706780948,HIEU 104,A00,185792,Staff,14,0,20,6
1683706781973,HIEU 115,A00,185800,Staff,0,0,20,20
1683706782998,HIEU 128,A00,185801,Staff,0,9,20,20
1683706784025,HIEU 147,A00,185802,Staff,15,0,20,5
1683706785055,HIEU 154,A00,185823,Staff,11,0,20,9
1683706786079,HILA 102,A00,185826,Staff,14,0,20,6
1683706787105,HILD 2C,A01,185778,Staff,0,13,20,20
1683706788131,HILD 7B,A01,185780,Kwak; Nancy,0,17,32,32
1683706788131,HILD 7B,A02,185781,Kwak; Nancy,0,18,32,32
1683706789155,HILD 30,A01,185791,Staff,12,0,20,8
1683706790178,HISC 119,A00,185830,Golan; Tal,0,10,20,20
1683706791207,HITO 156GS,A00,185831,Patterson; Patrick H.,0,0,0,23
1683706792235,HIUS 103,A00,185832,Man; Simeon S,0,4,20,20
1683706793260,HIUS 117,A00,185836,Kwak; Nancy,2,0,20,18
1683706794293,HIUS 125,A00,185840,Man; Simeon S,0,2,23,23
1683706795322,HIUS 149,A00,185845,Staff,1,0,20,19
1683706796348,HUM 3,A01,185882,Zavodny; Tatiana Sophia,0,8,50,50
1683706796348,HUM 3,B01,185899,Caldwell; Michael Alan,0,18,50,50
1683706797372,HUM 3GS,A00,185900,Patterson; Patrick H.,0,0,0,23
1683706798405,HUM 4,A01,185938,Zroka; Amy Liane,28,0,50,22
1683706798405,HUM 4,B01,185956,Watkins; Eric,0,6,50,50
1683706798405,HUM 4,B02,202209,Watkins; Eric,0,5,50,50
1683706798405,HUM 4,B03,202210,Watkins; Eric,0,5,50,50
1683706799432,HUM 5,A01,185958,West; Geoffrey Scott,0,0,50,50
1683706799432,HUM 5,A02,202215,West; Geoffrey Scott,0,1,50,50
1683706800458,INTL 190,A00,185959,Gagnon; Jeffrey C,0,0,0,9
1683706800458,INTL 190,B00,185960,Lettieri; Michael Joseph,0,0,0,2
1683706801486,JAPN 180,A00,254509,Staff,5,0,30,25
1683706802519,LATI 10,A01,202853,Kennemore; Amy Michelle,4,0,35,31
1683706802519,LATI 10,A02,202854,Kennemore; Amy Michelle,3,0,35,32
1683706802519,LATI 10,A03,270054,Kennemore; Amy Michelle,30,0,30,0
1683706803544,LATI 180,A00,202855,Kennemore; Amy Michelle,11,0,20,9
1683706804575,LAWS 101,A00,201767,Golan; Tal,0,7,40,40
1683706805660,LIFR 1C,A00,185961,Staff,6,0,20,14
1683706806685,LIFR 1CX,A00,185962,Staff,7,0,20,13
1683706807713,LIFR 1D,A00,185963,Staff,7,0,20,13
1683706808738,LIFR 1DX,A00,185964,Staff,7,0,20,13
1683706809772,LIGN 101,A01,186039,Staff,43,0,50,7
1683706810797,LIGN 165,A00,186040,Staff,14,0,50,36
1683706811827,LTCS 108,A00,186041,Staff,5,0,10,5
1683706812854,LTCS 119,A00,186042,Staff,15,0,20,5
1683706813880,LTCS 130,A00,186043,Wesling; Megan E.,15,0,25,10
1683706815937,LTEA 138,A00,186119,Staff,14,0,40,26
1683706816964,LTEN 124,A00,186148,Staff,5,0,25,20
1683706817993,LTEN 178,A00,186149,Staff,6,0,15,9
1683706819016,LTEN 181,A00,186150,Blanco; John D,34,0,40,6
1683706820043,LTWL 120,A00,186160,Staff,19,0,25,6
1683706821068,LTWL 165,A00,186161,Staff,22,0,25,3
1683706822096,LTWR 100,A00,186162,Staff,0,5,15,15
1683706823121,LTWR 102,A00,186163,Doller; Ben,5,0,15,10
1683706824151,MAE 8,A01,186412,Staff,0,1,0,0
1683706825176,MAE 30B,A00,186445,Bahadori; Mohammad Yousef,81,0,100,19
1683706826202,MAE 40,A00,186592,Bewley; Thomas R,10,0,50,40
1683706827230,MAE 101B,A00,186593,Bahadori; Mohammad Yousef,80,0,100,20
1683706828253,MAE 105,A00,186594,Bandaru; Prabhakar,10,0,50,40
1683706829283,MAE 107,A00,186599,Pham; Hieu Tan,0,8,120,120
1683706830310,MAE 148,A01,186660,Silberman; Jack,3,0,16,13
1683706831335,MATH 10A,A01,188095,Staff,0,6,35,35
1683706832366,MATH 10B,A01,188097,Bowers; Adam R.,0,12,30,30
1683706832366,MATH 10B,A02,188099,Bowers; Adam R.,0,11,30,30
1683706832366,MATH 10B,B01,188104,Bowers; Adam R.,0,10,30,30
1683706832366,MATH 10B,B02,188106,Bowers; Adam R.,0,9,30,30
1683706833391,MATH 10C,A01,188111,Staff,0,20,30,30
1683706833391,MATH 10C,A02,188127,Staff,0,19,30,30
1683706833391,MATH 10C,A03,188131,Staff,0,19,30,30
1683706833391,MATH 10C,B01,188218,Staff,17,0,30,13
1683706833391,MATH 10C,B02,188244,Staff,13,0,30,17
1683706833391,MATH 10C,B03,188277,Staff,14,0,30,16
1683706834420,MATH 18,A01,188344,Bach; Quang Tran,18,0,30,12
1683706834420,MATH 18,A02,188345,Bach; Quang Tran,11,0,30,19
1683706834420,MATH 18,B01,188353,Bach; Quang Tran,11,0,30,19
1683706834420,MATH 18,B02,188354,Bach; Quang Tran,19,0,30,11
1683706835448,MATH 20A,A01,188374,Staff,11,0,35,24
1683706836477,MATH 20B,A01,188382,Ohm; Ko Woon,7,0,30,23
1683706836477,MATH 20B,A02,188383,Ohm; Ko Woon,22,0,30,8
1683706836477,MATH 20B,B01,188385,Ohm; Ko Woon,7,0,30,23
1683706836477,MATH 20B,B02,188392,Ohm; Ko Woon,22,0,30,8
1683706837503,MATH 20C,A01,188394,Harel; Guershon,10,0,30,20
1683706837503,MATH 20C,A02,188395,Harel; Guershon,13,0,30,17
1683706837503,MATH 20C,B01,188404,Harel; Guershon,5,0,30,25
1683706837503,MATH 20C,B02,188405,Harel; Guershon,18,0,30,12
1683706838529,MATH 20D,A01,188414,Hammock; Frances H,0,1,30,30
1683706838529,MATH 20D,A02,188415,Hammock; Frances H,0,1,30,30
1683706838529,MATH 20D,B01,188447,Hammock; Frances H,0,1,30,30
1683706838529,MATH 20D,B02,188486,Hammock; Frances H,2,0,30,28
1683706839561,MATH 20E,A01,188649,Staff,21,0,30,9
1683706839561,MATH 20E,A02,188650,Staff,20,0,30,10
1683706839561,MATH 20E,A03,188673,Staff,0,0,30,30
1683706840592,MATH 102,A01,188675,Staff,0,40,35,35
1683706841618,MATH 103B,A01,188681,Staff,3,0,35,32
1683706841618,MATH 103B,B01,188692,Staff,5,0,35,30
1683706842644,MATH 109,A01,188695,Salehi Golsefidy; Alireza,24,0,35,11
1683706842644,MATH 109,A02,188696,Salehi Golsefidy; Alireza,25,0,35,10
1683706843670,MATH 120A,A01,188698,Eggers; John Dietrich,7,0,35,28
1683706844701,MATH 142B,A01,188736,Ioana; Adrian,0,0,30,30
1683706844701,MATH 142B,A02,188741,Ioana; Adrian,0,1,30,30
1683706844701,MATH 142B,A03,188743,Ioana; Adrian,0,2,30,30
1683706845730,MATH 168A,A01,188790,Staff,0,11,35,35
1683706846756,MATH 170A,A01,188803,Nie; Jiawang,0,2,35,35
1683706846756,MATH 170A,A02,188811,Nie; Jiawang,0,1,35,35
1683706846756,MATH 170A,A03,188814,Nie; Jiawang,0,0,35,35
1683706846756,MATH 170A,A04,188815,Nie; Jiawang,5,0,35,30
1683706847785,MATH 193B,A01,188817,Staff,0,0,35,35
1683706847785,MATH 193B,A02,188818,Staff,6,0,35,29
1683706848815,MGT 4,A01,202857,Anderson; John Charles,59,0,80,21
1683706849839,MGT 12,A00,202858,Lindenberger; Wade Douglas,40,0,90,50
1683706850867,MGT 18,A00,202859,Staff,73,0,90,17
1683706851897,MGT 18GS,A00,202860,McKay; Michael J,13,0,28,15
1683706852923,MGT 45,A00,202861,Pecore; Joseph P.,8,0,90,82
1683706853955,MGT 100,A00,202863,Yavorsky; Daniel Ryan,27,0,90,63
1683706854982,MGT 103,A00,202864,Ehrich; Kristine R,0,19,90,90
1683706856007,MGT 112,A00,202865,Ehrich; Kristine R,15,0,90,75
1683706857033,MGT 121A,A00,202868,Staff,70,0,90,20
1683706858061,MGT 131B,A00,202869,Anderson; John Charles,58,0,90,32
1683706859092,MGT 136,A00,202871,Lindenberger; Wade Douglas,83,0,90,7
1683706860118,MGT 164,A00,202873,Staff,0,67,90,91
1683706861143,MGT 164GS,A00,202874,McKay; Mary A,13,0,28,15
1683706862171,MGT 180,A00,202875,Staff,0,51,90,91
1683706863197,MMW 11R,A01,205019,Herbst; Matthew,0,0,30,30
1683706863197,MMW 11R,A02,205026,Herbst; Matthew,29,0,30,1
1683706864267,MMW 15,A01,193512,Chang; Edmond Yi-Teh,0,8,28,28
1683706864267,MMW 15,A02,193513,Chang; Edmond Yi-Teh,0,5,28,28
1683706864267,MMW 15,A03,193514,Chang; Edmond Yi-Teh,0,5,28,28
1683706864267,MMW 15,A04,193515,Chang; Edmond Yi-Teh,0,5,28,28
1683706864267,MMW 15,A05,193516,Chang; Edmond Yi-Teh,0,5,28,28
1683706864267,MMW 15,A06,193517,Chang; Edmond Yi-Teh,0,6,28,28
1683706864267,MMW 15,B01,193519,Chang; Edmond Yi-Teh,0,5,28,28
1683706864267,MMW 15,B02,193520,Chang; Edmond Yi-Teh,0,5,28,28
1683706864267,MMW 15,B03,193521,Chang; Edmond Yi-Teh,0,5,28,28
1683706864267,MMW 15,B04,193522,Chang; Edmond Yi-Teh,0,6,28,28
1683706864267,MMW 15,B05,193523,Chang; Edmond Yi-Teh,0,5,28,28
1683706864267,MMW 15,B06,193524,Chang; Edmond Yi-Teh,0,5,28,28
1683706865294,MMW 122,A01,193526,Rahimi; Babak,0,16,28,28
1683706865294,MMW 122,A02,193527,Rahimi; Babak,0,15,28,28
1683706865294,MMW 122,A03,193528,Rahimi; Babak,0,0,0,0
1683706865294,MMW 122,A04,193529,Rahimi; Babak,0,0,0,0
1683706866318,MUS 1A,A01,186663,Staff,0,18,35,35
1683706867344,MUS 4,A01,186715,Staff,0,12,35,35
1683706868372,MUS 5R,A01,186796,Dubnov; Shlomo,0,17,35,35
1683706869398,MUS 6,A01,186798,Staff,0,4,25,25
1683706870427,MUS 7,A01,186830,Staff,11,0,35,24
1683706871456,MUS 8,A01,186930,Staff,0,27,35,35
1683706872487,MUS 15,A01,186932,Staff,0,15,35,35
1683706872487,MUS 15,B01,186934,Staff,0,16,35,35
1683706873513,MUS 80,A00,186935,Staff,0,0,20,20
1683706873513,MUS 80,B00,186936,Staff,24,0,25,1
1683706874539,NANO 11,A00,204702,Lipomi; Darren John,0,0,0,0
1683706875569,NANO 15,A01,204709,Yang; Kesong,0,1,0,0
1683706876599,NANO 114,A00,202069,Jahed Motlagh; Zeinab,2,0,10,8
1683706877627,PHIL 1,A00,186955,Grush; Rick Scott,31,0,40,9
1683706878653,PHIL 10,A01,186973,Grush; Rick Scott,27,0,35,8
1683706878653,PHIL 10,A02,186974,Grush; Rick Scott,33,0,35,2
1683706879679,PHIL 13,A01,186976,Staff,1,0,35,34
1683706879679,PHIL 13,A02,186977,Staff,16,0,35,19
1683706880709,PHIL 14,A01,186979,Staff,30,0,35,5
1683706880709,PHIL 14,A02,186986,Staff,32,0,35,3
1683706881736,PHIL 28,A01,186988,Staff,16,0,30,14
1683706881736,PHIL 28,A02,186989,Staff,0,0,30,30
1683706881736,PHIL 28,A03,186990,Staff,10,0,30,20
1683706881736,PHIL 28,A04,186991,Staff,26,0,30,4
1683706882764,PHIL 120,A00,186997,Staff,23,0,40,17
1683706883793,PHIL 137,A00,187003,Staff,7,0,40,33
1683706884821,PHIL 150,A00,187015,Staff,47,0,70,23
1683706885853,PHIL 167,A00,187021,Lamey; Andy M.,34,0,40,6
1683706886881,PHIL 174,A01,202226,Staff,17,0,20,3
1683706886881,PHIL 174,A02,202235,Staff,20,0,20,0
1683706887909,PHIL 191A,A00,258918,Staff,0,0,1,1
1683706888934,PHYS 1A,A00,187028,Staff,26,0,60,34
1683706889959,PHYS 1AL,001,187036,Staff,3,0,30,27
1683706889959,PHYS 1AL,002,187049,Staff,18,0,30,12
1683706890984,PHYS 1B,A00,187058,Staff,21,0,60,39
1683706892011,PHYS 1BL,001,187064,Staff,0,1,30,30
1683706892011,PHYS 1BL,002,187070,Staff,4,0,30,26
1683706893040,PHYS 1C,A00,187082,Staff,30,0,120,90
1683706894066,PHYS 1CL,001,187088,Staff,0,9,30,30
1683706894066,PHYS 1CL,002,187089,Staff,0,1,30,30
1683706894066,PHYS 1CL,009,262693,Staff,9,0,30,21
1683706895091,PHYS 2B,A01,187097,Staff,55,0,115,60
1683706896121,PHYS 2C,A01,187099,Staff,63,0,115,52
1683706897151,PHYS 2CL,A01,187101,Staff,5,0,28,23
1683706897151,PHYS 2CL,A02,187102,Staff,15,0,28,13
1683706898176,PHYS 2D,A01,187123,Shotwell; Brian,95,0,115,20
1683706899205,PHYS 4B,A01,187133,Grinstein; Benjamin,35,0,50,15
1683706900234,POLI 10,A00,188819,Staff,0,4,50,50
1683706901260,POLI 11,A00,188827,Staff,43,0,50,7
1683706902285,POLI 13R,A00,188828,Staff,0,1,20,20
1683706903310,POLI 27,A01,188830,Elgin; Samuel Zincke,0,2,70,70
1683706904339,POLI 30,A00,188832,Desposato; Scott,30,0,50,20
1683706905368,POLI 102F,A00,188834,Staff,1,0,40,39
1683706906391,POLI 104A,A00,188852,Staff,12,0,30,18
1683706907416,POLI 104I,A00,188853,Staff,0,8,20,20
1683706908446,POLI 110B,A00,188854,Wiens; David,6,0,20,14
1683706909529,POLI 112A,A00,188855,Wiens; David,3,0,30,27
1683706910558,POLI 117R,A00,188856,Forman; Fonna,0,12,20,20
1683706911582,POLI 118,A00,188857,Ingham; Sean,8,0,20,12
1683706912606,POLI 120G,A00,188858,Staff,7,0,30,23
1683706913631,POLI 131CR,A00,188863,Hoston; Germaine,20,0,50,30
1683706914660,POLI 133,A00,188864,Nellis; Gareth Hb,44,0,50,6
1683706915686,POLI 134D,A00,188865,Desposato; Scott,27,0,30,3
1683706916711,POLI 142A,A00,188871,Gartzke; Erik,21,0,50,29
1683706917737,POLI 142K,A00,188874,Staff,38,0,50,12
1683706918763,POLI 143,A00,188940,Gartzke; Erik,15,0,30,15
1683706919790,POLI 153,A00,188943,Staff,1,0,20,19
1683706920815,POLI 160AA,A00,188944,Staff,10,0,40,30
1683706921843,POLI 170A,A00,188945,Staff,10,0,30,20
1683706923897,PSYC 1,A00,188952,Staff,36,0,90,54
1683706924922,PSYC 2,B00,188953,Staff,19,0,35,16
1683706925949,PSYC 6,A00,188970,Staff,47,0,60,13
1683706926977,PSYC 7,A00,188973,Staff,35,0,45,10
1683706928008,PSYC 60,A01,188980,Rickard; Timothy C.,42,0,60,18
1683706929039,PSYC 70,A01,189001,Steiner; Eric Tomas,22,0,45,23
1683706930064,PSYC 100,A00,189005,Lacefield; Katharine I,1,98,120,119
1683706931094,PSYC 102,A00,189008,Staff,6,0,30,24
1683706932117,PSYC 106,B00,189026,Gorman; Michael R.,27,0,60,33
1683706933141,PSYC 114,B01,189033,Winkielman; Piotr,0,31,30,30
1683706934166,PSYC 131,A00,189036,Anagnostaras; Stephan,0,44,60,60
1683706935193,PSYC 136,A00,189041,Lowe; Angela Beth,0,7,25,25
1683706936217,PSYC 137,A00,189057,Winkielman; Piotr,0,36,25,25
1683706937247,PSYC 144,A00,189107,Wixted; John T,0,11,50,50
1683706939296,PSYC 162,A00,189142,Staff,0,9,85,85
1683706940324,PSYC 172,A00,189144,Gorman; Michael R.,0,6,30,30
1683706942375,PSYC 179,A00,189146,Lacefield; Katharine I,0,88,120,120
1683706943399,PSYC 181,A00,189147,Anagnostaras; Stephan,0,45,90,90
1683706944425,PSYC 190R,A00,189148,Barner; David A.,0,23,80,80
1683706945451,PSYC 191,A00,189275,Rickard; Timothy C.,0,11,25,25
1683706946474,PSYC 193,A00,189276,Chapman; Eddie Nathaniel,0,1,0,4
1683706947499,PSYC 193L,A01,189281,Lowe; Angela Beth,8,0,20,12
1683706947499,PSYC 193L,B01,189285,Staff,28,0,35,7
1683706948525,RELI 149,A00,187137,Rahimi; Babak,6,0,40,34
1683706949549,SE 9,A01,187315,Staff,0,2,18,18
1683706950578,SE 101B,A00,187409,Staff,24,0,30,6
1683706951608,SE 110B,A00,187444,Staff,10,0,40,30
1683706952634,SE 130B,A00,187449,Staff,31,0,40,9
1683706953664,SE 150A,A00,187516,Staff,8,0,20,12
1683706954689,SE 154,A00,187528,Staff,29,0,50,21
1683706955714,SIO 3,A01,258171,Staff,35,0,40,5
1683706956742,SIO 10,A00,187144,Cook; Geoffrey W,0,6,75,75
1683706957767,SIO 45,A00,187152,Cook; Geoffrey W,1,7,100,99
1683706958794,SIO 109R,A00,194486,Staff,0,4,20,20
1683706960851,SIO 187,A01,187233,Kacev; David,12,0,40,28
1683706961885,SOCI 1,A01,258656,Thorpe; Charles Robert,28,0,30,2
1683706961885,SOCI 1,A02,258658,Thorpe; Charles Robert,30,0,30,0
1683706961885,SOCI 1,A03,258661,Thorpe; Charles Robert,25,0,25,0
1683706961885,SOCI 1,A04,258666,Thorpe; Charles Robert,22,0,25,3
1683706961885,SOCI 1,A05,258897,Thorpe; Charles Robert,22,0,25,3
1683706961885,SOCI 1,A06,258898,Thorpe; Charles Robert,25,0,25,0
1683706962911,SOCI 30,A01,258903,Pardo Guerra; Juan Pablo,14,0,30,16
1683706963934,SOCI 102,A00,258904,Staff,9,0,25,16
1683706964962,SOCI 106,A00,258905,Staff,19,0,25,6
1683706965993,SOCI 111,A00,258907,Ribas Norris; Janet Vanesa,26,0,30,4
1683706967019,SOCI 121R,A00,258908,Pardo Guerra; Juan Pablo,7,0,30,23
1683706968053,SOCI 126,A01,203330,Staff,14,0,20,6
1683706969080,SOCI 131,A00,258909,Thorpe; Charles Robert,30,0,60,30
1683706970112,SOCI 135,A00,258910,Payne; Christine Anna,0,13,30,30
1683706971137,SOCI 157,A00,258911,Staff,10,0,30,20
1683706972164,SOCI 184,A00,258912,Staff,25,0,30,5
1683706973189,SOCI 188D,A00,258913,Staff,22,0,30,8
1683706974214,SYN 2,001,187529,Staff,9,0,16,7
1683706974214,SYN 2,002,201452,Staff,0,20,16,16
1683706974214,SYN 2,003,201469,Staff,1,0,16,15
1683706975238,SYN 100,A01,187531,Staff,0,9,20,20
1683706975238,SYN 100,B01,201491,Staff,0,10,20,20
1683706976270,TDAC 1,A00,189286,Walsh; Kim C.,3,0,20,17
1683706976270,TDAC 1,B00,189287,Harting; Carla Kelso,10,0,20,10
1683706977294,TDAC 101,A00,189300,Walsh; Kim C.,16,0,20,4
1683706977294,TDAC 101,B00,189301,Harting; Carla Kelso,18,0,20,2
1683706978320,TDAC 102,A00,189304,Basso; Beatrice,14,0,20,6
1683706979348,TDAC 108,A00,189305,Staff,18,0,20,2
1683706980375,TDDE 131,A00,189310,Staff,19,0,20,1
1683706980375,TDDE 131,B00,189314,Staff,19,0,20,1
1683706980375,TDDE 131,C00,189315,Staff,48,0,50,2
1683706980375,TDDE 131,D00,189316,Staff,14,0,15,1
1683706980375,TDDE 131,E00,204841,Staff,20,0,20,0
1683706981399,TDGE 10,A00,189289,Staff,27,0,50,23
1683706981399,TDGE 10,B00,189290,Havis; Allan,0,1,50,50
1683706982423,TDGE 11,A00,189291,Fulton; Julia,0,4,50,50
1683706982423,TDGE 11,B00,189292,Staff,20,0,25,5
1683706982423,TDGE 11,C00,260270,Staff,0,0,0,0
1683706983452,TDGE 25,A00,189294,Staff,1,0,20,19
1683706984477,TDGE 124,A00,189318,Fulton; Julia,0,7,50,50
1683706985506,TDGE 125,A00,189319,Staff,13,0,25,12
1683706985506,TDGE 125,B00,189320,Staff,23,0,25,2
1683706986536,TDGE 127,A00,189322,Havis; Allan,1,0,50,49
1683706987561,TDHT 101,A00,189323,Staff,18,0,25,7
1683706987561,TDHT 101,B00,189324,Staff,25,0,25,0
1683706988590,TDHT 102,A00,189325,Staff,49,0,50,1
1683706989617,TDMV 1,A00,189295,Arcidiacono; Kristin,20,0,30,10
1683706989617,TDMV 1,B00,189296,Caligagan; Maria T.,23,0,30,7
1683706990644,TDMV 2,A00,189297,Sammartano; Tonnie,27,0,30,3
1683706990644,TDMV 2,B00,189299,Arcidiacono; Kristin,23,0,30,7
1683706991671,TDMV 3,A00,204998,Rincon; Alicia,22,0,30,8
1683706992700,TDMV 120,A00,189458,Sammartano; Tonnie,28,0,30,2
1683706993730,TDMV 138,A00,189541,Jun; Grace Shin Hae,20,0,40,20
1683706994758,TDMV 142,A00,189717,Caligagan; Tony,25,0,30,5
1683706994758,TDMV 142,B00,189718,Caligagan; Maria T.,25,0,30,5
1683706995784,TMC 2,A01,187533,Staff,25,0,25,0
1683706995784,TMC 2,A02,187534,Staff,25,0,25,0
1683706996814,USP 1,A01,187536,Kwak; Nancy,0,16,25,25
1683706997842,USP 5,A01,187538,Staff,8,0,25,17
1683706998868,USP 101,A00,199253,Staff,0,4,0,0
1683706999892,USP 124,A00,187562,Boomhower; Matthew Charles,0,0,30,30
1683707000918,USP 138,A00,187582,Staff,19,0,25,6
1683707001943,USP 152,A01,187597,Staff,3,0,25,22
1683707002968,USP 153,A00,187598,Staff,18,0,25,7
1683707004001,USP 168,A00,187607,Kwak; Nancy,2,0,5,3
1683707005030,USP 173,A00,187619,Staff,4,0,25,21
1683707006061,USP 181,A00,187638,Staff,0,4,25,25
1683707007086,VIS 103,A00,187650,Cruz; Edwin Teddy,17,0,75,58
1683707008109,VIS 110D,A00,187669,Staff,13,0,22,9
1683707009136,VIS 127C,A00,187720,Shen; Kuiyi,67,0,146,79
1683707010164,VIS 149,A00,187731,Yoldas; Pinar,0,12,22,22
1683707011188,VIS 151,A01,188091,Staff,22,0,34,12
1683707011188,VIS 151,A02,188092,Staff,11,0,34,23
1683707012214,VIS 160B,A00,188093,Stalbaum; Brett,0,1,10,10
1683707014321,WCWP 10B,A00,201720,Staff,0,0,5,5
1683707014321,WCWP 10B,B00,201722,Staff,0,0,6,6
1683707015346,WCWP 100,A00,201725,Gagnon; Jeffrey C,0,0,2,2
1683707015346,WCWP 100,B00,201727,Staff,0,4,15,15
1683707018464,ANBI 133,A00,258401,Wilder; Linnea Lorene,34,0,40,6
1683707019493,ANBI 140,A00,258395,Hrvoj Mihic; Branka,18,0,25,7
1683707020518,ANSC 120,A00,258402,Bialecki; Jon Anthony,26,0,40,14
1683707021545,ANSC 144,A00,258400,Staff,12,0,40,28
1683707023596,ANSC 166,A00,258396,Parish; Steven Martin,156,0,175,19
1683707024622,ANSC 180,A00,193533,Staff,8,0,20,12
1683707025649,ANSC 188,A00,258397,Jassal; Aftab,34,0,40,6
1683707026674,ANTH 3,A01,258316,Staff,23,0,30,7
1683707027699,ANTH 5,A00,258394,Semendeferi; Ekaterini,16,0,20,4
1683707028725,ANTH 21,A01,258331,Staff,4,0,40,36
1683707029752,ANTH 103,A00,258398,Varma; Saiba,15,0,25,10
1683707030788,AWP 10,001,202034,Staff,0,0,0,0
1683707030788,AWP 10,002,202035,Staff,0,0,0,0
1683707030788,AWP 10,003,202036,Staff,0,0,0,0
1683707030788,AWP 10,004,202037,Staff,0,0,0,0
1683707030788,AWP 10,005,202038,Staff,0,0,0,0
1683707030788,AWP 10,006,202039,Staff,0,0,0,0
1683707030788,AWP 10,007,202040,Staff,0,0,0,0
1683707030788,AWP 10,008,202041,Staff,0,0,0,0
1683707030788,AWP 10,009,202042,Staff,0,0,0,0
1683707030788,AWP 10,010,202043,Staff,0,0,0,0
1683707030788,AWP 10,011,202044,Staff,0,0,0,0
1683707030788,AWP 10,012,202045,Staff,0,0,0,0
1683707030788,AWP 10,013,202046,Staff,0,0,0,0
1683707030788,AWP 10,014,202047,Staff,0,0,0,0
1683707030788,AWP 10,015,202048,Staff,0,0,0,0
1683707030788,AWP 10,016,202049,Staff,0,0,0,0
1683707030788,AWP 10,017,202050,Staff,0,0,0,0
1683707030788,AWP 10,018,202051,Staff,0,0,0,0
1683707030788,AWP 10,019,202052,Staff,0,0,0,0
1683707030788,AWP 10,020,202053,Staff,0,0,0,0
1683707030788,AWP 10,021,202054,Staff,0,0,0,0
1683707030788,AWP 10,022,202055,Staff,0,0,0,0
1683707030788,AWP 10,023,202056,Staff,0,0,0,0
1683707030788,AWP 10,024,202057,Staff,0,0,0,0
1683707030788,AWP 10,025,202058,Staff,0,0,0,0
1683707030788,AWP 10,026,202059,Staff,0,0,0,0
1683707031815,AWP 102,001,202032,Staff,0,0,0,0
1683707031815,AWP 102,002,202033,Staff,0,0,0,0
1683707032841,BENG 100,A01,254234,Taylor Amos; Alyssa C,31,0,40,9
1683707033870,BENG 196,001,270013,Engler; Adam J.,9999,0,9999,0
1683707034901,BICD 100R,A01,202018,Smith; Laurie,0,7,32,32
1683707034901,BICD 100R,A02,202019,Smith; Laurie,0,3,32,32
1683707034901,BICD 100R,A03,202020,Smith; Laurie,0,1,32,32
1683707034901,BICD 100R,A04,202021,Smith; Laurie,6,0,32,26
1683707034901,BICD 100R,A05,202022,Smith; Laurie,10,0,32,22
1683707035927,BICD 136,A01,193242,Gustafson-Brown; Cindy,0,2,32,32
1683707035927,BICD 136,A02,193244,Gustafson-Brown; Cindy,13,0,32,19
1683707036973,BIEB 102,A01,193249,Butler; Shannon Rhey,0,0,32,32
1683707036973,BIEB 102,A02,193251,Butler; Shannon Rhey,0,0,32,32
1683707036973,BIEB 102,A03,193253,Butler; Shannon Rhey,0,0,32,32
1683707036973,BIEB 102,A04,193255,Butler; Shannon Rhey,13,0,32,19
1683707036973,BIEB 102,A05,193265,Butler; Shannon Rhey,25,0,32,7
1683707036973,BIEB 102,A06,193269,Butler; Shannon Rhey,12,0,32,20
1683707039024,BIEB 150,A01,193274,Staff,0,0,32,32
1683707039024,BIEB 150,A02,193285,Staff,24,0,32,8
1683707040050,BIEB 194,A00,193286,Kurle; Carolyn M.,19,0,32,13
1683707041076,BILD 1,A01,192291,Staff,15,0,32,17
1683707041076,BILD 1,A02,192292,Staff,30,0,32,2
1683707041076,BILD 1,B01,192520,Reuther; Keefe,0,1,0,0
1683707041076,BILD 1,B02,192532,Reuther; Keefe,0,1,0,0
1683707042107,BILD 3,A01,192556,Butler; Shannon Rhey,0,0,32,32
1683707042107,BILD 3,A02,192581,Butler; Shannon Rhey,0,1,32,32
1683707042107,BILD 3,A03,192611,Butler; Shannon Rhey,19,0,32,13
1683707042107,BILD 3,A04,192612,Butler; Shannon Rhey,23,0,32,9
1683707042107,BILD 3,A05,192613,Butler; Shannon Rhey,26,0,32,6
1683707042107,BILD 3,A06,192679,Butler; Shannon Rhey,27,0,32,5
1683707042107,BILD 3,A07,192682,Butler; Shannon Rhey,20,0,32,12
1683707043133,BILD 4,A01,192836,Reuther; Keefe,1,0,24,23
1683707043133,BILD 4,A02,193044,Reuther; Keefe,4,0,24,20
1683707044161,BILD 10,A01,193142,Gustafson-Brown; Cindy,29,0,32,3
1683707044161,BILD 10,A02,193149,Gustafson-Brown; Cindy,31,0,32,1
1683707045186,BIMM 100,A01,193301,Staff,0,6,32,32
1683707045186,BIMM 100,A02,193312,Staff,0,7,32,32
1683707045186,BIMM 100,A03,193323,Staff,0,10,32,32
1683707046221,BIMM 101,A01,193329,McDonnell; Lisa Marie,0,3,24,24
1683707046221,BIMM 101,A02,193339,McDonnell; Lisa Marie,0,3,24,24
1683707046221,BIMM 101,B01,193354,McDonnell; Lisa Marie,0,4,24,24
1683707046221,BIMM 101,B02,193357,McDonnell; Lisa Marie,0,3,24,24
1683707047250,BIMM 110,A01,193377,Tat; John,0,11,32,32
1683707047250,BIMM 110,A02,193378,Tat; John,0,11,32,32
1683707048275,BIMM 120,A01,206116,Staff,0,0,32,32
1683707048275,BIMM 120,A02,206117,Staff,7,0,32,25
1683707048275,BIMM 120,A03,206121,Staff,21,0,32,11
1683707049308,BIPN 100,A01,193393,Park; Ji Young,0,15,32,32
1683707049308,BIPN 100,A02,193402,Park; Ji Young,0,14,32,32
1683707049308,BIPN 100,A03,193413,Park; Ji Young,0,14,32,32
1683707049308,BIPN 100,A04,193414,Park; Ji Young,0,13,32,32
1683707050337,BIPN 102,A01,193429,Staff,0,0,32,32
1683707050337,BIPN 102,A02,193438,Staff,18,0,32,14
1683707051366,BIPN 106,A01,193450,Reyes Gonzalez; Catalina,0,2,40,40
1683707052391,BIPN 134,A01,193465,Cooke; James Edward,0,0,32,32
1683707052391,BIPN 134,A02,193474,Cooke; James Edward,25,0,32,7
1683707052391,BIPN 134,A03,193485,Cooke; James Edward,29,0,32,3
1683707052391,BIPN 134,A04,193486,Cooke; James Edward,20,0,32,12
1683707052391,BIPN 134,A05,193491,Cooke; James Edward,31,0,32,1
1683707052391,BIPN 134,A06,193501,Cooke; James Edward,30,0,32,2
1683707052391,BIPN 134,A07,193510,Cooke; James Edward,29,0,32,3
1683707054451,BISP 194,A00,222522,Staff,14,0,32,18
1683707055477,CAT 124,A01,202407,Staff,19,0,25,6
1683707056502,CAT 125,A00,202408,Marchisotto; Jennifer Anne,2,0,20,18
1683707057541,CAT 125R,A00,202409,Smith; Lauryn Alissa,0,11,20,20
1683707057541,CAT 125R,B00,202410,Morales; Celeste Georgianna,0,11,20,20
1683707057541,CAT 125R,C00,202411,Irwin; Matthew Joseph,0,12,20,20
1683707058565,CENG 15,A01,204712,Yang; Kesong,0,1,0,0
1683707059590,CENG 114,A00,202070,Jahed Motlagh; Zeinab,5,0,20,15
1683707060620,CGS 105,A00,185477,Wesling; Megan E.,24,0,40,16
1683707061648,CGS 106,A00,185494,Staff,11,0,22,11
1683707062675,CGS 108,A00,185495,Staff,14,0,20,6
1683707063703,CGS 114,A00,185496,Staff,13,0,18,5
1683707064731,CGS 119,A00,185501,Staff,15,0,20,5
1683707065756,CGS 120,A00,185511,Staff,11,0,20,9
1683707066783,CHEM 4,A01,184675,Bussey; Thomas J,97,0,100,3
1683707067811,CHEM 6A,A01,184677,Staff,32,0,60,28
1683707068839,CHEM 6B,A01,184679,Staff,63,0,100,37
1683707069869,CHEM 6C,A01,184681,Bussey; Thomas J,0,0,50,50
1683707069869,CHEM 6C,A02,184682,Bussey; Thomas J,32,0,50,18
1683707070895,CHEM 40A,A01,184684,Albizati; Kim F.,33,0,100,67
1683707071923,CHEM 40B,A01,184686,Albizati; Kim F.,0,22,100,100
1683707072950,CHEM 41B,A01,184690,Staff,51,0,100,49
1683707073974,COGS 3,A01,184715,Boyle; Mary E. T.,0,27,40,40
1683707075000,COGS 14B,A01,185172,Staff,0,14,38,38
1683707076027,COGS 18,A01,184736,Staff,14,0,80,66
1683707077069,COGS 100,A01,184932,Staff,0,8,73,73
1683707078100,COGS 101A,A01,184935,Staff,0,40,30,30
1683707079125,COGS 101B,A01,184944,Staff,0,2,30,30
1683707080153,COGS 101C,A01,184946,Staff,0,10,30,30
1683707081185,COGS 102A,A01,184951,Johnson; Christine M.,1,0,40,39
1683707082213,COGS 107B,A01,184953,Mooshagian; Eric Frederick,0,52,40,40
1683707083237,COGS 118B,A01,184959,Gupta; Anjum,0,50,40,40
1683707084262,COGS 153,A00,184961,Staff,1,16,30,29
1683707085287,COGS 177,A00,184962,Staff,0,20,30,30
1683707086313,COGS 187A,A01,184969,Boyle; Mary E. T.,0,19,40,40
1683707087339,COMM 10,A01,185174,Staff,0,5,25,25
1683707087339,COMM 10,A02,185189,Staff,0,2,25,25
1683707087339,COMM 10,A03,269821,Staff,0,1,0,0
1683707088365,COMM 100B,A02,185476,Staff,10,0,25,15
1683707088365,COMM 100B,A03,277340,Staff,25,0,25,0
1683707089389,COMM 100C,A01,185314,Staff,2,0,25,23
1683707089389,COMM 100C,A02,185327,Staff,17,0,25,8
1683707090415,COMM 110M,A00,185349,Staff,0,0,40,40
1683707091442,COMM 113T,A00,185352,Staff,25,0,40,15
1683707092466,COMM 114I,A00,185353,Staff,31,0,40,9
1683707093495,COMM 131,A00,185354,Staff,17,0,30,13
1683707094525,CSE 8A,A50,185358,Cao; Yingjun,0,46,10,10
1683707095550,CSE 8B,A01,185362,Staff,0,48,50,50
1683707096585,CSE 11,A01,185416,Cao; Yingjun,0,91,10,10
1683707097615,CSE 20,A01,185445,Briones; Jor-el Thomas Caparas,3,0,25,22
1683707098639,CSE 21,A01,185447,Staff,9,0,50,41
1683707099669,CSE 101,A01,185451,Staff,0,13,50,50
1683707099669,CSE 101,B01,185453,Jones; Miles E,0,15,50,50
1683707101725,CSE 141,A01,185458,Eldon; John,16,0,100,84
1683707102757,CSE 141L,A01,185461,Eldon; John,8,0,100,92
1683707103781,CSE 142,A01,185463,Staff,34,0,60,26
1683707103781,CSE 142,B01,201355,Staff,0,7,60,60
1683707104806,CSE 142L,A01,185470,Staff,34,0,60,26
1683707104806,CSE 142L,B01,201417,Staff,0,6,60,60
1683707105831,CSE 190,A00,201433,Staff,32,0,49,17
1683707106860,DOC 1,A01,259136,Strom; Megan C.,7,0,15,8
1683707106860,DOC 1,A02,259137,Strom; Megan C.,15,0,15,0
1683707106860,DOC 1,A03,259138,Strom; Megan C.,14,0,15,1
1683707106860,DOC 1,A04,259139,Strom; Megan C.,14,0,15,1
1683707107886,DOC 100D,A00,259140,Pass; Natalye Joann,14,0,25,11
1683707108912,DSGN 1,A01,184749,Rill; Bryan,0,26,30,30
1683707109937,DSGN 100,A01,185168,Staff,0,2,25,25
1683707110963,ECE 5,A01,185626,Morris; Karcher William,0,12,0,0
1683707111991,ECE 101,A01,185628,Staff,14,0,70,56
1683707113022,ECE 107,A01,185635,Baghdadchi; Saharnaz,0,0,20,20
1683707113022,ECE 107,A02,185638,Baghdadchi; Saharnaz,1,0,20,19
1683707114047,ECE 148,A01,185647,Silberman; Jack,0,0,16,16
1683707115072,ECON 1,A01,185537,Crane; Meredith Helen,54,0,70,16
1683707116100,ECON 3,A01,185549,Crane; Meredith Helen,30,0,70,40
1683707117189,ECON 4,A01,203354,Anderson; John Charles,0,5,10,10
1683707118213,ECON 100A,A01,185574,Staff,0,5,40,40
1683707119240,ECON 100B,A01,185576,Staff,0,12,50,50
1683707120265,ECON 100C,A01,185589,Newhouse; Herbert S,30,0,70,40
1683707121290,ECON 105,A00,185608,Vespa; Emanuel Ignacio,19,0,35,16
1683707122315,ECON 109,A01,185610,Shishkin; Denis,9,0,35,26
1683707123346,ECON 110A,A01,185612,Staff,8,0,40,32
1683707124372,ECON 120A,A01,185615,Staff,19,0,40,21
1683707125399,ECON 120C,A01,185617,Sun; Yixiao,0,21,70,70
1683707126433,ECON 144,A00,203346,Squires; Dale E,2,0,35,33
1683707127460,ECON 171,A01,203349,Newhouse; Herbert S,0,1,35,35
1683707128489,ECON 173A,A01,185621,Toda; Alexis Akira,21,0,35,14
1683707129525,EDS 25,A01,202413,Staff,0,1,0,0
1683707129525,EDS 25,A02,202414,Staff,0,1,0,0
1683707129525,EDS 25,A03,202415,Staff,0,0,0,0
1683707129525,EDS 25,A04,202416,Staff,0,1,0,0
1683707129525,EDS 25,A05,202439,Staff,0,0,0,0
1683707129525,EDS 25,A06,202440,Staff,0,0,0,0
1683707129525,EDS 25,B01,202631,Staff,0,0,0,0
1683707129525,EDS 25,B02,202632,Staff,0,0,0,0
1683707129525,EDS 25,B03,202639,Staff,0,0,0,0
1683707129525,EDS 25,B04,202640,Staff,0,0,0,0
1683707129525,EDS 25,B05,202643,Staff,0,0,0,0
1683707129525,EDS 25,B06,202644,Staff,0,0,0,0
1683707130558,EDS 38,A01,202659,Black; Alison Michelle,25,0,25,0
1683707131584,EDS 115,A00,202652,Staff,18,0,30,12
1683707132608,EDS 125,A00,202649,Staff,13,0,30,17
1683707133636,EDS 126,A01,203332,Staff,30,0,30,0
1683707134661,EDS 139,A00,202838,Staff,16,0,25,9
1683707135692,EDS 146,A01,202655,Staff,14,0,25,11
1683707136718,ENG 15,A00,185667,Staff,0,1,0,0
1683707136718,ENG 15,B00,185672,Staff,0,0,0,0
1683707136718,ENG 15,C00,185675,Staff,0,0,0,0
1683707136718,ENG 15,D00,185682,Staff,0,0,0,0
1683707136718,ENG 15,E00,185684,Staff,0,0,0,0
1683707137747,ETHN 103,A00,185710,Staff,0,8,35,35
1683707138772,ETHN 103A,A00,199228,Man; Simeon S,0,0,9,9
1683707139801,ETHN 109,A00,185711,Staff,15,0,35,20
1683707140830,ETHN 142,A00,185726,Staff,0,4,30,30
1683707141853,ETHN 163J,A00,199229,Man; Simeon S,5,0,8,3
1683707142878,ETHN 168,A00,185727,Staff,7,0,10,3
1683707143906,ETHN 182,A00,185728,Staff,0,0,35,35
1683707144933,ETHN 183,A00,185737,Staff,9,0,18,9
1683707145958,GLBH 111,A01,209361,Burgos; Jose L.,0,0,0,0
1683707148009,HIEU 104,A00,185792,Staff,14,0,20,6
1683707149039,HIEU 115,A00,185800,Staff,0,0,20,20
1683707150068,HIEU 128,A00,185801,Staff,0,9,20,20
1683707151093,HIEU 147,A00,185802,Staff,15,0,20,5
1683707152119,HIEU 154,A00,185823,Staff,11,0,20,9
1683707153148,HILA 102,A00,185826,Staff,14,0,20,6
1683707154178,HILD 2C,A01,185778,Staff,0,13,20,20
1683707155216,HILD 7B,A01,185780,Kwak; Nancy,0,17,32,32
1683707155216,HILD 7B,A02,185781,Kwak; Nancy,0,18,32,32
1683707156241,HILD 30,A01,185791,Staff,12,0,20,8
1683707157269,HISC 119,A00,185830,Golan; Tal,0,10,20,20
1683707158297,HITO 156GS,A00,185831,Patterson; Patrick H.,0,0,0,23
1683707159323,HIUS 103,A00,185832,Man; Simeon S,0,4,20,20
1683707160349,HIUS 117,A00,185836,Kwak; Nancy,2,0,20,18
1683707161374,HIUS 125,A00,185840,Man; Simeon S,0,2,23,23
1683707162400,HIUS 149,A00,185845,Staff,1,0,20,19
1683707163435,HUM 3,A01,185882,Zavodny; Tatiana Sophia,0,8,50,50
1683707163435,HUM 3,B01,185899,Caldwell; Michael Alan,0,18,50,50
1683707164466,HUM 3GS,A00,185900,Patterson; Patrick H.,0,0,0,23
1683707165498,HUM 4,A01,185938,Zroka; Amy Liane,28,0,50,22
1683707165498,HUM 4,B01,185956,Watkins; Eric,0,6,50,50
1683707165498,HUM 4,B02,202209,Watkins; Eric,0,5,50,50
1683707165498,HUM 4,B03,202210,Watkins; Eric,0,5,50,50
1683707166524,HUM 5,A01,185958,West; Geoffrey Scott,0,0,50,50
1683707166524,HUM 5,A02,202215,West; Geoffrey Scott,0,1,50,50
1683707167557,INTL 190,A00,185959,Gagnon; Jeffrey C,0,0,0,9
1683707167557,INTL 190,B00,185960,Lettieri; Michael Joseph,0,0,0,2
1683707168582,JAPN 180,A00,254509,Staff,5,0,30,25
1683707169609,LATI 10,A01,202853,Kennemore; Amy Michelle,4,0,35,31
1683707169609,LATI 10,A02,202854,Kennemore; Amy Michelle,3,0,35,32
1683707169609,LATI 10,A03,270054,Kennemore; Amy Michelle,30,0,30,0
1683707170637,LATI 180,A00,202855,Kennemore; Amy Michelle,11,0,20,9
1683707171663,LAWS 101,A00,201767,Golan; Tal,0,7,40,40
1683707172690,LIFR 1C,A00,185961,Staff,6,0,20,14
1683707173716,LIFR 1CX,A00,185962,Staff,7,0,20,13
1683707174742,LIFR 1D,A00,185963,Staff,7,0,20,13
1683707175768,LIFR 1DX,A00,185964,Staff,7,0,20,13
1683707176797,LIGN 101,A01,186039,Staff,43,0,50,7
1683707177821,LIGN 165,A00,186040,Staff,14,0,50,36
1683707178846,LTCS 108,A00,186041,Staff,5,0,10,5
1683707179872,LTCS 119,A00,186042,Staff,15,0,20,5
1683707180900,LTCS 130,A00,186043,Wesling; Megan E.,15,0,25,10
1683707182954,LTEA 138,A00,186119,Staff,14,0,40,26
1683707183979,LTEN 124,A00,186148,Staff,5,0,25,20
1683707185004,LTEN 178,A00,186149,Staff,6,0,15,9
1683707186035,LTEN 181,A00,186150,Blanco; John D,34,0,40,6
1683707187062,LTWL 120,A00,186160,Staff,19,0,25,6
1683707188085,LTWL 165,A00,186161,Staff,22,0,25,3
1683707189114,LTWR 100,A00,186162,Staff,0,5,15,15
1683707190144,LTWR 102,A00,186163,Doller; Ben,5,0,15,10
1683707191170,MAE 8,A01,186412,Staff,0,1,0,0
1683707192198,MAE 30B,A00,186445,Bahadori; Mohammad Yousef,81,0,100,19
1683707193227,MAE 40,A00,186592,Bewley; Thomas R,10,0,50,40
1683707194252,MAE 101B,A00,186593,Bahadori; Mohammad Yousef,80,0,100,20
1683707195279,MAE 105,A00,186594,Bandaru; Prabhakar,10,0,50,40
1683707196311,MAE 107,A00,186599,Pham; Hieu Tan,0,8,120,120
1683707197338,MAE 148,A01,186660,Silberman; Jack,3,0,16,13
1683707198373,MATH 10A,A01,188095,Staff,0,6,35,35
1683707199405,MATH 10B,A01,188097,Bowers; Adam R.,0,12,30,30
1683707199405,MATH 10B,A02,188099,Bowers; Adam R.,0,11,30,30
1683707199405,MATH 10B,B01,188104,Bowers; Adam R.,0,10,30,30
1683707199405,MATH 10B,B02,188106,Bowers; Adam R.,0,9,30,30
1683707200433,MATH 10C,A01,188111,Staff,0,20,30,30
1683707200433,MATH 10C,A02,188127,Staff,0,19,30,30
1683707200433,MATH 10C,A03,188131,Staff,0,19,30,30
1683707200433,MATH 10C,B01,188218,Staff,17,0,30,13
1683707200433,MATH 10C,B02,188244,Staff,13,0,30,17
1683707200433,MATH 10C,B03,188277,Staff,14,0,30,16
1683707201466,MATH 18,A01,188344,Bach; Quang Tran,18,0,30,12
1683707201466,MATH 18,A02,188345,Bach; Quang Tran,11,0,30,19
1683707201466,MATH 18,B01,188353,Bach; Quang Tran,11,0,30,19
1683707201466,MATH 18,B02,188354,Bach; Quang Tran,19,0,30,11
1683707202496,MATH 20A,A01,188374,Staff,11,0,35,24
1683707203522,MATH 20B,A01,188382,Ohm; Ko Woon,7,0,30,23
1683707203522,MATH 20B,A02,188383,Ohm; Ko Woon,22,0,30,8
1683707203522,MATH 20B,B01,188385,Ohm; Ko Woon,7,0,30,23
1683707203522,MATH 20B,B02,188392,Ohm; Ko Woon,22,0,30,8
1683707204549,MATH 20C,A01,188394,Harel; Guershon,10,0,30,20
1683707204549,MATH 20C,A02,188395,Harel; Guershon,13,0,30,17
1683707204549,MATH 20C,B01,188404,Harel; Guershon,5,0,30,25
1683707204549,MATH 20C,B02,188405,Harel; Guershon,18,0,30,12
1683707205576,MATH 20D,A01,188414,Hammock; Frances H,0,1,30,30
1683707205576,MATH 20D,A02,188415,Hammock; Frances H,0,1,30,30
1683707205576,MATH 20D,B01,188447,Hammock; Frances H,0,1,30,30
1683707205576,MATH 20D,B02,188486,Hammock; Frances H,2,0,30,28
1683707206601,MATH 20E,A01,188649,Staff,21,0,30,9
1683707206601,MATH 20E,A02,188650,Staff,20,0,30,10
1683707206601,MATH 20E,A03,188673,Staff,0,0,30,30
1683707207626,MATH 102,A01,188675,Staff,0,40,35,35
1683707208657,MATH 103B,A01,188681,Staff,3,0,35,32
1683707208657,MATH 103B,B01,188692,Staff,5,0,35,30
1683707209688,MATH 109,A01,188695,Salehi Golsefidy; Alireza,24,0,35,11
1683707209688,MATH 109,A02,188696,Salehi Golsefidy; Alireza,25,0,35,10
1683707210719,MATH 120A,A01,188698,Eggers; John Dietrich,7,0,35,28
1683707211747,MATH 142B,A01,188736,Ioana; Adrian,0,0,30,30
1683707211747,MATH 142B,A02,188741,Ioana; Adrian,0,1,30,30
1683707211747,MATH 142B,A03,188743,Ioana; Adrian,0,2,30,30
1683707212772,MATH 168A,A01,188790,Staff,0,11,35,35
1683707213804,MATH 170A,A01,188803,Nie; Jiawang,0,2,35,35
1683707213804,MATH 170A,A02,188811,Nie; Jiawang,0,1,35,35
1683707213804,MATH 170A,A03,188814,Nie; Jiawang,0,0,35,35
1683707213804,MATH 170A,A04,188815,Nie; Jiawang,5,0,35,30
1683707214829,MATH 193B,A01,188817,Staff,0,0,35,35
1683707214829,MATH 193B,A02,188818,Staff,6,0,35,29
1683707215855,MGT 4,A01,202857,Anderson; John Charles,59,0,80,21
1683707216888,MGT 12,A00,202858,Lindenberger; Wade Douglas,40,0,90,50
1683707217915,MGT 18,A00,202859,Staff,73,0,90,17
1683707218945,MGT 18GS,A00,202860,McKay; Michael J,13,0,28,15
1683707219970,MGT 45,A00,202861,Pecore; Joseph P.,8,0,90,82
1683707221051,MGT 100,A00,202863,Yavorsky; Daniel Ryan,27,0,90,63
1683707222079,MGT 103,A00,202864,Ehrich; Kristine R,0,19,90,90
1683707223109,MGT 112,A00,202865,Ehrich; Kristine R,15,0,90,75
1683707224137,MGT 121A,A00,202868,Staff,70,0,90,20
1683707225162,MGT 131B,A00,202869,Anderson; John Charles,58,0,90,32
1683707226187,MGT 136,A00,202871,Lindenberger; Wade Douglas,83,0,90,7
1683707227216,MGT 164,A00,202873,Staff,0,67,90,91
1683707228245,MGT 164GS,A00,202874,McKay; Mary A,13,0,28,15
1683707229270,MGT 180,A00,202875,Staff,0,51,90,91
1683707230297,MMW 11R,A01,205019,Herbst; Matthew,0,0,30,30
1683707230297,MMW 11R,A02,205026,Herbst; Matthew,29,0,30,1
1683707231329,MMW 15,A01,193512,Chang; Edmond Yi-Teh,0,8,28,28
1683707231329,MMW 15,A02,193513,Chang; Edmond Yi-Teh,0,5,28,28
1683707231329,MMW 15,A03,193514,Chang; Edmond Yi-Teh,0,5,28,28
1683707231329,MMW 15,A04,193515,Chang; Edmond Yi-Teh,0,5,28,28
1683707231329,MMW 15,A05,193516,Chang; Edmond Yi-Teh,0,5,28,28
1683707231329,MMW 15,A06,193517,Chang; Edmond Yi-Teh,0,6,28,28
1683707231329,MMW 15,B01,193519,Chang; Edmond Yi-Teh,0,5,28,28
1683707231329,MMW 15,B02,193520,Chang; Edmond Yi-Teh,0,5,28,28
1683707231329,MMW 15,B03,193521,Chang; Edmond Yi-Teh,0,5,28,28
1683707231329,MMW 15,B04,193522,Chang; Edmond Yi-Teh,0,6,28,28
1683707231329,MMW 15,B05,193523,Chang; Edmond Yi-Teh,0,5,28,28
1683707231329,MMW 15,B06,193524,Chang; Edmond Yi-Teh,0,5,28,28
1683707232354,MMW 122,A01,193526,Rahimi; Babak,0,16,28,28
1683707232354,MMW 122,A02,193527,Rahimi; Babak,0,15,28,28
1683707232354,MMW 122,A03,193528,Rahimi; Babak,0,0,0,0
1683707232354,MMW 122,A04,193529,Rahimi; Babak,0,0,0,0
1683707233383,MUS 1A,A01,186663,Staff,0,18,35,35
1683707234409,MUS 4,A01,186715,Staff,0,12,35,35
1683707235436,MUS 5R,A01,186796,Dubnov; Shlomo,0,17,35,35
1683707236464,MUS 6,A01,186798,Staff,0,4,25,25
1683707237489,MUS 7,A01,186830,Staff,11,0,35,24
1683707238518,MUS 8,A01,186930,Staff,0,27,35,35
1683707239550,MUS 15,A01,186932,Staff,0,15,35,35
1683707239550,MUS 15,B01,186934,Staff,0,16,35,35
1683707240575,MUS 80,A00,186935,Staff,0,0,20,20
1683707240575,MUS 80,B00,186936,Staff,24,0,25,1
1683707241605,NANO 11,A00,204702,Lipomi; Darren John,0,0,0,0
1683707242631,NANO 15,A01,204709,Yang; Kesong,0,1,0,0
1683707243656,NANO 114,A00,202069,Jahed Motlagh; Zeinab,2,0,10,8
1683707244685,PHIL 1,A00,186955,Grush; Rick Scott,31,0,40,9
1683707245710,PHIL 10,A01,186973,Grush; Rick Scott,27,0,35,8
1683707245710,PHIL 10,A02,186974,Grush; Rick Scott,33,0,35,2
1683707246738,PHIL 13,A01,186976,Staff,1,0,35,34
1683707246738,PHIL 13,A02,186977,Staff,16,0,35,19
1683707247762,PHIL 14,A01,186979,Staff,30,0,35,5
1683707247762,PHIL 14,A02,186986,Staff,32,0,35,3
1683707248787,PHIL 28,A01,186988,Staff,16,0,30,14
1683707248787,PHIL 28,A02,186989,Staff,0,0,30,30
1683707248787,PHIL 28,A03,186990,Staff,10,0,30,20
1683707248787,PHIL 28,A04,186991,Staff,26,0,30,4
1683707249812,PHIL 120,A00,186997,Staff,23,0,40,17
1683707250837,PHIL 137,A00,187003,Staff,7,0,40,33
1683707251863,PHIL 150,A00,187015,Staff,47,0,70,23
1683707252889,PHIL 167,A00,187021,Lamey; Andy M.,34,0,40,6
1683707253917,PHIL 174,A01,202226,Staff,17,0,20,3
1683707253917,PHIL 174,A02,202235,Staff,20,0,20,0
1683707254946,PHIL 191A,A00,258918,Staff,0,0,1,1
1683707255972,PHYS 1A,A00,187028,Staff,26,0,60,34
1683707256999,PHYS 1AL,001,187036,Staff,3,0,30,27
1683707256999,PHYS 1AL,002,187049,Staff,18,0,30,12
1683707258027,PHYS 1B,A00,187058,Staff,21,0,60,39
1683707259058,PHYS 1BL,001,187064,Staff,0,1,30,30
1683707259058,PHYS 1BL,002,187070,Staff,4,0,30,26
1683707260082,PHYS 1C,A00,187082,Staff,30,0,120,90
1683707261111,PHYS 1CL,001,187088,Staff,0,9,30,30
1683707261111,PHYS 1CL,002,187089,Staff,0,1,30,30
1683707261111,PHYS 1CL,009,262693,Staff,9,0,30,21
1683707262140,PHYS 2B,A01,187097,Staff,55,0,115,60
1683707263165,PHYS 2C,A01,187099,Staff,63,0,115,52
1683707264195,PHYS 2CL,A01,187101,Staff,5,0,28,23
1683707264195,PHYS 2CL,A02,187102,Staff,15,0,28,13
1683707265227,PHYS 2D,A01,187123,Shotwell; Brian,95,0,115,20
1683707266258,PHYS 4B,A01,187133,Grinstein; Benjamin,35,0,50,15
1683707267284,POLI 10,A00,188819,Staff,0,4,50,50
1683707268311,POLI 11,A00,188827,Staff,43,0,50,7
1683707269336,POLI 13R,A00,188828,Staff,0,1,20,20
1683707270361,POLI 27,A01,188830,Elgin; Samuel Zincke,0,2,70,70
1683707271392,POLI 30,A00,188832,Desposato; Scott,30,0,50,20
1683707272419,POLI 102F,A00,188834,Staff,1,0,40,39
1683707273445,POLI 104A,A00,188852,Staff,12,0,30,18
1683707274469,POLI 104I,A00,188853,Staff,0,8,20,20
1683707275499,POLI 110B,A00,188854,Wiens; David,6,0,20,14
1683707276525,POLI 112A,A00,188855,Wiens; David,3,0,30,27
1683707277569,POLI 117R,A00,188856,Forman; Fonna,0,12,20,20
1683707278596,POLI 118,A00,188857,Ingham; Sean,8,0,20,12
1683707279621,POLI 120G,A00,188858,Staff,7,0,30,23
1683707280651,POLI 131CR,A00,188863,Hoston; Germaine,20,0,50,30
1683707281685,POLI 133,A00,188864,Nellis; Gareth Hb,44,0,50,6
1683707282715,POLI 134D,A00,188865,Desposato; Scott,27,0,30,3
1683707283744,POLI 142A,A00,188871,Gartzke; Erik,21,0,50,29
1683707284773,POLI 142K,A00,188874,Staff,38,0,50,12
1683707285802,POLI 143,A00,188940,Gartzke; Erik,15,0,30,15
1683707286829,POLI 153,A00,188943,Staff,1,0,20,19
1683707287858,POLI 160AA,A00,188944,Staff,10,0,40,30
1683707288883,POLI 170A,A00,188945,Staff,10,0,30,20
1683707290940,PSYC 1,A00,188952,Staff,36,0,90,54
1683707291965,PSYC 2,B00,188953,Staff,19,0,35,16
1683707292997,PSYC 6,A00,188970,Staff,47,0,60,13
1683707294026,PSYC 7,A00,188973,Staff,35,0,45,10
1683707295060,PSYC 60,A01,188980,Rickard; Timothy C.,42,0,60,18
1683707296085,PSYC 70,A01,189001,Steiner; Eric Tomas,22,0,45,23
1683707297115,PSYC 100,A00,189005,Lacefield; Katharine I,1,98,120,119
1683707298142,PSYC 102,A00,189008,Staff,6,0,30,24
1683707299166,PSYC 106,B00,189026,Gorman; Michael R.,27,0,60,33
1683707300192,PSYC 114,B01,189033,Winkielman; Piotr,0,31,30,30
1683707301216,PSYC 131,A00,189036,Anagnostaras; Stephan,0,44,60,60
1683707302240,PSYC 136,A00,189041,Lowe; Angela Beth,0,7,25,25
1683707303265,PSYC 137,A00,189057,Winkielman; Piotr,0,36,25,25
1683707304297,PSYC 144,A00,189107,Wixted; John T,0,11,50,50
1683707306353,PSYC 162,A00,189142,Staff,0,9,85,85
1683707307378,PSYC 172,A00,189144,Gorman; Michael R.,0,6,30,30
1683707309431,PSYC 179,A00,189146,Lacefield; Katharine I,0,88,120,120
1683707310456,PSYC 181,A00,189147,Anagnostaras; Stephan,0,45,90,90
1683707311481,PSYC 190R,A00,189148,Barner; David A.,0,23,80,80
1683707312506,PSYC 191,A00,189275,Rickard; Timothy C.,0,11,25,25
1683707313532,PSYC 193,A00,189276,Chapman; Eddie Nathaniel,0,1,0,4
1683707314569,PSYC 193L,A01,189281,Lowe; Angela Beth,8,0,20,12
1683707314569,PSYC 193L,B01,189285,Staff,28,0,35,7
1683707315597,RELI 149,A00,187137,Rahimi; Babak,6,0,40,34
1683707316622,SE 9,A01,187315,Staff,0,2,18,18
1683707317651,SE 101B,A00,187409,Staff,24,0,30,6
1683707318681,SE 110B,A00,187444,Staff,10,0,40,30
1683707319709,SE 130B,A00,187449,Staff,31,0,40,9
1683707320735,SE 150A,A00,187516,Staff,8,0,20,12
1683707321759,SE 154,A00,187528,Staff,29,0,50,21
1683707322785,SIO 3,A01,258171,Staff,35,0,40,5
1683707323812,SIO 10,A00,187144,Cook; Geoffrey W,0,6,75,75
1683707324914,SIO 45,A00,187152,Cook; Geoffrey W,1,7,100,99
1683707325940,SIO 109R,A00,194486,Staff,0,4,20,20
1683707327993,SIO 187,A01,187233,Kacev; David,12,0,40,28
1683707329018,SOCI 1,A01,258656,Thorpe; Charles Robert,28,0,30,2
1683707329018,SOCI 1,A02,258658,Thorpe; Charles Robert,30,0,30,0
1683707329018,SOCI 1,A03,258661,Thorpe; Charles Robert,25,0,25,0
1683707329018,SOCI 1,A04,258666,Thorpe; Charles Robert,22,0,25,3
1683707329018,SOCI 1,A05,258897,Thorpe; Charles Robert,22,0,25,3
1683707329018,SOCI 1,A06,258898,Thorpe; Charles Robert,25,0,25,0
1683707330043,SOCI 30,A01,258903,Pardo Guerra; Juan Pablo,14,0,30,16
1683707331071,SOCI 102,A00,258904,Staff,9,0,25,16
1683707332098,SOCI 106,A00,258905,Staff,19,0,25,6
1683707333123,SOCI 111,A00,258907,Ribas Norris; Janet Vanesa,26,0,30,4
1683707334147,SOCI 121R,A00,258908,Pardo Guerra; Juan Pablo,7,0,30,23
1683707335176,SOCI 126,A01,203330,Staff,14,0,20,6
1683707336204,SOCI 131,A00,258909,Thorpe; Charles Robert,30,0,60,30
1683707337230,SOCI 135,A00,258910,Payne; Christine Anna,0,13,30,30
1683707338256,SOCI 157,A00,258911,Staff,10,0,30,20
1683707339284,SOCI 184,A00,258912,Staff,25,0,30,5
1683707340308,SOCI 188D,A00,258913,Staff,22,0,30,8
1683707341335,SYN 2,001,187529,Staff,9,0,16,7
1683707341335,SYN 2,002,201452,Staff,0,20,16,16
1683707341335,SYN 2,003,201469,Staff,1,0,16,15
1683707342360,SYN 100,A01,187531,Staff,0,9,20,20
1683707342360,SYN 100,B01,201491,Staff,0,10,20,20
1683707343393,TDAC 1,A00,189286,Walsh; Kim C.,3,0,20,17
1683707343393,TDAC 1,B00,189287,Harting; Carla Kelso,10,0,20,10
1683707344417,TDAC 101,A00,189300,Walsh; Kim C.,16,0,20,4
1683707344417,TDAC 101,B00,189301,Harting; Carla Kelso,18,0,20,2
1683707345442,TDAC 102,A00,189304,Basso; Beatrice,14,0,20,6
1683707346471,TDAC 108,A00,189305,Staff,18,0,20,2
1683707347499,TDDE 131,A00,189310,Staff,19,0,20,1
1683707347499,TDDE 131,B00,189314,Staff,19,0,20,1
1683707347499,TDDE 131,C00,189315,Staff,48,0,50,2
1683707347499,TDDE 131,D00,189316,Staff,14,0,15,1
1683707347499,TDDE 131,E00,204841,Staff,20,0,20,0
1683707348529,TDGE 10,A00,189289,Staff,27,0,50,23
1683707348529,TDGE 10,B00,189290,Havis; Allan,0,1,50,50
1683707349555,TDGE 11,A00,189291,Fulton; Julia,0,4,50,50
1683707349555,TDGE 11,B00,189292,Staff,20,0,25,5
1683707349555,TDGE 11,C00,260270,Staff,0,0,0,0
1683707350581,TDGE 25,A00,189294,Staff,1,0,20,19
1683707351609,TDGE 124,A00,189318,Fulton; Julia,0,7,50,50
1683707352632,TDGE 125,A00,189319,Staff,13,0,25,12
1683707352632,TDGE 125,B00,189320,Staff,23,0,25,2
1683707353657,TDGE 127,A00,189322,Havis; Allan,1,0,50,49
1683707354681,TDHT 101,A00,189323,Staff,18,0,25,7
1683707354681,TDHT 101,B00,189324,Staff,25,0,25,0
1683707355705,TDHT 102,A00,189325,Staff,49,0,50,1
1683707356736,TDMV 1,A00,189295,Arcidiacono; Kristin,20,0,30,10
1683707356736,TDMV 1,B00,189296,Caligagan; Maria T.,23,0,30,7
1683707357762,TDMV 2,A00,189297,Sammartano; Tonnie,27,0,30,3
1683707357762,TDMV 2,B00,189299,Arcidiacono; Kristin,23,0,30,7
1683707358789,TDMV 3,A00,204998,Rincon; Alicia,22,0,30,8
1683707359815,TDMV 120,A00,189458,Sammartano; Tonnie,28,0,30,2
1683707360841,TDMV 138,A00,189541,Jun; Grace Shin Hae,20,0,40,20
1683707361870,TDMV 142,A00,189717,Caligagan; Tony,25,0,30,5
1683707361870,TDMV 142,B00,189718,Caligagan; Maria T.,25,0,30,5
1683707362899,TMC 2,A01,187533,Staff,25,0,25,0
1683707362899,TMC 2,A02,187534,Staff,25,0,25,0
1683707363927,USP 1,A01,187536,Kwak; Nancy,0,16,25,25
1683707364956,USP 5,A01,187538,Staff,8,0,25,17
1683707365981,USP 101,A00,199253,Staff,0,4,0,0
1683707367009,USP 124,A00,187562,Boomhower; Matthew Charles,0,0,30,30
1683707368039,USP 138,A00,187582,Staff,19,0,25,6
1683707369065,USP 152,A01,187597,Staff,3,0,25,22
1683707370090,USP 153,A00,187598,Staff,18,0,25,7
1683707371115,USP 168,A00,187607,Kwak; Nancy,2,0,5,3
1683707372139,USP 173,A00,187619,Staff,4,0,25,21
1683707373162,USP 181,A00,187638,Staff,0,4,25,25
1683707374195,VIS 103,A00,187650,Cruz; Edwin Teddy,17,0,75,58
1683707375220,VIS 110D,A00,187669,Staff,13,0,22,9
1683707376245,VIS 127C,A00,187720,Shen; Kuiyi,67,0,146,79
1683707377272,VIS 149,A00,187731,Yoldas; Pinar,0,12,22,22
1683707378298,VIS 151,A01,188091,Staff,22,0,34,12
1683707378298,VIS 151,A02,188092,Staff,11,0,34,23
1683707379322,VIS 160B,A00,188093,Stalbaum; Brett,0,1,10,10
1683707381378,WCWP 10B,A00,201720,Staff,0,0,5,5
1683707381378,WCWP 10B,B00,201722,Staff,0,0,6,6
1683707382405,WCWP 100,A00,201725,Gagnon; Jeffrey C,0,0,2,2
1683707382405,WCWP 100,B00,201727,Staff,0,4,15,15
1683707385535,ANBI 133,A00,258401,Wilder; Linnea Lorene,34,0,40,6
1683707386560,ANBI 140,A00,258395,Hrvoj Mihic; Branka,18,0,25,7
1683707387588,ANSC 120,A00,258402,Bialecki; Jon Anthony,26,0,40,14
1683707388612,ANSC 144,A00,258400,Staff,12,0,40,28
1683707390665,ANSC 166,A00,258396,Parish; Steven Martin,156,0,175,19
1683707391688,ANSC 180,A00,193533,Staff,8,0,20,12
1683707392718,ANSC 188,A00,258397,Jassal; Aftab,34,0,40,6
1683707393746,ANTH 3,A01,258316,Staff,23,0,30,7
1683707394770,ANTH 5,A00,258394,Semendeferi; Ekaterini,16,0,20,4
1683707395799,ANTH 21,A01,258331,Staff,4,0,40,36
1683707396825,ANTH 103,A00,258398,Varma; Saiba,15,0,25,10
1683707397854,AWP 10,001,202034,Staff,0,0,0,0
1683707397854,AWP 10,002,202035,Staff,0,0,0,0
1683707397854,AWP 10,003,202036,Staff,0,0,0,0
1683707397854,AWP 10,004,202037,Staff,0,0,0,0
1683707397854,AWP 10,005,202038,Staff,0,0,0,0
1683707397854,AWP 10,006,202039,Staff,0,0,0,0
1683707397854,AWP 10,007,202040,Staff,0,0,0,0
1683707397854,AWP 10,008,202041,Staff,0,0,0,0
1683707397854,AWP 10,009,202042,Staff,0,0,0,0
1683707397854,AWP 10,010,202043,Staff,0,0,0,0
1683707397854,AWP 10,011,202044,Staff,0,0,0,0
1683707397854,AWP 10,012,202045,Staff,0,0,0,0
1683707397854,AWP 10,013,202046,Staff,0,0,0,0
1683707397854,AWP 10,014,202047,Staff,0,0,0,0
1683707397854,AWP 10,015,202048,Staff,0,0,0,0
1683707397854,AWP 10,016,202049,Staff,0,0,0,0
1683707397854,AWP 10,017,202050,Staff,0,0,0,0
1683707397854,AWP 10,018,202051,Staff,0,0,0,0
1683707397854,AWP 10,019,202052,Staff,0,0,0,0
1683707397854,AWP 10,020,202053,Staff,0,0,0,0
1683707397854,AWP 10,021,202054,Staff,0,0,0,0
1683707397854,AWP 10,022,202055,Staff,0,0,0,0
1683707397854,AWP 10,023,202056,Staff,0,0,0,0
1683707397854,AWP 10,024,202057,Staff,0,0,0,0
1683707397854,AWP 10,025,202058,Staff,0,0,0,0
1683707397854,AWP 10,026,202059,Staff,0,0,0,0
1683707398881,AWP 102,001,202032,Staff,0,0,0,0
1683707398881,AWP 102,002,202033,Staff,0,0,0,0
1683707399908,BENG 100,A01,254234,Taylor Amos; Alyssa C,31,0,40,9
1683707400933,BENG 196,001,270013,Engler; Adam J.,9999,0,9999,0
1683707401958,BICD 100R,A01,202018,Smith; Laurie,0,7,32,32
1683707401958,BICD 100R,A02,202019,Smith; Laurie,0,3,32,32
1683707401958,BICD 100R,A03,202020,Smith; Laurie,0,1,32,32
1683707401958,BICD 100R,A04,202021,Smith; Laurie,6,0,32,26
1683707401958,BICD 100R,A05,202022,Smith; Laurie,10,0,32,22
1683707402994,BICD 136,A01,193242,Gustafson-Brown; Cindy,0,2,32,32
1683707402994,BICD 136,A02,193244,Gustafson-Brown; Cindy,13,0,32,19
1683707404024,BIEB 102,A01,193249,Butler; Shannon Rhey,0,0,32,32
1683707404024,BIEB 102,A02,193251,Butler; Shannon Rhey,0,0,32,32
1683707404024,BIEB 102,A03,193253,Butler; Shannon Rhey,0,0,32,32
1683707404024,BIEB 102,A04,193255,Butler; Shannon Rhey,13,0,32,19
1683707404024,BIEB 102,A05,193265,Butler; Shannon Rhey,25,0,32,7
1683707404024,BIEB 102,A06,193269,Butler; Shannon Rhey,12,0,32,20
1683707406078,BIEB 150,A01,193274,Staff,0,0,32,32
1683707406078,BIEB 150,A02,193285,Staff,24,0,32,8
1683707407108,BIEB 194,A00,193286,Kurle; Carolyn M.,19,0,32,13
1683707408141,BILD 1,A01,192291,Staff,15,0,32,17
1683707408141,BILD 1,A02,192292,Staff,30,0,32,2
1683707408141,BILD 1,B01,192520,Reuther; Keefe,0,1,0,0
1683707408141,BILD 1,B02,192532,Reuther; Keefe,0,1,0,0
1683707409168,BILD 3,A01,192556,Butler; Shannon Rhey,0,0,32,32
1683707409168,BILD 3,A02,192581,Butler; Shannon Rhey,0,1,32,32
1683707409168,BILD 3,A03,192611,Butler; Shannon Rhey,19,0,32,13
1683707409168,BILD 3,A04,192612,Butler; Shannon Rhey,23,0,32,9
1683707409168,BILD 3,A05,192613,Butler; Shannon Rhey,26,0,32,6
1683707409168,BILD 3,A06,192679,Butler; Shannon Rhey,27,0,32,5
1683707409168,BILD 3,A07,192682,Butler; Shannon Rhey,20,0,32,12
1683707410193,BILD 4,A01,192836,Reuther; Keefe,1,0,24,23
1683707410193,BILD 4,A02,193044,Reuther; Keefe,4,0,24,20
1683707411221,BILD 10,A01,193142,Gustafson-Brown; Cindy,29,0,32,3
1683707411221,BILD 10,A02,193149,Gustafson-Brown; Cindy,31,0,32,1
1683707412248,BIMM 100,A01,193301,Staff,0,6,32,32
1683707412248,BIMM 100,A02,193312,Staff,0,7,32,32
1683707412248,BIMM 100,A03,193323,Staff,0,10,32,32
1683707413275,BIMM 101,A01,193329,McDonnell; Lisa Marie,0,3,24,24
1683707413275,BIMM 101,A02,193339,McDonnell; Lisa Marie,0,3,24,24
1683707413275,BIMM 101,B01,193354,McDonnell; Lisa Marie,0,4,24,24
1683707413275,BIMM 101,B02,193357,McDonnell; Lisa Marie,0,3,24,24
1683707414300,BIMM 110,A01,193377,Tat; John,0,11,32,32
1683707414300,BIMM 110,A02,193378,Tat; John,0,11,32,32
1683707415327,BIMM 120,A01,206116,Staff,0,0,32,32
1683707415327,BIMM 120,A02,206117,Staff,7,0,32,25
1683707415327,BIMM 120,A03,206121,Staff,21,0,32,11
1683707416351,BIPN 100,A01,193393,Park; Ji Young,0,15,32,32
1683707416351,BIPN 100,A02,193402,Park; Ji Young,0,14,32,32
1683707416351,BIPN 100,A03,193413,Park; Ji Young,0,14,32,32
1683707416351,BIPN 100,A04,193414,Park; Ji Young,0,13,32,32
1683707417375,BIPN 102,A01,193429,Staff,0,0,32,32
1683707417375,BIPN 102,A02,193438,Staff,18,0,32,14
1683707418406,BIPN 106,A01,193450,Reyes Gonzalez; Catalina,0,2,40,40
1683707419431,BIPN 134,A01,193465,Cooke; James Edward,0,0,32,32
1683707419431,BIPN 134,A02,193474,Cooke; James Edward,25,0,32,7
1683707419431,BIPN 134,A03,193485,Cooke; James Edward,29,0,32,3
1683707419431,BIPN 134,A04,193486,Cooke; James Edward,20,0,32,12
1683707419431,BIPN 134,A05,193491,Cooke; James Edward,31,0,32,1
1683707419431,BIPN 134,A06,193501,Cooke; James Edward,30,0,32,2
1683707419431,BIPN 134,A07,193510,Cooke; James Edward,29,0,32,3
1683707421481,BISP 194,A00,222522,Staff,14,0,32,18
1683707422510,CAT 124,A01,202407,Staff,19,0,25,6
1683707423536,CAT 125,A00,202408,Marchisotto; Jennifer Anne,2,0,20,18
1683707424571,CAT 125R,A00,202409,Smith; Lauryn Alissa,0,11,20,20
1683707424571,CAT 125R,B00,202410,Morales; Celeste Georgianna,0,11,20,20
1683707424571,CAT 125R,C00,202411,Irwin; Matthew Joseph,0,12,20,20
1683707425602,CENG 15,A01,204712,Yang; Kesong,0,1,0,0
1683707426628,CENG 114,A00,202070,Jahed Motlagh; Zeinab,5,0,20,15
1683707427653,CGS 105,A00,185477,Wesling; Megan E.,24,0,40,16
1683707428739,CGS 106,A00,185494,Staff,11,0,22,11
1683707429762,CGS 108,A00,185495,Staff,14,0,20,6
1683707430790,CGS 114,A00,185496,Staff,13,0,18,5
1683707431818,CGS 119,A00,185501,Staff,15,0,20,5
1683707432845,CGS 120,A00,185511,Staff,11,0,20,9
1683707433871,CHEM 4,A01,184675,Bussey; Thomas J,97,0,100,3
1683707434902,CHEM 6A,A01,184677,Staff,32,0,60,28
1683707435927,CHEM 6B,A01,184679,Staff,63,0,100,37
1683707436957,CHEM 6C,A01,184681,Bussey; Thomas J,0,0,50,50
1683707436957,CHEM 6C,A02,184682,Bussey; Thomas J,32,0,50,18
1683707437983,CHEM 40A,A01,184684,Albizati; Kim F.,33,0,100,67
1683707439010,CHEM 40B,A01,184686,Albizati; Kim F.,0,22,100,100
1683707440035,CHEM 41B,A01,184690,Staff,51,0,100,49
1683707441059,COGS 3,A01,184715,Boyle; Mary E. T.,0,27,40,40
1683707442089,COGS 14B,A01,185172,Staff,0,14,38,38
1683707443114,COGS 18,A01,184736,Staff,14,0,80,66
1683707444140,COGS 100,A01,184932,Staff,0,8,73,73
1683707445164,COGS 101A,A01,184935,Staff,0,40,30,30
1683707446188,COGS 101B,A01,184944,Staff,0,2,30,30
1683707447213,COGS 101C,A01,184946,Staff,0,10,30,30
1683707448243,COGS 102A,A01,184951,Johnson; Christine M.,1,0,40,39
1683707449273,COGS 107B,A01,184953,Mooshagian; Eric Frederick,0,52,40,40
1683707450299,COGS 118B,A01,184959,Gupta; Anjum,0,50,40,40
1683707451325,COGS 153,A00,184961,Staff,1,16,30,29
1683707452350,COGS 177,A00,184962,Staff,0,20,30,30
1683707453378,COGS 187A,A01,184969,Boyle; Mary E. T.,0,19,40,40
1683707454403,COMM 10,A01,185174,Staff,0,5,25,25
1683707454403,COMM 10,A02,185189,Staff,0,2,25,25
1683707454403,COMM 10,A03,269821,Staff,0,1,0,0
1683707455429,COMM 100B,A02,185476,Staff,10,0,25,15
1683707455429,COMM 100B,A03,277340,Staff,25,0,25,0
1683707456453,COMM 100C,A01,185314,Staff,2,0,25,23
1683707456453,COMM 100C,A02,185327,Staff,17,0,25,8
1683707457477,COMM 110M,A00,185349,Staff,0,0,40,40
1683707458501,COMM 113T,A00,185352,Staff,25,0,40,15
1683707459526,COMM 114I,A00,185353,Staff,31,0,40,9
1683707460554,COMM 131,A00,185354,Staff,17,0,30,13
1683707461632,CSE 8A,A50,185358,Cao; Yingjun,0,46,10,10
1683707462656,CSE 8B,A01,185362,Staff,0,48,50,50
1683707463686,CSE 11,A01,185416,Cao; Yingjun,0,91,10,10
1683707464718,CSE 20,A01,185445,Briones; Jor-el Thomas Caparas,3,0,25,22
1683707465743,CSE 21,A01,185447,Staff,9,0,50,41
1683707466770,CSE 101,A01,185451,Staff,0,13,50,50
1683707466770,CSE 101,B01,185453,Jones; Miles E,0,15,50,50
1683707468825,CSE 141,A01,185458,Eldon; John,16,0,100,84
1683707469850,CSE 141L,A01,185461,Eldon; John,8,0,100,92
1683707470880,CSE 142,A01,185463,Staff,34,0,60,26
1683707470880,CSE 142,B01,201355,Staff,0,7,60,60
1683707471909,CSE 142L,A01,185470,Staff,34,0,60,26
1683707471909,CSE 142L,B01,201417,Staff,0,6,60,60
1683707472934,CSE 190,A00,201433,Staff,32,0,49,17
1683707473965,DOC 1,A01,259136,Strom; Megan C.,7,0,15,8
1683707473965,DOC 1,A02,259137,Strom; Megan C.,15,0,15,0
1683707473965,DOC 1,A03,259138,Strom; Megan C.,14,0,15,1
1683707473965,DOC 1,A04,259139,Strom; Megan C.,14,0,15,1
1683707474992,DOC 100D,A00,259140,Pass; Natalye Joann,14,0,25,11
1683707476023,DSGN 1,A01,184749,Rill; Bryan,0,26,30,30
1683707477052,DSGN 100,A01,185168,Staff,0,2,25,25
1683707478079,ECE 5,A01,185626,Morris; Karcher William,0,12,0,0
1683707479108,ECE 101,A01,185628,Staff,14,0,70,56
1683707480137,ECE 107,A01,185635,Baghdadchi; Saharnaz,0,0,20,20
1683707480137,ECE 107,A02,185638,Baghdadchi; Saharnaz,1,0,20,19
1683707481167,ECE 148,A01,185647,Silberman; Jack,0,0,16,16
1683707482192,ECON 1,A01,185537,Crane; Meredith Helen,54,0,70,16
1683707483221,ECON 3,A01,185549,Crane; Meredith Helen,30,0,70,40
1683707484253,ECON 4,A01,203354,Anderson; John Charles,0,5,10,10
1683707485283,ECON 100A,A01,185574,Staff,0,5,40,40
1683707486309,ECON 100B,A01,185576,Staff,0,12,50,50
1683707487339,ECON 100C,A01,185589,Newhouse; Herbert S,30,0,70,40
1683707488368,ECON 105,A00,185608,Vespa; Emanuel Ignacio,19,0,35,16
1683707489393,ECON 109,A01,185610,Shishkin; Denis,9,0,35,26
1683707490418,ECON 110A,A01,185612,Staff,8,0,40,32
1683707491444,ECON 120A,A01,185615,Staff,19,0,40,21
1683707492475,ECON 120C,A01,185617,Sun; Yixiao,0,21,70,70
1683707493505,ECON 144,A00,203346,Squires; Dale E,2,0,35,33
1683707494530,ECON 171,A01,203349,Newhouse; Herbert S,0,1,35,35
1683707495554,ECON 173A,A01,185621,Toda; Alexis Akira,21,0,35,14
1683707496582,EDS 25,A01,202413,Staff,0,1,0,0
1683707496582,EDS 25,A02,202414,Staff,0,1,0,0
1683707496582,EDS 25,A03,202415,Staff,0,0,0,0
1683707496582,EDS 25,A04,202416,Staff,0,1,0,0
1683707496582,EDS 25,A05,202439,Staff,0,0,0,0
1683707496582,EDS 25,A06,202440,Staff,0,0,0,0
1683707496582,EDS 25,B01,202631,Staff,0,0,0,0
1683707496582,EDS 25,B02,202632,Staff,0,0,0,0
1683707496582,EDS 25,B03,202639,Staff,0,0,0,0
1683707496582,EDS 25,B04,202640,Staff,0,0,0,0
1683707496582,EDS 25,B05,202643,Staff,0,0,0,0
1683707496582,EDS 25,B06,202644,Staff,0,0,0,0
1683707497610,EDS 38,A01,202659,Black; Alison Michelle,25,0,25,0
1683707498635,EDS 115,A00,202652,Staff,18,0,30,12
1683707499661,EDS 125,A00,202649,Staff,13,0,30,17
1683707500686,EDS 126,A01,203332,Staff,30,0,30,0
1683707501715,EDS 139,A00,202838,Staff,16,0,25,9
1683707502739,EDS 146,A01,202655,Staff,14,0,25,11
1683707503767,ENG 15,A00,185667,Staff,0,1,0,0
1683707503767,ENG 15,B00,185672,Staff,0,0,0,0
1683707503767,ENG 15,C00,185675,Staff,0,0,0,0
1683707503767,ENG 15,D00,185682,Staff,0,0,0,0
1683707503767,ENG 15,E00,185684,Staff,0,0,0,0
1683707504793,ETHN 103,A00,185710,Staff,0,8,35,35
1683707505819,ETHN 103A,A00,199228,Man; Simeon S,0,0,9,9
1683707506845,ETHN 109,A00,185711,Staff,15,0,35,20
1683707507873,ETHN 142,A00,185726,Staff,0,4,30,30
1683707508903,ETHN 163J,A00,199229,Man; Simeon S,5,0,8,3
1683707509928,ETHN 168,A00,185727,Staff,7,0,10,3
1683707510954,ETHN 182,A00,185728,Staff,0,0,35,35
1683707511978,ETHN 183,A00,185737,Staff,9,0,18,9
1683707513009,GLBH 111,A01,209361,Burgos; Jose L.,0,0,0,0
1683707515062,HIEU 104,A00,185792,Staff,14,0,20,6
1683707516086,HIEU 115,A00,185800,Staff,0,0,20,20
1683707517110,HIEU 128,A00,185801,Staff,0,9,20,20
1683707518139,HIEU 147,A00,185802,Staff,15,0,20,5
1683707519167,HIEU 154,A00,185823,Staff,11,0,20,9
1683707520191,HILA 102,A00,185826,Staff,14,0,20,6
1683707521223,HILD 2C,A01,185778,Staff,0,13,20,20
1683707522254,HILD 7B,A01,185780,Kwak; Nancy,0,17,32,32
1683707522254,HILD 7B,A02,185781,Kwak; Nancy,0,18,32,32
1683707523282,HILD 30,A01,185791,Staff,12,0,20,8
1683707524310,HISC 119,A00,185830,Golan; Tal,0,10,20,20
1683707525335,HITO 156GS,A00,185831,Patterson; Patrick H.,0,0,0,23
1683707526369,HIUS 103,A00,185832,Man; Simeon S,0,4,20,20
1683707527393,HIUS 117,A00,185836,Kwak; Nancy,2,0,20,18
1683707528418,HIUS 125,A00,185840,Man; Simeon S,0,2,23,23
1683707529447,HIUS 149,A00,185845,Staff,1,0,20,19
1683707530474,HUM 3,A01,185882,Zavodny; Tatiana Sophia,0,8,50,50
1683707530474,HUM 3,B01,185899,Caldwell; Michael Alan,0,18,50,50
1683707531498,HUM 3GS,A00,185900,Patterson; Patrick H.,0,0,0,23
1683707532582,HUM 4,A01,185938,Zroka; Amy Liane,28,0,50,22
1683707532582,HUM 4,B01,185956,Watkins; Eric,0,6,50,50
1683707532582,HUM 4,B02,202209,Watkins; Eric,0,5,50,50
1683707532582,HUM 4,B03,202210,Watkins; Eric,0,5,50,50
1683707533618,HUM 5,A01,185958,West; Geoffrey Scott,0,0,50,50
1683707533618,HUM 5,A02,202215,West; Geoffrey Scott,0,1,50,50
1683707534643,INTL 190,A00,185959,Gagnon; Jeffrey C,0,0,0,9
1683707534643,INTL 190,B00,185960,Lettieri; Michael Joseph,0,0,0,2
1683707535673,JAPN 180,A00,254509,Staff,5,0,30,25
1683707536707,LATI 10,A01,202853,Kennemore; Amy Michelle,4,0,35,31
1683707536707,LATI 10,A02,202854,Kennemore; Amy Michelle,3,0,35,32
1683707536707,LATI 10,A03,270054,Kennemore; Amy Michelle,30,0,30,0
1683707537735,LATI 180,A00,202855,Kennemore; Amy Michelle,11,0,20,9
1683707538760,LAWS 101,A00,201767,Golan; Tal,0,7,40,40
1683707539786,LIFR 1C,A00,185961,Staff,6,0,20,14
1683707540815,LIFR 1CX,A00,185962,Staff,7,0,20,13
1683707541843,LIFR 1D,A00,185963,Staff,7,0,20,13
1683707542871,LIFR 1DX,A00,185964,Staff,7,0,20,13
1683707543905,LIGN 101,A01,186039,Staff,43,0,50,7
1683707544931,LIGN 165,A00,186040,Staff,14,0,50,36
1683707545957,LTCS 108,A00,186041,Staff,5,0,10,5
1683707546985,LTCS 119,A00,186042,Staff,15,0,20,5
1683707548011,LTCS 130,A00,186043,Wesling; Megan E.,15,0,25,10
1683707550068,LTEA 138,A00,186119,Staff,14,0,40,26
1683707551090,LTEN 124,A00,186148,Staff,5,0,25,20
1683707552115,LTEN 178,A00,186149,Staff,6,0,15,9
1683707553141,LTEN 181,A00,186150,Blanco; John D,34,0,40,6
1683707554164,LTWL 120,A00,186160,Staff,19,0,25,6
1683707555193,LTWL 165,A00,186161,Staff,22,0,25,3
1683707556219,LTWR 100,A00,186162,Staff,0,5,15,15
1683707557242,LTWR 102,A00,186163,Doller; Ben,5,0,15,10
1683707558268,MAE 8,A01,186412,Staff,0,1,0,0
1683707559299,MAE 30B,A00,186445,Bahadori; Mohammad Yousef,81,0,100,19
1683707560327,MAE 40,A00,186592,Bewley; Thomas R,10,0,50,40
1683707561352,MAE 101B,A00,186593,Bahadori; Mohammad Yousef,80,0,100,20
1683707562377,MAE 105,A00,186594,Bandaru; Prabhakar,10,0,50,40
1683707563408,MAE 107,A00,186599,Pham; Hieu Tan,0,8,120,120
1683707564439,MAE 148,A01,186660,Silberman; Jack,3,0,16,13
1683707565466,MATH 10A,A01,188095,Staff,0,6,35,35
1683707566502,MATH 10B,A01,188097,Bowers; Adam R.,0,12,30,30
1683707566502,MATH 10B,A02,188099,Bowers; Adam R.,0,11,30,30
1683707566502,MATH 10B,B01,188104,Bowers; Adam R.,0,10,30,30
1683707566502,MATH 10B,B02,188106,Bowers; Adam R.,0,9,30,30
1683707567530,MATH 10C,A01,188111,Staff,0,20,30,30
1683707567530,MATH 10C,A02,188127,Staff,0,19,30,30
1683707567530,MATH 10C,A03,188131,Staff,0,19,30,30
1683707567530,MATH 10C,B01,188218,Staff,17,0,30,13
1683707567530,MATH 10C,B02,188244,Staff,13,0,30,17
1683707567530,MATH 10C,B03,188277,Staff,14,0,30,16
1683707568563,MATH 18,A01,188344,Bach; Quang Tran,18,0,30,12
1683707568563,MATH 18,A02,188345,Bach; Quang Tran,11,0,30,19
1683707568563,MATH 18,B01,188353,Bach; Quang Tran,11,0,30,19
1683707568563,MATH 18,B02,188354,Bach; Quang Tran,19,0,30,11
1683707569590,MATH 20A,A01,188374,Staff,11,0,35,24
1683707570624,MATH 20B,A01,188382,Ohm; Ko Woon,7,0,30,23
1683707570624,MATH 20B,A02,188383,Ohm; Ko Woon,22,0,30,8
1683707570624,MATH 20B,B01,188385,Ohm; Ko Woon,7,0,30,23
1683707570624,MATH 20B,B02,188392,Ohm; Ko Woon,22,0,30,8
1683707571651,MATH 20C,A01,188394,Harel; Guershon,10,0,30,20
1683707571651,MATH 20C,A02,188395,Harel; Guershon,13,0,30,17
1683707571651,MATH 20C,B01,188404,Harel; Guershon,5,0,30,25
1683707571651,MATH 20C,B02,188405,Harel; Guershon,18,0,30,12
1683707572678,MATH 20D,A01,188414,Hammock; Frances H,0,1,30,30
1683707572678,MATH 20D,A02,188415,Hammock; Frances H,0,1,30,30
1683707572678,MATH 20D,B01,188447,Hammock; Frances H,0,1,30,30
1683707572678,MATH 20D,B02,188486,Hammock; Frances H,2,0,30,28
1683707573704,MATH 20E,A01,188649,Staff,21,0,30,9
1683707573704,MATH 20E,A02,188650,Staff,20,0,30,10
1683707573704,MATH 20E,A03,188673,Staff,0,0,30,30
1683707574735,MATH 102,A01,188675,Staff,0,40,35,35
1683707575766,MATH 103B,A01,188681,Staff,3,0,35,32
1683707575766,MATH 103B,B01,188692,Staff,5,0,35,30
1683707576791,MATH 109,A01,188695,Salehi Golsefidy; Alireza,24,0,35,11
1683707576791,MATH 109,A02,188696,Salehi Golsefidy; Alireza,25,0,35,10
1683707577818,MATH 120A,A01,188698,Eggers; John Dietrich,7,0,35,28
1683707578844,MATH 142B,A01,188736,Ioana; Adrian,0,0,30,30
1683707578844,MATH 142B,A02,188741,Ioana; Adrian,0,1,30,30
1683707578844,MATH 142B,A03,188743,Ioana; Adrian,0,2,30,30
1683707579874,MATH 168A,A01,188790,Staff,0,11,35,35
1683707580906,MATH 170A,A01,188803,Nie; Jiawang,0,2,35,35
1683707580906,MATH 170A,A02,188811,Nie; Jiawang,0,1,35,35
1683707580906,MATH 170A,A03,188814,Nie; Jiawang,0,0,35,35
1683707580906,MATH 170A,A04,188815,Nie; Jiawang,5,0,35,30
1683707581929,MATH 193B,A01,188817,Staff,0,0,35,35
1683707581929,MATH 193B,A02,188818,Staff,6,0,35,29
1683707582962,MGT 4,A01,202857,Anderson; John Charles,59,0,80,21
1683707583991,MGT 12,A00,202858,Lindenberger; Wade Douglas,40,0,90,50
1683707585016,MGT 18,A00,202859,Staff,73,0,90,17
1683707586042,MGT 18GS,A00,202860,McKay; Michael J,13,0,28,15
1683707587070,MGT 45,A00,202861,Pecore; Joseph P.,8,0,90,82
1683707588101,MGT 100,A00,202863,Yavorsky; Daniel Ryan,27,0,90,63
1683707589128,MGT 103,A00,202864,Ehrich; Kristine R,0,19,90,90
1683707590154,MGT 112,A00,202865,Ehrich; Kristine R,15,0,90,75
1683707591191,MGT 121A,A00,202868,Staff,70,0,90,20
1683707592217,MGT 131B,A00,202869,Anderson; John Charles,58,0,90,32
1683707593246,MGT 136,A00,202871,Lindenberger; Wade Douglas,83,0,90,7
1683707594272,MGT 164,A00,202873,Staff,0,67,90,91
1683707595299,MGT 164GS,A00,202874,McKay; Mary A,13,0,28,15
1683707596327,MGT 180,A00,202875,Staff,0,51,90,91
1683707597353,MMW 11R,A01,205019,Herbst; Matthew,0,0,30,30
1683707597353,MMW 11R,A02,205026,Herbst; Matthew,29,0,30,1
1683707598377,MMW 15,A01,193512,Chang; Edmond Yi-Teh,0,8,28,28
1683707598377,MMW 15,A02,193513,Chang; Edmond Yi-Teh,0,5,28,28
1683707598377,MMW 15,A03,193514,Chang; Edmond Yi-Teh,0,5,28,28
1683707598377,MMW 15,A04,193515,Chang; Edmond Yi-Teh,0,5,28,28
1683707598377,MMW 15,A05,193516,Chang; Edmond Yi-Teh,0,5,28,28
1683707598377,MMW 15,A06,193517,Chang; Edmond Yi-Teh,0,6,28,28
1683707598377,MMW 15,B01,193519,Chang; Edmond Yi-Teh,0,5,28,28
1683707598377,MMW 15,B02,193520,Chang; Edmond Yi-Teh,0,5,28,28
1683707598377,MMW 15,B03,193521,Chang; Edmond Yi-Teh,0,5,28,28
1683707598377,MMW 15,B04,193522,Chang; Edmond Yi-Teh,0,6,28,28
1683707598377,MMW 15,B05,193523,Chang; Edmond Yi-Teh,0,5,28,28
1683707598377,MMW 15,B06,193524,Chang; Edmond Yi-Teh,0,5,28,28
1683707599401,MMW 122,A01,193526,Rahimi; Babak,0,16,28,28
1683707599401,MMW 122,A02,193527,Rahimi; Babak,0,15,28,28
1683707599401,MMW 122,A03,193528,Rahimi; Babak,0,0,0,0
1683707599401,MMW 122,A04,193529,Rahimi; Babak,0,0,0,0
1683707600429,MUS 1A,A01,186663,Staff,0,18,35,35
1683707601455,MUS 4,A01,186715,Staff,0,12,35,35
1683707602485,MUS 5R,A01,186796,Dubnov; Shlomo,0,17,35,35
1683707603508,MUS 6,A01,186798,Staff,0,4,25,25
1683707604537,MUS 7,A01,186830,Staff,11,0,35,24
1683707605566,MUS 8,A01,186930,Staff,0,27,35,35
1683707606590,MUS 15,A01,186932,Staff,0,15,35,35
1683707606590,MUS 15,B01,186934,Staff,0,16,35,35
1683707607614,MUS 80,A00,186935,Staff,0,0,20,20
1683707607614,MUS 80,B00,186936,Staff,24,0,25,1
1683707608647,NANO 11,A00,204702,Lipomi; Darren John,0,0,0,0
1683707609679,NANO 15,A01,204709,Yang; Kesong,0,1,0,0
1683707610705,NANO 114,A00,202069,Jahed Motlagh; Zeinab,2,0,10,8
1683707611730,PHIL 1,A00,186955,Grush; Rick Scott,31,0,40,9
1683707612756,PHIL 10,A01,186973,Grush; Rick Scott,27,0,35,8
1683707612756,PHIL 10,A02,186974,Grush; Rick Scott,33,0,35,2
1683707613784,PHIL 13,A01,186976,Staff,1,0,35,34
1683707613784,PHIL 13,A02,186977,Staff,16,0,35,19
1683707614812,PHIL 14,A01,186979,Staff,30,0,35,5
1683707614812,PHIL 14,A02,186986,Staff,32,0,35,3
1683707615844,PHIL 28,A01,186988,Staff,16,0,30,14
1683707615844,PHIL 28,A02,186989,Staff,0,0,30,30
1683707615844,PHIL 28,A03,186990,Staff,10,0,30,20
1683707615844,PHIL 28,A04,186991,Staff,26,0,30,4
1683707616871,PHIL 120,A00,186997,Staff,23,0,40,17
1683707617901,PHIL 137,A00,187003,Staff,7,0,40,33
1683707618926,PHIL 150,A00,187015,Staff,47,0,70,23
1683707619955,PHIL 167,A00,187021,Lamey; Andy M.,34,0,40,6
1683707620980,PHIL 174,A01,202226,Staff,17,0,20,3
1683707620980,PHIL 174,A02,202235,Staff,20,0,20,0
1683707622003,PHIL 191A,A00,258918,Staff,0,0,1,1
1683707623034,PHYS 1A,A00,187028,Staff,26,0,60,34
1683707624063,PHYS 1AL,001,187036,Staff,3,0,30,27
1683707624063,PHYS 1AL,002,187049,Staff,18,0,30,12
1683707625091,PHYS 1B,A00,187058,Staff,21,0,60,39
1683707626118,PHYS 1BL,001,187064,Staff,0,1,30,30
1683707626118,PHYS 1BL,002,187070,Staff,4,0,30,26
1683707627144,PHYS 1C,A00,187082,Staff,30,0,120,90
1683707628175,PHYS 1CL,001,187088,Staff,0,9,30,30
1683707628175,PHYS 1CL,002,187089,Staff,0,1,30,30
1683707628175,PHYS 1CL,009,262693,Staff,9,0,30,21
1683707629205,PHYS 2B,A01,187097,Staff,55,0,115,60
1683707630235,PHYS 2C,A01,187099,Staff,63,0,115,52
1683707631260,PHYS 2CL,A01,187101,Staff,5,0,28,23
1683707631260,PHYS 2CL,A02,187102,Staff,15,0,28,13
1683707632291,PHYS 2D,A01,187123,Shotwell; Brian,95,0,115,20
1683707633321,PHYS 4B,A01,187133,Grinstein; Benjamin,35,0,50,15
1683707634346,POLI 10,A00,188819,Staff,0,4,50,50
1683707635373,POLI 11,A00,188827,Staff,43,0,50,7
1683707636457,POLI 13R,A00,188828,Staff,0,1,20,20
1683707637483,POLI 27,A01,188830,Elgin; Samuel Zincke,0,2,70,70
1683707638513,POLI 30,A00,188832,Desposato; Scott,30,0,50,20
1683707639537,POLI 102F,A00,188834,Staff,1,0,40,39
1683707640562,POLI 104A,A00,188852,Staff,12,0,30,18
1683707641591,POLI 104I,A00,188853,Staff,0,8,20,20
1683707642617,POLI 110B,A00,188854,Wiens; David,6,0,20,14
1683707643643,POLI 112A,A00,188855,Wiens; David,3,0,30,27
1683707644672,POLI 117R,A00,188856,Forman; Fonna,0,12,20,20
1683707645698,POLI 118,A00,188857,Ingham; Sean,8,0,20,12
1683707646724,POLI 120G,A00,188858,Staff,7,0,30,23
1683707647748,POLI 131CR,A00,188863,Hoston; Germaine,20,0,50,30
1683707648772,POLI 133,A00,188864,Nellis; Gareth Hb,44,0,50,6
1683707649797,POLI 134D,A00,188865,Desposato; Scott,27,0,30,3
1683707650822,POLI 142A,A00,188871,Gartzke; Erik,21,0,50,29
1683707651847,POLI 142K,A00,188874,Staff,38,0,50,12
1683707652872,POLI 143,A00,188940,Gartzke; Erik,15,0,30,15
1683707653898,POLI 153,A00,188943,Staff,1,0,20,19
1683707654922,POLI 160AA,A00,188944,Staff,10,0,40,30
1683707655950,POLI 170A,A00,188945,Staff,10,0,30,20
1683707658008,PSYC 1,A00,188952,Staff,36,0,90,54
1683707659036,PSYC 2,B00,188953,Staff,19,0,35,16
1683707660061,PSYC 6,A00,188970,Staff,47,0,60,13
1683707661089,PSYC 7,A00,188973,Staff,35,0,45,10
1683707662113,PSYC 60,A01,188980,Rickard; Timothy C.,42,0,60,18
1683707663142,PSYC 70,A01,189001,Steiner; Eric Tomas,22,0,45,23
1683707664167,PSYC 100,A00,189005,Lacefield; Katharine I,1,98,120,119
1683707665194,PSYC 102,A00,189008,Staff,6,0,30,24
1683707666221,PSYC 106,B00,189026,Gorman; Michael R.,27,0,60,33
1683707667247,PSYC 114,B01,189033,Winkielman; Piotr,0,31,30,30
1683707668272,PSYC 131,A00,189036,Anagnostaras; Stephan,0,44,60,60
1683707669297,PSYC 136,A00,189041,Lowe; Angela Beth,0,7,25,25
1683707670325,PSYC 137,A00,189057,Winkielman; Piotr,0,36,25,25
1683707671351,PSYC 144,A00,189107,Wixted; John T,0,11,50,50
1683707673400,PSYC 162,A00,189142,Staff,0,9,85,85
1683707674425,PSYC 172,A00,189144,Gorman; Michael R.,0,6,30,30
1683707676479,PSYC 179,A00,189146,Lacefield; Katharine I,0,88,120,120
1683707677504,PSYC 181,A00,189147,Anagnostaras; Stephan,0,45,90,90
1683707678528,PSYC 190R,A00,189148,Barner; David A.,0,23,80,80
1683707679553,PSYC 191,A00,189275,Rickard; Timothy C.,0,11,25,25
1683707680582,PSYC 193,A00,189276,Chapman; Eddie Nathaniel,0,1,0,4
1683707681610,PSYC 193L,A01,189281,Lowe; Angela Beth,8,0,20,12
1683707681610,PSYC 193L,B01,189285,Staff,28,0,35,7
1683707682635,RELI 149,A00,187137,Rahimi; Babak,6,0,40,34
1683707683661,SE 9,A01,187315,Staff,0,2,18,18
1683707684697,SE 101B,A00,187409,Staff,24,0,30,6
1683707685727,SE 110B,A00,187444,Staff,10,0,40,30
1683707686755,SE 130B,A00,187449,Staff,31,0,40,9
1683707687779,SE 150A,A00,187516,Staff,8,0,20,12
1683707688804,SE 154,A00,187528,Staff,29,0,50,21
1683707689829,SIO 3,A01,258171,Staff,35,0,40,5
1683707690857,SIO 10,A00,187144,Cook; Geoffrey W,0,6,75,75
1683707691881,SIO 45,A00,187152,Cook; Geoffrey W,1,7,100,99
1683707692909,SIO 109R,A00,194486,Staff,0,4,20,20
1683707694959,SIO 187,A01,187233,Kacev; David,12,0,40,28
1683707695984,SOCI 1,A01,258656,Thorpe; Charles Robert,28,0,30,2
1683707695984,SOCI 1,A02,258658,Thorpe; Charles Robert,30,0,30,0
1683707695984,SOCI 1,A03,258661,Thorpe; Charles Robert,25,0,25,0
1683707695984,SOCI 1,A04,258666,Thorpe; Charles Robert,22,0,25,3
1683707695984,SOCI 1,A05,258897,Thorpe; Charles Robert,22,0,25,3
1683707695984,SOCI 1,A06,258898,Thorpe; Charles Robert,25,0,25,0
1683707697010,SOCI 30,A01,258903,Pardo Guerra; Juan Pablo,14,0,30,16
1683707698035,SOCI 102,A00,258904,Staff,9,0,25,16
1683707699060,SOCI 106,A00,258905,Staff,19,0,25,6
1683707700086,SOCI 111,A00,258907,Ribas Norris; Janet Vanesa,26,0,30,4
1683707701113,SOCI 121R,A00,258908,Pardo Guerra; Juan Pablo,7,0,30,23
1683707702138,SOCI 126,A01,203330,Staff,14,0,20,6
1683707703166,SOCI 131,A00,258909,Thorpe; Charles Robert,30,0,60,30
1683707704194,SOCI 135,A00,258910,Payne; Christine Anna,0,13,30,30
1683707705217,SOCI 157,A00,258911,Staff,10,0,30,20
1683707706241,SOCI 184,A00,258912,Staff,25,0,30,5
1683707707266,SOCI 188D,A00,258913,Staff,22,0,30,8
1683707708297,SYN 2,001,187529,Staff,9,0,16,7
1683707708297,SYN 2,002,201452,Staff,0,20,16,16
1683707708297,SYN 2,003,201469,Staff,1,0,16,15
1683707709326,SYN 100,A01,187531,Staff,0,9,20,20
1683707709326,SYN 100,B01,201491,Staff,0,10,20,20
1683707710352,TDAC 1,A00,189286,Walsh; Kim C.,3,0,20,17
1683707710352,TDAC 1,B00,189287,Harting; Carla Kelso,10,0,20,10
1683707711379,TDAC 101,A00,189300,Walsh; Kim C.,16,0,20,4
1683707711379,TDAC 101,B00,189301,Harting; Carla Kelso,18,0,20,2
1683707712407,TDAC 102,A00,189304,Basso; Beatrice,14,0,20,6
1683707713433,TDAC 108,A00,189305,Staff,18,0,20,2
1683707714465,TDDE 131,A00,189310,Staff,19,0,20,1
1683707714465,TDDE 131,B00,189314,Staff,19,0,20,1
1683707714465,TDDE 131,C00,189315,Staff,48,0,50,2
1683707714465,TDDE 131,D00,189316,Staff,14,0,15,1
1683707714465,TDDE 131,E00,204841,Staff,20,0,20,0
1683707715495,TDGE 10,A00,189289,Staff,27,0,50,23
1683707715495,TDGE 10,B00,189290,Havis; Allan,0,1,50,50
1683707716524,TDGE 11,A00,189291,Fulton; Julia,0,4,50,50
1683707716524,TDGE 11,B00,189292,Staff,20,0,25,5
1683707716524,TDGE 11,C00,260270,Staff,0,0,0,0
1683707717547,TDGE 25,A00,189294,Staff,1,0,20,19
1683707718572,TDGE 124,A00,189318,Fulton; Julia,0,7,50,50
1683707719595,TDGE 125,A00,189319,Staff,13,0,25,12
1683707719595,TDGE 125,B00,189320,Staff,23,0,25,2
1683707720621,TDGE 127,A00,189322,Havis; Allan,1,0,50,49
1683707721651,TDHT 101,A00,189323,Staff,18,0,25,7
1683707721651,TDHT 101,B00,189324,Staff,25,0,25,0
1683707722678,TDHT 102,A00,189325,Staff,49,0,50,1
1683707723708,TDMV 1,A00,189295,Arcidiacono; Kristin,20,0,30,10
1683707723708,TDMV 1,B00,189296,Caligagan; Maria T.,23,0,30,7
1683707724738,TDMV 2,A00,189297,Sammartano; Tonnie,27,0,30,3
1683707724738,TDMV 2,B00,189299,Arcidiacono; Kristin,23,0,30,7
1683707725769,TDMV 3,A00,204998,Rincon; Alicia,22,0,30,8
1683707726797,TDMV 120,A00,189458,Sammartano; Tonnie,28,0,30,2
1683707727827,TDMV 138,A00,189541,Jun; Grace Shin Hae,20,0,40,20
1683707728856,TDMV 142,A00,189717,Caligagan; Tony,25,0,30,5
1683707728856,TDMV 142,B00,189718,Caligagan; Maria T.,25,0,30,5
1683707729886,TMC 2,A01,187533,Staff,25,0,25,0
1683707729886,TMC 2,A02,187534,Staff,25,0,25,0
1683707730912,USP 1,A01,187536,Kwak; Nancy,0,16,25,25
1683707731939,USP 5,A01,187538,Staff,8,0,25,17
1683707732964,USP 101,A00,199253,Staff,0,4,0,0
1683707733990,USP 124,A00,187562,Boomhower; Matthew Charles,0,0,30,30
1683707735013,USP 138,A00,187582,Staff,19,0,25,6
1683707736042,USP 152,A01,187597,Staff,3,0,25,22
1683707737067,USP 153,A00,187598,Staff,18,0,25,7
1683707738093,USP 168,A00,187607,Kwak; Nancy,2,0,5,3
1683707739117,USP 173,A00,187619,Staff,4,0,25,21
1683707740198,USP 181,A00,187638,Staff,0,4,25,25
1683707741223,VIS 103,A00,187650,Cruz; Edwin Teddy,17,0,75,58
1683707742250,VIS 110D,A00,187669,Staff,13,0,22,9
1683707743279,VIS 127C,A00,187720,Shen; Kuiyi,67,0,146,79
1683707744305,VIS 149,A00,187731,Yoldas; Pinar,0,12,22,22
1683707745329,VIS 151,A01,188091,Staff,22,0,34,12
1683707745329,VIS 151,A02,188092,Staff,11,0,34,23
1683707746358,VIS 160B,A00,188093,Stalbaum; Brett,0,1,10,10
1683707748408,WCWP 10B,A00,201720,Staff,0,0,5,5
1683707748408,WCWP 10B,B00,201722,Staff,0,0,6,6
1683707749437,WCWP 100,A00,201725,Gagnon; Jeffrey C,0,0,2,2
1683707749437,WCWP 100,B00,201727,Staff,0,4,15,15
1683707752592,ANBI 133,A00,258401,Wilder; Linnea Lorene,34,0,40,6
1683707753618,ANBI 140,A00,258395,Hrvoj Mihic; Branka,18,0,25,7
1683707754649,ANSC 120,A00,258402,Bialecki; Jon Anthony,26,0,40,14
1683707755677,ANSC 144,A00,258400,Staff,12,0,40,28
1683707757737,ANSC 166,A00,258396,Parish; Steven Martin,156,0,175,19
1683707758765,ANSC 180,A00,193533,Staff,8,0,20,12
1683707759791,ANSC 188,A00,258397,Jassal; Aftab,34,0,40,6
1683707760816,ANTH 3,A01,258316,Staff,23,0,30,7
1683707761843,ANTH 5,A00,258394,Semendeferi; Ekaterini,16,0,20,4
1683707762881,ANTH 21,A01,258331,Staff,4,0,40,36
1683707763906,ANTH 103,A00,258398,Varma; Saiba,15,0,25,10
1683707764949,AWP 10,001,202034,Staff,0,0,0,0
1683707764949,AWP 10,002,202035,Staff,0,0,0,0
1683707764949,AWP 10,003,202036,Staff,0,0,0,0
1683707764949,AWP 10,004,202037,Staff,0,0,0,0
1683707764949,AWP 10,005,202038,Staff,0,0,0,0
1683707764949,AWP 10,006,202039,Staff,0,0,0,0
1683707764949,AWP 10,007,202040,Staff,0,0,0,0
1683707764949,AWP 10,008,202041,Staff,0,0,0,0
1683707764949,AWP 10,009,202042,Staff,0,0,0,0
1683707764949,AWP 10,010,202043,Staff,0,0,0,0
1683707764949,AWP 10,011,202044,Staff,0,0,0,0
1683707764949,AWP 10,012,202045,Staff,0,0,0,0
1683707764949,AWP 10,013,202046,Staff,0,0,0,0
1683707764949,AWP 10,014,202047,Staff,0,0,0,0
1683707764949,AWP 10,015,202048,Staff,0,0,0,0
1683707764949,AWP 10,016,202049,Staff,0,0,0,0
1683707764949,AWP 10,017,202050,Staff,0,0,0,0
1683707764949,AWP 10,018,202051,Staff,0,0,0,0
1683707764949,AWP 10,019,202052,Staff,0,0,0,0
1683707764949,AWP 10,020,202053,Staff,0,0,0,0
1683707764949,AWP 10,021,202054,Staff,0,0,0,0
1683707764949,AWP 10,022,202055,Staff,0,0,0,0
1683707764949,AWP 10,023,202056,Staff,0,0,0,0
1683707764949,AWP 10,024,202057,Staff,0,0,0,0
1683707764949,AWP 10,025,202058,Staff,0,0,0,0
1683707764949,AWP 10,026,202059,Staff,0,0,0,0
1683707765974,AWP 102,001,202032,Staff,0,0,0,0
1683707765974,AWP 102,002,202033,Staff,0,0,0,0
1683707767000,BENG 100,A01,254234,Taylor Amos; Alyssa C,31,0,40,9
1683707768027,BENG 196,001,270013,Engler; Adam J.,9999,0,9999,0
1683707769060,BICD 100R,A01,202018,Smith; Laurie,0,7,32,32
1683707769060,BICD 100R,A02,202019,Smith; Laurie,0,3,32,32
1683707769060,BICD 100R,A03,202020,Smith; Laurie,0,1,32,32
1683707769060,BICD 100R,A04,202021,Smith; Laurie,6,0,32,26
1683707769060,BICD 100R,A05,202022,Smith; Laurie,10,0,32,22
1683707770090,BICD 136,A01,193242,Gustafson-Brown; Cindy,0,2,32,32
1683707770090,BICD 136,A02,193244,Gustafson-Brown; Cindy,13,0,32,19
1683707771117,BIEB 102,A01,193249,Butler; Shannon Rhey,0,0,32,32
1683707771117,BIEB 102,A02,193251,Butler; Shannon Rhey,0,0,32,32
1683707771117,BIEB 102,A03,193253,Butler; Shannon Rhey,0,0,32,32
1683707771117,BIEB 102,A04,193255,Butler; Shannon Rhey,13,0,32,19
1683707771117,BIEB 102,A05,193265,Butler; Shannon Rhey,25,0,32,7
1683707771117,BIEB 102,A06,193269,Butler; Shannon Rhey,12,0,32,20
1683707773166,BIEB 150,A01,193274,Staff,0,0,32,32
1683707773166,BIEB 150,A02,193285,Staff,24,0,32,8
1683707774195,BIEB 194,A00,193286,Kurle; Carolyn M.,19,0,32,13
1683707775226,BILD 1,A01,192291,Staff,15,0,32,17
1683707775226,BILD 1,A02,192292,Staff,30,0,32,2
1683707775226,BILD 1,B01,192520,Reuther; Keefe,0,1,0,0
1683707775226,BILD 1,B02,192532,Reuther; Keefe,0,1,0,0
1683707776256,BILD 3,A01,192556,Butler; Shannon Rhey,0,0,32,32
1683707776256,BILD 3,A02,192581,Butler; Shannon Rhey,0,1,32,32
1683707776256,BILD 3,A03,192611,Butler; Shannon Rhey,19,0,32,13
1683707776256,BILD 3,A04,192612,Butler; Shannon Rhey,23,0,32,9
1683707776256,BILD 3,A05,192613,Butler; Shannon Rhey,26,0,32,6
1683707776256,BILD 3,A06,192679,Butler; Shannon Rhey,27,0,32,5
1683707776256,BILD 3,A07,192682,Butler; Shannon Rhey,20,0,32,12
1683707777283,BILD 4,A01,192836,Reuther; Keefe,1,0,24,23
1683707777283,BILD 4,A02,193044,Reuther; Keefe,4,0,24,20
1683707778313,BILD 10,A01,193142,Gustafson-Brown; Cindy,29,0,32,3
1683707778313,BILD 10,A02,193149,Gustafson-Brown; Cindy,31,0,32,1
1683707779339,BIMM 100,A01,193301,Staff,0,6,32,32
1683707779339,BIMM 100,A02,193312,Staff,0,7,32,32
1683707779339,BIMM 100,A03,193323,Staff,0,10,32,32
1683707780365,BIMM 101,A01,193329,McDonnell; Lisa Marie,0,3,24,24
1683707780365,BIMM 101,A02,193339,McDonnell; Lisa Marie,0,3,24,24
1683707780365,BIMM 101,B01,193354,McDonnell; Lisa Marie,0,4,24,24
1683707780365,BIMM 101,B02,193357,McDonnell; Lisa Marie,0,3,24,24
1683707781392,BIMM 110,A01,193377,Tat; John,0,11,32,32
1683707781392,BIMM 110,A02,193378,Tat; John,0,11,32,32
1683707782418,BIMM 120,A01,206116,Staff,0,0,32,32
1683707782418,BIMM 120,A02,206117,Staff,7,0,32,25
1683707782418,BIMM 120,A03,206121,Staff,21,0,32,11
1683707783449,BIPN 100,A01,193393,Park; Ji Young,0,15,32,32
1683707783449,BIPN 100,A02,193402,Park; Ji Young,0,14,32,32
1683707783449,BIPN 100,A03,193413,Park; Ji Young,0,14,32,32
1683707783449,BIPN 100,A04,193414,Park; Ji Young,0,13,32,32
1683707784478,BIPN 102,A01,193429,Staff,0,0,32,32
1683707784478,BIPN 102,A02,193438,Staff,18,0,32,14
1683707785508,BIPN 106,A01,193450,Reyes Gonzalez; Catalina,0,2,40,40
1683707786535,BIPN 134,A01,193465,Cooke; James Edward,0,0,32,32
1683707786535,BIPN 134,A02,193474,Cooke; James Edward,25,0,32,7
1683707786535,BIPN 134,A03,193485,Cooke; James Edward,29,0,32,3
1683707786535,BIPN 134,A04,193486,Cooke; James Edward,20,0,32,12
1683707786535,BIPN 134,A05,193491,Cooke; James Edward,31,0,32,1
1683707786535,BIPN 134,A06,193501,Cooke; James Edward,30,0,32,2
1683707786535,BIPN 134,A07,193510,Cooke; James Edward,29,0,32,3
1683707788595,BISP 194,A00,222522,Staff,14,0,32,18
1683707789620,CAT 124,A01,202407,Staff,19,0,25,6
1683707790644,CAT 125,A00,202408,Marchisotto; Jennifer Anne,2,0,20,18
1683707791668,CAT 125R,A00,202409,Smith; Lauryn Alissa,0,11,20,20
1683707791668,CAT 125R,B00,202410,Morales; Celeste Georgianna,0,11,20,20
1683707791668,CAT 125R,C00,202411,Irwin; Matthew Joseph,0,12,20,20
1683707792695,CENG 15,A01,204712,Yang; Kesong,0,1,0,0
1683707793721,CENG 114,A00,202070,Jahed Motlagh; Zeinab,5,0,20,15
1683707794747,CGS 105,A00,185477,Wesling; Megan E.,24,0,40,16
1683707795771,CGS 106,A00,185494,Staff,11,0,22,11
1683707796797,CGS 108,A00,185495,Staff,14,0,20,6
1683707797826,CGS 114,A00,185496,Staff,13,0,18,5
1683707798851,CGS 119,A00,185501,Staff,15,0,20,5
1683707799876,CGS 120,A00,185511,Staff,11,0,20,9
1683707800908,CHEM 4,A01,184675,Bussey; Thomas J,97,0,100,3
1683707801933,CHEM 6A,A01,184677,Staff,32,0,60,28
1683707802958,CHEM 6B,A01,184679,Staff,63,0,100,37
1683707803987,CHEM 6C,A01,184681,Bussey; Thomas J,0,0,50,50
1683707803987,CHEM 6C,A02,184682,Bussey; Thomas J,32,0,50,18
1683707805014,CHEM 40A,A01,184684,Albizati; Kim F.,33,0,100,67
1683707806039,CHEM 40B,A01,184686,Albizati; Kim F.,0,22,100,100
1683707807069,CHEM 41B,A01,184690,Staff,51,0,100,49
1683707808098,COGS 3,A01,184715,Boyle; Mary E. T.,0,27,40,40
1683707809123,COGS 14B,A01,185172,Staff,0,14,38,38
1683707810149,COGS 18,A01,184736,Staff,14,0,80,66
1683707811179,COGS 100,A01,184932,Staff,0,8,73,73
1683707812203,COGS 101A,A01,184935,Staff,0,40,30,30
1683707813229,COGS 101B,A01,184944,Staff,0,2,30,30
1683707814257,COGS 101C,A01,184946,Staff,0,10,30,30
1683707815287,COGS 102A,A01,184951,Johnson; Christine M.,1,0,40,39
1683707816313,COGS 107B,A01,184953,Mooshagian; Eric Frederick,0,52,40,40
1683707817339,COGS 118B,A01,184959,Gupta; Anjum,0,50,40,40
1683707818362,COGS 153,A00,184961,Staff,1,16,30,29
1683707819387,COGS 177,A00,184962,Staff,0,20,30,30
1683707820412,COGS 187A,A01,184969,Boyle; Mary E. T.,0,19,40,40
1683707821444,COMM 10,A01,185174,Staff,0,5,25,25
1683707821444,COMM 10,A02,185189,Staff,0,2,25,25
1683707821444,COMM 10,A03,269821,Staff,0,1,0,0
1683707822470,COMM 100B,A02,185476,Staff,10,0,25,15
1683707822470,COMM 100B,A03,277340,Staff,25,0,25,0
1683707823497,COMM 100C,A01,185314,Staff,2,0,25,23
1683707823497,COMM 100C,A02,185327,Staff,17,0,25,8
1683707824525,COMM 110M,A00,185349,Staff,0,0,40,40
1683707825550,COMM 113T,A00,185352,Staff,25,0,40,15
1683707826578,COMM 114I,A00,185353,Staff,31,0,40,9
1683707827605,COMM 131,A00,185354,Staff,17,0,30,13
1683707828636,CSE 8A,A50,185358,Cao; Yingjun,0,46,10,10
1683707829660,CSE 8B,A01,185362,Staff,0,48,50,50
1683707830685,CSE 11,A01,185416,Cao; Yingjun,0,91,10,10
1683707831716,CSE 20,A01,185445,Briones; Jor-el Thomas Caparas,3,0,25,22
1683707832741,CSE 21,A01,185447,Staff,9,0,50,41
1683707833769,CSE 101,A01,185451,Staff,0,13,50,50
1683707833769,CSE 101,B01,185453,Jones; Miles E,0,15,50,50
1683707835821,CSE 141,A01,185458,Eldon; John,16,0,100,84
1683707836846,CSE 141L,A01,185461,Eldon; John,8,0,100,92
1683707837874,CSE 142,A01,185463,Staff,34,0,60,26
1683707837874,CSE 142,B01,201355,Staff,0,7,60,60
1683707838906,CSE 142L,A01,185470,Staff,34,0,60,26
1683707838906,CSE 142L,B01,201417,Staff,0,6,60,60
1683707839931,CSE 190,A00,201433,Staff,32,0,49,17
1683707840958,DOC 1,A01,259136,Strom; Megan C.,7,0,15,8
1683707840958,DOC 1,A02,259137,Strom; Megan C.,15,0,15,0
1683707840958,DOC 1,A03,259138,Strom; Megan C.,14,0,15,1
1683707840958,DOC 1,A04,259139,Strom; Megan C.,14,0,15,1
1683707841986,DOC 100D,A00,259140,Pass; Natalye Joann,14,0,25,11
1683707843010,DSGN 1,A01,184749,Rill; Bryan,0,26,30,30
1683707844094,DSGN 100,A01,185168,Staff,0,2,25,25
1683707845121,ECE 5,A01,185626,Morris; Karcher William,0,12,0,0
1683707846146,ECE 101,A01,185628,Staff,14,0,70,56
1683707847179,ECE 107,A01,185635,Baghdadchi; Saharnaz,0,0,20,20
1683707847179,ECE 107,A02,185638,Baghdadchi; Saharnaz,1,0,20,19
1683707848202,ECE 148,A01,185647,Silberman; Jack,0,0,16,16
1683707849234,ECON 1,A01,185537,Crane; Meredith Helen,54,0,70,16
1683707850259,ECON 3,A01,185549,Crane; Meredith Helen,30,0,70,40
1683707851285,ECON 4,A01,203354,Anderson; John Charles,0,5,10,10
1683707852316,ECON 100A,A01,185574,Staff,0,5,40,40
1683707853343,ECON 100B,A01,185576,Staff,0,12,50,50
1683707854370,ECON 100C,A01,185589,Newhouse; Herbert S,30,0,70,40
1683707855399,ECON 105,A00,185608,Vespa; Emanuel Ignacio,19,0,35,16
1683707856425,ECON 109,A01,185610,Shishkin; Denis,9,0,35,26
1683707857450,ECON 110A,A01,185612,Staff,8,0,40,32
1683707858477,ECON 120A,A01,185615,Staff,19,0,40,21
1683707859502,ECON 120C,A01,185617,Sun; Yixiao,0,21,70,70
1683707860532,ECON 144,A00,203346,Squires; Dale E,2,0,35,33
1683707861558,ECON 171,A01,203349,Newhouse; Herbert S,0,1,35,35
1683707862586,ECON 173A,A01,185621,Toda; Alexis Akira,21,0,35,14
1683707863619,EDS 25,A01,202413,Staff,0,1,0,0
1683707863619,EDS 25,A02,202414,Staff,0,1,0,0
1683707863619,EDS 25,A03,202415,Staff,0,0,0,0
1683707863619,EDS 25,A04,202416,Staff,0,1,0,0
1683707863619,EDS 25,A05,202439,Staff,0,0,0,0
1683707863619,EDS 25,A06,202440,Staff,0,0,0,0
1683707863619,EDS 25,B01,202631,Staff,0,0,0,0
1683707863619,EDS 25,B02,202632,Staff,0,0,0,0
1683707863619,EDS 25,B03,202639,Staff,0,0,0,0
1683707863619,EDS 25,B04,202640,Staff,0,0,0,0
1683707863619,EDS 25,B05,202643,Staff,0,0,0,0
1683707863619,EDS 25,B06,202644,Staff,0,0,0,0
1683707864651,EDS 38,A01,202659,Black; Alison Michelle,25,0,25,0
1683707865678,EDS 115,A00,202652,Staff,18,0,30,12
1683707866703,EDS 125,A00,202649,Staff,13,0,30,17
1683707867729,EDS 126,A01,203332,Staff,30,0,30,0
1683707868753,EDS 139,A00,202838,Staff,16,0,25,9
1683707869778,EDS 146,A01,202655,Staff,14,0,25,11
1683707870807,ENG 15,A00,185667,Staff,0,1,0,0
1683707870807,ENG 15,B00,185672,Staff,0,0,0,0
1683707870807,ENG 15,C00,185675,Staff,0,0,0,0
1683707870807,ENG 15,D00,185682,Staff,0,0,0,0
1683707870807,ENG 15,E00,185684,Staff,0,0,0,0
1683707871832,ETHN 103,A00,185710,Staff,0,8,35,35
1683707872860,ETHN 103A,A00,199228,Man; Simeon S,0,0,9,9
1683707873886,ETHN 109,A00,185711,Staff,15,0,35,20
1683707874911,ETHN 142,A00,185726,Staff,0,4,30,30
1683707875940,ETHN 163J,A00,199229,Man; Simeon S,5,0,8,3
1683707876970,ETHN 168,A00,185727,Staff,7,0,10,3
1683707877999,ETHN 182,A00,185728,Staff,0,0,35,35
1683707879039,ETHN 183,A00,185737,Staff,9,0,18,9
1683707880066,GLBH 111,A01,209361,Burgos; Jose L.,0,0,0,0
1683707882124,HIEU 104,A00,185792,Staff,14,0,20,6
1683707883149,HIEU 115,A00,185800,Staff,0,0,20,20
1683707884174,HIEU 128,A00,185801,Staff,0,9,20,20
1683707885204,HIEU 147,A00,185802,Staff,15,0,20,5
1683707886229,HIEU 154,A00,185823,Staff,11,0,20,9
1683707887256,HILA 102,A00,185826,Staff,14,0,20,6
1683707888283,HILD 2C,A01,185778,Staff,0,13,20,20
1683707889309,HILD 7B,A01,185780,Kwak; Nancy,0,17,32,32
1683707889309,HILD 7B,A02,185781,Kwak; Nancy,0,18,32,32
1683707890335,HILD 30,A01,185791,Staff,12,0,20,8
1683707891364,HISC 119,A00,185830,Golan; Tal,0,10,20,20
1683707892393,HITO 156GS,A00,185831,Patterson; Patrick H.,0,0,0,23
1683707893417,HIUS 103,A00,185832,Man; Simeon S,0,4,20,20
1683707894445,HIUS 117,A00,185836,Kwak; Nancy,2,0,20,18
1683707895473,HIUS 125,A00,185840,Man; Simeon S,0,2,23,23
1683707896498,HIUS 149,A00,185845,Staff,1,0,20,19
1683707897524,HUM 3,A01,185882,Zavodny; Tatiana Sophia,0,8,50,50
1683707897524,HUM 3,B01,185899,Caldwell; Michael Alan,0,18,50,50
1683707898553,HUM 3GS,A00,185900,Patterson; Patrick H.,0,0,0,23
1683707899581,HUM 4,A01,185938,Zroka; Amy Liane,28,0,50,22
1683707899581,HUM 4,B01,185956,Watkins; Eric,0,6,50,50
1683707899581,HUM 4,B02,202209,Watkins; Eric,0,5,50,50
1683707899581,HUM 4,B03,202210,Watkins; Eric,0,5,50,50
1683707900605,HUM 5,A01,185958,West; Geoffrey Scott,0,0,50,50
1683707900605,HUM 5,A02,202215,West; Geoffrey Scott,0,1,50,50
1683707901629,INTL 190,A00,185959,Gagnon; Jeffrey C,0,0,0,9
1683707901629,INTL 190,B00,185960,Lettieri; Michael Joseph,0,0,0,2
1683707902658,JAPN 180,A00,254509,Staff,5,0,30,25
1683707903690,LATI 10,A01,202853,Kennemore; Amy Michelle,4,0,35,31
1683707903690,LATI 10,A02,202854,Kennemore; Amy Michelle,3,0,35,32
1683707903690,LATI 10,A03,270054,Kennemore; Amy Michelle,30,0,30,0
1683707904715,LATI 180,A00,202855,Kennemore; Amy Michelle,11,0,20,9
1683707905739,LAWS 101,A00,201767,Golan; Tal,0,7,40,40
1683707906766,LIFR 1C,A00,185961,Staff,6,0,20,14
1683707907793,LIFR 1CX,A00,185962,Staff,7,0,20,13
1683707908823,LIFR 1D,A00,185963,Staff,7,0,20,13
1683707909847,LIFR 1DX,A00,185964,Staff,7,0,20,13
1683707910874,LIGN 101,A01,186039,Staff,43,0,50,7
1683707911901,LIGN 165,A00,186040,Staff,14,0,50,36
1683707912924,LTCS 108,A00,186041,Staff,5,0,10,5
1683707913951,LTCS 119,A00,186042,Staff,15,0,20,5
1683707914980,LTCS 130,A00,186043,Wesling; Megan E.,15,0,25,10
1683707917031,LTEA 138,A00,186119,Staff,14,0,40,26
1683707918060,LTEN 124,A00,186148,Staff,5,0,25,20
1683707919089,LTEN 178,A00,186149,Staff,6,0,15,9
1683707920115,LTEN 181,A00,186150,Blanco; John D,34,0,40,6
1683707921139,LTWL 120,A00,186160,Staff,19,0,25,6
1683707922166,LTWL 165,A00,186161,Staff,22,0,25,3
1683707923189,LTWR 100,A00,186162,Staff,0,5,15,15
1683707924213,LTWR 102,A00,186163,Doller; Ben,5,0,15,10
1683707925239,MAE 8,A01,186412,Staff,0,1,0,0
1683707926267,MAE 30B,A00,186445,Bahadori; Mohammad Yousef,81,0,100,19
1683707927293,MAE 40,A00,186592,Bewley; Thomas R,10,0,50,40
1683707928322,MAE 101B,A00,186593,Bahadori; Mohammad Yousef,80,0,100,20
1683707929350,MAE 105,A00,186594,Bandaru; Prabhakar,10,0,50,40
1683707930375,MAE 107,A00,186599,Pham; Hieu Tan,0,8,120,120
1683707931406,MAE 148,A01,186660,Silberman; Jack,3,0,16,13
1683707932431,MATH 10A,A01,188095,Staff,0,6,35,35
1683707933457,MATH 10B,A01,188097,Bowers; Adam R.,0,12,30,30
1683707933457,MATH 10B,A02,188099,Bowers; Adam R.,0,11,30,30
1683707933457,MATH 10B,B01,188104,Bowers; Adam R.,0,10,30,30
1683707933457,MATH 10B,B02,188106,Bowers; Adam R.,0,9,30,30
1683707934487,MATH 10C,A01,188111,Staff,0,20,30,30
1683707934487,MATH 10C,A02,188127,Staff,0,19,30,30
1683707934487,MATH 10C,A03,188131,Staff,0,19,30,30
1683707934487,MATH 10C,B01,188218,Staff,17,0,30,13
1683707934487,MATH 10C,B02,188244,Staff,13,0,30,17
1683707934487,MATH 10C,B03,188277,Staff,14,0,30,16
1683707935513,MATH 18,A01,188344,Bach; Quang Tran,18,0,30,12
1683707935513,MATH 18,A02,188345,Bach; Quang Tran,11,0,30,19
1683707935513,MATH 18,B01,188353,Bach; Quang Tran,11,0,30,19
1683707935513,MATH 18,B02,188354,Bach; Quang Tran,19,0,30,11
1683707936538,MATH 20A,A01,188374,Staff,11,0,35,24
1683707937570,MATH 20B,A01,188382,Ohm; Ko Woon,7,0,30,23
1683707937570,MATH 20B,A02,188383,Ohm; Ko Woon,22,0,30,8
1683707937570,MATH 20B,B01,188385,Ohm; Ko Woon,7,0,30,23
1683707937570,MATH 20B,B02,188392,Ohm; Ko Woon,22,0,30,8
1683707938597,MATH 20C,A01,188394,Harel; Guershon,10,0,30,20
1683707938597,MATH 20C,A02,188395,Harel; Guershon,13,0,30,17
1683707938597,MATH 20C,B01,188404,Harel; Guershon,5,0,30,25
1683707938597,MATH 20C,B02,188405,Harel; Guershon,18,0,30,12
1683707939628,MATH 20D,A01,188414,Hammock; Frances H,0,1,30,30
1683707939628,MATH 20D,A02,188415,Hammock; Frances H,0,1,30,30
1683707939628,MATH 20D,B01,188447,Hammock; Frances H,0,1,30,30
1683707939628,MATH 20D,B02,188486,Hammock; Frances H,2,0,30,28
1683707940656,MATH 20E,A01,188649,Staff,21,0,30,9
1683707940656,MATH 20E,A02,188650,Staff,20,0,30,10
1683707940656,MATH 20E,A03,188673,Staff,0,0,30,30
1683707941681,MATH 102,A01,188675,Staff,0,40,35,35
1683707942707,MATH 103B,A01,188681,Staff,3,0,35,32
1683707942707,MATH 103B,B01,188692,Staff,5,0,35,30
1683707943738,MATH 109,A01,188695,Salehi Golsefidy; Alireza,24,0,35,11
1683707943738,MATH 109,A02,188696,Salehi Golsefidy; Alireza,25,0,35,10
1683707944763,MATH 120A,A01,188698,Eggers; John Dietrich,7,0,35,28
1683707945789,MATH 142B,A01,188736,Ioana; Adrian,0,0,30,30
1683707945789,MATH 142B,A02,188741,Ioana; Adrian,0,1,30,30
1683707945789,MATH 142B,A03,188743,Ioana; Adrian,0,2,30,30
1683707946817,MATH 168A,A01,188790,Staff,0,11,35,35
1683707947907,MATH 170A,A01,188803,Nie; Jiawang,0,2,35,35
1683707947907,MATH 170A,A02,188811,Nie; Jiawang,0,1,35,35
1683707947907,MATH 170A,A03,188814,Nie; Jiawang,0,0,35,35
1683707947907,MATH 170A,A04,188815,Nie; Jiawang,5,0,35,30
1683707948937,MATH 193B,A01,188817,Staff,0,0,35,35
1683707948937,MATH 193B,A02,188818,Staff,6,0,35,29
1683707949961,MGT 4,A01,202857,Anderson; John Charles,59,0,80,21
1683707950990,MGT 12,A00,202858,Lindenberger; Wade Douglas,40,0,90,50
1683707952014,MGT 18,A00,202859,Staff,73,0,90,17
1683707953041,MGT 18GS,A00,202860,McKay; Michael J,13,0,28,15
1683707954066,MGT 45,A00,202861,Pecore; Joseph P.,8,0,90,82
1683707955096,MGT 100,A00,202863,Yavorsky; Daniel Ryan,27,0,90,63
1683707956124,MGT 103,A00,202864,Ehrich; Kristine R,0,19,90,90
1683707957153,MGT 112,A00,202865,Ehrich; Kristine R,15,0,90,75
1683707958179,MGT 121A,A00,202868,Staff,70,0,90,20
1683707959205,MGT 131B,A00,202869,Anderson; John Charles,58,0,90,32
1683707960230,MGT 136,A00,202871,Lindenberger; Wade Douglas,83,0,90,7
1683707961259,MGT 164,A00,202873,Staff,0,67,90,91
1683707962287,MGT 164GS,A00,202874,McKay; Mary A,13,0,28,15
1683707963317,MGT 180,A00,202875,Staff,0,51,90,91
1683707964345,MMW 11R,A01,205019,Herbst; Matthew,0,0,30,30
1683707964345,MMW 11R,A02,205026,Herbst; Matthew,29,0,30,1
1683707965372,MMW 15,A01,193512,Chang; Edmond Yi-Teh,0,8,28,28
1683707965372,MMW 15,A02,193513,Chang; Edmond Yi-Teh,0,5,28,28
1683707965372,MMW 15,A03,193514,Chang; Edmond Yi-Teh,0,5,28,28
1683707965372,MMW 15,A04,193515,Chang; Edmond Yi-Teh,0,5,28,28
1683707965372,MMW 15,A05,193516,Chang; Edmond Yi-Teh,0,5,28,28
1683707965372,MMW 15,A06,193517,Chang; Edmond Yi-Teh,0,6,28,28
1683707965372,MMW 15,B01,193519,Chang; Edmond Yi-Teh,0,5,28,28
1683707965372,MMW 15,B02,193520,Chang; Edmond Yi-Teh,0,5,28,28
1683707965372,MMW 15,B03,193521,Chang; Edmond Yi-Teh,0,5,28,28
1683707965372,MMW 15,B04,193522,Chang; Edmond Yi-Teh,0,6,28,28
1683707965372,MMW 15,B05,193523,Chang; Edmond Yi-Teh,0,5,28,28
1683707965372,MMW 15,B06,193524,Chang; Edmond Yi-Teh,0,5,28,28
1683707966397,MMW 122,A01,193526,Rahimi; Babak,0,16,28,28
1683707966397,MMW 122,A02,193527,Rahimi; Babak,0,15,28,28
1683707966397,MMW 122,A03,193528,Rahimi; Babak,0,0,0,0
1683707966397,MMW 122,A04,193529,Rahimi; Babak,0,0,0,0
1683707967422,MUS 1A,A01,186663,Staff,0,18,35,35
1683707968446,MUS 4,A01,186715,Staff,0,12,35,35
1683707969471,MUS 5R,A01,186796,Dubnov; Shlomo,0,17,35,35
1683707970499,MUS 6,A01,186798,Staff,0,4,25,25
1683707971526,MUS 7,A01,186830,Staff,11,0,35,24
1683707972550,MUS 8,A01,186930,Staff,0,27,35,35
1683707973575,MUS 15,A01,186932,Staff,0,15,35,35
1683707973575,MUS 15,B01,186934,Staff,0,16,35,35
1683707974600,MUS 80,A00,186935,Staff,0,0,20,20
1683707974600,MUS 80,B00,186936,Staff,24,0,25,1
1683707975626,NANO 11,A00,204702,Lipomi; Darren John,0,0,0,0
1683707976651,NANO 15,A01,204709,Yang; Kesong,0,1,0,0
1683707977676,NANO 114,A00,202069,Jahed Motlagh; Zeinab,2,0,10,8
1683707978704,PHIL 1,A00,186955,Grush; Rick Scott,31,0,40,9
1683707979733,PHIL 10,A01,186973,Grush; Rick Scott,27,0,35,8
1683707979733,PHIL 10,A02,186974,Grush; Rick Scott,33,0,35,2
1683707980757,PHIL 13,A01,186976,Staff,1,0,35,34
1683707980757,PHIL 13,A02,186977,Staff,16,0,35,19
1683707981785,PHIL 14,A01,186979,Staff,30,0,35,5
1683707981785,PHIL 14,A02,186986,Staff,32,0,35,3
1683707982810,PHIL 28,A01,186988,Staff,16,0,30,14
1683707982810,PHIL 28,A02,186989,Staff,0,0,30,30
1683707982810,PHIL 28,A03,186990,Staff,10,0,30,20
1683707982810,PHIL 28,A04,186991,Staff,26,0,30,4
1683707983837,PHIL 120,A00,186997,Staff,23,0,40,17
1683707984866,PHIL 137,A00,187003,Staff,7,0,40,33
1683707985889,PHIL 150,A00,187015,Staff,47,0,70,23
1683707986919,PHIL 167,A00,187021,Lamey; Andy M.,34,0,40,6
1683707987943,PHIL 174,A01,202226,Staff,17,0,20,3
1683707987943,PHIL 174,A02,202235,Staff,20,0,20,0
1683707988969,PHIL 191A,A00,258918,Staff,0,0,1,1
1683707990001,PHYS 1A,A00,187028,Staff,26,0,60,34
1683707991027,PHYS 1AL,001,187036,Staff,3,0,30,27
1683707991027,PHYS 1AL,002,187049,Staff,18,0,30,12
1683707992054,PHYS 1B,A00,187058,Staff,21,0,60,39
1683707993079,PHYS 1BL,001,187064,Staff,0,1,30,30
1683707993079,PHYS 1BL,002,187070,Staff,4,0,30,26
1683707994104,PHYS 1C,A00,187082,Staff,30,0,120,90
1683707995130,PHYS 1CL,001,187088,Staff,0,9,30,30
1683707995130,PHYS 1CL,002,187089,Staff,0,1,30,30
1683707995130,PHYS 1CL,009,262693,Staff,9,0,30,21
1683707996154,PHYS 2B,A01,187097,Staff,55,0,115,60
1683707997178,PHYS 2C,A01,187099,Staff,63,0,115,52
1683707998203,PHYS 2CL,A01,187101,Staff,5,0,28,23
1683707998203,PHYS 2CL,A02,187102,Staff,15,0,28,13
1683707999232,PHYS 2D,A01,187123,Shotwell; Brian,95,0,115,20
1683708000261,PHYS 4B,A01,187133,Grinstein; Benjamin,35,0,50,15
1683708001287,POLI 10,A00,188819,Staff,0,4,50,50
1683708002319,POLI 11,A00,188827,Staff,43,0,50,7
1683708003343,POLI 13R,A00,188828,Staff,0,1,20,20
1683708004371,POLI 27,A01,188830,Elgin; Samuel Zincke,0,2,70,70
1683708005397,POLI 30,A00,188832,Desposato; Scott,30,0,50,20
1683708006424,POLI 102F,A00,188834,Staff,1,0,40,39
1683708007448,POLI 104A,A00,188852,Staff,12,0,30,18
1683708008473,POLI 104I,A00,188853,Staff,0,8,20,20
1683708009502,POLI 110B,A00,188854,Wiens; David,6,0,20,14
1683708010529,POLI 112A,A00,188855,Wiens; David,3,0,30,27
1683708011553,POLI 117R,A00,188856,Forman; Fonna,0,12,20,20
1683708012577,POLI 118,A00,188857,Ingham; Sean,8,0,20,12
1683708013602,POLI 120G,A00,188858,Staff,7,0,30,23
1683708014626,POLI 131CR,A00,188863,Hoston; Germaine,20,0,50,30
1683708015658,POLI 133,A00,188864,Nellis; Gareth Hb,44,0,50,6
1683708016682,POLI 134D,A00,188865,Desposato; Scott,27,0,30,3
1683708017708,POLI 142A,A00,188871,Gartzke; Erik,21,0,50,29
1683708018744,POLI 142K,A00,188874,Staff,38,0,50,12
1683708019769,POLI 143,A00,188940,Gartzke; Erik,15,0,30,15
1683708020794,POLI 153,A00,188943,Staff,1,0,20,19
1683708021818,POLI 160AA,A00,188944,Staff,10,0,40,30
1683708022843,POLI 170A,A00,188945,Staff,10,0,30,20
1683708024895,PSYC 1,A00,188952,Staff,36,0,90,54
1683708025919,PSYC 2,B00,188953,Staff,19,0,35,16
1683708026946,PSYC 6,A00,188970,Staff,47,0,60,13
1683708027973,PSYC 7,A00,188973,Staff,35,0,45,10
1683708028998,PSYC 60,A01,188980,Rickard; Timothy C.,42,0,60,18
1683708030024,PSYC 70,A01,189001,Steiner; Eric Tomas,22,0,45,23
1683708031055,PSYC 100,A00,189005,Lacefield; Katharine I,1,98,120,119
1683708032079,PSYC 102,A00,189008,Staff,6,0,30,24
1683708033103,PSYC 106,B00,189026,Gorman; Michael R.,27,0,60,33
1683708034129,PSYC 114,B01,189033,Winkielman; Piotr,0,31,30,30
1683708035153,PSYC 131,A00,189036,Anagnostaras; Stephan,0,44,60,60
1683708036180,PSYC 136,A00,189041,Lowe; Angela Beth,0,7,25,25
1683708037209,PSYC 137,A00,189057,Winkielman; Piotr,0,36,25,25
1683708038238,PSYC 144,A00,189107,Wixted; John T,0,11,50,50
1683708040286,PSYC 162,A00,189142,Staff,0,9,85,85
1683708041309,PSYC 172,A00,189144,Gorman; Michael R.,0,6,30,30
1683708043359,PSYC 179,A00,189146,Lacefield; Katharine I,0,88,120,120
1683708044384,PSYC 181,A00,189147,Anagnostaras; Stephan,0,45,90,90
1683708045413,PSYC 190R,A00,189148,Barner; David A.,0,23,80,80
1683708046442,PSYC 191,A00,189275,Rickard; Timothy C.,0,11,25,25
1683708047468,PSYC 193,A00,189276,Chapman; Eddie Nathaniel,0,1,0,4
1683708048493,PSYC 193L,A01,189281,Lowe; Angela Beth,8,0,20,12
1683708048493,PSYC 193L,B01,189285,Staff,28,0,35,7
1683708049518,RELI 149,A00,187137,Rahimi; Babak,6,0,40,34
1683708050547,SE 9,A01,187315,Staff,0,2,18,18
1683708051631,SE 101B,A00,187409,Staff,24,0,30,6
1683708052656,SE 110B,A00,187444,Staff,10,0,40,30
1683708053681,SE 130B,A00,187449,Staff,31,0,40,9
1683708054707,SE 150A,A00,187516,Staff,8,0,20,12
1683708055738,SE 154,A00,187528,Staff,29,0,50,21
1683708056764,SIO 3,A01,258171,Staff,35,0,40,5
1683708057793,SIO 10,A00,187144,Cook; Geoffrey W,0,6,75,75
1683708058821,SIO 45,A00,187152,Cook; Geoffrey W,1,7,100,99
1683708059847,SIO 109R,A00,194486,Staff,0,4,20,20
1683708061900,SIO 187,A01,187233,Kacev; David,12,0,40,28
1683708062931,SOCI 1,A01,258656,Thorpe; Charles Robert,28,0,30,2
1683708062931,SOCI 1,A02,258658,Thorpe; Charles Robert,30,0,30,0
1683708062931,SOCI 1,A03,258661,Thorpe; Charles Robert,25,0,25,0
1683708062931,SOCI 1,A04,258666,Thorpe; Charles Robert,22,0,25,3
1683708062931,SOCI 1,A05,258897,Thorpe; Charles Robert,22,0,25,3
1683708062931,SOCI 1,A06,258898,Thorpe; Charles Robert,25,0,25,0
1683708063957,SOCI 30,A01,258903,Pardo Guerra; Juan Pablo,14,0,30,16
1683708064983,SOCI 102,A00,258904,Staff,9,0,25,16
1683708066008,SOCI 106,A00,258905,Staff,19,0,25,6
1683708067034,SOCI 111,A00,258907,Ribas Norris; Janet Vanesa,26,0,30,4
1683708068059,SOCI 121R,A00,258908,Pardo Guerra; Juan Pablo,7,0,30,23
1683708069085,SOCI 126,A01,203330,Staff,14,0,20,6
1683708070110,SOCI 131,A00,258909,Thorpe; Charles Robert,30,0,60,30
1683708071139,SOCI 135,A00,258910,Payne; Christine Anna,0,13,30,30
1683708072168,SOCI 157,A00,258911,Staff,10,0,30,20
1683708073194,SOCI 184,A00,258912,Staff,25,0,30,5
1683708074222,SOCI 188D,A00,258913,Staff,22,0,30,8
1683708075247,SYN 2,001,187529,Staff,9,0,16,7
1683708075247,SYN 2,002,201452,Staff,0,20,16,16
1683708075247,SYN 2,003,201469,Staff,1,0,16,15
1683708076275,SYN 100,A01,187531,Staff,0,9,20,20
1683708076275,SYN 100,B01,201491,Staff,0,10,20,20
1683708077301,TDAC 1,A00,189286,Walsh; Kim C.,3,0,20,17
1683708077301,TDAC 1,B00,189287,Harting; Carla Kelso,10,0,20,10
1683708078327,TDAC 101,A00,189300,Walsh; Kim C.,16,0,20,4
1683708078327,TDAC 101,B00,189301,Harting; Carla Kelso,18,0,20,2
1683708079358,TDAC 102,A00,189304,Basso; Beatrice,14,0,20,6
1683708080382,TDAC 108,A00,189305,Staff,18,0,20,2
1683708081410,TDDE 131,A00,189310,Staff,19,0,20,1
1683708081410,TDDE 131,B00,189314,Staff,19,0,20,1
1683708081410,TDDE 131,C00,189315,Staff,48,0,50,2
1683708081410,TDDE 131,D00,189316,Staff,14,0,15,1
1683708081410,TDDE 131,E00,204841,Staff,20,0,20,0
1683708082439,TDGE 10,A00,189289,Staff,27,0,50,23
1683708082439,TDGE 10,B00,189290,Havis; Allan,0,1,50,50
1683708083466,TDGE 11,A00,189291,Fulton; Julia,0,4,50,50
1683708083466,TDGE 11,B00,189292,Staff,20,0,25,5
1683708083466,TDGE 11,C00,260270,Staff,0,0,0,0
1683708084490,TDGE 25,A00,189294,Staff,1,0,20,19
1683708085515,TDGE 124,A00,189318,Fulton; Julia,0,7,50,50
1683708086541,TDGE 125,A00,189319,Staff,13,0,25,12
1683708086541,TDGE 125,B00,189320,Staff,23,0,25,2
1683708087566,TDGE 127,A00,189322,Havis; Allan,1,0,50,49
1683708088595,TDHT 101,A00,189323,Staff,18,0,25,7
1683708088595,TDHT 101,B00,189324,Staff,25,0,25,0
1683708089621,TDHT 102,A00,189325,Staff,49,0,50,1
1683708090646,TDMV 1,A00,189295,Arcidiacono; Kristin,20,0,30,10
1683708090646,TDMV 1,B00,189296,Caligagan; Maria T.,23,0,30,7
1683708091671,TDMV 2,A00,189297,Sammartano; Tonnie,27,0,30,3
1683708091671,TDMV 2,B00,189299,Arcidiacono; Kristin,23,0,30,7
1683708092701,TDMV 3,A00,204998,Rincon; Alicia,22,0,30,8
1683708093728,TDMV 120,A00,189458,Sammartano; Tonnie,28,0,30,2
1683708094757,TDMV 138,A00,189541,Jun; Grace Shin Hae,20,0,40,20
1683708095783,TDMV 142,A00,189717,Caligagan; Tony,25,0,30,5
1683708095783,TDMV 142,B00,189718,Caligagan; Maria T.,25,0,30,5
1683708096808,TMC 2,A01,187533,Staff,25,0,25,0
1683708096808,TMC 2,A02,187534,Staff,25,0,25,0
1683708097839,USP 1,A01,187536,Kwak; Nancy,0,16,25,25
1683708098866,USP 5,A01,187538,Staff,8,0,25,17
1683708099895,USP 101,A00,199253,Staff,0,4,0,0
1683708100920,USP 124,A00,187562,Boomhower; Matthew Charles,0,0,30,30
1683708101950,USP 138,A00,187582,Staff,19,0,25,6
1683708102977,USP 152,A01,187597,Staff,3,0,25,22
1683708104004,USP 153,A00,187598,Staff,18,0,25,7
1683708105031,USP 168,A00,187607,Kwak; Nancy,2,0,5,3
1683708106057,USP 173,A00,187619,Staff,4,0,25,21
1683708107083,USP 181,A00,187638,Staff,0,4,25,25
1683708108108,VIS 103,A00,187650,Cruz; Edwin Teddy,17,0,75,58
1683708109133,VIS 110D,A00,187669,Staff,13,0,22,9
1683708110158,VIS 127C,A00,187720,Shen; Kuiyi,67,0,146,79
1683708111188,VIS 149,A00,187731,Yoldas; Pinar,0,12,22,22
1683708112217,VIS 151,A01,188091,Staff,22,0,34,12
1683708112217,VIS 151,A02,188092,Staff,11,0,34,23
1683708113242,VIS 160B,A00,188093,Stalbaum; Brett,0,1,10,10
1683708115294,WCWP 10B,A00,201720,Staff,0,0,5,5
1683708115294,WCWP 10B,B00,201722,Staff,0,0,6,6
1683708116325,WCWP 100,A00,201725,Gagnon; Jeffrey C,0,0,2,2
1683708116325,WCWP 100,B00,201727,Staff,0,4,15,15
1683708119522,ANBI 133,A00,258401,Wilder; Linnea Lorene,34,0,40,6
1683708120548,ANBI 140,A00,258395,Hrvoj Mihic; Branka,18,0,25,7
1683708121681,ANSC 120,A00,258402,Bialecki; Jon Anthony,26,0,40,14
1683708122706,ANSC 144,A00,258400,Staff,12,0,40,28
1683708124768,ANSC 166,A00,258396,Parish; Steven Martin,156,0,175,19
1683708125793,ANSC 180,A00,193533,Staff,8,0,20,12
1683708126823,ANSC 188,A00,258397,Jassal; Aftab,34,0,40,6
1683708127860,ANTH 3,A01,258316,Staff,23,0,30,7
1683708128887,ANTH 5,A00,258394,Semendeferi; Ekaterini,16,0,20,4
1683708129913,ANTH 21,A01,258331,Staff,4,0,40,36
1683708130938,ANTH 103,A00,258398,Varma; Saiba,15,0,25,10
1683708131968,AWP 10,001,202034,Staff,0,0,0,0
1683708131968,AWP 10,002,202035,Staff,0,0,0,0
1683708131968,AWP 10,003,202036,Staff,0,0,0,0
1683708131968,AWP 10,004,202037,Staff,0,0,0,0
1683708131968,AWP 10,005,202038,Staff,0,0,0,0
1683708131968,AWP 10,006,202039,Staff,0,0,0,0
1683708131968,AWP 10,007,202040,Staff,0,0,0,0
1683708131968,AWP 10,008,202041,Staff,0,0,0,0
1683708131968,AWP 10,009,202042,Staff,0,0,0,0
1683708131968,AWP 10,010,202043,Staff,0,0,0,0
1683708131968,AWP 10,011,202044,Staff,0,0,0,0
1683708131968,AWP 10,012,202045,Staff,0,0,0,0
1683708131968,AWP 10,013,202046,Staff,0,0,0,0
1683708131968,AWP 10,014,202047,Staff,0,0,0,0
1683708131968,AWP 10,015,202048,Staff,0,0,0,0
1683708131968,AWP 10,016,202049,Staff,0,0,0,0
1683708131968,AWP 10,017,202050,Staff,0,0,0,0
1683708131968,AWP 10,018,202051,Staff,0,0,0,0
1683708131968,AWP 10,019,202052,Staff,0,0,0,0
1683708131968,AWP 10,020,202053,Staff,0,0,0,0
1683708131968,AWP 10,021,202054,Staff,0,0,0,0
1683708131968,AWP 10,022,202055,Staff,0,0,0,0
1683708131968,AWP 10,023,202056,Staff,0,0,0,0
1683708131968,AWP 10,024,202057,Staff,0,0,0,0
1683708131968,AWP 10,025,202058,Staff,0,0,0,0
1683708131968,AWP 10,026,202059,Staff,0,0,0,0
1683708132993,AWP 102,001,202032,Staff,0,0,0,0
1683708132993,AWP 102,002,202033,Staff,0,0,0,0
1683708134024,BENG 100,A01,254234,Taylor Amos; Alyssa C,31,0,40,9
1683708135054,BENG 196,001,270013,Engler; Adam J.,9999,0,9999,0
1683708136081,BICD 100R,A01,202018,Smith; Laurie,0,7,32,32
1683708136081,BICD 100R,A02,202019,Smith; Laurie,0,3,32,32
1683708136081,BICD 100R,A03,202020,Smith; Laurie,0,1,32,32
1683708136081,BICD 100R,A04,202021,Smith; Laurie,6,0,32,26
1683708136081,BICD 100R,A05,202022,Smith; Laurie,10,0,32,22
1683708137109,BICD 136,A01,193242,Gustafson-Brown; Cindy,0,2,32,32
1683708137109,BICD 136,A02,193244,Gustafson-Brown; Cindy,13,0,32,19
1683708138139,BIEB 102,A01,193249,Butler; Shannon Rhey,0,0,32,32
1683708138139,BIEB 102,A02,193251,Butler; Shannon Rhey,0,0,32,32
1683708138139,BIEB 102,A03,193253,Butler; Shannon Rhey,0,0,32,32
1683708138139,BIEB 102,A04,193255,Butler; Shannon Rhey,13,0,32,19
1683708138139,BIEB 102,A05,193265,Butler; Shannon Rhey,25,0,32,7
1683708138139,BIEB 102,A06,193269,Butler; Shannon Rhey,12,0,32,20
1683708140193,BIEB 150,A01,193274,Staff,0,0,32,32
1683708140193,BIEB 150,A02,193285,Staff,24,0,32,8
1683708141219,BIEB 194,A00,193286,Kurle; Carolyn M.,19,0,32,13
1683708142247,BILD 1,A01,192291,Staff,15,0,32,17
1683708142247,BILD 1,A02,192292,Staff,30,0,32,2
1683708142247,BILD 1,B01,192520,Reuther; Keefe,0,1,0,0
1683708142247,BILD 1,B02,192532,Reuther; Keefe,0,1,0,0
1683708143281,BILD 3,A01,192556,Butler; Shannon Rhey,0,0,32,32
1683708143281,BILD 3,A02,192581,Butler; Shannon Rhey,0,1,32,32
1683708143281,BILD 3,A03,192611,Butler; Shannon Rhey,19,0,32,13
1683708143281,BILD 3,A04,192612,Butler; Shannon Rhey,23,0,32,9
1683708143281,BILD 3,A05,192613,Butler; Shannon Rhey,26,0,32,6
1683708143281,BILD 3,A06,192679,Butler; Shannon Rhey,27,0,32,5
1683708143281,BILD 3,A07,192682,Butler; Shannon Rhey,20,0,32,12
1683708144315,BILD 4,A01,192836,Reuther; Keefe,1,0,24,23
1683708144315,BILD 4,A02,193044,Reuther; Keefe,4,0,24,20
1683708145345,BILD 10,A01,193142,Gustafson-Brown; Cindy,29,0,32,3
1683708145345,BILD 10,A02,193149,Gustafson-Brown; Cindy,31,0,32,1
1683708146375,BIMM 100,A01,193301,Staff,0,6,32,32
1683708146375,BIMM 100,A02,193312,Staff,0,7,32,32
1683708146375,BIMM 100,A03,193323,Staff,0,10,32,32
1683708147409,BIMM 101,A01,193329,McDonnell; Lisa Marie,0,3,24,24
1683708147409,BIMM 101,A02,193339,McDonnell; Lisa Marie,0,3,24,24
1683708147409,BIMM 101,B01,193354,McDonnell; Lisa Marie,0,4,24,24
1683708147409,BIMM 101,B02,193357,McDonnell; Lisa Marie,0,3,24,24
1683708148438,BIMM 110,A01,193377,Tat; John,0,11,32,32
1683708148438,BIMM 110,A02,193378,Tat; John,0,11,32,32
1683708149466,BIMM 120,A01,206116,Staff,0,0,32,32
1683708149466,BIMM 120,A02,206117,Staff,7,0,32,25
1683708149466,BIMM 120,A03,206121,Staff,21,0,32,11
1683708150493,BIPN 100,A01,193393,Park; Ji Young,0,15,32,32
1683708150493,BIPN 100,A02,193402,Park; Ji Young,0,14,32,32
1683708150493,BIPN 100,A03,193413,Park; Ji Young,0,14,32,32
1683708150493,BIPN 100,A04,193414,Park; Ji Young,0,13,32,32
1683708151607,BIPN 102,A01,193429,Staff,0,0,32,32
1683708151607,BIPN 102,A02,193438,Staff,18,0,32,14
1683708152635,BIPN 106,A01,193450,Reyes Gonzalez; Catalina,0,2,40,40
1683708153661,BIPN 134,A01,193465,Cooke; James Edward,0,0,32,32
1683708153661,BIPN 134,A02,193474,Cooke; James Edward,25,0,32,7
1683708153661,BIPN 134,A03,193485,Cooke; James Edward,29,0,32,3
1683708153661,BIPN 134,A04,193486,Cooke; James Edward,20,0,32,12
1683708153661,BIPN 134,A05,193491,Cooke; James Edward,31,0,32,1
1683708153661,BIPN 134,A06,193501,Cooke; James Edward,30,0,32,2
1683708153661,BIPN 134,A07,193510,Cooke; James Edward,29,0,32,3
1683708155774,BISP 194,A00,222522,Staff,14,0,32,18
1683708156799,CAT 124,A01,202407,Staff,19,0,25,6
1683708157826,CAT 125,A00,202408,Marchisotto; Jennifer Anne,2,0,20,18
1683708158854,CAT 125R,A00,202409,Smith; Lauryn Alissa,0,11,20,20
1683708158854,CAT 125R,B00,202410,Morales; Celeste Georgianna,0,11,20,20
1683708158854,CAT 125R,C00,202411,Irwin; Matthew Joseph,0,12,20,20
1683708159887,CENG 15,A01,204712,Yang; Kesong,0,1,0,0
1683708160917,CENG 114,A00,202070,Jahed Motlagh; Zeinab,5,0,20,15
1683708161949,CGS 105,A00,185477,Wesling; Megan E.,24,0,40,16
1683708162975,CGS 106,A00,185494,Staff,11,0,22,11
1683708164000,CGS 108,A00,185495,Staff,14,0,20,6
1683708165025,CGS 114,A00,185496,Staff,13,0,18,5
1683708166058,CGS 119,A00,185501,Staff,15,0,20,5
1683708167087,CGS 120,A00,185511,Staff,11,0,20,9
1683708168117,CHEM 4,A01,184675,Bussey; Thomas J,97,0,100,3
1683708169149,CHEM 6A,A01,184677,Staff,32,0,60,28
1683708170177,CHEM 6B,A01,184679,Staff,63,0,100,37
1683708171206,CHEM 6C,A01,184681,Bussey; Thomas J,0,0,50,50
1683708171206,CHEM 6C,A02,184682,Bussey; Thomas J,32,0,50,18
1683708172232,CHEM 40A,A01,184684,Albizati; Kim F.,33,0,100,67
1683708173257,CHEM 40B,A01,184686,Albizati; Kim F.,0,22,100,100
1683708174295,CHEM 41B,A01,184690,Staff,51,0,100,49
1683708175323,COGS 3,A01,184715,Boyle; Mary E. T.,0,27,40,40
1683708176350,COGS 14B,A01,185172,Staff,0,14,38,38
1683708177377,COGS 18,A01,184736,Staff,14,0,80,66
1683708178431,COGS 100,A01,184932,Staff,0,8,73,73
1683708179457,COGS 101A,A01,184935,Staff,0,40,30,30
1683708180487,COGS 101B,A01,184944,Staff,0,2,30,30
1683708181518,COGS 101C,A01,184946,Staff,0,10,30,30
1683708182548,COGS 102A,A01,184951,Johnson; Christine M.,1,0,40,39
1683708183581,COGS 107B,A01,184953,Mooshagian; Eric Frederick,0,52,40,40
1683708184607,COGS 118B,A01,184959,Gupta; Anjum,0,50,40,40
1683708185633,COGS 153,A00,184961,Staff,1,16,30,29
1683708186659,COGS 177,A00,184962,Staff,0,20,30,30
1683708187685,COGS 187A,A01,184969,Boyle; Mary E. T.,0,19,40,40
1683708188717,COMM 10,A01,185174,Staff,0,5,25,25
1683708188717,COMM 10,A02,185189,Staff,0,2,25,25
1683708188717,COMM 10,A03,269821,Staff,0,1,0,0
1683708189744,COMM 100B,A02,185476,Staff,10,0,25,15
1683708189744,COMM 100B,A03,277340,Staff,25,0,25,0
1683708190771,COMM 100C,A01,185314,Staff,2,0,25,23
1683708190771,COMM 100C,A02,185327,Staff,17,0,25,8
1683708191800,COMM 110M,A00,185349,Staff,0,0,40,40
1683708192826,COMM 113T,A00,185352,Staff,25,0,40,15
1683708193853,COMM 114I,A00,185353,Staff,31,0,40,9
1683708194882,COMM 131,A00,185354,Staff,17,0,30,13
1683708195910,CSE 8A,A50,185358,Cao; Yingjun,0,46,10,10
1683708196936,CSE 8B,A01,185362,Staff,0,48,50,50
1683708197963,CSE 11,A01,185416,Cao; Yingjun,0,91,10,10
1683708198992,CSE 20,A01,185445,Briones; Jor-el Thomas Caparas,3,0,25,22
1683708200021,CSE 21,A01,185447,Staff,9,0,50,41
1683708201049,CSE 101,A01,185451,Staff,0,13,50,50
1683708201049,CSE 101,B01,185453,Jones; Miles E,0,15,50,50
1683708203103,CSE 141,A01,185458,Eldon; John,16,0,100,84
1683708204129,CSE 141L,A01,185461,Eldon; John,8,0,100,92
1683708205155,CSE 142,A01,185463,Staff,34,0,60,26
1683708205155,CSE 142,B01,201355,Staff,0,7,60,60
1683708206184,CSE 142L,A01,185470,Staff,34,0,60,26
1683708206184,CSE 142L,B01,201417,Staff,0,6,60,60
1683708207211,CSE 190,A00,201433,Staff,32,0,49,17
1683708208250,DOC 1,A01,259136,Strom; Megan C.,7,0,15,8
1683708208250,DOC 1,A02,259137,Strom; Megan C.,15,0,15,0
1683708208250,DOC 1,A03,259138,Strom; Megan C.,14,0,15,1
1683708208250,DOC 1,A04,259139,Strom; Megan C.,14,0,15,1
1683708209277,DOC 100D,A00,259140,Pass; Natalye Joann,14,0,25,11
1683708210305,DSGN 1,A01,184749,Rill; Bryan,0,26,30,30
1683708211331,DSGN 100,A01,185168,Staff,0,2,25,25
1683708212357,ECE 5,A01,185626,Morris; Karcher William,0,12,0,0
1683708213382,ECE 101,A01,185628,Staff,14,0,70,56
1683708214421,ECE 107,A01,185635,Baghdadchi; Saharnaz,0,0,20,20
1683708214421,ECE 107,A02,185638,Baghdadchi; Saharnaz,1,0,20,19
1683708215447,ECE 148,A01,185647,Silberman; Jack,0,0,16,16
1683708216473,ECON 1,A01,185537,Crane; Meredith Helen,54,0,70,16
1683708217502,ECON 3,A01,185549,Crane; Meredith Helen,30,0,70,40
1683708218530,ECON 4,A01,203354,Anderson; John Charles,0,5,10,10
1683708219556,ECON 100A,A01,185574,Staff,0,5,40,40
1683708220587,ECON 100B,A01,185576,Staff,0,12,50,50
1683708221613,ECON 100C,A01,185589,Newhouse; Herbert S,30,0,70,40
1683708222638,ECON 105,A00,185608,Vespa; Emanuel Ignacio,19,0,35,16
1683708223663,ECON 109,A01,185610,Shishkin; Denis,9,0,35,26
1683708224690,ECON 110A,A01,185612,Staff,8,0,40,32
1683708225714,ECON 120A,A01,185615,Staff,19,0,40,21
1683708226740,ECON 120C,A01,185617,Sun; Yixiao,0,21,70,70
1683708227766,ECON 144,A00,203346,Squires; Dale E,2,0,35,33
1683708228797,ECON 171,A01,203349,Newhouse; Herbert S,0,1,35,35
1683708229828,ECON 173A,A01,185621,Toda; Alexis Akira,21,0,35,14
1683708230857,EDS 25,A01,202413,Staff,0,1,0,0
1683708230857,EDS 25,A02,202414,Staff,0,1,0,0
1683708230857,EDS 25,A03,202415,Staff,0,0,0,0
1683708230857,EDS 25,A04,202416,Staff,0,1,0,0
1683708230857,EDS 25,A05,202439,Staff,0,0,0,0
1683708230857,EDS 25,A06,202440,Staff,0,0,0,0
1683708230857,EDS 25,B01,202631,Staff,0,0,0,0
1683708230857,EDS 25,B02,202632,Staff,0,0,0,0
1683708230857,EDS 25,B03,202639,Staff,0,0,0,0
1683708230857,EDS 25,B04,202640,Staff,0,0,0,0
1683708230857,EDS 25,B05,202643,Staff,0,0,0,0
1683708230857,EDS 25,B06,202644,Staff,0,0,0,0
1683708231882,EDS 38,A01,202659,Black; Alison Michelle,25,0,25,0
1683708232907,EDS 115,A00,202652,Staff,18,0,30,12
1683708233932,EDS 125,A00,202649,Staff,13,0,30,17
1683708234956,EDS 126,A01,203332,Staff,30,0,30,0
1683708235983,EDS 139,A00,202838,Staff,16,0,25,9
1683708237013,EDS 146,A01,202655,Staff,14,0,25,11
1683708238045,ENG 15,A00,185667,Staff,0,1,0,0
1683708238045,ENG 15,B00,185672,Staff,0,0,0,0
1683708238045,ENG 15,C00,185675,Staff,0,0,0,0
1683708238045,ENG 15,D00,185682,Staff,0,0,0,0
1683708238045,ENG 15,E00,185684,Staff,0,0,0,0
1683708239073,ETHN 103,A00,185710,Staff,0,8,35,35
1683708240106,ETHN 103A,A00,199228,Man; Simeon S,0,0,9,9
1683708241134,ETHN 109,A00,185711,Staff,15,0,35,20
1683708242161,ETHN 142,A00,185726,Staff,0,4,30,30
1683708243190,ETHN 163J,A00,199229,Man; Simeon S,5,0,8,3
1683708244217,ETHN 168,A00,185727,Staff,7,0,10,3
1683708245252,ETHN 182,A00,185728,Staff,0,0,35,35
1683708246277,ETHN 183,A00,185737,Staff,9,0,18,9
1683708247307,GLBH 111,A01,209361,Burgos; Jose L.,0,0,0,0
1683708249363,HIEU 104,A00,185792,Staff,14,0,20,6
1683708250387,HIEU 115,A00,185800,Staff,0,0,20,20
1683708251417,HIEU 128,A00,185801,Staff,0,9,20,20
1683708252444,HIEU 147,A00,185802,Staff,15,0,20,5
1683708253472,HIEU 154,A00,185823,Staff,11,0,20,9
1683708254496,HILA 102,A00,185826,Staff,14,0,20,6
1683708255521,HILD 2C,A01,185778,Staff,0,13,20,20
1683708256546,HILD 7B,A01,185780,Kwak; Nancy,0,17,32,32
1683708256546,HILD 7B,A02,185781,Kwak; Nancy,0,18,32,32
1683708257577,HILD 30,A01,185791,Staff,12,0,20,8
1683708258603,HISC 119,A00,185830,Golan; Tal,0,10,20,20
1683708259684,HITO 156GS,A00,185831,Patterson; Patrick H.,0,0,0,23
1683708260714,HIUS 103,A00,185832,Man; Simeon S,0,4,20,20
1683708261742,HIUS 117,A00,185836,Kwak; Nancy,2,0,20,18
1683708262769,HIUS 125,A00,185840,Man; Simeon S,0,2,23,23
1683708263794,HIUS 149,A00,185845,Staff,1,0,20,19
1683708264821,HUM 3,A01,185882,Zavodny; Tatiana Sophia,0,8,50,50
1683708264821,HUM 3,B01,185899,Caldwell; Michael Alan,0,18,50,50
1683708265849,HUM 3GS,A00,185900,Patterson; Patrick H.,0,0,0,23
1683708266878,HUM 4,A01,185938,Zroka; Amy Liane,28,0,50,22
1683708266878,HUM 4,B01,185956,Watkins; Eric,0,6,50,50
1683708266878,HUM 4,B02,202209,Watkins; Eric,0,5,50,50
1683708266878,HUM 4,B03,202210,Watkins; Eric,0,5,50,50
1683708267907,HUM 5,A01,185958,West; Geoffrey Scott,0,0,50,50
1683708267907,HUM 5,A02,202215,West; Geoffrey Scott,0,1,50,50
1683708268943,INTL 190,A00,185959,Gagnon; Jeffrey C,0,0,0,9
1683708268943,INTL 190,B00,185960,Lettieri; Michael Joseph,0,0,0,2
1683708269969,JAPN 180,A00,254509,Staff,5,0,30,25
1683708270997,LATI 10,A01,202853,Kennemore; Amy Michelle,4,0,35,31
1683708270997,LATI 10,A02,202854,Kennemore; Amy Michelle,3,0,35,32
1683708270997,LATI 10,A03,270054,Kennemore; Amy Michelle,30,0,30,0
1683708272030,LATI 180,A00,202855,Kennemore; Amy Michelle,11,0,20,9
1683708273057,LAWS 101,A00,201767,Golan; Tal,0,7,40,40
1683708274081,LIFR 1C,A00,185961,Staff,6,0,20,14
1683708275109,LIFR 1CX,A00,185962,Staff,7,0,20,13
1683708276137,LIFR 1D,A00,185963,Staff,7,0,20,13
1683708277165,LIFR 1DX,A00,185964,Staff,7,0,20,13
1683708278195,LIGN 101,A01,186039,Staff,43,0,50,7
1683708279219,LIGN 165,A00,186040,Staff,14,0,50,36
1683708280243,LTCS 108,A00,186041,Staff,5,0,10,5
1683708281273,LTCS 119,A00,186042,Staff,15,0,20,5
1683708282301,LTCS 130,A00,186043,Wesling; Megan E.,15,0,25,10
1683708284350,LTEA 138,A00,186119,Staff,14,0,40,26
1683708285378,LTEN 124,A00,186148,Staff,5,0,25,20
1683708286404,LTEN 178,A00,186149,Staff,6,0,15,9
1683708287434,LTEN 181,A00,186150,Blanco; John D,34,0,40,6
1683708288463,LTWL 120,A00,186160,Staff,19,0,25,6
1683708289488,LTWL 165,A00,186161,Staff,22,0,25,3
1683708290511,LTWR 100,A00,186162,Staff,0,5,15,15
1683708291537,LTWR 102,A00,186163,Doller; Ben,5,0,15,10
1683708292563,MAE 8,A01,186412,Staff,0,1,0,0
1683708293588,MAE 30B,A00,186445,Bahadori; Mohammad Yousef,81,0,100,19
1683708294614,MAE 40,A00,186592,Bewley; Thomas R,10,0,50,40
1683708295640,MAE 101B,A00,186593,Bahadori; Mohammad Yousef,80,0,100,20
1683708296669,MAE 105,A00,186594,Bandaru; Prabhakar,10,0,50,40
1683708297696,MAE 107,A00,186599,Pham; Hieu Tan,0,8,120,120
1683708298721,MAE 148,A01,186660,Silberman; Jack,3,0,16,13
1683708299751,MATH 10A,A01,188095,Staff,0,6,35,35
1683708300777,MATH 10B,A01,188097,Bowers; Adam R.,0,12,30,30
1683708300777,MATH 10B,A02,188099,Bowers; Adam R.,0,11,30,30
1683708300777,MATH 10B,B01,188104,Bowers; Adam R.,0,10,30,30
1683708300777,MATH 10B,B02,188106,Bowers; Adam R.,0,9,30,30
1683708301805,MATH 10C,A01,188111,Staff,0,20,30,30
1683708301805,MATH 10C,A02,188127,Staff,0,19,30,30
1683708301805,MATH 10C,A03,188131,Staff,0,19,30,30
1683708301805,MATH 10C,B01,188218,Staff,17,0,30,13
1683708301805,MATH 10C,B02,188244,Staff,13,0,30,17
1683708301805,MATH 10C,B03,188277,Staff,14,0,30,16
1683708302841,MATH 18,A01,188344,Bach; Quang Tran,18,0,30,12
1683708302841,MATH 18,A02,188345,Bach; Quang Tran,11,0,30,19
1683708302841,MATH 18,B01,188353,Bach; Quang Tran,11,0,30,19
1683708302841,MATH 18,B02,188354,Bach; Quang Tran,19,0,30,11
1683708303865,MATH 20A,A01,188374,Staff,11,0,35,24
1683708304892,MATH 20B,A01,188382,Ohm; Ko Woon,7,0,30,23
1683708304892,MATH 20B,A02,188383,Ohm; Ko Woon,22,0,30,8
1683708304892,MATH 20B,B01,188385,Ohm; Ko Woon,7,0,30,23
1683708304892,MATH 20B,B02,188392,Ohm; Ko Woon,22,0,30,8
1683708305920,MATH 20C,A01,188394,Harel; Guershon,10,0,30,20
1683708305920,MATH 20C,A02,188395,Harel; Guershon,13,0,30,17
1683708305920,MATH 20C,B01,188404,Harel; Guershon,5,0,30,25
1683708305920,MATH 20C,B02,188405,Harel; Guershon,18,0,30,12
1683708306952,MATH 20D,A01,188414,Hammock; Frances H,0,1,30,30
1683708306952,MATH 20D,A02,188415,Hammock; Frances H,0,1,30,30
1683708306952,MATH 20D,B01,188447,Hammock; Frances H,0,1,30,30
1683708306952,MATH 20D,B02,188486,Hammock; Frances H,2,0,30,28
1683708307976,MATH 20E,A01,188649,Staff,21,0,30,9
1683708307976,MATH 20E,A02,188650,Staff,20,0,30,10
1683708307976,MATH 20E,A03,188673,Staff,0,0,30,30
1683708309004,MATH 102,A01,188675,Staff,0,40,35,35
1683708310040,MATH 103B,A01,188681,Staff,3,0,35,32
1683708310040,MATH 103B,B01,188692,Staff,5,0,35,30
1683708311066,MATH 109,A01,188695,Salehi Golsefidy; Alireza,24,0,35,11
1683708311066,MATH 109,A02,188696,Salehi Golsefidy; Alireza,25,0,35,10
1683708312092,MATH 120A,A01,188698,Eggers; John Dietrich,7,0,35,28
1683708313124,MATH 142B,A01,188736,Ioana; Adrian,0,0,30,30
1683708313124,MATH 142B,A02,188741,Ioana; Adrian,0,1,30,30
1683708313124,MATH 142B,A03,188743,Ioana; Adrian,0,2,30,30
1683708314148,MATH 168A,A01,188790,Staff,0,11,35,35
1683708315175,MATH 170A,A01,188803,Nie; Jiawang,0,2,35,35
1683708315175,MATH 170A,A02,188811,Nie; Jiawang,0,1,35,35
1683708315175,MATH 170A,A03,188814,Nie; Jiawang,0,0,35,35
1683708315175,MATH 170A,A04,188815,Nie; Jiawang,5,0,35,30
1683708316201,MATH 193B,A01,188817,Staff,0,0,35,35
1683708316201,MATH 193B,A02,188818,Staff,6,0,35,29
1683708317232,MGT 4,A01,202857,Anderson; John Charles,59,0,80,21
1683708318258,MGT 12,A00,202858,Lindenberger; Wade Douglas,40,0,90,50
1683708319283,MGT 18,A00,202859,Staff,73,0,90,17
1683708320310,MGT 18GS,A00,202860,McKay; Michael J,13,0,28,15
1683708321336,MGT 45,A00,202861,Pecore; Joseph P.,8,0,90,82
1683708322363,MGT 100,A00,202863,Yavorsky; Daniel Ryan,27,0,90,63
1683708323395,MGT 103,A00,202864,Ehrich; Kristine R,0,19,90,90
1683708324423,MGT 112,A00,202865,Ehrich; Kristine R,15,0,90,75
1683708325453,MGT 121A,A00,202868,Staff,70,0,90,20
1683708326477,MGT 131B,A00,202869,Anderson; John Charles,58,0,90,32
1683708327503,MGT 136,A00,202871,Lindenberger; Wade Douglas,83,0,90,7
1683708328529,MGT 164,A00,202873,Staff,0,67,90,91
1683708329554,MGT 164GS,A00,202874,McKay; Mary A,13,0,28,15
1683708330579,MGT 180,A00,202875,Staff,0,51,90,91
1683708331605,MMW 11R,A01,205019,Herbst; Matthew,0,0,30,30
1683708331605,MMW 11R,A02,205026,Herbst; Matthew,29,0,30,1
1683708332633,MMW 15,A01,193512,Chang; Edmond Yi-Teh,0,8,28,28
1683708332633,MMW 15,A02,193513,Chang; Edmond Yi-Teh,0,5,28,28
1683708332633,MMW 15,A03,193514,Chang; Edmond Yi-Teh,0,5,28,28
1683708332633,MMW 15,A04,193515,Chang; Edmond Yi-Teh,0,5,28,28
1683708332633,MMW 15,A05,193516,Chang; Edmond Yi-Teh,0,5,28,28
1683708332633,MMW 15,A06,193517,Chang; Edmond Yi-Teh,0,6,28,28
1683708332633,MMW 15,B01,193519,Chang; Edmond Yi-Teh,0,5,28,28
1683708332633,MMW 15,B02,193520,Chang; Edmond Yi-Teh,0,5,28,28
1683708332633,MMW 15,B03,193521,Chang; Edmond Yi-Teh,0,5,28,28
1683708332633,MMW 15,B04,193522,Chang; Edmond Yi-Teh,0,6,28,28
1683708332633,MMW 15,B05,193523,Chang; Edmond Yi-Teh,0,5,28,28
1683708332633,MMW 15,B06,193524,Chang; Edmond Yi-Teh,0,5,28,28
1683708333662,MMW 122,A01,193526,Rahimi; Babak,0,16,28,28
1683708333662,MMW 122,A02,193527,Rahimi; Babak,0,15,28,28
1683708333662,MMW 122,A03,193528,Rahimi; Babak,0,0,0,0
1683708333662,MMW 122,A04,193529,Rahimi; Babak,0,0,0,0
1683708334692,MUS 1A,A01,186663,Staff,0,18,35,35
1683708335722,MUS 4,A01,186715,Staff,0,12,35,35
1683708336753,MUS 5R,A01,186796,Dubnov; Shlomo,0,17,35,35
1683708337779,MUS 6,A01,186798,Staff,0,4,25,25
1683708338808,MUS 7,A01,186830,Staff,11,0,35,24
1683708339835,MUS 8,A01,186930,Staff,0,27,35,35
1683708340861,MUS 15,A01,186932,Staff,0,15,35,35
1683708340861,MUS 15,B01,186934,Staff,0,16,35,35
1683708341888,MUS 80,A00,186935,Staff,0,0,20,20
1683708341888,MUS 80,B00,186936,Staff,24,0,25,1
1683708342917,NANO 11,A00,204702,Lipomi; Darren John,0,0,0,0
1683708343949,NANO 15,A01,204709,Yang; Kesong,0,1,0,0
1683708344979,NANO 114,A00,202069,Jahed Motlagh; Zeinab,2,0,10,8
1683708346009,PHIL 1,A00,186955,Grush; Rick Scott,31,0,40,9
1683708347035,PHIL 10,A01,186973,Grush; Rick Scott,27,0,35,8
1683708347035,PHIL 10,A02,186974,Grush; Rick Scott,33,0,35,2
1683708348062,PHIL 13,A01,186976,Staff,1,0,35,34
1683708348062,PHIL 13,A02,186977,Staff,16,0,35,19
1683708349091,PHIL 14,A01,186979,Staff,30,0,35,5
1683708349091,PHIL 14,A02,186986,Staff,32,0,35,3
1683708350121,PHIL 28,A01,186988,Staff,16,0,30,14
1683708350121,PHIL 28,A02,186989,Staff,0,0,30,30
1683708350121,PHIL 28,A03,186990,Staff,10,0,30,20
1683708350121,PHIL 28,A04,186991,Staff,26,0,30,4
1683708351150,PHIL 120,A00,186997,Staff,23,0,40,17
1683708352174,PHIL 137,A00,187003,Staff,7,0,40,33
1683708353203,PHIL 150,A00,187015,Staff,47,0,70,23
1683708354227,PHIL 167,A00,187021,Lamey; Andy M.,34,0,40,6
1683708355252,PHIL 174,A01,202226,Staff,17,0,20,3
1683708355252,PHIL 174,A02,202235,Staff,20,0,20,0
1683708356280,PHIL 191A,A00,258918,Staff,0,0,1,1
1683708357306,PHYS 1A,A00,187028,Staff,26,0,60,34
1683708358335,PHYS 1AL,001,187036,Staff,3,0,30,27
1683708358335,PHYS 1AL,002,187049,Staff,18,0,30,12
1683708359365,PHYS 1B,A00,187058,Staff,21,0,60,39
1683708360391,PHYS 1BL,001,187064,Staff,0,1,30,30
1683708360391,PHYS 1BL,002,187070,Staff,4,0,30,26
1683708361425,PHYS 1C,A00,187082,Staff,30,0,120,90
1683708362453,PHYS 1CL,001,187088,Staff,0,9,30,30
1683708362453,PHYS 1CL,002,187089,Staff,0,1,30,30
1683708362453,PHYS 1CL,009,262693,Staff,9,0,30,21
1683708363543,PHYS 2B,A01,187097,Staff,55,0,115,60
1683708364572,PHYS 2C,A01,187099,Staff,63,0,115,52
1683708365601,PHYS 2CL,A01,187101,Staff,5,0,28,23
1683708365601,PHYS 2CL,A02,187102,Staff,15,0,28,13
1683708366634,PHYS 2D,A01,187123,Shotwell; Brian,95,0,115,20
1683708367661,PHYS 4B,A01,187133,Grinstein; Benjamin,35,0,50,15
1683708368690,POLI 10,A00,188819,Staff,0,4,50,50
1683708369715,POLI 11,A00,188827,Staff,43,0,50,7
1683708370740,POLI 13R,A00,188828,Staff,0,1,20,20
1683708371777,POLI 27,A01,188830,Elgin; Samuel Zincke,0,2,70,70
1683708372803,POLI 30,A00,188832,Desposato; Scott,30,0,50,20
1683708373828,POLI 102F,A00,188834,Staff,1,0,40,39
1683708374853,POLI 104A,A00,188852,Staff,12,0,30,18
1683708375878,POLI 104I,A00,188853,Staff,0,8,20,20
1683708376909,POLI 110B,A00,188854,Wiens; David,6,0,20,14
1683708377938,POLI 112A,A00,188855,Wiens; David,3,0,30,27
1683708378964,POLI 117R,A00,188856,Forman; Fonna,0,12,20,20
1683708379991,POLI 118,A00,188857,Ingham; Sean,8,0,20,12
1683708381020,POLI 120G,A00,188858,Staff,7,0,30,23
1683708382046,POLI 131CR,A00,188863,Hoston; Germaine,20,0,50,30
1683708383074,POLI 133,A00,188864,Nellis; Gareth Hb,44,0,50,6
1683708384102,POLI 134D,A00,188865,Desposato; Scott,27,0,30,3
1683708385131,POLI 142A,A00,188871,Gartzke; Erik,21,0,50,29
1683708386156,POLI 142K,A00,188874,Staff,38,0,50,12
1683708387185,POLI 143,A00,188940,Gartzke; Erik,15,0,30,15
1683708388214,POLI 153,A00,188943,Staff,1,0,20,19
1683708389242,POLI 160AA,A00,188944,Staff,10,0,40,30
1683708390267,POLI 170A,A00,188945,Staff,10,0,30,20
1683708392318,PSYC 1,A00,188952,Staff,36,0,90,54
1683708393343,PSYC 2,B00,188953,Staff,19,0,35,16
1683708394372,PSYC 6,A00,188970,Staff,47,0,60,13
1683708395399,PSYC 7,A00,188973,Staff,35,0,45,10
1683708396430,PSYC 60,A01,188980,Rickard; Timothy C.,42,0,60,18
1683708397455,PSYC 70,A01,189001,Steiner; Eric Tomas,22,0,45,23
1683708398481,PSYC 100,A00,189005,Lacefield; Katharine I,1,98,120,119
1683708399506,PSYC 102,A00,189008,Staff,6,0,30,24
1683708400538,PSYC 106,B00,189026,Gorman; Michael R.,27,0,60,33
1683708401568,PSYC 114,B01,189033,Winkielman; Piotr,0,31,30,30
1683708402594,PSYC 131,A00,189036,Anagnostaras; Stephan,0,44,60,60
1683708403620,PSYC 136,A00,189041,Lowe; Angela Beth,0,7,25,25
1683708404647,PSYC 137,A00,189057,Winkielman; Piotr,0,36,25,25
1683708405672,PSYC 144,A00,189107,Wixted; John T,0,11,50,50
1683708407724,PSYC 162,A00,189142,Staff,0,9,85,85
1683708408754,PSYC 172,A00,189144,Gorman; Michael R.,0,6,30,30
1683708410808,PSYC 179,A00,189146,Lacefield; Katharine I,0,88,120,120
1683708411834,PSYC 181,A00,189147,Anagnostaras; Stephan,0,45,90,90
1683708412860,PSYC 190R,A00,189148,Barner; David A.,0,23,80,80
1683708413891,PSYC 191,A00,189275,Rickard; Timothy C.,0,11,25,25
1683708414921,PSYC 193,A00,189276,Chapman; Eddie Nathaniel,0,1,0,4
1683708415953,PSYC 193L,A01,189281,Lowe; Angela Beth,8,0,20,12
1683708415953,PSYC 193L,B01,189285,Staff,28,0,35,7
1683708416985,RELI 149,A00,187137,Rahimi; Babak,6,0,40,34
1683708418013,SE 9,A01,187315,Staff,0,2,18,18
1683708419041,SE 101B,A00,187409,Staff,24,0,30,6
1683708420071,SE 110B,A00,187444,Staff,10,0,40,30
1683708421120,SE 130B,A00,187449,Staff,31,0,40,9
1683708422146,SE 150A,A00,187516,Staff,8,0,20,12
1683708423172,SE 154,A00,187528,Staff,29,0,50,21
1683708424200,SIO 3,A01,258171,Staff,35,0,40,5
1683708425233,SIO 10,A00,187144,Cook; Geoffrey W,0,6,75,75
1683708426260,SIO 45,A00,187152,Cook; Geoffrey W,1,7,100,99
1683708427285,SIO 109R,A00,194486,Staff,0,4,20,20
1683708429347,SIO 187,A01,187233,Kacev; David,12,0,40,28
1683708430382,SOCI 1,A01,258656,Thorpe; Charles Robert,28,0,30,2
1683708430382,SOCI 1,A02,258658,Thorpe; Charles Robert,30,0,30,0
1683708430382,SOCI 1,A03,258661,Thorpe; Charles Robert,25,0,25,0
1683708430382,SOCI 1,A04,258666,Thorpe; Charles Robert,22,0,25,3
1683708430382,SOCI 1,A05,258897,Thorpe; Charles Robert,22,0,25,3
1683708430382,SOCI 1,A06,258898,Thorpe; Charles Robert,25,0,25,0
1683708431408,SOCI 30,A01,258903,Pardo Guerra; Juan Pablo,14,0,30,16
1683708432435,SOCI 102,A00,258904,Staff,9,0,25,16
1683708433459,SOCI 106,A00,258905,Staff,19,0,25,6
1683708434485,SOCI 111,A00,258907,Ribas Norris; Janet Vanesa,26,0,30,4
1683708435510,SOCI 121R,A00,258908,Pardo Guerra; Juan Pablo,7,0,30,23
1683708436536,SOCI 126,A01,203330,Staff,14,0,20,6
1683708437571,SOCI 131,A00,258909,Thorpe; Charles Robert,30,0,60,30
1683708438601,SOCI 135,A00,258910,Payne; Christine Anna,0,13,30,30
1683708439625,SOCI 157,A00,258911,Staff,10,0,30,20
1683708440653,SOCI 184,A00,258912,Staff,25,0,30,5
1683708441678,SOCI 188D,A00,258913,Staff,22,0,30,8
1683708442706,SYN 2,001,187529,Staff,9,0,16,7
1683708442706,SYN 2,002,201452,Staff,0,20,16,16
1683708442706,SYN 2,003,201469,Staff,1,0,16,15
1683708443734,SYN 100,A01,187531,Staff,0,9,20,20
1683708443734,SYN 100,B01,201491,Staff,0,10,20,20
1683708444763,TDAC 1,A00,189286,Walsh; Kim C.,3,0,20,17
1683708444763,TDAC 1,B00,189287,Harting; Carla Kelso,10,0,20,10
1683708445792,TDAC 101,A00,189300,Walsh; Kim C.,16,0,20,4
1683708445792,TDAC 101,B00,189301,Harting; Carla Kelso,18,0,20,2
1683708446818,TDAC 102,A00,189304,Basso; Beatrice,14,0,20,6
1683708447846,TDAC 108,A00,189305,Staff,18,0,20,2
1683708448875,TDDE 131,A00,189310,Staff,19,0,20,1
1683708448875,TDDE 131,B00,189314,Staff,19,0,20,1
1683708448875,TDDE 131,C00,189315,Staff,48,0,50,2
1683708448875,TDDE 131,D00,189316,Staff,14,0,15,1
1683708448875,TDDE 131,E00,204841,Staff,20,0,20,0
1683708449900,TDGE 10,A00,189289,Staff,27,0,50,23
1683708449900,TDGE 10,B00,189290,Havis; Allan,0,1,50,50
1683708450927,TDGE 11,A00,189291,Fulton; Julia,0,4,50,50
1683708450927,TDGE 11,B00,189292,Staff,20,0,25,5
1683708450927,TDGE 11,C00,260270,Staff,0,0,0,0
1683708451957,TDGE 25,A00,189294,Staff,1,0,20,19
1683708452986,TDGE 124,A00,189318,Fulton; Julia,0,7,50,50
1683708454017,TDGE 125,A00,189319,Staff,13,0,25,12
1683708454017,TDGE 125,B00,189320,Staff,23,0,25,2
1683708455042,TDGE 127,A00,189322,Havis; Allan,1,0,50,49
1683708456068,TDHT 101,A00,189323,Staff,18,0,25,7
1683708456068,TDHT 101,B00,189324,Staff,25,0,25,0
1683708457095,TDHT 102,A00,189325,Staff,49,0,50,1
1683708458125,TDMV 1,A00,189295,Arcidiacono; Kristin,20,0,30,10
1683708458125,TDMV 1,B00,189296,Caligagan; Maria T.,23,0,30,7
1683708459155,TDMV 2,A00,189297,Sammartano; Tonnie,27,0,30,3
1683708459155,TDMV 2,B00,189299,Arcidiacono; Kristin,23,0,30,7
1683708460182,TDMV 3,A00,204998,Rincon; Alicia,22,0,30,8
1683708461210,TDMV 120,A00,189458,Sammartano; Tonnie,28,0,30,2
1683708462238,TDMV 138,A00,189541,Jun; Grace Shin Hae,20,0,40,20
1683708463266,TDMV 142,A00,189717,Caligagan; Tony,25,0,30,5
1683708463266,TDMV 142,B00,189718,Caligagan; Maria T.,25,0,30,5
1683708464296,TMC 2,A01,187533,Staff,25,0,25,0
1683708464296,TMC 2,A02,187534,Staff,25,0,25,0
1683708465326,USP 1,A01,187536,Kwak; Nancy,0,16,25,25
1683708466351,USP 5,A01,187538,Staff,8,0,25,17
1683708467456,USP 101,A00,199253,Staff,0,4,0,0
1683708468487,USP 124,A00,187562,Boomhower; Matthew Charles,0,0,30,30
1683708469514,USP 138,A00,187582,Staff,19,0,25,6
1683708470544,USP 152,A01,187597,Staff,3,0,25,22
1683708471571,USP 153,A00,187598,Staff,18,0,25,7
1683708472597,USP 168,A00,187607,Kwak; Nancy,2,0,5,3
1683708473622,USP 173,A00,187619,Staff,4,0,25,21
1683708474653,USP 181,A00,187638,Staff,0,4,25,25
1683708475687,VIS 103,A00,187650,Cruz; Edwin Teddy,17,0,75,58
1683708476712,VIS 110D,A00,187669,Staff,13,0,22,9
1683708477739,VIS 127C,A00,187720,Shen; Kuiyi,67,0,146,79
1683708478769,VIS 149,A00,187731,Yoldas; Pinar,0,12,22,22
1683708479796,VIS 151,A01,188091,Staff,22,0,34,12
1683708479796,VIS 151,A02,188092,Staff,11,0,34,23
1683708480822,VIS 160B,A00,188093,Stalbaum; Brett,0,1,10,10
1683708482874,WCWP 10B,A00,201720,Staff,0,0,5,5
1683708482874,WCWP 10B,B00,201722,Staff,0,0,6,6
1683708483907,WCWP 100,A00,201725,Gagnon; Jeffrey C,0,0,2,2
1683708483907,WCWP 100,B00,201727,Staff,0,4,15,15
1683708487071,ANBI 133,A00,258401,Wilder; Linnea Lorene,34,0,40,6
1683708488098,ANBI 140,A00,258395,Hrvoj Mihic; Branka,18,0,25,7
1683708489123,ANSC 120,A00,258402,Bialecki; Jon Anthony,26,0,40,14
1683708490149,ANSC 144,A00,258400,Staff,12,0,40,28
1683708492205,ANSC 166,A00,258396,Parish; Steven Martin,156,0,175,19
1683708493234,ANSC 180,A00,193533,Staff,8,0,20,12
1683708494266,ANSC 188,A00,258397,Jassal; Aftab,34,0,40,6
1683708495291,ANTH 3,A01,258316,Staff,23,0,30,7
1683708496318,ANTH 5,A00,258394,Semendeferi; Ekaterini,16,0,20,4
1683708497351,ANTH 21,A01,258331,Staff,4,0,40,36
1683708498381,ANTH 103,A00,258398,Varma; Saiba,15,0,25,10
1683708499422,AWP 10,001,202034,Staff,0,0,0,0
1683708499422,AWP 10,002,202035,Staff,0,0,0,0
1683708499422,AWP 10,003,202036,Staff,0,0,0,0
1683708499422,AWP 10,004,202037,Staff,0,0,0,0
1683708499422,AWP 10,005,202038,Staff,0,0,0,0
1683708499422,AWP 10,006,202039,Staff,0,0,0,0
1683708499422,AWP 10,007,202040,Staff,0,0,0,0
1683708499422,AWP 10,008,202041,Staff,0,0,0,0
1683708499422,AWP 10,009,202042,Staff,0,0,0,0
1683708499422,AWP 10,010,202043,Staff,0,0,0,0
1683708499422,AWP 10,011,202044,Staff,0,0,0,0
1683708499422,AWP 10,012,202045,Staff,0,0,0,0
1683708499422,AWP 10,013,202046,Staff,0,0,0,0
1683708499422,AWP 10,014,202047,Staff,0,0,0,0
1683708499422,AWP 10,015,202048,Staff,0,0,0,0
1683708499422,AWP 10,016,202049,Staff,0,0,0,0
1683708499422,AWP 10,017,202050,Staff,0,0,0,0
1683708499422,AWP 10,018,202051,Staff,0,0,0,0
1683708499422,AWP 10,019,202052,Staff,0,0,0,0
1683708499422,AWP 10,020,202053,Staff,0,0,0,0
1683708499422,AWP 10,021,202054,Staff,0,0,0,0
1683708499422,AWP 10,022,202055,Staff,0,0,0,0
1683708499422,AWP 10,023,202056,Staff,0,0,0,0
1683708499422,AWP 10,024,202057,Staff,0,0,0,0
1683708499422,AWP 10,025,202058,Staff,0,0,0,0
1683708499422,AWP 10,026,202059,Staff,0,0,0,0
1683708500447,AWP 102,001,202032,Staff,0,0,0,0
1683708500447,AWP 102,002,202033,Staff,0,0,0,0
1683708501474,BENG 100,A01,254234,Taylor Amos; Alyssa C,31,0,40,9
1683708502502,BENG 196,001,270013,Engler; Adam J.,9999,0,9999,0
1683708503537,BICD 100R,A01,202018,Smith; Laurie,0,7,32,32
1683708503537,BICD 100R,A02,202019,Smith; Laurie,0,3,32,32
1683708503537,BICD 100R,A03,202020,Smith; Laurie,0,1,32,32
1683708503537,BICD 100R,A04,202021,Smith; Laurie,6,0,32,26
1683708503537,BICD 100R,A05,202022,Smith; Laurie,10,0,32,22
1683708504564,BICD 136,A01,193242,Gustafson-Brown; Cindy,0,2,32,32
1683708504564,BICD 136,A02,193244,Gustafson-Brown; Cindy,13,0,32,19
1683708505600,BIEB 102,A01,193249,Butler; Shannon Rhey,0,0,32,32
1683708505600,BIEB 102,A02,193251,Butler; Shannon Rhey,0,0,32,32
1683708505600,BIEB 102,A03,193253,Butler; Shannon Rhey,0,0,32,32
1683708505600,BIEB 102,A04,193255,Butler; Shannon Rhey,13,0,32,19
1683708505600,BIEB 102,A05,193265,Butler; Shannon Rhey,25,0,32,7
1683708505600,BIEB 102,A06,193269,Butler; Shannon Rhey,12,0,32,20
1683708507654,BIEB 150,A01,193274,Staff,0,0,32,32
1683708507654,BIEB 150,A02,193285,Staff,24,0,32,8
1683708508679,BIEB 194,A00,193286,Kurle; Carolyn M.,19,0,32,13
1683708509710,BILD 1,A01,192291,Staff,15,0,32,17
1683708509710,BILD 1,A02,192292,Staff,30,0,32,2
1683708509710,BILD 1,B01,192520,Reuther; Keefe,0,1,0,0
1683708509710,BILD 1,B02,192532,Reuther; Keefe,0,1,0,0
1683708510742,BILD 3,A01,192556,Butler; Shannon Rhey,0,0,32,32
1683708510742,BILD 3,A02,192581,Butler; Shannon Rhey,0,1,32,32
1683708510742,BILD 3,A03,192611,Butler; Shannon Rhey,19,0,32,13
1683708510742,BILD 3,A04,192612,Butler; Shannon Rhey,23,0,32,9
1683708510742,BILD 3,A05,192613,Butler; Shannon Rhey,26,0,32,6
1683708510742,BILD 3,A06,192679,Butler; Shannon Rhey,27,0,32,5
1683708510742,BILD 3,A07,192682,Butler; Shannon Rhey,20,0,32,12
1683708511773,BILD 4,A01,192836,Reuther; Keefe,1,0,24,23
1683708511773,BILD 4,A02,193044,Reuther; Keefe,4,0,24,20
1683708512799,BILD 10,A01,193142,Gustafson-Brown; Cindy,29,0,32,3
1683708512799,BILD 10,A02,193149,Gustafson-Brown; Cindy,31,0,32,1
1683708513825,BIMM 100,A01,193301,Staff,0,6,32,32
1683708513825,BIMM 100,A02,193312,Staff,0,7,32,32
1683708513825,BIMM 100,A03,193323,Staff,0,10,32,32
1683708514852,BIMM 101,A01,193329,McDonnell; Lisa Marie,0,3,24,24
1683708514852,BIMM 101,A02,193339,McDonnell; Lisa Marie,0,3,24,24
1683708514852,BIMM 101,B01,193354,McDonnell; Lisa Marie,0,4,24,24
1683708514852,BIMM 101,B02,193357,McDonnell; Lisa Marie,0,3,24,24
1683708515883,BIMM 110,A01,193377,Tat; John,0,11,32,32
1683708515883,BIMM 110,A02,193378,Tat; John,0,11,32,32
1683708516912,BIMM 120,A01,206116,Staff,0,0,32,32
1683708516912,BIMM 120,A02,206117,Staff,7,0,32,25
1683708516912,BIMM 120,A03,206121,Staff,21,0,32,11
1683708517938,BIPN 100,A01,193393,Park; Ji Young,0,15,32,32
1683708517938,BIPN 100,A02,193402,Park; Ji Young,0,14,32,32
1683708517938,BIPN 100,A03,193413,Park; Ji Young,0,14,32,32
1683708517938,BIPN 100,A04,193414,Park; Ji Young,0,13,32,32
1683708518964,BIPN 102,A01,193429,Staff,0,0,32,32
1683708518964,BIPN 102,A02,193438,Staff,18,0,32,14
1683708519991,BIPN 106,A01,193450,Reyes Gonzalez; Catalina,0,2,40,40
1683708521017,BIPN 134,A01,193465,Cooke; James Edward,0,0,32,32
1683708521017,BIPN 134,A02,193474,Cooke; James Edward,25,0,32,7
1683708521017,BIPN 134,A03,193485,Cooke; James Edward,29,0,32,3
1683708521017,BIPN 134,A04,193486,Cooke; James Edward,20,0,32,12
1683708521017,BIPN 134,A05,193491,Cooke; James Edward,31,0,32,1
1683708521017,BIPN 134,A06,193501,Cooke; James Edward,30,0,32,2
1683708521017,BIPN 134,A07,193510,Cooke; James Edward,29,0,32,3
1683708523067,BISP 194,A00,222522,Staff,14,0,32,18
1683708524092,CAT 124,A01,202407,Staff,19,0,25,6
1683708525125,CAT 125,A00,202408,Marchisotto; Jennifer Anne,2,0,20,18
1683708526162,CAT 125R,A00,202409,Smith; Lauryn Alissa,0,11,20,20
1683708526162,CAT 125R,B00,202410,Morales; Celeste Georgianna,0,11,20,20
1683708526162,CAT 125R,C00,202411,Irwin; Matthew Joseph,0,12,20,20
1683708527190,CENG 15,A01,204712,Yang; Kesong,0,1,0,0
1683708528215,CENG 114,A00,202070,Jahed Motlagh; Zeinab,5,0,20,15
1683708529240,CGS 105,A00,185477,Wesling; Megan E.,24,0,40,16
1683708530267,CGS 106,A00,185494,Staff,11,0,22,11
1683708531292,CGS 108,A00,185495,Staff,14,0,20,6
1683708532319,CGS 114,A00,185496,Staff,13,0,18,5
1683708533344,CGS 119,A00,185501,Staff,15,0,20,5
1683708534369,CGS 120,A00,185511,Staff,11,0,20,9
1683708535401,CHEM 4,A01,184675,Bussey; Thomas J,97,0,100,3
1683708536430,CHEM 6A,A01,184677,Staff,32,0,60,28
1683708537457,CHEM 6B,A01,184679,Staff,63,0,100,37
1683708538486,CHEM 6C,A01,184681,Bussey; Thomas J,0,0,50,50
1683708538486,CHEM 6C,A02,184682,Bussey; Thomas J,32,0,50,18
1683708539511,CHEM 40A,A01,184684,Albizati; Kim F.,33,0,100,67
1683708540534,CHEM 40B,A01,184686,Albizati; Kim F.,0,22,100,100
1683708541563,CHEM 41B,A01,184690,Staff,51,0,100,49
1683708542593,COGS 3,A01,184715,Boyle; Mary E. T.,0,27,40,40
1683708543624,COGS 14B,A01,185172,Staff,0,14,38,38
1683708544654,COGS 18,A01,184736,Staff,14,0,80,66
1683708545685,COGS 100,A01,184932,Staff,0,8,73,73
1683708546709,COGS 101A,A01,184935,Staff,0,40,30,30
1683708547738,COGS 101B,A01,184944,Staff,0,2,30,30
1683708548763,COGS 101C,A01,184946,Staff,0,10,30,30
1683708549796,COGS 102A,A01,184951,Johnson; Christine M.,1,0,40,39
1683708550821,COGS 107B,A01,184953,Mooshagian; Eric Frederick,0,52,40,40
1683708551850,COGS 118B,A01,184959,Gupta; Anjum,0,50,40,40
1683708552873,COGS 153,A00,184961,Staff,1,16,30,29
1683708553900,COGS 177,A00,184962,Staff,0,20,30,30
1683708554924,COGS 187A,A01,184969,Boyle; Mary E. T.,0,19,40,40
1683708555953,COMM 10,A01,185174,Staff,0,5,25,25
1683708555953,COMM 10,A02,185189,Staff,0,2,25,25
1683708555953,COMM 10,A03,269821,Staff,0,1,0,0
1683708556979,COMM 100B,A02,185476,Staff,10,0,25,15
1683708556979,COMM 100B,A03,277340,Staff,25,0,25,0
1683708558008,COMM 100C,A01,185314,Staff,2,0,25,23
1683708558008,COMM 100C,A02,185327,Staff,17,0,25,8
1683708559038,COMM 110M,A00,185349,Staff,0,0,40,40
1683708560066,COMM 113T,A00,185352,Staff,25,0,40,15
1683708561090,COMM 114I,A00,185353,Staff,31,0,40,9
1683708562114,COMM 131,A00,185354,Staff,17,0,30,13
1683708563143,CSE 8A,A50,185358,Cao; Yingjun,0,46,10,10
1683708564168,CSE 8B,A01,185362,Staff,0,48,50,50
1683708565192,CSE 11,A01,185416,Cao; Yingjun,0,91,10,10
1683708566220,CSE 20,A01,185445,Briones; Jor-el Thomas Caparas,3,0,25,22
1683708567245,CSE 21,A01,185447,Staff,9,0,50,41
1683708568276,CSE 101,A01,185451,Staff,0,13,50,50
1683708568276,CSE 101,B01,185453,Jones; Miles E,0,15,50,50
1683708570333,CSE 141,A01,185458,Eldon; John,16,0,100,84
1683708571415,CSE 141L,A01,185461,Eldon; John,8,0,100,92
1683708572445,CSE 142,A01,185463,Staff,34,0,60,26
1683708572445,CSE 142,B01,201355,Staff,0,7,60,60
1683708573467,CSE 142L,A01,185470,Staff,34,0,60,26
1683708573467,CSE 142L,B01,201417,Staff,0,6,60,60
1683708574492,CSE 190,A00,201433,Staff,32,0,49,17
1683708575528,DOC 1,A01,259136,Strom; Megan C.,7,0,15,8
1683708575528,DOC 1,A02,259137,Strom; Megan C.,15,0,15,0
1683708575528,DOC 1,A03,259138,Strom; Megan C.,14,0,15,1
1683708575528,DOC 1,A04,259139,Strom; Megan C.,14,0,15,1
1683708576553,DOC 100D,A00,259140,Pass; Natalye Joann,14,0,25,11
1683708577579,DSGN 1,A01,184749,Rill; Bryan,0,26,30,30
1683708578605,DSGN 100,A01,185168,Staff,0,2,25,25
1683708579633,ECE 5,A01,185626,Morris; Karcher William,0,12,0,0
1683708580662,ECE 101,A01,185628,Staff,14,0,70,56
1683708581689,ECE 107,A01,185635,Baghdadchi; Saharnaz,0,0,20,20
1683708581689,ECE 107,A02,185638,Baghdadchi; Saharnaz,1,0,20,19
1683708582714,ECE 148,A01,185647,Silberman; Jack,0,0,16,16
1683708583741,ECON 1,A01,185537,Crane; Meredith Helen,54,0,70,16
1683708584767,ECON 3,A01,185549,Crane; Meredith Helen,30,0,70,40
1683708585792,ECON 4,A01,203354,Anderson; John Charles,0,5,10,10
1683708586818,ECON 100A,A01,185574,Staff,0,5,40,40
1683708587869,ECON 100B,A01,185576,Staff,0,12,50,50
1683708588899,ECON 100C,A01,185589,Newhouse; Herbert S,30,0,70,40
1683708589928,ECON 105,A00,185608,Vespa; Emanuel Ignacio,19,0,35,16
1683708590958,ECON 109,A01,185610,Shishkin; Denis,9,0,35,26
1683708591983,ECON 110A,A01,185612,Staff,8,0,40,32
1683708593007,ECON 120A,A01,185615,Staff,19,0,40,21
1683708594032,ECON 120C,A01,185617,Sun; Yixiao,0,21,70,70
1683708595058,ECON 144,A00,203346,Squires; Dale E,2,0,35,33
1683708596088,ECON 171,A01,203349,Newhouse; Herbert S,0,1,35,35
1683708597117,ECON 173A,A01,185621,Toda; Alexis Akira,21,0,35,14
1683708598144,EDS 25,A01,202413,Staff,0,1,0,0
1683708598144,EDS 25,A02,202414,Staff,0,1,0,0
1683708598144,EDS 25,A03,202415,Staff,0,0,0,0
1683708598144,EDS 25,A04,202416,Staff,0,1,0,0
1683708598144,EDS 25,A05,202439,Staff,0,0,0,0
1683708598144,EDS 25,A06,202440,Staff,0,0,0,0
1683708598144,EDS 25,B01,202631,Staff,0,0,0,0
1683708598144,EDS 25,B02,202632,Staff,0,0,0,0
1683708598144,EDS 25,B03,202639,Staff,0,0,0,0
1683708598144,EDS 25,B04,202640,Staff,0,0,0,0
1683708598144,EDS 25,B05,202643,Staff,0,0,0,0
1683708598144,EDS 25,B06,202644,Staff,0,0,0,0
1683708599171,EDS 38,A01,202659,Black; Alison Michelle,25,0,25,0
1683708600201,EDS 115,A00,202652,Staff,18,0,30,12
1683708601226,EDS 125,A00,202649,Staff,13,0,30,17
1683708602249,EDS 126,A01,203332,Staff,30,0,30,0
1683708603278,EDS 139,A00,202838,Staff,16,0,25,9
1683708604309,EDS 146,A01,202655,Staff,14,0,25,11
1683708605333,ENG 15,A00,185667,Staff,0,1,0,0
1683708605333,ENG 15,B00,185672,Staff,0,0,0,0
1683708605333,ENG 15,C00,185675,Staff,0,0,0,0
1683708605333,ENG 15,D00,185682,Staff,0,0,0,0
1683708605333,ENG 15,E00,185684,Staff,0,0,0,0
1683708606362,ETHN 103,A00,185710,Staff,0,8,35,35
1683708607395,ETHN 103A,A00,199228,Man; Simeon S,0,0,9,9
1683708608419,ETHN 109,A00,185711,Staff,15,0,35,20
1683708609449,ETHN 142,A00,185726,Staff,0,4,30,30
1683708610473,ETHN 163J,A00,199229,Man; Simeon S,5,0,8,3
1683708611498,ETHN 168,A00,185727,Staff,7,0,10,3
1683708612523,ETHN 182,A00,185728,Staff,0,0,35,35
1683708613551,ETHN 183,A00,185737,Staff,9,0,18,9
1683708614578,GLBH 111,A01,209361,Burgos; Jose L.,0,0,0,0
1683708616631,HIEU 104,A00,185792,Staff,14,0,20,6
1683708617657,HIEU 115,A00,185800,Staff,0,0,20,20
1683708618685,HIEU 128,A00,185801,Staff,0,9,20,20
1683708619708,HIEU 147,A00,185802,Staff,15,0,20,5
1683708620738,HIEU 154,A00,185823,Staff,11,0,20,9
1683708621764,HILA 102,A00,185826,Staff,14,0,20,6
1683708622793,HILD 2C,A01,185778,Staff,0,13,20,20
1683708623824,HILD 7B,A01,185780,Kwak; Nancy,0,17,32,32
1683708623824,HILD 7B,A02,185781,Kwak; Nancy,0,18,32,32
1683708624854,HILD 30,A01,185791,Staff,12,0,20,8
1683708625888,HISC 119,A00,185830,Golan; Tal,0,10,20,20
1683708626913,HITO 156GS,A00,185831,Patterson; Patrick H.,0,0,0,23
1683708627938,HIUS 103,A00,185832,Man; Simeon S,0,4,20,20
1683708628965,HIUS 117,A00,185836,Kwak; Nancy,2,0,20,18
1683708629989,HIUS 125,A00,185840,Man; Simeon S,0,2,23,23
1683708631018,HIUS 149,A00,185845,Staff,1,0,20,19
1683708632050,HUM 3,A01,185882,Zavodny; Tatiana Sophia,0,8,50,50
1683708632050,HUM 3,B01,185899,Caldwell; Michael Alan,0,18,50,50
1683708633077,HUM 3GS,A00,185900,Patterson; Patrick H.,0,0,0,23
1683708634105,HUM 4,A01,185938,Zroka; Amy Liane,28,0,50,22
1683708634105,HUM 4,B01,185956,Watkins; Eric,0,6,50,50
1683708634105,HUM 4,B02,202209,Watkins; Eric,0,5,50,50
1683708634105,HUM 4,B03,202210,Watkins; Eric,0,5,50,50
1683708635129,HUM 5,A01,185958,West; Geoffrey Scott,0,0,50,50
1683708635129,HUM 5,A02,202215,West; Geoffrey Scott,0,1,50,50
1683708636154,INTL 190,A00,185959,Gagnon; Jeffrey C,0,0,0,9
1683708636154,INTL 190,B00,185960,Lettieri; Michael Joseph,0,0,0,2
1683708637180,JAPN 180,A00,254509,Staff,5,0,30,25
1683708638217,LATI 10,A01,202853,Kennemore; Amy Michelle,4,0,35,31
1683708638217,LATI 10,A02,202854,Kennemore; Amy Michelle,3,0,35,32
1683708638217,LATI 10,A03,270054,Kennemore; Amy Michelle,30,0,30,0
1683708639248,LATI 180,A00,202855,Kennemore; Amy Michelle,11,0,20,9
1683708640272,LAWS 101,A00,201767,Golan; Tal,0,7,40,40
1683708641301,LIFR 1C,A00,185961,Staff,6,0,20,14
1683708642326,LIFR 1CX,A00,185962,Staff,7,0,20,13
1683708643349,LIFR 1D,A00,185963,Staff,7,0,20,13
1683708644376,LIFR 1DX,A00,185964,Staff,7,0,20,13
1683708645405,LIGN 101,A01,186039,Staff,43,0,50,7
1683708646430,LIGN 165,A00,186040,Staff,14,0,50,36
1683708647454,LTCS 108,A00,186041,Staff,5,0,10,5
1683708648483,LTCS 119,A00,186042,Staff,15,0,20,5
1683708649509,LTCS 130,A00,186043,Wesling; Megan E.,15,0,25,10
1683708651558,LTEA 138,A00,186119,Staff,14,0,40,26
1683708652584,LTEN 124,A00,186148,Staff,5,0,25,20
1683708653609,LTEN 178,A00,186149,Staff,6,0,15,9
1683708654636,LTEN 181,A00,186150,Blanco; John D,34,0,40,6
1683708655661,LTWL 120,A00,186160,Staff,19,0,25,6
1683708656688,LTWL 165,A00,186161,Staff,22,0,25,3
1683708657714,LTWR 100,A00,186162,Staff,0,5,15,15
1683708658747,LTWR 102,A00,186163,Doller; Ben,5,0,15,10
1683708659794,MAE 8,A01,186412,Staff,0,1,0,0
1683708660836,MAE 30B,A00,186445,Bahadori; Mohammad Yousef,81,0,100,19
1683708661869,MAE 40,A00,186592,Bewley; Thomas R,10,0,50,40
1683708662899,MAE 101B,A00,186593,Bahadori; Mohammad Yousef,80,0,100,20
1683708663931,MAE 105,A00,186594,Bandaru; Prabhakar,10,0,50,40
1683708664959,MAE 107,A00,186599,Pham; Hieu Tan,0,8,120,120
1683708665986,MAE 148,A01,186660,Silberman; Jack,3,0,16,13
1683708667025,MATH 10A,A01,188095,Staff,0,6,35,35
1683708668052,MATH 10B,A01,188097,Bowers; Adam R.,0,12,30,30
1683708668052,MATH 10B,A02,188099,Bowers; Adam R.,0,11,30,30
1683708668052,MATH 10B,B01,188104,Bowers; Adam R.,0,10,30,30
1683708668052,MATH 10B,B02,188106,Bowers; Adam R.,0,9,30,30
1683708669081,MATH 10C,A01,188111,Staff,0,20,30,30
1683708669081,MATH 10C,A02,188127,Staff,0,19,30,30
1683708669081,MATH 10C,A03,188131,Staff,0,19,30,30
1683708669081,MATH 10C,B01,188218,Staff,17,0,30,13
1683708669081,MATH 10C,B02,188244,Staff,13,0,30,17
1683708669081,MATH 10C,B03,188277,Staff,14,0,30,16
1683708670107,MATH 18,A01,188344,Bach; Quang Tran,18,0,30,12
1683708670107,MATH 18,A02,188345,Bach; Quang Tran,11,0,30,19
1683708670107,MATH 18,B01,188353,Bach; Quang Tran,11,0,30,19
1683708670107,MATH 18,B02,188354,Bach; Quang Tran,19,0,30,11
1683708671138,MATH 20A,A01,188374,Staff,11,0,35,24
1683708672172,MATH 20B,A01,188382,Ohm; Ko Woon,7,0,30,23
1683708672172,MATH 20B,A02,188383,Ohm; Ko Woon,22,0,30,8
1683708672172,MATH 20B,B01,188385,Ohm; Ko Woon,7,0,30,23
1683708672172,MATH 20B,B02,188392,Ohm; Ko Woon,22,0,30,8
1683708673238,MATH 20C,A01,188394,Harel; Guershon,10,0,30,20
1683708673238,MATH 20C,A02,188395,Harel; Guershon,13,0,30,17
1683708673238,MATH 20C,B01,188404,Harel; Guershon,5,0,30,25
1683708673238,MATH 20C,B02,188405,Harel; Guershon,18,0,30,12
1683708674267,MATH 20D,A01,188414,Hammock; Frances H,0,1,30,30
1683708674267,MATH 20D,A02,188415,Hammock; Frances H,0,1,30,30
1683708674267,MATH 20D,B01,188447,Hammock; Frances H,0,1,30,30
1683708674267,MATH 20D,B02,188486,Hammock; Frances H,2,0,30,28
1683708675349,MATH 20E,A01,188649,Staff,21,0,30,9
1683708675349,MATH 20E,A02,188650,Staff,20,0,30,10
1683708675349,MATH 20E,A03,188673,Staff,0,0,30,30
1683708676377,MATH 102,A01,188675,Staff,0,40,35,35
1683708677401,MATH 103B,A01,188681,Staff,3,0,35,32
1683708677401,MATH 103B,B01,188692,Staff,5,0,35,30
1683708678434,MATH 109,A01,188695,Salehi Golsefidy; Alireza,24,0,35,11
1683708678434,MATH 109,A02,188696,Salehi Golsefidy; Alireza,25,0,35,10
1683708679461,MATH 120A,A01,188698,Eggers; John Dietrich,7,0,35,28
1683708680485,MATH 142B,A01,188736,Ioana; Adrian,0,0,30,30
1683708680485,MATH 142B,A02,188741,Ioana; Adrian,0,1,30,30
1683708680485,MATH 142B,A03,188743,Ioana; Adrian,0,2,30,30
1683708681510,MATH 168A,A01,188790,Staff,0,11,35,35
1683708682542,MATH 170A,A01,188803,Nie; Jiawang,0,2,35,35
1683708682542,MATH 170A,A02,188811,Nie; Jiawang,0,1,35,35
1683708682542,MATH 170A,A03,188814,Nie; Jiawang,1,0,35,34
1683708682542,MATH 170A,A04,188815,Nie; Jiawang,5,0,35,30
1683708683568,MATH 193B,A01,188817,Staff,0,0,35,35
1683708683568,MATH 193B,A02,188818,Staff,6,0,35,29
1683708684594,MGT 4,A01,202857,Anderson; John Charles,59,0,80,21
1683708685620,MGT 12,A00,202858,Lindenberger; Wade Douglas,40,0,90,50
1683708686649,MGT 18,A00,202859,Staff,73,0,90,17
1683708687675,MGT 18GS,A00,202860,McKay; Michael J,13,0,28,15
1683708688707,MGT 45,A00,202861,Pecore; Joseph P.,8,0,90,82
1683708689737,MGT 100,A00,202863,Yavorsky; Daniel Ryan,27,0,90,63
1683708690768,MGT 103,A00,202864,Ehrich; Kristine R,0,19,90,90
1683708691794,MGT 112,A00,202865,Ehrich; Kristine R,15,0,90,75
1683708692822,MGT 121A,A00,202868,Staff,70,0,90,20
1683708693849,MGT 131B,A00,202869,Anderson; John Charles,58,0,90,32
1683708694881,MGT 136,A00,202871,Lindenberger; Wade Douglas,83,0,90,7
1683708695906,MGT 164,A00,202873,Staff,0,67,90,91
1683708696933,MGT 164GS,A00,202874,McKay; Mary A,13,0,28,15
1683708697959,MGT 180,A00,202875,Staff,0,51,90,91
1683708698990,MMW 11R,A01,205019,Herbst; Matthew,0,0,30,30
1683708698990,MMW 11R,A02,205026,Herbst; Matthew,29,0,30,1
1683708700022,MMW 15,A01,193512,Chang; Edmond Yi-Teh,0,8,28,28
1683708700022,MMW 15,A02,193513,Chang; Edmond Yi-Teh,0,5,28,28
1683708700022,MMW 15,A03,193514,Chang; Edmond Yi-Teh,0,5,28,28
1683708700022,MMW 15,A04,193515,Chang; Edmond Yi-Teh,0,5,28,28
1683708700022,MMW 15,A05,193516,Chang; Edmond Yi-Teh,0,5,28,28
1683708700022,MMW 15,A06,193517,Chang; Edmond Yi-Teh,0,6,28,28
1683708700022,MMW 15,B01,193519,Chang; Edmond Yi-Teh,0,5,28,28
1683708700022,MMW 15,B02,193520,Chang; Edmond Yi-Teh,0,5,28,28
1683708700022,MMW 15,B03,193521,Chang; Edmond Yi-Teh,0,5,28,28
1683708700022,MMW 15,B04,193522,Chang; Edmond Yi-Teh,0,6,28,28
1683708700022,MMW 15,B05,193523,Chang; Edmond Yi-Teh,0,5,28,28
1683708700022,MMW 15,B06,193524,Chang; Edmond Yi-Teh,0,5,28,28
1683708701047,MMW 122,A01,193526,Rahimi; Babak,0,16,28,28
1683708701047,MMW 122,A02,193527,Rahimi; Babak,0,15,28,28
1683708701047,MMW 122,A03,193528,Rahimi; Babak,0,0,0,0
1683708701047,MMW 122,A04,193529,Rahimi; Babak,0,0,0,0
1683708702073,MUS 1A,A01,186663,Staff,0,18,35,35
1683708703098,MUS 4,A01,186715,Staff,0,12,35,35
1683708704123,MUS 5R,A01,186796,Dubnov; Shlomo,0,17,35,35
1683708705149,MUS 6,A01,186798,Staff,0,4,25,25
1683708706178,MUS 7,A01,186830,Staff,11,0,35,24
1683708707209,MUS 8,A01,186930,Staff,0,27,35,35
1683708708241,MUS 15,A01,186932,Staff,0,15,35,35
1683708708241,MUS 15,B01,186934,Staff,0,16,35,35
1683708709266,MUS 80,A00,186935,Staff,0,0,20,20
1683708709266,MUS 80,B00,186936,Staff,24,0,25,1
1683708710290,NANO 11,A00,204702,Lipomi; Darren John,0,0,0,0
1683708711316,NANO 15,A01,204709,Yang; Kesong,0,1,0,0
1683708712341,NANO 114,A00,202069,Jahed Motlagh; Zeinab,2,0,10,8
1683708713426,PHIL 1,A00,186955,Grush; Rick Scott,31,0,40,9
1683708714458,PHIL 10,A01,186973,Grush; Rick Scott,27,0,35,8
1683708714458,PHIL 10,A02,186974,Grush; Rick Scott,33,0,35,2
1683708715491,PHIL 13,A01,186976,Staff,1,0,35,34
1683708715491,PHIL 13,A02,186977,Staff,16,0,35,19
1683708716517,PHIL 14,A01,186979,Staff,30,0,35,5
1683708716517,PHIL 14,A02,186986,Staff,32,0,35,3
1683708717542,PHIL 28,A01,186988,Staff,16,0,30,14
1683708717542,PHIL 28,A02,186989,Staff,0,0,30,30
1683708717542,PHIL 28,A03,186990,Staff,10,0,30,20
1683708717542,PHIL 28,A04,186991,Staff,26,0,30,4
1683708718568,PHIL 120,A00,186997,Staff,23,0,40,17
1683708719597,PHIL 137,A00,187003,Staff,7,0,40,33
1683708720622,PHIL 150,A00,187015,Staff,47,0,70,23
1683708721653,PHIL 167,A00,187021,Lamey; Andy M.,34,0,40,6
1683708722682,PHIL 174,A01,202226,Staff,17,0,20,3
1683708722682,PHIL 174,A02,202235,Staff,20,0,20,0
1683708723710,PHIL 191A,A00,258918,Staff,0,0,1,1
1683708724737,PHYS 1A,A00,187028,Staff,26,0,60,34
1683708725767,PHYS 1AL,001,187036,Staff,3,0,30,27
1683708725767,PHYS 1AL,002,187049,Staff,18,0,30,12
1683708726793,PHYS 1B,A00,187058,Staff,21,0,60,39
1683708727818,PHYS 1BL,001,187064,Staff,0,1,30,30
1683708727818,PHYS 1BL,002,187070,Staff,4,0,30,26
1683708728848,PHYS 1C,A00,187082,Staff,30,0,120,90
1683708729876,PHYS 1CL,001,187088,Staff,0,9,30,30
1683708729876,PHYS 1CL,002,187089,Staff,0,1,30,30
1683708729876,PHYS 1CL,009,262693,Staff,9,0,30,21
1683708730906,PHYS 2B,A01,187097,Staff,55,0,115,60
1683708731930,PHYS 2C,A01,187099,Staff,63,0,115,52
1683708732957,PHYS 2CL,A01,187101,Staff,5,0,28,23
1683708732957,PHYS 2CL,A02,187102,Staff,15,0,28,13
1683708733983,PHYS 2D,A01,187123,Shotwell; Brian,95,0,115,20
1683708735014,PHYS 4B,A01,187133,Grinstein; Benjamin,35,0,50,15
1683708736043,POLI 10,A00,188819,Staff,0,4,50,50
1683708737072,POLI 11,A00,188827,Staff,43,0,50,7
1683708738097,POLI 13R,A00,188828,Staff,0,1,20,20
1683708739121,POLI 27,A01,188830,Elgin; Samuel Zincke,0,2,70,70
1683708740151,POLI 30,A00,188832,Desposato; Scott,30,0,50,20
1683708741179,POLI 102F,A00,188834,Staff,1,0,40,39
1683708742202,POLI 104A,A00,188852,Staff,12,0,30,18
1683708743231,POLI 104I,A00,188853,Staff,0,8,20,20
1683708744263,POLI 110B,A00,188854,Wiens; David,6,0,20,14
1683708745293,POLI 112A,A00,188855,Wiens; David,3,0,30,27
1683708746317,POLI 117R,A00,188856,Forman; Fonna,0,12,20,20
1683708747342,POLI 118,A00,188857,Ingham; Sean,8,0,20,12
1683708748367,POLI 120G,A00,188858,Staff,7,0,30,23
1683708749406,POLI 131CR,A00,188863,Hoston; Germaine,20,0,50,30
1683708750432,POLI 133,A00,188864,Nellis; Gareth Hb,44,0,50,6
1683708751459,POLI 134D,A00,188865,Desposato; Scott,27,0,30,3
1683708752487,POLI 142A,A00,188871,Gartzke; Erik,21,0,50,29
1683708753516,POLI 142K,A00,188874,Staff,38,0,50,12
1683708754546,POLI 143,A00,188940,Gartzke; Erik,15,0,30,15
1683708755572,POLI 153,A00,188943,Staff,1,0,20,19
1683708756600,POLI 160AA,A00,188944,Staff,10,0,40,30
1683708757625,POLI 170A,A00,188945,Staff,10,0,30,20
1683708759681,PSYC 1,A00,188952,Staff,36,0,90,54
1683708760706,PSYC 2,B00,188953,Staff,19,0,35,16
1683708761731,PSYC 6,A00,188970,Staff,47,0,60,13
1683708762756,PSYC 7,A00,188973,Staff,35,0,45,10
1683708763791,PSYC 60,A01,188980,Rickard; Timothy C.,42,0,60,18
1683708764818,PSYC 70,A01,189001,Steiner; Eric Tomas,22,0,45,23
1683708765846,PSYC 100,A00,189005,Lacefield; Katharine I,1,98,120,119
1683708766876,PSYC 102,A00,189008,Staff,6,0,30,24
1683708767907,PSYC 106,B00,189026,Gorman; Michael R.,27,0,60,33
1683708768937,PSYC 114,B01,189033,Winkielman; Piotr,0,31,30,30
1683708769962,PSYC 131,A00,189036,Anagnostaras; Stephan,0,44,60,60
1683708770990,PSYC 136,A00,189041,Lowe; Angela Beth,0,7,25,25
1683708772020,PSYC 137,A00,189057,Winkielman; Piotr,0,36,25,25
1683708773046,PSYC 144,A00,189107,Wixted; John T,0,11,50,50
1683708775099,PSYC 162,A00,189142,Staff,0,9,85,85
1683708776131,PSYC 172,A00,189144,Gorman; Michael R.,0,6,30,30
1683708778184,PSYC 179,A00,189146,Lacefield; Katharine I,0,88,120,120
1683708779265,PSYC 181,A00,189147,Anagnostaras; Stephan,0,45,90,90
1683708780295,PSYC 190R,A00,189148,Barner; David A.,0,23,80,80
1683708781320,PSYC 191,A00,189275,Rickard; Timothy C.,0,11,25,25
1683708782346,PSYC 193,A00,189276,Chapman; Eddie Nathaniel,0,1,0,4
1683708783379,PSYC 193L,A01,189281,Lowe; Angela Beth,8,0,20,12
1683708783379,PSYC 193L,B01,189285,Staff,28,0,35,7
1683708784404,RELI 149,A00,187137,Rahimi; Babak,6,0,40,34
1683708785434,SE 9,A01,187315,Staff,0,2,18,18
1683708786463,SE 101B,A00,187409,Staff,24,0,30,6
1683708787495,SE 110B,A00,187444,Staff,10,0,40,30
1683708788526,SE 130B,A00,187449,Staff,31,0,40,9
1683708789561,SE 150A,A00,187516,Staff,8,0,20,12
1683708790587,SE 154,A00,187528,Staff,29,0,50,21
1683708791618,SIO 3,A01,258171,Staff,35,0,40,5
1683708792644,SIO 10,A00,187144,Cook; Geoffrey W,0,6,75,75
1683708793667,SIO 45,A00,187152,Cook; Geoffrey W,1,7,100,99
1683708794692,SIO 109R,A00,194486,Staff,0,4,20,20
1683708796755,SIO 187,A01,187233,Kacev; David,12,0,40,28
1683708797792,SOCI 1,A01,258656,Thorpe; Charles Robert,28,0,30,2
1683708797792,SOCI 1,A02,258658,Thorpe; Charles Robert,30,0,30,0
1683708797792,SOCI 1,A03,258661,Thorpe; Charles Robert,25,0,25,0
1683708797792,SOCI 1,A04,258666,Thorpe; Charles Robert,22,0,25,3
1683708797792,SOCI 1,A05,258897,Thorpe; Charles Robert,22,0,25,3
1683708797792,SOCI 1,A06,258898,Thorpe; Charles Robert,25,0,25,0
1683708798821,SOCI 30,A01,258903,Pardo Guerra; Juan Pablo,14,0,30,16
1683708799845,SOCI 102,A00,258904,Staff,9,0,25,16
1683708800873,SOCI 106,A00,258905,Staff,19,0,25,6
1683708801898,SOCI 111,A00,258907,Ribas Norris; Janet Vanesa,26,0,30,4
1683708802923,SOCI 121R,A00,258908,Pardo Guerra; Juan Pablo,7,0,30,23
1683708803950,SOCI 126,A01,203330,Staff,14,0,20,6
1683708804975,SOCI 131,A00,258909,Thorpe; Charles Robert,30,0,60,30
1683708806005,SOCI 135,A00,258910,Payne; Christine Anna,0,13,30,30
1683708807032,SOCI 157,A00,258911,Staff,10,0,30,20
1683708808056,SOCI 184,A00,258912,Staff,25,0,30,5
1683708809084,SOCI 188D,A00,258913,Staff,22,0,30,8
1683708810110,SYN 2,001,187529,Staff,9,0,16,7
1683708810110,SYN 2,002,201452,Staff,0,20,16,16
1683708810110,SYN 2,003,201469,Staff,1,0,16,15
1683708811134,SYN 100,A01,187531,Staff,0,9,20,20
1683708811134,SYN 100,B01,201491,Staff,0,10,20,20
1683708812168,TDAC 1,A00,189286,Walsh; Kim C.,3,0,20,17
1683708812168,TDAC 1,B00,189287,Harting; Carla Kelso,10,0,20,10
1683708813193,TDAC 101,A00,189300,Walsh; Kim C.,16,0,20,4
1683708813193,TDAC 101,B00,189301,Harting; Carla Kelso,18,0,20,2
1683708814219,TDAC 102,A00,189304,Basso; Beatrice,14,0,20,6
1683708815259,TDAC 108,A00,189305,Staff,18,0,20,2
1683708816292,TDDE 131,A00,189310,Staff,19,0,20,1
1683708816292,TDDE 131,B00,189314,Staff,19,0,20,1
1683708816292,TDDE 131,C00,189315,Staff,48,0,50,2
1683708816292,TDDE 131,D00,189316,Staff,14,0,15,1
1683708816292,TDDE 131,E00,204841,Staff,20,0,20,0
1683708817317,TDGE 10,A00,189289,Staff,27,0,50,23
1683708817317,TDGE 10,B00,189290,Havis; Allan,0,1,50,50
1683708818349,TDGE 11,A00,189291,Fulton; Julia,0,4,50,50
1683708818349,TDGE 11,B00,189292,Staff,20,0,25,5
1683708818349,TDGE 11,C00,260270,Staff,0,0,0,0
1683708819375,TDGE 25,A00,189294,Staff,1,0,20,19
1683708820402,TDGE 124,A00,189318,Fulton; Julia,0,7,50,50
1683708821430,TDGE 125,A00,189319,Staff,13,0,25,12
1683708821430,TDGE 125,B00,189320,Staff,23,0,25,2
1683708822457,TDGE 127,A00,189322,Havis; Allan,1,0,50,49
1683708823482,TDHT 101,A00,189323,Staff,18,0,25,7
1683708823482,TDHT 101,B00,189324,Staff,25,0,25,0
1683708824507,TDHT 102,A00,189325,Staff,49,0,50,1
1683708825536,TDMV 1,A00,189295,Arcidiacono; Kristin,20,0,30,10
1683708825536,TDMV 1,B00,189296,Caligagan; Maria T.,23,0,30,7
1683708826562,TDMV 2,A00,189297,Sammartano; Tonnie,27,0,30,3
1683708826562,TDMV 2,B00,189299,Arcidiacono; Kristin,23,0,30,7
1683708827591,TDMV 3,A00,204998,Rincon; Alicia,22,0,30,8
1683708828617,TDMV 120,A00,189458,Sammartano; Tonnie,28,0,30,2
1683708829645,TDMV 138,A00,189541,Jun; Grace Shin Hae,20,0,40,20
1683708830670,TDMV 142,A00,189717,Caligagan; Tony,25,0,30,5
1683708830670,TDMV 142,B00,189718,Caligagan; Maria T.,25,0,30,5
1683708831699,TMC 2,A01,187533,Staff,25,0,25,0
1683708831699,TMC 2,A02,187534,Staff,25,0,25,0
1683708832723,USP 1,A01,187536,Kwak; Nancy,0,16,25,25
1683708833751,USP 5,A01,187538,Staff,8,0,25,17
1683708834780,USP 101,A00,199253,Staff,0,4,0,0
1683708835806,USP 124,A00,187562,Boomhower; Matthew Charles,0,0,30,30
1683708836831,USP 138,A00,187582,Staff,19,0,25,6
1683708837856,USP 152,A01,187597,Staff,3,0,25,22
1683708838879,USP 153,A00,187598,Staff,18,0,25,7
1683708839907,USP 168,A00,187607,Kwak; Nancy,2,0,5,3
1683708840936,USP 173,A00,187619,Staff,4,0,25,21
1683708841966,USP 181,A00,187638,Staff,0,4,25,25
1683708842995,VIS 103,A00,187650,Cruz; Edwin Teddy,17,0,75,58
1683708844023,VIS 110D,A00,187669,Staff,13,0,22,9
1683708845054,VIS 127C,A00,187720,Shen; Kuiyi,67,0,146,79
1683708846082,VIS 149,A00,187731,Yoldas; Pinar,0,12,22,22
1683708847110,VIS 151,A01,188091,Staff,22,0,34,12
1683708847110,VIS 151,A02,188092,Staff,11,0,34,23
1683708848346,VIS 160B,A00,188093,Stalbaum; Brett,0,1,10,10
1683708850399,WCWP 10B,A00,201720,Staff,0,0,5,5
1683708850399,WCWP 10B,B00,201722,Staff,0,0,6,6
1683708851425,WCWP 100,A00,201725,Gagnon; Jeffrey C,0,0,2,2
1683708851425,WCWP 100,B00,201727,Staff,0,4,15,15
1683708854553,ANBI 133,A00,258401,Wilder; Linnea Lorene,34,0,40,6
1683708855582,ANBI 140,A00,258395,Hrvoj Mihic; Branka,18,0,25,7
1683708856610,ANSC 120,A00,258402,Bialecki; Jon Anthony,26,0,40,14
1683708857851,ANSC 144,A00,258400,Staff,12,0,40,28
1683708859907,ANSC 166,A00,258396,Parish; Steven Martin,156,0,175,19
1683708860931,ANSC 180,A00,193533,Staff,8,0,20,12
1683708861961,ANSC 188,A00,258397,Jassal; Aftab,34,0,40,6
1683708863415,ANTH 3,A01,258316,Staff,23,0,30,7
1683708864444,ANTH 5,A00,258394,Semendeferi; Ekaterini,16,0,20,4
1683708865469,ANTH 21,A01,258331,Staff,4,0,40,36
1683708866498,ANTH 103,A00,258398,Varma; Saiba,15,0,25,10
1683708867535,AWP 10,001,202034,Staff,0,0,0,0
1683708867535,AWP 10,002,202035,Staff,0,0,0,0
1683708867535,AWP 10,003,202036,Staff,0,0,0,0
1683708867535,AWP 10,004,202037,Staff,0,0,0,0
1683708867535,AWP 10,005,202038,Staff,0,0,0,0
1683708867535,AWP 10,006,202039,Staff,0,0,0,0
1683708867535,AWP 10,007,202040,Staff,0,0,0,0
1683708867535,AWP 10,008,202041,Staff,0,0,0,0
1683708867535,AWP 10,009,202042,Staff,0,0,0,0
1683708867535,AWP 10,010,202043,Staff,0,0,0,0
1683708867535,AWP 10,011,202044,Staff,0,0,0,0
1683708867535,AWP 10,012,202045,Staff,0,0,0,0
1683708867535,AWP 10,013,202046,Staff,0,0,0,0
1683708867535,AWP 10,014,202047,Staff,0,0,0,0
1683708867535,AWP 10,015,202048,Staff,0,0,0,0
1683708867535,AWP 10,016,202049,Staff,0,0,0,0
1683708867535,AWP 10,017,202050,Staff,0,0,0,0
1683708867535,AWP 10,018,202051,Staff,0,0,0,0
1683708867535,AWP 10,019,202052,Staff,0,0,0,0
1683708867535,AWP 10,020,202053,Staff,0,0,0,0
1683708867535,AWP 10,021,202054,Staff,0,0,0,0
1683708867535,AWP 10,022,202055,Staff,0,0,0,0
1683708867535,AWP 10,023,202056,Staff,0,0,0,0
1683708867535,AWP 10,024,202057,Staff,0,0,0,0
1683708867535,AWP 10,025,202058,Staff,0,0,0,0
1683708867535,AWP 10,026,202059,Staff,0,0,0,0
1683708868559,AWP 102,001,202032,Staff,0,0,0,0
1683708868559,AWP 102,002,202033,Staff,0,0,0,0
1683708869587,BENG 100,A01,254234,Taylor Amos; Alyssa C,31,0,40,9
1683708870615,BENG 196,001,270013,Engler; Adam J.,9999,0,9999,0
1683708871651,BICD 100R,A01,202018,Smith; Laurie,0,7,32,32
1683708871651,BICD 100R,A02,202019,Smith; Laurie,0,3,32,32
1683708871651,BICD 100R,A03,202020,Smith; Laurie,0,1,32,32
1683708871651,BICD 100R,A04,202021,Smith; Laurie,6,0,32,26
1683708871651,BICD 100R,A05,202022,Smith; Laurie,10,0,32,22
1683708872676,BICD 136,A01,193242,Gustafson-Brown; Cindy,0,2,32,32
1683708872676,BICD 136,A02,193244,Gustafson-Brown; Cindy,13,0,32,19
1683708873715,BIEB 102,A01,193249,Butler; Shannon Rhey,0,0,32,32
1683708873715,BIEB 102,A02,193251,Butler; Shannon Rhey,0,0,32,32
1683708873715,BIEB 102,A03,193253,Butler; Shannon Rhey,0,0,32,32
1683708873715,BIEB 102,A04,193255,Butler; Shannon Rhey,13,0,32,19
1683708873715,BIEB 102,A05,193265,Butler; Shannon Rhey,25,0,32,7
1683708873715,BIEB 102,A06,193269,Butler; Shannon Rhey,12,0,32,20
1683708875770,BIEB 150,A01,193274,Staff,0,0,32,32
1683708875770,BIEB 150,A02,193285,Staff,24,0,32,8
1683708876795,BIEB 194,A00,193286,Kurle; Carolyn M.,19,0,32,13
1683708877821,BILD 1,A01,192291,Staff,15,0,32,17
1683708877821,BILD 1,A02,192292,Staff,30,0,32,2
1683708877821,BILD 1,B01,192520,Reuther; Keefe,0,1,0,0
1683708877821,BILD 1,B02,192532,Reuther; Keefe,0,1,0,0
1683708878855,BILD 3,A01,192556,Butler; Shannon Rhey,0,0,32,32
1683708878855,BILD 3,A02,192581,Butler; Shannon Rhey,0,1,32,32
1683708878855,BILD 3,A03,192611,Butler; Shannon Rhey,19,0,32,13
1683708878855,BILD 3,A04,192612,Butler; Shannon Rhey,23,0,32,9
1683708878855,BILD 3,A05,192613,Butler; Shannon Rhey,26,0,32,6
1683708878855,BILD 3,A06,192679,Butler; Shannon Rhey,27,0,32,5
1683708878855,BILD 3,A07,192682,Butler; Shannon Rhey,20,0,32,12
1683708879887,BILD 4,A01,192836,Reuther; Keefe,1,0,24,23
1683708879887,BILD 4,A02,193044,Reuther; Keefe,4,0,24,20
1683708880914,BILD 10,A01,193142,Gustafson-Brown; Cindy,29,0,32,3
1683708880914,BILD 10,A02,193149,Gustafson-Brown; Cindy,31,0,32,1
1683708881938,BIMM 100,A01,193301,Staff,0,6,32,32
1683708881938,BIMM 100,A02,193312,Staff,0,7,32,32
1683708881938,BIMM 100,A03,193323,Staff,0,10,32,32
1683708882969,BIMM 101,A01,193329,McDonnell; Lisa Marie,0,3,24,24
1683708882969,BIMM 101,A02,193339,McDonnell; Lisa Marie,0,3,24,24
1683708882969,BIMM 101,B01,193354,McDonnell; Lisa Marie,0,4,24,24
1683708882969,BIMM 101,B02,193357,McDonnell; Lisa Marie,0,3,24,24
1683708884055,BIMM 110,A01,193377,Tat; John,0,11,32,32
1683708884055,BIMM 110,A02,193378,Tat; John,0,11,32,32
1683708885081,BIMM 120,A01,206116,Staff,0,0,32,32
1683708885081,BIMM 120,A02,206117,Staff,7,0,32,25
1683708885081,BIMM 120,A03,206121,Staff,21,0,32,11
1683708886108,BIPN 100,A01,193393,Park; Ji Young,0,15,32,32
1683708886108,BIPN 100,A02,193402,Park; Ji Young,0,14,32,32
1683708886108,BIPN 100,A03,193413,Park; Ji Young,0,14,32,32
1683708886108,BIPN 100,A04,193414,Park; Ji Young,0,13,32,32
1683708887135,BIPN 102,A01,193429,Staff,0,0,32,32
1683708887135,BIPN 102,A02,193438,Staff,18,0,32,14
1683708888161,BIPN 106,A01,193450,Reyes Gonzalez; Catalina,0,2,40,40
1683708889190,BIPN 134,A01,193465,Cooke; James Edward,0,0,32,32
1683708889190,BIPN 134,A02,193474,Cooke; James Edward,25,0,32,7
1683708889190,BIPN 134,A03,193485,Cooke; James Edward,29,0,32,3
1683708889190,BIPN 134,A04,193486,Cooke; James Edward,20,0,32,12
1683708889190,BIPN 134,A05,193491,Cooke; James Edward,31,0,32,1
1683708889190,BIPN 134,A06,193501,Cooke; James Edward,30,0,32,2
1683708889190,BIPN 134,A07,193510,Cooke; James Edward,29,0,32,3
1683708891251,BISP 194,A00,222522,Staff,14,0,32,18
1683708892276,CAT 124,A01,202407,Staff,19,0,25,6
1683708893302,CAT 125,A00,202408,Marchisotto; Jennifer Anne,2,0,20,18
1683708894334,CAT 125R,A00,202409,Smith; Lauryn Alissa,0,11,20,20
1683708894334,CAT 125R,B00,202410,Morales; Celeste Georgianna,0,11,20,20
1683708894334,CAT 125R,C00,202411,Irwin; Matthew Joseph,0,12,20,20
1683708895364,CENG 15,A01,204712,Yang; Kesong,0,1,0,0
1683708896388,CENG 114,A00,202070,Jahed Motlagh; Zeinab,5,0,20,15
1683708897427,CGS 105,A00,185477,Wesling; Megan E.,24,0,40,16
1683708898449,CGS 106,A00,185494,Staff,11,0,22,11
1683708899474,CGS 108,A00,185495,Staff,14,0,20,6
1683708900499,CGS 114,A00,185496,Staff,13,0,18,5
1683708901526,CGS 119,A00,185501,Staff,15,0,20,5
1683708902552,CGS 120,A00,185511,Staff,11,0,20,9
1683708903586,CHEM 4,A01,184675,Bussey; Thomas J,97,0,100,3
1683708904612,CHEM 6A,A01,184677,Staff,32,0,60,28
1683708905639,CHEM 6B,A01,184679,Staff,63,0,100,37
1683708906670,CHEM 6C,A01,184681,Bussey; Thomas J,0,0,50,50
1683708906670,CHEM 6C,A02,184682,Bussey; Thomas J,32,0,50,18
1683708907694,CHEM 40A,A01,184684,Albizati; Kim F.,33,0,100,67
1683708908725,CHEM 40B,A01,184686,Albizati; Kim F.,0,22,100,100
1683708909749,CHEM 41B,A01,184690,Staff,51,0,100,49
1683708910782,COGS 3,A01,184715,Boyle; Mary E. T.,0,27,40,40
1683708911807,COGS 14B,A01,185172,Staff,0,14,38,38
1683708912836,COGS 18,A01,184736,Staff,14,0,80,66
1683708913904,COGS 100,A01,184932,Staff,0,8,73,73
1683708914930,COGS 101A,A01,184935,Staff,0,40,30,30
1683708915955,COGS 101B,A01,184944,Staff,0,2,30,30
1683708916980,COGS 101C,A01,184946,Staff,0,10,30,30
1683708918005,COGS 102A,A01,184951,Johnson; Christine M.,1,0,40,39
1683708919029,COGS 107B,A01,184953,Mooshagian; Eric Frederick,0,52,40,40
1683708920061,COGS 118B,A01,184959,Gupta; Anjum,0,50,40,40
1683708921088,COGS 153,A00,184961,Staff,1,16,30,29
1683708922114,COGS 177,A00,184962,Staff,0,20,30,30
1683708923139,COGS 187A,A01,184969,Boyle; Mary E. T.,0,19,40,40
1683708924169,COMM 10,A01,185174,Staff,0,5,25,25
1683708924169,COMM 10,A02,185189,Staff,0,2,25,25
1683708924169,COMM 10,A03,269821,Staff,0,1,0,0
1683708925211,COMM 100B,A02,185476,Staff,10,0,25,15
1683708925211,COMM 100B,A03,277340,Staff,25,0,25,0
1683708926236,COMM 100C,A01,185314,Staff,2,0,25,23
1683708926236,COMM 100C,A02,185327,Staff,17,0,25,8
1683708927260,COMM 110M,A00,185349,Staff,0,0,40,40
1683708928287,COMM 113T,A00,185352,Staff,25,0,40,15
1683708929312,COMM 114I,A00,185353,Staff,31,0,40,9
1683708930340,COMM 131,A00,185354,Staff,17,0,30,13
1683708931374,CSE 8A,A50,185358,Cao; Yingjun,0,46,10,10
1683708932398,CSE 8B,A01,185362,Staff,0,48,50,50
1683708933424,CSE 11,A01,185416,Cao; Yingjun,0,91,10,10
1683708934452,CSE 20,A01,185445,Briones; Jor-el Thomas Caparas,3,0,25,22
1683708935481,CSE 21,A01,185447,Staff,9,0,50,41
1683708936512,CSE 101,A01,185451,Staff,0,13,50,50
1683708936512,CSE 101,B01,185453,Jones; Miles E,0,15,50,50
1683708938571,CSE 141,A01,185458,Eldon; John,16,0,100,84
1683708939599,CSE 141L,A01,185461,Eldon; John,8,0,100,92
1683708940627,CSE 142,A01,185463,Staff,34,0,60,26
1683708940627,CSE 142,B01,201355,Staff,0,7,60,60
1683708941653,CSE 142L,A01,185470,Staff,34,0,60,26
1683708941653,CSE 142L,B01,201417,Staff,0,6,60,60
1683708942678,CSE 190,A00,201433,Staff,32,0,49,17
1683708943702,DOC 1,A01,259136,Strom; Megan C.,7,0,15,8
1683708943702,DOC 1,A02,259137,Strom; Megan C.,15,0,15,0
1683708943702,DOC 1,A03,259138,Strom; Megan C.,14,0,15,1
1683708943702,DOC 1,A04,259139,Strom; Megan C.,14,0,15,1
1683708944730,DOC 100D,A00,259140,Pass; Natalye Joann,14,0,25,11
1683708945763,DSGN 1,A01,184749,Rill; Bryan,0,26,30,30
1683708946792,DSGN 100,A01,185168,Staff,0,2,25,25
1683708947827,ECE 5,A01,185626,Morris; Karcher William,0,12,0,0
1683708948854,ECE 101,A01,185628,Staff,14,0,70,56
1683708949884,ECE 107,A01,185635,Baghdadchi; Saharnaz,0,0,20,20
1683708949884,ECE 107,A02,185638,Baghdadchi; Saharnaz,1,0,20,19
1683708950913,ECE 148,A01,185647,Silberman; Jack,0,0,16,16
1683708951939,ECON 1,A01,185537,Crane; Meredith Helen,54,0,70,16
1683708952968,ECON 3,A01,185549,Crane; Meredith Helen,30,0,70,40
1683708953997,ECON 4,A01,203354,Anderson; John Charles,0,5,10,10
1683708955024,ECON 100A,A01,185574,Staff,0,5,40,40
1683708956049,ECON 100B,A01,185576,Staff,0,12,50,50
1683708957081,ECON 100C,A01,185589,Newhouse; Herbert S,30,0,70,40
1683708958105,ECON 105,A00,185608,Vespa; Emanuel Ignacio,19,0,35,16
1683708959133,ECON 109,A01,185610,Shishkin; Denis,9,0,35,26
1683708960162,ECON 110A,A01,185612,Staff,8,0,40,32
1683708961192,ECON 120A,A01,185615,Staff,19,0,40,21
1683708962218,ECON 120C,A01,185617,Sun; Yixiao,0,21,70,70
1683708963251,ECON 144,A00,203346,Squires; Dale E,2,0,35,33
1683708964280,ECON 171,A01,203349,Newhouse; Herbert S,0,1,35,35
1683708965311,ECON 173A,A01,185621,Toda; Alexis Akira,21,0,35,14
1683708966344,EDS 25,A01,202413,Staff,0,1,0,0
1683708966344,EDS 25,A02,202414,Staff,0,1,0,0
1683708966344,EDS 25,A03,202415,Staff,0,0,0,0
1683708966344,EDS 25,A04,202416,Staff,0,1,0,0
1683708966344,EDS 25,A05,202439,Staff,0,0,0,0
1683708966344,EDS 25,A06,202440,Staff,0,0,0,0
1683708966344,EDS 25,B01,202631,Staff,0,0,0,0
1683708966344,EDS 25,B02,202632,Staff,0,0,0,0
1683708966344,EDS 25,B03,202639,Staff,0,0,0,0
1683708966344,EDS 25,B04,202640,Staff,0,0,0,0
1683708966344,EDS 25,B05,202643,Staff,0,0,0,0
1683708966344,EDS 25,B06,202644,Staff,0,0,0,0
1683708967370,EDS 38,A01,202659,Black; Alison Michelle,25,0,25,0
1683708968394,EDS 115,A00,202652,Staff,18,0,30,12
1683708969428,EDS 125,A00,202649,Staff,13,0,30,17
1683708970490,EDS 126,A01,203332,Staff,30,0,30,0
1683708971515,EDS 139,A00,202838,Staff,16,0,25,9
1683708972540,EDS 146,A01,202655,Staff,14,0,25,11
1683708973569,ENG 15,A00,185667,Staff,0,1,0,0
1683708973569,ENG 15,B00,185672,Staff,0,0,0,0
1683708973569,ENG 15,C00,185675,Staff,0,0,0,0
1683708973569,ENG 15,D00,185682,Staff,0,0,0,0
1683708973569,ENG 15,E00,185684,Staff,0,0,0,0
1683708974598,ETHN 103,A00,185710,Staff,0,8,35,35
1683708975626,ETHN 103A,A00,199228,Man; Simeon S,0,0,9,9
1683708976651,ETHN 109,A00,185711,Staff,15,0,35,20
1683708977675,ETHN 142,A00,185726,Staff,0,4,30,30
1683708978706,ETHN 163J,A00,199229,Man; Simeon S,5,0,8,3
1683708979729,ETHN 168,A00,185727,Staff,7,0,10,3
1683708980754,ETHN 182,A00,185728,Staff,0,0,35,35
1683708981782,ETHN 183,A00,185737,Staff,9,0,18,9
1683708982813,GLBH 111,A01,209361,Burgos; Jose L.,0,0,0,0
1683708984866,HIEU 104,A00,185792,Staff,14,0,20,6
1683708985892,HIEU 115,A00,185800,Staff,0,0,20,20
1683708986919,HIEU 128,A00,185801,Staff,0,9,20,20
1683708988022,HIEU 147,A00,185802,Staff,15,0,20,5
1683708989049,HIEU 154,A00,185823,Staff,11,0,20,9
1683708990077,HILA 102,A00,185826,Staff,14,0,20,6
1683708991102,HILD 2C,A01,185778,Staff,0,13,20,20
1683708992142,HILD 7B,A01,185780,Kwak; Nancy,0,17,32,32
1683708992142,HILD 7B,A02,185781,Kwak; Nancy,0,18,32,32
1683708993168,HILD 30,A01,185791,Staff,12,0,20,8
1683708994214,HISC 119,A00,185830,Golan; Tal,0,10,20,20
1683708995242,HITO 156GS,A00,185831,Patterson; Patrick H.,0,0,0,23
1683708996267,HIUS 103,A00,185832,Man; Simeon S,0,4,20,20
1683708997294,HIUS 117,A00,185836,Kwak; Nancy,2,0,20,18
1683708998322,HIUS 125,A00,185840,Man; Simeon S,0,2,23,23
1683708999358,HIUS 149,A00,185845,Staff,1,0,20,19
1683709000384,HUM 3,A01,185882,Zavodny; Tatiana Sophia,0,8,50,50
1683709000384,HUM 3,B01,185899,Caldwell; Michael Alan,0,18,50,50
1683709001411,HUM 3GS,A00,185900,Patterson; Patrick H.,0,0,0,23
1683709002445,HUM 4,A01,185938,Zroka; Amy Liane,28,0,50,22
1683709002445,HUM 4,B01,185956,Watkins; Eric,0,6,50,50
1683709002445,HUM 4,B02,202209,Watkins; Eric,0,5,50,50
1683709002445,HUM 4,B03,202210,Watkins; Eric,0,5,50,50
1683709003471,HUM 5,A01,185958,West; Geoffrey Scott,0,0,50,50
1683709003471,HUM 5,A02,202215,West; Geoffrey Scott,0,1,50,50
1683709004500,INTL 190,A00,185959,Gagnon; Jeffrey C,0,0,0,9
1683709004500,INTL 190,B00,185960,Lettieri; Michael Joseph,0,0,0,2
1683709005526,JAPN 180,A00,254509,Staff,5,0,30,25
1683709006554,LATI 10,A01,202853,Kennemore; Amy Michelle,4,0,35,31
1683709006554,LATI 10,A02,202854,Kennemore; Amy Michelle,3,0,35,32
1683709006554,LATI 10,A03,270054,Kennemore; Amy Michelle,30,0,30,0
1683709007579,LATI 180,A00,202855,Kennemore; Amy Michelle,11,0,20,9
1683709008610,LAWS 101,A00,201767,Golan; Tal,0,7,40,40
1683709009640,LIFR 1C,A00,185961,Staff,6,0,20,14
1683709010666,LIFR 1CX,A00,185962,Staff,7,0,20,13
1683709011694,LIFR 1D,A00,185963,Staff,7,0,20,13
1683709012719,LIFR 1DX,A00,185964,Staff,7,0,20,13
1683709013748,LIGN 101,A01,186039,Staff,43,0,50,7
1683709014777,LIGN 165,A00,186040,Staff,14,0,50,36
1683709015802,LTCS 108,A00,186041,Staff,5,0,10,5
1683709016830,LTCS 119,A00,186042,Staff,15,0,20,5
1683709017857,LTCS 130,A00,186043,Wesling; Megan E.,15,0,25,10
1683709019908,LTEA 138,A00,186119,Staff,14,0,40,26
1683709020932,LTEN 124,A00,186148,Staff,5,0,25,20
1683709021960,LTEN 178,A00,186149,Staff,6,0,15,9
1683709022991,LTEN 181,A00,186150,Blanco; John D,34,0,40,6
1683709024023,LTWL 120,A00,186160,Staff,19,0,25,6
1683709025047,LTWL 165,A00,186161,Staff,22,0,25,3
1683709026071,LTWR 100,A00,186162,Staff,0,5,15,15
1683709027100,LTWR 102,A00,186163,Doller; Ben,5,0,15,10
1683709028131,MAE 8,A01,186412,Staff,0,1,0,0
1683709029167,MAE 30B,A00,186445,Bahadori; Mohammad Yousef,81,0,100,19
1683709030193,MAE 40,A00,186592,Bewley; Thomas R,10,0,50,40
1683709031219,MAE 101B,A00,186593,Bahadori; Mohammad Yousef,80,0,100,20
1683709032249,MAE 105,A00,186594,Bandaru; Prabhakar,10,0,50,40
1683709033280,MAE 107,A00,186599,Pham; Hieu Tan,0,8,120,120
1683709034310,MAE 148,A01,186660,Silberman; Jack,3,0,16,13
1683709035335,MATH 10A,A01,188095,Staff,0,6,35,35
1683709036359,MATH 10B,A01,188097,Bowers; Adam R.,0,12,30,30
1683709036359,MATH 10B,A02,188099,Bowers; Adam R.,0,11,30,30
1683709036359,MATH 10B,B01,188104,Bowers; Adam R.,0,10,30,30
1683709036359,MATH 10B,B02,188106,Bowers; Adam R.,0,9,30,30
1683709037395,MATH 10C,A01,188111,Staff,0,20,30,30
1683709037395,MATH 10C,A02,188127,Staff,0,19,30,30
1683709037395,MATH 10C,A03,188131,Staff,0,19,30,30
1683709037395,MATH 10C,B01,188218,Staff,17,0,30,13
1683709037395,MATH 10C,B02,188244,Staff,13,0,30,17
1683709037395,MATH 10C,B03,188277,Staff,14,0,30,16
1683709038420,MATH 18,A01,188344,Bach; Quang Tran,18,0,30,12
1683709038420,MATH 18,A02,188345,Bach; Quang Tran,11,0,30,19
1683709038420,MATH 18,B01,188353,Bach; Quang Tran,11,0,30,19
1683709038420,MATH 18,B02,188354,Bach; Quang Tran,19,0,30,11
1683709039445,MATH 20A,A01,188374,Staff,11,0,35,24
1683709040476,MATH 20B,A01,188382,Ohm; Ko Woon,7,0,30,23
1683709040476,MATH 20B,A02,188383,Ohm; Ko Woon,22,0,30,8
1683709040476,MATH 20B,B01,188385,Ohm; Ko Woon,7,0,30,23
1683709040476,MATH 20B,B02,188392,Ohm; Ko Woon,22,0,30,8
1683709041507,MATH 20C,A01,188394,Harel; Guershon,10,0,30,20
1683709041507,MATH 20C,A02,188395,Harel; Guershon,13,0,30,17
1683709041507,MATH 20C,B01,188404,Harel; Guershon,5,0,30,25
1683709041507,MATH 20C,B02,188405,Harel; Guershon,18,0,30,12
1683709042538,MATH 20D,A01,188414,Hammock; Frances H,0,1,30,30
1683709042538,MATH 20D,A02,188415,Hammock; Frances H,0,1,30,30
1683709042538,MATH 20D,B01,188447,Hammock; Frances H,0,1,30,30
1683709042538,MATH 20D,B02,188486,Hammock; Frances H,2,0,30,28
1683709043564,MATH 20E,A01,188649,Staff,21,0,30,9
1683709043564,MATH 20E,A02,188650,Staff,20,0,30,10
1683709043564,MATH 20E,A03,188673,Staff,0,0,30,30
1683709044589,MATH 102,A01,188675,Staff,0,40,35,35
1683709045621,MATH 103B,A01,188681,Staff,3,0,35,32
1683709045621,MATH 103B,B01,188692,Staff,5,0,35,30
1683709046650,MATH 109,A01,188695,Salehi Golsefidy; Alireza,24,0,35,11
1683709046650,MATH 109,A02,188696,Salehi Golsefidy; Alireza,25,0,35,10
1683709047688,MATH 120A,A01,188698,Eggers; John Dietrich,7,0,35,28
1683709048722,MATH 142B,A01,188736,Ioana; Adrian,0,0,30,30
1683709048722,MATH 142B,A02,188741,Ioana; Adrian,0,1,30,30
1683709048722,MATH 142B,A03,188743,Ioana; Adrian,0,2,30,30
1683709049753,MATH 168A,A01,188790,Staff,0,11,35,35
1683709050785,MATH 170A,A01,188803,Nie; Jiawang,0,2,35,35
1683709050785,MATH 170A,A02,188811,Nie; Jiawang,0,1,35,35
1683709050785,MATH 170A,A03,188814,Nie; Jiawang,1,0,35,34
1683709050785,MATH 170A,A04,188815,Nie; Jiawang,5,0,35,30
1683709051809,MATH 193B,A01,188817,Staff,0,0,35,35
1683709051809,MATH 193B,A02,188818,Staff,6,0,35,29
1683709052869,MGT 4,A01,202857,Anderson; John Charles,59,0,80,21
1683709053898,MGT 12,A00,202858,Lindenberger; Wade Douglas,40,0,90,50
1683709054923,MGT 18,A00,202859,Staff,73,0,90,17
1683709055953,MGT 18GS,A00,202860,McKay; Michael J,13,0,28,15
1683709056977,MGT 45,A00,202861,Pecore; Joseph P.,8,0,90,82
1683709058004,MGT 100,A00,202863,Yavorsky; Daniel Ryan,27,0,90,63
1683709059041,MGT 103,A00,202864,Ehrich; Kristine R,0,19,90,90
1683709060077,MGT 112,A00,202865,Ehrich; Kristine R,15,0,90,75
1683709061103,MGT 121A,A00,202868,Staff,70,0,90,20
1683709062131,MGT 131B,A00,202869,Anderson; John Charles,58,0,90,32
1683709063156,MGT 136,A00,202871,Lindenberger; Wade Douglas,83,0,90,7
1683709064181,MGT 164,A00,202873,Staff,0,67,90,91
1683709065206,MGT 164GS,A00,202874,McKay; Mary A,13,0,28,15
1683709066231,MGT 180,A00,202875,Staff,0,51,90,91
1683709067254,MMW 11R,A01,205019,Herbst; Matthew,0,0,30,30
1683709067254,MMW 11R,A02,205026,Herbst; Matthew,29,0,30,1
1683709068285,MMW 15,A01,193512,Chang; Edmond Yi-Teh,0,8,28,28
1683709068285,MMW 15,A02,193513,Chang; Edmond Yi-Teh,0,5,28,28
1683709068285,MMW 15,A03,193514,Chang; Edmond Yi-Teh,0,5,28,28
1683709068285,MMW 15,A04,193515,Chang; Edmond Yi-Teh,0,5,28,28
1683709068285,MMW 15,A05,193516,Chang; Edmond Yi-Teh,0,5,28,28
1683709068285,MMW 15,A06,193517,Chang; Edmond Yi-Teh,0,6,28,28
1683709068285,MMW 15,B01,193519,Chang; Edmond Yi-Teh,0,5,28,28
1683709068285,MMW 15,B02,193520,Chang; Edmond Yi-Teh,0,5,28,28
1683709068285,MMW 15,B03,193521,Chang; Edmond Yi-Teh,0,5,28,28
1683709068285,MMW 15,B04,193522,Chang; Edmond Yi-Teh,0,6,28,28
1683709068285,MMW 15,B05,193523,Chang; Edmond Yi-Teh,0,5,28,28
1683709068285,MMW 15,B06,193524,Chang; Edmond Yi-Teh,0,5,28,28
1683709069311,MMW 122,A01,193526,Rahimi; Babak,0,16,28,28
1683709069311,MMW 122,A02,193527,Rahimi; Babak,0,15,28,28
1683709069311,MMW 122,A03,193528,Rahimi; Babak,0,0,0,0
1683709069311,MMW 122,A04,193529,Rahimi; Babak,0,0,0,0
1683709070338,MUS 1A,A01,186663,Staff,0,18,35,35
1683709071365,MUS 4,A01,186715,Staff,0,12,35,35
1683709072399,MUS 5R,A01,186796,Dubnov; Shlomo,0,17,35,35
1683709073425,MUS 6,A01,186798,Staff,0,4,25,25
1683709074449,MUS 7,A01,186830,Staff,11,0,35,24
1683709075473,MUS 8,A01,186930,Staff,0,27,35,35
1683709076538,MUS 15,A01,186932,Staff,0,15,35,35
1683709076538,MUS 15,B01,186934,Staff,0,16,35,35
1683709077564,MUS 80,A00,186935,Staff,0,0,20,20
1683709077564,MUS 80,B00,186936,Staff,24,0,25,1
1683709078589,NANO 11,A00,204702,Lipomi; Darren John,0,0,0,0
1683709079617,NANO 15,A01,204709,Yang; Kesong,0,1,0,0
1683709080643,NANO 114,A00,202069,Jahed Motlagh; Zeinab,2,0,10,8
1683709081670,PHIL 1,A00,186955,Grush; Rick Scott,31,0,40,9
1683709082700,PHIL 10,A01,186973,Grush; Rick Scott,27,0,35,8
1683709082700,PHIL 10,A02,186974,Grush; Rick Scott,33,0,35,2
1683709083725,PHIL 13,A01,186976,Staff,1,0,35,34
1683709083725,PHIL 13,A02,186977,Staff,16,0,35,19
1683709084750,PHIL 14,A01,186979,Staff,30,0,35,5
1683709084750,PHIL 14,A02,186986,Staff,32,0,35,3
1683709085784,PHIL 28,A01,186988,Staff,16,0,30,14
1683709085784,PHIL 28,A02,186989,Staff,0,0,30,30
1683709085784,PHIL 28,A03,186990,Staff,10,0,30,20
1683709085784,PHIL 28,A04,186991,Staff,26,0,30,4
1683709086809,PHIL 120,A00,186997,Staff,23,0,40,17
1683709087835,PHIL 137,A00,187003,Staff,7,0,40,33
1683709088859,PHIL 150,A00,187015,Staff,47,0,70,23
1683709089888,PHIL 167,A00,187021,Lamey; Andy M.,34,0,40,6
1683709090914,PHIL 174,A01,202226,Staff,17,0,20,3
1683709090914,PHIL 174,A02,202235,Staff,20,0,20,0
1683709091998,PHIL 191A,A00,258918,Staff,0,0,1,1
1683709093036,PHYS 1A,A00,187028,Staff,26,0,60,34
1683709094061,PHYS 1AL,001,187036,Staff,3,0,30,27
1683709094061,PHYS 1AL,002,187049,Staff,18,0,30,12
1683709095085,PHYS 1B,A00,187058,Staff,21,0,60,39
1683709096115,PHYS 1BL,001,187064,Staff,0,1,30,30
1683709096115,PHYS 1BL,002,187070,Staff,4,0,30,26
1683709097141,PHYS 1C,A00,187082,Staff,30,0,120,90
1683709098168,PHYS 1CL,001,187088,Staff,0,9,30,30
1683709098168,PHYS 1CL,002,187089,Staff,0,1,30,30
1683709098168,PHYS 1CL,009,262693,Staff,9,0,30,21
1683709099196,PHYS 2B,A01,187097,Staff,55,0,115,60
1683709100226,PHYS 2C,A01,187099,Staff,63,0,115,52
1683709101257,PHYS 2CL,A01,187101,Staff,5,0,28,23
1683709101257,PHYS 2CL,A02,187102,Staff,15,0,28,13
1683709102280,PHYS 2D,A01,187123,Shotwell; Brian,95,0,115,20
1683709103306,PHYS 4B,A01,187133,Grinstein; Benjamin,35,0,50,15
1683709104337,POLI 10,A00,188819,Staff,0,4,50,50
1683709105362,POLI 11,A00,188827,Staff,43,0,50,7
1683709106389,POLI 13R,A00,188828,Staff,0,1,20,20
1683709107415,POLI 27,A01,188830,Elgin; Samuel Zincke,0,2,70,70
1683709108440,POLI 30,A00,188832,Desposato; Scott,30,0,50,20
1683709109469,POLI 102F,A00,188834,Staff,1,0,40,39
1683709110495,POLI 104A,A00,188852,Staff,12,0,30,18
1683709111521,POLI 104I,A00,188853,Staff,0,8,20,20
1683709112547,POLI 110B,A00,188854,Wiens; David,6,0,20,14
1683709113576,POLI 112A,A00,188855,Wiens; David,3,0,30,27
1683709114602,POLI 117R,A00,188856,Forman; Fonna,0,12,20,20
1683709115631,POLI 118,A00,188857,Ingham; Sean,8,0,20,12
1683709116659,POLI 120G,A00,188858,Staff,7,0,30,23
1683709117688,POLI 131CR,A00,188863,Hoston; Germaine,20,0,50,30
1683709118714,POLI 133,A00,188864,Nellis; Gareth Hb,44,0,50,6
1683709119742,POLI 134D,A00,188865,Desposato; Scott,27,0,30,3
1683709120767,POLI 142A,A00,188871,Gartzke; Erik,21,0,50,29
1683709121796,POLI 142K,A00,188874,Staff,38,0,50,12
1683709122825,POLI 143,A00,188940,Gartzke; Erik,15,0,30,15
1683709123850,POLI 153,A00,188943,Staff,1,0,20,19
1683709124880,POLI 160AA,A00,188944,Staff,10,0,40,30
1683709125906,POLI 170A,A00,188945,Staff,10,0,30,20
1683709127956,PSYC 1,A00,188952,Staff,36,0,90,54
1683709128984,PSYC 2,B00,188953,Staff,19,0,35,16
1683709130010,PSYC 6,A00,188970,Staff,47,0,60,13
1683709131034,PSYC 7,A00,188973,Staff,35,0,45,10
1683709132066,PSYC 60,A01,188980,Rickard; Timothy C.,42,0,60,18
1683709133092,PSYC 70,A01,189001,Steiner; Eric Tomas,22,0,45,23
1683709134118,PSYC 100,A00,189005,Lacefield; Katharine I,1,98,120,119
1683709135143,PSYC 102,A00,189008,Staff,6,0,30,24
1683709136171,PSYC 106,B00,189026,Gorman; Michael R.,27,0,60,33
1683709137197,PSYC 114,B01,189033,Winkielman; Piotr,0,31,30,30
1683709138226,PSYC 131,A00,189036,Anagnostaras; Stephan,0,44,60,60
1683709139255,PSYC 136,A00,189041,Lowe; Angela Beth,0,7,25,25
1683709140287,PSYC 137,A00,189057,Winkielman; Piotr,0,36,25,25
1683709141319,PSYC 144,A00,189107,Wixted; John T,0,11,50,50
1683709143375,PSYC 162,A00,189142,Staff,0,9,85,85
1683709144400,PSYC 172,A00,189144,Gorman; Michael R.,0,6,30,30
1683709146450,PSYC 179,A00,189146,Lacefield; Katharine I,0,88,120,120
1683709147479,PSYC 181,A00,189147,Anagnostaras; Stephan,0,45,90,90
1683709148504,PSYC 190R,A00,189148,Barner; David A.,0,23,80,80
1683709149529,PSYC 191,A00,189275,Rickard; Timothy C.,0,11,25,25
1683709150555,PSYC 193,A00,189276,Chapman; Eddie Nathaniel,0,1,0,4
1683709151580,PSYC 193L,A01,189281,Lowe; Angela Beth,8,0,20,12
1683709151580,PSYC 193L,B01,189285,Staff,28,0,35,7
1683709152607,RELI 149,A00,187137,Rahimi; Babak,6,0,40,34
1683709153632,SE 9,A01,187315,Staff,0,2,18,18
1683709154656,SE 101B,A00,187409,Staff,24,0,30,6
1683709155682,SE 110B,A00,187444,Staff,10,0,40,30
1683709156705,SE 130B,A00,187449,Staff,31,0,40,9
1683709157732,SE 150A,A00,187516,Staff,8,0,20,12
1683709158760,SE 154,A00,187528,Staff,29,0,50,21
1683709159785,SIO 3,A01,258171,Staff,35,0,40,5
1683709160817,SIO 10,A00,187144,Cook; Geoffrey W,0,6,75,75
1683709161842,SIO 45,A00,187152,Cook; Geoffrey W,1,7,100,99
1683709162866,SIO 109R,A00,194486,Staff,0,4,20,20
1683709164919,SIO 187,A01,187233,Kacev; David,12,0,40,28
1683709165947,SOCI 1,A01,258656,Thorpe; Charles Robert,28,0,30,2
1683709165947,SOCI 1,A02,258658,Thorpe; Charles Robert,30,0,30,0
1683709165947,SOCI 1,A03,258661,Thorpe; Charles Robert,25,0,25,0
1683709165947,SOCI 1,A04,258666,Thorpe; Charles Robert,22,0,25,3
1683709165947,SOCI 1,A05,258897,Thorpe; Charles Robert,22,0,25,3
1683709165947,SOCI 1,A06,258898,Thorpe; Charles Robert,25,0,25,0
1683709166976,SOCI 30,A01,258903,Pardo Guerra; Juan Pablo,14,0,30,16
1683709168006,SOCI 102,A00,258904,Staff,9,0,25,16
1683709169034,SOCI 106,A00,258905,Staff,19,0,25,6
1683709170065,SOCI 111,A00,258907,Ribas Norris; Janet Vanesa,26,0,30,4
1683709171089,SOCI 121R,A00,258908,Pardo Guerra; Juan Pablo,7,0,30,23
1683709172114,SOCI 126,A01,203330,Staff,14,0,20,6
1683709173138,SOCI 131,A00,258909,Thorpe; Charles Robert,30,0,60,30
1683709174166,SOCI 135,A00,258910,Payne; Christine Anna,0,13,30,30
1683709175193,SOCI 157,A00,258911,Staff,10,0,30,20
1683709176216,SOCI 184,A00,258912,Staff,25,0,30,5
1683709177240,SOCI 188D,A00,258913,Staff,22,0,30,8
1683709178269,SYN 2,001,187529,Staff,9,0,16,7
1683709178269,SYN 2,002,201452,Staff,0,20,16,16
1683709178269,SYN 2,003,201469,Staff,1,0,16,15
1683709179298,SYN 100,A01,187531,Staff,0,9,20,20
1683709179298,SYN 100,B01,201491,Staff,0,10,20,20
1683709180324,TDAC 1,A00,189286,Walsh; Kim C.,3,0,20,17
1683709180324,TDAC 1,B00,189287,Harting; Carla Kelso,10,0,20,10
1683709181349,TDAC 101,A00,189300,Walsh; Kim C.,16,0,20,4
1683709181349,TDAC 101,B00,189301,Harting; Carla Kelso,18,0,20,2
1683709182377,TDAC 102,A00,189304,Basso; Beatrice,14,0,20,6
1683709183405,TDAC 108,A00,189305,Staff,18,0,20,2
1683709184431,TDDE 131,A00,189310,Staff,19,0,20,1
1683709184431,TDDE 131,B00,189314,Staff,19,0,20,1
1683709184431,TDDE 131,C00,189315,Staff,48,0,50,2
1683709184431,TDDE 131,D00,189316,Staff,14,0,15,1
1683709184431,TDDE 131,E00,204841,Staff,20,0,20,0
1683709185459,TDGE 10,A00,189289,Staff,27,0,50,23
1683709185459,TDGE 10,B00,189290,Havis; Allan,0,1,50,50
1683709186486,TDGE 11,A00,189291,Fulton; Julia,0,4,50,50
1683709186486,TDGE 11,B00,189292,Staff,20,0,25,5
1683709186486,TDGE 11,C00,260270,Staff,0,0,0,0
1683709187512,TDGE 25,A00,189294,Staff,1,0,20,19
1683709188537,TDGE 124,A00,189318,Fulton; Julia,0,7,50,50
1683709189563,TDGE 125,A00,189319,Staff,13,0,25,12
1683709189563,TDGE 125,B00,189320,Staff,23,0,25,2
1683709190588,TDGE 127,A00,189322,Havis; Allan,1,0,50,49
1683709191613,TDHT 101,A00,189323,Staff,18,0,25,7
1683709191613,TDHT 101,B00,189324,Staff,25,0,25,0
1683709192642,TDHT 102,A00,189325,Staff,49,0,50,1
1683709193675,TDMV 1,A00,189295,Arcidiacono; Kristin,20,0,30,10
1683709193675,TDMV 1,B00,189296,Caligagan; Maria T.,23,0,30,7
1683709194702,TDMV 2,A00,189297,Sammartano; Tonnie,27,0,30,3
1683709194702,TDMV 2,B00,189299,Arcidiacono; Kristin,23,0,30,7
1683709195785,TDMV 3,A00,204998,Rincon; Alicia,22,0,30,8
1683709196810,TDMV 120,A00,189458,Sammartano; Tonnie,28,0,30,2
1683709197840,TDMV 138,A00,189541,Jun; Grace Shin Hae,20,0,40,20
1683709198869,TDMV 142,A00,189717,Caligagan; Tony,25,0,30,5
1683709198869,TDMV 142,B00,189718,Caligagan; Maria T.,25,0,30,5
1683709199897,TMC 2,A01,187533,Staff,25,0,25,0
1683709199897,TMC 2,A02,187534,Staff,25,0,25,0
1683709200926,USP 1,A01,187536,Kwak; Nancy,0,16,25,25
1683709201955,USP 5,A01,187538,Staff,8,0,25,17
1683709202983,USP 101,A00,199253,Staff,0,4,0,0
1683709204010,USP 124,A00,187562,Boomhower; Matthew Charles,0,0,30,30
1683709205034,USP 138,A00,187582,Staff,19,0,25,6
1683709206058,USP 152,A01,187597,Staff,3,0,25,22
1683709207082,USP 153,A00,187598,Staff,18,0,25,7
1683709208107,USP 168,A00,187607,Kwak; Nancy,2,0,5,3
1683709209134,USP 173,A00,187619,Staff,4,0,25,21
1683709210160,USP 181,A00,187638,Staff,0,4,25,25
1683709211188,VIS 103,A00,187650,Cruz; Edwin Teddy,17,0,75,58
1683709212215,VIS 110D,A00,187669,Staff,13,0,22,9
1683709213240,VIS 127C,A00,187720,Shen; Kuiyi,67,0,146,79
1683709214365,VIS 149,A00,187731,Yoldas; Pinar,0,12,22,22
1683709215390,VIS 151,A01,188091,Staff,22,0,34,12
1683709215390,VIS 151,A02,188092,Staff,11,0,34,23
1683709216415,VIS 160B,A00,188093,Stalbaum; Brett,0,1,10,10
1683709218467,WCWP 10B,A00,201720,Staff,0,0,5,5
1683709218467,WCWP 10B,B00,201722,Staff,0,0,6,6
1683709219493,WCWP 100,A00,201725,Gagnon; Jeffrey C,0,0,2,2
1683709219493,WCWP 100,B00,201727,Staff,0,4,15,15
1683709222662,ANBI 133,A00,258401,Wilder; Linnea Lorene,34,0,40,6
1683709223686,ANBI 140,A00,258395,Hrvoj Mihic; Branka,18,0,25,7
1683709224716,ANSC 120,A00,258402,Bialecki; Jon Anthony,26,0,40,14
1683709225741,ANSC 144,A00,258400,Staff,12,0,40,28
1683709227799,ANSC 166,A00,258396,Parish; Steven Martin,156,0,175,19
1683709228823,ANSC 180,A00,193533,Staff,8,0,20,12
1683709229852,ANSC 188,A00,258397,Jassal; Aftab,34,0,40,6
1683709230880,ANTH 3,A01,258316,Staff,23,0,30,7
1683709231904,ANTH 5,A00,258394,Semendeferi; Ekaterini,16,0,20,4
1683709232932,ANTH 21,A01,258331,Staff,4,0,40,36
1683709233956,ANTH 103,A00,258398,Varma; Saiba,15,0,25,10
1683709234983,AWP 10,001,202034,Staff,0,0,0,0
1683709234983,AWP 10,002,202035,Staff,0,0,0,0
1683709234983,AWP 10,003,202036,Staff,0,0,0,0
1683709234983,AWP 10,004,202037,Staff,0,0,0,0
1683709234983,AWP 10,005,202038,Staff,0,0,0,0
1683709234983,AWP 10,006,202039,Staff,0,0,0,0
1683709234983,AWP 10,007,202040,Staff,0,0,0,0
1683709234983,AWP 10,008,202041,Staff,0,0,0,0
1683709234983,AWP 10,009,202042,Staff,0,0,0,0
1683709234983,AWP 10,010,202043,Staff,0,0,0,0
1683709234983,AWP 10,011,202044,Staff,0,0,0,0
1683709234983,AWP 10,012,202045,Staff,0,0,0,0
1683709234983,AWP 10,013,202046,Staff,0,0,0,0
1683709234983,AWP 10,014,202047,Staff,0,0,0,0
1683709234983,AWP 10,015,202048,Staff,0,0,0,0
1683709234983,AWP 10,016,202049,Staff,0,0,0,0
1683709234983,AWP 10,017,202050,Staff,0,0,0,0
1683709234983,AWP 10,018,202051,Staff,0,0,0,0
1683709234983,AWP 10,019,202052,Staff,0,0,0,0
1683709234983,AWP 10,020,202053,Staff,0,0,0,0
1683709234983,AWP 10,021,202054,Staff,0,0,0,0
1683709234983,AWP 10,022,202055,Staff,0,0,0,0
1683709234983,AWP 10,023,202056,Staff,0,0,0,0
1683709234983,AWP 10,024,202057,Staff,0,0,0,0
1683709234983,AWP 10,025,202058,Staff,0,0,0,0
1683709234983,AWP 10,026,202059,Staff,0,0,0,0
1683709236010,AWP 102,001,202032,Staff,0,0,0,0
1683709236010,AWP 102,002,202033,Staff,0,0,0,0
1683709237040,BENG 100,A01,254234,Taylor Amos; Alyssa C,31,0,40,9
1683709238064,BENG 196,001,270013,Engler; Adam J.,9999,0,9999,0
1683709239090,BICD 100R,A01,202018,Smith; Laurie,0,7,32,32
1683709239090,BICD 100R,A02,202019,Smith; Laurie,0,3,32,32
1683709239090,BICD 100R,A03,202020,Smith; Laurie,0,1,32,32
1683709239090,BICD 100R,A04,202021,Smith; Laurie,6,0,32,26
1683709239090,BICD 100R,A05,202022,Smith; Laurie,10,0,32,22
1683709240122,BICD 136,A01,193242,Gustafson-Brown; Cindy,0,2,32,32
1683709240122,BICD 136,A02,193244,Gustafson-Brown; Cindy,13,0,32,19
1683709241148,BIEB 102,A01,193249,Butler; Shannon Rhey,0,0,32,32
1683709241148,BIEB 102,A02,193251,Butler; Shannon Rhey,0,0,32,32
1683709241148,BIEB 102,A03,193253,Butler; Shannon Rhey,0,0,32,32
1683709241148,BIEB 102,A04,193255,Butler; Shannon Rhey,13,0,32,19
1683709241148,BIEB 102,A05,193265,Butler; Shannon Rhey,25,0,32,7
1683709241148,BIEB 102,A06,193269,Butler; Shannon Rhey,12,0,32,20
1683709243204,BIEB 150,A01,193274,Staff,0,0,32,32
1683709243204,BIEB 150,A02,193285,Staff,24,0,32,8
1683709244230,BIEB 194,A00,193286,Kurle; Carolyn M.,19,0,32,13
1683709245260,BILD 1,A01,192291,Staff,15,0,32,17
1683709245260,BILD 1,A02,192292,Staff,30,0,32,2
1683709245260,BILD 1,B01,192520,Reuther; Keefe,0,1,0,0
1683709245260,BILD 1,B02,192532,Reuther; Keefe,0,1,0,0
1683709246292,BILD 3,A01,192556,Butler; Shannon Rhey,0,0,32,32
1683709246292,BILD 3,A02,192581,Butler; Shannon Rhey,0,1,32,32
1683709246292,BILD 3,A03,192611,Butler; Shannon Rhey,19,0,32,13
1683709246292,BILD 3,A04,192612,Butler; Shannon Rhey,23,0,32,9
1683709246292,BILD 3,A05,192613,Butler; Shannon Rhey,26,0,32,6
1683709246292,BILD 3,A06,192679,Butler; Shannon Rhey,27,0,32,5
1683709246292,BILD 3,A07,192682,Butler; Shannon Rhey,20,0,32,12
1683709247322,BILD 4,A01,192836,Reuther; Keefe,1,0,24,23
1683709247322,BILD 4,A02,193044,Reuther; Keefe,4,0,24,20
1683709248350,BILD 10,A01,193142,Gustafson-Brown; Cindy,29,0,32,3
1683709248350,BILD 10,A02,193149,Gustafson-Brown; Cindy,31,0,32,1
1683709249376,BIMM 100,A01,193301,Staff,0,6,32,32
1683709249376,BIMM 100,A02,193312,Staff,0,7,32,32
1683709249376,BIMM 100,A03,193323,Staff,0,10,32,32
1683709250402,BIMM 101,A01,193329,McDonnell; Lisa Marie,0,3,24,24
1683709250402,BIMM 101,A02,193339,McDonnell; Lisa Marie,0,3,24,24
1683709250402,BIMM 101,B01,193354,McDonnell; Lisa Marie,0,4,24,24
1683709250402,BIMM 101,B02,193357,McDonnell; Lisa Marie,0,3,24,24
1683709251433,BIMM 110,A01,193377,Tat; John,0,11,32,32
1683709251433,BIMM 110,A02,193378,Tat; John,0,11,32,32
1683709252466,BIMM 120,A01,206116,Staff,0,0,32,32
1683709252466,BIMM 120,A02,206117,Staff,7,0,32,25
1683709252466,BIMM 120,A03,206121,Staff,21,0,32,11
1683709253498,BIPN 100,A01,193393,Park; Ji Young,0,15,32,32
1683709253498,BIPN 100,A02,193402,Park; Ji Young,0,14,32,32
1683709253498,BIPN 100,A03,193413,Park; Ji Young,0,14,32,32
1683709253498,BIPN 100,A04,193414,Park; Ji Young,0,13,32,32
1683709254526,BIPN 102,A01,193429,Staff,0,0,32,32
1683709254526,BIPN 102,A02,193438,Staff,18,0,32,14
1683709255554,BIPN 106,A01,193450,Reyes Gonzalez; Catalina,0,2,40,40
1683709256580,BIPN 134,A01,193465,Cooke; James Edward,0,0,32,32
1683709256580,BIPN 134,A02,193474,Cooke; James Edward,25,0,32,7
1683709256580,BIPN 134,A03,193485,Cooke; James Edward,29,0,32,3
1683709256580,BIPN 134,A04,193486,Cooke; James Edward,20,0,32,12
1683709256580,BIPN 134,A05,193491,Cooke; James Edward,31,0,32,1
1683709256580,BIPN 134,A06,193501,Cooke; James Edward,30,0,32,2
1683709256580,BIPN 134,A07,193510,Cooke; James Edward,29,0,32,3
1683709258632,BISP 194,A00,222522,Staff,14,0,32,18
1683709259656,CAT 124,A01,202407,Staff,19,0,25,6
1683709260681,CAT 125,A00,202408,Marchisotto; Jennifer Anne,2,0,20,18
1683709261710,CAT 125R,A00,202409,Smith; Lauryn Alissa,0,11,20,20
1683709261710,CAT 125R,B00,202410,Morales; Celeste Georgianna,0,11,20,20
1683709261710,CAT 125R,C00,202411,Irwin; Matthew Joseph,0,12,20,20
1683709262743,CENG 15,A01,204712,Yang; Kesong,0,1,0,0
1683709263769,CENG 114,A00,202070,Jahed Motlagh; Zeinab,5,0,20,15
1683709264793,CGS 105,A00,185477,Wesling; Megan E.,24,0,40,16
1683709265822,CGS 106,A00,185494,Staff,11,0,22,11
1683709266847,CGS 108,A00,185495,Staff,14,0,20,6
1683709267873,CGS 114,A00,185496,Staff,13,0,18,5
1683709268902,CGS 119,A00,185501,Staff,15,0,20,5
1683709269930,CGS 120,A00,185511,Staff,11,0,20,9
1683709270965,CHEM 4,A01,184675,Bussey; Thomas J,97,0,100,3
1683709271994,CHEM 6A,A01,184677,Staff,32,0,60,28
1683709273018,CHEM 6B,A01,184679,Staff,63,0,100,37
1683709274044,CHEM 6C,A01,184681,Bussey; Thomas J,0,0,50,50
1683709274044,CHEM 6C,A02,184682,Bussey; Thomas J,32,0,50,18
1683709275070,CHEM 40A,A01,184684,Albizati; Kim F.,33,0,100,67
1683709276099,CHEM 40B,A01,184686,Albizati; Kim F.,0,22,100,100
1683709277124,CHEM 41B,A01,184690,Staff,51,0,100,49
1683709278155,COGS 3,A01,184715,Boyle; Mary E. T.,0,27,40,40
1683709279185,COGS 14B,A01,185172,Staff,0,14,38,38
1683709280211,COGS 18,A01,184736,Staff,14,0,80,66
1683709281239,COGS 100,A01,184932,Staff,0,8,73,73
1683709282267,COGS 101A,A01,184935,Staff,0,40,30,30
1683709283292,COGS 101B,A01,184944,Staff,0,2,30,30
1683709284318,COGS 101C,A01,184946,Staff,0,10,30,30
1683709285349,COGS 102A,A01,184951,Johnson; Christine M.,1,0,40,39
1683709286375,COGS 107B,A01,184953,Mooshagian; Eric Frederick,0,52,40,40
1683709287404,COGS 118B,A01,184959,Gupta; Anjum,0,50,40,40
1683709288433,COGS 153,A00,184961,Staff,1,16,30,29
1683709289458,COGS 177,A00,184962,Staff,0,20,30,30
1683709290487,COGS 187A,A01,184969,Boyle; Mary E. T.,0,19,40,40
1683709291515,COMM 10,A01,185174,Staff,0,5,25,25
1683709291515,COMM 10,A02,185189,Staff,0,2,25,25
1683709291515,COMM 10,A03,269821,Staff,0,1,0,0
1683709292562,COMM 100B,A02,185476,Staff,10,0,25,15
1683709292562,COMM 100B,A03,277340,Staff,25,0,25,0
1683709293587,COMM 100C,A01,185314,Staff,2,0,25,23
1683709293587,COMM 100C,A02,185327,Staff,17,0,25,8
1683709294613,COMM 110M,A00,185349,Staff,0,0,40,40
1683709295641,COMM 113T,A00,185352,Staff,25,0,40,15
1683709296666,COMM 114I,A00,185353,Staff,31,0,40,9
1683709297691,COMM 131,A00,185354,Staff,17,0,30,13
1683709298719,CSE 8A,A50,185358,Cao; Yingjun,0,46,10,10
1683709299806,CSE 8B,A01,185362,Staff,0,48,50,50
1683709300830,CSE 11,A01,185416,Cao; Yingjun,0,91,10,10
1683709301855,CSE 20,A01,185445,Briones; Jor-el Thomas Caparas,3,0,25,22
1683709302881,CSE 21,A01,185447,Staff,9,0,50,41
1683709303907,CSE 101,A01,185451,Staff,0,13,50,50
1683709303907,CSE 101,B01,185453,Jones; Miles E,0,15,50,50
1683709305957,CSE 141,A01,185458,Eldon; John,16,0,100,84
1683709306986,CSE 141L,A01,185461,Eldon; John,8,0,100,92
1683709308012,CSE 142,A01,185463,Staff,34,0,60,26
1683709308012,CSE 142,B01,201355,Staff,0,7,60,60
1683709309037,CSE 142L,A01,185470,Staff,34,0,60,26
1683709309037,CSE 142L,B01,201417,Staff,0,6,60,60
1683709310065,CSE 190,A00,201433,Staff,32,0,49,17
1683709311098,DOC 1,A01,259136,Strom; Megan C.,7,0,15,8
1683709311098,DOC 1,A02,259137,Strom; Megan C.,15,0,15,0
1683709311098,DOC 1,A03,259138,Strom; Megan C.,14,0,15,1
1683709311098,DOC 1,A04,259139,Strom; Megan C.,14,0,15,1
1683709312122,DOC 100D,A00,259140,Pass; Natalye Joann,14,0,25,11
1683709313152,DSGN 1,A01,184749,Rill; Bryan,0,26,30,30
1683709314181,DSGN 100,A01,185168,Staff,0,2,25,25
1683709315213,ECE 5,A01,185626,Morris; Karcher William,0,12,0,0
1683709316239,ECE 101,A01,185628,Staff,14,0,70,56
1683709317269,ECE 107,A01,185635,Baghdadchi; Saharnaz,0,0,20,20
1683709317269,ECE 107,A02,185638,Baghdadchi; Saharnaz,1,0,20,19
1683709318297,ECE 148,A01,185647,Silberman; Jack,0,0,16,16
1683709319326,ECON 1,A01,185537,Crane; Meredith Helen,54,0,70,16
1683709320353,ECON 3,A01,185549,Crane; Meredith Helen,30,0,70,40
1683709321379,ECON 4,A01,203354,Anderson; John Charles,0,5,10,10
1683709322411,ECON 100A,A01,185574,Staff,0,5,40,40
1683709323439,ECON 100B,A01,185576,Staff,0,12,50,50
1683709324466,ECON 100C,A01,185589,Newhouse; Herbert S,30,0,70,40
1683709325498,ECON 105,A00,185608,Vespa; Emanuel Ignacio,19,0,35,16
1683709326523,ECON 109,A01,185610,Shishkin; Denis,9,0,35,26
1683709327556,ECON 110A,A01,185612,Staff,8,0,40,32
1683709328581,ECON 120A,A01,185615,Staff,19,0,40,21
1683709329607,ECON 120C,A01,185617,Sun; Yixiao,0,21,70,70
1683709330641,ECON 144,A00,203346,Squires; Dale E,2,0,35,33
1683709331665,ECON 171,A01,203349,Newhouse; Herbert S,0,1,35,35
1683709332691,ECON 173A,A01,185621,Toda; Alexis Akira,21,0,35,14
1683709333726,EDS 25,A01,202413,Staff,0,1,0,0
1683709333726,EDS 25,A02,202414,Staff,0,1,0,0
1683709333726,EDS 25,A03,202415,Staff,0,0,0,0
1683709333726,EDS 25,A04,202416,Staff,0,1,0,0
1683709333726,EDS 25,A05,202439,Staff,0,0,0,0
1683709333726,EDS 25,A06,202440,Staff,0,0,0,0
1683709333726,EDS 25,B01,202631,Staff,0,0,0,0
1683709333726,EDS 25,B02,202632,Staff,0,0,0,0
1683709333726,EDS 25,B03,202639,Staff,0,0,0,0
1683709333726,EDS 25,B04,202640,Staff,0,0,0,0
1683709333726,EDS 25,B05,202643,Staff,0,0,0,0
1683709333726,EDS 25,B06,202644,Staff,0,0,0,0
1683709334755,EDS 38,A01,202659,Black; Alison Michelle,25,0,25,0
1683709335780,EDS 115,A00,202652,Staff,18,0,30,12
1683709336807,EDS 125,A00,202649,Staff,13,0,30,17
1683709337833,EDS 126,A01,203332,Staff,30,0,30,0
1683709338861,EDS 139,A00,202838,Staff,16,0,25,9
1683709339891,EDS 146,A01,202655,Staff,14,0,25,11
1683709340917,ENG 15,A00,185667,Staff,0,1,0,0
1683709340917,ENG 15,B00,185672,Staff,0,0,0,0
1683709340917,ENG 15,C00,185675,Staff,0,0,0,0
1683709340917,ENG 15,D00,185682,Staff,0,0,0,0
1683709340917,ENG 15,E00,185684,Staff,0,0,0,0
1683709341941,ETHN 103,A00,185710,Staff,0,8,35,35
1683709342972,ETHN 103A,A00,199228,Man; Simeon S,0,0,9,9
1683709344004,ETHN 109,A00,185711,Staff,15,0,35,20
1683709345033,ETHN 142,A00,185726,Staff,0,4,30,30
1683709346057,ETHN 163J,A00,199229,Man; Simeon S,5,0,8,3
1683709347087,ETHN 168,A00,185727,Staff,7,0,10,3
1683709348112,ETHN 182,A00,185728,Staff,0,0,35,35
1683709349136,ETHN 183,A00,185737,Staff,9,0,18,9
1683709350165,GLBH 111,A01,209361,Burgos; Jose L.,0,0,0,0
1683709352222,HIEU 104,A00,185792,Staff,14,0,20,6
1683709353250,HIEU 115,A00,185800,Staff,0,0,20,20
1683709354274,HIEU 128,A00,185801,Staff,0,9,20,20
1683709355299,HIEU 147,A00,185802,Staff,15,0,20,5
1683709356329,HIEU 154,A00,185823,Staff,11,0,20,9
1683709357351,HILA 102,A00,185826,Staff,14,0,20,6
1683709358384,HILD 2C,A01,185778,Staff,0,13,20,20
1683709359411,HILD 7B,A01,185780,Kwak; Nancy,0,17,32,32
1683709359411,HILD 7B,A02,185781,Kwak; Nancy,0,18,32,32
1683709360437,HILD 30,A01,185791,Staff,12,0,20,8
1683709361463,HISC 119,A00,185830,Golan; Tal,0,10,20,20
1683709362493,HITO 156GS,A00,185831,Patterson; Patrick H.,0,0,0,23
1683709363521,HIUS 103,A00,185832,Man; Simeon S,0,4,20,20
1683709364547,HIUS 117,A00,185836,Kwak; Nancy,2,0,20,18
1683709365572,HIUS 125,A00,185840,Man; Simeon S,0,2,23,23
1683709366597,HIUS 149,A00,185845,Staff,1,0,20,19
1683709367622,HUM 3,A01,185882,Zavodny; Tatiana Sophia,0,8,50,50
1683709367622,HUM 3,B01,185899,Caldwell; Michael Alan,0,18,50,50
1683709368651,HUM 3GS,A00,185900,Patterson; Patrick H.,0,0,0,23
1683709369677,HUM 4,A01,185938,Zroka; Amy Liane,28,0,50,22
1683709369677,HUM 4,B01,185956,Watkins; Eric,0,6,50,50
1683709369677,HUM 4,B02,202209,Watkins; Eric,0,5,50,50
1683709369677,HUM 4,B03,202210,Watkins; Eric,0,5,50,50
1683709370706,HUM 5,A01,185958,West; Geoffrey Scott,0,0,50,50
1683709370706,HUM 5,A02,202215,West; Geoffrey Scott,0,1,50,50
1683709371732,INTL 190,A00,185959,Gagnon; Jeffrey C,0,0,0,9
1683709371732,INTL 190,B00,185960,Lettieri; Michael Joseph,0,0,0,2
1683709372758,JAPN 180,A00,254509,Staff,5,0,30,25
1683709373788,LATI 10,A01,202853,Kennemore; Amy Michelle,4,0,35,31
1683709373788,LATI 10,A02,202854,Kennemore; Amy Michelle,3,0,35,32
1683709373788,LATI 10,A03,270054,Kennemore; Amy Michelle,30,0,30,0
1683709374815,LATI 180,A00,202855,Kennemore; Amy Michelle,11,0,20,9
1683709375841,LAWS 101,A00,201767,Golan; Tal,0,7,40,40
1683709376866,LIFR 1C,A00,185961,Staff,6,0,20,14
1683709377892,LIFR 1CX,A00,185962,Staff,7,0,20,13
1683709378919,LIFR 1D,A00,185963,Staff,7,0,20,13
1683709379943,LIFR 1DX,A00,185964,Staff,7,0,20,13
1683709380968,LIGN 101,A01,186039,Staff,43,0,50,7
1683709381996,LIGN 165,A00,186040,Staff,14,0,50,36
1683709383027,LTCS 108,A00,186041,Staff,5,0,10,5
1683709384057,LTCS 119,A00,186042,Staff,15,0,20,5
1683709385083,LTCS 130,A00,186043,Wesling; Megan E.,15,0,25,10
1683709387138,LTEA 138,A00,186119,Staff,14,0,40,26
1683709388164,LTEN 124,A00,186148,Staff,5,0,25,20
1683709389189,LTEN 178,A00,186149,Staff,6,0,15,9
1683709390219,LTEN 181,A00,186150,Blanco; John D,34,0,40,6
1683709391246,LTWL 120,A00,186160,Staff,19,0,25,6
1683709392274,LTWL 165,A00,186161,Staff,22,0,25,3
1683709393302,LTWR 100,A00,186162,Staff,0,5,15,15
1683709394330,LTWR 102,A00,186163,Doller; Ben,5,0,15,10
1683709395356,MAE 8,A01,186412,Staff,0,1,0,0
1683709396384,MAE 30B,A00,186445,Bahadori; Mohammad Yousef,81,0,100,19
1683709397414,MAE 40,A00,186592,Bewley; Thomas R,10,0,50,40
1683709398443,MAE 101B,A00,186593,Bahadori; Mohammad Yousef,80,0,100,20
1683709399473,MAE 105,A00,186594,Bandaru; Prabhakar,10,0,50,40
1683709400504,MAE 107,A00,186599,Pham; Hieu Tan,0,8,120,120
1683709401531,MAE 148,A01,186660,Silberman; Jack,3,0,16,13
1683709402562,MATH 10A,A01,188095,Staff,0,6,35,35
1683709403653,MATH 10B,A01,188097,Bowers; Adam R.,0,12,30,30
1683709403653,MATH 10B,A02,188099,Bowers; Adam R.,0,11,30,30
1683709403653,MATH 10B,B01,188104,Bowers; Adam R.,0,10,30,30
1683709403653,MATH 10B,B02,188106,Bowers; Adam R.,0,9,30,30
1683709404687,MATH 10C,A01,188111,Staff,0,20,30,30
1683709404687,MATH 10C,A02,188127,Staff,0,19,30,30
1683709404687,MATH 10C,A03,188131,Staff,0,19,30,30
1683709404687,MATH 10C,B01,188218,Staff,17,0,30,13
1683709404687,MATH 10C,B02,188244,Staff,13,0,30,17
1683709404687,MATH 10C,B03,188277,Staff,14,0,30,16
1683709405713,MATH 18,A01,188344,Bach; Quang Tran,18,0,30,12
1683709405713,MATH 18,A02,188345,Bach; Quang Tran,11,0,30,19
1683709405713,MATH 18,B01,188353,Bach; Quang Tran,11,0,30,19
1683709405713,MATH 18,B02,188354,Bach; Quang Tran,19,0,30,11
1683709406742,MATH 20A,A01,188374,Staff,11,0,35,24
1683709407772,MATH 20B,A01,188382,Ohm; Ko Woon,7,0,30,23
1683709407772,MATH 20B,A02,188383,Ohm; Ko Woon,22,0,30,8
1683709407772,MATH 20B,B01,188385,Ohm; Ko Woon,7,0,30,23
1683709407772,MATH 20B,B02,188392,Ohm; Ko Woon,22,0,30,8
1683709408797,MATH 20C,A01,188394,Harel; Guershon,10,0,30,20
1683709408797,MATH 20C,A02,188395,Harel; Guershon,13,0,30,17
1683709408797,MATH 20C,B01,188404,Harel; Guershon,5,0,30,25
1683709408797,MATH 20C,B02,188405,Harel; Guershon,18,0,30,12
1683709409829,MATH 20D,A01,188414,Hammock; Frances H,0,1,30,30
1683709409829,MATH 20D,A02,188415,Hammock; Frances H,0,1,30,30
1683709409829,MATH 20D,B01,188447,Hammock; Frances H,0,1,30,30
1683709409829,MATH 20D,B02,188486,Hammock; Frances H,2,0,30,28
1683709410858,MATH 20E,A01,188649,Staff,21,0,30,9
1683709410858,MATH 20E,A02,188650,Staff,20,0,30,10
1683709410858,MATH 20E,A03,188673,Staff,0,0,30,30
1683709411886,MATH 102,A01,188675,Staff,0,40,35,35
1683709412911,MATH 103B,A01,188681,Staff,3,0,35,32
1683709412911,MATH 103B,B01,188692,Staff,5,0,35,30
1683709413942,MATH 109,A01,188695,Salehi Golsefidy; Alireza,24,0,35,11
1683709413942,MATH 109,A02,188696,Salehi Golsefidy; Alireza,25,0,35,10
1683709414971,MATH 120A,A01,188698,Eggers; John Dietrich,7,0,35,28
1683709416004,MATH 142B,A01,188736,Ioana; Adrian,0,0,30,30
1683709416004,MATH 142B,A02,188741,Ioana; Adrian,0,1,30,30
1683709416004,MATH 142B,A03,188743,Ioana; Adrian,0,2,30,30
1683709417032,MATH 168A,A01,188790,Staff,0,11,35,35
1683709418059,MATH 170A,A01,188803,Nie; Jiawang,0,2,35,35
1683709418059,MATH 170A,A02,188811,Nie; Jiawang,0,1,35,35
1683709418059,MATH 170A,A03,188814,Nie; Jiawang,1,0,35,34
1683709418059,MATH 170A,A04,188815,Nie; Jiawang,5,0,35,30
1683709419088,MATH 193B,A01,188817,Staff,0,0,35,35
1683709419088,MATH 193B,A02,188818,Staff,6,0,35,29
1683709420114,MGT 4,A01,202857,Anderson; John Charles,59,0,80,21
1683709421138,MGT 12,A00,202858,Lindenberger; Wade Douglas,40,0,90,50
1683709422163,MGT 18,A00,202859,Staff,73,0,90,17
1683709423192,MGT 18GS,A00,202860,McKay; Michael J,13,0,28,15
1683709424216,MGT 45,A00,202861,Pecore; Joseph P.,8,0,90,82
1683709425245,MGT 100,A00,202863,Yavorsky; Daniel Ryan,27,0,90,63
1683709426269,MGT 103,A00,202864,Ehrich; Kristine R,0,19,90,90
1683709427294,MGT 112,A00,202865,Ehrich; Kristine R,15,0,90,75
1683709428321,MGT 121A,A00,202868,Staff,70,0,90,20
1683709429346,MGT 131B,A00,202869,Anderson; John Charles,58,0,90,32
1683709430371,MGT 136,A00,202871,Lindenberger; Wade Douglas,83,0,90,7
1683709431396,MGT 164,A00,202873,Staff,0,67,90,91
1683709432420,MGT 164GS,A00,202874,McKay; Mary A,13,0,28,15
1683709433446,MGT 180,A00,202875,Staff,0,51,90,91
1683709434472,MMW 11R,A01,205019,Herbst; Matthew,0,0,30,30
1683709434472,MMW 11R,A02,205026,Herbst; Matthew,29,0,30,1
1683709435504,MMW 15,A01,193512,Chang; Edmond Yi-Teh,0,8,28,28
1683709435504,MMW 15,A02,193513,Chang; Edmond Yi-Teh,0,5,28,28
1683709435504,MMW 15,A03,193514,Chang; Edmond Yi-Teh,0,5,28,28
1683709435504,MMW 15,A04,193515,Chang; Edmond Yi-Teh,0,5,28,28
1683709435504,MMW 15,A05,193516,Chang; Edmond Yi-Teh,0,5,28,28
1683709435504,MMW 15,A06,193517,Chang; Edmond Yi-Teh,0,6,28,28
1683709435504,MMW 15,B01,193519,Chang; Edmond Yi-Teh,0,5,28,28
1683709435504,MMW 15,B02,193520,Chang; Edmond Yi-Teh,0,5,28,28
1683709435504,MMW 15,B03,193521,Chang; Edmond Yi-Teh,0,5,28,28
1683709435504,MMW 15,B04,193522,Chang; Edmond Yi-Teh,0,6,28,28
1683709435504,MMW 15,B05,193523,Chang; Edmond Yi-Teh,0,5,28,28
1683709435504,MMW 15,B06,193524,Chang; Edmond Yi-Teh,0,5,28,28
1683709436540,MMW 122,A01,193526,Rahimi; Babak,0,16,28,28
1683709436540,MMW 122,A02,193527,Rahimi; Babak,0,15,28,28
1683709436540,MMW 122,A03,193528,Rahimi; Babak,0,0,0,0
1683709436540,MMW 122,A04,193529,Rahimi; Babak,0,0,0,0
1683709437565,MUS 1A,A01,186663,Staff,0,18,35,35
1683709438591,MUS 4,A01,186715,Staff,0,12,35,35
1683709439615,MUS 5R,A01,186796,Dubnov; Shlomo,0,17,35,35
1683709440643,MUS 6,A01,186798,Staff,0,4,25,25
1683709441670,MUS 7,A01,186830,Staff,11,0,35,24
1683709442695,MUS 8,A01,186930,Staff,0,27,35,35
1683709443724,MUS 15,A01,186932,Staff,0,15,35,35
1683709443724,MUS 15,B01,186934,Staff,0,16,35,35
1683709444750,MUS 80,A00,186935,Staff,0,0,20,20
1683709444750,MUS 80,B00,186936,Staff,24,0,25,1
1683709445778,NANO 11,A00,204702,Lipomi; Darren John,0,0,0,0
1683709446804,NANO 15,A01,204709,Yang; Kesong,0,1,0,0
1683709447834,NANO 114,A00,202069,Jahed Motlagh; Zeinab,2,0,10,8
1683709448860,PHIL 1,A00,186955,Grush; Rick Scott,31,0,40,9
1683709449890,PHIL 10,A01,186973,Grush; Rick Scott,27,0,35,8
1683709449890,PHIL 10,A02,186974,Grush; Rick Scott,33,0,35,2
1683709450915,PHIL 13,A01,186976,Staff,1,0,35,34
1683709450915,PHIL 13,A02,186977,Staff,16,0,35,19
1683709451939,PHIL 14,A01,186979,Staff,30,0,35,5
1683709451939,PHIL 14,A02,186986,Staff,32,0,35,3
1683709452963,PHIL 28,A01,186988,Staff,16,0,30,14
1683709452963,PHIL 28,A02,186989,Staff,0,0,30,30
1683709452963,PHIL 28,A03,186990,Staff,10,0,30,20
1683709452963,PHIL 28,A04,186991,Staff,26,0,30,4
1683709453987,PHIL 120,A00,186997,Staff,23,0,40,17
1683709455017,PHIL 137,A00,187003,Staff,8,0,40,32
1683709456041,PHIL 150,A00,187015,Staff,47,0,70,23
1683709457071,PHIL 167,A00,187021,Lamey; Andy M.,34,0,40,6
1683709458099,PHIL 174,A01,202226,Staff,17,0,20,3
1683709458099,PHIL 174,A02,202235,Staff,20,0,20,0
1683709459125,PHIL 191A,A00,258918,Staff,0,0,1,1
1683709460151,PHYS 1A,A00,187028,Staff,26,0,60,34
1683709461178,PHYS 1AL,001,187036,Staff,3,0,30,27
1683709461178,PHYS 1AL,002,187049,Staff,18,0,30,12
1683709462201,PHYS 1B,A00,187058,Staff,21,0,60,39
1683709463227,PHYS 1BL,001,187064,Staff,0,1,30,30
1683709463227,PHYS 1BL,002,187070,Staff,4,0,30,26
1683709464251,PHYS 1C,A00,187082,Staff,30,0,120,90
1683709465281,PHYS 1CL,001,187088,Staff,0,9,30,30
1683709465281,PHYS 1CL,002,187089,Staff,0,1,30,30
1683709465281,PHYS 1CL,009,262693,Staff,9,0,30,21
1683709466306,PHYS 2B,A01,187097,Staff,55,0,115,60
1683709467334,PHYS 2C,A01,187099,Staff,63,0,115,52
1683709468361,PHYS 2CL,A01,187101,Staff,5,0,28,23
1683709468361,PHYS 2CL,A02,187102,Staff,15,0,28,13
1683709469385,PHYS 2D,A01,187123,Shotwell; Brian,95,0,115,20
1683709470413,PHYS 4B,A01,187133,Grinstein; Benjamin,35,0,50,15
1683709471439,POLI 10,A00,188819,Staff,0,4,50,50
1683709472464,POLI 11,A00,188827,Staff,43,0,50,7
1683709473489,POLI 13R,A00,188828,Staff,0,1,20,20
1683709474514,POLI 27,A01,188830,Elgin; Samuel Zincke,0,2,70,70
1683709475537,POLI 30,A00,188832,Desposato; Scott,30,0,50,20
1683709476565,POLI 102F,A00,188834,Staff,1,0,40,39
1683709477592,POLI 104A,A00,188852,Staff,12,0,30,18
1683709478619,POLI 104I,A00,188853,Staff,0,8,20,20
1683709479644,POLI 110B,A00,188854,Wiens; David,6,0,20,14
1683709480669,POLI 112A,A00,188855,Wiens; David,3,0,30,27
1683709481694,POLI 117R,A00,188856,Forman; Fonna,0,12,20,20
1683709482722,POLI 118,A00,188857,Ingham; Sean,8,0,20,12
1683709483747,POLI 120G,A00,188858,Staff,7,0,30,23
1683709484772,POLI 131CR,A00,188863,Hoston; Germaine,20,0,50,30
1683709485796,POLI 133,A00,188864,Nellis; Gareth Hb,44,0,50,6
1683709486825,POLI 134D,A00,188865,Desposato; Scott,27,0,30,3
1683709487851,POLI 142A,A00,188871,Gartzke; Erik,21,0,50,29
1683709488876,POLI 142K,A00,188874,Staff,38,0,50,12
1683709489902,POLI 143,A00,188940,Gartzke; Erik,15,0,30,15
1683709490928,POLI 153,A00,188943,Staff,1,0,20,19
1683709491953,POLI 160AA,A00,188944,Staff,10,0,40,30
1683709492980,POLI 170A,A00,188945,Staff,10,0,30,20
1683709495031,PSYC 1,A00,188952,Staff,36,0,90,54
1683709496059,PSYC 2,B00,188953,Staff,19,0,35,16
1683709497084,PSYC 6,A00,188970,Staff,47,0,60,13
1683709498112,PSYC 7,A00,188973,Staff,35,0,45,10
1683709499139,PSYC 60,A01,188980,Rickard; Timothy C.,42,0,60,18
1683709500169,PSYC 70,A01,189001,Steiner; Eric Tomas,22,0,45,23
1683709501201,PSYC 100,A00,189005,Lacefield; Katharine I,1,98,120,119
1683709502228,PSYC 102,A00,189008,Staff,6,0,30,24
1683709503253,PSYC 106,B00,189026,Gorman; Michael R.,27,0,60,33
1683709504278,PSYC 114,B01,189033,Winkielman; Piotr,0,31,30,30
1683709505303,PSYC 131,A00,189036,Anagnostaras; Stephan,0,44,60,60
1683709506329,PSYC 136,A00,189041,Lowe; Angela Beth,0,7,25,25
1683709507408,PSYC 137,A00,189057,Winkielman; Piotr,0,36,25,25
1683709508432,PSYC 144,A00,189107,Wixted; John T,0,11,50,50
1683709510485,PSYC 162,A00,189142,Staff,0,9,85,85
1683709511511,PSYC 172,A00,189144,Gorman; Michael R.,0,6,30,30
1683709513562,PSYC 179,A00,189146,Lacefield; Katharine I,0,88,120,120
1683709514589,PSYC 181,A00,189147,Anagnostaras; Stephan,0,45,90,90
1683709515614,PSYC 190R,A00,189148,Barner; David A.,0,23,80,80
1683709516642,PSYC 191,A00,189275,Rickard; Timothy C.,0,11,25,25
1683709517666,PSYC 193,A00,189276,Chapman; Eddie Nathaniel,0,1,0,4
1683709518697,PSYC 193L,A01,189281,Lowe; Angela Beth,8,0,20,12
1683709518697,PSYC 193L,B01,189285,Staff,28,0,35,7
1683709519725,RELI 149,A00,187137,Rahimi; Babak,6,0,40,34
1683709520754,SE 9,A01,187315,Staff,0,2,18,18
1683709521778,SE 101B,A00,187409,Staff,24,0,30,6
1683709522804,SE 110B,A00,187444,Staff,10,0,40,30
1683709523833,SE 130B,A00,187449,Staff,31,0,40,9
1683709524864,SE 150A,A00,187516,Staff,8,0,20,12
1683709525890,SE 154,A00,187528,Staff,29,0,50,21
1683709526915,SIO 3,A01,258171,Staff,35,0,40,5
1683709527942,SIO 10,A00,187144,Cook; Geoffrey W,0,6,75,75
1683709528966,SIO 45,A00,187152,Cook; Geoffrey W,1,7,100,99
1683709529994,SIO 109R,A00,194486,Staff,0,4,20,20
1683709532044,SIO 187,A01,187233,Kacev; David,12,0,40,28
1683709533076,SOCI 1,A01,258656,Thorpe; Charles Robert,28,0,30,2
1683709533076,SOCI 1,A02,258658,Thorpe; Charles Robert,30,0,30,0
1683709533076,SOCI 1,A03,258661,Thorpe; Charles Robert,25,0,25,0
1683709533076,SOCI 1,A04,258666,Thorpe; Charles Robert,22,0,25,3
1683709533076,SOCI 1,A05,258897,Thorpe; Charles Robert,22,0,25,3
1683709533076,SOCI 1,A06,258898,Thorpe; Charles Robert,25,0,25,0
1683709534099,SOCI 30,A01,258903,Pardo Guerra; Juan Pablo,14,0,30,16
1683709535123,SOCI 102,A00,258904,Staff,9,0,25,16
1683709536153,SOCI 106,A00,258905,Staff,19,0,25,6
1683709537178,SOCI 111,A00,258907,Ribas Norris; Janet Vanesa,26,0,30,4
1683709538206,SOCI 121R,A00,258908,Pardo Guerra; Juan Pablo,7,0,30,23
1683709539231,SOCI 126,A01,203330,Staff,14,0,20,6
1683709540260,SOCI 131,A00,258909,Thorpe; Charles Robert,30,0,60,30
1683709541291,SOCI 135,A00,258910,Payne; Christine Anna,0,13,30,30
1683709542316,SOCI 157,A00,258911,Staff,10,0,30,20
1683709543340,SOCI 184,A00,258912,Staff,25,0,30,5
1683709544365,SOCI 188D,A00,258913,Staff,22,0,30,8
1683709545395,SYN 2,001,187529,Staff,9,0,16,7
1683709545395,SYN 2,002,201452,Staff,0,20,16,16
1683709545395,SYN 2,003,201469,Staff,1,0,16,15
1683709546425,SYN 100,A01,187531,Staff,0,9,20,20
1683709546425,SYN 100,B01,201491,Staff,0,10,20,20
1683709547456,TDAC 1,A00,189286,Walsh; Kim C.,3,0,20,17
1683709547456,TDAC 1,B00,189287,Harting; Carla Kelso,10,0,20,10
1683709548485,TDAC 101,A00,189300,Walsh; Kim C.,16,0,20,4
1683709548485,TDAC 101,B00,189301,Harting; Carla Kelso,18,0,20,2
1683709549516,TDAC 102,A00,189304,Basso; Beatrice,14,0,20,6
1683709550541,TDAC 108,A00,189305,Staff,18,0,20,2
1683709551572,TDDE 131,A00,189310,Staff,19,0,20,1
1683709551572,TDDE 131,B00,189314,Staff,19,0,20,1
1683709551572,TDDE 131,C00,189315,Staff,48,0,50,2
1683709551572,TDDE 131,D00,189316,Staff,14,0,15,1
1683709551572,TDDE 131,E00,204841,Staff,20,0,20,0
1683709552597,TDGE 10,A00,189289,Staff,27,0,50,23
1683709552597,TDGE 10,B00,189290,Havis; Allan,0,1,50,50
1683709553621,TDGE 11,A00,189291,Fulton; Julia,0,4,50,50
1683709553621,TDGE 11,B00,189292,Staff,20,0,25,5
1683709553621,TDGE 11,C00,260270,Staff,0,0,0,0
1683709554646,TDGE 25,A00,189294,Staff,1,0,20,19
1683709555674,TDGE 124,A00,189318,Fulton; Julia,0,7,50,50
1683709556703,TDGE 125,A00,189319,Staff,13,0,25,12
1683709556703,TDGE 125,B00,189320,Staff,23,0,25,2
1683709557732,TDGE 127,A00,189322,Havis; Allan,1,0,50,49
1683709558758,TDHT 101,A00,189323,Staff,18,0,25,7
1683709558758,TDHT 101,B00,189324,Staff,25,0,25,0
1683709559782,TDHT 102,A00,189325,Staff,49,0,50,1
1683709560814,TDMV 1,A00,189295,Arcidiacono; Kristin,20,0,30,10
1683709560814,TDMV 1,B00,189296,Caligagan; Maria T.,23,0,30,7
1683709561844,TDMV 2,A00,189297,Sammartano; Tonnie,27,0,30,3
1683709561844,TDMV 2,B00,189299,Arcidiacono; Kristin,23,0,30,7
1683709562871,TDMV 3,A00,204998,Rincon; Alicia,22,0,30,8
1683709563895,TDMV 120,A00,189458,Sammartano; Tonnie,28,0,30,2
1683709564920,TDMV 138,A00,189541,Jun; Grace Shin Hae,20,0,40,20
1683709565945,TDMV 142,A00,189717,Caligagan; Tony,25,0,30,5
1683709565945,TDMV 142,B00,189718,Caligagan; Maria T.,25,0,30,5
1683709566971,TMC 2,A01,187533,Staff,25,0,25,0
1683709566971,TMC 2,A02,187534,Staff,25,0,25,0
1683709567999,USP 1,A01,187536,Kwak; Nancy,0,16,25,25
1683709569027,USP 5,A01,187538,Staff,8,0,25,17
1683709570052,USP 101,A00,199253,Staff,0,4,0,0
1683709571078,USP 124,A00,187562,Boomhower; Matthew Charles,0,0,30,30
1683709572103,USP 138,A00,187582,Staff,19,0,25,6
1683709573131,USP 152,A01,187597,Staff,3,0,25,22
1683709574158,USP 153,A00,187598,Staff,18,0,25,7
1683709575187,USP 168,A00,187607,Kwak; Nancy,2,0,5,3
1683709576213,USP 173,A00,187619,Staff,4,0,25,21
1683709577241,USP 181,A00,187638,Staff,0,4,25,25
1683709578266,VIS 103,A00,187650,Cruz; Edwin Teddy,17,0,75,58
1683709579290,VIS 110D,A00,187669,Staff,13,0,22,9
1683709580319,VIS 127C,A00,187720,Shen; Kuiyi,67,0,146,79
1683709581344,VIS 149,A00,187731,Yoldas; Pinar,0,12,22,22
1683709582367,VIS 151,A01,188091,Staff,22,0,34,12
1683709582367,VIS 151,A02,188092,Staff,11,0,34,23
1683709583392,VIS 160B,A00,188093,Stalbaum; Brett,0,1,10,10
1683709585446,WCWP 10B,A00,201720,Staff,0,0,5,5
1683709585446,WCWP 10B,B00,201722,Staff,0,0,6,6
1683709586476,WCWP 100,A00,201725,Gagnon; Jeffrey C,0,0,2,2
1683709586476,WCWP 100,B00,201727,Staff,0,4,15,15
1683709589616,ANBI 133,A00,258401,Wilder; Linnea Lorene,34,0,40,6
1683709590644,ANBI 140,A00,258395,Hrvoj Mihic; Branka,18,0,25,7
1683709591669,ANSC 120,A00,258402,Bialecki; Jon Anthony,26,0,40,14
1683709592691,ANSC 144,A00,258400,Staff,12,0,40,28
1683709594743,ANSC 166,A00,258396,Parish; Steven Martin,156,0,175,19
1683709595767,ANSC 180,A00,193533,Staff,8,0,20,12
1683709596795,ANSC 188,A00,258397,Jassal; Aftab,34,0,40,6
1683709597822,ANTH 3,A01,258316,Staff,23,0,30,7
1683709598850,ANTH 5,A00,258394,Semendeferi; Ekaterini,16,0,20,4
1683709599877,ANTH 21,A01,258331,Staff,4,0,40,36
1683709600902,ANTH 103,A00,258398,Varma; Saiba,15,0,25,10
1683709601931,AWP 10,001,202034,Staff,0,0,0,0
1683709601931,AWP 10,002,202035,Staff,0,0,0,0
1683709601931,AWP 10,003,202036,Staff,0,0,0,0
1683709601931,AWP 10,004,202037,Staff,0,0,0,0
1683709601931,AWP 10,005,202038,Staff,0,0,0,0
1683709601931,AWP 10,006,202039,Staff,0,0,0,0
1683709601931,AWP 10,007,202040,Staff,0,0,0,0
1683709601931,AWP 10,008,202041,Staff,0,0,0,0
1683709601931,AWP 10,009,202042,Staff,0,0,0,0
1683709601931,AWP 10,010,202043,Staff,0,0,0,0
1683709601931,AWP 10,011,202044,Staff,0,0,0,0
1683709601931,AWP 10,012,202045,Staff,0,0,0,0
1683709601931,AWP 10,013,202046,Staff,0,0,0,0
1683709601931,AWP 10,014,202047,Staff,0,0,0,0
1683709601931,AWP 10,015,202048,Staff,0,0,0,0
1683709601931,AWP 10,016,202049,Staff,0,0,0,0
1683709601931,AWP 10,017,202050,Staff,0,0,0,0
1683709601931,AWP 10,018,202051,Staff,0,0,0,0
1683709601931,AWP 10,019,202052,Staff,0,0,0,0
1683709601931,AWP 10,020,202053,Staff,0,0,0,0
1683709601931,AWP 10,021,202054,Staff,0,0,0,0
1683709601931,AWP 10,022,202055,Staff,0,0,0,0
1683709601931,AWP 10,023,202056,Staff,0,0,0,0
1683709601931,AWP 10,024,202057,Staff,0,0,0,0
1683709601931,AWP 10,025,202058,Staff,0,0,0,0
1683709601931,AWP 10,026,202059,Staff,0,0,0,0
1683709602959,AWP 102,001,202032,Staff,0,0,0,0
1683709602959,AWP 102,002,202033,Staff,0,0,0,0
1683709603988,BENG 100,A01,254234,Taylor Amos; Alyssa C,31,0,40,9
1683709605019,BENG 196,001,270013,Engler; Adam J.,9999,0,9999,0
1683709606045,BICD 100R,A01,202018,Smith; Laurie,0,7,32,32
1683709606045,BICD 100R,A02,202019,Smith; Laurie,0,3,32,32
1683709606045,BICD 100R,A03,202020,Smith; Laurie,0,1,32,32
1683709606045,BICD 100R,A04,202021,Smith; Laurie,6,0,32,26
1683709606045,BICD 100R,A05,202022,Smith; Laurie,10,0,32,22
1683709607077,BICD 136,A01,193242,Gustafson-Brown; Cindy,0,2,32,32
1683709607077,BICD 136,A02,193244,Gustafson-Brown; Cindy,13,0,32,19
1683709608107,BIEB 102,A01,193249,Butler; Shannon Rhey,0,0,32,32
1683709608107,BIEB 102,A02,193251,Butler; Shannon Rhey,0,0,32,32
1683709608107,BIEB 102,A03,193253,Butler; Shannon Rhey,0,0,32,32
1683709608107,BIEB 102,A04,193255,Butler; Shannon Rhey,13,0,32,19
1683709608107,BIEB 102,A05,193265,Butler; Shannon Rhey,25,0,32,7
1683709608107,BIEB 102,A06,193269,Butler; Shannon Rhey,12,0,32,20
1683709610163,BIEB 150,A01,193274,Staff,0,0,32,32
1683709610163,BIEB 150,A02,193285,Staff,24,0,32,8
1683709611249,BIEB 194,A00,193286,Kurle; Carolyn M.,19,0,32,13
1683709612282,BILD 1,A01,192291,Staff,15,0,32,17
1683709612282,BILD 1,A02,192292,Staff,30,0,32,2
1683709612282,BILD 1,B01,192520,Reuther; Keefe,0,1,0,0
1683709612282,BILD 1,B02,192532,Reuther; Keefe,0,1,0,0
1683709613313,BILD 3,A01,192556,Butler; Shannon Rhey,0,0,32,32
1683709613313,BILD 3,A02,192581,Butler; Shannon Rhey,0,1,32,32
1683709613313,BILD 3,A03,192611,Butler; Shannon Rhey,19,0,32,13
1683709613313,BILD 3,A04,192612,Butler; Shannon Rhey,23,0,32,9
1683709613313,BILD 3,A05,192613,Butler; Shannon Rhey,26,0,32,6
1683709613313,BILD 3,A06,192679,Butler; Shannon Rhey,27,0,32,5
1683709613313,BILD 3,A07,192682,Butler; Shannon Rhey,20,0,32,12
1683709614339,BILD 4,A01,192836,Reuther; Keefe,1,0,24,23
1683709614339,BILD 4,A02,193044,Reuther; Keefe,4,0,24,20
1683709615364,BILD 10,A01,193142,Gustafson-Brown; Cindy,29,0,32,3
1683709615364,BILD 10,A02,193149,Gustafson-Brown; Cindy,31,0,32,1
1683709616390,BIMM 100,A01,193301,Staff,0,6,32,32
1683709616390,BIMM 100,A02,193312,Staff,0,7,32,32
1683709616390,BIMM 100,A03,193323,Staff,0,10,32,32
1683709617418,BIMM 101,A01,193329,McDonnell; Lisa Marie,0,3,24,24
1683709617418,BIMM 101,A02,193339,McDonnell; Lisa Marie,0,3,24,24
1683709617418,BIMM 101,B01,193354,McDonnell; Lisa Marie,0,4,24,24
1683709617418,BIMM 101,B02,193357,McDonnell; Lisa Marie,0,3,24,24
1683709618445,BIMM 110,A01,193377,Tat; John,0,11,32,32
1683709618445,BIMM 110,A02,193378,Tat; John,0,11,32,32
1683709619471,BIMM 120,A01,206116,Staff,0,0,32,32
1683709619471,BIMM 120,A02,206117,Staff,7,0,32,25
1683709619471,BIMM 120,A03,206121,Staff,21,0,32,11
1683709620501,BIPN 100,A01,193393,Park; Ji Young,0,15,32,32
1683709620501,BIPN 100,A02,193402,Park; Ji Young,0,14,32,32
1683709620501,BIPN 100,A03,193413,Park; Ji Young,0,14,32,32
1683709620501,BIPN 100,A04,193414,Park; Ji Young,0,13,32,32
1683709621530,BIPN 102,A01,193429,Staff,0,0,32,32
1683709621530,BIPN 102,A02,193438,Staff,18,0,32,14
1683709622557,BIPN 106,A01,193450,Reyes Gonzalez; Catalina,0,2,40,40
1683709623583,BIPN 134,A01,193465,Cooke; James Edward,0,0,32,32
1683709623583,BIPN 134,A02,193474,Cooke; James Edward,25,0,32,7
1683709623583,BIPN 134,A03,193485,Cooke; James Edward,29,0,32,3
1683709623583,BIPN 134,A04,193486,Cooke; James Edward,20,0,32,12
1683709623583,BIPN 134,A05,193491,Cooke; James Edward,31,0,32,1
1683709623583,BIPN 134,A06,193501,Cooke; James Edward,30,0,32,2
1683709623583,BIPN 134,A07,193510,Cooke; James Edward,29,0,32,3
1683709625633,BISP 194,A00,222522,Staff,14,0,32,18
1683709626659,CAT 124,A01,202407,Staff,19,0,25,6
1683709627688,CAT 125,A00,202408,Marchisotto; Jennifer Anne,2,0,20,18
1683709628714,CAT 125R,A00,202409,Smith; Lauryn Alissa,0,11,20,20
1683709628714,CAT 125R,B00,202410,Morales; Celeste Georgianna,0,11,20,20
1683709628714,CAT 125R,C00,202411,Irwin; Matthew Joseph,0,12,20,20
1683709629744,CENG 15,A01,204712,Yang; Kesong,0,1,0,0
1683709630768,CENG 114,A00,202070,Jahed Motlagh; Zeinab,5,0,20,15
1683709631798,CGS 105,A00,185477,Wesling; Megan E.,24,0,40,16
1683709632823,CGS 106,A00,185494,Staff,11,0,22,11
1683709633849,CGS 108,A00,185495,Staff,14,0,20,6
1683709634876,CGS 114,A00,185496,Staff,13,0,18,5
1683709635904,CGS 119,A00,185501,Staff,15,0,20,5
1683709636928,CGS 120,A00,185511,Staff,11,0,20,9
1683709637958,CHEM 4,A01,184675,Bussey; Thomas J,97,0,100,3
1683709638987,CHEM 6A,A01,184677,Staff,32,0,60,28
1683709640016,CHEM 6B,A01,184679,Staff,63,0,100,37
1683709641046,CHEM 6C,A01,184681,Bussey; Thomas J,0,0,50,50
1683709641046,CHEM 6C,A02,184682,Bussey; Thomas J,32,0,50,18
1683709642071,CHEM 40A,A01,184684,Albizati; Kim F.,33,0,100,67
1683709643095,CHEM 40B,A01,184686,Albizati; Kim F.,0,22,100,100
1683709644123,CHEM 41B,A01,184690,Staff,51,0,100,49
1683709645147,COGS 3,A01,184715,Boyle; Mary E. T.,0,27,40,40
1683709646174,COGS 14B,A01,185172,Staff,0,14,38,38
1683709647200,COGS 18,A01,184736,Staff,14,0,80,66
1683709648227,COGS 100,A01,184932,Staff,0,8,73,73
1683709649252,COGS 101A,A01,184935,Staff,0,40,30,30
1683709650276,COGS 101B,A01,184944,Staff,0,2,30,30
1683709651300,COGS 101C,A01,184946,Staff,0,10,30,30
1683709652325,COGS 102A,A01,184951,Johnson; Christine M.,1,0,40,39
1683709653351,COGS 107B,A01,184953,Mooshagian; Eric Frederick,0,52,40,40
1683709654375,COGS 118B,A01,184959,Gupta; Anjum,0,50,40,40
1683709655399,COGS 153,A00,184961,Staff,1,16,30,29
1683709656422,COGS 177,A00,184962,Staff,0,20,30,30
1683709657446,COGS 187A,A01,184969,Boyle; Mary E. T.,0,19,40,40
1683709658476,COMM 10,A01,185174,Staff,0,5,25,25
1683709658476,COMM 10,A02,185189,Staff,0,2,25,25
1683709658476,COMM 10,A03,269821,Staff,0,1,0,0
1683709659506,COMM 100B,A02,185476,Staff,10,0,25,15
1683709659506,COMM 100B,A03,277340,Staff,25,0,25,0
1683709660531,COMM 100C,A01,185314,Staff,2,0,25,23
1683709660531,COMM 100C,A02,185327,Staff,17,0,25,8
1683709661556,COMM 110M,A00,185349,Staff,0,0,40,40
1683709662583,COMM 113T,A00,185352,Staff,25,0,40,15
1683709663611,COMM 114I,A00,185353,Staff,31,0,40,9
1683709664639,COMM 131,A00,185354,Staff,17,0,30,13
1683709665667,CSE 8A,A50,185358,Cao; Yingjun,0,46,10,10
1683709666693,CSE 8B,A01,185362,Staff,0,48,50,50
1683709667719,CSE 11,A01,185416,Cao; Yingjun,0,91,10,10
1683709668749,CSE 20,A01,185445,Briones; Jor-el Thomas Caparas,3,0,25,22
1683709669774,CSE 21,A01,185447,Staff,9,0,50,41
1683709670805,CSE 101,A01,185451,Staff,0,13,50,50
1683709670805,CSE 101,B01,185453,Jones; Miles E,0,15,50,50
1683709672857,CSE 141,A01,185458,Eldon; John,16,0,100,84
1683709673883,CSE 141L,A01,185461,Eldon; John,8,0,100,92
1683709674913,CSE 142,A01,185463,Staff,34,0,60,26
1683709674913,CSE 142,B01,201355,Staff,0,7,60,60
1683709675941,CSE 142L,A01,185470,Staff,34,0,60,26
1683709675941,CSE 142L,B01,201417,Staff,0,6,60,60
1683709676966,CSE 190,A00,201433,Staff,32,0,49,17
1683709677992,DOC 1,A01,259136,Strom; Megan C.,7,0,15,8
1683709677992,DOC 1,A02,259137,Strom; Megan C.,15,0,15,0
1683709677992,DOC 1,A03,259138,Strom; Megan C.,14,0,15,1
1683709677992,DOC 1,A04,259139,Strom; Megan C.,13,0,15,2
1683709679017,DOC 100D,A00,259140,Pass; Natalye Joann,14,0,25,11
1683709680043,DSGN 1,A01,184749,Rill; Bryan,0,26,30,30
1683709681074,DSGN 100,A01,185168,Staff,0,2,25,25
1683709682100,ECE 5,A01,185626,Morris; Karcher William,0,12,0,0
1683709683125,ECE 101,A01,185628,Staff,14,0,70,56
1683709684157,ECE 107,A01,185635,Baghdadchi; Saharnaz,0,0,20,20
1683709684157,ECE 107,A02,185638,Baghdadchi; Saharnaz,1,0,20,19
1683709685185,ECE 148,A01,185647,Silberman; Jack,0,0,16,16
1683709686210,ECON 1,A01,185537,Crane; Meredith Helen,54,0,70,16
1683709687235,ECON 3,A01,185549,Crane; Meredith Helen,30,0,70,40
1683709688261,ECON 4,A01,203354,Anderson; John Charles,0,5,10,10
1683709689291,ECON 100A,A01,185574,Staff,0,5,40,40
1683709690319,ECON 100B,A01,185576,Staff,0,12,50,50
1683709691345,ECON 100C,A01,185589,Newhouse; Herbert S,30,0,70,40
1683709692369,ECON 105,A00,185608,Vespa; Emanuel Ignacio,19,0,35,16
1683709693392,ECON 109,A01,185610,Shishkin; Denis,9,0,35,26
1683709694417,ECON 110A,A01,185612,Staff,8,0,40,32
1683709695441,ECON 120A,A01,185615,Staff,19,0,40,21
1683709696469,ECON 120C,A01,185617,Sun; Yixiao,0,21,70,70
1683709697497,ECON 144,A00,203346,Squires; Dale E,2,0,35,33
1683709698522,ECON 171,A01,203349,Newhouse; Herbert S,0,1,35,35
1683709699550,ECON 173A,A01,185621,Toda; Alexis Akira,21,0,35,14
1683709700580,EDS 25,A01,202413,Staff,0,1,0,0
1683709700580,EDS 25,A02,202414,Staff,0,1,0,0
1683709700580,EDS 25,A03,202415,Staff,0,0,0,0
1683709700580,EDS 25,A04,202416,Staff,0,1,0,0
1683709700580,EDS 25,A05,202439,Staff,0,0,0,0
1683709700580,EDS 25,A06,202440,Staff,0,0,0,0
1683709700580,EDS 25,B01,202631,Staff,0,0,0,0
1683709700580,EDS 25,B02,202632,Staff,0,0,0,0
1683709700580,EDS 25,B03,202639,Staff,0,0,0,0
1683709700580,EDS 25,B04,202640,Staff,0,0,0,0
1683709700580,EDS 25,B05,202643,Staff,0,0,0,0
1683709700580,EDS 25,B06,202644,Staff,0,0,0,0
1683709701606,EDS 38,A01,202659,Black; Alison Michelle,25,0,25,0
1683709702631,EDS 115,A00,202652,Staff,18,0,30,12
1683709703656,EDS 125,A00,202649,Staff,13,0,30,17
1683709704683,EDS 126,A01,203332,Staff,30,0,30,0
1683709705710,EDS 139,A00,202838,Staff,16,0,25,9
1683709706741,EDS 146,A01,202655,Staff,14,0,25,11
1683709707777,ENG 15,A00,185667,Staff,0,1,0,0
1683709707777,ENG 15,B00,185672,Staff,0,0,0,0
1683709707777,ENG 15,C00,185675,Staff,0,0,0,0
1683709707777,ENG 15,D00,185682,Staff,0,0,0,0
1683709707777,ENG 15,E00,185684,Staff,0,0,0,0
1683709708806,ETHN 103,A00,185710,Staff,0,8,35,35
1683709709834,ETHN 103A,A00,199228,Man; Simeon S,0,0,9,9
1683709710862,ETHN 109,A00,185711,Staff,15,0,35,20
1683709711886,ETHN 142,A00,185726,Staff,0,4,30,30
1683709712912,ETHN 163J,A00,199229,Man; Simeon S,5,0,8,3
1683709713937,ETHN 168,A00,185727,Staff,7,0,10,3
1683709715017,ETHN 182,A00,185728,Staff,0,0,35,35
1683709716043,ETHN 183,A00,185737,Staff,9,0,18,9
1683709717066,GLBH 111,A01,209361,Burgos; Jose L.,0,0,0,0
1683709719115,HIEU 104,A00,185792,Staff,14,0,20,6
1683709720139,HIEU 115,A00,185800,Staff,0,0,20,20
1683709721164,HIEU 128,A00,185801,Staff,0,9,20,20
1683709722189,HIEU 147,A00,185802,Staff,15,0,20,5
1683709723215,HIEU 154,A00,185823,Staff,11,0,20,9
1683709724240,HILA 102,A00,185826,Staff,14,0,20,6
1683709725268,HILD 2C,A01,185778,Staff,0,13,20,20
1683709726293,HILD 7B,A01,185780,Kwak; Nancy,0,17,32,32
1683709726293,HILD 7B,A02,185781,Kwak; Nancy,0,18,32,32
1683709727320,HILD 30,A01,185791,Staff,12,0,20,8
1683709728348,HISC 119,A00,185830,Golan; Tal,0,10,20,20
1683709729374,HITO 156GS,A00,185831,Patterson; Patrick H.,0,0,0,23
1683709730398,HIUS 103,A00,185832,Man; Simeon S,0,4,20,20
1683709731423,HIUS 117,A00,185836,Kwak; Nancy,2,0,20,18
1683709732455,HIUS 125,A00,185840,Man; Simeon S,0,2,23,23
1683709733483,HIUS 149,A00,185845,Staff,1,0,20,19
1683709734513,HUM 3,A01,185882,Zavodny; Tatiana Sophia,0,8,50,50
1683709734513,HUM 3,B01,185899,Caldwell; Michael Alan,0,18,50,50
1683709735539,HUM 3GS,A00,185900,Patterson; Patrick H.,0,0,0,23
1683709736569,HUM 4,A01,185938,Zroka; Amy Liane,28,0,50,22
1683709736569,HUM 4,B01,185956,Watkins; Eric,0,6,50,50
1683709736569,HUM 4,B02,202209,Watkins; Eric,0,5,50,50
1683709736569,HUM 4,B03,202210,Watkins; Eric,0,5,50,50
1683709737594,HUM 5,A01,185958,West; Geoffrey Scott,0,0,50,50
1683709737594,HUM 5,A02,202215,West; Geoffrey Scott,0,1,50,50
1683709738617,INTL 190,A00,185959,Gagnon; Jeffrey C,0,0,0,9
1683709738617,INTL 190,B00,185960,Lettieri; Michael Joseph,0,0,0,2
1683709739641,JAPN 180,A00,254509,Staff,5,0,30,25
1683709740674,LATI 10,A01,202853,Kennemore; Amy Michelle,4,0,35,31
1683709740674,LATI 10,A02,202854,Kennemore; Amy Michelle,3,0,35,32
1683709740674,LATI 10,A03,270054,Kennemore; Amy Michelle,30,0,30,0
1683709741713,LATI 180,A00,202855,Kennemore; Amy Michelle,11,0,20,9
1683709742738,LAWS 101,A00,201767,Golan; Tal,0,7,40,40
1683709743764,LIFR 1C,A00,185961,Staff,6,0,20,14
1683709744792,LIFR 1CX,A00,185962,Staff,7,0,20,13
1683709745820,LIFR 1D,A00,185963,Staff,7,0,20,13
1683709746848,LIFR 1DX,A00,185964,Staff,7,0,20,13
1683709747872,LIGN 101,A01,186039,Staff,43,0,50,7
1683709748896,LIGN 165,A00,186040,Staff,14,0,50,36
1683709749919,LTCS 108,A00,186041,Staff,5,0,10,5
1683709750949,LTCS 119,A00,186042,Staff,15,0,20,5
1683709751973,LTCS 130,A00,186043,Wesling; Megan E.,15,0,25,10
1683709754027,LTEA 138,A00,186119,Staff,14,0,40,26
1683709755055,LTEN 124,A00,186148,Staff,5,0,25,20
1683709756078,LTEN 178,A00,186149,Staff,6,0,15,9
1683709757103,LTEN 181,A00,186150,Blanco; John D,34,0,40,6
1683709758129,LTWL 120,A00,186160,Staff,19,0,25,6
1683709759156,LTWL 165,A00,186161,Staff,22,0,25,3
1683709760184,LTWR 100,A00,186162,Staff,0,5,15,15
1683709761209,LTWR 102,A00,186163,Doller; Ben,5,0,15,10
1683709762236,MAE 8,A01,186412,Staff,0,1,0,0
1683709763261,MAE 30B,A00,186445,Bahadori; Mohammad Yousef,81,0,100,19
1683709764285,MAE 40,A00,186592,Bewley; Thomas R,10,0,50,40
1683709765310,MAE 101B,A00,186593,Bahadori; Mohammad Yousef,80,0,100,20
1683709766337,MAE 105,A00,186594,Bandaru; Prabhakar,10,0,50,40
1683709767361,MAE 107,A00,186599,Pham; Hieu Tan,0,8,120,120
1683709768385,MAE 148,A01,186660,Silberman; Jack,3,0,16,13
1683709769415,MATH 10A,A01,188095,Staff,0,6,35,35
1683709770446,MATH 10B,A01,188097,Bowers; Adam R.,0,12,30,30
1683709770446,MATH 10B,A02,188099,Bowers; Adam R.,0,11,30,30
1683709770446,MATH 10B,B01,188104,Bowers; Adam R.,0,10,30,30
1683709770446,MATH 10B,B02,188106,Bowers; Adam R.,0,9,30,30
1683709771471,MATH 10C,A01,188111,Staff,0,20,30,30
1683709771471,MATH 10C,A02,188127,Staff,0,19,30,30
1683709771471,MATH 10C,A03,188131,Staff,0,19,30,30
1683709771471,MATH 10C,B01,188218,Staff,17,0,30,13
1683709771471,MATH 10C,B02,188244,Staff,13,0,30,17
1683709771471,MATH 10C,B03,188277,Staff,14,0,30,16
1683709772501,MATH 18,A01,188344,Bach; Quang Tran,18,0,30,12
1683709772501,MATH 18,A02,188345,Bach; Quang Tran,11,0,30,19
1683709772501,MATH 18,B01,188353,Bach; Quang Tran,11,0,30,19
1683709772501,MATH 18,B02,188354,Bach; Quang Tran,19,0,30,11
1683709773530,MATH 20A,A01,188374,Staff,11,0,35,24
1683709774564,MATH 20B,A01,188382,Ohm; Ko Woon,7,0,30,23
1683709774564,MATH 20B,A02,188383,Ohm; Ko Woon,22,0,30,8
1683709774564,MATH 20B,B01,188385,Ohm; Ko Woon,7,0,30,23
1683709774564,MATH 20B,B02,188392,Ohm; Ko Woon,22,0,30,8
1683709775593,MATH 20C,A01,188394,Harel; Guershon,10,0,30,20
1683709775593,MATH 20C,A02,188395,Harel; Guershon,13,0,30,17
1683709775593,MATH 20C,B01,188404,Harel; Guershon,5,0,30,25
1683709775593,MATH 20C,B02,188405,Harel; Guershon,18,0,30,12
1683709776623,MATH 20D,A01,188414,Hammock; Frances H,0,1,30,30
1683709776623,MATH 20D,A02,188415,Hammock; Frances H,0,1,30,30
1683709776623,MATH 20D,B01,188447,Hammock; Frances H,0,1,30,30
1683709776623,MATH 20D,B02,188486,Hammock; Frances H,2,0,30,28
1683709777651,MATH 20E,A01,188649,Staff,21,0,30,9
1683709777651,MATH 20E,A02,188650,Staff,20,0,30,10
1683709777651,MATH 20E,A03,188673,Staff,0,0,30,30
1683709778676,MATH 102,A01,188675,Staff,0,40,35,35
1683709779705,MATH 103B,A01,188681,Staff,3,0,35,32
1683709779705,MATH 103B,B01,188692,Staff,5,0,35,30
1683709780731,MATH 109,A01,188695,Salehi Golsefidy; Alireza,24,0,35,11
1683709780731,MATH 109,A02,188696,Salehi Golsefidy; Alireza,25,0,35,10
1683709781759,MATH 120A,A01,188698,Eggers; John Dietrich,7,0,35,28
1683709782786,MATH 142B,A01,188736,Ioana; Adrian,0,0,30,30
1683709782786,MATH 142B,A02,188741,Ioana; Adrian,0,1,30,30
1683709782786,MATH 142B,A03,188743,Ioana; Adrian,0,2,30,30
1683709783810,MATH 168A,A01,188790,Staff,0,11,35,35
1683709784840,MATH 170A,A01,188803,Nie; Jiawang,0,2,35,35
1683709784840,MATH 170A,A02,188811,Nie; Jiawang,0,1,35,35
1683709784840,MATH 170A,A03,188814,Nie; Jiawang,1,0,35,34
1683709784840,MATH 170A,A04,188815,Nie; Jiawang,5,0,35,30
1683709785866,MATH 193B,A01,188817,Staff,0,0,35,35
1683709785866,MATH 193B,A02,188818,Staff,6,0,35,29
1683709786895,MGT 4,A01,202857,Anderson; John Charles,59,0,80,21
1683709787919,MGT 12,A00,202858,Lindenberger; Wade Douglas,40,0,90,50
1683709788946,MGT 18,A00,202859,Staff,73,0,90,17
1683709789971,MGT 18GS,A00,202860,McKay; Michael J,13,0,28,15
1683709790996,MGT 45,A00,202861,Pecore; Joseph P.,8,0,90,82
1683709792025,MGT 100,A00,202863,Yavorsky; Daniel Ryan,27,0,90,63
1683709793049,MGT 103,A00,202864,Ehrich; Kristine R,0,19,90,90
1683709794073,MGT 112,A00,202865,Ehrich; Kristine R,15,0,90,75
1683709795099,MGT 121A,A00,202868,Staff,70,0,90,20
1683709796123,MGT 131B,A00,202869,Anderson; John Charles,58,0,90,32
1683709797148,MGT 136,A00,202871,Lindenberger; Wade Douglas,83,0,90,7
1683709798170,MGT 164,A00,202873,Staff,0,67,90,91
1683709799198,MGT 164GS,A00,202874,McKay; Mary A,13,0,28,15
1683709800222,MGT 180,A00,202875,Staff,0,51,90,91
1683709801246,MMW 11R,A01,205019,Herbst; Matthew,0,0,30,30
1683709801246,MMW 11R,A02,205026,Herbst; Matthew,29,0,30,1
1683709802273,MMW 15,A01,193512,Chang; Edmond Yi-Teh,0,8,28,28
1683709802273,MMW 15,A02,193513,Chang; Edmond Yi-Teh,0,5,28,28
1683709802273,MMW 15,A03,193514,Chang; Edmond Yi-Teh,0,5,28,28
1683709802273,MMW 15,A04,193515,Chang; Edmond Yi-Teh,0,5,28,28
1683709802273,MMW 15,A05,193516,Chang; Edmond Yi-Teh,0,5,28,28
1683709802273,MMW 15,A06,193517,Chang; Edmond Yi-Teh,0,6,28,28
1683709802273,MMW 15,B01,193519,Chang; Edmond Yi-Teh,0,5,28,28
1683709802273,MMW 15,B02,193520,Chang; Edmond Yi-Teh,0,5,28,28
1683709802273,MMW 15,B03,193521,Chang; Edmond Yi-Teh,0,5,28,28
1683709802273,MMW 15,B04,193522,Chang; Edmond Yi-Teh,0,6,28,28
1683709802273,MMW 15,B05,193523,Chang; Edmond Yi-Teh,0,5,28,28
1683709802273,MMW 15,B06,193524,Chang; Edmond Yi-Teh,0,5,28,28
1683709803301,MMW 122,A01,193526,Rahimi; Babak,0,16,28,28
1683709803301,MMW 122,A02,193527,Rahimi; Babak,0,15,28,28
1683709803301,MMW 122,A03,193528,Rahimi; Babak,0,0,0,0
1683709803301,MMW 122,A04,193529,Rahimi; Babak,0,0,0,0
1683709804328,MUS 1A,A01,186663,Staff,0,18,35,35
1683709805355,MUS 4,A01,186715,Staff,0,12,35,35
1683709806385,MUS 5R,A01,186796,Dubnov; Shlomo,0,17,35,35
1683709807408,MUS 6,A01,186798,Staff,0,4,25,25
1683709808434,MUS 7,A01,186830,Staff,11,0,35,24
1683709809458,MUS 8,A01,186930,Staff,0,27,35,35
1683709810483,MUS 15,A01,186932,Staff,0,15,35,35
1683709810483,MUS 15,B01,186934,Staff,0,16,35,35
1683709811511,MUS 80,A00,186935,Staff,0,0,20,20
1683709811511,MUS 80,B00,186936,Staff,24,0,25,1
1683709812536,NANO 11,A00,204702,Lipomi; Darren John,0,0,0,0
1683709813566,NANO 15,A01,204709,Yang; Kesong,0,1,0,0
1683709814590,NANO 114,A00,202069,Jahed Motlagh; Zeinab,2,0,10,8
1683709815617,PHIL 1,A00,186955,Grush; Rick Scott,31,0,40,9
1683709816644,PHIL 10,A01,186973,Grush; Rick Scott,27,0,35,8
1683709816644,PHIL 10,A02,186974,Grush; Rick Scott,33,0,35,2
1683709817672,PHIL 13,A01,186976,Staff,1,0,35,34
1683709817672,PHIL 13,A02,186977,Staff,16,0,35,19
1683709818754,PHIL 14,A01,186979,Staff,30,0,35,5
1683709818754,PHIL 14,A02,186986,Staff,32,0,35,3
1683709819778,PHIL 28,A01,186988,Staff,16,0,30,14
1683709819778,PHIL 28,A02,186989,Staff,0,0,30,30
1683709819778,PHIL 28,A03,186990,Staff,10,0,30,20
1683709819778,PHIL 28,A04,186991,Staff,26,0,30,4
1683709820804,PHIL 120,A00,186997,Staff,23,0,40,17
1683709821833,PHIL 137,A00,187003,Staff,8,0,40,32
1683709822860,PHIL 150,A00,187015,Staff,47,0,70,23
1683709823893,PHIL 167,A00,187021,Lamey; Andy M.,34,0,40,6
1683709824922,PHIL 174,A01,202226,Staff,17,0,20,3
1683709824922,PHIL 174,A02,202235,Staff,20,0,20,0
1683709825946,PHIL 191A,A00,258918,Staff,0,0,1,1
1683709826973,PHYS 1A,A00,187028,Staff,26,0,60,34
1683709828001,PHYS 1AL,001,187036,Staff,3,0,30,27
1683709828001,PHYS 1AL,002,187049,Staff,18,0,30,12
1683709829028,PHYS 1B,A00,187058,Staff,21,0,60,39
1683709830053,PHYS 1BL,001,187064,Staff,0,1,30,30
1683709830053,PHYS 1BL,002,187070,Staff,4,0,30,26
1683709831080,PHYS 1C,A00,187082,Staff,30,0,120,90
1683709832104,PHYS 1CL,001,187088,Staff,0,9,30,30
1683709832104,PHYS 1CL,002,187089,Staff,0,1,30,30
1683709832104,PHYS 1CL,009,262693,Staff,9,0,30,21
1683709833129,PHYS 2B,A01,187097,Staff,55,0,115,60
1683709834154,PHYS 2C,A01,187099,Staff,63,0,115,52
1683709835183,PHYS 2CL,A01,187101,Staff,5,0,28,23
1683709835183,PHYS 2CL,A02,187102,Staff,15,0,28,13
1683709836207,PHYS 2D,A01,187123,Shotwell; Brian,95,0,115,20
1683709837234,PHYS 4B,A01,187133,Grinstein; Benjamin,35,0,50,15
1683709838258,POLI 10,A00,188819,Staff,0,4,50,50
1683709839282,POLI 11,A00,188827,Staff,43,0,50,7
1683709840309,POLI 13R,A00,188828,Staff,0,1,20,20
1683709841340,POLI 27,A01,188830,Elgin; Samuel Zincke,0,2,70,70
1683709842364,POLI 30,A00,188832,Desposato; Scott,30,0,50,20
1683709843389,POLI 102F,A00,188834,Staff,1,0,40,39
1683709844416,POLI 104A,A00,188852,Staff,12,0,30,18
1683709845440,POLI 104I,A00,188853,Staff,0,8,20,20
1683709846467,POLI 110B,A00,188854,Wiens; David,6,0,20,14
1683709847493,POLI 112A,A00,188855,Wiens; David,3,0,30,27
1683709848521,POLI 117R,A00,188856,Forman; Fonna,0,12,20,20
1683709849545,POLI 118,A00,188857,Ingham; Sean,8,0,20,12
1683709850573,POLI 120G,A00,188858,Staff,7,0,30,23
1683709851597,POLI 131CR,A00,188863,Hoston; Germaine,20,0,50,30
1683709852621,POLI 133,A00,188864,Nellis; Gareth Hb,44,0,50,6
1683709853649,POLI 134D,A00,188865,Desposato; Scott,27,0,30,3
1683709854674,POLI 142A,A00,188871,Gartzke; Erik,21,0,50,29
1683709855699,POLI 142K,A00,188874,Staff,38,0,50,12
1683709856727,POLI 143,A00,188940,Gartzke; Erik,15,0,30,15
1683709857752,POLI 153,A00,188943,Staff,1,0,20,19
1683709858779,POLI 160AA,A00,188944,Staff,10,0,40,30
1683709859806,POLI 170A,A00,188945,Staff,10,0,30,20
1683709861861,PSYC 1,A00,188952,Staff,36,0,90,54
1683709862889,PSYC 2,B00,188953,Staff,19,0,35,16
1683709863916,PSYC 6,A00,188970,Staff,47,0,60,13
1683709864941,PSYC 7,A00,188973,Staff,35,0,45,10
1683709865966,PSYC 60,A01,188980,Rickard; Timothy C.,42,0,60,18
1683709866991,PSYC 70,A01,189001,Steiner; Eric Tomas,22,0,45,23
1683709868020,PSYC 100,A00,189005,Lacefield; Katharine I,1,98,120,119
1683709869046,PSYC 102,A00,189008,Staff,6,0,30,24
1683709870075,PSYC 106,B00,189026,Gorman; Michael R.,27,0,60,33
1683709871108,PSYC 114,B01,189033,Winkielman; Piotr,0,31,30,30
1683709872139,PSYC 131,A00,189036,Anagnostaras; Stephan,0,44,60,60
1683709873164,PSYC 136,A00,189041,Lowe; Angela Beth,0,7,25,25
1683709874193,PSYC 137,A00,189057,Winkielman; Piotr,0,36,25,25
1683709875222,PSYC 144,A00,189107,Wixted; John T,0,11,50,50
1683709877273,PSYC 162,A00,189142,Staff,0,9,85,85
1683709878298,PSYC 172,A00,189144,Gorman; Michael R.,0,6,30,30
1683709880353,PSYC 179,A00,189146,Lacefield; Katharine I,0,88,120,120
1683709881383,PSYC 181,A00,189147,Anagnostaras; Stephan,0,45,90,90
1683709882411,PSYC 190R,A00,189148,Barner; David A.,0,23,80,80
1683709883436,PSYC 191,A00,189275,Rickard; Timothy C.,0,11,25,25
1683709884461,PSYC 193,A00,189276,Chapman; Eddie Nathaniel,0,1,0,4
1683709885488,PSYC 193L,A01,189281,Lowe; Angela Beth,8,0,20,12
1683709885488,PSYC 193L,B01,189285,Staff,28,0,35,7
1683709886512,RELI 149,A00,187137,Rahimi; Babak,6,0,40,34
1683709887541,SE 9,A01,187315,Staff,0,2,18,18
1683709888568,SE 101B,A00,187409,Staff,24,0,30,6
1683709889593,SE 110B,A00,187444,Staff,10,0,40,30
1683709890617,SE 130B,A00,187449,Staff,31,0,40,9
1683709891645,SE 150A,A00,187516,Staff,8,0,20,12
1683709892669,SE 154,A00,187528,Staff,29,0,50,21
1683709893694,SIO 3,A01,258171,Staff,35,0,40,5
1683709894719,SIO 10,A00,187144,Cook; Geoffrey W,0,6,75,75
1683709895748,SIO 45,A00,187152,Cook; Geoffrey W,1,7,100,99
1683709896772,SIO 109R,A00,194486,Staff,0,4,20,20
1683709898827,SIO 187,A01,187233,Kacev; David,12,0,40,28
1683709899855,SOCI 1,A01,258656,Thorpe; Charles Robert,28,0,30,2
1683709899855,SOCI 1,A02,258658,Thorpe; Charles Robert,30,0,30,0
1683709899855,SOCI 1,A03,258661,Thorpe; Charles Robert,25,0,25,0
1683709899855,SOCI 1,A04,258666,Thorpe; Charles Robert,22,0,25,3
1683709899855,SOCI 1,A05,258897,Thorpe; Charles Robert,22,0,25,3
1683709899855,SOCI 1,A06,258898,Thorpe; Charles Robert,25,0,25,0
1683709900880,SOCI 30,A01,258903,Pardo Guerra; Juan Pablo,14,0,30,16
1683709901908,SOCI 102,A00,258904,Staff,9,0,25,16
1683709902932,SOCI 106,A00,258905,Staff,19,0,25,6
1683709903957,SOCI 111,A00,258907,Ribas Norris; Janet Vanesa,26,0,30,4
1683709904981,SOCI 121R,A00,258908,Pardo Guerra; Juan Pablo,7,0,30,23
1683709906006,SOCI 126,A01,203330,Staff,14,0,20,6
1683709907032,SOCI 131,A00,258909,Thorpe; Charles Robert,30,0,60,30
1683709908057,SOCI 135,A00,258910,Payne; Christine Anna,0,13,30,30
1683709909081,SOCI 157,A00,258911,Staff,10,0,30,20
1683709910110,SOCI 184,A00,258912,Staff,25,0,30,5
1683709911135,SOCI 188D,A00,258913,Staff,22,0,30,8
1683709912159,SYN 2,001,187529,Staff,9,0,16,7
1683709912159,SYN 2,002,201452,Staff,0,20,16,16
1683709912159,SYN 2,003,201469,Staff,1,0,16,15
1683709913186,SYN 100,A01,187531,Staff,0,9,20,20
1683709913186,SYN 100,B01,201491,Staff,0,10,20,20
1683709914212,TDAC 1,A00,189286,Walsh; Kim C.,3,0,20,17
1683709914212,TDAC 1,B00,189287,Harting; Carla Kelso,10,0,20,10
1683709915239,TDAC 101,A00,189300,Walsh; Kim C.,16,0,20,4
1683709915239,TDAC 101,B00,189301,Harting; Carla Kelso,18,0,20,2
1683709916261,TDAC 102,A00,189304,Basso; Beatrice,14,0,20,6
1683709917289,TDAC 108,A00,189305,Staff,18,0,20,2
1683709918315,TDDE 131,A00,189310,Staff,19,0,20,1
1683709918315,TDDE 131,B00,189314,Staff,19,0,20,1
1683709918315,TDDE 131,C00,189315,Staff,48,0,50,2
1683709918315,TDDE 131,D00,189316,Staff,14,0,15,1
1683709918315,TDDE 131,E00,204841,Staff,20,0,20,0
1683709919343,TDGE 10,A00,189289,Staff,27,0,50,23
1683709919343,TDGE 10,B00,189290,Havis; Allan,0,1,50,50
1683709920369,TDGE 11,A00,189291,Fulton; Julia,0,4,50,50
1683709920369,TDGE 11,B00,189292,Staff,20,0,25,5
1683709920369,TDGE 11,C00,260270,Staff,0,0,0,0
1683709921394,TDGE 25,A00,189294,Staff,1,0,20,19
1683709922476,TDGE 124,A00,189318,Fulton; Julia,0,7,50,50
1683709923503,TDGE 125,A00,189319,Staff,13,0,25,12
1683709923503,TDGE 125,B00,189320,Staff,23,0,25,2
1683709924531,TDGE 127,A00,189322,Havis; Allan,1,0,50,49
1683709925556,TDHT 101,A00,189323,Staff,18,0,25,7
1683709925556,TDHT 101,B00,189324,Staff,25,0,25,0
1683709926581,TDHT 102,A00,189325,Staff,49,0,50,1
1683709927605,TDMV 1,A00,189295,Arcidiacono; Kristin,20,0,30,10
1683709927605,TDMV 1,B00,189296,Caligagan; Maria T.,23,0,30,7
1683709928629,TDMV 2,A00,189297,Sammartano; Tonnie,27,0,30,3
1683709928629,TDMV 2,B00,189299,Arcidiacono; Kristin,23,0,30,7
1683709929654,TDMV 3,A00,204998,Rincon; Alicia,22,0,30,8
1683709930679,TDMV 120,A00,189458,Sammartano; Tonnie,28,0,30,2
1683709931709,TDMV 138,A00,189541,Jun; Grace Shin Hae,20,0,40,20
1683709932740,TDMV 142,A00,189717,Caligagan; Tony,25,0,30,5
1683709932740,TDMV 142,B00,189718,Caligagan; Maria T.,25,0,30,5
1683709933767,TMC 2,A01,187533,Staff,25,0,25,0
1683709933767,TMC 2,A02,187534,Staff,25,0,25,0
1683709934791,USP 1,A01,187536,Kwak; Nancy,0,16,25,25
1683709935820,USP 5,A01,187538,Staff,8,0,25,17
1683709936844,USP 101,A00,199253,Staff,0,4,0,0
1683709937868,USP 124,A00,187562,Boomhower; Matthew Charles,0,0,30,30
1683709938896,USP 138,A00,187582,Staff,19,0,25,6
1683709939926,USP 152,A01,187597,Staff,3,0,25,22
1683709940954,USP 153,A00,187598,Staff,18,0,25,7
1683709941983,USP 168,A00,187607,Kwak; Nancy,2,0,5,3
1683709943008,USP 173,A00,187619,Staff,4,0,25,21
1683709944034,USP 181,A00,187638,Staff,0,4,25,25
1683709945061,VIS 103,A00,187650,Cruz; Edwin Teddy,17,0,75,58
1683709946091,VIS 110D,A00,187669,Staff,13,0,22,9
1683709947119,VIS 127C,A00,187720,Shen; Kuiyi,67,0,146,79
1683709948142,VIS 149,A00,187731,Yoldas; Pinar,0,12,22,22
1683709949172,VIS 151,A01,188091,Staff,22,0,34,12
1683709949172,VIS 151,A02,188092,Staff,11,0,34,23
1683709950197,VIS 160B,A00,188093,Stalbaum; Brett,0,1,10,10
1683709952250,WCWP 10B,A00,201720,Staff,0,0,5,5
1683709952250,WCWP 10B,B00,201722,Staff,0,0,6,6
1683709953277,WCWP 100,A00,201725,Gagnon; Jeffrey C,0,0,2,2
1683709953277,WCWP 100,B00,201727,Staff,0,4,15,15
1683709956385,ANBI 133,A00,258401,Wilder; Linnea Lorene,34,0,40,6
1683709957413,ANBI 140,A00,258395,Hrvoj Mihic; Branka,18,0,25,7
1683709958442,ANSC 120,A00,258402,Bialecki; Jon Anthony,26,0,40,14
1683709959467,ANSC 144,A00,258400,Staff,12,0,40,28
1683709961530,ANSC 166,A00,258396,Parish; Steven Martin,156,0,175,19
1683709962559,ANSC 180,A00,193533,Staff,8,0,20,12
1683709963585,ANSC 188,A00,258397,Jassal; Aftab,34,0,40,6
1683709964610,ANTH 3,A01,258316,Staff,23,0,30,7
1683709965636,ANTH 5,A00,258394,Semendeferi; Ekaterini,16,0,20,4
1683709966664,ANTH 21,A01,258331,Staff,4,0,40,36
1683709967689,ANTH 103,A00,258398,Varma; Saiba,15,0,25,10
1683709968723,AWP 10,001,202034,Staff,0,0,0,0
1683709968723,AWP 10,002,202035,Staff,0,0,0,0
1683709968723,AWP 10,003,202036,Staff,0,0,0,0
1683709968723,AWP 10,004,202037,Staff,0,0,0,0
1683709968723,AWP 10,005,202038,Staff,0,0,0,0
1683709968723,AWP 10,006,202039,Staff,0,0,0,0
1683709968723,AWP 10,007,202040,Staff,0,0,0,0
1683709968723,AWP 10,008,202041,Staff,0,0,0,0
1683709968723,AWP 10,009,202042,Staff,0,0,0,0
1683709968723,AWP 10,010,202043,Staff,0,0,0,0
1683709968723,AWP 10,011,202044,Staff,0,0,0,0
1683709968723,AWP 10,012,202045,Staff,0,0,0,0
1683709968723,AWP 10,013,202046,Staff,0,0,0,0
1683709968723,AWP 10,014,202047,Staff,0,0,0,0
1683709968723,AWP 10,015,202048,Staff,0,0,0,0
1683709968723,AWP 10,016,202049,Staff,0,0,0,0
1683709968723,AWP 10,017,202050,Staff,0,0,0,0
1683709968723,AWP 10,018,202051,Staff,0,0,0,0
1683709968723,AWP 10,019,202052,Staff,0,0,0,0
1683709968723,AWP 10,020,202053,Staff,0,0,0,0
1683709968723,AWP 10,021,202054,Staff,0,0,0,0
1683709968723,AWP 10,022,202055,Staff,0,0,0,0
1683709968723,AWP 10,023,202056,Staff,0,0,0,0
1683709968723,AWP 10,024,202057,Staff,0,0,0,0
1683709968723,AWP 10,025,202058,Staff,0,0,0,0
1683709968723,AWP 10,026,202059,Staff,0,0,0,0
1683709969751,AWP 102,001,202032,Staff,0,0,0,0
1683709969751,AWP 102,002,202033,Staff,0,0,0,0
1683709970780,BENG 100,A01,254234,Taylor Amos; Alyssa C,31,0,40,9
1683709971805,BENG 196,001,270013,Engler; Adam J.,9999,0,9999,0
1683709972830,BICD 100R,A01,202018,Smith; Laurie,0,7,32,32
1683709972830,BICD 100R,A02,202019,Smith; Laurie,0,3,32,32
1683709972830,BICD 100R,A03,202020,Smith; Laurie,0,1,32,32
1683709972830,BICD 100R,A04,202021,Smith; Laurie,6,0,32,26
1683709972830,BICD 100R,A05,202022,Smith; Laurie,10,0,32,22
1683709973854,BICD 136,A01,193242,Gustafson-Brown; Cindy,0,2,32,32
1683709973854,BICD 136,A02,193244,Gustafson-Brown; Cindy,13,0,32,19
1683709974879,BIEB 102,A01,193249,Butler; Shannon Rhey,0,0,32,32
1683709974879,BIEB 102,A02,193251,Butler; Shannon Rhey,0,0,32,32
1683709974879,BIEB 102,A03,193253,Butler; Shannon Rhey,0,0,32,32
1683709974879,BIEB 102,A04,193255,Butler; Shannon Rhey,13,0,32,19
1683709974879,BIEB 102,A05,193265,Butler; Shannon Rhey,25,0,32,7
1683709974879,BIEB 102,A06,193269,Butler; Shannon Rhey,12,0,32,20
1683709976937,BIEB 150,A01,193274,Staff,0,0,32,32
1683709976937,BIEB 150,A02,193285,Staff,24,0,32,8
1683709977961,BIEB 194,A00,193286,Kurle; Carolyn M.,19,0,32,13
1683709978986,BILD 1,A01,192291,Staff,15,0,32,17
1683709978986,BILD 1,A02,192292,Staff,30,0,32,2
1683709978986,BILD 1,B01,192520,Reuther; Keefe,0,1,0,0
1683709978986,BILD 1,B02,192532,Reuther; Keefe,0,1,0,0
1683709980018,BILD 3,A01,192556,Butler; Shannon Rhey,0,0,32,32
1683709980018,BILD 3,A02,192581,Butler; Shannon Rhey,0,1,32,32
1683709980018,BILD 3,A03,192611,Butler; Shannon Rhey,19,0,32,13
1683709980018,BILD 3,A04,192612,Butler; Shannon Rhey,23,0,32,9
1683709980018,BILD 3,A05,192613,Butler; Shannon Rhey,26,0,32,6
1683709980018,BILD 3,A06,192679,Butler; Shannon Rhey,27,0,32,5
1683709980018,BILD 3,A07,192682,Butler; Shannon Rhey,20,0,32,12
1683709981048,BILD 4,A01,192836,Reuther; Keefe,1,0,24,23
1683709981048,BILD 4,A02,193044,Reuther; Keefe,4,0,24,20
1683709982077,BILD 10,A01,193142,Gustafson-Brown; Cindy,29,0,32,3
1683709982077,BILD 10,A02,193149,Gustafson-Brown; Cindy,31,0,32,1
1683709983102,BIMM 100,A01,193301,Staff,0,6,32,32
1683709983102,BIMM 100,A02,193312,Staff,0,7,32,32
1683709983102,BIMM 100,A03,193323,Staff,0,10,32,32
1683709984126,BIMM 101,A01,193329,McDonnell; Lisa Marie,0,3,24,24
1683709984126,BIMM 101,A02,193339,McDonnell; Lisa Marie,0,3,24,24
1683709984126,BIMM 101,B01,193354,McDonnell; Lisa Marie,0,4,24,24
1683709984126,BIMM 101,B02,193357,McDonnell; Lisa Marie,0,3,24,24
1683709985152,BIMM 110,A01,193377,Tat; John,0,11,32,32
1683709985152,BIMM 110,A02,193378,Tat; John,0,11,32,32
1683709986178,BIMM 120,A01,206116,Staff,0,0,32,32
1683709986178,BIMM 120,A02,206117,Staff,7,0,32,25
1683709986178,BIMM 120,A03,206121,Staff,21,0,32,11
1683709987206,BIPN 100,A01,193393,Park; Ji Young,0,15,32,32
1683709987206,BIPN 100,A02,193402,Park; Ji Young,0,14,32,32
1683709987206,BIPN 100,A03,193413,Park; Ji Young,0,14,32,32
1683709987206,BIPN 100,A04,193414,Park; Ji Young,0,13,32,32
1683709988236,BIPN 102,A01,193429,Staff,0,0,32,32
1683709988236,BIPN 102,A02,193438,Staff,18,0,32,14
1683709989264,BIPN 106,A01,193450,Reyes Gonzalez; Catalina,0,2,40,40
1683709990289,BIPN 134,A01,193465,Cooke; James Edward,0,0,32,32
1683709990289,BIPN 134,A02,193474,Cooke; James Edward,25,0,32,7
1683709990289,BIPN 134,A03,193485,Cooke; James Edward,29,0,32,3
1683709990289,BIPN 134,A04,193486,Cooke; James Edward,20,0,32,12
1683709990289,BIPN 134,A05,193491,Cooke; James Edward,31,0,32,1
1683709990289,BIPN 134,A06,193501,Cooke; James Edward,30,0,32,2
1683709990289,BIPN 134,A07,193510,Cooke; James Edward,29,0,32,3
1683709992342,BISP 194,A00,222522,Staff,14,0,32,18
1683709993366,CAT 124,A01,202407,Staff,19,0,25,6
1683709994391,CAT 125,A00,202408,Marchisotto; Jennifer Anne,2,0,20,18
1683709995417,CAT 125R,A00,202409,Smith; Lauryn Alissa,0,11,20,20
1683709995417,CAT 125R,B00,202410,Morales; Celeste Georgianna,0,11,20,20
1683709995417,CAT 125R,C00,202411,Irwin; Matthew Joseph,0,12,20,20
1683709996444,CENG 15,A01,204712,Yang; Kesong,0,1,0,0
1683709997474,CENG 114,A00,202070,Jahed Motlagh; Zeinab,5,0,20,15
1683709998499,CGS 105,A00,185477,Wesling; Megan E.,24,0,40,16
1683709999524,CGS 106,A00,185494,Staff,11,0,22,11
1683710000549,CGS 108,A00,185495,Staff,14,0,20,6
1683710001573,CGS 114,A00,185496,Staff,13,0,18,5
1683710002599,CGS 119,A00,185501,Staff,15,0,20,5
1683710003623,CGS 120,A00,185511,Staff,11,0,20,9
1683710004649,CHEM 4,A01,184675,Bussey; Thomas J,97,0,100,3
1683710005673,CHEM 6A,A01,184677,Staff,32,0,60,28
1683710006701,CHEM 6B,A01,184679,Staff,63,0,100,37
1683710007727,CHEM 6C,A01,184681,Bussey; Thomas J,0,0,50,50
1683710007727,CHEM 6C,A02,184682,Bussey; Thomas J,32,0,50,18
1683710008757,CHEM 40A,A01,184684,Albizati; Kim F.,33,0,100,67
1683710009782,CHEM 40B,A01,184686,Albizati; Kim F.,0,22,100,100
1683710010806,CHEM 41B,A01,184690,Staff,51,0,100,49
1683710011837,COGS 3,A01,184715,Boyle; Mary E. T.,0,27,40,40
1683710012865,COGS 14B,A01,185172,Staff,0,14,38,38
1683710013893,COGS 18,A01,184736,Staff,14,0,80,66
1683710014918,COGS 100,A01,184932,Staff,0,8,73,73
1683710015947,COGS 101A,A01,184935,Staff,0,40,30,30
1683710016972,COGS 101B,A01,184944,Staff,0,2,30,30
1683710017998,COGS 101C,A01,184946,Staff,0,10,30,30
1683710019026,COGS 102A,A01,184951,Johnson; Christine M.,1,0,40,39
1683710020051,COGS 107B,A01,184953,Mooshagian; Eric Frederick,0,52,40,40
1683710021076,COGS 118B,A01,184959,Gupta; Anjum,0,50,40,40
1683710022105,COGS 153,A00,184961,Staff,1,16,30,29
1683710023131,COGS 177,A00,184962,Staff,0,20,30,30
1683710024159,COGS 187A,A01,184969,Boyle; Mary E. T.,0,19,40,40
1683710025187,COMM 10,A01,185174,Staff,0,5,25,25
1683710025187,COMM 10,A02,185189,Staff,0,2,25,25
1683710025187,COMM 10,A03,269821,Staff,0,1,0,0
1683710026267,COMM 100B,A02,185476,Staff,10,0,25,15
1683710026267,COMM 100B,A03,277340,Staff,25,0,25,0
1683710027290,COMM 100C,A01,185314,Staff,2,0,25,23
1683710027290,COMM 100C,A02,185327,Staff,17,0,25,8
1683710028314,COMM 110M,A00,185349,Staff,0,0,40,40
1683710029338,COMM 113T,A00,185352,Staff,25,0,40,15
1683710030362,COMM 114I,A00,185353,Staff,31,0,40,9
1683710031387,COMM 131,A00,185354,Staff,17,0,30,13
1683710032415,CSE 8A,A50,185358,Cao; Yingjun,0,46,10,10
1683710033443,CSE 8B,A01,185362,Staff,0,48,50,50
1683710034468,CSE 11,A01,185416,Cao; Yingjun,0,91,10,10
1683710035492,CSE 20,A01,185445,Briones; Jor-el Thomas Caparas,3,0,25,22
1683710036530,CSE 21,A01,185447,Staff,9,0,50,41
1683710037559,CSE 101,A01,185451,Staff,0,13,50,50
1683710037559,CSE 101,B01,185453,Jones; Miles E,0,15,50,50
1683710039611,CSE 141,A01,185458,Eldon; John,16,0,100,84
1683710040644,CSE 141L,A01,185461,Eldon; John,8,0,100,92
1683710041673,CSE 142,A01,185463,Staff,34,0,60,26
1683710041673,CSE 142,B01,201355,Staff,0,7,60,60
1683710042697,CSE 142L,A01,185470,Staff,34,0,60,26
1683710042697,CSE 142L,B01,201417,Staff,0,6,60,60
1683710043721,CSE 190,A00,201433,Staff,32,0,49,17
1683710044746,DOC 1,A01,259136,Strom; Megan C.,7,0,15,8
1683710044746,DOC 1,A02,259137,Strom; Megan C.,15,0,15,0
1683710044746,DOC 1,A03,259138,Strom; Megan C.,14,0,15,1
1683710044746,DOC 1,A04,259139,Strom; Megan C.,13,0,15,2
1683710045774,DOC 100D,A00,259140,Pass; Natalye Joann,14,0,25,11
1683710046798,DSGN 1,A01,184749,Rill; Bryan,0,26,30,30
1683710047827,DSGN 100,A01,185168,Staff,0,2,25,25
1683710048855,ECE 5,A01,185626,Morris; Karcher William,0,12,0,0
1683710049883,ECE 101,A01,185628,Staff,14,0,70,56
1683710050910,ECE 107,A01,185635,Baghdadchi; Saharnaz,0,0,20,20
1683710050910,ECE 107,A02,185638,Baghdadchi; Saharnaz,1,0,20,19
1683710051938,ECE 148,A01,185647,Silberman; Jack,0,0,16,16
1683710052963,ECON 1,A01,185537,Crane; Meredith Helen,54,0,70,16
1683710053987,ECON 3,A01,185549,Crane; Meredith Helen,30,0,70,40
1683710055015,ECON 4,A01,203354,Anderson; John Charles,0,5,10,10
1683710056042,ECON 100A,A01,185574,Staff,0,5,40,40
1683710057066,ECON 100B,A01,185576,Staff,0,12,50,50
1683710058091,ECON 100C,A01,185589,Newhouse; Herbert S,30,0,70,40
1683710059117,ECON 105,A00,185608,Vespa; Emanuel Ignacio,19,0,35,16
1683710060142,ECON 109,A01,185610,Shishkin; Denis,9,0,35,26
1683710061167,ECON 110A,A01,185612,Staff,8,0,40,32
1683710062191,ECON 120A,A01,185615,Staff,19,0,40,21
1683710063215,ECON 120C,A01,185617,Sun; Yixiao,0,21,70,70
1683710064241,ECON 144,A00,203346,Squires; Dale E,2,0,35,33
1683710065266,ECON 171,A01,203349,Newhouse; Herbert S,0,1,35,35
1683710066291,ECON 173A,A01,185621,Toda; Alexis Akira,21,0,35,14
1683710067322,EDS 25,A01,202413,Staff,0,1,0,0
1683710067322,EDS 25,A02,202414,Staff,0,1,0,0
1683710067322,EDS 25,A03,202415,Staff,0,0,0,0
1683710067322,EDS 25,A04,202416,Staff,0,1,0,0
1683710067322,EDS 25,A05,202439,Staff,0,0,0,0
1683710067322,EDS 25,A06,202440,Staff,0,0,0,0
1683710067322,EDS 25,B01,202631,Staff,0,0,0,0
1683710067322,EDS 25,B02,202632,Staff,0,0,0,0
1683710067322,EDS 25,B03,202639,Staff,0,0,0,0
1683710067322,EDS 25,B04,202640,Staff,0,0,0,0
1683710067322,EDS 25,B05,202643,Staff,0,0,0,0
1683710067322,EDS 25,B06,202644,Staff,0,0,0,0
1683710068347,EDS 38,A01,202659,Black; Alison Michelle,25,0,25,0
1683710069374,EDS 115,A00,202652,Staff,18,0,30,12
1683710070401,EDS 125,A00,202649,Staff,13,0,30,17
1683710071428,EDS 126,A01,203332,Staff,30,0,30,0
1683710072454,EDS 139,A00,202838,Staff,16,0,25,9
1683710073477,EDS 146,A01,202655,Staff,14,0,25,11
1683710074504,ENG 15,A00,185667,Staff,0,1,0,0
1683710074504,ENG 15,B00,185672,Staff,0,0,0,0
1683710074504,ENG 15,C00,185675,Staff,0,0,0,0
1683710074504,ENG 15,D00,185682,Staff,0,0,0,0
1683710074504,ENG 15,E00,185684,Staff,0,0,0,0
1683710075531,ETHN 103,A00,185710,Staff,0,8,35,35
1683710076554,ETHN 103A,A00,199228,Man; Simeon S,0,0,9,9
1683710077578,ETHN 109,A00,185711,Staff,15,0,35,20
1683710078602,ETHN 142,A00,185726,Staff,0,4,30,30
1683710079627,ETHN 163J,A00,199229,Man; Simeon S,5,0,8,3
1683710080652,ETHN 168,A00,185727,Staff,7,0,10,3
1683710081676,ETHN 182,A00,185728,Staff,0,0,35,35
1683710082699,ETHN 183,A00,185737,Staff,9,0,18,9
1683710083728,GLBH 111,A01,209361,Burgos; Jose L.,0,0,0,0
1683710085777,HIEU 104,A00,185792,Staff,14,0,20,6
1683710086803,HIEU 115,A00,185800,Staff,0,0,20,20
1683710087832,HIEU 128,A00,185801,Staff,0,9,20,20
1683710088858,HIEU 147,A00,185802,Staff,15,0,20,5
1683710089887,HIEU 154,A00,185823,Staff,11,0,20,9
1683710090915,HILA 102,A00,185826,Staff,14,0,20,6
1683710091944,HILD 2C,A01,185778,Staff,0,13,20,20
1683710092969,HILD 7B,A01,185780,Kwak; Nancy,0,17,32,32
1683710092969,HILD 7B,A02,185781,Kwak; Nancy,0,18,32,32
1683710093994,HILD 30,A01,185791,Staff,12,0,20,8
1683710095020,HISC 119,A00,185830,Golan; Tal,0,10,20,20
1683710096046,HITO 156GS,A00,185831,Patterson; Patrick H.,0,0,0,23
1683710097076,HIUS 103,A00,185832,Man; Simeon S,0,4,20,20
1683710098100,HIUS 117,A00,185836,Kwak; Nancy,2,0,20,18
1683710099128,HIUS 125,A00,185840,Man; Simeon S,0,2,23,23
1683710100155,HIUS 149,A00,185845,Staff,1,0,20,19
1683710101182,HUM 3,A01,185882,Zavodny; Tatiana Sophia,0,8,50,50
1683710101182,HUM 3,B01,185899,Caldwell; Michael Alan,0,18,50,50
1683710102205,HUM 3GS,A00,185900,Patterson; Patrick H.,0,0,0,23
1683710103238,HUM 4,A01,185938,Zroka; Amy Liane,28,0,50,22
1683710103238,HUM 4,B01,185956,Watkins; Eric,0,6,50,50
1683710103238,HUM 4,B02,202209,Watkins; Eric,0,5,50,50
1683710103238,HUM 4,B03,202210,Watkins; Eric,0,5,50,50
1683710104262,HUM 5,A01,185958,West; Geoffrey Scott,0,0,50,50
1683710104262,HUM 5,A02,202215,West; Geoffrey Scott,0,1,50,50
1683710105287,INTL 190,A00,185959,Gagnon; Jeffrey C,0,0,0,9
1683710105287,INTL 190,B00,185960,Lettieri; Michael Joseph,0,0,0,2
1683710106314,JAPN 180,A00,254509,Staff,5,0,30,25
1683710107343,LATI 10,A01,202853,Kennemore; Amy Michelle,4,0,35,31
1683710107343,LATI 10,A02,202854,Kennemore; Amy Michelle,3,0,35,32
1683710107343,LATI 10,A03,270054,Kennemore; Amy Michelle,30,0,30,0
1683710108372,LATI 180,A00,202855,Kennemore; Amy Michelle,11,0,20,9
1683710109396,LAWS 101,A00,201767,Golan; Tal,0,7,40,40
1683710110420,LIFR 1C,A00,185961,Staff,6,0,20,14
1683710111445,LIFR 1CX,A00,185962,Staff,7,0,20,13
1683710112470,LIFR 1D,A00,185963,Staff,7,0,20,13
1683710113497,LIFR 1DX,A00,185964,Staff,7,0,20,13
1683710114525,LIGN 101,A01,186039,Staff,43,0,50,7
1683710115549,LIGN 165,A00,186040,Staff,14,0,50,36
1683710116576,LTCS 108,A00,186041,Staff,5,0,10,5
1683710117600,LTCS 119,A00,186042,Staff,15,0,20,5
1683710118624,LTCS 130,A00,186043,Wesling; Megan E.,15,0,25,10
1683710120678,LTEA 138,A00,186119,Staff,14,0,40,26
1683710121703,LTEN 124,A00,186148,Staff,5,0,25,20
1683710122730,LTEN 178,A00,186149,Staff,6,0,15,9
1683710123755,LTEN 181,A00,186150,Blanco; John D,34,0,40,6
1683710124779,LTWL 120,A00,186160,Staff,19,0,25,6
1683710125804,LTWL 165,A00,186161,Staff,22,0,25,3
1683710126829,LTWR 100,A00,186162,Staff,0,5,15,15
1683710127859,LTWR 102,A00,186163,Doller; Ben,5,0,15,10
1683710128887,MAE 8,A01,186412,Staff,0,1,0,0
1683710129972,MAE 30B,A00,186445,Bahadori; Mohammad Yousef,81,0,100,19
1683710130997,MAE 40,A00,186592,Bewley; Thomas R,10,0,50,40
1683710132024,MAE 101B,A00,186593,Bahadori; Mohammad Yousef,80,0,100,20
1683710133053,MAE 105,A00,186594,Bandaru; Prabhakar,10,0,50,40
1683710134080,MAE 107,A00,186599,Pham; Hieu Tan,0,8,120,120
1683710135104,MAE 148,A01,186660,Silberman; Jack,3,0,16,13
1683710136132,MATH 10A,A01,188095,Staff,0,6,35,35
1683710137162,MATH 10B,A01,188097,Bowers; Adam R.,0,12,30,30
1683710137162,MATH 10B,A02,188099,Bowers; Adam R.,0,11,30,30
1683710137162,MATH 10B,B01,188104,Bowers; Adam R.,0,10,30,30
1683710137162,MATH 10B,B02,188106,Bowers; Adam R.,0,9,30,30
1683710138186,MATH 10C,A01,188111,Staff,0,20,30,30
1683710138186,MATH 10C,A02,188127,Staff,0,19,30,30
1683710138186,MATH 10C,A03,188131,Staff,0,19,30,30
1683710138186,MATH 10C,B01,188218,Staff,17,0,30,13
1683710138186,MATH 10C,B02,188244,Staff,13,0,30,17
1683710138186,MATH 10C,B03,188277,Staff,14,0,30,16
1683710139212,MATH 18,A01,188344,Bach; Quang Tran,18,0,30,12
1683710139212,MATH 18,A02,188345,Bach; Quang Tran,11,0,30,19
1683710139212,MATH 18,B01,188353,Bach; Quang Tran,11,0,30,19
1683710139212,MATH 18,B02,188354,Bach; Quang Tran,19,0,30,11
1683710140238,MATH 20A,A01,188374,Staff,11,0,35,24
1683710141266,MATH 20B,A01,188382,Ohm; Ko Woon,7,0,30,23
1683710141266,MATH 20B,A02,188383,Ohm; Ko Woon,22,0,30,8
1683710141266,MATH 20B,B01,188385,Ohm; Ko Woon,7,0,30,23
1683710141266,MATH 20B,B02,188392,Ohm; Ko Woon,22,0,30,8
1683710142293,MATH 20C,A01,188394,Harel; Guershon,10,0,30,20
1683710142293,MATH 20C,A02,188395,Harel; Guershon,13,0,30,17
1683710142293,MATH 20C,B01,188404,Harel; Guershon,5,0,30,25
1683710142293,MATH 20C,B02,188405,Harel; Guershon,18,0,30,12
1683710143317,MATH 20D,A01,188414,Hammock; Frances H,0,1,30,30
1683710143317,MATH 20D,A02,188415,Hammock; Frances H,0,1,30,30
1683710143317,MATH 20D,B01,188447,Hammock; Frances H,0,1,30,30
1683710143317,MATH 20D,B02,188486,Hammock; Frances H,2,0,30,28
1683710144341,MATH 20E,A01,188649,Staff,21,0,30,9
1683710144341,MATH 20E,A02,188650,Staff,20,0,30,10
1683710144341,MATH 20E,A03,188673,Staff,0,0,30,30
1683710145369,MATH 102,A01,188675,Staff,0,40,35,35
1683710146393,MATH 103B,A01,188681,Staff,3,0,35,32
1683710146393,MATH 103B,B01,188692,Staff,5,0,35,30
1683710147418,MATH 109,A01,188695,Salehi Golsefidy; Alireza,24,0,35,11
1683710147418,MATH 109,A02,188696,Salehi Golsefidy; Alireza,25,0,35,10
1683710159960,MATH 120A,A01,188698,Eggers; John Dietrich,7,0,35,28
1683710160987,MATH 142B,A01,188736,Ioana; Adrian,0,0,30,30
1683710160987,MATH 142B,A02,188741,Ioana; Adrian,0,1,30,30
1683710160987,MATH 142B,A03,188743,Ioana; Adrian,0,2,30,30
1683710162016,MATH 168A,A01,188790,Staff,0,11,35,35
1683710163045,MATH 170A,A01,188803,Nie; Jiawang,0,2,35,35
1683710163045,MATH 170A,A02,188811,Nie; Jiawang,0,1,35,35
1683710163045,MATH 170A,A03,188814,Nie; Jiawang,1,0,35,34
1683710163045,MATH 170A,A04,188815,Nie; Jiawang,5,0,35,30
1683710164073,MATH 193B,A01,188817,Staff,0,0,35,35
1683710164073,MATH 193B,A02,188818,Staff,6,0,35,29
1683710165105,MGT 4,A01,202857,Anderson; John Charles,59,0,80,21
1683710166131,MGT 12,A00,202858,Lindenberger; Wade Douglas,40,0,90,50
1683710167159,MGT 18,A00,202859,Staff,73,0,90,17
1683710168184,MGT 18GS,A00,202860,McKay; Michael J,13,0,28,15
1683710169209,MGT 45,A00,202861,Pecore; Joseph P.,8,0,90,82
1683710170232,MGT 100,A00,202863,Yavorsky; Daniel Ryan,27,0,90,63
1683710171257,MGT 103,A00,202864,Ehrich; Kristine R,0,19,90,90
1683710172283,MGT 112,A00,202865,Ehrich; Kristine R,15,0,90,75
1683710173310,MGT 121A,A00,202868,Staff,70,0,90,20
1683710174338,MGT 131B,A00,202869,Anderson; John Charles,58,0,90,32
1683710175364,MGT 136,A00,202871,Lindenberger; Wade Douglas,83,0,90,7
1683710176388,MGT 164,A00,202873,Staff,0,67,90,91
1683710177413,MGT 164GS,A00,202874,McKay; Mary A,13,0,28,15
1683710178441,MGT 180,A00,202875,Staff,0,51,90,91
1683710179470,MMW 11R,A01,205019,Herbst; Matthew,0,0,30,30
1683710179470,MMW 11R,A02,205026,Herbst; Matthew,29,0,30,1
1683710180495,MMW 15,A01,193512,Chang; Edmond Yi-Teh,0,8,28,28
1683710180495,MMW 15,A02,193513,Chang; Edmond Yi-Teh,0,5,28,28
1683710180495,MMW 15,A03,193514,Chang; Edmond Yi-Teh,0,5,28,28
1683710180495,MMW 15,A04,193515,Chang; Edmond Yi-Teh,0,5,28,28
1683710180495,MMW 15,A05,193516,Chang; Edmond Yi-Teh,0,5,28,28
1683710180495,MMW 15,A06,193517,Chang; Edmond Yi-Teh,0,6,28,28
1683710180495,MMW 15,B01,193519,Chang; Edmond Yi-Teh,0,5,28,28
1683710180495,MMW 15,B02,193520,Chang; Edmond Yi-Teh,0,5,28,28
1683710180495,MMW 15,B03,193521,Chang; Edmond Yi-Teh,0,5,28,28
1683710180495,MMW 15,B04,193522,Chang; Edmond Yi-Teh,0,6,28,28
1683710180495,MMW 15,B05,193523,Chang; Edmond Yi-Teh,0,5,28,28
1683710180495,MMW 15,B06,193524,Chang; Edmond Yi-Teh,0,5,28,28
1683710181521,MMW 122,A01,193526,Rahimi; Babak,0,16,28,28
1683710181521,MMW 122,A02,193527,Rahimi; Babak,0,15,28,28
1683710181521,MMW 122,A03,193528,Rahimi; Babak,0,0,0,0
1683710181521,MMW 122,A04,193529,Rahimi; Babak,0,0,0,0
1683710182548,MUS 1A,A01,186663,Staff,0,18,35,35
1683710183573,MUS 4,A01,186715,Staff,0,12,35,35
1683710184601,MUS 5R,A01,186796,Dubnov; Shlomo,0,17,35,35
1683710185626,MUS 6,A01,186798,Staff,0,4,25,25
1683710186652,MUS 7,A01,186830,Staff,11,0,35,24
1683710187676,MUS 8,A01,186930,Staff,0,27,35,35
1683710188705,MUS 15,A01,186932,Staff,0,15,35,35
1683710188705,MUS 15,B01,186934,Staff,0,16,35,35
1683710189728,MUS 80,A00,186935,Staff,0,0,20,20
1683710189728,MUS 80,B00,186936,Staff,24,0,25,1
1683710190753,NANO 11,A00,204702,Lipomi; Darren John,0,0,0,0
1683710191784,NANO 15,A01,204709,Yang; Kesong,0,1,0,0
1683710192808,NANO 114,A00,202069,Jahed Motlagh; Zeinab,2,0,10,8
1683710193834,PHIL 1,A00,186955,Grush; Rick Scott,31,0,40,9
1683710194859,PHIL 10,A01,186973,Grush; Rick Scott,27,0,35,8
1683710194859,PHIL 10,A02,186974,Grush; Rick Scott,33,0,35,2
1683710195884,PHIL 13,A01,186976,Staff,1,0,35,34
1683710195884,PHIL 13,A02,186977,Staff,16,0,35,19
1683710196913,PHIL 14,A01,186979,Staff,30,0,35,5
1683710196913,PHIL 14,A02,186986,Staff,32,0,35,3
1683710197941,PHIL 28,A01,186988,Staff,16,0,30,14
1683710197941,PHIL 28,A02,186989,Staff,0,0,30,30
1683710197941,PHIL 28,A03,186990,Staff,10,0,30,20
1683710197941,PHIL 28,A04,186991,Staff,26,0,30,4
1683710198965,PHIL 120,A00,186997,Staff,23,0,40,17
1683710199990,PHIL 137,A00,187003,Staff,8,0,40,32
1683710201019,PHIL 150,A00,187015,Staff,47,0,70,23
1683710202044,PHIL 167,A00,187021,Lamey; Andy M.,34,0,40,6
1683710203069,PHIL 174,A01,202226,Staff,17,0,20,3
1683710203069,PHIL 174,A02,202235,Staff,20,0,20,0
1683710204097,PHIL 191A,A00,258918,Staff,0,0,1,1
1683710205125,PHYS 1A,A00,187028,Staff,26,0,60,34
1683710206154,PHYS 1AL,001,187036,Staff,3,0,30,27
1683710206154,PHYS 1AL,002,187049,Staff,18,0,30,12
1683710207181,PHYS 1B,A00,187058,Staff,21,0,60,39
1683710208205,PHYS 1BL,001,187064,Staff,0,1,30,30
1683710208205,PHYS 1BL,002,187070,Staff,4,0,30,26
1683710209231,PHYS 1C,A00,187082,Staff,30,0,120,90
1683710210259,PHYS 1CL,001,187088,Staff,0,9,30,30
1683710210259,PHYS 1CL,002,187089,Staff,0,1,30,30
1683710210259,PHYS 1CL,009,262693,Staff,9,0,30,21
1683710211284,PHYS 2B,A01,187097,Staff,55,0,115,60
1683710212313,PHYS 2C,A01,187099,Staff,63,0,115,52
1683710213343,PHYS 2CL,A01,187101,Staff,5,0,28,23
1683710213343,PHYS 2CL,A02,187102,Staff,15,0,28,13
1683710214368,PHYS 2D,A01,187123,Shotwell; Brian,95,0,115,20
1683710215392,PHYS 4B,A01,187133,Grinstein; Benjamin,35,0,50,15
1683710216420,POLI 10,A00,188819,Staff,0,4,50,50
1683710217448,POLI 11,A00,188827,Staff,43,0,50,7
1683710218475,POLI 13R,A00,188828,Staff,0,1,20,20
1683710219501,POLI 27,A01,188830,Elgin; Samuel Zincke,0,2,70,70
1683710220526,POLI 30,A00,188832,Desposato; Scott,30,0,50,20
1683710221558,POLI 102F,A00,188834,Staff,1,0,40,39
1683710222583,POLI 104A,A00,188852,Staff,12,0,30,18
1683710223607,POLI 104I,A00,188853,Staff,0,8,20,20
1683710224637,POLI 110B,A00,188854,Wiens; David,6,0,20,14
1683710225665,POLI 112A,A00,188855,Wiens; David,3,0,30,27
1683710226693,POLI 117R,A00,188856,Forman; Fonna,0,12,20,20
1683710227717,POLI 118,A00,188857,Ingham; Sean,8,0,20,12
1683710228744,POLI 120G,A00,188858,Staff,7,0,30,23
1683710229775,POLI 131CR,A00,188863,Hoston; Germaine,20,0,50,30
1683710230802,POLI 133,A00,188864,Nellis; Gareth Hb,44,0,50,6
1683710231826,POLI 134D,A00,188865,Desposato; Scott,27,0,30,3
1683710232853,POLI 142A,A00,188871,Gartzke; Erik,21,0,50,29
1683710233876,POLI 142K,A00,188874,Staff,38,0,50,12
1683710234899,POLI 143,A00,188940,Gartzke; Erik,15,0,30,15
1683710235923,POLI 153,A00,188943,Staff,1,0,20,19
1683710236947,POLI 160AA,A00,188944,Staff,10,0,40,30
1683710237973,POLI 170A,A00,188945,Staff,10,0,30,20
1683710240025,PSYC 1,A00,188952,Staff,36,0,90,54
1683710241053,PSYC 2,B00,188953,Staff,19,0,35,16
1683710242077,PSYC 6,A00,188970,Staff,47,0,60,13
1683710243101,PSYC 7,A00,188973,Staff,35,0,45,10
1683710244129,PSYC 60,A01,188980,Rickard; Timothy C.,42,0,60,18
1683710245212,PSYC 70,A01,189001,Steiner; Eric Tomas,22,0,45,23
1683710246238,PSYC 100,A00,189005,Lacefield; Katharine I,1,98,120,119
1683710247262,PSYC 102,A00,189008,Staff,6,0,30,24
1683710248288,PSYC 106,B00,189026,Gorman; Michael R.,27,0,60,33
1683710249311,PSYC 114,B01,189033,Winkielman; Piotr,0,31,30,30
1683710250339,PSYC 131,A00,189036,Anagnostaras; Stephan,0,44,60,60
1683710251368,PSYC 136,A00,189041,Lowe; Angela Beth,0,7,25,25
1683710252396,PSYC 137,A00,189057,Winkielman; Piotr,0,36,25,25
1683710253425,PSYC 144,A00,189107,Wixted; John T,0,11,50,50
1683710255474,PSYC 162,A00,189142,Staff,0,9,85,85
1683710256499,PSYC 172,A00,189144,Gorman; Michael R.,0,6,30,30
1683710258549,PSYC 179,A00,189146,Lacefield; Katharine I,0,88,120,120
1683710259575,PSYC 181,A00,189147,Anagnostaras; Stephan,0,45,90,90
1683710260603,PSYC 190R,A00,189148,Barner; David A.,0,23,80,80
1683710261627,PSYC 191,A00,189275,Rickard; Timothy C.,0,11,25,25
1683710262654,PSYC 193,A00,189276,Chapman; Eddie Nathaniel,0,1,0,4
1683710263679,PSYC 193L,A01,189281,Lowe; Angela Beth,8,0,20,12
1683710263679,PSYC 193L,B01,189285,Staff,28,0,35,7
1683710264703,RELI 149,A00,187137,Rahimi; Babak,6,0,40,34
1683710265728,SE 9,A01,187315,Staff,0,2,18,18
1683710266752,SE 101B,A00,187409,Staff,24,0,30,6
1683710267777,SE 110B,A00,187444,Staff,10,0,40,30
1683710268806,SE 130B,A00,187449,Staff,31,0,40,9
1683710269835,SE 150A,A00,187516,Staff,8,0,20,12
1683710270870,SE 154,A00,187528,Staff,29,0,50,21
1683710271901,SIO 3,A01,258171,Staff,35,0,40,5
1683710272927,SIO 10,A00,187144,Cook; Geoffrey W,0,6,75,75
1683710273950,SIO 45,A00,187152,Cook; Geoffrey W,1,7,100,99
1683710274974,SIO 109R,A00,194486,Staff,0,4,20,20
1683710277028,SIO 187,A01,187233,Kacev; David,12,0,40,28
1683710278052,SOCI 1,A01,258656,Thorpe; Charles Robert,28,0,30,2
1683710278052,SOCI 1,A02,258658,Thorpe; Charles Robert,30,0,30,0
1683710278052,SOCI 1,A03,258661,Thorpe; Charles Robert,25,0,25,0
1683710278052,SOCI 1,A04,258666,Thorpe; Charles Robert,22,0,25,3
1683710278052,SOCI 1,A05,258897,Thorpe; Charles Robert,22,0,25,3
1683710278052,SOCI 1,A06,258898,Thorpe; Charles Robert,25,0,25,0
1683710279082,SOCI 30,A01,258903,Pardo Guerra; Juan Pablo,14,0,30,16
1683710280109,SOCI 102,A00,258904,Staff,9,0,25,16
1683710281132,SOCI 106,A00,258905,Staff,19,0,25,6
1683710282157,SOCI 111,A00,258907,Ribas Norris; Janet Vanesa,26,0,30,4
1683710283185,SOCI 121R,A00,258908,Pardo Guerra; Juan Pablo,7,0,30,23
1683710284209,SOCI 126,A01,203330,Staff,14,0,20,6
1683710285233,SOCI 131,A00,258909,Thorpe; Charles Robert,30,0,60,30
1683710286261,SOCI 135,A00,258910,Payne; Christine Anna,0,13,30,30
1683710287286,SOCI 157,A00,258911,Staff,10,0,30,20
1683710288312,SOCI 184,A00,258912,Staff,25,0,30,5
1683710289338,SOCI 188D,A00,258913,Staff,22,0,30,8
1683710290362,SYN 2,001,187529,Staff,9,0,16,7
1683710290362,SYN 2,002,201452,Staff,0,20,16,16
1683710290362,SYN 2,003,201469,Staff,1,0,16,15
1683710291387,SYN 100,A01,187531,Staff,0,9,20,20
1683710291387,SYN 100,B01,201491,Staff,0,10,20,20
1683710292414,TDAC 1,A00,189286,Walsh; Kim C.,3,0,20,17
1683710292414,TDAC 1,B00,189287,Harting; Carla Kelso,10,0,20,10
1683710293440,TDAC 101,A00,189300,Walsh; Kim C.,16,0,20,4
1683710293440,TDAC 101,B00,189301,Harting; Carla Kelso,18,0,20,2
1683710294465,TDAC 102,A00,189304,Basso; Beatrice,14,0,20,6
1683710295491,TDAC 108,A00,189305,Staff,18,0,20,2
1683710296515,TDDE 131,A00,189310,Staff,19,0,20,1
1683710296515,TDDE 131,B00,189314,Staff,19,0,20,1
1683710296515,TDDE 131,C00,189315,Staff,48,0,50,2
1683710296515,TDDE 131,D00,189316,Staff,14,0,15,1
1683710296515,TDDE 131,E00,204841,Staff,20,0,20,0
1683710297538,TDGE 10,A00,189289,Staff,27,0,50,23
1683710297538,TDGE 10,B00,189290,Havis; Allan,0,1,50,50
1683710298565,TDGE 11,A00,189291,Fulton; Julia,0,4,50,50
1683710298565,TDGE 11,B00,189292,Staff,20,0,25,5
1683710298565,TDGE 11,C00,260270,Staff,0,0,0,0
1683710299593,TDGE 25,A00,189294,Staff,1,0,20,19
1683710300622,TDGE 124,A00,189318,Fulton; Julia,0,7,50,50
1683710301649,TDGE 125,A00,189319,Staff,13,0,25,12
1683710301649,TDGE 125,B00,189320,Staff,23,0,25,2
1683710302674,TDGE 127,A00,189322,Havis; Allan,1,0,50,49
1683710303699,TDHT 101,A00,189323,Staff,18,0,25,7
1683710303699,TDHT 101,B00,189324,Staff,25,0,25,0
1683710304723,TDHT 102,A00,189325,Staff,49,0,50,1
1683710305751,TDMV 1,A00,189295,Arcidiacono; Kristin,20,0,30,10
1683710305751,TDMV 1,B00,189296,Caligagan; Maria T.,23,0,30,7
1683710306780,TDMV 2,A00,189297,Sammartano; Tonnie,27,0,30,3
1683710306780,TDMV 2,B00,189299,Arcidiacono; Kristin,23,0,30,7
1683710307806,TDMV 3,A00,204998,Rincon; Alicia,22,0,30,8
1683710308835,TDMV 120,A00,189458,Sammartano; Tonnie,28,0,30,2
1683710309861,TDMV 138,A00,189541,Jun; Grace Shin Hae,20,0,40,20
1683710310887,TDMV 142,A00,189717,Caligagan; Tony,25,0,30,5
1683710310887,TDMV 142,B00,189718,Caligagan; Maria T.,25,0,30,5
1683710311914,TMC 2,A01,187533,Staff,25,0,25,0
1683710311914,TMC 2,A02,187534,Staff,25,0,25,0
1683710312939,USP 1,A01,187536,Kwak; Nancy,0,16,25,25
1683710313963,USP 5,A01,187538,Staff,8,0,25,17
1683710314988,USP 101,A00,199253,Staff,0,4,0,0
1683710316017,USP 124,A00,187562,Boomhower; Matthew Charles,0,0,30,30
1683710317045,USP 138,A00,187582,Staff,19,0,25,6
1683710318070,USP 152,A01,187597,Staff,3,0,25,22
1683710319096,USP 153,A00,187598,Staff,18,0,25,7
1683710320125,USP 168,A00,187607,Kwak; Nancy,2,0,5,3
1683710321150,USP 173,A00,187619,Staff,4,0,25,21
1683710322174,USP 181,A00,187638,Staff,0,4,25,25
1683710323198,VIS 103,A00,187650,Cruz; Edwin Teddy,17,0,75,58
1683710324223,VIS 110D,A00,187669,Staff,13,0,22,9
1683710325249,VIS 127C,A00,187720,Shen; Kuiyi,67,0,146,79
1683710326275,VIS 149,A00,187731,Yoldas; Pinar,0,12,22,22
1683710327299,VIS 151,A01,188091,Staff,22,0,34,12
1683710327299,VIS 151,A02,188092,Staff,11,0,34,23
1683710328326,VIS 160B,A00,188093,Stalbaum; Brett,0,1,10,10
1683710330375,WCWP 10B,A00,201720,Staff,0,0,5,5
1683710330375,WCWP 10B,B00,201722,Staff,0,0,6,6
1683710331404,WCWP 100,A00,201725,Gagnon; Jeffrey C,0,0,2,2
1683710331404,WCWP 100,B00,201727,Staff,0,4,15,15
1683710334571,ANBI 133,A00,258401,Wilder; Linnea Lorene,34,0,40,6
1683710335595,ANBI 140,A00,258395,Hrvoj Mihic; Branka,18,0,25,7
1683710336620,ANSC 120,A00,258402,Bialecki; Jon Anthony,26,0,40,14
1683710337644,ANSC 144,A00,258400,Staff,12,0,40,28
1683710339698,ANSC 166,A00,258396,Parish; Steven Martin,156,0,175,19
1683710340723,ANSC 180,A00,193533,Staff,8,0,20,12
1683710341754,ANSC 188,A00,258397,Jassal; Aftab,34,0,40,6
1683710342779,ANTH 3,A01,258316,Staff,23,0,30,7
1683710343810,ANTH 5,A00,258394,Semendeferi; Ekaterini,16,0,20,4
1683710344835,ANTH 21,A01,258331,Staff,4,0,40,36
1683710345861,ANTH 103,A00,258398,Varma; Saiba,15,0,25,10
1683710346893,AWP 10,001,202034,Staff,0,0,0,0
1683710346893,AWP 10,002,202035,Staff,0,0,0,0
1683710346893,AWP 10,003,202036,Staff,0,0,0,0
1683710346893,AWP 10,004,202037,Staff,0,0,0,0
1683710346893,AWP 10,005,202038,Staff,0,0,0,0
1683710346893,AWP 10,006,202039,Staff,0,0,0,0
1683710346893,AWP 10,007,202040,Staff,0,0,0,0
1683710346893,AWP 10,008,202041,Staff,0,0,0,0
1683710346893,AWP 10,009,202042,Staff,0,0,0,0
1683710346893,AWP 10,010,202043,Staff,0,0,0,0
1683710346893,AWP 10,011,202044,Staff,0,0,0,0
1683710346893,AWP 10,012,202045,Staff,0,0,0,0
1683710346893,AWP 10,013,202046,Staff,0,0,0,0
1683710346893,AWP 10,014,202047,Staff,0,0,0,0
1683710346893,AWP 10,015,202048,Staff,0,0,0,0
1683710346893,AWP 10,016,202049,Staff,0,0,0,0
1683710346893,AWP 10,017,202050,Staff,0,0,0,0
1683710346893,AWP 10,018,202051,Staff,0,0,0,0
1683710346893,AWP 10,019,202052,Staff,0,0,0,0
1683710346893,AWP 10,020,202053,Staff,0,0,0,0
1683710346893,AWP 10,021,202054,Staff,0,0,0,0
1683710346893,AWP 10,022,202055,Staff,0,0,0,0
1683710346893,AWP 10,023,202056,Staff,0,0,0,0
1683710346893,AWP 10,024,202057,Staff,0,0,0,0
1683710346893,AWP 10,025,202058,Staff,0,0,0,0
1683710346893,AWP 10,026,202059,Staff,0,0,0,0
1683710347918,AWP 102,001,202032,Staff,0,0,0,0
1683710347918,AWP 102,002,202033,Staff,0,0,0,0
1683710349004,BENG 100,A01,254234,Taylor Amos; Alyssa C,31,0,40,9
1683710350031,BENG 196,001,270013,Engler; Adam J.,9999,0,9999,0
1683710351055,BICD 100R,A01,202018,Smith; Laurie,0,7,32,32
1683710351055,BICD 100R,A02,202019,Smith; Laurie,0,3,32,32
1683710351055,BICD 100R,A03,202020,Smith; Laurie,0,1,32,32
1683710351055,BICD 100R,A04,202021,Smith; Laurie,6,0,32,26
1683710351055,BICD 100R,A05,202022,Smith; Laurie,10,0,32,22
1683710352080,BICD 136,A01,193242,Gustafson-Brown; Cindy,0,2,32,32
1683710352080,BICD 136,A02,193244,Gustafson-Brown; Cindy,13,0,32,19
1683710353105,BIEB 102,A01,193249,Butler; Shannon Rhey,0,0,32,32
1683710353105,BIEB 102,A02,193251,Butler; Shannon Rhey,0,0,32,32
1683710353105,BIEB 102,A03,193253,Butler; Shannon Rhey,0,0,32,32
1683710353105,BIEB 102,A04,193255,Butler; Shannon Rhey,13,0,32,19
1683710353105,BIEB 102,A05,193265,Butler; Shannon Rhey,25,0,32,7
1683710353105,BIEB 102,A06,193269,Butler; Shannon Rhey,12,0,32,20
1683710355153,BIEB 150,A01,193274,Staff,0,0,32,32
1683710355153,BIEB 150,A02,193285,Staff,24,0,32,8
1683710356180,BIEB 194,A00,193286,Kurle; Carolyn M.,19,0,32,13
1683710357205,BILD 1,A01,192291,Staff,15,0,32,17
1683710357205,BILD 1,A02,192292,Staff,30,0,32,2
1683710357205,BILD 1,B01,192520,Reuther; Keefe,0,1,0,0
1683710357205,BILD 1,B02,192532,Reuther; Keefe,0,1,0,0
1683710358231,BILD 3,A01,192556,Butler; Shannon Rhey,0,0,32,32
1683710358231,BILD 3,A02,192581,Butler; Shannon Rhey,0,1,32,32
1683710358231,BILD 3,A03,192611,Butler; Shannon Rhey,19,0,32,13
1683710358231,BILD 3,A04,192612,Butler; Shannon Rhey,23,0,32,9
1683710358231,BILD 3,A05,192613,Butler; Shannon Rhey,26,0,32,6
1683710358231,BILD 3,A06,192679,Butler; Shannon Rhey,27,0,32,5
1683710358231,BILD 3,A07,192682,Butler; Shannon Rhey,20,0,32,12
1683710359259,BILD 4,A01,192836,Reuther; Keefe,1,0,24,23
1683710359259,BILD 4,A02,193044,Reuther; Keefe,4,0,24,20
1683710360287,BILD 10,A01,193142,Gustafson-Brown; Cindy,29,0,32,3
1683710360287,BILD 10,A02,193149,Gustafson-Brown; Cindy,31,0,32,1
1683710361312,BIMM 100,A01,193301,Staff,0,6,32,32
1683710361312,BIMM 100,A02,193312,Staff,0,7,32,32
1683710361312,BIMM 100,A03,193323,Staff,0,10,32,32
1683710362337,BIMM 101,A01,193329,McDonnell; Lisa Marie,0,3,24,24
1683710362337,BIMM 101,A02,193339,McDonnell; Lisa Marie,0,3,24,24
1683710362337,BIMM 101,B01,193354,McDonnell; Lisa Marie,0,4,24,24
1683710362337,BIMM 101,B02,193357,McDonnell; Lisa Marie,0,3,24,24
1683710363362,BIMM 110,A01,193377,Tat; John,0,11,32,32
1683710363362,BIMM 110,A02,193378,Tat; John,0,11,32,32
1683710364391,BIMM 120,A01,206116,Staff,0,0,32,32
1683710364391,BIMM 120,A02,206117,Staff,7,0,32,25
1683710364391,BIMM 120,A03,206121,Staff,21,0,32,11
1683710365422,BIPN 100,A01,193393,Park; Ji Young,0,15,32,32
1683710365422,BIPN 100,A02,193402,Park; Ji Young,0,14,32,32
1683710365422,BIPN 100,A03,193413,Park; Ji Young,0,14,32,32
1683710365422,BIPN 100,A04,193414,Park; Ji Young,0,13,32,32
1683710366447,BIPN 102,A01,193429,Staff,0,0,32,32
1683710366447,BIPN 102,A02,193438,Staff,18,0,32,14
1683710367472,BIPN 106,A01,193450,Reyes Gonzalez; Catalina,0,2,40,40
1683710368505,BIPN 134,A01,193465,Cooke; James Edward,0,0,32,32
1683710368505,BIPN 134,A02,193474,Cooke; James Edward,25,0,32,7
1683710368505,BIPN 134,A03,193485,Cooke; James Edward,29,0,32,3
1683710368505,BIPN 134,A04,193486,Cooke; James Edward,20,0,32,12
1683710368505,BIPN 134,A05,193491,Cooke; James Edward,31,0,32,1
1683710368505,BIPN 134,A06,193501,Cooke; James Edward,30,0,32,2
1683710368505,BIPN 134,A07,193510,Cooke; James Edward,29,0,32,3
1683710370561,BISP 194,A00,222522,Staff,14,0,32,18
1683710371586,CAT 124,A01,202407,Staff,19,0,25,6
1683710372612,CAT 125,A00,202408,Marchisotto; Jennifer Anne,2,0,20,18
1683710373639,CAT 125R,A00,202409,Smith; Lauryn Alissa,0,11,20,20
1683710373639,CAT 125R,B00,202410,Morales; Celeste Georgianna,0,11,20,20
1683710373639,CAT 125R,C00,202411,Irwin; Matthew Joseph,0,12,20,20
1683710374663,CENG 15,A01,204712,Yang; Kesong,0,1,0,0
1683710375689,CENG 114,A00,202070,Jahed Motlagh; Zeinab,5,0,20,15
1683710376715,CGS 105,A00,185477,Wesling; Megan E.,24,0,40,16
1683710377742,CGS 106,A00,185494,Staff,11,0,22,11
1683710378770,CGS 108,A00,185495,Staff,14,0,20,6
1683710379795,CGS 114,A00,185496,Staff,13,0,18,5
1683710380819,CGS 119,A00,185501,Staff,15,0,20,5
1683710381845,CGS 120,A00,185511,Staff,11,0,20,9
1683710382871,CHEM 4,A01,184675,Bussey; Thomas J,97,0,100,3
1683710383898,CHEM 6A,A01,184677,Staff,32,0,60,28
1683710384922,CHEM 6B,A01,184679,Staff,63,0,100,37
1683710385946,CHEM 6C,A01,184681,Bussey; Thomas J,0,0,50,50
1683710385946,CHEM 6C,A02,184682,Bussey; Thomas J,32,0,50,18
1683710386970,CHEM 40A,A01,184684,Albizati; Kim F.,33,0,100,67
1683710387998,CHEM 40B,A01,184686,Albizati; Kim F.,0,22,100,100
1683710389025,CHEM 41B,A01,184690,Staff,51,0,100,49
1683710390050,COGS 3,A01,184715,Boyle; Mary E. T.,0,27,40,40
1683710391077,COGS 14B,A01,185172,Staff,0,14,38,38
1683710392101,COGS 18,A01,184736,Staff,14,0,80,66
1683710393124,COGS 100,A01,184932,Staff,0,8,73,73
1683710394148,COGS 101A,A01,184935,Staff,0,40,30,30
1683710395173,COGS 101B,A01,184944,Staff,0,2,30,30
1683710396198,COGS 101C,A01,184946,Staff,0,10,30,30
1683710397226,COGS 102A,A01,184951,Johnson; Christine M.,1,0,40,39
1683710398249,COGS 107B,A01,184953,Mooshagian; Eric Frederick,0,52,40,40
1683710399275,COGS 118B,A01,184959,Gupta; Anjum,0,50,40,40
1683710400303,COGS 153,A00,184961,Staff,1,16,30,29
1683710401330,COGS 177,A00,184962,Staff,0,20,30,30
1683710402360,COGS 187A,A01,184969,Boyle; Mary E. T.,0,19,40,40
1683710403386,COMM 10,A01,185174,Staff,0,5,25,25
1683710403386,COMM 10,A02,185189,Staff,0,2,25,25
1683710403386,COMM 10,A03,269821,Staff,0,1,0,0
1683710404410,COMM 100B,A02,185476,Staff,10,0,25,15
1683710404410,COMM 100B,A03,277340,Staff,25,0,25,0
1683710405438,COMM 100C,A01,185314,Staff,2,0,25,23
1683710405438,COMM 100C,A02,185327,Staff,17,0,25,8
1683710406465,COMM 110M,A00,185349,Staff,0,0,40,40
1683710407490,COMM 113T,A00,185352,Staff,25,0,40,15
1683710408518,COMM 114I,A00,185353,Staff,31,0,40,9
1683710409547,COMM 131,A00,185354,Staff,17,0,30,13
1683710410575,CSE 8A,A50,185358,Cao; Yingjun,0,46,10,10
1683710411602,CSE 8B,A01,185362,Staff,0,48,50,50
1683710412626,CSE 11,A01,185416,Cao; Yingjun,0,91,10,10
1683710413651,CSE 20,A01,185445,Briones; Jor-el Thomas Caparas,3,0,25,22
1683710414675,CSE 21,A01,185447,Staff,9,0,50,41
1683710415704,CSE 101,A01,185451,Staff,0,13,50,50
1683710415704,CSE 101,B01,185453,Jones; Miles E,0,15,50,50
1683710417754,CSE 141,A01,185458,Eldon; John,16,0,100,84
1683710418781,CSE 141L,A01,185461,Eldon; John,8,0,100,92
1683710419809,CSE 142,A01,185463,Staff,34,0,60,26
1683710419809,CSE 142,B01,201355,Staff,0,7,60,60
1683710420836,CSE 142L,A01,185470,Staff,34,0,60,26
1683710420836,CSE 142L,B01,201417,Staff,0,6,60,60
1683710421863,CSE 190,A00,201433,Staff,32,0,49,17
1683710422890,DOC 1,A01,259136,Strom; Megan C.,7,0,15,8
1683710422890,DOC 1,A02,259137,Strom; Megan C.,15,0,15,0
1683710422890,DOC 1,A03,259138,Strom; Megan C.,14,0,15,1
1683710422890,DOC 1,A04,259139,Strom; Megan C.,13,0,15,2
1683710423915,DOC 100D,A00,259140,Pass; Natalye Joann,14,0,25,11
1683710424940,DSGN 1,A01,184749,Rill; Bryan,0,26,30,30
1683710425968,DSGN 100,A01,185168,Staff,0,2,25,25
1683710426995,ECE 5,A01,185626,Morris; Karcher William,0,12,0,0
1683710428023,ECE 101,A01,185628,Staff,14,0,70,56
1683710429049,ECE 107,A01,185635,Baghdadchi; Saharnaz,0,0,20,20
1683710429049,ECE 107,A02,185638,Baghdadchi; Saharnaz,1,0,20,19
1683710430073,ECE 148,A01,185647,Silberman; Jack,0,0,16,16
1683710431101,ECON 1,A01,185537,Crane; Meredith Helen,54,0,70,16
1683710432129,ECON 3,A01,185549,Crane; Meredith Helen,30,0,70,40
1683710433154,ECON 4,A01,203354,Anderson; John Charles,0,5,10,10
1683710434183,ECON 100A,A01,185574,Staff,0,5,40,40
1683710435214,ECON 100B,A01,185576,Staff,0,12,50,50
1683710436239,ECON 100C,A01,185589,Newhouse; Herbert S,30,0,70,40
1683710437263,ECON 105,A00,185608,Vespa; Emanuel Ignacio,19,0,35,16
1683710438293,ECON 109,A01,185610,Shishkin; Denis,9,0,35,26
1683710439316,ECON 110A,A01,185612,Staff,8,0,40,32
1683710440339,ECON 120A,A01,185615,Staff,19,0,40,21
1683710441367,ECON 120C,A01,185617,Sun; Yixiao,0,21,70,70
1683710442396,ECON 144,A00,203346,Squires; Dale E,2,0,35,33
1683710443421,ECON 171,A01,203349,Newhouse; Herbert S,0,1,35,35
1683710444447,ECON 173A,A01,185621,Toda; Alexis Akira,21,0,35,14
1683710445474,EDS 25,A01,202413,Staff,0,1,0,0
1683710445474,EDS 25,A02,202414,Staff,0,1,0,0
1683710445474,EDS 25,A03,202415,Staff,0,0,0,0
1683710445474,EDS 25,A04,202416,Staff,0,1,0,0
1683710445474,EDS 25,A05,202439,Staff,0,0,0,0
1683710445474,EDS 25,A06,202440,Staff,0,0,0,0
1683710445474,EDS 25,B01,202631,Staff,0,0,0,0
1683710445474,EDS 25,B02,202632,Staff,0,0,0,0
1683710445474,EDS 25,B03,202639,Staff,0,0,0,0
1683710445474,EDS 25,B04,202640,Staff,0,0,0,0
1683710445474,EDS 25,B05,202643,Staff,0,0,0,0
1683710445474,EDS 25,B06,202644,Staff,0,0,0,0
1683710446499,EDS 38,A01,202659,Black; Alison Michelle,25,0,25,0
1683710447526,EDS 115,A00,202652,Staff,18,0,30,12
1683710448554,EDS 125,A00,202649,Staff,13,0,30,17
1683710449579,EDS 126,A01,203332,Staff,30,0,30,0
1683710450603,EDS 139,A00,202838,Staff,16,0,25,9
1683710451629,EDS 146,A01,202655,Staff,14,0,25,11
1683710452710,ENG 15,A00,185667,Staff,0,1,0,0
1683710452710,ENG 15,B00,185672,Staff,0,0,0,0
1683710452710,ENG 15,C00,185675,Staff,0,0,0,0
1683710452710,ENG 15,D00,185682,Staff,0,0,0,0
1683710452710,ENG 15,E00,185684,Staff,0,0,0,0
1683710453735,ETHN 103,A00,185710,Staff,0,8,35,35
1683710454759,ETHN 103A,A00,199228,Man; Simeon S,0,0,9,9
1683710455784,ETHN 109,A00,185711,Staff,15,0,35,20
1683710456809,ETHN 142,A00,185726,Staff,0,4,30,30
1683710457834,ETHN 163J,A00,199229,Man; Simeon S,5,0,8,3
1683710458859,ETHN 168,A00,185727,Staff,7,0,10,3
1683710459886,ETHN 182,A00,185728,Staff,0,0,35,35
1683710460911,ETHN 183,A00,185737,Staff,9,0,18,9
1683710461935,GLBH 111,A01,209361,Burgos; Jose L.,0,0,0,0
1683710463988,HIEU 104,A00,185792,Staff,14,0,20,6
1683710465012,HIEU 115,A00,185800,Staff,0,0,20,20
1683710466040,HIEU 128,A00,185801,Staff,0,9,20,20
1683710467066,HIEU 147,A00,185802,Staff,15,0,20,5
1683710468090,HIEU 154,A00,185823,Staff,11,0,20,9
1683710469117,HILA 102,A00,185826,Staff,14,0,20,6
1683710470144,HILD 2C,A01,185778,Staff,0,13,20,20
1683710471169,HILD 7B,A01,185780,Kwak; Nancy,0,17,32,32
1683710471169,HILD 7B,A02,185781,Kwak; Nancy,0,18,32,32
1683710472194,HILD 30,A01,185791,Staff,12,0,20,8
1683710473222,HISC 119,A00,185830,Golan; Tal,0,10,20,20
1683710474249,HITO 156GS,A00,185831,Patterson; Patrick H.,0,0,0,23
1683710475274,HIUS 103,A00,185832,Man; Simeon S,0,4,20,20
1683710476299,HIUS 117,A00,185836,Kwak; Nancy,2,0,20,18
1683710477325,HIUS 125,A00,185840,Man; Simeon S,0,2,23,23
1683710478353,HIUS 149,A00,185845,Staff,1,0,20,19
1683710479385,HUM 3,A01,185882,Zavodny; Tatiana Sophia,0,8,50,50
1683710479385,HUM 3,B01,185899,Caldwell; Michael Alan,0,18,50,50
1683710480409,HUM 3GS,A00,185900,Patterson; Patrick H.,0,0,0,23
1683710481440,HUM 4,A01,185938,Zroka; Amy Liane,28,0,50,22
1683710481440,HUM 4,B01,185956,Watkins; Eric,0,6,50,50
1683710481440,HUM 4,B02,202209,Watkins; Eric,0,5,50,50
1683710481440,HUM 4,B03,202210,Watkins; Eric,0,5,50,50
1683710482464,HUM 5,A01,185958,West; Geoffrey Scott,0,0,50,50
1683710482464,HUM 5,A02,202215,West; Geoffrey Scott,0,1,50,50
1683710483490,INTL 190,A00,185959,Gagnon; Jeffrey C,0,0,0,9
1683710483490,INTL 190,B00,185960,Lettieri; Michael Joseph,0,0,0,2
1683710484515,JAPN 180,A00,254509,Staff,5,0,30,25
1683710485541,LATI 10,A01,202853,Kennemore; Amy Michelle,4,0,35,31
1683710485541,LATI 10,A02,202854,Kennemore; Amy Michelle,3,0,35,32
1683710485541,LATI 10,A03,270054,Kennemore; Amy Michelle,30,0,30,0
1683710486569,LATI 180,A00,202855,Kennemore; Amy Michelle,11,0,20,9
1683710487597,LAWS 101,A00,201767,Golan; Tal,0,7,40,40
1683710488624,LIFR 1C,A00,185961,Staff,6,0,20,14
1683710489650,LIFR 1CX,A00,185962,Staff,7,0,20,13
1683710490677,LIFR 1D,A00,185963,Staff,7,0,20,13
1683710491705,LIFR 1DX,A00,185964,Staff,7,0,20,13
1683710492732,LIGN 101,A01,186039,Staff,43,0,50,7
1683710493757,LIGN 165,A00,186040,Staff,14,0,50,36
1683710494782,LTCS 108,A00,186041,Staff,5,0,10,5
1683710495809,LTCS 119,A00,186042,Staff,15,0,20,5
1683710496837,LTCS 130,A00,186043,Wesling; Megan E.,15,0,25,10
1683710498884,LTEA 138,A00,186119,Staff,14,0,40,26
1683710499909,LTEN 124,A00,186148,Staff,5,0,25,20
1683710500937,LTEN 178,A00,186149,Staff,6,0,15,9
1683710501961,LTEN 181,A00,186150,Blanco; John D,34,0,40,6
1683710502989,LTWL 120,A00,186160,Staff,19,0,25,6
1683710504023,LTWL 165,A00,186161,Staff,22,0,25,3
1683710505050,LTWR 100,A00,186162,Staff,0,5,15,15
1683710506075,LTWR 102,A00,186163,Doller; Ben,5,0,15,10
1683710507098,MAE 8,A01,186412,Staff,0,1,0,0
1683710508123,MAE 30B,A00,186445,Bahadori; Mohammad Yousef,81,0,100,19
1683710509147,MAE 40,A00,186592,Bewley; Thomas R,10,0,50,40
1683710510176,MAE 101B,A00,186593,Bahadori; Mohammad Yousef,80,0,100,20
1683710511205,MAE 105,A00,186594,Bandaru; Prabhakar,10,0,50,40
1683710512232,MAE 107,A00,186599,Pham; Hieu Tan,0,8,120,120
1683710513257,MAE 148,A01,186660,Silberman; Jack,3,0,16,13
1683710514286,MATH 10A,A01,188095,Staff,0,6,35,35
1683710515310,MATH 10B,A01,188097,Bowers; Adam R.,0,12,30,30
1683710515310,MATH 10B,A02,188099,Bowers; Adam R.,0,11,30,30
1683710515310,MATH 10B,B01,188104,Bowers; Adam R.,0,10,30,30
1683710515310,MATH 10B,B02,188106,Bowers; Adam R.,0,9,30,30
1683710516336,MATH 10C,A01,188111,Staff,0,20,30,30
1683710516336,MATH 10C,A02,188127,Staff,0,19,30,30
1683710516336,MATH 10C,A03,188131,Staff,0,19,30,30
1683710516336,MATH 10C,B01,188218,Staff,17,0,30,13
1683710516336,MATH 10C,B02,188244,Staff,13,0,30,17
1683710516336,MATH 10C,B03,188277,Staff,14,0,30,16
1683710517362,MATH 18,A01,188344,Bach; Quang Tran,18,0,30,12
1683710517362,MATH 18,A02,188345,Bach; Quang Tran,11,0,30,19
1683710517362,MATH 18,B01,188353,Bach; Quang Tran,11,0,30,19
1683710517362,MATH 18,B02,188354,Bach; Quang Tran,19,0,30,11
1683710518389,MATH 20A,A01,188374,Staff,11,0,35,24
1683710519419,MATH 20B,A01,188382,Ohm; Ko Woon,7,0,30,23
1683710519419,MATH 20B,A02,188383,Ohm; Ko Woon,22,0,30,8
1683710519419,MATH 20B,B01,188385,Ohm; Ko Woon,7,0,30,23
1683710519419,MATH 20B,B02,188392,Ohm; Ko Woon,22,0,30,8
1683710520445,MATH 20C,A01,188394,Harel; Guershon,10,0,30,20
1683710520445,MATH 20C,A02,188395,Harel; Guershon,13,0,30,17
1683710520445,MATH 20C,B01,188404,Harel; Guershon,5,0,30,25
1683710520445,MATH 20C,B02,188405,Harel; Guershon,18,0,30,12
1683710521471,MATH 20D,A01,188414,Hammock; Frances H,0,1,30,30
1683710521471,MATH 20D,A02,188415,Hammock; Frances H,0,1,30,30
1683710521471,MATH 20D,B01,188447,Hammock; Frances H,0,1,30,30
1683710521471,MATH 20D,B02,188486,Hammock; Frances H,2,0,30,28
1683710522499,MATH 20E,A01,188649,Staff,21,0,30,9
1683710522499,MATH 20E,A02,188650,Staff,20,0,30,10
1683710522499,MATH 20E,A03,188673,Staff,0,0,30,30
1683710523523,MATH 102,A01,188675,Staff,0,40,35,35
1683710524548,MATH 103B,A01,188681,Staff,3,0,35,32
1683710524548,MATH 103B,B01,188692,Staff,5,0,35,30
1683710525572,MATH 109,A01,188695,Salehi Golsefidy; Alireza,24,0,35,11
1683710525572,MATH 109,A02,188696,Salehi Golsefidy; Alireza,25,0,35,10
1683710526598,MATH 120A,A01,188698,Eggers; John Dietrich,7,0,35,28
1683710527626,MATH 142B,A01,188736,Ioana; Adrian,0,0,30,30
1683710527626,MATH 142B,A02,188741,Ioana; Adrian,0,1,30,30
1683710527626,MATH 142B,A03,188743,Ioana; Adrian,0,2,30,30
1683710528655,MATH 168A,A01,188790,Staff,0,11,35,35
1683710529683,MATH 170A,A01,188803,Nie; Jiawang,0,2,35,35
1683710529683,MATH 170A,A02,188811,Nie; Jiawang,0,1,35,35
1683710529683,MATH 170A,A03,188814,Nie; Jiawang,1,0,35,34
1683710529683,MATH 170A,A04,188815,Nie; Jiawang,5,0,35,30
1683710530713,MATH 193B,A01,188817,Staff,0,0,35,35
1683710530713,MATH 193B,A02,188818,Staff,6,0,35,29
1683710531739,MGT 4,A01,202857,Anderson; John Charles,59,0,80,21
1683710532765,MGT 12,A00,202858,Lindenberger; Wade Douglas,40,0,90,50
1683710533794,MGT 18,A00,202859,Staff,73,0,90,17
1683710534823,MGT 18GS,A00,202860,McKay; Michael J,13,0,28,15
1683710535848,MGT 45,A00,202861,Pecore; Joseph P.,8,0,90,82
1683710536874,MGT 100,A00,202863,Yavorsky; Daniel Ryan,27,0,90,63
1683710537899,MGT 103,A00,202864,Ehrich; Kristine R,0,19,90,90
1683710538928,MGT 112,A00,202865,Ehrich; Kristine R,15,0,90,75
1683710539955,MGT 121A,A00,202868,Staff,70,0,90,20
1683710540984,MGT 131B,A00,202869,Anderson; John Charles,58,0,90,32
1683710542010,MGT 136,A00,202871,Lindenberger; Wade Douglas,83,0,90,7
1683710543035,MGT 164,A00,202873,Staff,0,67,90,91
1683710544064,MGT 164GS,A00,202874,McKay; Mary A,13,0,28,15
1683710545091,MGT 180,A00,202875,Staff,0,51,90,91
1683710546119,MMW 11R,A01,205019,Herbst; Matthew,0,0,30,30
1683710546119,MMW 11R,A02,205026,Herbst; Matthew,29,0,30,1
1683710547146,MMW 15,A01,193512,Chang; Edmond Yi-Teh,0,8,28,28
1683710547146,MMW 15,A02,193513,Chang; Edmond Yi-Teh,0,5,28,28
1683710547146,MMW 15,A03,193514,Chang; Edmond Yi-Teh,0,5,28,28
1683710547146,MMW 15,A04,193515,Chang; Edmond Yi-Teh,0,5,28,28
1683710547146,MMW 15,A05,193516,Chang; Edmond Yi-Teh,0,5,28,28
1683710547146,MMW 15,A06,193517,Chang; Edmond Yi-Teh,0,6,28,28
1683710547146,MMW 15,B01,193519,Chang; Edmond Yi-Teh,0,5,28,28
1683710547146,MMW 15,B02,193520,Chang; Edmond Yi-Teh,0,5,28,28
1683710547146,MMW 15,B03,193521,Chang; Edmond Yi-Teh,0,5,28,28
1683710547146,MMW 15,B04,193522,Chang; Edmond Yi-Teh,0,6,28,28
1683710547146,MMW 15,B05,193523,Chang; Edmond Yi-Teh,0,5,28,28
1683710547146,MMW 15,B06,193524,Chang; Edmond Yi-Teh,0,5,28,28
1683710548170,MMW 122,A01,193526,Rahimi; Babak,0,16,28,28
1683710548170,MMW 122,A02,193527,Rahimi; Babak,0,15,28,28
1683710548170,MMW 122,A03,193528,Rahimi; Babak,0,0,0,0
1683710548170,MMW 122,A04,193529,Rahimi; Babak,0,0,0,0
1683710549195,MUS 1A,A01,186663,Staff,0,18,35,35
1683710550222,MUS 4,A01,186715,Staff,0,12,35,35
1683710551251,MUS 5R,A01,186796,Dubnov; Shlomo,0,17,35,35
1683710552277,MUS 6,A01,186798,Staff,0,4,25,25
1683710553308,MUS 7,A01,186830,Staff,11,0,35,24
1683710554333,MUS 8,A01,186930,Staff,0,27,35,35
1683710555362,MUS 15,A01,186932,Staff,0,15,35,35
1683710555362,MUS 15,B01,186934,Staff,0,16,35,35
1683710556452,MUS 80,A00,186935,Staff,0,0,20,20
1683710556452,MUS 80,B00,186936,Staff,24,0,25,1
1683710557478,NANO 11,A00,204702,Lipomi; Darren John,0,0,0,0
1683710558503,NANO 15,A01,204709,Yang; Kesong,0,1,0,0
1683710559532,NANO 114,A00,202069,Jahed Motlagh; Zeinab,2,0,10,8
1683710560557,PHIL 1,A00,186955,Grush; Rick Scott,31,0,40,9
1683710561583,PHIL 10,A01,186973,Grush; Rick Scott,27,0,35,8
1683710561583,PHIL 10,A02,186974,Grush; Rick Scott,33,0,35,2
1683710562608,PHIL 13,A01,186976,Staff,1,0,35,34
1683710562608,PHIL 13,A02,186977,Staff,16,0,35,19
1683710563635,PHIL 14,A01,186979,Staff,30,0,35,5
1683710563635,PHIL 14,A02,186986,Staff,32,0,35,3
1683710564660,PHIL 28,A01,186988,Staff,16,0,30,14
1683710564660,PHIL 28,A02,186989,Staff,0,0,30,30
1683710564660,PHIL 28,A03,186990,Staff,10,0,30,20
1683710564660,PHIL 28,A04,186991,Staff,26,0,30,4
1683710565685,PHIL 120,A00,186997,Staff,23,0,40,17
1683710566710,PHIL 137,A00,187003,Staff,8,0,40,32
1683710567735,PHIL 150,A00,187015,Staff,47,0,70,23
1683710568761,PHIL 167,A00,187021,Lamey; Andy M.,34,0,40,6
1683710569792,PHIL 174,A01,202226,Staff,17,0,20,3
1683710569792,PHIL 174,A02,202235,Staff,20,0,20,0
1683710570819,PHIL 191A,A00,258918,Staff,0,0,1,1
1683710571844,PHYS 1A,A00,187028,Staff,26,0,60,34
1683710572869,PHYS 1AL,001,187036,Staff,3,0,30,27
1683710572869,PHYS 1AL,002,187049,Staff,18,0,30,12
1683710573894,PHYS 1B,A00,187058,Staff,21,0,60,39
1683710574919,PHYS 1BL,001,187064,Staff,0,1,30,30
1683710574919,PHYS 1BL,002,187070,Staff,4,0,30,26
1683710575943,PHYS 1C,A00,187082,Staff,30,0,120,90
1683710576969,PHYS 1CL,001,187088,Staff,0,9,30,30
1683710576969,PHYS 1CL,002,187089,Staff,0,1,30,30
1683710576969,PHYS 1CL,009,262693,Staff,9,0,30,21
1683710577991,PHYS 2B,A01,187097,Staff,55,0,115,60
1683710579016,PHYS 2C,A01,187099,Staff,63,0,115,52
1683710580041,PHYS 2CL,A01,187101,Staff,5,0,28,23
1683710580041,PHYS 2CL,A02,187102,Staff,15,0,28,13
1683710581068,PHYS 2D,A01,187123,Shotwell; Brian,95,0,115,20
1683710582097,PHYS 4B,A01,187133,Grinstein; Benjamin,35,0,50,15
1683710583122,POLI 10,A00,188819,Staff,0,4,50,50
1683710584151,POLI 11,A00,188827,Staff,43,0,50,7
1683710585176,POLI 13R,A00,188828,Staff,0,1,20,20
1683710586205,POLI 27,A01,188830,Elgin; Samuel Zincke,0,2,70,70
1683710587227,POLI 30,A00,188832,Desposato; Scott,30,0,50,20
1683710588252,POLI 102F,A00,188834,Staff,1,0,40,39
1683710589276,POLI 104A,A00,188852,Staff,12,0,30,18
1683710590303,POLI 104I,A00,188853,Staff,0,8,20,20
1683710591332,POLI 110B,A00,188854,Wiens; David,6,0,20,14
1683710592356,POLI 112A,A00,188855,Wiens; David,3,0,30,27
1683710593381,POLI 117R,A00,188856,Forman; Fonna,0,12,20,20
1683710594410,POLI 118,A00,188857,Ingham; Sean,8,0,20,12
1683710595435,POLI 120G,A00,188858,Staff,7,0,30,23
1683710596459,POLI 131CR,A00,188863,Hoston; Germaine,20,0,50,30
1683710597489,POLI 133,A00,188864,Nellis; Gareth Hb,44,0,50,6
1683710598517,POLI 134D,A00,188865,Desposato; Scott,27,0,30,3
1683710599546,POLI 142A,A00,188871,Gartzke; Erik,21,0,50,29
1683710600574,POLI 142K,A00,188874,Staff,38,0,50,12
1683710601599,POLI 143,A00,188940,Gartzke; Erik,15,0,30,15
1683710602627,POLI 153,A00,188943,Staff,1,0,20,19
1683710603652,POLI 160AA,A00,188944,Staff,10,0,40,30
1683710604677,POLI 170A,A00,188945,Staff,10,0,30,20
1683710606732,PSYC 1,A00,188952,Staff,36,0,90,54
1683710607757,PSYC 2,B00,188953,Staff,19,0,35,16
1683710608782,PSYC 6,A00,188970,Staff,47,0,60,13
1683710609809,PSYC 7,A00,188973,Staff,35,0,45,10
1683710610835,PSYC 60,A01,188980,Rickard; Timothy C.,42,0,60,18
1683710611860,PSYC 70,A01,189001,Steiner; Eric Tomas,22,0,45,23
1683710612889,PSYC 100,A00,189005,Lacefield; Katharine I,1,98,120,119
1683710613917,PSYC 102,A00,189008,Staff,6,0,30,24
1683710614944,PSYC 106,B00,189026,Gorman; Michael R.,27,0,60,33
1683710615970,PSYC 114,B01,189033,Winkielman; Piotr,0,31,30,30
1683710616995,PSYC 131,A00,189036,Anagnostaras; Stephan,0,44,60,60
1683710618023,PSYC 136,A00,189041,Lowe; Angela Beth,0,7,25,25
1683710619048,PSYC 137,A00,189057,Winkielman; Piotr,0,36,25,25
1683710620073,PSYC 144,A00,189107,Wixted; John T,0,11,50,50
1683710622127,PSYC 162,A00,189142,Staff,0,9,85,85
1683710623151,PSYC 172,A00,189144,Gorman; Michael R.,0,6,30,30
1683710625206,PSYC 179,A00,189146,Lacefield; Katharine I,0,88,120,120
1683710626233,PSYC 181,A00,189147,Anagnostaras; Stephan,0,45,90,90
1683710627258,PSYC 190R,A00,189148,Barner; David A.,0,23,80,80
1683710628287,PSYC 191,A00,189275,Rickard; Timothy C.,0,11,25,25
1683710629314,PSYC 193,A00,189276,Chapman; Eddie Nathaniel,0,1,0,4
1683710630338,PSYC 193L,A01,189281,Lowe; Angela Beth,8,0,20,12
1683710630338,PSYC 193L,B01,189285,Staff,28,0,35,7
1683710631363,RELI 149,A00,187137,Rahimi; Babak,6,0,40,34
1683710632388,SE 9,A01,187315,Staff,0,2,18,18
1683710633412,SE 101B,A00,187409,Staff,24,0,30,6
1683710634438,SE 110B,A00,187444,Staff,10,0,40,30
1683710635462,SE 130B,A00,187449,Staff,31,0,40,9
1683710636490,SE 150A,A00,187516,Staff,8,0,20,12
1683710637517,SE 154,A00,187528,Staff,29,0,50,21
1683710638542,SIO 3,A01,258171,Staff,35,0,40,5
1683710639569,SIO 10,A00,187144,Cook; Geoffrey W,0,6,75,75
1683710640593,SIO 45,A00,187152,Cook; Geoffrey W,1,7,100,99
1683710641621,SIO 109R,A00,194486,Staff,0,4,20,20
1683710643672,SIO 187,A01,187233,Kacev; David,12,0,40,28
1683710644697,SOCI 1,A01,258656,Thorpe; Charles Robert,28,0,30,2
1683710644697,SOCI 1,A02,258658,Thorpe; Charles Robert,30,0,30,0
1683710644697,SOCI 1,A03,258661,Thorpe; Charles Robert,25,0,25,0
1683710644697,SOCI 1,A04,258666,Thorpe; Charles Robert,22,0,25,3
1683710644697,SOCI 1,A05,258897,Thorpe; Charles Robert,22,0,25,3
1683710644697,SOCI 1,A06,258898,Thorpe; Charles Robert,25,0,25,0
1683710645723,SOCI 30,A01,258903,Pardo Guerra; Juan Pablo,14,0,30,16
1683710646747,SOCI 102,A00,258904,Staff,9,0,25,16
1683710647772,SOCI 106,A00,258905,Staff,19,0,25,6
1683710648796,SOCI 111,A00,258907,Ribas Norris; Janet Vanesa,26,0,30,4
1683710649821,SOCI 121R,A00,258908,Pardo Guerra; Juan Pablo,7,0,30,23
1683710650845,SOCI 126,A01,203330,Staff,14,0,20,6
1683710651869,SOCI 131,A00,258909,Thorpe; Charles Robert,30,0,60,30
1683710652895,SOCI 135,A00,258910,Payne; Christine Anna,0,13,30,30
1683710653922,SOCI 157,A00,258911,Staff,10,0,30,20
1683710654948,SOCI 184,A00,258912,Staff,25,0,30,5
1683710655973,SOCI 188D,A00,258913,Staff,22,0,30,8
1683710656997,SYN 2,001,187529,Staff,9,0,16,7
1683710656997,SYN 2,002,201452,Staff,0,20,16,16
1683710656997,SYN 2,003,201469,Staff,1,0,16,15
1683710658023,SYN 100,A01,187531,Staff,0,9,20,20
1683710658023,SYN 100,B01,201491,Staff,0,10,20,20
1683710659052,TDAC 1,A00,189286,Walsh; Kim C.,3,0,20,17
1683710659052,TDAC 1,B00,189287,Harting; Carla Kelso,10,0,20,10
1683710660136,TDAC 101,A00,189300,Walsh; Kim C.,16,0,20,4
1683710660136,TDAC 101,B00,189301,Harting; Carla Kelso,18,0,20,2
1683710661164,TDAC 102,A00,189304,Basso; Beatrice,14,0,20,6
1683710662191,TDAC 108,A00,189305,Staff,18,0,20,2
1683710663218,TDDE 131,A00,189310,Staff,19,0,20,1
1683710663218,TDDE 131,B00,189314,Staff,19,0,20,1
1683710663218,TDDE 131,C00,189315,Staff,48,0,50,2
1683710663218,TDDE 131,D00,189316,Staff,14,0,15,1
1683710663218,TDDE 131,E00,204841,Staff,20,0,20,0
1683710664243,TDGE 10,A00,189289,Staff,27,0,50,23
1683710664243,TDGE 10,B00,189290,Havis; Allan,0,1,50,50
1683710665271,TDGE 11,A00,189291,Fulton; Julia,0,4,50,50
1683710665271,TDGE 11,B00,189292,Staff,20,0,25,5
1683710665271,TDGE 11,C00,260270,Staff,0,0,0,0
1683710666296,TDGE 25,A00,189294,Staff,1,0,20,19
1683710667319,TDGE 124,A00,189318,Fulton; Julia,0,7,50,50
1683710668342,TDGE 125,A00,189319,Staff,13,0,25,12
1683710668342,TDGE 125,B00,189320,Staff,23,0,25,2
1683710669366,TDGE 127,A00,189322,Havis; Allan,1,0,50,49
1683710670393,TDHT 101,A00,189323,Staff,18,0,25,7
1683710670393,TDHT 101,B00,189324,Staff,25,0,25,0
1683710671419,TDHT 102,A00,189325,Staff,49,0,50,1
1683710672443,TDMV 1,A00,189295,Arcidiacono; Kristin,20,0,30,10
1683710672443,TDMV 1,B00,189296,Caligagan; Maria T.,23,0,30,7
1683710673470,TDMV 2,A00,189297,Sammartano; Tonnie,27,0,30,3
1683710673470,TDMV 2,B00,189299,Arcidiacono; Kristin,23,0,30,7
1683710674498,TDMV 3,A00,204998,Rincon; Alicia,22,0,30,8
1683710675523,TDMV 120,A00,189458,Sammartano; Tonnie,28,0,30,2
1683710676548,TDMV 138,A00,189541,Jun; Grace Shin Hae,20,0,40,20
1683710677572,TDMV 142,A00,189717,Caligagan; Tony,25,0,30,5
1683710677572,TDMV 142,B00,189718,Caligagan; Maria T.,25,0,30,5
1683710678597,TMC 2,A01,187533,Staff,25,0,25,0
1683710678597,TMC 2,A02,187534,Staff,25,0,25,0
1683710679622,USP 1,A01,187536,Kwak; Nancy,0,16,25,25
1683710680646,USP 5,A01,187538,Staff,8,0,25,17
1683710681672,USP 101,A00,199253,Staff,0,4,0,0
1683710682698,USP 124,A00,187562,Boomhower; Matthew Charles,0,0,30,30
1683710683722,USP 138,A00,187582,Staff,19,0,25,6
1683710684746,USP 152,A01,187597,Staff,3,0,25,22
1683710685773,USP 153,A00,187598,Staff,18,0,25,7
1683710686809,USP 168,A00,187607,Kwak; Nancy,2,0,5,3
1683710687834,USP 173,A00,187619,Staff,4,0,25,21
1683710688864,USP 181,A00,187638,Staff,0,4,25,25
1683710689893,VIS 103,A00,187650,Cruz; Edwin Teddy,17,0,75,58
1683710690922,VIS 110D,A00,187669,Staff,13,0,22,9
1683710691949,VIS 127C,A00,187720,Shen; Kuiyi,67,0,146,79
1683710692978,VIS 149,A00,187731,Yoldas; Pinar,0,12,22,22
1683710694009,VIS 151,A01,188091,Staff,22,0,34,12
1683710694009,VIS 151,A02,188092,Staff,11,0,34,23
1683710695036,VIS 160B,A00,188093,Stalbaum; Brett,0,1,10,10
1683710697093,WCWP 10B,A00,201720,Staff,0,0,5,5
1683710697093,WCWP 10B,B00,201722,Staff,0,0,6,6
1683710698118,WCWP 100,A00,201725,Gagnon; Jeffrey C,0,0,2,2
1683710698118,WCWP 100,B00,201727,Staff,0,4,15,15
1683710701283,ANBI 133,A00,258401,Wilder; Linnea Lorene,34,0,40,6
1683710702314,ANBI 140,A00,258395,Hrvoj Mihic; Branka,18,0,25,7
1683710703341,ANSC 120,A00,258402,Bialecki; Jon Anthony,26,0,40,14
1683710704370,ANSC 144,A00,258400,Staff,12,0,40,28
1683710706420,ANSC 166,A00,258396,Parish; Steven Martin,156,0,175,19
1683710707446,ANSC 180,A00,193533,Staff,8,0,20,12
1683710708472,ANSC 188,A00,258397,Jassal; Aftab,34,0,40,6
1683710709496,ANTH 3,A01,258316,Staff,23,0,30,7
1683710710526,ANTH 5,A00,258394,Semendeferi; Ekaterini,16,0,20,4
1683710711552,ANTH 21,A01,258331,Staff,4,0,40,36
1683710712575,ANTH 103,A00,258398,Varma; Saiba,15,0,25,10
1683710713603,AWP 10,001,202034,Staff,0,0,0,0
1683710713603,AWP 10,002,202035,Staff,0,0,0,0
1683710713603,AWP 10,003,202036,Staff,0,0,0,0
1683710713603,AWP 10,004,202037,Staff,0,0,0,0
1683710713603,AWP 10,005,202038,Staff,0,0,0,0
1683710713603,AWP 10,006,202039,Staff,0,0,0,0
1683710713603,AWP 10,007,202040,Staff,0,0,0,0
1683710713603,AWP 10,008,202041,Staff,0,0,0,0
1683710713603,AWP 10,009,202042,Staff,0,0,0,0
1683710713603,AWP 10,010,202043,Staff,0,0,0,0
1683710713603,AWP 10,011,202044,Staff,0,0,0,0
1683710713603,AWP 10,012,202045,Staff,0,0,0,0
1683710713603,AWP 10,013,202046,Staff,0,0,0,0
1683710713603,AWP 10,014,202047,Staff,0,0,0,0
1683710713603,AWP 10,015,202048,Staff,0,0,0,0
1683710713603,AWP 10,016,202049,Staff,0,0,0,0
1683710713603,AWP 10,017,202050,Staff,0,0,0,0
1683710713603,AWP 10,018,202051,Staff,0,0,0,0
1683710713603,AWP 10,019,202052,Staff,0,0,0,0
1683710713603,AWP 10,020,202053,Staff,0,0,0,0
1683710713603,AWP 10,021,202054,Staff,0,0,0,0
1683710713603,AWP 10,022,202055,Staff,0,0,0,0
1683710713603,AWP 10,023,202056,Staff,0,0,0,0
1683710713603,AWP 10,024,202057,Staff,0,0,0,0
1683710713603,AWP 10,025,202058,Staff,0,0,0,0
1683710713603,AWP 10,026,202059,Staff,0,0,0,0
1683710714628,AWP 102,001,202032,Staff,0,0,0,0
1683710714628,AWP 102,002,202033,Staff,0,0,0,0
1683710715656,BENG 100,A01,254234,Taylor Amos; Alyssa C,31,0,40,9
1683710716680,BENG 196,001,270013,Engler; Adam J.,9999,0,9999,0
1683710717712,BICD 100R,A01,202018,Smith; Laurie,0,7,32,32
1683710717712,BICD 100R,A02,202019,Smith; Laurie,0,3,32,32
1683710717712,BICD 100R,A03,202020,Smith; Laurie,0,1,32,32
1683710717712,BICD 100R,A04,202021,Smith; Laurie,6,0,32,26
1683710717712,BICD 100R,A05,202022,Smith; Laurie,10,0,32,22
1683710718736,BICD 136,A01,193242,Gustafson-Brown; Cindy,0,2,32,32
1683710718736,BICD 136,A02,193244,Gustafson-Brown; Cindy,13,0,32,19
1683710719767,BIEB 102,A01,193249,Butler; Shannon Rhey,0,0,32,32
1683710719767,BIEB 102,A02,193251,Butler; Shannon Rhey,0,0,32,32
1683710719767,BIEB 102,A03,193253,Butler; Shannon Rhey,0,0,32,32
1683710719767,BIEB 102,A04,193255,Butler; Shannon Rhey,13,0,32,19
1683710719767,BIEB 102,A05,193265,Butler; Shannon Rhey,25,0,32,7
1683710719767,BIEB 102,A06,193269,Butler; Shannon Rhey,12,0,32,20
1683710721815,BIEB 150,A01,193274,Staff,0,0,32,32
1683710721815,BIEB 150,A02,193285,Staff,24,0,32,8
1683710722844,BIEB 194,A00,193286,Kurle; Carolyn M.,19,0,32,13
1683710723874,BILD 1,A01,192291,Staff,15,0,32,17
1683710723874,BILD 1,A02,192292,Staff,30,0,32,2
1683710723874,BILD 1,B01,192520,Reuther; Keefe,0,1,0,0
1683710723874,BILD 1,B02,192532,Reuther; Keefe,0,1,0,0
1683710724906,BILD 3,A01,192556,Butler; Shannon Rhey,0,0,32,32
1683710724906,BILD 3,A02,192581,Butler; Shannon Rhey,0,1,32,32
1683710724906,BILD 3,A03,192611,Butler; Shannon Rhey,19,0,32,13
1683710724906,BILD 3,A04,192612,Butler; Shannon Rhey,23,0,32,9
1683710724906,BILD 3,A05,192613,Butler; Shannon Rhey,26,0,32,6
1683710724906,BILD 3,A06,192679,Butler; Shannon Rhey,27,0,32,5
1683710724906,BILD 3,A07,192682,Butler; Shannon Rhey,20,0,32,12
1683710725935,BILD 4,A01,192836,Reuther; Keefe,1,0,24,23
1683710725935,BILD 4,A02,193044,Reuther; Keefe,4,0,24,20
1683710726963,BILD 10,A01,193142,Gustafson-Brown; Cindy,29,0,32,3
1683710726963,BILD 10,A02,193149,Gustafson-Brown; Cindy,31,0,32,1
1683710727991,BIMM 100,A01,193301,Staff,0,6,32,32
1683710727991,BIMM 100,A02,193312,Staff,0,7,32,32
1683710727991,BIMM 100,A03,193323,Staff,0,10,32,32
1683710729018,BIMM 101,A01,193329,McDonnell; Lisa Marie,0,3,24,24
1683710729018,BIMM 101,A02,193339,McDonnell; Lisa Marie,0,3,24,24
1683710729018,BIMM 101,B01,193354,McDonnell; Lisa Marie,0,4,24,24
1683710729018,BIMM 101,B02,193357,McDonnell; Lisa Marie,0,3,24,24
1683710730047,BIMM 110,A01,193377,Tat; John,0,11,32,32
1683710730047,BIMM 110,A02,193378,Tat; John,0,11,32,32
1683710731077,BIMM 120,A01,206116,Staff,0,0,32,32
1683710731077,BIMM 120,A02,206117,Staff,7,0,32,25
1683710731077,BIMM 120,A03,206121,Staff,21,0,32,11
1683710732107,BIPN 100,A01,193393,Park; Ji Young,0,15,32,32
1683710732107,BIPN 100,A02,193402,Park; Ji Young,0,14,32,32
1683710732107,BIPN 100,A03,193413,Park; Ji Young,0,14,32,32
1683710732107,BIPN 100,A04,193414,Park; Ji Young,0,13,32,32
1683710733132,BIPN 102,A01,193429,Staff,0,0,32,32
1683710733132,BIPN 102,A02,193438,Staff,18,0,32,14
1683710734157,BIPN 106,A01,193450,Reyes Gonzalez; Catalina,0,2,40,40
1683710735186,BIPN 134,A01,193465,Cooke; James Edward,0,0,32,32
1683710735186,BIPN 134,A02,193474,Cooke; James Edward,25,0,32,7
1683710735186,BIPN 134,A03,193485,Cooke; James Edward,29,0,32,3
1683710735186,BIPN 134,A04,193486,Cooke; James Edward,20,0,32,12
1683710735186,BIPN 134,A05,193491,Cooke; James Edward,31,0,32,1
1683710735186,BIPN 134,A06,193501,Cooke; James Edward,30,0,32,2
1683710735186,BIPN 134,A07,193510,Cooke; James Edward,29,0,32,3
1683710737240,BISP 194,A00,222522,Staff,14,0,32,18
1683710738263,CAT 124,A01,202407,Staff,19,0,25,6
1683710739286,CAT 125,A00,202408,Marchisotto; Jennifer Anne,2,0,20,18
1683710740312,CAT 125R,A00,202409,Smith; Lauryn Alissa,0,11,20,20
1683710740312,CAT 125R,B00,202410,Morales; Celeste Georgianna,0,11,20,20
1683710740312,CAT 125R,C00,202411,Irwin; Matthew Joseph,0,12,20,20
1683710741340,CENG 15,A01,204712,Yang; Kesong,0,1,0,0
1683710742364,CENG 114,A00,202070,Jahed Motlagh; Zeinab,5,0,20,15
1683710743393,CGS 105,A00,185477,Wesling; Megan E.,24,0,40,16
1683710744422,CGS 106,A00,185494,Staff,11,0,22,11
1683710745450,CGS 108,A00,185495,Staff,14,0,20,6
1683710746475,CGS 114,A00,185496,Staff,13,0,18,5
1683710747498,CGS 119,A00,185501,Staff,15,0,20,5
1683710748526,CGS 120,A00,185511,Staff,11,0,20,9
1683710749557,CHEM 4,A01,184675,Bussey; Thomas J,97,0,100,3
1683710750581,CHEM 6A,A01,184677,Staff,32,0,60,28
1683710751607,CHEM 6B,A01,184679,Staff,63,0,100,37
1683710752636,CHEM 6C,A01,184681,Bussey; Thomas J,0,0,50,50
1683710752636,CHEM 6C,A02,184682,Bussey; Thomas J,32,0,50,18
1683710753664,CHEM 40A,A01,184684,Albizati; Kim F.,33,0,100,67
1683710754692,CHEM 40B,A01,184686,Albizati; Kim F.,0,22,100,100
1683710755722,CHEM 41B,A01,184690,Staff,51,0,100,49
1683710756748,COGS 3,A01,184715,Boyle; Mary E. T.,0,27,40,40
1683710757778,COGS 14B,A01,185172,Staff,0,14,38,38
1683710758803,COGS 18,A01,184736,Staff,14,0,80,66
1683710759830,COGS 100,A01,184932,Staff,0,8,73,73
1683710760856,COGS 101A,A01,184935,Staff,0,40,30,30
1683710761888,COGS 101B,A01,184944,Staff,0,2,30,30
1683710762914,COGS 101C,A01,184946,Staff,0,10,30,30
1683710763995,COGS 102A,A01,184951,Johnson; Christine M.,1,0,40,39
1683710765021,COGS 107B,A01,184953,Mooshagian; Eric Frederick,0,52,40,40
1683710766050,COGS 118B,A01,184959,Gupta; Anjum,0,50,40,40
1683710767073,COGS 153,A00,184961,Staff,1,16,30,29
1683710768099,COGS 177,A00,184962,Staff,0,20,30,30
1683710769121,COGS 187A,A01,184969,Boyle; Mary E. T.,0,19,40,40
1683710770144,COMM 10,A01,185174,Staff,0,5,25,25
1683710770144,COMM 10,A02,185189,Staff,0,2,25,25
1683710770144,COMM 10,A03,269821,Staff,0,1,0,0
1683710771179,COMM 100B,A02,185476,Staff,10,0,25,15
1683710771179,COMM 100B,A03,277340,Staff,25,0,25,0
1683710772207,COMM 100C,A01,185314,Staff,2,0,25,23
1683710772207,COMM 100C,A02,185327,Staff,17,0,25,8
1683710773230,COMM 110M,A00,185349,Staff,0,0,40,40
1683710774256,COMM 113T,A00,185352,Staff,25,0,40,15
1683710775280,COMM 114I,A00,185353,Staff,31,0,40,9
1683710776306,COMM 131,A00,185354,Staff,17,0,30,13
1683710777336,CSE 8A,A50,185358,Cao; Yingjun,0,46,10,10
1683710778364,CSE 8B,A01,185362,Staff,0,48,50,50
1683710779390,CSE 11,A01,185416,Cao; Yingjun,0,91,10,10
1683710780414,CSE 20,A01,185445,Briones; Jor-el Thomas Caparas,3,0,25,22
1683710781439,CSE 21,A01,185447,Staff,9,0,50,41
1683710782464,CSE 101,A01,185451,Staff,0,13,50,50
1683710782464,CSE 101,B01,185453,Jones; Miles E,0,15,50,50
1683710784519,CSE 141,A01,185458,Eldon; John,16,0,100,84
1683710785542,CSE 141L,A01,185461,Eldon; John,8,0,100,92
1683710786571,CSE 142,A01,185463,Staff,34,0,60,26
1683710786571,CSE 142,B01,201355,Staff,0,7,60,60
1683710787596,CSE 142L,A01,185470,Staff,34,0,60,26
1683710787596,CSE 142L,B01,201417,Staff,0,6,60,60
1683710788621,CSE 190,A00,201433,Staff,32,0,49,17
1683710789647,DOC 1,A01,259136,Strom; Megan C.,7,0,15,8
1683710789647,DOC 1,A02,259137,Strom; Megan C.,15,0,15,0
1683710789647,DOC 1,A03,259138,Strom; Megan C.,14,0,15,1
1683710789647,DOC 1,A04,259139,Strom; Megan C.,13,0,15,2
1683710790671,DOC 100D,A00,259140,Pass; Natalye Joann,14,0,25,11
1683710791696,DSGN 1,A01,184749,Rill; Bryan,0,26,30,30
1683710792724,DSGN 100,A01,185168,Staff,0,2,25,25
1683710793755,ECE 5,A01,185626,Morris; Karcher William,0,12,0,0
1683710794778,ECE 101,A01,185628,Staff,14,0,70,56
1683710795805,ECE 107,A01,185635,Baghdadchi; Saharnaz,0,0,20,20
1683710795805,ECE 107,A02,185638,Baghdadchi; Saharnaz,1,0,20,19
1683710796832,ECE 148,A01,185647,Silberman; Jack,0,0,16,16
1683710797861,ECON 1,A01,185537,Crane; Meredith Helen,54,0,70,16
1683710798886,ECON 3,A01,185549,Crane; Meredith Helen,30,0,70,40
1683710799914,ECON 4,A01,203354,Anderson; John Charles,0,5,10,10
1683710800941,ECON 100A,A01,185574,Staff,0,5,40,40
1683710801971,ECON 100B,A01,185576,Staff,0,12,50,50
1683710802996,ECON 100C,A01,185589,Newhouse; Herbert S,30,0,70,40
1683710804021,ECON 105,A00,185608,Vespa; Emanuel Ignacio,19,0,35,16
1683710805050,ECON 109,A01,185610,Shishkin; Denis,9,0,35,26
1683710806077,ECON 110A,A01,185612,Staff,8,0,40,32
1683710807104,ECON 120A,A01,185615,Staff,19,0,40,21
1683710808132,ECON 120C,A01,185617,Sun; Yixiao,0,21,70,70
1683710809156,ECON 144,A00,203346,Squires; Dale E,2,0,35,33
1683710810185,ECON 171,A01,203349,Newhouse; Herbert S,0,1,35,35
1683710811212,ECON 173A,A01,185621,Toda; Alexis Akira,21,0,35,14
1683710812238,EDS 25,A01,202413,Staff,0,1,0,0
1683710812238,EDS 25,A02,202414,Staff,0,1,0,0
1683710812238,EDS 25,A03,202415,Staff,0,0,0,0
1683710812238,EDS 25,A04,202416,Staff,0,1,0,0
1683710812238,EDS 25,A05,202439,Staff,0,0,0,0
1683710812238,EDS 25,A06,202440,Staff,0,0,0,0
1683710812238,EDS 25,B01,202631,Staff,0,0,0,0
1683710812238,EDS 25,B02,202632,Staff,0,0,0,0
1683710812238,EDS 25,B03,202639,Staff,0,0,0,0
1683710812238,EDS 25,B04,202640,Staff,0,0,0,0
1683710812238,EDS 25,B05,202643,Staff,0,0,0,0
1683710812238,EDS 25,B06,202644,Staff,0,0,0,0
1683710813264,EDS 38,A01,202659,Black; Alison Michelle,25,0,25,0
1683710814290,EDS 115,A00,202652,Staff,18,0,30,12
1683710815317,EDS 125,A00,202649,Staff,13,0,30,17
1683710816346,EDS 126,A01,203332,Staff,30,0,30,0
1683710817371,EDS 139,A00,202838,Staff,16,0,25,9
1683710818398,EDS 146,A01,202655,Staff,14,0,25,11
1683710819424,ENG 15,A00,185667,Staff,0,1,0,0
1683710819424,ENG 15,B00,185672,Staff,0,0,0,0
1683710819424,ENG 15,C00,185675,Staff,0,0,0,0
1683710819424,ENG 15,D00,185682,Staff,0,0,0,0
1683710819424,ENG 15,E00,185684,Staff,0,0,0,0
1683710820449,ETHN 103,A00,185710,Staff,0,8,35,35
1683710821475,ETHN 103A,A00,199228,Man; Simeon S,0,0,9,9
1683710822500,ETHN 109,A00,185711,Staff,15,0,35,20
1683710823525,ETHN 142,A00,185726,Staff,0,4,30,30
1683710824554,ETHN 163J,A00,199229,Man; Simeon S,5,0,8,3
1683710825581,ETHN 168,A00,185727,Staff,7,0,10,3
1683710826605,ETHN 182,A00,185728,Staff,0,0,35,35
1683710827633,ETHN 183,A00,185737,Staff,9,0,18,9
1683710828662,GLBH 111,A01,209361,Burgos; Jose L.,0,0,0,0
1683710830713,HIEU 104,A00,185792,Staff,14,0,20,6
1683710831742,HIEU 115,A00,185800,Staff,0,0,20,20
1683710832767,HIEU 128,A00,185801,Staff,0,9,20,20
1683710833792,HIEU 147,A00,185802,Staff,15,0,20,5
1683710834821,HIEU 154,A00,185823,Staff,11,0,20,9
1683710835849,HILA 102,A00,185826,Staff,14,0,20,6
1683710836877,HILD 2C,A01,185778,Staff,0,13,20,20
1683710837903,HILD 7B,A01,185780,Kwak; Nancy,0,17,32,32
1683710837903,HILD 7B,A02,185781,Kwak; Nancy,0,18,32,32
1683710838928,HILD 30,A01,185791,Staff,12,0,20,8
1683710839953,HISC 119,A00,185830,Golan; Tal,0,10,20,20
1683710840981,HITO 156GS,A00,185831,Patterson; Patrick H.,0,0,0,23
1683710842006,HIUS 103,A00,185832,Man; Simeon S,0,4,20,20
1683710843033,HIUS 117,A00,185836,Kwak; Nancy,2,0,20,18
1683710844061,HIUS 125,A00,185840,Man; Simeon S,0,2,23,23
1683710845089,HIUS 149,A00,185845,Staff,1,0,20,19
1683710846114,HUM 3,A01,185882,Zavodny; Tatiana Sophia,0,8,50,50
1683710846114,HUM 3,B01,185899,Caldwell; Michael Alan,0,18,50,50
1683710847139,HUM 3GS,A00,185900,Patterson; Patrick H.,0,0,0,23
1683710848165,HUM 4,A01,185938,Zroka; Amy Liane,28,0,50,22
1683710848165,HUM 4,B01,185956,Watkins; Eric,0,6,50,50
1683710848165,HUM 4,B02,202209,Watkins; Eric,0,5,50,50
1683710848165,HUM 4,B03,202210,Watkins; Eric,0,5,50,50
1683710849190,HUM 5,A01,185958,West; Geoffrey Scott,0,0,50,50
1683710849190,HUM 5,A02,202215,West; Geoffrey Scott,0,1,50,50
1683710850217,INTL 190,A00,185959,Gagnon; Jeffrey C,0,0,0,9
1683710850217,INTL 190,B00,185960,Lettieri; Michael Joseph,0,0,0,2
1683710851244,JAPN 180,A00,254509,Staff,5,0,30,25
1683710852275,LATI 10,A01,202853,Kennemore; Amy Michelle,4,0,35,31
1683710852275,LATI 10,A02,202854,Kennemore; Amy Michelle,3,0,35,32
1683710852275,LATI 10,A03,270054,Kennemore; Amy Michelle,30,0,30,0
1683710853300,LATI 180,A00,202855,Kennemore; Amy Michelle,11,0,20,9
1683710854324,LAWS 101,A00,201767,Golan; Tal,0,7,40,40
1683710855353,LIFR 1C,A00,185961,Staff,6,0,20,14
1683710856377,LIFR 1CX,A00,185962,Staff,7,0,20,13
1683710857403,LIFR 1D,A00,185963,Staff,7,0,20,13
1683710858428,LIFR 1DX,A00,185964,Staff,7,0,20,13
1683710859454,LIGN 101,A01,186039,Staff,43,0,50,7
1683710860480,LIGN 165,A00,186040,Staff,14,0,50,36
1683710861506,LTCS 108,A00,186041,Staff,5,0,10,5
1683710862532,LTCS 119,A00,186042,Staff,15,0,20,5
1683710863558,LTCS 130,A00,186043,Wesling; Megan E.,15,0,25,10
1683710865612,LTEA 138,A00,186119,Staff,14,0,40,26
1683710866637,LTEN 124,A00,186148,Staff,5,0,25,20
1683710867722,LTEN 178,A00,186149,Staff,6,0,15,9
1683710868752,LTEN 181,A00,186150,Blanco; John D,34,0,40,6
1683710869780,LTWL 120,A00,186160,Staff,19,0,25,6
1683710870804,LTWL 165,A00,186161,Staff,22,0,25,3
1683710871829,LTWR 100,A00,186162,Staff,0,5,15,15
1683710872862,LTWR 102,A00,186163,Doller; Ben,5,0,15,10
1683710873889,MAE 8,A01,186412,Staff,0,1,0,0
1683710874912,MAE 30B,A00,186445,Bahadori; Mohammad Yousef,81,0,100,19
1683710875940,MAE 40,A00,186592,Bewley; Thomas R,10,0,50,40
1683710876966,MAE 101B,A00,186593,Bahadori; Mohammad Yousef,80,0,100,20
1683710877995,MAE 105,A00,186594,Bandaru; Prabhakar,10,0,50,40
1683710879020,MAE 107,A00,186599,Pham; Hieu Tan,0,8,120,120
1683710880044,MAE 148,A01,186660,Silberman; Jack,3,0,16,13
1683710881077,MATH 10A,A01,188095,Staff,0,6,35,35
1683710882108,MATH 10B,A01,188097,Bowers; Adam R.,0,12,30,30
1683710882108,MATH 10B,A02,188099,Bowers; Adam R.,0,11,30,30
1683710882108,MATH 10B,B01,188104,Bowers; Adam R.,0,10,30,30
1683710882108,MATH 10B,B02,188106,Bowers; Adam R.,0,9,30,30
1683710883134,MATH 10C,A01,188111,Staff,0,20,30,30
1683710883134,MATH 10C,A02,188127,Staff,0,19,30,30
1683710883134,MATH 10C,A03,188131,Staff,0,19,30,30
1683710883134,MATH 10C,B01,188218,Staff,17,0,30,13
1683710883134,MATH 10C,B02,188244,Staff,13,0,30,17
1683710883134,MATH 10C,B03,188277,Staff,14,0,30,16
1683710884159,MATH 18,A01,188344,Bach; Quang Tran,18,0,30,12
1683710884159,MATH 18,A02,188345,Bach; Quang Tran,11,0,30,19
1683710884159,MATH 18,B01,188353,Bach; Quang Tran,11,0,30,19
1683710884159,MATH 18,B02,188354,Bach; Quang Tran,19,0,30,11
1683710885183,MATH 20A,A01,188374,Staff,11,0,35,24
1683710886211,MATH 20B,A01,188382,Ohm; Ko Woon,7,0,30,23
1683710886211,MATH 20B,A02,188383,Ohm; Ko Woon,22,0,30,8
1683710886211,MATH 20B,B01,188385,Ohm; Ko Woon,7,0,30,23
1683710886211,MATH 20B,B02,188392,Ohm; Ko Woon,22,0,30,8
1683710887235,MATH 20C,A01,188394,Harel; Guershon,10,0,30,20
1683710887235,MATH 20C,A02,188395,Harel; Guershon,13,0,30,17
1683710887235,MATH 20C,B01,188404,Harel; Guershon,5,0,30,25
1683710887235,MATH 20C,B02,188405,Harel; Guershon,18,0,30,12
1683710888262,MATH 20D,A01,188414,Hammock; Frances H,0,1,30,30
1683710888262,MATH 20D,A02,188415,Hammock; Frances H,0,1,30,30
1683710888262,MATH 20D,B01,188447,Hammock; Frances H,0,1,30,30
1683710888262,MATH 20D,B02,188486,Hammock; Frances H,2,0,30,28
1683710889292,MATH 20E,A01,188649,Staff,21,0,30,9
1683710889292,MATH 20E,A02,188650,Staff,20,0,30,10
1683710889292,MATH 20E,A03,188673,Staff,0,0,30,30
1683710890316,MATH 102,A01,188675,Staff,0,40,35,35
1683710891341,MATH 103B,A01,188681,Staff,3,0,35,32
1683710891341,MATH 103B,B01,188692,Staff,5,0,35,30
1683710892370,MATH 109,A01,188695,Salehi Golsefidy; Alireza,24,0,35,11
1683710892370,MATH 109,A02,188696,Salehi Golsefidy; Alireza,25,0,35,10
1683710893394,MATH 120A,A01,188698,Eggers; John Dietrich,7,0,35,28
1683710894420,MATH 142B,A01,188736,Ioana; Adrian,0,0,30,30
1683710894420,MATH 142B,A02,188741,Ioana; Adrian,0,1,30,30
1683710894420,MATH 142B,A03,188743,Ioana; Adrian,0,2,30,30
1683710895446,MATH 168A,A01,188790,Staff,0,11,35,35
1683710896476,MATH 170A,A01,188803,Nie; Jiawang,0,2,35,35
1683710896476,MATH 170A,A02,188811,Nie; Jiawang,0,1,35,35
1683710896476,MATH 170A,A03,188814,Nie; Jiawang,1,0,35,34
1683710896476,MATH 170A,A04,188815,Nie; Jiawang,5,0,35,30
1683710897506,MATH 193B,A01,188817,Staff,0,0,35,35
1683710897506,MATH 193B,A02,188818,Staff,6,0,35,29
1683710898531,MGT 4,A01,202857,Anderson; John Charles,59,0,80,21
1683710899555,MGT 12,A00,202858,Lindenberger; Wade Douglas,40,0,90,50
1683710900586,MGT 18,A00,202859,Staff,73,0,90,17
1683710901611,MGT 18GS,A00,202860,McKay; Michael J,13,0,28,15
1683710902637,MGT 45,A00,202861,Pecore; Joseph P.,8,0,90,82
1683710903663,MGT 100,A00,202863,Yavorsky; Daniel Ryan,27,0,90,63
1683710904691,MGT 103,A00,202864,Ehrich; Kristine R,0,19,90,90
1683710905719,MGT 112,A00,202865,Ehrich; Kristine R,15,0,90,75
1683710906744,MGT 121A,A00,202868,Staff,70,0,90,20
1683710907771,MGT 131B,A00,202869,Anderson; John Charles,58,0,90,32
1683710908800,MGT 136,A00,202871,Lindenberger; Wade Douglas,83,0,90,7
1683710909827,MGT 164,A00,202873,Staff,0,67,90,91
1683710910854,MGT 164GS,A00,202874,McKay; Mary A,13,0,28,15
1683710911880,MGT 180,A00,202875,Staff,0,51,90,91
1683710912908,MMW 11R,A01,205019,Herbst; Matthew,0,0,30,30
1683710912908,MMW 11R,A02,205026,Herbst; Matthew,29,0,30,1
1683710913939,MMW 15,A01,193512,Chang; Edmond Yi-Teh,0,8,28,28
1683710913939,MMW 15,A02,193513,Chang; Edmond Yi-Teh,0,5,28,28
1683710913939,MMW 15,A03,193514,Chang; Edmond Yi-Teh,0,5,28,28
1683710913939,MMW 15,A04,193515,Chang; Edmond Yi-Teh,0,5,28,28
1683710913939,MMW 15,A05,193516,Chang; Edmond Yi-Teh,0,5,28,28
1683710913939,MMW 15,A06,193517,Chang; Edmond Yi-Teh,0,6,28,28
1683710913939,MMW 15,B01,193519,Chang; Edmond Yi-Teh,0,5,28,28
1683710913939,MMW 15,B02,193520,Chang; Edmond Yi-Teh,0,5,28,28
1683710913939,MMW 15,B03,193521,Chang; Edmond Yi-Teh,0,5,28,28
1683710913939,MMW 15,B04,193522,Chang; Edmond Yi-Teh,0,6,28,28
1683710913939,MMW 15,B05,193523,Chang; Edmond Yi-Teh,0,5,28,28
1683710913939,MMW 15,B06,193524,Chang; Edmond Yi-Teh,0,5,28,28
1683710914967,MMW 122,A01,193526,Rahimi; Babak,0,16,28,28
1683710914967,MMW 122,A02,193527,Rahimi; Babak,0,15,28,28
1683710914967,MMW 122,A03,193528,Rahimi; Babak,0,0,0,0
1683710914967,MMW 122,A04,193529,Rahimi; Babak,0,0,0,0
1683710915995,MUS 1A,A01,186663,Staff,0,18,35,35
1683710917020,MUS 4,A01,186715,Staff,0,12,35,35
1683710918046,MUS 5R,A01,186796,Dubnov; Shlomo,0,17,35,35
1683710919074,MUS 6,A01,186798,Staff,0,4,25,25
1683710920101,MUS 7,A01,186830,Staff,11,0,35,24
1683710921125,MUS 8,A01,186930,Staff,0,27,35,35
1683710922150,MUS 15,A01,186932,Staff,0,15,35,35
1683710922150,MUS 15,B01,186934,Staff,0,16,35,35
1683710923176,MUS 80,A00,186935,Staff,0,0,20,20
1683710923176,MUS 80,B00,186936,Staff,24,0,25,1
1683710924202,NANO 11,A00,204702,Lipomi; Darren John,0,0,0,0
1683710925227,NANO 15,A01,204709,Yang; Kesong,0,1,0,0
1683710926257,NANO 114,A00,202069,Jahed Motlagh; Zeinab,2,0,10,8
1683710927285,PHIL 1,A00,186955,Grush; Rick Scott,31,0,40,9
1683710928309,PHIL 10,A01,186973,Grush; Rick Scott,27,0,35,8
1683710928309,PHIL 10,A02,186974,Grush; Rick Scott,33,0,35,2
1683710929333,PHIL 13,A01,186976,Staff,1,0,35,34
1683710929333,PHIL 13,A02,186977,Staff,16,0,35,19
1683710930357,PHIL 14,A01,186979,Staff,30,0,35,5
1683710930357,PHIL 14,A02,186986,Staff,32,0,35,3
1683710931385,PHIL 28,A01,186988,Staff,16,0,30,14
1683710931385,PHIL 28,A02,186989,Staff,0,0,30,30
1683710931385,PHIL 28,A03,186990,Staff,10,0,30,20
1683710931385,PHIL 28,A04,186991,Staff,26,0,30,4
1683710932413,PHIL 120,A00,186997,Staff,23,0,40,17
1683710933437,PHIL 137,A00,187003,Staff,8,0,40,32
1683710934462,PHIL 150,A00,187015,Staff,47,0,70,23
1683710935488,PHIL 167,A00,187021,Lamey; Andy M.,34,0,40,6
1683710936513,PHIL 174,A01,202226,Staff,17,0,20,3
1683710936513,PHIL 174,A02,202235,Staff,20,0,20,0
1683710937548,PHIL 191A,A00,258918,Staff,0,0,1,1
1683710938576,PHYS 1A,A00,187028,Staff,26,0,60,34
1683710939601,PHYS 1AL,001,187036,Staff,3,0,30,27
1683710939601,PHYS 1AL,002,187049,Staff,18,0,30,12
1683710940625,PHYS 1B,A00,187058,Staff,21,0,60,39
1683710941652,PHYS 1BL,001,187064,Staff,0,1,30,30
1683710941652,PHYS 1BL,002,187070,Staff,4,0,30,26
1683710942676,PHYS 1C,A00,187082,Staff,30,0,120,90
1683710943702,PHYS 1CL,001,187088,Staff,0,9,30,30
1683710943702,PHYS 1CL,002,187089,Staff,0,1,30,30
1683710943702,PHYS 1CL,009,262693,Staff,9,0,30,21
1683710944730,PHYS 2B,A01,187097,Staff,55,0,115,60
1683710945756,PHYS 2C,A01,187099,Staff,63,0,115,52
1683710946782,PHYS 2CL,A01,187101,Staff,5,0,28,23
1683710946782,PHYS 2CL,A02,187102,Staff,15,0,28,13
1683710947812,PHYS 2D,A01,187123,Shotwell; Brian,95,0,115,20
1683710948839,PHYS 4B,A01,187133,Grinstein; Benjamin,35,0,50,15
1683710949864,POLI 10,A00,188819,Staff,0,4,50,50
1683710950887,POLI 11,A00,188827,Staff,43,0,50,7
1683710951912,POLI 13R,A00,188828,Staff,0,1,20,20
1683710952941,POLI 27,A01,188830,Elgin; Samuel Zincke,0,2,70,70
1683710953967,POLI 30,A00,188832,Desposato; Scott,30,0,50,20
1683710954990,POLI 102F,A00,188834,Staff,1,0,40,39
1683710956015,POLI 104A,A00,188852,Staff,12,0,30,18
1683710957043,POLI 104I,A00,188853,Staff,0,8,20,20
1683710958067,POLI 110B,A00,188854,Wiens; David,6,0,20,14
1683710959094,POLI 112A,A00,188855,Wiens; David,3,0,30,27
1683710960118,POLI 117R,A00,188856,Forman; Fonna,0,12,20,20
1683710961143,POLI 118,A00,188857,Ingham; Sean,8,0,20,12
1683710962170,POLI 120G,A00,188858,Staff,7,0,30,23
1683710963196,POLI 131CR,A00,188863,Hoston; Germaine,20,0,50,30
1683710964222,POLI 133,A00,188864,Nellis; Gareth Hb,44,0,50,6
1683710965249,POLI 134D,A00,188865,Desposato; Scott,27,0,30,3
1683710966274,POLI 142A,A00,188871,Gartzke; Erik,21,0,50,29
1683710967299,POLI 142K,A00,188874,Staff,38,0,50,12
1683710968326,POLI 143,A00,188940,Gartzke; Erik,15,0,30,15
1683710969353,POLI 153,A00,188943,Staff,1,0,20,19
1683710970379,POLI 160AA,A00,188944,Staff,10,0,40,30
1683710971458,POLI 170A,A00,188945,Staff,10,0,30,20
1683710973507,PSYC 1,A00,188952,Staff,36,0,90,54
1683710974534,PSYC 2,B00,188953,Staff,19,0,35,16
1683710975562,PSYC 6,A00,188970,Staff,47,0,60,13
1683710976587,PSYC 7,A00,188973,Staff,35,0,45,10
1683710977616,PSYC 60,A01,188980,Rickard; Timothy C.,42,0,60,18
1683710978640,PSYC 70,A01,189001,Steiner; Eric Tomas,22,0,45,23
1683710979664,PSYC 100,A00,189005,Lacefield; Katharine I,1,98,120,119
1683710980689,PSYC 102,A00,189008,Staff,6,0,30,24
1683710981717,PSYC 106,B00,189026,Gorman; Michael R.,27,0,60,33
1683710982746,PSYC 114,B01,189033,Winkielman; Piotr,0,31,30,30
1683710983770,PSYC 131,A00,189036,Anagnostaras; Stephan,0,44,60,60
1683710984795,PSYC 136,A00,189041,Lowe; Angela Beth,0,7,25,25
1683710985820,PSYC 137,A00,189057,Winkielman; Piotr,0,36,25,25
1683710986846,PSYC 144,A00,189107,Wixted; John T,0,11,50,50
1683710988898,PSYC 162,A00,189142,Staff,0,9,85,85
1683710989923,PSYC 172,A00,189144,Gorman; Michael R.,0,6,30,30
1683710991978,PSYC 179,A00,189146,Lacefield; Katharine I,0,88,120,120
1683710993002,PSYC 181,A00,189147,Anagnostaras; Stephan,0,45,90,90
1683710994029,PSYC 190R,A00,189148,Barner; David A.,0,23,80,80
1683710995059,PSYC 191,A00,189275,Rickard; Timothy C.,0,11,25,25
1683710996089,PSYC 193,A00,189276,Chapman; Eddie Nathaniel,0,1,0,4
1683710997117,PSYC 193L,A01,189281,Lowe; Angela Beth,8,0,20,12
1683710997117,PSYC 193L,B01,189285,Staff,28,0,35,7
1683710998141,RELI 149,A00,187137,Rahimi; Babak,6,0,40,34
1683710999168,SE 9,A01,187315,Staff,0,2,18,18
1683711000195,SE 101B,A00,187409,Staff,24,0,30,6
1683711001220,SE 110B,A00,187444,Staff,10,0,40,30
1683711002244,SE 130B,A00,187449,Staff,31,0,40,9
1683711003273,SE 150A,A00,187516,Staff,8,0,20,12
1683711004294,SE 154,A00,187528,Staff,29,0,50,21
1683711005319,SIO 3,A01,258171,Staff,35,0,40,5
1683711006348,SIO 10,A00,187144,Cook; Geoffrey W,0,6,75,75
1683711007374,SIO 45,A00,187152,Cook; Geoffrey W,1,7,100,99
1683711008400,SIO 109R,A00,194486,Staff,0,4,20,20
1683711010448,SIO 187,A01,187233,Kacev; David,12,0,40,28
1683711011473,SOCI 1,A01,258656,Thorpe; Charles Robert,28,0,30,2
1683711011473,SOCI 1,A02,258658,Thorpe; Charles Robert,30,0,30,0
1683711011473,SOCI 1,A03,258661,Thorpe; Charles Robert,25,0,25,0
1683711011473,SOCI 1,A04,258666,Thorpe; Charles Robert,22,0,25,3
1683711011473,SOCI 1,A05,258897,Thorpe; Charles Robert,22,0,25,3
1683711011473,SOCI 1,A06,258898,Thorpe; Charles Robert,25,0,25,0
1683711012496,SOCI 30,A01,258903,Pardo Guerra; Juan Pablo,14,0,30,16
1683711013523,SOCI 102,A00,258904,Staff,9,0,25,16
1683711014547,SOCI 106,A00,258905,Staff,19,0,25,6
1683711015573,SOCI 111,A00,258907,Ribas Norris; Janet Vanesa,26,0,30,4
1683711016598,SOCI 121R,A00,258908,Pardo Guerra; Juan Pablo,7,0,30,23
1683711017626,SOCI 126,A01,203330,Staff,14,0,20,6
1683711018654,SOCI 131,A00,258909,Thorpe; Charles Robert,30,0,60,30
1683711019680,SOCI 135,A00,258910,Payne; Christine Anna,0,13,30,30
1683711020707,SOCI 157,A00,258911,Staff,10,0,30,20
1683711021732,SOCI 184,A00,258912,Staff,25,0,30,5
1683711022759,SOCI 188D,A00,258913,Staff,22,0,30,8
1683711023785,SYN 2,001,187529,Staff,9,0,16,7
1683711023785,SYN 2,002,201452,Staff,0,20,16,16
1683711023785,SYN 2,003,201469,Staff,1,0,16,15
1683711024812,SYN 100,A01,187531,Staff,0,9,20,20
1683711024812,SYN 100,B01,201491,Staff,0,10,20,20
1683711025840,TDAC 1,A00,189286,Walsh; Kim C.,3,0,20,17
1683711025840,TDAC 1,B00,189287,Harting; Carla Kelso,10,0,20,10
1683711026866,TDAC 101,A00,189300,Walsh; Kim C.,16,0,20,4
1683711026866,TDAC 101,B00,189301,Harting; Carla Kelso,18,0,20,2
1683711027895,TDAC 102,A00,189304,Basso; Beatrice,14,0,20,6
1683711028920,TDAC 108,A00,189305,Staff,18,0,20,2
1683711029954,TDDE 131,A00,189310,Staff,19,0,20,1
1683711029954,TDDE 131,B00,189314,Staff,19,0,20,1
1683711029954,TDDE 131,C00,189315,Staff,48,0,50,2
1683711029954,TDDE 131,D00,189316,Staff,14,0,15,1
1683711029954,TDDE 131,E00,204841,Staff,20,0,20,0
1683711030980,TDGE 10,A00,189289,Staff,27,0,50,23
1683711030980,TDGE 10,B00,189290,Havis; Allan,0,1,50,50
1683711032006,TDGE 11,A00,189291,Fulton; Julia,0,4,50,50
1683711032006,TDGE 11,B00,189292,Staff,20,0,25,5
1683711032006,TDGE 11,C00,260270,Staff,0,0,0,0
1683711033031,TDGE 25,A00,189294,Staff,1,0,20,19
1683711034057,TDGE 124,A00,189318,Fulton; Julia,0,7,50,50
1683711035081,TDGE 125,A00,189319,Staff,13,0,25,12
1683711035081,TDGE 125,B00,189320,Staff,23,0,25,2
1683711036110,TDGE 127,A00,189322,Havis; Allan,1,0,50,49
1683711037135,TDHT 101,A00,189323,Staff,18,0,25,7
1683711037135,TDHT 101,B00,189324,Staff,25,0,25,0
1683711038166,TDHT 102,A00,189325,Staff,49,0,50,1
1683711039189,TDMV 1,A00,189295,Arcidiacono; Kristin,20,0,30,10
1683711039189,TDMV 1,B00,189296,Caligagan; Maria T.,23,0,30,7
1683711040214,TDMV 2,A00,189297,Sammartano; Tonnie,27,0,30,3
1683711040214,TDMV 2,B00,189299,Arcidiacono; Kristin,23,0,30,7
1683711041241,TDMV 3,A00,204998,Rincon; Alicia,22,0,30,8
1683711042265,TDMV 120,A00,189458,Sammartano; Tonnie,28,0,30,2
1683711043293,TDMV 138,A00,189541,Jun; Grace Shin Hae,20,0,40,20
1683711044323,TDMV 142,A00,189717,Caligagan; Tony,25,0,30,5
1683711044323,TDMV 142,B00,189718,Caligagan; Maria T.,25,0,30,5
1683711045352,TMC 2,A01,187533,Staff,25,0,25,0
1683711045352,TMC 2,A02,187534,Staff,25,0,25,0
1683711046382,USP 1,A01,187536,Kwak; Nancy,0,16,25,25
1683711047411,USP 5,A01,187538,Staff,8,0,25,17
1683711048441,USP 101,A00,199253,Staff,0,4,0,0
1683711049470,USP 124,A00,187562,Boomhower; Matthew Charles,0,0,30,30
1683711050498,USP 138,A00,187582,Staff,19,0,25,6
1683711051530,USP 152,A01,187597,Staff,3,0,25,22
1683711052553,USP 153,A00,187598,Staff,18,0,25,7
1683711053579,USP 168,A00,187607,Kwak; Nancy,2,0,5,3
1683711054605,USP 173,A00,187619,Staff,4,0,25,21
1683711055629,USP 181,A00,187638,Staff,0,4,25,25
1683711056658,VIS 103,A00,187650,Cruz; Edwin Teddy,17,0,75,58
1683711057685,VIS 110D,A00,187669,Staff,13,0,22,9
1683711058715,VIS 127C,A00,187720,Shen; Kuiyi,67,0,146,79
1683711059741,VIS 149,A00,187731,Yoldas; Pinar,0,12,22,22
1683711060769,VIS 151,A01,188091,Staff,22,0,34,12
1683711060769,VIS 151,A02,188092,Staff,11,0,34,23
1683711061794,VIS 160B,A00,188093,Stalbaum; Brett,0,1,10,10
1683711063852,WCWP 10B,A00,201720,Staff,0,0,5,5
1683711063852,WCWP 10B,B00,201722,Staff,0,0,6,6
1683711064878,WCWP 100,A00,201725,Gagnon; Jeffrey C,0,0,2,2
1683711064878,WCWP 100,B00,201727,Staff,0,4,15,15
1683711068057,ANBI 133,A00,258401,Wilder; Linnea Lorene,34,0,40,6
1683711069081,ANBI 140,A00,258395,Hrvoj Mihic; Branka,18,0,25,7
1683711070108,ANSC 120,A00,258402,Bialecki; Jon Anthony,26,0,40,14
1683711071135,ANSC 144,A00,258400,Staff,12,0,40,28
1683711073185,ANSC 166,A00,258396,Parish; Steven Martin,156,0,175,19
1683711074213,ANSC 180,A00,193533,Staff,8,0,20,12
1683711075301,ANSC 188,A00,258397,Jassal; Aftab,34,0,40,6
1683711076328,ANTH 3,A01,258316,Staff,23,0,30,7
1683711077356,ANTH 5,A00,258394,Semendeferi; Ekaterini,16,0,20,4
1683711078381,ANTH 21,A01,258331,Staff,4,0,40,36
1683711079404,ANTH 103,A00,258398,Varma; Saiba,15,0,25,10
1683711080438,AWP 10,001,202034,Staff,0,0,0,0
1683711080438,AWP 10,002,202035,Staff,0,0,0,0
1683711080438,AWP 10,003,202036,Staff,0,0,0,0
1683711080438,AWP 10,004,202037,Staff,0,0,0,0
1683711080438,AWP 10,005,202038,Staff,0,0,0,0
1683711080438,AWP 10,006,202039,Staff,0,0,0,0
1683711080438,AWP 10,007,202040,Staff,0,0,0,0
1683711080438,AWP 10,008,202041,Staff,0,0,0,0
1683711080438,AWP 10,009,202042,Staff,0,0,0,0
1683711080438,AWP 10,010,202043,Staff,0,0,0,0
1683711080438,AWP 10,011,202044,Staff,0,0,0,0
1683711080438,AWP 10,012,202045,Staff,0,0,0,0
1683711080438,AWP 10,013,202046,Staff,0,0,0,0
1683711080438,AWP 10,014,202047,Staff,0,0,0,0
1683711080438,AWP 10,015,202048,Staff,0,0,0,0
1683711080438,AWP 10,016,202049,Staff,0,0,0,0
1683711080438,AWP 10,017,202050,Staff,0,0,0,0
1683711080438,AWP 10,018,202051,Staff,0,0,0,0
1683711080438,AWP 10,019,202052,Staff,0,0,0,0
1683711080438,AWP 10,020,202053,Staff,0,0,0,0
1683711080438,AWP 10,021,202054,Staff,0,0,0,0
1683711080438,AWP 10,022,202055,Staff,0,0,0,0
1683711080438,AWP 10,023,202056,Staff,0,0,0,0
1683711080438,AWP 10,024,202057,Staff,0,0,0,0
1683711080438,AWP 10,025,202058,Staff,0,0,0,0
1683711080438,AWP 10,026,202059,Staff,0,0,0,0
1683711081465,AWP 102,001,202032,Staff,0,0,0,0
1683711081465,AWP 102,002,202033,Staff,0,0,0,0
1683711082492,BENG 100,A01,254234,Taylor Amos; Alyssa C,31,0,40,9
1683711083521,BENG 196,001,270013,Engler; Adam J.,9999,0,9999,0
1683711084551,BICD 100R,A01,202018,Smith; Laurie,0,7,32,32
1683711084551,BICD 100R,A02,202019,Smith; Laurie,0,3,32,32
1683711084551,BICD 100R,A03,202020,Smith; Laurie,0,1,32,32
1683711084551,BICD 100R,A04,202021,Smith; Laurie,6,0,32,26
1683711084551,BICD 100R,A05,202022,Smith; Laurie,10,0,32,22
1683711085578,BICD 136,A01,193242,Gustafson-Brown; Cindy,0,2,32,32
1683711085578,BICD 136,A02,193244,Gustafson-Brown; Cindy,13,0,32,19
1683711086605,BIEB 102,A01,193249,Butler; Shannon Rhey,0,0,32,32
1683711086605,BIEB 102,A02,193251,Butler; Shannon Rhey,0,0,32,32
1683711086605,BIEB 102,A03,193253,Butler; Shannon Rhey,0,0,32,32
1683711086605,BIEB 102,A04,193255,Butler; Shannon Rhey,13,0,32,19
1683711086605,BIEB 102,A05,193265,Butler; Shannon Rhey,25,0,32,7
1683711086605,BIEB 102,A06,193269,Butler; Shannon Rhey,12,0,32,20
1683711088659,BIEB 150,A01,193274,Staff,0,0,32,32
1683711088659,BIEB 150,A02,193285,Staff,24,0,32,8
1683711089686,BIEB 194,A00,193286,Kurle; Carolyn M.,19,0,32,13
1683711090713,BILD 1,A01,192291,Staff,15,0,32,17
1683711090713,BILD 1,A02,192292,Staff,30,0,32,2
1683711090713,BILD 1,B01,192520,Reuther; Keefe,0,1,0,0
1683711090713,BILD 1,B02,192532,Reuther; Keefe,0,1,0,0
1683711091739,BILD 3,A01,192556,Butler; Shannon Rhey,0,0,32,32
1683711091739,BILD 3,A02,192581,Butler; Shannon Rhey,0,1,32,32
1683711091739,BILD 3,A03,192611,Butler; Shannon Rhey,19,0,32,13
1683711091739,BILD 3,A04,192612,Butler; Shannon Rhey,23,0,32,9
1683711091739,BILD 3,A05,192613,Butler; Shannon Rhey,26,0,32,6
1683711091739,BILD 3,A06,192679,Butler; Shannon Rhey,27,0,32,5
1683711091739,BILD 3,A07,192682,Butler; Shannon Rhey,20,0,32,12
1683711092765,BILD 4,A01,192836,Reuther; Keefe,1,0,24,23
1683711092765,BILD 4,A02,193044,Reuther; Keefe,4,0,24,20
1683711093795,BILD 10,A01,193142,Gustafson-Brown; Cindy,29,0,32,3
1683711093795,BILD 10,A02,193149,Gustafson-Brown; Cindy,31,0,32,1
1683711094823,BIMM 100,A01,193301,Staff,0,6,32,32
1683711094823,BIMM 100,A02,193312,Staff,0,7,32,32
1683711094823,BIMM 100,A03,193323,Staff,0,10,32,32
1683711095854,BIMM 101,A01,193329,McDonnell; Lisa Marie,0,3,24,24
1683711095854,BIMM 101,A02,193339,McDonnell; Lisa Marie,0,3,24,24
1683711095854,BIMM 101,B01,193354,McDonnell; Lisa Marie,0,4,24,24
1683711095854,BIMM 101,B02,193357,McDonnell; Lisa Marie,0,3,24,24
1683711096884,BIMM 110,A01,193377,Tat; John,0,11,32,32
1683711096884,BIMM 110,A02,193378,Tat; John,0,11,32,32
1683711097915,BIMM 120,A01,206116,Staff,0,0,32,32
1683711097915,BIMM 120,A02,206117,Staff,7,0,32,25
1683711097915,BIMM 120,A03,206121,Staff,21,0,32,11
1683711098946,BIPN 100,A01,193393,Park; Ji Young,0,15,32,32
1683711098946,BIPN 100,A02,193402,Park; Ji Young,0,14,32,32
1683711098946,BIPN 100,A03,193413,Park; Ji Young,0,14,32,32
1683711098946,BIPN 100,A04,193414,Park; Ji Young,0,13,32,32
1683711099974,BIPN 102,A01,193429,Staff,0,0,32,32
1683711099974,BIPN 102,A02,193438,Staff,18,0,32,14
1683711101005,BIPN 106,A01,193450,Reyes Gonzalez; Catalina,0,2,40,40
1683711102034,BIPN 134,A01,193465,Cooke; James Edward,0,0,32,32
1683711102034,BIPN 134,A02,193474,Cooke; James Edward,25,0,32,7
1683711102034,BIPN 134,A03,193485,Cooke; James Edward,29,0,32,3
1683711102034,BIPN 134,A04,193486,Cooke; James Edward,20,0,32,12
1683711102034,BIPN 134,A05,193491,Cooke; James Edward,31,0,32,1
1683711102034,BIPN 134,A06,193501,Cooke; James Edward,30,0,32,2
1683711102034,BIPN 134,A07,193510,Cooke; James Edward,29,0,32,3
1683711104089,BISP 194,A00,222522,Staff,14,0,32,18
1683711105118,CAT 124,A01,202407,Staff,19,0,25,6
1683711106144,CAT 125,A00,202408,Marchisotto; Jennifer Anne,2,0,20,18
1683711107170,CAT 125R,A00,202409,Smith; Lauryn Alissa,0,11,20,20
1683711107170,CAT 125R,B00,202410,Morales; Celeste Georgianna,0,11,20,20
1683711107170,CAT 125R,C00,202411,Irwin; Matthew Joseph,0,12,20,20
1683711108196,CENG 15,A01,204712,Yang; Kesong,0,1,0,0
1683711109221,CENG 114,A00,202070,Jahed Motlagh; Zeinab,5,0,20,15
1683711110247,CGS 105,A00,185477,Wesling; Megan E.,24,0,40,16
1683711111275,CGS 106,A00,185494,Staff,11,0,22,11
1683711112299,CGS 108,A00,185495,Staff,14,0,20,6
1683711113325,CGS 114,A00,185496,Staff,13,0,18,5
1683711114351,CGS 119,A00,185501,Staff,15,0,20,5
1683711115380,CGS 120,A00,185511,Staff,11,0,20,9
1683711116407,CHEM 4,A01,184675,Bussey; Thomas J,97,0,100,3
1683711117436,CHEM 6A,A01,184677,Staff,32,0,60,28
1683711118461,CHEM 6B,A01,184679,Staff,63,0,100,37
1683711119487,CHEM 6C,A01,184681,Bussey; Thomas J,0,0,50,50
1683711119487,CHEM 6C,A02,184682,Bussey; Thomas J,32,0,50,18
1683711120514,CHEM 40A,A01,184684,Albizati; Kim F.,33,0,100,67
1683711121543,CHEM 40B,A01,184686,Albizati; Kim F.,0,22,100,100
1683711122572,CHEM 41B,A01,184690,Staff,51,0,100,49
1683711123603,COGS 3,A01,184715,Boyle; Mary E. T.,0,27,40,40
1683711124631,COGS 14B,A01,185172,Staff,0,14,38,38
1683711125656,COGS 18,A01,184736,Staff,14,0,80,66
1683711126685,COGS 100,A01,184932,Staff,0,8,73,73
1683711127709,COGS 101A,A01,184935,Staff,0,40,30,30
1683711128734,COGS 101B,A01,184944,Staff,0,2,30,30
1683711129764,COGS 101C,A01,184946,Staff,0,10,30,30
1683711130790,COGS 102A,A01,184951,Johnson; Christine M.,1,0,40,39
1683711131819,COGS 107B,A01,184953,Mooshagian; Eric Frederick,0,52,40,40
1683711132849,COGS 118B,A01,184959,Gupta; Anjum,0,50,40,40
1683711133877,COGS 153,A00,184961,Staff,1,16,30,29
1683711134902,COGS 177,A00,184962,Staff,0,20,30,30
1683711135928,COGS 187A,A01,184969,Boyle; Mary E. T.,0,19,40,40
1683711136958,COMM 10,A01,185174,Staff,0,5,25,25
1683711136958,COMM 10,A02,185189,Staff,0,2,25,25
1683711136958,COMM 10,A03,269821,Staff,0,1,0,0
1683711137991,COMM 100B,A02,185476,Staff,10,0,25,15
1683711137991,COMM 100B,A03,277340,Staff,25,0,25,0
1683711139023,COMM 100C,A01,185314,Staff,2,0,25,23
1683711139023,COMM 100C,A02,185327,Staff,17,0,25,8
1683711140050,COMM 110M,A00,185349,Staff,0,0,40,40
1683711141075,COMM 113T,A00,185352,Staff,25,0,40,15
1683711142102,COMM 114I,A00,185353,Staff,31,0,40,9
1683711143128,COMM 131,A00,185354,Staff,17,0,30,13
1683711144168,CSE 8A,A50,185358,Cao; Yingjun,0,46,10,10
1683711145195,CSE 8B,A01,185362,Staff,0,48,50,50
1683711146222,CSE 11,A01,185416,Cao; Yingjun,0,91,10,10
1683711147254,CSE 20,A01,185445,Briones; Jor-el Thomas Caparas,3,0,25,22
1683711148279,CSE 21,A01,185447,Staff,9,0,50,41
1683711149306,CSE 101,A01,185451,Staff,0,13,50,50
1683711149306,CSE 101,B01,185453,Jones; Miles E,0,15,50,50
1683711151355,CSE 141,A01,185458,Eldon; John,16,0,100,84
1683711152380,CSE 141L,A01,185461,Eldon; John,8,0,100,92
1683711153408,CSE 142,A01,185463,Staff,34,0,60,26
1683711153408,CSE 142,B01,201355,Staff,0,7,60,60
1683711154437,CSE 142L,A01,185470,Staff,34,0,60,26
1683711154437,CSE 142L,B01,201417,Staff,0,6,60,60
1683711155461,CSE 190,A00,201433,Staff,32,0,49,17
1683711156495,DOC 1,A01,259136,Strom; Megan C.,7,0,15,8
1683711156495,DOC 1,A02,259137,Strom; Megan C.,15,0,15,0
1683711156495,DOC 1,A03,259138,Strom; Megan C.,14,0,15,1
1683711156495,DOC 1,A04,259139,Strom; Megan C.,13,0,15,2
1683711157521,DOC 100D,A00,259140,Pass; Natalye Joann,14,0,25,11
1683711158547,DSGN 1,A01,184749,Rill; Bryan,0,26,30,30
1683711159572,DSGN 100,A01,185168,Staff,0,2,25,25
1683711160598,ECE 5,A01,185626,Morris; Karcher William,0,12,0,0
1683711161625,ECE 101,A01,185628,Staff,14,0,70,56
1683711162649,ECE 107,A01,185635,Baghdadchi; Saharnaz,0,0,20,20
1683711162649,ECE 107,A02,185638,Baghdadchi; Saharnaz,1,0,20,19
1683711163675,ECE 148,A01,185647,Silberman; Jack,0,0,16,16
1683711164702,ECON 1,A01,185537,Crane; Meredith Helen,54,0,70,16
1683711165732,ECON 3,A01,185549,Crane; Meredith Helen,30,0,70,40
1683711166763,ECON 4,A01,203354,Anderson; John Charles,0,5,10,10
1683711167788,ECON 100A,A01,185574,Staff,0,5,40,40
1683711168816,ECON 100B,A01,185576,Staff,0,12,50,50
1683711169842,ECON 100C,A01,185589,Newhouse; Herbert S,30,0,70,40
1683711170868,ECON 105,A00,185608,Vespa; Emanuel Ignacio,19,0,35,16
1683711171894,ECON 109,A01,185610,Shishkin; Denis,9,0,35,26
1683711172922,ECON 110A,A01,185612,Staff,8,0,40,32
1683711173953,ECON 120A,A01,185615,Staff,19,0,40,21
1683711174978,ECON 120C,A01,185617,Sun; Yixiao,0,21,70,70
1683711176006,ECON 144,A00,203346,Squires; Dale E,2,0,35,33
1683711177035,ECON 171,A01,203349,Newhouse; Herbert S,0,1,35,35
1683711178062,ECON 173A,A01,185621,Toda; Alexis Akira,21,0,35,14
1683711179151,EDS 25,A01,202413,Staff,0,1,0,0
1683711179151,EDS 25,A02,202414,Staff,0,1,0,0
1683711179151,EDS 25,A03,202415,Staff,0,0,0,0
1683711179151,EDS 25,A04,202416,Staff,0,1,0,0
1683711179151,EDS 25,A05,202439,Staff,0,0,0,0
1683711179151,EDS 25,A06,202440,Staff,0,0,0,0
1683711179151,EDS 25,B01,202631,Staff,0,0,0,0
1683711179151,EDS 25,B02,202632,Staff,0,0,0,0
1683711179151,EDS 25,B03,202639,Staff,0,0,0,0
1683711179151,EDS 25,B04,202640,Staff,0,0,0,0
1683711179151,EDS 25,B05,202643,Staff,0,0,0,0
1683711179151,EDS 25,B06,202644,Staff,0,0,0,0
1683711180176,EDS 38,A01,202659,Black; Alison Michelle,25,0,25,0
1683711181202,EDS 115,A00,202652,Staff,18,0,30,12
1683711182229,EDS 125,A00,202649,Staff,13,0,30,17
1683711183255,EDS 126,A01,203332,Staff,30,0,30,0
1683711184280,EDS 139,A00,202838,Staff,16,0,25,9
1683711185311,EDS 146,A01,202655,Staff,14,0,25,11
1683711186342,ENG 15,A00,185667,Staff,0,1,0,0
1683711186342,ENG 15,B00,185672,Staff,0,0,0,0
1683711186342,ENG 15,C00,185675,Staff,0,0,0,0
1683711186342,ENG 15,D00,185682,Staff,0,0,0,0
1683711186342,ENG 15,E00,185684,Staff,0,0,0,0
1683711187365,ETHN 103,A00,185710,Staff,0,8,35,35
1683711188396,ETHN 103A,A00,199228,Man; Simeon S,0,0,9,9
1683711189424,ETHN 109,A00,185711,Staff,15,0,35,20
1683711190451,ETHN 142,A00,185726,Staff,0,4,30,30
1683711191481,ETHN 163J,A00,199229,Man; Simeon S,5,0,8,3
1683711192509,ETHN 168,A00,185727,Staff,7,0,10,3
1683711193536,ETHN 182,A00,185728,Staff,0,0,35,35
1683711194564,ETHN 183,A00,185737,Staff,9,0,18,9
1683711195592,GLBH 111,A01,209361,Burgos; Jose L.,0,0,0,0
1683711197645,HIEU 104,A00,185792,Staff,14,0,20,6
1683711198671,HIEU 115,A00,185800,Staff,0,0,20,20
1683711199695,HIEU 128,A00,185801,Staff,0,9,20,20
1683711200722,HIEU 147,A00,185802,Staff,15,0,20,5
1683711201753,HIEU 154,A00,185823,Staff,11,0,20,9
1683711202777,HILA 102,A00,185826,Staff,14,0,20,6
1683711203803,HILD 2C,A01,185778,Staff,0,13,20,20
1683711204829,HILD 7B,A01,185780,Kwak; Nancy,0,17,32,32
1683711204829,HILD 7B,A02,185781,Kwak; Nancy,0,18,32,32
1683711205854,HILD 30,A01,185791,Staff,12,0,20,8
1683711206880,HISC 119,A00,185830,Golan; Tal,0,10,20,20
1683711207904,HITO 156GS,A00,185831,Patterson; Patrick H.,0,0,0,23
1683711208929,HIUS 103,A00,185832,Man; Simeon S,0,4,20,20
1683711209955,HIUS 117,A00,185836,Kwak; Nancy,2,0,20,18
1683711210980,HIUS 125,A00,185840,Man; Simeon S,0,2,23,23
1683711212005,HIUS 149,A00,185845,Staff,1,0,20,19
1683711213033,HUM 3,A01,185882,Zavodny; Tatiana Sophia,0,8,50,50
1683711213033,HUM 3,B01,185899,Caldwell; Michael Alan,0,18,50,50
1683711214059,HUM 3GS,A00,185900,Patterson; Patrick H.,0,0,0,23
1683711215098,HUM 4,A01,185938,Zroka; Amy Liane,28,0,50,22
1683711215098,HUM 4,B01,185956,Watkins; Eric,0,6,50,50
1683711215098,HUM 4,B02,202209,Watkins; Eric,0,5,50,50
1683711215098,HUM 4,B03,202210,Watkins; Eric,0,5,50,50
1683711216124,HUM 5,A01,185958,West; Geoffrey Scott,0,0,50,50
1683711216124,HUM 5,A02,202215,West; Geoffrey Scott,0,1,50,50
1683711217151,INTL 190,A00,185959,Gagnon; Jeffrey C,0,0,0,9
1683711217151,INTL 190,B00,185960,Lettieri; Michael Joseph,0,0,0,2
1683711218180,JAPN 180,A00,254509,Staff,5,0,30,25
1683711219212,LATI 10,A01,202853,Kennemore; Amy Michelle,4,0,35,31
1683711219212,LATI 10,A02,202854,Kennemore; Amy Michelle,3,0,35,32
1683711219212,LATI 10,A03,270054,Kennemore; Amy Michelle,30,0,30,0
1683711220237,LATI 180,A00,202855,Kennemore; Amy Michelle,11,0,20,9
1683711221265,LAWS 101,A00,201767,Golan; Tal,0,7,40,40
1683711222294,LIFR 1C,A00,185961,Staff,6,0,20,14
1683711223323,LIFR 1CX,A00,185962,Staff,7,0,20,13
1683711224349,LIFR 1D,A00,185963,Staff,7,0,20,13
1683711225374,LIFR 1DX,A00,185964,Staff,7,0,20,13
1683711226400,LIGN 101,A01,186039,Staff,43,0,50,7
1683711227430,LIGN 165,A00,186040,Staff,14,0,50,36
1683711228459,LTCS 108,A00,186041,Staff,5,0,10,5
1683711229484,LTCS 119,A00,186042,Staff,15,0,20,5
1683711230515,LTCS 130,A00,186043,Wesling; Megan E.,15,0,25,10
1683711232564,LTEA 138,A00,186119,Staff,14,0,40,26
1683711233594,LTEN 124,A00,186148,Staff,5,0,25,20
1683711234620,LTEN 178,A00,186149,Staff,6,0,15,9
1683711235646,LTEN 181,A00,186150,Blanco; John D,34,0,40,6
1683711236672,LTWL 120,A00,186160,Staff,19,0,25,6
1683711237697,LTWL 165,A00,186161,Staff,22,0,25,3
1683711238725,LTWR 100,A00,186162,Staff,0,5,15,15
1683711239755,LTWR 102,A00,186163,Doller; Ben,5,0,15,10
1683711240780,MAE 8,A01,186412,Staff,0,1,0,0
1683711241808,MAE 30B,A00,186445,Bahadori; Mohammad Yousef,81,0,100,19
1683711242833,MAE 40,A00,186592,Bewley; Thomas R,10,0,50,40
1683711243862,MAE 101B,A00,186593,Bahadori; Mohammad Yousef,80,0,100,20
1683711244892,MAE 105,A00,186594,Bandaru; Prabhakar,10,0,50,40
1683711245919,MAE 107,A00,186599,Pham; Hieu Tan,0,8,120,120
1683711246944,MAE 148,A01,186660,Silberman; Jack,3,0,16,13
1683711247970,MATH 10A,A01,188095,Staff,0,6,35,35
1683711249002,MATH 10B,A01,188097,Bowers; Adam R.,0,12,30,30
1683711249002,MATH 10B,A02,188099,Bowers; Adam R.,0,11,30,30
1683711249002,MATH 10B,B01,188104,Bowers; Adam R.,0,10,30,30
1683711249002,MATH 10B,B02,188106,Bowers; Adam R.,0,9,30,30
1683711250036,MATH 10C,A01,188111,Staff,0,20,30,30
1683711250036,MATH 10C,A02,188127,Staff,0,19,30,30
1683711250036,MATH 10C,A03,188131,Staff,0,19,30,30
1683711250036,MATH 10C,B01,188218,Staff,17,0,30,13
1683711250036,MATH 10C,B02,188244,Staff,13,0,30,17
1683711250036,MATH 10C,B03,188277,Staff,14,0,30,16
1683711251072,MATH 18,A01,188344,Bach; Quang Tran,18,0,30,12
1683711251072,MATH 18,A02,188345,Bach; Quang Tran,11,0,30,19
1683711251072,MATH 18,B01,188353,Bach; Quang Tran,11,0,30,19
1683711251072,MATH 18,B02,188354,Bach; Quang Tran,19,0,30,11
1683711252103,MATH 20A,A01,188374,Staff,11,0,35,24
1683711253129,MATH 20B,A01,188382,Ohm; Ko Woon,7,0,30,23
1683711253129,MATH 20B,A02,188383,Ohm; Ko Woon,22,0,30,8
1683711253129,MATH 20B,B01,188385,Ohm; Ko Woon,7,0,30,23
1683711253129,MATH 20B,B02,188392,Ohm; Ko Woon,22,0,30,8
1683711254163,MATH 20C,A01,188394,Harel; Guershon,10,0,30,20
1683711254163,MATH 20C,A02,188395,Harel; Guershon,13,0,30,17
1683711254163,MATH 20C,B01,188404,Harel; Guershon,5,0,30,25
1683711254163,MATH 20C,B02,188405,Harel; Guershon,18,0,30,12
1683711255197,MATH 20D,A01,188414,Hammock; Frances H,0,1,30,30
1683711255197,MATH 20D,A02,188415,Hammock; Frances H,0,1,30,30
1683711255197,MATH 20D,B01,188447,Hammock; Frances H,0,1,30,30
1683711255197,MATH 20D,B02,188486,Hammock; Frances H,2,0,30,28
1683711256239,MATH 20E,A01,188649,Staff,21,0,30,9
1683711256239,MATH 20E,A02,188650,Staff,20,0,30,10
1683711256239,MATH 20E,A03,188673,Staff,0,0,30,30
1683711257264,MATH 102,A01,188675,Staff,0,40,35,35
1683711258290,MATH 103B,A01,188681,Staff,3,0,35,32
1683711258290,MATH 103B,B01,188692,Staff,5,0,35,30
1683711259316,MATH 109,A01,188695,Salehi Golsefidy; Alireza,24,0,35,11
1683711259316,MATH 109,A02,188696,Salehi Golsefidy; Alireza,25,0,35,10
1683711260351,MATH 120A,A01,188698,Eggers; John Dietrich,7,0,35,28
1683711261378,MATH 142B,A01,188736,Ioana; Adrian,0,0,30,30
1683711261378,MATH 142B,A02,188741,Ioana; Adrian,0,1,30,30
1683711261378,MATH 142B,A03,188743,Ioana; Adrian,0,2,30,30
1683711262402,MATH 168A,A01,188790,Staff,0,11,35,35
1683711263432,MATH 170A,A01,188803,Nie; Jiawang,0,2,35,35
1683711263432,MATH 170A,A02,188811,Nie; Jiawang,0,1,35,35
1683711263432,MATH 170A,A03,188814,Nie; Jiawang,1,0,35,34
1683711263432,MATH 170A,A04,188815,Nie; Jiawang,5,0,35,30
1683711264456,MATH 193B,A01,188817,Staff,0,0,35,35
1683711264456,MATH 193B,A02,188818,Staff,6,0,35,29
1683711265484,MGT 4,A01,202857,Anderson; John Charles,59,0,80,21
1683711266511,MGT 12,A00,202858,Lindenberger; Wade Douglas,40,0,90,50
1683711267537,MGT 18,A00,202859,Staff,73,0,90,17
1683711268567,MGT 18GS,A00,202860,McKay; Michael J,13,0,28,15
1683711269596,MGT 45,A00,202861,Pecore; Joseph P.,8,0,90,82
1683711270622,MGT 100,A00,202863,Yavorsky; Daniel Ryan,27,0,90,63
1683711271651,MGT 103,A00,202864,Ehrich; Kristine R,0,19,90,90
1683711272683,MGT 112,A00,202865,Ehrich; Kristine R,15,0,90,75
1683711273716,MGT 121A,A00,202868,Staff,70,0,90,20
1683711274741,MGT 131B,A00,202869,Anderson; John Charles,58,0,90,32
1683711275770,MGT 136,A00,202871,Lindenberger; Wade Douglas,83,0,90,7
1683711276801,MGT 164,A00,202873,Staff,0,67,90,91
1683711277826,MGT 164GS,A00,202874,McKay; Mary A,13,0,28,15
1683711278850,MGT 180,A00,202875,Staff,0,51,90,91
1683711279879,MMW 11R,A01,205019,Herbst; Matthew,0,0,30,30
1683711279879,MMW 11R,A02,205026,Herbst; Matthew,29,0,30,1
1683711280914,MMW 15,A01,193512,Chang; Edmond Yi-Teh,0,8,28,28
1683711280914,MMW 15,A02,193513,Chang; Edmond Yi-Teh,0,5,28,28
1683711280914,MMW 15,A03,193514,Chang; Edmond Yi-Teh,0,5,28,28
1683711280914,MMW 15,A04,193515,Chang; Edmond Yi-Teh,0,5,28,28
1683711280914,MMW 15,A05,193516,Chang; Edmond Yi-Teh,0,5,28,28
1683711280914,MMW 15,A06,193517,Chang; Edmond Yi-Teh,0,6,28,28
1683711280914,MMW 15,B01,193519,Chang; Edmond Yi-Teh,0,5,28,28
1683711280914,MMW 15,B02,193520,Chang; Edmond Yi-Teh,0,5,28,28
1683711280914,MMW 15,B03,193521,Chang; Edmond Yi-Teh,0,5,28,28
1683711280914,MMW 15,B04,193522,Chang; Edmond Yi-Teh,0,6,28,28
1683711280914,MMW 15,B05,193523,Chang; Edmond Yi-Teh,0,5,28,28
1683711280914,MMW 15,B06,193524,Chang; Edmond Yi-Teh,0,5,28,28
1683711281947,MMW 122,A01,193526,Rahimi; Babak,0,16,28,28
1683711281947,MMW 122,A02,193527,Rahimi; Babak,0,15,28,28
1683711281947,MMW 122,A03,193528,Rahimi; Babak,0,0,0,0
1683711281947,MMW 122,A04,193529,Rahimi; Babak,0,0,0,0
1683711283031,MUS 1A,A01,186663,Staff,0,18,35,35
1683711284058,MUS 4,A01,186715,Staff,0,12,35,35
1683711285084,MUS 5R,A01,186796,Dubnov; Shlomo,0,17,35,35
1683711286111,MUS 6,A01,186798,Staff,0,4,25,25
1683711287152,MUS 7,A01,186830,Staff,11,0,35,24
1683711288183,MUS 8,A01,186930,Staff,0,27,35,35
1683711289208,MUS 15,A01,186932,Staff,0,15,35,35
1683711289208,MUS 15,B01,186934,Staff,0,16,35,35
1683711290239,MUS 80,A00,186935,Staff,0,0,20,20
1683711290239,MUS 80,B00,186936,Staff,24,0,25,1
1683711291271,NANO 11,A00,204702,Lipomi; Darren John,0,0,0,0
1683711292300,NANO 15,A01,204709,Yang; Kesong,0,1,0,0
1683711293327,NANO 114,A00,202069,Jahed Motlagh; Zeinab,2,0,10,8
1683711294360,PHIL 1,A00,186955,Grush; Rick Scott,31,0,40,9
1683711295385,PHIL 10,A01,186973,Grush; Rick Scott,27,0,35,8
1683711295385,PHIL 10,A02,186974,Grush; Rick Scott,33,0,35,2
1683711296411,PHIL 13,A01,186976,Staff,1,0,35,34
1683711296411,PHIL 13,A02,186977,Staff,16,0,35,19
1683711297440,PHIL 14,A01,186979,Staff,30,0,35,5
1683711297440,PHIL 14,A02,186986,Staff,32,0,35,3
1683711298470,PHIL 28,A01,186988,Staff,16,0,30,14
1683711298470,PHIL 28,A02,186989,Staff,0,0,30,30
1683711298470,PHIL 28,A03,186990,Staff,10,0,30,20
1683711298470,PHIL 28,A04,186991,Staff,26,0,30,4
1683711299499,PHIL 120,A00,186997,Staff,23,0,40,17
1683711300525,PHIL 137,A00,187003,Staff,8,0,40,32
1683711301552,PHIL 150,A00,187015,Staff,47,0,70,23
1683711302598,PHIL 167,A00,187021,Lamey; Andy M.,34,0,40,6
1683711303626,PHIL 174,A01,202226,Staff,17,0,20,3
1683711303626,PHIL 174,A02,202235,Staff,20,0,20,0
1683711304656,PHIL 191A,A00,258918,Staff,0,0,1,1
1683711305682,PHYS 1A,A00,187028,Staff,26,0,60,34
1683711306713,PHYS 1AL,001,187036,Staff,3,0,30,27
1683711306713,PHYS 1AL,002,187049,Staff,18,0,30,12
1683711307737,PHYS 1B,A00,187058,Staff,21,0,60,39
1683711308762,PHYS 1BL,001,187064,Staff,0,1,30,30
1683711308762,PHYS 1BL,002,187070,Staff,4,0,30,26
1683711309788,PHYS 1C,A00,187082,Staff,30,0,120,90
1683711310836,PHYS 1CL,001,187088,Staff,0,9,30,30
1683711310836,PHYS 1CL,002,187089,Staff,0,1,30,30
1683711310836,PHYS 1CL,009,262693,Staff,9,0,30,21
1683711311866,PHYS 2B,A01,187097,Staff,55,0,115,60
1683711312894,PHYS 2C,A01,187099,Staff,63,0,115,52
1683711313920,PHYS 2CL,A01,187101,Staff,5,0,28,23
1683711313920,PHYS 2CL,A02,187102,Staff,15,0,28,13
1683711314948,PHYS 2D,A01,187123,Shotwell; Brian,95,0,115,20
1683711315980,PHYS 4B,A01,187133,Grinstein; Benjamin,35,0,50,15
1683711317009,POLI 10,A00,188819,Staff,0,4,50,50
1683711318032,POLI 11,A00,188827,Staff,43,0,50,7
1683711319061,POLI 13R,A00,188828,Staff,0,1,20,20
1683711320087,POLI 27,A01,188830,Elgin; Samuel Zincke,0,2,70,70
1683711321118,POLI 30,A00,188832,Desposato; Scott,30,0,50,20
1683711322146,POLI 102F,A00,188834,Staff,1,0,40,39
1683711323178,POLI 104A,A00,188852,Staff,12,0,30,18
1683711324212,POLI 104I,A00,188853,Staff,0,8,20,20
1683711325243,POLI 110B,A00,188854,Wiens; David,6,0,20,14
1683711326269,POLI 112A,A00,188855,Wiens; David,3,0,30,27
1683711327296,POLI 117R,A00,188856,Forman; Fonna,0,12,20,20
1683711328324,POLI 118,A00,188857,Ingham; Sean,8,0,20,12
1683711329353,POLI 120G,A00,188858,Staff,7,0,30,23
1683711330380,POLI 131CR,A00,188863,Hoston; Germaine,20,0,50,30
1683711331410,POLI 133,A00,188864,Nellis; Gareth Hb,44,0,50,6
1683711332438,POLI 134D,A00,188865,Desposato; Scott,27,0,30,3
1683711333470,POLI 142A,A00,188871,Gartzke; Erik,21,0,50,29
1683711334495,POLI 142K,A00,188874,Staff,38,0,50,12
1683711335520,POLI 143,A00,188940,Gartzke; Erik,15,0,30,15
1683711336546,POLI 153,A00,188943,Staff,1,0,20,19
1683711337575,POLI 160AA,A00,188944,Staff,10,0,40,30
1683711338599,POLI 170A,A00,188945,Staff,10,0,30,20
1683711340655,PSYC 1,A00,188952,Staff,36,0,90,54
1683711341682,PSYC 2,B00,188953,Staff,19,0,35,16
1683711342708,PSYC 6,A00,188970,Staff,47,0,60,13
1683711343737,PSYC 7,A00,188973,Staff,35,0,45,10
1683711344764,PSYC 60,A01,188980,Rickard; Timothy C.,42,0,60,18
1683711345791,PSYC 70,A01,189001,Steiner; Eric Tomas,22,0,45,23
1683711346817,PSYC 100,A00,189005,Lacefield; Katharine I,1,98,120,119
1683711347842,PSYC 102,A00,189008,Staff,6,0,30,24
1683711348868,PSYC 106,B00,189026,Gorman; Michael R.,27,0,60,33
1683711349894,PSYC 114,B01,189033,Winkielman; Piotr,0,31,30,30
1683711350919,PSYC 131,A00,189036,Anagnostaras; Stephan,0,44,60,60
1683711351945,PSYC 136,A00,189041,Lowe; Angela Beth,0,7,25,25
1683711352974,PSYC 137,A00,189057,Winkielman; Piotr,0,36,25,25
1683711354006,PSYC 144,A00,189107,Wixted; John T,0,11,50,50
1683711356059,PSYC 162,A00,189142,Staff,0,9,85,85
1683711357085,PSYC 172,A00,189144,Gorman; Michael R.,0,6,30,30
1683711359145,PSYC 179,A00,189146,Lacefield; Katharine I,0,88,120,120
1683711360172,PSYC 181,A00,189147,Anagnostaras; Stephan,0,45,90,90
1683711361198,PSYC 190R,A00,189148,Barner; David A.,0,23,80,80
1683711362223,PSYC 191,A00,189275,Rickard; Timothy C.,0,11,25,25
1683711363250,PSYC 193,A00,189276,Chapman; Eddie Nathaniel,0,1,0,4
1683711364274,PSYC 193L,A01,189281,Lowe; Angela Beth,8,0,20,12
1683711364274,PSYC 193L,B01,189285,Staff,28,0,35,7
1683711365302,RELI 149,A00,187137,Rahimi; Babak,6,0,40,34
1683711366329,SE 9,A01,187315,Staff,0,2,18,18
1683711367371,SE 101B,A00,187409,Staff,24,0,30,6
1683711368402,SE 110B,A00,187444,Staff,10,0,40,30
1683711369428,SE 130B,A00,187449,Staff,31,0,40,9
1683711370453,SE 150A,A00,187516,Staff,8,0,20,12
1683711371479,SE 154,A00,187528,Staff,29,0,50,21
1683711372514,SIO 3,A01,258171,Staff,35,0,40,5
1683711373544,SIO 10,A00,187144,Cook; Geoffrey W,0,6,75,75
1683711374569,SIO 45,A00,187152,Cook; Geoffrey W,1,7,100,99
1683711375596,SIO 109R,A00,194486,Staff,0,4,20,20
1683711377654,SIO 187,A01,187233,Kacev; David,12,0,40,28
1683711378682,SOCI 1,A01,258656,Thorpe; Charles Robert,28,0,30,2
1683711378682,SOCI 1,A02,258658,Thorpe; Charles Robert,30,0,30,0
1683711378682,SOCI 1,A03,258661,Thorpe; Charles Robert,25,0,25,0
1683711378682,SOCI 1,A04,258666,Thorpe; Charles Robert,22,0,25,3
1683711378682,SOCI 1,A05,258897,Thorpe; Charles Robert,22,0,25,3
1683711378682,SOCI 1,A06,258898,Thorpe; Charles Robert,25,0,25,0
1683711379721,SOCI 30,A01,258903,Pardo Guerra; Juan Pablo,14,0,30,16
1683711380753,SOCI 102,A00,258904,Staff,9,0,25,16
1683711381784,SOCI 106,A00,258905,Staff,19,0,25,6
1683711382813,SOCI 111,A00,258907,Ribas Norris; Janet Vanesa,26,0,30,4
1683711383839,SOCI 121R,A00,258908,Pardo Guerra; Juan Pablo,7,0,30,23
1683711384866,SOCI 126,A01,203330,Staff,14,0,20,6
1683711385894,SOCI 131,A00,258909,Thorpe; Charles Robert,30,0,60,30
1683711386979,SOCI 135,A00,258910,Payne; Christine Anna,0,13,30,30
1683711388004,SOCI 157,A00,258911,Staff,10,0,30,20
1683711389030,SOCI 184,A00,258912,Staff,25,0,30,5
1683711390053,SOCI 188D,A00,258913,Staff,22,0,30,8
1683711391087,SYN 2,001,187529,Staff,9,0,16,7
1683711391087,SYN 2,002,201452,Staff,0,20,16,16
1683711391087,SYN 2,003,201469,Staff,1,0,16,15
1683711392116,SYN 100,A01,187531,Staff,0,9,20,20
1683711392116,SYN 100,B01,201491,Staff,0,10,20,20
1683711393144,TDAC 1,A00,189286,Walsh; Kim C.,3,0,20,17
1683711393144,TDAC 1,B00,189287,Harting; Carla Kelso,10,0,20,10
1683711394174,TDAC 101,A00,189300,Walsh; Kim C.,16,0,20,4
1683711394174,TDAC 101,B00,189301,Harting; Carla Kelso,18,0,20,2
1683711395201,TDAC 102,A00,189304,Basso; Beatrice,14,0,20,6
1683711396226,TDAC 108,A00,189305,Staff,18,0,20,2
1683711397260,TDDE 131,A00,189310,Staff,19,0,20,1
1683711397260,TDDE 131,B00,189314,Staff,19,0,20,1
1683711397260,TDDE 131,C00,189315,Staff,48,0,50,2
1683711397260,TDDE 131,D00,189316,Staff,14,0,15,1
1683711397260,TDDE 131,E00,204841,Staff,20,0,20,0
1683711398287,TDGE 10,A00,189289,Staff,27,0,50,23
1683711398287,TDGE 10,B00,189290,Havis; Allan,0,1,50,50
1683711399315,TDGE 11,A00,189291,Fulton; Julia,0,4,50,50
1683711399315,TDGE 11,B00,189292,Staff,20,0,25,5
1683711399315,TDGE 11,C00,260270,Staff,0,0,0,0
1683711400341,TDGE 25,A00,189294,Staff,1,0,20,19
1683711401366,TDGE 124,A00,189318,Fulton; Julia,0,7,50,50
1683711402399,TDGE 125,A00,189319,Staff,13,0,25,12
1683711402399,TDGE 125,B00,189320,Staff,23,0,25,2
1683711403423,TDGE 127,A00,189322,Havis; Allan,1,0,50,49
1683711404453,TDHT 101,A00,189323,Staff,18,0,25,7
1683711404453,TDHT 101,B00,189324,Staff,25,0,25,0
1683711405479,TDHT 102,A00,189325,Staff,49,0,50,1
1683711406511,TDMV 1,A00,189295,Arcidiacono; Kristin,20,0,30,10
1683711406511,TDMV 1,B00,189296,Caligagan; Maria T.,23,0,30,7
1683711407538,TDMV 2,A00,189297,Sammartano; Tonnie,27,0,30,3
1683711407538,TDMV 2,B00,189299,Arcidiacono; Kristin,23,0,30,7
1683711408572,TDMV 3,A00,204998,Rincon; Alicia,22,0,30,8
1683711409600,TDMV 120,A00,189458,Sammartano; Tonnie,28,0,30,2
1683711410628,TDMV 138,A00,189541,Jun; Grace Shin Hae,20,0,40,20
1683711411655,TDMV 142,A00,189717,Caligagan; Tony,25,0,30,5
1683711411655,TDMV 142,B00,189718,Caligagan; Maria T.,25,0,30,5
1683711412695,TMC 2,A01,187533,Staff,25,0,25,0
1683711412695,TMC 2,A02,187534,Staff,25,0,25,0
1683711413725,USP 1,A01,187536,Kwak; Nancy,0,16,25,25
1683711414754,USP 5,A01,187538,Staff,8,0,25,17
1683711415781,USP 101,A00,199253,Staff,0,4,0,0
1683711416812,USP 124,A00,187562,Boomhower; Matthew Charles,0,0,30,30
1683711417838,USP 138,A00,187582,Staff,19,0,25,6
1683711418865,USP 152,A01,187597,Staff,3,0,25,22
1683711419891,USP 153,A00,187598,Staff,18,0,25,7
1683711420918,USP 168,A00,187607,Kwak; Nancy,2,0,5,3
1683711421946,USP 173,A00,187619,Staff,4,0,25,21
1683711422983,USP 181,A00,187638,Staff,0,4,25,25
1683711424018,VIS 103,A00,187650,Cruz; Edwin Teddy,17,0,75,58
1683711425048,VIS 110D,A00,187669,Staff,13,0,22,9
1683711426076,VIS 127C,A00,187720,Shen; Kuiyi,67,0,146,79
1683711427104,VIS 149,A00,187731,Yoldas; Pinar,0,12,22,22
1683711428129,VIS 151,A01,188091,Staff,22,0,34,12
1683711428129,VIS 151,A02,188092,Staff,11,0,34,23
1683711429154,VIS 160B,A00,188093,Stalbaum; Brett,0,1,10,10
1683711431219,WCWP 10B,A00,201720,Staff,0,0,5,5
1683711431219,WCWP 10B,B00,201722,Staff,0,0,6,6
1683711432252,WCWP 100,A00,201725,Gagnon; Jeffrey C,0,0,2,2
1683711432252,WCWP 100,B00,201727,Staff,0,4,15,15
1683711435494,ANBI 133,A00,258401,Wilder; Linnea Lorene,34,0,40,6
1683711436520,ANBI 140,A00,258395,Hrvoj Mihic; Branka,18,0,25,7
1683711437552,ANSC 120,A00,258402,Bialecki; Jon Anthony,26,0,40,14
1683711438583,ANSC 144,A00,258400,Staff,12,0,40,28
1683711440635,ANSC 166,A00,258396,Parish; Steven Martin,156,0,175,19
1683711441660,ANSC 180,A00,193533,Staff,8,0,20,12
1683711442687,ANSC 188,A00,258397,Jassal; Aftab,34,0,40,6
1683711443712,ANTH 3,A01,258316,Staff,23,0,30,7
1683711444738,ANTH 5,A00,258394,Semendeferi; Ekaterini,16,0,20,4
1683711445766,ANTH 21,A01,258331,Staff,4,0,40,36
1683711446792,ANTH 103,A00,258398,Varma; Saiba,15,0,25,10
1683711447823,AWP 10,001,202034,Staff,0,0,0,0
1683711447823,AWP 10,002,202035,Staff,0,0,0,0
1683711447823,AWP 10,003,202036,Staff,0,0,0,0
1683711447823,AWP 10,004,202037,Staff,0,0,0,0
1683711447823,AWP 10,005,202038,Staff,0,0,0,0
1683711447823,AWP 10,006,202039,Staff,0,0,0,0
1683711447823,AWP 10,007,202040,Staff,0,0,0,0
1683711447823,AWP 10,008,202041,Staff,0,0,0,0
1683711447823,AWP 10,009,202042,Staff,0,0,0,0
1683711447823,AWP 10,010,202043,Staff,0,0,0,0
1683711447823,AWP 10,011,202044,Staff,0,0,0,0
1683711447823,AWP 10,012,202045,Staff,0,0,0,0
1683711447823,AWP 10,013,202046,Staff,0,0,0,0
1683711447823,AWP 10,014,202047,Staff,0,0,0,0
1683711447823,AWP 10,015,202048,Staff,0,0,0,0
1683711447823,AWP 10,016,202049,Staff,0,0,0,0
1683711447823,AWP 10,017,202050,Staff,0,0,0,0
1683711447823,AWP 10,018,202051,Staff,0,0,0,0
1683711447823,AWP 10,019,202052,Staff,0,0,0,0
1683711447823,AWP 10,020,202053,Staff,0,0,0,0
1683711447823,AWP 10,021,202054,Staff,0,0,0,0
1683711447823,AWP 10,022,202055,Staff,0,0,0,0
1683711447823,AWP 10,023,202056,Staff,0,0,0,0
1683711447823,AWP 10,024,202057,Staff,0,0,0,0
1683711447823,AWP 10,025,202058,Staff,0,0,0,0
1683711447823,AWP 10,026,202059,Staff,0,0,0,0
1683711448849,AWP 102,001,202032,Staff,0,0,0,0
1683711448849,AWP 102,002,202033,Staff,0,0,0,0
1683711449875,BENG 100,A01,254234,Taylor Amos; Alyssa C,31,0,40,9
1683711450902,BENG 196,001,270013,Engler; Adam J.,9999,0,9999,0
1683711451938,BICD 100R,A01,202018,Smith; Laurie,0,7,32,32
1683711451938,BICD 100R,A02,202019,Smith; Laurie,0,3,32,32
1683711451938,BICD 100R,A03,202020,Smith; Laurie,0,1,32,32
1683711451938,BICD 100R,A04,202021,Smith; Laurie,6,0,32,26
1683711451938,BICD 100R,A05,202022,Smith; Laurie,10,0,32,22
1683711452967,BICD 136,A01,193242,Gustafson-Brown; Cindy,0,2,32,32
1683711452967,BICD 136,A02,193244,Gustafson-Brown; Cindy,13,0,32,19
1683711453995,BIEB 102,A01,193249,Butler; Shannon Rhey,0,0,32,32
1683711453995,BIEB 102,A02,193251,Butler; Shannon Rhey,0,0,32,32
1683711453995,BIEB 102,A03,193253,Butler; Shannon Rhey,0,0,32,32
1683711453995,BIEB 102,A04,193255,Butler; Shannon Rhey,13,0,32,19
1683711453995,BIEB 102,A05,193265,Butler; Shannon Rhey,25,0,32,7
1683711453995,BIEB 102,A06,193269,Butler; Shannon Rhey,12,0,32,20
1683711456049,BIEB 150,A01,193274,Staff,0,0,32,32
1683711456049,BIEB 150,A02,193285,Staff,24,0,32,8
1683711457075,BIEB 194,A00,193286,Kurle; Carolyn M.,19,0,32,13
1683711458104,BILD 1,A01,192291,Staff,15,0,32,17
1683711458104,BILD 1,A02,192292,Staff,30,0,32,2
1683711458104,BILD 1,B01,192520,Reuther; Keefe,0,1,0,0
1683711458104,BILD 1,B02,192532,Reuther; Keefe,0,1,0,0
1683711459138,BILD 3,A01,192556,Butler; Shannon Rhey,0,0,32,32
1683711459138,BILD 3,A02,192581,Butler; Shannon Rhey,0,1,32,32
1683711459138,BILD 3,A03,192611,Butler; Shannon Rhey,19,0,32,13
1683711459138,BILD 3,A04,192612,Butler; Shannon Rhey,23,0,32,9
1683711459138,BILD 3,A05,192613,Butler; Shannon Rhey,26,0,32,6
1683711459138,BILD 3,A06,192679,Butler; Shannon Rhey,27,0,32,5
1683711459138,BILD 3,A07,192682,Butler; Shannon Rhey,20,0,32,12
1683711460171,BILD 4,A01,192836,Reuther; Keefe,1,0,24,23
1683711460171,BILD 4,A02,193044,Reuther; Keefe,4,0,24,20
1683711461195,BILD 10,A01,193142,Gustafson-Brown; Cindy,29,0,32,3
1683711461195,BILD 10,A02,193149,Gustafson-Brown; Cindy,31,0,32,1
1683711462228,BIMM 100,A01,193301,Staff,0,6,32,32
1683711462228,BIMM 100,A02,193312,Staff,0,7,32,32
1683711462228,BIMM 100,A03,193323,Staff,0,10,32,32
1683711463262,BIMM 101,A01,193329,McDonnell; Lisa Marie,0,3,24,24
1683711463262,BIMM 101,A02,193339,McDonnell; Lisa Marie,0,3,24,24
1683711463262,BIMM 101,B01,193354,McDonnell; Lisa Marie,0,4,24,24
1683711463262,BIMM 101,B02,193357,McDonnell; Lisa Marie,0,3,24,24
1683711464294,BIMM 110,A01,193377,Tat; John,0,11,32,32
1683711464294,BIMM 110,A02,193378,Tat; John,0,11,32,32
1683711465327,BIMM 120,A01,206116,Staff,0,0,32,32
1683711465327,BIMM 120,A02,206117,Staff,7,0,32,25
1683711465327,BIMM 120,A03,206121,Staff,21,0,32,11
1683711466362,BIPN 100,A01,193393,Park; Ji Young,0,15,32,32
1683711466362,BIPN 100,A02,193402,Park; Ji Young,0,14,32,32
1683711466362,BIPN 100,A03,193413,Park; Ji Young,0,14,32,32
1683711466362,BIPN 100,A04,193414,Park; Ji Young,0,13,32,32
1683711467387,BIPN 102,A01,193429,Staff,0,0,32,32
1683711467387,BIPN 102,A02,193438,Staff,18,0,32,14
1683711468417,BIPN 106,A01,193450,Reyes Gonzalez; Catalina,0,2,40,40
1683711469443,BIPN 134,A01,193465,Cooke; James Edward,0,0,32,32
1683711469443,BIPN 134,A02,193474,Cooke; James Edward,25,0,32,7
1683711469443,BIPN 134,A03,193485,Cooke; James Edward,29,0,32,3
1683711469443,BIPN 134,A04,193486,Cooke; James Edward,20,0,32,12
1683711469443,BIPN 134,A05,193491,Cooke; James Edward,31,0,32,1
1683711469443,BIPN 134,A06,193501,Cooke; James Edward,30,0,32,2
1683711469443,BIPN 134,A07,193510,Cooke; James Edward,29,0,32,3
1683711471496,BISP 194,A00,222522,Staff,14,0,32,18
1683711472521,CAT 124,A01,202407,Staff,19,0,25,6
1683711473548,CAT 125,A00,202408,Marchisotto; Jennifer Anne,2,0,20,18
1683711474579,CAT 125R,A00,202409,Smith; Lauryn Alissa,0,11,20,20
1683711474579,CAT 125R,B00,202410,Morales; Celeste Georgianna,0,11,20,20
1683711474579,CAT 125R,C00,202411,Irwin; Matthew Joseph,0,12,20,20
1683711475615,CENG 15,A01,204712,Yang; Kesong,0,1,0,0
1683711476641,CENG 114,A00,202070,Jahed Motlagh; Zeinab,5,0,20,15
1683711477667,CGS 105,A00,185477,Wesling; Megan E.,24,0,40,16
1683711478693,CGS 106,A00,185494,Staff,11,0,22,11
1683711479721,CGS 108,A00,185495,Staff,14,0,20,6
1683711480750,CGS 114,A00,185496,Staff,13,0,18,5
1683711481774,CGS 119,A00,185501,Staff,15,0,20,5
1683711482803,CGS 120,A00,185511,Staff,11,0,20,9
1683711483837,CHEM 4,A01,184675,Bussey; Thomas J,97,0,100,3
1683711484867,CHEM 6A,A01,184677,Staff,32,0,60,28
1683711485892,CHEM 6B,A01,184679,Staff,63,0,100,37
1683711486917,CHEM 6C,A01,184681,Bussey; Thomas J,0,0,50,50
1683711486917,CHEM 6C,A02,184682,Bussey; Thomas J,32,0,50,18
1683711487943,CHEM 40A,A01,184684,Albizati; Kim F.,33,0,100,67
1683711488968,CHEM 40B,A01,184686,Albizati; Kim F.,0,22,100,100
1683711489997,CHEM 41B,A01,184690,Staff,51,0,100,49
1683711491079,COGS 3,A01,184715,Boyle; Mary E. T.,0,27,40,40
1683711492108,COGS 14B,A01,185172,Staff,0,14,38,38
1683711493133,COGS 18,A01,184736,Staff,14,0,80,66
1683711494160,COGS 100,A01,184932,Staff,0,8,73,73
1683711495189,COGS 101A,A01,184935,Staff,0,40,30,30
1683711496214,COGS 101B,A01,184944,Staff,0,2,30,30
1683711497240,COGS 101C,A01,184946,Staff,0,10,30,30
1683711498266,COGS 102A,A01,184951,Johnson; Christine M.,1,0,40,39
1683711499297,COGS 107B,A01,184953,Mooshagian; Eric Frederick,0,52,40,40
1683711500323,COGS 118B,A01,184959,Gupta; Anjum,0,50,40,40
1683711501349,COGS 153,A00,184961,Staff,1,16,30,29
1683711502380,COGS 177,A00,184962,Staff,0,20,30,30
1683711503406,COGS 187A,A01,184969,Boyle; Mary E. T.,0,19,40,40
1683711504440,COMM 10,A01,185174,Staff,0,5,25,25
1683711504440,COMM 10,A02,185189,Staff,0,2,25,25
1683711504440,COMM 10,A03,269821,Staff,0,1,0,0
1683711505469,COMM 100B,A02,185476,Staff,10,0,25,15
1683711505469,COMM 100B,A03,277340,Staff,25,0,25,0
1683711506495,COMM 100C,A01,185314,Staff,2,0,25,23
1683711506495,COMM 100C,A02,185327,Staff,17,0,25,8
1683711507520,COMM 110M,A00,185349,Staff,0,0,40,40
1683711508546,COMM 113T,A00,185352,Staff,25,0,40,15
1683711509571,COMM 114I,A00,185353,Staff,31,0,40,9
1683711510599,COMM 131,A00,185354,Staff,17,0,30,13
1683711511632,CSE 8A,A50,185358,Cao; Yingjun,0,46,10,10
1683711512664,CSE 8B,A01,185362,Staff,0,48,50,50
1683711513710,CSE 11,A01,185416,Cao; Yingjun,0,91,10,10
1683711514743,CSE 20,A01,185445,Briones; Jor-el Thomas Caparas,3,0,25,22
1683711515772,CSE 21,A01,185447,Staff,9,0,50,41
1683711516798,CSE 101,A01,185451,Staff,0,13,50,50
1683711516798,CSE 101,B01,185453,Jones; Miles E,0,15,50,50
1683711518853,CSE 141,A01,185458,Eldon; John,16,0,100,84
1683711519878,CSE 141L,A01,185461,Eldon; John,8,0,100,92
1683711520904,CSE 142,A01,185463,Staff,34,0,60,26
1683711520904,CSE 142,B01,201355,Staff,0,7,60,60
1683711521928,CSE 142L,A01,185470,Staff,34,0,60,26
1683711521928,CSE 142L,B01,201417,Staff,0,6,60,60
1683711522956,CSE 190,A00,201433,Staff,32,0,49,17
1683711523988,DOC 1,A01,259136,Strom; Megan C.,7,0,15,8
1683711523988,DOC 1,A02,259137,Strom; Megan C.,15,0,15,0
1683711523988,DOC 1,A03,259138,Strom; Megan C.,14,0,15,1
1683711523988,DOC 1,A04,259139,Strom; Megan C.,13,0,15,2
1683711525013,DOC 100D,A00,259140,Pass; Natalye Joann,14,0,25,11
1683711526043,DSGN 1,A01,184749,Rill; Bryan,0,26,30,30
1683711527070,DSGN 100,A01,185168,Staff,0,2,25,25
1683711528101,ECE 5,A01,185626,Morris; Karcher William,0,12,0,0
1683711529125,ECE 101,A01,185628,Staff,14,0,70,56
1683711530150,ECE 107,A01,185635,Baghdadchi; Saharnaz,0,0,20,20
1683711530150,ECE 107,A02,185638,Baghdadchi; Saharnaz,1,0,20,19
1683711531177,ECE 148,A01,185647,Silberman; Jack,0,0,16,16
1683711532205,ECON 1,A01,185537,Crane; Meredith Helen,54,0,70,16
1683711533229,ECON 3,A01,185549,Crane; Meredith Helen,30,0,70,40
1683711534256,ECON 4,A01,203354,Anderson; John Charles,0,5,10,10
1683711535284,ECON 100A,A01,185574,Staff,0,5,40,40
1683711536309,ECON 100B,A01,185576,Staff,0,12,50,50
1683711537333,ECON 100C,A01,185589,Newhouse; Herbert S,30,0,70,40
1683711538363,ECON 105,A00,185608,Vespa; Emanuel Ignacio,19,0,35,16
1683711539394,ECON 109,A01,185610,Shishkin; Denis,9,0,35,26
1683711540424,ECON 110A,A01,185612,Staff,8,0,40,32
1683711541457,ECON 120A,A01,185615,Staff,19,0,40,21
1683711542490,ECON 120C,A01,185617,Sun; Yixiao,0,21,70,70
1683711543516,ECON 144,A00,203346,Squires; Dale E,2,0,35,33
1683711544544,ECON 171,A01,203349,Newhouse; Herbert S,0,1,35,35
1683711545569,ECON 173A,A01,185621,Toda; Alexis Akira,21,0,35,14
1683711546609,EDS 25,A01,202413,Staff,0,1,0,0
1683711546609,EDS 25,A02,202414,Staff,0,1,0,0
1683711546609,EDS 25,A03,202415,Staff,0,0,0,0
1683711546609,EDS 25,A04,202416,Staff,0,1,0,0
1683711546609,EDS 25,A05,202439,Staff,0,0,0,0
1683711546609,EDS 25,A06,202440,Staff,0,0,0,0
1683711546609,EDS 25,B01,202631,Staff,0,0,0,0
1683711546609,EDS 25,B02,202632,Staff,0,0,0,0
1683711546609,EDS 25,B03,202639,Staff,0,0,0,0
1683711546609,EDS 25,B04,202640,Staff,0,0,0,0
1683711546609,EDS 25,B05,202643,Staff,0,0,0,0
1683711546609,EDS 25,B06,202644,Staff,0,0,0,0
1683711547640,EDS 38,A01,202659,Black; Alison Michelle,25,0,25,0
1683711548665,EDS 115,A00,202652,Staff,18,0,30,12
1683711549695,EDS 125,A00,202649,Staff,13,0,30,17
1683711550720,EDS 126,A01,203332,Staff,30,0,30,0
1683711551749,EDS 139,A00,202838,Staff,16,0,25,9
1683711552775,EDS 146,A01,202655,Staff,14,0,25,11
1683711553801,ENG 15,A00,185667,Staff,0,1,0,0
1683711553801,ENG 15,B00,185672,Staff,0,0,0,0
1683711553801,ENG 15,C00,185675,Staff,0,0,0,0
1683711553801,ENG 15,D00,185682,Staff,0,0,0,0
1683711553801,ENG 15,E00,185684,Staff,0,0,0,0
1683711554830,ETHN 103,A00,185710,Staff,0,8,35,35
1683711555856,ETHN 103A,A00,199228,Man; Simeon S,0,0,9,9
1683711556881,ETHN 109,A00,185711,Staff,15,0,35,20
1683711557910,ETHN 142,A00,185726,Staff,0,4,30,30
1683711558935,ETHN 163J,A00,199229,Man; Simeon S,5,0,8,3
1683711559959,ETHN 168,A00,185727,Staff,7,0,10,3
1683711560986,ETHN 182,A00,185728,Staff,0,0,35,35
1683711562010,ETHN 183,A00,185737,Staff,9,0,18,9
1683711563035,GLBH 111,A01,209361,Burgos; Jose L.,0,0,0,0
1683711565089,HIEU 104,A00,185792,Staff,14,0,20,6
1683711566115,HIEU 115,A00,185800,Staff,0,0,20,20
1683711567143,HIEU 128,A00,185801,Staff,0,9,20,20
1683711568167,HIEU 147,A00,185802,Staff,15,0,20,5
1683711569197,HIEU 154,A00,185823,Staff,11,0,20,9
1683711570224,HILA 102,A00,185826,Staff,14,0,20,6
1683711571251,HILD 2C,A01,185778,Staff,0,13,20,20
1683711572277,HILD 7B,A01,185780,Kwak; Nancy,0,17,32,32
1683711572277,HILD 7B,A02,185781,Kwak; Nancy,0,18,32,32
1683711573303,HILD 30,A01,185791,Staff,12,0,20,8
1683711574328,HISC 119,A00,185830,Golan; Tal,0,10,20,20
1683711575360,HITO 156GS,A00,185831,Patterson; Patrick H.,0,0,0,23
1683711576392,HIUS 103,A00,185832,Man; Simeon S,0,4,20,20
1683711577421,HIUS 117,A00,185836,Kwak; Nancy,2,0,20,18
1683711578449,HIUS 125,A00,185840,Man; Simeon S,0,2,23,23
1683711579474,HIUS 149,A00,185845,Staff,1,0,20,19
1683711580501,HUM 3,A01,185882,Zavodny; Tatiana Sophia,0,8,50,50
1683711580501,HUM 3,B01,185899,Caldwell; Michael Alan,0,18,50,50
1683711581526,HUM 3GS,A00,185900,Patterson; Patrick H.,0,0,0,23
1683711582554,HUM 4,A01,185938,Zroka; Amy Liane,28,0,50,22
1683711582554,HUM 4,B01,185956,Watkins; Eric,0,6,50,50
1683711582554,HUM 4,B02,202209,Watkins; Eric,0,5,50,50
1683711582554,HUM 4,B03,202210,Watkins; Eric,0,5,50,50
1683711583585,HUM 5,A01,185958,West; Geoffrey Scott,0,0,50,50
1683711583585,HUM 5,A02,202215,West; Geoffrey Scott,0,1,50,50
1683711584613,INTL 190,A00,185959,Gagnon; Jeffrey C,0,0,0,9
1683711584613,INTL 190,B00,185960,Lettieri; Michael Joseph,0,0,0,2
1683711585642,JAPN 180,A00,254509,Staff,5,0,30,25
1683711586683,LATI 10,A01,202853,Kennemore; Amy Michelle,4,0,35,31
1683711586683,LATI 10,A02,202854,Kennemore; Amy Michelle,3,0,35,32
1683711586683,LATI 10,A03,270054,Kennemore; Amy Michelle,30,0,30,0
1683711587707,LATI 180,A00,202855,Kennemore; Amy Michelle,11,0,20,9
1683711588737,LAWS 101,A00,201767,Golan; Tal,0,7,40,40
1683711589762,LIFR 1C,A00,185961,Staff,6,0,20,14
1683711590786,LIFR 1CX,A00,185962,Staff,7,0,20,13
1683711591814,LIFR 1D,A00,185963,Staff,7,0,20,13
1683711592838,LIFR 1DX,A00,185964,Staff,7,0,20,13
1683711593864,LIGN 101,A01,186039,Staff,43,0,50,7
1683711594974,LIGN 165,A00,186040,Staff,14,0,50,36
1683711595999,LTCS 108,A00,186041,Staff,5,0,10,5
1683711597029,LTCS 119,A00,186042,Staff,15,0,20,5
1683711598056,LTCS 130,A00,186043,Wesling; Megan E.,15,0,25,10
1683711600109,LTEA 138,A00,186119,Staff,14,0,40,26
1683711601138,LTEN 124,A00,186148,Staff,5,0,25,20
1683711602168,LTEN 178,A00,186149,Staff,6,0,15,9
1683711603191,LTEN 181,A00,186150,Blanco; John D,34,0,40,6
1683711604219,LTWL 120,A00,186160,Staff,19,0,25,6
1683711605245,LTWL 165,A00,186161,Staff,22,0,25,3
1683711606270,LTWR 100,A00,186162,Staff,0,5,15,15
1683711607302,LTWR 102,A00,186163,Doller; Ben,5,0,15,10
1683711608331,MAE 8,A01,186412,Staff,0,1,0,0
1683711609356,MAE 30B,A00,186445,Bahadori; Mohammad Yousef,81,0,100,19
1683711610382,MAE 40,A00,186592,Bewley; Thomas R,10,0,50,40
1683711611410,MAE 101B,A00,186593,Bahadori; Mohammad Yousef,80,0,100,20
1683711612435,MAE 105,A00,186594,Bandaru; Prabhakar,10,0,50,40
1683711613466,MAE 107,A00,186599,Pham; Hieu Tan,0,8,120,120
1683711614492,MAE 148,A01,186660,Silberman; Jack,3,0,16,13
1683711615524,MATH 10A,A01,188095,Staff,0,6,35,35
1683711616551,MATH 10B,A01,188097,Bowers; Adam R.,0,12,30,30
1683711616551,MATH 10B,A02,188099,Bowers; Adam R.,0,11,30,30
1683711616551,MATH 10B,B01,188104,Bowers; Adam R.,0,10,30,30
1683711616551,MATH 10B,B02,188106,Bowers; Adam R.,0,9,30,30
1683711617582,MATH 10C,A01,188111,Staff,0,20,30,30
1683711617582,MATH 10C,A02,188127,Staff,0,19,30,30
1683711617582,MATH 10C,A03,188131,Staff,0,19,30,30
1683711617582,MATH 10C,B01,188218,Staff,17,0,30,13
1683711617582,MATH 10C,B02,188244,Staff,13,0,30,17
1683711617582,MATH 10C,B03,188277,Staff,14,0,30,16
1683711618614,MATH 18,A01,188344,Bach; Quang Tran,18,0,30,12
1683711618614,MATH 18,A02,188345,Bach; Quang Tran,11,0,30,19
1683711618614,MATH 18,B01,188353,Bach; Quang Tran,11,0,30,19
1683711618614,MATH 18,B02,188354,Bach; Quang Tran,19,0,30,11
1683711619644,MATH 20A,A01,188374,Staff,11,0,35,24
1683711620672,MATH 20B,A01,188382,Ohm; Ko Woon,7,0,30,23
1683711620672,MATH 20B,A02,188383,Ohm; Ko Woon,22,0,30,8
1683711620672,MATH 20B,B01,188385,Ohm; Ko Woon,7,0,30,23
1683711620672,MATH 20B,B02,188392,Ohm; Ko Woon,22,0,30,8
1683711621705,MATH 20C,A01,188394,Harel; Guershon,10,0,30,20
1683711621705,MATH 20C,A02,188395,Harel; Guershon,13,0,30,17
1683711621705,MATH 20C,B01,188404,Harel; Guershon,5,0,30,25
1683711621705,MATH 20C,B02,188405,Harel; Guershon,18,0,30,12
1683711622731,MATH 20D,A01,188414,Hammock; Frances H,0,1,30,30
1683711622731,MATH 20D,A02,188415,Hammock; Frances H,0,1,30,30
1683711622731,MATH 20D,B01,188447,Hammock; Frances H,0,1,30,30
1683711622731,MATH 20D,B02,188486,Hammock; Frances H,2,0,30,28
1683711623757,MATH 20E,A01,188649,Staff,21,0,30,9
1683711623757,MATH 20E,A02,188650,Staff,20,0,30,10
1683711623757,MATH 20E,A03,188673,Staff,0,0,30,30
1683711624787,MATH 102,A01,188675,Staff,0,40,35,35
1683711625816,MATH 103B,A01,188681,Staff,3,0,35,32
1683711625816,MATH 103B,B01,188692,Staff,5,0,35,30
1683711626847,MATH 109,A01,188695,Salehi Golsefidy; Alireza,24,0,35,11
1683711626847,MATH 109,A02,188696,Salehi Golsefidy; Alireza,25,0,35,10
1683711627878,MATH 120A,A01,188698,Eggers; John Dietrich,7,0,35,28
1683711628910,MATH 142B,A01,188736,Ioana; Adrian,0,0,30,30
1683711628910,MATH 142B,A02,188741,Ioana; Adrian,0,1,30,30
1683711628910,MATH 142B,A03,188743,Ioana; Adrian,0,2,30,30
1683711629947,MATH 168A,A01,188790,Staff,0,11,35,35
1683711630974,MATH 170A,A01,188803,Nie; Jiawang,0,2,35,35
1683711630974,MATH 170A,A02,188811,Nie; Jiawang,0,1,35,35
1683711630974,MATH 170A,A03,188814,Nie; Jiawang,1,0,35,34
1683711630974,MATH 170A,A04,188815,Nie; Jiawang,5,0,35,30
1683711632000,MATH 193B,A01,188817,Staff,0,0,35,35
1683711632000,MATH 193B,A02,188818,Staff,6,0,35,29
1683711633151,MGT 4,A01,202857,Anderson; John Charles,59,0,80,21
1683711634175,MGT 12,A00,202858,Lindenberger; Wade Douglas,40,0,90,50
1683711635200,MGT 18,A00,202859,Staff,73,0,90,17
1683711636226,MGT 18GS,A00,202860,McKay; Michael J,13,0,28,15
1683711637254,MGT 45,A00,202861,Pecore; Joseph P.,8,0,90,82
1683711638279,MGT 100,A00,202863,Yavorsky; Daniel Ryan,27,0,90,63
1683711639305,MGT 103,A00,202864,Ehrich; Kristine R,0,19,90,90
1683711640333,MGT 112,A00,202865,Ehrich; Kristine R,15,0,90,75
1683711641364,MGT 121A,A00,202868,Staff,70,0,90,20
1683711642388,MGT 131B,A00,202869,Anderson; John Charles,58,0,90,32
1683711643413,MGT 136,A00,202871,Lindenberger; Wade Douglas,83,0,90,7
1683711644440,MGT 164,A00,202873,Staff,0,67,90,91
1683711645465,MGT 164GS,A00,202874,McKay; Mary A,13,0,28,15
1683711646494,MGT 180,A00,202875,Staff,0,51,90,91
1683711647521,MMW 11R,A01,205019,Herbst; Matthew,0,0,30,30
1683711647521,MMW 11R,A02,205026,Herbst; Matthew,29,0,30,1
1683711648553,MMW 15,A01,193512,Chang; Edmond Yi-Teh,0,8,28,28
1683711648553,MMW 15,A02,193513,Chang; Edmond Yi-Teh,0,5,28,28
1683711648553,MMW 15,A03,193514,Chang; Edmond Yi-Teh,0,5,28,28
1683711648553,MMW 15,A04,193515,Chang; Edmond Yi-Teh,0,5,28,28
1683711648553,MMW 15,A05,193516,Chang; Edmond Yi-Teh,0,5,28,28
1683711648553,MMW 15,A06,193517,Chang; Edmond Yi-Teh,0,6,28,28
1683711648553,MMW 15,B01,193519,Chang; Edmond Yi-Teh,0,5,28,28
1683711648553,MMW 15,B02,193520,Chang; Edmond Yi-Teh,0,5,28,28
1683711648553,MMW 15,B03,193521,Chang; Edmond Yi-Teh,0,5,28,28
1683711648553,MMW 15,B04,193522,Chang; Edmond Yi-Teh,0,6,28,28
1683711648553,MMW 15,B05,193523,Chang; Edmond Yi-Teh,0,5,28,28
1683711648553,MMW 15,B06,193524,Chang; Edmond Yi-Teh,0,5,28,28
1683711649586,MMW 122,A01,193526,Rahimi; Babak,0,16,28,28
1683711649586,MMW 122,A02,193527,Rahimi; Babak,0,15,28,28
1683711649586,MMW 122,A03,193528,Rahimi; Babak,0,0,0,0
1683711649586,MMW 122,A04,193529,Rahimi; Babak,0,0,0,0
1683711650618,MUS 1A,A01,186663,Staff,0,18,35,35
1683711651644,MUS 4,A01,186715,Staff,0,12,35,35
1683711652670,MUS 5R,A01,186796,Dubnov; Shlomo,0,17,35,35
1683711653695,MUS 6,A01,186798,Staff,0,4,25,25
1683711654721,MUS 7,A01,186830,Staff,11,0,35,24
1683711655750,MUS 8,A01,186930,Staff,0,27,35,35
1683711656781,MUS 15,A01,186932,Staff,0,15,35,35
1683711656781,MUS 15,B01,186934,Staff,0,16,35,35
1683711657810,MUS 80,A00,186935,Staff,0,0,20,20
1683711657810,MUS 80,B00,186936,Staff,24,0,25,1
1683711658841,NANO 11,A00,204702,Lipomi; Darren John,0,0,0,0
1683711659873,NANO 15,A01,204709,Yang; Kesong,0,1,0,0
1683711660898,NANO 114,A00,202069,Jahed Motlagh; Zeinab,2,0,10,8
1683711661929,PHIL 1,A00,186955,Grush; Rick Scott,31,0,40,9
1683711662961,PHIL 10,A01,186973,Grush; Rick Scott,27,0,35,8
1683711662961,PHIL 10,A02,186974,Grush; Rick Scott,33,0,35,2
1683711663990,PHIL 13,A01,186976,Staff,1,0,35,34
1683711663990,PHIL 13,A02,186977,Staff,16,0,35,19
1683711665015,PHIL 14,A01,186979,Staff,30,0,35,5
1683711665015,PHIL 14,A02,186986,Staff,32,0,35,3
1683711666041,PHIL 28,A01,186988,Staff,16,0,30,14
1683711666041,PHIL 28,A02,186989,Staff,0,0,30,30
1683711666041,PHIL 28,A03,186990,Staff,10,0,30,20
1683711666041,PHIL 28,A04,186991,Staff,26,0,30,4
1683711667070,PHIL 120,A00,186997,Staff,23,0,40,17
1683711668097,PHIL 137,A00,187003,Staff,8,0,40,32
1683711669122,PHIL 150,A00,187015,Staff,47,0,70,23
1683711670149,PHIL 167,A00,187021,Lamey; Andy M.,34,0,40,6
1683711671174,PHIL 174,A01,202226,Staff,17,0,20,3
1683711671174,PHIL 174,A02,202235,Staff,20,0,20,0
1683711672206,PHIL 191A,A00,258918,Staff,0,0,1,1
1683711673232,PHYS 1A,A00,187028,Staff,26,0,60,34
1683711674263,PHYS 1AL,001,187036,Staff,3,0,30,27
1683711674263,PHYS 1AL,002,187049,Staff,18,0,30,12
1683711675294,PHYS 1B,A00,187058,Staff,21,0,60,39
1683711676319,PHYS 1BL,001,187064,Staff,0,1,30,30
1683711676319,PHYS 1BL,002,187070,Staff,4,0,30,26
1683711677352,PHYS 1C,A00,187082,Staff,30,0,120,90
1683711678378,PHYS 1CL,001,187088,Staff,0,9,30,30
1683711678378,PHYS 1CL,002,187089,Staff,0,1,30,30
1683711678378,PHYS 1CL,009,262693,Staff,9,0,30,21
1683711679403,PHYS 2B,A01,187097,Staff,55,0,115,60
1683711680433,PHYS 2C,A01,187099,Staff,63,0,115,52
1683711681459,PHYS 2CL,A01,187101,Staff,5,0,28,23
1683711681459,PHYS 2CL,A02,187102,Staff,15,0,28,13
1683711682484,PHYS 2D,A01,187123,Shotwell; Brian,95,0,115,20
1683711683516,PHYS 4B,A01,187133,Grinstein; Benjamin,35,0,50,15
1683711684555,POLI 10,A00,188819,Staff,0,4,50,50
1683711685584,POLI 11,A00,188827,Staff,43,0,50,7
1683711686611,POLI 13R,A00,188828,Staff,0,1,20,20
1683711687641,POLI 27,A01,188830,Elgin; Samuel Zincke,0,2,70,70
1683711688668,POLI 30,A00,188832,Desposato; Scott,30,0,50,20
1683711689691,POLI 102F,A00,188834,Staff,1,0,40,39
1683711690720,POLI 104A,A00,188852,Staff,12,0,30,18
1683711691750,POLI 104I,A00,188853,Staff,0,8,20,20
1683711692784,POLI 110B,A00,188854,Wiens; David,6,0,20,14
1683711693814,POLI 112A,A00,188855,Wiens; David,3,0,30,27
1683711694839,POLI 117R,A00,188856,Forman; Fonna,0,12,20,20
1683711695865,POLI 118,A00,188857,Ingham; Sean,8,0,20,12
1683711696891,POLI 120G,A00,188858,Staff,7,0,30,23
1683711697921,POLI 131CR,A00,188863,Hoston; Germaine,20,0,50,30
1683711699009,POLI 133,A00,188864,Nellis; Gareth Hb,44,0,50,6
1683711700035,POLI 134D,A00,188865,Desposato; Scott,27,0,30,3
1683711701061,POLI 142A,A00,188871,Gartzke; Erik,21,0,50,29
1683711702088,POLI 142K,A00,188874,Staff,38,0,50,12
1683711703117,POLI 143,A00,188940,Gartzke; Erik,15,0,30,15
1683711704147,POLI 153,A00,188943,Staff,1,0,20,19
1683711705178,POLI 160AA,A00,188944,Staff,10,0,40,30
1683711706202,POLI 170A,A00,188945,Staff,10,0,30,20
1683711708263,PSYC 1,A00,188952,Staff,36,0,90,54
1683711709289,PSYC 2,B00,188953,Staff,19,0,35,16
1683711710317,PSYC 6,A00,188970,Staff,47,0,60,13
1683711711342,PSYC 7,A00,188973,Staff,35,0,45,10
1683711712376,PSYC 60,A01,188980,Rickard; Timothy C.,42,0,60,18
1683711713401,PSYC 70,A01,189001,Steiner; Eric Tomas,22,0,45,23
1683711714433,PSYC 100,A00,189005,Lacefield; Katharine I,1,98,120,119
1683711715461,PSYC 102,A00,189008,Staff,6,0,30,24
1683711716487,PSYC 106,B00,189026,Gorman; Michael R.,27,0,60,33
1683711717516,PSYC 114,B01,189033,Winkielman; Piotr,0,31,30,30
1683711718546,PSYC 131,A00,189036,Anagnostaras; Stephan,0,44,60,60
1683711719577,PSYC 136,A00,189041,Lowe; Angela Beth,0,7,25,25
1683711720604,PSYC 137,A00,189057,Winkielman; Piotr,0,36,25,25
1683711721631,PSYC 144,A00,189107,Wixted; John T,0,11,50,50
1683711723687,PSYC 162,A00,189142,Staff,0,9,85,85
1683711724717,PSYC 172,A00,189144,Gorman; Michael R.,0,6,30,30
1683711726768,PSYC 179,A00,189146,Lacefield; Katharine I,0,88,120,120
1683711727800,PSYC 181,A00,189147,Anagnostaras; Stephan,0,45,90,90
1683711728827,PSYC 190R,A00,189148,Barner; David A.,0,23,80,80
1683711729853,PSYC 191,A00,189275,Rickard; Timothy C.,0,11,25,25
1683711730878,PSYC 193,A00,189276,Chapman; Eddie Nathaniel,0,1,0,4
1683711731904,PSYC 193L,A01,189281,Lowe; Angela Beth,8,0,20,12
1683711731904,PSYC 193L,B01,189285,Staff,28,0,35,7
1683711732929,RELI 149,A00,187137,Rahimi; Babak,6,0,40,34
1683711733955,SE 9,A01,187315,Staff,0,2,18,18
1683711734984,SE 101B,A00,187409,Staff,24,0,30,6
1683711736015,SE 110B,A00,187444,Staff,10,0,40,30
1683711737043,SE 130B,A00,187449,Staff,31,0,40,9
1683711738069,SE 150A,A00,187516,Staff,8,0,20,12
1683711739093,SE 154,A00,187528,Staff,29,0,50,21
1683711740118,SIO 3,A01,258171,Staff,35,0,40,5
1683711741147,SIO 10,A00,187144,Cook; Geoffrey W,0,6,75,75
1683711742178,SIO 45,A00,187152,Cook; Geoffrey W,1,7,100,99
1683711743210,SIO 109R,A00,194486,Staff,0,4,20,20
1683711745267,SIO 187,A01,187233,Kacev; David,12,0,40,28
1683711746304,SOCI 1,A01,258656,Thorpe; Charles Robert,28,0,30,2
1683711746304,SOCI 1,A02,258658,Thorpe; Charles Robert,30,0,30,0
1683711746304,SOCI 1,A03,258661,Thorpe; Charles Robert,25,0,25,0
1683711746304,SOCI 1,A04,258666,Thorpe; Charles Robert,22,0,25,3
1683711746304,SOCI 1,A05,258897,Thorpe; Charles Robert,22,0,25,3
1683711746304,SOCI 1,A06,258898,Thorpe; Charles Robert,25,0,25,0
1683711747334,SOCI 30,A01,258903,Pardo Guerra; Juan Pablo,14,0,30,16
1683711748358,SOCI 102,A00,258904,Staff,9,0,25,16
1683711749384,SOCI 106,A00,258905,Staff,19,0,25,6
1683711750415,SOCI 111,A00,258907,Ribas Norris; Janet Vanesa,26,0,30,4
1683711751446,SOCI 121R,A00,258908,Pardo Guerra; Juan Pablo,7,0,30,23
1683711752475,SOCI 126,A01,203330,Staff,14,0,20,6
1683711753501,SOCI 131,A00,258909,Thorpe; Charles Robert,30,0,60,30
1683711754526,SOCI 135,A00,258910,Payne; Christine Anna,0,13,30,30
1683711755555,SOCI 157,A00,258911,Staff,10,0,30,20
1683711756583,SOCI 184,A00,258912,Staff,25,0,30,5
1683711757619,SOCI 188D,A00,258913,Staff,22,0,30,8
1683711758645,SYN 2,001,187529,Staff,9,0,16,7
1683711758645,SYN 2,002,201452,Staff,0,20,16,16
1683711758645,SYN 2,003,201469,Staff,1,0,16,15
1683711759670,SYN 100,A01,187531,Staff,0,9,20,20
1683711759670,SYN 100,B01,201491,Staff,0,10,20,20
1683711760705,TDAC 1,A00,189286,Walsh; Kim C.,3,0,20,17
1683711760705,TDAC 1,B00,189287,Harting; Carla Kelso,10,0,20,10
1683711761731,TDAC 101,A00,189300,Walsh; Kim C.,16,0,20,4
1683711761731,TDAC 101,B00,189301,Harting; Carla Kelso,18,0,20,2
1683711762756,TDAC 102,A00,189304,Basso; Beatrice,14,0,20,6
1683711763795,TDAC 108,A00,189305,Staff,18,0,20,2
1683711764843,TDDE 131,A00,189310,Staff,19,0,20,1
1683711764843,TDDE 131,B00,189314,Staff,19,0,20,1
1683711764843,TDDE 131,C00,189315,Staff,48,0,50,2
1683711764843,TDDE 131,D00,189316,Staff,14,0,15,1
1683711764843,TDDE 131,E00,204841,Staff,20,0,20,0
1683711765884,TDGE 10,A00,189289,Staff,27,0,50,23
1683711765884,TDGE 10,B00,189290,Havis; Allan,0,1,50,50
1683711766929,TDGE 11,A00,189291,Fulton; Julia,0,4,50,50
1683711766929,TDGE 11,B00,189292,Staff,20,0,25,5
1683711766929,TDGE 11,C00,260270,Staff,0,0,0,0
1683711772999,TDGE 25,A00,189294,Staff,1,0,20,19
1683711774024,TDGE 124,A00,189318,Fulton; Julia,0,7,50,50
1683711775049,TDGE 125,A00,189319,Staff,13,0,25,12
1683711775049,TDGE 125,B00,189320,Staff,23,0,25,2
1683711777597,TDGE 127,A00,189322,Havis; Allan,1,0,50,49
1683711778632,TDHT 101,A00,189323,Staff,18,0,25,7
1683711778632,TDHT 101,B00,189324,Staff,25,0,25,0
1683711779670,TDHT 102,A00,189325,Staff,49,0,50,1
1683711780714,TDMV 1,A00,189295,Arcidiacono; Kristin,20,0,30,10
1683711780714,TDMV 1,B00,189296,Caligagan; Maria T.,23,0,30,7
1683711781740,TDMV 2,A00,189297,Sammartano; Tonnie,27,0,30,3
1683711781740,TDMV 2,B00,189299,Arcidiacono; Kristin,23,0,30,7
1683711782790,TDMV 3,A00,204998,Rincon; Alicia,22,0,30,8
1683711783816,TDMV 120,A00,189458,Sammartano; Tonnie,28,0,30,2
1683711784857,TDMV 138,A00,189541,Jun; Grace Shin Hae,20,0,40,20
1683711785883,TDMV 142,A00,189717,Caligagan; Tony,25,0,30,5
1683711785883,TDMV 142,B00,189718,Caligagan; Maria T.,25,0,30,5
1683711786922,TMC 2,A01,187533,Staff,25,0,25,0
1683711786922,TMC 2,A02,187534,Staff,25,0,25,0
1683711787947,USP 1,A01,187536,Kwak; Nancy,0,16,25,25
1683711788974,USP 5,A01,187538,Staff,8,0,25,17
1683711790003,USP 101,A00,199253,Staff,0,4,0,0
1683711791030,USP 124,A00,187562,Boomhower; Matthew Charles,0,0,30,30
1683711792060,USP 138,A00,187582,Staff,19,0,25,6
1683711793088,USP 152,A01,187597,Staff,3,0,25,22
1683711794116,USP 153,A00,187598,Staff,18,0,25,7
1683711795145,USP 168,A00,187607,Kwak; Nancy,2,0,5,3
1683711796170,USP 173,A00,187619,Staff,4,0,25,21
1683711797196,USP 181,A00,187638,Staff,0,4,25,25
1683711798226,VIS 103,A00,187650,Cruz; Edwin Teddy,17,0,75,58
1683711799250,VIS 110D,A00,187669,Staff,13,0,22,9
1683711800274,VIS 127C,A00,187720,Shen; Kuiyi,67,0,146,79
1683711801317,VIS 149,A00,187731,Yoldas; Pinar,0,12,22,22
1683711802341,VIS 151,A01,188091,Staff,22,0,34,12
1683711802341,VIS 151,A02,188092,Staff,11,0,34,23
1683711803371,VIS 160B,A00,188093,Stalbaum; Brett,0,1,10,10
1683711805421,WCWP 10B,A00,201720,Staff,0,0,5,5
1683711805421,WCWP 10B,B00,201722,Staff,0,0,6,6
1683711806450,WCWP 100,A00,201725,Gagnon; Jeffrey C,0,0,2,2
1683711806450,WCWP 100,B00,201727,Staff,0,4,15,15
1683711809666,ANBI 133,A00,258401,Wilder; Linnea Lorene,34,0,40,6
1683711810694,ANBI 140,A00,258395,Hrvoj Mihic; Branka,18,0,25,7
1683711811723,ANSC 120,A00,258402,Bialecki; Jon Anthony,26,0,40,14
1683711812750,ANSC 144,A00,258400,Staff,12,0,40,28
1683711814808,ANSC 166,A00,258396,Parish; Steven Martin,156,0,175,19
1683711815836,ANSC 180,A00,193533,Staff,8,0,20,12
1683711816862,ANSC 188,A00,258397,Jassal; Aftab,34,0,40,6
1683711817887,ANTH 3,A01,258316,Staff,23,0,30,7
1683711818913,ANTH 5,A00,258394,Semendeferi; Ekaterini,16,0,20,4
1683711819937,ANTH 21,A01,258331,Staff,4,0,40,36
1683711820961,ANTH 103,A00,258398,Varma; Saiba,15,0,25,10
1683711821991,AWP 10,001,202034,Staff,0,0,0,0
1683711821991,AWP 10,002,202035,Staff,0,0,0,0
1683711821991,AWP 10,003,202036,Staff,0,0,0,0
1683711821991,AWP 10,004,202037,Staff,0,0,0,0
1683711821991,AWP 10,005,202038,Staff,0,0,0,0
1683711821991,AWP 10,006,202039,Staff,0,0,0,0
1683711821991,AWP 10,007,202040,Staff,0,0,0,0
1683711821991,AWP 10,008,202041,Staff,0,0,0,0
1683711821991,AWP 10,009,202042,Staff,0,0,0,0
1683711821991,AWP 10,010,202043,Staff,0,0,0,0
1683711821991,AWP 10,011,202044,Staff,0,0,0,0
1683711821991,AWP 10,012,202045,Staff,0,0,0,0
1683711821991,AWP 10,013,202046,Staff,0,0,0,0
1683711821991,AWP 10,014,202047,Staff,0,0,0,0
1683711821991,AWP 10,015,202048,Staff,0,0,0,0
1683711821991,AWP 10,016,202049,Staff,0,0,0,0
1683711821991,AWP 10,017,202050,Staff,0,0,0,0
1683711821991,AWP 10,018,202051,Staff,0,0,0,0
1683711821991,AWP 10,019,202052,Staff,0,0,0,0
1683711821991,AWP 10,020,202053,Staff,0,0,0,0
1683711821991,AWP 10,021,202054,Staff,0,0,0,0
1683711821991,AWP 10,022,202055,Staff,0,0,0,0
1683711821991,AWP 10,023,202056,Staff,0,0,0,0
1683711821991,AWP 10,024,202057,Staff,0,0,0,0
1683711821991,AWP 10,025,202058,Staff,0,0,0,0
1683711821991,AWP 10,026,202059,Staff,0,0,0,0
1683711823015,AWP 102,001,202032,Staff,0,0,0,0
1683711823015,AWP 102,002,202033,Staff,0,0,0,0
1683711824043,BENG 100,A01,254234,Taylor Amos; Alyssa C,31,0,40,9
1683711825067,BENG 196,001,270013,Engler; Adam J.,9999,0,9999,0
1683711826098,BICD 100R,A01,202018,Smith; Laurie,0,7,32,32
1683711826098,BICD 100R,A02,202019,Smith; Laurie,0,3,32,32
1683711826098,BICD 100R,A03,202020,Smith; Laurie,0,1,32,32
1683711826098,BICD 100R,A04,202021,Smith; Laurie,6,0,32,26
1683711826098,BICD 100R,A05,202022,Smith; Laurie,10,0,32,22
1683711827123,BICD 136,A01,193242,Gustafson-Brown; Cindy,0,2,32,32
1683711827123,BICD 136,A02,193244,Gustafson-Brown; Cindy,13,0,32,19
1683711828151,BIEB 102,A01,193249,Butler; Shannon Rhey,0,0,32,32
1683711828151,BIEB 102,A02,193251,Butler; Shannon Rhey,0,0,32,32
1683711828151,BIEB 102,A03,193253,Butler; Shannon Rhey,0,0,32,32
1683711828151,BIEB 102,A04,193255,Butler; Shannon Rhey,13,0,32,19
1683711828151,BIEB 102,A05,193265,Butler; Shannon Rhey,25,0,32,7
1683711828151,BIEB 102,A06,193269,Butler; Shannon Rhey,12,0,32,20
1683711830207,BIEB 150,A01,193274,Staff,0,0,32,32
1683711830207,BIEB 150,A02,193285,Staff,24,0,32,8
1683711831233,BIEB 194,A00,193286,Kurle; Carolyn M.,19,0,32,13
1683711832257,BILD 1,A01,192291,Staff,15,0,32,17
1683711832257,BILD 1,A02,192292,Staff,30,0,32,2
1683711832257,BILD 1,B01,192520,Reuther; Keefe,0,1,0,0
1683711832257,BILD 1,B02,192532,Reuther; Keefe,0,1,0,0
1683711833283,BILD 3,A01,192556,Butler; Shannon Rhey,0,0,32,32
1683711833283,BILD 3,A02,192581,Butler; Shannon Rhey,0,1,32,32
1683711833283,BILD 3,A03,192611,Butler; Shannon Rhey,19,0,32,13
1683711833283,BILD 3,A04,192612,Butler; Shannon Rhey,23,0,32,9
1683711833283,BILD 3,A05,192613,Butler; Shannon Rhey,26,0,32,6
1683711833283,BILD 3,A06,192679,Butler; Shannon Rhey,27,0,32,5
1683711833283,BILD 3,A07,192682,Butler; Shannon Rhey,20,0,32,12
1683711834314,BILD 4,A01,192836,Reuther; Keefe,1,0,24,23
1683711834314,BILD 4,A02,193044,Reuther; Keefe,4,0,24,20
1683711835343,BILD 10,A01,193142,Gustafson-Brown; Cindy,29,0,32,3
1683711835343,BILD 10,A02,193149,Gustafson-Brown; Cindy,31,0,32,1
1683711836368,BIMM 100,A01,193301,Staff,0,6,32,32
1683711836368,BIMM 100,A02,193312,Staff,0,7,32,32
1683711836368,BIMM 100,A03,193323,Staff,0,10,32,32
1683711837394,BIMM 101,A01,193329,McDonnell; Lisa Marie,0,3,24,24
1683711837394,BIMM 101,A02,193339,McDonnell; Lisa Marie,0,3,24,24
1683711837394,BIMM 101,B01,193354,McDonnell; Lisa Marie,0,4,24,24
1683711837394,BIMM 101,B02,193357,McDonnell; Lisa Marie,0,3,24,24
1683711838424,BIMM 110,A01,193377,Tat; John,0,11,32,32
1683711838424,BIMM 110,A02,193378,Tat; John,0,11,32,32
1683711839452,BIMM 120,A01,206116,Staff,0,0,32,32
1683711839452,BIMM 120,A02,206117,Staff,7,0,32,25
1683711839452,BIMM 120,A03,206121,Staff,21,0,32,11
1683711840478,BIPN 100,A01,193393,Park; Ji Young,0,15,32,32
1683711840478,BIPN 100,A02,193402,Park; Ji Young,0,14,32,32
1683711840478,BIPN 100,A03,193413,Park; Ji Young,0,14,32,32
1683711840478,BIPN 100,A04,193414,Park; Ji Young,0,13,32,32
1683711841504,BIPN 102,A01,193429,Staff,0,0,32,32
1683711841504,BIPN 102,A02,193438,Staff,18,0,32,14
1683711842534,BIPN 106,A01,193450,Reyes Gonzalez; Catalina,0,2,40,40
1683711843564,BIPN 134,A01,193465,Cooke; James Edward,0,0,32,32
1683711843564,BIPN 134,A02,193474,Cooke; James Edward,25,0,32,7
1683711843564,BIPN 134,A03,193485,Cooke; James Edward,29,0,32,3
1683711843564,BIPN 134,A04,193486,Cooke; James Edward,20,0,32,12
1683711843564,BIPN 134,A05,193491,Cooke; James Edward,31,0,32,1
1683711843564,BIPN 134,A06,193501,Cooke; James Edward,30,0,32,2
1683711843564,BIPN 134,A07,193510,Cooke; James Edward,29,0,32,3
1683711845615,BISP 194,A00,222522,Staff,14,0,32,18
1683711846640,CAT 124,A01,202407,Staff,19,0,25,6
1683711847664,CAT 125,A00,202408,Marchisotto; Jennifer Anne,2,0,20,18
1683711848697,CAT 125R,A00,202409,Smith; Lauryn Alissa,0,11,20,20
1683711848697,CAT 125R,B00,202410,Morales; Celeste Georgianna,0,11,20,20
1683711848697,CAT 125R,C00,202411,Irwin; Matthew Joseph,0,12,20,20
1683711849721,CENG 15,A01,204712,Yang; Kesong,0,1,0,0
1683711850746,CENG 114,A00,202070,Jahed Motlagh; Zeinab,5,0,20,15
1683711851772,CGS 105,A00,185477,Wesling; Megan E.,24,0,40,16
1683711852802,CGS 106,A00,185494,Staff,11,0,22,11
1683711853825,CGS 108,A00,185495,Staff,14,0,20,6
1683711854853,CGS 114,A00,185496,Staff,13,0,18,5
1683711855881,CGS 119,A00,185501,Staff,15,0,20,5
1683711856910,CGS 120,A00,185511,Staff,11,0,20,9
1683711857936,CHEM 4,A01,184675,Bussey; Thomas J,97,0,100,3
1683711858964,CHEM 6A,A01,184677,Staff,32,0,60,28
1683711859990,CHEM 6B,A01,184679,Staff,63,0,100,37
1683711861016,CHEM 6C,A01,184681,Bussey; Thomas J,0,0,50,50
1683711861016,CHEM 6C,A02,184682,Bussey; Thomas J,32,0,50,18
1683711862044,CHEM 40A,A01,184684,Albizati; Kim F.,33,0,100,67
1683711863069,CHEM 40B,A01,184686,Albizati; Kim F.,0,22,100,100
1683711864093,CHEM 41B,A01,184690,Staff,51,0,100,49
1683711865122,COGS 3,A01,184715,Boyle; Mary E. T.,0,27,40,40
1683711866147,COGS 14B,A01,185172,Staff,0,14,38,38
1683711867175,COGS 18,A01,184736,Staff,14,0,80,66
1683711868199,COGS 100,A01,184932,Staff,0,8,73,73
1683711869224,COGS 101A,A01,184935,Staff,0,40,30,30
1683711870255,COGS 101B,A01,184944,Staff,0,2,30,30
1683711871279,COGS 101C,A01,184946,Staff,0,10,30,30
1683711872305,COGS 102A,A01,184951,Johnson; Christine M.,1,0,40,39
1683711873329,COGS 107B,A01,184953,Mooshagian; Eric Frederick,0,52,40,40
1683711874353,COGS 118B,A01,184959,Gupta; Anjum,0,50,40,40
1683711875377,COGS 153,A00,184961,Staff,1,16,30,29
1683711876405,COGS 177,A00,184962,Staff,0,20,30,30
1683711877430,COGS 187A,A01,184969,Boyle; Mary E. T.,0,19,40,40
1683711878456,COMM 10,A01,185174,Staff,0,5,25,25
1683711878456,COMM 10,A02,185189,Staff,0,2,25,25
1683711878456,COMM 10,A03,269821,Staff,0,1,0,0
1683711879482,COMM 100B,A02,185476,Staff,10,0,25,15
1683711879482,COMM 100B,A03,277340,Staff,25,0,25,0
1683711880505,COMM 100C,A01,185314,Staff,2,0,25,23
1683711880505,COMM 100C,A02,185327,Staff,17,0,25,8
1683711881533,COMM 110M,A00,185349,Staff,0,0,40,40
1683711882558,COMM 113T,A00,185352,Staff,25,0,40,15
1683711883583,COMM 114I,A00,185353,Staff,31,0,40,9
1683711884613,COMM 131,A00,185354,Staff,17,0,30,13
1683711885640,CSE 8A,A50,185358,Cao; Yingjun,0,46,10,10
1683711886671,CSE 8B,A01,185362,Staff,0,48,50,50
1683711887700,CSE 11,A01,185416,Cao; Yingjun,0,91,10,10
1683711888726,CSE 20,A01,185445,Briones; Jor-el Thomas Caparas,3,0,25,22
1683711889756,CSE 21,A01,185447,Staff,9,0,50,41
1683711890782,CSE 101,A01,185451,Staff,0,13,50,50
1683711890782,CSE 101,B01,185453,Jones; Miles E,0,15,50,50
1683711892830,CSE 141,A01,185458,Eldon; John,16,0,100,84
1683711893859,CSE 141L,A01,185461,Eldon; John,8,0,100,92
1683711894884,CSE 142,A01,185463,Staff,34,0,60,26
1683711894884,CSE 142,B01,201355,Staff,0,7,60,60
1683711895913,CSE 142L,A01,185470,Staff,34,0,60,26
1683711895913,CSE 142L,B01,201417,Staff,0,6,60,60
1683711896938,CSE 190,A00,201433,Staff,32,0,49,17
1683711897971,DOC 1,A01,259136,Strom; Megan C.,7,0,15,8
1683711897971,DOC 1,A02,259137,Strom; Megan C.,15,0,15,0
1683711897971,DOC 1,A03,259138,Strom; Megan C.,14,0,15,1
1683711897971,DOC 1,A04,259139,Strom; Megan C.,13,0,15,2
1683711898997,DOC 100D,A00,259140,Pass; Natalye Joann,14,0,25,11
1683711900026,DSGN 1,A01,184749,Rill; Bryan,0,26,30,30
1683711901050,DSGN 100,A01,185168,Staff,0,2,25,25
1683711902076,ECE 5,A01,185626,Morris; Karcher William,0,12,0,0
1683711903100,ECE 101,A01,185628,Staff,14,0,70,56
1683711904130,ECE 107,A01,185635,Baghdadchi; Saharnaz,0,0,20,20
1683711904130,ECE 107,A02,185638,Baghdadchi; Saharnaz,1,0,20,19
1683711905159,ECE 148,A01,185647,Silberman; Jack,0,0,16,16
1683711906184,ECON 1,A01,185537,Crane; Meredith Helen,54,0,70,16
1683711907208,ECON 3,A01,185549,Crane; Meredith Helen,30,0,70,40
1683711908234,ECON 4,A01,203354,Anderson; John Charles,0,5,10,10
1683711909261,ECON 100A,A01,185574,Staff,0,5,40,40
1683711910286,ECON 100B,A01,185576,Staff,0,12,50,50
1683711911317,ECON 100C,A01,185589,Newhouse; Herbert S,30,0,70,40
1683711912345,ECON 105,A00,185608,Vespa; Emanuel Ignacio,19,0,35,16
1683711913429,ECON 109,A01,185610,Shishkin; Denis,9,0,35,26
1683711914454,ECON 110A,A01,185612,Staff,8,0,40,32
1683711915479,ECON 120A,A01,185615,Staff,19,0,40,21
1683711916509,ECON 120C,A01,185617,Sun; Yixiao,0,21,70,70
1683711917540,ECON 144,A00,203346,Squires; Dale E,2,0,35,33
1683711918570,ECON 171,A01,203349,Newhouse; Herbert S,0,1,35,35
1683711919595,ECON 173A,A01,185621,Toda; Alexis Akira,21,0,35,14
1683711920622,EDS 25,A01,202413,Staff,0,1,0,0
1683711920622,EDS 25,A02,202414,Staff,0,1,0,0
1683711920622,EDS 25,A03,202415,Staff,0,0,0,0
1683711920622,EDS 25,A04,202416,Staff,0,1,0,0
1683711920622,EDS 25,A05,202439,Staff,0,0,0,0
1683711920622,EDS 25,A06,202440,Staff,0,0,0,0
1683711920622,EDS 25,B01,202631,Staff,0,0,0,0
1683711920622,EDS 25,B02,202632,Staff,0,0,0,0
1683711920622,EDS 25,B03,202639,Staff,0,0,0,0
1683711920622,EDS 25,B04,202640,Staff,0,0,0,0
1683711920622,EDS 25,B05,202643,Staff,0,0,0,0
1683711920622,EDS 25,B06,202644,Staff,0,0,0,0
1683711921647,EDS 38,A01,202659,Black; Alison Michelle,25,0,25,0
1683711922672,EDS 115,A00,202652,Staff,18,0,30,12
1683711923701,EDS 125,A00,202649,Staff,13,0,30,17
1683711924726,EDS 126,A01,203332,Staff,30,0,30,0
1683711925750,EDS 139,A00,202838,Staff,16,0,25,9
1683711926778,EDS 146,A01,202655,Staff,14,0,25,11
1683711927811,ENG 15,A00,185667,Staff,0,1,0,0
1683711927811,ENG 15,B00,185672,Staff,0,0,0,0
1683711927811,ENG 15,C00,185675,Staff,0,0,0,0
1683711927811,ENG 15,D00,185682,Staff,0,0,0,0
1683711927811,ENG 15,E00,185684,Staff,0,0,0,0
1683711928840,ETHN 103,A00,185710,Staff,0,8,35,35
1683711929870,ETHN 103A,A00,199228,Man; Simeon S,0,0,9,9
1683711930896,ETHN 109,A00,185711,Staff,15,0,35,20
1683711931925,ETHN 142,A00,185726,Staff,0,4,30,30
1683711932953,ETHN 163J,A00,199229,Man; Simeon S,5,0,8,3
1683711933981,ETHN 168,A00,185727,Staff,7,0,10,3
1683711935004,ETHN 182,A00,185728,Staff,0,0,35,35
1683711936029,ETHN 183,A00,185737,Staff,9,0,18,9
1683711937060,GLBH 111,A01,209361,Burgos; Jose L.,0,0,0,0
1683711939112,HIEU 104,A00,185792,Staff,14,0,20,6
1683711940136,HIEU 115,A00,185800,Staff,0,0,20,20
1683711941162,HIEU 128,A00,185801,Staff,0,9,20,20
1683711942186,HIEU 147,A00,185802,Staff,15,0,20,5
1683711943212,HIEU 154,A00,185823,Staff,11,0,20,9
1683711944238,HILA 102,A00,185826,Staff,14,0,20,6
1683711945268,HILD 2C,A01,185778,Staff,0,13,20,20
1683711946298,HILD 7B,A01,185780,Kwak; Nancy,0,17,32,32
1683711946298,HILD 7B,A02,185781,Kwak; Nancy,0,18,32,32
1683711947323,HILD 30,A01,185791,Staff,12,0,20,8
1683711948348,HISC 119,A00,185830,Golan; Tal,0,10,20,20
1683711949372,HITO 156GS,A00,185831,Patterson; Patrick H.,0,0,0,23
1683711950403,HIUS 103,A00,185832,Man; Simeon S,0,4,20,20
1683711951432,HIUS 117,A00,185836,Kwak; Nancy,2,0,20,18
1683711952458,HIUS 125,A00,185840,Man; Simeon S,0,2,23,23
1683711953484,HIUS 149,A00,185845,Staff,1,0,20,19
1683711954520,HUM 3,A01,185882,Zavodny; Tatiana Sophia,0,8,50,50
1683711954520,HUM 3,B01,185899,Caldwell; Michael Alan,0,18,50,50
1683711955549,HUM 3GS,A00,185900,Patterson; Patrick H.,0,0,0,23
1683711956585,HUM 4,A01,185938,Zroka; Amy Liane,28,0,50,22
1683711956585,HUM 4,B01,185956,Watkins; Eric,0,6,50,50
1683711956585,HUM 4,B02,202209,Watkins; Eric,0,5,50,50
1683711956585,HUM 4,B03,202210,Watkins; Eric,0,5,50,50
1683711957612,HUM 5,A01,185958,West; Geoffrey Scott,0,0,50,50
1683711957612,HUM 5,A02,202215,West; Geoffrey Scott,0,1,50,50
1683711958644,INTL 190,A00,185959,Gagnon; Jeffrey C,0,0,0,9
1683711958644,INTL 190,B00,185960,Lettieri; Michael Joseph,0,0,0,2
1683711959674,JAPN 180,A00,254509,Staff,5,0,30,25
1683711960699,LATI 10,A01,202853,Kennemore; Amy Michelle,4,0,35,31
1683711960699,LATI 10,A02,202854,Kennemore; Amy Michelle,3,0,35,32
1683711960699,LATI 10,A03,270054,Kennemore; Amy Michelle,30,0,30,0
1683711961729,LATI 180,A00,202855,Kennemore; Amy Michelle,11,0,20,9
1683711962755,LAWS 101,A00,201767,Golan; Tal,0,7,40,40
1683711963780,LIFR 1C,A00,185961,Staff,6,0,20,14
1683711964805,LIFR 1CX,A00,185962,Staff,7,0,20,13
1683711965830,LIFR 1D,A00,185963,Staff,7,0,20,13
1683711966856,LIFR 1DX,A00,185964,Staff,7,0,20,13
1683711967881,LIGN 101,A01,186039,Staff,43,0,50,7
1683711968906,LIGN 165,A00,186040,Staff,14,0,50,36
1683711969931,LTCS 108,A00,186041,Staff,5,0,10,5
1683711970962,LTCS 119,A00,186042,Staff,15,0,20,5
1683711971992,LTCS 130,A00,186043,Wesling; Megan E.,15,0,25,10
1683711974042,LTEA 138,A00,186119,Staff,14,0,40,26
1683711975067,LTEN 124,A00,186148,Staff,5,0,25,20
1683711976101,LTEN 178,A00,186149,Staff,6,0,15,9
1683711977136,LTEN 181,A00,186150,Blanco; John D,34,0,40,6
1683711978162,LTWL 120,A00,186160,Staff,19,0,25,6
1683711979189,LTWL 165,A00,186161,Staff,22,0,25,3
1683711980217,LTWR 100,A00,186162,Staff,0,5,15,15
1683711981242,LTWR 102,A00,186163,Doller; Ben,5,0,15,10
1683711982266,MAE 8,A01,186412,Staff,0,1,0,0
1683711983296,MAE 30B,A00,186445,Bahadori; Mohammad Yousef,81,0,100,19
1683711984325,MAE 40,A00,186592,Bewley; Thomas R,10,0,50,40
1683711985352,MAE 101B,A00,186593,Bahadori; Mohammad Yousef,80,0,100,20
1683711986377,MAE 105,A00,186594,Bandaru; Prabhakar,10,0,50,40
1683711987402,MAE 107,A00,186599,Pham; Hieu Tan,0,8,120,120
1683711988431,MAE 148,A01,186660,Silberman; Jack,3,0,16,13
1683711989462,MATH 10A,A01,188095,Staff,0,6,35,35
1683711990488,MATH 10B,A01,188097,Bowers; Adam R.,0,12,30,30
1683711990488,MATH 10B,A02,188099,Bowers; Adam R.,0,11,30,30
1683711990488,MATH 10B,B01,188104,Bowers; Adam R.,0,10,30,30
1683711990488,MATH 10B,B02,188106,Bowers; Adam R.,0,9,30,30
1683711991516,MATH 10C,A01,188111,Staff,0,20,30,30
1683711991516,MATH 10C,A02,188127,Staff,0,19,30,30
1683711991516,MATH 10C,A03,188131,Staff,0,19,30,30
1683711991516,MATH 10C,B01,188218,Staff,17,0,30,13
1683711991516,MATH 10C,B02,188244,Staff,13,0,30,17
1683711991516,MATH 10C,B03,188277,Staff,14,0,30,16
1683711992542,MATH 18,A01,188344,Bach; Quang Tran,18,0,30,12
1683711992542,MATH 18,A02,188345,Bach; Quang Tran,11,0,30,19
1683711992542,MATH 18,B01,188353,Bach; Quang Tran,11,0,30,19
1683711992542,MATH 18,B02,188354,Bach; Quang Tran,19,0,30,11
1683711993572,MATH 20A,A01,188374,Staff,11,0,35,24
1683711994604,MATH 20B,A01,188382,Ohm; Ko Woon,7,0,30,23
1683711994604,MATH 20B,A02,188383,Ohm; Ko Woon,22,0,30,8
1683711994604,MATH 20B,B01,188385,Ohm; Ko Woon,7,0,30,23
1683711994604,MATH 20B,B02,188392,Ohm; Ko Woon,22,0,30,8
1683711995635,MATH 20C,A01,188394,Harel; Guershon,10,0,30,20
1683711995635,MATH 20C,A02,188395,Harel; Guershon,13,0,30,17
1683711995635,MATH 20C,B01,188404,Harel; Guershon,5,0,30,25
1683711995635,MATH 20C,B02,188405,Harel; Guershon,18,0,30,12
1683711996660,MATH 20D,A01,188414,Hammock; Frances H,0,1,30,30
1683711996660,MATH 20D,A02,188415,Hammock; Frances H,0,1,30,30
1683711996660,MATH 20D,B01,188447,Hammock; Frances H,0,1,30,30
1683711996660,MATH 20D,B02,188486,Hammock; Frances H,2,0,30,28
1683711997686,MATH 20E,A01,188649,Staff,21,0,30,9
1683711997686,MATH 20E,A02,188650,Staff,20,0,30,10
1683711997686,MATH 20E,A03,188673,Staff,0,0,30,30
1683711998715,MATH 102,A01,188675,Staff,0,40,35,35
1683711999745,MATH 103B,A01,188681,Staff,3,0,35,32
1683711999745,MATH 103B,B01,188692,Staff,5,0,35,30
1683712000776,MATH 109,A01,188695,Salehi Golsefidy; Alireza,24,0,35,11
1683712000776,MATH 109,A02,188696,Salehi Golsefidy; Alireza,25,0,35,10
1683712001802,MATH 120A,A01,188698,Eggers; John Dietrich,7,0,35,28
1683712002829,MATH 142B,A01,188736,Ioana; Adrian,0,0,30,30
1683712002829,MATH 142B,A02,188741,Ioana; Adrian,0,1,30,30
1683712002829,MATH 142B,A03,188743,Ioana; Adrian,0,2,30,30
1683712003858,MATH 168A,A01,188790,Staff,0,11,35,35
1683712004890,MATH 170A,A01,188803,Nie; Jiawang,0,2,35,35
1683712004890,MATH 170A,A02,188811,Nie; Jiawang,0,1,35,35
1683712004890,MATH 170A,A03,188814,Nie; Jiawang,1,0,35,34
1683712004890,MATH 170A,A04,188815,Nie; Jiawang,5,0,35,30
1683712005916,MATH 193B,A01,188817,Staff,0,0,35,35
1683712005916,MATH 193B,A02,188818,Staff,6,0,35,29
1683712006943,MGT 4,A01,202857,Anderson; John Charles,59,0,80,21
1683712007973,MGT 12,A00,202858,Lindenberger; Wade Douglas,40,0,90,50
1683712009004,MGT 18,A00,202859,Staff,73,0,90,17
1683712010033,MGT 18GS,A00,202860,McKay; Michael J,13,0,28,15
1683712011063,MGT 45,A00,202861,Pecore; Joseph P.,8,0,90,82
1683712012091,MGT 100,A00,202863,Yavorsky; Daniel Ryan,27,0,90,63
1683712013117,MGT 103,A00,202864,Ehrich; Kristine R,0,19,90,90
1683712014143,MGT 112,A00,202865,Ehrich; Kristine R,15,0,90,75
1683712015169,MGT 121A,A00,202868,Staff,70,0,90,20
1683712016195,MGT 131B,A00,202869,Anderson; John Charles,58,0,90,32
1683712017275,MGT 136,A00,202871,Lindenberger; Wade Douglas,83,0,90,7
1683712018301,MGT 164,A00,202873,Staff,0,67,90,91
1683712019328,MGT 164GS,A00,202874,McKay; Mary A,13,0,28,15
1683712020352,MGT 180,A00,202875,Staff,0,51,90,91
1683712021378,MMW 11R,A01,205019,Herbst; Matthew,0,0,30,30
1683712021378,MMW 11R,A02,205026,Herbst; Matthew,29,0,30,1
1683712022414,MMW 15,A01,193512,Chang; Edmond Yi-Teh,0,8,28,28
1683712022414,MMW 15,A02,193513,Chang; Edmond Yi-Teh,0,5,28,28
1683712022414,MMW 15,A03,193514,Chang; Edmond Yi-Teh,0,5,28,28
1683712022414,MMW 15,A04,193515,Chang; Edmond Yi-Teh,0,5,28,28
1683712022414,MMW 15,A05,193516,Chang; Edmond Yi-Teh,0,5,28,28
1683712022414,MMW 15,A06,193517,Chang; Edmond Yi-Teh,0,6,28,28
1683712022414,MMW 15,B01,193519,Chang; Edmond Yi-Teh,0,5,28,28
1683712022414,MMW 15,B02,193520,Chang; Edmond Yi-Teh,0,5,28,28
1683712022414,MMW 15,B03,193521,Chang; Edmond Yi-Teh,0,5,28,28
1683712022414,MMW 15,B04,193522,Chang; Edmond Yi-Teh,0,6,28,28
1683712022414,MMW 15,B05,193523,Chang; Edmond Yi-Teh,0,5,28,28
1683712022414,MMW 15,B06,193524,Chang; Edmond Yi-Teh,0,5,28,28
1683712023444,MMW 122,A01,193526,Rahimi; Babak,0,16,28,28
1683712023444,MMW 122,A02,193527,Rahimi; Babak,0,15,28,28
1683712023444,MMW 122,A03,193528,Rahimi; Babak,0,0,0,0
1683712023444,MMW 122,A04,193529,Rahimi; Babak,0,0,0,0
1683712024474,MUS 1A,A01,186663,Staff,0,18,35,35
1683712025499,MUS 4,A01,186715,Staff,0,12,35,35
1683712026528,MUS 5R,A01,186796,Dubnov; Shlomo,0,17,35,35
1683712027554,MUS 6,A01,186798,Staff,0,4,25,25
1683712028578,MUS 7,A01,186830,Staff,11,0,35,24
1683712029607,MUS 8,A01,186930,Staff,0,27,35,35
1683712030639,MUS 15,A01,186932,Staff,0,15,35,35
1683712030639,MUS 15,B01,186934,Staff,0,16,35,35
1683712031674,MUS 80,A00,186935,Staff,0,0,20,20
1683712031674,MUS 80,B00,186936,Staff,24,0,25,1
1683712032705,NANO 11,A00,204702,Lipomi; Darren John,0,0,0,0
1683712033730,NANO 15,A01,204709,Yang; Kesong,0,1,0,0
1683712034760,NANO 114,A00,202069,Jahed Motlagh; Zeinab,2,0,10,8
1683712035791,PHIL 1,A00,186955,Grush; Rick Scott,31,0,40,9
1683712036822,PHIL 10,A01,186973,Grush; Rick Scott,27,0,35,8
1683712036822,PHIL 10,A02,186974,Grush; Rick Scott,33,0,35,2
1683712037849,PHIL 13,A01,186976,Staff,1,0,35,34
1683712037849,PHIL 13,A02,186977,Staff,16,0,35,19
1683712038872,PHIL 14,A01,186979,Staff,30,0,35,5
1683712038872,PHIL 14,A02,186986,Staff,32,0,35,3
1683712039901,PHIL 28,A01,186988,Staff,16,0,30,14
1683712039901,PHIL 28,A02,186989,Staff,0,0,30,30
1683712039901,PHIL 28,A03,186990,Staff,10,0,30,20
1683712039901,PHIL 28,A04,186991,Staff,26,0,30,4
1683712040931,PHIL 120,A00,186997,Staff,23,0,40,17
1683712041961,PHIL 137,A00,187003,Staff,8,0,40,32
1683712042986,PHIL 150,A00,187015,Staff,47,0,70,23
1683712044011,PHIL 167,A00,187021,Lamey; Andy M.,34,0,40,6
1683712045043,PHIL 174,A01,202226,Staff,17,0,20,3
1683712045043,PHIL 174,A02,202235,Staff,20,0,20,0
1683712046073,PHIL 191A,A00,258918,Staff,0,0,1,1
1683712047100,PHYS 1A,A00,187028,Staff,26,0,60,34
1683712048125,PHYS 1AL,001,187036,Staff,3,0,30,27
1683712048125,PHYS 1AL,002,187049,Staff,18,0,30,12
1683712049152,PHYS 1B,A00,187058,Staff,21,0,60,39
1683712050178,PHYS 1BL,001,187064,Staff,0,1,30,30
1683712050178,PHYS 1BL,002,187070,Staff,4,0,30,26
1683712051200,PHYS 1C,A00,187082,Staff,30,0,120,90
1683712052227,PHYS 1CL,001,187088,Staff,0,9,30,30
1683712052227,PHYS 1CL,002,187089,Staff,0,1,30,30
1683712052227,PHYS 1CL,009,262693,Staff,9,0,30,21
1683712053254,PHYS 2B,A01,187097,Staff,55,0,115,60
1683712054280,PHYS 2C,A01,187099,Staff,63,0,115,52
1683712055311,PHYS 2CL,A01,187101,Staff,5,0,28,23
1683712055311,PHYS 2CL,A02,187102,Staff,15,0,28,13
1683712056342,PHYS 2D,A01,187123,Shotwell; Brian,95,0,115,20
1683712057368,PHYS 4B,A01,187133,Grinstein; Benjamin,35,0,50,15
1683712058397,POLI 10,A00,188819,Staff,0,4,50,50
1683712059427,POLI 11,A00,188827,Staff,43,0,50,7
1683712060453,POLI 13R,A00,188828,Staff,0,1,20,20
1683712061484,POLI 27,A01,188830,Elgin; Samuel Zincke,0,2,70,70
1683712062509,POLI 30,A00,188832,Desposato; Scott,30,0,50,20
1683712063535,POLI 102F,A00,188834,Staff,1,0,40,39
1683712064565,POLI 104A,A00,188852,Staff,12,0,30,18
1683712065591,POLI 104I,A00,188853,Staff,0,8,20,20
1683712066618,POLI 110B,A00,188854,Wiens; David,6,0,20,14
1683712067646,POLI 112A,A00,188855,Wiens; David,3,0,30,27
1683712068673,POLI 117R,A00,188856,Forman; Fonna,0,12,20,20
1683712069699,POLI 118,A00,188857,Ingham; Sean,8,0,20,12
1683712070725,POLI 120G,A00,188858,Staff,7,0,30,23
1683712071750,POLI 131CR,A00,188863,Hoston; Germaine,20,0,50,30
1683712072775,POLI 133,A00,188864,Nellis; Gareth Hb,44,0,50,6
1683712073801,POLI 134D,A00,188865,Desposato; Scott,27,0,30,3
1683712074833,POLI 142A,A00,188871,Gartzke; Erik,21,0,50,29
1683712075859,POLI 142K,A00,188874,Staff,38,0,50,12
1683712076885,POLI 143,A00,188940,Gartzke; Erik,15,0,30,15
1683712077918,POLI 153,A00,188943,Staff,1,0,20,19
1683712078945,POLI 160AA,A00,188944,Staff,10,0,40,30
1683712079974,POLI 170A,A00,188945,Staff,10,0,30,20
1683712082022,PSYC 1,A00,188952,Staff,36,0,90,54
1683712083050,PSYC 2,B00,188953,Staff,19,0,35,16
1683712084075,PSYC 6,A00,188970,Staff,47,0,60,13
1683712085099,PSYC 7,A00,188973,Staff,35,0,45,10
1683712086130,PSYC 60,A01,188980,Rickard; Timothy C.,42,0,60,18
1683712087160,PSYC 70,A01,189001,Steiner; Eric Tomas,22,0,45,23
1683712088190,PSYC 100,A00,189005,Lacefield; Katharine I,1,98,120,119
1683712089219,PSYC 102,A00,189008,Staff,6,0,30,24
1683712090247,PSYC 106,B00,189026,Gorman; Michael R.,27,0,60,33
1683712091278,PSYC 114,B01,189033,Winkielman; Piotr,0,31,30,30
1683712092309,PSYC 131,A00,189036,Anagnostaras; Stephan,0,44,60,60
1683712093338,PSYC 136,A00,189041,Lowe; Angela Beth,0,7,25,25
1683712094365,PSYC 137,A00,189057,Winkielman; Piotr,0,36,25,25
1683712095396,PSYC 144,A00,189107,Wixted; John T,0,11,50,50
1683712097446,PSYC 162,A00,189142,Staff,0,9,85,85
1683712098475,PSYC 172,A00,189144,Gorman; Michael R.,0,6,30,30
1683712100525,PSYC 179,A00,189146,Lacefield; Katharine I,0,88,120,120
1683712101562,PSYC 181,A00,189147,Anagnostaras; Stephan,0,45,90,90
1683712102586,PSYC 190R,A00,189148,Barner; David A.,0,23,80,80
1683712103613,PSYC 191,A00,189275,Rickard; Timothy C.,0,11,25,25
1683712104644,PSYC 193,A00,189276,Chapman; Eddie Nathaniel,0,1,0,4
1683712105674,PSYC 193L,A01,189281,Lowe; Angela Beth,8,0,20,12
1683712105674,PSYC 193L,B01,189285,Staff,28,0,35,7
1683712106701,RELI 149,A00,187137,Rahimi; Babak,6,0,40,34
1683712107728,SE 9,A01,187315,Staff,0,2,18,18
1683712108753,SE 101B,A00,187409,Staff,24,0,30,6
1683712109779,SE 110B,A00,187444,Staff,10,0,40,30
1683712110806,SE 130B,A00,187449,Staff,31,0,40,9
1683712111832,SE 150A,A00,187516,Staff,8,0,20,12
1683712112857,SE 154,A00,187528,Staff,29,0,50,21
1683712113883,SIO 3,A01,258171,Staff,35,0,40,5
1683712114912,SIO 10,A00,187144,Cook; Geoffrey W,0,6,75,75
1683712115940,SIO 45,A00,187152,Cook; Geoffrey W,1,7,100,99
1683712116968,SIO 109R,A00,194486,Staff,0,4,20,20
1683712119019,SIO 187,A01,187233,Kacev; David,12,0,40,28
1683712120046,SOCI 1,A01,258656,Thorpe; Charles Robert,28,0,30,2
1683712120046,SOCI 1,A02,258658,Thorpe; Charles Robert,30,0,30,0
1683712120046,SOCI 1,A03,258661,Thorpe; Charles Robert,25,0,25,0
1683712120046,SOCI 1,A04,258666,Thorpe; Charles Robert,22,0,25,3
1683712120046,SOCI 1,A05,258897,Thorpe; Charles Robert,22,0,25,3
1683712120046,SOCI 1,A06,258898,Thorpe; Charles Robert,25,0,25,0
1683712121149,SOCI 30,A01,258903,Pardo Guerra; Juan Pablo,14,0,30,16
1683712122178,SOCI 102,A00,258904,Staff,9,0,25,16
1683712123205,SOCI 106,A00,258905,Staff,19,0,25,6
1683712124231,SOCI 111,A00,258907,Ribas Norris; Janet Vanesa,26,0,30,4
1683712125257,SOCI 121R,A00,258908,Pardo Guerra; Juan Pablo,7,0,30,23
1683712126281,SOCI 126,A01,203330,Staff,14,0,20,6
1683712127307,SOCI 131,A00,258909,Thorpe; Charles Robert,30,0,60,30
1683712128332,SOCI 135,A00,258910,Payne; Christine Anna,0,13,30,30
1683712129357,SOCI 157,A00,258911,Staff,10,0,30,20
1683712130381,SOCI 184,A00,258912,Staff,25,0,30,5
1683712131410,SOCI 188D,A00,258913,Staff,22,0,30,8
1683712132437,SYN 2,001,187529,Staff,9,0,16,7
1683712132437,SYN 2,002,201452,Staff,0,20,16,16
1683712132437,SYN 2,003,201469,Staff,1,0,16,15
1683712133464,SYN 100,A01,187531,Staff,0,9,20,20
1683712133464,SYN 100,B01,201491,Staff,0,10,20,20
1683712134495,TDAC 1,A00,189286,Walsh; Kim C.,3,0,20,17
1683712134495,TDAC 1,B00,189287,Harting; Carla Kelso,10,0,20,10
1683712135526,TDAC 101,A00,189300,Walsh; Kim C.,16,0,20,4
1683712135526,TDAC 101,B00,189301,Harting; Carla Kelso,18,0,20,2
1683712136555,TDAC 102,A00,189304,Basso; Beatrice,14,0,20,6
1683712137580,TDAC 108,A00,189305,Staff,18,0,20,2
1683712138607,TDDE 131,A00,189310,Staff,19,0,20,1
1683712138607,TDDE 131,B00,189314,Staff,19,0,20,1
1683712138607,TDDE 131,C00,189315,Staff,48,0,50,2
1683712138607,TDDE 131,D00,189316,Staff,14,0,15,1
1683712138607,TDDE 131,E00,204841,Staff,20,0,20,0
1683712139630,TDGE 10,A00,189289,Staff,27,0,50,23
1683712139630,TDGE 10,B00,189290,Havis; Allan,0,1,50,50
1683712140655,TDGE 11,A00,189291,Fulton; Julia,0,4,50,50
1683712140655,TDGE 11,B00,189292,Staff,20,0,25,5
1683712140655,TDGE 11,C00,260270,Staff,0,0,0,0
1683712141686,TDGE 25,A00,189294,Staff,1,0,20,19
1683712142714,TDGE 124,A00,189318,Fulton; Julia,0,7,50,50
1683712143745,TDGE 125,A00,189319,Staff,13,0,25,12
1683712143745,TDGE 125,B00,189320,Staff,23,0,25,2
1683712144771,TDGE 127,A00,189322,Havis; Allan,1,0,50,49
1683712145796,TDHT 101,A00,189323,Staff,18,0,25,7
1683712145796,TDHT 101,B00,189324,Staff,25,0,25,0
1683712146823,TDHT 102,A00,189325,Staff,49,0,50,1
1683712147884,TDMV 1,A00,189295,Arcidiacono; Kristin,20,0,30,10
1683712147884,TDMV 1,B00,189296,Caligagan; Maria T.,23,0,30,7
1683712148910,TDMV 2,A00,189297,Sammartano; Tonnie,27,0,30,3
1683712148910,TDMV 2,B00,189299,Arcidiacono; Kristin,23,0,30,7
1683712149941,TDMV 3,A00,204998,Rincon; Alicia,22,0,30,8
1683712150967,TDMV 120,A00,189458,Sammartano; Tonnie,28,0,30,2
1683712151997,TDMV 138,A00,189541,Jun; Grace Shin Hae,20,0,40,20
1683712153022,TDMV 142,A00,189717,Caligagan; Tony,25,0,30,5
1683712153022,TDMV 142,B00,189718,Caligagan; Maria T.,25,0,30,5
1683712154054,TMC 2,A01,187533,Staff,25,0,25,0
1683712154054,TMC 2,A02,187534,Staff,25,0,25,0
1683712155080,USP 1,A01,187536,Kwak; Nancy,0,16,25,25
1683712156105,USP 5,A01,187538,Staff,8,0,25,17
1683712157131,USP 101,A00,199253,Staff,0,4,0,0
1683712158156,USP 124,A00,187562,Boomhower; Matthew Charles,0,0,30,30
1683712159182,USP 138,A00,187582,Staff,19,0,25,6
1683712160208,USP 152,A01,187597,Staff,3,0,25,22
1683712161237,USP 153,A00,187598,Staff,18,0,25,7
1683712162262,USP 168,A00,187607,Kwak; Nancy,2,0,5,3
1683712163297,USP 173,A00,187619,Staff,4,0,25,21
1683712164322,USP 181,A00,187638,Staff,0,4,25,25
1683712165349,VIS 103,A00,187650,Cruz; Edwin Teddy,17,0,75,58
1683712166374,VIS 110D,A00,187669,Staff,13,0,22,9
1683712167401,VIS 127C,A00,187720,Shen; Kuiyi,67,0,146,79
1683712168438,VIS 149,A00,187731,Yoldas; Pinar,0,12,22,22
1683712169469,VIS 151,A01,188091,Staff,22,0,34,12
1683712169469,VIS 151,A02,188092,Staff,11,0,34,23
1683712170497,VIS 160B,A00,188093,Stalbaum; Brett,0,1,10,10
1683712172553,WCWP 10B,A00,201720,Staff,0,0,5,5
1683712172553,WCWP 10B,B00,201722,Staff,0,0,6,6
1683712173579,WCWP 100,A00,201725,Gagnon; Jeffrey C,0,0,2,2
1683712173579,WCWP 100,B00,201727,Staff,0,4,15,15
1683712176828,ANBI 133,A00,258401,Wilder; Linnea Lorene,34,0,40,6
1683712177880,ANBI 140,A00,258395,Hrvoj Mihic; Branka,18,0,25,7
1683712178910,ANSC 120,A00,258402,Bialecki; Jon Anthony,26,0,40,14
1683712179938,ANSC 144,A00,258400,Staff,12,0,40,28
1683712181995,ANSC 166,A00,258396,Parish; Steven Martin,156,0,175,19
1683712183020,ANSC 180,A00,193533,Staff,8,0,20,12
1683712184045,ANSC 188,A00,258397,Jassal; Aftab,34,0,40,6
1683712185070,ANTH 3,A01,258316,Staff,23,0,30,7
1683712186096,ANTH 5,A00,258394,Semendeferi; Ekaterini,16,0,20,4
1683712187121,ANTH 21,A01,258331,Staff,4,0,40,36
1683712188149,ANTH 103,A00,258398,Varma; Saiba,15,0,25,10
1683712189207,AWP 10,001,202034,Staff,0,0,0,0
1683712189207,AWP 10,002,202035,Staff,0,0,0,0
1683712189207,AWP 10,003,202036,Staff,0,0,0,0
1683712189207,AWP 10,004,202037,Staff,0,0,0,0
1683712189207,AWP 10,005,202038,Staff,0,0,0,0
1683712189207,AWP 10,006,202039,Staff,0,0,0,0
1683712189207,AWP 10,007,202040,Staff,0,0,0,0
1683712189207,AWP 10,008,202041,Staff,0,0,0,0
1683712189207,AWP 10,009,202042,Staff,0,0,0,0
1683712189207,AWP 10,010,202043,Staff,0,0,0,0
1683712189207,AWP 10,011,202044,Staff,0,0,0,0
1683712189207,AWP 10,012,202045,Staff,0,0,0,0
1683712189207,AWP 10,013,202046,Staff,0,0,0,0
1683712189207,AWP 10,014,202047,Staff,0,0,0,0
1683712189207,AWP 10,015,202048,Staff,0,0,0,0
1683712189207,AWP 10,016,202049,Staff,0,0,0,0
1683712189207,AWP 10,017,202050,Staff,0,0,0,0
1683712189207,AWP 10,018,202051,Staff,0,0,0,0
1683712189207,AWP 10,019,202052,Staff,0,0,0,0
1683712189207,AWP 10,020,202053,Staff,0,0,0,0
1683712189207,AWP 10,021,202054,Staff,0,0,0,0
1683712189207,AWP 10,022,202055,Staff,0,0,0,0
1683712189207,AWP 10,023,202056,Staff,0,0,0,0
1683712189207,AWP 10,024,202057,Staff,0,0,0,0
1683712189207,AWP 10,025,202058,Staff,0,0,0,0
1683712189207,AWP 10,026,202059,Staff,0,0,0,0
1683712190245,AWP 102,001,202032,Staff,0,0,0,0
1683712190245,AWP 102,002,202033,Staff,0,0,0,0
1683712191275,BENG 100,A01,254234,Taylor Amos; Alyssa C,31,0,40,9
1683712192305,BENG 196,001,270013,Engler; Adam J.,9999,0,9999,0
1683712193333,BICD 100R,A01,202018,Smith; Laurie,0,7,32,32
1683712193333,BICD 100R,A02,202019,Smith; Laurie,0,3,32,32
1683712193333,BICD 100R,A03,202020,Smith; Laurie,0,1,32,32
1683712193333,BICD 100R,A04,202021,Smith; Laurie,6,0,32,26
1683712193333,BICD 100R,A05,202022,Smith; Laurie,10,0,32,22
1683712194360,BICD 136,A01,193242,Gustafson-Brown; Cindy,0,2,32,32
1683712194360,BICD 136,A02,193244,Gustafson-Brown; Cindy,13,0,32,19
1683712195388,BIEB 102,A01,193249,Butler; Shannon Rhey,0,0,32,32
1683712195388,BIEB 102,A02,193251,Butler; Shannon Rhey,0,0,32,32
1683712195388,BIEB 102,A03,193253,Butler; Shannon Rhey,0,0,32,32
1683712195388,BIEB 102,A04,193255,Butler; Shannon Rhey,13,0,32,19
1683712195388,BIEB 102,A05,193265,Butler; Shannon Rhey,25,0,32,7
1683712195388,BIEB 102,A06,193269,Butler; Shannon Rhey,12,0,32,20
1683712197443,BIEB 150,A01,193274,Staff,0,0,32,32
1683712197443,BIEB 150,A02,193285,Staff,24,0,32,8
1683712198468,BIEB 194,A00,193286,Kurle; Carolyn M.,19,0,32,13
1683712199502,BILD 1,A01,192291,Staff,15,0,32,17
1683712199502,BILD 1,A02,192292,Staff,30,0,32,2
1683712199502,BILD 1,B01,192520,Reuther; Keefe,0,1,0,0
1683712199502,BILD 1,B02,192532,Reuther; Keefe,0,1,0,0
1683712200535,BILD 3,A01,192556,Butler; Shannon Rhey,0,0,32,32
1683712200535,BILD 3,A02,192581,Butler; Shannon Rhey,0,1,32,32
1683712200535,BILD 3,A03,192611,Butler; Shannon Rhey,19,0,32,13
1683712200535,BILD 3,A04,192612,Butler; Shannon Rhey,23,0,32,9
1683712200535,BILD 3,A05,192613,Butler; Shannon Rhey,26,0,32,6
1683712200535,BILD 3,A06,192679,Butler; Shannon Rhey,27,0,32,5
1683712200535,BILD 3,A07,192682,Butler; Shannon Rhey,20,0,32,12
1683712201561,BILD 4,A01,192836,Reuther; Keefe,1,0,24,23
1683712201561,BILD 4,A02,193044,Reuther; Keefe,4,0,24,20
1683712202592,BILD 10,A01,193142,Gustafson-Brown; Cindy,29,0,32,3
1683712202592,BILD 10,A02,193149,Gustafson-Brown; Cindy,31,0,32,1
1683712203618,BIMM 100,A01,193301,Staff,0,6,32,32
1683712203618,BIMM 100,A02,193312,Staff,0,7,32,32
1683712203618,BIMM 100,A03,193323,Staff,0,10,32,32
1683712204642,BIMM 101,A01,193329,McDonnell; Lisa Marie,0,3,24,24
1683712204642,BIMM 101,A02,193339,McDonnell; Lisa Marie,0,3,24,24
1683712204642,BIMM 101,B01,193354,McDonnell; Lisa Marie,0,4,24,24
1683712204642,BIMM 101,B02,193357,McDonnell; Lisa Marie,0,3,24,24
1683712205668,BIMM 110,A01,193377,Tat; John,0,11,32,32
1683712205668,BIMM 110,A02,193378,Tat; John,0,11,32,32
1683712206696,BIMM 120,A01,206116,Staff,0,0,32,32
1683712206696,BIMM 120,A02,206117,Staff,7,0,32,25
1683712206696,BIMM 120,A03,206121,Staff,21,0,32,11
1683712207723,BIPN 100,A01,193393,Park; Ji Young,0,15,32,32
1683712207723,BIPN 100,A02,193402,Park; Ji Young,0,14,32,32
1683712207723,BIPN 100,A03,193413,Park; Ji Young,0,14,32,32
1683712207723,BIPN 100,A04,193414,Park; Ji Young,0,13,32,32
1683712208752,BIPN 102,A01,193429,Staff,0,0,32,32
1683712208752,BIPN 102,A02,193438,Staff,18,0,32,14
1683712209781,BIPN 106,A01,193450,Reyes Gonzalez; Catalina,0,2,40,40
1683712210812,BIPN 134,A01,193465,Cooke; James Edward,0,0,32,32
1683712210812,BIPN 134,A02,193474,Cooke; James Edward,25,0,32,7
1683712210812,BIPN 134,A03,193485,Cooke; James Edward,29,0,32,3
1683712210812,BIPN 134,A04,193486,Cooke; James Edward,20,0,32,12
1683712210812,BIPN 134,A05,193491,Cooke; James Edward,31,0,32,1
1683712210812,BIPN 134,A06,193501,Cooke; James Edward,30,0,32,2
1683712210812,BIPN 134,A07,193510,Cooke; James Edward,29,0,32,3
1683712212863,BISP 194,A00,222522,Staff,14,0,32,18
1683712213891,CAT 124,A01,202407,Staff,19,0,25,6
1683712214916,CAT 125,A00,202408,Marchisotto; Jennifer Anne,2,0,20,18
1683712215942,CAT 125R,A00,202409,Smith; Lauryn Alissa,0,11,20,20
1683712215942,CAT 125R,B00,202410,Morales; Celeste Georgianna,0,11,20,20
1683712215942,CAT 125R,C00,202411,Irwin; Matthew Joseph,0,12,20,20
1683712216974,CENG 15,A01,204712,Yang; Kesong,0,1,0,0
1683712218002,CENG 114,A00,202070,Jahed Motlagh; Zeinab,5,0,20,15
1683712219034,CGS 105,A00,185477,Wesling; Megan E.,24,0,40,16
1683712220067,CGS 106,A00,185494,Staff,11,0,22,11
1683712221095,CGS 108,A00,185495,Staff,14,0,20,6
1683712222122,CGS 114,A00,185496,Staff,13,0,18,5
1683712223148,CGS 119,A00,185501,Staff,15,0,20,5
1683712224177,CGS 120,A00,185511,Staff,11,0,20,9
1683712225259,CHEM 4,A01,184675,Bussey; Thomas J,97,0,100,3
1683712226289,CHEM 6A,A01,184677,Staff,32,0,60,28
1683712227314,CHEM 6B,A01,184679,Staff,63,0,100,37
1683712228337,CHEM 6C,A01,184681,Bussey; Thomas J,0,0,50,50
1683712228337,CHEM 6C,A02,184682,Bussey; Thomas J,32,0,50,18
1683712229362,CHEM 40A,A01,184684,Albizati; Kim F.,33,0,100,67
1683712230392,CHEM 40B,A01,184686,Albizati; Kim F.,0,22,100,100
1683712231416,CHEM 41B,A01,184690,Staff,51,0,100,49
1683712232441,COGS 3,A01,184715,Boyle; Mary E. T.,0,27,40,40
1683712233468,COGS 14B,A01,185172,Staff,0,14,38,38
1683712234493,COGS 18,A01,184736,Staff,14,0,80,66
1683712235519,COGS 100,A01,184932,Staff,0,8,73,73
1683712236547,COGS 101A,A01,184935,Staff,0,40,30,30
1683712237576,COGS 101B,A01,184944,Staff,0,2,30,30
1683712238605,COGS 101C,A01,184946,Staff,0,10,30,30
1683712239632,COGS 102A,A01,184951,Johnson; Christine M.,1,0,40,39
1683712240658,COGS 107B,A01,184953,Mooshagian; Eric Frederick,0,52,40,40
1683712241688,COGS 118B,A01,184959,Gupta; Anjum,0,50,40,40
1683712242712,COGS 153,A00,184961,Staff,1,16,30,29
1683712243740,COGS 177,A00,184962,Staff,0,20,30,30
1683712244766,COGS 187A,A01,184969,Boyle; Mary E. T.,0,19,40,40
1683712245792,COMM 10,A01,185174,Staff,0,5,25,25
1683712245792,COMM 10,A02,185189,Staff,0,2,25,25
1683712245792,COMM 10,A03,269821,Staff,0,1,0,0
1683712246826,COMM 100B,A02,185476,Staff,10,0,25,15
1683712246826,COMM 100B,A03,277340,Staff,25,0,25,0
1683712247851,COMM 100C,A01,185314,Staff,2,0,25,23
1683712247851,COMM 100C,A02,185327,Staff,17,0,25,8
1683712248884,COMM 110M,A00,185349,Staff,0,0,40,40
1683712249914,COMM 113T,A00,185352,Staff,25,0,40,15
1683712250939,COMM 114I,A00,185353,Staff,31,0,40,9
1683712251965,COMM 131,A00,185354,Staff,17,0,30,13
1683712252993,CSE 8A,A50,185358,Cao; Yingjun,0,46,10,10
1683712254017,CSE 8B,A01,185362,Staff,0,48,50,50
1683712255052,CSE 11,A01,185416,Cao; Yingjun,0,91,10,10
1683712256081,CSE 20,A01,185445,Briones; Jor-el Thomas Caparas,3,0,25,22
1683712257112,CSE 21,A01,185447,Staff,9,0,50,41
1683712258137,CSE 101,A01,185451,Staff,0,13,50,50
1683712258137,CSE 101,B01,185453,Jones; Miles E,0,15,50,50
1683712260191,CSE 141,A01,185458,Eldon; John,16,0,100,84
1683712261265,CSE 141L,A01,185461,Eldon; John,8,0,100,92
1683712262294,CSE 142,A01,185463,Staff,34,0,60,26
1683712262294,CSE 142,B01,201355,Staff,0,7,60,60
1683712263323,CSE 142L,A01,185470,Staff,34,0,60,26
1683712263323,CSE 142L,B01,201417,Staff,0,6,60,60
1683712264347,CSE 190,A00,201433,Staff,32,0,49,17
1683712265374,DOC 1,A01,259136,Strom; Megan C.,7,0,15,8
1683712265374,DOC 1,A02,259137,Strom; Megan C.,15,0,15,0
1683712265374,DOC 1,A03,259138,Strom; Megan C.,14,0,15,1
1683712265374,DOC 1,A04,259139,Strom; Megan C.,13,0,15,2
1683712266399,DOC 100D,A00,259140,Pass; Natalye Joann,14,0,25,11
1683712267425,DSGN 1,A01,184749,Rill; Bryan,0,26,30,30
1683712268453,DSGN 100,A01,185168,Staff,0,2,25,25
1683712269489,ECE 5,A01,185626,Morris; Karcher William,0,12,0,0
1683712270515,ECE 101,A01,185628,Staff,14,0,70,56
1683712271541,ECE 107,A01,185635,Baghdadchi; Saharnaz,0,0,20,20
1683712271541,ECE 107,A02,185638,Baghdadchi; Saharnaz,1,0,20,19
1683712272566,ECE 148,A01,185647,Silberman; Jack,0,0,16,16
1683712273591,ECON 1,A01,185537,Crane; Meredith Helen,54,0,70,16
1683712274623,ECON 3,A01,185549,Crane; Meredith Helen,30,0,70,40
1683712275651,ECON 4,A01,203354,Anderson; John Charles,0,5,10,10
1683712276682,ECON 100A,A01,185574,Staff,0,5,40,40
1683712277710,ECON 100B,A01,185576,Staff,0,12,50,50
1683712278740,ECON 100C,A01,185589,Newhouse; Herbert S,30,0,70,40
1683712279771,ECON 105,A00,185608,Vespa; Emanuel Ignacio,19,0,35,16
1683712280797,ECON 109,A01,185610,Shishkin; Denis,9,0,35,26
1683712281823,ECON 110A,A01,185612,Staff,8,0,40,32
1683712282856,ECON 120A,A01,185615,Staff,19,0,40,21
1683712283887,ECON 120C,A01,185617,Sun; Yixiao,0,21,70,70
1683712284914,ECON 144,A00,203346,Squires; Dale E,2,0,35,33
1683712285940,ECON 171,A01,203349,Newhouse; Herbert S,0,1,35,35
1683712286973,ECON 173A,A01,185621,Toda; Alexis Akira,21,0,35,14
1683712288016,EDS 25,A01,202413,Staff,0,1,0,0
1683712288016,EDS 25,A02,202414,Staff,0,1,0,0
1683712288016,EDS 25,A03,202415,Staff,0,0,0,0
1683712288016,EDS 25,A04,202416,Staff,0,1,0,0
1683712288016,EDS 25,A05,202439,Staff,0,0,0,0
1683712288016,EDS 25,A06,202440,Staff,0,0,0,0
1683712288016,EDS 25,B01,202631,Staff,0,0,0,0
1683712288016,EDS 25,B02,202632,Staff,0,0,0,0
1683712288016,EDS 25,B03,202639,Staff,0,0,0,0
1683712288016,EDS 25,B04,202640,Staff,0,0,0,0
1683712288016,EDS 25,B05,202643,Staff,0,0,0,0
1683712288016,EDS 25,B06,202644,Staff,0,0,0,0
1683712289051,EDS 38,A01,202659,Black; Alison Michelle,25,0,25,0
1683712290076,EDS 115,A00,202652,Staff,18,0,30,12
1683712291099,EDS 125,A00,202649,Staff,13,0,30,17
1683712292125,EDS 126,A01,203332,Staff,30,0,30,0
1683712293150,EDS 139,A00,202838,Staff,16,0,25,9
1683712294174,EDS 146,A01,202655,Staff,14,0,25,11
1683712295207,ENG 15,A00,185667,Staff,0,1,0,0
1683712295207,ENG 15,B00,185672,Staff,0,0,0,0
1683712295207,ENG 15,C00,185675,Staff,0,0,0,0
1683712295207,ENG 15,D00,185682,Staff,0,0,0,0
1683712295207,ENG 15,E00,185684,Staff,0,0,0,0
1683712296234,ETHN 103,A00,185710,Staff,0,8,35,35
1683712297260,ETHN 103A,A00,199228,Man; Simeon S,0,0,9,9
1683712298284,ETHN 109,A00,185711,Staff,15,0,35,20
1683712299312,ETHN 142,A00,185726,Staff,0,4,30,30
1683712300338,ETHN 163J,A00,199229,Man; Simeon S,5,0,8,3
1683712301368,ETHN 168,A00,185727,Staff,7,0,10,3
1683712302393,ETHN 182,A00,185728,Staff,0,0,35,35
1683712303416,ETHN 183,A00,185737,Staff,9,0,18,9
1683712304442,GLBH 111,A01,209361,Burgos; Jose L.,0,0,0,0
1683712306494,HIEU 104,A00,185792,Staff,14,0,20,6
1683712307524,HIEU 115,A00,185800,Staff,0,0,20,20
1683712308550,HIEU 128,A00,185801,Staff,0,9,20,20
1683712309581,HIEU 147,A00,185802,Staff,15,0,20,5
1683712310606,HIEU 154,A00,185823,Staff,11,0,20,9
1683712311631,HILA 102,A00,185826,Staff,14,0,20,6
1683712312657,HILD 2C,A01,185778,Staff,0,13,20,20
1683712313683,HILD 7B,A01,185780,Kwak; Nancy,0,17,32,32
1683712313683,HILD 7B,A02,185781,Kwak; Nancy,0,18,32,32
1683712314709,HILD 30,A01,185791,Staff,12,0,20,8
1683712315734,HISC 119,A00,185830,Golan; Tal,0,10,20,20
1683712316764,HITO 156GS,A00,185831,Patterson; Patrick H.,0,0,0,23
1683712317789,HIUS 103,A00,185832,Man; Simeon S,0,4,20,20
1683712318818,HIUS 117,A00,185836,Kwak; Nancy,2,0,20,18
1683712319846,HIUS 125,A00,185840,Man; Simeon S,0,2,23,23
1683712320876,HIUS 149,A00,185845,Staff,1,0,20,19
1683712321902,HUM 3,A01,185882,Zavodny; Tatiana Sophia,0,8,50,50
1683712321902,HUM 3,B01,185899,Caldwell; Michael Alan,0,18,50,50
1683712322927,HUM 3GS,A00,185900,Patterson; Patrick H.,0,0,0,23
1683712323956,HUM 4,A01,185938,Zroka; Amy Liane,28,0,50,22
1683712323956,HUM 4,B01,185956,Watkins; Eric,0,6,50,50
1683712323956,HUM 4,B02,202209,Watkins; Eric,0,5,50,50
1683712323956,HUM 4,B03,202210,Watkins; Eric,0,5,50,50
1683712324985,HUM 5,A01,185958,West; Geoffrey Scott,0,0,50,50
1683712324985,HUM 5,A02,202215,West; Geoffrey Scott,0,1,50,50
1683712326012,INTL 190,A00,185959,Gagnon; Jeffrey C,0,0,0,9
1683712326012,INTL 190,B00,185960,Lettieri; Michael Joseph,0,0,0,2
1683712327043,JAPN 180,A00,254509,Staff,5,0,30,25
1683712328073,LATI 10,A01,202853,Kennemore; Amy Michelle,4,0,35,31
1683712328073,LATI 10,A02,202854,Kennemore; Amy Michelle,3,0,35,32
1683712328073,LATI 10,A03,270054,Kennemore; Amy Michelle,30,0,30,0
1683712329154,LATI 180,A00,202855,Kennemore; Amy Michelle,11,0,20,9
1683712330180,LAWS 101,A00,201767,Golan; Tal,0,7,40,40
1683712331205,LIFR 1C,A00,185961,Staff,6,0,20,14
1683712332230,LIFR 1CX,A00,185962,Staff,7,0,20,13
1683712333256,LIFR 1D,A00,185963,Staff,7,0,20,13
1683712334281,LIFR 1DX,A00,185964,Staff,7,0,20,13
1683712335310,LIGN 101,A01,186039,Staff,43,0,50,7
1683712336339,LIGN 165,A00,186040,Staff,14,0,50,36
1683712337363,LTCS 108,A00,186041,Staff,5,0,10,5
1683712338388,LTCS 119,A00,186042,Staff,15,0,20,5
1683712339414,LTCS 130,A00,186043,Wesling; Megan E.,15,0,25,10
1683712341474,LTEA 138,A00,186119,Staff,14,0,40,26
1683712342499,LTEN 124,A00,186148,Staff,5,0,25,20
1683712343524,LTEN 178,A00,186149,Staff,6,0,15,9
1683712344550,LTEN 181,A00,186150,Blanco; John D,34,0,40,6
1683712345580,LTWL 120,A00,186160,Staff,19,0,25,6
1683712346606,LTWL 165,A00,186161,Staff,22,0,25,3
1683712347633,LTWR 100,A00,186162,Staff,0,5,15,15
1683712348661,LTWR 102,A00,186163,Doller; Ben,5,0,15,10
1683712349694,MAE 8,A01,186412,Staff,0,1,0,0
1683712350720,MAE 30B,A00,186445,Bahadori; Mohammad Yousef,81,0,100,19
1683712351745,MAE 40,A00,186592,Bewley; Thomas R,10,0,50,40
1683712352773,MAE 101B,A00,186593,Bahadori; Mohammad Yousef,80,0,100,20
1683712353800,MAE 105,A00,186594,Bandaru; Prabhakar,10,0,50,40
1683712354828,MAE 107,A00,186599,Pham; Hieu Tan,0,8,120,120
1683712355854,MAE 148,A01,186660,Silberman; Jack,3,0,16,13
1683712356886,MATH 10A,A01,188095,Staff,0,6,35,35
1683712357914,MATH 10B,A01,188097,Bowers; Adam R.,0,12,30,30
1683712357914,MATH 10B,A02,188099,Bowers; Adam R.,0,11,30,30
1683712357914,MATH 10B,B01,188104,Bowers; Adam R.,0,10,30,30
1683712357914,MATH 10B,B02,188106,Bowers; Adam R.,0,9,30,30
1683712358942,MATH 10C,A01,188111,Staff,0,20,30,30
1683712358942,MATH 10C,A02,188127,Staff,0,19,30,30
1683712358942,MATH 10C,A03,188131,Staff,0,19,30,30
1683712358942,MATH 10C,B01,188218,Staff,17,0,30,13
1683712358942,MATH 10C,B02,188244,Staff,13,0,30,17
1683712358942,MATH 10C,B03,188277,Staff,14,0,30,16
1683712359970,MATH 18,A01,188344,Bach; Quang Tran,18,0,30,12
1683712359970,MATH 18,A02,188345,Bach; Quang Tran,11,0,30,19
1683712359970,MATH 18,B01,188353,Bach; Quang Tran,11,0,30,19
1683712359970,MATH 18,B02,188354,Bach; Quang Tran,19,0,30,11
1683712360998,MATH 20A,A01,188374,Staff,11,0,35,24
1683712362032,MATH 20B,A01,188382,Ohm; Ko Woon,7,0,30,23
1683712362032,MATH 20B,A02,188383,Ohm; Ko Woon,22,0,30,8
1683712362032,MATH 20B,B01,188385,Ohm; Ko Woon,7,0,30,23
1683712362032,MATH 20B,B02,188392,Ohm; Ko Woon,22,0,30,8
1683712363063,MATH 20C,A01,188394,Harel; Guershon,10,0,30,20
1683712363063,MATH 20C,A02,188395,Harel; Guershon,13,0,30,17
1683712363063,MATH 20C,B01,188404,Harel; Guershon,5,0,30,25
1683712363063,MATH 20C,B02,188405,Harel; Guershon,18,0,30,12
1683712364098,MATH 20D,A01,188414,Hammock; Frances H,0,1,30,30
1683712364098,MATH 20D,A02,188415,Hammock; Frances H,0,1,30,30
1683712364098,MATH 20D,B01,188447,Hammock; Frances H,0,1,30,30
1683712364098,MATH 20D,B02,188486,Hammock; Frances H,2,0,30,28
1683712365127,MATH 20E,A01,188649,Staff,21,0,30,9
1683712365127,MATH 20E,A02,188650,Staff,20,0,30,10
1683712365127,MATH 20E,A03,188673,Staff,0,0,30,30
1683712366155,MATH 102,A01,188675,Staff,0,40,35,35
1683712367181,MATH 103B,A01,188681,Staff,3,0,35,32
1683712367181,MATH 103B,B01,188692,Staff,5,0,35,30
1683712368210,MATH 109,A01,188695,Salehi Golsefidy; Alireza,24,0,35,11
1683712368210,MATH 109,A02,188696,Salehi Golsefidy; Alireza,25,0,35,10
1683712369242,MATH 120A,A01,188698,Eggers; John Dietrich,7,0,35,28
1683712370267,MATH 142B,A01,188736,Ioana; Adrian,0,0,30,30
1683712370267,MATH 142B,A02,188741,Ioana; Adrian,0,1,30,30
1683712370267,MATH 142B,A03,188743,Ioana; Adrian,0,2,30,30
1683712371291,MATH 168A,A01,188790,Staff,0,11,35,35
1683712372325,MATH 170A,A01,188803,Nie; Jiawang,0,2,35,35
1683712372325,MATH 170A,A02,188811,Nie; Jiawang,0,1,35,35
1683712372325,MATH 170A,A03,188814,Nie; Jiawang,1,0,35,34
1683712372325,MATH 170A,A04,188815,Nie; Jiawang,5,0,35,30
1683712373352,MATH 193B,A01,188817,Staff,0,0,35,35
1683712373352,MATH 193B,A02,188818,Staff,6,0,35,29
1683712374380,MGT 4,A01,202857,Anderson; John Charles,59,0,80,21
1683712375411,MGT 12,A00,202858,Lindenberger; Wade Douglas,40,0,90,50
1683712376436,MGT 18,A00,202859,Staff,73,0,90,17
1683712377467,MGT 18GS,A00,202860,McKay; Michael J,13,0,28,15
1683712378497,MGT 45,A00,202861,Pecore; Joseph P.,8,0,90,82
1683712379524,MGT 100,A00,202863,Yavorsky; Daniel Ryan,27,0,90,63
1683712380550,MGT 103,A00,202864,Ehrich; Kristine R,0,19,90,90
1683712381581,MGT 112,A00,202865,Ehrich; Kristine R,15,0,90,75
1683712382609,MGT 121A,A00,202868,Staff,70,0,90,20
1683712383640,MGT 131B,A00,202869,Anderson; John Charles,58,0,90,32
1683712384671,MGT 136,A00,202871,Lindenberger; Wade Douglas,83,0,90,7
1683712385696,MGT 164,A00,202873,Staff,0,67,90,91
1683712386728,MGT 164GS,A00,202874,McKay; Mary A,13,0,28,15
1683712387758,MGT 180,A00,202875,Staff,0,51,90,91
1683712388785,MMW 11R,A01,205019,Herbst; Matthew,0,0,30,30
1683712388785,MMW 11R,A02,205026,Herbst; Matthew,29,0,30,1
1683712389824,MMW 15,A01,193512,Chang; Edmond Yi-Teh,0,8,28,28
1683712389824,MMW 15,A02,193513,Chang; Edmond Yi-Teh,0,5,28,28
1683712389824,MMW 15,A03,193514,Chang; Edmond Yi-Teh,0,5,28,28
1683712389824,MMW 15,A04,193515,Chang; Edmond Yi-Teh,0,5,28,28
1683712389824,MMW 15,A05,193516,Chang; Edmond Yi-Teh,0,5,28,28
1683712389824,MMW 15,A06,193517,Chang; Edmond Yi-Teh,0,6,28,28
1683712389824,MMW 15,B01,193519,Chang; Edmond Yi-Teh,0,5,28,28
1683712389824,MMW 15,B02,193520,Chang; Edmond Yi-Teh,0,5,28,28
1683712389824,MMW 15,B03,193521,Chang; Edmond Yi-Teh,0,5,28,28
1683712389824,MMW 15,B04,193522,Chang; Edmond Yi-Teh,0,6,28,28
1683712389824,MMW 15,B05,193523,Chang; Edmond Yi-Teh,0,5,28,28
1683712389824,MMW 15,B06,193524,Chang; Edmond Yi-Teh,0,5,28,28
1683712390851,MMW 122,A01,193526,Rahimi; Babak,0,16,28,28
1683712390851,MMW 122,A02,193527,Rahimi; Babak,0,15,28,28
1683712390851,MMW 122,A03,193528,Rahimi; Babak,0,0,0,0
1683712390851,MMW 122,A04,193529,Rahimi; Babak,0,0,0,0
1683712391882,MUS 1A,A01,186663,Staff,0,18,35,35
1683712392914,MUS 4,A01,186715,Staff,0,12,35,35
1683712393941,MUS 5R,A01,186796,Dubnov; Shlomo,0,17,35,35
1683712394966,MUS 6,A01,186798,Staff,0,4,25,25
1683712395994,MUS 7,A01,186830,Staff,11,0,35,24
1683712397021,MUS 8,A01,186930,Staff,0,27,35,35
1683712398047,MUS 15,A01,186932,Staff,0,15,35,35
1683712398047,MUS 15,B01,186934,Staff,0,16,35,35
1683712399078,MUS 80,A00,186935,Staff,0,0,20,20
1683712399078,MUS 80,B00,186936,Staff,24,0,25,1
1683712400114,NANO 11,A00,204702,Lipomi; Darren John,0,0,0,0
1683712401147,NANO 15,A01,204709,Yang; Kesong,0,1,0,0
1683712402174,NANO 114,A00,202069,Jahed Motlagh; Zeinab,2,0,10,8
1683712403199,PHIL 1,A00,186955,Grush; Rick Scott,31,0,40,9
1683712404230,PHIL 10,A01,186973,Grush; Rick Scott,27,0,35,8
1683712404230,PHIL 10,A02,186974,Grush; Rick Scott,33,0,35,2
1683712405254,PHIL 13,A01,186976,Staff,1,0,35,34
1683712405254,PHIL 13,A02,186977,Staff,16,0,35,19
1683712406280,PHIL 14,A01,186979,Staff,30,0,35,5
1683712406280,PHIL 14,A02,186986,Staff,32,0,35,3
1683712407305,PHIL 28,A01,186988,Staff,16,0,30,14
1683712407305,PHIL 28,A02,186989,Staff,0,0,30,30
1683712407305,PHIL 28,A03,186990,Staff,10,0,30,20
1683712407305,PHIL 28,A04,186991,Staff,26,0,30,4
1683712408330,PHIL 120,A00,186997,Staff,23,0,40,17
1683712409356,PHIL 137,A00,187003,Staff,8,0,40,32
1683712410381,PHIL 150,A00,187015,Staff,47,0,70,23
1683712411411,PHIL 167,A00,187021,Lamey; Andy M.,34,0,40,6
1683712412436,PHIL 174,A01,202226,Staff,17,0,20,3
1683712412436,PHIL 174,A02,202235,Staff,20,0,20,0
1683712413463,PHIL 191A,A00,258918,Staff,0,0,1,1
1683712414489,PHYS 1A,A00,187028,Staff,26,0,60,34
1683712415514,PHYS 1AL,001,187036,Staff,3,0,30,27
1683712415514,PHYS 1AL,002,187049,Staff,18,0,30,12
1683712416543,PHYS 1B,A00,187058,Staff,21,0,60,39
1683712417571,PHYS 1BL,001,187064,Staff,0,1,30,30
1683712417571,PHYS 1BL,002,187070,Staff,4,0,30,26
1683712418602,PHYS 1C,A00,187082,Staff,30,0,120,90
1683712419629,PHYS 1CL,001,187088,Staff,0,9,30,30
1683712419629,PHYS 1CL,002,187089,Staff,0,1,30,30
1683712419629,PHYS 1CL,009,262693,Staff,9,0,30,21
1683712420656,PHYS 2B,A01,187097,Staff,55,0,115,60
1683712421682,PHYS 2C,A01,187099,Staff,63,0,115,52
1683712422712,PHYS 2CL,A01,187101,Staff,5,0,28,23
1683712422712,PHYS 2CL,A02,187102,Staff,15,0,28,13
1683712423739,PHYS 2D,A01,187123,Shotwell; Brian,95,0,115,20
1683712424767,PHYS 4B,A01,187133,Grinstein; Benjamin,35,0,50,15
1683712425792,POLI 10,A00,188819,Staff,0,4,50,50
1683712426822,POLI 11,A00,188827,Staff,43,0,50,7
1683712427852,POLI 13R,A00,188828,Staff,0,1,20,20
1683712428878,POLI 27,A01,188830,Elgin; Samuel Zincke,0,2,70,70
1683712429906,POLI 30,A00,188832,Desposato; Scott,30,0,50,20
1683712430932,POLI 102F,A00,188834,Staff,1,0,40,39
1683712431960,POLI 104A,A00,188852,Staff,12,0,30,18
1683712433044,POLI 104I,A00,188853,Staff,0,8,20,20
1683712434070,POLI 110B,A00,188854,Wiens; David,6,0,20,14
1683712435095,POLI 112A,A00,188855,Wiens; David,3,0,30,27
1683712436120,POLI 117R,A00,188856,Forman; Fonna,0,12,20,20
1683712437149,POLI 118,A00,188857,Ingham; Sean,8,0,20,12
1683712438173,POLI 120G,A00,188858,Staff,7,0,30,23
1683712439203,POLI 131CR,A00,188863,Hoston; Germaine,20,0,50,30
1683712440231,POLI 133,A00,188864,Nellis; Gareth Hb,44,0,50,6
1683712441261,POLI 134D,A00,188865,Desposato; Scott,27,0,30,3
1683712442293,POLI 142A,A00,188871,Gartzke; Erik,21,0,50,29
1683712443321,POLI 142K,A00,188874,Staff,38,0,50,12
1683712444350,POLI 143,A00,188940,Gartzke; Erik,15,0,30,15
1683712445378,POLI 153,A00,188943,Staff,1,0,20,19
1683712446405,POLI 160AA,A00,188944,Staff,10,0,40,30
1683712447437,POLI 170A,A00,188945,Staff,10,0,30,20
1683712449485,PSYC 1,A00,188952,Staff,36,0,90,54
1683712450516,PSYC 2,B00,188953,Staff,19,0,35,16
1683712451546,PSYC 6,A00,188970,Staff,47,0,60,13
1683712452570,PSYC 7,A00,188973,Staff,35,0,45,10
1683712453597,PSYC 60,A01,188980,Rickard; Timothy C.,42,0,60,18
1683712454622,PSYC 70,A01,189001,Steiner; Eric Tomas,22,0,45,23
1683712455647,PSYC 100,A00,189005,Lacefield; Katharine I,1,98,120,119
1683712456672,PSYC 102,A00,189008,Staff,6,0,30,24
1683712457701,PSYC 106,B00,189026,Gorman; Michael R.,27,0,60,33
1683712458725,PSYC 114,B01,189033,Winkielman; Piotr,0,31,30,30
1683712459751,PSYC 131,A00,189036,Anagnostaras; Stephan,0,44,60,60
1683712460777,PSYC 136,A00,189041,Lowe; Angela Beth,0,7,25,25
1683712461803,PSYC 137,A00,189057,Winkielman; Piotr,0,36,25,25
1683712462832,PSYC 144,A00,189107,Wixted; John T,0,11,50,50
1683712464884,PSYC 162,A00,189142,Staff,0,9,85,85
1683712465909,PSYC 172,A00,189144,Gorman; Michael R.,0,6,30,30
1683712467970,PSYC 179,A00,189146,Lacefield; Katharine I,0,88,120,120
1683712468995,PSYC 181,A00,189147,Anagnostaras; Stephan,0,45,90,90
1683712470022,PSYC 190R,A00,189148,Barner; David A.,0,23,80,80
1683712471047,PSYC 191,A00,189275,Rickard; Timothy C.,0,11,25,25
1683712472073,PSYC 193,A00,189276,Chapman; Eddie Nathaniel,0,1,0,4
1683712473106,PSYC 193L,A01,189281,Lowe; Angela Beth,8,0,20,12
1683712473106,PSYC 193L,B01,189285,Staff,28,0,35,7
1683712474138,RELI 149,A00,187137,Rahimi; Babak,6,0,40,34
1683712475169,SE 9,A01,187315,Staff,0,2,18,18
1683712476201,SE 101B,A00,187409,Staff,24,0,30,6
1683712477231,SE 110B,A00,187444,Staff,10,0,40,30
1683712478262,SE 130B,A00,187449,Staff,31,0,40,9
1683712479290,SE 150A,A00,187516,Staff,8,0,20,12
1683712480318,SE 154,A00,187528,Staff,29,0,50,21
1683712481345,SIO 3,A01,258171,Staff,35,0,40,5
1683712482377,SIO 10,A00,187144,Cook; Geoffrey W,0,6,75,75
1683712483401,SIO 45,A00,187152,Cook; Geoffrey W,1,7,100,99
1683712484427,SIO 109R,A00,194486,Staff,0,4,20,20
1683712486481,SIO 187,A01,187233,Kacev; David,12,0,40,28
1683712487517,SOCI 1,A01,258656,Thorpe; Charles Robert,28,0,30,2
1683712487517,SOCI 1,A02,258658,Thorpe; Charles Robert,30,0,30,0
1683712487517,SOCI 1,A03,258661,Thorpe; Charles Robert,25,0,25,0
1683712487517,SOCI 1,A04,258666,Thorpe; Charles Robert,22,0,25,3
1683712487517,SOCI 1,A05,258897,Thorpe; Charles Robert,22,0,25,3
1683712487517,SOCI 1,A06,258898,Thorpe; Charles Robert,25,0,25,0
1683712488547,SOCI 30,A01,258903,Pardo Guerra; Juan Pablo,14,0,30,16
1683712489572,SOCI 102,A00,258904,Staff,9,0,25,16
1683712490595,SOCI 106,A00,258905,Staff,19,0,25,6
1683712491624,SOCI 111,A00,258907,Ribas Norris; Janet Vanesa,26,0,30,4
1683712492649,SOCI 121R,A00,258908,Pardo Guerra; Juan Pablo,7,0,30,23
1683712493674,SOCI 126,A01,203330,Staff,14,0,20,6
1683712494704,SOCI 131,A00,258909,Thorpe; Charles Robert,30,0,60,30
1683712495733,SOCI 135,A00,258910,Payne; Christine Anna,0,13,30,30
1683712496758,SOCI 157,A00,258911,Staff,10,0,30,20
1683712497784,SOCI 184,A00,258912,Staff,25,0,30,5
1683712498810,SOCI 188D,A00,258913,Staff,22,0,30,8
1683712499836,SYN 2,001,187529,Staff,9,0,16,7
1683712499836,SYN 2,002,201452,Staff,0,20,16,16
1683712499836,SYN 2,003,201469,Staff,1,0,16,15
1683712500865,SYN 100,A01,187531,Staff,0,9,20,20
1683712500865,SYN 100,B01,201491,Staff,0,10,20,20
1683712501893,TDAC 1,A00,189286,Walsh; Kim C.,3,0,20,17
1683712501893,TDAC 1,B00,189287,Harting; Carla Kelso,10,0,20,10
1683712502918,TDAC 101,A00,189300,Walsh; Kim C.,16,0,20,4
1683712502918,TDAC 101,B00,189301,Harting; Carla Kelso,18,0,20,2
1683712503945,TDAC 102,A00,189304,Basso; Beatrice,14,0,20,6
1683712504970,TDAC 108,A00,189305,Staff,18,0,20,2
1683712505997,TDDE 131,A00,189310,Staff,19,0,20,1
1683712505997,TDDE 131,B00,189314,Staff,19,0,20,1
1683712505997,TDDE 131,C00,189315,Staff,48,0,50,2
1683712505997,TDDE 131,D00,189316,Staff,14,0,15,1
1683712505997,TDDE 131,E00,204841,Staff,20,0,20,0
1683712507022,TDGE 10,A00,189289,Staff,27,0,50,23
1683712507022,TDGE 10,B00,189290,Havis; Allan,0,1,50,50
1683712508054,TDGE 11,A00,189291,Fulton; Julia,0,4,50,50
1683712508054,TDGE 11,B00,189292,Staff,20,0,25,5
1683712508054,TDGE 11,C00,260270,Staff,0,0,0,0
1683712509078,TDGE 25,A00,189294,Staff,1,0,20,19
1683712510106,TDGE 124,A00,189318,Fulton; Julia,0,7,50,50
1683712511134,TDGE 125,A00,189319,Staff,13,0,25,12
1683712511134,TDGE 125,B00,189320,Staff,23,0,25,2
1683712512162,TDGE 127,A00,189322,Havis; Allan,1,0,50,49
1683712513191,TDHT 101,A00,189323,Staff,18,0,25,7
1683712513191,TDHT 101,B00,189324,Staff,25,0,25,0
1683712514218,TDHT 102,A00,189325,Staff,49,0,50,1
1683712515243,TDMV 1,A00,189295,Arcidiacono; Kristin,20,0,30,10
1683712515243,TDMV 1,B00,189296,Caligagan; Maria T.,23,0,30,7
1683712516268,TDMV 2,A00,189297,Sammartano; Tonnie,27,0,30,3
1683712516268,TDMV 2,B00,189299,Arcidiacono; Kristin,23,0,30,7
1683712517299,TDMV 3,A00,204998,Rincon; Alicia,22,0,30,8
1683712518324,TDMV 120,A00,189458,Sammartano; Tonnie,28,0,30,2
1683712519353,TDMV 138,A00,189541,Jun; Grace Shin Hae,20,0,40,20
1683712520378,TDMV 142,A00,189717,Caligagan; Tony,25,0,30,5
1683712520378,TDMV 142,B00,189718,Caligagan; Maria T.,25,0,30,5
1683712521404,TMC 2,A01,187533,Staff,25,0,25,0
1683712521404,TMC 2,A02,187534,Staff,25,0,25,0
1683712522433,USP 1,A01,187536,Kwak; Nancy,0,16,25,25
1683712523457,USP 5,A01,187538,Staff,8,0,25,17
1683712524486,USP 101,A00,199253,Staff,0,4,0,0
1683712525516,USP 124,A00,187562,Boomhower; Matthew Charles,0,0,30,30
1683712526546,USP 138,A00,187582,Staff,19,0,25,6
1683712527574,USP 152,A01,187597,Staff,3,0,25,22
1683712528601,USP 153,A00,187598,Staff,18,0,25,7
1683712529627,USP 168,A00,187607,Kwak; Nancy,2,0,5,3
1683712530656,USP 173,A00,187619,Staff,4,0,25,21
1683712531683,USP 181,A00,187638,Staff,0,4,25,25
1683712532709,VIS 103,A00,187650,Cruz; Edwin Teddy,17,0,75,58
1683712533734,VIS 110D,A00,187669,Staff,13,0,22,9
1683712534760,VIS 127C,A00,187720,Shen; Kuiyi,67,0,146,79
1683712535784,VIS 149,A00,187731,Yoldas; Pinar,0,12,22,22
1683712536868,VIS 151,A01,188091,Staff,22,0,34,12
1683712536868,VIS 151,A02,188092,Staff,11,0,34,23
1683712537898,VIS 160B,A00,188093,Stalbaum; Brett,0,1,10,10
1683712539949,WCWP 10B,A00,201720,Staff,0,0,5,5
1683712539949,WCWP 10B,B00,201722,Staff,0,0,6,6
1683712540980,WCWP 100,A00,201725,Gagnon; Jeffrey C,0,0,2,2
1683712540980,WCWP 100,B00,201727,Staff,0,4,15,15
1683712544117,ANBI 133,A00,258401,Wilder; Linnea Lorene,34,0,40,6
1683712545146,ANBI 140,A00,258395,Hrvoj Mihic; Branka,18,0,25,7
1683712546171,ANSC 120,A00,258402,Bialecki; Jon Anthony,26,0,40,14
1683712547196,ANSC 144,A00,258400,Staff,12,0,40,28
1683712549250,ANSC 166,A00,258396,Parish; Steven Martin,156,0,175,19
1683712550279,ANSC 180,A00,193533,Staff,8,0,20,12
1683712551308,ANSC 188,A00,258397,Jassal; Aftab,34,0,40,6
1683712552334,ANTH 3,A01,258316,Staff,23,0,30,7
1683712553370,ANTH 5,A00,258394,Semendeferi; Ekaterini,16,0,20,4
1683712554397,ANTH 21,A01,258331,Staff,4,0,40,36
1683712555423,ANTH 103,A00,258398,Varma; Saiba,15,0,25,10
1683712556462,AWP 10,001,202034,Staff,0,0,0,0
1683712556462,AWP 10,002,202035,Staff,0,0,0,0
1683712556462,AWP 10,003,202036,Staff,0,0,0,0
1683712556462,AWP 10,004,202037,Staff,0,0,0,0
1683712556462,AWP 10,005,202038,Staff,0,0,0,0
1683712556462,AWP 10,006,202039,Staff,0,0,0,0
1683712556462,AWP 10,007,202040,Staff,0,0,0,0
1683712556462,AWP 10,008,202041,Staff,0,0,0,0
1683712556462,AWP 10,009,202042,Staff,0,0,0,0
1683712556462,AWP 10,010,202043,Staff,0,0,0,0
1683712556462,AWP 10,011,202044,Staff,0,0,0,0
1683712556462,AWP 10,012,202045,Staff,0,0,0,0
1683712556462,AWP 10,013,202046,Staff,0,0,0,0
1683712556462,AWP 10,014,202047,Staff,0,0,0,0
1683712556462,AWP 10,015,202048,Staff,0,0,0,0
1683712556462,AWP 10,016,202049,Staff,0,0,0,0
1683712556462,AWP 10,017,202050,Staff,0,0,0,0
1683712556462,AWP 10,018,202051,Staff,0,0,0,0
1683712556462,AWP 10,019,202052,Staff,0,0,0,0
1683712556462,AWP 10,020,202053,Staff,0,0,0,0
1683712556462,AWP 10,021,202054,Staff,0,0,0,0
1683712556462,AWP 10,022,202055,Staff,0,0,0,0
1683712556462,AWP 10,023,202056,Staff,0,0,0,0
1683712556462,AWP 10,024,202057,Staff,0,0,0,0
1683712556462,AWP 10,025,202058,Staff,0,0,0,0
1683712556462,AWP 10,026,202059,Staff,0,0,0,0
1683712557512,AWP 102,001,202032,Staff,0,0,0,0
1683712557512,AWP 102,002,202033,Staff,0,0,0,0
1683712558539,BENG 100,A01,254234,Taylor Amos; Alyssa C,31,0,40,9
1683712559564,BENG 196,001,270013,Engler; Adam J.,9999,0,9999,0
1683712560593,BICD 100R,A01,202018,Smith; Laurie,0,7,32,32
1683712560593,BICD 100R,A02,202019,Smith; Laurie,0,3,32,32
1683712560593,BICD 100R,A03,202020,Smith; Laurie,0,1,32,32
1683712560593,BICD 100R,A04,202021,Smith; Laurie,6,0,32,26
1683712560593,BICD 100R,A05,202022,Smith; Laurie,10,0,32,22
1683712561623,BICD 136,A01,193242,Gustafson-Brown; Cindy,0,2,32,32
1683712561623,BICD 136,A02,193244,Gustafson-Brown; Cindy,13,0,32,19
1683712562652,BIEB 102,A01,193249,Butler; Shannon Rhey,0,0,32,32
1683712562652,BIEB 102,A02,193251,Butler; Shannon Rhey,0,0,32,32
1683712562652,BIEB 102,A03,193253,Butler; Shannon Rhey,0,0,32,32
1683712562652,BIEB 102,A04,193255,Butler; Shannon Rhey,13,0,32,19
1683712562652,BIEB 102,A05,193265,Butler; Shannon Rhey,25,0,32,7
1683712562652,BIEB 102,A06,193269,Butler; Shannon Rhey,12,0,32,20
1683712564706,BIEB 150,A01,193274,Staff,0,0,32,32
1683712564706,BIEB 150,A02,193285,Staff,24,0,32,8
1683712565736,BIEB 194,A00,193286,Kurle; Carolyn M.,19,0,32,13
1683712566770,BILD 1,A01,192291,Staff,15,0,32,17
1683712566770,BILD 1,A02,192292,Staff,30,0,32,2
1683712566770,BILD 1,B01,192520,Reuther; Keefe,0,1,0,0
1683712566770,BILD 1,B02,192532,Reuther; Keefe,0,1,0,0
1683712567798,BILD 3,A01,192556,Butler; Shannon Rhey,0,0,32,32
1683712567798,BILD 3,A02,192581,Butler; Shannon Rhey,0,1,32,32
1683712567798,BILD 3,A03,192611,Butler; Shannon Rhey,19,0,32,13
1683712567798,BILD 3,A04,192612,Butler; Shannon Rhey,23,0,32,9
1683712567798,BILD 3,A05,192613,Butler; Shannon Rhey,26,0,32,6
1683712567798,BILD 3,A06,192679,Butler; Shannon Rhey,27,0,32,5
1683712567798,BILD 3,A07,192682,Butler; Shannon Rhey,20,0,32,12
1683712568823,BILD 4,A01,192836,Reuther; Keefe,1,0,24,23
1683712568823,BILD 4,A02,193044,Reuther; Keefe,4,0,24,20
1683712569850,BILD 10,A01,193142,Gustafson-Brown; Cindy,29,0,32,3
1683712569850,BILD 10,A02,193149,Gustafson-Brown; Cindy,31,0,32,1
1683712570874,BIMM 100,A01,193301,Staff,0,6,32,32
1683712570874,BIMM 100,A02,193312,Staff,0,7,32,32
1683712570874,BIMM 100,A03,193323,Staff,0,10,32,32
1683712571902,BIMM 101,A01,193329,McDonnell; Lisa Marie,0,3,24,24
1683712571902,BIMM 101,A02,193339,McDonnell; Lisa Marie,0,3,24,24
1683712571902,BIMM 101,B01,193354,McDonnell; Lisa Marie,0,4,24,24
1683712571902,BIMM 101,B02,193357,McDonnell; Lisa Marie,0,3,24,24
1683712572929,BIMM 110,A01,193377,Tat; John,0,11,32,32
1683712572929,BIMM 110,A02,193378,Tat; John,0,11,32,32
1683712573962,BIMM 120,A01,206116,Staff,0,0,32,32
1683712573962,BIMM 120,A02,206117,Staff,7,0,32,25
1683712573962,BIMM 120,A03,206121,Staff,21,0,32,11
1683712574990,BIPN 100,A01,193393,Park; Ji Young,0,15,32,32
1683712574990,BIPN 100,A02,193402,Park; Ji Young,0,14,32,32
1683712574990,BIPN 100,A03,193413,Park; Ji Young,0,14,32,32
1683712574990,BIPN 100,A04,193414,Park; Ji Young,0,13,32,32
1683712576016,BIPN 102,A01,193429,Staff,0,0,32,32
1683712576016,BIPN 102,A02,193438,Staff,18,0,32,14
1683712577047,BIPN 106,A01,193450,Reyes Gonzalez; Catalina,0,2,40,40
1683712578078,BIPN 134,A01,193465,Cooke; James Edward,0,0,32,32
1683712578078,BIPN 134,A02,193474,Cooke; James Edward,25,0,32,7
1683712578078,BIPN 134,A03,193485,Cooke; James Edward,29,0,32,3
1683712578078,BIPN 134,A04,193486,Cooke; James Edward,20,0,32,12
1683712578078,BIPN 134,A05,193491,Cooke; James Edward,31,0,32,1
1683712578078,BIPN 134,A06,193501,Cooke; James Edward,30,0,32,2
1683712578078,BIPN 134,A07,193510,Cooke; James Edward,29,0,32,3
1683712580134,BISP 194,A00,222522,Staff,14,0,32,18
1683712581163,CAT 124,A01,202407,Staff,19,0,25,6
1683712582194,CAT 125,A00,202408,Marchisotto; Jennifer Anne,2,0,20,18
1683712583222,CAT 125R,A00,202409,Smith; Lauryn Alissa,0,11,20,20
1683712583222,CAT 125R,B00,202410,Morales; Celeste Georgianna,0,11,20,20
1683712583222,CAT 125R,C00,202411,Irwin; Matthew Joseph,0,12,20,20
1683712584255,CENG 15,A01,204712,Yang; Kesong,0,1,0,0
1683712585286,CENG 114,A00,202070,Jahed Motlagh; Zeinab,5,0,20,15
1683712586313,CGS 105,A00,185477,Wesling; Megan E.,24,0,40,16
1683712587337,CGS 106,A00,185494,Staff,11,0,22,11
1683712588361,CGS 108,A00,185495,Staff,14,0,20,6
1683712589391,CGS 114,A00,185496,Staff,13,0,18,5
1683712590415,CGS 119,A00,185501,Staff,15,0,20,5
1683712591440,CGS 120,A00,185511,Staff,11,0,20,9
1683712592468,CHEM 4,A01,184675,Bussey; Thomas J,97,0,100,3
1683712593494,CHEM 6A,A01,184677,Staff,32,0,60,28
1683712594526,CHEM 6B,A01,184679,Staff,63,0,100,37
1683712595552,CHEM 6C,A01,184681,Bussey; Thomas J,0,0,50,50
1683712595552,CHEM 6C,A02,184682,Bussey; Thomas J,32,0,50,18
1683712596583,CHEM 40A,A01,184684,Albizati; Kim F.,33,0,100,67
1683712597612,CHEM 40B,A01,184686,Albizati; Kim F.,0,22,100,100
1683712598638,CHEM 41B,A01,184690,Staff,51,0,100,49
1683712599663,COGS 3,A01,184715,Boyle; Mary E. T.,0,27,40,40
1683712600695,COGS 14B,A01,185172,Staff,0,14,38,38
1683712601724,COGS 18,A01,184736,Staff,14,0,80,66
1683712602750,COGS 100,A01,184932,Staff,0,8,73,73
1683712603779,COGS 101A,A01,184935,Staff,0,40,30,30
1683712604806,COGS 101B,A01,184944,Staff,0,2,30,30
1683712605830,COGS 101C,A01,184946,Staff,0,10,30,30
1683712606862,COGS 102A,A01,184951,Johnson; Christine M.,1,0,40,39
1683712607892,COGS 107B,A01,184953,Mooshagian; Eric Frederick,0,52,40,40
1683712608917,COGS 118B,A01,184959,Gupta; Anjum,0,50,40,40
1683712609946,COGS 153,A00,184961,Staff,1,16,30,29
1683712610973,COGS 177,A00,184962,Staff,0,20,30,30
1683712611999,COGS 187A,A01,184969,Boyle; Mary E. T.,0,19,40,40
1683712613032,COMM 10,A01,185174,Staff,0,5,25,25
1683712613032,COMM 10,A02,185189,Staff,0,2,25,25
1683712613032,COMM 10,A03,269821,Staff,0,1,0,0
1683712614065,COMM 100B,A02,185476,Staff,10,0,25,15
1683712614065,COMM 100B,A03,277340,Staff,25,0,25,0
1683712615095,COMM 100C,A01,185314,Staff,2,0,25,23
1683712615095,COMM 100C,A02,185327,Staff,17,0,25,8
1683712616121,COMM 110M,A00,185349,Staff,0,0,40,40
1683712617149,COMM 113T,A00,185352,Staff,25,0,40,15
1683712618179,COMM 114I,A00,185353,Staff,31,0,40,9
1683712619204,COMM 131,A00,185354,Staff,17,0,30,13
1683712620229,CSE 8A,A50,185358,Cao; Yingjun,0,46,10,10
1683712621253,CSE 8B,A01,185362,Staff,0,48,50,50
1683712622284,CSE 11,A01,185416,Cao; Yingjun,0,91,10,10
1683712623310,CSE 20,A01,185445,Briones; Jor-el Thomas Caparas,3,0,25,22
1683712624339,CSE 21,A01,185447,Staff,9,0,50,41
1683712625368,CSE 101,A01,185451,Staff,0,13,50,50
1683712625368,CSE 101,B01,185453,Jones; Miles E,0,15,50,50
1683712627420,CSE 141,A01,185458,Eldon; John,16,0,100,84
1683712628449,CSE 141L,A01,185461,Eldon; John,8,0,100,92
1683712629480,CSE 142,A01,185463,Staff,34,0,60,26
1683712629480,CSE 142,B01,201355,Staff,0,7,60,60
1683712630509,CSE 142L,A01,185470,Staff,34,0,60,26
1683712630509,CSE 142L,B01,201417,Staff,0,6,60,60
1683712631539,CSE 190,A00,201433,Staff,32,0,49,17
1683712632577,DOC 1,A01,259136,Strom; Megan C.,7,0,15,8
1683712632577,DOC 1,A02,259137,Strom; Megan C.,15,0,15,0
1683712632577,DOC 1,A03,259138,Strom; Megan C.,14,0,15,1
1683712632577,DOC 1,A04,259139,Strom; Megan C.,13,0,15,2
1683712633613,DOC 100D,A00,259140,Pass; Natalye Joann,14,0,25,11
1683712634645,DSGN 1,A01,184749,Rill; Bryan,0,26,30,30
1683712635669,DSGN 100,A01,185168,Staff,0,2,25,25
1683712636695,ECE 5,A01,185626,Morris; Karcher William,0,12,0,0
1683712637719,ECE 101,A01,185628,Staff,14,0,70,56
1683712638748,ECE 107,A01,185635,Baghdadchi; Saharnaz,0,0,20,20
1683712638748,ECE 107,A02,185638,Baghdadchi; Saharnaz,1,0,20,19
1683712639774,ECE 148,A01,185647,Silberman; Jack,0,0,16,16
1683712640858,ECON 1,A01,185537,Crane; Meredith Helen,54,0,70,16
1683712641887,ECON 3,A01,185549,Crane; Meredith Helen,30,0,70,40
1683712642914,ECON 4,A01,203354,Anderson; John Charles,0,5,10,10
1683712643942,ECON 100A,A01,185574,Staff,0,5,40,40
1683712644973,ECON 100B,A01,185576,Staff,0,12,50,50
1683712645998,ECON 100C,A01,185589,Newhouse; Herbert S,30,0,70,40
1683712647029,ECON 105,A00,185608,Vespa; Emanuel Ignacio,19,0,35,16
1683712648055,ECON 109,A01,185610,Shishkin; Denis,9,0,35,26
1683712649080,ECON 110A,A01,185612,Staff,8,0,40,32
1683712650112,ECON 120A,A01,185615,Staff,19,0,40,21
1683712651137,ECON 120C,A01,185617,Sun; Yixiao,0,21,70,70
1683712652165,ECON 144,A00,203346,Squires; Dale E,2,0,35,33
1683712653193,ECON 171,A01,203349,Newhouse; Herbert S,0,1,35,35
1683712654225,ECON 173A,A01,185621,Toda; Alexis Akira,21,0,35,14
1683712655255,EDS 25,A01,202413,Staff,0,1,0,0
1683712655255,EDS 25,A02,202414,Staff,0,1,0,0
1683712655255,EDS 25,A03,202415,Staff,0,0,0,0
1683712655255,EDS 25,A04,202416,Staff,0,1,0,0
1683712655255,EDS 25,A05,202439,Staff,0,0,0,0
1683712655255,EDS 25,A06,202440,Staff,0,0,0,0
1683712655255,EDS 25,B01,202631,Staff,0,0,0,0
1683712655255,EDS 25,B02,202632,Staff,0,0,0,0
1683712655255,EDS 25,B03,202639,Staff,0,0,0,0
1683712655255,EDS 25,B04,202640,Staff,0,0,0,0
1683712655255,EDS 25,B05,202643,Staff,0,0,0,0
1683712655255,EDS 25,B06,202644,Staff,0,0,0,0
1683712656282,EDS 38,A01,202659,Black; Alison Michelle,25,0,25,0
1683712657310,EDS 115,A00,202652,Staff,18,0,30,12
1683712658336,EDS 125,A00,202649,Staff,13,0,30,17
1683712659362,EDS 126,A01,203332,Staff,30,0,30,0
1683712660387,EDS 139,A00,202838,Staff,16,0,25,9
1683712661415,EDS 146,A01,202655,Staff,14,0,25,11
1683712662441,ENG 15,A00,185667,Staff,0,1,0,0
1683712662441,ENG 15,B00,185672,Staff,0,0,0,0
1683712662441,ENG 15,C00,185675,Staff,0,0,0,0
1683712662441,ENG 15,D00,185682,Staff,0,0,0,0
1683712662441,ENG 15,E00,185684,Staff,0,0,0,0
1683712663468,ETHN 103,A00,185710,Staff,0,8,35,35
1683712664499,ETHN 103A,A00,199228,Man; Simeon S,0,0,9,9
1683712665528,ETHN 109,A00,185711,Staff,15,0,35,20
1683712666557,ETHN 142,A00,185726,Staff,0,4,30,30
1683712667583,ETHN 163J,A00,199229,Man; Simeon S,5,0,8,3
1683712668607,ETHN 168,A00,185727,Staff,7,0,10,3
1683712669632,ETHN 182,A00,185728,Staff,0,0,35,35
1683712670658,ETHN 183,A00,185737,Staff,9,0,18,9
1683712671691,GLBH 111,A01,209361,Burgos; Jose L.,0,0,0,0
1683712673742,HIEU 104,A00,185792,Staff,14,0,20,6
1683712674767,HIEU 115,A00,185800,Staff,0,0,20,20
1683712675793,HIEU 128,A00,185801,Staff,0,9,20,20
1683712676821,HIEU 147,A00,185802,Staff,15,0,20,5
1683712677846,HIEU 154,A00,185823,Staff,11,0,20,9
1683712678874,HILA 102,A00,185826,Staff,14,0,20,6
1683712679902,HILD 2C,A01,185778,Staff,0,13,20,20
1683712680928,HILD 7B,A01,185780,Kwak; Nancy,0,17,32,32
1683712680928,HILD 7B,A02,185781,Kwak; Nancy,0,18,32,32
1683712681957,HILD 30,A01,185791,Staff,12,0,20,8
1683712682983,HISC 119,A00,185830,Golan; Tal,0,10,20,20
1683712684007,HITO 156GS,A00,185831,Patterson; Patrick H.,0,0,0,23
1683712685032,HIUS 103,A00,185832,Man; Simeon S,0,4,20,20
1683712686058,HIUS 117,A00,185836,Kwak; Nancy,2,0,20,18
1683712687084,HIUS 125,A00,185840,Man; Simeon S,0,2,23,23
1683712688112,HIUS 149,A00,185845,Staff,1,0,20,19
1683712689138,HUM 3,A01,185882,Zavodny; Tatiana Sophia,0,8,50,50
1683712689138,HUM 3,B01,185899,Caldwell; Michael Alan,0,18,50,50
1683712690163,HUM 3GS,A00,185900,Patterson; Patrick H.,0,0,0,23
1683712691196,HUM 4,A01,185938,Zroka; Amy Liane,28,0,50,22
1683712691196,HUM 4,B01,185956,Watkins; Eric,0,6,50,50
1683712691196,HUM 4,B02,202209,Watkins; Eric,0,6,50,50
1683712691196,HUM 4,B03,202210,Watkins; Eric,0,5,50,50
1683712692223,HUM 5,A01,185958,West; Geoffrey Scott,0,0,50,50
1683712692223,HUM 5,A02,202215,West; Geoffrey Scott,0,1,50,50
1683712693247,INTL 190,A00,185959,Gagnon; Jeffrey C,0,0,0,9
1683712693247,INTL 190,B00,185960,Lettieri; Michael Joseph,0,0,0,2
1683712694275,JAPN 180,A00,254509,Staff,5,0,30,25
1683712695310,LATI 10,A01,202853,Kennemore; Amy Michelle,4,0,35,31
1683712695310,LATI 10,A02,202854,Kennemore; Amy Michelle,3,0,35,32
1683712695310,LATI 10,A03,270054,Kennemore; Amy Michelle,30,0,30,0
1683712696337,LATI 180,A00,202855,Kennemore; Amy Michelle,11,0,20,9
1683712697363,LAWS 101,A00,201767,Golan; Tal,0,7,40,40
1683712698391,LIFR 1C,A00,185961,Staff,6,0,20,14
1683712699416,LIFR 1CX,A00,185962,Staff,7,0,20,13
1683712700440,LIFR 1D,A00,185963,Staff,7,0,20,13
1683712701466,LIFR 1DX,A00,185964,Staff,7,0,20,13
1683712702491,LIGN 101,A01,186039,Staff,43,0,50,7
1683712703520,LIGN 165,A00,186040,Staff,14,0,50,36
1683712704547,LTCS 108,A00,186041,Staff,5,0,10,5
1683712705572,LTCS 119,A00,186042,Staff,15,0,20,5
1683712706601,LTCS 130,A00,186043,Wesling; Megan E.,15,0,25,10
1683712708652,LTEA 138,A00,186119,Staff,14,0,40,26
1683712709678,LTEN 124,A00,186148,Staff,5,0,25,20
1683712710707,LTEN 178,A00,186149,Staff,6,0,15,9
1683712711733,LTEN 181,A00,186150,Blanco; John D,34,0,40,6
1683712712757,LTWL 120,A00,186160,Staff,19,0,25,6
1683712713788,LTWL 165,A00,186161,Staff,22,0,25,3
1683712714813,LTWR 100,A00,186162,Staff,0,5,15,15
1683712715839,LTWR 102,A00,186163,Doller; Ben,5,0,15,10
1683712716863,MAE 8,A01,186412,Staff,0,1,0,0
1683712717890,MAE 30B,A00,186445,Bahadori; Mohammad Yousef,81,0,100,19
1683712718917,MAE 40,A00,186592,Bewley; Thomas R,10,0,50,40
1683712719945,MAE 101B,A00,186593,Bahadori; Mohammad Yousef,80,0,100,20
1683712720969,MAE 105,A00,186594,Bandaru; Prabhakar,10,0,50,40
1683712722001,MAE 107,A00,186599,Pham; Hieu Tan,0,8,120,120
1683712723026,MAE 148,A01,186660,Silberman; Jack,3,0,16,13
1683712724054,MATH 10A,A01,188095,Staff,0,6,35,35
1683712725079,MATH 10B,A01,188097,Bowers; Adam R.,0,12,30,30
1683712725079,MATH 10B,A02,188099,Bowers; Adam R.,0,11,30,30
1683712725079,MATH 10B,B01,188104,Bowers; Adam R.,0,10,30,30
1683712725079,MATH 10B,B02,188106,Bowers; Adam R.,0,9,30,30
1683712726110,MATH 10C,A01,188111,Staff,0,20,30,30
1683712726110,MATH 10C,A02,188127,Staff,0,19,30,30
1683712726110,MATH 10C,A03,188131,Staff,0,19,30,30
1683712726110,MATH 10C,B01,188218,Staff,17,0,30,13
1683712726110,MATH 10C,B02,188244,Staff,13,0,30,17
1683712726110,MATH 10C,B03,188277,Staff,14,0,30,16
1683712727142,MATH 18,A01,188344,Bach; Quang Tran,18,0,30,12
1683712727142,MATH 18,A02,188345,Bach; Quang Tran,11,0,30,19
1683712727142,MATH 18,B01,188353,Bach; Quang Tran,11,0,30,19
1683712727142,MATH 18,B02,188354,Bach; Quang Tran,19,0,30,11
1683712728167,MATH 20A,A01,188374,Staff,11,0,35,24
1683712729193,MATH 20B,A01,188382,Ohm; Ko Woon,7,0,30,23
1683712729193,MATH 20B,A02,188383,Ohm; Ko Woon,22,0,30,8
1683712729193,MATH 20B,B01,188385,Ohm; Ko Woon,7,0,30,23
1683712729193,MATH 20B,B02,188392,Ohm; Ko Woon,22,0,30,8
1683712730217,MATH 20C,A01,188394,Harel; Guershon,10,0,30,20
1683712730217,MATH 20C,A02,188395,Harel; Guershon,13,0,30,17
1683712730217,MATH 20C,B01,188404,Harel; Guershon,5,0,30,25
1683712730217,MATH 20C,B02,188405,Harel; Guershon,18,0,30,12
1683712731244,MATH 20D,A01,188414,Hammock; Frances H,0,1,30,30
1683712731244,MATH 20D,A02,188415,Hammock; Frances H,0,1,30,30
1683712731244,MATH 20D,B01,188447,Hammock; Frances H,0,1,30,30
1683712731244,MATH 20D,B02,188486,Hammock; Frances H,2,0,30,28
1683712732273,MATH 20E,A01,188649,Staff,21,0,30,9
1683712732273,MATH 20E,A02,188650,Staff,20,0,30,10
1683712732273,MATH 20E,A03,188673,Staff,0,0,30,30
1683712733297,MATH 102,A01,188675,Staff,0,40,35,35
1683712734322,MATH 103B,A01,188681,Staff,3,0,35,32
1683712734322,MATH 103B,B01,188692,Staff,5,0,35,30
1683712735352,MATH 109,A01,188695,Salehi Golsefidy; Alireza,24,0,35,11
1683712735352,MATH 109,A02,188696,Salehi Golsefidy; Alireza,25,0,35,10
1683712736383,MATH 120A,A01,188698,Eggers; John Dietrich,7,0,35,28
1683712737414,MATH 142B,A01,188736,Ioana; Adrian,0,0,30,30
1683712737414,MATH 142B,A02,188741,Ioana; Adrian,0,1,30,30
1683712737414,MATH 142B,A03,188743,Ioana; Adrian,0,2,30,30
1683712738438,MATH 168A,A01,188790,Staff,0,11,35,35
1683712739465,MATH 170A,A01,188803,Nie; Jiawang,0,2,35,35
1683712739465,MATH 170A,A02,188811,Nie; Jiawang,0,1,35,35
1683712739465,MATH 170A,A03,188814,Nie; Jiawang,1,0,35,34
1683712739465,MATH 170A,A04,188815,Nie; Jiawang,5,0,35,30
1683712740490,MATH 193B,A01,188817,Staff,0,0,35,35
1683712740490,MATH 193B,A02,188818,Staff,6,0,35,29
1683712741515,MGT 4,A01,202857,Anderson; John Charles,59,0,80,21
1683712742538,MGT 12,A00,202858,Lindenberger; Wade Douglas,40,0,90,50
1683712743567,MGT 18,A00,202859,Staff,73,0,90,17
1683712744666,MGT 18GS,A00,202860,McKay; Michael J,13,0,28,15
1683712745691,MGT 45,A00,202861,Pecore; Joseph P.,8,0,90,82
1683712746717,MGT 100,A00,202863,Yavorsky; Daniel Ryan,27,0,90,63
1683712747747,MGT 103,A00,202864,Ehrich; Kristine R,0,19,90,90
1683712748775,MGT 112,A00,202865,Ehrich; Kristine R,15,0,90,75
1683712749801,MGT 121A,A00,202868,Staff,70,0,90,20
1683712750827,MGT 131B,A00,202869,Anderson; John Charles,58,0,90,32
1683712751855,MGT 136,A00,202871,Lindenberger; Wade Douglas,83,0,90,7
1683712752880,MGT 164,A00,202873,Staff,0,67,90,91
1683712753905,MGT 164GS,A00,202874,McKay; Mary A,13,0,28,15
1683712754934,MGT 180,A00,202875,Staff,0,51,90,91
1683712755958,MMW 11R,A01,205019,Herbst; Matthew,0,0,30,30
1683712755958,MMW 11R,A02,205026,Herbst; Matthew,29,0,30,1
1683712756985,MMW 15,A01,193512,Chang; Edmond Yi-Teh,0,8,28,28
1683712756985,MMW 15,A02,193513,Chang; Edmond Yi-Teh,0,5,28,28
1683712756985,MMW 15,A03,193514,Chang; Edmond Yi-Teh,0,5,28,28
1683712756985,MMW 15,A04,193515,Chang; Edmond Yi-Teh,0,5,28,28
1683712756985,MMW 15,A05,193516,Chang; Edmond Yi-Teh,0,5,28,28
1683712756985,MMW 15,A06,193517,Chang; Edmond Yi-Teh,0,6,28,28
1683712756985,MMW 15,B01,193519,Chang; Edmond Yi-Teh,0,5,28,28
1683712756985,MMW 15,B02,193520,Chang; Edmond Yi-Teh,0,5,28,28
1683712756985,MMW 15,B03,193521,Chang; Edmond Yi-Teh,0,5,28,28
1683712756985,MMW 15,B04,193522,Chang; Edmond Yi-Teh,0,6,28,28
1683712756985,MMW 15,B05,193523,Chang; Edmond Yi-Teh,0,5,28,28
1683712756985,MMW 15,B06,193524,Chang; Edmond Yi-Teh,0,5,28,28
1683712758018,MMW 122,A01,193526,Rahimi; Babak,0,16,28,28
1683712758018,MMW 122,A02,193527,Rahimi; Babak,0,15,28,28
1683712758018,MMW 122,A03,193528,Rahimi; Babak,0,0,0,0
1683712758018,MMW 122,A04,193529,Rahimi; Babak,0,0,0,0
1683712759046,MUS 1A,A01,186663,Staff,0,18,35,35
1683712760074,MUS 4,A01,186715,Staff,0,12,35,35
1683712761099,MUS 5R,A01,186796,Dubnov; Shlomo,0,17,35,35
1683712762128,MUS 6,A01,186798,Staff,0,4,25,25
1683712763155,MUS 7,A01,186830,Staff,11,0,35,24
1683712764180,MUS 8,A01,186930,Staff,0,27,35,35
1683712765205,MUS 15,A01,186932,Staff,0,15,35,35
1683712765205,MUS 15,B01,186934,Staff,0,16,35,35
1683712766230,MUS 80,A00,186935,Staff,0,0,20,20
1683712766230,MUS 80,B00,186936,Staff,24,0,25,1
1683712767262,NANO 11,A00,204702,Lipomi; Darren John,0,0,0,0
1683712768287,NANO 15,A01,204709,Yang; Kesong,0,1,0,0
1683712769311,NANO 114,A00,202069,Jahed Motlagh; Zeinab,2,0,10,8
1683712770337,PHIL 1,A00,186955,Grush; Rick Scott,31,0,40,9
1683712771362,PHIL 10,A01,186973,Grush; Rick Scott,27,0,35,8
1683712771362,PHIL 10,A02,186974,Grush; Rick Scott,33,0,35,2
1683712772393,PHIL 13,A01,186976,Staff,1,0,35,34
1683712772393,PHIL 13,A02,186977,Staff,16,0,35,19
1683712773423,PHIL 14,A01,186979,Staff,30,0,35,5
1683712773423,PHIL 14,A02,186986,Staff,32,0,35,3
1683712774453,PHIL 28,A01,186988,Staff,16,0,30,14
1683712774453,PHIL 28,A02,186989,Staff,0,0,30,30
1683712774453,PHIL 28,A03,186990,Staff,10,0,30,20
1683712774453,PHIL 28,A04,186991,Staff,26,0,30,4
1683712775480,PHIL 120,A00,186997,Staff,23,0,40,17
1683712776505,PHIL 137,A00,187003,Staff,8,0,40,32
1683712777532,PHIL 150,A00,187015,Staff,47,0,70,23
1683712778557,PHIL 167,A00,187021,Lamey; Andy M.,34,0,40,6
1683712779583,PHIL 174,A01,202226,Staff,17,0,20,3
1683712779583,PHIL 174,A02,202235,Staff,20,0,20,0
1683712780606,PHIL 191A,A00,258918,Staff,0,0,1,1
1683712781630,PHYS 1A,A00,187028,Staff,26,0,60,34
1683712782657,PHYS 1AL,001,187036,Staff,3,0,30,27
1683712782657,PHYS 1AL,002,187049,Staff,18,0,30,12
1683712783682,PHYS 1B,A00,187058,Staff,21,0,60,39
1683712784713,PHYS 1BL,001,187064,Staff,0,1,30,30
1683712784713,PHYS 1BL,002,187070,Staff,4,0,30,26
1683712785741,PHYS 1C,A00,187082,Staff,30,0,120,90
1683712786772,PHYS 1CL,001,187088,Staff,0,9,30,30
1683712786772,PHYS 1CL,002,187089,Staff,0,1,30,30
1683712786772,PHYS 1CL,009,262693,Staff,9,0,30,21
1683712787802,PHYS 2B,A01,187097,Staff,55,0,115,60
1683712788826,PHYS 2C,A01,187099,Staff,63,0,115,52
1683712789855,PHYS 2CL,A01,187101,Staff,5,0,28,23
1683712789855,PHYS 2CL,A02,187102,Staff,15,0,28,13
1683712790881,PHYS 2D,A01,187123,Shotwell; Brian,95,0,115,20
1683712791905,PHYS 4B,A01,187133,Grinstein; Benjamin,35,0,50,15
1683712792934,POLI 10,A00,188819,Staff,0,4,50,50
1683712793961,POLI 11,A00,188827,Staff,43,0,50,7
1683712794990,POLI 13R,A00,188828,Staff,0,1,20,20
1683712796015,POLI 27,A01,188830,Elgin; Samuel Zincke,0,2,70,70
1683712797041,POLI 30,A00,188832,Desposato; Scott,30,0,50,20
1683712798065,POLI 102F,A00,188834,Staff,1,0,40,39
1683712799093,POLI 104A,A00,188852,Staff,12,0,30,18
1683712800118,POLI 104I,A00,188853,Staff,0,8,20,20
1683712801147,POLI 110B,A00,188854,Wiens; David,6,0,20,14
1683712802175,POLI 112A,A00,188855,Wiens; David,3,0,30,27
1683712803200,POLI 117R,A00,188856,Forman; Fonna,0,12,20,20
1683712804224,POLI 118,A00,188857,Ingham; Sean,8,0,20,12
1683712805248,POLI 120G,A00,188858,Staff,7,0,30,23
1683712806271,POLI 131CR,A00,188863,Hoston; Germaine,20,0,50,30
1683712807294,POLI 133,A00,188864,Nellis; Gareth Hb,44,0,50,6
1683712808328,POLI 134D,A00,188865,Desposato; Scott,27,0,30,3
1683712809354,POLI 142A,A00,188871,Gartzke; Erik,21,0,50,29
1683712810377,POLI 142K,A00,188874,Staff,38,0,50,12
1683712811405,POLI 143,A00,188940,Gartzke; Erik,15,0,30,15
1683712812433,POLI 153,A00,188943,Staff,1,0,20,19
1683712813458,POLI 160AA,A00,188944,Staff,10,0,40,30
1683712814483,POLI 170A,A00,188945,Staff,10,0,30,20
1683712816546,PSYC 1,A00,188952,Staff,36,0,90,54
1683712817575,PSYC 2,B00,188953,Staff,19,0,35,16
1683712818603,PSYC 6,A00,188970,Staff,47,0,60,13
1683712819631,PSYC 7,A00,188973,Staff,35,0,45,10
1683712820662,PSYC 60,A01,188980,Rickard; Timothy C.,42,0,60,18
1683712821692,PSYC 70,A01,189001,Steiner; Eric Tomas,22,0,45,23
1683712822717,PSYC 100,A00,189005,Lacefield; Katharine I,1,98,120,119
1683712823746,PSYC 102,A00,189008,Staff,6,0,30,24
1683712824777,PSYC 106,B00,189026,Gorman; Michael R.,27,0,60,33
1683712825807,PSYC 114,B01,189033,Winkielman; Piotr,0,31,30,30
1683712826836,PSYC 131,A00,189036,Anagnostaras; Stephan,0,44,60,60
1683712827864,PSYC 136,A00,189041,Lowe; Angela Beth,0,7,25,25
1683712828891,PSYC 137,A00,189057,Winkielman; Piotr,0,36,25,25
1683712829916,PSYC 144,A00,189107,Wixted; John T,0,11,50,50
1683712831969,PSYC 162,A00,189142,Staff,0,9,85,85
1683712832994,PSYC 172,A00,189144,Gorman; Michael R.,0,6,30,30
1683712835049,PSYC 179,A00,189146,Lacefield; Katharine I,0,88,120,120
1683712836074,PSYC 181,A00,189147,Anagnostaras; Stephan,0,45,90,90
1683712837114,PSYC 190R,A00,189148,Barner; David A.,0,23,80,80
1683712838138,PSYC 191,A00,189275,Rickard; Timothy C.,0,11,25,25
1683712839163,PSYC 193,A00,189276,Chapman; Eddie Nathaniel,0,1,0,4
1683712840188,PSYC 193L,A01,189281,Lowe; Angela Beth,8,0,20,12
1683712840188,PSYC 193L,B01,189285,Staff,28,0,35,7
1683712841213,RELI 149,A00,187137,Rahimi; Babak,6,0,40,34
1683712842244,SE 9,A01,187315,Staff,0,2,18,18
1683712843272,SE 101B,A00,187409,Staff,24,0,30,6
1683712844298,SE 110B,A00,187444,Staff,10,0,40,30
1683712845323,SE 130B,A00,187449,Staff,31,0,40,9
1683712846352,SE 150A,A00,187516,Staff,8,0,20,12
1683712847377,SE 154,A00,187528,Staff,29,0,50,21
1683712848462,SIO 3,A01,258171,Staff,35,0,40,5
1683712849490,SIO 10,A00,187144,Cook; Geoffrey W,0,6,75,75
1683712850514,SIO 45,A00,187152,Cook; Geoffrey W,1,7,100,99
1683712851543,SIO 109R,A00,194486,Staff,0,4,20,20
1683712853593,SIO 187,A01,187233,Kacev; David,12,0,40,28
1683712854627,SOCI 1,A01,258656,Thorpe; Charles Robert,28,0,30,2
1683712854627,SOCI 1,A02,258658,Thorpe; Charles Robert,30,0,30,0
1683712854627,SOCI 1,A03,258661,Thorpe; Charles Robert,25,0,25,0
1683712854627,SOCI 1,A04,258666,Thorpe; Charles Robert,22,0,25,3
1683712854627,SOCI 1,A05,258897,Thorpe; Charles Robert,22,0,25,3
1683712854627,SOCI 1,A06,258898,Thorpe; Charles Robert,25,0,25,0
1683712855653,SOCI 30,A01,258903,Pardo Guerra; Juan Pablo,14,0,30,16
1683712856678,SOCI 102,A00,258904,Staff,9,0,25,16
1683712857705,SOCI 106,A00,258905,Staff,19,0,25,6
1683712858734,SOCI 111,A00,258907,Ribas Norris; Janet Vanesa,26,0,30,4
1683712859761,SOCI 121R,A00,258908,Pardo Guerra; Juan Pablo,7,0,30,23
1683712860790,SOCI 126,A01,203330,Staff,14,0,20,6
1683712861814,SOCI 131,A00,258909,Thorpe; Charles Robert,30,0,60,30
1683712862841,SOCI 135,A00,258910,Payne; Christine Anna,0,13,30,30
1683712863867,SOCI 157,A00,258911,Staff,10,0,30,20
1683712864892,SOCI 184,A00,258912,Staff,25,0,30,5
1683712865920,SOCI 188D,A00,258913,Staff,22,0,30,8
1683712866946,SYN 2,001,187529,Staff,9,0,16,7
1683712866946,SYN 2,002,201452,Staff,0,20,16,16
1683712866946,SYN 2,003,201469,Staff,1,0,16,15
1683712867976,SYN 100,A01,187531,Staff,0,9,20,20
1683712867976,SYN 100,B01,201491,Staff,0,10,20,20
1683712869011,TDAC 1,A00,189286,Walsh; Kim C.,3,0,20,17
1683712869011,TDAC 1,B00,189287,Harting; Carla Kelso,10,0,20,10
1683712870046,TDAC 101,A00,189300,Walsh; Kim C.,16,0,20,4
1683712870046,TDAC 101,B00,189301,Harting; Carla Kelso,18,0,20,2
1683712871073,TDAC 102,A00,189304,Basso; Beatrice,14,0,20,6
1683712872098,TDAC 108,A00,189305,Staff,18,0,20,2
1683712873137,TDDE 131,A00,189310,Staff,19,0,20,1
1683712873137,TDDE 131,B00,189314,Staff,19,0,20,1
1683712873137,TDDE 131,C00,189315,Staff,48,0,50,2
1683712873137,TDDE 131,D00,189316,Staff,14,0,15,1
1683712873137,TDDE 131,E00,204841,Staff,20,0,20,0
1683712874168,TDGE 10,A00,189289,Staff,27,0,50,23
1683712874168,TDGE 10,B00,189290,Havis; Allan,0,1,50,50
1683712875202,TDGE 11,A00,189291,Fulton; Julia,0,4,50,50
1683712875202,TDGE 11,B00,189292,Staff,20,0,25,5
1683712875202,TDGE 11,C00,260270,Staff,0,0,0,0
1683712876226,TDGE 25,A00,189294,Staff,1,0,20,19
1683712877251,TDGE 124,A00,189318,Fulton; Julia,0,7,50,50
1683712878275,TDGE 125,A00,189319,Staff,13,0,25,12
1683712878275,TDGE 125,B00,189320,Staff,23,0,25,2
1683712879305,TDGE 127,A00,189322,Havis; Allan,1,0,50,49
1683712880330,TDHT 101,A00,189323,Staff,18,0,25,7
1683712880330,TDHT 101,B00,189324,Staff,25,0,25,0
1683712881355,TDHT 102,A00,189325,Staff,49,0,50,1
1683712882383,TDMV 1,A00,189295,Arcidiacono; Kristin,20,0,30,10
1683712882383,TDMV 1,B00,189296,Caligagan; Maria T.,23,0,30,7
1683712883409,TDMV 2,A00,189297,Sammartano; Tonnie,27,0,30,3
1683712883409,TDMV 2,B00,189299,Arcidiacono; Kristin,23,0,30,7
1683712884437,TDMV 3,A00,204998,Rincon; Alicia,22,0,30,8
1683712885468,TDMV 120,A00,189458,Sammartano; Tonnie,28,0,30,2
1683712886494,TDMV 138,A00,189541,Jun; Grace Shin Hae,20,0,40,20
1683712887525,TDMV 142,A00,189717,Caligagan; Tony,25,0,30,5
1683712887525,TDMV 142,B00,189718,Caligagan; Maria T.,25,0,30,5
1683712888550,TMC 2,A01,187533,Staff,25,0,25,0
1683712888550,TMC 2,A02,187534,Staff,25,0,25,0
1683712889577,USP 1,A01,187536,Kwak; Nancy,0,16,25,25
1683712890609,USP 5,A01,187538,Staff,8,0,25,17
1683712891634,USP 101,A00,199253,Staff,0,4,0,0
1683712892661,USP 124,A00,187562,Boomhower; Matthew Charles,0,0,30,30
1683712893692,USP 138,A00,187582,Staff,19,0,25,6
1683712894740,USP 152,A01,187597,Staff,3,0,25,22
1683712895766,USP 153,A00,187598,Staff,18,0,25,7
1683712896790,USP 168,A00,187607,Kwak; Nancy,2,0,5,3
1683712897816,USP 173,A00,187619,Staff,4,0,25,21
1683712898851,USP 181,A00,187638,Staff,0,4,25,25
1683712899882,VIS 103,A00,187650,Cruz; Edwin Teddy,17,0,75,58
1683712900910,VIS 110D,A00,187669,Staff,13,0,22,9
1683712901942,VIS 127C,A00,187720,Shen; Kuiyi,67,0,146,79
1683712902971,VIS 149,A00,187731,Yoldas; Pinar,0,12,22,22
1683712903999,VIS 151,A01,188091,Staff,22,0,34,12
1683712903999,VIS 151,A02,188092,Staff,11,0,34,23
1683712905023,VIS 160B,A00,188093,Stalbaum; Brett,0,1,10,10
1683712907079,WCWP 10B,A00,201720,Staff,0,0,5,5
1683712907079,WCWP 10B,B00,201722,Staff,0,0,6,6
1683712908104,WCWP 100,A00,201725,Gagnon; Jeffrey C,0,0,2,2
1683712908104,WCWP 100,B00,201727,Staff,0,4,15,15
1683712911309,ANBI 133,A00,258401,Wilder; Linnea Lorene,34,0,40,6
1683712912338,ANBI 140,A00,258395,Hrvoj Mihic; Branka,18,0,25,7
1683712913364,ANSC 120,A00,258402,Bialecki; Jon Anthony,26,0,40,14
1683712914394,ANSC 144,A00,258400,Staff,12,0,40,28
1683712916450,ANSC 166,A00,258396,Parish; Steven Martin,156,0,175,19
1683712917474,ANSC 180,A00,193533,Staff,8,0,20,12
1683712918504,ANSC 188,A00,258397,Jassal; Aftab,34,0,40,6
1683712919533,ANTH 3,A01,258316,Staff,23,0,30,7
1683712920558,ANTH 5,A00,258394,Semendeferi; Ekaterini,16,0,20,4
1683712921589,ANTH 21,A01,258331,Staff,4,0,40,36
1683712922614,ANTH 103,A00,258398,Varma; Saiba,15,0,25,10
1683712923645,AWP 10,001,202034,Staff,0,0,0,0
1683712923645,AWP 10,002,202035,Staff,0,0,0,0
1683712923645,AWP 10,003,202036,Staff,0,0,0,0
1683712923645,AWP 10,004,202037,Staff,0,0,0,0
1683712923645,AWP 10,005,202038,Staff,0,0,0,0
1683712923645,AWP 10,006,202039,Staff,0,0,0,0
1683712923645,AWP 10,007,202040,Staff,0,0,0,0
1683712923645,AWP 10,008,202041,Staff,0,0,0,0
1683712923645,AWP 10,009,202042,Staff,0,0,0,0
1683712923645,AWP 10,010,202043,Staff,0,0,0,0
1683712923645,AWP 10,011,202044,Staff,0,0,0,0
1683712923645,AWP 10,012,202045,Staff,0,0,0,0
1683712923645,AWP 10,013,202046,Staff,0,0,0,0
1683712923645,AWP 10,014,202047,Staff,0,0,0,0
1683712923645,AWP 10,015,202048,Staff,0,0,0,0
1683712923645,AWP 10,016,202049,Staff,0,0,0,0
1683712923645,AWP 10,017,202050,Staff,0,0,0,0
1683712923645,AWP 10,018,202051,Staff,0,0,0,0
1683712923645,AWP 10,019,202052,Staff,0,0,0,0
1683712923645,AWP 10,020,202053,Staff,0,0,0,0
1683712923645,AWP 10,021,202054,Staff,0,0,0,0
1683712923645,AWP 10,022,202055,Staff,0,0,0,0
1683712923645,AWP 10,023,202056,Staff,0,0,0,0
1683712923645,AWP 10,024,202057,Staff,0,0,0,0
1683712923645,AWP 10,025,202058,Staff,0,0,0,0
1683712923645,AWP 10,026,202059,Staff,0,0,0,0
1683712924671,AWP 102,001,202032,Staff,0,0,0,0
1683712924671,AWP 102,002,202033,Staff,0,0,0,0
1683712925697,BENG 100,A01,254234,Taylor Amos; Alyssa C,31,0,40,9
1683712926722,BENG 196,001,270013,Engler; Adam J.,9999,0,9999,0
1683712927751,BICD 100R,A01,202018,Smith; Laurie,0,7,32,32
1683712927751,BICD 100R,A02,202019,Smith; Laurie,0,3,32,32
1683712927751,BICD 100R,A03,202020,Smith; Laurie,0,1,32,32
1683712927751,BICD 100R,A04,202021,Smith; Laurie,6,0,32,26
1683712927751,BICD 100R,A05,202022,Smith; Laurie,10,0,32,22
1683712928780,BICD 136,A01,193242,Gustafson-Brown; Cindy,0,2,32,32
1683712928780,BICD 136,A02,193244,Gustafson-Brown; Cindy,13,0,32,19
1683712929809,BIEB 102,A01,193249,Butler; Shannon Rhey,0,0,32,32
1683712929809,BIEB 102,A02,193251,Butler; Shannon Rhey,0,0,32,32
1683712929809,BIEB 102,A03,193253,Butler; Shannon Rhey,0,0,32,32
1683712929809,BIEB 102,A04,193255,Butler; Shannon Rhey,13,0,32,19
1683712929809,BIEB 102,A05,193265,Butler; Shannon Rhey,25,0,32,7
1683712929809,BIEB 102,A06,193269,Butler; Shannon Rhey,12,0,32,20
1683712931866,BIEB 150,A01,193274,Staff,0,0,32,32
1683712931866,BIEB 150,A02,193285,Staff,24,0,32,8
1683712932892,BIEB 194,A00,193286,Kurle; Carolyn M.,19,0,32,13
1683712933919,BILD 1,A01,192291,Staff,15,0,32,17
1683712933919,BILD 1,A02,192292,Staff,30,0,32,2
1683712933919,BILD 1,B01,192520,Reuther; Keefe,0,1,0,0
1683712933919,BILD 1,B02,192532,Reuther; Keefe,0,1,0,0
1683712934947,BILD 3,A01,192556,Butler; Shannon Rhey,0,0,32,32
1683712934947,BILD 3,A02,192581,Butler; Shannon Rhey,0,1,32,32
1683712934947,BILD 3,A03,192611,Butler; Shannon Rhey,19,0,32,13
1683712934947,BILD 3,A04,192612,Butler; Shannon Rhey,23,0,32,9
1683712934947,BILD 3,A05,192613,Butler; Shannon Rhey,26,0,32,6
1683712934947,BILD 3,A06,192679,Butler; Shannon Rhey,27,0,32,5
1683712934947,BILD 3,A07,192682,Butler; Shannon Rhey,20,0,32,12
1683712935974,BILD 4,A01,192836,Reuther; Keefe,1,0,24,23
1683712935974,BILD 4,A02,193044,Reuther; Keefe,4,0,24,20
1683712937005,BILD 10,A01,193142,Gustafson-Brown; Cindy,29,0,32,3
1683712937005,BILD 10,A02,193149,Gustafson-Brown; Cindy,31,0,32,1
1683712938030,BIMM 100,A01,193301,Staff,0,6,32,32
1683712938030,BIMM 100,A02,193312,Staff,0,7,32,32
1683712938030,BIMM 100,A03,193323,Staff,0,10,32,32
1683712939065,BIMM 101,A01,193329,McDonnell; Lisa Marie,0,3,24,24
1683712939065,BIMM 101,A02,193339,McDonnell; Lisa Marie,0,3,24,24
1683712939065,BIMM 101,B01,193354,McDonnell; Lisa Marie,0,4,24,24
1683712939065,BIMM 101,B02,193357,McDonnell; Lisa Marie,0,3,24,24
1683712940099,BIMM 110,A01,193377,Tat; John,0,11,32,32
1683712940099,BIMM 110,A02,193378,Tat; John,0,11,32,32
1683712941133,BIMM 120,A01,206116,Staff,0,0,32,32
1683712941133,BIMM 120,A02,206117,Staff,7,0,32,25
1683712941133,BIMM 120,A03,206121,Staff,21,0,32,11
1683712942170,BIPN 100,A01,193393,Park; Ji Young,0,15,32,32
1683712942170,BIPN 100,A02,193402,Park; Ji Young,0,14,32,32
1683712942170,BIPN 100,A03,193413,Park; Ji Young,0,14,32,32
1683712942170,BIPN 100,A04,193414,Park; Ji Young,0,13,32,32
1683712943199,BIPN 102,A01,193429,Staff,0,0,32,32
1683712943199,BIPN 102,A02,193438,Staff,18,0,32,14
1683712944232,BIPN 106,A01,193450,Reyes Gonzalez; Catalina,0,2,40,40
1683712945258,BIPN 134,A01,193465,Cooke; James Edward,0,0,32,32
1683712945258,BIPN 134,A02,193474,Cooke; James Edward,25,0,32,7
1683712945258,BIPN 134,A03,193485,Cooke; James Edward,29,0,32,3
1683712945258,BIPN 134,A04,193486,Cooke; James Edward,20,0,32,12
1683712945258,BIPN 134,A05,193491,Cooke; James Edward,31,0,32,1
1683712945258,BIPN 134,A06,193501,Cooke; James Edward,30,0,32,2
1683712945258,BIPN 134,A07,193510,Cooke; James Edward,29,0,32,3
1683712947310,BISP 194,A00,222522,Staff,14,0,32,18
1683712948334,CAT 124,A01,202407,Staff,19,0,25,6
1683712949359,CAT 125,A00,202408,Marchisotto; Jennifer Anne,2,0,20,18
1683712950408,CAT 125R,A00,202409,Smith; Lauryn Alissa,0,11,20,20
1683712950408,CAT 125R,B00,202410,Morales; Celeste Georgianna,0,11,20,20
1683712950408,CAT 125R,C00,202411,Irwin; Matthew Joseph,0,12,20,20
1683712951434,CENG 15,A01,204712,Yang; Kesong,0,1,0,0
1683712952516,CENG 114,A00,202070,Jahed Motlagh; Zeinab,5,0,20,15
1683712953564,CGS 105,A00,185477,Wesling; Megan E.,24,0,40,16
1683712954597,CGS 106,A00,185494,Staff,11,0,22,11
1683712955624,CGS 108,A00,185495,Staff,14,0,20,6
1683712956652,CGS 114,A00,185496,Staff,13,0,18,5
1683712957677,CGS 119,A00,185501,Staff,15,0,20,5
1683712958705,CGS 120,A00,185511,Staff,11,0,20,9
1683712959731,CHEM 4,A01,184675,Bussey; Thomas J,97,0,100,3
1683712960758,CHEM 6A,A01,184677,Staff,32,0,60,28
1683712961783,CHEM 6B,A01,184679,Staff,63,0,100,37
1683712962809,CHEM 6C,A01,184681,Bussey; Thomas J,0,0,50,50
1683712962809,CHEM 6C,A02,184682,Bussey; Thomas J,32,0,50,18
1683712963835,CHEM 40A,A01,184684,Albizati; Kim F.,33,0,100,67
1683712964860,CHEM 40B,A01,184686,Albizati; Kim F.,0,22,100,100
1683712965889,CHEM 41B,A01,184690,Staff,51,0,100,49
1683712966915,COGS 3,A01,184715,Boyle; Mary E. T.,0,27,40,40
1683712967948,COGS 14B,A01,185172,Staff,0,14,38,38
1683712968973,COGS 18,A01,184736,Staff,14,0,80,66
1683712970006,COGS 100,A01,184932,Staff,0,8,73,73
1683712971031,COGS 101A,A01,184935,Staff,0,40,30,30
1683712972057,COGS 101B,A01,184944,Staff,0,2,30,30
1683712973087,COGS 101C,A01,184946,Staff,0,10,30,30
1683712974114,COGS 102A,A01,184951,Johnson; Christine M.,1,0,40,39
1683712975140,COGS 107B,A01,184953,Mooshagian; Eric Frederick,0,52,40,40
1683712976168,COGS 118B,A01,184959,Gupta; Anjum,0,50,40,40
1683712977198,COGS 153,A00,184961,Staff,1,16,30,29
1683712978222,COGS 177,A00,184962,Staff,0,20,30,30
1683712979253,COGS 187A,A01,184969,Boyle; Mary E. T.,0,19,40,40
1683712980286,COMM 10,A01,185174,Staff,0,5,25,25
1683712980286,COMM 10,A02,185189,Staff,0,2,25,25
1683712980286,COMM 10,A03,269821,Staff,0,1,0,0
1683712981322,COMM 100B,A02,185476,Staff,10,0,25,15
1683712981322,COMM 100B,A03,277340,Staff,25,0,25,0
1683712982346,COMM 100C,A01,185314,Staff,2,0,25,23
1683712982346,COMM 100C,A02,185327,Staff,17,0,25,8
1683712983379,COMM 110M,A00,185349,Staff,0,0,40,40
1683712984404,COMM 113T,A00,185352,Staff,25,0,40,15
1683712985429,COMM 114I,A00,185353,Staff,31,0,40,9
1683712986459,COMM 131,A00,185354,Staff,17,0,30,13
1683712987492,CSE 8A,A50,185358,Cao; Yingjun,0,46,10,10
1683712988522,CSE 8B,A01,185362,Staff,0,48,50,50
1683712989556,CSE 11,A01,185416,Cao; Yingjun,0,91,10,10
1683712990586,CSE 20,A01,185445,Briones; Jor-el Thomas Caparas,3,0,25,22
1683712991616,CSE 21,A01,185447,Staff,9,0,50,41
1683712992650,CSE 101,A01,185451,Staff,0,13,50,50
1683712992650,CSE 101,B01,185453,Jones; Miles E,0,15,50,50
1683712994706,CSE 141,A01,185458,Eldon; John,16,0,100,84
1683712995737,CSE 141L,A01,185461,Eldon; John,8,0,100,92
1683712996763,CSE 142,A01,185463,Staff,34,0,60,26
1683712996763,CSE 142,B01,201355,Staff,0,7,60,60
1683712997791,CSE 142L,A01,185470,Staff,34,0,60,26
1683712997791,CSE 142L,B01,201417,Staff,0,6,60,60
1683712998819,CSE 190,A00,201433,Staff,32,0,49,17
1683712999845,DOC 1,A01,259136,Strom; Megan C.,7,0,15,8
1683712999845,DOC 1,A02,259137,Strom; Megan C.,15,0,15,0
1683712999845,DOC 1,A03,259138,Strom; Megan C.,14,0,15,1
1683712999845,DOC 1,A04,259139,Strom; Megan C.,13,0,15,2
1683713000870,DOC 100D,A00,259140,Pass; Natalye Joann,14,0,25,11
1683713001897,DSGN 1,A01,184749,Rill; Bryan,0,26,30,30
1683713002923,DSGN 100,A01,185168,Staff,0,2,25,25
1683713003952,ECE 5,A01,185626,Morris; Karcher William,0,12,0,0
1683713004979,ECE 101,A01,185628,Staff,14,0,70,56
1683713006004,ECE 107,A01,185635,Baghdadchi; Saharnaz,0,0,20,20
1683713006004,ECE 107,A02,185638,Baghdadchi; Saharnaz,1,0,20,19
1683713007029,ECE 148,A01,185647,Silberman; Jack,0,0,16,16
1683713008055,ECON 1,A01,185537,Crane; Meredith Helen,54,0,70,16
1683713009087,ECON 3,A01,185549,Crane; Meredith Helen,30,0,70,40
1683713010115,ECON 4,A01,203354,Anderson; John Charles,0,5,10,10
1683713011141,ECON 100A,A01,185574,Staff,0,5,40,40
1683713012171,ECON 100B,A01,185576,Staff,0,12,50,50
1683713013205,ECON 100C,A01,185589,Newhouse; Herbert S,30,0,70,40
1683713014231,ECON 105,A00,185608,Vespa; Emanuel Ignacio,19,0,35,16
1683713015258,ECON 109,A01,185610,Shishkin; Denis,9,0,35,26
1683713016284,ECON 110A,A01,185612,Staff,8,0,40,32
1683713017313,ECON 120A,A01,185615,Staff,19,0,40,21
1683713018347,ECON 120C,A01,185617,Sun; Yixiao,0,21,70,70
1683713019375,ECON 144,A00,203346,Squires; Dale E,2,0,35,33
1683713020399,ECON 171,A01,203349,Newhouse; Herbert S,0,1,35,35
1683713021429,ECON 173A,A01,185621,Toda; Alexis Akira,21,0,35,14
1683713022460,EDS 25,A01,202413,Staff,0,1,0,0
1683713022460,EDS 25,A02,202414,Staff,0,1,0,0
1683713022460,EDS 25,A03,202415,Staff,0,0,0,0
1683713022460,EDS 25,A04,202416,Staff,0,1,0,0
1683713022460,EDS 25,A05,202439,Staff,0,0,0,0
1683713022460,EDS 25,A06,202440,Staff,0,0,0,0
1683713022460,EDS 25,B01,202631,Staff,0,0,0,0
1683713022460,EDS 25,B02,202632,Staff,0,0,0,0
1683713022460,EDS 25,B03,202639,Staff,0,0,0,0
1683713022460,EDS 25,B04,202640,Staff,0,0,0,0
1683713022460,EDS 25,B05,202643,Staff,0,0,0,0
1683713022460,EDS 25,B06,202644,Staff,0,0,0,0
1683713023484,EDS 38,A01,202659,Black; Alison Michelle,25,0,25,0
1683713024510,EDS 115,A00,202652,Staff,18,0,30,12
1683713025539,EDS 125,A00,202649,Staff,13,0,30,17
1683713026567,EDS 126,A01,203332,Staff,30,0,30,0
1683713027595,EDS 139,A00,202838,Staff,16,0,25,9
1683713028625,EDS 146,A01,202655,Staff,14,0,25,11
1683713029652,ENG 15,A00,185667,Staff,0,1,0,0
1683713029652,ENG 15,B00,185672,Staff,0,0,0,0
1683713029652,ENG 15,C00,185675,Staff,0,0,0,0
1683713029652,ENG 15,D00,185682,Staff,0,0,0,0
1683713029652,ENG 15,E00,185684,Staff,0,0,0,0
1683713030678,ETHN 103,A00,185710,Staff,0,8,35,35
1683713031706,ETHN 103A,A00,199228,Man; Simeon S,0,0,9,9
1683713032735,ETHN 109,A00,185711,Staff,15,0,35,20
1683713033762,ETHN 142,A00,185726,Staff,0,4,30,30
1683713034786,ETHN 163J,A00,199229,Man; Simeon S,5,0,8,3
1683713035818,ETHN 168,A00,185727,Staff,7,0,10,3
1683713036848,ETHN 182,A00,185728,Staff,0,0,35,35
1683713037872,ETHN 183,A00,185737,Staff,9,0,18,9
1683713038899,GLBH 111,A01,209361,Burgos; Jose L.,0,0,0,0
1683713040949,HIEU 104,A00,185792,Staff,14,0,20,6
1683713041974,HIEU 115,A00,185800,Staff,0,0,20,20
1683713042998,HIEU 128,A00,185801,Staff,0,9,20,20
1683713044023,HIEU 147,A00,185802,Staff,15,0,20,5
1683713045049,HIEU 154,A00,185823,Staff,11,0,20,9
1683713046073,HILA 102,A00,185826,Staff,14,0,20,6
1683713047101,HILD 2C,A01,185778,Staff,0,13,20,20
1683713048132,HILD 7B,A01,185780,Kwak; Nancy,0,17,32,32
1683713048132,HILD 7B,A02,185781,Kwak; Nancy,0,18,32,32
1683713049161,HILD 30,A01,185791,Staff,12,0,20,8
1683713050185,HISC 119,A00,185830,Golan; Tal,0,10,20,20
1683713051215,HITO 156GS,A00,185831,Patterson; Patrick H.,0,0,0,23
1683713052243,HIUS 103,A00,185832,Man; Simeon S,0,4,20,20
1683713053271,HIUS 117,A00,185836,Kwak; Nancy,2,0,20,18
1683713054300,HIUS 125,A00,185840,Man; Simeon S,0,2,23,23
1683713055326,HIUS 149,A00,185845,Staff,1,0,20,19
1683713056410,HUM 3,A01,185882,Zavodny; Tatiana Sophia,0,8,50,50
1683713056410,HUM 3,B01,185899,Caldwell; Michael Alan,0,18,50,50
1683713057438,HUM 3GS,A00,185900,Patterson; Patrick H.,0,0,0,23
1683713058467,HUM 4,A01,185938,Zroka; Amy Liane,28,0,50,22
1683713058467,HUM 4,B01,185956,Watkins; Eric,0,6,50,50
1683713058467,HUM 4,B02,202209,Watkins; Eric,0,6,50,50
1683713058467,HUM 4,B03,202210,Watkins; Eric,0,5,50,50
1683713059493,HUM 5,A01,185958,West; Geoffrey Scott,0,0,50,50
1683713059493,HUM 5,A02,202215,West; Geoffrey Scott,0,1,50,50
1683713060520,INTL 190,A00,185959,Gagnon; Jeffrey C,0,0,0,9
1683713060520,INTL 190,B00,185960,Lettieri; Michael Joseph,0,0,0,2
1683713061545,JAPN 180,A00,254509,Staff,5,0,30,25
1683713062581,LATI 10,A01,202853,Kennemore; Amy Michelle,4,0,35,31
1683713062581,LATI 10,A02,202854,Kennemore; Amy Michelle,3,0,35,32
1683713062581,LATI 10,A03,270054,Kennemore; Amy Michelle,30,0,30,0
1683713063609,LATI 180,A00,202855,Kennemore; Amy Michelle,11,0,20,9
1683713064634,LAWS 101,A00,201767,Golan; Tal,0,7,40,40
1683713065660,LIFR 1C,A00,185961,Staff,6,0,20,14
1683713066684,LIFR 1CX,A00,185962,Staff,7,0,20,13
1683713067708,LIFR 1D,A00,185963,Staff,7,0,20,13
1683713068732,LIFR 1DX,A00,185964,Staff,7,0,20,13
1683713069756,LIGN 101,A01,186039,Staff,43,0,50,7
1683713070780,LIGN 165,A00,186040,Staff,14,0,50,36
1683713071807,LTCS 108,A00,186041,Staff,5,0,10,5
1683713072838,LTCS 119,A00,186042,Staff,15,0,20,5
1683713073864,LTCS 130,A00,186043,Wesling; Megan E.,15,0,25,10
1683713075919,LTEA 138,A00,186119,Staff,14,0,40,26
1683713076944,LTEN 124,A00,186148,Staff,5,0,25,20
1683713077969,LTEN 178,A00,186149,Staff,6,0,15,9
1683713078998,LTEN 181,A00,186150,Blanco; John D,34,0,40,6
1683713080024,LTWL 120,A00,186160,Staff,19,0,25,6
1683713081050,LTWL 165,A00,186161,Staff,22,0,25,3
1683713082078,LTWR 100,A00,186162,Staff,0,5,15,15
1683713083105,LTWR 102,A00,186163,Doller; Ben,5,0,15,10
1683713084130,MAE 8,A01,186412,Staff,0,1,0,0
1683713085156,MAE 30B,A00,186445,Bahadori; Mohammad Yousef,81,0,100,19
1683713086179,MAE 40,A00,186592,Bewley; Thomas R,10,0,50,40
1683713087204,MAE 101B,A00,186593,Bahadori; Mohammad Yousef,80,0,100,20
1683713088228,MAE 105,A00,186594,Bandaru; Prabhakar,10,0,50,40
1683713089257,MAE 107,A00,186599,Pham; Hieu Tan,0,8,120,120
1683713090286,MAE 148,A01,186660,Silberman; Jack,3,0,16,13
1683713091322,MATH 10A,A01,188095,Staff,0,6,35,35
1683713092348,MATH 10B,A01,188097,Bowers; Adam R.,0,12,30,30
1683713092348,MATH 10B,A02,188099,Bowers; Adam R.,0,11,30,30
1683713092348,MATH 10B,B01,188104,Bowers; Adam R.,0,10,30,30
1683713092348,MATH 10B,B02,188106,Bowers; Adam R.,0,9,30,30
1683713093381,MATH 10C,A01,188111,Staff,0,20,30,30
1683713093381,MATH 10C,A02,188127,Staff,0,19,30,30
1683713093381,MATH 10C,A03,188131,Staff,0,19,30,30
1683713093381,MATH 10C,B01,188218,Staff,17,0,30,13
1683713093381,MATH 10C,B02,188244,Staff,13,0,30,17
1683713093381,MATH 10C,B03,188277,Staff,14,0,30,16
1683713094406,MATH 18,A01,188344,Bach; Quang Tran,18,0,30,12
1683713094406,MATH 18,A02,188345,Bach; Quang Tran,11,0,30,19
1683713094406,MATH 18,B01,188353,Bach; Quang Tran,11,0,30,19
1683713094406,MATH 18,B02,188354,Bach; Quang Tran,19,0,30,11
1683713095433,MATH 20A,A01,188374,Staff,11,0,35,24
1683713096459,MATH 20B,A01,188382,Ohm; Ko Woon,7,0,30,23
1683713096459,MATH 20B,A02,188383,Ohm; Ko Woon,22,0,30,8
1683713096459,MATH 20B,B01,188385,Ohm; Ko Woon,7,0,30,23
1683713096459,MATH 20B,B02,188392,Ohm; Ko Woon,22,0,30,8
1683713097491,MATH 20C,A01,188394,Harel; Guershon,10,0,30,20
1683713097491,MATH 20C,A02,188395,Harel; Guershon,13,0,30,17
1683713097491,MATH 20C,B01,188404,Harel; Guershon,5,0,30,25
1683713097491,MATH 20C,B02,188405,Harel; Guershon,18,0,30,12
1683713098530,MATH 20D,A01,188414,Hammock; Frances H,0,1,30,30
1683713098530,MATH 20D,A02,188415,Hammock; Frances H,0,1,30,30
1683713098530,MATH 20D,B01,188447,Hammock; Frances H,0,1,30,30
1683713098530,MATH 20D,B02,188486,Hammock; Frances H,2,0,30,28
1683713099556,MATH 20E,A01,188649,Staff,21,0,30,9
1683713099556,MATH 20E,A02,188650,Staff,20,0,30,10
1683713099556,MATH 20E,A03,188673,Staff,0,0,30,30
1683713100582,MATH 102,A01,188675,Staff,0,40,35,35
1683713101609,MATH 103B,A01,188681,Staff,3,0,35,32
1683713101609,MATH 103B,B01,188692,Staff,5,0,35,30
1683713102634,MATH 109,A01,188695,Salehi Golsefidy; Alireza,24,0,35,11
1683713102634,MATH 109,A02,188696,Salehi Golsefidy; Alireza,25,0,35,10
1683713103659,MATH 120A,A01,188698,Eggers; John Dietrich,7,0,35,28
1683713104714,MATH 142B,A01,188736,Ioana; Adrian,0,0,30,30
1683713104714,MATH 142B,A02,188741,Ioana; Adrian,0,1,30,30
1683713104714,MATH 142B,A03,188743,Ioana; Adrian,0,2,30,30
1683713105741,MATH 168A,A01,188790,Staff,0,11,35,35
1683713106768,MATH 170A,A01,188803,Nie; Jiawang,0,2,35,35
1683713106768,MATH 170A,A02,188811,Nie; Jiawang,0,1,35,35
1683713106768,MATH 170A,A03,188814,Nie; Jiawang,1,0,35,34
1683713106768,MATH 170A,A04,188815,Nie; Jiawang,5,0,35,30
1683713107793,MATH 193B,A01,188817,Staff,0,0,35,35
1683713107793,MATH 193B,A02,188818,Staff,6,0,35,29
1683713108825,MGT 4,A01,202857,Anderson; John Charles,59,0,80,21
1683713109849,MGT 12,A00,202858,Lindenberger; Wade Douglas,40,0,90,50
1683713110874,MGT 18,A00,202859,Staff,73,0,90,17
1683713111899,MGT 18GS,A00,202860,McKay; Michael J,13,0,28,15
1683713112925,MGT 45,A00,202861,Pecore; Joseph P.,8,0,90,82
1683713113951,MGT 100,A00,202863,Yavorsky; Daniel Ryan,27,0,90,63
1683713114975,MGT 103,A00,202864,Ehrich; Kristine R,0,19,90,90
1683713116000,MGT 112,A00,202865,Ehrich; Kristine R,15,0,90,75
1683713117027,MGT 121A,A00,202868,Staff,70,0,90,20
1683713118057,MGT 131B,A00,202869,Anderson; John Charles,58,0,90,32
1683713119085,MGT 136,A00,202871,Lindenberger; Wade Douglas,83,0,90,7
1683713120110,MGT 164,A00,202873,Staff,0,67,90,91
1683713121135,MGT 164GS,A00,202874,McKay; Mary A,13,0,28,15
1683713122158,MGT 180,A00,202875,Staff,0,51,90,91
1683713123192,MMW 11R,A01,205019,Herbst; Matthew,0,0,30,30
1683713123192,MMW 11R,A02,205026,Herbst; Matthew,29,0,30,1
1683713124218,MMW 15,A01,193512,Chang; Edmond Yi-Teh,0,8,28,28
1683713124218,MMW 15,A02,193513,Chang; Edmond Yi-Teh,0,5,28,28
1683713124218,MMW 15,A03,193514,Chang; Edmond Yi-Teh,0,5,28,28
1683713124218,MMW 15,A04,193515,Chang; Edmond Yi-Teh,0,5,28,28
1683713124218,MMW 15,A05,193516,Chang; Edmond Yi-Teh,0,5,28,28
1683713124218,MMW 15,A06,193517,Chang; Edmond Yi-Teh,0,6,28,28
1683713124218,MMW 15,B01,193519,Chang; Edmond Yi-Teh,0,5,28,28
1683713124218,MMW 15,B02,193520,Chang; Edmond Yi-Teh,0,5,28,28
1683713124218,MMW 15,B03,193521,Chang; Edmond Yi-Teh,0,5,28,28
1683713124218,MMW 15,B04,193522,Chang; Edmond Yi-Teh,0,6,28,28
1683713124218,MMW 15,B05,193523,Chang; Edmond Yi-Teh,0,5,28,28
1683713124218,MMW 15,B06,193524,Chang; Edmond Yi-Teh,0,5,28,28
1683713125246,MMW 122,A01,193526,Rahimi; Babak,0,16,28,28
1683713125246,MMW 122,A02,193527,Rahimi; Babak,0,15,28,28
1683713125246,MMW 122,A03,193528,Rahimi; Babak,0,0,0,0
1683713125246,MMW 122,A04,193529,Rahimi; Babak,0,0,0,0
1683713126272,MUS 1A,A01,186663,Staff,0,18,35,35
1683713127297,MUS 4,A01,186715,Staff,0,12,35,35
1683713128325,MUS 5R,A01,186796,Dubnov; Shlomo,0,17,35,35
1683713129354,MUS 6,A01,186798,Staff,0,4,25,25
1683713130388,MUS 7,A01,186830,Staff,11,0,35,24
1683713131413,MUS 8,A01,186930,Staff,0,27,35,35
1683713132439,MUS 15,A01,186932,Staff,0,15,35,35
1683713132439,MUS 15,B01,186934,Staff,0,16,35,35
1683713133469,MUS 80,A00,186935,Staff,0,0,20,20
1683713133469,MUS 80,B00,186936,Staff,24,0,25,1
1683713134494,NANO 11,A00,204702,Lipomi; Darren John,0,0,0,0
1683713135519,NANO 15,A01,204709,Yang; Kesong,0,1,0,0
1683713136549,NANO 114,A00,202069,Jahed Motlagh; Zeinab,2,0,10,8
1683713137577,PHIL 1,A00,186955,Grush; Rick Scott,31,0,40,9
1683713138605,PHIL 10,A01,186973,Grush; Rick Scott,27,0,35,8
1683713138605,PHIL 10,A02,186974,Grush; Rick Scott,33,0,35,2
1683713139629,PHIL 13,A01,186976,Staff,1,0,35,34
1683713139629,PHIL 13,A02,186977,Staff,16,0,35,19
1683713140654,PHIL 14,A01,186979,Staff,30,0,35,5
1683713140654,PHIL 14,A02,186986,Staff,32,0,35,3
1683713141679,PHIL 28,A01,186988,Staff,16,0,30,14
1683713141679,PHIL 28,A02,186989,Staff,0,0,30,30
1683713141679,PHIL 28,A03,186990,Staff,10,0,30,20
1683713141679,PHIL 28,A04,186991,Staff,26,0,30,4
1683713142705,PHIL 120,A00,186997,Staff,23,0,40,17
1683713143735,PHIL 137,A00,187003,Staff,8,0,40,32
1683713144763,PHIL 150,A00,187015,Staff,47,0,70,23
1683713145789,PHIL 167,A00,187021,Lamey; Andy M.,34,0,40,6
1683713146814,PHIL 174,A01,202226,Staff,17,0,20,3
1683713146814,PHIL 174,A02,202235,Staff,20,0,20,0
1683713147840,PHIL 191A,A00,258918,Staff,0,0,1,1
1683713148951,PHYS 1A,A00,187028,Staff,26,0,60,34
1683713149976,PHYS 1AL,001,187036,Staff,3,0,30,27
1683713149976,PHYS 1AL,002,187049,Staff,18,0,30,12
1683713151003,PHYS 1B,A00,187058,Staff,21,0,60,39
1683713152033,PHYS 1BL,001,187064,Staff,0,1,30,30
1683713152033,PHYS 1BL,002,187070,Staff,4,0,30,26
1683713153058,PHYS 1C,A00,187082,Staff,30,0,120,90
1683713154085,PHYS 1CL,001,187088,Staff,0,9,30,30
1683713154085,PHYS 1CL,002,187089,Staff,0,1,30,30
1683713154085,PHYS 1CL,009,262693,Staff,9,0,30,21
1683713155109,PHYS 2B,A01,187097,Staff,55,0,115,60
1683713156135,PHYS 2C,A01,187099,Staff,63,0,115,52
1683713157162,PHYS 2CL,A01,187101,Staff,5,0,28,23
1683713157162,PHYS 2CL,A02,187102,Staff,15,0,28,13
1683713158189,PHYS 2D,A01,187123,Shotwell; Brian,95,0,115,20
1683713159219,PHYS 4B,A01,187133,Grinstein; Benjamin,35,0,50,15
1683713160304,POLI 10,A00,188819,Staff,0,4,50,50
1683713161329,POLI 11,A00,188827,Staff,43,0,50,7
1683713162357,POLI 13R,A00,188828,Staff,0,1,20,20
1683713163383,POLI 27,A01,188830,Elgin; Samuel Zincke,0,2,70,70
1683713164412,POLI 30,A00,188832,Desposato; Scott,30,0,50,20
1683713165438,POLI 102F,A00,188834,Staff,1,0,40,39
1683713166462,POLI 104A,A00,188852,Staff,12,0,30,18
1683713167490,POLI 104I,A00,188853,Staff,0,8,20,20
1683713168516,POLI 110B,A00,188854,Wiens; David,6,0,20,14
1683713169540,POLI 112A,A00,188855,Wiens; David,3,0,30,27
1683713170566,POLI 117R,A00,188856,Forman; Fonna,0,12,20,20
1683713171597,POLI 118,A00,188857,Ingham; Sean,8,0,20,12
1683713172626,POLI 120G,A00,188858,Staff,7,0,30,23
1683713173652,POLI 131CR,A00,188863,Hoston; Germaine,20,0,50,30
1683713174686,POLI 133,A00,188864,Nellis; Gareth Hb,44,0,50,6
1683713175716,POLI 134D,A00,188865,Desposato; Scott,27,0,30,3
1683713176740,POLI 142A,A00,188871,Gartzke; Erik,21,0,50,29
1683713177765,POLI 142K,A00,188874,Staff,38,0,50,12
1683713178790,POLI 143,A00,188940,Gartzke; Erik,15,0,30,15
1683713179819,POLI 153,A00,188943,Staff,1,0,20,19
1683713180849,POLI 160AA,A00,188944,Staff,10,0,40,30
1683713181874,POLI 170A,A00,188945,Staff,10,0,30,20
1683713183925,PSYC 1,A00,188952,Staff,36,0,90,54
1683713184949,PSYC 2,B00,188953,Staff,19,0,35,16
1683713185977,PSYC 6,A00,188970,Staff,47,0,60,13
1683713187003,PSYC 7,A00,188973,Staff,35,0,45,10
1683713188043,PSYC 60,A01,188980,Rickard; Timothy C.,42,0,60,18
1683713189075,PSYC 70,A01,189001,Steiner; Eric Tomas,22,0,45,23
1683713190104,PSYC 100,A00,189005,Lacefield; Katharine I,1,98,120,119
1683713191132,PSYC 102,A00,189008,Staff,6,0,30,24
1683713192158,PSYC 106,B00,189026,Gorman; Michael R.,27,0,60,33
1683713193184,PSYC 114,B01,189033,Winkielman; Piotr,0,31,30,30
1683713194210,PSYC 131,A00,189036,Anagnostaras; Stephan,0,44,60,60
1683713195236,PSYC 136,A00,189041,Lowe; Angela Beth,0,7,25,25
1683713196261,PSYC 137,A00,189057,Winkielman; Piotr,0,36,25,25
1683713197290,PSYC 144,A00,189107,Wixted; John T,0,11,50,50
1683713199345,PSYC 162,A00,189142,Staff,0,9,85,85
1683713200376,PSYC 172,A00,189144,Gorman; Michael R.,0,6,30,30
1683713202430,PSYC 179,A00,189146,Lacefield; Katharine I,0,88,120,120
1683713203455,PSYC 181,A00,189147,Anagnostaras; Stephan,0,45,90,90
1683713204484,PSYC 190R,A00,189148,Barner; David A.,0,23,80,80
1683713205514,PSYC 191,A00,189275,Rickard; Timothy C.,0,11,25,25
1683713206540,PSYC 193,A00,189276,Chapman; Eddie Nathaniel,0,1,0,4
1683713207565,PSYC 193L,A01,189281,Lowe; Angela Beth,8,0,20,12
1683713207565,PSYC 193L,B01,189285,Staff,28,0,35,7
1683713208590,RELI 149,A00,187137,Rahimi; Babak,6,0,40,34
1683713209623,SE 9,A01,187315,Staff,0,2,18,18
1683713210650,SE 101B,A00,187409,Staff,24,0,30,6
1683713211678,SE 110B,A00,187444,Staff,10,0,40,30
1683713212711,SE 130B,A00,187449,Staff,31,0,40,9
1683713213741,SE 150A,A00,187516,Staff,8,0,20,12
1683713214770,SE 154,A00,187528,Staff,29,0,50,21
1683713215796,SIO 3,A01,258171,Staff,35,0,40,5
1683713216826,SIO 10,A00,187144,Cook; Geoffrey W,0,6,75,75
1683713217855,SIO 45,A00,187152,Cook; Geoffrey W,1,7,100,99
1683713218881,SIO 109R,A00,194486,Staff,0,4,20,20
1683713220931,SIO 187,A01,187233,Kacev; David,12,0,40,28
1683713221964,SOCI 1,A01,258656,Thorpe; Charles Robert,28,0,30,2
1683713221964,SOCI 1,A02,258658,Thorpe; Charles Robert,30,0,30,0
1683713221964,SOCI 1,A03,258661,Thorpe; Charles Robert,25,0,25,0
1683713221964,SOCI 1,A04,258666,Thorpe; Charles Robert,22,0,25,3
1683713221964,SOCI 1,A05,258897,Thorpe; Charles Robert,22,0,25,3
1683713221964,SOCI 1,A06,258898,Thorpe; Charles Robert,25,0,25,0
1683713222989,SOCI 30,A01,258903,Pardo Guerra; Juan Pablo,14,0,30,16
1683713224016,SOCI 102,A00,258904,Staff,9,0,25,16
1683713225044,SOCI 106,A00,258905,Staff,19,0,25,6
1683713226074,SOCI 111,A00,258907,Ribas Norris; Janet Vanesa,26,0,30,4
1683713227102,SOCI 121R,A00,258908,Pardo Guerra; Juan Pablo,7,0,30,23
1683713228128,SOCI 126,A01,203330,Staff,14,0,20,6
1683713229154,SOCI 131,A00,258909,Thorpe; Charles Robert,30,0,60,30
1683713230737,SOCI 135,A00,258910,Payne; Christine Anna,0,13,30,30
1683713231767,SOCI 157,A00,258911,Staff,10,0,30,20
1683713232794,SOCI 184,A00,258912,Staff,25,0,30,5
1683713233820,SOCI 188D,A00,258913,Staff,22,0,30,8
1683713234846,SYN 2,001,187529,Staff,9,0,16,7
1683713234846,SYN 2,002,201452,Staff,0,20,16,16
1683713234846,SYN 2,003,201469,Staff,1,0,16,15
1683713235877,SYN 100,A01,187531,Staff,0,9,20,20
1683713235877,SYN 100,B01,201491,Staff,0,10,20,20
1683713236911,TDAC 1,A00,189286,Walsh; Kim C.,3,0,20,17
1683713236911,TDAC 1,B00,189287,Harting; Carla Kelso,10,0,20,10
1683713237937,TDAC 101,A00,189300,Walsh; Kim C.,16,0,20,4
1683713237937,TDAC 101,B00,189301,Harting; Carla Kelso,18,0,20,2
1683713238962,TDAC 102,A00,189304,Basso; Beatrice,14,0,20,6
1683713239987,TDAC 108,A00,189305,Staff,18,0,20,2
1683713241018,TDDE 131,A00,189310,Staff,19,0,20,1
1683713241018,TDDE 131,B00,189314,Staff,19,0,20,1
1683713241018,TDDE 131,C00,189315,Staff,48,0,50,2
1683713241018,TDDE 131,D00,189316,Staff,14,0,15,1
1683713241018,TDDE 131,E00,204841,Staff,20,0,20,0
1683713242048,TDGE 10,A00,189289,Staff,27,0,50,23
1683713242048,TDGE 10,B00,189290,Havis; Allan,0,1,50,50
1683713243075,TDGE 11,A00,189291,Fulton; Julia,0,4,50,50
1683713243075,TDGE 11,B00,189292,Staff,20,0,25,5
1683713243075,TDGE 11,C00,260270,Staff,0,0,0,0
1683713244100,TDGE 25,A00,189294,Staff,1,0,20,19
1683713245126,TDGE 124,A00,189318,Fulton; Julia,0,7,50,50
1683713246151,TDGE 125,A00,189319,Staff,13,0,25,12
1683713246151,TDGE 125,B00,189320,Staff,23,0,25,2
1683713247179,TDGE 127,A00,189322,Havis; Allan,1,0,50,49
1683713248202,TDHT 101,A00,189323,Staff,18,0,25,7
1683713248202,TDHT 101,B00,189324,Staff,25,0,25,0
1683713249227,TDHT 102,A00,189325,Staff,49,0,50,1
1683713250258,TDMV 1,A00,189295,Arcidiacono; Kristin,20,0,30,10
1683713250258,TDMV 1,B00,189296,Caligagan; Maria T.,23,0,30,7
1683713251283,TDMV 2,A00,189297,Sammartano; Tonnie,27,0,30,3
1683713251283,TDMV 2,B00,189299,Arcidiacono; Kristin,23,0,30,7
1683713252310,TDMV 3,A00,204998,Rincon; Alicia,22,0,30,8
1683713253336,TDMV 120,A00,189458,Sammartano; Tonnie,28,0,30,2
1683713254361,TDMV 138,A00,189541,Jun; Grace Shin Hae,20,0,40,20
1683713255389,TDMV 142,A00,189717,Caligagan; Tony,25,0,30,5
1683713255389,TDMV 142,B00,189718,Caligagan; Maria T.,25,0,30,5
1683713256418,TMC 2,A01,187533,Staff,25,0,25,0
1683713256418,TMC 2,A02,187534,Staff,25,0,25,0
1683713257444,USP 1,A01,187536,Kwak; Nancy,0,16,25,25
1683713258469,USP 5,A01,187538,Staff,8,0,25,17
1683713259496,USP 101,A00,199253,Staff,0,4,0,0
1683713260520,USP 124,A00,187562,Boomhower; Matthew Charles,0,0,30,30
1683713261552,USP 138,A00,187582,Staff,19,0,25,6
1683713262582,USP 152,A01,187597,Staff,3,0,25,22
1683713263609,USP 153,A00,187598,Staff,18,0,25,7
1683713264690,USP 168,A00,187607,Kwak; Nancy,2,0,5,3
1683713265713,USP 173,A00,187619,Staff,4,0,25,21
1683713266738,USP 181,A00,187638,Staff,0,4,25,25
1683713267763,VIS 103,A00,187650,Cruz; Edwin Teddy,17,0,75,58
1683713268790,VIS 110D,A00,187669,Staff,13,0,22,9
1683713269820,VIS 127C,A00,187720,Shen; Kuiyi,67,0,146,79
1683713270848,VIS 149,A00,187731,Yoldas; Pinar,0,12,22,22
1683713271873,VIS 151,A01,188091,Staff,22,0,34,12
1683713271873,VIS 151,A02,188092,Staff,11,0,34,23
1683713272905,VIS 160B,A00,188093,Stalbaum; Brett,0,1,10,10
1683713274958,WCWP 10B,A00,201720,Staff,0,0,5,5
1683713274958,WCWP 10B,B00,201722,Staff,0,0,6,6
1683713275986,WCWP 100,A00,201725,Gagnon; Jeffrey C,0,0,2,2
1683713275986,WCWP 100,B00,201727,Staff,0,4,15,15
1683713279134,ANBI 133,A00,258401,Wilder; Linnea Lorene,34,0,40,6
1683713280175,ANBI 140,A00,258395,Hrvoj Mihic; Branka,18,0,25,7
1683713281203,ANSC 120,A00,258402,Bialecki; Jon Anthony,26,0,40,14
1683713282237,ANSC 144,A00,258400,Staff,12,0,40,28
1683713284289,ANSC 166,A00,258396,Parish; Steven Martin,156,0,175,19
1683713285314,ANSC 180,A00,193533,Staff,8,0,20,12
1683713286339,ANSC 188,A00,258397,Jassal; Aftab,34,0,40,6
1683713287366,ANTH 3,A01,258316,Staff,23,0,30,7
1683713288393,ANTH 5,A00,258394,Semendeferi; Ekaterini,16,0,20,4
1683713289420,ANTH 21,A01,258331,Staff,4,0,40,36
1683713290451,ANTH 103,A00,258398,Varma; Saiba,15,0,25,10
1683713291489,AWP 10,001,202034,Staff,0,0,0,0
1683713291489,AWP 10,002,202035,Staff,0,0,0,0
1683713291489,AWP 10,003,202036,Staff,0,0,0,0
1683713291489,AWP 10,004,202037,Staff,0,0,0,0
1683713291489,AWP 10,005,202038,Staff,0,0,0,0
1683713291489,AWP 10,006,202039,Staff,0,0,0,0
1683713291489,AWP 10,007,202040,Staff,0,0,0,0
1683713291489,AWP 10,008,202041,Staff,0,0,0,0
1683713291489,AWP 10,009,202042,Staff,0,0,0,0
1683713291489,AWP 10,010,202043,Staff,0,0,0,0
1683713291489,AWP 10,011,202044,Staff,0,0,0,0
1683713291489,AWP 10,012,202045,Staff,0,0,0,0
1683713291489,AWP 10,013,202046,Staff,0,0,0,0
1683713291489,AWP 10,014,202047,Staff,0,0,0,0
1683713291489,AWP 10,015,202048,Staff,0,0,0,0
1683713291489,AWP 10,016,202049,Staff,0,0,0,0
1683713291489,AWP 10,017,202050,Staff,0,0,0,0
1683713291489,AWP 10,018,202051,Staff,0,0,0,0
1683713291489,AWP 10,019,202052,Staff,0,0,0,0
1683713291489,AWP 10,020,202053,Staff,0,0,0,0
1683713291489,AWP 10,021,202054,Staff,0,0,0,0
1683713291489,AWP 10,022,202055,Staff,0,0,0,0
1683713291489,AWP 10,023,202056,Staff,0,0,0,0
1683713291489,AWP 10,024,202057,Staff,0,0,0,0
1683713291489,AWP 10,025,202058,Staff,0,0,0,0
1683713291489,AWP 10,026,202059,Staff,0,0,0,0
1683713292517,AWP 102,001,202032,Staff,0,0,0,0
1683713292517,AWP 102,002,202033,Staff,0,0,0,0
1683713293545,BENG 100,A01,254234,Taylor Amos; Alyssa C,31,0,40,9
1683713294570,BENG 196,001,270013,Engler; Adam J.,9999,0,9999,0
1683713295596,BICD 100R,A01,202018,Smith; Laurie,0,7,32,32
1683713295596,BICD 100R,A02,202019,Smith; Laurie,0,3,32,32
1683713295596,BICD 100R,A03,202020,Smith; Laurie,0,1,32,32
1683713295596,BICD 100R,A04,202021,Smith; Laurie,6,0,32,26
1683713295596,BICD 100R,A05,202022,Smith; Laurie,10,0,32,22
1683713296624,BICD 136,A01,193242,Gustafson-Brown; Cindy,0,2,32,32
1683713296624,BICD 136,A02,193244,Gustafson-Brown; Cindy,13,0,32,19
1683713297652,BIEB 102,A01,193249,Butler; Shannon Rhey,0,0,32,32
1683713297652,BIEB 102,A02,193251,Butler; Shannon Rhey,0,0,32,32
1683713297652,BIEB 102,A03,193253,Butler; Shannon Rhey,0,0,32,32
1683713297652,BIEB 102,A04,193255,Butler; Shannon Rhey,13,0,32,19
1683713297652,BIEB 102,A05,193265,Butler; Shannon Rhey,25,0,32,7
1683713297652,BIEB 102,A06,193269,Butler; Shannon Rhey,12,0,32,20
1683713299703,BIEB 150,A01,193274,Staff,0,0,32,32
1683713299703,BIEB 150,A02,193285,Staff,24,0,32,8
1683713300728,BIEB 194,A00,193286,Kurle; Carolyn M.,19,0,32,13
1683713301754,BILD 1,A01,192291,Staff,15,0,32,17
1683713301754,BILD 1,A02,192292,Staff,30,0,32,2
1683713301754,BILD 1,B01,192520,Reuther; Keefe,0,1,0,0
1683713301754,BILD 1,B02,192532,Reuther; Keefe,0,1,0,0
1683713302780,BILD 3,A01,192556,Butler; Shannon Rhey,0,0,32,32
1683713302780,BILD 3,A02,192581,Butler; Shannon Rhey,0,1,32,32
1683713302780,BILD 3,A03,192611,Butler; Shannon Rhey,19,0,32,13
1683713302780,BILD 3,A04,192612,Butler; Shannon Rhey,23,0,32,9
1683713302780,BILD 3,A05,192613,Butler; Shannon Rhey,26,0,32,6
1683713302780,BILD 3,A06,192679,Butler; Shannon Rhey,27,0,32,5
1683713302780,BILD 3,A07,192682,Butler; Shannon Rhey,20,0,32,12
1683713303808,BILD 4,A01,192836,Reuther; Keefe,1,0,24,23
1683713303808,BILD 4,A02,193044,Reuther; Keefe,4,0,24,20
1683713304835,BILD 10,A01,193142,Gustafson-Brown; Cindy,29,0,32,3
1683713304835,BILD 10,A02,193149,Gustafson-Brown; Cindy,31,0,32,1
1683713305863,BIMM 100,A01,193301,Staff,0,6,32,32
1683713305863,BIMM 100,A02,193312,Staff,0,7,32,32
1683713305863,BIMM 100,A03,193323,Staff,0,10,32,32
1683713306895,BIMM 101,A01,193329,McDonnell; Lisa Marie,0,3,24,24
1683713306895,BIMM 101,A02,193339,McDonnell; Lisa Marie,0,3,24,24
1683713306895,BIMM 101,B01,193354,McDonnell; Lisa Marie,0,4,24,24
1683713306895,BIMM 101,B02,193357,McDonnell; Lisa Marie,0,3,24,24
1683713307919,BIMM 110,A01,193377,Tat; John,0,11,32,32
1683713307919,BIMM 110,A02,193378,Tat; John,0,11,32,32
1683713308946,BIMM 120,A01,206116,Staff,0,0,32,32
1683713308946,BIMM 120,A02,206117,Staff,7,0,32,25
1683713308946,BIMM 120,A03,206121,Staff,21,0,32,11
1683713309973,BIPN 100,A01,193393,Park; Ji Young,0,15,32,32
1683713309973,BIPN 100,A02,193402,Park; Ji Young,0,14,32,32
1683713309973,BIPN 100,A03,193413,Park; Ji Young,0,14,32,32
1683713309973,BIPN 100,A04,193414,Park; Ji Young,0,13,32,32
1683713311008,BIPN 102,A01,193429,Staff,0,0,32,32
1683713311008,BIPN 102,A02,193438,Staff,18,0,32,14
1683713312045,BIPN 106,A01,193450,Reyes Gonzalez; Catalina,0,2,40,40
1683713313072,BIPN 134,A01,193465,Cooke; James Edward,0,0,32,32
1683713313072,BIPN 134,A02,193474,Cooke; James Edward,25,0,32,7
1683713313072,BIPN 134,A03,193485,Cooke; James Edward,29,0,32,3
1683713313072,BIPN 134,A04,193486,Cooke; James Edward,20,0,32,12
1683713313072,BIPN 134,A05,193491,Cooke; James Edward,31,0,32,1
1683713313072,BIPN 134,A06,193501,Cooke; James Edward,30,0,32,2
1683713313072,BIPN 134,A07,193510,Cooke; James Edward,29,0,32,3
1683713315123,BISP 194,A00,222522,Staff,14,0,32,18
1683713316146,CAT 124,A01,202407,Staff,19,0,25,6
1683713317171,CAT 125,A00,202408,Marchisotto; Jennifer Anne,2,0,20,18
1683713318206,CAT 125R,A00,202409,Smith; Lauryn Alissa,0,11,20,20
1683713318206,CAT 125R,B00,202410,Morales; Celeste Georgianna,0,11,20,20
1683713318206,CAT 125R,C00,202411,Irwin; Matthew Joseph,0,12,20,20
1683713319243,CENG 15,A01,204712,Yang; Kesong,0,1,0,0
1683713320271,CENG 114,A00,202070,Jahed Motlagh; Zeinab,5,0,20,15
1683713321303,CGS 105,A00,185477,Wesling; Megan E.,24,0,40,16
1683713322330,CGS 106,A00,185494,Staff,11,0,22,11
1683713323358,CGS 108,A00,185495,Staff,14,0,20,6
1683713324386,CGS 114,A00,185496,Staff,13,0,18,5
1683713325413,CGS 119,A00,185501,Staff,15,0,20,5
1683713326444,CGS 120,A00,185511,Staff,11,0,20,9
1683713327473,CHEM 4,A01,184675,Bussey; Thomas J,97,0,100,3
1683713328499,CHEM 6A,A01,184677,Staff,32,0,60,28
1683713329529,CHEM 6B,A01,184679,Staff,63,0,100,37
1683713330558,CHEM 6C,A01,184681,Bussey; Thomas J,0,0,50,50
1683713330558,CHEM 6C,A02,184682,Bussey; Thomas J,32,0,50,18
1683713331582,CHEM 40A,A01,184684,Albizati; Kim F.,33,0,100,67
1683713332611,CHEM 40B,A01,184686,Albizati; Kim F.,0,22,100,100
1683713333640,CHEM 41B,A01,184690,Staff,51,0,100,49
1683713334669,COGS 3,A01,184715,Boyle; Mary E. T.,0,27,40,40
1683713335694,COGS 14B,A01,185172,Staff,0,14,38,38
1683713336720,COGS 18,A01,184736,Staff,14,0,80,66
1683713337746,COGS 100,A01,184932,Staff,0,8,73,73
1683713338773,COGS 101A,A01,184935,Staff,0,40,30,30
1683713339798,COGS 101B,A01,184944,Staff,0,2,30,30
1683713340822,COGS 101C,A01,184946,Staff,0,10,30,30
1683713341854,COGS 102A,A01,184951,Johnson; Christine M.,1,0,40,39
1683713342880,COGS 107B,A01,184953,Mooshagian; Eric Frederick,0,52,40,40
1683713343907,COGS 118B,A01,184959,Gupta; Anjum,0,50,40,40
1683713344935,COGS 153,A00,184961,Staff,1,16,30,29
1683713345963,COGS 177,A00,184962,Staff,0,20,30,30
1683713346995,COGS 187A,A01,184969,Boyle; Mary E. T.,0,19,40,40
1683713348022,COMM 10,A01,185174,Staff,0,5,25,25
1683713348022,COMM 10,A02,185189,Staff,0,2,25,25
1683713348022,COMM 10,A03,269821,Staff,0,1,0,0
1683713349048,COMM 100B,A02,185476,Staff,10,0,25,15
1683713349048,COMM 100B,A03,277340,Staff,25,0,25,0
1683713350073,COMM 100C,A01,185314,Staff,2,0,25,23
1683713350073,COMM 100C,A02,185327,Staff,17,0,25,8
1683713351101,COMM 110M,A00,185349,Staff,0,0,40,40
1683713352132,COMM 113T,A00,185352,Staff,25,0,40,15
1683713353159,COMM 114I,A00,185353,Staff,31,0,40,9
1683713354184,COMM 131,A00,185354,Staff,17,0,30,13
1683713355212,CSE 8A,A50,185358,Cao; Yingjun,0,46,10,10
1683713356237,CSE 8B,A01,185362,Staff,0,48,50,50
1683713357262,CSE 11,A01,185416,Cao; Yingjun,0,91,10,10
1683713358288,CSE 20,A01,185445,Briones; Jor-el Thomas Caparas,3,0,25,22
1683713359318,CSE 21,A01,185447,Staff,9,0,50,41
1683713360345,CSE 101,A01,185451,Staff,0,13,50,50
1683713360345,CSE 101,B01,185453,Jones; Miles E,0,15,50,50
1683713362398,CSE 141,A01,185458,Eldon; John,16,0,100,84
1683713363427,CSE 141L,A01,185461,Eldon; John,8,0,100,92
1683713364455,CSE 142,A01,185463,Staff,34,0,60,26
1683713364455,CSE 142,B01,201355,Staff,0,7,60,60
1683713365489,CSE 142L,A01,185470,Staff,34,0,60,26
1683713365489,CSE 142L,B01,201417,Staff,0,6,60,60
1683713366517,CSE 190,A00,201433,Staff,32,0,49,17
1683713367557,DOC 1,A01,259136,Strom; Megan C.,7,0,15,8
1683713367557,DOC 1,A02,259137,Strom; Megan C.,15,0,15,0
1683713367557,DOC 1,A03,259138,Strom; Megan C.,14,0,15,1
1683713367557,DOC 1,A04,259139,Strom; Megan C.,13,0,15,2
1683713368638,DOC 100D,A00,259140,Pass; Natalye Joann,14,0,25,11
1683713369669,DSGN 1,A01,184749,Rill; Bryan,0,26,30,30
1683713370702,DSGN 100,A01,185168,Staff,0,2,25,25
1683713371729,ECE 5,A01,185626,Morris; Karcher William,0,12,0,0
1683713372755,ECE 101,A01,185628,Staff,14,0,70,56
1683713373787,ECE 107,A01,185635,Baghdadchi; Saharnaz,0,0,20,20
1683713373787,ECE 107,A02,185638,Baghdadchi; Saharnaz,1,0,20,19
1683713374813,ECE 148,A01,185647,Silberman; Jack,0,0,16,16
1683713375844,ECON 1,A01,185537,Crane; Meredith Helen,54,0,70,16
1683713376870,ECON 3,A01,185549,Crane; Meredith Helen,30,0,70,40
1683713377896,ECON 4,A01,203354,Anderson; John Charles,0,5,10,10
1683713378925,ECON 100A,A01,185574,Staff,0,5,40,40
1683713379950,ECON 100B,A01,185576,Staff,0,12,50,50
1683713380981,ECON 100C,A01,185589,Newhouse; Herbert S,30,0,70,40
1683713382007,ECON 105,A00,185608,Vespa; Emanuel Ignacio,19,0,35,16
1683713383033,ECON 109,A01,185610,Shishkin; Denis,9,0,35,26
1683713384058,ECON 110A,A01,185612,Staff,8,0,40,32
1683713385082,ECON 120A,A01,185615,Staff,19,0,40,21
1683713386108,ECON 120C,A01,185617,Sun; Yixiao,0,21,70,70
1683713387134,ECON 144,A00,203346,Squires; Dale E,2,0,35,33
1683713388164,ECON 171,A01,203349,Newhouse; Herbert S,0,1,35,35
1683713389196,ECON 173A,A01,185621,Toda; Alexis Akira,21,0,35,14
1683713390226,EDS 25,A01,202413,Staff,0,1,0,0
1683713390226,EDS 25,A02,202414,Staff,0,1,0,0
1683713390226,EDS 25,A03,202415,Staff,0,0,0,0
1683713390226,EDS 25,A04,202416,Staff,0,1,0,0
1683713390226,EDS 25,A05,202439,Staff,0,0,0,0
1683713390226,EDS 25,A06,202440,Staff,0,0,0,0
1683713390226,EDS 25,B01,202631,Staff,0,0,0,0
1683713390226,EDS 25,B02,202632,Staff,0,0,0,0
1683713390226,EDS 25,B03,202639,Staff,0,0,0,0
1683713390226,EDS 25,B04,202640,Staff,0,0,0,0
1683713390226,EDS 25,B05,202643,Staff,0,0,0,0
1683713390226,EDS 25,B06,202644,Staff,0,0,0,0
1683713391259,EDS 38,A01,202659,Black; Alison Michelle,25,0,25,0
1683713392284,EDS 115,A00,202652,Staff,18,0,30,12
1683713393307,EDS 125,A00,202649,Staff,13,0,30,17
1683713394337,EDS 126,A01,203332,Staff,30,0,30,0
1683713395365,EDS 139,A00,202838,Staff,16,0,25,9
1683713396393,EDS 146,A01,202655,Staff,14,0,25,11
1683713397420,ENG 15,A00,185667,Staff,0,1,0,0
1683713397420,ENG 15,B00,185672,Staff,0,0,0,0
1683713397420,ENG 15,C00,185675,Staff,0,0,0,0
1683713397420,ENG 15,D00,185682,Staff,0,0,0,0
1683713397420,ENG 15,E00,185684,Staff,0,0,0,0
1683713398445,ETHN 103,A00,185710,Staff,0,8,35,35
1683713399476,ETHN 103A,A00,199228,Man; Simeon S,0,0,9,9
1683713400501,ETHN 109,A00,185711,Staff,15,0,35,20
1683713401532,ETHN 142,A00,185726,Staff,0,4,30,30
1683713402561,ETHN 163J,A00,199229,Man; Simeon S,5,0,8,3
1683713403586,ETHN 168,A00,185727,Staff,7,0,10,3
1683713404613,ETHN 182,A00,185728,Staff,0,0,35,35
1683713405637,ETHN 183,A00,185737,Staff,9,0,18,9
1683713406662,GLBH 111,A01,209361,Burgos; Jose L.,0,0,0,0
1683713408718,HIEU 104,A00,185792,Staff,14,0,20,6
1683713409744,HIEU 115,A00,185800,Staff,0,0,20,20
1683713410773,HIEU 128,A00,185801,Staff,0,9,20,20
1683713411800,HIEU 147,A00,185802,Staff,15,0,20,5
1683713412828,HIEU 154,A00,185823,Staff,11,0,20,9
1683713413853,HILA 102,A00,185826,Staff,14,0,20,6
1683713414889,HILD 2C,A01,185778,Staff,0,13,20,20
1683713415920,HILD 7B,A01,185780,Kwak; Nancy,0,17,32,32
1683713415920,HILD 7B,A02,185781,Kwak; Nancy,0,18,32,32
1683713416948,HILD 30,A01,185791,Staff,12,0,20,8
1683713417987,HISC 119,A00,185830,Golan; Tal,0,10,20,20
1683713419016,HITO 156GS,A00,185831,Patterson; Patrick H.,0,0,0,23
1683713420039,HIUS 103,A00,185832,Man; Simeon S,0,4,20,20
1683713421064,HIUS 117,A00,185836,Kwak; Nancy,2,0,20,18
1683713422088,HIUS 125,A00,185840,Man; Simeon S,0,2,23,23
1683713423117,HIUS 149,A00,185845,Staff,1,0,20,19
1683713424149,HUM 3,A01,185882,Zavodny; Tatiana Sophia,0,8,50,50
1683713424149,HUM 3,B01,185899,Caldwell; Michael Alan,0,18,50,50
1683713425173,HUM 3GS,A00,185900,Patterson; Patrick H.,0,0,0,23
1683713426208,HUM 4,A01,185938,Zroka; Amy Liane,28,0,50,22
1683713426208,HUM 4,B01,185956,Watkins; Eric,0,6,50,50
1683713426208,HUM 4,B02,202209,Watkins; Eric,0,6,50,50
1683713426208,HUM 4,B03,202210,Watkins; Eric,0,5,50,50
1683713427234,HUM 5,A01,185958,West; Geoffrey Scott,0,0,50,50
1683713427234,HUM 5,A02,202215,West; Geoffrey Scott,0,1,50,50
1683713428265,INTL 190,A00,185959,Gagnon; Jeffrey C,0,0,0,9
1683713428265,INTL 190,B00,185960,Lettieri; Michael Joseph,0,0,0,2
1683713429294,JAPN 180,A00,254509,Staff,5,0,30,25
1683713430321,LATI 10,A01,202853,Kennemore; Amy Michelle,4,0,35,31
1683713430321,LATI 10,A02,202854,Kennemore; Amy Michelle,3,0,35,32
1683713430321,LATI 10,A03,270054,Kennemore; Amy Michelle,30,0,30,0
1683713431346,LATI 180,A00,202855,Kennemore; Amy Michelle,11,0,20,9
1683713432378,LAWS 101,A00,201767,Golan; Tal,0,7,40,40
1683713433403,LIFR 1C,A00,185961,Staff,6,0,20,14
1683713434427,LIFR 1CX,A00,185962,Staff,7,0,20,13
1683713435455,LIFR 1D,A00,185963,Staff,7,0,20,13
1683713436479,LIFR 1DX,A00,185964,Staff,7,0,20,13
1683713437507,LIGN 101,A01,186039,Staff,43,0,50,7
1683713438531,LIGN 165,A00,186040,Staff,14,0,50,36
1683713439556,LTCS 108,A00,186041,Staff,5,0,10,5
1683713440586,LTCS 119,A00,186042,Staff,15,0,20,5
1683713441616,LTCS 130,A00,186043,Wesling; Megan E.,15,0,25,10
1683713443672,LTEA 138,A00,186119,Staff,14,0,40,26
1683713444699,LTEN 124,A00,186148,Staff,5,0,25,20
1683713445725,LTEN 178,A00,186149,Staff,6,0,15,9
1683713446757,LTEN 181,A00,186150,Blanco; John D,34,0,40,6
1683713447783,LTWL 120,A00,186160,Staff,19,0,25,6
1683713448810,LTWL 165,A00,186161,Staff,22,0,25,3
1683713449838,LTWR 100,A00,186162,Staff,0,5,15,15
1683713450864,LTWR 102,A00,186163,Doller; Ben,5,0,15,10
1683713451895,MAE 8,A01,186412,Staff,0,1,0,0
1683713452926,MAE 30B,A00,186445,Bahadori; Mohammad Yousef,81,0,100,19
1683713453951,MAE 40,A00,186592,Bewley; Thomas R,10,0,50,40
1683713454978,MAE 101B,A00,186593,Bahadori; Mohammad Yousef,80,0,100,20
1683713456003,MAE 105,A00,186594,Bandaru; Prabhakar,10,0,50,40
1683713457031,MAE 107,A00,186599,Pham; Hieu Tan,0,8,120,120
1683713458057,MAE 148,A01,186660,Silberman; Jack,3,0,16,13
1683713459084,MATH 10A,A01,188095,Staff,0,6,35,35
1683713460118,MATH 10B,A01,188097,Bowers; Adam R.,0,12,30,30
1683713460118,MATH 10B,A02,188099,Bowers; Adam R.,0,11,30,30
1683713460118,MATH 10B,B01,188104,Bowers; Adam R.,0,10,30,30
1683713460118,MATH 10B,B02,188106,Bowers; Adam R.,0,9,30,30
1683713461155,MATH 10C,A01,188111,Staff,0,20,30,30
1683713461155,MATH 10C,A02,188127,Staff,0,19,30,30
1683713461155,MATH 10C,A03,188131,Staff,0,19,30,30
1683713461155,MATH 10C,B01,188218,Staff,17,0,30,13
1683713461155,MATH 10C,B02,188244,Staff,13,0,30,17
1683713461155,MATH 10C,B03,188277,Staff,14,0,30,16
1683713462183,MATH 18,A01,188344,Bach; Quang Tran,18,0,30,12
1683713462183,MATH 18,A02,188345,Bach; Quang Tran,11,0,30,19
1683713462183,MATH 18,B01,188353,Bach; Quang Tran,11,0,30,19
1683713462183,MATH 18,B02,188354,Bach; Quang Tran,19,0,30,11
1683713463210,MATH 20A,A01,188374,Staff,11,0,35,24
1683713464243,MATH 20B,A01,188382,Ohm; Ko Woon,7,0,30,23
1683713464243,MATH 20B,A02,188383,Ohm; Ko Woon,22,0,30,8
1683713464243,MATH 20B,B01,188385,Ohm; Ko Woon,7,0,30,23
1683713464243,MATH 20B,B02,188392,Ohm; Ko Woon,22,0,30,8
1683713465269,MATH 20C,A01,188394,Harel; Guershon,10,0,30,20
1683713465269,MATH 20C,A02,188395,Harel; Guershon,13,0,30,17
1683713465269,MATH 20C,B01,188404,Harel; Guershon,5,0,30,25
1683713465269,MATH 20C,B02,188405,Harel; Guershon,18,0,30,12
1683713466302,MATH 20D,A01,188414,Hammock; Frances H,0,1,30,30
1683713466302,MATH 20D,A02,188415,Hammock; Frances H,0,1,30,30
1683713466302,MATH 20D,B01,188447,Hammock; Frances H,0,1,30,30
1683713466302,MATH 20D,B02,188486,Hammock; Frances H,2,0,30,28
1683713467329,MATH 20E,A01,188649,Staff,21,0,30,9
1683713467329,MATH 20E,A02,188650,Staff,20,0,30,10
1683713467329,MATH 20E,A03,188673,Staff,0,0,30,30
1683713468358,MATH 102,A01,188675,Staff,0,40,35,35
1683713469386,MATH 103B,A01,188681,Staff,3,0,35,32
1683713469386,MATH 103B,B01,188692,Staff,5,0,35,30
1683713470416,MATH 109,A01,188695,Salehi Golsefidy; Alireza,24,0,35,11
1683713470416,MATH 109,A02,188696,Salehi Golsefidy; Alireza,25,0,35,10
1683713471447,MATH 120A,A01,188698,Eggers; John Dietrich,7,0,35,28
1683713472558,MATH 142B,A01,188736,Ioana; Adrian,0,0,30,30
1683713472558,MATH 142B,A02,188741,Ioana; Adrian,0,1,30,30
1683713472558,MATH 142B,A03,188743,Ioana; Adrian,0,2,30,30
1683713473584,MATH 168A,A01,188790,Staff,0,11,35,35
1683713474613,MATH 170A,A01,188803,Nie; Jiawang,0,2,35,35
1683713474613,MATH 170A,A02,188811,Nie; Jiawang,0,1,35,35
1683713474613,MATH 170A,A03,188814,Nie; Jiawang,1,0,35,34
1683713474613,MATH 170A,A04,188815,Nie; Jiawang,5,0,35,30
1683713475642,MATH 193B,A01,188817,Staff,0,0,35,35
1683713475642,MATH 193B,A02,188818,Staff,6,0,35,29
1683713476669,MGT 4,A01,202857,Anderson; John Charles,59,0,80,21
1683713477698,MGT 12,A00,202858,Lindenberger; Wade Douglas,40,0,90,50
1683713478723,MGT 18,A00,202859,Staff,73,0,90,17
1683713479749,MGT 18GS,A00,202860,McKay; Michael J,13,0,28,15
1683713480785,MGT 45,A00,202861,Pecore; Joseph P.,8,0,90,82
1683713481827,MGT 100,A00,202863,Yavorsky; Daniel Ryan,27,0,90,63
1683713482853,MGT 103,A00,202864,Ehrich; Kristine R,0,19,90,90
1683713483882,MGT 112,A00,202865,Ehrich; Kristine R,15,0,90,75
1683713484909,MGT 121A,A00,202868,Staff,70,0,90,20
1683713485933,MGT 131B,A00,202869,Anderson; John Charles,58,0,90,32
1683713486956,MGT 136,A00,202871,Lindenberger; Wade Douglas,83,0,90,7
1683713487982,MGT 164,A00,202873,Staff,0,67,90,91
1683713489008,MGT 164GS,A00,202874,McKay; Mary A,13,0,28,15
1683713490033,MGT 180,A00,202875,Staff,0,51,90,91
1683713491059,MMW 11R,A01,205019,Herbst; Matthew,0,0,30,30
1683713491059,MMW 11R,A02,205026,Herbst; Matthew,29,0,30,1
1683713492094,MMW 15,A01,193512,Chang; Edmond Yi-Teh,0,8,28,28
1683713492094,MMW 15,A02,193513,Chang; Edmond Yi-Teh,0,5,28,28
1683713492094,MMW 15,A03,193514,Chang; Edmond Yi-Teh,0,5,28,28
1683713492094,MMW 15,A04,193515,Chang; Edmond Yi-Teh,0,5,28,28
1683713492094,MMW 15,A05,193516,Chang; Edmond Yi-Teh,0,5,28,28
1683713492094,MMW 15,A06,193517,Chang; Edmond Yi-Teh,0,6,28,28
1683713492094,MMW 15,B01,193519,Chang; Edmond Yi-Teh,0,5,28,28
1683713492094,MMW 15,B02,193520,Chang; Edmond Yi-Teh,0,5,28,28
1683713492094,MMW 15,B03,193521,Chang; Edmond Yi-Teh,0,5,28,28
1683713492094,MMW 15,B04,193522,Chang; Edmond Yi-Teh,0,6,28,28
1683713492094,MMW 15,B05,193523,Chang; Edmond Yi-Teh,0,5,28,28
1683713492094,MMW 15,B06,193524,Chang; Edmond Yi-Teh,0,5,28,28
1683713493123,MMW 122,A01,193526,Rahimi; Babak,0,16,28,28
1683713493123,MMW 122,A02,193527,Rahimi; Babak,0,15,28,28
1683713493123,MMW 122,A03,193528,Rahimi; Babak,0,0,0,0
1683713493123,MMW 122,A04,193529,Rahimi; Babak,0,0,0,0
1683713494152,MUS 1A,A01,186663,Staff,0,18,35,35
1683713495182,MUS 4,A01,186715,Staff,0,12,35,35
1683713496207,MUS 5R,A01,186796,Dubnov; Shlomo,0,17,35,35
1683713497231,MUS 6,A01,186798,Staff,0,4,25,25
1683713498255,MUS 7,A01,186830,Staff,11,0,35,24
1683713499280,MUS 8,A01,186930,Staff,0,27,35,35
1683713500310,MUS 15,A01,186932,Staff,0,15,35,35
1683713500310,MUS 15,B01,186934,Staff,0,16,35,35
1683713501336,MUS 80,A00,186935,Staff,0,0,20,20
1683713501336,MUS 80,B00,186936,Staff,24,0,25,1
1683713502362,NANO 11,A00,204702,Lipomi; Darren John,0,0,0,0
1683713503392,NANO 15,A01,204709,Yang; Kesong,0,1,0,0
1683713504418,NANO 114,A00,202069,Jahed Motlagh; Zeinab,2,0,10,8
1683713505443,PHIL 1,A00,186955,Grush; Rick Scott,31,0,40,9
1683713506473,PHIL 10,A01,186973,Grush; Rick Scott,27,0,35,8
1683713506473,PHIL 10,A02,186974,Grush; Rick Scott,33,0,35,2
1683713507502,PHIL 13,A01,186976,Staff,1,0,35,34
1683713507502,PHIL 13,A02,186977,Staff,16,0,35,19
1683713508532,PHIL 14,A01,186979,Staff,30,0,35,5
1683713508532,PHIL 14,A02,186986,Staff,32,0,35,3
1683713509558,PHIL 28,A01,186988,Staff,16,0,30,14
1683713509558,PHIL 28,A02,186989,Staff,0,0,30,30
1683713509558,PHIL 28,A03,186990,Staff,10,0,30,20
1683713509558,PHIL 28,A04,186991,Staff,26,0,30,4
1683713510582,PHIL 120,A00,186997,Staff,23,0,40,17
1683713511612,PHIL 137,A00,187003,Staff,8,0,40,32
1683713512636,PHIL 150,A00,187015,Staff,47,0,70,23
1683713513666,PHIL 167,A00,187021,Lamey; Andy M.,34,0,40,6
1683713514693,PHIL 174,A01,202226,Staff,17,0,20,3
1683713514693,PHIL 174,A02,202235,Staff,20,0,20,0
1683713515728,PHIL 191A,A00,258918,Staff,0,0,1,1
1683713516759,PHYS 1A,A00,187028,Staff,26,0,60,34
1683713517785,PHYS 1AL,001,187036,Staff,3,0,30,27
1683713517785,PHYS 1AL,002,187049,Staff,18,0,30,12
1683713518810,PHYS 1B,A00,187058,Staff,21,0,60,39
1683713519836,PHYS 1BL,001,187064,Staff,0,1,30,30
1683713519836,PHYS 1BL,002,187070,Staff,4,0,30,26
1683713520861,PHYS 1C,A00,187082,Staff,30,0,120,90
1683713521888,PHYS 1CL,001,187088,Staff,0,9,30,30
1683713521888,PHYS 1CL,002,187089,Staff,0,1,30,30
1683713521888,PHYS 1CL,009,262693,Staff,9,0,30,21
1683713522917,PHYS 2B,A01,187097,Staff,55,0,115,60
1683713523943,PHYS 2C,A01,187099,Staff,63,0,115,52
1683713524974,PHYS 2CL,A01,187101,Staff,5,0,28,23
1683713524974,PHYS 2CL,A02,187102,Staff,15,0,28,13
1683713526001,PHYS 2D,A01,187123,Shotwell; Brian,95,0,115,20
1683713527031,PHYS 4B,A01,187133,Grinstein; Benjamin,35,0,50,15
1683713528060,POLI 10,A00,188819,Staff,0,4,50,50
1683713529088,POLI 11,A00,188827,Staff,43,0,50,7
1683713530117,POLI 13R,A00,188828,Staff,0,1,20,20
1683713531144,POLI 27,A01,188830,Elgin; Samuel Zincke,0,2,70,70
1683713532170,POLI 30,A00,188832,Desposato; Scott,30,0,50,20
1683713533195,POLI 102F,A00,188834,Staff,1,0,40,39
1683713534222,POLI 104A,A00,188852,Staff,12,0,30,18
1683713535247,POLI 104I,A00,188853,Staff,0,8,20,20
1683713536271,POLI 110B,A00,188854,Wiens; David,6,0,20,14
1683713537296,POLI 112A,A00,188855,Wiens; David,3,0,30,27
1683713538321,POLI 117R,A00,188856,Forman; Fonna,0,12,20,20
1683713539351,POLI 118,A00,188857,Ingham; Sean,8,0,20,12
1683713540379,POLI 120G,A00,188858,Staff,7,0,30,23
1683713541406,POLI 131CR,A00,188863,Hoston; Germaine,20,0,50,30
1683713542431,POLI 133,A00,188864,Nellis; Gareth Hb,44,0,50,6
1683713543461,POLI 134D,A00,188865,Desposato; Scott,27,0,30,3
1683713544492,POLI 142A,A00,188871,Gartzke; Erik,21,0,50,29
1683713545521,POLI 142K,A00,188874,Staff,38,0,50,12
1683713546546,POLI 143,A00,188940,Gartzke; Erik,15,0,30,15
1683713547572,POLI 153,A00,188943,Staff,1,0,20,19
1683713548597,POLI 160AA,A00,188944,Staff,10,0,40,30
1683713549622,POLI 170A,A00,188945,Staff,10,0,30,20
1683713551676,PSYC 1,A00,188952,Staff,36,0,90,54
1683713552701,PSYC 2,B00,188953,Staff,19,0,35,16
1683713553725,PSYC 6,A00,188970,Staff,47,0,60,13
1683713554753,PSYC 7,A00,188973,Staff,35,0,45,10
1683713555779,PSYC 60,A01,188980,Rickard; Timothy C.,42,0,60,18
1683713556806,PSYC 70,A01,189001,Steiner; Eric Tomas,22,0,45,23
1683713557832,PSYC 100,A00,189005,Lacefield; Katharine I,1,98,120,119
1683713558858,PSYC 102,A00,189008,Staff,6,0,30,24
1683713559885,PSYC 106,B00,189026,Gorman; Michael R.,27,0,60,33
1683713560909,PSYC 114,B01,189033,Winkielman; Piotr,0,31,30,30
1683713561935,PSYC 131,A00,189036,Anagnostaras; Stephan,0,44,60,60
1683713562965,PSYC 136,A00,189041,Lowe; Angela Beth,0,7,25,25
1683713563994,PSYC 137,A00,189057,Winkielman; Piotr,0,36,25,25
1683713565020,PSYC 144,A00,189107,Wixted; John T,0,11,50,50
1683713567074,PSYC 162,A00,189142,Staff,0,9,85,85
1683713568100,PSYC 172,A00,189144,Gorman; Michael R.,0,6,30,30
1683713570154,PSYC 179,A00,189146,Lacefield; Katharine I,0,88,120,120
1683713571183,PSYC 181,A00,189147,Anagnostaras; Stephan,0,45,90,90
1683713572215,PSYC 190R,A00,189148,Barner; David A.,0,23,80,80
1683713573242,PSYC 191,A00,189275,Rickard; Timothy C.,0,11,25,25
1683713574268,PSYC 193,A00,189276,Chapman; Eddie Nathaniel,0,1,0,4
1683713575293,PSYC 193L,A01,189281,Lowe; Angela Beth,8,0,20,12
1683713575293,PSYC 193L,B01,189285,Staff,28,0,35,7
1683713576376,RELI 149,A00,187137,Rahimi; Babak,6,0,40,34
1683713577403,SE 9,A01,187315,Staff,0,2,18,18
1683713578426,SE 101B,A00,187409,Staff,24,0,30,6
1683713579451,SE 110B,A00,187444,Staff,10,0,40,30
1683713580481,SE 130B,A00,187449,Staff,31,0,40,9
1683713581510,SE 150A,A00,187516,Staff,8,0,20,12
1683713582539,SE 154,A00,187528,Staff,29,0,50,21
1683713583567,SIO 3,A01,258171,Staff,35,0,40,5
1683713584600,SIO 10,A00,187144,Cook; Geoffrey W,0,6,75,75
1683713585624,SIO 45,A00,187152,Cook; Geoffrey W,1,7,100,99
1683713586649,SIO 109R,A00,194486,Staff,0,4,20,20
1683713588703,SIO 187,A01,187233,Kacev; David,12,0,40,28
1683713589747,SOCI 1,A01,258656,Thorpe; Charles Robert,28,0,30,2
1683713589747,SOCI 1,A02,258658,Thorpe; Charles Robert,30,0,30,0
1683713589747,SOCI 1,A03,258661,Thorpe; Charles Robert,25,0,25,0
1683713589747,SOCI 1,A04,258666,Thorpe; Charles Robert,22,0,25,3
1683713589747,SOCI 1,A05,258897,Thorpe; Charles Robert,22,0,25,3
1683713589747,SOCI 1,A06,258898,Thorpe; Charles Robert,25,0,25,0
1683713590779,SOCI 30,A01,258903,Pardo Guerra; Juan Pablo,14,0,30,16
1683713591805,SOCI 102,A00,258904,Staff,9,0,25,16
1683713592835,SOCI 106,A00,258905,Staff,19,0,25,6
1683713593863,SOCI 111,A00,258907,Ribas Norris; Janet Vanesa,26,0,30,4
1683713594889,SOCI 121R,A00,258908,Pardo Guerra; Juan Pablo,7,0,30,23
1683713595915,SOCI 126,A01,203330,Staff,14,0,20,6
1683713596944,SOCI 131,A00,258909,Thorpe; Charles Robert,30,0,60,30
1683713597969,SOCI 135,A00,258910,Payne; Christine Anna,0,13,30,30
1683713598995,SOCI 157,A00,258911,Staff,10,0,30,20
1683713600021,SOCI 184,A00,258912,Staff,25,0,30,5
1683713601044,SOCI 188D,A00,258913,Staff,22,0,30,8
1683713602070,SYN 2,001,187529,Staff,9,0,16,7
1683713602070,SYN 2,002,201452,Staff,0,20,16,16
1683713602070,SYN 2,003,201469,Staff,1,0,16,15
1683713603099,SYN 100,A01,187531,Staff,0,9,20,20
1683713603099,SYN 100,B01,201491,Staff,0,10,20,20
1683713604127,TDAC 1,A00,189286,Walsh; Kim C.,3,0,20,17
1683713604127,TDAC 1,B00,189287,Harting; Carla Kelso,10,0,20,10
1683713605152,TDAC 101,A00,189300,Walsh; Kim C.,16,0,20,4
1683713605152,TDAC 101,B00,189301,Harting; Carla Kelso,18,0,20,2
1683713606185,TDAC 102,A00,189304,Basso; Beatrice,14,0,20,6
1683713607211,TDAC 108,A00,189305,Staff,18,0,20,2
1683713608237,TDDE 131,A00,189310,Staff,19,0,20,1
1683713608237,TDDE 131,B00,189314,Staff,19,0,20,1
1683713608237,TDDE 131,C00,189315,Staff,48,0,50,2
1683713608237,TDDE 131,D00,189316,Staff,14,0,15,1
1683713608237,TDDE 131,E00,204841,Staff,20,0,20,0
1683713609262,TDGE 10,A00,189289,Staff,27,0,50,23
1683713609262,TDGE 10,B00,189290,Havis; Allan,0,1,50,50
1683713610290,TDGE 11,A00,189291,Fulton; Julia,0,4,50,50
1683713610290,TDGE 11,B00,189292,Staff,20,0,25,5
1683713610290,TDGE 11,C00,260270,Staff,0,0,0,0
1683713611318,TDGE 25,A00,189294,Staff,1,0,20,19
1683713612343,TDGE 124,A00,189318,Fulton; Julia,0,7,50,50
1683713613371,TDGE 125,A00,189319,Staff,13,0,25,12
1683713613371,TDGE 125,B00,189320,Staff,23,0,25,2
1683713614395,TDGE 127,A00,189322,Havis; Allan,1,0,50,49
1683713615421,TDHT 101,A00,189323,Staff,18,0,25,7
1683713615421,TDHT 101,B00,189324,Staff,25,0,25,0
1683713616447,TDHT 102,A00,189325,Staff,49,0,50,1
1683713617474,TDMV 1,A00,189295,Arcidiacono; Kristin,20,0,30,10
1683713617474,TDMV 1,B00,189296,Caligagan; Maria T.,23,0,30,7
1683713618505,TDMV 2,A00,189297,Sammartano; Tonnie,27,0,30,3
1683713618505,TDMV 2,B00,189299,Arcidiacono; Kristin,23,0,30,7
1683713619531,TDMV 3,A00,204998,Rincon; Alicia,22,0,30,8
1683713620557,TDMV 120,A00,189458,Sammartano; Tonnie,28,0,30,2
1683713621585,TDMV 138,A00,189541,Jun; Grace Shin Hae,20,0,40,20
1683713622616,TDMV 142,A00,189717,Caligagan; Tony,25,0,30,5
1683713622616,TDMV 142,B00,189718,Caligagan; Maria T.,25,0,30,5
1683713623642,TMC 2,A01,187533,Staff,25,0,25,0
1683713623642,TMC 2,A02,187534,Staff,25,0,25,0
1683713624668,USP 1,A01,187536,Kwak; Nancy,0,16,25,25
1683713625692,USP 5,A01,187538,Staff,8,0,25,17
1683713626718,USP 101,A00,199253,Staff,0,4,0,0
1683713627742,USP 124,A00,187562,Boomhower; Matthew Charles,0,0,30,30
1683713628769,USP 138,A00,187582,Staff,19,0,25,6
1683713629798,USP 152,A01,187597,Staff,3,0,25,22
1683713630826,USP 153,A00,187598,Staff,18,0,25,7
1683713631853,USP 168,A00,187607,Kwak; Nancy,2,0,5,3
1683713632877,USP 173,A00,187619,Staff,4,0,25,21
1683713633906,USP 181,A00,187638,Staff,0,4,25,25
1683713634935,VIS 103,A00,187650,Cruz; Edwin Teddy,17,0,75,58
1683713635959,VIS 110D,A00,187669,Staff,13,0,22,9
1683713636982,VIS 127C,A00,187720,Shen; Kuiyi,67,0,146,79
1683713638013,VIS 149,A00,187731,Yoldas; Pinar,0,12,22,22
1683713639039,VIS 151,A01,188091,Staff,22,0,34,12
1683713639039,VIS 151,A02,188092,Staff,11,0,34,23
1683713640065,VIS 160B,A00,188093,Stalbaum; Brett,0,1,10,10
1683713642118,WCWP 10B,A00,201720,Staff,0,0,5,5
1683713642118,WCWP 10B,B00,201722,Staff,0,0,6,6
1683713643145,WCWP 100,A00,201725,Gagnon; Jeffrey C,0,0,2,2
1683713643145,WCWP 100,B00,201727,Staff,0,4,15,15
1683713646293,ANBI 133,A00,258401,Wilder; Linnea Lorene,34,0,40,6
1683713647322,ANBI 140,A00,258395,Hrvoj Mihic; Branka,18,0,25,7
1683713648349,ANSC 120,A00,258402,Bialecki; Jon Anthony,26,0,40,14
1683713649376,ANSC 144,A00,258400,Staff,12,0,40,28
1683713651425,ANSC 166,A00,258396,Parish; Steven Martin,156,0,175,19
1683713652453,ANSC 180,A00,193533,Staff,8,0,20,12
1683713653482,ANSC 188,A00,258397,Jassal; Aftab,34,0,40,6
1683713654506,ANTH 3,A01,258316,Staff,23,0,30,7
1683713655534,ANTH 5,A00,258394,Semendeferi; Ekaterini,16,0,20,4
1683713656563,ANTH 21,A01,258331,Staff,4,0,40,36
1683713657587,ANTH 103,A00,258398,Varma; Saiba,15,0,25,10
1683713658617,AWP 10,001,202034,Staff,0,0,0,0
1683713658617,AWP 10,002,202035,Staff,0,0,0,0
1683713658617,AWP 10,003,202036,Staff,0,0,0,0
1683713658617,AWP 10,004,202037,Staff,0,0,0,0
1683713658617,AWP 10,005,202038,Staff,0,0,0,0
1683713658617,AWP 10,006,202039,Staff,0,0,0,0
1683713658617,AWP 10,007,202040,Staff,0,0,0,0
1683713658617,AWP 10,008,202041,Staff,0,0,0,0
1683713658617,AWP 10,009,202042,Staff,0,0,0,0
1683713658617,AWP 10,010,202043,Staff,0,0,0,0
1683713658617,AWP 10,011,202044,Staff,0,0,0,0
1683713658617,AWP 10,012,202045,Staff,0,0,0,0
1683713658617,AWP 10,013,202046,Staff,0,0,0,0
1683713658617,AWP 10,014,202047,Staff,0,0,0,0
1683713658617,AWP 10,015,202048,Staff,0,0,0,0
1683713658617,AWP 10,016,202049,Staff,0,0,0,0
1683713658617,AWP 10,017,202050,Staff,0,0,0,0
1683713658617,AWP 10,018,202051,Staff,0,0,0,0
1683713658617,AWP 10,019,202052,Staff,0,0,0,0
1683713658617,AWP 10,020,202053,Staff,0,0,0,0
1683713658617,AWP 10,021,202054,Staff,0,0,0,0
1683713658617,AWP 10,022,202055,Staff,0,0,0,0
1683713658617,AWP 10,023,202056,Staff,0,0,0,0
1683713658617,AWP 10,024,202057,Staff,0,0,0,0
1683713658617,AWP 10,025,202058,Staff,0,0,0,0
1683713658617,AWP 10,026,202059,Staff,0,0,0,0
1683713659643,AWP 102,001,202032,Staff,0,0,0,0
1683713659643,AWP 102,002,202033,Staff,0,0,0,0
1683713660677,BENG 100,A01,254234,Taylor Amos; Alyssa C,31,0,40,9
1683713661720,BENG 196,001,270013,Engler; Adam J.,9999,0,9999,0
1683713662748,BICD 100R,A01,202018,Smith; Laurie,0,7,32,32
1683713662748,BICD 100R,A02,202019,Smith; Laurie,0,3,32,32
1683713662748,BICD 100R,A03,202020,Smith; Laurie,0,1,32,32
1683713662748,BICD 100R,A04,202021,Smith; Laurie,6,0,32,26
1683713662748,BICD 100R,A05,202022,Smith; Laurie,10,0,32,22
1683713663776,BICD 136,A01,193242,Gustafson-Brown; Cindy,0,2,32,32
1683713663776,BICD 136,A02,193244,Gustafson-Brown; Cindy,13,0,32,19
1683713664804,BIEB 102,A01,193249,Butler; Shannon Rhey,0,0,32,32
1683713664804,BIEB 102,A02,193251,Butler; Shannon Rhey,0,0,32,32
1683713664804,BIEB 102,A03,193253,Butler; Shannon Rhey,0,0,32,32
1683713664804,BIEB 102,A04,193255,Butler; Shannon Rhey,13,0,32,19
1683713664804,BIEB 102,A05,193265,Butler; Shannon Rhey,25,0,32,7
1683713664804,BIEB 102,A06,193269,Butler; Shannon Rhey,12,0,32,20
1683713666855,BIEB 150,A01,193274,Staff,0,0,32,32
1683713666855,BIEB 150,A02,193285,Staff,24,0,32,8
1683713667880,BIEB 194,A00,193286,Kurle; Carolyn M.,19,0,32,13
1683713668908,BILD 1,A01,192291,Staff,15,0,32,17
1683713668908,BILD 1,A02,192292,Staff,30,0,32,2
1683713668908,BILD 1,B01,192520,Reuther; Keefe,0,1,0,0
1683713668908,BILD 1,B02,192532,Reuther; Keefe,0,1,0,0
1683713669933,BILD 3,A01,192556,Butler; Shannon Rhey,0,0,32,32
1683713669933,BILD 3,A02,192581,Butler; Shannon Rhey,0,1,32,32
1683713669933,BILD 3,A03,192611,Butler; Shannon Rhey,19,0,32,13
1683713669933,BILD 3,A04,192612,Butler; Shannon Rhey,23,0,32,9
1683713669933,BILD 3,A05,192613,Butler; Shannon Rhey,26,0,32,6
1683713669933,BILD 3,A06,192679,Butler; Shannon Rhey,27,0,32,5
1683713669933,BILD 3,A07,192682,Butler; Shannon Rhey,20,0,32,12
1683713670965,BILD 4,A01,192836,Reuther; Keefe,1,0,24,23
1683713670965,BILD 4,A02,193044,Reuther; Keefe,4,0,24,20
1683713671990,BILD 10,A01,193142,Gustafson-Brown; Cindy,29,0,32,3
1683713671990,BILD 10,A02,193149,Gustafson-Brown; Cindy,31,0,32,1
1683713673017,BIMM 100,A01,193301,Staff,0,6,32,32
1683713673017,BIMM 100,A02,193312,Staff,0,7,32,32
1683713673017,BIMM 100,A03,193323,Staff,0,10,32,32
1683713674042,BIMM 101,A01,193329,McDonnell; Lisa Marie,0,3,24,24
1683713674042,BIMM 101,A02,193339,McDonnell; Lisa Marie,0,3,24,24
1683713674042,BIMM 101,B01,193354,McDonnell; Lisa Marie,0,4,24,24
1683713674042,BIMM 101,B02,193357,McDonnell; Lisa Marie,0,3,24,24
1683713675068,BIMM 110,A01,193377,Tat; John,0,11,32,32
1683713675068,BIMM 110,A02,193378,Tat; John,0,11,32,32
1683713676096,BIMM 120,A01,206116,Staff,0,0,32,32
1683713676096,BIMM 120,A02,206117,Staff,7,0,32,25
1683713676096,BIMM 120,A03,206121,Staff,21,0,32,11
1683713677123,BIPN 100,A01,193393,Park; Ji Young,0,15,32,32
1683713677123,BIPN 100,A02,193402,Park; Ji Young,0,14,32,32
1683713677123,BIPN 100,A03,193413,Park; Ji Young,0,14,32,32
1683713677123,BIPN 100,A04,193414,Park; Ji Young,0,13,32,32
1683713678149,BIPN 102,A01,193429,Staff,0,0,32,32
1683713678149,BIPN 102,A02,193438,Staff,18,0,32,14
1683713679176,BIPN 106,A01,193450,Reyes Gonzalez; Catalina,0,2,40,40
1683713680265,BIPN 134,A01,193465,Cooke; James Edward,0,0,32,32
1683713680265,BIPN 134,A02,193474,Cooke; James Edward,25,0,32,7
1683713680265,BIPN 134,A03,193485,Cooke; James Edward,29,0,32,3
1683713680265,BIPN 134,A04,193486,Cooke; James Edward,20,0,32,12
1683713680265,BIPN 134,A05,193491,Cooke; James Edward,31,0,32,1
1683713680265,BIPN 134,A06,193501,Cooke; James Edward,30,0,32,2
1683713680265,BIPN 134,A07,193510,Cooke; James Edward,29,0,32,3
1683713682315,BISP 194,A00,222522,Staff,14,0,32,18
1683713683343,CAT 124,A01,202407,Staff,19,0,25,6
1683713684371,CAT 125,A00,202408,Marchisotto; Jennifer Anne,2,0,20,18
1683713685409,CAT 125R,A00,202409,Smith; Lauryn Alissa,0,11,20,20
1683713685409,CAT 125R,B00,202410,Morales; Celeste Georgianna,0,11,20,20
1683713685409,CAT 125R,C00,202411,Irwin; Matthew Joseph,0,12,20,20
1683713686436,CENG 15,A01,204712,Yang; Kesong,0,1,0,0
1683713687467,CENG 114,A00,202070,Jahed Motlagh; Zeinab,5,0,20,15
1683713688501,CGS 105,A00,185477,Wesling; Megan E.,24,0,40,16
1683713689526,CGS 106,A00,185494,Staff,11,0,22,11
1683713690550,CGS 108,A00,185495,Staff,14,0,20,6
1683713691580,CGS 114,A00,185496,Staff,13,0,18,5
1683713692608,CGS 119,A00,185501,Staff,15,0,20,5
1683713693633,CGS 120,A00,185511,Staff,11,0,20,9
1683713694666,CHEM 4,A01,184675,Bussey; Thomas J,97,0,100,3
1683713695695,CHEM 6A,A01,184677,Staff,32,0,60,28
1683713696721,CHEM 6B,A01,184679,Staff,63,0,100,37
1683713697746,CHEM 6C,A01,184681,Bussey; Thomas J,0,0,50,50
1683713697746,CHEM 6C,A02,184682,Bussey; Thomas J,32,0,50,18
1683713698773,CHEM 40A,A01,184684,Albizati; Kim F.,33,0,100,67
1683713699798,CHEM 40B,A01,184686,Albizati; Kim F.,0,22,100,100
1683713700823,CHEM 41B,A01,184690,Staff,51,0,100,49
1683713701863,COGS 3,A01,184715,Boyle; Mary E. T.,0,27,40,40
1683713702895,COGS 14B,A01,185172,Staff,0,14,38,38
1683713703919,COGS 18,A01,184736,Staff,14,0,80,66
1683713704943,COGS 100,A01,184932,Staff,0,8,73,73
1683713705970,COGS 101A,A01,184935,Staff,0,40,30,30
1683713706997,COGS 101B,A01,184944,Staff,0,2,30,30
1683713708024,COGS 101C,A01,184946,Staff,0,10,30,30
1683713709054,COGS 102A,A01,184951,Johnson; Christine M.,1,0,40,39
1683713710079,COGS 107B,A01,184953,Mooshagian; Eric Frederick,0,52,40,40
1683713711109,COGS 118B,A01,184959,Gupta; Anjum,0,50,40,40
1683713712137,COGS 153,A00,184961,Staff,1,16,30,29
1683713713165,COGS 177,A00,184962,Staff,0,20,30,30
1683713714189,COGS 187A,A01,184969,Boyle; Mary E. T.,0,19,40,40
1683713715223,COMM 10,A01,185174,Staff,0,5,25,25
1683713715223,COMM 10,A02,185189,Staff,0,2,25,25
1683713715223,COMM 10,A03,269821,Staff,0,1,0,0
1683713716249,COMM 100B,A02,185476,Staff,10,0,25,15
1683713716249,COMM 100B,A03,277340,Staff,25,0,25,0
1683713717274,COMM 100C,A01,185314,Staff,2,0,25,23
1683713717274,COMM 100C,A02,185327,Staff,17,0,25,8
1683713718299,COMM 110M,A00,185349,Staff,0,0,40,40
1683713719327,COMM 113T,A00,185352,Staff,25,0,40,15
1683713720352,COMM 114I,A00,185353,Staff,31,0,40,9
1683713721378,COMM 131,A00,185354,Staff,17,0,30,13
1683713722408,CSE 8A,A50,185358,Cao; Yingjun,0,46,10,10
1683713723433,CSE 8B,A01,185362,Staff,0,48,50,50
1683713724463,CSE 11,A01,185416,Cao; Yingjun,0,91,10,10
1683713725488,CSE 20,A01,185445,Briones; Jor-el Thomas Caparas,3,0,25,22
1683713726513,CSE 21,A01,185447,Staff,9,0,50,41
1683713727547,CSE 101,A01,185451,Staff,0,13,50,50
1683713727547,CSE 101,B01,185453,Jones; Miles E,0,15,50,50
1683713729601,CSE 141,A01,185458,Eldon; John,16,0,100,84
1683713730630,CSE 141L,A01,185461,Eldon; John,8,0,100,92
1683713731658,CSE 142,A01,185463,Staff,34,0,60,26
1683713731658,CSE 142,B01,201355,Staff,0,7,60,60
1683713732682,CSE 142L,A01,185470,Staff,34,0,60,26
1683713732682,CSE 142L,B01,201417,Staff,0,6,60,60
1683713733705,CSE 190,A00,201433,Staff,32,0,49,17
1683713734737,DOC 1,A01,259136,Strom; Megan C.,7,0,15,8
1683713734737,DOC 1,A02,259137,Strom; Megan C.,15,0,15,0
1683713734737,DOC 1,A03,259138,Strom; Megan C.,14,0,15,1
1683713734737,DOC 1,A04,259139,Strom; Megan C.,13,0,15,2
1683713735767,DOC 100D,A00,259140,Pass; Natalye Joann,14,0,25,11
1683713736797,DSGN 1,A01,184749,Rill; Bryan,0,26,30,30
1683713737824,DSGN 100,A01,185168,Staff,0,2,25,25
1683713738851,ECE 5,A01,185626,Morris; Karcher William,0,12,0,0
1683713739881,ECE 101,A01,185628,Staff,14,0,70,56
1683713740907,ECE 107,A01,185635,Baghdadchi; Saharnaz,0,0,20,20
1683713740907,ECE 107,A02,185638,Baghdadchi; Saharnaz,1,0,20,19
1683713741933,ECE 148,A01,185647,Silberman; Jack,0,0,16,16
1683713742958,ECON 1,A01,185537,Crane; Meredith Helen,54,0,70,16
1683713743983,ECON 3,A01,185549,Crane; Meredith Helen,30,0,70,40
1683713745007,ECON 4,A01,203354,Anderson; John Charles,0,5,10,10
1683713746035,ECON 100A,A01,185574,Staff,0,5,40,40
1683713747061,ECON 100B,A01,185576,Staff,0,12,50,50
1683713748087,ECON 100C,A01,185589,Newhouse; Herbert S,30,0,70,40
1683713749113,ECON 105,A00,185608,Vespa; Emanuel Ignacio,19,0,35,16
1683713750139,ECON 109,A01,185610,Shishkin; Denis,9,0,35,26
1683713751163,ECON 110A,A01,185612,Staff,8,0,40,32
1683713752188,ECON 120A,A01,185615,Staff,19,0,40,21
1683713753220,ECON 120C,A01,185617,Sun; Yixiao,0,21,70,70
1683713754253,ECON 144,A00,203346,Squires; Dale E,2,0,35,33
1683713755278,ECON 171,A01,203349,Newhouse; Herbert S,0,1,35,35
1683713756305,ECON 173A,A01,185621,Toda; Alexis Akira,21,0,35,14
1683713757342,EDS 25,A01,202413,Staff,0,1,0,0
1683713757342,EDS 25,A02,202414,Staff,0,1,0,0
1683713757342,EDS 25,A03,202415,Staff,0,0,0,0
1683713757342,EDS 25,A04,202416,Staff,0,1,0,0
1683713757342,EDS 25,A05,202439,Staff,0,0,0,0
1683713757342,EDS 25,A06,202440,Staff,0,0,0,0
1683713757342,EDS 25,B01,202631,Staff,0,0,0,0
1683713757342,EDS 25,B02,202632,Staff,0,0,0,0
1683713757342,EDS 25,B03,202639,Staff,0,0,0,0
1683713757342,EDS 25,B04,202640,Staff,0,0,0,0
1683713757342,EDS 25,B05,202643,Staff,0,0,0,0
1683713757342,EDS 25,B06,202644,Staff,0,0,0,0
1683713758367,EDS 38,A01,202659,Black; Alison Michelle,25,0,25,0
1683713759393,EDS 115,A00,202652,Staff,18,0,30,12
1683713760427,EDS 125,A00,202649,Staff,13,0,30,17
1683713761457,EDS 126,A01,203332,Staff,30,0,30,0
1683713762483,EDS 139,A00,202838,Staff,16,0,25,9
1683713763509,EDS 146,A01,202655,Staff,14,0,25,11
1683713764535,ENG 15,A00,185667,Staff,0,1,0,0
1683713764535,ENG 15,B00,185672,Staff,0,0,0,0
1683713764535,ENG 15,C00,185675,Staff,0,0,0,0
1683713764535,ENG 15,D00,185682,Staff,0,0,0,0
1683713764535,ENG 15,E00,185684,Staff,0,0,0,0
1683713765563,ETHN 103,A00,185710,Staff,0,8,35,35
1683713766594,ETHN 103A,A00,199228,Man; Simeon S,0,0,9,9
1683713767621,ETHN 109,A00,185711,Staff,15,0,35,20
1683713768650,ETHN 142,A00,185726,Staff,0,4,30,30
1683713769680,ETHN 163J,A00,199229,Man; Simeon S,5,0,8,3
1683713770706,ETHN 168,A00,185727,Staff,7,0,10,3
1683713771733,ETHN 182,A00,185728,Staff,0,0,35,35
1683713772758,ETHN 183,A00,185737,Staff,10,0,18,8
1683713773791,GLBH 111,A01,209361,Burgos; Jose L.,0,0,0,0
1683713775843,HIEU 104,A00,185792,Staff,14,0,20,6
1683713776869,HIEU 115,A00,185800,Staff,0,0,20,20
1683713777895,HIEU 128,A00,185801,Staff,0,9,20,20
1683713778922,HIEU 147,A00,185802,Staff,15,0,20,5
1683713779948,HIEU 154,A00,185823,Staff,11,0,20,9
1683713780977,HILA 102,A00,185826,Staff,14,0,20,6
1683713782003,HILD 2C,A01,185778,Staff,0,13,20,20
1683713783029,HILD 7B,A01,185780,Kwak; Nancy,0,17,32,32
1683713783029,HILD 7B,A02,185781,Kwak; Nancy,0,18,32,32
1683713784118,HILD 30,A01,185791,Staff,12,0,20,8
1683713785148,HISC 119,A00,185830,Golan; Tal,0,10,20,20
1683713786173,HITO 156GS,A00,185831,Patterson; Patrick H.,0,0,0,23
1683713787198,HIUS 103,A00,185832,Man; Simeon S,0,4,20,20
1683713788222,HIUS 117,A00,185836,Kwak; Nancy,2,0,20,18
1683713789252,HIUS 125,A00,185840,Man; Simeon S,0,2,23,23
1683713790281,HIUS 149,A00,185845,Staff,1,0,20,19
1683713791308,HUM 3,A01,185882,Zavodny; Tatiana Sophia,0,8,50,50
1683713791308,HUM 3,B01,185899,Caldwell; Michael Alan,0,18,50,50
1683713792333,HUM 3GS,A00,185900,Patterson; Patrick H.,0,0,0,23
1683713793369,HUM 4,A01,185938,Zroka; Amy Liane,28,0,50,22
1683713793369,HUM 4,B01,185956,Watkins; Eric,0,6,50,50
1683713793369,HUM 4,B02,202209,Watkins; Eric,0,6,50,50
1683713793369,HUM 4,B03,202210,Watkins; Eric,0,5,50,50
1683713794395,HUM 5,A01,185958,West; Geoffrey Scott,0,0,50,50
1683713794395,HUM 5,A02,202215,West; Geoffrey Scott,0,1,50,50
1683713795422,INTL 190,A00,185959,Gagnon; Jeffrey C,0,0,0,9
1683713795422,INTL 190,B00,185960,Lettieri; Michael Joseph,0,0,0,2
1683713796451,JAPN 180,A00,254509,Staff,5,0,30,25
1683713797477,LATI 10,A01,202853,Kennemore; Amy Michelle,4,0,35,31
1683713797477,LATI 10,A02,202854,Kennemore; Amy Michelle,3,0,35,32
1683713797477,LATI 10,A03,270054,Kennemore; Amy Michelle,30,0,30,0
1683713798505,LATI 180,A00,202855,Kennemore; Amy Michelle,11,0,20,9
1683713799531,LAWS 101,A00,201767,Golan; Tal,0,7,40,40
1683713800556,LIFR 1C,A00,185961,Staff,6,0,20,14
1683713801582,LIFR 1CX,A00,185962,Staff,7,0,20,13
1683713802608,LIFR 1D,A00,185963,Staff,7,0,20,13
1683713803632,LIFR 1DX,A00,185964,Staff,7,0,20,13
1683713804658,LIGN 101,A01,186039,Staff,43,0,50,7
1683713805688,LIGN 165,A00,186040,Staff,14,0,50,36
1683713806711,LTCS 108,A00,186041,Staff,5,0,10,5
1683713807737,LTCS 119,A00,186042,Staff,15,0,20,5
1683713808764,LTCS 130,A00,186043,Wesling; Megan E.,15,0,25,10
1683713810818,LTEA 138,A00,186119,Staff,14,0,40,26
1683713811847,LTEN 124,A00,186148,Staff,5,0,25,20
1683713812874,LTEN 178,A00,186149,Staff,6,0,15,9
1683713813903,LTEN 181,A00,186150,Blanco; John D,34,0,40,6
1683713814926,LTWL 120,A00,186160,Staff,19,0,25,6
1683713815952,LTWL 165,A00,186161,Staff,22,0,25,3
1683713816981,LTWR 100,A00,186162,Staff,0,5,15,15
1683713818008,LTWR 102,A00,186163,Doller; Ben,5,0,15,10
1683713819034,MAE 8,A01,186412,Staff,0,1,0,0
1683713820064,MAE 30B,A00,186445,Bahadori; Mohammad Yousef,81,0,100,19
1683713821090,MAE 40,A00,186592,Bewley; Thomas R,10,0,50,40
1683713822114,MAE 101B,A00,186593,Bahadori; Mohammad Yousef,80,0,100,20
1683713823145,MAE 105,A00,186594,Bandaru; Prabhakar,10,0,50,40
1683713824177,MAE 107,A00,186599,Pham; Hieu Tan,0,8,120,120
1683713825203,MAE 148,A01,186660,Silberman; Jack,3,0,16,13
1683713826235,MATH 10A,A01,188095,Staff,0,6,35,35
1683713827267,MATH 10B,A01,188097,Bowers; Adam R.,0,12,30,30
1683713827267,MATH 10B,A02,188099,Bowers; Adam R.,0,11,30,30
1683713827267,MATH 10B,B01,188104,Bowers; Adam R.,0,10,30,30
1683713827267,MATH 10B,B02,188106,Bowers; Adam R.,0,9,30,30
1683713828294,MATH 10C,A01,188111,Staff,0,20,30,30
1683713828294,MATH 10C,A02,188127,Staff,0,19,30,30
1683713828294,MATH 10C,A03,188131,Staff,0,19,30,30
1683713828294,MATH 10C,B01,188218,Staff,17,0,30,13
1683713828294,MATH 10C,B02,188244,Staff,13,0,30,17
1683713828294,MATH 10C,B03,188277,Staff,14,0,30,16
1683713829323,MATH 18,A01,188344,Bach; Quang Tran,18,0,30,12
1683713829323,MATH 18,A02,188345,Bach; Quang Tran,11,0,30,19
1683713829323,MATH 18,B01,188353,Bach; Quang Tran,11,0,30,19
1683713829323,MATH 18,B02,188354,Bach; Quang Tran,19,0,30,11
1683713830351,MATH 20A,A01,188374,Staff,11,0,35,24
1683713831385,MATH 20B,A01,188382,Ohm; Ko Woon,7,0,30,23
1683713831385,MATH 20B,A02,188383,Ohm; Ko Woon,22,0,30,8
1683713831385,MATH 20B,B01,188385,Ohm; Ko Woon,7,0,30,23
1683713831385,MATH 20B,B02,188392,Ohm; Ko Woon,22,0,30,8
1683713832409,MATH 20C,A01,188394,Harel; Guershon,10,0,30,20
1683713832409,MATH 20C,A02,188395,Harel; Guershon,13,0,30,17
1683713832409,MATH 20C,B01,188404,Harel; Guershon,5,0,30,25
1683713832409,MATH 20C,B02,188405,Harel; Guershon,18,0,30,12
1683713833436,MATH 20D,A01,188414,Hammock; Frances H,0,1,30,30
1683713833436,MATH 20D,A02,188415,Hammock; Frances H,0,1,30,30
1683713833436,MATH 20D,B01,188447,Hammock; Frances H,0,1,30,30
1683713833436,MATH 20D,B02,188486,Hammock; Frances H,2,0,30,28
1683713834461,MATH 20E,A01,188649,Staff,21,0,30,9
1683713834461,MATH 20E,A02,188650,Staff,20,0,30,10
1683713834461,MATH 20E,A03,188673,Staff,0,0,30,30
1683713835486,MATH 102,A01,188675,Staff,0,40,35,35
1683713836510,MATH 103B,A01,188681,Staff,3,0,35,32
1683713836510,MATH 103B,B01,188692,Staff,5,0,35,30
1683713837540,MATH 109,A01,188695,Salehi Golsefidy; Alireza,24,0,35,11
1683713837540,MATH 109,A02,188696,Salehi Golsefidy; Alireza,24,0,35,11
1683713838573,MATH 120A,A01,188698,Eggers; John Dietrich,7,0,35,28
1683713839599,MATH 142B,A01,188736,Ioana; Adrian,0,0,30,30
1683713839599,MATH 142B,A02,188741,Ioana; Adrian,0,1,30,30
1683713839599,MATH 142B,A03,188743,Ioana; Adrian,0,2,30,30
1683713840639,MATH 168A,A01,188790,Staff,0,11,35,35
1683713841671,MATH 170A,A01,188803,Nie; Jiawang,0,2,35,35
1683713841671,MATH 170A,A02,188811,Nie; Jiawang,0,1,35,35
1683713841671,MATH 170A,A03,188814,Nie; Jiawang,1,0,35,34
1683713841671,MATH 170A,A04,188815,Nie; Jiawang,5,0,35,30
1683713842695,MATH 193B,A01,188817,Staff,0,0,35,35
1683713842695,MATH 193B,A02,188818,Staff,6,0,35,29
1683713843721,MGT 4,A01,202857,Anderson; John Charles,59,0,80,21
1683713844747,MGT 12,A00,202858,Lindenberger; Wade Douglas,40,0,90,50
1683713845776,MGT 18,A00,202859,Staff,73,0,90,17
1683713846803,MGT 18GS,A00,202860,McKay; Michael J,13,0,28,15
1683713847828,MGT 45,A00,202861,Pecore; Joseph P.,8,0,90,82
1683713848858,MGT 100,A00,202863,Yavorsky; Daniel Ryan,27,0,90,63
1683713849887,MGT 103,A00,202864,Ehrich; Kristine R,0,19,90,90
1683713850914,MGT 112,A00,202865,Ehrich; Kristine R,15,0,90,75
1683713851942,MGT 121A,A00,202868,Staff,70,0,90,20
1683713852967,MGT 131B,A00,202869,Anderson; John Charles,58,0,90,32
1683713853997,MGT 136,A00,202871,Lindenberger; Wade Douglas,83,0,90,7
1683713855022,MGT 164,A00,202873,Staff,0,67,90,91
1683713856047,MGT 164GS,A00,202874,McKay; Mary A,13,0,28,15
1683713857070,MGT 180,A00,202875,Staff,0,51,90,91
1683713858100,MMW 11R,A01,205019,Herbst; Matthew,0,0,30,30
1683713858100,MMW 11R,A02,205026,Herbst; Matthew,29,0,30,1
1683713859132,MMW 15,A01,193512,Chang; Edmond Yi-Teh,0,8,28,28
1683713859132,MMW 15,A02,193513,Chang; Edmond Yi-Teh,0,5,28,28
1683713859132,MMW 15,A03,193514,Chang; Edmond Yi-Teh,0,5,28,28
1683713859132,MMW 15,A04,193515,Chang; Edmond Yi-Teh,0,5,28,28
1683713859132,MMW 15,A05,193516,Chang; Edmond Yi-Teh,0,5,28,28
1683713859132,MMW 15,A06,193517,Chang; Edmond Yi-Teh,0,6,28,28
1683713859132,MMW 15,B01,193519,Chang; Edmond Yi-Teh,0,5,28,28
1683713859132,MMW 15,B02,193520,Chang; Edmond Yi-Teh,0,5,28,28
1683713859132,MMW 15,B03,193521,Chang; Edmond Yi-Teh,0,5,28,28
1683713859132,MMW 15,B04,193522,Chang; Edmond Yi-Teh,0,6,28,28
1683713859132,MMW 15,B05,193523,Chang; Edmond Yi-Teh,0,5,28,28
1683713859132,MMW 15,B06,193524,Chang; Edmond Yi-Teh,0,5,28,28
1683713860159,MMW 122,A01,193526,Rahimi; Babak,0,16,28,28
1683713860159,MMW 122,A02,193527,Rahimi; Babak,0,15,28,28
1683713860159,MMW 122,A03,193528,Rahimi; Babak,0,0,0,0
1683713860159,MMW 122,A04,193529,Rahimi; Babak,0,0,0,0
1683713861186,MUS 1A,A01,186663,Staff,0,18,35,35
1683713862214,MUS 4,A01,186715,Staff,0,12,35,35
1683713863239,MUS 5R,A01,186796,Dubnov; Shlomo,0,17,35,35
1683713864264,MUS 6,A01,186798,Staff,0,4,25,25
1683713865293,MUS 7,A01,186830,Staff,11,0,35,24
1683713866320,MUS 8,A01,186930,Staff,0,27,35,35
1683713867346,MUS 15,A01,186932,Staff,0,15,35,35
1683713867346,MUS 15,B01,186934,Staff,0,16,35,35
1683713868372,MUS 80,A00,186935,Staff,0,0,20,20
1683713868372,MUS 80,B00,186936,Staff,24,0,25,1
1683713869399,NANO 11,A00,204702,Lipomi; Darren John,0,0,0,0
1683713870433,NANO 15,A01,204709,Yang; Kesong,0,1,0,0
1683713871461,NANO 114,A00,202069,Jahed Motlagh; Zeinab,2,0,10,8
1683713872487,PHIL 1,A00,186955,Grush; Rick Scott,31,0,40,9
1683713873516,PHIL 10,A01,186973,Grush; Rick Scott,27,0,35,8
1683713873516,PHIL 10,A02,186974,Grush; Rick Scott,33,0,35,2
1683713874540,PHIL 13,A01,186976,Staff,1,0,35,34
1683713874540,PHIL 13,A02,186977,Staff,16,0,35,19
1683713875566,PHIL 14,A01,186979,Staff,30,0,35,5
1683713875566,PHIL 14,A02,186986,Staff,32,0,35,3
1683713876591,PHIL 28,A01,186988,Staff,16,0,30,14
1683713876591,PHIL 28,A02,186989,Staff,0,0,30,30
1683713876591,PHIL 28,A03,186990,Staff,10,0,30,20
1683713876591,PHIL 28,A04,186991,Staff,26,0,30,4
1683713877618,PHIL 120,A00,186997,Staff,23,0,40,17
1683713878643,PHIL 137,A00,187003,Staff,8,0,40,32
1683713879669,PHIL 150,A00,187015,Staff,47,0,70,23
1683713880709,PHIL 167,A00,187021,Lamey; Andy M.,34,0,40,6
1683713881734,PHIL 174,A01,202226,Staff,17,0,20,3
1683713881734,PHIL 174,A02,202235,Staff,20,0,20,0
1683713882758,PHIL 191A,A00,258918,Staff,0,0,1,1
1683713883783,PHYS 1A,A00,187028,Staff,26,0,60,34
1683713884813,PHYS 1AL,001,187036,Staff,3,0,30,27
1683713884813,PHYS 1AL,002,187049,Staff,18,0,30,12
1683713885839,PHYS 1B,A00,187058,Staff,21,0,60,39
1683713886869,PHYS 1BL,001,187064,Staff,0,1,30,30
1683713886869,PHYS 1BL,002,187070,Staff,4,0,30,26
1683713887952,PHYS 1C,A00,187082,Staff,30,0,120,90
1683713888976,PHYS 1CL,001,187088,Staff,0,9,30,30
1683713888976,PHYS 1CL,002,187089,Staff,0,1,30,30
1683713888976,PHYS 1CL,009,262693,Staff,9,0,30,21
1683713890002,PHYS 2B,A01,187097,Staff,55,0,115,60
1683713891034,PHYS 2C,A01,187099,Staff,63,0,115,52
1683713892065,PHYS 2CL,A01,187101,Staff,5,0,28,23
1683713892065,PHYS 2CL,A02,187102,Staff,15,0,28,13
1683713893095,PHYS 2D,A01,187123,Shotwell; Brian,95,0,115,20
1683713894122,PHYS 4B,A01,187133,Grinstein; Benjamin,35,0,50,15
1683713895150,POLI 10,A00,188819,Staff,0,4,50,50
1683713896173,POLI 11,A00,188827,Staff,43,0,50,7
1683713897201,POLI 13R,A00,188828,Staff,0,1,20,20
1683713898227,POLI 27,A01,188830,Elgin; Samuel Zincke,0,2,70,70
1683713899259,POLI 30,A00,188832,Desposato; Scott,30,0,50,20
1683713900284,POLI 102F,A00,188834,Staff,1,0,40,39
1683713901311,POLI 104A,A00,188852,Staff,12,0,30,18
1683713902336,POLI 104I,A00,188853,Staff,0,8,20,20
1683713903368,POLI 110B,A00,188854,Wiens; David,6,0,20,14
1683713904391,POLI 112A,A00,188855,Wiens; David,3,0,30,27
1683713905417,POLI 117R,A00,188856,Forman; Fonna,0,12,20,20
1683713906448,POLI 118,A00,188857,Ingham; Sean,8,0,20,12
1683713907475,POLI 120G,A00,188858,Staff,7,0,30,23
1683713908498,POLI 131CR,A00,188863,Hoston; Germaine,20,0,50,30
1683713909527,POLI 133,A00,188864,Nellis; Gareth Hb,44,0,50,6
1683713910553,POLI 134D,A00,188865,Desposato; Scott,27,0,30,3
1683713911578,POLI 142A,A00,188871,Gartzke; Erik,21,0,50,29
1683713912603,POLI 142K,A00,188874,Staff,38,0,50,12
1683713913628,POLI 143,A00,188940,Gartzke; Erik,15,0,30,15
1683713914655,POLI 153,A00,188943,Staff,1,0,20,19
1683713915680,POLI 160AA,A00,188944,Staff,10,0,40,30
1683713916710,POLI 170A,A00,188945,Staff,10,0,30,20
1683713918760,PSYC 1,A00,188952,Staff,36,0,90,54
1683713919787,PSYC 2,B00,188953,Staff,19,0,35,16
1683713920814,PSYC 6,A00,188970,Staff,47,0,60,13
1683713921839,PSYC 7,A00,188973,Staff,35,0,45,10
1683713922873,PSYC 60,A01,188980,Rickard; Timothy C.,42,0,60,18
1683713923898,PSYC 70,A01,189001,Steiner; Eric Tomas,22,0,45,23
1683713924924,PSYC 100,A00,189005,Lacefield; Katharine I,1,98,120,119
1683713925947,PSYC 102,A00,189008,Staff,6,0,30,24
1683713926970,PSYC 106,B00,189026,Gorman; Michael R.,27,0,60,33
1683713927995,PSYC 114,B01,189033,Winkielman; Piotr,0,31,30,30
1683713929021,PSYC 131,A00,189036,Anagnostaras; Stephan,0,44,60,60
1683713930045,PSYC 136,A00,189041,Lowe; Angela Beth,0,7,25,25
1683713931070,PSYC 137,A00,189057,Winkielman; Piotr,0,36,25,25
1683713932098,PSYC 144,A00,189107,Wixted; John T,0,11,50,50
1683713934149,PSYC 162,A00,189142,Staff,0,9,85,85
1683713935173,PSYC 172,A00,189144,Gorman; Michael R.,0,6,30,30
1683713937261,PSYC 179,A00,189146,Lacefield; Katharine I,0,88,120,120
1683713938288,PSYC 181,A00,189147,Anagnostaras; Stephan,0,45,90,90
1683713939314,PSYC 190R,A00,189148,Barner; David A.,0,23,80,80
1683713940339,PSYC 191,A00,189275,Rickard; Timothy C.,0,11,25,25
1683713941370,PSYC 193,A00,189276,Chapman; Eddie Nathaniel,0,1,0,4
1683713942401,PSYC 193L,A01,189281,Lowe; Angela Beth,8,0,20,12
1683713942401,PSYC 193L,B01,189285,Staff,28,0,35,7
1683713943427,RELI 149,A00,187137,Rahimi; Babak,6,0,40,34
1683713944453,SE 9,A01,187315,Staff,0,2,18,18
1683713945478,SE 101B,A00,187409,Staff,24,0,30,6
1683713946504,SE 110B,A00,187444,Staff,10,0,40,30
1683713947530,SE 130B,A00,187449,Staff,31,0,40,9
1683713948557,SE 150A,A00,187516,Staff,8,0,20,12
1683713949587,SE 154,A00,187528,Staff,29,0,50,21
1683713950617,SIO 3,A01,258171,Staff,35,0,40,5
1683713951648,SIO 10,A00,187144,Cook; Geoffrey W,0,6,75,75
1683713952674,SIO 45,A00,187152,Cook; Geoffrey W,1,7,100,99
1683713953702,SIO 109R,A00,194486,Staff,0,4,20,20
1683713955754,SIO 187,A01,187233,Kacev; David,12,0,40,28
1683713956784,SOCI 1,A01,258656,Thorpe; Charles Robert,28,0,30,2
1683713956784,SOCI 1,A02,258658,Thorpe; Charles Robert,30,0,30,0
1683713956784,SOCI 1,A03,258661,Thorpe; Charles Robert,25,0,25,0
1683713956784,SOCI 1,A04,258666,Thorpe; Charles Robert,22,0,25,3
1683713956784,SOCI 1,A05,258897,Thorpe; Charles Robert,22,0,25,3
1683713956784,SOCI 1,A06,258898,Thorpe; Charles Robert,25,0,25,0
1683713957809,SOCI 30,A01,258903,Pardo Guerra; Juan Pablo,14,0,30,16
1683713958833,SOCI 102,A00,258904,Staff,9,0,25,16
1683713959856,SOCI 106,A00,258905,Staff,19,0,25,6
1683713960884,SOCI 111,A00,258907,Ribas Norris; Janet Vanesa,26,0,30,4
1683713961913,SOCI 121R,A00,258908,Pardo Guerra; Juan Pablo,7,0,30,23
1683713962939,SOCI 126,A01,203330,Staff,14,0,20,6
1683713963963,SOCI 131,A00,258909,Thorpe; Charles Robert,30,0,60,30
1683713964993,SOCI 135,A00,258910,Payne; Christine Anna,0,13,30,30
1683713966017,SOCI 157,A00,258911,Staff,10,0,30,20
1683713967044,SOCI 184,A00,258912,Staff,25,0,30,5
1683713968068,SOCI 188D,A00,258913,Staff,22,0,30,8
1683713969093,SYN 2,001,187529,Staff,9,0,16,7
1683713969093,SYN 2,002,201452,Staff,0,20,16,16
1683713969093,SYN 2,003,201469,Staff,1,0,16,15
1683713970117,SYN 100,A01,187531,Staff,0,9,20,20
1683713970117,SYN 100,B01,201491,Staff,0,10,20,20
1683713971145,TDAC 1,A00,189286,Walsh; Kim C.,3,0,20,17
1683713971145,TDAC 1,B00,189287,Harting; Carla Kelso,10,0,20,10
1683713972169,TDAC 101,A00,189300,Walsh; Kim C.,16,0,20,4
1683713972169,TDAC 101,B00,189301,Harting; Carla Kelso,18,0,20,2
1683713973197,TDAC 102,A00,189304,Basso; Beatrice,14,0,20,6
1683713974223,TDAC 108,A00,189305,Staff,18,0,20,2
1683713975264,TDDE 131,A00,189310,Staff,19,0,20,1
1683713975264,TDDE 131,B00,189314,Staff,19,0,20,1
1683713975264,TDDE 131,C00,189315,Staff,48,0,50,2
1683713975264,TDDE 131,D00,189316,Staff,14,0,15,1
1683713975264,TDDE 131,E00,204841,Staff,20,0,20,0
1683713976293,TDGE 10,A00,189289,Staff,27,0,50,23
1683713976293,TDGE 10,B00,189290,Havis; Allan,0,1,50,50
1683713977324,TDGE 11,A00,189291,Fulton; Julia,0,4,50,50
1683713977324,TDGE 11,B00,189292,Staff,20,0,25,5
1683713977324,TDGE 11,C00,260270,Staff,0,0,0,0
1683713978347,TDGE 25,A00,189294,Staff,1,0,20,19
1683713979375,TDGE 124,A00,189318,Fulton; Julia,0,7,50,50
1683713980400,TDGE 125,A00,189319,Staff,13,0,25,12
1683713980400,TDGE 125,B00,189320,Staff,23,0,25,2
1683713981424,TDGE 127,A00,189322,Havis; Allan,1,0,50,49
1683713982449,TDHT 101,A00,189323,Staff,18,0,25,7
1683713982449,TDHT 101,B00,189324,Staff,25,0,25,0
1683713983477,TDHT 102,A00,189325,Staff,49,0,50,1
1683713984510,TDMV 1,A00,189295,Arcidiacono; Kristin,20,0,30,10
1683713984510,TDMV 1,B00,189296,Caligagan; Maria T.,23,0,30,7
1683713985535,TDMV 2,A00,189297,Sammartano; Tonnie,27,0,30,3
1683713985535,TDMV 2,B00,189299,Arcidiacono; Kristin,23,0,30,7
1683713986560,TDMV 3,A00,204998,Rincon; Alicia,22,0,30,8
1683713987585,TDMV 120,A00,189458,Sammartano; Tonnie,28,0,30,2
1683713988613,TDMV 138,A00,189541,Jun; Grace Shin Hae,20,0,40,20
1683713989638,TDMV 142,A00,189717,Caligagan; Tony,25,0,30,5
1683713989638,TDMV 142,B00,189718,Caligagan; Maria T.,25,0,30,5
1683713990663,TMC 2,A01,187533,Staff,25,0,25,0
1683713990663,TMC 2,A02,187534,Staff,25,0,25,0
1683713991747,USP 1,A01,187536,Kwak; Nancy,0,16,25,25
1683713992772,USP 5,A01,187538,Staff,8,0,25,17
1683713993801,USP 101,A00,199253,Staff,0,4,0,0
1683713994829,USP 124,A00,187562,Boomhower; Matthew Charles,0,0,30,30
1683713995855,USP 138,A00,187582,Staff,19,0,25,6
1683713996880,USP 152,A01,187597,Staff,3,0,25,22
1683713997907,USP 153,A00,187598,Staff,18,0,25,7
1683713998937,USP 168,A00,187607,Kwak; Nancy,2,0,5,3
1683713999966,USP 173,A00,187619,Staff,4,0,25,21
1683714000990,USP 181,A00,187638,Staff,0,4,25,25
1683714002020,VIS 103,A00,187650,Cruz; Edwin Teddy,17,0,75,58
1683714003045,VIS 110D,A00,187669,Staff,13,0,22,9
1683714004069,VIS 127C,A00,187720,Shen; Kuiyi,67,0,146,79
1683714005094,VIS 149,A00,187731,Yoldas; Pinar,0,12,22,22
1683714006118,VIS 151,A01,188091,Staff,22,0,34,12
1683714006118,VIS 151,A02,188092,Staff,11,0,34,23
1683714007145,VIS 160B,A00,188093,Stalbaum; Brett,0,1,10,10
1683714009200,WCWP 10B,A00,201720,Staff,0,0,5,5
1683714009200,WCWP 10B,B00,201722,Staff,0,0,6,6
1683714010229,WCWP 100,A00,201725,Gagnon; Jeffrey C,0,0,2,2
1683714010229,WCWP 100,B00,201727,Staff,0,4,15,15
1683714013385,ANBI 133,A00,258401,Wilder; Linnea Lorene,34,0,40,6
1683714014414,ANBI 140,A00,258395,Hrvoj Mihic; Branka,18,0,25,7
1683714015443,ANSC 120,A00,258402,Bialecki; Jon Anthony,26,0,40,14
1683714016467,ANSC 144,A00,258400,Staff,12,0,40,28
1683714018521,ANSC 166,A00,258396,Parish; Steven Martin,156,0,175,19
1683714019545,ANSC 180,A00,193533,Staff,8,0,20,12
1683714020570,ANSC 188,A00,258397,Jassal; Aftab,34,0,40,6
1683714021597,ANTH 3,A01,258316,Staff,23,0,30,7
1683714022625,ANTH 5,A00,258394,Semendeferi; Ekaterini,16,0,20,4
1683714023650,ANTH 21,A01,258331,Staff,4,0,40,36
1683714024678,ANTH 103,A00,258398,Varma; Saiba,15,0,25,10
1683714025711,AWP 10,001,202034,Staff,0,0,0,0
1683714025711,AWP 10,002,202035,Staff,0,0,0,0
1683714025711,AWP 10,003,202036,Staff,0,0,0,0
1683714025711,AWP 10,004,202037,Staff,0,0,0,0
1683714025711,AWP 10,005,202038,Staff,0,0,0,0
1683714025711,AWP 10,006,202039,Staff,0,0,0,0
1683714025711,AWP 10,007,202040,Staff,0,0,0,0
1683714025711,AWP 10,008,202041,Staff,0,0,0,0
1683714025711,AWP 10,009,202042,Staff,0,0,0,0
1683714025711,AWP 10,010,202043,Staff,0,0,0,0
1683714025711,AWP 10,011,202044,Staff,0,0,0,0
1683714025711,AWP 10,012,202045,Staff,0,0,0,0
1683714025711,AWP 10,013,202046,Staff,0,0,0,0
1683714025711,AWP 10,014,202047,Staff,0,0,0,0
1683714025711,AWP 10,015,202048,Staff,0,0,0,0
1683714025711,AWP 10,016,202049,Staff,0,0,0,0
1683714025711,AWP 10,017,202050,Staff,0,0,0,0
1683714025711,AWP 10,018,202051,Staff,0,0,0,0
1683714025711,AWP 10,019,202052,Staff,0,0,0,0
1683714025711,AWP 10,020,202053,Staff,0,0,0,0
1683714025711,AWP 10,021,202054,Staff,0,0,0,0
1683714025711,AWP 10,022,202055,Staff,0,0,0,0
1683714025711,AWP 10,023,202056,Staff,0,0,0,0
1683714025711,AWP 10,024,202057,Staff,0,0,0,0
1683714025711,AWP 10,025,202058,Staff,0,0,0,0
1683714025711,AWP 10,026,202059,Staff,0,0,0,0
1683714026738,AWP 102,001,202032,Staff,0,0,0,0
1683714026738,AWP 102,002,202033,Staff,0,0,0,0
1683714027766,BENG 100,A01,254234,Taylor Amos; Alyssa C,31,0,40,9
1683714028792,BENG 196,001,270013,Engler; Adam J.,9999,0,9999,0
1683714029884,BICD 100R,A01,202018,Smith; Laurie,0,7,32,32
1683714029884,BICD 100R,A02,202019,Smith; Laurie,0,3,32,32
1683714029884,BICD 100R,A03,202020,Smith; Laurie,0,1,32,32
1683714029884,BICD 100R,A04,202021,Smith; Laurie,6,0,32,26
1683714029884,BICD 100R,A05,202022,Smith; Laurie,10,0,32,22
1683714030909,BICD 136,A01,193242,Gustafson-Brown; Cindy,0,2,32,32
1683714030909,BICD 136,A02,193244,Gustafson-Brown; Cindy,13,0,32,19
1683714031941,BIEB 102,A01,193249,Butler; Shannon Rhey,0,0,32,32
1683714031941,BIEB 102,A02,193251,Butler; Shannon Rhey,0,0,32,32
1683714031941,BIEB 102,A03,193253,Butler; Shannon Rhey,0,0,32,32
1683714031941,BIEB 102,A04,193255,Butler; Shannon Rhey,13,0,32,19
1683714031941,BIEB 102,A05,193265,Butler; Shannon Rhey,25,0,32,7
1683714031941,BIEB 102,A06,193269,Butler; Shannon Rhey,12,0,32,20
1683714033997,BIEB 150,A01,193274,Staff,0,0,32,32
1683714033997,BIEB 150,A02,193285,Staff,24,0,32,8
1683714035021,BIEB 194,A00,193286,Kurle; Carolyn M.,19,0,32,13
1683714036048,BILD 1,A01,192291,Staff,15,0,32,17
1683714036048,BILD 1,A02,192292,Staff,30,0,32,2
1683714036048,BILD 1,B01,192520,Reuther; Keefe,0,1,0,0
1683714036048,BILD 1,B02,192532,Reuther; Keefe,0,1,0,0
1683714037078,BILD 3,A01,192556,Butler; Shannon Rhey,0,0,32,32
1683714037078,BILD 3,A02,192581,Butler; Shannon Rhey,0,1,32,32
1683714037078,BILD 3,A03,192611,Butler; Shannon Rhey,19,0,32,13
1683714037078,BILD 3,A04,192612,Butler; Shannon Rhey,23,0,32,9
1683714037078,BILD 3,A05,192613,Butler; Shannon Rhey,26,0,32,6
1683714037078,BILD 3,A06,192679,Butler; Shannon Rhey,27,0,32,5
1683714037078,BILD 3,A07,192682,Butler; Shannon Rhey,20,0,32,12
1683714038109,BILD 4,A01,192836,Reuther; Keefe,1,0,24,23
1683714038109,BILD 4,A02,193044,Reuther; Keefe,4,0,24,20
1683714039134,BILD 10,A01,193142,Gustafson-Brown; Cindy,29,0,32,3
1683714039134,BILD 10,A02,193149,Gustafson-Brown; Cindy,31,0,32,1
1683714040159,BIMM 100,A01,193301,Staff,0,6,32,32
1683714040159,BIMM 100,A02,193312,Staff,0,7,32,32
1683714040159,BIMM 100,A03,193323,Staff,0,10,32,32
1683714041189,BIMM 101,A01,193329,McDonnell; Lisa Marie,0,3,24,24
1683714041189,BIMM 101,A02,193339,McDonnell; Lisa Marie,0,3,24,24
1683714041189,BIMM 101,B01,193354,McDonnell; Lisa Marie,0,4,24,24
1683714041189,BIMM 101,B02,193357,McDonnell; Lisa Marie,0,3,24,24
1683714042214,BIMM 110,A01,193377,Tat; John,0,11,32,32
1683714042214,BIMM 110,A02,193378,Tat; John,0,11,32,32
1683714043240,BIMM 120,A01,206116,Staff,0,0,32,32
1683714043240,BIMM 120,A02,206117,Staff,7,0,32,25
1683714043240,BIMM 120,A03,206121,Staff,21,0,32,11
1683714044264,BIPN 100,A01,193393,Park; Ji Young,0,15,32,32
1683714044264,BIPN 100,A02,193402,Park; Ji Young,0,14,32,32
1683714044264,BIPN 100,A03,193413,Park; Ji Young,0,14,32,32
1683714044264,BIPN 100,A04,193414,Park; Ji Young,0,13,32,32
1683714045292,BIPN 102,A01,193429,Staff,0,0,32,32
1683714045292,BIPN 102,A02,193438,Staff,18,0,32,14
1683714046318,BIPN 106,A01,193450,Reyes Gonzalez; Catalina,0,2,40,40
1683714047346,BIPN 134,A01,193465,Cooke; James Edward,0,0,32,32
1683714047346,BIPN 134,A02,193474,Cooke; James Edward,25,0,32,7
1683714047346,BIPN 134,A03,193485,Cooke; James Edward,29,0,32,3
1683714047346,BIPN 134,A04,193486,Cooke; James Edward,20,0,32,12
1683714047346,BIPN 134,A05,193491,Cooke; James Edward,31,0,32,1
1683714047346,BIPN 134,A06,193501,Cooke; James Edward,30,0,32,2
1683714047346,BIPN 134,A07,193510,Cooke; James Edward,29,0,32,3
1683714049401,BISP 194,A00,222522,Staff,14,0,32,18
1683714050426,CAT 124,A01,202407,Staff,19,0,25,6
1683714051452,CAT 125,A00,202408,Marchisotto; Jennifer Anne,2,0,20,18
1683714052478,CAT 125R,A00,202409,Smith; Lauryn Alissa,0,11,20,20
1683714052478,CAT 125R,B00,202410,Morales; Celeste Georgianna,0,11,20,20
1683714052478,CAT 125R,C00,202411,Irwin; Matthew Joseph,0,12,20,20
1683714053504,CENG 15,A01,204712,Yang; Kesong,0,1,0,0
1683714054536,CENG 114,A00,202070,Jahed Motlagh; Zeinab,5,0,20,15
1683714055565,CGS 105,A00,185477,Wesling; Megan E.,24,0,40,16
1683714056593,CGS 106,A00,185494,Staff,11,0,22,11
1683714057617,CGS 108,A00,185495,Staff,14,0,20,6
1683714058642,CGS 114,A00,185496,Staff,13,0,18,5
1683714059665,CGS 119,A00,185501,Staff,15,0,20,5
1683714060692,CGS 120,A00,185511,Staff,11,0,20,9
1683714061726,CHEM 4,A01,184675,Bussey; Thomas J,97,0,100,3
1683714062751,CHEM 6A,A01,184677,Staff,32,0,60,28
1683714063775,CHEM 6B,A01,184679,Staff,63,0,100,37
1683714064801,CHEM 6C,A01,184681,Bussey; Thomas J,0,0,50,50
1683714064801,CHEM 6C,A02,184682,Bussey; Thomas J,32,0,50,18
1683714065834,CHEM 40A,A01,184684,Albizati; Kim F.,33,0,100,67
1683714066863,CHEM 40B,A01,184686,Albizati; Kim F.,0,22,100,100
1683714067893,CHEM 41B,A01,184690,Staff,51,0,100,49
1683714068921,COGS 3,A01,184715,Boyle; Mary E. T.,0,27,40,40
1683714069950,COGS 14B,A01,185172,Staff,0,14,38,38
1683714070976,COGS 18,A01,184736,Staff,14,0,80,66
1683714072003,COGS 100,A01,184932,Staff,0,8,73,73
1683714073026,COGS 101A,A01,184935,Staff,0,40,30,30
1683714074055,COGS 101B,A01,184944,Staff,0,2,30,30
1683714075080,COGS 101C,A01,184946,Staff,0,10,30,30
1683714076107,COGS 102A,A01,184951,Johnson; Christine M.,1,0,40,39
1683714077136,COGS 107B,A01,184953,Mooshagian; Eric Frederick,0,52,40,40
1683714078166,COGS 118B,A01,184959,Gupta; Anjum,0,50,40,40
1683714079189,COGS 153,A00,184961,Staff,1,16,30,29
1683714080214,COGS 177,A00,184962,Staff,0,20,30,30
1683714081240,COGS 187A,A01,184969,Boyle; Mary E. T.,0,19,40,40
1683714082267,COMM 10,A01,185174,Staff,0,5,25,25
1683714082267,COMM 10,A02,185189,Staff,0,2,25,25
1683714082267,COMM 10,A03,269821,Staff,0,1,0,0
1683714083300,COMM 100B,A02,185476,Staff,10,0,25,15
1683714083300,COMM 100B,A03,277340,Staff,25,0,25,0
1683714084326,COMM 100C,A01,185314,Staff,2,0,25,23
1683714084326,COMM 100C,A02,185327,Staff,17,0,25,8
1683714085351,COMM 110M,A00,185349,Staff,0,0,40,40
1683714086377,COMM 113T,A00,185352,Staff,25,0,40,15
1683714087404,COMM 114I,A00,185353,Staff,31,0,40,9
1683714088429,COMM 131,A00,185354,Staff,17,0,30,13
1683714089455,CSE 8A,A50,185358,Cao; Yingjun,0,46,10,10
1683714090485,CSE 8B,A01,185362,Staff,0,48,50,50
1683714091510,CSE 11,A01,185416,Cao; Yingjun,0,91,10,10
1683714092537,CSE 20,A01,185445,Briones; Jor-el Thomas Caparas,3,0,25,22
1683714093568,CSE 21,A01,185447,Staff,9,0,50,41
1683714094599,CSE 101,A01,185451,Staff,0,13,50,50
1683714094599,CSE 101,B01,185453,Jones; Miles E,0,15,50,50
1683714096730,CSE 141,A01,185458,Eldon; John,16,0,100,84
1683714097757,CSE 141L,A01,185461,Eldon; John,8,0,100,92
1683714098785,CSE 142,A01,185463,Staff,34,0,60,26
1683714098785,CSE 142,B01,201355,Staff,0,7,60,60
1683714099810,CSE 142L,A01,185470,Staff,34,0,60,26
1683714099810,CSE 142L,B01,201417,Staff,0,6,60,60
1683714100835,CSE 190,A00,201433,Staff,32,0,49,17
1683714101863,DOC 1,A01,259136,Strom; Megan C.,7,0,15,8
1683714101863,DOC 1,A02,259137,Strom; Megan C.,15,0,15,0
1683714101863,DOC 1,A03,259138,Strom; Megan C.,14,0,15,1
1683714101863,DOC 1,A04,259139,Strom; Megan C.,13,0,15,2
1683714102894,DOC 100D,A00,259140,Pass; Natalye Joann,14,0,25,11
1683714103924,DSGN 1,A01,184749,Rill; Bryan,0,26,30,30
1683714104954,DSGN 100,A01,185168,Staff,0,2,25,25
1683714105981,ECE 5,A01,185626,Morris; Karcher William,0,12,0,0
1683714107011,ECE 101,A01,185628,Staff,14,0,70,56
1683714108040,ECE 107,A01,185635,Baghdadchi; Saharnaz,0,0,20,20
1683714108040,ECE 107,A02,185638,Baghdadchi; Saharnaz,1,0,20,19
1683714109065,ECE 148,A01,185647,Silberman; Jack,0,0,16,16
1683714110091,ECON 1,A01,185537,Crane; Meredith Helen,54,0,70,16
1683714111121,ECON 3,A01,185549,Crane; Meredith Helen,30,0,70,40
1683714112152,ECON 4,A01,203354,Anderson; John Charles,0,5,10,10
1683714113181,ECON 100A,A01,185574,Staff,0,5,40,40
1683714114207,ECON 100B,A01,185576,Staff,0,12,50,50
1683714115231,ECON 100C,A01,185589,Newhouse; Herbert S,30,0,70,40
1683714116264,ECON 105,A00,185608,Vespa; Emanuel Ignacio,19,0,35,16
1683714117293,ECON 109,A01,185610,Shishkin; Denis,9,0,35,26
1683714118319,ECON 110A,A01,185612,Staff,8,0,40,32
1683714119345,ECON 120A,A01,185615,Staff,19,0,40,21
1683714120377,ECON 120C,A01,185617,Sun; Yixiao,0,21,70,70
1683714121402,ECON 144,A00,203346,Squires; Dale E,2,0,35,33
1683714122431,ECON 171,A01,203349,Newhouse; Herbert S,0,1,35,35
1683714123465,ECON 173A,A01,185621,Toda; Alexis Akira,21,0,35,14
1683714124499,EDS 25,A01,202413,Staff,0,1,0,0
1683714124499,EDS 25,A02,202414,Staff,0,1,0,0
1683714124499,EDS 25,A03,202415,Staff,0,0,0,0
1683714124499,EDS 25,A04,202416,Staff,0,1,0,0
1683714124499,EDS 25,A05,202439,Staff,0,0,0,0
1683714124499,EDS 25,A06,202440,Staff,0,0,0,0
1683714124499,EDS 25,B01,202631,Staff,0,0,0,0
1683714124499,EDS 25,B02,202632,Staff,0,0,0,0
1683714124499,EDS 25,B03,202639,Staff,0,0,0,0
1683714124499,EDS 25,B04,202640,Staff,0,0,0,0
1683714124499,EDS 25,B05,202643,Staff,0,0,0,0
1683714124499,EDS 25,B06,202644,Staff,0,0,0,0
1683714125526,EDS 38,A01,202659,Black; Alison Michelle,25,0,25,0
1683714126554,EDS 115,A00,202652,Staff,18,0,30,12
1683714127580,EDS 125,A00,202649,Staff,13,0,30,17
1683714128606,EDS 126,A01,203332,Staff,30,0,30,0
1683714129630,EDS 139,A00,202838,Staff,16,0,25,9
1683714130657,EDS 146,A01,202655,Staff,14,0,25,11
1683714131683,ENG 15,A00,185667,Staff,0,1,0,0
1683714131683,ENG 15,B00,185672,Staff,0,0,0,0
1683714131683,ENG 15,C00,185675,Staff,0,0,0,0
1683714131683,ENG 15,D00,185682,Staff,0,0,0,0
1683714131683,ENG 15,E00,185684,Staff,0,0,0,0
1683714132711,ETHN 103,A00,185710,Staff,0,8,35,35
1683714133736,ETHN 103A,A00,199228,Man; Simeon S,0,0,9,9
1683714134759,ETHN 109,A00,185711,Staff,15,0,35,20
1683714135788,ETHN 142,A00,185726,Staff,0,4,30,30
1683714136817,ETHN 163J,A00,199229,Man; Simeon S,5,0,8,3
1683714137845,ETHN 168,A00,185727,Staff,7,0,10,3
1683714138871,ETHN 182,A00,185728,Staff,0,0,35,35
1683714139898,ETHN 183,A00,185737,Staff,10,0,18,8
1683714140924,GLBH 111,A01,209361,Burgos; Jose L.,0,0,0,0
1683714142979,HIEU 104,A00,185792,Staff,14,0,20,6
1683714144009,HIEU 115,A00,185800,Staff,0,0,20,20
1683714145036,HIEU 128,A00,185801,Staff,0,9,20,20
1683714146063,HIEU 147,A00,185802,Staff,15,0,20,5
1683714147093,HIEU 154,A00,185823,Staff,11,0,20,9
1683714148117,HILA 102,A00,185826,Staff,14,0,20,6
1683714149150,HILD 2C,A01,185778,Staff,0,13,20,20
1683714150177,HILD 7B,A01,185780,Kwak; Nancy,0,17,32,32
1683714150177,HILD 7B,A02,185781,Kwak; Nancy,0,18,32,32
1683714151201,HILD 30,A01,185791,Staff,12,0,20,8
1683714152225,HISC 119,A00,185830,Golan; Tal,0,10,20,20
1683714153252,HITO 156GS,A00,185831,Patterson; Patrick H.,0,0,0,23
1683714154278,HIUS 103,A00,185832,Man; Simeon S,0,4,20,20
1683714155303,HIUS 117,A00,185836,Kwak; Nancy,2,0,20,18
1683714156327,HIUS 125,A00,185840,Man; Simeon S,0,2,23,23
1683714157352,HIUS 149,A00,185845,Staff,1,0,20,19
1683714158378,HUM 3,A01,185882,Zavodny; Tatiana Sophia,0,8,50,50
1683714158378,HUM 3,B01,185899,Caldwell; Michael Alan,0,18,50,50
1683714159404,HUM 3GS,A00,185900,Patterson; Patrick H.,0,0,0,23
1683714160431,HUM 4,A01,185938,Zroka; Amy Liane,28,0,50,22
1683714160431,HUM 4,B01,185956,Watkins; Eric,0,6,50,50
1683714160431,HUM 4,B02,202209,Watkins; Eric,0,6,50,50
1683714160431,HUM 4,B03,202210,Watkins; Eric,0,5,50,50
1683714161459,HUM 5,A01,185958,West; Geoffrey Scott,0,0,50,50
1683714161459,HUM 5,A02,202215,West; Geoffrey Scott,0,1,50,50
1683714162489,INTL 190,A00,185959,Gagnon; Jeffrey C,0,0,0,9
1683714162489,INTL 190,B00,185960,Lettieri; Michael Joseph,0,0,0,2
1683714163514,JAPN 180,A00,254509,Staff,5,0,30,25
1683714164539,LATI 10,A01,202853,Kennemore; Amy Michelle,4,0,35,31
1683714164539,LATI 10,A02,202854,Kennemore; Amy Michelle,3,0,35,32
1683714164539,LATI 10,A03,270054,Kennemore; Amy Michelle,30,0,30,0
1683714165564,LATI 180,A00,202855,Kennemore; Amy Michelle,11,0,20,9
1683714166594,LAWS 101,A00,201767,Golan; Tal,0,7,40,40
1683714167618,LIFR 1C,A00,185961,Staff,6,0,20,14
1683714168649,LIFR 1CX,A00,185962,Staff,7,0,20,13
1683714169675,LIFR 1D,A00,185963,Staff,7,0,20,13
1683714170704,LIFR 1DX,A00,185964,Staff,7,0,20,13
1683714171730,LIGN 101,A01,186039,Staff,43,0,50,7
1683714172755,LIGN 165,A00,186040,Staff,14,0,50,36
1683714173782,LTCS 108,A00,186041,Staff,5,0,10,5
1683714174807,LTCS 119,A00,186042,Staff,15,0,20,5
1683714175831,LTCS 130,A00,186043,Wesling; Megan E.,15,0,25,10
1683714177882,LTEA 138,A00,186119,Staff,14,0,40,26
1683714178910,LTEN 124,A00,186148,Staff,5,0,25,20
1683714179935,LTEN 178,A00,186149,Staff,6,0,15,9
1683714180962,LTEN 181,A00,186150,Blanco; John D,34,0,40,6
1683714181990,LTWL 120,A00,186160,Staff,19,0,25,6
1683714183013,LTWL 165,A00,186161,Staff,22,0,25,3
1683714184037,LTWR 100,A00,186162,Staff,0,5,15,15
1683714185066,LTWR 102,A00,186163,Doller; Ben,5,0,15,10
1683714186092,MAE 8,A01,186412,Staff,0,1,0,0
1683714187117,MAE 30B,A00,186445,Bahadori; Mohammad Yousef,81,0,100,19
1683714188146,MAE 40,A00,186592,Bewley; Thomas R,10,0,50,40
1683714189172,MAE 101B,A00,186593,Bahadori; Mohammad Yousef,80,0,100,20
1683714190196,MAE 105,A00,186594,Bandaru; Prabhakar,10,0,50,40
1683714191221,MAE 107,A00,186599,Pham; Hieu Tan,0,8,120,120
1683714192246,MAE 148,A01,186660,Silberman; Jack,3,0,16,13
1683714193275,MATH 10A,A01,188095,Staff,0,6,35,35
1683714194305,MATH 10B,A01,188097,Bowers; Adam R.,0,12,30,30
1683714194305,MATH 10B,A02,188099,Bowers; Adam R.,0,11,30,30
1683714194305,MATH 10B,B01,188104,Bowers; Adam R.,0,10,30,30
1683714194305,MATH 10B,B02,188106,Bowers; Adam R.,0,9,30,30
1683714195333,MATH 10C,A01,188111,Staff,0,20,30,30
1683714195333,MATH 10C,A02,188127,Staff,0,19,30,30
1683714195333,MATH 10C,A03,188131,Staff,0,19,30,30
1683714195333,MATH 10C,B01,188218,Staff,17,0,30,13
1683714195333,MATH 10C,B02,188244,Staff,13,0,30,17
1683714195333,MATH 10C,B03,188277,Staff,14,0,30,16
1683714196356,MATH 18,A01,188344,Bach; Quang Tran,18,0,30,12
1683714196356,MATH 18,A02,188345,Bach; Quang Tran,11,0,30,19
1683714196356,MATH 18,B01,188353,Bach; Quang Tran,11,0,30,19
1683714196356,MATH 18,B02,188354,Bach; Quang Tran,19,0,30,11
1683714197380,MATH 20A,A01,188374,Staff,11,0,35,24
1683714198411,MATH 20B,A01,188382,Ohm; Ko Woon,7,0,30,23
1683714198411,MATH 20B,A02,188383,Ohm; Ko Woon,22,0,30,8
1683714198411,MATH 20B,B01,188385,Ohm; Ko Woon,7,0,30,23
1683714198411,MATH 20B,B02,188392,Ohm; Ko Woon,22,0,30,8
1683714199493,MATH 20C,A01,188394,Harel; Guershon,10,0,30,20
1683714199493,MATH 20C,A02,188395,Harel; Guershon,13,0,30,17
1683714199493,MATH 20C,B01,188404,Harel; Guershon,5,0,30,25
1683714199493,MATH 20C,B02,188405,Harel; Guershon,18,0,30,12
1683714200524,MATH 20D,A01,188414,Hammock; Frances H,0,1,30,30
1683714200524,MATH 20D,A02,188415,Hammock; Frances H,0,1,30,30
1683714200524,MATH 20D,B01,188447,Hammock; Frances H,0,1,30,30
1683714200524,MATH 20D,B02,188486,Hammock; Frances H,2,0,30,28
1683714201553,MATH 20E,A01,188649,Staff,21,0,30,9
1683714201553,MATH 20E,A02,188650,Staff,20,0,30,10
1683714201553,MATH 20E,A03,188673,Staff,0,0,30,30
1683714202582,MATH 102,A01,188675,Staff,0,40,35,35
1683714203609,MATH 103B,A01,188681,Staff,3,0,35,32
1683714203609,MATH 103B,B01,188692,Staff,5,0,35,30
1683714204633,MATH 109,A01,188695,Salehi Golsefidy; Alireza,24,0,35,11
1683714204633,MATH 109,A02,188696,Salehi Golsefidy; Alireza,24,0,35,11
1683714205664,MATH 120A,A01,188698,Eggers; John Dietrich,7,0,35,28
1683714206694,MATH 142B,A01,188736,Ioana; Adrian,0,0,30,30
1683714206694,MATH 142B,A02,188741,Ioana; Adrian,0,1,30,30
1683714206694,MATH 142B,A03,188743,Ioana; Adrian,0,2,30,30
1683714207722,MATH 168A,A01,188790,Staff,0,11,35,35
1683714208747,MATH 170A,A01,188803,Nie; Jiawang,0,2,35,35
1683714208747,MATH 170A,A02,188811,Nie; Jiawang,0,1,35,35
1683714208747,MATH 170A,A03,188814,Nie; Jiawang,1,0,35,34
1683714208747,MATH 170A,A04,188815,Nie; Jiawang,5,0,35,30
1683714209775,MATH 193B,A01,188817,Staff,0,0,35,35
1683714209775,MATH 193B,A02,188818,Staff,6,0,35,29
1683714210801,MGT 4,A01,202857,Anderson; John Charles,59,0,80,21
1683714211825,MGT 12,A00,202858,Lindenberger; Wade Douglas,40,0,90,50
1683714212851,MGT 18,A00,202859,Staff,73,0,90,17
1683714213880,MGT 18GS,A00,202860,McKay; Michael J,13,0,28,15
1683714214909,MGT 45,A00,202861,Pecore; Joseph P.,8,0,90,82
1683714215942,MGT 100,A00,202863,Yavorsky; Daniel Ryan,27,0,90,63
1683714216973,MGT 103,A00,202864,Ehrich; Kristine R,0,19,90,90
1683714218003,MGT 112,A00,202865,Ehrich; Kristine R,15,0,90,75
1683714219027,MGT 121A,A00,202868,Staff,70,0,90,20
1683714220054,MGT 131B,A00,202869,Anderson; John Charles,58,0,90,32
1683714221079,MGT 136,A00,202871,Lindenberger; Wade Douglas,83,0,90,7
1683714222107,MGT 164,A00,202873,Staff,0,67,90,91
1683714223135,MGT 164GS,A00,202874,McKay; Mary A,13,0,28,15
1683714224160,MGT 180,A00,202875,Staff,0,51,90,91
1683714225186,MMW 11R,A01,205019,Herbst; Matthew,0,0,30,30
1683714225186,MMW 11R,A02,205026,Herbst; Matthew,29,0,30,1
1683714226215,MMW 15,A01,193512,Chang; Edmond Yi-Teh,0,8,28,28
1683714226215,MMW 15,A02,193513,Chang; Edmond Yi-Teh,0,5,28,28
1683714226215,MMW 15,A03,193514,Chang; Edmond Yi-Teh,0,5,28,28
1683714226215,MMW 15,A04,193515,Chang; Edmond Yi-Teh,0,5,28,28
1683714226215,MMW 15,A05,193516,Chang; Edmond Yi-Teh,0,5,28,28
1683714226215,MMW 15,A06,193517,Chang; Edmond Yi-Teh,0,6,28,28
1683714226215,MMW 15,B01,193519,Chang; Edmond Yi-Teh,0,5,28,28
1683714226215,MMW 15,B02,193520,Chang; Edmond Yi-Teh,0,5,28,28
1683714226215,MMW 15,B03,193521,Chang; Edmond Yi-Teh,0,5,28,28
1683714226215,MMW 15,B04,193522,Chang; Edmond Yi-Teh,0,6,28,28
1683714226215,MMW 15,B05,193523,Chang; Edmond Yi-Teh,0,5,28,28
1683714226215,MMW 15,B06,193524,Chang; Edmond Yi-Teh,0,5,28,28
1683714227239,MMW 122,A01,193526,Rahimi; Babak,0,16,28,28
1683714227239,MMW 122,A02,193527,Rahimi; Babak,0,15,28,28
1683714227239,MMW 122,A03,193528,Rahimi; Babak,0,0,0,0
1683714227239,MMW 122,A04,193529,Rahimi; Babak,0,0,0,0
1683714228264,MUS 1A,A01,186663,Staff,0,18,35,35
1683714229289,MUS 4,A01,186715,Staff,0,12,35,35
1683714230316,MUS 5R,A01,186796,Dubnov; Shlomo,0,17,35,35
1683714231342,MUS 6,A01,186798,Staff,0,4,25,25
1683714232368,MUS 7,A01,186830,Staff,11,0,35,24
1683714233394,MUS 8,A01,186930,Staff,0,27,35,35
1683714234425,MUS 15,A01,186932,Staff,0,15,35,35
1683714234425,MUS 15,B01,186934,Staff,0,16,35,35
1683714235454,MUS 80,A00,186935,Staff,0,0,20,20
1683714235454,MUS 80,B00,186936,Staff,24,0,25,1
1683714236485,NANO 11,A00,204702,Lipomi; Darren John,0,0,0,0
1683714237510,NANO 15,A01,204709,Yang; Kesong,0,1,0,0
1683714238539,NANO 114,A00,202069,Jahed Motlagh; Zeinab,2,0,10,8
1683714239571,PHIL 1,A00,186955,Grush; Rick Scott,31,0,40,9
1683714240601,PHIL 10,A01,186973,Grush; Rick Scott,27,0,35,8
1683714240601,PHIL 10,A02,186974,Grush; Rick Scott,33,0,35,2
1683714241630,PHIL 13,A01,186976,Staff,1,0,35,34
1683714241630,PHIL 13,A02,186977,Staff,16,0,35,19
1683714242653,PHIL 14,A01,186979,Staff,30,0,35,5
1683714242653,PHIL 14,A02,186986,Staff,32,0,35,3
1683714243684,PHIL 28,A01,186988,Staff,16,0,30,14
1683714243684,PHIL 28,A02,186989,Staff,0,0,30,30
1683714243684,PHIL 28,A03,186990,Staff,10,0,30,20
1683714243684,PHIL 28,A04,186991,Staff,26,0,30,4
1683714244713,PHIL 120,A00,186997,Staff,23,0,40,17
1683714245740,PHIL 137,A00,187003,Staff,8,0,40,32
1683714246764,PHIL 150,A00,187015,Staff,47,0,70,23
1683714247799,PHIL 167,A00,187021,Lamey; Andy M.,34,0,40,6
1683714248824,PHIL 174,A01,202226,Staff,17,0,20,3
1683714248824,PHIL 174,A02,202235,Staff,20,0,20,0
1683714249854,PHIL 191A,A00,258918,Staff,0,0,1,1
1683714250883,PHYS 1A,A00,187028,Staff,26,0,60,34
1683714251909,PHYS 1AL,001,187036,Staff,3,0,30,27
1683714251909,PHYS 1AL,002,187049,Staff,18,0,30,12
1683714252933,PHYS 1B,A00,187058,Staff,21,0,60,39
1683714253963,PHYS 1BL,001,187064,Staff,0,1,30,30
1683714253963,PHYS 1BL,002,187070,Staff,4,0,30,26
1683714254992,PHYS 1C,A00,187082,Staff,30,0,120,90
1683714256030,PHYS 1CL,001,187088,Staff,0,9,30,30
1683714256030,PHYS 1CL,002,187089,Staff,0,1,30,30
1683714256030,PHYS 1CL,009,262693,Staff,9,0,30,21
1683714257057,PHYS 2B,A01,187097,Staff,55,0,115,60
1683714258082,PHYS 2C,A01,187099,Staff,63,0,115,52
1683714259112,PHYS 2CL,A01,187101,Staff,5,0,28,23
1683714259112,PHYS 2CL,A02,187102,Staff,15,0,28,13
1683714260136,PHYS 2D,A01,187123,Shotwell; Brian,95,0,115,20
1683714261162,PHYS 4B,A01,187133,Grinstein; Benjamin,35,0,50,15
1683714262186,POLI 10,A00,188819,Staff,0,4,50,50
1683714263215,POLI 11,A00,188827,Staff,43,0,50,7
1683714264241,POLI 13R,A00,188828,Staff,0,2,20,20
1683714265273,POLI 27,A01,188830,Elgin; Samuel Zincke,0,2,70,70
1683714266297,POLI 30,A00,188832,Desposato; Scott,30,0,50,20
1683714267322,POLI 102F,A00,188834,Staff,1,0,40,39
1683714268349,POLI 104A,A00,188852,Staff,12,0,30,18
1683714269372,POLI 104I,A00,188853,Staff,0,8,20,20
1683714270399,POLI 110B,A00,188854,Wiens; David,6,0,20,14
1683714271425,POLI 112A,A00,188855,Wiens; David,3,0,30,27
1683714272451,POLI 117R,A00,188856,Forman; Fonna,0,12,20,20
1683714273476,POLI 118,A00,188857,Ingham; Sean,8,0,20,12
1683714274501,POLI 120G,A00,188858,Staff,7,0,30,23
1683714275524,POLI 131CR,A00,188863,Hoston; Germaine,20,0,50,30
1683714276555,POLI 133,A00,188864,Nellis; Gareth Hb,44,0,50,6
1683714277580,POLI 134D,A00,188865,Desposato; Scott,27,0,30,3
1683714278606,POLI 142A,A00,188871,Gartzke; Erik,21,0,50,29
1683714279635,POLI 142K,A00,188874,Staff,38,0,50,12
1683714280662,POLI 143,A00,188940,Gartzke; Erik,15,0,30,15
1683714281686,POLI 153,A00,188943,Staff,1,0,20,19
1683714282710,POLI 160AA,A00,188944,Staff,10,0,40,30
1683714283736,POLI 170A,A00,188945,Staff,10,0,30,20
1683714285787,PSYC 1,A00,188952,Staff,36,0,90,54
1683714286815,PSYC 2,B00,188953,Staff,19,0,35,16
1683714287844,PSYC 6,A00,188970,Staff,47,0,60,13
1683714288873,PSYC 7,A00,188973,Staff,35,0,45,10
1683714289897,PSYC 60,A01,188980,Rickard; Timothy C.,42,0,60,18
1683714290923,PSYC 70,A01,189001,Steiner; Eric Tomas,22,0,45,23
1683714291947,PSYC 100,A00,189005,Lacefield; Katharine I,1,98,120,119
1683714292971,PSYC 102,A00,189008,Staff,6,0,30,24
1683714293995,PSYC 106,B00,189026,Gorman; Michael R.,27,0,60,33
1683714295023,PSYC 114,B01,189033,Winkielman; Piotr,0,31,30,30
1683714296053,PSYC 131,A00,189036,Anagnostaras; Stephan,0,44,60,60
1683714297082,PSYC 136,A00,189041,Lowe; Angela Beth,0,7,25,25
1683714298110,PSYC 137,A00,189057,Winkielman; Piotr,0,36,25,25
1683714299135,PSYC 144,A00,189107,Wixted; John T,0,11,50,50
1683714301183,PSYC 162,A00,189142,Staff,0,9,85,85
1683714302206,PSYC 172,A00,189144,Gorman; Michael R.,0,6,30,30
1683714304313,PSYC 179,A00,189146,Lacefield; Katharine I,0,88,120,120
1683714305342,PSYC 181,A00,189147,Anagnostaras; Stephan,0,45,90,90
1683714306371,PSYC 190R,A00,189148,Barner; David A.,0,23,80,80
1683714307397,PSYC 191,A00,189275,Rickard; Timothy C.,0,11,25,25
1683714308425,PSYC 193,A00,189276,Chapman; Eddie Nathaniel,0,1,0,4
1683714309455,PSYC 193L,A01,189281,Lowe; Angela Beth,8,0,20,12
1683714309455,PSYC 193L,B01,189285,Staff,28,0,35,7
1683714310484,RELI 149,A00,187137,Rahimi; Babak,6,0,40,34
1683714311509,SE 9,A01,187315,Staff,0,2,18,18
1683714312537,SE 101B,A00,187409,Staff,24,0,30,6
1683714313564,SE 110B,A00,187444,Staff,10,0,40,30
1683714314589,SE 130B,A00,187449,Staff,31,0,40,9
1683714315613,SE 150A,A00,187516,Staff,8,0,20,12
1683714316640,SE 154,A00,187528,Staff,29,0,50,21
1683714317665,SIO 3,A01,258171,Staff,35,0,40,5
1683714318690,SIO 10,A00,187144,Cook; Geoffrey W,0,6,75,75
1683714319719,SIO 45,A00,187152,Cook; Geoffrey W,1,7,100,99
1683714320745,SIO 109R,A00,194486,Staff,0,4,20,20
1683714322797,SIO 187,A01,187233,Kacev; David,12,0,40,28
1683714323821,SOCI 1,A01,258656,Thorpe; Charles Robert,28,0,30,2
1683714323821,SOCI 1,A02,258658,Thorpe; Charles Robert,30,0,30,0
1683714323821,SOCI 1,A03,258661,Thorpe; Charles Robert,25,0,25,0
1683714323821,SOCI 1,A04,258666,Thorpe; Charles Robert,22,0,25,3
1683714323821,SOCI 1,A05,258897,Thorpe; Charles Robert,22,0,25,3
1683714323821,SOCI 1,A06,258898,Thorpe; Charles Robert,25,0,25,0
1683714324847,SOCI 30,A01,258903,Pardo Guerra; Juan Pablo,14,0,30,16
1683714325872,SOCI 102,A00,258904,Staff,9,0,25,16
1683714326899,SOCI 106,A00,258905,Staff,19,0,25,6
1683714327925,SOCI 111,A00,258907,Ribas Norris; Janet Vanesa,26,0,30,4
1683714328950,SOCI 121R,A00,258908,Pardo Guerra; Juan Pablo,7,0,30,23
1683714329977,SOCI 126,A01,203330,Staff,14,0,20,6
1683714331003,SOCI 131,A00,258909,Thorpe; Charles Robert,30,0,60,30
1683714332030,SOCI 135,A00,258910,Payne; Christine Anna,0,13,30,30
1683714333059,SOCI 157,A00,258911,Staff,10,0,30,20
1683714334083,SOCI 184,A00,258912,Staff,25,0,30,5
1683714335111,SOCI 188D,A00,258913,Staff,22,0,30,8
1683714336140,SYN 2,001,187529,Staff,9,0,16,7
1683714336140,SYN 2,002,201452,Staff,0,20,16,16
1683714336140,SYN 2,003,201469,Staff,1,0,16,15
1683714337163,SYN 100,A01,187531,Staff,0,9,20,20
1683714337163,SYN 100,B01,201491,Staff,0,10,20,20
1683714338189,TDAC 1,A00,189286,Walsh; Kim C.,3,0,20,17
1683714338189,TDAC 1,B00,189287,Harting; Carla Kelso,10,0,20,10
1683714339217,TDAC 101,A00,189300,Walsh; Kim C.,16,0,20,4
1683714339217,TDAC 101,B00,189301,Harting; Carla Kelso,18,0,20,2
1683714340241,TDAC 102,A00,189304,Basso; Beatrice,14,0,20,6
1683714341266,TDAC 108,A00,189305,Staff,18,0,20,2
1683714342297,TDDE 131,A00,189310,Staff,19,0,20,1
1683714342297,TDDE 131,B00,189314,Staff,19,0,20,1
1683714342297,TDDE 131,C00,189315,Staff,48,0,50,2
1683714342297,TDDE 131,D00,189316,Staff,14,0,15,1
1683714342297,TDDE 131,E00,204841,Staff,20,0,20,0
1683714343326,TDGE 10,A00,189289,Staff,27,0,50,23
1683714343326,TDGE 10,B00,189290,Havis; Allan,0,1,50,50
1683714344351,TDGE 11,A00,189291,Fulton; Julia,0,4,50,50
1683714344351,TDGE 11,B00,189292,Staff,20,0,25,5
1683714344351,TDGE 11,C00,260270,Staff,0,0,0,0
1683714345376,TDGE 25,A00,189294,Staff,1,0,20,19
1683714346400,TDGE 124,A00,189318,Fulton; Julia,0,7,50,50
1683714347423,TDGE 125,A00,189319,Staff,13,0,25,12
1683714347423,TDGE 125,B00,189320,Staff,23,0,25,2
1683714348448,TDGE 127,A00,189322,Havis; Allan,1,0,50,49
1683714349472,TDHT 101,A00,189323,Staff,18,0,25,7
1683714349472,TDHT 101,B00,189324,Staff,25,0,25,0
1683714350498,TDHT 102,A00,189325,Staff,49,0,50,1
1683714351527,TDMV 1,A00,189295,Arcidiacono; Kristin,20,0,30,10
1683714351527,TDMV 1,B00,189296,Caligagan; Maria T.,23,0,30,7
1683714352558,TDMV 2,A00,189297,Sammartano; Tonnie,27,0,30,3
1683714352558,TDMV 2,B00,189299,Arcidiacono; Kristin,23,0,30,7
1683714353583,TDMV 3,A00,204998,Rincon; Alicia,22,0,30,8
1683714354612,TDMV 120,A00,189458,Sammartano; Tonnie,28,0,30,2
1683714355639,TDMV 138,A00,189541,Jun; Grace Shin Hae,20,0,40,20
1683714356665,TDMV 142,A00,189717,Caligagan; Tony,25,0,30,5
1683714356665,TDMV 142,B00,189718,Caligagan; Maria T.,25,0,30,5
1683714357693,TMC 2,A01,187533,Staff,25,0,25,0
1683714357693,TMC 2,A02,187534,Staff,25,0,25,0
1683714358718,USP 1,A01,187536,Kwak; Nancy,0,16,25,25
1683714359743,USP 5,A01,187538,Staff,8,0,25,17
1683714360772,USP 101,A00,199253,Staff,0,4,0,0
1683714361803,USP 124,A00,187562,Boomhower; Matthew Charles,0,0,30,30
1683714362829,USP 138,A00,187582,Staff,19,0,25,6
1683714363859,USP 152,A01,187597,Staff,3,0,25,22
1683714364893,USP 153,A00,187598,Staff,18,0,25,7
1683714365918,USP 168,A00,187607,Kwak; Nancy,2,0,5,3
1683714366944,USP 173,A00,187619,Staff,4,0,25,21
1683714367970,USP 181,A00,187638,Staff,0,4,25,25
1683714368995,VIS 103,A00,187650,Cruz; Edwin Teddy,17,0,75,58
1683714370023,VIS 110D,A00,187669,Staff,13,0,22,9
1683714371047,VIS 127C,A00,187720,Shen; Kuiyi,67,0,146,79
1683714372076,VIS 149,A00,187731,Yoldas; Pinar,0,12,22,22
1683714373100,VIS 151,A01,188091,Staff,22,0,34,12
1683714373100,VIS 151,A02,188092,Staff,11,0,34,23
1683714374125,VIS 160B,A00,188093,Stalbaum; Brett,0,1,10,10
1683714376179,WCWP 10B,A00,201720,Staff,0,0,5,5
1683714376179,WCWP 10B,B00,201722,Staff,0,0,6,6
1683714377206,WCWP 100,A00,201725,Gagnon; Jeffrey C,0,0,2,2
1683714377206,WCWP 100,B00,201727,Staff,0,4,15,15
1683714380348,ANBI 133,A00,258401,Wilder; Linnea Lorene,34,0,40,6
1683714381380,ANBI 140,A00,258395,Hrvoj Mihic; Branka,18,0,25,7
1683714382406,ANSC 120,A00,258402,Bialecki; Jon Anthony,26,0,40,14
1683714383435,ANSC 144,A00,258400,Staff,12,0,40,28
1683714385489,ANSC 166,A00,258396,Parish; Steven Martin,156,0,175,19
1683714386513,ANSC 180,A00,193533,Staff,8,0,20,12
1683714387538,ANSC 188,A00,258397,Jassal; Aftab,34,0,40,6
1683714388564,ANTH 3,A01,258316,Staff,23,0,30,7
1683714389589,ANTH 5,A00,258394,Semendeferi; Ekaterini,16,0,20,4
1683714390617,ANTH 21,A01,258331,Staff,4,0,40,36
1683714391643,ANTH 103,A00,258398,Varma; Saiba,15,0,25,10
1683714392681,AWP 10,001,202034,Staff,0,0,0,0
1683714392681,AWP 10,002,202035,Staff,0,0,0,0
1683714392681,AWP 10,003,202036,Staff,0,0,0,0
1683714392681,AWP 10,004,202037,Staff,0,0,0,0
1683714392681,AWP 10,005,202038,Staff,0,0,0,0
1683714392681,AWP 10,006,202039,Staff,0,0,0,0
1683714392681,AWP 10,007,202040,Staff,0,0,0,0
1683714392681,AWP 10,008,202041,Staff,0,0,0,0
1683714392681,AWP 10,009,202042,Staff,0,0,0,0
1683714392681,AWP 10,010,202043,Staff,0,0,0,0
1683714392681,AWP 10,011,202044,Staff,0,0,0,0
1683714392681,AWP 10,012,202045,Staff,0,0,0,0
1683714392681,AWP 10,013,202046,Staff,0,0,0,0
1683714392681,AWP 10,014,202047,Staff,0,0,0,0
1683714392681,AWP 10,015,202048,Staff,0,0,0,0
1683714392681,AWP 10,016,202049,Staff,0,0,0,0
1683714392681,AWP 10,017,202050,Staff,0,0,0,0
1683714392681,AWP 10,018,202051,Staff,0,0,0,0
1683714392681,AWP 10,019,202052,Staff,0,0,0,0
1683714392681,AWP 10,020,202053,Staff,0,0,0,0
1683714392681,AWP 10,021,202054,Staff,0,0,0,0
1683714392681,AWP 10,022,202055,Staff,0,0,0,0
1683714392681,AWP 10,023,202056,Staff,0,0,0,0
1683714392681,AWP 10,024,202057,Staff,0,0,0,0
1683714392681,AWP 10,025,202058,Staff,0,0,0,0
1683714392681,AWP 10,026,202059,Staff,0,0,0,0
1683714393706,AWP 102,001,202032,Staff,0,0,0,0
1683714393706,AWP 102,002,202033,Staff,0,0,0,0
1683714394739,BENG 100,A01,254234,Taylor Amos; Alyssa C,31,0,40,9
1683714395766,BENG 196,001,270013,Engler; Adam J.,9999,0,9999,0
1683714396792,BICD 100R,A01,202018,Smith; Laurie,0,7,32,32
1683714396792,BICD 100R,A02,202019,Smith; Laurie,0,3,32,32
1683714396792,BICD 100R,A03,202020,Smith; Laurie,0,1,32,32
1683714396792,BICD 100R,A04,202021,Smith; Laurie,6,0,32,26
1683714396792,BICD 100R,A05,202022,Smith; Laurie,10,0,32,22
1683714397818,BICD 136,A01,193242,Gustafson-Brown; Cindy,0,2,32,32
1683714397818,BICD 136,A02,193244,Gustafson-Brown; Cindy,13,0,32,19
1683714398848,BIEB 102,A01,193249,Butler; Shannon Rhey,0,0,32,32
1683714398848,BIEB 102,A02,193251,Butler; Shannon Rhey,0,0,32,32
1683714398848,BIEB 102,A03,193253,Butler; Shannon Rhey,0,0,32,32
1683714398848,BIEB 102,A04,193255,Butler; Shannon Rhey,13,0,32,19
1683714398848,BIEB 102,A05,193265,Butler; Shannon Rhey,25,0,32,7
1683714398848,BIEB 102,A06,193269,Butler; Shannon Rhey,12,0,32,20
1683714400911,BIEB 150,A01,193274,Staff,0,0,32,32
1683714400911,BIEB 150,A02,193285,Staff,24,0,32,8
1683714401939,BIEB 194,A00,193286,Kurle; Carolyn M.,19,0,32,13
1683714402975,BILD 1,A01,192291,Staff,15,0,32,17
1683714402975,BILD 1,A02,192292,Staff,30,0,32,2
1683714402975,BILD 1,B01,192520,Reuther; Keefe,0,1,0,0
1683714402975,BILD 1,B02,192532,Reuther; Keefe,0,1,0,0
1683714404005,BILD 3,A01,192556,Butler; Shannon Rhey,0,0,32,32
1683714404005,BILD 3,A02,192581,Butler; Shannon Rhey,0,1,32,32
1683714404005,BILD 3,A03,192611,Butler; Shannon Rhey,19,0,32,13
1683714404005,BILD 3,A04,192612,Butler; Shannon Rhey,23,0,32,9
1683714404005,BILD 3,A05,192613,Butler; Shannon Rhey,26,0,32,6
1683714404005,BILD 3,A06,192679,Butler; Shannon Rhey,27,0,32,5
1683714404005,BILD 3,A07,192682,Butler; Shannon Rhey,20,0,32,12
1683714405033,BILD 4,A01,192836,Reuther; Keefe,1,0,24,23
1683714405033,BILD 4,A02,193044,Reuther; Keefe,4,0,24,20
1683714406059,BILD 10,A01,193142,Gustafson-Brown; Cindy,29,0,32,3
1683714406059,BILD 10,A02,193149,Gustafson-Brown; Cindy,31,0,32,1
1683714407141,BIMM 100,A01,193301,Staff,0,6,32,32
1683714407141,BIMM 100,A02,193312,Staff,0,7,32,32
1683714407141,BIMM 100,A03,193323,Staff,0,10,32,32
1683714408174,BIMM 101,A01,193329,McDonnell; Lisa Marie,0,3,24,24
1683714408174,BIMM 101,A02,193339,McDonnell; Lisa Marie,0,3,24,24
1683714408174,BIMM 101,B01,193354,McDonnell; Lisa Marie,0,4,24,24
1683714408174,BIMM 101,B02,193357,McDonnell; Lisa Marie,0,3,24,24
1683714409199,BIMM 110,A01,193377,Tat; John,0,11,32,32
1683714409199,BIMM 110,A02,193378,Tat; John,0,11,32,32
1683714410225,BIMM 120,A01,206116,Staff,0,0,32,32
1683714410225,BIMM 120,A02,206117,Staff,7,0,32,25
1683714410225,BIMM 120,A03,206121,Staff,21,0,32,11
1683714411250,BIPN 100,A01,193393,Park; Ji Young,0,15,32,32
1683714411250,BIPN 100,A02,193402,Park; Ji Young,0,14,32,32
1683714411250,BIPN 100,A03,193413,Park; Ji Young,0,14,32,32
1683714411250,BIPN 100,A04,193414,Park; Ji Young,0,13,32,32
1683714412275,BIPN 102,A01,193429,Staff,0,0,32,32
1683714412275,BIPN 102,A02,193438,Staff,18,0,32,14
1683714413302,BIPN 106,A01,193450,Reyes Gonzalez; Catalina,0,2,40,40
1683714414331,BIPN 134,A01,193465,Cooke; James Edward,0,0,32,32
1683714414331,BIPN 134,A02,193474,Cooke; James Edward,25,0,32,7
1683714414331,BIPN 134,A03,193485,Cooke; James Edward,29,0,32,3
1683714414331,BIPN 134,A04,193486,Cooke; James Edward,20,0,32,12
1683714414331,BIPN 134,A05,193491,Cooke; James Edward,31,0,32,1
1683714414331,BIPN 134,A06,193501,Cooke; James Edward,30,0,32,2
1683714414331,BIPN 134,A07,193510,Cooke; James Edward,29,0,32,3
1683714416381,BISP 194,A00,222522,Staff,14,0,32,18
1683714417408,CAT 124,A01,202407,Staff,19,0,25,6
1683714418432,CAT 125,A00,202408,Marchisotto; Jennifer Anne,2,0,20,18
1683714419470,CAT 125R,A00,202409,Smith; Lauryn Alissa,0,11,20,20
1683714419470,CAT 125R,B00,202410,Morales; Celeste Georgianna,0,11,20,20
1683714419470,CAT 125R,C00,202411,Irwin; Matthew Joseph,0,12,20,20
1683714420505,CENG 15,A01,204712,Yang; Kesong,0,1,0,0
1683714421533,CENG 114,A00,202070,Jahed Motlagh; Zeinab,5,0,20,15
1683714422560,CGS 105,A00,185477,Wesling; Megan E.,24,0,40,16
1683714423585,CGS 106,A00,185494,Staff,11,0,22,11
1683714424612,CGS 108,A00,185495,Staff,14,0,20,6
1683714425639,CGS 114,A00,185496,Staff,13,0,18,5
1683714426664,CGS 119,A00,185501,Staff,15,0,20,5
1683714427694,CGS 120,A00,185511,Staff,11,0,20,9
1683714428726,CHEM 4,A01,184675,Bussey; Thomas J,97,0,100,3
1683714429752,CHEM 6A,A01,184677,Staff,32,0,60,28
1683714430781,CHEM 6B,A01,184679,Staff,63,0,100,37
1683714431813,CHEM 6C,A01,184681,Bussey; Thomas J,0,0,50,50
1683714431813,CHEM 6C,A02,184682,Bussey; Thomas J,32,0,50,18
1683714432840,CHEM 40A,A01,184684,Albizati; Kim F.,33,0,100,67
1683714433868,CHEM 40B,A01,184686,Albizati; Kim F.,0,22,100,100
1683714434892,CHEM 41B,A01,184690,Staff,51,0,100,49
1683714435918,COGS 3,A01,184715,Boyle; Mary E. T.,0,27,40,40
1683714436948,COGS 14B,A01,185172,Staff,0,14,38,38
1683714437975,COGS 18,A01,184736,Staff,14,0,80,66
1683714439003,COGS 100,A01,184932,Staff,0,8,73,73
1683714440032,COGS 101A,A01,184935,Staff,0,40,30,30
1683714441057,COGS 101B,A01,184944,Staff,0,2,30,30
1683714442082,COGS 101C,A01,184946,Staff,0,10,30,30
1683714443114,COGS 102A,A01,184951,Johnson; Christine M.,1,0,40,39
1683714444145,COGS 107B,A01,184953,Mooshagian; Eric Frederick,0,52,40,40
1683714445169,COGS 118B,A01,184959,Gupta; Anjum,0,50,40,40
1683714446197,COGS 153,A00,184961,Staff,1,16,30,29
1683714447227,COGS 177,A00,184962,Staff,0,20,30,30
1683714448251,COGS 187A,A01,184969,Boyle; Mary E. T.,0,19,40,40
1683714449282,COMM 10,A01,185174,Staff,0,5,25,25
1683714449282,COMM 10,A02,185189,Staff,0,2,25,25
1683714449282,COMM 10,A03,269821,Staff,0,1,0,0
1683714450308,COMM 100B,A02,185476,Staff,10,0,25,15
1683714450308,COMM 100B,A03,277340,Staff,25,0,25,0
1683714451337,COMM 100C,A01,185314,Staff,2,0,25,23
1683714451337,COMM 100C,A02,185327,Staff,17,0,25,8
1683714452363,COMM 110M,A00,185349,Staff,0,0,40,40
1683714453388,COMM 113T,A00,185352,Staff,25,0,40,15
1683714454414,COMM 114I,A00,185353,Staff,31,0,40,9
1683714455443,COMM 131,A00,185354,Staff,17,0,30,13
1683714456467,CSE 8A,A50,185358,Cao; Yingjun,0,46,10,10
1683714457493,CSE 8B,A01,185362,Staff,0,48,50,50
1683714458520,CSE 11,A01,185416,Cao; Yingjun,0,91,10,10
1683714459550,CSE 20,A01,185445,Briones; Jor-el Thomas Caparas,3,0,25,22
1683714460576,CSE 21,A01,185447,Staff,9,0,50,41
1683714461602,CSE 101,A01,185451,Staff,0,13,50,50
1683714461602,CSE 101,B01,185453,Jones; Miles E,0,15,50,50
1683714463653,CSE 141,A01,185458,Eldon; John,16,0,100,84
1683714464677,CSE 141L,A01,185461,Eldon; John,8,0,100,92
1683714465704,CSE 142,A01,185463,Staff,34,0,60,26
1683714465704,CSE 142,B01,201355,Staff,0,7,60,60
1683714466728,CSE 142L,A01,185470,Staff,34,0,60,26
1683714466728,CSE 142L,B01,201417,Staff,0,6,60,60
1683714467754,CSE 190,A00,201433,Staff,32,0,49,17
1683714468783,DOC 1,A01,259136,Strom; Megan C.,7,0,15,8
1683714468783,DOC 1,A02,259137,Strom; Megan C.,15,0,15,0
1683714468783,DOC 1,A03,259138,Strom; Megan C.,14,0,15,1
1683714468783,DOC 1,A04,259139,Strom; Megan C.,13,0,15,2
1683714469813,DOC 100D,A00,259140,Pass; Natalye Joann,14,0,25,11
1683714470838,DSGN 1,A01,184749,Rill; Bryan,0,26,30,30
1683714471864,DSGN 100,A01,185168,Staff,0,2,25,25
1683714472892,ECE 5,A01,185626,Morris; Karcher William,0,12,0,0
1683714473921,ECE 101,A01,185628,Staff,14,0,70,56
1683714474947,ECE 107,A01,185635,Baghdadchi; Saharnaz,0,0,20,20
1683714474947,ECE 107,A02,185638,Baghdadchi; Saharnaz,1,0,20,19
1683714475977,ECE 148,A01,185647,Silberman; Jack,0,0,16,16
1683714477002,ECON 1,A01,185537,Crane; Meredith Helen,54,0,70,16
1683714478027,ECON 3,A01,185549,Crane; Meredith Helen,30,0,70,40
1683714479058,ECON 4,A01,203354,Anderson; John Charles,0,5,10,10
1683714480085,ECON 100A,A01,185574,Staff,0,5,40,40
1683714481111,ECON 100B,A01,185576,Staff,0,12,50,50
1683714482139,ECON 100C,A01,185589,Newhouse; Herbert S,30,0,70,40
1683714483165,ECON 105,A00,185608,Vespa; Emanuel Ignacio,19,0,35,16
1683714484191,ECON 109,A01,185610,Shishkin; Denis,9,0,35,26
1683714485216,ECON 110A,A01,185612,Staff,8,0,40,32
1683714486241,ECON 120A,A01,185615,Staff,19,0,40,21
1683714487268,ECON 120C,A01,185617,Sun; Yixiao,0,21,70,70
1683714488297,ECON 144,A00,203346,Squires; Dale E,2,0,35,33
1683714489323,ECON 171,A01,203349,Newhouse; Herbert S,0,1,35,35
1683714490350,ECON 173A,A01,185621,Toda; Alexis Akira,21,0,35,14
1683714491379,EDS 25,A01,202413,Staff,0,1,0,0
1683714491379,EDS 25,A02,202414,Staff,0,1,0,0
1683714491379,EDS 25,A03,202415,Staff,0,0,0,0
1683714491379,EDS 25,A04,202416,Staff,0,1,0,0
1683714491379,EDS 25,A05,202439,Staff,0,0,0,0
1683714491379,EDS 25,A06,202440,Staff,0,0,0,0
1683714491379,EDS 25,B01,202631,Staff,0,0,0,0
1683714491379,EDS 25,B02,202632,Staff,0,0,0,0
1683714491379,EDS 25,B03,202639,Staff,0,0,0,0
1683714491379,EDS 25,B04,202640,Staff,0,0,0,0
1683714491379,EDS 25,B05,202643,Staff,0,0,0,0
1683714491379,EDS 25,B06,202644,Staff,0,0,0,0
1683714492405,EDS 38,A01,202659,Black; Alison Michelle,25,0,25,0
1683714493430,EDS 115,A00,202652,Staff,18,0,30,12
1683714494455,EDS 125,A00,202649,Staff,13,0,30,17
1683714495487,EDS 126,A01,203332,Staff,30,0,30,0
1683714496514,EDS 139,A00,202838,Staff,16,0,25,9
1683714497539,EDS 146,A01,202655,Staff,14,0,25,11
1683714498565,ENG 15,A00,185667,Staff,0,1,0,0
1683714498565,ENG 15,B00,185672,Staff,0,0,0,0
1683714498565,ENG 15,C00,185675,Staff,0,0,0,0
1683714498565,ENG 15,D00,185682,Staff,0,0,0,0
1683714498565,ENG 15,E00,185684,Staff,0,0,0,0
1683714499593,ETHN 103,A00,185710,Staff,0,8,35,35
1683714500620,ETHN 103A,A00,199228,Man; Simeon S,0,0,9,9
1683714501648,ETHN 109,A00,185711,Staff,15,0,35,20
1683714502676,ETHN 142,A00,185726,Staff,0,4,30,30
1683714503701,ETHN 163J,A00,199229,Man; Simeon S,5,0,8,3
1683714504727,ETHN 168,A00,185727,Staff,7,0,10,3
1683714505756,ETHN 182,A00,185728,Staff,0,0,35,35
1683714506783,ETHN 183,A00,185737,Staff,10,0,18,8
1683714507812,GLBH 111,A01,209361,Burgos; Jose L.,0,0,0,0
1683714509862,HIEU 104,A00,185792,Staff,14,0,20,6
1683714510946,HIEU 115,A00,185800,Staff,0,0,20,20
1683714511974,HIEU 128,A00,185801,Staff,0,9,20,20
1683714512999,HIEU 147,A00,185802,Staff,15,0,20,5
1683714514029,HIEU 154,A00,185823,Staff,11,0,20,9
1683714515054,HILA 102,A00,185826,Staff,14,0,20,6
1683714516080,HILD 2C,A01,185778,Staff,0,13,20,20
1683714517109,HILD 7B,A01,185780,Kwak; Nancy,0,17,32,32
1683714517109,HILD 7B,A02,185781,Kwak; Nancy,0,18,32,32
1683714518134,HILD 30,A01,185791,Staff,12,0,20,8
1683714519161,HISC 119,A00,185830,Golan; Tal,0,10,20,20
1683714520187,HITO 156GS,A00,185831,Patterson; Patrick H.,0,0,0,23
1683714521211,HIUS 103,A00,185832,Man; Simeon S,0,4,20,20
1683714522240,HIUS 117,A00,185836,Kwak; Nancy,2,0,20,18
1683714523267,HIUS 125,A00,185840,Man; Simeon S,0,2,23,23
1683714524292,HIUS 149,A00,185845,Staff,1,0,20,19
1683714525328,HUM 3,A01,185882,Zavodny; Tatiana Sophia,0,8,50,50
1683714525328,HUM 3,B01,185899,Caldwell; Michael Alan,0,18,50,50
1683714526354,HUM 3GS,A00,185900,Patterson; Patrick H.,0,0,0,23
1683714527388,HUM 4,A01,185938,Zroka; Amy Liane,28,0,50,22
1683714527388,HUM 4,B01,185956,Watkins; Eric,0,6,50,50
1683714527388,HUM 4,B02,202209,Watkins; Eric,0,6,50,50
1683714527388,HUM 4,B03,202210,Watkins; Eric,0,5,50,50
1683714528417,HUM 5,A01,185958,West; Geoffrey Scott,0,0,50,50
1683714528417,HUM 5,A02,202215,West; Geoffrey Scott,0,1,50,50
1683714529449,INTL 190,A00,185959,Gagnon; Jeffrey C,0,0,0,9
1683714529449,INTL 190,B00,185960,Lettieri; Michael Joseph,0,0,0,2
1683714530474,JAPN 180,A00,254509,Staff,5,0,30,25
1683714531501,LATI 10,A01,202853,Kennemore; Amy Michelle,4,0,35,31
1683714531501,LATI 10,A02,202854,Kennemore; Amy Michelle,3,0,35,32
1683714531501,LATI 10,A03,270054,Kennemore; Amy Michelle,30,0,30,0
1683714532526,LATI 180,A00,202855,Kennemore; Amy Michelle,11,0,20,9
1683714533556,LAWS 101,A00,201767,Golan; Tal,0,7,40,40
1683714534585,LIFR 1C,A00,185961,Staff,6,0,20,14
1683714535609,LIFR 1CX,A00,185962,Staff,7,0,20,13
1683714536634,LIFR 1D,A00,185963,Staff,7,0,20,13
1683714537661,LIFR 1DX,A00,185964,Staff,7,0,20,13
1683714538688,LIGN 101,A01,186039,Staff,43,0,50,7
1683714539716,LIGN 165,A00,186040,Staff,14,0,50,36
1683714540741,LTCS 108,A00,186041,Staff,5,0,10,5
1683714541771,LTCS 119,A00,186042,Staff,15,0,20,5
1683714542797,LTCS 130,A00,186043,Wesling; Megan E.,15,0,25,10
1683714544848,LTEA 138,A00,186119,Staff,14,0,40,26
1683714545877,LTEN 124,A00,186148,Staff,5,0,25,20
1683714546902,LTEN 178,A00,186149,Staff,6,0,15,9
1683714547928,LTEN 181,A00,186150,Blanco; John D,34,0,40,6
1683714548957,LTWL 120,A00,186160,Staff,19,0,25,6
1683714549982,LTWL 165,A00,186161,Staff,22,0,25,3
1683714551011,LTWR 100,A00,186162,Staff,0,5,15,15
1683714552039,LTWR 102,A00,186163,Doller; Ben,5,0,15,10
1683714553065,MAE 8,A01,186412,Staff,0,1,0,0
1683714554091,MAE 30B,A00,186445,Bahadori; Mohammad Yousef,81,0,100,19
1683714555116,MAE 40,A00,186592,Bewley; Thomas R,10,0,50,40
1683714556145,MAE 101B,A00,186593,Bahadori; Mohammad Yousef,80,0,100,20
1683714557175,MAE 105,A00,186594,Bandaru; Prabhakar,10,0,50,40
1683714558201,MAE 107,A00,186599,Pham; Hieu Tan,0,8,120,120
1683714559228,MAE 148,A01,186660,Silberman; Jack,3,0,16,13
1683714560260,MATH 10A,A01,188095,Staff,0,6,35,35
1683714561287,MATH 10B,A01,188097,Bowers; Adam R.,0,12,30,30
1683714561287,MATH 10B,A02,188099,Bowers; Adam R.,0,11,30,30
1683714561287,MATH 10B,B01,188104,Bowers; Adam R.,0,10,30,30
1683714561287,MATH 10B,B02,188106,Bowers; Adam R.,0,9,30,30
1683714562312,MATH 10C,A01,188111,Staff,0,20,30,30
1683714562312,MATH 10C,A02,188127,Staff,0,19,30,30
1683714562312,MATH 10C,A03,188131,Staff,0,19,30,30
1683714562312,MATH 10C,B01,188218,Staff,17,0,30,13
1683714562312,MATH 10C,B02,188244,Staff,13,0,30,17
1683714562312,MATH 10C,B03,188277,Staff,14,0,30,16
1683714563338,MATH 18,A01,188344,Bach; Quang Tran,18,0,30,12
1683714563338,MATH 18,A02,188345,Bach; Quang Tran,11,0,30,19
1683714563338,MATH 18,B01,188353,Bach; Quang Tran,11,0,30,19
1683714563338,MATH 18,B02,188354,Bach; Quang Tran,19,0,30,11
1683714564364,MATH 20A,A01,188374,Staff,11,0,35,24
1683714565390,MATH 20B,A01,188382,Ohm; Ko Woon,7,0,30,23
1683714565390,MATH 20B,A02,188383,Ohm; Ko Woon,22,0,30,8
1683714565390,MATH 20B,B01,188385,Ohm; Ko Woon,7,0,30,23
1683714565390,MATH 20B,B02,188392,Ohm; Ko Woon,22,0,30,8
1683714566421,MATH 20C,A01,188394,Harel; Guershon,10,0,30,20
1683714566421,MATH 20C,A02,188395,Harel; Guershon,13,0,30,17
1683714566421,MATH 20C,B01,188404,Harel; Guershon,5,0,30,25
1683714566421,MATH 20C,B02,188405,Harel; Guershon,18,0,30,12
1683714567447,MATH 20D,A01,188414,Hammock; Frances H,0,1,30,30
1683714567447,MATH 20D,A02,188415,Hammock; Frances H,0,1,30,30
1683714567447,MATH 20D,B01,188447,Hammock; Frances H,0,1,30,30
1683714567447,MATH 20D,B02,188486,Hammock; Frances H,2,0,30,28
1683714568472,MATH 20E,A01,188649,Staff,21,0,30,9
1683714568472,MATH 20E,A02,188650,Staff,20,0,30,10
1683714568472,MATH 20E,A03,188673,Staff,0,0,30,30
1683714569501,MATH 102,A01,188675,Staff,0,40,35,35
1683714570530,MATH 103B,A01,188681,Staff,3,0,35,32
1683714570530,MATH 103B,B01,188692,Staff,5,0,35,30
1683714571572,MATH 109,A01,188695,Salehi Golsefidy; Alireza,24,0,35,11
1683714571572,MATH 109,A02,188696,Salehi Golsefidy; Alireza,24,0,35,11
1683714572598,MATH 120A,A01,188698,Eggers; John Dietrich,7,0,35,28
1683714573622,MATH 142B,A01,188736,Ioana; Adrian,0,0,30,30
1683714573622,MATH 142B,A02,188741,Ioana; Adrian,0,1,30,30
1683714573622,MATH 142B,A03,188743,Ioana; Adrian,0,2,30,30
1683714574651,MATH 168A,A01,188790,Staff,0,11,35,35
1683714575681,MATH 170A,A01,188803,Nie; Jiawang,0,2,35,35
1683714575681,MATH 170A,A02,188811,Nie; Jiawang,0,1,35,35
1683714575681,MATH 170A,A03,188814,Nie; Jiawang,1,0,35,34
1683714575681,MATH 170A,A04,188815,Nie; Jiawang,5,0,35,30
1683714576709,MATH 193B,A01,188817,Staff,0,0,35,35
1683714576709,MATH 193B,A02,188818,Staff,6,0,35,29
1683714577733,MGT 4,A01,202857,Anderson; John Charles,59,0,80,21
1683714578759,MGT 12,A00,202858,Lindenberger; Wade Douglas,40,0,90,50
1683714579783,MGT 18,A00,202859,Staff,73,0,90,17
1683714580807,MGT 18GS,A00,202860,McKay; Michael J,13,0,28,15
1683714581833,MGT 45,A00,202861,Pecore; Joseph P.,8,0,90,82
1683714582862,MGT 100,A00,202863,Yavorsky; Daniel Ryan,27,0,90,63
1683714583886,MGT 103,A00,202864,Ehrich; Kristine R,0,19,90,90
1683714584914,MGT 112,A00,202865,Ehrich; Kristine R,15,0,90,75
1683714585940,MGT 121A,A00,202868,Staff,70,0,90,20
1683714586968,MGT 131B,A00,202869,Anderson; John Charles,58,0,90,32
1683714587997,MGT 136,A00,202871,Lindenberger; Wade Douglas,83,0,90,7
1683714589026,MGT 164,A00,202873,Staff,0,67,90,91
1683714590051,MGT 164GS,A00,202874,McKay; Mary A,13,0,28,15
1683714591078,MGT 180,A00,202875,Staff,0,51,90,91
1683714592103,MMW 11R,A01,205019,Herbst; Matthew,0,0,30,30
1683714592103,MMW 11R,A02,205026,Herbst; Matthew,29,0,30,1
1683714593137,MMW 15,A01,193512,Chang; Edmond Yi-Teh,0,8,28,28
1683714593137,MMW 15,A02,193513,Chang; Edmond Yi-Teh,0,5,28,28
1683714593137,MMW 15,A03,193514,Chang; Edmond Yi-Teh,0,5,28,28
1683714593137,MMW 15,A04,193515,Chang; Edmond Yi-Teh,0,5,28,28
1683714593137,MMW 15,A05,193516,Chang; Edmond Yi-Teh,0,5,28,28
1683714593137,MMW 15,A06,193517,Chang; Edmond Yi-Teh,0,6,28,28
1683714593137,MMW 15,B01,193519,Chang; Edmond Yi-Teh,0,5,28,28
1683714593137,MMW 15,B02,193520,Chang; Edmond Yi-Teh,0,5,28,28
1683714593137,MMW 15,B03,193521,Chang; Edmond Yi-Teh,0,5,28,28
1683714593137,MMW 15,B04,193522,Chang; Edmond Yi-Teh,0,6,28,28
1683714593137,MMW 15,B05,193523,Chang; Edmond Yi-Teh,0,5,28,28
1683714593137,MMW 15,B06,193524,Chang; Edmond Yi-Teh,0,5,28,28
1683714594165,MMW 122,A01,193526,Rahimi; Babak,0,16,28,28
1683714594165,MMW 122,A02,193527,Rahimi; Babak,0,15,28,28
1683714594165,MMW 122,A03,193528,Rahimi; Babak,0,0,0,0
1683714594165,MMW 122,A04,193529,Rahimi; Babak,0,0,0,0
1683714595189,MUS 1A,A01,186663,Staff,0,18,35,35
1683714596218,MUS 4,A01,186715,Staff,0,12,35,35
1683714597243,MUS 5R,A01,186796,Dubnov; Shlomo,0,17,35,35
1683714598271,MUS 6,A01,186798,Staff,0,4,25,25
1683714599299,MUS 7,A01,186830,Staff,11,0,35,24
1683714600332,MUS 8,A01,186930,Staff,0,27,35,35
1683714601357,MUS 15,A01,186932,Staff,0,15,35,35
1683714601357,MUS 15,B01,186934,Staff,0,16,35,35
1683714602392,MUS 80,A00,186935,Staff,0,0,20,20
1683714602392,MUS 80,B00,186936,Staff,24,0,25,1
1683714603418,NANO 11,A00,204702,Lipomi; Darren John,0,0,0,0
1683714604444,NANO 15,A01,204709,Yang; Kesong,0,1,0,0
1683714605469,NANO 114,A00,202069,Jahed Motlagh; Zeinab,2,0,10,8
1683714606496,PHIL 1,A00,186955,Grush; Rick Scott,31,0,40,9
1683714607520,PHIL 10,A01,186973,Grush; Rick Scott,27,0,35,8
1683714607520,PHIL 10,A02,186974,Grush; Rick Scott,33,0,35,2
1683714608547,PHIL 13,A01,186976,Staff,1,0,35,34
1683714608547,PHIL 13,A02,186977,Staff,16,0,35,19
1683714609572,PHIL 14,A01,186979,Staff,30,0,35,5
1683714609572,PHIL 14,A02,186986,Staff,32,0,35,3
1683714610597,PHIL 28,A01,186988,Staff,16,0,30,14
1683714610597,PHIL 28,A02,186989,Staff,0,0,30,30
1683714610597,PHIL 28,A03,186990,Staff,10,0,30,20
1683714610597,PHIL 28,A04,186991,Staff,26,0,30,4
1683714611628,PHIL 120,A00,186997,Staff,23,0,40,17
1683714612654,PHIL 137,A00,187003,Staff,8,0,40,32
1683714613680,PHIL 150,A00,187015,Staff,47,0,70,23
1683714614778,PHIL 167,A00,187021,Lamey; Andy M.,34,0,40,6
1683714615808,PHIL 174,A01,202226,Staff,17,0,20,3
1683714615808,PHIL 174,A02,202235,Staff,20,0,20,0
1683714616833,PHIL 191A,A00,258918,Staff,0,0,1,1
1683714617858,PHYS 1A,A00,187028,Staff,26,0,60,34
1683714618885,PHYS 1AL,001,187036,Staff,3,0,30,27
1683714618885,PHYS 1AL,002,187049,Staff,18,0,30,12
1683714619910,PHYS 1B,A00,187058,Staff,21,0,60,39
1683714620938,PHYS 1BL,001,187064,Staff,0,1,30,30
1683714620938,PHYS 1BL,002,187070,Staff,4,0,30,26
1683714621964,PHYS 1C,A00,187082,Staff,30,0,120,90
1683714622994,PHYS 1CL,001,187088,Staff,0,9,30,30
1683714622994,PHYS 1CL,002,187089,Staff,0,1,30,30
1683714622994,PHYS 1CL,009,262693,Staff,9,0,30,21
1683714624019,PHYS 2B,A01,187097,Staff,55,0,115,60
1683714625045,PHYS 2C,A01,187099,Staff,63,0,115,52
1683714626073,PHYS 2CL,A01,187101,Staff,5,0,28,23
1683714626073,PHYS 2CL,A02,187102,Staff,15,0,28,13
1683714627098,PHYS 2D,A01,187123,Shotwell; Brian,95,0,115,20
1683714628122,PHYS 4B,A01,187133,Grinstein; Benjamin,35,0,50,15
1683714629151,POLI 10,A00,188819,Staff,0,4,50,50
1683714630175,POLI 11,A00,188827,Staff,43,0,50,7
1683714631199,POLI 13R,A00,188828,Staff,0,2,20,20
1683714632225,POLI 27,A01,188830,Elgin; Samuel Zincke,0,2,70,70
1683714633256,POLI 30,A00,188832,Desposato; Scott,30,0,50,20
1683714634281,POLI 102F,A00,188834,Staff,1,0,40,39
1683714635306,POLI 104A,A00,188852,Staff,12,0,30,18
1683714636330,POLI 104I,A00,188853,Staff,0,8,20,20
1683714637356,POLI 110B,A00,188854,Wiens; David,6,0,20,14
1683714638381,POLI 112A,A00,188855,Wiens; David,3,0,30,27
1683714639407,POLI 117R,A00,188856,Forman; Fonna,0,12,20,20
1683714640436,POLI 118,A00,188857,Ingham; Sean,8,0,20,12
1683714641463,POLI 120G,A00,188858,Staff,7,0,30,23
1683714642489,POLI 131CR,A00,188863,Hoston; Germaine,20,0,50,30
1683714643513,POLI 133,A00,188864,Nellis; Gareth Hb,44,0,50,6
1683714644538,POLI 134D,A00,188865,Desposato; Scott,27,0,30,3
1683714645569,POLI 142A,A00,188871,Gartzke; Erik,21,0,50,29
1683714646594,POLI 142K,A00,188874,Staff,38,0,50,12
1683714647620,POLI 143,A00,188940,Gartzke; Erik,15,0,30,15
1683714648646,POLI 153,A00,188943,Staff,1,0,20,19
1683714649671,POLI 160AA,A00,188944,Staff,10,0,40,30
1683714650699,POLI 170A,A00,188945,Staff,10,0,30,20
1683714652752,PSYC 1,A00,188952,Staff,36,0,90,54
1683714653777,PSYC 2,B00,188953,Staff,19,0,35,16
1683714654803,PSYC 6,A00,188970,Staff,47,0,60,13
1683714655831,PSYC 7,A00,188973,Staff,35,0,45,10
1683714656856,PSYC 60,A01,188980,Rickard; Timothy C.,42,0,60,18
1683714657882,PSYC 70,A01,189001,Steiner; Eric Tomas,22,0,45,23
1683714658912,PSYC 100,A00,189005,Lacefield; Katharine I,1,98,120,119
1683714659940,PSYC 102,A00,189008,Staff,6,0,30,24
1683714660966,PSYC 106,B00,189026,Gorman; Michael R.,27,0,60,33
1683714661992,PSYC 114,B01,189033,Winkielman; Piotr,0,31,30,30
1683714663017,PSYC 131,A00,189036,Anagnostaras; Stephan,0,44,60,60
1683714664043,PSYC 136,A00,189041,Lowe; Angela Beth,0,7,25,25
1683714665072,PSYC 137,A00,189057,Winkielman; Piotr,0,36,25,25
1683714666104,PSYC 144,A00,189107,Wixted; John T,0,11,50,50
1683714668158,PSYC 162,A00,189142,Staff,0,9,85,85
1683714669183,PSYC 172,A00,189144,Gorman; Michael R.,0,6,30,30
1683714671235,PSYC 179,A00,189146,Lacefield; Katharine I,0,88,120,120
1683714672263,PSYC 181,A00,189147,Anagnostaras; Stephan,0,45,90,90
1683714673287,PSYC 190R,A00,189148,Barner; David A.,0,23,80,80
1683714674313,PSYC 191,A00,189275,Rickard; Timothy C.,0,11,25,25
1683714675338,PSYC 193,A00,189276,Chapman; Eddie Nathaniel,0,1,0,4
1683714676364,PSYC 193L,A01,189281,Lowe; Angela Beth,8,0,20,12
1683714676364,PSYC 193L,B01,189285,Staff,28,0,35,7
1683714677390,RELI 149,A00,187137,Rahimi; Babak,6,0,40,34
1683714678416,SE 9,A01,187315,Staff,0,2,18,18
1683714679441,SE 101B,A00,187409,Staff,24,0,30,6
1683714680472,SE 110B,A00,187444,Staff,10,0,40,30
1683714681497,SE 130B,A00,187449,Staff,31,0,40,9
1683714682522,SE 150A,A00,187516,Staff,8,0,20,12
1683714683549,SE 154,A00,187528,Staff,29,0,50,21
1683714684575,SIO 3,A01,258171,Staff,35,0,40,5
1683714685604,SIO 10,A00,187144,Cook; Geoffrey W,0,6,75,75
1683714686632,SIO 45,A00,187152,Cook; Geoffrey W,1,7,100,99
1683714687658,SIO 109R,A00,194486,Staff,0,4,20,20
1683714689705,SIO 187,A01,187233,Kacev; David,12,0,40,28
1683714690731,SOCI 1,A01,258656,Thorpe; Charles Robert,28,0,30,2
1683714690731,SOCI 1,A02,258658,Thorpe; Charles Robert,30,0,30,0
1683714690731,SOCI 1,A03,258661,Thorpe; Charles Robert,25,0,25,0
1683714690731,SOCI 1,A04,258666,Thorpe; Charles Robert,22,0,25,3
1683714690731,SOCI 1,A05,258897,Thorpe; Charles Robert,22,0,25,3
1683714690731,SOCI 1,A06,258898,Thorpe; Charles Robert,25,0,25,0
1683714691756,SOCI 30,A01,258903,Pardo Guerra; Juan Pablo,14,0,30,16
1683714692780,SOCI 102,A00,258904,Staff,9,0,25,16
1683714693809,SOCI 106,A00,258905,Staff,19,0,25,6
1683714694838,SOCI 111,A00,258907,Ribas Norris; Janet Vanesa,26,0,30,4
1683714695863,SOCI 121R,A00,258908,Pardo Guerra; Juan Pablo,7,0,30,23
1683714696888,SOCI 126,A01,203330,Staff,14,0,20,6
1683714697913,SOCI 131,A00,258909,Thorpe; Charles Robert,30,0,60,30
1683714698941,SOCI 135,A00,258910,Payne; Christine Anna,0,13,30,30
1683714699970,SOCI 157,A00,258911,Staff,10,0,30,20
1683714700997,SOCI 184,A00,258912,Staff,25,0,30,5
1683714702023,SOCI 188D,A00,258913,Staff,22,0,30,8
1683714703051,SYN 2,001,187529,Staff,9,0,16,7
1683714703051,SYN 2,002,201452,Staff,0,20,16,16
1683714703051,SYN 2,003,201469,Staff,1,0,16,15
1683714704076,SYN 100,A01,187531,Staff,0,9,20,20
1683714704076,SYN 100,B01,201491,Staff,0,10,20,20
1683714705103,TDAC 1,A00,189286,Walsh; Kim C.,3,0,20,17
1683714705103,TDAC 1,B00,189287,Harting; Carla Kelso,10,0,20,10
1683714706128,TDAC 101,A00,189300,Walsh; Kim C.,16,0,20,4
1683714706128,TDAC 101,B00,189301,Harting; Carla Kelso,18,0,20,2
1683714707155,TDAC 102,A00,189304,Basso; Beatrice,14,0,20,6
1683714708181,TDAC 108,A00,189305,Staff,18,0,20,2
1683714709214,TDDE 131,A00,189310,Staff,19,0,20,1
1683714709214,TDDE 131,B00,189314,Staff,19,0,20,1
1683714709214,TDDE 131,C00,189315,Staff,48,0,50,2
1683714709214,TDDE 131,D00,189316,Staff,14,0,15,1
1683714709214,TDDE 131,E00,204841,Staff,20,0,20,0
1683714710240,TDGE 10,A00,189289,Staff,27,0,50,23
1683714710240,TDGE 10,B00,189290,Havis; Allan,0,1,50,50
1683714711279,TDGE 11,A00,189291,Fulton; Julia,0,4,50,50
1683714711279,TDGE 11,B00,189292,Staff,20,0,25,5
1683714711279,TDGE 11,C00,260270,Staff,0,0,0,0
1683714712304,TDGE 25,A00,189294,Staff,1,0,20,19
1683714713328,TDGE 124,A00,189318,Fulton; Julia,0,7,50,50
1683714714352,TDGE 125,A00,189319,Staff,13,0,25,12
1683714714352,TDGE 125,B00,189320,Staff,23,0,25,2
1683714715381,TDGE 127,A00,189322,Havis; Allan,1,0,50,49
1683714716410,TDHT 101,A00,189323,Staff,18,0,25,7
1683714716410,TDHT 101,B00,189324,Staff,25,0,25,0
1683714717434,TDHT 102,A00,189325,Staff,49,0,50,1
1683714718515,TDMV 1,A00,189295,Arcidiacono; Kristin,20,0,30,10
1683714718515,TDMV 1,B00,189296,Caligagan; Maria T.,23,0,30,7
1683714719544,TDMV 2,A00,189297,Sammartano; Tonnie,27,0,30,3
1683714719544,TDMV 2,B00,189299,Arcidiacono; Kristin,23,0,30,7
1683714720570,TDMV 3,A00,204998,Rincon; Alicia,22,0,30,8
1683714721595,TDMV 120,A00,189458,Sammartano; Tonnie,28,0,30,2
1683714722623,TDMV 138,A00,189541,Jun; Grace Shin Hae,20,0,40,20
1683714723652,TDMV 142,A00,189717,Caligagan; Tony,25,0,30,5
1683714723652,TDMV 142,B00,189718,Caligagan; Maria T.,25,0,30,5
1683714724677,TMC 2,A01,187533,Staff,25,0,25,0
1683714724677,TMC 2,A02,187534,Staff,25,0,25,0
1683714725707,USP 1,A01,187536,Kwak; Nancy,0,16,25,25
1683714726737,USP 5,A01,187538,Staff,8,0,25,17
1683714727767,USP 101,A00,199253,Staff,0,4,0,0
1683714728811,USP 124,A00,187562,Boomhower; Matthew Charles,0,0,30,30
1683714729840,USP 138,A00,187582,Staff,19,0,25,6
1683714730870,USP 152,A01,187597,Staff,3,0,25,22
1683714731895,USP 153,A00,187598,Staff,18,0,25,7
1683714732923,USP 168,A00,187607,Kwak; Nancy,2,0,5,3
1683714733947,USP 173,A00,187619,Staff,4,0,25,21
1683714734975,USP 181,A00,187638,Staff,0,4,25,25
1683714736010,VIS 103,A00,187650,Cruz; Edwin Teddy,17,0,75,58
1683714737035,VIS 110D,A00,187669,Staff,13,0,22,9
1683714738064,VIS 127C,A00,187720,Shen; Kuiyi,67,0,146,79
1683714739089,VIS 149,A00,187731,Yoldas; Pinar,0,12,22,22
1683714740118,VIS 151,A01,188091,Staff,22,0,34,12
1683714740118,VIS 151,A02,188092,Staff,11,0,34,23
1683714741147,VIS 160B,A00,188093,Stalbaum; Brett,0,1,10,10
1683714743200,WCWP 10B,A00,201720,Staff,0,0,5,5
1683714743200,WCWP 10B,B00,201722,Staff,0,0,6,6
1683714744227,WCWP 100,A00,201725,Gagnon; Jeffrey C,0,0,2,2
1683714744227,WCWP 100,B00,201727,Staff,0,4,15,15
1683714747422,ANBI 133,A00,258401,Wilder; Linnea Lorene,34,0,40,6
1683714748448,ANBI 140,A00,258395,Hrvoj Mihic; Branka,18,0,25,7
1683714749488,ANSC 120,A00,258402,Bialecki; Jon Anthony,26,0,40,14
1683714750513,ANSC 144,A00,258400,Staff,12,0,40,28
1683714752571,ANSC 166,A00,258396,Parish; Steven Martin,156,0,175,19
1683714753600,ANSC 180,A00,193533,Staff,8,0,20,12
1683714754634,ANSC 188,A00,258397,Jassal; Aftab,34,0,40,6
1683714755658,ANTH 3,A01,258316,Staff,23,0,30,7
1683714756688,ANTH 5,A00,258394,Semendeferi; Ekaterini,16,0,20,4
1683714757715,ANTH 21,A01,258331,Staff,4,0,40,36
1683714758744,ANTH 103,A00,258398,Varma; Saiba,15,0,25,10
1683714759772,AWP 10,001,202034,Staff,0,0,0,0
1683714759772,AWP 10,002,202035,Staff,0,0,0,0
1683714759772,AWP 10,003,202036,Staff,0,0,0,0
1683714759772,AWP 10,004,202037,Staff,0,0,0,0
1683714759772,AWP 10,005,202038,Staff,0,0,0,0
1683714759772,AWP 10,006,202039,Staff,0,0,0,0
1683714759772,AWP 10,007,202040,Staff,0,0,0,0
1683714759772,AWP 10,008,202041,Staff,0,0,0,0
1683714759772,AWP 10,009,202042,Staff,0,0,0,0
1683714759772,AWP 10,010,202043,Staff,0,0,0,0
1683714759772,AWP 10,011,202044,Staff,0,0,0,0
1683714759772,AWP 10,012,202045,Staff,0,0,0,0
1683714759772,AWP 10,013,202046,Staff,0,0,0,0
1683714759772,AWP 10,014,202047,Staff,0,0,0,0
1683714759772,AWP 10,015,202048,Staff,0,0,0,0
1683714759772,AWP 10,016,202049,Staff,0,0,0,0
1683714759772,AWP 10,017,202050,Staff,0,0,0,0
1683714759772,AWP 10,018,202051,Staff,0,0,0,0
1683714759772,AWP 10,019,202052,Staff,0,0,0,0
1683714759772,AWP 10,020,202053,Staff,0,0,0,0
1683714759772,AWP 10,021,202054,Staff,0,0,0,0
1683714759772,AWP 10,022,202055,Staff,0,0,0,0
1683714759772,AWP 10,023,202056,Staff,0,0,0,0
1683714759772,AWP 10,024,202057,Staff,0,0,0,0
1683714759772,AWP 10,025,202058,Staff,0,0,0,0
1683714759772,AWP 10,026,202059,Staff,0,0,0,0
1683714760796,AWP 102,001,202032,Staff,0,0,0,0
1683714760796,AWP 102,002,202033,Staff,0,0,0,0
1683714761822,BENG 100,A01,254234,Taylor Amos; Alyssa C,31,0,40,9
1683714762850,BENG 196,001,270013,Engler; Adam J.,9999,0,9999,0
1683714763880,BICD 100R,A01,202018,Smith; Laurie,0,7,32,32
1683714763880,BICD 100R,A02,202019,Smith; Laurie,0,3,32,32
1683714763880,BICD 100R,A03,202020,Smith; Laurie,0,1,32,32
1683714763880,BICD 100R,A04,202021,Smith; Laurie,6,0,32,26
1683714763880,BICD 100R,A05,202022,Smith; Laurie,10,0,32,22
1683714764905,BICD 136,A01,193242,Gustafson-Brown; Cindy,0,2,32,32
1683714764905,BICD 136,A02,193244,Gustafson-Brown; Cindy,13,0,32,19
1683714765937,BIEB 102,A01,193249,Butler; Shannon Rhey,0,0,32,32
1683714765937,BIEB 102,A02,193251,Butler; Shannon Rhey,0,0,32,32
1683714765937,BIEB 102,A03,193253,Butler; Shannon Rhey,0,0,32,32
1683714765937,BIEB 102,A04,193255,Butler; Shannon Rhey,13,0,32,19
1683714765937,BIEB 102,A05,193265,Butler; Shannon Rhey,25,0,32,7
1683714765937,BIEB 102,A06,193269,Butler; Shannon Rhey,12,0,32,20
1683714767990,BIEB 150,A01,193274,Staff,0,0,32,32
1683714767990,BIEB 150,A02,193285,Staff,24,0,32,8
1683714769014,BIEB 194,A00,193286,Kurle; Carolyn M.,19,0,32,13
1683714770042,BILD 1,A01,192291,Staff,15,0,32,17
1683714770042,BILD 1,A02,192292,Staff,30,0,32,2
1683714770042,BILD 1,B01,192520,Reuther; Keefe,0,1,0,0
1683714770042,BILD 1,B02,192532,Reuther; Keefe,0,1,0,0
1683714771072,BILD 3,A01,192556,Butler; Shannon Rhey,0,0,32,32
1683714771072,BILD 3,A02,192581,Butler; Shannon Rhey,0,1,32,32
1683714771072,BILD 3,A03,192611,Butler; Shannon Rhey,19,0,32,13
1683714771072,BILD 3,A04,192612,Butler; Shannon Rhey,23,0,32,9
1683714771072,BILD 3,A05,192613,Butler; Shannon Rhey,26,0,32,6
1683714771072,BILD 3,A06,192679,Butler; Shannon Rhey,27,0,32,5
1683714771072,BILD 3,A07,192682,Butler; Shannon Rhey,20,0,32,12
1683714772099,BILD 4,A01,192836,Reuther; Keefe,1,0,24,23
1683714772099,BILD 4,A02,193044,Reuther; Keefe,4,0,24,20
1683714773126,BILD 10,A01,193142,Gustafson-Brown; Cindy,29,0,32,3
1683714773126,BILD 10,A02,193149,Gustafson-Brown; Cindy,31,0,32,1
1683714774152,BIMM 100,A01,193301,Staff,0,6,32,32
1683714774152,BIMM 100,A02,193312,Staff,0,7,32,32
1683714774152,BIMM 100,A03,193323,Staff,0,10,32,32
1683714775179,BIMM 101,A01,193329,McDonnell; Lisa Marie,0,3,24,24
1683714775179,BIMM 101,A02,193339,McDonnell; Lisa Marie,0,3,24,24
1683714775179,BIMM 101,B01,193354,McDonnell; Lisa Marie,0,4,24,24
1683714775179,BIMM 101,B02,193357,McDonnell; Lisa Marie,0,3,24,24
1683714776210,BIMM 110,A01,193377,Tat; John,0,11,32,32
1683714776210,BIMM 110,A02,193378,Tat; John,0,11,32,32
1683714777237,BIMM 120,A01,206116,Staff,0,0,32,32
1683714777237,BIMM 120,A02,206117,Staff,7,0,32,25
1683714777237,BIMM 120,A03,206121,Staff,21,0,32,11
1683714778264,BIPN 100,A01,193393,Park; Ji Young,0,15,32,32
1683714778264,BIPN 100,A02,193402,Park; Ji Young,0,14,32,32
1683714778264,BIPN 100,A03,193413,Park; Ji Young,0,14,32,32
1683714778264,BIPN 100,A04,193414,Park; Ji Young,0,13,32,32
1683714779291,BIPN 102,A01,193429,Staff,0,0,32,32
1683714779291,BIPN 102,A02,193438,Staff,18,0,32,14
1683714780317,BIPN 106,A01,193450,Reyes Gonzalez; Catalina,0,2,40,40
1683714781349,BIPN 134,A01,193465,Cooke; James Edward,0,0,32,32
1683714781349,BIPN 134,A02,193474,Cooke; James Edward,25,0,32,7
1683714781349,BIPN 134,A03,193485,Cooke; James Edward,29,0,32,3
1683714781349,BIPN 134,A04,193486,Cooke; James Edward,20,0,32,12
1683714781349,BIPN 134,A05,193491,Cooke; James Edward,31,0,32,1
1683714781349,BIPN 134,A06,193501,Cooke; James Edward,30,0,32,2
1683714781349,BIPN 134,A07,193510,Cooke; James Edward,29,0,32,3
1683714783406,BISP 194,A00,222522,Staff,14,0,32,18
1683714784437,CAT 124,A01,202407,Staff,19,0,25,6
1683714785464,CAT 125,A00,202408,Marchisotto; Jennifer Anne,2,0,20,18
1683714786493,CAT 125R,A00,202409,Smith; Lauryn Alissa,0,11,20,20
1683714786493,CAT 125R,B00,202410,Morales; Celeste Georgianna,0,11,20,20
1683714786493,CAT 125R,C00,202411,Irwin; Matthew Joseph,0,12,20,20
1683714787518,CENG 15,A01,204712,Yang; Kesong,0,1,0,0
1683714788544,CENG 114,A00,202070,Jahed Motlagh; Zeinab,5,0,20,15
1683714789570,CGS 105,A00,185477,Wesling; Megan E.,24,0,40,16
1683714790599,CGS 106,A00,185494,Staff,11,0,22,11
1683714791624,CGS 108,A00,185495,Staff,14,0,20,6
1683714792649,CGS 114,A00,185496,Staff,13,0,18,5
1683714793674,CGS 119,A00,185501,Staff,15,0,20,5
1683714794700,CGS 120,A00,185511,Staff,11,0,20,9
1683714795735,CHEM 4,A01,184675,Bussey; Thomas J,97,0,100,3
1683714796764,CHEM 6A,A01,184677,Staff,32,0,60,28
1683714797797,CHEM 6B,A01,184679,Staff,63,0,100,37
1683714798827,CHEM 6C,A01,184681,Bussey; Thomas J,0,0,50,50
1683714798827,CHEM 6C,A02,184682,Bussey; Thomas J,32,0,50,18
1683714799853,CHEM 40A,A01,184684,Albizati; Kim F.,33,0,100,67
1683714800882,CHEM 40B,A01,184686,Albizati; Kim F.,0,22,100,100
1683714801907,CHEM 41B,A01,184690,Staff,51,0,100,49
1683714802936,COGS 3,A01,184715,Boyle; Mary E. T.,0,27,40,40
1683714803962,COGS 14B,A01,185172,Staff,0,14,38,38
1683714804988,COGS 18,A01,184736,Staff,14,0,80,66
1683714806015,COGS 100,A01,184932,Staff,0,8,73,73
1683714807043,COGS 101A,A01,184935,Staff,0,40,30,30
1683714808072,COGS 101B,A01,184944,Staff,0,2,30,30
1683714809098,COGS 101C,A01,184946,Staff,0,10,30,30
1683714810124,COGS 102A,A01,184951,Johnson; Christine M.,1,0,40,39
1683714811154,COGS 107B,A01,184953,Mooshagian; Eric Frederick,0,52,40,40
1683714812185,COGS 118B,A01,184959,Gupta; Anjum,0,50,40,40
1683714813210,COGS 153,A00,184961,Staff,1,16,30,29
1683714814233,COGS 177,A00,184962,Staff,0,20,30,30
1683714815261,COGS 187A,A01,184969,Boyle; Mary E. T.,0,19,40,40
1683714816287,COMM 10,A01,185174,Staff,0,5,25,25
1683714816287,COMM 10,A02,185189,Staff,0,2,25,25
1683714816287,COMM 10,A03,269821,Staff,0,1,0,0
1683714817316,COMM 100B,A02,185476,Staff,10,0,25,15
1683714817316,COMM 100B,A03,277340,Staff,25,0,25,0
1683714818347,COMM 100C,A01,185314,Staff,2,0,25,23
1683714818347,COMM 100C,A02,185327,Staff,17,0,25,8
1683714819372,COMM 110M,A00,185349,Staff,0,0,40,40
1683714820396,COMM 113T,A00,185352,Staff,25,0,40,15
1683714821421,COMM 114I,A00,185353,Staff,31,0,40,9
1683714822507,COMM 131,A00,185354,Staff,17,0,30,13
1683714823537,CSE 8A,A50,185358,Cao; Yingjun,0,46,10,10
1683714824571,CSE 8B,A01,185362,Staff,0,48,50,50
1683714825600,CSE 11,A01,185416,Cao; Yingjun,0,91,10,10
1683714826631,CSE 20,A01,185445,Briones; Jor-el Thomas Caparas,3,0,25,22
1683714827655,CSE 21,A01,185447,Staff,9,0,50,41
1683714828684,CSE 101,A01,185451,Staff,0,13,50,50
1683714828684,CSE 101,B01,185453,Jones; Miles E,0,15,50,50
1683714830734,CSE 141,A01,185458,Eldon; John,16,0,100,84
1683714831772,CSE 141L,A01,185461,Eldon; John,8,0,100,92
1683714832803,CSE 142,A01,185463,Staff,34,0,60,26
1683714832803,CSE 142,B01,201355,Staff,0,7,60,60
1683714833827,CSE 142L,A01,185470,Staff,34,0,60,26
1683714833827,CSE 142L,B01,201417,Staff,0,6,60,60
1683714834852,CSE 190,A00,201433,Staff,32,0,49,17
1683714835882,DOC 1,A01,259136,Strom; Megan C.,7,0,15,8
1683714835882,DOC 1,A02,259137,Strom; Megan C.,15,0,15,0
1683714835882,DOC 1,A03,259138,Strom; Megan C.,14,0,15,1
1683714835882,DOC 1,A04,259139,Strom; Megan C.,13,0,15,2
1683714836912,DOC 100D,A00,259140,Pass; Natalye Joann,14,0,25,11
1683714837939,DSGN 1,A01,184749,Rill; Bryan,0,26,30,30
1683714838964,DSGN 100,A01,185168,Staff,0,2,25,25
1683714839992,ECE 5,A01,185626,Morris; Karcher William,0,12,0,0
1683714841020,ECE 101,A01,185628,Staff,14,0,70,56
1683714842045,ECE 107,A01,185635,Baghdadchi; Saharnaz,0,0,20,20
1683714842045,ECE 107,A02,185638,Baghdadchi; Saharnaz,1,0,20,19
1683714843072,ECE 148,A01,185647,Silberman; Jack,0,0,16,16
1683714844098,ECON 1,A01,185537,Crane; Meredith Helen,54,0,70,16
1683714845123,ECON 3,A01,185549,Crane; Meredith Helen,30,0,70,40
1683714846153,ECON 4,A01,203354,Anderson; John Charles,0,5,10,10
1683714847182,ECON 100A,A01,185574,Staff,0,5,40,40
1683714848207,ECON 100B,A01,185576,Staff,0,12,50,50
1683714849232,ECON 100C,A01,185589,Newhouse; Herbert S,30,0,70,40
1683714850260,ECON 105,A00,185608,Vespa; Emanuel Ignacio,19,0,35,16
1683714851285,ECON 109,A01,185610,Shishkin; Denis,9,0,35,26
1683714852308,ECON 110A,A01,185612,Staff,8,0,40,32
1683714853333,ECON 120A,A01,185615,Staff,19,0,40,21
1683714854364,ECON 120C,A01,185617,Sun; Yixiao,0,21,70,70
1683714855389,ECON 144,A00,203346,Squires; Dale E,2,0,35,33
1683714856420,ECON 171,A01,203349,Newhouse; Herbert S,0,1,35,35
1683714857446,ECON 173A,A01,185621,Toda; Alexis Akira,21,0,35,14
1683714858474,EDS 25,A01,202413,Staff,0,1,0,0
1683714858474,EDS 25,A02,202414,Staff,0,1,0,0
1683714858474,EDS 25,A03,202415,Staff,0,0,0,0
1683714858474,EDS 25,A04,202416,Staff,0,1,0,0
1683714858474,EDS 25,A05,202439,Staff,0,0,0,0
1683714858474,EDS 25,A06,202440,Staff,0,0,0,0
1683714858474,EDS 25,B01,202631,Staff,0,0,0,0
1683714858474,EDS 25,B02,202632,Staff,0,0,0,0
1683714858474,EDS 25,B03,202639,Staff,0,0,0,0
1683714858474,EDS 25,B04,202640,Staff,0,0,0,0
1683714858474,EDS 25,B05,202643,Staff,0,0,0,0
1683714858474,EDS 25,B06,202644,Staff,0,0,0,0
1683714859507,EDS 38,A01,202659,Black; Alison Michelle,25,0,25,0
1683714860530,EDS 115,A00,202652,Staff,18,0,30,12
1683714861556,EDS 125,A00,202649,Staff,13,0,30,17
1683714862581,EDS 126,A01,203332,Staff,30,0,30,0
1683714863611,EDS 139,A00,202838,Staff,16,0,25,9
1683714864636,EDS 146,A01,202655,Staff,14,0,25,11
1683714865663,ENG 15,A00,185667,Staff,0,1,0,0
1683714865663,ENG 15,B00,185672,Staff,0,0,0,0
1683714865663,ENG 15,C00,185675,Staff,0,0,0,0
1683714865663,ENG 15,D00,185682,Staff,0,0,0,0
1683714865663,ENG 15,E00,185684,Staff,0,0,0,0
1683714866688,ETHN 103,A00,185710,Staff,0,8,35,35
1683714867720,ETHN 103A,A00,199228,Man; Simeon S,0,0,9,9
1683714868750,ETHN 109,A00,185711,Staff,15,0,35,20
1683714869779,ETHN 142,A00,185726,Staff,0,4,30,30
1683714870806,ETHN 163J,A00,199229,Man; Simeon S,5,0,8,3
1683714871833,ETHN 168,A00,185727,Staff,7,0,10,3
1683714872861,ETHN 182,A00,185728,Staff,0,0,35,35
1683714873886,ETHN 183,A00,185737,Staff,10,0,18,8
1683714874914,GLBH 111,A01,209361,Burgos; Jose L.,0,0,0,0
1683714876971,HIEU 104,A00,185792,Staff,14,0,20,6
1683714877993,HIEU 115,A00,185800,Staff,0,0,20,20
1683714879020,HIEU 128,A00,185801,Staff,0,9,20,20
1683714880043,HIEU 147,A00,185802,Staff,15,0,20,5
1683714881071,HIEU 154,A00,185823,Staff,11,0,20,9
1683714882098,HILA 102,A00,185826,Staff,14,0,20,6
1683714883123,HILD 2C,A01,185778,Staff,0,13,20,20
1683714884148,HILD 7B,A01,185780,Kwak; Nancy,0,17,32,32
1683714884148,HILD 7B,A02,185781,Kwak; Nancy,0,18,32,32
1683714885177,HILD 30,A01,185791,Staff,12,0,20,8
1683714886208,HISC 119,A00,185830,Golan; Tal,0,10,20,20
1683714887231,HITO 156GS,A00,185831,Patterson; Patrick H.,0,0,0,23
1683714888260,HIUS 103,A00,185832,Man; Simeon S,0,4,20,20
1683714889289,HIUS 117,A00,185836,Kwak; Nancy,2,0,20,18
1683714890318,HIUS 125,A00,185840,Man; Simeon S,0,2,23,23
1683714891350,HIUS 149,A00,185845,Staff,1,0,20,19
1683714892376,HUM 3,A01,185882,Zavodny; Tatiana Sophia,0,8,50,50
1683714892376,HUM 3,B01,185899,Caldwell; Michael Alan,0,18,50,50
1683714893404,HUM 3GS,A00,185900,Patterson; Patrick H.,0,0,0,23
1683714894434,HUM 4,A01,185938,Zroka; Amy Liane,28,0,50,22
1683714894434,HUM 4,B01,185956,Watkins; Eric,0,6,50,50
1683714894434,HUM 4,B02,202209,Watkins; Eric,0,6,50,50
1683714894434,HUM 4,B03,202210,Watkins; Eric,0,5,50,50
1683714895466,HUM 5,A01,185958,West; Geoffrey Scott,0,0,50,50
1683714895466,HUM 5,A02,202215,West; Geoffrey Scott,0,1,50,50
1683714896492,INTL 190,A00,185959,Gagnon; Jeffrey C,0,0,0,9
1683714896492,INTL 190,B00,185960,Lettieri; Michael Joseph,0,0,0,2
1683714897516,JAPN 180,A00,254509,Staff,5,0,30,25
1683714898551,LATI 10,A01,202853,Kennemore; Amy Michelle,4,0,35,31
1683714898551,LATI 10,A02,202854,Kennemore; Amy Michelle,3,0,35,32
1683714898551,LATI 10,A03,270054,Kennemore; Amy Michelle,30,0,30,0
1683714899577,LATI 180,A00,202855,Kennemore; Amy Michelle,11,0,20,9
1683714900601,LAWS 101,A00,201767,Golan; Tal,0,7,40,40
1683714901624,LIFR 1C,A00,185961,Staff,6,0,20,14
1683714902649,LIFR 1CX,A00,185962,Staff,7,0,20,13
1683714903673,LIFR 1D,A00,185963,Staff,7,0,20,13
1683714904699,LIFR 1DX,A00,185964,Staff,7,0,20,13
1683714905724,LIGN 101,A01,186039,Staff,43,0,50,7
1683714906748,LIGN 165,A00,186040,Staff,14,0,50,36
1683714907773,LTCS 108,A00,186041,Staff,5,0,10,5
1683714908798,LTCS 119,A00,186042,Staff,15,0,20,5
1683714909826,LTCS 130,A00,186043,Wesling; Megan E.,15,0,25,10
1683714911883,LTEA 138,A00,186119,Staff,14,0,40,26
1683714912911,LTEN 124,A00,186148,Staff,5,0,25,20
1683714913936,LTEN 178,A00,186149,Staff,6,0,15,9
1683714914968,LTEN 181,A00,186150,Blanco; John D,34,0,40,6
1683714915999,LTWL 120,A00,186160,Staff,19,0,25,6
1683714917024,LTWL 165,A00,186161,Staff,22,0,25,3
1683714918048,LTWR 100,A00,186162,Staff,0,5,15,15
1683714919072,LTWR 102,A00,186163,Doller; Ben,5,0,15,10
1683714920104,MAE 8,A01,186412,Staff,0,1,0,0
1683714921136,MAE 30B,A00,186445,Bahadori; Mohammad Yousef,81,0,100,19
1683714922161,MAE 40,A00,186592,Bewley; Thomas R,10,0,50,40
1683714923188,MAE 101B,A00,186593,Bahadori; Mohammad Yousef,80,0,100,20
1683714924215,MAE 105,A00,186594,Bandaru; Prabhakar,10,0,50,40
1683714925243,MAE 107,A00,186599,Pham; Hieu Tan,0,8,120,120
1683714926326,MAE 148,A01,186660,Silberman; Jack,3,0,16,13
1683714927356,MATH 10A,A01,188095,Staff,0,6,35,35
1683714928387,MATH 10B,A01,188097,Bowers; Adam R.,0,12,30,30
1683714928387,MATH 10B,A02,188099,Bowers; Adam R.,0,11,30,30
1683714928387,MATH 10B,B01,188104,Bowers; Adam R.,0,10,30,30
1683714928387,MATH 10B,B02,188106,Bowers; Adam R.,0,9,30,30
1683714929412,MATH 10C,A01,188111,Staff,0,20,30,30
1683714929412,MATH 10C,A02,188127,Staff,0,19,30,30
1683714929412,MATH 10C,A03,188131,Staff,0,19,30,30
1683714929412,MATH 10C,B01,188218,Staff,17,0,30,13
1683714929412,MATH 10C,B02,188244,Staff,13,0,30,17
1683714929412,MATH 10C,B03,188277,Staff,14,0,30,16
1683714930440,MATH 18,A01,188344,Bach; Quang Tran,18,0,30,12
1683714930440,MATH 18,A02,188345,Bach; Quang Tran,11,0,30,19
1683714930440,MATH 18,B01,188353,Bach; Quang Tran,11,0,30,19
1683714930440,MATH 18,B02,188354,Bach; Quang Tran,19,0,30,11
1683714931468,MATH 20A,A01,188374,Staff,11,0,35,24
1683714932498,MATH 20B,A01,188382,Ohm; Ko Woon,7,0,30,23
1683714932498,MATH 20B,A02,188383,Ohm; Ko Woon,22,0,30,8
1683714932498,MATH 20B,B01,188385,Ohm; Ko Woon,7,0,30,23
1683714932498,MATH 20B,B02,188392,Ohm; Ko Woon,22,0,30,8
1683714933523,MATH 20C,A01,188394,Harel; Guershon,10,0,30,20
1683714933523,MATH 20C,A02,188395,Harel; Guershon,13,0,30,17
1683714933523,MATH 20C,B01,188404,Harel; Guershon,5,0,30,25
1683714933523,MATH 20C,B02,188405,Harel; Guershon,18,0,30,12
1683714934548,MATH 20D,A01,188414,Hammock; Frances H,0,1,30,30
1683714934548,MATH 20D,A02,188415,Hammock; Frances H,0,1,30,30
1683714934548,MATH 20D,B01,188447,Hammock; Frances H,0,1,30,30
1683714934548,MATH 20D,B02,188486,Hammock; Frances H,2,0,30,28
1683714935578,MATH 20E,A01,188649,Staff,21,0,30,9
1683714935578,MATH 20E,A02,188650,Staff,20,0,30,10
1683714935578,MATH 20E,A03,188673,Staff,0,0,30,30
1683714936604,MATH 102,A01,188675,Staff,0,40,35,35
1683714937629,MATH 103B,A01,188681,Staff,3,0,35,32
1683714937629,MATH 103B,B01,188692,Staff,5,0,35,30
1683714938653,MATH 109,A01,188695,Salehi Golsefidy; Alireza,24,0,35,11
1683714938653,MATH 109,A02,188696,Salehi Golsefidy; Alireza,24,0,35,11
1683714939679,MATH 120A,A01,188698,Eggers; John Dietrich,7,0,35,28
1683714940705,MATH 142B,A01,188736,Ioana; Adrian,0,0,30,30
1683714940705,MATH 142B,A02,188741,Ioana; Adrian,0,1,30,30
1683714940705,MATH 142B,A03,188743,Ioana; Adrian,0,2,30,30
1683714941734,MATH 168A,A01,188790,Staff,0,11,35,35
1683714942764,MATH 170A,A01,188803,Nie; Jiawang,0,2,35,35
1683714942764,MATH 170A,A02,188811,Nie; Jiawang,0,1,35,35
1683714942764,MATH 170A,A03,188814,Nie; Jiawang,1,0,35,34
1683714942764,MATH 170A,A04,188815,Nie; Jiawang,5,0,35,30
1683714943792,MATH 193B,A01,188817,Staff,0,0,35,35
1683714943792,MATH 193B,A02,188818,Staff,6,0,35,29
1683714944817,MGT 4,A01,202857,Anderson; John Charles,59,0,80,21
1683714945842,MGT 12,A00,202858,Lindenberger; Wade Douglas,40,0,90,50
1683714946867,MGT 18,A00,202859,Staff,73,0,90,17
1683714947895,MGT 18GS,A00,202860,McKay; Michael J,13,0,28,15
1683714948919,MGT 45,A00,202861,Pecore; Joseph P.,8,0,90,82
1683714949944,MGT 100,A00,202863,Yavorsky; Daniel Ryan,27,0,90,63
1683714950976,MGT 103,A00,202864,Ehrich; Kristine R,0,19,90,90
1683714952001,MGT 112,A00,202865,Ehrich; Kristine R,15,0,90,75
1683714953032,MGT 121A,A00,202868,Staff,70,0,90,20
1683714954061,MGT 131B,A00,202869,Anderson; John Charles,58,0,90,32
1683714955085,MGT 136,A00,202871,Lindenberger; Wade Douglas,83,0,90,7
1683714956112,MGT 164,A00,202873,Staff,0,67,90,91
1683714957141,MGT 164GS,A00,202874,McKay; Mary A,13,0,28,15
1683714958165,MGT 180,A00,202875,Staff,0,51,90,91
1683714959192,MMW 11R,A01,205019,Herbst; Matthew,0,0,30,30
1683714959192,MMW 11R,A02,205026,Herbst; Matthew,29,0,30,1
1683714960224,MMW 15,A01,193512,Chang; Edmond Yi-Teh,0,8,28,28
1683714960224,MMW 15,A02,193513,Chang; Edmond Yi-Teh,0,5,28,28
1683714960224,MMW 15,A03,193514,Chang; Edmond Yi-Teh,0,5,28,28
1683714960224,MMW 15,A04,193515,Chang; Edmond Yi-Teh,0,5,28,28
1683714960224,MMW 15,A05,193516,Chang; Edmond Yi-Teh,0,5,28,28
1683714960224,MMW 15,A06,193517,Chang; Edmond Yi-Teh,0,6,28,28
1683714960224,MMW 15,B01,193519,Chang; Edmond Yi-Teh,0,5,28,28
1683714960224,MMW 15,B02,193520,Chang; Edmond Yi-Teh,0,5,28,28
1683714960224,MMW 15,B03,193521,Chang; Edmond Yi-Teh,0,5,28,28
1683714960224,MMW 15,B04,193522,Chang; Edmond Yi-Teh,0,6,28,28
1683714960224,MMW 15,B05,193523,Chang; Edmond Yi-Teh,0,5,28,28
1683714960224,MMW 15,B06,193524,Chang; Edmond Yi-Teh,0,5,28,28
1683714961258,MMW 122,A01,193526,Rahimi; Babak,0,16,28,28
1683714961258,MMW 122,A02,193527,Rahimi; Babak,0,15,28,28
1683714961258,MMW 122,A03,193528,Rahimi; Babak,0,0,0,0
1683714961258,MMW 122,A04,193529,Rahimi; Babak,0,0,0,0
1683714962283,MUS 1A,A01,186663,Staff,0,18,35,35
1683714963307,MUS 4,A01,186715,Staff,0,12,35,35
1683714964331,MUS 5R,A01,186796,Dubnov; Shlomo,0,17,35,35
1683714965360,MUS 6,A01,186798,Staff,0,4,25,25
1683714966386,MUS 7,A01,186830,Staff,11,0,35,24
1683714967413,MUS 8,A01,186930,Staff,0,27,35,35
1683714968438,MUS 15,A01,186932,Staff,0,15,35,35
1683714968438,MUS 15,B01,186934,Staff,0,16,35,35
1683714969463,MUS 80,A00,186935,Staff,0,0,20,20
1683714969463,MUS 80,B00,186936,Staff,24,0,25,1
1683714970489,NANO 11,A00,204702,Lipomi; Darren John,0,0,0,0
1683714971520,NANO 15,A01,204709,Yang; Kesong,0,1,0,0
1683714972546,NANO 114,A00,202069,Jahed Motlagh; Zeinab,2,0,10,8
1683714973572,PHIL 1,A00,186955,Grush; Rick Scott,31,0,40,9
1683714974600,PHIL 10,A01,186973,Grush; Rick Scott,27,0,35,8
1683714974600,PHIL 10,A02,186974,Grush; Rick Scott,33,0,35,2
1683714975626,PHIL 13,A01,186976,Staff,1,0,35,34
1683714975626,PHIL 13,A02,186977,Staff,16,0,35,19
1683714976655,PHIL 14,A01,186979,Staff,30,0,35,5
1683714976655,PHIL 14,A02,186986,Staff,32,0,35,3
1683714977683,PHIL 28,A01,186988,Staff,16,0,30,14
1683714977683,PHIL 28,A02,186989,Staff,0,0,30,30
1683714977683,PHIL 28,A03,186990,Staff,10,0,30,20
1683714977683,PHIL 28,A04,186991,Staff,26,0,30,4
1683714978708,PHIL 120,A00,186997,Staff,23,0,40,17
1683714979731,PHIL 137,A00,187003,Staff,8,0,40,32
1683714980761,PHIL 150,A00,187015,Staff,47,0,70,23
1683714981796,PHIL 167,A00,187021,Lamey; Andy M.,34,0,40,6
1683714982824,PHIL 174,A01,202226,Staff,17,0,20,3
1683714982824,PHIL 174,A02,202235,Staff,20,0,20,0
1683714983853,PHIL 191A,A00,258918,Staff,0,0,1,1
1683714984880,PHYS 1A,A00,187028,Staff,26,0,60,34
1683714985905,PHYS 1AL,001,187036,Staff,3,0,30,27
1683714985905,PHYS 1AL,002,187049,Staff,18,0,30,12
1683714986930,PHYS 1B,A00,187058,Staff,21,0,60,39
1683714987956,PHYS 1BL,001,187064,Staff,0,1,30,30
1683714987956,PHYS 1BL,002,187070,Staff,4,0,30,26
1683714988982,PHYS 1C,A00,187082,Staff,30,0,120,90
1683714990013,PHYS 1CL,001,187088,Staff,0,9,30,30
1683714990013,PHYS 1CL,002,187089,Staff,0,1,30,30
1683714990013,PHYS 1CL,009,262693,Staff,9,0,30,21
1683714991037,PHYS 2B,A01,187097,Staff,55,0,115,60
1683714992062,PHYS 2C,A01,187099,Staff,63,0,115,52
1683714993087,PHYS 2CL,A01,187101,Staff,5,0,28,23
1683714993087,PHYS 2CL,A02,187102,Staff,15,0,28,13
1683714994116,PHYS 2D,A01,187123,Shotwell; Brian,95,0,115,20
1683714995140,PHYS 4B,A01,187133,Grinstein; Benjamin,35,0,50,15
1683714996165,POLI 10,A00,188819,Staff,0,4,50,50
1683714997189,POLI 11,A00,188827,Staff,43,0,50,7
1683714998214,POLI 13R,A00,188828,Staff,0,2,20,20
1683714999245,POLI 27,A01,188830,Elgin; Samuel Zincke,0,2,70,70
1683715000274,POLI 30,A00,188832,Desposato; Scott,30,0,50,20
1683715001302,POLI 102F,A00,188834,Staff,1,0,40,39
1683715002327,POLI 104A,A00,188852,Staff,12,0,30,18
1683715003353,POLI 104I,A00,188853,Staff,0,8,20,20
1683715004378,POLI 110B,A00,188854,Wiens; David,6,0,20,14
1683715005402,POLI 112A,A00,188855,Wiens; David,3,0,30,27
1683715006428,POLI 117R,A00,188856,Forman; Fonna,0,12,20,20
1683715007453,POLI 118,A00,188857,Ingham; Sean,8,0,20,12
1683715008477,POLI 120G,A00,188858,Staff,7,0,30,23
1683715009502,POLI 131CR,A00,188863,Hoston; Germaine,20,0,50,30
1683715010527,POLI 133,A00,188864,Nellis; Gareth Hb,44,0,50,6
1683715011552,POLI 134D,A00,188865,Desposato; Scott,27,0,30,3
1683715012577,POLI 142A,A00,188871,Gartzke; Erik,21,0,50,29
1683715013607,POLI 142K,A00,188874,Staff,38,0,50,12
1683715014634,POLI 143,A00,188940,Gartzke; Erik,15,0,30,15
1683715015659,POLI 153,A00,188943,Staff,1,0,20,19
1683715016683,POLI 160AA,A00,188944,Staff,10,0,40,30
1683715017708,POLI 170A,A00,188945,Staff,10,0,30,20
1683715019757,PSYC 1,A00,188952,Staff,36,0,90,54
1683715020782,PSYC 2,B00,188953,Staff,19,0,35,16
1683715021807,PSYC 6,A00,188970,Staff,47,0,60,13
1683715022832,PSYC 7,A00,188973,Staff,35,0,45,10
1683715023861,PSYC 60,A01,188980,Rickard; Timothy C.,42,0,60,18
1683715024886,PSYC 70,A01,189001,Steiner; Eric Tomas,22,0,45,23
1683715025918,PSYC 100,A00,189005,Lacefield; Katharine I,1,98,120,119
1683715026946,PSYC 102,A00,189008,Staff,6,0,30,24
1683715027975,PSYC 106,B00,189026,Gorman; Michael R.,27,0,60,33
1683715029000,PSYC 114,B01,189033,Winkielman; Piotr,0,31,30,30
1683715030093,PSYC 131,A00,189036,Anagnostaras; Stephan,0,44,60,60
1683715031129,PSYC 136,A00,189041,Lowe; Angela Beth,0,7,25,25
1683715032154,PSYC 137,A00,189057,Winkielman; Piotr,0,36,25,25
1683715033178,PSYC 144,A00,189107,Wixted; John T,0,11,50,50
1683715035237,PSYC 162,A00,189142,Staff,0,9,85,85
1683715036264,PSYC 172,A00,189144,Gorman; Michael R.,0,6,30,30
1683715038322,PSYC 179,A00,189146,Lacefield; Katharine I,0,88,120,120
1683715039348,PSYC 181,A00,189147,Anagnostaras; Stephan,0,45,90,90
1683715040372,PSYC 190R,A00,189148,Barner; David A.,0,23,80,80
1683715041398,PSYC 191,A00,189275,Rickard; Timothy C.,0,11,25,25
1683715042425,PSYC 193,A00,189276,Chapman; Eddie Nathaniel,0,1,0,4
1683715043452,PSYC 193L,A01,189281,Lowe; Angela Beth,8,0,20,12
1683715043452,PSYC 193L,B01,189285,Staff,28,0,35,7
1683715044477,RELI 149,A00,187137,Rahimi; Babak,6,0,40,34
1683715045506,SE 9,A01,187315,Staff,0,2,18,18
1683715046534,SE 101B,A00,187409,Staff,24,0,30,6
1683715047560,SE 110B,A00,187444,Staff,10,0,40,30
1683715048590,SE 130B,A00,187449,Staff,31,0,40,9
1683715049614,SE 150A,A00,187516,Staff,8,0,20,12
1683715050642,SE 154,A00,187528,Staff,29,0,50,21
1683715051673,SIO 3,A01,258171,Staff,35,0,40,5
1683715052697,SIO 10,A00,187144,Cook; Geoffrey W,0,6,75,75
1683715053723,SIO 45,A00,187152,Cook; Geoffrey W,1,7,100,99
1683715054748,SIO 109R,A00,194486,Staff,0,4,20,20
1683715056803,SIO 187,A01,187233,Kacev; David,12,0,40,28
1683715057834,SOCI 1,A01,258656,Thorpe; Charles Robert,28,0,30,2
1683715057834,SOCI 1,A02,258658,Thorpe; Charles Robert,30,0,30,0
1683715057834,SOCI 1,A03,258661,Thorpe; Charles Robert,25,0,25,0
1683715057834,SOCI 1,A04,258666,Thorpe; Charles Robert,22,0,25,3
1683715057834,SOCI 1,A05,258897,Thorpe; Charles Robert,22,0,25,3
1683715057834,SOCI 1,A06,258898,Thorpe; Charles Robert,25,0,25,0
1683715058860,SOCI 30,A01,258903,Pardo Guerra; Juan Pablo,14,0,30,16
1683715059884,SOCI 102,A00,258904,Staff,9,0,25,16
1683715060909,SOCI 106,A00,258905,Staff,19,0,25,6
1683715061937,SOCI 111,A00,258907,Ribas Norris; Janet Vanesa,26,0,30,4
1683715062962,SOCI 121R,A00,258908,Pardo Guerra; Juan Pablo,7,0,30,23
1683715063991,SOCI 126,A01,203330,Staff,14,0,20,6
1683715065016,SOCI 131,A00,258909,Thorpe; Charles Robert,30,0,60,30
1683715066040,SOCI 135,A00,258910,Payne; Christine Anna,0,13,30,30
1683715067066,SOCI 157,A00,258911,Staff,10,0,30,20
1683715068096,SOCI 184,A00,258912,Staff,25,0,30,5
1683715069121,SOCI 188D,A00,258913,Staff,22,0,30,8
1683715070178,SYN 2,001,187529,Staff,9,0,16,7
1683715070178,SYN 2,002,201452,Staff,0,20,16,16
1683715070178,SYN 2,003,201469,Staff,1,0,16,15
1683715071206,SYN 100,A01,187531,Staff,0,9,20,20
1683715071206,SYN 100,B01,201491,Staff,0,10,20,20
1683715072233,TDAC 1,A00,189286,Walsh; Kim C.,3,0,20,17
1683715072233,TDAC 1,B00,189287,Harting; Carla Kelso,10,0,20,10
1683715073257,TDAC 101,A00,189300,Walsh; Kim C.,16,0,20,4
1683715073257,TDAC 101,B00,189301,Harting; Carla Kelso,18,0,20,2
1683715074288,TDAC 102,A00,189304,Basso; Beatrice,14,0,20,6
1683715075313,TDAC 108,A00,189305,Staff,18,0,20,2
1683715076338,TDDE 131,A00,189310,Staff,19,0,20,1
1683715076338,TDDE 131,B00,189314,Staff,19,0,20,1
1683715076338,TDDE 131,C00,189315,Staff,48,0,50,2
1683715076338,TDDE 131,D00,189316,Staff,14,0,15,1
1683715076338,TDDE 131,E00,204841,Staff,20,0,20,0
1683715077365,TDGE 10,A00,189289,Staff,27,0,50,23
1683715077365,TDGE 10,B00,189290,Havis; Allan,0,1,50,50
1683715078399,TDGE 11,A00,189291,Fulton; Julia,0,4,50,50
1683715078399,TDGE 11,B00,189292,Staff,20,0,25,5
1683715078399,TDGE 11,C00,260270,Staff,0,0,0,0
1683715079424,TDGE 25,A00,189294,Staff,1,0,20,19
1683715080450,TDGE 124,A00,189318,Fulton; Julia,0,7,50,50
1683715081475,TDGE 125,A00,189319,Staff,13,0,25,12
1683715081475,TDGE 125,B00,189320,Staff,23,0,25,2
1683715082501,TDGE 127,A00,189322,Havis; Allan,1,0,50,49
1683715083529,TDHT 101,A00,189323,Staff,18,0,25,7
1683715083529,TDHT 101,B00,189324,Staff,25,0,25,0
1683715084554,TDHT 102,A00,189325,Staff,49,0,50,1
1683715085583,TDMV 1,A00,189295,Arcidiacono; Kristin,20,0,30,10
1683715085583,TDMV 1,B00,189296,Caligagan; Maria T.,23,0,30,7
1683715086609,TDMV 2,A00,189297,Sammartano; Tonnie,27,0,30,3
1683715086609,TDMV 2,B00,189299,Arcidiacono; Kristin,23,0,30,7
1683715087639,TDMV 3,A00,204998,Rincon; Alicia,22,0,30,8
1683715088664,TDMV 120,A00,189458,Sammartano; Tonnie,28,0,30,2
1683715089695,TDMV 138,A00,189541,Jun; Grace Shin Hae,20,0,40,20
1683715090720,TDMV 142,A00,189717,Caligagan; Tony,25,0,30,5
1683715090720,TDMV 142,B00,189718,Caligagan; Maria T.,25,0,30,5
1683715091747,TMC 2,A01,187533,Staff,25,0,25,0
1683715091747,TMC 2,A02,187534,Staff,25,0,25,0
1683715092777,USP 1,A01,187536,Kwak; Nancy,0,16,25,25
1683715093802,USP 5,A01,187538,Staff,8,0,25,17
1683715094826,USP 101,A00,199253,Staff,0,4,0,0
1683715095852,USP 124,A00,187562,Boomhower; Matthew Charles,0,0,30,30
1683715096880,USP 138,A00,187582,Staff,19,0,25,6
1683715097907,USP 152,A01,187597,Staff,3,0,25,22
1683715098932,USP 153,A00,187598,Staff,18,0,25,7
1683715099962,USP 168,A00,187607,Kwak; Nancy,2,0,5,3
1683715100992,USP 173,A00,187619,Staff,4,0,25,21
1683715102020,USP 181,A00,187638,Staff,0,4,25,25
1683715103045,VIS 103,A00,187650,Cruz; Edwin Teddy,17,0,75,58
1683715104069,VIS 110D,A00,187669,Staff,13,0,22,9
1683715105098,VIS 127C,A00,187720,Shen; Kuiyi,67,0,146,79
1683715106126,VIS 149,A00,187731,Yoldas; Pinar,0,12,22,22
1683715107152,VIS 151,A01,188091,Staff,22,0,34,12
1683715107152,VIS 151,A02,188092,Staff,11,0,34,23
1683715108177,VIS 160B,A00,188093,Stalbaum; Brett,0,1,10,10
1683715110232,WCWP 10B,A00,201720,Staff,0,0,5,5
1683715110232,WCWP 10B,B00,201722,Staff,0,0,6,6
1683715111257,WCWP 100,A00,201725,Gagnon; Jeffrey C,0,0,2,2
1683715111257,WCWP 100,B00,201727,Staff,0,4,15,15
1683715114366,ANBI 133,A00,258401,Wilder; Linnea Lorene,34,0,40,6
1683715115394,ANBI 140,A00,258395,Hrvoj Mihic; Branka,18,0,25,7
1683715116419,ANSC 120,A00,258402,Bialecki; Jon Anthony,26,0,40,14
1683715117445,ANSC 144,A00,258400,Staff,12,0,40,28
1683715119495,ANSC 166,A00,258396,Parish; Steven Martin,156,0,175,19
1683715120523,ANSC 180,A00,193533,Staff,8,0,20,12
1683715121548,ANSC 188,A00,258397,Jassal; Aftab,34,0,40,6
1683715122577,ANTH 3,A01,258316,Staff,23,0,30,7
1683715123605,ANTH 5,A00,258394,Semendeferi; Ekaterini,16,0,20,4
1683715124635,ANTH 21,A01,258331,Staff,4,0,40,36
1683715125658,ANTH 103,A00,258398,Varma; Saiba,15,0,25,10
1683715126688,AWP 10,001,202034,Staff,0,0,0,0
1683715126688,AWP 10,002,202035,Staff,0,0,0,0
1683715126688,AWP 10,003,202036,Staff,0,0,0,0
1683715126688,AWP 10,004,202037,Staff,0,0,0,0
1683715126688,AWP 10,005,202038,Staff,0,0,0,0
1683715126688,AWP 10,006,202039,Staff,0,0,0,0
1683715126688,AWP 10,007,202040,Staff,0,0,0,0
1683715126688,AWP 10,008,202041,Staff,0,0,0,0
1683715126688,AWP 10,009,202042,Staff,0,0,0,0
1683715126688,AWP 10,010,202043,Staff,0,0,0,0
1683715126688,AWP 10,011,202044,Staff,0,0,0,0
1683715126688,AWP 10,012,202045,Staff,0,0,0,0
1683715126688,AWP 10,013,202046,Staff,0,0,0,0
1683715126688,AWP 10,014,202047,Staff,0,0,0,0
1683715126688,AWP 10,015,202048,Staff,0,0,0,0
1683715126688,AWP 10,016,202049,Staff,0,0,0,0
1683715126688,AWP 10,017,202050,Staff,0,0,0,0
1683715126688,AWP 10,018,202051,Staff,0,0,0,0
1683715126688,AWP 10,019,202052,Staff,0,0,0,0
1683715126688,AWP 10,020,202053,Staff,0,0,0,0
1683715126688,AWP 10,021,202054,Staff,0,0,0,0
1683715126688,AWP 10,022,202055,Staff,0,0,0,0
1683715126688,AWP 10,023,202056,Staff,0,0,0,0
1683715126688,AWP 10,024,202057,Staff,0,0,0,0
1683715126688,AWP 10,025,202058,Staff,0,0,0,0
1683715126688,AWP 10,026,202059,Staff,0,0,0,0
1683715127713,AWP 102,001,202032,Staff,0,0,0,0
1683715127713,AWP 102,002,202033,Staff,0,0,0,0
1683715128738,BENG 100,A01,254234,Taylor Amos; Alyssa C,31,0,40,9
1683715129761,BENG 196,001,270013,Engler; Adam J.,9999,0,9999,0
1683715130795,BICD 100R,A01,202018,Smith; Laurie,0,7,32,32
1683715130795,BICD 100R,A02,202019,Smith; Laurie,0,3,32,32
1683715130795,BICD 100R,A03,202020,Smith; Laurie,0,1,32,32
1683715130795,BICD 100R,A04,202021,Smith; Laurie,6,0,32,26
1683715130795,BICD 100R,A05,202022,Smith; Laurie,10,0,32,22
1683715131823,BICD 136,A01,193242,Gustafson-Brown; Cindy,0,2,32,32
1683715131823,BICD 136,A02,193244,Gustafson-Brown; Cindy,13,0,32,19
1683715132849,BIEB 102,A01,193249,Butler; Shannon Rhey,0,0,32,32
1683715132849,BIEB 102,A02,193251,Butler; Shannon Rhey,0,0,32,32
1683715132849,BIEB 102,A03,193253,Butler; Shannon Rhey,0,0,32,32
1683715132849,BIEB 102,A04,193255,Butler; Shannon Rhey,13,0,32,19
1683715132849,BIEB 102,A05,193265,Butler; Shannon Rhey,25,0,32,7
1683715132849,BIEB 102,A06,193269,Butler; Shannon Rhey,12,0,32,20
1683715134980,BIEB 150,A01,193274,Staff,0,0,32,32
1683715134980,BIEB 150,A02,193285,Staff,24,0,32,8
1683715136010,BIEB 194,A00,193286,Kurle; Carolyn M.,19,0,32,13
1683715137038,BILD 1,A01,192291,Staff,15,0,32,17
1683715137038,BILD 1,A02,192292,Staff,30,0,32,2
1683715137038,BILD 1,B01,192520,Reuther; Keefe,0,1,0,0
1683715137038,BILD 1,B02,192532,Reuther; Keefe,0,1,0,0
1683715138064,BILD 3,A01,192556,Butler; Shannon Rhey,0,0,32,32
1683715138064,BILD 3,A02,192581,Butler; Shannon Rhey,0,1,32,32
1683715138064,BILD 3,A03,192611,Butler; Shannon Rhey,19,0,32,13
1683715138064,BILD 3,A04,192612,Butler; Shannon Rhey,23,0,32,9
1683715138064,BILD 3,A05,192613,Butler; Shannon Rhey,26,0,32,6
1683715138064,BILD 3,A06,192679,Butler; Shannon Rhey,27,0,32,5
1683715138064,BILD 3,A07,192682,Butler; Shannon Rhey,20,0,32,12
1683715139089,BILD 4,A01,192836,Reuther; Keefe,1,0,24,23
1683715139089,BILD 4,A02,193044,Reuther; Keefe,4,0,24,20
1683715140112,BILD 10,A01,193142,Gustafson-Brown; Cindy,29,0,32,3
1683715140112,BILD 10,A02,193149,Gustafson-Brown; Cindy,31,0,32,1
1683715141142,BIMM 100,A01,193301,Staff,0,6,32,32
1683715141142,BIMM 100,A02,193312,Staff,0,7,32,32
1683715141142,BIMM 100,A03,193323,Staff,0,10,32,32
1683715142174,BIMM 101,A01,193329,McDonnell; Lisa Marie,0,3,24,24
1683715142174,BIMM 101,A02,193339,McDonnell; Lisa Marie,0,3,24,24
1683715142174,BIMM 101,B01,193354,McDonnell; Lisa Marie,0,4,24,24
1683715142174,BIMM 101,B02,193357,McDonnell; Lisa Marie,0,3,24,24
1683715143206,BIMM 110,A01,193377,Tat; John,0,11,32,32
1683715143206,BIMM 110,A02,193378,Tat; John,0,11,32,32
1683715144240,BIMM 120,A01,206116,Staff,0,0,32,32
1683715144240,BIMM 120,A02,206117,Staff,7,0,32,25
1683715144240,BIMM 120,A03,206121,Staff,21,0,32,11
1683715145269,BIPN 100,A01,193393,Park; Ji Young,0,15,32,32
1683715145269,BIPN 100,A02,193402,Park; Ji Young,0,14,32,32
1683715145269,BIPN 100,A03,193413,Park; Ji Young,0,14,32,32
1683715145269,BIPN 100,A04,193414,Park; Ji Young,0,13,32,32
1683715146299,BIPN 102,A01,193429,Staff,0,0,32,32
1683715146299,BIPN 102,A02,193438,Staff,18,0,32,14
1683715147328,BIPN 106,A01,193450,Reyes Gonzalez; Catalina,0,2,40,40
1683715148355,BIPN 134,A01,193465,Cooke; James Edward,0,0,32,32
1683715148355,BIPN 134,A02,193474,Cooke; James Edward,25,0,32,7
1683715148355,BIPN 134,A03,193485,Cooke; James Edward,29,0,32,3
1683715148355,BIPN 134,A04,193486,Cooke; James Edward,20,0,32,12
1683715148355,BIPN 134,A05,193491,Cooke; James Edward,31,0,32,1
1683715148355,BIPN 134,A06,193501,Cooke; James Edward,30,0,32,2
1683715148355,BIPN 134,A07,193510,Cooke; James Edward,29,0,32,3
1683715150412,BISP 194,A00,222522,Staff,14,0,32,18
1683715151436,CAT 124,A01,202407,Staff,19,0,25,6
1683715152462,CAT 125,A00,202408,Marchisotto; Jennifer Anne,2,0,20,18
1683715153492,CAT 125R,A00,202409,Smith; Lauryn Alissa,0,11,20,20
1683715153492,CAT 125R,B00,202410,Morales; Celeste Georgianna,0,11,20,20
1683715153492,CAT 125R,C00,202411,Irwin; Matthew Joseph,0,12,20,20
1683715154516,CENG 15,A01,204712,Yang; Kesong,0,1,0,0
1683715155540,CENG 114,A00,202070,Jahed Motlagh; Zeinab,5,0,20,15
1683715156566,CGS 105,A00,185477,Wesling; Megan E.,24,0,40,16
1683715157594,CGS 106,A00,185494,Staff,11,0,22,11
1683715158620,CGS 108,A00,185495,Staff,14,0,20,6
1683715159644,CGS 114,A00,185496,Staff,13,0,18,5
1683715160670,CGS 119,A00,185501,Staff,15,0,20,5
1683715161695,CGS 120,A00,185511,Staff,11,0,20,9
1683715162721,CHEM 4,A01,184675,Bussey; Thomas J,97,0,100,3
1683715163745,CHEM 6A,A01,184677,Staff,32,0,60,28
1683715164771,CHEM 6B,A01,184679,Staff,63,0,100,37
1683715165795,CHEM 6C,A01,184681,Bussey; Thomas J,0,0,50,50
1683715165795,CHEM 6C,A02,184682,Bussey; Thomas J,32,0,50,18
1683715166822,CHEM 40A,A01,184684,Albizati; Kim F.,33,0,100,67
1683715167847,CHEM 40B,A01,184686,Albizati; Kim F.,0,22,100,100
1683715168871,CHEM 41B,A01,184690,Staff,51,0,100,49
1683715169898,COGS 3,A01,184715,Boyle; Mary E. T.,0,27,40,40
1683715170925,COGS 14B,A01,185172,Staff,0,14,38,38
1683715171954,COGS 18,A01,184736,Staff,14,0,80,66
1683715172988,COGS 100,A01,184932,Staff,0,8,73,73
1683715174012,COGS 101A,A01,184935,Staff,0,40,30,30
1683715175039,COGS 101B,A01,184944,Staff,0,2,30,30
1683715176068,COGS 101C,A01,184946,Staff,0,10,30,30
1683715177096,COGS 102A,A01,184951,Johnson; Christine M.,1,0,40,39
1683715178125,COGS 107B,A01,184953,Mooshagian; Eric Frederick,0,52,40,40
1683715179148,COGS 118B,A01,184959,Gupta; Anjum,0,50,40,40
1683715180170,COGS 153,A00,184961,Staff,1,16,30,29
1683715181195,COGS 177,A00,184962,Staff,0,20,30,30
1683715182219,COGS 187A,A01,184969,Boyle; Mary E. T.,0,19,40,40
1683715183248,COMM 10,A01,185174,Staff,0,5,25,25
1683715183248,COMM 10,A02,185189,Staff,0,2,25,25
1683715183248,COMM 10,A03,269821,Staff,0,1,0,0
1683715184275,COMM 100B,A02,185476,Staff,10,0,25,15
1683715184275,COMM 100B,A03,277340,Staff,25,0,25,0
1683715185299,COMM 100C,A01,185314,Staff,2,0,25,23
1683715185299,COMM 100C,A02,185327,Staff,17,0,25,8
1683715186323,COMM 110M,A00,185349,Staff,0,0,40,40
1683715187347,COMM 113T,A00,185352,Staff,25,0,40,15
1683715188371,COMM 114I,A00,185353,Staff,31,0,40,9
1683715189397,COMM 131,A00,185354,Staff,17,0,30,13
1683715190426,CSE 8A,A50,185358,Cao; Yingjun,0,46,10,10
1683715191449,CSE 8B,A01,185362,Staff,0,48,50,50
1683715192472,CSE 11,A01,185416,Cao; Yingjun,0,91,10,10
1683715193498,CSE 20,A01,185445,Briones; Jor-el Thomas Caparas,3,0,25,22
1683715194524,CSE 21,A01,185447,Staff,9,0,50,41
1683715195550,CSE 101,A01,185451,Staff,0,13,50,50
1683715195550,CSE 101,B01,185453,Jones; Miles E,0,15,50,50
1683715197605,CSE 141,A01,185458,Eldon; John,16,0,100,84
1683715198630,CSE 141L,A01,185461,Eldon; John,8,0,100,92
1683715199656,CSE 142,A01,185463,Staff,34,0,60,26
1683715199656,CSE 142,B01,201355,Staff,0,7,60,60
1683715200683,CSE 142L,A01,185470,Staff,34,0,60,26
1683715200683,CSE 142L,B01,201417,Staff,0,6,60,60
1683715201708,CSE 190,A00,201433,Staff,32,0,49,17
1683715202734,DOC 1,A01,259136,Strom; Megan C.,7,0,15,8
1683715202734,DOC 1,A02,259137,Strom; Megan C.,15,0,15,0
1683715202734,DOC 1,A03,259138,Strom; Megan C.,14,0,15,1
1683715202734,DOC 1,A04,259139,Strom; Megan C.,13,0,15,2
1683715203761,DOC 100D,A00,259140,Pass; Natalye Joann,14,0,25,11
1683715204788,DSGN 1,A01,184749,Rill; Bryan,0,26,30,30
1683715205814,DSGN 100,A01,185168,Staff,0,2,25,25
1683715206839,ECE 5,A01,185626,Morris; Karcher William,0,12,0,0
1683715207863,ECE 101,A01,185628,Staff,14,0,70,56
1683715208888,ECE 107,A01,185635,Baghdadchi; Saharnaz,0,0,20,20
1683715208888,ECE 107,A02,185638,Baghdadchi; Saharnaz,1,0,20,19
1683715209912,ECE 148,A01,185647,Silberman; Jack,0,0,16,16
1683715210936,ECON 1,A01,185537,Crane; Meredith Helen,54,0,70,16
1683715211959,ECON 3,A01,185549,Crane; Meredith Helen,30,0,70,40
1683715212988,ECON 4,A01,203354,Anderson; John Charles,0,5,10,10
1683715214015,ECON 100A,A01,185574,Staff,0,5,40,40
1683715215039,ECON 100B,A01,185576,Staff,0,12,50,50
1683715216064,ECON 100C,A01,185589,Newhouse; Herbert S,30,0,70,40
1683715217093,ECON 105,A00,185608,Vespa; Emanuel Ignacio,19,0,35,16
1683715218117,ECON 109,A01,185610,Shishkin; Denis,9,0,35,26
1683715219144,ECON 110A,A01,185612,Staff,8,0,40,32
1683715220172,ECON 120A,A01,185615,Staff,19,0,40,21
1683715221198,ECON 120C,A01,185617,Sun; Yixiao,0,21,70,70
1683715222230,ECON 144,A00,203346,Squires; Dale E,2,0,35,33
1683715223261,ECON 171,A01,203349,Newhouse; Herbert S,0,1,35,35
1683715224290,ECON 173A,A01,185621,Toda; Alexis Akira,21,0,35,14
1683715225327,EDS 25,A01,202413,Staff,0,1,0,0
1683715225327,EDS 25,A02,202414,Staff,0,1,0,0
1683715225327,EDS 25,A03,202415,Staff,0,0,0,0
1683715225327,EDS 25,A04,202416,Staff,0,1,0,0
1683715225327,EDS 25,A05,202439,Staff,0,0,0,0
1683715225327,EDS 25,A06,202440,Staff,0,0,0,0
1683715225327,EDS 25,B01,202631,Staff,0,0,0,0
1683715225327,EDS 25,B02,202632,Staff,0,0,0,0
1683715225327,EDS 25,B03,202639,Staff,0,0,0,0
1683715225327,EDS 25,B04,202640,Staff,0,0,0,0
1683715225327,EDS 25,B05,202643,Staff,0,0,0,0
1683715225327,EDS 25,B06,202644,Staff,0,0,0,0
1683715226353,EDS 38,A01,202659,Black; Alison Michelle,25,0,25,0
1683715227378,EDS 115,A00,202652,Staff,18,0,30,12
1683715228402,EDS 125,A00,202649,Staff,13,0,30,17
1683715229430,EDS 126,A01,203332,Staff,30,0,30,0
1683715230457,EDS 139,A00,202838,Staff,16,0,25,9
1683715231482,EDS 146,A01,202655,Staff,14,0,25,11
1683715232506,ENG 15,A00,185667,Staff,0,1,0,0
1683715232506,ENG 15,B00,185672,Staff,0,0,0,0
1683715232506,ENG 15,C00,185675,Staff,0,0,0,0
1683715232506,ENG 15,D00,185682,Staff,0,0,0,0
1683715232506,ENG 15,E00,185684,Staff,0,0,0,0
1683715233533,ETHN 103,A00,185710,Staff,0,8,35,35
1683715234558,ETHN 103A,A00,199228,Man; Simeon S,0,0,9,9
1683715235581,ETHN 109,A00,185711,Staff,15,0,35,20
1683715236609,ETHN 142,A00,185726,Staff,0,4,30,30
1683715237687,ETHN 163J,A00,199229,Man; Simeon S,5,0,8,3
1683715238711,ETHN 168,A00,185727,Staff,7,0,10,3
1683715239736,ETHN 182,A00,185728,Staff,0,0,35,35
1683715240762,ETHN 183,A00,185737,Staff,10,0,18,8
1683715241788,GLBH 111,A01,209361,Burgos; Jose L.,0,0,0,0
1683715243839,HIEU 104,A00,185792,Staff,14,0,20,6
1683715244867,HIEU 115,A00,185800,Staff,0,0,20,20
1683715245892,HIEU 128,A00,185801,Staff,0,9,20,20
1683715246919,HIEU 147,A00,185802,Staff,15,0,20,5
1683715247947,HIEU 154,A00,185823,Staff,11,0,20,9
1683715248975,HILA 102,A00,185826,Staff,14,0,20,6
1683715249997,HILD 2C,A01,185778,Staff,0,13,20,20
1683715251022,HILD 7B,A01,185780,Kwak; Nancy,0,17,32,32
1683715251022,HILD 7B,A02,185781,Kwak; Nancy,0,18,32,32
1683715252048,HILD 30,A01,185791,Staff,12,0,20,8
1683715253076,HISC 119,A00,185830,Golan; Tal,0,10,20,20
1683715254104,HITO 156GS,A00,185831,Patterson; Patrick H.,0,0,0,23
1683715255132,HIUS 103,A00,185832,Man; Simeon S,0,4,20,20
1683715256157,HIUS 117,A00,185836,Kwak; Nancy,2,0,20,18
1683715257182,HIUS 125,A00,185840,Man; Simeon S,0,2,23,23
1683715258205,HIUS 149,A00,185845,Staff,1,0,20,19
1683715259232,HUM 3,A01,185882,Zavodny; Tatiana Sophia,0,8,50,50
1683715259232,HUM 3,B01,185899,Caldwell; Michael Alan,0,18,50,50
1683715260268,HUM 3GS,A00,185900,Patterson; Patrick H.,0,0,0,23
1683715261323,HUM 4,A01,185938,Zroka; Amy Liane,28,0,50,22
1683715261323,HUM 4,B01,185956,Watkins; Eric,0,6,50,50
1683715261323,HUM 4,B02,202209,Watkins; Eric,0,6,50,50
1683715261323,HUM 4,B03,202210,Watkins; Eric,0,5,50,50
1683715262352,HUM 5,A01,185958,West; Geoffrey Scott,0,0,50,50
1683715262352,HUM 5,A02,202215,West; Geoffrey Scott,0,1,50,50
1683715263381,INTL 190,A00,185959,Gagnon; Jeffrey C,0,0,0,9
1683715263381,INTL 190,B00,185960,Lettieri; Michael Joseph,0,0,0,2
1683715264408,JAPN 180,A00,254509,Staff,5,0,30,25
1683715265433,LATI 10,A01,202853,Kennemore; Amy Michelle,4,0,35,31
1683715265433,LATI 10,A02,202854,Kennemore; Amy Michelle,3,0,35,32
1683715265433,LATI 10,A03,270054,Kennemore; Amy Michelle,30,0,30,0
1683715266460,LATI 180,A00,202855,Kennemore; Amy Michelle,11,0,20,9
1683715267485,LAWS 101,A00,201767,Golan; Tal,0,7,40,40
1683715268508,LIFR 1C,A00,185961,Staff,6,0,20,14
1683715269533,LIFR 1CX,A00,185962,Staff,7,0,20,13
1683715270560,LIFR 1D,A00,185963,Staff,7,0,20,13
1683715271585,LIFR 1DX,A00,185964,Staff,7,0,20,13
1683715272610,LIGN 101,A01,186039,Staff,43,0,50,7
1683715273635,LIGN 165,A00,186040,Staff,14,0,50,36
1683715274664,LTCS 108,A00,186041,Staff,5,0,10,5
1683715275692,LTCS 119,A00,186042,Staff,15,0,20,5
1683715276723,LTCS 130,A00,186043,Wesling; Megan E.,15,0,25,10
1683715278778,LTEA 138,A00,186119,Staff,14,0,40,26
1683715279805,LTEN 124,A00,186148,Staff,5,0,25,20
1683715280837,LTEN 178,A00,186149,Staff,6,0,15,9
1683715281860,LTEN 181,A00,186150,Blanco; John D,34,0,40,6
1683715282886,LTWL 120,A00,186160,Staff,19,0,25,6
1683715283915,LTWL 165,A00,186161,Staff,22,0,25,3
1683715284938,LTWR 100,A00,186162,Staff,0,5,15,15
1683715285968,LTWR 102,A00,186163,Doller; Ben,5,0,15,10
1683715286992,MAE 8,A01,186412,Staff,0,1,0,0
1683715288015,MAE 30B,A00,186445,Bahadori; Mohammad Yousef,81,0,100,19
1683715289043,MAE 40,A00,186592,Bewley; Thomas R,10,0,50,40
1683715290071,MAE 101B,A00,186593,Bahadori; Mohammad Yousef,80,0,100,20
1683715291101,MAE 105,A00,186594,Bandaru; Prabhakar,10,0,50,40
1683715292129,MAE 107,A00,186599,Pham; Hieu Tan,0,8,120,120
1683715293159,MAE 148,A01,186660,Silberman; Jack,3,0,16,13
1683715294189,MATH 10A,A01,188095,Staff,0,6,35,35
1683715295216,MATH 10B,A01,188097,Bowers; Adam R.,0,12,30,30
1683715295216,MATH 10B,A02,188099,Bowers; Adam R.,0,11,30,30
1683715295216,MATH 10B,B01,188104,Bowers; Adam R.,0,10,30,30
1683715295216,MATH 10B,B02,188106,Bowers; Adam R.,0,9,30,30
1683715296245,MATH 10C,A01,188111,Staff,0,20,30,30
1683715296245,MATH 10C,A02,188127,Staff,0,19,30,30
1683715296245,MATH 10C,A03,188131,Staff,0,19,30,30
1683715296245,MATH 10C,B01,188218,Staff,17,0,30,13
1683715296245,MATH 10C,B02,188244,Staff,13,0,30,17
1683715296245,MATH 10C,B03,188277,Staff,14,0,30,16
1683715297275,MATH 18,A01,188344,Bach; Quang Tran,18,0,30,12
1683715297275,MATH 18,A02,188345,Bach; Quang Tran,11,0,30,19
1683715297275,MATH 18,B01,188353,Bach; Quang Tran,11,0,30,19
1683715297275,MATH 18,B02,188354,Bach; Quang Tran,19,0,30,11
1683715298299,MATH 20A,A01,188374,Staff,11,0,35,24
1683715299325,MATH 20B,A01,188382,Ohm; Ko Woon,7,0,30,23
1683715299325,MATH 20B,A02,188383,Ohm; Ko Woon,22,0,30,8
1683715299325,MATH 20B,B01,188385,Ohm; Ko Woon,7,0,30,23
1683715299325,MATH 20B,B02,188392,Ohm; Ko Woon,22,0,30,8
1683715300356,MATH 20C,A01,188394,Harel; Guershon,10,0,30,20
1683715300356,MATH 20C,A02,188395,Harel; Guershon,13,0,30,17
1683715300356,MATH 20C,B01,188404,Harel; Guershon,5,0,30,25
1683715300356,MATH 20C,B02,188405,Harel; Guershon,18,0,30,12
1683715301390,MATH 20D,A01,188414,Hammock; Frances H,0,1,30,30
1683715301390,MATH 20D,A02,188415,Hammock; Frances H,0,1,30,30
1683715301390,MATH 20D,B01,188447,Hammock; Frances H,0,1,30,30
1683715301390,MATH 20D,B02,188486,Hammock; Frances H,2,0,30,28
1683715302417,MATH 20E,A01,188649,Staff,21,0,30,9
1683715302417,MATH 20E,A02,188650,Staff,20,0,30,10
1683715302417,MATH 20E,A03,188673,Staff,0,0,30,30
1683715303442,MATH 102,A01,188675,Staff,0,40,35,35
1683715304468,MATH 103B,A01,188681,Staff,3,0,35,32
1683715304468,MATH 103B,B01,188692,Staff,5,0,35,30
1683715305500,MATH 109,A01,188695,Salehi Golsefidy; Alireza,24,0,35,11
1683715305500,MATH 109,A02,188696,Salehi Golsefidy; Alireza,24,0,35,11
1683715306526,MATH 120A,A01,188698,Eggers; John Dietrich,7,0,35,28
1683715307559,MATH 142B,A01,188736,Ioana; Adrian,0,0,30,30
1683715307559,MATH 142B,A02,188741,Ioana; Adrian,0,1,30,30
1683715307559,MATH 142B,A03,188743,Ioana; Adrian,0,2,30,30
1683715308584,MATH 168A,A01,188790,Staff,0,11,35,35
1683715309616,MATH 170A,A01,188803,Nie; Jiawang,0,2,35,35
1683715309616,MATH 170A,A02,188811,Nie; Jiawang,0,1,35,35
1683715309616,MATH 170A,A03,188814,Nie; Jiawang,1,0,35,34
1683715309616,MATH 170A,A04,188815,Nie; Jiawang,5,0,35,30
1683715310639,MATH 193B,A01,188817,Staff,0,0,35,35
1683715310639,MATH 193B,A02,188818,Staff,6,0,35,29
1683715311664,MGT 4,A01,202857,Anderson; John Charles,59,0,80,21
1683715312694,MGT 12,A00,202858,Lindenberger; Wade Douglas,40,0,90,50
1683715313729,MGT 18,A00,202859,Staff,73,0,90,17
1683715314755,MGT 18GS,A00,202860,McKay; Michael J,13,0,28,15
1683715315786,MGT 45,A00,202861,Pecore; Joseph P.,8,0,90,82
1683715316816,MGT 100,A00,202863,Yavorsky; Daniel Ryan,27,0,90,63
1683715317841,MGT 103,A00,202864,Ehrich; Kristine R,0,19,90,90
1683715318870,MGT 112,A00,202865,Ehrich; Kristine R,15,0,90,75
1683715319900,MGT 121A,A00,202868,Staff,70,0,90,20
1683715320929,MGT 131B,A00,202869,Anderson; John Charles,58,0,90,32
1683715321956,MGT 136,A00,202871,Lindenberger; Wade Douglas,83,0,90,7
1683715322983,MGT 164,A00,202873,Staff,0,67,90,91
1683715324008,MGT 164GS,A00,202874,McKay; Mary A,13,0,28,15
1683715325032,MGT 180,A00,202875,Staff,0,51,90,91
1683715326058,MMW 11R,A01,205019,Herbst; Matthew,0,0,30,30
1683715326058,MMW 11R,A02,205026,Herbst; Matthew,29,0,30,1
1683715327084,MMW 15,A01,193512,Chang; Edmond Yi-Teh,0,8,28,28
1683715327084,MMW 15,A02,193513,Chang; Edmond Yi-Teh,0,5,28,28
1683715327084,MMW 15,A03,193514,Chang; Edmond Yi-Teh,0,5,28,28
1683715327084,MMW 15,A04,193515,Chang; Edmond Yi-Teh,0,5,28,28
1683715327084,MMW 15,A05,193516,Chang; Edmond Yi-Teh,0,5,28,28
1683715327084,MMW 15,A06,193517,Chang; Edmond Yi-Teh,0,6,28,28
1683715327084,MMW 15,B01,193519,Chang; Edmond Yi-Teh,0,5,28,28
1683715327084,MMW 15,B02,193520,Chang; Edmond Yi-Teh,0,5,28,28
1683715327084,MMW 15,B03,193521,Chang; Edmond Yi-Teh,0,5,28,28
1683715327084,MMW 15,B04,193522,Chang; Edmond Yi-Teh,0,6,28,28
1683715327084,MMW 15,B05,193523,Chang; Edmond Yi-Teh,0,5,28,28
1683715327084,MMW 15,B06,193524,Chang; Edmond Yi-Teh,0,5,28,28
1683715328108,MMW 122,A01,193526,Rahimi; Babak,0,16,28,28
1683715328108,MMW 122,A02,193527,Rahimi; Babak,0,15,28,28
1683715328108,MMW 122,A03,193528,Rahimi; Babak,0,0,0,0
1683715328108,MMW 122,A04,193529,Rahimi; Babak,0,0,0,0
1683715329135,MUS 1A,A01,186663,Staff,0,18,35,35
1683715330161,MUS 4,A01,186715,Staff,0,12,35,35
1683715331192,MUS 5R,A01,186796,Dubnov; Shlomo,0,17,35,35
1683715332215,MUS 6,A01,186798,Staff,0,4,25,25
1683715333239,MUS 7,A01,186830,Staff,11,0,35,24
1683715334265,MUS 8,A01,186930,Staff,0,27,35,35
1683715335289,MUS 15,A01,186932,Staff,0,15,35,35
1683715335289,MUS 15,B01,186934,Staff,0,16,35,35
1683715336313,MUS 80,A00,186935,Staff,0,0,20,20
1683715336313,MUS 80,B00,186936,Staff,24,0,25,1
1683715337344,NANO 11,A00,204702,Lipomi; Darren John,0,0,0,0
1683715338374,NANO 15,A01,204709,Yang; Kesong,0,1,0,0
1683715339399,NANO 114,A00,202069,Jahed Motlagh; Zeinab,2,0,10,8
1683715340427,PHIL 1,A00,186955,Grush; Rick Scott,31,0,40,9
1683715341516,PHIL 10,A01,186973,Grush; Rick Scott,27,0,35,8
1683715341516,PHIL 10,A02,186974,Grush; Rick Scott,33,0,35,2
1683715342543,PHIL 13,A01,186976,Staff,1,0,35,34
1683715342543,PHIL 13,A02,186977,Staff,16,0,35,19
1683715343572,PHIL 14,A01,186979,Staff,30,0,35,5
1683715343572,PHIL 14,A02,186986,Staff,32,0,35,3
1683715344603,PHIL 28,A01,186988,Staff,16,0,30,14
1683715344603,PHIL 28,A02,186989,Staff,0,0,30,30
1683715344603,PHIL 28,A03,186990,Staff,10,0,30,20
1683715344603,PHIL 28,A04,186991,Staff,26,0,30,4
1683715345629,PHIL 120,A00,186997,Staff,23,0,40,17
1683715346654,PHIL 137,A00,187003,Staff,8,0,40,32
1683715347681,PHIL 150,A00,187015,Staff,47,0,70,23
1683715348716,PHIL 167,A00,187021,Lamey; Andy M.,34,0,40,6
1683715349743,PHIL 174,A01,202226,Staff,17,0,20,3
1683715349743,PHIL 174,A02,202235,Staff,20,0,20,0
1683715350768,PHIL 191A,A00,258918,Staff,0,0,1,1
1683715351793,PHYS 1A,A00,187028,Staff,26,0,60,34
1683715352818,PHYS 1AL,001,187036,Staff,3,0,30,27
1683715352818,PHYS 1AL,002,187049,Staff,18,0,30,12
1683715353845,PHYS 1B,A00,187058,Staff,21,0,60,39
1683715354869,PHYS 1BL,001,187064,Staff,0,1,30,30
1683715354869,PHYS 1BL,002,187070,Staff,4,0,30,26
1683715355895,PHYS 1C,A00,187082,Staff,30,0,120,90
1683715356921,PHYS 1CL,001,187088,Staff,0,9,30,30
1683715356921,PHYS 1CL,002,187089,Staff,0,1,30,30
1683715356921,PHYS 1CL,009,262693,Staff,9,0,30,21
1683715357951,PHYS 2B,A01,187097,Staff,55,0,115,60
1683715358976,PHYS 2C,A01,187099,Staff,63,0,115,52
1683715360003,PHYS 2CL,A01,187101,Staff,5,0,28,23
1683715360003,PHYS 2CL,A02,187102,Staff,15,0,28,13
1683715361032,PHYS 2D,A01,187123,Shotwell; Brian,95,0,115,20
1683715362064,PHYS 4B,A01,187133,Grinstein; Benjamin,35,0,50,15
1683715363096,POLI 10,A00,188819,Staff,0,4,50,50
1683715364121,POLI 11,A00,188827,Staff,43,0,50,7
1683715365146,POLI 13R,A00,188828,Staff,0,2,20,20
1683715366177,POLI 27,A01,188830,Elgin; Samuel Zincke,0,2,70,70
1683715367208,POLI 30,A00,188832,Desposato; Scott,30,0,50,20
1683715368234,POLI 102F,A00,188834,Staff,1,0,40,39
1683715369261,POLI 104A,A00,188852,Staff,12,0,30,18
1683715370289,POLI 104I,A00,188853,Staff,0,8,20,20
1683715371314,POLI 110B,A00,188854,Wiens; David,6,0,20,14
1683715372339,POLI 112A,A00,188855,Wiens; David,3,0,30,27
1683715373365,POLI 117R,A00,188856,Forman; Fonna,0,12,20,20
1683715374395,POLI 118,A00,188857,Ingham; Sean,8,0,20,12
1683715375417,POLI 120G,A00,188858,Staff,7,0,30,23
1683715376444,POLI 131CR,A00,188863,Hoston; Germaine,20,0,50,30
1683715377469,POLI 133,A00,188864,Nellis; Gareth Hb,44,0,50,6
1683715378499,POLI 134D,A00,188865,Desposato; Scott,27,0,30,3
1683715379524,POLI 142A,A00,188871,Gartzke; Erik,21,0,50,29
1683715380547,POLI 142K,A00,188874,Staff,38,0,50,12
1683715381573,POLI 143,A00,188940,Gartzke; Erik,15,0,30,15
1683715382603,POLI 153,A00,188943,Staff,1,0,20,19
1683715383629,POLI 160AA,A00,188944,Staff,10,0,40,30
1683715384659,POLI 170A,A00,188945,Staff,10,0,30,20
1683715386712,PSYC 1,A00,188952,Staff,36,0,90,54
1683715387738,PSYC 2,B00,188953,Staff,19,0,35,16
1683715388762,PSYC 6,A00,188970,Staff,47,0,60,13
1683715389787,PSYC 7,A00,188973,Staff,35,0,45,10
1683715390824,PSYC 60,A01,188980,Rickard; Timothy C.,42,0,60,18
1683715391856,PSYC 70,A01,189001,Steiner; Eric Tomas,22,0,45,23
1683715392881,PSYC 100,A00,189005,Lacefield; Katharine I,1,98,120,119
1683715393907,PSYC 102,A00,189008,Staff,6,0,30,24
1683715394937,PSYC 106,B00,189026,Gorman; Michael R.,27,0,60,33
1683715395962,PSYC 114,B01,189033,Winkielman; Piotr,0,31,30,30
1683715396994,PSYC 131,A00,189036,Anagnostaras; Stephan,0,44,60,60
1683715398022,PSYC 136,A00,189041,Lowe; Angela Beth,0,7,25,25
1683715399050,PSYC 137,A00,189057,Winkielman; Piotr,0,36,25,25
1683715400076,PSYC 144,A00,189107,Wixted; John T,0,11,50,50
1683715402126,PSYC 162,A00,189142,Staff,0,9,85,85
1683715403154,PSYC 172,A00,189144,Gorman; Michael R.,0,6,30,30
1683715405204,PSYC 179,A00,189146,Lacefield; Katharine I,0,88,120,120
1683715406233,PSYC 181,A00,189147,Anagnostaras; Stephan,0,45,90,90
1683715407261,PSYC 190R,A00,189148,Barner; David A.,0,23,80,80
1683715408285,PSYC 191,A00,189275,Rickard; Timothy C.,0,11,25,25
1683715409312,PSYC 193,A00,189276,Chapman; Eddie Nathaniel,0,1,0,4
1683715410338,PSYC 193L,A01,189281,Lowe; Angela Beth,8,0,20,12
1683715410338,PSYC 193L,B01,189285,Staff,28,0,35,7
1683715411369,RELI 149,A00,187137,Rahimi; Babak,6,0,40,34
1683715412396,SE 9,A01,187315,Staff,0,2,18,18
1683715413421,SE 101B,A00,187409,Staff,24,0,30,6
1683715414449,SE 110B,A00,187444,Staff,10,0,40,30
1683715415475,SE 130B,A00,187449,Staff,31,0,40,9
1683715416499,SE 150A,A00,187516,Staff,8,0,20,12
1683715417524,SE 154,A00,187528,Staff,29,0,50,21
1683715418549,SIO 3,A01,258171,Staff,35,0,40,5
1683715419579,SIO 10,A00,187144,Cook; Geoffrey W,0,6,75,75
1683715420608,SIO 45,A00,187152,Cook; Geoffrey W,1,7,100,99
1683715421636,SIO 109R,A00,194486,Staff,0,4,20,20
1683715423687,SIO 187,A01,187233,Kacev; David,12,0,40,28
1683715424713,SOCI 1,A01,258656,Thorpe; Charles Robert,28,0,30,2
1683715424713,SOCI 1,A02,258658,Thorpe; Charles Robert,30,0,30,0
1683715424713,SOCI 1,A03,258661,Thorpe; Charles Robert,25,0,25,0
1683715424713,SOCI 1,A04,258666,Thorpe; Charles Robert,22,0,25,3
1683715424713,SOCI 1,A05,258897,Thorpe; Charles Robert,22,0,25,3
1683715424713,SOCI 1,A06,258898,Thorpe; Charles Robert,25,0,25,0
1683715425739,SOCI 30,A01,258903,Pardo Guerra; Juan Pablo,14,0,30,16
1683715426764,SOCI 102,A00,258904,Staff,9,0,25,16
1683715427788,SOCI 106,A00,258905,Staff,19,0,25,6
1683715428812,SOCI 111,A00,258907,Ribas Norris; Janet Vanesa,26,0,30,4
1683715429839,SOCI 121R,A00,258908,Pardo Guerra; Juan Pablo,7,0,30,23
1683715430869,SOCI 126,A01,203330,Staff,14,0,20,6
1683715431897,SOCI 131,A00,258909,Thorpe; Charles Robert,30,0,60,30
1683715432922,SOCI 135,A00,258910,Payne; Christine Anna,0,13,30,30
1683715433948,SOCI 157,A00,258911,Staff,10,0,30,20
1683715434975,SOCI 184,A00,258912,Staff,25,0,30,5
1683715436000,SOCI 188D,A00,258913,Staff,22,0,30,8
1683715437029,SYN 2,001,187529,Staff,9,0,16,7
1683715437029,SYN 2,002,201452,Staff,0,20,16,16
1683715437029,SYN 2,003,201469,Staff,1,0,16,15
1683715438057,SYN 100,A01,187531,Staff,0,9,20,20
1683715438057,SYN 100,B01,201491,Staff,0,10,20,20
1683715439088,TDAC 1,A00,189286,Walsh; Kim C.,3,0,20,17
1683715439088,TDAC 1,B00,189287,Harting; Carla Kelso,10,0,20,10
1683715440114,TDAC 101,A00,189300,Walsh; Kim C.,16,0,20,4
1683715440114,TDAC 101,B00,189301,Harting; Carla Kelso,18,0,20,2
1683715441139,TDAC 102,A00,189304,Basso; Beatrice,14,0,20,6
1683715442173,TDAC 108,A00,189305,Staff,18,0,20,2
1683715443199,TDDE 131,A00,189310,Staff,19,0,20,1
1683715443199,TDDE 131,B00,189314,Staff,19,0,20,1
1683715443199,TDDE 131,C00,189315,Staff,48,0,50,2
1683715443199,TDDE 131,D00,189316,Staff,14,0,15,1
1683715443199,TDDE 131,E00,204841,Staff,20,0,20,0
1683715444228,TDGE 10,A00,189289,Staff,27,0,50,23
1683715444228,TDGE 10,B00,189290,Havis; Allan,0,1,50,50
1683715445309,TDGE 11,A00,189291,Fulton; Julia,0,4,50,50
1683715445309,TDGE 11,B00,189292,Staff,20,0,25,5
1683715445309,TDGE 11,C00,260270,Staff,0,0,0,0
1683715446334,TDGE 25,A00,189294,Staff,1,0,20,19
1683715447359,TDGE 124,A00,189318,Fulton; Julia,0,7,50,50
1683715448387,TDGE 125,A00,189319,Staff,13,0,25,12
1683715448387,TDGE 125,B00,189320,Staff,23,0,25,2
1683715449416,TDGE 127,A00,189322,Havis; Allan,1,0,50,49
1683715450445,TDHT 101,A00,189323,Staff,18,0,25,7
1683715450445,TDHT 101,B00,189324,Staff,25,0,25,0
1683715451470,TDHT 102,A00,189325,Staff,49,0,50,1
1683715452494,TDMV 1,A00,189295,Arcidiacono; Kristin,20,0,30,10
1683715452494,TDMV 1,B00,189296,Caligagan; Maria T.,23,0,30,7
1683715453518,TDMV 2,A00,189297,Sammartano; Tonnie,27,0,30,3
1683715453518,TDMV 2,B00,189299,Arcidiacono; Kristin,23,0,30,7
1683715454550,TDMV 3,A00,204998,Rincon; Alicia,22,0,30,8
1683715455574,TDMV 120,A00,189458,Sammartano; Tonnie,28,0,30,2
1683715456599,TDMV 138,A00,189541,Jun; Grace Shin Hae,20,0,40,20
1683715457628,TDMV 142,A00,189717,Caligagan; Tony,25,0,30,5
1683715457628,TDMV 142,B00,189718,Caligagan; Maria T.,25,0,30,5
1683715458660,TMC 2,A01,187533,Staff,25,0,25,0
1683715458660,TMC 2,A02,187534,Staff,25,0,25,0
1683715459694,USP 1,A01,187536,Kwak; Nancy,0,16,25,25
1683715460724,USP 5,A01,187538,Staff,8,0,25,17
1683715461748,USP 101,A00,199253,Staff,0,4,0,0
1683715462775,USP 124,A00,187562,Boomhower; Matthew Charles,0,0,30,30
1683715463804,USP 138,A00,187582,Staff,19,0,25,6
1683715464829,USP 152,A01,187597,Staff,3,0,25,22
1683715465854,USP 153,A00,187598,Staff,18,0,25,7
1683715466880,USP 168,A00,187607,Kwak; Nancy,2,0,5,3
1683715467904,USP 173,A00,187619,Staff,4,0,25,21
1683715468933,USP 181,A00,187638,Staff,0,4,25,25
1683715469961,VIS 103,A00,187650,Cruz; Edwin Teddy,17,0,75,58
1683715470986,VIS 110D,A00,187669,Staff,13,0,22,9
1683715472012,VIS 127C,A00,187720,Shen; Kuiyi,67,0,146,79
1683715473043,VIS 149,A00,187731,Yoldas; Pinar,0,12,22,22
1683715474067,VIS 151,A01,188091,Staff,22,0,34,12
1683715474067,VIS 151,A02,188092,Staff,11,0,34,23
1683715475092,VIS 160B,A00,188093,Stalbaum; Brett,0,1,10,10
1683715477141,WCWP 10B,A00,201720,Staff,0,0,5,5
1683715477141,WCWP 10B,B00,201722,Staff,0,0,6,6
1683715478172,WCWP 100,A00,201725,Gagnon; Jeffrey C,0,0,2,2
1683715478172,WCWP 100,B00,201727,Staff,0,4,15,15
1683715481407,ANBI 133,A00,258401,Wilder; Linnea Lorene,34,0,40,6
1683715482433,ANBI 140,A00,258395,Hrvoj Mihic; Branka,18,0,25,7
1683715483463,ANSC 120,A00,258402,Bialecki; Jon Anthony,26,0,40,14
1683715484491,ANSC 144,A00,258400,Staff,12,0,40,28
1683715486541,ANSC 166,A00,258396,Parish; Steven Martin,156,0,175,19
1683715487565,ANSC 180,A00,193533,Staff,8,0,20,12
1683715488592,ANSC 188,A00,258397,Jassal; Aftab,34,0,40,6
1683715489616,ANTH 3,A01,258316,Staff,23,0,30,7
1683715490642,ANTH 5,A00,258394,Semendeferi; Ekaterini,16,0,20,4
1683715491666,ANTH 21,A01,258331,Staff,4,0,40,36
1683715492692,ANTH 103,A00,258398,Varma; Saiba,15,0,25,10
1683715493723,AWP 10,001,202034,Staff,0,0,0,0
1683715493723,AWP 10,002,202035,Staff,0,0,0,0
1683715493723,AWP 10,003,202036,Staff,0,0,0,0
1683715493723,AWP 10,004,202037,Staff,0,0,0,0
1683715493723,AWP 10,005,202038,Staff,0,0,0,0
1683715493723,AWP 10,006,202039,Staff,0,0,0,0
1683715493723,AWP 10,007,202040,Staff,0,0,0,0
1683715493723,AWP 10,008,202041,Staff,0,0,0,0
1683715493723,AWP 10,009,202042,Staff,0,0,0,0
1683715493723,AWP 10,010,202043,Staff,0,0,0,0
1683715493723,AWP 10,011,202044,Staff,0,0,0,0
1683715493723,AWP 10,012,202045,Staff,0,0,0,0
1683715493723,AWP 10,013,202046,Staff,0,0,0,0
1683715493723,AWP 10,014,202047,Staff,0,0,0,0
1683715493723,AWP 10,015,202048,Staff,0,0,0,0
1683715493723,AWP 10,016,202049,Staff,0,0,0,0
1683715493723,AWP 10,017,202050,Staff,0,0,0,0
1683715493723,AWP 10,018,202051,Staff,0,0,0,0
1683715493723,AWP 10,019,202052,Staff,0,0,0,0
1683715493723,AWP 10,020,202053,Staff,0,0,0,0
1683715493723,AWP 10,021,202054,Staff,0,0,0,0
1683715493723,AWP 10,022,202055,Staff,0,0,0,0
1683715493723,AWP 10,023,202056,Staff,0,0,0,0
1683715493723,AWP 10,024,202057,Staff,0,0,0,0
1683715493723,AWP 10,025,202058,Staff,0,0,0,0
1683715493723,AWP 10,026,202059,Staff,0,0,0,0
1683715494749,AWP 102,001,202032,Staff,0,0,0,0
1683715494749,AWP 102,002,202033,Staff,0,0,0,0
1683715495774,BENG 100,A01,254234,Taylor Amos; Alyssa C,31,0,40,9
1683715496798,BENG 196,001,270013,Engler; Adam J.,9999,0,9999,0
1683715497826,BICD 100R,A01,202018,Smith; Laurie,0,7,32,32
1683715497826,BICD 100R,A02,202019,Smith; Laurie,0,3,32,32
1683715497826,BICD 100R,A03,202020,Smith; Laurie,0,1,32,32
1683715497826,BICD 100R,A04,202021,Smith; Laurie,6,0,32,26
1683715497826,BICD 100R,A05,202022,Smith; Laurie,10,0,32,22
1683715498860,BICD 136,A01,193242,Gustafson-Brown; Cindy,0,2,32,32
1683715498860,BICD 136,A02,193244,Gustafson-Brown; Cindy,13,0,32,19
1683715499894,BIEB 102,A01,193249,Butler; Shannon Rhey,0,0,32,32
1683715499894,BIEB 102,A02,193251,Butler; Shannon Rhey,0,0,32,32
1683715499894,BIEB 102,A03,193253,Butler; Shannon Rhey,0,0,32,32
1683715499894,BIEB 102,A04,193255,Butler; Shannon Rhey,13,0,32,19
1683715499894,BIEB 102,A05,193265,Butler; Shannon Rhey,25,0,32,7
1683715499894,BIEB 102,A06,193269,Butler; Shannon Rhey,12,0,32,20
1683715501950,BIEB 150,A01,193274,Staff,0,0,32,32
1683715501950,BIEB 150,A02,193285,Staff,24,0,32,8
1683715502983,BIEB 194,A00,193286,Kurle; Carolyn M.,19,0,32,13
1683715504011,BILD 1,A01,192291,Staff,15,0,32,17
1683715504011,BILD 1,A02,192292,Staff,30,0,32,2
1683715504011,BILD 1,B01,192520,Reuther; Keefe,0,1,0,0
1683715504011,BILD 1,B02,192532,Reuther; Keefe,0,1,0,0
1683715505044,BILD 3,A01,192556,Butler; Shannon Rhey,0,0,32,32
1683715505044,BILD 3,A02,192581,Butler; Shannon Rhey,0,1,32,32
1683715505044,BILD 3,A03,192611,Butler; Shannon Rhey,19,0,32,13
1683715505044,BILD 3,A04,192612,Butler; Shannon Rhey,23,0,32,9
1683715505044,BILD 3,A05,192613,Butler; Shannon Rhey,26,0,32,6
1683715505044,BILD 3,A06,192679,Butler; Shannon Rhey,27,0,32,5
1683715505044,BILD 3,A07,192682,Butler; Shannon Rhey,20,0,32,12
1683715506070,BILD 4,A01,192836,Reuther; Keefe,1,0,24,23
1683715506070,BILD 4,A02,193044,Reuther; Keefe,4,0,24,20
1683715507098,BILD 10,A01,193142,Gustafson-Brown; Cindy,29,0,32,3
1683715507098,BILD 10,A02,193149,Gustafson-Brown; Cindy,31,0,32,1
1683715508123,BIMM 100,A01,193301,Staff,0,6,32,32
1683715508123,BIMM 100,A02,193312,Staff,0,7,32,32
1683715508123,BIMM 100,A03,193323,Staff,0,10,32,32
1683715509150,BIMM 101,A01,193329,McDonnell; Lisa Marie,0,3,24,24
1683715509150,BIMM 101,A02,193339,McDonnell; Lisa Marie,0,3,24,24
1683715509150,BIMM 101,B01,193354,McDonnell; Lisa Marie,0,4,24,24
1683715509150,BIMM 101,B02,193357,McDonnell; Lisa Marie,0,3,24,24
1683715510179,BIMM 110,A01,193377,Tat; John,0,11,32,32
1683715510179,BIMM 110,A02,193378,Tat; John,0,11,32,32
1683715511206,BIMM 120,A01,206116,Staff,0,0,32,32
1683715511206,BIMM 120,A02,206117,Staff,7,0,32,25
1683715511206,BIMM 120,A03,206121,Staff,21,0,32,11
1683715512238,BIPN 100,A01,193393,Park; Ji Young,0,15,32,32
1683715512238,BIPN 100,A02,193402,Park; Ji Young,0,14,32,32
1683715512238,BIPN 100,A03,193413,Park; Ji Young,0,14,32,32
1683715512238,BIPN 100,A04,193414,Park; Ji Young,0,13,32,32
1683715513263,BIPN 102,A01,193429,Staff,0,0,32,32
1683715513263,BIPN 102,A02,193438,Staff,18,0,32,14
1683715514288,BIPN 106,A01,193450,Reyes Gonzalez; Catalina,0,2,40,40
1683715515319,BIPN 134,A01,193465,Cooke; James Edward,0,0,32,32
1683715515319,BIPN 134,A02,193474,Cooke; James Edward,25,0,32,7
1683715515319,BIPN 134,A03,193485,Cooke; James Edward,29,0,32,3
1683715515319,BIPN 134,A04,193486,Cooke; James Edward,20,0,32,12
1683715515319,BIPN 134,A05,193491,Cooke; James Edward,31,0,32,1
1683715515319,BIPN 134,A06,193501,Cooke; James Edward,30,0,32,2
1683715515319,BIPN 134,A07,193510,Cooke; James Edward,29,0,32,3
1683715517374,BISP 194,A00,222522,Staff,14,0,32,18
1683715518399,CAT 124,A01,202407,Staff,19,0,25,6
1683715519426,CAT 125,A00,202408,Marchisotto; Jennifer Anne,2,0,20,18
1683715520455,CAT 125R,A00,202409,Smith; Lauryn Alissa,0,11,20,20
1683715520455,CAT 125R,B00,202410,Morales; Celeste Georgianna,0,11,20,20
1683715520455,CAT 125R,C00,202411,Irwin; Matthew Joseph,0,12,20,20
1683715521480,CENG 15,A01,204712,Yang; Kesong,0,1,0,0
1683715522505,CENG 114,A00,202070,Jahed Motlagh; Zeinab,5,0,20,15
1683715523530,CGS 105,A00,185477,Wesling; Megan E.,24,0,40,16
1683715524558,CGS 106,A00,185494,Staff,11,0,22,11
1683715525586,CGS 108,A00,185495,Staff,14,0,20,6
1683715526609,CGS 114,A00,185496,Staff,13,0,18,5
1683715527634,CGS 119,A00,185501,Staff,15,0,20,5
1683715528661,CGS 120,A00,185511,Staff,11,0,20,9
1683715529694,CHEM 4,A01,184675,Bussey; Thomas J,97,0,100,3
1683715530719,CHEM 6A,A01,184677,Staff,32,0,60,28
1683715531744,CHEM 6B,A01,184679,Staff,63,0,100,37
1683715532770,CHEM 6C,A01,184681,Bussey; Thomas J,0,0,50,50
1683715532770,CHEM 6C,A02,184682,Bussey; Thomas J,32,0,50,18
1683715533800,CHEM 40A,A01,184684,Albizati; Kim F.,33,0,100,67
1683715534828,CHEM 40B,A01,184686,Albizati; Kim F.,0,22,100,100
1683715535853,CHEM 41B,A01,184690,Staff,51,0,100,49
1683715536880,COGS 3,A01,184715,Boyle; Mary E. T.,0,27,40,40
1683715537906,COGS 14B,A01,185172,Staff,0,14,38,38
1683715538936,COGS 18,A01,184736,Staff,14,0,80,66
1683715539961,COGS 100,A01,184932,Staff,0,8,73,73
1683715540984,COGS 101A,A01,184935,Staff,0,40,30,30
1683715542011,COGS 101B,A01,184944,Staff,0,2,30,30
1683715543036,COGS 101C,A01,184946,Staff,0,10,30,30
1683715544067,COGS 102A,A01,184951,Johnson; Christine M.,1,0,40,39
1683715545099,COGS 107B,A01,184953,Mooshagian; Eric Frederick,0,52,40,40
1683715546129,COGS 118B,A01,184959,Gupta; Anjum,0,50,40,40
1683715547159,COGS 153,A00,184961,Staff,1,16,30,29
1683715548186,COGS 177,A00,184962,Staff,0,20,30,30
1683715549266,COGS 187A,A01,184969,Boyle; Mary E. T.,0,19,40,40
1683715550293,COMM 10,A01,185174,Staff,0,5,25,25
1683715550293,COMM 10,A02,185189,Staff,0,2,25,25
1683715550293,COMM 10,A03,269821,Staff,0,1,0,0
1683715551319,COMM 100B,A02,185476,Staff,10,0,25,15
1683715551319,COMM 100B,A03,277340,Staff,25,0,25,0
1683715552345,COMM 100C,A01,185314,Staff,2,0,25,23
1683715552345,COMM 100C,A02,185327,Staff,17,0,25,8
1683715553370,COMM 110M,A00,185349,Staff,0,0,40,40
1683715554400,COMM 113T,A00,185352,Staff,25,0,40,15
1683715555427,COMM 114I,A00,185353,Staff,31,0,40,9
1683715556455,COMM 131,A00,185354,Staff,17,0,30,13
1683715557480,CSE 8A,A50,185358,Cao; Yingjun,0,46,10,10
1683715558505,CSE 8B,A01,185362,Staff,0,48,50,50
1683715559530,CSE 11,A01,185416,Cao; Yingjun,0,91,10,10
1683715560557,CSE 20,A01,185445,Briones; Jor-el Thomas Caparas,3,0,25,22
1683715561588,CSE 21,A01,185447,Staff,9,0,50,41
1683715562614,CSE 101,A01,185451,Staff,0,13,50,50
1683715562614,CSE 101,B01,185453,Jones; Miles E,0,15,50,50
1683715564668,CSE 141,A01,185458,Eldon; John,16,0,100,84
1683715565696,CSE 141L,A01,185461,Eldon; John,8,0,100,92
1683715566726,CSE 142,A01,185463,Staff,34,0,60,26
1683715566726,CSE 142,B01,201355,Staff,0,7,60,60
1683715567751,CSE 142L,A01,185470,Staff,34,0,60,26
1683715567751,CSE 142L,B01,201417,Staff,0,6,60,60
1683715568776,CSE 190,A00,201433,Staff,32,0,49,17
1683715569809,DOC 1,A01,259136,Strom; Megan C.,7,0,15,8
1683715569809,DOC 1,A02,259137,Strom; Megan C.,15,0,15,0
1683715569809,DOC 1,A03,259138,Strom; Megan C.,14,0,15,1
1683715569809,DOC 1,A04,259139,Strom; Megan C.,13,0,15,2
1683715570836,DOC 100D,A00,259140,Pass; Natalye Joann,14,0,25,11
1683715571863,DSGN 1,A01,184749,Rill; Bryan,0,26,30,30
1683715572888,DSGN 100,A01,185168,Staff,0,2,25,25
1683715573920,ECE 5,A01,185626,Morris; Karcher William,0,12,0,0
1683715574950,ECE 101,A01,185628,Staff,14,0,70,56
1683715575974,ECE 107,A01,185635,Baghdadchi; Saharnaz,0,0,20,20
1683715575974,ECE 107,A02,185638,Baghdadchi; Saharnaz,1,0,20,19
1683715577000,ECE 148,A01,185647,Silberman; Jack,0,0,16,16
1683715578027,ECON 1,A01,185537,Crane; Meredith Helen,54,0,70,16
1683715579055,ECON 3,A01,185549,Crane; Meredith Helen,30,0,70,40
1683715580081,ECON 4,A01,203354,Anderson; John Charles,0,5,10,10
1683715581107,ECON 100A,A01,185574,Staff,0,5,40,40
1683715582132,ECON 100B,A01,185576,Staff,0,12,50,50
1683715583158,ECON 100C,A01,185589,Newhouse; Herbert S,30,0,70,40
1683715584188,ECON 105,A00,185608,Vespa; Emanuel Ignacio,19,0,35,16
1683715585213,ECON 109,A01,185610,Shishkin; Denis,9,0,35,26
1683715586237,ECON 110A,A01,185612,Staff,8,0,40,32
1683715587262,ECON 120A,A01,185615,Staff,19,0,40,21
1683715588295,ECON 120C,A01,185617,Sun; Yixiao,0,21,70,70
1683715589320,ECON 144,A00,203346,Squires; Dale E,2,0,35,33
1683715590346,ECON 171,A01,203349,Newhouse; Herbert S,0,1,35,35
1683715591373,ECON 173A,A01,185621,Toda; Alexis Akira,21,0,35,14
1683715592401,EDS 25,A01,202413,Staff,0,1,0,0
1683715592401,EDS 25,A02,202414,Staff,0,1,0,0
1683715592401,EDS 25,A03,202415,Staff,0,0,0,0
1683715592401,EDS 25,A04,202416,Staff,0,1,0,0
1683715592401,EDS 25,A05,202439,Staff,0,0,0,0
1683715592401,EDS 25,A06,202440,Staff,0,0,0,0
1683715592401,EDS 25,B01,202631,Staff,0,0,0,0
1683715592401,EDS 25,B02,202632,Staff,0,0,0,0
1683715592401,EDS 25,B03,202639,Staff,0,0,0,0
1683715592401,EDS 25,B04,202640,Staff,0,0,0,0
1683715592401,EDS 25,B05,202643,Staff,0,0,0,0
1683715592401,EDS 25,B06,202644,Staff,0,0,0,0
1683715593428,EDS 38,A01,202659,Black; Alison Michelle,25,0,25,0
1683715594453,EDS 115,A00,202652,Staff,18,0,30,12
1683715595478,EDS 125,A00,202649,Staff,13,0,30,17
1683715596505,EDS 126,A01,203332,Staff,30,0,30,0
1683715597533,EDS 139,A00,202838,Staff,16,0,25,9
1683715598558,EDS 146,A01,202655,Staff,14,0,25,11
1683715599582,ENG 15,A00,185667,Staff,0,1,0,0
1683715599582,ENG 15,B00,185672,Staff,0,0,0,0
1683715599582,ENG 15,C00,185675,Staff,0,0,0,0
1683715599582,ENG 15,D00,185682,Staff,0,0,0,0
1683715599582,ENG 15,E00,185684,Staff,0,0,0,0
1683715600606,ETHN 103,A00,185710,Staff,0,8,35,35
1683715601632,ETHN 103A,A00,199228,Man; Simeon S,0,0,9,9
1683715602657,ETHN 109,A00,185711,Staff,15,0,35,20
1683715603685,ETHN 142,A00,185726,Staff,0,4,30,30
1683715604711,ETHN 163J,A00,199229,Man; Simeon S,5,0,8,3
1683715605735,ETHN 168,A00,185727,Staff,7,0,10,3
1683715606762,ETHN 182,A00,185728,Staff,0,0,35,35
1683715607787,ETHN 183,A00,185737,Staff,10,0,18,8
1683715608813,GLBH 111,A01,209361,Burgos; Jose L.,0,0,0,0
1683715610865,HIEU 104,A00,185792,Staff,14,0,20,6
1683715611896,HIEU 115,A00,185800,Staff,0,0,20,20
1683715612925,HIEU 128,A00,185801,Staff,0,9,20,20
1683715613953,HIEU 147,A00,185802,Staff,15,0,20,5
1683715614984,HIEU 154,A00,185823,Staff,11,0,20,9
1683715616008,HILA 102,A00,185826,Staff,14,0,20,6
1683715617037,HILD 2C,A01,185778,Staff,0,13,20,20
1683715618067,HILD 7B,A01,185780,Kwak; Nancy,0,17,32,32
1683715618067,HILD 7B,A02,185781,Kwak; Nancy,0,18,32,32
1683715619094,HILD 30,A01,185791,Staff,12,0,20,8
1683715620119,HISC 119,A00,185830,Golan; Tal,0,10,20,20
1683715621147,HITO 156GS,A00,185831,Patterson; Patrick H.,0,0,0,23
1683715622173,HIUS 103,A00,185832,Man; Simeon S,0,4,20,20
1683715623197,HIUS 117,A00,185836,Kwak; Nancy,2,0,20,18
1683715624221,HIUS 125,A00,185840,Man; Simeon S,0,2,23,23
1683715625245,HIUS 149,A00,185845,Staff,1,0,20,19
1683715626279,HUM 3,A01,185882,Zavodny; Tatiana Sophia,0,8,50,50
1683715626279,HUM 3,B01,185899,Caldwell; Michael Alan,0,18,50,50
1683715627303,HUM 3GS,A00,185900,Patterson; Patrick H.,0,0,0,23
1683715628330,HUM 4,A01,185938,Zroka; Amy Liane,28,0,50,22
1683715628330,HUM 4,B01,185956,Watkins; Eric,0,6,50,50
1683715628330,HUM 4,B02,202209,Watkins; Eric,0,6,50,50
1683715628330,HUM 4,B03,202210,Watkins; Eric,0,5,50,50
1683715629356,HUM 5,A01,185958,West; Geoffrey Scott,0,0,50,50
1683715629356,HUM 5,A02,202215,West; Geoffrey Scott,0,1,50,50
1683715630387,INTL 190,A00,185959,Gagnon; Jeffrey C,0,0,0,9
1683715630387,INTL 190,B00,185960,Lettieri; Michael Joseph,0,0,0,2
1683715631416,JAPN 180,A00,254509,Staff,5,0,30,25
1683715632442,LATI 10,A01,202853,Kennemore; Amy Michelle,4,0,35,31
1683715632442,LATI 10,A02,202854,Kennemore; Amy Michelle,3,0,35,32
1683715632442,LATI 10,A03,270054,Kennemore; Amy Michelle,30,0,30,0
1683715633467,LATI 180,A00,202855,Kennemore; Amy Michelle,11,0,20,9
1683715634497,LAWS 101,A00,201767,Golan; Tal,0,7,40,40
1683715635524,LIFR 1C,A00,185961,Staff,6,0,20,14
1683715636556,LIFR 1CX,A00,185962,Staff,7,0,20,13
1683715637580,LIFR 1D,A00,185963,Staff,7,0,20,13
1683715638608,LIFR 1DX,A00,185964,Staff,7,0,20,13
1683715639640,LIGN 101,A01,186039,Staff,43,0,50,7
1683715640668,LIGN 165,A00,186040,Staff,14,0,50,36
1683715641695,LTCS 108,A00,186041,Staff,5,0,10,5
1683715642723,LTCS 119,A00,186042,Staff,15,0,20,5
1683715643749,LTCS 130,A00,186043,Wesling; Megan E.,15,0,25,10
1683715645802,LTEA 138,A00,186119,Staff,14,0,40,26
1683715646833,LTEN 124,A00,186148,Staff,5,0,25,20
1683715647858,LTEN 178,A00,186149,Staff,6,0,15,9
1683715648889,LTEN 181,A00,186150,Blanco; John D,34,0,40,6
1683715649923,LTWL 120,A00,186160,Staff,19,0,25,6
1683715650953,LTWL 165,A00,186161,Staff,22,0,25,3
1683715651988,LTWR 100,A00,186162,Staff,0,5,15,15
1683715653099,LTWR 102,A00,186163,Doller; Ben,5,0,15,10
1683715654121,MAE 8,A01,186412,Staff,0,1,0,0
1683715655146,MAE 30B,A00,186445,Bahadori; Mohammad Yousef,81,0,100,19
1683715656170,MAE 40,A00,186592,Bewley; Thomas R,10,0,50,40
1683715657198,MAE 101B,A00,186593,Bahadori; Mohammad Yousef,80,0,100,20
1683715658228,MAE 105,A00,186594,Bandaru; Prabhakar,10,0,50,40
1683715659253,MAE 107,A00,186599,Pham; Hieu Tan,0,8,120,120
1683715660277,MAE 148,A01,186660,Silberman; Jack,3,0,16,13
1683715661305,MATH 10A,A01,188095,Staff,0,6,35,35
1683715662338,MATH 10B,A01,188097,Bowers; Adam R.,0,12,30,30
1683715662338,MATH 10B,A02,188099,Bowers; Adam R.,0,11,30,30
1683715662338,MATH 10B,B01,188104,Bowers; Adam R.,0,10,30,30
1683715662338,MATH 10B,B02,188106,Bowers; Adam R.,0,9,30,30
1683715663370,MATH 10C,A01,188111,Staff,0,20,30,30
1683715663370,MATH 10C,A02,188127,Staff,0,19,30,30
1683715663370,MATH 10C,A03,188131,Staff,0,19,30,30
1683715663370,MATH 10C,B01,188218,Staff,17,0,30,13
1683715663370,MATH 10C,B02,188244,Staff,13,0,30,17
1683715663370,MATH 10C,B03,188277,Staff,14,0,30,16
1683715664396,MATH 18,A01,188344,Bach; Quang Tran,18,0,30,12
1683715664396,MATH 18,A02,188345,Bach; Quang Tran,11,0,30,19
1683715664396,MATH 18,B01,188353,Bach; Quang Tran,11,0,30,19
1683715664396,MATH 18,B02,188354,Bach; Quang Tran,19,0,30,11
1683715665420,MATH 20A,A01,188374,Staff,11,0,35,24
1683715666447,MATH 20B,A01,188382,Ohm; Ko Woon,7,0,30,23
1683715666447,MATH 20B,A02,188383,Ohm; Ko Woon,22,0,30,8
1683715666447,MATH 20B,B01,188385,Ohm; Ko Woon,7,0,30,23
1683715666447,MATH 20B,B02,188392,Ohm; Ko Woon,22,0,30,8
1683715667474,MATH 20C,A01,188394,Harel; Guershon,10,0,30,20
1683715667474,MATH 20C,A02,188395,Harel; Guershon,13,0,30,17
1683715667474,MATH 20C,B01,188404,Harel; Guershon,5,0,30,25
1683715667474,MATH 20C,B02,188405,Harel; Guershon,18,0,30,12
1683715668501,MATH 20D,A01,188414,Hammock; Frances H,0,1,30,30
1683715668501,MATH 20D,A02,188415,Hammock; Frances H,0,1,30,30
1683715668501,MATH 20D,B01,188447,Hammock; Frances H,0,1,30,30
1683715668501,MATH 20D,B02,188486,Hammock; Frances H,2,0,30,28
1683715669532,MATH 20E,A01,188649,Staff,21,0,30,9
1683715669532,MATH 20E,A02,188650,Staff,20,0,30,10
1683715669532,MATH 20E,A03,188673,Staff,0,0,30,30
1683715670560,MATH 102,A01,188675,Staff,0,40,35,35
1683715671600,MATH 103B,A01,188681,Staff,3,0,35,32
1683715671600,MATH 103B,B01,188692,Staff,5,0,35,30
1683715672625,MATH 109,A01,188695,Salehi Golsefidy; Alireza,24,0,35,11
1683715672625,MATH 109,A02,188696,Salehi Golsefidy; Alireza,24,0,35,11
1683715673655,MATH 120A,A01,188698,Eggers; John Dietrich,7,0,35,28
1683715674681,MATH 142B,A01,188736,Ioana; Adrian,0,0,30,30
1683715674681,MATH 142B,A02,188741,Ioana; Adrian,0,1,30,30
1683715674681,MATH 142B,A03,188743,Ioana; Adrian,0,2,30,30
1683715675707,MATH 168A,A01,188790,Staff,0,11,35,35
1683715676731,MATH 170A,A01,188803,Nie; Jiawang,0,2,35,35
1683715676731,MATH 170A,A02,188811,Nie; Jiawang,0,1,35,35
1683715676731,MATH 170A,A03,188814,Nie; Jiawang,1,0,35,34
1683715676731,MATH 170A,A04,188815,Nie; Jiawang,5,0,35,30
1683715677756,MATH 193B,A01,188817,Staff,0,0,35,35
1683715677756,MATH 193B,A02,188818,Staff,6,0,35,29
1683715678786,MGT 4,A01,202857,Anderson; John Charles,59,0,80,21
1683715679815,MGT 12,A00,202858,Lindenberger; Wade Douglas,40,0,90,50
1683715680840,MGT 18,A00,202859,Staff,73,0,90,17
1683715681869,MGT 18GS,A00,202860,McKay; Michael J,13,0,28,15
1683715682898,MGT 45,A00,202861,Pecore; Joseph P.,8,0,90,82
1683715683928,MGT 100,A00,202863,Yavorsky; Daniel Ryan,27,0,90,63
1683715684961,MGT 103,A00,202864,Ehrich; Kristine R,0,19,90,90
1683715685989,MGT 112,A00,202865,Ehrich; Kristine R,15,0,90,75
1683715687022,MGT 121A,A00,202868,Staff,70,0,90,20
1683715688046,MGT 131B,A00,202869,Anderson; John Charles,58,0,90,32
1683715689070,MGT 136,A00,202871,Lindenberger; Wade Douglas,83,0,90,7
1683715690096,MGT 164,A00,202873,Staff,0,67,90,91
1683715691124,MGT 164GS,A00,202874,McKay; Mary A,13,0,28,15
1683715692148,MGT 180,A00,202875,Staff,0,51,90,91
1683715693178,MMW 11R,A01,205019,Herbst; Matthew,0,0,30,30
1683715693178,MMW 11R,A02,205026,Herbst; Matthew,29,0,30,1
1683715694205,MMW 15,A01,193512,Chang; Edmond Yi-Teh,0,8,28,28
1683715694205,MMW 15,A02,193513,Chang; Edmond Yi-Teh,0,5,28,28
1683715694205,MMW 15,A03,193514,Chang; Edmond Yi-Teh,0,5,28,28
1683715694205,MMW 15,A04,193515,Chang; Edmond Yi-Teh,0,5,28,28
1683715694205,MMW 15,A05,193516,Chang; Edmond Yi-Teh,0,5,28,28
1683715694205,MMW 15,A06,193517,Chang; Edmond Yi-Teh,0,6,28,28
1683715694205,MMW 15,B01,193519,Chang; Edmond Yi-Teh,0,5,28,28
1683715694205,MMW 15,B02,193520,Chang; Edmond Yi-Teh,0,5,28,28
1683715694205,MMW 15,B03,193521,Chang; Edmond Yi-Teh,0,5,28,28
1683715694205,MMW 15,B04,193522,Chang; Edmond Yi-Teh,0,6,28,28
1683715694205,MMW 15,B05,193523,Chang; Edmond Yi-Teh,0,5,28,28
1683715694205,MMW 15,B06,193524,Chang; Edmond Yi-Teh,0,5,28,28
1683715695230,MMW 122,A01,193526,Rahimi; Babak,0,16,28,28
1683715695230,MMW 122,A02,193527,Rahimi; Babak,0,15,28,28
1683715695230,MMW 122,A03,193528,Rahimi; Babak,0,0,0,0
1683715695230,MMW 122,A04,193529,Rahimi; Babak,0,0,0,0
1683715696258,MUS 1A,A01,186663,Staff,0,18,35,35
1683715697285,MUS 4,A01,186715,Staff,0,12,35,35
1683715698309,MUS 5R,A01,186796,Dubnov; Shlomo,0,17,35,35
1683715699334,MUS 6,A01,186798,Staff,0,4,25,25
1683715700363,MUS 7,A01,186830,Staff,11,0,35,24
1683715701387,MUS 8,A01,186930,Staff,0,27,35,35
1683715702416,MUS 15,A01,186932,Staff,0,15,35,35
1683715702416,MUS 15,B01,186934,Staff,0,16,35,35
1683715703441,MUS 80,A00,186935,Staff,0,0,20,20
1683715703441,MUS 80,B00,186936,Staff,24,0,25,1
1683715704466,NANO 11,A00,204702,Lipomi; Darren John,0,0,0,0
1683715705493,NANO 15,A01,204709,Yang; Kesong,0,1,0,0
1683715706526,NANO 114,A00,202069,Jahed Motlagh; Zeinab,2,0,10,8
1683715707558,PHIL 1,A00,186955,Grush; Rick Scott,31,0,40,9
1683715708582,PHIL 10,A01,186973,Grush; Rick Scott,27,0,35,8
1683715708582,PHIL 10,A02,186974,Grush; Rick Scott,33,0,35,2
1683715709608,PHIL 13,A01,186976,Staff,1,0,35,34
1683715709608,PHIL 13,A02,186977,Staff,16,0,35,19
1683715710634,PHIL 14,A01,186979,Staff,30,0,35,5
1683715710634,PHIL 14,A02,186986,Staff,32,0,35,3
1683715711662,PHIL 28,A01,186988,Staff,16,0,30,14
1683715711662,PHIL 28,A02,186989,Staff,0,0,30,30
1683715711662,PHIL 28,A03,186990,Staff,10,0,30,20
1683715711662,PHIL 28,A04,186991,Staff,26,0,30,4
1683715712686,PHIL 120,A00,186997,Staff,23,0,40,17
1683715713714,PHIL 137,A00,187003,Staff,8,0,40,32
1683715714742,PHIL 150,A00,187015,Staff,47,0,70,23
1683715715770,PHIL 167,A00,187021,Lamey; Andy M.,34,0,40,6
1683715716795,PHIL 174,A01,202226,Staff,17,0,20,3
1683715716795,PHIL 174,A02,202235,Staff,20,0,20,0
1683715717820,PHIL 191A,A00,258918,Staff,0,0,1,1
1683715718852,PHYS 1A,A00,187028,Staff,26,0,60,34
1683715719883,PHYS 1AL,001,187036,Staff,3,0,30,27
1683715719883,PHYS 1AL,002,187049,Staff,18,0,30,12
1683715720910,PHYS 1B,A00,187058,Staff,21,0,60,39
1683715721935,PHYS 1BL,001,187064,Staff,0,1,30,30
1683715721935,PHYS 1BL,002,187070,Staff,4,0,30,26
1683715722960,PHYS 1C,A00,187082,Staff,30,0,120,90
1683715723985,PHYS 1CL,001,187088,Staff,0,9,30,30
1683715723985,PHYS 1CL,002,187089,Staff,0,1,30,30
1683715723985,PHYS 1CL,009,262693,Staff,9,0,30,21
1683715725014,PHYS 2B,A01,187097,Staff,55,0,115,60
1683715726040,PHYS 2C,A01,187099,Staff,63,0,115,52
1683715727070,PHYS 2CL,A01,187101,Staff,5,0,28,23
1683715727070,PHYS 2CL,A02,187102,Staff,15,0,28,13
1683715728099,PHYS 2D,A01,187123,Shotwell; Brian,95,0,115,20
1683715729122,PHYS 4B,A01,187133,Grinstein; Benjamin,35,0,50,15
1683715730147,POLI 10,A00,188819,Staff,0,4,50,50
1683715731172,POLI 11,A00,188827,Staff,43,0,50,7
1683715732196,POLI 13R,A00,188828,Staff,0,2,20,20
1683715733222,POLI 27,A01,188830,Elgin; Samuel Zincke,0,2,70,70
1683715734253,POLI 30,A00,188832,Desposato; Scott,30,0,50,20
1683715735280,POLI 102F,A00,188834,Staff,1,0,40,39
1683715736305,POLI 104A,A00,188852,Staff,12,0,30,18
1683715737329,POLI 104I,A00,188853,Staff,0,8,20,20
1683715738360,POLI 110B,A00,188854,Wiens; David,6,0,20,14
1683715739385,POLI 112A,A00,188855,Wiens; David,3,0,30,27
1683715740410,POLI 117R,A00,188856,Forman; Fonna,0,12,20,20
1683715741433,POLI 118,A00,188857,Ingham; Sean,8,0,20,12
1683715742458,POLI 120G,A00,188858,Staff,7,0,30,23
1683715743482,POLI 131CR,A00,188863,Hoston; Germaine,20,0,50,30
1683715744513,POLI 133,A00,188864,Nellis; Gareth Hb,44,0,50,6
1683715745544,POLI 134D,A00,188865,Desposato; Scott,27,0,30,3
1683715746575,POLI 142A,A00,188871,Gartzke; Erik,21,0,50,29
1683715747600,POLI 142K,A00,188874,Staff,38,0,50,12
1683715748625,POLI 143,A00,188940,Gartzke; Erik,15,0,30,15
1683715749650,POLI 153,A00,188943,Staff,1,0,20,19
1683715750686,POLI 160AA,A00,188944,Staff,10,0,40,30
1683715751711,POLI 170A,A00,188945,Staff,10,0,30,20
1683715753758,PSYC 1,A00,188952,Staff,36,0,90,54
1683715754786,PSYC 2,B00,188953,Staff,19,0,35,16
1683715755810,PSYC 6,A00,188970,Staff,47,0,60,13
1683715756898,PSYC 7,A00,188973,Staff,35,0,45,10
1683715757928,PSYC 60,A01,188980,Rickard; Timothy C.,42,0,60,18
1683715758955,PSYC 70,A01,189001,Steiner; Eric Tomas,22,0,45,23
1683715759981,PSYC 100,A00,189005,Lacefield; Katharine I,1,98,120,119
1683715761010,PSYC 102,A00,189008,Staff,6,0,30,24
1683715762040,PSYC 106,B00,189026,Gorman; Michael R.,27,0,60,33
1683715763065,PSYC 114,B01,189033,Winkielman; Piotr,0,31,30,30
1683715764091,PSYC 131,A00,189036,Anagnostaras; Stephan,0,44,60,60
1683715765119,PSYC 136,A00,189041,Lowe; Angela Beth,0,7,25,25
1683715766145,PSYC 137,A00,189057,Winkielman; Piotr,0,36,25,25
1683715767169,PSYC 144,A00,189107,Wixted; John T,0,11,50,50
1683715769219,PSYC 162,A00,189142,Staff,0,9,85,85
1683715770247,PSYC 172,A00,189144,Gorman; Michael R.,0,6,30,30
1683715772302,PSYC 179,A00,189146,Lacefield; Katharine I,0,88,120,120
1683715773332,PSYC 181,A00,189147,Anagnostaras; Stephan,0,45,90,90
1683715774358,PSYC 190R,A00,189148,Barner; David A.,0,23,80,80
1683715775382,PSYC 191,A00,189275,Rickard; Timothy C.,0,11,25,25
1683715776407,PSYC 193,A00,189276,Chapman; Eddie Nathaniel,0,1,0,4
1683715777437,PSYC 193L,A01,189281,Lowe; Angela Beth,8,0,20,12
1683715777437,PSYC 193L,B01,189285,Staff,28,0,35,7
1683715778465,RELI 149,A00,187137,Rahimi; Babak,6,0,40,34
1683715779490,SE 9,A01,187315,Staff,0,2,18,18
1683715780519,SE 101B,A00,187409,Staff,24,0,30,6
1683715781547,SE 110B,A00,187444,Staff,10,0,40,30
1683715782573,SE 130B,A00,187449,Staff,31,0,40,9
1683715783595,SE 150A,A00,187516,Staff,8,0,20,12
1683715784619,SE 154,A00,187528,Staff,29,0,50,21
1683715785642,SIO 3,A01,258171,Staff,35,0,40,5
1683715786666,SIO 10,A00,187144,Cook; Geoffrey W,0,6,75,75
1683715787693,SIO 45,A00,187152,Cook; Geoffrey W,1,7,100,99
1683715788718,SIO 109R,A00,194486,Staff,0,4,20,20
1683715790774,SIO 187,A01,187233,Kacev; David,12,0,40,28
1683715791807,SOCI 1,A01,258656,Thorpe; Charles Robert,28,0,30,2
1683715791807,SOCI 1,A02,258658,Thorpe; Charles Robert,30,0,30,0
1683715791807,SOCI 1,A03,258661,Thorpe; Charles Robert,25,0,25,0
1683715791807,SOCI 1,A04,258666,Thorpe; Charles Robert,22,0,25,3
1683715791807,SOCI 1,A05,258897,Thorpe; Charles Robert,22,0,25,3
1683715791807,SOCI 1,A06,258898,Thorpe; Charles Robert,25,0,25,0
1683715792834,SOCI 30,A01,258903,Pardo Guerra; Juan Pablo,14,0,30,16
1683715793859,SOCI 102,A00,258904,Staff,9,0,25,16
1683715794887,SOCI 106,A00,258905,Staff,19,0,25,6
1683715795912,SOCI 111,A00,258907,Ribas Norris; Janet Vanesa,26,0,30,4
1683715796936,SOCI 121R,A00,258908,Pardo Guerra; Juan Pablo,7,0,30,23
1683715797960,SOCI 126,A01,203330,Staff,14,0,20,6
1683715798986,SOCI 131,A00,258909,Thorpe; Charles Robert,30,0,60,30
1683715800010,SOCI 135,A00,258910,Payne; Christine Anna,0,13,30,30
1683715801038,SOCI 157,A00,258911,Staff,10,0,30,20
1683715802067,SOCI 184,A00,258912,Staff,25,0,30,5
1683715803097,SOCI 188D,A00,258913,Staff,22,0,30,8
1683715804123,SYN 2,001,187529,Staff,9,0,16,7
1683715804123,SYN 2,002,201452,Staff,0,20,16,16
1683715804123,SYN 2,003,201469,Staff,1,0,16,15
1683715805147,SYN 100,A01,187531,Staff,0,9,20,20
1683715805147,SYN 100,B01,201491,Staff,0,10,20,20
1683715806172,TDAC 1,A00,189286,Walsh; Kim C.,3,0,20,17
1683715806172,TDAC 1,B00,189287,Harting; Carla Kelso,10,0,20,10
1683715807200,TDAC 101,A00,189300,Walsh; Kim C.,16,0,20,4
1683715807200,TDAC 101,B00,189301,Harting; Carla Kelso,18,0,20,2
1683715808224,TDAC 102,A00,189304,Basso; Beatrice,14,0,20,6
1683715809249,TDAC 108,A00,189305,Staff,18,0,20,2
1683715810272,TDDE 131,A00,189310,Staff,19,0,20,1
1683715810272,TDDE 131,B00,189314,Staff,19,0,20,1
1683715810272,TDDE 131,C00,189315,Staff,48,0,50,2
1683715810272,TDDE 131,D00,189316,Staff,14,0,15,1
1683715810272,TDDE 131,E00,204841,Staff,20,0,20,0
1683715811296,TDGE 10,A00,189289,Staff,27,0,50,23
1683715811296,TDGE 10,B00,189290,Havis; Allan,0,1,50,50
1683715812322,TDGE 11,A00,189291,Fulton; Julia,0,4,50,50
1683715812322,TDGE 11,B00,189292,Staff,20,0,25,5
1683715812322,TDGE 11,C00,260270,Staff,0,0,0,0
1683715813350,TDGE 25,A00,189294,Staff,1,0,20,19
1683715814374,TDGE 124,A00,189318,Fulton; Julia,0,7,50,50
1683715815403,TDGE 125,A00,189319,Staff,13,0,25,12
1683715815403,TDGE 125,B00,189320,Staff,23,0,25,2
1683715816434,TDGE 127,A00,189322,Havis; Allan,1,0,50,49
1683715817463,TDHT 101,A00,189323,Staff,18,0,25,7
1683715817463,TDHT 101,B00,189324,Staff,25,0,25,0
1683715818486,TDHT 102,A00,189325,Staff,49,0,50,1
1683715819510,TDMV 1,A00,189295,Arcidiacono; Kristin,20,0,30,10
1683715819510,TDMV 1,B00,189296,Caligagan; Maria T.,23,0,30,7
1683715820536,TDMV 2,A00,189297,Sammartano; Tonnie,27,0,30,3
1683715820536,TDMV 2,B00,189299,Arcidiacono; Kristin,23,0,30,7
1683715821562,TDMV 3,A00,204998,Rincon; Alicia,22,0,30,8
1683715822587,TDMV 120,A00,189458,Sammartano; Tonnie,28,0,30,2
1683715823616,TDMV 138,A00,189541,Jun; Grace Shin Hae,20,0,40,20
1683715824642,TDMV 142,A00,189717,Caligagan; Tony,25,0,30,5
1683715824642,TDMV 142,B00,189718,Caligagan; Maria T.,25,0,30,5
1683715825670,TMC 2,A01,187533,Staff,25,0,25,0
1683715825670,TMC 2,A02,187534,Staff,25,0,25,0
1683715826695,USP 1,A01,187536,Kwak; Nancy,0,16,25,25
1683715827720,USP 5,A01,187538,Staff,8,0,25,17
1683715828745,USP 101,A00,199253,Staff,0,4,0,0
1683715829774,USP 124,A00,187562,Boomhower; Matthew Charles,0,0,30,30
1683715830799,USP 138,A00,187582,Staff,19,0,25,6
1683715831828,USP 152,A01,187597,Staff,3,0,25,22
1683715832854,USP 153,A00,187598,Staff,18,0,25,7
1683715833878,USP 168,A00,187607,Kwak; Nancy,2,0,5,3
1683715834900,USP 173,A00,187619,Staff,4,0,25,21
1683715835928,USP 181,A00,187638,Staff,0,4,25,25
1683715836958,VIS 103,A00,187650,Cruz; Edwin Teddy,17,0,75,58
1683715837983,VIS 110D,A00,187669,Staff,13,0,22,9
1683715839015,VIS 127C,A00,187720,Shen; Kuiyi,67,0,146,79
1683715840040,VIS 149,A00,187731,Yoldas; Pinar,0,12,22,22
1683715841065,VIS 151,A01,188091,Staff,22,0,34,12
1683715841065,VIS 151,A02,188092,Staff,11,0,34,23
1683715842094,VIS 160B,A00,188093,Stalbaum; Brett,0,1,10,10
1683715844153,WCWP 10B,A00,201720,Staff,0,0,5,5
1683715844153,WCWP 10B,B00,201722,Staff,0,0,6,6
1683715845185,WCWP 100,A00,201725,Gagnon; Jeffrey C,0,0,2,2
1683715845185,WCWP 100,B00,201727,Staff,0,4,15,15
1683715848357,ANBI 133,A00,258401,Wilder; Linnea Lorene,34,0,40,6
1683715849382,ANBI 140,A00,258395,Hrvoj Mihic; Branka,18,0,25,7
1683715850412,ANSC 120,A00,258402,Bialecki; Jon Anthony,26,0,40,14
1683715851437,ANSC 144,A00,258400,Staff,12,0,40,28
1683715853490,ANSC 166,A00,258396,Parish; Steven Martin,156,0,175,19
1683715854515,ANSC 180,A00,193533,Staff,8,0,20,12
1683715855540,ANSC 188,A00,258397,Jassal; Aftab,34,0,40,6
1683715856565,ANTH 3,A01,258316,Staff,23,0,30,7
1683715857596,ANTH 5,A00,258394,Semendeferi; Ekaterini,16,0,20,4
1683715858623,ANTH 21,A01,258331,Staff,4,0,40,36
1683715859649,ANTH 103,A00,258398,Varma; Saiba,15,0,25,10
1683715860742,AWP 10,001,202034,Staff,0,0,0,0
1683715860742,AWP 10,002,202035,Staff,0,0,0,0
1683715860742,AWP 10,003,202036,Staff,0,0,0,0
1683715860742,AWP 10,004,202037,Staff,0,0,0,0
1683715860742,AWP 10,005,202038,Staff,0,0,0,0
1683715860742,AWP 10,006,202039,Staff,0,0,0,0
1683715860742,AWP 10,007,202040,Staff,0,0,0,0
1683715860742,AWP 10,008,202041,Staff,0,0,0,0
1683715860742,AWP 10,009,202042,Staff,0,0,0,0
1683715860742,AWP 10,010,202043,Staff,0,0,0,0
1683715860742,AWP 10,011,202044,Staff,0,0,0,0
1683715860742,AWP 10,012,202045,Staff,0,0,0,0
1683715860742,AWP 10,013,202046,Staff,0,0,0,0
1683715860742,AWP 10,014,202047,Staff,0,0,0,0
1683715860742,AWP 10,015,202048,Staff,0,0,0,0
1683715860742,AWP 10,016,202049,Staff,0,0,0,0
1683715860742,AWP 10,017,202050,Staff,0,0,0,0
1683715860742,AWP 10,018,202051,Staff,0,0,0,0
1683715860742,AWP 10,019,202052,Staff,0,0,0,0
1683715860742,AWP 10,020,202053,Staff,0,0,0,0
1683715860742,AWP 10,021,202054,Staff,0,0,0,0
1683715860742,AWP 10,022,202055,Staff,0,0,0,0
1683715860742,AWP 10,023,202056,Staff,0,0,0,0
1683715860742,AWP 10,024,202057,Staff,0,0,0,0
1683715860742,AWP 10,025,202058,Staff,0,0,0,0
1683715860742,AWP 10,026,202059,Staff,0,0,0,0
1683715861772,AWP 102,001,202032,Staff,0,0,0,0
1683715861772,AWP 102,002,202033,Staff,0,0,0,0
1683715862798,BENG 100,A01,254234,Taylor Amos; Alyssa C,31,0,40,9
1683715863828,BENG 196,001,270013,Engler; Adam J.,9999,0,9999,0
1683715864864,BICD 100R,A01,202018,Smith; Laurie,0,7,32,32
1683715864864,BICD 100R,A02,202019,Smith; Laurie,0,3,32,32
1683715864864,BICD 100R,A03,202020,Smith; Laurie,0,1,32,32
1683715864864,BICD 100R,A04,202021,Smith; Laurie,6,0,32,26
1683715864864,BICD 100R,A05,202022,Smith; Laurie,10,0,32,22
1683715865892,BICD 136,A01,193242,Gustafson-Brown; Cindy,0,2,32,32
1683715865892,BICD 136,A02,193244,Gustafson-Brown; Cindy,13,0,32,19
1683715866920,BIEB 102,A01,193249,Butler; Shannon Rhey,0,0,32,32
1683715866920,BIEB 102,A02,193251,Butler; Shannon Rhey,0,0,32,32
1683715866920,BIEB 102,A03,193253,Butler; Shannon Rhey,0,0,32,32
1683715866920,BIEB 102,A04,193255,Butler; Shannon Rhey,13,0,32,19
1683715866920,BIEB 102,A05,193265,Butler; Shannon Rhey,25,0,32,7
1683715866920,BIEB 102,A06,193269,Butler; Shannon Rhey,12,0,32,20
1683715868974,BIEB 150,A01,193274,Staff,0,0,32,32
1683715868974,BIEB 150,A02,193285,Staff,24,0,32,8
1683715869999,BIEB 194,A00,193286,Kurle; Carolyn M.,19,0,32,13
1683715871030,BILD 1,A01,192291,Staff,15,0,32,17
1683715871030,BILD 1,A02,192292,Staff,30,0,32,2
1683715871030,BILD 1,B01,192520,Reuther; Keefe,0,1,0,0
1683715871030,BILD 1,B02,192532,Reuther; Keefe,0,1,0,0
1683715872062,BILD 3,A01,192556,Butler; Shannon Rhey,0,0,32,32
1683715872062,BILD 3,A02,192581,Butler; Shannon Rhey,0,1,32,32
1683715872062,BILD 3,A03,192611,Butler; Shannon Rhey,19,0,32,13
1683715872062,BILD 3,A04,192612,Butler; Shannon Rhey,23,0,32,9
1683715872062,BILD 3,A05,192613,Butler; Shannon Rhey,26,0,32,6
1683715872062,BILD 3,A06,192679,Butler; Shannon Rhey,27,0,32,5
1683715872062,BILD 3,A07,192682,Butler; Shannon Rhey,20,0,32,12
1683715873087,BILD 4,A01,192836,Reuther; Keefe,1,0,24,23
1683715873087,BILD 4,A02,193044,Reuther; Keefe,4,0,24,20
1683715874113,BILD 10,A01,193142,Gustafson-Brown; Cindy,29,0,32,3
1683715874113,BILD 10,A02,193149,Gustafson-Brown; Cindy,31,0,32,1
1683715875138,BIMM 100,A01,193301,Staff,0,6,32,32
1683715875138,BIMM 100,A02,193312,Staff,0,7,32,32
1683715875138,BIMM 100,A03,193323,Staff,0,10,32,32
1683715876172,BIMM 101,A01,193329,McDonnell; Lisa Marie,0,3,24,24
1683715876172,BIMM 101,A02,193339,McDonnell; Lisa Marie,0,3,24,24
1683715876172,BIMM 101,B01,193354,McDonnell; Lisa Marie,0,4,24,24
1683715876172,BIMM 101,B02,193357,McDonnell; Lisa Marie,0,3,24,24
1683715877198,BIMM 110,A01,193377,Tat; John,0,11,32,32
1683715877198,BIMM 110,A02,193378,Tat; John,0,11,32,32
1683715878225,BIMM 120,A01,206116,Staff,0,0,32,32
1683715878225,BIMM 120,A02,206117,Staff,7,0,32,25
1683715878225,BIMM 120,A03,206121,Staff,21,0,32,11
1683715879256,BIPN 100,A01,193393,Park; Ji Young,0,15,32,32
1683715879256,BIPN 100,A02,193402,Park; Ji Young,0,14,32,32
1683715879256,BIPN 100,A03,193413,Park; Ji Young,0,14,32,32
1683715879256,BIPN 100,A04,193414,Park; Ji Young,0,13,32,32
1683715880287,BIPN 102,A01,193429,Staff,0,0,32,32
1683715880287,BIPN 102,A02,193438,Staff,18,0,32,14
1683715881313,BIPN 106,A01,193450,Reyes Gonzalez; Catalina,0,2,40,40
1683715882339,BIPN 134,A01,193465,Cooke; James Edward,0,0,32,32
1683715882339,BIPN 134,A02,193474,Cooke; James Edward,25,0,32,7
1683715882339,BIPN 134,A03,193485,Cooke; James Edward,29,0,32,3
1683715882339,BIPN 134,A04,193486,Cooke; James Edward,20,0,32,12
1683715882339,BIPN 134,A05,193491,Cooke; James Edward,31,0,32,1
1683715882339,BIPN 134,A06,193501,Cooke; James Edward,30,0,32,2
1683715882339,BIPN 134,A07,193510,Cooke; James Edward,29,0,32,3
1683715884392,BISP 194,A00,222522,Staff,14,0,32,18
1683715885420,CAT 124,A01,202407,Staff,19,0,25,6
1683715886445,CAT 125,A00,202408,Marchisotto; Jennifer Anne,2,0,20,18
1683715887480,CAT 125R,A00,202409,Smith; Lauryn Alissa,0,11,20,20
1683715887480,CAT 125R,B00,202410,Morales; Celeste Georgianna,0,11,20,20
1683715887480,CAT 125R,C00,202411,Irwin; Matthew Joseph,0,12,20,20
1683715888511,CENG 15,A01,204712,Yang; Kesong,0,1,0,0
1683715889534,CENG 114,A00,202070,Jahed Motlagh; Zeinab,5,0,20,15
1683715890560,CGS 105,A00,185477,Wesling; Megan E.,24,0,40,16
1683715891588,CGS 106,A00,185494,Staff,11,0,22,11
1683715892613,CGS 108,A00,185495,Staff,14,0,20,6
1683715893637,CGS 114,A00,185496,Staff,13,0,18,5
1683715894669,CGS 119,A00,185501,Staff,15,0,20,5
1683715895694,CGS 120,A00,185511,Staff,11,0,20,9
1683715896727,CHEM 4,A01,184675,Bussey; Thomas J,97,0,100,3
1683715897753,CHEM 6A,A01,184677,Staff,32,0,60,28
1683715898781,CHEM 6B,A01,184679,Staff,63,0,100,37
1683715899812,CHEM 6C,A01,184681,Bussey; Thomas J,0,0,50,50
1683715899812,CHEM 6C,A02,184682,Bussey; Thomas J,32,0,50,18
1683715900842,CHEM 40A,A01,184684,Albizati; Kim F.,33,0,100,67
1683715901872,CHEM 40B,A01,184686,Albizati; Kim F.,0,22,100,100
1683715902900,CHEM 41B,A01,184690,Staff,51,0,100,49
1683715903932,COGS 3,A01,184715,Boyle; Mary E. T.,0,27,40,40
1683715904962,COGS 14B,A01,185172,Staff,0,14,38,38
1683715905987,COGS 18,A01,184736,Staff,14,0,80,66
1683715907014,COGS 100,A01,184932,Staff,0,8,73,73
1683715908039,COGS 101A,A01,184935,Staff,0,40,30,30
1683715909064,COGS 101B,A01,184944,Staff,0,2,30,30
1683715910089,COGS 101C,A01,184946,Staff,0,10,30,30
1683715911116,COGS 102A,A01,184951,Johnson; Christine M.,1,0,40,39
1683715912141,COGS 107B,A01,184953,Mooshagian; Eric Frederick,0,52,40,40
1683715913173,COGS 118B,A01,184959,Gupta; Anjum,0,50,40,40
1683715914197,COGS 153,A00,184961,Staff,1,16,30,29
1683715915221,COGS 177,A00,184962,Staff,0,20,30,30
1683715916249,COGS 187A,A01,184969,Boyle; Mary E. T.,0,19,40,40
1683715917278,COMM 10,A01,185174,Staff,0,5,25,25
1683715917278,COMM 10,A02,185189,Staff,0,2,25,25
1683715917278,COMM 10,A03,269821,Staff,0,1,0,0
1683715918302,COMM 100B,A02,185476,Staff,10,0,25,15
1683715918302,COMM 100B,A03,277340,Staff,25,0,25,0
1683715919327,COMM 100C,A01,185314,Staff,2,0,25,23
1683715919327,COMM 100C,A02,185327,Staff,17,0,25,8
1683715920352,COMM 110M,A00,185349,Staff,0,0,40,40
1683715921375,COMM 113T,A00,185352,Staff,25,0,40,15
1683715922400,COMM 114I,A00,185353,Staff,31,0,40,9
1683715923424,COMM 131,A00,185354,Staff,17,0,30,13
1683715924455,CSE 8A,A50,185358,Cao; Yingjun,0,46,10,10
1683715925481,CSE 8B,A01,185362,Staff,0,48,50,50
1683715926504,CSE 11,A01,185416,Cao; Yingjun,0,91,10,10
1683715927530,CSE 20,A01,185445,Briones; Jor-el Thomas Caparas,3,0,25,22
1683715928556,CSE 21,A01,185447,Staff,9,0,50,41
1683715929581,CSE 101,A01,185451,Staff,0,13,50,50
1683715929581,CSE 101,B01,185453,Jones; Miles E,0,15,50,50
1683715931631,CSE 141,A01,185458,Eldon; John,16,0,100,84
1683715932655,CSE 141L,A01,185461,Eldon; John,8,0,100,92
1683715933686,CSE 142,A01,185463,Staff,34,0,60,26
1683715933686,CSE 142,B01,201355,Staff,0,7,60,60
1683715934712,CSE 142L,A01,185470,Staff,34,0,60,26
1683715934712,CSE 142L,B01,201417,Staff,0,6,60,60
1683715935737,CSE 190,A00,201433,Staff,32,0,49,17
1683715936770,DOC 1,A01,259136,Strom; Megan C.,7,0,15,8
1683715936770,DOC 1,A02,259137,Strom; Megan C.,15,0,15,0
1683715936770,DOC 1,A03,259138,Strom; Megan C.,14,0,15,1
1683715936770,DOC 1,A04,259139,Strom; Megan C.,13,0,15,2
1683715937804,DOC 100D,A00,259140,Pass; Natalye Joann,14,0,25,11
1683715938830,DSGN 1,A01,184749,Rill; Bryan,0,26,30,30
1683715939859,DSGN 100,A01,185168,Staff,0,2,25,25
1683715940892,ECE 5,A01,185626,Morris; Karcher William,0,12,0,0
1683715941916,ECE 101,A01,185628,Staff,14,0,70,56
1683715942945,ECE 107,A01,185635,Baghdadchi; Saharnaz,0,0,20,20
1683715942945,ECE 107,A02,185638,Baghdadchi; Saharnaz,1,0,20,19
1683715943972,ECE 148,A01,185647,Silberman; Jack,0,0,16,16
1683715945000,ECON 1,A01,185537,Crane; Meredith Helen,54,0,70,16
1683715946028,ECON 3,A01,185549,Crane; Meredith Helen,30,0,70,40
1683715947054,ECON 4,A01,203354,Anderson; John Charles,0,5,10,10
1683715948078,ECON 100A,A01,185574,Staff,0,5,40,40
1683715949102,ECON 100B,A01,185576,Staff,0,12,50,50
1683715950129,ECON 100C,A01,185589,Newhouse; Herbert S,30,0,70,40
1683715951154,ECON 105,A00,185608,Vespa; Emanuel Ignacio,19,0,35,16
1683715952180,ECON 109,A01,185610,Shishkin; Denis,9,0,35,26
1683715953210,ECON 110A,A01,185612,Staff,8,0,40,32
1683715954234,ECON 120A,A01,185615,Staff,19,0,40,21
1683715955260,ECON 120C,A01,185617,Sun; Yixiao,0,21,70,70
1683715956286,ECON 144,A00,203346,Squires; Dale E,2,0,35,33
1683715957310,ECON 171,A01,203349,Newhouse; Herbert S,0,1,35,35
1683715958335,ECON 173A,A01,185621,Toda; Alexis Akira,21,0,35,14
1683715959364,EDS 25,A01,202413,Staff,0,1,0,0
1683715959364,EDS 25,A02,202414,Staff,0,1,0,0
1683715959364,EDS 25,A03,202415,Staff,0,0,0,0
1683715959364,EDS 25,A04,202416,Staff,0,1,0,0
1683715959364,EDS 25,A05,202439,Staff,0,0,0,0
1683715959364,EDS 25,A06,202440,Staff,0,0,0,0
1683715959364,EDS 25,B01,202631,Staff,0,0,0,0
1683715959364,EDS 25,B02,202632,Staff,0,0,0,0
1683715959364,EDS 25,B03,202639,Staff,0,0,0,0
1683715959364,EDS 25,B04,202640,Staff,0,0,0,0
1683715959364,EDS 25,B05,202643,Staff,0,0,0,0
1683715959364,EDS 25,B06,202644,Staff,0,0,0,0
1683715960392,EDS 38,A01,202659,Black; Alison Michelle,25,0,25,0
1683715961421,EDS 115,A00,202652,Staff,18,0,30,12
1683715962445,EDS 125,A00,202649,Staff,13,0,30,17
1683715963474,EDS 126,A01,203332,Staff,30,0,30,0
1683715964557,EDS 139,A00,202838,Staff,16,0,25,9
1683715965582,EDS 146,A01,202655,Staff,14,0,25,11
1683715966614,ENG 15,A00,185667,Staff,0,1,0,0
1683715966614,ENG 15,B00,185672,Staff,0,0,0,0
1683715966614,ENG 15,C00,185675,Staff,0,0,0,0
1683715966614,ENG 15,D00,185682,Staff,0,0,0,0
1683715966614,ENG 15,E00,185684,Staff,0,0,0,0
1683715967643,ETHN 103,A00,185710,Staff,0,8,35,35
1683715968673,ETHN 103A,A00,199228,Man; Simeon S,0,0,9,9
1683715969698,ETHN 109,A00,185711,Staff,15,0,35,20
1683715970726,ETHN 142,A00,185726,Staff,0,4,30,30
1683715971752,ETHN 163J,A00,199229,Man; Simeon S,5,0,8,3
1683715972779,ETHN 168,A00,185727,Staff,7,0,10,3
1683715973808,ETHN 182,A00,185728,Staff,0,0,35,35
1683715974833,ETHN 183,A00,185737,Staff,10,0,18,8
1683715975859,GLBH 111,A01,209361,Burgos; Jose L.,0,0,0,0
1683715977919,HIEU 104,A00,185792,Staff,14,0,20,6
1683715978944,HIEU 115,A00,185800,Staff,0,0,20,20
1683715979969,HIEU 128,A00,185801,Staff,0,9,20,20
1683715980994,HIEU 147,A00,185802,Staff,15,0,20,5
1683715982025,HIEU 154,A00,185823,Staff,11,0,20,9
1683715983050,HILA 102,A00,185826,Staff,14,0,20,6
1683715984074,HILD 2C,A01,185778,Staff,0,13,20,20
1683715985100,HILD 7B,A01,185780,Kwak; Nancy,0,17,32,32
1683715985100,HILD 7B,A02,185781,Kwak; Nancy,0,18,32,32
1683715986125,HILD 30,A01,185791,Staff,12,0,20,8
1683715987155,HISC 119,A00,185830,Golan; Tal,0,10,20,20
1683715988178,HITO 156GS,A00,185831,Patterson; Patrick H.,0,0,0,23
1683715989202,HIUS 103,A00,185832,Man; Simeon S,0,4,20,20
1683715990231,HIUS 117,A00,185836,Kwak; Nancy,2,0,20,18
1683715991256,HIUS 125,A00,185840,Man; Simeon S,0,2,23,23
1683715992285,HIUS 149,A00,185845,Staff,1,0,20,19
1683715993310,HUM 3,A01,185882,Zavodny; Tatiana Sophia,0,8,50,50
1683715993310,HUM 3,B01,185899,Caldwell; Michael Alan,0,18,50,50
1683715994334,HUM 3GS,A00,185900,Patterson; Patrick H.,0,0,0,23
1683715995361,HUM 4,A01,185938,Zroka; Amy Liane,28,0,50,22
1683715995361,HUM 4,B01,185956,Watkins; Eric,0,6,50,50
1683715995361,HUM 4,B02,202209,Watkins; Eric,0,6,50,50
1683715995361,HUM 4,B03,202210,Watkins; Eric,0,5,50,50
1683715996387,HUM 5,A01,185958,West; Geoffrey Scott,0,0,50,50
1683715996387,HUM 5,A02,202215,West; Geoffrey Scott,0,1,50,50
1683715997418,INTL 190,A00,185959,Gagnon; Jeffrey C,0,0,0,9
1683715997418,INTL 190,B00,185960,Lettieri; Michael Joseph,0,0,0,2
1683715998443,JAPN 180,A00,254509,Staff,5,0,30,25
1683715999470,LATI 10,A01,202853,Kennemore; Amy Michelle,4,0,35,31
1683715999470,LATI 10,A02,202854,Kennemore; Amy Michelle,3,0,35,32
1683715999470,LATI 10,A03,270054,Kennemore; Amy Michelle,30,0,30,0
1683716000499,LATI 180,A00,202855,Kennemore; Amy Michelle,11,0,20,9
1683716001526,LAWS 101,A00,201767,Golan; Tal,0,7,40,40
1683716002556,LIFR 1C,A00,185961,Staff,6,0,20,14
1683716003581,LIFR 1CX,A00,185962,Staff,7,0,20,13
1683716004609,LIFR 1D,A00,185963,Staff,7,0,20,13
1683716005633,LIFR 1DX,A00,185964,Staff,7,0,20,13
1683716006657,LIGN 101,A01,186039,Staff,43,0,50,7
1683716007685,LIGN 165,A00,186040,Staff,14,0,50,36
1683716008709,LTCS 108,A00,186041,Staff,5,0,10,5
1683716009736,LTCS 119,A00,186042,Staff,15,0,20,5
1683716010766,LTCS 130,A00,186043,Wesling; Megan E.,15,0,25,10
1683716012819,LTEA 138,A00,186119,Staff,14,0,40,26
1683716013847,LTEN 124,A00,186148,Staff,5,0,25,20
1683716014872,LTEN 178,A00,186149,Staff,6,0,15,9
1683716015896,LTEN 181,A00,186150,Blanco; John D,34,0,40,6
1683716016924,LTWL 120,A00,186160,Staff,19,0,25,6
1683716017949,LTWL 165,A00,186161,Staff,22,0,25,3
1683716018973,LTWR 100,A00,186162,Staff,0,5,15,15
1683716020003,LTWR 102,A00,186163,Doller; Ben,5,0,15,10
1683716021029,MAE 8,A01,186412,Staff,0,1,0,0
1683716022061,MAE 30B,A00,186445,Bahadori; Mohammad Yousef,81,0,100,19
1683716023085,MAE 40,A00,186592,Bewley; Thomas R,10,0,50,40
1683716024109,MAE 101B,A00,186593,Bahadori; Mohammad Yousef,80,0,100,20
1683716025135,MAE 105,A00,186594,Bandaru; Prabhakar,10,0,50,40
1683716026164,MAE 107,A00,186599,Pham; Hieu Tan,0,8,120,120
1683716027192,MAE 148,A01,186660,Silberman; Jack,3,0,16,13
1683716028222,MATH 10A,A01,188095,Staff,0,6,35,35
1683716029253,MATH 10B,A01,188097,Bowers; Adam R.,0,12,30,30
1683716029253,MATH 10B,A02,188099,Bowers; Adam R.,0,11,30,30
1683716029253,MATH 10B,B01,188104,Bowers; Adam R.,0,10,30,30
1683716029253,MATH 10B,B02,188106,Bowers; Adam R.,0,9,30,30
1683716030279,MATH 10C,A01,188111,Staff,0,20,30,30
1683716030279,MATH 10C,A02,188127,Staff,0,19,30,30
1683716030279,MATH 10C,A03,188131,Staff,0,19,30,30
1683716030279,MATH 10C,B01,188218,Staff,17,0,30,13
1683716030279,MATH 10C,B02,188244,Staff,13,0,30,17
1683716030279,MATH 10C,B03,188277,Staff,14,0,30,16
1683716031303,MATH 18,A01,188344,Bach; Quang Tran,18,0,30,12
1683716031303,MATH 18,A02,188345,Bach; Quang Tran,11,0,30,19
1683716031303,MATH 18,B01,188353,Bach; Quang Tran,11,0,30,19
1683716031303,MATH 18,B02,188354,Bach; Quang Tran,19,0,30,11
1683716032327,MATH 20A,A01,188374,Staff,11,0,35,24
1683716033352,MATH 20B,A01,188382,Ohm; Ko Woon,7,0,30,23
1683716033352,MATH 20B,A02,188383,Ohm; Ko Woon,22,0,30,8
1683716033352,MATH 20B,B01,188385,Ohm; Ko Woon,7,0,30,23
1683716033352,MATH 20B,B02,188392,Ohm; Ko Woon,22,0,30,8
1683716034377,MATH 20C,A01,188394,Harel; Guershon,10,0,30,20
1683716034377,MATH 20C,A02,188395,Harel; Guershon,13,0,30,17
1683716034377,MATH 20C,B01,188404,Harel; Guershon,5,0,30,25
1683716034377,MATH 20C,B02,188405,Harel; Guershon,18,0,30,12
1683716035404,MATH 20D,A01,188414,Hammock; Frances H,0,1,30,30
1683716035404,MATH 20D,A02,188415,Hammock; Frances H,0,1,30,30
1683716035404,MATH 20D,B01,188447,Hammock; Frances H,0,1,30,30
1683716035404,MATH 20D,B02,188486,Hammock; Frances H,2,0,30,28
1683716036427,MATH 20E,A01,188649,Staff,21,0,30,9
1683716036427,MATH 20E,A02,188650,Staff,20,0,30,10
1683716036427,MATH 20E,A03,188673,Staff,0,0,30,30
1683716037453,MATH 102,A01,188675,Staff,0,40,35,35
1683716038480,MATH 103B,A01,188681,Staff,3,0,35,32
1683716038480,MATH 103B,B01,188692,Staff,5,0,35,30
1683716039510,MATH 109,A01,188695,Salehi Golsefidy; Alireza,24,0,35,11
1683716039510,MATH 109,A02,188696,Salehi Golsefidy; Alireza,24,0,35,11
1683716040541,MATH 120A,A01,188698,Eggers; John Dietrich,7,0,35,28
1683716041572,MATH 142B,A01,188736,Ioana; Adrian,0,0,30,30
1683716041572,MATH 142B,A02,188741,Ioana; Adrian,0,1,30,30
1683716041572,MATH 142B,A03,188743,Ioana; Adrian,0,2,30,30
1683716042597,MATH 168A,A01,188790,Staff,0,11,35,35
1683716043629,MATH 170A,A01,188803,Nie; Jiawang,0,2,35,35
1683716043629,MATH 170A,A02,188811,Nie; Jiawang,0,1,35,35
1683716043629,MATH 170A,A03,188814,Nie; Jiawang,1,0,35,34
1683716043629,MATH 170A,A04,188815,Nie; Jiawang,5,0,35,30
1683716044653,MATH 193B,A01,188817,Staff,0,0,35,35
1683716044653,MATH 193B,A02,188818,Staff,6,0,35,29
1683716045689,MGT 4,A01,202857,Anderson; John Charles,59,0,80,21
1683716046720,MGT 12,A00,202858,Lindenberger; Wade Douglas,40,0,90,50
1683716047744,MGT 18,A00,202859,Staff,73,0,90,17
1683716048767,MGT 18GS,A00,202860,McKay; Michael J,13,0,28,15
1683716049792,MGT 45,A00,202861,Pecore; Joseph P.,8,0,90,82
1683716050820,MGT 100,A00,202863,Yavorsky; Daniel Ryan,27,0,90,63
1683716051850,MGT 103,A00,202864,Ehrich; Kristine R,0,19,90,90
1683716052875,MGT 112,A00,202865,Ehrich; Kristine R,15,0,90,75
1683716053906,MGT 121A,A00,202868,Staff,70,0,90,20
1683716054931,MGT 131B,A00,202869,Anderson; John Charles,58,0,90,32
1683716055955,MGT 136,A00,202871,Lindenberger; Wade Douglas,83,0,90,7
1683716056978,MGT 164,A00,202873,Staff,0,67,90,91
1683716058003,MGT 164GS,A00,202874,McKay; Mary A,13,0,28,15
1683716059029,MGT 180,A00,202875,Staff,0,51,90,91
1683716060059,MMW 11R,A01,205019,Herbst; Matthew,0,0,30,30
1683716060059,MMW 11R,A02,205026,Herbst; Matthew,29,0,30,1
1683716061085,MMW 15,A01,193512,Chang; Edmond Yi-Teh,0,8,28,28
1683716061085,MMW 15,A02,193513,Chang; Edmond Yi-Teh,0,5,28,28
1683716061085,MMW 15,A03,193514,Chang; Edmond Yi-Teh,0,5,28,28
1683716061085,MMW 15,A04,193515,Chang; Edmond Yi-Teh,0,5,28,28
1683716061085,MMW 15,A05,193516,Chang; Edmond Yi-Teh,0,5,28,28
1683716061085,MMW 15,A06,193517,Chang; Edmond Yi-Teh,0,6,28,28
1683716061085,MMW 15,B01,193519,Chang; Edmond Yi-Teh,0,5,28,28
1683716061085,MMW 15,B02,193520,Chang; Edmond Yi-Teh,0,5,28,28
1683716061085,MMW 15,B03,193521,Chang; Edmond Yi-Teh,0,5,28,28
1683716061085,MMW 15,B04,193522,Chang; Edmond Yi-Teh,0,6,28,28
1683716061085,MMW 15,B05,193523,Chang; Edmond Yi-Teh,0,5,28,28
1683716061085,MMW 15,B06,193524,Chang; Edmond Yi-Teh,0,5,28,28
1683716062114,MMW 122,A01,193526,Rahimi; Babak,0,16,28,28
1683716062114,MMW 122,A02,193527,Rahimi; Babak,0,15,28,28
1683716062114,MMW 122,A03,193528,Rahimi; Babak,0,0,0,0
1683716062114,MMW 122,A04,193529,Rahimi; Babak,0,0,0,0
1683716063140,MUS 1A,A01,186663,Staff,0,18,35,35
1683716064166,MUS 4,A01,186715,Staff,0,12,35,35
1683716065191,MUS 5R,A01,186796,Dubnov; Shlomo,0,17,35,35
1683716066220,MUS 6,A01,186798,Staff,0,4,25,25
1683716067247,MUS 7,A01,186830,Staff,11,0,35,24
1683716068332,MUS 8,A01,186930,Staff,0,27,35,35
1683716069356,MUS 15,A01,186932,Staff,0,15,35,35
1683716069356,MUS 15,B01,186934,Staff,0,16,35,35
1683716070382,MUS 80,A00,186935,Staff,0,0,20,20
1683716070382,MUS 80,B00,186936,Staff,24,0,25,1
1683716071413,NANO 11,A00,204702,Lipomi; Darren John,0,0,0,0
1683716072444,NANO 15,A01,204709,Yang; Kesong,0,1,0,0
1683716073475,NANO 114,A00,202069,Jahed Motlagh; Zeinab,2,0,10,8
1683716074501,PHIL 1,A00,186955,Grush; Rick Scott,31,0,40,9
1683716075526,PHIL 10,A01,186973,Grush; Rick Scott,27,0,35,8
1683716075526,PHIL 10,A02,186974,Grush; Rick Scott,33,0,35,2
1683716076554,PHIL 13,A01,186976,Staff,1,0,35,34
1683716076554,PHIL 13,A02,186977,Staff,16,0,35,19
1683716077582,PHIL 14,A01,186979,Staff,30,0,35,5
1683716077582,PHIL 14,A02,186986,Staff,32,0,35,3
1683716078606,PHIL 28,A01,186988,Staff,16,0,30,14
1683716078606,PHIL 28,A02,186989,Staff,0,0,30,30
1683716078606,PHIL 28,A03,186990,Staff,10,0,30,20
1683716078606,PHIL 28,A04,186991,Staff,26,0,30,4
1683716079630,PHIL 120,A00,186997,Staff,23,0,40,17
1683716080653,PHIL 137,A00,187003,Staff,8,0,40,32
1683716081681,PHIL 150,A00,187015,Staff,47,0,70,23
1683716082712,PHIL 167,A00,187021,Lamey; Andy M.,34,0,40,6
1683716083742,PHIL 174,A01,202226,Staff,17,0,20,3
1683716083742,PHIL 174,A02,202235,Staff,20,0,20,0
1683716084766,PHIL 191A,A00,258918,Staff,0,0,1,1
1683716085794,PHYS 1A,A00,187028,Staff,26,0,60,34
1683716086818,PHYS 1AL,001,187036,Staff,3,0,30,27
1683716086818,PHYS 1AL,002,187049,Staff,18,0,30,12
1683716087844,PHYS 1B,A00,187058,Staff,21,0,60,39
1683716088869,PHYS 1BL,001,187064,Staff,0,1,30,30
1683716088869,PHYS 1BL,002,187070,Staff,4,0,30,26
1683716089898,PHYS 1C,A00,187082,Staff,30,0,120,90
1683716090934,PHYS 1CL,001,187088,Staff,0,9,30,30
1683716090934,PHYS 1CL,002,187089,Staff,0,1,30,30
1683716090934,PHYS 1CL,009,262693,Staff,9,0,30,21
1683716091966,PHYS 2B,A01,187097,Staff,55,0,115,60
1683716092996,PHYS 2C,A01,187099,Staff,63,0,115,52
1683716094026,PHYS 2CL,A01,187101,Staff,5,0,28,23
1683716094026,PHYS 2CL,A02,187102,Staff,15,0,28,13
1683716095056,PHYS 2D,A01,187123,Shotwell; Brian,95,0,115,20
1683716096080,PHYS 4B,A01,187133,Grinstein; Benjamin,35,0,50,15
1683716097105,POLI 10,A00,188819,Staff,0,4,50,50
1683716098128,POLI 11,A00,188827,Staff,43,0,50,7
1683716099155,POLI 13R,A00,188828,Staff,0,2,20,20
1683716100181,POLI 27,A01,188830,Elgin; Samuel Zincke,0,2,70,70
1683716101206,POLI 30,A00,188832,Desposato; Scott,30,0,50,20
1683716102237,POLI 102F,A00,188834,Staff,1,0,40,39
1683716103261,POLI 104A,A00,188852,Staff,12,0,30,18
1683716104285,POLI 104I,A00,188853,Staff,0,8,20,20
1683716105318,POLI 110B,A00,188854,Wiens; David,6,0,20,14
1683716106343,POLI 112A,A00,188855,Wiens; David,3,0,30,27
1683716107368,POLI 117R,A00,188856,Forman; Fonna,0,12,20,20
1683716108392,POLI 118,A00,188857,Ingham; Sean,8,0,20,12
1683716109417,POLI 120G,A00,188858,Staff,7,0,30,23
1683716110442,POLI 131CR,A00,188863,Hoston; Germaine,20,0,50,30
1683716111467,POLI 133,A00,188864,Nellis; Gareth Hb,44,0,50,6
1683716112497,POLI 134D,A00,188865,Desposato; Scott,27,0,30,3
1683716113520,POLI 142A,A00,188871,Gartzke; Erik,21,0,50,29
1683716114544,POLI 142K,A00,188874,Staff,38,0,50,12
1683716115568,POLI 143,A00,188940,Gartzke; Erik,15,0,30,15
1683716116595,POLI 153,A00,188943,Staff,1,0,20,19
1683716117620,POLI 160AA,A00,188944,Staff,10,0,40,30
1683716118644,POLI 170A,A00,188945,Staff,10,0,30,20
1683716120698,PSYC 1,A00,188952,Staff,36,0,90,54
1683716121724,PSYC 2,B00,188953,Staff,19,0,35,16
1683716122747,PSYC 6,A00,188970,Staff,47,0,60,13
1683716123771,PSYC 7,A00,188973,Staff,35,0,45,10
1683716124797,PSYC 60,A01,188980,Rickard; Timothy C.,42,0,60,18
1683716125822,PSYC 70,A01,189001,Steiner; Eric Tomas,22,0,45,23
1683716126853,PSYC 100,A00,189005,Lacefield; Katharine I,1,98,120,119
1683716127877,PSYC 102,A00,189008,Staff,6,0,30,24
1683716128901,PSYC 106,B00,189026,Gorman; Michael R.,27,0,60,33
1683716129929,PSYC 114,B01,189033,Winkielman; Piotr,0,31,30,30
1683716130955,PSYC 131,A00,189036,Anagnostaras; Stephan,0,44,60,60
1683716131981,PSYC 136,A00,189041,Lowe; Angela Beth,0,7,25,25
1683716133005,PSYC 137,A00,189057,Winkielman; Piotr,0,36,25,25
1683716134032,PSYC 144,A00,189107,Wixted; John T,0,11,50,50
1683716136087,PSYC 162,A00,189142,Staff,0,9,85,85
1683716137110,PSYC 172,A00,189144,Gorman; Michael R.,0,6,30,30
1683716139161,PSYC 179,A00,189146,Lacefield; Katharine I,0,88,120,120
1683716140190,PSYC 181,A00,189147,Anagnostaras; Stephan,0,45,90,90
1683716141214,PSYC 190R,A00,189148,Barner; David A.,0,23,80,80
1683716142238,PSYC 191,A00,189275,Rickard; Timothy C.,0,11,25,25
1683716143266,PSYC 193,A00,189276,Chapman; Eddie Nathaniel,0,1,0,4
1683716144296,PSYC 193L,A01,189281,Lowe; Angela Beth,8,0,20,12
1683716144296,PSYC 193L,B01,189285,Staff,28,0,35,7
1683716145320,RELI 149,A00,187137,Rahimi; Babak,6,0,40,34
1683716146350,SE 9,A01,187315,Staff,0,2,18,18
1683716147377,SE 101B,A00,187409,Staff,24,0,30,6
1683716148401,SE 110B,A00,187444,Staff,10,0,40,30
1683716149426,SE 130B,A00,187449,Staff,31,0,40,9
1683716150455,SE 150A,A00,187516,Staff,8,0,20,12
1683716151478,SE 154,A00,187528,Staff,29,0,50,21
1683716152502,SIO 3,A01,258171,Staff,35,0,40,5
1683716153530,SIO 10,A00,187144,Cook; Geoffrey W,0,6,75,75
1683716154557,SIO 45,A00,187152,Cook; Geoffrey W,1,7,100,99
1683716155581,SIO 109R,A00,194486,Staff,0,4,20,20
1683716157632,SIO 187,A01,187233,Kacev; David,12,0,40,28
1683716158660,SOCI 1,A01,258656,Thorpe; Charles Robert,28,0,30,2
1683716158660,SOCI 1,A02,258658,Thorpe; Charles Robert,30,0,30,0
1683716158660,SOCI 1,A03,258661,Thorpe; Charles Robert,25,0,25,0
1683716158660,SOCI 1,A04,258666,Thorpe; Charles Robert,22,0,25,3
1683716158660,SOCI 1,A05,258897,Thorpe; Charles Robert,22,0,25,3
1683716158660,SOCI 1,A06,258898,Thorpe; Charles Robert,25,0,25,0
1683716159686,SOCI 30,A01,258903,Pardo Guerra; Juan Pablo,14,0,30,16
1683716160714,SOCI 102,A00,258904,Staff,9,0,25,16
1683716161743,SOCI 106,A00,258905,Staff,19,0,25,6
1683716162768,SOCI 111,A00,258907,Ribas Norris; Janet Vanesa,26,0,30,4
1683716163794,SOCI 121R,A00,258908,Pardo Guerra; Juan Pablo,7,0,30,23
1683716164821,SOCI 126,A01,203330,Staff,14,0,20,6
1683716165847,SOCI 131,A00,258909,Thorpe; Charles Robert,30,0,60,30
1683716166876,SOCI 135,A00,258910,Payne; Christine Anna,0,13,30,30
1683716167908,SOCI 157,A00,258911,Staff,10,0,30,20
1683716168932,SOCI 184,A00,258912,Staff,25,0,30,5
1683716169958,SOCI 188D,A00,258913,Staff,22,0,30,8
1683716170983,SYN 2,001,187529,Staff,9,0,16,7
1683716170983,SYN 2,002,201452,Staff,0,20,16,16
1683716170983,SYN 2,003,201469,Staff,1,0,16,15
1683716172064,SYN 100,A01,187531,Staff,0,9,20,20
1683716172064,SYN 100,B01,201491,Staff,0,10,20,20
1683716173091,TDAC 1,A00,189286,Walsh; Kim C.,3,0,20,17
1683716173091,TDAC 1,B00,189287,Harting; Carla Kelso,10,0,20,10
1683716174122,TDAC 101,A00,189300,Walsh; Kim C.,16,0,20,4
1683716174122,TDAC 101,B00,189301,Harting; Carla Kelso,18,0,20,2
1683716175152,TDAC 102,A00,189304,Basso; Beatrice,14,0,20,6
1683716176174,TDAC 108,A00,189305,Staff,18,0,20,2
1683716177200,TDDE 131,A00,189310,Staff,19,0,20,1
1683716177200,TDDE 131,B00,189314,Staff,19,0,20,1
1683716177200,TDDE 131,C00,189315,Staff,48,0,50,2
1683716177200,TDDE 131,D00,189316,Staff,14,0,15,1
1683716177200,TDDE 131,E00,204841,Staff,20,0,20,0
1683716178224,TDGE 10,A00,189289,Staff,27,0,50,23
1683716178224,TDGE 10,B00,189290,Havis; Allan,0,1,50,50
1683716179248,TDGE 11,A00,189291,Fulton; Julia,0,4,50,50
1683716179248,TDGE 11,B00,189292,Staff,20,0,25,5
1683716179248,TDGE 11,C00,260270,Staff,0,0,0,0
1683716180276,TDGE 25,A00,189294,Staff,1,0,20,19
1683716181307,TDGE 124,A00,189318,Fulton; Julia,0,7,50,50
1683716182333,TDGE 125,A00,189319,Staff,13,0,25,12
1683716182333,TDGE 125,B00,189320,Staff,23,0,25,2
1683716183363,TDGE 127,A00,189322,Havis; Allan,1,0,50,49
1683716184393,TDHT 101,A00,189323,Staff,18,0,25,7
1683716184393,TDHT 101,B00,189324,Staff,25,0,25,0
1683716185418,TDHT 102,A00,189325,Staff,49,0,50,1
1683716186448,TDMV 1,A00,189295,Arcidiacono; Kristin,20,0,30,10
1683716186448,TDMV 1,B00,189296,Caligagan; Maria T.,23,0,30,7
1683716187478,TDMV 2,A00,189297,Sammartano; Tonnie,27,0,30,3
1683716187478,TDMV 2,B00,189299,Arcidiacono; Kristin,23,0,30,7
1683716188507,TDMV 3,A00,204998,Rincon; Alicia,22,0,30,8
1683716189532,TDMV 120,A00,189458,Sammartano; Tonnie,28,0,30,2
1683716190562,TDMV 138,A00,189541,Jun; Grace Shin Hae,20,0,40,20
1683716191588,TDMV 142,A00,189717,Caligagan; Tony,25,0,30,5
1683716191588,TDMV 142,B00,189718,Caligagan; Maria T.,25,0,30,5
1683716192612,TMC 2,A01,187533,Staff,25,0,25,0
1683716192612,TMC 2,A02,187534,Staff,25,0,25,0
1683716193642,USP 1,A01,187536,Kwak; Nancy,0,16,25,25
1683716194666,USP 5,A01,187538,Staff,8,0,25,17
1683716195691,USP 101,A00,199253,Staff,0,4,0,0
1683716196716,USP 124,A00,187562,Boomhower; Matthew Charles,0,0,30,30
1683716197744,USP 138,A00,187582,Staff,19,0,25,6
1683716198773,USP 152,A01,187597,Staff,3,0,25,22
1683716199797,USP 153,A00,187598,Staff,18,0,25,7
1683716200822,USP 168,A00,187607,Kwak; Nancy,2,0,5,3
1683716201846,USP 173,A00,187619,Staff,4,0,25,21
1683716202871,USP 181,A00,187638,Staff,0,4,25,25
1683716203896,VIS 103,A00,187650,Cruz; Edwin Teddy,17,0,75,58
1683716204923,VIS 110D,A00,187669,Staff,13,0,22,9
1683716205954,VIS 127C,A00,187720,Shen; Kuiyi,67,0,146,79
1683716206980,VIS 149,A00,187731,Yoldas; Pinar,0,12,22,22
1683716208005,VIS 151,A01,188091,Staff,22,0,34,12
1683716208005,VIS 151,A02,188092,Staff,11,0,34,23
1683716209031,VIS 160B,A00,188093,Stalbaum; Brett,0,1,10,10
1683716211088,WCWP 10B,A00,201720,Staff,0,0,5,5
1683716211088,WCWP 10B,B00,201722,Staff,0,0,6,6
1683716212118,WCWP 100,A00,201725,Gagnon; Jeffrey C,0,0,2,2
1683716212118,WCWP 100,B00,201727,Staff,0,4,15,15
1683716215245,ANBI 133,A00,258401,Wilder; Linnea Lorene,34,0,40,6
1683716216273,ANBI 140,A00,258395,Hrvoj Mihic; Branka,18,0,25,7
1683716217303,ANSC 120,A00,258402,Bialecki; Jon Anthony,26,0,40,14
1683716218327,ANSC 144,A00,258400,Staff,12,0,40,28
1683716220376,ANSC 166,A00,258396,Parish; Steven Martin,156,0,175,19
1683716221400,ANSC 180,A00,193533,Staff,8,0,20,12
1683716222428,ANSC 188,A00,258397,Jassal; Aftab,34,0,40,6
1683716223456,ANTH 3,A01,258316,Staff,23,0,30,7
1683716224484,ANTH 5,A00,258394,Semendeferi; Ekaterini,16,0,20,4
1683716225509,ANTH 21,A01,258331,Staff,4,0,40,36
1683716226534,ANTH 103,A00,258398,Varma; Saiba,15,0,25,10
1683716227562,AWP 10,001,202034,Staff,0,0,0,0
1683716227562,AWP 10,002,202035,Staff,0,0,0,0
1683716227562,AWP 10,003,202036,Staff,0,0,0,0
1683716227562,AWP 10,004,202037,Staff,0,0,0,0
1683716227562,AWP 10,005,202038,Staff,0,0,0,0
1683716227562,AWP 10,006,202039,Staff,0,0,0,0
1683716227562,AWP 10,007,202040,Staff,0,0,0,0
1683716227562,AWP 10,008,202041,Staff,0,0,0,0
1683716227562,AWP 10,009,202042,Staff,0,0,0,0
1683716227562,AWP 10,010,202043,Staff,0,0,0,0
1683716227562,AWP 10,011,202044,Staff,0,0,0,0
1683716227562,AWP 10,012,202045,Staff,0,0,0,0
1683716227562,AWP 10,013,202046,Staff,0,0,0,0
1683716227562,AWP 10,014,202047,Staff,0,0,0,0
1683716227562,AWP 10,015,202048,Staff,0,0,0,0
1683716227562,AWP 10,016,202049,Staff,0,0,0,0
1683716227562,AWP 10,017,202050,Staff,0,0,0,0
1683716227562,AWP 10,018,202051,Staff,0,0,0,0
1683716227562,AWP 10,019,202052,Staff,0,0,0,0
1683716227562,AWP 10,020,202053,Staff,0,0,0,0
1683716227562,AWP 10,021,202054,Staff,0,0,0,0
1683716227562,AWP 10,022,202055,Staff,0,0,0,0
1683716227562,AWP 10,023,202056,Staff,0,0,0,0
1683716227562,AWP 10,024,202057,Staff,0,0,0,0
1683716227562,AWP 10,025,202058,Staff,0,0,0,0
1683716227562,AWP 10,026,202059,Staff,0,0,0,0
1683716228590,AWP 102,001,202032,Staff,0,0,0,0
1683716228590,AWP 102,002,202033,Staff,0,0,0,0
1683716229622,BENG 100,A01,254234,Taylor Amos; Alyssa C,31,0,40,9
1683716230647,BENG 196,001,270013,Engler; Adam J.,9999,0,9999,0
1683716231675,BICD 100R,A01,202018,Smith; Laurie,0,7,32,32
1683716231675,BICD 100R,A02,202019,Smith; Laurie,0,3,32,32
1683716231675,BICD 100R,A03,202020,Smith; Laurie,0,1,32,32
1683716231675,BICD 100R,A04,202021,Smith; Laurie,6,0,32,26
1683716231675,BICD 100R,A05,202022,Smith; Laurie,10,0,32,22
1683716232709,BICD 136,A01,193242,Gustafson-Brown; Cindy,0,2,32,32
1683716232709,BICD 136,A02,193244,Gustafson-Brown; Cindy,13,0,32,19
1683716233737,BIEB 102,A01,193249,Butler; Shannon Rhey,0,0,32,32
1683716233737,BIEB 102,A02,193251,Butler; Shannon Rhey,0,0,32,32
1683716233737,BIEB 102,A03,193253,Butler; Shannon Rhey,0,0,32,32
1683716233737,BIEB 102,A04,193255,Butler; Shannon Rhey,13,0,32,19
1683716233737,BIEB 102,A05,193265,Butler; Shannon Rhey,25,0,32,7
1683716233737,BIEB 102,A06,193269,Butler; Shannon Rhey,12,0,32,20
1683716235791,BIEB 150,A01,193274,Staff,0,0,32,32
1683716235791,BIEB 150,A02,193285,Staff,24,0,32,8
1683716236825,BIEB 194,A00,193286,Kurle; Carolyn M.,19,0,32,13
1683716237857,BILD 1,A01,192291,Staff,15,0,32,17
1683716237857,BILD 1,A02,192292,Staff,30,0,32,2
1683716237857,BILD 1,B01,192520,Reuther; Keefe,0,1,0,0
1683716237857,BILD 1,B02,192532,Reuther; Keefe,0,1,0,0
1683716238883,BILD 3,A01,192556,Butler; Shannon Rhey,0,0,32,32
1683716238883,BILD 3,A02,192581,Butler; Shannon Rhey,0,1,32,32
1683716238883,BILD 3,A03,192611,Butler; Shannon Rhey,19,0,32,13
1683716238883,BILD 3,A04,192612,Butler; Shannon Rhey,23,0,32,9
1683716238883,BILD 3,A05,192613,Butler; Shannon Rhey,26,0,32,6
1683716238883,BILD 3,A06,192679,Butler; Shannon Rhey,27,0,32,5
1683716238883,BILD 3,A07,192682,Butler; Shannon Rhey,20,0,32,12
1683716239909,BILD 4,A01,192836,Reuther; Keefe,1,0,24,23
1683716239909,BILD 4,A02,193044,Reuther; Keefe,4,0,24,20
1683716240934,BILD 10,A01,193142,Gustafson-Brown; Cindy,29,0,32,3
1683716240934,BILD 10,A02,193149,Gustafson-Brown; Cindy,31,0,32,1
1683716241957,BIMM 100,A01,193301,Staff,0,6,32,32
1683716241957,BIMM 100,A02,193312,Staff,0,7,32,32
1683716241957,BIMM 100,A03,193323,Staff,0,10,32,32
1683716242984,BIMM 101,A01,193329,McDonnell; Lisa Marie,0,3,24,24
1683716242984,BIMM 101,A02,193339,McDonnell; Lisa Marie,0,3,24,24
1683716242984,BIMM 101,B01,193354,McDonnell; Lisa Marie,0,4,24,24
1683716242984,BIMM 101,B02,193357,McDonnell; Lisa Marie,0,3,24,24
1683716244017,BIMM 110,A01,193377,Tat; John,0,11,32,32
1683716244017,BIMM 110,A02,193378,Tat; John,0,11,32,32
1683716245044,BIMM 120,A01,206116,Staff,0,0,32,32
1683716245044,BIMM 120,A02,206117,Staff,7,0,32,25
1683716245044,BIMM 120,A03,206121,Staff,21,0,32,11
1683716246069,BIPN 100,A01,193393,Park; Ji Young,0,15,32,32
1683716246069,BIPN 100,A02,193402,Park; Ji Young,0,14,32,32
1683716246069,BIPN 100,A03,193413,Park; Ji Young,0,14,32,32
1683716246069,BIPN 100,A04,193414,Park; Ji Young,0,13,32,32
1683716247094,BIPN 102,A01,193429,Staff,0,0,32,32
1683716247094,BIPN 102,A02,193438,Staff,18,0,32,14
1683716248124,BIPN 106,A01,193450,Reyes Gonzalez; Catalina,0,2,40,40
1683716249150,BIPN 134,A01,193465,Cooke; James Edward,0,0,32,32
1683716249150,BIPN 134,A02,193474,Cooke; James Edward,25,0,32,7
1683716249150,BIPN 134,A03,193485,Cooke; James Edward,29,0,32,3
1683716249150,BIPN 134,A04,193486,Cooke; James Edward,20,0,32,12
1683716249150,BIPN 134,A05,193491,Cooke; James Edward,31,0,32,1
1683716249150,BIPN 134,A06,193501,Cooke; James Edward,30,0,32,2
1683716249150,BIPN 134,A07,193510,Cooke; James Edward,29,0,32,3
1683716251203,BISP 194,A00,222522,Staff,14,0,32,18
1683716252231,CAT 124,A01,202407,Staff,19,0,25,6
1683716253260,CAT 125,A00,202408,Marchisotto; Jennifer Anne,2,0,20,18
1683716254285,CAT 125R,A00,202409,Smith; Lauryn Alissa,0,11,20,20
1683716254285,CAT 125R,B00,202410,Morales; Celeste Georgianna,0,11,20,20
1683716254285,CAT 125R,C00,202411,Irwin; Matthew Joseph,0,12,20,20
1683716255313,CENG 15,A01,204712,Yang; Kesong,0,1,0,0
1683716256345,CENG 114,A00,202070,Jahed Motlagh; Zeinab,5,0,20,15
1683716257376,CGS 105,A00,185477,Wesling; Megan E.,24,0,40,16
1683716258402,CGS 106,A00,185494,Staff,11,0,22,11
1683716259429,CGS 108,A00,185495,Staff,14,0,20,6
1683716260453,CGS 114,A00,185496,Staff,13,0,18,5
1683716261489,CGS 119,A00,185501,Staff,15,0,20,5
1683716262518,CGS 120,A00,185511,Staff,11,0,20,9
1683716263548,CHEM 4,A01,184675,Bussey; Thomas J,97,0,100,3
1683716264578,CHEM 6A,A01,184677,Staff,32,0,60,28
1683716265608,CHEM 6B,A01,184679,Staff,63,0,100,37
1683716266633,CHEM 6C,A01,184681,Bussey; Thomas J,0,0,50,50
1683716266633,CHEM 6C,A02,184682,Bussey; Thomas J,32,0,50,18
1683716267662,CHEM 40A,A01,184684,Albizati; Kim F.,33,0,100,67
1683716268692,CHEM 40B,A01,184686,Albizati; Kim F.,0,22,100,100
1683716269720,CHEM 41B,A01,184690,Staff,51,0,100,49
1683716270749,COGS 3,A01,184715,Boyle; Mary E. T.,0,27,40,40
1683716271775,COGS 14B,A01,185172,Staff,0,14,38,38
1683716272799,COGS 18,A01,184736,Staff,14,0,80,66
1683716273829,COGS 100,A01,184932,Staff,0,8,73,73
1683716274854,COGS 101A,A01,184935,Staff,0,40,30,30
1683716275940,COGS 101B,A01,184944,Staff,0,2,30,30
1683716276972,COGS 101C,A01,184946,Staff,0,10,30,30
1683716278003,COGS 102A,A01,184951,Johnson; Christine M.,1,0,40,39
1683716279029,COGS 107B,A01,184953,Mooshagian; Eric Frederick,0,52,40,40
1683716280058,COGS 118B,A01,184959,Gupta; Anjum,0,50,40,40
1683716281086,COGS 153,A00,184961,Staff,1,16,30,29
1683716282114,COGS 177,A00,184962,Staff,0,20,30,30
1683716283142,COGS 187A,A01,184969,Boyle; Mary E. T.,0,19,40,40
1683716284168,COMM 10,A01,185174,Staff,0,5,25,25
1683716284168,COMM 10,A02,185189,Staff,0,2,25,25
1683716284168,COMM 10,A03,269821,Staff,0,1,0,0
1683716285194,COMM 100B,A02,185476,Staff,10,0,25,15
1683716285194,COMM 100B,A03,277340,Staff,25,0,25,0
1683716286218,COMM 100C,A01,185314,Staff,2,0,25,23
1683716286218,COMM 100C,A02,185327,Staff,17,0,25,8
1683716287246,COMM 110M,A00,185349,Staff,0,0,40,40
1683716288273,COMM 113T,A00,185352,Staff,25,0,40,15
1683716289298,COMM 114I,A00,185353,Staff,31,0,40,9
1683716290323,COMM 131,A00,185354,Staff,17,0,30,13
1683716291348,CSE 8A,A50,185358,Cao; Yingjun,0,46,10,10
1683716292380,CSE 8B,A01,185362,Staff,0,48,50,50
1683716293409,CSE 11,A01,185416,Cao; Yingjun,0,91,10,10
1683716294434,CSE 20,A01,185445,Briones; Jor-el Thomas Caparas,3,0,25,22
1683716295459,CSE 21,A01,185447,Staff,9,0,50,41
1683716296483,CSE 101,A01,185451,Staff,0,13,50,50
1683716296483,CSE 101,B01,185453,Jones; Miles E,0,15,50,50
1683716298542,CSE 141,A01,185458,Eldon; John,16,0,100,84
1683716299567,CSE 141L,A01,185461,Eldon; John,8,0,100,92
1683716300593,CSE 142,A01,185463,Staff,34,0,60,26
1683716300593,CSE 142,B01,201355,Staff,0,7,60,60
1683716301617,CSE 142L,A01,185470,Staff,34,0,60,26
1683716301617,CSE 142L,B01,201417,Staff,0,6,60,60
1683716302645,CSE 190,A00,201433,Staff,32,0,49,17
1683716303675,DOC 1,A01,259136,Strom; Megan C.,7,0,15,8
1683716303675,DOC 1,A02,259137,Strom; Megan C.,15,0,15,0
1683716303675,DOC 1,A03,259138,Strom; Megan C.,14,0,15,1
1683716303675,DOC 1,A04,259139,Strom; Megan C.,13,0,15,2
1683716304703,DOC 100D,A00,259140,Pass; Natalye Joann,14,0,25,11
1683716305728,DSGN 1,A01,184749,Rill; Bryan,0,26,30,30
1683716306753,DSGN 100,A01,185168,Staff,0,2,25,25
1683716307780,ECE 5,A01,185626,Morris; Karcher William,0,12,0,0
1683716308806,ECE 101,A01,185628,Staff,14,0,70,56
1683716309831,ECE 107,A01,185635,Baghdadchi; Saharnaz,0,0,20,20
1683716309831,ECE 107,A02,185638,Baghdadchi; Saharnaz,1,0,20,19
1683716310856,ECE 148,A01,185647,Silberman; Jack,0,0,16,16
1683716311881,ECON 1,A01,185537,Crane; Meredith Helen,54,0,70,16
1683716312906,ECON 3,A01,185549,Crane; Meredith Helen,30,0,70,40
1683716313931,ECON 4,A01,203354,Anderson; John Charles,0,5,10,10
1683716314956,ECON 100A,A01,185574,Staff,0,5,40,40
1683716315981,ECON 100B,A01,185576,Staff,0,12,50,50
1683716317011,ECON 100C,A01,185589,Newhouse; Herbert S,30,0,70,40
1683716318039,ECON 105,A00,185608,Vespa; Emanuel Ignacio,19,0,35,16
1683716319065,ECON 109,A01,185610,Shishkin; Denis,9,0,35,26
1683716320088,ECON 110A,A01,185612,Staff,8,0,40,32
1683716321116,ECON 120A,A01,185615,Staff,19,0,40,21
1683716322145,ECON 120C,A01,185617,Sun; Yixiao,0,21,70,70
1683716323176,ECON 144,A00,203346,Squires; Dale E,2,0,35,33
1683716324201,ECON 171,A01,203349,Newhouse; Herbert S,0,1,35,35
1683716325234,ECON 173A,A01,185621,Toda; Alexis Akira,21,0,35,14
1683716326267,EDS 25,A01,202413,Staff,0,1,0,0
1683716326267,EDS 25,A02,202414,Staff,0,1,0,0
1683716326267,EDS 25,A03,202415,Staff,0,0,0,0
1683716326267,EDS 25,A04,202416,Staff,0,1,0,0
1683716326267,EDS 25,A05,202439,Staff,0,0,0,0
1683716326267,EDS 25,A06,202440,Staff,0,0,0,0
1683716326267,EDS 25,B01,202631,Staff,0,0,0,0
1683716326267,EDS 25,B02,202632,Staff,0,0,0,0
1683716326267,EDS 25,B03,202639,Staff,0,0,0,0
1683716326267,EDS 25,B04,202640,Staff,0,0,0,0
1683716326267,EDS 25,B05,202643,Staff,0,0,0,0
1683716326267,EDS 25,B06,202644,Staff,0,0,0,0
1683716327293,EDS 38,A01,202659,Black; Alison Michelle,25,0,25,0
1683716328322,EDS 115,A00,202652,Staff,18,0,30,12
1683716329347,EDS 125,A00,202649,Staff,13,0,30,17
1683716330376,EDS 126,A01,203332,Staff,30,0,30,0
1683716331400,EDS 139,A00,202838,Staff,16,0,25,9
1683716332425,EDS 146,A01,202655,Staff,14,0,25,11
1683716333451,ENG 15,A00,185667,Staff,0,1,0,0
1683716333451,ENG 15,B00,185672,Staff,0,0,0,0
1683716333451,ENG 15,C00,185675,Staff,0,0,0,0
1683716333451,ENG 15,D00,185682,Staff,0,0,0,0
1683716333451,ENG 15,E00,185684,Staff,0,0,0,0
1683716334475,ETHN 103,A00,185710,Staff,0,8,35,35
1683716335500,ETHN 103A,A00,199228,Man; Simeon S,0,0,9,9
1683716336525,ETHN 109,A00,185711,Staff,15,0,35,20
1683716337548,ETHN 142,A00,185726,Staff,0,4,30,30
1683716338576,ETHN 163J,A00,199229,Man; Simeon S,5,0,8,3
1683716339604,ETHN 168,A00,185727,Staff,7,0,10,3
1683716340630,ETHN 182,A00,185728,Staff,0,0,35,35
1683716341660,ETHN 183,A00,185737,Staff,10,0,18,8
1683716342691,GLBH 111,A01,209361,Burgos; Jose L.,0,0,0,0
1683716344745,HIEU 104,A00,185792,Staff,14,0,20,6
1683716345775,HIEU 115,A00,185800,Staff,0,0,20,20
1683716346800,HIEU 128,A00,185801,Staff,0,9,20,20
1683716347826,HIEU 147,A00,185802,Staff,15,0,20,5
1683716348854,HIEU 154,A00,185823,Staff,11,0,20,9
1683716349877,HILA 102,A00,185826,Staff,14,0,20,6
1683716350906,HILD 2C,A01,185778,Staff,0,13,20,20
1683716351931,HILD 7B,A01,185780,Kwak; Nancy,0,17,32,32
1683716351931,HILD 7B,A02,185781,Kwak; Nancy,0,18,32,32
1683716352960,HILD 30,A01,185791,Staff,12,0,20,8
1683716353984,HISC 119,A00,185830,Golan; Tal,0,10,20,20
1683716355009,HITO 156GS,A00,185831,Patterson; Patrick H.,0,0,0,23
1683716356033,HIUS 103,A00,185832,Man; Simeon S,0,4,20,20
1683716357060,HIUS 117,A00,185836,Kwak; Nancy,2,0,20,18
1683716358088,HIUS 125,A00,185840,Man; Simeon S,0,2,23,23
1683716359116,HIUS 149,A00,185845,Staff,1,0,20,19
1683716360142,HUM 3,A01,185882,Zavodny; Tatiana Sophia,0,8,50,50
1683716360142,HUM 3,B01,185899,Caldwell; Michael Alan,0,18,50,50
1683716361167,HUM 3GS,A00,185900,Patterson; Patrick H.,0,0,0,23
1683716362195,HUM 4,A01,185938,Zroka; Amy Liane,28,0,50,22
1683716362195,HUM 4,B01,185956,Watkins; Eric,0,6,50,50
1683716362195,HUM 4,B02,202209,Watkins; Eric,0,6,50,50
1683716362195,HUM 4,B03,202210,Watkins; Eric,0,5,50,50
1683716363219,HUM 5,A01,185958,West; Geoffrey Scott,0,0,50,50
1683716363219,HUM 5,A02,202215,West; Geoffrey Scott,0,1,50,50
1683716364244,INTL 190,A00,185959,Gagnon; Jeffrey C,0,0,0,9
1683716364244,INTL 190,B00,185960,Lettieri; Michael Joseph,0,0,0,2
1683716365273,JAPN 180,A00,254509,Staff,5,0,30,25
1683716366306,LATI 10,A01,202853,Kennemore; Amy Michelle,4,0,35,31
1683716366306,LATI 10,A02,202854,Kennemore; Amy Michelle,3,0,35,32
1683716366306,LATI 10,A03,270054,Kennemore; Amy Michelle,30,0,30,0
1683716367332,LATI 180,A00,202855,Kennemore; Amy Michelle,11,0,20,9
1683716368356,LAWS 101,A00,201767,Golan; Tal,0,7,40,40
1683716369381,LIFR 1C,A00,185961,Staff,6,0,20,14
1683716370408,LIFR 1CX,A00,185962,Staff,7,0,20,13
1683716371432,LIFR 1D,A00,185963,Staff,7,0,20,13
1683716372459,LIFR 1DX,A00,185964,Staff,7,0,20,13
1683716373489,LIGN 101,A01,186039,Staff,43,0,50,7
1683716374517,LIGN 165,A00,186040,Staff,14,0,50,36
1683716375543,LTCS 108,A00,186041,Staff,5,0,10,5
1683716376567,LTCS 119,A00,186042,Staff,15,0,20,5
1683716377597,LTCS 130,A00,186043,Wesling; Megan E.,15,0,25,10
1683716379711,LTEA 138,A00,186119,Staff,14,0,40,26
1683716380735,LTEN 124,A00,186148,Staff,5,0,25,20
1683716381761,LTEN 178,A00,186149,Staff,6,0,15,9
1683716382792,LTEN 181,A00,186150,Blanco; John D,34,0,40,6
1683716383817,LTWL 120,A00,186160,Staff,19,0,25,6
1683716384842,LTWL 165,A00,186161,Staff,22,0,25,3
1683716385866,LTWR 100,A00,186162,Staff,0,5,15,15
1683716386891,LTWR 102,A00,186163,Doller; Ben,5,0,15,10
1683716387920,MAE 8,A01,186412,Staff,0,1,0,0
1683716388946,MAE 30B,A00,186445,Bahadori; Mohammad Yousef,81,0,100,19
1683716389971,MAE 40,A00,186592,Bewley; Thomas R,10,0,50,40
1683716390999,MAE 101B,A00,186593,Bahadori; Mohammad Yousef,80,0,100,20
1683716392025,MAE 105,A00,186594,Bandaru; Prabhakar,10,0,50,40
1683716393051,MAE 107,A00,186599,Pham; Hieu Tan,0,8,120,120
1683716394076,MAE 148,A01,186660,Silberman; Jack,3,0,16,13
1683716395101,MATH 10A,A01,188095,Staff,0,6,35,35
1683716396133,MATH 10B,A01,188097,Bowers; Adam R.,0,12,30,30
1683716396133,MATH 10B,A02,188099,Bowers; Adam R.,0,11,30,30
1683716396133,MATH 10B,B01,188104,Bowers; Adam R.,0,10,30,30
1683716396133,MATH 10B,B02,188106,Bowers; Adam R.,0,9,30,30
1683716397167,MATH 10C,A01,188111,Staff,0,20,30,30
1683716397167,MATH 10C,A02,188127,Staff,0,19,30,30
1683716397167,MATH 10C,A03,188131,Staff,0,19,30,30
1683716397167,MATH 10C,B01,188218,Staff,17,0,30,13
1683716397167,MATH 10C,B02,188244,Staff,13,0,30,17
1683716397167,MATH 10C,B03,188277,Staff,14,0,30,16
1683716398192,MATH 18,A01,188344,Bach; Quang Tran,18,0,30,12
1683716398192,MATH 18,A02,188345,Bach; Quang Tran,11,0,30,19
1683716398192,MATH 18,B01,188353,Bach; Quang Tran,11,0,30,19
1683716398192,MATH 18,B02,188354,Bach; Quang Tran,19,0,30,11
1683716399217,MATH 20A,A01,188374,Staff,11,0,35,24
1683716400242,MATH 20B,A01,188382,Ohm; Ko Woon,7,0,30,23
1683716400242,MATH 20B,A02,188383,Ohm; Ko Woon,22,0,30,8
1683716400242,MATH 20B,B01,188385,Ohm; Ko Woon,7,0,30,23
1683716400242,MATH 20B,B02,188392,Ohm; Ko Woon,22,0,30,8
1683716401267,MATH 20C,A01,188394,Harel; Guershon,10,0,30,20
1683716401267,MATH 20C,A02,188395,Harel; Guershon,13,0,30,17
1683716401267,MATH 20C,B01,188404,Harel; Guershon,5,0,30,25
1683716401267,MATH 20C,B02,188405,Harel; Guershon,18,0,30,12
1683716402298,MATH 20D,A01,188414,Hammock; Frances H,0,1,30,30
1683716402298,MATH 20D,A02,188415,Hammock; Frances H,0,1,30,30
1683716402298,MATH 20D,B01,188447,Hammock; Frances H,0,1,30,30
1683716402298,MATH 20D,B02,188486,Hammock; Frances H,2,0,30,28
1683716403329,MATH 20E,A01,188649,Staff,21,0,30,9
1683716403329,MATH 20E,A02,188650,Staff,20,0,30,10
1683716403329,MATH 20E,A03,188673,Staff,0,0,30,30
1683716404358,MATH 102,A01,188675,Staff,0,40,35,35
1683716405383,MATH 103B,A01,188681,Staff,3,0,35,32
1683716405383,MATH 103B,B01,188692,Staff,5,0,35,30
1683716406407,MATH 109,A01,188695,Salehi Golsefidy; Alireza,24,0,35,11
1683716406407,MATH 109,A02,188696,Salehi Golsefidy; Alireza,24,0,35,11
1683716407436,MATH 120A,A01,188698,Eggers; John Dietrich,7,0,35,28
1683716408466,MATH 142B,A01,188736,Ioana; Adrian,0,0,30,30
1683716408466,MATH 142B,A02,188741,Ioana; Adrian,0,1,30,30
1683716408466,MATH 142B,A03,188743,Ioana; Adrian,0,2,30,30
1683716409490,MATH 168A,A01,188790,Staff,0,11,35,35
1683716410521,MATH 170A,A01,188803,Nie; Jiawang,0,2,35,35
1683716410521,MATH 170A,A02,188811,Nie; Jiawang,0,1,35,35
1683716410521,MATH 170A,A03,188814,Nie; Jiawang,1,0,35,34
1683716410521,MATH 170A,A04,188815,Nie; Jiawang,5,0,35,30
1683716411546,MATH 193B,A01,188817,Staff,0,0,35,35
1683716411546,MATH 193B,A02,188818,Staff,6,0,35,29
1683716412579,MGT 4,A01,202857,Anderson; John Charles,59,0,80,21
1683716413610,MGT 12,A00,202858,Lindenberger; Wade Douglas,40,0,90,50
1683716414638,MGT 18,A00,202859,Staff,73,0,90,17
1683716415667,MGT 18GS,A00,202860,McKay; Michael J,13,0,28,15
1683716416698,MGT 45,A00,202861,Pecore; Joseph P.,8,0,90,82
1683716417724,MGT 100,A00,202863,Yavorsky; Daniel Ryan,27,0,90,63
1683716418749,MGT 103,A00,202864,Ehrich; Kristine R,0,19,90,90
1683716419775,MGT 112,A00,202865,Ehrich; Kristine R,15,0,90,75
1683716420802,MGT 121A,A00,202868,Staff,70,0,90,20
1683716421832,MGT 131B,A00,202869,Anderson; John Charles,58,0,90,32
1683716422861,MGT 136,A00,202871,Lindenberger; Wade Douglas,83,0,90,7
1683716423886,MGT 164,A00,202873,Staff,0,67,90,91
1683716424910,MGT 164GS,A00,202874,McKay; Mary A,13,0,28,15
1683716425939,MGT 180,A00,202875,Staff,0,51,90,91
1683716426968,MMW 11R,A01,205019,Herbst; Matthew,0,0,30,30
1683716426968,MMW 11R,A02,205026,Herbst; Matthew,29,0,30,1
1683716427994,MMW 15,A01,193512,Chang; Edmond Yi-Teh,0,8,28,28
1683716427994,MMW 15,A02,193513,Chang; Edmond Yi-Teh,0,5,28,28
1683716427994,MMW 15,A03,193514,Chang; Edmond Yi-Teh,0,5,28,28
1683716427994,MMW 15,A04,193515,Chang; Edmond Yi-Teh,0,5,28,28
1683716427994,MMW 15,A05,193516,Chang; Edmond Yi-Teh,0,5,28,28
1683716427994,MMW 15,A06,193517,Chang; Edmond Yi-Teh,0,6,28,28
1683716427994,MMW 15,B01,193519,Chang; Edmond Yi-Teh,0,5,28,28
1683716427994,MMW 15,B02,193520,Chang; Edmond Yi-Teh,0,5,28,28
1683716427994,MMW 15,B03,193521,Chang; Edmond Yi-Teh,0,5,28,28
1683716427994,MMW 15,B04,193522,Chang; Edmond Yi-Teh,0,6,28,28
1683716427994,MMW 15,B05,193523,Chang; Edmond Yi-Teh,0,5,28,28
1683716427994,MMW 15,B06,193524,Chang; Edmond Yi-Teh,0,5,28,28
1683716429019,MMW 122,A01,193526,Rahimi; Babak,0,16,28,28
1683716429019,MMW 122,A02,193527,Rahimi; Babak,0,15,28,28
1683716429019,MMW 122,A03,193528,Rahimi; Babak,0,0,0,0
1683716429019,MMW 122,A04,193529,Rahimi; Babak,0,0,0,0
1683716430045,MUS 1A,A01,186663,Staff,0,18,35,35
1683716431073,MUS 4,A01,186715,Staff,0,12,35,35
1683716432101,MUS 5R,A01,186796,Dubnov; Shlomo,0,17,35,35
1683716433128,MUS 6,A01,186798,Staff,0,4,25,25
1683716434152,MUS 7,A01,186830,Staff,11,0,35,24
1683716435176,MUS 8,A01,186930,Staff,0,27,35,35
1683716436200,MUS 15,A01,186932,Staff,0,15,35,35
1683716436200,MUS 15,B01,186934,Staff,0,16,35,35
1683716437224,MUS 80,A00,186935,Staff,0,0,20,20
1683716437224,MUS 80,B00,186936,Staff,24,0,25,1
1683716438249,NANO 11,A00,204702,Lipomi; Darren John,0,0,0,0
1683716439275,NANO 15,A01,204709,Yang; Kesong,0,1,0,0
1683716440301,NANO 114,A00,202069,Jahed Motlagh; Zeinab,2,0,10,8
1683716441328,PHIL 1,A00,186955,Grush; Rick Scott,31,0,40,9
1683716442359,PHIL 10,A01,186973,Grush; Rick Scott,27,0,35,8
1683716442359,PHIL 10,A02,186974,Grush; Rick Scott,33,0,35,2
1683716443387,PHIL 13,A01,186976,Staff,1,0,35,34
1683716443387,PHIL 13,A02,186977,Staff,16,0,35,19
1683716444417,PHIL 14,A01,186979,Staff,30,0,35,5
1683716444417,PHIL 14,A02,186986,Staff,32,0,35,3
1683716445441,PHIL 28,A01,186988,Staff,16,0,30,14
1683716445441,PHIL 28,A02,186989,Staff,0,0,30,30
1683716445441,PHIL 28,A03,186990,Staff,10,0,30,20
1683716445441,PHIL 28,A04,186991,Staff,26,0,30,4
1683716446469,PHIL 120,A00,186997,Staff,23,0,40,17
1683716447496,PHIL 137,A00,187003,Staff,8,0,40,32
1683716448521,PHIL 150,A00,187015,Staff,47,0,70,23
1683716449550,PHIL 167,A00,187021,Lamey; Andy M.,34,0,40,6
1683716450577,PHIL 174,A01,202226,Staff,17,0,20,3
1683716450577,PHIL 174,A02,202235,Staff,20,0,20,0
1683716451606,PHIL 191A,A00,258918,Staff,0,0,1,1
1683716452631,PHYS 1A,A00,187028,Staff,26,0,60,34
1683716453660,PHYS 1AL,001,187036,Staff,3,0,30,27
1683716453660,PHYS 1AL,002,187049,Staff,18,0,30,12
1683716454687,PHYS 1B,A00,187058,Staff,21,0,60,39
1683716455713,PHYS 1BL,001,187064,Staff,0,1,30,30
1683716455713,PHYS 1BL,002,187070,Staff,4,0,30,26
1683716456741,PHYS 1C,A00,187082,Staff,30,0,120,90
1683716457765,PHYS 1CL,001,187088,Staff,0,9,30,30
1683716457765,PHYS 1CL,002,187089,Staff,0,1,30,30
1683716457765,PHYS 1CL,009,262693,Staff,9,0,30,21
1683716458790,PHYS 2B,A01,187097,Staff,55,0,115,60
1683716459817,PHYS 2C,A01,187099,Staff,63,0,115,52
1683716460846,PHYS 2CL,A01,187101,Staff,5,0,28,23
1683716460846,PHYS 2CL,A02,187102,Staff,15,0,28,13
1683716461879,PHYS 2D,A01,187123,Shotwell; Brian,95,0,115,20
1683716462919,PHYS 4B,A01,187133,Grinstein; Benjamin,35,0,50,15
1683716463943,POLI 10,A00,188819,Staff,0,4,50,50
1683716464967,POLI 11,A00,188827,Staff,43,0,50,7
1683716465991,POLI 13R,A00,188828,Staff,0,2,20,20
1683716467018,POLI 27,A01,188830,Elgin; Samuel Zincke,0,2,70,70
1683716468049,POLI 30,A00,188832,Desposato; Scott,30,0,50,20
1683716469080,POLI 102F,A00,188834,Staff,1,0,40,39
1683716470105,POLI 104A,A00,188852,Staff,12,0,30,18
1683716471132,POLI 104I,A00,188853,Staff,0,8,20,20
1683716472163,POLI 110B,A00,188854,Wiens; David,6,0,20,14
1683716473190,POLI 112A,A00,188855,Wiens; David,3,0,30,27
1683716474217,POLI 117R,A00,188856,Forman; Fonna,0,12,20,20
1683716475245,POLI 118,A00,188857,Ingham; Sean,8,0,20,12
1683716476269,POLI 120G,A00,188858,Staff,7,0,30,23
1683716477294,POLI 131CR,A00,188863,Hoston; Germaine,20,0,50,30
1683716478322,POLI 133,A00,188864,Nellis; Gareth Hb,44,0,50,6
1683716479351,POLI 134D,A00,188865,Desposato; Scott,27,0,30,3
1683716480380,POLI 142A,A00,188871,Gartzke; Erik,21,0,50,29
1683716481410,POLI 142K,A00,188874,Staff,38,0,50,12
1683716482434,POLI 143,A00,188940,Gartzke; Erik,15,0,30,15
1683716483517,POLI 153,A00,188943,Staff,1,0,20,19
1683716484547,POLI 160AA,A00,188944,Staff,10,0,40,30
1683716485572,POLI 170A,A00,188945,Staff,10,0,30,20
1683716487625,PSYC 1,A00,188952,Staff,36,0,90,54
1683716488650,PSYC 2,B00,188953,Staff,19,0,35,16
1683716489677,PSYC 6,A00,188970,Staff,47,0,60,13
1683716490702,PSYC 7,A00,188973,Staff,35,0,45,10
1683716491728,PSYC 60,A01,188980,Rickard; Timothy C.,42,0,60,18
1683716492763,PSYC 70,A01,189001,Steiner; Eric Tomas,22,0,45,23
1683716493791,PSYC 100,A00,189005,Lacefield; Katharine I,1,98,120,119
1683716494814,PSYC 102,A00,189008,Staff,6,0,30,24
1683716495838,PSYC 106,B00,189026,Gorman; Michael R.,27,0,60,33
1683716496866,PSYC 114,B01,189033,Winkielman; Piotr,0,31,30,30
1683716497891,PSYC 131,A00,189036,Anagnostaras; Stephan,0,44,60,60
1683716498917,PSYC 136,A00,189041,Lowe; Angela Beth,0,7,25,25
1683716499942,PSYC 137,A00,189057,Winkielman; Piotr,0,36,25,25
1683716500970,PSYC 144,A00,189107,Wixted; John T,0,11,50,50
1683716503023,PSYC 162,A00,189142,Staff,0,9,85,85
1683716504050,PSYC 172,A00,189144,Gorman; Michael R.,0,6,30,30
1683716506098,PSYC 179,A00,189146,Lacefield; Katharine I,0,88,120,120
1683716507123,PSYC 181,A00,189147,Anagnostaras; Stephan,0,45,90,90
1683716508153,PSYC 190R,A00,189148,Barner; David A.,0,23,80,80
1683716509177,PSYC 191,A00,189275,Rickard; Timothy C.,0,11,25,25
1683716510205,PSYC 193,A00,189276,Chapman; Eddie Nathaniel,0,1,0,4
1683716511229,PSYC 193L,A01,189281,Lowe; Angela Beth,8,0,20,12
1683716511229,PSYC 193L,B01,189285,Staff,28,0,35,7
1683716512256,RELI 149,A00,187137,Rahimi; Babak,6,0,40,34
1683716513284,SE 9,A01,187315,Staff,0,2,18,18
1683716514309,SE 101B,A00,187409,Staff,24,0,30,6
1683716515333,SE 110B,A00,187444,Staff,10,0,40,30
1683716516362,SE 130B,A00,187449,Staff,31,0,40,9
1683716517390,SE 150A,A00,187516,Staff,8,0,20,12
1683716518415,SE 154,A00,187528,Staff,29,0,50,21
1683716519442,SIO 3,A01,258171,Staff,35,0,40,5
1683716520465,SIO 10,A00,187144,Cook; Geoffrey W,0,6,75,75
1683716521491,SIO 45,A00,187152,Cook; Geoffrey W,1,7,100,99
1683716522518,SIO 109R,A00,194486,Staff,0,4,20,20
1683716524569,SIO 187,A01,187233,Kacev; David,12,0,40,28
1683716525593,SOCI 1,A01,258656,Thorpe; Charles Robert,28,0,30,2
1683716525593,SOCI 1,A02,258658,Thorpe; Charles Robert,30,0,30,0
1683716525593,SOCI 1,A03,258661,Thorpe; Charles Robert,25,0,25,0
1683716525593,SOCI 1,A04,258666,Thorpe; Charles Robert,22,0,25,3
1683716525593,SOCI 1,A05,258897,Thorpe; Charles Robert,22,0,25,3
1683716525593,SOCI 1,A06,258898,Thorpe; Charles Robert,25,0,25,0
1683716526619,SOCI 30,A01,258903,Pardo Guerra; Juan Pablo,14,0,30,16
1683716527644,SOCI 102,A00,258904,Staff,9,0,25,16
1683716528670,SOCI 106,A00,258905,Staff,19,0,25,6
1683716529697,SOCI 111,A00,258907,Ribas Norris; Janet Vanesa,26,0,30,4
1683716530720,SOCI 121R,A00,258908,Pardo Guerra; Juan Pablo,7,0,30,23
1683716531743,SOCI 126,A01,203330,Staff,14,0,20,6
1683716532766,SOCI 131,A00,258909,Thorpe; Charles Robert,30,0,60,30
1683716533794,SOCI 135,A00,258910,Payne; Christine Anna,0,13,30,30
1683716534818,SOCI 157,A00,258911,Staff,10,0,30,20
1683716535841,SOCI 184,A00,258912,Staff,25,0,30,5
1683716536869,SOCI 188D,A00,258913,Staff,22,0,30,8
1683716537897,SYN 2,001,187529,Staff,9,0,16,7
1683716537897,SYN 2,002,201452,Staff,0,20,16,16
1683716537897,SYN 2,003,201469,Staff,1,0,16,15
1683716538920,SYN 100,A01,187531,Staff,0,9,20,20
1683716538920,SYN 100,B01,201491,Staff,0,10,20,20
1683716539945,TDAC 1,A00,189286,Walsh; Kim C.,3,0,20,17
1683716539945,TDAC 1,B00,189287,Harting; Carla Kelso,10,0,20,10
1683716540974,TDAC 101,A00,189300,Walsh; Kim C.,16,0,20,4
1683716540974,TDAC 101,B00,189301,Harting; Carla Kelso,18,0,20,2
1683716542002,TDAC 102,A00,189304,Basso; Beatrice,14,0,20,6
1683716543025,TDAC 108,A00,189305,Staff,18,0,20,2
1683716544049,TDDE 131,A00,189310,Staff,19,0,20,1
1683716544049,TDDE 131,B00,189314,Staff,19,0,20,1
1683716544049,TDDE 131,C00,189315,Staff,48,0,50,2
1683716544049,TDDE 131,D00,189316,Staff,14,0,15,1
1683716544049,TDDE 131,E00,204841,Staff,20,0,20,0
1683716545077,TDGE 10,A00,189289,Staff,27,0,50,23
1683716545077,TDGE 10,B00,189290,Havis; Allan,0,1,50,50
1683716546104,TDGE 11,A00,189291,Fulton; Julia,0,4,50,50
1683716546104,TDGE 11,B00,189292,Staff,20,0,25,5
1683716546104,TDGE 11,C00,260270,Staff,0,0,0,0
1683716547126,TDGE 25,A00,189294,Staff,1,0,20,19
1683716548149,TDGE 124,A00,189318,Fulton; Julia,0,7,50,50
1683716549179,TDGE 125,A00,189319,Staff,13,0,25,12
1683716549179,TDGE 125,B00,189320,Staff,23,0,25,2
1683716550209,TDGE 127,A00,189322,Havis; Allan,1,0,50,49
1683716551245,TDHT 101,A00,189323,Staff,18,0,25,7
1683716551245,TDHT 101,B00,189324,Staff,25,0,25,0
1683716552269,TDHT 102,A00,189325,Staff,49,0,50,1
1683716553296,TDMV 1,A00,189295,Arcidiacono; Kristin,20,0,30,10
1683716553296,TDMV 1,B00,189296,Caligagan; Maria T.,23,0,30,7
1683716554321,TDMV 2,A00,189297,Sammartano; Tonnie,27,0,30,3
1683716554321,TDMV 2,B00,189299,Arcidiacono; Kristin,23,0,30,7
1683716555348,TDMV 3,A00,204998,Rincon; Alicia,22,0,30,8
1683716556373,TDMV 120,A00,189458,Sammartano; Tonnie,28,0,30,2
1683716557397,TDMV 138,A00,189541,Jun; Grace Shin Hae,20,0,40,20
1683716558425,TDMV 142,A00,189717,Caligagan; Tony,25,0,30,5
1683716558425,TDMV 142,B00,189718,Caligagan; Maria T.,25,0,30,5
1683716559451,TMC 2,A01,187533,Staff,25,0,25,0
1683716559451,TMC 2,A02,187534,Staff,25,0,25,0
1683716560475,USP 1,A01,187536,Kwak; Nancy,0,16,25,25
1683716561502,USP 5,A01,187538,Staff,8,0,25,17
1683716562529,USP 101,A00,199253,Staff,0,4,0,0
1683716563553,USP 124,A00,187562,Boomhower; Matthew Charles,0,0,30,30
1683716564577,USP 138,A00,187582,Staff,19,0,25,6
1683716565602,USP 152,A01,187597,Staff,3,0,25,22
1683716566629,USP 153,A00,187598,Staff,18,0,25,7
1683716567653,USP 168,A00,187607,Kwak; Nancy,2,0,5,3
1683716568677,USP 173,A00,187619,Staff,4,0,25,21
1683716569702,USP 181,A00,187638,Staff,0,4,25,25
1683716570727,VIS 103,A00,187650,Cruz; Edwin Teddy,17,0,75,58
1683716571751,VIS 110D,A00,187669,Staff,13,0,22,9
1683716572778,VIS 127C,A00,187720,Shen; Kuiyi,67,0,146,79
1683716573806,VIS 149,A00,187731,Yoldas; Pinar,0,12,22,22
1683716574832,VIS 151,A01,188091,Staff,22,0,34,12
1683716574832,VIS 151,A02,188092,Staff,11,0,34,23
1683716575856,VIS 160B,A00,188093,Stalbaum; Brett,0,1,10,10
1683716577908,WCWP 10B,A00,201720,Staff,0,0,5,5
1683716577908,WCWP 10B,B00,201722,Staff,0,0,6,6
1683716578936,WCWP 100,A00,201725,Gagnon; Jeffrey C,0,0,2,2
1683716578936,WCWP 100,B00,201727,Staff,0,4,15,15
1683716582055,ANBI 133,A00,258401,Wilder; Linnea Lorene,34,0,40,6
1683716583079,ANBI 140,A00,258395,Hrvoj Mihic; Branka,18,0,25,7
1683716584104,ANSC 120,A00,258402,Bialecki; Jon Anthony,26,0,40,14
1683716585129,ANSC 144,A00,258400,Staff,12,0,40,28
1683716587238,ANSC 166,A00,258396,Parish; Steven Martin,156,0,175,19
1683716588272,ANSC 180,A00,193533,Staff,8,0,20,12
1683716589296,ANSC 188,A00,258397,Jassal; Aftab,34,0,40,6
1683716590319,ANTH 3,A01,258316,Staff,23,0,30,7
1683716591347,ANTH 5,A00,258394,Semendeferi; Ekaterini,16,0,20,4
1683716592371,ANTH 21,A01,258331,Staff,4,0,40,36
1683716593395,ANTH 103,A00,258398,Varma; Saiba,15,0,25,10
1683716594421,AWP 10,001,202034,Staff,0,0,0,0
1683716594421,AWP 10,002,202035,Staff,0,0,0,0
1683716594421,AWP 10,003,202036,Staff,0,0,0,0
1683716594421,AWP 10,004,202037,Staff,0,0,0,0
1683716594421,AWP 10,005,202038,Staff,0,0,0,0
1683716594421,AWP 10,006,202039,Staff,0,0,0,0
1683716594421,AWP 10,007,202040,Staff,0,0,0,0
1683716594421,AWP 10,008,202041,Staff,0,0,0,0
1683716594421,AWP 10,009,202042,Staff,0,0,0,0
1683716594421,AWP 10,010,202043,Staff,0,0,0,0
1683716594421,AWP 10,011,202044,Staff,0,0,0,0
1683716594421,AWP 10,012,202045,Staff,0,0,0,0
1683716594421,AWP 10,013,202046,Staff,0,0,0,0
1683716594421,AWP 10,014,202047,Staff,0,0,0,0
1683716594421,AWP 10,015,202048,Staff,0,0,0,0
1683716594421,AWP 10,016,202049,Staff,0,0,0,0
1683716594421,AWP 10,017,202050,Staff,0,0,0,0
1683716594421,AWP 10,018,202051,Staff,0,0,0,0
1683716594421,AWP 10,019,202052,Staff,0,0,0,0
1683716594421,AWP 10,020,202053,Staff,0,0,0,0
1683716594421,AWP 10,021,202054,Staff,0,0,0,0
1683716594421,AWP 10,022,202055,Staff,0,0,0,0
1683716594421,AWP 10,023,202056,Staff,0,0,0,0
1683716594421,AWP 10,024,202057,Staff,0,0,0,0
1683716594421,AWP 10,025,202058,Staff,0,0,0,0
1683716594421,AWP 10,026,202059,Staff,0,0,0,0
1683716595446,AWP 102,001,202032,Staff,0,0,0,0
1683716595446,AWP 102,002,202033,Staff,0,0,0,0
1683716596473,BENG 100,A01,254234,Taylor Amos; Alyssa C,31,0,40,9
1683716597500,BENG 196,001,270013,Engler; Adam J.,9999,0,9999,0
1683716598524,BICD 100R,A01,202018,Smith; Laurie,0,7,32,32
1683716598524,BICD 100R,A02,202019,Smith; Laurie,0,3,32,32
1683716598524,BICD 100R,A03,202020,Smith; Laurie,0,1,32,32
1683716598524,BICD 100R,A04,202021,Smith; Laurie,6,0,32,26
1683716598524,BICD 100R,A05,202022,Smith; Laurie,10,0,32,22
1683716599550,BICD 136,A01,193242,Gustafson-Brown; Cindy,0,2,32,32
1683716599550,BICD 136,A02,193244,Gustafson-Brown; Cindy,13,0,32,19
1683716600582,BIEB 102,A01,193249,Butler; Shannon Rhey,0,0,32,32
1683716600582,BIEB 102,A02,193251,Butler; Shannon Rhey,0,0,32,32
1683716600582,BIEB 102,A03,193253,Butler; Shannon Rhey,0,0,32,32
1683716600582,BIEB 102,A04,193255,Butler; Shannon Rhey,13,0,32,19
1683716600582,BIEB 102,A05,193265,Butler; Shannon Rhey,25,0,32,7
1683716600582,BIEB 102,A06,193269,Butler; Shannon Rhey,12,0,32,20
1683716602633,BIEB 150,A01,193274,Staff,0,0,32,32
1683716602633,BIEB 150,A02,193285,Staff,24,0,32,8
1683716603665,BIEB 194,A00,193286,Kurle; Carolyn M.,19,0,32,13
1683716604690,BILD 1,A01,192291,Staff,15,0,32,17
1683716604690,BILD 1,A02,192292,Staff,30,0,32,2
1683716604690,BILD 1,B01,192520,Reuther; Keefe,0,1,0,0
1683716604690,BILD 1,B02,192532,Reuther; Keefe,0,1,0,0
1683716605720,BILD 3,A01,192556,Butler; Shannon Rhey,0,0,32,32
1683716605720,BILD 3,A02,192581,Butler; Shannon Rhey,0,1,32,32
1683716605720,BILD 3,A03,192611,Butler; Shannon Rhey,19,0,32,13
1683716605720,BILD 3,A04,192612,Butler; Shannon Rhey,23,0,32,9
1683716605720,BILD 3,A05,192613,Butler; Shannon Rhey,26,0,32,6
1683716605720,BILD 3,A06,192679,Butler; Shannon Rhey,27,0,32,5
1683716605720,BILD 3,A07,192682,Butler; Shannon Rhey,20,0,32,12
1683716606750,BILD 4,A01,192836,Reuther; Keefe,1,0,24,23
1683716606750,BILD 4,A02,193044,Reuther; Keefe,4,0,24,20
1683716607774,BILD 10,A01,193142,Gustafson-Brown; Cindy,29,0,32,3
1683716607774,BILD 10,A02,193149,Gustafson-Brown; Cindy,31,0,32,1
1683716608804,BIMM 100,A01,193301,Staff,0,6,32,32
1683716608804,BIMM 100,A02,193312,Staff,0,7,32,32
1683716608804,BIMM 100,A03,193323,Staff,0,10,32,32
1683716609834,BIMM 101,A01,193329,McDonnell; Lisa Marie,0,3,24,24
1683716609834,BIMM 101,A02,193339,McDonnell; Lisa Marie,0,3,24,24
1683716609834,BIMM 101,B01,193354,McDonnell; Lisa Marie,0,4,24,24
1683716609834,BIMM 101,B02,193357,McDonnell; Lisa Marie,0,3,24,24
1683716610858,BIMM 110,A01,193377,Tat; John,0,11,32,32
1683716610858,BIMM 110,A02,193378,Tat; John,0,11,32,32
1683716611883,BIMM 120,A01,206116,Staff,0,0,32,32
1683716611883,BIMM 120,A02,206117,Staff,7,0,32,25
1683716611883,BIMM 120,A03,206121,Staff,21,0,32,11
1683716612914,BIPN 100,A01,193393,Park; Ji Young,0,15,32,32
1683716612914,BIPN 100,A02,193402,Park; Ji Young,0,14,32,32
1683716612914,BIPN 100,A03,193413,Park; Ji Young,0,14,32,32
1683716612914,BIPN 100,A04,193414,Park; Ji Young,0,13,32,32
1683716613939,BIPN 102,A01,193429,Staff,0,0,32,32
1683716613939,BIPN 102,A02,193438,Staff,18,0,32,14
1683716614963,BIPN 106,A01,193450,Reyes Gonzalez; Catalina,0,2,40,40
1683716615991,BIPN 134,A01,193465,Cooke; James Edward,0,0,32,32
1683716615991,BIPN 134,A02,193474,Cooke; James Edward,25,0,32,7
1683716615991,BIPN 134,A03,193485,Cooke; James Edward,29,0,32,3
1683716615991,BIPN 134,A04,193486,Cooke; James Edward,20,0,32,12
1683716615991,BIPN 134,A05,193491,Cooke; James Edward,31,0,32,1
1683716615991,BIPN 134,A06,193501,Cooke; James Edward,30,0,32,2
1683716615991,BIPN 134,A07,193510,Cooke; James Edward,29,0,32,3
1683716618042,BISP 194,A00,222522,Staff,14,0,32,18
1683716619066,CAT 124,A01,202407,Staff,19,0,25,6
1683716620091,CAT 125,A00,202408,Marchisotto; Jennifer Anne,2,0,20,18
1683716621124,CAT 125R,A00,202409,Smith; Lauryn Alissa,0,11,20,20
1683716621124,CAT 125R,B00,202410,Morales; Celeste Georgianna,0,11,20,20
1683716621124,CAT 125R,C00,202411,Irwin; Matthew Joseph,0,12,20,20
1683716622153,CENG 15,A01,204712,Yang; Kesong,0,1,0,0
1683716623179,CENG 114,A00,202070,Jahed Motlagh; Zeinab,5,0,20,15
1683716624210,CGS 105,A00,185477,Wesling; Megan E.,24,0,40,16
1683716625236,CGS 106,A00,185494,Staff,11,0,22,11
1683716626259,CGS 108,A00,185495,Staff,14,0,20,6
1683716627283,CGS 114,A00,185496,Staff,13,0,18,5
1683716628306,CGS 119,A00,185501,Staff,15,0,20,5
1683716629332,CGS 120,A00,185511,Staff,11,0,20,9
1683716630364,CHEM 4,A01,184675,Bussey; Thomas J,97,0,100,3
1683716631390,CHEM 6A,A01,184677,Staff,32,0,60,28
1683716632415,CHEM 6B,A01,184679,Staff,63,0,100,37
1683716633444,CHEM 6C,A01,184681,Bussey; Thomas J,0,0,50,50
1683716633444,CHEM 6C,A02,184682,Bussey; Thomas J,32,0,50,18
1683716634469,CHEM 40A,A01,184684,Albizati; Kim F.,33,0,100,67
1683716635492,CHEM 40B,A01,184686,Albizati; Kim F.,0,22,100,100
1683716636518,CHEM 41B,A01,184690,Staff,51,0,100,49
1683716637547,COGS 3,A01,184715,Boyle; Mary E. T.,0,27,40,40
1683716638574,COGS 14B,A01,185172,Staff,0,14,38,38
1683716639597,COGS 18,A01,184736,Staff,14,0,80,66
1683716640621,COGS 100,A01,184932,Staff,0,8,73,73
1683716641643,COGS 101A,A01,184935,Staff,0,40,30,30
1683716642668,COGS 101B,A01,184944,Staff,0,2,30,30
1683716643693,COGS 101C,A01,184946,Staff,0,10,30,30
1683716644716,COGS 102A,A01,184951,Johnson; Christine M.,1,0,40,39
1683716645747,COGS 107B,A01,184953,Mooshagian; Eric Frederick,0,52,40,40
1683716646769,COGS 118B,A01,184959,Gupta; Anjum,0,50,40,40
1683716647802,COGS 153,A00,184961,Staff,1,16,30,29
1683716648826,COGS 177,A00,184962,Staff,0,20,30,30
1683716649850,COGS 187A,A01,184969,Boyle; Mary E. T.,0,19,40,40
1683716650877,COMM 10,A01,185174,Staff,0,5,25,25
1683716650877,COMM 10,A02,185189,Staff,0,2,25,25
1683716650877,COMM 10,A03,269821,Staff,0,1,0,0
1683716651902,COMM 100B,A02,185476,Staff,10,0,25,15
1683716651902,COMM 100B,A03,277340,Staff,25,0,25,0
1683716652926,COMM 100C,A01,185314,Staff,2,0,25,23
1683716652926,COMM 100C,A02,185327,Staff,17,0,25,8
1683716653950,COMM 110M,A00,185349,Staff,0,0,40,40
1683716654978,COMM 113T,A00,185352,Staff,25,0,40,15
1683716656005,COMM 114I,A00,185353,Staff,31,0,40,9
1683716657028,COMM 131,A00,185354,Staff,17,0,30,13
1683716658051,CSE 8A,A50,185358,Cao; Yingjun,0,46,10,10
1683716659074,CSE 8B,A01,185362,Staff,0,48,50,50
1683716660099,CSE 11,A01,185416,Cao; Yingjun,0,91,10,10
1683716661129,CSE 20,A01,185445,Briones; Jor-el Thomas Caparas,3,0,25,22
1683716662155,CSE 21,A01,185447,Staff,9,0,50,41
1683716663304,CSE 101,A01,185451,Staff,0,13,50,50
1683716663304,CSE 101,B01,185453,Jones; Miles E,0,15,50,50
1683716665363,CSE 141,A01,185458,Eldon; John,16,0,100,84
1683716666388,CSE 141L,A01,185461,Eldon; John,8,0,100,92
1683716667411,CSE 142,A01,185463,Staff,34,0,60,26
1683716667411,CSE 142,B01,201355,Staff,0,7,60,60
1683716668435,CSE 142L,A01,185470,Staff,34,0,60,26
1683716668435,CSE 142L,B01,201417,Staff,0,6,60,60
1683716669463,CSE 190,A00,201433,Staff,32,0,49,17
1683716670490,DOC 1,A01,259136,Strom; Megan C.,7,0,15,8
1683716670490,DOC 1,A02,259137,Strom; Megan C.,15,0,15,0
1683716670490,DOC 1,A03,259138,Strom; Megan C.,14,0,15,1
1683716670490,DOC 1,A04,259139,Strom; Megan C.,13,0,15,2
1683716671515,DOC 100D,A00,259140,Pass; Natalye Joann,14,0,25,11
1683716672544,DSGN 1,A01,184749,Rill; Bryan,0,26,30,30
1683716673576,DSGN 100,A01,185168,Staff,0,2,25,25
1683716674605,ECE 5,A01,185626,Morris; Karcher William,0,12,0,0
1683716675629,ECE 101,A01,185628,Staff,14,0,70,56
1683716676655,ECE 107,A01,185635,Baghdadchi; Saharnaz,0,0,20,20
1683716676655,ECE 107,A02,185638,Baghdadchi; Saharnaz,1,0,20,19
1683716677681,ECE 148,A01,185647,Silberman; Jack,0,0,16,16
1683716678705,ECON 1,A01,185537,Crane; Meredith Helen,54,0,70,16
1683716679733,ECON 3,A01,185549,Crane; Meredith Helen,30,0,70,40
1683716680761,ECON 4,A01,203354,Anderson; John Charles,0,5,10,10
1683716681788,ECON 100A,A01,185574,Staff,0,5,40,40
1683716682817,ECON 100B,A01,185576,Staff,0,12,50,50
1683716683844,ECON 100C,A01,185589,Newhouse; Herbert S,30,0,70,40
1683716684872,ECON 105,A00,185608,Vespa; Emanuel Ignacio,19,0,35,16
1683716685900,ECON 109,A01,185610,Shishkin; Denis,9,0,35,26
1683716686927,ECON 110A,A01,185612,Staff,8,0,40,32
1683716687956,ECON 120A,A01,185615,Staff,19,0,40,21
1683716688983,ECON 120C,A01,185617,Sun; Yixiao,0,21,70,70
1683716690011,ECON 144,A00,203346,Squires; Dale E,2,0,35,33
1683716691034,ECON 171,A01,203349,Newhouse; Herbert S,0,1,35,35
1683716692065,ECON 173A,A01,185621,Toda; Alexis Akira,21,0,35,14
1683716693093,EDS 25,A01,202413,Staff,0,1,0,0
1683716693093,EDS 25,A02,202414,Staff,0,1,0,0
1683716693093,EDS 25,A03,202415,Staff,0,0,0,0
1683716693093,EDS 25,A04,202416,Staff,0,1,0,0
1683716693093,EDS 25,A05,202439,Staff,0,0,0,0
1683716693093,EDS 25,A06,202440,Staff,0,0,0,0
1683716693093,EDS 25,B01,202631,Staff,0,0,0,0
1683716693093,EDS 25,B02,202632,Staff,0,0,0,0
1683716693093,EDS 25,B03,202639,Staff,0,0,0,0
1683716693093,EDS 25,B04,202640,Staff,0,0,0,0
1683716693093,EDS 25,B05,202643,Staff,0,0,0,0
1683716693093,EDS 25,B06,202644,Staff,0,0,0,0
1683716694117,EDS 38,A01,202659,Black; Alison Michelle,25,0,25,0
1683716695145,EDS 115,A00,202652,Staff,18,0,30,12
1683716696170,EDS 125,A00,202649,Staff,13,0,30,17
1683716697194,EDS 126,A01,203332,Staff,30,0,30,0
1683716698218,EDS 139,A00,202838,Staff,16,0,25,9
1683716699247,EDS 146,A01,202655,Staff,14,0,25,11
1683716700277,ENG 15,A00,185667,Staff,0,1,0,0
1683716700277,ENG 15,B00,185672,Staff,0,0,0,0
1683716700277,ENG 15,C00,185675,Staff,0,0,0,0
1683716700277,ENG 15,D00,185682,Staff,0,0,0,0
1683716700277,ENG 15,E00,185684,Staff,0,0,0,0
1683716701300,ETHN 103,A00,185710,Staff,0,8,35,35
1683716702330,ETHN 103A,A00,199228,Man; Simeon S,0,0,9,9
1683716703355,ETHN 109,A00,185711,Staff,15,0,35,20
1683716704379,ETHN 142,A00,185726,Staff,0,4,30,30
1683716705405,ETHN 163J,A00,199229,Man; Simeon S,5,0,8,3
1683716706429,ETHN 168,A00,185727,Staff,7,0,10,3
1683716707453,ETHN 182,A00,185728,Staff,0,0,35,35
1683716708481,ETHN 183,A00,185737,Staff,10,0,18,8
1683716709509,GLBH 111,A01,209361,Burgos; Jose L.,0,0,0,0
1683716711563,HIEU 104,A00,185792,Staff,14,0,20,6
1683716712587,HIEU 115,A00,185800,Staff,0,0,20,20
1683716713614,HIEU 128,A00,185801,Staff,0,9,20,20
1683716714640,HIEU 147,A00,185802,Staff,15,0,20,5
1683716715668,HIEU 154,A00,185823,Staff,11,0,20,9
1683716716693,HILA 102,A00,185826,Staff,14,0,20,6
1683716717717,HILD 2C,A01,185778,Staff,0,13,20,20
1683716718746,HILD 7B,A01,185780,Kwak; Nancy,0,17,32,32
1683716718746,HILD 7B,A02,185781,Kwak; Nancy,0,18,32,32
1683716719773,HILD 30,A01,185791,Staff,12,0,20,8
1683716720801,HISC 119,A00,185830,Golan; Tal,0,10,20,20
1683716721829,HITO 156GS,A00,185831,Patterson; Patrick H.,0,0,0,23
1683716722857,HIUS 103,A00,185832,Man; Simeon S,0,4,20,20
1683716723882,HIUS 117,A00,185836,Kwak; Nancy,2,0,20,18
1683716724909,HIUS 125,A00,185840,Man; Simeon S,0,2,23,23
1683716725934,HIUS 149,A00,185845,Staff,1,0,20,19
1683716726960,HUM 3,A01,185882,Zavodny; Tatiana Sophia,0,8,50,50
1683716726960,HUM 3,B01,185899,Caldwell; Michael Alan,0,18,50,50
1683716727986,HUM 3GS,A00,185900,Patterson; Patrick H.,0,0,0,23
1683716729012,HUM 4,A01,185938,Zroka; Amy Liane,28,0,50,22
1683716729012,HUM 4,B01,185956,Watkins; Eric,0,6,50,50
1683716729012,HUM 4,B02,202209,Watkins; Eric,0,6,50,50
1683716729012,HUM 4,B03,202210,Watkins; Eric,0,5,50,50
1683716730040,HUM 5,A01,185958,West; Geoffrey Scott,0,0,50,50
1683716730040,HUM 5,A02,202215,West; Geoffrey Scott,0,1,50,50
1683716731065,INTL 190,A00,185959,Gagnon; Jeffrey C,0,0,0,9
1683716731065,INTL 190,B00,185960,Lettieri; Michael Joseph,0,0,0,2
1683716732091,JAPN 180,A00,254509,Staff,5,0,30,25
1683716733120,LATI 10,A01,202853,Kennemore; Amy Michelle,4,0,35,31
1683716733120,LATI 10,A02,202854,Kennemore; Amy Michelle,3,0,35,32
1683716733120,LATI 10,A03,270054,Kennemore; Amy Michelle,30,0,30,0
1683716734143,LATI 180,A00,202855,Kennemore; Amy Michelle,11,0,20,9
1683716735169,LAWS 101,A00,201767,Golan; Tal,0,7,40,40
1683716736192,LIFR 1C,A00,185961,Staff,6,0,20,14
1683716737216,LIFR 1CX,A00,185962,Staff,7,0,20,13
1683716738241,LIFR 1D,A00,185963,Staff,7,0,20,13
1683716739268,LIFR 1DX,A00,185964,Staff,7,0,20,13
1683716740296,LIGN 101,A01,186039,Staff,43,0,50,7
1683716741324,LIGN 165,A00,186040,Staff,14,0,50,36
1683716742349,LTCS 108,A00,186041,Staff,5,0,10,5
1683716743373,LTCS 119,A00,186042,Staff,15,0,20,5
1683716744404,LTCS 130,A00,186043,Wesling; Megan E.,15,0,25,10
1683716746459,LTEA 138,A00,186119,Staff,14,0,40,26
1683716747488,LTEN 124,A00,186148,Staff,5,0,25,20
1683716748512,LTEN 178,A00,186149,Staff,6,0,15,9
1683716749540,LTEN 181,A00,186150,Blanco; John D,34,0,40,6
