time,subj_course_id,sec_code,sec_id,prof,available,waitlist,total,enrolled_ct
1683285828430,ANBI 133,A00,258401,Wilder; Linnea Lorene,34,0,40,6
1683285829460,ANBI 140,A00,258395,Hrvoj Mihic; Branka,18,0,25,7
1683285830498,ANSC 120,A00,258402,Bialecki; Jon Anthony,27,0,40,13
1683285831529,ANSC 144,A00,258400,Staff,14,0,40,26
1683285833588,ANSC 166,A00,258396,Parish; Steven Martin,157,0,175,18
1683285834619,ANSC 180,A00,193533,Staff,9,0,20,11
1683285835652,ANSC 188,A00,258397,Jassal; Aftab,33,0,40,7
1683285836686,ANTH 3,A01,258316,Staff,23,0,30,7
1683285837724,ANTH 5,A00,258394,Semendeferi; Ekaterini,16,0,20,4
1683285838756,ANTH 21,A01,258331,Staff,9,0,40,31
1683285839792,ANTH 103,A00,258398,Varma; Saiba,15,0,25,10
1683285840833,AWP 10,001,202034,Staff,0,0,0,0
1683285840833,AWP 10,002,202035,Staff,0,0,0,0
1683285840833,AWP 10,003,202036,Staff,0,0,0,0
1683285840833,AWP 10,004,202037,Staff,0,0,0,0
1683285840833,AWP 10,005,202038,Staff,0,0,0,0
1683285840833,AWP 10,006,202039,Staff,0,0,0,0
1683285840833,AWP 10,007,202040,Staff,0,0,0,0
1683285840833,AWP 10,008,202041,Staff,0,0,0,0
1683285840833,AWP 10,009,202042,Staff,0,0,0,0
1683285840833,AWP 10,010,202043,Staff,0,0,0,0
1683285840833,AWP 10,011,202044,Staff,0,0,0,0
1683285840833,AWP 10,012,202045,Staff,0,0,0,0
1683285840833,AWP 10,013,202046,Staff,0,0,0,0
1683285840833,AWP 10,014,202047,Staff,0,0,0,0
1683285840833,AWP 10,015,202048,Staff,0,0,0,0
1683285840833,AWP 10,016,202049,Staff,0,0,0,0
1683285840833,AWP 10,017,202050,Staff,0,0,0,0
1683285840833,AWP 10,018,202051,Staff,0,0,0,0
1683285840833,AWP 10,019,202052,Staff,0,0,0,0
1683285840833,AWP 10,020,202053,Staff,0,0,0,0
1683285840833,AWP 10,021,202054,Staff,0,0,0,0
1683285840833,AWP 10,022,202055,Staff,0,0,0,0
1683285840833,AWP 10,023,202056,Staff,0,0,0,0
1683285840833,AWP 10,024,202057,Staff,0,0,0,0
1683285840833,AWP 10,025,202058,Staff,0,0,0,0
1683285840833,AWP 10,026,202059,Staff,0,0,0,0
1683285841869,AWP 102,001,202032,Staff,0,0,0,0
1683285841869,AWP 102,002,202033,Staff,0,0,0,0
1683285842913,BENG 100,A01,254234,Taylor Amos; Alyssa C,31,0,40,9
1683285843950,BENG 196,001,270013,Engler; Adam J.,9999,0,9999,0
1683285845005,BICD 100R,A01,202018,Smith; Laurie,0,7,32,32
1683285845005,BICD 100R,A02,202019,Smith; Laurie,0,2,32,32
1683285845005,BICD 100R,A03,202020,Smith; Laurie,0,1,32,32
1683285845005,BICD 100R,A04,202021,Smith; Laurie,8,0,32,24
1683285845005,BICD 100R,A05,202022,Smith; Laurie,12,0,32,20
1683285846041,BICD 136,A01,193242,Gustafson-Brown; Cindy,0,2,32,32
1683285846041,BICD 136,A02,193244,Gustafson-Brown; Cindy,15,0,32,17
1683285847073,BIEB 102,A01,193249,Butler; Shannon Rhey,0,2,32,32
1683285847073,BIEB 102,A02,193251,Butler; Shannon Rhey,0,0,32,32
1683285847073,BIEB 102,A03,193253,Butler; Shannon Rhey,0,1,32,32
1683285847073,BIEB 102,A04,193255,Butler; Shannon Rhey,17,0,32,15
1683285847073,BIEB 102,A05,193265,Butler; Shannon Rhey,26,0,32,6
1683285847073,BIEB 102,A06,193269,Butler; Shannon Rhey,16,0,32,16
1683285849136,BIEB 150,A01,193274,Staff,0,0,32,32
1683285849136,BIEB 150,A02,193285,Staff,24,0,32,8
1683285850167,BIEB 194,A00,193286,Kurle; Carolyn M.,22,0,32,10
1683285851202,BILD 1,A01,192291,Staff,16,0,32,16
1683285851202,BILD 1,A02,192292,Staff,30,0,32,2
1683285851202,BILD 1,B01,192520,Reuther; Keefe,0,1,0,0
1683285851202,BILD 1,B02,192532,Reuther; Keefe,0,1,0,0
1683285852235,BILD 3,A01,192556,Butler; Shannon Rhey,0,0,32,32
1683285852235,BILD 3,A02,192581,Butler; Shannon Rhey,5,0,32,27
1683285852235,BILD 3,A03,192611,Butler; Shannon Rhey,23,0,32,9
1683285852235,BILD 3,A04,192612,Butler; Shannon Rhey,25,0,32,7
1683285852235,BILD 3,A05,192613,Butler; Shannon Rhey,27,0,32,5
1683285852235,BILD 3,A06,192679,Butler; Shannon Rhey,27,0,32,5
1683285852235,BILD 3,A07,192682,Butler; Shannon Rhey,22,0,32,10
1683285853273,BILD 4,A01,192836,Reuther; Keefe,1,0,24,23
1683285853273,BILD 4,A02,193044,Reuther; Keefe,4,0,24,20
1683285854305,BILD 10,A01,193142,Gustafson-Brown; Cindy,31,0,32,1
1683285854305,BILD 10,A02,193149,Gustafson-Brown; Cindy,31,0,32,1
1683285855337,BIMM 100,A01,193301,Staff,0,6,32,32
1683285855337,BIMM 100,A02,193312,Staff,0,5,32,32
1683285855337,BIMM 100,A03,193323,Staff,0,8,32,32
1683285856372,BIMM 101,A01,193329,McDonnell; Lisa Marie,0,3,24,24
1683285856372,BIMM 101,A02,193339,McDonnell; Lisa Marie,0,2,24,24
1683285856372,BIMM 101,B01,193354,McDonnell; Lisa Marie,0,3,24,24
1683285856372,BIMM 101,B02,193357,McDonnell; Lisa Marie,0,3,24,24
1683285857404,BIMM 110,A01,193377,Tat; John,0,11,32,32
1683285857404,BIMM 110,A02,193378,Tat; John,1,9,32,31
1683285858438,BIMM 120,A01,206116,Staff,0,0,32,32
1683285858438,BIMM 120,A02,206117,Staff,8,0,32,24
1683285858438,BIMM 120,A03,206121,Staff,21,0,32,11
1683285859470,BIPN 100,A01,193393,Park; Ji Young,0,14,32,32
1683285859470,BIPN 100,A02,193402,Park; Ji Young,0,12,32,32
1683285859470,BIPN 100,A03,193413,Park; Ji Young,0,14,32,32
1683285859470,BIPN 100,A04,193414,Park; Ji Young,0,13,32,32
1683285860506,BIPN 102,A01,193429,Staff,0,0,32,32
1683285860506,BIPN 102,A02,193438,Staff,23,0,32,9
1683285861537,BIPN 106,A01,193450,Reyes Gonzalez; Catalina,0,2,40,40
1683285862575,BIPN 134,A01,193465,Cooke; James Edward,0,0,32,32
1683285862575,BIPN 134,A02,193474,Cooke; James Edward,27,0,32,5
1683285862575,BIPN 134,A03,193485,Cooke; James Edward,29,0,32,3
1683285862575,BIPN 134,A04,193486,Cooke; James Edward,21,0,32,11
1683285862575,BIPN 134,A05,193491,Cooke; James Edward,31,0,32,1
1683285862575,BIPN 134,A06,193501,Cooke; James Edward,30,0,32,2
1683285862575,BIPN 134,A07,193510,Cooke; James Edward,29,0,32,3
1683285864636,BISP 194,A00,222522,Staff,16,0,32,16
1683285865669,CAT 124,A01,202407,Staff,20,0,25,5
1683285866704,CAT 125,A00,202408,Marchisotto; Jennifer Anne,4,0,20,16
1683285867746,CAT 125R,A00,202409,Smith; Lauryn Alissa,0,11,20,20
1683285867746,CAT 125R,B00,202410,Morales; Celeste Georgianna,0,11,20,20
1683285867746,CAT 125R,C00,202411,Irwin; Matthew Joseph,0,10,20,20
1683285868782,CENG 15,A01,204712,Yang; Kesong,0,1,0,0
1683285869814,CENG 114,A00,202070,Jahed Motlagh; Zeinab,5,0,20,15
1683285870848,CGS 105,A00,185477,Wesling; Megan E.,24,0,40,16
1683285871881,CGS 106,A00,185494,Staff,13,0,22,9
1683285872912,CGS 108,A00,185495,Staff,14,0,20,6
1683285873946,CGS 114,A00,185496,Staff,13,0,18,5
1683285874977,CGS 119,A00,185501,Staff,15,0,20,5
1683285876008,CGS 120,A00,185511,Staff,13,0,20,7
1683285877040,CHEM 4,A01,184675,Bussey; Thomas J,96,0,100,4
1683285878070,CHEM 6A,A01,184677,Staff,35,0,60,25
1683285879100,CHEM 6B,A01,184679,Staff,65,0,100,35
1683285880135,CHEM 6C,A01,184681,Bussey; Thomas J,1,0,50,49
1683285880135,CHEM 6C,A02,184682,Bussey; Thomas J,34,0,50,16
1683285881169,CHEM 40A,A01,184684,Albizati; Kim F.,37,0,100,63
1683285882200,CHEM 40B,A01,184686,Albizati; Kim F.,0,20,100,100
1683285883229,CHEM 41B,A01,184690,Staff,52,0,100,48
1683285884260,COGS 3,A01,184715,Boyle; Mary E. T.,0,25,40,40
1683285885294,COGS 14B,A01,185172,Staff,0,15,38,38
1683285886320,COGS 18,A01,184736,Staff,20,0,80,60
1683285887350,COGS 100,A01,184932,Staff,0,5,73,73
1683285888380,COGS 101A,A01,184935,Staff,0,38,30,30
1683285889410,COGS 101B,A01,184944,Staff,0,2,30,30
1683285890444,COGS 101C,A01,184946,Staff,0,12,30,30
1683285891477,COGS 102A,A01,184951,Johnson; Christine M.,2,0,40,38
1683285892512,COGS 107B,A01,184953,Mooshagian; Eric Frederick,0,50,40,40
1683285893546,COGS 118B,A01,184959,Gupta; Anjum,0,48,40,40
1683285894575,COGS 153,A00,184961,Staff,0,15,30,30
1683285895604,COGS 177,A00,184962,Staff,0,21,30,30
1683285896635,COGS 187A,A01,184969,Boyle; Mary E. T.,0,17,40,40
1683285897669,COMM 10,A01,185174,Staff,0,5,25,25
1683285897669,COMM 10,A02,185189,Staff,0,5,25,25
1683285897669,COMM 10,A03,269821,Staff,0,0,0,0
1683285898700,COMM 100B,A01,185475,Staff,0,0,0,2
1683285898700,COMM 100B,A02,185476,Staff,14,0,25,11
1683285899734,COMM 100C,A01,185314,Staff,1,0,25,24
1683285899734,COMM 100C,A02,185327,Staff,19,0,25,6
1683285900769,COMM 110M,A00,185349,Staff,2,0,40,38
1683285901799,COMM 113T,A00,185352,Staff,25,0,40,15
1683285902827,COMM 114I,A00,185353,Staff,33,0,40,7
1683285903860,COMM 131,A00,185354,Staff,19,0,30,11
1683285904902,CSE 8A,A50,185358,Cao; Yingjun,0,46,10,10
1683285905932,CSE 8B,A01,185362,Staff,0,47,50,50
1683285906964,CSE 11,A01,185416,Cao; Yingjun,0,93,10,10
1683285908012,CSE 20,A01,185445,Briones; Jor-el Thomas Caparas,5,0,25,20
1683285909042,CSE 21,A01,185447,Staff,10,0,50,40
1683285910072,CSE 101,A01,185451,Staff,0,12,50,50
1683285910072,CSE 101,B01,185453,Jones; Miles E,0,11,50,50
1683285912134,CSE 141,A01,185458,Eldon; John,20,0,100,80
1683285913169,CSE 141L,A01,185461,Eldon; John,12,0,100,88
1683285914200,CSE 142,A01,185463,Staff,35,0,60,25
1683285914200,CSE 142,B01,201355,Staff,0,6,60,60
1683285915231,CSE 142L,A01,185470,Staff,35,0,60,25
1683285915231,CSE 142L,B01,201417,Staff,0,5,60,60
1683285916264,CSE 190,A00,201433,Staff,32,0,49,17
1683285917295,DOC 1,A01,259136,Strom; Megan C.,8,0,15,7
1683285917295,DOC 1,A02,259137,Strom; Megan C.,14,0,15,1
1683285917295,DOC 1,A03,259138,Strom; Megan C.,14,0,15,1
1683285917295,DOC 1,A04,259139,Strom; Megan C.,14,0,15,1
1683285918325,DOC 100D,A00,259140,Pass; Natalye Joann,17,0,25,8
1683285919356,DSGN 1,A01,184749,Rill; Bryan,0,24,30,30
1683285920383,DSGN 100,A01,185168,Staff,0,2,25,25
1683285921423,ECE 5,A01,185626,Morris; Karcher William,0,10,0,0
1683285922457,ECE 101,A01,185628,Staff,17,0,70,53
1683285923488,ECE 107,A01,185635,Baghdadchi; Saharnaz,0,0,20,20
1683285923488,ECE 107,A02,185638,Baghdadchi; Saharnaz,4,0,20,16
1683285924520,ECE 148,A01,185647,Silberman; Jack,1,0,16,15
1683285925551,ECON 1,A01,185537,Crane; Meredith Helen,54,0,70,16
1683285926581,ECON 3,A01,185549,Crane; Meredith Helen,33,0,70,37
1683285927667,ECON 4,A01,203354,Anderson; John Charles,0,4,10,10
1683285928699,ECON 100A,A01,185574,Staff,0,4,40,40
1683285929733,ECON 100B,A01,185576,Staff,0,22,40,40
1683285930762,ECON 100C,A01,185589,Newhouse; Herbert S,30,0,70,40
1683285931793,ECON 105,A00,185608,Vespa; Emanuel Ignacio,19,0,35,16
1683285932822,ECON 109,A01,185610,Shishkin; Denis,10,0,35,25
1683285933853,ECON 110A,A01,185612,Staff,11,0,40,29
1683285934885,ECON 120A,A01,185615,Staff,20,0,40,20
1683285935917,ECON 120C,A01,185617,Sun; Yixiao,0,20,70,70
1683285936948,ECON 144,A00,203346,Squires; Dale E,3,0,35,32
1683285937982,ECON 171,A01,203349,Newhouse; Herbert S,0,1,35,35
1683285939015,ECON 173A,A01,185621,Toda; Alexis Akira,21,0,35,14
1683285940047,EDS 25,A01,202413,Staff,0,1,0,0
1683285940047,EDS 25,A02,202414,Staff,0,1,0,0
1683285940047,EDS 25,A03,202415,Staff,0,0,0,0
1683285940047,EDS 25,A04,202416,Staff,0,1,0,0
1683285940047,EDS 25,A05,202439,Staff,0,0,0,0
1683285940047,EDS 25,A06,202440,Staff,0,0,0,0
1683285940047,EDS 25,B01,202631,Staff,0,0,0,0
1683285940047,EDS 25,B02,202632,Staff,0,0,0,0
1683285940047,EDS 25,B03,202639,Staff,0,0,0,0
1683285940047,EDS 25,B04,202640,Staff,0,0,0,0
1683285940047,EDS 25,B05,202643,Staff,0,0,0,0
1683285940047,EDS 25,B06,202644,Staff,0,0,0,0
1683285941078,EDS 38,A01,202659,Black; Alison Michelle,24,0,25,1
1683285942110,EDS 115,A00,202652,Staff,17,0,30,13
1683285943140,EDS 125,A00,202649,Staff,14,0,30,16
1683285944168,EDS 126,A01,203332,Staff,30,0,30,0
1683285945196,EDS 139,A00,202838,Staff,17,0,25,8
1683285946226,EDS 146,A01,202655,Staff,15,0,25,10
1683285947258,ENG 15,A00,185667,Staff,0,1,0,0
1683285947258,ENG 15,B00,185672,Staff,0,0,0,0
1683285947258,ENG 15,C00,185675,Staff,0,0,0,0
1683285947258,ENG 15,D00,185682,Staff,0,0,0,0
1683285947258,ENG 15,E00,185684,Staff,0,0,0,0
1683285948288,ETHN 103,A00,185710,Staff,0,3,35,35
1683285949323,ETHN 103A,A00,199228,Man; Simeon S,3,0,9,6
1683285950357,ETHN 109,A00,185711,Staff,18,0,35,17
1683285951391,ETHN 142,A00,185726,Staff,0,4,30,30
1683285952423,ETHN 163J,A00,199229,Man; Simeon S,6,0,8,2
1683285953456,ETHN 168,A00,185727,Staff,8,0,10,2
1683285954490,ETHN 182,A00,185728,Staff,1,0,35,34
1683285955522,ETHN 183,A00,185737,Staff,8,0,18,10
1683285956554,GLBH 111,A01,209361,Burgos; Jose L.,0,0,0,0
1683285958614,HIEU 104,A00,185792,Staff,16,0,20,4
1683285959647,HIEU 115,A00,185800,Staff,1,0,20,19
1683285960681,HIEU 128,A00,185801,Staff,0,7,20,20
1683285961714,HIEU 147,A00,185802,Staff,16,0,20,4
1683285962743,HIEU 154,A00,185823,Staff,12,0,20,8
1683285963776,HILA 102,A00,185826,Staff,13,0,20,7
1683285964805,HILD 2C,A01,185778,Staff,0,12,20,20
1683285965841,HILD 7B,A01,185780,Kwak; Nancy,0,15,32,32
1683285965841,HILD 7B,A02,185781,Kwak; Nancy,0,18,32,32
1683285966875,HILD 30,A01,185791,Staff,14,0,20,6
1683285967909,HISC 119,A00,185830,Golan; Tal,0,9,20,20
1683285968942,HITO 156GS,A00,185831,Patterson; Patrick H.,0,0,0,23
1683285969978,HIUS 103,A00,185832,Man; Simeon S,0,7,20,20
1683285971009,HIUS 117,A00,185836,Kwak; Nancy,2,0,20,18
1683285972040,HIUS 125,A00,185840,Man; Simeon S,0,0,23,23
1683285973072,HIUS 149,A00,185845,Staff,0,0,20,20
1683285974109,HUM 3,A01,185882,Zavodny; Tatiana Sophia,0,6,50,50
1683285974109,HUM 3,B01,185899,Caldwell; Michael Alan,0,19,50,50
1683285975142,HUM 3GS,A00,185900,Patterson; Patrick H.,0,0,0,23
1683285976175,HUM 4,A01,185938,Zroka; Amy Liane,31,0,50,19
1683285976175,HUM 4,B01,185956,Watkins; Eric,0,2,50,50
1683285976175,HUM 4,B02,202209,Watkins; Eric,0,1,50,50
1683285976175,HUM 4,B03,202210,Watkins; Eric,0,0,50,50
1683285977204,HUM 5,A01,185958,West; Geoffrey Scott,5,0,50,45
1683285977204,HUM 5,A02,202215,West; Geoffrey Scott,0,0,50,50
1683285978233,INTL 190,A00,185959,Gagnon; Jeffrey C,0,0,0,9
1683285978233,INTL 190,B00,185960,Lettieri; Michael Joseph,0,0,0,1
1683285979263,JAPN 180,A00,254509,Staff,0,1,25,25
1683285980294,LATI 10,A01,202853,Kennemore; Amy Michelle,5,0,35,30
1683285980294,LATI 10,A02,202854,Kennemore; Amy Michelle,1,0,35,34
1683285980294,LATI 10,A03,270054,Kennemore; Amy Michelle,30,0,30,0
1683285981323,LATI 180,A00,202855,Kennemore; Amy Michelle,11,0,20,9
1683285982353,LAWS 101,A00,201767,Golan; Tal,0,7,40,40
1683285983383,LIFR 1C,A00,185961,Staff,6,0,20,14
1683285984413,LIFR 1CX,A00,185962,Staff,7,0,20,13
1683285985440,LIFR 1D,A00,185963,Staff,9,0,20,11
1683285986470,LIFR 1DX,A00,185964,Staff,9,0,20,11
1683285987502,LIGN 101,A01,186039,Staff,43,0,50,7
1683285988535,LIGN 165,A00,186040,Staff,18,0,50,32
1683285989566,LTCS 108,A00,186041,Staff,6,0,10,4
1683285990596,LTCS 119,A00,186042,Staff,16,0,20,4
1683285991629,LTCS 130,A00,186043,Wesling; Megan E.,15,0,25,10
1683285993688,LTEA 138,A00,186119,Staff,14,0,40,26
1683285994717,LTEN 124,A00,186148,Staff,6,0,25,19
1683285995746,LTEN 178,A00,186149,Staff,7,0,15,8
1683285996775,LTEN 181,A00,186150,Blanco; John D,33,0,40,7
1683285997803,LTWL 120,A00,186160,Staff,20,0,25,5
1683285998834,LTWL 165,A00,186161,Staff,22,0,25,3
1683285999864,LTWR 100,A00,186162,Staff,0,4,15,15
1683286000899,LTWR 102,A00,186163,Doller; Ben,5,0,15,10
1683286001929,MAE 8,A01,186412,Staff,0,0,0,0
1683286002963,MAE 30B,A00,186445,Bahadori; Mohammad Yousef,83,0,100,17
1683286003991,MAE 40,A00,186592,Bewley; Thomas R,9,0,50,41
1683286005022,MAE 101B,A00,186593,Bahadori; Mohammad Yousef,81,0,100,19
1683286006052,MAE 105,A00,186594,Bandaru; Prabhakar,12,0,50,38
1683286007084,MAE 107,A00,186599,Pham; Hieu Tan,0,6,120,120
1683286008118,MAE 148,A01,186660,Silberman; Jack,3,0,16,13
1683286009155,MATH 10A,A01,188095,Staff,0,7,35,35
1683286010194,MATH 10B,A01,188097,Bowers; Adam R.,0,11,30,30
1683286010194,MATH 10B,A02,188099,Bowers; Adam R.,0,9,30,30
1683286010194,MATH 10B,B01,188104,Bowers; Adam R.,0,11,30,30
1683286010194,MATH 10B,B02,188106,Bowers; Adam R.,0,11,30,30
1683286011231,MATH 10C,A01,188111,Staff,0,18,30,30
1683286011231,MATH 10C,A02,188127,Staff,0,17,30,30
1683286011231,MATH 10C,A03,188131,Staff,0,17,30,30
1683286011231,MATH 10C,B01,188218,Staff,21,0,30,9
1683286011231,MATH 10C,B02,188244,Staff,13,0,30,17
1683286011231,MATH 10C,B03,188277,Staff,16,0,30,14
1683286012260,MATH 18,A01,188344,Bach; Quang Tran,18,0,30,12
1683286012260,MATH 18,A02,188345,Bach; Quang Tran,11,0,30,19
1683286012260,MATH 18,B01,188353,Bach; Quang Tran,10,0,30,20
1683286012260,MATH 18,B02,188354,Bach; Quang Tran,20,0,30,10
1683286013290,MATH 20A,A01,188374,Staff,13,0,35,22
1683286014325,MATH 20B,A01,188382,Ohm; Ko Woon,6,0,30,24
1683286014325,MATH 20B,A02,188383,Ohm; Ko Woon,24,0,30,6
1683286014325,MATH 20B,B01,188385,Ohm; Ko Woon,7,0,30,23
1683286014325,MATH 20B,B02,188392,Ohm; Ko Woon,22,0,30,8
1683286015354,MATH 20C,A01,188394,Harel; Guershon,10,0,30,20
1683286015354,MATH 20C,A02,188395,Harel; Guershon,13,0,30,17
1683286015354,MATH 20C,B01,188404,Harel; Guershon,3,0,30,27
1683286015354,MATH 20C,B02,188405,Harel; Guershon,19,0,30,11
1683286016385,MATH 20D,A01,188414,Hammock; Frances H,0,1,30,30
1683286016385,MATH 20D,A02,188415,Hammock; Frances H,4,0,30,26
1683286016385,MATH 20D,B01,188447,Hammock; Frances H,2,0,30,28
1683286016385,MATH 20D,B02,188486,Hammock; Frances H,8,0,30,22
1683286017417,MATH 20E,A01,188649,Staff,22,0,30,8
1683286017417,MATH 20E,A02,188650,Staff,23,0,30,7
1683286017417,MATH 20E,A03,188673,Staff,0,0,30,30
1683286018445,MATH 102,A01,188675,Staff,0,35,35,35
1683286019480,MATH 103B,A01,188681,Staff,4,0,35,31
1683286019480,MATH 103B,B01,188692,Staff,8,0,35,27
1683286020515,MATH 109,A01,188695,Salehi Golsefidy; Alireza,25,0,35,10
1683286020515,MATH 109,A02,188696,Salehi Golsefidy; Alireza,27,0,35,8
1683286021550,MATH 120A,A01,188698,Eggers; John Dietrich,5,0,35,30
1683286022584,MATH 142B,A01,188736,Ioana; Adrian,0,2,30,30
1683286022584,MATH 142B,A02,188741,Ioana; Adrian,0,1,30,30
1683286022584,MATH 142B,A03,188743,Ioana; Adrian,0,3,30,30
1683286023616,MATH 168A,A01,188790,Staff,0,8,35,35
1683286024654,MATH 170A,A01,188803,Nie; Jiawang,0,2,35,35
1683286024654,MATH 170A,A02,188811,Nie; Jiawang,0,0,35,35
1683286024654,MATH 170A,A03,188814,Nie; Jiawang,1,0,35,34
1683286024654,MATH 170A,A04,188815,Nie; Jiawang,14,0,35,21
1683286025683,MATH 193B,A01,188817,Staff,0,0,35,35
1683286025683,MATH 193B,A02,188818,Staff,5,0,35,30
1683286026714,MGT 4,A01,202857,Anderson; John Charles,62,0,80,18
1683286027744,MGT 12,A00,202858,Lindenberger; Wade Douglas,43,0,90,47
1683286028772,MGT 18,A00,202859,Staff,74,0,90,16
1683286029802,MGT 18GS,A00,202860,McKay; Michael J,13,0,28,15
1683286030832,MGT 45,A00,202861,Pecore; Joseph P.,14,0,90,76
1683286031915,MGT 100,A00,202863,Yavorsky; Daniel Ryan,28,0,90,62
1683286032947,MGT 103,A00,202864,Ehrich; Kristine R,0,16,90,90
1683286033976,MGT 112,A00,202865,Ehrich; Kristine R,15,0,90,75
1683286035010,MGT 121A,A00,202868,Staff,0,19,0,0
1683286036043,MGT 131B,A00,202869,Anderson; John Charles,60,0,90,30
1683286037076,MGT 136,A00,202871,Lindenberger; Wade Douglas,84,0,90,6
1683286038105,MGT 164,A00,202873,Staff,0,69,90,90
1683286039132,MGT 164GS,A00,202874,McKay; Mary A,13,0,28,15
1683286040197,MGT 180,A00,202875,Staff,0,51,90,90
1683286041229,MMW 11R,A01,205019,Herbst; Matthew,3,0,30,27
1683286041229,MMW 11R,A02,205026,Herbst; Matthew,29,0,30,1
1683286042262,MMW 15,A01,193512,Chang; Edmond Yi-Teh,0,9,28,28
1683286042262,MMW 15,A02,193513,Chang; Edmond Yi-Teh,0,5,28,28
1683286042262,MMW 15,A03,193514,Chang; Edmond Yi-Teh,0,5,28,28
1683286042262,MMW 15,A04,193515,Chang; Edmond Yi-Teh,0,4,28,28
1683286042262,MMW 15,A05,193516,Chang; Edmond Yi-Teh,0,4,28,28
1683286042262,MMW 15,A06,193517,Chang; Edmond Yi-Teh,0,5,28,28
1683286042262,MMW 15,B01,193519,Chang; Edmond Yi-Teh,0,4,28,28
1683286042262,MMW 15,B02,193520,Chang; Edmond Yi-Teh,0,5,28,28
1683286042262,MMW 15,B03,193521,Chang; Edmond Yi-Teh,0,4,28,28
1683286042262,MMW 15,B04,193522,Chang; Edmond Yi-Teh,0,4,28,28
1683286042262,MMW 15,B05,193523,Chang; Edmond Yi-Teh,0,5,28,28
1683286042262,MMW 15,B06,193524,Chang; Edmond Yi-Teh,0,4,28,28
1683286043291,MMW 122,A01,193526,Rahimi; Babak,0,14,28,28
1683286043291,MMW 122,A02,193527,Rahimi; Babak,0,14,28,28
1683286043291,MMW 122,A03,193528,Rahimi; Babak,0,0,0,0
1683286043291,MMW 122,A04,193529,Rahimi; Babak,0,0,0,0
1683286044325,MUS 1A,A01,186663,Staff,0,20,35,35
1683286045360,MUS 4,A01,186715,Staff,0,12,35,35
1683286046394,MUS 5R,A01,186796,Dubnov; Shlomo,0,16,35,35
1683286047426,MUS 6,A01,186798,Staff,0,3,25,25
1683286048461,MUS 7,A01,186830,Staff,12,0,35,23
1683286049493,MUS 8,A01,186930,Staff,0,25,35,35
1683286050528,MUS 15,A01,186932,Staff,0,15,35,35
1683286050528,MUS 15,B01,186934,Staff,0,14,35,35
1683286051557,MUS 80,A00,186935,Staff,2,0,20,18
1683286051557,MUS 80,B00,186936,Staff,25,0,25,0
1683286052587,NANO 11,A00,204702,Lipomi; Darren John,0,0,0,0
1683286053625,NANO 15,A01,204709,Yang; Kesong,0,1,0,0
1683286054655,NANO 114,A00,202069,Jahed Motlagh; Zeinab,3,0,10,7
1683286055689,PHIL 1,A00,186955,Grush; Rick Scott,32,0,40,8
1683286056723,PHIL 10,A01,186973,Grush; Rick Scott,29,0,35,6
1683286056723,PHIL 10,A02,186974,Grush; Rick Scott,33,0,35,2
1683286057756,PHIL 13,A01,186976,Staff,7,0,35,28
1683286057756,PHIL 13,A02,186977,Staff,16,0,35,19
1683286058786,PHIL 14,A01,186979,Staff,31,0,35,4
1683286058786,PHIL 14,A02,186986,Staff,32,0,35,3
1683286059817,PHIL 28,A01,186988,Staff,16,0,30,14
1683286059817,PHIL 28,A02,186989,Staff,1,0,30,29
1683286059817,PHIL 28,A03,186990,Staff,9,0,30,21
1683286059817,PHIL 28,A04,186991,Staff,26,0,30,4
1683286060846,PHIL 120,A00,186997,Staff,23,0,40,17
1683286061875,PHIL 137,A00,187003,Staff,9,0,40,31
1683286062907,PHIL 150,A00,187015,Staff,47,0,70,23
1683286063939,PHIL 167,A00,187021,Lamey; Andy M.,35,0,40,5
1683286064968,PHIL 174,A01,202226,Staff,17,0,20,3
1683286064968,PHIL 174,A02,202235,Staff,20,0,20,0
1683286065995,PHIL 191A,A00,258918,Staff,0,0,1,1
1683286067026,PHYS 1A,A00,187028,Staff,26,0,60,34
1683286068052,PHYS 1AL,001,187036,Staff,2,0,30,28
1683286068052,PHYS 1AL,002,187049,Staff,18,0,30,12
1683286069081,PHYS 1B,A00,187058,Staff,23,0,60,37
1683286070113,PHYS 1BL,001,187064,Staff,0,0,30,30
1683286070113,PHYS 1BL,002,187070,Staff,6,0,30,24
1683286071145,PHYS 1C,A00,187082,Staff,32,0,120,88
1683286072172,PHYS 1CL,001,187088,Staff,0,9,30,30
1683286072172,PHYS 1CL,002,187089,Staff,0,2,30,30
1683286072172,PHYS 1CL,009,262693,Staff,12,0,30,18
1683286073201,PHYS 2B,A01,187097,Staff,54,0,115,61
1683286074231,PHYS 2C,A01,187099,Staff,67,0,115,48
1683286075264,PHYS 2CL,A01,187101,Staff,5,0,28,23
1683286075264,PHYS 2CL,A02,187102,Staff,15,0,28,13
1683286076294,PHYS 2D,A01,187123,Shotwell; Brian,95,0,115,20
1683286077328,PHYS 4B,A01,187133,Grinstein; Benjamin,35,0,50,15
1683286078353,POLI 10,A00,188819,Staff,0,3,50,50
1683286079381,POLI 11,A00,188827,Staff,43,0,50,7
1683286080409,POLI 13R,A00,188828,Staff,0,1,20,20
1683286081442,POLI 27,A01,188830,Elgin; Samuel Zincke,0,1,70,70
1683286082474,POLI 30,A00,188832,Desposato; Scott,33,0,50,17
1683286083508,POLI 102F,A00,188834,Staff,3,0,40,37
1683286084539,POLI 104A,A00,188852,Staff,14,0,30,16
1683286085569,POLI 104I,A00,188853,Staff,0,6,20,20
1683286086602,POLI 110B,A00,188854,Wiens; David,7,0,20,13
1683286087634,POLI 112A,A00,188855,Wiens; David,5,0,30,25
1683286088666,POLI 117R,A00,188856,Forman; Fonna,0,11,20,20
1683286089698,POLI 118,A00,188857,Ingham; Sean,8,0,20,12
1683286090732,POLI 120G,A00,188858,Staff,9,0,30,21
1683286091770,POLI 131CR,A00,188863,Hoston; Germaine,24,0,50,26
1683286092798,POLI 133,A00,188864,Nellis; Gareth Hb,44,0,50,6
1683286093826,POLI 134D,A00,188865,Desposato; Scott,27,0,30,3
1683286094855,POLI 142A,A00,188871,Gartzke; Erik,22,0,50,28
1683286095884,POLI 142K,A00,188874,Staff,38,0,50,12
1683286096913,POLI 143,A00,188940,Gartzke; Erik,16,0,30,14
1683286097944,POLI 153,A00,188943,Staff,3,0,20,17
1683286098976,POLI 160AA,A00,188944,Staff,13,0,40,27
1683286100008,POLI 170A,A00,188945,Staff,11,0,30,19
1683286102065,PSYC 1,A00,188952,Staff,38,0,90,52
1683286103093,PSYC 2,B00,188953,Staff,20,0,35,15
1683286104118,PSYC 6,A00,188970,Staff,47,0,60,13
1683286105150,PSYC 7,A00,188973,Staff,37,0,45,8
1683286106184,PSYC 60,A01,188980,Rickard; Timothy C.,43,0,60,17
1683286107214,PSYC 70,A01,189001,Steiner; Eric Tomas,24,0,45,21
1683286108241,PSYC 100,A00,189005,Lacefield; Katharine I,0,99,120,120
1683286109271,PSYC 102,A00,189008,Staff,10,0,30,20
1683286110303,PSYC 106,B00,189026,Gorman; Michael R.,37,0,60,23
1683286111331,PSYC 114,B01,189033,Winkielman; Piotr,0,32,30,30
1683286112360,PSYC 131,A00,189036,Anagnostaras; Stephan,0,43,60,60
1683286113389,PSYC 136,A00,189041,Lowe; Angela Beth,0,7,25,25
1683286114415,PSYC 137,A00,189057,Winkielman; Piotr,0,34,25,25
1683286115443,PSYC 144,A00,189107,Wixted; John T,0,7,50,50
1683286117502,PSYC 162,A00,189142,Staff,0,8,85,85
1683286118535,PSYC 172,A00,189144,Gorman; Michael R.,0,7,30,30
1683286120592,PSYC 179,A00,189146,Lacefield; Katharine I,0,84,120,120
1683286121621,PSYC 181,A00,189147,Anagnostaras; Stephan,0,44,90,90
1683286122654,PSYC 190R,A00,189148,Barner; David A.,0,22,80,80
1683286123684,PSYC 191,A00,189275,Rickard; Timothy C.,0,7,25,25
1683286124717,PSYC 193,A00,189276,Chapman; Eddie Nathaniel,0,1,0,4
1683286125748,PSYC 193L,A01,189281,Lowe; Angela Beth,12,0,20,8
1683286125748,PSYC 193L,B01,189285,Staff,28,0,35,7
1683286126778,RELI 149,A00,187137,Rahimi; Babak,7,0,40,33
1683286127813,SE 9,A01,187315,Staff,0,2,18,18
1683286128847,SE 101B,A00,187409,Staff,24,0,30,6
1683286129876,SE 110B,A00,187444,Staff,10,0,40,30
1683286130904,SE 130B,A00,187449,Staff,31,0,40,9
1683286131932,SE 150A,A00,187516,Staff,9,0,20,11
1683286132960,SE 154,A00,187528,Staff,30,0,50,20
1683286133987,SIO 3,A01,258171,Staff,35,0,40,5
1683286135019,SIO 10,A00,187144,Cook; Geoffrey W,0,3,75,75
1683286136105,SIO 45,A00,187152,Cook; Geoffrey W,1,0,100,99
1683286137135,SIO 109R,A00,194486,Staff,0,3,20,20
1683286139193,SIO 187,A01,187233,Kacev; David,12,0,40,28
1683286140229,SOCI 1,A01,258656,Thorpe; Charles Robert,28,0,30,2
1683286140229,SOCI 1,A02,258658,Thorpe; Charles Robert,30,0,30,0
1683286140229,SOCI 1,A03,258661,Thorpe; Charles Robert,25,0,25,0
1683286140229,SOCI 1,A04,258666,Thorpe; Charles Robert,22,0,25,3
1683286140229,SOCI 1,A05,258897,Thorpe; Charles Robert,23,0,25,2
1683286140229,SOCI 1,A06,258898,Thorpe; Charles Robert,25,0,25,0
1683286141274,SOCI 30,A01,258903,Pardo Guerra; Juan Pablo,16,0,30,14
1683286142306,SOCI 102,A00,258904,Staff,9,0,25,16
1683286143335,SOCI 106,A00,258905,Staff,19,0,25,6
1683286144365,SOCI 111,A00,258907,Ribas Norris; Janet Vanesa,26,0,30,4
1683286145397,SOCI 121R,A00,258908,Pardo Guerra; Juan Pablo,11,0,30,19
1683286146426,SOCI 126,A01,203330,Staff,14,0,20,6
1683286147458,SOCI 131,A00,258909,Thorpe; Charles Robert,31,0,60,29
1683286148491,SOCI 135,A00,258910,Payne; Christine Anna,0,9,30,30
1683286149523,SOCI 157,A00,258911,Staff,13,0,30,17
1683286150552,SOCI 184,A00,258912,Staff,26,0,30,4
1683286151582,SOCI 188D,A00,258913,Staff,21,0,30,9
1683286152610,SYN 2,001,187529,Staff,9,0,16,7
1683286152610,SYN 2,002,201452,Staff,0,18,16,16
1683286152610,SYN 2,003,201469,Staff,3,0,16,13
1683286153638,SYN 100,A01,187531,Staff,0,9,20,20
1683286153638,SYN 100,B01,201491,Staff,0,12,20,20
1683286154672,TDAC 1,A00,189286,Walsh; Kim C.,3,0,20,17
1683286154672,TDAC 1,B00,189287,Harting; Carla Kelso,11,0,20,9
1683286155705,TDAC 101,A00,189300,Walsh; Kim C.,16,0,20,4
1683286155705,TDAC 101,B00,189301,Harting; Carla Kelso,18,0,20,2
1683286156738,TDAC 102,A00,189304,Basso; Beatrice,14,0,20,6
1683286157771,TDAC 108,A00,189305,Staff,18,0,20,2
1683286158799,TDDE 131,A00,189310,Staff,19,0,20,1
1683286158799,TDDE 131,B00,189314,Staff,19,0,20,1
1683286158799,TDDE 131,C00,189315,Staff,48,0,50,2
1683286158799,TDDE 131,D00,189316,Staff,14,0,15,1
1683286158799,TDDE 131,E00,204841,Staff,20,0,20,0
1683286159829,TDGE 10,A00,189289,Staff,30,0,50,20
1683286159829,TDGE 10,B00,189290,Havis; Allan,2,0,50,48
1683286160863,TDGE 11,A00,189291,Fulton; Julia,0,3,50,50
1683286160863,TDGE 11,B00,189292,Staff,20,0,25,5
1683286160863,TDGE 11,C00,260270,Staff,0,0,0,0
1683286161891,TDGE 25,A00,189294,Staff,3,0,20,17
1683286162919,TDGE 124,A00,189318,Fulton; Julia,0,8,50,50
1683286163944,TDGE 125,A00,189319,Staff,13,0,25,12
1683286163944,TDGE 125,B00,189320,Staff,23,0,25,2
1683286164971,TDGE 127,A00,189322,Havis; Allan,0,0,50,50
1683286165999,TDHT 101,A00,189323,Staff,18,0,25,7
1683286165999,TDHT 101,B00,189324,Staff,25,0,25,0
1683286167028,TDHT 102,A00,189325,Staff,49,0,50,1
1683286168062,TDMV 1,A00,189295,Arcidiacono; Kristin,20,0,30,10
1683286168062,TDMV 1,B00,189296,Caligagan; Maria T.,24,0,30,6
1683286169095,TDMV 2,A00,189297,Sammartano; Tonnie,28,0,30,2
1683286169095,TDMV 2,B00,189299,Arcidiacono; Kristin,24,0,30,6
1683286170129,TDMV 3,A00,204998,Rincon; Alicia,22,0,30,8
1683286171161,TDMV 120,A00,189458,Sammartano; Tonnie,28,0,30,2
1683286172194,TDMV 138,A00,189541,Jun; Grace Shin Hae,22,0,40,18
1683286173224,TDMV 142,A00,189717,Caligagan; Tony,23,0,30,7
1683286173224,TDMV 142,B00,189718,Caligagan; Maria T.,25,0,30,5
1683286174254,TMC 2,A01,187533,Staff,25,0,25,0
1683286174254,TMC 2,A02,187534,Staff,25,0,25,0
1683286175283,USP 1,A01,187536,Kwak; Nancy,0,16,25,25
1683286176312,USP 5,A01,187538,Staff,9,0,25,16
1683286177339,USP 101,A00,199253,Staff,0,4,0,0
1683286178373,USP 124,A00,187562,Boomhower; Matthew Charles,1,0,30,29
1683286179405,USP 138,A00,187582,Staff,20,0,25,5
1683286180435,USP 152,A01,187597,Staff,4,0,25,21
1683286181465,USP 153,A00,187598,Staff,19,0,25,6
1683286182495,USP 168,A00,187607,Kwak; Nancy,2,0,5,3
1683286183523,USP 173,A00,187619,Staff,4,0,25,21
1683286184550,USP 181,A00,187638,Staff,0,0,25,25
1683286185576,VIS 103,A00,187650,Cruz; Edwin Teddy,23,0,75,52
1683286186605,VIS 110D,A00,187669,Staff,12,0,22,10
1683286198433,VIS 127C,A00,187720,Shen; Kuiyi,68,0,146,78
1683286199462,VIS 149,A00,187731,Yoldas; Pinar,0,14,22,22
1683286200488,VIS 151,A01,188091,Staff,22,0,34,12
1683286200488,VIS 151,A02,188092,Staff,11,0,34,23
1683286201515,VIS 160B,A00,188093,Stalbaum; Brett,0,0,10,10
1683286203576,WCWP 10B,A00,201720,Staff,10,0,15,5
1683286203576,WCWP 10B,B00,201722,Staff,8,0,15,7
1683286204611,WCWP 100,A00,201725,Gagnon; Jeffrey C,0,0,2,2
1683286204611,WCWP 100,B00,201727,Staff,0,4,15,15
1683286207850,ANBI 133,A00,258401,Wilder; Linnea Lorene,34,0,40,6
1683286220680,ANBI 140,A00,258395,Hrvoj Mihic; Branka,18,0,25,7
1683286221708,ANSC 120,A00,258402,Bialecki; Jon Anthony,27,0,40,13
1683286222735,ANSC 144,A00,258400,Staff,14,0,40,26
1683286224795,ANSC 166,A00,258396,Parish; Steven Martin,157,0,175,18
1683286225823,ANSC 180,A00,193533,Staff,9,0,20,11
1683286226851,ANSC 188,A00,258397,Jassal; Aftab,33,0,40,7
1683286227880,ANTH 3,A01,258316,Staff,23,0,30,7
1683286228908,ANTH 5,A00,258394,Semendeferi; Ekaterini,16,0,20,4
1683286229940,ANTH 21,A01,258331,Staff,9,0,40,31
1683286231963,ANTH 103,A00,258398,Varma; Saiba,15,0,25,10
1683286232995,AWP 10,001,202034,Staff,0,0,0,0
1683286232995,AWP 10,002,202035,Staff,0,0,0,0
1683286232995,AWP 10,003,202036,Staff,0,0,0,0
1683286232995,AWP 10,004,202037,Staff,0,0,0,0
1683286232995,AWP 10,005,202038,Staff,0,0,0,0
1683286232995,AWP 10,006,202039,Staff,0,0,0,0
1683286232995,AWP 10,007,202040,Staff,0,0,0,0
1683286232995,AWP 10,008,202041,Staff,0,0,0,0
1683286232995,AWP 10,009,202042,Staff,0,0,0,0
1683286232995,AWP 10,010,202043,Staff,0,0,0,0
1683286232995,AWP 10,011,202044,Staff,0,0,0,0
1683286232995,AWP 10,012,202045,Staff,0,0,0,0
1683286232995,AWP 10,013,202046,Staff,0,0,0,0
1683286232995,AWP 10,014,202047,Staff,0,0,0,0
1683286232995,AWP 10,015,202048,Staff,0,0,0,0
1683286232995,AWP 10,016,202049,Staff,0,0,0,0
1683286232995,AWP 10,017,202050,Staff,0,0,0,0
1683286232995,AWP 10,018,202051,Staff,0,0,0,0
1683286232995,AWP 10,019,202052,Staff,0,0,0,0
1683286232995,AWP 10,020,202053,Staff,0,0,0,0
1683286232995,AWP 10,021,202054,Staff,0,0,0,0
1683286232995,AWP 10,022,202055,Staff,0,0,0,0
1683286232995,AWP 10,023,202056,Staff,0,0,0,0
1683286232995,AWP 10,024,202057,Staff,0,0,0,0
1683286232995,AWP 10,025,202058,Staff,0,0,0,0
1683286232995,AWP 10,026,202059,Staff,0,0,0,0
1683286234024,AWP 102,001,202032,Staff,0,0,0,0
1683286234024,AWP 102,002,202033,Staff,0,0,0,0
1683286235053,BENG 100,A01,254234,Taylor Amos; Alyssa C,31,0,40,9
1683286236079,BENG 196,001,270013,Engler; Adam J.,9999,0,9999,0
1683286237109,BICD 100R,A01,202018,Smith; Laurie,0,7,32,32
1683286237109,BICD 100R,A02,202019,Smith; Laurie,0,2,32,32
1683286237109,BICD 100R,A03,202020,Smith; Laurie,0,1,32,32
1683286237109,BICD 100R,A04,202021,Smith; Laurie,8,0,32,24
1683286237109,BICD 100R,A05,202022,Smith; Laurie,12,0,32,20
1683286238138,BICD 136,A01,193242,Gustafson-Brown; Cindy,0,2,32,32
1683286238138,BICD 136,A02,193244,Gustafson-Brown; Cindy,15,0,32,17
1683286239170,BIEB 102,A01,193249,Butler; Shannon Rhey,0,2,32,32
1683286239170,BIEB 102,A02,193251,Butler; Shannon Rhey,0,0,32,32
1683286239170,BIEB 102,A03,193253,Butler; Shannon Rhey,0,1,32,32
1683286239170,BIEB 102,A04,193255,Butler; Shannon Rhey,17,0,32,15
1683286239170,BIEB 102,A05,193265,Butler; Shannon Rhey,26,0,32,6
1683286239170,BIEB 102,A06,193269,Butler; Shannon Rhey,16,0,32,16
1683286241228,BIEB 150,A01,193274,Staff,0,0,32,32
1683286241228,BIEB 150,A02,193285,Staff,24,0,32,8
1683286242258,BIEB 194,A00,193286,Kurle; Carolyn M.,22,0,32,10
1683286243295,BILD 1,A01,192291,Staff,16,0,32,16
1683286243295,BILD 1,A02,192292,Staff,30,0,32,2
1683286243295,BILD 1,B01,192520,Reuther; Keefe,0,1,0,0
1683286243295,BILD 1,B02,192532,Reuther; Keefe,0,1,0,0
1683286244323,BILD 3,A01,192556,Butler; Shannon Rhey,0,0,32,32
1683286244323,BILD 3,A02,192581,Butler; Shannon Rhey,5,0,32,27
1683286244323,BILD 3,A03,192611,Butler; Shannon Rhey,23,0,32,9
1683286244323,BILD 3,A04,192612,Butler; Shannon Rhey,25,0,32,7
1683286244323,BILD 3,A05,192613,Butler; Shannon Rhey,27,0,32,5
1683286244323,BILD 3,A06,192679,Butler; Shannon Rhey,27,0,32,5
1683286244323,BILD 3,A07,192682,Butler; Shannon Rhey,22,0,32,10
1683286245351,BILD 4,A01,192836,Reuther; Keefe,1,0,24,23
1683286245351,BILD 4,A02,193044,Reuther; Keefe,4,0,24,20
1683286246379,BILD 10,A01,193142,Gustafson-Brown; Cindy,31,0,32,1
1683286246379,BILD 10,A02,193149,Gustafson-Brown; Cindy,31,0,32,1
1683286247408,BIMM 100,A01,193301,Staff,0,6,32,32
1683286247408,BIMM 100,A02,193312,Staff,0,5,32,32
1683286247408,BIMM 100,A03,193323,Staff,0,8,32,32
1683286248438,BIMM 101,A01,193329,McDonnell; Lisa Marie,0,3,24,24
1683286248438,BIMM 101,A02,193339,McDonnell; Lisa Marie,0,2,24,24
1683286248438,BIMM 101,B01,193354,McDonnell; Lisa Marie,0,3,24,24
1683286248438,BIMM 101,B02,193357,McDonnell; Lisa Marie,0,3,24,24
1683286249470,BIMM 110,A01,193377,Tat; John,0,11,32,32
1683286249470,BIMM 110,A02,193378,Tat; John,1,9,32,31
1683286250501,BIMM 120,A01,206116,Staff,0,0,32,32
1683286250501,BIMM 120,A02,206117,Staff,8,0,32,24
1683286250501,BIMM 120,A03,206121,Staff,21,0,32,11
1683286251530,BIPN 100,A01,193393,Park; Ji Young,0,14,32,32
1683286251530,BIPN 100,A02,193402,Park; Ji Young,0,12,32,32
1683286251530,BIPN 100,A03,193413,Park; Ji Young,0,14,32,32
1683286251530,BIPN 100,A04,193414,Park; Ji Young,0,13,32,32
1683286252558,BIPN 102,A01,193429,Staff,0,0,32,32
1683286252558,BIPN 102,A02,193438,Staff,23,0,32,9
1683286253586,BIPN 106,A01,193450,Reyes Gonzalez; Catalina,0,2,40,40
1683286254620,BIPN 134,A01,193465,Cooke; James Edward,0,0,32,32
1683286254620,BIPN 134,A02,193474,Cooke; James Edward,27,0,32,5
1683286254620,BIPN 134,A03,193485,Cooke; James Edward,29,0,32,3
1683286254620,BIPN 134,A04,193486,Cooke; James Edward,21,0,32,11
1683286254620,BIPN 134,A05,193491,Cooke; James Edward,31,0,32,1
1683286254620,BIPN 134,A06,193501,Cooke; James Edward,30,0,32,2
1683286254620,BIPN 134,A07,193510,Cooke; James Edward,29,0,32,3
1683286258023,BISP 194,A00,222522,Staff,16,0,32,16
1683286259051,CAT 124,A01,202407,Staff,20,0,25,5
1683286260083,CAT 125,A00,202408,Marchisotto; Jennifer Anne,4,0,20,16
1683286261146,CAT 125R,A00,202409,Smith; Lauryn Alissa,0,11,20,20
1683286261146,CAT 125R,B00,202410,Morales; Celeste Georgianna,0,11,20,20
1683286261146,CAT 125R,C00,202411,Irwin; Matthew Joseph,0,10,20,20
1683286262176,CENG 15,A01,204712,Yang; Kesong,0,1,0,0
1683286263209,CENG 114,A00,202070,Jahed Motlagh; Zeinab,5,0,20,15
1683286264237,CGS 105,A00,185477,Wesling; Megan E.,24,0,40,16
1683286265355,CGS 106,A00,185494,Staff,13,0,22,9
1683286266386,CGS 108,A00,185495,Staff,14,0,20,6
1683286267418,CGS 114,A00,185496,Staff,13,0,18,5
1683286268445,CGS 119,A00,185501,Staff,15,0,20,5
1683286269476,CGS 120,A00,185511,Staff,13,0,20,7
1683286270505,CHEM 4,A01,184675,Bussey; Thomas J,96,0,100,4
1683286271532,CHEM 6A,A01,184677,Staff,35,0,60,25
1683286272561,CHEM 6B,A01,184679,Staff,65,0,100,35
1683286273594,CHEM 6C,A01,184681,Bussey; Thomas J,1,0,50,49
1683286273594,CHEM 6C,A02,184682,Bussey; Thomas J,34,0,50,16
1683286274628,CHEM 40A,A01,184684,Albizati; Kim F.,37,0,100,63
1683286275660,CHEM 40B,A01,184686,Albizati; Kim F.,0,20,100,100
1683286276692,CHEM 41B,A01,184690,Staff,52,0,100,48
1683286277724,COGS 3,A01,184715,Boyle; Mary E. T.,0,25,40,40
1683286278757,COGS 14B,A01,185172,Staff,0,15,38,38
1683286279789,COGS 18,A01,184736,Staff,20,0,80,60
1683286280817,COGS 100,A01,184932,Staff,0,5,73,73
1683286281845,COGS 101A,A01,184935,Staff,0,38,30,30
1683286282872,COGS 101B,A01,184944,Staff,0,2,30,30
1683286283899,COGS 101C,A01,184946,Staff,0,12,30,30
1683286284930,COGS 102A,A01,184951,Johnson; Christine M.,2,0,40,38
1683286285958,COGS 107B,A01,184953,Mooshagian; Eric Frederick,0,50,40,40
1683286286992,COGS 118B,A01,184959,Gupta; Anjum,0,48,40,40
1683286288023,COGS 153,A00,184961,Staff,0,15,30,30
1683286289055,COGS 177,A00,184962,Staff,0,21,30,30
1683286290085,COGS 187A,A01,184969,Boyle; Mary E. T.,0,17,40,40
1683286291115,COMM 10,A01,185174,Staff,0,5,25,25
1683286291115,COMM 10,A02,185189,Staff,0,5,25,25
1683286291115,COMM 10,A03,269821,Staff,0,0,0,0
1683286292147,COMM 100B,A01,185475,Staff,0,0,0,2
1683286292147,COMM 100B,A02,185476,Staff,14,0,25,11
1683286293180,COMM 100C,A01,185314,Staff,1,0,25,24
1683286293180,COMM 100C,A02,185327,Staff,19,0,25,6
1683286294206,COMM 110M,A00,185349,Staff,2,0,40,38
1683286295234,COMM 113T,A00,185352,Staff,25,0,40,15
1683286296260,COMM 114I,A00,185353,Staff,33,0,40,7
1683286297287,COMM 131,A00,185354,Staff,19,0,30,11
1683286298314,CSE 8A,A50,185358,Cao; Yingjun,0,46,10,10
1683286299344,CSE 8B,A01,185362,Staff,0,47,50,50
1683286300375,CSE 11,A01,185416,Cao; Yingjun,0,93,10,10
1683286301402,CSE 20,A01,185445,Briones; Jor-el Thomas Caparas,5,0,25,20
1683286302430,CSE 21,A01,185447,Staff,10,0,50,40
1683286303458,CSE 101,A01,185451,Staff,0,12,50,50
1683286303458,CSE 101,B01,185453,Jones; Miles E,0,11,50,50
1683286305517,CSE 141,A01,185458,Eldon; John,20,0,100,80
1683286306546,CSE 141L,A01,185461,Eldon; John,12,0,100,88
1683286307574,CSE 142,A01,185463,Staff,35,0,60,25
1683286307574,CSE 142,B01,201355,Staff,0,6,60,60
1683286308606,CSE 142L,A01,185470,Staff,35,0,60,25
1683286308606,CSE 142L,B01,201417,Staff,0,5,60,60
1683286309634,CSE 190,A00,201433,Staff,32,0,49,17
1683286310667,DOC 1,A01,259136,Strom; Megan C.,8,0,15,7
1683286310667,DOC 1,A02,259137,Strom; Megan C.,14,0,15,1
1683286310667,DOC 1,A03,259138,Strom; Megan C.,14,0,15,1
1683286310667,DOC 1,A04,259139,Strom; Megan C.,14,0,15,1
1683286311696,DOC 100D,A00,259140,Pass; Natalye Joann,17,0,25,8
1683286312723,DSGN 1,A01,184749,Rill; Bryan,0,24,30,30
1683286313751,DSGN 100,A01,185168,Staff,0,2,25,25
1683286314786,ECE 5,A01,185626,Morris; Karcher William,0,10,0,0
1683286315817,ECE 101,A01,185628,Staff,17,0,70,53
1683286316850,ECE 107,A01,185635,Baghdadchi; Saharnaz,0,0,20,20
1683286316850,ECE 107,A02,185638,Baghdadchi; Saharnaz,4,0,20,16
1683286317880,ECE 148,A01,185647,Silberman; Jack,1,0,16,15
1683286318905,ECON 1,A01,185537,Crane; Meredith Helen,54,0,70,16
1683286319937,ECON 3,A01,185549,Crane; Meredith Helen,33,0,70,37
1683286320968,ECON 4,A01,203354,Anderson; John Charles,0,4,10,10
1683286322008,ECON 100A,A01,185574,Staff,0,4,40,40
1683286323034,ECON 100B,A01,185576,Staff,0,22,40,40
1683286324063,ECON 100C,A01,185589,Newhouse; Herbert S,30,0,70,40
1683286325091,ECON 105,A00,185608,Vespa; Emanuel Ignacio,19,0,35,16
1683286326119,ECON 109,A01,185610,Shishkin; Denis,10,0,35,25
1683286327144,ECON 110A,A01,185612,Staff,11,0,40,29
1683286328171,ECON 120A,A01,185615,Staff,20,0,40,20
1683286329199,ECON 120C,A01,185617,Sun; Yixiao,0,20,70,70
1683286330230,ECON 144,A00,203346,Squires; Dale E,3,0,35,32
1683286331262,ECON 171,A01,203349,Newhouse; Herbert S,0,1,35,35
1683286332295,ECON 173A,A01,185621,Toda; Alexis Akira,21,0,35,14
1683286333327,EDS 25,A01,202413,Staff,0,1,0,0
1683286333327,EDS 25,A02,202414,Staff,0,1,0,0
1683286333327,EDS 25,A03,202415,Staff,0,0,0,0
1683286333327,EDS 25,A04,202416,Staff,0,1,0,0
1683286333327,EDS 25,A05,202439,Staff,0,0,0,0
1683286333327,EDS 25,A06,202440,Staff,0,0,0,0
1683286333327,EDS 25,B01,202631,Staff,0,0,0,0
1683286333327,EDS 25,B02,202632,Staff,0,0,0,0
1683286333327,EDS 25,B03,202639,Staff,0,0,0,0
1683286333327,EDS 25,B04,202640,Staff,0,0,0,0
1683286333327,EDS 25,B05,202643,Staff,0,0,0,0
1683286333327,EDS 25,B06,202644,Staff,0,0,0,0
1683286334355,EDS 38,A01,202659,Black; Alison Michelle,24,0,25,1
1683286335382,EDS 115,A00,202652,Staff,17,0,30,13
1683286336407,EDS 125,A00,202649,Staff,14,0,30,16
1683286337438,EDS 126,A01,203332,Staff,30,0,30,0
1683286338465,EDS 139,A00,202838,Staff,17,0,25,8
1683286339496,EDS 146,A01,202655,Staff,15,0,25,10
1683286340524,ENG 15,A00,185667,Staff,0,1,0,0
1683286340524,ENG 15,B00,185672,Staff,0,0,0,0
1683286340524,ENG 15,C00,185675,Staff,0,0,0,0
1683286340524,ENG 15,D00,185682,Staff,0,0,0,0
1683286340524,ENG 15,E00,185684,Staff,0,0,0,0
1683286341551,ETHN 103,A00,185710,Staff,0,3,35,35
1683286342581,ETHN 103A,A00,199228,Man; Simeon S,3,0,9,6
1683286343608,ETHN 109,A00,185711,Staff,18,0,35,17
1683286344634,ETHN 142,A00,185726,Staff,0,4,30,30
1683286345662,ETHN 163J,A00,199229,Man; Simeon S,6,0,8,2
1683286346689,ETHN 168,A00,185727,Staff,8,0,10,2
1683286347717,ETHN 182,A00,185728,Staff,1,0,35,34
1683286348744,ETHN 183,A00,185737,Staff,8,0,18,10
1683286349773,GLBH 111,A01,209361,Burgos; Jose L.,0,0,0,0
1683286351830,HIEU 104,A00,185792,Staff,16,0,20,4
1683286352858,HIEU 115,A00,185800,Staff,1,0,20,19
1683286353891,HIEU 128,A00,185801,Staff,0,7,20,20
1683286354921,HIEU 147,A00,185802,Staff,16,0,20,4
1683286355953,HIEU 154,A00,185823,Staff,12,0,20,8
1683286356982,HILA 102,A00,185826,Staff,13,0,20,7
1683286358010,HILD 2C,A01,185778,Staff,0,12,20,20
1683286359037,HILD 7B,A01,185780,Kwak; Nancy,0,15,32,32
1683286359037,HILD 7B,A02,185781,Kwak; Nancy,0,18,32,32
1683286360063,HILD 30,A01,185791,Staff,14,0,20,6
1683286361091,HISC 119,A00,185830,Golan; Tal,0,9,20,20
1683286362119,HITO 156GS,A00,185831,Patterson; Patrick H.,0,0,0,23
1683286363147,HIUS 103,A00,185832,Man; Simeon S,0,7,20,20
1683286364179,HIUS 117,A00,185836,Kwak; Nancy,2,0,20,18
1683286365206,HIUS 125,A00,185840,Man; Simeon S,0,0,23,23
1683286366236,HIUS 149,A00,185845,Staff,0,0,20,20
1683286367265,HUM 3,A01,185882,Zavodny; Tatiana Sophia,0,6,50,50
1683286367265,HUM 3,B01,185899,Caldwell; Michael Alan,0,19,50,50
1683286368294,HUM 3GS,A00,185900,Patterson; Patrick H.,0,0,0,23
1683286369385,HUM 4,A01,185938,Zroka; Amy Liane,31,0,50,19
1683286369385,HUM 4,B01,185956,Watkins; Eric,0,2,50,50
1683286369385,HUM 4,B02,202209,Watkins; Eric,0,1,50,50
1683286369385,HUM 4,B03,202210,Watkins; Eric,0,0,50,50
1683286370430,HUM 5,A01,185958,West; Geoffrey Scott,5,0,50,45
1683286370430,HUM 5,A02,202215,West; Geoffrey Scott,0,0,50,50
1683286371463,INTL 190,A00,185959,Gagnon; Jeffrey C,0,0,0,9
1683286371463,INTL 190,B00,185960,Lettieri; Michael Joseph,0,0,0,1
1683286372491,JAPN 180,A00,254509,Staff,0,1,25,25
1683286373520,LATI 10,A01,202853,Kennemore; Amy Michelle,5,0,35,30
1683286373520,LATI 10,A02,202854,Kennemore; Amy Michelle,1,0,35,34
1683286373520,LATI 10,A03,270054,Kennemore; Amy Michelle,30,0,30,0
1683286374547,LATI 180,A00,202855,Kennemore; Amy Michelle,11,0,20,9
1683286375575,LAWS 101,A00,201767,Golan; Tal,0,7,40,40
1683286376600,LIFR 1C,A00,185961,Staff,6,0,20,14
1683286377628,LIFR 1CX,A00,185962,Staff,7,0,20,13
1683286378654,LIFR 1D,A00,185963,Staff,9,0,20,11
1683286379680,LIFR 1DX,A00,185964,Staff,9,0,20,11
1683286380710,LIGN 101,A01,186039,Staff,43,0,50,7
1683286381741,LIGN 165,A00,186040,Staff,18,0,50,32
1683286382772,LTCS 108,A00,186041,Staff,6,0,10,4
1683286383800,LTCS 119,A00,186042,Staff,16,0,20,4
1683286384827,LTCS 130,A00,186043,Wesling; Megan E.,15,0,25,10
1683286386883,LTEA 138,A00,186119,Staff,14,0,40,26
1683286387912,LTEN 124,A00,186148,Staff,6,0,25,19
1683286388942,LTEN 178,A00,186149,Staff,7,0,15,8
1683286389974,LTEN 181,A00,186150,Blanco; John D,33,0,40,7
1683286391001,LTWL 120,A00,186160,Staff,20,0,25,5
1683286392034,LTWL 165,A00,186161,Staff,22,0,25,3
1683286393065,LTWR 100,A00,186162,Staff,0,4,15,15
1683286394097,LTWR 102,A00,186163,Doller; Ben,5,0,15,10
1683286395125,MAE 8,A01,186412,Staff,0,0,0,0
1683286396153,MAE 30B,A00,186445,Bahadori; Mohammad Yousef,83,0,100,17
1683286397186,MAE 40,A00,186592,Bewley; Thomas R,9,0,50,41
1683286398218,MAE 101B,A00,186593,Bahadori; Mohammad Yousef,81,0,100,19
1683286399250,MAE 105,A00,186594,Bandaru; Prabhakar,12,0,50,38
1683286400281,MAE 107,A00,186599,Pham; Hieu Tan,0,6,120,120
1683286401308,MAE 148,A01,186660,Silberman; Jack,3,0,16,13
1683286402343,MATH 10A,A01,188095,Staff,0,7,35,35
1683286403371,MATH 10B,A01,188097,Bowers; Adam R.,0,11,30,30
1683286403371,MATH 10B,A02,188099,Bowers; Adam R.,0,9,30,30
1683286403371,MATH 10B,B01,188104,Bowers; Adam R.,0,11,30,30
1683286403371,MATH 10B,B02,188106,Bowers; Adam R.,0,11,30,30
1683286404402,MATH 10C,A01,188111,Staff,0,18,30,30
1683286404402,MATH 10C,A02,188127,Staff,0,17,30,30
1683286404402,MATH 10C,A03,188131,Staff,0,17,30,30
1683286404402,MATH 10C,B01,188218,Staff,21,0,30,9
1683286404402,MATH 10C,B02,188244,Staff,13,0,30,17
1683286404402,MATH 10C,B03,188277,Staff,16,0,30,14
1683286405439,MATH 18,A01,188344,Bach; Quang Tran,18,0,30,12
1683286405439,MATH 18,A02,188345,Bach; Quang Tran,11,0,30,19
1683286405439,MATH 18,B01,188353,Bach; Quang Tran,10,0,30,20
1683286405439,MATH 18,B02,188354,Bach; Quang Tran,20,0,30,10
1683286406471,MATH 20A,A01,188374,Staff,13,0,35,22
1683286407506,MATH 20B,A01,188382,Ohm; Ko Woon,6,0,30,24
1683286407506,MATH 20B,A02,188383,Ohm; Ko Woon,24,0,30,6
1683286407506,MATH 20B,B01,188385,Ohm; Ko Woon,7,0,30,23
1683286407506,MATH 20B,B02,188392,Ohm; Ko Woon,22,0,30,8
1683286408541,MATH 20C,A01,188394,Harel; Guershon,10,0,30,20
1683286408541,MATH 20C,A02,188395,Harel; Guershon,13,0,30,17
1683286408541,MATH 20C,B01,188404,Harel; Guershon,3,0,30,27
1683286408541,MATH 20C,B02,188405,Harel; Guershon,19,0,30,11
1683286409572,MATH 20D,A01,188414,Hammock; Frances H,0,1,30,30
1683286409572,MATH 20D,A02,188415,Hammock; Frances H,4,0,30,26
1683286409572,MATH 20D,B01,188447,Hammock; Frances H,2,0,30,28
1683286409572,MATH 20D,B02,188486,Hammock; Frances H,8,0,30,22
1683286410603,MATH 20E,A01,188649,Staff,22,0,30,8
1683286410603,MATH 20E,A02,188650,Staff,23,0,30,7
1683286410603,MATH 20E,A03,188673,Staff,0,0,30,30
1683286411633,MATH 102,A01,188675,Staff,0,35,35,35
1683286412663,MATH 103B,A01,188681,Staff,4,0,35,31
1683286412663,MATH 103B,B01,188692,Staff,8,0,35,27
1683286413693,MATH 109,A01,188695,Salehi Golsefidy; Alireza,25,0,35,10
1683286413693,MATH 109,A02,188696,Salehi Golsefidy; Alireza,27,0,35,8
1683286414722,MATH 120A,A01,188698,Eggers; John Dietrich,5,0,35,30
1683286415751,MATH 142B,A01,188736,Ioana; Adrian,0,2,30,30
1683286415751,MATH 142B,A02,188741,Ioana; Adrian,0,1,30,30
1683286415751,MATH 142B,A03,188743,Ioana; Adrian,0,3,30,30
1683286416778,MATH 168A,A01,188790,Staff,0,8,35,35
1683286417806,MATH 170A,A01,188803,Nie; Jiawang,0,2,35,35
1683286417806,MATH 170A,A02,188811,Nie; Jiawang,0,0,35,35
1683286417806,MATH 170A,A03,188814,Nie; Jiawang,1,0,35,34
1683286417806,MATH 170A,A04,188815,Nie; Jiawang,14,0,35,21
1683286418834,MATH 193B,A01,188817,Staff,0,0,35,35
1683286418834,MATH 193B,A02,188818,Staff,5,0,35,30
1683286419867,MGT 4,A01,202857,Anderson; John Charles,62,0,80,18
1683286420898,MGT 12,A00,202858,Lindenberger; Wade Douglas,43,0,90,47
1683286421925,MGT 18,A00,202859,Staff,74,0,90,16
1683286422951,MGT 18GS,A00,202860,McKay; Michael J,13,0,28,15
1683286423981,MGT 45,A00,202861,Pecore; Joseph P.,14,0,90,76
1683286425007,MGT 100,A00,202863,Yavorsky; Daniel Ryan,28,0,90,62
1683286426034,MGT 103,A00,202864,Ehrich; Kristine R,0,16,90,90
1683286427060,MGT 112,A00,202865,Ehrich; Kristine R,15,0,90,75
1683286428089,MGT 121A,A00,202868,Staff,0,19,0,0
1683286429115,MGT 131B,A00,202869,Anderson; John Charles,60,0,90,30
1683286430141,MGT 136,A00,202871,Lindenberger; Wade Douglas,84,0,90,6
1683286431168,MGT 164,A00,202873,Staff,0,69,90,90
1683286432197,MGT 164GS,A00,202874,McKay; Mary A,13,0,28,15
1683286433226,MGT 180,A00,202875,Staff,0,51,90,90
1683286434254,MMW 11R,A01,205019,Herbst; Matthew,3,0,30,27
1683286434254,MMW 11R,A02,205026,Herbst; Matthew,29,0,30,1
1683286435283,MMW 15,A01,193512,Chang; Edmond Yi-Teh,0,9,28,28
1683286435283,MMW 15,A02,193513,Chang; Edmond Yi-Teh,0,5,28,28
1683286435283,MMW 15,A03,193514,Chang; Edmond Yi-Teh,0,5,28,28
1683286435283,MMW 15,A04,193515,Chang; Edmond Yi-Teh,0,4,28,28
1683286435283,MMW 15,A05,193516,Chang; Edmond Yi-Teh,0,4,28,28
1683286435283,MMW 15,A06,193517,Chang; Edmond Yi-Teh,0,5,28,28
1683286435283,MMW 15,B01,193519,Chang; Edmond Yi-Teh,0,4,28,28
1683286435283,MMW 15,B02,193520,Chang; Edmond Yi-Teh,0,5,28,28
1683286435283,MMW 15,B03,193521,Chang; Edmond Yi-Teh,0,4,28,28
1683286435283,MMW 15,B04,193522,Chang; Edmond Yi-Teh,0,4,28,28
1683286435283,MMW 15,B05,193523,Chang; Edmond Yi-Teh,0,5,28,28
1683286435283,MMW 15,B06,193524,Chang; Edmond Yi-Teh,0,4,28,28
1683286436312,MMW 122,A01,193526,Rahimi; Babak,0,14,28,28
1683286436312,MMW 122,A02,193527,Rahimi; Babak,0,14,28,28
1683286436312,MMW 122,A03,193528,Rahimi; Babak,0,0,0,0
1683286436312,MMW 122,A04,193529,Rahimi; Babak,0,0,0,0
1683286437344,MUS 1A,A01,186663,Staff,0,20,35,35
1683286438374,MUS 4,A01,186715,Staff,0,12,35,35
1683286439402,MUS 5R,A01,186796,Dubnov; Shlomo,0,16,35,35
1683286440430,MUS 6,A01,186798,Staff,0,3,25,25
1683286441456,MUS 7,A01,186830,Staff,12,0,35,23
1683286442484,MUS 8,A01,186930,Staff,0,25,35,35
1683286443512,MUS 15,A01,186932,Staff,0,15,35,35
1683286443512,MUS 15,B01,186934,Staff,0,14,35,35
1683286444538,MUS 80,A00,186935,Staff,2,0,20,18
1683286444538,MUS 80,B00,186936,Staff,25,0,25,0
1683286445572,NANO 11,A00,204702,Lipomi; Darren John,0,0,0,0
1683286446601,NANO 15,A01,204709,Yang; Kesong,0,1,0,0
1683286447633,NANO 114,A00,202069,Jahed Motlagh; Zeinab,3,0,10,7
1683286448661,PHIL 1,A00,186955,Grush; Rick Scott,32,0,40,8
1683286449688,PHIL 10,A01,186973,Grush; Rick Scott,29,0,35,6
1683286449688,PHIL 10,A02,186974,Grush; Rick Scott,33,0,35,2
1683286450717,PHIL 13,A01,186976,Staff,7,0,35,28
1683286450717,PHIL 13,A02,186977,Staff,16,0,35,19
1683286451745,PHIL 14,A01,186979,Staff,31,0,35,4
1683286451745,PHIL 14,A02,186986,Staff,32,0,35,3
1683286452773,PHIL 28,A01,186988,Staff,16,0,30,14
1683286452773,PHIL 28,A02,186989,Staff,1,0,30,29
1683286452773,PHIL 28,A03,186990,Staff,9,0,30,21
1683286452773,PHIL 28,A04,186991,Staff,26,0,30,4
1683286453806,PHIL 120,A00,186997,Staff,23,0,40,17
1683286454837,PHIL 137,A00,187003,Staff,9,0,40,31
1683286455865,PHIL 150,A00,187015,Staff,47,0,70,23
1683286456896,PHIL 167,A00,187021,Lamey; Andy M.,35,0,40,5
1683286457927,PHIL 174,A01,202226,Staff,17,0,20,3
1683286457927,PHIL 174,A02,202235,Staff,20,0,20,0
1683286458956,PHIL 191A,A00,258918,Staff,0,0,1,1
1683286459983,PHYS 1A,A00,187028,Staff,26,0,60,34
1683286461016,PHYS 1AL,001,187036,Staff,2,0,30,28
1683286461016,PHYS 1AL,002,187049,Staff,18,0,30,12
1683286462043,PHYS 1B,A00,187058,Staff,23,0,60,37
1683286463072,PHYS 1BL,001,187064,Staff,0,0,30,30
1683286463072,PHYS 1BL,002,187070,Staff,6,0,30,24
1683286464103,PHYS 1C,A00,187082,Staff,32,0,120,88
1683286465134,PHYS 1CL,001,187088,Staff,0,9,30,30
1683286465134,PHYS 1CL,002,187089,Staff,0,2,30,30
1683286465134,PHYS 1CL,009,262693,Staff,12,0,30,18
1683286466165,PHYS 2B,A01,187097,Staff,54,0,115,61
1683286467194,PHYS 2C,A01,187099,Staff,67,0,115,48
1683286468221,PHYS 2CL,A01,187101,Staff,5,0,28,23
1683286468221,PHYS 2CL,A02,187102,Staff,15,0,28,13
1683286469250,PHYS 2D,A01,187123,Shotwell; Brian,95,0,115,20
1683286470278,PHYS 4B,A01,187133,Grinstein; Benjamin,35,0,50,15
1683286471305,POLI 10,A00,188819,Staff,0,3,50,50
1683286472336,POLI 11,A00,188827,Staff,43,0,50,7
1683286473437,POLI 13R,A00,188828,Staff,0,1,20,20
1683286474470,POLI 27,A01,188830,Elgin; Samuel Zincke,0,1,70,70
1683286475498,POLI 30,A00,188832,Desposato; Scott,33,0,50,17
1683286476525,POLI 102F,A00,188834,Staff,3,0,40,37
1683286477556,POLI 104A,A00,188852,Staff,14,0,30,16
1683286478587,POLI 104I,A00,188853,Staff,0,6,20,20
1683286479622,POLI 110B,A00,188854,Wiens; David,7,0,20,13
1683286480654,POLI 112A,A00,188855,Wiens; David,5,0,30,25
1683286481684,POLI 117R,A00,188856,Forman; Fonna,0,11,20,20
1683286482716,POLI 118,A00,188857,Ingham; Sean,8,0,20,12
1683286483745,POLI 120G,A00,188858,Staff,9,0,30,21
1683286484772,POLI 131CR,A00,188863,Hoston; Germaine,24,0,50,26
1683286485801,POLI 133,A00,188864,Nellis; Gareth Hb,44,0,50,6
1683286486828,POLI 134D,A00,188865,Desposato; Scott,27,0,30,3
1683286487855,POLI 142A,A00,188871,Gartzke; Erik,22,0,50,28
1683286488882,POLI 142K,A00,188874,Staff,38,0,50,12
1683286489911,POLI 143,A00,188940,Gartzke; Erik,16,0,30,14
1683286490938,POLI 153,A00,188943,Staff,3,0,20,17
1683286491962,POLI 160AA,A00,188944,Staff,13,0,40,27
1683286492990,POLI 170A,A00,188945,Staff,11,0,30,19
1683286495048,PSYC 1,A00,188952,Staff,38,0,90,52
1683286496075,PSYC 2,B00,188953,Staff,20,0,35,15
1683286497102,PSYC 6,A00,188970,Staff,47,0,60,13
1683286498129,PSYC 7,A00,188973,Staff,37,0,45,8
1683286499158,PSYC 60,A01,188980,Rickard; Timothy C.,43,0,60,17
1683286500186,PSYC 70,A01,189001,Steiner; Eric Tomas,24,0,45,21
1683286501214,PSYC 100,A00,189005,Lacefield; Katharine I,0,99,120,120
1683286502245,PSYC 102,A00,189008,Staff,10,0,30,20
1683286503273,PSYC 106,B00,189026,Gorman; Michael R.,37,0,60,23
1683286504307,PSYC 114,B01,189033,Winkielman; Piotr,0,32,30,30
1683286505335,PSYC 131,A00,189036,Anagnostaras; Stephan,0,43,60,60
1683286506366,PSYC 136,A00,189041,Lowe; Angela Beth,0,7,25,25
1683286507397,PSYC 137,A00,189057,Winkielman; Piotr,0,34,25,25
1683286508426,PSYC 144,A00,189107,Wixted; John T,0,7,50,50
1683286510485,PSYC 162,A00,189142,Staff,0,8,85,85
1683286511512,PSYC 172,A00,189144,Gorman; Michael R.,0,7,30,30
1683286513566,PSYC 179,A00,189146,Lacefield; Katharine I,0,84,120,120
1683286514594,PSYC 181,A00,189147,Anagnostaras; Stephan,0,44,90,90
1683286515623,PSYC 190R,A00,189148,Barner; David A.,0,22,80,80
1683286516653,PSYC 191,A00,189275,Rickard; Timothy C.,0,7,25,25
1683286517680,PSYC 193,A00,189276,Chapman; Eddie Nathaniel,0,1,0,4
1683286518705,PSYC 193L,A01,189281,Lowe; Angela Beth,12,0,20,8
1683286518705,PSYC 193L,B01,189285,Staff,28,0,35,7
1683286519734,RELI 149,A00,187137,Rahimi; Babak,7,0,40,33
1683286520760,SE 9,A01,187315,Staff,0,2,18,18
1683286521789,SE 101B,A00,187409,Staff,24,0,30,6
1683286522821,SE 110B,A00,187444,Staff,10,0,40,30
1683286523853,SE 130B,A00,187449,Staff,31,0,40,9
1683286524884,SE 150A,A00,187516,Staff,9,0,20,11
1683286525913,SE 154,A00,187528,Staff,30,0,50,20
1683286526943,SIO 3,A01,258171,Staff,35,0,40,5
1683286527969,SIO 10,A00,187144,Cook; Geoffrey W,0,3,75,75
1683286529001,SIO 45,A00,187152,Cook; Geoffrey W,1,0,100,99
1683286530029,SIO 109R,A00,194486,Staff,0,3,20,20
1683286532089,SIO 187,A01,187233,Kacev; David,12,0,40,28
1683286533118,SOCI 1,A01,258656,Thorpe; Charles Robert,28,0,30,2
1683286533118,SOCI 1,A02,258658,Thorpe; Charles Robert,30,0,30,0
1683286533118,SOCI 1,A03,258661,Thorpe; Charles Robert,25,0,25,0
1683286533118,SOCI 1,A04,258666,Thorpe; Charles Robert,22,0,25,3
1683286533118,SOCI 1,A05,258897,Thorpe; Charles Robert,23,0,25,2
1683286533118,SOCI 1,A06,258898,Thorpe; Charles Robert,25,0,25,0
1683286534146,SOCI 30,A01,258903,Pardo Guerra; Juan Pablo,16,0,30,14
1683286535175,SOCI 102,A00,258904,Staff,9,0,25,16
1683286536252,SOCI 106,A00,258905,Staff,19,0,25,6
1683286537283,SOCI 111,A00,258907,Ribas Norris; Janet Vanesa,26,0,30,4
1683286538312,SOCI 121R,A00,258908,Pardo Guerra; Juan Pablo,11,0,30,19
1683286539340,SOCI 126,A01,203330,Staff,14,0,20,6
1683286540368,SOCI 131,A00,258909,Thorpe; Charles Robert,31,0,60,29
1683286541396,SOCI 135,A00,258910,Payne; Christine Anna,0,9,30,30
1683286542425,SOCI 157,A00,258911,Staff,13,0,30,17
1683286543454,SOCI 184,A00,258912,Staff,26,0,30,4
1683286544484,SOCI 188D,A00,258913,Staff,21,0,30,9
1683286545516,SYN 2,001,187529,Staff,9,0,16,7
1683286545516,SYN 2,002,201452,Staff,0,18,16,16
1683286545516,SYN 2,003,201469,Staff,3,0,16,13
1683286546544,SYN 100,A01,187531,Staff,0,9,20,20
1683286546544,SYN 100,B01,201491,Staff,0,12,20,20
1683286547576,TDAC 1,A00,189286,Walsh; Kim C.,3,0,20,17
1683286547576,TDAC 1,B00,189287,Harting; Carla Kelso,11,0,20,9
1683286548603,TDAC 101,A00,189300,Walsh; Kim C.,16,0,20,4
1683286548603,TDAC 101,B00,189301,Harting; Carla Kelso,18,0,20,2
1683286549633,TDAC 102,A00,189304,Basso; Beatrice,14,0,20,6
1683286550660,TDAC 108,A00,189305,Staff,18,0,20,2
1683286551689,TDDE 131,A00,189310,Staff,19,0,20,1
1683286551689,TDDE 131,B00,189314,Staff,19,0,20,1
1683286551689,TDDE 131,C00,189315,Staff,48,0,50,2
1683286551689,TDDE 131,D00,189316,Staff,14,0,15,1
1683286551689,TDDE 131,E00,204841,Staff,20,0,20,0
1683286552716,TDGE 10,A00,189289,Staff,30,0,50,20
1683286552716,TDGE 10,B00,189290,Havis; Allan,2,0,50,48
1683286553746,TDGE 11,A00,189291,Fulton; Julia,0,3,50,50
1683286553746,TDGE 11,B00,189292,Staff,20,0,25,5
1683286553746,TDGE 11,C00,260270,Staff,0,0,0,0
1683286554774,TDGE 25,A00,189294,Staff,3,0,20,17
1683286555800,TDGE 124,A00,189318,Fulton; Julia,0,8,50,50
1683286556829,TDGE 125,A00,189319,Staff,13,0,25,12
1683286556829,TDGE 125,B00,189320,Staff,23,0,25,2
1683286557855,TDGE 127,A00,189322,Havis; Allan,0,0,50,50
1683286558883,TDHT 101,A00,189323,Staff,18,0,25,7
1683286558883,TDHT 101,B00,189324,Staff,25,0,25,0
1683286559911,TDHT 102,A00,189325,Staff,49,0,50,1
1683286560942,TDMV 1,A00,189295,Arcidiacono; Kristin,20,0,30,10
1683286560942,TDMV 1,B00,189296,Caligagan; Maria T.,24,0,30,6
1683286561975,TDMV 2,A00,189297,Sammartano; Tonnie,28,0,30,2
1683286561975,TDMV 2,B00,189299,Arcidiacono; Kristin,24,0,30,6
1683286563009,TDMV 3,A00,204998,Rincon; Alicia,22,0,30,8
1683286564037,TDMV 120,A00,189458,Sammartano; Tonnie,28,0,30,2
1683286565067,TDMV 138,A00,189541,Jun; Grace Shin Hae,22,0,40,18
1683286566098,TDMV 142,A00,189717,Caligagan; Tony,23,0,30,7
1683286566098,TDMV 142,B00,189718,Caligagan; Maria T.,25,0,30,5
1683286567128,TMC 2,A01,187533,Staff,25,0,25,0
1683286567128,TMC 2,A02,187534,Staff,25,0,25,0
1683286568159,USP 1,A01,187536,Kwak; Nancy,0,16,25,25
1683286569190,USP 5,A01,187538,Staff,9,0,25,16
1683286570218,USP 101,A00,199253,Staff,0,4,0,0
1683286571246,USP 124,A00,187562,Boomhower; Matthew Charles,1,0,30,29
1683286572274,USP 138,A00,187582,Staff,20,0,25,5
1683286573301,USP 152,A01,187597,Staff,4,0,25,21
1683286574330,USP 153,A00,187598,Staff,19,0,25,6
1683286575357,USP 168,A00,187607,Kwak; Nancy,2,0,5,3
1683286576384,USP 173,A00,187619,Staff,4,0,25,21
1683286577484,USP 181,A00,187638,Staff,0,0,25,25
1683286578518,VIS 103,A00,187650,Cruz; Edwin Teddy,23,0,75,52
1683286579544,VIS 110D,A00,187669,Staff,12,0,22,10
1683286580585,VIS 127C,A00,187720,Shen; Kuiyi,68,0,146,78
1683286581616,VIS 149,A00,187731,Yoldas; Pinar,0,14,22,22
1683286582646,VIS 151,A01,188091,Staff,22,0,34,12
1683286582646,VIS 151,A02,188092,Staff,11,0,34,23
1683286583675,VIS 160B,A00,188093,Stalbaum; Brett,0,0,10,10
1683286585741,WCWP 10B,A00,201720,Staff,10,0,15,5
1683286585741,WCWP 10B,B00,201722,Staff,8,0,15,7
1683286586774,WCWP 100,A00,201725,Gagnon; Jeffrey C,0,0,2,2
1683286586774,WCWP 100,B00,201727,Staff,0,4,15,15
1683286589925,ANBI 133,A00,258401,Wilder; Linnea Lorene,34,0,40,6
1683286590954,ANBI 140,A00,258395,Hrvoj Mihic; Branka,18,0,25,7
1683286591978,ANSC 120,A00,258402,Bialecki; Jon Anthony,27,0,40,13
1683286593006,ANSC 144,A00,258400,Staff,14,0,40,26
1683286595060,ANSC 166,A00,258396,Parish; Steven Martin,157,0,175,18
1683286596090,ANSC 180,A00,193533,Staff,9,0,20,11
1683286597118,ANSC 188,A00,258397,Jassal; Aftab,33,0,40,7
1683286598146,ANTH 3,A01,258316,Staff,23,0,30,7
1683286599178,ANTH 5,A00,258394,Semendeferi; Ekaterini,16,0,20,4
1683286600209,ANTH 21,A01,258331,Staff,9,0,40,31
1683286601241,ANTH 103,A00,258398,Varma; Saiba,15,0,25,10
1683286602281,AWP 10,001,202034,Staff,0,0,0,0
1683286602281,AWP 10,002,202035,Staff,0,0,0,0
1683286602281,AWP 10,003,202036,Staff,0,0,0,0
1683286602281,AWP 10,004,202037,Staff,0,0,0,0
1683286602281,AWP 10,005,202038,Staff,0,0,0,0
1683286602281,AWP 10,006,202039,Staff,0,0,0,0
1683286602281,AWP 10,007,202040,Staff,0,0,0,0
1683286602281,AWP 10,008,202041,Staff,0,0,0,0
1683286602281,AWP 10,009,202042,Staff,0,0,0,0
1683286602281,AWP 10,010,202043,Staff,0,0,0,0
1683286602281,AWP 10,011,202044,Staff,0,0,0,0
1683286602281,AWP 10,012,202045,Staff,0,0,0,0
1683286602281,AWP 10,013,202046,Staff,0,0,0,0
1683286602281,AWP 10,014,202047,Staff,0,0,0,0
1683286602281,AWP 10,015,202048,Staff,0,0,0,0
1683286602281,AWP 10,016,202049,Staff,0,0,0,0
1683286602281,AWP 10,017,202050,Staff,0,0,0,0
1683286602281,AWP 10,018,202051,Staff,0,0,0,0
1683286602281,AWP 10,019,202052,Staff,0,0,0,0
1683286602281,AWP 10,020,202053,Staff,0,0,0,0
1683286602281,AWP 10,021,202054,Staff,0,0,0,0
1683286602281,AWP 10,022,202055,Staff,0,0,0,0
1683286602281,AWP 10,023,202056,Staff,0,0,0,0
1683286602281,AWP 10,024,202057,Staff,0,0,0,0
1683286602281,AWP 10,025,202058,Staff,0,0,0,0
1683286602281,AWP 10,026,202059,Staff,0,0,0,0
1683286603310,AWP 102,001,202032,Staff,0,0,0,0
1683286603310,AWP 102,002,202033,Staff,0,0,0,0
1683286604338,BENG 100,A01,254234,Taylor Amos; Alyssa C,31,0,40,9
1683286605364,BENG 196,001,270013,Engler; Adam J.,9999,0,9999,0
1683286606392,BICD 100R,A01,202018,Smith; Laurie,0,7,32,32
1683286606392,BICD 100R,A02,202019,Smith; Laurie,0,2,32,32
1683286606392,BICD 100R,A03,202020,Smith; Laurie,0,1,32,32
1683286606392,BICD 100R,A04,202021,Smith; Laurie,8,0,32,24
1683286606392,BICD 100R,A05,202022,Smith; Laurie,12,0,32,20
1683286607424,BICD 136,A01,193242,Gustafson-Brown; Cindy,0,2,32,32
1683286607424,BICD 136,A02,193244,Gustafson-Brown; Cindy,15,0,32,17
1683286608455,BIEB 102,A01,193249,Butler; Shannon Rhey,0,2,32,32
1683286608455,BIEB 102,A02,193251,Butler; Shannon Rhey,0,0,32,32
1683286608455,BIEB 102,A03,193253,Butler; Shannon Rhey,0,1,32,32
1683286608455,BIEB 102,A04,193255,Butler; Shannon Rhey,17,0,32,15
1683286608455,BIEB 102,A05,193265,Butler; Shannon Rhey,26,0,32,6
1683286608455,BIEB 102,A06,193269,Butler; Shannon Rhey,16,0,32,16
1683286610509,BIEB 150,A01,193274,Staff,0,0,32,32
1683286610509,BIEB 150,A02,193285,Staff,24,0,32,8
1683286611536,BIEB 194,A00,193286,Kurle; Carolyn M.,22,0,32,10
1683286612564,BILD 1,A01,192291,Staff,16,0,32,16
1683286612564,BILD 1,A02,192292,Staff,30,0,32,2
1683286612564,BILD 1,B01,192520,Reuther; Keefe,0,1,0,0
1683286612564,BILD 1,B02,192532,Reuther; Keefe,0,1,0,0
1683286613591,BILD 3,A01,192556,Butler; Shannon Rhey,0,0,32,32
1683286613591,BILD 3,A02,192581,Butler; Shannon Rhey,5,0,32,27
1683286613591,BILD 3,A03,192611,Butler; Shannon Rhey,23,0,32,9
1683286613591,BILD 3,A04,192612,Butler; Shannon Rhey,25,0,32,7
1683286613591,BILD 3,A05,192613,Butler; Shannon Rhey,27,0,32,5
1683286613591,BILD 3,A06,192679,Butler; Shannon Rhey,27,0,32,5
1683286613591,BILD 3,A07,192682,Butler; Shannon Rhey,22,0,32,10
1683286614627,BILD 4,A01,192836,Reuther; Keefe,1,0,24,23
1683286614627,BILD 4,A02,193044,Reuther; Keefe,4,0,24,20
1683286615655,BILD 10,A01,193142,Gustafson-Brown; Cindy,31,0,32,1
1683286615655,BILD 10,A02,193149,Gustafson-Brown; Cindy,31,0,32,1
1683286616682,BIMM 100,A01,193301,Staff,0,6,32,32
1683286616682,BIMM 100,A02,193312,Staff,0,5,32,32
1683286616682,BIMM 100,A03,193323,Staff,0,8,32,32
1683286617711,BIMM 101,A01,193329,McDonnell; Lisa Marie,0,3,24,24
1683286617711,BIMM 101,A02,193339,McDonnell; Lisa Marie,0,2,24,24
1683286617711,BIMM 101,B01,193354,McDonnell; Lisa Marie,0,3,24,24
1683286617711,BIMM 101,B02,193357,McDonnell; Lisa Marie,0,3,24,24
1683286618738,BIMM 110,A01,193377,Tat; John,0,11,32,32
1683286618738,BIMM 110,A02,193378,Tat; John,1,9,32,31
1683286619774,BIMM 120,A01,206116,Staff,0,0,32,32
1683286619774,BIMM 120,A02,206117,Staff,8,0,32,24
1683286619774,BIMM 120,A03,206121,Staff,21,0,32,11
1683286620801,BIPN 100,A01,193393,Park; Ji Young,0,14,32,32
1683286620801,BIPN 100,A02,193402,Park; Ji Young,0,12,32,32
1683286620801,BIPN 100,A03,193413,Park; Ji Young,0,14,32,32
1683286620801,BIPN 100,A04,193414,Park; Ji Young,0,13,32,32
1683286621832,BIPN 102,A01,193429,Staff,0,0,32,32
1683286621832,BIPN 102,A02,193438,Staff,23,0,32,9
1683286622866,BIPN 106,A01,193450,Reyes Gonzalez; Catalina,0,2,40,40
1683286623898,BIPN 134,A01,193465,Cooke; James Edward,0,0,32,32
1683286623898,BIPN 134,A02,193474,Cooke; James Edward,27,0,32,5
1683286623898,BIPN 134,A03,193485,Cooke; James Edward,29,0,32,3
1683286623898,BIPN 134,A04,193486,Cooke; James Edward,21,0,32,11
1683286623898,BIPN 134,A05,193491,Cooke; James Edward,31,0,32,1
1683286623898,BIPN 134,A06,193501,Cooke; James Edward,30,0,32,2
1683286623898,BIPN 134,A07,193510,Cooke; James Edward,29,0,32,3
1683286625955,BISP 194,A00,222522,Staff,16,0,32,16
1683286626983,CAT 124,A01,202407,Staff,20,0,25,5
1683286628011,CAT 125,A00,202408,Marchisotto; Jennifer Anne,4,0,20,16
1683286629041,CAT 125R,A00,202409,Smith; Lauryn Alissa,0,11,20,20
1683286629041,CAT 125R,B00,202410,Morales; Celeste Georgianna,0,11,20,20
1683286629041,CAT 125R,C00,202411,Irwin; Matthew Joseph,0,10,20,20
1683286630075,CENG 15,A01,204712,Yang; Kesong,0,1,0,0
1683286631109,CENG 114,A00,202070,Jahed Motlagh; Zeinab,5,0,20,15
1683286632141,CGS 105,A00,185477,Wesling; Megan E.,24,0,40,16
1683286633166,CGS 106,A00,185494,Staff,13,0,22,9
1683286634193,CGS 108,A00,185495,Staff,14,0,20,6
1683286635220,CGS 114,A00,185496,Staff,13,0,18,5
1683286636249,CGS 119,A00,185501,Staff,15,0,20,5
1683286637276,CGS 120,A00,185511,Staff,13,0,20,7
1683286638305,CHEM 4,A01,184675,Bussey; Thomas J,96,0,100,4
1683286639332,CHEM 6A,A01,184677,Staff,35,0,60,25
1683286640359,CHEM 6B,A01,184679,Staff,65,0,100,35
1683286641390,CHEM 6C,A01,184681,Bussey; Thomas J,1,0,50,49
1683286641390,CHEM 6C,A02,184682,Bussey; Thomas J,34,0,50,16
1683286642421,CHEM 40A,A01,184684,Albizati; Kim F.,37,0,100,63
1683286643449,CHEM 40B,A01,184686,Albizati; Kim F.,0,20,100,100
1683286644482,CHEM 41B,A01,184690,Staff,52,0,100,48
1683286645510,COGS 3,A01,184715,Boyle; Mary E. T.,0,25,40,40
1683286646545,COGS 14B,A01,185172,Staff,0,15,38,38
1683286647578,COGS 18,A01,184736,Staff,20,0,80,60
1683286648610,COGS 100,A01,184932,Staff,0,5,73,73
1683286649637,COGS 101A,A01,184935,Staff,0,38,30,30
1683286650665,COGS 101B,A01,184944,Staff,0,2,30,30
1683286651693,COGS 101C,A01,184946,Staff,0,12,30,30
1683286652721,COGS 102A,A01,184951,Johnson; Christine M.,2,0,40,38
1683286653753,COGS 107B,A01,184953,Mooshagian; Eric Frederick,0,50,40,40
1683286654781,COGS 118B,A01,184959,Gupta; Anjum,0,48,40,40
1683286655808,COGS 153,A00,184961,Staff,0,15,30,30
1683286656834,COGS 177,A00,184962,Staff,0,21,30,30
1683286657861,COGS 187A,A01,184969,Boyle; Mary E. T.,0,17,40,40
1683286658887,COMM 10,A01,185174,Staff,0,5,25,25
1683286658887,COMM 10,A02,185189,Staff,0,5,25,25
1683286658887,COMM 10,A03,269821,Staff,0,0,0,0
1683286659917,COMM 100B,A01,185475,Staff,0,0,0,2
1683286659917,COMM 100B,A02,185476,Staff,14,0,25,11
1683286660949,COMM 100C,A01,185314,Staff,1,0,25,24
1683286660949,COMM 100C,A02,185327,Staff,19,0,25,6
1683286661981,COMM 110M,A00,185349,Staff,2,0,40,38
1683286663012,COMM 113T,A00,185352,Staff,25,0,40,15
1683286664044,COMM 114I,A00,185353,Staff,33,0,40,7
1683286665072,COMM 131,A00,185354,Staff,19,0,30,11
1683286666103,CSE 8A,A50,185358,Cao; Yingjun,0,46,10,10
1683286667130,CSE 8B,A01,185362,Staff,0,47,50,50
1683286668158,CSE 11,A01,185416,Cao; Yingjun,0,93,10,10
1683286669185,CSE 20,A01,185445,Briones; Jor-el Thomas Caparas,5,0,25,20
1683286670213,CSE 21,A01,185447,Staff,10,0,50,40
1683286671240,CSE 101,A01,185451,Staff,0,12,50,50
1683286671240,CSE 101,B01,185453,Jones; Miles E,0,11,50,50
1683286673298,CSE 141,A01,185458,Eldon; John,20,0,100,80
1683286674328,CSE 141L,A01,185461,Eldon; John,12,0,100,88
1683286675355,CSE 142,A01,185463,Staff,35,0,60,25
1683286675355,CSE 142,B01,201355,Staff,0,6,60,60
1683286676381,CSE 142L,A01,185470,Staff,35,0,60,25
1683286676381,CSE 142L,B01,201417,Staff,0,5,60,60
1683286677412,CSE 190,A00,201433,Staff,32,0,49,17
1683286678437,DOC 1,A01,259136,Strom; Megan C.,8,0,15,7
1683286678437,DOC 1,A02,259137,Strom; Megan C.,14,0,15,1
1683286678437,DOC 1,A03,259138,Strom; Megan C.,14,0,15,1
1683286678437,DOC 1,A04,259139,Strom; Megan C.,14,0,15,1
1683286679467,DOC 100D,A00,259140,Pass; Natalye Joann,17,0,25,8
1683286680497,DSGN 1,A01,184749,Rill; Bryan,0,24,30,30
1683286681582,DSGN 100,A01,185168,Staff,0,2,25,25
1683286682615,ECE 5,A01,185626,Morris; Karcher William,0,10,0,0
1683286683646,ECE 101,A01,185628,Staff,17,0,70,53
1683286684679,ECE 107,A01,185635,Baghdadchi; Saharnaz,0,0,20,20
1683286684679,ECE 107,A02,185638,Baghdadchi; Saharnaz,4,0,20,16
1683286685707,ECE 148,A01,185647,Silberman; Jack,1,0,16,15
1683286686734,ECON 1,A01,185537,Crane; Meredith Helen,54,0,70,16
1683286687759,ECON 3,A01,185549,Crane; Meredith Helen,33,0,70,37
1683286688793,ECON 4,A01,203354,Anderson; John Charles,0,4,10,10
1683286689821,ECON 100A,A01,185574,Staff,0,4,40,40
1683286690849,ECON 100B,A01,185576,Staff,0,22,40,40
1683286691875,ECON 100C,A01,185589,Newhouse; Herbert S,30,0,70,40
1683286692903,ECON 105,A00,185608,Vespa; Emanuel Ignacio,19,0,35,16
1683286693933,ECON 109,A01,185610,Shishkin; Denis,10,0,35,25
1683286694960,ECON 110A,A01,185612,Staff,11,0,40,29
1683286695988,ECON 120A,A01,185615,Staff,20,0,40,20
1683286697016,ECON 120C,A01,185617,Sun; Yixiao,0,20,70,70
1683286698044,ECON 144,A00,203346,Squires; Dale E,3,0,35,32
1683286699071,ECON 171,A01,203349,Newhouse; Herbert S,0,1,35,35
1683286700099,ECON 173A,A01,185621,Toda; Alexis Akira,21,0,35,14
1683286701137,EDS 25,A01,202413,Staff,0,1,0,0
1683286701137,EDS 25,A02,202414,Staff,0,1,0,0
1683286701137,EDS 25,A03,202415,Staff,0,0,0,0
1683286701137,EDS 25,A04,202416,Staff,0,1,0,0
1683286701137,EDS 25,A05,202439,Staff,0,0,0,0
1683286701137,EDS 25,A06,202440,Staff,0,0,0,0
1683286701137,EDS 25,B01,202631,Staff,0,0,0,0
1683286701137,EDS 25,B02,202632,Staff,0,0,0,0
1683286701137,EDS 25,B03,202639,Staff,0,0,0,0
1683286701137,EDS 25,B04,202640,Staff,0,0,0,0
1683286701137,EDS 25,B05,202643,Staff,0,0,0,0
1683286701137,EDS 25,B06,202644,Staff,0,0,0,0
1683286702168,EDS 38,A01,202659,Black; Alison Michelle,24,0,25,1
1683286703194,EDS 115,A00,202652,Staff,17,0,30,13
1683286704219,EDS 125,A00,202649,Staff,14,0,30,16
1683286705248,EDS 126,A01,203332,Staff,30,0,30,0
1683286706277,EDS 139,A00,202838,Staff,17,0,25,8
1683286707306,EDS 146,A01,202655,Staff,15,0,25,10
1683286708332,ENG 15,A00,185667,Staff,0,1,0,0
1683286708332,ENG 15,B00,185672,Staff,0,0,0,0
1683286708332,ENG 15,C00,185675,Staff,0,0,0,0
1683286708332,ENG 15,D00,185682,Staff,0,0,0,0
1683286708332,ENG 15,E00,185684,Staff,0,0,0,0
1683286709361,ETHN 103,A00,185710,Staff,0,3,35,35
1683286710387,ETHN 103A,A00,199228,Man; Simeon S,3,0,9,6
1683286711413,ETHN 109,A00,185711,Staff,18,0,35,17
1683286712441,ETHN 142,A00,185726,Staff,0,4,30,30
1683286713469,ETHN 163J,A00,199229,Man; Simeon S,6,0,8,2
1683286714494,ETHN 168,A00,185727,Staff,8,0,10,2
1683286715520,ETHN 182,A00,185728,Staff,1,0,35,34
1683286716547,ETHN 183,A00,185737,Staff,8,0,18,10
1683286717574,GLBH 111,A01,209361,Burgos; Jose L.,0,0,0,0
1683286719631,HIEU 104,A00,185792,Staff,16,0,20,4
1683286720659,HIEU 115,A00,185800,Staff,1,0,20,19
1683286721686,HIEU 128,A00,185801,Staff,0,7,20,20
1683286722713,HIEU 147,A00,185802,Staff,16,0,20,4
1683286723737,HIEU 154,A00,185823,Staff,12,0,20,8
1683286724767,HILA 102,A00,185826,Staff,13,0,20,7
1683286725797,HILD 2C,A01,185778,Staff,0,12,20,20
1683286726830,HILD 7B,A01,185780,Kwak; Nancy,0,15,32,32
1683286726830,HILD 7B,A02,185781,Kwak; Nancy,0,18,32,32
1683286727858,HILD 30,A01,185791,Staff,14,0,20,6
1683286728884,HISC 119,A00,185830,Golan; Tal,0,9,20,20
1683286729911,HITO 156GS,A00,185831,Patterson; Patrick H.,0,0,0,23
1683286730937,HIUS 103,A00,185832,Man; Simeon S,0,7,20,20
1683286731964,HIUS 117,A00,185836,Kwak; Nancy,2,0,20,18
1683286732995,HIUS 125,A00,185840,Man; Simeon S,0,0,23,23
1683286734025,HIUS 149,A00,185845,Staff,0,0,20,20
1683286735059,HUM 3,A01,185882,Zavodny; Tatiana Sophia,0,6,50,50
1683286735059,HUM 3,B01,185899,Caldwell; Michael Alan,0,19,50,50
1683286736089,HUM 3GS,A00,185900,Patterson; Patrick H.,0,0,0,23
1683286737125,HUM 4,A01,185938,Zroka; Amy Liane,31,0,50,19
1683286737125,HUM 4,B01,185956,Watkins; Eric,0,2,50,50
1683286737125,HUM 4,B02,202209,Watkins; Eric,0,1,50,50
1683286737125,HUM 4,B03,202210,Watkins; Eric,0,0,50,50
1683286738152,HUM 5,A01,185958,West; Geoffrey Scott,5,0,50,45
1683286738152,HUM 5,A02,202215,West; Geoffrey Scott,0,0,50,50
1683286739180,INTL 190,A00,185959,Gagnon; Jeffrey C,0,0,0,9
1683286739180,INTL 190,B00,185960,Lettieri; Michael Joseph,0,0,0,1
1683286740211,JAPN 180,A00,254509,Staff,0,1,25,25
1683286741274,LATI 10,A01,202853,Kennemore; Amy Michelle,5,0,35,30
1683286741274,LATI 10,A02,202854,Kennemore; Amy Michelle,1,0,35,34
1683286741274,LATI 10,A03,270054,Kennemore; Amy Michelle,30,0,30,0
1683286742305,LATI 180,A00,202855,Kennemore; Amy Michelle,11,0,20,9
1683286743334,LAWS 101,A00,201767,Golan; Tal,0,7,40,40
1683286744361,LIFR 1C,A00,185961,Staff,6,0,20,14
1683286745388,LIFR 1CX,A00,185962,Staff,7,0,20,13
1683286746414,LIFR 1D,A00,185963,Staff,9,0,20,11
1683286747439,LIFR 1DX,A00,185964,Staff,9,0,20,11
1683286748469,LIGN 101,A01,186039,Staff,43,0,50,7
1683286749500,LIGN 165,A00,186040,Staff,18,0,50,32
1683286750530,LTCS 108,A00,186041,Staff,6,0,10,4
1683286751557,LTCS 119,A00,186042,Staff,16,0,20,4
1683286752588,LTCS 130,A00,186043,Wesling; Megan E.,15,0,25,10
1683286754649,LTEA 138,A00,186119,Staff,14,0,40,26
1683286755677,LTEN 124,A00,186148,Staff,6,0,25,19
1683286756703,LTEN 178,A00,186149,Staff,7,0,15,8
1683286757730,LTEN 181,A00,186150,Blanco; John D,33,0,40,7
1683286758756,LTWL 120,A00,186160,Staff,20,0,25,5
1683286759783,LTWL 165,A00,186161,Staff,22,0,25,3
1683286760810,LTWR 100,A00,186162,Staff,0,4,15,15
1683286761836,LTWR 102,A00,186163,Doller; Ben,5,0,15,10
1683286762869,MAE 8,A01,186412,Staff,0,0,0,0
1683286763901,MAE 30B,A00,186445,Bahadori; Mohammad Yousef,83,0,100,17
1683286764933,MAE 40,A00,186592,Bewley; Thomas R,9,0,50,41
1683286765962,MAE 101B,A00,186593,Bahadori; Mohammad Yousef,81,0,100,19
1683286766991,MAE 105,A00,186594,Bandaru; Prabhakar,12,0,50,38
1683286768018,MAE 107,A00,186599,Pham; Hieu Tan,0,6,120,120
1683286769044,MAE 148,A01,186660,Silberman; Jack,3,0,16,13
1683286770079,MATH 10A,A01,188095,Staff,0,7,35,35
1683286771113,MATH 10B,A01,188097,Bowers; Adam R.,0,11,30,30
1683286771113,MATH 10B,A02,188099,Bowers; Adam R.,0,9,30,30
1683286771113,MATH 10B,B01,188104,Bowers; Adam R.,0,11,30,30
1683286771113,MATH 10B,B02,188106,Bowers; Adam R.,0,11,30,30
1683286772140,MATH 10C,A01,188111,Staff,0,18,30,30
1683286772140,MATH 10C,A02,188127,Staff,0,17,30,30
1683286772140,MATH 10C,A03,188131,Staff,0,17,30,30
1683286772140,MATH 10C,B01,188218,Staff,21,0,30,9
1683286772140,MATH 10C,B02,188244,Staff,13,0,30,17
1683286772140,MATH 10C,B03,188277,Staff,16,0,30,14
1683286773167,MATH 18,A01,188344,Bach; Quang Tran,18,0,30,12
1683286773167,MATH 18,A02,188345,Bach; Quang Tran,11,0,30,19
1683286773167,MATH 18,B01,188353,Bach; Quang Tran,10,0,30,20
1683286773167,MATH 18,B02,188354,Bach; Quang Tran,20,0,30,10
1683286774193,MATH 20A,A01,188374,Staff,13,0,35,22
1683286775221,MATH 20B,A01,188382,Ohm; Ko Woon,6,0,30,24
1683286775221,MATH 20B,A02,188383,Ohm; Ko Woon,24,0,30,6
1683286775221,MATH 20B,B01,188385,Ohm; Ko Woon,7,0,30,23
1683286775221,MATH 20B,B02,188392,Ohm; Ko Woon,22,0,30,8
1683286776249,MATH 20C,A01,188394,Harel; Guershon,10,0,30,20
1683286776249,MATH 20C,A02,188395,Harel; Guershon,13,0,30,17
1683286776249,MATH 20C,B01,188404,Harel; Guershon,3,0,30,27
1683286776249,MATH 20C,B02,188405,Harel; Guershon,19,0,30,11
1683286777277,MATH 20D,A01,188414,Hammock; Frances H,0,1,30,30
1683286777277,MATH 20D,A02,188415,Hammock; Frances H,4,0,30,26
1683286777277,MATH 20D,B01,188447,Hammock; Frances H,2,0,30,28
1683286777277,MATH 20D,B02,188486,Hammock; Frances H,8,0,30,22
1683286778303,MATH 20E,A01,188649,Staff,22,0,30,8
1683286778303,MATH 20E,A02,188650,Staff,23,0,30,7
1683286778303,MATH 20E,A03,188673,Staff,0,0,30,30
1683286779331,MATH 102,A01,188675,Staff,0,35,35,35
1683286780362,MATH 103B,A01,188681,Staff,4,0,35,31
1683286780362,MATH 103B,B01,188692,Staff,8,0,35,27
1683286781389,MATH 109,A01,188695,Salehi Golsefidy; Alireza,25,0,35,10
1683286781389,MATH 109,A02,188696,Salehi Golsefidy; Alireza,27,0,35,8
1683286782416,MATH 120A,A01,188698,Eggers; John Dietrich,5,0,35,30
1683286783443,MATH 142B,A01,188736,Ioana; Adrian,0,2,30,30
1683286783443,MATH 142B,A02,188741,Ioana; Adrian,0,1,30,30
1683286783443,MATH 142B,A03,188743,Ioana; Adrian,0,3,30,30
1683286784477,MATH 168A,A01,188790,Staff,0,8,35,35
1683286785558,MATH 170A,A01,188803,Nie; Jiawang,0,2,35,35
1683286785558,MATH 170A,A02,188811,Nie; Jiawang,0,0,35,35
1683286785558,MATH 170A,A03,188814,Nie; Jiawang,1,0,35,34
1683286785558,MATH 170A,A04,188815,Nie; Jiawang,14,0,35,21
1683286786588,MATH 193B,A01,188817,Staff,0,0,35,35
1683286786588,MATH 193B,A02,188818,Staff,5,0,35,30
1683286787615,MGT 4,A01,202857,Anderson; John Charles,62,0,80,18
1683286788642,MGT 12,A00,202858,Lindenberger; Wade Douglas,43,0,90,47
1683286789672,MGT 18,A00,202859,Staff,74,0,90,16
1683286790702,MGT 18GS,A00,202860,McKay; Michael J,13,0,28,15
1683286791735,MGT 45,A00,202861,Pecore; Joseph P.,14,0,90,76
1683286792763,MGT 100,A00,202863,Yavorsky; Daniel Ryan,28,0,90,62
1683286793790,MGT 103,A00,202864,Ehrich; Kristine R,0,16,90,90
1683286794820,MGT 112,A00,202865,Ehrich; Kristine R,15,0,90,75
1683286795847,MGT 121A,A00,202868,Staff,0,19,0,0
1683286796873,MGT 131B,A00,202869,Anderson; John Charles,60,0,90,30
1683286797903,MGT 136,A00,202871,Lindenberger; Wade Douglas,84,0,90,6
1683286798931,MGT 164,A00,202873,Staff,0,69,90,90
1683286799957,MGT 164GS,A00,202874,McKay; Mary A,13,0,28,15
1683286800982,MGT 180,A00,202875,Staff,0,51,90,90
1683286802012,MMW 11R,A01,205019,Herbst; Matthew,3,0,30,27
1683286802012,MMW 11R,A02,205026,Herbst; Matthew,29,0,30,1
1683286803047,MMW 15,A01,193512,Chang; Edmond Yi-Teh,0,9,28,28
1683286803047,MMW 15,A02,193513,Chang; Edmond Yi-Teh,0,5,28,28
1683286803047,MMW 15,A03,193514,Chang; Edmond Yi-Teh,0,5,28,28
1683286803047,MMW 15,A04,193515,Chang; Edmond Yi-Teh,0,4,28,28
1683286803047,MMW 15,A05,193516,Chang; Edmond Yi-Teh,0,4,28,28
1683286803047,MMW 15,A06,193517,Chang; Edmond Yi-Teh,0,5,28,28
1683286803047,MMW 15,B01,193519,Chang; Edmond Yi-Teh,0,4,28,28
1683286803047,MMW 15,B02,193520,Chang; Edmond Yi-Teh,0,5,28,28
1683286803047,MMW 15,B03,193521,Chang; Edmond Yi-Teh,0,4,28,28
1683286803047,MMW 15,B04,193522,Chang; Edmond Yi-Teh,0,4,28,28
1683286803047,MMW 15,B05,193523,Chang; Edmond Yi-Teh,0,5,28,28
1683286803047,MMW 15,B06,193524,Chang; Edmond Yi-Teh,0,4,28,28
1683286804080,MMW 122,A01,193526,Rahimi; Babak,0,14,28,28
1683286804080,MMW 122,A02,193527,Rahimi; Babak,0,14,28,28
1683286804080,MMW 122,A03,193528,Rahimi; Babak,0,0,0,0
1683286804080,MMW 122,A04,193529,Rahimi; Babak,0,0,0,0
1683286805110,MUS 1A,A01,186663,Staff,0,20,35,35
1683286806141,MUS 4,A01,186715,Staff,0,12,35,35
1683286807168,MUS 5R,A01,186796,Dubnov; Shlomo,0,16,35,35
1683286808195,MUS 6,A01,186798,Staff,0,3,25,25
1683286809223,MUS 7,A01,186830,Staff,12,0,35,23
1683286810251,MUS 8,A01,186930,Staff,0,25,35,35
1683286811279,MUS 15,A01,186932,Staff,0,15,35,35
1683286811279,MUS 15,B01,186934,Staff,0,14,35,35
1683286812309,MUS 80,A00,186935,Staff,2,0,20,18
1683286812309,MUS 80,B00,186936,Staff,25,0,25,0
1683286813341,NANO 11,A00,204702,Lipomi; Darren John,0,0,0,0
1683286814369,NANO 15,A01,204709,Yang; Kesong,0,1,0,0
1683286815398,NANO 114,A00,202069,Jahed Motlagh; Zeinab,3,0,10,7
1683286816430,PHIL 1,A00,186955,Grush; Rick Scott,32,0,40,8
1683286817458,PHIL 10,A01,186973,Grush; Rick Scott,29,0,35,6
1683286817458,PHIL 10,A02,186974,Grush; Rick Scott,33,0,35,2
1683286818485,PHIL 13,A01,186976,Staff,7,0,35,28
1683286818485,PHIL 13,A02,186977,Staff,16,0,35,19
1683286819511,PHIL 14,A01,186979,Staff,31,0,35,4
1683286819511,PHIL 14,A02,186986,Staff,32,0,35,3
1683286820541,PHIL 28,A01,186988,Staff,16,0,30,14
1683286820541,PHIL 28,A02,186989,Staff,1,0,30,29
1683286820541,PHIL 28,A03,186990,Staff,9,0,30,21
1683286820541,PHIL 28,A04,186991,Staff,26,0,30,4
1683286821570,PHIL 120,A00,186997,Staff,23,0,40,17
1683286822596,PHIL 137,A00,187003,Staff,9,0,40,31
1683286823626,PHIL 150,A00,187015,Staff,47,0,70,23
1683286824651,PHIL 167,A00,187021,Lamey; Andy M.,35,0,40,5
1683286825678,PHIL 174,A01,202226,Staff,17,0,20,3
1683286825678,PHIL 174,A02,202235,Staff,20,0,20,0
1683286826703,PHIL 191A,A00,258918,Staff,0,0,1,1
1683286827730,PHYS 1A,A00,187028,Staff,26,0,60,34
1683286828757,PHYS 1AL,001,187036,Staff,2,0,30,28
1683286828757,PHYS 1AL,002,187049,Staff,18,0,30,12
1683286829783,PHYS 1B,A00,187058,Staff,23,0,60,37
1683286830811,PHYS 1BL,001,187064,Staff,0,0,30,30
1683286830811,PHYS 1BL,002,187070,Staff,6,0,30,24
1683286831843,PHYS 1C,A00,187082,Staff,32,0,120,88
1683286832872,PHYS 1CL,001,187088,Staff,0,9,30,30
1683286832872,PHYS 1CL,002,187089,Staff,0,2,30,30
1683286832872,PHYS 1CL,009,262693,Staff,12,0,30,18
1683286833898,PHYS 2B,A01,187097,Staff,54,0,115,61
1683286834925,PHYS 2C,A01,187099,Staff,67,0,115,48
1683286835953,PHYS 2CL,A01,187101,Staff,5,0,28,23
1683286835953,PHYS 2CL,A02,187102,Staff,15,0,28,13
1683286836985,PHYS 2D,A01,187123,Shotwell; Brian,95,0,115,20
1683286838015,PHYS 4B,A01,187133,Grinstein; Benjamin,35,0,50,15
1683286839045,POLI 10,A00,188819,Staff,0,3,50,50
1683286840075,POLI 11,A00,188827,Staff,43,0,50,7
1683286841102,POLI 13R,A00,188828,Staff,0,1,20,20
1683286842129,POLI 27,A01,188830,Elgin; Samuel Zincke,0,1,70,70
1683286843157,POLI 30,A00,188832,Desposato; Scott,33,0,50,17
1683286844187,POLI 102F,A00,188834,Staff,3,0,40,37
1683286845214,POLI 104A,A00,188852,Staff,14,0,30,16
1683286846244,POLI 104I,A00,188853,Staff,0,6,20,20
1683286847270,POLI 110B,A00,188854,Wiens; David,7,0,20,13
1683286848301,POLI 112A,A00,188855,Wiens; David,5,0,30,25
1683286849329,POLI 117R,A00,188856,Forman; Fonna,0,11,20,20
1683286850359,POLI 118,A00,188857,Ingham; Sean,8,0,20,12
1683286851386,POLI 120G,A00,188858,Staff,9,0,30,21
1683286852411,POLI 131CR,A00,188863,Hoston; Germaine,24,0,50,26
1683286853437,POLI 133,A00,188864,Nellis; Gareth Hb,44,0,50,6
1683286854462,POLI 134D,A00,188865,Desposato; Scott,27,0,30,3
1683286855493,POLI 142A,A00,188871,Gartzke; Erik,22,0,50,28
1683286856523,POLI 142K,A00,188874,Staff,38,0,50,12
1683286857547,POLI 143,A00,188940,Gartzke; Erik,16,0,30,14
1683286858577,POLI 153,A00,188943,Staff,3,0,20,17
1683286859607,POLI 160AA,A00,188944,Staff,13,0,40,27
1683286860637,POLI 170A,A00,188945,Staff,11,0,30,19
1683286862694,PSYC 1,A00,188952,Staff,38,0,90,52
1683286863721,PSYC 2,B00,188953,Staff,20,0,35,15
1683286864747,PSYC 6,A00,188970,Staff,47,0,60,13
1683286865774,PSYC 7,A00,188973,Staff,37,0,45,8
1683286866806,PSYC 60,A01,188980,Rickard; Timothy C.,43,0,60,17
1683286867842,PSYC 70,A01,189001,Steiner; Eric Tomas,24,0,45,21
1683286868875,PSYC 100,A00,189005,Lacefield; Katharine I,0,99,120,120
1683286869899,PSYC 102,A00,189008,Staff,10,0,30,20
1683286870929,PSYC 106,B00,189026,Gorman; Michael R.,37,0,60,23
1683286871960,PSYC 114,B01,189033,Winkielman; Piotr,0,32,30,30
1683286872989,PSYC 131,A00,189036,Anagnostaras; Stephan,0,43,60,60
1683286874015,PSYC 136,A00,189041,Lowe; Angela Beth,0,7,25,25
1683286875040,PSYC 137,A00,189057,Winkielman; Piotr,0,34,25,25
1683286876067,PSYC 144,A00,189107,Wixted; John T,0,7,50,50
1683286878119,PSYC 162,A00,189142,Staff,0,8,85,85
1683286879149,PSYC 172,A00,189144,Gorman; Michael R.,0,7,30,30
1683286881209,PSYC 179,A00,189146,Lacefield; Katharine I,0,84,120,120
1683286882236,PSYC 181,A00,189147,Anagnostaras; Stephan,0,44,90,90
1683286883267,PSYC 190R,A00,189148,Barner; David A.,0,22,80,80
1683286884301,PSYC 191,A00,189275,Rickard; Timothy C.,0,7,25,25
1683286885329,PSYC 193,A00,189276,Chapman; Eddie Nathaniel,0,1,0,4
1683286886360,PSYC 193L,A01,189281,Lowe; Angela Beth,12,0,20,8
1683286886360,PSYC 193L,B01,189285,Staff,28,0,35,7
1683286887389,RELI 149,A00,187137,Rahimi; Babak,7,0,40,33
1683286888414,SE 9,A01,187315,Staff,0,2,18,18
1683286889497,SE 101B,A00,187409,Staff,24,0,30,6
1683286890523,SE 110B,A00,187444,Staff,10,0,40,30
1683286891551,SE 130B,A00,187449,Staff,31,0,40,9
1683286892581,SE 150A,A00,187516,Staff,9,0,20,11
1683286893611,SE 154,A00,187528,Staff,30,0,50,20
1683286894642,SIO 3,A01,258171,Staff,35,0,40,5
1683286895671,SIO 10,A00,187144,Cook; Geoffrey W,0,3,75,75
1683286896697,SIO 45,A00,187152,Cook; Geoffrey W,1,0,100,99
1683286897725,SIO 109R,A00,194486,Staff,0,3,20,20
1683286899775,SIO 187,A01,187233,Kacev; David,12,0,40,28
1683286900803,SOCI 1,A01,258656,Thorpe; Charles Robert,28,0,30,2
1683286900803,SOCI 1,A02,258658,Thorpe; Charles Robert,30,0,30,0
1683286900803,SOCI 1,A03,258661,Thorpe; Charles Robert,25,0,25,0
1683286900803,SOCI 1,A04,258666,Thorpe; Charles Robert,22,0,25,3
1683286900803,SOCI 1,A05,258897,Thorpe; Charles Robert,23,0,25,2
1683286900803,SOCI 1,A06,258898,Thorpe; Charles Robert,25,0,25,0
1683286901831,SOCI 30,A01,258903,Pardo Guerra; Juan Pablo,16,0,30,14
1683286902859,SOCI 102,A00,258904,Staff,9,0,25,16
1683286903888,SOCI 106,A00,258905,Staff,19,0,25,6
1683286904918,SOCI 111,A00,258907,Ribas Norris; Janet Vanesa,26,0,30,4
1683286905944,SOCI 121R,A00,258908,Pardo Guerra; Juan Pablo,11,0,30,19
1683286906975,SOCI 126,A01,203330,Staff,14,0,20,6
1683286908006,SOCI 131,A00,258909,Thorpe; Charles Robert,31,0,60,29
1683286909035,SOCI 135,A00,258910,Payne; Christine Anna,0,9,30,30
1683286910062,SOCI 157,A00,258911,Staff,13,0,30,17
1683286911089,SOCI 184,A00,258912,Staff,26,0,30,4
1683286912115,SOCI 188D,A00,258913,Staff,21,0,30,9
1683286913143,SYN 2,001,187529,Staff,9,0,16,7
1683286913143,SYN 2,002,201452,Staff,0,18,16,16
1683286913143,SYN 2,003,201469,Staff,3,0,16,13
1683286914171,SYN 100,A01,187531,Staff,0,9,20,20
1683286914171,SYN 100,B01,201491,Staff,0,12,20,20
1683286915200,TDAC 1,A00,189286,Walsh; Kim C.,3,0,20,17
1683286915200,TDAC 1,B00,189287,Harting; Carla Kelso,11,0,20,9
1683286916230,TDAC 101,A00,189300,Walsh; Kim C.,16,0,20,4
1683286916230,TDAC 101,B00,189301,Harting; Carla Kelso,18,0,20,2
1683286917257,TDAC 102,A00,189304,Basso; Beatrice,14,0,20,6
1683286918284,TDAC 108,A00,189305,Staff,18,0,20,2
1683286919319,TDDE 131,A00,189310,Staff,19,0,20,1
1683286919319,TDDE 131,B00,189314,Staff,19,0,20,1
1683286919319,TDDE 131,C00,189315,Staff,48,0,50,2
1683286919319,TDDE 131,D00,189316,Staff,14,0,15,1
1683286919319,TDDE 131,E00,204841,Staff,20,0,20,0
1683286920349,TDGE 10,A00,189289,Staff,30,0,50,20
1683286920349,TDGE 10,B00,189290,Havis; Allan,2,0,50,48
1683286921382,TDGE 11,A00,189291,Fulton; Julia,0,3,50,50
1683286921382,TDGE 11,B00,189292,Staff,20,0,25,5
1683286921382,TDGE 11,C00,260270,Staff,0,0,0,0
1683286922409,TDGE 25,A00,189294,Staff,3,0,20,17
1683286923434,TDGE 124,A00,189318,Fulton; Julia,0,8,50,50
1683286924459,TDGE 125,A00,189319,Staff,13,0,25,12
1683286924459,TDGE 125,B00,189320,Staff,23,0,25,2
1683286925485,TDGE 127,A00,189322,Havis; Allan,0,0,50,50
1683286926513,TDHT 101,A00,189323,Staff,18,0,25,7
1683286926513,TDHT 101,B00,189324,Staff,25,0,25,0
1683286927539,TDHT 102,A00,189325,Staff,49,0,50,1
1683286928572,TDMV 1,A00,189295,Arcidiacono; Kristin,20,0,30,10
1683286928572,TDMV 1,B00,189296,Caligagan; Maria T.,24,0,30,6
1683286929603,TDMV 2,A00,189297,Sammartano; Tonnie,28,0,30,2
1683286929603,TDMV 2,B00,189299,Arcidiacono; Kristin,24,0,30,6
1683286930635,TDMV 3,A00,204998,Rincon; Alicia,22,0,30,8
1683286931661,TDMV 120,A00,189458,Sammartano; Tonnie,28,0,30,2
1683286932689,TDMV 138,A00,189541,Jun; Grace Shin Hae,22,0,40,18
1683286933716,TDMV 142,A00,189717,Caligagan; Tony,23,0,30,7
1683286933716,TDMV 142,B00,189718,Caligagan; Maria T.,25,0,30,5
1683286934743,TMC 2,A01,187533,Staff,25,0,25,0
1683286934743,TMC 2,A02,187534,Staff,25,0,25,0
1683286935774,USP 1,A01,187536,Kwak; Nancy,0,16,25,25
1683286936805,USP 5,A01,187538,Staff,9,0,25,16
1683286937835,USP 101,A00,199253,Staff,0,4,0,0
1683286938867,USP 124,A00,187562,Boomhower; Matthew Charles,1,0,30,29
1683286939896,USP 138,A00,187582,Staff,20,0,25,5
1683286940922,USP 152,A01,187597,Staff,4,0,25,21
1683286941946,USP 153,A00,187598,Staff,19,0,25,6
1683286942974,USP 168,A00,187607,Kwak; Nancy,2,0,5,3
1683286944000,USP 173,A00,187619,Staff,4,0,25,21
1683286945026,USP 181,A00,187638,Staff,0,0,25,25
1683286946053,VIS 103,A00,187650,Cruz; Edwin Teddy,23,0,75,52
1683286947082,VIS 110D,A00,187669,Staff,12,0,22,10
1683286948106,VIS 127C,A00,187720,Shen; Kuiyi,68,0,146,78
1683286949133,VIS 149,A00,187731,Yoldas; Pinar,0,14,22,22
1683286950159,VIS 151,A01,188091,Staff,22,0,34,12
1683286950159,VIS 151,A02,188092,Staff,11,0,34,23
1683286951189,VIS 160B,A00,188093,Stalbaum; Brett,0,0,10,10
1683286953241,WCWP 10B,A00,201720,Staff,10,0,15,5
1683286953241,WCWP 10B,B00,201722,Staff,8,0,15,7
1683286954268,WCWP 100,A00,201725,Gagnon; Jeffrey C,0,0,2,2
1683286954268,WCWP 100,B00,201727,Staff,0,4,15,15
1683286957378,ANBI 133,A00,258401,Wilder; Linnea Lorene,34,0,40,6
1683286958405,ANBI 140,A00,258395,Hrvoj Mihic; Branka,18,0,25,7
1683286959432,ANSC 120,A00,258402,Bialecki; Jon Anthony,27,0,40,13
1683286960461,ANSC 144,A00,258400,Staff,14,0,40,26
1683286962521,ANSC 166,A00,258396,Parish; Steven Martin,157,0,175,18
1683286963550,ANSC 180,A00,193533,Staff,9,0,20,11
1683286964579,ANSC 188,A00,258397,Jassal; Aftab,33,0,40,7
1683286965602,ANTH 3,A01,258316,Staff,23,0,30,7
1683286966628,ANTH 5,A00,258394,Semendeferi; Ekaterini,16,0,20,4
1683286967656,ANTH 21,A01,258331,Staff,9,0,40,31
1683286968683,ANTH 103,A00,258398,Varma; Saiba,15,0,25,10
1683286969715,AWP 10,001,202034,Staff,0,0,0,0
1683286969715,AWP 10,002,202035,Staff,0,0,0,0
1683286969715,AWP 10,003,202036,Staff,0,0,0,0
1683286969715,AWP 10,004,202037,Staff,0,0,0,0
1683286969715,AWP 10,005,202038,Staff,0,0,0,0
1683286969715,AWP 10,006,202039,Staff,0,0,0,0
1683286969715,AWP 10,007,202040,Staff,0,0,0,0
1683286969715,AWP 10,008,202041,Staff,0,0,0,0
1683286969715,AWP 10,009,202042,Staff,0,0,0,0
1683286969715,AWP 10,010,202043,Staff,0,0,0,0
1683286969715,AWP 10,011,202044,Staff,0,0,0,0
1683286969715,AWP 10,012,202045,Staff,0,0,0,0
1683286969715,AWP 10,013,202046,Staff,0,0,0,0
1683286969715,AWP 10,014,202047,Staff,0,0,0,0
1683286969715,AWP 10,015,202048,Staff,0,0,0,0
1683286969715,AWP 10,016,202049,Staff,0,0,0,0
1683286969715,AWP 10,017,202050,Staff,0,0,0,0
1683286969715,AWP 10,018,202051,Staff,0,0,0,0
1683286969715,AWP 10,019,202052,Staff,0,0,0,0
1683286969715,AWP 10,020,202053,Staff,0,0,0,0
1683286969715,AWP 10,021,202054,Staff,0,0,0,0
1683286969715,AWP 10,022,202055,Staff,0,0,0,0
1683286969715,AWP 10,023,202056,Staff,0,0,0,0
1683286969715,AWP 10,024,202057,Staff,0,0,0,0
1683286969715,AWP 10,025,202058,Staff,0,0,0,0
1683286969715,AWP 10,026,202059,Staff,0,0,0,0
1683286970741,AWP 102,001,202032,Staff,0,0,0,0
1683286970741,AWP 102,002,202033,Staff,0,0,0,0
1683286971772,BENG 100,A01,254234,Taylor Amos; Alyssa C,31,0,40,9
1683286972802,BENG 196,001,270013,Engler; Adam J.,9999,0,9999,0
1683286973836,BICD 100R,A01,202018,Smith; Laurie,0,7,32,32
1683286973836,BICD 100R,A02,202019,Smith; Laurie,0,2,32,32
1683286973836,BICD 100R,A03,202020,Smith; Laurie,0,1,32,32
1683286973836,BICD 100R,A04,202021,Smith; Laurie,8,0,32,24
1683286973836,BICD 100R,A05,202022,Smith; Laurie,12,0,32,20
1683286974870,BICD 136,A01,193242,Gustafson-Brown; Cindy,0,2,32,32
1683286974870,BICD 136,A02,193244,Gustafson-Brown; Cindy,15,0,32,17
1683286975899,BIEB 102,A01,193249,Butler; Shannon Rhey,0,2,32,32
1683286975899,BIEB 102,A02,193251,Butler; Shannon Rhey,0,0,32,32
1683286975899,BIEB 102,A03,193253,Butler; Shannon Rhey,0,1,32,32
1683286975899,BIEB 102,A04,193255,Butler; Shannon Rhey,17,0,32,15
1683286975899,BIEB 102,A05,193265,Butler; Shannon Rhey,26,0,32,6
1683286975899,BIEB 102,A06,193269,Butler; Shannon Rhey,16,0,32,16
1683286977956,BIEB 150,A01,193274,Staff,0,0,32,32
1683286977956,BIEB 150,A02,193285,Staff,24,0,32,8
1683286978983,BIEB 194,A00,193286,Kurle; Carolyn M.,22,0,32,10
1683286980017,BILD 1,A01,192291,Staff,16,0,32,16
1683286980017,BILD 1,A02,192292,Staff,30,0,32,2
1683286980017,BILD 1,B01,192520,Reuther; Keefe,0,1,0,0
1683286980017,BILD 1,B02,192532,Reuther; Keefe,0,1,0,0
1683286981046,BILD 3,A01,192556,Butler; Shannon Rhey,0,0,32,32
1683286981046,BILD 3,A02,192581,Butler; Shannon Rhey,5,0,32,27
1683286981046,BILD 3,A03,192611,Butler; Shannon Rhey,23,0,32,9
1683286981046,BILD 3,A04,192612,Butler; Shannon Rhey,25,0,32,7
1683286981046,BILD 3,A05,192613,Butler; Shannon Rhey,27,0,32,5
1683286981046,BILD 3,A06,192679,Butler; Shannon Rhey,27,0,32,5
1683286981046,BILD 3,A07,192682,Butler; Shannon Rhey,22,0,32,10
1683286982075,BILD 4,A01,192836,Reuther; Keefe,1,0,24,23
1683286982075,BILD 4,A02,193044,Reuther; Keefe,4,0,24,20
1683286983102,BILD 10,A01,193142,Gustafson-Brown; Cindy,31,0,32,1
1683286983102,BILD 10,A02,193149,Gustafson-Brown; Cindy,31,0,32,1
1683286984126,BIMM 100,A01,193301,Staff,0,6,32,32
1683286984126,BIMM 100,A02,193312,Staff,0,5,32,32
1683286984126,BIMM 100,A03,193323,Staff,0,8,32,32
1683286985155,BIMM 101,A01,193329,McDonnell; Lisa Marie,0,3,24,24
1683286985155,BIMM 101,A02,193339,McDonnell; Lisa Marie,0,2,24,24
1683286985155,BIMM 101,B01,193354,McDonnell; Lisa Marie,0,3,24,24
1683286985155,BIMM 101,B02,193357,McDonnell; Lisa Marie,0,3,24,24
1683286986180,BIMM 110,A01,193377,Tat; John,0,11,32,32
1683286986180,BIMM 110,A02,193378,Tat; John,1,9,32,31
1683286987211,BIMM 120,A01,206116,Staff,0,0,32,32
1683286987211,BIMM 120,A02,206117,Staff,8,0,32,24
1683286987211,BIMM 120,A03,206121,Staff,21,0,32,11
1683286988239,BIPN 100,A01,193393,Park; Ji Young,0,14,32,32
1683286988239,BIPN 100,A02,193402,Park; Ji Young,0,12,32,32
1683286988239,BIPN 100,A03,193413,Park; Ji Young,0,14,32,32
1683286988239,BIPN 100,A04,193414,Park; Ji Young,0,13,32,32
1683286989270,BIPN 102,A01,193429,Staff,0,0,32,32
1683286989270,BIPN 102,A02,193438,Staff,23,0,32,9
1683286990297,BIPN 106,A01,193450,Reyes Gonzalez; Catalina,0,2,40,40
1683286991325,BIPN 134,A01,193465,Cooke; James Edward,0,0,32,32
1683286991325,BIPN 134,A02,193474,Cooke; James Edward,27,0,32,5
1683286991325,BIPN 134,A03,193485,Cooke; James Edward,29,0,32,3
1683286991325,BIPN 134,A04,193486,Cooke; James Edward,21,0,32,11
1683286991325,BIPN 134,A05,193491,Cooke; James Edward,31,0,32,1
1683286991325,BIPN 134,A06,193501,Cooke; James Edward,30,0,32,2
1683286991325,BIPN 134,A07,193510,Cooke; James Edward,29,0,32,3
1683286993451,BISP 194,A00,222522,Staff,16,0,32,16
1683286994482,CAT 124,A01,202407,Staff,20,0,25,5
1683286995511,CAT 125,A00,202408,Marchisotto; Jennifer Anne,4,0,20,16
1683286996548,CAT 125R,A00,202409,Smith; Lauryn Alissa,0,11,20,20
1683286996548,CAT 125R,B00,202410,Morales; Celeste Georgianna,0,11,20,20
1683286996548,CAT 125R,C00,202411,Irwin; Matthew Joseph,0,10,20,20
1683286997579,CENG 15,A01,204712,Yang; Kesong,0,1,0,0
1683286998609,CENG 114,A00,202070,Jahed Motlagh; Zeinab,5,0,20,15
1683286999637,CGS 105,A00,185477,Wesling; Megan E.,24,0,40,16
1683287000664,CGS 106,A00,185494,Staff,13,0,22,9
1683287001691,CGS 108,A00,185495,Staff,14,0,20,6
1683287002718,CGS 114,A00,185496,Staff,13,0,18,5
1683287003745,CGS 119,A00,185501,Staff,15,0,20,5
1683287004771,CGS 120,A00,185511,Staff,13,0,20,7
1683287005799,CHEM 4,A01,184675,Bussey; Thomas J,96,0,100,4
1683287006830,CHEM 6A,A01,184677,Staff,35,0,60,25
1683287007859,CHEM 6B,A01,184679,Staff,65,0,100,35
1683287008886,CHEM 6C,A01,184681,Bussey; Thomas J,1,0,50,49
1683287008886,CHEM 6C,A02,184682,Bussey; Thomas J,34,0,50,16
1683287009913,CHEM 40A,A01,184684,Albizati; Kim F.,37,0,100,63
1683287010945,CHEM 40B,A01,184686,Albizati; Kim F.,0,20,100,100
1683287011973,CHEM 41B,A01,184690,Staff,52,0,100,48
1683287012999,COGS 3,A01,184715,Boyle; Mary E. T.,0,25,40,40
1683287014026,COGS 14B,A01,185172,Staff,0,15,38,38
1683287015055,COGS 18,A01,184736,Staff,20,0,80,60
1683287016081,COGS 100,A01,184932,Staff,0,5,73,73
1683287017108,COGS 101A,A01,184935,Staff,0,38,30,30
1683287018135,COGS 101B,A01,184944,Staff,0,2,30,30
1683287019163,COGS 101C,A01,184946,Staff,0,12,30,30
1683287020189,COGS 102A,A01,184951,Johnson; Christine M.,2,0,40,38
1683287021217,COGS 107B,A01,184953,Mooshagian; Eric Frederick,0,50,40,40
1683287022243,COGS 118B,A01,184959,Gupta; Anjum,0,48,40,40
1683287023272,COGS 153,A00,184961,Staff,0,15,30,30
1683287024296,COGS 177,A00,184962,Staff,0,21,30,30
1683287025327,COGS 187A,A01,184969,Boyle; Mary E. T.,0,17,40,40
1683287026354,COMM 10,A01,185174,Staff,0,5,25,25
1683287026354,COMM 10,A02,185189,Staff,0,5,25,25
1683287026354,COMM 10,A03,269821,Staff,0,0,0,0
1683287027381,COMM 100B,A01,185475,Staff,0,0,0,2
1683287027381,COMM 100B,A02,185476,Staff,14,0,25,11
1683287028408,COMM 100C,A01,185314,Staff,1,0,25,24
1683287028408,COMM 100C,A02,185327,Staff,19,0,25,6
1683287029432,COMM 110M,A00,185349,Staff,2,0,40,38
1683287030457,COMM 113T,A00,185352,Staff,25,0,40,15
1683287031483,COMM 114I,A00,185353,Staff,33,0,40,7
1683287032509,COMM 131,A00,185354,Staff,19,0,30,11
1683287033536,CSE 8A,A50,185358,Cao; Yingjun,0,46,10,10
1683287034562,CSE 8B,A01,185362,Staff,0,47,50,50
1683287035593,CSE 11,A01,185416,Cao; Yingjun,0,93,10,10
1683287036625,CSE 20,A01,185445,Briones; Jor-el Thomas Caparas,5,0,25,20
1683287037653,CSE 21,A01,185447,Staff,10,0,50,40
1683287038685,CSE 101,A01,185451,Staff,0,12,50,50
1683287038685,CSE 101,B01,185453,Jones; Miles E,0,11,50,50
1683287040737,CSE 141,A01,185458,Eldon; John,20,0,100,80
1683287041765,CSE 141L,A01,185461,Eldon; John,12,0,100,88
1683287042792,CSE 142,A01,185463,Staff,35,0,60,25
1683287042792,CSE 142,B01,201355,Staff,0,6,60,60
1683287043822,CSE 142L,A01,185470,Staff,35,0,60,25
1683287043822,CSE 142L,B01,201417,Staff,0,5,60,60
1683287044851,CSE 190,A00,201433,Staff,32,0,49,17
1683287045885,DOC 1,A01,259136,Strom; Megan C.,8,0,15,7
1683287045885,DOC 1,A02,259137,Strom; Megan C.,14,0,15,1
1683287045885,DOC 1,A03,259138,Strom; Megan C.,14,0,15,1
1683287045885,DOC 1,A04,259139,Strom; Megan C.,14,0,15,1
1683287046918,DOC 100D,A00,259140,Pass; Natalye Joann,17,0,25,8
1683287047950,DSGN 1,A01,184749,Rill; Bryan,0,24,30,30
1683287048980,DSGN 100,A01,185168,Staff,0,2,25,25
1683287050008,ECE 5,A01,185626,Morris; Karcher William,0,10,0,0
1683287051033,ECE 101,A01,185628,Staff,17,0,70,53
1683287052062,ECE 107,A01,185635,Baghdadchi; Saharnaz,0,0,20,20
1683287052062,ECE 107,A02,185638,Baghdadchi; Saharnaz,4,0,20,16
1683287053087,ECE 148,A01,185647,Silberman; Jack,1,0,16,15
1683287054113,ECON 1,A01,185537,Crane; Meredith Helen,54,0,70,16
1683287055140,ECON 3,A01,185549,Crane; Meredith Helen,33,0,70,37
1683287056169,ECON 4,A01,203354,Anderson; John Charles,0,4,10,10
1683287057200,ECON 100A,A01,185574,Staff,0,4,40,40
1683287058229,ECON 100B,A01,185576,Staff,0,22,40,40
1683287059255,ECON 100C,A01,185589,Newhouse; Herbert S,30,0,70,40
1683287060285,ECON 105,A00,185608,Vespa; Emanuel Ignacio,19,0,35,16
1683287061312,ECON 109,A01,185610,Shishkin; Denis,10,0,35,25
1683287062337,ECON 110A,A01,185612,Staff,11,0,40,29
1683287063364,ECON 120A,A01,185615,Staff,20,0,40,20
1683287064394,ECON 120C,A01,185617,Sun; Yixiao,0,20,70,70
1683287065424,ECON 144,A00,203346,Squires; Dale E,3,0,35,32
1683287066454,ECON 171,A01,203349,Newhouse; Herbert S,0,1,35,35
1683287067486,ECON 173A,A01,185621,Toda; Alexis Akira,21,0,35,14
1683287068520,EDS 25,A01,202413,Staff,0,1,0,0
1683287068520,EDS 25,A02,202414,Staff,0,1,0,0
1683287068520,EDS 25,A03,202415,Staff,0,0,0,0
1683287068520,EDS 25,A04,202416,Staff,0,1,0,0
1683287068520,EDS 25,A05,202439,Staff,0,0,0,0
1683287068520,EDS 25,A06,202440,Staff,0,0,0,0
1683287068520,EDS 25,B01,202631,Staff,0,0,0,0
1683287068520,EDS 25,B02,202632,Staff,0,0,0,0
1683287068520,EDS 25,B03,202639,Staff,0,0,0,0
1683287068520,EDS 25,B04,202640,Staff,0,0,0,0
1683287068520,EDS 25,B05,202643,Staff,0,0,0,0
1683287068520,EDS 25,B06,202644,Staff,0,0,0,0
1683287069549,EDS 38,A01,202659,Black; Alison Michelle,24,0,25,1
1683287070583,EDS 115,A00,202652,Staff,17,0,30,13
1683287071611,EDS 125,A00,202649,Staff,14,0,30,16
1683287072642,EDS 126,A01,203332,Staff,30,0,30,0
1683287073673,EDS 139,A00,202838,Staff,17,0,25,8
1683287074701,EDS 146,A01,202655,Staff,15,0,25,10
1683287075733,ENG 15,A00,185667,Staff,0,1,0,0
1683287075733,ENG 15,B00,185672,Staff,0,0,0,0
1683287075733,ENG 15,C00,185675,Staff,0,0,0,0
1683287075733,ENG 15,D00,185682,Staff,0,0,0,0
1683287075733,ENG 15,E00,185684,Staff,0,0,0,0
1683287076763,ETHN 103,A00,185710,Staff,0,3,35,35
1683287077790,ETHN 103A,A00,199228,Man; Simeon S,3,0,9,6
1683287078817,ETHN 109,A00,185711,Staff,18,0,35,17
1683287079845,ETHN 142,A00,185726,Staff,0,4,30,30
1683287080871,ETHN 163J,A00,199229,Man; Simeon S,6,0,8,2
1683287081900,ETHN 168,A00,185727,Staff,8,0,10,2
1683287082926,ETHN 182,A00,185728,Staff,1,0,35,34
1683287083955,ETHN 183,A00,185737,Staff,8,0,18,10
1683287084982,GLBH 111,A01,209361,Burgos; Jose L.,0,0,0,0
1683287087035,HIEU 104,A00,185792,Staff,16,0,20,4
1683287088061,HIEU 115,A00,185800,Staff,1,0,20,19
1683287089087,HIEU 128,A00,185801,Staff,0,7,20,20
1683287090113,HIEU 147,A00,185802,Staff,16,0,20,4
1683287091139,HIEU 154,A00,185823,Staff,12,0,20,8
1683287092166,HILA 102,A00,185826,Staff,13,0,20,7
1683287093194,HILD 2C,A01,185778,Staff,0,12,20,20
1683287094221,HILD 7B,A01,185780,Kwak; Nancy,0,15,32,32
1683287094221,HILD 7B,A02,185781,Kwak; Nancy,0,18,32,32
1683287095249,HILD 30,A01,185791,Staff,14,0,20,6
1683287096275,HISC 119,A00,185830,Golan; Tal,0,9,20,20
1683287097361,HITO 156GS,A00,185831,Patterson; Patrick H.,0,0,0,23
1683287098388,HIUS 103,A00,185832,Man; Simeon S,0,7,20,20
1683287099416,HIUS 117,A00,185836,Kwak; Nancy,2,0,20,18
1683287100440,HIUS 125,A00,185840,Man; Simeon S,0,0,23,23
1683287101467,HIUS 149,A00,185845,Staff,0,0,20,20
1683287102494,HUM 3,A01,185882,Zavodny; Tatiana Sophia,0,6,50,50
1683287102494,HUM 3,B01,185899,Caldwell; Michael Alan,0,19,50,50
1683287103522,HUM 3GS,A00,185900,Patterson; Patrick H.,0,0,0,23
1683287104556,HUM 4,A01,185938,Zroka; Amy Liane,31,0,50,19
1683287104556,HUM 4,B01,185956,Watkins; Eric,0,2,50,50
1683287104556,HUM 4,B02,202209,Watkins; Eric,0,1,50,50
1683287104556,HUM 4,B03,202210,Watkins; Eric,0,0,50,50
1683287105582,HUM 5,A01,185958,West; Geoffrey Scott,5,0,50,45
1683287105582,HUM 5,A02,202215,West; Geoffrey Scott,0,0,50,50
1683287106615,INTL 190,A00,185959,Gagnon; Jeffrey C,0,0,0,9
1683287106615,INTL 190,B00,185960,Lettieri; Michael Joseph,0,0,0,1
1683287107643,JAPN 180,A00,254509,Staff,0,1,25,25
1683287108681,LATI 10,A01,202853,Kennemore; Amy Michelle,5,0,35,30
1683287108681,LATI 10,A02,202854,Kennemore; Amy Michelle,1,0,35,34
1683287108681,LATI 10,A03,270054,Kennemore; Amy Michelle,30,0,30,0
1683287109711,LATI 180,A00,202855,Kennemore; Amy Michelle,11,0,20,9
1683287110740,LAWS 101,A00,201767,Golan; Tal,0,7,40,40
1683287111771,LIFR 1C,A00,185961,Staff,6,0,20,14
1683287112802,LIFR 1CX,A00,185962,Staff,7,0,20,13
1683287113833,LIFR 1D,A00,185963,Staff,9,0,20,11
1683287114862,LIFR 1DX,A00,185964,Staff,9,0,20,11
1683287115891,LIGN 101,A01,186039,Staff,43,0,50,7
1683287116918,LIGN 165,A00,186040,Staff,18,0,50,32
1683287117943,LTCS 108,A00,186041,Staff,6,0,10,4
1683287118968,LTCS 119,A00,186042,Staff,16,0,20,4
1683287119995,LTCS 130,A00,186043,Wesling; Megan E.,15,0,25,10
1683287122051,LTEA 138,A00,186119,Staff,14,0,40,26
1683287123081,LTEN 124,A00,186148,Staff,6,0,25,19
1683287124107,LTEN 178,A00,186149,Staff,7,0,15,8
1683287125139,LTEN 181,A00,186150,Blanco; John D,33,0,40,7
1683287126169,LTWL 120,A00,186160,Staff,20,0,25,5
1683287127197,LTWL 165,A00,186161,Staff,22,0,25,3
1683287128221,LTWR 100,A00,186162,Staff,0,4,15,15
1683287129251,LTWR 102,A00,186163,Doller; Ben,5,0,15,10
1683287130278,MAE 8,A01,186412,Staff,0,0,0,0
1683287131305,MAE 30B,A00,186445,Bahadori; Mohammad Yousef,83,0,100,17
1683287132332,MAE 40,A00,186592,Bewley; Thomas R,9,0,50,41
1683287133357,MAE 101B,A00,186593,Bahadori; Mohammad Yousef,81,0,100,19
1683287134381,MAE 105,A00,186594,Bandaru; Prabhakar,12,0,50,38
1683287135415,MAE 107,A00,186599,Pham; Hieu Tan,0,6,120,120
1683287136445,MAE 148,A01,186660,Silberman; Jack,3,0,16,13
1683287137477,MATH 10A,A01,188095,Staff,0,7,35,35
1683287138505,MATH 10B,A01,188097,Bowers; Adam R.,0,11,30,30
1683287138505,MATH 10B,A02,188099,Bowers; Adam R.,0,9,30,30
1683287138505,MATH 10B,B01,188104,Bowers; Adam R.,0,11,30,30
1683287138505,MATH 10B,B02,188106,Bowers; Adam R.,0,11,30,30
1683287139534,MATH 10C,A01,188111,Staff,0,18,30,30
1683287139534,MATH 10C,A02,188127,Staff,0,17,30,30
1683287139534,MATH 10C,A03,188131,Staff,0,17,30,30
1683287139534,MATH 10C,B01,188218,Staff,21,0,30,9
1683287139534,MATH 10C,B02,188244,Staff,13,0,30,17
1683287139534,MATH 10C,B03,188277,Staff,16,0,30,14
1683287140562,MATH 18,A01,188344,Bach; Quang Tran,18,0,30,12
1683287140562,MATH 18,A02,188345,Bach; Quang Tran,11,0,30,19
1683287140562,MATH 18,B01,188353,Bach; Quang Tran,10,0,30,20
1683287140562,MATH 18,B02,188354,Bach; Quang Tran,20,0,30,10
1683287141589,MATH 20A,A01,188374,Staff,13,0,35,22
1683287142617,MATH 20B,A01,188382,Ohm; Ko Woon,6,0,30,24
1683287142617,MATH 20B,A02,188383,Ohm; Ko Woon,24,0,30,6
1683287142617,MATH 20B,B01,188385,Ohm; Ko Woon,7,0,30,23
1683287142617,MATH 20B,B02,188392,Ohm; Ko Woon,22,0,30,8
1683287143644,MATH 20C,A01,188394,Harel; Guershon,10,0,30,20
1683287143644,MATH 20C,A02,188395,Harel; Guershon,13,0,30,17
1683287143644,MATH 20C,B01,188404,Harel; Guershon,3,0,30,27
1683287143644,MATH 20C,B02,188405,Harel; Guershon,19,0,30,11
1683287144673,MATH 20D,A01,188414,Hammock; Frances H,0,1,30,30
1683287144673,MATH 20D,A02,188415,Hammock; Frances H,4,0,30,26
1683287144673,MATH 20D,B01,188447,Hammock; Frances H,2,0,30,28
1683287144673,MATH 20D,B02,188486,Hammock; Frances H,8,0,30,22
1683287145698,MATH 20E,A01,188649,Staff,22,0,30,8
1683287145698,MATH 20E,A02,188650,Staff,23,0,30,7
1683287145698,MATH 20E,A03,188673,Staff,0,0,30,30
1683287146723,MATH 102,A01,188675,Staff,0,35,35,35
1683287147749,MATH 103B,A01,188681,Staff,4,0,35,31
1683287147749,MATH 103B,B01,188692,Staff,8,0,35,27
1683287148776,MATH 109,A01,188695,Salehi Golsefidy; Alireza,25,0,35,10
1683287148776,MATH 109,A02,188696,Salehi Golsefidy; Alireza,27,0,35,8
1683287149803,MATH 120A,A01,188698,Eggers; John Dietrich,5,0,35,30
1683287150831,MATH 142B,A01,188736,Ioana; Adrian,0,2,30,30
1683287150831,MATH 142B,A02,188741,Ioana; Adrian,0,1,30,30
1683287150831,MATH 142B,A03,188743,Ioana; Adrian,0,3,30,30
1683287151862,MATH 168A,A01,188790,Staff,0,8,35,35
1683287152894,MATH 170A,A01,188803,Nie; Jiawang,0,2,35,35
1683287152894,MATH 170A,A02,188811,Nie; Jiawang,0,0,35,35
1683287152894,MATH 170A,A03,188814,Nie; Jiawang,1,0,35,34
1683287152894,MATH 170A,A04,188815,Nie; Jiawang,14,0,35,21
1683287153925,MATH 193B,A01,188817,Staff,0,0,35,35
1683287153925,MATH 193B,A02,188818,Staff,5,0,35,30
1683287154958,MGT 4,A01,202857,Anderson; John Charles,62,0,80,18
1683287155987,MGT 12,A00,202858,Lindenberger; Wade Douglas,43,0,90,47
1683287157013,MGT 18,A00,202859,Staff,74,0,90,16
1683287158043,MGT 18GS,A00,202860,McKay; Michael J,13,0,28,15
1683287159075,MGT 45,A00,202861,Pecore; Joseph P.,14,0,90,76
1683287160105,MGT 100,A00,202863,Yavorsky; Daniel Ryan,28,0,90,62
1683287161138,MGT 103,A00,202864,Ehrich; Kristine R,0,16,90,90
1683287162164,MGT 112,A00,202865,Ehrich; Kristine R,15,0,90,75
1683287163192,MGT 121A,A00,202868,Staff,0,19,0,0
1683287164217,MGT 131B,A00,202869,Anderson; John Charles,60,0,90,30
1683287165244,MGT 136,A00,202871,Lindenberger; Wade Douglas,84,0,90,6
1683287166269,MGT 164,A00,202873,Staff,0,69,90,90
1683287167295,MGT 164GS,A00,202874,McKay; Mary A,13,0,28,15
1683287168321,MGT 180,A00,202875,Staff,0,51,90,90
1683287169354,MMW 11R,A01,205019,Herbst; Matthew,3,0,30,27
1683287169354,MMW 11R,A02,205026,Herbst; Matthew,29,0,30,1
1683287170389,MMW 15,A01,193512,Chang; Edmond Yi-Teh,0,9,28,28
1683287170389,MMW 15,A02,193513,Chang; Edmond Yi-Teh,0,5,28,28
1683287170389,MMW 15,A03,193514,Chang; Edmond Yi-Teh,0,5,28,28
1683287170389,MMW 15,A04,193515,Chang; Edmond Yi-Teh,0,4,28,28
1683287170389,MMW 15,A05,193516,Chang; Edmond Yi-Teh,0,4,28,28
1683287170389,MMW 15,A06,193517,Chang; Edmond Yi-Teh,0,5,28,28
1683287170389,MMW 15,B01,193519,Chang; Edmond Yi-Teh,0,4,28,28
1683287170389,MMW 15,B02,193520,Chang; Edmond Yi-Teh,0,5,28,28
1683287170389,MMW 15,B03,193521,Chang; Edmond Yi-Teh,0,4,28,28
1683287170389,MMW 15,B04,193522,Chang; Edmond Yi-Teh,0,4,28,28
1683287170389,MMW 15,B05,193523,Chang; Edmond Yi-Teh,0,5,28,28
1683287170389,MMW 15,B06,193524,Chang; Edmond Yi-Teh,0,4,28,28
1683287171417,MMW 122,A01,193526,Rahimi; Babak,0,14,28,28
1683287171417,MMW 122,A02,193527,Rahimi; Babak,0,14,28,28
1683287171417,MMW 122,A03,193528,Rahimi; Babak,0,0,0,0
1683287171417,MMW 122,A04,193529,Rahimi; Babak,0,0,0,0
1683287172445,MUS 1A,A01,186663,Staff,0,20,35,35
1683287173472,MUS 4,A01,186715,Staff,0,12,35,35
1683287174500,MUS 5R,A01,186796,Dubnov; Shlomo,0,16,35,35
1683287175526,MUS 6,A01,186798,Staff,0,3,25,25
1683287176552,MUS 7,A01,186830,Staff,12,0,35,23
1683287177579,MUS 8,A01,186930,Staff,0,25,35,35
1683287178611,MUS 15,A01,186932,Staff,0,15,35,35
1683287178611,MUS 15,B01,186934,Staff,0,14,35,35
1683287179643,MUS 80,A00,186935,Staff,2,0,20,18
1683287179643,MUS 80,B00,186936,Staff,25,0,25,0
1683287180672,NANO 11,A00,204702,Lipomi; Darren John,0,0,0,0
1683287181701,NANO 15,A01,204709,Yang; Kesong,0,1,0,0
1683287182729,NANO 114,A00,202069,Jahed Motlagh; Zeinab,3,0,10,7
1683287183760,PHIL 1,A00,186955,Grush; Rick Scott,32,0,40,8
1683287184790,PHIL 10,A01,186973,Grush; Rick Scott,29,0,35,6
1683287184790,PHIL 10,A02,186974,Grush; Rick Scott,33,0,35,2
1683287185817,PHIL 13,A01,186976,Staff,7,0,35,28
1683287185817,PHIL 13,A02,186977,Staff,16,0,35,19
1683287186842,PHIL 14,A01,186979,Staff,31,0,35,4
1683287186842,PHIL 14,A02,186986,Staff,32,0,35,3
1683287187870,PHIL 28,A01,186988,Staff,16,0,30,14
1683287187870,PHIL 28,A02,186989,Staff,1,0,30,29
1683287187870,PHIL 28,A03,186990,Staff,9,0,30,21
1683287187870,PHIL 28,A04,186991,Staff,26,0,30,4
1683287188898,PHIL 120,A00,186997,Staff,23,0,40,17
1683287189928,PHIL 137,A00,187003,Staff,9,0,40,31
1683287190958,PHIL 150,A00,187015,Staff,47,0,70,23
1683287191989,PHIL 167,A00,187021,Lamey; Andy M.,35,0,40,5
1683287193022,PHIL 174,A01,202226,Staff,17,0,20,3
1683287193022,PHIL 174,A02,202235,Staff,20,0,20,0
1683287194048,PHIL 191A,A00,258918,Staff,0,0,1,1
1683287195075,PHYS 1A,A00,187028,Staff,26,0,60,34
1683287196101,PHYS 1AL,001,187036,Staff,2,0,30,28
1683287196101,PHYS 1AL,002,187049,Staff,18,0,30,12
1683287197126,PHYS 1B,A00,187058,Staff,23,0,60,37
1683287198155,PHYS 1BL,001,187064,Staff,0,0,30,30
1683287198155,PHYS 1BL,002,187070,Staff,6,0,30,24
1683287199186,PHYS 1C,A00,187082,Staff,32,0,120,88
1683287200217,PHYS 1CL,001,187088,Staff,0,9,30,30
1683287200217,PHYS 1CL,002,187089,Staff,0,2,30,30
1683287200217,PHYS 1CL,009,262693,Staff,12,0,30,18
1683287201302,PHYS 2B,A01,187097,Staff,54,0,115,61
1683287202334,PHYS 2C,A01,187099,Staff,67,0,115,48
1683287203364,PHYS 2CL,A01,187101,Staff,5,0,28,23
1683287203364,PHYS 2CL,A02,187102,Staff,15,0,28,13
1683287204396,PHYS 2D,A01,187123,Shotwell; Brian,95,0,115,20
1683287205427,PHYS 4B,A01,187133,Grinstein; Benjamin,35,0,50,15
1683287206455,POLI 10,A00,188819,Staff,0,3,50,50
1683287207483,POLI 11,A00,188827,Staff,43,0,50,7
1683287208509,POLI 13R,A00,188828,Staff,0,1,20,20
1683287209536,POLI 27,A01,188830,Elgin; Samuel Zincke,0,1,70,70
1683287210564,POLI 30,A00,188832,Desposato; Scott,33,0,50,17
1683287211594,POLI 102F,A00,188834,Staff,3,0,40,37
1683287212620,POLI 104A,A00,188852,Staff,14,0,30,16
1683287213652,POLI 104I,A00,188853,Staff,0,6,20,20
1683287214684,POLI 110B,A00,188854,Wiens; David,7,0,20,13
1683287215713,POLI 112A,A00,188855,Wiens; David,5,0,30,25
1683287216742,POLI 117R,A00,188856,Forman; Fonna,0,11,20,20
1683287217767,POLI 118,A00,188857,Ingham; Sean,8,0,20,12
1683287218793,POLI 120G,A00,188858,Staff,9,0,30,21
1683287219823,POLI 131CR,A00,188863,Hoston; Germaine,24,0,50,26
1683287220854,POLI 133,A00,188864,Nellis; Gareth Hb,44,0,50,6
1683287221880,POLI 134D,A00,188865,Desposato; Scott,27,0,30,3
1683287222909,POLI 142A,A00,188871,Gartzke; Erik,22,0,50,28
1683287223936,POLI 142K,A00,188874,Staff,38,0,50,12
1683287224962,POLI 143,A00,188940,Gartzke; Erik,16,0,30,14
1683287225989,POLI 153,A00,188943,Staff,3,0,20,17
1683287227015,POLI 160AA,A00,188944,Staff,13,0,40,27
1683287228040,POLI 170A,A00,188945,Staff,11,0,30,19
1683287230097,PSYC 1,A00,188952,Staff,38,0,90,52
1683287231123,PSYC 2,B00,188953,Staff,20,0,35,15
1683287232155,PSYC 6,A00,188970,Staff,47,0,60,13
1683287233182,PSYC 7,A00,188973,Staff,37,0,45,8
1683287234217,PSYC 60,A01,188980,Rickard; Timothy C.,43,0,60,17
1683287235249,PSYC 70,A01,189001,Steiner; Eric Tomas,24,0,45,21
1683287236274,PSYC 100,A00,189005,Lacefield; Katharine I,0,99,120,120
1683287237300,PSYC 102,A00,189008,Staff,10,0,30,20
1683287238327,PSYC 106,B00,189026,Gorman; Michael R.,37,0,60,23
1683287239352,PSYC 114,B01,189033,Winkielman; Piotr,0,32,30,30
1683287240382,PSYC 131,A00,189036,Anagnostaras; Stephan,0,43,60,60
1683287241411,PSYC 136,A00,189041,Lowe; Angela Beth,0,7,25,25
1683287242440,PSYC 137,A00,189057,Winkielman; Piotr,0,34,25,25
1683287243467,PSYC 144,A00,189107,Wixted; John T,0,7,50,50
1683287245528,PSYC 162,A00,189142,Staff,0,8,85,85
1683287246556,PSYC 172,A00,189144,Gorman; Michael R.,0,7,30,30
1683287248612,PSYC 179,A00,189146,Lacefield; Katharine I,0,84,120,120
1683287249643,PSYC 181,A00,189147,Anagnostaras; Stephan,0,44,90,90
1683287250669,PSYC 190R,A00,189148,Barner; David A.,0,22,80,80
1683287251696,PSYC 191,A00,189275,Rickard; Timothy C.,0,7,25,25
1683287252727,PSYC 193,A00,189276,Chapman; Eddie Nathaniel,0,1,0,4
1683287253759,PSYC 193L,A01,189281,Lowe; Angela Beth,12,0,20,8
1683287253759,PSYC 193L,B01,189285,Staff,28,0,35,7
1683287254787,RELI 149,A00,187137,Rahimi; Babak,7,0,40,33
1683287255814,SE 9,A01,187315,Staff,0,2,18,18
1683287256841,SE 101B,A00,187409,Staff,24,0,30,6
1683287257874,SE 110B,A00,187444,Staff,10,0,40,30
1683287258904,SE 130B,A00,187449,Staff,31,0,40,9
1683287259933,SE 150A,A00,187516,Staff,9,0,20,11
1683287260963,SE 154,A00,187528,Staff,30,0,50,20
1683287261995,SIO 3,A01,258171,Staff,35,0,40,5
1683287263025,SIO 10,A00,187144,Cook; Geoffrey W,0,3,75,75
1683287264053,SIO 45,A00,187152,Cook; Geoffrey W,1,0,100,99
1683287265080,SIO 109R,A00,194486,Staff,0,3,20,20
1683287267139,SIO 187,A01,187233,Kacev; David,12,0,40,28
1683287268175,SOCI 1,A01,258656,Thorpe; Charles Robert,28,0,30,2
1683287268175,SOCI 1,A02,258658,Thorpe; Charles Robert,30,0,30,0
1683287268175,SOCI 1,A03,258661,Thorpe; Charles Robert,25,0,25,0
1683287268175,SOCI 1,A04,258666,Thorpe; Charles Robert,22,0,25,3
1683287268175,SOCI 1,A05,258897,Thorpe; Charles Robert,23,0,25,2
1683287268175,SOCI 1,A06,258898,Thorpe; Charles Robert,25,0,25,0
1683287269202,SOCI 30,A01,258903,Pardo Guerra; Juan Pablo,16,0,30,14
1683287270229,SOCI 102,A00,258904,Staff,9,0,25,16
1683287271255,SOCI 106,A00,258905,Staff,19,0,25,6
1683287272282,SOCI 111,A00,258907,Ribas Norris; Janet Vanesa,26,0,30,4
1683287273312,SOCI 121R,A00,258908,Pardo Guerra; Juan Pablo,11,0,30,19
1683287274342,SOCI 126,A01,203330,Staff,14,0,20,6
1683287275367,SOCI 131,A00,258909,Thorpe; Charles Robert,31,0,60,29
1683287276396,SOCI 135,A00,258910,Payne; Christine Anna,0,9,30,30
1683287277426,SOCI 157,A00,258911,Staff,13,0,30,17
1683287278457,SOCI 184,A00,258912,Staff,26,0,30,4
1683287279484,SOCI 188D,A00,258913,Staff,21,0,30,9
1683287280510,SYN 2,001,187529,Staff,9,0,16,7
1683287280510,SYN 2,002,201452,Staff,0,18,16,16
1683287280510,SYN 2,003,201469,Staff,3,0,16,13
1683287281536,SYN 100,A01,187531,Staff,0,9,20,20
1683287281536,SYN 100,B01,201491,Staff,0,12,20,20
1683287282565,TDAC 1,A00,189286,Walsh; Kim C.,3,0,20,17
1683287282565,TDAC 1,B00,189287,Harting; Carla Kelso,11,0,20,9
1683287283592,TDAC 101,A00,189300,Walsh; Kim C.,16,0,20,4
1683287283592,TDAC 101,B00,189301,Harting; Carla Kelso,18,0,20,2
1683287284623,TDAC 102,A00,189304,Basso; Beatrice,14,0,20,6
1683287285650,TDAC 108,A00,189305,Staff,18,0,20,2
1683287286679,TDDE 131,A00,189310,Staff,19,0,20,1
1683287286679,TDDE 131,B00,189314,Staff,19,0,20,1
1683287286679,TDDE 131,C00,189315,Staff,48,0,50,2
1683287286679,TDDE 131,D00,189316,Staff,14,0,15,1
1683287286679,TDDE 131,E00,204841,Staff,20,0,20,0
1683287287706,TDGE 10,A00,189289,Staff,30,0,50,20
1683287287706,TDGE 10,B00,189290,Havis; Allan,2,0,50,48
1683287288733,TDGE 11,A00,189291,Fulton; Julia,0,3,50,50
1683287288733,TDGE 11,B00,189292,Staff,20,0,25,5
1683287288733,TDGE 11,C00,260270,Staff,0,0,0,0
1683287289758,TDGE 25,A00,189294,Staff,3,0,20,17
1683287290783,TDGE 124,A00,189318,Fulton; Julia,0,8,50,50
1683287291810,TDGE 125,A00,189319,Staff,13,0,25,12
1683287291810,TDGE 125,B00,189320,Staff,23,0,25,2
1683287292841,TDGE 127,A00,189322,Havis; Allan,0,0,50,50
1683287293869,TDHT 101,A00,189323,Staff,18,0,25,7
1683287293869,TDHT 101,B00,189324,Staff,25,0,25,0
1683287294896,TDHT 102,A00,189325,Staff,49,0,50,1
1683287295925,TDMV 1,A00,189295,Arcidiacono; Kristin,20,0,30,10
1683287295925,TDMV 1,B00,189296,Caligagan; Maria T.,24,0,30,6
1683287296953,TDMV 2,A00,189297,Sammartano; Tonnie,28,0,30,2
1683287296953,TDMV 2,B00,189299,Arcidiacono; Kristin,24,0,30,6
1683287297980,TDMV 3,A00,204998,Rincon; Alicia,22,0,30,8
1683287299005,TDMV 120,A00,189458,Sammartano; Tonnie,28,0,30,2
1683287300034,TDMV 138,A00,189541,Jun; Grace Shin Hae,22,0,40,18
1683287301074,TDMV 142,A00,189717,Caligagan; Tony,23,0,30,7
1683287301074,TDMV 142,B00,189718,Caligagan; Maria T.,25,0,30,5
1683287302104,TMC 2,A01,187533,Staff,25,0,25,0
1683287302104,TMC 2,A02,187534,Staff,25,0,25,0
1683287303134,USP 1,A01,187536,Kwak; Nancy,0,16,25,25
1683287304170,USP 5,A01,187538,Staff,9,0,25,16
1683287305257,USP 101,A00,199253,Staff,0,4,0,0
1683287306285,USP 124,A00,187562,Boomhower; Matthew Charles,1,0,30,29
1683287307315,USP 138,A00,187582,Staff,20,0,25,5
1683287308340,USP 152,A01,187597,Staff,4,0,25,21
1683287309366,USP 153,A00,187598,Staff,19,0,25,6
1683287310392,USP 168,A00,187607,Kwak; Nancy,2,0,5,3
1683287311420,USP 173,A00,187619,Staff,4,0,25,21
1683287312448,USP 181,A00,187638,Staff,0,0,25,25
1683287313474,VIS 103,A00,187650,Cruz; Edwin Teddy,23,0,75,52
1683287314501,VIS 110D,A00,187669,Staff,12,0,22,10
1683287315528,VIS 127C,A00,187720,Shen; Kuiyi,68,0,146,78
1683287316555,VIS 149,A00,187731,Yoldas; Pinar,0,14,22,22
1683287317585,VIS 151,A01,188091,Staff,22,0,34,12
1683287317585,VIS 151,A02,188092,Staff,11,0,34,23
1683287318615,VIS 160B,A00,188093,Stalbaum; Brett,0,0,10,10
1683287320670,WCWP 10B,A00,201720,Staff,10,0,15,5
1683287320670,WCWP 10B,B00,201722,Staff,8,0,15,7
1683287321701,WCWP 100,A00,201725,Gagnon; Jeffrey C,0,0,2,2
1683287321701,WCWP 100,B00,201727,Staff,0,4,15,15
1683287324852,ANBI 133,A00,258401,Wilder; Linnea Lorene,34,0,40,6
1683287325884,ANBI 140,A00,258395,Hrvoj Mihic; Branka,18,0,25,7
1683287326915,ANSC 120,A00,258402,Bialecki; Jon Anthony,27,0,40,13
1683287327944,ANSC 144,A00,258400,Staff,14,0,40,26
1683287330004,ANSC 166,A00,258396,Parish; Steven Martin,157,0,175,18
1683287331032,ANSC 180,A00,193533,Staff,9,0,20,11
1683287332059,ANSC 188,A00,258397,Jassal; Aftab,33,0,40,7
1683287333086,ANTH 3,A01,258316,Staff,23,0,30,7
1683287334114,ANTH 5,A00,258394,Semendeferi; Ekaterini,16,0,20,4
1683287335138,ANTH 21,A01,258331,Staff,9,0,40,31
1683287336170,ANTH 103,A00,258398,Varma; Saiba,15,0,25,10
1683287337199,AWP 10,001,202034,Staff,0,0,0,0
1683287337199,AWP 10,002,202035,Staff,0,0,0,0
1683287337199,AWP 10,003,202036,Staff,0,0,0,0
1683287337199,AWP 10,004,202037,Staff,0,0,0,0
1683287337199,AWP 10,005,202038,Staff,0,0,0,0
1683287337199,AWP 10,006,202039,Staff,0,0,0,0
1683287337199,AWP 10,007,202040,Staff,0,0,0,0
1683287337199,AWP 10,008,202041,Staff,0,0,0,0
1683287337199,AWP 10,009,202042,Staff,0,0,0,0
1683287337199,AWP 10,010,202043,Staff,0,0,0,0
1683287337199,AWP 10,011,202044,Staff,0,0,0,0
1683287337199,AWP 10,012,202045,Staff,0,0,0,0
1683287337199,AWP 10,013,202046,Staff,0,0,0,0
1683287337199,AWP 10,014,202047,Staff,0,0,0,0
1683287337199,AWP 10,015,202048,Staff,0,0,0,0
1683287337199,AWP 10,016,202049,Staff,0,0,0,0
1683287337199,AWP 10,017,202050,Staff,0,0,0,0
1683287337199,AWP 10,018,202051,Staff,0,0,0,0
1683287337199,AWP 10,019,202052,Staff,0,0,0,0
1683287337199,AWP 10,020,202053,Staff,0,0,0,0
1683287337199,AWP 10,021,202054,Staff,0,0,0,0
1683287337199,AWP 10,022,202055,Staff,0,0,0,0
1683287337199,AWP 10,023,202056,Staff,0,0,0,0
1683287337199,AWP 10,024,202057,Staff,0,0,0,0
1683287337199,AWP 10,025,202058,Staff,0,0,0,0
1683287337199,AWP 10,026,202059,Staff,0,0,0,0
1683287338224,AWP 102,001,202032,Staff,0,0,0,0
1683287338224,AWP 102,002,202033,Staff,0,0,0,0
1683287339251,BENG 100,A01,254234,Taylor Amos; Alyssa C,31,0,40,9
1683287340276,BENG 196,001,270013,Engler; Adam J.,9999,0,9999,0
1683287341315,BICD 100R,A01,202018,Smith; Laurie,0,7,32,32
1683287341315,BICD 100R,A02,202019,Smith; Laurie,0,2,32,32
1683287341315,BICD 100R,A03,202020,Smith; Laurie,0,1,32,32
1683287341315,BICD 100R,A04,202021,Smith; Laurie,8,0,32,24
1683287341315,BICD 100R,A05,202022,Smith; Laurie,12,0,32,20
1683287342341,BICD 136,A01,193242,Gustafson-Brown; Cindy,0,2,32,32
1683287342341,BICD 136,A02,193244,Gustafson-Brown; Cindy,15,0,32,17
1683287343372,BIEB 102,A01,193249,Butler; Shannon Rhey,0,2,32,32
1683287343372,BIEB 102,A02,193251,Butler; Shannon Rhey,0,0,32,32
1683287343372,BIEB 102,A03,193253,Butler; Shannon Rhey,0,1,32,32
1683287343372,BIEB 102,A04,193255,Butler; Shannon Rhey,17,0,32,15
1683287343372,BIEB 102,A05,193265,Butler; Shannon Rhey,26,0,32,6
1683287343372,BIEB 102,A06,193269,Butler; Shannon Rhey,16,0,32,16
1683287345430,BIEB 150,A01,193274,Staff,0,0,32,32
1683287345430,BIEB 150,A02,193285,Staff,24,0,32,8
1683287346461,BIEB 194,A00,193286,Kurle; Carolyn M.,22,0,32,10
1683287347495,BILD 1,A01,192291,Staff,16,0,32,16
1683287347495,BILD 1,A02,192292,Staff,30,0,32,2
1683287347495,BILD 1,B01,192520,Reuther; Keefe,0,1,0,0
1683287347495,BILD 1,B02,192532,Reuther; Keefe,0,1,0,0
1683287348528,BILD 3,A01,192556,Butler; Shannon Rhey,0,0,32,32
1683287348528,BILD 3,A02,192581,Butler; Shannon Rhey,5,0,32,27
1683287348528,BILD 3,A03,192611,Butler; Shannon Rhey,23,0,32,9
1683287348528,BILD 3,A04,192612,Butler; Shannon Rhey,25,0,32,7
1683287348528,BILD 3,A05,192613,Butler; Shannon Rhey,27,0,32,5
1683287348528,BILD 3,A06,192679,Butler; Shannon Rhey,27,0,32,5
1683287348528,BILD 3,A07,192682,Butler; Shannon Rhey,22,0,32,10
1683287349559,BILD 4,A01,192836,Reuther; Keefe,1,0,24,23
1683287349559,BILD 4,A02,193044,Reuther; Keefe,4,0,24,20
1683287350590,BILD 10,A01,193142,Gustafson-Brown; Cindy,31,0,32,1
1683287350590,BILD 10,A02,193149,Gustafson-Brown; Cindy,31,0,32,1
1683287351617,BIMM 100,A01,193301,Staff,0,6,32,32
1683287351617,BIMM 100,A02,193312,Staff,0,5,32,32
1683287351617,BIMM 100,A03,193323,Staff,0,8,32,32
1683287352645,BIMM 101,A01,193329,McDonnell; Lisa Marie,0,3,24,24
1683287352645,BIMM 101,A02,193339,McDonnell; Lisa Marie,0,2,24,24
1683287352645,BIMM 101,B01,193354,McDonnell; Lisa Marie,0,3,24,24
1683287352645,BIMM 101,B02,193357,McDonnell; Lisa Marie,0,3,24,24
1683287353674,BIMM 110,A01,193377,Tat; John,0,11,32,32
1683287353674,BIMM 110,A02,193378,Tat; John,1,9,32,31
1683287354703,BIMM 120,A01,206116,Staff,0,0,32,32
1683287354703,BIMM 120,A02,206117,Staff,8,0,32,24
1683287354703,BIMM 120,A03,206121,Staff,21,0,32,11
1683287355730,BIPN 100,A01,193393,Park; Ji Young,0,14,32,32
1683287355730,BIPN 100,A02,193402,Park; Ji Young,0,12,32,32
1683287355730,BIPN 100,A03,193413,Park; Ji Young,0,14,32,32
1683287355730,BIPN 100,A04,193414,Park; Ji Young,0,13,32,32
1683287356762,BIPN 102,A01,193429,Staff,0,0,32,32
1683287356762,BIPN 102,A02,193438,Staff,23,0,32,9
1683287357789,BIPN 106,A01,193450,Reyes Gonzalez; Catalina,0,2,40,40
1683287358818,BIPN 134,A01,193465,Cooke; James Edward,0,0,32,32
1683287358818,BIPN 134,A02,193474,Cooke; James Edward,27,0,32,5
1683287358818,BIPN 134,A03,193485,Cooke; James Edward,29,0,32,3
1683287358818,BIPN 134,A04,193486,Cooke; James Edward,21,0,32,11
1683287358818,BIPN 134,A05,193491,Cooke; James Edward,31,0,32,1
1683287358818,BIPN 134,A06,193501,Cooke; James Edward,30,0,32,2
1683287358818,BIPN 134,A07,193510,Cooke; James Edward,29,0,32,3
1683287360874,BISP 194,A00,222522,Staff,16,0,32,16
1683287361901,CAT 124,A01,202407,Staff,20,0,25,5
1683287362928,CAT 125,A00,202408,Marchisotto; Jennifer Anne,4,0,20,16
1683287363957,CAT 125R,A00,202409,Smith; Lauryn Alissa,0,11,20,20
1683287363957,CAT 125R,B00,202410,Morales; Celeste Georgianna,0,11,20,20
1683287363957,CAT 125R,C00,202411,Irwin; Matthew Joseph,0,10,20,20
1683287364984,CENG 15,A01,204712,Yang; Kesong,0,1,0,0
1683287366011,CENG 114,A00,202070,Jahed Motlagh; Zeinab,5,0,20,15
1683287367041,CGS 105,A00,185477,Wesling; Megan E.,24,0,40,16
1683287368071,CGS 106,A00,185494,Staff,13,0,22,9
1683287369105,CGS 108,A00,185495,Staff,14,0,20,6
1683287370135,CGS 114,A00,185496,Staff,13,0,18,5
1683287371162,CGS 119,A00,185501,Staff,15,0,20,5
1683287372191,CGS 120,A00,185511,Staff,13,0,20,7
1683287373226,CHEM 4,A01,184675,Bussey; Thomas J,96,0,100,4
1683287374254,CHEM 6A,A01,184677,Staff,35,0,60,25
1683287375280,CHEM 6B,A01,184679,Staff,65,0,100,35
1683287376308,CHEM 6C,A01,184681,Bussey; Thomas J,1,0,50,49
1683287376308,CHEM 6C,A02,184682,Bussey; Thomas J,34,0,50,16
1683287377336,CHEM 40A,A01,184684,Albizati; Kim F.,37,0,100,63
1683287378362,CHEM 40B,A01,184686,Albizati; Kim F.,0,20,100,100
1683287379389,CHEM 41B,A01,184690,Staff,52,0,100,48
1683287380419,COGS 3,A01,184715,Boyle; Mary E. T.,0,25,40,40
1683287381450,COGS 14B,A01,185172,Staff,0,15,38,38
1683287382479,COGS 18,A01,184736,Staff,20,0,80,60
1683287383511,COGS 100,A01,184932,Staff,0,5,73,73
1683287384540,COGS 101A,A01,184935,Staff,0,38,30,30
1683287385568,COGS 101B,A01,184944,Staff,0,2,30,30
1683287386598,COGS 101C,A01,184946,Staff,0,12,30,30
1683287387625,COGS 102A,A01,184951,Johnson; Christine M.,2,0,40,38
1683287388652,COGS 107B,A01,184953,Mooshagian; Eric Frederick,0,50,40,40
1683287389680,COGS 118B,A01,184959,Gupta; Anjum,0,48,40,40
1683287390707,COGS 153,A00,184961,Staff,0,15,30,30
1683287391733,COGS 177,A00,184962,Staff,0,21,30,30
1683287392765,COGS 187A,A01,184969,Boyle; Mary E. T.,0,17,40,40
1683287393793,COMM 10,A01,185174,Staff,0,5,25,25
1683287393793,COMM 10,A02,185189,Staff,0,5,25,25
1683287393793,COMM 10,A03,269821,Staff,0,0,0,0
1683287394825,COMM 100B,A01,185475,Staff,0,0,0,2
1683287394825,COMM 100B,A02,185476,Staff,14,0,25,11
1683287395851,COMM 100C,A01,185314,Staff,1,0,25,24
1683287395851,COMM 100C,A02,185327,Staff,19,0,25,6
1683287396876,COMM 110M,A00,185349,Staff,2,0,40,38
1683287397906,COMM 113T,A00,185352,Staff,25,0,40,15
1683287398933,COMM 114I,A00,185353,Staff,33,0,40,7
1683287399961,COMM 131,A00,185354,Staff,19,0,30,11
1683287400998,CSE 8A,A50,185358,Cao; Yingjun,0,46,10,10
1683287402026,CSE 8B,A01,185362,Staff,0,47,50,50
1683287403052,CSE 11,A01,185416,Cao; Yingjun,0,93,10,10
1683287404086,CSE 20,A01,185445,Briones; Jor-el Thomas Caparas,5,0,25,20
1683287405116,CSE 21,A01,185447,Staff,10,0,50,40
1683287406149,CSE 101,A01,185451,Staff,0,12,50,50
1683287406149,CSE 101,B01,185453,Jones; Miles E,0,11,50,50
1683287408206,CSE 141,A01,185458,Eldon; John,20,0,100,80
1683287409288,CSE 141L,A01,185461,Eldon; John,12,0,100,88
1683287410318,CSE 142,A01,185463,Staff,35,0,60,25
1683287410318,CSE 142,B01,201355,Staff,0,6,60,60
1683287411345,CSE 142L,A01,185470,Staff,35,0,60,25
1683287411345,CSE 142L,B01,201417,Staff,0,5,60,60
1683287412370,CSE 190,A00,201433,Staff,32,0,49,17
1683287413398,DOC 1,A01,259136,Strom; Megan C.,8,0,15,7
1683287413398,DOC 1,A02,259137,Strom; Megan C.,14,0,15,1
1683287413398,DOC 1,A03,259138,Strom; Megan C.,14,0,15,1
1683287413398,DOC 1,A04,259139,Strom; Megan C.,14,0,15,1
1683287414425,DOC 100D,A00,259140,Pass; Natalye Joann,17,0,25,8
1683287415452,DSGN 1,A01,184749,Rill; Bryan,0,24,30,30
1683287416480,DSGN 100,A01,185168,Staff,0,2,25,25
1683287417512,ECE 5,A01,185626,Morris; Karcher William,0,10,0,0
1683287418542,ECE 101,A01,185628,Staff,17,0,70,53
1683287419574,ECE 107,A01,185635,Baghdadchi; Saharnaz,0,0,20,20
1683287419574,ECE 107,A02,185638,Baghdadchi; Saharnaz,4,0,20,16
1683287420606,ECE 148,A01,185647,Silberman; Jack,1,0,16,15
1683287421633,ECON 1,A01,185537,Crane; Meredith Helen,54,0,70,16
1683287422658,ECON 3,A01,185549,Crane; Meredith Helen,33,0,70,37
1683287423689,ECON 4,A01,203354,Anderson; John Charles,0,4,10,10
1683287424714,ECON 100A,A01,185574,Staff,0,4,40,40
1683287425741,ECON 100B,A01,185576,Staff,0,22,40,40
1683287426767,ECON 100C,A01,185589,Newhouse; Herbert S,30,0,70,40
1683287427794,ECON 105,A00,185608,Vespa; Emanuel Ignacio,19,0,35,16
1683287428821,ECON 109,A01,185610,Shishkin; Denis,10,0,35,25
1683287429852,ECON 110A,A01,185612,Staff,11,0,40,29
1683287430878,ECON 120A,A01,185615,Staff,20,0,40,20
1683287431913,ECON 120C,A01,185617,Sun; Yixiao,0,20,70,70
1683287432940,ECON 144,A00,203346,Squires; Dale E,3,0,35,32
1683287433974,ECON 171,A01,203349,Newhouse; Herbert S,0,1,35,35
1683287435004,ECON 173A,A01,185621,Toda; Alexis Akira,21,0,35,14
1683287436040,EDS 25,A01,202413,Staff,0,1,0,0
1683287436040,EDS 25,A02,202414,Staff,0,1,0,0
1683287436040,EDS 25,A03,202415,Staff,0,0,0,0
1683287436040,EDS 25,A04,202416,Staff,0,1,0,0
1683287436040,EDS 25,A05,202439,Staff,0,0,0,0
1683287436040,EDS 25,A06,202440,Staff,0,0,0,0
1683287436040,EDS 25,B01,202631,Staff,0,0,0,0
1683287436040,EDS 25,B02,202632,Staff,0,0,0,0
1683287436040,EDS 25,B03,202639,Staff,0,0,0,0
1683287436040,EDS 25,B04,202640,Staff,0,0,0,0
1683287436040,EDS 25,B05,202643,Staff,0,0,0,0
1683287436040,EDS 25,B06,202644,Staff,0,0,0,0
1683287437068,EDS 38,A01,202659,Black; Alison Michelle,24,0,25,1
1683287438094,EDS 115,A00,202652,Staff,17,0,30,13
1683287439119,EDS 125,A00,202649,Staff,14,0,30,16
1683287440146,EDS 126,A01,203332,Staff,30,0,30,0
1683287441172,EDS 139,A00,202838,Staff,17,0,25,8
1683287442197,EDS 146,A01,202655,Staff,15,0,25,10
1683287443222,ENG 15,A00,185667,Staff,0,1,0,0
1683287443222,ENG 15,B00,185672,Staff,0,0,0,0
1683287443222,ENG 15,C00,185675,Staff,0,0,0,0
1683287443222,ENG 15,D00,185682,Staff,0,0,0,0
1683287443222,ENG 15,E00,185684,Staff,0,0,0,0
1683287444250,ETHN 103,A00,185710,Staff,0,3,35,35
1683287445282,ETHN 103A,A00,199228,Man; Simeon S,3,0,9,6
1683287446307,ETHN 109,A00,185711,Staff,18,0,35,17
1683287447333,ETHN 142,A00,185726,Staff,0,4,30,30
1683287448358,ETHN 163J,A00,199229,Man; Simeon S,6,0,8,2
1683287449384,ETHN 168,A00,185727,Staff,8,0,10,2
1683287450411,ETHN 182,A00,185728,Staff,1,0,35,34
1683287451436,ETHN 183,A00,185737,Staff,8,0,18,10
1683287452468,GLBH 111,A01,209361,Burgos; Jose L.,0,0,0,0
1683287454530,HIEU 104,A00,185792,Staff,16,0,20,4
1683287455558,HIEU 115,A00,185800,Staff,1,0,20,19
1683287456586,HIEU 128,A00,185801,Staff,0,7,20,20
1683287457615,HIEU 147,A00,185802,Staff,16,0,20,4
1683287458646,HIEU 154,A00,185823,Staff,12,0,20,8
1683287459674,HILA 102,A00,185826,Staff,13,0,20,7
1683287460705,HILD 2C,A01,185778,Staff,0,12,20,20
1683287461736,HILD 7B,A01,185780,Kwak; Nancy,0,15,32,32
1683287461736,HILD 7B,A02,185781,Kwak; Nancy,0,18,32,32
1683287462763,HILD 30,A01,185791,Staff,14,0,20,6
1683287463794,HISC 119,A00,185830,Golan; Tal,0,9,20,20
1683287464823,HITO 156GS,A00,185831,Patterson; Patrick H.,0,0,0,23
1683287465852,HIUS 103,A00,185832,Man; Simeon S,0,7,20,20
1683287466882,HIUS 117,A00,185836,Kwak; Nancy,2,0,20,18
1683287467908,HIUS 125,A00,185840,Man; Simeon S,0,0,23,23
1683287468936,HIUS 149,A00,185845,Staff,0,0,20,20
1683287469966,HUM 3,A01,185882,Zavodny; Tatiana Sophia,0,6,50,50
1683287469966,HUM 3,B01,185899,Caldwell; Michael Alan,0,19,50,50
1683287470996,HUM 3GS,A00,185900,Patterson; Patrick H.,0,0,0,23
1683287472031,HUM 4,A01,185938,Zroka; Amy Liane,31,0,50,19
1683287472031,HUM 4,B01,185956,Watkins; Eric,0,2,50,50
1683287472031,HUM 4,B02,202209,Watkins; Eric,0,1,50,50
1683287472031,HUM 4,B03,202210,Watkins; Eric,0,0,50,50
1683287473062,HUM 5,A01,185958,West; Geoffrey Scott,5,0,50,45
1683287473062,HUM 5,A02,202215,West; Geoffrey Scott,0,0,50,50
1683287474090,INTL 190,A00,185959,Gagnon; Jeffrey C,0,0,0,9
1683287474090,INTL 190,B00,185960,Lettieri; Michael Joseph,0,0,0,1
1683287475117,JAPN 180,A00,254509,Staff,0,1,25,25
1683287476146,LATI 10,A01,202853,Kennemore; Amy Michelle,5,0,35,30
1683287476146,LATI 10,A02,202854,Kennemore; Amy Michelle,1,0,35,34
1683287476146,LATI 10,A03,270054,Kennemore; Amy Michelle,30,0,30,0
1683287477172,LATI 180,A00,202855,Kennemore; Amy Michelle,11,0,20,9
1683287478200,LAWS 101,A00,201767,Golan; Tal,0,7,40,40
1683287479229,LIFR 1C,A00,185961,Staff,6,0,20,14
1683287480260,LIFR 1CX,A00,185962,Staff,7,0,20,13
1683287481289,LIFR 1D,A00,185963,Staff,9,0,20,11
1683287482317,LIFR 1DX,A00,185964,Staff,9,0,20,11
1683287483345,LIGN 101,A01,186039,Staff,43,0,50,7
1683287484372,LIGN 165,A00,186040,Staff,18,0,50,32
1683287485399,LTCS 108,A00,186041,Staff,6,0,10,4
1683287486425,LTCS 119,A00,186042,Staff,16,0,20,4
1683287487452,LTCS 130,A00,186043,Wesling; Megan E.,15,0,25,10
1683287489502,LTEA 138,A00,186119,Staff,14,0,40,26
1683287490528,LTEN 124,A00,186148,Staff,6,0,25,19
1683287491557,LTEN 178,A00,186149,Staff,7,0,15,8
1683287492588,LTEN 181,A00,186150,Blanco; John D,33,0,40,7
1683287493613,LTWL 120,A00,186160,Staff,20,0,25,5
1683287494639,LTWL 165,A00,186161,Staff,22,0,25,3
1683287495667,LTWR 100,A00,186162,Staff,0,4,15,15
1683287496695,LTWR 102,A00,186163,Doller; Ben,5,0,15,10
1683287497727,MAE 8,A01,186412,Staff,0,0,0,0
1683287498754,MAE 30B,A00,186445,Bahadori; Mohammad Yousef,83,0,100,17
1683287499785,MAE 40,A00,186592,Bewley; Thomas R,9,0,50,41
1683287500813,MAE 101B,A00,186593,Bahadori; Mohammad Yousef,81,0,100,19
1683287501840,MAE 105,A00,186594,Bandaru; Prabhakar,12,0,50,38
1683287502871,MAE 107,A00,186599,Pham; Hieu Tan,0,6,120,120
1683287503897,MAE 148,A01,186660,Silberman; Jack,3,0,16,13
1683287504924,MATH 10A,A01,188095,Staff,0,7,35,35
1683287505952,MATH 10B,A01,188097,Bowers; Adam R.,0,11,30,30
1683287505952,MATH 10B,A02,188099,Bowers; Adam R.,0,9,30,30
1683287505952,MATH 10B,B01,188104,Bowers; Adam R.,0,11,30,30
1683287505952,MATH 10B,B02,188106,Bowers; Adam R.,0,11,30,30
1683287506987,MATH 10C,A01,188111,Staff,0,18,30,30
1683287506987,MATH 10C,A02,188127,Staff,0,17,30,30
1683287506987,MATH 10C,A03,188131,Staff,0,17,30,30
1683287506987,MATH 10C,B01,188218,Staff,21,0,30,9
1683287506987,MATH 10C,B02,188244,Staff,13,0,30,17
1683287506987,MATH 10C,B03,188277,Staff,16,0,30,14
1683287508020,MATH 18,A01,188344,Bach; Quang Tran,18,0,30,12
1683287508020,MATH 18,A02,188345,Bach; Quang Tran,11,0,30,19
1683287508020,MATH 18,B01,188353,Bach; Quang Tran,10,0,30,20
1683287508020,MATH 18,B02,188354,Bach; Quang Tran,20,0,30,10
1683287509046,MATH 20A,A01,188374,Staff,13,0,35,22
1683287510075,MATH 20B,A01,188382,Ohm; Ko Woon,6,0,30,24
1683287510075,MATH 20B,A02,188383,Ohm; Ko Woon,24,0,30,6
1683287510075,MATH 20B,B01,188385,Ohm; Ko Woon,7,0,30,23
1683287510075,MATH 20B,B02,188392,Ohm; Ko Woon,22,0,30,8
1683287511103,MATH 20C,A01,188394,Harel; Guershon,10,0,30,20
1683287511103,MATH 20C,A02,188395,Harel; Guershon,13,0,30,17
1683287511103,MATH 20C,B01,188404,Harel; Guershon,3,0,30,27
1683287511103,MATH 20C,B02,188405,Harel; Guershon,19,0,30,11
1683287512130,MATH 20D,A01,188414,Hammock; Frances H,0,1,30,30
1683287512130,MATH 20D,A02,188415,Hammock; Frances H,4,0,30,26
1683287512130,MATH 20D,B01,188447,Hammock; Frances H,2,0,30,28
1683287512130,MATH 20D,B02,188486,Hammock; Frances H,8,0,30,22
1683287513230,MATH 20E,A01,188649,Staff,22,0,30,8
1683287513230,MATH 20E,A02,188650,Staff,23,0,30,7
1683287513230,MATH 20E,A03,188673,Staff,0,0,30,30
1683287514260,MATH 102,A01,188675,Staff,0,35,35,35
1683287515290,MATH 103B,A01,188681,Staff,4,0,35,31
1683287515290,MATH 103B,B01,188692,Staff,8,0,35,27
1683287516323,MATH 109,A01,188695,Salehi Golsefidy; Alireza,25,0,35,10
1683287516323,MATH 109,A02,188696,Salehi Golsefidy; Alireza,27,0,35,8
1683287517355,MATH 120A,A01,188698,Eggers; John Dietrich,5,0,35,30
1683287518386,MATH 142B,A01,188736,Ioana; Adrian,0,2,30,30
1683287518386,MATH 142B,A02,188741,Ioana; Adrian,0,1,30,30
1683287518386,MATH 142B,A03,188743,Ioana; Adrian,0,3,30,30
1683287519419,MATH 168A,A01,188790,Staff,0,8,35,35
1683287520453,MATH 170A,A01,188803,Nie; Jiawang,0,2,35,35
1683287520453,MATH 170A,A02,188811,Nie; Jiawang,0,0,35,35
1683287520453,MATH 170A,A03,188814,Nie; Jiawang,1,0,35,34
1683287520453,MATH 170A,A04,188815,Nie; Jiawang,14,0,35,21
1683287521478,MATH 193B,A01,188817,Staff,0,0,35,35
1683287521478,MATH 193B,A02,188818,Staff,5,0,35,30
1683287522505,MGT 4,A01,202857,Anderson; John Charles,62,0,80,18
1683287523532,MGT 12,A00,202858,Lindenberger; Wade Douglas,43,0,90,47
1683287524558,MGT 18,A00,202859,Staff,74,0,90,16
1683287525585,MGT 18GS,A00,202860,McKay; Michael J,13,0,28,15
1683287526613,MGT 45,A00,202861,Pecore; Joseph P.,14,0,90,76
1683287527642,MGT 100,A00,202863,Yavorsky; Daniel Ryan,28,0,90,62
1683287528674,MGT 103,A00,202864,Ehrich; Kristine R,0,16,90,90
1683287529703,MGT 112,A00,202865,Ehrich; Kristine R,15,0,90,75
1683287530730,MGT 121A,A00,202868,Staff,0,19,0,0
1683287531756,MGT 131B,A00,202869,Anderson; John Charles,60,0,90,30
1683287532783,MGT 136,A00,202871,Lindenberger; Wade Douglas,84,0,90,6
1683287533809,MGT 164,A00,202873,Staff,0,69,90,90
1683287534836,MGT 164GS,A00,202874,McKay; Mary A,13,0,28,15
1683287535868,MGT 180,A00,202875,Staff,0,51,90,90
1683287536897,MMW 11R,A01,205019,Herbst; Matthew,3,0,30,27
1683287536897,MMW 11R,A02,205026,Herbst; Matthew,29,0,30,1
1683287537930,MMW 15,A01,193512,Chang; Edmond Yi-Teh,0,9,28,28
1683287537930,MMW 15,A02,193513,Chang; Edmond Yi-Teh,0,5,28,28
1683287537930,MMW 15,A03,193514,Chang; Edmond Yi-Teh,0,5,28,28
1683287537930,MMW 15,A04,193515,Chang; Edmond Yi-Teh,0,4,28,28
1683287537930,MMW 15,A05,193516,Chang; Edmond Yi-Teh,0,4,28,28
1683287537930,MMW 15,A06,193517,Chang; Edmond Yi-Teh,0,5,28,28
1683287537930,MMW 15,B01,193519,Chang; Edmond Yi-Teh,0,4,28,28
1683287537930,MMW 15,B02,193520,Chang; Edmond Yi-Teh,0,5,28,28
1683287537930,MMW 15,B03,193521,Chang; Edmond Yi-Teh,0,4,28,28
1683287537930,MMW 15,B04,193522,Chang; Edmond Yi-Teh,0,4,28,28
1683287537930,MMW 15,B05,193523,Chang; Edmond Yi-Teh,0,5,28,28
1683287537930,MMW 15,B06,193524,Chang; Edmond Yi-Teh,0,4,28,28
1683287538962,MMW 122,A01,193526,Rahimi; Babak,0,14,28,28
1683287538962,MMW 122,A02,193527,Rahimi; Babak,0,14,28,28
1683287538962,MMW 122,A03,193528,Rahimi; Babak,0,0,0,0
1683287538962,MMW 122,A04,193529,Rahimi; Babak,0,0,0,0
1683287539990,MUS 1A,A01,186663,Staff,0,20,35,35
1683287541017,MUS 4,A01,186715,Staff,0,12,35,35
1683287542046,MUS 5R,A01,186796,Dubnov; Shlomo,0,16,35,35
1683287543073,MUS 6,A01,186798,Staff,0,3,25,25
1683287544100,MUS 7,A01,186830,Staff,12,0,35,23
1683287545125,MUS 8,A01,186930,Staff,0,25,35,35
1683287546154,MUS 15,A01,186932,Staff,0,15,35,35
1683287546154,MUS 15,B01,186934,Staff,0,14,35,35
1683287547180,MUS 80,A00,186935,Staff,2,0,20,18
1683287547180,MUS 80,B00,186936,Staff,25,0,25,0
1683287548209,NANO 11,A00,204702,Lipomi; Darren John,0,0,0,0
1683287549238,NANO 15,A01,204709,Yang; Kesong,0,1,0,0
1683287550265,NANO 114,A00,202069,Jahed Motlagh; Zeinab,3,0,10,7
1683287551298,PHIL 1,A00,186955,Grush; Rick Scott,32,0,40,8
1683287552329,PHIL 10,A01,186973,Grush; Rick Scott,29,0,35,6
1683287552329,PHIL 10,A02,186974,Grush; Rick Scott,33,0,35,2
1683287553356,PHIL 13,A01,186976,Staff,7,0,35,28
1683287553356,PHIL 13,A02,186977,Staff,16,0,35,19
1683287554381,PHIL 14,A01,186979,Staff,31,0,35,4
1683287554381,PHIL 14,A02,186986,Staff,32,0,35,3
1683287555409,PHIL 28,A01,186988,Staff,16,0,30,14
1683287555409,PHIL 28,A02,186989,Staff,1,0,30,29
1683287555409,PHIL 28,A03,186990,Staff,9,0,30,21
1683287555409,PHIL 28,A04,186991,Staff,26,0,30,4
1683287556439,PHIL 120,A00,186997,Staff,23,0,40,17
1683287557465,PHIL 137,A00,187003,Staff,9,0,40,31
1683287558495,PHIL 150,A00,187015,Staff,47,0,70,23
1683287559526,PHIL 167,A00,187021,Lamey; Andy M.,35,0,40,5
1683287560557,PHIL 174,A01,202226,Staff,17,0,20,3
1683287560557,PHIL 174,A02,202235,Staff,20,0,20,0
1683287561583,PHIL 191A,A00,258918,Staff,0,0,1,1
1683287562614,PHYS 1A,A00,187028,Staff,26,0,60,34
1683287563643,PHYS 1AL,001,187036,Staff,2,0,30,28
1683287563643,PHYS 1AL,002,187049,Staff,18,0,30,12
1683287564672,PHYS 1B,A00,187058,Staff,23,0,60,37
1683287565702,PHYS 1BL,001,187064,Staff,0,0,30,30
1683287565702,PHYS 1BL,002,187070,Staff,6,0,30,24
1683287566733,PHYS 1C,A00,187082,Staff,32,0,120,88
1683287567761,PHYS 1CL,001,187088,Staff,0,9,30,30
1683287567761,PHYS 1CL,002,187089,Staff,0,2,30,30
1683287567761,PHYS 1CL,009,262693,Staff,12,0,30,18
1683287568791,PHYS 2B,A01,187097,Staff,54,0,115,61
1683287569818,PHYS 2C,A01,187099,Staff,67,0,115,48
1683287570850,PHYS 2CL,A01,187101,Staff,5,0,28,23
1683287570850,PHYS 2CL,A02,187102,Staff,15,0,28,13
1683287571882,PHYS 2D,A01,187123,Shotwell; Brian,95,0,115,20
1683287572914,PHYS 4B,A01,187133,Grinstein; Benjamin,35,0,50,15
1683287573940,POLI 10,A00,188819,Staff,0,3,50,50
1683287574966,POLI 11,A00,188827,Staff,43,0,50,7
1683287575990,POLI 13R,A00,188828,Staff,0,1,20,20
1683287577015,POLI 27,A01,188830,Elgin; Samuel Zincke,0,1,70,70
1683287578041,POLI 30,A00,188832,Desposato; Scott,33,0,50,17
1683287579070,POLI 102F,A00,188834,Staff,3,0,40,37
1683287580099,POLI 104A,A00,188852,Staff,14,0,30,16
1683287581125,POLI 104I,A00,188853,Staff,0,6,20,20
1683287582152,POLI 110B,A00,188854,Wiens; David,7,0,20,13
1683287583179,POLI 112A,A00,188855,Wiens; David,5,0,30,25
1683287584205,POLI 117R,A00,188856,Forman; Fonna,0,11,20,20
1683287585236,POLI 118,A00,188857,Ingham; Sean,8,0,20,12
1683287586268,POLI 120G,A00,188858,Staff,9,0,30,21
1683287587298,POLI 131CR,A00,188863,Hoston; Germaine,24,0,50,26
1683287588325,POLI 133,A00,188864,Nellis; Gareth Hb,44,0,50,6
1683287589352,POLI 134D,A00,188865,Desposato; Scott,27,0,30,3
1683287590377,POLI 142A,A00,188871,Gartzke; Erik,22,0,50,28
1683287591404,POLI 142K,A00,188874,Staff,38,0,50,12
1683287592432,POLI 143,A00,188940,Gartzke; Erik,16,0,30,14
1683287593461,POLI 153,A00,188943,Staff,3,0,20,17
1683287594491,POLI 160AA,A00,188944,Staff,13,0,40,27
1683287595522,POLI 170A,A00,188945,Staff,11,0,30,19
1683287597580,PSYC 1,A00,188952,Staff,38,0,90,52
1683287598609,PSYC 2,B00,188953,Staff,20,0,35,15
1683287599640,PSYC 6,A00,188970,Staff,47,0,60,13
1683287600666,PSYC 7,A00,188973,Staff,37,0,45,8
1683287601695,PSYC 60,A01,188980,Rickard; Timothy C.,43,0,60,17
1683287602722,PSYC 70,A01,189001,Steiner; Eric Tomas,24,0,45,21
1683287603749,PSYC 100,A00,189005,Lacefield; Katharine I,0,99,120,120
1683287604774,PSYC 102,A00,189008,Staff,10,0,30,20
1683287605802,PSYC 106,B00,189026,Gorman; Michael R.,37,0,60,23
1683287606829,PSYC 114,B01,189033,Winkielman; Piotr,0,32,30,30
1683287607855,PSYC 131,A00,189036,Anagnostaras; Stephan,0,43,60,60
1683287608886,PSYC 136,A00,189041,Lowe; Angela Beth,0,7,25,25
1683287609917,PSYC 137,A00,189057,Winkielman; Piotr,0,34,25,25
1683287610948,PSYC 144,A00,189107,Wixted; John T,0,7,50,50
1683287613009,PSYC 162,A00,189142,Staff,0,8,85,85
1683287614036,PSYC 172,A00,189144,Gorman; Michael R.,0,7,30,30
1683287616088,PSYC 179,A00,189146,Lacefield; Katharine I,0,84,120,120
1683287617169,PSYC 181,A00,189147,Anagnostaras; Stephan,0,44,90,90
1683287618196,PSYC 190R,A00,189148,Barner; David A.,0,22,80,80
1683287619227,PSYC 191,A00,189275,Rickard; Timothy C.,0,7,25,25
1683287620253,PSYC 193,A00,189276,Chapman; Eddie Nathaniel,0,1,0,4
1683287621280,PSYC 193L,A01,189281,Lowe; Angela Beth,12,0,20,8
1683287621280,PSYC 193L,B01,189285,Staff,28,0,35,7
1683287622307,RELI 149,A00,187137,Rahimi; Babak,7,0,40,33
1683287623333,SE 9,A01,187315,Staff,0,2,18,18
1683287624364,SE 101B,A00,187409,Staff,24,0,30,6
1683287625393,SE 110B,A00,187444,Staff,10,0,40,30
1683287626422,SE 130B,A00,187449,Staff,31,0,40,9
1683287627451,SE 150A,A00,187516,Staff,9,0,20,11
1683287628481,SE 154,A00,187528,Staff,30,0,50,20
1683287629509,SIO 3,A01,258171,Staff,35,0,40,5
1683287630537,SIO 10,A00,187144,Cook; Geoffrey W,0,3,75,75
1683287631563,SIO 45,A00,187152,Cook; Geoffrey W,1,0,100,99
1683287632589,SIO 109R,A00,194486,Staff,0,3,20,20
1683287634644,SIO 187,A01,187233,Kacev; David,12,0,40,28
1683287635679,SOCI 1,A01,258656,Thorpe; Charles Robert,28,0,30,2
1683287635679,SOCI 1,A02,258658,Thorpe; Charles Robert,30,0,30,0
1683287635679,SOCI 1,A03,258661,Thorpe; Charles Robert,25,0,25,0
1683287635679,SOCI 1,A04,258666,Thorpe; Charles Robert,22,0,25,3
1683287635679,SOCI 1,A05,258897,Thorpe; Charles Robert,23,0,25,2
1683287635679,SOCI 1,A06,258898,Thorpe; Charles Robert,25,0,25,0
1683287636710,SOCI 30,A01,258903,Pardo Guerra; Juan Pablo,16,0,30,14
1683287637738,SOCI 102,A00,258904,Staff,9,0,25,16
1683287638767,SOCI 106,A00,258905,Staff,19,0,25,6
1683287639798,SOCI 111,A00,258907,Ribas Norris; Janet Vanesa,26,0,30,4
1683287640824,SOCI 121R,A00,258908,Pardo Guerra; Juan Pablo,11,0,30,19
1683287641854,SOCI 126,A01,203330,Staff,14,0,20,6
1683287642881,SOCI 131,A00,258909,Thorpe; Charles Robert,31,0,60,29
1683287643911,SOCI 135,A00,258910,Payne; Christine Anna,0,9,30,30
1683287644937,SOCI 157,A00,258911,Staff,13,0,30,17
1683287645966,SOCI 184,A00,258912,Staff,26,0,30,4
1683287646992,SOCI 188D,A00,258913,Staff,21,0,30,9
1683287648018,SYN 2,001,187529,Staff,9,0,16,7
1683287648018,SYN 2,002,201452,Staff,0,18,16,16
1683287648018,SYN 2,003,201469,Staff,3,0,16,13
1683287649049,SYN 100,A01,187531,Staff,0,9,20,20
1683287649049,SYN 100,B01,201491,Staff,0,12,20,20
1683287650080,TDAC 1,A00,189286,Walsh; Kim C.,3,0,20,17
1683287650080,TDAC 1,B00,189287,Harting; Carla Kelso,11,0,20,9
1683287651110,TDAC 101,A00,189300,Walsh; Kim C.,16,0,20,4
1683287651110,TDAC 101,B00,189301,Harting; Carla Kelso,18,0,20,2
1683287652141,TDAC 102,A00,189304,Basso; Beatrice,14,0,20,6
1683287653165,TDAC 108,A00,189305,Staff,18,0,20,2
1683287654193,TDDE 131,A00,189310,Staff,19,0,20,1
1683287654193,TDDE 131,B00,189314,Staff,19,0,20,1
1683287654193,TDDE 131,C00,189315,Staff,48,0,50,2
1683287654193,TDDE 131,D00,189316,Staff,14,0,15,1
1683287654193,TDDE 131,E00,204841,Staff,20,0,20,0
1683287655221,TDGE 10,A00,189289,Staff,30,0,50,20
1683287655221,TDGE 10,B00,189290,Havis; Allan,2,0,50,48
1683287656247,TDGE 11,A00,189291,Fulton; Julia,0,3,50,50
1683287656247,TDGE 11,B00,189292,Staff,20,0,25,5
1683287656247,TDGE 11,C00,260270,Staff,0,0,0,0
1683287657272,TDGE 25,A00,189294,Staff,3,0,20,17
1683287658302,TDGE 124,A00,189318,Fulton; Julia,0,8,50,50
1683287659333,TDGE 125,A00,189319,Staff,13,0,25,12
1683287659333,TDGE 125,B00,189320,Staff,23,0,25,2
1683287660363,TDGE 127,A00,189322,Havis; Allan,0,0,50,50
1683287661391,TDHT 101,A00,189323,Staff,18,0,25,7
1683287661391,TDHT 101,B00,189324,Staff,25,0,25,0
1683287662417,TDHT 102,A00,189325,Staff,49,0,50,1
1683287663446,TDMV 1,A00,189295,Arcidiacono; Kristin,20,0,30,10
1683287663446,TDMV 1,B00,189296,Caligagan; Maria T.,24,0,30,6
1683287664473,TDMV 2,A00,189297,Sammartano; Tonnie,28,0,30,2
1683287664473,TDMV 2,B00,189299,Arcidiacono; Kristin,24,0,30,6
1683287665505,TDMV 3,A00,204998,Rincon; Alicia,22,0,30,8
1683287666535,TDMV 120,A00,189458,Sammartano; Tonnie,28,0,30,2
1683287667569,TDMV 138,A00,189541,Jun; Grace Shin Hae,22,0,40,18
1683287668596,TDMV 142,A00,189717,Caligagan; Tony,23,0,30,7
1683287668596,TDMV 142,B00,189718,Caligagan; Maria T.,25,0,30,5
1683287669628,TMC 2,A01,187533,Staff,25,0,25,0
1683287669628,TMC 2,A02,187534,Staff,25,0,25,0
1683287670654,USP 1,A01,187536,Kwak; Nancy,0,16,25,25
1683287671680,USP 5,A01,187538,Staff,9,0,25,16
1683287672710,USP 101,A00,199253,Staff,0,4,0,0
1683287673738,USP 124,A00,187562,Boomhower; Matthew Charles,1,0,30,29
1683287674764,USP 138,A00,187582,Staff,20,0,25,5
1683287675789,USP 152,A01,187597,Staff,4,0,25,21
1683287676816,USP 153,A00,187598,Staff,19,0,25,6
1683287677842,USP 168,A00,187607,Kwak; Nancy,2,0,5,3
1683287678869,USP 173,A00,187619,Staff,4,0,25,21
1683287679897,USP 181,A00,187638,Staff,0,0,25,25
1683287680929,VIS 103,A00,187650,Cruz; Edwin Teddy,23,0,75,52
1683287681955,VIS 110D,A00,187669,Staff,12,0,22,10
1683287682983,VIS 127C,A00,187720,Shen; Kuiyi,68,0,146,78
1683287684012,VIS 149,A00,187731,Yoldas; Pinar,0,14,22,22
1683287685042,VIS 151,A01,188091,Staff,22,0,34,12
1683287685042,VIS 151,A02,188092,Staff,11,0,34,23
1683287686073,VIS 160B,A00,188093,Stalbaum; Brett,0,0,10,10
1683287688124,WCWP 10B,A00,201720,Staff,10,0,15,5
1683287688124,WCWP 10B,B00,201722,Staff,8,0,15,7
1683287689149,WCWP 100,A00,201725,Gagnon; Jeffrey C,0,0,2,2
1683287689149,WCWP 100,B00,201727,Staff,0,4,15,15
1683287692281,ANBI 133,A00,258401,Wilder; Linnea Lorene,34,0,40,6
1683287693311,ANBI 140,A00,258395,Hrvoj Mihic; Branka,18,0,25,7
1683287694340,ANSC 120,A00,258402,Bialecki; Jon Anthony,27,0,40,13
1683287695365,ANSC 144,A00,258400,Staff,14,0,40,26
1683287697422,ANSC 166,A00,258396,Parish; Steven Martin,157,0,175,18
1683287698450,ANSC 180,A00,193533,Staff,9,0,20,11
1683287699481,ANSC 188,A00,258397,Jassal; Aftab,33,0,40,7
1683287700510,ANTH 3,A01,258316,Staff,23,0,30,7
1683287701536,ANTH 5,A00,258394,Semendeferi; Ekaterini,16,0,20,4
1683287702566,ANTH 21,A01,258331,Staff,9,0,40,31
1683287703595,ANTH 103,A00,258398,Varma; Saiba,15,0,25,10
1683287704634,AWP 10,001,202034,Staff,0,0,0,0
1683287704634,AWP 10,002,202035,Staff,0,0,0,0
1683287704634,AWP 10,003,202036,Staff,0,0,0,0
1683287704634,AWP 10,004,202037,Staff,0,0,0,0
1683287704634,AWP 10,005,202038,Staff,0,0,0,0
1683287704634,AWP 10,006,202039,Staff,0,0,0,0
1683287704634,AWP 10,007,202040,Staff,0,0,0,0
1683287704634,AWP 10,008,202041,Staff,0,0,0,0
1683287704634,AWP 10,009,202042,Staff,0,0,0,0
1683287704634,AWP 10,010,202043,Staff,0,0,0,0
1683287704634,AWP 10,011,202044,Staff,0,0,0,0
1683287704634,AWP 10,012,202045,Staff,0,0,0,0
1683287704634,AWP 10,013,202046,Staff,0,0,0,0
1683287704634,AWP 10,014,202047,Staff,0,0,0,0
1683287704634,AWP 10,015,202048,Staff,0,0,0,0
1683287704634,AWP 10,016,202049,Staff,0,0,0,0
1683287704634,AWP 10,017,202050,Staff,0,0,0,0
1683287704634,AWP 10,018,202051,Staff,0,0,0,0
1683287704634,AWP 10,019,202052,Staff,0,0,0,0
1683287704634,AWP 10,020,202053,Staff,0,0,0,0
1683287704634,AWP 10,021,202054,Staff,0,0,0,0
1683287704634,AWP 10,022,202055,Staff,0,0,0,0
1683287704634,AWP 10,023,202056,Staff,0,0,0,0
1683287704634,AWP 10,024,202057,Staff,0,0,0,0
1683287704634,AWP 10,025,202058,Staff,0,0,0,0
1683287704634,AWP 10,026,202059,Staff,0,0,0,0
1683287705663,AWP 102,001,202032,Staff,0,0,0,0
1683287705663,AWP 102,002,202033,Staff,0,0,0,0
1683287706690,BENG 100,A01,254234,Taylor Amos; Alyssa C,31,0,40,9
1683287707718,BENG 196,001,270013,Engler; Adam J.,9999,0,9999,0
1683287708749,BICD 100R,A01,202018,Smith; Laurie,0,7,32,32
1683287708749,BICD 100R,A02,202019,Smith; Laurie,0,2,32,32
1683287708749,BICD 100R,A03,202020,Smith; Laurie,0,1,32,32
1683287708749,BICD 100R,A04,202021,Smith; Laurie,8,0,32,24
1683287708749,BICD 100R,A05,202022,Smith; Laurie,12,0,32,20
1683287709777,BICD 136,A01,193242,Gustafson-Brown; Cindy,0,2,32,32
1683287709777,BICD 136,A02,193244,Gustafson-Brown; Cindy,15,0,32,17
1683287710814,BIEB 102,A01,193249,Butler; Shannon Rhey,0,2,32,32
1683287710814,BIEB 102,A02,193251,Butler; Shannon Rhey,0,0,32,32
1683287710814,BIEB 102,A03,193253,Butler; Shannon Rhey,0,1,32,32
1683287710814,BIEB 102,A04,193255,Butler; Shannon Rhey,17,0,32,15
1683287710814,BIEB 102,A05,193265,Butler; Shannon Rhey,26,0,32,6
1683287710814,BIEB 102,A06,193269,Butler; Shannon Rhey,16,0,32,16
1683287712867,BIEB 150,A01,193274,Staff,0,0,32,32
1683287712867,BIEB 150,A02,193285,Staff,24,0,32,8
1683287713892,BIEB 194,A00,193286,Kurle; Carolyn M.,22,0,32,10
1683287714919,BILD 1,A01,192291,Staff,16,0,32,16
1683287714919,BILD 1,A02,192292,Staff,30,0,32,2
1683287714919,BILD 1,B01,192520,Reuther; Keefe,0,1,0,0
1683287714919,BILD 1,B02,192532,Reuther; Keefe,0,1,0,0
1683287715950,BILD 3,A01,192556,Butler; Shannon Rhey,0,0,32,32
1683287715950,BILD 3,A02,192581,Butler; Shannon Rhey,5,0,32,27
1683287715950,BILD 3,A03,192611,Butler; Shannon Rhey,23,0,32,9
1683287715950,BILD 3,A04,192612,Butler; Shannon Rhey,25,0,32,7
1683287715950,BILD 3,A05,192613,Butler; Shannon Rhey,27,0,32,5
1683287715950,BILD 3,A06,192679,Butler; Shannon Rhey,27,0,32,5
1683287715950,BILD 3,A07,192682,Butler; Shannon Rhey,22,0,32,10
1683287716982,BILD 4,A01,192836,Reuther; Keefe,1,0,24,23
1683287716982,BILD 4,A02,193044,Reuther; Keefe,4,0,24,20
1683287718011,BILD 10,A01,193142,Gustafson-Brown; Cindy,31,0,32,1
1683287718011,BILD 10,A02,193149,Gustafson-Brown; Cindy,31,0,32,1
1683287719041,BIMM 100,A01,193301,Staff,0,6,32,32
1683287719041,BIMM 100,A02,193312,Staff,0,5,32,32
1683287719041,BIMM 100,A03,193323,Staff,0,8,32,32
1683287720067,BIMM 101,A01,193329,McDonnell; Lisa Marie,0,3,24,24
1683287720067,BIMM 101,A02,193339,McDonnell; Lisa Marie,0,2,24,24
1683287720067,BIMM 101,B01,193354,McDonnell; Lisa Marie,0,3,24,24
1683287720067,BIMM 101,B02,193357,McDonnell; Lisa Marie,0,3,24,24
1683287721147,BIMM 110,A01,193377,Tat; John,0,11,32,32
1683287721147,BIMM 110,A02,193378,Tat; John,1,9,32,31
1683287722182,BIMM 120,A01,206116,Staff,0,0,32,32
1683287722182,BIMM 120,A02,206117,Staff,8,0,32,24
1683287722182,BIMM 120,A03,206121,Staff,21,0,32,11
1683287723208,BIPN 100,A01,193393,Park; Ji Young,0,14,32,32
1683287723208,BIPN 100,A02,193402,Park; Ji Young,0,12,32,32
1683287723208,BIPN 100,A03,193413,Park; Ji Young,0,14,32,32
1683287723208,BIPN 100,A04,193414,Park; Ji Young,0,13,32,32
1683287724237,BIPN 102,A01,193429,Staff,0,0,32,32
1683287724237,BIPN 102,A02,193438,Staff,23,0,32,9
1683287725267,BIPN 106,A01,193450,Reyes Gonzalez; Catalina,0,2,40,40
1683287726301,BIPN 134,A01,193465,Cooke; James Edward,0,0,32,32
1683287726301,BIPN 134,A02,193474,Cooke; James Edward,27,0,32,5
1683287726301,BIPN 134,A03,193485,Cooke; James Edward,29,0,32,3
1683287726301,BIPN 134,A04,193486,Cooke; James Edward,21,0,32,11
1683287726301,BIPN 134,A05,193491,Cooke; James Edward,31,0,32,1
1683287726301,BIPN 134,A06,193501,Cooke; James Edward,30,0,32,2
1683287726301,BIPN 134,A07,193510,Cooke; James Edward,29,0,32,3
1683287728357,BISP 194,A00,222522,Staff,16,0,32,16
1683287729384,CAT 124,A01,202407,Staff,20,0,25,5
1683287730417,CAT 125,A00,202408,Marchisotto; Jennifer Anne,4,0,20,16
1683287731449,CAT 125R,A00,202409,Smith; Lauryn Alissa,0,11,20,20
1683287731449,CAT 125R,B00,202410,Morales; Celeste Georgianna,0,11,20,20
1683287731449,CAT 125R,C00,202411,Irwin; Matthew Joseph,0,10,20,20
1683287732479,CENG 15,A01,204712,Yang; Kesong,0,1,0,0
1683287733506,CENG 114,A00,202070,Jahed Motlagh; Zeinab,5,0,20,15
1683287734534,CGS 105,A00,185477,Wesling; Megan E.,24,0,40,16
1683287735558,CGS 106,A00,185494,Staff,13,0,22,9
1683287736583,CGS 108,A00,185495,Staff,14,0,20,6
1683287737607,CGS 114,A00,185496,Staff,13,0,18,5
1683287738637,CGS 119,A00,185501,Staff,15,0,20,5
1683287739666,CGS 120,A00,185511,Staff,13,0,20,7
1683287740698,CHEM 4,A01,184675,Bussey; Thomas J,96,0,100,4
1683287741723,CHEM 6A,A01,184677,Staff,35,0,60,25
1683287742749,CHEM 6B,A01,184679,Staff,65,0,100,35
1683287743780,CHEM 6C,A01,184681,Bussey; Thomas J,1,0,50,49
1683287743780,CHEM 6C,A02,184682,Bussey; Thomas J,34,0,50,16
1683287744805,CHEM 40A,A01,184684,Albizati; Kim F.,37,0,100,63
1683287745835,CHEM 40B,A01,184686,Albizati; Kim F.,0,20,100,100
1683287746861,CHEM 41B,A01,184690,Staff,52,0,100,48
1683287747889,COGS 3,A01,184715,Boyle; Mary E. T.,0,25,40,40
1683287748916,COGS 14B,A01,185172,Staff,0,15,38,38
1683287749942,COGS 18,A01,184736,Staff,20,0,80,60
1683287750969,COGS 100,A01,184932,Staff,0,5,73,73
1683287751995,COGS 101A,A01,184935,Staff,0,38,30,30
1683287753024,COGS 101B,A01,184944,Staff,0,2,30,30
1683287754054,COGS 101C,A01,184946,Staff,0,12,30,30
1683287755083,COGS 102A,A01,184951,Johnson; Christine M.,2,0,40,38
1683287756109,COGS 107B,A01,184953,Mooshagian; Eric Frederick,0,50,40,40
1683287757137,COGS 118B,A01,184959,Gupta; Anjum,0,48,40,40
1683287758164,COGS 153,A00,184961,Staff,0,15,30,30
1683287759191,COGS 177,A00,184962,Staff,0,21,30,30
1683287760219,COGS 187A,A01,184969,Boyle; Mary E. T.,0,17,40,40
1683287761245,COMM 10,A01,185174,Staff,0,5,25,25
1683287761245,COMM 10,A02,185189,Staff,0,5,25,25
1683287761245,COMM 10,A03,269821,Staff,0,0,0,0
1683287762272,COMM 100B,A01,185475,Staff,0,0,0,2
1683287762272,COMM 100B,A02,185476,Staff,14,0,25,11
1683287763304,COMM 100C,A01,185314,Staff,1,0,25,24
1683287763304,COMM 100C,A02,185327,Staff,19,0,25,6
1683287764340,COMM 110M,A00,185349,Staff,2,0,40,38
1683287765370,COMM 113T,A00,185352,Staff,25,0,40,15
1683287766398,COMM 114I,A00,185353,Staff,33,0,40,7
1683287767423,COMM 131,A00,185354,Staff,19,0,30,11
1683287768450,CSE 8A,A50,185358,Cao; Yingjun,0,46,10,10
1683287769480,CSE 8B,A01,185362,Staff,0,47,50,50
1683287770511,CSE 11,A01,185416,Cao; Yingjun,0,93,10,10
1683287771541,CSE 20,A01,185445,Briones; Jor-el Thomas Caparas,5,0,25,20
1683287772569,CSE 21,A01,185447,Staff,10,0,50,40
1683287773597,CSE 101,A01,185451,Staff,0,12,50,50
1683287773597,CSE 101,B01,185453,Jones; Miles E,0,11,50,50
1683287775648,CSE 141,A01,185458,Eldon; John,20,0,100,80
1683287776673,CSE 141L,A01,185461,Eldon; John,12,0,100,88
1683287777703,CSE 142,A01,185463,Staff,35,0,60,25
1683287777703,CSE 142,B01,201355,Staff,0,6,60,60
1683287778731,CSE 142L,A01,185470,Staff,35,0,60,25
1683287778731,CSE 142L,B01,201417,Staff,0,5,60,60
1683287779756,CSE 190,A00,201433,Staff,32,0,49,17
1683287780785,DOC 1,A01,259136,Strom; Megan C.,8,0,15,7
1683287780785,DOC 1,A02,259137,Strom; Megan C.,14,0,15,1
1683287780785,DOC 1,A03,259138,Strom; Megan C.,14,0,15,1
1683287780785,DOC 1,A04,259139,Strom; Megan C.,14,0,15,1
1683287781815,DOC 100D,A00,259140,Pass; Natalye Joann,17,0,25,8
1683287782847,DSGN 1,A01,184749,Rill; Bryan,0,24,30,30
1683287783873,DSGN 100,A01,185168,Staff,0,2,25,25
1683287784900,ECE 5,A01,185626,Morris; Karcher William,0,10,0,0
1683287785930,ECE 101,A01,185628,Staff,17,0,70,53
1683287786964,ECE 107,A01,185635,Baghdadchi; Saharnaz,0,0,20,20
1683287786964,ECE 107,A02,185638,Baghdadchi; Saharnaz,4,0,20,16
1683287787990,ECE 148,A01,185647,Silberman; Jack,1,0,16,15
1683287789021,ECON 1,A01,185537,Crane; Meredith Helen,54,0,70,16
1683287790054,ECON 3,A01,185549,Crane; Meredith Helen,33,0,70,37
1683287791082,ECON 4,A01,203354,Anderson; John Charles,0,4,10,10
1683287792109,ECON 100A,A01,185574,Staff,0,4,40,40
1683287793136,ECON 100B,A01,185576,Staff,0,22,40,40
1683287794164,ECON 100C,A01,185589,Newhouse; Herbert S,30,0,70,40
1683287795190,ECON 105,A00,185608,Vespa; Emanuel Ignacio,19,0,35,16
1683287796217,ECON 109,A01,185610,Shishkin; Denis,10,0,35,25
1683287797242,ECON 110A,A01,185612,Staff,11,0,40,29
1683287798269,ECON 120A,A01,185615,Staff,20,0,40,20
1683287799296,ECON 120C,A01,185617,Sun; Yixiao,0,20,70,70
1683287800320,ECON 144,A00,203346,Squires; Dale E,3,0,35,32
1683287801348,ECON 171,A01,203349,Newhouse; Herbert S,0,1,35,35
1683287802375,ECON 173A,A01,185621,Toda; Alexis Akira,21,0,35,14
1683287803404,EDS 25,A01,202413,Staff,0,1,0,0
1683287803404,EDS 25,A02,202414,Staff,0,1,0,0
1683287803404,EDS 25,A03,202415,Staff,0,0,0,0
1683287803404,EDS 25,A04,202416,Staff,0,1,0,0
1683287803404,EDS 25,A05,202439,Staff,0,0,0,0
1683287803404,EDS 25,A06,202440,Staff,0,0,0,0
1683287803404,EDS 25,B01,202631,Staff,0,0,0,0
1683287803404,EDS 25,B02,202632,Staff,0,0,0,0
1683287803404,EDS 25,B03,202639,Staff,0,0,0,0
1683287803404,EDS 25,B04,202640,Staff,0,0,0,0
1683287803404,EDS 25,B05,202643,Staff,0,0,0,0
1683287803404,EDS 25,B06,202644,Staff,0,0,0,0
1683287804431,EDS 38,A01,202659,Black; Alison Michelle,24,0,25,1
1683287805460,EDS 115,A00,202652,Staff,17,0,30,13
1683287806486,EDS 125,A00,202649,Staff,14,0,30,16
1683287807513,EDS 126,A01,203332,Staff,30,0,30,0
1683287808539,EDS 139,A00,202838,Staff,17,0,25,8
1683287809566,EDS 146,A01,202655,Staff,15,0,25,10
1683287810598,ENG 15,A00,185667,Staff,0,1,0,0
1683287810598,ENG 15,B00,185672,Staff,0,0,0,0
1683287810598,ENG 15,C00,185675,Staff,0,0,0,0
1683287810598,ENG 15,D00,185682,Staff,0,0,0,0
1683287810598,ENG 15,E00,185684,Staff,0,0,0,0
1683287811623,ETHN 103,A00,185710,Staff,0,3,35,35
1683287812653,ETHN 103A,A00,199228,Man; Simeon S,3,0,9,6
1683287813681,ETHN 109,A00,185711,Staff,18,0,35,17
1683287814707,ETHN 142,A00,185726,Staff,0,4,30,30
1683287815734,ETHN 163J,A00,199229,Man; Simeon S,6,0,8,2
1683287816759,ETHN 168,A00,185727,Staff,8,0,10,2
1683287817784,ETHN 182,A00,185728,Staff,1,0,35,34
1683287818809,ETHN 183,A00,185737,Staff,8,0,18,10
1683287819835,GLBH 111,A01,209361,Burgos; Jose L.,0,0,0,0
1683287821891,HIEU 104,A00,185792,Staff,16,0,20,4
1683287822921,HIEU 115,A00,185800,Staff,1,0,20,19
1683287823949,HIEU 128,A00,185801,Staff,0,7,20,20
1683287825035,HIEU 147,A00,185802,Staff,16,0,20,4
1683287826066,HIEU 154,A00,185823,Staff,12,0,20,8
1683287827094,HILA 102,A00,185826,Staff,13,0,20,7
1683287828124,HILD 2C,A01,185778,Staff,0,12,20,20
1683287829151,HILD 7B,A01,185780,Kwak; Nancy,0,15,32,32
1683287829151,HILD 7B,A02,185781,Kwak; Nancy,0,18,32,32
1683287830176,HILD 30,A01,185791,Staff,14,0,20,6
1683287831203,HISC 119,A00,185830,Golan; Tal,0,9,20,20
1683287832229,HITO 156GS,A00,185831,Patterson; Patrick H.,0,0,0,23
1683287833255,HIUS 103,A00,185832,Man; Simeon S,0,7,20,20
1683287834285,HIUS 117,A00,185836,Kwak; Nancy,2,0,20,18
1683287835312,HIUS 125,A00,185840,Man; Simeon S,0,0,23,23
1683287836339,HIUS 149,A00,185845,Staff,0,0,20,20
1683287837372,HUM 3,A01,185882,Zavodny; Tatiana Sophia,0,6,50,50
1683287837372,HUM 3,B01,185899,Caldwell; Michael Alan,0,19,50,50
1683287838400,HUM 3GS,A00,185900,Patterson; Patrick H.,0,0,0,23
1683287839428,HUM 4,A01,185938,Zroka; Amy Liane,31,0,50,19
1683287839428,HUM 4,B01,185956,Watkins; Eric,0,2,50,50
1683287839428,HUM 4,B02,202209,Watkins; Eric,0,1,50,50
1683287839428,HUM 4,B03,202210,Watkins; Eric,0,0,50,50
1683287840456,HUM 5,A01,185958,West; Geoffrey Scott,5,0,50,45
1683287840456,HUM 5,A02,202215,West; Geoffrey Scott,0,0,50,50
1683287841486,INTL 190,A00,185959,Gagnon; Jeffrey C,0,0,0,9
1683287841486,INTL 190,B00,185960,Lettieri; Michael Joseph,0,0,0,1
1683287842514,JAPN 180,A00,254509,Staff,0,1,25,25
1683287843541,LATI 10,A01,202853,Kennemore; Amy Michelle,5,0,35,30
1683287843541,LATI 10,A02,202854,Kennemore; Amy Michelle,1,0,35,34
1683287843541,LATI 10,A03,270054,Kennemore; Amy Michelle,30,0,30,0
1683287844570,LATI 180,A00,202855,Kennemore; Amy Michelle,11,0,20,9
1683287845601,LAWS 101,A00,201767,Golan; Tal,0,7,40,40
1683287846630,LIFR 1C,A00,185961,Staff,6,0,20,14
1683287847657,LIFR 1CX,A00,185962,Staff,7,0,20,13
1683287848684,LIFR 1D,A00,185963,Staff,9,0,20,11
1683287849710,LIFR 1DX,A00,185964,Staff,9,0,20,11
1683287850738,LIGN 101,A01,186039,Staff,43,0,50,7
1683287851766,LIGN 165,A00,186040,Staff,18,0,50,32
1683287852791,LTCS 108,A00,186041,Staff,6,0,10,4
1683287853817,LTCS 119,A00,186042,Staff,16,0,20,4
1683287854843,LTCS 130,A00,186043,Wesling; Megan E.,15,0,25,10
1683287856907,LTEA 138,A00,186119,Staff,14,0,40,26
1683287857939,LTEN 124,A00,186148,Staff,6,0,25,19
1683287858969,LTEN 178,A00,186149,Staff,7,0,15,8
1683287859995,LTEN 181,A00,186150,Blanco; John D,33,0,40,7
1683287861022,LTWL 120,A00,186160,Staff,20,0,25,5
1683287862048,LTWL 165,A00,186161,Staff,22,0,25,3
1683287863072,LTWR 100,A00,186162,Staff,0,4,15,15
1683287864101,LTWR 102,A00,186163,Doller; Ben,5,0,15,10
1683287865126,MAE 8,A01,186412,Staff,0,0,0,0
1683287866153,MAE 30B,A00,186445,Bahadori; Mohammad Yousef,83,0,100,17
1683287867180,MAE 40,A00,186592,Bewley; Thomas R,9,0,50,41
1683287868211,MAE 101B,A00,186593,Bahadori; Mohammad Yousef,81,0,100,19
1683287869240,MAE 105,A00,186594,Bandaru; Prabhakar,12,0,50,38
1683287870272,MAE 107,A00,186599,Pham; Hieu Tan,0,6,120,120
1683287871298,MAE 148,A01,186660,Silberman; Jack,3,0,16,13
1683287872326,MATH 10A,A01,188095,Staff,0,7,35,35
1683287873354,MATH 10B,A01,188097,Bowers; Adam R.,0,11,30,30
1683287873354,MATH 10B,A02,188099,Bowers; Adam R.,0,9,30,30
1683287873354,MATH 10B,B01,188104,Bowers; Adam R.,0,11,30,30
1683287873354,MATH 10B,B02,188106,Bowers; Adam R.,0,11,30,30
1683287874382,MATH 10C,A01,188111,Staff,0,18,30,30
1683287874382,MATH 10C,A02,188127,Staff,0,17,30,30
1683287874382,MATH 10C,A03,188131,Staff,0,17,30,30
1683287874382,MATH 10C,B01,188218,Staff,21,0,30,9
1683287874382,MATH 10C,B02,188244,Staff,13,0,30,17
1683287874382,MATH 10C,B03,188277,Staff,16,0,30,14
1683287875411,MATH 18,A01,188344,Bach; Quang Tran,18,0,30,12
1683287875411,MATH 18,A02,188345,Bach; Quang Tran,11,0,30,19
1683287875411,MATH 18,B01,188353,Bach; Quang Tran,10,0,30,20
1683287875411,MATH 18,B02,188354,Bach; Quang Tran,20,0,30,10
1683287876441,MATH 20A,A01,188374,Staff,13,0,35,22
1683287877469,MATH 20B,A01,188382,Ohm; Ko Woon,6,0,30,24
1683287877469,MATH 20B,A02,188383,Ohm; Ko Woon,24,0,30,6
1683287877469,MATH 20B,B01,188385,Ohm; Ko Woon,7,0,30,23
1683287877469,MATH 20B,B02,188392,Ohm; Ko Woon,22,0,30,8
1683287878503,MATH 20C,A01,188394,Harel; Guershon,10,0,30,20
1683287878503,MATH 20C,A02,188395,Harel; Guershon,13,0,30,17
1683287878503,MATH 20C,B01,188404,Harel; Guershon,3,0,30,27
1683287878503,MATH 20C,B02,188405,Harel; Guershon,19,0,30,11
1683287879536,MATH 20D,A01,188414,Hammock; Frances H,0,1,30,30
1683287879536,MATH 20D,A02,188415,Hammock; Frances H,4,0,30,26
1683287879536,MATH 20D,B01,188447,Hammock; Frances H,2,0,30,28
1683287879536,MATH 20D,B02,188486,Hammock; Frances H,8,0,30,22
1683287880565,MATH 20E,A01,188649,Staff,22,0,30,8
1683287880565,MATH 20E,A02,188650,Staff,23,0,30,7
1683287880565,MATH 20E,A03,188673,Staff,0,0,30,30
1683287881599,MATH 102,A01,188675,Staff,0,35,35,35
1683287882629,MATH 103B,A01,188681,Staff,4,0,35,31
1683287882629,MATH 103B,B01,188692,Staff,8,0,35,27
1683287883658,MATH 109,A01,188695,Salehi Golsefidy; Alireza,25,0,35,10
1683287883658,MATH 109,A02,188696,Salehi Golsefidy; Alireza,27,0,35,8
1683287884689,MATH 120A,A01,188698,Eggers; John Dietrich,5,0,35,30
1683287885727,MATH 142B,A01,188736,Ioana; Adrian,0,2,30,30
1683287885727,MATH 142B,A02,188741,Ioana; Adrian,0,1,30,30
1683287885727,MATH 142B,A03,188743,Ioana; Adrian,0,3,30,30
1683287886758,MATH 168A,A01,188790,Staff,0,8,35,35
1683287887786,MATH 170A,A01,188803,Nie; Jiawang,0,2,35,35
1683287887786,MATH 170A,A02,188811,Nie; Jiawang,0,0,35,35
1683287887786,MATH 170A,A03,188814,Nie; Jiawang,1,0,35,34
1683287887786,MATH 170A,A04,188815,Nie; Jiawang,14,0,35,21
1683287888813,MATH 193B,A01,188817,Staff,0,0,35,35
1683287888813,MATH 193B,A02,188818,Staff,5,0,35,30
1683287889839,MGT 4,A01,202857,Anderson; John Charles,62,0,80,18
1683287890865,MGT 12,A00,202858,Lindenberger; Wade Douglas,43,0,90,47
1683287891892,MGT 18,A00,202859,Staff,74,0,90,16
1683287892918,MGT 18GS,A00,202860,McKay; Michael J,13,0,28,15
1683287893943,MGT 45,A00,202861,Pecore; Joseph P.,14,0,90,76
1683287894969,MGT 100,A00,202863,Yavorsky; Daniel Ryan,28,0,90,62
1683287895995,MGT 103,A00,202864,Ehrich; Kristine R,0,16,90,90
1683287897025,MGT 112,A00,202865,Ehrich; Kristine R,15,0,90,75
1683287898056,MGT 121A,A00,202868,Staff,0,19,0,0
1683287899081,MGT 131B,A00,202869,Anderson; John Charles,60,0,90,30
1683287900105,MGT 136,A00,202871,Lindenberger; Wade Douglas,84,0,90,6
1683287901135,MGT 164,A00,202873,Staff,0,69,90,90
1683287902163,MGT 164GS,A00,202874,McKay; Mary A,13,0,28,15
1683287903193,MGT 180,A00,202875,Staff,0,51,90,90
1683287904219,MMW 11R,A01,205019,Herbst; Matthew,3,0,30,27
1683287904219,MMW 11R,A02,205026,Herbst; Matthew,29,0,30,1
1683287905250,MMW 15,A01,193512,Chang; Edmond Yi-Teh,0,9,28,28
1683287905250,MMW 15,A02,193513,Chang; Edmond Yi-Teh,0,5,28,28
1683287905250,MMW 15,A03,193514,Chang; Edmond Yi-Teh,0,5,28,28
1683287905250,MMW 15,A04,193515,Chang; Edmond Yi-Teh,0,4,28,28
1683287905250,MMW 15,A05,193516,Chang; Edmond Yi-Teh,0,4,28,28
1683287905250,MMW 15,A06,193517,Chang; Edmond Yi-Teh,0,5,28,28
1683287905250,MMW 15,B01,193519,Chang; Edmond Yi-Teh,0,4,28,28
1683287905250,MMW 15,B02,193520,Chang; Edmond Yi-Teh,0,5,28,28
1683287905250,MMW 15,B03,193521,Chang; Edmond Yi-Teh,0,4,28,28
1683287905250,MMW 15,B04,193522,Chang; Edmond Yi-Teh,0,4,28,28
1683287905250,MMW 15,B05,193523,Chang; Edmond Yi-Teh,0,5,28,28
1683287905250,MMW 15,B06,193524,Chang; Edmond Yi-Teh,0,4,28,28
1683287906282,MMW 122,A01,193526,Rahimi; Babak,0,14,28,28
1683287906282,MMW 122,A02,193527,Rahimi; Babak,0,14,28,28
1683287906282,MMW 122,A03,193528,Rahimi; Babak,0,0,0,0
1683287906282,MMW 122,A04,193529,Rahimi; Babak,0,0,0,0
1683287907308,MUS 1A,A01,186663,Staff,0,20,35,35
1683287908336,MUS 4,A01,186715,Staff,0,12,35,35
1683287909367,MUS 5R,A01,186796,Dubnov; Shlomo,0,16,35,35
1683287910397,MUS 6,A01,186798,Staff,0,3,25,25
1683287911422,MUS 7,A01,186830,Staff,12,0,35,23
1683287912448,MUS 8,A01,186930,Staff,0,25,35,35
1683287913479,MUS 15,A01,186932,Staff,0,15,35,35
1683287913479,MUS 15,B01,186934,Staff,0,14,35,35
1683287914508,MUS 80,A00,186935,Staff,2,0,20,18
1683287914508,MUS 80,B00,186936,Staff,25,0,25,0
1683287915540,NANO 11,A00,204702,Lipomi; Darren John,0,0,0,0
1683287916568,NANO 15,A01,204709,Yang; Kesong,0,1,0,0
1683287917597,NANO 114,A00,202069,Jahed Motlagh; Zeinab,3,0,10,7
1683287918626,PHIL 1,A00,186955,Grush; Rick Scott,32,0,40,8
1683287919654,PHIL 10,A01,186973,Grush; Rick Scott,29,0,35,6
1683287919654,PHIL 10,A02,186974,Grush; Rick Scott,33,0,35,2
1683287920683,PHIL 13,A01,186976,Staff,7,0,35,28
1683287920683,PHIL 13,A02,186977,Staff,16,0,35,19
1683287921712,PHIL 14,A01,186979,Staff,31,0,35,4
1683287921712,PHIL 14,A02,186986,Staff,32,0,35,3
1683287922741,PHIL 28,A01,186988,Staff,16,0,30,14
1683287922741,PHIL 28,A02,186989,Staff,1,0,30,29
1683287922741,PHIL 28,A03,186990,Staff,9,0,30,21
1683287922741,PHIL 28,A04,186991,Staff,26,0,30,4
1683287923771,PHIL 120,A00,186997,Staff,23,0,40,17
1683287924801,PHIL 137,A00,187003,Staff,9,0,40,31
1683287925828,PHIL 150,A00,187015,Staff,47,0,70,23
1683287926854,PHIL 167,A00,187021,Lamey; Andy M.,35,0,40,5
1683287927881,PHIL 174,A01,202226,Staff,17,0,20,3
1683287927881,PHIL 174,A02,202235,Staff,20,0,20,0
1683287928963,PHIL 191A,A00,258918,Staff,0,0,1,1
1683287929994,PHYS 1A,A00,187028,Staff,26,0,60,34
1683287931026,PHYS 1AL,001,187036,Staff,2,0,30,28
1683287931026,PHYS 1AL,002,187049,Staff,18,0,30,12
1683287932061,PHYS 1B,A00,187058,Staff,23,0,60,37
1683287933088,PHYS 1BL,001,187064,Staff,0,0,30,30
1683287933088,PHYS 1BL,002,187070,Staff,6,0,30,24
1683287934115,PHYS 1C,A00,187082,Staff,32,0,120,88
1683287935143,PHYS 1CL,001,187088,Staff,0,9,30,30
1683287935143,PHYS 1CL,002,187089,Staff,0,2,30,30
1683287935143,PHYS 1CL,009,262693,Staff,12,0,30,18
1683287936173,PHYS 2B,A01,187097,Staff,54,0,115,61
1683287937204,PHYS 2C,A01,187099,Staff,67,0,115,48
1683287938228,PHYS 2CL,A01,187101,Staff,5,0,28,23
1683287938228,PHYS 2CL,A02,187102,Staff,15,0,28,13
1683287939258,PHYS 2D,A01,187123,Shotwell; Brian,95,0,115,20
1683287940289,PHYS 4B,A01,187133,Grinstein; Benjamin,35,0,50,15
1683287941327,POLI 10,A00,188819,Staff,0,3,50,50
1683287942356,POLI 11,A00,188827,Staff,43,0,50,7
1683287943381,POLI 13R,A00,188828,Staff,0,1,20,20
1683287944408,POLI 27,A01,188830,Elgin; Samuel Zincke,0,1,70,70
1683287945434,POLI 30,A00,188832,Desposato; Scott,33,0,50,17
1683287946464,POLI 102F,A00,188834,Staff,3,0,40,37
1683287947493,POLI 104A,A00,188852,Staff,14,0,30,16
1683287948522,POLI 104I,A00,188853,Staff,0,6,20,20
1683287949548,POLI 110B,A00,188854,Wiens; David,7,0,20,13
1683287950577,POLI 112A,A00,188855,Wiens; David,5,0,30,25
1683287951602,POLI 117R,A00,188856,Forman; Fonna,0,11,20,20
1683287952628,POLI 118,A00,188857,Ingham; Sean,8,0,20,12
1683287953656,POLI 120G,A00,188858,Staff,9,0,30,21
1683287954687,POLI 131CR,A00,188863,Hoston; Germaine,24,0,50,26
1683287955713,POLI 133,A00,188864,Nellis; Gareth Hb,44,0,50,6
1683287956740,POLI 134D,A00,188865,Desposato; Scott,27,0,30,3
1683287957766,POLI 142A,A00,188871,Gartzke; Erik,22,0,50,28
1683287958794,POLI 142K,A00,188874,Staff,38,0,50,12
1683287959823,POLI 143,A00,188940,Gartzke; Erik,16,0,30,14
1683287960851,POLI 153,A00,188943,Staff,3,0,20,17
1683287961876,POLI 160AA,A00,188944,Staff,13,0,40,27
1683287962902,POLI 170A,A00,188945,Staff,11,0,30,19
1683287964957,PSYC 1,A00,188952,Staff,38,0,90,52
1683287965987,PSYC 2,B00,188953,Staff,20,0,35,15
1683287967014,PSYC 6,A00,188970,Staff,47,0,60,13
1683287968043,PSYC 7,A00,188973,Staff,37,0,45,8
1683287969069,PSYC 60,A01,188980,Rickard; Timothy C.,43,0,60,17
1683287970093,PSYC 70,A01,189001,Steiner; Eric Tomas,24,0,45,21
1683287971120,PSYC 100,A00,189005,Lacefield; Katharine I,0,99,120,120
1683287972147,PSYC 102,A00,189008,Staff,10,0,30,20
1683287973180,PSYC 106,B00,189026,Gorman; Michael R.,37,0,60,23
1683287974209,PSYC 114,B01,189033,Winkielman; Piotr,0,32,30,30
1683287975237,PSYC 131,A00,189036,Anagnostaras; Stephan,0,43,60,60
1683287976262,PSYC 136,A00,189041,Lowe; Angela Beth,0,7,25,25
1683287977290,PSYC 137,A00,189057,Winkielman; Piotr,0,34,25,25
1683287978317,PSYC 144,A00,189107,Wixted; John T,0,7,50,50
1683287980373,PSYC 162,A00,189142,Staff,0,8,85,85
1683287981398,PSYC 172,A00,189144,Gorman; Michael R.,0,7,30,30
1683287983447,PSYC 179,A00,189146,Lacefield; Katharine I,0,84,120,120
1683287984472,PSYC 181,A00,189147,Anagnostaras; Stephan,0,44,90,90
1683287985499,PSYC 190R,A00,189148,Barner; David A.,0,22,80,80
1683287986525,PSYC 191,A00,189275,Rickard; Timothy C.,0,7,25,25
1683287987551,PSYC 193,A00,189276,Chapman; Eddie Nathaniel,0,1,0,4
1683287988581,PSYC 193L,A01,189281,Lowe; Angela Beth,12,0,20,8
1683287988581,PSYC 193L,B01,189285,Staff,28,0,35,7
1683287989610,RELI 149,A00,187137,Rahimi; Babak,7,0,40,33
1683287990641,SE 9,A01,187315,Staff,0,2,18,18
1683287991669,SE 101B,A00,187409,Staff,24,0,30,6
1683287992699,SE 110B,A00,187444,Staff,10,0,40,30
1683287993730,SE 130B,A00,187449,Staff,31,0,40,9
1683287994756,SE 150A,A00,187516,Staff,9,0,20,11
1683287995788,SE 154,A00,187528,Staff,30,0,50,20
1683287996823,SIO 3,A01,258171,Staff,35,0,40,5
1683287997849,SIO 10,A00,187144,Cook; Geoffrey W,0,3,75,75
1683287998879,SIO 45,A00,187152,Cook; Geoffrey W,1,0,100,99
1683287999906,SIO 109R,A00,194486,Staff,0,3,20,20
1683288001957,SIO 187,A01,187233,Kacev; David,12,0,40,28
1683288002985,SOCI 1,A01,258656,Thorpe; Charles Robert,28,0,30,2
1683288002985,SOCI 1,A02,258658,Thorpe; Charles Robert,30,0,30,0
1683288002985,SOCI 1,A03,258661,Thorpe; Charles Robert,25,0,25,0
1683288002985,SOCI 1,A04,258666,Thorpe; Charles Robert,22,0,25,3
1683288002985,SOCI 1,A05,258897,Thorpe; Charles Robert,23,0,25,2
1683288002985,SOCI 1,A06,258898,Thorpe; Charles Robert,25,0,25,0
1683288004011,SOCI 30,A01,258903,Pardo Guerra; Juan Pablo,16,0,30,14
1683288005037,SOCI 102,A00,258904,Staff,9,0,25,16
1683288006062,SOCI 106,A00,258905,Staff,19,0,25,6
1683288007089,SOCI 111,A00,258907,Ribas Norris; Janet Vanesa,26,0,30,4
1683288008115,SOCI 121R,A00,258908,Pardo Guerra; Juan Pablo,11,0,30,19
1683288009141,SOCI 126,A01,203330,Staff,14,0,20,6
1683288010166,SOCI 131,A00,258909,Thorpe; Charles Robert,31,0,60,29
1683288011192,SOCI 135,A00,258910,Payne; Christine Anna,0,9,30,30
1683288012221,SOCI 157,A00,258911,Staff,13,0,30,17
1683288013250,SOCI 184,A00,258912,Staff,26,0,30,4
1683288014275,SOCI 188D,A00,258913,Staff,21,0,30,9
1683288015301,SYN 2,001,187529,Staff,9,0,16,7
1683288015301,SYN 2,002,201452,Staff,0,18,16,16
1683288015301,SYN 2,003,201469,Staff,3,0,16,13
1683288016329,SYN 100,A01,187531,Staff,0,9,20,20
1683288016329,SYN 100,B01,201491,Staff,0,12,20,20
1683288017358,TDAC 1,A00,189286,Walsh; Kim C.,3,0,20,17
1683288017358,TDAC 1,B00,189287,Harting; Carla Kelso,11,0,20,9
1683288018385,TDAC 101,A00,189300,Walsh; Kim C.,16,0,20,4
1683288018385,TDAC 101,B00,189301,Harting; Carla Kelso,18,0,20,2
1683288019411,TDAC 102,A00,189304,Basso; Beatrice,14,0,20,6
1683288020437,TDAC 108,A00,189305,Staff,18,0,20,2
1683288021467,TDDE 131,A00,189310,Staff,19,0,20,1
1683288021467,TDDE 131,B00,189314,Staff,19,0,20,1
1683288021467,TDDE 131,C00,189315,Staff,48,0,50,2
1683288021467,TDDE 131,D00,189316,Staff,14,0,15,1
1683288021467,TDDE 131,E00,204841,Staff,20,0,20,0
1683288022496,TDGE 10,A00,189289,Staff,30,0,50,20
1683288022496,TDGE 10,B00,189290,Havis; Allan,2,0,50,48
1683288023523,TDGE 11,A00,189291,Fulton; Julia,0,3,50,50
1683288023523,TDGE 11,B00,189292,Staff,20,0,25,5
1683288023523,TDGE 11,C00,260270,Staff,0,0,0,0
1683288024549,TDGE 25,A00,189294,Staff,3,0,20,17
1683288025574,TDGE 124,A00,189318,Fulton; Julia,0,8,50,50
1683288026600,TDGE 125,A00,189319,Staff,13,0,25,12
1683288026600,TDGE 125,B00,189320,Staff,23,0,25,2
1683288027629,TDGE 127,A00,189322,Havis; Allan,0,0,50,50
1683288028655,TDHT 101,A00,189323,Staff,18,0,25,7
1683288028655,TDHT 101,B00,189324,Staff,25,0,25,0
1683288029685,TDHT 102,A00,189325,Staff,49,0,50,1
1683288030710,TDMV 1,A00,189295,Arcidiacono; Kristin,20,0,30,10
1683288030710,TDMV 1,B00,189296,Caligagan; Maria T.,24,0,30,6
1683288031737,TDMV 2,A00,189297,Sammartano; Tonnie,28,0,30,2
1683288031737,TDMV 2,B00,189299,Arcidiacono; Kristin,24,0,30,6
1683288032838,TDMV 3,A00,204998,Rincon; Alicia,22,0,30,8
1683288033863,TDMV 120,A00,189458,Sammartano; Tonnie,28,0,30,2
1683288034892,TDMV 138,A00,189541,Jun; Grace Shin Hae,22,0,40,18
1683288035917,TDMV 142,A00,189717,Caligagan; Tony,23,0,30,7
1683288035917,TDMV 142,B00,189718,Caligagan; Maria T.,25,0,30,5
1683288036943,TMC 2,A01,187533,Staff,25,0,25,0
1683288036943,TMC 2,A02,187534,Staff,25,0,25,0
1683288037973,USP 1,A01,187536,Kwak; Nancy,0,16,25,25
1683288039005,USP 5,A01,187538,Staff,9,0,25,16
1683288040033,USP 101,A00,199253,Staff,0,4,0,0
1683288041064,USP 124,A00,187562,Boomhower; Matthew Charles,1,0,30,29
1683288042091,USP 138,A00,187582,Staff,20,0,25,5
1683288043115,USP 152,A01,187597,Staff,4,0,25,21
1683288044145,USP 153,A00,187598,Staff,19,0,25,6
1683288045170,USP 168,A00,187607,Kwak; Nancy,2,0,5,3
1683288046199,USP 173,A00,187619,Staff,4,0,25,21
1683288047225,USP 181,A00,187638,Staff,0,0,25,25
1683288048251,VIS 103,A00,187650,Cruz; Edwin Teddy,23,0,75,52
1683288049279,VIS 110D,A00,187669,Staff,12,0,22,10
1683288050310,VIS 127C,A00,187720,Shen; Kuiyi,68,0,146,78
1683288051335,VIS 149,A00,187731,Yoldas; Pinar,0,14,22,22
1683288052359,VIS 151,A01,188091,Staff,22,0,34,12
1683288052359,VIS 151,A02,188092,Staff,11,0,34,23
1683288053385,VIS 160B,A00,188093,Stalbaum; Brett,0,0,10,10
1683288055443,WCWP 10B,A00,201720,Staff,10,0,15,5
1683288055443,WCWP 10B,B00,201722,Staff,8,0,15,7
1683288056472,WCWP 100,A00,201725,Gagnon; Jeffrey C,0,0,2,2
1683288056472,WCWP 100,B00,201727,Staff,0,4,15,15
1683288059656,ANBI 133,A00,258401,Wilder; Linnea Lorene,34,0,40,6
1683288060682,ANBI 140,A00,258395,Hrvoj Mihic; Branka,18,0,25,7
1683288061709,ANSC 120,A00,258402,Bialecki; Jon Anthony,27,0,40,13
1683288062736,ANSC 144,A00,258400,Staff,14,0,40,26
1683288064794,ANSC 166,A00,258396,Parish; Steven Martin,157,0,175,18
1683288065822,ANSC 180,A00,193533,Staff,9,0,20,11
1683288066852,ANSC 188,A00,258397,Jassal; Aftab,33,0,40,7
1683288067880,ANTH 3,A01,258316,Staff,23,0,30,7
1683288068917,ANTH 5,A00,258394,Semendeferi; Ekaterini,16,0,20,4
1683288069942,ANTH 21,A01,258331,Staff,9,0,40,31
1683288070967,ANTH 103,A00,258398,Varma; Saiba,15,0,25,10
1683288071997,AWP 10,001,202034,Staff,0,0,0,0
1683288071997,AWP 10,002,202035,Staff,0,0,0,0
1683288071997,AWP 10,003,202036,Staff,0,0,0,0
1683288071997,AWP 10,004,202037,Staff,0,0,0,0
1683288071997,AWP 10,005,202038,Staff,0,0,0,0
1683288071997,AWP 10,006,202039,Staff,0,0,0,0
1683288071997,AWP 10,007,202040,Staff,0,0,0,0
1683288071997,AWP 10,008,202041,Staff,0,0,0,0
1683288071997,AWP 10,009,202042,Staff,0,0,0,0
1683288071997,AWP 10,010,202043,Staff,0,0,0,0
1683288071997,AWP 10,011,202044,Staff,0,0,0,0
1683288071997,AWP 10,012,202045,Staff,0,0,0,0
1683288071997,AWP 10,013,202046,Staff,0,0,0,0
1683288071997,AWP 10,014,202047,Staff,0,0,0,0
1683288071997,AWP 10,015,202048,Staff,0,0,0,0
1683288071997,AWP 10,016,202049,Staff,0,0,0,0
1683288071997,AWP 10,017,202050,Staff,0,0,0,0
1683288071997,AWP 10,018,202051,Staff,0,0,0,0
1683288071997,AWP 10,019,202052,Staff,0,0,0,0
1683288071997,AWP 10,020,202053,Staff,0,0,0,0
1683288071997,AWP 10,021,202054,Staff,0,0,0,0
1683288071997,AWP 10,022,202055,Staff,0,0,0,0
1683288071997,AWP 10,023,202056,Staff,0,0,0,0
1683288071997,AWP 10,024,202057,Staff,0,0,0,0
1683288071997,AWP 10,025,202058,Staff,0,0,0,0
1683288071997,AWP 10,026,202059,Staff,0,0,0,0
1683288073023,AWP 102,001,202032,Staff,0,0,0,0
1683288073023,AWP 102,002,202033,Staff,0,0,0,0
1683288074048,BENG 100,A01,254234,Taylor Amos; Alyssa C,31,0,40,9
1683288075074,BENG 196,001,270013,Engler; Adam J.,9999,0,9999,0
1683288076101,BICD 100R,A01,202018,Smith; Laurie,0,7,32,32
1683288076101,BICD 100R,A02,202019,Smith; Laurie,0,2,32,32
1683288076101,BICD 100R,A03,202020,Smith; Laurie,0,1,32,32
1683288076101,BICD 100R,A04,202021,Smith; Laurie,8,0,32,24
1683288076101,BICD 100R,A05,202022,Smith; Laurie,12,0,32,20
1683288077134,BICD 136,A01,193242,Gustafson-Brown; Cindy,0,2,32,32
1683288077134,BICD 136,A02,193244,Gustafson-Brown; Cindy,15,0,32,17
1683288078166,BIEB 102,A01,193249,Butler; Shannon Rhey,0,2,32,32
1683288078166,BIEB 102,A02,193251,Butler; Shannon Rhey,0,0,32,32
1683288078166,BIEB 102,A03,193253,Butler; Shannon Rhey,0,1,32,32
1683288078166,BIEB 102,A04,193255,Butler; Shannon Rhey,17,0,32,15
1683288078166,BIEB 102,A05,193265,Butler; Shannon Rhey,26,0,32,6
1683288078166,BIEB 102,A06,193269,Butler; Shannon Rhey,16,0,32,16
1683288080219,BIEB 150,A01,193274,Staff,0,0,32,32
1683288080219,BIEB 150,A02,193285,Staff,24,0,32,8
1683288081245,BIEB 194,A00,193286,Kurle; Carolyn M.,22,0,32,10
1683288082270,BILD 1,A01,192291,Staff,16,0,32,16
1683288082270,BILD 1,A02,192292,Staff,30,0,32,2
1683288082270,BILD 1,B01,192520,Reuther; Keefe,0,1,0,0
1683288082270,BILD 1,B02,192532,Reuther; Keefe,0,1,0,0
1683288083298,BILD 3,A01,192556,Butler; Shannon Rhey,0,0,32,32
1683288083298,BILD 3,A02,192581,Butler; Shannon Rhey,5,0,32,27
1683288083298,BILD 3,A03,192611,Butler; Shannon Rhey,23,0,32,9
1683288083298,BILD 3,A04,192612,Butler; Shannon Rhey,25,0,32,7
1683288083298,BILD 3,A05,192613,Butler; Shannon Rhey,27,0,32,5
1683288083298,BILD 3,A06,192679,Butler; Shannon Rhey,27,0,32,5
1683288083298,BILD 3,A07,192682,Butler; Shannon Rhey,22,0,32,10
1683288084325,BILD 4,A01,192836,Reuther; Keefe,1,0,24,23
1683288084325,BILD 4,A02,193044,Reuther; Keefe,4,0,24,20
1683288085356,BILD 10,A01,193142,Gustafson-Brown; Cindy,31,0,32,1
1683288085356,BILD 10,A02,193149,Gustafson-Brown; Cindy,31,0,32,1
1683288086386,BIMM 100,A01,193301,Staff,0,6,32,32
1683288086386,BIMM 100,A02,193312,Staff,0,5,32,32
1683288086386,BIMM 100,A03,193323,Staff,0,8,32,32
1683288087419,BIMM 101,A01,193329,McDonnell; Lisa Marie,0,3,24,24
1683288087419,BIMM 101,A02,193339,McDonnell; Lisa Marie,0,2,24,24
1683288087419,BIMM 101,B01,193354,McDonnell; Lisa Marie,0,3,24,24
1683288087419,BIMM 101,B02,193357,McDonnell; Lisa Marie,0,3,24,24
1683288088446,BIMM 110,A01,193377,Tat; John,0,11,32,32
1683288088446,BIMM 110,A02,193378,Tat; John,1,9,32,31
1683288089473,BIMM 120,A01,206116,Staff,0,0,32,32
1683288089473,BIMM 120,A02,206117,Staff,8,0,32,24
1683288089473,BIMM 120,A03,206121,Staff,21,0,32,11
1683288090504,BIPN 100,A01,193393,Park; Ji Young,0,14,32,32
1683288090504,BIPN 100,A02,193402,Park; Ji Young,0,12,32,32
1683288090504,BIPN 100,A03,193413,Park; Ji Young,0,14,32,32
1683288090504,BIPN 100,A04,193414,Park; Ji Young,0,13,32,32
1683288091532,BIPN 102,A01,193429,Staff,0,0,32,32
1683288091532,BIPN 102,A02,193438,Staff,23,0,32,9
1683288092561,BIPN 106,A01,193450,Reyes Gonzalez; Catalina,0,2,40,40
1683288093592,BIPN 134,A01,193465,Cooke; James Edward,0,0,32,32
1683288093592,BIPN 134,A02,193474,Cooke; James Edward,27,0,32,5
1683288093592,BIPN 134,A03,193485,Cooke; James Edward,29,0,32,3
1683288093592,BIPN 134,A04,193486,Cooke; James Edward,21,0,32,11
1683288093592,BIPN 134,A05,193491,Cooke; James Edward,31,0,32,1
1683288093592,BIPN 134,A06,193501,Cooke; James Edward,30,0,32,2
1683288093592,BIPN 134,A07,193510,Cooke; James Edward,29,0,32,3
1683288095647,BISP 194,A00,222522,Staff,16,0,32,16
1683288096675,CAT 124,A01,202407,Staff,20,0,25,5
1683288097706,CAT 125,A00,202408,Marchisotto; Jennifer Anne,4,0,20,16
1683288098739,CAT 125R,A00,202409,Smith; Lauryn Alissa,0,11,20,20
1683288098739,CAT 125R,B00,202410,Morales; Celeste Georgianna,0,11,20,20
1683288098739,CAT 125R,C00,202411,Irwin; Matthew Joseph,0,10,20,20
1683288099766,CENG 15,A01,204712,Yang; Kesong,0,1,0,0
1683288100791,CENG 114,A00,202070,Jahed Motlagh; Zeinab,5,0,20,15
1683288101821,CGS 105,A00,185477,Wesling; Megan E.,24,0,40,16
1683288102848,CGS 106,A00,185494,Staff,13,0,22,9
1683288103878,CGS 108,A00,185495,Staff,14,0,20,6
1683288104907,CGS 114,A00,185496,Staff,13,0,18,5
1683288105934,CGS 119,A00,185501,Staff,15,0,20,5
1683288106960,CGS 120,A00,185511,Staff,13,0,20,7
1683288107992,CHEM 4,A01,184675,Bussey; Thomas J,96,0,100,4
1683288109022,CHEM 6A,A01,184677,Staff,35,0,60,25
1683288110049,CHEM 6B,A01,184679,Staff,65,0,100,35
1683288111075,CHEM 6C,A01,184681,Bussey; Thomas J,1,0,50,49
1683288111075,CHEM 6C,A02,184682,Bussey; Thomas J,34,0,50,16
1683288112103,CHEM 40A,A01,184684,Albizati; Kim F.,37,0,100,63
1683288113129,CHEM 40B,A01,184686,Albizati; Kim F.,0,20,100,100
1683288114157,CHEM 41B,A01,184690,Staff,52,0,100,48
1683288115186,COGS 3,A01,184715,Boyle; Mary E. T.,0,25,40,40
1683288116211,COGS 14B,A01,185172,Staff,0,15,38,38
1683288117236,COGS 18,A01,184736,Staff,20,0,80,60
1683288118264,COGS 100,A01,184932,Staff,0,5,73,73
1683288119292,COGS 101A,A01,184935,Staff,0,38,30,30
1683288120316,COGS 101B,A01,184944,Staff,0,2,30,30
1683288121342,COGS 101C,A01,184946,Staff,0,12,30,30
1683288122369,COGS 102A,A01,184951,Johnson; Christine M.,2,0,40,38
1683288123399,COGS 107B,A01,184953,Mooshagian; Eric Frederick,0,50,40,40
1683288124424,COGS 118B,A01,184959,Gupta; Anjum,0,48,40,40
1683288125450,COGS 153,A00,184961,Staff,0,15,30,30
1683288126479,COGS 177,A00,184962,Staff,0,21,30,30
1683288127508,COGS 187A,A01,184969,Boyle; Mary E. T.,0,17,40,40
1683288128535,COMM 10,A01,185174,Staff,0,5,25,25
1683288128535,COMM 10,A02,185189,Staff,0,5,25,25
1683288128535,COMM 10,A03,269821,Staff,0,0,0,0
1683288129564,COMM 100B,A01,185475,Staff,0,0,0,2
1683288129564,COMM 100B,A02,185476,Staff,14,0,25,11
1683288130590,COMM 100C,A01,185314,Staff,1,0,25,24
1683288130590,COMM 100C,A02,185327,Staff,19,0,25,6
1683288131615,COMM 110M,A00,185349,Staff,2,0,40,38
1683288132643,COMM 113T,A00,185352,Staff,25,0,40,15
1683288133668,COMM 114I,A00,185353,Staff,33,0,40,7
1683288134698,COMM 131,A00,185354,Staff,19,0,30,11
1683288135727,CSE 8A,A50,185358,Cao; Yingjun,0,46,10,10
1683288136815,CSE 8B,A01,185362,Staff,0,47,50,50
1683288137843,CSE 11,A01,185416,Cao; Yingjun,0,93,10,10
1683288138869,CSE 20,A01,185445,Briones; Jor-el Thomas Caparas,5,0,25,20
1683288139896,CSE 21,A01,185447,Staff,10,0,50,40
1683288140923,CSE 101,A01,185451,Staff,0,12,50,50
1683288140923,CSE 101,B01,185453,Jones; Miles E,0,11,50,50
1683288142977,CSE 141,A01,185458,Eldon; John,20,0,100,80
1683288144004,CSE 141L,A01,185461,Eldon; John,12,0,100,88
1683288145029,CSE 142,A01,185463,Staff,35,0,60,25
1683288145029,CSE 142,B01,201355,Staff,0,6,60,60
1683288146059,CSE 142L,A01,185470,Staff,35,0,60,25
1683288146059,CSE 142L,B01,201417,Staff,0,5,60,60
1683288147087,CSE 190,A00,201433,Staff,32,0,49,17
1683288148116,DOC 1,A01,259136,Strom; Megan C.,8,0,15,7
1683288148116,DOC 1,A02,259137,Strom; Megan C.,14,0,15,1
1683288148116,DOC 1,A03,259138,Strom; Megan C.,14,0,15,1
1683288148116,DOC 1,A04,259139,Strom; Megan C.,14,0,15,1
1683288149142,DOC 100D,A00,259140,Pass; Natalye Joann,17,0,25,8
1683288150168,DSGN 1,A01,184749,Rill; Bryan,0,24,30,30
1683288151194,DSGN 100,A01,185168,Staff,0,2,25,25
1683288152221,ECE 5,A01,185626,Morris; Karcher William,0,10,0,0
1683288153247,ECE 101,A01,185628,Staff,17,0,70,53
1683288154273,ECE 107,A01,185635,Baghdadchi; Saharnaz,0,0,20,20
1683288154273,ECE 107,A02,185638,Baghdadchi; Saharnaz,4,0,20,16
1683288155302,ECE 148,A01,185647,Silberman; Jack,1,0,16,15
1683288156331,ECON 1,A01,185537,Crane; Meredith Helen,54,0,70,16
1683288157356,ECON 3,A01,185549,Crane; Meredith Helen,33,0,70,37
1683288158382,ECON 4,A01,203354,Anderson; John Charles,0,4,10,10
1683288159409,ECON 100A,A01,185574,Staff,0,4,40,40
1683288160438,ECON 100B,A01,185576,Staff,0,22,40,40
1683288161465,ECON 100C,A01,185589,Newhouse; Herbert S,30,0,70,40
1683288162491,ECON 105,A00,185608,Vespa; Emanuel Ignacio,19,0,35,16
1683288163519,ECON 109,A01,185610,Shishkin; Denis,10,0,35,25
1683288164547,ECON 110A,A01,185612,Staff,11,0,40,29
1683288165577,ECON 120A,A01,185615,Staff,20,0,40,20
1683288166605,ECON 120C,A01,185617,Sun; Yixiao,0,20,70,70
1683288167634,ECON 144,A00,203346,Squires; Dale E,3,0,35,32
1683288168661,ECON 171,A01,203349,Newhouse; Herbert S,0,1,35,35
1683288169687,ECON 173A,A01,185621,Toda; Alexis Akira,21,0,35,14
1683288170721,EDS 25,A01,202413,Staff,0,1,0,0
1683288170721,EDS 25,A02,202414,Staff,0,1,0,0
1683288170721,EDS 25,A03,202415,Staff,0,0,0,0
1683288170721,EDS 25,A04,202416,Staff,0,1,0,0
1683288170721,EDS 25,A05,202439,Staff,0,0,0,0
1683288170721,EDS 25,A06,202440,Staff,0,0,0,0
1683288170721,EDS 25,B01,202631,Staff,0,0,0,0
1683288170721,EDS 25,B02,202632,Staff,0,0,0,0
1683288170721,EDS 25,B03,202639,Staff,0,0,0,0
1683288170721,EDS 25,B04,202640,Staff,0,0,0,0
1683288170721,EDS 25,B05,202643,Staff,0,0,0,0
1683288170721,EDS 25,B06,202644,Staff,0,0,0,0
1683288171745,EDS 38,A01,202659,Black; Alison Michelle,24,0,25,1
1683288172770,EDS 115,A00,202652,Staff,17,0,30,13
1683288173797,EDS 125,A00,202649,Staff,14,0,30,16
1683288174824,EDS 126,A01,203332,Staff,30,0,30,0
1683288175848,EDS 139,A00,202838,Staff,17,0,25,8
1683288176874,EDS 146,A01,202655,Staff,15,0,25,10
1683288177903,ENG 15,A00,185667,Staff,0,1,0,0
1683288177903,ENG 15,B00,185672,Staff,0,0,0,0
1683288177903,ENG 15,C00,185675,Staff,0,0,0,0
1683288177903,ENG 15,D00,185682,Staff,0,0,0,0
1683288177903,ENG 15,E00,185684,Staff,0,0,0,0
1683288178943,ETHN 103,A00,185710,Staff,0,3,35,35
1683288179968,ETHN 103A,A00,199228,Man; Simeon S,3,0,9,6
1683288180994,ETHN 109,A00,185711,Staff,18,0,35,17
1683288182018,ETHN 142,A00,185726,Staff,0,4,30,30
1683288183045,ETHN 163J,A00,199229,Man; Simeon S,6,0,8,2
1683288184074,ETHN 168,A00,185727,Staff,8,0,10,2
1683288185101,ETHN 182,A00,185728,Staff,1,0,35,34
1683288186126,ETHN 183,A00,185737,Staff,8,0,18,10
1683288187156,GLBH 111,A01,209361,Burgos; Jose L.,0,0,0,0
1683288189214,HIEU 104,A00,185792,Staff,16,0,20,4
1683288190243,HIEU 115,A00,185800,Staff,1,0,20,19
1683288191270,HIEU 128,A00,185801,Staff,0,7,20,20
1683288192295,HIEU 147,A00,185802,Staff,16,0,20,4
1683288193323,HIEU 154,A00,185823,Staff,12,0,20,8
1683288194349,HILA 102,A00,185826,Staff,13,0,20,7
1683288195379,HILD 2C,A01,185778,Staff,0,12,20,20
1683288196406,HILD 7B,A01,185780,Kwak; Nancy,0,15,32,32
1683288196406,HILD 7B,A02,185781,Kwak; Nancy,0,18,32,32
1683288197432,HILD 30,A01,185791,Staff,14,0,20,6
1683288198461,HISC 119,A00,185830,Golan; Tal,0,9,20,20
1683288199490,HITO 156GS,A00,185831,Patterson; Patrick H.,0,0,0,23
1683288200517,HIUS 103,A00,185832,Man; Simeon S,0,7,20,20
1683288201547,HIUS 117,A00,185836,Kwak; Nancy,2,0,20,18
1683288202573,HIUS 125,A00,185840,Man; Simeon S,0,0,23,23
1683288203600,HIUS 149,A00,185845,Staff,0,0,20,20
1683288204627,HUM 3,A01,185882,Zavodny; Tatiana Sophia,0,6,50,50
1683288204627,HUM 3,B01,185899,Caldwell; Michael Alan,0,19,50,50
1683288205656,HUM 3GS,A00,185900,Patterson; Patrick H.,0,0,0,23
1683288206682,HUM 4,A01,185938,Zroka; Amy Liane,31,0,50,19
1683288206682,HUM 4,B01,185956,Watkins; Eric,0,2,50,50
1683288206682,HUM 4,B02,202209,Watkins; Eric,0,1,50,50
1683288206682,HUM 4,B03,202210,Watkins; Eric,0,0,50,50
1683288207708,HUM 5,A01,185958,West; Geoffrey Scott,5,0,50,45
1683288207708,HUM 5,A02,202215,West; Geoffrey Scott,0,0,50,50
1683288208737,INTL 190,A00,185959,Gagnon; Jeffrey C,0,0,0,9
1683288208737,INTL 190,B00,185960,Lettieri; Michael Joseph,0,0,0,1
1683288209763,JAPN 180,A00,254509,Staff,0,1,25,25
1683288210789,LATI 10,A01,202853,Kennemore; Amy Michelle,5,0,35,30
1683288210789,LATI 10,A02,202854,Kennemore; Amy Michelle,1,0,35,34
1683288210789,LATI 10,A03,270054,Kennemore; Amy Michelle,30,0,30,0
1683288211814,LATI 180,A00,202855,Kennemore; Amy Michelle,11,0,20,9
1683288212843,LAWS 101,A00,201767,Golan; Tal,0,7,40,40
1683288213872,LIFR 1C,A00,185961,Staff,6,0,20,14
1683288214899,LIFR 1CX,A00,185962,Staff,7,0,20,13
1683288215925,LIFR 1D,A00,185963,Staff,9,0,20,11
1683288216950,LIFR 1DX,A00,185964,Staff,9,0,20,11
1683288217980,LIGN 101,A01,186039,Staff,43,0,50,7
1683288219007,LIGN 165,A00,186040,Staff,18,0,50,32
1683288220036,LTCS 108,A00,186041,Staff,6,0,10,4
1683288221064,LTCS 119,A00,186042,Staff,16,0,20,4
1683288222094,LTCS 130,A00,186043,Wesling; Megan E.,15,0,25,10
1683288224149,LTEA 138,A00,186119,Staff,14,0,40,26
1683288225174,LTEN 124,A00,186148,Staff,6,0,25,19
1683288226202,LTEN 178,A00,186149,Staff,7,0,15,8
1683288227232,LTEN 181,A00,186150,Blanco; John D,33,0,40,7
1683288228257,LTWL 120,A00,186160,Staff,20,0,25,5
1683288229283,LTWL 165,A00,186161,Staff,22,0,25,3
1683288230309,LTWR 100,A00,186162,Staff,0,4,15,15
1683288231334,LTWR 102,A00,186163,Doller; Ben,5,0,15,10
1683288232358,MAE 8,A01,186412,Staff,0,0,0,0
1683288233387,MAE 30B,A00,186445,Bahadori; Mohammad Yousef,83,0,100,17
1683288234413,MAE 40,A00,186592,Bewley; Thomas R,9,0,50,41
1683288235436,MAE 101B,A00,186593,Bahadori; Mohammad Yousef,81,0,100,19
1683288236462,MAE 105,A00,186594,Bandaru; Prabhakar,12,0,50,38
1683288237491,MAE 107,A00,186599,Pham; Hieu Tan,0,6,120,120
1683288238520,MAE 148,A01,186660,Silberman; Jack,3,0,16,13
1683288239547,MATH 10A,A01,188095,Staff,0,7,35,35
1683288240634,MATH 10B,A01,188097,Bowers; Adam R.,0,11,30,30
1683288240634,MATH 10B,A02,188099,Bowers; Adam R.,0,9,30,30
1683288240634,MATH 10B,B01,188104,Bowers; Adam R.,0,11,30,30
1683288240634,MATH 10B,B02,188106,Bowers; Adam R.,0,11,30,30
1683288241662,MATH 10C,A01,188111,Staff,0,18,30,30
1683288241662,MATH 10C,A02,188127,Staff,0,17,30,30
1683288241662,MATH 10C,A03,188131,Staff,0,17,30,30
1683288241662,MATH 10C,B01,188218,Staff,21,0,30,9
1683288241662,MATH 10C,B02,188244,Staff,13,0,30,17
1683288241662,MATH 10C,B03,188277,Staff,16,0,30,14
1683288242693,MATH 18,A01,188344,Bach; Quang Tran,18,0,30,12
1683288242693,MATH 18,A02,188345,Bach; Quang Tran,11,0,30,19
1683288242693,MATH 18,B01,188353,Bach; Quang Tran,10,0,30,20
1683288242693,MATH 18,B02,188354,Bach; Quang Tran,20,0,30,10
1683288243719,MATH 20A,A01,188374,Staff,13,0,35,22
1683288244749,MATH 20B,A01,188382,Ohm; Ko Woon,6,0,30,24
1683288244749,MATH 20B,A02,188383,Ohm; Ko Woon,24,0,30,6
1683288244749,MATH 20B,B01,188385,Ohm; Ko Woon,7,0,30,23
1683288244749,MATH 20B,B02,188392,Ohm; Ko Woon,22,0,30,8
1683288245781,MATH 20C,A01,188394,Harel; Guershon,10,0,30,20
1683288245781,MATH 20C,A02,188395,Harel; Guershon,13,0,30,17
1683288245781,MATH 20C,B01,188404,Harel; Guershon,3,0,30,27
1683288245781,MATH 20C,B02,188405,Harel; Guershon,19,0,30,11
1683288246808,MATH 20D,A01,188414,Hammock; Frances H,0,1,30,30
1683288246808,MATH 20D,A02,188415,Hammock; Frances H,4,0,30,26
1683288246808,MATH 20D,B01,188447,Hammock; Frances H,2,0,30,28
1683288246808,MATH 20D,B02,188486,Hammock; Frances H,8,0,30,22
1683288247834,MATH 20E,A01,188649,Staff,22,0,30,8
1683288247834,MATH 20E,A02,188650,Staff,23,0,30,7
1683288247834,MATH 20E,A03,188673,Staff,0,0,30,30
1683288248860,MATH 102,A01,188675,Staff,0,35,35,35
1683288249890,MATH 103B,A01,188681,Staff,4,0,35,31
1683288249890,MATH 103B,B01,188692,Staff,8,0,35,27
1683288250919,MATH 109,A01,188695,Salehi Golsefidy; Alireza,25,0,35,10
1683288250919,MATH 109,A02,188696,Salehi Golsefidy; Alireza,27,0,35,8
1683288251945,MATH 120A,A01,188698,Eggers; John Dietrich,5,0,35,30
1683288252971,MATH 142B,A01,188736,Ioana; Adrian,0,2,30,30
1683288252971,MATH 142B,A02,188741,Ioana; Adrian,0,1,30,30
1683288252971,MATH 142B,A03,188743,Ioana; Adrian,0,3,30,30
1683288253996,MATH 168A,A01,188790,Staff,0,8,35,35
1683288255027,MATH 170A,A01,188803,Nie; Jiawang,0,2,35,35
1683288255027,MATH 170A,A02,188811,Nie; Jiawang,0,0,35,35
1683288255027,MATH 170A,A03,188814,Nie; Jiawang,1,0,35,34
1683288255027,MATH 170A,A04,188815,Nie; Jiawang,14,0,35,21
1683288256052,MATH 193B,A01,188817,Staff,0,0,35,35
1683288256052,MATH 193B,A02,188818,Staff,5,0,35,30
1683288257078,MGT 4,A01,202857,Anderson; John Charles,62,0,80,18
1683288258107,MGT 12,A00,202858,Lindenberger; Wade Douglas,43,0,90,47
1683288259135,MGT 18,A00,202859,Staff,74,0,90,16
1683288260160,MGT 18GS,A00,202860,McKay; Michael J,13,0,28,15
1683288261185,MGT 45,A00,202861,Pecore; Joseph P.,14,0,90,76
1683288262215,MGT 100,A00,202863,Yavorsky; Daniel Ryan,28,0,90,62
1683288263246,MGT 103,A00,202864,Ehrich; Kristine R,0,16,90,90
1683288264275,MGT 112,A00,202865,Ehrich; Kristine R,15,0,90,75
1683288265301,MGT 121A,A00,202868,Staff,0,19,0,0
1683288266326,MGT 131B,A00,202869,Anderson; John Charles,60,0,90,30
1683288267351,MGT 136,A00,202871,Lindenberger; Wade Douglas,84,0,90,6
1683288268374,MGT 164,A00,202873,Staff,0,69,90,90
1683288269402,MGT 164GS,A00,202874,McKay; Mary A,13,0,28,15
1683288270434,MGT 180,A00,202875,Staff,0,51,90,90
1683288271460,MMW 11R,A01,205019,Herbst; Matthew,3,0,30,27
1683288271460,MMW 11R,A02,205026,Herbst; Matthew,29,0,30,1
1683288272488,MMW 15,A01,193512,Chang; Edmond Yi-Teh,0,9,28,28
1683288272488,MMW 15,A02,193513,Chang; Edmond Yi-Teh,0,5,28,28
1683288272488,MMW 15,A03,193514,Chang; Edmond Yi-Teh,0,5,28,28
1683288272488,MMW 15,A04,193515,Chang; Edmond Yi-Teh,0,4,28,28
1683288272488,MMW 15,A05,193516,Chang; Edmond Yi-Teh,0,4,28,28
1683288272488,MMW 15,A06,193517,Chang; Edmond Yi-Teh,0,5,28,28
1683288272488,MMW 15,B01,193519,Chang; Edmond Yi-Teh,0,4,28,28
1683288272488,MMW 15,B02,193520,Chang; Edmond Yi-Teh,0,5,28,28
1683288272488,MMW 15,B03,193521,Chang; Edmond Yi-Teh,0,4,28,28
1683288272488,MMW 15,B04,193522,Chang; Edmond Yi-Teh,0,4,28,28
1683288272488,MMW 15,B05,193523,Chang; Edmond Yi-Teh,0,5,28,28
1683288272488,MMW 15,B06,193524,Chang; Edmond Yi-Teh,0,4,28,28
1683288273514,MMW 122,A01,193526,Rahimi; Babak,0,14,28,28
1683288273514,MMW 122,A02,193527,Rahimi; Babak,0,14,28,28
1683288273514,MMW 122,A03,193528,Rahimi; Babak,0,0,0,0
1683288273514,MMW 122,A04,193529,Rahimi; Babak,0,0,0,0
1683288274541,MUS 1A,A01,186663,Staff,0,20,35,35
1683288275570,MUS 4,A01,186715,Staff,0,12,35,35
1683288276596,MUS 5R,A01,186796,Dubnov; Shlomo,0,16,35,35
1683288277634,MUS 6,A01,186798,Staff,0,3,25,25
1683288278663,MUS 7,A01,186830,Staff,12,0,35,23
1683288279696,MUS 8,A01,186930,Staff,0,25,35,35
1683288280727,MUS 15,A01,186932,Staff,0,15,35,35
1683288280727,MUS 15,B01,186934,Staff,0,14,35,35
1683288281756,MUS 80,A00,186935,Staff,2,0,20,18
1683288281756,MUS 80,B00,186936,Staff,25,0,25,0
1683288282788,NANO 11,A00,204702,Lipomi; Darren John,0,0,0,0
1683288283815,NANO 15,A01,204709,Yang; Kesong,0,1,0,0
1683288284846,NANO 114,A00,202069,Jahed Motlagh; Zeinab,3,0,10,7
1683288285882,PHIL 1,A00,186955,Grush; Rick Scott,32,0,40,8
1683288286908,PHIL 10,A01,186973,Grush; Rick Scott,29,0,35,6
1683288286908,PHIL 10,A02,186974,Grush; Rick Scott,33,0,35,2
1683288287941,PHIL 13,A01,186976,Staff,7,0,35,28
1683288287941,PHIL 13,A02,186977,Staff,16,0,35,19
1683288288966,PHIL 14,A01,186979,Staff,31,0,35,4
1683288288966,PHIL 14,A02,186986,Staff,32,0,35,3
1683288289994,PHIL 28,A01,186988,Staff,16,0,30,14
1683288289994,PHIL 28,A02,186989,Staff,1,0,30,29
1683288289994,PHIL 28,A03,186990,Staff,9,0,30,21
1683288289994,PHIL 28,A04,186991,Staff,26,0,30,4
1683288291020,PHIL 120,A00,186997,Staff,23,0,40,17
1683288292049,PHIL 137,A00,187003,Staff,9,0,40,31
1683288293085,PHIL 150,A00,187015,Staff,47,0,70,23
1683288294115,PHIL 167,A00,187021,Lamey; Andy M.,35,0,40,5
1683288295142,PHIL 174,A01,202226,Staff,17,0,20,3
1683288295142,PHIL 174,A02,202235,Staff,20,0,20,0
1683288296171,PHIL 191A,A00,258918,Staff,0,0,1,1
1683288297203,PHYS 1A,A00,187028,Staff,26,0,60,34
1683288298233,PHYS 1AL,001,187036,Staff,2,0,30,28
1683288298233,PHYS 1AL,002,187049,Staff,18,0,30,12
1683288299259,PHYS 1B,A00,187058,Staff,23,0,60,37
1683288300303,PHYS 1BL,001,187064,Staff,0,0,30,30
1683288300303,PHYS 1BL,002,187070,Staff,6,0,30,24
1683288301329,PHYS 1C,A00,187082,Staff,32,0,120,88
1683288302355,PHYS 1CL,001,187088,Staff,0,9,30,30
1683288302355,PHYS 1CL,002,187089,Staff,0,2,30,30
1683288302355,PHYS 1CL,009,262693,Staff,12,0,30,18
1683288303381,PHYS 2B,A01,187097,Staff,54,0,115,61
1683288304411,PHYS 2C,A01,187099,Staff,67,0,115,48
1683288305440,PHYS 2CL,A01,187101,Staff,5,0,28,23
1683288305440,PHYS 2CL,A02,187102,Staff,15,0,28,13
1683288306470,PHYS 2D,A01,187123,Shotwell; Brian,95,0,115,20
1683288307497,PHYS 4B,A01,187133,Grinstein; Benjamin,35,0,50,15
1683288308524,POLI 10,A00,188819,Staff,0,3,50,50
1683288309557,POLI 11,A00,188827,Staff,43,0,50,7
1683288310584,POLI 13R,A00,188828,Staff,0,1,20,20
1683288311612,POLI 27,A01,188830,Elgin; Samuel Zincke,0,1,70,70
1683288312638,POLI 30,A00,188832,Desposato; Scott,33,0,50,17
1683288313667,POLI 102F,A00,188834,Staff,3,0,40,37
1683288314724,POLI 104A,A00,188852,Staff,14,0,30,16
1683288315749,POLI 104I,A00,188853,Staff,0,6,20,20
1683288316775,POLI 110B,A00,188854,Wiens; David,7,0,20,13
1683288317804,POLI 112A,A00,188855,Wiens; David,5,0,30,25
1683288318830,POLI 117R,A00,188856,Forman; Fonna,0,11,20,20
1683288319859,POLI 118,A00,188857,Ingham; Sean,8,0,20,12
1683288320887,POLI 120G,A00,188858,Staff,9,0,30,21
1683288321914,POLI 131CR,A00,188863,Hoston; Germaine,24,0,50,26
1683288322940,POLI 133,A00,188864,Nellis; Gareth Hb,44,0,50,6
1683288323970,POLI 134D,A00,188865,Desposato; Scott,27,0,30,3
1683288325006,POLI 142A,A00,188871,Gartzke; Erik,22,0,50,28
1683288326034,POLI 142K,A00,188874,Staff,38,0,50,12
1683288327059,POLI 143,A00,188940,Gartzke; Erik,16,0,30,14
1683288328088,POLI 153,A00,188943,Staff,3,0,20,17
1683288329114,POLI 160AA,A00,188944,Staff,13,0,40,27
1683288330141,POLI 170A,A00,188945,Staff,11,0,30,19
1683288332196,PSYC 1,A00,188952,Staff,38,0,90,52
1683288333222,PSYC 2,B00,188953,Staff,20,0,35,15
1683288334247,PSYC 6,A00,188970,Staff,47,0,60,13
1683288335276,PSYC 7,A00,188973,Staff,37,0,45,8
1683288336312,PSYC 60,A01,188980,Rickard; Timothy C.,43,0,60,17
1683288337342,PSYC 70,A01,189001,Steiner; Eric Tomas,24,0,45,21
1683288338371,PSYC 100,A00,189005,Lacefield; Katharine I,0,99,120,120
1683288339396,PSYC 102,A00,189008,Staff,10,0,30,20
1683288340421,PSYC 106,B00,189026,Gorman; Michael R.,37,0,60,23
1683288341451,PSYC 114,B01,189033,Winkielman; Piotr,0,32,30,30
1683288342477,PSYC 131,A00,189036,Anagnostaras; Stephan,0,43,60,60
1683288343504,PSYC 136,A00,189041,Lowe; Angela Beth,0,7,25,25
1683288344592,PSYC 137,A00,189057,Winkielman; Piotr,0,34,25,25
1683288345622,PSYC 144,A00,189107,Wixted; John T,0,7,50,50
1683288347676,PSYC 162,A00,189142,Staff,0,8,85,85
1683288348706,PSYC 172,A00,189144,Gorman; Michael R.,0,7,30,30
1683288350763,PSYC 179,A00,189146,Lacefield; Katharine I,0,84,120,120
1683288351790,PSYC 181,A00,189147,Anagnostaras; Stephan,0,44,90,90
1683288352824,PSYC 190R,A00,189148,Barner; David A.,0,22,80,80
1683288353850,PSYC 191,A00,189275,Rickard; Timothy C.,0,7,25,25
1683288354877,PSYC 193,A00,189276,Chapman; Eddie Nathaniel,0,1,0,4
1683288355918,PSYC 193L,A01,189281,Lowe; Angela Beth,12,0,20,8
1683288355918,PSYC 193L,B01,189285,Staff,28,0,35,7
1683288356949,RELI 149,A00,187137,Rahimi; Babak,7,0,40,33
1683288357975,SE 9,A01,187315,Staff,0,2,18,18
1683288359002,SE 101B,A00,187409,Staff,24,0,30,6
1683288360029,SE 110B,A00,187444,Staff,10,0,40,30
1683288361059,SE 130B,A00,187449,Staff,31,0,40,9
1683288362087,SE 150A,A00,187516,Staff,9,0,20,11
1683288363117,SE 154,A00,187528,Staff,30,0,50,20
1683288364147,SIO 3,A01,258171,Staff,35,0,40,5
1683288365174,SIO 10,A00,187144,Cook; Geoffrey W,0,3,75,75
1683288366202,SIO 45,A00,187152,Cook; Geoffrey W,1,0,100,99
1683288367231,SIO 109R,A00,194486,Staff,0,3,20,20
1683288369284,SIO 187,A01,187233,Kacev; David,12,0,40,28
1683288370313,SOCI 1,A01,258656,Thorpe; Charles Robert,28,0,30,2
1683288370313,SOCI 1,A02,258658,Thorpe; Charles Robert,30,0,30,0
1683288370313,SOCI 1,A03,258661,Thorpe; Charles Robert,25,0,25,0
1683288370313,SOCI 1,A04,258666,Thorpe; Charles Robert,22,0,25,3
1683288370313,SOCI 1,A05,258897,Thorpe; Charles Robert,23,0,25,2
1683288370313,SOCI 1,A06,258898,Thorpe; Charles Robert,25,0,25,0
1683288371344,SOCI 30,A01,258903,Pardo Guerra; Juan Pablo,16,0,30,14
1683288372371,SOCI 102,A00,258904,Staff,9,0,25,16
1683288373396,SOCI 106,A00,258905,Staff,19,0,25,6
1683288374422,SOCI 111,A00,258907,Ribas Norris; Janet Vanesa,26,0,30,4
1683288375451,SOCI 121R,A00,258908,Pardo Guerra; Juan Pablo,11,0,30,19
1683288376479,SOCI 126,A01,203330,Staff,14,0,20,6
1683288377509,SOCI 131,A00,258909,Thorpe; Charles Robert,31,0,60,29
1683288378540,SOCI 135,A00,258910,Payne; Christine Anna,0,9,30,30
1683288379565,SOCI 157,A00,258911,Staff,13,0,30,17
1683288380590,SOCI 184,A00,258912,Staff,26,0,30,4
1683288381615,SOCI 188D,A00,258913,Staff,21,0,30,9
1683288382649,SYN 2,001,187529,Staff,9,0,16,7
1683288382649,SYN 2,002,201452,Staff,0,18,16,16
1683288382649,SYN 2,003,201469,Staff,3,0,16,13
1683288383679,SYN 100,A01,187531,Staff,0,9,20,20
1683288383679,SYN 100,B01,201491,Staff,0,12,20,20
1683288384706,TDAC 1,A00,189286,Walsh; Kim C.,3,0,20,17
1683288384706,TDAC 1,B00,189287,Harting; Carla Kelso,11,0,20,9
1683288385732,TDAC 101,A00,189300,Walsh; Kim C.,16,0,20,4
1683288385732,TDAC 101,B00,189301,Harting; Carla Kelso,18,0,20,2
1683288386763,TDAC 102,A00,189304,Basso; Beatrice,14,0,20,6
1683288387792,TDAC 108,A00,189305,Staff,18,0,20,2
1683288388820,TDDE 131,A00,189310,Staff,19,0,20,1
1683288388820,TDDE 131,B00,189314,Staff,19,0,20,1
1683288388820,TDDE 131,C00,189315,Staff,48,0,50,2
1683288388820,TDDE 131,D00,189316,Staff,14,0,15,1
1683288388820,TDDE 131,E00,204841,Staff,20,0,20,0
1683288389850,TDGE 10,A00,189289,Staff,30,0,50,20
1683288389850,TDGE 10,B00,189290,Havis; Allan,2,0,50,48
1683288390886,TDGE 11,A00,189291,Fulton; Julia,0,3,50,50
1683288390886,TDGE 11,B00,189292,Staff,20,0,25,5
1683288390886,TDGE 11,C00,260270,Staff,0,0,0,0
1683288391914,TDGE 25,A00,189294,Staff,3,0,20,17
1683288392943,TDGE 124,A00,189318,Fulton; Julia,0,8,50,50
1683288393970,TDGE 125,A00,189319,Staff,13,0,25,12
1683288393970,TDGE 125,B00,189320,Staff,23,0,25,2
1683288394998,TDGE 127,A00,189322,Havis; Allan,0,0,50,50
1683288396029,TDHT 101,A00,189323,Staff,18,0,25,7
1683288396029,TDHT 101,B00,189324,Staff,25,0,25,0
1683288397055,TDHT 102,A00,189325,Staff,49,0,50,1
1683288398082,TDMV 1,A00,189295,Arcidiacono; Kristin,20,0,30,10
1683288398082,TDMV 1,B00,189296,Caligagan; Maria T.,24,0,30,6
1683288399113,TDMV 2,A00,189297,Sammartano; Tonnie,28,0,30,2
1683288399113,TDMV 2,B00,189299,Arcidiacono; Kristin,24,0,30,6
1683288400144,TDMV 3,A00,204998,Rincon; Alicia,22,0,30,8
1683288401170,TDMV 120,A00,189458,Sammartano; Tonnie,28,0,30,2
1683288402195,TDMV 138,A00,189541,Jun; Grace Shin Hae,22,0,40,18
1683288403220,TDMV 142,A00,189717,Caligagan; Tony,23,0,30,7
1683288403220,TDMV 142,B00,189718,Caligagan; Maria T.,25,0,30,5
1683288404246,TMC 2,A01,187533,Staff,25,0,25,0
1683288404246,TMC 2,A02,187534,Staff,25,0,25,0
1683288405276,USP 1,A01,187536,Kwak; Nancy,0,16,25,25
1683288406319,USP 5,A01,187538,Staff,9,0,25,16
1683288407349,USP 101,A00,199253,Staff,0,4,0,0
1683288408374,USP 124,A00,187562,Boomhower; Matthew Charles,1,0,30,29
1683288409403,USP 138,A00,187582,Staff,20,0,25,5
1683288410429,USP 152,A01,187597,Staff,4,0,25,21
1683288411458,USP 153,A00,187598,Staff,19,0,25,6
1683288412487,USP 168,A00,187607,Kwak; Nancy,2,0,5,3
1683288413514,USP 173,A00,187619,Staff,4,0,25,21
1683288414540,USP 181,A00,187638,Staff,0,0,25,25
1683288415566,VIS 103,A00,187650,Cruz; Edwin Teddy,23,0,75,52
1683288416595,VIS 110D,A00,187669,Staff,12,0,22,10
1683288417625,VIS 127C,A00,187720,Shen; Kuiyi,68,0,146,78
1683288418654,VIS 149,A00,187731,Yoldas; Pinar,0,14,22,22
1683288419679,VIS 151,A01,188091,Staff,22,0,34,12
1683288419679,VIS 151,A02,188092,Staff,11,0,34,23
1683288420710,VIS 160B,A00,188093,Stalbaum; Brett,0,0,10,10
1683288422761,WCWP 10B,A00,201720,Staff,10,0,15,5
1683288422761,WCWP 10B,B00,201722,Staff,8,0,15,7
1683288423788,WCWP 100,A00,201725,Gagnon; Jeffrey C,0,0,2,2
1683288423788,WCWP 100,B00,201727,Staff,0,4,15,15
1683288427013,ANBI 133,A00,258401,Wilder; Linnea Lorene,34,0,40,6
1683288428044,ANBI 140,A00,258395,Hrvoj Mihic; Branka,18,0,25,7
1683288429078,ANSC 120,A00,258402,Bialecki; Jon Anthony,27,0,40,13
1683288430103,ANSC 144,A00,258400,Staff,14,0,40,26
1683288432162,ANSC 166,A00,258396,Parish; Steven Martin,157,0,175,18
1683288433187,ANSC 180,A00,193533,Staff,9,0,20,11
1683288434217,ANSC 188,A00,258397,Jassal; Aftab,33,0,40,7
1683288435245,ANTH 3,A01,258316,Staff,23,0,30,7
1683288436282,ANTH 5,A00,258394,Semendeferi; Ekaterini,16,0,20,4
1683288437308,ANTH 21,A01,258331,Staff,9,0,40,31
1683288438334,ANTH 103,A00,258398,Varma; Saiba,15,0,25,10
1683288439364,AWP 10,001,202034,Staff,0,0,0,0
1683288439364,AWP 10,002,202035,Staff,0,0,0,0
1683288439364,AWP 10,003,202036,Staff,0,0,0,0
1683288439364,AWP 10,004,202037,Staff,0,0,0,0
1683288439364,AWP 10,005,202038,Staff,0,0,0,0
1683288439364,AWP 10,006,202039,Staff,0,0,0,0
1683288439364,AWP 10,007,202040,Staff,0,0,0,0
1683288439364,AWP 10,008,202041,Staff,0,0,0,0
1683288439364,AWP 10,009,202042,Staff,0,0,0,0
1683288439364,AWP 10,010,202043,Staff,0,0,0,0
1683288439364,AWP 10,011,202044,Staff,0,0,0,0
1683288439364,AWP 10,012,202045,Staff,0,0,0,0
1683288439364,AWP 10,013,202046,Staff,0,0,0,0
1683288439364,AWP 10,014,202047,Staff,0,0,0,0
1683288439364,AWP 10,015,202048,Staff,0,0,0,0
1683288439364,AWP 10,016,202049,Staff,0,0,0,0
1683288439364,AWP 10,017,202050,Staff,0,0,0,0
1683288439364,AWP 10,018,202051,Staff,0,0,0,0
1683288439364,AWP 10,019,202052,Staff,0,0,0,0
1683288439364,AWP 10,020,202053,Staff,0,0,0,0
1683288439364,AWP 10,021,202054,Staff,0,0,0,0
1683288439364,AWP 10,022,202055,Staff,0,0,0,0
1683288439364,AWP 10,023,202056,Staff,0,0,0,0
1683288439364,AWP 10,024,202057,Staff,0,0,0,0
1683288439364,AWP 10,025,202058,Staff,0,0,0,0
1683288439364,AWP 10,026,202059,Staff,0,0,0,0
1683288440389,AWP 102,001,202032,Staff,0,0,0,0
1683288440389,AWP 102,002,202033,Staff,0,0,0,0
1683288441416,BENG 100,A01,254234,Taylor Amos; Alyssa C,31,0,40,9
1683288442448,BENG 196,001,270013,Engler; Adam J.,9999,0,9999,0
1683288443484,BICD 100R,A01,202018,Smith; Laurie,0,7,32,32
1683288443484,BICD 100R,A02,202019,Smith; Laurie,0,2,32,32
1683288443484,BICD 100R,A03,202020,Smith; Laurie,0,1,32,32
1683288443484,BICD 100R,A04,202021,Smith; Laurie,8,0,32,24
1683288443484,BICD 100R,A05,202022,Smith; Laurie,12,0,32,20
1683288444513,BICD 136,A01,193242,Gustafson-Brown; Cindy,0,2,32,32
1683288444513,BICD 136,A02,193244,Gustafson-Brown; Cindy,15,0,32,17
1683288445678,BIEB 102,A01,193249,Butler; Shannon Rhey,0,2,32,32
1683288445678,BIEB 102,A02,193251,Butler; Shannon Rhey,0,0,32,32
1683288445678,BIEB 102,A03,193253,Butler; Shannon Rhey,0,1,32,32
1683288445678,BIEB 102,A04,193255,Butler; Shannon Rhey,17,0,32,15
1683288445678,BIEB 102,A05,193265,Butler; Shannon Rhey,26,0,32,6
1683288445678,BIEB 102,A06,193269,Butler; Shannon Rhey,16,0,32,16
1683288447735,BIEB 150,A01,193274,Staff,0,0,32,32
1683288447735,BIEB 150,A02,193285,Staff,24,0,32,8
1683288448820,BIEB 194,A00,193286,Kurle; Carolyn M.,22,0,32,10
1683288449856,BILD 1,A01,192291,Staff,16,0,32,16
1683288449856,BILD 1,A02,192292,Staff,30,0,32,2
1683288449856,BILD 1,B01,192520,Reuther; Keefe,0,1,0,0
1683288449856,BILD 1,B02,192532,Reuther; Keefe,0,1,0,0
1683288450885,BILD 3,A01,192556,Butler; Shannon Rhey,0,0,32,32
1683288450885,BILD 3,A02,192581,Butler; Shannon Rhey,5,0,32,27
1683288450885,BILD 3,A03,192611,Butler; Shannon Rhey,23,0,32,9
1683288450885,BILD 3,A04,192612,Butler; Shannon Rhey,25,0,32,7
1683288450885,BILD 3,A05,192613,Butler; Shannon Rhey,27,0,32,5
1683288450885,BILD 3,A06,192679,Butler; Shannon Rhey,27,0,32,5
1683288450885,BILD 3,A07,192682,Butler; Shannon Rhey,22,0,32,10
1683288451925,BILD 4,A01,192836,Reuther; Keefe,1,0,24,23
1683288451925,BILD 4,A02,193044,Reuther; Keefe,4,0,24,20
1683288452957,BILD 10,A01,193142,Gustafson-Brown; Cindy,31,0,32,1
1683288452957,BILD 10,A02,193149,Gustafson-Brown; Cindy,31,0,32,1
1683288453985,BIMM 100,A01,193301,Staff,0,6,32,32
1683288453985,BIMM 100,A02,193312,Staff,0,5,32,32
1683288453985,BIMM 100,A03,193323,Staff,0,8,32,32
1683288455013,BIMM 101,A01,193329,McDonnell; Lisa Marie,0,3,24,24
1683288455013,BIMM 101,A02,193339,McDonnell; Lisa Marie,0,2,24,24
1683288455013,BIMM 101,B01,193354,McDonnell; Lisa Marie,0,3,24,24
1683288455013,BIMM 101,B02,193357,McDonnell; Lisa Marie,0,3,24,24
1683288456048,BIMM 110,A01,193377,Tat; John,0,11,32,32
1683288456048,BIMM 110,A02,193378,Tat; John,1,9,32,31
1683288457083,BIMM 120,A01,206116,Staff,0,0,32,32
1683288457083,BIMM 120,A02,206117,Staff,8,0,32,24
1683288457083,BIMM 120,A03,206121,Staff,21,0,32,11
1683288458112,BIPN 100,A01,193393,Park; Ji Young,0,14,32,32
1683288458112,BIPN 100,A02,193402,Park; Ji Young,0,12,32,32
1683288458112,BIPN 100,A03,193413,Park; Ji Young,0,14,32,32
1683288458112,BIPN 100,A04,193414,Park; Ji Young,0,13,32,32
1683288459142,BIPN 102,A01,193429,Staff,0,0,32,32
1683288459142,BIPN 102,A02,193438,Staff,23,0,32,9
1683288460168,BIPN 106,A01,193450,Reyes Gonzalez; Catalina,0,2,40,40
1683288461196,BIPN 134,A01,193465,Cooke; James Edward,0,0,32,32
1683288461196,BIPN 134,A02,193474,Cooke; James Edward,27,0,32,5
1683288461196,BIPN 134,A03,193485,Cooke; James Edward,29,0,32,3
1683288461196,BIPN 134,A04,193486,Cooke; James Edward,21,0,32,11
1683288461196,BIPN 134,A05,193491,Cooke; James Edward,31,0,32,1
1683288461196,BIPN 134,A06,193501,Cooke; James Edward,30,0,32,2
1683288461196,BIPN 134,A07,193510,Cooke; James Edward,29,0,32,3
1683288463252,BISP 194,A00,222522,Staff,16,0,32,16
1683288464282,CAT 124,A01,202407,Staff,20,0,25,5
1683288465312,CAT 125,A00,202408,Marchisotto; Jennifer Anne,4,0,20,16
1683288466347,CAT 125R,A00,202409,Smith; Lauryn Alissa,0,11,20,20
1683288466347,CAT 125R,B00,202410,Morales; Celeste Georgianna,0,11,20,20
1683288466347,CAT 125R,C00,202411,Irwin; Matthew Joseph,0,10,20,20
1683288467379,CENG 15,A01,204712,Yang; Kesong,0,1,0,0
1683288468405,CENG 114,A00,202070,Jahed Motlagh; Zeinab,5,0,20,15
1683288469430,CGS 105,A00,185477,Wesling; Megan E.,24,0,40,16
1683288470456,CGS 106,A00,185494,Staff,13,0,22,9
1683288471485,CGS 108,A00,185495,Staff,14,0,20,6
1683288472511,CGS 114,A00,185496,Staff,13,0,18,5
1683288473540,CGS 119,A00,185501,Staff,15,0,20,5
1683288474565,CGS 120,A00,185511,Staff,13,0,20,7
1683288475594,CHEM 4,A01,184675,Bussey; Thomas J,96,0,100,4
1683288476620,CHEM 6A,A01,184677,Staff,35,0,60,25
1683288477651,CHEM 6B,A01,184679,Staff,65,0,100,35
1683288478683,CHEM 6C,A01,184681,Bussey; Thomas J,1,0,50,49
1683288478683,CHEM 6C,A02,184682,Bussey; Thomas J,34,0,50,16
1683288479710,CHEM 40A,A01,184684,Albizati; Kim F.,37,0,100,63
1683288480737,CHEM 40B,A01,184686,Albizati; Kim F.,0,20,100,100
1683288481766,CHEM 41B,A01,184690,Staff,52,0,100,48
1683288482798,COGS 3,A01,184715,Boyle; Mary E. T.,0,25,40,40
1683288483827,COGS 14B,A01,185172,Staff,0,15,38,38
1683288484860,COGS 18,A01,184736,Staff,20,0,80,60
1683288485887,COGS 100,A01,184932,Staff,0,5,73,73
1683288486913,COGS 101A,A01,184935,Staff,0,38,30,30
1683288487937,COGS 101B,A01,184944,Staff,0,2,30,30
1683288488968,COGS 101C,A01,184946,Staff,0,12,30,30
1683288489994,COGS 102A,A01,184951,Johnson; Christine M.,2,0,40,38
1683288491021,COGS 107B,A01,184953,Mooshagian; Eric Frederick,0,50,40,40
1683288492052,COGS 118B,A01,184959,Gupta; Anjum,0,48,40,40
1683288493082,COGS 153,A00,184961,Staff,0,15,30,30
1683288494112,COGS 177,A00,184962,Staff,0,21,30,30
1683288495143,COGS 187A,A01,184969,Boyle; Mary E. T.,0,17,40,40
1683288496170,COMM 10,A01,185174,Staff,0,5,25,25
1683288496170,COMM 10,A02,185189,Staff,0,5,25,25
1683288496170,COMM 10,A03,269821,Staff,0,0,0,0
1683288497196,COMM 100B,A01,185475,Staff,0,0,0,2
1683288497196,COMM 100B,A02,185476,Staff,14,0,25,11
1683288498222,COMM 100C,A01,185314,Staff,1,0,25,24
1683288498222,COMM 100C,A02,185327,Staff,19,0,25,6
1683288499246,COMM 110M,A00,185349,Staff,2,0,40,38
1683288500272,COMM 113T,A00,185352,Staff,25,0,40,15
1683288501302,COMM 114I,A00,185353,Staff,33,0,40,7
1683288502329,COMM 131,A00,185354,Staff,19,0,30,11
1683288503357,CSE 8A,A50,185358,Cao; Yingjun,0,46,10,10
1683288504383,CSE 8B,A01,185362,Staff,0,47,50,50
1683288505417,CSE 11,A01,185416,Cao; Yingjun,0,93,10,10
1683288506452,CSE 20,A01,185445,Briones; Jor-el Thomas Caparas,5,0,25,20
1683288507483,CSE 21,A01,185447,Staff,10,0,50,40
1683288508521,CSE 101,A01,185451,Staff,0,12,50,50
1683288508521,CSE 101,B01,185453,Jones; Miles E,0,11,50,50
1683288510579,CSE 141,A01,185458,Eldon; John,20,0,100,80
1683288511605,CSE 141L,A01,185461,Eldon; John,12,0,100,88
1683288512638,CSE 142,A01,185463,Staff,35,0,60,25
1683288512638,CSE 142,B01,201355,Staff,0,6,60,60
1683288513664,CSE 142L,A01,185470,Staff,35,0,60,25
1683288513664,CSE 142L,B01,201417,Staff,0,5,60,60
1683288514691,CSE 190,A00,201433,Staff,32,0,49,17
1683288515719,DOC 1,A01,259136,Strom; Megan C.,8,0,15,7
1683288515719,DOC 1,A02,259137,Strom; Megan C.,14,0,15,1
1683288515719,DOC 1,A03,259138,Strom; Megan C.,14,0,15,1
1683288515719,DOC 1,A04,259139,Strom; Megan C.,14,0,15,1
1683288516743,DOC 100D,A00,259140,Pass; Natalye Joann,17,0,25,8
1683288517777,DSGN 1,A01,184749,Rill; Bryan,0,24,30,30
1683288518806,DSGN 100,A01,185168,Staff,0,2,25,25
1683288519841,ECE 5,A01,185626,Morris; Karcher William,0,10,0,0
1683288520867,ECE 101,A01,185628,Staff,17,0,70,53
1683288521894,ECE 107,A01,185635,Baghdadchi; Saharnaz,0,0,20,20
1683288521894,ECE 107,A02,185638,Baghdadchi; Saharnaz,4,0,20,16
1683288522922,ECE 148,A01,185647,Silberman; Jack,1,0,16,15
1683288523953,ECON 1,A01,185537,Crane; Meredith Helen,54,0,70,16
1683288524978,ECON 3,A01,185549,Crane; Meredith Helen,33,0,70,37
1683288526012,ECON 4,A01,203354,Anderson; John Charles,0,4,10,10
1683288527041,ECON 100A,A01,185574,Staff,0,4,40,40
1683288528068,ECON 100B,A01,185576,Staff,0,22,40,40
1683288529097,ECON 100C,A01,185589,Newhouse; Herbert S,30,0,70,40
1683288530124,ECON 105,A00,185608,Vespa; Emanuel Ignacio,19,0,35,16
1683288531151,ECON 109,A01,185610,Shishkin; Denis,10,0,35,25
1683288532181,ECON 110A,A01,185612,Staff,11,0,40,29
1683288533211,ECON 120A,A01,185615,Staff,20,0,40,20
1683288534237,ECON 120C,A01,185617,Sun; Yixiao,0,20,70,70
1683288535264,ECON 144,A00,203346,Squires; Dale E,3,0,35,32
1683288536291,ECON 171,A01,203349,Newhouse; Herbert S,0,1,35,35
1683288537318,ECON 173A,A01,185621,Toda; Alexis Akira,21,0,35,14
1683288538346,EDS 25,A01,202413,Staff,0,1,0,0
1683288538346,EDS 25,A02,202414,Staff,0,1,0,0
1683288538346,EDS 25,A03,202415,Staff,0,0,0,0
1683288538346,EDS 25,A04,202416,Staff,0,1,0,0
1683288538346,EDS 25,A05,202439,Staff,0,0,0,0
1683288538346,EDS 25,A06,202440,Staff,0,0,0,0
1683288538346,EDS 25,B01,202631,Staff,0,0,0,0
1683288538346,EDS 25,B02,202632,Staff,0,0,0,0
1683288538346,EDS 25,B03,202639,Staff,0,0,0,0
1683288538346,EDS 25,B04,202640,Staff,0,0,0,0
1683288538346,EDS 25,B05,202643,Staff,0,0,0,0
1683288538346,EDS 25,B06,202644,Staff,0,0,0,0
1683288539378,EDS 38,A01,202659,Black; Alison Michelle,24,0,25,1
1683288540405,EDS 115,A00,202652,Staff,17,0,30,13
1683288541434,EDS 125,A00,202649,Staff,14,0,30,16
1683288542464,EDS 126,A01,203332,Staff,30,0,30,0
1683288543490,EDS 139,A00,202838,Staff,17,0,25,8
1683288544517,EDS 146,A01,202655,Staff,15,0,25,10
1683288545551,ENG 15,A00,185667,Staff,0,1,0,0
1683288545551,ENG 15,B00,185672,Staff,0,0,0,0
1683288545551,ENG 15,C00,185675,Staff,0,0,0,0
1683288545551,ENG 15,D00,185682,Staff,0,0,0,0
1683288545551,ENG 15,E00,185684,Staff,0,0,0,0
1683288546585,ETHN 103,A00,185710,Staff,0,3,35,35
1683288547612,ETHN 103A,A00,199228,Man; Simeon S,3,0,9,6
1683288548638,ETHN 109,A00,185711,Staff,18,0,35,17
1683288549668,ETHN 142,A00,185726,Staff,0,4,30,30
1683288550695,ETHN 163J,A00,199229,Man; Simeon S,6,0,8,2
1683288551722,ETHN 168,A00,185727,Staff,8,0,10,2
1683288552806,ETHN 182,A00,185728,Staff,1,0,35,34
1683288553832,ETHN 183,A00,185737,Staff,8,0,18,10
1683288554866,GLBH 111,A01,209361,Burgos; Jose L.,0,0,0,0
1683288556918,HIEU 104,A00,185792,Staff,16,0,20,4
1683288557944,HIEU 115,A00,185800,Staff,1,0,20,19
1683288558969,HIEU 128,A00,185801,Staff,0,7,20,20
1683288559998,HIEU 147,A00,185802,Staff,16,0,20,4
1683288561024,HIEU 154,A00,185823,Staff,12,0,20,8
1683288562049,HILA 102,A00,185826,Staff,13,0,20,7
1683288563076,HILD 2C,A01,185778,Staff,0,12,20,20
1683288564108,HILD 7B,A01,185780,Kwak; Nancy,0,15,32,32
1683288564108,HILD 7B,A02,185781,Kwak; Nancy,0,18,32,32
1683288565135,HILD 30,A01,185791,Staff,14,0,20,6
1683288566160,HISC 119,A00,185830,Golan; Tal,0,9,20,20
1683288567191,HITO 156GS,A00,185831,Patterson; Patrick H.,0,0,0,23
1683288568214,HIUS 103,A00,185832,Man; Simeon S,0,7,20,20
1683288569243,HIUS 117,A00,185836,Kwak; Nancy,2,0,20,18
1683288570269,HIUS 125,A00,185840,Man; Simeon S,0,0,23,23
1683288571295,HIUS 149,A00,185845,Staff,0,0,20,20
1683288572323,HUM 3,A01,185882,Zavodny; Tatiana Sophia,0,6,50,50
1683288572323,HUM 3,B01,185899,Caldwell; Michael Alan,0,19,50,50
1683288573349,HUM 3GS,A00,185900,Patterson; Patrick H.,0,0,0,23
1683288574386,HUM 4,A01,185938,Zroka; Amy Liane,31,0,50,19
1683288574386,HUM 4,B01,185956,Watkins; Eric,0,2,50,50
1683288574386,HUM 4,B02,202209,Watkins; Eric,0,1,50,50
1683288574386,HUM 4,B03,202210,Watkins; Eric,0,0,50,50
1683288575418,HUM 5,A01,185958,West; Geoffrey Scott,5,0,50,45
1683288575418,HUM 5,A02,202215,West; Geoffrey Scott,0,0,50,50
1683288576450,INTL 190,A00,185959,Gagnon; Jeffrey C,0,0,0,9
1683288576450,INTL 190,B00,185960,Lettieri; Michael Joseph,0,0,0,1
1683288577476,JAPN 180,A00,254509,Staff,0,1,25,25
1683288578507,LATI 10,A01,202853,Kennemore; Amy Michelle,5,0,35,30
1683288578507,LATI 10,A02,202854,Kennemore; Amy Michelle,1,0,35,34
1683288578507,LATI 10,A03,270054,Kennemore; Amy Michelle,30,0,30,0
1683288579532,LATI 180,A00,202855,Kennemore; Amy Michelle,11,0,20,9
1683288580558,LAWS 101,A00,201767,Golan; Tal,0,7,40,40
1683288581586,LIFR 1C,A00,185961,Staff,6,0,20,14
1683288582617,LIFR 1CX,A00,185962,Staff,7,0,20,13
1683288583645,LIFR 1D,A00,185963,Staff,9,0,20,11
1683288584670,LIFR 1DX,A00,185964,Staff,9,0,20,11
1683288585699,LIGN 101,A01,186039,Staff,43,0,50,7
1683288586725,LIGN 165,A00,186040,Staff,18,0,50,32
1683288587750,LTCS 108,A00,186041,Staff,6,0,10,4
1683288588777,LTCS 119,A00,186042,Staff,16,0,20,4
1683288589808,LTCS 130,A00,186043,Wesling; Megan E.,15,0,25,10
1683288591859,LTEA 138,A00,186119,Staff,14,0,40,26
1683288592885,LTEN 124,A00,186148,Staff,6,0,25,19
1683288593910,LTEN 178,A00,186149,Staff,7,0,15,8
1683288594937,LTEN 181,A00,186150,Blanco; John D,33,0,40,7
1683288595968,LTWL 120,A00,186160,Staff,20,0,25,5
1683288596996,LTWL 165,A00,186161,Staff,22,0,25,3
1683288598021,LTWR 100,A00,186162,Staff,0,4,15,15
1683288599047,LTWR 102,A00,186163,Doller; Ben,5,0,15,10
1683288600073,MAE 8,A01,186412,Staff,0,0,0,0
1683288601109,MAE 30B,A00,186445,Bahadori; Mohammad Yousef,83,0,100,17
1683288602135,MAE 40,A00,186592,Bewley; Thomas R,9,0,50,41
1683288603166,MAE 101B,A00,186593,Bahadori; Mohammad Yousef,81,0,100,19
1683288604200,MAE 105,A00,186594,Bandaru; Prabhakar,12,0,50,38
1683288605228,MAE 107,A00,186599,Pham; Hieu Tan,0,6,120,120
1683288606259,MAE 148,A01,186660,Silberman; Jack,3,0,16,13
1683288607286,MATH 10A,A01,188095,Staff,0,7,35,35
1683288608320,MATH 10B,A01,188097,Bowers; Adam R.,0,11,30,30
1683288608320,MATH 10B,A02,188099,Bowers; Adam R.,0,9,30,30
1683288608320,MATH 10B,B01,188104,Bowers; Adam R.,0,11,30,30
1683288608320,MATH 10B,B02,188106,Bowers; Adam R.,0,11,30,30
1683288609349,MATH 10C,A01,188111,Staff,0,18,30,30
1683288609349,MATH 10C,A02,188127,Staff,0,17,30,30
1683288609349,MATH 10C,A03,188131,Staff,0,17,30,30
1683288609349,MATH 10C,B01,188218,Staff,21,0,30,9
1683288609349,MATH 10C,B02,188244,Staff,13,0,30,17
1683288609349,MATH 10C,B03,188277,Staff,16,0,30,14
1683288610386,MATH 18,A01,188344,Bach; Quang Tran,18,0,30,12
1683288610386,MATH 18,A02,188345,Bach; Quang Tran,11,0,30,19
1683288610386,MATH 18,B01,188353,Bach; Quang Tran,10,0,30,20
1683288610386,MATH 18,B02,188354,Bach; Quang Tran,20,0,30,10
1683288611417,MATH 20A,A01,188374,Staff,13,0,35,22
1683288612450,MATH 20B,A01,188382,Ohm; Ko Woon,6,0,30,24
1683288612450,MATH 20B,A02,188383,Ohm; Ko Woon,24,0,30,6
1683288612450,MATH 20B,B01,188385,Ohm; Ko Woon,7,0,30,23
1683288612450,MATH 20B,B02,188392,Ohm; Ko Woon,22,0,30,8
1683288613484,MATH 20C,A01,188394,Harel; Guershon,10,0,30,20
1683288613484,MATH 20C,A02,188395,Harel; Guershon,13,0,30,17
1683288613484,MATH 20C,B01,188404,Harel; Guershon,3,0,30,27
1683288613484,MATH 20C,B02,188405,Harel; Guershon,19,0,30,11
1683288614511,MATH 20D,A01,188414,Hammock; Frances H,0,1,30,30
1683288614511,MATH 20D,A02,188415,Hammock; Frances H,4,0,30,26
1683288614511,MATH 20D,B01,188447,Hammock; Frances H,2,0,30,28
1683288614511,MATH 20D,B02,188486,Hammock; Frances H,8,0,30,22
1683288615538,MATH 20E,A01,188649,Staff,22,0,30,8
1683288615538,MATH 20E,A02,188650,Staff,23,0,30,7
1683288615538,MATH 20E,A03,188673,Staff,0,0,30,30
1683288616565,MATH 102,A01,188675,Staff,0,35,35,35
1683288617592,MATH 103B,A01,188681,Staff,4,0,35,31
1683288617592,MATH 103B,B01,188692,Staff,8,0,35,27
1683288618623,MATH 109,A01,188695,Salehi Golsefidy; Alireza,25,0,35,10
1683288618623,MATH 109,A02,188696,Salehi Golsefidy; Alireza,27,0,35,8
1683288619654,MATH 120A,A01,188698,Eggers; John Dietrich,5,0,35,30
1683288620684,MATH 142B,A01,188736,Ioana; Adrian,0,2,30,30
1683288620684,MATH 142B,A02,188741,Ioana; Adrian,0,1,30,30
1683288620684,MATH 142B,A03,188743,Ioana; Adrian,0,3,30,30
1683288621711,MATH 168A,A01,188790,Staff,0,8,35,35
1683288622742,MATH 170A,A01,188803,Nie; Jiawang,0,2,35,35
1683288622742,MATH 170A,A02,188811,Nie; Jiawang,0,0,35,35
1683288622742,MATH 170A,A03,188814,Nie; Jiawang,1,0,35,34
1683288622742,MATH 170A,A04,188815,Nie; Jiawang,14,0,35,21
1683288623772,MATH 193B,A01,188817,Staff,0,0,35,35
1683288623772,MATH 193B,A02,188818,Staff,5,0,35,30
1683288624799,MGT 4,A01,202857,Anderson; John Charles,62,0,80,18
1683288625828,MGT 12,A00,202858,Lindenberger; Wade Douglas,43,0,90,47
1683288626855,MGT 18,A00,202859,Staff,74,0,90,16
1683288627879,MGT 18GS,A00,202860,McKay; Michael J,13,0,28,15
1683288628907,MGT 45,A00,202861,Pecore; Joseph P.,14,0,90,76
1683288629938,MGT 100,A00,202863,Yavorsky; Daniel Ryan,28,0,90,62
1683288630969,MGT 103,A00,202864,Ehrich; Kristine R,0,16,90,90
1683288631995,MGT 112,A00,202865,Ehrich; Kristine R,15,0,90,75
1683288633021,MGT 121A,A00,202868,Staff,0,19,0,0
1683288634051,MGT 131B,A00,202869,Anderson; John Charles,60,0,90,30
1683288635077,MGT 136,A00,202871,Lindenberger; Wade Douglas,84,0,90,6
1683288636106,MGT 164,A00,202873,Staff,0,69,90,90
1683288637135,MGT 164GS,A00,202874,McKay; Mary A,13,0,28,15
1683288638161,MGT 180,A00,202875,Staff,0,51,90,90
1683288639191,MMW 11R,A01,205019,Herbst; Matthew,3,0,30,27
1683288639191,MMW 11R,A02,205026,Herbst; Matthew,29,0,30,1
1683288640228,MMW 15,A01,193512,Chang; Edmond Yi-Teh,0,9,28,28
1683288640228,MMW 15,A02,193513,Chang; Edmond Yi-Teh,0,5,28,28
1683288640228,MMW 15,A03,193514,Chang; Edmond Yi-Teh,0,5,28,28
1683288640228,MMW 15,A04,193515,Chang; Edmond Yi-Teh,0,4,28,28
1683288640228,MMW 15,A05,193516,Chang; Edmond Yi-Teh,0,4,28,28
1683288640228,MMW 15,A06,193517,Chang; Edmond Yi-Teh,0,5,28,28
1683288640228,MMW 15,B01,193519,Chang; Edmond Yi-Teh,0,4,28,28
1683288640228,MMW 15,B02,193520,Chang; Edmond Yi-Teh,0,5,28,28
1683288640228,MMW 15,B03,193521,Chang; Edmond Yi-Teh,0,4,28,28
1683288640228,MMW 15,B04,193522,Chang; Edmond Yi-Teh,0,4,28,28
1683288640228,MMW 15,B05,193523,Chang; Edmond Yi-Teh,0,5,28,28
1683288640228,MMW 15,B06,193524,Chang; Edmond Yi-Teh,0,4,28,28
1683288641255,MMW 122,A01,193526,Rahimi; Babak,0,14,28,28
1683288641255,MMW 122,A02,193527,Rahimi; Babak,0,14,28,28
1683288641255,MMW 122,A03,193528,Rahimi; Babak,0,0,0,0
1683288641255,MMW 122,A04,193529,Rahimi; Babak,0,0,0,0
1683288642285,MUS 1A,A01,186663,Staff,0,20,35,35
1683288643315,MUS 4,A01,186715,Staff,0,12,35,35
1683288644345,MUS 5R,A01,186796,Dubnov; Shlomo,0,16,35,35
1683288645372,MUS 6,A01,186798,Staff,0,3,25,25
1683288646398,MUS 7,A01,186830,Staff,12,0,35,23
1683288647425,MUS 8,A01,186930,Staff,0,25,35,35
1683288648454,MUS 15,A01,186932,Staff,0,15,35,35
1683288648454,MUS 15,B01,186934,Staff,0,14,35,35
1683288649480,MUS 80,A00,186935,Staff,2,0,20,18
1683288649480,MUS 80,B00,186936,Staff,25,0,25,0
1683288650511,NANO 11,A00,204702,Lipomi; Darren John,0,0,0,0
1683288651544,NANO 15,A01,204709,Yang; Kesong,0,1,0,0
1683288652571,NANO 114,A00,202069,Jahed Motlagh; Zeinab,3,0,10,7
1683288653602,PHIL 1,A00,186955,Grush; Rick Scott,32,0,40,8
1683288654631,PHIL 10,A01,186973,Grush; Rick Scott,29,0,35,6
1683288654631,PHIL 10,A02,186974,Grush; Rick Scott,33,0,35,2
1683288655661,PHIL 13,A01,186976,Staff,7,0,35,28
1683288655661,PHIL 13,A02,186977,Staff,16,0,35,19
1683288656744,PHIL 14,A01,186979,Staff,31,0,35,4
1683288656744,PHIL 14,A02,186986,Staff,32,0,35,3
1683288657770,PHIL 28,A01,186988,Staff,16,0,30,14
1683288657770,PHIL 28,A02,186989,Staff,1,0,30,29
1683288657770,PHIL 28,A03,186990,Staff,9,0,30,21
1683288657770,PHIL 28,A04,186991,Staff,26,0,30,4
1683288658797,PHIL 120,A00,186997,Staff,23,0,40,17
1683288659821,PHIL 137,A00,187003,Staff,9,0,40,31
1683288660850,PHIL 150,A00,187015,Staff,47,0,70,23
1683288661875,PHIL 167,A00,187021,Lamey; Andy M.,35,0,40,5
1683288662906,PHIL 174,A01,202226,Staff,17,0,20,3
1683288662906,PHIL 174,A02,202235,Staff,20,0,20,0
1683288663932,PHIL 191A,A00,258918,Staff,0,0,1,1
1683288664958,PHYS 1A,A00,187028,Staff,26,0,60,34
1683288665985,PHYS 1AL,001,187036,Staff,2,0,30,28
1683288665985,PHYS 1AL,002,187049,Staff,18,0,30,12
1683288667012,PHYS 1B,A00,187058,Staff,23,0,60,37
1683288668041,PHYS 1BL,001,187064,Staff,0,0,30,30
1683288668041,PHYS 1BL,002,187070,Staff,6,0,30,24
1683288669070,PHYS 1C,A00,187082,Staff,32,0,120,88
1683288670096,PHYS 1CL,001,187088,Staff,0,9,30,30
1683288670096,PHYS 1CL,002,187089,Staff,0,2,30,30
1683288670096,PHYS 1CL,009,262693,Staff,12,0,30,18
1683288671125,PHYS 2B,A01,187097,Staff,54,0,115,61
1683288672150,PHYS 2C,A01,187099,Staff,67,0,115,48
1683288673174,PHYS 2CL,A01,187101,Staff,5,0,28,23
1683288673174,PHYS 2CL,A02,187102,Staff,15,0,28,13
1683288674205,PHYS 2D,A01,187123,Shotwell; Brian,95,0,115,20
1683288675234,PHYS 4B,A01,187133,Grinstein; Benjamin,35,0,50,15
1683288676264,POLI 10,A00,188819,Staff,0,3,50,50
1683288677291,POLI 11,A00,188827,Staff,43,0,50,7
1683288678317,POLI 13R,A00,188828,Staff,0,1,20,20
1683288679343,POLI 27,A01,188830,Elgin; Samuel Zincke,0,1,70,70
1683288680370,POLI 30,A00,188832,Desposato; Scott,33,0,50,17
1683288681396,POLI 102F,A00,188834,Staff,3,0,40,37
1683288682427,POLI 104A,A00,188852,Staff,14,0,30,16
1683288683453,POLI 104I,A00,188853,Staff,0,6,20,20
1683288684483,POLI 110B,A00,188854,Wiens; David,7,0,20,13
1683288685510,POLI 112A,A00,188855,Wiens; David,5,0,30,25
1683288686541,POLI 117R,A00,188856,Forman; Fonna,0,11,20,20
1683288687570,POLI 118,A00,188857,Ingham; Sean,8,0,20,12
1683288688596,POLI 120G,A00,188858,Staff,9,0,30,21
1683288689626,POLI 131CR,A00,188863,Hoston; Germaine,24,0,50,26
1683288690655,POLI 133,A00,188864,Nellis; Gareth Hb,44,0,50,6
1683288691680,POLI 134D,A00,188865,Desposato; Scott,27,0,30,3
1683288692710,POLI 142A,A00,188871,Gartzke; Erik,22,0,50,28
1683288693736,POLI 142K,A00,188874,Staff,38,0,50,12
1683288694765,POLI 143,A00,188940,Gartzke; Erik,16,0,30,14
1683288695791,POLI 153,A00,188943,Staff,3,0,20,17
1683288696819,POLI 160AA,A00,188944,Staff,13,0,40,27
1683288697844,POLI 170A,A00,188945,Staff,11,0,30,19
1683288699902,PSYC 1,A00,188952,Staff,38,0,90,52
1683288700930,PSYC 2,B00,188953,Staff,20,0,35,15
1683288701954,PSYC 6,A00,188970,Staff,47,0,60,13
1683288702980,PSYC 7,A00,188973,Staff,37,0,45,8
1683288704012,PSYC 60,A01,188980,Rickard; Timothy C.,43,0,60,17
1683288705038,PSYC 70,A01,189001,Steiner; Eric Tomas,24,0,45,21
1683288706064,PSYC 100,A00,189005,Lacefield; Katharine I,0,99,120,120
1683288707089,PSYC 102,A00,189008,Staff,10,0,30,20
1683288708119,PSYC 106,B00,189026,Gorman; Michael R.,37,0,60,23
1683288709144,PSYC 114,B01,189033,Winkielman; Piotr,0,32,30,30
1683288710171,PSYC 131,A00,189036,Anagnostaras; Stephan,0,43,60,60
1683288711201,PSYC 136,A00,189041,Lowe; Angela Beth,0,7,25,25
1683288712228,PSYC 137,A00,189057,Winkielman; Piotr,0,34,25,25
1683288713256,PSYC 144,A00,189107,Wixted; John T,0,7,50,50
1683288715308,PSYC 162,A00,189142,Staff,0,8,85,85
1683288716337,PSYC 172,A00,189144,Gorman; Michael R.,0,7,30,30
1683288718386,PSYC 179,A00,189146,Lacefield; Katharine I,0,84,120,120
1683288719412,PSYC 181,A00,189147,Anagnostaras; Stephan,0,44,90,90
1683288720437,PSYC 190R,A00,189148,Barner; David A.,0,22,80,80
1683288721467,PSYC 191,A00,189275,Rickard; Timothy C.,0,7,25,25
1683288722494,PSYC 193,A00,189276,Chapman; Eddie Nathaniel,0,1,0,4
1683288723531,PSYC 193L,A01,189281,Lowe; Angela Beth,12,0,20,8
1683288723531,PSYC 193L,B01,189285,Staff,28,0,35,7
1683288724558,RELI 149,A00,187137,Rahimi; Babak,7,0,40,33
1683288725585,SE 9,A01,187315,Staff,0,2,18,18
1683288726614,SE 101B,A00,187409,Staff,24,0,30,6
1683288727640,SE 110B,A00,187444,Staff,10,0,40,30
1683288728664,SE 130B,A00,187449,Staff,31,0,40,9
1683288729689,SE 150A,A00,187516,Staff,9,0,20,11
1683288730718,SE 154,A00,187528,Staff,30,0,50,20
1683288731748,SIO 3,A01,258171,Staff,35,0,40,5
1683288732777,SIO 10,A00,187144,Cook; Geoffrey W,0,3,75,75
1683288733803,SIO 45,A00,187152,Cook; Geoffrey W,1,0,100,99
1683288734832,SIO 109R,A00,194486,Staff,0,3,20,20
1683288736886,SIO 187,A01,187233,Kacev; David,12,0,40,28
1683288737920,SOCI 1,A01,258656,Thorpe; Charles Robert,28,0,30,2
1683288737920,SOCI 1,A02,258658,Thorpe; Charles Robert,30,0,30,0
1683288737920,SOCI 1,A03,258661,Thorpe; Charles Robert,25,0,25,0
1683288737920,SOCI 1,A04,258666,Thorpe; Charles Robert,22,0,25,3
1683288737920,SOCI 1,A05,258897,Thorpe; Charles Robert,23,0,25,2
1683288737920,SOCI 1,A06,258898,Thorpe; Charles Robert,25,0,25,0
1683288738946,SOCI 30,A01,258903,Pardo Guerra; Juan Pablo,16,0,30,14
1683288739972,SOCI 102,A00,258904,Staff,9,0,25,16
1683288740998,SOCI 106,A00,258905,Staff,19,0,25,6
1683288742023,SOCI 111,A00,258907,Ribas Norris; Janet Vanesa,26,0,30,4
1683288743052,SOCI 121R,A00,258908,Pardo Guerra; Juan Pablo,11,0,30,19
1683288744084,SOCI 126,A01,203330,Staff,14,0,20,6
1683288745110,SOCI 131,A00,258909,Thorpe; Charles Robert,31,0,60,29
1683288746137,SOCI 135,A00,258910,Payne; Christine Anna,0,9,30,30
1683288747166,SOCI 157,A00,258911,Staff,13,0,30,17
1683288748190,SOCI 184,A00,258912,Staff,26,0,30,4
1683288749216,SOCI 188D,A00,258913,Staff,21,0,30,9
1683288750243,SYN 2,001,187529,Staff,9,0,16,7
1683288750243,SYN 2,002,201452,Staff,0,18,16,16
1683288750243,SYN 2,003,201469,Staff,3,0,16,13
1683288751273,SYN 100,A01,187531,Staff,0,9,20,20
1683288751273,SYN 100,B01,201491,Staff,0,12,20,20
1683288752300,TDAC 1,A00,189286,Walsh; Kim C.,3,0,20,17
1683288752300,TDAC 1,B00,189287,Harting; Carla Kelso,11,0,20,9
1683288753326,TDAC 101,A00,189300,Walsh; Kim C.,16,0,20,4
1683288753326,TDAC 101,B00,189301,Harting; Carla Kelso,18,0,20,2
1683288754353,TDAC 102,A00,189304,Basso; Beatrice,14,0,20,6
1683288755384,TDAC 108,A00,189305,Staff,18,0,20,2
1683288756414,TDDE 131,A00,189310,Staff,19,0,20,1
1683288756414,TDDE 131,B00,189314,Staff,19,0,20,1
1683288756414,TDDE 131,C00,189315,Staff,48,0,50,2
1683288756414,TDDE 131,D00,189316,Staff,14,0,15,1
1683288756414,TDDE 131,E00,204841,Staff,20,0,20,0
1683288757440,TDGE 10,A00,189289,Staff,30,0,50,20
1683288757440,TDGE 10,B00,189290,Havis; Allan,2,0,50,48
1683288758469,TDGE 11,A00,189291,Fulton; Julia,0,3,50,50
1683288758469,TDGE 11,B00,189292,Staff,20,0,25,5
1683288758469,TDGE 11,C00,260270,Staff,0,0,0,0
1683288759497,TDGE 25,A00,189294,Staff,3,0,20,17
1683288760579,TDGE 124,A00,189318,Fulton; Julia,0,8,50,50
1683288761604,TDGE 125,A00,189319,Staff,13,0,25,12
1683288761604,TDGE 125,B00,189320,Staff,23,0,25,2
1683288762630,TDGE 127,A00,189322,Havis; Allan,0,0,50,50
1683288763660,TDHT 101,A00,189323,Staff,18,0,25,7
1683288763660,TDHT 101,B00,189324,Staff,25,0,25,0
1683288764685,TDHT 102,A00,189325,Staff,49,0,50,1
1683288765712,TDMV 1,A00,189295,Arcidiacono; Kristin,20,0,30,10
1683288765712,TDMV 1,B00,189296,Caligagan; Maria T.,24,0,30,6
1683288766743,TDMV 2,A00,189297,Sammartano; Tonnie,28,0,30,2
1683288766743,TDMV 2,B00,189299,Arcidiacono; Kristin,24,0,30,6
1683288767769,TDMV 3,A00,204998,Rincon; Alicia,22,0,30,8
1683288768794,TDMV 120,A00,189458,Sammartano; Tonnie,28,0,30,2
1683288769824,TDMV 138,A00,189541,Jun; Grace Shin Hae,22,0,40,18
1683288770850,TDMV 142,A00,189717,Caligagan; Tony,23,0,30,7
1683288770850,TDMV 142,B00,189718,Caligagan; Maria T.,25,0,30,5
1683288771875,TMC 2,A01,187533,Staff,25,0,25,0
1683288771875,TMC 2,A02,187534,Staff,25,0,25,0
1683288772905,USP 1,A01,187536,Kwak; Nancy,0,16,25,25
1683288773936,USP 5,A01,187538,Staff,9,0,25,16
1683288774961,USP 101,A00,199253,Staff,0,4,0,0
1683288775987,USP 124,A00,187562,Boomhower; Matthew Charles,1,0,30,29
1683288777017,USP 138,A00,187582,Staff,20,0,25,5
1683288778042,USP 152,A01,187597,Staff,4,0,25,21
1683288779068,USP 153,A00,187598,Staff,19,0,25,6
1683288780094,USP 168,A00,187607,Kwak; Nancy,2,0,5,3
1683288781150,USP 173,A00,187619,Staff,4,0,25,21
1683288782175,USP 181,A00,187638,Staff,0,0,25,25
1683288783202,VIS 103,A00,187650,Cruz; Edwin Teddy,23,0,75,52
1683288784226,VIS 110D,A00,187669,Staff,12,0,22,10
1683288785252,VIS 127C,A00,187720,Shen; Kuiyi,68,0,146,78
1683288786285,VIS 149,A00,187731,Yoldas; Pinar,0,14,22,22
1683288787311,VIS 151,A01,188091,Staff,22,0,34,12
1683288787311,VIS 151,A02,188092,Staff,11,0,34,23
1683288788337,VIS 160B,A00,188093,Stalbaum; Brett,0,0,10,10
1683288790394,WCWP 10B,A00,201720,Staff,10,0,15,5
1683288790394,WCWP 10B,B00,201722,Staff,8,0,15,7
1683288791420,WCWP 100,A00,201725,Gagnon; Jeffrey C,0,0,2,2
1683288791420,WCWP 100,B00,201727,Staff,0,4,15,15
1683288794569,ANBI 133,A00,258401,Wilder; Linnea Lorene,34,0,40,6
1683288795595,ANBI 140,A00,258395,Hrvoj Mihic; Branka,18,0,25,7
1683288796621,ANSC 120,A00,258402,Bialecki; Jon Anthony,27,0,40,13
1683288797650,ANSC 144,A00,258400,Staff,14,0,40,26
1683288799707,ANSC 166,A00,258396,Parish; Steven Martin,157,0,175,18
1683288800737,ANSC 180,A00,193533,Staff,9,0,20,11
1683288801769,ANSC 188,A00,258397,Jassal; Aftab,33,0,40,7
1683288802798,ANTH 3,A01,258316,Staff,23,0,30,7
1683288803825,ANTH 5,A00,258394,Semendeferi; Ekaterini,16,0,20,4
1683288804854,ANTH 21,A01,258331,Staff,9,0,40,31
1683288805882,ANTH 103,A00,258398,Varma; Saiba,15,0,25,10
1683288806921,AWP 10,001,202034,Staff,0,0,0,0
1683288806921,AWP 10,002,202035,Staff,0,0,0,0
1683288806921,AWP 10,003,202036,Staff,0,0,0,0
1683288806921,AWP 10,004,202037,Staff,0,0,0,0
1683288806921,AWP 10,005,202038,Staff,0,0,0,0
1683288806921,AWP 10,006,202039,Staff,0,0,0,0
1683288806921,AWP 10,007,202040,Staff,0,0,0,0
1683288806921,AWP 10,008,202041,Staff,0,0,0,0
1683288806921,AWP 10,009,202042,Staff,0,0,0,0
1683288806921,AWP 10,010,202043,Staff,0,0,0,0
1683288806921,AWP 10,011,202044,Staff,0,0,0,0
1683288806921,AWP 10,012,202045,Staff,0,0,0,0
1683288806921,AWP 10,013,202046,Staff,0,0,0,0
1683288806921,AWP 10,014,202047,Staff,0,0,0,0
1683288806921,AWP 10,015,202048,Staff,0,0,0,0
1683288806921,AWP 10,016,202049,Staff,0,0,0,0
1683288806921,AWP 10,017,202050,Staff,0,0,0,0
1683288806921,AWP 10,018,202051,Staff,0,0,0,0
1683288806921,AWP 10,019,202052,Staff,0,0,0,0
1683288806921,AWP 10,020,202053,Staff,0,0,0,0
1683288806921,AWP 10,021,202054,Staff,0,0,0,0
1683288806921,AWP 10,022,202055,Staff,0,0,0,0
1683288806921,AWP 10,023,202056,Staff,0,0,0,0
1683288806921,AWP 10,024,202057,Staff,0,0,0,0
1683288806921,AWP 10,025,202058,Staff,0,0,0,0
1683288806921,AWP 10,026,202059,Staff,0,0,0,0
1683288807947,AWP 102,001,202032,Staff,0,0,0,0
1683288807947,AWP 102,002,202033,Staff,0,0,0,0
1683288808975,BENG 100,A01,254234,Taylor Amos; Alyssa C,31,0,40,9
1683288810004,BENG 196,001,270013,Engler; Adam J.,9999,0,9999,0
1683288811036,BICD 100R,A01,202018,Smith; Laurie,0,7,32,32
1683288811036,BICD 100R,A02,202019,Smith; Laurie,0,2,32,32
1683288811036,BICD 100R,A03,202020,Smith; Laurie,0,1,32,32
1683288811036,BICD 100R,A04,202021,Smith; Laurie,8,0,32,24
1683288811036,BICD 100R,A05,202022,Smith; Laurie,12,0,32,20
1683288812067,BICD 136,A01,193242,Gustafson-Brown; Cindy,0,2,32,32
1683288812067,BICD 136,A02,193244,Gustafson-Brown; Cindy,15,0,32,17
1683288813099,BIEB 102,A01,193249,Butler; Shannon Rhey,0,2,32,32
1683288813099,BIEB 102,A02,193251,Butler; Shannon Rhey,0,0,32,32
1683288813099,BIEB 102,A03,193253,Butler; Shannon Rhey,0,1,32,32
1683288813099,BIEB 102,A04,193255,Butler; Shannon Rhey,17,0,32,15
1683288813099,BIEB 102,A05,193265,Butler; Shannon Rhey,26,0,32,6
1683288813099,BIEB 102,A06,193269,Butler; Shannon Rhey,16,0,32,16
1683288815157,BIEB 150,A01,193274,Staff,0,0,32,32
1683288815157,BIEB 150,A02,193285,Staff,24,0,32,8
1683288816184,BIEB 194,A00,193286,Kurle; Carolyn M.,22,0,32,10
1683288817214,BILD 1,A01,192291,Staff,16,0,32,16
1683288817214,BILD 1,A02,192292,Staff,30,0,32,2
1683288817214,BILD 1,B01,192520,Reuther; Keefe,0,1,0,0
1683288817214,BILD 1,B02,192532,Reuther; Keefe,0,1,0,0
1683288818240,BILD 3,A01,192556,Butler; Shannon Rhey,0,0,32,32
1683288818240,BILD 3,A02,192581,Butler; Shannon Rhey,5,0,32,27
1683288818240,BILD 3,A03,192611,Butler; Shannon Rhey,23,0,32,9
1683288818240,BILD 3,A04,192612,Butler; Shannon Rhey,25,0,32,7
1683288818240,BILD 3,A05,192613,Butler; Shannon Rhey,27,0,32,5
1683288818240,BILD 3,A06,192679,Butler; Shannon Rhey,27,0,32,5
1683288818240,BILD 3,A07,192682,Butler; Shannon Rhey,22,0,32,10
1683288819272,BILD 4,A01,192836,Reuther; Keefe,1,0,24,23
1683288819272,BILD 4,A02,193044,Reuther; Keefe,4,0,24,20
1683288820298,BILD 10,A01,193142,Gustafson-Brown; Cindy,31,0,32,1
1683288820298,BILD 10,A02,193149,Gustafson-Brown; Cindy,31,0,32,1
1683288821325,BIMM 100,A01,193301,Staff,0,6,32,32
1683288821325,BIMM 100,A02,193312,Staff,0,5,32,32
1683288821325,BIMM 100,A03,193323,Staff,0,8,32,32
1683288822353,BIMM 101,A01,193329,McDonnell; Lisa Marie,0,3,24,24
1683288822353,BIMM 101,A02,193339,McDonnell; Lisa Marie,0,2,24,24
1683288822353,BIMM 101,B01,193354,McDonnell; Lisa Marie,0,3,24,24
1683288822353,BIMM 101,B02,193357,McDonnell; Lisa Marie,0,3,24,24
1683288823377,BIMM 110,A01,193377,Tat; John,0,11,32,32
1683288823377,BIMM 110,A02,193378,Tat; John,1,9,32,31
1683288824410,BIMM 120,A01,206116,Staff,0,0,32,32
1683288824410,BIMM 120,A02,206117,Staff,8,0,32,24
1683288824410,BIMM 120,A03,206121,Staff,21,0,32,11
1683288825438,BIPN 100,A01,193393,Park; Ji Young,0,14,32,32
1683288825438,BIPN 100,A02,193402,Park; Ji Young,0,12,32,32
1683288825438,BIPN 100,A03,193413,Park; Ji Young,0,14,32,32
1683288825438,BIPN 100,A04,193414,Park; Ji Young,0,13,32,32
1683288826465,BIPN 102,A01,193429,Staff,0,0,32,32
1683288826465,BIPN 102,A02,193438,Staff,23,0,32,9
1683288827495,BIPN 106,A01,193450,Reyes Gonzalez; Catalina,0,2,40,40
1683288828523,BIPN 134,A01,193465,Cooke; James Edward,0,0,32,32
1683288828523,BIPN 134,A02,193474,Cooke; James Edward,27,0,32,5
1683288828523,BIPN 134,A03,193485,Cooke; James Edward,29,0,32,3
1683288828523,BIPN 134,A04,193486,Cooke; James Edward,21,0,32,11
1683288828523,BIPN 134,A05,193491,Cooke; James Edward,31,0,32,1
1683288828523,BIPN 134,A06,193501,Cooke; James Edward,30,0,32,2
1683288828523,BIPN 134,A07,193510,Cooke; James Edward,29,0,32,3
1683288830574,BISP 194,A00,222522,Staff,16,0,32,16
1683288831600,CAT 124,A01,202407,Staff,20,0,25,5
1683288832625,CAT 125,A00,202408,Marchisotto; Jennifer Anne,4,0,20,16
1683288833654,CAT 125R,A00,202409,Smith; Lauryn Alissa,0,11,20,20
1683288833654,CAT 125R,B00,202410,Morales; Celeste Georgianna,0,11,20,20
1683288833654,CAT 125R,C00,202411,Irwin; Matthew Joseph,0,10,20,20
1683288834682,CENG 15,A01,204712,Yang; Kesong,0,1,0,0
1683288835707,CENG 114,A00,202070,Jahed Motlagh; Zeinab,5,0,20,15
1683288836734,CGS 105,A00,185477,Wesling; Megan E.,24,0,40,16
1683288837763,CGS 106,A00,185494,Staff,13,0,22,9
1683288838794,CGS 108,A00,185495,Staff,14,0,20,6
1683288839820,CGS 114,A00,185496,Staff,13,0,18,5
1683288840846,CGS 119,A00,185501,Staff,15,0,20,5
1683288841874,CGS 120,A00,185511,Staff,13,0,20,7
1683288842901,CHEM 4,A01,184675,Bussey; Thomas J,96,0,100,4
1683288843927,CHEM 6A,A01,184677,Staff,35,0,60,25
1683288844954,CHEM 6B,A01,184679,Staff,65,0,100,35
1683288845978,CHEM 6C,A01,184681,Bussey; Thomas J,1,0,50,49
1683288845978,CHEM 6C,A02,184682,Bussey; Thomas J,34,0,50,16
1683288847008,CHEM 40A,A01,184684,Albizati; Kim F.,37,0,100,63
1683288848035,CHEM 40B,A01,184686,Albizati; Kim F.,0,20,100,100
1683288849065,CHEM 41B,A01,184690,Staff,52,0,100,48
1683288850092,COGS 3,A01,184715,Boyle; Mary E. T.,0,25,40,40
1683288851121,COGS 14B,A01,185172,Staff,0,15,38,38
1683288852145,COGS 18,A01,184736,Staff,20,0,80,60
1683288853173,COGS 100,A01,184932,Staff,0,5,73,73
1683288854198,COGS 101A,A01,184935,Staff,0,38,30,30
1683288855223,COGS 101B,A01,184944,Staff,0,2,30,30
1683288856251,COGS 101C,A01,184946,Staff,0,12,30,30
1683288857280,COGS 102A,A01,184951,Johnson; Christine M.,2,0,40,38
1683288858310,COGS 107B,A01,184953,Mooshagian; Eric Frederick,0,50,40,40
1683288859336,COGS 118B,A01,184959,Gupta; Anjum,0,48,40,40
1683288860362,COGS 153,A00,184961,Staff,0,15,30,30
1683288861387,COGS 177,A00,184962,Staff,0,21,30,30
1683288862416,COGS 187A,A01,184969,Boyle; Mary E. T.,0,17,40,40
1683288863445,COMM 10,A01,185174,Staff,0,5,25,25
1683288863445,COMM 10,A02,185189,Staff,0,5,25,25
1683288863445,COMM 10,A03,269821,Staff,0,0,0,0
1683288864528,COMM 100B,A01,185475,Staff,0,0,0,2
1683288864528,COMM 100B,A02,185476,Staff,14,0,25,11
1683288865553,COMM 100C,A01,185314,Staff,1,0,25,24
1683288865553,COMM 100C,A02,185327,Staff,19,0,25,6
1683288866579,COMM 110M,A00,185349,Staff,2,0,40,38
1683288867609,COMM 113T,A00,185352,Staff,25,0,40,15
1683288868635,COMM 114I,A00,185353,Staff,33,0,40,7
1683288869664,COMM 131,A00,185354,Staff,19,0,30,11
1683288870696,CSE 8A,A50,185358,Cao; Yingjun,0,46,10,10
1683288871722,CSE 8B,A01,185362,Staff,0,47,50,50
1683288872753,CSE 11,A01,185416,Cao; Yingjun,0,93,10,10
1683288873783,CSE 20,A01,185445,Briones; Jor-el Thomas Caparas,5,0,25,20
1683288874810,CSE 21,A01,185447,Staff,10,0,50,40
1683288875842,CSE 101,A01,185451,Staff,0,12,50,50
1683288875842,CSE 101,B01,185453,Jones; Miles E,0,11,50,50
1683288877893,CSE 141,A01,185458,Eldon; John,20,0,100,80
1683288878918,CSE 141L,A01,185461,Eldon; John,12,0,100,88
1683288879950,CSE 142,A01,185463,Staff,35,0,60,25
1683288879950,CSE 142,B01,201355,Staff,0,6,60,60
1683288880980,CSE 142L,A01,185470,Staff,35,0,60,25
1683288880980,CSE 142L,B01,201417,Staff,0,5,60,60
1683288882008,CSE 190,A00,201433,Staff,32,0,49,17
1683288883038,DOC 1,A01,259136,Strom; Megan C.,8,0,15,7
1683288883038,DOC 1,A02,259137,Strom; Megan C.,14,0,15,1
1683288883038,DOC 1,A03,259138,Strom; Megan C.,14,0,15,1
1683288883038,DOC 1,A04,259139,Strom; Megan C.,14,0,15,1
1683288884066,DOC 100D,A00,259140,Pass; Natalye Joann,17,0,25,8
1683288885092,DSGN 1,A01,184749,Rill; Bryan,0,24,30,30
1683288886118,DSGN 100,A01,185168,Staff,0,2,25,25
1683288887150,ECE 5,A01,185626,Morris; Karcher William,0,10,0,0
1683288888176,ECE 101,A01,185628,Staff,17,0,70,53
1683288889203,ECE 107,A01,185635,Baghdadchi; Saharnaz,0,0,20,20
1683288889203,ECE 107,A02,185638,Baghdadchi; Saharnaz,4,0,20,16
1683288890232,ECE 148,A01,185647,Silberman; Jack,1,0,16,15
1683288891267,ECON 1,A01,185537,Crane; Meredith Helen,54,0,70,16
1683288892293,ECON 3,A01,185549,Crane; Meredith Helen,33,0,70,37
1683288893331,ECON 4,A01,203354,Anderson; John Charles,0,4,10,10
1683288894361,ECON 100A,A01,185574,Staff,0,4,40,40
1683288895386,ECON 100B,A01,185576,Staff,0,22,40,40
1683288896412,ECON 100C,A01,185589,Newhouse; Herbert S,30,0,70,40
1683288897444,ECON 105,A00,185608,Vespa; Emanuel Ignacio,19,0,35,16
1683288898472,ECON 109,A01,185610,Shishkin; Denis,10,0,35,25
1683288899499,ECON 110A,A01,185612,Staff,11,0,40,29
1683288900528,ECON 120A,A01,185615,Staff,20,0,40,20
1683288901556,ECON 120C,A01,185617,Sun; Yixiao,0,20,70,70
1683288902586,ECON 144,A00,203346,Squires; Dale E,3,0,35,32
1683288903612,ECON 171,A01,203349,Newhouse; Herbert S,0,1,35,35
1683288904645,ECON 173A,A01,185621,Toda; Alexis Akira,21,0,35,14
1683288905675,EDS 25,A01,202413,Staff,0,1,0,0
1683288905675,EDS 25,A02,202414,Staff,0,1,0,0
1683288905675,EDS 25,A03,202415,Staff,0,0,0,0
1683288905675,EDS 25,A04,202416,Staff,0,1,0,0
1683288905675,EDS 25,A05,202439,Staff,0,0,0,0
1683288905675,EDS 25,A06,202440,Staff,0,0,0,0
1683288905675,EDS 25,B01,202631,Staff,0,0,0,0
1683288905675,EDS 25,B02,202632,Staff,0,0,0,0
1683288905675,EDS 25,B03,202639,Staff,0,0,0,0
1683288905675,EDS 25,B04,202640,Staff,0,0,0,0
1683288905675,EDS 25,B05,202643,Staff,0,0,0,0
1683288905675,EDS 25,B06,202644,Staff,0,0,0,0
1683288906707,EDS 38,A01,202659,Black; Alison Michelle,24,0,25,1
1683288907731,EDS 115,A00,202652,Staff,17,0,30,13
1683288908760,EDS 125,A00,202649,Staff,14,0,30,16
1683288909795,EDS 126,A01,203332,Staff,30,0,30,0
1683288910823,EDS 139,A00,202838,Staff,17,0,25,8
1683288911849,EDS 146,A01,202655,Staff,15,0,25,10
1683288912879,ENG 15,A00,185667,Staff,0,1,0,0
1683288912879,ENG 15,B00,185672,Staff,0,0,0,0
1683288912879,ENG 15,C00,185675,Staff,0,0,0,0
1683288912879,ENG 15,D00,185682,Staff,0,0,0,0
1683288912879,ENG 15,E00,185684,Staff,0,0,0,0
1683288913904,ETHN 103,A00,185710,Staff,0,3,35,35
1683288914931,ETHN 103A,A00,199228,Man; Simeon S,3,0,9,6
1683288915956,ETHN 109,A00,185711,Staff,18,0,35,17
1683288916980,ETHN 142,A00,185726,Staff,0,4,30,30
1683288918006,ETHN 163J,A00,199229,Man; Simeon S,6,0,8,2
1683288919034,ETHN 168,A00,185727,Staff,8,0,10,2
1683288920059,ETHN 182,A00,185728,Staff,1,0,35,34
1683288921083,ETHN 183,A00,185737,Staff,8,0,18,10
1683288922113,GLBH 111,A01,209361,Burgos; Jose L.,0,0,0,0
1683288924168,HIEU 104,A00,185792,Staff,16,0,20,4
1683288925197,HIEU 115,A00,185800,Staff,1,0,20,19
1683288926224,HIEU 128,A00,185801,Staff,0,7,20,20
1683288927251,HIEU 147,A00,185802,Staff,16,0,20,4
1683288928277,HIEU 154,A00,185823,Staff,12,0,20,8
1683288929305,HILA 102,A00,185826,Staff,13,0,20,7
1683288930344,HILD 2C,A01,185778,Staff,0,12,20,20
1683288931371,HILD 7B,A01,185780,Kwak; Nancy,0,15,32,32
1683288931371,HILD 7B,A02,185781,Kwak; Nancy,0,18,32,32
1683288932400,HILD 30,A01,185791,Staff,14,0,20,6
1683288933426,HISC 119,A00,185830,Golan; Tal,0,9,20,20
1683288934450,HITO 156GS,A00,185831,Patterson; Patrick H.,0,0,0,23
1683288935480,HIUS 103,A00,185832,Man; Simeon S,0,7,20,20
1683288936509,HIUS 117,A00,185836,Kwak; Nancy,2,0,20,18
1683288937534,HIUS 125,A00,185840,Man; Simeon S,0,0,23,23
1683288938564,HIUS 149,A00,185845,Staff,0,0,20,20
1683288939593,HUM 3,A01,185882,Zavodny; Tatiana Sophia,0,6,50,50
1683288939593,HUM 3,B01,185899,Caldwell; Michael Alan,0,19,50,50
1683288940619,HUM 3GS,A00,185900,Patterson; Patrick H.,0,0,0,23
1683288941653,HUM 4,A01,185938,Zroka; Amy Liane,31,0,50,19
1683288941653,HUM 4,B01,185956,Watkins; Eric,0,2,50,50
1683288941653,HUM 4,B02,202209,Watkins; Eric,0,1,50,50
1683288941653,HUM 4,B03,202210,Watkins; Eric,0,0,50,50
1683288942679,HUM 5,A01,185958,West; Geoffrey Scott,5,0,50,45
1683288942679,HUM 5,A02,202215,West; Geoffrey Scott,0,0,50,50
1683288943705,INTL 190,A00,185959,Gagnon; Jeffrey C,0,0,0,9
1683288943705,INTL 190,B00,185960,Lettieri; Michael Joseph,0,0,0,1
1683288944730,JAPN 180,A00,254509,Staff,0,1,25,25
1683288945757,LATI 10,A01,202853,Kennemore; Amy Michelle,5,0,35,30
1683288945757,LATI 10,A02,202854,Kennemore; Amy Michelle,1,0,35,34
1683288945757,LATI 10,A03,270054,Kennemore; Amy Michelle,30,0,30,0
1683288946785,LATI 180,A00,202855,Kennemore; Amy Michelle,11,0,20,9
1683288947814,LAWS 101,A00,201767,Golan; Tal,0,7,40,40
1683288948844,LIFR 1C,A00,185961,Staff,6,0,20,14
1683288949869,LIFR 1CX,A00,185962,Staff,7,0,20,13
1683288950897,LIFR 1D,A00,185963,Staff,9,0,20,11
1683288951922,LIFR 1DX,A00,185964,Staff,9,0,20,11
1683288952947,LIGN 101,A01,186039,Staff,43,0,50,7
1683288953972,LIGN 165,A00,186040,Staff,18,0,50,32
1683288954998,LTCS 108,A00,186041,Staff,6,0,10,4
1683288956031,LTCS 119,A00,186042,Staff,16,0,20,4
1683288957056,LTCS 130,A00,186043,Wesling; Megan E.,15,0,25,10
1683288959113,LTEA 138,A00,186119,Staff,14,0,40,26
1683288960142,LTEN 124,A00,186148,Staff,6,0,25,19
1683288961167,LTEN 178,A00,186149,Staff,7,0,15,8
1683288962193,LTEN 181,A00,186150,Blanco; John D,33,0,40,7
1683288963223,LTWL 120,A00,186160,Staff,20,0,25,5
1683288964251,LTWL 165,A00,186161,Staff,22,0,25,3
1683288965277,LTWR 100,A00,186162,Staff,0,4,15,15
1683288966309,LTWR 102,A00,186163,Doller; Ben,5,0,15,10
1683288967335,MAE 8,A01,186412,Staff,0,0,0,0
1683288968425,MAE 30B,A00,186445,Bahadori; Mohammad Yousef,83,0,100,17
1683288969451,MAE 40,A00,186592,Bewley; Thomas R,9,0,50,41
1683288970480,MAE 101B,A00,186593,Bahadori; Mohammad Yousef,81,0,100,19
1683288971504,MAE 105,A00,186594,Bandaru; Prabhakar,12,0,50,38
1683288972530,MAE 107,A00,186599,Pham; Hieu Tan,0,6,120,120
1683288973556,MAE 148,A01,186660,Silberman; Jack,3,0,16,13
1683288974590,MATH 10A,A01,188095,Staff,0,7,35,35
1683288975622,MATH 10B,A01,188097,Bowers; Adam R.,0,11,30,30
1683288975622,MATH 10B,A02,188099,Bowers; Adam R.,0,9,30,30
1683288975622,MATH 10B,B01,188104,Bowers; Adam R.,0,11,30,30
1683288975622,MATH 10B,B02,188106,Bowers; Adam R.,0,11,30,30
1683288976650,MATH 10C,A01,188111,Staff,0,18,30,30
1683288976650,MATH 10C,A02,188127,Staff,0,17,30,30
1683288976650,MATH 10C,A03,188131,Staff,0,17,30,30
1683288976650,MATH 10C,B01,188218,Staff,21,0,30,9
1683288976650,MATH 10C,B02,188244,Staff,13,0,30,17
1683288976650,MATH 10C,B03,188277,Staff,16,0,30,14
1683288977676,MATH 18,A01,188344,Bach; Quang Tran,18,0,30,12
1683288977676,MATH 18,A02,188345,Bach; Quang Tran,11,0,30,19
1683288977676,MATH 18,B01,188353,Bach; Quang Tran,10,0,30,20
1683288977676,MATH 18,B02,188354,Bach; Quang Tran,20,0,30,10
1683288978701,MATH 20A,A01,188374,Staff,13,0,35,22
1683288979728,MATH 20B,A01,188382,Ohm; Ko Woon,6,0,30,24
1683288979728,MATH 20B,A02,188383,Ohm; Ko Woon,24,0,30,6
1683288979728,MATH 20B,B01,188385,Ohm; Ko Woon,7,0,30,23
1683288979728,MATH 20B,B02,188392,Ohm; Ko Woon,22,0,30,8
1683288980754,MATH 20C,A01,188394,Harel; Guershon,10,0,30,20
1683288980754,MATH 20C,A02,188395,Harel; Guershon,13,0,30,17
1683288980754,MATH 20C,B01,188404,Harel; Guershon,3,0,30,27
1683288980754,MATH 20C,B02,188405,Harel; Guershon,19,0,30,11
1683288981782,MATH 20D,A01,188414,Hammock; Frances H,0,1,30,30
1683288981782,MATH 20D,A02,188415,Hammock; Frances H,4,0,30,26
1683288981782,MATH 20D,B01,188447,Hammock; Frances H,2,0,30,28
1683288981782,MATH 20D,B02,188486,Hammock; Frances H,8,0,30,22
1683288982809,MATH 20E,A01,188649,Staff,22,0,30,8
1683288982809,MATH 20E,A02,188650,Staff,23,0,30,7
1683288982809,MATH 20E,A03,188673,Staff,0,0,30,30
1683288983836,MATH 102,A01,188675,Staff,0,35,35,35
1683288984868,MATH 103B,A01,188681,Staff,4,0,35,31
1683288984868,MATH 103B,B01,188692,Staff,8,0,35,27
1683288985893,MATH 109,A01,188695,Salehi Golsefidy; Alireza,25,0,35,10
1683288985893,MATH 109,A02,188696,Salehi Golsefidy; Alireza,27,0,35,8
1683288986929,MATH 120A,A01,188698,Eggers; John Dietrich,5,0,35,30
1683288987956,MATH 142B,A01,188736,Ioana; Adrian,0,2,30,30
1683288987956,MATH 142B,A02,188741,Ioana; Adrian,0,1,30,30
1683288987956,MATH 142B,A03,188743,Ioana; Adrian,0,3,30,30
1683288988982,MATH 168A,A01,188790,Staff,0,8,35,35
1683288990017,MATH 170A,A01,188803,Nie; Jiawang,0,2,35,35
1683288990017,MATH 170A,A02,188811,Nie; Jiawang,0,0,35,35
1683288990017,MATH 170A,A03,188814,Nie; Jiawang,1,0,35,34
1683288990017,MATH 170A,A04,188815,Nie; Jiawang,14,0,35,21
1683288991043,MATH 193B,A01,188817,Staff,0,0,35,35
1683288991043,MATH 193B,A02,188818,Staff,5,0,35,30
1683288992071,MGT 4,A01,202857,Anderson; John Charles,62,0,80,18
1683288993102,MGT 12,A00,202858,Lindenberger; Wade Douglas,43,0,90,47
1683288994126,MGT 18,A00,202859,Staff,74,0,90,16
1683288995153,MGT 18GS,A00,202860,McKay; Michael J,13,0,28,15
1683288996180,MGT 45,A00,202861,Pecore; Joseph P.,14,0,90,76
1683288997204,MGT 100,A00,202863,Yavorsky; Daniel Ryan,28,0,90,62
1683288998231,MGT 103,A00,202864,Ehrich; Kristine R,0,16,90,90
1683288999259,MGT 112,A00,202865,Ehrich; Kristine R,15,0,90,75
1683289000287,MGT 121A,A00,202868,Staff,0,19,0,0
1683289001313,MGT 131B,A00,202869,Anderson; John Charles,60,0,90,30
1683289002340,MGT 136,A00,202871,Lindenberger; Wade Douglas,84,0,90,6
1683289003367,MGT 164,A00,202873,Staff,0,69,90,90
1683289004393,MGT 164GS,A00,202874,McKay; Mary A,13,0,28,15
1683289005422,MGT 180,A00,202875,Staff,0,51,90,90
1683289006446,MMW 11R,A01,205019,Herbst; Matthew,3,0,30,27
1683289006446,MMW 11R,A02,205026,Herbst; Matthew,29,0,30,1
1683289007471,MMW 15,A01,193512,Chang; Edmond Yi-Teh,0,9,28,28
1683289007471,MMW 15,A02,193513,Chang; Edmond Yi-Teh,0,5,28,28
1683289007471,MMW 15,A03,193514,Chang; Edmond Yi-Teh,0,5,28,28
1683289007471,MMW 15,A04,193515,Chang; Edmond Yi-Teh,0,4,28,28
1683289007471,MMW 15,A05,193516,Chang; Edmond Yi-Teh,0,4,28,28
1683289007471,MMW 15,A06,193517,Chang; Edmond Yi-Teh,0,5,28,28
1683289007471,MMW 15,B01,193519,Chang; Edmond Yi-Teh,0,4,28,28
1683289007471,MMW 15,B02,193520,Chang; Edmond Yi-Teh,0,5,28,28
1683289007471,MMW 15,B03,193521,Chang; Edmond Yi-Teh,0,4,28,28
1683289007471,MMW 15,B04,193522,Chang; Edmond Yi-Teh,0,4,28,28
1683289007471,MMW 15,B05,193523,Chang; Edmond Yi-Teh,0,5,28,28
1683289007471,MMW 15,B06,193524,Chang; Edmond Yi-Teh,0,4,28,28
1683289008498,MMW 122,A01,193526,Rahimi; Babak,0,14,28,28
1683289008498,MMW 122,A02,193527,Rahimi; Babak,0,14,28,28
1683289008498,MMW 122,A03,193528,Rahimi; Babak,0,0,0,0
1683289008498,MMW 122,A04,193529,Rahimi; Babak,0,0,0,0
1683289009524,MUS 1A,A01,186663,Staff,0,20,35,35
1683289010551,MUS 4,A01,186715,Staff,0,12,35,35
1683289011580,MUS 5R,A01,186796,Dubnov; Shlomo,0,16,35,35
1683289012605,MUS 6,A01,186798,Staff,0,3,25,25
1683289013629,MUS 7,A01,186830,Staff,12,0,35,23
1683289014656,MUS 8,A01,186930,Staff,0,25,35,35
1683289015685,MUS 15,A01,186932,Staff,0,15,35,35
1683289015685,MUS 15,B01,186934,Staff,0,14,35,35
1683289016711,MUS 80,A00,186935,Staff,2,0,20,18
1683289016711,MUS 80,B00,186936,Staff,25,0,25,0
1683289017742,NANO 11,A00,204702,Lipomi; Darren John,0,0,0,0
1683289018768,NANO 15,A01,204709,Yang; Kesong,0,1,0,0
1683289019794,NANO 114,A00,202069,Jahed Motlagh; Zeinab,3,0,10,7
1683289020825,PHIL 1,A00,186955,Grush; Rick Scott,32,0,40,8
1683289021862,PHIL 10,A01,186973,Grush; Rick Scott,29,0,35,6
1683289021862,PHIL 10,A02,186974,Grush; Rick Scott,33,0,35,2
1683289022889,PHIL 13,A01,186976,Staff,7,0,35,28
1683289022889,PHIL 13,A02,186977,Staff,16,0,35,19
1683289023916,PHIL 14,A01,186979,Staff,31,0,35,4
1683289023916,PHIL 14,A02,186986,Staff,32,0,35,3
1683289024946,PHIL 28,A01,186988,Staff,16,0,30,14
1683289024946,PHIL 28,A02,186989,Staff,1,0,30,29
1683289024946,PHIL 28,A03,186990,Staff,9,0,30,21
1683289024946,PHIL 28,A04,186991,Staff,26,0,30,4
1683289025972,PHIL 120,A00,186997,Staff,23,0,40,17
1683289026998,PHIL 137,A00,187003,Staff,9,0,40,31
1683289028027,PHIL 150,A00,187015,Staff,47,0,70,23
1683289029053,PHIL 167,A00,187021,Lamey; Andy M.,35,0,40,5
1683289030082,PHIL 174,A01,202226,Staff,17,0,20,3
1683289030082,PHIL 174,A02,202235,Staff,20,0,20,0
1683289031108,PHIL 191A,A00,258918,Staff,0,0,1,1
1683289032137,PHYS 1A,A00,187028,Staff,26,0,60,34
1683289033162,PHYS 1AL,001,187036,Staff,2,0,30,28
1683289033162,PHYS 1AL,002,187049,Staff,18,0,30,12
1683289034188,PHYS 1B,A00,187058,Staff,23,0,60,37
1683289035217,PHYS 1BL,001,187064,Staff,0,0,30,30
1683289035217,PHYS 1BL,002,187070,Staff,6,0,30,24
1683289036245,PHYS 1C,A00,187082,Staff,32,0,120,88
1683289037277,PHYS 1CL,001,187088,Staff,0,9,30,30
1683289037277,PHYS 1CL,002,187089,Staff,0,2,30,30
1683289037277,PHYS 1CL,009,262693,Staff,12,0,30,18
1683289038316,PHYS 2B,A01,187097,Staff,54,0,115,61
1683289039342,PHYS 2C,A01,187099,Staff,67,0,115,48
1683289040372,PHYS 2CL,A01,187101,Staff,5,0,28,23
1683289040372,PHYS 2CL,A02,187102,Staff,15,0,28,13
1683289041403,PHYS 2D,A01,187123,Shotwell; Brian,95,0,115,20
1683289042428,PHYS 4B,A01,187133,Grinstein; Benjamin,35,0,50,15
1683289043455,POLI 10,A00,188819,Staff,0,3,50,50
1683289044484,POLI 11,A00,188827,Staff,43,0,50,7
1683289045509,POLI 13R,A00,188828,Staff,0,1,20,20
1683289046541,POLI 27,A01,188830,Elgin; Samuel Zincke,0,1,70,70
1683289047573,POLI 30,A00,188832,Desposato; Scott,33,0,50,17
1683289048598,POLI 102F,A00,188834,Staff,3,0,40,37
1683289049626,POLI 104A,A00,188852,Staff,14,0,30,16
1683289050652,POLI 104I,A00,188853,Staff,0,6,20,20
1683289051677,POLI 110B,A00,188854,Wiens; David,7,0,20,13
1683289052702,POLI 112A,A00,188855,Wiens; David,5,0,30,25
1683289053732,POLI 117R,A00,188856,Forman; Fonna,0,11,20,20
1683289054761,POLI 118,A00,188857,Ingham; Sean,8,0,20,12
1683289055788,POLI 120G,A00,188858,Staff,9,0,30,21
1683289056816,POLI 131CR,A00,188863,Hoston; Germaine,24,0,50,26
1683289057846,POLI 133,A00,188864,Nellis; Gareth Hb,44,0,50,6
1683289058871,POLI 134D,A00,188865,Desposato; Scott,27,0,30,3
1683289059902,POLI 142A,A00,188871,Gartzke; Erik,22,0,50,28
1683289060933,POLI 142K,A00,188874,Staff,38,0,50,12
1683289061961,POLI 143,A00,188940,Gartzke; Erik,16,0,30,14
1683289062987,POLI 153,A00,188943,Staff,3,0,20,17
1683289064012,POLI 160AA,A00,188944,Staff,13,0,40,27
1683289065038,POLI 170A,A00,188945,Staff,11,0,30,19
1683289067089,PSYC 1,A00,188952,Staff,38,0,90,52
1683289068116,PSYC 2,B00,188953,Staff,20,0,35,15
1683289069145,PSYC 6,A00,188970,Staff,47,0,60,13
1683289070168,PSYC 7,A00,188973,Staff,37,0,45,8
1683289071200,PSYC 60,A01,188980,Rickard; Timothy C.,43,0,60,17
1683289072285,PSYC 70,A01,189001,Steiner; Eric Tomas,24,0,45,21
1683289073319,PSYC 100,A00,189005,Lacefield; Katharine I,0,99,120,120
1683289074344,PSYC 102,A00,189008,Staff,10,0,30,20
1683289075373,PSYC 106,B00,189026,Gorman; Michael R.,37,0,60,23
1683289076401,PSYC 114,B01,189033,Winkielman; Piotr,0,32,30,30
1683289077428,PSYC 131,A00,189036,Anagnostaras; Stephan,0,43,60,60
1683289078459,PSYC 136,A00,189041,Lowe; Angela Beth,0,7,25,25
1683289079484,PSYC 137,A00,189057,Winkielman; Piotr,0,34,25,25
1683289080515,PSYC 144,A00,189107,Wixted; John T,0,7,50,50
1683289082570,PSYC 162,A00,189142,Staff,0,8,85,85
1683289083600,PSYC 172,A00,189144,Gorman; Michael R.,0,7,30,30
1683289085656,PSYC 179,A00,189146,Lacefield; Katharine I,0,84,120,120
1683289086682,PSYC 181,A00,189147,Anagnostaras; Stephan,0,44,90,90
1683289087707,PSYC 190R,A00,189148,Barner; David A.,0,22,80,80
1683289088736,PSYC 191,A00,189275,Rickard; Timothy C.,0,7,25,25
1683289089766,PSYC 193,A00,189276,Chapman; Eddie Nathaniel,0,1,0,4
1683289090792,PSYC 193L,A01,189281,Lowe; Angela Beth,12,0,20,8
1683289090792,PSYC 193L,B01,189285,Staff,28,0,35,7
1683289091818,RELI 149,A00,187137,Rahimi; Babak,7,0,40,33
1683289092848,SE 9,A01,187315,Staff,0,2,18,18
1683289093874,SE 101B,A00,187409,Staff,24,0,30,6
1683289094899,SE 110B,A00,187444,Staff,10,0,40,30
1683289095929,SE 130B,A00,187449,Staff,31,0,40,9
1683289096956,SE 150A,A00,187516,Staff,9,0,20,11
1683289097981,SE 154,A00,187528,Staff,30,0,50,20
1683289099007,SIO 3,A01,258171,Staff,35,0,40,5
1683289100037,SIO 10,A00,187144,Cook; Geoffrey W,0,3,75,75
1683289101065,SIO 45,A00,187152,Cook; Geoffrey W,1,0,100,99
1683289102093,SIO 109R,A00,194486,Staff,0,3,20,20
1683289104151,SIO 187,A01,187233,Kacev; David,12,0,40,28
1683289105183,SOCI 1,A01,258656,Thorpe; Charles Robert,28,0,30,2
1683289105183,SOCI 1,A02,258658,Thorpe; Charles Robert,30,0,30,0
1683289105183,SOCI 1,A03,258661,Thorpe; Charles Robert,25,0,25,0
1683289105183,SOCI 1,A04,258666,Thorpe; Charles Robert,22,0,25,3
1683289105183,SOCI 1,A05,258897,Thorpe; Charles Robert,23,0,25,2
1683289105183,SOCI 1,A06,258898,Thorpe; Charles Robert,25,0,25,0
1683289106215,SOCI 30,A01,258903,Pardo Guerra; Juan Pablo,16,0,30,14
1683289107241,SOCI 102,A00,258904,Staff,9,0,25,16
1683289108265,SOCI 106,A00,258905,Staff,19,0,25,6
1683289109296,SOCI 111,A00,258907,Ribas Norris; Janet Vanesa,26,0,30,4
1683289110321,SOCI 121R,A00,258908,Pardo Guerra; Juan Pablo,11,0,30,19
1683289111348,SOCI 126,A01,203330,Staff,14,0,20,6
1683289112373,SOCI 131,A00,258909,Thorpe; Charles Robert,31,0,60,29
1683289113398,SOCI 135,A00,258910,Payne; Christine Anna,0,9,30,30
1683289114426,SOCI 157,A00,258911,Staff,13,0,30,17
1683289115452,SOCI 184,A00,258912,Staff,26,0,30,4
1683289116482,SOCI 188D,A00,258913,Staff,21,0,30,9
1683289117509,SYN 2,001,187529,Staff,9,0,16,7
1683289117509,SYN 2,002,201452,Staff,0,18,16,16
1683289117509,SYN 2,003,201469,Staff,3,0,16,13
1683289118533,SYN 100,A01,187531,Staff,0,9,20,20
1683289118533,SYN 100,B01,201491,Staff,0,12,20,20
1683289119564,TDAC 1,A00,189286,Walsh; Kim C.,3,0,20,17
1683289119564,TDAC 1,B00,189287,Harting; Carla Kelso,11,0,20,9
1683289120591,TDAC 101,A00,189300,Walsh; Kim C.,16,0,20,4
1683289120591,TDAC 101,B00,189301,Harting; Carla Kelso,18,0,20,2
1683289121620,TDAC 102,A00,189304,Basso; Beatrice,14,0,20,6
1683289122645,TDAC 108,A00,189305,Staff,18,0,20,2
1683289123672,TDDE 131,A00,189310,Staff,19,0,20,1
1683289123672,TDDE 131,B00,189314,Staff,19,0,20,1
1683289123672,TDDE 131,C00,189315,Staff,48,0,50,2
1683289123672,TDDE 131,D00,189316,Staff,14,0,15,1
1683289123672,TDDE 131,E00,204841,Staff,20,0,20,0
1683289124702,TDGE 10,A00,189289,Staff,30,0,50,20
1683289124702,TDGE 10,B00,189290,Havis; Allan,2,0,50,48
1683289125735,TDGE 11,A00,189291,Fulton; Julia,0,3,50,50
1683289125735,TDGE 11,B00,189292,Staff,20,0,25,5
1683289125735,TDGE 11,C00,260270,Staff,0,0,0,0
1683289126763,TDGE 25,A00,189294,Staff,3,0,20,17
1683289127789,TDGE 124,A00,189318,Fulton; Julia,0,8,50,50
1683289128813,TDGE 125,A00,189319,Staff,13,0,25,12
1683289128813,TDGE 125,B00,189320,Staff,23,0,25,2
1683289129843,TDGE 127,A00,189322,Havis; Allan,0,0,50,50
1683289130869,TDHT 101,A00,189323,Staff,18,0,25,7
1683289130869,TDHT 101,B00,189324,Staff,25,0,25,0
1683289131898,TDHT 102,A00,189325,Staff,49,0,50,1
1683289132930,TDMV 1,A00,189295,Arcidiacono; Kristin,20,0,30,10
1683289132930,TDMV 1,B00,189296,Caligagan; Maria T.,24,0,30,6
1683289133957,TDMV 2,A00,189297,Sammartano; Tonnie,28,0,30,2
1683289133957,TDMV 2,B00,189299,Arcidiacono; Kristin,24,0,30,6
1683289134994,TDMV 3,A00,204998,Rincon; Alicia,22,0,30,8
1683289136020,TDMV 120,A00,189458,Sammartano; Tonnie,28,0,30,2
1683289137047,TDMV 138,A00,189541,Jun; Grace Shin Hae,22,0,40,18
1683289138074,TDMV 142,A00,189717,Caligagan; Tony,23,0,30,7
1683289138074,TDMV 142,B00,189718,Caligagan; Maria T.,25,0,30,5
1683289139104,TMC 2,A01,187533,Staff,25,0,25,0
1683289139104,TMC 2,A02,187534,Staff,25,0,25,0
1683289140134,USP 1,A01,187536,Kwak; Nancy,0,16,25,25
1683289141164,USP 5,A01,187538,Staff,9,0,25,16
1683289142190,USP 101,A00,199253,Staff,0,4,0,0
1683289143226,USP 124,A00,187562,Boomhower; Matthew Charles,1,0,30,29
1683289144251,USP 138,A00,187582,Staff,20,0,25,5
1683289145277,USP 152,A01,187597,Staff,4,0,25,21
1683289146307,USP 153,A00,187598,Staff,19,0,25,6
1683289147331,USP 168,A00,187607,Kwak; Nancy,2,0,5,3
1683289148360,USP 173,A00,187619,Staff,4,0,25,21
1683289149389,USP 181,A00,187638,Staff,0,0,25,25
1683289150415,VIS 103,A00,187650,Cruz; Edwin Teddy,23,0,75,52
1683289151440,VIS 110D,A00,187669,Staff,12,0,22,10
1683289152470,VIS 127C,A00,187720,Shen; Kuiyi,68,0,146,78
1683289153499,VIS 149,A00,187731,Yoldas; Pinar,0,14,22,22
1683289154524,VIS 151,A01,188091,Staff,22,0,34,12
1683289154524,VIS 151,A02,188092,Staff,11,0,34,23
1683289155554,VIS 160B,A00,188093,Stalbaum; Brett,0,0,10,10
1683289157606,WCWP 10B,A00,201720,Staff,10,0,15,5
1683289157606,WCWP 10B,B00,201722,Staff,8,0,15,7
1683289158632,WCWP 100,A00,201725,Gagnon; Jeffrey C,0,0,2,2
1683289158632,WCWP 100,B00,201727,Staff,0,4,15,15
1683289161812,ANBI 133,A00,258401,Wilder; Linnea Lorene,34,0,40,6
1683289162839,ANBI 140,A00,258395,Hrvoj Mihic; Branka,18,0,25,7
1683289163866,ANSC 120,A00,258402,Bialecki; Jon Anthony,27,0,40,13
1683289164894,ANSC 144,A00,258400,Staff,14,0,40,26
1683289166946,ANSC 166,A00,258396,Parish; Steven Martin,157,0,175,18
1683289167975,ANSC 180,A00,193533,Staff,9,0,20,11
1683289169000,ANSC 188,A00,258397,Jassal; Aftab,33,0,40,7
1683289170030,ANTH 3,A01,258316,Staff,23,0,30,7
1683289171060,ANTH 5,A00,258394,Semendeferi; Ekaterini,16,0,20,4
1683289172088,ANTH 21,A01,258331,Staff,9,0,40,31
1683289173114,ANTH 103,A00,258398,Varma; Saiba,15,0,25,10
1683289174149,AWP 10,001,202034,Staff,0,0,0,0
1683289174149,AWP 10,002,202035,Staff,0,0,0,0
1683289174149,AWP 10,003,202036,Staff,0,0,0,0
1683289174149,AWP 10,004,202037,Staff,0,0,0,0
1683289174149,AWP 10,005,202038,Staff,0,0,0,0
1683289174149,AWP 10,006,202039,Staff,0,0,0,0
1683289174149,AWP 10,007,202040,Staff,0,0,0,0
1683289174149,AWP 10,008,202041,Staff,0,0,0,0
1683289174149,AWP 10,009,202042,Staff,0,0,0,0
1683289174149,AWP 10,010,202043,Staff,0,0,0,0
1683289174149,AWP 10,011,202044,Staff,0,0,0,0
1683289174149,AWP 10,012,202045,Staff,0,0,0,0
1683289174149,AWP 10,013,202046,Staff,0,0,0,0
1683289174149,AWP 10,014,202047,Staff,0,0,0,0
1683289174149,AWP 10,015,202048,Staff,0,0,0,0
1683289174149,AWP 10,016,202049,Staff,0,0,0,0
1683289174149,AWP 10,017,202050,Staff,0,0,0,0
1683289174149,AWP 10,018,202051,Staff,0,0,0,0
1683289174149,AWP 10,019,202052,Staff,0,0,0,0
1683289174149,AWP 10,020,202053,Staff,0,0,0,0
1683289174149,AWP 10,021,202054,Staff,0,0,0,0
1683289174149,AWP 10,022,202055,Staff,0,0,0,0
1683289174149,AWP 10,023,202056,Staff,0,0,0,0
1683289174149,AWP 10,024,202057,Staff,0,0,0,0
1683289174149,AWP 10,025,202058,Staff,0,0,0,0
1683289174149,AWP 10,026,202059,Staff,0,0,0,0
1683289175191,AWP 102,001,202032,Staff,0,0,0,0
1683289175191,AWP 102,002,202033,Staff,0,0,0,0
1683289176273,BENG 100,A01,254234,Taylor Amos; Alyssa C,31,0,40,9
1683289177300,BENG 196,001,270013,Engler; Adam J.,9999,0,9999,0
1683289178327,BICD 100R,A01,202018,Smith; Laurie,0,7,32,32
1683289178327,BICD 100R,A02,202019,Smith; Laurie,0,2,32,32
1683289178327,BICD 100R,A03,202020,Smith; Laurie,0,1,32,32
1683289178327,BICD 100R,A04,202021,Smith; Laurie,8,0,32,24
1683289178327,BICD 100R,A05,202022,Smith; Laurie,12,0,32,20
1683289179355,BICD 136,A01,193242,Gustafson-Brown; Cindy,0,2,32,32
1683289179355,BICD 136,A02,193244,Gustafson-Brown; Cindy,15,0,32,17
1683289180386,BIEB 102,A01,193249,Butler; Shannon Rhey,0,2,32,32
1683289180386,BIEB 102,A02,193251,Butler; Shannon Rhey,0,0,32,32
1683289180386,BIEB 102,A03,193253,Butler; Shannon Rhey,0,1,32,32
1683289180386,BIEB 102,A04,193255,Butler; Shannon Rhey,17,0,32,15
1683289180386,BIEB 102,A05,193265,Butler; Shannon Rhey,26,0,32,6
1683289180386,BIEB 102,A06,193269,Butler; Shannon Rhey,16,0,32,16
1683289182441,BIEB 150,A01,193274,Staff,0,0,32,32
1683289182441,BIEB 150,A02,193285,Staff,24,0,32,8
1683289183465,BIEB 194,A00,193286,Kurle; Carolyn M.,22,0,32,10
1683289184497,BILD 1,A01,192291,Staff,16,0,32,16
1683289184497,BILD 1,A02,192292,Staff,30,0,32,2
1683289184497,BILD 1,B01,192520,Reuther; Keefe,0,1,0,0
1683289184497,BILD 1,B02,192532,Reuther; Keefe,0,1,0,0
1683289185529,BILD 3,A01,192556,Butler; Shannon Rhey,0,0,32,32
1683289185529,BILD 3,A02,192581,Butler; Shannon Rhey,5,0,32,27
1683289185529,BILD 3,A03,192611,Butler; Shannon Rhey,23,0,32,9
1683289185529,BILD 3,A04,192612,Butler; Shannon Rhey,25,0,32,7
1683289185529,BILD 3,A05,192613,Butler; Shannon Rhey,27,0,32,5
1683289185529,BILD 3,A06,192679,Butler; Shannon Rhey,27,0,32,5
1683289185529,BILD 3,A07,192682,Butler; Shannon Rhey,22,0,32,10
1683289186554,BILD 4,A01,192836,Reuther; Keefe,1,0,24,23
1683289186554,BILD 4,A02,193044,Reuther; Keefe,4,0,24,20
1683289187579,BILD 10,A01,193142,Gustafson-Brown; Cindy,31,0,32,1
1683289187579,BILD 10,A02,193149,Gustafson-Brown; Cindy,31,0,32,1
1683289188605,BIMM 100,A01,193301,Staff,0,6,32,32
1683289188605,BIMM 100,A02,193312,Staff,0,5,32,32
1683289188605,BIMM 100,A03,193323,Staff,0,8,32,32
1683289189631,BIMM 101,A01,193329,McDonnell; Lisa Marie,0,3,24,24
1683289189631,BIMM 101,A02,193339,McDonnell; Lisa Marie,0,2,24,24
1683289189631,BIMM 101,B01,193354,McDonnell; Lisa Marie,0,3,24,24
1683289189631,BIMM 101,B02,193357,McDonnell; Lisa Marie,0,3,24,24
1683289190657,BIMM 110,A01,193377,Tat; John,0,11,32,32
1683289190657,BIMM 110,A02,193378,Tat; John,1,9,32,31
1683289191683,BIMM 120,A01,206116,Staff,0,0,32,32
1683289191683,BIMM 120,A02,206117,Staff,8,0,32,24
1683289191683,BIMM 120,A03,206121,Staff,21,0,32,11
1683289192710,BIPN 100,A01,193393,Park; Ji Young,0,14,32,32
1683289192710,BIPN 100,A02,193402,Park; Ji Young,0,12,32,32
1683289192710,BIPN 100,A03,193413,Park; Ji Young,0,14,32,32
1683289192710,BIPN 100,A04,193414,Park; Ji Young,0,13,32,32
1683289193734,BIPN 102,A01,193429,Staff,0,0,32,32
1683289193734,BIPN 102,A02,193438,Staff,23,0,32,9
1683289194760,BIPN 106,A01,193450,Reyes Gonzalez; Catalina,0,2,40,40
1683289195790,BIPN 134,A01,193465,Cooke; James Edward,0,0,32,32
1683289195790,BIPN 134,A02,193474,Cooke; James Edward,27,0,32,5
1683289195790,BIPN 134,A03,193485,Cooke; James Edward,29,0,32,3
1683289195790,BIPN 134,A04,193486,Cooke; James Edward,21,0,32,11
1683289195790,BIPN 134,A05,193491,Cooke; James Edward,31,0,32,1
1683289195790,BIPN 134,A06,193501,Cooke; James Edward,30,0,32,2
1683289195790,BIPN 134,A07,193510,Cooke; James Edward,29,0,32,3
1683289197842,BISP 194,A00,222522,Staff,16,0,32,16
1683289198868,CAT 124,A01,202407,Staff,20,0,25,5
1683289199893,CAT 125,A00,202408,Marchisotto; Jennifer Anne,4,0,20,16
1683289200927,CAT 125R,A00,202409,Smith; Lauryn Alissa,0,11,20,20
1683289200927,CAT 125R,B00,202410,Morales; Celeste Georgianna,0,11,20,20
1683289200927,CAT 125R,C00,202411,Irwin; Matthew Joseph,0,10,20,20
1683289201954,CENG 15,A01,204712,Yang; Kesong,0,1,0,0
1683289202979,CENG 114,A00,202070,Jahed Motlagh; Zeinab,5,0,20,15
1683289204008,CGS 105,A00,185477,Wesling; Megan E.,24,0,40,16
1683289205032,CGS 106,A00,185494,Staff,13,0,22,9
1683289206060,CGS 108,A00,185495,Staff,14,0,20,6
1683289207086,CGS 114,A00,185496,Staff,13,0,18,5
1683289208112,CGS 119,A00,185501,Staff,15,0,20,5
1683289209139,CGS 120,A00,185511,Staff,13,0,20,7
1683289210167,CHEM 4,A01,184675,Bussey; Thomas J,96,0,100,4
1683289211193,CHEM 6A,A01,184677,Staff,35,0,60,25
1683289212217,CHEM 6B,A01,184679,Staff,65,0,100,35
1683289213241,CHEM 6C,A01,184681,Bussey; Thomas J,1,0,50,49
1683289213241,CHEM 6C,A02,184682,Bussey; Thomas J,34,0,50,16
1683289214267,CHEM 40A,A01,184684,Albizati; Kim F.,37,0,100,63
1683289215296,CHEM 40B,A01,184686,Albizati; Kim F.,0,20,100,100
1683289216325,CHEM 41B,A01,184690,Staff,52,0,100,48
1683289217354,COGS 3,A01,184715,Boyle; Mary E. T.,0,25,40,40
1683289218379,COGS 14B,A01,185172,Staff,0,15,38,38
1683289219410,COGS 18,A01,184736,Staff,20,0,80,60
1683289220445,COGS 100,A01,184932,Staff,0,5,73,73
1683289221470,COGS 101A,A01,184935,Staff,0,38,30,30
1683289222498,COGS 101B,A01,184944,Staff,0,2,30,30
1683289223523,COGS 101C,A01,184946,Staff,0,12,30,30
1683289224552,COGS 102A,A01,184951,Johnson; Christine M.,2,0,40,38
1683289225578,COGS 107B,A01,184953,Mooshagian; Eric Frederick,0,50,40,40
1683289226608,COGS 118B,A01,184959,Gupta; Anjum,0,48,40,40
1683289227634,COGS 153,A00,184961,Staff,0,15,30,30
1683289228659,COGS 177,A00,184962,Staff,0,21,30,30
1683289229684,COGS 187A,A01,184969,Boyle; Mary E. T.,0,17,40,40
1683289230713,COMM 10,A01,185174,Staff,0,5,25,25
1683289230713,COMM 10,A02,185189,Staff,0,5,25,25
1683289230713,COMM 10,A03,269821,Staff,0,0,0,0
1683289231739,COMM 100B,A01,185475,Staff,0,0,0,2
1683289231739,COMM 100B,A02,185476,Staff,14,0,25,11
1683289232764,COMM 100C,A01,185314,Staff,1,0,25,24
1683289232764,COMM 100C,A02,185327,Staff,19,0,25,6
1683289233792,COMM 110M,A00,185349,Staff,2,0,40,38
1683289234820,COMM 113T,A00,185352,Staff,25,0,40,15
1683289235847,COMM 114I,A00,185353,Staff,33,0,40,7
1683289236872,COMM 131,A00,185354,Staff,19,0,30,11
1683289237902,CSE 8A,A50,185358,Cao; Yingjun,0,46,10,10
1683289238930,CSE 8B,A01,185362,Staff,0,47,50,50
1683289239955,CSE 11,A01,185416,Cao; Yingjun,0,93,10,10
1683289240983,CSE 20,A01,185445,Briones; Jor-el Thomas Caparas,5,0,25,20
1683289242008,CSE 21,A01,185447,Staff,10,0,50,40
1683289243033,CSE 101,A01,185451,Staff,0,12,50,50
1683289243033,CSE 101,B01,185453,Jones; Miles E,0,11,50,50
1683289245085,CSE 141,A01,185458,Eldon; John,20,0,100,80
1683289246112,CSE 141L,A01,185461,Eldon; John,12,0,100,88
1683289247137,CSE 142,A01,185463,Staff,35,0,60,25
1683289247137,CSE 142,B01,201355,Staff,0,6,60,60
1683289248162,CSE 142L,A01,185470,Staff,35,0,60,25
1683289248162,CSE 142L,B01,201417,Staff,0,5,60,60
1683289249185,CSE 190,A00,201433,Staff,32,0,49,17
1683289250214,DOC 1,A01,259136,Strom; Megan C.,8,0,15,7
1683289250214,DOC 1,A02,259137,Strom; Megan C.,14,0,15,1
1683289250214,DOC 1,A03,259138,Strom; Megan C.,14,0,15,1
1683289250214,DOC 1,A04,259139,Strom; Megan C.,14,0,15,1
1683289251244,DOC 100D,A00,259140,Pass; Natalye Joann,17,0,25,8
1683289252272,DSGN 1,A01,184749,Rill; Bryan,0,24,30,30
1683289253301,DSGN 100,A01,185168,Staff,0,2,25,25
1683289254327,ECE 5,A01,185626,Morris; Karcher William,0,10,0,0
1683289255350,ECE 101,A01,185628,Staff,17,0,70,53
1683289256376,ECE 107,A01,185635,Baghdadchi; Saharnaz,0,0,20,20
1683289256376,ECE 107,A02,185638,Baghdadchi; Saharnaz,4,0,20,16
1683289257402,ECE 148,A01,185647,Silberman; Jack,1,0,16,15
1683289258430,ECON 1,A01,185537,Crane; Meredith Helen,54,0,70,16
1683289259455,ECON 3,A01,185549,Crane; Meredith Helen,33,0,70,37
1683289260479,ECON 4,A01,203354,Anderson; John Charles,0,4,10,10
1683289261505,ECON 100A,A01,185574,Staff,0,4,40,40
1683289262530,ECON 100B,A01,185576,Staff,0,22,40,40
1683289263557,ECON 100C,A01,185589,Newhouse; Herbert S,30,0,70,40
1683289264585,ECON 105,A00,185608,Vespa; Emanuel Ignacio,19,0,35,16
1683289265612,ECON 109,A01,185610,Shishkin; Denis,10,0,35,25
1683289266641,ECON 110A,A01,185612,Staff,11,0,40,29
1683289267667,ECON 120A,A01,185615,Staff,20,0,40,20
1683289268697,ECON 120C,A01,185617,Sun; Yixiao,0,20,70,70
1683289269727,ECON 144,A00,203346,Squires; Dale E,3,0,35,32
1683289270753,ECON 171,A01,203349,Newhouse; Herbert S,0,1,35,35
1683289271778,ECON 173A,A01,185621,Toda; Alexis Akira,21,0,35,14
1683289272808,EDS 25,A01,202413,Staff,0,1,0,0
1683289272808,EDS 25,A02,202414,Staff,0,1,0,0
1683289272808,EDS 25,A03,202415,Staff,0,0,0,0
1683289272808,EDS 25,A04,202416,Staff,0,1,0,0
1683289272808,EDS 25,A05,202439,Staff,0,0,0,0
1683289272808,EDS 25,A06,202440,Staff,0,0,0,0
1683289272808,EDS 25,B01,202631,Staff,0,0,0,0
1683289272808,EDS 25,B02,202632,Staff,0,0,0,0
1683289272808,EDS 25,B03,202639,Staff,0,0,0,0
1683289272808,EDS 25,B04,202640,Staff,0,0,0,0
1683289272808,EDS 25,B05,202643,Staff,0,0,0,0
1683289272808,EDS 25,B06,202644,Staff,0,0,0,0
1683289273833,EDS 38,A01,202659,Black; Alison Michelle,24,0,25,1
1683289274862,EDS 115,A00,202652,Staff,17,0,30,13
1683289275890,EDS 125,A00,202649,Staff,14,0,30,16
1683289276917,EDS 126,A01,203332,Staff,30,0,30,0
1683289277945,EDS 139,A00,202838,Staff,17,0,25,8
1683289278975,EDS 146,A01,202655,Staff,15,0,25,10
1683289280056,ENG 15,A00,185667,Staff,0,1,0,0
1683289280056,ENG 15,B00,185672,Staff,0,0,0,0
1683289280056,ENG 15,C00,185675,Staff,0,0,0,0
1683289280056,ENG 15,D00,185682,Staff,0,0,0,0
1683289280056,ENG 15,E00,185684,Staff,0,0,0,0
1683289281086,ETHN 103,A00,185710,Staff,0,3,35,35
1683289282117,ETHN 103A,A00,199228,Man; Simeon S,3,0,9,6
1683289283147,ETHN 109,A00,185711,Staff,18,0,35,17
1683289284173,ETHN 142,A00,185726,Staff,0,4,30,30
1683289285204,ETHN 163J,A00,199229,Man; Simeon S,6,0,8,2
1683289286232,ETHN 168,A00,185727,Staff,8,0,10,2
1683289287258,ETHN 182,A00,185728,Staff,1,0,35,34
1683289288287,ETHN 183,A00,185737,Staff,8,0,18,10
1683289289318,GLBH 111,A01,209361,Burgos; Jose L.,0,0,0,0
1683289291373,HIEU 104,A00,185792,Staff,16,0,20,4
1683289292409,HIEU 115,A00,185800,Staff,1,0,20,19
1683289293439,HIEU 128,A00,185801,Staff,0,7,20,20
1683289294468,HIEU 147,A00,185802,Staff,16,0,20,4
1683289295494,HIEU 154,A00,185823,Staff,12,0,20,8
1683289296517,HILA 102,A00,185826,Staff,13,0,20,7
1683289297543,HILD 2C,A01,185778,Staff,0,12,20,20
1683289298576,HILD 7B,A01,185780,Kwak; Nancy,0,15,32,32
1683289298576,HILD 7B,A02,185781,Kwak; Nancy,0,18,32,32
1683289299606,HILD 30,A01,185791,Staff,14,0,20,6
1683289300636,HISC 119,A00,185830,Golan; Tal,0,9,20,20
1683289301662,HITO 156GS,A00,185831,Patterson; Patrick H.,0,0,0,23
1683289302692,HIUS 103,A00,185832,Man; Simeon S,0,7,20,20
1683289303719,HIUS 117,A00,185836,Kwak; Nancy,2,0,20,18
1683289304744,HIUS 125,A00,185840,Man; Simeon S,0,0,23,23
1683289305769,HIUS 149,A00,185845,Staff,0,0,20,20
1683289306796,HUM 3,A01,185882,Zavodny; Tatiana Sophia,0,6,50,50
1683289306796,HUM 3,B01,185899,Caldwell; Michael Alan,0,19,50,50
1683289307821,HUM 3GS,A00,185900,Patterson; Patrick H.,0,0,0,23
1683289308856,HUM 4,A01,185938,Zroka; Amy Liane,31,0,50,19
1683289308856,HUM 4,B01,185956,Watkins; Eric,0,2,50,50
1683289308856,HUM 4,B02,202209,Watkins; Eric,0,1,50,50
1683289308856,HUM 4,B03,202210,Watkins; Eric,0,0,50,50
1683289309891,HUM 5,A01,185958,West; Geoffrey Scott,5,0,50,45
1683289309891,HUM 5,A02,202215,West; Geoffrey Scott,0,0,50,50
1683289310921,INTL 190,A00,185959,Gagnon; Jeffrey C,0,0,0,9
1683289310921,INTL 190,B00,185960,Lettieri; Michael Joseph,0,0,0,1
1683289311949,JAPN 180,A00,254509,Staff,0,1,25,25
1683289312978,LATI 10,A01,202853,Kennemore; Amy Michelle,5,0,35,30
1683289312978,LATI 10,A02,202854,Kennemore; Amy Michelle,1,0,35,34
1683289312978,LATI 10,A03,270054,Kennemore; Amy Michelle,30,0,30,0
1683289314005,LATI 180,A00,202855,Kennemore; Amy Michelle,11,0,20,9
1683289315031,LAWS 101,A00,201767,Golan; Tal,0,7,40,40
1683289316056,LIFR 1C,A00,185961,Staff,6,0,20,14
1683289317087,LIFR 1CX,A00,185962,Staff,7,0,20,13
1683289318110,LIFR 1D,A00,185963,Staff,9,0,20,11
1683289319136,LIFR 1DX,A00,185964,Staff,9,0,20,11
1683289320166,LIGN 101,A01,186039,Staff,43,0,50,7
1683289321194,LIGN 165,A00,186040,Staff,18,0,50,32
1683289322221,LTCS 108,A00,186041,Staff,6,0,10,4
1683289323247,LTCS 119,A00,186042,Staff,16,0,20,4
1683289324273,LTCS 130,A00,186043,Wesling; Megan E.,15,0,25,10
1683289326323,LTEA 138,A00,186119,Staff,14,0,40,26
1683289327351,LTEN 124,A00,186148,Staff,6,0,25,19
1683289328381,LTEN 178,A00,186149,Staff,7,0,15,8
1683289329409,LTEN 181,A00,186150,Blanco; John D,33,0,40,7
1683289330433,LTWL 120,A00,186160,Staff,20,0,25,5
1683289331459,LTWL 165,A00,186161,Staff,22,0,25,3
1683289332487,LTWR 100,A00,186162,Staff,0,4,15,15
1683289333517,LTWR 102,A00,186163,Doller; Ben,5,0,15,10
1683289334548,MAE 8,A01,186412,Staff,0,0,0,0
1683289335579,MAE 30B,A00,186445,Bahadori; Mohammad Yousef,83,0,100,17
1683289336608,MAE 40,A00,186592,Bewley; Thomas R,9,0,50,41
1683289337635,MAE 101B,A00,186593,Bahadori; Mohammad Yousef,81,0,100,19
1683289338662,MAE 105,A00,186594,Bandaru; Prabhakar,12,0,50,38
1683289339688,MAE 107,A00,186599,Pham; Hieu Tan,0,6,120,120
1683289340713,MAE 148,A01,186660,Silberman; Jack,3,0,16,13
1683289341742,MATH 10A,A01,188095,Staff,0,7,35,35
1683289342774,MATH 10B,A01,188097,Bowers; Adam R.,0,11,30,30
1683289342774,MATH 10B,A02,188099,Bowers; Adam R.,0,9,30,30
1683289342774,MATH 10B,B01,188104,Bowers; Adam R.,0,11,30,30
1683289342774,MATH 10B,B02,188106,Bowers; Adam R.,0,11,30,30
1683289343802,MATH 10C,A01,188111,Staff,0,18,30,30
1683289343802,MATH 10C,A02,188127,Staff,0,17,30,30
1683289343802,MATH 10C,A03,188131,Staff,0,17,30,30
1683289343802,MATH 10C,B01,188218,Staff,21,0,30,9
1683289343802,MATH 10C,B02,188244,Staff,13,0,30,17
1683289343802,MATH 10C,B03,188277,Staff,16,0,30,14
1683289344828,MATH 18,A01,188344,Bach; Quang Tran,18,0,30,12
1683289344828,MATH 18,A02,188345,Bach; Quang Tran,11,0,30,19
1683289344828,MATH 18,B01,188353,Bach; Quang Tran,10,0,30,20
1683289344828,MATH 18,B02,188354,Bach; Quang Tran,20,0,30,10
1683289345857,MATH 20A,A01,188374,Staff,13,0,35,22
1683289346886,MATH 20B,A01,188382,Ohm; Ko Woon,6,0,30,24
1683289346886,MATH 20B,A02,188383,Ohm; Ko Woon,24,0,30,6
1683289346886,MATH 20B,B01,188385,Ohm; Ko Woon,7,0,30,23
1683289346886,MATH 20B,B02,188392,Ohm; Ko Woon,22,0,30,8
1683289347919,MATH 20C,A01,188394,Harel; Guershon,10,0,30,20
1683289347919,MATH 20C,A02,188395,Harel; Guershon,13,0,30,17
1683289347919,MATH 20C,B01,188404,Harel; Guershon,3,0,30,27
1683289347919,MATH 20C,B02,188405,Harel; Guershon,19,0,30,11
1683289348947,MATH 20D,A01,188414,Hammock; Frances H,0,1,30,30
1683289348947,MATH 20D,A02,188415,Hammock; Frances H,4,0,30,26
1683289348947,MATH 20D,B01,188447,Hammock; Frances H,2,0,30,28
1683289348947,MATH 20D,B02,188486,Hammock; Frances H,8,0,30,22
1683289349973,MATH 20E,A01,188649,Staff,22,0,30,8
1683289349973,MATH 20E,A02,188650,Staff,23,0,30,7
1683289349973,MATH 20E,A03,188673,Staff,0,0,30,30
1683289350998,MATH 102,A01,188675,Staff,0,35,35,35
1683289352025,MATH 103B,A01,188681,Staff,4,0,35,31
1683289352025,MATH 103B,B01,188692,Staff,8,0,35,27
1683289353051,MATH 109,A01,188695,Salehi Golsefidy; Alireza,25,0,35,10
1683289353051,MATH 109,A02,188696,Salehi Golsefidy; Alireza,27,0,35,8
1683289354083,MATH 120A,A01,188698,Eggers; John Dietrich,5,0,35,30
1683289355114,MATH 142B,A01,188736,Ioana; Adrian,0,2,30,30
1683289355114,MATH 142B,A02,188741,Ioana; Adrian,0,1,30,30
1683289355114,MATH 142B,A03,188743,Ioana; Adrian,0,3,30,30
1683289356141,MATH 168A,A01,188790,Staff,0,8,35,35
1683289357174,MATH 170A,A01,188803,Nie; Jiawang,0,2,35,35
1683289357174,MATH 170A,A02,188811,Nie; Jiawang,0,0,35,35
1683289357174,MATH 170A,A03,188814,Nie; Jiawang,1,0,35,34
1683289357174,MATH 170A,A04,188815,Nie; Jiawang,14,0,35,21
1683289358200,MATH 193B,A01,188817,Staff,0,0,35,35
1683289358200,MATH 193B,A02,188818,Staff,5,0,35,30
1683289359227,MGT 4,A01,202857,Anderson; John Charles,62,0,80,18
1683289360253,MGT 12,A00,202858,Lindenberger; Wade Douglas,43,0,90,47
1683289361279,MGT 18,A00,202859,Staff,74,0,90,16
1683289362305,MGT 18GS,A00,202860,McKay; Michael J,13,0,28,15
1683289363330,MGT 45,A00,202861,Pecore; Joseph P.,14,0,90,76
1683289364359,MGT 100,A00,202863,Yavorsky; Daniel Ryan,28,0,90,62
1683289365389,MGT 103,A00,202864,Ehrich; Kristine R,0,16,90,90
1683289366416,MGT 112,A00,202865,Ehrich; Kristine R,15,0,90,75
1683289367444,MGT 121A,A00,202868,Staff,0,19,0,0
1683289368470,MGT 131B,A00,202869,Anderson; John Charles,60,0,90,30
1683289369500,MGT 136,A00,202871,Lindenberger; Wade Douglas,84,0,90,6
1683289370529,MGT 164,A00,202873,Staff,0,69,90,90
1683289371559,MGT 164GS,A00,202874,McKay; Mary A,13,0,28,15
1683289372587,MGT 180,A00,202875,Staff,0,51,90,90
1683289373615,MMW 11R,A01,205019,Herbst; Matthew,3,0,30,27
1683289373615,MMW 11R,A02,205026,Herbst; Matthew,29,0,30,1
1683289374642,MMW 15,A01,193512,Chang; Edmond Yi-Teh,0,9,28,28
1683289374642,MMW 15,A02,193513,Chang; Edmond Yi-Teh,0,5,28,28
1683289374642,MMW 15,A03,193514,Chang; Edmond Yi-Teh,0,5,28,28
1683289374642,MMW 15,A04,193515,Chang; Edmond Yi-Teh,0,4,28,28
1683289374642,MMW 15,A05,193516,Chang; Edmond Yi-Teh,0,4,28,28
1683289374642,MMW 15,A06,193517,Chang; Edmond Yi-Teh,0,5,28,28
1683289374642,MMW 15,B01,193519,Chang; Edmond Yi-Teh,0,4,28,28
1683289374642,MMW 15,B02,193520,Chang; Edmond Yi-Teh,0,5,28,28
1683289374642,MMW 15,B03,193521,Chang; Edmond Yi-Teh,0,4,28,28
1683289374642,MMW 15,B04,193522,Chang; Edmond Yi-Teh,0,4,28,28
1683289374642,MMW 15,B05,193523,Chang; Edmond Yi-Teh,0,5,28,28
1683289374642,MMW 15,B06,193524,Chang; Edmond Yi-Teh,0,4,28,28
1683289375668,MMW 122,A01,193526,Rahimi; Babak,0,14,28,28
1683289375668,MMW 122,A02,193527,Rahimi; Babak,0,14,28,28
1683289375668,MMW 122,A03,193528,Rahimi; Babak,0,0,0,0
1683289375668,MMW 122,A04,193529,Rahimi; Babak,0,0,0,0
1683289376693,MUS 1A,A01,186663,Staff,0,20,35,35
1683289377722,MUS 4,A01,186715,Staff,0,12,35,35
1683289378752,MUS 5R,A01,186796,Dubnov; Shlomo,0,16,35,35
1683289379778,MUS 6,A01,186798,Staff,0,3,25,25
1683289380805,MUS 7,A01,186830,Staff,12,0,35,23
1683289381833,MUS 8,A01,186930,Staff,0,25,35,35
1683289382860,MUS 15,A01,186932,Staff,0,15,35,35
1683289382860,MUS 15,B01,186934,Staff,0,14,35,35
1683289383958,MUS 80,A00,186935,Staff,2,0,20,18
1683289383958,MUS 80,B00,186936,Staff,25,0,25,0
1683289384985,NANO 11,A00,204702,Lipomi; Darren John,0,0,0,0
1683289386016,NANO 15,A01,204709,Yang; Kesong,0,1,0,0
1683289387046,NANO 114,A00,202069,Jahed Motlagh; Zeinab,3,0,10,7
1683289388082,PHIL 1,A00,186955,Grush; Rick Scott,32,0,40,8
1683289389108,PHIL 10,A01,186973,Grush; Rick Scott,29,0,35,6
1683289389108,PHIL 10,A02,186974,Grush; Rick Scott,33,0,35,2
1683289390132,PHIL 13,A01,186976,Staff,7,0,35,28
1683289390132,PHIL 13,A02,186977,Staff,16,0,35,19
1683289391161,PHIL 14,A01,186979,Staff,31,0,35,4
1683289391161,PHIL 14,A02,186986,Staff,32,0,35,3
1683289392191,PHIL 28,A01,186988,Staff,16,0,30,14
1683289392191,PHIL 28,A02,186989,Staff,1,0,30,29
1683289392191,PHIL 28,A03,186990,Staff,9,0,30,21
1683289392191,PHIL 28,A04,186991,Staff,26,0,30,4
1683289393216,PHIL 120,A00,186997,Staff,23,0,40,17
1683289394245,PHIL 137,A00,187003,Staff,9,0,40,31
1683289395273,PHIL 150,A00,187015,Staff,47,0,70,23
1683289396299,PHIL 167,A00,187021,Lamey; Andy M.,35,0,40,5
1683289397326,PHIL 174,A01,202226,Staff,17,0,20,3
1683289397326,PHIL 174,A02,202235,Staff,20,0,20,0
1683289398355,PHIL 191A,A00,258918,Staff,0,0,1,1
1683289399380,PHYS 1A,A00,187028,Staff,26,0,60,34
1683289400405,PHYS 1AL,001,187036,Staff,2,0,30,28
1683289400405,PHYS 1AL,002,187049,Staff,18,0,30,12
1683289401432,PHYS 1B,A00,187058,Staff,23,0,60,37
1683289402460,PHYS 1BL,001,187064,Staff,0,0,30,30
1683289402460,PHYS 1BL,002,187070,Staff,6,0,30,24
1683289403486,PHYS 1C,A00,187082,Staff,32,0,120,88
1683289404516,PHYS 1CL,001,187088,Staff,0,9,30,30
1683289404516,PHYS 1CL,002,187089,Staff,0,2,30,30
1683289404516,PHYS 1CL,009,262693,Staff,12,0,30,18
1683289405541,PHYS 2B,A01,187097,Staff,54,0,115,61
1683289406567,PHYS 2C,A01,187099,Staff,67,0,115,48
1683289407599,PHYS 2CL,A01,187101,Staff,5,0,28,23
1683289407599,PHYS 2CL,A02,187102,Staff,15,0,28,13
1683289408632,PHYS 2D,A01,187123,Shotwell; Brian,95,0,115,20
1683289409662,PHYS 4B,A01,187133,Grinstein; Benjamin,35,0,50,15
1683289410688,POLI 10,A00,188819,Staff,0,3,50,50
1683289411716,POLI 11,A00,188827,Staff,43,0,50,7
1683289412744,POLI 13R,A00,188828,Staff,0,1,20,20
1683289413771,POLI 27,A01,188830,Elgin; Samuel Zincke,0,1,70,70
1683289414797,POLI 30,A00,188832,Desposato; Scott,33,0,50,17
1683289415824,POLI 102F,A00,188834,Staff,3,0,40,37
1683289416850,POLI 104A,A00,188852,Staff,14,0,30,16
1683289417878,POLI 104I,A00,188853,Staff,0,6,20,20
1683289418910,POLI 110B,A00,188854,Wiens; David,7,0,20,13
1683289419940,POLI 112A,A00,188855,Wiens; David,5,0,30,25
1683289420970,POLI 117R,A00,188856,Forman; Fonna,0,11,20,20
1683289422000,POLI 118,A00,188857,Ingham; Sean,8,0,20,12
1683289423032,POLI 120G,A00,188858,Staff,9,0,30,21
1683289424062,POLI 131CR,A00,188863,Hoston; Germaine,24,0,50,26
1683289425089,POLI 133,A00,188864,Nellis; Gareth Hb,44,0,50,6
1683289426115,POLI 134D,A00,188865,Desposato; Scott,27,0,30,3
1683289427141,POLI 142A,A00,188871,Gartzke; Erik,22,0,50,28
1683289428167,POLI 142K,A00,188874,Staff,38,0,50,12
1683289429195,POLI 143,A00,188940,Gartzke; Erik,16,0,30,14
1683289430221,POLI 153,A00,188943,Staff,3,0,20,17
1683289431247,POLI 160AA,A00,188944,Staff,13,0,40,27
1683289432276,POLI 170A,A00,188945,Staff,11,0,30,19
1683289434328,PSYC 1,A00,188952,Staff,38,0,90,52
1683289435357,PSYC 2,B00,188953,Staff,20,0,35,15
1683289436383,PSYC 6,A00,188970,Staff,47,0,60,13
1683289437410,PSYC 7,A00,188973,Staff,37,0,45,8
1683289438436,PSYC 60,A01,188980,Rickard; Timothy C.,43,0,60,17
1683289439462,PSYC 70,A01,189001,Steiner; Eric Tomas,24,0,45,21
1683289440488,PSYC 100,A00,189005,Lacefield; Katharine I,0,99,120,120
1683289441514,PSYC 102,A00,189008,Staff,10,0,30,20
1683289442544,PSYC 106,B00,189026,Gorman; Michael R.,37,0,60,23
1683289443577,PSYC 114,B01,189033,Winkielman; Piotr,0,32,30,30
1683289444608,PSYC 131,A00,189036,Anagnostaras; Stephan,0,43,60,60
1683289445639,PSYC 136,A00,189041,Lowe; Angela Beth,0,7,25,25
1683289446665,PSYC 137,A00,189057,Winkielman; Piotr,0,34,25,25
1683289447692,PSYC 144,A00,189107,Wixted; John T,0,7,50,50
1683289449747,PSYC 162,A00,189142,Staff,0,8,85,85
1683289450776,PSYC 172,A00,189144,Gorman; Michael R.,0,7,30,30
1683289452828,PSYC 179,A00,189146,Lacefield; Katharine I,0,84,120,120
1683289453859,PSYC 181,A00,189147,Anagnostaras; Stephan,0,44,90,90
1683289454887,PSYC 190R,A00,189148,Barner; David A.,0,22,80,80
1683289455914,PSYC 191,A00,189275,Rickard; Timothy C.,0,7,25,25
1683289456940,PSYC 193,A00,189276,Chapman; Eddie Nathaniel,0,1,0,4
1683289457966,PSYC 193L,A01,189281,Lowe; Angela Beth,12,0,20,8
1683289457966,PSYC 193L,B01,189285,Staff,28,0,35,7
1683289458992,RELI 149,A00,187137,Rahimi; Babak,7,0,40,33
1683289460018,SE 9,A01,187315,Staff,0,2,18,18
1683289461042,SE 101B,A00,187409,Staff,24,0,30,6
1683289462069,SE 110B,A00,187444,Staff,10,0,40,30
1683289463094,SE 130B,A00,187449,Staff,31,0,40,9
1683289464120,SE 150A,A00,187516,Staff,9,0,20,11
1683289465145,SE 154,A00,187528,Staff,30,0,50,20
1683289466171,SIO 3,A01,258171,Staff,35,0,40,5
1683289467200,SIO 10,A00,187144,Cook; Geoffrey W,0,3,75,75
1683289468228,SIO 45,A00,187152,Cook; Geoffrey W,1,0,100,99
1683289469257,SIO 109R,A00,194486,Staff,0,3,20,20
1683289471311,SIO 187,A01,187233,Kacev; David,12,0,40,28
1683289472339,SOCI 1,A01,258656,Thorpe; Charles Robert,28,0,30,2
1683289472339,SOCI 1,A02,258658,Thorpe; Charles Robert,30,0,30,0
1683289472339,SOCI 1,A03,258661,Thorpe; Charles Robert,25,0,25,0
1683289472339,SOCI 1,A04,258666,Thorpe; Charles Robert,22,0,25,3
1683289472339,SOCI 1,A05,258897,Thorpe; Charles Robert,23,0,25,2
1683289472339,SOCI 1,A06,258898,Thorpe; Charles Robert,25,0,25,0
1683289473368,SOCI 30,A01,258903,Pardo Guerra; Juan Pablo,16,0,30,14
1683289474393,SOCI 102,A00,258904,Staff,9,0,25,16
1683289475420,SOCI 106,A00,258905,Staff,19,0,25,6
1683289476449,SOCI 111,A00,258907,Ribas Norris; Janet Vanesa,26,0,30,4
1683289477478,SOCI 121R,A00,258908,Pardo Guerra; Juan Pablo,11,0,30,19
1683289478508,SOCI 126,A01,203330,Staff,14,0,20,6
1683289479535,SOCI 131,A00,258909,Thorpe; Charles Robert,31,0,60,29
1683289480562,SOCI 135,A00,258910,Payne; Christine Anna,0,9,30,30
1683289481587,SOCI 157,A00,258911,Staff,13,0,30,17
1683289482613,SOCI 184,A00,258912,Staff,26,0,30,4
1683289483637,SOCI 188D,A00,258913,Staff,21,0,30,9
1683289484665,SYN 2,001,187529,Staff,9,0,16,7
1683289484665,SYN 2,002,201452,Staff,0,18,16,16
1683289484665,SYN 2,003,201469,Staff,3,0,16,13
1683289485690,SYN 100,A01,187531,Staff,0,9,20,20
1683289485690,SYN 100,B01,201491,Staff,0,12,20,20
1683289486716,TDAC 1,A00,189286,Walsh; Kim C.,3,0,20,17
1683289486716,TDAC 1,B00,189287,Harting; Carla Kelso,11,0,20,9
1683289487799,TDAC 101,A00,189300,Walsh; Kim C.,16,0,20,4
1683289487799,TDAC 101,B00,189301,Harting; Carla Kelso,18,0,20,2
1683289488829,TDAC 102,A00,189304,Basso; Beatrice,14,0,20,6
1683289489858,TDAC 108,A00,189305,Staff,18,0,20,2
1683289490894,TDDE 131,A00,189310,Staff,19,0,20,1
1683289490894,TDDE 131,B00,189314,Staff,19,0,20,1
1683289490894,TDDE 131,C00,189315,Staff,48,0,50,2
1683289490894,TDDE 131,D00,189316,Staff,14,0,15,1
1683289490894,TDDE 131,E00,204841,Staff,20,0,20,0
1683289491919,TDGE 10,A00,189289,Staff,30,0,50,20
1683289491919,TDGE 10,B00,189290,Havis; Allan,2,0,50,48
1683289492947,TDGE 11,A00,189291,Fulton; Julia,0,3,50,50
1683289492947,TDGE 11,B00,189292,Staff,20,0,25,5
1683289492947,TDGE 11,C00,260270,Staff,0,0,0,0
1683289493971,TDGE 25,A00,189294,Staff,3,0,20,17
1683289494997,TDGE 124,A00,189318,Fulton; Julia,0,8,50,50
1683289496022,TDGE 125,A00,189319,Staff,13,0,25,12
1683289496022,TDGE 125,B00,189320,Staff,23,0,25,2
1683289497048,TDGE 127,A00,189322,Havis; Allan,0,0,50,50
1683289498074,TDHT 101,A00,189323,Staff,18,0,25,7
1683289498074,TDHT 101,B00,189324,Staff,25,0,25,0
1683289499101,TDHT 102,A00,189325,Staff,49,0,50,1
1683289500128,TDMV 1,A00,189295,Arcidiacono; Kristin,20,0,30,10
1683289500128,TDMV 1,B00,189296,Caligagan; Maria T.,24,0,30,6
1683289501157,TDMV 2,A00,189297,Sammartano; Tonnie,28,0,30,2
1683289501157,TDMV 2,B00,189299,Arcidiacono; Kristin,24,0,30,6
1683289502186,TDMV 3,A00,204998,Rincon; Alicia,22,0,30,8
1683289503212,TDMV 120,A00,189458,Sammartano; Tonnie,28,0,30,2
1683289504237,TDMV 138,A00,189541,Jun; Grace Shin Hae,22,0,40,18
1683289505263,TDMV 142,A00,189717,Caligagan; Tony,23,0,30,7
1683289505263,TDMV 142,B00,189718,Caligagan; Maria T.,25,0,30,5
1683289506289,TMC 2,A01,187533,Staff,25,0,25,0
1683289506289,TMC 2,A02,187534,Staff,25,0,25,0
1683289507321,USP 1,A01,187536,Kwak; Nancy,0,16,25,25
1683289508352,USP 5,A01,187538,Staff,9,0,25,16
1683289509385,USP 101,A00,199253,Staff,0,4,0,0
1683289510410,USP 124,A00,187562,Boomhower; Matthew Charles,1,0,30,29
1683289511436,USP 138,A00,187582,Staff,20,0,25,5
1683289512466,USP 152,A01,187597,Staff,4,0,25,21
1683289513494,USP 153,A00,187598,Staff,19,0,25,6
1683289514520,USP 168,A00,187607,Kwak; Nancy,2,0,5,3
1683289515559,USP 173,A00,187619,Staff,4,0,25,21
1683289516586,USP 181,A00,187638,Staff,0,0,25,25
1683289517615,VIS 103,A00,187650,Cruz; Edwin Teddy,23,0,75,52
1683289518644,VIS 110D,A00,187669,Staff,12,0,22,10
1683289519676,VIS 127C,A00,187720,Shen; Kuiyi,68,0,146,78
1683289520701,VIS 149,A00,187731,Yoldas; Pinar,0,14,22,22
1683289521728,VIS 151,A01,188091,Staff,22,0,34,12
1683289521728,VIS 151,A02,188092,Staff,11,0,34,23
1683289522753,VIS 160B,A00,188093,Stalbaum; Brett,0,0,10,10
1683289524810,WCWP 10B,A00,201720,Staff,10,0,15,5
1683289524810,WCWP 10B,B00,201722,Staff,8,0,15,7
1683289525837,WCWP 100,A00,201725,Gagnon; Jeffrey C,0,0,2,2
1683289525837,WCWP 100,B00,201727,Staff,0,4,15,15
1683289529001,ANBI 133,A00,258401,Wilder; Linnea Lorene,34,0,40,6
1683289530028,ANBI 140,A00,258395,Hrvoj Mihic; Branka,18,0,25,7
1683289531053,ANSC 120,A00,258402,Bialecki; Jon Anthony,27,0,40,13
1683289532076,ANSC 144,A00,258400,Staff,14,0,40,26
1683289534134,ANSC 166,A00,258396,Parish; Steven Martin,157,0,175,18
1683289535163,ANSC 180,A00,193533,Staff,9,0,20,11
1683289536189,ANSC 188,A00,258397,Jassal; Aftab,33,0,40,7
1683289537215,ANTH 3,A01,258316,Staff,23,0,30,7
1683289538241,ANTH 5,A00,258394,Semendeferi; Ekaterini,16,0,20,4
1683289539267,ANTH 21,A01,258331,Staff,9,0,40,31
1683289540293,ANTH 103,A00,258398,Varma; Saiba,15,0,25,10
1683289541324,AWP 10,001,202034,Staff,0,0,0,0
1683289541324,AWP 10,002,202035,Staff,0,0,0,0
1683289541324,AWP 10,003,202036,Staff,0,0,0,0
1683289541324,AWP 10,004,202037,Staff,0,0,0,0
1683289541324,AWP 10,005,202038,Staff,0,0,0,0
1683289541324,AWP 10,006,202039,Staff,0,0,0,0
1683289541324,AWP 10,007,202040,Staff,0,0,0,0
1683289541324,AWP 10,008,202041,Staff,0,0,0,0
1683289541324,AWP 10,009,202042,Staff,0,0,0,0
1683289541324,AWP 10,010,202043,Staff,0,0,0,0
1683289541324,AWP 10,011,202044,Staff,0,0,0,0
1683289541324,AWP 10,012,202045,Staff,0,0,0,0
1683289541324,AWP 10,013,202046,Staff,0,0,0,0
1683289541324,AWP 10,014,202047,Staff,0,0,0,0
1683289541324,AWP 10,015,202048,Staff,0,0,0,0
1683289541324,AWP 10,016,202049,Staff,0,0,0,0
1683289541324,AWP 10,017,202050,Staff,0,0,0,0
1683289541324,AWP 10,018,202051,Staff,0,0,0,0
1683289541324,AWP 10,019,202052,Staff,0,0,0,0
1683289541324,AWP 10,020,202053,Staff,0,0,0,0
1683289541324,AWP 10,021,202054,Staff,0,0,0,0
1683289541324,AWP 10,022,202055,Staff,0,0,0,0
1683289541324,AWP 10,023,202056,Staff,0,0,0,0
1683289541324,AWP 10,024,202057,Staff,0,0,0,0
1683289541324,AWP 10,025,202058,Staff,0,0,0,0
1683289541324,AWP 10,026,202059,Staff,0,0,0,0
1683289542352,AWP 102,001,202032,Staff,0,0,0,0
1683289542352,AWP 102,002,202033,Staff,0,0,0,0
1683289543383,BENG 100,A01,254234,Taylor Amos; Alyssa C,31,0,40,9
1683289544413,BENG 196,001,270013,Engler; Adam J.,9999,0,9999,0
1683289545447,BICD 100R,A01,202018,Smith; Laurie,0,7,32,32
1683289545447,BICD 100R,A02,202019,Smith; Laurie,0,2,32,32
1683289545447,BICD 100R,A03,202020,Smith; Laurie,0,1,32,32
1683289545447,BICD 100R,A04,202021,Smith; Laurie,8,0,32,24
1683289545447,BICD 100R,A05,202022,Smith; Laurie,12,0,32,20
1683289546478,BICD 136,A01,193242,Gustafson-Brown; Cindy,0,2,32,32
1683289546478,BICD 136,A02,193244,Gustafson-Brown; Cindy,15,0,32,17
1683289547511,BIEB 102,A01,193249,Butler; Shannon Rhey,0,2,32,32
1683289547511,BIEB 102,A02,193251,Butler; Shannon Rhey,0,0,32,32
1683289547511,BIEB 102,A03,193253,Butler; Shannon Rhey,0,1,32,32
1683289547511,BIEB 102,A04,193255,Butler; Shannon Rhey,17,0,32,15
1683289547511,BIEB 102,A05,193265,Butler; Shannon Rhey,26,0,32,6
1683289547511,BIEB 102,A06,193269,Butler; Shannon Rhey,16,0,32,16
1683289549572,BIEB 150,A01,193274,Staff,0,0,32,32
1683289549572,BIEB 150,A02,193285,Staff,24,0,32,8
1683289550597,BIEB 194,A00,193286,Kurle; Carolyn M.,22,0,32,10
1683289551625,BILD 1,A01,192291,Staff,16,0,32,16
1683289551625,BILD 1,A02,192292,Staff,30,0,32,2
1683289551625,BILD 1,B01,192520,Reuther; Keefe,0,1,0,0
1683289551625,BILD 1,B02,192532,Reuther; Keefe,0,1,0,0
1683289552652,BILD 3,A01,192556,Butler; Shannon Rhey,0,0,32,32
1683289552652,BILD 3,A02,192581,Butler; Shannon Rhey,5,0,32,27
1683289552652,BILD 3,A03,192611,Butler; Shannon Rhey,23,0,32,9
1683289552652,BILD 3,A04,192612,Butler; Shannon Rhey,25,0,32,7
1683289552652,BILD 3,A05,192613,Butler; Shannon Rhey,27,0,32,5
1683289552652,BILD 3,A06,192679,Butler; Shannon Rhey,27,0,32,5
1683289552652,BILD 3,A07,192682,Butler; Shannon Rhey,22,0,32,10
1683289553686,BILD 4,A01,192836,Reuther; Keefe,1,0,24,23
1683289553686,BILD 4,A02,193044,Reuther; Keefe,4,0,24,20
1683289554714,BILD 10,A01,193142,Gustafson-Brown; Cindy,31,0,32,1
1683289554714,BILD 10,A02,193149,Gustafson-Brown; Cindy,31,0,32,1
1683289555743,BIMM 100,A01,193301,Staff,0,6,32,32
1683289555743,BIMM 100,A02,193312,Staff,0,5,32,32
1683289555743,BIMM 100,A03,193323,Staff,0,8,32,32
1683289556776,BIMM 101,A01,193329,McDonnell; Lisa Marie,0,3,24,24
1683289556776,BIMM 101,A02,193339,McDonnell; Lisa Marie,0,2,24,24
1683289556776,BIMM 101,B01,193354,McDonnell; Lisa Marie,0,3,24,24
1683289556776,BIMM 101,B02,193357,McDonnell; Lisa Marie,0,3,24,24
1683289557803,BIMM 110,A01,193377,Tat; John,0,11,32,32
1683289557803,BIMM 110,A02,193378,Tat; John,1,9,32,31
1683289558840,BIMM 120,A01,206116,Staff,0,0,32,32
1683289558840,BIMM 120,A02,206117,Staff,8,0,32,24
1683289558840,BIMM 120,A03,206121,Staff,21,0,32,11
1683289559868,BIPN 100,A01,193393,Park; Ji Young,0,14,32,32
1683289559868,BIPN 100,A02,193402,Park; Ji Young,0,12,32,32
1683289559868,BIPN 100,A03,193413,Park; Ji Young,0,14,32,32
1683289559868,BIPN 100,A04,193414,Park; Ji Young,0,13,32,32
1683289560900,BIPN 102,A01,193429,Staff,0,0,32,32
1683289560900,BIPN 102,A02,193438,Staff,23,0,32,9
1683289561934,BIPN 106,A01,193450,Reyes Gonzalez; Catalina,0,2,40,40
1683289562967,BIPN 134,A01,193465,Cooke; James Edward,0,0,32,32
1683289562967,BIPN 134,A02,193474,Cooke; James Edward,27,0,32,5
1683289562967,BIPN 134,A03,193485,Cooke; James Edward,29,0,32,3
1683289562967,BIPN 134,A04,193486,Cooke; James Edward,21,0,32,11
1683289562967,BIPN 134,A05,193491,Cooke; James Edward,31,0,32,1
1683289562967,BIPN 134,A06,193501,Cooke; James Edward,30,0,32,2
1683289562967,BIPN 134,A07,193510,Cooke; James Edward,29,0,32,3
1683289565018,BISP 194,A00,222522,Staff,16,0,32,16
1683289566044,CAT 124,A01,202407,Staff,20,0,25,5
1683289567074,CAT 125,A00,202408,Marchisotto; Jennifer Anne,4,0,20,16
1683289568103,CAT 125R,A00,202409,Smith; Lauryn Alissa,0,11,20,20
1683289568103,CAT 125R,B00,202410,Morales; Celeste Georgianna,0,11,20,20
1683289568103,CAT 125R,C00,202411,Irwin; Matthew Joseph,0,10,20,20
1683289569130,CENG 15,A01,204712,Yang; Kesong,0,1,0,0
1683289570157,CENG 114,A00,202070,Jahed Motlagh; Zeinab,5,0,20,15
1683289571184,CGS 105,A00,185477,Wesling; Megan E.,24,0,40,16
1683289572213,CGS 106,A00,185494,Staff,13,0,22,9
1683289573241,CGS 108,A00,185495,Staff,14,0,20,6
1683289574271,CGS 114,A00,185496,Staff,13,0,18,5
1683289575300,CGS 119,A00,185501,Staff,15,0,20,5
1683289576326,CGS 120,A00,185511,Staff,13,0,20,7
1683289577354,CHEM 4,A01,184675,Bussey; Thomas J,96,0,100,4
1683289578380,CHEM 6A,A01,184677,Staff,35,0,60,25
1683289579405,CHEM 6B,A01,184679,Staff,65,0,100,35
1683289580435,CHEM 6C,A01,184681,Bussey; Thomas J,1,0,50,49
1683289580435,CHEM 6C,A02,184682,Bussey; Thomas J,34,0,50,16
1683289581465,CHEM 40A,A01,184684,Albizati; Kim F.,37,0,100,63
1683289582494,CHEM 40B,A01,184686,Albizati; Kim F.,0,20,100,100
1683289583522,CHEM 41B,A01,184690,Staff,52,0,100,48
1683289584547,COGS 3,A01,184715,Boyle; Mary E. T.,0,25,40,40
1683289585574,COGS 14B,A01,185172,Staff,0,15,38,38
1683289586604,COGS 18,A01,184736,Staff,20,0,80,60
1683289587635,COGS 100,A01,184932,Staff,0,5,73,73
1683289588665,COGS 101A,A01,184935,Staff,0,38,30,30
1683289589693,COGS 101B,A01,184944,Staff,0,2,30,30
1683289590717,COGS 101C,A01,184946,Staff,0,12,30,30
1683289591802,COGS 102A,A01,184951,Johnson; Christine M.,2,0,40,38
1683289592837,COGS 107B,A01,184953,Mooshagian; Eric Frederick,0,50,40,40
1683289593868,COGS 118B,A01,184959,Gupta; Anjum,0,48,40,40
1683289594894,COGS 153,A00,184961,Staff,0,15,30,30
1683289595925,COGS 177,A00,184962,Staff,0,21,30,30
1683289596948,COGS 187A,A01,184969,Boyle; Mary E. T.,0,17,40,40
1683289597975,COMM 10,A01,185174,Staff,0,5,25,25
1683289597975,COMM 10,A02,185189,Staff,0,5,25,25
1683289597975,COMM 10,A03,269821,Staff,0,0,0,0
1683289599002,COMM 100B,A01,185475,Staff,0,0,0,2
1683289599002,COMM 100B,A02,185476,Staff,14,0,25,11
1683289600028,COMM 100C,A01,185314,Staff,1,0,25,24
1683289600028,COMM 100C,A02,185327,Staff,19,0,25,6
1683289601057,COMM 110M,A00,185349,Staff,2,0,40,38
1683289602087,COMM 113T,A00,185352,Staff,25,0,40,15
1683289603114,COMM 114I,A00,185353,Staff,33,0,40,7
1683289604140,COMM 131,A00,185354,Staff,19,0,30,11
1683289605167,CSE 8A,A50,185358,Cao; Yingjun,0,46,10,10
1683289606193,CSE 8B,A01,185362,Staff,0,47,50,50
1683289607219,CSE 11,A01,185416,Cao; Yingjun,0,93,10,10
1683289608245,CSE 20,A01,185445,Briones; Jor-el Thomas Caparas,5,0,25,20
1683289609284,CSE 21,A01,185447,Staff,10,0,50,40
1683289610312,CSE 101,A01,185451,Staff,0,12,50,50
1683289610312,CSE 101,B01,185453,Jones; Miles E,0,11,50,50
1683289612365,CSE 141,A01,185458,Eldon; John,20,0,100,80
1683289613392,CSE 141L,A01,185461,Eldon; John,12,0,100,88
1683289614422,CSE 142,A01,185463,Staff,35,0,60,25
1683289614422,CSE 142,B01,201355,Staff,0,6,60,60
1683289615451,CSE 142L,A01,185470,Staff,35,0,60,25
1683289615451,CSE 142L,B01,201417,Staff,0,5,60,60
1683289616480,CSE 190,A00,201433,Staff,32,0,49,17
1683289617506,DOC 1,A01,259136,Strom; Megan C.,8,0,15,7
1683289617506,DOC 1,A02,259137,Strom; Megan C.,14,0,15,1
1683289617506,DOC 1,A03,259138,Strom; Megan C.,14,0,15,1
1683289617506,DOC 1,A04,259139,Strom; Megan C.,14,0,15,1
1683289618538,DOC 100D,A00,259140,Pass; Natalye Joann,17,0,25,8
1683289619568,DSGN 1,A01,184749,Rill; Bryan,0,24,30,30
1683289620598,DSGN 100,A01,185168,Staff,0,2,25,25
1683289621632,ECE 5,A01,185626,Morris; Karcher William,0,10,0,0
1683289622658,ECE 101,A01,185628,Staff,17,0,70,53
1683289623684,ECE 107,A01,185635,Baghdadchi; Saharnaz,0,0,20,20
1683289623684,ECE 107,A02,185638,Baghdadchi; Saharnaz,4,0,20,16
1683289624709,ECE 148,A01,185647,Silberman; Jack,1,0,16,15
1683289625735,ECON 1,A01,185537,Crane; Meredith Helen,54,0,70,16
1683289626761,ECON 3,A01,185549,Crane; Meredith Helen,33,0,70,37
1683289627788,ECON 4,A01,203354,Anderson; John Charles,0,4,10,10
1683289628815,ECON 100A,A01,185574,Staff,0,4,40,40
1683289629841,ECON 100B,A01,185576,Staff,0,22,40,40
1683289630866,ECON 100C,A01,185589,Newhouse; Herbert S,30,0,70,40
1683289631897,ECON 105,A00,185608,Vespa; Emanuel Ignacio,19,0,35,16
1683289632930,ECON 109,A01,185610,Shishkin; Denis,10,0,35,25
1683289633956,ECON 110A,A01,185612,Staff,11,0,40,29
1683289634986,ECON 120A,A01,185615,Staff,20,0,40,20
1683289636017,ECON 120C,A01,185617,Sun; Yixiao,0,20,70,70
1683289637044,ECON 144,A00,203346,Squires; Dale E,3,0,35,32
1683289638070,ECON 171,A01,203349,Newhouse; Herbert S,0,1,35,35
1683289639096,ECON 173A,A01,185621,Toda; Alexis Akira,21,0,35,14
1683289640124,EDS 25,A01,202413,Staff,0,1,0,0
1683289640124,EDS 25,A02,202414,Staff,0,1,0,0
1683289640124,EDS 25,A03,202415,Staff,0,0,0,0
1683289640124,EDS 25,A04,202416,Staff,0,1,0,0
1683289640124,EDS 25,A05,202439,Staff,0,0,0,0
1683289640124,EDS 25,A06,202440,Staff,0,0,0,0
1683289640124,EDS 25,B01,202631,Staff,0,0,0,0
1683289640124,EDS 25,B02,202632,Staff,0,0,0,0
1683289640124,EDS 25,B03,202639,Staff,0,0,0,0
1683289640124,EDS 25,B04,202640,Staff,0,0,0,0
1683289640124,EDS 25,B05,202643,Staff,0,0,0,0
1683289640124,EDS 25,B06,202644,Staff,0,0,0,0
1683289641151,EDS 38,A01,202659,Black; Alison Michelle,24,0,25,1
1683289642180,EDS 115,A00,202652,Staff,17,0,30,13
1683289643208,EDS 125,A00,202649,Staff,14,0,30,16
1683289644232,EDS 126,A01,203332,Staff,30,0,30,0
1683289645264,EDS 139,A00,202838,Staff,17,0,25,8
1683289646288,EDS 146,A01,202655,Staff,15,0,25,10
1683289647313,ENG 15,A00,185667,Staff,0,1,0,0
1683289647313,ENG 15,B00,185672,Staff,0,0,0,0
1683289647313,ENG 15,C00,185675,Staff,0,0,0,0
1683289647313,ENG 15,D00,185682,Staff,0,0,0,0
1683289647313,ENG 15,E00,185684,Staff,0,0,0,0
1683289648338,ETHN 103,A00,185710,Staff,0,3,35,35
1683289649366,ETHN 103A,A00,199228,Man; Simeon S,3,0,9,6
1683289650390,ETHN 109,A00,185711,Staff,18,0,35,17
1683289651415,ETHN 142,A00,185726,Staff,0,4,30,30
1683289652442,ETHN 163J,A00,199229,Man; Simeon S,6,0,8,2
1683289653471,ETHN 168,A00,185727,Staff,8,0,10,2
1683289654498,ETHN 182,A00,185728,Staff,1,0,35,34
1683289655524,ETHN 183,A00,185737,Staff,8,0,18,10
1683289656551,GLBH 111,A01,209361,Burgos; Jose L.,0,0,0,0
1683289658603,HIEU 104,A00,185792,Staff,16,0,20,4
1683289659630,HIEU 115,A00,185800,Staff,1,0,20,19
1683289660659,HIEU 128,A00,185801,Staff,0,7,20,20
1683289661690,HIEU 147,A00,185802,Staff,16,0,20,4
1683289662718,HIEU 154,A00,185823,Staff,12,0,20,8
1683289663745,HILA 102,A00,185826,Staff,13,0,20,7
1683289664774,HILD 2C,A01,185778,Staff,0,12,20,20
1683289665800,HILD 7B,A01,185780,Kwak; Nancy,0,15,32,32
1683289665800,HILD 7B,A02,185781,Kwak; Nancy,0,18,32,32
1683289666826,HILD 30,A01,185791,Staff,14,0,20,6
1683289667856,HISC 119,A00,185830,Golan; Tal,0,9,20,20
1683289668883,HITO 156GS,A00,185831,Patterson; Patrick H.,0,0,0,23
1683289669909,HIUS 103,A00,185832,Man; Simeon S,0,7,20,20
1683289670938,HIUS 117,A00,185836,Kwak; Nancy,2,0,20,18
1683289671966,HIUS 125,A00,185840,Man; Simeon S,0,0,23,23
1683289672996,HIUS 149,A00,185845,Staff,0,0,20,20
1683289674024,HUM 3,A01,185882,Zavodny; Tatiana Sophia,0,6,50,50
1683289674024,HUM 3,B01,185899,Caldwell; Michael Alan,0,19,50,50
1683289675049,HUM 3GS,A00,185900,Patterson; Patrick H.,0,0,0,23
1683289676077,HUM 4,A01,185938,Zroka; Amy Liane,31,0,50,19
1683289676077,HUM 4,B01,185956,Watkins; Eric,0,2,50,50
1683289676077,HUM 4,B02,202209,Watkins; Eric,0,1,50,50
1683289676077,HUM 4,B03,202210,Watkins; Eric,0,0,50,50
1683289677105,HUM 5,A01,185958,West; Geoffrey Scott,5,0,50,45
1683289677105,HUM 5,A02,202215,West; Geoffrey Scott,0,0,50,50
1683289678130,INTL 190,A00,185959,Gagnon; Jeffrey C,0,0,0,9
1683289678130,INTL 190,B00,185960,Lettieri; Michael Joseph,0,0,0,1
1683289679156,JAPN 180,A00,254509,Staff,0,1,25,25
1683289680184,LATI 10,A01,202853,Kennemore; Amy Michelle,5,0,35,30
1683289680184,LATI 10,A02,202854,Kennemore; Amy Michelle,1,0,35,34
1683289680184,LATI 10,A03,270054,Kennemore; Amy Michelle,30,0,30,0
1683289681208,LATI 180,A00,202855,Kennemore; Amy Michelle,11,0,20,9
1683289682240,LAWS 101,A00,201767,Golan; Tal,0,7,40,40
1683289683270,LIFR 1C,A00,185961,Staff,6,0,20,14
1683289684300,LIFR 1CX,A00,185962,Staff,7,0,20,13
1683289685328,LIFR 1D,A00,185963,Staff,9,0,20,11
1683289686357,LIFR 1DX,A00,185964,Staff,9,0,20,11
1683289687384,LIGN 101,A01,186039,Staff,43,0,50,7
1683289688409,LIGN 165,A00,186040,Staff,18,0,50,32
1683289689439,LTCS 108,A00,186041,Staff,6,0,10,4
1683289690467,LTCS 119,A00,186042,Staff,16,0,20,4
1683289691494,LTCS 130,A00,186043,Wesling; Megan E.,15,0,25,10
1683289693548,LTEA 138,A00,186119,Staff,14,0,40,26
1683289694573,LTEN 124,A00,186148,Staff,6,0,25,19
1683289695659,LTEN 178,A00,186149,Staff,7,0,15,8
1683289696690,LTEN 181,A00,186150,Blanco; John D,33,0,40,7
1683289697715,LTWL 120,A00,186160,Staff,20,0,25,5
1683289698741,LTWL 165,A00,186161,Staff,22,0,25,3
1683289699770,LTWR 100,A00,186162,Staff,0,4,15,15
1683289700800,LTWR 102,A00,186163,Doller; Ben,5,0,15,10
1683289701833,MAE 8,A01,186412,Staff,0,0,0,0
1683289702864,MAE 30B,A00,186445,Bahadori; Mohammad Yousef,83,0,100,17
1683289703896,MAE 40,A00,186592,Bewley; Thomas R,9,0,50,41
1683289704926,MAE 101B,A00,186593,Bahadori; Mohammad Yousef,81,0,100,19
1683289705956,MAE 105,A00,186594,Bandaru; Prabhakar,12,0,50,38
1683289706989,MAE 107,A00,186599,Pham; Hieu Tan,0,6,120,120
1683289708018,MAE 148,A01,186660,Silberman; Jack,3,0,16,13
1683289709052,MATH 10A,A01,188095,Staff,0,7,35,35
1683289710080,MATH 10B,A01,188097,Bowers; Adam R.,0,11,30,30
1683289710080,MATH 10B,A02,188099,Bowers; Adam R.,0,9,30,30
1683289710080,MATH 10B,B01,188104,Bowers; Adam R.,0,11,30,30
1683289710080,MATH 10B,B02,188106,Bowers; Adam R.,0,11,30,30
1683289711105,MATH 10C,A01,188111,Staff,0,18,30,30
1683289711105,MATH 10C,A02,188127,Staff,0,17,30,30
1683289711105,MATH 10C,A03,188131,Staff,0,17,30,30
1683289711105,MATH 10C,B01,188218,Staff,21,0,30,9
1683289711105,MATH 10C,B02,188244,Staff,13,0,30,17
1683289711105,MATH 10C,B03,188277,Staff,16,0,30,14
1683289712136,MATH 18,A01,188344,Bach; Quang Tran,18,0,30,12
1683289712136,MATH 18,A02,188345,Bach; Quang Tran,11,0,30,19
1683289712136,MATH 18,B01,188353,Bach; Quang Tran,10,0,30,20
1683289712136,MATH 18,B02,188354,Bach; Quang Tran,20,0,30,10
1683289713166,MATH 20A,A01,188374,Staff,13,0,35,22
1683289714198,MATH 20B,A01,188382,Ohm; Ko Woon,6,0,30,24
1683289714198,MATH 20B,A02,188383,Ohm; Ko Woon,24,0,30,6
1683289714198,MATH 20B,B01,188385,Ohm; Ko Woon,7,0,30,23
1683289714198,MATH 20B,B02,188392,Ohm; Ko Woon,22,0,30,8
1683289715224,MATH 20C,A01,188394,Harel; Guershon,10,0,30,20
1683289715224,MATH 20C,A02,188395,Harel; Guershon,13,0,30,17
1683289715224,MATH 20C,B01,188404,Harel; Guershon,3,0,30,27
1683289715224,MATH 20C,B02,188405,Harel; Guershon,19,0,30,11
1683289716252,MATH 20D,A01,188414,Hammock; Frances H,0,1,30,30
1683289716252,MATH 20D,A02,188415,Hammock; Frances H,4,0,30,26
1683289716252,MATH 20D,B01,188447,Hammock; Frances H,2,0,30,28
1683289716252,MATH 20D,B02,188486,Hammock; Frances H,8,0,30,22
1683289717282,MATH 20E,A01,188649,Staff,22,0,30,8
1683289717282,MATH 20E,A02,188650,Staff,23,0,30,7
1683289717282,MATH 20E,A03,188673,Staff,0,0,30,30
1683289718311,MATH 102,A01,188675,Staff,0,35,35,35
1683289719338,MATH 103B,A01,188681,Staff,4,0,35,31
1683289719338,MATH 103B,B01,188692,Staff,8,0,35,27
1683289720370,MATH 109,A01,188695,Salehi Golsefidy; Alireza,25,0,35,10
1683289720370,MATH 109,A02,188696,Salehi Golsefidy; Alireza,27,0,35,8
1683289721403,MATH 120A,A01,188698,Eggers; John Dietrich,5,0,35,30
1683289722433,MATH 142B,A01,188736,Ioana; Adrian,0,2,30,30
1683289722433,MATH 142B,A02,188741,Ioana; Adrian,0,1,30,30
1683289722433,MATH 142B,A03,188743,Ioana; Adrian,0,3,30,30
1683289723462,MATH 168A,A01,188790,Staff,0,8,35,35
1683289724489,MATH 170A,A01,188803,Nie; Jiawang,0,2,35,35
1683289724489,MATH 170A,A02,188811,Nie; Jiawang,0,0,35,35
1683289724489,MATH 170A,A03,188814,Nie; Jiawang,1,0,35,34
1683289724489,MATH 170A,A04,188815,Nie; Jiawang,14,0,35,21
1683289725515,MATH 193B,A01,188817,Staff,0,0,35,35
1683289725515,MATH 193B,A02,188818,Staff,5,0,35,30
1683289726542,MGT 4,A01,202857,Anderson; John Charles,62,0,80,18
1683289727568,MGT 12,A00,202858,Lindenberger; Wade Douglas,43,0,90,47
1683289728598,MGT 18,A00,202859,Staff,74,0,90,16
1683289729625,MGT 18GS,A00,202860,McKay; Michael J,13,0,28,15
1683289730655,MGT 45,A00,202861,Pecore; Joseph P.,14,0,90,76
1683289731685,MGT 100,A00,202863,Yavorsky; Daniel Ryan,28,0,90,62
1683289732713,MGT 103,A00,202864,Ehrich; Kristine R,0,16,90,90
1683289733738,MGT 112,A00,202865,Ehrich; Kristine R,15,0,90,75
1683289734771,MGT 121A,A00,202868,Staff,0,19,0,0
1683289735796,MGT 131B,A00,202869,Anderson; John Charles,60,0,90,30
1683289736823,MGT 136,A00,202871,Lindenberger; Wade Douglas,84,0,90,6
1683289737852,MGT 164,A00,202873,Staff,0,69,90,90
1683289738876,MGT 164GS,A00,202874,McKay; Mary A,13,0,28,15
1683289739902,MGT 180,A00,202875,Staff,0,51,90,90
1683289740932,MMW 11R,A01,205019,Herbst; Matthew,3,0,30,27
1683289740932,MMW 11R,A02,205026,Herbst; Matthew,29,0,30,1
1683289741967,MMW 15,A01,193512,Chang; Edmond Yi-Teh,0,9,28,28
1683289741967,MMW 15,A02,193513,Chang; Edmond Yi-Teh,0,5,28,28
1683289741967,MMW 15,A03,193514,Chang; Edmond Yi-Teh,0,5,28,28
1683289741967,MMW 15,A04,193515,Chang; Edmond Yi-Teh,0,4,28,28
1683289741967,MMW 15,A05,193516,Chang; Edmond Yi-Teh,0,4,28,28
1683289741967,MMW 15,A06,193517,Chang; Edmond Yi-Teh,0,5,28,28
1683289741967,MMW 15,B01,193519,Chang; Edmond Yi-Teh,0,4,28,28
1683289741967,MMW 15,B02,193520,Chang; Edmond Yi-Teh,0,5,28,28
1683289741967,MMW 15,B03,193521,Chang; Edmond Yi-Teh,0,4,28,28
1683289741967,MMW 15,B04,193522,Chang; Edmond Yi-Teh,0,4,28,28
1683289741967,MMW 15,B05,193523,Chang; Edmond Yi-Teh,0,5,28,28
1683289741967,MMW 15,B06,193524,Chang; Edmond Yi-Teh,0,4,28,28
1683289742994,MMW 122,A01,193526,Rahimi; Babak,0,14,28,28
1683289742994,MMW 122,A02,193527,Rahimi; Babak,0,14,28,28
1683289742994,MMW 122,A03,193528,Rahimi; Babak,0,0,0,0
1683289742994,MMW 122,A04,193529,Rahimi; Babak,0,0,0,0
1683289744019,MUS 1A,A01,186663,Staff,0,20,35,35
1683289745044,MUS 4,A01,186715,Staff,0,12,35,35
1683289746074,MUS 5R,A01,186796,Dubnov; Shlomo,0,16,35,35
1683289747100,MUS 6,A01,186798,Staff,0,3,25,25
1683289748124,MUS 7,A01,186830,Staff,12,0,35,23
1683289749150,MUS 8,A01,186930,Staff,0,25,35,35
1683289750176,MUS 15,A01,186932,Staff,0,15,35,35
1683289750176,MUS 15,B01,186934,Staff,0,14,35,35
1683289751202,MUS 80,A00,186935,Staff,2,0,20,18
1683289751202,MUS 80,B00,186936,Staff,25,0,25,0
1683289752233,NANO 11,A00,204702,Lipomi; Darren John,0,0,0,0
1683289753263,NANO 15,A01,204709,Yang; Kesong,0,1,0,0
1683289754289,NANO 114,A00,202069,Jahed Motlagh; Zeinab,3,0,10,7
1683289755318,PHIL 1,A00,186955,Grush; Rick Scott,32,0,40,8
1683289756349,PHIL 10,A01,186973,Grush; Rick Scott,29,0,35,6
1683289756349,PHIL 10,A02,186974,Grush; Rick Scott,33,0,35,2
1683289757380,PHIL 13,A01,186976,Staff,7,0,35,28
1683289757380,PHIL 13,A02,186977,Staff,16,0,35,19
1683289758410,PHIL 14,A01,186979,Staff,31,0,35,4
1683289758410,PHIL 14,A02,186986,Staff,32,0,35,3
1683289759436,PHIL 28,A01,186988,Staff,16,0,30,14
1683289759436,PHIL 28,A02,186989,Staff,1,0,30,29
1683289759436,PHIL 28,A03,186990,Staff,9,0,30,21
1683289759436,PHIL 28,A04,186991,Staff,26,0,30,4
1683289760465,PHIL 120,A00,186997,Staff,23,0,40,17
1683289761490,PHIL 137,A00,187003,Staff,9,0,40,31
1683289762517,PHIL 150,A00,187015,Staff,47,0,70,23
1683289763559,PHIL 167,A00,187021,Lamey; Andy M.,35,0,40,5
1683289764590,PHIL 174,A01,202226,Staff,17,0,20,3
1683289764590,PHIL 174,A02,202235,Staff,20,0,20,0
1683289765616,PHIL 191A,A00,258918,Staff,0,0,1,1
1683289766643,PHYS 1A,A00,187028,Staff,26,0,60,34
1683289767673,PHYS 1AL,001,187036,Staff,2,0,30,28
1683289767673,PHYS 1AL,002,187049,Staff,18,0,30,12
1683289768701,PHYS 1B,A00,187058,Staff,23,0,60,37
1683289769732,PHYS 1BL,001,187064,Staff,0,0,30,30
1683289769732,PHYS 1BL,002,187070,Staff,6,0,30,24
1683289770760,PHYS 1C,A00,187082,Staff,32,0,120,88
1683289771786,PHYS 1CL,001,187088,Staff,0,9,30,30
1683289771786,PHYS 1CL,002,187089,Staff,0,2,30,30
1683289771786,PHYS 1CL,009,262693,Staff,12,0,30,18
1683289772812,PHYS 2B,A01,187097,Staff,54,0,115,61
1683289773839,PHYS 2C,A01,187099,Staff,67,0,115,48
1683289774865,PHYS 2CL,A01,187101,Staff,5,0,28,23
1683289774865,PHYS 2CL,A02,187102,Staff,15,0,28,13
1683289775895,PHYS 2D,A01,187123,Shotwell; Brian,95,0,115,20
1683289776924,PHYS 4B,A01,187133,Grinstein; Benjamin,35,0,50,15
1683289777953,POLI 10,A00,188819,Staff,0,3,50,50
1683289778978,POLI 11,A00,188827,Staff,43,0,50,7
1683289780006,POLI 13R,A00,188828,Staff,0,1,20,20
1683289781032,POLI 27,A01,188830,Elgin; Samuel Zincke,0,1,70,70
1683289782059,POLI 30,A00,188832,Desposato; Scott,33,0,50,17
1683289783085,POLI 102F,A00,188834,Staff,3,0,40,37
1683289784112,POLI 104A,A00,188852,Staff,14,0,30,16
1683289785138,POLI 104I,A00,188853,Staff,0,6,20,20
1683289786162,POLI 110B,A00,188854,Wiens; David,7,0,20,13
1683289787188,POLI 112A,A00,188855,Wiens; David,5,0,30,25
1683289788217,POLI 117R,A00,188856,Forman; Fonna,0,11,20,20
1683289789241,POLI 118,A00,188857,Ingham; Sean,8,0,20,12
1683289790268,POLI 120G,A00,188858,Staff,9,0,30,21
1683289791294,POLI 131CR,A00,188863,Hoston; Germaine,24,0,50,26
1683289792320,POLI 133,A00,188864,Nellis; Gareth Hb,44,0,50,6
1683289793347,POLI 134D,A00,188865,Desposato; Scott,27,0,30,3
1683289794374,POLI 142A,A00,188871,Gartzke; Erik,22,0,50,28
1683289795400,POLI 142K,A00,188874,Staff,38,0,50,12
1683289796430,POLI 143,A00,188940,Gartzke; Erik,16,0,30,14
1683289797457,POLI 153,A00,188943,Staff,3,0,20,17
1683289798487,POLI 160AA,A00,188944,Staff,13,0,40,27
1683289799573,POLI 170A,A00,188945,Staff,11,0,30,19
1683289801626,PSYC 1,A00,188952,Staff,38,0,90,52
1683289802652,PSYC 2,B00,188953,Staff,20,0,35,15
1683289803680,PSYC 6,A00,188970,Staff,47,0,60,13
1683289804707,PSYC 7,A00,188973,Staff,37,0,45,8
1683289805731,PSYC 60,A01,188980,Rickard; Timothy C.,43,0,60,17
1683289806757,PSYC 70,A01,189001,Steiner; Eric Tomas,24,0,45,21
1683289807782,PSYC 100,A00,189005,Lacefield; Katharine I,0,99,120,120
1683289808808,PSYC 102,A00,189008,Staff,10,0,30,20
1683289809837,PSYC 106,B00,189026,Gorman; Michael R.,37,0,60,23
1683289810864,PSYC 114,B01,189033,Winkielman; Piotr,0,32,30,30
1683289811893,PSYC 131,A00,189036,Anagnostaras; Stephan,0,43,60,60
1683289812919,PSYC 136,A00,189041,Lowe; Angela Beth,0,7,25,25
1683289813944,PSYC 137,A00,189057,Winkielman; Piotr,0,34,25,25
1683289814970,PSYC 144,A00,189107,Wixted; John T,0,7,50,50
1683289817024,PSYC 162,A00,189142,Staff,0,8,85,85
1683289818051,PSYC 172,A00,189144,Gorman; Michael R.,0,7,30,30
1683289820107,PSYC 179,A00,189146,Lacefield; Katharine I,0,84,120,120
1683289821137,PSYC 181,A00,189147,Anagnostaras; Stephan,0,44,90,90
1683289822163,PSYC 190R,A00,189148,Barner; David A.,0,22,80,80
1683289823194,PSYC 191,A00,189275,Rickard; Timothy C.,0,7,25,25
1683289824223,PSYC 193,A00,189276,Chapman; Eddie Nathaniel,0,1,0,4
1683289825248,PSYC 193L,A01,189281,Lowe; Angela Beth,12,0,20,8
1683289825248,PSYC 193L,B01,189285,Staff,28,0,35,7
1683289826273,RELI 149,A00,187137,Rahimi; Babak,7,0,40,33
1683289827300,SE 9,A01,187315,Staff,0,2,18,18
1683289828324,SE 101B,A00,187409,Staff,24,0,30,6
1683289829350,SE 110B,A00,187444,Staff,10,0,40,30
1683289830378,SE 130B,A00,187449,Staff,31,0,40,9
1683289831403,SE 150A,A00,187516,Staff,9,0,20,11
1683289832428,SE 154,A00,187528,Staff,30,0,50,20
1683289833454,SIO 3,A01,258171,Staff,35,0,40,5
1683289834481,SIO 10,A00,187144,Cook; Geoffrey W,0,3,75,75
1683289835506,SIO 45,A00,187152,Cook; Geoffrey W,1,0,100,99
1683289836533,SIO 109R,A00,194486,Staff,0,3,20,20
1683289838584,SIO 187,A01,187233,Kacev; David,12,0,40,28
1683289839611,SOCI 1,A01,258656,Thorpe; Charles Robert,28,0,30,2
1683289839611,SOCI 1,A02,258658,Thorpe; Charles Robert,30,0,30,0
1683289839611,SOCI 1,A03,258661,Thorpe; Charles Robert,25,0,25,0
1683289839611,SOCI 1,A04,258666,Thorpe; Charles Robert,22,0,25,3
1683289839611,SOCI 1,A05,258897,Thorpe; Charles Robert,23,0,25,2
1683289839611,SOCI 1,A06,258898,Thorpe; Charles Robert,25,0,25,0
1683289840637,SOCI 30,A01,258903,Pardo Guerra; Juan Pablo,16,0,30,14
1683289841663,SOCI 102,A00,258904,Staff,9,0,25,16
1683289842688,SOCI 106,A00,258905,Staff,19,0,25,6
1683289843713,SOCI 111,A00,258907,Ribas Norris; Janet Vanesa,26,0,30,4
1683289844741,SOCI 121R,A00,258908,Pardo Guerra; Juan Pablo,11,0,30,19
1683289845766,SOCI 126,A01,203330,Staff,14,0,20,6
1683289846791,SOCI 131,A00,258909,Thorpe; Charles Robert,31,0,60,29
1683289847816,SOCI 135,A00,258910,Payne; Christine Anna,0,9,30,30
1683289848846,SOCI 157,A00,258911,Staff,13,0,30,17
1683289849871,SOCI 184,A00,258912,Staff,26,0,30,4
1683289850896,SOCI 188D,A00,258913,Staff,21,0,30,9
1683289851927,SYN 2,001,187529,Staff,9,0,16,7
1683289851927,SYN 2,002,201452,Staff,0,18,16,16
1683289851927,SYN 2,003,201469,Staff,3,0,16,13
1683289852958,SYN 100,A01,187531,Staff,0,9,20,20
1683289852958,SYN 100,B01,201491,Staff,0,12,20,20
1683289853990,TDAC 1,A00,189286,Walsh; Kim C.,3,0,20,17
1683289853990,TDAC 1,B00,189287,Harting; Carla Kelso,11,0,20,9
1683289855020,TDAC 101,A00,189300,Walsh; Kim C.,16,0,20,4
1683289855020,TDAC 101,B00,189301,Harting; Carla Kelso,18,0,20,2
1683289856048,TDAC 102,A00,189304,Basso; Beatrice,14,0,20,6
1683289857073,TDAC 108,A00,189305,Staff,18,0,20,2
1683289858100,TDDE 131,A00,189310,Staff,19,0,20,1
1683289858100,TDDE 131,B00,189314,Staff,19,0,20,1
1683289858100,TDDE 131,C00,189315,Staff,48,0,50,2
1683289858100,TDDE 131,D00,189316,Staff,14,0,15,1
1683289858100,TDDE 131,E00,204841,Staff,20,0,20,0
1683289859126,TDGE 10,A00,189289,Staff,30,0,50,20
1683289859126,TDGE 10,B00,189290,Havis; Allan,2,0,50,48
1683289860160,TDGE 11,A00,189291,Fulton; Julia,0,3,50,50
1683289860160,TDGE 11,B00,189292,Staff,20,0,25,5
1683289860160,TDGE 11,C00,260270,Staff,0,0,0,0
1683289861318,TDGE 25,A00,189294,Staff,3,0,20,17
1683289862345,TDGE 124,A00,189318,Fulton; Julia,0,8,50,50
1683289863376,TDGE 125,A00,189319,Staff,13,0,25,12
1683289863376,TDGE 125,B00,189320,Staff,23,0,25,2
1683289864400,TDGE 127,A00,189322,Havis; Allan,0,0,50,50
1683289865426,TDHT 101,A00,189323,Staff,18,0,25,7
1683289865426,TDHT 101,B00,189324,Staff,25,0,25,0
1683289866452,TDHT 102,A00,189325,Staff,49,0,50,1
1683289867477,TDMV 1,A00,189295,Arcidiacono; Kristin,20,0,30,10
1683289867477,TDMV 1,B00,189296,Caligagan; Maria T.,24,0,30,6
1683289868502,TDMV 2,A00,189297,Sammartano; Tonnie,28,0,30,2
1683289868502,TDMV 2,B00,189299,Arcidiacono; Kristin,24,0,30,6
1683289869533,TDMV 3,A00,204998,Rincon; Alicia,22,0,30,8
1683289870562,TDMV 120,A00,189458,Sammartano; Tonnie,28,0,30,2
1683289871600,TDMV 138,A00,189541,Jun; Grace Shin Hae,22,0,40,18
1683289872627,TDMV 142,A00,189717,Caligagan; Tony,23,0,30,7
1683289872627,TDMV 142,B00,189718,Caligagan; Maria T.,25,0,30,5
1683289873654,TMC 2,A01,187533,Staff,25,0,25,0
1683289873654,TMC 2,A02,187534,Staff,25,0,25,0
1683289874683,USP 1,A01,187536,Kwak; Nancy,0,16,25,25
1683289875713,USP 5,A01,187538,Staff,9,0,25,16
1683289876741,USP 101,A00,199253,Staff,0,4,0,0
1683289877772,USP 124,A00,187562,Boomhower; Matthew Charles,1,0,30,29
1683289878803,USP 138,A00,187582,Staff,20,0,25,5
1683289879828,USP 152,A01,187597,Staff,4,0,25,21
1683289880854,USP 153,A00,187598,Staff,19,0,25,6
1683289881880,USP 168,A00,187607,Kwak; Nancy,2,0,5,3
1683289882906,USP 173,A00,187619,Staff,4,0,25,21
1683289883931,USP 181,A00,187638,Staff,0,0,25,25
1683289884957,VIS 103,A00,187650,Cruz; Edwin Teddy,23,0,75,52
1683289885981,VIS 110D,A00,187669,Staff,12,0,22,10
1683289887010,VIS 127C,A00,187720,Shen; Kuiyi,68,0,146,78
1683289888040,VIS 149,A00,187731,Yoldas; Pinar,0,14,22,22
1683289889067,VIS 151,A01,188091,Staff,22,0,34,12
1683289889067,VIS 151,A02,188092,Staff,11,0,34,23
1683289890098,VIS 160B,A00,188093,Stalbaum; Brett,0,0,10,10
1683289892149,WCWP 10B,A00,201720,Staff,10,0,15,5
1683289892149,WCWP 10B,B00,201722,Staff,8,0,15,7
1683289893174,WCWP 100,A00,201725,Gagnon; Jeffrey C,0,0,2,2
1683289893174,WCWP 100,B00,201727,Staff,0,4,15,15
1683289896278,ANBI 133,A00,258401,Wilder; Linnea Lorene,34,0,40,6
1683289897306,ANBI 140,A00,258395,Hrvoj Mihic; Branka,18,0,25,7
1683289898330,ANSC 120,A00,258402,Bialecki; Jon Anthony,27,0,40,13
1683289899354,ANSC 144,A00,258400,Staff,14,0,40,26
1683289901407,ANSC 166,A00,258396,Parish; Steven Martin,157,0,175,18
1683289902432,ANSC 180,A00,193533,Staff,9,0,20,11
1683289903517,ANSC 188,A00,258397,Jassal; Aftab,33,0,40,7
1683289904543,ANTH 3,A01,258316,Staff,23,0,30,7
1683289905568,ANTH 5,A00,258394,Semendeferi; Ekaterini,16,0,20,4
1683289906594,ANTH 21,A01,258331,Staff,9,0,40,31
1683289907619,ANTH 103,A00,258398,Varma; Saiba,15,0,25,10
1683289908654,AWP 10,001,202034,Staff,0,0,0,0
1683289908654,AWP 10,002,202035,Staff,0,0,0,0
1683289908654,AWP 10,003,202036,Staff,0,0,0,0
1683289908654,AWP 10,004,202037,Staff,0,0,0,0
1683289908654,AWP 10,005,202038,Staff,0,0,0,0
1683289908654,AWP 10,006,202039,Staff,0,0,0,0
1683289908654,AWP 10,007,202040,Staff,0,0,0,0
1683289908654,AWP 10,008,202041,Staff,0,0,0,0
1683289908654,AWP 10,009,202042,Staff,0,0,0,0
1683289908654,AWP 10,010,202043,Staff,0,0,0,0
1683289908654,AWP 10,011,202044,Staff,0,0,0,0
1683289908654,AWP 10,012,202045,Staff,0,0,0,0
1683289908654,AWP 10,013,202046,Staff,0,0,0,0
1683289908654,AWP 10,014,202047,Staff,0,0,0,0
1683289908654,AWP 10,015,202048,Staff,0,0,0,0
1683289908654,AWP 10,016,202049,Staff,0,0,0,0
1683289908654,AWP 10,017,202050,Staff,0,0,0,0
1683289908654,AWP 10,018,202051,Staff,0,0,0,0
1683289908654,AWP 10,019,202052,Staff,0,0,0,0
1683289908654,AWP 10,020,202053,Staff,0,0,0,0
1683289908654,AWP 10,021,202054,Staff,0,0,0,0
1683289908654,AWP 10,022,202055,Staff,0,0,0,0
1683289908654,AWP 10,023,202056,Staff,0,0,0,0
1683289908654,AWP 10,024,202057,Staff,0,0,0,0
1683289908654,AWP 10,025,202058,Staff,0,0,0,0
1683289908654,AWP 10,026,202059,Staff,0,0,0,0
1683289909682,AWP 102,001,202032,Staff,0,0,0,0
1683289909682,AWP 102,002,202033,Staff,0,0,0,0
1683289910714,BENG 100,A01,254234,Taylor Amos; Alyssa C,31,0,40,9
1683289911741,BENG 196,001,270013,Engler; Adam J.,9999,0,9999,0
1683289912769,BICD 100R,A01,202018,Smith; Laurie,0,7,32,32
1683289912769,BICD 100R,A02,202019,Smith; Laurie,0,2,32,32
1683289912769,BICD 100R,A03,202020,Smith; Laurie,0,1,32,32
1683289912769,BICD 100R,A04,202021,Smith; Laurie,8,0,32,24
1683289912769,BICD 100R,A05,202022,Smith; Laurie,12,0,32,20
1683289913796,BICD 136,A01,193242,Gustafson-Brown; Cindy,0,2,32,32
1683289913796,BICD 136,A02,193244,Gustafson-Brown; Cindy,15,0,32,17
1683289914824,BIEB 102,A01,193249,Butler; Shannon Rhey,0,2,32,32
1683289914824,BIEB 102,A02,193251,Butler; Shannon Rhey,0,0,32,32
1683289914824,BIEB 102,A03,193253,Butler; Shannon Rhey,0,1,32,32
1683289914824,BIEB 102,A04,193255,Butler; Shannon Rhey,17,0,32,15
1683289914824,BIEB 102,A05,193265,Butler; Shannon Rhey,26,0,32,6
1683289914824,BIEB 102,A06,193269,Butler; Shannon Rhey,16,0,32,16
1683289916877,BIEB 150,A01,193274,Staff,0,0,32,32
1683289916877,BIEB 150,A02,193285,Staff,24,0,32,8
1683289917907,BIEB 194,A00,193286,Kurle; Carolyn M.,22,0,32,10
1683289918935,BILD 1,A01,192291,Staff,16,0,32,16
1683289918935,BILD 1,A02,192292,Staff,30,0,32,2
1683289918935,BILD 1,B01,192520,Reuther; Keefe,0,1,0,0
1683289918935,BILD 1,B02,192532,Reuther; Keefe,0,1,0,0
1683289919962,BILD 3,A01,192556,Butler; Shannon Rhey,0,0,32,32
1683289919962,BILD 3,A02,192581,Butler; Shannon Rhey,5,0,32,27
1683289919962,BILD 3,A03,192611,Butler; Shannon Rhey,23,0,32,9
1683289919962,BILD 3,A04,192612,Butler; Shannon Rhey,25,0,32,7
1683289919962,BILD 3,A05,192613,Butler; Shannon Rhey,27,0,32,5
1683289919962,BILD 3,A06,192679,Butler; Shannon Rhey,27,0,32,5
1683289919962,BILD 3,A07,192682,Butler; Shannon Rhey,22,0,32,10
1683289920993,BILD 4,A01,192836,Reuther; Keefe,1,0,24,23
1683289920993,BILD 4,A02,193044,Reuther; Keefe,4,0,24,20
1683289922022,BILD 10,A01,193142,Gustafson-Brown; Cindy,31,0,32,1
1683289922022,BILD 10,A02,193149,Gustafson-Brown; Cindy,31,0,32,1
1683289923050,BIMM 100,A01,193301,Staff,0,6,32,32
1683289923050,BIMM 100,A02,193312,Staff,0,5,32,32
1683289923050,BIMM 100,A03,193323,Staff,0,8,32,32
1683289924085,BIMM 101,A01,193329,McDonnell; Lisa Marie,0,3,24,24
1683289924085,BIMM 101,A02,193339,McDonnell; Lisa Marie,0,2,24,24
1683289924085,BIMM 101,B01,193354,McDonnell; Lisa Marie,0,3,24,24
1683289924085,BIMM 101,B02,193357,McDonnell; Lisa Marie,0,3,24,24
1683289925117,BIMM 110,A01,193377,Tat; John,0,11,32,32
1683289925117,BIMM 110,A02,193378,Tat; John,1,9,32,31
1683289926151,BIMM 120,A01,206116,Staff,0,0,32,32
1683289926151,BIMM 120,A02,206117,Staff,8,0,32,24
1683289926151,BIMM 120,A03,206121,Staff,21,0,32,11
1683289927182,BIPN 100,A01,193393,Park; Ji Young,0,14,32,32
1683289927182,BIPN 100,A02,193402,Park; Ji Young,0,12,32,32
1683289927182,BIPN 100,A03,193413,Park; Ji Young,0,14,32,32
1683289927182,BIPN 100,A04,193414,Park; Ji Young,0,13,32,32
1683289928215,BIPN 102,A01,193429,Staff,0,0,32,32
1683289928215,BIPN 102,A02,193438,Staff,23,0,32,9
1683289929241,BIPN 106,A01,193450,Reyes Gonzalez; Catalina,0,2,40,40
1683289930269,BIPN 134,A01,193465,Cooke; James Edward,0,0,32,32
1683289930269,BIPN 134,A02,193474,Cooke; James Edward,27,0,32,5
1683289930269,BIPN 134,A03,193485,Cooke; James Edward,29,0,32,3
1683289930269,BIPN 134,A04,193486,Cooke; James Edward,21,0,32,11
1683289930269,BIPN 134,A05,193491,Cooke; James Edward,31,0,32,1
1683289930269,BIPN 134,A06,193501,Cooke; James Edward,30,0,32,2
1683289930269,BIPN 134,A07,193510,Cooke; James Edward,29,0,32,3
1683289932329,BISP 194,A00,222522,Staff,16,0,32,16
1683289933359,CAT 124,A01,202407,Staff,20,0,25,5
1683289934387,CAT 125,A00,202408,Marchisotto; Jennifer Anne,4,0,20,16
1683289935414,CAT 125R,A00,202409,Smith; Lauryn Alissa,0,11,20,20
1683289935414,CAT 125R,B00,202410,Morales; Celeste Georgianna,0,11,20,20
1683289935414,CAT 125R,C00,202411,Irwin; Matthew Joseph,0,10,20,20
1683289936442,CENG 15,A01,204712,Yang; Kesong,0,1,0,0
1683289937471,CENG 114,A00,202070,Jahed Motlagh; Zeinab,5,0,20,15
1683289938500,CGS 105,A00,185477,Wesling; Megan E.,24,0,40,16
1683289939525,CGS 106,A00,185494,Staff,13,0,22,9
1683289940553,CGS 108,A00,185495,Staff,14,0,20,6
1683289941582,CGS 114,A00,185496,Staff,13,0,18,5
1683289942612,CGS 119,A00,185501,Staff,15,0,20,5
1683289943638,CGS 120,A00,185511,Staff,13,0,20,7
1683289944671,CHEM 4,A01,184675,Bussey; Thomas J,96,0,100,4
1683289945700,CHEM 6A,A01,184677,Staff,35,0,60,25
1683289946728,CHEM 6B,A01,184679,Staff,65,0,100,35
1683289947753,CHEM 6C,A01,184681,Bussey; Thomas J,1,0,50,49
1683289947753,CHEM 6C,A02,184682,Bussey; Thomas J,34,0,50,16
1683289948780,CHEM 40A,A01,184684,Albizati; Kim F.,37,0,100,63
1683289949805,CHEM 40B,A01,184686,Albizati; Kim F.,0,20,100,100
1683289950835,CHEM 41B,A01,184690,Staff,52,0,100,48
1683289951866,COGS 3,A01,184715,Boyle; Mary E. T.,0,25,40,40
1683289952897,COGS 14B,A01,185172,Staff,0,15,38,38
1683289953923,COGS 18,A01,184736,Staff,20,0,80,60
1683289954950,COGS 100,A01,184932,Staff,0,5,73,73
1683289955975,COGS 101A,A01,184935,Staff,0,38,30,30
1683289957000,COGS 101B,A01,184944,Staff,0,2,30,30
1683289958030,COGS 101C,A01,184946,Staff,0,12,30,30
1683289959060,COGS 102A,A01,184951,Johnson; Christine M.,2,0,40,38
1683289960090,COGS 107B,A01,184953,Mooshagian; Eric Frederick,0,50,40,40
1683289961120,COGS 118B,A01,184959,Gupta; Anjum,0,48,40,40
1683289962149,COGS 153,A00,184961,Staff,0,15,30,30
1683289963176,COGS 177,A00,184962,Staff,0,21,30,30
1683289964207,COGS 187A,A01,184969,Boyle; Mary E. T.,0,17,40,40
1683289965238,COMM 10,A01,185174,Staff,0,5,25,25
1683289965238,COMM 10,A02,185189,Staff,0,5,25,25
1683289965238,COMM 10,A03,269821,Staff,0,0,0,0
1683289966267,COMM 100B,A01,185475,Staff,0,0,0,2
1683289966267,COMM 100B,A02,185476,Staff,14,0,25,11
1683289967297,COMM 100C,A01,185314,Staff,1,0,25,24
1683289967297,COMM 100C,A02,185327,Staff,19,0,25,6
1683289968326,COMM 110M,A00,185349,Staff,2,0,40,38
1683289969350,COMM 113T,A00,185352,Staff,25,0,40,15
1683289970376,COMM 114I,A00,185353,Staff,33,0,40,7
1683289971401,COMM 131,A00,185354,Staff,19,0,30,11
1683289972430,CSE 8A,A50,185358,Cao; Yingjun,0,46,10,10
1683289973455,CSE 8B,A01,185362,Staff,0,47,50,50
1683289974481,CSE 11,A01,185416,Cao; Yingjun,0,93,10,10
1683289975510,CSE 20,A01,185445,Briones; Jor-el Thomas Caparas,5,0,25,20
1683289976538,CSE 21,A01,185447,Staff,10,0,50,40
1683289977565,CSE 101,A01,185451,Staff,0,12,50,50
1683289977565,CSE 101,B01,185453,Jones; Miles E,0,11,50,50
1683289979621,CSE 141,A01,185458,Eldon; John,20,0,100,80
1683289980651,CSE 141L,A01,185461,Eldon; John,12,0,100,88
1683289981679,CSE 142,A01,185463,Staff,35,0,60,25
1683289981679,CSE 142,B01,201355,Staff,0,6,60,60
1683289982711,CSE 142L,A01,185470,Staff,35,0,60,25
1683289982711,CSE 142L,B01,201417,Staff,0,5,60,60
1683289983745,CSE 190,A00,201433,Staff,32,0,49,17
1683289984777,DOC 1,A01,259136,Strom; Megan C.,8,0,15,7
1683289984777,DOC 1,A02,259137,Strom; Megan C.,14,0,15,1
1683289984777,DOC 1,A03,259138,Strom; Megan C.,14,0,15,1
1683289984777,DOC 1,A04,259139,Strom; Megan C.,14,0,15,1
1683289985807,DOC 100D,A00,259140,Pass; Natalye Joann,17,0,25,8
1683289986834,DSGN 1,A01,184749,Rill; Bryan,0,24,30,30
1683289987863,DSGN 100,A01,185168,Staff,0,2,25,25
1683289988897,ECE 5,A01,185626,Morris; Karcher William,0,10,0,0
1683289989927,ECE 101,A01,185628,Staff,17,0,70,53
1683289990954,ECE 107,A01,185635,Baghdadchi; Saharnaz,0,0,20,20
1683289990954,ECE 107,A02,185638,Baghdadchi; Saharnaz,4,0,20,16
1683289991981,ECE 148,A01,185647,Silberman; Jack,1,0,16,15
1683289993006,ECON 1,A01,185537,Crane; Meredith Helen,54,0,70,16
1683289994035,ECON 3,A01,185549,Crane; Meredith Helen,33,0,70,37
1683289995062,ECON 4,A01,203354,Anderson; John Charles,0,4,10,10
1683289996092,ECON 100A,A01,185574,Staff,0,4,40,40
1683289997122,ECON 100B,A01,185576,Staff,0,22,40,40
1683289998148,ECON 100C,A01,185589,Newhouse; Herbert S,30,0,70,40
1683289999179,ECON 105,A00,185608,Vespa; Emanuel Ignacio,19,0,35,16
1683290000204,ECON 109,A01,185610,Shishkin; Denis,10,0,35,25
1683290001235,ECON 110A,A01,185612,Staff,11,0,40,29
1683290002261,ECON 120A,A01,185615,Staff,20,0,40,20
1683290003286,ECON 120C,A01,185617,Sun; Yixiao,0,20,70,70
1683290004318,ECON 144,A00,203346,Squires; Dale E,3,0,35,32
1683290005344,ECON 171,A01,203349,Newhouse; Herbert S,0,1,35,35
1683290006370,ECON 173A,A01,185621,Toda; Alexis Akira,21,0,35,14
1683290007456,EDS 25,A01,202413,Staff,0,1,0,0
1683290007456,EDS 25,A02,202414,Staff,0,1,0,0
1683290007456,EDS 25,A03,202415,Staff,0,0,0,0
1683290007456,EDS 25,A04,202416,Staff,0,1,0,0
1683290007456,EDS 25,A05,202439,Staff,0,0,0,0
1683290007456,EDS 25,A06,202440,Staff,0,0,0,0
1683290007456,EDS 25,B01,202631,Staff,0,0,0,0
1683290007456,EDS 25,B02,202632,Staff,0,0,0,0
1683290007456,EDS 25,B03,202639,Staff,0,0,0,0
1683290007456,EDS 25,B04,202640,Staff,0,0,0,0
1683290007456,EDS 25,B05,202643,Staff,0,0,0,0
1683290007456,EDS 25,B06,202644,Staff,0,0,0,0
1683290008483,EDS 38,A01,202659,Black; Alison Michelle,24,0,25,1
1683290009508,EDS 115,A00,202652,Staff,17,0,30,13
1683290010538,EDS 125,A00,202649,Staff,14,0,30,16
1683290011569,EDS 126,A01,203332,Staff,30,0,30,0
1683290012599,EDS 139,A00,202838,Staff,17,0,25,8
1683290013625,EDS 146,A01,202655,Staff,15,0,25,10
1683290014651,ENG 15,A00,185667,Staff,0,1,0,0
1683290014651,ENG 15,B00,185672,Staff,0,0,0,0
1683290014651,ENG 15,C00,185675,Staff,0,0,0,0
1683290014651,ENG 15,D00,185682,Staff,0,0,0,0
1683290014651,ENG 15,E00,185684,Staff,0,0,0,0
1683290015677,ETHN 103,A00,185710,Staff,0,3,35,35
1683290016701,ETHN 103A,A00,199228,Man; Simeon S,3,0,9,6
1683290017726,ETHN 109,A00,185711,Staff,18,0,35,17
1683290018756,ETHN 142,A00,185726,Staff,0,4,30,30
1683290019782,ETHN 163J,A00,199229,Man; Simeon S,6,0,8,2
1683290020809,ETHN 168,A00,185727,Staff,8,0,10,2
1683290021838,ETHN 182,A00,185728,Staff,1,0,35,34
1683290022864,ETHN 183,A00,185737,Staff,8,0,18,10
1683290023897,GLBH 111,A01,209361,Burgos; Jose L.,0,0,0,0
1683290025958,HIEU 104,A00,185792,Staff,16,0,20,4
1683290026987,HIEU 115,A00,185800,Staff,1,0,20,19
1683290028017,HIEU 128,A00,185801,Staff,0,7,20,20
1683290029043,HIEU 147,A00,185802,Staff,16,0,20,4
1683290030071,HIEU 154,A00,185823,Staff,12,0,20,8
1683290031104,HILA 102,A00,185826,Staff,13,0,20,7
1683290032128,HILD 2C,A01,185778,Staff,0,12,20,20
1683290033160,HILD 7B,A01,185780,Kwak; Nancy,0,15,32,32
1683290033160,HILD 7B,A02,185781,Kwak; Nancy,0,18,32,32
1683290034188,HILD 30,A01,185791,Staff,14,0,20,6
1683290035214,HISC 119,A00,185830,Golan; Tal,0,9,20,20
1683290036240,HITO 156GS,A00,185831,Patterson; Patrick H.,0,0,0,23
1683290037269,HIUS 103,A00,185832,Man; Simeon S,0,7,20,20
1683290038296,HIUS 117,A00,185836,Kwak; Nancy,2,0,20,18
1683290039324,HIUS 125,A00,185840,Man; Simeon S,0,0,23,23
1683290040350,HIUS 149,A00,185845,Staff,0,0,20,20
1683290041375,HUM 3,A01,185882,Zavodny; Tatiana Sophia,0,6,50,50
1683290041375,HUM 3,B01,185899,Caldwell; Michael Alan,0,19,50,50
1683290042408,HUM 3GS,A00,185900,Patterson; Patrick H.,0,0,0,23
1683290043442,HUM 4,A01,185938,Zroka; Amy Liane,31,0,50,19
1683290043442,HUM 4,B01,185956,Watkins; Eric,0,2,50,50
1683290043442,HUM 4,B02,202209,Watkins; Eric,0,1,50,50
1683290043442,HUM 4,B03,202210,Watkins; Eric,0,0,50,50
1683290044478,HUM 5,A01,185958,West; Geoffrey Scott,5,0,50,45
1683290044478,HUM 5,A02,202215,West; Geoffrey Scott,0,0,50,50
1683290045509,INTL 190,A00,185959,Gagnon; Jeffrey C,0,0,0,9
1683290045509,INTL 190,B00,185960,Lettieri; Michael Joseph,0,0,0,1
1683290046535,JAPN 180,A00,254509,Staff,0,1,25,25
1683290047563,LATI 10,A01,202853,Kennemore; Amy Michelle,5,0,35,30
1683290047563,LATI 10,A02,202854,Kennemore; Amy Michelle,1,0,35,34
1683290047563,LATI 10,A03,270054,Kennemore; Amy Michelle,30,0,30,0
1683290048590,LATI 180,A00,202855,Kennemore; Amy Michelle,11,0,20,9
1683290049622,LAWS 101,A00,201767,Golan; Tal,0,7,40,40
1683290050652,LIFR 1C,A00,185961,Staff,6,0,20,14
1683290051681,LIFR 1CX,A00,185962,Staff,7,0,20,13
1683290052710,LIFR 1D,A00,185963,Staff,9,0,20,11
1683290053739,LIFR 1DX,A00,185964,Staff,9,0,20,11
1683290054768,LIGN 101,A01,186039,Staff,43,0,50,7
1683290055796,LIGN 165,A00,186040,Staff,18,0,50,32
1683290056825,LTCS 108,A00,186041,Staff,6,0,10,4
1683290057854,LTCS 119,A00,186042,Staff,16,0,20,4
1683290058882,LTCS 130,A00,186043,Wesling; Megan E.,15,0,25,10
1683290060937,LTEA 138,A00,186119,Staff,14,0,40,26
1683290061964,LTEN 124,A00,186148,Staff,6,0,25,19
1683290062990,LTEN 178,A00,186149,Staff,7,0,15,8
1683290064016,LTEN 181,A00,186150,Blanco; John D,33,0,40,7
1683290065043,LTWL 120,A00,186160,Staff,20,0,25,5
1683290066069,LTWL 165,A00,186161,Staff,22,0,25,3
1683290067095,LTWR 100,A00,186162,Staff,0,4,15,15
1683290068124,LTWR 102,A00,186163,Doller; Ben,5,0,15,10
1683290069153,MAE 8,A01,186412,Staff,0,0,0,0
1683290070184,MAE 30B,A00,186445,Bahadori; Mohammad Yousef,83,0,100,17
1683290071214,MAE 40,A00,186592,Bewley; Thomas R,9,0,50,41
1683290072240,MAE 101B,A00,186593,Bahadori; Mohammad Yousef,81,0,100,19
1683290073269,MAE 105,A00,186594,Bandaru; Prabhakar,12,0,50,38
1683290074308,MAE 107,A00,186599,Pham; Hieu Tan,0,6,120,120
1683290075338,MAE 148,A01,186660,Silberman; Jack,3,0,16,13
1683290076369,MATH 10A,A01,188095,Staff,0,7,35,35
1683290077400,MATH 10B,A01,188097,Bowers; Adam R.,0,11,30,30
1683290077400,MATH 10B,A02,188099,Bowers; Adam R.,0,9,30,30
1683290077400,MATH 10B,B01,188104,Bowers; Adam R.,0,11,30,30
1683290077400,MATH 10B,B02,188106,Bowers; Adam R.,0,11,30,30
1683290078428,MATH 10C,A01,188111,Staff,0,18,30,30
1683290078428,MATH 10C,A02,188127,Staff,0,17,30,30
1683290078428,MATH 10C,A03,188131,Staff,0,17,30,30
1683290078428,MATH 10C,B01,188218,Staff,21,0,30,9
1683290078428,MATH 10C,B02,188244,Staff,13,0,30,17
1683290078428,MATH 10C,B03,188277,Staff,16,0,30,14
1683290079454,MATH 18,A01,188344,Bach; Quang Tran,18,0,30,12
1683290079454,MATH 18,A02,188345,Bach; Quang Tran,11,0,30,19
1683290079454,MATH 18,B01,188353,Bach; Quang Tran,10,0,30,20
1683290079454,MATH 18,B02,188354,Bach; Quang Tran,20,0,30,10
1683290080484,MATH 20A,A01,188374,Staff,13,0,35,22
1683290081515,MATH 20B,A01,188382,Ohm; Ko Woon,6,0,30,24
1683290081515,MATH 20B,A02,188383,Ohm; Ko Woon,24,0,30,6
1683290081515,MATH 20B,B01,188385,Ohm; Ko Woon,7,0,30,23
1683290081515,MATH 20B,B02,188392,Ohm; Ko Woon,22,0,30,8
1683290082547,MATH 20C,A01,188394,Harel; Guershon,10,0,30,20
1683290082547,MATH 20C,A02,188395,Harel; Guershon,13,0,30,17
1683290082547,MATH 20C,B01,188404,Harel; Guershon,3,0,30,27
1683290082547,MATH 20C,B02,188405,Harel; Guershon,19,0,30,11
1683290083584,MATH 20D,A01,188414,Hammock; Frances H,0,1,30,30
1683290083584,MATH 20D,A02,188415,Hammock; Frances H,4,0,30,26
1683290083584,MATH 20D,B01,188447,Hammock; Frances H,2,0,30,28
1683290083584,MATH 20D,B02,188486,Hammock; Frances H,8,0,30,22
1683290084615,MATH 20E,A01,188649,Staff,22,0,30,8
1683290084615,MATH 20E,A02,188650,Staff,23,0,30,7
1683290084615,MATH 20E,A03,188673,Staff,0,0,30,30
1683290085639,MATH 102,A01,188675,Staff,0,35,35,35
1683290086670,MATH 103B,A01,188681,Staff,4,0,35,31
1683290086670,MATH 103B,B01,188692,Staff,8,0,35,27
1683290087697,MATH 109,A01,188695,Salehi Golsefidy; Alireza,25,0,35,10
1683290087697,MATH 109,A02,188696,Salehi Golsefidy; Alireza,27,0,35,8
1683290088723,MATH 120A,A01,188698,Eggers; John Dietrich,5,0,35,30
1683290089750,MATH 142B,A01,188736,Ioana; Adrian,0,2,30,30
1683290089750,MATH 142B,A02,188741,Ioana; Adrian,0,1,30,30
1683290089750,MATH 142B,A03,188743,Ioana; Adrian,0,3,30,30
1683290090781,MATH 168A,A01,188790,Staff,0,8,35,35
1683290091808,MATH 170A,A01,188803,Nie; Jiawang,0,2,35,35
1683290091808,MATH 170A,A02,188811,Nie; Jiawang,0,0,35,35
1683290091808,MATH 170A,A03,188814,Nie; Jiawang,1,0,35,34
1683290091808,MATH 170A,A04,188815,Nie; Jiawang,14,0,35,21
1683290092834,MATH 193B,A01,188817,Staff,0,0,35,35
1683290092834,MATH 193B,A02,188818,Staff,5,0,35,30
1683290093859,MGT 4,A01,202857,Anderson; John Charles,62,0,80,18
1683290094891,MGT 12,A00,202858,Lindenberger; Wade Douglas,43,0,90,47
1683290095917,MGT 18,A00,202859,Staff,74,0,90,16
1683290096951,MGT 18GS,A00,202860,McKay; Michael J,13,0,28,15
1683290097986,MGT 45,A00,202861,Pecore; Joseph P.,14,0,90,76
1683290099014,MGT 100,A00,202863,Yavorsky; Daniel Ryan,28,0,90,62
1683290100041,MGT 103,A00,202864,Ehrich; Kristine R,0,16,90,90
1683290101068,MGT 112,A00,202865,Ehrich; Kristine R,15,0,90,75
1683290102095,MGT 121A,A00,202868,Staff,0,19,0,0
1683290103120,MGT 131B,A00,202869,Anderson; John Charles,60,0,90,30
1683290104148,MGT 136,A00,202871,Lindenberger; Wade Douglas,84,0,90,6
1683290105179,MGT 164,A00,202873,Staff,0,69,90,90
1683290106208,MGT 164GS,A00,202874,McKay; Mary A,13,0,28,15
1683290107235,MGT 180,A00,202875,Staff,0,51,90,90
1683290108261,MMW 11R,A01,205019,Herbst; Matthew,3,0,30,27
1683290108261,MMW 11R,A02,205026,Herbst; Matthew,29,0,30,1
1683290109290,MMW 15,A01,193512,Chang; Edmond Yi-Teh,0,9,28,28
1683290109290,MMW 15,A02,193513,Chang; Edmond Yi-Teh,0,5,28,28
1683290109290,MMW 15,A03,193514,Chang; Edmond Yi-Teh,0,5,28,28
1683290109290,MMW 15,A04,193515,Chang; Edmond Yi-Teh,0,4,28,28
1683290109290,MMW 15,A05,193516,Chang; Edmond Yi-Teh,0,4,28,28
1683290109290,MMW 15,A06,193517,Chang; Edmond Yi-Teh,0,5,28,28
1683290109290,MMW 15,B01,193519,Chang; Edmond Yi-Teh,0,4,28,28
1683290109290,MMW 15,B02,193520,Chang; Edmond Yi-Teh,0,5,28,28
1683290109290,MMW 15,B03,193521,Chang; Edmond Yi-Teh,0,4,28,28
1683290109290,MMW 15,B04,193522,Chang; Edmond Yi-Teh,0,4,28,28
1683290109290,MMW 15,B05,193523,Chang; Edmond Yi-Teh,0,5,28,28
1683290109290,MMW 15,B06,193524,Chang; Edmond Yi-Teh,0,4,28,28
1683290110317,MMW 122,A01,193526,Rahimi; Babak,0,14,28,28
1683290110317,MMW 122,A02,193527,Rahimi; Babak,0,14,28,28
1683290110317,MMW 122,A03,193528,Rahimi; Babak,0,0,0,0
1683290110317,MMW 122,A04,193529,Rahimi; Babak,0,0,0,0
1683290111404,MUS 1A,A01,186663,Staff,0,20,35,35
1683290112437,MUS 4,A01,186715,Staff,0,12,35,35
1683290113464,MUS 5R,A01,186796,Dubnov; Shlomo,0,16,35,35
1683290114488,MUS 6,A01,186798,Staff,0,3,25,25
1683290115513,MUS 7,A01,186830,Staff,12,0,35,23
1683290116540,MUS 8,A01,186930,Staff,0,25,35,35
1683290117565,MUS 15,A01,186932,Staff,0,15,35,35
1683290117565,MUS 15,B01,186934,Staff,0,14,35,35
1683290118596,MUS 80,A00,186935,Staff,2,0,20,18
1683290118596,MUS 80,B00,186936,Staff,25,0,25,0
1683290119628,NANO 11,A00,204702,Lipomi; Darren John,0,0,0,0
1683290120662,NANO 15,A01,204709,Yang; Kesong,0,1,0,0
1683290121690,NANO 114,A00,202069,Jahed Motlagh; Zeinab,3,0,10,7
1683290122718,PHIL 1,A00,186955,Grush; Rick Scott,32,0,40,8
1683290123750,PHIL 10,A01,186973,Grush; Rick Scott,29,0,35,6
1683290123750,PHIL 10,A02,186974,Grush; Rick Scott,33,0,35,2
1683290124779,PHIL 13,A01,186976,Staff,7,0,35,28
1683290124779,PHIL 13,A02,186977,Staff,16,0,35,19
1683290125804,PHIL 14,A01,186979,Staff,31,0,35,4
1683290125804,PHIL 14,A02,186986,Staff,32,0,35,3
1683290126832,PHIL 28,A01,186988,Staff,16,0,30,14
1683290126832,PHIL 28,A02,186989,Staff,1,0,30,29
1683290126832,PHIL 28,A03,186990,Staff,9,0,30,21
1683290126832,PHIL 28,A04,186991,Staff,26,0,30,4
1683290127859,PHIL 120,A00,186997,Staff,23,0,40,17
1683290128885,PHIL 137,A00,187003,Staff,9,0,40,31
1683290129911,PHIL 150,A00,187015,Staff,47,0,70,23
1683290130940,PHIL 167,A00,187021,Lamey; Andy M.,35,0,40,5
1683290131970,PHIL 174,A01,202226,Staff,17,0,20,3
1683290131970,PHIL 174,A02,202235,Staff,20,0,20,0
1683290132999,PHIL 191A,A00,258918,Staff,0,0,1,1
1683290134027,PHYS 1A,A00,187028,Staff,26,0,60,34
1683290135057,PHYS 1AL,001,187036,Staff,2,0,30,28
1683290135057,PHYS 1AL,002,187049,Staff,18,0,30,12
1683290136086,PHYS 1B,A00,187058,Staff,23,0,60,37
1683290137113,PHYS 1BL,001,187064,Staff,0,0,30,30
1683290137113,PHYS 1BL,002,187070,Staff,6,0,30,24
1683290138140,PHYS 1C,A00,187082,Staff,32,0,120,88
1683290139172,PHYS 1CL,001,187088,Staff,0,9,30,30
1683290139172,PHYS 1CL,002,187089,Staff,0,2,30,30
1683290139172,PHYS 1CL,009,262693,Staff,12,0,30,18
1683290140203,PHYS 2B,A01,187097,Staff,54,0,115,61
1683290141235,PHYS 2C,A01,187099,Staff,67,0,115,48
1683290142266,PHYS 2CL,A01,187101,Staff,5,0,28,23
1683290142266,PHYS 2CL,A02,187102,Staff,15,0,28,13
1683290143298,PHYS 2D,A01,187123,Shotwell; Brian,95,0,115,20
1683290144323,PHYS 4B,A01,187133,Grinstein; Benjamin,35,0,50,15
1683290145349,POLI 10,A00,188819,Staff,0,3,50,50
1683290146375,POLI 11,A00,188827,Staff,43,0,50,7
1683290147401,POLI 13R,A00,188828,Staff,0,1,20,20
1683290148428,POLI 27,A01,188830,Elgin; Samuel Zincke,0,1,70,70
1683290149453,POLI 30,A00,188832,Desposato; Scott,33,0,50,17
1683290150484,POLI 102F,A00,188834,Staff,3,0,40,37
1683290151514,POLI 104A,A00,188852,Staff,14,0,30,16
1683290152542,POLI 104I,A00,188853,Staff,0,6,20,20
1683290153568,POLI 110B,A00,188854,Wiens; David,7,0,20,13
1683290154598,POLI 112A,A00,188855,Wiens; David,5,0,30,25
1683290155624,POLI 117R,A00,188856,Forman; Fonna,0,11,20,20
1683290156650,POLI 118,A00,188857,Ingham; Sean,8,0,20,12
1683290157679,POLI 120G,A00,188858,Staff,9,0,30,21
1683290158711,POLI 131CR,A00,188863,Hoston; Germaine,24,0,50,26
1683290159741,POLI 133,A00,188864,Nellis; Gareth Hb,44,0,50,6
1683290160767,POLI 134D,A00,188865,Desposato; Scott,27,0,30,3
1683290161794,POLI 142A,A00,188871,Gartzke; Erik,22,0,50,28
1683290162819,POLI 142K,A00,188874,Staff,38,0,50,12
1683290163845,POLI 143,A00,188940,Gartzke; Erik,16,0,30,14
1683290164872,POLI 153,A00,188943,Staff,3,0,20,17
1683290165901,POLI 160AA,A00,188944,Staff,13,0,40,27
1683290166930,POLI 170A,A00,188945,Staff,11,0,30,19
1683290168990,PSYC 1,A00,188952,Staff,38,0,90,52
1683290170020,PSYC 2,B00,188953,Staff,20,0,35,15
1683290171046,PSYC 6,A00,188970,Staff,47,0,60,13
1683290172072,PSYC 7,A00,188973,Staff,37,0,45,8
1683290173100,PSYC 60,A01,188980,Rickard; Timothy C.,43,0,60,17
1683290174126,PSYC 70,A01,189001,Steiner; Eric Tomas,24,0,45,21
1683290175152,PSYC 100,A00,189005,Lacefield; Katharine I,0,99,120,120
1683290176180,PSYC 102,A00,189008,Staff,10,0,30,20
1683290177210,PSYC 106,B00,189026,Gorman; Michael R.,37,0,60,23
1683290178239,PSYC 114,B01,189033,Winkielman; Piotr,0,32,30,30
1683290179264,PSYC 131,A00,189036,Anagnostaras; Stephan,0,43,60,60
1683290180290,PSYC 136,A00,189041,Lowe; Angela Beth,0,7,25,25
1683290181316,PSYC 137,A00,189057,Winkielman; Piotr,0,34,25,25
1683290182341,PSYC 144,A00,189107,Wixted; John T,0,7,50,50
1683290184389,PSYC 162,A00,189142,Staff,0,8,85,85
1683290185415,PSYC 172,A00,189144,Gorman; Michael R.,0,7,30,30
1683290187470,PSYC 179,A00,189146,Lacefield; Katharine I,0,84,120,120
1683290188500,PSYC 181,A00,189147,Anagnostaras; Stephan,0,44,90,90
1683290189531,PSYC 190R,A00,189148,Barner; David A.,0,22,80,80
1683290190556,PSYC 191,A00,189275,Rickard; Timothy C.,0,7,25,25
1683290191580,PSYC 193,A00,189276,Chapman; Eddie Nathaniel,0,1,0,4
1683290192609,PSYC 193L,A01,189281,Lowe; Angela Beth,12,0,20,8
1683290192609,PSYC 193L,B01,189285,Staff,28,0,35,7
1683290193635,RELI 149,A00,187137,Rahimi; Babak,7,0,40,33
1683290194662,SE 9,A01,187315,Staff,0,2,18,18
1683290195695,SE 101B,A00,187409,Staff,24,0,30,6
1683290196724,SE 110B,A00,187444,Staff,10,0,40,30
1683290197754,SE 130B,A00,187449,Staff,31,0,40,9
1683290198783,SE 150A,A00,187516,Staff,9,0,20,11
1683290199816,SE 154,A00,187528,Staff,30,0,50,20
1683290200842,SIO 3,A01,258171,Staff,35,0,40,5
1683290201872,SIO 10,A00,187144,Cook; Geoffrey W,0,3,75,75
1683290202902,SIO 45,A00,187152,Cook; Geoffrey W,1,0,100,99
1683290203931,SIO 109R,A00,194486,Staff,0,3,20,20
1683290205983,SIO 187,A01,187233,Kacev; David,12,0,40,28
1683290207011,SOCI 1,A01,258656,Thorpe; Charles Robert,28,0,30,2
1683290207011,SOCI 1,A02,258658,Thorpe; Charles Robert,30,0,30,0
1683290207011,SOCI 1,A03,258661,Thorpe; Charles Robert,25,0,25,0
1683290207011,SOCI 1,A04,258666,Thorpe; Charles Robert,22,0,25,3
1683290207011,SOCI 1,A05,258897,Thorpe; Charles Robert,23,0,25,2
1683290207011,SOCI 1,A06,258898,Thorpe; Charles Robert,25,0,25,0
1683290208037,SOCI 30,A01,258903,Pardo Guerra; Juan Pablo,16,0,30,14
1683290209062,SOCI 102,A00,258904,Staff,9,0,25,16
1683290210091,SOCI 106,A00,258905,Staff,19,0,25,6
1683290211118,SOCI 111,A00,258907,Ribas Norris; Janet Vanesa,26,0,30,4
1683290212144,SOCI 121R,A00,258908,Pardo Guerra; Juan Pablo,11,0,30,19
1683290213178,SOCI 126,A01,203330,Staff,14,0,20,6
1683290214204,SOCI 131,A00,258909,Thorpe; Charles Robert,31,0,60,29
1683290215290,SOCI 135,A00,258910,Payne; Christine Anna,0,9,30,30
1683290216321,SOCI 157,A00,258911,Staff,13,0,30,17
1683290217351,SOCI 184,A00,258912,Staff,26,0,30,4
1683290218380,SOCI 188D,A00,258913,Staff,21,0,30,9
1683290219412,SYN 2,001,187529,Staff,9,0,16,7
1683290219412,SYN 2,002,201452,Staff,0,18,16,16
1683290219412,SYN 2,003,201469,Staff,3,0,16,13
1683290220443,SYN 100,A01,187531,Staff,0,9,20,20
1683290220443,SYN 100,B01,201491,Staff,0,12,20,20
1683290221471,TDAC 1,A00,189286,Walsh; Kim C.,3,0,20,17
1683290221471,TDAC 1,B00,189287,Harting; Carla Kelso,11,0,20,9
1683290222502,TDAC 101,A00,189300,Walsh; Kim C.,16,0,20,4
1683290222502,TDAC 101,B00,189301,Harting; Carla Kelso,18,0,20,2
1683290223535,TDAC 102,A00,189304,Basso; Beatrice,14,0,20,6
1683290224567,TDAC 108,A00,189305,Staff,18,0,20,2
1683290225596,TDDE 131,A00,189310,Staff,19,0,20,1
1683290225596,TDDE 131,B00,189314,Staff,19,0,20,1
1683290225596,TDDE 131,C00,189315,Staff,48,0,50,2
1683290225596,TDDE 131,D00,189316,Staff,14,0,15,1
1683290225596,TDDE 131,E00,204841,Staff,20,0,20,0
1683290226624,TDGE 10,A00,189289,Staff,30,0,50,20
1683290226624,TDGE 10,B00,189290,Havis; Allan,2,0,50,48
1683290227651,TDGE 11,A00,189291,Fulton; Julia,0,3,50,50
1683290227651,TDGE 11,B00,189292,Staff,20,0,25,5
1683290227651,TDGE 11,C00,260270,Staff,0,0,0,0
1683290228678,TDGE 25,A00,189294,Staff,3,0,20,17
1683290229705,TDGE 124,A00,189318,Fulton; Julia,0,8,50,50
1683290230734,TDGE 125,A00,189319,Staff,13,0,25,12
1683290230734,TDGE 125,B00,189320,Staff,23,0,25,2
1683290231762,TDGE 127,A00,189322,Havis; Allan,0,0,50,50
1683290232788,TDHT 101,A00,189323,Staff,18,0,25,7
1683290232788,TDHT 101,B00,189324,Staff,25,0,25,0
1683290233814,TDHT 102,A00,189325,Staff,49,0,50,1
1683290234845,TDMV 1,A00,189295,Arcidiacono; Kristin,20,0,30,10
1683290234845,TDMV 1,B00,189296,Caligagan; Maria T.,24,0,30,6
1683290235876,TDMV 2,A00,189297,Sammartano; Tonnie,28,0,30,2
1683290235876,TDMV 2,B00,189299,Arcidiacono; Kristin,24,0,30,6
1683290236909,TDMV 3,A00,204998,Rincon; Alicia,22,0,30,8
1683290237940,TDMV 120,A00,189458,Sammartano; Tonnie,28,0,30,2
1683290238968,TDMV 138,A00,189541,Jun; Grace Shin Hae,22,0,40,18
1683290239995,TDMV 142,A00,189717,Caligagan; Tony,23,0,30,7
1683290239995,TDMV 142,B00,189718,Caligagan; Maria T.,25,0,30,5
1683290241022,TMC 2,A01,187533,Staff,25,0,25,0
1683290241022,TMC 2,A02,187534,Staff,25,0,25,0
1683290242049,USP 1,A01,187536,Kwak; Nancy,0,16,25,25
1683290243089,USP 5,A01,187538,Staff,9,0,25,16
1683290244115,USP 101,A00,199253,Staff,0,4,0,0
1683290245142,USP 124,A00,187562,Boomhower; Matthew Charles,1,0,30,29
1683290246168,USP 138,A00,187582,Staff,20,0,25,5
1683290247198,USP 152,A01,187597,Staff,4,0,25,21
1683290248222,USP 153,A00,187598,Staff,19,0,25,6
1683290249253,USP 168,A00,187607,Kwak; Nancy,2,0,5,3
1683290250282,USP 173,A00,187619,Staff,4,0,25,21
1683290251313,USP 181,A00,187638,Staff,0,0,25,25
1683290252343,VIS 103,A00,187650,Cruz; Edwin Teddy,23,0,75,52
1683290253371,VIS 110D,A00,187669,Staff,12,0,22,10
1683290254400,VIS 127C,A00,187720,Shen; Kuiyi,68,0,146,78
1683290255430,VIS 149,A00,187731,Yoldas; Pinar,0,14,22,22
1683290256456,VIS 151,A01,188091,Staff,22,0,34,12
1683290256456,VIS 151,A02,188092,Staff,11,0,34,23
1683290257481,VIS 160B,A00,188093,Stalbaum; Brett,0,0,10,10
1683290259534,WCWP 10B,A00,201720,Staff,10,0,15,5
1683290259534,WCWP 10B,B00,201722,Staff,8,0,15,7
1683290260561,WCWP 100,A00,201725,Gagnon; Jeffrey C,0,0,2,2
1683290260561,WCWP 100,B00,201727,Staff,0,4,15,15
1683290263680,ANBI 133,A00,258401,Wilder; Linnea Lorene,34,0,40,6
1683290264707,ANBI 140,A00,258395,Hrvoj Mihic; Branka,18,0,25,7
1683290265734,ANSC 120,A00,258402,Bialecki; Jon Anthony,27,0,40,13
1683290266758,ANSC 144,A00,258400,Staff,14,0,40,26
1683290268819,ANSC 166,A00,258396,Parish; Steven Martin,157,0,175,18
1683290269852,ANSC 180,A00,193533,Staff,9,0,20,11
1683290270877,ANSC 188,A00,258397,Jassal; Aftab,33,0,40,7
1683290271903,ANTH 3,A01,258316,Staff,23,0,30,7
1683290272930,ANTH 5,A00,258394,Semendeferi; Ekaterini,16,0,20,4
1683290273956,ANTH 21,A01,258331,Staff,9,0,40,31
1683290274982,ANTH 103,A00,258398,Varma; Saiba,15,0,25,10
1683290276021,AWP 10,001,202034,Staff,0,0,0,0
1683290276021,AWP 10,002,202035,Staff,0,0,0,0
1683290276021,AWP 10,003,202036,Staff,0,0,0,0
1683290276021,AWP 10,004,202037,Staff,0,0,0,0
1683290276021,AWP 10,005,202038,Staff,0,0,0,0
1683290276021,AWP 10,006,202039,Staff,0,0,0,0
1683290276021,AWP 10,007,202040,Staff,0,0,0,0
1683290276021,AWP 10,008,202041,Staff,0,0,0,0
1683290276021,AWP 10,009,202042,Staff,0,0,0,0
1683290276021,AWP 10,010,202043,Staff,0,0,0,0
1683290276021,AWP 10,011,202044,Staff,0,0,0,0
1683290276021,AWP 10,012,202045,Staff,0,0,0,0
1683290276021,AWP 10,013,202046,Staff,0,0,0,0
1683290276021,AWP 10,014,202047,Staff,0,0,0,0
1683290276021,AWP 10,015,202048,Staff,0,0,0,0
1683290276021,AWP 10,016,202049,Staff,0,0,0,0
1683290276021,AWP 10,017,202050,Staff,0,0,0,0
1683290276021,AWP 10,018,202051,Staff,0,0,0,0
1683290276021,AWP 10,019,202052,Staff,0,0,0,0
1683290276021,AWP 10,020,202053,Staff,0,0,0,0
1683290276021,AWP 10,021,202054,Staff,0,0,0,0
1683290276021,AWP 10,022,202055,Staff,0,0,0,0
1683290276021,AWP 10,023,202056,Staff,0,0,0,0
1683290276021,AWP 10,024,202057,Staff,0,0,0,0
1683290276021,AWP 10,025,202058,Staff,0,0,0,0
1683290276021,AWP 10,026,202059,Staff,0,0,0,0
1683290277050,AWP 102,001,202032,Staff,0,0,0,0
1683290277050,AWP 102,002,202033,Staff,0,0,0,0
1683290278073,BENG 100,A01,254234,Taylor Amos; Alyssa C,31,0,40,9
1683290279099,BENG 196,001,270013,Engler; Adam J.,9999,0,9999,0
1683290280127,BICD 100R,A01,202018,Smith; Laurie,0,7,32,32
1683290280127,BICD 100R,A02,202019,Smith; Laurie,0,2,32,32
1683290280127,BICD 100R,A03,202020,Smith; Laurie,0,1,32,32
1683290280127,BICD 100R,A04,202021,Smith; Laurie,8,0,32,24
1683290280127,BICD 100R,A05,202022,Smith; Laurie,12,0,32,20
1683290281160,BICD 136,A01,193242,Gustafson-Brown; Cindy,0,2,32,32
1683290281160,BICD 136,A02,193244,Gustafson-Brown; Cindy,15,0,32,17
1683290282189,BIEB 102,A01,193249,Butler; Shannon Rhey,0,2,32,32
1683290282189,BIEB 102,A02,193251,Butler; Shannon Rhey,0,0,32,32
1683290282189,BIEB 102,A03,193253,Butler; Shannon Rhey,0,1,32,32
1683290282189,BIEB 102,A04,193255,Butler; Shannon Rhey,17,0,32,15
1683290282189,BIEB 102,A05,193265,Butler; Shannon Rhey,26,0,32,6
1683290282189,BIEB 102,A06,193269,Butler; Shannon Rhey,16,0,32,16
1683290284252,BIEB 150,A01,193274,Staff,0,0,32,32
1683290284252,BIEB 150,A02,193285,Staff,24,0,32,8
1683290285280,BIEB 194,A00,193286,Kurle; Carolyn M.,22,0,32,10
1683290286309,BILD 1,A01,192291,Staff,16,0,32,16
1683290286309,BILD 1,A02,192292,Staff,30,0,32,2
1683290286309,BILD 1,B01,192520,Reuther; Keefe,0,1,0,0
1683290286309,BILD 1,B02,192532,Reuther; Keefe,0,1,0,0
1683290287339,BILD 3,A01,192556,Butler; Shannon Rhey,0,0,32,32
1683290287339,BILD 3,A02,192581,Butler; Shannon Rhey,5,0,32,27
1683290287339,BILD 3,A03,192611,Butler; Shannon Rhey,23,0,32,9
1683290287339,BILD 3,A04,192612,Butler; Shannon Rhey,25,0,32,7
1683290287339,BILD 3,A05,192613,Butler; Shannon Rhey,27,0,32,5
1683290287339,BILD 3,A06,192679,Butler; Shannon Rhey,27,0,32,5
1683290287339,BILD 3,A07,192682,Butler; Shannon Rhey,22,0,32,10
1683290288364,BILD 4,A01,192836,Reuther; Keefe,1,0,24,23
1683290288364,BILD 4,A02,193044,Reuther; Keefe,4,0,24,20
1683290289390,BILD 10,A01,193142,Gustafson-Brown; Cindy,31,0,32,1
1683290289390,BILD 10,A02,193149,Gustafson-Brown; Cindy,31,0,32,1
1683290290414,BIMM 100,A01,193301,Staff,0,6,32,32
1683290290414,BIMM 100,A02,193312,Staff,0,5,32,32
1683290290414,BIMM 100,A03,193323,Staff,0,8,32,32
1683290291443,BIMM 101,A01,193329,McDonnell; Lisa Marie,0,3,24,24
1683290291443,BIMM 101,A02,193339,McDonnell; Lisa Marie,0,2,24,24
1683290291443,BIMM 101,B01,193354,McDonnell; Lisa Marie,0,3,24,24
1683290291443,BIMM 101,B02,193357,McDonnell; Lisa Marie,0,3,24,24
1683290292470,BIMM 110,A01,193377,Tat; John,0,11,32,32
1683290292470,BIMM 110,A02,193378,Tat; John,1,9,32,31
1683290293504,BIMM 120,A01,206116,Staff,0,0,32,32
1683290293504,BIMM 120,A02,206117,Staff,8,0,32,24
1683290293504,BIMM 120,A03,206121,Staff,21,0,32,11
1683290294537,BIPN 100,A01,193393,Park; Ji Young,0,14,32,32
1683290294537,BIPN 100,A02,193402,Park; Ji Young,0,12,32,32
1683290294537,BIPN 100,A03,193413,Park; Ji Young,0,14,32,32
1683290294537,BIPN 100,A04,193414,Park; Ji Young,0,13,32,32
1683290295569,BIPN 102,A01,193429,Staff,0,0,32,32
1683290295569,BIPN 102,A02,193438,Staff,23,0,32,9
1683290296594,BIPN 106,A01,193450,Reyes Gonzalez; Catalina,0,2,40,40
1683290297624,BIPN 134,A01,193465,Cooke; James Edward,0,0,32,32
1683290297624,BIPN 134,A02,193474,Cooke; James Edward,27,0,32,5
1683290297624,BIPN 134,A03,193485,Cooke; James Edward,29,0,32,3
1683290297624,BIPN 134,A04,193486,Cooke; James Edward,21,0,32,11
1683290297624,BIPN 134,A05,193491,Cooke; James Edward,31,0,32,1
1683290297624,BIPN 134,A06,193501,Cooke; James Edward,30,0,32,2
1683290297624,BIPN 134,A07,193510,Cooke; James Edward,29,0,32,3
1683290299684,BISP 194,A00,222522,Staff,16,0,32,16
1683290300714,CAT 124,A01,202407,Staff,20,0,25,5
1683290301740,CAT 125,A00,202408,Marchisotto; Jennifer Anne,4,0,20,16
1683290302768,CAT 125R,A00,202409,Smith; Lauryn Alissa,0,11,20,20
1683290302768,CAT 125R,B00,202410,Morales; Celeste Georgianna,0,11,20,20
1683290302768,CAT 125R,C00,202411,Irwin; Matthew Joseph,0,10,20,20
1683290303800,CENG 15,A01,204712,Yang; Kesong,0,1,0,0
1683290304827,CENG 114,A00,202070,Jahed Motlagh; Zeinab,5,0,20,15
1683290305855,CGS 105,A00,185477,Wesling; Megan E.,24,0,40,16
1683290306881,CGS 106,A00,185494,Staff,13,0,22,9
1683290307906,CGS 108,A00,185495,Staff,14,0,20,6
1683290308932,CGS 114,A00,185496,Staff,13,0,18,5
1683290309962,CGS 119,A00,185501,Staff,15,0,20,5
1683290310992,CGS 120,A00,185511,Staff,13,0,20,7
1683290312025,CHEM 4,A01,184675,Bussey; Thomas J,96,0,100,4
1683290313050,CHEM 6A,A01,184677,Staff,35,0,60,25
1683290314080,CHEM 6B,A01,184679,Staff,65,0,100,35
1683290315109,CHEM 6C,A01,184681,Bussey; Thomas J,1,0,50,49
1683290315109,CHEM 6C,A02,184682,Bussey; Thomas J,34,0,50,16
1683290316136,CHEM 40A,A01,184684,Albizati; Kim F.,37,0,100,63
1683290317161,CHEM 40B,A01,184686,Albizati; Kim F.,0,20,100,100
1683290318188,CHEM 41B,A01,184690,Staff,52,0,100,48
1683290319271,COGS 3,A01,184715,Boyle; Mary E. T.,0,25,40,40
1683290320297,COGS 14B,A01,185172,Staff,0,15,38,38
1683290321322,COGS 18,A01,184736,Staff,20,0,80,60
1683290322348,COGS 100,A01,184932,Staff,0,5,73,73
1683290323373,COGS 101A,A01,184935,Staff,0,38,30,30
1683290324399,COGS 101B,A01,184944,Staff,0,2,30,30
1683290325424,COGS 101C,A01,184946,Staff,0,12,30,30
1683290326449,COGS 102A,A01,184951,Johnson; Christine M.,2,0,40,38
1683290327479,COGS 107B,A01,184953,Mooshagian; Eric Frederick,0,50,40,40
1683290328505,COGS 118B,A01,184959,Gupta; Anjum,0,48,40,40
1683290329535,COGS 153,A00,184961,Staff,0,15,30,30
1683290330564,COGS 177,A00,184962,Staff,0,21,30,30
1683290331593,COGS 187A,A01,184969,Boyle; Mary E. T.,0,17,40,40
1683290332620,COMM 10,A01,185174,Staff,0,5,25,25
1683290332620,COMM 10,A02,185189,Staff,0,5,25,25
1683290332620,COMM 10,A03,269821,Staff,0,0,0,0
1683290333652,COMM 100B,A01,185475,Staff,0,0,0,2
1683290333652,COMM 100B,A02,185476,Staff,14,0,25,11
1683290334683,COMM 100C,A01,185314,Staff,1,0,25,24
1683290334683,COMM 100C,A02,185327,Staff,19,0,25,6
1683290335712,COMM 110M,A00,185349,Staff,2,0,40,38
1683290336738,COMM 113T,A00,185352,Staff,25,0,40,15
1683290337767,COMM 114I,A00,185353,Staff,33,0,40,7
1683290338798,COMM 131,A00,185354,Staff,19,0,30,11
1683290339829,CSE 8A,A50,185358,Cao; Yingjun,0,46,10,10
1683290340858,CSE 8B,A01,185362,Staff,0,47,50,50
1683290341888,CSE 11,A01,185416,Cao; Yingjun,0,93,10,10
1683290342919,CSE 20,A01,185445,Briones; Jor-el Thomas Caparas,5,0,25,20
1683290343946,CSE 21,A01,185447,Staff,10,0,50,40
1683290344974,CSE 101,A01,185451,Staff,0,12,50,50
1683290344974,CSE 101,B01,185453,Jones; Miles E,0,11,50,50
1683290347038,CSE 141,A01,185458,Eldon; John,20,0,100,80
1683290348069,CSE 141L,A01,185461,Eldon; John,12,0,100,88
1683290349101,CSE 142,A01,185463,Staff,35,0,60,25
1683290349101,CSE 142,B01,201355,Staff,0,6,60,60
1683290350131,CSE 142L,A01,185470,Staff,35,0,60,25
1683290350131,CSE 142L,B01,201417,Staff,0,5,60,60
1683290351159,CSE 190,A00,201433,Staff,32,0,49,17
1683290352188,DOC 1,A01,259136,Strom; Megan C.,8,0,15,7
1683290352188,DOC 1,A02,259137,Strom; Megan C.,14,0,15,1
1683290352188,DOC 1,A03,259138,Strom; Megan C.,14,0,15,1
1683290352188,DOC 1,A04,259139,Strom; Megan C.,14,0,15,1
1683290353216,DOC 100D,A00,259140,Pass; Natalye Joann,17,0,25,8
1683290354242,DSGN 1,A01,184749,Rill; Bryan,0,24,30,30
1683290355269,DSGN 100,A01,185168,Staff,0,2,25,25
1683290356295,ECE 5,A01,185626,Morris; Karcher William,0,10,0,0
1683290357321,ECE 101,A01,185628,Staff,17,0,70,53
1683290358349,ECE 107,A01,185635,Baghdadchi; Saharnaz,0,0,20,20
1683290358349,ECE 107,A02,185638,Baghdadchi; Saharnaz,4,0,20,16
1683290359374,ECE 148,A01,185647,Silberman; Jack,1,0,16,15
1683290360405,ECON 1,A01,185537,Crane; Meredith Helen,54,0,70,16
1683290361433,ECON 3,A01,185549,Crane; Meredith Helen,33,0,70,37
1683290362459,ECON 4,A01,203354,Anderson; John Charles,0,4,10,10
1683290363485,ECON 100A,A01,185574,Staff,0,4,40,40
1683290364511,ECON 100B,A01,185576,Staff,0,22,40,40
1683290365536,ECON 100C,A01,185589,Newhouse; Herbert S,30,0,70,40
1683290366567,ECON 105,A00,185608,Vespa; Emanuel Ignacio,19,0,35,16
1683290367601,ECON 109,A01,185610,Shishkin; Denis,10,0,35,25
1683290368631,ECON 110A,A01,185612,Staff,11,0,40,29
1683290369661,ECON 120A,A01,185615,Staff,20,0,40,20
1683290370688,ECON 120C,A01,185617,Sun; Yixiao,0,20,70,70
1683290371715,ECON 144,A00,203346,Squires; Dale E,3,0,35,32
1683290372741,ECON 171,A01,203349,Newhouse; Herbert S,0,1,35,35
1683290373767,ECON 173A,A01,185621,Toda; Alexis Akira,21,0,35,14
1683290374797,EDS 25,A01,202413,Staff,0,1,0,0
1683290374797,EDS 25,A02,202414,Staff,0,1,0,0
1683290374797,EDS 25,A03,202415,Staff,0,0,0,0
1683290374797,EDS 25,A04,202416,Staff,0,1,0,0
1683290374797,EDS 25,A05,202439,Staff,0,0,0,0
1683290374797,EDS 25,A06,202440,Staff,0,0,0,0
1683290374797,EDS 25,B01,202631,Staff,0,0,0,0
1683290374797,EDS 25,B02,202632,Staff,0,0,0,0
1683290374797,EDS 25,B03,202639,Staff,0,0,0,0
1683290374797,EDS 25,B04,202640,Staff,0,0,0,0
1683290374797,EDS 25,B05,202643,Staff,0,0,0,0
1683290374797,EDS 25,B06,202644,Staff,0,0,0,0
1683290375823,EDS 38,A01,202659,Black; Alison Michelle,24,0,25,1
1683290376849,EDS 115,A00,202652,Staff,17,0,30,13
1683290377874,EDS 125,A00,202649,Staff,14,0,30,16
1683290378903,EDS 126,A01,203332,Staff,30,0,30,0
1683290379931,EDS 139,A00,202838,Staff,17,0,25,8
1683290380957,EDS 146,A01,202655,Staff,15,0,25,10
1683290381983,ENG 15,A00,185667,Staff,0,1,0,0
1683290381983,ENG 15,B00,185672,Staff,0,0,0,0
1683290381983,ENG 15,C00,185675,Staff,0,0,0,0
1683290381983,ENG 15,D00,185682,Staff,0,0,0,0
1683290381983,ENG 15,E00,185684,Staff,0,0,0,0
1683290383009,ETHN 103,A00,185710,Staff,0,3,35,35
1683290384035,ETHN 103A,A00,199228,Man; Simeon S,3,0,9,6
1683290385061,ETHN 109,A00,185711,Staff,18,0,35,17
1683290386086,ETHN 142,A00,185726,Staff,0,4,30,30
1683290387114,ETHN 163J,A00,199229,Man; Simeon S,6,0,8,2
1683290388140,ETHN 168,A00,185727,Staff,8,0,10,2
1683290389164,ETHN 182,A00,185728,Staff,1,0,35,34
1683290390190,ETHN 183,A00,185737,Staff,8,0,18,10
1683290391218,GLBH 111,A01,209361,Burgos; Jose L.,0,0,0,0
1683290393276,HIEU 104,A00,185792,Staff,16,0,20,4
1683290394305,HIEU 115,A00,185800,Staff,1,0,20,19
1683290395333,HIEU 128,A00,185801,Staff,0,7,20,20
1683290396359,HIEU 147,A00,185802,Staff,16,0,20,4
1683290397385,HIEU 154,A00,185823,Staff,12,0,20,8
1683290398411,HILA 102,A00,185826,Staff,13,0,20,7
1683290399435,HILD 2C,A01,185778,Staff,0,12,20,20
1683290400462,HILD 7B,A01,185780,Kwak; Nancy,0,15,32,32
1683290400462,HILD 7B,A02,185781,Kwak; Nancy,0,18,32,32
1683290401489,HILD 30,A01,185791,Staff,14,0,20,6
1683290402519,HISC 119,A00,185830,Golan; Tal,0,9,20,20
1683290403552,HITO 156GS,A00,185831,Patterson; Patrick H.,0,0,0,23
1683290404583,HIUS 103,A00,185832,Man; Simeon S,0,7,20,20
1683290405612,HIUS 117,A00,185836,Kwak; Nancy,2,0,20,18
1683290406642,HIUS 125,A00,185840,Man; Simeon S,0,0,23,23
1683290407674,HIUS 149,A00,185845,Staff,0,0,20,20
1683290408707,HUM 3,A01,185882,Zavodny; Tatiana Sophia,0,6,50,50
1683290408707,HUM 3,B01,185899,Caldwell; Michael Alan,0,19,50,50
1683290409738,HUM 3GS,A00,185900,Patterson; Patrick H.,0,0,0,23
1683290410770,HUM 4,A01,185938,Zroka; Amy Liane,31,0,50,19
1683290410770,HUM 4,B01,185956,Watkins; Eric,0,2,50,50
1683290410770,HUM 4,B02,202209,Watkins; Eric,0,1,50,50
1683290410770,HUM 4,B03,202210,Watkins; Eric,0,0,50,50
1683290411797,HUM 5,A01,185958,West; Geoffrey Scott,5,0,50,45
1683290411797,HUM 5,A02,202215,West; Geoffrey Scott,0,0,50,50
1683290412823,INTL 190,A00,185959,Gagnon; Jeffrey C,0,0,0,9
1683290412823,INTL 190,B00,185960,Lettieri; Michael Joseph,0,0,0,1
1683290413855,JAPN 180,A00,254509,Staff,0,1,25,25
1683290414887,LATI 10,A01,202853,Kennemore; Amy Michelle,5,0,35,30
1683290414887,LATI 10,A02,202854,Kennemore; Amy Michelle,1,0,35,34
1683290414887,LATI 10,A03,270054,Kennemore; Amy Michelle,30,0,30,0
1683290415915,LATI 180,A00,202855,Kennemore; Amy Michelle,11,0,20,9
1683290416945,LAWS 101,A00,201767,Golan; Tal,0,7,40,40
1683290417972,LIFR 1C,A00,185961,Staff,6,0,20,14
1683290419000,LIFR 1CX,A00,185962,Staff,7,0,20,13
1683290420026,LIFR 1D,A00,185963,Staff,9,0,20,11
1683290421052,LIFR 1DX,A00,185964,Staff,9,0,20,11
1683290422077,LIGN 101,A01,186039,Staff,43,0,50,7
1683290423158,LIGN 165,A00,186040,Staff,18,0,50,32
1683290424186,LTCS 108,A00,186041,Staff,6,0,10,4
1683290425211,LTCS 119,A00,186042,Staff,16,0,20,4
1683290426244,LTCS 130,A00,186043,Wesling; Megan E.,15,0,25,10
1683290428300,LTEA 138,A00,186119,Staff,14,0,40,26
1683290429335,LTEN 124,A00,186148,Staff,6,0,25,19
1683290430362,LTEN 178,A00,186149,Staff,7,0,15,8
1683290431389,LTEN 181,A00,186150,Blanco; John D,33,0,40,7
1683290432415,LTWL 120,A00,186160,Staff,20,0,25,5
1683290433442,LTWL 165,A00,186161,Staff,22,0,25,3
1683290434469,LTWR 100,A00,186162,Staff,0,4,15,15
1683290435508,LTWR 102,A00,186163,Doller; Ben,5,0,15,10
1683290436536,MAE 8,A01,186412,Staff,0,0,0,0
1683290437562,MAE 30B,A00,186445,Bahadori; Mohammad Yousef,83,0,100,17
1683290438594,MAE 40,A00,186592,Bewley; Thomas R,9,0,50,41
1683290439622,MAE 101B,A00,186593,Bahadori; Mohammad Yousef,81,0,100,19
1683290440661,MAE 105,A00,186594,Bandaru; Prabhakar,12,0,50,38
1683290441693,MAE 107,A00,186599,Pham; Hieu Tan,0,6,120,120
1683290442720,MAE 148,A01,186660,Silberman; Jack,3,0,16,13
1683290443748,MATH 10A,A01,188095,Staff,0,7,35,35
1683290444776,MATH 10B,A01,188097,Bowers; Adam R.,0,11,30,30
1683290444776,MATH 10B,A02,188099,Bowers; Adam R.,0,9,30,30
1683290444776,MATH 10B,B01,188104,Bowers; Adam R.,0,11,30,30
1683290444776,MATH 10B,B02,188106,Bowers; Adam R.,0,11,30,30
1683290445811,MATH 10C,A01,188111,Staff,0,18,30,30
1683290445811,MATH 10C,A02,188127,Staff,0,17,30,30
1683290445811,MATH 10C,A03,188131,Staff,0,17,30,30
1683290445811,MATH 10C,B01,188218,Staff,21,0,30,9
1683290445811,MATH 10C,B02,188244,Staff,13,0,30,17
1683290445811,MATH 10C,B03,188277,Staff,16,0,30,14
1683290446839,MATH 18,A01,188344,Bach; Quang Tran,18,0,30,12
1683290446839,MATH 18,A02,188345,Bach; Quang Tran,11,0,30,19
1683290446839,MATH 18,B01,188353,Bach; Quang Tran,10,0,30,20
1683290446839,MATH 18,B02,188354,Bach; Quang Tran,20,0,30,10
1683290447867,MATH 20A,A01,188374,Staff,13,0,35,22
1683290448895,MATH 20B,A01,188382,Ohm; Ko Woon,6,0,30,24
1683290448895,MATH 20B,A02,188383,Ohm; Ko Woon,24,0,30,6
1683290448895,MATH 20B,B01,188385,Ohm; Ko Woon,7,0,30,23
1683290448895,MATH 20B,B02,188392,Ohm; Ko Woon,22,0,30,8
1683290449924,MATH 20C,A01,188394,Harel; Guershon,10,0,30,20
1683290449924,MATH 20C,A02,188395,Harel; Guershon,13,0,30,17
1683290449924,MATH 20C,B01,188404,Harel; Guershon,3,0,30,27
1683290449924,MATH 20C,B02,188405,Harel; Guershon,19,0,30,11
1683290450958,MATH 20D,A01,188414,Hammock; Frances H,0,1,30,30
1683290450958,MATH 20D,A02,188415,Hammock; Frances H,4,0,30,26
1683290450958,MATH 20D,B01,188447,Hammock; Frances H,2,0,30,28
1683290450958,MATH 20D,B02,188486,Hammock; Frances H,8,0,30,22
1683290451991,MATH 20E,A01,188649,Staff,22,0,30,8
1683290451991,MATH 20E,A02,188650,Staff,23,0,30,7
1683290451991,MATH 20E,A03,188673,Staff,0,0,30,30
1683290453021,MATH 102,A01,188675,Staff,0,35,35,35
1683290454050,MATH 103B,A01,188681,Staff,4,0,35,31
1683290454050,MATH 103B,B01,188692,Staff,8,0,35,27
1683290455078,MATH 109,A01,188695,Salehi Golsefidy; Alireza,25,0,35,10
1683290455078,MATH 109,A02,188696,Salehi Golsefidy; Alireza,27,0,35,8
1683290456111,MATH 120A,A01,188698,Eggers; John Dietrich,5,0,35,30
1683290457145,MATH 142B,A01,188736,Ioana; Adrian,0,2,30,30
1683290457145,MATH 142B,A02,188741,Ioana; Adrian,0,1,30,30
1683290457145,MATH 142B,A03,188743,Ioana; Adrian,0,3,30,30
1683290458182,MATH 168A,A01,188790,Staff,0,8,35,35
1683290459218,MATH 170A,A01,188803,Nie; Jiawang,0,2,35,35
1683290459218,MATH 170A,A02,188811,Nie; Jiawang,0,0,35,35
1683290459218,MATH 170A,A03,188814,Nie; Jiawang,1,0,35,34
1683290459218,MATH 170A,A04,188815,Nie; Jiawang,14,0,35,21
1683290460246,MATH 193B,A01,188817,Staff,0,0,35,35
1683290460246,MATH 193B,A02,188818,Staff,5,0,35,30
1683290461277,MGT 4,A01,202857,Anderson; John Charles,62,0,80,18
1683290462305,MGT 12,A00,202858,Lindenberger; Wade Douglas,43,0,90,47
1683290463335,MGT 18,A00,202859,Staff,74,0,90,16
1683290464362,MGT 18GS,A00,202860,McKay; Michael J,13,0,28,15
1683290465389,MGT 45,A00,202861,Pecore; Joseph P.,14,0,90,76
1683290466421,MGT 100,A00,202863,Yavorsky; Daniel Ryan,28,0,90,62
1683290467454,MGT 103,A00,202864,Ehrich; Kristine R,0,16,90,90
1683290468485,MGT 112,A00,202865,Ehrich; Kristine R,15,0,90,75
1683290469517,MGT 121A,A00,202868,Staff,0,19,0,0
1683290470545,MGT 131B,A00,202869,Anderson; John Charles,60,0,90,30
1683290471572,MGT 136,A00,202871,Lindenberger; Wade Douglas,84,0,90,6
1683290472597,MGT 164,A00,202873,Staff,0,69,90,90
1683290473623,MGT 164GS,A00,202874,McKay; Mary A,13,0,28,15
1683290474652,MGT 180,A00,202875,Staff,0,51,90,90
1683290475678,MMW 11R,A01,205019,Herbst; Matthew,3,0,30,27
1683290475678,MMW 11R,A02,205026,Herbst; Matthew,29,0,30,1
1683290476706,MMW 15,A01,193512,Chang; Edmond Yi-Teh,0,9,28,28
1683290476706,MMW 15,A02,193513,Chang; Edmond Yi-Teh,0,5,28,28
1683290476706,MMW 15,A03,193514,Chang; Edmond Yi-Teh,0,5,28,28
1683290476706,MMW 15,A04,193515,Chang; Edmond Yi-Teh,0,4,28,28
1683290476706,MMW 15,A05,193516,Chang; Edmond Yi-Teh,0,4,28,28
1683290476706,MMW 15,A06,193517,Chang; Edmond Yi-Teh,0,5,28,28
1683290476706,MMW 15,B01,193519,Chang; Edmond Yi-Teh,0,4,28,28
1683290476706,MMW 15,B02,193520,Chang; Edmond Yi-Teh,0,5,28,28
1683290476706,MMW 15,B03,193521,Chang; Edmond Yi-Teh,0,4,28,28
1683290476706,MMW 15,B04,193522,Chang; Edmond Yi-Teh,0,4,28,28
1683290476706,MMW 15,B05,193523,Chang; Edmond Yi-Teh,0,5,28,28
1683290476706,MMW 15,B06,193524,Chang; Edmond Yi-Teh,0,4,28,28
1683290477739,MMW 122,A01,193526,Rahimi; Babak,0,14,28,28
1683290477739,MMW 122,A02,193527,Rahimi; Babak,0,14,28,28
1683290477739,MMW 122,A03,193528,Rahimi; Babak,0,0,0,0
1683290477739,MMW 122,A04,193529,Rahimi; Babak,0,0,0,0
1683290478766,MUS 1A,A01,186663,Staff,0,20,35,35
1683290479798,MUS 4,A01,186715,Staff,0,12,35,35
1683290480825,MUS 5R,A01,186796,Dubnov; Shlomo,0,16,35,35
1683290481852,MUS 6,A01,186798,Staff,0,3,25,25
1683290482882,MUS 7,A01,186830,Staff,12,0,35,23
1683290483908,MUS 8,A01,186930,Staff,0,25,35,35
1683290484940,MUS 15,A01,186932,Staff,0,15,35,35
1683290484940,MUS 15,B01,186934,Staff,0,14,35,35
1683290485973,MUS 80,A00,186935,Staff,2,0,20,18
1683290485973,MUS 80,B00,186936,Staff,25,0,25,0
1683290487000,NANO 11,A00,204702,Lipomi; Darren John,0,0,0,0
1683290488036,NANO 15,A01,204709,Yang; Kesong,0,1,0,0
1683290489070,NANO 114,A00,202069,Jahed Motlagh; Zeinab,3,0,10,7
1683290490103,PHIL 1,A00,186955,Grush; Rick Scott,32,0,40,8
1683290491129,PHIL 10,A01,186973,Grush; Rick Scott,29,0,35,6
1683290491129,PHIL 10,A02,186974,Grush; Rick Scott,33,0,35,2
1683290492159,PHIL 13,A01,186976,Staff,7,0,35,28
1683290492159,PHIL 13,A02,186977,Staff,16,0,35,19
1683290493190,PHIL 14,A01,186979,Staff,31,0,35,4
1683290493190,PHIL 14,A02,186986,Staff,32,0,35,3
1683290494218,PHIL 28,A01,186988,Staff,16,0,30,14
1683290494218,PHIL 28,A02,186989,Staff,1,0,30,29
1683290494218,PHIL 28,A03,186990,Staff,9,0,30,21
1683290494218,PHIL 28,A04,186991,Staff,26,0,30,4
1683290495245,PHIL 120,A00,186997,Staff,23,0,40,17
1683290496272,PHIL 137,A00,187003,Staff,9,0,40,31
1683290497299,PHIL 150,A00,187015,Staff,47,0,70,23
1683290498332,PHIL 167,A00,187021,Lamey; Andy M.,35,0,40,5
1683290499357,PHIL 174,A01,202226,Staff,17,0,20,3
1683290499357,PHIL 174,A02,202235,Staff,20,0,20,0
1683290500386,PHIL 191A,A00,258918,Staff,0,0,1,1
1683290501419,PHYS 1A,A00,187028,Staff,26,0,60,34
1683290502446,PHYS 1AL,001,187036,Staff,2,0,30,28
1683290502446,PHYS 1AL,002,187049,Staff,18,0,30,12
1683290503477,PHYS 1B,A00,187058,Staff,23,0,60,37
1683290504518,PHYS 1BL,001,187064,Staff,0,0,30,30
1683290504518,PHYS 1BL,002,187070,Staff,6,0,30,24
1683290505546,PHYS 1C,A00,187082,Staff,32,0,120,88
1683290506574,PHYS 1CL,001,187088,Staff,0,9,30,30
1683290506574,PHYS 1CL,002,187089,Staff,0,2,30,30
1683290506574,PHYS 1CL,009,262693,Staff,12,0,30,18
1683290507606,PHYS 2B,A01,187097,Staff,54,0,115,61
1683290508635,PHYS 2C,A01,187099,Staff,67,0,115,48
1683290509662,PHYS 2CL,A01,187101,Staff,5,0,28,23
1683290509662,PHYS 2CL,A02,187102,Staff,15,0,28,13
1683290510696,PHYS 2D,A01,187123,Shotwell; Brian,95,0,115,20
1683290511723,PHYS 4B,A01,187133,Grinstein; Benjamin,35,0,50,15
1683290512749,POLI 10,A00,188819,Staff,0,3,50,50
1683290513778,POLI 11,A00,188827,Staff,43,0,50,7
1683290514805,POLI 13R,A00,188828,Staff,0,1,20,20
1683290515831,POLI 27,A01,188830,Elgin; Samuel Zincke,0,1,70,70
1683290516856,POLI 30,A00,188832,Desposato; Scott,33,0,50,17
1683290517883,POLI 102F,A00,188834,Staff,3,0,40,37
1683290518909,POLI 104A,A00,188852,Staff,14,0,30,16
1683290519940,POLI 104I,A00,188853,Staff,0,6,20,20
1683290520973,POLI 110B,A00,188854,Wiens; David,7,0,20,13
1683290522001,POLI 112A,A00,188855,Wiens; David,5,0,30,25
1683290523026,POLI 117R,A00,188856,Forman; Fonna,0,11,20,20
1683290524053,POLI 118,A00,188857,Ingham; Sean,8,0,20,12
1683290525079,POLI 120G,A00,188858,Staff,9,0,30,21
1683290526107,POLI 131CR,A00,188863,Hoston; Germaine,24,0,50,26
1683290527193,POLI 133,A00,188864,Nellis; Gareth Hb,44,0,50,6
1683290528223,POLI 134D,A00,188865,Desposato; Scott,27,0,30,3
1683290529254,POLI 142A,A00,188871,Gartzke; Erik,22,0,50,28
1683290530280,POLI 142K,A00,188874,Staff,38,0,50,12
1683290531306,POLI 143,A00,188940,Gartzke; Erik,16,0,30,14
1683290532332,POLI 153,A00,188943,Staff,3,0,20,17
1683290533360,POLI 160AA,A00,188944,Staff,13,0,40,27
1683290534384,POLI 170A,A00,188945,Staff,11,0,30,19
1683290536438,PSYC 1,A00,188952,Staff,38,0,90,52
1683290537468,PSYC 2,B00,188953,Staff,20,0,35,15
1683290538498,PSYC 6,A00,188970,Staff,47,0,60,13
1683290539528,PSYC 7,A00,188973,Staff,37,0,45,8
1683290540554,PSYC 60,A01,188980,Rickard; Timothy C.,43,0,60,17
1683290541581,PSYC 70,A01,189001,Steiner; Eric Tomas,24,0,45,21
1683290542615,PSYC 100,A00,189005,Lacefield; Katharine I,0,99,120,120
1683290543646,PSYC 102,A00,189008,Staff,10,0,30,20
1683290544676,PSYC 106,B00,189026,Gorman; Michael R.,37,0,60,23
1683290545709,PSYC 114,B01,189033,Winkielman; Piotr,0,32,30,30
1683290546739,PSYC 131,A00,189036,Anagnostaras; Stephan,0,43,60,60
1683290547770,PSYC 136,A00,189041,Lowe; Angela Beth,0,7,25,25
1683290548800,PSYC 137,A00,189057,Winkielman; Piotr,0,34,25,25
1683290549830,PSYC 144,A00,189107,Wixted; John T,0,7,50,50
1683290551885,PSYC 162,A00,189142,Staff,0,8,85,85
1683290552912,PSYC 172,A00,189144,Gorman; Michael R.,0,7,30,30
1683290554967,PSYC 179,A00,189146,Lacefield; Katharine I,0,84,120,120
1683290555993,PSYC 181,A00,189147,Anagnostaras; Stephan,0,44,90,90
1683290557019,PSYC 190R,A00,189148,Barner; David A.,0,22,80,80
1683290558046,PSYC 191,A00,189275,Rickard; Timothy C.,0,7,25,25
1683290559078,PSYC 193,A00,189276,Chapman; Eddie Nathaniel,0,1,0,4
1683290560106,PSYC 193L,A01,189281,Lowe; Angela Beth,12,0,20,8
1683290560106,PSYC 193L,B01,189285,Staff,28,0,35,7
1683290561131,RELI 149,A00,187137,Rahimi; Babak,7,0,40,33
1683290562163,SE 9,A01,187315,Staff,0,2,18,18
1683290563190,SE 101B,A00,187409,Staff,24,0,30,6
1683290564217,SE 110B,A00,187444,Staff,10,0,40,30
1683290565245,SE 130B,A00,187449,Staff,31,0,40,9
1683290566270,SE 150A,A00,187516,Staff,9,0,20,11
1683290567296,SE 154,A00,187528,Staff,30,0,50,20
1683290568323,SIO 3,A01,258171,Staff,35,0,40,5
1683290569348,SIO 10,A00,187144,Cook; Geoffrey W,0,3,75,75
1683290570374,SIO 45,A00,187152,Cook; Geoffrey W,1,0,100,99
1683290571399,SIO 109R,A00,194486,Staff,0,3,20,20
1683290573450,SIO 187,A01,187233,Kacev; David,12,0,40,28
1683290574485,SOCI 1,A01,258656,Thorpe; Charles Robert,28,0,30,2
1683290574485,SOCI 1,A02,258658,Thorpe; Charles Robert,30,0,30,0
1683290574485,SOCI 1,A03,258661,Thorpe; Charles Robert,25,0,25,0
1683290574485,SOCI 1,A04,258666,Thorpe; Charles Robert,22,0,25,3
1683290574485,SOCI 1,A05,258897,Thorpe; Charles Robert,23,0,25,2
1683290574485,SOCI 1,A06,258898,Thorpe; Charles Robert,25,0,25,0
1683290575510,SOCI 30,A01,258903,Pardo Guerra; Juan Pablo,16,0,30,14
1683290576536,SOCI 102,A00,258904,Staff,9,0,25,16
1683290577561,SOCI 106,A00,258905,Staff,19,0,25,6
1683290578587,SOCI 111,A00,258907,Ribas Norris; Janet Vanesa,26,0,30,4
1683290579613,SOCI 121R,A00,258908,Pardo Guerra; Juan Pablo,11,0,30,19
1683290580641,SOCI 126,A01,203330,Staff,14,0,20,6
1683290581671,SOCI 131,A00,258909,Thorpe; Charles Robert,31,0,60,29
1683290582701,SOCI 135,A00,258910,Payne; Christine Anna,0,9,30,30
1683290583732,SOCI 157,A00,258911,Staff,13,0,30,17
1683290584758,SOCI 184,A00,258912,Staff,26,0,30,4
1683290585784,SOCI 188D,A00,258913,Staff,21,0,30,9
1683290586813,SYN 2,001,187529,Staff,9,0,16,7
1683290586813,SYN 2,002,201452,Staff,0,18,16,16
1683290586813,SYN 2,003,201469,Staff,3,0,16,13
1683290587851,SYN 100,A01,187531,Staff,0,9,20,20
1683290587851,SYN 100,B01,201491,Staff,0,12,20,20
1683290588881,TDAC 1,A00,189286,Walsh; Kim C.,3,0,20,17
1683290588881,TDAC 1,B00,189287,Harting; Carla Kelso,11,0,20,9
1683290589908,TDAC 101,A00,189300,Walsh; Kim C.,16,0,20,4
1683290589908,TDAC 101,B00,189301,Harting; Carla Kelso,18,0,20,2
1683290590934,TDAC 102,A00,189304,Basso; Beatrice,14,0,20,6
1683290591959,TDAC 108,A00,189305,Staff,18,0,20,2
1683290592987,TDDE 131,A00,189310,Staff,19,0,20,1
1683290592987,TDDE 131,B00,189314,Staff,19,0,20,1
1683290592987,TDDE 131,C00,189315,Staff,48,0,50,2
1683290592987,TDDE 131,D00,189316,Staff,14,0,15,1
1683290592987,TDDE 131,E00,204841,Staff,20,0,20,0
1683290594014,TDGE 10,A00,189289,Staff,30,0,50,20
1683290594014,TDGE 10,B00,189290,Havis; Allan,2,0,50,48
1683290595048,TDGE 11,A00,189291,Fulton; Julia,0,3,50,50
1683290595048,TDGE 11,B00,189292,Staff,20,0,25,5
1683290595048,TDGE 11,C00,260270,Staff,0,0,0,0
1683290596079,TDGE 25,A00,189294,Staff,3,0,20,17
1683290597108,TDGE 124,A00,189318,Fulton; Julia,0,8,50,50
1683290598136,TDGE 125,A00,189319,Staff,13,0,25,12
1683290598136,TDGE 125,B00,189320,Staff,23,0,25,2
1683290599162,TDGE 127,A00,189322,Havis; Allan,0,0,50,50
1683290600188,TDHT 101,A00,189323,Staff,18,0,25,7
1683290600188,TDHT 101,B00,189324,Staff,25,0,25,0
1683290601212,TDHT 102,A00,189325,Staff,49,0,50,1
1683290602243,TDMV 1,A00,189295,Arcidiacono; Kristin,20,0,30,10
1683290602243,TDMV 1,B00,189296,Caligagan; Maria T.,24,0,30,6
1683290603274,TDMV 2,A00,189297,Sammartano; Tonnie,28,0,30,2
1683290603274,TDMV 2,B00,189299,Arcidiacono; Kristin,24,0,30,6
1683290604302,TDMV 3,A00,204998,Rincon; Alicia,22,0,30,8
1683290605332,TDMV 120,A00,189458,Sammartano; Tonnie,28,0,30,2
1683290606361,TDMV 138,A00,189541,Jun; Grace Shin Hae,22,0,40,18
1683290607391,TDMV 142,A00,189717,Caligagan; Tony,23,0,30,7
1683290607391,TDMV 142,B00,189718,Caligagan; Maria T.,25,0,30,5
1683290608425,TMC 2,A01,187533,Staff,25,0,25,0
1683290608425,TMC 2,A02,187534,Staff,25,0,25,0
1683290609458,USP 1,A01,187536,Kwak; Nancy,0,16,25,25
1683290610489,USP 5,A01,187538,Staff,9,0,25,16
1683290611519,USP 101,A00,199253,Staff,0,4,0,0
1683290612550,USP 124,A00,187562,Boomhower; Matthew Charles,1,0,30,29
1683290613580,USP 138,A00,187582,Staff,20,0,25,5
1683290614611,USP 152,A01,187597,Staff,4,0,25,21
1683290615634,USP 153,A00,187598,Staff,19,0,25,6
1683290616660,USP 168,A00,187607,Kwak; Nancy,2,0,5,3
1683290617689,USP 173,A00,187619,Staff,4,0,25,21
1683290618719,USP 181,A00,187638,Staff,0,0,25,25
1683290619745,VIS 103,A00,187650,Cruz; Edwin Teddy,23,0,75,52
1683290620770,VIS 110D,A00,187669,Staff,12,0,22,10
1683290621796,VIS 127C,A00,187720,Shen; Kuiyi,68,0,146,78
1683290622824,VIS 149,A00,187731,Yoldas; Pinar,0,14,22,22
1683290623849,VIS 151,A01,188091,Staff,22,0,34,12
1683290623849,VIS 151,A02,188092,Staff,11,0,34,23
1683290624876,VIS 160B,A00,188093,Stalbaum; Brett,0,0,10,10
1683290626929,WCWP 10B,A00,201720,Staff,10,0,15,5
1683290626929,WCWP 10B,B00,201722,Staff,8,0,15,7
1683290627956,WCWP 100,A00,201725,Gagnon; Jeffrey C,0,0,2,2
1683290627956,WCWP 100,B00,201727,Staff,0,4,15,15
1683290631241,ANBI 133,A00,258401,Wilder; Linnea Lorene,34,0,40,6
1683290632272,ANBI 140,A00,258395,Hrvoj Mihic; Branka,18,0,25,7
1683290633298,ANSC 120,A00,258402,Bialecki; Jon Anthony,27,0,40,13
1683290634325,ANSC 144,A00,258400,Staff,14,0,40,26
1683290636377,ANSC 166,A00,258396,Parish; Steven Martin,157,0,175,18
1683290637401,ANSC 180,A00,193533,Staff,9,0,20,11
1683290638432,ANSC 188,A00,258397,Jassal; Aftab,33,0,40,7
1683290639462,ANTH 3,A01,258316,Staff,23,0,30,7
1683290640489,ANTH 5,A00,258394,Semendeferi; Ekaterini,16,0,20,4
1683290641514,ANTH 21,A01,258331,Staff,9,0,40,31
1683290642540,ANTH 103,A00,258398,Varma; Saiba,15,0,25,10
1683290643569,AWP 10,001,202034,Staff,0,0,0,0
1683290643569,AWP 10,002,202035,Staff,0,0,0,0
1683290643569,AWP 10,003,202036,Staff,0,0,0,0
1683290643569,AWP 10,004,202037,Staff,0,0,0,0
1683290643569,AWP 10,005,202038,Staff,0,0,0,0
1683290643569,AWP 10,006,202039,Staff,0,0,0,0
1683290643569,AWP 10,007,202040,Staff,0,0,0,0
1683290643569,AWP 10,008,202041,Staff,0,0,0,0
1683290643569,AWP 10,009,202042,Staff,0,0,0,0
1683290643569,AWP 10,010,202043,Staff,0,0,0,0
1683290643569,AWP 10,011,202044,Staff,0,0,0,0
1683290643569,AWP 10,012,202045,Staff,0,0,0,0
1683290643569,AWP 10,013,202046,Staff,0,0,0,0
1683290643569,AWP 10,014,202047,Staff,0,0,0,0
1683290643569,AWP 10,015,202048,Staff,0,0,0,0
1683290643569,AWP 10,016,202049,Staff,0,0,0,0
1683290643569,AWP 10,017,202050,Staff,0,0,0,0
1683290643569,AWP 10,018,202051,Staff,0,0,0,0
1683290643569,AWP 10,019,202052,Staff,0,0,0,0
1683290643569,AWP 10,020,202053,Staff,0,0,0,0
1683290643569,AWP 10,021,202054,Staff,0,0,0,0
1683290643569,AWP 10,022,202055,Staff,0,0,0,0
1683290643569,AWP 10,023,202056,Staff,0,0,0,0
1683290643569,AWP 10,024,202057,Staff,0,0,0,0
1683290643569,AWP 10,025,202058,Staff,0,0,0,0
1683290643569,AWP 10,026,202059,Staff,0,0,0,0
1683290644595,AWP 102,001,202032,Staff,0,0,0,0
1683290644595,AWP 102,002,202033,Staff,0,0,0,0
1683290645622,BENG 100,A01,254234,Taylor Amos; Alyssa C,31,0,40,9
1683290646654,BENG 196,001,270013,Engler; Adam J.,9999,0,9999,0
1683290647683,BICD 100R,A01,202018,Smith; Laurie,0,7,32,32
1683290647683,BICD 100R,A02,202019,Smith; Laurie,0,2,32,32
1683290647683,BICD 100R,A03,202020,Smith; Laurie,0,1,32,32
1683290647683,BICD 100R,A04,202021,Smith; Laurie,8,0,32,24
1683290647683,BICD 100R,A05,202022,Smith; Laurie,12,0,32,20
1683290648719,BICD 136,A01,193242,Gustafson-Brown; Cindy,0,2,32,32
1683290648719,BICD 136,A02,193244,Gustafson-Brown; Cindy,15,0,32,17
1683290649755,BIEB 102,A01,193249,Butler; Shannon Rhey,0,2,32,32
1683290649755,BIEB 102,A02,193251,Butler; Shannon Rhey,0,0,32,32
1683290649755,BIEB 102,A03,193253,Butler; Shannon Rhey,0,1,32,32
1683290649755,BIEB 102,A04,193255,Butler; Shannon Rhey,17,0,32,15
1683290649755,BIEB 102,A05,193265,Butler; Shannon Rhey,26,0,32,6
1683290649755,BIEB 102,A06,193269,Butler; Shannon Rhey,16,0,32,16
1683290651815,BIEB 150,A01,193274,Staff,0,0,32,32
1683290651815,BIEB 150,A02,193285,Staff,24,0,32,8
1683290652847,BIEB 194,A00,193286,Kurle; Carolyn M.,22,0,32,10
1683290653876,BILD 1,A01,192291,Staff,16,0,32,16
1683290653876,BILD 1,A02,192292,Staff,30,0,32,2
1683290653876,BILD 1,B01,192520,Reuther; Keefe,0,1,0,0
1683290653876,BILD 1,B02,192532,Reuther; Keefe,0,1,0,0
1683290654909,BILD 3,A01,192556,Butler; Shannon Rhey,0,0,32,32
1683290654909,BILD 3,A02,192581,Butler; Shannon Rhey,5,0,32,27
1683290654909,BILD 3,A03,192611,Butler; Shannon Rhey,23,0,32,9
1683290654909,BILD 3,A04,192612,Butler; Shannon Rhey,25,0,32,7
1683290654909,BILD 3,A05,192613,Butler; Shannon Rhey,27,0,32,5
1683290654909,BILD 3,A06,192679,Butler; Shannon Rhey,27,0,32,5
1683290654909,BILD 3,A07,192682,Butler; Shannon Rhey,22,0,32,10
1683290655942,BILD 4,A01,192836,Reuther; Keefe,1,0,24,23
1683290655942,BILD 4,A02,193044,Reuther; Keefe,4,0,24,20
1683290656968,BILD 10,A01,193142,Gustafson-Brown; Cindy,31,0,32,1
1683290656968,BILD 10,A02,193149,Gustafson-Brown; Cindy,31,0,32,1
1683290657998,BIMM 100,A01,193301,Staff,0,6,32,32
1683290657998,BIMM 100,A02,193312,Staff,0,5,32,32
1683290657998,BIMM 100,A03,193323,Staff,0,8,32,32
1683290659031,BIMM 101,A01,193329,McDonnell; Lisa Marie,0,3,24,24
1683290659031,BIMM 101,A02,193339,McDonnell; Lisa Marie,0,2,24,24
1683290659031,BIMM 101,B01,193354,McDonnell; Lisa Marie,0,3,24,24
1683290659031,BIMM 101,B02,193357,McDonnell; Lisa Marie,0,3,24,24
1683290660058,BIMM 110,A01,193377,Tat; John,0,11,32,32
1683290660058,BIMM 110,A02,193378,Tat; John,1,9,32,31
1683290661091,BIMM 120,A01,206116,Staff,0,0,32,32
1683290661091,BIMM 120,A02,206117,Staff,8,0,32,24
1683290661091,BIMM 120,A03,206121,Staff,21,0,32,11
1683290662117,BIPN 100,A01,193393,Park; Ji Young,0,14,32,32
1683290662117,BIPN 100,A02,193402,Park; Ji Young,0,12,32,32
1683290662117,BIPN 100,A03,193413,Park; Ji Young,0,14,32,32
1683290662117,BIPN 100,A04,193414,Park; Ji Young,0,13,32,32
1683290663143,BIPN 102,A01,193429,Staff,0,0,32,32
1683290663143,BIPN 102,A02,193438,Staff,23,0,32,9
1683290664171,BIPN 106,A01,193450,Reyes Gonzalez; Catalina,0,2,40,40
1683290665200,BIPN 134,A01,193465,Cooke; James Edward,0,0,32,32
1683290665200,BIPN 134,A02,193474,Cooke; James Edward,27,0,32,5
1683290665200,BIPN 134,A03,193485,Cooke; James Edward,29,0,32,3
1683290665200,BIPN 134,A04,193486,Cooke; James Edward,21,0,32,11
1683290665200,BIPN 134,A05,193491,Cooke; James Edward,31,0,32,1
1683290665200,BIPN 134,A06,193501,Cooke; James Edward,30,0,32,2
1683290665200,BIPN 134,A07,193510,Cooke; James Edward,29,0,32,3
1683290667259,BISP 194,A00,222522,Staff,16,0,32,16
1683290668288,CAT 124,A01,202407,Staff,20,0,25,5
1683290669315,CAT 125,A00,202408,Marchisotto; Jennifer Anne,4,0,20,16
1683290670342,CAT 125R,A00,202409,Smith; Lauryn Alissa,0,11,20,20
1683290670342,CAT 125R,B00,202410,Morales; Celeste Georgianna,0,11,20,20
1683290670342,CAT 125R,C00,202411,Irwin; Matthew Joseph,0,10,20,20
1683290671367,CENG 15,A01,204712,Yang; Kesong,0,1,0,0
1683290672394,CENG 114,A00,202070,Jahed Motlagh; Zeinab,5,0,20,15
1683290673420,CGS 105,A00,185477,Wesling; Megan E.,24,0,40,16
1683290674444,CGS 106,A00,185494,Staff,13,0,22,9
1683290675469,CGS 108,A00,185495,Staff,14,0,20,6
1683290676495,CGS 114,A00,185496,Staff,13,0,18,5
1683290677522,CGS 119,A00,185501,Staff,15,0,20,5
1683290678552,CGS 120,A00,185511,Staff,13,0,20,7
1683290679583,CHEM 4,A01,184675,Bussey; Thomas J,96,0,100,4
1683290680610,CHEM 6A,A01,184677,Staff,35,0,60,25
1683290681639,CHEM 6B,A01,184679,Staff,65,0,100,35
1683290682666,CHEM 6C,A01,184681,Bussey; Thomas J,1,0,50,49
1683290682666,CHEM 6C,A02,184682,Bussey; Thomas J,34,0,50,16
1683290683692,CHEM 40A,A01,184684,Albizati; Kim F.,37,0,100,63
1683290684718,CHEM 40B,A01,184686,Albizati; Kim F.,0,20,100,100
1683290685745,CHEM 41B,A01,184690,Staff,52,0,100,48
1683290686777,COGS 3,A01,184715,Boyle; Mary E. T.,0,25,40,40
1683290687807,COGS 14B,A01,185172,Staff,0,15,38,38
1683290688836,COGS 18,A01,184736,Staff,20,0,80,60
1683290689868,COGS 100,A01,184932,Staff,0,5,73,73
1683290690897,COGS 101A,A01,184935,Staff,0,38,30,30
1683290691927,COGS 101B,A01,184944,Staff,0,2,30,30
1683290692958,COGS 101C,A01,184946,Staff,0,12,30,30
1683290693985,COGS 102A,A01,184951,Johnson; Christine M.,2,0,40,38
1683290695014,COGS 107B,A01,184953,Mooshagian; Eric Frederick,0,50,40,40
1683290696042,COGS 118B,A01,184959,Gupta; Anjum,0,48,40,40
1683290697069,COGS 153,A00,184961,Staff,0,15,30,30
1683290698096,COGS 177,A00,184962,Staff,0,21,30,30
1683290699124,COGS 187A,A01,184969,Boyle; Mary E. T.,0,17,40,40
1683290700151,COMM 10,A01,185174,Staff,0,5,25,25
1683290700151,COMM 10,A02,185189,Staff,0,5,25,25
1683290700151,COMM 10,A03,269821,Staff,0,0,0,0
1683290701178,COMM 100B,A01,185475,Staff,0,0,0,2
1683290701178,COMM 100B,A02,185476,Staff,14,0,25,11
1683290702202,COMM 100C,A01,185314,Staff,1,0,25,24
1683290702202,COMM 100C,A02,185327,Staff,19,0,25,6
1683290703226,COMM 110M,A00,185349,Staff,2,0,40,38
1683290704250,COMM 113T,A00,185352,Staff,25,0,40,15
1683290705276,COMM 114I,A00,185353,Staff,33,0,40,7
1683290706304,COMM 131,A00,185354,Staff,19,0,30,11
1683290707334,CSE 8A,A50,185358,Cao; Yingjun,0,46,10,10
1683290708366,CSE 8B,A01,185362,Staff,0,47,50,50
1683290709399,CSE 11,A01,185416,Cao; Yingjun,0,93,10,10
1683290710431,CSE 20,A01,185445,Briones; Jor-el Thomas Caparas,5,0,25,20
1683290711463,CSE 21,A01,185447,Staff,10,0,50,40
1683290712489,CSE 101,A01,185451,Staff,0,12,50,50
1683290712489,CSE 101,B01,185453,Jones; Miles E,0,11,50,50
1683290714540,CSE 141,A01,185458,Eldon; John,20,0,100,80
1683290715569,CSE 141L,A01,185461,Eldon; John,12,0,100,88
1683290716594,CSE 142,A01,185463,Staff,35,0,60,25
1683290716594,CSE 142,B01,201355,Staff,0,6,60,60
1683290717618,CSE 142L,A01,185470,Staff,35,0,60,25
1683290717618,CSE 142L,B01,201417,Staff,0,5,60,60
1683290718642,CSE 190,A00,201433,Staff,32,0,49,17
1683290719669,DOC 1,A01,259136,Strom; Megan C.,8,0,15,7
1683290719669,DOC 1,A02,259137,Strom; Megan C.,14,0,15,1
1683290719669,DOC 1,A03,259138,Strom; Megan C.,14,0,15,1
1683290719669,DOC 1,A04,259139,Strom; Megan C.,14,0,15,1
1683290720699,DOC 100D,A00,259140,Pass; Natalye Joann,17,0,25,8
1683290721731,DSGN 1,A01,184749,Rill; Bryan,0,24,30,30
1683290722761,DSGN 100,A01,185168,Staff,0,2,25,25
1683290723788,ECE 5,A01,185626,Morris; Karcher William,0,10,0,0
1683290724818,ECE 101,A01,185628,Staff,17,0,70,53
1683290725845,ECE 107,A01,185635,Baghdadchi; Saharnaz,0,0,20,20
1683290725845,ECE 107,A02,185638,Baghdadchi; Saharnaz,4,0,20,16
1683290726869,ECE 148,A01,185647,Silberman; Jack,1,0,16,15
1683290727900,ECON 1,A01,185537,Crane; Meredith Helen,54,0,70,16
1683290728926,ECON 3,A01,185549,Crane; Meredith Helen,33,0,70,37
1683290729954,ECON 4,A01,203354,Anderson; John Charles,0,4,10,10
1683290730979,ECON 100A,A01,185574,Staff,0,4,40,40
1683290732004,ECON 100B,A01,185576,Staff,0,22,40,40
1683290733033,ECON 100C,A01,185589,Newhouse; Herbert S,30,0,70,40
1683290734063,ECON 105,A00,185608,Vespa; Emanuel Ignacio,19,0,35,16
1683290735152,ECON 109,A01,185610,Shishkin; Denis,10,0,35,25
1683290736175,ECON 110A,A01,185612,Staff,11,0,40,29
1683290737207,ECON 120A,A01,185615,Staff,20,0,40,20
1683290738237,ECON 120C,A01,185617,Sun; Yixiao,0,20,70,70
1683290739267,ECON 144,A00,203346,Squires; Dale E,3,0,35,32
1683290740296,ECON 171,A01,203349,Newhouse; Herbert S,0,1,35,35
1683290741327,ECON 173A,A01,185621,Toda; Alexis Akira,21,0,35,14
1683290742359,EDS 25,A01,202413,Staff,0,1,0,0
1683290742359,EDS 25,A02,202414,Staff,0,1,0,0
1683290742359,EDS 25,A03,202415,Staff,0,0,0,0
1683290742359,EDS 25,A04,202416,Staff,0,1,0,0
1683290742359,EDS 25,A05,202439,Staff,0,0,0,0
1683290742359,EDS 25,A06,202440,Staff,0,0,0,0
1683290742359,EDS 25,B01,202631,Staff,0,0,0,0
1683290742359,EDS 25,B02,202632,Staff,0,0,0,0
1683290742359,EDS 25,B03,202639,Staff,0,0,0,0
1683290742359,EDS 25,B04,202640,Staff,0,0,0,0
1683290742359,EDS 25,B05,202643,Staff,0,0,0,0
1683290742359,EDS 25,B06,202644,Staff,0,0,0,0
1683290743388,EDS 38,A01,202659,Black; Alison Michelle,24,0,25,1
1683290744418,EDS 115,A00,202652,Staff,17,0,30,13
1683290745441,EDS 125,A00,202649,Staff,14,0,30,16
1683290746469,EDS 126,A01,203332,Staff,30,0,30,0
1683290747496,EDS 139,A00,202838,Staff,17,0,25,8
1683290748526,EDS 146,A01,202655,Staff,15,0,25,10
1683290749557,ENG 15,A00,185667,Staff,0,1,0,0
1683290749557,ENG 15,B00,185672,Staff,0,0,0,0
1683290749557,ENG 15,C00,185675,Staff,0,0,0,0
1683290749557,ENG 15,D00,185682,Staff,0,0,0,0
1683290749557,ENG 15,E00,185684,Staff,0,0,0,0
1683290750582,ETHN 103,A00,185710,Staff,0,3,35,35
1683290751611,ETHN 103A,A00,199228,Man; Simeon S,3,0,9,6
1683290752640,ETHN 109,A00,185711,Staff,18,0,35,17
1683290753670,ETHN 142,A00,185726,Staff,0,4,30,30
1683290754696,ETHN 163J,A00,199229,Man; Simeon S,6,0,8,2
1683290755722,ETHN 168,A00,185727,Staff,8,0,10,2
1683290756747,ETHN 182,A00,185728,Staff,1,0,35,34
1683290757775,ETHN 183,A00,185737,Staff,8,0,18,10
1683290758801,GLBH 111,A01,209361,Burgos; Jose L.,0,0,0,0
1683290760861,HIEU 104,A00,185792,Staff,16,0,20,4
1683290761887,HIEU 115,A00,185800,Staff,1,0,20,19
1683290762914,HIEU 128,A00,185801,Staff,0,7,20,20
1683290763939,HIEU 147,A00,185802,Staff,16,0,20,4
1683290764966,HIEU 154,A00,185823,Staff,12,0,20,8
1683290765991,HILA 102,A00,185826,Staff,13,0,20,7
1683290767016,HILD 2C,A01,185778,Staff,0,12,20,20
1683290768042,HILD 7B,A01,185780,Kwak; Nancy,0,15,32,32
1683290768042,HILD 7B,A02,185781,Kwak; Nancy,0,18,32,32
1683290769069,HILD 30,A01,185791,Staff,14,0,20,6
1683290770097,HISC 119,A00,185830,Golan; Tal,0,9,20,20
1683290771126,HITO 156GS,A00,185831,Patterson; Patrick H.,0,0,0,23
1683290772157,HIUS 103,A00,185832,Man; Simeon S,0,7,20,20
1683290773187,HIUS 117,A00,185836,Kwak; Nancy,2,0,20,18
1683290774216,HIUS 125,A00,185840,Man; Simeon S,0,0,23,23
1683290775245,HIUS 149,A00,185845,Staff,0,0,20,20
1683290776279,HUM 3,A01,185882,Zavodny; Tatiana Sophia,0,6,50,50
1683290776279,HUM 3,B01,185899,Caldwell; Michael Alan,0,19,50,50
1683290777308,HUM 3GS,A00,185900,Patterson; Patrick H.,0,0,0,23
1683290778341,HUM 4,A01,185938,Zroka; Amy Liane,31,0,50,19
1683290778341,HUM 4,B01,185956,Watkins; Eric,0,2,50,50
1683290778341,HUM 4,B02,202209,Watkins; Eric,0,1,50,50
1683290778341,HUM 4,B03,202210,Watkins; Eric,0,0,50,50
1683290779371,HUM 5,A01,185958,West; Geoffrey Scott,5,0,50,45
1683290779371,HUM 5,A02,202215,West; Geoffrey Scott,0,0,50,50
1683290780402,INTL 190,A00,185959,Gagnon; Jeffrey C,0,0,0,9
1683290780402,INTL 190,B00,185960,Lettieri; Michael Joseph,0,0,0,1
1683290781429,JAPN 180,A00,254509,Staff,0,1,25,25
1683290782464,LATI 10,A01,202853,Kennemore; Amy Michelle,5,0,35,30
1683290782464,LATI 10,A02,202854,Kennemore; Amy Michelle,1,0,35,34
1683290782464,LATI 10,A03,270054,Kennemore; Amy Michelle,30,0,30,0
1683290783491,LATI 180,A00,202855,Kennemore; Amy Michelle,11,0,20,9
1683290784518,LAWS 101,A00,201767,Golan; Tal,0,7,40,40
1683290785543,LIFR 1C,A00,185961,Staff,6,0,20,14
1683290786571,LIFR 1CX,A00,185962,Staff,7,0,20,13
1683290787596,LIFR 1D,A00,185963,Staff,9,0,20,11
1683290788622,LIFR 1DX,A00,185964,Staff,9,0,20,11
1683290789652,LIGN 101,A01,186039,Staff,43,0,50,7
1683290790680,LIGN 165,A00,186040,Staff,18,0,50,32
1683290791709,LTCS 108,A00,186041,Staff,6,0,10,4
1683290792738,LTCS 119,A00,186042,Staff,16,0,20,4
1683290793765,LTCS 130,A00,186043,Wesling; Megan E.,15,0,25,10
1683290795814,LTEA 138,A00,186119,Staff,14,0,40,26
1683290796841,LTEN 124,A00,186148,Staff,6,0,25,19
1683290797869,LTEN 178,A00,186149,Staff,7,0,15,8
1683290798898,LTEN 181,A00,186150,Blanco; John D,33,0,40,7
1683290799928,LTWL 120,A00,186160,Staff,20,0,25,5
1683290800954,LTWL 165,A00,186161,Staff,22,0,25,3
1683290801979,LTWR 100,A00,186162,Staff,0,4,15,15
1683290803004,LTWR 102,A00,186163,Doller; Ben,5,0,15,10
1683290804035,MAE 8,A01,186412,Staff,0,0,0,0
1683290805064,MAE 30B,A00,186445,Bahadori; Mohammad Yousef,83,0,100,17
1683290806090,MAE 40,A00,186592,Bewley; Thomas R,9,0,50,41
1683290807116,MAE 101B,A00,186593,Bahadori; Mohammad Yousef,81,0,100,19
1683290808141,MAE 105,A00,186594,Bandaru; Prabhakar,12,0,50,38
1683290809165,MAE 107,A00,186599,Pham; Hieu Tan,0,6,120,120
1683290810193,MAE 148,A01,186660,Silberman; Jack,3,0,16,13
1683290811225,MATH 10A,A01,188095,Staff,0,7,35,35
1683290812258,MATH 10B,A01,188097,Bowers; Adam R.,0,11,30,30
1683290812258,MATH 10B,A02,188099,Bowers; Adam R.,0,9,30,30
1683290812258,MATH 10B,B01,188104,Bowers; Adam R.,0,11,30,30
1683290812258,MATH 10B,B02,188106,Bowers; Adam R.,0,11,30,30
1683290813286,MATH 10C,A01,188111,Staff,0,18,30,30
1683290813286,MATH 10C,A02,188127,Staff,0,17,30,30
1683290813286,MATH 10C,A03,188131,Staff,0,17,30,30
1683290813286,MATH 10C,B01,188218,Staff,21,0,30,9
1683290813286,MATH 10C,B02,188244,Staff,13,0,30,17
1683290813286,MATH 10C,B03,188277,Staff,16,0,30,14
1683290814316,MATH 18,A01,188344,Bach; Quang Tran,18,0,30,12
1683290814316,MATH 18,A02,188345,Bach; Quang Tran,11,0,30,19
1683290814316,MATH 18,B01,188353,Bach; Quang Tran,10,0,30,20
1683290814316,MATH 18,B02,188354,Bach; Quang Tran,20,0,30,10
1683290815347,MATH 20A,A01,188374,Staff,13,0,35,22
1683290816373,MATH 20B,A01,188382,Ohm; Ko Woon,6,0,30,24
1683290816373,MATH 20B,A02,188383,Ohm; Ko Woon,24,0,30,6
1683290816373,MATH 20B,B01,188385,Ohm; Ko Woon,7,0,30,23
1683290816373,MATH 20B,B02,188392,Ohm; Ko Woon,22,0,30,8
1683290817405,MATH 20C,A01,188394,Harel; Guershon,10,0,30,20
1683290817405,MATH 20C,A02,188395,Harel; Guershon,13,0,30,17
1683290817405,MATH 20C,B01,188404,Harel; Guershon,3,0,30,27
1683290817405,MATH 20C,B02,188405,Harel; Guershon,19,0,30,11
1683290818438,MATH 20D,A01,188414,Hammock; Frances H,0,1,30,30
1683290818438,MATH 20D,A02,188415,Hammock; Frances H,4,0,30,26
1683290818438,MATH 20D,B01,188447,Hammock; Frances H,2,0,30,28
1683290818438,MATH 20D,B02,188486,Hammock; Frances H,8,0,30,22
1683290819465,MATH 20E,A01,188649,Staff,22,0,30,8
1683290819465,MATH 20E,A02,188650,Staff,23,0,30,7
1683290819465,MATH 20E,A03,188673,Staff,0,0,30,30
1683290820492,MATH 102,A01,188675,Staff,0,35,35,35
1683290821523,MATH 103B,A01,188681,Staff,4,0,35,31
1683290821523,MATH 103B,B01,188692,Staff,8,0,35,27
1683290822551,MATH 109,A01,188695,Salehi Golsefidy; Alireza,25,0,35,10
1683290822551,MATH 109,A02,188696,Salehi Golsefidy; Alireza,27,0,35,8
1683290823595,MATH 120A,A01,188698,Eggers; John Dietrich,5,0,35,30
1683290824621,MATH 142B,A01,188736,Ioana; Adrian,0,2,30,30
1683290824621,MATH 142B,A02,188741,Ioana; Adrian,0,1,30,30
1683290824621,MATH 142B,A03,188743,Ioana; Adrian,0,3,30,30
1683290825650,MATH 168A,A01,188790,Staff,0,8,35,35
1683290826681,MATH 170A,A01,188803,Nie; Jiawang,0,2,35,35
1683290826681,MATH 170A,A02,188811,Nie; Jiawang,0,0,35,35
1683290826681,MATH 170A,A03,188814,Nie; Jiawang,1,0,35,34
1683290826681,MATH 170A,A04,188815,Nie; Jiawang,14,0,35,21
1683290827710,MATH 193B,A01,188817,Staff,0,0,35,35
1683290827710,MATH 193B,A02,188818,Staff,5,0,35,30
1683290828738,MGT 4,A01,202857,Anderson; John Charles,62,0,80,18
1683290829765,MGT 12,A00,202858,Lindenberger; Wade Douglas,43,0,90,47
1683290830791,MGT 18,A00,202859,Staff,74,0,90,16
1683290831817,MGT 18GS,A00,202860,McKay; Michael J,13,0,28,15
1683290832844,MGT 45,A00,202861,Pecore; Joseph P.,14,0,90,76
1683290833874,MGT 100,A00,202863,Yavorsky; Daniel Ryan,28,0,90,62
1683290834903,MGT 103,A00,202864,Ehrich; Kristine R,0,16,90,90
1683290835931,MGT 112,A00,202865,Ehrich; Kristine R,15,0,90,75
1683290836958,MGT 121A,A00,202868,Staff,0,19,0,0
1683290837989,MGT 131B,A00,202869,Anderson; John Charles,59,0,90,31
1683290839071,MGT 136,A00,202871,Lindenberger; Wade Douglas,84,0,90,6
1683290840099,MGT 164,A00,202873,Staff,0,69,90,90
1683290841126,MGT 164GS,A00,202874,McKay; Mary A,13,0,28,15
1683290842149,MGT 180,A00,202875,Staff,0,51,90,90
1683290843175,MMW 11R,A01,205019,Herbst; Matthew,3,0,30,27
1683290843175,MMW 11R,A02,205026,Herbst; Matthew,29,0,30,1
1683290844202,MMW 15,A01,193512,Chang; Edmond Yi-Teh,0,9,28,28
1683290844202,MMW 15,A02,193513,Chang; Edmond Yi-Teh,0,5,28,28
1683290844202,MMW 15,A03,193514,Chang; Edmond Yi-Teh,0,5,28,28
1683290844202,MMW 15,A04,193515,Chang; Edmond Yi-Teh,0,4,28,28
1683290844202,MMW 15,A05,193516,Chang; Edmond Yi-Teh,0,4,28,28
1683290844202,MMW 15,A06,193517,Chang; Edmond Yi-Teh,0,5,28,28
1683290844202,MMW 15,B01,193519,Chang; Edmond Yi-Teh,0,4,28,28
1683290844202,MMW 15,B02,193520,Chang; Edmond Yi-Teh,0,5,28,28
1683290844202,MMW 15,B03,193521,Chang; Edmond Yi-Teh,0,4,28,28
1683290844202,MMW 15,B04,193522,Chang; Edmond Yi-Teh,0,4,28,28
1683290844202,MMW 15,B05,193523,Chang; Edmond Yi-Teh,0,5,28,28
1683290844202,MMW 15,B06,193524,Chang; Edmond Yi-Teh,0,4,28,28
1683290845227,MMW 122,A01,193526,Rahimi; Babak,0,14,28,28
1683290845227,MMW 122,A02,193527,Rahimi; Babak,0,14,28,28
1683290845227,MMW 122,A03,193528,Rahimi; Babak,0,0,0,0
1683290845227,MMW 122,A04,193529,Rahimi; Babak,0,0,0,0
1683290846256,MUS 1A,A01,186663,Staff,0,20,35,35
1683290847283,MUS 4,A01,186715,Staff,0,12,35,35
1683290848313,MUS 5R,A01,186796,Dubnov; Shlomo,0,16,35,35
1683290849343,MUS 6,A01,186798,Staff,0,3,25,25
1683290850368,MUS 7,A01,186830,Staff,12,0,35,23
1683290851397,MUS 8,A01,186930,Staff,0,25,35,35
1683290852427,MUS 15,A01,186932,Staff,0,15,35,35
1683290852427,MUS 15,B01,186934,Staff,0,14,35,35
1683290853453,MUS 80,A00,186935,Staff,2,0,20,18
1683290853453,MUS 80,B00,186936,Staff,25,0,25,0
1683290854481,NANO 11,A00,204702,Lipomi; Darren John,0,0,0,0
1683290855507,NANO 15,A01,204709,Yang; Kesong,0,1,0,0
1683290856538,NANO 114,A00,202069,Jahed Motlagh; Zeinab,3,0,10,7
1683290857566,PHIL 1,A00,186955,Grush; Rick Scott,32,0,40,8
1683290858591,PHIL 10,A01,186973,Grush; Rick Scott,29,0,35,6
1683290858591,PHIL 10,A02,186974,Grush; Rick Scott,33,0,35,2
1683290859617,PHIL 13,A01,186976,Staff,7,0,35,28
1683290859617,PHIL 13,A02,186977,Staff,16,0,35,19
1683290860642,PHIL 14,A01,186979,Staff,31,0,35,4
1683290860642,PHIL 14,A02,186986,Staff,32,0,35,3
1683290861666,PHIL 28,A01,186988,Staff,16,0,30,14
1683290861666,PHIL 28,A02,186989,Staff,1,0,30,29
1683290861666,PHIL 28,A03,186990,Staff,9,0,30,21
1683290861666,PHIL 28,A04,186991,Staff,26,0,30,4
1683290862691,PHIL 120,A00,186997,Staff,23,0,40,17
1683290863717,PHIL 137,A00,187003,Staff,9,0,40,31
1683290864744,PHIL 150,A00,187015,Staff,47,0,70,23
1683290865770,PHIL 167,A00,187021,Lamey; Andy M.,35,0,40,5
1683290866794,PHIL 174,A01,202226,Staff,17,0,20,3
1683290866794,PHIL 174,A02,202235,Staff,20,0,20,0
1683290867822,PHIL 191A,A00,258918,Staff,0,0,1,1
1683290868851,PHYS 1A,A00,187028,Staff,26,0,60,34
1683290869881,PHYS 1AL,001,187036,Staff,2,0,30,28
1683290869881,PHYS 1AL,002,187049,Staff,18,0,30,12
1683290870908,PHYS 1B,A00,187058,Staff,23,0,60,37
1683290871935,PHYS 1BL,001,187064,Staff,0,0,30,30
1683290871935,PHYS 1BL,002,187070,Staff,6,0,30,24
1683290872959,PHYS 1C,A00,187082,Staff,32,0,120,88
1683290873988,PHYS 1CL,001,187088,Staff,0,9,30,30
1683290873988,PHYS 1CL,002,187089,Staff,0,2,30,30
1683290873988,PHYS 1CL,009,262693,Staff,12,0,30,18
1683290875013,PHYS 2B,A01,187097,Staff,54,0,115,61
1683290876040,PHYS 2C,A01,187099,Staff,67,0,115,48
1683290877066,PHYS 2CL,A01,187101,Staff,5,0,28,23
1683290877066,PHYS 2CL,A02,187102,Staff,15,0,28,13
1683290878090,PHYS 2D,A01,187123,Shotwell; Brian,95,0,115,20
1683290879115,PHYS 4B,A01,187133,Grinstein; Benjamin,35,0,50,15
1683290880140,POLI 10,A00,188819,Staff,0,3,50,50
1683290881168,POLI 11,A00,188827,Staff,43,0,50,7
1683290882196,POLI 13R,A00,188828,Staff,0,1,20,20
1683290883223,POLI 27,A01,188830,Elgin; Samuel Zincke,0,1,70,70
1683290884247,POLI 30,A00,188832,Desposato; Scott,33,0,50,17
1683290885273,POLI 102F,A00,188834,Staff,3,0,40,37
1683290886299,POLI 104A,A00,188852,Staff,14,0,30,16
1683290887325,POLI 104I,A00,188853,Staff,0,6,20,20
1683290888350,POLI 110B,A00,188854,Wiens; David,7,0,20,13
1683290889379,POLI 112A,A00,188855,Wiens; David,5,0,30,25
1683290890408,POLI 117R,A00,188856,Forman; Fonna,0,11,20,20
1683290891436,POLI 118,A00,188857,Ingham; Sean,8,0,20,12
1683290892461,POLI 120G,A00,188858,Staff,9,0,30,21
1683290893486,POLI 131CR,A00,188863,Hoston; Germaine,24,0,50,26
1683290894512,POLI 133,A00,188864,Nellis; Gareth Hb,44,0,50,6
1683290895538,POLI 134D,A00,188865,Desposato; Scott,27,0,30,3
1683290896563,POLI 142A,A00,188871,Gartzke; Erik,22,0,50,28
1683290897592,POLI 142K,A00,188874,Staff,38,0,50,12
1683290898621,POLI 143,A00,188940,Gartzke; Erik,16,0,30,14
1683290899650,POLI 153,A00,188943,Staff,3,0,20,17
1683290900681,POLI 160AA,A00,188944,Staff,13,0,40,27
1683290901708,POLI 170A,A00,188945,Staff,11,0,30,19
1683290903768,PSYC 1,A00,188952,Staff,38,0,90,52
1683290904798,PSYC 2,B00,188953,Staff,20,0,35,15
1683290905824,PSYC 6,A00,188970,Staff,47,0,60,13
1683290906850,PSYC 7,A00,188973,Staff,37,0,45,8
1683290907876,PSYC 60,A01,188980,Rickard; Timothy C.,43,0,60,17
1683290908900,PSYC 70,A01,189001,Steiner; Eric Tomas,24,0,45,21
1683290909924,PSYC 100,A00,189005,Lacefield; Katharine I,0,99,120,120
1683290910955,PSYC 102,A00,189008,Staff,10,0,30,20
1683290911985,PSYC 106,B00,189026,Gorman; Michael R.,37,0,60,23
1683290913015,PSYC 114,B01,189033,Winkielman; Piotr,0,32,30,30
1683290914044,PSYC 131,A00,189036,Anagnostaras; Stephan,0,43,60,60
1683290915069,PSYC 136,A00,189041,Lowe; Angela Beth,0,7,25,25
1683290916094,PSYC 137,A00,189057,Winkielman; Piotr,0,34,25,25
1683290917120,PSYC 144,A00,189107,Wixted; John T,0,7,50,50
1683290919168,PSYC 162,A00,189142,Staff,0,8,85,85
1683290920193,PSYC 172,A00,189144,Gorman; Michael R.,0,7,30,30
1683290922243,PSYC 179,A00,189146,Lacefield; Katharine I,0,84,120,120
1683290923267,PSYC 181,A00,189147,Anagnostaras; Stephan,0,44,90,90
1683290924292,PSYC 190R,A00,189148,Barner; David A.,0,22,80,80
1683290925321,PSYC 191,A00,189275,Rickard; Timothy C.,0,7,25,25
1683290926346,PSYC 193,A00,189276,Chapman; Eddie Nathaniel,0,1,0,4
1683290927376,PSYC 193L,A01,189281,Lowe; Angela Beth,12,0,20,8
1683290927376,PSYC 193L,B01,189285,Staff,28,0,35,7
1683290928407,RELI 149,A00,187137,Rahimi; Babak,7,0,40,33
1683290929431,SE 9,A01,187315,Staff,0,2,18,18
1683290930457,SE 101B,A00,187409,Staff,24,0,30,6
1683290931484,SE 110B,A00,187444,Staff,10,0,40,30
1683290932509,SE 130B,A00,187449,Staff,31,0,40,9
1683290933535,SE 150A,A00,187516,Staff,9,0,20,11
1683290934562,SE 154,A00,187528,Staff,30,0,50,20
1683290935588,SIO 3,A01,258171,Staff,35,0,40,5
1683290936616,SIO 10,A00,187144,Cook; Geoffrey W,0,3,75,75
1683290937642,SIO 45,A00,187152,Cook; Geoffrey W,1,0,100,99
1683290938666,SIO 109R,A00,194486,Staff,0,3,20,20
1683290940715,SIO 187,A01,187233,Kacev; David,12,0,40,28
1683290941742,SOCI 1,A01,258656,Thorpe; Charles Robert,28,0,30,2
1683290941742,SOCI 1,A02,258658,Thorpe; Charles Robert,30,0,30,0
1683290941742,SOCI 1,A03,258661,Thorpe; Charles Robert,25,0,25,0
1683290941742,SOCI 1,A04,258666,Thorpe; Charles Robert,22,0,25,3
1683290941742,SOCI 1,A05,258897,Thorpe; Charles Robert,23,0,25,2
1683290941742,SOCI 1,A06,258898,Thorpe; Charles Robert,25,0,25,0
1683290942823,SOCI 30,A01,258903,Pardo Guerra; Juan Pablo,16,0,30,14
1683290943852,SOCI 102,A00,258904,Staff,9,0,25,16
1683290944877,SOCI 106,A00,258905,Staff,19,0,25,6
1683290945904,SOCI 111,A00,258907,Ribas Norris; Janet Vanesa,26,0,30,4
1683290946928,SOCI 121R,A00,258908,Pardo Guerra; Juan Pablo,11,0,30,19
1683290947957,SOCI 126,A01,203330,Staff,14,0,20,6
1683290948987,SOCI 131,A00,258909,Thorpe; Charles Robert,31,0,60,29
1683290950012,SOCI 135,A00,258910,Payne; Christine Anna,0,9,30,30
1683290951037,SOCI 157,A00,258911,Staff,13,0,30,17
1683290952065,SOCI 184,A00,258912,Staff,26,0,30,4
1683290953092,SOCI 188D,A00,258913,Staff,21,0,30,9
1683290954120,SYN 2,001,187529,Staff,9,0,16,7
1683290954120,SYN 2,002,201452,Staff,0,18,16,16
1683290954120,SYN 2,003,201469,Staff,3,0,16,13
1683290955146,SYN 100,A01,187531,Staff,0,9,20,20
1683290955146,SYN 100,B01,201491,Staff,0,12,20,20
1683290956174,TDAC 1,A00,189286,Walsh; Kim C.,3,0,20,17
1683290956174,TDAC 1,B00,189287,Harting; Carla Kelso,11,0,20,9
1683290957204,TDAC 101,A00,189300,Walsh; Kim C.,16,0,20,4
1683290957204,TDAC 101,B00,189301,Harting; Carla Kelso,18,0,20,2
1683290958230,TDAC 102,A00,189304,Basso; Beatrice,14,0,20,6
1683290959255,TDAC 108,A00,189305,Staff,18,0,20,2
1683290960291,TDDE 131,A00,189310,Staff,19,0,20,1
1683290960291,TDDE 131,B00,189314,Staff,19,0,20,1
1683290960291,TDDE 131,C00,189315,Staff,48,0,50,2
1683290960291,TDDE 131,D00,189316,Staff,14,0,15,1
1683290960291,TDDE 131,E00,204841,Staff,20,0,20,0
1683290961321,TDGE 10,A00,189289,Staff,30,0,50,20
1683290961321,TDGE 10,B00,189290,Havis; Allan,2,0,50,48
1683290962347,TDGE 11,A00,189291,Fulton; Julia,0,3,50,50
1683290962347,TDGE 11,B00,189292,Staff,20,0,25,5
1683290962347,TDGE 11,C00,260270,Staff,0,0,0,0
1683290963373,TDGE 25,A00,189294,Staff,3,0,20,17
1683290964399,TDGE 124,A00,189318,Fulton; Julia,0,8,50,50
1683290965426,TDGE 125,A00,189319,Staff,13,0,25,12
1683290965426,TDGE 125,B00,189320,Staff,23,0,25,2
1683290966451,TDGE 127,A00,189322,Havis; Allan,0,0,50,50
1683290967475,TDHT 101,A00,189323,Staff,18,0,25,7
1683290967475,TDHT 101,B00,189324,Staff,25,0,25,0
1683290968500,TDHT 102,A00,189325,Staff,49,0,50,1
1683290969525,TDMV 1,A00,189295,Arcidiacono; Kristin,20,0,30,10
1683290969525,TDMV 1,B00,189296,Caligagan; Maria T.,24,0,30,6
1683290970550,TDMV 2,A00,189297,Sammartano; Tonnie,28,0,30,2
1683290970550,TDMV 2,B00,189299,Arcidiacono; Kristin,24,0,30,6
1683290971577,TDMV 3,A00,204998,Rincon; Alicia,22,0,30,8
1683290972602,TDMV 120,A00,189458,Sammartano; Tonnie,28,0,30,2
1683290973627,TDMV 138,A00,189541,Jun; Grace Shin Hae,22,0,40,18
1683290974651,TDMV 142,A00,189717,Caligagan; Tony,23,0,30,7
1683290974651,TDMV 142,B00,189718,Caligagan; Maria T.,25,0,30,5
1683290975677,TMC 2,A01,187533,Staff,25,0,25,0
1683290975677,TMC 2,A02,187534,Staff,25,0,25,0
1683290976702,USP 1,A01,187536,Kwak; Nancy,0,16,25,25
1683290977732,USP 5,A01,187538,Staff,9,0,25,16
1683290978763,USP 101,A00,199253,Staff,0,4,0,0
1683290979789,USP 124,A00,187562,Boomhower; Matthew Charles,1,0,30,29
1683290980816,USP 138,A00,187582,Staff,20,0,25,5
1683290981842,USP 152,A01,187597,Staff,4,0,25,21
1683290982868,USP 153,A00,187598,Staff,19,0,25,6
1683290983895,USP 168,A00,187607,Kwak; Nancy,2,0,5,3
1683290984920,USP 173,A00,187619,Staff,4,0,25,21
1683290985948,USP 181,A00,187638,Staff,0,0,25,25
1683290986973,VIS 103,A00,187650,Cruz; Edwin Teddy,23,0,75,52
1683290988002,VIS 110D,A00,187669,Staff,12,0,22,10
1683290989031,VIS 127C,A00,187720,Shen; Kuiyi,68,0,146,78
1683290990062,VIS 149,A00,187731,Yoldas; Pinar,0,14,22,22
1683290991091,VIS 151,A01,188091,Staff,22,0,34,12
1683290991091,VIS 151,A02,188092,Staff,11,0,34,23
1683290992120,VIS 160B,A00,188093,Stalbaum; Brett,0,0,10,10
1683290994175,WCWP 10B,A00,201720,Staff,10,0,15,5
1683290994175,WCWP 10B,B00,201722,Staff,8,0,15,7
1683290995205,WCWP 100,A00,201725,Gagnon; Jeffrey C,0,0,2,2
1683290995205,WCWP 100,B00,201727,Staff,0,4,15,15
1683290998349,ANBI 133,A00,258401,Wilder; Linnea Lorene,34,0,40,6
1683290999374,ANBI 140,A00,258395,Hrvoj Mihic; Branka,18,0,25,7
1683291000403,ANSC 120,A00,258402,Bialecki; Jon Anthony,27,0,40,13
1683291001431,ANSC 144,A00,258400,Staff,14,0,40,26
1683291003489,ANSC 166,A00,258396,Parish; Steven Martin,157,0,175,18
1683291004523,ANSC 180,A00,193533,Staff,9,0,20,11
1683291005548,ANSC 188,A00,258397,Jassal; Aftab,33,0,40,7
1683291006574,ANTH 3,A01,258316,Staff,23,0,30,7
1683291007599,ANTH 5,A00,258394,Semendeferi; Ekaterini,16,0,20,4
1683291008624,ANTH 21,A01,258331,Staff,9,0,40,31
1683291009650,ANTH 103,A00,258398,Varma; Saiba,15,0,25,10
1683291010678,AWP 10,001,202034,Staff,0,0,0,0
1683291010678,AWP 10,002,202035,Staff,0,0,0,0
1683291010678,AWP 10,003,202036,Staff,0,0,0,0
1683291010678,AWP 10,004,202037,Staff,0,0,0,0
1683291010678,AWP 10,005,202038,Staff,0,0,0,0
1683291010678,AWP 10,006,202039,Staff,0,0,0,0
1683291010678,AWP 10,007,202040,Staff,0,0,0,0
1683291010678,AWP 10,008,202041,Staff,0,0,0,0
1683291010678,AWP 10,009,202042,Staff,0,0,0,0
1683291010678,AWP 10,010,202043,Staff,0,0,0,0
1683291010678,AWP 10,011,202044,Staff,0,0,0,0
1683291010678,AWP 10,012,202045,Staff,0,0,0,0
1683291010678,AWP 10,013,202046,Staff,0,0,0,0
1683291010678,AWP 10,014,202047,Staff,0,0,0,0
1683291010678,AWP 10,015,202048,Staff,0,0,0,0
1683291010678,AWP 10,016,202049,Staff,0,0,0,0
1683291010678,AWP 10,017,202050,Staff,0,0,0,0
1683291010678,AWP 10,018,202051,Staff,0,0,0,0
1683291010678,AWP 10,019,202052,Staff,0,0,0,0
1683291010678,AWP 10,020,202053,Staff,0,0,0,0
1683291010678,AWP 10,021,202054,Staff,0,0,0,0
1683291010678,AWP 10,022,202055,Staff,0,0,0,0
1683291010678,AWP 10,023,202056,Staff,0,0,0,0
1683291010678,AWP 10,024,202057,Staff,0,0,0,0
1683291010678,AWP 10,025,202058,Staff,0,0,0,0
1683291010678,AWP 10,026,202059,Staff,0,0,0,0
1683291011708,AWP 102,001,202032,Staff,0,0,0,0
1683291011708,AWP 102,002,202033,Staff,0,0,0,0
1683291012740,BENG 100,A01,254234,Taylor Amos; Alyssa C,31,0,40,9
1683291013766,BENG 196,001,270013,Engler; Adam J.,9999,0,9999,0
1683291014793,BICD 100R,A01,202018,Smith; Laurie,0,7,32,32
1683291014793,BICD 100R,A02,202019,Smith; Laurie,0,2,32,32
1683291014793,BICD 100R,A03,202020,Smith; Laurie,0,1,32,32
1683291014793,BICD 100R,A04,202021,Smith; Laurie,8,0,32,24
1683291014793,BICD 100R,A05,202022,Smith; Laurie,12,0,32,20
1683291015820,BICD 136,A01,193242,Gustafson-Brown; Cindy,0,2,32,32
1683291015820,BICD 136,A02,193244,Gustafson-Brown; Cindy,15,0,32,17
1683291016853,BIEB 102,A01,193249,Butler; Shannon Rhey,0,2,32,32
1683291016853,BIEB 102,A02,193251,Butler; Shannon Rhey,0,0,32,32
1683291016853,BIEB 102,A03,193253,Butler; Shannon Rhey,0,1,32,32
1683291016853,BIEB 102,A04,193255,Butler; Shannon Rhey,17,0,32,15
1683291016853,BIEB 102,A05,193265,Butler; Shannon Rhey,26,0,32,6
1683291016853,BIEB 102,A06,193269,Butler; Shannon Rhey,16,0,32,16
1683291018913,BIEB 150,A01,193274,Staff,0,0,32,32
1683291018913,BIEB 150,A02,193285,Staff,24,0,32,8
1683291019938,BIEB 194,A00,193286,Kurle; Carolyn M.,22,0,32,10
1683291020964,BILD 1,A01,192291,Staff,16,0,32,16
1683291020964,BILD 1,A02,192292,Staff,30,0,32,2
1683291020964,BILD 1,B01,192520,Reuther; Keefe,0,1,0,0
1683291020964,BILD 1,B02,192532,Reuther; Keefe,0,1,0,0
1683291021987,BILD 3,A01,192556,Butler; Shannon Rhey,0,0,32,32
1683291021987,BILD 3,A02,192581,Butler; Shannon Rhey,5,0,32,27
1683291021987,BILD 3,A03,192611,Butler; Shannon Rhey,23,0,32,9
1683291021987,BILD 3,A04,192612,Butler; Shannon Rhey,25,0,32,7
1683291021987,BILD 3,A05,192613,Butler; Shannon Rhey,27,0,32,5
1683291021987,BILD 3,A06,192679,Butler; Shannon Rhey,27,0,32,5
1683291021987,BILD 3,A07,192682,Butler; Shannon Rhey,22,0,32,10
1683291023014,BILD 4,A01,192836,Reuther; Keefe,1,0,24,23
1683291023014,BILD 4,A02,193044,Reuther; Keefe,4,0,24,20
1683291024038,BILD 10,A01,193142,Gustafson-Brown; Cindy,31,0,32,1
1683291024038,BILD 10,A02,193149,Gustafson-Brown; Cindy,31,0,32,1
1683291025063,BIMM 100,A01,193301,Staff,0,6,32,32
1683291025063,BIMM 100,A02,193312,Staff,0,5,32,32
1683291025063,BIMM 100,A03,193323,Staff,0,8,32,32
1683291026092,BIMM 101,A01,193329,McDonnell; Lisa Marie,0,3,24,24
1683291026092,BIMM 101,A02,193339,McDonnell; Lisa Marie,0,2,24,24
1683291026092,BIMM 101,B01,193354,McDonnell; Lisa Marie,0,3,24,24
1683291026092,BIMM 101,B02,193357,McDonnell; Lisa Marie,0,3,24,24
1683291027121,BIMM 110,A01,193377,Tat; John,0,11,32,32
1683291027121,BIMM 110,A02,193378,Tat; John,1,9,32,31
1683291028155,BIMM 120,A01,206116,Staff,0,0,32,32
1683291028155,BIMM 120,A02,206117,Staff,8,0,32,24
1683291028155,BIMM 120,A03,206121,Staff,21,0,32,11
1683291029198,BIPN 100,A01,193393,Park; Ji Young,0,14,32,32
1683291029198,BIPN 100,A02,193402,Park; Ji Young,0,12,32,32
1683291029198,BIPN 100,A03,193413,Park; Ji Young,0,14,32,32
1683291029198,BIPN 100,A04,193414,Park; Ji Young,0,13,32,32
1683291030227,BIPN 102,A01,193429,Staff,0,0,32,32
1683291030227,BIPN 102,A02,193438,Staff,23,0,32,9
1683291031259,BIPN 106,A01,193450,Reyes Gonzalez; Catalina,0,2,40,40
1683291032286,BIPN 134,A01,193465,Cooke; James Edward,0,0,32,32
1683291032286,BIPN 134,A02,193474,Cooke; James Edward,27,0,32,5
1683291032286,BIPN 134,A03,193485,Cooke; James Edward,29,0,32,3
1683291032286,BIPN 134,A04,193486,Cooke; James Edward,21,0,32,11
1683291032286,BIPN 134,A05,193491,Cooke; James Edward,31,0,32,1
1683291032286,BIPN 134,A06,193501,Cooke; James Edward,30,0,32,2
1683291032286,BIPN 134,A07,193510,Cooke; James Edward,29,0,32,3
1683291034342,BISP 194,A00,222522,Staff,16,0,32,16
1683291035368,CAT 124,A01,202407,Staff,20,0,25,5
1683291036394,CAT 125,A00,202408,Marchisotto; Jennifer Anne,4,0,20,16
1683291037427,CAT 125R,A00,202409,Smith; Lauryn Alissa,0,11,20,20
1683291037427,CAT 125R,B00,202410,Morales; Celeste Georgianna,0,11,20,20
1683291037427,CAT 125R,C00,202411,Irwin; Matthew Joseph,0,10,20,20
1683291038456,CENG 15,A01,204712,Yang; Kesong,0,1,0,0
1683291039481,CENG 114,A00,202070,Jahed Motlagh; Zeinab,5,0,20,15
1683291040512,CGS 105,A00,185477,Wesling; Megan E.,24,0,40,16
1683291041536,CGS 106,A00,185494,Staff,13,0,22,9
1683291042562,CGS 108,A00,185495,Staff,14,0,20,6
1683291043589,CGS 114,A00,185496,Staff,13,0,18,5
1683291044613,CGS 119,A00,185501,Staff,15,0,20,5
1683291045638,CGS 120,A00,185511,Staff,13,0,20,7
1683291046719,CHEM 4,A01,184675,Bussey; Thomas J,96,0,100,4
1683291047746,CHEM 6A,A01,184677,Staff,35,0,60,25
1683291048771,CHEM 6B,A01,184679,Staff,65,0,100,35
1683291049801,CHEM 6C,A01,184681,Bussey; Thomas J,1,0,50,49
1683291049801,CHEM 6C,A02,184682,Bussey; Thomas J,34,0,50,16
1683291050831,CHEM 40A,A01,184684,Albizati; Kim F.,37,0,100,63
1683291051869,CHEM 40B,A01,184686,Albizati; Kim F.,0,20,100,100
1683291052900,CHEM 41B,A01,184690,Staff,52,0,100,48
1683291053931,COGS 3,A01,184715,Boyle; Mary E. T.,0,25,40,40
1683291054958,COGS 14B,A01,185172,Staff,0,15,38,38
1683291055984,COGS 18,A01,184736,Staff,20,0,80,60
1683291057010,COGS 100,A01,184932,Staff,0,5,73,73
1683291058039,COGS 101A,A01,184935,Staff,0,38,30,30
1683291059068,COGS 101B,A01,184944,Staff,0,2,30,30
1683291060094,COGS 101C,A01,184946,Staff,0,12,30,30
1683291061120,COGS 102A,A01,184951,Johnson; Christine M.,2,0,40,38
1683291062149,COGS 107B,A01,184953,Mooshagian; Eric Frederick,0,50,40,40
1683291063175,COGS 118B,A01,184959,Gupta; Anjum,0,48,40,40
1683291064201,COGS 153,A00,184961,Staff,0,15,30,30
1683291065232,COGS 177,A00,184962,Staff,0,21,30,30
1683291066262,COGS 187A,A01,184969,Boyle; Mary E. T.,0,17,40,40
1683291067293,COMM 10,A01,185174,Staff,0,5,25,25
1683291067293,COMM 10,A02,185189,Staff,0,5,25,25
1683291067293,COMM 10,A03,269821,Staff,0,0,0,0
1683291068320,COMM 100B,A01,185475,Staff,0,0,0,2
1683291068320,COMM 100B,A02,185476,Staff,14,0,25,11
1683291069346,COMM 100C,A01,185314,Staff,1,0,25,24
1683291069346,COMM 100C,A02,185327,Staff,19,0,25,6
1683291070370,COMM 110M,A00,185349,Staff,2,0,40,38
1683291071401,COMM 113T,A00,185352,Staff,25,0,40,15
1683291072427,COMM 114I,A00,185353,Staff,33,0,40,7
1683291073450,COMM 131,A00,185354,Staff,19,0,30,11
1683291074475,CSE 8A,A50,185358,Cao; Yingjun,0,46,10,10
1683291075499,CSE 8B,A01,185362,Staff,0,47,50,50
1683291076529,CSE 11,A01,185416,Cao; Yingjun,0,93,10,10
1683291077558,CSE 20,A01,185445,Briones; Jor-el Thomas Caparas,5,0,25,20
1683291078582,CSE 21,A01,185447,Staff,10,0,50,40
1683291079608,CSE 101,A01,185451,Staff,0,12,50,50
1683291079608,CSE 101,B01,185453,Jones; Miles E,0,11,50,50
1683291081660,CSE 141,A01,185458,Eldon; John,20,0,100,80
1683291082685,CSE 141L,A01,185461,Eldon; John,12,0,100,88
1683291083712,CSE 142,A01,185463,Staff,35,0,60,25
1683291083712,CSE 142,B01,201355,Staff,0,6,60,60
1683291084737,CSE 142L,A01,185470,Staff,35,0,60,25
1683291084737,CSE 142L,B01,201417,Staff,0,5,60,60
1683291085763,CSE 190,A00,201433,Staff,32,0,49,17
1683291086789,DOC 1,A01,259136,Strom; Megan C.,8,0,15,7
1683291086789,DOC 1,A02,259137,Strom; Megan C.,14,0,15,1
1683291086789,DOC 1,A03,259138,Strom; Megan C.,14,0,15,1
1683291086789,DOC 1,A04,259139,Strom; Megan C.,14,0,15,1
1683291087815,DOC 100D,A00,259140,Pass; Natalye Joann,17,0,25,8
1683291088845,DSGN 1,A01,184749,Rill; Bryan,0,24,30,30
1683291089874,DSGN 100,A01,185168,Staff,0,2,25,25
1683291090903,ECE 5,A01,185626,Morris; Karcher William,0,10,0,0
1683291091930,ECE 101,A01,185628,Staff,17,0,70,53
1683291092961,ECE 107,A01,185635,Baghdadchi; Saharnaz,0,0,20,20
1683291092961,ECE 107,A02,185638,Baghdadchi; Saharnaz,4,0,20,16
1683291093987,ECE 148,A01,185647,Silberman; Jack,1,0,16,15
1683291095013,ECON 1,A01,185537,Crane; Meredith Helen,54,0,70,16
1683291096040,ECON 3,A01,185549,Crane; Meredith Helen,33,0,70,37
1683291097067,ECON 4,A01,203354,Anderson; John Charles,0,4,10,10
1683291098094,ECON 100A,A01,185574,Staff,0,4,40,40
1683291099121,ECON 100B,A01,185576,Staff,0,22,40,40
1683291100148,ECON 100C,A01,185589,Newhouse; Herbert S,30,0,70,40
1683291101173,ECON 105,A00,185608,Vespa; Emanuel Ignacio,19,0,35,16
1683291102201,ECON 109,A01,185610,Shishkin; Denis,10,0,35,25
1683291103227,ECON 110A,A01,185612,Staff,11,0,40,29
1683291104252,ECON 120A,A01,185615,Staff,20,0,40,20
1683291105282,ECON 120C,A01,185617,Sun; Yixiao,0,20,70,70
1683291106309,ECON 144,A00,203346,Squires; Dale E,3,0,35,32
1683291107335,ECON 171,A01,203349,Newhouse; Herbert S,0,1,35,35
1683291108362,ECON 173A,A01,185621,Toda; Alexis Akira,21,0,35,14
1683291109395,EDS 25,A01,202413,Staff,0,1,0,0
1683291109395,EDS 25,A02,202414,Staff,0,1,0,0
1683291109395,EDS 25,A03,202415,Staff,0,0,0,0
1683291109395,EDS 25,A04,202416,Staff,0,1,0,0
1683291109395,EDS 25,A05,202439,Staff,0,0,0,0
1683291109395,EDS 25,A06,202440,Staff,0,0,0,0
1683291109395,EDS 25,B01,202631,Staff,0,0,0,0
1683291109395,EDS 25,B02,202632,Staff,0,0,0,0
1683291109395,EDS 25,B03,202639,Staff,0,0,0,0
1683291109395,EDS 25,B04,202640,Staff,0,0,0,0
1683291109395,EDS 25,B05,202643,Staff,0,0,0,0
1683291109395,EDS 25,B06,202644,Staff,0,0,0,0
1683291110427,EDS 38,A01,202659,Black; Alison Michelle,24,0,25,1
1683291111457,EDS 115,A00,202652,Staff,17,0,30,13
1683291112485,EDS 125,A00,202649,Staff,14,0,30,16
1683291113509,EDS 126,A01,203332,Staff,30,0,30,0
1683291114533,EDS 139,A00,202838,Staff,17,0,25,8
1683291115559,EDS 146,A01,202655,Staff,15,0,25,10
1683291116585,ENG 15,A00,185667,Staff,0,1,0,0
1683291116585,ENG 15,B00,185672,Staff,0,0,0,0
1683291116585,ENG 15,C00,185675,Staff,0,0,0,0
1683291116585,ENG 15,D00,185682,Staff,0,0,0,0
1683291116585,ENG 15,E00,185684,Staff,0,0,0,0
1683291117611,ETHN 103,A00,185710,Staff,0,3,35,35
1683291118651,ETHN 103A,A00,199228,Man; Simeon S,3,0,9,6
1683291119677,ETHN 109,A00,185711,Staff,18,0,35,17
1683291120703,ETHN 142,A00,185726,Staff,0,4,30,30
1683291121729,ETHN 163J,A00,199229,Man; Simeon S,6,0,8,2
1683291122755,ETHN 168,A00,185727,Staff,8,0,10,2
1683291123783,ETHN 182,A00,185728,Staff,1,0,35,34
1683291124810,ETHN 183,A00,185737,Staff,8,0,18,10
1683291125841,GLBH 111,A01,209361,Burgos; Jose L.,0,0,0,0
1683291127897,HIEU 104,A00,185792,Staff,16,0,20,4
1683291128923,HIEU 115,A00,185800,Staff,1,0,20,19
1683291129949,HIEU 128,A00,185801,Staff,0,7,20,20
1683291130974,HIEU 147,A00,185802,Staff,16,0,20,4
1683291132003,HIEU 154,A00,185823,Staff,12,0,20,8
1683291133033,HILA 102,A00,185826,Staff,13,0,20,7
1683291134061,HILD 2C,A01,185778,Staff,0,12,20,20
1683291135089,HILD 7B,A01,185780,Kwak; Nancy,0,15,32,32
1683291135089,HILD 7B,A02,185781,Kwak; Nancy,0,18,32,32
1683291136111,HILD 30,A01,185791,Staff,14,0,20,6
1683291137137,HISC 119,A00,185830,Golan; Tal,0,9,20,20
1683291138163,HITO 156GS,A00,185831,Patterson; Patrick H.,0,0,0,23
1683291139188,HIUS 103,A00,185832,Man; Simeon S,0,7,20,20
1683291140216,HIUS 117,A00,185836,Kwak; Nancy,2,0,20,18
1683291141244,HIUS 125,A00,185840,Man; Simeon S,0,0,23,23
1683291142272,HIUS 149,A00,185845,Staff,0,0,20,20
1683291143297,HUM 3,A01,185882,Zavodny; Tatiana Sophia,0,6,50,50
1683291143297,HUM 3,B01,185899,Caldwell; Michael Alan,0,19,50,50
1683291144324,HUM 3GS,A00,185900,Patterson; Patrick H.,0,0,0,23
1683291145356,HUM 4,A01,185938,Zroka; Amy Liane,31,0,50,19
1683291145356,HUM 4,B01,185956,Watkins; Eric,0,2,50,50
1683291145356,HUM 4,B02,202209,Watkins; Eric,0,1,50,50
1683291145356,HUM 4,B03,202210,Watkins; Eric,0,0,50,50
1683291146383,HUM 5,A01,185958,West; Geoffrey Scott,5,0,50,45
1683291146383,HUM 5,A02,202215,West; Geoffrey Scott,0,0,50,50
1683291147408,INTL 190,A00,185959,Gagnon; Jeffrey C,0,0,0,9
1683291147408,INTL 190,B00,185960,Lettieri; Michael Joseph,0,0,0,1
1683291148432,JAPN 180,A00,254509,Staff,0,1,25,25
1683291149458,LATI 10,A01,202853,Kennemore; Amy Michelle,5,0,35,30
1683291149458,LATI 10,A02,202854,Kennemore; Amy Michelle,1,0,35,34
1683291149458,LATI 10,A03,270054,Kennemore; Amy Michelle,30,0,30,0
1683291150541,LATI 180,A00,202855,Kennemore; Amy Michelle,11,0,20,9
1683291151571,LAWS 101,A00,201767,Golan; Tal,0,7,40,40
1683291152599,LIFR 1C,A00,185961,Staff,6,0,20,14
1683291153628,LIFR 1CX,A00,185962,Staff,7,0,20,13
1683291154655,LIFR 1D,A00,185963,Staff,9,0,20,11
1683291155681,LIFR 1DX,A00,185964,Staff,9,0,20,11
1683291156707,LIGN 101,A01,186039,Staff,43,0,50,7
1683291157732,LIGN 165,A00,186040,Staff,18,0,50,32
1683291158757,LTCS 108,A00,186041,Staff,6,0,10,4
1683291159782,LTCS 119,A00,186042,Staff,16,0,20,4
1683291160811,LTCS 130,A00,186043,Wesling; Megan E.,15,0,25,10
1683291162866,LTEA 138,A00,186119,Staff,14,0,40,26
1683291163895,LTEN 124,A00,186148,Staff,6,0,25,19
1683291164923,LTEN 178,A00,186149,Staff,7,0,15,8
1683291165952,LTEN 181,A00,186150,Blanco; John D,33,0,40,7
1683291166981,LTWL 120,A00,186160,Staff,20,0,25,5
1683291168010,LTWL 165,A00,186161,Staff,22,0,25,3
1683291169038,LTWR 100,A00,186162,Staff,0,4,15,15
1683291170065,LTWR 102,A00,186163,Doller; Ben,5,0,15,10
1683291171094,MAE 8,A01,186412,Staff,0,0,0,0
1683291172125,MAE 30B,A00,186445,Bahadori; Mohammad Yousef,83,0,100,17
1683291173150,MAE 40,A00,186592,Bewley; Thomas R,9,0,50,41
1683291174176,MAE 101B,A00,186593,Bahadori; Mohammad Yousef,81,0,100,19
1683291175201,MAE 105,A00,186594,Bandaru; Prabhakar,12,0,50,38
1683291176226,MAE 107,A00,186599,Pham; Hieu Tan,0,6,120,120
1683291177250,MAE 148,A01,186660,Silberman; Jack,3,0,16,13
1683291178274,MATH 10A,A01,188095,Staff,0,7,35,35
1683291179301,MATH 10B,A01,188097,Bowers; Adam R.,0,11,30,30
1683291179301,MATH 10B,A02,188099,Bowers; Adam R.,0,9,30,30
1683291179301,MATH 10B,B01,188104,Bowers; Adam R.,0,11,30,30
1683291179301,MATH 10B,B02,188106,Bowers; Adam R.,0,11,30,30
1683291180327,MATH 10C,A01,188111,Staff,0,18,30,30
1683291180327,MATH 10C,A02,188127,Staff,0,17,30,30
1683291180327,MATH 10C,A03,188131,Staff,0,17,30,30
1683291180327,MATH 10C,B01,188218,Staff,21,0,30,9
1683291180327,MATH 10C,B02,188244,Staff,13,0,30,17
1683291180327,MATH 10C,B03,188277,Staff,16,0,30,14
1683291181360,MATH 18,A01,188344,Bach; Quang Tran,18,0,30,12
1683291181360,MATH 18,A02,188345,Bach; Quang Tran,11,0,30,19
1683291181360,MATH 18,B01,188353,Bach; Quang Tran,10,0,30,20
1683291181360,MATH 18,B02,188354,Bach; Quang Tran,20,0,30,10
1683291182391,MATH 20A,A01,188374,Staff,13,0,35,22
1683291183420,MATH 20B,A01,188382,Ohm; Ko Woon,6,0,30,24
1683291183420,MATH 20B,A02,188383,Ohm; Ko Woon,24,0,30,6
1683291183420,MATH 20B,B01,188385,Ohm; Ko Woon,7,0,30,23
1683291183420,MATH 20B,B02,188392,Ohm; Ko Woon,22,0,30,8
1683291184453,MATH 20C,A01,188394,Harel; Guershon,10,0,30,20
1683291184453,MATH 20C,A02,188395,Harel; Guershon,13,0,30,17
1683291184453,MATH 20C,B01,188404,Harel; Guershon,3,0,30,27
1683291184453,MATH 20C,B02,188405,Harel; Guershon,19,0,30,11
1683291185479,MATH 20D,A01,188414,Hammock; Frances H,0,1,30,30
1683291185479,MATH 20D,A02,188415,Hammock; Frances H,4,0,30,26
1683291185479,MATH 20D,B01,188447,Hammock; Frances H,2,0,30,28
1683291185479,MATH 20D,B02,188486,Hammock; Frances H,8,0,30,22
1683291186512,MATH 20E,A01,188649,Staff,22,0,30,8
1683291186512,MATH 20E,A02,188650,Staff,23,0,30,7
1683291186512,MATH 20E,A03,188673,Staff,0,0,30,30
1683291187541,MATH 102,A01,188675,Staff,0,35,35,35
1683291188566,MATH 103B,A01,188681,Staff,4,0,35,31
1683291188566,MATH 103B,B01,188692,Staff,8,0,35,27
1683291189597,MATH 109,A01,188695,Salehi Golsefidy; Alireza,25,0,35,10
1683291189597,MATH 109,A02,188696,Salehi Golsefidy; Alireza,27,0,35,8
1683291190623,MATH 120A,A01,188698,Eggers; John Dietrich,5,0,35,30
1683291191650,MATH 142B,A01,188736,Ioana; Adrian,0,2,30,30
1683291191650,MATH 142B,A02,188741,Ioana; Adrian,0,1,30,30
1683291191650,MATH 142B,A03,188743,Ioana; Adrian,0,3,30,30
1683291192675,MATH 168A,A01,188790,Staff,0,8,35,35
1683291193701,MATH 170A,A01,188803,Nie; Jiawang,0,2,35,35
1683291193701,MATH 170A,A02,188811,Nie; Jiawang,0,0,35,35
1683291193701,MATH 170A,A03,188814,Nie; Jiawang,1,0,35,34
1683291193701,MATH 170A,A04,188815,Nie; Jiawang,14,0,35,21
1683291194726,MATH 193B,A01,188817,Staff,0,0,35,35
1683291194726,MATH 193B,A02,188818,Staff,5,0,35,30
1683291195750,MGT 4,A01,202857,Anderson; John Charles,62,0,80,18
1683291196777,MGT 12,A00,202858,Lindenberger; Wade Douglas,43,0,90,47
1683291197802,MGT 18,A00,202859,Staff,74,0,90,16
1683291198832,MGT 18GS,A00,202860,McKay; Michael J,13,0,28,15
1683291199857,MGT 45,A00,202861,Pecore; Joseph P.,14,0,90,76
1683291200883,MGT 100,A00,202863,Yavorsky; Daniel Ryan,28,0,90,62
1683291201913,MGT 103,A00,202864,Ehrich; Kristine R,0,16,90,90
1683291202942,MGT 112,A00,202865,Ehrich; Kristine R,15,0,90,75
1683291203967,MGT 121A,A00,202868,Staff,0,19,0,0
1683291204991,MGT 131B,A00,202869,Anderson; John Charles,59,0,90,31
1683291206018,MGT 136,A00,202871,Lindenberger; Wade Douglas,84,0,90,6
1683291207043,MGT 164,A00,202873,Staff,0,69,90,90
1683291208067,MGT 164GS,A00,202874,McKay; Mary A,13,0,28,15
1683291209092,MGT 180,A00,202875,Staff,0,51,90,90
1683291210121,MMW 11R,A01,205019,Herbst; Matthew,3,0,30,27
1683291210121,MMW 11R,A02,205026,Herbst; Matthew,29,0,30,1
1683291211153,MMW 15,A01,193512,Chang; Edmond Yi-Teh,0,9,28,28
1683291211153,MMW 15,A02,193513,Chang; Edmond Yi-Teh,0,5,28,28
1683291211153,MMW 15,A03,193514,Chang; Edmond Yi-Teh,0,5,28,28
1683291211153,MMW 15,A04,193515,Chang; Edmond Yi-Teh,0,4,28,28
1683291211153,MMW 15,A05,193516,Chang; Edmond Yi-Teh,0,4,28,28
1683291211153,MMW 15,A06,193517,Chang; Edmond Yi-Teh,0,5,28,28
1683291211153,MMW 15,B01,193519,Chang; Edmond Yi-Teh,0,4,28,28
1683291211153,MMW 15,B02,193520,Chang; Edmond Yi-Teh,0,5,28,28
1683291211153,MMW 15,B03,193521,Chang; Edmond Yi-Teh,0,4,28,28
1683291211153,MMW 15,B04,193522,Chang; Edmond Yi-Teh,0,4,28,28
1683291211153,MMW 15,B05,193523,Chang; Edmond Yi-Teh,0,5,28,28
1683291211153,MMW 15,B06,193524,Chang; Edmond Yi-Teh,0,4,28,28
1683291212182,MMW 122,A01,193526,Rahimi; Babak,0,14,28,28
1683291212182,MMW 122,A02,193527,Rahimi; Babak,0,14,28,28
1683291212182,MMW 122,A03,193528,Rahimi; Babak,0,0,0,0
1683291212182,MMW 122,A04,193529,Rahimi; Babak,0,0,0,0
1683291213208,MUS 1A,A01,186663,Staff,0,20,35,35
1683291214235,MUS 4,A01,186715,Staff,0,12,35,35
1683291215264,MUS 5R,A01,186796,Dubnov; Shlomo,0,16,35,35
1683291216290,MUS 6,A01,186798,Staff,0,3,25,25
1683291217315,MUS 7,A01,186830,Staff,12,0,35,23
1683291218341,MUS 8,A01,186930,Staff,0,25,35,35
1683291219373,MUS 15,A01,186932,Staff,0,15,35,35
1683291219373,MUS 15,B01,186934,Staff,0,14,35,35
1683291220400,MUS 80,A00,186935,Staff,2,0,20,18
1683291220400,MUS 80,B00,186936,Staff,25,0,25,0
1683291221430,NANO 11,A00,204702,Lipomi; Darren John,0,0,0,0
1683291222456,NANO 15,A01,204709,Yang; Kesong,0,1,0,0
1683291223485,NANO 114,A00,202069,Jahed Motlagh; Zeinab,3,0,10,7
1683291224510,PHIL 1,A00,186955,Grush; Rick Scott,32,0,40,8
1683291225540,PHIL 10,A01,186973,Grush; Rick Scott,29,0,35,6
1683291225540,PHIL 10,A02,186974,Grush; Rick Scott,33,0,35,2
1683291226563,PHIL 13,A01,186976,Staff,7,0,35,28
1683291226563,PHIL 13,A02,186977,Staff,16,0,35,19
1683291227592,PHIL 14,A01,186979,Staff,31,0,35,4
1683291227592,PHIL 14,A02,186986,Staff,32,0,35,3
1683291228620,PHIL 28,A01,186988,Staff,16,0,30,14
1683291228620,PHIL 28,A02,186989,Staff,1,0,30,29
1683291228620,PHIL 28,A03,186990,Staff,9,0,30,21
1683291228620,PHIL 28,A04,186991,Staff,26,0,30,4
1683291229647,PHIL 120,A00,186997,Staff,23,0,40,17
1683291230671,PHIL 137,A00,187003,Staff,9,0,40,31
1683291231695,PHIL 150,A00,187015,Staff,47,0,70,23
1683291232721,PHIL 167,A00,187021,Lamey; Andy M.,35,0,40,5
1683291233745,PHIL 174,A01,202226,Staff,17,0,20,3
1683291233745,PHIL 174,A02,202235,Staff,20,0,20,0
1683291234770,PHIL 191A,A00,258918,Staff,0,0,1,1
1683291235798,PHYS 1A,A00,187028,Staff,26,0,60,34
1683291236826,PHYS 1AL,001,187036,Staff,2,0,30,28
1683291236826,PHYS 1AL,002,187049,Staff,18,0,30,12
1683291237851,PHYS 1B,A00,187058,Staff,23,0,60,37
1683291238880,PHYS 1BL,001,187064,Staff,0,0,30,30
1683291238880,PHYS 1BL,002,187070,Staff,6,0,30,24
1683291239905,PHYS 1C,A00,187082,Staff,32,0,120,88
1683291240931,PHYS 1CL,001,187088,Staff,0,9,30,30
1683291240931,PHYS 1CL,002,187089,Staff,0,2,30,30
1683291240931,PHYS 1CL,009,262693,Staff,12,0,30,18
1683291241955,PHYS 2B,A01,187097,Staff,54,0,115,61
1683291242986,PHYS 2C,A01,187099,Staff,67,0,115,48
1683291244014,PHYS 2CL,A01,187101,Staff,5,0,28,23
1683291244014,PHYS 2CL,A02,187102,Staff,15,0,28,13
1683291245043,PHYS 2D,A01,187123,Shotwell; Brian,95,0,115,20
1683291246069,PHYS 4B,A01,187133,Grinstein; Benjamin,35,0,50,15
1683291247093,POLI 10,A00,188819,Staff,0,3,50,50
1683291248117,POLI 11,A00,188827,Staff,43,0,50,7
1683291249142,POLI 13R,A00,188828,Staff,0,1,20,20
1683291250166,POLI 27,A01,188830,Elgin; Samuel Zincke,0,1,70,70
1683291251195,POLI 30,A00,188832,Desposato; Scott,33,0,50,17
1683291252224,POLI 102F,A00,188834,Staff,3,0,40,37
1683291253248,POLI 104A,A00,188852,Staff,14,0,30,16
1683291254345,POLI 104I,A00,188853,Staff,0,6,20,20
1683291255369,POLI 110B,A00,188854,Wiens; David,7,0,20,13
1683291256395,POLI 112A,A00,188855,Wiens; David,5,0,30,25
1683291257423,POLI 117R,A00,188856,Forman; Fonna,0,11,20,20
1683291258453,POLI 118,A00,188857,Ingham; Sean,8,0,20,12
1683291259482,POLI 120G,A00,188858,Staff,9,0,30,21
1683291260506,POLI 131CR,A00,188863,Hoston; Germaine,24,0,50,26
1683291261530,POLI 133,A00,188864,Nellis; Gareth Hb,44,0,50,6
1683291262554,POLI 134D,A00,188865,Desposato; Scott,27,0,30,3
1683291263579,POLI 142A,A00,188871,Gartzke; Erik,22,0,50,28
1683291264605,POLI 142K,A00,188874,Staff,38,0,50,12
1683291265632,POLI 143,A00,188940,Gartzke; Erik,16,0,30,14
1683291266657,POLI 153,A00,188943,Staff,3,0,20,17
1683291267680,POLI 160AA,A00,188944,Staff,13,0,40,27
1683291268704,POLI 170A,A00,188945,Staff,11,0,30,19
1683291270753,PSYC 1,A00,188952,Staff,38,0,90,52
1683291271781,PSYC 2,B00,188953,Staff,20,0,35,15
1683291272808,PSYC 6,A00,188970,Staff,47,0,60,13
1683291273835,PSYC 7,A00,188973,Staff,37,0,45,8
1683291274863,PSYC 60,A01,188980,Rickard; Timothy C.,43,0,60,17
1683291275889,PSYC 70,A01,189001,Steiner; Eric Tomas,24,0,45,21
1683291276913,PSYC 100,A00,189005,Lacefield; Katharine I,0,99,120,120
1683291277937,PSYC 102,A00,189008,Staff,10,0,30,20
1683291278963,PSYC 106,B00,189026,Gorman; Michael R.,37,0,60,23
1683291279993,PSYC 114,B01,189033,Winkielman; Piotr,0,32,30,30
1683291281021,PSYC 131,A00,189036,Anagnostaras; Stephan,0,43,60,60
1683291282050,PSYC 136,A00,189041,Lowe; Angela Beth,0,7,25,25
1683291283077,PSYC 137,A00,189057,Winkielman; Piotr,0,34,25,25
1683291284105,PSYC 144,A00,189107,Wixted; John T,0,7,50,50
1683291286157,PSYC 162,A00,189142,Staff,0,8,85,85
1683291287181,PSYC 172,A00,189144,Gorman; Michael R.,0,7,30,30
1683291289229,PSYC 179,A00,189146,Lacefield; Katharine I,0,84,120,120
1683291290254,PSYC 181,A00,189147,Anagnostaras; Stephan,0,44,90,90
1683291291279,PSYC 190R,A00,189148,Barner; David A.,0,22,80,80
1683291292308,PSYC 191,A00,189275,Rickard; Timothy C.,0,7,25,25
1683291293336,PSYC 193,A00,189276,Chapman; Eddie Nathaniel,0,1,0,4
1683291294365,PSYC 193L,A01,189281,Lowe; Angela Beth,12,0,20,8
1683291294365,PSYC 193L,B01,189285,Staff,28,0,35,7
1683291295389,RELI 149,A00,187137,Rahimi; Babak,7,0,40,33
1683291296414,SE 9,A01,187315,Staff,0,2,18,18
1683291297438,SE 101B,A00,187409,Staff,24,0,30,6
1683291298466,SE 110B,A00,187444,Staff,10,0,40,30
1683291299489,SE 130B,A00,187449,Staff,31,0,40,9
1683291300513,SE 150A,A00,187516,Staff,9,0,20,11
1683291301537,SE 154,A00,187528,Staff,30,0,50,20
1683291302561,SIO 3,A01,258171,Staff,35,0,40,5
1683291303584,SIO 10,A00,187144,Cook; Geoffrey W,0,3,75,75
1683291304607,SIO 45,A00,187152,Cook; Geoffrey W,1,0,100,99
1683291305631,SIO 109R,A00,194486,Staff,0,3,20,20
1683291307684,SIO 187,A01,187233,Kacev; David,12,0,40,28
1683291308710,SOCI 1,A01,258656,Thorpe; Charles Robert,28,0,30,2
1683291308710,SOCI 1,A02,258658,Thorpe; Charles Robert,30,0,30,0
1683291308710,SOCI 1,A03,258661,Thorpe; Charles Robert,25,0,25,0
1683291308710,SOCI 1,A04,258666,Thorpe; Charles Robert,22,0,25,3
1683291308710,SOCI 1,A05,258897,Thorpe; Charles Robert,23,0,25,2
1683291308710,SOCI 1,A06,258898,Thorpe; Charles Robert,25,0,25,0
1683291309735,SOCI 30,A01,258903,Pardo Guerra; Juan Pablo,16,0,30,14
1683291310762,SOCI 102,A00,258904,Staff,9,0,25,16
1683291311787,SOCI 106,A00,258905,Staff,19,0,25,6
1683291312817,SOCI 111,A00,258907,Ribas Norris; Janet Vanesa,26,0,30,4
1683291313842,SOCI 121R,A00,258908,Pardo Guerra; Juan Pablo,11,0,30,19
1683291314871,SOCI 126,A01,203330,Staff,14,0,20,6
1683291315901,SOCI 131,A00,258909,Thorpe; Charles Robert,31,0,60,29
1683291316929,SOCI 135,A00,258910,Payne; Christine Anna,0,9,30,30
1683291317952,SOCI 157,A00,258911,Staff,13,0,30,17
1683291318976,SOCI 184,A00,258912,Staff,26,0,30,4
1683291319999,SOCI 188D,A00,258913,Staff,21,0,30,9
1683291321024,SYN 2,001,187529,Staff,9,0,16,7
1683291321024,SYN 2,002,201452,Staff,0,18,16,16
1683291321024,SYN 2,003,201469,Staff,3,0,16,13
1683291322051,SYN 100,A01,187531,Staff,0,9,20,20
1683291322051,SYN 100,B01,201491,Staff,0,12,20,20
1683291323081,TDAC 1,A00,189286,Walsh; Kim C.,3,0,20,17
1683291323081,TDAC 1,B00,189287,Harting; Carla Kelso,11,0,20,9
1683291324106,TDAC 101,A00,189300,Walsh; Kim C.,16,0,20,4
1683291324106,TDAC 101,B00,189301,Harting; Carla Kelso,18,0,20,2
1683291325136,TDAC 102,A00,189304,Basso; Beatrice,14,0,20,6
1683291326164,TDAC 108,A00,189305,Staff,18,0,20,2
1683291327193,TDDE 131,A00,189310,Staff,19,0,20,1
1683291327193,TDDE 131,B00,189314,Staff,19,0,20,1
1683291327193,TDDE 131,C00,189315,Staff,48,0,50,2
1683291327193,TDDE 131,D00,189316,Staff,14,0,15,1
1683291327193,TDDE 131,E00,204841,Staff,20,0,20,0
1683291328217,TDGE 10,A00,189289,Staff,30,0,50,20
1683291328217,TDGE 10,B00,189290,Havis; Allan,2,0,50,48
1683291329250,TDGE 11,A00,189291,Fulton; Julia,0,3,50,50
1683291329250,TDGE 11,B00,189292,Staff,20,0,25,5
1683291329250,TDGE 11,C00,260270,Staff,0,0,0,0
1683291330278,TDGE 25,A00,189294,Staff,3,0,20,17
1683291331307,TDGE 124,A00,189318,Fulton; Julia,0,8,50,50
1683291332330,TDGE 125,A00,189319,Staff,13,0,25,12
1683291332330,TDGE 125,B00,189320,Staff,23,0,25,2
1683291333354,TDGE 127,A00,189322,Havis; Allan,0,0,50,50
1683291334380,TDHT 101,A00,189323,Staff,18,0,25,7
1683291334380,TDHT 101,B00,189324,Staff,25,0,25,0
1683291335404,TDHT 102,A00,189325,Staff,49,0,50,1
1683291336431,TDMV 1,A00,189295,Arcidiacono; Kristin,20,0,30,10
1683291336431,TDMV 1,B00,189296,Caligagan; Maria T.,24,0,30,6
1683291337461,TDMV 2,A00,189297,Sammartano; Tonnie,28,0,30,2
1683291337461,TDMV 2,B00,189299,Arcidiacono; Kristin,24,0,30,6
1683291338490,TDMV 3,A00,204998,Rincon; Alicia,22,0,30,8
1683291339515,TDMV 120,A00,189458,Sammartano; Tonnie,28,0,30,2
1683291340540,TDMV 138,A00,189541,Jun; Grace Shin Hae,22,0,40,18
1683291341569,TDMV 142,A00,189717,Caligagan; Tony,23,0,30,7
1683291341569,TDMV 142,B00,189718,Caligagan; Maria T.,25,0,30,5
1683291342599,TMC 2,A01,187533,Staff,25,0,25,0
1683291342599,TMC 2,A02,187534,Staff,25,0,25,0
1683291343624,USP 1,A01,187536,Kwak; Nancy,0,16,25,25
1683291344651,USP 5,A01,187538,Staff,9,0,25,16
1683291345676,USP 101,A00,199253,Staff,0,4,0,0
1683291346700,USP 124,A00,187562,Boomhower; Matthew Charles,1,0,30,29
1683291347729,USP 138,A00,187582,Staff,20,0,25,5
1683291348753,USP 152,A01,187597,Staff,4,0,25,21
1683291349777,USP 153,A00,187598,Staff,19,0,25,6
1683291350801,USP 168,A00,187607,Kwak; Nancy,2,0,5,3
1683291351826,USP 173,A00,187619,Staff,4,0,25,21
1683291352850,USP 181,A00,187638,Staff,0,0,25,25
1683291353880,VIS 103,A00,187650,Cruz; Edwin Teddy,23,0,75,52
1683291354905,VIS 110D,A00,187669,Staff,12,0,22,10
1683291355929,VIS 127C,A00,187720,Shen; Kuiyi,68,0,146,78
1683291356956,VIS 149,A00,187731,Yoldas; Pinar,0,14,22,22
1683291358045,VIS 151,A01,188091,Staff,22,0,34,12
1683291358045,VIS 151,A02,188092,Staff,11,0,34,23
1683291359073,VIS 160B,A00,188093,Stalbaum; Brett,0,0,10,10
1683291361123,WCWP 10B,A00,201720,Staff,10,0,15,5
1683291361123,WCWP 10B,B00,201722,Staff,8,0,15,7
1683291362154,WCWP 100,A00,201725,Gagnon; Jeffrey C,0,0,2,2
1683291362154,WCWP 100,B00,201727,Staff,0,4,15,15
1683291365283,ANBI 133,A00,258401,Wilder; Linnea Lorene,34,0,40,6
1683291366313,ANBI 140,A00,258395,Hrvoj Mihic; Branka,18,0,25,7
1683291367342,ANSC 120,A00,258402,Bialecki; Jon Anthony,27,0,40,13
1683291368369,ANSC 144,A00,258400,Staff,14,0,40,26
1683291370425,ANSC 166,A00,258396,Parish; Steven Martin,157,0,175,18
1683291371453,ANSC 180,A00,193533,Staff,9,0,20,11
1683291372482,ANSC 188,A00,258397,Jassal; Aftab,33,0,40,7
1683291373508,ANTH 3,A01,258316,Staff,23,0,30,7
1683291374533,ANTH 5,A00,258394,Semendeferi; Ekaterini,16,0,20,4
1683291375559,ANTH 21,A01,258331,Staff,9,0,40,31
1683291376585,ANTH 103,A00,258398,Varma; Saiba,15,0,25,10
1683291377614,AWP 10,001,202034,Staff,0,0,0,0
1683291377614,AWP 10,002,202035,Staff,0,0,0,0
1683291377614,AWP 10,003,202036,Staff,0,0,0,0
1683291377614,AWP 10,004,202037,Staff,0,0,0,0
1683291377614,AWP 10,005,202038,Staff,0,0,0,0
1683291377614,AWP 10,006,202039,Staff,0,0,0,0
1683291377614,AWP 10,007,202040,Staff,0,0,0,0
1683291377614,AWP 10,008,202041,Staff,0,0,0,0
1683291377614,AWP 10,009,202042,Staff,0,0,0,0
1683291377614,AWP 10,010,202043,Staff,0,0,0,0
1683291377614,AWP 10,011,202044,Staff,0,0,0,0
1683291377614,AWP 10,012,202045,Staff,0,0,0,0
1683291377614,AWP 10,013,202046,Staff,0,0,0,0
1683291377614,AWP 10,014,202047,Staff,0,0,0,0
1683291377614,AWP 10,015,202048,Staff,0,0,0,0
1683291377614,AWP 10,016,202049,Staff,0,0,0,0
1683291377614,AWP 10,017,202050,Staff,0,0,0,0
1683291377614,AWP 10,018,202051,Staff,0,0,0,0
1683291377614,AWP 10,019,202052,Staff,0,0,0,0
1683291377614,AWP 10,020,202053,Staff,0,0,0,0
1683291377614,AWP 10,021,202054,Staff,0,0,0,0
1683291377614,AWP 10,022,202055,Staff,0,0,0,0
1683291377614,AWP 10,023,202056,Staff,0,0,0,0
1683291377614,AWP 10,024,202057,Staff,0,0,0,0
1683291377614,AWP 10,025,202058,Staff,0,0,0,0
1683291377614,AWP 10,026,202059,Staff,0,0,0,0
1683291378642,AWP 102,001,202032,Staff,0,0,0,0
1683291378642,AWP 102,002,202033,Staff,0,0,0,0
1683291379672,BENG 100,A01,254234,Taylor Amos; Alyssa C,31,0,40,9
1683291380701,BENG 196,001,270013,Engler; Adam J.,9999,0,9999,0
1683291381729,BICD 100R,A01,202018,Smith; Laurie,0,7,32,32
1683291381729,BICD 100R,A02,202019,Smith; Laurie,0,2,32,32
1683291381729,BICD 100R,A03,202020,Smith; Laurie,0,1,32,32
1683291381729,BICD 100R,A04,202021,Smith; Laurie,8,0,32,24
1683291381729,BICD 100R,A05,202022,Smith; Laurie,12,0,32,20
1683291382755,BICD 136,A01,193242,Gustafson-Brown; Cindy,0,2,32,32
1683291382755,BICD 136,A02,193244,Gustafson-Brown; Cindy,15,0,32,17
1683291383790,BIEB 102,A01,193249,Butler; Shannon Rhey,0,2,32,32
1683291383790,BIEB 102,A02,193251,Butler; Shannon Rhey,0,0,32,32
1683291383790,BIEB 102,A03,193253,Butler; Shannon Rhey,0,1,32,32
1683291383790,BIEB 102,A04,193255,Butler; Shannon Rhey,17,0,32,15
1683291383790,BIEB 102,A05,193265,Butler; Shannon Rhey,26,0,32,6
1683291383790,BIEB 102,A06,193269,Butler; Shannon Rhey,16,0,32,16
1683291385841,BIEB 150,A01,193274,Staff,0,0,32,32
1683291385841,BIEB 150,A02,193285,Staff,24,0,32,8
1683291386867,BIEB 194,A00,193286,Kurle; Carolyn M.,22,0,32,10
1683291387893,BILD 1,A01,192291,Staff,16,0,32,16
1683291387893,BILD 1,A02,192292,Staff,30,0,32,2
1683291387893,BILD 1,B01,192520,Reuther; Keefe,0,1,0,0
1683291387893,BILD 1,B02,192532,Reuther; Keefe,0,1,0,0
1683291388924,BILD 3,A01,192556,Butler; Shannon Rhey,0,0,32,32
1683291388924,BILD 3,A02,192581,Butler; Shannon Rhey,5,0,32,27
1683291388924,BILD 3,A03,192611,Butler; Shannon Rhey,23,0,32,9
1683291388924,BILD 3,A04,192612,Butler; Shannon Rhey,25,0,32,7
1683291388924,BILD 3,A05,192613,Butler; Shannon Rhey,27,0,32,5
1683291388924,BILD 3,A06,192679,Butler; Shannon Rhey,27,0,32,5
1683291388924,BILD 3,A07,192682,Butler; Shannon Rhey,22,0,32,10
1683291389957,BILD 4,A01,192836,Reuther; Keefe,1,0,24,23
1683291389957,BILD 4,A02,193044,Reuther; Keefe,4,0,24,20
1683291390987,BILD 10,A01,193142,Gustafson-Brown; Cindy,31,0,32,1
1683291390987,BILD 10,A02,193149,Gustafson-Brown; Cindy,31,0,32,1
1683291392011,BIMM 100,A01,193301,Staff,0,6,32,32
1683291392011,BIMM 100,A02,193312,Staff,0,5,32,32
1683291392011,BIMM 100,A03,193323,Staff,0,8,32,32
1683291393038,BIMM 101,A01,193329,McDonnell; Lisa Marie,0,3,24,24
1683291393038,BIMM 101,A02,193339,McDonnell; Lisa Marie,0,2,24,24
1683291393038,BIMM 101,B01,193354,McDonnell; Lisa Marie,0,3,24,24
1683291393038,BIMM 101,B02,193357,McDonnell; Lisa Marie,0,3,24,24
1683291394064,BIMM 110,A01,193377,Tat; John,0,11,32,32
1683291394064,BIMM 110,A02,193378,Tat; John,1,9,32,31
1683291395091,BIMM 120,A01,206116,Staff,0,0,32,32
1683291395091,BIMM 120,A02,206117,Staff,8,0,32,24
1683291395091,BIMM 120,A03,206121,Staff,21,0,32,11
1683291396117,BIPN 100,A01,193393,Park; Ji Young,0,14,32,32
1683291396117,BIPN 100,A02,193402,Park; Ji Young,0,12,32,32
1683291396117,BIPN 100,A03,193413,Park; Ji Young,0,14,32,32
1683291396117,BIPN 100,A04,193414,Park; Ji Young,0,13,32,32
1683291397141,BIPN 102,A01,193429,Staff,0,0,32,32
1683291397141,BIPN 102,A02,193438,Staff,23,0,32,9
1683291398171,BIPN 106,A01,193450,Reyes Gonzalez; Catalina,0,2,40,40
1683291399195,BIPN 134,A01,193465,Cooke; James Edward,0,0,32,32
1683291399195,BIPN 134,A02,193474,Cooke; James Edward,27,0,32,5
1683291399195,BIPN 134,A03,193485,Cooke; James Edward,29,0,32,3
1683291399195,BIPN 134,A04,193486,Cooke; James Edward,21,0,32,11
1683291399195,BIPN 134,A05,193491,Cooke; James Edward,31,0,32,1
1683291399195,BIPN 134,A06,193501,Cooke; James Edward,30,0,32,2
1683291399195,BIPN 134,A07,193510,Cooke; James Edward,29,0,32,3
1683291401243,BISP 194,A00,222522,Staff,16,0,32,16
1683291402268,CAT 124,A01,202407,Staff,20,0,25,5
1683291403303,CAT 125,A00,202408,Marchisotto; Jennifer Anne,4,0,20,16
1683291404334,CAT 125R,A00,202409,Smith; Lauryn Alissa,0,11,20,20
1683291404334,CAT 125R,B00,202410,Morales; Celeste Georgianna,0,11,20,20
1683291404334,CAT 125R,C00,202411,Irwin; Matthew Joseph,0,10,20,20
1683291405359,CENG 15,A01,204712,Yang; Kesong,0,1,0,0
1683291406387,CENG 114,A00,202070,Jahed Motlagh; Zeinab,5,0,20,15
1683291407414,CGS 105,A00,185477,Wesling; Megan E.,24,0,40,16
1683291408439,CGS 106,A00,185494,Staff,13,0,22,9
1683291409466,CGS 108,A00,185495,Staff,14,0,20,6
1683291410496,CGS 114,A00,185496,Staff,13,0,18,5
1683291411522,CGS 119,A00,185501,Staff,15,0,20,5
1683291412547,CGS 120,A00,185511,Staff,13,0,20,7
1683291413576,CHEM 4,A01,184675,Bussey; Thomas J,96,0,100,4
1683291414601,CHEM 6A,A01,184677,Staff,35,0,60,25
1683291415626,CHEM 6B,A01,184679,Staff,65,0,100,35
1683291416652,CHEM 6C,A01,184681,Bussey; Thomas J,1,0,50,49
1683291416652,CHEM 6C,A02,184682,Bussey; Thomas J,34,0,50,16
1683291417683,CHEM 40A,A01,184684,Albizati; Kim F.,37,0,100,63
1683291418708,CHEM 40B,A01,184686,Albizati; Kim F.,0,20,100,100
1683291419734,CHEM 41B,A01,184690,Staff,52,0,100,48
1683291420764,COGS 3,A01,184715,Boyle; Mary E. T.,0,25,40,40
1683291421790,COGS 14B,A01,185172,Staff,0,15,38,38
1683291422821,COGS 18,A01,184736,Staff,20,0,80,60
1683291423851,COGS 100,A01,184932,Staff,0,5,73,73
1683291424881,COGS 101A,A01,184935,Staff,0,38,30,30
1683291425909,COGS 101B,A01,184944,Staff,0,2,30,30
1683291426935,COGS 101C,A01,184946,Staff,0,12,30,30
1683291427962,COGS 102A,A01,184951,Johnson; Christine M.,2,0,40,38
1683291428986,COGS 107B,A01,184953,Mooshagian; Eric Frederick,0,50,40,40
1683291430013,COGS 118B,A01,184959,Gupta; Anjum,0,48,40,40
1683291431038,COGS 153,A00,184961,Staff,0,15,30,30
1683291432062,COGS 177,A00,184962,Staff,0,21,30,30
1683291433086,COGS 187A,A01,184969,Boyle; Mary E. T.,0,17,40,40
1683291434112,COMM 10,A01,185174,Staff,0,5,25,25
1683291434112,COMM 10,A02,185189,Staff,0,5,25,25
1683291434112,COMM 10,A03,269821,Staff,0,0,0,0
1683291435142,COMM 100B,A01,185475,Staff,0,0,0,2
1683291435142,COMM 100B,A02,185476,Staff,14,0,25,11
1683291436171,COMM 100C,A01,185314,Staff,1,0,25,24
1683291436171,COMM 100C,A02,185327,Staff,19,0,25,6
1683291437198,COMM 110M,A00,185349,Staff,2,0,40,38
1683291438222,COMM 113T,A00,185352,Staff,25,0,40,15
1683291439249,COMM 114I,A00,185353,Staff,33,0,40,7
1683291440277,COMM 131,A00,185354,Staff,19,0,30,11
1683291441306,CSE 8A,A50,185358,Cao; Yingjun,0,46,10,10
1683291442332,CSE 8B,A01,185362,Staff,0,47,50,50
1683291443357,CSE 11,A01,185416,Cao; Yingjun,0,93,10,10
1683291444386,CSE 20,A01,185445,Briones; Jor-el Thomas Caparas,5,0,25,20
1683291445411,CSE 21,A01,185447,Staff,10,0,50,40
1683291446438,CSE 101,A01,185451,Staff,0,12,50,50
1683291446438,CSE 101,B01,185453,Jones; Miles E,0,11,50,50
1683291448489,CSE 141,A01,185458,Eldon; John,20,0,100,80
1683291449518,CSE 141L,A01,185461,Eldon; John,12,0,100,88
1683291450548,CSE 142,A01,185463,Staff,35,0,60,25
1683291450548,CSE 142,B01,201355,Staff,0,6,60,60
1683291451578,CSE 142L,A01,185470,Staff,35,0,60,25
1683291451578,CSE 142L,B01,201417,Staff,0,5,60,60
1683291452602,CSE 190,A00,201433,Staff,32,0,49,17
1683291453629,DOC 1,A01,259136,Strom; Megan C.,8,0,15,7
1683291453629,DOC 1,A02,259137,Strom; Megan C.,14,0,15,1
1683291453629,DOC 1,A03,259138,Strom; Megan C.,14,0,15,1
1683291453629,DOC 1,A04,259139,Strom; Megan C.,14,0,15,1
1683291454654,DOC 100D,A00,259140,Pass; Natalye Joann,17,0,25,8
1683291455681,DSGN 1,A01,184749,Rill; Bryan,0,24,30,30
1683291456710,DSGN 100,A01,185168,Staff,0,2,25,25
1683291457741,ECE 5,A01,185626,Morris; Karcher William,0,10,0,0
1683291458766,ECE 101,A01,185628,Staff,17,0,70,53
1683291459791,ECE 107,A01,185635,Baghdadchi; Saharnaz,0,0,20,20
1683291459791,ECE 107,A02,185638,Baghdadchi; Saharnaz,4,0,20,16
1683291460816,ECE 148,A01,185647,Silberman; Jack,1,0,16,15
1683291461897,ECON 1,A01,185537,Crane; Meredith Helen,54,0,70,16
1683291462922,ECON 3,A01,185549,Crane; Meredith Helen,33,0,70,37
1683291463947,ECON 4,A01,203354,Anderson; John Charles,0,4,10,10
1683291464973,ECON 100A,A01,185574,Staff,0,4,40,40
1683291465998,ECON 100B,A01,185576,Staff,0,22,40,40
1683291467028,ECON 100C,A01,185589,Newhouse; Herbert S,30,0,70,40
1683291468053,ECON 105,A00,185608,Vespa; Emanuel Ignacio,19,0,35,16
1683291469080,ECON 109,A01,185610,Shishkin; Denis,10,0,35,25
1683291470105,ECON 110A,A01,185612,Staff,11,0,40,29
1683291471134,ECON 120A,A01,185615,Staff,20,0,40,20
1683291472163,ECON 120C,A01,185617,Sun; Yixiao,0,20,70,70
1683291473189,ECON 144,A00,203346,Squires; Dale E,3,0,35,32
1683291474225,ECON 171,A01,203349,Newhouse; Herbert S,0,1,35,35
1683291475253,ECON 173A,A01,185621,Toda; Alexis Akira,21,0,35,14
1683291476285,EDS 25,A01,202413,Staff,0,1,0,0
1683291476285,EDS 25,A02,202414,Staff,0,1,0,0
1683291476285,EDS 25,A03,202415,Staff,0,0,0,0
1683291476285,EDS 25,A04,202416,Staff,0,1,0,0
1683291476285,EDS 25,A05,202439,Staff,0,0,0,0
1683291476285,EDS 25,A06,202440,Staff,0,0,0,0
1683291476285,EDS 25,B01,202631,Staff,0,0,0,0
1683291476285,EDS 25,B02,202632,Staff,0,0,0,0
1683291476285,EDS 25,B03,202639,Staff,0,0,0,0
1683291476285,EDS 25,B04,202640,Staff,0,0,0,0
1683291476285,EDS 25,B05,202643,Staff,0,0,0,0
1683291476285,EDS 25,B06,202644,Staff,0,0,0,0
1683291477311,EDS 38,A01,202659,Black; Alison Michelle,24,0,25,1
1683291478333,EDS 115,A00,202652,Staff,17,0,30,13
1683291479357,EDS 125,A00,202649,Staff,14,0,30,16
1683291480386,EDS 126,A01,203332,Staff,30,0,30,0
1683291481411,EDS 139,A00,202838,Staff,17,0,25,8
1683291482437,EDS 146,A01,202655,Staff,15,0,25,10
1683291483461,ENG 15,A00,185667,Staff,0,1,0,0
1683291483461,ENG 15,B00,185672,Staff,0,0,0,0
1683291483461,ENG 15,C00,185675,Staff,0,0,0,0
1683291483461,ENG 15,D00,185682,Staff,0,0,0,0
1683291483461,ENG 15,E00,185684,Staff,0,0,0,0
1683291484487,ETHN 103,A00,185710,Staff,0,3,35,35
1683291485518,ETHN 103A,A00,199228,Man; Simeon S,3,0,9,6
1683291486546,ETHN 109,A00,185711,Staff,18,0,35,17
1683291487574,ETHN 142,A00,185726,Staff,0,4,30,30
1683291488601,ETHN 163J,A00,199229,Man; Simeon S,6,0,8,2
1683291489629,ETHN 168,A00,185727,Staff,8,0,10,2
1683291490657,ETHN 182,A00,185728,Staff,1,0,35,34
1683291491682,ETHN 183,A00,185737,Staff,8,0,18,10
1683291492711,GLBH 111,A01,209361,Burgos; Jose L.,0,0,0,0
1683291494765,HIEU 104,A00,185792,Staff,16,0,20,4
1683291495794,HIEU 115,A00,185800,Staff,1,0,20,19
1683291496821,HIEU 128,A00,185801,Staff,0,7,20,20
1683291497848,HIEU 147,A00,185802,Staff,16,0,20,4
1683291498877,HIEU 154,A00,185823,Staff,12,0,20,8
1683291499903,HILA 102,A00,185826,Staff,13,0,20,7
1683291500926,HILD 2C,A01,185778,Staff,0,12,20,20
1683291501954,HILD 7B,A01,185780,Kwak; Nancy,0,15,32,32
1683291501954,HILD 7B,A02,185781,Kwak; Nancy,0,18,32,32
1683291502982,HILD 30,A01,185791,Staff,14,0,20,6
1683291504006,HISC 119,A00,185830,Golan; Tal,0,9,20,20
1683291505034,HITO 156GS,A00,185831,Patterson; Patrick H.,0,0,0,23
1683291506061,HIUS 103,A00,185832,Man; Simeon S,0,7,20,20
1683291507085,HIUS 117,A00,185836,Kwak; Nancy,2,0,20,18
1683291508111,HIUS 125,A00,185840,Man; Simeon S,0,0,23,23
1683291509137,HIUS 149,A00,185845,Staff,0,0,20,20
1683291510164,HUM 3,A01,185882,Zavodny; Tatiana Sophia,0,6,50,50
1683291510164,HUM 3,B01,185899,Caldwell; Michael Alan,0,19,50,50
1683291511189,HUM 3GS,A00,185900,Patterson; Patrick H.,0,0,0,23
1683291512225,HUM 4,A01,185938,Zroka; Amy Liane,31,0,50,19
1683291512225,HUM 4,B01,185956,Watkins; Eric,0,2,50,50
1683291512225,HUM 4,B02,202209,Watkins; Eric,0,1,50,50
1683291512225,HUM 4,B03,202210,Watkins; Eric,0,0,50,50
1683291513256,HUM 5,A01,185958,West; Geoffrey Scott,5,0,50,45
1683291513256,HUM 5,A02,202215,West; Geoffrey Scott,0,0,50,50
1683291514280,INTL 190,A00,185959,Gagnon; Jeffrey C,0,0,0,9
1683291514280,INTL 190,B00,185960,Lettieri; Michael Joseph,0,0,0,1
1683291515307,JAPN 180,A00,254509,Staff,0,1,25,25
1683291516337,LATI 10,A01,202853,Kennemore; Amy Michelle,5,0,35,30
1683291516337,LATI 10,A02,202854,Kennemore; Amy Michelle,1,0,35,34
1683291516337,LATI 10,A03,270054,Kennemore; Amy Michelle,30,0,30,0
1683291517362,LATI 180,A00,202855,Kennemore; Amy Michelle,11,0,20,9
1683291518393,LAWS 101,A00,201767,Golan; Tal,0,7,40,40
1683291519419,LIFR 1C,A00,185961,Staff,6,0,20,14
1683291520444,LIFR 1CX,A00,185962,Staff,7,0,20,13
1683291521470,LIFR 1D,A00,185963,Staff,9,0,20,11
1683291522495,LIFR 1DX,A00,185964,Staff,9,0,20,11
1683291523519,LIGN 101,A01,186039,Staff,43,0,50,7
1683291524549,LIGN 165,A00,186040,Staff,18,0,50,32
1683291525577,LTCS 108,A00,186041,Staff,6,0,10,4
1683291526602,LTCS 119,A00,186042,Staff,16,0,20,4
1683291527629,LTCS 130,A00,186043,Wesling; Megan E.,15,0,25,10
1683291529682,LTEA 138,A00,186119,Staff,14,0,40,26
1683291530711,LTEN 124,A00,186148,Staff,6,0,25,19
1683291531739,LTEN 178,A00,186149,Staff,7,0,15,8
1683291532765,LTEN 181,A00,186150,Blanco; John D,33,0,40,7
1683291533791,LTWL 120,A00,186160,Staff,20,0,25,5
1683291534820,LTWL 165,A00,186161,Staff,22,0,25,3
1683291535846,LTWR 100,A00,186162,Staff,0,4,15,15
1683291536875,LTWR 102,A00,186163,Doller; Ben,5,0,15,10
1683291537899,MAE 8,A01,186412,Staff,0,0,0,0
1683291538925,MAE 30B,A00,186445,Bahadori; Mohammad Yousef,83,0,100,17
1683291539955,MAE 40,A00,186592,Bewley; Thomas R,9,0,50,41
1683291540983,MAE 101B,A00,186593,Bahadori; Mohammad Yousef,81,0,100,19
1683291542015,MAE 105,A00,186594,Bandaru; Prabhakar,12,0,50,38
1683291543045,MAE 107,A00,186599,Pham; Hieu Tan,0,6,120,120
1683291544073,MAE 148,A01,186660,Silberman; Jack,3,0,16,13
1683291545102,MATH 10A,A01,188095,Staff,0,7,35,35
1683291546134,MATH 10B,A01,188097,Bowers; Adam R.,0,11,30,30
1683291546134,MATH 10B,A02,188099,Bowers; Adam R.,0,9,30,30
1683291546134,MATH 10B,B01,188104,Bowers; Adam R.,0,11,30,30
1683291546134,MATH 10B,B02,188106,Bowers; Adam R.,0,11,30,30
1683291547164,MATH 10C,A01,188111,Staff,0,18,30,30
1683291547164,MATH 10C,A02,188127,Staff,0,17,30,30
1683291547164,MATH 10C,A03,188131,Staff,0,17,30,30
1683291547164,MATH 10C,B01,188218,Staff,21,0,30,9
1683291547164,MATH 10C,B02,188244,Staff,13,0,30,17
1683291547164,MATH 10C,B03,188277,Staff,16,0,30,14
1683291548190,MATH 18,A01,188344,Bach; Quang Tran,18,0,30,12
1683291548190,MATH 18,A02,188345,Bach; Quang Tran,11,0,30,19
1683291548190,MATH 18,B01,188353,Bach; Quang Tran,10,0,30,20
1683291548190,MATH 18,B02,188354,Bach; Quang Tran,20,0,30,10
1683291549216,MATH 20A,A01,188374,Staff,13,0,35,22
1683291550247,MATH 20B,A01,188382,Ohm; Ko Woon,6,0,30,24
1683291550247,MATH 20B,A02,188383,Ohm; Ko Woon,24,0,30,6
1683291550247,MATH 20B,B01,188385,Ohm; Ko Woon,7,0,30,23
1683291550247,MATH 20B,B02,188392,Ohm; Ko Woon,22,0,30,8
1683291551277,MATH 20C,A01,188394,Harel; Guershon,10,0,30,20
1683291551277,MATH 20C,A02,188395,Harel; Guershon,13,0,30,17
1683291551277,MATH 20C,B01,188404,Harel; Guershon,3,0,30,27
1683291551277,MATH 20C,B02,188405,Harel; Guershon,19,0,30,11
1683291552310,MATH 20D,A01,188414,Hammock; Frances H,0,1,30,30
1683291552310,MATH 20D,A02,188415,Hammock; Frances H,4,0,30,26
1683291552310,MATH 20D,B01,188447,Hammock; Frances H,2,0,30,28
1683291552310,MATH 20D,B02,188486,Hammock; Frances H,8,0,30,22
1683291553341,MATH 20E,A01,188649,Staff,22,0,30,8
1683291553341,MATH 20E,A02,188650,Staff,23,0,30,7
1683291553341,MATH 20E,A03,188673,Staff,0,0,30,30
1683291554370,MATH 102,A01,188675,Staff,0,35,35,35
1683291555401,MATH 103B,A01,188681,Staff,4,0,35,31
1683291555401,MATH 103B,B01,188692,Staff,8,0,35,27
1683291556426,MATH 109,A01,188695,Salehi Golsefidy; Alireza,25,0,35,10
1683291556426,MATH 109,A02,188696,Salehi Golsefidy; Alireza,27,0,35,8
1683291557456,MATH 120A,A01,188698,Eggers; John Dietrich,5,0,35,30
1683291558486,MATH 142B,A01,188736,Ioana; Adrian,0,2,30,30
1683291558486,MATH 142B,A02,188741,Ioana; Adrian,0,1,30,30
1683291558486,MATH 142B,A03,188743,Ioana; Adrian,0,3,30,30
1683291559514,MATH 168A,A01,188790,Staff,0,8,35,35
1683291560545,MATH 170A,A01,188803,Nie; Jiawang,0,2,35,35
1683291560545,MATH 170A,A02,188811,Nie; Jiawang,0,0,35,35
1683291560545,MATH 170A,A03,188814,Nie; Jiawang,1,0,35,34
1683291560545,MATH 170A,A04,188815,Nie; Jiawang,14,0,35,21
1683291561571,MATH 193B,A01,188817,Staff,0,0,35,35
1683291561571,MATH 193B,A02,188818,Staff,5,0,35,30
1683291562596,MGT 4,A01,202857,Anderson; John Charles,62,0,80,18
1683291563621,MGT 12,A00,202858,Lindenberger; Wade Douglas,43,0,90,47
1683291564647,MGT 18,A00,202859,Staff,74,0,90,16
1683291565735,MGT 18GS,A00,202860,McKay; Michael J,13,0,28,15
1683291566767,MGT 45,A00,202861,Pecore; Joseph P.,14,0,90,76
1683291567793,MGT 100,A00,202863,Yavorsky; Daniel Ryan,28,0,90,62
1683291568823,MGT 103,A00,202864,Ehrich; Kristine R,0,16,90,90
1683291569846,MGT 112,A00,202865,Ehrich; Kristine R,15,0,90,75
1683291570872,MGT 121A,A00,202868,Staff,0,19,0,0
1683291571901,MGT 131B,A00,202869,Anderson; John Charles,59,0,90,31
1683291572929,MGT 136,A00,202871,Lindenberger; Wade Douglas,84,0,90,6
1683291573959,MGT 164,A00,202873,Staff,0,69,90,90
1683291574985,MGT 164GS,A00,202874,McKay; Mary A,13,0,28,15
1683291576010,MGT 180,A00,202875,Staff,0,51,90,90
1683291577036,MMW 11R,A01,205019,Herbst; Matthew,3,0,30,27
1683291577036,MMW 11R,A02,205026,Herbst; Matthew,29,0,30,1
1683291578064,MMW 15,A01,193512,Chang; Edmond Yi-Teh,0,9,28,28
1683291578064,MMW 15,A02,193513,Chang; Edmond Yi-Teh,0,5,28,28
1683291578064,MMW 15,A03,193514,Chang; Edmond Yi-Teh,0,5,28,28
1683291578064,MMW 15,A04,193515,Chang; Edmond Yi-Teh,0,4,28,28
1683291578064,MMW 15,A05,193516,Chang; Edmond Yi-Teh,0,4,28,28
1683291578064,MMW 15,A06,193517,Chang; Edmond Yi-Teh,0,5,28,28
1683291578064,MMW 15,B01,193519,Chang; Edmond Yi-Teh,0,4,28,28
1683291578064,MMW 15,B02,193520,Chang; Edmond Yi-Teh,0,5,28,28
1683291578064,MMW 15,B03,193521,Chang; Edmond Yi-Teh,0,4,28,28
1683291578064,MMW 15,B04,193522,Chang; Edmond Yi-Teh,0,4,28,28
1683291578064,MMW 15,B05,193523,Chang; Edmond Yi-Teh,0,5,28,28
1683291578064,MMW 15,B06,193524,Chang; Edmond Yi-Teh,0,4,28,28
1683291579091,MMW 122,A01,193526,Rahimi; Babak,0,14,28,28
1683291579091,MMW 122,A02,193527,Rahimi; Babak,0,14,28,28
1683291579091,MMW 122,A03,193528,Rahimi; Babak,0,0,0,0
1683291579091,MMW 122,A04,193529,Rahimi; Babak,0,0,0,0
1683291580117,MUS 1A,A01,186663,Staff,0,20,35,35
1683291581142,MUS 4,A01,186715,Staff,0,12,35,35
1683291582167,MUS 5R,A01,186796,Dubnov; Shlomo,0,16,35,35
1683291583191,MUS 6,A01,186798,Staff,0,3,25,25
1683291584234,MUS 7,A01,186830,Staff,12,0,35,23
1683291585258,MUS 8,A01,186930,Staff,0,25,35,35
1683291586288,MUS 15,A01,186932,Staff,0,15,35,35
1683291586288,MUS 15,B01,186934,Staff,0,14,35,35
1683291587318,MUS 80,A00,186935,Staff,2,0,20,18
1683291587318,MUS 80,B00,186936,Staff,25,0,25,0
1683291588348,NANO 11,A00,204702,Lipomi; Darren John,0,0,0,0
1683291589380,NANO 15,A01,204709,Yang; Kesong,0,1,0,0
1683291590405,NANO 114,A00,202069,Jahed Motlagh; Zeinab,3,0,10,7
1683291591434,PHIL 1,A00,186955,Grush; Rick Scott,32,0,40,8
1683291592465,PHIL 10,A01,186973,Grush; Rick Scott,29,0,35,6
1683291592465,PHIL 10,A02,186974,Grush; Rick Scott,33,0,35,2
1683291593493,PHIL 13,A01,186976,Staff,7,0,35,28
1683291593493,PHIL 13,A02,186977,Staff,16,0,35,19
1683291594521,PHIL 14,A01,186979,Staff,31,0,35,4
1683291594521,PHIL 14,A02,186986,Staff,32,0,35,3
1683291595550,PHIL 28,A01,186988,Staff,16,0,30,14
1683291595550,PHIL 28,A02,186989,Staff,1,0,30,29
1683291595550,PHIL 28,A03,186990,Staff,9,0,30,21
1683291595550,PHIL 28,A04,186991,Staff,26,0,30,4
1683291596577,PHIL 120,A00,186997,Staff,23,0,40,17
1683291597605,PHIL 137,A00,187003,Staff,9,0,40,31
1683291598631,PHIL 150,A00,187015,Staff,47,0,70,23
1683291599657,PHIL 167,A00,187021,Lamey; Andy M.,35,0,40,5
1683291600684,PHIL 174,A01,202226,Staff,17,0,20,3
1683291600684,PHIL 174,A02,202235,Staff,20,0,20,0
1683291601711,PHIL 191A,A00,258918,Staff,0,0,1,1
1683291602735,PHYS 1A,A00,187028,Staff,26,0,60,34
1683291603765,PHYS 1AL,001,187036,Staff,2,0,30,28
1683291603765,PHYS 1AL,002,187049,Staff,18,0,30,12
1683291604797,PHYS 1B,A00,187058,Staff,23,0,60,37
1683291605824,PHYS 1BL,001,187064,Staff,0,0,30,30
1683291605824,PHYS 1BL,002,187070,Staff,6,0,30,24
1683291606852,PHYS 1C,A00,187082,Staff,32,0,120,88
1683291607877,PHYS 1CL,001,187088,Staff,0,9,30,30
1683291607877,PHYS 1CL,002,187089,Staff,0,2,30,30
1683291607877,PHYS 1CL,009,262693,Staff,12,0,30,18
1683291608906,PHYS 2B,A01,187097,Staff,54,0,115,61
1683291609938,PHYS 2C,A01,187099,Staff,67,0,115,48
1683291610966,PHYS 2CL,A01,187101,Staff,5,0,28,23
1683291610966,PHYS 2CL,A02,187102,Staff,15,0,28,13
1683291611997,PHYS 2D,A01,187123,Shotwell; Brian,95,0,115,20
1683291613026,PHYS 4B,A01,187133,Grinstein; Benjamin,35,0,50,15
1683291614051,POLI 10,A00,188819,Staff,0,3,50,50
1683291615078,POLI 11,A00,188827,Staff,43,0,50,7
1683291616108,POLI 13R,A00,188828,Staff,0,1,20,20
1683291617145,POLI 27,A01,188830,Elgin; Samuel Zincke,0,1,70,70
1683291618170,POLI 30,A00,188832,Desposato; Scott,33,0,50,17
1683291619200,POLI 102F,A00,188834,Staff,3,0,40,37
1683291620228,POLI 104A,A00,188852,Staff,14,0,30,16
1683291621253,POLI 104I,A00,188853,Staff,0,6,20,20
1683291622281,POLI 110B,A00,188854,Wiens; David,7,0,20,13
1683291623309,POLI 112A,A00,188855,Wiens; David,5,0,30,25
1683291624335,POLI 117R,A00,188856,Forman; Fonna,0,11,20,20
1683291625365,POLI 118,A00,188857,Ingham; Sean,8,0,20,12
1683291626393,POLI 120G,A00,188858,Staff,9,0,30,21
1683291627418,POLI 131CR,A00,188863,Hoston; Germaine,24,0,50,26
1683291628443,POLI 133,A00,188864,Nellis; Gareth Hb,44,0,50,6
1683291629472,POLI 134D,A00,188865,Desposato; Scott,27,0,30,3
1683291630499,POLI 142A,A00,188871,Gartzke; Erik,22,0,50,28
1683291631525,POLI 142K,A00,188874,Staff,38,0,50,12
1683291632551,POLI 143,A00,188940,Gartzke; Erik,16,0,30,14
1683291633576,POLI 153,A00,188943,Staff,3,0,20,17
1683291634605,POLI 160AA,A00,188944,Staff,13,0,40,27
1683291635648,POLI 170A,A00,188945,Staff,11,0,30,19
1683291637727,PSYC 1,A00,188952,Staff,38,0,90,52
1683291638753,PSYC 2,B00,188953,Staff,20,0,35,15
1683291639779,PSYC 6,A00,188970,Staff,47,0,60,13
1683291640805,PSYC 7,A00,188973,Staff,37,0,45,8
1683291641834,PSYC 60,A01,188980,Rickard; Timothy C.,43,0,60,17
1683291642859,PSYC 70,A01,189001,Steiner; Eric Tomas,24,0,45,21
1683291643883,PSYC 100,A00,189005,Lacefield; Katharine I,0,99,120,120
1683291644911,PSYC 102,A00,189008,Staff,10,0,30,20
1683291645935,PSYC 106,B00,189026,Gorman; Michael R.,37,0,60,23
1683291646959,PSYC 114,B01,189033,Winkielman; Piotr,0,32,30,30
1683291647985,PSYC 131,A00,189036,Anagnostaras; Stephan,0,43,60,60
1683291649011,PSYC 136,A00,189041,Lowe; Angela Beth,0,7,25,25
1683291650038,PSYC 137,A00,189057,Winkielman; Piotr,0,34,25,25
1683291651064,PSYC 144,A00,189107,Wixted; John T,0,7,50,50
1683291653118,PSYC 162,A00,189142,Staff,0,8,85,85
1683291654141,PSYC 172,A00,189144,Gorman; Michael R.,0,7,30,30
1683291656191,PSYC 179,A00,189146,Lacefield; Katharine I,0,84,120,120
1683291657221,PSYC 181,A00,189147,Anagnostaras; Stephan,0,44,90,90
1683291658249,PSYC 190R,A00,189148,Barner; David A.,0,22,80,80
1683291659275,PSYC 191,A00,189275,Rickard; Timothy C.,0,7,25,25
1683291660305,PSYC 193,A00,189276,Chapman; Eddie Nathaniel,0,1,0,4
1683291661339,PSYC 193L,A01,189281,Lowe; Angela Beth,12,0,20,8
1683291661339,PSYC 193L,B01,189285,Staff,28,0,35,7
1683291662364,RELI 149,A00,187137,Rahimi; Babak,7,0,40,33
1683291663393,SE 9,A01,187315,Staff,0,2,18,18
1683291664419,SE 101B,A00,187409,Staff,24,0,30,6
1683291665445,SE 110B,A00,187444,Staff,10,0,40,30
1683291666470,SE 130B,A00,187449,Staff,31,0,40,9
1683291667496,SE 150A,A00,187516,Staff,9,0,20,11
1683291668525,SE 154,A00,187528,Staff,30,0,50,20
1683291669605,SIO 3,A01,258171,Staff,35,0,40,5
1683291670631,SIO 10,A00,187144,Cook; Geoffrey W,0,3,75,75
1683291671657,SIO 45,A00,187152,Cook; Geoffrey W,1,0,100,99
1683291672681,SIO 109R,A00,194486,Staff,0,3,20,20
1683291674739,SIO 187,A01,187233,Kacev; David,12,0,40,28
1683291675774,SOCI 1,A01,258656,Thorpe; Charles Robert,28,0,30,2
1683291675774,SOCI 1,A02,258658,Thorpe; Charles Robert,30,0,30,0
1683291675774,SOCI 1,A03,258661,Thorpe; Charles Robert,25,0,25,0
1683291675774,SOCI 1,A04,258666,Thorpe; Charles Robert,22,0,25,3
1683291675774,SOCI 1,A05,258897,Thorpe; Charles Robert,23,0,25,2
1683291675774,SOCI 1,A06,258898,Thorpe; Charles Robert,25,0,25,0
1683291676799,SOCI 30,A01,258903,Pardo Guerra; Juan Pablo,16,0,30,14
1683291677827,SOCI 102,A00,258904,Staff,9,0,25,16
1683291678855,SOCI 106,A00,258905,Staff,19,0,25,6
1683291679878,SOCI 111,A00,258907,Ribas Norris; Janet Vanesa,26,0,30,4
1683291680906,SOCI 121R,A00,258908,Pardo Guerra; Juan Pablo,11,0,30,19
1683291681932,SOCI 126,A01,203330,Staff,14,0,20,6
1683291682958,SOCI 131,A00,258909,Thorpe; Charles Robert,31,0,60,29
1683291683984,SOCI 135,A00,258910,Payne; Christine Anna,0,9,30,30
1683291685009,SOCI 157,A00,258911,Staff,13,0,30,17
1683291686038,SOCI 184,A00,258912,Staff,26,0,30,4
1683291687066,SOCI 188D,A00,258913,Staff,21,0,30,9
1683291688090,SYN 2,001,187529,Staff,9,0,16,7
1683291688090,SYN 2,002,201452,Staff,0,18,16,16
1683291688090,SYN 2,003,201469,Staff,3,0,16,13
1683291689116,SYN 100,A01,187531,Staff,0,9,20,20
1683291689116,SYN 100,B01,201491,Staff,0,12,20,20
1683291690143,TDAC 1,A00,189286,Walsh; Kim C.,3,0,20,17
1683291690143,TDAC 1,B00,189287,Harting; Carla Kelso,11,0,20,9
1683291691167,TDAC 101,A00,189300,Walsh; Kim C.,16,0,20,4
1683291691167,TDAC 101,B00,189301,Harting; Carla Kelso,18,0,20,2
1683291692193,TDAC 102,A00,189304,Basso; Beatrice,14,0,20,6
1683291693218,TDAC 108,A00,189305,Staff,18,0,20,2
1683291694246,TDDE 131,A00,189310,Staff,19,0,20,1
1683291694246,TDDE 131,B00,189314,Staff,19,0,20,1
1683291694246,TDDE 131,C00,189315,Staff,48,0,50,2
1683291694246,TDDE 131,D00,189316,Staff,14,0,15,1
1683291694246,TDDE 131,E00,204841,Staff,20,0,20,0
1683291695277,TDGE 10,A00,189289,Staff,30,0,50,20
1683291695277,TDGE 10,B00,189290,Havis; Allan,2,0,50,48
1683291696303,TDGE 11,A00,189291,Fulton; Julia,0,3,50,50
1683291696303,TDGE 11,B00,189292,Staff,20,0,25,5
1683291696303,TDGE 11,C00,260270,Staff,0,0,0,0
1683291697331,TDGE 25,A00,189294,Staff,3,0,20,17
1683291698356,TDGE 124,A00,189318,Fulton; Julia,0,8,50,50
1683291699382,TDGE 125,A00,189319,Staff,13,0,25,12
1683291699382,TDGE 125,B00,189320,Staff,23,0,25,2
1683291700412,TDGE 127,A00,189322,Havis; Allan,0,0,50,50
1683291701443,TDHT 101,A00,189323,Staff,18,0,25,7
1683291701443,TDHT 101,B00,189324,Staff,25,0,25,0
1683291702473,TDHT 102,A00,189325,Staff,49,0,50,1
1683291703501,TDMV 1,A00,189295,Arcidiacono; Kristin,20,0,30,10
1683291703501,TDMV 1,B00,189296,Caligagan; Maria T.,24,0,30,6
1683291704532,TDMV 2,A00,189297,Sammartano; Tonnie,28,0,30,2
1683291704532,TDMV 2,B00,189299,Arcidiacono; Kristin,24,0,30,6
1683291705567,TDMV 3,A00,204998,Rincon; Alicia,22,0,30,8
1683291706591,TDMV 120,A00,189458,Sammartano; Tonnie,28,0,30,2
1683291707617,TDMV 138,A00,189541,Jun; Grace Shin Hae,22,0,40,18
1683291708642,TDMV 142,A00,189717,Caligagan; Tony,23,0,30,7
1683291708642,TDMV 142,B00,189718,Caligagan; Maria T.,25,0,30,5
1683291709670,TMC 2,A01,187533,Staff,25,0,25,0
1683291709670,TMC 2,A02,187534,Staff,25,0,25,0
1683291710697,USP 1,A01,187536,Kwak; Nancy,0,16,25,25
1683291711721,USP 5,A01,187538,Staff,9,0,25,16
1683291712747,USP 101,A00,199253,Staff,0,4,0,0
1683291713773,USP 124,A00,187562,Boomhower; Matthew Charles,1,0,30,29
1683291714798,USP 138,A00,187582,Staff,20,0,25,5
1683291715827,USP 152,A01,187597,Staff,4,0,25,21
1683291716856,USP 153,A00,187598,Staff,19,0,25,6
1683291717881,USP 168,A00,187607,Kwak; Nancy,2,0,5,3
1683291718907,USP 173,A00,187619,Staff,4,0,25,21
1683291719932,USP 181,A00,187638,Staff,0,0,25,25
1683291720959,VIS 103,A00,187650,Cruz; Edwin Teddy,23,0,75,52
1683291721989,VIS 110D,A00,187669,Staff,12,0,22,10
1683291723016,VIS 127C,A00,187720,Shen; Kuiyi,68,0,146,78
1683291724042,VIS 149,A00,187731,Yoldas; Pinar,0,14,22,22
1683291725067,VIS 151,A01,188091,Staff,22,0,34,12
1683291725067,VIS 151,A02,188092,Staff,11,0,34,23
1683291726097,VIS 160B,A00,188093,Stalbaum; Brett,0,0,10,10
1683291728152,WCWP 10B,A00,201720,Staff,10,0,15,5
1683291728152,WCWP 10B,B00,201722,Staff,8,0,15,7
1683291729179,WCWP 100,A00,201725,Gagnon; Jeffrey C,0,0,2,2
1683291729179,WCWP 100,B00,201727,Staff,0,4,15,15
1683291732373,ANBI 133,A00,258401,Wilder; Linnea Lorene,34,0,40,6
1683291733398,ANBI 140,A00,258395,Hrvoj Mihic; Branka,18,0,25,7
1683291734423,ANSC 120,A00,258402,Bialecki; Jon Anthony,27,0,40,13
1683291735448,ANSC 144,A00,258400,Staff,14,0,40,26
1683291737504,ANSC 166,A00,258396,Parish; Steven Martin,157,0,175,18
1683291738529,ANSC 180,A00,193533,Staff,9,0,20,11
1683291739554,ANSC 188,A00,258397,Jassal; Aftab,33,0,40,7
1683291740580,ANTH 3,A01,258316,Staff,23,0,30,7
1683291741606,ANTH 5,A00,258394,Semendeferi; Ekaterini,16,0,20,4
1683291742631,ANTH 21,A01,258331,Staff,9,0,40,31
1683291743661,ANTH 103,A00,258398,Varma; Saiba,15,0,25,10
1683291744691,AWP 10,001,202034,Staff,0,0,0,0
1683291744691,AWP 10,002,202035,Staff,0,0,0,0
1683291744691,AWP 10,003,202036,Staff,0,0,0,0
1683291744691,AWP 10,004,202037,Staff,0,0,0,0
1683291744691,AWP 10,005,202038,Staff,0,0,0,0
1683291744691,AWP 10,006,202039,Staff,0,0,0,0
1683291744691,AWP 10,007,202040,Staff,0,0,0,0
1683291744691,AWP 10,008,202041,Staff,0,0,0,0
1683291744691,AWP 10,009,202042,Staff,0,0,0,0
1683291744691,AWP 10,010,202043,Staff,0,0,0,0
1683291744691,AWP 10,011,202044,Staff,0,0,0,0
1683291744691,AWP 10,012,202045,Staff,0,0,0,0
1683291744691,AWP 10,013,202046,Staff,0,0,0,0
1683291744691,AWP 10,014,202047,Staff,0,0,0,0
1683291744691,AWP 10,015,202048,Staff,0,0,0,0
1683291744691,AWP 10,016,202049,Staff,0,0,0,0
1683291744691,AWP 10,017,202050,Staff,0,0,0,0
1683291744691,AWP 10,018,202051,Staff,0,0,0,0
1683291744691,AWP 10,019,202052,Staff,0,0,0,0
1683291744691,AWP 10,020,202053,Staff,0,0,0,0
1683291744691,AWP 10,021,202054,Staff,0,0,0,0
1683291744691,AWP 10,022,202055,Staff,0,0,0,0
1683291744691,AWP 10,023,202056,Staff,0,0,0,0
1683291744691,AWP 10,024,202057,Staff,0,0,0,0
1683291744691,AWP 10,025,202058,Staff,0,0,0,0
1683291744691,AWP 10,026,202059,Staff,0,0,0,0
1683291745717,AWP 102,001,202032,Staff,0,0,0,0
1683291745717,AWP 102,002,202033,Staff,0,0,0,0
1683291746743,BENG 100,A01,254234,Taylor Amos; Alyssa C,31,0,40,9
1683291747774,BENG 196,001,270013,Engler; Adam J.,9999,0,9999,0
1683291748802,BICD 100R,A01,202018,Smith; Laurie,0,7,32,32
1683291748802,BICD 100R,A02,202019,Smith; Laurie,0,2,32,32
1683291748802,BICD 100R,A03,202020,Smith; Laurie,0,1,32,32
1683291748802,BICD 100R,A04,202021,Smith; Laurie,8,0,32,24
1683291748802,BICD 100R,A05,202022,Smith; Laurie,12,0,32,20
1683291749830,BICD 136,A01,193242,Gustafson-Brown; Cindy,0,2,32,32
1683291749830,BICD 136,A02,193244,Gustafson-Brown; Cindy,15,0,32,17
1683291750864,BIEB 102,A01,193249,Butler; Shannon Rhey,0,2,32,32
1683291750864,BIEB 102,A02,193251,Butler; Shannon Rhey,0,0,32,32
1683291750864,BIEB 102,A03,193253,Butler; Shannon Rhey,0,1,32,32
1683291750864,BIEB 102,A04,193255,Butler; Shannon Rhey,17,0,32,15
1683291750864,BIEB 102,A05,193265,Butler; Shannon Rhey,26,0,32,6
1683291750864,BIEB 102,A06,193269,Butler; Shannon Rhey,16,0,32,16
1683291752918,BIEB 150,A01,193274,Staff,0,0,32,32
1683291752918,BIEB 150,A02,193285,Staff,24,0,32,8
1683291753948,BIEB 194,A00,193286,Kurle; Carolyn M.,22,0,32,10
1683291754976,BILD 1,A01,192291,Staff,16,0,32,16
1683291754976,BILD 1,A02,192292,Staff,30,0,32,2
1683291754976,BILD 1,B01,192520,Reuther; Keefe,0,1,0,0
1683291754976,BILD 1,B02,192532,Reuther; Keefe,0,1,0,0
1683291756006,BILD 3,A01,192556,Butler; Shannon Rhey,0,0,32,32
1683291756006,BILD 3,A02,192581,Butler; Shannon Rhey,5,0,32,27
1683291756006,BILD 3,A03,192611,Butler; Shannon Rhey,23,0,32,9
1683291756006,BILD 3,A04,192612,Butler; Shannon Rhey,25,0,32,7
1683291756006,BILD 3,A05,192613,Butler; Shannon Rhey,27,0,32,5
1683291756006,BILD 3,A06,192679,Butler; Shannon Rhey,27,0,32,5
1683291756006,BILD 3,A07,192682,Butler; Shannon Rhey,22,0,32,10
1683291757033,BILD 4,A01,192836,Reuther; Keefe,1,0,24,23
1683291757033,BILD 4,A02,193044,Reuther; Keefe,4,0,24,20
1683291758062,BILD 10,A01,193142,Gustafson-Brown; Cindy,31,0,32,1
1683291758062,BILD 10,A02,193149,Gustafson-Brown; Cindy,31,0,32,1
1683291759090,BIMM 100,A01,193301,Staff,0,6,32,32
1683291759090,BIMM 100,A02,193312,Staff,0,5,32,32
1683291759090,BIMM 100,A03,193323,Staff,0,8,32,32
1683291760122,BIMM 101,A01,193329,McDonnell; Lisa Marie,0,3,24,24
1683291760122,BIMM 101,A02,193339,McDonnell; Lisa Marie,0,2,24,24
1683291760122,BIMM 101,B01,193354,McDonnell; Lisa Marie,0,3,24,24
1683291760122,BIMM 101,B02,193357,McDonnell; Lisa Marie,0,3,24,24
1683291761155,BIMM 110,A01,193377,Tat; John,0,11,32,32
1683291761155,BIMM 110,A02,193378,Tat; John,1,9,32,31
1683291762190,BIMM 120,A01,206116,Staff,0,0,32,32
1683291762190,BIMM 120,A02,206117,Staff,8,0,32,24
1683291762190,BIMM 120,A03,206121,Staff,21,0,32,11
1683291763216,BIPN 100,A01,193393,Park; Ji Young,0,14,32,32
1683291763216,BIPN 100,A02,193402,Park; Ji Young,0,12,32,32
1683291763216,BIPN 100,A03,193413,Park; Ji Young,0,14,32,32
1683291763216,BIPN 100,A04,193414,Park; Ji Young,0,13,32,32
1683291764246,BIPN 102,A01,193429,Staff,0,0,32,32
1683291764246,BIPN 102,A02,193438,Staff,23,0,32,9
1683291765271,BIPN 106,A01,193450,Reyes Gonzalez; Catalina,0,2,40,40
1683291766304,BIPN 134,A01,193465,Cooke; James Edward,0,0,32,32
1683291766304,BIPN 134,A02,193474,Cooke; James Edward,27,0,32,5
1683291766304,BIPN 134,A03,193485,Cooke; James Edward,29,0,32,3
1683291766304,BIPN 134,A04,193486,Cooke; James Edward,21,0,32,11
1683291766304,BIPN 134,A05,193491,Cooke; James Edward,31,0,32,1
1683291766304,BIPN 134,A06,193501,Cooke; James Edward,30,0,32,2
1683291766304,BIPN 134,A07,193510,Cooke; James Edward,29,0,32,3
1683291768361,BISP 194,A00,222522,Staff,16,0,32,16
1683291769391,CAT 124,A01,202407,Staff,20,0,25,5
1683291770417,CAT 125,A00,202408,Marchisotto; Jennifer Anne,4,0,20,16
1683291771446,CAT 125R,A00,202409,Smith; Lauryn Alissa,0,11,20,20
1683291771446,CAT 125R,B00,202410,Morales; Celeste Georgianna,0,11,20,20
1683291771446,CAT 125R,C00,202411,Irwin; Matthew Joseph,0,10,20,20
1683291772473,CENG 15,A01,204712,Yang; Kesong,0,1,0,0
1683291773568,CENG 114,A00,202070,Jahed Motlagh; Zeinab,5,0,20,15
1683291774594,CGS 105,A00,185477,Wesling; Megan E.,24,0,40,16
1683291775620,CGS 106,A00,185494,Staff,13,0,22,9
1683291776647,CGS 108,A00,185495,Staff,14,0,20,6
1683291777673,CGS 114,A00,185496,Staff,13,0,18,5
1683291778697,CGS 119,A00,185501,Staff,15,0,20,5
1683291779720,CGS 120,A00,185511,Staff,13,0,20,7
1683291780746,CHEM 4,A01,184675,Bussey; Thomas J,96,0,100,4
1683291781775,CHEM 6A,A01,184677,Staff,35,0,60,25
1683291782801,CHEM 6B,A01,184679,Staff,65,0,100,35
1683291783829,CHEM 6C,A01,184681,Bussey; Thomas J,1,0,50,49
1683291783829,CHEM 6C,A02,184682,Bussey; Thomas J,34,0,50,16
1683291784855,CHEM 40A,A01,184684,Albizati; Kim F.,37,0,100,63
1683291785880,CHEM 40B,A01,184686,Albizati; Kim F.,0,20,100,100
1683291786910,CHEM 41B,A01,184690,Staff,52,0,100,48
1683291787941,COGS 3,A01,184715,Boyle; Mary E. T.,0,25,40,40
1683291788970,COGS 14B,A01,185172,Staff,0,15,38,38
1683291789999,COGS 18,A01,184736,Staff,20,0,80,60
1683291791029,COGS 100,A01,184932,Staff,0,5,73,73
1683291792057,COGS 101A,A01,184935,Staff,0,38,30,30
1683291793082,COGS 101B,A01,184944,Staff,0,2,30,30
1683291794107,COGS 101C,A01,184946,Staff,0,12,30,30
1683291795133,COGS 102A,A01,184951,Johnson; Christine M.,2,0,40,38
1683291796159,COGS 107B,A01,184953,Mooshagian; Eric Frederick,0,50,40,40
1683291797183,COGS 118B,A01,184959,Gupta; Anjum,0,48,40,40
1683291798209,COGS 153,A00,184961,Staff,0,15,30,30
1683291799234,COGS 177,A00,184962,Staff,0,21,30,30
1683291800263,COGS 187A,A01,184969,Boyle; Mary E. T.,0,17,40,40
1683291801289,COMM 10,A01,185174,Staff,0,5,25,25
1683291801289,COMM 10,A02,185189,Staff,0,5,25,25
1683291801289,COMM 10,A03,269821,Staff,0,0,0,0
1683291802320,COMM 100B,A01,185475,Staff,0,0,0,2
1683291802320,COMM 100B,A02,185476,Staff,14,0,25,11
1683291803346,COMM 100C,A01,185314,Staff,1,0,25,24
1683291803346,COMM 100C,A02,185327,Staff,19,0,25,6
1683291804384,COMM 110M,A00,185349,Staff,2,0,40,38
1683291805411,COMM 113T,A00,185352,Staff,25,0,40,15
1683291806437,COMM 114I,A00,185353,Staff,33,0,40,7
1683291807465,COMM 131,A00,185354,Staff,19,0,30,11
1683291808492,CSE 8A,A50,185358,Cao; Yingjun,0,46,10,10
1683291809518,CSE 8B,A01,185362,Staff,0,47,50,50
1683291810546,CSE 11,A01,185416,Cao; Yingjun,0,93,10,10
1683291811578,CSE 20,A01,185445,Briones; Jor-el Thomas Caparas,5,0,25,20
1683291812603,CSE 21,A01,185447,Staff,10,0,50,40
1683291813629,CSE 101,A01,185451,Staff,0,12,50,50
1683291813629,CSE 101,B01,185453,Jones; Miles E,0,11,50,50
1683291815684,CSE 141,A01,185458,Eldon; John,20,0,100,80
1683291816713,CSE 141L,A01,185461,Eldon; John,12,0,100,88
1683291817743,CSE 142,A01,185463,Staff,35,0,60,25
1683291817743,CSE 142,B01,201355,Staff,0,6,60,60
1683291818767,CSE 142L,A01,185470,Staff,35,0,60,25
1683291818767,CSE 142L,B01,201417,Staff,0,5,60,60
1683291819793,CSE 190,A00,201433,Staff,32,0,49,17
1683291820834,DOC 1,A01,259136,Strom; Megan C.,8,0,15,7
1683291820834,DOC 1,A02,259137,Strom; Megan C.,14,0,15,1
1683291820834,DOC 1,A03,259138,Strom; Megan C.,14,0,15,1
1683291820834,DOC 1,A04,259139,Strom; Megan C.,14,0,15,1
1683291821861,DOC 100D,A00,259140,Pass; Natalye Joann,17,0,25,8
1683291822890,DSGN 1,A01,184749,Rill; Bryan,0,24,30,30
1683291823920,DSGN 100,A01,185168,Staff,0,2,25,25
1683291824953,ECE 5,A01,185626,Morris; Karcher William,0,10,0,0
1683291825978,ECE 101,A01,185628,Staff,17,0,70,53
1683291827007,ECE 107,A01,185635,Baghdadchi; Saharnaz,0,0,20,20
1683291827007,ECE 107,A02,185638,Baghdadchi; Saharnaz,4,0,20,16
1683291828034,ECE 148,A01,185647,Silberman; Jack,1,0,16,15
1683291829063,ECON 1,A01,185537,Crane; Meredith Helen,54,0,70,16
1683291830093,ECON 3,A01,185549,Crane; Meredith Helen,33,0,70,37
1683291831118,ECON 4,A01,203354,Anderson; John Charles,0,4,10,10
1683291832143,ECON 100A,A01,185574,Staff,0,4,40,40
1683291833169,ECON 100B,A01,185576,Staff,0,22,40,40
1683291834196,ECON 100C,A01,185589,Newhouse; Herbert S,30,0,70,40
1683291835218,ECON 105,A00,185608,Vespa; Emanuel Ignacio,19,0,35,16
1683291836248,ECON 109,A01,185610,Shishkin; Denis,10,0,35,25
1683291837277,ECON 110A,A01,185612,Staff,11,0,40,29
1683291838303,ECON 120A,A01,185615,Staff,20,0,40,20
1683291839346,ECON 120C,A01,185617,Sun; Yixiao,0,20,70,70
1683291840376,ECON 144,A00,203346,Squires; Dale E,3,0,35,32
1683291841402,ECON 171,A01,203349,Newhouse; Herbert S,0,1,35,35
1683291842427,ECON 173A,A01,185621,Toda; Alexis Akira,21,0,35,14
1683291843455,EDS 25,A01,202413,Staff,0,1,0,0
1683291843455,EDS 25,A02,202414,Staff,0,1,0,0
1683291843455,EDS 25,A03,202415,Staff,0,0,0,0
1683291843455,EDS 25,A04,202416,Staff,0,1,0,0
1683291843455,EDS 25,A05,202439,Staff,0,0,0,0
1683291843455,EDS 25,A06,202440,Staff,0,0,0,0
1683291843455,EDS 25,B01,202631,Staff,0,0,0,0
1683291843455,EDS 25,B02,202632,Staff,0,0,0,0
1683291843455,EDS 25,B03,202639,Staff,0,0,0,0
1683291843455,EDS 25,B04,202640,Staff,0,0,0,0
1683291843455,EDS 25,B05,202643,Staff,0,0,0,0
1683291843455,EDS 25,B06,202644,Staff,0,0,0,0
1683291844482,EDS 38,A01,202659,Black; Alison Michelle,24,0,25,1
1683291845508,EDS 115,A00,202652,Staff,17,0,30,13
1683291846534,EDS 125,A00,202649,Staff,14,0,30,16
1683291847562,EDS 126,A01,203332,Staff,30,0,30,0
1683291848590,EDS 139,A00,202838,Staff,17,0,25,8
1683291849619,EDS 146,A01,202655,Staff,15,0,25,10
1683291850644,ENG 15,A00,185667,Staff,0,1,0,0
1683291850644,ENG 15,B00,185672,Staff,0,0,0,0
1683291850644,ENG 15,C00,185675,Staff,0,0,0,0
1683291850644,ENG 15,D00,185682,Staff,0,0,0,0
1683291850644,ENG 15,E00,185684,Staff,0,0,0,0
1683291851669,ETHN 103,A00,185710,Staff,0,3,35,35
1683291852694,ETHN 103A,A00,199228,Man; Simeon S,3,0,9,6
1683291853721,ETHN 109,A00,185711,Staff,18,0,35,17
1683291854746,ETHN 142,A00,185726,Staff,0,4,30,30
1683291855769,ETHN 163J,A00,199229,Man; Simeon S,6,0,8,2
1683291856792,ETHN 168,A00,185727,Staff,8,0,10,2
1683291857817,ETHN 182,A00,185728,Staff,1,0,35,34
1683291858846,ETHN 183,A00,185737,Staff,8,0,18,10
1683291859877,GLBH 111,A01,209361,Burgos; Jose L.,0,0,0,0
1683291861932,HIEU 104,A00,185792,Staff,16,0,20,4
1683291862959,HIEU 115,A00,185800,Staff,1,0,20,19
1683291863988,HIEU 128,A00,185801,Staff,0,7,20,20
1683291865019,HIEU 147,A00,185802,Staff,16,0,20,4
1683291866044,HIEU 154,A00,185823,Staff,12,0,20,8
1683291867071,HILA 102,A00,185826,Staff,13,0,20,7
1683291868095,HILD 2C,A01,185778,Staff,0,12,20,20
1683291869122,HILD 7B,A01,185780,Kwak; Nancy,0,15,32,32
1683291869122,HILD 7B,A02,185781,Kwak; Nancy,0,18,32,32
1683291870148,HILD 30,A01,185791,Staff,14,0,20,6
1683291871177,HISC 119,A00,185830,Golan; Tal,0,9,20,20
1683291872206,HITO 156GS,A00,185831,Patterson; Patrick H.,0,0,0,23
1683291873235,HIUS 103,A00,185832,Man; Simeon S,0,7,20,20
1683291874262,HIUS 117,A00,185836,Kwak; Nancy,2,0,20,18
1683291875288,HIUS 125,A00,185840,Man; Simeon S,0,0,23,23
1683291876313,HIUS 149,A00,185845,Staff,0,0,20,20
1683291877393,HUM 3,A01,185882,Zavodny; Tatiana Sophia,0,6,50,50
1683291877393,HUM 3,B01,185899,Caldwell; Michael Alan,0,19,50,50
1683291878418,HUM 3GS,A00,185900,Patterson; Patrick H.,0,0,0,23
1683291879453,HUM 4,A01,185938,Zroka; Amy Liane,31,0,50,19
1683291879453,HUM 4,B01,185956,Watkins; Eric,0,2,50,50
1683291879453,HUM 4,B02,202209,Watkins; Eric,0,1,50,50
1683291879453,HUM 4,B03,202210,Watkins; Eric,0,0,50,50
1683291880480,HUM 5,A01,185958,West; Geoffrey Scott,5,0,50,45
1683291880480,HUM 5,A02,202215,West; Geoffrey Scott,0,0,50,50
1683291881509,INTL 190,A00,185959,Gagnon; Jeffrey C,0,0,0,9
1683291881509,INTL 190,B00,185960,Lettieri; Michael Joseph,0,0,0,1
1683291882537,JAPN 180,A00,254509,Staff,0,1,25,25
1683291883571,LATI 10,A01,202853,Kennemore; Amy Michelle,5,0,35,30
1683291883571,LATI 10,A02,202854,Kennemore; Amy Michelle,1,0,35,34
1683291883571,LATI 10,A03,270054,Kennemore; Amy Michelle,30,0,30,0
1683291884595,LATI 180,A00,202855,Kennemore; Amy Michelle,11,0,20,9
1683291885620,LAWS 101,A00,201767,Golan; Tal,0,7,40,40
1683291886646,LIFR 1C,A00,185961,Staff,6,0,20,14
1683291887673,LIFR 1CX,A00,185962,Staff,7,0,20,13
1683291888696,LIFR 1D,A00,185963,Staff,9,0,20,11
1683291889721,LIFR 1DX,A00,185964,Staff,9,0,20,11
1683291890746,LIGN 101,A01,186039,Staff,43,0,50,7
1683291891774,LIGN 165,A00,186040,Staff,18,0,50,32
1683291892802,LTCS 108,A00,186041,Staff,6,0,10,4
1683291893830,LTCS 119,A00,186042,Staff,16,0,20,4
1683291894860,LTCS 130,A00,186043,Wesling; Megan E.,15,0,25,10
1683291896918,LTEA 138,A00,186119,Staff,14,0,40,26
1683291897942,LTEN 124,A00,186148,Staff,6,0,25,19
1683291898971,LTEN 178,A00,186149,Staff,7,0,15,8
1683291899997,LTEN 181,A00,186150,Blanco; John D,33,0,40,7
1683291901024,LTWL 120,A00,186160,Staff,20,0,25,5
1683291902049,LTWL 165,A00,186161,Staff,22,0,25,3
1683291903080,LTWR 100,A00,186162,Staff,0,4,15,15
1683291904114,LTWR 102,A00,186163,Doller; Ben,5,0,15,10
1683291905140,MAE 8,A01,186412,Staff,0,0,0,0
1683291906165,MAE 30B,A00,186445,Bahadori; Mohammad Yousef,83,0,100,17
1683291907189,MAE 40,A00,186592,Bewley; Thomas R,9,0,50,41
1683291908213,MAE 101B,A00,186593,Bahadori; Mohammad Yousef,81,0,100,19
1683291909240,MAE 105,A00,186594,Bandaru; Prabhakar,12,0,50,38
1683291910270,MAE 107,A00,186599,Pham; Hieu Tan,0,6,120,120
1683291911297,MAE 148,A01,186660,Silberman; Jack,3,0,16,13
1683291912323,MATH 10A,A01,188095,Staff,0,7,35,35
1683291913350,MATH 10B,A01,188097,Bowers; Adam R.,0,11,30,30
1683291913350,MATH 10B,A02,188099,Bowers; Adam R.,0,9,30,30
1683291913350,MATH 10B,B01,188104,Bowers; Adam R.,0,11,30,30
1683291913350,MATH 10B,B02,188106,Bowers; Adam R.,0,11,30,30
1683291914381,MATH 10C,A01,188111,Staff,0,18,30,30
1683291914381,MATH 10C,A02,188127,Staff,0,17,30,30
1683291914381,MATH 10C,A03,188131,Staff,0,17,30,30
1683291914381,MATH 10C,B01,188218,Staff,21,0,30,9
1683291914381,MATH 10C,B02,188244,Staff,13,0,30,17
1683291914381,MATH 10C,B03,188277,Staff,16,0,30,14
1683291915407,MATH 18,A01,188344,Bach; Quang Tran,18,0,30,12
1683291915407,MATH 18,A02,188345,Bach; Quang Tran,11,0,30,19
1683291915407,MATH 18,B01,188353,Bach; Quang Tran,10,0,30,20
1683291915407,MATH 18,B02,188354,Bach; Quang Tran,20,0,30,10
1683291916432,MATH 20A,A01,188374,Staff,13,0,35,22
1683291917458,MATH 20B,A01,188382,Ohm; Ko Woon,6,0,30,24
1683291917458,MATH 20B,A02,188383,Ohm; Ko Woon,24,0,30,6
1683291917458,MATH 20B,B01,188385,Ohm; Ko Woon,7,0,30,23
1683291917458,MATH 20B,B02,188392,Ohm; Ko Woon,22,0,30,8
1683291918484,MATH 20C,A01,188394,Harel; Guershon,10,0,30,20
1683291918484,MATH 20C,A02,188395,Harel; Guershon,13,0,30,17
1683291918484,MATH 20C,B01,188404,Harel; Guershon,3,0,30,27
1683291918484,MATH 20C,B02,188405,Harel; Guershon,19,0,30,11
1683291919511,MATH 20D,A01,188414,Hammock; Frances H,0,1,30,30
1683291919511,MATH 20D,A02,188415,Hammock; Frances H,4,0,30,26
1683291919511,MATH 20D,B01,188447,Hammock; Frances H,2,0,30,28
1683291919511,MATH 20D,B02,188486,Hammock; Frances H,8,0,30,22
1683291920540,MATH 20E,A01,188649,Staff,22,0,30,8
1683291920540,MATH 20E,A02,188650,Staff,23,0,30,7
1683291920540,MATH 20E,A03,188673,Staff,0,0,30,30
1683291921569,MATH 102,A01,188675,Staff,0,35,35,35
1683291922598,MATH 103B,A01,188681,Staff,4,0,35,31
1683291922598,MATH 103B,B01,188692,Staff,8,0,35,27
1683291923624,MATH 109,A01,188695,Salehi Golsefidy; Alireza,25,0,35,10
1683291923624,MATH 109,A02,188696,Salehi Golsefidy; Alireza,27,0,35,8
1683291924654,MATH 120A,A01,188698,Eggers; John Dietrich,5,0,35,30
1683291925685,MATH 142B,A01,188736,Ioana; Adrian,0,2,30,30
1683291925685,MATH 142B,A02,188741,Ioana; Adrian,0,1,30,30
1683291925685,MATH 142B,A03,188743,Ioana; Adrian,0,3,30,30
1683291926714,MATH 168A,A01,188790,Staff,0,8,35,35
1683291927740,MATH 170A,A01,188803,Nie; Jiawang,0,2,35,35
1683291927740,MATH 170A,A02,188811,Nie; Jiawang,0,0,35,35
1683291927740,MATH 170A,A03,188814,Nie; Jiawang,1,0,35,34
1683291927740,MATH 170A,A04,188815,Nie; Jiawang,14,0,35,21
1683291928765,MATH 193B,A01,188817,Staff,0,0,35,35
1683291928765,MATH 193B,A02,188818,Staff,5,0,35,30
1683291929790,MGT 4,A01,202857,Anderson; John Charles,62,0,80,18
1683291930816,MGT 12,A00,202858,Lindenberger; Wade Douglas,43,0,90,47
1683291931841,MGT 18,A00,202859,Staff,74,0,90,16
1683291932867,MGT 18GS,A00,202860,McKay; Michael J,13,0,28,15
1683291933898,MGT 45,A00,202861,Pecore; Joseph P.,14,0,90,76
1683291934924,MGT 100,A00,202863,Yavorsky; Daniel Ryan,28,0,90,62
1683291935953,MGT 103,A00,202864,Ehrich; Kristine R,0,16,90,90
1683291936981,MGT 112,A00,202865,Ehrich; Kristine R,15,0,90,75
1683291938012,MGT 121A,A00,202868,Staff,0,19,0,0
1683291939038,MGT 131B,A00,202869,Anderson; John Charles,59,0,90,31
1683291940064,MGT 136,A00,202871,Lindenberger; Wade Douglas,84,0,90,6
1683291941089,MGT 164,A00,202873,Staff,0,69,90,90
1683291942115,MGT 164GS,A00,202874,McKay; Mary A,13,0,28,15
1683291943141,MGT 180,A00,202875,Staff,0,51,90,90
1683291944166,MMW 11R,A01,205019,Herbst; Matthew,3,0,30,27
1683291944166,MMW 11R,A02,205026,Herbst; Matthew,29,0,30,1
1683291945192,MMW 15,A01,193512,Chang; Edmond Yi-Teh,0,9,28,28
1683291945192,MMW 15,A02,193513,Chang; Edmond Yi-Teh,0,5,28,28
1683291945192,MMW 15,A03,193514,Chang; Edmond Yi-Teh,0,5,28,28
1683291945192,MMW 15,A04,193515,Chang; Edmond Yi-Teh,0,4,28,28
1683291945192,MMW 15,A05,193516,Chang; Edmond Yi-Teh,0,4,28,28
1683291945192,MMW 15,A06,193517,Chang; Edmond Yi-Teh,0,5,28,28
1683291945192,MMW 15,B01,193519,Chang; Edmond Yi-Teh,0,4,28,28
1683291945192,MMW 15,B02,193520,Chang; Edmond Yi-Teh,0,5,28,28
1683291945192,MMW 15,B03,193521,Chang; Edmond Yi-Teh,0,4,28,28
1683291945192,MMW 15,B04,193522,Chang; Edmond Yi-Teh,0,4,28,28
1683291945192,MMW 15,B05,193523,Chang; Edmond Yi-Teh,0,5,28,28
1683291945192,MMW 15,B06,193524,Chang; Edmond Yi-Teh,0,4,28,28
1683291946219,MMW 122,A01,193526,Rahimi; Babak,0,14,28,28
1683291946219,MMW 122,A02,193527,Rahimi; Babak,0,14,28,28
1683291946219,MMW 122,A03,193528,Rahimi; Babak,0,0,0,0
1683291946219,MMW 122,A04,193529,Rahimi; Babak,0,0,0,0
1683291947243,MUS 1A,A01,186663,Staff,0,20,35,35
1683291948271,MUS 4,A01,186715,Staff,0,12,35,35
1683291949299,MUS 5R,A01,186796,Dubnov; Shlomo,0,16,35,35
1683291950328,MUS 6,A01,186798,Staff,0,3,25,25
1683291951352,MUS 7,A01,186830,Staff,12,0,35,23
1683291952382,MUS 8,A01,186930,Staff,0,25,35,35
1683291953406,MUS 15,A01,186932,Staff,0,15,35,35
1683291953406,MUS 15,B01,186934,Staff,0,14,35,35
1683291954433,MUS 80,A00,186935,Staff,2,0,20,18
1683291954433,MUS 80,B00,186936,Staff,25,0,25,0
1683291955460,NANO 11,A00,204702,Lipomi; Darren John,0,0,0,0
1683291956485,NANO 15,A01,204709,Yang; Kesong,0,1,0,0
1683291957510,NANO 114,A00,202069,Jahed Motlagh; Zeinab,3,0,10,7
1683291958541,PHIL 1,A00,186955,Grush; Rick Scott,32,0,40,8
1683291959568,PHIL 10,A01,186973,Grush; Rick Scott,29,0,35,6
1683291959568,PHIL 10,A02,186974,Grush; Rick Scott,33,0,35,2
1683291960594,PHIL 13,A01,186976,Staff,7,0,35,28
1683291960594,PHIL 13,A02,186977,Staff,16,0,35,19
1683291961621,PHIL 14,A01,186979,Staff,31,0,35,4
1683291961621,PHIL 14,A02,186986,Staff,32,0,35,3
1683291962646,PHIL 28,A01,186988,Staff,16,0,30,14
1683291962646,PHIL 28,A02,186989,Staff,1,0,30,29
1683291962646,PHIL 28,A03,186990,Staff,9,0,30,21
1683291962646,PHIL 28,A04,186991,Staff,26,0,30,4
1683291963675,PHIL 120,A00,186997,Staff,23,0,40,17
1683291964703,PHIL 137,A00,187003,Staff,9,0,40,31
1683291965731,PHIL 150,A00,187015,Staff,47,0,70,23
1683291966758,PHIL 167,A00,187021,Lamey; Andy M.,35,0,40,5
1683291967784,PHIL 174,A01,202226,Staff,17,0,20,3
1683291967784,PHIL 174,A02,202235,Staff,20,0,20,0
1683291968808,PHIL 191A,A00,258918,Staff,0,0,1,1
1683291969834,PHYS 1A,A00,187028,Staff,26,0,60,34
1683291970859,PHYS 1AL,001,187036,Staff,2,0,30,28
1683291970859,PHYS 1AL,002,187049,Staff,18,0,30,12
1683291971887,PHYS 1B,A00,187058,Staff,23,0,60,37
1683291972915,PHYS 1BL,001,187064,Staff,0,0,30,30
1683291972915,PHYS 1BL,002,187070,Staff,6,0,30,24
1683291973943,PHYS 1C,A00,187082,Staff,32,0,120,88
1683291974969,PHYS 1CL,001,187088,Staff,0,9,30,30
1683291974969,PHYS 1CL,002,187089,Staff,0,2,30,30
1683291974969,PHYS 1CL,009,262693,Staff,12,0,30,18
1683291975995,PHYS 2B,A01,187097,Staff,54,0,115,61
1683291977021,PHYS 2C,A01,187099,Staff,67,0,115,48
1683291978046,PHYS 2CL,A01,187101,Staff,5,0,28,23
1683291978046,PHYS 2CL,A02,187102,Staff,15,0,28,13
1683291979072,PHYS 2D,A01,187123,Shotwell; Brian,95,0,115,20
1683291980102,PHYS 4B,A01,187133,Grinstein; Benjamin,35,0,50,15
1683291981184,POLI 10,A00,188819,Staff,0,3,50,50
1683291982217,POLI 11,A00,188827,Staff,43,0,50,7
1683291983249,POLI 13R,A00,188828,Staff,0,1,20,20
1683291984282,POLI 27,A01,188830,Elgin; Samuel Zincke,0,1,70,70
1683291985308,POLI 30,A00,188832,Desposato; Scott,33,0,50,17
1683291986341,POLI 102F,A00,188834,Staff,3,0,40,37
1683291987369,POLI 104A,A00,188852,Staff,14,0,30,16
1683291988392,POLI 104I,A00,188853,Staff,0,6,20,20
1683291989423,POLI 110B,A00,188854,Wiens; David,7,0,20,13
1683291990447,POLI 112A,A00,188855,Wiens; David,5,0,30,25
1683291991472,POLI 117R,A00,188856,Forman; Fonna,0,11,20,20
1683291992501,POLI 118,A00,188857,Ingham; Sean,8,0,20,12
1683291993529,POLI 120G,A00,188858,Staff,9,0,30,21
1683291994557,POLI 131CR,A00,188863,Hoston; Germaine,24,0,50,26
1683291995582,POLI 133,A00,188864,Nellis; Gareth Hb,44,0,50,6
1683291996607,POLI 134D,A00,188865,Desposato; Scott,27,0,30,3
1683291997632,POLI 142A,A00,188871,Gartzke; Erik,22,0,50,28
1683291998656,POLI 142K,A00,188874,Staff,38,0,50,12
1683291999681,POLI 143,A00,188940,Gartzke; Erik,16,0,30,14
1683292000709,POLI 153,A00,188943,Staff,3,0,20,17
1683292001736,POLI 160AA,A00,188944,Staff,13,0,40,27
1683292002764,POLI 170A,A00,188945,Staff,11,0,30,19
1683292004821,PSYC 1,A00,188952,Staff,38,0,90,52
1683292005846,PSYC 2,B00,188953,Staff,20,0,35,15
1683292006876,PSYC 6,A00,188970,Staff,47,0,60,13
1683292007901,PSYC 7,A00,188973,Staff,37,0,45,8
1683292008928,PSYC 60,A01,188980,Rickard; Timothy C.,43,0,60,17
1683292009954,PSYC 70,A01,189001,Steiner; Eric Tomas,24,0,45,21
1683292010979,PSYC 100,A00,189005,Lacefield; Katharine I,0,99,120,120
1683292012005,PSYC 102,A00,189008,Staff,10,0,30,20
1683292013035,PSYC 106,B00,189026,Gorman; Michael R.,37,0,60,23
1683292014065,PSYC 114,B01,189033,Winkielman; Piotr,0,32,30,30
1683292015093,PSYC 131,A00,189036,Anagnostaras; Stephan,0,43,60,60
1683292016117,PSYC 136,A00,189041,Lowe; Angela Beth,0,7,25,25
1683292017141,PSYC 137,A00,189057,Winkielman; Piotr,0,34,25,25
1683292018170,PSYC 144,A00,189107,Wixted; John T,0,7,50,50
1683292020219,PSYC 162,A00,189142,Staff,0,8,85,85
1683292021245,PSYC 172,A00,189144,Gorman; Michael R.,0,7,30,30
1683292023299,PSYC 179,A00,189146,Lacefield; Katharine I,0,84,120,120
1683292024328,PSYC 181,A00,189147,Anagnostaras; Stephan,0,44,90,90
1683292025356,PSYC 190R,A00,189148,Barner; David A.,0,22,80,80
1683292026381,PSYC 191,A00,189275,Rickard; Timothy C.,0,7,25,25
1683292027405,PSYC 193,A00,189276,Chapman; Eddie Nathaniel,0,1,0,4
1683292028431,PSYC 193L,A01,189281,Lowe; Angela Beth,12,0,20,8
1683292028431,PSYC 193L,B01,189285,Staff,28,0,35,7
1683292029460,RELI 149,A00,187137,Rahimi; Babak,7,0,40,33
1683292030490,SE 9,A01,187315,Staff,0,2,18,18
1683292031514,SE 101B,A00,187409,Staff,24,0,30,6
1683292032539,SE 110B,A00,187444,Staff,10,0,40,30
1683292033566,SE 130B,A00,187449,Staff,31,0,40,9
1683292034609,SE 150A,A00,187516,Staff,9,0,20,11
1683292035634,SE 154,A00,187528,Staff,30,0,50,20
1683292036670,SIO 3,A01,258171,Staff,35,0,40,5
1683292037698,SIO 10,A00,187144,Cook; Geoffrey W,0,3,75,75
1683292038723,SIO 45,A00,187152,Cook; Geoffrey W,1,0,100,99
1683292039748,SIO 109R,A00,194486,Staff,0,3,20,20
1683292041807,SIO 187,A01,187233,Kacev; David,12,0,40,28
1683292042833,SOCI 1,A01,258656,Thorpe; Charles Robert,28,0,30,2
1683292042833,SOCI 1,A02,258658,Thorpe; Charles Robert,30,0,30,0
1683292042833,SOCI 1,A03,258661,Thorpe; Charles Robert,25,0,25,0
1683292042833,SOCI 1,A04,258666,Thorpe; Charles Robert,22,0,25,3
1683292042833,SOCI 1,A05,258897,Thorpe; Charles Robert,23,0,25,2
1683292042833,SOCI 1,A06,258898,Thorpe; Charles Robert,25,0,25,0
1683292043864,SOCI 30,A01,258903,Pardo Guerra; Juan Pablo,16,0,30,14
1683292044890,SOCI 102,A00,258904,Staff,9,0,25,16
1683292045916,SOCI 106,A00,258905,Staff,19,0,25,6
1683292046941,SOCI 111,A00,258907,Ribas Norris; Janet Vanesa,26,0,30,4
1683292047966,SOCI 121R,A00,258908,Pardo Guerra; Juan Pablo,11,0,30,19
1683292048995,SOCI 126,A01,203330,Staff,14,0,20,6
1683292050022,SOCI 131,A00,258909,Thorpe; Charles Robert,31,0,60,29
1683292051052,SOCI 135,A00,258910,Payne; Christine Anna,0,9,30,30
1683292052077,SOCI 157,A00,258911,Staff,13,0,30,17
1683292053101,SOCI 184,A00,258912,Staff,26,0,30,4
1683292054126,SOCI 188D,A00,258913,Staff,21,0,30,9
1683292055151,SYN 2,001,187529,Staff,9,0,16,7
1683292055151,SYN 2,002,201452,Staff,0,18,16,16
1683292055151,SYN 2,003,201469,Staff,3,0,16,13
1683292056178,SYN 100,A01,187531,Staff,0,9,20,20
1683292056178,SYN 100,B01,201491,Staff,0,12,20,20
1683292057207,TDAC 1,A00,189286,Walsh; Kim C.,3,0,20,17
1683292057207,TDAC 1,B00,189287,Harting; Carla Kelso,11,0,20,9
1683292058237,TDAC 101,A00,189300,Walsh; Kim C.,16,0,20,4
1683292058237,TDAC 101,B00,189301,Harting; Carla Kelso,18,0,20,2
1683292059262,TDAC 102,A00,189304,Basso; Beatrice,14,0,20,6
1683292060291,TDAC 108,A00,189305,Staff,18,0,20,2
1683292061324,TDDE 131,A00,189310,Staff,19,0,20,1
1683292061324,TDDE 131,B00,189314,Staff,19,0,20,1
1683292061324,TDDE 131,C00,189315,Staff,48,0,50,2
1683292061324,TDDE 131,D00,189316,Staff,14,0,15,1
1683292061324,TDDE 131,E00,204841,Staff,20,0,20,0
1683292062352,TDGE 10,A00,189289,Staff,30,0,50,20
1683292062352,TDGE 10,B00,189290,Havis; Allan,2,0,50,48
1683292063381,TDGE 11,A00,189291,Fulton; Julia,0,3,50,50
1683292063381,TDGE 11,B00,189292,Staff,20,0,25,5
1683292063381,TDGE 11,C00,260270,Staff,0,0,0,0
1683292064409,TDGE 25,A00,189294,Staff,3,0,20,17
1683292065433,TDGE 124,A00,189318,Fulton; Julia,0,8,50,50
1683292066458,TDGE 125,A00,189319,Staff,13,0,25,12
1683292066458,TDGE 125,B00,189320,Staff,23,0,25,2
1683292067483,TDGE 127,A00,189322,Havis; Allan,0,0,50,50
1683292068509,TDHT 101,A00,189323,Staff,18,0,25,7
1683292068509,TDHT 101,B00,189324,Staff,25,0,25,0
1683292069534,TDHT 102,A00,189325,Staff,49,0,50,1
1683292070566,TDMV 1,A00,189295,Arcidiacono; Kristin,20,0,30,10
1683292070566,TDMV 1,B00,189296,Caligagan; Maria T.,24,0,30,6
1683292071595,TDMV 2,A00,189297,Sammartano; Tonnie,28,0,30,2
1683292071595,TDMV 2,B00,189299,Arcidiacono; Kristin,24,0,30,6
1683292072621,TDMV 3,A00,204998,Rincon; Alicia,22,0,30,8
1683292073649,TDMV 120,A00,189458,Sammartano; Tonnie,28,0,30,2
1683292074674,TDMV 138,A00,189541,Jun; Grace Shin Hae,22,0,40,18
1683292075702,TDMV 142,A00,189717,Caligagan; Tony,23,0,30,7
1683292075702,TDMV 142,B00,189718,Caligagan; Maria T.,25,0,30,5
1683292076732,TMC 2,A01,187533,Staff,25,0,25,0
1683292076732,TMC 2,A02,187534,Staff,25,0,25,0
1683292077759,USP 1,A01,187536,Kwak; Nancy,0,16,25,25
1683292078788,USP 5,A01,187538,Staff,9,0,25,16
1683292079817,USP 101,A00,199253,Staff,0,4,0,0
1683292080847,USP 124,A00,187562,Boomhower; Matthew Charles,1,0,30,29
1683292081874,USP 138,A00,187582,Staff,20,0,25,5
1683292082901,USP 152,A01,187597,Staff,4,0,25,21
1683292083926,USP 153,A00,187598,Staff,19,0,25,6
1683292085008,USP 168,A00,187607,Kwak; Nancy,2,0,5,3
1683292086034,USP 173,A00,187619,Staff,4,0,25,21
1683292087058,USP 181,A00,187638,Staff,0,0,25,25
1683292088082,VIS 103,A00,187650,Cruz; Edwin Teddy,23,0,75,52
1683292089108,VIS 110D,A00,187669,Staff,12,0,22,10
1683292090133,VIS 127C,A00,187720,Shen; Kuiyi,68,0,146,78
1683292091161,VIS 149,A00,187731,Yoldas; Pinar,0,14,22,22
1683292092189,VIS 151,A01,188091,Staff,22,0,34,12
1683292092189,VIS 151,A02,188092,Staff,11,0,34,23
1683292093217,VIS 160B,A00,188093,Stalbaum; Brett,0,0,10,10
1683292095268,WCWP 10B,A00,201720,Staff,10,0,15,5
1683292095268,WCWP 10B,B00,201722,Staff,8,0,15,7
1683292096297,WCWP 100,A00,201725,Gagnon; Jeffrey C,0,0,2,2
1683292096297,WCWP 100,B00,201727,Staff,0,4,15,15
1683292099395,ANBI 133,A00,258401,Wilder; Linnea Lorene,34,0,40,6
1683292100419,ANBI 140,A00,258395,Hrvoj Mihic; Branka,18,0,25,7
1683292101446,ANSC 120,A00,258402,Bialecki; Jon Anthony,27,0,40,13
1683292102472,ANSC 144,A00,258400,Staff,14,0,40,26
1683292104526,ANSC 166,A00,258396,Parish; Steven Martin,157,0,175,18
1683292105551,ANSC 180,A00,193533,Staff,9,0,20,11
1683292106577,ANSC 188,A00,258397,Jassal; Aftab,33,0,40,7
1683292107605,ANTH 3,A01,258316,Staff,23,0,30,7
1683292108630,ANTH 5,A00,258394,Semendeferi; Ekaterini,16,0,20,4
1683292109654,ANTH 21,A01,258331,Staff,9,0,40,31
1683292110679,ANTH 103,A00,258398,Varma; Saiba,15,0,25,10
1683292111708,AWP 10,001,202034,Staff,0,0,0,0
1683292111708,AWP 10,002,202035,Staff,0,0,0,0
1683292111708,AWP 10,003,202036,Staff,0,0,0,0
1683292111708,AWP 10,004,202037,Staff,0,0,0,0
1683292111708,AWP 10,005,202038,Staff,0,0,0,0
1683292111708,AWP 10,006,202039,Staff,0,0,0,0
1683292111708,AWP 10,007,202040,Staff,0,0,0,0
1683292111708,AWP 10,008,202041,Staff,0,0,0,0
1683292111708,AWP 10,009,202042,Staff,0,0,0,0
1683292111708,AWP 10,010,202043,Staff,0,0,0,0
1683292111708,AWP 10,011,202044,Staff,0,0,0,0
1683292111708,AWP 10,012,202045,Staff,0,0,0,0
1683292111708,AWP 10,013,202046,Staff,0,0,0,0
1683292111708,AWP 10,014,202047,Staff,0,0,0,0
1683292111708,AWP 10,015,202048,Staff,0,0,0,0
1683292111708,AWP 10,016,202049,Staff,0,0,0,0
1683292111708,AWP 10,017,202050,Staff,0,0,0,0
1683292111708,AWP 10,018,202051,Staff,0,0,0,0
1683292111708,AWP 10,019,202052,Staff,0,0,0,0
1683292111708,AWP 10,020,202053,Staff,0,0,0,0
1683292111708,AWP 10,021,202054,Staff,0,0,0,0
1683292111708,AWP 10,022,202055,Staff,0,0,0,0
1683292111708,AWP 10,023,202056,Staff,0,0,0,0
1683292111708,AWP 10,024,202057,Staff,0,0,0,0
1683292111708,AWP 10,025,202058,Staff,0,0,0,0
1683292111708,AWP 10,026,202059,Staff,0,0,0,0
1683292112736,AWP 102,001,202032,Staff,0,0,0,0
1683292112736,AWP 102,002,202033,Staff,0,0,0,0
1683292113765,BENG 100,A01,254234,Taylor Amos; Alyssa C,31,0,40,9
1683292114790,BENG 196,001,270013,Engler; Adam J.,9999,0,9999,0
1683292115817,BICD 100R,A01,202018,Smith; Laurie,0,7,32,32
1683292115817,BICD 100R,A02,202019,Smith; Laurie,0,2,32,32
1683292115817,BICD 100R,A03,202020,Smith; Laurie,0,1,32,32
1683292115817,BICD 100R,A04,202021,Smith; Laurie,8,0,32,24
1683292115817,BICD 100R,A05,202022,Smith; Laurie,12,0,32,20
1683292116843,BICD 136,A01,193242,Gustafson-Brown; Cindy,0,2,32,32
1683292116843,BICD 136,A02,193244,Gustafson-Brown; Cindy,15,0,32,17
1683292117870,BIEB 102,A01,193249,Butler; Shannon Rhey,0,2,32,32
1683292117870,BIEB 102,A02,193251,Butler; Shannon Rhey,0,0,32,32
1683292117870,BIEB 102,A03,193253,Butler; Shannon Rhey,0,1,32,32
1683292117870,BIEB 102,A04,193255,Butler; Shannon Rhey,17,0,32,15
1683292117870,BIEB 102,A05,193265,Butler; Shannon Rhey,26,0,32,6
1683292117870,BIEB 102,A06,193269,Butler; Shannon Rhey,16,0,32,16
1683292119925,BIEB 150,A01,193274,Staff,0,0,32,32
1683292119925,BIEB 150,A02,193285,Staff,24,0,32,8
1683292120949,BIEB 194,A00,193286,Kurle; Carolyn M.,22,0,32,10
1683292121978,BILD 1,A01,192291,Staff,16,0,32,16
1683292121978,BILD 1,A02,192292,Staff,30,0,32,2
1683292121978,BILD 1,B01,192520,Reuther; Keefe,0,1,0,0
1683292121978,BILD 1,B02,192532,Reuther; Keefe,0,1,0,0
1683292123004,BILD 3,A01,192556,Butler; Shannon Rhey,0,0,32,32
1683292123004,BILD 3,A02,192581,Butler; Shannon Rhey,5,0,32,27
1683292123004,BILD 3,A03,192611,Butler; Shannon Rhey,23,0,32,9
1683292123004,BILD 3,A04,192612,Butler; Shannon Rhey,25,0,32,7
1683292123004,BILD 3,A05,192613,Butler; Shannon Rhey,27,0,32,5
1683292123004,BILD 3,A06,192679,Butler; Shannon Rhey,27,0,32,5
1683292123004,BILD 3,A07,192682,Butler; Shannon Rhey,22,0,32,10
1683292124031,BILD 4,A01,192836,Reuther; Keefe,1,0,24,23
1683292124031,BILD 4,A02,193044,Reuther; Keefe,4,0,24,20
1683292125057,BILD 10,A01,193142,Gustafson-Brown; Cindy,31,0,32,1
1683292125057,BILD 10,A02,193149,Gustafson-Brown; Cindy,31,0,32,1
1683292126083,BIMM 100,A01,193301,Staff,0,6,32,32
1683292126083,BIMM 100,A02,193312,Staff,0,5,32,32
1683292126083,BIMM 100,A03,193323,Staff,0,8,32,32
1683292127108,BIMM 101,A01,193329,McDonnell; Lisa Marie,0,3,24,24
1683292127108,BIMM 101,A02,193339,McDonnell; Lisa Marie,0,2,24,24
1683292127108,BIMM 101,B01,193354,McDonnell; Lisa Marie,0,3,24,24
1683292127108,BIMM 101,B02,193357,McDonnell; Lisa Marie,0,3,24,24
1683292128133,BIMM 110,A01,193377,Tat; John,0,11,32,32
1683292128133,BIMM 110,A02,193378,Tat; John,1,9,32,31
1683292129166,BIMM 120,A01,206116,Staff,0,0,32,32
1683292129166,BIMM 120,A02,206117,Staff,8,0,32,24
1683292129166,BIMM 120,A03,206121,Staff,21,0,32,11
1683292130199,BIPN 100,A01,193393,Park; Ji Young,0,14,32,32
1683292130199,BIPN 100,A02,193402,Park; Ji Young,0,12,32,32
1683292130199,BIPN 100,A03,193413,Park; Ji Young,0,14,32,32
1683292130199,BIPN 100,A04,193414,Park; Ji Young,0,13,32,32
1683292131228,BIPN 102,A01,193429,Staff,0,0,32,32
1683292131228,BIPN 102,A02,193438,Staff,23,0,32,9
1683292132258,BIPN 106,A01,193450,Reyes Gonzalez; Catalina,0,2,40,40
1683292133287,BIPN 134,A01,193465,Cooke; James Edward,0,0,32,32
1683292133287,BIPN 134,A02,193474,Cooke; James Edward,27,0,32,5
1683292133287,BIPN 134,A03,193485,Cooke; James Edward,29,0,32,3
1683292133287,BIPN 134,A04,193486,Cooke; James Edward,21,0,32,11
1683292133287,BIPN 134,A05,193491,Cooke; James Edward,31,0,32,1
1683292133287,BIPN 134,A06,193501,Cooke; James Edward,30,0,32,2
1683292133287,BIPN 134,A07,193510,Cooke; James Edward,29,0,32,3
1683292135341,BISP 194,A00,222522,Staff,16,0,32,16
1683292136366,CAT 124,A01,202407,Staff,20,0,25,5
1683292137391,CAT 125,A00,202408,Marchisotto; Jennifer Anne,4,0,20,16
1683292138417,CAT 125R,A00,202409,Smith; Lauryn Alissa,0,11,20,20
1683292138417,CAT 125R,B00,202410,Morales; Celeste Georgianna,0,11,20,20
1683292138417,CAT 125R,C00,202411,Irwin; Matthew Joseph,0,10,20,20
1683292139440,CENG 15,A01,204712,Yang; Kesong,0,1,0,0
1683292140465,CENG 114,A00,202070,Jahed Motlagh; Zeinab,5,0,20,15
1683292141495,CGS 105,A00,185477,Wesling; Megan E.,24,0,40,16
1683292142524,CGS 106,A00,185494,Staff,13,0,22,9
1683292143553,CGS 108,A00,185495,Staff,14,0,20,6
1683292144579,CGS 114,A00,185496,Staff,13,0,18,5
1683292145605,CGS 119,A00,185501,Staff,15,0,20,5
1683292146667,CGS 120,A00,185511,Staff,13,0,20,7
1683292147697,CHEM 4,A01,184675,Bussey; Thomas J,96,0,100,4
1683292148724,CHEM 6A,A01,184677,Staff,35,0,60,25
1683292149757,CHEM 6B,A01,184679,Staff,65,0,100,35
1683292150788,CHEM 6C,A01,184681,Bussey; Thomas J,1,0,50,49
1683292150788,CHEM 6C,A02,184682,Bussey; Thomas J,34,0,50,16
1683292151819,CHEM 40A,A01,184684,Albizati; Kim F.,37,0,100,63
1683292152845,CHEM 40B,A01,184686,Albizati; Kim F.,0,20,100,100
1683292153872,CHEM 41B,A01,184690,Staff,52,0,100,48
1683292154899,COGS 3,A01,184715,Boyle; Mary E. T.,0,25,40,40
1683292155929,COGS 14B,A01,185172,Staff,0,15,38,38
1683292156957,COGS 18,A01,184736,Staff,20,0,80,60
1683292157985,COGS 100,A01,184932,Staff,0,5,73,73
1683292159013,COGS 101A,A01,184935,Staff,0,38,30,30
1683292160042,COGS 101B,A01,184944,Staff,0,2,30,30
1683292161072,COGS 101C,A01,184946,Staff,0,12,30,30
1683292162098,COGS 102A,A01,184951,Johnson; Christine M.,2,0,40,38
1683292163124,COGS 107B,A01,184953,Mooshagian; Eric Frederick,0,50,40,40
1683292164154,COGS 118B,A01,184959,Gupta; Anjum,0,48,40,40
1683292165180,COGS 153,A00,184961,Staff,0,15,30,30
1683292166204,COGS 177,A00,184962,Staff,0,21,30,30
1683292167229,COGS 187A,A01,184969,Boyle; Mary E. T.,0,17,40,40
1683292168253,COMM 10,A01,185174,Staff,0,5,25,25
1683292168253,COMM 10,A02,185189,Staff,0,5,25,25
1683292168253,COMM 10,A03,269821,Staff,0,0,0,0
1683292169280,COMM 100B,A01,185475,Staff,0,0,0,2
1683292169280,COMM 100B,A02,185476,Staff,14,0,25,11
1683292170304,COMM 100C,A01,185314,Staff,1,0,25,24
1683292170304,COMM 100C,A02,185327,Staff,19,0,25,6
1683292171333,COMM 110M,A00,185349,Staff,2,0,40,38
1683292172361,COMM 113T,A00,185352,Staff,25,0,40,15
1683292173387,COMM 114I,A00,185353,Staff,33,0,40,7
1683292174413,COMM 131,A00,185354,Staff,19,0,30,11
1683292175439,CSE 8A,A50,185358,Cao; Yingjun,0,46,10,10
1683292176465,CSE 8B,A01,185362,Staff,0,47,50,50
1683292177490,CSE 11,A01,185416,Cao; Yingjun,0,93,10,10
1683292178516,CSE 20,A01,185445,Briones; Jor-el Thomas Caparas,5,0,25,20
1683292179541,CSE 21,A01,185447,Staff,10,0,50,40
1683292180572,CSE 101,A01,185451,Staff,0,12,50,50
1683292180572,CSE 101,B01,185453,Jones; Miles E,0,11,50,50
1683292182631,CSE 141,A01,185458,Eldon; John,20,0,100,80
1683292183659,CSE 141L,A01,185461,Eldon; John,12,0,100,88
1683292184688,CSE 142,A01,185463,Staff,35,0,60,25
1683292184688,CSE 142,B01,201355,Staff,0,6,60,60
1683292185716,CSE 142L,A01,185470,Staff,35,0,60,25
1683292185716,CSE 142L,B01,201417,Staff,0,5,60,60
1683292186741,CSE 190,A00,201433,Staff,32,0,49,17
1683292187768,DOC 1,A01,259136,Strom; Megan C.,8,0,15,7
1683292187768,DOC 1,A02,259137,Strom; Megan C.,14,0,15,1
1683292187768,DOC 1,A03,259138,Strom; Megan C.,14,0,15,1
1683292187768,DOC 1,A04,259139,Strom; Megan C.,14,0,15,1
1683292188852,DOC 100D,A00,259140,Pass; Natalye Joann,17,0,25,8
1683292189877,DSGN 1,A01,184749,Rill; Bryan,0,24,30,30
1683292190902,DSGN 100,A01,185168,Staff,0,2,25,25
1683292191933,ECE 5,A01,185626,Morris; Karcher William,0,10,0,0
1683292192961,ECE 101,A01,185628,Staff,17,0,70,53
1683292193991,ECE 107,A01,185635,Baghdadchi; Saharnaz,0,0,20,20
1683292193991,ECE 107,A02,185638,Baghdadchi; Saharnaz,4,0,20,16
1683292195022,ECE 148,A01,185647,Silberman; Jack,1,0,16,15
1683292196048,ECON 1,A01,185537,Crane; Meredith Helen,54,0,70,16
1683292197075,ECON 3,A01,185549,Crane; Meredith Helen,33,0,70,37
1683292198103,ECON 4,A01,203354,Anderson; John Charles,0,4,10,10
1683292199128,ECON 100A,A01,185574,Staff,0,4,40,40
1683292200154,ECON 100B,A01,185576,Staff,0,22,40,40
1683292201178,ECON 100C,A01,185589,Newhouse; Herbert S,30,0,70,40
1683292202207,ECON 105,A00,185608,Vespa; Emanuel Ignacio,19,0,35,16
1683292203232,ECON 109,A01,185610,Shishkin; Denis,10,0,35,25
1683292204260,ECON 110A,A01,185612,Staff,11,0,40,29
1683292205287,ECON 120A,A01,185615,Staff,20,0,40,20
1683292206317,ECON 120C,A01,185617,Sun; Yixiao,0,20,70,70
1683292207343,ECON 144,A00,203346,Squires; Dale E,3,0,35,32
1683292208368,ECON 171,A01,203349,Newhouse; Herbert S,0,1,35,35
1683292209394,ECON 173A,A01,185621,Toda; Alexis Akira,21,0,35,14
1683292210423,EDS 25,A01,202413,Staff,0,1,0,0
1683292210423,EDS 25,A02,202414,Staff,0,1,0,0
1683292210423,EDS 25,A03,202415,Staff,0,0,0,0
1683292210423,EDS 25,A04,202416,Staff,0,1,0,0
1683292210423,EDS 25,A05,202439,Staff,0,0,0,0
1683292210423,EDS 25,A06,202440,Staff,0,0,0,0
1683292210423,EDS 25,B01,202631,Staff,0,0,0,0
1683292210423,EDS 25,B02,202632,Staff,0,0,0,0
1683292210423,EDS 25,B03,202639,Staff,0,0,0,0
1683292210423,EDS 25,B04,202640,Staff,0,0,0,0
1683292210423,EDS 25,B05,202643,Staff,0,0,0,0
1683292210423,EDS 25,B06,202644,Staff,0,0,0,0
1683292211447,EDS 38,A01,202659,Black; Alison Michelle,24,0,25,1
1683292212473,EDS 115,A00,202652,Staff,17,0,30,13
1683292213497,EDS 125,A00,202649,Staff,14,0,30,16
1683292214521,EDS 126,A01,203332,Staff,30,0,30,0
1683292215544,EDS 139,A00,202838,Staff,17,0,25,8
1683292216570,EDS 146,A01,202655,Staff,15,0,25,10
1683292217597,ENG 15,A00,185667,Staff,0,1,0,0
1683292217597,ENG 15,B00,185672,Staff,0,0,0,0
1683292217597,ENG 15,C00,185675,Staff,0,0,0,0
1683292217597,ENG 15,D00,185682,Staff,0,0,0,0
1683292217597,ENG 15,E00,185684,Staff,0,0,0,0
1683292218625,ETHN 103,A00,185710,Staff,0,3,35,35
1683292219650,ETHN 103A,A00,199228,Man; Simeon S,3,0,9,6
1683292220675,ETHN 109,A00,185711,Staff,18,0,35,17
1683292221700,ETHN 142,A00,185726,Staff,0,4,30,30
1683292222727,ETHN 163J,A00,199229,Man; Simeon S,6,0,8,2
1683292223757,ETHN 168,A00,185727,Staff,8,0,10,2
1683292224807,ETHN 182,A00,185728,Staff,1,0,35,34
1683292225832,ETHN 183,A00,185737,Staff,8,0,18,10
1683292226857,GLBH 111,A01,209361,Burgos; Jose L.,0,0,0,0
1683292228913,HIEU 104,A00,185792,Staff,16,0,20,4
1683292229942,HIEU 115,A00,185800,Staff,1,0,20,19
1683292230969,HIEU 128,A00,185801,Staff,0,7,20,20
1683292231994,HIEU 147,A00,185802,Staff,16,0,20,4
1683292233019,HIEU 154,A00,185823,Staff,12,0,20,8
1683292234044,HILA 102,A00,185826,Staff,13,0,20,7
1683292235073,HILD 2C,A01,185778,Staff,0,12,20,20
1683292236097,HILD 7B,A01,185780,Kwak; Nancy,0,15,32,32
1683292236097,HILD 7B,A02,185781,Kwak; Nancy,0,18,32,32
1683292237126,HILD 30,A01,185791,Staff,14,0,20,6
1683292238152,HISC 119,A00,185830,Golan; Tal,0,9,20,20
1683292239177,HITO 156GS,A00,185831,Patterson; Patrick H.,0,0,0,23
1683292240201,HIUS 103,A00,185832,Man; Simeon S,0,7,20,20
1683292241230,HIUS 117,A00,185836,Kwak; Nancy,2,0,20,18
1683292242259,HIUS 125,A00,185840,Man; Simeon S,0,0,23,23
1683292243287,HIUS 149,A00,185845,Staff,0,0,20,20
1683292244319,HUM 3,A01,185882,Zavodny; Tatiana Sophia,0,6,50,50
1683292244319,HUM 3,B01,185899,Caldwell; Michael Alan,0,19,50,50
1683292245343,HUM 3GS,A00,185900,Patterson; Patrick H.,0,0,0,23
1683292246370,HUM 4,A01,185938,Zroka; Amy Liane,31,0,50,19
1683292246370,HUM 4,B01,185956,Watkins; Eric,0,2,50,50
1683292246370,HUM 4,B02,202209,Watkins; Eric,0,1,50,50
1683292246370,HUM 4,B03,202210,Watkins; Eric,0,0,50,50
1683292247395,HUM 5,A01,185958,West; Geoffrey Scott,5,0,50,45
1683292247395,HUM 5,A02,202215,West; Geoffrey Scott,0,0,50,50
1683292248421,INTL 190,A00,185959,Gagnon; Jeffrey C,0,0,0,9
1683292248421,INTL 190,B00,185960,Lettieri; Michael Joseph,0,0,0,1
1683292249447,JAPN 180,A00,254509,Staff,0,1,25,25
1683292250479,LATI 10,A01,202853,Kennemore; Amy Michelle,5,0,35,30
1683292250479,LATI 10,A02,202854,Kennemore; Amy Michelle,1,0,35,34
1683292250479,LATI 10,A03,270054,Kennemore; Amy Michelle,30,0,30,0
1683292251506,LATI 180,A00,202855,Kennemore; Amy Michelle,11,0,20,9
1683292252536,LAWS 101,A00,201767,Golan; Tal,0,7,40,40
1683292253562,LIFR 1C,A00,185961,Staff,6,0,20,14
1683292254586,LIFR 1CX,A00,185962,Staff,7,0,20,13
1683292255611,LIFR 1D,A00,185963,Staff,9,0,20,11
1683292256634,LIFR 1DX,A00,185964,Staff,9,0,20,11
1683292257660,LIGN 101,A01,186039,Staff,43,0,50,7
1683292258686,LIGN 165,A00,186040,Staff,18,0,50,32
1683292259710,LTCS 108,A00,186041,Staff,6,0,10,4
1683292260734,LTCS 119,A00,186042,Staff,16,0,20,4
1683292261764,LTCS 130,A00,186043,Wesling; Megan E.,15,0,25,10
1683292263830,LTEA 138,A00,186119,Staff,14,0,40,26
1683292264859,LTEN 124,A00,186148,Staff,6,0,25,19
1683292265888,LTEN 178,A00,186149,Staff,7,0,15,8
1683292266914,LTEN 181,A00,186150,Blanco; John D,33,0,40,7
1683292267940,LTWL 120,A00,186160,Staff,20,0,25,5
1683292268965,LTWL 165,A00,186161,Staff,22,0,25,3
1683292269991,LTWR 100,A00,186162,Staff,0,4,15,15
1683292271017,LTWR 102,A00,186163,Doller; Ben,5,0,15,10
1683292272043,MAE 8,A01,186412,Staff,0,0,0,0
1683292273069,MAE 30B,A00,186445,Bahadori; Mohammad Yousef,83,0,100,17
1683292274094,MAE 40,A00,186592,Bewley; Thomas R,9,0,50,41
1683292275125,MAE 101B,A00,186593,Bahadori; Mohammad Yousef,81,0,100,19
1683292276154,MAE 105,A00,186594,Bandaru; Prabhakar,12,0,50,38
1683292277179,MAE 107,A00,186599,Pham; Hieu Tan,0,6,120,120
1683292278204,MAE 148,A01,186660,Silberman; Jack,3,0,16,13
1683292279230,MATH 10A,A01,188095,Staff,0,7,35,35
1683292280255,MATH 10B,A01,188097,Bowers; Adam R.,0,11,30,30
1683292280255,MATH 10B,A02,188099,Bowers; Adam R.,0,9,30,30
1683292280255,MATH 10B,B01,188104,Bowers; Adam R.,0,11,30,30
1683292280255,MATH 10B,B02,188106,Bowers; Adam R.,0,11,30,30
1683292281282,MATH 10C,A01,188111,Staff,0,18,30,30
1683292281282,MATH 10C,A02,188127,Staff,0,17,30,30
1683292281282,MATH 10C,A03,188131,Staff,0,17,30,30
1683292281282,MATH 10C,B01,188218,Staff,21,0,30,9
1683292281282,MATH 10C,B02,188244,Staff,13,0,30,17
1683292281282,MATH 10C,B03,188277,Staff,16,0,30,14
1683292282308,MATH 18,A01,188344,Bach; Quang Tran,18,0,30,12
1683292282308,MATH 18,A02,188345,Bach; Quang Tran,11,0,30,19
1683292282308,MATH 18,B01,188353,Bach; Quang Tran,10,0,30,20
1683292282308,MATH 18,B02,188354,Bach; Quang Tran,20,0,30,10
1683292283333,MATH 20A,A01,188374,Staff,13,0,35,22
1683292284360,MATH 20B,A01,188382,Ohm; Ko Woon,6,0,30,24
1683292284360,MATH 20B,A02,188383,Ohm; Ko Woon,24,0,30,6
1683292284360,MATH 20B,B01,188385,Ohm; Ko Woon,7,0,30,23
1683292284360,MATH 20B,B02,188392,Ohm; Ko Woon,22,0,30,8
1683292285387,MATH 20C,A01,188394,Harel; Guershon,10,0,30,20
1683292285387,MATH 20C,A02,188395,Harel; Guershon,13,0,30,17
1683292285387,MATH 20C,B01,188404,Harel; Guershon,3,0,30,27
1683292285387,MATH 20C,B02,188405,Harel; Guershon,19,0,30,11
1683292286414,MATH 20D,A01,188414,Hammock; Frances H,0,1,30,30
1683292286414,MATH 20D,A02,188415,Hammock; Frances H,4,0,30,26
1683292286414,MATH 20D,B01,188447,Hammock; Frances H,2,0,30,28
1683292286414,MATH 20D,B02,188486,Hammock; Frances H,8,0,30,22
1683292287441,MATH 20E,A01,188649,Staff,22,0,30,8
1683292287441,MATH 20E,A02,188650,Staff,23,0,30,7
1683292287441,MATH 20E,A03,188673,Staff,0,0,30,30
1683292288473,MATH 102,A01,188675,Staff,0,35,35,35
1683292289502,MATH 103B,A01,188681,Staff,4,0,35,31
1683292289502,MATH 103B,B01,188692,Staff,8,0,35,27
1683292290533,MATH 109,A01,188695,Salehi Golsefidy; Alireza,25,0,35,10
1683292290533,MATH 109,A02,188696,Salehi Golsefidy; Alireza,27,0,35,8
1683292291564,MATH 120A,A01,188698,Eggers; John Dietrich,5,0,35,30
1683292292662,MATH 142B,A01,188736,Ioana; Adrian,0,2,30,30
1683292292662,MATH 142B,A02,188741,Ioana; Adrian,0,1,30,30
1683292292662,MATH 142B,A03,188743,Ioana; Adrian,0,3,30,30
1683292293689,MATH 168A,A01,188790,Staff,0,8,35,35
1683292294714,MATH 170A,A01,188803,Nie; Jiawang,0,2,35,35
1683292294714,MATH 170A,A02,188811,Nie; Jiawang,0,0,35,35
1683292294714,MATH 170A,A03,188814,Nie; Jiawang,1,0,35,34
1683292294714,MATH 170A,A04,188815,Nie; Jiawang,14,0,35,21
1683292295742,MATH 193B,A01,188817,Staff,0,0,35,35
1683292295742,MATH 193B,A02,188818,Staff,5,0,35,30
1683292296768,MGT 4,A01,202857,Anderson; John Charles,62,0,80,18
1683292297796,MGT 12,A00,202858,Lindenberger; Wade Douglas,43,0,90,47
1683292298823,MGT 18,A00,202859,Staff,74,0,90,16
1683292299853,MGT 18GS,A00,202860,McKay; Michael J,13,0,28,15
1683292300881,MGT 45,A00,202861,Pecore; Joseph P.,14,0,90,76
1683292301908,MGT 100,A00,202863,Yavorsky; Daniel Ryan,28,0,90,62
1683292302939,MGT 103,A00,202864,Ehrich; Kristine R,0,16,90,90
1683292303966,MGT 112,A00,202865,Ehrich; Kristine R,15,0,90,75
1683292304992,MGT 121A,A00,202868,Staff,0,19,0,0
1683292306018,MGT 131B,A00,202869,Anderson; John Charles,59,0,90,31
1683292307043,MGT 136,A00,202871,Lindenberger; Wade Douglas,84,0,90,6
1683292308069,MGT 164,A00,202873,Staff,0,69,90,90
1683292309096,MGT 164GS,A00,202874,McKay; Mary A,13,0,28,15
1683292310121,MGT 180,A00,202875,Staff,0,51,90,90
1683292311146,MMW 11R,A01,205019,Herbst; Matthew,3,0,30,27
1683292311146,MMW 11R,A02,205026,Herbst; Matthew,29,0,30,1
1683292312177,MMW 15,A01,193512,Chang; Edmond Yi-Teh,0,9,28,28
1683292312177,MMW 15,A02,193513,Chang; Edmond Yi-Teh,0,5,28,28
1683292312177,MMW 15,A03,193514,Chang; Edmond Yi-Teh,0,5,28,28
1683292312177,MMW 15,A04,193515,Chang; Edmond Yi-Teh,0,4,28,28
1683292312177,MMW 15,A05,193516,Chang; Edmond Yi-Teh,0,4,28,28
1683292312177,MMW 15,A06,193517,Chang; Edmond Yi-Teh,0,5,28,28
1683292312177,MMW 15,B01,193519,Chang; Edmond Yi-Teh,0,4,28,28
1683292312177,MMW 15,B02,193520,Chang; Edmond Yi-Teh,0,5,28,28
1683292312177,MMW 15,B03,193521,Chang; Edmond Yi-Teh,0,4,28,28
1683292312177,MMW 15,B04,193522,Chang; Edmond Yi-Teh,0,4,28,28
1683292312177,MMW 15,B05,193523,Chang; Edmond Yi-Teh,0,5,28,28
1683292312177,MMW 15,B06,193524,Chang; Edmond Yi-Teh,0,4,28,28
1683292313202,MMW 122,A01,193526,Rahimi; Babak,0,14,28,28
1683292313202,MMW 122,A02,193527,Rahimi; Babak,0,14,28,28
1683292313202,MMW 122,A03,193528,Rahimi; Babak,0,0,0,0
1683292313202,MMW 122,A04,193529,Rahimi; Babak,0,0,0,0
1683292314231,MUS 1A,A01,186663,Staff,0,20,35,35
1683292315256,MUS 4,A01,186715,Staff,0,12,35,35
1683292316282,MUS 5R,A01,186796,Dubnov; Shlomo,0,16,35,35
1683292317308,MUS 6,A01,186798,Staff,0,3,25,25
1683292318331,MUS 7,A01,186830,Staff,12,0,35,23
1683292319357,MUS 8,A01,186930,Staff,0,25,35,35
1683292320381,MUS 15,A01,186932,Staff,0,15,35,35
1683292320381,MUS 15,B01,186934,Staff,0,14,35,35
1683292321407,MUS 80,A00,186935,Staff,2,0,20,18
1683292321407,MUS 80,B00,186936,Staff,25,0,25,0
1683292322433,NANO 11,A00,204702,Lipomi; Darren John,0,0,0,0
1683292323462,NANO 15,A01,204709,Yang; Kesong,0,1,0,0
1683292324491,NANO 114,A00,202069,Jahed Motlagh; Zeinab,3,0,10,7
1683292325521,PHIL 1,A00,186955,Grush; Rick Scott,32,0,40,8
1683292326551,PHIL 10,A01,186973,Grush; Rick Scott,29,0,35,6
1683292326551,PHIL 10,A02,186974,Grush; Rick Scott,33,0,35,2
1683292327584,PHIL 13,A01,186976,Staff,7,0,35,28
1683292327584,PHIL 13,A02,186977,Staff,16,0,35,19
1683292328610,PHIL 14,A01,186979,Staff,31,0,35,4
1683292328610,PHIL 14,A02,186986,Staff,32,0,35,3
1683292329642,PHIL 28,A01,186988,Staff,16,0,30,14
1683292329642,PHIL 28,A02,186989,Staff,1,0,30,29
1683292329642,PHIL 28,A03,186990,Staff,9,0,30,21
1683292329642,PHIL 28,A04,186991,Staff,26,0,30,4
1683292330666,PHIL 120,A00,186997,Staff,23,0,40,17
1683292331691,PHIL 137,A00,187003,Staff,9,0,40,31
1683292332717,PHIL 150,A00,187015,Staff,47,0,70,23
1683292333743,PHIL 167,A00,187021,Lamey; Andy M.,35,0,40,5
1683292334770,PHIL 174,A01,202226,Staff,17,0,20,3
1683292334770,PHIL 174,A02,202235,Staff,20,0,20,0
1683292335797,PHIL 191A,A00,258918,Staff,0,0,1,1
1683292336823,PHYS 1A,A00,187028,Staff,26,0,60,34
1683292337850,PHYS 1AL,001,187036,Staff,2,0,30,28
1683292337850,PHYS 1AL,002,187049,Staff,18,0,30,12
1683292338875,PHYS 1B,A00,187058,Staff,23,0,60,37
1683292339904,PHYS 1BL,001,187064,Staff,0,0,30,30
1683292339904,PHYS 1BL,002,187070,Staff,6,0,30,24
1683292340930,PHYS 1C,A00,187082,Staff,32,0,120,88
1683292341958,PHYS 1CL,001,187088,Staff,0,9,30,30
1683292341958,PHYS 1CL,002,187089,Staff,0,2,30,30
1683292341958,PHYS 1CL,009,262693,Staff,12,0,30,18
1683292342984,PHYS 2B,A01,187097,Staff,54,0,115,61
1683292344011,PHYS 2C,A01,187099,Staff,67,0,115,48
1683292345041,PHYS 2CL,A01,187101,Staff,5,0,28,23
1683292345041,PHYS 2CL,A02,187102,Staff,15,0,28,13
1683292346066,PHYS 2D,A01,187123,Shotwell; Brian,95,0,115,20
1683292347093,PHYS 4B,A01,187133,Grinstein; Benjamin,35,0,50,15
1683292348116,POLI 10,A00,188819,Staff,0,3,50,50
1683292349149,POLI 11,A00,188827,Staff,43,0,50,7
1683292350176,POLI 13R,A00,188828,Staff,0,1,20,20
1683292351206,POLI 27,A01,188830,Elgin; Samuel Zincke,0,1,70,70
1683292352235,POLI 30,A00,188832,Desposato; Scott,33,0,50,17
1683292353264,POLI 102F,A00,188834,Staff,3,0,40,37
1683292354291,POLI 104A,A00,188852,Staff,14,0,30,16
1683292355321,POLI 104I,A00,188853,Staff,0,6,20,20
1683292356346,POLI 110B,A00,188854,Wiens; David,7,0,20,13
1683292357374,POLI 112A,A00,188855,Wiens; David,5,0,30,25
1683292358403,POLI 117R,A00,188856,Forman; Fonna,0,11,20,20
1683292359430,POLI 118,A00,188857,Ingham; Sean,8,0,20,12
1683292360455,POLI 120G,A00,188858,Staff,9,0,30,21
1683292361481,POLI 131CR,A00,188863,Hoston; Germaine,24,0,50,26
1683292362507,POLI 133,A00,188864,Nellis; Gareth Hb,44,0,50,6
1683292363536,POLI 134D,A00,188865,Desposato; Scott,27,0,30,3
1683292364565,POLI 142A,A00,188871,Gartzke; Erik,22,0,50,28
1683292365592,POLI 142K,A00,188874,Staff,38,0,50,12
1683292366620,POLI 143,A00,188940,Gartzke; Erik,16,0,30,14
1683292367649,POLI 153,A00,188943,Staff,3,0,20,17
1683292368677,POLI 160AA,A00,188944,Staff,13,0,40,27
1683292369702,POLI 170A,A00,188945,Staff,11,0,30,19
1683292371752,PSYC 1,A00,188952,Staff,38,0,90,52
1683292372776,PSYC 2,B00,188953,Staff,20,0,35,15
1683292373801,PSYC 6,A00,188970,Staff,47,0,60,13
1683292374827,PSYC 7,A00,188973,Staff,37,0,45,8
1683292375852,PSYC 60,A01,188980,Rickard; Timothy C.,43,0,60,17
1683292376878,PSYC 70,A01,189001,Steiner; Eric Tomas,24,0,45,21
1683292377905,PSYC 100,A00,189005,Lacefield; Katharine I,0,99,120,120
1683292378934,PSYC 102,A00,189008,Staff,10,0,30,20
1683292379962,PSYC 106,B00,189026,Gorman; Michael R.,37,0,60,23
1683292380987,PSYC 114,B01,189033,Winkielman; Piotr,0,32,30,30
1683292382013,PSYC 131,A00,189036,Anagnostaras; Stephan,0,43,60,60
1683292383043,PSYC 136,A00,189041,Lowe; Angela Beth,0,7,25,25
1683292384069,PSYC 137,A00,189057,Winkielman; Piotr,0,34,25,25
1683292385094,PSYC 144,A00,189107,Wixted; John T,0,7,50,50
1683292387148,PSYC 162,A00,189142,Staff,0,8,85,85
1683292388175,PSYC 172,A00,189144,Gorman; Michael R.,0,7,30,30
1683292390228,PSYC 179,A00,189146,Lacefield; Katharine I,0,84,120,120
1683292391254,PSYC 181,A00,189147,Anagnostaras; Stephan,0,44,90,90
1683292392281,PSYC 190R,A00,189148,Barner; David A.,0,22,80,80
1683292393309,PSYC 191,A00,189275,Rickard; Timothy C.,0,7,25,25
1683292394335,PSYC 193,A00,189276,Chapman; Eddie Nathaniel,0,1,0,4
1683292395365,PSYC 193L,A01,189281,Lowe; Angela Beth,12,0,20,8
1683292395365,PSYC 193L,B01,189285,Staff,28,0,35,7
1683292396449,RELI 149,A00,187137,Rahimi; Babak,7,0,40,33
1683292397475,SE 9,A01,187315,Staff,0,2,18,18
1683292398500,SE 101B,A00,187409,Staff,24,0,30,6
1683292399529,SE 110B,A00,187444,Staff,10,0,40,30
1683292400559,SE 130B,A00,187449,Staff,31,0,40,9
1683292401588,SE 150A,A00,187516,Staff,9,0,20,11
1683292402611,SE 154,A00,187528,Staff,30,0,50,20
1683292403637,SIO 3,A01,258171,Staff,35,0,40,5
1683292404667,SIO 10,A00,187144,Cook; Geoffrey W,0,3,75,75
1683292405696,SIO 45,A00,187152,Cook; Geoffrey W,1,0,100,99
1683292406721,SIO 109R,A00,194486,Staff,0,3,20,20
1683292408773,SIO 187,A01,187233,Kacev; David,12,0,40,28
1683292409801,SOCI 1,A01,258656,Thorpe; Charles Robert,28,0,30,2
1683292409801,SOCI 1,A02,258658,Thorpe; Charles Robert,30,0,30,0
1683292409801,SOCI 1,A03,258661,Thorpe; Charles Robert,25,0,25,0
1683292409801,SOCI 1,A04,258666,Thorpe; Charles Robert,22,0,25,3
1683292409801,SOCI 1,A05,258897,Thorpe; Charles Robert,23,0,25,2
1683292409801,SOCI 1,A06,258898,Thorpe; Charles Robert,25,0,25,0
1683292410828,SOCI 30,A01,258903,Pardo Guerra; Juan Pablo,16,0,30,14
1683292411854,SOCI 102,A00,258904,Staff,9,0,25,16
1683292412880,SOCI 106,A00,258905,Staff,19,0,25,6
1683292413905,SOCI 111,A00,258907,Ribas Norris; Janet Vanesa,26,0,30,4
1683292414931,SOCI 121R,A00,258908,Pardo Guerra; Juan Pablo,11,0,30,19
1683292415960,SOCI 126,A01,203330,Staff,14,0,20,6
1683292416986,SOCI 131,A00,258909,Thorpe; Charles Robert,31,0,60,29
1683292418012,SOCI 135,A00,258910,Payne; Christine Anna,0,9,30,30
1683292419038,SOCI 157,A00,258911,Staff,13,0,30,17
1683292420068,SOCI 184,A00,258912,Staff,26,0,30,4
1683292421095,SOCI 188D,A00,258913,Staff,21,0,30,9
1683292422121,SYN 2,001,187529,Staff,9,0,16,7
1683292422121,SYN 2,002,201452,Staff,0,18,16,16
1683292422121,SYN 2,003,201469,Staff,3,0,16,13
1683292423150,SYN 100,A01,187531,Staff,0,9,20,20
1683292423150,SYN 100,B01,201491,Staff,0,12,20,20
1683292424176,TDAC 1,A00,189286,Walsh; Kim C.,3,0,20,17
1683292424176,TDAC 1,B00,189287,Harting; Carla Kelso,11,0,20,9
1683292425202,TDAC 101,A00,189300,Walsh; Kim C.,16,0,20,4
1683292425202,TDAC 101,B00,189301,Harting; Carla Kelso,18,0,20,2
1683292426227,TDAC 102,A00,189304,Basso; Beatrice,14,0,20,6
1683292427254,TDAC 108,A00,189305,Staff,18,0,20,2
1683292428279,TDDE 131,A00,189310,Staff,19,0,20,1
1683292428279,TDDE 131,B00,189314,Staff,19,0,20,1
1683292428279,TDDE 131,C00,189315,Staff,48,0,50,2
1683292428279,TDDE 131,D00,189316,Staff,14,0,15,1
1683292428279,TDDE 131,E00,204841,Staff,20,0,20,0
1683292429304,TDGE 10,A00,189289,Staff,30,0,50,20
1683292429304,TDGE 10,B00,189290,Havis; Allan,2,0,50,48
1683292430337,TDGE 11,A00,189291,Fulton; Julia,0,3,50,50
1683292430337,TDGE 11,B00,189292,Staff,20,0,25,5
1683292430337,TDGE 11,C00,260270,Staff,0,0,0,0
1683292431361,TDGE 25,A00,189294,Staff,3,0,20,17
1683292432388,TDGE 124,A00,189318,Fulton; Julia,0,8,50,50
1683292433413,TDGE 125,A00,189319,Staff,13,0,25,12
1683292433413,TDGE 125,B00,189320,Staff,23,0,25,2
1683292434442,TDGE 127,A00,189322,Havis; Allan,0,0,50,50
1683292435468,TDHT 101,A00,189323,Staff,18,0,25,7
1683292435468,TDHT 101,B00,189324,Staff,25,0,25,0
1683292436495,TDHT 102,A00,189325,Staff,49,0,50,1
1683292437525,TDMV 1,A00,189295,Arcidiacono; Kristin,20,0,30,10
1683292437525,TDMV 1,B00,189296,Caligagan; Maria T.,24,0,30,6
1683292438551,TDMV 2,A00,189297,Sammartano; Tonnie,28,0,30,2
1683292438551,TDMV 2,B00,189299,Arcidiacono; Kristin,24,0,30,6
1683292439583,TDMV 3,A00,204998,Rincon; Alicia,22,0,30,8
1683292440610,TDMV 120,A00,189458,Sammartano; Tonnie,28,0,30,2
1683292441641,TDMV 138,A00,189541,Jun; Grace Shin Hae,22,0,40,18
1683292442668,TDMV 142,A00,189717,Caligagan; Tony,23,0,30,7
1683292442668,TDMV 142,B00,189718,Caligagan; Maria T.,25,0,30,5
1683292443694,TMC 2,A01,187533,Staff,25,0,25,0
1683292443694,TMC 2,A02,187534,Staff,25,0,25,0
1683292444726,USP 1,A01,187536,Kwak; Nancy,0,16,25,25
1683292445756,USP 5,A01,187538,Staff,9,0,25,16
1683292446781,USP 101,A00,199253,Staff,0,4,0,0
1683292447811,USP 124,A00,187562,Boomhower; Matthew Charles,1,0,30,29
1683292448841,USP 138,A00,187582,Staff,20,0,25,5
1683292449867,USP 152,A01,187597,Staff,4,0,25,21
1683292450895,USP 153,A00,187598,Staff,19,0,25,6
1683292451927,USP 168,A00,187607,Kwak; Nancy,2,0,5,3
1683292452953,USP 173,A00,187619,Staff,4,0,25,21
1683292453978,USP 181,A00,187638,Staff,0,0,25,25
1683292455004,VIS 103,A00,187650,Cruz; Edwin Teddy,23,0,75,52
1683292456030,VIS 110D,A00,187669,Staff,12,0,22,10
1683292457057,VIS 127C,A00,187720,Shen; Kuiyi,68,0,146,78
1683292458082,VIS 149,A00,187731,Yoldas; Pinar,0,14,22,22
1683292459107,VIS 151,A01,188091,Staff,22,0,34,12
1683292459107,VIS 151,A02,188092,Staff,11,0,34,23
1683292460138,VIS 160B,A00,188093,Stalbaum; Brett,0,0,10,10
1683292462197,WCWP 10B,A00,201720,Staff,10,0,15,5
1683292462197,WCWP 10B,B00,201722,Staff,8,0,15,7
1683292463223,WCWP 100,A00,201725,Gagnon; Jeffrey C,0,0,2,2
1683292463223,WCWP 100,B00,201727,Staff,0,4,15,15
1683292466379,ANBI 133,A00,258401,Wilder; Linnea Lorene,34,0,40,6
1683292467412,ANBI 140,A00,258395,Hrvoj Mihic; Branka,18,0,25,7
1683292468437,ANSC 120,A00,258402,Bialecki; Jon Anthony,27,0,40,13
1683292469465,ANSC 144,A00,258400,Staff,14,0,40,26
1683292471517,ANSC 166,A00,258396,Parish; Steven Martin,157,0,175,18
1683292472546,ANSC 180,A00,193533,Staff,9,0,20,11
1683292473571,ANSC 188,A00,258397,Jassal; Aftab,33,0,40,7
1683292474598,ANTH 3,A01,258316,Staff,23,0,30,7
1683292475629,ANTH 5,A00,258394,Semendeferi; Ekaterini,16,0,20,4
1683292476655,ANTH 21,A01,258331,Staff,9,0,40,31
1683292477680,ANTH 103,A00,258398,Varma; Saiba,15,0,25,10
1683292478710,AWP 10,001,202034,Staff,0,0,0,0
1683292478710,AWP 10,002,202035,Staff,0,0,0,0
1683292478710,AWP 10,003,202036,Staff,0,0,0,0
1683292478710,AWP 10,004,202037,Staff,0,0,0,0
1683292478710,AWP 10,005,202038,Staff,0,0,0,0
1683292478710,AWP 10,006,202039,Staff,0,0,0,0
1683292478710,AWP 10,007,202040,Staff,0,0,0,0
1683292478710,AWP 10,008,202041,Staff,0,0,0,0
1683292478710,AWP 10,009,202042,Staff,0,0,0,0
1683292478710,AWP 10,010,202043,Staff,0,0,0,0
1683292478710,AWP 10,011,202044,Staff,0,0,0,0
1683292478710,AWP 10,012,202045,Staff,0,0,0,0
1683292478710,AWP 10,013,202046,Staff,0,0,0,0
1683292478710,AWP 10,014,202047,Staff,0,0,0,0
1683292478710,AWP 10,015,202048,Staff,0,0,0,0
1683292478710,AWP 10,016,202049,Staff,0,0,0,0
1683292478710,AWP 10,017,202050,Staff,0,0,0,0
1683292478710,AWP 10,018,202051,Staff,0,0,0,0
1683292478710,AWP 10,019,202052,Staff,0,0,0,0
1683292478710,AWP 10,020,202053,Staff,0,0,0,0
1683292478710,AWP 10,021,202054,Staff,0,0,0,0
1683292478710,AWP 10,022,202055,Staff,0,0,0,0
1683292478710,AWP 10,023,202056,Staff,0,0,0,0
1683292478710,AWP 10,024,202057,Staff,0,0,0,0
1683292478710,AWP 10,025,202058,Staff,0,0,0,0
1683292478710,AWP 10,026,202059,Staff,0,0,0,0
1683292479734,AWP 102,001,202032,Staff,0,0,0,0
1683292479734,AWP 102,002,202033,Staff,0,0,0,0
1683292480766,BENG 100,A01,254234,Taylor Amos; Alyssa C,31,0,40,9
1683292481799,BENG 196,001,270013,Engler; Adam J.,9999,0,9999,0
1683292482836,BICD 100R,A01,202018,Smith; Laurie,0,7,32,32
1683292482836,BICD 100R,A02,202019,Smith; Laurie,0,2,32,32
1683292482836,BICD 100R,A03,202020,Smith; Laurie,0,1,32,32
1683292482836,BICD 100R,A04,202021,Smith; Laurie,8,0,32,24
1683292482836,BICD 100R,A05,202022,Smith; Laurie,12,0,32,20
1683292483870,BICD 136,A01,193242,Gustafson-Brown; Cindy,0,2,32,32
1683292483870,BICD 136,A02,193244,Gustafson-Brown; Cindy,15,0,32,17
1683292484905,BIEB 102,A01,193249,Butler; Shannon Rhey,0,2,32,32
1683292484905,BIEB 102,A02,193251,Butler; Shannon Rhey,0,0,32,32
1683292484905,BIEB 102,A03,193253,Butler; Shannon Rhey,0,1,32,32
1683292484905,BIEB 102,A04,193255,Butler; Shannon Rhey,17,0,32,15
1683292484905,BIEB 102,A05,193265,Butler; Shannon Rhey,26,0,32,6
1683292484905,BIEB 102,A06,193269,Butler; Shannon Rhey,16,0,32,16
1683292486958,BIEB 150,A01,193274,Staff,0,0,32,32
1683292486958,BIEB 150,A02,193285,Staff,24,0,32,8
1683292487985,BIEB 194,A00,193286,Kurle; Carolyn M.,22,0,32,10
1683292489013,BILD 1,A01,192291,Staff,16,0,32,16
1683292489013,BILD 1,A02,192292,Staff,30,0,32,2
1683292489013,BILD 1,B01,192520,Reuther; Keefe,0,1,0,0
1683292489013,BILD 1,B02,192532,Reuther; Keefe,0,1,0,0
1683292490039,BILD 3,A01,192556,Butler; Shannon Rhey,0,0,32,32
1683292490039,BILD 3,A02,192581,Butler; Shannon Rhey,5,0,32,27
1683292490039,BILD 3,A03,192611,Butler; Shannon Rhey,23,0,32,9
1683292490039,BILD 3,A04,192612,Butler; Shannon Rhey,25,0,32,7
1683292490039,BILD 3,A05,192613,Butler; Shannon Rhey,27,0,32,5
1683292490039,BILD 3,A06,192679,Butler; Shannon Rhey,27,0,32,5
1683292490039,BILD 3,A07,192682,Butler; Shannon Rhey,22,0,32,10
1683292491066,BILD 4,A01,192836,Reuther; Keefe,1,0,24,23
1683292491066,BILD 4,A02,193044,Reuther; Keefe,4,0,24,20
1683292492100,BILD 10,A01,193142,Gustafson-Brown; Cindy,31,0,32,1
1683292492100,BILD 10,A02,193149,Gustafson-Brown; Cindy,31,0,32,1
1683292493131,BIMM 100,A01,193301,Staff,0,6,32,32
1683292493131,BIMM 100,A02,193312,Staff,0,5,32,32
1683292493131,BIMM 100,A03,193323,Staff,0,8,32,32
1683292494164,BIMM 101,A01,193329,McDonnell; Lisa Marie,0,3,24,24
1683292494164,BIMM 101,A02,193339,McDonnell; Lisa Marie,0,2,24,24
1683292494164,BIMM 101,B01,193354,McDonnell; Lisa Marie,0,3,24,24
1683292494164,BIMM 101,B02,193357,McDonnell; Lisa Marie,0,3,24,24
1683292495196,BIMM 110,A01,193377,Tat; John,0,11,32,32
1683292495196,BIMM 110,A02,193378,Tat; John,1,9,32,31
1683292496232,BIMM 120,A01,206116,Staff,0,0,32,32
1683292496232,BIMM 120,A02,206117,Staff,8,0,32,24
1683292496232,BIMM 120,A03,206121,Staff,21,0,32,11
1683292497258,BIPN 100,A01,193393,Park; Ji Young,0,14,32,32
1683292497258,BIPN 100,A02,193402,Park; Ji Young,0,12,32,32
1683292497258,BIPN 100,A03,193413,Park; Ji Young,0,14,32,32
1683292497258,BIPN 100,A04,193414,Park; Ji Young,0,13,32,32
1683292498286,BIPN 102,A01,193429,Staff,0,0,32,32
1683292498286,BIPN 102,A02,193438,Staff,23,0,32,9
1683292499320,BIPN 106,A01,193450,Reyes Gonzalez; Catalina,0,2,40,40
1683292500405,BIPN 134,A01,193465,Cooke; James Edward,0,0,32,32
1683292500405,BIPN 134,A02,193474,Cooke; James Edward,27,0,32,5
1683292500405,BIPN 134,A03,193485,Cooke; James Edward,29,0,32,3
1683292500405,BIPN 134,A04,193486,Cooke; James Edward,21,0,32,11
1683292500405,BIPN 134,A05,193491,Cooke; James Edward,31,0,32,1
1683292500405,BIPN 134,A06,193501,Cooke; James Edward,30,0,32,2
1683292500405,BIPN 134,A07,193510,Cooke; James Edward,29,0,32,3
1683292502461,BISP 194,A00,222522,Staff,16,0,32,16
1683292503485,CAT 124,A01,202407,Staff,20,0,25,5
1683292504511,CAT 125,A00,202408,Marchisotto; Jennifer Anne,4,0,20,16
1683292505541,CAT 125R,A00,202409,Smith; Lauryn Alissa,0,11,20,20
1683292505541,CAT 125R,B00,202410,Morales; Celeste Georgianna,0,11,20,20
1683292505541,CAT 125R,C00,202411,Irwin; Matthew Joseph,0,10,20,20
1683292506566,CENG 15,A01,204712,Yang; Kesong,0,1,0,0
1683292507593,CENG 114,A00,202070,Jahed Motlagh; Zeinab,5,0,20,15
1683292508633,CGS 105,A00,185477,Wesling; Megan E.,24,0,40,16
1683292509661,CGS 106,A00,185494,Staff,13,0,22,9
1683292510689,CGS 108,A00,185495,Staff,14,0,20,6
1683292511715,CGS 114,A00,185496,Staff,13,0,18,5
1683292512745,CGS 119,A00,185501,Staff,15,0,20,5
1683292513770,CGS 120,A00,185511,Staff,13,0,20,7
1683292514804,CHEM 4,A01,184675,Bussey; Thomas J,96,0,100,4
1683292515834,CHEM 6A,A01,184677,Staff,35,0,60,25
1683292516860,CHEM 6B,A01,184679,Staff,65,0,100,35
1683292517889,CHEM 6C,A01,184681,Bussey; Thomas J,1,0,50,49
1683292517889,CHEM 6C,A02,184682,Bussey; Thomas J,34,0,50,16
1683292518917,CHEM 40A,A01,184684,Albizati; Kim F.,37,0,100,63
1683292519942,CHEM 40B,A01,184686,Albizati; Kim F.,0,20,100,100
1683292520967,CHEM 41B,A01,184690,Staff,52,0,100,48
1683292521994,COGS 3,A01,184715,Boyle; Mary E. T.,0,25,40,40
1683292523027,COGS 14B,A01,185172,Staff,0,15,38,38
1683292524052,COGS 18,A01,184736,Staff,20,0,80,60
1683292525077,COGS 100,A01,184932,Staff,0,5,73,73
1683292526101,COGS 101A,A01,184935,Staff,0,38,30,30
1683292527130,COGS 101B,A01,184944,Staff,0,2,30,30
1683292528159,COGS 101C,A01,184946,Staff,0,12,30,30
1683292529190,COGS 102A,A01,184951,Johnson; Christine M.,2,0,40,38
1683292530222,COGS 107B,A01,184953,Mooshagian; Eric Frederick,0,50,40,40
1683292531249,COGS 118B,A01,184959,Gupta; Anjum,0,48,40,40
1683292532277,COGS 153,A00,184961,Staff,0,15,30,30
1683292533308,COGS 177,A00,184962,Staff,0,21,30,30
1683292534338,COGS 187A,A01,184969,Boyle; Mary E. T.,0,17,40,40
1683292535371,COMM 10,A01,185174,Staff,0,5,25,25
1683292535371,COMM 10,A02,185189,Staff,0,5,25,25
1683292535371,COMM 10,A03,269821,Staff,0,0,0,0
1683292536402,COMM 100B,A01,185475,Staff,0,0,0,2
1683292536402,COMM 100B,A02,185476,Staff,14,0,25,11
1683292537427,COMM 100C,A01,185314,Staff,1,0,25,24
1683292537427,COMM 100C,A02,185327,Staff,19,0,25,6
1683292538451,COMM 110M,A00,185349,Staff,2,0,40,38
1683292539476,COMM 113T,A00,185352,Staff,25,0,40,15
1683292540501,COMM 114I,A00,185353,Staff,33,0,40,7
1683292541529,COMM 131,A00,185354,Staff,19,0,30,11
1683292542562,CSE 8A,A50,185358,Cao; Yingjun,0,46,10,10
1683292543592,CSE 8B,A01,185362,Staff,0,47,50,50
1683292544623,CSE 11,A01,185416,Cao; Yingjun,0,93,10,10
1683292545650,CSE 20,A01,185445,Briones; Jor-el Thomas Caparas,5,0,25,20
1683292546676,CSE 21,A01,185447,Staff,10,0,50,40
1683292547702,CSE 101,A01,185451,Staff,0,12,50,50
1683292547702,CSE 101,B01,185453,Jones; Miles E,0,11,50,50
1683292549754,CSE 141,A01,185458,Eldon; John,20,0,100,80
1683292550779,CSE 141L,A01,185461,Eldon; John,12,0,100,88
1683292551803,CSE 142,A01,185463,Staff,35,0,60,25
1683292551803,CSE 142,B01,201355,Staff,0,6,60,60
1683292552828,CSE 142L,A01,185470,Staff,35,0,60,25
1683292552828,CSE 142L,B01,201417,Staff,0,5,60,60
1683292553853,CSE 190,A00,201433,Staff,32,0,49,17
1683292554881,DOC 1,A01,259136,Strom; Megan C.,8,0,15,7
1683292554881,DOC 1,A02,259137,Strom; Megan C.,14,0,15,1
1683292554881,DOC 1,A03,259138,Strom; Megan C.,14,0,15,1
1683292554881,DOC 1,A04,259139,Strom; Megan C.,14,0,15,1
1683292555907,DOC 100D,A00,259140,Pass; Natalye Joann,17,0,25,8
1683292556933,DSGN 1,A01,184749,Rill; Bryan,0,24,30,30
1683292557961,DSGN 100,A01,185168,Staff,0,2,25,25
1683292558989,ECE 5,A01,185626,Morris; Karcher William,0,10,0,0
1683292560015,ECE 101,A01,185628,Staff,17,0,70,53
1683292561041,ECE 107,A01,185635,Baghdadchi; Saharnaz,0,0,20,20
1683292561041,ECE 107,A02,185638,Baghdadchi; Saharnaz,4,0,20,16
1683292562073,ECE 148,A01,185647,Silberman; Jack,1,0,16,15
1683292563103,ECON 1,A01,185537,Crane; Meredith Helen,54,0,70,16
1683292564133,ECON 3,A01,185549,Crane; Meredith Helen,33,0,70,37
1683292565158,ECON 4,A01,203354,Anderson; John Charles,0,4,10,10
1683292566188,ECON 100A,A01,185574,Staff,0,4,40,40
1683292567213,ECON 100B,A01,185576,Staff,0,22,40,40
1683292568240,ECON 100C,A01,185589,Newhouse; Herbert S,30,0,70,40
1683292569268,ECON 105,A00,185608,Vespa; Emanuel Ignacio,19,0,35,16
1683292570293,ECON 109,A01,185610,Shishkin; Denis,10,0,35,25
1683292571318,ECON 110A,A01,185612,Staff,11,0,40,29
1683292572358,ECON 120A,A01,185615,Staff,20,0,40,20
1683292573389,ECON 120C,A01,185617,Sun; Yixiao,0,20,70,70
1683292574419,ECON 144,A00,203346,Squires; Dale E,3,0,35,32
1683292575448,ECON 171,A01,203349,Newhouse; Herbert S,0,1,35,35
1683292576480,ECON 173A,A01,185621,Toda; Alexis Akira,21,0,35,14
1683292577511,EDS 25,A01,202413,Staff,0,1,0,0
1683292577511,EDS 25,A02,202414,Staff,0,1,0,0
1683292577511,EDS 25,A03,202415,Staff,0,0,0,0
1683292577511,EDS 25,A04,202416,Staff,0,1,0,0
1683292577511,EDS 25,A05,202439,Staff,0,0,0,0
1683292577511,EDS 25,A06,202440,Staff,0,0,0,0
1683292577511,EDS 25,B01,202631,Staff,0,0,0,0
1683292577511,EDS 25,B02,202632,Staff,0,0,0,0
1683292577511,EDS 25,B03,202639,Staff,0,0,0,0
1683292577511,EDS 25,B04,202640,Staff,0,0,0,0
1683292577511,EDS 25,B05,202643,Staff,0,0,0,0
1683292577511,EDS 25,B06,202644,Staff,0,0,0,0
1683292578539,EDS 38,A01,202659,Black; Alison Michelle,24,0,25,1
1683292579564,EDS 115,A00,202652,Staff,17,0,30,13
1683292580589,EDS 125,A00,202649,Staff,14,0,30,16
1683292581614,EDS 126,A01,203332,Staff,30,0,30,0
1683292582642,EDS 139,A00,202838,Staff,17,0,25,8
1683292583673,EDS 146,A01,202655,Staff,15,0,25,10
1683292584699,ENG 15,A00,185667,Staff,0,1,0,0
1683292584699,ENG 15,B00,185672,Staff,0,0,0,0
1683292584699,ENG 15,C00,185675,Staff,0,0,0,0
1683292584699,ENG 15,D00,185682,Staff,0,0,0,0
1683292584699,ENG 15,E00,185684,Staff,0,0,0,0
1683292585729,ETHN 103,A00,185710,Staff,0,3,35,35
1683292586759,ETHN 103A,A00,199228,Man; Simeon S,3,0,9,6
1683292587788,ETHN 109,A00,185711,Staff,18,0,35,17
1683292588817,ETHN 142,A00,185726,Staff,0,4,30,30
1683292589843,ETHN 163J,A00,199229,Man; Simeon S,6,0,8,2
1683292590870,ETHN 168,A00,185727,Staff,8,0,10,2
1683292591895,ETHN 182,A00,185728,Staff,1,0,35,34
1683292592926,ETHN 183,A00,185737,Staff,8,0,18,10
1683292593961,GLBH 111,A01,209361,Burgos; Jose L.,0,0,0,0
1683292596014,HIEU 104,A00,185792,Staff,16,0,20,4
1683292597039,HIEU 115,A00,185800,Staff,1,0,20,19
1683292598066,HIEU 128,A00,185801,Staff,0,7,20,20
1683292599095,HIEU 147,A00,185802,Staff,16,0,20,4
1683292600123,HIEU 154,A00,185823,Staff,12,0,20,8
1683292601148,HILA 102,A00,185826,Staff,13,0,20,7
1683292602178,HILD 2C,A01,185778,Staff,0,12,20,20
1683292603204,HILD 7B,A01,185780,Kwak; Nancy,0,15,32,32
1683292603204,HILD 7B,A02,185781,Kwak; Nancy,0,18,32,32
1683292604288,HILD 30,A01,185791,Staff,14,0,20,6
1683292605320,HISC 119,A00,185830,Golan; Tal,0,9,20,20
1683292606346,HITO 156GS,A00,185831,Patterson; Patrick H.,0,0,0,23
1683292607374,HIUS 103,A00,185832,Man; Simeon S,0,7,20,20
1683292608405,HIUS 117,A00,185836,Kwak; Nancy,2,0,20,18
1683292609433,HIUS 125,A00,185840,Man; Simeon S,0,0,23,23
1683292610459,HIUS 149,A00,185845,Staff,0,0,20,20
1683292611488,HUM 3,A01,185882,Zavodny; Tatiana Sophia,0,6,50,50
1683292611488,HUM 3,B01,185899,Caldwell; Michael Alan,0,19,50,50
1683292612512,HUM 3GS,A00,185900,Patterson; Patrick H.,0,0,0,23
1683292613541,HUM 4,A01,185938,Zroka; Amy Liane,31,0,50,19
1683292613541,HUM 4,B01,185956,Watkins; Eric,0,2,50,50
1683292613541,HUM 4,B02,202209,Watkins; Eric,0,1,50,50
1683292613541,HUM 4,B03,202210,Watkins; Eric,0,0,50,50
1683292614568,HUM 5,A01,185958,West; Geoffrey Scott,5,0,50,45
1683292614568,HUM 5,A02,202215,West; Geoffrey Scott,0,0,50,50
1683292615601,INTL 190,A00,185959,Gagnon; Jeffrey C,0,0,0,9
1683292615601,INTL 190,B00,185960,Lettieri; Michael Joseph,0,0,0,1
1683292616630,JAPN 180,A00,254509,Staff,0,1,25,25
1683292617673,LATI 10,A01,202853,Kennemore; Amy Michelle,5,0,35,30
1683292617673,LATI 10,A02,202854,Kennemore; Amy Michelle,1,0,35,34
1683292617673,LATI 10,A03,270054,Kennemore; Amy Michelle,30,0,30,0
1683292618702,LATI 180,A00,202855,Kennemore; Amy Michelle,11,0,20,9
1683292619732,LAWS 101,A00,201767,Golan; Tal,0,7,40,40
1683292620764,LIFR 1C,A00,185961,Staff,6,0,20,14
1683292621791,LIFR 1CX,A00,185962,Staff,7,0,20,13
1683292622816,LIFR 1D,A00,185963,Staff,9,0,20,11
1683292623838,LIFR 1DX,A00,185964,Staff,9,0,20,11
1683292624864,LIGN 101,A01,186039,Staff,43,0,50,7
1683292625889,LIGN 165,A00,186040,Staff,18,0,50,32
1683292626914,LTCS 108,A00,186041,Staff,6,0,10,4
1683292627940,LTCS 119,A00,186042,Staff,16,0,20,4
1683292628971,LTCS 130,A00,186043,Wesling; Megan E.,15,0,25,10
1683292631024,LTEA 138,A00,186119,Staff,14,0,40,26
1683292632054,LTEN 124,A00,186148,Staff,6,0,25,19
1683292633082,LTEN 178,A00,186149,Staff,7,0,15,8
1683292634113,LTEN 181,A00,186150,Blanco; John D,33,0,40,7
1683292635142,LTWL 120,A00,186160,Staff,20,0,25,5
1683292636167,LTWL 165,A00,186161,Staff,22,0,25,3
1683292637192,LTWR 100,A00,186162,Staff,0,4,15,15
1683292638219,LTWR 102,A00,186163,Doller; Ben,5,0,15,10
1683292639249,MAE 8,A01,186412,Staff,0,0,0,0
1683292640275,MAE 30B,A00,186445,Bahadori; Mohammad Yousef,83,0,100,17
1683292641302,MAE 40,A00,186592,Bewley; Thomas R,9,0,50,41
1683292642331,MAE 101B,A00,186593,Bahadori; Mohammad Yousef,81,0,100,19
1683292643358,MAE 105,A00,186594,Bandaru; Prabhakar,12,0,50,38
1683292644389,MAE 107,A00,186599,Pham; Hieu Tan,0,6,120,120
1683292645418,MAE 148,A01,186660,Silberman; Jack,3,0,16,13
1683292646445,MATH 10A,A01,188095,Staff,0,7,35,35
1683292647473,MATH 10B,A01,188097,Bowers; Adam R.,0,11,30,30
1683292647473,MATH 10B,A02,188099,Bowers; Adam R.,0,9,30,30
1683292647473,MATH 10B,B01,188104,Bowers; Adam R.,0,11,30,30
1683292647473,MATH 10B,B02,188106,Bowers; Adam R.,0,11,30,30
1683292648500,MATH 10C,A01,188111,Staff,0,18,30,30
1683292648500,MATH 10C,A02,188127,Staff,0,17,30,30
1683292648500,MATH 10C,A03,188131,Staff,0,17,30,30
1683292648500,MATH 10C,B01,188218,Staff,21,0,30,9
1683292648500,MATH 10C,B02,188244,Staff,13,0,30,17
1683292648500,MATH 10C,B03,188277,Staff,16,0,30,14
1683292649534,MATH 18,A01,188344,Bach; Quang Tran,18,0,30,12
1683292649534,MATH 18,A02,188345,Bach; Quang Tran,11,0,30,19
1683292649534,MATH 18,B01,188353,Bach; Quang Tran,10,0,30,20
1683292649534,MATH 18,B02,188354,Bach; Quang Tran,20,0,30,10
1683292650561,MATH 20A,A01,188374,Staff,13,0,35,22
1683292651588,MATH 20B,A01,188382,Ohm; Ko Woon,6,0,30,24
1683292651588,MATH 20B,A02,188383,Ohm; Ko Woon,24,0,30,6
1683292651588,MATH 20B,B01,188385,Ohm; Ko Woon,7,0,30,23
1683292651588,MATH 20B,B02,188392,Ohm; Ko Woon,22,0,30,8
1683292652621,MATH 20C,A01,188394,Harel; Guershon,10,0,30,20
1683292652621,MATH 20C,A02,188395,Harel; Guershon,13,0,30,17
1683292652621,MATH 20C,B01,188404,Harel; Guershon,3,0,30,27
1683292652621,MATH 20C,B02,188405,Harel; Guershon,19,0,30,11
1683292653648,MATH 20D,A01,188414,Hammock; Frances H,0,1,30,30
1683292653648,MATH 20D,A02,188415,Hammock; Frances H,4,0,30,26
1683292653648,MATH 20D,B01,188447,Hammock; Frances H,2,0,30,28
1683292653648,MATH 20D,B02,188486,Hammock; Frances H,8,0,30,22
1683292654699,MATH 20E,A01,188649,Staff,22,0,30,8
1683292654699,MATH 20E,A02,188650,Staff,23,0,30,7
1683292654699,MATH 20E,A03,188673,Staff,0,0,30,30
1683292655729,MATH 102,A01,188675,Staff,0,35,35,35
1683292656756,MATH 103B,A01,188681,Staff,4,0,35,31
1683292656756,MATH 103B,B01,188692,Staff,8,0,35,27
1683292657780,MATH 109,A01,188695,Salehi Golsefidy; Alireza,25,0,35,10
1683292657780,MATH 109,A02,188696,Salehi Golsefidy; Alireza,27,0,35,8
1683292658811,MATH 120A,A01,188698,Eggers; John Dietrich,5,0,35,30
1683292659838,MATH 142B,A01,188736,Ioana; Adrian,0,2,30,30
1683292659838,MATH 142B,A02,188741,Ioana; Adrian,0,1,30,30
1683292659838,MATH 142B,A03,188743,Ioana; Adrian,0,3,30,30
1683292660867,MATH 168A,A01,188790,Staff,0,8,35,35
1683292661893,MATH 170A,A01,188803,Nie; Jiawang,0,2,35,35
1683292661893,MATH 170A,A02,188811,Nie; Jiawang,0,0,35,35
1683292661893,MATH 170A,A03,188814,Nie; Jiawang,1,0,35,34
1683292661893,MATH 170A,A04,188815,Nie; Jiawang,14,0,35,21
1683292662922,MATH 193B,A01,188817,Staff,0,0,35,35
1683292662922,MATH 193B,A02,188818,Staff,5,0,35,30
1683292663950,MGT 4,A01,202857,Anderson; John Charles,62,0,80,18
1683292664977,MGT 12,A00,202858,Lindenberger; Wade Douglas,43,0,90,47
1683292666006,MGT 18,A00,202859,Staff,74,0,90,16
1683292667033,MGT 18GS,A00,202860,McKay; Michael J,13,0,28,15
1683292668063,MGT 45,A00,202861,Pecore; Joseph P.,14,0,90,76
1683292669089,MGT 100,A00,202863,Yavorsky; Daniel Ryan,28,0,90,62
1683292670121,MGT 103,A00,202864,Ehrich; Kristine R,0,16,90,90
1683292671147,MGT 112,A00,202865,Ehrich; Kristine R,15,0,90,75
1683292672173,MGT 121A,A00,202868,Staff,0,19,0,0
1683292673202,MGT 131B,A00,202869,Anderson; John Charles,59,0,90,31
1683292674228,MGT 136,A00,202871,Lindenberger; Wade Douglas,84,0,90,6
1683292675252,MGT 164,A00,202873,Staff,0,69,90,90
1683292676277,MGT 164GS,A00,202874,McKay; Mary A,13,0,28,15
1683292677302,MGT 180,A00,202875,Staff,0,51,90,90
1683292678331,MMW 11R,A01,205019,Herbst; Matthew,3,0,30,27
1683292678331,MMW 11R,A02,205026,Herbst; Matthew,29,0,30,1
1683292679359,MMW 15,A01,193512,Chang; Edmond Yi-Teh,0,9,28,28
1683292679359,MMW 15,A02,193513,Chang; Edmond Yi-Teh,0,5,28,28
1683292679359,MMW 15,A03,193514,Chang; Edmond Yi-Teh,0,5,28,28
1683292679359,MMW 15,A04,193515,Chang; Edmond Yi-Teh,0,4,28,28
1683292679359,MMW 15,A05,193516,Chang; Edmond Yi-Teh,0,4,28,28
1683292679359,MMW 15,A06,193517,Chang; Edmond Yi-Teh,0,5,28,28
1683292679359,MMW 15,B01,193519,Chang; Edmond Yi-Teh,0,4,28,28
1683292679359,MMW 15,B02,193520,Chang; Edmond Yi-Teh,0,5,28,28
1683292679359,MMW 15,B03,193521,Chang; Edmond Yi-Teh,0,4,28,28
1683292679359,MMW 15,B04,193522,Chang; Edmond Yi-Teh,0,4,28,28
1683292679359,MMW 15,B05,193523,Chang; Edmond Yi-Teh,0,5,28,28
1683292679359,MMW 15,B06,193524,Chang; Edmond Yi-Teh,0,4,28,28
1683292680386,MMW 122,A01,193526,Rahimi; Babak,0,14,28,28
1683292680386,MMW 122,A02,193527,Rahimi; Babak,0,14,28,28
1683292680386,MMW 122,A03,193528,Rahimi; Babak,0,0,0,0
1683292680386,MMW 122,A04,193529,Rahimi; Babak,0,0,0,0
1683292681412,MUS 1A,A01,186663,Staff,0,20,35,35
1683292682442,MUS 4,A01,186715,Staff,0,12,35,35
1683292683472,MUS 5R,A01,186796,Dubnov; Shlomo,0,16,35,35
1683292684502,MUS 6,A01,186798,Staff,0,3,25,25
1683292685527,MUS 7,A01,186830,Staff,12,0,35,23
1683292686556,MUS 8,A01,186930,Staff,0,25,35,35
1683292687582,MUS 15,A01,186932,Staff,0,15,35,35
1683292687582,MUS 15,B01,186934,Staff,0,14,35,35
1683292688606,MUS 80,A00,186935,Staff,2,0,20,18
1683292688606,MUS 80,B00,186936,Staff,25,0,25,0
1683292689643,NANO 11,A00,204702,Lipomi; Darren John,0,0,0,0
1683292690670,NANO 15,A01,204709,Yang; Kesong,0,1,0,0
1683292691697,NANO 114,A00,202069,Jahed Motlagh; Zeinab,3,0,10,7
1683292692722,PHIL 1,A00,186955,Grush; Rick Scott,32,0,40,8
1683292693754,PHIL 10,A01,186973,Grush; Rick Scott,29,0,35,6
1683292693754,PHIL 10,A02,186974,Grush; Rick Scott,33,0,35,2
1683292694782,PHIL 13,A01,186976,Staff,7,0,35,28
1683292694782,PHIL 13,A02,186977,Staff,16,0,35,19
1683292695807,PHIL 14,A01,186979,Staff,31,0,35,4
1683292695807,PHIL 14,A02,186986,Staff,32,0,35,3
1683292696833,PHIL 28,A01,186988,Staff,16,0,30,14
1683292696833,PHIL 28,A02,186989,Staff,1,0,30,29
1683292696833,PHIL 28,A03,186990,Staff,9,0,30,21
1683292696833,PHIL 28,A04,186991,Staff,26,0,30,4
1683292697859,PHIL 120,A00,186997,Staff,23,0,40,17
1683292698886,PHIL 137,A00,187003,Staff,9,0,40,31
1683292699910,PHIL 150,A00,187015,Staff,47,0,70,23
1683292700935,PHIL 167,A00,187021,Lamey; Andy M.,35,0,40,5
1683292701961,PHIL 174,A01,202226,Staff,17,0,20,3
1683292701961,PHIL 174,A02,202235,Staff,20,0,20,0
1683292702986,PHIL 191A,A00,258918,Staff,0,0,1,1
1683292704011,PHYS 1A,A00,187028,Staff,26,0,60,34
1683292705040,PHYS 1AL,001,187036,Staff,2,0,30,28
1683292705040,PHYS 1AL,002,187049,Staff,18,0,30,12
1683292706066,PHYS 1B,A00,187058,Staff,23,0,60,37
1683292707092,PHYS 1BL,001,187064,Staff,0,0,30,30
1683292707092,PHYS 1BL,002,187070,Staff,6,0,30,24
1683292708174,PHYS 1C,A00,187082,Staff,32,0,120,88
1683292709207,PHYS 1CL,001,187088,Staff,0,9,30,30
1683292709207,PHYS 1CL,002,187089,Staff,0,2,30,30
1683292709207,PHYS 1CL,009,262693,Staff,12,0,30,18
1683292710237,PHYS 2B,A01,187097,Staff,54,0,115,61
1683292711262,PHYS 2C,A01,187099,Staff,67,0,115,48
1683292712292,PHYS 2CL,A01,187101,Staff,5,0,28,23
1683292712292,PHYS 2CL,A02,187102,Staff,15,0,28,13
1683292713327,PHYS 2D,A01,187123,Shotwell; Brian,95,0,115,20
1683292714353,PHYS 4B,A01,187133,Grinstein; Benjamin,35,0,50,15
1683292715379,POLI 10,A00,188819,Staff,0,3,50,50
1683292716408,POLI 11,A00,188827,Staff,43,0,50,7
1683292717435,POLI 13R,A00,188828,Staff,0,1,20,20
1683292718465,POLI 27,A01,188830,Elgin; Samuel Zincke,0,1,70,70
1683292719491,POLI 30,A00,188832,Desposato; Scott,33,0,50,17
1683292720522,POLI 102F,A00,188834,Staff,3,0,40,37
1683292721553,POLI 104A,A00,188852,Staff,14,0,30,16
1683292722579,POLI 104I,A00,188853,Staff,0,6,20,20
1683292723609,POLI 110B,A00,188854,Wiens; David,7,0,20,13
1683292724637,POLI 112A,A00,188855,Wiens; David,5,0,30,25
1683292725666,POLI 117R,A00,188856,Forman; Fonna,0,11,20,20
1683292726696,POLI 118,A00,188857,Ingham; Sean,8,0,20,12
1683292727722,POLI 120G,A00,188858,Staff,9,0,30,21
1683292728748,POLI 131CR,A00,188863,Hoston; Germaine,24,0,50,26
1683292729776,POLI 133,A00,188864,Nellis; Gareth Hb,44,0,50,6
1683292730802,POLI 134D,A00,188865,Desposato; Scott,27,0,30,3
1683292731836,POLI 142A,A00,188871,Gartzke; Erik,22,0,50,28
1683292732866,POLI 142K,A00,188874,Staff,38,0,50,12
1683292733891,POLI 143,A00,188940,Gartzke; Erik,16,0,30,14
1683292734917,POLI 153,A00,188943,Staff,3,0,20,17
1683292735944,POLI 160AA,A00,188944,Staff,13,0,40,27
1683292736969,POLI 170A,A00,188945,Staff,11,0,30,19
1683292739021,PSYC 1,A00,188952,Staff,38,0,90,52
1683292740047,PSYC 2,B00,188953,Staff,20,0,35,15
1683292741076,PSYC 6,A00,188970,Staff,47,0,60,13
1683292742101,PSYC 7,A00,188973,Staff,37,0,45,8
1683292743133,PSYC 60,A01,188980,Rickard; Timothy C.,43,0,60,17
1683292744184,PSYC 70,A01,189001,Steiner; Eric Tomas,24,0,45,21
1683292745214,PSYC 100,A00,189005,Lacefield; Katharine I,0,99,120,120
1683292746242,PSYC 102,A00,189008,Staff,10,0,30,20
1683292747268,PSYC 106,B00,189026,Gorman; Michael R.,37,0,60,23
1683292748293,PSYC 114,B01,189033,Winkielman; Piotr,0,32,30,30
1683292749319,PSYC 131,A00,189036,Anagnostaras; Stephan,0,43,60,60
1683292750344,PSYC 136,A00,189041,Lowe; Angela Beth,0,7,25,25
1683292751374,PSYC 137,A00,189057,Winkielman; Piotr,0,34,25,25
1683292752401,PSYC 144,A00,189107,Wixted; John T,0,7,50,50
1683292754462,PSYC 162,A00,189142,Staff,0,8,85,85
1683292755491,PSYC 172,A00,189144,Gorman; Michael R.,0,7,30,30
1683292757543,PSYC 179,A00,189146,Lacefield; Katharine I,0,84,120,120
1683292758573,PSYC 181,A00,189147,Anagnostaras; Stephan,0,44,90,90
1683292759599,PSYC 190R,A00,189148,Barner; David A.,0,22,80,80
1683292760633,PSYC 191,A00,189275,Rickard; Timothy C.,0,7,25,25
1683292761658,PSYC 193,A00,189276,Chapman; Eddie Nathaniel,0,1,0,4
1683292762684,PSYC 193L,A01,189281,Lowe; Angela Beth,12,0,20,8
1683292762684,PSYC 193L,B01,189285,Staff,28,0,35,7
1683292763712,RELI 149,A00,187137,Rahimi; Babak,7,0,40,33
1683292764737,SE 9,A01,187315,Staff,0,2,18,18
1683292765762,SE 101B,A00,187409,Staff,24,0,30,6
1683292766788,SE 110B,A00,187444,Staff,10,0,40,30
1683292767814,SE 130B,A00,187449,Staff,31,0,40,9
1683292768838,SE 150A,A00,187516,Staff,9,0,20,11
1683292769862,SE 154,A00,187528,Staff,30,0,50,20
1683292770892,SIO 3,A01,258171,Staff,35,0,40,5
1683292771922,SIO 10,A00,187144,Cook; Geoffrey W,0,3,75,75
1683292772952,SIO 45,A00,187152,Cook; Geoffrey W,1,0,100,99
1683292773979,SIO 109R,A00,194486,Staff,0,3,20,20
1683292776034,SIO 187,A01,187233,Kacev; David,12,0,40,28
1683292777069,SOCI 1,A01,258656,Thorpe; Charles Robert,28,0,30,2
1683292777069,SOCI 1,A02,258658,Thorpe; Charles Robert,30,0,30,0
1683292777069,SOCI 1,A03,258661,Thorpe; Charles Robert,25,0,25,0
1683292777069,SOCI 1,A04,258666,Thorpe; Charles Robert,22,0,25,3
1683292777069,SOCI 1,A05,258897,Thorpe; Charles Robert,23,0,25,2
1683292777069,SOCI 1,A06,258898,Thorpe; Charles Robert,25,0,25,0
1683292778099,SOCI 30,A01,258903,Pardo Guerra; Juan Pablo,16,0,30,14
1683292779127,SOCI 102,A00,258904,Staff,9,0,25,16
1683292780152,SOCI 106,A00,258905,Staff,19,0,25,6
1683292781177,SOCI 111,A00,258907,Ribas Norris; Janet Vanesa,26,0,30,4
1683292782201,SOCI 121R,A00,258908,Pardo Guerra; Juan Pablo,11,0,30,19
1683292783225,SOCI 126,A01,203330,Staff,14,0,20,6
1683292784268,SOCI 131,A00,258909,Thorpe; Charles Robert,31,0,60,29
1683292785296,SOCI 135,A00,258910,Payne; Christine Anna,0,9,30,30
1683292786325,SOCI 157,A00,258911,Staff,13,0,30,17
1683292787353,SOCI 184,A00,258912,Staff,26,0,30,4
1683292788378,SOCI 188D,A00,258913,Staff,21,0,30,9
1683292789403,SYN 2,001,187529,Staff,9,0,16,7
1683292789403,SYN 2,002,201452,Staff,0,18,16,16
1683292789403,SYN 2,003,201469,Staff,3,0,16,13
1683292790431,SYN 100,A01,187531,Staff,0,9,20,20
1683292790431,SYN 100,B01,201491,Staff,0,12,20,20
1683292791465,TDAC 1,A00,189286,Walsh; Kim C.,3,0,20,17
1683292791465,TDAC 1,B00,189287,Harting; Carla Kelso,11,0,20,9
1683292792490,TDAC 101,A00,189300,Walsh; Kim C.,16,0,20,4
1683292792490,TDAC 101,B00,189301,Harting; Carla Kelso,18,0,20,2
1683292793517,TDAC 102,A00,189304,Basso; Beatrice,14,0,20,6
1683292794542,TDAC 108,A00,189305,Staff,18,0,20,2
1683292795576,TDDE 131,A00,189310,Staff,19,0,20,1
1683292795576,TDDE 131,B00,189314,Staff,19,0,20,1
1683292795576,TDDE 131,C00,189315,Staff,48,0,50,2
1683292795576,TDDE 131,D00,189316,Staff,14,0,15,1
1683292795576,TDDE 131,E00,204841,Staff,20,0,20,0
1683292796606,TDGE 10,A00,189289,Staff,30,0,50,20
1683292796606,TDGE 10,B00,189290,Havis; Allan,2,0,50,48
1683292797641,TDGE 11,A00,189291,Fulton; Julia,0,3,50,50
1683292797641,TDGE 11,B00,189292,Staff,20,0,25,5
1683292797641,TDGE 11,C00,260270,Staff,0,0,0,0
1683292798666,TDGE 25,A00,189294,Staff,3,0,20,17
1683292799690,TDGE 124,A00,189318,Fulton; Julia,0,8,50,50
1683292800715,TDGE 125,A00,189319,Staff,13,0,25,12
1683292800715,TDGE 125,B00,189320,Staff,23,0,25,2
1683292801746,TDGE 127,A00,189322,Havis; Allan,0,0,50,50
1683292802771,TDHT 101,A00,189323,Staff,18,0,25,7
1683292802771,TDHT 101,B00,189324,Staff,25,0,25,0
1683292803796,TDHT 102,A00,189325,Staff,49,0,50,1
1683292804829,TDMV 1,A00,189295,Arcidiacono; Kristin,20,0,30,10
1683292804829,TDMV 1,B00,189296,Caligagan; Maria T.,24,0,30,6
1683292805859,TDMV 2,A00,189297,Sammartano; Tonnie,28,0,30,2
1683292805859,TDMV 2,B00,189299,Arcidiacono; Kristin,24,0,30,6
1683292806891,TDMV 3,A00,204998,Rincon; Alicia,22,0,30,8
1683292807922,TDMV 120,A00,189458,Sammartano; Tonnie,28,0,30,2
1683292808955,TDMV 138,A00,189541,Jun; Grace Shin Hae,22,0,40,18
1683292809981,TDMV 142,A00,189717,Caligagan; Tony,23,0,30,7
1683292809981,TDMV 142,B00,189718,Caligagan; Maria T.,25,0,30,5
1683292811011,TMC 2,A01,187533,Staff,25,0,25,0
1683292811011,TMC 2,A02,187534,Staff,25,0,25,0
1683292812094,USP 1,A01,187536,Kwak; Nancy,0,16,25,25
1683292813120,USP 5,A01,187538,Staff,9,0,25,16
1683292814151,USP 101,A00,199253,Staff,0,4,0,0
1683292815178,USP 124,A00,187562,Boomhower; Matthew Charles,1,0,30,29
1683292816203,USP 138,A00,187582,Staff,20,0,25,5
1683292817228,USP 152,A01,187597,Staff,4,0,25,21
1683292818255,USP 153,A00,187598,Staff,19,0,25,6
1683292819280,USP 168,A00,187607,Kwak; Nancy,2,0,5,3
1683292820307,USP 173,A00,187619,Staff,4,0,25,21
1683292821337,USP 181,A00,187638,Staff,0,0,25,25
1683292822369,VIS 103,A00,187650,Cruz; Edwin Teddy,23,0,75,52
1683292823397,VIS 110D,A00,187669,Staff,12,0,22,10
1683292824427,VIS 127C,A00,187720,Shen; Kuiyi,68,0,146,78
1683292825455,VIS 149,A00,187731,Yoldas; Pinar,0,14,22,22
1683292826486,VIS 151,A01,188091,Staff,22,0,34,12
1683292826486,VIS 151,A02,188092,Staff,11,0,34,23
1683292827515,VIS 160B,A00,188093,Stalbaum; Brett,0,0,10,10
1683292829571,WCWP 10B,A00,201720,Staff,10,0,15,5
1683292829571,WCWP 10B,B00,201722,Staff,8,0,15,7
1683292830599,WCWP 100,A00,201725,Gagnon; Jeffrey C,0,0,2,2
1683292830599,WCWP 100,B00,201727,Staff,0,4,15,15
1683292833717,ANBI 133,A00,258401,Wilder; Linnea Lorene,34,0,40,6
1683292834742,ANBI 140,A00,258395,Hrvoj Mihic; Branka,18,0,25,7
1683292835771,ANSC 120,A00,258402,Bialecki; Jon Anthony,27,0,40,13
1683292836798,ANSC 144,A00,258400,Staff,14,0,40,26
1683292838855,ANSC 166,A00,258396,Parish; Steven Martin,157,0,175,18
1683292839879,ANSC 180,A00,193533,Staff,9,0,20,11
1683292840904,ANSC 188,A00,258397,Jassal; Aftab,33,0,40,7
1683292841928,ANTH 3,A01,258316,Staff,23,0,30,7
1683292842953,ANTH 5,A00,258394,Semendeferi; Ekaterini,16,0,20,4
1683292843981,ANTH 21,A01,258331,Staff,9,0,40,31
1683292845005,ANTH 103,A00,258398,Varma; Saiba,15,0,25,10
1683292846033,AWP 10,001,202034,Staff,0,0,0,0
1683292846033,AWP 10,002,202035,Staff,0,0,0,0
1683292846033,AWP 10,003,202036,Staff,0,0,0,0
1683292846033,AWP 10,004,202037,Staff,0,0,0,0
1683292846033,AWP 10,005,202038,Staff,0,0,0,0
1683292846033,AWP 10,006,202039,Staff,0,0,0,0
1683292846033,AWP 10,007,202040,Staff,0,0,0,0
1683292846033,AWP 10,008,202041,Staff,0,0,0,0
1683292846033,AWP 10,009,202042,Staff,0,0,0,0
1683292846033,AWP 10,010,202043,Staff,0,0,0,0
1683292846033,AWP 10,011,202044,Staff,0,0,0,0
1683292846033,AWP 10,012,202045,Staff,0,0,0,0
1683292846033,AWP 10,013,202046,Staff,0,0,0,0
1683292846033,AWP 10,014,202047,Staff,0,0,0,0
1683292846033,AWP 10,015,202048,Staff,0,0,0,0
1683292846033,AWP 10,016,202049,Staff,0,0,0,0
1683292846033,AWP 10,017,202050,Staff,0,0,0,0
1683292846033,AWP 10,018,202051,Staff,0,0,0,0
1683292846033,AWP 10,019,202052,Staff,0,0,0,0
1683292846033,AWP 10,020,202053,Staff,0,0,0,0
1683292846033,AWP 10,021,202054,Staff,0,0,0,0
1683292846033,AWP 10,022,202055,Staff,0,0,0,0
1683292846033,AWP 10,023,202056,Staff,0,0,0,0
1683292846033,AWP 10,024,202057,Staff,0,0,0,0
1683292846033,AWP 10,025,202058,Staff,0,0,0,0
1683292846033,AWP 10,026,202059,Staff,0,0,0,0
1683292847057,AWP 102,001,202032,Staff,0,0,0,0
1683292847057,AWP 102,002,202033,Staff,0,0,0,0
1683292848083,BENG 100,A01,254234,Taylor Amos; Alyssa C,31,0,40,9
1683292849107,BENG 196,001,270013,Engler; Adam J.,9999,0,9999,0
1683292850134,BICD 100R,A01,202018,Smith; Laurie,0,7,32,32
1683292850134,BICD 100R,A02,202019,Smith; Laurie,0,2,32,32
1683292850134,BICD 100R,A03,202020,Smith; Laurie,0,1,32,32
1683292850134,BICD 100R,A04,202021,Smith; Laurie,8,0,32,24
1683292850134,BICD 100R,A05,202022,Smith; Laurie,12,0,32,20
1683292851162,BICD 136,A01,193242,Gustafson-Brown; Cindy,0,2,32,32
1683292851162,BICD 136,A02,193244,Gustafson-Brown; Cindy,15,0,32,17
1683292852189,BIEB 102,A01,193249,Butler; Shannon Rhey,0,2,32,32
1683292852189,BIEB 102,A02,193251,Butler; Shannon Rhey,0,0,32,32
1683292852189,BIEB 102,A03,193253,Butler; Shannon Rhey,0,1,32,32
1683292852189,BIEB 102,A04,193255,Butler; Shannon Rhey,17,0,32,15
1683292852189,BIEB 102,A05,193265,Butler; Shannon Rhey,26,0,32,6
1683292852189,BIEB 102,A06,193269,Butler; Shannon Rhey,16,0,32,16
1683292854245,BIEB 150,A01,193274,Staff,0,0,32,32
1683292854245,BIEB 150,A02,193285,Staff,24,0,32,8
1683292855286,BIEB 194,A00,193286,Kurle; Carolyn M.,22,0,32,10
1683292856320,BILD 1,A01,192291,Staff,16,0,32,16
1683292856320,BILD 1,A02,192292,Staff,30,0,32,2
1683292856320,BILD 1,B01,192520,Reuther; Keefe,0,1,0,0
1683292856320,BILD 1,B02,192532,Reuther; Keefe,0,1,0,0
1683292857352,BILD 3,A01,192556,Butler; Shannon Rhey,0,0,32,32
1683292857352,BILD 3,A02,192581,Butler; Shannon Rhey,5,0,32,27
1683292857352,BILD 3,A03,192611,Butler; Shannon Rhey,23,0,32,9
1683292857352,BILD 3,A04,192612,Butler; Shannon Rhey,25,0,32,7
1683292857352,BILD 3,A05,192613,Butler; Shannon Rhey,27,0,32,5
1683292857352,BILD 3,A06,192679,Butler; Shannon Rhey,27,0,32,5
1683292857352,BILD 3,A07,192682,Butler; Shannon Rhey,22,0,32,10
1683292858379,BILD 4,A01,192836,Reuther; Keefe,1,0,24,23
1683292858379,BILD 4,A02,193044,Reuther; Keefe,4,0,24,20
1683292859405,BILD 10,A01,193142,Gustafson-Brown; Cindy,31,0,32,1
1683292859405,BILD 10,A02,193149,Gustafson-Brown; Cindy,31,0,32,1
1683292860431,BIMM 100,A01,193301,Staff,0,6,32,32
1683292860431,BIMM 100,A02,193312,Staff,0,5,32,32
1683292860431,BIMM 100,A03,193323,Staff,0,8,32,32
1683292861463,BIMM 101,A01,193329,McDonnell; Lisa Marie,0,3,24,24
1683292861463,BIMM 101,A02,193339,McDonnell; Lisa Marie,0,2,24,24
1683292861463,BIMM 101,B01,193354,McDonnell; Lisa Marie,0,3,24,24
1683292861463,BIMM 101,B02,193357,McDonnell; Lisa Marie,0,3,24,24
1683292862492,BIMM 110,A01,193377,Tat; John,0,11,32,32
1683292862492,BIMM 110,A02,193378,Tat; John,1,9,32,31
1683292863518,BIMM 120,A01,206116,Staff,0,0,32,32
1683292863518,BIMM 120,A02,206117,Staff,8,0,32,24
1683292863518,BIMM 120,A03,206121,Staff,21,0,32,11
1683292864549,BIPN 100,A01,193393,Park; Ji Young,0,14,32,32
1683292864549,BIPN 100,A02,193402,Park; Ji Young,0,12,32,32
1683292864549,BIPN 100,A03,193413,Park; Ji Young,0,14,32,32
1683292864549,BIPN 100,A04,193414,Park; Ji Young,0,13,32,32
1683292865578,BIPN 102,A01,193429,Staff,0,0,32,32
1683292865578,BIPN 102,A02,193438,Staff,23,0,32,9
1683292866608,BIPN 106,A01,193450,Reyes Gonzalez; Catalina,0,2,40,40
1683292867639,BIPN 134,A01,193465,Cooke; James Edward,0,0,32,32
1683292867639,BIPN 134,A02,193474,Cooke; James Edward,27,0,32,5
1683292867639,BIPN 134,A03,193485,Cooke; James Edward,29,0,32,3
1683292867639,BIPN 134,A04,193486,Cooke; James Edward,21,0,32,11
1683292867639,BIPN 134,A05,193491,Cooke; James Edward,31,0,32,1
1683292867639,BIPN 134,A06,193501,Cooke; James Edward,30,0,32,2
1683292867639,BIPN 134,A07,193510,Cooke; James Edward,29,0,32,3
1683292869691,BISP 194,A00,222522,Staff,16,0,32,16
1683292870721,CAT 124,A01,202407,Staff,20,0,25,5
1683292871754,CAT 125,A00,202408,Marchisotto; Jennifer Anne,4,0,20,16
1683292872789,CAT 125R,A00,202409,Smith; Lauryn Alissa,0,11,20,20
1683292872789,CAT 125R,B00,202410,Morales; Celeste Georgianna,0,11,20,20
1683292872789,CAT 125R,C00,202411,Irwin; Matthew Joseph,0,10,20,20
1683292873822,CENG 15,A01,204712,Yang; Kesong,0,1,0,0
1683292874854,CENG 114,A00,202070,Jahed Motlagh; Zeinab,5,0,20,15
1683292875880,CGS 105,A00,185477,Wesling; Megan E.,24,0,40,16
1683292876910,CGS 106,A00,185494,Staff,13,0,22,9
1683292877939,CGS 108,A00,185495,Staff,14,0,20,6
1683292878966,CGS 114,A00,185496,Staff,13,0,18,5
1683292879990,CGS 119,A00,185501,Staff,15,0,20,5
1683292881015,CGS 120,A00,185511,Staff,13,0,20,7
1683292882041,CHEM 4,A01,184675,Bussey; Thomas J,96,0,100,4
1683292883066,CHEM 6A,A01,184677,Staff,35,0,60,25
1683292884094,CHEM 6B,A01,184679,Staff,65,0,100,35
1683292885120,CHEM 6C,A01,184681,Bussey; Thomas J,1,0,50,49
1683292885120,CHEM 6C,A02,184682,Bussey; Thomas J,34,0,50,16
1683292886147,CHEM 40A,A01,184684,Albizati; Kim F.,37,0,100,63
1683292887172,CHEM 40B,A01,184686,Albizati; Kim F.,0,20,100,100
1683292888196,CHEM 41B,A01,184690,Staff,52,0,100,48
1683292889227,COGS 3,A01,184715,Boyle; Mary E. T.,0,25,40,40
1683292890255,COGS 14B,A01,185172,Staff,0,15,38,38
1683292891283,COGS 18,A01,184736,Staff,20,0,80,60
1683292892308,COGS 100,A01,184932,Staff,0,5,73,73
1683292893333,COGS 101A,A01,184935,Staff,0,38,30,30
1683292894359,COGS 101B,A01,184944,Staff,0,2,30,30
1683292895385,COGS 101C,A01,184946,Staff,0,12,30,30
1683292896412,COGS 102A,A01,184951,Johnson; Christine M.,2,0,40,38
1683292897437,COGS 107B,A01,184953,Mooshagian; Eric Frederick,0,50,40,40
1683292898463,COGS 118B,A01,184959,Gupta; Anjum,0,48,40,40
1683292899489,COGS 153,A00,184961,Staff,0,15,30,30
1683292900515,COGS 177,A00,184962,Staff,0,21,30,30
1683292901539,COGS 187A,A01,184969,Boyle; Mary E. T.,0,17,40,40
1683292902565,COMM 10,A01,185174,Staff,0,5,25,25
1683292902565,COMM 10,A02,185189,Staff,0,5,25,25
1683292902565,COMM 10,A03,269821,Staff,0,0,0,0
1683292903590,COMM 100B,A01,185475,Staff,0,0,0,2
1683292903590,COMM 100B,A02,185476,Staff,14,0,25,11
1683292904616,COMM 100C,A01,185314,Staff,1,0,25,24
1683292904616,COMM 100C,A02,185327,Staff,19,0,25,6
1683292905641,COMM 110M,A00,185349,Staff,2,0,40,38
1683292906666,COMM 113T,A00,185352,Staff,25,0,40,15
1683292907691,COMM 114I,A00,185353,Staff,33,0,40,7
1683292908716,COMM 131,A00,185354,Staff,19,0,30,11
1683292909742,CSE 8A,A50,185358,Cao; Yingjun,0,46,10,10
1683292910770,CSE 8B,A01,185362,Staff,0,47,50,50
1683292911799,CSE 11,A01,185416,Cao; Yingjun,0,93,10,10
1683292912830,CSE 20,A01,185445,Briones; Jor-el Thomas Caparas,5,0,25,20
1683292913860,CSE 21,A01,185447,Staff,10,0,50,40
1683292914891,CSE 101,A01,185451,Staff,0,12,50,50
1683292914891,CSE 101,B01,185453,Jones; Miles E,0,11,50,50
1683292916997,CSE 141,A01,185458,Eldon; John,20,0,100,80
1683292918026,CSE 141L,A01,185461,Eldon; John,12,0,100,88
1683292919052,CSE 142,A01,185463,Staff,35,0,60,25
1683292919052,CSE 142,B01,201355,Staff,0,6,60,60
1683292920077,CSE 142L,A01,185470,Staff,35,0,60,25
1683292920077,CSE 142L,B01,201417,Staff,0,5,60,60
1683292921103,CSE 190,A00,201433,Staff,32,0,49,17
1683292922140,DOC 1,A01,259136,Strom; Megan C.,8,0,15,7
1683292922140,DOC 1,A02,259137,Strom; Megan C.,14,0,15,1
1683292922140,DOC 1,A03,259138,Strom; Megan C.,14,0,15,1
1683292922140,DOC 1,A04,259139,Strom; Megan C.,14,0,15,1
1683292923166,DOC 100D,A00,259140,Pass; Natalye Joann,17,0,25,8
1683292924198,DSGN 1,A01,184749,Rill; Bryan,0,24,30,30
1683292925226,DSGN 100,A01,185168,Staff,0,2,25,25
1683292926255,ECE 5,A01,185626,Morris; Karcher William,0,10,0,0
1683292927283,ECE 101,A01,185628,Staff,17,0,70,53
1683292928309,ECE 107,A01,185635,Baghdadchi; Saharnaz,0,0,20,20
1683292928309,ECE 107,A02,185638,Baghdadchi; Saharnaz,4,0,20,16
1683292929334,ECE 148,A01,185647,Silberman; Jack,1,0,16,15
1683292930358,ECON 1,A01,185537,Crane; Meredith Helen,54,0,70,16
1683292931386,ECON 3,A01,185549,Crane; Meredith Helen,33,0,70,37
1683292932413,ECON 4,A01,203354,Anderson; John Charles,0,4,10,10
1683292933439,ECON 100A,A01,185574,Staff,0,4,40,40
1683292934464,ECON 100B,A01,185576,Staff,0,22,40,40
1683292935497,ECON 100C,A01,185589,Newhouse; Herbert S,30,0,70,40
1683292936528,ECON 105,A00,185608,Vespa; Emanuel Ignacio,19,0,35,16
1683292937557,ECON 109,A01,185610,Shishkin; Denis,10,0,35,25
1683292938585,ECON 110A,A01,185612,Staff,11,0,40,29
1683292939610,ECON 120A,A01,185615,Staff,20,0,40,20
1683292940637,ECON 120C,A01,185617,Sun; Yixiao,0,20,70,70
1683292941665,ECON 144,A00,203346,Squires; Dale E,3,0,35,32
1683292942690,ECON 171,A01,203349,Newhouse; Herbert S,0,1,35,35
1683292943716,ECON 173A,A01,185621,Toda; Alexis Akira,21,0,35,14
1683292944745,EDS 25,A01,202413,Staff,0,1,0,0
1683292944745,EDS 25,A02,202414,Staff,0,1,0,0
1683292944745,EDS 25,A03,202415,Staff,0,0,0,0
1683292944745,EDS 25,A04,202416,Staff,0,1,0,0
1683292944745,EDS 25,A05,202439,Staff,0,0,0,0
1683292944745,EDS 25,A06,202440,Staff,0,0,0,0
1683292944745,EDS 25,B01,202631,Staff,0,0,0,0
1683292944745,EDS 25,B02,202632,Staff,0,0,0,0
1683292944745,EDS 25,B03,202639,Staff,0,0,0,0
1683292944745,EDS 25,B04,202640,Staff,0,0,0,0
1683292944745,EDS 25,B05,202643,Staff,0,0,0,0
1683292944745,EDS 25,B06,202644,Staff,0,0,0,0
1683292945770,EDS 38,A01,202659,Black; Alison Michelle,24,0,25,1
1683292946795,EDS 115,A00,202652,Staff,17,0,30,13
1683292947825,EDS 125,A00,202649,Staff,14,0,30,16
1683292948852,EDS 126,A01,203332,Staff,30,0,30,0
1683292949881,EDS 139,A00,202838,Staff,17,0,25,8
1683292950908,EDS 146,A01,202655,Staff,15,0,25,10
1683292951935,ENG 15,A00,185667,Staff,0,1,0,0
1683292951935,ENG 15,B00,185672,Staff,0,0,0,0
1683292951935,ENG 15,C00,185675,Staff,0,0,0,0
1683292951935,ENG 15,D00,185682,Staff,0,0,0,0
1683292951935,ENG 15,E00,185684,Staff,0,0,0,0
1683292952961,ETHN 103,A00,185710,Staff,0,3,35,35
1683292953988,ETHN 103A,A00,199228,Man; Simeon S,3,0,9,6
1683292955013,ETHN 109,A00,185711,Staff,18,0,35,17
1683292956038,ETHN 142,A00,185726,Staff,0,4,30,30
1683292957069,ETHN 163J,A00,199229,Man; Simeon S,6,0,8,2
1683292958096,ETHN 168,A00,185727,Staff,8,0,10,2
1683292959121,ETHN 182,A00,185728,Staff,1,0,35,34
1683292960142,ETHN 183,A00,185737,Staff,8,0,18,10
1683292961167,GLBH 111,A01,209361,Burgos; Jose L.,0,0,0,0
1683292963216,HIEU 104,A00,185792,Staff,16,0,20,4
1683292964241,HIEU 115,A00,185800,Staff,1,0,20,19
1683292965273,HIEU 128,A00,185801,Staff,0,7,20,20
1683292966298,HIEU 147,A00,185802,Staff,16,0,20,4
1683292967332,HIEU 154,A00,185823,Staff,12,0,20,8
1683292968357,HILA 102,A00,185826,Staff,13,0,20,7
1683292969382,HILD 2C,A01,185778,Staff,0,12,20,20
1683292970408,HILD 7B,A01,185780,Kwak; Nancy,0,15,32,32
1683292970408,HILD 7B,A02,185781,Kwak; Nancy,0,18,32,32
1683292971433,HILD 30,A01,185791,Staff,14,0,20,6
1683292972458,HISC 119,A00,185830,Golan; Tal,0,9,20,20
1683292973487,HITO 156GS,A00,185831,Patterson; Patrick H.,0,0,0,23
1683292974516,HIUS 103,A00,185832,Man; Simeon S,0,7,20,20
1683292975544,HIUS 117,A00,185836,Kwak; Nancy,2,0,20,18
1683292976569,HIUS 125,A00,185840,Man; Simeon S,0,0,23,23
1683292977594,HIUS 149,A00,185845,Staff,0,0,20,20
1683292978622,HUM 3,A01,185882,Zavodny; Tatiana Sophia,0,6,50,50
1683292978622,HUM 3,B01,185899,Caldwell; Michael Alan,0,19,50,50
1683292979650,HUM 3GS,A00,185900,Patterson; Patrick H.,0,0,0,23
1683292980684,HUM 4,A01,185938,Zroka; Amy Liane,31,0,50,19
1683292980684,HUM 4,B01,185956,Watkins; Eric,0,2,50,50
1683292980684,HUM 4,B02,202209,Watkins; Eric,0,1,50,50
1683292980684,HUM 4,B03,202210,Watkins; Eric,0,0,50,50
1683292981714,HUM 5,A01,185958,West; Geoffrey Scott,5,0,50,45
1683292981714,HUM 5,A02,202215,West; Geoffrey Scott,0,0,50,50
1683292982744,INTL 190,A00,185959,Gagnon; Jeffrey C,0,0,0,9
1683292982744,INTL 190,B00,185960,Lettieri; Michael Joseph,0,0,0,1
1683292983769,JAPN 180,A00,254509,Staff,0,1,25,25
1683292984801,LATI 10,A01,202853,Kennemore; Amy Michelle,5,0,35,30
1683292984801,LATI 10,A02,202854,Kennemore; Amy Michelle,1,0,35,34
1683292984801,LATI 10,A03,270054,Kennemore; Amy Michelle,30,0,30,0
1683292985826,LATI 180,A00,202855,Kennemore; Amy Michelle,11,0,20,9
1683292986851,LAWS 101,A00,201767,Golan; Tal,0,7,40,40
1683292987875,LIFR 1C,A00,185961,Staff,6,0,20,14
1683292988902,LIFR 1CX,A00,185962,Staff,7,0,20,13
1683292989927,LIFR 1D,A00,185963,Staff,9,0,20,11
1683292990953,LIFR 1DX,A00,185964,Staff,9,0,20,11
1683292991982,LIGN 101,A01,186039,Staff,43,0,50,7
1683292993017,LIGN 165,A00,186040,Staff,18,0,50,32
1683292994043,LTCS 108,A00,186041,Staff,6,0,10,4
1683292995069,LTCS 119,A00,186042,Staff,16,0,20,4
1683292996094,LTCS 130,A00,186043,Wesling; Megan E.,15,0,25,10
1683292998147,LTEA 138,A00,186119,Staff,14,0,40,26
1683292999176,LTEN 124,A00,186148,Staff,6,0,25,19
1683293000205,LTEN 178,A00,186149,Staff,7,0,15,8
1683293001230,LTEN 181,A00,186150,Blanco; John D,33,0,40,7
1683293002254,LTWL 120,A00,186160,Staff,20,0,25,5
1683293003279,LTWL 165,A00,186161,Staff,22,0,25,3
1683293004305,LTWR 100,A00,186162,Staff,0,4,15,15
1683293005331,LTWR 102,A00,186163,Doller; Ben,5,0,15,10
1683293006357,MAE 8,A01,186412,Staff,0,0,0,0
1683293007383,MAE 30B,A00,186445,Bahadori; Mohammad Yousef,83,0,100,17
1683293008408,MAE 40,A00,186592,Bewley; Thomas R,9,0,50,41
1683293009436,MAE 101B,A00,186593,Bahadori; Mohammad Yousef,81,0,100,19
1683293010460,MAE 105,A00,186594,Bandaru; Prabhakar,12,0,50,38
1683293011486,MAE 107,A00,186599,Pham; Hieu Tan,0,6,120,120
1683293012513,MAE 148,A01,186660,Silberman; Jack,3,0,16,13
1683293013539,MATH 10A,A01,188095,Staff,0,7,35,35
1683293014566,MATH 10B,A01,188097,Bowers; Adam R.,0,11,30,30
1683293014566,MATH 10B,A02,188099,Bowers; Adam R.,0,9,30,30
1683293014566,MATH 10B,B01,188104,Bowers; Adam R.,0,11,30,30
1683293014566,MATH 10B,B02,188106,Bowers; Adam R.,0,11,30,30
1683293015594,MATH 10C,A01,188111,Staff,0,18,30,30
1683293015594,MATH 10C,A02,188127,Staff,0,17,30,30
1683293015594,MATH 10C,A03,188131,Staff,0,17,30,30
1683293015594,MATH 10C,B01,188218,Staff,21,0,30,9
1683293015594,MATH 10C,B02,188244,Staff,13,0,30,17
1683293015594,MATH 10C,B03,188277,Staff,16,0,30,14
1683293016620,MATH 18,A01,188344,Bach; Quang Tran,18,0,30,12
1683293016620,MATH 18,A02,188345,Bach; Quang Tran,11,0,30,19
1683293016620,MATH 18,B01,188353,Bach; Quang Tran,10,0,30,20
1683293016620,MATH 18,B02,188354,Bach; Quang Tran,20,0,30,10
1683293017646,MATH 20A,A01,188374,Staff,13,0,35,22
1683293018673,MATH 20B,A01,188382,Ohm; Ko Woon,6,0,30,24
1683293018673,MATH 20B,A02,188383,Ohm; Ko Woon,24,0,30,6
1683293018673,MATH 20B,B01,188385,Ohm; Ko Woon,7,0,30,23
1683293018673,MATH 20B,B02,188392,Ohm; Ko Woon,22,0,30,8
1683293019756,MATH 20C,A01,188394,Harel; Guershon,10,0,30,20
1683293019756,MATH 20C,A02,188395,Harel; Guershon,13,0,30,17
1683293019756,MATH 20C,B01,188404,Harel; Guershon,3,0,30,27
1683293019756,MATH 20C,B02,188405,Harel; Guershon,19,0,30,11
1683293020782,MATH 20D,A01,188414,Hammock; Frances H,0,1,30,30
1683293020782,MATH 20D,A02,188415,Hammock; Frances H,4,0,30,26
1683293020782,MATH 20D,B01,188447,Hammock; Frances H,2,0,30,28
1683293020782,MATH 20D,B02,188486,Hammock; Frances H,8,0,30,22
1683293021808,MATH 20E,A01,188649,Staff,22,0,30,8
1683293021808,MATH 20E,A02,188650,Staff,23,0,30,7
1683293021808,MATH 20E,A03,188673,Staff,0,0,30,30
1683293022833,MATH 102,A01,188675,Staff,0,35,35,35
1683293023859,MATH 103B,A01,188681,Staff,4,0,35,31
1683293023859,MATH 103B,B01,188692,Staff,8,0,35,27
1683293024885,MATH 109,A01,188695,Salehi Golsefidy; Alireza,25,0,35,10
1683293024885,MATH 109,A02,188696,Salehi Golsefidy; Alireza,27,0,35,8
1683293025914,MATH 120A,A01,188698,Eggers; John Dietrich,5,0,35,30
1683293026941,MATH 142B,A01,188736,Ioana; Adrian,0,2,30,30
1683293026941,MATH 142B,A02,188741,Ioana; Adrian,0,1,30,30
1683293026941,MATH 142B,A03,188743,Ioana; Adrian,0,3,30,30
1683293027971,MATH 168A,A01,188790,Staff,0,8,35,35
1683293029002,MATH 170A,A01,188803,Nie; Jiawang,0,2,35,35
1683293029002,MATH 170A,A02,188811,Nie; Jiawang,0,0,35,35
1683293029002,MATH 170A,A03,188814,Nie; Jiawang,1,0,35,34
1683293029002,MATH 170A,A04,188815,Nie; Jiawang,14,0,35,21
1683293030031,MATH 193B,A01,188817,Staff,0,0,35,35
1683293030031,MATH 193B,A02,188818,Staff,5,0,35,30
1683293031056,MGT 4,A01,202857,Anderson; John Charles,62,0,80,18
1683293032080,MGT 12,A00,202858,Lindenberger; Wade Douglas,43,0,90,47
1683293033105,MGT 18,A00,202859,Staff,74,0,90,16
1683293034130,MGT 18GS,A00,202860,McKay; Michael J,13,0,28,15
1683293035157,MGT 45,A00,202861,Pecore; Joseph P.,14,0,90,76
1683293036182,MGT 100,A00,202863,Yavorsky; Daniel Ryan,28,0,90,62
1683293037206,MGT 103,A00,202864,Ehrich; Kristine R,0,16,90,90
1683293038233,MGT 112,A00,202865,Ehrich; Kristine R,15,0,90,75
1683293039259,MGT 121A,A00,202868,Staff,0,19,0,0
1683293040292,MGT 131B,A00,202869,Anderson; John Charles,59,0,90,31
1683293041319,MGT 136,A00,202871,Lindenberger; Wade Douglas,84,0,90,6
1683293042344,MGT 164,A00,202873,Staff,0,69,90,90
1683293043372,MGT 164GS,A00,202874,McKay; Mary A,13,0,28,15
1683293044401,MGT 180,A00,202875,Staff,0,51,90,90
1683293045427,MMW 11R,A01,205019,Herbst; Matthew,3,0,30,27
1683293045427,MMW 11R,A02,205026,Herbst; Matthew,29,0,30,1
1683293046455,MMW 15,A01,193512,Chang; Edmond Yi-Teh,0,9,28,28
1683293046455,MMW 15,A02,193513,Chang; Edmond Yi-Teh,0,5,28,28
1683293046455,MMW 15,A03,193514,Chang; Edmond Yi-Teh,0,5,28,28
1683293046455,MMW 15,A04,193515,Chang; Edmond Yi-Teh,0,4,28,28
1683293046455,MMW 15,A05,193516,Chang; Edmond Yi-Teh,0,4,28,28
1683293046455,MMW 15,A06,193517,Chang; Edmond Yi-Teh,0,5,28,28
1683293046455,MMW 15,B01,193519,Chang; Edmond Yi-Teh,0,4,28,28
1683293046455,MMW 15,B02,193520,Chang; Edmond Yi-Teh,0,5,28,28
1683293046455,MMW 15,B03,193521,Chang; Edmond Yi-Teh,0,4,28,28
1683293046455,MMW 15,B04,193522,Chang; Edmond Yi-Teh,0,4,28,28
1683293046455,MMW 15,B05,193523,Chang; Edmond Yi-Teh,0,5,28,28
1683293046455,MMW 15,B06,193524,Chang; Edmond Yi-Teh,0,4,28,28
1683293047482,MMW 122,A01,193526,Rahimi; Babak,0,14,28,28
1683293047482,MMW 122,A02,193527,Rahimi; Babak,0,14,28,28
1683293047482,MMW 122,A03,193528,Rahimi; Babak,0,0,0,0
1683293047482,MMW 122,A04,193529,Rahimi; Babak,0,0,0,0
1683293048510,MUS 1A,A01,186663,Staff,0,20,35,35
1683293049537,MUS 4,A01,186715,Staff,0,12,35,35
1683293050563,MUS 5R,A01,186796,Dubnov; Shlomo,0,16,35,35
1683293051589,MUS 6,A01,186798,Staff,0,3,25,25
1683293052619,MUS 7,A01,186830,Staff,12,0,35,23
1683293053648,MUS 8,A01,186930,Staff,0,25,35,35
1683293054679,MUS 15,A01,186932,Staff,0,15,35,35
1683293054679,MUS 15,B01,186934,Staff,0,14,35,35
1683293055706,MUS 80,A00,186935,Staff,2,0,20,18
1683293055706,MUS 80,B00,186936,Staff,25,0,25,0
1683293056735,NANO 11,A00,204702,Lipomi; Darren John,0,0,0,0
1683293057767,NANO 15,A01,204709,Yang; Kesong,0,1,0,0
1683293058799,NANO 114,A00,202069,Jahed Motlagh; Zeinab,3,0,10,7
1683293059825,PHIL 1,A00,186955,Grush; Rick Scott,32,0,40,8
1683293060855,PHIL 10,A01,186973,Grush; Rick Scott,29,0,35,6
1683293060855,PHIL 10,A02,186974,Grush; Rick Scott,33,0,35,2
1683293061880,PHIL 13,A01,186976,Staff,7,0,35,28
1683293061880,PHIL 13,A02,186977,Staff,16,0,35,19
1683293062908,PHIL 14,A01,186979,Staff,31,0,35,4
1683293062908,PHIL 14,A02,186986,Staff,32,0,35,3
1683293063938,PHIL 28,A01,186988,Staff,16,0,30,14
1683293063938,PHIL 28,A02,186989,Staff,1,0,30,29
1683293063938,PHIL 28,A03,186990,Staff,9,0,30,21
1683293063938,PHIL 28,A04,186991,Staff,26,0,30,4
1683293064965,PHIL 120,A00,186997,Staff,23,0,40,17
1683293065990,PHIL 137,A00,187003,Staff,9,0,40,31
1683293067019,PHIL 150,A00,187015,Staff,47,0,70,23
1683293068045,PHIL 167,A00,187021,Lamey; Andy M.,35,0,40,5
1683293069071,PHIL 174,A01,202226,Staff,17,0,20,3
1683293069071,PHIL 174,A02,202235,Staff,20,0,20,0
1683293070096,PHIL 191A,A00,258918,Staff,0,0,1,1
1683293071121,PHYS 1A,A00,187028,Staff,26,0,60,34
1683293072151,PHYS 1AL,001,187036,Staff,2,0,30,28
1683293072151,PHYS 1AL,002,187049,Staff,18,0,30,12
1683293073179,PHYS 1B,A00,187058,Staff,23,0,60,37
1683293074207,PHYS 1BL,001,187064,Staff,0,0,30,30
1683293074207,PHYS 1BL,002,187070,Staff,6,0,30,24
1683293075232,PHYS 1C,A00,187082,Staff,32,0,120,88
1683293076259,PHYS 1CL,001,187088,Staff,0,9,30,30
1683293076259,PHYS 1CL,002,187089,Staff,0,2,30,30
1683293076259,PHYS 1CL,009,262693,Staff,12,0,30,18
1683293077286,PHYS 2B,A01,187097,Staff,54,0,115,61
1683293078311,PHYS 2C,A01,187099,Staff,67,0,115,48
1683293079338,PHYS 2CL,A01,187101,Staff,5,0,28,23
1683293079338,PHYS 2CL,A02,187102,Staff,15,0,28,13
1683293080366,PHYS 2D,A01,187123,Shotwell; Brian,95,0,115,20
1683293081396,PHYS 4B,A01,187133,Grinstein; Benjamin,35,0,50,15
1683293082423,POLI 10,A00,188819,Staff,0,3,50,50
1683293083450,POLI 11,A00,188827,Staff,43,0,50,7
1683293084477,POLI 13R,A00,188828,Staff,0,1,20,20
1683293085515,POLI 27,A01,188830,Elgin; Samuel Zincke,0,1,70,70
1683293086545,POLI 30,A00,188832,Desposato; Scott,33,0,50,17
1683293087574,POLI 102F,A00,188834,Staff,3,0,40,37
1683293088599,POLI 104A,A00,188852,Staff,14,0,30,16
1683293089628,POLI 104I,A00,188853,Staff,0,6,20,20
1683293090654,POLI 110B,A00,188854,Wiens; David,7,0,20,13
1683293091679,POLI 112A,A00,188855,Wiens; David,5,0,30,25
1683293092704,POLI 117R,A00,188856,Forman; Fonna,0,11,20,20
1683293093731,POLI 118,A00,188857,Ingham; Sean,8,0,20,12
1683293094756,POLI 120G,A00,188858,Staff,9,0,30,21
1683293095781,POLI 131CR,A00,188863,Hoston; Germaine,24,0,50,26
1683293096810,POLI 133,A00,188864,Nellis; Gareth Hb,44,0,50,6
1683293097835,POLI 134D,A00,188865,Desposato; Scott,27,0,30,3
1683293098860,POLI 142A,A00,188871,Gartzke; Erik,22,0,50,28
1683293099885,POLI 142K,A00,188874,Staff,38,0,50,12
1683293100910,POLI 143,A00,188940,Gartzke; Erik,16,0,30,14
1683293101940,POLI 153,A00,188943,Staff,3,0,20,17
1683293102968,POLI 160AA,A00,188944,Staff,13,0,40,27
1683293103993,POLI 170A,A00,188945,Staff,11,0,30,19
1683293106044,PSYC 1,A00,188952,Staff,38,0,90,52
1683293107069,PSYC 2,B00,188953,Staff,20,0,35,15
1683293108092,PSYC 6,A00,188970,Staff,47,0,60,13
1683293109120,PSYC 7,A00,188973,Staff,37,0,45,8
1683293110151,PSYC 60,A01,188980,Rickard; Timothy C.,43,0,60,17
1683293111179,PSYC 70,A01,189001,Steiner; Eric Tomas,24,0,45,21
1683293112205,PSYC 100,A00,189005,Lacefield; Katharine I,0,99,120,120
1683293113233,PSYC 102,A00,189008,Staff,10,0,30,20
1683293114262,PSYC 106,B00,189026,Gorman; Michael R.,37,0,60,23
1683293115291,PSYC 114,B01,189033,Winkielman; Piotr,0,32,30,30
1683293116322,PSYC 131,A00,189036,Anagnostaras; Stephan,0,43,60,60
1683293117348,PSYC 136,A00,189041,Lowe; Angela Beth,0,7,25,25
1683293118377,PSYC 137,A00,189057,Winkielman; Piotr,0,34,25,25
1683293119406,PSYC 144,A00,189107,Wixted; John T,0,7,50,50
1683293121458,PSYC 162,A00,189142,Staff,0,8,85,85
1683293122484,PSYC 172,A00,189144,Gorman; Michael R.,0,7,30,30
1683293124606,PSYC 179,A00,189146,Lacefield; Katharine I,0,84,120,120
1683293125631,PSYC 181,A00,189147,Anagnostaras; Stephan,0,44,90,90
1683293126656,PSYC 190R,A00,189148,Barner; David A.,0,22,80,80
1683293127681,PSYC 191,A00,189275,Rickard; Timothy C.,0,7,25,25
1683293128707,PSYC 193,A00,189276,Chapman; Eddie Nathaniel,0,1,0,4
1683293129734,PSYC 193L,A01,189281,Lowe; Angela Beth,12,0,20,8
1683293129734,PSYC 193L,B01,189285,Staff,28,0,35,7
1683293130760,RELI 149,A00,187137,Rahimi; Babak,7,0,40,33
1683293131787,SE 9,A01,187315,Staff,0,2,18,18
1683293132813,SE 101B,A00,187409,Staff,24,0,30,6
1683293133838,SE 110B,A00,187444,Staff,10,0,40,30
1683293134867,SE 130B,A00,187449,Staff,31,0,40,9
1683293135896,SE 150A,A00,187516,Staff,9,0,20,11
1683293136925,SE 154,A00,187528,Staff,30,0,50,20
1683293137951,SIO 3,A01,258171,Staff,35,0,40,5
1683293138976,SIO 10,A00,187144,Cook; Geoffrey W,0,3,75,75
1683293140000,SIO 45,A00,187152,Cook; Geoffrey W,1,0,100,99
1683293141025,SIO 109R,A00,194486,Staff,0,3,20,20
1683293143076,SIO 187,A01,187233,Kacev; David,12,0,40,28
1683293144102,SOCI 1,A01,258656,Thorpe; Charles Robert,28,0,30,2
1683293144102,SOCI 1,A02,258658,Thorpe; Charles Robert,30,0,30,0
1683293144102,SOCI 1,A03,258661,Thorpe; Charles Robert,25,0,25,0
1683293144102,SOCI 1,A04,258666,Thorpe; Charles Robert,22,0,25,3
1683293144102,SOCI 1,A05,258897,Thorpe; Charles Robert,23,0,25,2
1683293144102,SOCI 1,A06,258898,Thorpe; Charles Robert,25,0,25,0
1683293145130,SOCI 30,A01,258903,Pardo Guerra; Juan Pablo,16,0,30,14
1683293146158,SOCI 102,A00,258904,Staff,9,0,25,16
1683293147186,SOCI 106,A00,258905,Staff,19,0,25,6
1683293148214,SOCI 111,A00,258907,Ribas Norris; Janet Vanesa,26,0,30,4
1683293149238,SOCI 121R,A00,258908,Pardo Guerra; Juan Pablo,11,0,30,19
1683293150267,SOCI 126,A01,203330,Staff,14,0,20,6
1683293151295,SOCI 131,A00,258909,Thorpe; Charles Robert,31,0,60,29
1683293152324,SOCI 135,A00,258910,Payne; Christine Anna,0,9,30,30
1683293153348,SOCI 157,A00,258911,Staff,13,0,30,17
1683293154373,SOCI 184,A00,258912,Staff,26,0,30,4
1683293155399,SOCI 188D,A00,258913,Staff,21,0,30,9
1683293156426,SYN 2,001,187529,Staff,9,0,16,7
1683293156426,SYN 2,002,201452,Staff,0,18,16,16
1683293156426,SYN 2,003,201469,Staff,3,0,16,13
1683293157452,SYN 100,A01,187531,Staff,0,9,20,20
1683293157452,SYN 100,B01,201491,Staff,0,12,20,20
1683293158479,TDAC 1,A00,189286,Walsh; Kim C.,3,0,20,17
1683293158479,TDAC 1,B00,189287,Harting; Carla Kelso,11,0,20,9
1683293159505,TDAC 101,A00,189300,Walsh; Kim C.,16,0,20,4
1683293159505,TDAC 101,B00,189301,Harting; Carla Kelso,18,0,20,2
1683293160533,TDAC 102,A00,189304,Basso; Beatrice,14,0,20,6
1683293161558,TDAC 108,A00,189305,Staff,18,0,20,2
1683293162588,TDDE 131,A00,189310,Staff,19,0,20,1
1683293162588,TDDE 131,B00,189314,Staff,19,0,20,1
1683293162588,TDDE 131,C00,189315,Staff,48,0,50,2
1683293162588,TDDE 131,D00,189316,Staff,14,0,15,1
1683293162588,TDDE 131,E00,204841,Staff,20,0,20,0
1683293163616,TDGE 10,A00,189289,Staff,30,0,50,20
1683293163616,TDGE 10,B00,189290,Havis; Allan,2,0,50,48
1683293164646,TDGE 11,A00,189291,Fulton; Julia,0,3,50,50
1683293164646,TDGE 11,B00,189292,Staff,20,0,25,5
1683293164646,TDGE 11,C00,260270,Staff,0,0,0,0
1683293165676,TDGE 25,A00,189294,Staff,3,0,20,17
1683293166705,TDGE 124,A00,189318,Fulton; Julia,0,8,50,50
1683293167730,TDGE 125,A00,189319,Staff,13,0,25,12
1683293167730,TDGE 125,B00,189320,Staff,23,0,25,2
1683293168753,TDGE 127,A00,189322,Havis; Allan,0,0,50,50
1683293169780,TDHT 101,A00,189323,Staff,18,0,25,7
1683293169780,TDHT 101,B00,189324,Staff,25,0,25,0
1683293170805,TDHT 102,A00,189325,Staff,49,0,50,1
1683293171829,TDMV 1,A00,189295,Arcidiacono; Kristin,20,0,30,10
1683293171829,TDMV 1,B00,189296,Caligagan; Maria T.,24,0,30,6
1683293172858,TDMV 2,A00,189297,Sammartano; Tonnie,28,0,30,2
1683293172858,TDMV 2,B00,189299,Arcidiacono; Kristin,24,0,30,6
1683293173889,TDMV 3,A00,204998,Rincon; Alicia,22,0,30,8
1683293174919,TDMV 120,A00,189458,Sammartano; Tonnie,28,0,30,2
1683293175955,TDMV 138,A00,189541,Jun; Grace Shin Hae,22,0,40,18
1683293176986,TDMV 142,A00,189717,Caligagan; Tony,23,0,30,7
1683293176986,TDMV 142,B00,189718,Caligagan; Maria T.,25,0,30,5
1683293178012,TMC 2,A01,187533,Staff,25,0,25,0
1683293178012,TMC 2,A02,187534,Staff,25,0,25,0
1683293179038,USP 1,A01,187536,Kwak; Nancy,0,16,25,25
1683293180068,USP 5,A01,187538,Staff,9,0,25,16
1683293181093,USP 101,A00,199253,Staff,0,4,0,0
1683293182117,USP 124,A00,187562,Boomhower; Matthew Charles,1,0,30,29
1683293183149,USP 138,A00,187582,Staff,20,0,25,5
1683293184178,USP 152,A01,187597,Staff,4,0,25,21
1683293185202,USP 153,A00,187598,Staff,19,0,25,6
1683293186228,USP 168,A00,187607,Kwak; Nancy,2,0,5,3
1683293187253,USP 173,A00,187619,Staff,4,0,25,21
1683293188277,USP 181,A00,187638,Staff,0,0,25,25
1683293189303,VIS 103,A00,187650,Cruz; Edwin Teddy,23,0,75,52
1683293190329,VIS 110D,A00,187669,Staff,12,0,22,10
1683293191352,VIS 127C,A00,187720,Shen; Kuiyi,68,0,146,78
1683293192378,VIS 149,A00,187731,Yoldas; Pinar,0,14,22,22
1683293193403,VIS 151,A01,188091,Staff,22,0,34,12
1683293193403,VIS 151,A02,188092,Staff,11,0,34,23
1683293194427,VIS 160B,A00,188093,Stalbaum; Brett,0,0,10,10
1683293196480,WCWP 10B,A00,201720,Staff,10,0,15,5
1683293196480,WCWP 10B,B00,201722,Staff,8,0,15,7
1683293197506,WCWP 100,A00,201725,Gagnon; Jeffrey C,0,0,2,2
1683293197506,WCWP 100,B00,201727,Staff,0,4,15,15
1683293200659,ANBI 133,A00,258401,Wilder; Linnea Lorene,34,0,40,6
1683293201690,ANBI 140,A00,258395,Hrvoj Mihic; Branka,18,0,25,7
1683293202721,ANSC 120,A00,258402,Bialecki; Jon Anthony,27,0,40,13
1683293203748,ANSC 144,A00,258400,Staff,14,0,40,26
1683293205806,ANSC 166,A00,258396,Parish; Steven Martin,157,0,175,18
1683293206837,ANSC 180,A00,193533,Staff,9,0,20,11
1683293207863,ANSC 188,A00,258397,Jassal; Aftab,33,0,40,7
1683293208888,ANTH 3,A01,258316,Staff,23,0,30,7
1683293209917,ANTH 5,A00,258394,Semendeferi; Ekaterini,16,0,20,4
1683293210943,ANTH 21,A01,258331,Staff,9,0,40,31
1683293211971,ANTH 103,A00,258398,Varma; Saiba,15,0,25,10
1683293212998,AWP 10,001,202034,Staff,0,0,0,0
1683293212998,AWP 10,002,202035,Staff,0,0,0,0
1683293212998,AWP 10,003,202036,Staff,0,0,0,0
1683293212998,AWP 10,004,202037,Staff,0,0,0,0
1683293212998,AWP 10,005,202038,Staff,0,0,0,0
1683293212998,AWP 10,006,202039,Staff,0,0,0,0
1683293212998,AWP 10,007,202040,Staff,0,0,0,0
1683293212998,AWP 10,008,202041,Staff,0,0,0,0
1683293212998,AWP 10,009,202042,Staff,0,0,0,0
1683293212998,AWP 10,010,202043,Staff,0,0,0,0
1683293212998,AWP 10,011,202044,Staff,0,0,0,0
1683293212998,AWP 10,012,202045,Staff,0,0,0,0
1683293212998,AWP 10,013,202046,Staff,0,0,0,0
1683293212998,AWP 10,014,202047,Staff,0,0,0,0
1683293212998,AWP 10,015,202048,Staff,0,0,0,0
1683293212998,AWP 10,016,202049,Staff,0,0,0,0
1683293212998,AWP 10,017,202050,Staff,0,0,0,0
1683293212998,AWP 10,018,202051,Staff,0,0,0,0
1683293212998,AWP 10,019,202052,Staff,0,0,0,0
1683293212998,AWP 10,020,202053,Staff,0,0,0,0
1683293212998,AWP 10,021,202054,Staff,0,0,0,0
1683293212998,AWP 10,022,202055,Staff,0,0,0,0
1683293212998,AWP 10,023,202056,Staff,0,0,0,0
1683293212998,AWP 10,024,202057,Staff,0,0,0,0
1683293212998,AWP 10,025,202058,Staff,0,0,0,0
1683293212998,AWP 10,026,202059,Staff,0,0,0,0
1683293214024,AWP 102,001,202032,Staff,0,0,0,0
1683293214024,AWP 102,002,202033,Staff,0,0,0,0
1683293215051,BENG 100,A01,254234,Taylor Amos; Alyssa C,31,0,40,9
1683293216077,BENG 196,001,270013,Engler; Adam J.,9999,0,9999,0
1683293217104,BICD 100R,A01,202018,Smith; Laurie,0,7,32,32
1683293217104,BICD 100R,A02,202019,Smith; Laurie,0,2,32,32
1683293217104,BICD 100R,A03,202020,Smith; Laurie,0,1,32,32
1683293217104,BICD 100R,A04,202021,Smith; Laurie,8,0,32,24
1683293217104,BICD 100R,A05,202022,Smith; Laurie,12,0,32,20
1683293218129,BICD 136,A01,193242,Gustafson-Brown; Cindy,0,2,32,32
1683293218129,BICD 136,A02,193244,Gustafson-Brown; Cindy,15,0,32,17
1683293219163,BIEB 102,A01,193249,Butler; Shannon Rhey,0,2,32,32
1683293219163,BIEB 102,A02,193251,Butler; Shannon Rhey,0,0,32,32
1683293219163,BIEB 102,A03,193253,Butler; Shannon Rhey,0,1,32,32
1683293219163,BIEB 102,A04,193255,Butler; Shannon Rhey,17,0,32,15
1683293219163,BIEB 102,A05,193265,Butler; Shannon Rhey,26,0,32,6
1683293219163,BIEB 102,A06,193269,Butler; Shannon Rhey,16,0,32,16
1683293221215,BIEB 150,A01,193274,Staff,0,0,32,32
1683293221215,BIEB 150,A02,193285,Staff,24,0,32,8
1683293222242,BIEB 194,A00,193286,Kurle; Carolyn M.,22,0,32,10
1683293223272,BILD 1,A01,192291,Staff,16,0,32,16
1683293223272,BILD 1,A02,192292,Staff,30,0,32,2
1683293223272,BILD 1,B01,192520,Reuther; Keefe,0,1,0,0
1683293223272,BILD 1,B02,192532,Reuther; Keefe,0,1,0,0
1683293224300,BILD 3,A01,192556,Butler; Shannon Rhey,0,0,32,32
1683293224300,BILD 3,A02,192581,Butler; Shannon Rhey,5,0,32,27
1683293224300,BILD 3,A03,192611,Butler; Shannon Rhey,23,0,32,9
1683293224300,BILD 3,A04,192612,Butler; Shannon Rhey,25,0,32,7
1683293224300,BILD 3,A05,192613,Butler; Shannon Rhey,27,0,32,5
1683293224300,BILD 3,A06,192679,Butler; Shannon Rhey,27,0,32,5
1683293224300,BILD 3,A07,192682,Butler; Shannon Rhey,22,0,32,10
1683293225327,BILD 4,A01,192836,Reuther; Keefe,1,0,24,23
1683293225327,BILD 4,A02,193044,Reuther; Keefe,4,0,24,20
1683293226353,BILD 10,A01,193142,Gustafson-Brown; Cindy,31,0,32,1
1683293226353,BILD 10,A02,193149,Gustafson-Brown; Cindy,31,0,32,1
1683293227437,BIMM 100,A01,193301,Staff,0,6,32,32
1683293227437,BIMM 100,A02,193312,Staff,0,5,32,32
1683293227437,BIMM 100,A03,193323,Staff,0,8,32,32
1683293228464,BIMM 101,A01,193329,McDonnell; Lisa Marie,0,3,24,24
1683293228464,BIMM 101,A02,193339,McDonnell; Lisa Marie,0,2,24,24
1683293228464,BIMM 101,B01,193354,McDonnell; Lisa Marie,0,3,24,24
1683293228464,BIMM 101,B02,193357,McDonnell; Lisa Marie,0,3,24,24
1683293229493,BIMM 110,A01,193377,Tat; John,0,11,32,32
1683293229493,BIMM 110,A02,193378,Tat; John,1,9,32,31
1683293230526,BIMM 120,A01,206116,Staff,0,0,32,32
1683293230526,BIMM 120,A02,206117,Staff,8,0,32,24
1683293230526,BIMM 120,A03,206121,Staff,21,0,32,11
1683293231558,BIPN 100,A01,193393,Park; Ji Young,0,14,32,32
1683293231558,BIPN 100,A02,193402,Park; Ji Young,0,12,32,32
1683293231558,BIPN 100,A03,193413,Park; Ji Young,0,14,32,32
1683293231558,BIPN 100,A04,193414,Park; Ji Young,0,13,32,32
1683293232586,BIPN 102,A01,193429,Staff,0,0,32,32
1683293232586,BIPN 102,A02,193438,Staff,23,0,32,9
1683293233616,BIPN 106,A01,193450,Reyes Gonzalez; Catalina,0,2,40,40
1683293234644,BIPN 134,A01,193465,Cooke; James Edward,0,0,32,32
1683293234644,BIPN 134,A02,193474,Cooke; James Edward,27,0,32,5
1683293234644,BIPN 134,A03,193485,Cooke; James Edward,29,0,32,3
1683293234644,BIPN 134,A04,193486,Cooke; James Edward,21,0,32,11
1683293234644,BIPN 134,A05,193491,Cooke; James Edward,31,0,32,1
1683293234644,BIPN 134,A06,193501,Cooke; James Edward,30,0,32,2
1683293234644,BIPN 134,A07,193510,Cooke; James Edward,29,0,32,3
1683293236702,BISP 194,A00,222522,Staff,16,0,32,16
1683293237726,CAT 124,A01,202407,Staff,20,0,25,5
1683293238754,CAT 125,A00,202408,Marchisotto; Jennifer Anne,4,0,20,16
1683293239781,CAT 125R,A00,202409,Smith; Lauryn Alissa,0,11,20,20
1683293239781,CAT 125R,B00,202410,Morales; Celeste Georgianna,0,11,20,20
1683293239781,CAT 125R,C00,202411,Irwin; Matthew Joseph,0,10,20,20
1683293240807,CENG 15,A01,204712,Yang; Kesong,0,1,0,0
1683293241833,CENG 114,A00,202070,Jahed Motlagh; Zeinab,5,0,20,15
1683293242863,CGS 105,A00,185477,Wesling; Megan E.,24,0,40,16
1683293243888,CGS 106,A00,185494,Staff,13,0,22,9
1683293244913,CGS 108,A00,185495,Staff,14,0,20,6
1683293245938,CGS 114,A00,185496,Staff,13,0,18,5
1683293246963,CGS 119,A00,185501,Staff,15,0,20,5
1683293247989,CGS 120,A00,185511,Staff,13,0,20,7
1683293249016,CHEM 4,A01,184675,Bussey; Thomas J,96,0,100,4
1683293250043,CHEM 6A,A01,184677,Staff,35,0,60,25
1683293251072,CHEM 6B,A01,184679,Staff,65,0,100,35
1683293252101,CHEM 6C,A01,184681,Bussey; Thomas J,1,0,50,49
1683293252101,CHEM 6C,A02,184682,Bussey; Thomas J,34,0,50,16
1683293253132,CHEM 40A,A01,184684,Albizati; Kim F.,37,0,100,63
1683293254157,CHEM 40B,A01,184686,Albizati; Kim F.,0,20,100,100
1683293255183,CHEM 41B,A01,184690,Staff,52,0,100,48
1683293256209,COGS 3,A01,184715,Boyle; Mary E. T.,0,25,40,40
1683293257234,COGS 14B,A01,185172,Staff,0,15,38,38
1683293258260,COGS 18,A01,184736,Staff,20,0,80,60
1683293259288,COGS 100,A01,184932,Staff,0,5,73,73
1683293260317,COGS 101A,A01,184935,Staff,0,38,30,30
1683293261346,COGS 101B,A01,184944,Staff,0,2,30,30
1683293262375,COGS 101C,A01,184946,Staff,0,12,30,30
1683293263404,COGS 102A,A01,184951,Johnson; Christine M.,2,0,40,38
1683293264435,COGS 107B,A01,184953,Mooshagian; Eric Frederick,0,50,40,40
1683293265461,COGS 118B,A01,184959,Gupta; Anjum,0,48,40,40
1683293266486,COGS 153,A00,184961,Staff,0,15,30,30
1683293267515,COGS 177,A00,184962,Staff,0,21,30,30
1683293268543,COGS 187A,A01,184969,Boyle; Mary E. T.,0,17,40,40
1683293269571,COMM 10,A01,185174,Staff,0,5,25,25
1683293269571,COMM 10,A02,185189,Staff,0,5,25,25
1683293269571,COMM 10,A03,269821,Staff,0,0,0,0
1683293270596,COMM 100B,A01,185475,Staff,0,0,0,2
1683293270596,COMM 100B,A02,185476,Staff,14,0,25,11
1683293271625,COMM 100C,A01,185314,Staff,1,0,25,24
1683293271625,COMM 100C,A02,185327,Staff,19,0,25,6
1683293272653,COMM 110M,A00,185349,Staff,2,0,40,38
1683293273681,COMM 113T,A00,185352,Staff,25,0,40,15
1683293274705,COMM 114I,A00,185353,Staff,33,0,40,7
1683293275730,COMM 131,A00,185354,Staff,19,0,30,11
1683293276756,CSE 8A,A50,185358,Cao; Yingjun,0,46,10,10
1683293277781,CSE 8B,A01,185362,Staff,0,47,50,50
1683293278806,CSE 11,A01,185416,Cao; Yingjun,0,93,10,10
1683293279832,CSE 20,A01,185445,Briones; Jor-el Thomas Caparas,5,0,25,20
1683293280858,CSE 21,A01,185447,Staff,10,0,50,40
1683293281884,CSE 101,A01,185451,Staff,0,12,50,50
1683293281884,CSE 101,B01,185453,Jones; Miles E,0,11,50,50
1683293283938,CSE 141,A01,185458,Eldon; John,20,0,100,80
1683293284968,CSE 141L,A01,185461,Eldon; John,12,0,100,88
1683293285999,CSE 142,A01,185463,Staff,35,0,60,25
1683293285999,CSE 142,B01,201355,Staff,0,6,60,60
1683293287030,CSE 142L,A01,185470,Staff,35,0,60,25
1683293287030,CSE 142L,B01,201417,Staff,0,5,60,60
1683293288059,CSE 190,A00,201433,Staff,32,0,49,17
1683293289086,DOC 1,A01,259136,Strom; Megan C.,8,0,15,7
1683293289086,DOC 1,A02,259137,Strom; Megan C.,14,0,15,1
1683293289086,DOC 1,A03,259138,Strom; Megan C.,14,0,15,1
1683293289086,DOC 1,A04,259139,Strom; Megan C.,14,0,15,1
1683293290116,DOC 100D,A00,259140,Pass; Natalye Joann,17,0,25,8
1683293291142,DSGN 1,A01,184749,Rill; Bryan,0,24,30,30
1683293292165,DSGN 100,A01,185168,Staff,0,2,25,25
1683293293188,ECE 5,A01,185626,Morris; Karcher William,0,10,0,0
1683293294214,ECE 101,A01,185628,Staff,17,0,70,53
1683293295241,ECE 107,A01,185635,Baghdadchi; Saharnaz,0,0,20,20
1683293295241,ECE 107,A02,185638,Baghdadchi; Saharnaz,4,0,20,16
1683293296273,ECE 148,A01,185647,Silberman; Jack,1,0,16,15
1683293297302,ECON 1,A01,185537,Crane; Meredith Helen,54,0,70,16
1683293298331,ECON 3,A01,185549,Crane; Meredith Helen,33,0,70,37
1683293299356,ECON 4,A01,203354,Anderson; John Charles,0,4,10,10
1683293300382,ECON 100A,A01,185574,Staff,0,4,40,40
1683293301408,ECON 100B,A01,185576,Staff,0,22,40,40
1683293302432,ECON 100C,A01,185589,Newhouse; Herbert S,30,0,70,40
1683293303457,ECON 105,A00,185608,Vespa; Emanuel Ignacio,19,0,35,16
1683293304482,ECON 109,A01,185610,Shishkin; Denis,10,0,35,25
1683293305508,ECON 110A,A01,185612,Staff,11,0,40,29
1683293306533,ECON 120A,A01,185615,Staff,20,0,40,20
1683293307565,ECON 120C,A01,185617,Sun; Yixiao,0,20,70,70
1683293308596,ECON 144,A00,203346,Squires; Dale E,3,0,35,32
1683293309624,ECON 171,A01,203349,Newhouse; Herbert S,0,1,35,35
1683293310656,ECON 173A,A01,185621,Toda; Alexis Akira,21,0,35,14
1683293311686,EDS 25,A01,202413,Staff,0,1,0,0
1683293311686,EDS 25,A02,202414,Staff,0,1,0,0
1683293311686,EDS 25,A03,202415,Staff,0,0,0,0
1683293311686,EDS 25,A04,202416,Staff,0,1,0,0
1683293311686,EDS 25,A05,202439,Staff,0,0,0,0
1683293311686,EDS 25,A06,202440,Staff,0,0,0,0
1683293311686,EDS 25,B01,202631,Staff,0,0,0,0
1683293311686,EDS 25,B02,202632,Staff,0,0,0,0
1683293311686,EDS 25,B03,202639,Staff,0,0,0,0
1683293311686,EDS 25,B04,202640,Staff,0,0,0,0
1683293311686,EDS 25,B05,202643,Staff,0,0,0,0
1683293311686,EDS 25,B06,202644,Staff,0,0,0,0
1683293312718,EDS 38,A01,202659,Black; Alison Michelle,24,0,25,1
1683293313743,EDS 115,A00,202652,Staff,17,0,30,13
1683293314768,EDS 125,A00,202649,Staff,14,0,30,16
1683293315794,EDS 126,A01,203332,Staff,30,0,30,0
1683293316819,EDS 139,A00,202838,Staff,17,0,25,8
1683293317843,EDS 146,A01,202655,Staff,15,0,25,10
1683293318874,ENG 15,A00,185667,Staff,0,1,0,0
1683293318874,ENG 15,B00,185672,Staff,0,0,0,0
1683293318874,ENG 15,C00,185675,Staff,0,0,0,0
1683293318874,ENG 15,D00,185682,Staff,0,0,0,0
1683293318874,ENG 15,E00,185684,Staff,0,0,0,0
1683293319899,ETHN 103,A00,185710,Staff,0,3,35,35
1683293320925,ETHN 103A,A00,199228,Man; Simeon S,3,0,9,6
1683293321950,ETHN 109,A00,185711,Staff,18,0,35,17
1683293322975,ETHN 142,A00,185726,Staff,0,4,30,30
1683293324005,ETHN 163J,A00,199229,Man; Simeon S,6,0,8,2
1683293325031,ETHN 168,A00,185727,Staff,8,0,10,2
1683293326055,ETHN 182,A00,185728,Staff,1,0,35,34
1683293327080,ETHN 183,A00,185737,Staff,8,0,18,10
1683293328110,GLBH 111,A01,209361,Burgos; Jose L.,0,0,0,0
1683293330166,HIEU 104,A00,185792,Staff,16,0,20,4
1683293331248,HIEU 115,A00,185800,Staff,1,0,20,19
1683293332271,HIEU 128,A00,185801,Staff,0,7,20,20
1683293333299,HIEU 147,A00,185802,Staff,16,0,20,4
1683293334325,HIEU 154,A00,185823,Staff,12,0,20,8
1683293335350,HILA 102,A00,185826,Staff,13,0,20,7
1683293336375,HILD 2C,A01,185778,Staff,0,12,20,20
1683293337399,HILD 7B,A01,185780,Kwak; Nancy,0,15,32,32
1683293337399,HILD 7B,A02,185781,Kwak; Nancy,0,18,32,32
1683293338428,HILD 30,A01,185791,Staff,14,0,20,6
1683293339454,HISC 119,A00,185830,Golan; Tal,0,9,20,20
1683293340479,HITO 156GS,A00,185831,Patterson; Patrick H.,0,0,0,23
1683293341505,HIUS 103,A00,185832,Man; Simeon S,0,7,20,20
1683293342531,HIUS 117,A00,185836,Kwak; Nancy,2,0,20,18
1683293343557,HIUS 125,A00,185840,Man; Simeon S,0,0,23,23
1683293344585,HIUS 149,A00,185845,Staff,0,0,20,20
1683293345618,HUM 3,A01,185882,Zavodny; Tatiana Sophia,0,6,50,50
1683293345618,HUM 3,B01,185899,Caldwell; Michael Alan,0,19,50,50
1683293346646,HUM 3GS,A00,185900,Patterson; Patrick H.,0,0,0,23
1683293347673,HUM 4,A01,185938,Zroka; Amy Liane,31,0,50,19
1683293347673,HUM 4,B01,185956,Watkins; Eric,0,2,50,50
1683293347673,HUM 4,B02,202209,Watkins; Eric,0,1,50,50
1683293347673,HUM 4,B03,202210,Watkins; Eric,0,0,50,50
1683293348702,HUM 5,A01,185958,West; Geoffrey Scott,5,0,50,45
1683293348702,HUM 5,A02,202215,West; Geoffrey Scott,0,0,50,50
1683293349728,INTL 190,A00,185959,Gagnon; Jeffrey C,0,0,0,9
1683293349728,INTL 190,B00,185960,Lettieri; Michael Joseph,0,0,0,1
1683293350752,JAPN 180,A00,254509,Staff,0,1,25,25
1683293351777,LATI 10,A01,202853,Kennemore; Amy Michelle,5,0,35,30
1683293351777,LATI 10,A02,202854,Kennemore; Amy Michelle,1,0,35,34
1683293351777,LATI 10,A03,270054,Kennemore; Amy Michelle,30,0,30,0
1683293352807,LATI 180,A00,202855,Kennemore; Amy Michelle,11,0,20,9
1683293353835,LAWS 101,A00,201767,Golan; Tal,0,7,40,40
1683293354862,LIFR 1C,A00,185961,Staff,6,0,20,14
1683293355886,LIFR 1CX,A00,185962,Staff,7,0,20,13
1683293356912,LIFR 1D,A00,185963,Staff,9,0,20,11
1683293357938,LIFR 1DX,A00,185964,Staff,9,0,20,11
1683293358962,LIGN 101,A01,186039,Staff,43,0,50,7
1683293359987,LIGN 165,A00,186040,Staff,18,0,50,32
1683293361011,LTCS 108,A00,186041,Staff,6,0,10,4
1683293362039,LTCS 119,A00,186042,Staff,16,0,20,4
1683293363064,LTCS 130,A00,186043,Wesling; Megan E.,15,0,25,10
1683293365117,LTEA 138,A00,186119,Staff,14,0,40,26
1683293366143,LTEN 124,A00,186148,Staff,6,0,25,19
1683293367168,LTEN 178,A00,186149,Staff,7,0,15,8
1683293368192,LTEN 181,A00,186150,Blanco; John D,33,0,40,7
1683293369221,LTWL 120,A00,186160,Staff,20,0,25,5
1683293370251,LTWL 165,A00,186161,Staff,22,0,25,3
1683293371278,LTWR 100,A00,186162,Staff,0,4,15,15
1683293372305,LTWR 102,A00,186163,Doller; Ben,5,0,15,10
1683293373329,MAE 8,A01,186412,Staff,0,0,0,0
1683293374356,MAE 30B,A00,186445,Bahadori; Mohammad Yousef,83,0,100,17
1683293375381,MAE 40,A00,186592,Bewley; Thomas R,9,0,50,41
1683293376405,MAE 101B,A00,186593,Bahadori; Mohammad Yousef,81,0,100,19
1683293377431,MAE 105,A00,186594,Bandaru; Prabhakar,12,0,50,38
1683293378460,MAE 107,A00,186599,Pham; Hieu Tan,0,6,120,120
1683293379485,MAE 148,A01,186660,Silberman; Jack,3,0,16,13
1683293380516,MATH 10A,A01,188095,Staff,0,7,35,35
1683293381543,MATH 10B,A01,188097,Bowers; Adam R.,0,11,30,30
1683293381543,MATH 10B,A02,188099,Bowers; Adam R.,0,9,30,30
1683293381543,MATH 10B,B01,188104,Bowers; Adam R.,0,11,30,30
1683293381543,MATH 10B,B02,188106,Bowers; Adam R.,0,11,30,30
1683293382577,MATH 10C,A01,188111,Staff,0,18,30,30
1683293382577,MATH 10C,A02,188127,Staff,0,17,30,30
1683293382577,MATH 10C,A03,188131,Staff,0,17,30,30
1683293382577,MATH 10C,B01,188218,Staff,21,0,30,9
1683293382577,MATH 10C,B02,188244,Staff,13,0,30,17
1683293382577,MATH 10C,B03,188277,Staff,16,0,30,14
1683293383603,MATH 18,A01,188344,Bach; Quang Tran,18,0,30,12
1683293383603,MATH 18,A02,188345,Bach; Quang Tran,11,0,30,19
1683293383603,MATH 18,B01,188353,Bach; Quang Tran,10,0,30,20
1683293383603,MATH 18,B02,188354,Bach; Quang Tran,20,0,30,10
1683293384631,MATH 20A,A01,188374,Staff,13,0,35,22
1683293385661,MATH 20B,A01,188382,Ohm; Ko Woon,6,0,30,24
1683293385661,MATH 20B,A02,188383,Ohm; Ko Woon,24,0,30,6
1683293385661,MATH 20B,B01,188385,Ohm; Ko Woon,7,0,30,23
1683293385661,MATH 20B,B02,188392,Ohm; Ko Woon,22,0,30,8
1683293386693,MATH 20C,A01,188394,Harel; Guershon,10,0,30,20
1683293386693,MATH 20C,A02,188395,Harel; Guershon,13,0,30,17
1683293386693,MATH 20C,B01,188404,Harel; Guershon,3,0,30,27
1683293386693,MATH 20C,B02,188405,Harel; Guershon,19,0,30,11
1683293387721,MATH 20D,A01,188414,Hammock; Frances H,0,1,30,30
1683293387721,MATH 20D,A02,188415,Hammock; Frances H,4,0,30,26
1683293387721,MATH 20D,B01,188447,Hammock; Frances H,2,0,30,28
1683293387721,MATH 20D,B02,188486,Hammock; Frances H,8,0,30,22
1683293388749,MATH 20E,A01,188649,Staff,22,0,30,8
1683293388749,MATH 20E,A02,188650,Staff,23,0,30,7
1683293388749,MATH 20E,A03,188673,Staff,0,0,30,30
1683293389777,MATH 102,A01,188675,Staff,0,35,35,35
1683293390805,MATH 103B,A01,188681,Staff,4,0,35,31
1683293390805,MATH 103B,B01,188692,Staff,8,0,35,27
1683293391832,MATH 109,A01,188695,Salehi Golsefidy; Alireza,25,0,35,10
1683293391832,MATH 109,A02,188696,Salehi Golsefidy; Alireza,27,0,35,8
1683293392858,MATH 120A,A01,188698,Eggers; John Dietrich,5,0,35,30
1683293393885,MATH 142B,A01,188736,Ioana; Adrian,0,2,30,30
1683293393885,MATH 142B,A02,188741,Ioana; Adrian,0,1,30,30
1683293393885,MATH 142B,A03,188743,Ioana; Adrian,0,3,30,30
1683293394910,MATH 168A,A01,188790,Staff,0,8,35,35
1683293395934,MATH 170A,A01,188803,Nie; Jiawang,0,2,35,35
1683293395934,MATH 170A,A02,188811,Nie; Jiawang,0,0,35,35
1683293395934,MATH 170A,A03,188814,Nie; Jiawang,1,0,35,34
1683293395934,MATH 170A,A04,188815,Nie; Jiawang,14,0,35,21
1683293396964,MATH 193B,A01,188817,Staff,0,0,35,35
1683293396964,MATH 193B,A02,188818,Staff,5,0,35,30
1683293397991,MGT 4,A01,202857,Anderson; John Charles,62,0,80,18
1683293399019,MGT 12,A00,202858,Lindenberger; Wade Douglas,43,0,90,47
1683293400045,MGT 18,A00,202859,Staff,74,0,90,16
1683293401081,MGT 18GS,A00,202860,McKay; Michael J,13,0,28,15
1683293402112,MGT 45,A00,202861,Pecore; Joseph P.,14,0,90,76
1683293403139,MGT 100,A00,202863,Yavorsky; Daniel Ryan,28,0,90,62
1683293404164,MGT 103,A00,202864,Ehrich; Kristine R,0,16,90,90
1683293405188,MGT 112,A00,202865,Ehrich; Kristine R,15,0,90,75
1683293406214,MGT 121A,A00,202868,Staff,0,19,0,0
1683293407238,MGT 131B,A00,202869,Anderson; John Charles,59,0,90,31
1683293408263,MGT 136,A00,202871,Lindenberger; Wade Douglas,84,0,90,6
1683293409288,MGT 164,A00,202873,Staff,0,69,90,90
1683293410313,MGT 164GS,A00,202874,McKay; Mary A,13,0,28,15
1683293411338,MGT 180,A00,202875,Staff,0,51,90,90
1683293412367,MMW 11R,A01,205019,Herbst; Matthew,3,0,30,27
1683293412367,MMW 11R,A02,205026,Herbst; Matthew,29,0,30,1
1683293413399,MMW 15,A01,193512,Chang; Edmond Yi-Teh,0,9,28,28
1683293413399,MMW 15,A02,193513,Chang; Edmond Yi-Teh,0,5,28,28
1683293413399,MMW 15,A03,193514,Chang; Edmond Yi-Teh,0,5,28,28
1683293413399,MMW 15,A04,193515,Chang; Edmond Yi-Teh,0,4,28,28
1683293413399,MMW 15,A05,193516,Chang; Edmond Yi-Teh,0,4,28,28
1683293413399,MMW 15,A06,193517,Chang; Edmond Yi-Teh,0,5,28,28
1683293413399,MMW 15,B01,193519,Chang; Edmond Yi-Teh,0,4,28,28
1683293413399,MMW 15,B02,193520,Chang; Edmond Yi-Teh,0,5,28,28
1683293413399,MMW 15,B03,193521,Chang; Edmond Yi-Teh,0,4,28,28
1683293413399,MMW 15,B04,193522,Chang; Edmond Yi-Teh,0,4,28,28
1683293413399,MMW 15,B05,193523,Chang; Edmond Yi-Teh,0,5,28,28
1683293413399,MMW 15,B06,193524,Chang; Edmond Yi-Teh,0,4,28,28
1683293414425,MMW 122,A01,193526,Rahimi; Babak,0,14,28,28
1683293414425,MMW 122,A02,193527,Rahimi; Babak,0,14,28,28
1683293414425,MMW 122,A03,193528,Rahimi; Babak,0,0,0,0
1683293414425,MMW 122,A04,193529,Rahimi; Babak,0,0,0,0
1683293415450,MUS 1A,A01,186663,Staff,0,20,35,35
1683293416475,MUS 4,A01,186715,Staff,0,12,35,35
1683293417500,MUS 5R,A01,186796,Dubnov; Shlomo,0,16,35,35
1683293418525,MUS 6,A01,186798,Staff,0,3,25,25
1683293419549,MUS 7,A01,186830,Staff,12,0,35,23
1683293420573,MUS 8,A01,186930,Staff,0,25,35,35
1683293421599,MUS 15,A01,186932,Staff,0,15,35,35
1683293421599,MUS 15,B01,186934,Staff,0,14,35,35
1683293422625,MUS 80,A00,186935,Staff,2,0,20,18
1683293422625,MUS 80,B00,186936,Staff,25,0,25,0
1683293423650,NANO 11,A00,204702,Lipomi; Darren John,0,0,0,0
1683293424678,NANO 15,A01,204709,Yang; Kesong,0,1,0,0
1683293425704,NANO 114,A00,202069,Jahed Motlagh; Zeinab,3,0,10,7
1683293426733,PHIL 1,A00,186955,Grush; Rick Scott,32,0,40,8
1683293427764,PHIL 10,A01,186973,Grush; Rick Scott,29,0,35,6
1683293427764,PHIL 10,A02,186974,Grush; Rick Scott,33,0,35,2
1683293428827,PHIL 13,A01,186976,Staff,7,0,35,28
1683293428827,PHIL 13,A02,186977,Staff,16,0,35,19
1683293429854,PHIL 14,A01,186979,Staff,31,0,35,4
1683293429854,PHIL 14,A02,186986,Staff,32,0,35,3
1683293430879,PHIL 28,A01,186988,Staff,16,0,30,14
1683293430879,PHIL 28,A02,186989,Staff,1,0,30,29
1683293430879,PHIL 28,A03,186990,Staff,9,0,30,21
1683293430879,PHIL 28,A04,186991,Staff,26,0,30,4
1683293431904,PHIL 120,A00,186997,Staff,23,0,40,17
1683293432929,PHIL 137,A00,187003,Staff,9,0,40,31
1683293433955,PHIL 150,A00,187015,Staff,47,0,70,23
1683293435043,PHIL 167,A00,187021,Lamey; Andy M.,35,0,40,5
1683293436071,PHIL 174,A01,202226,Staff,17,0,20,3
1683293436071,PHIL 174,A02,202235,Staff,20,0,20,0
1683293437097,PHIL 191A,A00,258918,Staff,0,0,1,1
1683293438126,PHYS 1A,A00,187028,Staff,26,0,60,34
1683293439150,PHYS 1AL,001,187036,Staff,2,0,30,28
1683293439150,PHYS 1AL,002,187049,Staff,18,0,30,12
1683293440172,PHYS 1B,A00,187058,Staff,23,0,60,37
1683293441197,PHYS 1BL,001,187064,Staff,0,0,30,30
1683293441197,PHYS 1BL,002,187070,Staff,6,0,30,24
1683293442223,PHYS 1C,A00,187082,Staff,32,0,120,88
1683293443248,PHYS 1CL,001,187088,Staff,0,9,30,30
1683293443248,PHYS 1CL,002,187089,Staff,0,2,30,30
1683293443248,PHYS 1CL,009,262693,Staff,12,0,30,18
1683293444275,PHYS 2B,A01,187097,Staff,54,0,115,61
1683293445299,PHYS 2C,A01,187099,Staff,67,0,115,48
1683293446323,PHYS 2CL,A01,187101,Staff,5,0,28,23
1683293446323,PHYS 2CL,A02,187102,Staff,15,0,28,13
1683293447348,PHYS 2D,A01,187123,Shotwell; Brian,95,0,115,20
1683293448375,PHYS 4B,A01,187133,Grinstein; Benjamin,35,0,50,15
1683293449399,POLI 10,A00,188819,Staff,0,3,50,50
1683293450425,POLI 11,A00,188827,Staff,43,0,50,7
1683293451452,POLI 13R,A00,188828,Staff,0,1,20,20
1683293452481,POLI 27,A01,188830,Elgin; Samuel Zincke,0,1,70,70
1683293453511,POLI 30,A00,188832,Desposato; Scott,33,0,50,17
1683293454537,POLI 102F,A00,188834,Staff,3,0,40,37
1683293455561,POLI 104A,A00,188852,Staff,14,0,30,16
1683293456586,POLI 104I,A00,188853,Staff,0,6,20,20
1683293457613,POLI 110B,A00,188854,Wiens; David,7,0,20,13
1683293458637,POLI 112A,A00,188855,Wiens; David,5,0,30,25
1683293459662,POLI 117R,A00,188856,Forman; Fonna,0,11,20,20
1683293460691,POLI 118,A00,188857,Ingham; Sean,8,0,20,12
1683293461720,POLI 120G,A00,188858,Staff,9,0,30,21
1683293462747,POLI 131CR,A00,188863,Hoston; Germaine,24,0,50,26
1683293463772,POLI 133,A00,188864,Nellis; Gareth Hb,44,0,50,6
1683293464797,POLI 134D,A00,188865,Desposato; Scott,27,0,30,3
1683293465830,POLI 142A,A00,188871,Gartzke; Erik,22,0,50,28
1683293466857,POLI 142K,A00,188874,Staff,38,0,50,12
1683293467885,POLI 143,A00,188940,Gartzke; Erik,16,0,30,14
1683293468910,POLI 153,A00,188943,Staff,3,0,20,17
1683293469936,POLI 160AA,A00,188944,Staff,13,0,40,27
1683293470961,POLI 170A,A00,188945,Staff,11,0,30,19
1683293473013,PSYC 1,A00,188952,Staff,38,0,90,52
1683293474041,PSYC 2,B00,188953,Staff,20,0,35,15
1683293475065,PSYC 6,A00,188970,Staff,47,0,60,13
1683293476090,PSYC 7,A00,188973,Staff,37,0,45,8
1683293477117,PSYC 60,A01,188980,Rickard; Timothy C.,43,0,60,17
1683293478148,PSYC 70,A01,189001,Steiner; Eric Tomas,24,0,45,21
1683293479174,PSYC 100,A00,189005,Lacefield; Katharine I,0,99,120,120
1683293480200,PSYC 102,A00,189008,Staff,10,0,30,20
1683293481225,PSYC 106,B00,189026,Gorman; Michael R.,37,0,60,23
1683293482254,PSYC 114,B01,189033,Winkielman; Piotr,0,32,30,30
1683293483280,PSYC 131,A00,189036,Anagnostaras; Stephan,0,43,60,60
1683293484309,PSYC 136,A00,189041,Lowe; Angela Beth,0,7,25,25
1683293485344,PSYC 137,A00,189057,Winkielman; Piotr,0,34,25,25
1683293486370,PSYC 144,A00,189107,Wixted; John T,0,7,50,50
1683293488433,PSYC 162,A00,189142,Staff,0,8,85,85
1683293489460,PSYC 172,A00,189144,Gorman; Michael R.,0,7,30,30
1683293491516,PSYC 179,A00,189146,Lacefield; Katharine I,0,84,120,120
1683293492542,PSYC 181,A00,189147,Anagnostaras; Stephan,0,44,90,90
1683293493568,PSYC 190R,A00,189148,Barner; David A.,0,22,80,80
1683293494593,PSYC 191,A00,189275,Rickard; Timothy C.,0,7,25,25
1683293495619,PSYC 193,A00,189276,Chapman; Eddie Nathaniel,0,1,0,4
1683293496646,PSYC 193L,A01,189281,Lowe; Angela Beth,12,0,20,8
1683293496646,PSYC 193L,B01,189285,Staff,28,0,35,7
1683293497673,RELI 149,A00,187137,Rahimi; Babak,7,0,40,33
1683293498699,SE 9,A01,187315,Staff,0,2,18,18
1683293499723,SE 101B,A00,187409,Staff,24,0,30,6
1683293500749,SE 110B,A00,187444,Staff,10,0,40,30
1683293501773,SE 130B,A00,187449,Staff,31,0,40,9
1683293502797,SE 150A,A00,187516,Staff,9,0,20,11
1683293503823,SE 154,A00,187528,Staff,30,0,50,20
1683293504852,SIO 3,A01,258171,Staff,35,0,40,5
1683293505881,SIO 10,A00,187144,Cook; Geoffrey W,0,3,75,75
1683293506909,SIO 45,A00,187152,Cook; Geoffrey W,1,0,100,99
1683293507937,SIO 109R,A00,194486,Staff,0,3,20,20
1683293509988,SIO 187,A01,187233,Kacev; David,12,0,40,28
1683293511014,SOCI 1,A01,258656,Thorpe; Charles Robert,28,0,30,2
1683293511014,SOCI 1,A02,258658,Thorpe; Charles Robert,30,0,30,0
1683293511014,SOCI 1,A03,258661,Thorpe; Charles Robert,25,0,25,0
1683293511014,SOCI 1,A04,258666,Thorpe; Charles Robert,22,0,25,3
1683293511014,SOCI 1,A05,258897,Thorpe; Charles Robert,23,0,25,2
1683293511014,SOCI 1,A06,258898,Thorpe; Charles Robert,25,0,25,0
1683293512044,SOCI 30,A01,258903,Pardo Guerra; Juan Pablo,16,0,30,14
1683293513071,SOCI 102,A00,258904,Staff,9,0,25,16
1683293514097,SOCI 106,A00,258905,Staff,19,0,25,6
1683293515126,SOCI 111,A00,258907,Ribas Norris; Janet Vanesa,26,0,30,4
1683293516150,SOCI 121R,A00,258908,Pardo Guerra; Juan Pablo,11,0,30,19
1683293517177,SOCI 126,A01,203330,Staff,14,0,20,6
1683293518203,SOCI 131,A00,258909,Thorpe; Charles Robert,31,0,60,29
1683293519229,SOCI 135,A00,258910,Payne; Christine Anna,0,9,30,30
1683293520255,SOCI 157,A00,258911,Staff,13,0,30,17
1683293521283,SOCI 184,A00,258912,Staff,26,0,30,4
1683293522312,SOCI 188D,A00,258913,Staff,21,0,30,9
1683293523341,SYN 2,001,187529,Staff,9,0,16,7
1683293523341,SYN 2,002,201452,Staff,0,18,16,16
1683293523341,SYN 2,003,201469,Staff,3,0,16,13
1683293524366,SYN 100,A01,187531,Staff,0,9,20,20
1683293524366,SYN 100,B01,201491,Staff,0,12,20,20
1683293525390,TDAC 1,A00,189286,Walsh; Kim C.,3,0,20,17
1683293525390,TDAC 1,B00,189287,Harting; Carla Kelso,11,0,20,9
1683293526416,TDAC 101,A00,189300,Walsh; Kim C.,16,0,20,4
1683293526416,TDAC 101,B00,189301,Harting; Carla Kelso,18,0,20,2
1683293527440,TDAC 102,A00,189304,Basso; Beatrice,14,0,20,6
1683293528466,TDAC 108,A00,189305,Staff,18,0,20,2
1683293529494,TDDE 131,A00,189310,Staff,19,0,20,1
1683293529494,TDDE 131,B00,189314,Staff,19,0,20,1
1683293529494,TDDE 131,C00,189315,Staff,48,0,50,2
1683293529494,TDDE 131,D00,189316,Staff,14,0,15,1
1683293529494,TDDE 131,E00,204841,Staff,20,0,20,0
1683293530518,TDGE 10,A00,189289,Staff,30,0,50,20
1683293530518,TDGE 10,B00,189290,Havis; Allan,2,0,50,48
1683293531549,TDGE 11,A00,189291,Fulton; Julia,0,3,50,50
1683293531549,TDGE 11,B00,189292,Staff,20,0,25,5
1683293531549,TDGE 11,C00,260270,Staff,0,0,0,0
1683293532577,TDGE 25,A00,189294,Staff,3,0,20,17
1683293533604,TDGE 124,A00,189318,Fulton; Julia,0,8,50,50
1683293534630,TDGE 125,A00,189319,Staff,13,0,25,12
1683293534630,TDGE 125,B00,189320,Staff,23,0,25,2
1683293535653,TDGE 127,A00,189322,Havis; Allan,0,0,50,50
1683293536678,TDHT 101,A00,189323,Staff,18,0,25,7
1683293536678,TDHT 101,B00,189324,Staff,25,0,25,0
1683293537704,TDHT 102,A00,189325,Staff,49,0,50,1
1683293538791,TDMV 1,A00,189295,Arcidiacono; Kristin,20,0,30,10
1683293538791,TDMV 1,B00,189296,Caligagan; Maria T.,24,0,30,6
1683293539823,TDMV 2,A00,189297,Sammartano; Tonnie,28,0,30,2
1683293539823,TDMV 2,B00,189299,Arcidiacono; Kristin,24,0,30,6
1683293540855,TDMV 3,A00,204998,Rincon; Alicia,22,0,30,8
1683293541880,TDMV 120,A00,189458,Sammartano; Tonnie,28,0,30,2
1683293542905,TDMV 138,A00,189541,Jun; Grace Shin Hae,22,0,40,18
1683293543930,TDMV 142,A00,189717,Caligagan; Tony,23,0,30,7
1683293543930,TDMV 142,B00,189718,Caligagan; Maria T.,25,0,30,5
1683293544959,TMC 2,A01,187533,Staff,25,0,25,0
1683293544959,TMC 2,A02,187534,Staff,25,0,25,0
1683293545989,USP 1,A01,187536,Kwak; Nancy,0,16,25,25
1683293547017,USP 5,A01,187538,Staff,9,0,25,16
1683293548047,USP 101,A00,199253,Staff,0,4,0,0
1683293549074,USP 124,A00,187562,Boomhower; Matthew Charles,1,0,30,29
1683293550102,USP 138,A00,187582,Staff,20,0,25,5
1683293551130,USP 152,A01,187597,Staff,4,0,25,21
1683293552157,USP 153,A00,187598,Staff,19,0,25,6
1683293553188,USP 168,A00,187607,Kwak; Nancy,2,0,5,3
1683293554213,USP 173,A00,187619,Staff,4,0,25,21
1683293555238,USP 181,A00,187638,Staff,0,0,25,25
1683293556263,VIS 103,A00,187650,Cruz; Edwin Teddy,23,0,75,52
1683293557288,VIS 110D,A00,187669,Staff,12,0,22,10
1683293558312,VIS 127C,A00,187720,Shen; Kuiyi,68,0,146,78
1683293559337,VIS 149,A00,187731,Yoldas; Pinar,0,14,22,22
1683293560364,VIS 151,A01,188091,Staff,22,0,34,12
1683293560364,VIS 151,A02,188092,Staff,11,0,34,23
1683293561393,VIS 160B,A00,188093,Stalbaum; Brett,0,0,10,10
1683293563443,WCWP 10B,A00,201720,Staff,10,0,15,5
1683293563443,WCWP 10B,B00,201722,Staff,8,0,15,7
1683293564470,WCWP 100,A00,201725,Gagnon; Jeffrey C,0,0,2,2
1683293564470,WCWP 100,B00,201727,Staff,0,4,15,15
1683293567587,ANBI 133,A00,258401,Wilder; Linnea Lorene,34,0,40,6
1683293568614,ANBI 140,A00,258395,Hrvoj Mihic; Branka,18,0,25,7
1683293569641,ANSC 120,A00,258402,Bialecki; Jon Anthony,27,0,40,13
1683293570670,ANSC 144,A00,258400,Staff,14,0,40,26
1683293572727,ANSC 166,A00,258396,Parish; Steven Martin,157,0,175,18
1683293573757,ANSC 180,A00,193533,Staff,9,0,20,11
1683293574783,ANSC 188,A00,258397,Jassal; Aftab,33,0,40,7
1683293575809,ANTH 3,A01,258316,Staff,23,0,30,7
1683293576833,ANTH 5,A00,258394,Semendeferi; Ekaterini,16,0,20,4
1683293577861,ANTH 21,A01,258331,Staff,9,0,40,31
1683293578889,ANTH 103,A00,258398,Varma; Saiba,15,0,25,10
1683293579919,AWP 10,001,202034,Staff,0,0,0,0
1683293579919,AWP 10,002,202035,Staff,0,0,0,0
1683293579919,AWP 10,003,202036,Staff,0,0,0,0
1683293579919,AWP 10,004,202037,Staff,0,0,0,0
1683293579919,AWP 10,005,202038,Staff,0,0,0,0
1683293579919,AWP 10,006,202039,Staff,0,0,0,0
1683293579919,AWP 10,007,202040,Staff,0,0,0,0
1683293579919,AWP 10,008,202041,Staff,0,0,0,0
1683293579919,AWP 10,009,202042,Staff,0,0,0,0
1683293579919,AWP 10,010,202043,Staff,0,0,0,0
1683293579919,AWP 10,011,202044,Staff,0,0,0,0
1683293579919,AWP 10,012,202045,Staff,0,0,0,0
1683293579919,AWP 10,013,202046,Staff,0,0,0,0
1683293579919,AWP 10,014,202047,Staff,0,0,0,0
1683293579919,AWP 10,015,202048,Staff,0,0,0,0
1683293579919,AWP 10,016,202049,Staff,0,0,0,0
1683293579919,AWP 10,017,202050,Staff,0,0,0,0
1683293579919,AWP 10,018,202051,Staff,0,0,0,0
1683293579919,AWP 10,019,202052,Staff,0,0,0,0
1683293579919,AWP 10,020,202053,Staff,0,0,0,0
1683293579919,AWP 10,021,202054,Staff,0,0,0,0
1683293579919,AWP 10,022,202055,Staff,0,0,0,0
1683293579919,AWP 10,023,202056,Staff,0,0,0,0
1683293579919,AWP 10,024,202057,Staff,0,0,0,0
1683293579919,AWP 10,025,202058,Staff,0,0,0,0
1683293579919,AWP 10,026,202059,Staff,0,0,0,0
1683293580945,AWP 102,001,202032,Staff,0,0,0,0
1683293580945,AWP 102,002,202033,Staff,0,0,0,0
1683293581975,BENG 100,A01,254234,Taylor Amos; Alyssa C,31,0,40,9
1683293583005,BENG 196,001,270013,Engler; Adam J.,9999,0,9999,0
1683293584040,BICD 100R,A01,202018,Smith; Laurie,0,7,32,32
1683293584040,BICD 100R,A02,202019,Smith; Laurie,0,2,32,32
1683293584040,BICD 100R,A03,202020,Smith; Laurie,0,1,32,32
1683293584040,BICD 100R,A04,202021,Smith; Laurie,8,0,32,24
1683293584040,BICD 100R,A05,202022,Smith; Laurie,12,0,32,20
1683293585067,BICD 136,A01,193242,Gustafson-Brown; Cindy,0,2,32,32
1683293585067,BICD 136,A02,193244,Gustafson-Brown; Cindy,15,0,32,17
1683293586095,BIEB 102,A01,193249,Butler; Shannon Rhey,0,2,32,32
1683293586095,BIEB 102,A02,193251,Butler; Shannon Rhey,0,0,32,32
1683293586095,BIEB 102,A03,193253,Butler; Shannon Rhey,0,1,32,32
1683293586095,BIEB 102,A04,193255,Butler; Shannon Rhey,17,0,32,15
1683293586095,BIEB 102,A05,193265,Butler; Shannon Rhey,26,0,32,6
1683293586095,BIEB 102,A06,193269,Butler; Shannon Rhey,16,0,32,16
1683293588148,BIEB 150,A01,193274,Staff,0,0,32,32
1683293588148,BIEB 150,A02,193285,Staff,24,0,32,8
1683293589173,BIEB 194,A00,193286,Kurle; Carolyn M.,22,0,32,10
1683293590206,BILD 1,A01,192291,Staff,16,0,32,16
1683293590206,BILD 1,A02,192292,Staff,30,0,32,2
1683293590206,BILD 1,B01,192520,Reuther; Keefe,0,1,0,0
1683293590206,BILD 1,B02,192532,Reuther; Keefe,0,1,0,0
1683293591237,BILD 3,A01,192556,Butler; Shannon Rhey,0,0,32,32
1683293591237,BILD 3,A02,192581,Butler; Shannon Rhey,5,0,32,27
1683293591237,BILD 3,A03,192611,Butler; Shannon Rhey,23,0,32,9
1683293591237,BILD 3,A04,192612,Butler; Shannon Rhey,25,0,32,7
1683293591237,BILD 3,A05,192613,Butler; Shannon Rhey,27,0,32,5
1683293591237,BILD 3,A06,192679,Butler; Shannon Rhey,27,0,32,5
1683293591237,BILD 3,A07,192682,Butler; Shannon Rhey,22,0,32,10
1683293592266,BILD 4,A01,192836,Reuther; Keefe,1,0,24,23
1683293592266,BILD 4,A02,193044,Reuther; Keefe,4,0,24,20
1683293593297,BILD 10,A01,193142,Gustafson-Brown; Cindy,31,0,32,1
1683293593297,BILD 10,A02,193149,Gustafson-Brown; Cindy,31,0,32,1
1683293594326,BIMM 100,A01,193301,Staff,0,6,32,32
1683293594326,BIMM 100,A02,193312,Staff,0,5,32,32
1683293594326,BIMM 100,A03,193323,Staff,0,8,32,32
1683293595354,BIMM 101,A01,193329,McDonnell; Lisa Marie,0,3,24,24
1683293595354,BIMM 101,A02,193339,McDonnell; Lisa Marie,0,2,24,24
1683293595354,BIMM 101,B01,193354,McDonnell; Lisa Marie,0,3,24,24
1683293595354,BIMM 101,B02,193357,McDonnell; Lisa Marie,0,3,24,24
1683293596380,BIMM 110,A01,193377,Tat; John,0,11,32,32
1683293596380,BIMM 110,A02,193378,Tat; John,1,9,32,31
1683293597408,BIMM 120,A01,206116,Staff,0,0,32,32
1683293597408,BIMM 120,A02,206117,Staff,8,0,32,24
1683293597408,BIMM 120,A03,206121,Staff,21,0,32,11
1683293598435,BIPN 100,A01,193393,Park; Ji Young,0,14,32,32
1683293598435,BIPN 100,A02,193402,Park; Ji Young,0,12,32,32
1683293598435,BIPN 100,A03,193413,Park; Ji Young,0,14,32,32
1683293598435,BIPN 100,A04,193414,Park; Ji Young,0,13,32,32
1683293599461,BIPN 102,A01,193429,Staff,0,0,32,32
1683293599461,BIPN 102,A02,193438,Staff,23,0,32,9
1683293600492,BIPN 106,A01,193450,Reyes Gonzalez; Catalina,0,2,40,40
1683293601518,BIPN 134,A01,193465,Cooke; James Edward,0,0,32,32
1683293601518,BIPN 134,A02,193474,Cooke; James Edward,27,0,32,5
1683293601518,BIPN 134,A03,193485,Cooke; James Edward,29,0,32,3
1683293601518,BIPN 134,A04,193486,Cooke; James Edward,21,0,32,11
1683293601518,BIPN 134,A05,193491,Cooke; James Edward,31,0,32,1
1683293601518,BIPN 134,A06,193501,Cooke; James Edward,30,0,32,2
1683293601518,BIPN 134,A07,193510,Cooke; James Edward,29,0,32,3
1683293603575,BISP 194,A00,222522,Staff,16,0,32,16
1683293604599,CAT 124,A01,202407,Staff,20,0,25,5
1683293605626,CAT 125,A00,202408,Marchisotto; Jennifer Anne,4,0,20,16
1683293606653,CAT 125R,A00,202409,Smith; Lauryn Alissa,0,11,20,20
1683293606653,CAT 125R,B00,202410,Morales; Celeste Georgianna,0,11,20,20
1683293606653,CAT 125R,C00,202411,Irwin; Matthew Joseph,0,10,20,20
1683293607684,CENG 15,A01,204712,Yang; Kesong,0,1,0,0
1683293608713,CENG 114,A00,202070,Jahed Motlagh; Zeinab,5,0,20,15
1683293609743,CGS 105,A00,185477,Wesling; Megan E.,24,0,40,16
1683293610771,CGS 106,A00,185494,Staff,13,0,22,9
1683293611799,CGS 108,A00,185495,Staff,14,0,20,6
1683293612825,CGS 114,A00,185496,Staff,13,0,18,5
1683293613854,CGS 119,A00,185501,Staff,15,0,20,5
1683293614882,CGS 120,A00,185511,Staff,13,0,20,7
1683293615916,CHEM 4,A01,184675,Bussey; Thomas J,96,0,100,4
1683293616946,CHEM 6A,A01,184677,Staff,35,0,60,25
1683293617975,CHEM 6B,A01,184679,Staff,65,0,100,35
1683293619001,CHEM 6C,A01,184681,Bussey; Thomas J,1,0,50,49
1683293619001,CHEM 6C,A02,184682,Bussey; Thomas J,34,0,50,16
1683293620031,CHEM 40A,A01,184684,Albizati; Kim F.,37,0,100,63
1683293621061,CHEM 40B,A01,184686,Albizati; Kim F.,0,20,100,100
1683293622089,CHEM 41B,A01,184690,Staff,52,0,100,48
1683293623120,COGS 3,A01,184715,Boyle; Mary E. T.,0,25,40,40
1683293624146,COGS 14B,A01,185172,Staff,0,15,38,38
1683293625171,COGS 18,A01,184736,Staff,20,0,80,60
1683293626197,COGS 100,A01,184932,Staff,0,5,73,73
1683293627224,COGS 101A,A01,184935,Staff,0,38,30,30
1683293628250,COGS 101B,A01,184944,Staff,0,2,30,30
1683293629277,COGS 101C,A01,184946,Staff,0,12,30,30
1683293630306,COGS 102A,A01,184951,Johnson; Christine M.,2,0,40,38
1683293631338,COGS 107B,A01,184953,Mooshagian; Eric Frederick,0,50,40,40
1683293632368,COGS 118B,A01,184959,Gupta; Anjum,0,48,40,40
1683293633397,COGS 153,A00,184961,Staff,0,15,30,30
1683293634422,COGS 177,A00,184962,Staff,0,21,30,30
1683293635446,COGS 187A,A01,184969,Boyle; Mary E. T.,0,17,40,40
1683293636472,COMM 10,A01,185174,Staff,0,5,25,25
1683293636472,COMM 10,A02,185189,Staff,0,5,25,25
1683293636472,COMM 10,A03,269821,Staff,0,0,0,0
1683293637497,COMM 100B,A01,185475,Staff,0,0,0,2
1683293637497,COMM 100B,A02,185476,Staff,14,0,25,11
1683293638523,COMM 100C,A01,185314,Staff,1,0,25,24
1683293638523,COMM 100C,A02,185327,Staff,19,0,25,6
1683293639548,COMM 110M,A00,185349,Staff,2,0,40,38
1683293640574,COMM 113T,A00,185352,Staff,25,0,40,15
1683293641599,COMM 114I,A00,185353,Staff,33,0,40,7
1683293642690,COMM 131,A00,185354,Staff,19,0,30,11
1683293643715,CSE 8A,A50,185358,Cao; Yingjun,0,46,10,10
1683293644741,CSE 8B,A01,185362,Staff,0,47,50,50
1683293645766,CSE 11,A01,185416,Cao; Yingjun,0,93,10,10
1683293646798,CSE 20,A01,185445,Briones; Jor-el Thomas Caparas,5,0,25,20
1683293647825,CSE 21,A01,185447,Staff,10,0,50,40
1683293648851,CSE 101,A01,185451,Staff,0,12,50,50
1683293648851,CSE 101,B01,185453,Jones; Miles E,0,11,50,50
1683293650902,CSE 141,A01,185458,Eldon; John,20,0,100,80
1683293651927,CSE 141L,A01,185461,Eldon; John,12,0,100,88
1683293652953,CSE 142,A01,185463,Staff,35,0,60,25
1683293652953,CSE 142,B01,201355,Staff,0,6,60,60
1683293653979,CSE 142L,A01,185470,Staff,35,0,60,25
1683293653979,CSE 142L,B01,201417,Staff,0,5,60,60
1683293655003,CSE 190,A00,201433,Staff,32,0,49,17
1683293656036,DOC 1,A01,259136,Strom; Megan C.,8,0,15,7
1683293656036,DOC 1,A02,259137,Strom; Megan C.,14,0,15,1
1683293656036,DOC 1,A03,259138,Strom; Megan C.,14,0,15,1
1683293656036,DOC 1,A04,259139,Strom; Megan C.,14,0,15,1
1683293657065,DOC 100D,A00,259140,Pass; Natalye Joann,17,0,25,8
1683293658091,DSGN 1,A01,184749,Rill; Bryan,0,24,30,30
1683293659119,DSGN 100,A01,185168,Staff,0,2,25,25
1683293660147,ECE 5,A01,185626,Morris; Karcher William,0,10,0,0
1683293661172,ECE 101,A01,185628,Staff,17,0,70,53
1683293662197,ECE 107,A01,185635,Baghdadchi; Saharnaz,0,0,20,20
1683293662197,ECE 107,A02,185638,Baghdadchi; Saharnaz,4,0,20,16
1683293663223,ECE 148,A01,185647,Silberman; Jack,1,0,16,15
1683293664248,ECON 1,A01,185537,Crane; Meredith Helen,54,0,70,16
1683293665274,ECON 3,A01,185549,Crane; Meredith Helen,33,0,70,37
1683293666299,ECON 4,A01,203354,Anderson; John Charles,0,4,10,10
1683293667327,ECON 100A,A01,185574,Staff,0,4,40,40
1683293668355,ECON 100B,A01,185576,Staff,0,22,40,40
1683293669385,ECON 100C,A01,185589,Newhouse; Herbert S,30,0,70,40
1683293670415,ECON 105,A00,185608,Vespa; Emanuel Ignacio,19,0,35,16
1683293671444,ECON 109,A01,185610,Shishkin; Denis,10,0,35,25
1683293672471,ECON 110A,A01,185612,Staff,11,0,40,29
1683293673498,ECON 120A,A01,185615,Staff,20,0,40,20
1683293674523,ECON 120C,A01,185617,Sun; Yixiao,0,20,70,70
1683293675549,ECON 144,A00,203346,Squires; Dale E,3,0,35,32
1683293676574,ECON 171,A01,203349,Newhouse; Herbert S,0,1,35,35
1683293677600,ECON 173A,A01,185621,Toda; Alexis Akira,21,0,35,14
1683293678635,EDS 25,A01,202413,Staff,0,1,0,0
1683293678635,EDS 25,A02,202414,Staff,0,1,0,0
1683293678635,EDS 25,A03,202415,Staff,0,0,0,0
1683293678635,EDS 25,A04,202416,Staff,0,1,0,0
1683293678635,EDS 25,A05,202439,Staff,0,0,0,0
1683293678635,EDS 25,A06,202440,Staff,0,0,0,0
1683293678635,EDS 25,B01,202631,Staff,0,0,0,0
1683293678635,EDS 25,B02,202632,Staff,0,0,0,0
1683293678635,EDS 25,B03,202639,Staff,0,0,0,0
1683293678635,EDS 25,B04,202640,Staff,0,0,0,0
1683293678635,EDS 25,B05,202643,Staff,0,0,0,0
1683293678635,EDS 25,B06,202644,Staff,0,0,0,0
1683293679668,EDS 38,A01,202659,Black; Alison Michelle,24,0,25,1
1683293680696,EDS 115,A00,202652,Staff,17,0,30,13
1683293681721,EDS 125,A00,202649,Staff,14,0,30,16
1683293682745,EDS 126,A01,203332,Staff,30,0,30,0
1683293683773,EDS 139,A00,202838,Staff,17,0,25,8
1683293684801,EDS 146,A01,202655,Staff,15,0,25,10
1683293685831,ENG 15,A00,185667,Staff,0,1,0,0
1683293685831,ENG 15,B00,185672,Staff,0,0,0,0
1683293685831,ENG 15,C00,185675,Staff,0,0,0,0
1683293685831,ENG 15,D00,185682,Staff,0,0,0,0
1683293685831,ENG 15,E00,185684,Staff,0,0,0,0
1683293686857,ETHN 103,A00,185710,Staff,0,3,35,35
1683293687887,ETHN 103A,A00,199228,Man; Simeon S,3,0,9,6
1683293688914,ETHN 109,A00,185711,Staff,18,0,35,17
1683293689940,ETHN 142,A00,185726,Staff,0,4,30,30
1683293690965,ETHN 163J,A00,199229,Man; Simeon S,6,0,8,2
1683293691990,ETHN 168,A00,185727,Staff,8,0,10,2
1683293693016,ETHN 182,A00,185728,Staff,1,0,35,34
1683293694042,ETHN 183,A00,185737,Staff,8,0,18,10
1683293695067,GLBH 111,A01,209361,Burgos; Jose L.,0,0,0,0
1683293697121,HIEU 104,A00,185792,Staff,16,0,20,4
1683293698145,HIEU 115,A00,185800,Staff,1,0,20,19
1683293699168,HIEU 128,A00,185801,Staff,0,7,20,20
1683293700197,HIEU 147,A00,185802,Staff,16,0,20,4
1683293701269,HIEU 154,A00,185823,Staff,12,0,20,8
1683293702293,HILA 102,A00,185826,Staff,13,0,20,7
1683293703318,HILD 2C,A01,185778,Staff,0,12,20,20
1683293704350,HILD 7B,A01,185780,Kwak; Nancy,0,15,32,32
1683293704350,HILD 7B,A02,185781,Kwak; Nancy,0,18,32,32
1683293705376,HILD 30,A01,185791,Staff,14,0,20,6
1683293706402,HISC 119,A00,185830,Golan; Tal,0,9,20,20
1683293707427,HITO 156GS,A00,185831,Patterson; Patrick H.,0,0,0,23
1683293708454,HIUS 103,A00,185832,Man; Simeon S,0,7,20,20
1683293709479,HIUS 117,A00,185836,Kwak; Nancy,2,0,20,18
1683293710503,HIUS 125,A00,185840,Man; Simeon S,0,0,23,23
1683293711528,HIUS 149,A00,185845,Staff,0,0,20,20
1683293712561,HUM 3,A01,185882,Zavodny; Tatiana Sophia,0,6,50,50
1683293712561,HUM 3,B01,185899,Caldwell; Michael Alan,0,19,50,50
1683293713585,HUM 3GS,A00,185900,Patterson; Patrick H.,0,0,0,23
1683293714613,HUM 4,A01,185938,Zroka; Amy Liane,31,0,50,19
1683293714613,HUM 4,B01,185956,Watkins; Eric,0,2,50,50
1683293714613,HUM 4,B02,202209,Watkins; Eric,0,1,50,50
1683293714613,HUM 4,B03,202210,Watkins; Eric,0,0,50,50
1683293715638,HUM 5,A01,185958,West; Geoffrey Scott,5,0,50,45
1683293715638,HUM 5,A02,202215,West; Geoffrey Scott,0,0,50,50
1683293716667,INTL 190,A00,185959,Gagnon; Jeffrey C,0,0,0,9
1683293716667,INTL 190,B00,185960,Lettieri; Michael Joseph,0,0,0,1
1683293717694,JAPN 180,A00,254509,Staff,0,1,25,25
1683293718726,LATI 10,A01,202853,Kennemore; Amy Michelle,5,0,35,30
1683293718726,LATI 10,A02,202854,Kennemore; Amy Michelle,1,0,35,34
1683293718726,LATI 10,A03,270054,Kennemore; Amy Michelle,30,0,30,0
1683293719751,LATI 180,A00,202855,Kennemore; Amy Michelle,11,0,20,9
1683293720777,LAWS 101,A00,201767,Golan; Tal,0,7,40,40
1683293721801,LIFR 1C,A00,185961,Staff,6,0,20,14
1683293722826,LIFR 1CX,A00,185962,Staff,7,0,20,13
1683293723851,LIFR 1D,A00,185963,Staff,9,0,20,11
1683293724880,LIFR 1DX,A00,185964,Staff,9,0,20,11
1683293725906,LIGN 101,A01,186039,Staff,43,0,50,7
1683293726930,LIGN 165,A00,186040,Staff,18,0,50,32
1683293727954,LTCS 108,A00,186041,Staff,6,0,10,4
1683293728978,LTCS 119,A00,186042,Staff,16,0,20,4
1683293730007,LTCS 130,A00,186043,Wesling; Megan E.,15,0,25,10
1683293732056,LTEA 138,A00,186119,Staff,14,0,40,26
1683293733080,LTEN 124,A00,186148,Staff,6,0,25,19
1683293734108,LTEN 178,A00,186149,Staff,7,0,15,8
1683293735139,LTEN 181,A00,186150,Blanco; John D,33,0,40,7
1683293736163,LTWL 120,A00,186160,Staff,20,0,25,5
1683293737186,LTWL 165,A00,186161,Staff,22,0,25,3
1683293738214,LTWR 100,A00,186162,Staff,0,4,15,15
1683293739239,LTWR 102,A00,186163,Doller; Ben,5,0,15,10
1683293740263,MAE 8,A01,186412,Staff,0,0,0,0
1683293741298,MAE 30B,A00,186445,Bahadori; Mohammad Yousef,83,0,100,17
1683293742327,MAE 40,A00,186592,Bewley; Thomas R,9,0,50,41
1683293743355,MAE 101B,A00,186593,Bahadori; Mohammad Yousef,81,0,100,19
1683293744386,MAE 105,A00,186594,Bandaru; Prabhakar,12,0,50,38
1683293745418,MAE 107,A00,186599,Pham; Hieu Tan,0,6,120,120
1683293746502,MAE 148,A01,186660,Silberman; Jack,3,0,16,13
1683293747531,MATH 10A,A01,188095,Staff,0,7,35,35
1683293748561,MATH 10B,A01,188097,Bowers; Adam R.,0,11,30,30
1683293748561,MATH 10B,A02,188099,Bowers; Adam R.,0,9,30,30
1683293748561,MATH 10B,B01,188104,Bowers; Adam R.,0,11,30,30
1683293748561,MATH 10B,B02,188106,Bowers; Adam R.,0,11,30,30
1683293749587,MATH 10C,A01,188111,Staff,0,18,30,30
1683293749587,MATH 10C,A02,188127,Staff,0,17,30,30
1683293749587,MATH 10C,A03,188131,Staff,0,17,30,30
1683293749587,MATH 10C,B01,188218,Staff,21,0,30,9
1683293749587,MATH 10C,B02,188244,Staff,13,0,30,17
1683293749587,MATH 10C,B03,188277,Staff,16,0,30,14
1683293750613,MATH 18,A01,188344,Bach; Quang Tran,18,0,30,12
1683293750613,MATH 18,A02,188345,Bach; Quang Tran,11,0,30,19
1683293750613,MATH 18,B01,188353,Bach; Quang Tran,10,0,30,20
1683293750613,MATH 18,B02,188354,Bach; Quang Tran,20,0,30,10
1683293751637,MATH 20A,A01,188374,Staff,13,0,35,22
1683293752661,MATH 20B,A01,188382,Ohm; Ko Woon,6,0,30,24
1683293752661,MATH 20B,A02,188383,Ohm; Ko Woon,24,0,30,6
1683293752661,MATH 20B,B01,188385,Ohm; Ko Woon,7,0,30,23
1683293752661,MATH 20B,B02,188392,Ohm; Ko Woon,22,0,30,8
1683293753691,MATH 20C,A01,188394,Harel; Guershon,10,0,30,20
1683293753691,MATH 20C,A02,188395,Harel; Guershon,13,0,30,17
1683293753691,MATH 20C,B01,188404,Harel; Guershon,3,0,30,27
1683293753691,MATH 20C,B02,188405,Harel; Guershon,19,0,30,11
1683293754723,MATH 20D,A01,188414,Hammock; Frances H,0,1,30,30
1683293754723,MATH 20D,A02,188415,Hammock; Frances H,4,0,30,26
1683293754723,MATH 20D,B01,188447,Hammock; Frances H,2,0,30,28
1683293754723,MATH 20D,B02,188486,Hammock; Frances H,8,0,30,22
1683293755751,MATH 20E,A01,188649,Staff,22,0,30,8
1683293755751,MATH 20E,A02,188650,Staff,23,0,30,7
1683293755751,MATH 20E,A03,188673,Staff,0,0,30,30
1683293756776,MATH 102,A01,188675,Staff,0,35,35,35
1683293757803,MATH 103B,A01,188681,Staff,4,0,35,31
1683293757803,MATH 103B,B01,188692,Staff,7,0,35,28
1683293758834,MATH 109,A01,188695,Salehi Golsefidy; Alireza,25,0,35,10
1683293758834,MATH 109,A02,188696,Salehi Golsefidy; Alireza,27,0,35,8
1683293759865,MATH 120A,A01,188698,Eggers; John Dietrich,5,0,35,30
1683293760890,MATH 142B,A01,188736,Ioana; Adrian,0,2,30,30
1683293760890,MATH 142B,A02,188741,Ioana; Adrian,0,1,30,30
1683293760890,MATH 142B,A03,188743,Ioana; Adrian,0,3,30,30
1683293761915,MATH 168A,A01,188790,Staff,0,8,35,35
1683293762941,MATH 170A,A01,188803,Nie; Jiawang,0,2,35,35
1683293762941,MATH 170A,A02,188811,Nie; Jiawang,0,0,35,35
1683293762941,MATH 170A,A03,188814,Nie; Jiawang,1,0,35,34
1683293762941,MATH 170A,A04,188815,Nie; Jiawang,14,0,35,21
1683293763966,MATH 193B,A01,188817,Staff,0,0,35,35
1683293763966,MATH 193B,A02,188818,Staff,5,0,35,30
1683293764990,MGT 4,A01,202857,Anderson; John Charles,62,0,80,18
1683293766016,MGT 12,A00,202858,Lindenberger; Wade Douglas,43,0,90,47
1683293767043,MGT 18,A00,202859,Staff,74,0,90,16
1683293768073,MGT 18GS,A00,202860,McKay; Michael J,13,0,28,15
1683293769106,MGT 45,A00,202861,Pecore; Joseph P.,14,0,90,76
1683293770132,MGT 100,A00,202863,Yavorsky; Daniel Ryan,28,0,90,62
1683293771161,MGT 103,A00,202864,Ehrich; Kristine R,0,16,90,90
1683293772187,MGT 112,A00,202865,Ehrich; Kristine R,15,0,90,75
1683293773213,MGT 121A,A00,202868,Staff,0,19,0,0
1683293774238,MGT 131B,A00,202869,Anderson; John Charles,59,0,90,31
1683293775267,MGT 136,A00,202871,Lindenberger; Wade Douglas,84,0,90,6
1683293776291,MGT 164,A00,202873,Staff,0,69,90,90
1683293777315,MGT 164GS,A00,202874,McKay; Mary A,13,0,28,15
1683293778343,MGT 180,A00,202875,Staff,0,51,90,90
1683293779367,MMW 11R,A01,205019,Herbst; Matthew,3,0,30,27
1683293779367,MMW 11R,A02,205026,Herbst; Matthew,29,0,30,1
1683293780395,MMW 15,A01,193512,Chang; Edmond Yi-Teh,0,9,28,28
1683293780395,MMW 15,A02,193513,Chang; Edmond Yi-Teh,0,5,28,28
1683293780395,MMW 15,A03,193514,Chang; Edmond Yi-Teh,0,5,28,28
1683293780395,MMW 15,A04,193515,Chang; Edmond Yi-Teh,0,4,28,28
1683293780395,MMW 15,A05,193516,Chang; Edmond Yi-Teh,0,4,28,28
1683293780395,MMW 15,A06,193517,Chang; Edmond Yi-Teh,0,5,28,28
1683293780395,MMW 15,B01,193519,Chang; Edmond Yi-Teh,0,4,28,28
1683293780395,MMW 15,B02,193520,Chang; Edmond Yi-Teh,0,5,28,28
1683293780395,MMW 15,B03,193521,Chang; Edmond Yi-Teh,0,4,28,28
1683293780395,MMW 15,B04,193522,Chang; Edmond Yi-Teh,0,4,28,28
1683293780395,MMW 15,B05,193523,Chang; Edmond Yi-Teh,0,5,28,28
1683293780395,MMW 15,B06,193524,Chang; Edmond Yi-Teh,0,4,28,28
1683293781420,MMW 122,A01,193526,Rahimi; Babak,0,14,28,28
1683293781420,MMW 122,A02,193527,Rahimi; Babak,0,14,28,28
1683293781420,MMW 122,A03,193528,Rahimi; Babak,0,0,0,0
1683293781420,MMW 122,A04,193529,Rahimi; Babak,0,0,0,0
1683293782449,MUS 1A,A01,186663,Staff,0,20,35,35
1683293783476,MUS 4,A01,186715,Staff,0,12,35,35
1683293784506,MUS 5R,A01,186796,Dubnov; Shlomo,0,16,35,35
1683293785537,MUS 6,A01,186798,Staff,0,3,25,25
1683293786562,MUS 7,A01,186830,Staff,12,0,35,23
1683293787590,MUS 8,A01,186930,Staff,0,25,35,35
1683293788621,MUS 15,A01,186932,Staff,0,15,35,35
1683293788621,MUS 15,B01,186934,Staff,0,14,35,35
1683293789650,MUS 80,A00,186935,Staff,2,0,20,18
1683293789650,MUS 80,B00,186936,Staff,25,0,25,0
1683293790674,NANO 11,A00,204702,Lipomi; Darren John,0,0,0,0
1683293791697,NANO 15,A01,204709,Yang; Kesong,0,1,0,0
1683293792723,NANO 114,A00,202069,Jahed Motlagh; Zeinab,3,0,10,7
1683293793747,PHIL 1,A00,186955,Grush; Rick Scott,32,0,40,8
1683293794772,PHIL 10,A01,186973,Grush; Rick Scott,29,0,35,6
1683293794772,PHIL 10,A02,186974,Grush; Rick Scott,33,0,35,2
1683293795798,PHIL 13,A01,186976,Staff,7,0,35,28
1683293795798,PHIL 13,A02,186977,Staff,16,0,35,19
1683293796827,PHIL 14,A01,186979,Staff,31,0,35,4
1683293796827,PHIL 14,A02,186986,Staff,32,0,35,3
1683293797852,PHIL 28,A01,186988,Staff,16,0,30,14
1683293797852,PHIL 28,A02,186989,Staff,1,0,30,29
1683293797852,PHIL 28,A03,186990,Staff,9,0,30,21
1683293797852,PHIL 28,A04,186991,Staff,26,0,30,4
1683293798877,PHIL 120,A00,186997,Staff,23,0,40,17
1683293799901,PHIL 137,A00,187003,Staff,9,0,40,31
1683293800928,PHIL 150,A00,187015,Staff,47,0,70,23
1683293801952,PHIL 167,A00,187021,Lamey; Andy M.,35,0,40,5
1683293802978,PHIL 174,A01,202226,Staff,17,0,20,3
1683293802978,PHIL 174,A02,202235,Staff,20,0,20,0
1683293804003,PHIL 191A,A00,258918,Staff,0,0,1,1
1683293805029,PHYS 1A,A00,187028,Staff,26,0,60,34
1683293806058,PHYS 1AL,001,187036,Staff,2,0,30,28
1683293806058,PHYS 1AL,002,187049,Staff,18,0,30,12
1683293807083,PHYS 1B,A00,187058,Staff,23,0,60,37
1683293808109,PHYS 1BL,001,187064,Staff,0,0,30,30
1683293808109,PHYS 1BL,002,187070,Staff,6,0,30,24
1683293809138,PHYS 1C,A00,187082,Staff,32,0,120,88
1683293810164,PHYS 1CL,001,187088,Staff,0,9,30,30
1683293810164,PHYS 1CL,002,187089,Staff,0,2,30,30
1683293810164,PHYS 1CL,009,262693,Staff,12,0,30,18
1683293811190,PHYS 2B,A01,187097,Staff,54,0,115,61
1683293812219,PHYS 2C,A01,187099,Staff,67,0,115,48
1683293813245,PHYS 2CL,A01,187101,Staff,5,0,28,23
1683293813245,PHYS 2CL,A02,187102,Staff,15,0,28,13
1683293814271,PHYS 2D,A01,187123,Shotwell; Brian,95,0,115,20
1683293815296,PHYS 4B,A01,187133,Grinstein; Benjamin,35,0,50,15
1683293816321,POLI 10,A00,188819,Staff,0,3,50,50
1683293817346,POLI 11,A00,188827,Staff,43,0,50,7
1683293818369,POLI 13R,A00,188828,Staff,0,1,20,20
1683293819393,POLI 27,A01,188830,Elgin; Samuel Zincke,0,1,70,70
1683293820419,POLI 30,A00,188832,Desposato; Scott,33,0,50,17
1683293821444,POLI 102F,A00,188834,Staff,3,0,40,37
1683293822470,POLI 104A,A00,188852,Staff,14,0,30,16
1683293823495,POLI 104I,A00,188853,Staff,0,6,20,20
1683293824526,POLI 110B,A00,188854,Wiens; David,7,0,20,13
1683293825554,POLI 112A,A00,188855,Wiens; David,5,0,30,25
1683293826584,POLI 117R,A00,188856,Forman; Fonna,0,11,20,20
1683293827613,POLI 118,A00,188857,Ingham; Sean,8,0,20,12
1683293828642,POLI 120G,A00,188858,Staff,9,0,30,21
1683293829672,POLI 131CR,A00,188863,Hoston; Germaine,24,0,50,26
1683293830703,POLI 133,A00,188864,Nellis; Gareth Hb,44,0,50,6
1683293831732,POLI 134D,A00,188865,Desposato; Scott,27,0,30,3
1683293832760,POLI 142A,A00,188871,Gartzke; Erik,22,0,50,28
1683293833787,POLI 142K,A00,188874,Staff,38,0,50,12
1683293834813,POLI 143,A00,188940,Gartzke; Erik,16,0,30,14
1683293835839,POLI 153,A00,188943,Staff,3,0,20,17
1683293836863,POLI 160AA,A00,188944,Staff,13,0,40,27
1683293837887,POLI 170A,A00,188945,Staff,11,0,30,19
1683293839942,PSYC 1,A00,188952,Staff,38,0,90,52
1683293840970,PSYC 2,B00,188953,Staff,20,0,35,15
1683293841998,PSYC 6,A00,188970,Staff,47,0,60,13
1683293843023,PSYC 7,A00,188973,Staff,37,0,45,8
1683293844053,PSYC 60,A01,188980,Rickard; Timothy C.,43,0,60,17
1683293845082,PSYC 70,A01,189001,Steiner; Eric Tomas,24,0,45,21
1683293846113,PSYC 100,A00,189005,Lacefield; Katharine I,0,99,120,120
1683293847140,PSYC 102,A00,189008,Staff,10,0,30,20
1683293848163,PSYC 106,B00,189026,Gorman; Michael R.,37,0,60,23
1683293849190,PSYC 114,B01,189033,Winkielman; Piotr,0,32,30,30
1683293850270,PSYC 131,A00,189036,Anagnostaras; Stephan,0,43,60,60
1683293851295,PSYC 136,A00,189041,Lowe; Angela Beth,0,7,25,25
1683293852319,PSYC 137,A00,189057,Winkielman; Piotr,0,34,25,25
1683293853348,PSYC 144,A00,189107,Wixted; John T,0,7,50,50
1683293855401,PSYC 162,A00,189142,Staff,0,8,85,85
1683293856425,PSYC 172,A00,189144,Gorman; Michael R.,0,7,30,30
1683293858474,PSYC 179,A00,189146,Lacefield; Katharine I,0,84,120,120
1683293859499,PSYC 181,A00,189147,Anagnostaras; Stephan,0,44,90,90
1683293860529,PSYC 190R,A00,189148,Barner; David A.,0,22,80,80
1683293861558,PSYC 191,A00,189275,Rickard; Timothy C.,0,7,25,25
1683293862586,PSYC 193,A00,189276,Chapman; Eddie Nathaniel,0,1,0,4
1683293863616,PSYC 193L,A01,189281,Lowe; Angela Beth,12,0,20,8
1683293863616,PSYC 193L,B01,189285,Staff,28,0,35,7
1683293864644,RELI 149,A00,187137,Rahimi; Babak,7,0,40,33
1683293865669,SE 9,A01,187315,Staff,0,2,18,18
1683293866694,SE 101B,A00,187409,Staff,24,0,30,6
1683293867717,SE 110B,A00,187444,Staff,10,0,40,30
1683293868743,SE 130B,A00,187449,Staff,31,0,40,9
1683293869766,SE 150A,A00,187516,Staff,9,0,20,11
1683293870792,SE 154,A00,187528,Staff,30,0,50,20
1683293871817,SIO 3,A01,258171,Staff,35,0,40,5
1683293872844,SIO 10,A00,187144,Cook; Geoffrey W,0,3,75,75
1683293873873,SIO 45,A00,187152,Cook; Geoffrey W,1,0,100,99
1683293874898,SIO 109R,A00,194486,Staff,0,3,20,20
1683293876955,SIO 187,A01,187233,Kacev; David,12,0,40,28
1683293877985,SOCI 1,A01,258656,Thorpe; Charles Robert,28,0,30,2
1683293877985,SOCI 1,A02,258658,Thorpe; Charles Robert,30,0,30,0
1683293877985,SOCI 1,A03,258661,Thorpe; Charles Robert,25,0,25,0
1683293877985,SOCI 1,A04,258666,Thorpe; Charles Robert,22,0,25,3
1683293877985,SOCI 1,A05,258897,Thorpe; Charles Robert,23,0,25,2
1683293877985,SOCI 1,A06,258898,Thorpe; Charles Robert,25,0,25,0
1683293879009,SOCI 30,A01,258903,Pardo Guerra; Juan Pablo,16,0,30,14
1683293880038,SOCI 102,A00,258904,Staff,9,0,25,16
1683293881064,SOCI 106,A00,258905,Staff,19,0,25,6
1683293882089,SOCI 111,A00,258907,Ribas Norris; Janet Vanesa,26,0,30,4
1683293883114,SOCI 121R,A00,258908,Pardo Guerra; Juan Pablo,11,0,30,19
1683293884139,SOCI 126,A01,203330,Staff,14,0,20,6
1683293885164,SOCI 131,A00,258909,Thorpe; Charles Robert,31,0,60,29
1683293886193,SOCI 135,A00,258910,Payne; Christine Anna,0,9,30,30
1683293887217,SOCI 157,A00,258911,Staff,13,0,30,17
1683293888242,SOCI 184,A00,258912,Staff,26,0,30,4
1683293889270,SOCI 188D,A00,258913,Staff,21,0,30,9
1683293890296,SYN 2,001,187529,Staff,9,0,16,7
1683293890296,SYN 2,002,201452,Staff,0,18,16,16
1683293890296,SYN 2,003,201469,Staff,3,0,16,13
1683293891323,SYN 100,A01,187531,Staff,0,9,20,20
1683293891323,SYN 100,B01,201491,Staff,0,12,20,20
1683293892355,TDAC 1,A00,189286,Walsh; Kim C.,3,0,20,17
1683293892355,TDAC 1,B00,189287,Harting; Carla Kelso,11,0,20,9
1683293893382,TDAC 101,A00,189300,Walsh; Kim C.,16,0,20,4
1683293893382,TDAC 101,B00,189301,Harting; Carla Kelso,18,0,20,2
1683293894410,TDAC 102,A00,189304,Basso; Beatrice,14,0,20,6
1683293895440,TDAC 108,A00,189305,Staff,18,0,20,2
1683293896467,TDDE 131,A00,189310,Staff,19,0,20,1
1683293896467,TDDE 131,B00,189314,Staff,19,0,20,1
1683293896467,TDDE 131,C00,189315,Staff,48,0,50,2
1683293896467,TDDE 131,D00,189316,Staff,14,0,15,1
1683293896467,TDDE 131,E00,204841,Staff,20,0,20,0
1683293897494,TDGE 10,A00,189289,Staff,30,0,50,20
1683293897494,TDGE 10,B00,189290,Havis; Allan,2,0,50,48
1683293898520,TDGE 11,A00,189291,Fulton; Julia,0,3,50,50
1683293898520,TDGE 11,B00,189292,Staff,20,0,25,5
1683293898520,TDGE 11,C00,260270,Staff,0,0,0,0
1683293899545,TDGE 25,A00,189294,Staff,3,0,20,17
1683293900571,TDGE 124,A00,189318,Fulton; Julia,0,8,50,50
1683293901600,TDGE 125,A00,189319,Staff,13,0,25,12
1683293901600,TDGE 125,B00,189320,Staff,23,0,25,2
1683293902625,TDGE 127,A00,189322,Havis; Allan,0,0,50,50
1683293903650,TDHT 101,A00,189323,Staff,18,0,25,7
1683293903650,TDHT 101,B00,189324,Staff,25,0,25,0
1683293904676,TDHT 102,A00,189325,Staff,49,0,50,1
1683293905702,TDMV 1,A00,189295,Arcidiacono; Kristin,20,0,30,10
1683293905702,TDMV 1,B00,189296,Caligagan; Maria T.,24,0,30,6
1683293906727,TDMV 2,A00,189297,Sammartano; Tonnie,28,0,30,2
1683293906727,TDMV 2,B00,189299,Arcidiacono; Kristin,24,0,30,6
1683293907753,TDMV 3,A00,204998,Rincon; Alicia,22,0,30,8
1683293908777,TDMV 120,A00,189458,Sammartano; Tonnie,28,0,30,2
1683293909803,TDMV 138,A00,189541,Jun; Grace Shin Hae,22,0,40,18
1683293910833,TDMV 142,A00,189717,Caligagan; Tony,23,0,30,7
1683293910833,TDMV 142,B00,189718,Caligagan; Maria T.,25,0,30,5
1683293911857,TMC 2,A01,187533,Staff,25,0,25,0
1683293911857,TMC 2,A02,187534,Staff,25,0,25,0
1683293912882,USP 1,A01,187536,Kwak; Nancy,0,16,25,25
1683293913907,USP 5,A01,187538,Staff,9,0,25,16
1683293914932,USP 101,A00,199253,Staff,0,4,0,0
1683293915956,USP 124,A00,187562,Boomhower; Matthew Charles,1,0,30,29
1683293916983,USP 138,A00,187582,Staff,20,0,25,5
1683293918013,USP 152,A01,187597,Staff,4,0,25,21
1683293919038,USP 153,A00,187598,Staff,19,0,25,6
1683293920068,USP 168,A00,187607,Kwak; Nancy,2,0,5,3
1683293921094,USP 173,A00,187619,Staff,4,0,25,21
1683293922118,USP 181,A00,187638,Staff,0,0,25,25
1683293923145,VIS 103,A00,187650,Cruz; Edwin Teddy,23,0,75,52
1683293924172,VIS 110D,A00,187669,Staff,12,0,22,10
1683293925197,VIS 127C,A00,187720,Shen; Kuiyi,68,0,146,78
1683293926224,VIS 149,A00,187731,Yoldas; Pinar,0,14,22,22
1683293927248,VIS 151,A01,188091,Staff,22,0,34,12
1683293927248,VIS 151,A02,188092,Staff,11,0,34,23
1683293928275,VIS 160B,A00,188093,Stalbaum; Brett,0,0,10,10
1683293930329,WCWP 10B,A00,201720,Staff,10,0,15,5
1683293930329,WCWP 10B,B00,201722,Staff,8,0,15,7
1683293931355,WCWP 100,A00,201725,Gagnon; Jeffrey C,0,0,2,2
1683293931355,WCWP 100,B00,201727,Staff,0,4,15,15
1683293934502,ANBI 133,A00,258401,Wilder; Linnea Lorene,34,0,40,6
1683293935530,ANBI 140,A00,258395,Hrvoj Mihic; Branka,18,0,25,7
1683293936559,ANSC 120,A00,258402,Bialecki; Jon Anthony,27,0,40,13
1683293937584,ANSC 144,A00,258400,Staff,14,0,40,26
1683293939638,ANSC 166,A00,258396,Parish; Steven Martin,157,0,175,18
1683293940665,ANSC 180,A00,193533,Staff,9,0,20,11
1683293941691,ANSC 188,A00,258397,Jassal; Aftab,33,0,40,7
1683293942725,ANTH 3,A01,258316,Staff,23,0,30,7
1683293943751,ANTH 5,A00,258394,Semendeferi; Ekaterini,16,0,20,4
1683293944777,ANTH 21,A01,258331,Staff,9,0,40,31
1683293945805,ANTH 103,A00,258398,Varma; Saiba,15,0,25,10
1683293946840,AWP 10,001,202034,Staff,0,0,0,0
1683293946840,AWP 10,002,202035,Staff,0,0,0,0
1683293946840,AWP 10,003,202036,Staff,0,0,0,0
1683293946840,AWP 10,004,202037,Staff,0,0,0,0
1683293946840,AWP 10,005,202038,Staff,0,0,0,0
1683293946840,AWP 10,006,202039,Staff,0,0,0,0
1683293946840,AWP 10,007,202040,Staff,0,0,0,0
1683293946840,AWP 10,008,202041,Staff,0,0,0,0
1683293946840,AWP 10,009,202042,Staff,0,0,0,0
1683293946840,AWP 10,010,202043,Staff,0,0,0,0
1683293946840,AWP 10,011,202044,Staff,0,0,0,0
1683293946840,AWP 10,012,202045,Staff,0,0,0,0
1683293946840,AWP 10,013,202046,Staff,0,0,0,0
1683293946840,AWP 10,014,202047,Staff,0,0,0,0
1683293946840,AWP 10,015,202048,Staff,0,0,0,0
1683293946840,AWP 10,016,202049,Staff,0,0,0,0
1683293946840,AWP 10,017,202050,Staff,0,0,0,0
1683293946840,AWP 10,018,202051,Staff,0,0,0,0
1683293946840,AWP 10,019,202052,Staff,0,0,0,0
1683293946840,AWP 10,020,202053,Staff,0,0,0,0
1683293946840,AWP 10,021,202054,Staff,0,0,0,0
1683293946840,AWP 10,022,202055,Staff,0,0,0,0
1683293946840,AWP 10,023,202056,Staff,0,0,0,0
1683293946840,AWP 10,024,202057,Staff,0,0,0,0
1683293946840,AWP 10,025,202058,Staff,0,0,0,0
1683293946840,AWP 10,026,202059,Staff,0,0,0,0
1683293947868,AWP 102,001,202032,Staff,0,0,0,0
1683293947868,AWP 102,002,202033,Staff,0,0,0,0
1683293948893,BENG 100,A01,254234,Taylor Amos; Alyssa C,31,0,40,9
1683293949919,BENG 196,001,270013,Engler; Adam J.,9999,0,9999,0
1683293950946,BICD 100R,A01,202018,Smith; Laurie,0,7,32,32
1683293950946,BICD 100R,A02,202019,Smith; Laurie,0,2,32,32
1683293950946,BICD 100R,A03,202020,Smith; Laurie,0,1,32,32
1683293950946,BICD 100R,A04,202021,Smith; Laurie,8,0,32,24
1683293950946,BICD 100R,A05,202022,Smith; Laurie,12,0,32,20
1683293951974,BICD 136,A01,193242,Gustafson-Brown; Cindy,0,2,32,32
1683293951974,BICD 136,A02,193244,Gustafson-Brown; Cindy,15,0,32,17
1683293953000,BIEB 102,A01,193249,Butler; Shannon Rhey,0,2,32,32
1683293953000,BIEB 102,A02,193251,Butler; Shannon Rhey,0,0,32,32
1683293953000,BIEB 102,A03,193253,Butler; Shannon Rhey,0,1,32,32
1683293953000,BIEB 102,A04,193255,Butler; Shannon Rhey,17,0,32,15
1683293953000,BIEB 102,A05,193265,Butler; Shannon Rhey,26,0,32,6
1683293953000,BIEB 102,A06,193269,Butler; Shannon Rhey,16,0,32,16
1683293955109,BIEB 150,A01,193274,Staff,0,0,32,32
1683293955109,BIEB 150,A02,193285,Staff,24,0,32,8
1683293956137,BIEB 194,A00,193286,Kurle; Carolyn M.,22,0,32,10
1683293957170,BILD 1,A01,192291,Staff,16,0,32,16
1683293957170,BILD 1,A02,192292,Staff,30,0,32,2
1683293957170,BILD 1,B01,192520,Reuther; Keefe,0,1,0,0
1683293957170,BILD 1,B02,192532,Reuther; Keefe,0,1,0,0
1683293958202,BILD 3,A01,192556,Butler; Shannon Rhey,0,0,32,32
1683293958202,BILD 3,A02,192581,Butler; Shannon Rhey,5,0,32,27
1683293958202,BILD 3,A03,192611,Butler; Shannon Rhey,23,0,32,9
1683293958202,BILD 3,A04,192612,Butler; Shannon Rhey,25,0,32,7
1683293958202,BILD 3,A05,192613,Butler; Shannon Rhey,27,0,32,5
1683293958202,BILD 3,A06,192679,Butler; Shannon Rhey,27,0,32,5
1683293958202,BILD 3,A07,192682,Butler; Shannon Rhey,22,0,32,10
1683293959233,BILD 4,A01,192836,Reuther; Keefe,1,0,24,23
1683293959233,BILD 4,A02,193044,Reuther; Keefe,4,0,24,20
1683293960257,BILD 10,A01,193142,Gustafson-Brown; Cindy,31,0,32,1
1683293960257,BILD 10,A02,193149,Gustafson-Brown; Cindy,31,0,32,1
1683293961282,BIMM 100,A01,193301,Staff,0,6,32,32
1683293961282,BIMM 100,A02,193312,Staff,0,5,32,32
1683293961282,BIMM 100,A03,193323,Staff,0,8,32,32
1683293962306,BIMM 101,A01,193329,McDonnell; Lisa Marie,0,3,24,24
1683293962306,BIMM 101,A02,193339,McDonnell; Lisa Marie,0,2,24,24
1683293962306,BIMM 101,B01,193354,McDonnell; Lisa Marie,0,3,24,24
1683293962306,BIMM 101,B02,193357,McDonnell; Lisa Marie,0,3,24,24
1683293963337,BIMM 110,A01,193377,Tat; John,0,11,32,32
1683293963337,BIMM 110,A02,193378,Tat; John,1,9,32,31
1683293964363,BIMM 120,A01,206116,Staff,0,0,32,32
1683293964363,BIMM 120,A02,206117,Staff,8,0,32,24
1683293964363,BIMM 120,A03,206121,Staff,21,0,32,11
1683293965389,BIPN 100,A01,193393,Park; Ji Young,0,14,32,32
1683293965389,BIPN 100,A02,193402,Park; Ji Young,0,12,32,32
1683293965389,BIPN 100,A03,193413,Park; Ji Young,0,14,32,32
1683293965389,BIPN 100,A04,193414,Park; Ji Young,0,13,32,32
1683293966416,BIPN 102,A01,193429,Staff,0,0,32,32
1683293966416,BIPN 102,A02,193438,Staff,23,0,32,9
1683293967441,BIPN 106,A01,193450,Reyes Gonzalez; Catalina,0,2,40,40
1683293968471,BIPN 134,A01,193465,Cooke; James Edward,0,0,32,32
1683293968471,BIPN 134,A02,193474,Cooke; James Edward,27,0,32,5
1683293968471,BIPN 134,A03,193485,Cooke; James Edward,29,0,32,3
1683293968471,BIPN 134,A04,193486,Cooke; James Edward,21,0,32,11
1683293968471,BIPN 134,A05,193491,Cooke; James Edward,31,0,32,1
1683293968471,BIPN 134,A06,193501,Cooke; James Edward,30,0,32,2
1683293968471,BIPN 134,A07,193510,Cooke; James Edward,29,0,32,3
1683293970529,BISP 194,A00,222522,Staff,16,0,32,16
1683293971554,CAT 124,A01,202407,Staff,20,0,25,5
1683293972582,CAT 125,A00,202408,Marchisotto; Jennifer Anne,4,0,20,16
1683293973608,CAT 125R,A00,202409,Smith; Lauryn Alissa,0,11,20,20
1683293973608,CAT 125R,B00,202410,Morales; Celeste Georgianna,0,11,20,20
1683293973608,CAT 125R,C00,202411,Irwin; Matthew Joseph,0,10,20,20
1683293974635,CENG 15,A01,204712,Yang; Kesong,0,1,0,0
1683293975664,CENG 114,A00,202070,Jahed Motlagh; Zeinab,5,0,20,15
1683293976690,CGS 105,A00,185477,Wesling; Megan E.,24,0,40,16
1683293977719,CGS 106,A00,185494,Staff,13,0,22,9
1683293978746,CGS 108,A00,185495,Staff,14,0,20,6
1683293979771,CGS 114,A00,185496,Staff,13,0,18,5
1683293980797,CGS 119,A00,185501,Staff,15,0,20,5
1683293981822,CGS 120,A00,185511,Staff,13,0,20,7
1683293982853,CHEM 4,A01,184675,Bussey; Thomas J,96,0,100,4
1683293983879,CHEM 6A,A01,184677,Staff,35,0,60,25
1683293984904,CHEM 6B,A01,184679,Staff,65,0,100,35
1683293985930,CHEM 6C,A01,184681,Bussey; Thomas J,1,0,50,49
1683293985930,CHEM 6C,A02,184682,Bussey; Thomas J,34,0,50,16
1683293986956,CHEM 40A,A01,184684,Albizati; Kim F.,37,0,100,63
1683293987980,CHEM 40B,A01,184686,Albizati; Kim F.,0,20,100,100
1683293989009,CHEM 41B,A01,184690,Staff,52,0,100,48
1683293990039,COGS 3,A01,184715,Boyle; Mary E. T.,0,25,40,40
1683293991070,COGS 14B,A01,185172,Staff,0,15,38,38
1683293992098,COGS 18,A01,184736,Staff,20,0,80,60
1683293993127,COGS 100,A01,184932,Staff,0,5,73,73
1683293994156,COGS 101A,A01,184935,Staff,0,38,30,30
1683293995180,COGS 101B,A01,184944,Staff,0,2,30,30
1683293996210,COGS 101C,A01,184946,Staff,0,12,30,30
1683293997234,COGS 102A,A01,184951,Johnson; Christine M.,2,0,40,38
1683293998262,COGS 107B,A01,184953,Mooshagian; Eric Frederick,0,50,40,40
1683293999292,COGS 118B,A01,184959,Gupta; Anjum,0,48,40,40
1683294000320,COGS 153,A00,184961,Staff,0,15,30,30
1683294001349,COGS 177,A00,184962,Staff,0,21,30,30
1683294002378,COGS 187A,A01,184969,Boyle; Mary E. T.,0,17,40,40
1683294003406,COMM 10,A01,185174,Staff,0,5,25,25
1683294003406,COMM 10,A02,185189,Staff,0,5,25,25
1683294003406,COMM 10,A03,269821,Staff,0,0,0,0
1683294004432,COMM 100B,A01,185475,Staff,0,0,0,2
1683294004432,COMM 100B,A02,185476,Staff,14,0,25,11
1683294005459,COMM 100C,A01,185314,Staff,1,0,25,24
1683294005459,COMM 100C,A02,185327,Staff,19,0,25,6
1683294006485,COMM 110M,A00,185349,Staff,2,0,40,38
1683294007514,COMM 113T,A00,185352,Staff,25,0,40,15
1683294008539,COMM 114I,A00,185353,Staff,33,0,40,7
1683294009564,COMM 131,A00,185354,Staff,19,0,30,11
1683294010592,CSE 8A,A50,185358,Cao; Yingjun,0,46,10,10
1683294011620,CSE 8B,A01,185362,Staff,0,47,50,50
1683294012646,CSE 11,A01,185416,Cao; Yingjun,0,93,10,10
1683294013677,CSE 20,A01,185445,Briones; Jor-el Thomas Caparas,5,0,25,20
1683294014703,CSE 21,A01,185447,Staff,10,0,50,40
1683294015729,CSE 101,A01,185451,Staff,0,12,50,50
1683294015729,CSE 101,B01,185453,Jones; Miles E,0,11,50,50
1683294017785,CSE 141,A01,185458,Eldon; John,20,0,100,80
1683294018810,CSE 141L,A01,185461,Eldon; John,12,0,100,88
1683294019837,CSE 142,A01,185463,Staff,35,0,60,25
1683294019837,CSE 142,B01,201355,Staff,0,6,60,60
1683294020861,CSE 142L,A01,185470,Staff,35,0,60,25
1683294020861,CSE 142L,B01,201417,Staff,0,5,60,60
1683294021885,CSE 190,A00,201433,Staff,32,0,49,17
1683294022916,DOC 1,A01,259136,Strom; Megan C.,8,0,15,7
1683294022916,DOC 1,A02,259137,Strom; Megan C.,14,0,15,1
1683294022916,DOC 1,A03,259138,Strom; Megan C.,14,0,15,1
1683294022916,DOC 1,A04,259139,Strom; Megan C.,14,0,15,1
1683294023939,DOC 100D,A00,259140,Pass; Natalye Joann,17,0,25,8
1683294024969,DSGN 1,A01,184749,Rill; Bryan,0,24,30,30
1683294025997,DSGN 100,A01,185168,Staff,0,2,25,25
1683294027025,ECE 5,A01,185626,Morris; Karcher William,0,10,0,0
1683294028049,ECE 101,A01,185628,Staff,17,0,70,53
1683294029077,ECE 107,A01,185635,Baghdadchi; Saharnaz,0,0,20,20
1683294029077,ECE 107,A02,185638,Baghdadchi; Saharnaz,4,0,20,16
1683294030101,ECE 148,A01,185647,Silberman; Jack,1,0,16,15
1683294031125,ECON 1,A01,185537,Crane; Meredith Helen,54,0,70,16
1683294032152,ECON 3,A01,185549,Crane; Meredith Helen,33,0,70,37
1683294033180,ECON 4,A01,203354,Anderson; John Charles,0,4,10,10
1683294034204,ECON 100A,A01,185574,Staff,0,4,40,40
1683294035233,ECON 100B,A01,185576,Staff,0,22,40,40
1683294036262,ECON 100C,A01,185589,Newhouse; Herbert S,30,0,70,40
1683294037286,ECON 105,A00,185608,Vespa; Emanuel Ignacio,19,0,35,16
1683294038316,ECON 109,A01,185610,Shishkin; Denis,10,0,35,25
1683294039341,ECON 110A,A01,185612,Staff,11,0,40,29
1683294040367,ECON 120A,A01,185615,Staff,20,0,40,20
1683294041391,ECON 120C,A01,185617,Sun; Yixiao,0,20,70,70
1683294042417,ECON 144,A00,203346,Squires; Dale E,3,0,35,32
1683294043444,ECON 171,A01,203349,Newhouse; Herbert S,0,1,35,35
1683294044469,ECON 173A,A01,185621,Toda; Alexis Akira,21,0,35,14
1683294045497,EDS 25,A01,202413,Staff,0,1,0,0
1683294045497,EDS 25,A02,202414,Staff,0,1,0,0
1683294045497,EDS 25,A03,202415,Staff,0,0,0,0
1683294045497,EDS 25,A04,202416,Staff,0,1,0,0
1683294045497,EDS 25,A05,202439,Staff,0,0,0,0
1683294045497,EDS 25,A06,202440,Staff,0,0,0,0
1683294045497,EDS 25,B01,202631,Staff,0,0,0,0
1683294045497,EDS 25,B02,202632,Staff,0,0,0,0
1683294045497,EDS 25,B03,202639,Staff,0,0,0,0
1683294045497,EDS 25,B04,202640,Staff,0,0,0,0
1683294045497,EDS 25,B05,202643,Staff,0,0,0,0
1683294045497,EDS 25,B06,202644,Staff,0,0,0,0
1683294046523,EDS 38,A01,202659,Black; Alison Michelle,24,0,25,1
1683294047551,EDS 115,A00,202652,Staff,17,0,30,13
1683294048575,EDS 125,A00,202649,Staff,14,0,30,16
1683294049600,EDS 126,A01,203332,Staff,30,0,30,0
1683294050626,EDS 139,A00,202838,Staff,17,0,25,8
1683294051651,EDS 146,A01,202655,Staff,15,0,25,10
1683294052676,ENG 15,A00,185667,Staff,0,1,0,0
1683294052676,ENG 15,B00,185672,Staff,0,0,0,0
1683294052676,ENG 15,C00,185675,Staff,0,0,0,0
1683294052676,ENG 15,D00,185682,Staff,0,0,0,0
1683294052676,ENG 15,E00,185684,Staff,0,0,0,0
1683294053712,ETHN 103,A00,185710,Staff,0,3,35,35
1683294054738,ETHN 103A,A00,199228,Man; Simeon S,3,0,9,6
1683294055762,ETHN 109,A00,185711,Staff,18,0,35,17
1683294056789,ETHN 142,A00,185726,Staff,0,4,30,30
1683294057875,ETHN 163J,A00,199229,Man; Simeon S,6,0,8,2
1683294058904,ETHN 168,A00,185727,Staff,8,0,10,2
1683294059932,ETHN 182,A00,185728,Staff,1,0,35,34
1683294060956,ETHN 183,A00,185737,Staff,8,0,18,10
1683294061987,GLBH 111,A01,209361,Burgos; Jose L.,0,0,0,0
1683294064041,HIEU 104,A00,185792,Staff,16,0,20,4
1683294065065,HIEU 115,A00,185800,Staff,1,0,20,19
1683294066091,HIEU 128,A00,185801,Staff,0,7,20,20
1683294067118,HIEU 147,A00,185802,Staff,16,0,20,4
1683294068144,HIEU 154,A00,185823,Staff,12,0,20,8
1683294069172,HILA 102,A00,185826,Staff,13,0,20,7
1683294070196,HILD 2C,A01,185778,Staff,0,12,20,20
1683294071221,HILD 7B,A01,185780,Kwak; Nancy,0,15,32,32
1683294071221,HILD 7B,A02,185781,Kwak; Nancy,0,18,32,32
1683294072250,HILD 30,A01,185791,Staff,14,0,20,6
1683294073275,HISC 119,A00,185830,Golan; Tal,0,9,20,20
1683294074298,HITO 156GS,A00,185831,Patterson; Patrick H.,0,0,0,23
1683294075326,HIUS 103,A00,185832,Man; Simeon S,0,7,20,20
1683294076350,HIUS 117,A00,185836,Kwak; Nancy,2,0,20,18
1683294077380,HIUS 125,A00,185840,Man; Simeon S,0,0,23,23
1683294078407,HIUS 149,A00,185845,Staff,0,0,20,20
1683294079432,HUM 3,A01,185882,Zavodny; Tatiana Sophia,0,6,50,50
1683294079432,HUM 3,B01,185899,Caldwell; Michael Alan,0,19,50,50
1683294080464,HUM 3GS,A00,185900,Patterson; Patrick H.,0,0,0,23
1683294081501,HUM 4,A01,185938,Zroka; Amy Liane,31,0,50,19
1683294081501,HUM 4,B01,185956,Watkins; Eric,0,2,50,50
1683294081501,HUM 4,B02,202209,Watkins; Eric,0,1,50,50
1683294081501,HUM 4,B03,202210,Watkins; Eric,0,0,50,50
1683294082534,HUM 5,A01,185958,West; Geoffrey Scott,5,0,50,45
1683294082534,HUM 5,A02,202215,West; Geoffrey Scott,0,0,50,50
1683294083560,INTL 190,A00,185959,Gagnon; Jeffrey C,0,0,0,9
1683294083560,INTL 190,B00,185960,Lettieri; Michael Joseph,0,0,0,1
1683294084585,JAPN 180,A00,254509,Staff,0,1,25,25
1683294085610,LATI 10,A01,202853,Kennemore; Amy Michelle,5,0,35,30
1683294085610,LATI 10,A02,202854,Kennemore; Amy Michelle,1,0,35,34
1683294085610,LATI 10,A03,270054,Kennemore; Amy Michelle,30,0,30,0
1683294086638,LATI 180,A00,202855,Kennemore; Amy Michelle,11,0,20,9
1683294087663,LAWS 101,A00,201767,Golan; Tal,0,7,40,40
1683294088688,LIFR 1C,A00,185961,Staff,6,0,20,14
1683294089714,LIFR 1CX,A00,185962,Staff,7,0,20,13
1683294090740,LIFR 1D,A00,185963,Staff,9,0,20,11
1683294091767,LIFR 1DX,A00,185964,Staff,9,0,20,11
1683294092792,LIGN 101,A01,186039,Staff,43,0,50,7
1683294093817,LIGN 165,A00,186040,Staff,18,0,50,32
1683294094845,LTCS 108,A00,186041,Staff,6,0,10,4
1683294095870,LTCS 119,A00,186042,Staff,16,0,20,4
1683294096896,LTCS 130,A00,186043,Wesling; Megan E.,15,0,25,10
1683294098947,LTEA 138,A00,186119,Staff,14,0,40,26
1683294099971,LTEN 124,A00,186148,Staff,6,0,25,19
1683294100999,LTEN 178,A00,186149,Staff,7,0,15,8
1683294102025,LTEN 181,A00,186150,Blanco; John D,33,0,40,7
1683294103051,LTWL 120,A00,186160,Staff,20,0,25,5
1683294104077,LTWL 165,A00,186161,Staff,22,0,25,3
1683294105103,LTWR 100,A00,186162,Staff,0,4,15,15
1683294106131,LTWR 102,A00,186163,Doller; Ben,5,0,15,10
1683294107154,MAE 8,A01,186412,Staff,0,0,0,0
1683294108180,MAE 30B,A00,186445,Bahadori; Mohammad Yousef,83,0,100,17
1683294109209,MAE 40,A00,186592,Bewley; Thomas R,9,0,50,41
1683294110234,MAE 101B,A00,186593,Bahadori; Mohammad Yousef,81,0,100,19
1683294111258,MAE 105,A00,186594,Bandaru; Prabhakar,12,0,50,38
1683294112286,MAE 107,A00,186599,Pham; Hieu Tan,0,6,120,120
1683294113315,MAE 148,A01,186660,Silberman; Jack,3,0,16,13
1683294114340,MATH 10A,A01,188095,Staff,0,7,35,35
1683294115366,MATH 10B,A01,188097,Bowers; Adam R.,0,11,30,30
1683294115366,MATH 10B,A02,188099,Bowers; Adam R.,0,9,30,30
1683294115366,MATH 10B,B01,188104,Bowers; Adam R.,0,11,30,30
1683294115366,MATH 10B,B02,188106,Bowers; Adam R.,0,11,30,30
1683294116404,MATH 10C,A01,188111,Staff,0,18,30,30
1683294116404,MATH 10C,A02,188127,Staff,0,17,30,30
1683294116404,MATH 10C,A03,188131,Staff,0,17,30,30
1683294116404,MATH 10C,B01,188218,Staff,21,0,30,9
1683294116404,MATH 10C,B02,188244,Staff,13,0,30,17
1683294116404,MATH 10C,B03,188277,Staff,16,0,30,14
1683294117435,MATH 18,A01,188344,Bach; Quang Tran,18,0,30,12
1683294117435,MATH 18,A02,188345,Bach; Quang Tran,11,0,30,19
1683294117435,MATH 18,B01,188353,Bach; Quang Tran,10,0,30,20
1683294117435,MATH 18,B02,188354,Bach; Quang Tran,20,0,30,10
1683294118458,MATH 20A,A01,188374,Staff,13,0,35,22
1683294119490,MATH 20B,A01,188382,Ohm; Ko Woon,6,0,30,24
1683294119490,MATH 20B,A02,188383,Ohm; Ko Woon,24,0,30,6
1683294119490,MATH 20B,B01,188385,Ohm; Ko Woon,7,0,30,23
1683294119490,MATH 20B,B02,188392,Ohm; Ko Woon,22,0,30,8
1683294120516,MATH 20C,A01,188394,Harel; Guershon,10,0,30,20
1683294120516,MATH 20C,A02,188395,Harel; Guershon,13,0,30,17
1683294120516,MATH 20C,B01,188404,Harel; Guershon,3,0,30,27
1683294120516,MATH 20C,B02,188405,Harel; Guershon,19,0,30,11
1683294121543,MATH 20D,A01,188414,Hammock; Frances H,0,1,30,30
1683294121543,MATH 20D,A02,188415,Hammock; Frances H,4,0,30,26
1683294121543,MATH 20D,B01,188447,Hammock; Frances H,2,0,30,28
1683294121543,MATH 20D,B02,188486,Hammock; Frances H,8,0,30,22
1683294122573,MATH 20E,A01,188649,Staff,22,0,30,8
1683294122573,MATH 20E,A02,188650,Staff,23,0,30,7
1683294122573,MATH 20E,A03,188673,Staff,0,0,30,30
1683294123600,MATH 102,A01,188675,Staff,0,35,35,35
1683294124627,MATH 103B,A01,188681,Staff,4,0,35,31
1683294124627,MATH 103B,B01,188692,Staff,7,0,35,28
1683294125652,MATH 109,A01,188695,Salehi Golsefidy; Alireza,25,0,35,10
1683294125652,MATH 109,A02,188696,Salehi Golsefidy; Alireza,27,0,35,8
1683294126684,MATH 120A,A01,188698,Eggers; John Dietrich,5,0,35,30
1683294127714,MATH 142B,A01,188736,Ioana; Adrian,0,2,30,30
1683294127714,MATH 142B,A02,188741,Ioana; Adrian,0,1,30,30
1683294127714,MATH 142B,A03,188743,Ioana; Adrian,0,3,30,30
1683294128739,MATH 168A,A01,188790,Staff,0,8,35,35
1683294129770,MATH 170A,A01,188803,Nie; Jiawang,0,2,35,35
1683294129770,MATH 170A,A02,188811,Nie; Jiawang,0,0,35,35
1683294129770,MATH 170A,A03,188814,Nie; Jiawang,1,0,35,34
1683294129770,MATH 170A,A04,188815,Nie; Jiawang,14,0,35,21
1683294130796,MATH 193B,A01,188817,Staff,0,0,35,35
1683294130796,MATH 193B,A02,188818,Staff,5,0,35,30
1683294131825,MGT 4,A01,202857,Anderson; John Charles,62,0,80,18
1683294132851,MGT 12,A00,202858,Lindenberger; Wade Douglas,43,0,90,47
1683294133880,MGT 18,A00,202859,Staff,74,0,90,16
1683294134910,MGT 18GS,A00,202860,McKay; Michael J,13,0,28,15
1683294135939,MGT 45,A00,202861,Pecore; Joseph P.,14,0,90,76
1683294136964,MGT 100,A00,202863,Yavorsky; Daniel Ryan,28,0,90,62
1683294137994,MGT 103,A00,202864,Ehrich; Kristine R,0,16,90,90
1683294139020,MGT 112,A00,202865,Ehrich; Kristine R,15,0,90,75
1683294140045,MGT 121A,A00,202868,Staff,0,19,0,0
1683294141069,MGT 131B,A00,202869,Anderson; John Charles,59,0,90,31
1683294142094,MGT 136,A00,202871,Lindenberger; Wade Douglas,84,0,90,6
1683294143120,MGT 164,A00,202873,Staff,0,69,90,90
1683294144146,MGT 164GS,A00,202874,McKay; Mary A,13,0,28,15
1683294145174,MGT 180,A00,202875,Staff,0,51,90,90
1683294146200,MMW 11R,A01,205019,Herbst; Matthew,3,0,30,27
1683294146200,MMW 11R,A02,205026,Herbst; Matthew,29,0,30,1
1683294147229,MMW 15,A01,193512,Chang; Edmond Yi-Teh,0,9,28,28
1683294147229,MMW 15,A02,193513,Chang; Edmond Yi-Teh,0,5,28,28
1683294147229,MMW 15,A03,193514,Chang; Edmond Yi-Teh,0,5,28,28
1683294147229,MMW 15,A04,193515,Chang; Edmond Yi-Teh,0,4,28,28
1683294147229,MMW 15,A05,193516,Chang; Edmond Yi-Teh,0,4,28,28
1683294147229,MMW 15,A06,193517,Chang; Edmond Yi-Teh,0,5,28,28
1683294147229,MMW 15,B01,193519,Chang; Edmond Yi-Teh,0,4,28,28
1683294147229,MMW 15,B02,193520,Chang; Edmond Yi-Teh,0,5,28,28
1683294147229,MMW 15,B03,193521,Chang; Edmond Yi-Teh,0,4,28,28
1683294147229,MMW 15,B04,193522,Chang; Edmond Yi-Teh,0,4,28,28
1683294147229,MMW 15,B05,193523,Chang; Edmond Yi-Teh,0,5,28,28
1683294147229,MMW 15,B06,193524,Chang; Edmond Yi-Teh,0,4,28,28
1683294148257,MMW 122,A01,193526,Rahimi; Babak,0,14,28,28
1683294148257,MMW 122,A02,193527,Rahimi; Babak,0,14,28,28
1683294148257,MMW 122,A03,193528,Rahimi; Babak,0,0,0,0
1683294148257,MMW 122,A04,193529,Rahimi; Babak,0,0,0,0
1683294149282,MUS 1A,A01,186663,Staff,0,20,35,35
1683294150308,MUS 4,A01,186715,Staff,0,12,35,35
1683294151336,MUS 5R,A01,186796,Dubnov; Shlomo,0,16,35,35
1683294152363,MUS 6,A01,186798,Staff,0,3,25,25
1683294153389,MUS 7,A01,186830,Staff,12,0,35,23
1683294154415,MUS 8,A01,186930,Staff,0,25,35,35
1683294155441,MUS 15,A01,186932,Staff,0,15,35,35
1683294155441,MUS 15,B01,186934,Staff,0,14,35,35
1683294156471,MUS 80,A00,186935,Staff,2,0,20,18
1683294156471,MUS 80,B00,186936,Staff,25,0,25,0
1683294157497,NANO 11,A00,204702,Lipomi; Darren John,0,0,0,0
1683294158523,NANO 15,A01,204709,Yang; Kesong,0,1,0,0
1683294159555,NANO 114,A00,202069,Jahed Motlagh; Zeinab,3,0,10,7
1683294160581,PHIL 1,A00,186955,Grush; Rick Scott,32,0,40,8
1683294161682,PHIL 10,A01,186973,Grush; Rick Scott,29,0,35,6
1683294161682,PHIL 10,A02,186974,Grush; Rick Scott,33,0,35,2
1683294162707,PHIL 13,A01,186976,Staff,7,0,35,28
1683294162707,PHIL 13,A02,186977,Staff,16,0,35,19
1683294163735,PHIL 14,A01,186979,Staff,31,0,35,4
1683294163735,PHIL 14,A02,186986,Staff,32,0,35,3
1683294164763,PHIL 28,A01,186988,Staff,16,0,30,14
1683294164763,PHIL 28,A02,186989,Staff,1,0,30,29
1683294164763,PHIL 28,A03,186990,Staff,9,0,30,21
1683294164763,PHIL 28,A04,186991,Staff,26,0,30,4
1683294165787,PHIL 120,A00,186997,Staff,23,0,40,17
1683294166812,PHIL 137,A00,187003,Staff,9,0,40,31
1683294167839,PHIL 150,A00,187015,Staff,47,0,70,23
1683294168865,PHIL 167,A00,187021,Lamey; Andy M.,35,0,40,5
1683294169895,PHIL 174,A01,202226,Staff,17,0,20,3
1683294169895,PHIL 174,A02,202235,Staff,20,0,20,0
1683294170926,PHIL 191A,A00,258918,Staff,0,0,1,1
1683294171955,PHYS 1A,A00,187028,Staff,26,0,60,34
1683294172985,PHYS 1AL,001,187036,Staff,2,0,30,28
1683294172985,PHYS 1AL,002,187049,Staff,18,0,30,12
1683294174011,PHYS 1B,A00,187058,Staff,23,0,60,37
1683294175037,PHYS 1BL,001,187064,Staff,0,0,30,30
1683294175037,PHYS 1BL,002,187070,Staff,6,0,30,24
1683294176062,PHYS 1C,A00,187082,Staff,32,0,120,88
1683294177087,PHYS 1CL,001,187088,Staff,0,9,30,30
1683294177087,PHYS 1CL,002,187089,Staff,0,2,30,30
1683294177087,PHYS 1CL,009,262693,Staff,12,0,30,18
1683294178113,PHYS 2B,A01,187097,Staff,54,0,115,61
1683294179138,PHYS 2C,A01,187099,Staff,67,0,115,48
1683294180167,PHYS 2CL,A01,187101,Staff,5,0,28,23
1683294180167,PHYS 2CL,A02,187102,Staff,15,0,28,13
1683294181192,PHYS 2D,A01,187123,Shotwell; Brian,95,0,115,20
1683294182221,PHYS 4B,A01,187133,Grinstein; Benjamin,35,0,50,15
1683294183250,POLI 10,A00,188819,Staff,0,3,50,50
1683294184279,POLI 11,A00,188827,Staff,43,0,50,7
1683294185304,POLI 13R,A00,188828,Staff,0,1,20,20
1683294186329,POLI 27,A01,188830,Elgin; Samuel Zincke,0,1,70,70
1683294187354,POLI 30,A00,188832,Desposato; Scott,33,0,50,17
1683294188382,POLI 102F,A00,188834,Staff,3,0,40,37
1683294189411,POLI 104A,A00,188852,Staff,14,0,30,16
1683294190438,POLI 104I,A00,188853,Staff,0,6,20,20
1683294191470,POLI 110B,A00,188854,Wiens; David,7,0,20,13
1683294192498,POLI 112A,A00,188855,Wiens; David,5,0,30,25
1683294193528,POLI 117R,A00,188856,Forman; Fonna,0,11,20,20
1683294194558,POLI 118,A00,188857,Ingham; Sean,8,0,20,12
1683294195584,POLI 120G,A00,188858,Staff,9,0,30,21
1683294196610,POLI 131CR,A00,188863,Hoston; Germaine,24,0,50,26
1683294197640,POLI 133,A00,188864,Nellis; Gareth Hb,44,0,50,6
1683294198666,POLI 134D,A00,188865,Desposato; Scott,27,0,30,3
1683294199696,POLI 142A,A00,188871,Gartzke; Erik,22,0,50,28
1683294200724,POLI 142K,A00,188874,Staff,38,0,50,12
1683294201751,POLI 143,A00,188940,Gartzke; Erik,16,0,30,14
1683294202776,POLI 153,A00,188943,Staff,3,0,20,17
1683294203800,POLI 160AA,A00,188944,Staff,13,0,40,27
1683294204828,POLI 170A,A00,188945,Staff,11,0,30,19
1683294206881,PSYC 1,A00,188952,Staff,38,0,90,52
1683294207911,PSYC 2,B00,188953,Staff,20,0,35,15
1683294208941,PSYC 6,A00,188970,Staff,47,0,60,13
1683294209966,PSYC 7,A00,188973,Staff,37,0,45,8
1683294210991,PSYC 60,A01,188980,Rickard; Timothy C.,43,0,60,17
1683294212016,PSYC 70,A01,189001,Steiner; Eric Tomas,24,0,45,21
1683294213044,PSYC 100,A00,189005,Lacefield; Katharine I,0,99,120,120
1683294214068,PSYC 102,A00,189008,Staff,10,0,30,20
1683294215094,PSYC 106,B00,189026,Gorman; Michael R.,37,0,60,23
1683294216123,PSYC 114,B01,189033,Winkielman; Piotr,0,32,30,30
1683294217151,PSYC 131,A00,189036,Anagnostaras; Stephan,0,43,60,60
1683294218175,PSYC 136,A00,189041,Lowe; Angela Beth,0,7,25,25
1683294219204,PSYC 137,A00,189057,Winkielman; Piotr,0,34,25,25
1683294220231,PSYC 144,A00,189107,Wixted; John T,0,7,50,50
1683294222289,PSYC 162,A00,189142,Staff,0,8,85,85
1683294223317,PSYC 172,A00,189144,Gorman; Michael R.,0,7,30,30
1683294225370,PSYC 179,A00,189146,Lacefield; Katharine I,0,84,120,120
1683294226398,PSYC 181,A00,189147,Anagnostaras; Stephan,0,44,90,90
1683294227426,PSYC 190R,A00,189148,Barner; David A.,0,22,80,80
1683294228455,PSYC 191,A00,189275,Rickard; Timothy C.,0,7,25,25
1683294229479,PSYC 193,A00,189276,Chapman; Eddie Nathaniel,0,1,0,4
1683294230505,PSYC 193L,A01,189281,Lowe; Angela Beth,12,0,20,8
1683294230505,PSYC 193L,B01,189285,Staff,28,0,35,7
1683294231530,RELI 149,A00,187137,Rahimi; Babak,7,0,40,33
1683294232557,SE 9,A01,187315,Staff,0,2,18,18
1683294233586,SE 101B,A00,187409,Staff,24,0,30,6
1683294234613,SE 110B,A00,187444,Staff,10,0,40,30
1683294235640,SE 130B,A00,187449,Staff,31,0,40,9
1683294236665,SE 150A,A00,187516,Staff,9,0,20,11
1683294237689,SE 154,A00,187528,Staff,30,0,50,20
1683294238718,SIO 3,A01,258171,Staff,35,0,40,5
1683294239751,SIO 10,A00,187144,Cook; Geoffrey W,0,3,75,75
1683294240781,SIO 45,A00,187152,Cook; Geoffrey W,1,0,100,99
1683294241808,SIO 109R,A00,194486,Staff,0,3,20,20
1683294243870,SIO 187,A01,187233,Kacev; David,12,0,40,28
1683294244899,SOCI 1,A01,258656,Thorpe; Charles Robert,28,0,30,2
1683294244899,SOCI 1,A02,258658,Thorpe; Charles Robert,30,0,30,0
1683294244899,SOCI 1,A03,258661,Thorpe; Charles Robert,25,0,25,0
1683294244899,SOCI 1,A04,258666,Thorpe; Charles Robert,22,0,25,3
1683294244899,SOCI 1,A05,258897,Thorpe; Charles Robert,23,0,25,2
1683294244899,SOCI 1,A06,258898,Thorpe; Charles Robert,25,0,25,0
1683294245929,SOCI 30,A01,258903,Pardo Guerra; Juan Pablo,16,0,30,14
1683294246957,SOCI 102,A00,258904,Staff,9,0,25,16
1683294247986,SOCI 106,A00,258905,Staff,19,0,25,6
1683294249013,SOCI 111,A00,258907,Ribas Norris; Janet Vanesa,26,0,30,4
1683294250041,SOCI 121R,A00,258908,Pardo Guerra; Juan Pablo,11,0,30,19
1683294251068,SOCI 126,A01,203330,Staff,14,0,20,6
1683294252093,SOCI 131,A00,258909,Thorpe; Charles Robert,31,0,60,29
1683294253118,SOCI 135,A00,258910,Payne; Christine Anna,0,9,30,30
1683294254143,SOCI 157,A00,258911,Staff,13,0,30,17
1683294255167,SOCI 184,A00,258912,Staff,26,0,30,4
1683294256192,SOCI 188D,A00,258913,Staff,21,0,30,9
1683294257217,SYN 2,001,187529,Staff,9,0,16,7
1683294257217,SYN 2,002,201452,Staff,0,18,16,16
1683294257217,SYN 2,003,201469,Staff,3,0,16,13
1683294258241,SYN 100,A01,187531,Staff,0,9,20,20
1683294258241,SYN 100,B01,201491,Staff,0,12,20,20
1683294259270,TDAC 1,A00,189286,Walsh; Kim C.,3,0,20,17
1683294259270,TDAC 1,B00,189287,Harting; Carla Kelso,11,0,20,9
1683294260300,TDAC 101,A00,189300,Walsh; Kim C.,16,0,20,4
1683294260300,TDAC 101,B00,189301,Harting; Carla Kelso,18,0,20,2
1683294261330,TDAC 102,A00,189304,Basso; Beatrice,14,0,20,6
1683294262355,TDAC 108,A00,189305,Staff,18,0,20,2
1683294263382,TDDE 131,A00,189310,Staff,19,0,20,1
1683294263382,TDDE 131,B00,189314,Staff,19,0,20,1
1683294263382,TDDE 131,C00,189315,Staff,48,0,50,2
1683294263382,TDDE 131,D00,189316,Staff,14,0,15,1
1683294263382,TDDE 131,E00,204841,Staff,20,0,20,0
1683294264410,TDGE 10,A00,189289,Staff,30,0,50,20
1683294264410,TDGE 10,B00,189290,Havis; Allan,2,0,50,48
1683294265502,TDGE 11,A00,189291,Fulton; Julia,0,3,50,50
1683294265502,TDGE 11,B00,189292,Staff,20,0,25,5
1683294265502,TDGE 11,C00,260270,Staff,0,0,0,0
1683294266533,TDGE 25,A00,189294,Staff,3,0,20,17
1683294267560,TDGE 124,A00,189318,Fulton; Julia,0,8,50,50
1683294268589,TDGE 125,A00,189319,Staff,13,0,25,12
1683294268589,TDGE 125,B00,189320,Staff,23,0,25,2
1683294269614,TDGE 127,A00,189322,Havis; Allan,0,0,50,50
1683294270638,TDHT 101,A00,189323,Staff,18,0,25,7
1683294270638,TDHT 101,B00,189324,Staff,25,0,25,0
1683294271664,TDHT 102,A00,189325,Staff,49,0,50,1
1683294272689,TDMV 1,A00,189295,Arcidiacono; Kristin,20,0,30,10
1683294272689,TDMV 1,B00,189296,Caligagan; Maria T.,24,0,30,6
1683294273714,TDMV 2,A00,189297,Sammartano; Tonnie,28,0,30,2
1683294273714,TDMV 2,B00,189299,Arcidiacono; Kristin,24,0,30,6
1683294274738,TDMV 3,A00,204998,Rincon; Alicia,22,0,30,8
1683294275766,TDMV 120,A00,189458,Sammartano; Tonnie,28,0,30,2
1683294276791,TDMV 138,A00,189541,Jun; Grace Shin Hae,22,0,40,18
1683294277821,TDMV 142,A00,189717,Caligagan; Tony,23,0,30,7
1683294277821,TDMV 142,B00,189718,Caligagan; Maria T.,25,0,30,5
1683294278848,TMC 2,A01,187533,Staff,25,0,25,0
1683294278848,TMC 2,A02,187534,Staff,25,0,25,0
1683294279874,USP 1,A01,187536,Kwak; Nancy,0,16,25,25
1683294280900,USP 5,A01,187538,Staff,9,0,25,16
1683294281923,USP 101,A00,199253,Staff,0,4,0,0
1683294282948,USP 124,A00,187562,Boomhower; Matthew Charles,1,0,30,29
1683294283975,USP 138,A00,187582,Staff,20,0,25,5
1683294285004,USP 152,A01,187597,Staff,4,0,25,21
1683294286034,USP 153,A00,187598,Staff,19,0,25,6
1683294287062,USP 168,A00,187607,Kwak; Nancy,2,0,5,3
1683294288090,USP 173,A00,187619,Staff,4,0,25,21
1683294289114,USP 181,A00,187638,Staff,0,0,25,25
1683294290140,VIS 103,A00,187650,Cruz; Edwin Teddy,23,0,75,52
1683294291165,VIS 110D,A00,187669,Staff,12,0,22,10
1683294292196,VIS 127C,A00,187720,Shen; Kuiyi,68,0,146,78
1683294293225,VIS 149,A00,187731,Yoldas; Pinar,0,14,22,22
1683294294254,VIS 151,A01,188091,Staff,22,0,34,12
1683294294254,VIS 151,A02,188092,Staff,11,0,34,23
1683294295278,VIS 160B,A00,188093,Stalbaum; Brett,0,0,10,10
1683294297331,WCWP 10B,A00,201720,Staff,10,0,15,5
1683294297331,WCWP 10B,B00,201722,Staff,8,0,15,7
1683294298355,WCWP 100,A00,201725,Gagnon; Jeffrey C,0,0,2,2
1683294298355,WCWP 100,B00,201727,Staff,0,4,15,15
1683294301518,ANBI 133,A00,258401,Wilder; Linnea Lorene,34,0,40,6
1683294302547,ANBI 140,A00,258395,Hrvoj Mihic; Branka,18,0,25,7
1683294303575,ANSC 120,A00,258402,Bialecki; Jon Anthony,27,0,40,13
1683294304599,ANSC 144,A00,258400,Staff,14,0,40,26
1683294306649,ANSC 166,A00,258396,Parish; Steven Martin,157,0,175,18
1683294307675,ANSC 180,A00,193533,Staff,9,0,20,11
1683294308700,ANSC 188,A00,258397,Jassal; Aftab,33,0,40,7
1683294309728,ANTH 3,A01,258316,Staff,23,0,30,7
1683294310759,ANTH 5,A00,258394,Semendeferi; Ekaterini,16,0,20,4
1683294311786,ANTH 21,A01,258331,Staff,9,0,40,31
1683294312815,ANTH 103,A00,258398,Varma; Saiba,15,0,25,10
1683294313856,AWP 10,001,202034,Staff,0,0,0,0
1683294313856,AWP 10,002,202035,Staff,0,0,0,0
1683294313856,AWP 10,003,202036,Staff,0,0,0,0
1683294313856,AWP 10,004,202037,Staff,0,0,0,0
1683294313856,AWP 10,005,202038,Staff,0,0,0,0
1683294313856,AWP 10,006,202039,Staff,0,0,0,0
1683294313856,AWP 10,007,202040,Staff,0,0,0,0
1683294313856,AWP 10,008,202041,Staff,0,0,0,0
1683294313856,AWP 10,009,202042,Staff,0,0,0,0
1683294313856,AWP 10,010,202043,Staff,0,0,0,0
1683294313856,AWP 10,011,202044,Staff,0,0,0,0
1683294313856,AWP 10,012,202045,Staff,0,0,0,0
1683294313856,AWP 10,013,202046,Staff,0,0,0,0
1683294313856,AWP 10,014,202047,Staff,0,0,0,0
1683294313856,AWP 10,015,202048,Staff,0,0,0,0
1683294313856,AWP 10,016,202049,Staff,0,0,0,0
1683294313856,AWP 10,017,202050,Staff,0,0,0,0
1683294313856,AWP 10,018,202051,Staff,0,0,0,0
1683294313856,AWP 10,019,202052,Staff,0,0,0,0
1683294313856,AWP 10,020,202053,Staff,0,0,0,0
1683294313856,AWP 10,021,202054,Staff,0,0,0,0
1683294313856,AWP 10,022,202055,Staff,0,0,0,0
1683294313856,AWP 10,023,202056,Staff,0,0,0,0
1683294313856,AWP 10,024,202057,Staff,0,0,0,0
1683294313856,AWP 10,025,202058,Staff,0,0,0,0
1683294313856,AWP 10,026,202059,Staff,0,0,0,0
1683294314887,AWP 102,001,202032,Staff,0,0,0,0
1683294314887,AWP 102,002,202033,Staff,0,0,0,0
1683294315918,BENG 100,A01,254234,Taylor Amos; Alyssa C,31,0,40,9
1683294316944,BENG 196,001,270013,Engler; Adam J.,9999,0,9999,0
1683294317970,BICD 100R,A01,202018,Smith; Laurie,0,7,32,32
1683294317970,BICD 100R,A02,202019,Smith; Laurie,0,2,32,32
1683294317970,BICD 100R,A03,202020,Smith; Laurie,0,1,32,32
1683294317970,BICD 100R,A04,202021,Smith; Laurie,8,0,32,24
1683294317970,BICD 100R,A05,202022,Smith; Laurie,12,0,32,20
1683294319002,BICD 136,A01,193242,Gustafson-Brown; Cindy,0,2,32,32
1683294319002,BICD 136,A02,193244,Gustafson-Brown; Cindy,15,0,32,17
1683294320035,BIEB 102,A01,193249,Butler; Shannon Rhey,0,2,32,32
1683294320035,BIEB 102,A02,193251,Butler; Shannon Rhey,0,0,32,32
1683294320035,BIEB 102,A03,193253,Butler; Shannon Rhey,0,1,32,32
1683294320035,BIEB 102,A04,193255,Butler; Shannon Rhey,17,0,32,15
1683294320035,BIEB 102,A05,193265,Butler; Shannon Rhey,26,0,32,6
1683294320035,BIEB 102,A06,193269,Butler; Shannon Rhey,16,0,32,16
1683294322088,BIEB 150,A01,193274,Staff,0,0,32,32
1683294322088,BIEB 150,A02,193285,Staff,24,0,32,8
1683294323115,BIEB 194,A00,193286,Kurle; Carolyn M.,22,0,32,10
1683294324142,BILD 1,A01,192291,Staff,16,0,32,16
1683294324142,BILD 1,A02,192292,Staff,30,0,32,2
1683294324142,BILD 1,B01,192520,Reuther; Keefe,0,1,0,0
1683294324142,BILD 1,B02,192532,Reuther; Keefe,0,1,0,0
1683294325171,BILD 3,A01,192556,Butler; Shannon Rhey,0,0,32,32
1683294325171,BILD 3,A02,192581,Butler; Shannon Rhey,5,0,32,27
1683294325171,BILD 3,A03,192611,Butler; Shannon Rhey,23,0,32,9
1683294325171,BILD 3,A04,192612,Butler; Shannon Rhey,25,0,32,7
1683294325171,BILD 3,A05,192613,Butler; Shannon Rhey,27,0,32,5
1683294325171,BILD 3,A06,192679,Butler; Shannon Rhey,27,0,32,5
1683294325171,BILD 3,A07,192682,Butler; Shannon Rhey,22,0,32,10
1683294326200,BILD 4,A01,192836,Reuther; Keefe,1,0,24,23
1683294326200,BILD 4,A02,193044,Reuther; Keefe,4,0,24,20
1683294327229,BILD 10,A01,193142,Gustafson-Brown; Cindy,31,0,32,1
1683294327229,BILD 10,A02,193149,Gustafson-Brown; Cindy,31,0,32,1
1683294328257,BIMM 100,A01,193301,Staff,0,6,32,32
1683294328257,BIMM 100,A02,193312,Staff,0,5,32,32
1683294328257,BIMM 100,A03,193323,Staff,0,8,32,32
1683294329282,BIMM 101,A01,193329,McDonnell; Lisa Marie,0,3,24,24
1683294329282,BIMM 101,A02,193339,McDonnell; Lisa Marie,0,2,24,24
1683294329282,BIMM 101,B01,193354,McDonnell; Lisa Marie,0,3,24,24
1683294329282,BIMM 101,B02,193357,McDonnell; Lisa Marie,0,3,24,24
1683294330308,BIMM 110,A01,193377,Tat; John,0,11,32,32
1683294330308,BIMM 110,A02,193378,Tat; John,1,9,32,31
1683294331337,BIMM 120,A01,206116,Staff,0,0,32,32
1683294331337,BIMM 120,A02,206117,Staff,8,0,32,24
1683294331337,BIMM 120,A03,206121,Staff,21,0,32,11
1683294332365,BIPN 100,A01,193393,Park; Ji Young,0,14,32,32
1683294332365,BIPN 100,A02,193402,Park; Ji Young,0,12,32,32
1683294332365,BIPN 100,A03,193413,Park; Ji Young,0,14,32,32
1683294332365,BIPN 100,A04,193414,Park; Ji Young,0,13,32,32
1683294333393,BIPN 102,A01,193429,Staff,0,0,32,32
1683294333393,BIPN 102,A02,193438,Staff,23,0,32,9
1683294334424,BIPN 106,A01,193450,Reyes Gonzalez; Catalina,0,2,40,40
1683294335449,BIPN 134,A01,193465,Cooke; James Edward,0,0,32,32
1683294335449,BIPN 134,A02,193474,Cooke; James Edward,27,0,32,5
1683294335449,BIPN 134,A03,193485,Cooke; James Edward,29,0,32,3
1683294335449,BIPN 134,A04,193486,Cooke; James Edward,21,0,32,11
1683294335449,BIPN 134,A05,193491,Cooke; James Edward,31,0,32,1
1683294335449,BIPN 134,A06,193501,Cooke; James Edward,30,0,32,2
1683294335449,BIPN 134,A07,193510,Cooke; James Edward,29,0,32,3
1683294337506,BISP 194,A00,222522,Staff,16,0,32,16
1683294338530,CAT 124,A01,202407,Staff,20,0,25,5
1683294339556,CAT 125,A00,202408,Marchisotto; Jennifer Anne,4,0,20,16
1683294340590,CAT 125R,A00,202409,Smith; Lauryn Alissa,0,11,20,20
1683294340590,CAT 125R,B00,202410,Morales; Celeste Georgianna,0,11,20,20
1683294340590,CAT 125R,C00,202411,Irwin; Matthew Joseph,0,10,20,20
1683294341619,CENG 15,A01,204712,Yang; Kesong,0,1,0,0
1683294342647,CENG 114,A00,202070,Jahed Motlagh; Zeinab,5,0,20,15
1683294343677,CGS 105,A00,185477,Wesling; Megan E.,24,0,40,16
1683294344702,CGS 106,A00,185494,Staff,13,0,22,9
1683294345725,CGS 108,A00,185495,Staff,14,0,20,6
1683294346749,CGS 114,A00,185496,Staff,13,0,18,5
1683294347773,CGS 119,A00,185501,Staff,15,0,20,5
1683294348800,CGS 120,A00,185511,Staff,13,0,20,7
1683294349832,CHEM 4,A01,184675,Bussey; Thomas J,96,0,100,4
1683294350858,CHEM 6A,A01,184677,Staff,35,0,60,25
1683294351885,CHEM 6B,A01,184679,Staff,65,0,100,35
1683294352911,CHEM 6C,A01,184681,Bussey; Thomas J,1,0,50,49
1683294352911,CHEM 6C,A02,184682,Bussey; Thomas J,34,0,50,16
1683294353941,CHEM 40A,A01,184684,Albizati; Kim F.,37,0,100,63
1683294354967,CHEM 40B,A01,184686,Albizati; Kim F.,0,20,100,100
1683294355993,CHEM 41B,A01,184690,Staff,52,0,100,48
1683294357024,COGS 3,A01,184715,Boyle; Mary E. T.,0,25,40,40
1683294358053,COGS 14B,A01,185172,Staff,0,15,38,38
1683294359081,COGS 18,A01,184736,Staff,20,0,80,60
1683294360106,COGS 100,A01,184932,Staff,0,5,73,73
1683294361176,COGS 101A,A01,184935,Staff,0,38,30,30
1683294362205,COGS 101B,A01,184944,Staff,0,2,30,30
1683294363233,COGS 101C,A01,184946,Staff,0,12,30,30
1683294364261,COGS 102A,A01,184951,Johnson; Christine M.,2,0,40,38
1683294365285,COGS 107B,A01,184953,Mooshagian; Eric Frederick,0,50,40,40
1683294366317,COGS 118B,A01,184959,Gupta; Anjum,0,48,40,40
1683294367347,COGS 153,A00,184961,Staff,0,15,30,30
1683294368372,COGS 177,A00,184962,Staff,0,21,30,30
1683294369455,COGS 187A,A01,184969,Boyle; Mary E. T.,0,17,40,40
1683294370486,COMM 10,A01,185174,Staff,0,5,25,25
1683294370486,COMM 10,A02,185189,Staff,0,5,25,25
1683294370486,COMM 10,A03,269821,Staff,0,0,0,0
1683294371514,COMM 100B,A01,185475,Staff,0,0,0,2
1683294371514,COMM 100B,A02,185476,Staff,14,0,25,11
1683294372544,COMM 100C,A01,185314,Staff,1,0,25,24
1683294372544,COMM 100C,A02,185327,Staff,19,0,25,6
1683294373571,COMM 110M,A00,185349,Staff,2,0,40,38
1683294374598,COMM 113T,A00,185352,Staff,25,0,40,15
1683294375627,COMM 114I,A00,185353,Staff,33,0,40,7
1683294376653,COMM 131,A00,185354,Staff,19,0,30,11
1683294377685,CSE 8A,A50,185358,Cao; Yingjun,0,46,10,10
1683294378714,CSE 8B,A01,185362,Staff,0,47,50,50
1683294379739,CSE 11,A01,185416,Cao; Yingjun,0,93,10,10
1683294380770,CSE 20,A01,185445,Briones; Jor-el Thomas Caparas,5,0,25,20
1683294381801,CSE 21,A01,185447,Staff,10,0,50,40
1683294382833,CSE 101,A01,185451,Staff,0,12,50,50
1683294382833,CSE 101,B01,185453,Jones; Miles E,0,11,50,50
1683294384892,CSE 141,A01,185458,Eldon; John,20,0,100,80
1683294385916,CSE 141L,A01,185461,Eldon; John,12,0,100,88
1683294386941,CSE 142,A01,185463,Staff,35,0,60,25
1683294386941,CSE 142,B01,201355,Staff,0,6,60,60
1683294387969,CSE 142L,A01,185470,Staff,35,0,60,25
1683294387969,CSE 142L,B01,201417,Staff,0,5,60,60
1683294388997,CSE 190,A00,201433,Staff,32,0,49,17
1683294390026,DOC 1,A01,259136,Strom; Megan C.,8,0,15,7
1683294390026,DOC 1,A02,259137,Strom; Megan C.,14,0,15,1
1683294390026,DOC 1,A03,259138,Strom; Megan C.,14,0,15,1
1683294390026,DOC 1,A04,259139,Strom; Megan C.,14,0,15,1
1683294391053,DOC 100D,A00,259140,Pass; Natalye Joann,17,0,25,8
1683294392081,DSGN 1,A01,184749,Rill; Bryan,0,24,30,30
1683294393106,DSGN 100,A01,185168,Staff,0,2,25,25
1683294394135,ECE 5,A01,185626,Morris; Karcher William,0,10,0,0
1683294395161,ECE 101,A01,185628,Staff,17,0,70,53
1683294396185,ECE 107,A01,185635,Baghdadchi; Saharnaz,0,0,20,20
1683294396185,ECE 107,A02,185638,Baghdadchi; Saharnaz,4,0,20,16
1683294397211,ECE 148,A01,185647,Silberman; Jack,1,0,16,15
1683294398237,ECON 1,A01,185537,Crane; Meredith Helen,54,0,70,16
1683294399262,ECON 3,A01,185549,Crane; Meredith Helen,33,0,70,37
1683294400293,ECON 4,A01,203354,Anderson; John Charles,0,4,10,10
1683294401318,ECON 100A,A01,185574,Staff,0,4,40,40
1683294402347,ECON 100B,A01,185576,Staff,0,22,40,40
1683294403378,ECON 100C,A01,185589,Newhouse; Herbert S,30,0,70,40
1683294404403,ECON 105,A00,185608,Vespa; Emanuel Ignacio,19,0,35,16
1683294405427,ECON 109,A01,185610,Shishkin; Denis,10,0,35,25
1683294406455,ECON 110A,A01,185612,Staff,11,0,40,29
1683294407480,ECON 120A,A01,185615,Staff,20,0,40,20
1683294408507,ECON 120C,A01,185617,Sun; Yixiao,0,20,70,70
1683294409533,ECON 144,A00,203346,Squires; Dale E,3,0,35,32
1683294410558,ECON 171,A01,203349,Newhouse; Herbert S,0,1,35,35
1683294411582,ECON 173A,A01,185621,Toda; Alexis Akira,21,0,35,14
1683294412611,EDS 25,A01,202413,Staff,0,1,0,0
1683294412611,EDS 25,A02,202414,Staff,0,1,0,0
1683294412611,EDS 25,A03,202415,Staff,0,0,0,0
1683294412611,EDS 25,A04,202416,Staff,0,1,0,0
1683294412611,EDS 25,A05,202439,Staff,0,0,0,0
1683294412611,EDS 25,A06,202440,Staff,0,0,0,0
1683294412611,EDS 25,B01,202631,Staff,0,0,0,0
1683294412611,EDS 25,B02,202632,Staff,0,0,0,0
1683294412611,EDS 25,B03,202639,Staff,0,0,0,0
1683294412611,EDS 25,B04,202640,Staff,0,0,0,0
1683294412611,EDS 25,B05,202643,Staff,0,0,0,0
1683294412611,EDS 25,B06,202644,Staff,0,0,0,0
1683294413641,EDS 38,A01,202659,Black; Alison Michelle,24,0,25,1
1683294414666,EDS 115,A00,202652,Staff,17,0,30,13
1683294415693,EDS 125,A00,202649,Staff,14,0,30,16
1683294416717,EDS 126,A01,203332,Staff,30,0,30,0
1683294417741,EDS 139,A00,202838,Staff,17,0,25,8
1683294418769,EDS 146,A01,202655,Staff,15,0,25,10
1683294419794,ENG 15,A00,185667,Staff,0,1,0,0
1683294419794,ENG 15,B00,185672,Staff,0,0,0,0
1683294419794,ENG 15,C00,185675,Staff,0,0,0,0
1683294419794,ENG 15,D00,185682,Staff,0,0,0,0
1683294419794,ENG 15,E00,185684,Staff,0,0,0,0
1683294420824,ETHN 103,A00,185710,Staff,0,3,35,35
1683294421850,ETHN 103A,A00,199228,Man; Simeon S,3,0,9,6
1683294422879,ETHN 109,A00,185711,Staff,18,0,35,17
1683294423908,ETHN 142,A00,185726,Staff,0,4,30,30
1683294424936,ETHN 163J,A00,199229,Man; Simeon S,6,0,8,2
1683294425961,ETHN 168,A00,185727,Staff,8,0,10,2
1683294426986,ETHN 182,A00,185728,Staff,1,0,35,34
1683294428016,ETHN 183,A00,185737,Staff,8,0,18,10
1683294429043,GLBH 111,A01,209361,Burgos; Jose L.,0,0,0,0
1683294431097,HIEU 104,A00,185792,Staff,16,0,20,4
1683294432122,HIEU 115,A00,185800,Staff,1,0,20,19
1683294433150,HIEU 128,A00,185801,Staff,0,7,20,20
1683294434178,HIEU 147,A00,185802,Staff,16,0,20,4
1683294435204,HIEU 154,A00,185823,Staff,12,0,20,8
1683294436226,HILA 102,A00,185826,Staff,13,0,20,7
1683294437250,HILD 2C,A01,185778,Staff,0,12,20,20
1683294438275,HILD 7B,A01,185780,Kwak; Nancy,0,15,32,32
1683294438275,HILD 7B,A02,185781,Kwak; Nancy,0,18,32,32
1683294439303,HILD 30,A01,185791,Staff,14,0,20,6
1683294440327,HISC 119,A00,185830,Golan; Tal,0,9,20,20
1683294441356,HITO 156GS,A00,185831,Patterson; Patrick H.,0,0,0,23
1683294442380,HIUS 103,A00,185832,Man; Simeon S,0,7,20,20
1683294443408,HIUS 117,A00,185836,Kwak; Nancy,2,0,20,18
1683294444433,HIUS 125,A00,185840,Man; Simeon S,0,0,23,23
1683294445460,HIUS 149,A00,185845,Staff,0,0,20,20
1683294446487,HUM 3,A01,185882,Zavodny; Tatiana Sophia,0,6,50,50
1683294446487,HUM 3,B01,185899,Caldwell; Michael Alan,0,19,50,50
1683294447511,HUM 3GS,A00,185900,Patterson; Patrick H.,0,0,0,23
1683294448538,HUM 4,A01,185938,Zroka; Amy Liane,31,0,50,19
1683294448538,HUM 4,B01,185956,Watkins; Eric,0,2,50,50
1683294448538,HUM 4,B02,202209,Watkins; Eric,0,1,50,50
1683294448538,HUM 4,B03,202210,Watkins; Eric,0,0,50,50
1683294449567,HUM 5,A01,185958,West; Geoffrey Scott,5,0,50,45
1683294449567,HUM 5,A02,202215,West; Geoffrey Scott,0,0,50,50
1683294450593,INTL 190,A00,185959,Gagnon; Jeffrey C,0,0,0,9
1683294450593,INTL 190,B00,185960,Lettieri; Michael Joseph,0,0,0,1
1683294451617,JAPN 180,A00,254509,Staff,0,1,25,25
1683294452647,LATI 10,A01,202853,Kennemore; Amy Michelle,5,0,35,30
1683294452647,LATI 10,A02,202854,Kennemore; Amy Michelle,1,0,35,34
1683294452647,LATI 10,A03,270054,Kennemore; Amy Michelle,30,0,30,0
1683294453676,LATI 180,A00,202855,Kennemore; Amy Michelle,11,0,20,9
1683294454704,LAWS 101,A00,201767,Golan; Tal,0,7,40,40
1683294455729,LIFR 1C,A00,185961,Staff,6,0,20,14
1683294456755,LIFR 1CX,A00,185962,Staff,7,0,20,13
1683294457783,LIFR 1D,A00,185963,Staff,9,0,20,11
1683294458809,LIFR 1DX,A00,185964,Staff,9,0,20,11
1683294459834,LIGN 101,A01,186039,Staff,43,0,50,7
1683294460859,LIGN 165,A00,186040,Staff,18,0,50,32
1683294461884,LTCS 108,A00,186041,Staff,6,0,10,4
1683294462913,LTCS 119,A00,186042,Staff,16,0,20,4
1683294463935,LTCS 130,A00,186043,Wesling; Megan E.,15,0,25,10
1683294465985,LTEA 138,A00,186119,Staff,14,0,40,26
1683294467009,LTEN 124,A00,186148,Staff,6,0,25,19
1683294468035,LTEN 178,A00,186149,Staff,7,0,15,8
1683294469060,LTEN 181,A00,186150,Blanco; John D,33,0,40,7
1683294470085,LTWL 120,A00,186160,Staff,20,0,25,5
1683294471109,LTWL 165,A00,186161,Staff,22,0,25,3
1683294472135,LTWR 100,A00,186162,Staff,0,4,15,15
1683294473239,LTWR 102,A00,186163,Doller; Ben,5,0,15,10
1683294474265,MAE 8,A01,186412,Staff,0,0,0,0
1683294475291,MAE 30B,A00,186445,Bahadori; Mohammad Yousef,83,0,100,17
1683294476316,MAE 40,A00,186592,Bewley; Thomas R,9,0,50,41
1683294477344,MAE 101B,A00,186593,Bahadori; Mohammad Yousef,81,0,100,19
1683294478372,MAE 105,A00,186594,Bandaru; Prabhakar,12,0,50,38
1683294479398,MAE 107,A00,186599,Pham; Hieu Tan,0,6,120,120
1683294480422,MAE 148,A01,186660,Silberman; Jack,3,0,16,13
1683294481452,MATH 10A,A01,188095,Staff,0,7,35,35
1683294482479,MATH 10B,A01,188097,Bowers; Adam R.,0,11,30,30
1683294482479,MATH 10B,A02,188099,Bowers; Adam R.,0,9,30,30
1683294482479,MATH 10B,B01,188104,Bowers; Adam R.,0,11,30,30
1683294482479,MATH 10B,B02,188106,Bowers; Adam R.,0,11,30,30
1683294483514,MATH 10C,A01,188111,Staff,0,18,30,30
1683294483514,MATH 10C,A02,188127,Staff,0,17,30,30
1683294483514,MATH 10C,A03,188131,Staff,0,17,30,30
1683294483514,MATH 10C,B01,188218,Staff,21,0,30,9
1683294483514,MATH 10C,B02,188244,Staff,13,0,30,17
1683294483514,MATH 10C,B03,188277,Staff,16,0,30,14
1683294484546,MATH 18,A01,188344,Bach; Quang Tran,18,0,30,12
1683294484546,MATH 18,A02,188345,Bach; Quang Tran,11,0,30,19
1683294484546,MATH 18,B01,188353,Bach; Quang Tran,10,0,30,20
1683294484546,MATH 18,B02,188354,Bach; Quang Tran,20,0,30,10
1683294485576,MATH 20A,A01,188374,Staff,13,0,35,22
1683294486628,MATH 20B,A01,188382,Ohm; Ko Woon,6,0,30,24
1683294486628,MATH 20B,A02,188383,Ohm; Ko Woon,24,0,30,6
1683294486628,MATH 20B,B01,188385,Ohm; Ko Woon,7,0,30,23
1683294486628,MATH 20B,B02,188392,Ohm; Ko Woon,22,0,30,8
1683294487656,MATH 20C,A01,188394,Harel; Guershon,10,0,30,20
1683294487656,MATH 20C,A02,188395,Harel; Guershon,13,0,30,17
1683294487656,MATH 20C,B01,188404,Harel; Guershon,3,0,30,27
1683294487656,MATH 20C,B02,188405,Harel; Guershon,19,0,30,11
1683294488683,MATH 20D,A01,188414,Hammock; Frances H,0,1,30,30
1683294488683,MATH 20D,A02,188415,Hammock; Frances H,4,0,30,26
1683294488683,MATH 20D,B01,188447,Hammock; Frances H,2,0,30,28
1683294488683,MATH 20D,B02,188486,Hammock; Frances H,8,0,30,22
1683294489710,MATH 20E,A01,188649,Staff,22,0,30,8
1683294489710,MATH 20E,A02,188650,Staff,23,0,30,7
1683294489710,MATH 20E,A03,188673,Staff,0,0,30,30
1683294490736,MATH 102,A01,188675,Staff,0,35,35,35
1683294491762,MATH 103B,A01,188681,Staff,4,0,35,31
1683294491762,MATH 103B,B01,188692,Staff,7,0,35,28
1683294492793,MATH 109,A01,188695,Salehi Golsefidy; Alireza,25,0,35,10
1683294492793,MATH 109,A02,188696,Salehi Golsefidy; Alireza,27,0,35,8
1683294493823,MATH 120A,A01,188698,Eggers; John Dietrich,5,0,35,30
1683294494854,MATH 142B,A01,188736,Ioana; Adrian,0,2,30,30
1683294494854,MATH 142B,A02,188741,Ioana; Adrian,0,1,30,30
1683294494854,MATH 142B,A03,188743,Ioana; Adrian,0,3,30,30
1683294495879,MATH 168A,A01,188790,Staff,0,8,35,35
1683294496910,MATH 170A,A01,188803,Nie; Jiawang,0,2,35,35
1683294496910,MATH 170A,A02,188811,Nie; Jiawang,0,0,35,35
1683294496910,MATH 170A,A03,188814,Nie; Jiawang,1,0,35,34
1683294496910,MATH 170A,A04,188815,Nie; Jiawang,14,0,35,21
1683294497939,MATH 193B,A01,188817,Staff,0,0,35,35
1683294497939,MATH 193B,A02,188818,Staff,5,0,35,30
1683294498968,MGT 4,A01,202857,Anderson; John Charles,62,0,80,18
1683294499995,MGT 12,A00,202858,Lindenberger; Wade Douglas,43,0,90,47
1683294501018,MGT 18,A00,202859,Staff,74,0,90,16
1683294502048,MGT 18GS,A00,202860,McKay; Michael J,13,0,28,15
1683294503076,MGT 45,A00,202861,Pecore; Joseph P.,14,0,90,76
1683294504099,MGT 100,A00,202863,Yavorsky; Daniel Ryan,28,0,90,62
1683294505123,MGT 103,A00,202864,Ehrich; Kristine R,0,16,90,90
1683294506147,MGT 112,A00,202865,Ehrich; Kristine R,15,0,90,75
1683294507174,MGT 121A,A00,202868,Staff,0,19,0,0
1683294508197,MGT 131B,A00,202869,Anderson; John Charles,59,0,90,31
1683294509223,MGT 136,A00,202871,Lindenberger; Wade Douglas,84,0,90,6
1683294510251,MGT 164,A00,202873,Staff,0,69,90,90
1683294511279,MGT 164GS,A00,202874,McKay; Mary A,13,0,28,15
1683294512308,MGT 180,A00,202875,Staff,0,51,90,90
1683294513335,MMW 11R,A01,205019,Herbst; Matthew,3,0,30,27
1683294513335,MMW 11R,A02,205026,Herbst; Matthew,29,0,30,1
1683294514359,MMW 15,A01,193512,Chang; Edmond Yi-Teh,0,9,28,28
1683294514359,MMW 15,A02,193513,Chang; Edmond Yi-Teh,0,5,28,28
1683294514359,MMW 15,A03,193514,Chang; Edmond Yi-Teh,0,5,28,28
1683294514359,MMW 15,A04,193515,Chang; Edmond Yi-Teh,0,4,28,28
1683294514359,MMW 15,A05,193516,Chang; Edmond Yi-Teh,0,4,28,28
1683294514359,MMW 15,A06,193517,Chang; Edmond Yi-Teh,0,5,28,28
1683294514359,MMW 15,B01,193519,Chang; Edmond Yi-Teh,0,4,28,28
1683294514359,MMW 15,B02,193520,Chang; Edmond Yi-Teh,0,5,28,28
1683294514359,MMW 15,B03,193521,Chang; Edmond Yi-Teh,0,4,28,28
1683294514359,MMW 15,B04,193522,Chang; Edmond Yi-Teh,0,4,28,28
1683294514359,MMW 15,B05,193523,Chang; Edmond Yi-Teh,0,5,28,28
1683294514359,MMW 15,B06,193524,Chang; Edmond Yi-Teh,0,4,28,28
1683294515384,MMW 122,A01,193526,Rahimi; Babak,0,14,28,28
1683294515384,MMW 122,A02,193527,Rahimi; Babak,0,14,28,28
1683294515384,MMW 122,A03,193528,Rahimi; Babak,0,0,0,0
1683294515384,MMW 122,A04,193529,Rahimi; Babak,0,0,0,0
1683294516410,MUS 1A,A01,186663,Staff,0,20,35,35
1683294517434,MUS 4,A01,186715,Staff,0,12,35,35
1683294518464,MUS 5R,A01,186796,Dubnov; Shlomo,0,16,35,35
1683294519488,MUS 6,A01,186798,Staff,0,3,25,25
1683294520515,MUS 7,A01,186830,Staff,12,0,35,23
1683294521540,MUS 8,A01,186930,Staff,0,25,35,35
1683294522567,MUS 15,A01,186932,Staff,0,15,35,35
1683294522567,MUS 15,B01,186934,Staff,0,14,35,35
1683294523598,MUS 80,A00,186935,Staff,2,0,20,18
1683294523598,MUS 80,B00,186936,Staff,25,0,25,0
1683294524623,NANO 11,A00,204702,Lipomi; Darren John,0,0,0,0
1683294525650,NANO 15,A01,204709,Yang; Kesong,0,1,0,0
1683294526674,NANO 114,A00,202069,Jahed Motlagh; Zeinab,3,0,10,7
1683294527699,PHIL 1,A00,186955,Grush; Rick Scott,32,0,40,8
1683294528724,PHIL 10,A01,186973,Grush; Rick Scott,29,0,35,6
1683294528724,PHIL 10,A02,186974,Grush; Rick Scott,33,0,35,2
1683294529748,PHIL 13,A01,186976,Staff,7,0,35,28
1683294529748,PHIL 13,A02,186977,Staff,16,0,35,19
1683294530774,PHIL 14,A01,186979,Staff,31,0,35,4
1683294530774,PHIL 14,A02,186986,Staff,32,0,35,3
1683294531801,PHIL 28,A01,186988,Staff,16,0,30,14
1683294531801,PHIL 28,A02,186989,Staff,1,0,30,29
1683294531801,PHIL 28,A03,186990,Staff,9,0,30,21
1683294531801,PHIL 28,A04,186991,Staff,26,0,30,4
1683294532825,PHIL 120,A00,186997,Staff,23,0,40,17
1683294533850,PHIL 137,A00,187003,Staff,9,0,40,31
1683294534877,PHIL 150,A00,187015,Staff,47,0,70,23
1683294535907,PHIL 167,A00,187021,Lamey; Andy M.,35,0,40,5
1683294536934,PHIL 174,A01,202226,Staff,17,0,20,3
1683294536934,PHIL 174,A02,202235,Staff,20,0,20,0
1683294537962,PHIL 191A,A00,258918,Staff,0,0,1,1
1683294538985,PHYS 1A,A00,187028,Staff,26,0,60,34
1683294540012,PHYS 1AL,001,187036,Staff,2,0,30,28
1683294540012,PHYS 1AL,002,187049,Staff,18,0,30,12
1683294541038,PHYS 1B,A00,187058,Staff,23,0,60,37
1683294542066,PHYS 1BL,001,187064,Staff,0,0,30,30
1683294542066,PHYS 1BL,002,187070,Staff,6,0,30,24
1683294543095,PHYS 1C,A00,187082,Staff,32,0,120,88
1683294544133,PHYS 1CL,001,187088,Staff,0,9,30,30
1683294544133,PHYS 1CL,002,187089,Staff,0,2,30,30
1683294544133,PHYS 1CL,009,262693,Staff,12,0,30,18
1683294545162,PHYS 2B,A01,187097,Staff,54,0,115,61
1683294546191,PHYS 2C,A01,187099,Staff,67,0,115,48
1683294547220,PHYS 2CL,A01,187101,Staff,5,0,28,23
1683294547220,PHYS 2CL,A02,187102,Staff,15,0,28,13
1683294548246,PHYS 2D,A01,187123,Shotwell; Brian,95,0,115,20
1683294549272,PHYS 4B,A01,187133,Grinstein; Benjamin,35,0,50,15
1683294550298,POLI 10,A00,188819,Staff,0,3,50,50
1683294551325,POLI 11,A00,188827,Staff,43,0,50,7
1683294552353,POLI 13R,A00,188828,Staff,0,1,20,20
1683294553382,POLI 27,A01,188830,Elgin; Samuel Zincke,0,1,70,70
1683294554409,POLI 30,A00,188832,Desposato; Scott,33,0,50,17
1683294555435,POLI 102F,A00,188834,Staff,3,0,40,37
1683294556460,POLI 104A,A00,188852,Staff,14,0,30,16
1683294557485,POLI 104I,A00,188853,Staff,0,6,20,20
1683294558509,POLI 110B,A00,188854,Wiens; David,7,0,20,13
1683294559536,POLI 112A,A00,188855,Wiens; David,5,0,30,25
1683294560561,POLI 117R,A00,188856,Forman; Fonna,0,11,20,20
1683294561587,POLI 118,A00,188857,Ingham; Sean,8,0,20,12
1683294562615,POLI 120G,A00,188858,Staff,9,0,30,21
1683294563640,POLI 131CR,A00,188863,Hoston; Germaine,24,0,50,26
1683294564665,POLI 133,A00,188864,Nellis; Gareth Hb,44,0,50,6
1683294565695,POLI 134D,A00,188865,Desposato; Scott,27,0,30,3
1683294566722,POLI 142A,A00,188871,Gartzke; Erik,22,0,50,28
1683294567749,POLI 142K,A00,188874,Staff,38,0,50,12
1683294568774,POLI 143,A00,188940,Gartzke; Erik,16,0,30,14
1683294569799,POLI 153,A00,188943,Staff,3,0,20,17
1683294570824,POLI 160AA,A00,188944,Staff,13,0,40,27
1683294571849,POLI 170A,A00,188945,Staff,11,0,30,19
1683294573901,PSYC 1,A00,188952,Staff,38,0,90,52
1683294574926,PSYC 2,B00,188953,Staff,20,0,35,15
1683294575954,PSYC 6,A00,188970,Staff,47,0,60,13
1683294577038,PSYC 7,A00,188973,Staff,37,0,45,8
1683294578067,PSYC 60,A01,188980,Rickard; Timothy C.,43,0,60,17
1683294579092,PSYC 70,A01,189001,Steiner; Eric Tomas,24,0,45,21
1683294580117,PSYC 100,A00,189005,Lacefield; Katharine I,0,99,120,120
1683294581144,PSYC 102,A00,189008,Staff,10,0,30,20
1683294582170,PSYC 106,B00,189026,Gorman; Michael R.,37,0,60,23
1683294583193,PSYC 114,B01,189033,Winkielman; Piotr,0,32,30,30
1683294584217,PSYC 131,A00,189036,Anagnostaras; Stephan,0,43,60,60
1683294585247,PSYC 136,A00,189041,Lowe; Angela Beth,0,7,25,25
1683294586269,PSYC 137,A00,189057,Winkielman; Piotr,0,34,25,25
1683294587294,PSYC 144,A00,189107,Wixted; John T,0,7,50,50
1683294589347,PSYC 162,A00,189142,Staff,0,8,85,85
1683294590375,PSYC 172,A00,189144,Gorman; Michael R.,0,7,30,30
1683294592446,PSYC 179,A00,189146,Lacefield; Katharine I,0,84,120,120
1683294593471,PSYC 181,A00,189147,Anagnostaras; Stephan,0,44,90,90
1683294594497,PSYC 190R,A00,189148,Barner; David A.,0,22,80,80
1683294595521,PSYC 191,A00,189275,Rickard; Timothy C.,0,7,25,25
1683294596547,PSYC 193,A00,189276,Chapman; Eddie Nathaniel,0,1,0,4
1683294597573,PSYC 193L,A01,189281,Lowe; Angela Beth,12,0,20,8
1683294597573,PSYC 193L,B01,189285,Staff,28,0,35,7
1683294598602,RELI 149,A00,187137,Rahimi; Babak,7,0,40,33
1683294599628,SE 9,A01,187315,Staff,0,2,18,18
1683294600657,SE 101B,A00,187409,Staff,24,0,30,6
1683294601687,SE 110B,A00,187444,Staff,10,0,40,30
1683294602711,SE 130B,A00,187449,Staff,31,0,40,9
1683294603744,SE 150A,A00,187516,Staff,9,0,20,11
1683294604779,SE 154,A00,187528,Staff,30,0,50,20
1683294605809,SIO 3,A01,258171,Staff,35,0,40,5
1683294606837,SIO 10,A00,187144,Cook; Geoffrey W,0,3,75,75
1683294607864,SIO 45,A00,187152,Cook; Geoffrey W,1,0,100,99
1683294608890,SIO 109R,A00,194486,Staff,0,3,20,20
1683294610942,SIO 187,A01,187233,Kacev; David,12,0,40,28
1683294611973,SOCI 1,A01,258656,Thorpe; Charles Robert,28,0,30,2
1683294611973,SOCI 1,A02,258658,Thorpe; Charles Robert,30,0,30,0
1683294611973,SOCI 1,A03,258661,Thorpe; Charles Robert,25,0,25,0
1683294611973,SOCI 1,A04,258666,Thorpe; Charles Robert,22,0,25,3
1683294611973,SOCI 1,A05,258897,Thorpe; Charles Robert,23,0,25,2
1683294611973,SOCI 1,A06,258898,Thorpe; Charles Robert,25,0,25,0
1683294612996,SOCI 30,A01,258903,Pardo Guerra; Juan Pablo,16,0,30,14
1683294614021,SOCI 102,A00,258904,Staff,9,0,25,16
1683294615045,SOCI 106,A00,258905,Staff,19,0,25,6
1683294616076,SOCI 111,A00,258907,Ribas Norris; Janet Vanesa,26,0,30,4
1683294617104,SOCI 121R,A00,258908,Pardo Guerra; Juan Pablo,11,0,30,19
1683294618132,SOCI 126,A01,203330,Staff,14,0,20,6
1683294619156,SOCI 131,A00,258909,Thorpe; Charles Robert,31,0,60,29
1683294620185,SOCI 135,A00,258910,Payne; Christine Anna,0,9,30,30
1683294621209,SOCI 157,A00,258911,Staff,13,0,30,17
1683294622232,SOCI 184,A00,258912,Staff,26,0,30,4
1683294623257,SOCI 188D,A00,258913,Staff,21,0,30,9
1683294624283,SYN 2,001,187529,Staff,9,0,16,7
1683294624283,SYN 2,002,201452,Staff,0,18,16,16
1683294624283,SYN 2,003,201469,Staff,3,0,16,13
1683294625308,SYN 100,A01,187531,Staff,0,9,20,20
1683294625308,SYN 100,B01,201491,Staff,0,12,20,20
1683294626333,TDAC 1,A00,189286,Walsh; Kim C.,3,0,20,17
1683294626333,TDAC 1,B00,189287,Harting; Carla Kelso,11,0,20,9
1683294627361,TDAC 101,A00,189300,Walsh; Kim C.,16,0,20,4
1683294627361,TDAC 101,B00,189301,Harting; Carla Kelso,18,0,20,2
1683294628386,TDAC 102,A00,189304,Basso; Beatrice,14,0,20,6
1683294629411,TDAC 108,A00,189305,Staff,18,0,20,2
1683294630440,TDDE 131,A00,189310,Staff,19,0,20,1
1683294630440,TDDE 131,B00,189314,Staff,19,0,20,1
1683294630440,TDDE 131,C00,189315,Staff,48,0,50,2
1683294630440,TDDE 131,D00,189316,Staff,14,0,15,1
1683294630440,TDDE 131,E00,204841,Staff,20,0,20,0
1683294631465,TDGE 10,A00,189289,Staff,30,0,50,20
1683294631465,TDGE 10,B00,189290,Havis; Allan,2,0,50,48
1683294632494,TDGE 11,A00,189291,Fulton; Julia,0,3,50,50
1683294632494,TDGE 11,B00,189292,Staff,20,0,25,5
1683294632494,TDGE 11,C00,260270,Staff,0,0,0,0
1683294633520,TDGE 25,A00,189294,Staff,3,0,20,17
1683294634543,TDGE 124,A00,189318,Fulton; Julia,0,8,50,50
1683294635568,TDGE 125,A00,189319,Staff,13,0,25,12
1683294635568,TDGE 125,B00,189320,Staff,23,0,25,2
1683294636597,TDGE 127,A00,189322,Havis; Allan,0,0,50,50
1683294637622,TDHT 101,A00,189323,Staff,18,0,25,7
1683294637622,TDHT 101,B00,189324,Staff,25,0,25,0
1683294638647,TDHT 102,A00,189325,Staff,49,0,50,1
1683294639672,TDMV 1,A00,189295,Arcidiacono; Kristin,20,0,30,10
1683294639672,TDMV 1,B00,189296,Caligagan; Maria T.,24,0,30,6
1683294640701,TDMV 2,A00,189297,Sammartano; Tonnie,28,0,30,2
1683294640701,TDMV 2,B00,189299,Arcidiacono; Kristin,24,0,30,6
1683294641731,TDMV 3,A00,204998,Rincon; Alicia,22,0,30,8
1683294642759,TDMV 120,A00,189458,Sammartano; Tonnie,28,0,30,2
1683294643787,TDMV 138,A00,189541,Jun; Grace Shin Hae,22,0,40,18
1683294644814,TDMV 142,A00,189717,Caligagan; Tony,23,0,30,7
1683294644814,TDMV 142,B00,189718,Caligagan; Maria T.,25,0,30,5
1683294645838,TMC 2,A01,187533,Staff,25,0,25,0
1683294645838,TMC 2,A02,187534,Staff,25,0,25,0
1683294646863,USP 1,A01,187536,Kwak; Nancy,0,16,25,25
1683294647889,USP 5,A01,187538,Staff,9,0,25,16
1683294648913,USP 101,A00,199253,Staff,0,4,0,0
1683294649938,USP 124,A00,187562,Boomhower; Matthew Charles,1,0,30,29
1683294650964,USP 138,A00,187582,Staff,20,0,25,5
1683294651989,USP 152,A01,187597,Staff,4,0,25,21
1683294653014,USP 153,A00,187598,Staff,19,0,25,6
1683294654037,USP 168,A00,187607,Kwak; Nancy,2,0,5,3
1683294655063,USP 173,A00,187619,Staff,4,0,25,21
1683294656087,USP 181,A00,187638,Staff,0,0,25,25
1683294657115,VIS 103,A00,187650,Cruz; Edwin Teddy,23,0,75,52
1683294658142,VIS 110D,A00,187669,Staff,12,0,22,10
1683294659168,VIS 127C,A00,187720,Shen; Kuiyi,68,0,146,78
1683294660197,VIS 149,A00,187731,Yoldas; Pinar,0,14,22,22
1683294661270,VIS 151,A01,188091,Staff,22,0,34,12
1683294661270,VIS 151,A02,188092,Staff,11,0,34,23
1683294662294,VIS 160B,A00,188093,Stalbaum; Brett,0,0,10,10
1683294664350,WCWP 10B,A00,201720,Staff,10,0,15,5
1683294664350,WCWP 10B,B00,201722,Staff,8,0,15,7
1683294665375,WCWP 100,A00,201725,Gagnon; Jeffrey C,0,0,2,2
1683294665375,WCWP 100,B00,201727,Staff,0,4,15,15
1683294668489,ANBI 133,A00,258401,Wilder; Linnea Lorene,34,0,40,6
1683294669518,ANBI 140,A00,258395,Hrvoj Mihic; Branka,18,0,25,7
1683294670545,ANSC 120,A00,258402,Bialecki; Jon Anthony,27,0,40,13
1683294671571,ANSC 144,A00,258400,Staff,14,0,40,26
1683294673630,ANSC 166,A00,258396,Parish; Steven Martin,157,0,175,18
1683294674659,ANSC 180,A00,193533,Staff,9,0,20,11
1683294675689,ANSC 188,A00,258397,Jassal; Aftab,33,0,40,7
1683294676717,ANTH 3,A01,258316,Staff,23,0,30,7
1683294677744,ANTH 5,A00,258394,Semendeferi; Ekaterini,16,0,20,4
1683294678769,ANTH 21,A01,258331,Staff,9,0,40,31
1683294679794,ANTH 103,A00,258398,Varma; Saiba,15,0,25,10
1683294680881,AWP 10,001,202034,Staff,0,0,0,0
1683294680881,AWP 10,002,202035,Staff,0,0,0,0
1683294680881,AWP 10,003,202036,Staff,0,0,0,0
1683294680881,AWP 10,004,202037,Staff,0,0,0,0
1683294680881,AWP 10,005,202038,Staff,0,0,0,0
1683294680881,AWP 10,006,202039,Staff,0,0,0,0
1683294680881,AWP 10,007,202040,Staff,0,0,0,0
1683294680881,AWP 10,008,202041,Staff,0,0,0,0
1683294680881,AWP 10,009,202042,Staff,0,0,0,0
1683294680881,AWP 10,010,202043,Staff,0,0,0,0
1683294680881,AWP 10,011,202044,Staff,0,0,0,0
1683294680881,AWP 10,012,202045,Staff,0,0,0,0
1683294680881,AWP 10,013,202046,Staff,0,0,0,0
1683294680881,AWP 10,014,202047,Staff,0,0,0,0
1683294680881,AWP 10,015,202048,Staff,0,0,0,0
1683294680881,AWP 10,016,202049,Staff,0,0,0,0
1683294680881,AWP 10,017,202050,Staff,0,0,0,0
1683294680881,AWP 10,018,202051,Staff,0,0,0,0
1683294680881,AWP 10,019,202052,Staff,0,0,0,0
1683294680881,AWP 10,020,202053,Staff,0,0,0,0
1683294680881,AWP 10,021,202054,Staff,0,0,0,0
1683294680881,AWP 10,022,202055,Staff,0,0,0,0
1683294680881,AWP 10,023,202056,Staff,0,0,0,0
1683294680881,AWP 10,024,202057,Staff,0,0,0,0
1683294680881,AWP 10,025,202058,Staff,0,0,0,0
1683294680881,AWP 10,026,202059,Staff,0,0,0,0
1683294681907,AWP 102,001,202032,Staff,0,0,0,0
1683294681907,AWP 102,002,202033,Staff,0,0,0,0
1683294682937,BENG 100,A01,254234,Taylor Amos; Alyssa C,31,0,40,9
1683294683965,BENG 196,001,270013,Engler; Adam J.,9999,0,9999,0
1683294684993,BICD 100R,A01,202018,Smith; Laurie,0,7,32,32
1683294684993,BICD 100R,A02,202019,Smith; Laurie,0,2,32,32
1683294684993,BICD 100R,A03,202020,Smith; Laurie,0,1,32,32
1683294684993,BICD 100R,A04,202021,Smith; Laurie,8,0,32,24
1683294684993,BICD 100R,A05,202022,Smith; Laurie,12,0,32,20
1683294686019,BICD 136,A01,193242,Gustafson-Brown; Cindy,0,2,32,32
1683294686019,BICD 136,A02,193244,Gustafson-Brown; Cindy,15,0,32,17
1683294687046,BIEB 102,A01,193249,Butler; Shannon Rhey,0,2,32,32
1683294687046,BIEB 102,A02,193251,Butler; Shannon Rhey,0,0,32,32
1683294687046,BIEB 102,A03,193253,Butler; Shannon Rhey,0,1,32,32
1683294687046,BIEB 102,A04,193255,Butler; Shannon Rhey,17,0,32,15
1683294687046,BIEB 102,A05,193265,Butler; Shannon Rhey,26,0,32,6
1683294687046,BIEB 102,A06,193269,Butler; Shannon Rhey,16,0,32,16
1683294689101,BIEB 150,A01,193274,Staff,0,0,32,32
1683294689101,BIEB 150,A02,193285,Staff,24,0,32,8
1683294690125,BIEB 194,A00,193286,Kurle; Carolyn M.,22,0,32,10
1683294691150,BILD 1,A01,192291,Staff,16,0,32,16
1683294691150,BILD 1,A02,192292,Staff,30,0,32,2
1683294691150,BILD 1,B01,192520,Reuther; Keefe,0,1,0,0
1683294691150,BILD 1,B02,192532,Reuther; Keefe,0,1,0,0
1683294692173,BILD 3,A01,192556,Butler; Shannon Rhey,0,0,32,32
1683294692173,BILD 3,A02,192581,Butler; Shannon Rhey,5,0,32,27
1683294692173,BILD 3,A03,192611,Butler; Shannon Rhey,23,0,32,9
1683294692173,BILD 3,A04,192612,Butler; Shannon Rhey,25,0,32,7
1683294692173,BILD 3,A05,192613,Butler; Shannon Rhey,27,0,32,5
1683294692173,BILD 3,A06,192679,Butler; Shannon Rhey,27,0,32,5
1683294692173,BILD 3,A07,192682,Butler; Shannon Rhey,22,0,32,10
1683294693205,BILD 4,A01,192836,Reuther; Keefe,1,0,24,23
1683294693205,BILD 4,A02,193044,Reuther; Keefe,4,0,24,20
1683294694234,BILD 10,A01,193142,Gustafson-Brown; Cindy,31,0,32,1
1683294694234,BILD 10,A02,193149,Gustafson-Brown; Cindy,31,0,32,1
1683294695262,BIMM 100,A01,193301,Staff,0,6,32,32
1683294695262,BIMM 100,A02,193312,Staff,0,5,32,32
1683294695262,BIMM 100,A03,193323,Staff,0,8,32,32
1683294696288,BIMM 101,A01,193329,McDonnell; Lisa Marie,0,3,24,24
1683294696288,BIMM 101,A02,193339,McDonnell; Lisa Marie,0,2,24,24
1683294696288,BIMM 101,B01,193354,McDonnell; Lisa Marie,0,3,24,24
1683294696288,BIMM 101,B02,193357,McDonnell; Lisa Marie,0,3,24,24
1683294697313,BIMM 110,A01,193377,Tat; John,0,11,32,32
1683294697313,BIMM 110,A02,193378,Tat; John,1,9,32,31
1683294698339,BIMM 120,A01,206116,Staff,0,0,32,32
1683294698339,BIMM 120,A02,206117,Staff,8,0,32,24
1683294698339,BIMM 120,A03,206121,Staff,21,0,32,11
1683294699366,BIPN 100,A01,193393,Park; Ji Young,0,14,32,32
1683294699366,BIPN 100,A02,193402,Park; Ji Young,0,12,32,32
1683294699366,BIPN 100,A03,193413,Park; Ji Young,0,14,32,32
1683294699366,BIPN 100,A04,193414,Park; Ji Young,0,13,32,32
1683294700391,BIPN 102,A01,193429,Staff,0,0,32,32
1683294700391,BIPN 102,A02,193438,Staff,23,0,32,9
1683294701424,BIPN 106,A01,193450,Reyes Gonzalez; Catalina,0,2,40,40
1683294702458,BIPN 134,A01,193465,Cooke; James Edward,0,0,32,32
1683294702458,BIPN 134,A02,193474,Cooke; James Edward,27,0,32,5
1683294702458,BIPN 134,A03,193485,Cooke; James Edward,29,0,32,3
1683294702458,BIPN 134,A04,193486,Cooke; James Edward,21,0,32,11
1683294702458,BIPN 134,A05,193491,Cooke; James Edward,31,0,32,1
1683294702458,BIPN 134,A06,193501,Cooke; James Edward,30,0,32,2
1683294702458,BIPN 134,A07,193510,Cooke; James Edward,29,0,32,3
1683294704512,BISP 194,A00,222522,Staff,16,0,32,16
1683294705537,CAT 124,A01,202407,Staff,20,0,25,5
1683294706561,CAT 125,A00,202408,Marchisotto; Jennifer Anne,4,0,20,16
1683294707588,CAT 125R,A00,202409,Smith; Lauryn Alissa,0,11,20,20
1683294707588,CAT 125R,B00,202410,Morales; Celeste Georgianna,0,11,20,20
1683294707588,CAT 125R,C00,202411,Irwin; Matthew Joseph,0,10,20,20
1683294708614,CENG 15,A01,204712,Yang; Kesong,0,1,0,0
1683294709639,CENG 114,A00,202070,Jahed Motlagh; Zeinab,5,0,20,15
1683294710668,CGS 105,A00,185477,Wesling; Megan E.,24,0,40,16
1683294711694,CGS 106,A00,185494,Staff,13,0,22,9
1683294712722,CGS 108,A00,185495,Staff,14,0,20,6
1683294713756,CGS 114,A00,185496,Staff,13,0,18,5
1683294714784,CGS 119,A00,185501,Staff,15,0,20,5
1683294715808,CGS 120,A00,185511,Staff,13,0,20,7
1683294716834,CHEM 4,A01,184675,Bussey; Thomas J,96,0,100,4
1683294717862,CHEM 6A,A01,184677,Staff,35,0,60,25
1683294718886,CHEM 6B,A01,184679,Staff,65,0,100,35
1683294719910,CHEM 6C,A01,184681,Bussey; Thomas J,1,0,50,49
1683294719910,CHEM 6C,A02,184682,Bussey; Thomas J,34,0,50,16
1683294720934,CHEM 40A,A01,184684,Albizati; Kim F.,37,0,100,63
1683294721962,CHEM 40B,A01,184686,Albizati; Kim F.,0,20,100,100
1683294722991,CHEM 41B,A01,184690,Staff,52,0,100,48
1683294724020,COGS 3,A01,184715,Boyle; Mary E. T.,0,25,40,40
1683294725048,COGS 14B,A01,185172,Staff,0,15,38,38
1683294726076,COGS 18,A01,184736,Staff,20,0,80,60
1683294727104,COGS 100,A01,184932,Staff,0,5,73,73
1683294728133,COGS 101A,A01,184935,Staff,0,38,30,30
1683294729158,COGS 101B,A01,184944,Staff,0,2,30,30
1683294730183,COGS 101C,A01,184946,Staff,0,12,30,30
1683294731208,COGS 102A,A01,184951,Johnson; Christine M.,2,0,40,38
1683294732232,COGS 107B,A01,184953,Mooshagian; Eric Frederick,0,50,40,40
1683294733258,COGS 118B,A01,184959,Gupta; Anjum,0,48,40,40
1683294734285,COGS 153,A00,184961,Staff,0,15,30,30
1683294735309,COGS 177,A00,184962,Staff,0,21,30,30
1683294736336,COGS 187A,A01,184969,Boyle; Mary E. T.,0,17,40,40
1683294737362,COMM 10,A01,185174,Staff,0,5,25,25
1683294737362,COMM 10,A02,185189,Staff,0,5,25,25
1683294737362,COMM 10,A03,269821,Staff,0,0,0,0
1683294738388,COMM 100B,A01,185475,Staff,0,0,0,2
1683294738388,COMM 100B,A02,185476,Staff,14,0,25,11
1683294739411,COMM 100C,A01,185314,Staff,1,0,25,24
1683294739411,COMM 100C,A02,185327,Staff,19,0,25,6
1683294740436,COMM 110M,A00,185349,Staff,2,0,40,38
1683294741463,COMM 113T,A00,185352,Staff,25,0,40,15
1683294742488,COMM 114I,A00,185353,Staff,33,0,40,7
1683294743513,COMM 131,A00,185354,Staff,19,0,30,11
1683294744538,CSE 8A,A50,185358,Cao; Yingjun,0,46,10,10
1683294745563,CSE 8B,A01,185362,Staff,0,47,50,50
1683294746587,CSE 11,A01,185416,Cao; Yingjun,0,93,10,10
1683294747614,CSE 20,A01,185445,Briones; Jor-el Thomas Caparas,5,0,25,20
1683294748642,CSE 21,A01,185447,Staff,10,0,50,40
1683294749668,CSE 101,A01,185451,Staff,0,12,50,50
1683294749668,CSE 101,B01,185453,Jones; Miles E,0,11,50,50
1683294751722,CSE 141,A01,185458,Eldon; John,20,0,100,80
1683294752749,CSE 141L,A01,185461,Eldon; John,12,0,100,88
1683294753777,CSE 142,A01,185463,Staff,35,0,60,25
1683294753777,CSE 142,B01,201355,Staff,0,6,60,60
1683294754802,CSE 142L,A01,185470,Staff,35,0,60,25
1683294754802,CSE 142L,B01,201417,Staff,0,5,60,60
1683294755826,CSE 190,A00,201433,Staff,32,0,49,17
1683294756852,DOC 1,A01,259136,Strom; Megan C.,8,0,15,7
1683294756852,DOC 1,A02,259137,Strom; Megan C.,14,0,15,1
1683294756852,DOC 1,A03,259138,Strom; Megan C.,14,0,15,1
1683294756852,DOC 1,A04,259139,Strom; Megan C.,14,0,15,1
1683294757881,DOC 100D,A00,259140,Pass; Natalye Joann,17,0,25,8
1683294758911,DSGN 1,A01,184749,Rill; Bryan,0,24,30,30
1683294759939,DSGN 100,A01,185168,Staff,0,2,25,25
1683294760970,ECE 5,A01,185626,Morris; Karcher William,0,10,0,0
1683294761995,ECE 101,A01,185628,Staff,17,0,70,53
1683294763019,ECE 107,A01,185635,Baghdadchi; Saharnaz,0,0,20,20
1683294763019,ECE 107,A02,185638,Baghdadchi; Saharnaz,4,0,20,16
1683294764047,ECE 148,A01,185647,Silberman; Jack,1,0,16,15
1683294765076,ECON 1,A01,185537,Crane; Meredith Helen,54,0,70,16
1683294766101,ECON 3,A01,185549,Crane; Meredith Helen,33,0,70,37
1683294767129,ECON 4,A01,203354,Anderson; John Charles,0,4,10,10
1683294768153,ECON 100A,A01,185574,Staff,0,4,40,40
1683294769176,ECON 100B,A01,185576,Staff,0,22,40,40
1683294770204,ECON 100C,A01,185589,Newhouse; Herbert S,30,0,70,40
1683294771233,ECON 105,A00,185608,Vespa; Emanuel Ignacio,19,0,35,16
1683294772259,ECON 109,A01,185610,Shishkin; Denis,10,0,35,25
1683294773285,ECON 110A,A01,185612,Staff,11,0,40,29
1683294774313,ECON 120A,A01,185615,Staff,20,0,40,20
1683294775337,ECON 120C,A01,185617,Sun; Yixiao,0,20,70,70
1683294776362,ECON 144,A00,203346,Squires; Dale E,3,0,35,32
1683294777390,ECON 171,A01,203349,Newhouse; Herbert S,0,1,35,35
1683294778418,ECON 173A,A01,185621,Toda; Alexis Akira,21,0,35,14
1683294779471,EDS 25,A01,202413,Staff,0,1,0,0
1683294779471,EDS 25,A02,202414,Staff,0,1,0,0
1683294779471,EDS 25,A03,202415,Staff,0,0,0,0
1683294779471,EDS 25,A04,202416,Staff,0,1,0,0
1683294779471,EDS 25,A05,202439,Staff,0,0,0,0
1683294779471,EDS 25,A06,202440,Staff,0,0,0,0
1683294779471,EDS 25,B01,202631,Staff,0,0,0,0
1683294779471,EDS 25,B02,202632,Staff,0,0,0,0
1683294779471,EDS 25,B03,202639,Staff,0,0,0,0
1683294779471,EDS 25,B04,202640,Staff,0,0,0,0
1683294779471,EDS 25,B05,202643,Staff,0,0,0,0
1683294779471,EDS 25,B06,202644,Staff,0,0,0,0
1683294780496,EDS 38,A01,202659,Black; Alison Michelle,24,0,25,1
1683294781521,EDS 115,A00,202652,Staff,17,0,30,13
1683294782548,EDS 125,A00,202649,Staff,14,0,30,16
1683294783573,EDS 126,A01,203332,Staff,30,0,30,0
1683294784655,EDS 139,A00,202838,Staff,17,0,25,8
1683294785682,EDS 146,A01,202655,Staff,15,0,25,10
1683294786711,ENG 15,A00,185667,Staff,0,1,0,0
1683294786711,ENG 15,B00,185672,Staff,0,0,0,0
1683294786711,ENG 15,C00,185675,Staff,0,0,0,0
1683294786711,ENG 15,D00,185682,Staff,0,0,0,0
1683294786711,ENG 15,E00,185684,Staff,0,0,0,0
1683294787740,ETHN 103,A00,185710,Staff,0,3,35,35
1683294788769,ETHN 103A,A00,199228,Man; Simeon S,3,0,9,6
1683294789794,ETHN 109,A00,185711,Staff,18,0,35,17
1683294790819,ETHN 142,A00,185726,Staff,0,4,30,30
1683294791843,ETHN 163J,A00,199229,Man; Simeon S,6,0,8,2
1683294792870,ETHN 168,A00,185727,Staff,8,0,10,2
1683294793898,ETHN 182,A00,185728,Staff,1,0,35,34
1683294794926,ETHN 183,A00,185737,Staff,8,0,18,10
1683294795955,GLBH 111,A01,209361,Burgos; Jose L.,0,0,0,0
1683294798009,HIEU 104,A00,185792,Staff,16,0,20,4
1683294799034,HIEU 115,A00,185800,Staff,1,0,20,19
1683294800061,HIEU 128,A00,185801,Staff,0,7,20,20
1683294801084,HIEU 147,A00,185802,Staff,16,0,20,4
1683294802106,HIEU 154,A00,185823,Staff,12,0,20,8
1683294803134,HILA 102,A00,185826,Staff,13,0,20,7
1683294804161,HILD 2C,A01,185778,Staff,0,12,20,20
1683294805185,HILD 7B,A01,185780,Kwak; Nancy,0,15,32,32
1683294805185,HILD 7B,A02,185781,Kwak; Nancy,0,18,32,32
1683294806209,HILD 30,A01,185791,Staff,14,0,20,6
1683294807237,HISC 119,A00,185830,Golan; Tal,0,9,20,20
1683294808263,HITO 156GS,A00,185831,Patterson; Patrick H.,0,0,0,23
1683294809291,HIUS 103,A00,185832,Man; Simeon S,0,7,20,20
1683294810315,HIUS 117,A00,185836,Kwak; Nancy,2,0,20,18
1683294811337,HIUS 125,A00,185840,Man; Simeon S,0,0,23,23
1683294812362,HIUS 149,A00,185845,Staff,0,0,20,20
1683294813391,HUM 3,A01,185882,Zavodny; Tatiana Sophia,0,6,50,50
1683294813391,HUM 3,B01,185899,Caldwell; Michael Alan,0,19,50,50
1683294814418,HUM 3GS,A00,185900,Patterson; Patrick H.,0,0,0,23
1683294815449,HUM 4,A01,185938,Zroka; Amy Liane,31,0,50,19
1683294815449,HUM 4,B01,185956,Watkins; Eric,0,2,50,50
1683294815449,HUM 4,B02,202209,Watkins; Eric,0,1,50,50
1683294815449,HUM 4,B03,202210,Watkins; Eric,0,0,50,50
1683294816474,HUM 5,A01,185958,West; Geoffrey Scott,5,0,50,45
1683294816474,HUM 5,A02,202215,West; Geoffrey Scott,0,0,50,50
1683294817498,INTL 190,A00,185959,Gagnon; Jeffrey C,0,0,0,9
1683294817498,INTL 190,B00,185960,Lettieri; Michael Joseph,0,0,0,1
1683294818525,JAPN 180,A00,254509,Staff,0,1,25,25
1683294819551,LATI 10,A01,202853,Kennemore; Amy Michelle,5,0,35,30
1683294819551,LATI 10,A02,202854,Kennemore; Amy Michelle,1,0,35,34
1683294819551,LATI 10,A03,270054,Kennemore; Amy Michelle,30,0,30,0
1683294820575,LATI 180,A00,202855,Kennemore; Amy Michelle,11,0,20,9
1683294821600,LAWS 101,A00,201767,Golan; Tal,0,7,40,40
1683294822625,LIFR 1C,A00,185961,Staff,6,0,20,14
1683294823653,LIFR 1CX,A00,185962,Staff,7,0,20,13
1683294824681,LIFR 1D,A00,185963,Staff,9,0,20,11
1683294825706,LIFR 1DX,A00,185964,Staff,9,0,20,11
1683294826734,LIGN 101,A01,186039,Staff,43,0,50,7
1683294827758,LIGN 165,A00,186040,Staff,18,0,50,32
1683294828782,LTCS 108,A00,186041,Staff,6,0,10,4
1683294829807,LTCS 119,A00,186042,Staff,16,0,20,4
1683294830832,LTCS 130,A00,186043,Wesling; Megan E.,15,0,25,10
1683294832884,LTEA 138,A00,186119,Staff,14,0,40,26
1683294833912,LTEN 124,A00,186148,Staff,6,0,25,19
1683294834940,LTEN 178,A00,186149,Staff,7,0,15,8
1683294835968,LTEN 181,A00,186150,Blanco; John D,33,0,40,7
1683294836994,LTWL 120,A00,186160,Staff,20,0,25,5
1683294838018,LTWL 165,A00,186161,Staff,22,0,25,3
1683294839046,LTWR 100,A00,186162,Staff,0,4,15,15
1683294840074,LTWR 102,A00,186163,Doller; Ben,5,0,15,10
1683294841099,MAE 8,A01,186412,Staff,0,0,0,0
1683294842122,MAE 30B,A00,186445,Bahadori; Mohammad Yousef,83,0,100,17
1683294843147,MAE 40,A00,186592,Bewley; Thomas R,9,0,50,41
1683294844172,MAE 101B,A00,186593,Bahadori; Mohammad Yousef,81,0,100,19
1683294845197,MAE 105,A00,186594,Bandaru; Prabhakar,12,0,50,38
1683294846224,MAE 107,A00,186599,Pham; Hieu Tan,0,6,120,120
1683294847250,MAE 148,A01,186660,Silberman; Jack,3,0,16,13
1683294848278,MATH 10A,A01,188095,Staff,0,7,35,35
1683294849305,MATH 10B,A01,188097,Bowers; Adam R.,0,11,30,30
1683294849305,MATH 10B,A02,188099,Bowers; Adam R.,0,9,30,30
1683294849305,MATH 10B,B01,188104,Bowers; Adam R.,0,11,30,30
1683294849305,MATH 10B,B02,188106,Bowers; Adam R.,0,11,30,30
1683294850331,MATH 10C,A01,188111,Staff,0,18,30,30
1683294850331,MATH 10C,A02,188127,Staff,0,17,30,30
1683294850331,MATH 10C,A03,188131,Staff,0,17,30,30
1683294850331,MATH 10C,B01,188218,Staff,21,0,30,9
1683294850331,MATH 10C,B02,188244,Staff,13,0,30,17
1683294850331,MATH 10C,B03,188277,Staff,16,0,30,14
1683294851356,MATH 18,A01,188344,Bach; Quang Tran,18,0,30,12
1683294851356,MATH 18,A02,188345,Bach; Quang Tran,11,0,30,19
1683294851356,MATH 18,B01,188353,Bach; Quang Tran,10,0,30,20
1683294851356,MATH 18,B02,188354,Bach; Quang Tran,20,0,30,10
1683294852381,MATH 20A,A01,188374,Staff,13,0,35,22
1683294853413,MATH 20B,A01,188382,Ohm; Ko Woon,6,0,30,24
1683294853413,MATH 20B,A02,188383,Ohm; Ko Woon,24,0,30,6
1683294853413,MATH 20B,B01,188385,Ohm; Ko Woon,7,0,30,23
1683294853413,MATH 20B,B02,188392,Ohm; Ko Woon,22,0,30,8
1683294854443,MATH 20C,A01,188394,Harel; Guershon,10,0,30,20
1683294854443,MATH 20C,A02,188395,Harel; Guershon,13,0,30,17
1683294854443,MATH 20C,B01,188404,Harel; Guershon,3,0,30,27
1683294854443,MATH 20C,B02,188405,Harel; Guershon,19,0,30,11
1683294855473,MATH 20D,A01,188414,Hammock; Frances H,0,1,30,30
1683294855473,MATH 20D,A02,188415,Hammock; Frances H,4,0,30,26
1683294855473,MATH 20D,B01,188447,Hammock; Frances H,2,0,30,28
1683294855473,MATH 20D,B02,188486,Hammock; Frances H,8,0,30,22
1683294856500,MATH 20E,A01,188649,Staff,22,0,30,8
1683294856500,MATH 20E,A02,188650,Staff,23,0,30,7
1683294856500,MATH 20E,A03,188673,Staff,0,0,30,30
1683294857525,MATH 102,A01,188675,Staff,0,35,35,35
1683294858550,MATH 103B,A01,188681,Staff,4,0,35,31
1683294858550,MATH 103B,B01,188692,Staff,7,0,35,28
1683294859575,MATH 109,A01,188695,Salehi Golsefidy; Alireza,25,0,35,10
1683294859575,MATH 109,A02,188696,Salehi Golsefidy; Alireza,27,0,35,8
1683294860601,MATH 120A,A01,188698,Eggers; John Dietrich,5,0,35,30
1683294861627,MATH 142B,A01,188736,Ioana; Adrian,0,2,30,30
1683294861627,MATH 142B,A02,188741,Ioana; Adrian,0,1,30,30
1683294861627,MATH 142B,A03,188743,Ioana; Adrian,0,3,30,30
1683294862655,MATH 168A,A01,188790,Staff,0,8,35,35
1683294863683,MATH 170A,A01,188803,Nie; Jiawang,0,2,35,35
1683294863683,MATH 170A,A02,188811,Nie; Jiawang,0,0,35,35
1683294863683,MATH 170A,A03,188814,Nie; Jiawang,1,0,35,34
1683294863683,MATH 170A,A04,188815,Nie; Jiawang,14,0,35,21
1683294864709,MATH 193B,A01,188817,Staff,0,0,35,35
1683294864709,MATH 193B,A02,188818,Staff,5,0,35,30
1683294865734,MGT 4,A01,202857,Anderson; John Charles,62,0,80,18
1683294866758,MGT 12,A00,202858,Lindenberger; Wade Douglas,43,0,90,47
1683294867783,MGT 18,A00,202859,Staff,74,0,90,16
1683294868808,MGT 18GS,A00,202860,McKay; Michael J,13,0,28,15
1683294869833,MGT 45,A00,202861,Pecore; Joseph P.,14,0,90,76
1683294870860,MGT 100,A00,202863,Yavorsky; Daniel Ryan,28,0,90,62
1683294871884,MGT 103,A00,202864,Ehrich; Kristine R,0,16,90,90
1683294872909,MGT 112,A00,202865,Ehrich; Kristine R,15,0,90,75
1683294873933,MGT 121A,A00,202868,Staff,0,19,0,0
1683294874958,MGT 131B,A00,202869,Anderson; John Charles,59,0,90,31
1683294875986,MGT 136,A00,202871,Lindenberger; Wade Douglas,84,0,90,6
1683294877014,MGT 164,A00,202873,Staff,0,69,90,90
1683294878041,MGT 164GS,A00,202874,McKay; Mary A,13,0,28,15
1683294879068,MGT 180,A00,202875,Staff,0,51,90,90
1683294880091,MMW 11R,A01,205019,Herbst; Matthew,3,0,30,27
1683294880091,MMW 11R,A02,205026,Herbst; Matthew,29,0,30,1
1683294881121,MMW 15,A01,193512,Chang; Edmond Yi-Teh,0,9,28,28
1683294881121,MMW 15,A02,193513,Chang; Edmond Yi-Teh,0,5,28,28
1683294881121,MMW 15,A03,193514,Chang; Edmond Yi-Teh,0,5,28,28
1683294881121,MMW 15,A04,193515,Chang; Edmond Yi-Teh,0,4,28,28
1683294881121,MMW 15,A05,193516,Chang; Edmond Yi-Teh,0,4,28,28
1683294881121,MMW 15,A06,193517,Chang; Edmond Yi-Teh,0,5,28,28
1683294881121,MMW 15,B01,193519,Chang; Edmond Yi-Teh,0,4,28,28
1683294881121,MMW 15,B02,193520,Chang; Edmond Yi-Teh,0,5,28,28
1683294881121,MMW 15,B03,193521,Chang; Edmond Yi-Teh,0,4,28,28
1683294881121,MMW 15,B04,193522,Chang; Edmond Yi-Teh,0,4,28,28
1683294881121,MMW 15,B05,193523,Chang; Edmond Yi-Teh,0,5,28,28
1683294881121,MMW 15,B06,193524,Chang; Edmond Yi-Teh,0,4,28,28
1683294882150,MMW 122,A01,193526,Rahimi; Babak,0,14,28,28
1683294882150,MMW 122,A02,193527,Rahimi; Babak,0,14,28,28
1683294882150,MMW 122,A03,193528,Rahimi; Babak,0,0,0,0
1683294882150,MMW 122,A04,193529,Rahimi; Babak,0,0,0,0
1683294883176,MUS 1A,A01,186663,Staff,0,20,35,35
1683294884205,MUS 4,A01,186715,Staff,0,12,35,35
1683294885230,MUS 5R,A01,186796,Dubnov; Shlomo,0,16,35,35
1683294886259,MUS 6,A01,186798,Staff,0,3,25,25
1683294887287,MUS 7,A01,186830,Staff,12,0,35,23
1683294888370,MUS 8,A01,186930,Staff,0,25,35,35
1683294889398,MUS 15,A01,186932,Staff,0,15,35,35
1683294889398,MUS 15,B01,186934,Staff,0,14,35,35
1683294890427,MUS 80,A00,186935,Staff,2,0,20,18
1683294890427,MUS 80,B00,186936,Staff,25,0,25,0
1683294891451,NANO 11,A00,204702,Lipomi; Darren John,0,0,0,0
1683294892476,NANO 15,A01,204709,Yang; Kesong,0,1,0,0
1683294893501,NANO 114,A00,202069,Jahed Motlagh; Zeinab,3,0,10,7
1683294894527,PHIL 1,A00,186955,Grush; Rick Scott,32,0,40,8
1683294895555,PHIL 10,A01,186973,Grush; Rick Scott,29,0,35,6
1683294895555,PHIL 10,A02,186974,Grush; Rick Scott,33,0,35,2
1683294896583,PHIL 13,A01,186976,Staff,7,0,35,28
1683294896583,PHIL 13,A02,186977,Staff,16,0,35,19
1683294897610,PHIL 14,A01,186979,Staff,31,0,35,4
1683294897610,PHIL 14,A02,186986,Staff,32,0,35,3
1683294898639,PHIL 28,A01,186988,Staff,16,0,30,14
1683294898639,PHIL 28,A02,186989,Staff,1,0,30,29
1683294898639,PHIL 28,A03,186990,Staff,9,0,30,21
1683294898639,PHIL 28,A04,186991,Staff,26,0,30,4
1683294899667,PHIL 120,A00,186997,Staff,23,0,40,17
1683294900695,PHIL 137,A00,187003,Staff,9,0,40,31
1683294901719,PHIL 150,A00,187015,Staff,47,0,70,23
1683294902750,PHIL 167,A00,187021,Lamey; Andy M.,35,0,40,5
1683294903775,PHIL 174,A01,202226,Staff,17,0,20,3
1683294903775,PHIL 174,A02,202235,Staff,20,0,20,0
1683294904799,PHIL 191A,A00,258918,Staff,0,0,1,1
1683294905823,PHYS 1A,A00,187028,Staff,26,0,60,34
1683294906848,PHYS 1AL,001,187036,Staff,2,0,30,28
1683294906848,PHYS 1AL,002,187049,Staff,18,0,30,12
1683294907872,PHYS 1B,A00,187058,Staff,23,0,60,37
1683294908899,PHYS 1BL,001,187064,Staff,0,0,30,30
1683294908899,PHYS 1BL,002,187070,Staff,6,0,30,24
1683294909923,PHYS 1C,A00,187082,Staff,32,0,120,88
1683294910951,PHYS 1CL,001,187088,Staff,0,9,30,30
1683294910951,PHYS 1CL,002,187089,Staff,0,2,30,30
1683294910951,PHYS 1CL,009,262693,Staff,12,0,30,18
1683294911977,PHYS 2B,A01,187097,Staff,54,0,115,61
1683294913003,PHYS 2C,A01,187099,Staff,67,0,115,48
1683294914032,PHYS 2CL,A01,187101,Staff,5,0,28,23
1683294914032,PHYS 2CL,A02,187102,Staff,15,0,28,13
1683294915059,PHYS 2D,A01,187123,Shotwell; Brian,95,0,115,20
1683294916083,PHYS 4B,A01,187133,Grinstein; Benjamin,35,0,50,15
1683294917110,POLI 10,A00,188819,Staff,0,3,50,50
1683294918137,POLI 11,A00,188827,Staff,43,0,50,7
1683294919162,POLI 13R,A00,188828,Staff,0,1,20,20
1683294920190,POLI 27,A01,188830,Elgin; Samuel Zincke,0,1,70,70
1683294921214,POLI 30,A00,188832,Desposato; Scott,33,0,50,17
1683294922239,POLI 102F,A00,188834,Staff,3,0,40,37
1683294923264,POLI 104A,A00,188852,Staff,14,0,30,16
1683294924290,POLI 104I,A00,188853,Staff,0,6,20,20
1683294925316,POLI 110B,A00,188854,Wiens; David,7,0,20,13
1683294926341,POLI 112A,A00,188855,Wiens; David,5,0,30,25
1683294927366,POLI 117R,A00,188856,Forman; Fonna,0,11,20,20
1683294928394,POLI 118,A00,188857,Ingham; Sean,8,0,20,12
1683294929421,POLI 120G,A00,188858,Staff,9,0,30,21
1683294930448,POLI 131CR,A00,188863,Hoston; Germaine,24,0,50,26
1683294931473,POLI 133,A00,188864,Nellis; Gareth Hb,44,0,50,6
1683294932496,POLI 134D,A00,188865,Desposato; Scott,27,0,30,3
1683294933521,POLI 142A,A00,188871,Gartzke; Erik,22,0,50,28
1683294934545,POLI 142K,A00,188874,Staff,38,0,50,12
1683294935568,POLI 143,A00,188940,Gartzke; Erik,16,0,30,14
1683294936593,POLI 153,A00,188943,Staff,3,0,20,17
1683294937618,POLI 160AA,A00,188944,Staff,13,0,40,27
1683294938642,POLI 170A,A00,188945,Staff,11,0,30,19
1683294940698,PSYC 1,A00,188952,Staff,38,0,90,52
1683294941725,PSYC 2,B00,188953,Staff,20,0,35,15
1683294942750,PSYC 6,A00,188970,Staff,47,0,60,13
1683294943778,PSYC 7,A00,188973,Staff,37,0,45,8
1683294944802,PSYC 60,A01,188980,Rickard; Timothy C.,43,0,60,17
1683294945828,PSYC 70,A01,189001,Steiner; Eric Tomas,24,0,45,21
1683294946853,PSYC 100,A00,189005,Lacefield; Katharine I,0,99,120,120
1683294947884,PSYC 102,A00,189008,Staff,10,0,30,20
1683294948911,PSYC 106,B00,189026,Gorman; Michael R.,37,0,60,23
1683294949939,PSYC 114,B01,189033,Winkielman; Piotr,0,32,30,30
1683294950966,PSYC 131,A00,189036,Anagnostaras; Stephan,0,43,60,60
1683294951990,PSYC 136,A00,189041,Lowe; Angela Beth,0,7,25,25
1683294953015,PSYC 137,A00,189057,Winkielman; Piotr,0,34,25,25
1683294954039,PSYC 144,A00,189107,Wixted; John T,0,7,50,50
1683294956087,PSYC 162,A00,189142,Staff,0,8,85,85
1683294957113,PSYC 172,A00,189144,Gorman; Michael R.,0,7,30,30
1683294959167,PSYC 179,A00,189146,Lacefield; Katharine I,0,84,120,120
1683294960190,PSYC 181,A00,189147,Anagnostaras; Stephan,0,44,90,90
1683294961214,PSYC 190R,A00,189148,Barner; David A.,0,22,80,80
1683294962239,PSYC 191,A00,189275,Rickard; Timothy C.,0,7,25,25
1683294963266,PSYC 193,A00,189276,Chapman; Eddie Nathaniel,0,1,0,4
1683294964292,PSYC 193L,A01,189281,Lowe; Angela Beth,12,0,20,8
1683294964292,PSYC 193L,B01,189285,Staff,28,0,35,7
1683294965315,RELI 149,A00,187137,Rahimi; Babak,7,0,40,33
1683294966341,SE 9,A01,187315,Staff,0,2,18,18
1683294967366,SE 101B,A00,187409,Staff,24,0,30,6
1683294968390,SE 110B,A00,187444,Staff,10,0,40,30
1683294969416,SE 130B,A00,187449,Staff,31,0,40,9
1683294970442,SE 150A,A00,187516,Staff,9,0,20,11
1683294971472,SE 154,A00,187528,Staff,30,0,50,20
1683294972500,SIO 3,A01,258171,Staff,35,0,40,5
1683294973525,SIO 10,A00,187144,Cook; Geoffrey W,0,3,75,75
1683294974551,SIO 45,A00,187152,Cook; Geoffrey W,1,0,100,99
1683294975576,SIO 109R,A00,194486,Staff,0,3,20,20
1683294977625,SIO 187,A01,187233,Kacev; David,12,0,40,28
1683294978651,SOCI 1,A01,258656,Thorpe; Charles Robert,28,0,30,2
1683294978651,SOCI 1,A02,258658,Thorpe; Charles Robert,30,0,30,0
1683294978651,SOCI 1,A03,258661,Thorpe; Charles Robert,25,0,25,0
1683294978651,SOCI 1,A04,258666,Thorpe; Charles Robert,22,0,25,3
1683294978651,SOCI 1,A05,258897,Thorpe; Charles Robert,23,0,25,2
1683294978651,SOCI 1,A06,258898,Thorpe; Charles Robert,25,0,25,0
1683294979676,SOCI 30,A01,258903,Pardo Guerra; Juan Pablo,16,0,30,14
1683294980701,SOCI 102,A00,258904,Staff,9,0,25,16
1683294981727,SOCI 106,A00,258905,Staff,19,0,25,6
1683294982753,SOCI 111,A00,258907,Ribas Norris; Janet Vanesa,26,0,30,4
1683294983778,SOCI 121R,A00,258908,Pardo Guerra; Juan Pablo,11,0,30,19
1683294984806,SOCI 126,A01,203330,Staff,14,0,20,6
1683294985834,SOCI 131,A00,258909,Thorpe; Charles Robert,31,0,60,29
1683294986862,SOCI 135,A00,258910,Payne; Christine Anna,0,9,30,30
1683294987889,SOCI 157,A00,258911,Staff,13,0,30,17
1683294988914,SOCI 184,A00,258912,Staff,26,0,30,4
1683294989937,SOCI 188D,A00,258913,Staff,21,0,30,9
1683294990966,SYN 2,001,187529,Staff,9,0,16,7
1683294990966,SYN 2,002,201452,Staff,0,18,16,16
1683294990966,SYN 2,003,201469,Staff,3,0,16,13
1683294992052,SYN 100,A01,187531,Staff,0,9,20,20
1683294992052,SYN 100,B01,201491,Staff,0,12,20,20
1683294993082,TDAC 1,A00,189286,Walsh; Kim C.,3,0,20,17
1683294993082,TDAC 1,B00,189287,Harting; Carla Kelso,11,0,20,9
1683294994108,TDAC 101,A00,189300,Walsh; Kim C.,16,0,20,4
1683294994108,TDAC 101,B00,189301,Harting; Carla Kelso,18,0,20,2
1683294995136,TDAC 102,A00,189304,Basso; Beatrice,14,0,20,6
1683294996163,TDAC 108,A00,189305,Staff,18,0,20,2
1683294997189,TDDE 131,A00,189310,Staff,19,0,20,1
1683294997189,TDDE 131,B00,189314,Staff,19,0,20,1
1683294997189,TDDE 131,C00,189315,Staff,48,0,50,2
1683294997189,TDDE 131,D00,189316,Staff,14,0,15,1
1683294997189,TDDE 131,E00,204841,Staff,20,0,20,0
1683294998214,TDGE 10,A00,189289,Staff,30,0,50,20
1683294998214,TDGE 10,B00,189290,Havis; Allan,2,0,50,48
1683294999239,TDGE 11,A00,189291,Fulton; Julia,0,3,50,50
1683294999239,TDGE 11,B00,189292,Staff,20,0,25,5
1683294999239,TDGE 11,C00,260270,Staff,0,0,0,0
1683295000263,TDGE 25,A00,189294,Staff,3,0,20,17
1683295001287,TDGE 124,A00,189318,Fulton; Julia,0,8,50,50
1683295002311,TDGE 125,A00,189319,Staff,13,0,25,12
1683295002311,TDGE 125,B00,189320,Staff,23,0,25,2
1683295003337,TDGE 127,A00,189322,Havis; Allan,0,0,50,50
1683295004362,TDHT 101,A00,189323,Staff,18,0,25,7
1683295004362,TDHT 101,B00,189324,Staff,25,0,25,0
1683295005389,TDHT 102,A00,189325,Staff,49,0,50,1
1683295006415,TDMV 1,A00,189295,Arcidiacono; Kristin,20,0,30,10
1683295006415,TDMV 1,B00,189296,Caligagan; Maria T.,24,0,30,6
1683295007444,TDMV 2,A00,189297,Sammartano; Tonnie,28,0,30,2
1683295007444,TDMV 2,B00,189299,Arcidiacono; Kristin,24,0,30,6
1683295008469,TDMV 3,A00,204998,Rincon; Alicia,22,0,30,8
1683295009494,TDMV 120,A00,189458,Sammartano; Tonnie,28,0,30,2
1683295010519,TDMV 138,A00,189541,Jun; Grace Shin Hae,22,0,40,18
1683295011544,TDMV 142,A00,189717,Caligagan; Tony,23,0,30,7
1683295011544,TDMV 142,B00,189718,Caligagan; Maria T.,25,0,30,5
1683295012570,TMC 2,A01,187533,Staff,25,0,25,0
1683295012570,TMC 2,A02,187534,Staff,25,0,25,0
1683295013598,USP 1,A01,187536,Kwak; Nancy,0,16,25,25
1683295014626,USP 5,A01,187538,Staff,9,0,25,16
1683295015654,USP 101,A00,199253,Staff,0,4,0,0
1683295016682,USP 124,A00,187562,Boomhower; Matthew Charles,1,0,30,29
1683295017707,USP 138,A00,187582,Staff,20,0,25,5
1683295018734,USP 152,A01,187597,Staff,4,0,25,21
1683295019761,USP 153,A00,187598,Staff,19,0,25,6
1683295020786,USP 168,A00,187607,Kwak; Nancy,2,0,5,3
1683295021811,USP 173,A00,187619,Staff,4,0,25,21
1683295022836,USP 181,A00,187638,Staff,0,0,25,25
1683295023864,VIS 103,A00,187650,Cruz; Edwin Teddy,23,0,75,52
1683295024889,VIS 110D,A00,187669,Staff,12,0,22,10
1683295025912,VIS 127C,A00,187720,Shen; Kuiyi,68,0,146,78
1683295026941,VIS 149,A00,187731,Yoldas; Pinar,0,14,22,22
1683295027969,VIS 151,A01,188091,Staff,22,0,34,12
1683295027969,VIS 151,A02,188092,Staff,11,0,34,23
1683295028996,VIS 160B,A00,188093,Stalbaum; Brett,0,0,10,10
1683295031051,WCWP 10B,A00,201720,Staff,10,0,15,5
1683295031051,WCWP 10B,B00,201722,Staff,8,0,15,7
1683295032080,WCWP 100,A00,201725,Gagnon; Jeffrey C,0,0,2,2
1683295032080,WCWP 100,B00,201727,Staff,0,4,15,15
1683295035191,ANBI 133,A00,258401,Wilder; Linnea Lorene,34,0,40,6
1683295036216,ANBI 140,A00,258395,Hrvoj Mihic; Branka,18,0,25,7
1683295037245,ANSC 120,A00,258402,Bialecki; Jon Anthony,27,0,40,13
1683295038273,ANSC 144,A00,258400,Staff,14,0,40,26
1683295040326,ANSC 166,A00,258396,Parish; Steven Martin,157,0,175,18
1683295041351,ANSC 180,A00,193533,Staff,9,0,20,11
1683295042375,ANSC 188,A00,258397,Jassal; Aftab,33,0,40,7
1683295043401,ANTH 3,A01,258316,Staff,23,0,30,7
1683295044426,ANTH 5,A00,258394,Semendeferi; Ekaterini,16,0,20,4
1683295045451,ANTH 21,A01,258331,Staff,9,0,40,31
1683295046477,ANTH 103,A00,258398,Varma; Saiba,15,0,25,10
1683295047503,AWP 10,001,202034,Staff,0,0,0,0
1683295047503,AWP 10,002,202035,Staff,0,0,0,0
1683295047503,AWP 10,003,202036,Staff,0,0,0,0
1683295047503,AWP 10,004,202037,Staff,0,0,0,0
1683295047503,AWP 10,005,202038,Staff,0,0,0,0
1683295047503,AWP 10,006,202039,Staff,0,0,0,0
1683295047503,AWP 10,007,202040,Staff,0,0,0,0
1683295047503,AWP 10,008,202041,Staff,0,0,0,0
1683295047503,AWP 10,009,202042,Staff,0,0,0,0
1683295047503,AWP 10,010,202043,Staff,0,0,0,0
1683295047503,AWP 10,011,202044,Staff,0,0,0,0
1683295047503,AWP 10,012,202045,Staff,0,0,0,0
1683295047503,AWP 10,013,202046,Staff,0,0,0,0
1683295047503,AWP 10,014,202047,Staff,0,0,0,0
1683295047503,AWP 10,015,202048,Staff,0,0,0,0
1683295047503,AWP 10,016,202049,Staff,0,0,0,0
1683295047503,AWP 10,017,202050,Staff,0,0,0,0
1683295047503,AWP 10,018,202051,Staff,0,0,0,0
1683295047503,AWP 10,019,202052,Staff,0,0,0,0
1683295047503,AWP 10,020,202053,Staff,0,0,0,0
1683295047503,AWP 10,021,202054,Staff,0,0,0,0
1683295047503,AWP 10,022,202055,Staff,0,0,0,0
1683295047503,AWP 10,023,202056,Staff,0,0,0,0
1683295047503,AWP 10,024,202057,Staff,0,0,0,0
1683295047503,AWP 10,025,202058,Staff,0,0,0,0
1683295047503,AWP 10,026,202059,Staff,0,0,0,0
1683295048528,AWP 102,001,202032,Staff,0,0,0,0
1683295048528,AWP 102,002,202033,Staff,0,0,0,0
1683295049553,BENG 100,A01,254234,Taylor Amos; Alyssa C,31,0,40,9
1683295050579,BENG 196,001,270013,Engler; Adam J.,9999,0,9999,0
1683295051608,BICD 100R,A01,202018,Smith; Laurie,0,7,32,32
1683295051608,BICD 100R,A02,202019,Smith; Laurie,0,2,32,32
1683295051608,BICD 100R,A03,202020,Smith; Laurie,0,1,32,32
1683295051608,BICD 100R,A04,202021,Smith; Laurie,8,0,32,24
1683295051608,BICD 100R,A05,202022,Smith; Laurie,12,0,32,20
1683295052638,BICD 136,A01,193242,Gustafson-Brown; Cindy,0,2,32,32
1683295052638,BICD 136,A02,193244,Gustafson-Brown; Cindy,15,0,32,17
1683295053664,BIEB 102,A01,193249,Butler; Shannon Rhey,0,2,32,32
1683295053664,BIEB 102,A02,193251,Butler; Shannon Rhey,0,0,32,32
1683295053664,BIEB 102,A03,193253,Butler; Shannon Rhey,0,1,32,32
1683295053664,BIEB 102,A04,193255,Butler; Shannon Rhey,17,0,32,15
1683295053664,BIEB 102,A05,193265,Butler; Shannon Rhey,26,0,32,6
1683295053664,BIEB 102,A06,193269,Butler; Shannon Rhey,16,0,32,16
1683295055713,BIEB 150,A01,193274,Staff,0,0,32,32
1683295055713,BIEB 150,A02,193285,Staff,24,0,32,8
1683295056737,BIEB 194,A00,193286,Kurle; Carolyn M.,22,0,32,10
1683295057763,BILD 1,A01,192291,Staff,16,0,32,16
1683295057763,BILD 1,A02,192292,Staff,30,0,32,2
1683295057763,BILD 1,B01,192520,Reuther; Keefe,0,1,0,0
1683295057763,BILD 1,B02,192532,Reuther; Keefe,0,1,0,0
1683295058789,BILD 3,A01,192556,Butler; Shannon Rhey,0,0,32,32
1683295058789,BILD 3,A02,192581,Butler; Shannon Rhey,5,0,32,27
1683295058789,BILD 3,A03,192611,Butler; Shannon Rhey,23,0,32,9
1683295058789,BILD 3,A04,192612,Butler; Shannon Rhey,25,0,32,7
1683295058789,BILD 3,A05,192613,Butler; Shannon Rhey,27,0,32,5
1683295058789,BILD 3,A06,192679,Butler; Shannon Rhey,27,0,32,5
1683295058789,BILD 3,A07,192682,Butler; Shannon Rhey,22,0,32,10
1683295059820,BILD 4,A01,192836,Reuther; Keefe,1,0,24,23
1683295059820,BILD 4,A02,193044,Reuther; Keefe,4,0,24,20
1683295060846,BILD 10,A01,193142,Gustafson-Brown; Cindy,31,0,32,1
1683295060846,BILD 10,A02,193149,Gustafson-Brown; Cindy,31,0,32,1
1683295061873,BIMM 100,A01,193301,Staff,0,6,32,32
1683295061873,BIMM 100,A02,193312,Staff,0,5,32,32
1683295061873,BIMM 100,A03,193323,Staff,0,8,32,32
1683295062897,BIMM 101,A01,193329,McDonnell; Lisa Marie,0,3,24,24
1683295062897,BIMM 101,A02,193339,McDonnell; Lisa Marie,0,2,24,24
1683295062897,BIMM 101,B01,193354,McDonnell; Lisa Marie,0,3,24,24
1683295062897,BIMM 101,B02,193357,McDonnell; Lisa Marie,0,3,24,24
1683295063922,BIMM 110,A01,193377,Tat; John,0,11,32,32
1683295063922,BIMM 110,A02,193378,Tat; John,1,9,32,31
1683295064953,BIMM 120,A01,206116,Staff,0,0,32,32
1683295064953,BIMM 120,A02,206117,Staff,8,0,32,24
1683295064953,BIMM 120,A03,206121,Staff,21,0,32,11
1683295065981,BIPN 100,A01,193393,Park; Ji Young,0,14,32,32
1683295065981,BIPN 100,A02,193402,Park; Ji Young,0,12,32,32
1683295065981,BIPN 100,A03,193413,Park; Ji Young,0,14,32,32
1683295065981,BIPN 100,A04,193414,Park; Ji Young,0,13,32,32
1683295067010,BIPN 102,A01,193429,Staff,0,0,32,32
1683295067010,BIPN 102,A02,193438,Staff,23,0,32,9
1683295068035,BIPN 106,A01,193450,Reyes Gonzalez; Catalina,0,2,40,40
1683295069065,BIPN 134,A01,193465,Cooke; James Edward,0,0,32,32
1683295069065,BIPN 134,A02,193474,Cooke; James Edward,27,0,32,5
1683295069065,BIPN 134,A03,193485,Cooke; James Edward,29,0,32,3
1683295069065,BIPN 134,A04,193486,Cooke; James Edward,21,0,32,11
1683295069065,BIPN 134,A05,193491,Cooke; James Edward,31,0,32,1
1683295069065,BIPN 134,A06,193501,Cooke; James Edward,30,0,32,2
1683295069065,BIPN 134,A07,193510,Cooke; James Edward,29,0,32,3
1683295071121,BISP 194,A00,222522,Staff,16,0,32,16
1683295072149,CAT 124,A01,202407,Staff,20,0,25,5
1683295073174,CAT 125,A00,202408,Marchisotto; Jennifer Anne,4,0,20,16
1683295074199,CAT 125R,A00,202409,Smith; Lauryn Alissa,0,11,20,20
1683295074199,CAT 125R,B00,202410,Morales; Celeste Georgianna,0,11,20,20
1683295074199,CAT 125R,C00,202411,Irwin; Matthew Joseph,0,10,20,20
1683295075221,CENG 15,A01,204712,Yang; Kesong,0,1,0,0
1683295076247,CENG 114,A00,202070,Jahed Motlagh; Zeinab,5,0,20,15
1683295077271,CGS 105,A00,185477,Wesling; Megan E.,24,0,40,16
1683295078297,CGS 106,A00,185494,Staff,13,0,22,9
1683295079324,CGS 108,A00,185495,Staff,14,0,20,6
1683295080351,CGS 114,A00,185496,Staff,13,0,18,5
1683295081378,CGS 119,A00,185501,Staff,15,0,20,5
1683295082403,CGS 120,A00,185511,Staff,13,0,20,7
1683295083431,CHEM 4,A01,184675,Bussey; Thomas J,96,0,100,4
1683295084459,CHEM 6A,A01,184677,Staff,35,0,60,25
1683295085488,CHEM 6B,A01,184679,Staff,65,0,100,35
1683295086512,CHEM 6C,A01,184681,Bussey; Thomas J,1,0,50,49
1683295086512,CHEM 6C,A02,184682,Bussey; Thomas J,34,0,50,16
1683295087541,CHEM 40A,A01,184684,Albizati; Kim F.,37,0,100,63
1683295088571,CHEM 40B,A01,184686,Albizati; Kim F.,0,20,100,100
1683295089596,CHEM 41B,A01,184690,Staff,52,0,100,48
1683295090622,COGS 3,A01,184715,Boyle; Mary E. T.,0,25,40,40
1683295091646,COGS 14B,A01,185172,Staff,0,15,38,38
1683295092671,COGS 18,A01,184736,Staff,20,0,80,60
1683295093697,COGS 100,A01,184932,Staff,0,5,73,73
1683295094726,COGS 101A,A01,184935,Staff,0,38,30,30
1683295095808,COGS 101B,A01,184944,Staff,0,2,30,30
1683295096836,COGS 101C,A01,184946,Staff,0,12,30,30
1683295097868,COGS 102A,A01,184951,Johnson; Christine M.,2,0,40,38
1683295098898,COGS 107B,A01,184953,Mooshagian; Eric Frederick,0,50,40,40
1683295099928,COGS 118B,A01,184959,Gupta; Anjum,0,48,40,40
1683295100958,COGS 153,A00,184961,Staff,0,15,30,30
1683295101984,COGS 177,A00,184962,Staff,0,21,30,30
1683295103009,COGS 187A,A01,184969,Boyle; Mary E. T.,0,17,40,40
1683295104035,COMM 10,A01,185174,Staff,0,5,25,25
1683295104035,COMM 10,A02,185189,Staff,0,5,25,25
1683295104035,COMM 10,A03,269821,Staff,0,0,0,0
1683295105061,COMM 100B,A01,185475,Staff,0,0,0,2
1683295105061,COMM 100B,A02,185476,Staff,14,0,25,11
1683295106085,COMM 100C,A01,185314,Staff,1,0,25,24
1683295106085,COMM 100C,A02,185327,Staff,19,0,25,6
1683295107117,COMM 110M,A00,185349,Staff,2,0,40,38
1683295108141,COMM 113T,A00,185352,Staff,25,0,40,15
1683295109166,COMM 114I,A00,185353,Staff,33,0,40,7
1683295110193,COMM 131,A00,185354,Staff,19,0,30,11
1683295111217,CSE 8A,A50,185358,Cao; Yingjun,0,46,10,10
1683295112242,CSE 8B,A01,185362,Staff,0,47,50,50
1683295113267,CSE 11,A01,185416,Cao; Yingjun,0,93,10,10
1683295114292,CSE 20,A01,185445,Briones; Jor-el Thomas Caparas,5,0,25,20
1683295115318,CSE 21,A01,185447,Staff,10,0,50,40
1683295116344,CSE 101,A01,185451,Staff,0,12,50,50
1683295116344,CSE 101,B01,185453,Jones; Miles E,0,11,50,50
1683295118396,CSE 141,A01,185458,Eldon; John,20,0,100,80
1683295119423,CSE 141L,A01,185461,Eldon; John,12,0,100,88
1683295120448,CSE 142,A01,185463,Staff,35,0,60,25
1683295120448,CSE 142,B01,201355,Staff,0,6,60,60
1683295121473,CSE 142L,A01,185470,Staff,35,0,60,25
1683295121473,CSE 142L,B01,201417,Staff,0,5,60,60
1683295122506,CSE 190,A00,201433,Staff,32,0,49,17
1683295123533,DOC 1,A01,259136,Strom; Megan C.,8,0,15,7
1683295123533,DOC 1,A02,259137,Strom; Megan C.,14,0,15,1
1683295123533,DOC 1,A03,259138,Strom; Megan C.,14,0,15,1
1683295123533,DOC 1,A04,259139,Strom; Megan C.,14,0,15,1
1683295124562,DOC 100D,A00,259140,Pass; Natalye Joann,17,0,25,8
1683295125586,DSGN 1,A01,184749,Rill; Bryan,0,24,30,30
1683295126613,DSGN 100,A01,185168,Staff,0,2,25,25
1683295127639,ECE 5,A01,185626,Morris; Karcher William,0,10,0,0
1683295128667,ECE 101,A01,185628,Staff,17,0,70,53
1683295129695,ECE 107,A01,185635,Baghdadchi; Saharnaz,0,0,20,20
1683295129695,ECE 107,A02,185638,Baghdadchi; Saharnaz,4,0,20,16
1683295130720,ECE 148,A01,185647,Silberman; Jack,1,0,16,15
1683295131745,ECON 1,A01,185537,Crane; Meredith Helen,54,0,70,16
1683295132769,ECON 3,A01,185549,Crane; Meredith Helen,33,0,70,37
1683295133797,ECON 4,A01,203354,Anderson; John Charles,0,4,10,10
1683295134824,ECON 100A,A01,185574,Staff,0,4,40,40
1683295135852,ECON 100B,A01,185576,Staff,0,22,40,40
1683295136877,ECON 100C,A01,185589,Newhouse; Herbert S,30,0,70,40
1683295137902,ECON 105,A00,185608,Vespa; Emanuel Ignacio,19,0,35,16
1683295138930,ECON 109,A01,185610,Shishkin; Denis,10,0,35,25
1683295139956,ECON 110A,A01,185612,Staff,11,0,40,29
1683295140980,ECON 120A,A01,185615,Staff,20,0,40,20
1683295142004,ECON 120C,A01,185617,Sun; Yixiao,0,20,70,70
1683295143032,ECON 144,A00,203346,Squires; Dale E,3,0,35,32
1683295144057,ECON 171,A01,203349,Newhouse; Herbert S,0,1,35,35
1683295145084,ECON 173A,A01,185621,Toda; Alexis Akira,21,0,35,14
1683295146114,EDS 25,A01,202413,Staff,0,1,0,0
1683295146114,EDS 25,A02,202414,Staff,0,1,0,0
1683295146114,EDS 25,A03,202415,Staff,0,0,0,0
1683295146114,EDS 25,A04,202416,Staff,0,1,0,0
1683295146114,EDS 25,A05,202439,Staff,0,0,0,0
1683295146114,EDS 25,A06,202440,Staff,0,0,0,0
1683295146114,EDS 25,B01,202631,Staff,0,0,0,0
1683295146114,EDS 25,B02,202632,Staff,0,0,0,0
1683295146114,EDS 25,B03,202639,Staff,0,0,0,0
1683295146114,EDS 25,B04,202640,Staff,0,0,0,0
1683295146114,EDS 25,B05,202643,Staff,0,0,0,0
1683295146114,EDS 25,B06,202644,Staff,0,0,0,0
1683295147187,EDS 38,A01,202659,Black; Alison Michelle,24,0,25,1
1683295148214,EDS 115,A00,202652,Staff,17,0,30,13
1683295149241,EDS 125,A00,202649,Staff,14,0,30,16
1683295150263,EDS 126,A01,203332,Staff,30,0,30,0
1683295151287,EDS 139,A00,202838,Staff,17,0,25,8
1683295152315,EDS 146,A01,202655,Staff,15,0,25,10
1683295153340,ENG 15,A00,185667,Staff,0,1,0,0
1683295153340,ENG 15,B00,185672,Staff,0,0,0,0
1683295153340,ENG 15,C00,185675,Staff,0,0,0,0
1683295153340,ENG 15,D00,185682,Staff,0,0,0,0
1683295153340,ENG 15,E00,185684,Staff,0,0,0,0
1683295154365,ETHN 103,A00,185710,Staff,0,3,35,35
1683295155389,ETHN 103A,A00,199228,Man; Simeon S,3,0,9,6
1683295156420,ETHN 109,A00,185711,Staff,18,0,35,17
1683295157450,ETHN 142,A00,185726,Staff,0,4,30,30
1683295158479,ETHN 163J,A00,199229,Man; Simeon S,6,0,8,2
1683295159505,ETHN 168,A00,185727,Staff,8,0,10,2
1683295160532,ETHN 182,A00,185728,Staff,1,0,35,34
1683295161556,ETHN 183,A00,185737,Staff,8,0,18,10
1683295162579,GLBH 111,A01,209361,Burgos; Jose L.,0,0,0,0
1683295164630,HIEU 104,A00,185792,Staff,16,0,20,4
1683295165654,HIEU 115,A00,185800,Staff,1,0,20,19
1683295166679,HIEU 128,A00,185801,Staff,0,7,20,20
1683295167706,HIEU 147,A00,185802,Staff,16,0,20,4
1683295168733,HIEU 154,A00,185823,Staff,12,0,20,8
1683295169760,HILA 102,A00,185826,Staff,13,0,20,7
1683295170785,HILD 2C,A01,185778,Staff,0,12,20,20
1683295171810,HILD 7B,A01,185780,Kwak; Nancy,0,15,32,32
1683295171810,HILD 7B,A02,185781,Kwak; Nancy,0,18,32,32
1683295172838,HILD 30,A01,185791,Staff,14,0,20,6
1683295173866,HISC 119,A00,185830,Golan; Tal,0,9,20,20
1683295174890,HITO 156GS,A00,185831,Patterson; Patrick H.,0,0,0,23
1683295175916,HIUS 103,A00,185832,Man; Simeon S,0,7,20,20
1683295176943,HIUS 117,A00,185836,Kwak; Nancy,2,0,20,18
1683295177969,HIUS 125,A00,185840,Man; Simeon S,0,0,23,23
1683295178994,HIUS 149,A00,185845,Staff,0,0,20,20
1683295180020,HUM 3,A01,185882,Zavodny; Tatiana Sophia,0,6,50,50
1683295180020,HUM 3,B01,185899,Caldwell; Michael Alan,0,19,50,50
1683295181044,HUM 3GS,A00,185900,Patterson; Patrick H.,0,0,0,23
1683295182071,HUM 4,A01,185938,Zroka; Amy Liane,31,0,50,19
1683295182071,HUM 4,B01,185956,Watkins; Eric,0,2,50,50
1683295182071,HUM 4,B02,202209,Watkins; Eric,0,1,50,50
1683295182071,HUM 4,B03,202210,Watkins; Eric,0,0,50,50
1683295183097,HUM 5,A01,185958,West; Geoffrey Scott,5,0,50,45
1683295183097,HUM 5,A02,202215,West; Geoffrey Scott,0,0,50,50
1683295184122,INTL 190,A00,185959,Gagnon; Jeffrey C,0,0,0,9
1683295184122,INTL 190,B00,185960,Lettieri; Michael Joseph,0,0,0,1
1683295185147,JAPN 180,A00,254509,Staff,0,1,25,25
1683295186172,LATI 10,A01,202853,Kennemore; Amy Michelle,5,0,35,30
1683295186172,LATI 10,A02,202854,Kennemore; Amy Michelle,1,0,35,34
1683295186172,LATI 10,A03,270054,Kennemore; Amy Michelle,30,0,30,0
1683295187197,LATI 180,A00,202855,Kennemore; Amy Michelle,11,0,20,9
1683295188223,LAWS 101,A00,201767,Golan; Tal,0,7,40,40
1683295189247,LIFR 1C,A00,185961,Staff,6,0,20,14
1683295190271,LIFR 1CX,A00,185962,Staff,7,0,20,13
1683295191297,LIFR 1D,A00,185963,Staff,9,0,20,11
1683295192324,LIFR 1DX,A00,185964,Staff,9,0,20,11
1683295193350,LIGN 101,A01,186039,Staff,43,0,50,7
1683295194377,LIGN 165,A00,186040,Staff,18,0,50,32
1683295195405,LTCS 108,A00,186041,Staff,6,0,10,4
1683295196431,LTCS 119,A00,186042,Staff,16,0,20,4
1683295197459,LTCS 130,A00,186043,Wesling; Megan E.,15,0,25,10
1683295199567,LTEA 138,A00,186119,Staff,14,0,40,26
1683295200594,LTEN 124,A00,186148,Staff,6,0,25,19
1683295201618,LTEN 178,A00,186149,Staff,7,0,15,8
1683295202645,LTEN 181,A00,186150,Blanco; John D,33,0,40,7
1683295203669,LTWL 120,A00,186160,Staff,20,0,25,5
1683295204695,LTWL 165,A00,186161,Staff,22,0,25,3
1683295205719,LTWR 100,A00,186162,Staff,0,4,15,15
1683295206749,LTWR 102,A00,186163,Doller; Ben,5,0,15,10
1683295207774,MAE 8,A01,186412,Staff,0,0,0,0
1683295208799,MAE 30B,A00,186445,Bahadori; Mohammad Yousef,83,0,100,17
1683295209823,MAE 40,A00,186592,Bewley; Thomas R,9,0,50,41
1683295210850,MAE 101B,A00,186593,Bahadori; Mohammad Yousef,81,0,100,19
1683295211876,MAE 105,A00,186594,Bandaru; Prabhakar,12,0,50,38
1683295212907,MAE 107,A00,186599,Pham; Hieu Tan,0,6,120,120
1683295213933,MAE 148,A01,186660,Silberman; Jack,3,0,16,13
1683295214961,MATH 10A,A01,188095,Staff,0,7,35,35
1683295215987,MATH 10B,A01,188097,Bowers; Adam R.,0,11,30,30
1683295215987,MATH 10B,A02,188099,Bowers; Adam R.,0,9,30,30
1683295215987,MATH 10B,B01,188104,Bowers; Adam R.,0,11,30,30
1683295215987,MATH 10B,B02,188106,Bowers; Adam R.,0,11,30,30
1683295217013,MATH 10C,A01,188111,Staff,0,18,30,30
1683295217013,MATH 10C,A02,188127,Staff,0,17,30,30
1683295217013,MATH 10C,A03,188131,Staff,0,17,30,30
1683295217013,MATH 10C,B01,188218,Staff,21,0,30,9
1683295217013,MATH 10C,B02,188244,Staff,13,0,30,17
1683295217013,MATH 10C,B03,188277,Staff,16,0,30,14
1683295218038,MATH 18,A01,188344,Bach; Quang Tran,18,0,30,12
1683295218038,MATH 18,A02,188345,Bach; Quang Tran,11,0,30,19
1683295218038,MATH 18,B01,188353,Bach; Quang Tran,10,0,30,20
1683295218038,MATH 18,B02,188354,Bach; Quang Tran,20,0,30,10
1683295219068,MATH 20A,A01,188374,Staff,13,0,35,22
1683295220099,MATH 20B,A01,188382,Ohm; Ko Woon,6,0,30,24
1683295220099,MATH 20B,A02,188383,Ohm; Ko Woon,24,0,30,6
1683295220099,MATH 20B,B01,188385,Ohm; Ko Woon,7,0,30,23
1683295220099,MATH 20B,B02,188392,Ohm; Ko Woon,22,0,30,8
1683295221124,MATH 20C,A01,188394,Harel; Guershon,10,0,30,20
1683295221124,MATH 20C,A02,188395,Harel; Guershon,13,0,30,17
1683295221124,MATH 20C,B01,188404,Harel; Guershon,3,0,30,27
1683295221124,MATH 20C,B02,188405,Harel; Guershon,19,0,30,11
1683295222157,MATH 20D,A01,188414,Hammock; Frances H,0,1,30,30
1683295222157,MATH 20D,A02,188415,Hammock; Frances H,4,0,30,26
1683295222157,MATH 20D,B01,188447,Hammock; Frances H,2,0,30,28
1683295222157,MATH 20D,B02,188486,Hammock; Frances H,8,0,30,22
1683295223183,MATH 20E,A01,188649,Staff,22,0,30,8
1683295223183,MATH 20E,A02,188650,Staff,23,0,30,7
1683295223183,MATH 20E,A03,188673,Staff,0,0,30,30
1683295224212,MATH 102,A01,188675,Staff,0,35,35,35
1683295225239,MATH 103B,A01,188681,Staff,4,0,35,31
1683295225239,MATH 103B,B01,188692,Staff,7,0,35,28
1683295226264,MATH 109,A01,188695,Salehi Golsefidy; Alireza,25,0,35,10
1683295226264,MATH 109,A02,188696,Salehi Golsefidy; Alireza,27,0,35,8
1683295227290,MATH 120A,A01,188698,Eggers; John Dietrich,5,0,35,30
1683295228314,MATH 142B,A01,188736,Ioana; Adrian,0,2,30,30
1683295228314,MATH 142B,A02,188741,Ioana; Adrian,0,1,30,30
1683295228314,MATH 142B,A03,188743,Ioana; Adrian,0,3,30,30
1683295229344,MATH 168A,A01,188790,Staff,0,8,35,35
1683295230373,MATH 170A,A01,188803,Nie; Jiawang,0,2,35,35
1683295230373,MATH 170A,A02,188811,Nie; Jiawang,0,0,35,35
1683295230373,MATH 170A,A03,188814,Nie; Jiawang,1,0,35,34
1683295230373,MATH 170A,A04,188815,Nie; Jiawang,14,0,35,21
1683295231396,MATH 193B,A01,188817,Staff,0,0,35,35
1683295231396,MATH 193B,A02,188818,Staff,5,0,35,30
1683295232428,MGT 4,A01,202857,Anderson; John Charles,62,0,80,18
1683295233454,MGT 12,A00,202858,Lindenberger; Wade Douglas,43,0,90,47
1683295234482,MGT 18,A00,202859,Staff,74,0,90,16
1683295235508,MGT 18GS,A00,202860,McKay; Michael J,13,0,28,15
1683295236533,MGT 45,A00,202861,Pecore; Joseph P.,14,0,90,76
1683295237560,MGT 100,A00,202863,Yavorsky; Daniel Ryan,28,0,90,62
1683295238584,MGT 103,A00,202864,Ehrich; Kristine R,0,16,90,90
1683295239611,MGT 112,A00,202865,Ehrich; Kristine R,15,0,90,75
1683295240638,MGT 121A,A00,202868,Staff,0,19,0,0
1683295241662,MGT 131B,A00,202869,Anderson; John Charles,59,0,90,31
1683295242687,MGT 136,A00,202871,Lindenberger; Wade Douglas,84,0,90,6
1683295243710,MGT 164,A00,202873,Staff,0,69,90,90
1683295244747,MGT 164GS,A00,202874,McKay; Mary A,13,0,28,15
1683295245771,MGT 180,A00,202875,Staff,0,51,90,90
1683295246798,MMW 11R,A01,205019,Herbst; Matthew,3,0,30,27
1683295246798,MMW 11R,A02,205026,Herbst; Matthew,29,0,30,1
1683295247830,MMW 15,A01,193512,Chang; Edmond Yi-Teh,0,9,28,28
1683295247830,MMW 15,A02,193513,Chang; Edmond Yi-Teh,0,5,28,28
1683295247830,MMW 15,A03,193514,Chang; Edmond Yi-Teh,0,5,28,28
1683295247830,MMW 15,A04,193515,Chang; Edmond Yi-Teh,0,4,28,28
1683295247830,MMW 15,A05,193516,Chang; Edmond Yi-Teh,0,4,28,28
1683295247830,MMW 15,A06,193517,Chang; Edmond Yi-Teh,0,5,28,28
1683295247830,MMW 15,B01,193519,Chang; Edmond Yi-Teh,0,4,28,28
1683295247830,MMW 15,B02,193520,Chang; Edmond Yi-Teh,0,5,28,28
1683295247830,MMW 15,B03,193521,Chang; Edmond Yi-Teh,0,4,28,28
1683295247830,MMW 15,B04,193522,Chang; Edmond Yi-Teh,0,4,28,28
1683295247830,MMW 15,B05,193523,Chang; Edmond Yi-Teh,0,5,28,28
1683295247830,MMW 15,B06,193524,Chang; Edmond Yi-Teh,0,4,28,28
1683295248855,MMW 122,A01,193526,Rahimi; Babak,0,14,28,28
1683295248855,MMW 122,A02,193527,Rahimi; Babak,0,14,28,28
1683295248855,MMW 122,A03,193528,Rahimi; Babak,0,0,0,0
1683295248855,MMW 122,A04,193529,Rahimi; Babak,0,0,0,0
1683295249879,MUS 1A,A01,186663,Staff,0,20,35,35
1683295250905,MUS 4,A01,186715,Staff,0,12,35,35
1683295251930,MUS 5R,A01,186796,Dubnov; Shlomo,0,16,35,35
1683295252957,MUS 6,A01,186798,Staff,0,3,25,25
1683295253981,MUS 7,A01,186830,Staff,12,0,35,23
1683295255007,MUS 8,A01,186930,Staff,0,25,35,35
1683295256032,MUS 15,A01,186932,Staff,0,15,35,35
1683295256032,MUS 15,B01,186934,Staff,0,14,35,35
1683295257057,MUS 80,A00,186935,Staff,2,0,20,18
1683295257057,MUS 80,B00,186936,Staff,25,0,25,0
1683295258084,NANO 11,A00,204702,Lipomi; Darren John,0,0,0,0
1683295259110,NANO 15,A01,204709,Yang; Kesong,0,1,0,0
1683295260138,NANO 114,A00,202069,Jahed Motlagh; Zeinab,3,0,10,7
1683295261162,PHIL 1,A00,186955,Grush; Rick Scott,32,0,40,8
1683295262190,PHIL 10,A01,186973,Grush; Rick Scott,29,0,35,6
1683295262190,PHIL 10,A02,186974,Grush; Rick Scott,33,0,35,2
1683295263216,PHIL 13,A01,186976,Staff,7,0,35,28
1683295263216,PHIL 13,A02,186977,Staff,16,0,35,19
1683295264254,PHIL 14,A01,186979,Staff,31,0,35,4
1683295264254,PHIL 14,A02,186986,Staff,32,0,35,3
1683295265280,PHIL 28,A01,186988,Staff,16,0,30,14
1683295265280,PHIL 28,A02,186989,Staff,1,0,30,29
1683295265280,PHIL 28,A03,186990,Staff,9,0,30,21
1683295265280,PHIL 28,A04,186991,Staff,26,0,30,4
1683295266308,PHIL 120,A00,186997,Staff,23,0,40,17
1683295267334,PHIL 137,A00,187003,Staff,9,0,40,31
1683295268358,PHIL 150,A00,187015,Staff,47,0,70,23
1683295269389,PHIL 167,A00,187021,Lamey; Andy M.,35,0,40,5
1683295270416,PHIL 174,A01,202226,Staff,17,0,20,3
1683295270416,PHIL 174,A02,202235,Staff,20,0,20,0
1683295271444,PHIL 191A,A00,258918,Staff,0,0,1,1
1683295272473,PHYS 1A,A00,187028,Staff,26,0,60,34
1683295273499,PHYS 1AL,001,187036,Staff,2,0,30,28
1683295273499,PHYS 1AL,002,187049,Staff,18,0,30,12
1683295274525,PHYS 1B,A00,187058,Staff,23,0,60,37
1683295275551,PHYS 1BL,001,187064,Staff,0,0,30,30
1683295275551,PHYS 1BL,002,187070,Staff,6,0,30,24
1683295276580,PHYS 1C,A00,187082,Staff,32,0,120,88
1683295277611,PHYS 1CL,001,187088,Staff,0,9,30,30
1683295277611,PHYS 1CL,002,187089,Staff,0,2,30,30
1683295277611,PHYS 1CL,009,262693,Staff,12,0,30,18
1683295278637,PHYS 2B,A01,187097,Staff,54,0,115,61
1683295279662,PHYS 2C,A01,187099,Staff,67,0,115,48
1683295280692,PHYS 2CL,A01,187101,Staff,5,0,28,23
1683295280692,PHYS 2CL,A02,187102,Staff,15,0,28,13
1683295281722,PHYS 2D,A01,187123,Shotwell; Brian,95,0,115,20
1683295282752,PHYS 4B,A01,187133,Grinstein; Benjamin,35,0,50,15
1683295283780,POLI 10,A00,188819,Staff,0,3,50,50
1683295284809,POLI 11,A00,188827,Staff,43,0,50,7
1683295285834,POLI 13R,A00,188828,Staff,0,1,20,20
1683295286860,POLI 27,A01,188830,Elgin; Samuel Zincke,0,1,70,70
1683295287886,POLI 30,A00,188832,Desposato; Scott,33,0,50,17
1683295288917,POLI 102F,A00,188834,Staff,3,0,40,37
1683295289945,POLI 104A,A00,188852,Staff,14,0,30,16
1683295290972,POLI 104I,A00,188853,Staff,0,6,20,20
1683295291998,POLI 110B,A00,188854,Wiens; David,7,0,20,13
1683295293024,POLI 112A,A00,188855,Wiens; David,5,0,30,25
1683295294049,POLI 117R,A00,188856,Forman; Fonna,0,11,20,20
1683295295079,POLI 118,A00,188857,Ingham; Sean,8,0,20,12
1683295296103,POLI 120G,A00,188858,Staff,9,0,30,21
1683295297129,POLI 131CR,A00,188863,Hoston; Germaine,24,0,50,26
1683295298157,POLI 133,A00,188864,Nellis; Gareth Hb,44,0,50,6
1683295299183,POLI 134D,A00,188865,Desposato; Scott,27,0,30,3
1683295300212,POLI 142A,A00,188871,Gartzke; Erik,22,0,50,28
1683295301238,POLI 142K,A00,188874,Staff,38,0,50,12
1683295302265,POLI 143,A00,188940,Gartzke; Erik,16,0,30,14
1683295303345,POLI 153,A00,188943,Staff,3,0,20,17
1683295304370,POLI 160AA,A00,188944,Staff,13,0,40,27
1683295305396,POLI 170A,A00,188945,Staff,11,0,30,19
1683295307482,PSYC 1,A00,188952,Staff,38,0,90,52
1683295308510,PSYC 2,B00,188953,Staff,20,0,35,15
1683295309537,PSYC 6,A00,188970,Staff,47,0,60,13
1683295310563,PSYC 7,A00,188973,Staff,37,0,45,8
1683295311592,PSYC 60,A01,188980,Rickard; Timothy C.,43,0,60,17
1683295312621,PSYC 70,A01,189001,Steiner; Eric Tomas,24,0,45,21
1683295313651,PSYC 100,A00,189005,Lacefield; Katharine I,0,99,120,120
1683295314677,PSYC 102,A00,189008,Staff,10,0,30,20
1683295315702,PSYC 106,B00,189026,Gorman; Michael R.,37,0,60,23
1683295316730,PSYC 114,B01,189033,Winkielman; Piotr,0,32,30,30
1683295317756,PSYC 131,A00,189036,Anagnostaras; Stephan,0,43,60,60
1683295318786,PSYC 136,A00,189041,Lowe; Angela Beth,0,7,25,25
1683295319810,PSYC 137,A00,189057,Winkielman; Piotr,0,34,25,25
1683295320835,PSYC 144,A00,189107,Wixted; John T,0,7,50,50
1683295322904,PSYC 162,A00,189142,Staff,0,8,85,85
1683295323931,PSYC 172,A00,189144,Gorman; Michael R.,0,7,30,30
1683295325988,PSYC 179,A00,189146,Lacefield; Katharine I,0,84,120,120
1683295327017,PSYC 181,A00,189147,Anagnostaras; Stephan,0,44,90,90
1683295328045,PSYC 190R,A00,189148,Barner; David A.,0,22,80,80
1683295329071,PSYC 191,A00,189275,Rickard; Timothy C.,0,7,25,25
1683295330096,PSYC 193,A00,189276,Chapman; Eddie Nathaniel,0,1,0,4
1683295331120,PSYC 193L,A01,189281,Lowe; Angela Beth,12,0,20,8
1683295331120,PSYC 193L,B01,189285,Staff,28,0,35,7
1683295332145,RELI 149,A00,187137,Rahimi; Babak,7,0,40,33
1683295333170,SE 9,A01,187315,Staff,0,2,18,18
1683295334197,SE 101B,A00,187409,Staff,24,0,30,6
1683295335220,SE 110B,A00,187444,Staff,10,0,40,30
1683295336247,SE 130B,A00,187449,Staff,31,0,40,9
1683295337277,SE 150A,A00,187516,Staff,9,0,20,11
1683295338305,SE 154,A00,187528,Staff,30,0,50,20
1683295339333,SIO 3,A01,258171,Staff,35,0,40,5
1683295340360,SIO 10,A00,187144,Cook; Geoffrey W,0,3,75,75
1683295341385,SIO 45,A00,187152,Cook; Geoffrey W,1,0,100,99
1683295342413,SIO 109R,A00,194486,Staff,0,3,20,20
1683295344471,SIO 187,A01,187233,Kacev; David,12,0,40,28
1683295345505,SOCI 1,A01,258656,Thorpe; Charles Robert,28,0,30,2
1683295345505,SOCI 1,A02,258658,Thorpe; Charles Robert,30,0,30,0
1683295345505,SOCI 1,A03,258661,Thorpe; Charles Robert,25,0,25,0
1683295345505,SOCI 1,A04,258666,Thorpe; Charles Robert,22,0,25,3
1683295345505,SOCI 1,A05,258897,Thorpe; Charles Robert,23,0,25,2
1683295345505,SOCI 1,A06,258898,Thorpe; Charles Robert,25,0,25,0
1683295346530,SOCI 30,A01,258903,Pardo Guerra; Juan Pablo,16,0,30,14
1683295347559,SOCI 102,A00,258904,Staff,9,0,25,16
1683295348587,SOCI 106,A00,258905,Staff,19,0,25,6
1683295349618,SOCI 111,A00,258907,Ribas Norris; Janet Vanesa,26,0,30,4
1683295350646,SOCI 121R,A00,258908,Pardo Guerra; Juan Pablo,11,0,30,19
1683295351672,SOCI 126,A01,203330,Staff,14,0,20,6
1683295352696,SOCI 131,A00,258909,Thorpe; Charles Robert,31,0,60,29
1683295353720,SOCI 135,A00,258910,Payne; Christine Anna,0,9,30,30
1683295354745,SOCI 157,A00,258911,Staff,13,0,30,17
1683295355770,SOCI 184,A00,258912,Staff,26,0,30,4
1683295356797,SOCI 188D,A00,258913,Staff,21,0,30,9
1683295357823,SYN 2,001,187529,Staff,9,0,16,7
1683295357823,SYN 2,002,201452,Staff,0,18,16,16
1683295357823,SYN 2,003,201469,Staff,3,0,16,13
1683295358852,SYN 100,A01,187531,Staff,0,9,20,20
1683295358852,SYN 100,B01,201491,Staff,0,12,20,20
1683295359886,TDAC 1,A00,189286,Walsh; Kim C.,3,0,20,17
1683295359886,TDAC 1,B00,189287,Harting; Carla Kelso,11,0,20,9
1683295360912,TDAC 101,A00,189300,Walsh; Kim C.,16,0,20,4
1683295360912,TDAC 101,B00,189301,Harting; Carla Kelso,18,0,20,2
1683295361939,TDAC 102,A00,189304,Basso; Beatrice,14,0,20,6
1683295362963,TDAC 108,A00,189305,Staff,18,0,20,2
1683295363995,TDDE 131,A00,189310,Staff,19,0,20,1
1683295363995,TDDE 131,B00,189314,Staff,19,0,20,1
1683295363995,TDDE 131,C00,189315,Staff,48,0,50,2
1683295363995,TDDE 131,D00,189316,Staff,14,0,15,1
1683295363995,TDDE 131,E00,204841,Staff,20,0,20,0
1683295368088,TDGE 10,A00,189289,Staff,30,0,50,20
1683295368088,TDGE 10,B00,189290,Havis; Allan,2,0,50,48
1683295369117,TDGE 11,A00,189291,Fulton; Julia,0,3,50,50
1683295369117,TDGE 11,B00,189292,Staff,20,0,25,5
1683295369117,TDGE 11,C00,260270,Staff,0,0,0,0
1683295370141,TDGE 25,A00,189294,Staff,3,0,20,17
1683295371164,TDGE 124,A00,189318,Fulton; Julia,0,8,50,50
1683295372189,TDGE 125,A00,189319,Staff,13,0,25,12
1683295372189,TDGE 125,B00,189320,Staff,23,0,25,2
1683295373216,TDGE 127,A00,189322,Havis; Allan,0,0,50,50
1683295374244,TDHT 101,A00,189323,Staff,18,0,25,7
1683295374244,TDHT 101,B00,189324,Staff,25,0,25,0
1683295375272,TDHT 102,A00,189325,Staff,49,0,50,1
1683295376298,TDMV 1,A00,189295,Arcidiacono; Kristin,20,0,30,10
1683295376298,TDMV 1,B00,189296,Caligagan; Maria T.,24,0,30,6
1683295377339,TDMV 2,A00,189297,Sammartano; Tonnie,28,0,30,2
1683295377339,TDMV 2,B00,189299,Arcidiacono; Kristin,24,0,30,6
1683295378366,TDMV 3,A00,204998,Rincon; Alicia,22,0,30,8
1683295379393,TDMV 120,A00,189458,Sammartano; Tonnie,28,0,30,2
1683295380418,TDMV 138,A00,189541,Jun; Grace Shin Hae,22,0,40,18
1683295381444,TDMV 142,A00,189717,Caligagan; Tony,23,0,30,7
1683295381444,TDMV 142,B00,189718,Caligagan; Maria T.,25,0,30,5
1683295382469,TMC 2,A01,187533,Staff,25,0,25,0
1683295382469,TMC 2,A02,187534,Staff,25,0,25,0
1683295383495,USP 1,A01,187536,Kwak; Nancy,0,16,25,25
1683295384520,USP 5,A01,187538,Staff,9,0,25,16
1683295385546,USP 101,A00,199253,Staff,0,4,0,0
1683295386571,USP 124,A00,187562,Boomhower; Matthew Charles,1,0,30,29
1683295387597,USP 138,A00,187582,Staff,20,0,25,5
1683295388630,USP 152,A01,187597,Staff,4,0,25,21
1683295389657,USP 153,A00,187598,Staff,19,0,25,6
1683295390687,USP 168,A00,187607,Kwak; Nancy,2,0,5,3
1683295391714,USP 173,A00,187619,Staff,4,0,25,21
1683295392742,USP 181,A00,187638,Staff,0,0,25,25
1683295393780,VIS 103,A00,187650,Cruz; Edwin Teddy,23,0,75,52
1683295394806,VIS 110D,A00,187669,Staff,12,0,22,10
1683295395834,VIS 127C,A00,187720,Shen; Kuiyi,68,0,146,78
1683295396861,VIS 149,A00,187731,Yoldas; Pinar,0,14,22,22
1683295397886,VIS 151,A01,188091,Staff,22,0,34,12
1683295397886,VIS 151,A02,188092,Staff,11,0,34,23
1683295398913,VIS 160B,A00,188093,Stalbaum; Brett,0,0,10,10
1683295400976,WCWP 10B,A00,201720,Staff,10,0,15,5
1683295400976,WCWP 10B,B00,201722,Staff,8,0,15,7
1683295402004,WCWP 100,A00,201725,Gagnon; Jeffrey C,0,0,2,2
1683295402004,WCWP 100,B00,201727,Staff,0,4,15,15
1683295405220,ANBI 133,A00,258401,Wilder; Linnea Lorene,34,0,40,6
1683295406248,ANBI 140,A00,258395,Hrvoj Mihic; Branka,18,0,25,7
1683295407280,ANSC 120,A00,258402,Bialecki; Jon Anthony,27,0,40,13
1683295408310,ANSC 144,A00,258400,Staff,14,0,40,26
1683295410426,ANSC 166,A00,258396,Parish; Steven Martin,157,0,175,18
1683295411452,ANSC 180,A00,193533,Staff,9,0,20,11
1683295412482,ANSC 188,A00,258397,Jassal; Aftab,33,0,40,7
1683295413506,ANTH 3,A01,258316,Staff,23,0,30,7
1683295414534,ANTH 5,A00,258394,Semendeferi; Ekaterini,16,0,20,4
1683295415559,ANTH 21,A01,258331,Staff,9,0,40,31
1683295416586,ANTH 103,A00,258398,Varma; Saiba,15,0,25,10
1683295417617,AWP 10,001,202034,Staff,0,0,0,0
1683295417617,AWP 10,002,202035,Staff,0,0,0,0
1683295417617,AWP 10,003,202036,Staff,0,0,0,0
1683295417617,AWP 10,004,202037,Staff,0,0,0,0
1683295417617,AWP 10,005,202038,Staff,0,0,0,0
1683295417617,AWP 10,006,202039,Staff,0,0,0,0
1683295417617,AWP 10,007,202040,Staff,0,0,0,0
1683295417617,AWP 10,008,202041,Staff,0,0,0,0
1683295417617,AWP 10,009,202042,Staff,0,0,0,0
1683295417617,AWP 10,010,202043,Staff,0,0,0,0
1683295417617,AWP 10,011,202044,Staff,0,0,0,0
1683295417617,AWP 10,012,202045,Staff,0,0,0,0
1683295417617,AWP 10,013,202046,Staff,0,0,0,0
1683295417617,AWP 10,014,202047,Staff,0,0,0,0
1683295417617,AWP 10,015,202048,Staff,0,0,0,0
1683295417617,AWP 10,016,202049,Staff,0,0,0,0
1683295417617,AWP 10,017,202050,Staff,0,0,0,0
1683295417617,AWP 10,018,202051,Staff,0,0,0,0
1683295417617,AWP 10,019,202052,Staff,0,0,0,0
1683295417617,AWP 10,020,202053,Staff,0,0,0,0
1683295417617,AWP 10,021,202054,Staff,0,0,0,0
1683295417617,AWP 10,022,202055,Staff,0,0,0,0
1683295417617,AWP 10,023,202056,Staff,0,0,0,0
1683295417617,AWP 10,024,202057,Staff,0,0,0,0
1683295417617,AWP 10,025,202058,Staff,0,0,0,0
1683295417617,AWP 10,026,202059,Staff,0,0,0,0
1683295418643,AWP 102,001,202032,Staff,0,0,0,0
1683295418643,AWP 102,002,202033,Staff,0,0,0,0
1683295419670,BENG 100,A01,254234,Taylor Amos; Alyssa C,31,0,40,9
1683295420699,BENG 196,001,270013,Engler; Adam J.,9999,0,9999,0
1683295421726,BICD 100R,A01,202018,Smith; Laurie,0,7,32,32
1683295421726,BICD 100R,A02,202019,Smith; Laurie,0,2,32,32
1683295421726,BICD 100R,A03,202020,Smith; Laurie,0,1,32,32
1683295421726,BICD 100R,A04,202021,Smith; Laurie,8,0,32,24
1683295421726,BICD 100R,A05,202022,Smith; Laurie,12,0,32,20
1683295422753,BICD 136,A01,193242,Gustafson-Brown; Cindy,0,2,32,32
1683295422753,BICD 136,A02,193244,Gustafson-Brown; Cindy,15,0,32,17
1683295423788,BIEB 102,A01,193249,Butler; Shannon Rhey,0,2,32,32
1683295423788,BIEB 102,A02,193251,Butler; Shannon Rhey,0,0,32,32
1683295423788,BIEB 102,A03,193253,Butler; Shannon Rhey,0,1,32,32
1683295423788,BIEB 102,A04,193255,Butler; Shannon Rhey,17,0,32,15
1683295423788,BIEB 102,A05,193265,Butler; Shannon Rhey,26,0,32,6
1683295423788,BIEB 102,A06,193269,Butler; Shannon Rhey,16,0,32,16
1683295425847,BIEB 150,A01,193274,Staff,0,0,32,32
1683295425847,BIEB 150,A02,193285,Staff,24,0,32,8
1683295426879,BIEB 194,A00,193286,Kurle; Carolyn M.,22,0,32,10
1683295427913,BILD 1,A01,192291,Staff,16,0,32,16
1683295427913,BILD 1,A02,192292,Staff,30,0,32,2
1683295427913,BILD 1,B01,192520,Reuther; Keefe,0,1,0,0
1683295427913,BILD 1,B02,192532,Reuther; Keefe,0,1,0,0
1683295428946,BILD 3,A01,192556,Butler; Shannon Rhey,0,0,32,32
1683295428946,BILD 3,A02,192581,Butler; Shannon Rhey,5,0,32,27
1683295428946,BILD 3,A03,192611,Butler; Shannon Rhey,23,0,32,9
1683295428946,BILD 3,A04,192612,Butler; Shannon Rhey,25,0,32,7
1683295428946,BILD 3,A05,192613,Butler; Shannon Rhey,27,0,32,5
1683295428946,BILD 3,A06,192679,Butler; Shannon Rhey,27,0,32,5
1683295428946,BILD 3,A07,192682,Butler; Shannon Rhey,22,0,32,10
1683295429972,BILD 4,A01,192836,Reuther; Keefe,1,0,24,23
1683295429972,BILD 4,A02,193044,Reuther; Keefe,4,0,24,20
1683295430997,BILD 10,A01,193142,Gustafson-Brown; Cindy,31,0,32,1
1683295430997,BILD 10,A02,193149,Gustafson-Brown; Cindy,31,0,32,1
1683295432023,BIMM 100,A01,193301,Staff,0,6,32,32
1683295432023,BIMM 100,A02,193312,Staff,0,5,32,32
1683295432023,BIMM 100,A03,193323,Staff,0,8,32,32
1683295433050,BIMM 101,A01,193329,McDonnell; Lisa Marie,0,3,24,24
1683295433050,BIMM 101,A02,193339,McDonnell; Lisa Marie,0,2,24,24
1683295433050,BIMM 101,B01,193354,McDonnell; Lisa Marie,0,3,24,24
1683295433050,BIMM 101,B02,193357,McDonnell; Lisa Marie,0,3,24,24
1683295434076,BIMM 110,A01,193377,Tat; John,0,11,32,32
1683295434076,BIMM 110,A02,193378,Tat; John,1,9,32,31
1683295435102,BIMM 120,A01,206116,Staff,0,0,32,32
1683295435102,BIMM 120,A02,206117,Staff,8,0,32,24
1683295435102,BIMM 120,A03,206121,Staff,21,0,32,11
1683295436132,BIPN 100,A01,193393,Park; Ji Young,0,14,32,32
1683295436132,BIPN 100,A02,193402,Park; Ji Young,0,12,32,32
1683295436132,BIPN 100,A03,193413,Park; Ji Young,0,14,32,32
1683295436132,BIPN 100,A04,193414,Park; Ji Young,0,13,32,32
1683295437161,BIPN 102,A01,193429,Staff,0,0,32,32
1683295437161,BIPN 102,A02,193438,Staff,23,0,32,9
1683295438190,BIPN 106,A01,193450,Reyes Gonzalez; Catalina,0,2,40,40
1683295439218,BIPN 134,A01,193465,Cooke; James Edward,0,0,32,32
1683295439218,BIPN 134,A02,193474,Cooke; James Edward,27,0,32,5
1683295439218,BIPN 134,A03,193485,Cooke; James Edward,29,0,32,3
1683295439218,BIPN 134,A04,193486,Cooke; James Edward,21,0,32,11
1683295439218,BIPN 134,A05,193491,Cooke; James Edward,31,0,32,1
1683295439218,BIPN 134,A06,193501,Cooke; James Edward,30,0,32,2
1683295439218,BIPN 134,A07,193510,Cooke; James Edward,29,0,32,3
1683295441278,BISP 194,A00,222522,Staff,16,0,32,16
1683295442308,CAT 124,A01,202407,Staff,20,0,25,5
1683295443335,CAT 125,A00,202408,Marchisotto; Jennifer Anne,4,0,20,16
1683295444364,CAT 125R,A00,202409,Smith; Lauryn Alissa,0,11,20,20
1683295444364,CAT 125R,B00,202410,Morales; Celeste Georgianna,0,11,20,20
1683295444364,CAT 125R,C00,202411,Irwin; Matthew Joseph,0,10,20,20
1683295445396,CENG 15,A01,204712,Yang; Kesong,0,1,0,0
1683295446423,CENG 114,A00,202070,Jahed Motlagh; Zeinab,5,0,20,15
1683295447452,CGS 105,A00,185477,Wesling; Megan E.,24,0,40,16
1683295448477,CGS 106,A00,185494,Staff,13,0,22,9
1683295449501,CGS 108,A00,185495,Staff,14,0,20,6
1683295450528,CGS 114,A00,185496,Staff,13,0,18,5
1683295451556,CGS 119,A00,185501,Staff,15,0,20,5
1683295452584,CGS 120,A00,185511,Staff,13,0,20,7
1683295453619,CHEM 4,A01,184675,Bussey; Thomas J,96,0,100,4
1683295454648,CHEM 6A,A01,184677,Staff,35,0,60,25
1683295455678,CHEM 6B,A01,184679,Staff,65,0,100,35
1683295456708,CHEM 6C,A01,184681,Bussey; Thomas J,1,0,50,49
1683295456708,CHEM 6C,A02,184682,Bussey; Thomas J,34,0,50,16
1683295457734,CHEM 40A,A01,184684,Albizati; Kim F.,37,0,100,63
1683295458758,CHEM 40B,A01,184686,Albizati; Kim F.,0,20,100,100
1683295459787,CHEM 41B,A01,184690,Staff,52,0,100,48
1683295460818,COGS 3,A01,184715,Boyle; Mary E. T.,0,25,40,40
1683295461844,COGS 14B,A01,185172,Staff,0,15,38,38
1683295462870,COGS 18,A01,184736,Staff,20,0,80,60
1683295463895,COGS 100,A01,184932,Staff,0,5,73,73
1683295464925,COGS 101A,A01,184935,Staff,0,38,30,30
1683295465952,COGS 101B,A01,184944,Staff,0,2,30,30
1683295466978,COGS 101C,A01,184946,Staff,0,12,30,30
1683295468003,COGS 102A,A01,184951,Johnson; Christine M.,2,0,40,38
1683295469029,COGS 107B,A01,184953,Mooshagian; Eric Frederick,0,50,40,40
1683295470064,COGS 118B,A01,184959,Gupta; Anjum,0,48,40,40
1683295471090,COGS 153,A00,184961,Staff,0,15,30,30
1683295472115,COGS 177,A00,184962,Staff,0,21,30,30
1683295473150,COGS 187A,A01,184969,Boyle; Mary E. T.,0,17,40,40
1683295474181,COMM 10,A01,185174,Staff,0,5,25,25
1683295474181,COMM 10,A02,185189,Staff,0,5,25,25
1683295474181,COMM 10,A03,269821,Staff,0,0,0,0
1683295475211,COMM 100B,A01,185475,Staff,0,0,0,2
1683295475211,COMM 100B,A02,185476,Staff,14,0,25,11
1683295476241,COMM 100C,A01,185314,Staff,1,0,25,24
1683295476241,COMM 100C,A02,185327,Staff,19,0,25,6
1683295477270,COMM 110M,A00,185349,Staff,2,0,40,38
1683295478299,COMM 113T,A00,185352,Staff,25,0,40,15
1683295479326,COMM 114I,A00,185353,Staff,33,0,40,7
1683295480353,COMM 131,A00,185354,Staff,19,0,30,11
1683295481380,CSE 8A,A50,185358,Cao; Yingjun,0,46,10,10
1683295482407,CSE 8B,A01,185362,Staff,0,47,50,50
1683295483436,CSE 11,A01,185416,Cao; Yingjun,0,93,10,10
1683295484466,CSE 20,A01,185445,Briones; Jor-el Thomas Caparas,5,0,25,20
1683295485491,CSE 21,A01,185447,Staff,10,0,50,40
1683295486524,CSE 101,A01,185451,Staff,0,12,50,50
1683295486524,CSE 101,B01,185453,Jones; Miles E,0,11,50,50
1683295488579,CSE 141,A01,185458,Eldon; John,20,0,100,80
1683295489604,CSE 141L,A01,185461,Eldon; John,12,0,100,88
1683295490629,CSE 142,A01,185463,Staff,35,0,60,25
1683295490629,CSE 142,B01,201355,Staff,0,6,60,60
1683295491656,CSE 142L,A01,185470,Staff,35,0,60,25
1683295491656,CSE 142L,B01,201417,Staff,0,5,60,60
1683295492681,CSE 190,A00,201433,Staff,32,0,49,17
1683295493723,DOC 1,A01,259136,Strom; Megan C.,8,0,15,7
1683295493723,DOC 1,A02,259137,Strom; Megan C.,14,0,15,1
1683295493723,DOC 1,A03,259138,Strom; Megan C.,14,0,15,1
1683295493723,DOC 1,A04,259139,Strom; Megan C.,14,0,15,1
1683295494753,DOC 100D,A00,259140,Pass; Natalye Joann,17,0,25,8
1683295495779,DSGN 1,A01,184749,Rill; Bryan,0,24,30,30
1683295496807,DSGN 100,A01,185168,Staff,0,2,25,25
1683295497837,ECE 5,A01,185626,Morris; Karcher William,0,10,0,0
1683295498867,ECE 101,A01,185628,Staff,17,0,70,53
1683295499892,ECE 107,A01,185635,Baghdadchi; Saharnaz,0,0,20,20
1683295499892,ECE 107,A02,185638,Baghdadchi; Saharnaz,4,0,20,16
1683295500918,ECE 148,A01,185647,Silberman; Jack,1,0,16,15
1683295501943,ECON 1,A01,185537,Crane; Meredith Helen,54,0,70,16
1683295502969,ECON 3,A01,185549,Crane; Meredith Helen,33,0,70,37
1683295504003,ECON 4,A01,203354,Anderson; John Charles,0,4,10,10
1683295505030,ECON 100A,A01,185574,Staff,0,4,40,40
1683295506058,ECON 100B,A01,185576,Staff,0,22,40,40
1683295507082,ECON 100C,A01,185589,Newhouse; Herbert S,30,0,70,40
1683295508109,ECON 105,A00,185608,Vespa; Emanuel Ignacio,19,0,35,16
1683295509139,ECON 109,A01,185610,Shishkin; Denis,10,0,35,25
1683295510162,ECON 110A,A01,185612,Staff,11,0,40,29
1683295511191,ECON 120A,A01,185615,Staff,20,0,40,20
1683295512219,ECON 120C,A01,185617,Sun; Yixiao,0,20,70,70
1683295513250,ECON 144,A00,203346,Squires; Dale E,3,0,35,32
1683295514336,ECON 171,A01,203349,Newhouse; Herbert S,0,1,35,35
1683295515367,ECON 173A,A01,185621,Toda; Alexis Akira,21,0,35,14
1683295516394,EDS 25,A01,202413,Staff,0,1,0,0
1683295516394,EDS 25,A02,202414,Staff,0,1,0,0
1683295516394,EDS 25,A03,202415,Staff,0,0,0,0
1683295516394,EDS 25,A04,202416,Staff,0,1,0,0
1683295516394,EDS 25,A05,202439,Staff,0,0,0,0
1683295516394,EDS 25,A06,202440,Staff,0,0,0,0
1683295516394,EDS 25,B01,202631,Staff,0,0,0,0
1683295516394,EDS 25,B02,202632,Staff,0,0,0,0
1683295516394,EDS 25,B03,202639,Staff,0,0,0,0
1683295516394,EDS 25,B04,202640,Staff,0,0,0,0
1683295516394,EDS 25,B05,202643,Staff,0,0,0,0
1683295516394,EDS 25,B06,202644,Staff,0,0,0,0
1683295517423,EDS 38,A01,202659,Black; Alison Michelle,24,0,25,1
1683295518447,EDS 115,A00,202652,Staff,17,0,30,13
1683295519476,EDS 125,A00,202649,Staff,14,0,30,16
1683295520505,EDS 126,A01,203332,Staff,30,0,30,0
1683295521528,EDS 139,A00,202838,Staff,17,0,25,8
1683295522556,EDS 146,A01,202655,Staff,15,0,25,10
1683295523585,ENG 15,A00,185667,Staff,0,1,0,0
1683295523585,ENG 15,B00,185672,Staff,0,0,0,0
1683295523585,ENG 15,C00,185675,Staff,0,0,0,0
1683295523585,ENG 15,D00,185682,Staff,0,0,0,0
1683295523585,ENG 15,E00,185684,Staff,0,0,0,0
1683295524613,ETHN 103,A00,185710,Staff,0,3,35,35
1683295525641,ETHN 103A,A00,199228,Man; Simeon S,3,0,9,6
1683295526667,ETHN 109,A00,185711,Staff,18,0,35,17
1683295527691,ETHN 142,A00,185726,Staff,0,4,30,30
1683295528716,ETHN 163J,A00,199229,Man; Simeon S,6,0,8,2
1683295529743,ETHN 168,A00,185727,Staff,8,0,10,2
1683295530767,ETHN 182,A00,185728,Staff,1,0,35,34
1683295531793,ETHN 183,A00,185737,Staff,8,0,18,10
1683295532820,GLBH 111,A01,209361,Burgos; Jose L.,0,0,0,0
1683295534872,HIEU 104,A00,185792,Staff,16,0,20,4
1683295535896,HIEU 115,A00,185800,Staff,1,0,20,19
1683295536924,HIEU 128,A00,185801,Staff,0,7,20,20
1683295537950,HIEU 147,A00,185802,Staff,16,0,20,4
1683295538980,HIEU 154,A00,185823,Staff,12,0,20,8
1683295540007,HILA 102,A00,185826,Staff,13,0,20,7
1683295541032,HILD 2C,A01,185778,Staff,0,12,20,20
1683295542061,HILD 7B,A01,185780,Kwak; Nancy,0,15,32,32
1683295542061,HILD 7B,A02,185781,Kwak; Nancy,0,18,32,32
1683295543088,HILD 30,A01,185791,Staff,14,0,20,6
1683295544113,HISC 119,A00,185830,Golan; Tal,0,9,20,20
1683295545143,HITO 156GS,A00,185831,Patterson; Patrick H.,0,0,0,23
1683295546167,HIUS 103,A00,185832,Man; Simeon S,0,7,20,20
1683295547195,HIUS 117,A00,185836,Kwak; Nancy,2,0,20,18
1683295548220,HIUS 125,A00,185840,Man; Simeon S,0,0,23,23
1683295549248,HIUS 149,A00,185845,Staff,0,0,20,20
1683295550279,HUM 3,A01,185882,Zavodny; Tatiana Sophia,0,6,50,50
1683295550279,HUM 3,B01,185899,Caldwell; Michael Alan,0,19,50,50
1683295551307,HUM 3GS,A00,185900,Patterson; Patrick H.,0,0,0,23
1683295552339,HUM 4,A01,185938,Zroka; Amy Liane,31,0,50,19
1683295552339,HUM 4,B01,185956,Watkins; Eric,0,2,50,50
1683295552339,HUM 4,B02,202209,Watkins; Eric,0,1,50,50
1683295552339,HUM 4,B03,202210,Watkins; Eric,0,0,50,50
1683295553363,HUM 5,A01,185958,West; Geoffrey Scott,5,0,50,45
1683295553363,HUM 5,A02,202215,West; Geoffrey Scott,0,0,50,50
1683295554389,INTL 190,A00,185959,Gagnon; Jeffrey C,0,0,0,9
1683295554389,INTL 190,B00,185960,Lettieri; Michael Joseph,0,0,0,1
1683295555412,JAPN 180,A00,254509,Staff,0,1,25,25
1683295556443,LATI 10,A01,202853,Kennemore; Amy Michelle,5,0,35,30
1683295556443,LATI 10,A02,202854,Kennemore; Amy Michelle,1,0,35,34
1683295556443,LATI 10,A03,270054,Kennemore; Amy Michelle,30,0,30,0
1683295557476,LATI 180,A00,202855,Kennemore; Amy Michelle,11,0,20,9
1683295558502,LAWS 101,A00,201767,Golan; Tal,0,7,40,40
1683295559527,LIFR 1C,A00,185961,Staff,6,0,20,14
1683295560552,LIFR 1CX,A00,185962,Staff,7,0,20,13
1683295561576,LIFR 1D,A00,185963,Staff,9,0,20,11
1683295562600,LIFR 1DX,A00,185964,Staff,9,0,20,11
1683295563626,LIGN 101,A01,186039,Staff,43,0,50,7
1683295564650,LIGN 165,A00,186040,Staff,18,0,50,32
1683295565675,LTCS 108,A00,186041,Staff,6,0,10,4
1683295566703,LTCS 119,A00,186042,Staff,16,0,20,4
1683295567730,LTCS 130,A00,186043,Wesling; Megan E.,15,0,25,10
1683295569782,LTEA 138,A00,186119,Staff,14,0,40,26
1683295570811,LTEN 124,A00,186148,Staff,6,0,25,19
1683295571837,LTEN 178,A00,186149,Staff,7,0,15,8
1683295572862,LTEN 181,A00,186150,Blanco; John D,33,0,40,7
1683295573887,LTWL 120,A00,186160,Staff,20,0,25,5
1683295574914,LTWL 165,A00,186161,Staff,22,0,25,3
1683295575942,LTWR 100,A00,186162,Staff,0,4,15,15
1683295576969,LTWR 102,A00,186163,Doller; Ben,5,0,15,10
1683295577998,MAE 8,A01,186412,Staff,0,0,0,0
1683295579024,MAE 30B,A00,186445,Bahadori; Mohammad Yousef,83,0,100,17
1683295580051,MAE 40,A00,186592,Bewley; Thomas R,9,0,50,41
1683295581076,MAE 101B,A00,186593,Bahadori; Mohammad Yousef,81,0,100,19
1683295582100,MAE 105,A00,186594,Bandaru; Prabhakar,12,0,50,38
1683295583131,MAE 107,A00,186599,Pham; Hieu Tan,0,6,120,120
1683295584157,MAE 148,A01,186660,Silberman; Jack,3,0,16,13
1683295585182,MATH 10A,A01,188095,Staff,0,7,35,35
1683295586209,MATH 10B,A01,188097,Bowers; Adam R.,0,11,30,30
1683295586209,MATH 10B,A02,188099,Bowers; Adam R.,0,9,30,30
1683295586209,MATH 10B,B01,188104,Bowers; Adam R.,0,11,30,30
1683295586209,MATH 10B,B02,188106,Bowers; Adam R.,0,11,30,30
1683295587235,MATH 10C,A01,188111,Staff,0,18,30,30
1683295587235,MATH 10C,A02,188127,Staff,0,17,30,30
1683295587235,MATH 10C,A03,188131,Staff,0,17,30,30
1683295587235,MATH 10C,B01,188218,Staff,21,0,30,9
1683295587235,MATH 10C,B02,188244,Staff,13,0,30,17
1683295587235,MATH 10C,B03,188277,Staff,16,0,30,14
1683295588261,MATH 18,A01,188344,Bach; Quang Tran,18,0,30,12
1683295588261,MATH 18,A02,188345,Bach; Quang Tran,11,0,30,19
1683295588261,MATH 18,B01,188353,Bach; Quang Tran,10,0,30,20
1683295588261,MATH 18,B02,188354,Bach; Quang Tran,20,0,30,10
1683295589285,MATH 20A,A01,188374,Staff,13,0,35,22
1683295590311,MATH 20B,A01,188382,Ohm; Ko Woon,6,0,30,24
1683295590311,MATH 20B,A02,188383,Ohm; Ko Woon,24,0,30,6
1683295590311,MATH 20B,B01,188385,Ohm; Ko Woon,7,0,30,23
1683295590311,MATH 20B,B02,188392,Ohm; Ko Woon,22,0,30,8
1683295591336,MATH 20C,A01,188394,Harel; Guershon,10,0,30,20
1683295591336,MATH 20C,A02,188395,Harel; Guershon,13,0,30,17
1683295591336,MATH 20C,B01,188404,Harel; Guershon,3,0,30,27
1683295591336,MATH 20C,B02,188405,Harel; Guershon,19,0,30,11
1683295592363,MATH 20D,A01,188414,Hammock; Frances H,0,1,30,30
1683295592363,MATH 20D,A02,188415,Hammock; Frances H,4,0,30,26
1683295592363,MATH 20D,B01,188447,Hammock; Frances H,2,0,30,28
1683295592363,MATH 20D,B02,188486,Hammock; Frances H,8,0,30,22
1683295593387,MATH 20E,A01,188649,Staff,22,0,30,8
1683295593387,MATH 20E,A02,188650,Staff,23,0,30,7
1683295593387,MATH 20E,A03,188673,Staff,0,0,30,30
1683295594412,MATH 102,A01,188675,Staff,0,35,35,35
1683295595436,MATH 103B,A01,188681,Staff,4,0,35,31
1683295595436,MATH 103B,B01,188692,Staff,7,0,35,28
1683295596474,MATH 109,A01,188695,Salehi Golsefidy; Alireza,25,0,35,10
1683295596474,MATH 109,A02,188696,Salehi Golsefidy; Alireza,27,0,35,8
1683295597506,MATH 120A,A01,188698,Eggers; John Dietrich,5,0,35,30
1683295598538,MATH 142B,A01,188736,Ioana; Adrian,0,2,30,30
1683295598538,MATH 142B,A02,188741,Ioana; Adrian,0,1,30,30
1683295598538,MATH 142B,A03,188743,Ioana; Adrian,0,3,30,30
1683295599562,MATH 168A,A01,188790,Staff,0,8,35,35
1683295600592,MATH 170A,A01,188803,Nie; Jiawang,0,2,35,35
1683295600592,MATH 170A,A02,188811,Nie; Jiawang,0,0,35,35
1683295600592,MATH 170A,A03,188814,Nie; Jiawang,1,0,35,34
1683295600592,MATH 170A,A04,188815,Nie; Jiawang,14,0,35,21
1683295601617,MATH 193B,A01,188817,Staff,0,0,35,35
1683295601617,MATH 193B,A02,188818,Staff,5,0,35,30
1683295602642,MGT 4,A01,202857,Anderson; John Charles,62,0,80,18
1683295603666,MGT 12,A00,202858,Lindenberger; Wade Douglas,43,0,90,47
1683295604689,MGT 18,A00,202859,Staff,74,0,90,16
1683295605714,MGT 18GS,A00,202860,McKay; Michael J,13,0,28,15
1683295606740,MGT 45,A00,202861,Pecore; Joseph P.,14,0,90,76
1683295607769,MGT 100,A00,202863,Yavorsky; Daniel Ryan,28,0,90,62
1683295608797,MGT 103,A00,202864,Ehrich; Kristine R,0,16,90,90
1683295609821,MGT 112,A00,202865,Ehrich; Kristine R,15,0,90,75
1683295610846,MGT 121A,A00,202868,Staff,0,19,0,0
1683295611871,MGT 131B,A00,202869,Anderson; John Charles,59,0,90,31
1683295612896,MGT 136,A00,202871,Lindenberger; Wade Douglas,84,0,90,6
1683295613921,MGT 164,A00,202873,Staff,0,69,90,90
1683295614945,MGT 164GS,A00,202874,McKay; Mary A,13,0,28,15
1683295615976,MGT 180,A00,202875,Staff,0,51,90,90
1683295617006,MMW 11R,A01,205019,Herbst; Matthew,3,0,30,27
1683295617006,MMW 11R,A02,205026,Herbst; Matthew,29,0,30,1
1683295618088,MMW 15,A01,193512,Chang; Edmond Yi-Teh,0,9,28,28
1683295618088,MMW 15,A02,193513,Chang; Edmond Yi-Teh,0,5,28,28
1683295618088,MMW 15,A03,193514,Chang; Edmond Yi-Teh,0,5,28,28
1683295618088,MMW 15,A04,193515,Chang; Edmond Yi-Teh,0,4,28,28
1683295618088,MMW 15,A05,193516,Chang; Edmond Yi-Teh,0,4,28,28
1683295618088,MMW 15,A06,193517,Chang; Edmond Yi-Teh,0,5,28,28
1683295618088,MMW 15,B01,193519,Chang; Edmond Yi-Teh,0,4,28,28
1683295618088,MMW 15,B02,193520,Chang; Edmond Yi-Teh,0,5,28,28
1683295618088,MMW 15,B03,193521,Chang; Edmond Yi-Teh,0,4,28,28
1683295618088,MMW 15,B04,193522,Chang; Edmond Yi-Teh,0,4,28,28
1683295618088,MMW 15,B05,193523,Chang; Edmond Yi-Teh,0,5,28,28
1683295618088,MMW 15,B06,193524,Chang; Edmond Yi-Teh,0,4,28,28
1683295619114,MMW 122,A01,193526,Rahimi; Babak,0,14,28,28
1683295619114,MMW 122,A02,193527,Rahimi; Babak,0,14,28,28
1683295619114,MMW 122,A03,193528,Rahimi; Babak,0,0,0,0
1683295619114,MMW 122,A04,193529,Rahimi; Babak,0,0,0,0
1683295620140,MUS 1A,A01,186663,Staff,0,20,35,35
1683295621169,MUS 4,A01,186715,Staff,0,12,35,35
1683295622195,MUS 5R,A01,186796,Dubnov; Shlomo,0,16,35,35
1683295623221,MUS 6,A01,186798,Staff,0,3,25,25
1683295624248,MUS 7,A01,186830,Staff,12,0,35,23
1683295625272,MUS 8,A01,186930,Staff,0,25,35,35
1683295626297,MUS 15,A01,186932,Staff,0,15,35,35
1683295626297,MUS 15,B01,186934,Staff,0,14,35,35
1683295627321,MUS 80,A00,186935,Staff,2,0,20,18
1683295627321,MUS 80,B00,186936,Staff,25,0,25,0
1683295628348,NANO 11,A00,204702,Lipomi; Darren John,0,0,0,0
1683295629378,NANO 15,A01,204709,Yang; Kesong,0,1,0,0
1683295630405,NANO 114,A00,202069,Jahed Motlagh; Zeinab,3,0,10,7
1683295631435,PHIL 1,A00,186955,Grush; Rick Scott,32,0,40,8
1683295632460,PHIL 10,A01,186973,Grush; Rick Scott,29,0,35,6
1683295632460,PHIL 10,A02,186974,Grush; Rick Scott,33,0,35,2
1683295633485,PHIL 13,A01,186976,Staff,7,0,35,28
1683295633485,PHIL 13,A02,186977,Staff,16,0,35,19
1683295634513,PHIL 14,A01,186979,Staff,31,0,35,4
1683295634513,PHIL 14,A02,186986,Staff,32,0,35,3
1683295635538,PHIL 28,A01,186988,Staff,16,0,30,14
1683295635538,PHIL 28,A02,186989,Staff,1,0,30,29
1683295635538,PHIL 28,A03,186990,Staff,9,0,30,21
1683295635538,PHIL 28,A04,186991,Staff,26,0,30,4
1683295636564,PHIL 120,A00,186997,Staff,23,0,40,17
1683295637589,PHIL 137,A00,187003,Staff,9,0,40,31
1683295638616,PHIL 150,A00,187015,Staff,47,0,70,23
1683295639641,PHIL 167,A00,187021,Lamey; Andy M.,35,0,40,5
1683295640669,PHIL 174,A01,202226,Staff,17,0,20,3
1683295640669,PHIL 174,A02,202235,Staff,20,0,20,0
1683295641696,PHIL 191A,A00,258918,Staff,0,0,1,1
1683295642724,PHYS 1A,A00,187028,Staff,26,0,60,34
1683295643749,PHYS 1AL,001,187036,Staff,2,0,30,28
1683295643749,PHYS 1AL,002,187049,Staff,18,0,30,12
1683295644776,PHYS 1B,A00,187058,Staff,23,0,60,37
1683295645801,PHYS 1BL,001,187064,Staff,0,0,30,30
1683295645801,PHYS 1BL,002,187070,Staff,6,0,30,24
1683295646826,PHYS 1C,A00,187082,Staff,32,0,120,88
1683295647851,PHYS 1CL,001,187088,Staff,0,9,30,30
1683295647851,PHYS 1CL,002,187089,Staff,0,2,30,30
1683295647851,PHYS 1CL,009,262693,Staff,12,0,30,18
1683295648880,PHYS 2B,A01,187097,Staff,54,0,115,61
1683295649903,PHYS 2C,A01,187099,Staff,67,0,115,48
1683295650932,PHYS 2CL,A01,187101,Staff,5,0,28,23
1683295650932,PHYS 2CL,A02,187102,Staff,15,0,28,13
1683295651958,PHYS 2D,A01,187123,Shotwell; Brian,95,0,115,20
1683295652988,PHYS 4B,A01,187133,Grinstein; Benjamin,35,0,50,15
1683295654012,POLI 10,A00,188819,Staff,0,3,50,50
1683295655038,POLI 11,A00,188827,Staff,43,0,50,7
1683295656063,POLI 13R,A00,188828,Staff,0,1,20,20
1683295657088,POLI 27,A01,188830,Elgin; Samuel Zincke,0,1,70,70
1683295658112,POLI 30,A00,188832,Desposato; Scott,33,0,50,17
1683295659138,POLI 102F,A00,188834,Staff,3,0,40,37
1683295660166,POLI 104A,A00,188852,Staff,14,0,30,16
1683295661191,POLI 104I,A00,188853,Staff,0,6,20,20
1683295662220,POLI 110B,A00,188854,Wiens; David,7,0,20,13
1683295663248,POLI 112A,A00,188855,Wiens; David,5,0,30,25
1683295664274,POLI 117R,A00,188856,Forman; Fonna,0,11,20,20
1683295665299,POLI 118,A00,188857,Ingham; Sean,8,0,20,12
1683295666326,POLI 120G,A00,188858,Staff,9,0,30,21
1683295667351,POLI 131CR,A00,188863,Hoston; Germaine,24,0,50,26
1683295668379,POLI 133,A00,188864,Nellis; Gareth Hb,44,0,50,6
1683295669404,POLI 134D,A00,188865,Desposato; Scott,27,0,30,3
1683295670435,POLI 142A,A00,188871,Gartzke; Erik,22,0,50,28
1683295671460,POLI 142K,A00,188874,Staff,38,0,50,12
1683295672485,POLI 143,A00,188940,Gartzke; Erik,16,0,30,14
1683295673510,POLI 153,A00,188943,Staff,3,0,20,17
1683295674538,POLI 160AA,A00,188944,Staff,13,0,40,27
1683295675566,POLI 170A,A00,188945,Staff,11,0,30,19
1683295677620,PSYC 1,A00,188952,Staff,38,0,90,52
1683295678644,PSYC 2,B00,188953,Staff,20,0,35,15
1683295679670,PSYC 6,A00,188970,Staff,47,0,60,13
1683295680693,PSYC 7,A00,188973,Staff,37,0,45,8
1683295681717,PSYC 60,A01,188980,Rickard; Timothy C.,43,0,60,17
1683295682747,PSYC 70,A01,189001,Steiner; Eric Tomas,24,0,45,21
1683295683777,PSYC 100,A00,189005,Lacefield; Katharine I,0,99,120,120
1683295684802,PSYC 102,A00,189008,Staff,10,0,30,20
1683295685828,PSYC 106,B00,189026,Gorman; Michael R.,37,0,60,23
1683295686858,PSYC 114,B01,189033,Winkielman; Piotr,0,32,30,30
1683295687884,PSYC 131,A00,189036,Anagnostaras; Stephan,0,43,60,60
1683295688909,PSYC 136,A00,189041,Lowe; Angela Beth,0,7,25,25
1683295689935,PSYC 137,A00,189057,Winkielman; Piotr,0,34,25,25
1683295690965,PSYC 144,A00,189107,Wixted; John T,0,7,50,50
1683295693016,PSYC 162,A00,189142,Staff,0,8,85,85
1683295694041,PSYC 172,A00,189144,Gorman; Michael R.,0,7,30,30
1683295696098,PSYC 179,A00,189146,Lacefield; Katharine I,0,84,120,120
1683295697122,PSYC 181,A00,189147,Anagnostaras; Stephan,0,44,90,90
1683295698147,PSYC 190R,A00,189148,Barner; David A.,0,22,80,80
1683295699172,PSYC 191,A00,189275,Rickard; Timothy C.,0,7,25,25
1683295700201,PSYC 193,A00,189276,Chapman; Eddie Nathaniel,0,1,0,4
1683295701227,PSYC 193L,A01,189281,Lowe; Angela Beth,12,0,20,8
1683295701227,PSYC 193L,B01,189285,Staff,28,0,35,7
1683295702250,RELI 149,A00,187137,Rahimi; Babak,7,0,40,33
1683295703275,SE 9,A01,187315,Staff,0,2,18,18
1683295704299,SE 101B,A00,187409,Staff,24,0,30,6
1683295705324,SE 110B,A00,187444,Staff,10,0,40,30
1683295706351,SE 130B,A00,187449,Staff,31,0,40,9
1683295707377,SE 150A,A00,187516,Staff,9,0,20,11
1683295708404,SE 154,A00,187528,Staff,30,0,50,20
1683295709430,SIO 3,A01,258171,Staff,35,0,40,5
1683295710459,SIO 10,A00,187144,Cook; Geoffrey W,0,3,75,75
1683295711484,SIO 45,A00,187152,Cook; Geoffrey W,1,0,100,99
1683295712508,SIO 109R,A00,194486,Staff,0,3,20,20
1683295714563,SIO 187,A01,187233,Kacev; David,12,0,40,28
1683295715589,SOCI 1,A01,258656,Thorpe; Charles Robert,28,0,30,2
1683295715589,SOCI 1,A02,258658,Thorpe; Charles Robert,30,0,30,0
1683295715589,SOCI 1,A03,258661,Thorpe; Charles Robert,25,0,25,0
1683295715589,SOCI 1,A04,258666,Thorpe; Charles Robert,22,0,25,3
1683295715589,SOCI 1,A05,258897,Thorpe; Charles Robert,23,0,25,2
1683295715589,SOCI 1,A06,258898,Thorpe; Charles Robert,25,0,25,0
1683295716613,SOCI 30,A01,258903,Pardo Guerra; Juan Pablo,16,0,30,14
1683295717637,SOCI 102,A00,258904,Staff,9,0,25,16
1683295718663,SOCI 106,A00,258905,Staff,19,0,25,6
1683295719688,SOCI 111,A00,258907,Ribas Norris; Janet Vanesa,26,0,30,4
1683295720713,SOCI 121R,A00,258908,Pardo Guerra; Juan Pablo,11,0,30,19
1683295721798,SOCI 126,A01,203330,Staff,14,0,20,6
1683295722822,SOCI 131,A00,258909,Thorpe; Charles Robert,31,0,60,29
1683295723848,SOCI 135,A00,258910,Payne; Christine Anna,0,9,30,30
1683295724875,SOCI 157,A00,258911,Staff,13,0,30,17
1683295725898,SOCI 184,A00,258912,Staff,26,0,30,4
1683295726922,SOCI 188D,A00,258913,Staff,21,0,30,9
1683295727947,SYN 2,001,187529,Staff,9,0,16,7
1683295727947,SYN 2,002,201452,Staff,0,18,16,16
1683295727947,SYN 2,003,201469,Staff,3,0,16,13
1683295728974,SYN 100,A01,187531,Staff,0,9,20,20
1683295728974,SYN 100,B01,201491,Staff,0,12,20,20
1683295730006,TDAC 1,A00,189286,Walsh; Kim C.,3,0,20,17
1683295730006,TDAC 1,B00,189287,Harting; Carla Kelso,11,0,20,9
1683295731036,TDAC 101,A00,189300,Walsh; Kim C.,16,0,20,4
1683295731036,TDAC 101,B00,189301,Harting; Carla Kelso,18,0,20,2
1683295732064,TDAC 102,A00,189304,Basso; Beatrice,14,0,20,6
1683295733089,TDAC 108,A00,189305,Staff,18,0,20,2
1683295734113,TDDE 131,A00,189310,Staff,19,0,20,1
1683295734113,TDDE 131,B00,189314,Staff,19,0,20,1
1683295734113,TDDE 131,C00,189315,Staff,48,0,50,2
1683295734113,TDDE 131,D00,189316,Staff,14,0,15,1
1683295734113,TDDE 131,E00,204841,Staff,20,0,20,0
1683295735142,TDGE 10,A00,189289,Staff,30,0,50,20
1683295735142,TDGE 10,B00,189290,Havis; Allan,2,0,50,48
1683295736167,TDGE 11,A00,189291,Fulton; Julia,0,3,50,50
1683295736167,TDGE 11,B00,189292,Staff,20,0,25,5
1683295736167,TDGE 11,C00,260270,Staff,0,0,0,0
1683295737195,TDGE 25,A00,189294,Staff,3,0,20,17
1683295738220,TDGE 124,A00,189318,Fulton; Julia,0,8,50,50
1683295739248,TDGE 125,A00,189319,Staff,13,0,25,12
1683295739248,TDGE 125,B00,189320,Staff,23,0,25,2
1683295740271,TDGE 127,A00,189322,Havis; Allan,0,0,50,50
1683295741310,TDHT 101,A00,189323,Staff,18,0,25,7
1683295741310,TDHT 101,B00,189324,Staff,25,0,25,0
1683295742335,TDHT 102,A00,189325,Staff,49,0,50,1
1683295743361,TDMV 1,A00,189295,Arcidiacono; Kristin,20,0,30,10
1683295743361,TDMV 1,B00,189296,Caligagan; Maria T.,24,0,30,6
1683295744386,TDMV 2,A00,189297,Sammartano; Tonnie,28,0,30,2
1683295744386,TDMV 2,B00,189299,Arcidiacono; Kristin,24,0,30,6
1683295745417,TDMV 3,A00,204998,Rincon; Alicia,22,0,30,8
1683295746442,TDMV 120,A00,189458,Sammartano; Tonnie,28,0,30,2
1683295747471,TDMV 138,A00,189541,Jun; Grace Shin Hae,22,0,40,18
1683295748497,TDMV 142,A00,189717,Caligagan; Tony,23,0,30,7
1683295748497,TDMV 142,B00,189718,Caligagan; Maria T.,25,0,30,5
1683295749534,TMC 2,A01,187533,Staff,25,0,25,0
1683295749534,TMC 2,A02,187534,Staff,25,0,25,0
1683295750563,USP 1,A01,187536,Kwak; Nancy,0,16,25,25
1683295751587,USP 5,A01,187538,Staff,9,0,25,16
1683295752615,USP 101,A00,199253,Staff,0,4,0,0
1683295753642,USP 124,A00,187562,Boomhower; Matthew Charles,1,0,30,29
1683295754666,USP 138,A00,187582,Staff,20,0,25,5
1683295755694,USP 152,A01,187597,Staff,4,0,25,21
1683295756719,USP 153,A00,187598,Staff,19,0,25,6
1683295757747,USP 168,A00,187607,Kwak; Nancy,2,0,5,3
1683295758773,USP 173,A00,187619,Staff,4,0,25,21
1683295759798,USP 181,A00,187638,Staff,0,0,25,25
1683295760824,VIS 103,A00,187650,Cruz; Edwin Teddy,23,0,75,52
1683295761853,VIS 110D,A00,187669,Staff,12,0,22,10
1683295762878,VIS 127C,A00,187720,Shen; Kuiyi,68,0,146,78
1683295763903,VIS 149,A00,187731,Yoldas; Pinar,0,14,22,22
1683295764926,VIS 151,A01,188091,Staff,22,0,34,12
1683295764926,VIS 151,A02,188092,Staff,11,0,34,23
1683295765957,VIS 160B,A00,188093,Stalbaum; Brett,0,0,10,10
1683295768011,WCWP 10B,A00,201720,Staff,10,0,15,5
1683295768011,WCWP 10B,B00,201722,Staff,8,0,15,7
1683295769074,WCWP 100,A00,201725,Gagnon; Jeffrey C,0,0,2,2
1683295769074,WCWP 100,B00,201727,Staff,0,4,15,15
1683295772264,ANBI 133,A00,258401,Wilder; Linnea Lorene,34,0,40,6
1683295773291,ANBI 140,A00,258395,Hrvoj Mihic; Branka,18,0,25,7
1683295774320,ANSC 120,A00,258402,Bialecki; Jon Anthony,27,0,40,13
1683295775343,ANSC 144,A00,258400,Staff,14,0,40,26
1683295777402,ANSC 166,A00,258396,Parish; Steven Martin,157,0,175,18
1683295778428,ANSC 180,A00,193533,Staff,9,0,20,11
1683295779455,ANSC 188,A00,258397,Jassal; Aftab,33,0,40,7
1683295780481,ANTH 3,A01,258316,Staff,23,0,30,7
1683295781506,ANTH 5,A00,258394,Semendeferi; Ekaterini,16,0,20,4
1683295782532,ANTH 21,A01,258331,Staff,9,0,40,31
1683295783558,ANTH 103,A00,258398,Varma; Saiba,15,0,25,10
1683295784588,AWP 10,001,202034,Staff,0,0,0,0
1683295784588,AWP 10,002,202035,Staff,0,0,0,0
1683295784588,AWP 10,003,202036,Staff,0,0,0,0
1683295784588,AWP 10,004,202037,Staff,0,0,0,0
1683295784588,AWP 10,005,202038,Staff,0,0,0,0
1683295784588,AWP 10,006,202039,Staff,0,0,0,0
1683295784588,AWP 10,007,202040,Staff,0,0,0,0
1683295784588,AWP 10,008,202041,Staff,0,0,0,0
1683295784588,AWP 10,009,202042,Staff,0,0,0,0
1683295784588,AWP 10,010,202043,Staff,0,0,0,0
1683295784588,AWP 10,011,202044,Staff,0,0,0,0
1683295784588,AWP 10,012,202045,Staff,0,0,0,0
1683295784588,AWP 10,013,202046,Staff,0,0,0,0
1683295784588,AWP 10,014,202047,Staff,0,0,0,0
1683295784588,AWP 10,015,202048,Staff,0,0,0,0
1683295784588,AWP 10,016,202049,Staff,0,0,0,0
1683295784588,AWP 10,017,202050,Staff,0,0,0,0
1683295784588,AWP 10,018,202051,Staff,0,0,0,0
1683295784588,AWP 10,019,202052,Staff,0,0,0,0
1683295784588,AWP 10,020,202053,Staff,0,0,0,0
1683295784588,AWP 10,021,202054,Staff,0,0,0,0
1683295784588,AWP 10,022,202055,Staff,0,0,0,0
1683295784588,AWP 10,023,202056,Staff,0,0,0,0
1683295784588,AWP 10,024,202057,Staff,0,0,0,0
1683295784588,AWP 10,025,202058,Staff,0,0,0,0
1683295784588,AWP 10,026,202059,Staff,0,0,0,0
1683295785618,AWP 102,001,202032,Staff,0,0,0,0
1683295785618,AWP 102,002,202033,Staff,0,0,0,0
1683295786648,BENG 100,A01,254234,Taylor Amos; Alyssa C,31,0,40,9
1683295787678,BENG 196,001,270013,Engler; Adam J.,9999,0,9999,0
1683295788712,BICD 100R,A01,202018,Smith; Laurie,0,7,32,32
1683295788712,BICD 100R,A02,202019,Smith; Laurie,0,2,32,32
1683295788712,BICD 100R,A03,202020,Smith; Laurie,0,1,32,32
1683295788712,BICD 100R,A04,202021,Smith; Laurie,8,0,32,24
1683295788712,BICD 100R,A05,202022,Smith; Laurie,12,0,32,20
1683295789739,BICD 136,A01,193242,Gustafson-Brown; Cindy,0,2,32,32
1683295789739,BICD 136,A02,193244,Gustafson-Brown; Cindy,15,0,32,17
1683295790772,BIEB 102,A01,193249,Butler; Shannon Rhey,0,2,32,32
1683295790772,BIEB 102,A02,193251,Butler; Shannon Rhey,0,0,32,32
1683295790772,BIEB 102,A03,193253,Butler; Shannon Rhey,0,1,32,32
1683295790772,BIEB 102,A04,193255,Butler; Shannon Rhey,17,0,32,15
1683295790772,BIEB 102,A05,193265,Butler; Shannon Rhey,26,0,32,6
1683295790772,BIEB 102,A06,193269,Butler; Shannon Rhey,16,0,32,16
1683295792826,BIEB 150,A01,193274,Staff,0,0,32,32
1683295792826,BIEB 150,A02,193285,Staff,24,0,32,8
1683295793852,BIEB 194,A00,193286,Kurle; Carolyn M.,22,0,32,10
1683295794877,BILD 1,A01,192291,Staff,16,0,32,16
1683295794877,BILD 1,A02,192292,Staff,30,0,32,2
1683295794877,BILD 1,B01,192520,Reuther; Keefe,0,1,0,0
1683295794877,BILD 1,B02,192532,Reuther; Keefe,0,1,0,0
1683295795904,BILD 3,A01,192556,Butler; Shannon Rhey,0,0,32,32
1683295795904,BILD 3,A02,192581,Butler; Shannon Rhey,5,0,32,27
1683295795904,BILD 3,A03,192611,Butler; Shannon Rhey,23,0,32,9
1683295795904,BILD 3,A04,192612,Butler; Shannon Rhey,25,0,32,7
1683295795904,BILD 3,A05,192613,Butler; Shannon Rhey,27,0,32,5
1683295795904,BILD 3,A06,192679,Butler; Shannon Rhey,27,0,32,5
1683295795904,BILD 3,A07,192682,Butler; Shannon Rhey,22,0,32,10
1683295796934,BILD 4,A01,192836,Reuther; Keefe,1,0,24,23
1683295796934,BILD 4,A02,193044,Reuther; Keefe,4,0,24,20
1683295797957,BILD 10,A01,193142,Gustafson-Brown; Cindy,31,0,32,1
1683295797957,BILD 10,A02,193149,Gustafson-Brown; Cindy,31,0,32,1
1683295798987,BIMM 100,A01,193301,Staff,0,6,32,32
1683295798987,BIMM 100,A02,193312,Staff,0,5,32,32
1683295798987,BIMM 100,A03,193323,Staff,0,8,32,32
1683295800018,BIMM 101,A01,193329,McDonnell; Lisa Marie,0,3,24,24
1683295800018,BIMM 101,A02,193339,McDonnell; Lisa Marie,0,2,24,24
1683295800018,BIMM 101,B01,193354,McDonnell; Lisa Marie,0,3,24,24
1683295800018,BIMM 101,B02,193357,McDonnell; Lisa Marie,0,3,24,24
1683295801054,BIMM 110,A01,193377,Tat; John,0,11,32,32
1683295801054,BIMM 110,A02,193378,Tat; John,1,9,32,31
1683295802090,BIMM 120,A01,206116,Staff,0,0,32,32
1683295802090,BIMM 120,A02,206117,Staff,8,0,32,24
1683295802090,BIMM 120,A03,206121,Staff,21,0,32,11
1683295803120,BIPN 100,A01,193393,Park; Ji Young,0,14,32,32
1683295803120,BIPN 100,A02,193402,Park; Ji Young,0,12,32,32
1683295803120,BIPN 100,A03,193413,Park; Ji Young,0,14,32,32
1683295803120,BIPN 100,A04,193414,Park; Ji Young,0,13,32,32
1683295804146,BIPN 102,A01,193429,Staff,0,0,32,32
1683295804146,BIPN 102,A02,193438,Staff,23,0,32,9
1683295805172,BIPN 106,A01,193450,Reyes Gonzalez; Catalina,0,2,40,40
1683295806203,BIPN 134,A01,193465,Cooke; James Edward,0,0,32,32
1683295806203,BIPN 134,A02,193474,Cooke; James Edward,27,0,32,5
1683295806203,BIPN 134,A03,193485,Cooke; James Edward,29,0,32,3
1683295806203,BIPN 134,A04,193486,Cooke; James Edward,21,0,32,11
1683295806203,BIPN 134,A05,193491,Cooke; James Edward,31,0,32,1
1683295806203,BIPN 134,A06,193501,Cooke; James Edward,30,0,32,2
1683295806203,BIPN 134,A07,193510,Cooke; James Edward,29,0,32,3
1683295808256,BISP 194,A00,222522,Staff,16,0,32,16
1683295809284,CAT 124,A01,202407,Staff,20,0,25,5
1683295810310,CAT 125,A00,202408,Marchisotto; Jennifer Anne,4,0,20,16
1683295811340,CAT 125R,A00,202409,Smith; Lauryn Alissa,0,11,20,20
1683295811340,CAT 125R,B00,202410,Morales; Celeste Georgianna,0,11,20,20
1683295811340,CAT 125R,C00,202411,Irwin; Matthew Joseph,0,10,20,20
1683295812368,CENG 15,A01,204712,Yang; Kesong,0,1,0,0
1683295813394,CENG 114,A00,202070,Jahed Motlagh; Zeinab,5,0,20,15
1683295814419,CGS 105,A00,185477,Wesling; Megan E.,24,0,40,16
1683295815448,CGS 106,A00,185494,Staff,13,0,22,9
1683295816475,CGS 108,A00,185495,Staff,14,0,20,6
1683295817498,CGS 114,A00,185496,Staff,13,0,18,5
1683295818522,CGS 119,A00,185501,Staff,15,0,20,5
1683295819550,CGS 120,A00,185511,Staff,13,0,20,7
1683295820579,CHEM 4,A01,184675,Bussey; Thomas J,96,0,100,4
1683295821604,CHEM 6A,A01,184677,Staff,35,0,60,25
1683295822628,CHEM 6B,A01,184679,Staff,65,0,100,35
1683295823655,CHEM 6C,A01,184681,Bussey; Thomas J,1,0,50,49
1683295823655,CHEM 6C,A02,184682,Bussey; Thomas J,34,0,50,16
1683295824684,CHEM 40A,A01,184684,Albizati; Kim F.,37,0,100,63
1683295825766,CHEM 40B,A01,184686,Albizati; Kim F.,0,20,100,100
1683295826790,CHEM 41B,A01,184690,Staff,52,0,100,48
1683295827819,COGS 3,A01,184715,Boyle; Mary E. T.,0,25,40,40
1683295828849,COGS 14B,A01,185172,Staff,0,15,38,38
1683295829878,COGS 18,A01,184736,Staff,20,0,80,60
1683295830904,COGS 100,A01,184932,Staff,0,5,73,73
1683295831934,COGS 101A,A01,184935,Staff,0,38,30,30
1683295832958,COGS 101B,A01,184944,Staff,0,2,30,30
1683295833982,COGS 101C,A01,184946,Staff,0,12,30,30
1683295835007,COGS 102A,A01,184951,Johnson; Christine M.,2,0,40,38
1683295836032,COGS 107B,A01,184953,Mooshagian; Eric Frederick,0,50,40,40
1683295837058,COGS 118B,A01,184959,Gupta; Anjum,0,48,40,40
1683295838084,COGS 153,A00,184961,Staff,0,15,30,30
1683295839109,COGS 177,A00,184962,Staff,0,21,30,30
1683295840135,COGS 187A,A01,184969,Boyle; Mary E. T.,0,17,40,40
1683295841167,COMM 10,A01,185174,Staff,0,5,25,25
1683295841167,COMM 10,A02,185189,Staff,0,5,25,25
1683295841167,COMM 10,A03,269821,Staff,0,0,0,0
1683295842193,COMM 100B,A01,185475,Staff,0,0,0,2
1683295842193,COMM 100B,A02,185476,Staff,14,0,25,11
1683295843218,COMM 100C,A01,185314,Staff,1,0,25,24
1683295843218,COMM 100C,A02,185327,Staff,19,0,25,6
1683295844243,COMM 110M,A00,185349,Staff,2,0,40,38
1683295845271,COMM 113T,A00,185352,Staff,25,0,40,15
1683295846295,COMM 114I,A00,185353,Staff,33,0,40,7
1683295847321,COMM 131,A00,185354,Staff,19,0,30,11
1683295848345,CSE 8A,A50,185358,Cao; Yingjun,0,46,10,10
1683295849374,CSE 8B,A01,185362,Staff,1,47,50,49
1683295850400,CSE 11,A01,185416,Cao; Yingjun,0,93,10,10
1683295851424,CSE 20,A01,185445,Briones; Jor-el Thomas Caparas,5,0,25,20
1683295852452,CSE 21,A01,185447,Staff,10,0,50,40
1683295853478,CSE 101,A01,185451,Staff,0,12,50,50
1683295853478,CSE 101,B01,185453,Jones; Miles E,0,11,50,50
1683295855530,CSE 141,A01,185458,Eldon; John,20,0,100,80
1683295856555,CSE 141L,A01,185461,Eldon; John,12,0,100,88
1683295857580,CSE 142,A01,185463,Staff,35,0,60,25
1683295857580,CSE 142,B01,201355,Staff,0,6,60,60
1683295858605,CSE 142L,A01,185470,Staff,35,0,60,25
1683295858605,CSE 142L,B01,201417,Staff,0,5,60,60
1683295859630,CSE 190,A00,201433,Staff,32,0,49,17
1683295860655,DOC 1,A01,259136,Strom; Megan C.,8,0,15,7
1683295860655,DOC 1,A02,259137,Strom; Megan C.,14,0,15,1
1683295860655,DOC 1,A03,259138,Strom; Megan C.,14,0,15,1
1683295860655,DOC 1,A04,259139,Strom; Megan C.,14,0,15,1
1683295861684,DOC 100D,A00,259140,Pass; Natalye Joann,17,0,25,8
1683295862710,DSGN 1,A01,184749,Rill; Bryan,0,24,30,30
1683295863735,DSGN 100,A01,185168,Staff,0,2,25,25
1683295864765,ECE 5,A01,185626,Morris; Karcher William,0,10,0,0
1683295865793,ECE 101,A01,185628,Staff,17,0,70,53
1683295866825,ECE 107,A01,185635,Baghdadchi; Saharnaz,0,0,20,20
1683295866825,ECE 107,A02,185638,Baghdadchi; Saharnaz,4,0,20,16
1683295867852,ECE 148,A01,185647,Silberman; Jack,1,0,16,15
1683295868876,ECON 1,A01,185537,Crane; Meredith Helen,54,0,70,16
1683295869901,ECON 3,A01,185549,Crane; Meredith Helen,33,0,70,37
1683295870927,ECON 4,A01,203354,Anderson; John Charles,0,4,10,10
1683295871952,ECON 100A,A01,185574,Staff,0,4,40,40
1683295872981,ECON 100B,A01,185576,Staff,0,22,40,40
1683295874013,ECON 100C,A01,185589,Newhouse; Herbert S,30,0,70,40
1683295875039,ECON 105,A00,185608,Vespa; Emanuel Ignacio,19,0,35,16
1683295876063,ECON 109,A01,185610,Shishkin; Denis,10,0,35,25
1683295877090,ECON 110A,A01,185612,Staff,11,0,40,29
1683295878114,ECON 120A,A01,185615,Staff,20,0,40,20
1683295879145,ECON 120C,A01,185617,Sun; Yixiao,0,20,70,70
1683295880172,ECON 144,A00,203346,Squires; Dale E,3,0,35,32
1683295881199,ECON 171,A01,203349,Newhouse; Herbert S,0,1,35,35
1683295882223,ECON 173A,A01,185621,Toda; Alexis Akira,21,0,35,14
1683295883252,EDS 25,A01,202413,Staff,0,1,0,0
1683295883252,EDS 25,A02,202414,Staff,0,1,0,0
1683295883252,EDS 25,A03,202415,Staff,0,0,0,0
1683295883252,EDS 25,A04,202416,Staff,0,1,0,0
1683295883252,EDS 25,A05,202439,Staff,0,0,0,0
1683295883252,EDS 25,A06,202440,Staff,0,0,0,0
1683295883252,EDS 25,B01,202631,Staff,0,0,0,0
1683295883252,EDS 25,B02,202632,Staff,0,0,0,0
1683295883252,EDS 25,B03,202639,Staff,0,0,0,0
1683295883252,EDS 25,B04,202640,Staff,0,0,0,0
1683295883252,EDS 25,B05,202643,Staff,0,0,0,0
1683295883252,EDS 25,B06,202644,Staff,0,0,0,0
1683295884281,EDS 38,A01,202659,Black; Alison Michelle,24,0,25,1
1683295885309,EDS 115,A00,202652,Staff,17,0,30,13
1683295886334,EDS 125,A00,202649,Staff,14,0,30,16
1683295887359,EDS 126,A01,203332,Staff,30,0,30,0
1683295888383,EDS 139,A00,202838,Staff,17,0,25,8
1683295889408,EDS 146,A01,202655,Staff,15,0,25,10
1683295890434,ENG 15,A00,185667,Staff,0,1,0,0
1683295890434,ENG 15,B00,185672,Staff,0,0,0,0
1683295890434,ENG 15,C00,185675,Staff,0,0,0,0
1683295890434,ENG 15,D00,185682,Staff,0,0,0,0
1683295890434,ENG 15,E00,185684,Staff,0,0,0,0
1683295891459,ETHN 103,A00,185710,Staff,0,3,35,35
1683295892486,ETHN 103A,A00,199228,Man; Simeon S,3,0,9,6
1683295893511,ETHN 109,A00,185711,Staff,18,0,35,17
1683295894538,ETHN 142,A00,185726,Staff,0,4,30,30
1683295895563,ETHN 163J,A00,199229,Man; Simeon S,6,0,8,2
1683295896589,ETHN 168,A00,185727,Staff,8,0,10,2
1683295897616,ETHN 182,A00,185728,Staff,1,0,35,34
1683295898641,ETHN 183,A00,185737,Staff,8,0,18,10
1683295899667,GLBH 111,A01,209361,Burgos; Jose L.,0,0,0,0
1683295901720,HIEU 104,A00,185792,Staff,16,0,20,4
1683295902746,HIEU 115,A00,185800,Staff,1,0,20,19
1683295903771,HIEU 128,A00,185801,Staff,0,7,20,20
1683295904796,HIEU 147,A00,185802,Staff,16,0,20,4
1683295905820,HIEU 154,A00,185823,Staff,12,0,20,8
1683295906849,HILA 102,A00,185826,Staff,13,0,20,7
1683295907874,HILD 2C,A01,185778,Staff,0,12,20,20
1683295908903,HILD 7B,A01,185780,Kwak; Nancy,0,15,32,32
1683295908903,HILD 7B,A02,185781,Kwak; Nancy,0,18,32,32
1683295909928,HILD 30,A01,185791,Staff,14,0,20,6
1683295910953,HISC 119,A00,185830,Golan; Tal,0,9,20,20
1683295911981,HITO 156GS,A00,185831,Patterson; Patrick H.,0,0,0,23
1683295913006,HIUS 103,A00,185832,Man; Simeon S,0,7,20,20
1683295914031,HIUS 117,A00,185836,Kwak; Nancy,2,0,20,18
1683295915057,HIUS 125,A00,185840,Man; Simeon S,0,0,23,23
1683295916083,HIUS 149,A00,185845,Staff,0,0,20,20
1683295917112,HUM 3,A01,185882,Zavodny; Tatiana Sophia,0,6,50,50
1683295917112,HUM 3,B01,185899,Caldwell; Michael Alan,0,19,50,50
1683295918139,HUM 3GS,A00,185900,Patterson; Patrick H.,0,0,0,23
1683295919165,HUM 4,A01,185938,Zroka; Amy Liane,31,0,50,19
1683295919165,HUM 4,B01,185956,Watkins; Eric,0,2,50,50
1683295919165,HUM 4,B02,202209,Watkins; Eric,0,1,50,50
1683295919165,HUM 4,B03,202210,Watkins; Eric,0,0,50,50
1683295920190,HUM 5,A01,185958,West; Geoffrey Scott,5,0,50,45
1683295920190,HUM 5,A02,202215,West; Geoffrey Scott,0,0,50,50
1683295921220,INTL 190,A00,185959,Gagnon; Jeffrey C,0,0,0,9
1683295921220,INTL 190,B00,185960,Lettieri; Michael Joseph,0,0,0,1
1683295922250,JAPN 180,A00,254509,Staff,0,1,25,25
1683295923276,LATI 10,A01,202853,Kennemore; Amy Michelle,5,0,35,30
1683295923276,LATI 10,A02,202854,Kennemore; Amy Michelle,1,0,35,34
1683295923276,LATI 10,A03,270054,Kennemore; Amy Michelle,30,0,30,0
1683295924301,LATI 180,A00,202855,Kennemore; Amy Michelle,11,0,20,9
1683295925327,LAWS 101,A00,201767,Golan; Tal,0,7,40,40
1683295926352,LIFR 1C,A00,185961,Staff,6,0,20,14
1683295927380,LIFR 1CX,A00,185962,Staff,7,0,20,13
1683295928404,LIFR 1D,A00,185963,Staff,9,0,20,11
1683295929486,LIFR 1DX,A00,185964,Staff,9,0,20,11
1683295930515,LIGN 101,A01,186039,Staff,43,0,50,7
1683295931542,LIGN 165,A00,186040,Staff,18,0,50,32
1683295932570,LTCS 108,A00,186041,Staff,6,0,10,4
1683295933598,LTCS 119,A00,186042,Staff,16,0,20,4
1683295934623,LTCS 130,A00,186043,Wesling; Megan E.,15,0,25,10
1683295936674,LTEA 138,A00,186119,Staff,14,0,40,26
1683295937699,LTEN 124,A00,186148,Staff,6,0,25,19
1683295938723,LTEN 178,A00,186149,Staff,7,0,15,8
1683295939749,LTEN 181,A00,186150,Blanco; John D,33,0,40,7
1683295940777,LTWL 120,A00,186160,Staff,20,0,25,5
1683295941804,LTWL 165,A00,186161,Staff,22,0,25,3
1683295942829,LTWR 100,A00,186162,Staff,0,4,15,15
1683295943854,LTWR 102,A00,186163,Doller; Ben,5,0,15,10
1683295944882,MAE 8,A01,186412,Staff,0,0,0,0
1683295945911,MAE 30B,A00,186445,Bahadori; Mohammad Yousef,83,0,100,17
1683295946935,MAE 40,A00,186592,Bewley; Thomas R,9,0,50,41
1683295947963,MAE 101B,A00,186593,Bahadori; Mohammad Yousef,81,0,100,19
1683295948987,MAE 105,A00,186594,Bandaru; Prabhakar,12,0,50,38
1683295950015,MAE 107,A00,186599,Pham; Hieu Tan,0,6,120,120
1683295951039,MAE 148,A01,186660,Silberman; Jack,3,0,16,13
1683295952064,MATH 10A,A01,188095,Staff,0,7,35,35
1683295953088,MATH 10B,A01,188097,Bowers; Adam R.,0,11,30,30
1683295953088,MATH 10B,A02,188099,Bowers; Adam R.,0,9,30,30
1683295953088,MATH 10B,B01,188104,Bowers; Adam R.,0,11,30,30
1683295953088,MATH 10B,B02,188106,Bowers; Adam R.,0,11,30,30
1683295954114,MATH 10C,A01,188111,Staff,0,18,30,30
1683295954114,MATH 10C,A02,188127,Staff,0,17,30,30
1683295954114,MATH 10C,A03,188131,Staff,0,17,30,30
1683295954114,MATH 10C,B01,188218,Staff,21,0,30,9
1683295954114,MATH 10C,B02,188244,Staff,13,0,30,17
1683295954114,MATH 10C,B03,188277,Staff,16,0,30,14
1683295955144,MATH 18,A01,188344,Bach; Quang Tran,18,0,30,12
1683295955144,MATH 18,A02,188345,Bach; Quang Tran,11,0,30,19
1683295955144,MATH 18,B01,188353,Bach; Quang Tran,10,0,30,20
1683295955144,MATH 18,B02,188354,Bach; Quang Tran,20,0,30,10
1683295956168,MATH 20A,A01,188374,Staff,13,0,35,22
1683295957197,MATH 20B,A01,188382,Ohm; Ko Woon,6,0,30,24
1683295957197,MATH 20B,A02,188383,Ohm; Ko Woon,24,0,30,6
1683295957197,MATH 20B,B01,188385,Ohm; Ko Woon,7,0,30,23
1683295957197,MATH 20B,B02,188392,Ohm; Ko Woon,22,0,30,8
1683295958220,MATH 20C,A01,188394,Harel; Guershon,10,0,30,20
1683295958220,MATH 20C,A02,188395,Harel; Guershon,13,0,30,17
1683295958220,MATH 20C,B01,188404,Harel; Guershon,3,0,30,27
1683295958220,MATH 20C,B02,188405,Harel; Guershon,19,0,30,11
1683295959246,MATH 20D,A01,188414,Hammock; Frances H,0,1,30,30
1683295959246,MATH 20D,A02,188415,Hammock; Frances H,4,0,30,26
1683295959246,MATH 20D,B01,188447,Hammock; Frances H,2,0,30,28
1683295959246,MATH 20D,B02,188486,Hammock; Frances H,8,0,30,22
1683295960275,MATH 20E,A01,188649,Staff,22,0,30,8
1683295960275,MATH 20E,A02,188650,Staff,23,0,30,7
1683295960275,MATH 20E,A03,188673,Staff,0,0,30,30
1683295961299,MATH 102,A01,188675,Staff,0,35,35,35
1683295962326,MATH 103B,A01,188681,Staff,4,0,35,31
1683295962326,MATH 103B,B01,188692,Staff,7,0,35,28
1683295963350,MATH 109,A01,188695,Salehi Golsefidy; Alireza,25,0,35,10
1683295963350,MATH 109,A02,188696,Salehi Golsefidy; Alireza,27,0,35,8
1683295964380,MATH 120A,A01,188698,Eggers; John Dietrich,5,0,35,30
1683295965405,MATH 142B,A01,188736,Ioana; Adrian,0,2,30,30
1683295965405,MATH 142B,A02,188741,Ioana; Adrian,0,1,30,30
1683295965405,MATH 142B,A03,188743,Ioana; Adrian,0,3,30,30
1683295966428,MATH 168A,A01,188790,Staff,0,8,35,35
1683295967453,MATH 170A,A01,188803,Nie; Jiawang,0,2,35,35
1683295967453,MATH 170A,A02,188811,Nie; Jiawang,0,0,35,35
1683295967453,MATH 170A,A03,188814,Nie; Jiawang,1,0,35,34
1683295967453,MATH 170A,A04,188815,Nie; Jiawang,14,0,35,21
1683295968481,MATH 193B,A01,188817,Staff,0,0,35,35
1683295968481,MATH 193B,A02,188818,Staff,5,0,35,30
1683295969506,MGT 4,A01,202857,Anderson; John Charles,62,0,80,18
1683295970531,MGT 12,A00,202858,Lindenberger; Wade Douglas,43,0,90,47
1683295971557,MGT 18,A00,202859,Staff,74,0,90,16
1683295972585,MGT 18GS,A00,202860,McKay; Michael J,13,0,28,15
1683295973643,MGT 45,A00,202861,Pecore; Joseph P.,14,0,90,76
1683295974668,MGT 100,A00,202863,Yavorsky; Daniel Ryan,28,0,90,62
1683295975693,MGT 103,A00,202864,Ehrich; Kristine R,0,16,90,90
1683295976723,MGT 112,A00,202865,Ehrich; Kristine R,15,0,90,75
1683295977748,MGT 121A,A00,202868,Staff,0,19,0,0
1683295978773,MGT 131B,A00,202869,Anderson; John Charles,59,0,90,31
1683295979798,MGT 136,A00,202871,Lindenberger; Wade Douglas,84,0,90,6
1683295980827,MGT 164,A00,202873,Staff,0,69,90,90
1683295981852,MGT 164GS,A00,202874,McKay; Mary A,13,0,28,15
1683295982878,MGT 180,A00,202875,Staff,0,51,90,90
1683295983903,MMW 11R,A01,205019,Herbst; Matthew,3,0,30,27
1683295983903,MMW 11R,A02,205026,Herbst; Matthew,29,0,30,1
1683295984929,MMW 15,A01,193512,Chang; Edmond Yi-Teh,0,9,28,28
1683295984929,MMW 15,A02,193513,Chang; Edmond Yi-Teh,0,5,28,28
1683295984929,MMW 15,A03,193514,Chang; Edmond Yi-Teh,0,5,28,28
1683295984929,MMW 15,A04,193515,Chang; Edmond Yi-Teh,0,4,28,28
1683295984929,MMW 15,A05,193516,Chang; Edmond Yi-Teh,0,4,28,28
1683295984929,MMW 15,A06,193517,Chang; Edmond Yi-Teh,0,5,28,28
1683295984929,MMW 15,B01,193519,Chang; Edmond Yi-Teh,0,4,28,28
1683295984929,MMW 15,B02,193520,Chang; Edmond Yi-Teh,0,5,28,28
1683295984929,MMW 15,B03,193521,Chang; Edmond Yi-Teh,0,4,28,28
1683295984929,MMW 15,B04,193522,Chang; Edmond Yi-Teh,0,4,28,28
1683295984929,MMW 15,B05,193523,Chang; Edmond Yi-Teh,0,5,28,28
1683295984929,MMW 15,B06,193524,Chang; Edmond Yi-Teh,0,4,28,28
1683295985958,MMW 122,A01,193526,Rahimi; Babak,0,14,28,28
1683295985958,MMW 122,A02,193527,Rahimi; Babak,0,14,28,28
1683295985958,MMW 122,A03,193528,Rahimi; Babak,0,0,0,0
1683295985958,MMW 122,A04,193529,Rahimi; Babak,0,0,0,0
1683295986983,MUS 1A,A01,186663,Staff,0,20,35,35
1683295988008,MUS 4,A01,186715,Staff,0,12,35,35
1683295989033,MUS 5R,A01,186796,Dubnov; Shlomo,0,16,35,35
1683295990059,MUS 6,A01,186798,Staff,0,3,25,25
1683295991088,MUS 7,A01,186830,Staff,12,0,35,23
1683295992113,MUS 8,A01,186930,Staff,0,25,35,35
1683295993139,MUS 15,A01,186932,Staff,0,15,35,35
1683295993139,MUS 15,B01,186934,Staff,0,14,35,35
1683295994164,MUS 80,A00,186935,Staff,2,0,20,18
1683295994164,MUS 80,B00,186936,Staff,25,0,25,0
1683295995193,NANO 11,A00,204702,Lipomi; Darren John,0,0,0,0
1683295996219,NANO 15,A01,204709,Yang; Kesong,0,1,0,0
1683295997243,NANO 114,A00,202069,Jahed Motlagh; Zeinab,3,0,10,7
1683295998268,PHIL 1,A00,186955,Grush; Rick Scott,32,0,40,8
1683295999296,PHIL 10,A01,186973,Grush; Rick Scott,29,0,35,6
1683295999296,PHIL 10,A02,186974,Grush; Rick Scott,33,0,35,2
1683296000325,PHIL 13,A01,186976,Staff,7,0,35,28
1683296000325,PHIL 13,A02,186977,Staff,16,0,35,19
1683296001353,PHIL 14,A01,186979,Staff,31,0,35,4
1683296001353,PHIL 14,A02,186986,Staff,32,0,35,3
1683296002378,PHIL 28,A01,186988,Staff,16,0,30,14
1683296002378,PHIL 28,A02,186989,Staff,1,0,30,29
1683296002378,PHIL 28,A03,186990,Staff,9,0,30,21
1683296002378,PHIL 28,A04,186991,Staff,26,0,30,4
1683296003406,PHIL 120,A00,186997,Staff,23,0,40,17
1683296004434,PHIL 137,A00,187003,Staff,9,0,40,31
1683296005460,PHIL 150,A00,187015,Staff,47,0,70,23
1683296006485,PHIL 167,A00,187021,Lamey; Andy M.,35,0,40,5
1683296007510,PHIL 174,A01,202226,Staff,17,0,20,3
1683296007510,PHIL 174,A02,202235,Staff,20,0,20,0
1683296008537,PHIL 191A,A00,258918,Staff,0,0,1,1
1683296009564,PHYS 1A,A00,187028,Staff,26,0,60,34
1683296010588,PHYS 1AL,001,187036,Staff,2,0,30,28
1683296010588,PHYS 1AL,002,187049,Staff,18,0,30,12
1683296011614,PHYS 1B,A00,187058,Staff,23,0,60,37
1683296012643,PHYS 1BL,001,187064,Staff,0,0,30,30
1683296012643,PHYS 1BL,002,187070,Staff,6,0,30,24
1683296013670,PHYS 1C,A00,187082,Staff,32,0,120,88
1683296014695,PHYS 1CL,001,187088,Staff,0,9,30,30
1683296014695,PHYS 1CL,002,187089,Staff,0,2,30,30
1683296014695,PHYS 1CL,009,262693,Staff,12,0,30,18
1683296015721,PHYS 2B,A01,187097,Staff,54,0,115,61
1683296016745,PHYS 2C,A01,187099,Staff,67,0,115,48
1683296017774,PHYS 2CL,A01,187101,Staff,5,0,28,23
1683296017774,PHYS 2CL,A02,187102,Staff,15,0,28,13
1683296018802,PHYS 2D,A01,187123,Shotwell; Brian,95,0,115,20
1683296019830,PHYS 4B,A01,187133,Grinstein; Benjamin,35,0,50,15
1683296020855,POLI 10,A00,188819,Staff,0,3,50,50
1683296021883,POLI 11,A00,188827,Staff,43,0,50,7
1683296022908,POLI 13R,A00,188828,Staff,0,1,20,20
1683296023934,POLI 27,A01,188830,Elgin; Samuel Zincke,0,1,70,70
1683296024958,POLI 30,A00,188832,Desposato; Scott,33,0,50,17
1683296025984,POLI 102F,A00,188834,Staff,3,0,40,37
1683296027009,POLI 104A,A00,188852,Staff,14,0,30,16
1683296028033,POLI 104I,A00,188853,Staff,0,6,20,20
1683296029061,POLI 110B,A00,188854,Wiens; David,7,0,20,13
1683296030087,POLI 112A,A00,188855,Wiens; David,5,0,30,25
1683296031112,POLI 117R,A00,188856,Forman; Fonna,0,11,20,20
1683296032141,POLI 118,A00,188857,Ingham; Sean,8,0,20,12
1683296033223,POLI 120G,A00,188858,Staff,9,0,30,21
1683296034249,POLI 131CR,A00,188863,Hoston; Germaine,24,0,50,26
1683296035275,POLI 133,A00,188864,Nellis; Gareth Hb,44,0,50,6
1683296036299,POLI 134D,A00,188865,Desposato; Scott,27,0,30,3
1683296037324,POLI 142A,A00,188871,Gartzke; Erik,22,0,50,28
1683296038348,POLI 142K,A00,188874,Staff,38,0,50,12
1683296039382,POLI 143,A00,188940,Gartzke; Erik,16,0,30,14
1683296040407,POLI 153,A00,188943,Staff,3,0,20,17
1683296041434,POLI 160AA,A00,188944,Staff,13,0,40,27
1683296042461,POLI 170A,A00,188945,Staff,11,0,30,19
1683296044515,PSYC 1,A00,188952,Staff,38,0,90,52
1683296045539,PSYC 2,B00,188953,Staff,20,0,35,15
1683296046568,PSYC 6,A00,188970,Staff,47,0,60,13
1683296047596,PSYC 7,A00,188973,Staff,37,0,45,8
1683296048625,PSYC 60,A01,188980,Rickard; Timothy C.,43,0,60,17
1683296049652,PSYC 70,A01,189001,Steiner; Eric Tomas,24,0,45,21
1683296050677,PSYC 100,A00,189005,Lacefield; Katharine I,0,99,120,120
1683296051705,PSYC 102,A00,189008,Staff,10,0,30,20
1683296052729,PSYC 106,B00,189026,Gorman; Michael R.,37,0,60,23
1683296053754,PSYC 114,B01,189033,Winkielman; Piotr,0,32,30,30
1683296054782,PSYC 131,A00,189036,Anagnostaras; Stephan,0,43,60,60
1683296055806,PSYC 136,A00,189041,Lowe; Angela Beth,0,7,25,25
1683296056831,PSYC 137,A00,189057,Winkielman; Piotr,0,34,25,25
1683296057855,PSYC 144,A00,189107,Wixted; John T,0,7,50,50
1683296059905,PSYC 162,A00,189142,Staff,0,8,85,85
1683296060933,PSYC 172,A00,189144,Gorman; Michael R.,0,7,30,30
1683296062989,PSYC 179,A00,189146,Lacefield; Katharine I,0,84,120,120
1683296064018,PSYC 181,A00,189147,Anagnostaras; Stephan,0,44,90,90
1683296065042,PSYC 190R,A00,189148,Barner; David A.,0,22,80,80
1683296066069,PSYC 191,A00,189275,Rickard; Timothy C.,0,7,25,25
1683296067095,PSYC 193,A00,189276,Chapman; Eddie Nathaniel,0,1,0,4
1683296068123,PSYC 193L,A01,189281,Lowe; Angela Beth,12,0,20,8
1683296068123,PSYC 193L,B01,189285,Staff,28,0,35,7
1683296069147,RELI 149,A00,187137,Rahimi; Babak,7,0,40,33
1683296070176,SE 9,A01,187315,Staff,0,2,18,18
1683296071200,SE 101B,A00,187409,Staff,24,0,30,6
1683296072227,SE 110B,A00,187444,Staff,10,0,40,30
1683296073254,SE 130B,A00,187449,Staff,31,0,40,9
1683296074277,SE 150A,A00,187516,Staff,9,0,20,11
1683296075302,SE 154,A00,187528,Staff,30,0,50,20
1683296076327,SIO 3,A01,258171,Staff,35,0,40,5
1683296077355,SIO 10,A00,187144,Cook; Geoffrey W,0,3,75,75
1683296078382,SIO 45,A00,187152,Cook; Geoffrey W,1,0,100,99
1683296079408,SIO 109R,A00,194486,Staff,0,3,20,20
1683296081458,SIO 187,A01,187233,Kacev; David,12,0,40,28
1683296082484,SOCI 1,A01,258656,Thorpe; Charles Robert,28,0,30,2
1683296082484,SOCI 1,A02,258658,Thorpe; Charles Robert,30,0,30,0
1683296082484,SOCI 1,A03,258661,Thorpe; Charles Robert,25,0,25,0
1683296082484,SOCI 1,A04,258666,Thorpe; Charles Robert,22,0,25,3
1683296082484,SOCI 1,A05,258897,Thorpe; Charles Robert,23,0,25,2
1683296082484,SOCI 1,A06,258898,Thorpe; Charles Robert,25,0,25,0
1683296083510,SOCI 30,A01,258903,Pardo Guerra; Juan Pablo,16,0,30,14
1683296084534,SOCI 102,A00,258904,Staff,9,0,25,16
1683296085558,SOCI 106,A00,258905,Staff,19,0,25,6
1683296086582,SOCI 111,A00,258907,Ribas Norris; Janet Vanesa,26,0,30,4
1683296087610,SOCI 121R,A00,258908,Pardo Guerra; Juan Pablo,11,0,30,19
1683296088638,SOCI 126,A01,203330,Staff,14,0,20,6
1683296089663,SOCI 131,A00,258909,Thorpe; Charles Robert,31,0,60,29
1683296090692,SOCI 135,A00,258910,Payne; Christine Anna,0,9,30,30
1683296091720,SOCI 157,A00,258911,Staff,13,0,30,17
1683296092746,SOCI 184,A00,258912,Staff,26,0,30,4
1683296093773,SOCI 188D,A00,258913,Staff,21,0,30,9
1683296094805,SYN 2,001,187529,Staff,9,0,16,7
1683296094805,SYN 2,002,201452,Staff,0,18,16,16
1683296094805,SYN 2,003,201469,Staff,3,0,16,13
1683296095829,SYN 100,A01,187531,Staff,0,9,20,20
1683296095829,SYN 100,B01,201491,Staff,0,12,20,20
1683296096855,TDAC 1,A00,189286,Walsh; Kim C.,3,0,20,17
1683296096855,TDAC 1,B00,189287,Harting; Carla Kelso,11,0,20,9
1683296097881,TDAC 101,A00,189300,Walsh; Kim C.,16,0,20,4
1683296097881,TDAC 101,B00,189301,Harting; Carla Kelso,18,0,20,2
1683296098910,TDAC 102,A00,189304,Basso; Beatrice,14,0,20,6
1683296099935,TDAC 108,A00,189305,Staff,18,0,20,2
1683296100966,TDDE 131,A00,189310,Staff,19,0,20,1
1683296100966,TDDE 131,B00,189314,Staff,19,0,20,1
1683296100966,TDDE 131,C00,189315,Staff,48,0,50,2
1683296100966,TDDE 131,D00,189316,Staff,14,0,15,1
1683296100966,TDDE 131,E00,204841,Staff,20,0,20,0
1683296101996,TDGE 10,A00,189289,Staff,30,0,50,20
1683296101996,TDGE 10,B00,189290,Havis; Allan,2,0,50,48
1683296103021,TDGE 11,A00,189291,Fulton; Julia,0,3,50,50
1683296103021,TDGE 11,B00,189292,Staff,20,0,25,5
1683296103021,TDGE 11,C00,260270,Staff,0,0,0,0
1683296104044,TDGE 25,A00,189294,Staff,3,0,20,17
1683296105072,TDGE 124,A00,189318,Fulton; Julia,0,8,50,50
1683296106098,TDGE 125,A00,189319,Staff,13,0,25,12
1683296106098,TDGE 125,B00,189320,Staff,23,0,25,2
1683296107122,TDGE 127,A00,189322,Havis; Allan,0,0,50,50
1683296108152,TDHT 101,A00,189323,Staff,18,0,25,7
1683296108152,TDHT 101,B00,189324,Staff,25,0,25,0
1683296109178,TDHT 102,A00,189325,Staff,49,0,50,1
1683296110206,TDMV 1,A00,189295,Arcidiacono; Kristin,20,0,30,10
1683296110206,TDMV 1,B00,189296,Caligagan; Maria T.,24,0,30,6
1683296111236,TDMV 2,A00,189297,Sammartano; Tonnie,28,0,30,2
1683296111236,TDMV 2,B00,189299,Arcidiacono; Kristin,24,0,30,6
1683296112267,TDMV 3,A00,204998,Rincon; Alicia,22,0,30,8
1683296113292,TDMV 120,A00,189458,Sammartano; Tonnie,28,0,30,2
1683296114319,TDMV 138,A00,189541,Jun; Grace Shin Hae,22,0,40,18
1683296115347,TDMV 142,A00,189717,Caligagan; Tony,23,0,30,7
1683296115347,TDMV 142,B00,189718,Caligagan; Maria T.,25,0,30,5
1683296116373,TMC 2,A01,187533,Staff,25,0,25,0
1683296116373,TMC 2,A02,187534,Staff,25,0,25,0
1683296117401,USP 1,A01,187536,Kwak; Nancy,0,16,25,25
1683296118428,USP 5,A01,187538,Staff,9,0,25,16
1683296119454,USP 101,A00,199253,Staff,0,4,0,0
1683296120478,USP 124,A00,187562,Boomhower; Matthew Charles,1,0,30,29
1683296121502,USP 138,A00,187582,Staff,20,0,25,5
1683296122526,USP 152,A01,187597,Staff,4,0,25,21
1683296123552,USP 153,A00,187598,Staff,19,0,25,6
1683296124576,USP 168,A00,187607,Kwak; Nancy,2,0,5,3
1683296125600,USP 173,A00,187619,Staff,4,0,25,21
1683296126625,USP 181,A00,187638,Staff,0,0,25,25
1683296127650,VIS 103,A00,187650,Cruz; Edwin Teddy,23,0,75,52
1683296128679,VIS 110D,A00,187669,Staff,12,0,22,10
1683296129706,VIS 127C,A00,187720,Shen; Kuiyi,68,0,146,78
1683296130731,VIS 149,A00,187731,Yoldas; Pinar,0,14,22,22
1683296131758,VIS 151,A01,188091,Staff,22,0,34,12
1683296131758,VIS 151,A02,188092,Staff,11,0,34,23
1683296132787,VIS 160B,A00,188093,Stalbaum; Brett,0,0,10,10
1683296134840,WCWP 10B,A00,201720,Staff,10,0,15,5
1683296134840,WCWP 10B,B00,201722,Staff,8,0,15,7
1683296135866,WCWP 100,A00,201725,Gagnon; Jeffrey C,0,0,2,2
1683296135866,WCWP 100,B00,201727,Staff,0,4,15,15
1683296139016,ANBI 133,A00,258401,Wilder; Linnea Lorene,34,0,40,6
1683296140044,ANBI 140,A00,258395,Hrvoj Mihic; Branka,18,0,25,7
1683296141068,ANSC 120,A00,258402,Bialecki; Jon Anthony,27,0,40,13
1683296142096,ANSC 144,A00,258400,Staff,14,0,40,26
1683296144151,ANSC 166,A00,258396,Parish; Steven Martin,157,0,175,18
1683296145175,ANSC 180,A00,193533,Staff,9,0,20,11
1683296146199,ANSC 188,A00,258397,Jassal; Aftab,33,0,40,7
1683296147224,ANTH 3,A01,258316,Staff,23,0,30,7
1683296148250,ANTH 5,A00,258394,Semendeferi; Ekaterini,16,0,20,4
1683296149275,ANTH 21,A01,258331,Staff,9,0,40,31
1683296150300,ANTH 103,A00,258398,Varma; Saiba,15,0,25,10
1683296151335,AWP 10,001,202034,Staff,0,0,0,0
1683296151335,AWP 10,002,202035,Staff,0,0,0,0
1683296151335,AWP 10,003,202036,Staff,0,0,0,0
1683296151335,AWP 10,004,202037,Staff,0,0,0,0
1683296151335,AWP 10,005,202038,Staff,0,0,0,0
1683296151335,AWP 10,006,202039,Staff,0,0,0,0
1683296151335,AWP 10,007,202040,Staff,0,0,0,0
1683296151335,AWP 10,008,202041,Staff,0,0,0,0
1683296151335,AWP 10,009,202042,Staff,0,0,0,0
1683296151335,AWP 10,010,202043,Staff,0,0,0,0
1683296151335,AWP 10,011,202044,Staff,0,0,0,0
1683296151335,AWP 10,012,202045,Staff,0,0,0,0
1683296151335,AWP 10,013,202046,Staff,0,0,0,0
1683296151335,AWP 10,014,202047,Staff,0,0,0,0
1683296151335,AWP 10,015,202048,Staff,0,0,0,0
1683296151335,AWP 10,016,202049,Staff,0,0,0,0
1683296151335,AWP 10,017,202050,Staff,0,0,0,0
1683296151335,AWP 10,018,202051,Staff,0,0,0,0
1683296151335,AWP 10,019,202052,Staff,0,0,0,0
1683296151335,AWP 10,020,202053,Staff,0,0,0,0
1683296151335,AWP 10,021,202054,Staff,0,0,0,0
1683296151335,AWP 10,022,202055,Staff,0,0,0,0
1683296151335,AWP 10,023,202056,Staff,0,0,0,0
1683296151335,AWP 10,024,202057,Staff,0,0,0,0
1683296151335,AWP 10,025,202058,Staff,0,0,0,0
1683296151335,AWP 10,026,202059,Staff,0,0,0,0
1683296152366,AWP 102,001,202032,Staff,0,0,0,0
1683296152366,AWP 102,002,202033,Staff,0,0,0,0
1683296153393,BENG 100,A01,254234,Taylor Amos; Alyssa C,31,0,40,9
1683296154416,BENG 196,001,270013,Engler; Adam J.,9999,0,9999,0
1683296155448,BICD 100R,A01,202018,Smith; Laurie,0,7,32,32
1683296155448,BICD 100R,A02,202019,Smith; Laurie,0,2,32,32
1683296155448,BICD 100R,A03,202020,Smith; Laurie,0,1,32,32
1683296155448,BICD 100R,A04,202021,Smith; Laurie,8,0,32,24
1683296155448,BICD 100R,A05,202022,Smith; Laurie,12,0,32,20
1683296156472,BICD 136,A01,193242,Gustafson-Brown; Cindy,0,2,32,32
1683296156472,BICD 136,A02,193244,Gustafson-Brown; Cindy,15,0,32,17
1683296157506,BIEB 102,A01,193249,Butler; Shannon Rhey,0,2,32,32
1683296157506,BIEB 102,A02,193251,Butler; Shannon Rhey,0,0,32,32
1683296157506,BIEB 102,A03,193253,Butler; Shannon Rhey,0,1,32,32
1683296157506,BIEB 102,A04,193255,Butler; Shannon Rhey,17,0,32,15
1683296157506,BIEB 102,A05,193265,Butler; Shannon Rhey,26,0,32,6
1683296157506,BIEB 102,A06,193269,Butler; Shannon Rhey,16,0,32,16
1683296159560,BIEB 150,A01,193274,Staff,0,0,32,32
1683296159560,BIEB 150,A02,193285,Staff,24,0,32,8
1683296160590,BIEB 194,A00,193286,Kurle; Carolyn M.,22,0,32,10
1683296161622,BILD 1,A01,192291,Staff,16,0,32,16
1683296161622,BILD 1,A02,192292,Staff,30,0,32,2
1683296161622,BILD 1,B01,192520,Reuther; Keefe,0,1,0,0
1683296161622,BILD 1,B02,192532,Reuther; Keefe,0,1,0,0
1683296162647,BILD 3,A01,192556,Butler; Shannon Rhey,0,0,32,32
1683296162647,BILD 3,A02,192581,Butler; Shannon Rhey,5,0,32,27
1683296162647,BILD 3,A03,192611,Butler; Shannon Rhey,23,0,32,9
1683296162647,BILD 3,A04,192612,Butler; Shannon Rhey,25,0,32,7
1683296162647,BILD 3,A05,192613,Butler; Shannon Rhey,27,0,32,5
1683296162647,BILD 3,A06,192679,Butler; Shannon Rhey,27,0,32,5
1683296162647,BILD 3,A07,192682,Butler; Shannon Rhey,22,0,32,10
1683296163674,BILD 4,A01,192836,Reuther; Keefe,1,0,24,23
1683296163674,BILD 4,A02,193044,Reuther; Keefe,4,0,24,20
1683296164703,BILD 10,A01,193142,Gustafson-Brown; Cindy,31,0,32,1
1683296164703,BILD 10,A02,193149,Gustafson-Brown; Cindy,31,0,32,1
1683296165729,BIMM 100,A01,193301,Staff,0,6,32,32
1683296165729,BIMM 100,A02,193312,Staff,0,5,32,32
1683296165729,BIMM 100,A03,193323,Staff,0,8,32,32
1683296166757,BIMM 101,A01,193329,McDonnell; Lisa Marie,0,3,24,24
1683296166757,BIMM 101,A02,193339,McDonnell; Lisa Marie,0,2,24,24
1683296166757,BIMM 101,B01,193354,McDonnell; Lisa Marie,0,3,24,24
1683296166757,BIMM 101,B02,193357,McDonnell; Lisa Marie,0,3,24,24
1683296167830,BIMM 110,A01,193377,Tat; John,0,11,32,32
1683296167830,BIMM 110,A02,193378,Tat; John,1,9,32,31
1683296168862,BIMM 120,A01,206116,Staff,0,0,32,32
1683296168862,BIMM 120,A02,206117,Staff,8,0,32,24
1683296168862,BIMM 120,A03,206121,Staff,21,0,32,11
1683296169893,BIPN 100,A01,193393,Park; Ji Young,0,14,32,32
1683296169893,BIPN 100,A02,193402,Park; Ji Young,0,12,32,32
1683296169893,BIPN 100,A03,193413,Park; Ji Young,0,14,32,32
1683296169893,BIPN 100,A04,193414,Park; Ji Young,0,13,32,32
1683296170922,BIPN 102,A01,193429,Staff,0,0,32,32
1683296170922,BIPN 102,A02,193438,Staff,23,0,32,9
1683296171951,BIPN 106,A01,193450,Reyes Gonzalez; Catalina,0,2,40,40
1683296172978,BIPN 134,A01,193465,Cooke; James Edward,0,0,32,32
1683296172978,BIPN 134,A02,193474,Cooke; James Edward,27,0,32,5
1683296172978,BIPN 134,A03,193485,Cooke; James Edward,29,0,32,3
1683296172978,BIPN 134,A04,193486,Cooke; James Edward,21,0,32,11
1683296172978,BIPN 134,A05,193491,Cooke; James Edward,31,0,32,1
1683296172978,BIPN 134,A06,193501,Cooke; James Edward,30,0,32,2
1683296172978,BIPN 134,A07,193510,Cooke; James Edward,29,0,32,3
1683296175031,BISP 194,A00,222522,Staff,16,0,32,16
1683296176060,CAT 124,A01,202407,Staff,20,0,25,5
1683296177090,CAT 125,A00,202408,Marchisotto; Jennifer Anne,4,0,20,16
1683296178127,CAT 125R,A00,202409,Smith; Lauryn Alissa,0,11,20,20
1683296178127,CAT 125R,B00,202410,Morales; Celeste Georgianna,0,11,20,20
1683296178127,CAT 125R,C00,202411,Irwin; Matthew Joseph,0,10,20,20
1683296179152,CENG 15,A01,204712,Yang; Kesong,0,1,0,0
1683296180178,CENG 114,A00,202070,Jahed Motlagh; Zeinab,5,0,20,15
1683296181210,CGS 105,A00,185477,Wesling; Megan E.,24,0,40,16
1683296182235,CGS 106,A00,185494,Staff,13,0,22,9
1683296183263,CGS 108,A00,185495,Staff,14,0,20,6
1683296184292,CGS 114,A00,185496,Staff,13,0,18,5
1683296185320,CGS 119,A00,185501,Staff,15,0,20,5
1683296186345,CGS 120,A00,185511,Staff,13,0,20,7
1683296187371,CHEM 4,A01,184675,Bussey; Thomas J,96,0,100,4
1683296188395,CHEM 6A,A01,184677,Staff,35,0,60,25
1683296189424,CHEM 6B,A01,184679,Staff,65,0,100,35
1683296190450,CHEM 6C,A01,184681,Bussey; Thomas J,1,0,50,49
1683296190450,CHEM 6C,A02,184682,Bussey; Thomas J,34,0,50,16
1683296191476,CHEM 40A,A01,184684,Albizati; Kim F.,37,0,100,63
1683296192503,CHEM 40B,A01,184686,Albizati; Kim F.,0,20,100,100
1683296193528,CHEM 41B,A01,184690,Staff,52,0,100,48
1683296194553,COGS 3,A01,184715,Boyle; Mary E. T.,0,25,40,40
1683296195583,COGS 14B,A01,185172,Staff,0,15,38,38
1683296196609,COGS 18,A01,184736,Staff,20,0,80,60
1683296197635,COGS 100,A01,184932,Staff,0,5,73,73
1683296198663,COGS 101A,A01,184935,Staff,0,38,30,30
1683296199691,COGS 101B,A01,184944,Staff,0,2,30,30
1683296200716,COGS 101C,A01,184946,Staff,0,12,30,30
1683296201749,COGS 102A,A01,184951,Johnson; Christine M.,2,0,40,38
1683296202776,COGS 107B,A01,184953,Mooshagian; Eric Frederick,0,50,40,40
1683296203801,COGS 118B,A01,184959,Gupta; Anjum,0,48,40,40
1683296204826,COGS 153,A00,184961,Staff,0,15,30,30
1683296205851,COGS 177,A00,184962,Staff,0,21,30,30
1683296206879,COGS 187A,A01,184969,Boyle; Mary E. T.,0,17,40,40
1683296207905,COMM 10,A01,185174,Staff,0,5,25,25
1683296207905,COMM 10,A02,185189,Staff,0,5,25,25
1683296207905,COMM 10,A03,269821,Staff,0,0,0,0
1683296208935,COMM 100B,A01,185475,Staff,0,0,0,2
1683296208935,COMM 100B,A02,185476,Staff,14,0,25,11
1683296209961,COMM 100C,A01,185314,Staff,1,0,25,24
1683296209961,COMM 100C,A02,185327,Staff,19,0,25,6
1683296210989,COMM 110M,A00,185349,Staff,2,0,40,38
1683296212014,COMM 113T,A00,185352,Staff,25,0,40,15
1683296213039,COMM 114I,A00,185353,Staff,33,0,40,7
1683296214066,COMM 131,A00,185354,Staff,19,0,30,11
1683296215093,CSE 8A,A50,185358,Cao; Yingjun,0,46,10,10
1683296216118,CSE 8B,A01,185362,Staff,1,47,50,49
1683296217148,CSE 11,A01,185416,Cao; Yingjun,0,93,10,10
1683296218176,CSE 20,A01,185445,Briones; Jor-el Thomas Caparas,5,0,25,20
1683296219206,CSE 21,A01,185447,Staff,10,0,50,40
1683296220235,CSE 101,A01,185451,Staff,0,12,50,50
1683296220235,CSE 101,B01,185453,Jones; Miles E,0,11,50,50
1683296222288,CSE 141,A01,185458,Eldon; John,20,0,100,80
1683296223314,CSE 141L,A01,185461,Eldon; John,12,0,100,88
1683296224343,CSE 142,A01,185463,Staff,35,0,60,25
1683296224343,CSE 142,B01,201355,Staff,0,6,60,60
1683296225369,CSE 142L,A01,185470,Staff,35,0,60,25
1683296225369,CSE 142L,B01,201417,Staff,0,5,60,60
1683296226398,CSE 190,A00,201433,Staff,32,0,49,17
1683296227423,DOC 1,A01,259136,Strom; Megan C.,8,0,15,7
1683296227423,DOC 1,A02,259137,Strom; Megan C.,14,0,15,1
1683296227423,DOC 1,A03,259138,Strom; Megan C.,14,0,15,1
1683296227423,DOC 1,A04,259139,Strom; Megan C.,14,0,15,1
1683296228448,DOC 100D,A00,259140,Pass; Natalye Joann,17,0,25,8
1683296229473,DSGN 1,A01,184749,Rill; Bryan,0,24,30,30
1683296230497,DSGN 100,A01,185168,Staff,0,2,25,25
1683296231522,ECE 5,A01,185626,Morris; Karcher William,0,10,0,0
1683296232547,ECE 101,A01,185628,Staff,17,0,70,53
1683296233576,ECE 107,A01,185635,Baghdadchi; Saharnaz,0,0,20,20
1683296233576,ECE 107,A02,185638,Baghdadchi; Saharnaz,4,0,20,16
1683296234601,ECE 148,A01,185647,Silberman; Jack,1,0,16,15
1683296235626,ECON 1,A01,185537,Crane; Meredith Helen,54,0,70,16
1683296236654,ECON 3,A01,185549,Crane; Meredith Helen,33,0,70,37
1683296237683,ECON 4,A01,203354,Anderson; John Charles,0,4,10,10
1683296238710,ECON 100A,A01,185574,Staff,0,4,40,40
1683296239735,ECON 100B,A01,185576,Staff,0,22,40,40
1683296240817,ECON 100C,A01,185589,Newhouse; Herbert S,30,0,70,40
1683296241843,ECON 105,A00,185608,Vespa; Emanuel Ignacio,19,0,35,16
1683296242867,ECON 109,A01,185610,Shishkin; Denis,10,0,35,25
1683296243894,ECON 110A,A01,185612,Staff,11,0,40,29
1683296244921,ECON 120A,A01,185615,Staff,20,0,40,20
1683296245948,ECON 120C,A01,185617,Sun; Yixiao,0,20,70,70
1683296246978,ECON 144,A00,203346,Squires; Dale E,3,0,35,32
1683296248008,ECON 171,A01,203349,Newhouse; Herbert S,0,1,35,35
1683296249034,ECON 173A,A01,185621,Toda; Alexis Akira,21,0,35,14
1683296250063,EDS 25,A01,202413,Staff,0,1,0,0
1683296250063,EDS 25,A02,202414,Staff,0,1,0,0
1683296250063,EDS 25,A03,202415,Staff,0,0,0,0
1683296250063,EDS 25,A04,202416,Staff,0,1,0,0
1683296250063,EDS 25,A05,202439,Staff,0,0,0,0
1683296250063,EDS 25,A06,202440,Staff,0,0,0,0
1683296250063,EDS 25,B01,202631,Staff,0,0,0,0
1683296250063,EDS 25,B02,202632,Staff,0,0,0,0
1683296250063,EDS 25,B03,202639,Staff,0,0,0,0
1683296250063,EDS 25,B04,202640,Staff,0,0,0,0
1683296250063,EDS 25,B05,202643,Staff,0,0,0,0
1683296250063,EDS 25,B06,202644,Staff,0,0,0,0
1683296251088,EDS 38,A01,202659,Black; Alison Michelle,24,0,25,1
1683296252113,EDS 115,A00,202652,Staff,17,0,30,13
1683296253141,EDS 125,A00,202649,Staff,14,0,30,16
1683296254164,EDS 126,A01,203332,Staff,30,0,30,0
1683296255189,EDS 139,A00,202838,Staff,17,0,25,8
1683296256211,EDS 146,A01,202655,Staff,15,0,25,10
1683296257241,ENG 15,A00,185667,Staff,0,1,0,0
1683296257241,ENG 15,B00,185672,Staff,0,0,0,0
1683296257241,ENG 15,C00,185675,Staff,0,0,0,0
1683296257241,ENG 15,D00,185682,Staff,0,0,0,0
1683296257241,ENG 15,E00,185684,Staff,0,0,0,0
1683296258266,ETHN 103,A00,185710,Staff,0,3,35,35
1683296259295,ETHN 103A,A00,199228,Man; Simeon S,3,0,9,6
1683296260323,ETHN 109,A00,185711,Staff,18,0,35,17
1683296261348,ETHN 142,A00,185726,Staff,0,4,30,30
1683296262376,ETHN 163J,A00,199229,Man; Simeon S,6,0,8,2
1683296263400,ETHN 168,A00,185727,Staff,8,0,10,2
1683296264424,ETHN 182,A00,185728,Staff,1,0,35,34
1683296265451,ETHN 183,A00,185737,Staff,8,0,18,10
1683296266477,GLBH 111,A01,209361,Burgos; Jose L.,0,0,0,0
1683296268532,HIEU 104,A00,185792,Staff,16,0,20,4
1683296269560,HIEU 115,A00,185800,Staff,1,0,20,19
1683296270584,HIEU 128,A00,185801,Staff,0,7,20,20
1683296271610,HIEU 147,A00,185802,Staff,16,0,20,4
1683296272638,HIEU 154,A00,185823,Staff,12,0,20,8
1683296273666,HILA 102,A00,185826,Staff,13,0,20,7
1683296274694,HILD 2C,A01,185778,Staff,0,12,20,20
1683296275719,HILD 7B,A01,185780,Kwak; Nancy,0,15,32,32
1683296275719,HILD 7B,A02,185781,Kwak; Nancy,0,18,32,32
1683296276743,HILD 30,A01,185791,Staff,14,0,20,6
1683296277769,HISC 119,A00,185830,Golan; Tal,0,9,20,20
1683296278798,HITO 156GS,A00,185831,Patterson; Patrick H.,0,0,0,23
1683296279826,HIUS 103,A00,185832,Man; Simeon S,0,7,20,20
1683296280851,HIUS 117,A00,185836,Kwak; Nancy,2,0,20,18
1683296281879,HIUS 125,A00,185840,Man; Simeon S,0,0,23,23
1683296282904,HIUS 149,A00,185845,Staff,0,0,20,20
1683296283931,HUM 3,A01,185882,Zavodny; Tatiana Sophia,0,6,50,50
1683296283931,HUM 3,B01,185899,Caldwell; Michael Alan,0,19,50,50
1683296284959,HUM 3GS,A00,185900,Patterson; Patrick H.,0,0,0,23
1683296285993,HUM 4,A01,185938,Zroka; Amy Liane,31,0,50,19
1683296285993,HUM 4,B01,185956,Watkins; Eric,0,2,50,50
1683296285993,HUM 4,B02,202209,Watkins; Eric,0,1,50,50
1683296285993,HUM 4,B03,202210,Watkins; Eric,0,0,50,50
1683296287018,HUM 5,A01,185958,West; Geoffrey Scott,5,0,50,45
1683296287018,HUM 5,A02,202215,West; Geoffrey Scott,0,0,50,50
1683296288048,INTL 190,A00,185959,Gagnon; Jeffrey C,0,0,0,9
1683296288048,INTL 190,B00,185960,Lettieri; Michael Joseph,0,0,0,1
1683296289073,JAPN 180,A00,254509,Staff,0,1,25,25
1683296290099,LATI 10,A01,202853,Kennemore; Amy Michelle,5,0,35,30
1683296290099,LATI 10,A02,202854,Kennemore; Amy Michelle,1,0,35,34
1683296290099,LATI 10,A03,270054,Kennemore; Amy Michelle,30,0,30,0
1683296291123,LATI 180,A00,202855,Kennemore; Amy Michelle,11,0,20,9
1683296292148,LAWS 101,A00,201767,Golan; Tal,0,7,40,40
1683296293176,LIFR 1C,A00,185961,Staff,6,0,20,14
1683296294200,LIFR 1CX,A00,185962,Staff,7,0,20,13
1683296295225,LIFR 1D,A00,185963,Staff,9,0,20,11
1683296296249,LIFR 1DX,A00,185964,Staff,9,0,20,11
1683296297273,LIGN 101,A01,186039,Staff,43,0,50,7
1683296298298,LIGN 165,A00,186040,Staff,18,0,50,32
1683296299322,LTCS 108,A00,186041,Staff,6,0,10,4
1683296300358,LTCS 119,A00,186042,Staff,16,0,20,4
1683296301383,LTCS 130,A00,186043,Wesling; Megan E.,15,0,25,10
1683296303435,LTEA 138,A00,186119,Staff,14,0,40,26
1683296304460,LTEN 124,A00,186148,Staff,6,0,25,19
1683296305485,LTEN 178,A00,186149,Staff,7,0,15,8
1683296306511,LTEN 181,A00,186150,Blanco; John D,33,0,40,7
1683296307538,LTWL 120,A00,186160,Staff,20,0,25,5
1683296308562,LTWL 165,A00,186161,Staff,22,0,25,3
1683296309590,LTWR 100,A00,186162,Staff,0,4,15,15
1683296310618,LTWR 102,A00,186163,Doller; Ben,5,0,15,10
1683296311644,MAE 8,A01,186412,Staff,0,0,0,0
1683296312668,MAE 30B,A00,186445,Bahadori; Mohammad Yousef,83,0,100,17
1683296313694,MAE 40,A00,186592,Bewley; Thomas R,9,0,50,41
1683296314719,MAE 101B,A00,186593,Bahadori; Mohammad Yousef,81,0,100,19
1683296315744,MAE 105,A00,186594,Bandaru; Prabhakar,12,0,50,38
1683296316775,MAE 107,A00,186599,Pham; Hieu Tan,0,6,120,120
1683296317801,MAE 148,A01,186660,Silberman; Jack,3,0,16,13
1683296318826,MATH 10A,A01,188095,Staff,0,7,35,35
1683296319857,MATH 10B,A01,188097,Bowers; Adam R.,0,11,30,30
1683296319857,MATH 10B,A02,188099,Bowers; Adam R.,0,9,30,30
1683296319857,MATH 10B,B01,188104,Bowers; Adam R.,0,11,30,30
1683296319857,MATH 10B,B02,188106,Bowers; Adam R.,0,11,30,30
1683296320883,MATH 10C,A01,188111,Staff,0,18,30,30
1683296320883,MATH 10C,A02,188127,Staff,0,17,30,30
1683296320883,MATH 10C,A03,188131,Staff,0,17,30,30
1683296320883,MATH 10C,B01,188218,Staff,21,0,30,9
1683296320883,MATH 10C,B02,188244,Staff,13,0,30,17
1683296320883,MATH 10C,B03,188277,Staff,16,0,30,14
1683296321915,MATH 18,A01,188344,Bach; Quang Tran,18,0,30,12
1683296321915,MATH 18,A02,188345,Bach; Quang Tran,11,0,30,19
1683296321915,MATH 18,B01,188353,Bach; Quang Tran,10,0,30,20
1683296321915,MATH 18,B02,188354,Bach; Quang Tran,20,0,30,10
1683296322940,MATH 20A,A01,188374,Staff,13,0,35,22
1683296323972,MATH 20B,A01,188382,Ohm; Ko Woon,6,0,30,24
1683296323972,MATH 20B,A02,188383,Ohm; Ko Woon,24,0,30,6
1683296323972,MATH 20B,B01,188385,Ohm; Ko Woon,7,0,30,23
1683296323972,MATH 20B,B02,188392,Ohm; Ko Woon,22,0,30,8
1683296325002,MATH 20C,A01,188394,Harel; Guershon,10,0,30,20
1683296325002,MATH 20C,A02,188395,Harel; Guershon,13,0,30,17
1683296325002,MATH 20C,B01,188404,Harel; Guershon,3,0,30,27
1683296325002,MATH 20C,B02,188405,Harel; Guershon,19,0,30,11
1683296326033,MATH 20D,A01,188414,Hammock; Frances H,0,1,30,30
1683296326033,MATH 20D,A02,188415,Hammock; Frances H,4,0,30,26
1683296326033,MATH 20D,B01,188447,Hammock; Frances H,2,0,30,28
1683296326033,MATH 20D,B02,188486,Hammock; Frances H,8,0,30,22
1683296327063,MATH 20E,A01,188649,Staff,22,0,30,8
1683296327063,MATH 20E,A02,188650,Staff,23,0,30,7
1683296327063,MATH 20E,A03,188673,Staff,0,0,30,30
1683296328090,MATH 102,A01,188675,Staff,0,35,35,35
1683296329115,MATH 103B,A01,188681,Staff,4,0,35,31
1683296329115,MATH 103B,B01,188692,Staff,7,0,35,28
1683296330146,MATH 109,A01,188695,Salehi Golsefidy; Alireza,25,0,35,10
1683296330146,MATH 109,A02,188696,Salehi Golsefidy; Alireza,27,0,35,8
1683296331179,MATH 120A,A01,188698,Eggers; John Dietrich,5,0,35,30
1683296332205,MATH 142B,A01,188736,Ioana; Adrian,0,2,30,30
1683296332205,MATH 142B,A02,188741,Ioana; Adrian,0,1,30,30
1683296332205,MATH 142B,A03,188743,Ioana; Adrian,0,3,30,30
1683296333235,MATH 168A,A01,188790,Staff,0,8,35,35
1683296334268,MATH 170A,A01,188803,Nie; Jiawang,0,2,35,35
1683296334268,MATH 170A,A02,188811,Nie; Jiawang,0,0,35,35
1683296334268,MATH 170A,A03,188814,Nie; Jiawang,1,0,35,34
1683296334268,MATH 170A,A04,188815,Nie; Jiawang,14,0,35,21
1683296335295,MATH 193B,A01,188817,Staff,0,0,35,35
1683296335295,MATH 193B,A02,188818,Staff,5,0,35,30
1683296336320,MGT 4,A01,202857,Anderson; John Charles,62,0,80,18
1683296337349,MGT 12,A00,202858,Lindenberger; Wade Douglas,43,0,90,47
1683296338374,MGT 18,A00,202859,Staff,74,0,90,16
1683296339399,MGT 18GS,A00,202860,McKay; Michael J,13,0,28,15
1683296340424,MGT 45,A00,202861,Pecore; Joseph P.,14,0,90,76
1683296341449,MGT 100,A00,202863,Yavorsky; Daniel Ryan,28,0,90,62
1683296342477,MGT 103,A00,202864,Ehrich; Kristine R,0,16,90,90
1683296343502,MGT 112,A00,202865,Ehrich; Kristine R,15,0,90,75
1683296344585,MGT 121A,A00,202868,Staff,0,19,0,0
1683296345610,MGT 131B,A00,202869,Anderson; John Charles,59,0,90,31
1683296346640,MGT 136,A00,202871,Lindenberger; Wade Douglas,84,0,90,6
1683296347664,MGT 164,A00,202873,Staff,0,69,90,90
1683296348693,MGT 164GS,A00,202874,McKay; Mary A,13,0,28,15
1683296349718,MGT 180,A00,202875,Staff,0,51,90,90
1683296350744,MMW 11R,A01,205019,Herbst; Matthew,3,0,30,27
1683296350744,MMW 11R,A02,205026,Herbst; Matthew,29,0,30,1
1683296351772,MMW 15,A01,193512,Chang; Edmond Yi-Teh,0,9,28,28
1683296351772,MMW 15,A02,193513,Chang; Edmond Yi-Teh,0,5,28,28
1683296351772,MMW 15,A03,193514,Chang; Edmond Yi-Teh,0,5,28,28
1683296351772,MMW 15,A04,193515,Chang; Edmond Yi-Teh,0,4,28,28
1683296351772,MMW 15,A05,193516,Chang; Edmond Yi-Teh,0,4,28,28
1683296351772,MMW 15,A06,193517,Chang; Edmond Yi-Teh,0,5,28,28
1683296351772,MMW 15,B01,193519,Chang; Edmond Yi-Teh,0,4,28,28
1683296351772,MMW 15,B02,193520,Chang; Edmond Yi-Teh,0,5,28,28
1683296351772,MMW 15,B03,193521,Chang; Edmond Yi-Teh,0,4,28,28
1683296351772,MMW 15,B04,193522,Chang; Edmond Yi-Teh,0,4,28,28
1683296351772,MMW 15,B05,193523,Chang; Edmond Yi-Teh,0,5,28,28
1683296351772,MMW 15,B06,193524,Chang; Edmond Yi-Teh,0,4,28,28
1683296352802,MMW 122,A01,193526,Rahimi; Babak,0,14,28,28
1683296352802,MMW 122,A02,193527,Rahimi; Babak,0,14,28,28
1683296352802,MMW 122,A03,193528,Rahimi; Babak,0,0,0,0
1683296352802,MMW 122,A04,193529,Rahimi; Babak,0,0,0,0
1683296353828,MUS 1A,A01,186663,Staff,0,20,35,35
1683296354854,MUS 4,A01,186715,Staff,0,12,35,35
1683296355883,MUS 5R,A01,186796,Dubnov; Shlomo,0,16,35,35
1683296356907,MUS 6,A01,186798,Staff,0,3,25,25
1683296357934,MUS 7,A01,186830,Staff,12,0,35,23
1683296358959,MUS 8,A01,186930,Staff,0,25,35,35
1683296359989,MUS 15,A01,186932,Staff,0,15,35,35
1683296359989,MUS 15,B01,186934,Staff,0,14,35,35
1683296361015,MUS 80,A00,186935,Staff,2,0,20,18
1683296361015,MUS 80,B00,186936,Staff,25,0,25,0
1683296362041,NANO 11,A00,204702,Lipomi; Darren John,0,0,0,0
1683296363071,NANO 15,A01,204709,Yang; Kesong,0,1,0,0
1683296364100,NANO 114,A00,202069,Jahed Motlagh; Zeinab,3,0,10,7
1683296365126,PHIL 1,A00,186955,Grush; Rick Scott,32,0,40,8
1683296366151,PHIL 10,A01,186973,Grush; Rick Scott,29,0,35,6
1683296366151,PHIL 10,A02,186974,Grush; Rick Scott,33,0,35,2
1683296367178,PHIL 13,A01,186976,Staff,7,0,35,28
1683296367178,PHIL 13,A02,186977,Staff,16,0,35,19
1683296368203,PHIL 14,A01,186979,Staff,31,0,35,4
1683296368203,PHIL 14,A02,186986,Staff,32,0,35,3
1683296369227,PHIL 28,A01,186988,Staff,16,0,30,14
1683296369227,PHIL 28,A02,186989,Staff,1,0,30,29
1683296369227,PHIL 28,A03,186990,Staff,9,0,30,21
1683296369227,PHIL 28,A04,186991,Staff,26,0,30,4
1683296370254,PHIL 120,A00,186997,Staff,23,0,40,17
1683296371284,PHIL 137,A00,187003,Staff,9,0,40,31
1683296372308,PHIL 150,A00,187015,Staff,47,0,70,23
1683296373335,PHIL 167,A00,187021,Lamey; Andy M.,35,0,40,5
1683296374361,PHIL 174,A01,202226,Staff,17,0,20,3
1683296374361,PHIL 174,A02,202235,Staff,20,0,20,0
1683296375388,PHIL 191A,A00,258918,Staff,0,0,1,1
1683296376413,PHYS 1A,A00,187028,Staff,26,0,60,34
1683296377438,PHYS 1AL,001,187036,Staff,2,0,30,28
1683296377438,PHYS 1AL,002,187049,Staff,18,0,30,12
1683296378464,PHYS 1B,A00,187058,Staff,23,0,60,37
1683296379493,PHYS 1BL,001,187064,Staff,0,0,30,30
1683296379493,PHYS 1BL,002,187070,Staff,6,0,30,24
1683296380518,PHYS 1C,A00,187082,Staff,32,0,120,88
1683296381550,PHYS 1CL,001,187088,Staff,0,9,30,30
1683296381550,PHYS 1CL,002,187089,Staff,0,2,30,30
1683296381550,PHYS 1CL,009,262693,Staff,12,0,30,18
1683296382575,PHYS 2B,A01,187097,Staff,54,0,115,61
1683296383603,PHYS 2C,A01,187099,Staff,67,0,115,48
1683296384632,PHYS 2CL,A01,187101,Staff,5,0,28,23
1683296384632,PHYS 2CL,A02,187102,Staff,15,0,28,13
1683296385657,PHYS 2D,A01,187123,Shotwell; Brian,95,0,115,20
1683296386683,PHYS 4B,A01,187133,Grinstein; Benjamin,35,0,50,15
1683296387710,POLI 10,A00,188819,Staff,0,3,50,50
1683296388735,POLI 11,A00,188827,Staff,43,0,50,7
1683296389759,POLI 13R,A00,188828,Staff,0,1,20,20
1683296390790,POLI 27,A01,188830,Elgin; Samuel Zincke,0,1,70,70
1683296391815,POLI 30,A00,188832,Desposato; Scott,33,0,50,17
1683296392841,POLI 102F,A00,188834,Staff,3,0,40,37
1683296393866,POLI 104A,A00,188852,Staff,14,0,30,16
1683296394891,POLI 104I,A00,188853,Staff,0,6,20,20
1683296395916,POLI 110B,A00,188854,Wiens; David,7,0,20,13
1683296396944,POLI 112A,A00,188855,Wiens; David,5,0,30,25
1683296397969,POLI 117R,A00,188856,Forman; Fonna,0,11,20,20
1683296398995,POLI 118,A00,188857,Ingham; Sean,8,0,20,12
1683296400018,POLI 120G,A00,188858,Staff,9,0,30,21
1683296401042,POLI 131CR,A00,188863,Hoston; Germaine,24,0,50,26
1683296402069,POLI 133,A00,188864,Nellis; Gareth Hb,44,0,50,6
1683296403096,POLI 134D,A00,188865,Desposato; Scott,27,0,30,3
1683296404125,POLI 142A,A00,188871,Gartzke; Erik,22,0,50,28
1683296405149,POLI 142K,A00,188874,Staff,38,0,50,12
1683296406178,POLI 143,A00,188940,Gartzke; Erik,16,0,30,14
1683296407207,POLI 153,A00,188943,Staff,3,0,20,17
1683296408233,POLI 160AA,A00,188944,Staff,13,0,40,27
1683296409259,POLI 170A,A00,188945,Staff,11,0,30,19
1683296411309,PSYC 1,A00,188952,Staff,38,0,90,52
1683296412334,PSYC 2,B00,188953,Staff,20,0,35,15
1683296413358,PSYC 6,A00,188970,Staff,47,0,60,13
1683296414386,PSYC 7,A00,188973,Staff,37,0,45,8
1683296415416,PSYC 60,A01,188980,Rickard; Timothy C.,43,0,60,17
1683296416444,PSYC 70,A01,189001,Steiner; Eric Tomas,24,0,45,21
1683296417474,PSYC 100,A00,189005,Lacefield; Katharine I,0,99,120,120
1683296418498,PSYC 102,A00,189008,Staff,10,0,30,20
1683296419523,PSYC 106,B00,189026,Gorman; Michael R.,37,0,60,23
1683296420554,PSYC 114,B01,189033,Winkielman; Piotr,0,32,30,30
1683296421587,PSYC 131,A00,189036,Anagnostaras; Stephan,0,43,60,60
1683296422615,PSYC 136,A00,189041,Lowe; Angela Beth,0,7,25,25
1683296423646,PSYC 137,A00,189057,Winkielman; Piotr,0,34,25,25
1683296424674,PSYC 144,A00,189107,Wixted; John T,0,7,50,50
1683296426722,PSYC 162,A00,189142,Staff,0,8,85,85
1683296427747,PSYC 172,A00,189144,Gorman; Michael R.,0,7,30,30
1683296429799,PSYC 179,A00,189146,Lacefield; Katharine I,0,84,120,120
1683296430824,PSYC 181,A00,189147,Anagnostaras; Stephan,0,44,90,90
1683296431853,PSYC 190R,A00,189148,Barner; David A.,0,22,80,80
1683296432878,PSYC 191,A00,189275,Rickard; Timothy C.,0,7,25,25
1683296433903,PSYC 193,A00,189276,Chapman; Eddie Nathaniel,0,1,0,4
1683296434933,PSYC 193L,A01,189281,Lowe; Angela Beth,12,0,20,8
1683296434933,PSYC 193L,B01,189285,Staff,28,0,35,7
1683296435960,RELI 149,A00,187137,Rahimi; Babak,7,0,40,33
1683296436986,SE 9,A01,187315,Staff,0,2,18,18
1683296438021,SE 101B,A00,187409,Staff,24,0,30,6
1683296439047,SE 110B,A00,187444,Staff,10,0,40,30
1683296440076,SE 130B,A00,187449,Staff,31,0,40,9
1683296441103,SE 150A,A00,187516,Staff,9,0,20,11
1683296442130,SE 154,A00,187528,Staff,30,0,50,20
1683296443158,SIO 3,A01,258171,Staff,35,0,40,5
1683296444185,SIO 10,A00,187144,Cook; Geoffrey W,0,3,75,75
1683296445208,SIO 45,A00,187152,Cook; Geoffrey W,1,0,100,99
1683296446237,SIO 109R,A00,194486,Staff,0,3,20,20
1683296448342,SIO 187,A01,187233,Kacev; David,12,0,40,28
1683296449368,SOCI 1,A01,258656,Thorpe; Charles Robert,28,0,30,2
1683296449368,SOCI 1,A02,258658,Thorpe; Charles Robert,30,0,30,0
1683296449368,SOCI 1,A03,258661,Thorpe; Charles Robert,25,0,25,0
1683296449368,SOCI 1,A04,258666,Thorpe; Charles Robert,22,0,25,3
1683296449368,SOCI 1,A05,258897,Thorpe; Charles Robert,23,0,25,2
1683296449368,SOCI 1,A06,258898,Thorpe; Charles Robert,25,0,25,0
1683296450393,SOCI 30,A01,258903,Pardo Guerra; Juan Pablo,16,0,30,14
1683296451418,SOCI 102,A00,258904,Staff,9,0,25,16
1683296452444,SOCI 106,A00,258905,Staff,19,0,25,6
1683296453468,SOCI 111,A00,258907,Ribas Norris; Janet Vanesa,26,0,30,4
1683296454492,SOCI 121R,A00,258908,Pardo Guerra; Juan Pablo,11,0,30,19
1683296455520,SOCI 126,A01,203330,Staff,14,0,20,6
1683296456546,SOCI 131,A00,258909,Thorpe; Charles Robert,31,0,60,29
1683296457571,SOCI 135,A00,258910,Payne; Christine Anna,0,9,30,30
1683296458599,SOCI 157,A00,258911,Staff,13,0,30,17
1683296459627,SOCI 184,A00,258912,Staff,26,0,30,4
1683296460651,SOCI 188D,A00,258913,Staff,21,0,30,9
1683296461676,SYN 2,001,187529,Staff,9,0,16,7
1683296461676,SYN 2,002,201452,Staff,0,18,16,16
1683296461676,SYN 2,003,201469,Staff,3,0,16,13
1683296462704,SYN 100,A01,187531,Staff,0,9,20,20
1683296462704,SYN 100,B01,201491,Staff,0,12,20,20
1683296463734,TDAC 1,A00,189286,Walsh; Kim C.,3,0,20,17
1683296463734,TDAC 1,B00,189287,Harting; Carla Kelso,11,0,20,9
1683296464758,TDAC 101,A00,189300,Walsh; Kim C.,16,0,20,4
1683296464758,TDAC 101,B00,189301,Harting; Carla Kelso,18,0,20,2
1683296465787,TDAC 102,A00,189304,Basso; Beatrice,14,0,20,6
1683296466815,TDAC 108,A00,189305,Staff,18,0,20,2
1683296467846,TDDE 131,A00,189310,Staff,19,0,20,1
1683296467846,TDDE 131,B00,189314,Staff,19,0,20,1
1683296467846,TDDE 131,C00,189315,Staff,48,0,50,2
1683296467846,TDDE 131,D00,189316,Staff,14,0,15,1
1683296467846,TDDE 131,E00,204841,Staff,20,0,20,0
1683296468874,TDGE 10,A00,189289,Staff,30,0,50,20
1683296468874,TDGE 10,B00,189290,Havis; Allan,2,0,50,48
1683296469900,TDGE 11,A00,189291,Fulton; Julia,0,3,50,50
1683296469900,TDGE 11,B00,189292,Staff,20,0,25,5
1683296469900,TDGE 11,C00,260270,Staff,0,0,0,0
1683296470928,TDGE 25,A00,189294,Staff,3,0,20,17
1683296471958,TDGE 124,A00,189318,Fulton; Julia,0,8,50,50
1683296472982,TDGE 125,A00,189319,Staff,13,0,25,12
1683296472982,TDGE 125,B00,189320,Staff,23,0,25,2
1683296474010,TDGE 127,A00,189322,Havis; Allan,0,0,50,50
1683296475034,TDHT 101,A00,189323,Staff,18,0,25,7
1683296475034,TDHT 101,B00,189324,Staff,25,0,25,0
1683296476064,TDHT 102,A00,189325,Staff,49,0,50,1
1683296477094,TDMV 1,A00,189295,Arcidiacono; Kristin,20,0,30,10
1683296477094,TDMV 1,B00,189296,Caligagan; Maria T.,24,0,30,6
1683296478122,TDMV 2,A00,189297,Sammartano; Tonnie,28,0,30,2
1683296478122,TDMV 2,B00,189299,Arcidiacono; Kristin,24,0,30,6
1683296479147,TDMV 3,A00,204998,Rincon; Alicia,22,0,30,8
1683296480172,TDMV 120,A00,189458,Sammartano; Tonnie,28,0,30,2
1683296481202,TDMV 138,A00,189541,Jun; Grace Shin Hae,22,0,40,18
1683296482227,TDMV 142,A00,189717,Caligagan; Tony,23,0,30,7
1683296482227,TDMV 142,B00,189718,Caligagan; Maria T.,25,0,30,5
1683296483256,TMC 2,A01,187533,Staff,25,0,25,0
1683296483256,TMC 2,A02,187534,Staff,25,0,25,0
1683296484286,USP 1,A01,187536,Kwak; Nancy,0,16,25,25
1683296485311,USP 5,A01,187538,Staff,9,0,25,16
1683296486335,USP 101,A00,199253,Staff,0,4,0,0
1683296487365,USP 124,A00,187562,Boomhower; Matthew Charles,1,0,30,29
1683296488390,USP 138,A00,187582,Staff,20,0,25,5
1683296489418,USP 152,A01,187597,Staff,4,0,25,21
1683296490441,USP 153,A00,187598,Staff,19,0,25,6
1683296491464,USP 168,A00,187607,Kwak; Nancy,2,0,5,3
1683296492492,USP 173,A00,187619,Staff,4,0,25,21
1683296493518,USP 181,A00,187638,Staff,0,0,25,25
1683296494543,VIS 103,A00,187650,Cruz; Edwin Teddy,23,0,75,52
1683296495567,VIS 110D,A00,187669,Staff,12,0,22,10
1683296496597,VIS 127C,A00,187720,Shen; Kuiyi,68,0,146,78
1683296497623,VIS 149,A00,187731,Yoldas; Pinar,0,14,22,22
1683296498648,VIS 151,A01,188091,Staff,22,0,34,12
1683296498648,VIS 151,A02,188092,Staff,11,0,34,23
1683296499678,VIS 160B,A00,188093,Stalbaum; Brett,0,0,10,10
1683296501732,WCWP 10B,A00,201720,Staff,10,0,15,5
1683296501732,WCWP 10B,B00,201722,Staff,8,0,15,7
1683296502761,WCWP 100,A00,201725,Gagnon; Jeffrey C,0,0,2,2
1683296502761,WCWP 100,B00,201727,Staff,0,4,15,15
1683296505865,ANBI 133,A00,258401,Wilder; Linnea Lorene,34,0,40,6
1683296506892,ANBI 140,A00,258395,Hrvoj Mihic; Branka,18,0,25,7
1683296507917,ANSC 120,A00,258402,Bialecki; Jon Anthony,27,0,40,13
1683296508946,ANSC 144,A00,258400,Staff,14,0,40,26
1683296510997,ANSC 166,A00,258396,Parish; Steven Martin,157,0,175,18
1683296512025,ANSC 180,A00,193533,Staff,9,0,20,11
1683296513055,ANSC 188,A00,258397,Jassal; Aftab,33,0,40,7
1683296514084,ANTH 3,A01,258316,Staff,23,0,30,7
1683296515110,ANTH 5,A00,258394,Semendeferi; Ekaterini,16,0,20,4
1683296516137,ANTH 21,A01,258331,Staff,9,0,40,31
1683296517163,ANTH 103,A00,258398,Varma; Saiba,15,0,25,10
1683296518190,AWP 10,001,202034,Staff,0,0,0,0
1683296518190,AWP 10,002,202035,Staff,0,0,0,0
1683296518190,AWP 10,003,202036,Staff,0,0,0,0
1683296518190,AWP 10,004,202037,Staff,0,0,0,0
1683296518190,AWP 10,005,202038,Staff,0,0,0,0
1683296518190,AWP 10,006,202039,Staff,0,0,0,0
1683296518190,AWP 10,007,202040,Staff,0,0,0,0
1683296518190,AWP 10,008,202041,Staff,0,0,0,0
1683296518190,AWP 10,009,202042,Staff,0,0,0,0
1683296518190,AWP 10,010,202043,Staff,0,0,0,0
1683296518190,AWP 10,011,202044,Staff,0,0,0,0
1683296518190,AWP 10,012,202045,Staff,0,0,0,0
1683296518190,AWP 10,013,202046,Staff,0,0,0,0
1683296518190,AWP 10,014,202047,Staff,0,0,0,0
1683296518190,AWP 10,015,202048,Staff,0,0,0,0
1683296518190,AWP 10,016,202049,Staff,0,0,0,0
1683296518190,AWP 10,017,202050,Staff,0,0,0,0
1683296518190,AWP 10,018,202051,Staff,0,0,0,0
1683296518190,AWP 10,019,202052,Staff,0,0,0,0
1683296518190,AWP 10,020,202053,Staff,0,0,0,0
1683296518190,AWP 10,021,202054,Staff,0,0,0,0
1683296518190,AWP 10,022,202055,Staff,0,0,0,0
1683296518190,AWP 10,023,202056,Staff,0,0,0,0
1683296518190,AWP 10,024,202057,Staff,0,0,0,0
1683296518190,AWP 10,025,202058,Staff,0,0,0,0
1683296518190,AWP 10,026,202059,Staff,0,0,0,0
1683296519215,AWP 102,001,202032,Staff,0,0,0,0
1683296519215,AWP 102,002,202033,Staff,0,0,0,0
1683296520241,BENG 100,A01,254234,Taylor Amos; Alyssa C,31,0,40,9
1683296521268,BENG 196,001,270013,Engler; Adam J.,9999,0,9999,0
1683296522294,BICD 100R,A01,202018,Smith; Laurie,0,7,32,32
1683296522294,BICD 100R,A02,202019,Smith; Laurie,0,2,32,32
1683296522294,BICD 100R,A03,202020,Smith; Laurie,0,1,32,32
1683296522294,BICD 100R,A04,202021,Smith; Laurie,8,0,32,24
1683296522294,BICD 100R,A05,202022,Smith; Laurie,12,0,32,20
1683296523321,BICD 136,A01,193242,Gustafson-Brown; Cindy,0,2,32,32
1683296523321,BICD 136,A02,193244,Gustafson-Brown; Cindy,15,0,32,17
1683296524349,BIEB 102,A01,193249,Butler; Shannon Rhey,0,2,32,32
1683296524349,BIEB 102,A02,193251,Butler; Shannon Rhey,0,0,32,32
1683296524349,BIEB 102,A03,193253,Butler; Shannon Rhey,0,1,32,32
1683296524349,BIEB 102,A04,193255,Butler; Shannon Rhey,17,0,32,15
1683296524349,BIEB 102,A05,193265,Butler; Shannon Rhey,26,0,32,6
1683296524349,BIEB 102,A06,193269,Butler; Shannon Rhey,16,0,32,16
1683296526402,BIEB 150,A01,193274,Staff,0,0,32,32
1683296526402,BIEB 150,A02,193285,Staff,24,0,32,8
1683296527430,BIEB 194,A00,193286,Kurle; Carolyn M.,22,0,32,10
1683296528457,BILD 1,A01,192291,Staff,16,0,32,16
1683296528457,BILD 1,A02,192292,Staff,30,0,32,2
1683296528457,BILD 1,B01,192520,Reuther; Keefe,0,1,0,0
1683296528457,BILD 1,B02,192532,Reuther; Keefe,0,1,0,0
1683296529483,BILD 3,A01,192556,Butler; Shannon Rhey,0,0,32,32
1683296529483,BILD 3,A02,192581,Butler; Shannon Rhey,5,0,32,27
1683296529483,BILD 3,A03,192611,Butler; Shannon Rhey,23,0,32,9
1683296529483,BILD 3,A04,192612,Butler; Shannon Rhey,25,0,32,7
1683296529483,BILD 3,A05,192613,Butler; Shannon Rhey,27,0,32,5
1683296529483,BILD 3,A06,192679,Butler; Shannon Rhey,27,0,32,5
1683296529483,BILD 3,A07,192682,Butler; Shannon Rhey,22,0,32,10
1683296530512,BILD 4,A01,192836,Reuther; Keefe,1,0,24,23
1683296530512,BILD 4,A02,193044,Reuther; Keefe,4,0,24,20
1683296531537,BILD 10,A01,193142,Gustafson-Brown; Cindy,31,0,32,1
1683296531537,BILD 10,A02,193149,Gustafson-Brown; Cindy,31,0,32,1
1683296532568,BIMM 100,A01,193301,Staff,0,6,32,32
1683296532568,BIMM 100,A02,193312,Staff,0,5,32,32
1683296532568,BIMM 100,A03,193323,Staff,0,8,32,32
1683296533601,BIMM 101,A01,193329,McDonnell; Lisa Marie,0,3,24,24
1683296533601,BIMM 101,A02,193339,McDonnell; Lisa Marie,0,2,24,24
1683296533601,BIMM 101,B01,193354,McDonnell; Lisa Marie,0,3,24,24
1683296533601,BIMM 101,B02,193357,McDonnell; Lisa Marie,0,3,24,24
1683296534630,BIMM 110,A01,193377,Tat; John,0,11,32,32
1683296534630,BIMM 110,A02,193378,Tat; John,1,9,32,31
1683296535657,BIMM 120,A01,206116,Staff,0,0,32,32
1683296535657,BIMM 120,A02,206117,Staff,8,0,32,24
1683296535657,BIMM 120,A03,206121,Staff,21,0,32,11
1683296536687,BIPN 100,A01,193393,Park; Ji Young,0,14,32,32
1683296536687,BIPN 100,A02,193402,Park; Ji Young,0,12,32,32
1683296536687,BIPN 100,A03,193413,Park; Ji Young,0,14,32,32
1683296536687,BIPN 100,A04,193414,Park; Ji Young,0,13,32,32
1683296537714,BIPN 102,A01,193429,Staff,0,0,32,32
1683296537714,BIPN 102,A02,193438,Staff,23,0,32,9
1683296538745,BIPN 106,A01,193450,Reyes Gonzalez; Catalina,0,2,40,40
1683296539776,BIPN 134,A01,193465,Cooke; James Edward,0,0,32,32
1683296539776,BIPN 134,A02,193474,Cooke; James Edward,27,0,32,5
1683296539776,BIPN 134,A03,193485,Cooke; James Edward,29,0,32,3
1683296539776,BIPN 134,A04,193486,Cooke; James Edward,21,0,32,11
1683296539776,BIPN 134,A05,193491,Cooke; James Edward,31,0,32,1
1683296539776,BIPN 134,A06,193501,Cooke; James Edward,30,0,32,2
1683296539776,BIPN 134,A07,193510,Cooke; James Edward,29,0,32,3
1683296541834,BISP 194,A00,222522,Staff,16,0,32,16
1683296542862,CAT 124,A01,202407,Staff,20,0,25,5
1683296543887,CAT 125,A00,202408,Marchisotto; Jennifer Anne,4,0,20,16
1683296544922,CAT 125R,A00,202409,Smith; Lauryn Alissa,0,11,20,20
1683296544922,CAT 125R,B00,202410,Morales; Celeste Georgianna,0,11,20,20
1683296544922,CAT 125R,C00,202411,Irwin; Matthew Joseph,0,10,20,20
1683296545953,CENG 15,A01,204712,Yang; Kesong,0,1,0,0
1683296546978,CENG 114,A00,202070,Jahed Motlagh; Zeinab,5,0,20,15
1683296548003,CGS 105,A00,185477,Wesling; Megan E.,24,0,40,16
1683296549028,CGS 106,A00,185494,Staff,13,0,22,9
1683296550053,CGS 108,A00,185495,Staff,14,0,20,6
1683296551079,CGS 114,A00,185496,Staff,13,0,18,5
1683296552159,CGS 119,A00,185501,Staff,15,0,20,5
1683296553186,CGS 120,A00,185511,Staff,13,0,20,7
1683296554211,CHEM 4,A01,184675,Bussey; Thomas J,96,0,100,4
1683296555236,CHEM 6A,A01,184677,Staff,35,0,60,25
1683296556264,CHEM 6B,A01,184679,Staff,65,0,100,35
1683296557290,CHEM 6C,A01,184681,Bussey; Thomas J,1,0,50,49
1683296557290,CHEM 6C,A02,184682,Bussey; Thomas J,34,0,50,16
1683296558323,CHEM 40A,A01,184684,Albizati; Kim F.,37,0,100,63
1683296559352,CHEM 40B,A01,184686,Albizati; Kim F.,0,20,100,100
1683296560377,CHEM 41B,A01,184690,Staff,52,0,100,48
1683296561406,COGS 3,A01,184715,Boyle; Mary E. T.,0,25,40,40
1683296562435,COGS 14B,A01,185172,Staff,0,15,38,38
1683296563465,COGS 18,A01,184736,Staff,20,0,80,60
1683296564490,COGS 100,A01,184932,Staff,0,5,73,73
1683296565514,COGS 101A,A01,184935,Staff,0,38,30,30
1683296566542,COGS 101B,A01,184944,Staff,0,2,30,30
1683296567567,COGS 101C,A01,184946,Staff,0,12,30,30
1683296568592,COGS 102A,A01,184951,Johnson; Christine M.,2,0,40,38
1683296569619,COGS 107B,A01,184953,Mooshagian; Eric Frederick,0,50,40,40
1683296570647,COGS 118B,A01,184959,Gupta; Anjum,0,48,40,40
1683296571670,COGS 153,A00,184961,Staff,0,15,30,30
1683296572696,COGS 177,A00,184962,Staff,0,21,30,30
1683296573721,COGS 187A,A01,184969,Boyle; Mary E. T.,0,17,40,40
1683296574750,COMM 10,A01,185174,Staff,0,5,25,25
1683296574750,COMM 10,A02,185189,Staff,0,5,25,25
1683296574750,COMM 10,A03,269821,Staff,0,0,0,0
1683296575775,COMM 100B,A01,185475,Staff,0,0,0,2
1683296575775,COMM 100B,A02,185476,Staff,14,0,25,11
1683296576799,COMM 100C,A01,185314,Staff,1,0,25,24
1683296576799,COMM 100C,A02,185327,Staff,19,0,25,6
1683296577825,COMM 110M,A00,185349,Staff,2,0,40,38
1683296578850,COMM 113T,A00,185352,Staff,25,0,40,15
1683296579875,COMM 114I,A00,185353,Staff,33,0,40,7
1683296580900,COMM 131,A00,185354,Staff,19,0,30,11
1683296581925,CSE 8A,A50,185358,Cao; Yingjun,0,46,10,10
1683296582949,CSE 8B,A01,185362,Staff,1,47,50,49
1683296583979,CSE 11,A01,185416,Cao; Yingjun,0,93,10,10
1683296585005,CSE 20,A01,185445,Briones; Jor-el Thomas Caparas,5,0,25,20
1683296586034,CSE 21,A01,185447,Staff,10,0,50,40
1683296587063,CSE 101,A01,185451,Staff,0,12,50,50
1683296587063,CSE 101,B01,185453,Jones; Miles E,0,11,50,50
1683296589135,CSE 141,A01,185458,Eldon; John,20,0,100,80
1683296590163,CSE 141L,A01,185461,Eldon; John,12,0,100,88
1683296591188,CSE 142,A01,185463,Staff,35,0,60,25
1683296591188,CSE 142,B01,201355,Staff,0,6,60,60
1683296592213,CSE 142L,A01,185470,Staff,35,0,60,25
1683296592213,CSE 142L,B01,201417,Staff,0,5,60,60
1683296593237,CSE 190,A00,201433,Staff,32,0,49,17
1683296594263,DOC 1,A01,259136,Strom; Megan C.,8,0,15,7
1683296594263,DOC 1,A02,259137,Strom; Megan C.,14,0,15,1
1683296594263,DOC 1,A03,259138,Strom; Megan C.,14,0,15,1
1683296594263,DOC 1,A04,259139,Strom; Megan C.,14,0,15,1
1683296595289,DOC 100D,A00,259140,Pass; Natalye Joann,17,0,25,8
1683296596313,DSGN 1,A01,184749,Rill; Bryan,0,24,30,30
1683296597338,DSGN 100,A01,185168,Staff,0,2,25,25
1683296598364,ECE 5,A01,185626,Morris; Karcher William,0,10,0,0
1683296599390,ECE 101,A01,185628,Staff,17,0,70,53
1683296600418,ECE 107,A01,185635,Baghdadchi; Saharnaz,0,0,20,20
1683296600418,ECE 107,A02,185638,Baghdadchi; Saharnaz,4,0,20,16
1683296601445,ECE 148,A01,185647,Silberman; Jack,1,0,16,15
1683296602470,ECON 1,A01,185537,Crane; Meredith Helen,54,0,70,16
1683296603494,ECON 3,A01,185549,Crane; Meredith Helen,33,0,70,37
1683296604518,ECON 4,A01,203354,Anderson; John Charles,0,4,10,10
1683296605543,ECON 100A,A01,185574,Staff,0,4,40,40
1683296606568,ECON 100B,A01,185576,Staff,0,22,40,40
1683296607597,ECON 100C,A01,185589,Newhouse; Herbert S,30,0,70,40
1683296608626,ECON 105,A00,185608,Vespa; Emanuel Ignacio,19,0,35,16
1683296609651,ECON 109,A01,185610,Shishkin; Denis,10,0,35,25
1683296610680,ECON 110A,A01,185612,Staff,11,0,40,29
1683296611706,ECON 120A,A01,185615,Staff,20,0,40,20
1683296612730,ECON 120C,A01,185617,Sun; Yixiao,0,20,70,70
1683296613756,ECON 144,A00,203346,Squires; Dale E,3,0,35,32
1683296614782,ECON 171,A01,203349,Newhouse; Herbert S,0,1,35,35
1683296615811,ECON 173A,A01,185621,Toda; Alexis Akira,21,0,35,14
1683296616838,EDS 25,A01,202413,Staff,0,1,0,0
1683296616838,EDS 25,A02,202414,Staff,0,1,0,0
1683296616838,EDS 25,A03,202415,Staff,0,0,0,0
1683296616838,EDS 25,A04,202416,Staff,0,1,0,0
1683296616838,EDS 25,A05,202439,Staff,0,0,0,0
1683296616838,EDS 25,A06,202440,Staff,0,0,0,0
1683296616838,EDS 25,B01,202631,Staff,0,0,0,0
1683296616838,EDS 25,B02,202632,Staff,0,0,0,0
1683296616838,EDS 25,B03,202639,Staff,0,0,0,0
1683296616838,EDS 25,B04,202640,Staff,0,0,0,0
1683296616838,EDS 25,B05,202643,Staff,0,0,0,0
1683296616838,EDS 25,B06,202644,Staff,0,0,0,0
1683296617870,EDS 38,A01,202659,Black; Alison Michelle,24,0,25,1
1683296618896,EDS 115,A00,202652,Staff,17,0,30,13
1683296619920,EDS 125,A00,202649,Staff,14,0,30,16
1683296620945,EDS 126,A01,203332,Staff,30,0,30,0
1683296621972,EDS 139,A00,202838,Staff,17,0,25,8
1683296623002,EDS 146,A01,202655,Staff,15,0,25,10
1683296624033,ENG 15,A00,185667,Staff,0,1,0,0
1683296624033,ENG 15,B00,185672,Staff,0,0,0,0
1683296624033,ENG 15,C00,185675,Staff,0,0,0,0
1683296624033,ENG 15,D00,185682,Staff,0,0,0,0
1683296624033,ENG 15,E00,185684,Staff,0,0,0,0
1683296625061,ETHN 103,A00,185710,Staff,0,3,35,35
1683296626090,ETHN 103A,A00,199228,Man; Simeon S,3,0,9,6
1683296627115,ETHN 109,A00,185711,Staff,18,0,35,17
1683296628138,ETHN 142,A00,185726,Staff,0,4,30,30
1683296629166,ETHN 163J,A00,199229,Man; Simeon S,6,0,8,2
1683296630194,ETHN 168,A00,185727,Staff,8,0,10,2
1683296631224,ETHN 182,A00,185728,Staff,1,0,35,34
1683296632246,ETHN 183,A00,185737,Staff,8,0,18,10
1683296633276,GLBH 111,A01,209361,Burgos; Jose L.,0,0,0,0
1683296635331,HIEU 104,A00,185792,Staff,16,0,20,4
1683296636358,HIEU 115,A00,185800,Staff,1,0,20,19
1683296637382,HIEU 128,A00,185801,Staff,0,7,20,20
1683296638405,HIEU 147,A00,185802,Staff,16,0,20,4
1683296639429,HIEU 154,A00,185823,Staff,12,0,20,8
1683296640457,HILA 102,A00,185826,Staff,13,0,20,7
1683296641485,HILD 2C,A01,185778,Staff,0,12,20,20
1683296642514,HILD 7B,A01,185780,Kwak; Nancy,0,15,32,32
1683296642514,HILD 7B,A02,185781,Kwak; Nancy,0,18,32,32
1683296643541,HILD 30,A01,185791,Staff,14,0,20,6
1683296644566,HISC 119,A00,185830,Golan; Tal,0,9,20,20
1683296645590,HITO 156GS,A00,185831,Patterson; Patrick H.,0,0,0,23
1683296646619,HIUS 103,A00,185832,Man; Simeon S,0,7,20,20
1683296647646,HIUS 117,A00,185836,Kwak; Nancy,2,0,20,18
1683296648670,HIUS 125,A00,185840,Man; Simeon S,0,0,23,23
1683296649697,HIUS 149,A00,185845,Staff,0,0,20,20
1683296650722,HUM 3,A01,185882,Zavodny; Tatiana Sophia,0,6,50,50
1683296650722,HUM 3,B01,185899,Caldwell; Michael Alan,0,19,50,50
1683296651749,HUM 3GS,A00,185900,Patterson; Patrick H.,0,0,0,23
1683296652775,HUM 4,A01,185938,Zroka; Amy Liane,31,0,50,19
1683296652775,HUM 4,B01,185956,Watkins; Eric,0,2,50,50
1683296652775,HUM 4,B02,202209,Watkins; Eric,0,1,50,50
1683296652775,HUM 4,B03,202210,Watkins; Eric,0,0,50,50
1683296653803,HUM 5,A01,185958,West; Geoffrey Scott,5,0,50,45
1683296653803,HUM 5,A02,202215,West; Geoffrey Scott,0,0,50,50
1683296654828,INTL 190,A00,185959,Gagnon; Jeffrey C,0,0,0,9
1683296654828,INTL 190,B00,185960,Lettieri; Michael Joseph,0,0,0,1
1683296655921,JAPN 180,A00,254509,Staff,0,1,25,25
1683296656946,LATI 10,A01,202853,Kennemore; Amy Michelle,5,0,35,30
1683296656946,LATI 10,A02,202854,Kennemore; Amy Michelle,1,0,35,34
1683296656946,LATI 10,A03,270054,Kennemore; Amy Michelle,30,0,30,0
1683296657973,LATI 180,A00,202855,Kennemore; Amy Michelle,11,0,20,9
1683296659002,LAWS 101,A00,201767,Golan; Tal,0,7,40,40
1683296660028,LIFR 1C,A00,185961,Staff,6,0,20,14
1683296661052,LIFR 1CX,A00,185962,Staff,7,0,20,13
1683296662079,LIFR 1D,A00,185963,Staff,9,0,20,11
1683296663103,LIFR 1DX,A00,185964,Staff,9,0,20,11
1683296664132,LIGN 101,A01,186039,Staff,43,0,50,7
1683296665156,LIGN 165,A00,186040,Staff,18,0,50,32
1683296666183,LTCS 108,A00,186041,Staff,6,0,10,4
1683296667210,LTCS 119,A00,186042,Staff,16,0,20,4
1683296668234,LTCS 130,A00,186043,Wesling; Megan E.,15,0,25,10
1683296670288,LTEA 138,A00,186119,Staff,14,0,40,26
1683296671312,LTEN 124,A00,186148,Staff,6,0,25,19
1683296672337,LTEN 178,A00,186149,Staff,7,0,15,8
1683296673363,LTEN 181,A00,186150,Blanco; John D,33,0,40,7
1683296674390,LTWL 120,A00,186160,Staff,20,0,25,5
1683296675417,LTWL 165,A00,186161,Staff,22,0,25,3
1683296676443,LTWR 100,A00,186162,Staff,0,4,15,15
1683296677468,LTWR 102,A00,186163,Doller; Ben,5,0,15,10
1683296678491,MAE 8,A01,186412,Staff,0,0,0,0
1683296679520,MAE 30B,A00,186445,Bahadori; Mohammad Yousef,83,0,100,17
1683296680545,MAE 40,A00,186592,Bewley; Thomas R,9,0,50,41
1683296681574,MAE 101B,A00,186593,Bahadori; Mohammad Yousef,81,0,100,19
1683296682603,MAE 105,A00,186594,Bandaru; Prabhakar,12,0,50,38
1683296683630,MAE 107,A00,186599,Pham; Hieu Tan,0,6,120,120
1683296684658,MAE 148,A01,186660,Silberman; Jack,3,0,16,13
1683296685690,MATH 10A,A01,188095,Staff,0,7,35,35
1683296686720,MATH 10B,A01,188097,Bowers; Adam R.,0,11,30,30
1683296686720,MATH 10B,A02,188099,Bowers; Adam R.,0,9,30,30
1683296686720,MATH 10B,B01,188104,Bowers; Adam R.,0,11,30,30
1683296686720,MATH 10B,B02,188106,Bowers; Adam R.,0,11,30,30
1683296687747,MATH 10C,A01,188111,Staff,0,18,30,30
1683296687747,MATH 10C,A02,188127,Staff,0,17,30,30
1683296687747,MATH 10C,A03,188131,Staff,0,17,30,30
1683296687747,MATH 10C,B01,188218,Staff,21,0,30,9
1683296687747,MATH 10C,B02,188244,Staff,13,0,30,17
1683296687747,MATH 10C,B03,188277,Staff,16,0,30,14
1683296688776,MATH 18,A01,188344,Bach; Quang Tran,18,0,30,12
1683296688776,MATH 18,A02,188345,Bach; Quang Tran,11,0,30,19
1683296688776,MATH 18,B01,188353,Bach; Quang Tran,10,0,30,20
1683296688776,MATH 18,B02,188354,Bach; Quang Tran,20,0,30,10
1683296689813,MATH 20A,A01,188374,Staff,13,0,35,22
1683296690843,MATH 20B,A01,188382,Ohm; Ko Woon,6,0,30,24
1683296690843,MATH 20B,A02,188383,Ohm; Ko Woon,24,0,30,6
1683296690843,MATH 20B,B01,188385,Ohm; Ko Woon,7,0,30,23
1683296690843,MATH 20B,B02,188392,Ohm; Ko Woon,22,0,30,8
1683296691873,MATH 20C,A01,188394,Harel; Guershon,10,0,30,20
1683296691873,MATH 20C,A02,188395,Harel; Guershon,13,0,30,17
1683296691873,MATH 20C,B01,188404,Harel; Guershon,3,0,30,27
1683296691873,MATH 20C,B02,188405,Harel; Guershon,19,0,30,11
1683296692903,MATH 20D,A01,188414,Hammock; Frances H,0,1,30,30
1683296692903,MATH 20D,A02,188415,Hammock; Frances H,4,0,30,26
1683296692903,MATH 20D,B01,188447,Hammock; Frances H,2,0,30,28
1683296692903,MATH 20D,B02,188486,Hammock; Frances H,8,0,30,22
1683296693931,MATH 20E,A01,188649,Staff,22,0,30,8
1683296693931,MATH 20E,A02,188650,Staff,23,0,30,7
1683296693931,MATH 20E,A03,188673,Staff,0,0,30,30
1683296694955,MATH 102,A01,188675,Staff,0,35,35,35
1683296695984,MATH 103B,A01,188681,Staff,4,0,35,31
1683296695984,MATH 103B,B01,188692,Staff,7,0,35,28
1683296697008,MATH 109,A01,188695,Salehi Golsefidy; Alireza,25,0,35,10
1683296697008,MATH 109,A02,188696,Salehi Golsefidy; Alireza,27,0,35,8
1683296698033,MATH 120A,A01,188698,Eggers; John Dietrich,5,0,35,30
1683296699063,MATH 142B,A01,188736,Ioana; Adrian,0,2,30,30
1683296699063,MATH 142B,A02,188741,Ioana; Adrian,0,1,30,30
1683296699063,MATH 142B,A03,188743,Ioana; Adrian,0,3,30,30
1683296700089,MATH 168A,A01,188790,Staff,0,8,35,35
1683296701130,MATH 170A,A01,188803,Nie; Jiawang,0,2,35,35
1683296701130,MATH 170A,A02,188811,Nie; Jiawang,0,0,35,35
1683296701130,MATH 170A,A03,188814,Nie; Jiawang,1,0,35,34
1683296701130,MATH 170A,A04,188815,Nie; Jiawang,14,0,35,21
1683296702155,MATH 193B,A01,188817,Staff,0,0,35,35
1683296702155,MATH 193B,A02,188818,Staff,5,0,35,30
1683296703179,MGT 4,A01,202857,Anderson; John Charles,62,0,80,18
1683296704203,MGT 12,A00,202858,Lindenberger; Wade Douglas,43,0,90,47
1683296705228,MGT 18,A00,202859,Staff,74,0,90,16
1683296706256,MGT 18GS,A00,202860,McKay; Michael J,13,0,28,15
1683296707283,MGT 45,A00,202861,Pecore; Joseph P.,14,0,90,76
1683296708308,MGT 100,A00,202863,Yavorsky; Daniel Ryan,28,0,90,62
1683296709331,MGT 103,A00,202864,Ehrich; Kristine R,0,16,90,90
1683296710358,MGT 112,A00,202865,Ehrich; Kristine R,15,0,90,75
1683296711388,MGT 121A,A00,202868,Staff,0,19,0,0
1683296712415,MGT 131B,A00,202869,Anderson; John Charles,59,0,90,31
1683296713444,MGT 136,A00,202871,Lindenberger; Wade Douglas,84,0,90,6
1683296714472,MGT 164,A00,202873,Staff,0,69,90,90
1683296715499,MGT 164GS,A00,202874,McKay; Mary A,13,0,28,15
1683296716523,MGT 180,A00,202875,Staff,0,51,90,90
1683296717550,MMW 11R,A01,205019,Herbst; Matthew,3,0,30,27
1683296717550,MMW 11R,A02,205026,Herbst; Matthew,29,0,30,1
1683296718577,MMW 15,A01,193512,Chang; Edmond Yi-Teh,0,9,28,28
1683296718577,MMW 15,A02,193513,Chang; Edmond Yi-Teh,0,5,28,28
1683296718577,MMW 15,A03,193514,Chang; Edmond Yi-Teh,0,5,28,28
1683296718577,MMW 15,A04,193515,Chang; Edmond Yi-Teh,0,4,28,28
1683296718577,MMW 15,A05,193516,Chang; Edmond Yi-Teh,0,4,28,28
1683296718577,MMW 15,A06,193517,Chang; Edmond Yi-Teh,0,5,28,28
1683296718577,MMW 15,B01,193519,Chang; Edmond Yi-Teh,0,4,28,28
1683296718577,MMW 15,B02,193520,Chang; Edmond Yi-Teh,0,5,28,28
1683296718577,MMW 15,B03,193521,Chang; Edmond Yi-Teh,0,4,28,28
1683296718577,MMW 15,B04,193522,Chang; Edmond Yi-Teh,0,4,28,28
1683296718577,MMW 15,B05,193523,Chang; Edmond Yi-Teh,0,5,28,28
1683296718577,MMW 15,B06,193524,Chang; Edmond Yi-Teh,0,4,28,28
1683296719602,MMW 122,A01,193526,Rahimi; Babak,0,14,28,28
1683296719602,MMW 122,A02,193527,Rahimi; Babak,0,14,28,28
1683296719602,MMW 122,A03,193528,Rahimi; Babak,0,0,0,0
1683296719602,MMW 122,A04,193529,Rahimi; Babak,0,0,0,0
1683296720630,MUS 1A,A01,186663,Staff,0,20,35,35
1683296721657,MUS 4,A01,186715,Staff,0,12,35,35
1683296722686,MUS 5R,A01,186796,Dubnov; Shlomo,0,16,35,35
1683296723710,MUS 6,A01,186798,Staff,0,3,25,25
1683296724733,MUS 7,A01,186830,Staff,12,0,35,23
1683296725758,MUS 8,A01,186930,Staff,0,25,35,35
1683296726784,MUS 15,A01,186932,Staff,0,15,35,35
1683296726784,MUS 15,B01,186934,Staff,0,14,35,35
1683296727809,MUS 80,A00,186935,Staff,2,0,20,18
1683296727809,MUS 80,B00,186936,Staff,25,0,25,0
1683296728837,NANO 11,A00,204702,Lipomi; Darren John,0,0,0,0
1683296729863,NANO 15,A01,204709,Yang; Kesong,0,1,0,0
1683296730890,NANO 114,A00,202069,Jahed Motlagh; Zeinab,3,0,10,7
1683296731919,PHIL 1,A00,186955,Grush; Rick Scott,32,0,40,8
1683296732943,PHIL 10,A01,186973,Grush; Rick Scott,29,0,35,6
1683296732943,PHIL 10,A02,186974,Grush; Rick Scott,33,0,35,2
1683296733971,PHIL 13,A01,186976,Staff,7,0,35,28
1683296733971,PHIL 13,A02,186977,Staff,16,0,35,19
1683296734999,PHIL 14,A01,186979,Staff,31,0,35,4
1683296734999,PHIL 14,A02,186986,Staff,32,0,35,3
1683296736023,PHIL 28,A01,186988,Staff,16,0,30,14
1683296736023,PHIL 28,A02,186989,Staff,1,0,30,29
1683296736023,PHIL 28,A03,186990,Staff,9,0,30,21
1683296736023,PHIL 28,A04,186991,Staff,26,0,30,4
1683296737047,PHIL 120,A00,186997,Staff,23,0,40,17
1683296738071,PHIL 137,A00,187003,Staff,9,0,40,31
1683296739096,PHIL 150,A00,187015,Staff,47,0,70,23
1683296740121,PHIL 167,A00,187021,Lamey; Andy M.,35,0,40,5
1683296741146,PHIL 174,A01,202226,Staff,17,0,20,3
1683296741146,PHIL 174,A02,202235,Staff,20,0,20,0
1683296742172,PHIL 191A,A00,258918,Staff,0,0,1,1
1683296743201,PHYS 1A,A00,187028,Staff,26,0,60,34
1683296744227,PHYS 1AL,001,187036,Staff,2,0,30,28
1683296744227,PHYS 1AL,002,187049,Staff,18,0,30,12
1683296745254,PHYS 1B,A00,187058,Staff,23,0,60,37
1683296746278,PHYS 1BL,001,187064,Staff,0,0,30,30
1683296746278,PHYS 1BL,002,187070,Staff,6,0,30,24
1683296747306,PHYS 1C,A00,187082,Staff,32,0,120,88
1683296748334,PHYS 1CL,001,187088,Staff,0,9,30,30
1683296748334,PHYS 1CL,002,187089,Staff,0,2,30,30
1683296748334,PHYS 1CL,009,262693,Staff,12,0,30,18
1683296749363,PHYS 2B,A01,187097,Staff,54,0,115,61
1683296750388,PHYS 2C,A01,187099,Staff,67,0,115,48
1683296751412,PHYS 2CL,A01,187101,Staff,5,0,28,23
1683296751412,PHYS 2CL,A02,187102,Staff,15,0,28,13
1683296752440,PHYS 2D,A01,187123,Shotwell; Brian,95,0,115,20
1683296753468,PHYS 4B,A01,187133,Grinstein; Benjamin,35,0,50,15
1683296754496,POLI 10,A00,188819,Staff,0,3,50,50
1683296755523,POLI 11,A00,188827,Staff,43,0,50,7
1683296756548,POLI 13R,A00,188828,Staff,0,1,20,20
1683296757573,POLI 27,A01,188830,Elgin; Samuel Zincke,0,1,70,70
1683296758602,POLI 30,A00,188832,Desposato; Scott,33,0,50,17
1683296759683,POLI 102F,A00,188834,Staff,3,0,40,37
1683296760710,POLI 104A,A00,188852,Staff,14,0,30,16
1683296761736,POLI 104I,A00,188853,Staff,0,6,20,20
1683296762765,POLI 110B,A00,188854,Wiens; David,7,0,20,13
1683296763789,POLI 112A,A00,188855,Wiens; David,5,0,30,25
1683296764811,POLI 117R,A00,188856,Forman; Fonna,0,11,20,20
1683296765836,POLI 118,A00,188857,Ingham; Sean,8,0,20,12
1683296766863,POLI 120G,A00,188858,Staff,9,0,30,21
1683296767888,POLI 131CR,A00,188863,Hoston; Germaine,24,0,50,26
1683296768915,POLI 133,A00,188864,Nellis; Gareth Hb,44,0,50,6
1683296769941,POLI 134D,A00,188865,Desposato; Scott,27,0,30,3
1683296770965,POLI 142A,A00,188871,Gartzke; Erik,22,0,50,28
1683296771990,POLI 142K,A00,188874,Staff,38,0,50,12
1683296773018,POLI 143,A00,188940,Gartzke; Erik,16,0,30,14
1683296774045,POLI 153,A00,188943,Staff,3,0,20,17
1683296775071,POLI 160AA,A00,188944,Staff,13,0,40,27
1683296776096,POLI 170A,A00,188945,Staff,11,0,30,19
1683296778147,PSYC 1,A00,188952,Staff,38,0,90,52
1683296779173,PSYC 2,B00,188953,Staff,20,0,35,15
1683296780201,PSYC 6,A00,188970,Staff,47,0,60,13
1683296781226,PSYC 7,A00,188973,Staff,37,0,45,8
1683296782251,PSYC 60,A01,188980,Rickard; Timothy C.,43,0,60,17
1683296783281,PSYC 70,A01,189001,Steiner; Eric Tomas,24,0,45,21
1683296784310,PSYC 100,A00,189005,Lacefield; Katharine I,0,99,120,120
1683296785333,PSYC 102,A00,189008,Staff,10,0,30,20
1683296786362,PSYC 106,B00,189026,Gorman; Michael R.,37,0,60,23
1683296787387,PSYC 114,B01,189033,Winkielman; Piotr,0,32,30,30
1683296788414,PSYC 131,A00,189036,Anagnostaras; Stephan,0,43,60,60
1683296789441,PSYC 136,A00,189041,Lowe; Angela Beth,0,7,25,25
1683296790469,PSYC 137,A00,189057,Winkielman; Piotr,0,34,25,25
1683296791492,PSYC 144,A00,189107,Wixted; John T,0,7,50,50
1683296793543,PSYC 162,A00,189142,Staff,0,8,85,85
1683296794572,PSYC 172,A00,189144,Gorman; Michael R.,0,7,30,30
1683296796627,PSYC 179,A00,189146,Lacefield; Katharine I,0,84,120,120
1683296797652,PSYC 181,A00,189147,Anagnostaras; Stephan,0,44,90,90
1683296798680,PSYC 190R,A00,189148,Barner; David A.,0,22,80,80
1683296799709,PSYC 191,A00,189275,Rickard; Timothy C.,0,7,25,25
1683296800732,PSYC 193,A00,189276,Chapman; Eddie Nathaniel,0,1,0,4
1683296801760,PSYC 193L,A01,189281,Lowe; Angela Beth,12,0,20,8
1683296801760,PSYC 193L,B01,189285,Staff,28,0,35,7
1683296802787,RELI 149,A00,187137,Rahimi; Babak,7,0,40,33
1683296803815,SE 9,A01,187315,Staff,0,2,18,18
1683296804841,SE 101B,A00,187409,Staff,24,0,30,6
1683296805866,SE 110B,A00,187444,Staff,10,0,40,30
1683296806892,SE 130B,A00,187449,Staff,31,0,40,9
1683296807918,SE 150A,A00,187516,Staff,9,0,20,11
1683296808946,SE 154,A00,187528,Staff,30,0,50,20
1683296809974,SIO 3,A01,258171,Staff,35,0,40,5
1683296810999,SIO 10,A00,187144,Cook; Geoffrey W,0,3,75,75
1683296812027,SIO 45,A00,187152,Cook; Geoffrey W,1,0,100,99
1683296813052,SIO 109R,A00,194486,Staff,0,3,20,20
1683296815105,SIO 187,A01,187233,Kacev; David,12,0,40,28
1683296816129,SOCI 1,A01,258656,Thorpe; Charles Robert,28,0,30,2
1683296816129,SOCI 1,A02,258658,Thorpe; Charles Robert,30,0,30,0
1683296816129,SOCI 1,A03,258661,Thorpe; Charles Robert,25,0,25,0
1683296816129,SOCI 1,A04,258666,Thorpe; Charles Robert,22,0,25,3
1683296816129,SOCI 1,A05,258897,Thorpe; Charles Robert,23,0,25,2
1683296816129,SOCI 1,A06,258898,Thorpe; Charles Robert,25,0,25,0
1683296817154,SOCI 30,A01,258903,Pardo Guerra; Juan Pablo,16,0,30,14
1683296818183,SOCI 102,A00,258904,Staff,9,0,25,16
1683296819209,SOCI 106,A00,258905,Staff,19,0,25,6
1683296820237,SOCI 111,A00,258907,Ribas Norris; Janet Vanesa,26,0,30,4
1683296821274,SOCI 121R,A00,258908,Pardo Guerra; Juan Pablo,11,0,30,19
1683296822302,SOCI 126,A01,203330,Staff,14,0,20,6
1683296823326,SOCI 131,A00,258909,Thorpe; Charles Robert,31,0,60,29
1683296824351,SOCI 135,A00,258910,Payne; Christine Anna,0,9,30,30
1683296825378,SOCI 157,A00,258911,Staff,13,0,30,17
1683296826405,SOCI 184,A00,258912,Staff,26,0,30,4
1683296827432,SOCI 188D,A00,258913,Staff,21,0,30,9
1683296828458,SYN 2,001,187529,Staff,9,0,16,7
1683296828458,SYN 2,002,201452,Staff,0,18,16,16
1683296828458,SYN 2,003,201469,Staff,3,0,16,13
1683296829482,SYN 100,A01,187531,Staff,0,9,20,20
1683296829482,SYN 100,B01,201491,Staff,0,12,20,20
1683296830507,TDAC 1,A00,189286,Walsh; Kim C.,3,0,20,17
1683296830507,TDAC 1,B00,189287,Harting; Carla Kelso,11,0,20,9
1683296831536,TDAC 101,A00,189300,Walsh; Kim C.,16,0,20,4
1683296831536,TDAC 101,B00,189301,Harting; Carla Kelso,18,0,20,2
1683296832561,TDAC 102,A00,189304,Basso; Beatrice,14,0,20,6
1683296833585,TDAC 108,A00,189305,Staff,18,0,20,2
1683296834611,TDDE 131,A00,189310,Staff,19,0,20,1
1683296834611,TDDE 131,B00,189314,Staff,19,0,20,1
1683296834611,TDDE 131,C00,189315,Staff,48,0,50,2
1683296834611,TDDE 131,D00,189316,Staff,14,0,15,1
1683296834611,TDDE 131,E00,204841,Staff,20,0,20,0
1683296835639,TDGE 10,A00,189289,Staff,30,0,50,20
1683296835639,TDGE 10,B00,189290,Havis; Allan,2,0,50,48
1683296836667,TDGE 11,A00,189291,Fulton; Julia,0,3,50,50
1683296836667,TDGE 11,B00,189292,Staff,20,0,25,5
1683296836667,TDGE 11,C00,260270,Staff,0,0,0,0
1683296837691,TDGE 25,A00,189294,Staff,3,0,20,17
1683296838716,TDGE 124,A00,189318,Fulton; Julia,0,8,50,50
1683296839741,TDGE 125,A00,189319,Staff,13,0,25,12
1683296839741,TDGE 125,B00,189320,Staff,23,0,25,2
1683296840768,TDGE 127,A00,189322,Havis; Allan,0,0,50,50
1683296841794,TDHT 101,A00,189323,Staff,18,0,25,7
1683296841794,TDHT 101,B00,189324,Staff,25,0,25,0
1683296842822,TDHT 102,A00,189325,Staff,49,0,50,1
1683296843848,TDMV 1,A00,189295,Arcidiacono; Kristin,20,0,30,10
1683296843848,TDMV 1,B00,189296,Caligagan; Maria T.,24,0,30,6
1683296844874,TDMV 2,A00,189297,Sammartano; Tonnie,28,0,30,2
1683296844874,TDMV 2,B00,189299,Arcidiacono; Kristin,24,0,30,6
1683296845899,TDMV 3,A00,204998,Rincon; Alicia,22,0,30,8
1683296846926,TDMV 120,A00,189458,Sammartano; Tonnie,28,0,30,2
1683296847951,TDMV 138,A00,189541,Jun; Grace Shin Hae,22,0,40,18
1683296848979,TDMV 142,A00,189717,Caligagan; Tony,23,0,30,7
1683296848979,TDMV 142,B00,189718,Caligagan; Maria T.,25,0,30,5
1683296850004,TMC 2,A01,187533,Staff,25,0,25,0
1683296850004,TMC 2,A02,187534,Staff,25,0,25,0
1683296851039,USP 1,A01,187536,Kwak; Nancy,0,16,25,25
1683296852068,USP 5,A01,187538,Staff,9,0,25,16
1683296853092,USP 101,A00,199253,Staff,0,4,0,0
1683296854117,USP 124,A00,187562,Boomhower; Matthew Charles,1,0,30,29
1683296855142,USP 138,A00,187582,Staff,20,0,25,5
1683296856169,USP 152,A01,187597,Staff,4,0,25,21
1683296857195,USP 153,A00,187598,Staff,19,0,25,6
1683296858228,USP 168,A00,187607,Kwak; Nancy,2,0,5,3
1683296859255,USP 173,A00,187619,Staff,4,0,25,21
1683296860279,USP 181,A00,187638,Staff,0,0,25,25
1683296861305,VIS 103,A00,187650,Cruz; Edwin Teddy,23,0,75,52
1683296862329,VIS 110D,A00,187669,Staff,12,0,22,10
1683296863409,VIS 127C,A00,187720,Shen; Kuiyi,68,0,146,78
1683296864433,VIS 149,A00,187731,Yoldas; Pinar,0,14,22,22
1683296865461,VIS 151,A01,188091,Staff,22,0,34,12
1683296865461,VIS 151,A02,188092,Staff,11,0,34,23
1683296866485,VIS 160B,A00,188093,Stalbaum; Brett,0,0,10,10
1683296868536,WCWP 10B,A00,201720,Staff,10,0,15,5
1683296868536,WCWP 10B,B00,201722,Staff,8,0,15,7
1683296869565,WCWP 100,A00,201725,Gagnon; Jeffrey C,0,0,2,2
1683296869565,WCWP 100,B00,201727,Staff,0,4,15,15
1683296872718,ANBI 133,A00,258401,Wilder; Linnea Lorene,34,0,40,6
1683296873744,ANBI 140,A00,258395,Hrvoj Mihic; Branka,18,0,25,7
1683296874769,ANSC 120,A00,258402,Bialecki; Jon Anthony,27,0,40,13
1683296875794,ANSC 144,A00,258400,Staff,14,0,40,26
1683296877847,ANSC 166,A00,258396,Parish; Steven Martin,157,0,175,18
1683296878873,ANSC 180,A00,193533,Staff,9,0,20,11
1683296879899,ANSC 188,A00,258397,Jassal; Aftab,33,0,40,7
1683296880927,ANTH 3,A01,258316,Staff,23,0,30,7
1683296881953,ANTH 5,A00,258394,Semendeferi; Ekaterini,16,0,20,4
1683296882981,ANTH 21,A01,258331,Staff,9,0,40,31
1683296884008,ANTH 103,A00,258398,Varma; Saiba,15,0,25,10
1683296885042,AWP 10,001,202034,Staff,0,0,0,0
1683296885042,AWP 10,002,202035,Staff,0,0,0,0
1683296885042,AWP 10,003,202036,Staff,0,0,0,0
1683296885042,AWP 10,004,202037,Staff,0,0,0,0
1683296885042,AWP 10,005,202038,Staff,0,0,0,0
1683296885042,AWP 10,006,202039,Staff,0,0,0,0
1683296885042,AWP 10,007,202040,Staff,0,0,0,0
1683296885042,AWP 10,008,202041,Staff,0,0,0,0
1683296885042,AWP 10,009,202042,Staff,0,0,0,0
1683296885042,AWP 10,010,202043,Staff,0,0,0,0
1683296885042,AWP 10,011,202044,Staff,0,0,0,0
1683296885042,AWP 10,012,202045,Staff,0,0,0,0
1683296885042,AWP 10,013,202046,Staff,0,0,0,0
1683296885042,AWP 10,014,202047,Staff,0,0,0,0
1683296885042,AWP 10,015,202048,Staff,0,0,0,0
1683296885042,AWP 10,016,202049,Staff,0,0,0,0
1683296885042,AWP 10,017,202050,Staff,0,0,0,0
1683296885042,AWP 10,018,202051,Staff,0,0,0,0
1683296885042,AWP 10,019,202052,Staff,0,0,0,0
1683296885042,AWP 10,020,202053,Staff,0,0,0,0
1683296885042,AWP 10,021,202054,Staff,0,0,0,0
1683296885042,AWP 10,022,202055,Staff,0,0,0,0
1683296885042,AWP 10,023,202056,Staff,0,0,0,0
1683296885042,AWP 10,024,202057,Staff,0,0,0,0
1683296885042,AWP 10,025,202058,Staff,0,0,0,0
1683296885042,AWP 10,026,202059,Staff,0,0,0,0
1683296886068,AWP 102,001,202032,Staff,0,0,0,0
1683296886068,AWP 102,002,202033,Staff,0,0,0,0
1683296887094,BENG 100,A01,254234,Taylor Amos; Alyssa C,31,0,40,9
1683296888116,BENG 196,001,270013,Engler; Adam J.,9999,0,9999,0
1683296889144,BICD 100R,A01,202018,Smith; Laurie,0,7,32,32
1683296889144,BICD 100R,A02,202019,Smith; Laurie,0,2,32,32
1683296889144,BICD 100R,A03,202020,Smith; Laurie,0,1,32,32
1683296889144,BICD 100R,A04,202021,Smith; Laurie,8,0,32,24
1683296889144,BICD 100R,A05,202022,Smith; Laurie,12,0,32,20
1683296890168,BICD 136,A01,193242,Gustafson-Brown; Cindy,0,2,32,32
1683296890168,BICD 136,A02,193244,Gustafson-Brown; Cindy,15,0,32,17
1683296891193,BIEB 102,A01,193249,Butler; Shannon Rhey,0,2,32,32
1683296891193,BIEB 102,A02,193251,Butler; Shannon Rhey,0,0,32,32
1683296891193,BIEB 102,A03,193253,Butler; Shannon Rhey,0,1,32,32
1683296891193,BIEB 102,A04,193255,Butler; Shannon Rhey,17,0,32,15
1683296891193,BIEB 102,A05,193265,Butler; Shannon Rhey,26,0,32,6
1683296891193,BIEB 102,A06,193269,Butler; Shannon Rhey,16,0,32,16
1683296893255,BIEB 150,A01,193274,Staff,0,0,32,32
1683296893255,BIEB 150,A02,193285,Staff,24,0,32,8
1683296894283,BIEB 194,A00,193286,Kurle; Carolyn M.,22,0,32,10
1683296895315,BILD 1,A01,192291,Staff,16,0,32,16
1683296895315,BILD 1,A02,192292,Staff,30,0,32,2
1683296895315,BILD 1,B01,192520,Reuther; Keefe,0,1,0,0
1683296895315,BILD 1,B02,192532,Reuther; Keefe,0,1,0,0
1683296896340,BILD 3,A01,192556,Butler; Shannon Rhey,0,0,32,32
1683296896340,BILD 3,A02,192581,Butler; Shannon Rhey,5,0,32,27
1683296896340,BILD 3,A03,192611,Butler; Shannon Rhey,23,0,32,9
1683296896340,BILD 3,A04,192612,Butler; Shannon Rhey,25,0,32,7
1683296896340,BILD 3,A05,192613,Butler; Shannon Rhey,27,0,32,5
1683296896340,BILD 3,A06,192679,Butler; Shannon Rhey,27,0,32,5
1683296896340,BILD 3,A07,192682,Butler; Shannon Rhey,22,0,32,10
1683296897370,BILD 4,A01,192836,Reuther; Keefe,1,0,24,23
1683296897370,BILD 4,A02,193044,Reuther; Keefe,4,0,24,20
1683296898399,BILD 10,A01,193142,Gustafson-Brown; Cindy,31,0,32,1
1683296898399,BILD 10,A02,193149,Gustafson-Brown; Cindy,31,0,32,1
1683296899423,BIMM 100,A01,193301,Staff,0,6,32,32
1683296899423,BIMM 100,A02,193312,Staff,0,5,32,32
1683296899423,BIMM 100,A03,193323,Staff,0,8,32,32
1683296900454,BIMM 101,A01,193329,McDonnell; Lisa Marie,0,3,24,24
1683296900454,BIMM 101,A02,193339,McDonnell; Lisa Marie,0,2,24,24
1683296900454,BIMM 101,B01,193354,McDonnell; Lisa Marie,0,3,24,24
1683296900454,BIMM 101,B02,193357,McDonnell; Lisa Marie,0,3,24,24
1683296901478,BIMM 110,A01,193377,Tat; John,0,11,32,32
1683296901478,BIMM 110,A02,193378,Tat; John,1,9,32,31
1683296902505,BIMM 120,A01,206116,Staff,0,0,32,32
1683296902505,BIMM 120,A02,206117,Staff,8,0,32,24
1683296902505,BIMM 120,A03,206121,Staff,21,0,32,11
1683296903530,BIPN 100,A01,193393,Park; Ji Young,0,14,32,32
1683296903530,BIPN 100,A02,193402,Park; Ji Young,0,12,32,32
1683296903530,BIPN 100,A03,193413,Park; Ji Young,0,14,32,32
1683296903530,BIPN 100,A04,193414,Park; Ji Young,0,13,32,32
1683296904559,BIPN 102,A01,193429,Staff,0,0,32,32
1683296904559,BIPN 102,A02,193438,Staff,23,0,32,9
1683296905588,BIPN 106,A01,193450,Reyes Gonzalez; Catalina,0,2,40,40
1683296906614,BIPN 134,A01,193465,Cooke; James Edward,0,0,32,32
1683296906614,BIPN 134,A02,193474,Cooke; James Edward,27,0,32,5
1683296906614,BIPN 134,A03,193485,Cooke; James Edward,29,0,32,3
1683296906614,BIPN 134,A04,193486,Cooke; James Edward,21,0,32,11
1683296906614,BIPN 134,A05,193491,Cooke; James Edward,31,0,32,1
1683296906614,BIPN 134,A06,193501,Cooke; James Edward,30,0,32,2
1683296906614,BIPN 134,A07,193510,Cooke; James Edward,29,0,32,3
1683296908661,BISP 194,A00,222522,Staff,16,0,32,16
1683296909686,CAT 124,A01,202407,Staff,20,0,25,5
1683296910711,CAT 125,A00,202408,Marchisotto; Jennifer Anne,4,0,20,16
1683296911736,CAT 125R,A00,202409,Smith; Lauryn Alissa,0,11,20,20
1683296911736,CAT 125R,B00,202410,Morales; Celeste Georgianna,0,11,20,20
1683296911736,CAT 125R,C00,202411,Irwin; Matthew Joseph,0,10,20,20
1683296912761,CENG 15,A01,204712,Yang; Kesong,0,1,0,0
1683296913785,CENG 114,A00,202070,Jahed Motlagh; Zeinab,5,0,20,15
1683296914810,CGS 105,A00,185477,Wesling; Megan E.,24,0,40,16
1683296915859,CGS 106,A00,185494,Staff,13,0,22,9
1683296916885,CGS 108,A00,185495,Staff,14,0,20,6
1683296917910,CGS 114,A00,185496,Staff,13,0,18,5
1683296918935,CGS 119,A00,185501,Staff,15,0,20,5
1683296919958,CGS 120,A00,185511,Staff,13,0,20,7
1683296920987,CHEM 4,A01,184675,Bussey; Thomas J,96,0,100,4
1683296922012,CHEM 6A,A01,184677,Staff,35,0,60,25
1683296923037,CHEM 6B,A01,184679,Staff,65,0,100,35
1683296924060,CHEM 6C,A01,184681,Bussey; Thomas J,1,0,50,49
1683296924060,CHEM 6C,A02,184682,Bussey; Thomas J,34,0,50,16
1683296925088,CHEM 40A,A01,184684,Albizati; Kim F.,37,0,100,63
1683296926114,CHEM 40B,A01,184686,Albizati; Kim F.,0,20,100,100
1683296927141,CHEM 41B,A01,184690,Staff,52,0,100,48
1683296928165,COGS 3,A01,184715,Boyle; Mary E. T.,0,25,40,40
1683296929187,COGS 14B,A01,185172,Staff,0,15,38,38
1683296930212,COGS 18,A01,184736,Staff,20,0,80,60
1683296931240,COGS 100,A01,184932,Staff,0,5,73,73
1683296932264,COGS 101A,A01,184935,Staff,0,38,30,30
1683296933293,COGS 101B,A01,184944,Staff,0,2,30,30
1683296934321,COGS 101C,A01,184946,Staff,0,12,30,30
1683296935345,COGS 102A,A01,184951,Johnson; Christine M.,2,0,40,38
1683296936370,COGS 107B,A01,184953,Mooshagian; Eric Frederick,0,50,40,40
1683296937394,COGS 118B,A01,184959,Gupta; Anjum,0,48,40,40
1683296938416,COGS 153,A00,184961,Staff,0,15,30,30
1683296939440,COGS 177,A00,184962,Staff,0,21,30,30
1683296940467,COGS 187A,A01,184969,Boyle; Mary E. T.,0,17,40,40
1683296941493,COMM 10,A01,185174,Staff,0,5,25,25
1683296941493,COMM 10,A02,185189,Staff,0,5,25,25
1683296941493,COMM 10,A03,269821,Staff,0,0,0,0
1683296942517,COMM 100B,A01,185475,Staff,0,0,0,2
1683296942517,COMM 100B,A02,185476,Staff,14,0,25,11
1683296943545,COMM 100C,A01,185314,Staff,1,0,25,24
1683296943545,COMM 100C,A02,185327,Staff,19,0,25,6
1683296944573,COMM 110M,A00,185349,Staff,2,0,40,38
1683296945598,COMM 113T,A00,185352,Staff,25,0,40,15
1683296946622,COMM 114I,A00,185353,Staff,33,0,40,7
1683296947646,COMM 131,A00,185354,Staff,19,0,30,11
1683296948671,CSE 8A,A50,185358,Cao; Yingjun,0,46,10,10
1683296949699,CSE 8B,A01,185362,Staff,1,47,50,49
1683296950725,CSE 11,A01,185416,Cao; Yingjun,0,93,10,10
1683296951753,CSE 20,A01,185445,Briones; Jor-el Thomas Caparas,5,0,25,20
1683296952778,CSE 21,A01,185447,Staff,10,0,50,40
1683296953808,CSE 101,A01,185451,Staff,0,12,50,50
1683296953808,CSE 101,B01,185453,Jones; Miles E,0,11,50,50
1683296955859,CSE 141,A01,185458,Eldon; John,20,0,100,80
1683296956887,CSE 141L,A01,185461,Eldon; John,12,0,100,88
1683296957912,CSE 142,A01,185463,Staff,35,0,60,25
1683296957912,CSE 142,B01,201355,Staff,0,6,60,60
1683296958939,CSE 142L,A01,185470,Staff,35,0,60,25
1683296958939,CSE 142L,B01,201417,Staff,0,5,60,60
1683296959966,CSE 190,A00,201433,Staff,32,0,49,17
1683296960994,DOC 1,A01,259136,Strom; Megan C.,8,0,15,7
1683296960994,DOC 1,A02,259137,Strom; Megan C.,14,0,15,1
1683296960994,DOC 1,A03,259138,Strom; Megan C.,14,0,15,1
1683296960994,DOC 1,A04,259139,Strom; Megan C.,14,0,15,1
1683296962018,DOC 100D,A00,259140,Pass; Natalye Joann,17,0,25,8
1683296963045,DSGN 1,A01,184749,Rill; Bryan,0,24,30,30
1683296964069,DSGN 100,A01,185168,Staff,0,2,25,25
1683296965092,ECE 5,A01,185626,Morris; Karcher William,0,10,0,0
1683296966117,ECE 101,A01,185628,Staff,17,0,70,53
1683296967196,ECE 107,A01,185635,Baghdadchi; Saharnaz,0,0,20,20
1683296967196,ECE 107,A02,185638,Baghdadchi; Saharnaz,4,0,20,16
1683296968219,ECE 148,A01,185647,Silberman; Jack,1,0,16,15
1683296969243,ECON 1,A01,185537,Crane; Meredith Helen,54,0,70,16
1683296970266,ECON 3,A01,185549,Crane; Meredith Helen,33,0,70,37
1683296971291,ECON 4,A01,203354,Anderson; John Charles,0,4,10,10
1683296972315,ECON 100A,A01,185574,Staff,0,4,40,40
1683296973343,ECON 100B,A01,185576,Staff,0,22,40,40
1683296974369,ECON 100C,A01,185589,Newhouse; Herbert S,30,0,70,40
1683296975395,ECON 105,A00,185608,Vespa; Emanuel Ignacio,19,0,35,16
1683296976423,ECON 109,A01,185610,Shishkin; Denis,10,0,35,25
1683296977447,ECON 110A,A01,185612,Staff,11,0,40,29
1683296978476,ECON 120A,A01,185615,Staff,20,0,40,20
1683296979500,ECON 120C,A01,185617,Sun; Yixiao,0,20,70,70
1683296980529,ECON 144,A00,203346,Squires; Dale E,3,0,35,32
1683296981558,ECON 171,A01,203349,Newhouse; Herbert S,0,1,35,35
1683296982582,ECON 173A,A01,185621,Toda; Alexis Akira,21,0,35,14
1683296983606,EDS 25,A01,202413,Staff,0,1,0,0
1683296983606,EDS 25,A02,202414,Staff,0,1,0,0
1683296983606,EDS 25,A03,202415,Staff,0,0,0,0
1683296983606,EDS 25,A04,202416,Staff,0,1,0,0
1683296983606,EDS 25,A05,202439,Staff,0,0,0,0
1683296983606,EDS 25,A06,202440,Staff,0,0,0,0
1683296983606,EDS 25,B01,202631,Staff,0,0,0,0
1683296983606,EDS 25,B02,202632,Staff,0,0,0,0
1683296983606,EDS 25,B03,202639,Staff,0,0,0,0
1683296983606,EDS 25,B04,202640,Staff,0,0,0,0
1683296983606,EDS 25,B05,202643,Staff,0,0,0,0
1683296983606,EDS 25,B06,202644,Staff,0,0,0,0
1683296984631,EDS 38,A01,202659,Black; Alison Michelle,24,0,25,1
1683296985659,EDS 115,A00,202652,Staff,17,0,30,13
1683296986685,EDS 125,A00,202649,Staff,14,0,30,16
1683296987710,EDS 126,A01,203332,Staff,30,0,30,0
1683296988737,EDS 139,A00,202838,Staff,17,0,25,8
1683296989765,EDS 146,A01,202655,Staff,15,0,25,10
1683296990795,ENG 15,A00,185667,Staff,0,1,0,0
1683296990795,ENG 15,B00,185672,Staff,0,0,0,0
1683296990795,ENG 15,C00,185675,Staff,0,0,0,0
1683296990795,ENG 15,D00,185682,Staff,0,0,0,0
1683296990795,ENG 15,E00,185684,Staff,0,0,0,0
1683296991820,ETHN 103,A00,185710,Staff,0,3,35,35
1683296992846,ETHN 103A,A00,199228,Man; Simeon S,3,0,9,6
1683296993875,ETHN 109,A00,185711,Staff,18,0,35,17
1683296994911,ETHN 142,A00,185726,Staff,0,4,30,30
1683296995936,ETHN 163J,A00,199229,Man; Simeon S,6,0,8,2
1683296996960,ETHN 168,A00,185727,Staff,8,0,10,2
1683296997983,ETHN 182,A00,185728,Staff,1,0,35,34
1683296999011,ETHN 183,A00,185737,Staff,8,0,18,10
1683297000041,GLBH 111,A01,209361,Burgos; Jose L.,0,0,0,0
1683297002092,HIEU 104,A00,185792,Staff,16,0,20,4
1683297003116,HIEU 115,A00,185800,Staff,1,0,20,19
1683297004139,HIEU 128,A00,185801,Staff,0,7,20,20
1683297005162,HIEU 147,A00,185802,Staff,16,0,20,4
1683297006185,HIEU 154,A00,185823,Staff,12,0,20,8
1683297007213,HILA 102,A00,185826,Staff,13,0,20,7
1683297008241,HILD 2C,A01,185778,Staff,0,12,20,20
1683297009268,HILD 7B,A01,185780,Kwak; Nancy,0,15,32,32
1683297009268,HILD 7B,A02,185781,Kwak; Nancy,0,18,32,32
1683297010293,HILD 30,A01,185791,Staff,14,0,20,6
1683297011318,HISC 119,A00,185830,Golan; Tal,0,9,20,20
1683297012342,HITO 156GS,A00,185831,Patterson; Patrick H.,0,0,0,23
1683297013367,HIUS 103,A00,185832,Man; Simeon S,0,7,20,20
1683297014392,HIUS 117,A00,185836,Kwak; Nancy,2,0,20,18
1683297015417,HIUS 125,A00,185840,Man; Simeon S,0,0,23,23
1683297016445,HIUS 149,A00,185845,Staff,0,0,20,20
1683297017470,HUM 3,A01,185882,Zavodny; Tatiana Sophia,0,6,50,50
1683297017470,HUM 3,B01,185899,Caldwell; Michael Alan,0,19,50,50
1683297018497,HUM 3GS,A00,185900,Patterson; Patrick H.,0,0,0,23
1683297019524,HUM 4,A01,185938,Zroka; Amy Liane,31,0,50,19
1683297019524,HUM 4,B01,185956,Watkins; Eric,0,2,50,50
1683297019524,HUM 4,B02,202209,Watkins; Eric,0,1,50,50
1683297019524,HUM 4,B03,202210,Watkins; Eric,0,0,50,50
1683297020551,HUM 5,A01,185958,West; Geoffrey Scott,5,0,50,45
1683297020551,HUM 5,A02,202215,West; Geoffrey Scott,0,0,50,50
1683297021580,INTL 190,A00,185959,Gagnon; Jeffrey C,0,0,0,9
1683297021580,INTL 190,B00,185960,Lettieri; Michael Joseph,0,0,0,1
1683297022608,JAPN 180,A00,254509,Staff,0,1,25,25
1683297023637,LATI 10,A01,202853,Kennemore; Amy Michelle,5,0,35,30
1683297023637,LATI 10,A02,202854,Kennemore; Amy Michelle,1,0,35,34
1683297023637,LATI 10,A03,270054,Kennemore; Amy Michelle,30,0,30,0
1683297024666,LATI 180,A00,202855,Kennemore; Amy Michelle,11,0,20,9
1683297025691,LAWS 101,A00,201767,Golan; Tal,0,7,40,40
1683297026716,LIFR 1C,A00,185961,Staff,6,0,20,14
1683297027741,LIFR 1CX,A00,185962,Staff,7,0,20,13
1683297028766,LIFR 1D,A00,185963,Staff,9,0,20,11
1683297029790,LIFR 1DX,A00,185964,Staff,9,0,20,11
1683297030812,LIGN 101,A01,186039,Staff,43,0,50,7
1683297031835,LIGN 165,A00,186040,Staff,18,0,50,32
1683297032859,LTCS 108,A00,186041,Staff,6,0,10,4
1683297033894,LTCS 119,A00,186042,Staff,16,0,20,4
1683297034919,LTCS 130,A00,186043,Wesling; Megan E.,15,0,25,10
1683297036972,LTEA 138,A00,186119,Staff,14,0,40,26
1683297037998,LTEN 124,A00,186148,Staff,6,0,25,19
1683297039022,LTEN 178,A00,186149,Staff,7,0,15,8
1683297040051,LTEN 181,A00,186150,Blanco; John D,33,0,40,7
1683297041077,LTWL 120,A00,186160,Staff,20,0,25,5
1683297042102,LTWL 165,A00,186161,Staff,22,0,25,3
1683297043127,LTWR 100,A00,186162,Staff,0,4,15,15
1683297044154,LTWR 102,A00,186163,Doller; Ben,5,0,15,10
1683297045178,MAE 8,A01,186412,Staff,0,0,0,0
1683297046202,MAE 30B,A00,186445,Bahadori; Mohammad Yousef,83,0,100,17
1683297047226,MAE 40,A00,186592,Bewley; Thomas R,9,0,50,41
1683297048257,MAE 101B,A00,186593,Bahadori; Mohammad Yousef,81,0,100,19
1683297049284,MAE 105,A00,186594,Bandaru; Prabhakar,12,0,50,38
1683297050308,MAE 107,A00,186599,Pham; Hieu Tan,0,6,120,120
1683297051332,MAE 148,A01,186660,Silberman; Jack,3,0,16,13
1683297052357,MATH 10A,A01,188095,Staff,0,7,35,35
1683297053386,MATH 10B,A01,188097,Bowers; Adam R.,0,11,30,30
1683297053386,MATH 10B,A02,188099,Bowers; Adam R.,0,9,30,30
1683297053386,MATH 10B,B01,188104,Bowers; Adam R.,0,11,30,30
1683297053386,MATH 10B,B02,188106,Bowers; Adam R.,0,11,30,30
1683297054411,MATH 10C,A01,188111,Staff,0,18,30,30
1683297054411,MATH 10C,A02,188127,Staff,0,17,30,30
1683297054411,MATH 10C,A03,188131,Staff,0,17,30,30
1683297054411,MATH 10C,B01,188218,Staff,21,0,30,9
1683297054411,MATH 10C,B02,188244,Staff,13,0,30,17
1683297054411,MATH 10C,B03,188277,Staff,16,0,30,14
1683297055437,MATH 18,A01,188344,Bach; Quang Tran,18,0,30,12
1683297055437,MATH 18,A02,188345,Bach; Quang Tran,11,0,30,19
1683297055437,MATH 18,B01,188353,Bach; Quang Tran,10,0,30,20
1683297055437,MATH 18,B02,188354,Bach; Quang Tran,20,0,30,10
1683297056465,MATH 20A,A01,188374,Staff,13,0,35,22
1683297057496,MATH 20B,A01,188382,Ohm; Ko Woon,6,0,30,24
1683297057496,MATH 20B,A02,188383,Ohm; Ko Woon,24,0,30,6
1683297057496,MATH 20B,B01,188385,Ohm; Ko Woon,7,0,30,23
1683297057496,MATH 20B,B02,188392,Ohm; Ko Woon,22,0,30,8
1683297058523,MATH 20C,A01,188394,Harel; Guershon,10,0,30,20
1683297058523,MATH 20C,A02,188395,Harel; Guershon,13,0,30,17
1683297058523,MATH 20C,B01,188404,Harel; Guershon,3,0,30,27
1683297058523,MATH 20C,B02,188405,Harel; Guershon,19,0,30,11
1683297059550,MATH 20D,A01,188414,Hammock; Frances H,0,1,30,30
1683297059550,MATH 20D,A02,188415,Hammock; Frances H,4,0,30,26
1683297059550,MATH 20D,B01,188447,Hammock; Frances H,2,0,30,28
1683297059550,MATH 20D,B02,188486,Hammock; Frances H,8,0,30,22
1683297060579,MATH 20E,A01,188649,Staff,22,0,30,8
1683297060579,MATH 20E,A02,188650,Staff,23,0,30,7
1683297060579,MATH 20E,A03,188673,Staff,0,0,30,30
1683297061610,MATH 102,A01,188675,Staff,0,35,35,35
1683297062639,MATH 103B,A01,188681,Staff,4,0,35,31
1683297062639,MATH 103B,B01,188692,Staff,7,0,35,28
1683297063665,MATH 109,A01,188695,Salehi Golsefidy; Alireza,25,0,35,10
1683297063665,MATH 109,A02,188696,Salehi Golsefidy; Alireza,27,0,35,8
1683297064690,MATH 120A,A01,188698,Eggers; John Dietrich,5,0,35,30
1683297065716,MATH 142B,A01,188736,Ioana; Adrian,0,2,30,30
1683297065716,MATH 142B,A02,188741,Ioana; Adrian,0,1,30,30
1683297065716,MATH 142B,A03,188743,Ioana; Adrian,0,3,30,30
1683297066744,MATH 168A,A01,188790,Staff,0,8,35,35
1683297067774,MATH 170A,A01,188803,Nie; Jiawang,0,2,35,35
1683297067774,MATH 170A,A02,188811,Nie; Jiawang,0,0,35,35
1683297067774,MATH 170A,A03,188814,Nie; Jiawang,1,0,35,34
1683297067774,MATH 170A,A04,188815,Nie; Jiawang,14,0,35,21
1683297068802,MATH 193B,A01,188817,Staff,0,0,35,35
1683297068802,MATH 193B,A02,188818,Staff,5,0,35,30
1683297069832,MGT 4,A01,202857,Anderson; John Charles,62,0,80,18
1683297070930,MGT 12,A00,202858,Lindenberger; Wade Douglas,43,0,90,47
1683297071954,MGT 18,A00,202859,Staff,74,0,90,16
1683297072978,MGT 18GS,A00,202860,McKay; Michael J,13,0,28,15
1683297074006,MGT 45,A00,202861,Pecore; Joseph P.,14,0,90,76
1683297075034,MGT 100,A00,202863,Yavorsky; Daniel Ryan,28,0,90,62
1683297076058,MGT 103,A00,202864,Ehrich; Kristine R,0,16,90,90
1683297077083,MGT 112,A00,202865,Ehrich; Kristine R,15,0,90,75
1683297078112,MGT 121A,A00,202868,Staff,0,19,0,0
1683297079136,MGT 131B,A00,202869,Anderson; John Charles,59,0,90,31
1683297080164,MGT 136,A00,202871,Lindenberger; Wade Douglas,84,0,90,6
1683297081191,MGT 164,A00,202873,Staff,0,69,90,90
1683297082218,MGT 164GS,A00,202874,McKay; Mary A,13,0,28,15
1683297083243,MGT 180,A00,202875,Staff,0,51,90,90
1683297084268,MMW 11R,A01,205019,Herbst; Matthew,3,0,30,27
1683297084268,MMW 11R,A02,205026,Herbst; Matthew,29,0,30,1
1683297085298,MMW 15,A01,193512,Chang; Edmond Yi-Teh,0,9,28,28
1683297085298,MMW 15,A02,193513,Chang; Edmond Yi-Teh,0,5,28,28
1683297085298,MMW 15,A03,193514,Chang; Edmond Yi-Teh,0,5,28,28
1683297085298,MMW 15,A04,193515,Chang; Edmond Yi-Teh,0,4,28,28
1683297085298,MMW 15,A05,193516,Chang; Edmond Yi-Teh,0,4,28,28
1683297085298,MMW 15,A06,193517,Chang; Edmond Yi-Teh,0,5,28,28
1683297085298,MMW 15,B01,193519,Chang; Edmond Yi-Teh,0,4,28,28
1683297085298,MMW 15,B02,193520,Chang; Edmond Yi-Teh,0,5,28,28
1683297085298,MMW 15,B03,193521,Chang; Edmond Yi-Teh,0,4,28,28
1683297085298,MMW 15,B04,193522,Chang; Edmond Yi-Teh,0,4,28,28
1683297085298,MMW 15,B05,193523,Chang; Edmond Yi-Teh,0,5,28,28
1683297085298,MMW 15,B06,193524,Chang; Edmond Yi-Teh,0,4,28,28
1683297086328,MMW 122,A01,193526,Rahimi; Babak,0,14,28,28
1683297086328,MMW 122,A02,193527,Rahimi; Babak,0,14,28,28
1683297086328,MMW 122,A03,193528,Rahimi; Babak,0,0,0,0
1683297086328,MMW 122,A04,193529,Rahimi; Babak,0,0,0,0
1683297087352,MUS 1A,A01,186663,Staff,0,20,35,35
1683297088378,MUS 4,A01,186715,Staff,0,12,35,35
1683297089405,MUS 5R,A01,186796,Dubnov; Shlomo,0,16,35,35
1683297090430,MUS 6,A01,186798,Staff,0,3,25,25
1683297091458,MUS 7,A01,186830,Staff,12,0,35,23
1683297092481,MUS 8,A01,186930,Staff,0,25,35,35
1683297093506,MUS 15,A01,186932,Staff,0,15,35,35
1683297093506,MUS 15,B01,186934,Staff,0,14,35,35
1683297094530,MUS 80,A00,186935,Staff,2,0,20,18
1683297094530,MUS 80,B00,186936,Staff,25,0,25,0
1683297095557,NANO 11,A00,204702,Lipomi; Darren John,0,0,0,0
1683297096582,NANO 15,A01,204709,Yang; Kesong,0,1,0,0
1683297097606,NANO 114,A00,202069,Jahed Motlagh; Zeinab,3,0,10,7
1683297098630,PHIL 1,A00,186955,Grush; Rick Scott,32,0,40,8
1683297099655,PHIL 10,A01,186973,Grush; Rick Scott,29,0,35,6
1683297099655,PHIL 10,A02,186974,Grush; Rick Scott,33,0,35,2
1683297100682,PHIL 13,A01,186976,Staff,7,0,35,28
1683297100682,PHIL 13,A02,186977,Staff,16,0,35,19
1683297101710,PHIL 14,A01,186979,Staff,31,0,35,4
1683297101710,PHIL 14,A02,186986,Staff,32,0,35,3
1683297102738,PHIL 28,A01,186988,Staff,16,0,30,14
1683297102738,PHIL 28,A02,186989,Staff,1,0,30,29
1683297102738,PHIL 28,A03,186990,Staff,9,0,30,21
1683297102738,PHIL 28,A04,186991,Staff,26,0,30,4
1683297103764,PHIL 120,A00,186997,Staff,23,0,40,17
1683297104791,PHIL 137,A00,187003,Staff,9,0,40,31
1683297105818,PHIL 150,A00,187015,Staff,47,0,70,23
1683297106843,PHIL 167,A00,187021,Lamey; Andy M.,35,0,40,5
1683297107869,PHIL 174,A01,202226,Staff,17,0,20,3
1683297107869,PHIL 174,A02,202235,Staff,20,0,20,0
1683297108896,PHIL 191A,A00,258918,Staff,0,0,1,1
1683297109923,PHYS 1A,A00,187028,Staff,26,0,60,34
1683297110948,PHYS 1AL,001,187036,Staff,2,0,30,28
1683297110948,PHYS 1AL,002,187049,Staff,18,0,30,12
1683297111973,PHYS 1B,A00,187058,Staff,23,0,60,37
1683297112999,PHYS 1BL,001,187064,Staff,0,0,30,30
1683297112999,PHYS 1BL,002,187070,Staff,6,0,30,24
1683297114024,PHYS 1C,A00,187082,Staff,32,0,120,88
1683297115052,PHYS 1CL,001,187088,Staff,0,9,30,30
1683297115052,PHYS 1CL,002,187089,Staff,0,2,30,30
1683297115052,PHYS 1CL,009,262693,Staff,12,0,30,18
1683297116086,PHYS 2B,A01,187097,Staff,54,0,115,61
1683297117110,PHYS 2C,A01,187099,Staff,67,0,115,48
1683297118137,PHYS 2CL,A01,187101,Staff,5,0,28,23
1683297118137,PHYS 2CL,A02,187102,Staff,15,0,28,13
1683297119161,PHYS 2D,A01,187123,Shotwell; Brian,95,0,115,20
1683297120188,PHYS 4B,A01,187133,Grinstein; Benjamin,35,0,50,15
1683297121212,POLI 10,A00,188819,Staff,0,3,50,50
1683297122236,POLI 11,A00,188827,Staff,43,0,50,7
1683297123261,POLI 13R,A00,188828,Staff,0,1,20,20
1683297124290,POLI 27,A01,188830,Elgin; Samuel Zincke,0,1,70,70
1683297125319,POLI 30,A00,188832,Desposato; Scott,33,0,50,17
1683297126345,POLI 102F,A00,188834,Staff,3,0,40,37
1683297127369,POLI 104A,A00,188852,Staff,14,0,30,16
1683297128401,POLI 104I,A00,188853,Staff,0,6,20,20
1683297129426,POLI 110B,A00,188854,Wiens; David,7,0,20,13
1683297130453,POLI 112A,A00,188855,Wiens; David,5,0,30,25
1683297131481,POLI 117R,A00,188856,Forman; Fonna,0,11,20,20
1683297132510,POLI 118,A00,188857,Ingham; Sean,8,0,20,12
1683297133537,POLI 120G,A00,188858,Staff,9,0,30,21
1683297134562,POLI 131CR,A00,188863,Hoston; Germaine,24,0,50,26
1683297135586,POLI 133,A00,188864,Nellis; Gareth Hb,44,0,50,6
1683297136613,POLI 134D,A00,188865,Desposato; Scott,27,0,30,3
1683297137643,POLI 142A,A00,188871,Gartzke; Erik,22,0,50,28
1683297138668,POLI 142K,A00,188874,Staff,38,0,50,12
1683297139695,POLI 143,A00,188940,Gartzke; Erik,16,0,30,14
1683297140725,POLI 153,A00,188943,Staff,3,0,20,17
1683297141753,POLI 160AA,A00,188944,Staff,13,0,40,27
1683297142780,POLI 170A,A00,188945,Staff,11,0,30,19
1683297144834,PSYC 1,A00,188952,Staff,38,0,90,52
1683297145861,PSYC 2,B00,188953,Staff,20,0,35,15
1683297146886,PSYC 6,A00,188970,Staff,47,0,60,13
1683297147911,PSYC 7,A00,188973,Staff,37,0,45,8
1683297148942,PSYC 60,A01,188980,Rickard; Timothy C.,43,0,60,17
1683297149968,PSYC 70,A01,189001,Steiner; Eric Tomas,24,0,45,21
1683297150993,PSYC 100,A00,189005,Lacefield; Katharine I,0,99,120,120
1683297152019,PSYC 102,A00,189008,Staff,10,0,30,20
1683297153049,PSYC 106,B00,189026,Gorman; Michael R.,37,0,60,23
1683297154077,PSYC 114,B01,189033,Winkielman; Piotr,0,32,30,30
1683297155105,PSYC 131,A00,189036,Anagnostaras; Stephan,0,43,60,60
1683297156131,PSYC 136,A00,189041,Lowe; Angela Beth,0,7,25,25
1683297157158,PSYC 137,A00,189057,Winkielman; Piotr,0,34,25,25
1683297158183,PSYC 144,A00,189107,Wixted; John T,0,7,50,50
1683297160239,PSYC 162,A00,189142,Staff,0,8,85,85
1683297161263,PSYC 172,A00,189144,Gorman; Michael R.,0,7,30,30
1683297163312,PSYC 179,A00,189146,Lacefield; Katharine I,0,84,120,120
1683297164337,PSYC 181,A00,189147,Anagnostaras; Stephan,0,44,90,90
1683297165365,PSYC 190R,A00,189148,Barner; David A.,0,22,80,80
1683297166389,PSYC 191,A00,189275,Rickard; Timothy C.,0,7,25,25
1683297167418,PSYC 193,A00,189276,Chapman; Eddie Nathaniel,0,1,0,4
1683297168466,PSYC 193L,A01,189281,Lowe; Angela Beth,12,0,20,8
1683297168466,PSYC 193L,B01,189285,Staff,28,0,35,7
1683297169489,RELI 149,A00,187137,Rahimi; Babak,7,0,40,33
1683297170515,SE 9,A01,187315,Staff,0,2,18,18
1683297171540,SE 101B,A00,187409,Staff,24,0,30,6
1683297172565,SE 110B,A00,187444,Staff,10,0,40,30
1683297173591,SE 130B,A00,187449,Staff,31,0,40,9
1683297174675,SE 150A,A00,187516,Staff,9,0,20,11
1683297175703,SE 154,A00,187528,Staff,30,0,50,20
1683297176732,SIO 3,A01,258171,Staff,35,0,40,5
1683297177759,SIO 10,A00,187144,Cook; Geoffrey W,0,3,75,75
1683297178787,SIO 45,A00,187152,Cook; Geoffrey W,1,0,100,99
1683297179814,SIO 109R,A00,194486,Staff,0,3,20,20
1683297181874,SIO 187,A01,187233,Kacev; David,12,0,40,28
1683297182898,SOCI 1,A01,258656,Thorpe; Charles Robert,28,0,30,2
1683297182898,SOCI 1,A02,258658,Thorpe; Charles Robert,30,0,30,0
1683297182898,SOCI 1,A03,258661,Thorpe; Charles Robert,25,0,25,0
1683297182898,SOCI 1,A04,258666,Thorpe; Charles Robert,22,0,25,3
1683297182898,SOCI 1,A05,258897,Thorpe; Charles Robert,23,0,25,2
1683297182898,SOCI 1,A06,258898,Thorpe; Charles Robert,25,0,25,0
1683297183927,SOCI 30,A01,258903,Pardo Guerra; Juan Pablo,16,0,30,14
1683297184955,SOCI 102,A00,258904,Staff,9,0,25,16
1683297185980,SOCI 106,A00,258905,Staff,19,0,25,6
1683297187006,SOCI 111,A00,258907,Ribas Norris; Janet Vanesa,26,0,30,4
1683297188034,SOCI 121R,A00,258908,Pardo Guerra; Juan Pablo,11,0,30,19
1683297189061,SOCI 126,A01,203330,Staff,14,0,20,6
1683297190086,SOCI 131,A00,258909,Thorpe; Charles Robert,31,0,60,29
1683297191111,SOCI 135,A00,258910,Payne; Christine Anna,0,9,30,30
1683297192137,SOCI 157,A00,258911,Staff,13,0,30,17
1683297193160,SOCI 184,A00,258912,Staff,26,0,30,4
1683297194188,SOCI 188D,A00,258913,Staff,21,0,30,9
1683297195217,SYN 2,001,187529,Staff,9,0,16,7
1683297195217,SYN 2,002,201452,Staff,0,18,16,16
1683297195217,SYN 2,003,201469,Staff,3,0,16,13
1683297196243,SYN 100,A01,187531,Staff,0,9,20,20
1683297196243,SYN 100,B01,201491,Staff,0,12,20,20
1683297197271,TDAC 1,A00,189286,Walsh; Kim C.,3,0,20,17
1683297197271,TDAC 1,B00,189287,Harting; Carla Kelso,11,0,20,9
1683297198298,TDAC 101,A00,189300,Walsh; Kim C.,16,0,20,4
1683297198298,TDAC 101,B00,189301,Harting; Carla Kelso,18,0,20,2
1683297199326,TDAC 102,A00,189304,Basso; Beatrice,14,0,20,6
1683297200348,TDAC 108,A00,189305,Staff,18,0,20,2
1683297201379,TDDE 131,A00,189310,Staff,19,0,20,1
1683297201379,TDDE 131,B00,189314,Staff,19,0,20,1
1683297201379,TDDE 131,C00,189315,Staff,48,0,50,2
1683297201379,TDDE 131,D00,189316,Staff,14,0,15,1
1683297201379,TDDE 131,E00,204841,Staff,20,0,20,0
1683297202404,TDGE 10,A00,189289,Staff,30,0,50,20
1683297202404,TDGE 10,B00,189290,Havis; Allan,2,0,50,48
1683297203429,TDGE 11,A00,189291,Fulton; Julia,0,3,50,50
1683297203429,TDGE 11,B00,189292,Staff,20,0,25,5
1683297203429,TDGE 11,C00,260270,Staff,0,0,0,0
1683297204458,TDGE 25,A00,189294,Staff,3,0,20,17
1683297205483,TDGE 124,A00,189318,Fulton; Julia,0,8,50,50
1683297206507,TDGE 125,A00,189319,Staff,13,0,25,12
1683297206507,TDGE 125,B00,189320,Staff,23,0,25,2
1683297207531,TDGE 127,A00,189322,Havis; Allan,0,0,50,50
1683297208561,TDHT 101,A00,189323,Staff,18,0,25,7
1683297208561,TDHT 101,B00,189324,Staff,25,0,25,0
1683297209586,TDHT 102,A00,189325,Staff,49,0,50,1
1683297210615,TDMV 1,A00,189295,Arcidiacono; Kristin,20,0,30,10
1683297210615,TDMV 1,B00,189296,Caligagan; Maria T.,24,0,30,6
1683297211642,TDMV 2,A00,189297,Sammartano; Tonnie,28,0,30,2
1683297211642,TDMV 2,B00,189299,Arcidiacono; Kristin,24,0,30,6
1683297212667,TDMV 3,A00,204998,Rincon; Alicia,22,0,30,8
1683297213694,TDMV 120,A00,189458,Sammartano; Tonnie,28,0,30,2
1683297214718,TDMV 138,A00,189541,Jun; Grace Shin Hae,22,0,40,18
1683297215743,TDMV 142,A00,189717,Caligagan; Tony,23,0,30,7
1683297215743,TDMV 142,B00,189718,Caligagan; Maria T.,25,0,30,5
1683297216768,TMC 2,A01,187533,Staff,25,0,25,0
1683297216768,TMC 2,A02,187534,Staff,25,0,25,0
1683297217792,USP 1,A01,187536,Kwak; Nancy,0,16,25,25
1683297218819,USP 5,A01,187538,Staff,9,0,25,16
1683297219846,USP 101,A00,199253,Staff,0,4,0,0
1683297220870,USP 124,A00,187562,Boomhower; Matthew Charles,1,0,30,29
1683297221897,USP 138,A00,187582,Staff,20,0,25,5
1683297222924,USP 152,A01,187597,Staff,4,0,25,21
1683297223948,USP 153,A00,187598,Staff,19,0,25,6
1683297224973,USP 168,A00,187607,Kwak; Nancy,2,0,5,3
1683297226001,USP 173,A00,187619,Staff,4,0,25,21
1683297227026,USP 181,A00,187638,Staff,0,0,25,25
1683297228049,VIS 103,A00,187650,Cruz; Edwin Teddy,23,0,75,52
1683297229076,VIS 110D,A00,187669,Staff,12,0,22,10
1683297230104,VIS 127C,A00,187720,Shen; Kuiyi,68,0,146,78
1683297231132,VIS 149,A00,187731,Yoldas; Pinar,0,14,22,22
1683297232156,VIS 151,A01,188091,Staff,22,0,34,12
1683297232156,VIS 151,A02,188092,Staff,11,0,34,23
1683297233183,VIS 160B,A00,188093,Stalbaum; Brett,0,0,10,10
1683297235232,WCWP 10B,A00,201720,Staff,10,0,15,5
1683297235232,WCWP 10B,B00,201722,Staff,8,0,15,7
1683297236260,WCWP 100,A00,201725,Gagnon; Jeffrey C,0,0,2,2
1683297236260,WCWP 100,B00,201727,Staff,0,4,15,15
1683297239355,ANBI 133,A00,258401,Wilder; Linnea Lorene,34,0,40,6
1683297240384,ANBI 140,A00,258395,Hrvoj Mihic; Branka,18,0,25,7
1683297241409,ANSC 120,A00,258402,Bialecki; Jon Anthony,27,0,40,13
1683297242436,ANSC 144,A00,258400,Staff,14,0,40,26
1683297244489,ANSC 166,A00,258396,Parish; Steven Martin,157,0,175,18
1683297245514,ANSC 180,A00,193533,Staff,9,0,20,11
1683297246540,ANSC 188,A00,258397,Jassal; Aftab,33,0,40,7
1683297247568,ANTH 3,A01,258316,Staff,23,0,30,7
1683297248593,ANTH 5,A00,258394,Semendeferi; Ekaterini,16,0,20,4
1683297249618,ANTH 21,A01,258331,Staff,9,0,40,31
1683297250647,ANTH 103,A00,258398,Varma; Saiba,15,0,25,10
1683297251674,AWP 10,001,202034,Staff,0,0,0,0
1683297251674,AWP 10,002,202035,Staff,0,0,0,0
1683297251674,AWP 10,003,202036,Staff,0,0,0,0
1683297251674,AWP 10,004,202037,Staff,0,0,0,0
1683297251674,AWP 10,005,202038,Staff,0,0,0,0
1683297251674,AWP 10,006,202039,Staff,0,0,0,0
1683297251674,AWP 10,007,202040,Staff,0,0,0,0
1683297251674,AWP 10,008,202041,Staff,0,0,0,0
1683297251674,AWP 10,009,202042,Staff,0,0,0,0
1683297251674,AWP 10,010,202043,Staff,0,0,0,0
1683297251674,AWP 10,011,202044,Staff,0,0,0,0
1683297251674,AWP 10,012,202045,Staff,0,0,0,0
1683297251674,AWP 10,013,202046,Staff,0,0,0,0
1683297251674,AWP 10,014,202047,Staff,0,0,0,0
1683297251674,AWP 10,015,202048,Staff,0,0,0,0
1683297251674,AWP 10,016,202049,Staff,0,0,0,0
1683297251674,AWP 10,017,202050,Staff,0,0,0,0
1683297251674,AWP 10,018,202051,Staff,0,0,0,0
1683297251674,AWP 10,019,202052,Staff,0,0,0,0
1683297251674,AWP 10,020,202053,Staff,0,0,0,0
1683297251674,AWP 10,021,202054,Staff,0,0,0,0
1683297251674,AWP 10,022,202055,Staff,0,0,0,0
1683297251674,AWP 10,023,202056,Staff,0,0,0,0
1683297251674,AWP 10,024,202057,Staff,0,0,0,0
1683297251674,AWP 10,025,202058,Staff,0,0,0,0
1683297251674,AWP 10,026,202059,Staff,0,0,0,0
1683297252701,AWP 102,001,202032,Staff,0,0,0,0
1683297252701,AWP 102,002,202033,Staff,0,0,0,0
1683297253726,BENG 100,A01,254234,Taylor Amos; Alyssa C,31,0,40,9
1683297254751,BENG 196,001,270013,Engler; Adam J.,9999,0,9999,0
1683297255775,BICD 100R,A01,202018,Smith; Laurie,0,7,32,32
1683297255775,BICD 100R,A02,202019,Smith; Laurie,0,2,32,32
1683297255775,BICD 100R,A03,202020,Smith; Laurie,0,1,32,32
1683297255775,BICD 100R,A04,202021,Smith; Laurie,8,0,32,24
1683297255775,BICD 100R,A05,202022,Smith; Laurie,12,0,32,20
1683297256800,BICD 136,A01,193242,Gustafson-Brown; Cindy,0,2,32,32
1683297256800,BICD 136,A02,193244,Gustafson-Brown; Cindy,15,0,32,17
1683297257827,BIEB 102,A01,193249,Butler; Shannon Rhey,0,2,32,32
1683297257827,BIEB 102,A02,193251,Butler; Shannon Rhey,0,0,32,32
1683297257827,BIEB 102,A03,193253,Butler; Shannon Rhey,0,1,32,32
1683297257827,BIEB 102,A04,193255,Butler; Shannon Rhey,17,0,32,15
1683297257827,BIEB 102,A05,193265,Butler; Shannon Rhey,26,0,32,6
1683297257827,BIEB 102,A06,193269,Butler; Shannon Rhey,16,0,32,16
1683297259875,BIEB 150,A01,193274,Staff,0,0,32,32
1683297259875,BIEB 150,A02,193285,Staff,24,0,32,8
1683297260902,BIEB 194,A00,193286,Kurle; Carolyn M.,22,0,32,10
1683297261932,BILD 1,A01,192291,Staff,16,0,32,16
1683297261932,BILD 1,A02,192292,Staff,30,0,32,2
1683297261932,BILD 1,B01,192520,Reuther; Keefe,0,1,0,0
1683297261932,BILD 1,B02,192532,Reuther; Keefe,0,1,0,0
1683297262958,BILD 3,A01,192556,Butler; Shannon Rhey,0,0,32,32
1683297262958,BILD 3,A02,192581,Butler; Shannon Rhey,5,0,32,27
1683297262958,BILD 3,A03,192611,Butler; Shannon Rhey,23,0,32,9
1683297262958,BILD 3,A04,192612,Butler; Shannon Rhey,25,0,32,7
1683297262958,BILD 3,A05,192613,Butler; Shannon Rhey,27,0,32,5
1683297262958,BILD 3,A06,192679,Butler; Shannon Rhey,27,0,32,5
1683297262958,BILD 3,A07,192682,Butler; Shannon Rhey,22,0,32,10
1683297263988,BILD 4,A01,192836,Reuther; Keefe,1,0,24,23
1683297263988,BILD 4,A02,193044,Reuther; Keefe,4,0,24,20
1683297265013,BILD 10,A01,193142,Gustafson-Brown; Cindy,31,0,32,1
1683297265013,BILD 10,A02,193149,Gustafson-Brown; Cindy,31,0,32,1
1683297266040,BIMM 100,A01,193301,Staff,0,6,32,32
1683297266040,BIMM 100,A02,193312,Staff,0,5,32,32
1683297266040,BIMM 100,A03,193323,Staff,0,8,32,32
1683297267065,BIMM 101,A01,193329,McDonnell; Lisa Marie,0,3,24,24
1683297267065,BIMM 101,A02,193339,McDonnell; Lisa Marie,0,2,24,24
1683297267065,BIMM 101,B01,193354,McDonnell; Lisa Marie,0,3,24,24
1683297267065,BIMM 101,B02,193357,McDonnell; Lisa Marie,0,3,24,24
1683297268091,BIMM 110,A01,193377,Tat; John,0,11,32,32
1683297268091,BIMM 110,A02,193378,Tat; John,1,9,32,31
1683297269118,BIMM 120,A01,206116,Staff,0,0,32,32
1683297269118,BIMM 120,A02,206117,Staff,8,0,32,24
1683297269118,BIMM 120,A03,206121,Staff,21,0,32,11
1683297270144,BIPN 100,A01,193393,Park; Ji Young,0,14,32,32
1683297270144,BIPN 100,A02,193402,Park; Ji Young,0,12,32,32
1683297270144,BIPN 100,A03,193413,Park; Ji Young,0,14,32,32
1683297270144,BIPN 100,A04,193414,Park; Ji Young,0,13,32,32
1683297271168,BIPN 102,A01,193429,Staff,0,0,32,32
1683297271168,BIPN 102,A02,193438,Staff,23,0,32,9
1683297272195,BIPN 106,A01,193450,Reyes Gonzalez; Catalina,0,2,40,40
1683297273224,BIPN 134,A01,193465,Cooke; James Edward,0,0,32,32
1683297273224,BIPN 134,A02,193474,Cooke; James Edward,27,0,32,5
1683297273224,BIPN 134,A03,193485,Cooke; James Edward,29,0,32,3
1683297273224,BIPN 134,A04,193486,Cooke; James Edward,21,0,32,11
1683297273224,BIPN 134,A05,193491,Cooke; James Edward,31,0,32,1
1683297273224,BIPN 134,A06,193501,Cooke; James Edward,30,0,32,2
1683297273224,BIPN 134,A07,193510,Cooke; James Edward,29,0,32,3
1683297275274,BISP 194,A00,222522,Staff,16,0,32,16
1683297276299,CAT 124,A01,202407,Staff,20,0,25,5
1683297277324,CAT 125,A00,202408,Marchisotto; Jennifer Anne,4,0,20,16
1683297278409,CAT 125R,A00,202409,Smith; Lauryn Alissa,0,11,20,20
1683297278409,CAT 125R,B00,202410,Morales; Celeste Georgianna,0,11,20,20
1683297278409,CAT 125R,C00,202411,Irwin; Matthew Joseph,0,10,20,20
1683297279435,CENG 15,A01,204712,Yang; Kesong,0,1,0,0
1683297280460,CENG 114,A00,202070,Jahed Motlagh; Zeinab,5,0,20,15
1683297281484,CGS 105,A00,185477,Wesling; Megan E.,24,0,40,16
1683297282509,CGS 106,A00,185494,Staff,13,0,22,9
1683297283536,CGS 108,A00,185495,Staff,14,0,20,6
1683297284560,CGS 114,A00,185496,Staff,13,0,18,5
1683297285585,CGS 119,A00,185501,Staff,15,0,20,5
1683297286613,CGS 120,A00,185511,Staff,13,0,20,7
1683297287642,CHEM 4,A01,184675,Bussey; Thomas J,96,0,100,4
1683297288667,CHEM 6A,A01,184677,Staff,35,0,60,25
1683297289693,CHEM 6B,A01,184679,Staff,65,0,100,35
1683297290719,CHEM 6C,A01,184681,Bussey; Thomas J,1,0,50,49
1683297290719,CHEM 6C,A02,184682,Bussey; Thomas J,34,0,50,16
1683297291742,CHEM 40A,A01,184684,Albizati; Kim F.,37,0,100,63
1683297292768,CHEM 40B,A01,184686,Albizati; Kim F.,0,20,100,100
1683297293797,CHEM 41B,A01,184690,Staff,52,0,100,48
1683297294824,COGS 3,A01,184715,Boyle; Mary E. T.,0,25,40,40
1683297295852,COGS 14B,A01,185172,Staff,0,15,38,38
1683297296877,COGS 18,A01,184736,Staff,20,0,80,60
1683297297904,COGS 100,A01,184932,Staff,0,5,73,73
1683297298927,COGS 101A,A01,184935,Staff,0,38,30,30
1683297299952,COGS 101B,A01,184944,Staff,0,2,30,30
1683297300979,COGS 101C,A01,184946,Staff,0,12,30,30
1683297302011,COGS 102A,A01,184951,Johnson; Christine M.,2,0,40,38
1683297303038,COGS 107B,A01,184953,Mooshagian; Eric Frederick,0,50,40,40
1683297304066,COGS 118B,A01,184959,Gupta; Anjum,0,48,40,40
1683297305090,COGS 153,A00,184961,Staff,0,15,30,30
1683297306115,COGS 177,A00,184962,Staff,0,21,30,30
1683297307143,COGS 187A,A01,184969,Boyle; Mary E. T.,0,17,40,40
1683297308166,COMM 10,A01,185174,Staff,0,5,25,25
1683297308166,COMM 10,A02,185189,Staff,0,5,25,25
1683297308166,COMM 10,A03,269821,Staff,0,0,0,0
1683297309193,COMM 100B,A01,185475,Staff,0,0,0,2
1683297309193,COMM 100B,A02,185476,Staff,14,0,25,11
1683297310216,COMM 100C,A01,185314,Staff,1,0,25,24
1683297310216,COMM 100C,A02,185327,Staff,19,0,25,6
1683297311243,COMM 110M,A00,185349,Staff,2,0,40,38
1683297312266,COMM 113T,A00,185352,Staff,25,0,40,15
1683297313289,COMM 114I,A00,185353,Staff,33,0,40,7
1683297314314,COMM 131,A00,185354,Staff,19,0,30,11
1683297315338,CSE 8A,A50,185358,Cao; Yingjun,0,46,10,10
1683297316366,CSE 8B,A01,185362,Staff,1,47,50,49
1683297317391,CSE 11,A01,185416,Cao; Yingjun,0,93,10,10
1683297318419,CSE 20,A01,185445,Briones; Jor-el Thomas Caparas,5,0,25,20
1683297319444,CSE 21,A01,185447,Staff,10,0,50,40
1683297320472,CSE 101,A01,185451,Staff,0,12,50,50
1683297320472,CSE 101,B01,185453,Jones; Miles E,0,11,50,50
1683297322526,CSE 141,A01,185458,Eldon; John,20,0,100,80
1683297323550,CSE 141L,A01,185461,Eldon; John,12,0,100,88
1683297324576,CSE 142,A01,185463,Staff,35,0,60,25
1683297324576,CSE 142,B01,201355,Staff,0,6,60,60
1683297325603,CSE 142L,A01,185470,Staff,35,0,60,25
1683297325603,CSE 142L,B01,201417,Staff,0,5,60,60
1683297326633,CSE 190,A00,201433,Staff,32,0,49,17
1683297327659,DOC 1,A01,259136,Strom; Megan C.,8,0,15,7
1683297327659,DOC 1,A02,259137,Strom; Megan C.,14,0,15,1
1683297327659,DOC 1,A03,259138,Strom; Megan C.,14,0,15,1
1683297327659,DOC 1,A04,259139,Strom; Megan C.,14,0,15,1
1683297328685,DOC 100D,A00,259140,Pass; Natalye Joann,17,0,25,8
1683297329712,DSGN 1,A01,184749,Rill; Bryan,0,24,30,30
1683297330735,DSGN 100,A01,185168,Staff,0,2,25,25
1683297331763,ECE 5,A01,185626,Morris; Karcher William,0,10,0,0
1683297332786,ECE 101,A01,185628,Staff,17,0,70,53
1683297333811,ECE 107,A01,185635,Baghdadchi; Saharnaz,0,0,20,20
1683297333811,ECE 107,A02,185638,Baghdadchi; Saharnaz,4,0,20,16
1683297334838,ECE 148,A01,185647,Silberman; Jack,1,0,16,15
1683297335863,ECON 1,A01,185537,Crane; Meredith Helen,54,0,70,16
1683297336888,ECON 3,A01,185549,Crane; Meredith Helen,33,0,70,37
1683297337911,ECON 4,A01,203354,Anderson; John Charles,0,4,10,10
1683297338936,ECON 100A,A01,185574,Staff,0,4,40,40
1683297339963,ECON 100B,A01,185576,Staff,0,22,40,40
1683297340990,ECON 100C,A01,185589,Newhouse; Herbert S,30,0,70,40
1683297342016,ECON 105,A00,185608,Vespa; Emanuel Ignacio,19,0,35,16
1683297343045,ECON 109,A01,185610,Shishkin; Denis,10,0,35,25
1683297344069,ECON 110A,A01,185612,Staff,11,0,40,29
1683297345092,ECON 120A,A01,185615,Staff,20,0,40,20
1683297346117,ECON 120C,A01,185617,Sun; Yixiao,0,20,70,70
1683297347146,ECON 144,A00,203346,Squires; Dale E,3,0,35,32
1683297348171,ECON 171,A01,203349,Newhouse; Herbert S,0,1,35,35
1683297349199,ECON 173A,A01,185621,Toda; Alexis Akira,21,0,35,14
1683297350225,EDS 25,A01,202413,Staff,0,1,0,0
1683297350225,EDS 25,A02,202414,Staff,0,1,0,0
1683297350225,EDS 25,A03,202415,Staff,0,0,0,0
1683297350225,EDS 25,A04,202416,Staff,0,1,0,0
1683297350225,EDS 25,A05,202439,Staff,0,0,0,0
1683297350225,EDS 25,A06,202440,Staff,0,0,0,0
1683297350225,EDS 25,B01,202631,Staff,0,0,0,0
1683297350225,EDS 25,B02,202632,Staff,0,0,0,0
1683297350225,EDS 25,B03,202639,Staff,0,0,0,0
1683297350225,EDS 25,B04,202640,Staff,0,0,0,0
1683297350225,EDS 25,B05,202643,Staff,0,0,0,0
1683297350225,EDS 25,B06,202644,Staff,0,0,0,0
1683297351248,EDS 38,A01,202659,Black; Alison Michelle,24,0,25,1
1683297352274,EDS 115,A00,202652,Staff,17,0,30,13
1683297353302,EDS 125,A00,202649,Staff,14,0,30,16
1683297354328,EDS 126,A01,203332,Staff,30,0,30,0
1683297355354,EDS 139,A00,202838,Staff,17,0,25,8
1683297356379,EDS 146,A01,202655,Staff,15,0,25,10
1683297357403,ENG 15,A00,185667,Staff,0,1,0,0
1683297357403,ENG 15,B00,185672,Staff,0,0,0,0
1683297357403,ENG 15,C00,185675,Staff,0,0,0,0
1683297357403,ENG 15,D00,185682,Staff,0,0,0,0
1683297357403,ENG 15,E00,185684,Staff,0,0,0,0
1683297358426,ETHN 103,A00,185710,Staff,0,3,35,35
1683297359454,ETHN 103A,A00,199228,Man; Simeon S,3,0,9,6
1683297360480,ETHN 109,A00,185711,Staff,18,0,35,17
1683297361506,ETHN 142,A00,185726,Staff,0,4,30,30
1683297362533,ETHN 163J,A00,199229,Man; Simeon S,6,0,8,2
1683297363558,ETHN 168,A00,185727,Staff,8,0,10,2
1683297364583,ETHN 182,A00,185728,Staff,1,0,35,34
1683297365606,ETHN 183,A00,185737,Staff,8,0,18,10
1683297366633,GLBH 111,A01,209361,Burgos; Jose L.,0,0,0,0
1683297368686,HIEU 104,A00,185792,Staff,16,0,20,4
1683297369712,HIEU 115,A00,185800,Staff,1,0,20,19
1683297370737,HIEU 128,A00,185801,Staff,0,7,20,20
1683297371761,HIEU 147,A00,185802,Staff,16,0,20,4
1683297372785,HIEU 154,A00,185823,Staff,12,0,20,8
1683297373814,HILA 102,A00,185826,Staff,13,0,20,7
1683297374839,HILD 2C,A01,185778,Staff,0,12,20,20
1683297375865,HILD 7B,A01,185780,Kwak; Nancy,0,15,32,32
1683297375865,HILD 7B,A02,185781,Kwak; Nancy,0,18,32,32
1683297376892,HILD 30,A01,185791,Staff,14,0,20,6
1683297377918,HISC 119,A00,185830,Golan; Tal,0,9,20,20
1683297378941,HITO 156GS,A00,185831,Patterson; Patrick H.,0,0,0,23
1683297379963,HIUS 103,A00,185832,Man; Simeon S,0,7,20,20
1683297380987,HIUS 117,A00,185836,Kwak; Nancy,2,0,20,18
1683297382066,HIUS 125,A00,185840,Man; Simeon S,0,0,23,23
1683297383094,HIUS 149,A00,185845,Staff,0,0,20,20
1683297384120,HUM 3,A01,185882,Zavodny; Tatiana Sophia,0,6,50,50
1683297384120,HUM 3,B01,185899,Caldwell; Michael Alan,0,19,50,50
1683297385149,HUM 3GS,A00,185900,Patterson; Patrick H.,0,0,0,23
1683297386176,HUM 4,A01,185938,Zroka; Amy Liane,31,0,50,19
1683297386176,HUM 4,B01,185956,Watkins; Eric,0,2,50,50
1683297386176,HUM 4,B02,202209,Watkins; Eric,0,1,50,50
1683297386176,HUM 4,B03,202210,Watkins; Eric,0,0,50,50
1683297387201,HUM 5,A01,185958,West; Geoffrey Scott,5,0,50,45
1683297387201,HUM 5,A02,202215,West; Geoffrey Scott,0,0,50,50
1683297388226,INTL 190,A00,185959,Gagnon; Jeffrey C,0,0,0,9
1683297388226,INTL 190,B00,185960,Lettieri; Michael Joseph,0,0,0,1
1683297389252,JAPN 180,A00,254509,Staff,0,1,25,25
1683297390280,LATI 10,A01,202853,Kennemore; Amy Michelle,5,0,35,30
1683297390280,LATI 10,A02,202854,Kennemore; Amy Michelle,1,0,35,34
1683297390280,LATI 10,A03,270054,Kennemore; Amy Michelle,30,0,30,0
1683297391303,LATI 180,A00,202855,Kennemore; Amy Michelle,11,0,20,9
1683297392327,LAWS 101,A00,201767,Golan; Tal,0,7,40,40
1683297393356,LIFR 1C,A00,185961,Staff,6,0,20,14
1683297394380,LIFR 1CX,A00,185962,Staff,7,0,20,13
1683297395404,LIFR 1D,A00,185963,Staff,9,0,20,11
1683297396427,LIFR 1DX,A00,185964,Staff,9,0,20,11
1683297397454,LIGN 101,A01,186039,Staff,43,0,50,7
1683297398480,LIGN 165,A00,186040,Staff,18,0,50,32
1683297399505,LTCS 108,A00,186041,Staff,6,0,10,4
1683297400529,LTCS 119,A00,186042,Staff,16,0,20,4
1683297401557,LTCS 130,A00,186043,Wesling; Megan E.,15,0,25,10
1683297403604,LTEA 138,A00,186119,Staff,14,0,40,26
1683297404633,LTEN 124,A00,186148,Staff,6,0,25,19
1683297405657,LTEN 178,A00,186149,Staff,7,0,15,8
1683297406682,LTEN 181,A00,186150,Blanco; John D,33,0,40,7
1683297407707,LTWL 120,A00,186160,Staff,20,0,25,5
1683297408735,LTWL 165,A00,186161,Staff,22,0,25,3
1683297409762,LTWR 100,A00,186162,Staff,0,4,15,15
1683297410786,LTWR 102,A00,186163,Doller; Ben,5,0,15,10
1683297411811,MAE 8,A01,186412,Staff,0,0,0,0
1683297412835,MAE 30B,A00,186445,Bahadori; Mohammad Yousef,83,0,100,17
1683297413859,MAE 40,A00,186592,Bewley; Thomas R,9,0,50,41
1683297414887,MAE 101B,A00,186593,Bahadori; Mohammad Yousef,81,0,100,19
1683297415914,MAE 105,A00,186594,Bandaru; Prabhakar,12,0,50,38
1683297416938,MAE 107,A00,186599,Pham; Hieu Tan,0,6,120,120
1683297417963,MAE 148,A01,186660,Silberman; Jack,3,0,16,13
1683297418988,MATH 10A,A01,188095,Staff,0,7,35,35
1683297420018,MATH 10B,A01,188097,Bowers; Adam R.,0,11,30,30
1683297420018,MATH 10B,A02,188099,Bowers; Adam R.,0,9,30,30
1683297420018,MATH 10B,B01,188104,Bowers; Adam R.,0,11,30,30
1683297420018,MATH 10B,B02,188106,Bowers; Adam R.,0,11,30,30
1683297421047,MATH 10C,A01,188111,Staff,0,18,30,30
1683297421047,MATH 10C,A02,188127,Staff,0,17,30,30
1683297421047,MATH 10C,A03,188131,Staff,0,17,30,30
1683297421047,MATH 10C,B01,188218,Staff,21,0,30,9
1683297421047,MATH 10C,B02,188244,Staff,13,0,30,17
1683297421047,MATH 10C,B03,188277,Staff,16,0,30,14
1683297422076,MATH 18,A01,188344,Bach; Quang Tran,18,0,30,12
1683297422076,MATH 18,A02,188345,Bach; Quang Tran,11,0,30,19
1683297422076,MATH 18,B01,188353,Bach; Quang Tran,10,0,30,20
1683297422076,MATH 18,B02,188354,Bach; Quang Tran,20,0,30,10
1683297423101,MATH 20A,A01,188374,Staff,13,0,35,22
1683297424127,MATH 20B,A01,188382,Ohm; Ko Woon,6,0,30,24
1683297424127,MATH 20B,A02,188383,Ohm; Ko Woon,24,0,30,6
1683297424127,MATH 20B,B01,188385,Ohm; Ko Woon,7,0,30,23
1683297424127,MATH 20B,B02,188392,Ohm; Ko Woon,22,0,30,8
1683297425156,MATH 20C,A01,188394,Harel; Guershon,10,0,30,20
1683297425156,MATH 20C,A02,188395,Harel; Guershon,13,0,30,17
1683297425156,MATH 20C,B01,188404,Harel; Guershon,3,0,30,27
1683297425156,MATH 20C,B02,188405,Harel; Guershon,19,0,30,11
1683297426185,MATH 20D,A01,188414,Hammock; Frances H,0,1,30,30
1683297426185,MATH 20D,A02,188415,Hammock; Frances H,4,0,30,26
1683297426185,MATH 20D,B01,188447,Hammock; Frances H,2,0,30,28
1683297426185,MATH 20D,B02,188486,Hammock; Frances H,8,0,30,22
1683297427209,MATH 20E,A01,188649,Staff,22,0,30,8
1683297427209,MATH 20E,A02,188650,Staff,23,0,30,7
1683297427209,MATH 20E,A03,188673,Staff,0,0,30,30
1683297428236,MATH 102,A01,188675,Staff,0,35,35,35
1683297429262,MATH 103B,A01,188681,Staff,4,0,35,31
1683297429262,MATH 103B,B01,188692,Staff,7,0,35,28
1683297430287,MATH 109,A01,188695,Salehi Golsefidy; Alireza,25,0,35,10
1683297430287,MATH 109,A02,188696,Salehi Golsefidy; Alireza,27,0,35,8
1683297431316,MATH 120A,A01,188698,Eggers; John Dietrich,5,0,35,30
1683297432344,MATH 142B,A01,188736,Ioana; Adrian,0,2,30,30
1683297432344,MATH 142B,A02,188741,Ioana; Adrian,0,1,30,30
1683297432344,MATH 142B,A03,188743,Ioana; Adrian,0,3,30,30
1683297433369,MATH 168A,A01,188790,Staff,0,8,35,35
1683297434394,MATH 170A,A01,188803,Nie; Jiawang,0,2,35,35
1683297434394,MATH 170A,A02,188811,Nie; Jiawang,0,0,35,35
1683297434394,MATH 170A,A03,188814,Nie; Jiawang,1,0,35,34
1683297434394,MATH 170A,A04,188815,Nie; Jiawang,14,0,35,21
1683297435421,MATH 193B,A01,188817,Staff,0,0,35,35
1683297435421,MATH 193B,A02,188818,Staff,5,0,35,30
1683297436447,MGT 4,A01,202857,Anderson; John Charles,62,0,80,18
1683297437472,MGT 12,A00,202858,Lindenberger; Wade Douglas,43,0,90,47
1683297438495,MGT 18,A00,202859,Staff,74,0,90,16
1683297439521,MGT 18GS,A00,202860,McKay; Michael J,13,0,28,15
1683297440547,MGT 45,A00,202861,Pecore; Joseph P.,14,0,90,76
1683297441573,MGT 100,A00,202863,Yavorsky; Daniel Ryan,28,0,90,62
1683297442598,MGT 103,A00,202864,Ehrich; Kristine R,0,16,90,90
1683297443622,MGT 112,A00,202865,Ehrich; Kristine R,15,0,90,75
1683297444647,MGT 121A,A00,202868,Staff,0,19,0,0
1683297445672,MGT 131B,A00,202869,Anderson; John Charles,59,0,90,31
1683297446697,MGT 136,A00,202871,Lindenberger; Wade Douglas,84,0,90,6
1683297447725,MGT 164,A00,202873,Staff,0,69,90,90
1683297448752,MGT 164GS,A00,202874,McKay; Mary A,13,0,28,15
1683297449782,MGT 180,A00,202875,Staff,0,51,90,90
1683297450811,MMW 11R,A01,205019,Herbst; Matthew,3,0,30,27
1683297450811,MMW 11R,A02,205026,Herbst; Matthew,29,0,30,1
1683297451836,MMW 15,A01,193512,Chang; Edmond Yi-Teh,0,9,28,28
1683297451836,MMW 15,A02,193513,Chang; Edmond Yi-Teh,0,5,28,28
1683297451836,MMW 15,A03,193514,Chang; Edmond Yi-Teh,0,5,28,28
1683297451836,MMW 15,A04,193515,Chang; Edmond Yi-Teh,0,4,28,28
1683297451836,MMW 15,A05,193516,Chang; Edmond Yi-Teh,0,4,28,28
1683297451836,MMW 15,A06,193517,Chang; Edmond Yi-Teh,0,5,28,28
1683297451836,MMW 15,B01,193519,Chang; Edmond Yi-Teh,0,4,28,28
1683297451836,MMW 15,B02,193520,Chang; Edmond Yi-Teh,0,5,28,28
1683297451836,MMW 15,B03,193521,Chang; Edmond Yi-Teh,0,4,28,28
1683297451836,MMW 15,B04,193522,Chang; Edmond Yi-Teh,0,4,28,28
1683297451836,MMW 15,B05,193523,Chang; Edmond Yi-Teh,0,5,28,28
1683297451836,MMW 15,B06,193524,Chang; Edmond Yi-Teh,0,4,28,28
1683297452861,MMW 122,A01,193526,Rahimi; Babak,0,14,28,28
1683297452861,MMW 122,A02,193527,Rahimi; Babak,0,14,28,28
1683297452861,MMW 122,A03,193528,Rahimi; Babak,0,0,0,0
1683297452861,MMW 122,A04,193529,Rahimi; Babak,0,0,0,0
1683297453885,MUS 1A,A01,186663,Staff,0,20,35,35
1683297454909,MUS 4,A01,186715,Staff,0,12,35,35
1683297455936,MUS 5R,A01,186796,Dubnov; Shlomo,0,16,35,35
1683297456963,MUS 6,A01,186798,Staff,0,3,25,25
1683297457990,MUS 7,A01,186830,Staff,12,0,35,23
1683297459014,MUS 8,A01,186930,Staff,0,25,35,35
1683297460039,MUS 15,A01,186932,Staff,0,15,35,35
1683297460039,MUS 15,B01,186934,Staff,0,14,35,35
1683297461063,MUS 80,A00,186935,Staff,2,0,20,18
1683297461063,MUS 80,B00,186936,Staff,25,0,25,0
1683297462090,NANO 11,A00,204702,Lipomi; Darren John,0,0,0,0
1683297463114,NANO 15,A01,204709,Yang; Kesong,0,1,0,0
1683297464137,NANO 114,A00,202069,Jahed Motlagh; Zeinab,3,0,10,7
1683297465163,PHIL 1,A00,186955,Grush; Rick Scott,32,0,40,8
1683297466191,PHIL 10,A01,186973,Grush; Rick Scott,29,0,35,6
1683297466191,PHIL 10,A02,186974,Grush; Rick Scott,33,0,35,2
1683297467216,PHIL 13,A01,186976,Staff,7,0,35,28
1683297467216,PHIL 13,A02,186977,Staff,16,0,35,19
1683297468240,PHIL 14,A01,186979,Staff,31,0,35,4
1683297468240,PHIL 14,A02,186986,Staff,32,0,35,3
1683297469269,PHIL 28,A01,186988,Staff,16,0,30,14
1683297469269,PHIL 28,A02,186989,Staff,1,0,30,29
1683297469269,PHIL 28,A03,186990,Staff,9,0,30,21
1683297469269,PHIL 28,A04,186991,Staff,26,0,30,4
1683297470297,PHIL 120,A00,186997,Staff,23,0,40,17
1683297471323,PHIL 137,A00,187003,Staff,9,0,40,31
1683297472350,PHIL 150,A00,187015,Staff,47,0,70,23
1683297473380,PHIL 167,A00,187021,Lamey; Andy M.,35,0,40,5
1683297474408,PHIL 174,A01,202226,Staff,17,0,20,3
1683297474408,PHIL 174,A02,202235,Staff,20,0,20,0
1683297475432,PHIL 191A,A00,258918,Staff,0,0,1,1
1683297476456,PHYS 1A,A00,187028,Staff,26,0,60,34
1683297477481,PHYS 1AL,001,187036,Staff,2,0,30,28
1683297477481,PHYS 1AL,002,187049,Staff,18,0,30,12
1683297478509,PHYS 1B,A00,187058,Staff,23,0,60,37
1683297479538,PHYS 1BL,001,187064,Staff,0,0,30,30
1683297479538,PHYS 1BL,002,187070,Staff,6,0,30,24
1683297480560,PHYS 1C,A00,187082,Staff,32,0,120,88
1683297481598,PHYS 1CL,001,187088,Staff,0,9,30,30
1683297481598,PHYS 1CL,002,187089,Staff,0,2,30,30
1683297481598,PHYS 1CL,009,262693,Staff,12,0,30,18
1683297482624,PHYS 2B,A01,187097,Staff,54,0,115,61
1683297483648,PHYS 2C,A01,187099,Staff,67,0,115,48
1683297484678,PHYS 2CL,A01,187101,Staff,5,0,28,23
1683297484678,PHYS 2CL,A02,187102,Staff,15,0,28,13
1683297485760,PHYS 2D,A01,187123,Shotwell; Brian,95,0,115,20
1683297486785,PHYS 4B,A01,187133,Grinstein; Benjamin,35,0,50,15
1683297487811,POLI 10,A00,188819,Staff,0,3,50,50
1683297488840,POLI 11,A00,188827,Staff,43,0,50,7
1683297489865,POLI 13R,A00,188828,Staff,0,1,20,20
1683297490889,POLI 27,A01,188830,Elgin; Samuel Zincke,0,1,70,70
1683297491917,POLI 30,A00,188832,Desposato; Scott,33,0,50,17
1683297492945,POLI 102F,A00,188834,Staff,3,0,40,37
1683297493970,POLI 104A,A00,188852,Staff,14,0,30,16
1683297494997,POLI 104I,A00,188853,Staff,0,6,20,20
1683297496023,POLI 110B,A00,188854,Wiens; David,7,0,20,13
1683297497052,POLI 112A,A00,188855,Wiens; David,5,0,30,25
1683297498081,POLI 117R,A00,188856,Forman; Fonna,0,11,20,20
1683297499105,POLI 118,A00,188857,Ingham; Sean,8,0,20,12
1683297500130,POLI 120G,A00,188858,Staff,9,0,30,21
1683297501154,POLI 131CR,A00,188863,Hoston; Germaine,24,0,50,26
1683297502182,POLI 133,A00,188864,Nellis; Gareth Hb,44,0,50,6
1683297503207,POLI 134D,A00,188865,Desposato; Scott,27,0,30,3
1683297504233,POLI 142A,A00,188871,Gartzke; Erik,22,0,50,28
1683297505259,POLI 142K,A00,188874,Staff,38,0,50,12
1683297506282,POLI 143,A00,188940,Gartzke; Erik,16,0,30,14
1683297507307,POLI 153,A00,188943,Staff,3,0,20,17
1683297508333,POLI 160AA,A00,188944,Staff,13,0,40,27
1683297509360,POLI 170A,A00,188945,Staff,11,0,30,19
1683297511413,PSYC 1,A00,188952,Staff,38,0,90,52
1683297512438,PSYC 2,B00,188953,Staff,20,0,35,15
1683297513461,PSYC 6,A00,188970,Staff,47,0,60,13
1683297514484,PSYC 7,A00,188973,Staff,37,0,45,8
1683297515509,PSYC 60,A01,188980,Rickard; Timothy C.,43,0,60,17
1683297516538,PSYC 70,A01,189001,Steiner; Eric Tomas,24,0,45,21
1683297517566,PSYC 100,A00,189005,Lacefield; Katharine I,0,99,120,120
1683297518591,PSYC 102,A00,189008,Staff,10,0,30,20
1683297519617,PSYC 106,B00,189026,Gorman; Michael R.,37,0,60,23
1683297520644,PSYC 114,B01,189033,Winkielman; Piotr,0,32,30,30
1683297521671,PSYC 131,A00,189036,Anagnostaras; Stephan,0,43,60,60
1683297522700,PSYC 136,A00,189041,Lowe; Angela Beth,0,7,25,25
1683297523725,PSYC 137,A00,189057,Winkielman; Piotr,0,34,25,25
1683297524754,PSYC 144,A00,189107,Wixted; John T,0,7,50,50
1683297526806,PSYC 162,A00,189142,Staff,0,8,85,85
1683297527833,PSYC 172,A00,189144,Gorman; Michael R.,0,7,30,30
1683297529884,PSYC 179,A00,189146,Lacefield; Katharine I,0,84,120,120
1683297530908,PSYC 181,A00,189147,Anagnostaras; Stephan,0,44,90,90
1683297531936,PSYC 190R,A00,189148,Barner; David A.,0,22,80,80
1683297532961,PSYC 191,A00,189275,Rickard; Timothy C.,0,7,25,25
1683297533987,PSYC 193,A00,189276,Chapman; Eddie Nathaniel,0,1,0,4
1683297535013,PSYC 193L,A01,189281,Lowe; Angela Beth,12,0,20,8
1683297535013,PSYC 193L,B01,189285,Staff,28,0,35,7
1683297536040,RELI 149,A00,187137,Rahimi; Babak,7,0,40,33
1683297537065,SE 9,A01,187315,Staff,0,2,18,18
1683297538093,SE 101B,A00,187409,Staff,24,0,30,6
1683297539120,SE 110B,A00,187444,Staff,10,0,40,30
1683297540147,SE 130B,A00,187449,Staff,31,0,40,9
1683297541175,SE 150A,A00,187516,Staff,9,0,20,11
1683297542204,SE 154,A00,187528,Staff,30,0,50,20
1683297543228,SIO 3,A01,258171,Staff,35,0,40,5
1683297544257,SIO 10,A00,187144,Cook; Geoffrey W,0,3,75,75
1683297545284,SIO 45,A00,187152,Cook; Geoffrey W,1,0,100,99
1683297546309,SIO 109R,A00,194486,Staff,0,3,20,20
1683297548364,SIO 187,A01,187233,Kacev; David,12,0,40,28
1683297549394,SOCI 1,A01,258656,Thorpe; Charles Robert,28,0,30,2
1683297549394,SOCI 1,A02,258658,Thorpe; Charles Robert,30,0,30,0
1683297549394,SOCI 1,A03,258661,Thorpe; Charles Robert,25,0,25,0
1683297549394,SOCI 1,A04,258666,Thorpe; Charles Robert,22,0,25,3
1683297549394,SOCI 1,A05,258897,Thorpe; Charles Robert,23,0,25,2
1683297549394,SOCI 1,A06,258898,Thorpe; Charles Robert,25,0,25,0
1683297550421,SOCI 30,A01,258903,Pardo Guerra; Juan Pablo,16,0,30,14
1683297551443,SOCI 102,A00,258904,Staff,9,0,25,16
1683297552470,SOCI 106,A00,258905,Staff,19,0,25,6
1683297553495,SOCI 111,A00,258907,Ribas Norris; Janet Vanesa,26,0,30,4
1683297554518,SOCI 121R,A00,258908,Pardo Guerra; Juan Pablo,11,0,30,19
1683297555542,SOCI 126,A01,203330,Staff,14,0,20,6
1683297556571,SOCI 131,A00,258909,Thorpe; Charles Robert,31,0,60,29
1683297557598,SOCI 135,A00,258910,Payne; Christine Anna,0,9,30,30
1683297558626,SOCI 157,A00,258911,Staff,13,0,30,17
1683297559651,SOCI 184,A00,258912,Staff,26,0,30,4
1683297560675,SOCI 188D,A00,258913,Staff,21,0,30,9
1683297561706,SYN 2,001,187529,Staff,9,0,16,7
1683297561706,SYN 2,002,201452,Staff,0,18,16,16
1683297561706,SYN 2,003,201469,Staff,3,0,16,13
1683297562734,SYN 100,A01,187531,Staff,0,9,20,20
1683297562734,SYN 100,B01,201491,Staff,0,12,20,20
1683297563759,TDAC 1,A00,189286,Walsh; Kim C.,3,0,20,17
1683297563759,TDAC 1,B00,189287,Harting; Carla Kelso,11,0,20,9
1683297564785,TDAC 101,A00,189300,Walsh; Kim C.,16,0,20,4
1683297564785,TDAC 101,B00,189301,Harting; Carla Kelso,18,0,20,2
1683297565822,TDAC 102,A00,189304,Basso; Beatrice,14,0,20,6
1683297566847,TDAC 108,A00,189305,Staff,18,0,20,2
1683297567876,TDDE 131,A00,189310,Staff,19,0,20,1
1683297567876,TDDE 131,B00,189314,Staff,19,0,20,1
1683297567876,TDDE 131,C00,189315,Staff,48,0,50,2
1683297567876,TDDE 131,D00,189316,Staff,14,0,15,1
1683297567876,TDDE 131,E00,204841,Staff,20,0,20,0
1683297568903,TDGE 10,A00,189289,Staff,30,0,50,20
1683297568903,TDGE 10,B00,189290,Havis; Allan,2,0,50,48
1683297569933,TDGE 11,A00,189291,Fulton; Julia,0,3,50,50
1683297569933,TDGE 11,B00,189292,Staff,20,0,25,5
1683297569933,TDGE 11,C00,260270,Staff,0,0,0,0
1683297570958,TDGE 25,A00,189294,Staff,3,0,20,17
1683297571983,TDGE 124,A00,189318,Fulton; Julia,0,8,50,50
1683297573012,TDGE 125,A00,189319,Staff,13,0,25,12
1683297573012,TDGE 125,B00,189320,Staff,23,0,25,2
1683297574034,TDGE 127,A00,189322,Havis; Allan,0,0,50,50
1683297575061,TDHT 101,A00,189323,Staff,18,0,25,7
1683297575061,TDHT 101,B00,189324,Staff,25,0,25,0
1683297576089,TDHT 102,A00,189325,Staff,49,0,50,1
1683297577115,TDMV 1,A00,189295,Arcidiacono; Kristin,20,0,30,10
1683297577115,TDMV 1,B00,189296,Caligagan; Maria T.,24,0,30,6
1683297578144,TDMV 2,A00,189297,Sammartano; Tonnie,28,0,30,2
1683297578144,TDMV 2,B00,189299,Arcidiacono; Kristin,24,0,30,6
1683297579170,TDMV 3,A00,204998,Rincon; Alicia,22,0,30,8
1683297580199,TDMV 120,A00,189458,Sammartano; Tonnie,28,0,30,2
1683297581224,TDMV 138,A00,189541,Jun; Grace Shin Hae,22,0,40,18
1683297582249,TDMV 142,A00,189717,Caligagan; Tony,23,0,30,7
1683297582249,TDMV 142,B00,189718,Caligagan; Maria T.,25,0,30,5
1683297583273,TMC 2,A01,187533,Staff,25,0,25,0
1683297583273,TMC 2,A02,187534,Staff,25,0,25,0
1683297584298,USP 1,A01,187536,Kwak; Nancy,0,16,25,25
1683297585322,USP 5,A01,187538,Staff,9,0,25,16
1683297586350,USP 101,A00,199253,Staff,0,4,0,0
1683297587377,USP 124,A00,187562,Boomhower; Matthew Charles,1,0,30,29
1683297588402,USP 138,A00,187582,Staff,20,0,25,5
1683297589500,USP 152,A01,187597,Staff,4,0,25,21
1683297590528,USP 153,A00,187598,Staff,19,0,25,6
1683297591551,USP 168,A00,187607,Kwak; Nancy,2,0,5,3
1683297592579,USP 173,A00,187619,Staff,4,0,25,21
1683297593606,USP 181,A00,187638,Staff,0,0,25,25
1683297594633,VIS 103,A00,187650,Cruz; Edwin Teddy,23,0,75,52
1683297595661,VIS 110D,A00,187669,Staff,12,0,22,10
1683297596689,VIS 127C,A00,187720,Shen; Kuiyi,68,0,146,78
1683297597718,VIS 149,A00,187731,Yoldas; Pinar,0,14,22,22
1683297598745,VIS 151,A01,188091,Staff,22,0,34,12
1683297598745,VIS 151,A02,188092,Staff,11,0,34,23
1683297599771,VIS 160B,A00,188093,Stalbaum; Brett,0,0,10,10
1683297601825,WCWP 10B,A00,201720,Staff,10,0,15,5
1683297601825,WCWP 10B,B00,201722,Staff,8,0,15,7
1683297602850,WCWP 100,A00,201725,Gagnon; Jeffrey C,0,0,2,2
1683297602850,WCWP 100,B00,201727,Staff,0,4,15,15
1683297605941,ANBI 133,A00,258401,Wilder; Linnea Lorene,34,0,40,6
1683297606967,ANBI 140,A00,258395,Hrvoj Mihic; Branka,18,0,25,7
1683297607995,ANSC 120,A00,258402,Bialecki; Jon Anthony,27,0,40,13
1683297609022,ANSC 144,A00,258400,Staff,14,0,40,26
1683297611072,ANSC 166,A00,258396,Parish; Steven Martin,157,0,175,18
1683297612099,ANSC 180,A00,193533,Staff,9,0,20,11
1683297613124,ANSC 188,A00,258397,Jassal; Aftab,33,0,40,7
1683297614149,ANTH 3,A01,258316,Staff,23,0,30,7
1683297615179,ANTH 5,A00,258394,Semendeferi; Ekaterini,16,0,20,4
1683297616205,ANTH 21,A01,258331,Staff,9,0,40,31
1683297617230,ANTH 103,A00,258398,Varma; Saiba,15,0,25,10
1683297618256,AWP 10,001,202034,Staff,0,0,0,0
1683297618256,AWP 10,002,202035,Staff,0,0,0,0
1683297618256,AWP 10,003,202036,Staff,0,0,0,0
1683297618256,AWP 10,004,202037,Staff,0,0,0,0
1683297618256,AWP 10,005,202038,Staff,0,0,0,0
1683297618256,AWP 10,006,202039,Staff,0,0,0,0
1683297618256,AWP 10,007,202040,Staff,0,0,0,0
1683297618256,AWP 10,008,202041,Staff,0,0,0,0
1683297618256,AWP 10,009,202042,Staff,0,0,0,0
1683297618256,AWP 10,010,202043,Staff,0,0,0,0
1683297618256,AWP 10,011,202044,Staff,0,0,0,0
1683297618256,AWP 10,012,202045,Staff,0,0,0,0
1683297618256,AWP 10,013,202046,Staff,0,0,0,0
1683297618256,AWP 10,014,202047,Staff,0,0,0,0
1683297618256,AWP 10,015,202048,Staff,0,0,0,0
1683297618256,AWP 10,016,202049,Staff,0,0,0,0
1683297618256,AWP 10,017,202050,Staff,0,0,0,0
1683297618256,AWP 10,018,202051,Staff,0,0,0,0
1683297618256,AWP 10,019,202052,Staff,0,0,0,0
1683297618256,AWP 10,020,202053,Staff,0,0,0,0
1683297618256,AWP 10,021,202054,Staff,0,0,0,0
1683297618256,AWP 10,022,202055,Staff,0,0,0,0
1683297618256,AWP 10,023,202056,Staff,0,0,0,0
1683297618256,AWP 10,024,202057,Staff,0,0,0,0
1683297618256,AWP 10,025,202058,Staff,0,0,0,0
1683297618256,AWP 10,026,202059,Staff,0,0,0,0
1683297619281,AWP 102,001,202032,Staff,0,0,0,0
1683297619281,AWP 102,002,202033,Staff,0,0,0,0
1683297620306,BENG 100,A01,254234,Taylor Amos; Alyssa C,31,0,40,9
1683297621334,BENG 196,001,270013,Engler; Adam J.,9999,0,9999,0
1683297622358,BICD 100R,A01,202018,Smith; Laurie,0,7,32,32
1683297622358,BICD 100R,A02,202019,Smith; Laurie,0,2,32,32
1683297622358,BICD 100R,A03,202020,Smith; Laurie,0,1,32,32
1683297622358,BICD 100R,A04,202021,Smith; Laurie,8,0,32,24
1683297622358,BICD 100R,A05,202022,Smith; Laurie,12,0,32,20
1683297623382,BICD 136,A01,193242,Gustafson-Brown; Cindy,0,2,32,32
1683297623382,BICD 136,A02,193244,Gustafson-Brown; Cindy,15,0,32,17
1683297624407,BIEB 102,A01,193249,Butler; Shannon Rhey,0,2,32,32
1683297624407,BIEB 102,A02,193251,Butler; Shannon Rhey,0,0,32,32
1683297624407,BIEB 102,A03,193253,Butler; Shannon Rhey,0,1,32,32
1683297624407,BIEB 102,A04,193255,Butler; Shannon Rhey,17,0,32,15
1683297624407,BIEB 102,A05,193265,Butler; Shannon Rhey,26,0,32,6
1683297624407,BIEB 102,A06,193269,Butler; Shannon Rhey,16,0,32,16
1683297626465,BIEB 150,A01,193274,Staff,0,0,32,32
1683297626465,BIEB 150,A02,193285,Staff,24,0,32,8
1683297627491,BIEB 194,A00,193286,Kurle; Carolyn M.,22,0,32,10
1683297628517,BILD 1,A01,192291,Staff,16,0,32,16
1683297628517,BILD 1,A02,192292,Staff,30,0,32,2
1683297628517,BILD 1,B01,192520,Reuther; Keefe,0,1,0,0
1683297628517,BILD 1,B02,192532,Reuther; Keefe,0,1,0,0
1683297629541,BILD 3,A01,192556,Butler; Shannon Rhey,0,0,32,32
1683297629541,BILD 3,A02,192581,Butler; Shannon Rhey,5,0,32,27
1683297629541,BILD 3,A03,192611,Butler; Shannon Rhey,23,0,32,9
1683297629541,BILD 3,A04,192612,Butler; Shannon Rhey,25,0,32,7
1683297629541,BILD 3,A05,192613,Butler; Shannon Rhey,27,0,32,5
1683297629541,BILD 3,A06,192679,Butler; Shannon Rhey,27,0,32,5
1683297629541,BILD 3,A07,192682,Butler; Shannon Rhey,22,0,32,10
1683297630567,BILD 4,A01,192836,Reuther; Keefe,1,0,24,23
1683297630567,BILD 4,A02,193044,Reuther; Keefe,4,0,24,20
1683297631597,BILD 10,A01,193142,Gustafson-Brown; Cindy,31,0,32,1
1683297631597,BILD 10,A02,193149,Gustafson-Brown; Cindy,31,0,32,1
1683297632625,BIMM 100,A01,193301,Staff,0,6,32,32
1683297632625,BIMM 100,A02,193312,Staff,0,5,32,32
1683297632625,BIMM 100,A03,193323,Staff,0,8,32,32
1683297633650,BIMM 101,A01,193329,McDonnell; Lisa Marie,0,3,24,24
1683297633650,BIMM 101,A02,193339,McDonnell; Lisa Marie,0,2,24,24
1683297633650,BIMM 101,B01,193354,McDonnell; Lisa Marie,0,3,24,24
1683297633650,BIMM 101,B02,193357,McDonnell; Lisa Marie,0,3,24,24
1683297634674,BIMM 110,A01,193377,Tat; John,0,11,32,32
1683297634674,BIMM 110,A02,193378,Tat; John,1,9,32,31
1683297635698,BIMM 120,A01,206116,Staff,0,0,32,32
1683297635698,BIMM 120,A02,206117,Staff,8,0,32,24
1683297635698,BIMM 120,A03,206121,Staff,21,0,32,11
1683297636724,BIPN 100,A01,193393,Park; Ji Young,0,14,32,32
1683297636724,BIPN 100,A02,193402,Park; Ji Young,0,12,32,32
1683297636724,BIPN 100,A03,193413,Park; Ji Young,0,14,32,32
1683297636724,BIPN 100,A04,193414,Park; Ji Young,0,13,32,32
1683297637749,BIPN 102,A01,193429,Staff,0,0,32,32
1683297637749,BIPN 102,A02,193438,Staff,23,0,32,9
1683297638776,BIPN 106,A01,193450,Reyes Gonzalez; Catalina,0,2,40,40
1683297639801,BIPN 134,A01,193465,Cooke; James Edward,0,0,32,32
1683297639801,BIPN 134,A02,193474,Cooke; James Edward,27,0,32,5
1683297639801,BIPN 134,A03,193485,Cooke; James Edward,29,0,32,3
1683297639801,BIPN 134,A04,193486,Cooke; James Edward,21,0,32,11
1683297639801,BIPN 134,A05,193491,Cooke; James Edward,31,0,32,1
1683297639801,BIPN 134,A06,193501,Cooke; James Edward,30,0,32,2
1683297639801,BIPN 134,A07,193510,Cooke; James Edward,29,0,32,3
1683297641850,BISP 194,A00,222522,Staff,16,0,32,16
1683297642877,CAT 124,A01,202407,Staff,20,0,25,5
1683297643902,CAT 125,A00,202408,Marchisotto; Jennifer Anne,4,0,20,16
1683297644932,CAT 125R,A00,202409,Smith; Lauryn Alissa,0,11,20,20
1683297644932,CAT 125R,B00,202410,Morales; Celeste Georgianna,0,11,20,20
1683297644932,CAT 125R,C00,202411,Irwin; Matthew Joseph,0,10,20,20
1683297645956,CENG 15,A01,204712,Yang; Kesong,0,1,0,0
1683297646979,CENG 114,A00,202070,Jahed Motlagh; Zeinab,5,0,20,15
1683297648009,CGS 105,A00,185477,Wesling; Megan E.,24,0,40,16
1683297649036,CGS 106,A00,185494,Staff,13,0,22,9
1683297650060,CGS 108,A00,185495,Staff,14,0,20,6
1683297651087,CGS 114,A00,185496,Staff,13,0,18,5
1683297652110,CGS 119,A00,185501,Staff,15,0,20,5
1683297653135,CGS 120,A00,185511,Staff,13,0,20,7
1683297654160,CHEM 4,A01,184675,Bussey; Thomas J,96,0,100,4
1683297655187,CHEM 6A,A01,184677,Staff,35,0,60,25
1683297656210,CHEM 6B,A01,184679,Staff,65,0,100,35
1683297657234,CHEM 6C,A01,184681,Bussey; Thomas J,1,0,50,49
1683297657234,CHEM 6C,A02,184682,Bussey; Thomas J,34,0,50,16
1683297658257,CHEM 40A,A01,184684,Albizati; Kim F.,37,0,100,63
1683297659282,CHEM 40B,A01,184686,Albizati; Kim F.,0,20,100,100
1683297660306,CHEM 41B,A01,184690,Staff,52,0,100,48
1683297661330,COGS 3,A01,184715,Boyle; Mary E. T.,0,25,40,40
1683297662355,COGS 14B,A01,185172,Staff,0,15,38,38
1683297663380,COGS 18,A01,184736,Staff,20,0,80,60
1683297664408,COGS 100,A01,184932,Staff,0,5,73,73
1683297665431,COGS 101A,A01,184935,Staff,0,38,30,30
1683297666457,COGS 101B,A01,184944,Staff,0,2,30,30
1683297667482,COGS 101C,A01,184946,Staff,0,12,30,30
1683297668509,COGS 102A,A01,184951,Johnson; Christine M.,2,0,40,38
1683297669531,COGS 107B,A01,184953,Mooshagian; Eric Frederick,0,50,40,40
1683297670556,COGS 118B,A01,184959,Gupta; Anjum,0,48,40,40
1683297671583,COGS 153,A00,184961,Staff,0,15,30,30
1683297672610,COGS 177,A00,184962,Staff,0,21,30,30
1683297673634,COGS 187A,A01,184969,Boyle; Mary E. T.,0,17,40,40
1683297674662,COMM 10,A01,185174,Staff,0,5,25,25
1683297674662,COMM 10,A02,185189,Staff,0,5,25,25
1683297674662,COMM 10,A03,269821,Staff,0,0,0,0
1683297675690,COMM 100B,A01,185475,Staff,0,0,0,2
1683297675690,COMM 100B,A02,185476,Staff,14,0,25,11
1683297676717,COMM 100C,A01,185314,Staff,1,0,25,24
1683297676717,COMM 100C,A02,185327,Staff,19,0,25,6
1683297677745,COMM 110M,A00,185349,Staff,2,0,40,38
1683297678770,COMM 113T,A00,185352,Staff,25,0,40,15
1683297679795,COMM 114I,A00,185353,Staff,33,0,40,7
1683297680820,COMM 131,A00,185354,Staff,19,0,30,11
1683297681845,CSE 8A,A50,185358,Cao; Yingjun,0,46,10,10
1683297682870,CSE 8B,A01,185362,Staff,1,47,50,49
1683297683896,CSE 11,A01,185416,Cao; Yingjun,0,93,10,10
1683297684920,CSE 20,A01,185445,Briones; Jor-el Thomas Caparas,5,0,25,20
1683297685945,CSE 21,A01,185447,Staff,10,0,50,40
1683297686970,CSE 101,A01,185451,Staff,0,12,50,50
1683297686970,CSE 101,B01,185453,Jones; Miles E,0,11,50,50
1683297689026,CSE 141,A01,185458,Eldon; John,20,0,100,80
1683297690052,CSE 141L,A01,185461,Eldon; John,12,0,100,88
1683297691082,CSE 142,A01,185463,Staff,35,0,60,25
1683297691082,CSE 142,B01,201355,Staff,0,6,60,60
1683297692106,CSE 142L,A01,185470,Staff,35,0,60,25
1683297692106,CSE 142L,B01,201417,Staff,0,5,60,60
1683297693187,CSE 190,A00,201433,Staff,32,0,49,17
1683297694214,DOC 1,A01,259136,Strom; Megan C.,8,0,15,7
1683297694214,DOC 1,A02,259137,Strom; Megan C.,14,0,15,1
1683297694214,DOC 1,A03,259138,Strom; Megan C.,14,0,15,1
1683297694214,DOC 1,A04,259139,Strom; Megan C.,14,0,15,1
1683297695239,DOC 100D,A00,259140,Pass; Natalye Joann,17,0,25,8
1683297696268,DSGN 1,A01,184749,Rill; Bryan,0,24,30,30
1683297697292,DSGN 100,A01,185168,Staff,0,2,25,25
1683297698318,ECE 5,A01,185626,Morris; Karcher William,0,10,0,0
1683297699346,ECE 101,A01,185628,Staff,17,0,70,53
1683297700371,ECE 107,A01,185635,Baghdadchi; Saharnaz,0,0,20,20
1683297700371,ECE 107,A02,185638,Baghdadchi; Saharnaz,4,0,20,16
1683297701395,ECE 148,A01,185647,Silberman; Jack,1,0,16,15
1683297702419,ECON 1,A01,185537,Crane; Meredith Helen,54,0,70,16
1683297703445,ECON 3,A01,185549,Crane; Meredith Helen,33,0,70,37
1683297704469,ECON 4,A01,203354,Anderson; John Charles,0,4,10,10
1683297705498,ECON 100A,A01,185574,Staff,0,4,40,40
1683297706526,ECON 100B,A01,185576,Staff,0,22,40,40
1683297707550,ECON 100C,A01,185589,Newhouse; Herbert S,30,0,70,40
1683297708578,ECON 105,A00,185608,Vespa; Emanuel Ignacio,19,0,35,16
1683297709602,ECON 109,A01,185610,Shishkin; Denis,10,0,35,25
1683297710627,ECON 110A,A01,185612,Staff,11,0,40,29
1683297711651,ECON 120A,A01,185615,Staff,20,0,40,20
1683297712675,ECON 120C,A01,185617,Sun; Yixiao,0,20,70,70
1683297713704,ECON 144,A00,203346,Squires; Dale E,3,0,35,32
1683297714727,ECON 171,A01,203349,Newhouse; Herbert S,0,1,35,35
1683297715751,ECON 173A,A01,185621,Toda; Alexis Akira,21,0,35,14
1683297716778,EDS 25,A01,202413,Staff,0,1,0,0
1683297716778,EDS 25,A02,202414,Staff,0,1,0,0
1683297716778,EDS 25,A03,202415,Staff,0,0,0,0
1683297716778,EDS 25,A04,202416,Staff,0,1,0,0
1683297716778,EDS 25,A05,202439,Staff,0,0,0,0
1683297716778,EDS 25,A06,202440,Staff,0,0,0,0
1683297716778,EDS 25,B01,202631,Staff,0,0,0,0
1683297716778,EDS 25,B02,202632,Staff,0,0,0,0
1683297716778,EDS 25,B03,202639,Staff,0,0,0,0
1683297716778,EDS 25,B04,202640,Staff,0,0,0,0
1683297716778,EDS 25,B05,202643,Staff,0,0,0,0
1683297716778,EDS 25,B06,202644,Staff,0,0,0,0
1683297717802,EDS 38,A01,202659,Black; Alison Michelle,24,0,25,1
1683297718827,EDS 115,A00,202652,Staff,17,0,30,13
1683297719852,EDS 125,A00,202649,Staff,14,0,30,16
1683297720876,EDS 126,A01,203332,Staff,30,0,30,0
1683297721903,EDS 139,A00,202838,Staff,17,0,25,8
1683297722927,EDS 146,A01,202655,Staff,15,0,25,10
1683297723954,ENG 15,A00,185667,Staff,0,1,0,0
1683297723954,ENG 15,B00,185672,Staff,0,0,0,0
1683297723954,ENG 15,C00,185675,Staff,0,0,0,0
1683297723954,ENG 15,D00,185682,Staff,0,0,0,0
1683297723954,ENG 15,E00,185684,Staff,0,0,0,0
1683297724980,ETHN 103,A00,185710,Staff,0,3,35,35
1683297726007,ETHN 103A,A00,199228,Man; Simeon S,3,0,9,6
1683297727035,ETHN 109,A00,185711,Staff,18,0,35,17
1683297728063,ETHN 142,A00,185726,Staff,0,4,30,30
1683297729087,ETHN 163J,A00,199229,Man; Simeon S,6,0,8,2
1683297730110,ETHN 168,A00,185727,Staff,8,0,10,2
1683297731136,ETHN 182,A00,185728,Staff,1,0,35,34
1683297732161,ETHN 183,A00,185737,Staff,8,0,18,10
1683297733186,GLBH 111,A01,209361,Burgos; Jose L.,0,0,0,0
1683297735237,HIEU 104,A00,185792,Staff,16,0,20,4
1683297736261,HIEU 115,A00,185800,Staff,1,0,20,19
1683297737290,HIEU 128,A00,185801,Staff,0,7,20,20
1683297738318,HIEU 147,A00,185802,Staff,16,0,20,4
1683297739343,HIEU 154,A00,185823,Staff,12,0,20,8
1683297740370,HILA 102,A00,185826,Staff,13,0,20,7
1683297741395,HILD 2C,A01,185778,Staff,0,12,20,20
1683297742419,HILD 7B,A01,185780,Kwak; Nancy,0,15,32,32
1683297742419,HILD 7B,A02,185781,Kwak; Nancy,0,18,32,32
1683297743443,HILD 30,A01,185791,Staff,14,0,20,6
1683297744471,HISC 119,A00,185830,Golan; Tal,0,9,20,20
1683297745495,HITO 156GS,A00,185831,Patterson; Patrick H.,0,0,0,23
1683297746520,HIUS 103,A00,185832,Man; Simeon S,0,7,20,20
1683297747545,HIUS 117,A00,185836,Kwak; Nancy,2,0,20,18
1683297748570,HIUS 125,A00,185840,Man; Simeon S,0,0,23,23
1683297749597,HIUS 149,A00,185845,Staff,0,0,20,20
1683297750623,HUM 3,A01,185882,Zavodny; Tatiana Sophia,0,6,50,50
1683297750623,HUM 3,B01,185899,Caldwell; Michael Alan,0,19,50,50
1683297751646,HUM 3GS,A00,185900,Patterson; Patrick H.,0,0,0,23
1683297752676,HUM 4,A01,185938,Zroka; Amy Liane,31,0,50,19
1683297752676,HUM 4,B01,185956,Watkins; Eric,0,2,50,50
1683297752676,HUM 4,B02,202209,Watkins; Eric,0,1,50,50
1683297752676,HUM 4,B03,202210,Watkins; Eric,0,0,50,50
1683297753701,HUM 5,A01,185958,West; Geoffrey Scott,5,0,50,45
1683297753701,HUM 5,A02,202215,West; Geoffrey Scott,0,0,50,50
1683297754726,INTL 190,A00,185959,Gagnon; Jeffrey C,0,0,0,9
1683297754726,INTL 190,B00,185960,Lettieri; Michael Joseph,0,0,0,1
1683297755754,JAPN 180,A00,254509,Staff,0,1,25,25
1683297756779,LATI 10,A01,202853,Kennemore; Amy Michelle,5,0,35,30
1683297756779,LATI 10,A02,202854,Kennemore; Amy Michelle,1,0,35,34
1683297756779,LATI 10,A03,270054,Kennemore; Amy Michelle,30,0,30,0
1683297757803,LATI 180,A00,202855,Kennemore; Amy Michelle,11,0,20,9
1683297758829,LAWS 101,A00,201767,Golan; Tal,0,7,40,40
1683297759854,LIFR 1C,A00,185961,Staff,6,0,20,14
1683297760880,LIFR 1CX,A00,185962,Staff,7,0,20,13
1683297761904,LIFR 1D,A00,185963,Staff,9,0,20,11
1683297762929,LIFR 1DX,A00,185964,Staff,9,0,20,11
1683297763954,LIGN 101,A01,186039,Staff,43,0,50,7
1683297764980,LIGN 165,A00,186040,Staff,18,0,50,32
1683297766003,LTCS 108,A00,186041,Staff,6,0,10,4
1683297767030,LTCS 119,A00,186042,Staff,16,0,20,4
1683297768059,LTCS 130,A00,186043,Wesling; Megan E.,15,0,25,10
1683297770107,LTEA 138,A00,186119,Staff,14,0,40,26
1683297771134,LTEN 124,A00,186148,Staff,6,0,25,19
1683297772155,LTEN 178,A00,186149,Staff,7,0,15,8
1683297773181,LTEN 181,A00,186150,Blanco; John D,33,0,40,7
1683297774207,LTWL 120,A00,186160,Staff,20,0,25,5
1683297775234,LTWL 165,A00,186161,Staff,22,0,25,3
1683297776258,LTWR 100,A00,186162,Staff,0,4,15,15
1683297777283,LTWR 102,A00,186163,Doller; Ben,5,0,15,10
1683297778310,MAE 8,A01,186412,Staff,0,0,0,0
1683297779337,MAE 30B,A00,186445,Bahadori; Mohammad Yousef,83,0,100,17
1683297780365,MAE 40,A00,186592,Bewley; Thomas R,9,0,50,41
1683297781390,MAE 101B,A00,186593,Bahadori; Mohammad Yousef,81,0,100,19
1683297782415,MAE 105,A00,186594,Bandaru; Prabhakar,12,0,50,38
1683297783440,MAE 107,A00,186599,Pham; Hieu Tan,0,6,120,120
1683297784468,MAE 148,A01,186660,Silberman; Jack,3,0,16,13
1683297785493,MATH 10A,A01,188095,Staff,0,7,35,35
1683297786524,MATH 10B,A01,188097,Bowers; Adam R.,0,11,30,30
1683297786524,MATH 10B,A02,188099,Bowers; Adam R.,0,9,30,30
1683297786524,MATH 10B,B01,188104,Bowers; Adam R.,0,11,30,30
1683297786524,MATH 10B,B02,188106,Bowers; Adam R.,0,11,30,30
1683297787550,MATH 10C,A01,188111,Staff,0,18,30,30
1683297787550,MATH 10C,A02,188127,Staff,0,17,30,30
1683297787550,MATH 10C,A03,188131,Staff,0,17,30,30
1683297787550,MATH 10C,B01,188218,Staff,21,0,30,9
1683297787550,MATH 10C,B02,188244,Staff,13,0,30,17
1683297787550,MATH 10C,B03,188277,Staff,16,0,30,14
1683297788575,MATH 18,A01,188344,Bach; Quang Tran,18,0,30,12
1683297788575,MATH 18,A02,188345,Bach; Quang Tran,11,0,30,19
1683297788575,MATH 18,B01,188353,Bach; Quang Tran,10,0,30,20
1683297788575,MATH 18,B02,188354,Bach; Quang Tran,20,0,30,10
1683297789600,MATH 20A,A01,188374,Staff,13,0,35,22
1683297790630,MATH 20B,A01,188382,Ohm; Ko Woon,6,0,30,24
1683297790630,MATH 20B,A02,188383,Ohm; Ko Woon,24,0,30,6
1683297790630,MATH 20B,B01,188385,Ohm; Ko Woon,7,0,30,23
1683297790630,MATH 20B,B02,188392,Ohm; Ko Woon,22,0,30,8
1683297791656,MATH 20C,A01,188394,Harel; Guershon,10,0,30,20
1683297791656,MATH 20C,A02,188395,Harel; Guershon,13,0,30,17
1683297791656,MATH 20C,B01,188404,Harel; Guershon,3,0,30,27
1683297791656,MATH 20C,B02,188405,Harel; Guershon,19,0,30,11
1683297792683,MATH 20D,A01,188414,Hammock; Frances H,0,1,30,30
1683297792683,MATH 20D,A02,188415,Hammock; Frances H,4,0,30,26
1683297792683,MATH 20D,B01,188447,Hammock; Frances H,2,0,30,28
1683297792683,MATH 20D,B02,188486,Hammock; Frances H,8,0,30,22
1683297793709,MATH 20E,A01,188649,Staff,22,0,30,8
1683297793709,MATH 20E,A02,188650,Staff,23,0,30,7
1683297793709,MATH 20E,A03,188673,Staff,0,0,30,30
1683297794738,MATH 102,A01,188675,Staff,0,35,35,35
1683297795764,MATH 103B,A01,188681,Staff,4,0,35,31
1683297795764,MATH 103B,B01,188692,Staff,7,0,35,28
1683297796847,MATH 109,A01,188695,Salehi Golsefidy; Alireza,25,0,35,10
1683297796847,MATH 109,A02,188696,Salehi Golsefidy; Alireza,27,0,35,8
1683297797871,MATH 120A,A01,188698,Eggers; John Dietrich,5,0,35,30
1683297798900,MATH 142B,A01,188736,Ioana; Adrian,0,2,30,30
1683297798900,MATH 142B,A02,188741,Ioana; Adrian,0,1,30,30
1683297798900,MATH 142B,A03,188743,Ioana; Adrian,0,3,30,30
1683297799926,MATH 168A,A01,188790,Staff,0,8,35,35
1683297800952,MATH 170A,A01,188803,Nie; Jiawang,0,2,35,35
1683297800952,MATH 170A,A02,188811,Nie; Jiawang,0,0,35,35
1683297800952,MATH 170A,A03,188814,Nie; Jiawang,1,0,35,34
1683297800952,MATH 170A,A04,188815,Nie; Jiawang,14,0,35,21
1683297801977,MATH 193B,A01,188817,Staff,0,0,35,35
1683297801977,MATH 193B,A02,188818,Staff,5,0,35,30
1683297803002,MGT 4,A01,202857,Anderson; John Charles,62,0,80,18
1683297804030,MGT 12,A00,202858,Lindenberger; Wade Douglas,43,0,90,47
1683297805057,MGT 18,A00,202859,Staff,74,0,90,16
1683297806082,MGT 18GS,A00,202860,McKay; Michael J,13,0,28,15
1683297807106,MGT 45,A00,202861,Pecore; Joseph P.,14,0,90,76
1683297808134,MGT 100,A00,202863,Yavorsky; Daniel Ryan,28,0,90,62
1683297809162,MGT 103,A00,202864,Ehrich; Kristine R,0,16,90,90
1683297810186,MGT 112,A00,202865,Ehrich; Kristine R,15,0,90,75
1683297811210,MGT 121A,A00,202868,Staff,0,19,0,0
1683297812237,MGT 131B,A00,202869,Anderson; John Charles,59,0,90,31
1683297813262,MGT 136,A00,202871,Lindenberger; Wade Douglas,84,0,90,6
1683297814286,MGT 164,A00,202873,Staff,0,69,90,90
1683297815311,MGT 164GS,A00,202874,McKay; Mary A,13,0,28,15
1683297816339,MGT 180,A00,202875,Staff,0,51,90,90
1683297817363,MMW 11R,A01,205019,Herbst; Matthew,3,0,30,27
1683297817363,MMW 11R,A02,205026,Herbst; Matthew,29,0,30,1
1683297818389,MMW 15,A01,193512,Chang; Edmond Yi-Teh,0,9,28,28
1683297818389,MMW 15,A02,193513,Chang; Edmond Yi-Teh,0,5,28,28
1683297818389,MMW 15,A03,193514,Chang; Edmond Yi-Teh,0,5,28,28
1683297818389,MMW 15,A04,193515,Chang; Edmond Yi-Teh,0,4,28,28
1683297818389,MMW 15,A05,193516,Chang; Edmond Yi-Teh,0,4,28,28
1683297818389,MMW 15,A06,193517,Chang; Edmond Yi-Teh,0,5,28,28
1683297818389,MMW 15,B01,193519,Chang; Edmond Yi-Teh,0,4,28,28
1683297818389,MMW 15,B02,193520,Chang; Edmond Yi-Teh,0,5,28,28
1683297818389,MMW 15,B03,193521,Chang; Edmond Yi-Teh,0,4,28,28
1683297818389,MMW 15,B04,193522,Chang; Edmond Yi-Teh,0,4,28,28
1683297818389,MMW 15,B05,193523,Chang; Edmond Yi-Teh,0,5,28,28
1683297818389,MMW 15,B06,193524,Chang; Edmond Yi-Teh,0,4,28,28
1683297819414,MMW 122,A01,193526,Rahimi; Babak,0,14,28,28
1683297819414,MMW 122,A02,193527,Rahimi; Babak,0,14,28,28
1683297819414,MMW 122,A03,193528,Rahimi; Babak,0,0,0,0
1683297819414,MMW 122,A04,193529,Rahimi; Babak,0,0,0,0
1683297820438,MUS 1A,A01,186663,Staff,0,20,35,35
1683297821467,MUS 4,A01,186715,Staff,0,12,35,35
1683297822494,MUS 5R,A01,186796,Dubnov; Shlomo,0,16,35,35
1683297823523,MUS 6,A01,186798,Staff,0,3,25,25
1683297824551,MUS 7,A01,186830,Staff,12,0,35,23
1683297825577,MUS 8,A01,186930,Staff,0,25,35,35
1683297826603,MUS 15,A01,186932,Staff,0,15,35,35
1683297826603,MUS 15,B01,186934,Staff,0,14,35,35
1683297827638,MUS 80,A00,186935,Staff,2,0,20,18
1683297827638,MUS 80,B00,186936,Staff,25,0,25,0
1683297828664,NANO 11,A00,204702,Lipomi; Darren John,0,0,0,0
1683297829690,NANO 15,A01,204709,Yang; Kesong,0,1,0,0
1683297830721,NANO 114,A00,202069,Jahed Motlagh; Zeinab,3,0,10,7
1683297831750,PHIL 1,A00,186955,Grush; Rick Scott,32,0,40,8
1683297832776,PHIL 10,A01,186973,Grush; Rick Scott,29,0,35,6
1683297832776,PHIL 10,A02,186974,Grush; Rick Scott,33,0,35,2
1683297833802,PHIL 13,A01,186976,Staff,7,0,35,28
1683297833802,PHIL 13,A02,186977,Staff,16,0,35,19
1683297834827,PHIL 14,A01,186979,Staff,31,0,35,4
1683297834827,PHIL 14,A02,186986,Staff,32,0,35,3
1683297835853,PHIL 28,A01,186988,Staff,16,0,30,14
1683297835853,PHIL 28,A02,186989,Staff,1,0,30,29
1683297835853,PHIL 28,A03,186990,Staff,9,0,30,21
1683297835853,PHIL 28,A04,186991,Staff,26,0,30,4
1683297836878,PHIL 120,A00,186997,Staff,23,0,40,17
1683297837903,PHIL 137,A00,187003,Staff,9,0,40,31
1683297838929,PHIL 150,A00,187015,Staff,47,0,70,23
1683297839952,PHIL 167,A00,187021,Lamey; Andy M.,35,0,40,5
1683297840977,PHIL 174,A01,202226,Staff,17,0,20,3
1683297840977,PHIL 174,A02,202235,Staff,20,0,20,0
1683297842006,PHIL 191A,A00,258918,Staff,0,0,1,1
1683297843031,PHYS 1A,A00,187028,Staff,26,0,60,34
1683297844056,PHYS 1AL,001,187036,Staff,2,0,30,28
1683297844056,PHYS 1AL,002,187049,Staff,18,0,30,12
1683297845084,PHYS 1B,A00,187058,Staff,23,0,60,37
1683297846110,PHYS 1BL,001,187064,Staff,0,0,30,30
1683297846110,PHYS 1BL,002,187070,Staff,6,0,30,24
1683297847136,PHYS 1C,A00,187082,Staff,32,0,120,88
1683297848166,PHYS 1CL,001,187088,Staff,0,9,30,30
1683297848166,PHYS 1CL,002,187089,Staff,0,2,30,30
1683297848166,PHYS 1CL,009,262693,Staff,12,0,30,18
1683297849195,PHYS 2B,A01,187097,Staff,54,0,115,61
1683297850222,PHYS 2C,A01,187099,Staff,67,0,115,48
1683297851248,PHYS 2CL,A01,187101,Staff,5,0,28,23
1683297851248,PHYS 2CL,A02,187102,Staff,15,0,28,13
1683297852278,PHYS 2D,A01,187123,Shotwell; Brian,95,0,115,20
1683297853305,PHYS 4B,A01,187133,Grinstein; Benjamin,35,0,50,15
1683297854331,POLI 10,A00,188819,Staff,0,3,50,50
1683297855359,POLI 11,A00,188827,Staff,43,0,50,7
1683297856385,POLI 13R,A00,188828,Staff,0,1,20,20
1683297857410,POLI 27,A01,188830,Elgin; Samuel Zincke,0,1,70,70
1683297858437,POLI 30,A00,188832,Desposato; Scott,33,0,50,17
1683297859463,POLI 102F,A00,188834,Staff,3,0,40,37
1683297860489,POLI 104A,A00,188852,Staff,14,0,30,16
1683297861518,POLI 104I,A00,188853,Staff,0,6,20,20
1683297862548,POLI 110B,A00,188854,Wiens; David,7,0,20,13
1683297863577,POLI 112A,A00,188855,Wiens; David,5,0,30,25
1683297864607,POLI 117R,A00,188856,Forman; Fonna,0,11,20,20
1683297865633,POLI 118,A00,188857,Ingham; Sean,8,0,20,12
1683297866658,POLI 120G,A00,188858,Staff,9,0,30,21
1683297867683,POLI 131CR,A00,188863,Hoston; Germaine,24,0,50,26
1683297868712,POLI 133,A00,188864,Nellis; Gareth Hb,44,0,50,6
1683297869738,POLI 134D,A00,188865,Desposato; Scott,27,0,30,3
1683297870764,POLI 142A,A00,188871,Gartzke; Erik,22,0,50,28
1683297871788,POLI 142K,A00,188874,Staff,38,0,50,12
1683297872813,POLI 143,A00,188940,Gartzke; Erik,16,0,30,14
1683297873837,POLI 153,A00,188943,Staff,3,0,20,17
1683297874865,POLI 160AA,A00,188944,Staff,13,0,40,27
1683297875894,POLI 170A,A00,188945,Staff,11,0,30,19
1683297877950,PSYC 1,A00,188952,Staff,38,0,90,52
1683297878977,PSYC 2,B00,188953,Staff,20,0,35,15
1683297880005,PSYC 6,A00,188970,Staff,47,0,60,13
1683297881033,PSYC 7,A00,188973,Staff,37,0,45,8
1683297882064,PSYC 60,A01,188980,Rickard; Timothy C.,43,0,60,17
1683297883094,PSYC 70,A01,189001,Steiner; Eric Tomas,24,0,45,21
1683297884125,PSYC 100,A00,189005,Lacefield; Katharine I,0,99,120,120
1683297885152,PSYC 102,A00,189008,Staff,10,0,30,20
1683297886178,PSYC 106,B00,189026,Gorman; Michael R.,37,0,60,23
1683297887210,PSYC 114,B01,189033,Winkielman; Piotr,0,32,30,30
1683297888236,PSYC 131,A00,189036,Anagnostaras; Stephan,0,43,60,60
1683297889262,PSYC 136,A00,189041,Lowe; Angela Beth,0,7,25,25
1683297890288,PSYC 137,A00,189057,Winkielman; Piotr,0,34,25,25
1683297891319,PSYC 144,A00,189107,Wixted; John T,0,7,50,50
1683297893372,PSYC 162,A00,189142,Staff,0,8,85,85
1683297894396,PSYC 172,A00,189144,Gorman; Michael R.,0,7,30,30
1683297896444,PSYC 179,A00,189146,Lacefield; Katharine I,0,84,120,120
1683297897469,PSYC 181,A00,189147,Anagnostaras; Stephan,0,44,90,90
1683297898495,PSYC 190R,A00,189148,Barner; David A.,0,22,80,80
1683297899525,PSYC 191,A00,189275,Rickard; Timothy C.,0,7,25,25
1683297900608,PSYC 193,A00,189276,Chapman; Eddie Nathaniel,0,1,0,4
1683297901633,PSYC 193L,A01,189281,Lowe; Angela Beth,12,0,20,8
1683297901633,PSYC 193L,B01,189285,Staff,28,0,35,7
1683297902658,RELI 149,A00,187137,Rahimi; Babak,7,0,40,33
1683297903685,SE 9,A01,187315,Staff,0,2,18,18
1683297904707,SE 101B,A00,187409,Staff,24,0,30,6
1683297905732,SE 110B,A00,187444,Staff,10,0,40,30
1683297906758,SE 130B,A00,187449,Staff,31,0,40,9
1683297907787,SE 150A,A00,187516,Staff,9,0,20,11
1683297908815,SE 154,A00,187528,Staff,30,0,50,20
1683297909843,SIO 3,A01,258171,Staff,35,0,40,5
1683297910868,SIO 10,A00,187144,Cook; Geoffrey W,0,3,75,75
1683297911894,SIO 45,A00,187152,Cook; Geoffrey W,1,0,100,99
1683297912920,SIO 109R,A00,194486,Staff,0,3,20,20
1683297914973,SIO 187,A01,187233,Kacev; David,12,0,40,28
1683297916005,SOCI 1,A01,258656,Thorpe; Charles Robert,28,0,30,2
1683297916005,SOCI 1,A02,258658,Thorpe; Charles Robert,30,0,30,0
1683297916005,SOCI 1,A03,258661,Thorpe; Charles Robert,25,0,25,0
1683297916005,SOCI 1,A04,258666,Thorpe; Charles Robert,22,0,25,3
1683297916005,SOCI 1,A05,258897,Thorpe; Charles Robert,23,0,25,2
1683297916005,SOCI 1,A06,258898,Thorpe; Charles Robert,25,0,25,0
1683297917033,SOCI 30,A01,258903,Pardo Guerra; Juan Pablo,16,0,30,14
1683297918060,SOCI 102,A00,258904,Staff,9,0,25,16
1683297919088,SOCI 106,A00,258905,Staff,19,0,25,6
1683297920118,SOCI 111,A00,258907,Ribas Norris; Janet Vanesa,26,0,30,4
1683297921145,SOCI 121R,A00,258908,Pardo Guerra; Juan Pablo,11,0,30,19
1683297922169,SOCI 126,A01,203330,Staff,14,0,20,6
1683297923194,SOCI 131,A00,258909,Thorpe; Charles Robert,31,0,60,29
1683297924220,SOCI 135,A00,258910,Payne; Christine Anna,0,9,30,30
1683297925247,SOCI 157,A00,258911,Staff,13,0,30,17
1683297926275,SOCI 184,A00,258912,Staff,26,0,30,4
1683297927299,SOCI 188D,A00,258913,Staff,21,0,30,9
1683297928329,SYN 2,001,187529,Staff,9,0,16,7
1683297928329,SYN 2,002,201452,Staff,0,18,16,16
1683297928329,SYN 2,003,201469,Staff,3,0,16,13
1683297929360,SYN 100,A01,187531,Staff,0,9,20,20
1683297929360,SYN 100,B01,201491,Staff,0,12,20,20
1683297930392,TDAC 1,A00,189286,Walsh; Kim C.,3,0,20,17
1683297930392,TDAC 1,B00,189287,Harting; Carla Kelso,11,0,20,9
1683297931420,TDAC 101,A00,189300,Walsh; Kim C.,16,0,20,4
1683297931420,TDAC 101,B00,189301,Harting; Carla Kelso,18,0,20,2
1683297932446,TDAC 102,A00,189304,Basso; Beatrice,14,0,20,6
1683297933470,TDAC 108,A00,189305,Staff,18,0,20,2
1683297934496,TDDE 131,A00,189310,Staff,19,0,20,1
1683297934496,TDDE 131,B00,189314,Staff,19,0,20,1
1683297934496,TDDE 131,C00,189315,Staff,48,0,50,2
1683297934496,TDDE 131,D00,189316,Staff,14,0,15,1
1683297934496,TDDE 131,E00,204841,Staff,20,0,20,0
1683297935521,TDGE 10,A00,189289,Staff,30,0,50,20
1683297935521,TDGE 10,B00,189290,Havis; Allan,2,0,50,48
1683297936547,TDGE 11,A00,189291,Fulton; Julia,0,3,50,50
1683297936547,TDGE 11,B00,189292,Staff,20,0,25,5
1683297936547,TDGE 11,C00,260270,Staff,0,0,0,0
1683297937573,TDGE 25,A00,189294,Staff,3,0,20,17
1683297938598,TDGE 124,A00,189318,Fulton; Julia,0,8,50,50
1683297939621,TDGE 125,A00,189319,Staff,13,0,25,12
1683297939621,TDGE 125,B00,189320,Staff,23,0,25,2
1683297940645,TDGE 127,A00,189322,Havis; Allan,0,0,50,50
1683297941670,TDHT 101,A00,189323,Staff,18,0,25,7
1683297941670,TDHT 101,B00,189324,Staff,25,0,25,0
1683297942696,TDHT 102,A00,189325,Staff,49,0,50,1
1683297943723,TDMV 1,A00,189295,Arcidiacono; Kristin,20,0,30,10
1683297943723,TDMV 1,B00,189296,Caligagan; Maria T.,24,0,30,6
1683297944752,TDMV 2,A00,189297,Sammartano; Tonnie,28,0,30,2
1683297944752,TDMV 2,B00,189299,Arcidiacono; Kristin,24,0,30,6
1683297945778,TDMV 3,A00,204998,Rincon; Alicia,22,0,30,8
1683297946807,TDMV 120,A00,189458,Sammartano; Tonnie,28,0,30,2
1683297947837,TDMV 138,A00,189541,Jun; Grace Shin Hae,22,0,40,18
1683297948867,TDMV 142,A00,189717,Caligagan; Tony,23,0,30,7
1683297948867,TDMV 142,B00,189718,Caligagan; Maria T.,25,0,30,5
1683297949894,TMC 2,A01,187533,Staff,25,0,25,0
1683297949894,TMC 2,A02,187534,Staff,25,0,25,0
1683297950918,USP 1,A01,187536,Kwak; Nancy,0,16,25,25
1683297951944,USP 5,A01,187538,Staff,9,0,25,16
1683297952966,USP 101,A00,199253,Staff,0,4,0,0
1683297953996,USP 124,A00,187562,Boomhower; Matthew Charles,1,0,30,29
1683297955024,USP 138,A00,187582,Staff,20,0,25,5
1683297956051,USP 152,A01,187597,Staff,4,0,25,21
1683297957078,USP 153,A00,187598,Staff,19,0,25,6
1683297958101,USP 168,A00,187607,Kwak; Nancy,2,0,5,3
1683297959127,USP 173,A00,187619,Staff,4,0,25,21
1683297960155,USP 181,A00,187638,Staff,0,0,25,25
1683297961190,VIS 103,A00,187650,Cruz; Edwin Teddy,23,0,75,52
1683297962218,VIS 110D,A00,187669,Staff,12,0,22,10
1683297963249,VIS 127C,A00,187720,Shen; Kuiyi,68,0,146,78
1683297964281,VIS 149,A00,187731,Yoldas; Pinar,0,14,22,22
1683297965308,VIS 151,A01,188091,Staff,22,0,34,12
1683297965308,VIS 151,A02,188092,Staff,11,0,34,23
1683297966335,VIS 160B,A00,188093,Stalbaum; Brett,0,0,10,10
1683297968390,WCWP 10B,A00,201720,Staff,10,0,15,5
1683297968390,WCWP 10B,B00,201722,Staff,8,0,15,7
1683297969420,WCWP 100,A00,201725,Gagnon; Jeffrey C,0,0,2,2
1683297969420,WCWP 100,B00,201727,Staff,0,4,15,15
1683297972595,ANBI 133,A00,258401,Wilder; Linnea Lorene,34,0,40,6
1683297973628,ANBI 140,A00,258395,Hrvoj Mihic; Branka,18,0,25,7
1683297974653,ANSC 120,A00,258402,Bialecki; Jon Anthony,27,0,40,13
1683297975681,ANSC 144,A00,258400,Staff,14,0,40,26
1683297977735,ANSC 166,A00,258396,Parish; Steven Martin,157,0,175,18
1683297978760,ANSC 180,A00,193533,Staff,9,0,20,11
1683297979790,ANSC 188,A00,258397,Jassal; Aftab,33,0,40,7
1683297980815,ANTH 3,A01,258316,Staff,23,0,30,7
1683297981842,ANTH 5,A00,258394,Semendeferi; Ekaterini,16,0,20,4
1683297982867,ANTH 21,A01,258331,Staff,9,0,40,31
1683297983892,ANTH 103,A00,258398,Varma; Saiba,15,0,25,10
1683297984922,AWP 10,001,202034,Staff,0,0,0,0
1683297984922,AWP 10,002,202035,Staff,0,0,0,0
1683297984922,AWP 10,003,202036,Staff,0,0,0,0
1683297984922,AWP 10,004,202037,Staff,0,0,0,0
1683297984922,AWP 10,005,202038,Staff,0,0,0,0
1683297984922,AWP 10,006,202039,Staff,0,0,0,0
1683297984922,AWP 10,007,202040,Staff,0,0,0,0
1683297984922,AWP 10,008,202041,Staff,0,0,0,0
1683297984922,AWP 10,009,202042,Staff,0,0,0,0
1683297984922,AWP 10,010,202043,Staff,0,0,0,0
1683297984922,AWP 10,011,202044,Staff,0,0,0,0
1683297984922,AWP 10,012,202045,Staff,0,0,0,0
1683297984922,AWP 10,013,202046,Staff,0,0,0,0
1683297984922,AWP 10,014,202047,Staff,0,0,0,0
1683297984922,AWP 10,015,202048,Staff,0,0,0,0
1683297984922,AWP 10,016,202049,Staff,0,0,0,0
1683297984922,AWP 10,017,202050,Staff,0,0,0,0
1683297984922,AWP 10,018,202051,Staff,0,0,0,0
1683297984922,AWP 10,019,202052,Staff,0,0,0,0
1683297984922,AWP 10,020,202053,Staff,0,0,0,0
1683297984922,AWP 10,021,202054,Staff,0,0,0,0
1683297984922,AWP 10,022,202055,Staff,0,0,0,0
1683297984922,AWP 10,023,202056,Staff,0,0,0,0
1683297984922,AWP 10,024,202057,Staff,0,0,0,0
1683297984922,AWP 10,025,202058,Staff,0,0,0,0
1683297984922,AWP 10,026,202059,Staff,0,0,0,0
1683297985947,AWP 102,001,202032,Staff,0,0,0,0
1683297985947,AWP 102,002,202033,Staff,0,0,0,0
1683297986977,BENG 100,A01,254234,Taylor Amos; Alyssa C,31,0,40,9
1683297988003,BENG 196,001,270013,Engler; Adam J.,9999,0,9999,0
1683297989043,BICD 100R,A01,202018,Smith; Laurie,0,7,32,32
1683297989043,BICD 100R,A02,202019,Smith; Laurie,0,2,32,32
1683297989043,BICD 100R,A03,202020,Smith; Laurie,0,1,32,32
1683297989043,BICD 100R,A04,202021,Smith; Laurie,8,0,32,24
1683297989043,BICD 100R,A05,202022,Smith; Laurie,12,0,32,20
1683297990077,BICD 136,A01,193242,Gustafson-Brown; Cindy,0,2,32,32
1683297990077,BICD 136,A02,193244,Gustafson-Brown; Cindy,15,0,32,17
1683297991102,BIEB 102,A01,193249,Butler; Shannon Rhey,0,2,32,32
1683297991102,BIEB 102,A02,193251,Butler; Shannon Rhey,0,0,32,32
1683297991102,BIEB 102,A03,193253,Butler; Shannon Rhey,0,1,32,32
1683297991102,BIEB 102,A04,193255,Butler; Shannon Rhey,17,0,32,15
1683297991102,BIEB 102,A05,193265,Butler; Shannon Rhey,26,0,32,6
1683297991102,BIEB 102,A06,193269,Butler; Shannon Rhey,16,0,32,16
1683297993157,BIEB 150,A01,193274,Staff,0,0,32,32
1683297993157,BIEB 150,A02,193285,Staff,24,0,32,8
1683297994182,BIEB 194,A00,193286,Kurle; Carolyn M.,22,0,32,10
1683297995209,BILD 1,A01,192291,Staff,16,0,32,16
1683297995209,BILD 1,A02,192292,Staff,30,0,32,2
1683297995209,BILD 1,B01,192520,Reuther; Keefe,0,1,0,0
1683297995209,BILD 1,B02,192532,Reuther; Keefe,0,1,0,0
1683297996239,BILD 3,A01,192556,Butler; Shannon Rhey,0,0,32,32
1683297996239,BILD 3,A02,192581,Butler; Shannon Rhey,5,0,32,27
1683297996239,BILD 3,A03,192611,Butler; Shannon Rhey,23,0,32,9
1683297996239,BILD 3,A04,192612,Butler; Shannon Rhey,25,0,32,7
1683297996239,BILD 3,A05,192613,Butler; Shannon Rhey,27,0,32,5
1683297996239,BILD 3,A06,192679,Butler; Shannon Rhey,27,0,32,5
1683297996239,BILD 3,A07,192682,Butler; Shannon Rhey,22,0,32,10
1683297997270,BILD 4,A01,192836,Reuther; Keefe,1,0,24,23
1683297997270,BILD 4,A02,193044,Reuther; Keefe,4,0,24,20
1683297998298,BILD 10,A01,193142,Gustafson-Brown; Cindy,31,0,32,1
1683297998298,BILD 10,A02,193149,Gustafson-Brown; Cindy,31,0,32,1
1683297999326,BIMM 100,A01,193301,Staff,0,6,32,32
1683297999326,BIMM 100,A02,193312,Staff,0,5,32,32
1683297999326,BIMM 100,A03,193323,Staff,0,8,32,32
1683298000352,BIMM 101,A01,193329,McDonnell; Lisa Marie,0,3,24,24
1683298000352,BIMM 101,A02,193339,McDonnell; Lisa Marie,0,2,24,24
1683298000352,BIMM 101,B01,193354,McDonnell; Lisa Marie,0,3,24,24
1683298000352,BIMM 101,B02,193357,McDonnell; Lisa Marie,0,3,24,24
1683298001378,BIMM 110,A01,193377,Tat; John,0,11,32,32
1683298001378,BIMM 110,A02,193378,Tat; John,1,9,32,31
1683298002411,BIMM 120,A01,206116,Staff,0,0,32,32
1683298002411,BIMM 120,A02,206117,Staff,8,0,32,24
1683298002411,BIMM 120,A03,206121,Staff,21,0,32,11
1683298003438,BIPN 100,A01,193393,Park; Ji Young,0,14,32,32
1683298003438,BIPN 100,A02,193402,Park; Ji Young,0,12,32,32
1683298003438,BIPN 100,A03,193413,Park; Ji Young,0,14,32,32
1683298003438,BIPN 100,A04,193414,Park; Ji Young,0,13,32,32
1683298004519,BIPN 102,A01,193429,Staff,0,0,32,32
1683298004519,BIPN 102,A02,193438,Staff,23,0,32,9
1683298005545,BIPN 106,A01,193450,Reyes Gonzalez; Catalina,0,2,40,40
1683298006570,BIPN 134,A01,193465,Cooke; James Edward,0,0,32,32
1683298006570,BIPN 134,A02,193474,Cooke; James Edward,27,0,32,5
1683298006570,BIPN 134,A03,193485,Cooke; James Edward,29,0,32,3
1683298006570,BIPN 134,A04,193486,Cooke; James Edward,21,0,32,11
1683298006570,BIPN 134,A05,193491,Cooke; James Edward,31,0,32,1
1683298006570,BIPN 134,A06,193501,Cooke; James Edward,30,0,32,2
1683298006570,BIPN 134,A07,193510,Cooke; James Edward,29,0,32,3
1683298008627,BISP 194,A00,222522,Staff,16,0,32,16
1683298009652,CAT 124,A01,202407,Staff,20,0,25,5
1683298010677,CAT 125,A00,202408,Marchisotto; Jennifer Anne,4,0,20,16
1683298011705,CAT 125R,A00,202409,Smith; Lauryn Alissa,0,11,20,20
1683298011705,CAT 125R,B00,202410,Morales; Celeste Georgianna,0,11,20,20
1683298011705,CAT 125R,C00,202411,Irwin; Matthew Joseph,0,10,20,20
1683298012732,CENG 15,A01,204712,Yang; Kesong,0,1,0,0
1683298013757,CENG 114,A00,202070,Jahed Motlagh; Zeinab,5,0,20,15
1683298014784,CGS 105,A00,185477,Wesling; Megan E.,24,0,40,16
1683298015808,CGS 106,A00,185494,Staff,13,0,22,9
1683298016836,CGS 108,A00,185495,Staff,14,0,20,6
1683298017862,CGS 114,A00,185496,Staff,13,0,18,5
1683298018890,CGS 119,A00,185501,Staff,15,0,20,5
1683298019914,CGS 120,A00,185511,Staff,13,0,20,7
1683298020947,CHEM 4,A01,184675,Bussey; Thomas J,96,0,100,4
1683298021972,CHEM 6A,A01,184677,Staff,35,0,60,25
1683298023001,CHEM 6B,A01,184679,Staff,65,0,100,35
1683298024032,CHEM 6C,A01,184681,Bussey; Thomas J,1,0,50,49
1683298024032,CHEM 6C,A02,184682,Bussey; Thomas J,34,0,50,16
1683298025057,CHEM 40A,A01,184684,Albizati; Kim F.,37,0,100,63
1683298026087,CHEM 40B,A01,184686,Albizati; Kim F.,0,20,100,100
1683298027111,CHEM 41B,A01,184690,Staff,52,0,100,48
1683298028136,COGS 3,A01,184715,Boyle; Mary E. T.,0,25,40,40
1683298029161,COGS 14B,A01,185172,Staff,0,15,38,38
1683298030186,COGS 18,A01,184736,Staff,20,0,80,60
1683298031212,COGS 100,A01,184932,Staff,0,5,73,73
1683298032237,COGS 101A,A01,184935,Staff,0,38,30,30
1683298033262,COGS 101B,A01,184944,Staff,0,2,30,30
1683298034290,COGS 101C,A01,184946,Staff,0,12,30,30
1683298035322,COGS 102A,A01,184951,Johnson; Christine M.,2,0,40,38
1683298036345,COGS 107B,A01,184953,Mooshagian; Eric Frederick,0,50,40,40
1683298037371,COGS 118B,A01,184959,Gupta; Anjum,0,48,40,40
1683298038397,COGS 153,A00,184961,Staff,0,15,30,30
1683298039424,COGS 177,A00,184962,Staff,0,21,30,30
1683298040452,COGS 187A,A01,184969,Boyle; Mary E. T.,0,17,40,40
1683298041477,COMM 10,A01,185174,Staff,0,5,25,25
1683298041477,COMM 10,A02,185189,Staff,0,5,25,25
1683298041477,COMM 10,A03,269821,Staff,0,0,0,0
1683298042505,COMM 100B,A01,185475,Staff,0,0,0,2
1683298042505,COMM 100B,A02,185476,Staff,14,0,25,11
1683298043530,COMM 100C,A01,185314,Staff,1,0,25,24
1683298043530,COMM 100C,A02,185327,Staff,19,0,25,6
1683298044556,COMM 110M,A00,185349,Staff,2,0,40,38
1683298045587,COMM 113T,A00,185352,Staff,25,0,40,15
1683298046611,COMM 114I,A00,185353,Staff,33,0,40,7
1683298047639,COMM 131,A00,185354,Staff,19,0,30,11
1683298048668,CSE 8A,A50,185358,Cao; Yingjun,0,46,10,10
1683298049697,CSE 8B,A01,185362,Staff,1,47,50,49
1683298050723,CSE 11,A01,185416,Cao; Yingjun,0,93,10,10
1683298051749,CSE 20,A01,185445,Briones; Jor-el Thomas Caparas,5,0,25,20
1683298052774,CSE 21,A01,185447,Staff,10,0,50,40
1683298053801,CSE 101,A01,185451,Staff,0,12,50,50
1683298053801,CSE 101,B01,185453,Jones; Miles E,0,11,50,50
1683298055847,CSE 141,A01,185458,Eldon; John,20,0,100,80
1683298056871,CSE 141L,A01,185461,Eldon; John,12,0,100,88
1683298057899,CSE 142,A01,185463,Staff,35,0,60,25
1683298057899,CSE 142,B01,201355,Staff,0,6,60,60
1683298058923,CSE 142L,A01,185470,Staff,35,0,60,25
1683298058923,CSE 142L,B01,201417,Staff,0,5,60,60
1683298059950,CSE 190,A00,201433,Staff,32,0,49,17
1683298060980,DOC 1,A01,259136,Strom; Megan C.,8,0,15,7
1683298060980,DOC 1,A02,259137,Strom; Megan C.,14,0,15,1
1683298060980,DOC 1,A03,259138,Strom; Megan C.,14,0,15,1
1683298060980,DOC 1,A04,259139,Strom; Megan C.,14,0,15,1
1683298062006,DOC 100D,A00,259140,Pass; Natalye Joann,17,0,25,8
1683298063036,DSGN 1,A01,184749,Rill; Bryan,0,24,30,30
1683298064062,DSGN 100,A01,185168,Staff,0,2,25,25
1683298065087,ECE 5,A01,185626,Morris; Karcher William,0,10,0,0
1683298066111,ECE 101,A01,185628,Staff,17,0,70,53
1683298067140,ECE 107,A01,185635,Baghdadchi; Saharnaz,0,0,20,20
1683298067140,ECE 107,A02,185638,Baghdadchi; Saharnaz,4,0,20,16
1683298068164,ECE 148,A01,185647,Silberman; Jack,1,0,16,15
1683298069189,ECON 1,A01,185537,Crane; Meredith Helen,54,0,70,16
1683298070217,ECON 3,A01,185549,Crane; Meredith Helen,33,0,70,37
1683298071246,ECON 4,A01,203354,Anderson; John Charles,0,4,10,10
1683298072269,ECON 100A,A01,185574,Staff,0,4,40,40
1683298073297,ECON 100B,A01,185576,Staff,0,22,40,40
1683298074322,ECON 100C,A01,185589,Newhouse; Herbert S,30,0,70,40
1683298075346,ECON 105,A00,185608,Vespa; Emanuel Ignacio,19,0,35,16
1683298076371,ECON 109,A01,185610,Shishkin; Denis,10,0,35,25
1683298077396,ECON 110A,A01,185612,Staff,11,0,40,29
1683298078420,ECON 120A,A01,185615,Staff,20,0,40,20
1683298079444,ECON 120C,A01,185617,Sun; Yixiao,0,20,70,70
1683298080470,ECON 144,A00,203346,Squires; Dale E,3,0,35,32
1683298081494,ECON 171,A01,203349,Newhouse; Herbert S,0,1,35,35
1683298082519,ECON 173A,A01,185621,Toda; Alexis Akira,21,0,35,14
1683298083546,EDS 25,A01,202413,Staff,0,1,0,0
1683298083546,EDS 25,A02,202414,Staff,0,1,0,0
1683298083546,EDS 25,A03,202415,Staff,0,0,0,0
1683298083546,EDS 25,A04,202416,Staff,0,1,0,0
1683298083546,EDS 25,A05,202439,Staff,0,0,0,0
1683298083546,EDS 25,A06,202440,Staff,0,0,0,0
1683298083546,EDS 25,B01,202631,Staff,0,0,0,0
1683298083546,EDS 25,B02,202632,Staff,0,0,0,0
1683298083546,EDS 25,B03,202639,Staff,0,0,0,0
1683298083546,EDS 25,B04,202640,Staff,0,0,0,0
1683298083546,EDS 25,B05,202643,Staff,0,0,0,0
1683298083546,EDS 25,B06,202644,Staff,0,0,0,0
1683298084573,EDS 38,A01,202659,Black; Alison Michelle,24,0,25,1
1683298085599,EDS 115,A00,202652,Staff,17,0,30,13
1683298086624,EDS 125,A00,202649,Staff,14,0,30,16
1683298087649,EDS 126,A01,203332,Staff,30,0,30,0
1683298088681,EDS 139,A00,202838,Staff,17,0,25,8
1683298089706,EDS 146,A01,202655,Staff,15,0,25,10
1683298090732,ENG 15,A00,185667,Staff,0,1,0,0
1683298090732,ENG 15,B00,185672,Staff,0,0,0,0
1683298090732,ENG 15,C00,185675,Staff,0,0,0,0
1683298090732,ENG 15,D00,185682,Staff,0,0,0,0
1683298090732,ENG 15,E00,185684,Staff,0,0,0,0
1683298091756,ETHN 103,A00,185710,Staff,0,3,35,35
1683298092781,ETHN 103A,A00,199228,Man; Simeon S,3,0,9,6
1683298093807,ETHN 109,A00,185711,Staff,18,0,35,17
1683298094835,ETHN 142,A00,185726,Staff,0,4,30,30
1683298095860,ETHN 163J,A00,199229,Man; Simeon S,6,0,8,2
1683298096885,ETHN 168,A00,185727,Staff,8,0,10,2
1683298097909,ETHN 182,A00,185728,Staff,1,0,35,34
1683298098934,ETHN 183,A00,185737,Staff,8,0,18,10
1683298099960,GLBH 111,A01,209361,Burgos; Jose L.,0,0,0,0
1683298102011,HIEU 104,A00,185792,Staff,16,0,20,4
1683298103036,HIEU 115,A00,185800,Staff,1,0,20,19
1683298104064,HIEU 128,A00,185801,Staff,0,7,20,20
1683298105091,HIEU 147,A00,185802,Staff,16,0,20,4
1683298106120,HIEU 154,A00,185823,Staff,12,0,20,8
1683298107145,HILA 102,A00,185826,Staff,13,0,20,7
1683298108245,HILD 2C,A01,185778,Staff,0,12,20,20
1683298109271,HILD 7B,A01,185780,Kwak; Nancy,0,15,32,32
1683298109271,HILD 7B,A02,185781,Kwak; Nancy,0,18,32,32
1683298110298,HILD 30,A01,185791,Staff,14,0,20,6
1683298111323,HISC 119,A00,185830,Golan; Tal,0,9,20,20
1683298112347,HITO 156GS,A00,185831,Patterson; Patrick H.,0,0,0,23
1683298113372,HIUS 103,A00,185832,Man; Simeon S,0,7,20,20
1683298114396,HIUS 117,A00,185836,Kwak; Nancy,2,0,20,18
1683298115423,HIUS 125,A00,185840,Man; Simeon S,0,0,23,23
1683298116446,HIUS 149,A00,185845,Staff,0,0,20,20
1683298117476,HUM 3,A01,185882,Zavodny; Tatiana Sophia,0,6,50,50
1683298117476,HUM 3,B01,185899,Caldwell; Michael Alan,0,19,50,50
1683298118503,HUM 3GS,A00,185900,Patterson; Patrick H.,0,0,0,23
1683298119531,HUM 4,A01,185938,Zroka; Amy Liane,31,0,50,19
1683298119531,HUM 4,B01,185956,Watkins; Eric,0,2,50,50
1683298119531,HUM 4,B02,202209,Watkins; Eric,0,1,50,50
1683298119531,HUM 4,B03,202210,Watkins; Eric,0,0,50,50
1683298120559,HUM 5,A01,185958,West; Geoffrey Scott,5,0,50,45
1683298120559,HUM 5,A02,202215,West; Geoffrey Scott,0,0,50,50
1683298121586,INTL 190,A00,185959,Gagnon; Jeffrey C,0,0,0,9
1683298121586,INTL 190,B00,185960,Lettieri; Michael Joseph,0,0,0,1
1683298122611,JAPN 180,A00,254509,Staff,0,1,25,25
1683298123636,LATI 10,A01,202853,Kennemore; Amy Michelle,5,0,35,30
1683298123636,LATI 10,A02,202854,Kennemore; Amy Michelle,1,0,35,34
1683298123636,LATI 10,A03,270054,Kennemore; Amy Michelle,30,0,30,0
1683298124665,LATI 180,A00,202855,Kennemore; Amy Michelle,11,0,20,9
1683298125689,LAWS 101,A00,201767,Golan; Tal,0,7,40,40
1683298126712,LIFR 1C,A00,185961,Staff,6,0,20,14
1683298127735,LIFR 1CX,A00,185962,Staff,7,0,20,13
1683298128761,LIFR 1D,A00,185963,Staff,9,0,20,11
1683298129787,LIFR 1DX,A00,185964,Staff,9,0,20,11
1683298130813,LIGN 101,A01,186039,Staff,43,0,50,7
1683298131840,LIGN 165,A00,186040,Staff,18,0,50,32
1683298132867,LTCS 108,A00,186041,Staff,6,0,10,4
1683298133892,LTCS 119,A00,186042,Staff,16,0,20,4
1683298134916,LTCS 130,A00,186043,Wesling; Megan E.,15,0,25,10
1683298136963,LTEA 138,A00,186119,Staff,14,0,40,26
1683298137990,LTEN 124,A00,186148,Staff,6,0,25,19
1683298139014,LTEN 178,A00,186149,Staff,7,0,15,8
1683298140038,LTEN 181,A00,186150,Blanco; John D,33,0,40,7
1683298141066,LTWL 120,A00,186160,Staff,20,0,25,5
1683298142093,LTWL 165,A00,186161,Staff,22,0,25,3
1683298143122,LTWR 100,A00,186162,Staff,0,4,15,15
1683298144150,LTWR 102,A00,186163,Doller; Ben,5,0,15,10
1683298145174,MAE 8,A01,186412,Staff,0,0,0,0
1683298146199,MAE 30B,A00,186445,Bahadori; Mohammad Yousef,83,0,100,17
1683298147223,MAE 40,A00,186592,Bewley; Thomas R,9,0,50,41
1683298148250,MAE 101B,A00,186593,Bahadori; Mohammad Yousef,81,0,100,19
1683298149274,MAE 105,A00,186594,Bandaru; Prabhakar,12,0,50,38
1683298150298,MAE 107,A00,186599,Pham; Hieu Tan,0,6,120,120
1683298151328,MAE 148,A01,186660,Silberman; Jack,3,0,16,13
1683298152353,MATH 10A,A01,188095,Staff,0,7,35,35
1683298153376,MATH 10B,A01,188097,Bowers; Adam R.,0,11,30,30
1683298153376,MATH 10B,A02,188099,Bowers; Adam R.,0,9,30,30
1683298153376,MATH 10B,B01,188104,Bowers; Adam R.,0,11,30,30
1683298153376,MATH 10B,B02,188106,Bowers; Adam R.,0,11,30,30
1683298154401,MATH 10C,A01,188111,Staff,0,18,30,30
1683298154401,MATH 10C,A02,188127,Staff,0,17,30,30
1683298154401,MATH 10C,A03,188131,Staff,0,17,30,30
1683298154401,MATH 10C,B01,188218,Staff,21,0,30,9
1683298154401,MATH 10C,B02,188244,Staff,13,0,30,17
1683298154401,MATH 10C,B03,188277,Staff,16,0,30,14
1683298155429,MATH 18,A01,188344,Bach; Quang Tran,18,0,30,12
1683298155429,MATH 18,A02,188345,Bach; Quang Tran,11,0,30,19
1683298155429,MATH 18,B01,188353,Bach; Quang Tran,10,0,30,20
1683298155429,MATH 18,B02,188354,Bach; Quang Tran,20,0,30,10
1683298156456,MATH 20A,A01,188374,Staff,13,0,35,22
1683298157484,MATH 20B,A01,188382,Ohm; Ko Woon,6,0,30,24
1683298157484,MATH 20B,A02,188383,Ohm; Ko Woon,24,0,30,6
1683298157484,MATH 20B,B01,188385,Ohm; Ko Woon,7,0,30,23
1683298157484,MATH 20B,B02,188392,Ohm; Ko Woon,22,0,30,8
1683298158509,MATH 20C,A01,188394,Harel; Guershon,10,0,30,20
1683298158509,MATH 20C,A02,188395,Harel; Guershon,13,0,30,17
1683298158509,MATH 20C,B01,188404,Harel; Guershon,3,0,30,27
1683298158509,MATH 20C,B02,188405,Harel; Guershon,19,0,30,11
1683298159537,MATH 20D,A01,188414,Hammock; Frances H,0,1,30,30
1683298159537,MATH 20D,A02,188415,Hammock; Frances H,4,0,30,26
1683298159537,MATH 20D,B01,188447,Hammock; Frances H,2,0,30,28
1683298159537,MATH 20D,B02,188486,Hammock; Frances H,8,0,30,22
1683298160565,MATH 20E,A01,188649,Staff,22,0,30,8
1683298160565,MATH 20E,A02,188650,Staff,23,0,30,7
1683298160565,MATH 20E,A03,188673,Staff,0,0,30,30
1683298161592,MATH 102,A01,188675,Staff,0,35,35,35
1683298162625,MATH 103B,A01,188681,Staff,4,0,35,31
1683298162625,MATH 103B,B01,188692,Staff,7,0,35,28
1683298163649,MATH 109,A01,188695,Salehi Golsefidy; Alireza,25,0,35,10
1683298163649,MATH 109,A02,188696,Salehi Golsefidy; Alireza,27,0,35,8
1683298164677,MATH 120A,A01,188698,Eggers; John Dietrich,5,0,35,30
1683298165702,MATH 142B,A01,188736,Ioana; Adrian,0,2,30,30
1683298165702,MATH 142B,A02,188741,Ioana; Adrian,0,1,30,30
1683298165702,MATH 142B,A03,188743,Ioana; Adrian,0,3,30,30
1683298166730,MATH 168A,A01,188790,Staff,0,8,35,35
1683298167756,MATH 170A,A01,188803,Nie; Jiawang,0,2,35,35
1683298167756,MATH 170A,A02,188811,Nie; Jiawang,0,0,35,35
1683298167756,MATH 170A,A03,188814,Nie; Jiawang,1,0,35,34
1683298167756,MATH 170A,A04,188815,Nie; Jiawang,14,0,35,21
1683298168779,MATH 193B,A01,188817,Staff,0,0,35,35
1683298168779,MATH 193B,A02,188818,Staff,5,0,35,30
1683298169802,MGT 4,A01,202857,Anderson; John Charles,62,0,80,18
1683298170826,MGT 12,A00,202858,Lindenberger; Wade Douglas,43,0,90,47
1683298171849,MGT 18,A00,202859,Staff,74,0,90,16
1683298172875,MGT 18GS,A00,202860,McKay; Michael J,13,0,28,15
1683298173898,MGT 45,A00,202861,Pecore; Joseph P.,14,0,90,76
1683298174923,MGT 100,A00,202863,Yavorsky; Daniel Ryan,28,0,90,62
1683298175948,MGT 103,A00,202864,Ehrich; Kristine R,0,16,90,90
1683298176971,MGT 112,A00,202865,Ehrich; Kristine R,15,0,90,75
1683298177995,MGT 121A,A00,202868,Staff,0,19,0,0
1683298179020,MGT 131B,A00,202869,Anderson; John Charles,59,0,90,31
1683298180043,MGT 136,A00,202871,Lindenberger; Wade Douglas,84,0,90,6
1683298181068,MGT 164,A00,202873,Staff,0,69,90,90
1683298182092,MGT 164GS,A00,202874,McKay; Mary A,13,0,28,15
1683298183116,MGT 180,A00,202875,Staff,0,51,90,90
1683298184141,MMW 11R,A01,205019,Herbst; Matthew,3,0,30,27
1683298184141,MMW 11R,A02,205026,Herbst; Matthew,29,0,30,1
1683298185166,MMW 15,A01,193512,Chang; Edmond Yi-Teh,0,9,28,28
1683298185166,MMW 15,A02,193513,Chang; Edmond Yi-Teh,0,5,28,28
1683298185166,MMW 15,A03,193514,Chang; Edmond Yi-Teh,0,5,28,28
1683298185166,MMW 15,A04,193515,Chang; Edmond Yi-Teh,0,4,28,28
1683298185166,MMW 15,A05,193516,Chang; Edmond Yi-Teh,0,4,28,28
1683298185166,MMW 15,A06,193517,Chang; Edmond Yi-Teh,0,5,28,28
1683298185166,MMW 15,B01,193519,Chang; Edmond Yi-Teh,0,4,28,28
1683298185166,MMW 15,B02,193520,Chang; Edmond Yi-Teh,0,5,28,28
1683298185166,MMW 15,B03,193521,Chang; Edmond Yi-Teh,0,4,28,28
1683298185166,MMW 15,B04,193522,Chang; Edmond Yi-Teh,0,4,28,28
1683298185166,MMW 15,B05,193523,Chang; Edmond Yi-Teh,0,5,28,28
1683298185166,MMW 15,B06,193524,Chang; Edmond Yi-Teh,0,4,28,28
1683298186193,MMW 122,A01,193526,Rahimi; Babak,0,14,28,28
1683298186193,MMW 122,A02,193527,Rahimi; Babak,0,14,28,28
1683298186193,MMW 122,A03,193528,Rahimi; Babak,0,0,0,0
1683298186193,MMW 122,A04,193529,Rahimi; Babak,0,0,0,0
1683298187218,MUS 1A,A01,186663,Staff,0,20,35,35
1683298188243,MUS 4,A01,186715,Staff,0,12,35,35
1683298189288,MUS 5R,A01,186796,Dubnov; Shlomo,0,16,35,35
1683298190316,MUS 6,A01,186798,Staff,0,3,25,25
1683298191343,MUS 7,A01,186830,Staff,12,0,35,23
1683298192368,MUS 8,A01,186930,Staff,0,25,35,35
1683298193397,MUS 15,A01,186932,Staff,0,15,35,35
1683298193397,MUS 15,B01,186934,Staff,0,14,35,35
1683298194422,MUS 80,A00,186935,Staff,2,0,20,18
1683298194422,MUS 80,B00,186936,Staff,25,0,25,0
1683298195449,NANO 11,A00,204702,Lipomi; Darren John,0,0,0,0
1683298196476,NANO 15,A01,204709,Yang; Kesong,0,1,0,0
1683298197501,NANO 114,A00,202069,Jahed Motlagh; Zeinab,3,0,10,7
1683298198526,PHIL 1,A00,186955,Grush; Rick Scott,32,0,40,8
1683298199549,PHIL 10,A01,186973,Grush; Rick Scott,29,0,35,6
1683298199549,PHIL 10,A02,186974,Grush; Rick Scott,33,0,35,2
1683298200575,PHIL 13,A01,186976,Staff,7,0,35,28
1683298200575,PHIL 13,A02,186977,Staff,16,0,35,19
1683298201605,PHIL 14,A01,186979,Staff,31,0,35,4
1683298201605,PHIL 14,A02,186986,Staff,32,0,35,3
1683298202632,PHIL 28,A01,186988,Staff,16,0,30,14
1683298202632,PHIL 28,A02,186989,Staff,1,0,30,29
1683298202632,PHIL 28,A03,186990,Staff,9,0,30,21
1683298202632,PHIL 28,A04,186991,Staff,26,0,30,4
1683298203658,PHIL 120,A00,186997,Staff,23,0,40,17
1683298204682,PHIL 137,A00,187003,Staff,9,0,40,31
1683298205705,PHIL 150,A00,187015,Staff,47,0,70,23
1683298206733,PHIL 167,A00,187021,Lamey; Andy M.,35,0,40,5
1683298207759,PHIL 174,A01,202226,Staff,17,0,20,3
1683298207759,PHIL 174,A02,202235,Staff,20,0,20,0
1683298208788,PHIL 191A,A00,258918,Staff,0,0,1,1
1683298209814,PHYS 1A,A00,187028,Staff,26,0,60,34
1683298210842,PHYS 1AL,001,187036,Staff,2,0,30,28
1683298210842,PHYS 1AL,002,187049,Staff,18,0,30,12
1683298211925,PHYS 1B,A00,187058,Staff,23,0,60,37
1683298212954,PHYS 1BL,001,187064,Staff,0,0,30,30
1683298212954,PHYS 1BL,002,187070,Staff,6,0,30,24
1683298213980,PHYS 1C,A00,187082,Staff,32,0,120,88
1683298215008,PHYS 1CL,001,187088,Staff,0,9,30,30
1683298215008,PHYS 1CL,002,187089,Staff,0,2,30,30
1683298215008,PHYS 1CL,009,262693,Staff,12,0,30,18
1683298216037,PHYS 2B,A01,187097,Staff,54,0,115,61
1683298217063,PHYS 2C,A01,187099,Staff,67,0,115,48
1683298218090,PHYS 2CL,A01,187101,Staff,5,0,28,23
1683298218090,PHYS 2CL,A02,187102,Staff,15,0,28,13
1683298219114,PHYS 2D,A01,187123,Shotwell; Brian,95,0,115,20
1683298220139,PHYS 4B,A01,187133,Grinstein; Benjamin,35,0,50,15
1683298221163,POLI 10,A00,188819,Staff,0,3,50,50
1683298222187,POLI 11,A00,188827,Staff,43,0,50,7
1683298223210,POLI 13R,A00,188828,Staff,0,1,20,20
1683298224240,POLI 27,A01,188830,Elgin; Samuel Zincke,0,1,70,70
1683298225264,POLI 30,A00,188832,Desposato; Scott,33,0,50,17
1683298226287,POLI 102F,A00,188834,Staff,3,0,40,37
1683298227311,POLI 104A,A00,188852,Staff,14,0,30,16
1683298228333,POLI 104I,A00,188853,Staff,0,6,20,20
1683298229357,POLI 110B,A00,188854,Wiens; David,7,0,20,13
1683298230381,POLI 112A,A00,188855,Wiens; David,5,0,30,25
1683298231404,POLI 117R,A00,188856,Forman; Fonna,0,11,20,20
1683298232428,POLI 118,A00,188857,Ingham; Sean,8,0,20,12
1683298233454,POLI 120G,A00,188858,Staff,9,0,30,21
1683298234480,POLI 131CR,A00,188863,Hoston; Germaine,24,0,50,26
1683298235504,POLI 133,A00,188864,Nellis; Gareth Hb,44,0,50,6
1683298236528,POLI 134D,A00,188865,Desposato; Scott,27,0,30,3
1683298237555,POLI 142A,A00,188871,Gartzke; Erik,22,0,50,28
1683298238580,POLI 142K,A00,188874,Staff,38,0,50,12
1683298239606,POLI 143,A00,188940,Gartzke; Erik,16,0,30,14
1683298240632,POLI 153,A00,188943,Staff,3,0,20,17
1683298241656,POLI 160AA,A00,188944,Staff,13,0,40,27
1683298242683,POLI 170A,A00,188945,Staff,11,0,30,19
1683298244738,PSYC 1,A00,188952,Staff,38,0,90,52
1683298245765,PSYC 2,B00,188953,Staff,20,0,35,15
1683298246790,PSYC 6,A00,188970,Staff,47,0,60,13
1683298247817,PSYC 7,A00,188973,Staff,37,0,45,8
1683298248841,PSYC 60,A01,188980,Rickard; Timothy C.,43,0,60,17
1683298249870,PSYC 70,A01,189001,Steiner; Eric Tomas,24,0,45,21
1683298250894,PSYC 100,A00,189005,Lacefield; Katharine I,0,99,120,120
1683298251921,PSYC 102,A00,189008,Staff,10,0,30,20
1683298252946,PSYC 106,B00,189026,Gorman; Michael R.,37,0,60,23
1683298253974,PSYC 114,B01,189033,Winkielman; Piotr,0,32,30,30
1683298254998,PSYC 131,A00,189036,Anagnostaras; Stephan,0,43,60,60
1683298256022,PSYC 136,A00,189041,Lowe; Angela Beth,0,7,25,25
1683298257046,PSYC 137,A00,189057,Winkielman; Piotr,0,34,25,25
1683298258073,PSYC 144,A00,189107,Wixted; John T,0,7,50,50
1683298260127,PSYC 162,A00,189142,Staff,0,8,85,85
1683298261154,PSYC 172,A00,189144,Gorman; Michael R.,0,7,30,30
1683298263202,PSYC 179,A00,189146,Lacefield; Katharine I,0,84,120,120
1683298264228,PSYC 181,A00,189147,Anagnostaras; Stephan,0,44,90,90
1683298265255,PSYC 190R,A00,189148,Barner; David A.,0,22,80,80
1683298266278,PSYC 191,A00,189275,Rickard; Timothy C.,0,7,25,25
1683298267305,PSYC 193,A00,189276,Chapman; Eddie Nathaniel,0,1,0,4
1683298268334,PSYC 193L,A01,189281,Lowe; Angela Beth,12,0,20,8
1683298268334,PSYC 193L,B01,189285,Staff,28,0,35,7
1683298269360,RELI 149,A00,187137,Rahimi; Babak,7,0,40,33
1683298270384,SE 9,A01,187315,Staff,0,2,18,18
1683298271413,SE 101B,A00,187409,Staff,24,0,30,6
1683298272438,SE 110B,A00,187444,Staff,10,0,40,30
1683298273460,SE 130B,A00,187449,Staff,31,0,40,9
1683298274484,SE 150A,A00,187516,Staff,9,0,20,11
1683298275510,SE 154,A00,187528,Staff,30,0,50,20
1683298276536,SIO 3,A01,258171,Staff,35,0,40,5
1683298277563,SIO 10,A00,187144,Cook; Geoffrey W,0,3,75,75
1683298278588,SIO 45,A00,187152,Cook; Geoffrey W,1,0,100,99
1683298279615,SIO 109R,A00,194486,Staff,0,3,20,20
1683298281673,SIO 187,A01,187233,Kacev; David,12,0,40,28
1683298282697,SOCI 1,A01,258656,Thorpe; Charles Robert,28,0,30,2
1683298282697,SOCI 1,A02,258658,Thorpe; Charles Robert,30,0,30,0
1683298282697,SOCI 1,A03,258661,Thorpe; Charles Robert,25,0,25,0
1683298282697,SOCI 1,A04,258666,Thorpe; Charles Robert,22,0,25,3
1683298282697,SOCI 1,A05,258897,Thorpe; Charles Robert,23,0,25,2
1683298282697,SOCI 1,A06,258898,Thorpe; Charles Robert,25,0,25,0
1683298283724,SOCI 30,A01,258903,Pardo Guerra; Juan Pablo,16,0,30,14
1683298284751,SOCI 102,A00,258904,Staff,9,0,25,16
1683298285777,SOCI 106,A00,258905,Staff,19,0,25,6
1683298286804,SOCI 111,A00,258907,Ribas Norris; Janet Vanesa,26,0,30,4
1683298287828,SOCI 121R,A00,258908,Pardo Guerra; Juan Pablo,11,0,30,19
1683298288852,SOCI 126,A01,203330,Staff,14,0,20,6
1683298289874,SOCI 131,A00,258909,Thorpe; Charles Robert,31,0,60,29
1683298290897,SOCI 135,A00,258910,Payne; Christine Anna,0,9,30,30
1683298291924,SOCI 157,A00,258911,Staff,13,0,30,17
1683298292954,SOCI 184,A00,258912,Staff,26,0,30,4
1683298293980,SOCI 188D,A00,258913,Staff,21,0,30,9
1683298295004,SYN 2,001,187529,Staff,9,0,16,7
1683298295004,SYN 2,002,201452,Staff,0,18,16,16
1683298295004,SYN 2,003,201469,Staff,3,0,16,13
1683298296028,SYN 100,A01,187531,Staff,0,9,20,20
1683298296028,SYN 100,B01,201491,Staff,0,12,20,20
1683298297055,TDAC 1,A00,189286,Walsh; Kim C.,3,0,20,17
1683298297055,TDAC 1,B00,189287,Harting; Carla Kelso,11,0,20,9
1683298298080,TDAC 101,A00,189300,Walsh; Kim C.,16,0,20,4
1683298298080,TDAC 101,B00,189301,Harting; Carla Kelso,18,0,20,2
1683298299105,TDAC 102,A00,189304,Basso; Beatrice,14,0,20,6
1683298300130,TDAC 108,A00,189305,Staff,18,0,20,2
1683298301155,TDDE 131,A00,189310,Staff,19,0,20,1
1683298301155,TDDE 131,B00,189314,Staff,19,0,20,1
1683298301155,TDDE 131,C00,189315,Staff,48,0,50,2
1683298301155,TDDE 131,D00,189316,Staff,14,0,15,1
1683298301155,TDDE 131,E00,204841,Staff,20,0,20,0
1683298302179,TDGE 10,A00,189289,Staff,30,0,50,20
1683298302179,TDGE 10,B00,189290,Havis; Allan,2,0,50,48
1683298303203,TDGE 11,A00,189291,Fulton; Julia,0,3,50,50
1683298303203,TDGE 11,B00,189292,Staff,20,0,25,5
1683298303203,TDGE 11,C00,260270,Staff,0,0,0,0
1683298304230,TDGE 25,A00,189294,Staff,3,0,20,17
1683298305253,TDGE 124,A00,189318,Fulton; Julia,0,8,50,50
1683298306276,TDGE 125,A00,189319,Staff,13,0,25,12
1683298306276,TDGE 125,B00,189320,Staff,23,0,25,2
1683298307305,TDGE 127,A00,189322,Havis; Allan,0,0,50,50
1683298308328,TDHT 101,A00,189323,Staff,18,0,25,7
1683298308328,TDHT 101,B00,189324,Staff,25,0,25,0
1683298309352,TDHT 102,A00,189325,Staff,49,0,50,1
1683298310377,TDMV 1,A00,189295,Arcidiacono; Kristin,20,0,30,10
1683298310377,TDMV 1,B00,189296,Caligagan; Maria T.,24,0,30,6
1683298311402,TDMV 2,A00,189297,Sammartano; Tonnie,28,0,30,2
1683298311402,TDMV 2,B00,189299,Arcidiacono; Kristin,24,0,30,6
1683298312426,TDMV 3,A00,204998,Rincon; Alicia,22,0,30,8
1683298313453,TDMV 120,A00,189458,Sammartano; Tonnie,28,0,30,2
1683298314477,TDMV 138,A00,189541,Jun; Grace Shin Hae,22,0,40,18
1683298315560,TDMV 142,A00,189717,Caligagan; Tony,23,0,30,7
1683298315560,TDMV 142,B00,189718,Caligagan; Maria T.,25,0,30,5
1683298316589,TMC 2,A01,187533,Staff,25,0,25,0
1683298316589,TMC 2,A02,187534,Staff,25,0,25,0
1683298317615,USP 1,A01,187536,Kwak; Nancy,0,16,25,25
1683298318640,USP 5,A01,187538,Staff,9,0,25,16
1683298319668,USP 101,A00,199253,Staff,0,4,0,0
1683298320692,USP 124,A00,187562,Boomhower; Matthew Charles,1,0,30,29
1683298321716,USP 138,A00,187582,Staff,20,0,25,5
1683298322747,USP 152,A01,187597,Staff,4,0,25,21
1683298323771,USP 153,A00,187598,Staff,19,0,25,6
1683298324796,USP 168,A00,187607,Kwak; Nancy,2,0,5,3
1683298325821,USP 173,A00,187619,Staff,4,0,25,21
1683298326848,USP 181,A00,187638,Staff,0,0,25,25
1683298327871,VIS 103,A00,187650,Cruz; Edwin Teddy,23,0,75,52
1683298328896,VIS 110D,A00,187669,Staff,12,0,22,10
1683298329922,VIS 127C,A00,187720,Shen; Kuiyi,68,0,146,78
1683298330949,VIS 149,A00,187731,Yoldas; Pinar,0,14,22,22
1683298331974,VIS 151,A01,188091,Staff,22,0,34,12
1683298331974,VIS 151,A02,188092,Staff,11,0,34,23
1683298332997,VIS 160B,A00,188093,Stalbaum; Brett,0,0,10,10
1683298335048,WCWP 10B,A00,201720,Staff,10,0,15,5
1683298335048,WCWP 10B,B00,201722,Staff,8,0,15,7
1683298336071,WCWP 100,A00,201725,Gagnon; Jeffrey C,0,0,2,2
1683298336071,WCWP 100,B00,201727,Staff,0,4,15,15
1683298339199,ANBI 133,A00,258401,Wilder; Linnea Lorene,34,0,40,6
1683298340223,ANBI 140,A00,258395,Hrvoj Mihic; Branka,18,0,25,7
1683298341250,ANSC 120,A00,258402,Bialecki; Jon Anthony,27,0,40,13
1683298342274,ANSC 144,A00,258400,Staff,14,0,40,26
1683298344326,ANSC 166,A00,258396,Parish; Steven Martin,157,0,175,18
1683298345350,ANSC 180,A00,193533,Staff,9,0,20,11
1683298346378,ANSC 188,A00,258397,Jassal; Aftab,33,0,40,7
1683298347401,ANTH 3,A01,258316,Staff,23,0,30,7
1683298348427,ANTH 5,A00,258394,Semendeferi; Ekaterini,16,0,20,4
1683298349453,ANTH 21,A01,258331,Staff,9,0,40,31
1683298350480,ANTH 103,A00,258398,Varma; Saiba,15,0,25,10
1683298351507,AWP 10,001,202034,Staff,0,0,0,0
1683298351507,AWP 10,002,202035,Staff,0,0,0,0
1683298351507,AWP 10,003,202036,Staff,0,0,0,0
1683298351507,AWP 10,004,202037,Staff,0,0,0,0
1683298351507,AWP 10,005,202038,Staff,0,0,0,0
1683298351507,AWP 10,006,202039,Staff,0,0,0,0
1683298351507,AWP 10,007,202040,Staff,0,0,0,0
1683298351507,AWP 10,008,202041,Staff,0,0,0,0
1683298351507,AWP 10,009,202042,Staff,0,0,0,0
1683298351507,AWP 10,010,202043,Staff,0,0,0,0
1683298351507,AWP 10,011,202044,Staff,0,0,0,0
1683298351507,AWP 10,012,202045,Staff,0,0,0,0
1683298351507,AWP 10,013,202046,Staff,0,0,0,0
1683298351507,AWP 10,014,202047,Staff,0,0,0,0
1683298351507,AWP 10,015,202048,Staff,0,0,0,0
1683298351507,AWP 10,016,202049,Staff,0,0,0,0
1683298351507,AWP 10,017,202050,Staff,0,0,0,0
1683298351507,AWP 10,018,202051,Staff,0,0,0,0
1683298351507,AWP 10,019,202052,Staff,0,0,0,0
1683298351507,AWP 10,020,202053,Staff,0,0,0,0
1683298351507,AWP 10,021,202054,Staff,0,0,0,0
1683298351507,AWP 10,022,202055,Staff,0,0,0,0
1683298351507,AWP 10,023,202056,Staff,0,0,0,0
1683298351507,AWP 10,024,202057,Staff,0,0,0,0
1683298351507,AWP 10,025,202058,Staff,0,0,0,0
1683298351507,AWP 10,026,202059,Staff,0,0,0,0
1683298352531,AWP 102,001,202032,Staff,0,0,0,0
1683298352531,AWP 102,002,202033,Staff,0,0,0,0
1683298353555,BENG 100,A01,254234,Taylor Amos; Alyssa C,31,0,40,9
1683298354581,BENG 196,001,270013,Engler; Adam J.,9999,0,9999,0
1683298355606,BICD 100R,A01,202018,Smith; Laurie,0,7,32,32
1683298355606,BICD 100R,A02,202019,Smith; Laurie,0,2,32,32
1683298355606,BICD 100R,A03,202020,Smith; Laurie,0,1,32,32
1683298355606,BICD 100R,A04,202021,Smith; Laurie,8,0,32,24
1683298355606,BICD 100R,A05,202022,Smith; Laurie,12,0,32,20
1683298356635,BICD 136,A01,193242,Gustafson-Brown; Cindy,0,2,32,32
1683298356635,BICD 136,A02,193244,Gustafson-Brown; Cindy,15,0,32,17
1683298357660,BIEB 102,A01,193249,Butler; Shannon Rhey,0,2,32,32
1683298357660,BIEB 102,A02,193251,Butler; Shannon Rhey,0,0,32,32
1683298357660,BIEB 102,A03,193253,Butler; Shannon Rhey,0,1,32,32
1683298357660,BIEB 102,A04,193255,Butler; Shannon Rhey,17,0,32,15
1683298357660,BIEB 102,A05,193265,Butler; Shannon Rhey,26,0,32,6
1683298357660,BIEB 102,A06,193269,Butler; Shannon Rhey,16,0,32,16
1683298359709,BIEB 150,A01,193274,Staff,0,0,32,32
1683298359709,BIEB 150,A02,193285,Staff,24,0,32,8
1683298360734,BIEB 194,A00,193286,Kurle; Carolyn M.,22,0,32,10
1683298361760,BILD 1,A01,192291,Staff,16,0,32,16
1683298361760,BILD 1,A02,192292,Staff,30,0,32,2
1683298361760,BILD 1,B01,192520,Reuther; Keefe,0,1,0,0
1683298361760,BILD 1,B02,192532,Reuther; Keefe,0,1,0,0
1683298362791,BILD 3,A01,192556,Butler; Shannon Rhey,0,0,32,32
1683298362791,BILD 3,A02,192581,Butler; Shannon Rhey,5,0,32,27
1683298362791,BILD 3,A03,192611,Butler; Shannon Rhey,23,0,32,9
1683298362791,BILD 3,A04,192612,Butler; Shannon Rhey,25,0,32,7
1683298362791,BILD 3,A05,192613,Butler; Shannon Rhey,27,0,32,5
1683298362791,BILD 3,A06,192679,Butler; Shannon Rhey,27,0,32,5
1683298362791,BILD 3,A07,192682,Butler; Shannon Rhey,22,0,32,10
1683298363821,BILD 4,A01,192836,Reuther; Keefe,1,0,24,23
1683298363821,BILD 4,A02,193044,Reuther; Keefe,4,0,24,20
1683298364849,BILD 10,A01,193142,Gustafson-Brown; Cindy,31,0,32,1
1683298364849,BILD 10,A02,193149,Gustafson-Brown; Cindy,31,0,32,1
1683298365877,BIMM 100,A01,193301,Staff,0,6,32,32
1683298365877,BIMM 100,A02,193312,Staff,0,5,32,32
1683298365877,BIMM 100,A03,193323,Staff,0,8,32,32
1683298366907,BIMM 101,A01,193329,McDonnell; Lisa Marie,0,3,24,24
1683298366907,BIMM 101,A02,193339,McDonnell; Lisa Marie,0,2,24,24
1683298366907,BIMM 101,B01,193354,McDonnell; Lisa Marie,0,3,24,24
1683298366907,BIMM 101,B02,193357,McDonnell; Lisa Marie,0,3,24,24
1683298367931,BIMM 110,A01,193377,Tat; John,0,11,32,32
1683298367931,BIMM 110,A02,193378,Tat; John,1,9,32,31
1683298368958,BIMM 120,A01,206116,Staff,0,0,32,32
1683298368958,BIMM 120,A02,206117,Staff,8,0,32,24
1683298368958,BIMM 120,A03,206121,Staff,21,0,32,11
1683298369986,BIPN 100,A01,193393,Park; Ji Young,0,14,32,32
1683298369986,BIPN 100,A02,193402,Park; Ji Young,0,12,32,32
1683298369986,BIPN 100,A03,193413,Park; Ji Young,0,14,32,32
1683298369986,BIPN 100,A04,193414,Park; Ji Young,0,13,32,32
1683298371013,BIPN 102,A01,193429,Staff,0,0,32,32
1683298371013,BIPN 102,A02,193438,Staff,23,0,32,9
1683298372040,BIPN 106,A01,193450,Reyes Gonzalez; Catalina,0,2,40,40
1683298373066,BIPN 134,A01,193465,Cooke; James Edward,0,0,32,32
1683298373066,BIPN 134,A02,193474,Cooke; James Edward,27,0,32,5
1683298373066,BIPN 134,A03,193485,Cooke; James Edward,29,0,32,3
1683298373066,BIPN 134,A04,193486,Cooke; James Edward,21,0,32,11
1683298373066,BIPN 134,A05,193491,Cooke; James Edward,31,0,32,1
1683298373066,BIPN 134,A06,193501,Cooke; James Edward,30,0,32,2
1683298373066,BIPN 134,A07,193510,Cooke; James Edward,29,0,32,3
1683298375119,BISP 194,A00,222522,Staff,16,0,32,16
1683298376145,CAT 124,A01,202407,Staff,20,0,25,5
1683298377172,CAT 125,A00,202408,Marchisotto; Jennifer Anne,4,0,20,16
1683298378199,CAT 125R,A00,202409,Smith; Lauryn Alissa,0,11,20,20
1683298378199,CAT 125R,B00,202410,Morales; Celeste Georgianna,0,11,20,20
1683298378199,CAT 125R,C00,202411,Irwin; Matthew Joseph,0,10,20,20
1683298379229,CENG 15,A01,204712,Yang; Kesong,0,1,0,0
1683298380256,CENG 114,A00,202070,Jahed Motlagh; Zeinab,5,0,20,15
1683298381286,CGS 105,A00,185477,Wesling; Megan E.,24,0,40,16
1683298382310,CGS 106,A00,185494,Staff,13,0,22,9
1683298383336,CGS 108,A00,185495,Staff,14,0,20,6
1683298384364,CGS 114,A00,185496,Staff,13,0,18,5
1683298385389,CGS 119,A00,185501,Staff,15,0,20,5
1683298386422,CGS 120,A00,185511,Staff,13,0,20,7
1683298387449,CHEM 4,A01,184675,Bussey; Thomas J,96,0,100,4
1683298388476,CHEM 6A,A01,184677,Staff,35,0,60,25
1683298389500,CHEM 6B,A01,184679,Staff,65,0,100,35
1683298390529,CHEM 6C,A01,184681,Bussey; Thomas J,1,0,50,49
1683298390529,CHEM 6C,A02,184682,Bussey; Thomas J,34,0,50,16
1683298391556,CHEM 40A,A01,184684,Albizati; Kim F.,37,0,100,63
1683298392584,CHEM 40B,A01,184686,Albizati; Kim F.,0,20,100,100
1683298393612,CHEM 41B,A01,184690,Staff,52,0,100,48
1683298394639,COGS 3,A01,184715,Boyle; Mary E. T.,0,25,40,40
1683298395663,COGS 14B,A01,185172,Staff,0,15,38,38
1683298396690,COGS 18,A01,184736,Staff,20,0,80,60
1683298397714,COGS 100,A01,184932,Staff,0,5,73,73
1683298398741,COGS 101A,A01,184935,Staff,0,38,30,30
1683298399765,COGS 101B,A01,184944,Staff,0,2,30,30
1683298400789,COGS 101C,A01,184946,Staff,0,12,30,30
1683298401815,COGS 102A,A01,184951,Johnson; Christine M.,2,0,40,38
1683298402843,COGS 107B,A01,184953,Mooshagian; Eric Frederick,0,50,40,40
1683298403870,COGS 118B,A01,184959,Gupta; Anjum,0,48,40,40
1683298404896,COGS 153,A00,184961,Staff,0,15,30,30
1683298405921,COGS 177,A00,184962,Staff,0,21,30,30
1683298406946,COGS 187A,A01,184969,Boyle; Mary E. T.,0,17,40,40
1683298407974,COMM 10,A01,185174,Staff,0,5,25,25
1683298407974,COMM 10,A02,185189,Staff,0,5,25,25
1683298407974,COMM 10,A03,269821,Staff,0,0,0,0
1683298408999,COMM 100B,A01,185475,Staff,0,0,0,2
1683298408999,COMM 100B,A02,185476,Staff,14,0,25,11
1683298410028,COMM 100C,A01,185314,Staff,1,0,25,24
1683298410028,COMM 100C,A02,185327,Staff,19,0,25,6
1683298411051,COMM 110M,A00,185349,Staff,2,0,40,38
1683298412075,COMM 113T,A00,185352,Staff,25,0,40,15
1683298413098,COMM 114I,A00,185353,Staff,33,0,40,7
1683298414123,COMM 131,A00,185354,Staff,19,0,30,11
1683298415150,CSE 8A,A50,185358,Cao; Yingjun,0,46,10,10
1683298416175,CSE 8B,A01,185362,Staff,1,47,50,49
1683298417202,CSE 11,A01,185416,Cao; Yingjun,0,93,10,10
1683298418236,CSE 20,A01,185445,Briones; Jor-el Thomas Caparas,5,0,25,20
1683298419336,CSE 21,A01,185447,Staff,10,0,50,40
1683298420366,CSE 101,A01,185451,Staff,0,12,50,50
1683298420366,CSE 101,B01,185453,Jones; Miles E,0,11,50,50
1683298422413,CSE 141,A01,185458,Eldon; John,20,0,100,80
1683298423437,CSE 141L,A01,185461,Eldon; John,12,0,100,88
1683298424462,CSE 142,A01,185463,Staff,35,0,60,25
1683298424462,CSE 142,B01,201355,Staff,0,6,60,60
1683298425489,CSE 142L,A01,185470,Staff,35,0,60,25
1683298425489,CSE 142L,B01,201417,Staff,0,5,60,60
1683298426518,CSE 190,A00,201433,Staff,32,0,49,17
1683298427543,DOC 1,A01,259136,Strom; Megan C.,8,0,15,7
1683298427543,DOC 1,A02,259137,Strom; Megan C.,14,0,15,1
1683298427543,DOC 1,A03,259138,Strom; Megan C.,14,0,15,1
1683298427543,DOC 1,A04,259139,Strom; Megan C.,14,0,15,1
1683298428568,DOC 100D,A00,259140,Pass; Natalye Joann,17,0,25,8
1683298429591,DSGN 1,A01,184749,Rill; Bryan,0,24,30,30
1683298430621,DSGN 100,A01,185168,Staff,0,2,25,25
1683298431649,ECE 5,A01,185626,Morris; Karcher William,0,10,0,0
1683298432674,ECE 101,A01,185628,Staff,17,0,70,53
1683298433702,ECE 107,A01,185635,Baghdadchi; Saharnaz,0,0,20,20
1683298433702,ECE 107,A02,185638,Baghdadchi; Saharnaz,4,0,20,16
1683298434729,ECE 148,A01,185647,Silberman; Jack,1,0,16,15
1683298435758,ECON 1,A01,185537,Crane; Meredith Helen,54,0,70,16
1683298436785,ECON 3,A01,185549,Crane; Meredith Helen,33,0,70,37
1683298437814,ECON 4,A01,203354,Anderson; John Charles,0,4,10,10
1683298438837,ECON 100A,A01,185574,Staff,0,4,40,40
1683298439861,ECON 100B,A01,185576,Staff,0,22,40,40
1683298440887,ECON 100C,A01,185589,Newhouse; Herbert S,30,0,70,40
1683298441911,ECON 105,A00,185608,Vespa; Emanuel Ignacio,19,0,35,16
1683298442939,ECON 109,A01,185610,Shishkin; Denis,10,0,35,25
1683298443967,ECON 110A,A01,185612,Staff,11,0,40,29
1683298444995,ECON 120A,A01,185615,Staff,20,0,40,20
1683298446019,ECON 120C,A01,185617,Sun; Yixiao,0,20,70,70
1683298447042,ECON 144,A00,203346,Squires; Dale E,3,0,35,32
1683298448069,ECON 171,A01,203349,Newhouse; Herbert S,0,1,35,35
1683298449097,ECON 173A,A01,185621,Toda; Alexis Akira,21,0,35,14
1683298450123,EDS 25,A01,202413,Staff,0,1,0,0
1683298450123,EDS 25,A02,202414,Staff,0,1,0,0
1683298450123,EDS 25,A03,202415,Staff,0,0,0,0
1683298450123,EDS 25,A04,202416,Staff,0,1,0,0
1683298450123,EDS 25,A05,202439,Staff,0,0,0,0
1683298450123,EDS 25,A06,202440,Staff,0,0,0,0
1683298450123,EDS 25,B01,202631,Staff,0,0,0,0
1683298450123,EDS 25,B02,202632,Staff,0,0,0,0
1683298450123,EDS 25,B03,202639,Staff,0,0,0,0
1683298450123,EDS 25,B04,202640,Staff,0,0,0,0
1683298450123,EDS 25,B05,202643,Staff,0,0,0,0
1683298450123,EDS 25,B06,202644,Staff,0,0,0,0
1683298451147,EDS 38,A01,202659,Black; Alison Michelle,24,0,25,1
1683298452172,EDS 115,A00,202652,Staff,17,0,30,13
1683298453196,EDS 125,A00,202649,Staff,14,0,30,16
1683298454224,EDS 126,A01,203332,Staff,30,0,30,0
1683298455249,EDS 139,A00,202838,Staff,17,0,25,8
1683298456277,EDS 146,A01,202655,Staff,15,0,25,10
1683298457300,ENG 15,A00,185667,Staff,0,1,0,0
1683298457300,ENG 15,B00,185672,Staff,0,0,0,0
1683298457300,ENG 15,C00,185675,Staff,0,0,0,0
1683298457300,ENG 15,D00,185682,Staff,0,0,0,0
1683298457300,ENG 15,E00,185684,Staff,0,0,0,0
1683298458324,ETHN 103,A00,185710,Staff,0,3,35,35
1683298459360,ETHN 103A,A00,199228,Man; Simeon S,3,0,9,6
1683298460384,ETHN 109,A00,185711,Staff,18,0,35,17
1683298461410,ETHN 142,A00,185726,Staff,0,4,30,30
1683298462438,ETHN 163J,A00,199229,Man; Simeon S,6,0,8,2
1683298463465,ETHN 168,A00,185727,Staff,8,0,10,2
1683298464488,ETHN 182,A00,185728,Staff,1,0,35,34
1683298465513,ETHN 183,A00,185737,Staff,8,0,18,10
1683298466537,GLBH 111,A01,209361,Burgos; Jose L.,0,0,0,0
1683298468588,HIEU 104,A00,185792,Staff,16,0,20,4
1683298469612,HIEU 115,A00,185800,Staff,1,0,20,19
1683298470637,HIEU 128,A00,185801,Staff,0,7,20,20
1683298471661,HIEU 147,A00,185802,Staff,16,0,20,4
1683298472688,HIEU 154,A00,185823,Staff,12,0,20,8
1683298473714,HILA 102,A00,185826,Staff,13,0,20,7
1683298474739,HILD 2C,A01,185778,Staff,0,12,20,20
1683298475763,HILD 7B,A01,185780,Kwak; Nancy,0,15,32,32
1683298475763,HILD 7B,A02,185781,Kwak; Nancy,0,18,32,32
1683298476788,HILD 30,A01,185791,Staff,14,0,20,6
1683298477815,HISC 119,A00,185830,Golan; Tal,0,9,20,20
1683298478840,HITO 156GS,A00,185831,Patterson; Patrick H.,0,0,0,23
1683298479864,HIUS 103,A00,185832,Man; Simeon S,0,7,20,20
1683298480888,HIUS 117,A00,185836,Kwak; Nancy,2,0,20,18
1683298481912,HIUS 125,A00,185840,Man; Simeon S,0,0,23,23
1683298482936,HIUS 149,A00,185845,Staff,0,0,20,20
1683298483961,HUM 3,A01,185882,Zavodny; Tatiana Sophia,0,6,50,50
1683298483961,HUM 3,B01,185899,Caldwell; Michael Alan,0,19,50,50
1683298484984,HUM 3GS,A00,185900,Patterson; Patrick H.,0,0,0,23
1683298486009,HUM 4,A01,185938,Zroka; Amy Liane,31,0,50,19
1683298486009,HUM 4,B01,185956,Watkins; Eric,0,2,50,50
1683298486009,HUM 4,B02,202209,Watkins; Eric,0,1,50,50
1683298486009,HUM 4,B03,202210,Watkins; Eric,0,0,50,50
1683298487033,HUM 5,A01,185958,West; Geoffrey Scott,5,0,50,45
1683298487033,HUM 5,A02,202215,West; Geoffrey Scott,0,0,50,50
1683298488058,INTL 190,A00,185959,Gagnon; Jeffrey C,0,0,0,9
1683298488058,INTL 190,B00,185960,Lettieri; Michael Joseph,0,0,0,1
1683298489084,JAPN 180,A00,254509,Staff,0,1,25,25
1683298490109,LATI 10,A01,202853,Kennemore; Amy Michelle,5,0,35,30
1683298490109,LATI 10,A02,202854,Kennemore; Amy Michelle,1,0,35,34
1683298490109,LATI 10,A03,270054,Kennemore; Amy Michelle,30,0,30,0
1683298491133,LATI 180,A00,202855,Kennemore; Amy Michelle,11,0,20,9
1683298492157,LAWS 101,A00,201767,Golan; Tal,0,7,40,40
1683298493184,LIFR 1C,A00,185961,Staff,6,0,20,14
1683298494210,LIFR 1CX,A00,185962,Staff,7,0,20,13
1683298495235,LIFR 1D,A00,185963,Staff,9,0,20,11
1683298496262,LIFR 1DX,A00,185964,Staff,9,0,20,11
1683298497287,LIGN 101,A01,186039,Staff,43,0,50,7
1683298498310,LIGN 165,A00,186040,Staff,18,0,50,32
1683298499337,LTCS 108,A00,186041,Staff,6,0,10,4
1683298500363,LTCS 119,A00,186042,Staff,16,0,20,4
1683298501395,LTCS 130,A00,186043,Wesling; Megan E.,15,0,25,10
1683298503444,LTEA 138,A00,186119,Staff,14,0,40,26
1683298504469,LTEN 124,A00,186148,Staff,6,0,25,19
1683298505493,LTEN 178,A00,186149,Staff,7,0,15,8
1683298506518,LTEN 181,A00,186150,Blanco; John D,33,0,40,7
1683298507543,LTWL 120,A00,186160,Staff,20,0,25,5
1683298508569,LTWL 165,A00,186161,Staff,22,0,25,3
1683298509595,LTWR 100,A00,186162,Staff,0,4,15,15
1683298510622,LTWR 102,A00,186163,Doller; Ben,5,0,15,10
1683298511647,MAE 8,A01,186412,Staff,0,0,0,0
1683298512675,MAE 30B,A00,186445,Bahadori; Mohammad Yousef,83,0,100,17
1683298513702,MAE 40,A00,186592,Bewley; Thomas R,9,0,50,41
1683298514726,MAE 101B,A00,186593,Bahadori; Mohammad Yousef,81,0,100,19
1683298515755,MAE 105,A00,186594,Bandaru; Prabhakar,12,0,50,38
1683298516782,MAE 107,A00,186599,Pham; Hieu Tan,0,6,120,120
1683298517818,MAE 148,A01,186660,Silberman; Jack,3,0,16,13
1683298518842,MATH 10A,A01,188095,Staff,0,7,35,35
1683298519872,MATH 10B,A01,188097,Bowers; Adam R.,0,11,30,30
1683298519872,MATH 10B,A02,188099,Bowers; Adam R.,0,9,30,30
1683298519872,MATH 10B,B01,188104,Bowers; Adam R.,0,11,30,30
1683298519872,MATH 10B,B02,188106,Bowers; Adam R.,0,11,30,30
1683298520898,MATH 10C,A01,188111,Staff,0,18,30,30
1683298520898,MATH 10C,A02,188127,Staff,0,17,30,30
1683298520898,MATH 10C,A03,188131,Staff,0,17,30,30
1683298520898,MATH 10C,B01,188218,Staff,21,0,30,9
1683298520898,MATH 10C,B02,188244,Staff,13,0,30,17
1683298520898,MATH 10C,B03,188277,Staff,16,0,30,14
1683298521925,MATH 18,A01,188344,Bach; Quang Tran,18,0,30,12
1683298521925,MATH 18,A02,188345,Bach; Quang Tran,11,0,30,19
1683298521925,MATH 18,B01,188353,Bach; Quang Tran,10,0,30,20
1683298521925,MATH 18,B02,188354,Bach; Quang Tran,20,0,30,10
1683298523008,MATH 20A,A01,188374,Staff,13,0,35,22
1683298524036,MATH 20B,A01,188382,Ohm; Ko Woon,6,0,30,24
1683298524036,MATH 20B,A02,188383,Ohm; Ko Woon,24,0,30,6
1683298524036,MATH 20B,B01,188385,Ohm; Ko Woon,7,0,30,23
1683298524036,MATH 20B,B02,188392,Ohm; Ko Woon,22,0,30,8
1683298525065,MATH 20C,A01,188394,Harel; Guershon,10,0,30,20
1683298525065,MATH 20C,A02,188395,Harel; Guershon,13,0,30,17
1683298525065,MATH 20C,B01,188404,Harel; Guershon,3,0,30,27
1683298525065,MATH 20C,B02,188405,Harel; Guershon,19,0,30,11
1683298526091,MATH 20D,A01,188414,Hammock; Frances H,0,1,30,30
1683298526091,MATH 20D,A02,188415,Hammock; Frances H,4,0,30,26
1683298526091,MATH 20D,B01,188447,Hammock; Frances H,2,0,30,28
1683298526091,MATH 20D,B02,188486,Hammock; Frances H,8,0,30,22
1683298527115,MATH 20E,A01,188649,Staff,22,0,30,8
1683298527115,MATH 20E,A02,188650,Staff,23,0,30,7
1683298527115,MATH 20E,A03,188673,Staff,0,0,30,30
1683298528138,MATH 102,A01,188675,Staff,0,35,35,35
1683298529166,MATH 103B,A01,188681,Staff,4,0,35,31
1683298529166,MATH 103B,B01,188692,Staff,7,0,35,28
1683298530192,MATH 109,A01,188695,Salehi Golsefidy; Alireza,25,0,35,10
1683298530192,MATH 109,A02,188696,Salehi Golsefidy; Alireza,27,0,35,8
1683298531216,MATH 120A,A01,188698,Eggers; John Dietrich,5,0,35,30
1683298532240,MATH 142B,A01,188736,Ioana; Adrian,0,2,30,30
1683298532240,MATH 142B,A02,188741,Ioana; Adrian,0,1,30,30
1683298532240,MATH 142B,A03,188743,Ioana; Adrian,0,3,30,30
1683298533266,MATH 168A,A01,188790,Staff,0,8,35,35
1683298534294,MATH 170A,A01,188803,Nie; Jiawang,0,2,35,35
1683298534294,MATH 170A,A02,188811,Nie; Jiawang,0,0,35,35
1683298534294,MATH 170A,A03,188814,Nie; Jiawang,1,0,35,34
1683298534294,MATH 170A,A04,188815,Nie; Jiawang,14,0,35,21
1683298535322,MATH 193B,A01,188817,Staff,0,0,35,35
1683298535322,MATH 193B,A02,188818,Staff,5,0,35,30
1683298536345,MGT 4,A01,202857,Anderson; John Charles,62,0,80,18
1683298537374,MGT 12,A00,202858,Lindenberger; Wade Douglas,43,0,90,47
1683298538398,MGT 18,A00,202859,Staff,74,0,90,16
1683298539422,MGT 18GS,A00,202860,McKay; Michael J,13,0,28,15
1683298540450,MGT 45,A00,202861,Pecore; Joseph P.,14,0,90,76
1683298541477,MGT 100,A00,202863,Yavorsky; Daniel Ryan,28,0,90,62
1683298542509,MGT 103,A00,202864,Ehrich; Kristine R,0,16,90,90
1683298543533,MGT 112,A00,202865,Ehrich; Kristine R,15,0,90,75
1683298544556,MGT 121A,A00,202868,Staff,0,19,0,0
1683298545581,MGT 131B,A00,202869,Anderson; John Charles,59,0,90,31
1683298546606,MGT 136,A00,202871,Lindenberger; Wade Douglas,84,0,90,6
1683298547630,MGT 164,A00,202873,Staff,0,69,90,90
1683298548657,MGT 164GS,A00,202874,McKay; Mary A,13,0,28,15
1683298549682,MGT 180,A00,202875,Staff,0,51,90,90
1683298550710,MMW 11R,A01,205019,Herbst; Matthew,3,0,30,27
1683298550710,MMW 11R,A02,205026,Herbst; Matthew,29,0,30,1
1683298551739,MMW 15,A01,193512,Chang; Edmond Yi-Teh,0,9,28,28
1683298551739,MMW 15,A02,193513,Chang; Edmond Yi-Teh,0,5,28,28
1683298551739,MMW 15,A03,193514,Chang; Edmond Yi-Teh,0,5,28,28
1683298551739,MMW 15,A04,193515,Chang; Edmond Yi-Teh,0,4,28,28
1683298551739,MMW 15,A05,193516,Chang; Edmond Yi-Teh,0,4,28,28
1683298551739,MMW 15,A06,193517,Chang; Edmond Yi-Teh,0,5,28,28
1683298551739,MMW 15,B01,193519,Chang; Edmond Yi-Teh,0,4,28,28
1683298551739,MMW 15,B02,193520,Chang; Edmond Yi-Teh,0,5,28,28
1683298551739,MMW 15,B03,193521,Chang; Edmond Yi-Teh,0,4,28,28
1683298551739,MMW 15,B04,193522,Chang; Edmond Yi-Teh,0,4,28,28
1683298551739,MMW 15,B05,193523,Chang; Edmond Yi-Teh,0,5,28,28
1683298551739,MMW 15,B06,193524,Chang; Edmond Yi-Teh,0,4,28,28
1683298552764,MMW 122,A01,193526,Rahimi; Babak,0,14,28,28
1683298552764,MMW 122,A02,193527,Rahimi; Babak,0,14,28,28
1683298552764,MMW 122,A03,193528,Rahimi; Babak,0,0,0,0
1683298552764,MMW 122,A04,193529,Rahimi; Babak,0,0,0,0
1683298553789,MUS 1A,A01,186663,Staff,0,20,35,35
1683298554815,MUS 4,A01,186715,Staff,0,12,35,35
1683298555843,MUS 5R,A01,186796,Dubnov; Shlomo,0,16,35,35
1683298556871,MUS 6,A01,186798,Staff,0,3,25,25
1683298557898,MUS 7,A01,186830,Staff,12,0,35,23
1683298558925,MUS 8,A01,186930,Staff,0,25,35,35
1683298559953,MUS 15,A01,186932,Staff,0,15,35,35
1683298559953,MUS 15,B01,186934,Staff,0,14,35,35
1683298560978,MUS 80,A00,186935,Staff,2,0,20,18
1683298560978,MUS 80,B00,186936,Staff,25,0,25,0
1683298562003,NANO 11,A00,204702,Lipomi; Darren John,0,0,0,0
1683298563030,NANO 15,A01,204709,Yang; Kesong,0,1,0,0
1683298564055,NANO 114,A00,202069,Jahed Motlagh; Zeinab,3,0,10,7
1683298565081,PHIL 1,A00,186955,Grush; Rick Scott,32,0,40,8
1683298566106,PHIL 10,A01,186973,Grush; Rick Scott,29,0,35,6
1683298566106,PHIL 10,A02,186974,Grush; Rick Scott,33,0,35,2
1683298567134,PHIL 13,A01,186976,Staff,7,0,35,28
1683298567134,PHIL 13,A02,186977,Staff,16,0,35,19
1683298568158,PHIL 14,A01,186979,Staff,31,0,35,4
1683298568158,PHIL 14,A02,186986,Staff,32,0,35,3
1683298569186,PHIL 28,A01,186988,Staff,16,0,30,14
1683298569186,PHIL 28,A02,186989,Staff,1,0,30,29
1683298569186,PHIL 28,A03,186990,Staff,9,0,30,21
1683298569186,PHIL 28,A04,186991,Staff,26,0,30,4
1683298570213,PHIL 120,A00,186997,Staff,23,0,40,17
1683298571240,PHIL 137,A00,187003,Staff,9,0,40,31
1683298572266,PHIL 150,A00,187015,Staff,47,0,70,23
1683298573291,PHIL 167,A00,187021,Lamey; Andy M.,35,0,40,5
1683298574315,PHIL 174,A01,202226,Staff,17,0,20,3
1683298574315,PHIL 174,A02,202235,Staff,20,0,20,0
1683298575340,PHIL 191A,A00,258918,Staff,0,0,1,1
1683298576366,PHYS 1A,A00,187028,Staff,26,0,60,34
1683298577390,PHYS 1AL,001,187036,Staff,2,0,30,28
1683298577390,PHYS 1AL,002,187049,Staff,18,0,30,12
1683298578417,PHYS 1B,A00,187058,Staff,23,0,60,37
1683298579447,PHYS 1BL,001,187064,Staff,0,0,30,30
1683298579447,PHYS 1BL,002,187070,Staff,6,0,30,24
1683298580473,PHYS 1C,A00,187082,Staff,32,0,120,88
1683298581498,PHYS 1CL,001,187088,Staff,0,9,30,30
1683298581498,PHYS 1CL,002,187089,Staff,0,2,30,30
1683298581498,PHYS 1CL,009,262693,Staff,12,0,30,18
1683298582522,PHYS 2B,A01,187097,Staff,54,0,115,61
1683298583546,PHYS 2C,A01,187099,Staff,67,0,115,48
1683298584571,PHYS 2CL,A01,187101,Staff,5,0,28,23
1683298584571,PHYS 2CL,A02,187102,Staff,15,0,28,13
1683298585599,PHYS 2D,A01,187123,Shotwell; Brian,95,0,115,20
1683298586628,PHYS 4B,A01,187133,Grinstein; Benjamin,35,0,50,15
1683298587652,POLI 10,A00,188819,Staff,0,3,50,50
1683298588677,POLI 11,A00,188827,Staff,43,0,50,7
1683298589704,POLI 13R,A00,188828,Staff,0,1,20,20
1683298590730,POLI 27,A01,188830,Elgin; Samuel Zincke,0,1,70,70
1683298591758,POLI 30,A00,188832,Desposato; Scott,33,0,50,17
1683298592783,POLI 102F,A00,188834,Staff,3,0,40,37
1683298593808,POLI 104A,A00,188852,Staff,14,0,30,16
1683298594834,POLI 104I,A00,188853,Staff,0,6,20,20
1683298595857,POLI 110B,A00,188854,Wiens; David,7,0,20,13
1683298596881,POLI 112A,A00,188855,Wiens; David,5,0,30,25
1683298597905,POLI 117R,A00,188856,Forman; Fonna,0,11,20,20
1683298598929,POLI 118,A00,188857,Ingham; Sean,8,0,20,12
1683298599957,POLI 120G,A00,188858,Staff,9,0,30,21
1683298600980,POLI 131CR,A00,188863,Hoston; Germaine,24,0,50,26
1683298602006,POLI 133,A00,188864,Nellis; Gareth Hb,44,0,50,6
1683298603032,POLI 134D,A00,188865,Desposato; Scott,27,0,30,3
1683298604059,POLI 142A,A00,188871,Gartzke; Erik,22,0,50,28
1683298605084,POLI 142K,A00,188874,Staff,38,0,50,12
1683298606108,POLI 143,A00,188940,Gartzke; Erik,16,0,30,14
1683298607137,POLI 153,A00,188943,Staff,3,0,20,17
1683298608161,POLI 160AA,A00,188944,Staff,13,0,40,27
1683298609185,POLI 170A,A00,188945,Staff,11,0,30,19
1683298611236,PSYC 1,A00,188952,Staff,38,0,90,52
1683298612264,PSYC 2,B00,188953,Staff,20,0,35,15
1683298613288,PSYC 6,A00,188970,Staff,47,0,60,13
1683298614313,PSYC 7,A00,188973,Staff,37,0,45,8
1683298615337,PSYC 60,A01,188980,Rickard; Timothy C.,43,0,60,17
1683298616365,PSYC 70,A01,189001,Steiner; Eric Tomas,24,0,45,21
1683298617389,PSYC 100,A00,189005,Lacefield; Katharine I,0,99,120,120
1683298618418,PSYC 102,A00,189008,Staff,10,0,30,20
1683298619445,PSYC 106,B00,189026,Gorman; Michael R.,37,0,60,23
1683298620469,PSYC 114,B01,189033,Winkielman; Piotr,0,32,30,30
1683298621494,PSYC 131,A00,189036,Anagnostaras; Stephan,0,43,60,60
1683298622517,PSYC 136,A00,189041,Lowe; Angela Beth,0,7,25,25
1683298623542,PSYC 137,A00,189057,Winkielman; Piotr,0,34,25,25
1683298624567,PSYC 144,A00,189107,Wixted; John T,0,7,50,50
1683298626688,PSYC 162,A00,189142,Staff,0,8,85,85
1683298627715,PSYC 172,A00,189144,Gorman; Michael R.,0,7,30,30
1683298629766,PSYC 179,A00,189146,Lacefield; Katharine I,0,84,120,120
1683298630790,PSYC 181,A00,189147,Anagnostaras; Stephan,0,44,90,90
1683298631818,PSYC 190R,A00,189148,Barner; David A.,0,22,80,80
1683298632842,PSYC 191,A00,189275,Rickard; Timothy C.,0,7,25,25
1683298633870,PSYC 193,A00,189276,Chapman; Eddie Nathaniel,0,1,0,4
1683298634894,PSYC 193L,A01,189281,Lowe; Angela Beth,12,0,20,8
1683298634894,PSYC 193L,B01,189285,Staff,28,0,35,7
1683298635919,RELI 149,A00,187137,Rahimi; Babak,7,0,40,33
1683298636943,SE 9,A01,187315,Staff,0,2,18,18
1683298637967,SE 101B,A00,187409,Staff,24,0,30,6
1683298638991,SE 110B,A00,187444,Staff,10,0,40,30
1683298640019,SE 130B,A00,187449,Staff,31,0,40,9
1683298641044,SE 150A,A00,187516,Staff,9,0,20,11
1683298642068,SE 154,A00,187528,Staff,30,0,50,20
1683298643093,SIO 3,A01,258171,Staff,35,0,40,5
1683298644118,SIO 10,A00,187144,Cook; Geoffrey W,0,3,75,75
1683298645141,SIO 45,A00,187152,Cook; Geoffrey W,1,0,100,99
1683298646168,SIO 109R,A00,194486,Staff,0,3,20,20
1683298648220,SIO 187,A01,187233,Kacev; David,12,0,40,28
1683298649246,SOCI 1,A01,258656,Thorpe; Charles Robert,28,0,30,2
1683298649246,SOCI 1,A02,258658,Thorpe; Charles Robert,30,0,30,0
1683298649246,SOCI 1,A03,258661,Thorpe; Charles Robert,25,0,25,0
1683298649246,SOCI 1,A04,258666,Thorpe; Charles Robert,22,0,25,3
1683298649246,SOCI 1,A05,258897,Thorpe; Charles Robert,23,0,25,2
1683298649246,SOCI 1,A06,258898,Thorpe; Charles Robert,25,0,25,0
1683298650270,SOCI 30,A01,258903,Pardo Guerra; Juan Pablo,16,0,30,14
1683298651294,SOCI 102,A00,258904,Staff,9,0,25,16
1683298652323,SOCI 106,A00,258905,Staff,19,0,25,6
1683298653349,SOCI 111,A00,258907,Ribas Norris; Janet Vanesa,26,0,30,4
1683298654376,SOCI 121R,A00,258908,Pardo Guerra; Juan Pablo,11,0,30,19
1683298655400,SOCI 126,A01,203330,Staff,14,0,20,6
1683298656424,SOCI 131,A00,258909,Thorpe; Charles Robert,31,0,60,29
1683298657452,SOCI 135,A00,258910,Payne; Christine Anna,0,9,30,30
1683298658479,SOCI 157,A00,258911,Staff,13,0,30,17
1683298659503,SOCI 184,A00,258912,Staff,26,0,30,4
1683298660525,SOCI 188D,A00,258913,Staff,21,0,30,9
1683298661549,SYN 2,001,187529,Staff,9,0,16,7
1683298661549,SYN 2,002,201452,Staff,0,18,16,16
1683298661549,SYN 2,003,201469,Staff,3,0,16,13
1683298662572,SYN 100,A01,187531,Staff,0,9,20,20
1683298662572,SYN 100,B01,201491,Staff,0,12,20,20
1683298663597,TDAC 1,A00,189286,Walsh; Kim C.,3,0,20,17
1683298663597,TDAC 1,B00,189287,Harting; Carla Kelso,11,0,20,9
1683298664626,TDAC 101,A00,189300,Walsh; Kim C.,16,0,20,4
1683298664626,TDAC 101,B00,189301,Harting; Carla Kelso,18,0,20,2
1683298665649,TDAC 102,A00,189304,Basso; Beatrice,14,0,20,6
1683298666674,TDAC 108,A00,189305,Staff,18,0,20,2
1683298667700,TDDE 131,A00,189310,Staff,19,0,20,1
1683298667700,TDDE 131,B00,189314,Staff,19,0,20,1
1683298667700,TDDE 131,C00,189315,Staff,48,0,50,2
1683298667700,TDDE 131,D00,189316,Staff,14,0,15,1
1683298667700,TDDE 131,E00,204841,Staff,20,0,20,0
1683298668727,TDGE 10,A00,189289,Staff,30,0,50,20
1683298668727,TDGE 10,B00,189290,Havis; Allan,2,0,50,48
1683298669752,TDGE 11,A00,189291,Fulton; Julia,0,3,50,50
1683298669752,TDGE 11,B00,189292,Staff,20,0,25,5
1683298669752,TDGE 11,C00,260270,Staff,0,0,0,0
1683298670776,TDGE 25,A00,189294,Staff,3,0,20,17
1683298671800,TDGE 124,A00,189318,Fulton; Julia,0,8,50,50
1683298672826,TDGE 125,A00,189319,Staff,13,0,25,12
1683298672826,TDGE 125,B00,189320,Staff,23,0,25,2
1683298673850,TDGE 127,A00,189322,Havis; Allan,0,0,50,50
1683298674878,TDHT 101,A00,189323,Staff,18,0,25,7
1683298674878,TDHT 101,B00,189324,Staff,25,0,25,0
1683298675905,TDHT 102,A00,189325,Staff,49,0,50,1
1683298676929,TDMV 1,A00,189295,Arcidiacono; Kristin,20,0,30,10
1683298676929,TDMV 1,B00,189296,Caligagan; Maria T.,24,0,30,6
1683298677957,TDMV 2,A00,189297,Sammartano; Tonnie,28,0,30,2
1683298677957,TDMV 2,B00,189299,Arcidiacono; Kristin,24,0,30,6
1683298678982,TDMV 3,A00,204998,Rincon; Alicia,22,0,30,8
1683298680009,TDMV 120,A00,189458,Sammartano; Tonnie,28,0,30,2
1683298681036,TDMV 138,A00,189541,Jun; Grace Shin Hae,22,0,40,18
1683298682081,TDMV 142,A00,189717,Caligagan; Tony,23,0,30,7
1683298682081,TDMV 142,B00,189718,Caligagan; Maria T.,25,0,30,5
1683298683105,TMC 2,A01,187533,Staff,25,0,25,0
1683298683105,TMC 2,A02,187534,Staff,25,0,25,0
1683298684131,USP 1,A01,187536,Kwak; Nancy,0,16,25,25
1683298685154,USP 5,A01,187538,Staff,9,0,25,16
1683298686182,USP 101,A00,199253,Staff,0,4,0,0
1683298687206,USP 124,A00,187562,Boomhower; Matthew Charles,1,0,30,29
1683298688230,USP 138,A00,187582,Staff,20,0,25,5
1683298689255,USP 152,A01,187597,Staff,4,0,25,21
1683298690280,USP 153,A00,187598,Staff,19,0,25,6
1683298691308,USP 168,A00,187607,Kwak; Nancy,2,0,5,3
1683298692334,USP 173,A00,187619,Staff,4,0,25,21
1683298693359,USP 181,A00,187638,Staff,0,0,25,25
1683298694388,VIS 103,A00,187650,Cruz; Edwin Teddy,23,0,75,52
1683298695413,VIS 110D,A00,187669,Staff,12,0,22,10
1683298696438,VIS 127C,A00,187720,Shen; Kuiyi,68,0,146,78
1683298697462,VIS 149,A00,187731,Yoldas; Pinar,0,14,22,22
1683298698489,VIS 151,A01,188091,Staff,22,0,34,12
1683298698489,VIS 151,A02,188092,Staff,11,0,34,23
1683298699516,VIS 160B,A00,188093,Stalbaum; Brett,0,0,10,10
1683298701570,WCWP 10B,A00,201720,Staff,10,0,15,5
1683298701570,WCWP 10B,B00,201722,Staff,8,0,15,7
1683298702593,WCWP 100,A00,201725,Gagnon; Jeffrey C,0,0,2,2
1683298702593,WCWP 100,B00,201727,Staff,0,4,15,15
1683298705693,ANBI 133,A00,258401,Wilder; Linnea Lorene,34,0,40,6
1683298706719,ANBI 140,A00,258395,Hrvoj Mihic; Branka,18,0,25,7
1683298707743,ANSC 120,A00,258402,Bialecki; Jon Anthony,27,0,40,13
1683298708767,ANSC 144,A00,258400,Staff,14,0,40,26
1683298710817,ANSC 166,A00,258396,Parish; Steven Martin,157,0,175,18
1683298711842,ANSC 180,A00,193533,Staff,9,0,20,11
1683298712873,ANSC 188,A00,258397,Jassal; Aftab,33,0,40,7
1683298713901,ANTH 3,A01,258316,Staff,23,0,30,7
1683298714932,ANTH 5,A00,258394,Semendeferi; Ekaterini,16,0,20,4
1683298715959,ANTH 21,A01,258331,Staff,9,0,40,31
1683298716984,ANTH 103,A00,258398,Varma; Saiba,15,0,25,10
1683298718017,AWP 10,001,202034,Staff,0,0,0,0
1683298718017,AWP 10,002,202035,Staff,0,0,0,0
1683298718017,AWP 10,003,202036,Staff,0,0,0,0
1683298718017,AWP 10,004,202037,Staff,0,0,0,0
1683298718017,AWP 10,005,202038,Staff,0,0,0,0
1683298718017,AWP 10,006,202039,Staff,0,0,0,0
1683298718017,AWP 10,007,202040,Staff,0,0,0,0
1683298718017,AWP 10,008,202041,Staff,0,0,0,0
1683298718017,AWP 10,009,202042,Staff,0,0,0,0
1683298718017,AWP 10,010,202043,Staff,0,0,0,0
1683298718017,AWP 10,011,202044,Staff,0,0,0,0
1683298718017,AWP 10,012,202045,Staff,0,0,0,0
1683298718017,AWP 10,013,202046,Staff,0,0,0,0
1683298718017,AWP 10,014,202047,Staff,0,0,0,0
1683298718017,AWP 10,015,202048,Staff,0,0,0,0
1683298718017,AWP 10,016,202049,Staff,0,0,0,0
1683298718017,AWP 10,017,202050,Staff,0,0,0,0
1683298718017,AWP 10,018,202051,Staff,0,0,0,0
1683298718017,AWP 10,019,202052,Staff,0,0,0,0
1683298718017,AWP 10,020,202053,Staff,0,0,0,0
1683298718017,AWP 10,021,202054,Staff,0,0,0,0
1683298718017,AWP 10,022,202055,Staff,0,0,0,0
1683298718017,AWP 10,023,202056,Staff,0,0,0,0
1683298718017,AWP 10,024,202057,Staff,0,0,0,0
1683298718017,AWP 10,025,202058,Staff,0,0,0,0
1683298718017,AWP 10,026,202059,Staff,0,0,0,0
1683298719044,AWP 102,001,202032,Staff,0,0,0,0
1683298719044,AWP 102,002,202033,Staff,0,0,0,0
1683298720068,BENG 100,A01,254234,Taylor Amos; Alyssa C,31,0,40,9
1683298721091,BENG 196,001,270013,Engler; Adam J.,9999,0,9999,0
1683298722120,BICD 100R,A01,202018,Smith; Laurie,0,7,32,32
1683298722120,BICD 100R,A02,202019,Smith; Laurie,0,2,32,32
1683298722120,BICD 100R,A03,202020,Smith; Laurie,0,1,32,32
1683298722120,BICD 100R,A04,202021,Smith; Laurie,8,0,32,24
1683298722120,BICD 100R,A05,202022,Smith; Laurie,12,0,32,20
1683298723143,BICD 136,A01,193242,Gustafson-Brown; Cindy,0,2,32,32
1683298723143,BICD 136,A02,193244,Gustafson-Brown; Cindy,15,0,32,17
1683298724167,BIEB 102,A01,193249,Butler; Shannon Rhey,0,2,32,32
1683298724167,BIEB 102,A02,193251,Butler; Shannon Rhey,0,0,32,32
1683298724167,BIEB 102,A03,193253,Butler; Shannon Rhey,0,1,32,32
1683298724167,BIEB 102,A04,193255,Butler; Shannon Rhey,17,0,32,15
1683298724167,BIEB 102,A05,193265,Butler; Shannon Rhey,26,0,32,6
1683298724167,BIEB 102,A06,193269,Butler; Shannon Rhey,16,0,32,16
1683298726219,BIEB 150,A01,193274,Staff,0,0,32,32
1683298726219,BIEB 150,A02,193285,Staff,24,0,32,8
1683298727242,BIEB 194,A00,193286,Kurle; Carolyn M.,22,0,32,10
1683298728270,BILD 1,A01,192291,Staff,16,0,32,16
1683298728270,BILD 1,A02,192292,Staff,30,0,32,2
1683298728270,BILD 1,B01,192520,Reuther; Keefe,0,1,0,0
1683298728270,BILD 1,B02,192532,Reuther; Keefe,0,1,0,0
1683298729298,BILD 3,A01,192556,Butler; Shannon Rhey,0,0,32,32
1683298729298,BILD 3,A02,192581,Butler; Shannon Rhey,5,0,32,27
1683298729298,BILD 3,A03,192611,Butler; Shannon Rhey,23,0,32,9
1683298729298,BILD 3,A04,192612,Butler; Shannon Rhey,25,0,32,7
1683298729298,BILD 3,A05,192613,Butler; Shannon Rhey,27,0,32,5
1683298729298,BILD 3,A06,192679,Butler; Shannon Rhey,27,0,32,5
1683298729298,BILD 3,A07,192682,Butler; Shannon Rhey,22,0,32,10
1683298730381,BILD 4,A01,192836,Reuther; Keefe,1,0,24,23
1683298730381,BILD 4,A02,193044,Reuther; Keefe,4,0,24,20
1683298731409,BILD 10,A01,193142,Gustafson-Brown; Cindy,31,0,32,1
1683298731409,BILD 10,A02,193149,Gustafson-Brown; Cindy,31,0,32,1
1683298732434,BIMM 100,A01,193301,Staff,0,6,32,32
1683298732434,BIMM 100,A02,193312,Staff,0,5,32,32
1683298732434,BIMM 100,A03,193323,Staff,0,8,32,32
1683298733460,BIMM 101,A01,193329,McDonnell; Lisa Marie,0,3,24,24
1683298733460,BIMM 101,A02,193339,McDonnell; Lisa Marie,0,2,24,24
1683298733460,BIMM 101,B01,193354,McDonnell; Lisa Marie,0,3,24,24
1683298733460,BIMM 101,B02,193357,McDonnell; Lisa Marie,0,3,24,24
1683298734485,BIMM 110,A01,193377,Tat; John,0,11,32,32
1683298734485,BIMM 110,A02,193378,Tat; John,1,9,32,31
1683298735514,BIMM 120,A01,206116,Staff,0,0,32,32
1683298735514,BIMM 120,A02,206117,Staff,8,0,32,24
1683298735514,BIMM 120,A03,206121,Staff,21,0,32,11
1683298736543,BIPN 100,A01,193393,Park; Ji Young,0,14,32,32
1683298736543,BIPN 100,A02,193402,Park; Ji Young,0,12,32,32
1683298736543,BIPN 100,A03,193413,Park; Ji Young,0,14,32,32
1683298736543,BIPN 100,A04,193414,Park; Ji Young,0,13,32,32
1683298737570,BIPN 102,A01,193429,Staff,0,0,32,32
1683298737570,BIPN 102,A02,193438,Staff,23,0,32,9
1683298738596,BIPN 106,A01,193450,Reyes Gonzalez; Catalina,0,2,40,40
1683298739620,BIPN 134,A01,193465,Cooke; James Edward,0,0,32,32
1683298739620,BIPN 134,A02,193474,Cooke; James Edward,27,0,32,5
1683298739620,BIPN 134,A03,193485,Cooke; James Edward,29,0,32,3
1683298739620,BIPN 134,A04,193486,Cooke; James Edward,21,0,32,11
1683298739620,BIPN 134,A05,193491,Cooke; James Edward,31,0,32,1
1683298739620,BIPN 134,A06,193501,Cooke; James Edward,30,0,32,2
1683298739620,BIPN 134,A07,193510,Cooke; James Edward,29,0,32,3
1683298741679,BISP 194,A00,222522,Staff,16,0,32,16
1683298742705,CAT 124,A01,202407,Staff,20,0,25,5
1683298743729,CAT 125,A00,202408,Marchisotto; Jennifer Anne,4,0,20,16
1683298744758,CAT 125R,A00,202409,Smith; Lauryn Alissa,0,11,20,20
1683298744758,CAT 125R,B00,202410,Morales; Celeste Georgianna,0,11,20,20
1683298744758,CAT 125R,C00,202411,Irwin; Matthew Joseph,0,10,20,20
1683298745783,CENG 15,A01,204712,Yang; Kesong,0,1,0,0
1683298746809,CENG 114,A00,202070,Jahed Motlagh; Zeinab,5,0,20,15
1683298747834,CGS 105,A00,185477,Wesling; Megan E.,24,0,40,16
1683298748862,CGS 106,A00,185494,Staff,13,0,22,9
1683298749886,CGS 108,A00,185495,Staff,14,0,20,6
1683298750911,CGS 114,A00,185496,Staff,13,0,18,5
1683298751934,CGS 119,A00,185501,Staff,15,0,20,5
1683298752959,CGS 120,A00,185511,Staff,13,0,20,7
1683298753988,CHEM 4,A01,184675,Bussey; Thomas J,96,0,100,4
1683298755014,CHEM 6A,A01,184677,Staff,35,0,60,25
1683298756038,CHEM 6B,A01,184679,Staff,65,0,100,35
1683298757064,CHEM 6C,A01,184681,Bussey; Thomas J,1,0,50,49
1683298757064,CHEM 6C,A02,184682,Bussey; Thomas J,34,0,50,16
1683298758094,CHEM 40A,A01,184684,Albizati; Kim F.,37,0,100,63
1683298759118,CHEM 40B,A01,184686,Albizati; Kim F.,0,20,100,100
1683298760146,CHEM 41B,A01,184690,Staff,52,0,100,48
1683298761171,COGS 3,A01,184715,Boyle; Mary E. T.,0,25,40,40
1683298762199,COGS 14B,A01,185172,Staff,0,15,38,38
1683298763225,COGS 18,A01,184736,Staff,20,0,80,60
1683298764252,COGS 100,A01,184932,Staff,0,5,73,73
1683298765278,COGS 101A,A01,184935,Staff,0,38,30,30
1683298766302,COGS 101B,A01,184944,Staff,0,2,30,30
1683298767329,COGS 101C,A01,184946,Staff,0,12,30,30
1683298768357,COGS 102A,A01,184951,Johnson; Christine M.,2,0,40,38
1683298769382,COGS 107B,A01,184953,Mooshagian; Eric Frederick,0,50,40,40
1683298770406,COGS 118B,A01,184959,Gupta; Anjum,0,48,40,40
1683298771429,COGS 153,A00,184961,Staff,0,15,30,30
1683298772454,COGS 177,A00,184962,Staff,0,21,30,30
1683298773478,COGS 187A,A01,184969,Boyle; Mary E. T.,0,17,40,40
1683298774500,COMM 10,A01,185174,Staff,0,5,25,25
1683298774500,COMM 10,A02,185189,Staff,0,5,25,25
1683298774500,COMM 10,A03,269821,Staff,0,0,0,0
1683298775525,COMM 100B,A01,185475,Staff,0,0,0,2
1683298775525,COMM 100B,A02,185476,Staff,14,0,25,11
1683298776550,COMM 100C,A01,185314,Staff,1,0,25,24
1683298776550,COMM 100C,A02,185327,Staff,19,0,25,6
1683298777577,COMM 110M,A00,185349,Staff,2,0,40,38
1683298778603,COMM 113T,A00,185352,Staff,25,0,40,15
1683298779629,COMM 114I,A00,185353,Staff,33,0,40,7
1683298780653,COMM 131,A00,185354,Staff,19,0,30,11
1683298781682,CSE 8A,A50,185358,Cao; Yingjun,0,46,10,10
1683298782711,CSE 8B,A01,185362,Staff,1,47,50,49
1683298783736,CSE 11,A01,185416,Cao; Yingjun,0,93,10,10
1683298784761,CSE 20,A01,185445,Briones; Jor-el Thomas Caparas,5,0,25,20
1683298785785,CSE 21,A01,185447,Staff,10,0,50,40
1683298786810,CSE 101,A01,185451,Staff,0,12,50,50
1683298786810,CSE 101,B01,185453,Jones; Miles E,0,11,50,50
1683298788862,CSE 141,A01,185458,Eldon; John,20,0,100,80
1683298789889,CSE 141L,A01,185461,Eldon; John,12,0,100,88
1683298790913,CSE 142,A01,185463,Staff,35,0,60,25
1683298790913,CSE 142,B01,201355,Staff,0,6,60,60
1683298791942,CSE 142L,A01,185470,Staff,35,0,60,25
1683298791942,CSE 142L,B01,201417,Staff,0,5,60,60
1683298792965,CSE 190,A00,201433,Staff,32,0,49,17
1683298793990,DOC 1,A01,259136,Strom; Megan C.,8,0,15,7
1683298793990,DOC 1,A02,259137,Strom; Megan C.,14,0,15,1
1683298793990,DOC 1,A03,259138,Strom; Megan C.,14,0,15,1
1683298793990,DOC 1,A04,259139,Strom; Megan C.,14,0,15,1
1683298795023,DOC 100D,A00,259140,Pass; Natalye Joann,17,0,25,8
1683298796051,DSGN 1,A01,184749,Rill; Bryan,0,24,30,30
1683298797078,DSGN 100,A01,185168,Staff,0,2,25,25
1683298798100,ECE 5,A01,185626,Morris; Karcher William,0,10,0,0
1683298799127,ECE 101,A01,185628,Staff,17,0,70,53
1683298800153,ECE 107,A01,185635,Baghdadchi; Saharnaz,0,0,20,20
1683298800153,ECE 107,A02,185638,Baghdadchi; Saharnaz,4,0,20,16
1683298801181,ECE 148,A01,185647,Silberman; Jack,1,0,16,15
1683298802206,ECON 1,A01,185537,Crane; Meredith Helen,54,0,70,16
1683298803230,ECON 3,A01,185549,Crane; Meredith Helen,33,0,70,37
1683298804254,ECON 4,A01,203354,Anderson; John Charles,0,4,10,10
1683298805284,ECON 100A,A01,185574,Staff,0,4,40,40
1683298806309,ECON 100B,A01,185576,Staff,0,22,40,40
1683298807336,ECON 100C,A01,185589,Newhouse; Herbert S,30,0,70,40
1683298808363,ECON 105,A00,185608,Vespa; Emanuel Ignacio,19,0,35,16
1683298809393,ECON 109,A01,185610,Shishkin; Denis,10,0,35,25
1683298810416,ECON 110A,A01,185612,Staff,11,0,40,29
1683298811442,ECON 120A,A01,185615,Staff,20,0,40,20
1683298812467,ECON 120C,A01,185617,Sun; Yixiao,0,20,70,70
1683298813496,ECON 144,A00,203346,Squires; Dale E,3,0,35,32
1683298814518,ECON 171,A01,203349,Newhouse; Herbert S,0,1,35,35
1683298815547,ECON 173A,A01,185621,Toda; Alexis Akira,21,0,35,14
1683298816574,EDS 25,A01,202413,Staff,0,1,0,0
1683298816574,EDS 25,A02,202414,Staff,0,1,0,0
1683298816574,EDS 25,A03,202415,Staff,0,0,0,0
1683298816574,EDS 25,A04,202416,Staff,0,1,0,0
1683298816574,EDS 25,A05,202439,Staff,0,0,0,0
1683298816574,EDS 25,A06,202440,Staff,0,0,0,0
1683298816574,EDS 25,B01,202631,Staff,0,0,0,0
1683298816574,EDS 25,B02,202632,Staff,0,0,0,0
1683298816574,EDS 25,B03,202639,Staff,0,0,0,0
1683298816574,EDS 25,B04,202640,Staff,0,0,0,0
1683298816574,EDS 25,B05,202643,Staff,0,0,0,0
1683298816574,EDS 25,B06,202644,Staff,0,0,0,0
1683298817601,EDS 38,A01,202659,Black; Alison Michelle,24,0,25,1
1683298818629,EDS 115,A00,202652,Staff,17,0,30,13
1683298819652,EDS 125,A00,202649,Staff,14,0,30,16
1683298820676,EDS 126,A01,203332,Staff,30,0,30,0
1683298821707,EDS 139,A00,202838,Staff,17,0,25,8
1683298822734,EDS 146,A01,202655,Staff,15,0,25,10
1683298823758,ENG 15,A00,185667,Staff,0,1,0,0
1683298823758,ENG 15,B00,185672,Staff,0,0,0,0
1683298823758,ENG 15,C00,185675,Staff,0,0,0,0
1683298823758,ENG 15,D00,185682,Staff,0,0,0,0
1683298823758,ENG 15,E00,185684,Staff,0,0,0,0
1683298824784,ETHN 103,A00,185710,Staff,0,3,35,35
1683298825808,ETHN 103A,A00,199228,Man; Simeon S,3,0,9,6
1683298826834,ETHN 109,A00,185711,Staff,18,0,35,17
1683298827867,ETHN 142,A00,185726,Staff,0,4,30,30
1683298828892,ETHN 163J,A00,199229,Man; Simeon S,6,0,8,2
1683298829915,ETHN 168,A00,185727,Staff,8,0,10,2
1683298830940,ETHN 182,A00,185728,Staff,1,0,35,34
1683298831966,ETHN 183,A00,185737,Staff,8,0,18,10
1683298832990,GLBH 111,A01,209361,Burgos; Jose L.,0,0,0,0
1683298835095,HIEU 104,A00,185792,Staff,16,0,20,4
1683298836119,HIEU 115,A00,185800,Staff,1,0,20,19
1683298837146,HIEU 128,A00,185801,Staff,0,7,20,20
1683298838172,HIEU 147,A00,185802,Staff,16,0,20,4
1683298839199,HIEU 154,A00,185823,Staff,12,0,20,8
1683298840222,HILA 102,A00,185826,Staff,13,0,20,7
1683298841247,HILD 2C,A01,185778,Staff,0,12,20,20
1683298842270,HILD 7B,A01,185780,Kwak; Nancy,0,15,32,32
1683298842270,HILD 7B,A02,185781,Kwak; Nancy,0,18,32,32
1683298843294,HILD 30,A01,185791,Staff,14,0,20,6
1683298844322,HISC 119,A00,185830,Golan; Tal,0,9,20,20
1683298845347,HITO 156GS,A00,185831,Patterson; Patrick H.,0,0,0,23
1683298846372,HIUS 103,A00,185832,Man; Simeon S,0,7,20,20
1683298847602,HIUS 117,A00,185836,Kwak; Nancy,2,0,20,18
1683298848625,HIUS 125,A00,185840,Man; Simeon S,0,0,23,23
1683298849651,HIUS 149,A00,185845,Staff,0,0,20,20
1683298850678,HUM 3,A01,185882,Zavodny; Tatiana Sophia,0,6,50,50
1683298850678,HUM 3,B01,185899,Caldwell; Michael Alan,0,19,50,50
1683298851703,HUM 3GS,A00,185900,Patterson; Patrick H.,0,0,0,23
1683298852732,HUM 4,A01,185938,Zroka; Amy Liane,31,0,50,19
1683298852732,HUM 4,B01,185956,Watkins; Eric,0,2,50,50
1683298852732,HUM 4,B02,202209,Watkins; Eric,0,1,50,50
1683298852732,HUM 4,B03,202210,Watkins; Eric,0,0,50,50
1683298853765,HUM 5,A01,185958,West; Geoffrey Scott,5,0,50,45
1683298853765,HUM 5,A02,202215,West; Geoffrey Scott,0,0,50,50
1683298854794,INTL 190,A00,185959,Gagnon; Jeffrey C,0,0,0,9
1683298854794,INTL 190,B00,185960,Lettieri; Michael Joseph,0,0,0,1
1683298855819,JAPN 180,A00,254509,Staff,0,1,25,25
1683298856843,LATI 10,A01,202853,Kennemore; Amy Michelle,5,0,35,30
1683298856843,LATI 10,A02,202854,Kennemore; Amy Michelle,1,0,35,34
1683298856843,LATI 10,A03,270054,Kennemore; Amy Michelle,30,0,30,0
1683298857867,LATI 180,A00,202855,Kennemore; Amy Michelle,11,0,20,9
1683298858892,LAWS 101,A00,201767,Golan; Tal,0,7,40,40
1683298859916,LIFR 1C,A00,185961,Staff,6,0,20,14
1683298860940,LIFR 1CX,A00,185962,Staff,7,0,20,13
1683298861969,LIFR 1D,A00,185963,Staff,9,0,20,11
1683298863013,LIFR 1DX,A00,185964,Staff,9,0,20,11
1683298864038,LIGN 101,A01,186039,Staff,43,0,50,7
1683298865062,LIGN 165,A00,186040,Staff,18,0,50,32
1683298866090,LTCS 108,A00,186041,Staff,6,0,10,4
1683298867117,LTCS 119,A00,186042,Staff,16,0,20,4
1683298868142,LTCS 130,A00,186043,Wesling; Megan E.,15,0,25,10
1683298870194,LTEA 138,A00,186119,Staff,14,0,40,26
1683298871218,LTEN 124,A00,186148,Staff,6,0,25,19
1683298872242,LTEN 178,A00,186149,Staff,7,0,15,8
1683298873268,LTEN 181,A00,186150,Blanco; John D,33,0,40,7
1683298874292,LTWL 120,A00,186160,Staff,20,0,25,5
1683298875318,LTWL 165,A00,186161,Staff,22,0,25,3
1683298876342,LTWR 100,A00,186162,Staff,0,4,15,15
1683298877365,LTWR 102,A00,186163,Doller; Ben,5,0,15,10
1683298878392,MAE 8,A01,186412,Staff,0,0,0,0
1683298879416,MAE 30B,A00,186445,Bahadori; Mohammad Yousef,83,0,100,17
1683298880440,MAE 40,A00,186592,Bewley; Thomas R,9,0,50,41
1683298881466,MAE 101B,A00,186593,Bahadori; Mohammad Yousef,81,0,100,19
1683298882493,MAE 105,A00,186594,Bandaru; Prabhakar,12,0,50,38
1683298883523,MAE 107,A00,186599,Pham; Hieu Tan,0,6,120,120
1683298884550,MAE 148,A01,186660,Silberman; Jack,3,0,16,13
1683298885576,MATH 10A,A01,188095,Staff,0,7,35,35
1683298886601,MATH 10B,A01,188097,Bowers; Adam R.,0,11,30,30
1683298886601,MATH 10B,A02,188099,Bowers; Adam R.,0,9,30,30
1683298886601,MATH 10B,B01,188104,Bowers; Adam R.,0,11,30,30
1683298886601,MATH 10B,B02,188106,Bowers; Adam R.,0,11,30,30
1683298887629,MATH 10C,A01,188111,Staff,0,18,30,30
1683298887629,MATH 10C,A02,188127,Staff,0,17,30,30
1683298887629,MATH 10C,A03,188131,Staff,0,17,30,30
1683298887629,MATH 10C,B01,188218,Staff,21,0,30,9
1683298887629,MATH 10C,B02,188244,Staff,13,0,30,17
1683298887629,MATH 10C,B03,188277,Staff,16,0,30,14
1683298888658,MATH 18,A01,188344,Bach; Quang Tran,18,0,30,12
1683298888658,MATH 18,A02,188345,Bach; Quang Tran,11,0,30,19
1683298888658,MATH 18,B01,188353,Bach; Quang Tran,10,0,30,20
1683298888658,MATH 18,B02,188354,Bach; Quang Tran,20,0,30,10
1683298889686,MATH 20A,A01,188374,Staff,13,0,35,22
1683298890715,MATH 20B,A01,188382,Ohm; Ko Woon,6,0,30,24
1683298890715,MATH 20B,A02,188383,Ohm; Ko Woon,24,0,30,6
1683298890715,MATH 20B,B01,188385,Ohm; Ko Woon,7,0,30,23
1683298890715,MATH 20B,B02,188392,Ohm; Ko Woon,22,0,30,8
1683298891739,MATH 20C,A01,188394,Harel; Guershon,10,0,30,20
1683298891739,MATH 20C,A02,188395,Harel; Guershon,13,0,30,17
1683298891739,MATH 20C,B01,188404,Harel; Guershon,3,0,30,27
1683298891739,MATH 20C,B02,188405,Harel; Guershon,19,0,30,11
1683298892767,MATH 20D,A01,188414,Hammock; Frances H,0,1,30,30
1683298892767,MATH 20D,A02,188415,Hammock; Frances H,4,0,30,26
1683298892767,MATH 20D,B01,188447,Hammock; Frances H,2,0,30,28
1683298892767,MATH 20D,B02,188486,Hammock; Frances H,8,0,30,22
1683298893794,MATH 20E,A01,188649,Staff,22,0,30,8
1683298893794,MATH 20E,A02,188650,Staff,23,0,30,7
1683298893794,MATH 20E,A03,188673,Staff,0,0,30,30
1683298894817,MATH 102,A01,188675,Staff,0,35,35,35
1683298895842,MATH 103B,A01,188681,Staff,4,0,35,31
1683298895842,MATH 103B,B01,188692,Staff,7,0,35,28
1683298896871,MATH 109,A01,188695,Salehi Golsefidy; Alireza,25,0,35,10
1683298896871,MATH 109,A02,188696,Salehi Golsefidy; Alireza,27,0,35,8
1683298897896,MATH 120A,A01,188698,Eggers; John Dietrich,5,0,35,30
1683298898922,MATH 142B,A01,188736,Ioana; Adrian,0,2,30,30
1683298898922,MATH 142B,A02,188741,Ioana; Adrian,0,1,30,30
1683298898922,MATH 142B,A03,188743,Ioana; Adrian,0,3,30,30
1683298899946,MATH 168A,A01,188790,Staff,0,8,35,35
1683298900975,MATH 170A,A01,188803,Nie; Jiawang,0,2,35,35
1683298900975,MATH 170A,A02,188811,Nie; Jiawang,0,0,35,35
1683298900975,MATH 170A,A03,188814,Nie; Jiawang,1,0,35,34
1683298900975,MATH 170A,A04,188815,Nie; Jiawang,14,0,35,21
1683298901999,MATH 193B,A01,188817,Staff,0,0,35,35
1683298901999,MATH 193B,A02,188818,Staff,5,0,35,30
1683298903026,MGT 4,A01,202857,Anderson; John Charles,62,0,80,18
1683298904049,MGT 12,A00,202858,Lindenberger; Wade Douglas,43,0,90,47
1683298905073,MGT 18,A00,202859,Staff,74,0,90,16
1683298906098,MGT 18GS,A00,202860,McKay; Michael J,13,0,28,15
1683298907125,MGT 45,A00,202861,Pecore; Joseph P.,14,0,90,76
1683298908150,MGT 100,A00,202863,Yavorsky; Daniel Ryan,28,0,90,62
1683298909173,MGT 103,A00,202864,Ehrich; Kristine R,0,16,90,90
1683298910201,MGT 112,A00,202865,Ehrich; Kristine R,15,0,90,75
1683298911225,MGT 121A,A00,202868,Staff,0,19,0,0
1683298912248,MGT 131B,A00,202869,Anderson; John Charles,59,0,90,31
1683298913272,MGT 136,A00,202871,Lindenberger; Wade Douglas,84,0,90,6
1683298914299,MGT 164,A00,202873,Staff,0,69,90,90
1683298915325,MGT 164GS,A00,202874,McKay; Mary A,13,0,28,15
1683298916352,MGT 180,A00,202875,Staff,0,51,90,90
1683298917376,MMW 11R,A01,205019,Herbst; Matthew,3,0,30,27
1683298917376,MMW 11R,A02,205026,Herbst; Matthew,29,0,30,1
1683298918400,MMW 15,A01,193512,Chang; Edmond Yi-Teh,0,9,28,28
1683298918400,MMW 15,A02,193513,Chang; Edmond Yi-Teh,0,5,28,28
1683298918400,MMW 15,A03,193514,Chang; Edmond Yi-Teh,0,5,28,28
1683298918400,MMW 15,A04,193515,Chang; Edmond Yi-Teh,0,4,28,28
1683298918400,MMW 15,A05,193516,Chang; Edmond Yi-Teh,0,4,28,28
1683298918400,MMW 15,A06,193517,Chang; Edmond Yi-Teh,0,5,28,28
1683298918400,MMW 15,B01,193519,Chang; Edmond Yi-Teh,0,4,28,28
1683298918400,MMW 15,B02,193520,Chang; Edmond Yi-Teh,0,5,28,28
1683298918400,MMW 15,B03,193521,Chang; Edmond Yi-Teh,0,4,28,28
1683298918400,MMW 15,B04,193522,Chang; Edmond Yi-Teh,0,4,28,28
1683298918400,MMW 15,B05,193523,Chang; Edmond Yi-Teh,0,5,28,28
1683298918400,MMW 15,B06,193524,Chang; Edmond Yi-Teh,0,4,28,28
1683298919428,MMW 122,A01,193526,Rahimi; Babak,0,14,28,28
1683298919428,MMW 122,A02,193527,Rahimi; Babak,0,14,28,28
1683298919428,MMW 122,A03,193528,Rahimi; Babak,0,0,0,0
1683298919428,MMW 122,A04,193529,Rahimi; Babak,0,0,0,0
1683298920453,MUS 1A,A01,186663,Staff,0,20,35,35
1683298921477,MUS 4,A01,186715,Staff,0,12,35,35
1683298922510,MUS 5R,A01,186796,Dubnov; Shlomo,0,16,35,35
1683298923535,MUS 6,A01,186798,Staff,0,3,25,25
1683298924559,MUS 7,A01,186830,Staff,12,0,35,23
1683298925584,MUS 8,A01,186930,Staff,0,25,35,35
1683298926609,MUS 15,A01,186932,Staff,0,15,35,35
1683298926609,MUS 15,B01,186934,Staff,0,14,35,35
1683298927635,MUS 80,A00,186935,Staff,2,0,20,18
1683298927635,MUS 80,B00,186936,Staff,25,0,25,0
1683298928660,NANO 11,A00,204702,Lipomi; Darren John,0,0,0,0
1683298929685,NANO 15,A01,204709,Yang; Kesong,0,1,0,0
1683298930714,NANO 114,A00,202069,Jahed Motlagh; Zeinab,3,0,10,7
1683298931736,PHIL 1,A00,186955,Grush; Rick Scott,32,0,40,8
1683298932762,PHIL 10,A01,186973,Grush; Rick Scott,29,0,35,6
1683298932762,PHIL 10,A02,186974,Grush; Rick Scott,33,0,35,2
1683298933792,PHIL 13,A01,186976,Staff,7,0,35,28
1683298933792,PHIL 13,A02,186977,Staff,16,0,35,19
1683298934819,PHIL 14,A01,186979,Staff,31,0,35,4
1683298934819,PHIL 14,A02,186986,Staff,32,0,35,3
1683298935847,PHIL 28,A01,186988,Staff,16,0,30,14
1683298935847,PHIL 28,A02,186989,Staff,1,0,30,29
1683298935847,PHIL 28,A03,186990,Staff,9,0,30,21
1683298935847,PHIL 28,A04,186991,Staff,26,0,30,4
1683298936875,PHIL 120,A00,186997,Staff,23,0,40,17
1683298937958,PHIL 137,A00,187003,Staff,9,0,40,31
1683298938984,PHIL 150,A00,187015,Staff,47,0,70,23
1683298940013,PHIL 167,A00,187021,Lamey; Andy M.,35,0,40,5
1683298941040,PHIL 174,A01,202226,Staff,17,0,20,3
1683298941040,PHIL 174,A02,202235,Staff,20,0,20,0
1683298942068,PHIL 191A,A00,258918,Staff,0,0,1,1
1683298943095,PHYS 1A,A00,187028,Staff,26,0,60,34
1683298944121,PHYS 1AL,001,187036,Staff,2,0,30,28
1683298944121,PHYS 1AL,002,187049,Staff,18,0,30,12
1683298945145,PHYS 1B,A00,187058,Staff,23,0,60,37
1683298946180,PHYS 1BL,001,187064,Staff,0,0,30,30
1683298946180,PHYS 1BL,002,187070,Staff,6,0,30,24
1683298947205,PHYS 1C,A00,187082,Staff,32,0,120,88
1683298948233,PHYS 1CL,001,187088,Staff,0,9,30,30
1683298948233,PHYS 1CL,002,187089,Staff,0,2,30,30
1683298948233,PHYS 1CL,009,262693,Staff,12,0,30,18
1683298949262,PHYS 2B,A01,187097,Staff,54,0,115,61
1683298950287,PHYS 2C,A01,187099,Staff,67,0,115,48
1683298951310,PHYS 2CL,A01,187101,Staff,5,0,28,23
1683298951310,PHYS 2CL,A02,187102,Staff,15,0,28,13
1683298952333,PHYS 2D,A01,187123,Shotwell; Brian,95,0,115,20
1683298953359,PHYS 4B,A01,187133,Grinstein; Benjamin,35,0,50,15
1683298954387,POLI 10,A00,188819,Staff,0,3,50,50
1683298955410,POLI 11,A00,188827,Staff,43,0,50,7
1683298956435,POLI 13R,A00,188828,Staff,0,1,20,20
1683298957460,POLI 27,A01,188830,Elgin; Samuel Zincke,0,1,70,70
1683298958484,POLI 30,A00,188832,Desposato; Scott,33,0,50,17
1683298959507,POLI 102F,A00,188834,Staff,3,0,40,37
1683298960531,POLI 104A,A00,188852,Staff,14,0,30,16
1683298961556,POLI 104I,A00,188853,Staff,0,6,20,20
1683298962586,POLI 110B,A00,188854,Wiens; David,7,0,20,13
1683298963612,POLI 112A,A00,188855,Wiens; David,5,0,30,25
1683298964636,POLI 117R,A00,188856,Forman; Fonna,0,11,20,20
1683298965662,POLI 118,A00,188857,Ingham; Sean,8,0,20,12
1683298966686,POLI 120G,A00,188858,Staff,9,0,30,21
1683298967710,POLI 131CR,A00,188863,Hoston; Germaine,24,0,50,26
1683298968733,POLI 133,A00,188864,Nellis; Gareth Hb,44,0,50,6
1683298969757,POLI 134D,A00,188865,Desposato; Scott,27,0,30,3
1683298970782,POLI 142A,A00,188871,Gartzke; Erik,22,0,50,28
1683298971805,POLI 142K,A00,188874,Staff,38,0,50,12
1683298972831,POLI 143,A00,188940,Gartzke; Erik,16,0,30,14
1683298973856,POLI 153,A00,188943,Staff,3,0,20,17
1683298974883,POLI 160AA,A00,188944,Staff,13,0,40,27
1683298975910,POLI 170A,A00,188945,Staff,11,0,30,19
1683298977963,PSYC 1,A00,188952,Staff,38,0,90,52
1683298978989,PSYC 2,B00,188953,Staff,20,0,35,15
1683298980016,PSYC 6,A00,188970,Staff,47,0,60,13
1683298981043,PSYC 7,A00,188973,Staff,37,0,45,8
1683298982069,PSYC 60,A01,188980,Rickard; Timothy C.,43,0,60,17
1683298983093,PSYC 70,A01,189001,Steiner; Eric Tomas,24,0,45,21
1683298984118,PSYC 100,A00,189005,Lacefield; Katharine I,0,99,120,120
1683298985142,PSYC 102,A00,189008,Staff,10,0,30,20
1683298986167,PSYC 106,B00,189026,Gorman; Michael R.,37,0,60,23
1683298987191,PSYC 114,B01,189033,Winkielman; Piotr,0,32,30,30
1683298988215,PSYC 131,A00,189036,Anagnostaras; Stephan,0,43,60,60
1683298989240,PSYC 136,A00,189041,Lowe; Angela Beth,0,7,25,25
1683298990269,PSYC 137,A00,189057,Winkielman; Piotr,0,34,25,25
1683298991298,PSYC 144,A00,189107,Wixted; John T,0,7,50,50
1683298993348,PSYC 162,A00,189142,Staff,0,8,85,85
1683298994373,PSYC 172,A00,189144,Gorman; Michael R.,0,7,30,30
1683298996421,PSYC 179,A00,189146,Lacefield; Katharine I,0,84,120,120
1683298997453,PSYC 181,A00,189147,Anagnostaras; Stephan,0,44,90,90
1683298998480,PSYC 190R,A00,189148,Barner; David A.,0,22,80,80
1683298999505,PSYC 191,A00,189275,Rickard; Timothy C.,0,7,25,25
1683299000531,PSYC 193,A00,189276,Chapman; Eddie Nathaniel,0,1,0,4
1683299001554,PSYC 193L,A01,189281,Lowe; Angela Beth,12,0,20,8
1683299001554,PSYC 193L,B01,189285,Staff,28,0,35,7
1683299002580,RELI 149,A00,187137,Rahimi; Babak,7,0,40,33
1683299003608,SE 9,A01,187315,Staff,0,2,18,18
1683299004635,SE 101B,A00,187409,Staff,24,0,30,6
1683299005658,SE 110B,A00,187444,Staff,10,0,40,30
1683299006688,SE 130B,A00,187449,Staff,31,0,40,9
1683299007710,SE 150A,A00,187516,Staff,9,0,20,11
1683299008734,SE 154,A00,187528,Staff,30,0,50,20
1683299009758,SIO 3,A01,258171,Staff,35,0,40,5
1683299010781,SIO 10,A00,187144,Cook; Geoffrey W,0,3,75,75
1683299011804,SIO 45,A00,187152,Cook; Geoffrey W,1,0,100,99
1683299012828,SIO 109R,A00,194486,Staff,0,3,20,20
1683299014881,SIO 187,A01,187233,Kacev; David,12,0,40,28
1683299015909,SOCI 1,A01,258656,Thorpe; Charles Robert,28,0,30,2
1683299015909,SOCI 1,A02,258658,Thorpe; Charles Robert,30,0,30,0
1683299015909,SOCI 1,A03,258661,Thorpe; Charles Robert,25,0,25,0
1683299015909,SOCI 1,A04,258666,Thorpe; Charles Robert,22,0,25,3
1683299015909,SOCI 1,A05,258897,Thorpe; Charles Robert,23,0,25,2
1683299015909,SOCI 1,A06,258898,Thorpe; Charles Robert,25,0,25,0
1683299016933,SOCI 30,A01,258903,Pardo Guerra; Juan Pablo,16,0,30,14
1683299017959,SOCI 102,A00,258904,Staff,9,0,25,16
1683299018982,SOCI 106,A00,258905,Staff,19,0,25,6
1683299020005,SOCI 111,A00,258907,Ribas Norris; Janet Vanesa,26,0,30,4
1683299021032,SOCI 121R,A00,258908,Pardo Guerra; Juan Pablo,11,0,30,19
1683299022056,SOCI 126,A01,203330,Staff,14,0,20,6
1683299023080,SOCI 131,A00,258909,Thorpe; Charles Robert,31,0,60,29
1683299024107,SOCI 135,A00,258910,Payne; Christine Anna,0,9,30,30
1683299025131,SOCI 157,A00,258911,Staff,13,0,30,17
1683299026153,SOCI 184,A00,258912,Staff,26,0,30,4
1683299027176,SOCI 188D,A00,258913,Staff,21,0,30,9
1683299028204,SYN 2,001,187529,Staff,9,0,16,7
1683299028204,SYN 2,002,201452,Staff,0,18,16,16
1683299028204,SYN 2,003,201469,Staff,3,0,16,13
1683299029230,SYN 100,A01,187531,Staff,0,9,20,20
1683299029230,SYN 100,B01,201491,Staff,0,12,20,20
1683299030257,TDAC 1,A00,189286,Walsh; Kim C.,3,0,20,17
1683299030257,TDAC 1,B00,189287,Harting; Carla Kelso,11,0,20,9
1683299031284,TDAC 101,A00,189300,Walsh; Kim C.,16,0,20,4
1683299031284,TDAC 101,B00,189301,Harting; Carla Kelso,18,0,20,2
1683299032309,TDAC 102,A00,189304,Basso; Beatrice,14,0,20,6
1683299033333,TDAC 108,A00,189305,Staff,18,0,20,2
1683299034358,TDDE 131,A00,189310,Staff,19,0,20,1
1683299034358,TDDE 131,B00,189314,Staff,19,0,20,1
1683299034358,TDDE 131,C00,189315,Staff,48,0,50,2
1683299034358,TDDE 131,D00,189316,Staff,14,0,15,1
1683299034358,TDDE 131,E00,204841,Staff,20,0,20,0
1683299035383,TDGE 10,A00,189289,Staff,30,0,50,20
1683299035383,TDGE 10,B00,189290,Havis; Allan,2,0,50,48
1683299036407,TDGE 11,A00,189291,Fulton; Julia,0,3,50,50
1683299036407,TDGE 11,B00,189292,Staff,20,0,25,5
1683299036407,TDGE 11,C00,260270,Staff,0,0,0,0
1683299037430,TDGE 25,A00,189294,Staff,3,0,20,17
1683299038454,TDGE 124,A00,189318,Fulton; Julia,0,8,50,50
1683299039482,TDGE 125,A00,189319,Staff,13,0,25,12
1683299039482,TDGE 125,B00,189320,Staff,23,0,25,2
1683299040509,TDGE 127,A00,189322,Havis; Allan,0,0,50,50
1683299041598,TDHT 101,A00,189323,Staff,18,0,25,7
1683299041598,TDHT 101,B00,189324,Staff,25,0,25,0
1683299042625,TDHT 102,A00,189325,Staff,49,0,50,1
1683299043653,TDMV 1,A00,189295,Arcidiacono; Kristin,20,0,30,10
1683299043653,TDMV 1,B00,189296,Caligagan; Maria T.,24,0,30,6
1683299044678,TDMV 2,A00,189297,Sammartano; Tonnie,28,0,30,2
1683299044678,TDMV 2,B00,189299,Arcidiacono; Kristin,24,0,30,6
1683299045702,TDMV 3,A00,204998,Rincon; Alicia,22,0,30,8
1683299046731,TDMV 120,A00,189458,Sammartano; Tonnie,28,0,30,2
1683299047754,TDMV 138,A00,189541,Jun; Grace Shin Hae,22,0,40,18
1683299048778,TDMV 142,A00,189717,Caligagan; Tony,23,0,30,7
1683299048778,TDMV 142,B00,189718,Caligagan; Maria T.,25,0,30,5
1683299049803,TMC 2,A01,187533,Staff,25,0,25,0
1683299049803,TMC 2,A02,187534,Staff,25,0,25,0
1683299050828,USP 1,A01,187536,Kwak; Nancy,0,16,25,25
1683299051853,USP 5,A01,187538,Staff,9,0,25,16
1683299052877,USP 101,A00,199253,Staff,0,4,0,0
1683299053900,USP 124,A00,187562,Boomhower; Matthew Charles,1,0,30,29
1683299054927,USP 138,A00,187582,Staff,20,0,25,5
1683299055962,USP 152,A01,187597,Staff,4,0,25,21
1683299056989,USP 153,A00,187598,Staff,19,0,25,6
1683299058019,USP 168,A00,187607,Kwak; Nancy,2,0,5,3
1683299059042,USP 173,A00,187619,Staff,4,0,25,21
1683299060066,USP 181,A00,187638,Staff,0,0,25,25
1683299061090,VIS 103,A00,187650,Cruz; Edwin Teddy,23,0,75,52
1683299062117,VIS 110D,A00,187669,Staff,12,0,22,10
1683299063144,VIS 127C,A00,187720,Shen; Kuiyi,68,0,146,78
1683299064171,VIS 149,A00,187731,Yoldas; Pinar,0,14,22,22
1683299065198,VIS 151,A01,188091,Staff,22,0,34,12
1683299065198,VIS 151,A02,188092,Staff,11,0,34,23
1683299066222,VIS 160B,A00,188093,Stalbaum; Brett,0,0,10,10
1683299068271,WCWP 10B,A00,201720,Staff,10,0,15,5
1683299068271,WCWP 10B,B00,201722,Staff,8,0,15,7
1683299069299,WCWP 100,A00,201725,Gagnon; Jeffrey C,0,0,2,2
1683299069299,WCWP 100,B00,201727,Staff,0,4,15,15
1683299072389,ANBI 133,A00,258401,Wilder; Linnea Lorene,34,0,40,6
1683299073413,ANBI 140,A00,258395,Hrvoj Mihic; Branka,18,0,25,7
1683299074436,ANSC 120,A00,258402,Bialecki; Jon Anthony,27,0,40,13
1683299075459,ANSC 144,A00,258400,Staff,14,0,40,26
1683299077513,ANSC 166,A00,258396,Parish; Steven Martin,157,0,175,18
1683299078540,ANSC 180,A00,193533,Staff,9,0,20,11
1683299079568,ANSC 188,A00,258397,Jassal; Aftab,33,0,40,7
1683299080592,ANTH 3,A01,258316,Staff,23,0,30,7
1683299081617,ANTH 5,A00,258394,Semendeferi; Ekaterini,16,0,20,4
1683299082642,ANTH 21,A01,258331,Staff,9,0,40,31
1683299083669,ANTH 103,A00,258398,Varma; Saiba,15,0,25,10
1683299084697,AWP 10,001,202034,Staff,0,0,0,0
1683299084697,AWP 10,002,202035,Staff,0,0,0,0
1683299084697,AWP 10,003,202036,Staff,0,0,0,0
1683299084697,AWP 10,004,202037,Staff,0,0,0,0
1683299084697,AWP 10,005,202038,Staff,0,0,0,0
1683299084697,AWP 10,006,202039,Staff,0,0,0,0
1683299084697,AWP 10,007,202040,Staff,0,0,0,0
1683299084697,AWP 10,008,202041,Staff,0,0,0,0
1683299084697,AWP 10,009,202042,Staff,0,0,0,0
1683299084697,AWP 10,010,202043,Staff,0,0,0,0
1683299084697,AWP 10,011,202044,Staff,0,0,0,0
1683299084697,AWP 10,012,202045,Staff,0,0,0,0
1683299084697,AWP 10,013,202046,Staff,0,0,0,0
1683299084697,AWP 10,014,202047,Staff,0,0,0,0
1683299084697,AWP 10,015,202048,Staff,0,0,0,0
1683299084697,AWP 10,016,202049,Staff,0,0,0,0
1683299084697,AWP 10,017,202050,Staff,0,0,0,0
1683299084697,AWP 10,018,202051,Staff,0,0,0,0
1683299084697,AWP 10,019,202052,Staff,0,0,0,0
1683299084697,AWP 10,020,202053,Staff,0,0,0,0
1683299084697,AWP 10,021,202054,Staff,0,0,0,0
1683299084697,AWP 10,022,202055,Staff,0,0,0,0
1683299084697,AWP 10,023,202056,Staff,0,0,0,0
1683299084697,AWP 10,024,202057,Staff,0,0,0,0
1683299084697,AWP 10,025,202058,Staff,0,0,0,0
1683299084697,AWP 10,026,202059,Staff,0,0,0,0
1683299085725,AWP 102,001,202032,Staff,0,0,0,0
1683299085725,AWP 102,002,202033,Staff,0,0,0,0
1683299086753,BENG 100,A01,254234,Taylor Amos; Alyssa C,31,0,40,9
1683299087780,BENG 196,001,270013,Engler; Adam J.,9999,0,9999,0
1683299088809,BICD 100R,A01,202018,Smith; Laurie,0,7,32,32
1683299088809,BICD 100R,A02,202019,Smith; Laurie,0,2,32,32
1683299088809,BICD 100R,A03,202020,Smith; Laurie,0,1,32,32
1683299088809,BICD 100R,A04,202021,Smith; Laurie,8,0,32,24
1683299088809,BICD 100R,A05,202022,Smith; Laurie,12,0,32,20
1683299089838,BICD 136,A01,193242,Gustafson-Brown; Cindy,0,2,32,32
1683299089838,BICD 136,A02,193244,Gustafson-Brown; Cindy,15,0,32,17
1683299090866,BIEB 102,A01,193249,Butler; Shannon Rhey,0,2,32,32
1683299090866,BIEB 102,A02,193251,Butler; Shannon Rhey,0,0,32,32
1683299090866,BIEB 102,A03,193253,Butler; Shannon Rhey,0,1,32,32
1683299090866,BIEB 102,A04,193255,Butler; Shannon Rhey,17,0,32,15
1683299090866,BIEB 102,A05,193265,Butler; Shannon Rhey,26,0,32,6
1683299090866,BIEB 102,A06,193269,Butler; Shannon Rhey,16,0,32,16
1683299092918,BIEB 150,A01,193274,Staff,0,0,32,32
1683299092918,BIEB 150,A02,193285,Staff,24,0,32,8
1683299093942,BIEB 194,A00,193286,Kurle; Carolyn M.,22,0,32,10
1683299094971,BILD 1,A01,192291,Staff,16,0,32,16
1683299094971,BILD 1,A02,192292,Staff,30,0,32,2
1683299094971,BILD 1,B01,192520,Reuther; Keefe,0,1,0,0
1683299094971,BILD 1,B02,192532,Reuther; Keefe,0,1,0,0
1683299096007,BILD 3,A01,192556,Butler; Shannon Rhey,0,0,32,32
1683299096007,BILD 3,A02,192581,Butler; Shannon Rhey,5,0,32,27
1683299096007,BILD 3,A03,192611,Butler; Shannon Rhey,23,0,32,9
1683299096007,BILD 3,A04,192612,Butler; Shannon Rhey,25,0,32,7
1683299096007,BILD 3,A05,192613,Butler; Shannon Rhey,27,0,32,5
1683299096007,BILD 3,A06,192679,Butler; Shannon Rhey,27,0,32,5
1683299096007,BILD 3,A07,192682,Butler; Shannon Rhey,22,0,32,10
1683299097035,BILD 4,A01,192836,Reuther; Keefe,1,0,24,23
1683299097035,BILD 4,A02,193044,Reuther; Keefe,4,0,24,20
1683299098063,BILD 10,A01,193142,Gustafson-Brown; Cindy,31,0,32,1
1683299098063,BILD 10,A02,193149,Gustafson-Brown; Cindy,31,0,32,1
1683299099087,BIMM 100,A01,193301,Staff,0,6,32,32
1683299099087,BIMM 100,A02,193312,Staff,0,5,32,32
1683299099087,BIMM 100,A03,193323,Staff,0,8,32,32
1683299100116,BIMM 101,A01,193329,McDonnell; Lisa Marie,0,3,24,24
1683299100116,BIMM 101,A02,193339,McDonnell; Lisa Marie,0,2,24,24
1683299100116,BIMM 101,B01,193354,McDonnell; Lisa Marie,0,3,24,24
1683299100116,BIMM 101,B02,193357,McDonnell; Lisa Marie,0,3,24,24
1683299101145,BIMM 110,A01,193377,Tat; John,0,11,32,32
1683299101145,BIMM 110,A02,193378,Tat; John,1,9,32,31
1683299102173,BIMM 120,A01,206116,Staff,0,0,32,32
1683299102173,BIMM 120,A02,206117,Staff,8,0,32,24
1683299102173,BIMM 120,A03,206121,Staff,21,0,32,11
1683299103199,BIPN 100,A01,193393,Park; Ji Young,0,14,32,32
1683299103199,BIPN 100,A02,193402,Park; Ji Young,0,12,32,32
1683299103199,BIPN 100,A03,193413,Park; Ji Young,0,14,32,32
1683299103199,BIPN 100,A04,193414,Park; Ji Young,0,13,32,32
1683299104223,BIPN 102,A01,193429,Staff,0,0,32,32
1683299104223,BIPN 102,A02,193438,Staff,23,0,32,9
1683299105251,BIPN 106,A01,193450,Reyes Gonzalez; Catalina,0,2,40,40
1683299106275,BIPN 134,A01,193465,Cooke; James Edward,0,0,32,32
1683299106275,BIPN 134,A02,193474,Cooke; James Edward,27,0,32,5
1683299106275,BIPN 134,A03,193485,Cooke; James Edward,29,0,32,3
1683299106275,BIPN 134,A04,193486,Cooke; James Edward,21,0,32,11
1683299106275,BIPN 134,A05,193491,Cooke; James Edward,31,0,32,1
1683299106275,BIPN 134,A06,193501,Cooke; James Edward,30,0,32,2
1683299106275,BIPN 134,A07,193510,Cooke; James Edward,29,0,32,3
1683299108323,BISP 194,A00,222522,Staff,16,0,32,16
1683299109350,CAT 124,A01,202407,Staff,20,0,25,5
1683299110375,CAT 125,A00,202408,Marchisotto; Jennifer Anne,4,0,20,16
1683299111402,CAT 125R,A00,202409,Smith; Lauryn Alissa,0,11,20,20
1683299111402,CAT 125R,B00,202410,Morales; Celeste Georgianna,0,11,20,20
1683299111402,CAT 125R,C00,202411,Irwin; Matthew Joseph,0,10,20,20
1683299112429,CENG 15,A01,204712,Yang; Kesong,0,1,0,0
1683299113453,CENG 114,A00,202070,Jahed Motlagh; Zeinab,5,0,20,15
1683299114477,CGS 105,A00,185477,Wesling; Megan E.,24,0,40,16
1683299115502,CGS 106,A00,185494,Staff,13,0,22,9
1683299116527,CGS 108,A00,185495,Staff,14,0,20,6
1683299117555,CGS 114,A00,185496,Staff,13,0,18,5
1683299118582,CGS 119,A00,185501,Staff,15,0,20,5
1683299119606,CGS 120,A00,185511,Staff,13,0,20,7
1683299120635,CHEM 4,A01,184675,Bussey; Thomas J,96,0,100,4
1683299121663,CHEM 6A,A01,184677,Staff,35,0,60,25
1683299122690,CHEM 6B,A01,184679,Staff,65,0,100,35
1683299123715,CHEM 6C,A01,184681,Bussey; Thomas J,1,0,50,49
1683299123715,CHEM 6C,A02,184682,Bussey; Thomas J,34,0,50,16
1683299124739,CHEM 40A,A01,184684,Albizati; Kim F.,37,0,100,63
1683299125763,CHEM 40B,A01,184686,Albizati; Kim F.,0,20,100,100
1683299126790,CHEM 41B,A01,184690,Staff,52,0,100,48
1683299127818,COGS 3,A01,184715,Boyle; Mary E. T.,0,25,40,40
1683299128846,COGS 14B,A01,185172,Staff,0,15,38,38
1683299129868,COGS 18,A01,184736,Staff,20,0,80,60
1683299130892,COGS 100,A01,184932,Staff,0,5,73,73
1683299131919,COGS 101A,A01,184935,Staff,0,38,30,30
1683299132944,COGS 101B,A01,184944,Staff,0,2,30,30
1683299133971,COGS 101C,A01,184946,Staff,0,12,30,30
1683299135005,COGS 102A,A01,184951,Johnson; Christine M.,2,0,40,38
1683299136028,COGS 107B,A01,184953,Mooshagian; Eric Frederick,0,50,40,40
1683299137060,COGS 118B,A01,184959,Gupta; Anjum,0,48,40,40
1683299138085,COGS 153,A00,184961,Staff,0,15,30,30
1683299139110,COGS 177,A00,184962,Staff,0,21,30,30
1683299140133,COGS 187A,A01,184969,Boyle; Mary E. T.,0,17,40,40
1683299141162,COMM 10,A01,185174,Staff,0,5,25,25
1683299141162,COMM 10,A02,185189,Staff,0,5,25,25
1683299141162,COMM 10,A03,269821,Staff,0,0,0,0
1683299142187,COMM 100B,A01,185475,Staff,0,0,0,2
1683299142187,COMM 100B,A02,185476,Staff,14,0,25,11
1683299143210,COMM 100C,A01,185314,Staff,1,0,25,24
1683299143210,COMM 100C,A02,185327,Staff,19,0,25,6
1683299144235,COMM 110M,A00,185349,Staff,2,0,40,38
1683299145314,COMM 113T,A00,185352,Staff,25,0,40,15
1683299146341,COMM 114I,A00,185353,Staff,33,0,40,7
1683299147365,COMM 131,A00,185354,Staff,19,0,30,11
1683299148393,CSE 8A,A50,185358,Cao; Yingjun,0,46,10,10
1683299149418,CSE 8B,A01,185362,Staff,1,47,50,49
1683299150443,CSE 11,A01,185416,Cao; Yingjun,0,93,10,10
1683299151467,CSE 20,A01,185445,Briones; Jor-el Thomas Caparas,5,0,25,20
1683299152497,CSE 21,A01,185447,Staff,10,0,50,40
1683299153522,CSE 101,A01,185451,Staff,0,12,50,50
1683299153522,CSE 101,B01,185453,Jones; Miles E,0,11,50,50
1683299155572,CSE 141,A01,185458,Eldon; John,20,0,100,80
1683299156600,CSE 141L,A01,185461,Eldon; John,12,0,100,88
1683299157628,CSE 142,A01,185463,Staff,35,0,60,25
1683299157628,CSE 142,B01,201355,Staff,0,6,60,60
1683299158653,CSE 142L,A01,185470,Staff,35,0,60,25
1683299158653,CSE 142L,B01,201417,Staff,0,5,60,60
1683299159680,CSE 190,A00,201433,Staff,32,0,49,17
1683299160709,DOC 1,A01,259136,Strom; Megan C.,8,0,15,7
1683299160709,DOC 1,A02,259137,Strom; Megan C.,14,0,15,1
1683299160709,DOC 1,A03,259138,Strom; Megan C.,14,0,15,1
1683299160709,DOC 1,A04,259139,Strom; Megan C.,14,0,15,1
1683299161734,DOC 100D,A00,259140,Pass; Natalye Joann,17,0,25,8
1683299162759,DSGN 1,A01,184749,Rill; Bryan,0,24,30,30
1683299163782,DSGN 100,A01,185168,Staff,0,2,25,25
1683299164806,ECE 5,A01,185626,Morris; Karcher William,0,10,0,0
1683299165836,ECE 101,A01,185628,Staff,17,0,70,53
1683299166863,ECE 107,A01,185635,Baghdadchi; Saharnaz,0,0,20,20
1683299166863,ECE 107,A02,185638,Baghdadchi; Saharnaz,4,0,20,16
1683299167888,ECE 148,A01,185647,Silberman; Jack,1,0,16,15
1683299168917,ECON 1,A01,185537,Crane; Meredith Helen,54,0,70,16
1683299169945,ECON 3,A01,185549,Crane; Meredith Helen,33,0,70,37
1683299170970,ECON 4,A01,203354,Anderson; John Charles,0,4,10,10
1683299171994,ECON 100A,A01,185574,Staff,0,4,40,40
1683299173023,ECON 100B,A01,185576,Staff,0,22,40,40
1683299174050,ECON 100C,A01,185589,Newhouse; Herbert S,30,0,70,40
1683299175075,ECON 105,A00,185608,Vespa; Emanuel Ignacio,19,0,35,16
1683299176102,ECON 109,A01,185610,Shishkin; Denis,10,0,35,25
1683299177130,ECON 110A,A01,185612,Staff,11,0,40,29
1683299178156,ECON 120A,A01,185615,Staff,20,0,40,20
1683299179181,ECON 120C,A01,185617,Sun; Yixiao,0,20,70,70
1683299180205,ECON 144,A00,203346,Squires; Dale E,3,0,35,32
1683299181229,ECON 171,A01,203349,Newhouse; Herbert S,0,1,35,35
1683299182256,ECON 173A,A01,185621,Toda; Alexis Akira,21,0,35,14
1683299183288,EDS 25,A01,202413,Staff,0,1,0,0
1683299183288,EDS 25,A02,202414,Staff,0,1,0,0
1683299183288,EDS 25,A03,202415,Staff,0,0,0,0
1683299183288,EDS 25,A04,202416,Staff,0,1,0,0
1683299183288,EDS 25,A05,202439,Staff,0,0,0,0
1683299183288,EDS 25,A06,202440,Staff,0,0,0,0
1683299183288,EDS 25,B01,202631,Staff,0,0,0,0
1683299183288,EDS 25,B02,202632,Staff,0,0,0,0
1683299183288,EDS 25,B03,202639,Staff,0,0,0,0
1683299183288,EDS 25,B04,202640,Staff,0,0,0,0
1683299183288,EDS 25,B05,202643,Staff,0,0,0,0
1683299183288,EDS 25,B06,202644,Staff,0,0,0,0
1683299184318,EDS 38,A01,202659,Black; Alison Michelle,24,0,25,1
1683299185345,EDS 115,A00,202652,Staff,17,0,30,13
1683299186370,EDS 125,A00,202649,Staff,14,0,30,16
1683299187394,EDS 126,A01,203332,Staff,30,0,30,0
1683299188420,EDS 139,A00,202838,Staff,17,0,25,8
1683299189444,EDS 146,A01,202655,Staff,15,0,25,10
1683299190468,ENG 15,A00,185667,Staff,0,1,0,0
1683299190468,ENG 15,B00,185672,Staff,0,0,0,0
1683299190468,ENG 15,C00,185675,Staff,0,0,0,0
1683299190468,ENG 15,D00,185682,Staff,0,0,0,0
1683299190468,ENG 15,E00,185684,Staff,0,0,0,0
1683299191492,ETHN 103,A00,185710,Staff,0,3,35,35
1683299192515,ETHN 103A,A00,199228,Man; Simeon S,3,0,9,6
1683299193537,ETHN 109,A00,185711,Staff,18,0,35,17
1683299194563,ETHN 142,A00,185726,Staff,0,4,30,30
1683299195589,ETHN 163J,A00,199229,Man; Simeon S,6,0,8,2
1683299196615,ETHN 168,A00,185727,Staff,8,0,10,2
1683299197639,ETHN 182,A00,185728,Staff,1,0,35,34
1683299198665,ETHN 183,A00,185737,Staff,8,0,18,10
1683299199692,GLBH 111,A01,209361,Burgos; Jose L.,0,0,0,0
1683299201743,HIEU 104,A00,185792,Staff,16,0,20,4
1683299202770,HIEU 115,A00,185800,Staff,1,0,20,19
1683299203794,HIEU 128,A00,185801,Staff,0,7,20,20
1683299204818,HIEU 147,A00,185802,Staff,16,0,20,4
1683299205841,HIEU 154,A00,185823,Staff,12,0,20,8
1683299206864,HILA 102,A00,185826,Staff,13,0,20,7
1683299207890,HILD 2C,A01,185778,Staff,0,12,20,20
1683299208918,HILD 7B,A01,185780,Kwak; Nancy,0,15,32,32
1683299208918,HILD 7B,A02,185781,Kwak; Nancy,0,18,32,32
1683299209946,HILD 30,A01,185791,Staff,14,0,20,6
1683299210973,HISC 119,A00,185830,Golan; Tal,0,9,20,20
1683299211996,HITO 156GS,A00,185831,Patterson; Patrick H.,0,0,0,23
1683299213020,HIUS 103,A00,185832,Man; Simeon S,0,7,20,20
1683299214047,HIUS 117,A00,185836,Kwak; Nancy,2,0,20,18
1683299215070,HIUS 125,A00,185840,Man; Simeon S,0,0,23,23
1683299216097,HIUS 149,A00,185845,Staff,0,0,20,20
1683299217122,HUM 3,A01,185882,Zavodny; Tatiana Sophia,0,6,50,50
1683299217122,HUM 3,B01,185899,Caldwell; Michael Alan,0,19,50,50
1683299218146,HUM 3GS,A00,185900,Patterson; Patrick H.,0,0,0,23
1683299219171,HUM 4,A01,185938,Zroka; Amy Liane,31,0,50,19
1683299219171,HUM 4,B01,185956,Watkins; Eric,0,2,50,50
1683299219171,HUM 4,B02,202209,Watkins; Eric,0,1,50,50
1683299219171,HUM 4,B03,202210,Watkins; Eric,0,0,50,50
1683299220195,HUM 5,A01,185958,West; Geoffrey Scott,5,0,50,45
1683299220195,HUM 5,A02,202215,West; Geoffrey Scott,0,0,50,50
1683299221224,INTL 190,A00,185959,Gagnon; Jeffrey C,0,0,0,9
1683299221224,INTL 190,B00,185960,Lettieri; Michael Joseph,0,0,0,1
1683299222251,JAPN 180,A00,254509,Staff,0,1,25,25
1683299223279,LATI 10,A01,202853,Kennemore; Amy Michelle,5,0,35,30
1683299223279,LATI 10,A02,202854,Kennemore; Amy Michelle,1,0,35,34
1683299223279,LATI 10,A03,270054,Kennemore; Amy Michelle,30,0,30,0
1683299224308,LATI 180,A00,202855,Kennemore; Amy Michelle,11,0,20,9
1683299225339,LAWS 101,A00,201767,Golan; Tal,0,7,40,40
1683299226367,LIFR 1C,A00,185961,Staff,6,0,20,14
1683299227390,LIFR 1CX,A00,185962,Staff,7,0,20,13
1683299228417,LIFR 1D,A00,185963,Staff,9,0,20,11
1683299229440,LIFR 1DX,A00,185964,Staff,9,0,20,11
1683299230467,LIGN 101,A01,186039,Staff,43,0,50,7
1683299231494,LIGN 165,A00,186040,Staff,18,0,50,32
1683299232518,LTCS 108,A00,186041,Staff,6,0,10,4
1683299233543,LTCS 119,A00,186042,Staff,16,0,20,4
1683299234568,LTCS 130,A00,186043,Wesling; Megan E.,15,0,25,10
1683299236622,LTEA 138,A00,186119,Staff,14,0,40,26
1683299237647,LTEN 124,A00,186148,Staff,6,0,25,19
1683299238673,LTEN 178,A00,186149,Staff,7,0,15,8
1683299239696,LTEN 181,A00,186150,Blanco; John D,33,0,40,7
1683299240721,LTWL 120,A00,186160,Staff,20,0,25,5
1683299241745,LTWL 165,A00,186161,Staff,22,0,25,3
1683299242768,LTWR 100,A00,186162,Staff,0,4,15,15
1683299243801,LTWR 102,A00,186163,Doller; Ben,5,0,15,10
1683299244829,MAE 8,A01,186412,Staff,0,0,0,0
1683299245854,MAE 30B,A00,186445,Bahadori; Mohammad Yousef,83,0,100,17
1683299246881,MAE 40,A00,186592,Bewley; Thomas R,9,0,50,41
1683299247907,MAE 101B,A00,186593,Bahadori; Mohammad Yousef,81,0,100,19
1683299248991,MAE 105,A00,186594,Bandaru; Prabhakar,12,0,50,38
1683299250019,MAE 107,A00,186599,Pham; Hieu Tan,0,6,120,120
1683299251043,MAE 148,A01,186660,Silberman; Jack,3,0,16,13
1683299252071,MATH 10A,A01,188095,Staff,0,7,35,35
1683299253101,MATH 10B,A01,188097,Bowers; Adam R.,0,11,30,30
1683299253101,MATH 10B,A02,188099,Bowers; Adam R.,0,9,30,30
1683299253101,MATH 10B,B01,188104,Bowers; Adam R.,0,11,30,30
1683299253101,MATH 10B,B02,188106,Bowers; Adam R.,0,11,30,30
1683299254129,MATH 10C,A01,188111,Staff,0,18,30,30
1683299254129,MATH 10C,A02,188127,Staff,0,17,30,30
1683299254129,MATH 10C,A03,188131,Staff,0,17,30,30
1683299254129,MATH 10C,B01,188218,Staff,21,0,30,9
1683299254129,MATH 10C,B02,188244,Staff,13,0,30,17
1683299254129,MATH 10C,B03,188277,Staff,16,0,30,14
1683299255155,MATH 18,A01,188344,Bach; Quang Tran,18,0,30,12
1683299255155,MATH 18,A02,188345,Bach; Quang Tran,11,0,30,19
1683299255155,MATH 18,B01,188353,Bach; Quang Tran,10,0,30,20
1683299255155,MATH 18,B02,188354,Bach; Quang Tran,20,0,30,10
1683299256180,MATH 20A,A01,188374,Staff,13,0,35,22
1683299257204,MATH 20B,A01,188382,Ohm; Ko Woon,6,0,30,24
1683299257204,MATH 20B,A02,188383,Ohm; Ko Woon,24,0,30,6
1683299257204,MATH 20B,B01,188385,Ohm; Ko Woon,7,0,30,23
1683299257204,MATH 20B,B02,188392,Ohm; Ko Woon,22,0,30,8
1683299258229,MATH 20C,A01,188394,Harel; Guershon,10,0,30,20
1683299258229,MATH 20C,A02,188395,Harel; Guershon,13,0,30,17
1683299258229,MATH 20C,B01,188404,Harel; Guershon,3,0,30,27
1683299258229,MATH 20C,B02,188405,Harel; Guershon,19,0,30,11
1683299259258,MATH 20D,A01,188414,Hammock; Frances H,0,1,30,30
1683299259258,MATH 20D,A02,188415,Hammock; Frances H,4,0,30,26
1683299259258,MATH 20D,B01,188447,Hammock; Frances H,2,0,30,28
1683299259258,MATH 20D,B02,188486,Hammock; Frances H,8,0,30,22
1683299260282,MATH 20E,A01,188649,Staff,22,0,30,8
1683299260282,MATH 20E,A02,188650,Staff,23,0,30,7
1683299260282,MATH 20E,A03,188673,Staff,0,0,30,30
1683299261306,MATH 102,A01,188675,Staff,0,35,35,35
1683299262331,MATH 103B,A01,188681,Staff,4,0,35,31
1683299262331,MATH 103B,B01,188692,Staff,7,0,35,28
1683299263355,MATH 109,A01,188695,Salehi Golsefidy; Alireza,25,0,35,10
1683299263355,MATH 109,A02,188696,Salehi Golsefidy; Alireza,27,0,35,8
1683299264379,MATH 120A,A01,188698,Eggers; John Dietrich,5,0,35,30
1683299265404,MATH 142B,A01,188736,Ioana; Adrian,0,2,30,30
1683299265404,MATH 142B,A02,188741,Ioana; Adrian,0,1,30,30
1683299265404,MATH 142B,A03,188743,Ioana; Adrian,0,3,30,30
1683299266426,MATH 168A,A01,188790,Staff,0,8,35,35
1683299267451,MATH 170A,A01,188803,Nie; Jiawang,0,2,35,35
1683299267451,MATH 170A,A02,188811,Nie; Jiawang,0,0,35,35
1683299267451,MATH 170A,A03,188814,Nie; Jiawang,1,0,35,34
1683299267451,MATH 170A,A04,188815,Nie; Jiawang,14,0,35,21
1683299268476,MATH 193B,A01,188817,Staff,0,0,35,35
1683299268476,MATH 193B,A02,188818,Staff,5,0,35,30
1683299269500,MGT 4,A01,202857,Anderson; John Charles,62,0,80,18
1683299270529,MGT 12,A00,202858,Lindenberger; Wade Douglas,43,0,90,47
1683299271554,MGT 18,A00,202859,Staff,74,0,90,16
1683299272582,MGT 18GS,A00,202860,McKay; Michael J,13,0,28,15
1683299273609,MGT 45,A00,202861,Pecore; Joseph P.,14,0,90,76
1683299274636,MGT 100,A00,202863,Yavorsky; Daniel Ryan,28,0,90,62
1683299275664,MGT 103,A00,202864,Ehrich; Kristine R,0,16,90,90
1683299276691,MGT 112,A00,202865,Ehrich; Kristine R,15,0,90,75
1683299277719,MGT 121A,A00,202868,Staff,0,19,0,0
1683299278743,MGT 131B,A00,202869,Anderson; John Charles,59,0,90,31
1683299279771,MGT 136,A00,202871,Lindenberger; Wade Douglas,84,0,90,6
1683299280795,MGT 164,A00,202873,Staff,0,69,90,90
1683299281822,MGT 164GS,A00,202874,McKay; Mary A,13,0,28,15
1683299282846,MGT 180,A00,202875,Staff,0,51,90,90
1683299283870,MMW 11R,A01,205019,Herbst; Matthew,3,0,30,27
1683299283870,MMW 11R,A02,205026,Herbst; Matthew,29,0,30,1
1683299284896,MMW 15,A01,193512,Chang; Edmond Yi-Teh,0,9,28,28
1683299284896,MMW 15,A02,193513,Chang; Edmond Yi-Teh,0,5,28,28
1683299284896,MMW 15,A03,193514,Chang; Edmond Yi-Teh,0,5,28,28
1683299284896,MMW 15,A04,193515,Chang; Edmond Yi-Teh,0,4,28,28
1683299284896,MMW 15,A05,193516,Chang; Edmond Yi-Teh,0,4,28,28
1683299284896,MMW 15,A06,193517,Chang; Edmond Yi-Teh,0,5,28,28
1683299284896,MMW 15,B01,193519,Chang; Edmond Yi-Teh,0,4,28,28
1683299284896,MMW 15,B02,193520,Chang; Edmond Yi-Teh,0,5,28,28
1683299284896,MMW 15,B03,193521,Chang; Edmond Yi-Teh,0,4,28,28
1683299284896,MMW 15,B04,193522,Chang; Edmond Yi-Teh,0,4,28,28
1683299284896,MMW 15,B05,193523,Chang; Edmond Yi-Teh,0,5,28,28
1683299284896,MMW 15,B06,193524,Chang; Edmond Yi-Teh,0,4,28,28
1683299285920,MMW 122,A01,193526,Rahimi; Babak,0,14,28,28
1683299285920,MMW 122,A02,193527,Rahimi; Babak,0,14,28,28
1683299285920,MMW 122,A03,193528,Rahimi; Babak,0,0,0,0
1683299285920,MMW 122,A04,193529,Rahimi; Babak,0,0,0,0
1683299286946,MUS 1A,A01,186663,Staff,0,20,35,35
1683299287974,MUS 4,A01,186715,Staff,0,12,35,35
1683299289005,MUS 5R,A01,186796,Dubnov; Shlomo,0,16,35,35
1683299290035,MUS 6,A01,186798,Staff,0,3,25,25
1683299291062,MUS 7,A01,186830,Staff,12,0,35,23
1683299292090,MUS 8,A01,186930,Staff,0,25,35,35
1683299293118,MUS 15,A01,186932,Staff,0,15,35,35
1683299293118,MUS 15,B01,186934,Staff,0,14,35,35
1683299294145,MUS 80,A00,186935,Staff,2,0,20,18
1683299294145,MUS 80,B00,186936,Staff,25,0,25,0
1683299295173,NANO 11,A00,204702,Lipomi; Darren John,0,0,0,0
1683299296201,NANO 15,A01,204709,Yang; Kesong,0,1,0,0
1683299297225,NANO 114,A00,202069,Jahed Motlagh; Zeinab,3,0,10,7
1683299298249,PHIL 1,A00,186955,Grush; Rick Scott,32,0,40,8
1683299299276,PHIL 10,A01,186973,Grush; Rick Scott,29,0,35,6
1683299299276,PHIL 10,A02,186974,Grush; Rick Scott,33,0,35,2
1683299300302,PHIL 13,A01,186976,Staff,7,0,35,28
1683299300302,PHIL 13,A02,186977,Staff,16,0,35,19
1683299301330,PHIL 14,A01,186979,Staff,31,0,35,4
1683299301330,PHIL 14,A02,186986,Staff,32,0,35,3
1683299302354,PHIL 28,A01,186988,Staff,16,0,30,14
1683299302354,PHIL 28,A02,186989,Staff,1,0,30,29
1683299302354,PHIL 28,A03,186990,Staff,9,0,30,21
1683299302354,PHIL 28,A04,186991,Staff,26,0,30,4
1683299303385,PHIL 120,A00,186997,Staff,23,0,40,17
1683299304413,PHIL 137,A00,187003,Staff,9,0,40,31
1683299305436,PHIL 150,A00,187015,Staff,47,0,70,23
1683299306461,PHIL 167,A00,187021,Lamey; Andy M.,35,0,40,5
1683299307485,PHIL 174,A01,202226,Staff,17,0,20,3
1683299307485,PHIL 174,A02,202235,Staff,20,0,20,0
1683299308509,PHIL 191A,A00,258918,Staff,0,0,1,1
1683299309536,PHYS 1A,A00,187028,Staff,26,0,60,34
1683299310564,PHYS 1AL,001,187036,Staff,2,0,30,28
1683299310564,PHYS 1AL,002,187049,Staff,18,0,30,12
1683299311592,PHYS 1B,A00,187058,Staff,23,0,60,37
1683299312620,PHYS 1BL,001,187064,Staff,0,0,30,30
1683299312620,PHYS 1BL,002,187070,Staff,6,0,30,24
1683299313645,PHYS 1C,A00,187082,Staff,32,0,120,88
1683299314674,PHYS 1CL,001,187088,Staff,0,9,30,30
1683299314674,PHYS 1CL,002,187089,Staff,0,2,30,30
1683299314674,PHYS 1CL,009,262693,Staff,12,0,30,18
1683299315700,PHYS 2B,A01,187097,Staff,54,0,115,61
1683299316726,PHYS 2C,A01,187099,Staff,67,0,115,48
1683299317752,PHYS 2CL,A01,187101,Staff,5,0,28,23
1683299317752,PHYS 2CL,A02,187102,Staff,15,0,28,13
1683299318780,PHYS 2D,A01,187123,Shotwell; Brian,95,0,115,20
1683299319809,PHYS 4B,A01,187133,Grinstein; Benjamin,35,0,50,15
1683299320833,POLI 10,A00,188819,Staff,0,3,50,50
1683299321860,POLI 11,A00,188827,Staff,43,0,50,7
1683299322884,POLI 13R,A00,188828,Staff,0,1,20,20
1683299323909,POLI 27,A01,188830,Elgin; Samuel Zincke,0,1,70,70
1683299324933,POLI 30,A00,188832,Desposato; Scott,33,0,50,17
1683299325960,POLI 102F,A00,188834,Staff,3,0,40,37
1683299326984,POLI 104A,A00,188852,Staff,14,0,30,16
1683299328008,POLI 104I,A00,188853,Staff,0,6,20,20
1683299329032,POLI 110B,A00,188854,Wiens; David,7,0,20,13
1683299330055,POLI 112A,A00,188855,Wiens; David,5,0,30,25
1683299331079,POLI 117R,A00,188856,Forman; Fonna,0,11,20,20
1683299332102,POLI 118,A00,188857,Ingham; Sean,8,0,20,12
1683299333128,POLI 120G,A00,188858,Staff,9,0,30,21
1683299334152,POLI 131CR,A00,188863,Hoston; Germaine,24,0,50,26
1683299335176,POLI 133,A00,188864,Nellis; Gareth Hb,44,0,50,6
1683299336200,POLI 134D,A00,188865,Desposato; Scott,27,0,30,3
1683299337225,POLI 142A,A00,188871,Gartzke; Erik,22,0,50,28
1683299338248,POLI 142K,A00,188874,Staff,38,0,50,12
1683299339273,POLI 143,A00,188940,Gartzke; Erik,16,0,30,14
1683299340297,POLI 153,A00,188943,Staff,3,0,20,17
1683299341326,POLI 160AA,A00,188944,Staff,13,0,40,27
1683299342358,POLI 170A,A00,188945,Staff,11,0,30,19
1683299344412,PSYC 1,A00,188952,Staff,38,0,90,52
1683299345436,PSYC 2,B00,188953,Staff,20,0,35,15
1683299346461,PSYC 6,A00,188970,Staff,47,0,60,13
1683299347485,PSYC 7,A00,188973,Staff,37,0,45,8
1683299348513,PSYC 60,A01,188980,Rickard; Timothy C.,43,0,60,17
1683299349539,PSYC 70,A01,189001,Steiner; Eric Tomas,24,0,45,21
1683299350563,PSYC 100,A00,189005,Lacefield; Katharine I,0,99,120,120
1683299351587,PSYC 102,A00,189008,Staff,10,0,30,20
1683299352666,PSYC 106,B00,189026,Gorman; Michael R.,37,0,60,23
1683299353690,PSYC 114,B01,189033,Winkielman; Piotr,0,32,30,30
1683299354715,PSYC 131,A00,189036,Anagnostaras; Stephan,0,43,60,60
1683299355740,PSYC 136,A00,189041,Lowe; Angela Beth,0,7,25,25
1683299356768,PSYC 137,A00,189057,Winkielman; Piotr,0,34,25,25
1683299357795,PSYC 144,A00,189107,Wixted; John T,0,7,50,50
1683299359869,PSYC 162,A00,189142,Staff,0,8,85,85
1683299360894,PSYC 172,A00,189144,Gorman; Michael R.,0,7,30,30
1683299362948,PSYC 179,A00,189146,Lacefield; Katharine I,0,84,120,120
1683299363973,PSYC 181,A00,189147,Anagnostaras; Stephan,0,44,90,90
1683299365001,PSYC 190R,A00,189148,Barner; David A.,0,22,80,80
1683299366026,PSYC 191,A00,189275,Rickard; Timothy C.,0,7,25,25
1683299367049,PSYC 193,A00,189276,Chapman; Eddie Nathaniel,0,1,0,4
1683299368076,PSYC 193L,A01,189281,Lowe; Angela Beth,12,0,20,8
1683299368076,PSYC 193L,B01,189285,Staff,28,0,35,7
1683299369100,RELI 149,A00,187137,Rahimi; Babak,7,0,40,33
1683299370128,SE 9,A01,187315,Staff,0,2,18,18
1683299371152,SE 101B,A00,187409,Staff,24,0,30,6
1683299372177,SE 110B,A00,187444,Staff,10,0,40,30
1683299373203,SE 130B,A00,187449,Staff,31,0,40,9
1683299374227,SE 150A,A00,187516,Staff,9,0,20,11
1683299375253,SE 154,A00,187528,Staff,30,0,50,20
1683299376278,SIO 3,A01,258171,Staff,35,0,40,5
1683299377303,SIO 10,A00,187144,Cook; Geoffrey W,0,3,75,75
1683299378332,SIO 45,A00,187152,Cook; Geoffrey W,1,0,100,99
1683299379356,SIO 109R,A00,194486,Staff,0,3,20,20
1683299381411,SIO 187,A01,187233,Kacev; David,12,0,40,28
1683299382441,SOCI 1,A01,258656,Thorpe; Charles Robert,28,0,30,2
1683299382441,SOCI 1,A02,258658,Thorpe; Charles Robert,30,0,30,0
1683299382441,SOCI 1,A03,258661,Thorpe; Charles Robert,25,0,25,0
1683299382441,SOCI 1,A04,258666,Thorpe; Charles Robert,22,0,25,3
1683299382441,SOCI 1,A05,258897,Thorpe; Charles Robert,23,0,25,2
1683299382441,SOCI 1,A06,258898,Thorpe; Charles Robert,25,0,25,0
1683299383470,SOCI 30,A01,258903,Pardo Guerra; Juan Pablo,16,0,30,14
1683299384497,SOCI 102,A00,258904,Staff,9,0,25,16
1683299385522,SOCI 106,A00,258905,Staff,19,0,25,6
1683299386547,SOCI 111,A00,258907,Ribas Norris; Janet Vanesa,26,0,30,4
1683299387575,SOCI 121R,A00,258908,Pardo Guerra; Juan Pablo,11,0,30,19
1683299388599,SOCI 126,A01,203330,Staff,14,0,20,6
1683299389627,SOCI 131,A00,258909,Thorpe; Charles Robert,31,0,60,29
1683299390651,SOCI 135,A00,258910,Payne; Christine Anna,0,9,30,30
1683299391675,SOCI 157,A00,258911,Staff,13,0,30,17
1683299392702,SOCI 184,A00,258912,Staff,26,0,30,4
1683299393729,SOCI 188D,A00,258913,Staff,21,0,30,9
1683299394754,SYN 2,001,187529,Staff,9,0,16,7
1683299394754,SYN 2,002,201452,Staff,0,18,16,16
1683299394754,SYN 2,003,201469,Staff,3,0,16,13
1683299395779,SYN 100,A01,187531,Staff,0,9,20,20
1683299395779,SYN 100,B01,201491,Staff,0,12,20,20
1683299396803,TDAC 1,A00,189286,Walsh; Kim C.,3,0,20,17
1683299396803,TDAC 1,B00,189287,Harting; Carla Kelso,11,0,20,9
1683299397831,TDAC 101,A00,189300,Walsh; Kim C.,16,0,20,4
1683299397831,TDAC 101,B00,189301,Harting; Carla Kelso,18,0,20,2
1683299398857,TDAC 102,A00,189304,Basso; Beatrice,14,0,20,6
1683299399888,TDAC 108,A00,189305,Staff,18,0,20,2
1683299400913,TDDE 131,A00,189310,Staff,19,0,20,1
1683299400913,TDDE 131,B00,189314,Staff,19,0,20,1
1683299400913,TDDE 131,C00,189315,Staff,48,0,50,2
1683299400913,TDDE 131,D00,189316,Staff,14,0,15,1
1683299400913,TDDE 131,E00,204841,Staff,20,0,20,0
1683299401941,TDGE 10,A00,189289,Staff,30,0,50,20
1683299401941,TDGE 10,B00,189290,Havis; Allan,2,0,50,48
1683299402973,TDGE 11,A00,189291,Fulton; Julia,0,3,50,50
1683299402973,TDGE 11,B00,189292,Staff,20,0,25,5
1683299402973,TDGE 11,C00,260270,Staff,0,0,0,0
1683299403999,TDGE 25,A00,189294,Staff,3,0,20,17
1683299405032,TDGE 124,A00,189318,Fulton; Julia,0,8,50,50
1683299406057,TDGE 125,A00,189319,Staff,13,0,25,12
1683299406057,TDGE 125,B00,189320,Staff,23,0,25,2
1683299407079,TDGE 127,A00,189322,Havis; Allan,0,0,50,50
1683299408106,TDHT 101,A00,189323,Staff,18,0,25,7
1683299408106,TDHT 101,B00,189324,Staff,25,0,25,0
1683299409130,TDHT 102,A00,189325,Staff,49,0,50,1
1683299410157,TDMV 1,A00,189295,Arcidiacono; Kristin,20,0,30,10
1683299410157,TDMV 1,B00,189296,Caligagan; Maria T.,24,0,30,6
1683299411184,TDMV 2,A00,189297,Sammartano; Tonnie,28,0,30,2
1683299411184,TDMV 2,B00,189299,Arcidiacono; Kristin,24,0,30,6
1683299412211,TDMV 3,A00,204998,Rincon; Alicia,22,0,30,8
1683299413236,TDMV 120,A00,189458,Sammartano; Tonnie,28,0,30,2
1683299414264,TDMV 138,A00,189541,Jun; Grace Shin Hae,22,0,40,18
1683299415291,TDMV 142,A00,189717,Caligagan; Tony,23,0,30,7
1683299415291,TDMV 142,B00,189718,Caligagan; Maria T.,25,0,30,5
1683299416319,TMC 2,A01,187533,Staff,25,0,25,0
1683299416319,TMC 2,A02,187534,Staff,25,0,25,0
1683299417347,USP 1,A01,187536,Kwak; Nancy,0,16,25,25
1683299418375,USP 5,A01,187538,Staff,9,0,25,16
1683299419400,USP 101,A00,199253,Staff,0,4,0,0
1683299420428,USP 124,A00,187562,Boomhower; Matthew Charles,1,0,30,29
1683299421453,USP 138,A00,187582,Staff,20,0,25,5
1683299422479,USP 152,A01,187597,Staff,4,0,25,21
1683299423502,USP 153,A00,187598,Staff,19,0,25,6
1683299424528,USP 168,A00,187607,Kwak; Nancy,2,0,5,3
1683299425555,USP 173,A00,187619,Staff,4,0,25,21
1683299426583,USP 181,A00,187638,Staff,0,0,25,25
1683299427610,VIS 103,A00,187650,Cruz; Edwin Teddy,23,0,75,52
1683299428636,VIS 110D,A00,187669,Staff,12,0,22,10
1683299429661,VIS 127C,A00,187720,Shen; Kuiyi,68,0,146,78
1683299430688,VIS 149,A00,187731,Yoldas; Pinar,0,14,22,22
1683299431715,VIS 151,A01,188091,Staff,22,0,34,12
1683299431715,VIS 151,A02,188092,Staff,11,0,34,23
1683299432741,VIS 160B,A00,188093,Stalbaum; Brett,0,0,10,10
1683299434803,WCWP 10B,A00,201720,Staff,10,0,15,5
1683299434803,WCWP 10B,B00,201722,Staff,8,0,15,7
1683299435827,WCWP 100,A00,201725,Gagnon; Jeffrey C,0,0,2,2
1683299435827,WCWP 100,B00,201727,Staff,0,4,15,15
1683299438927,ANBI 133,A00,258401,Wilder; Linnea Lorene,34,0,40,6
1683299439950,ANBI 140,A00,258395,Hrvoj Mihic; Branka,18,0,25,7
1683299440975,ANSC 120,A00,258402,Bialecki; Jon Anthony,27,0,40,13
1683299441999,ANSC 144,A00,258400,Staff,14,0,40,26
1683299444047,ANSC 166,A00,258396,Parish; Steven Martin,157,0,175,18
1683299445074,ANSC 180,A00,193533,Staff,9,0,20,11
1683299446098,ANSC 188,A00,258397,Jassal; Aftab,33,0,40,7
1683299447125,ANTH 3,A01,258316,Staff,23,0,30,7
1683299448151,ANTH 5,A00,258394,Semendeferi; Ekaterini,16,0,20,4
1683299449175,ANTH 21,A01,258331,Staff,9,0,40,31
1683299450199,ANTH 103,A00,258398,Varma; Saiba,15,0,25,10
1683299451229,AWP 10,001,202034,Staff,0,0,0,0
1683299451229,AWP 10,002,202035,Staff,0,0,0,0
1683299451229,AWP 10,003,202036,Staff,0,0,0,0
1683299451229,AWP 10,004,202037,Staff,0,0,0,0
1683299451229,AWP 10,005,202038,Staff,0,0,0,0
1683299451229,AWP 10,006,202039,Staff,0,0,0,0
1683299451229,AWP 10,007,202040,Staff,0,0,0,0
1683299451229,AWP 10,008,202041,Staff,0,0,0,0
1683299451229,AWP 10,009,202042,Staff,0,0,0,0
1683299451229,AWP 10,010,202043,Staff,0,0,0,0
1683299451229,AWP 10,011,202044,Staff,0,0,0,0
1683299451229,AWP 10,012,202045,Staff,0,0,0,0
1683299451229,AWP 10,013,202046,Staff,0,0,0,0
1683299451229,AWP 10,014,202047,Staff,0,0,0,0
1683299451229,AWP 10,015,202048,Staff,0,0,0,0
1683299451229,AWP 10,016,202049,Staff,0,0,0,0
1683299451229,AWP 10,017,202050,Staff,0,0,0,0
1683299451229,AWP 10,018,202051,Staff,0,0,0,0
1683299451229,AWP 10,019,202052,Staff,0,0,0,0
1683299451229,AWP 10,020,202053,Staff,0,0,0,0
1683299451229,AWP 10,021,202054,Staff,0,0,0,0
1683299451229,AWP 10,022,202055,Staff,0,0,0,0
1683299451229,AWP 10,023,202056,Staff,0,0,0,0
1683299451229,AWP 10,024,202057,Staff,0,0,0,0
1683299451229,AWP 10,025,202058,Staff,0,0,0,0
1683299451229,AWP 10,026,202059,Staff,0,0,0,0
1683299452253,AWP 102,001,202032,Staff,0,0,0,0
1683299452253,AWP 102,002,202033,Staff,0,0,0,0
1683299453277,BENG 100,A01,254234,Taylor Amos; Alyssa C,31,0,40,9
1683299454303,BENG 196,001,270013,Engler; Adam J.,9999,0,9999,0
1683299455328,BICD 100R,A01,202018,Smith; Laurie,0,7,32,32
1683299455328,BICD 100R,A02,202019,Smith; Laurie,0,2,32,32
1683299455328,BICD 100R,A03,202020,Smith; Laurie,0,1,32,32
1683299455328,BICD 100R,A04,202021,Smith; Laurie,8,0,32,24
1683299455328,BICD 100R,A05,202022,Smith; Laurie,12,0,32,20
1683299456415,BICD 136,A01,193242,Gustafson-Brown; Cindy,0,2,32,32
1683299456415,BICD 136,A02,193244,Gustafson-Brown; Cindy,15,0,32,17
1683299457441,BIEB 102,A01,193249,Butler; Shannon Rhey,0,2,32,32
1683299457441,BIEB 102,A02,193251,Butler; Shannon Rhey,0,0,32,32
1683299457441,BIEB 102,A03,193253,Butler; Shannon Rhey,0,1,32,32
1683299457441,BIEB 102,A04,193255,Butler; Shannon Rhey,17,0,32,15
1683299457441,BIEB 102,A05,193265,Butler; Shannon Rhey,26,0,32,6
1683299457441,BIEB 102,A06,193269,Butler; Shannon Rhey,16,0,32,16
1683299459493,BIEB 150,A01,193274,Staff,0,0,32,32
1683299459493,BIEB 150,A02,193285,Staff,24,0,32,8
1683299460520,BIEB 194,A00,193286,Kurle; Carolyn M.,22,0,32,10
1683299461551,BILD 1,A01,192291,Staff,16,0,32,16
1683299461551,BILD 1,A02,192292,Staff,30,0,32,2
1683299461551,BILD 1,B01,192520,Reuther; Keefe,0,1,0,0
1683299461551,BILD 1,B02,192532,Reuther; Keefe,0,1,0,0
1683299462578,BILD 3,A01,192556,Butler; Shannon Rhey,0,0,32,32
1683299462578,BILD 3,A02,192581,Butler; Shannon Rhey,5,0,32,27
1683299462578,BILD 3,A03,192611,Butler; Shannon Rhey,23,0,32,9
1683299462578,BILD 3,A04,192612,Butler; Shannon Rhey,25,0,32,7
1683299462578,BILD 3,A05,192613,Butler; Shannon Rhey,27,0,32,5
1683299462578,BILD 3,A06,192679,Butler; Shannon Rhey,27,0,32,5
1683299462578,BILD 3,A07,192682,Butler; Shannon Rhey,22,0,32,10
1683299463603,BILD 4,A01,192836,Reuther; Keefe,1,0,24,23
1683299463603,BILD 4,A02,193044,Reuther; Keefe,4,0,24,20
1683299464626,BILD 10,A01,193142,Gustafson-Brown; Cindy,31,0,32,1
1683299464626,BILD 10,A02,193149,Gustafson-Brown; Cindy,31,0,32,1
1683299465651,BIMM 100,A01,193301,Staff,0,6,32,32
1683299465651,BIMM 100,A02,193312,Staff,0,5,32,32
1683299465651,BIMM 100,A03,193323,Staff,0,8,32,32
1683299466681,BIMM 101,A01,193329,McDonnell; Lisa Marie,0,3,24,24
1683299466681,BIMM 101,A02,193339,McDonnell; Lisa Marie,0,2,24,24
1683299466681,BIMM 101,B01,193354,McDonnell; Lisa Marie,0,3,24,24
1683299466681,BIMM 101,B02,193357,McDonnell; Lisa Marie,0,3,24,24
1683299467710,BIMM 110,A01,193377,Tat; John,0,11,32,32
1683299467710,BIMM 110,A02,193378,Tat; John,1,9,32,31
1683299468738,BIMM 120,A01,206116,Staff,0,0,32,32
1683299468738,BIMM 120,A02,206117,Staff,8,0,32,24
1683299468738,BIMM 120,A03,206121,Staff,21,0,32,11
1683299469766,BIPN 100,A01,193393,Park; Ji Young,0,14,32,32
1683299469766,BIPN 100,A02,193402,Park; Ji Young,0,12,32,32
1683299469766,BIPN 100,A03,193413,Park; Ji Young,0,14,32,32
1683299469766,BIPN 100,A04,193414,Park; Ji Young,0,13,32,32
1683299470794,BIPN 102,A01,193429,Staff,0,0,32,32
1683299470794,BIPN 102,A02,193438,Staff,23,0,32,9
1683299471818,BIPN 106,A01,193450,Reyes Gonzalez; Catalina,0,2,40,40
1683299472848,BIPN 134,A01,193465,Cooke; James Edward,0,0,32,32
1683299472848,BIPN 134,A02,193474,Cooke; James Edward,27,0,32,5
1683299472848,BIPN 134,A03,193485,Cooke; James Edward,29,0,32,3
1683299472848,BIPN 134,A04,193486,Cooke; James Edward,21,0,32,11
1683299472848,BIPN 134,A05,193491,Cooke; James Edward,31,0,32,1
1683299472848,BIPN 134,A06,193501,Cooke; James Edward,30,0,32,2
1683299472848,BIPN 134,A07,193510,Cooke; James Edward,29,0,32,3
1683299474902,BISP 194,A00,222522,Staff,16,0,32,16
1683299475929,CAT 124,A01,202407,Staff,20,0,25,5
1683299476954,CAT 125,A00,202408,Marchisotto; Jennifer Anne,4,0,20,16
1683299477979,CAT 125R,A00,202409,Smith; Lauryn Alissa,0,11,20,20
1683299477979,CAT 125R,B00,202410,Morales; Celeste Georgianna,0,11,20,20
1683299477979,CAT 125R,C00,202411,Irwin; Matthew Joseph,0,10,20,20
1683299479003,CENG 15,A01,204712,Yang; Kesong,0,1,0,0
1683299480028,CENG 114,A00,202070,Jahed Motlagh; Zeinab,5,0,20,15
1683299481054,CGS 105,A00,185477,Wesling; Megan E.,24,0,40,16
1683299482080,CGS 106,A00,185494,Staff,13,0,22,9
1683299483106,CGS 108,A00,185495,Staff,14,0,20,6
1683299484133,CGS 114,A00,185496,Staff,13,0,18,5
1683299485157,CGS 119,A00,185501,Staff,15,0,20,5
1683299486184,CGS 120,A00,185511,Staff,13,0,20,7
1683299487212,CHEM 4,A01,184675,Bussey; Thomas J,96,0,100,4
1683299488237,CHEM 6A,A01,184677,Staff,35,0,60,25
1683299489261,CHEM 6B,A01,184679,Staff,65,0,100,35
1683299490289,CHEM 6C,A01,184681,Bussey; Thomas J,1,0,50,49
1683299490289,CHEM 6C,A02,184682,Bussey; Thomas J,34,0,50,16
1683299491318,CHEM 40A,A01,184684,Albizati; Kim F.,37,0,100,63
1683299492343,CHEM 40B,A01,184686,Albizati; Kim F.,0,20,100,100
1683299493367,CHEM 41B,A01,184690,Staff,52,0,100,48
1683299494389,COGS 3,A01,184715,Boyle; Mary E. T.,0,25,40,40
1683299495413,COGS 14B,A01,185172,Staff,0,15,38,38
1683299496437,COGS 18,A01,184736,Staff,20,0,80,60
1683299497465,COGS 100,A01,184932,Staff,0,5,73,73
1683299498493,COGS 101A,A01,184935,Staff,0,38,30,30
1683299499517,COGS 101B,A01,184944,Staff,0,2,30,30
1683299500544,COGS 101C,A01,184946,Staff,0,12,30,30
1683299501572,COGS 102A,A01,184951,Johnson; Christine M.,2,0,40,38
1683299502602,COGS 107B,A01,184953,Mooshagian; Eric Frederick,0,50,40,40
1683299503626,COGS 118B,A01,184959,Gupta; Anjum,0,48,40,40
1683299504650,COGS 153,A00,184961,Staff,0,15,30,30
1683299505674,COGS 177,A00,184962,Staff,0,21,30,30
1683299506698,COGS 187A,A01,184969,Boyle; Mary E. T.,0,17,40,40
1683299507723,COMM 10,A01,185174,Staff,0,5,25,25
1683299507723,COMM 10,A02,185189,Staff,0,5,25,25
1683299507723,COMM 10,A03,269821,Staff,0,0,0,0
1683299508747,COMM 100B,A01,185475,Staff,0,0,0,2
1683299508747,COMM 100B,A02,185476,Staff,14,0,25,11
1683299509772,COMM 100C,A01,185314,Staff,1,0,25,24
1683299509772,COMM 100C,A02,185327,Staff,19,0,25,6
1683299510798,COMM 110M,A00,185349,Staff,2,0,40,38
1683299511822,COMM 113T,A00,185352,Staff,25,0,40,15
1683299512846,COMM 114I,A00,185353,Staff,33,0,40,7
1683299513870,COMM 131,A00,185354,Staff,19,0,30,11
1683299514895,CSE 8A,A50,185358,Cao; Yingjun,0,46,10,10
1683299515919,CSE 8B,A01,185362,Staff,1,47,50,49
1683299516946,CSE 11,A01,185416,Cao; Yingjun,0,93,10,10
1683299517974,CSE 20,A01,185445,Briones; Jor-el Thomas Caparas,5,0,25,20
1683299518998,CSE 21,A01,185447,Staff,10,0,50,40
1683299520026,CSE 101,A01,185451,Staff,0,12,50,50
1683299520026,CSE 101,B01,185453,Jones; Miles E,0,11,50,50
1683299522089,CSE 141,A01,185458,Eldon; John,20,0,100,80
1683299523113,CSE 141L,A01,185461,Eldon; John,12,0,100,88
1683299524139,CSE 142,A01,185463,Staff,35,0,60,25
1683299524139,CSE 142,B01,201355,Staff,0,6,60,60
1683299525164,CSE 142L,A01,185470,Staff,35,0,60,25
1683299525164,CSE 142L,B01,201417,Staff,0,5,60,60
1683299526187,CSE 190,A00,201433,Staff,32,0,49,17
1683299527211,DOC 1,A01,259136,Strom; Megan C.,8,0,15,7
1683299527211,DOC 1,A02,259137,Strom; Megan C.,14,0,15,1
1683299527211,DOC 1,A03,259138,Strom; Megan C.,14,0,15,1
1683299527211,DOC 1,A04,259139,Strom; Megan C.,14,0,15,1
1683299528235,DOC 100D,A00,259140,Pass; Natalye Joann,17,0,25,8
1683299529260,DSGN 1,A01,184749,Rill; Bryan,0,24,30,30
1683299530284,DSGN 100,A01,185168,Staff,0,2,25,25
1683299531309,ECE 5,A01,185626,Morris; Karcher William,0,10,0,0
1683299532333,ECE 101,A01,185628,Staff,17,0,70,53
1683299533362,ECE 107,A01,185635,Baghdadchi; Saharnaz,0,0,20,20
1683299533362,ECE 107,A02,185638,Baghdadchi; Saharnaz,4,0,20,16
1683299534389,ECE 148,A01,185647,Silberman; Jack,1,0,16,15
1683299535417,ECON 1,A01,185537,Crane; Meredith Helen,54,0,70,16
1683299536440,ECON 3,A01,185549,Crane; Meredith Helen,33,0,70,37
1683299537467,ECON 4,A01,203354,Anderson; John Charles,0,4,10,10
1683299538493,ECON 100A,A01,185574,Staff,0,4,40,40
1683299539522,ECON 100B,A01,185576,Staff,0,22,40,40
1683299540550,ECON 100C,A01,185589,Newhouse; Herbert S,30,0,70,40
1683299541576,ECON 105,A00,185608,Vespa; Emanuel Ignacio,19,0,35,16
1683299542604,ECON 109,A01,185610,Shishkin; Denis,10,0,35,25
1683299543629,ECON 110A,A01,185612,Staff,11,0,40,29
1683299544653,ECON 120A,A01,185615,Staff,20,0,40,20
1683299545677,ECON 120C,A01,185617,Sun; Yixiao,0,20,70,70
1683299546701,ECON 144,A00,203346,Squires; Dale E,3,0,35,32
1683299547731,ECON 171,A01,203349,Newhouse; Herbert S,0,1,35,35
1683299548759,ECON 173A,A01,185621,Toda; Alexis Akira,21,0,35,14
1683299549785,EDS 25,A01,202413,Staff,0,1,0,0
1683299549785,EDS 25,A02,202414,Staff,0,1,0,0
1683299549785,EDS 25,A03,202415,Staff,0,0,0,0
1683299549785,EDS 25,A04,202416,Staff,0,1,0,0
1683299549785,EDS 25,A05,202439,Staff,0,0,0,0
1683299549785,EDS 25,A06,202440,Staff,0,0,0,0
1683299549785,EDS 25,B01,202631,Staff,0,0,0,0
1683299549785,EDS 25,B02,202632,Staff,0,0,0,0
1683299549785,EDS 25,B03,202639,Staff,0,0,0,0
1683299549785,EDS 25,B04,202640,Staff,0,0,0,0
1683299549785,EDS 25,B05,202643,Staff,0,0,0,0
1683299549785,EDS 25,B06,202644,Staff,0,0,0,0
1683299550813,EDS 38,A01,202659,Black; Alison Michelle,24,0,25,1
1683299551839,EDS 115,A00,202652,Staff,17,0,30,13
1683299552867,EDS 125,A00,202649,Staff,14,0,30,16
1683299553890,EDS 126,A01,203332,Staff,30,0,30,0
1683299554914,EDS 139,A00,202838,Staff,17,0,25,8
1683299555938,EDS 146,A01,202655,Staff,15,0,25,10
1683299556964,ENG 15,A00,185667,Staff,0,1,0,0
1683299556964,ENG 15,B00,185672,Staff,0,0,0,0
1683299556964,ENG 15,C00,185675,Staff,0,0,0,0
1683299556964,ENG 15,D00,185682,Staff,0,0,0,0
1683299556964,ENG 15,E00,185684,Staff,0,0,0,0
1683299557992,ETHN 103,A00,185710,Staff,0,3,35,35
1683299559019,ETHN 103A,A00,199228,Man; Simeon S,3,0,9,6
1683299560100,ETHN 109,A00,185711,Staff,18,0,35,17
1683299561127,ETHN 142,A00,185726,Staff,0,4,30,30
1683299562152,ETHN 163J,A00,199229,Man; Simeon S,6,0,8,2
1683299563175,ETHN 168,A00,185727,Staff,8,0,10,2
1683299564203,ETHN 182,A00,185728,Staff,1,0,35,34
1683299565230,ETHN 183,A00,185737,Staff,8,0,18,10
1683299566256,GLBH 111,A01,209361,Burgos; Jose L.,0,0,0,0
1683299568309,HIEU 104,A00,185792,Staff,16,0,20,4
1683299569334,HIEU 115,A00,185800,Staff,1,0,20,19
1683299570361,HIEU 128,A00,185801,Staff,0,7,20,20
1683299571390,HIEU 147,A00,185802,Staff,16,0,20,4
1683299572417,HIEU 154,A00,185823,Staff,12,0,20,8
1683299573443,HILA 102,A00,185826,Staff,13,0,20,7
1683299574467,HILD 2C,A01,185778,Staff,0,12,20,20
1683299575492,HILD 7B,A01,185780,Kwak; Nancy,0,15,32,32
1683299575492,HILD 7B,A02,185781,Kwak; Nancy,0,18,32,32
1683299576519,HILD 30,A01,185791,Staff,14,0,20,6
1683299577544,HISC 119,A00,185830,Golan; Tal,0,9,20,20
1683299578570,HITO 156GS,A00,185831,Patterson; Patrick H.,0,0,0,23
1683299579594,HIUS 103,A00,185832,Man; Simeon S,0,7,20,20
1683299580618,HIUS 117,A00,185836,Kwak; Nancy,2,0,20,18
1683299581646,HIUS 125,A00,185840,Man; Simeon S,0,0,23,23
1683299582670,HIUS 149,A00,185845,Staff,0,0,20,20
1683299583695,HUM 3,A01,185882,Zavodny; Tatiana Sophia,0,6,50,50
1683299583695,HUM 3,B01,185899,Caldwell; Michael Alan,0,19,50,50
1683299584720,HUM 3GS,A00,185900,Patterson; Patrick H.,0,0,0,23
1683299585746,HUM 4,A01,185938,Zroka; Amy Liane,31,0,50,19
1683299585746,HUM 4,B01,185956,Watkins; Eric,0,2,50,50
1683299585746,HUM 4,B02,202209,Watkins; Eric,0,1,50,50
1683299585746,HUM 4,B03,202210,Watkins; Eric,0,0,50,50
1683299586771,HUM 5,A01,185958,West; Geoffrey Scott,5,0,50,45
1683299586771,HUM 5,A02,202215,West; Geoffrey Scott,0,0,50,50
1683299587796,INTL 190,A00,185959,Gagnon; Jeffrey C,0,0,0,9
1683299587796,INTL 190,B00,185960,Lettieri; Michael Joseph,0,0,0,1
1683299588820,JAPN 180,A00,254509,Staff,0,1,25,25
1683299589849,LATI 10,A01,202853,Kennemore; Amy Michelle,5,0,35,30
1683299589849,LATI 10,A02,202854,Kennemore; Amy Michelle,1,0,35,34
1683299589849,LATI 10,A03,270054,Kennemore; Amy Michelle,30,0,30,0
1683299590877,LATI 180,A00,202855,Kennemore; Amy Michelle,11,0,20,9
1683299591903,LAWS 101,A00,201767,Golan; Tal,0,7,40,40
1683299592932,LIFR 1C,A00,185961,Staff,6,0,20,14
1683299593960,LIFR 1CX,A00,185962,Staff,7,0,20,13
1683299594986,LIFR 1D,A00,185963,Staff,9,0,20,11
1683299596009,LIFR 1DX,A00,185964,Staff,9,0,20,11
1683299597034,LIGN 101,A01,186039,Staff,43,0,50,7
1683299598061,LIGN 165,A00,186040,Staff,18,0,50,32
1683299599088,LTCS 108,A00,186041,Staff,6,0,10,4
1683299600113,LTCS 119,A00,186042,Staff,16,0,20,4
1683299601136,LTCS 130,A00,186043,Wesling; Megan E.,15,0,25,10
1683299603187,LTEA 138,A00,186119,Staff,14,0,40,26
1683299604212,LTEN 124,A00,186148,Staff,6,0,25,19
1683299605233,LTEN 178,A00,186149,Staff,7,0,15,8
1683299606259,LTEN 181,A00,186150,Blanco; John D,33,0,40,7
1683299607283,LTWL 120,A00,186160,Staff,20,0,25,5
1683299608306,LTWL 165,A00,186161,Staff,22,0,25,3
1683299609328,LTWR 100,A00,186162,Staff,0,4,15,15
1683299610354,LTWR 102,A00,186163,Doller; Ben,5,0,15,10
1683299611380,MAE 8,A01,186412,Staff,0,0,0,0
1683299612405,MAE 30B,A00,186445,Bahadori; Mohammad Yousef,83,0,100,17
1683299613429,MAE 40,A00,186592,Bewley; Thomas R,9,0,50,41
1683299614452,MAE 101B,A00,186593,Bahadori; Mohammad Yousef,81,0,100,19
1683299615476,MAE 105,A00,186594,Bandaru; Prabhakar,12,0,50,38
1683299616501,MAE 107,A00,186599,Pham; Hieu Tan,0,6,120,120
1683299617525,MAE 148,A01,186660,Silberman; Jack,3,0,16,13
1683299618552,MATH 10A,A01,188095,Staff,0,7,35,35
1683299619577,MATH 10B,A01,188097,Bowers; Adam R.,0,11,30,30
1683299619577,MATH 10B,A02,188099,Bowers; Adam R.,0,9,30,30
1683299619577,MATH 10B,B01,188104,Bowers; Adam R.,0,11,30,30
1683299619577,MATH 10B,B02,188106,Bowers; Adam R.,0,11,30,30
1683299620605,MATH 10C,A01,188111,Staff,0,18,30,30
1683299620605,MATH 10C,A02,188127,Staff,0,17,30,30
1683299620605,MATH 10C,A03,188131,Staff,0,17,30,30
1683299620605,MATH 10C,B01,188218,Staff,21,0,30,9
1683299620605,MATH 10C,B02,188244,Staff,13,0,30,17
1683299620605,MATH 10C,B03,188277,Staff,16,0,30,14
1683299621627,MATH 18,A01,188344,Bach; Quang Tran,18,0,30,12
1683299621627,MATH 18,A02,188345,Bach; Quang Tran,11,0,30,19
1683299621627,MATH 18,B01,188353,Bach; Quang Tran,10,0,30,20
1683299621627,MATH 18,B02,188354,Bach; Quang Tran,20,0,30,10
1683299622651,MATH 20A,A01,188374,Staff,13,0,35,22
1683299623676,MATH 20B,A01,188382,Ohm; Ko Woon,6,0,30,24
1683299623676,MATH 20B,A02,188383,Ohm; Ko Woon,24,0,30,6
1683299623676,MATH 20B,B01,188385,Ohm; Ko Woon,7,0,30,23
1683299623676,MATH 20B,B02,188392,Ohm; Ko Woon,22,0,30,8
1683299624705,MATH 20C,A01,188394,Harel; Guershon,10,0,30,20
1683299624705,MATH 20C,A02,188395,Harel; Guershon,13,0,30,17
1683299624705,MATH 20C,B01,188404,Harel; Guershon,3,0,30,27
1683299624705,MATH 20C,B02,188405,Harel; Guershon,19,0,30,11
1683299625734,MATH 20D,A01,188414,Hammock; Frances H,0,1,30,30
1683299625734,MATH 20D,A02,188415,Hammock; Frances H,4,0,30,26
1683299625734,MATH 20D,B01,188447,Hammock; Frances H,2,0,30,28
1683299625734,MATH 20D,B02,188486,Hammock; Frances H,8,0,30,22
1683299626762,MATH 20E,A01,188649,Staff,22,0,30,8
1683299626762,MATH 20E,A02,188650,Staff,23,0,30,7
1683299626762,MATH 20E,A03,188673,Staff,0,0,30,30
1683299627788,MATH 102,A01,188675,Staff,0,35,35,35
1683299628817,MATH 103B,A01,188681,Staff,4,0,35,31
1683299628817,MATH 103B,B01,188692,Staff,7,0,35,28
1683299629844,MATH 109,A01,188695,Salehi Golsefidy; Alireza,25,0,35,10
1683299629844,MATH 109,A02,188696,Salehi Golsefidy; Alireza,27,0,35,8
1683299630871,MATH 120A,A01,188698,Eggers; John Dietrich,5,0,35,30
1683299631899,MATH 142B,A01,188736,Ioana; Adrian,0,2,30,30
1683299631899,MATH 142B,A02,188741,Ioana; Adrian,0,1,30,30
1683299631899,MATH 142B,A03,188743,Ioana; Adrian,0,3,30,30
1683299632925,MATH 168A,A01,188790,Staff,0,8,35,35
1683299633950,MATH 170A,A01,188803,Nie; Jiawang,0,2,35,35
1683299633950,MATH 170A,A02,188811,Nie; Jiawang,0,0,35,35
1683299633950,MATH 170A,A03,188814,Nie; Jiawang,1,0,35,34
1683299633950,MATH 170A,A04,188815,Nie; Jiawang,14,0,35,21
1683299634977,MATH 193B,A01,188817,Staff,0,0,35,35
1683299634977,MATH 193B,A02,188818,Staff,5,0,35,30
1683299636001,MGT 4,A01,202857,Anderson; John Charles,62,0,80,18
1683299637025,MGT 12,A00,202858,Lindenberger; Wade Douglas,43,0,90,47
1683299638051,MGT 18,A00,202859,Staff,74,0,90,16
1683299639078,MGT 18GS,A00,202860,McKay; Michael J,13,0,28,15
1683299640102,MGT 45,A00,202861,Pecore; Joseph P.,14,0,90,76
1683299641130,MGT 100,A00,202863,Yavorsky; Daniel Ryan,28,0,90,62
1683299642152,MGT 103,A00,202864,Ehrich; Kristine R,0,16,90,90
1683299643179,MGT 112,A00,202865,Ehrich; Kristine R,15,0,90,75
1683299644214,MGT 121A,A00,202868,Staff,0,19,0,0
1683299645241,MGT 131B,A00,202869,Anderson; John Charles,59,0,90,31
1683299646266,MGT 136,A00,202871,Lindenberger; Wade Douglas,84,0,90,6
1683299647291,MGT 164,A00,202873,Staff,0,69,90,90
1683299648314,MGT 164GS,A00,202874,McKay; Mary A,13,0,28,15
1683299649339,MGT 180,A00,202875,Staff,0,51,90,90
1683299650364,MMW 11R,A01,205019,Herbst; Matthew,3,0,30,27
1683299650364,MMW 11R,A02,205026,Herbst; Matthew,29,0,30,1
1683299651389,MMW 15,A01,193512,Chang; Edmond Yi-Teh,0,9,28,28
1683299651389,MMW 15,A02,193513,Chang; Edmond Yi-Teh,0,5,28,28
1683299651389,MMW 15,A03,193514,Chang; Edmond Yi-Teh,0,5,28,28
1683299651389,MMW 15,A04,193515,Chang; Edmond Yi-Teh,0,4,28,28
1683299651389,MMW 15,A05,193516,Chang; Edmond Yi-Teh,0,4,28,28
1683299651389,MMW 15,A06,193517,Chang; Edmond Yi-Teh,0,5,28,28
1683299651389,MMW 15,B01,193519,Chang; Edmond Yi-Teh,0,4,28,28
1683299651389,MMW 15,B02,193520,Chang; Edmond Yi-Teh,0,5,28,28
1683299651389,MMW 15,B03,193521,Chang; Edmond Yi-Teh,0,4,28,28
1683299651389,MMW 15,B04,193522,Chang; Edmond Yi-Teh,0,4,28,28
1683299651389,MMW 15,B05,193523,Chang; Edmond Yi-Teh,0,5,28,28
1683299651389,MMW 15,B06,193524,Chang; Edmond Yi-Teh,0,4,28,28
1683299652418,MMW 122,A01,193526,Rahimi; Babak,0,14,28,28
1683299652418,MMW 122,A02,193527,Rahimi; Babak,0,14,28,28
1683299652418,MMW 122,A03,193528,Rahimi; Babak,0,0,0,0
1683299652418,MMW 122,A04,193529,Rahimi; Babak,0,0,0,0
1683299653444,MUS 1A,A01,186663,Staff,0,20,35,35
1683299654471,MUS 4,A01,186715,Staff,0,12,35,35
1683299655498,MUS 5R,A01,186796,Dubnov; Shlomo,0,16,35,35
1683299656527,MUS 6,A01,186798,Staff,0,3,25,25
1683299657552,MUS 7,A01,186830,Staff,12,0,35,23
1683299658575,MUS 8,A01,186930,Staff,0,25,35,35
1683299659603,MUS 15,A01,186932,Staff,0,15,35,35
1683299659603,MUS 15,B01,186934,Staff,0,14,35,35
1683299660632,MUS 80,A00,186935,Staff,2,0,20,18
1683299660632,MUS 80,B00,186936,Staff,25,0,25,0
1683299661659,NANO 11,A00,204702,Lipomi; Darren John,0,0,0,0
1683299662687,NANO 15,A01,204709,Yang; Kesong,0,1,0,0
1683299663771,NANO 114,A00,202069,Jahed Motlagh; Zeinab,3,0,10,7
1683299664798,PHIL 1,A00,186955,Grush; Rick Scott,32,0,40,8
1683299665825,PHIL 10,A01,186973,Grush; Rick Scott,29,0,35,6
1683299665825,PHIL 10,A02,186974,Grush; Rick Scott,33,0,35,2
1683299666853,PHIL 13,A01,186976,Staff,7,0,35,28
1683299666853,PHIL 13,A02,186977,Staff,16,0,35,19
1683299667876,PHIL 14,A01,186979,Staff,31,0,35,4
1683299667876,PHIL 14,A02,186986,Staff,32,0,35,3
1683299668903,PHIL 28,A01,186988,Staff,16,0,30,14
1683299668903,PHIL 28,A02,186989,Staff,1,0,30,29
1683299668903,PHIL 28,A03,186990,Staff,9,0,30,21
1683299668903,PHIL 28,A04,186991,Staff,26,0,30,4
1683299669928,PHIL 120,A00,186997,Staff,23,0,40,17
1683299670952,PHIL 137,A00,187003,Staff,9,0,40,31
1683299671977,PHIL 150,A00,187015,Staff,47,0,70,23
1683299673002,PHIL 167,A00,187021,Lamey; Andy M.,35,0,40,5
1683299674030,PHIL 174,A01,202226,Staff,17,0,20,3
1683299674030,PHIL 174,A02,202235,Staff,20,0,20,0
1683299675061,PHIL 191A,A00,258918,Staff,0,0,1,1
1683299676087,PHYS 1A,A00,187028,Staff,26,0,60,34
1683299677112,PHYS 1AL,001,187036,Staff,2,0,30,28
1683299677112,PHYS 1AL,002,187049,Staff,18,0,30,12
1683299678139,PHYS 1B,A00,187058,Staff,23,0,60,37
1683299679167,PHYS 1BL,001,187064,Staff,0,0,30,30
1683299679167,PHYS 1BL,002,187070,Staff,6,0,30,24
1683299680194,PHYS 1C,A00,187082,Staff,32,0,120,88
1683299681223,PHYS 1CL,001,187088,Staff,0,9,30,30
1683299681223,PHYS 1CL,002,187089,Staff,0,2,30,30
1683299681223,PHYS 1CL,009,262693,Staff,12,0,30,18
1683299682247,PHYS 2B,A01,187097,Staff,54,0,115,61
1683299683274,PHYS 2C,A01,187099,Staff,67,0,115,48
1683299684299,PHYS 2CL,A01,187101,Staff,5,0,28,23
1683299684299,PHYS 2CL,A02,187102,Staff,15,0,28,13
1683299685324,PHYS 2D,A01,187123,Shotwell; Brian,95,0,115,20
1683299686356,PHYS 4B,A01,187133,Grinstein; Benjamin,35,0,50,15
1683299687380,POLI 10,A00,188819,Staff,0,3,50,50
1683299688407,POLI 11,A00,188827,Staff,43,0,50,7
1683299689431,POLI 13R,A00,188828,Staff,0,1,20,20
1683299690457,POLI 27,A01,188830,Elgin; Samuel Zincke,0,1,70,70
1683299691481,POLI 30,A00,188832,Desposato; Scott,33,0,50,17
1683299692508,POLI 102F,A00,188834,Staff,3,0,40,37
1683299693536,POLI 104A,A00,188852,Staff,14,0,30,16
1683299694563,POLI 104I,A00,188853,Staff,0,6,20,20
1683299695588,POLI 110B,A00,188854,Wiens; David,7,0,20,13
1683299696615,POLI 112A,A00,188855,Wiens; David,5,0,30,25
1683299697642,POLI 117R,A00,188856,Forman; Fonna,0,11,20,20
1683299698669,POLI 118,A00,188857,Ingham; Sean,8,0,20,12
1683299699694,POLI 120G,A00,188858,Staff,9,0,30,21
1683299700719,POLI 131CR,A00,188863,Hoston; Germaine,24,0,50,26
1683299701743,POLI 133,A00,188864,Nellis; Gareth Hb,44,0,50,6
1683299702766,POLI 134D,A00,188865,Desposato; Scott,27,0,30,3
1683299703790,POLI 142A,A00,188871,Gartzke; Erik,22,0,50,28
1683299704817,POLI 142K,A00,188874,Staff,38,0,50,12
1683299705842,POLI 143,A00,188940,Gartzke; Erik,16,0,30,14
1683299706865,POLI 153,A00,188943,Staff,3,0,20,17
1683299707892,POLI 160AA,A00,188944,Staff,13,0,40,27
1683299708920,POLI 170A,A00,188945,Staff,11,0,30,19
1683299710968,PSYC 1,A00,188952,Staff,38,0,90,52
1683299711993,PSYC 2,B00,188953,Staff,20,0,35,15
1683299713021,PSYC 6,A00,188970,Staff,47,0,60,13
1683299714049,PSYC 7,A00,188973,Staff,37,0,45,8
1683299715074,PSYC 60,A01,188980,Rickard; Timothy C.,43,0,60,17
1683299716096,PSYC 70,A01,189001,Steiner; Eric Tomas,24,0,45,21
1683299717120,PSYC 100,A00,189005,Lacefield; Katharine I,0,99,120,120
1683299718144,PSYC 102,A00,189008,Staff,10,0,30,20
1683299719168,PSYC 106,B00,189026,Gorman; Michael R.,37,0,60,23
1683299720193,PSYC 114,B01,189033,Winkielman; Piotr,0,32,30,30
1683299721218,PSYC 131,A00,189036,Anagnostaras; Stephan,0,43,60,60
1683299722240,PSYC 136,A00,189041,Lowe; Angela Beth,0,7,25,25
1683299723264,PSYC 137,A00,189057,Winkielman; Piotr,0,34,25,25
1683299724289,PSYC 144,A00,189107,Wixted; John T,0,7,50,50
1683299726337,PSYC 162,A00,189142,Staff,0,8,85,85
1683299727363,PSYC 172,A00,189144,Gorman; Michael R.,0,7,30,30
1683299729410,PSYC 179,A00,189146,Lacefield; Katharine I,0,84,120,120
1683299730434,PSYC 181,A00,189147,Anagnostaras; Stephan,0,44,90,90
1683299731459,PSYC 190R,A00,189148,Barner; David A.,0,22,80,80
1683299732482,PSYC 191,A00,189275,Rickard; Timothy C.,0,7,25,25
1683299733505,PSYC 193,A00,189276,Chapman; Eddie Nathaniel,0,1,0,4
1683299734534,PSYC 193L,A01,189281,Lowe; Angela Beth,12,0,20,8
1683299734534,PSYC 193L,B01,189285,Staff,28,0,35,7
1683299735558,RELI 149,A00,187137,Rahimi; Babak,7,0,40,33
1683299736582,SE 9,A01,187315,Staff,0,2,18,18
1683299737607,SE 101B,A00,187409,Staff,24,0,30,6
1683299738634,SE 110B,A00,187444,Staff,10,0,40,30
1683299739661,SE 130B,A00,187449,Staff,31,0,40,9
1683299740685,SE 150A,A00,187516,Staff,9,0,20,11
1683299741710,SE 154,A00,187528,Staff,30,0,50,20
1683299742733,SIO 3,A01,258171,Staff,35,0,40,5
1683299743757,SIO 10,A00,187144,Cook; Geoffrey W,0,3,75,75
1683299744781,SIO 45,A00,187152,Cook; Geoffrey W,1,0,100,99
1683299745808,SIO 109R,A00,194486,Staff,0,3,20,20
1683299747863,SIO 187,A01,187233,Kacev; David,12,0,40,28
1683299748891,SOCI 1,A01,258656,Thorpe; Charles Robert,28,0,30,2
1683299748891,SOCI 1,A02,258658,Thorpe; Charles Robert,30,0,30,0
1683299748891,SOCI 1,A03,258661,Thorpe; Charles Robert,25,0,25,0
1683299748891,SOCI 1,A04,258666,Thorpe; Charles Robert,22,0,25,3
1683299748891,SOCI 1,A05,258897,Thorpe; Charles Robert,23,0,25,2
1683299748891,SOCI 1,A06,258898,Thorpe; Charles Robert,25,0,25,0
1683299749918,SOCI 30,A01,258903,Pardo Guerra; Juan Pablo,16,0,30,14
1683299750942,SOCI 102,A00,258904,Staff,9,0,25,16
1683299751967,SOCI 106,A00,258905,Staff,19,0,25,6
1683299752991,SOCI 111,A00,258907,Ribas Norris; Janet Vanesa,26,0,30,4
1683299754016,SOCI 121R,A00,258908,Pardo Guerra; Juan Pablo,11,0,30,19
1683299755041,SOCI 126,A01,203330,Staff,14,0,20,6
1683299756065,SOCI 131,A00,258909,Thorpe; Charles Robert,31,0,60,29
1683299757089,SOCI 135,A00,258910,Payne; Christine Anna,0,9,30,30
1683299758113,SOCI 157,A00,258911,Staff,13,0,30,17
1683299759140,SOCI 184,A00,258912,Staff,26,0,30,4
1683299760165,SOCI 188D,A00,258913,Staff,21,0,30,9
1683299761193,SYN 2,001,187529,Staff,9,0,16,7
1683299761193,SYN 2,002,201452,Staff,0,18,16,16
1683299761193,SYN 2,003,201469,Staff,3,0,16,13
1683299762220,SYN 100,A01,187531,Staff,0,9,20,20
1683299762220,SYN 100,B01,201491,Staff,0,12,20,20
1683299763245,TDAC 1,A00,189286,Walsh; Kim C.,3,0,20,17
1683299763245,TDAC 1,B00,189287,Harting; Carla Kelso,11,0,20,9
1683299764268,TDAC 101,A00,189300,Walsh; Kim C.,16,0,20,4
1683299764268,TDAC 101,B00,189301,Harting; Carla Kelso,18,0,20,2
1683299765291,TDAC 102,A00,189304,Basso; Beatrice,14,0,20,6
1683299766327,TDAC 108,A00,189305,Staff,18,0,20,2
1683299767415,TDDE 131,A00,189310,Staff,19,0,20,1
1683299767415,TDDE 131,B00,189314,Staff,19,0,20,1
1683299767415,TDDE 131,C00,189315,Staff,48,0,50,2
1683299767415,TDDE 131,D00,189316,Staff,14,0,15,1
1683299767415,TDDE 131,E00,204841,Staff,20,0,20,0
1683299768439,TDGE 10,A00,189289,Staff,30,0,50,20
1683299768439,TDGE 10,B00,189290,Havis; Allan,2,0,50,48
1683299769468,TDGE 11,A00,189291,Fulton; Julia,0,3,50,50
1683299769468,TDGE 11,B00,189292,Staff,20,0,25,5
1683299769468,TDGE 11,C00,260270,Staff,0,0,0,0
1683299770493,TDGE 25,A00,189294,Staff,3,0,20,17
1683299771519,TDGE 124,A00,189318,Fulton; Julia,0,8,50,50
1683299772547,TDGE 125,A00,189319,Staff,13,0,25,12
1683299772547,TDGE 125,B00,189320,Staff,23,0,25,2
1683299773570,TDGE 127,A00,189322,Havis; Allan,0,0,50,50
1683299774593,TDHT 101,A00,189323,Staff,18,0,25,7
1683299774593,TDHT 101,B00,189324,Staff,25,0,25,0
1683299775621,TDHT 102,A00,189325,Staff,49,0,50,1
1683299776645,TDMV 1,A00,189295,Arcidiacono; Kristin,20,0,30,10
1683299776645,TDMV 1,B00,189296,Caligagan; Maria T.,24,0,30,6
1683299777671,TDMV 2,A00,189297,Sammartano; Tonnie,28,0,30,2
1683299777671,TDMV 2,B00,189299,Arcidiacono; Kristin,24,0,30,6
1683299778694,TDMV 3,A00,204998,Rincon; Alicia,22,0,30,8
1683299779718,TDMV 120,A00,189458,Sammartano; Tonnie,28,0,30,2
1683299780742,TDMV 138,A00,189541,Jun; Grace Shin Hae,22,0,40,18
1683299781766,TDMV 142,A00,189717,Caligagan; Tony,23,0,30,7
1683299781766,TDMV 142,B00,189718,Caligagan; Maria T.,25,0,30,5
1683299782793,TMC 2,A01,187533,Staff,25,0,25,0
1683299782793,TMC 2,A02,187534,Staff,25,0,25,0
1683299783821,USP 1,A01,187536,Kwak; Nancy,0,16,25,25
1683299784848,USP 5,A01,187538,Staff,9,0,25,16
1683299785873,USP 101,A00,199253,Staff,0,4,0,0
1683299786895,USP 124,A00,187562,Boomhower; Matthew Charles,1,0,30,29
1683299787919,USP 138,A00,187582,Staff,20,0,25,5
1683299788951,USP 152,A01,187597,Staff,4,0,25,21
1683299789975,USP 153,A00,187598,Staff,19,0,25,6
1683299791002,USP 168,A00,187607,Kwak; Nancy,2,0,5,3
1683299792029,USP 173,A00,187619,Staff,4,0,25,21
1683299793055,USP 181,A00,187638,Staff,0,0,25,25
1683299794082,VIS 103,A00,187650,Cruz; Edwin Teddy,23,0,75,52
1683299795106,VIS 110D,A00,187669,Staff,12,0,22,10
1683299796128,VIS 127C,A00,187720,Shen; Kuiyi,68,0,146,78
1683299797151,VIS 149,A00,187731,Yoldas; Pinar,0,14,22,22
1683299798179,VIS 151,A01,188091,Staff,22,0,34,12
1683299798179,VIS 151,A02,188092,Staff,11,0,34,23
1683299799203,VIS 160B,A00,188093,Stalbaum; Brett,0,0,10,10
1683299801251,WCWP 10B,A00,201720,Staff,10,0,15,5
1683299801251,WCWP 10B,B00,201722,Staff,8,0,15,7
1683299802275,WCWP 100,A00,201725,Gagnon; Jeffrey C,0,0,2,2
1683299802275,WCWP 100,B00,201727,Staff,0,4,15,15
1683299805367,ANBI 133,A00,258401,Wilder; Linnea Lorene,34,0,40,6
1683299806391,ANBI 140,A00,258395,Hrvoj Mihic; Branka,18,0,25,7
1683299807416,ANSC 120,A00,258402,Bialecki; Jon Anthony,27,0,40,13
1683299808442,ANSC 144,A00,258400,Staff,14,0,40,26
1683299810495,ANSC 166,A00,258396,Parish; Steven Martin,157,0,175,18
1683299811519,ANSC 180,A00,193533,Staff,9,0,20,11
1683299812543,ANSC 188,A00,258397,Jassal; Aftab,33,0,40,7
1683299813567,ANTH 3,A01,258316,Staff,23,0,30,7
1683299814592,ANTH 5,A00,258394,Semendeferi; Ekaterini,16,0,20,4
1683299815616,ANTH 21,A01,258331,Staff,9,0,40,31
1683299816639,ANTH 103,A00,258398,Varma; Saiba,15,0,25,10
1683299817666,AWP 10,001,202034,Staff,0,0,0,0
1683299817666,AWP 10,002,202035,Staff,0,0,0,0
1683299817666,AWP 10,003,202036,Staff,0,0,0,0
1683299817666,AWP 10,004,202037,Staff,0,0,0,0
1683299817666,AWP 10,005,202038,Staff,0,0,0,0
1683299817666,AWP 10,006,202039,Staff,0,0,0,0
1683299817666,AWP 10,007,202040,Staff,0,0,0,0
1683299817666,AWP 10,008,202041,Staff,0,0,0,0
1683299817666,AWP 10,009,202042,Staff,0,0,0,0
1683299817666,AWP 10,010,202043,Staff,0,0,0,0
1683299817666,AWP 10,011,202044,Staff,0,0,0,0
1683299817666,AWP 10,012,202045,Staff,0,0,0,0
1683299817666,AWP 10,013,202046,Staff,0,0,0,0
1683299817666,AWP 10,014,202047,Staff,0,0,0,0
1683299817666,AWP 10,015,202048,Staff,0,0,0,0
1683299817666,AWP 10,016,202049,Staff,0,0,0,0
1683299817666,AWP 10,017,202050,Staff,0,0,0,0
1683299817666,AWP 10,018,202051,Staff,0,0,0,0
1683299817666,AWP 10,019,202052,Staff,0,0,0,0
1683299817666,AWP 10,020,202053,Staff,0,0,0,0
1683299817666,AWP 10,021,202054,Staff,0,0,0,0
1683299817666,AWP 10,022,202055,Staff,0,0,0,0
1683299817666,AWP 10,023,202056,Staff,0,0,0,0
1683299817666,AWP 10,024,202057,Staff,0,0,0,0
1683299817666,AWP 10,025,202058,Staff,0,0,0,0
1683299817666,AWP 10,026,202059,Staff,0,0,0,0
1683299818691,AWP 102,001,202032,Staff,0,0,0,0
1683299818691,AWP 102,002,202033,Staff,0,0,0,0
1683299819715,BENG 100,A01,254234,Taylor Amos; Alyssa C,31,0,40,9
1683299820740,BENG 196,001,270013,Engler; Adam J.,9999,0,9999,0
1683299821774,BICD 100R,A01,202018,Smith; Laurie,0,7,32,32
1683299821774,BICD 100R,A02,202019,Smith; Laurie,0,2,32,32
1683299821774,BICD 100R,A03,202020,Smith; Laurie,0,1,32,32
1683299821774,BICD 100R,A04,202021,Smith; Laurie,8,0,32,24
1683299821774,BICD 100R,A05,202022,Smith; Laurie,12,0,32,20
1683299822802,BICD 136,A01,193242,Gustafson-Brown; Cindy,0,2,32,32
1683299822802,BICD 136,A02,193244,Gustafson-Brown; Cindy,15,0,32,17
1683299823828,BIEB 102,A01,193249,Butler; Shannon Rhey,0,2,32,32
1683299823828,BIEB 102,A02,193251,Butler; Shannon Rhey,0,0,32,32
1683299823828,BIEB 102,A03,193253,Butler; Shannon Rhey,0,1,32,32
1683299823828,BIEB 102,A04,193255,Butler; Shannon Rhey,17,0,32,15
1683299823828,BIEB 102,A05,193265,Butler; Shannon Rhey,26,0,32,6
1683299823828,BIEB 102,A06,193269,Butler; Shannon Rhey,16,0,32,16
1683299825878,BIEB 150,A01,193274,Staff,0,0,32,32
1683299825878,BIEB 150,A02,193285,Staff,24,0,32,8
1683299826901,BIEB 194,A00,193286,Kurle; Carolyn M.,22,0,32,10
1683299827927,BILD 1,A01,192291,Staff,16,0,32,16
1683299827927,BILD 1,A02,192292,Staff,30,0,32,2
1683299827927,BILD 1,B01,192520,Reuther; Keefe,0,1,0,0
1683299827927,BILD 1,B02,192532,Reuther; Keefe,0,1,0,0
1683299828953,BILD 3,A01,192556,Butler; Shannon Rhey,0,0,32,32
1683299828953,BILD 3,A02,192581,Butler; Shannon Rhey,5,0,32,27
1683299828953,BILD 3,A03,192611,Butler; Shannon Rhey,23,0,32,9
1683299828953,BILD 3,A04,192612,Butler; Shannon Rhey,25,0,32,7
1683299828953,BILD 3,A05,192613,Butler; Shannon Rhey,27,0,32,5
1683299828953,BILD 3,A06,192679,Butler; Shannon Rhey,27,0,32,5
1683299828953,BILD 3,A07,192682,Butler; Shannon Rhey,22,0,32,10
1683299829979,BILD 4,A01,192836,Reuther; Keefe,1,0,24,23
1683299829979,BILD 4,A02,193044,Reuther; Keefe,4,0,24,20
1683299831002,BILD 10,A01,193142,Gustafson-Brown; Cindy,31,0,32,1
1683299831002,BILD 10,A02,193149,Gustafson-Brown; Cindy,31,0,32,1
1683299832027,BIMM 100,A01,193301,Staff,0,6,32,32
1683299832027,BIMM 100,A02,193312,Staff,0,5,32,32
1683299832027,BIMM 100,A03,193323,Staff,0,8,32,32
1683299833052,BIMM 101,A01,193329,McDonnell; Lisa Marie,0,3,24,24
1683299833052,BIMM 101,A02,193339,McDonnell; Lisa Marie,0,2,24,24
1683299833052,BIMM 101,B01,193354,McDonnell; Lisa Marie,0,3,24,24
1683299833052,BIMM 101,B02,193357,McDonnell; Lisa Marie,0,3,24,24
1683299834076,BIMM 110,A01,193377,Tat; John,0,11,32,32
1683299834076,BIMM 110,A02,193378,Tat; John,1,9,32,31
1683299835101,BIMM 120,A01,206116,Staff,0,0,32,32
1683299835101,BIMM 120,A02,206117,Staff,8,0,32,24
1683299835101,BIMM 120,A03,206121,Staff,21,0,32,11
1683299836125,BIPN 100,A01,193393,Park; Ji Young,0,14,32,32
1683299836125,BIPN 100,A02,193402,Park; Ji Young,0,12,32,32
1683299836125,BIPN 100,A03,193413,Park; Ji Young,0,14,32,32
1683299836125,BIPN 100,A04,193414,Park; Ji Young,0,13,32,32
1683299837153,BIPN 102,A01,193429,Staff,0,0,32,32
1683299837153,BIPN 102,A02,193438,Staff,23,0,32,9
1683299838180,BIPN 106,A01,193450,Reyes Gonzalez; Catalina,0,2,40,40
1683299839208,BIPN 134,A01,193465,Cooke; James Edward,0,0,32,32
1683299839208,BIPN 134,A02,193474,Cooke; James Edward,27,0,32,5
1683299839208,BIPN 134,A03,193485,Cooke; James Edward,29,0,32,3
1683299839208,BIPN 134,A04,193486,Cooke; James Edward,21,0,32,11
1683299839208,BIPN 134,A05,193491,Cooke; James Edward,31,0,32,1
1683299839208,BIPN 134,A06,193501,Cooke; James Edward,30,0,32,2
1683299839208,BIPN 134,A07,193510,Cooke; James Edward,29,0,32,3
1683299841259,BISP 194,A00,222522,Staff,16,0,32,16
1683299842288,CAT 124,A01,202407,Staff,20,0,25,5
1683299843314,CAT 125,A00,202408,Marchisotto; Jennifer Anne,4,0,20,16
1683299844338,CAT 125R,A00,202409,Smith; Lauryn Alissa,0,11,20,20
1683299844338,CAT 125R,B00,202410,Morales; Celeste Georgianna,0,11,20,20
1683299844338,CAT 125R,C00,202411,Irwin; Matthew Joseph,0,10,20,20
1683299845363,CENG 15,A01,204712,Yang; Kesong,0,1,0,0
1683299846388,CENG 114,A00,202070,Jahed Motlagh; Zeinab,5,0,20,15
1683299847411,CGS 105,A00,185477,Wesling; Megan E.,24,0,40,16
1683299848438,CGS 106,A00,185494,Staff,13,0,22,9
1683299849463,CGS 108,A00,185495,Staff,14,0,20,6
1683299850488,CGS 114,A00,185496,Staff,13,0,18,5
1683299851511,CGS 119,A00,185501,Staff,15,0,20,5
1683299852534,CGS 120,A00,185511,Staff,13,0,20,7
1683299853593,CHEM 4,A01,184675,Bussey; Thomas J,96,0,100,4
1683299854621,CHEM 6A,A01,184677,Staff,35,0,60,25
1683299855644,CHEM 6B,A01,184679,Staff,65,0,100,35
1683299856673,CHEM 6C,A01,184681,Bussey; Thomas J,1,0,50,49
1683299856673,CHEM 6C,A02,184682,Bussey; Thomas J,34,0,50,16
1683299857697,CHEM 40A,A01,184684,Albizati; Kim F.,37,0,100,63
1683299858720,CHEM 40B,A01,184686,Albizati; Kim F.,0,20,100,100
1683299859744,CHEM 41B,A01,184690,Staff,52,0,100,48
1683299860769,COGS 3,A01,184715,Boyle; Mary E. T.,0,25,40,40
1683299861796,COGS 14B,A01,185172,Staff,0,15,38,38
1683299862820,COGS 18,A01,184736,Staff,20,0,80,60
1683299863847,COGS 100,A01,184932,Staff,0,5,73,73
1683299864875,COGS 101A,A01,184935,Staff,0,38,30,30
1683299865897,COGS 101B,A01,184944,Staff,0,2,30,30
1683299866925,COGS 101C,A01,184946,Staff,0,12,30,30
1683299867950,COGS 102A,A01,184951,Johnson; Christine M.,2,0,40,38
1683299868974,COGS 107B,A01,184953,Mooshagian; Eric Frederick,0,50,40,40
1683299869999,COGS 118B,A01,184959,Gupta; Anjum,0,48,40,40
1683299871083,COGS 153,A00,184961,Staff,0,15,30,30
1683299872110,COGS 177,A00,184962,Staff,0,21,30,30
1683299873135,COGS 187A,A01,184969,Boyle; Mary E. T.,0,17,40,40
1683299874162,COMM 10,A01,185174,Staff,0,5,25,25
1683299874162,COMM 10,A02,185189,Staff,0,5,25,25
1683299874162,COMM 10,A03,269821,Staff,0,0,0,0
1683299875186,COMM 100B,A01,185475,Staff,0,0,0,2
1683299875186,COMM 100B,A02,185476,Staff,14,0,25,11
1683299876210,COMM 100C,A01,185314,Staff,1,0,25,24
1683299876210,COMM 100C,A02,185327,Staff,19,0,25,6
1683299877238,COMM 110M,A00,185349,Staff,2,0,40,38
1683299878263,COMM 113T,A00,185352,Staff,25,0,40,15
1683299879288,COMM 114I,A00,185353,Staff,33,0,40,7
1683299880311,COMM 131,A00,185354,Staff,19,0,30,11
1683299881340,CSE 8A,A50,185358,Cao; Yingjun,0,46,10,10
1683299882367,CSE 8B,A01,185362,Staff,1,47,50,49
1683299883390,CSE 11,A01,185416,Cao; Yingjun,0,93,10,10
1683299884416,CSE 20,A01,185445,Briones; Jor-el Thomas Caparas,5,0,25,20
1683299885441,CSE 21,A01,185447,Staff,10,0,50,40
1683299886466,CSE 101,A01,185451,Staff,0,12,50,50
1683299886466,CSE 101,B01,185453,Jones; Miles E,0,11,50,50
1683299888516,CSE 141,A01,185458,Eldon; John,20,0,100,80
1683299889540,CSE 141L,A01,185461,Eldon; John,12,0,100,88
1683299890566,CSE 142,A01,185463,Staff,35,0,60,25
1683299890566,CSE 142,B01,201355,Staff,0,6,60,60
1683299891590,CSE 142L,A01,185470,Staff,35,0,60,25
1683299891590,CSE 142L,B01,201417,Staff,0,5,60,60
1683299892615,CSE 190,A00,201433,Staff,32,0,49,17
1683299893641,DOC 1,A01,259136,Strom; Megan C.,8,0,15,7
1683299893641,DOC 1,A02,259137,Strom; Megan C.,14,0,15,1
1683299893641,DOC 1,A03,259138,Strom; Megan C.,14,0,15,1
1683299893641,DOC 1,A04,259139,Strom; Megan C.,14,0,15,1
1683299894669,DOC 100D,A00,259140,Pass; Natalye Joann,17,0,25,8
1683299895701,DSGN 1,A01,184749,Rill; Bryan,0,24,30,30
1683299896734,DSGN 100,A01,185168,Staff,0,2,25,25
1683299897763,ECE 5,A01,185626,Morris; Karcher William,0,10,0,0
1683299898786,ECE 101,A01,185628,Staff,17,0,70,53
1683299899811,ECE 107,A01,185635,Baghdadchi; Saharnaz,0,0,20,20
1683299899811,ECE 107,A02,185638,Baghdadchi; Saharnaz,4,0,20,16
1683299900834,ECE 148,A01,185647,Silberman; Jack,1,0,16,15
1683299901865,ECON 1,A01,185537,Crane; Meredith Helen,54,0,70,16
1683299902893,ECON 3,A01,185549,Crane; Meredith Helen,33,0,70,37
1683299903921,ECON 4,A01,203354,Anderson; John Charles,0,4,10,10
1683299904946,ECON 100A,A01,185574,Staff,0,4,40,40
1683299905971,ECON 100B,A01,185576,Staff,0,22,40,40
1683299906996,ECON 100C,A01,185589,Newhouse; Herbert S,30,0,70,40
1683299908026,ECON 105,A00,185608,Vespa; Emanuel Ignacio,19,0,35,16
1683299909051,ECON 109,A01,185610,Shishkin; Denis,10,0,35,25
1683299910074,ECON 110A,A01,185612,Staff,11,0,40,29
1683299911097,ECON 120A,A01,185615,Staff,20,0,40,20
1683299912121,ECON 120C,A01,185617,Sun; Yixiao,0,20,70,70
1683299913146,ECON 144,A00,203346,Squires; Dale E,3,0,35,32
1683299914170,ECON 171,A01,203349,Newhouse; Herbert S,0,1,35,35
1683299915195,ECON 173A,A01,185621,Toda; Alexis Akira,21,0,35,14
1683299916227,EDS 25,A01,202413,Staff,0,1,0,0
1683299916227,EDS 25,A02,202414,Staff,0,1,0,0
1683299916227,EDS 25,A03,202415,Staff,0,0,0,0
1683299916227,EDS 25,A04,202416,Staff,0,1,0,0
1683299916227,EDS 25,A05,202439,Staff,0,0,0,0
1683299916227,EDS 25,A06,202440,Staff,0,0,0,0
1683299916227,EDS 25,B01,202631,Staff,0,0,0,0
1683299916227,EDS 25,B02,202632,Staff,0,0,0,0
1683299916227,EDS 25,B03,202639,Staff,0,0,0,0
1683299916227,EDS 25,B04,202640,Staff,0,0,0,0
1683299916227,EDS 25,B05,202643,Staff,0,0,0,0
1683299916227,EDS 25,B06,202644,Staff,0,0,0,0
1683299917251,EDS 38,A01,202659,Black; Alison Michelle,24,0,25,1
1683299918279,EDS 115,A00,202652,Staff,17,0,30,13
1683299919305,EDS 125,A00,202649,Staff,14,0,30,16
1683299920332,EDS 126,A01,203332,Staff,30,0,30,0
1683299921357,EDS 139,A00,202838,Staff,17,0,25,8
1683299922382,EDS 146,A01,202655,Staff,15,0,25,10
1683299923409,ENG 15,A00,185667,Staff,0,1,0,0
1683299923409,ENG 15,B00,185672,Staff,0,0,0,0
1683299923409,ENG 15,C00,185675,Staff,0,0,0,0
1683299923409,ENG 15,D00,185682,Staff,0,0,0,0
1683299923409,ENG 15,E00,185684,Staff,0,0,0,0
1683299924434,ETHN 103,A00,185710,Staff,0,3,35,35
1683299925458,ETHN 103A,A00,199228,Man; Simeon S,3,0,9,6
1683299926481,ETHN 109,A00,185711,Staff,18,0,35,17
1683299927510,ETHN 142,A00,185726,Staff,0,4,30,30
1683299928533,ETHN 163J,A00,199229,Man; Simeon S,6,0,8,2
1683299929557,ETHN 168,A00,185727,Staff,8,0,10,2
1683299930581,ETHN 182,A00,185728,Staff,1,0,35,34
1683299931606,ETHN 183,A00,185737,Staff,8,0,18,10
1683299932634,GLBH 111,A01,209361,Burgos; Jose L.,0,0,0,0
1683299934685,HIEU 104,A00,185792,Staff,16,0,20,4
1683299935712,HIEU 115,A00,185800,Staff,1,0,20,19
1683299936739,HIEU 128,A00,185801,Staff,0,7,20,20
1683299937765,HIEU 147,A00,185802,Staff,16,0,20,4
1683299938791,HIEU 154,A00,185823,Staff,12,0,20,8
1683299939813,HILA 102,A00,185826,Staff,13,0,20,7
1683299940840,HILD 2C,A01,185778,Staff,0,12,20,20
1683299941864,HILD 7B,A01,185780,Kwak; Nancy,0,15,32,32
1683299941864,HILD 7B,A02,185781,Kwak; Nancy,0,18,32,32
1683299942889,HILD 30,A01,185791,Staff,14,0,20,6
1683299943914,HISC 119,A00,185830,Golan; Tal,0,9,20,20
1683299944941,HITO 156GS,A00,185831,Patterson; Patrick H.,0,0,0,23
1683299945966,HIUS 103,A00,185832,Man; Simeon S,0,7,20,20
1683299946990,HIUS 117,A00,185836,Kwak; Nancy,2,0,20,18
1683299948014,HIUS 125,A00,185840,Man; Simeon S,0,0,23,23
1683299949041,HIUS 149,A00,185845,Staff,0,0,20,20
1683299950066,HUM 3,A01,185882,Zavodny; Tatiana Sophia,0,6,50,50
1683299950066,HUM 3,B01,185899,Caldwell; Michael Alan,0,19,50,50
1683299951094,HUM 3GS,A00,185900,Patterson; Patrick H.,0,0,0,23
1683299952117,HUM 4,A01,185938,Zroka; Amy Liane,31,0,50,19
1683299952117,HUM 4,B01,185956,Watkins; Eric,0,2,50,50
1683299952117,HUM 4,B02,202209,Watkins; Eric,0,1,50,50
1683299952117,HUM 4,B03,202210,Watkins; Eric,0,0,50,50
1683299953145,HUM 5,A01,185958,West; Geoffrey Scott,5,0,50,45
1683299953145,HUM 5,A02,202215,West; Geoffrey Scott,0,0,50,50
1683299954169,INTL 190,A00,185959,Gagnon; Jeffrey C,0,0,0,9
1683299954169,INTL 190,B00,185960,Lettieri; Michael Joseph,0,0,0,1
1683299955195,JAPN 180,A00,254509,Staff,0,1,25,25
1683299956220,LATI 10,A01,202853,Kennemore; Amy Michelle,5,0,35,30
1683299956220,LATI 10,A02,202854,Kennemore; Amy Michelle,1,0,35,34
1683299956220,LATI 10,A03,270054,Kennemore; Amy Michelle,30,0,30,0
1683299957247,LATI 180,A00,202855,Kennemore; Amy Michelle,11,0,20,9
1683299958271,LAWS 101,A00,201767,Golan; Tal,0,7,40,40
1683299959295,LIFR 1C,A00,185961,Staff,6,0,20,14
1683299960320,LIFR 1CX,A00,185962,Staff,7,0,20,13
1683299961347,LIFR 1D,A00,185963,Staff,9,0,20,11
1683299962371,LIFR 1DX,A00,185964,Staff,9,0,20,11
1683299963400,LIGN 101,A01,186039,Staff,43,0,50,7
1683299964423,LIGN 165,A00,186040,Staff,18,0,50,32
1683299965446,LTCS 108,A00,186041,Staff,6,0,10,4
1683299966469,LTCS 119,A00,186042,Staff,16,0,20,4
1683299967495,LTCS 130,A00,186043,Wesling; Megan E.,15,0,25,10
1683299969546,LTEA 138,A00,186119,Staff,14,0,40,26
1683299970570,LTEN 124,A00,186148,Staff,6,0,25,19
1683299971597,LTEN 178,A00,186149,Staff,7,0,15,8
1683299972624,LTEN 181,A00,186150,Blanco; John D,33,0,40,7
1683299973647,LTWL 120,A00,186160,Staff,20,0,25,5
1683299974741,LTWL 165,A00,186161,Staff,22,0,25,3
1683299975765,LTWR 100,A00,186162,Staff,0,4,15,15
1683299976793,LTWR 102,A00,186163,Doller; Ben,5,0,15,10
1683299977818,MAE 8,A01,186412,Staff,0,0,0,0
1683299978843,MAE 30B,A00,186445,Bahadori; Mohammad Yousef,83,0,100,17
1683299979871,MAE 40,A00,186592,Bewley; Thomas R,9,0,50,41
1683299980899,MAE 101B,A00,186593,Bahadori; Mohammad Yousef,81,0,100,19
1683299981927,MAE 105,A00,186594,Bandaru; Prabhakar,12,0,50,38
1683299982952,MAE 107,A00,186599,Pham; Hieu Tan,0,6,120,120
1683299983975,MAE 148,A01,186660,Silberman; Jack,3,0,16,13
1683299985000,MATH 10A,A01,188095,Staff,0,7,35,35
1683299986027,MATH 10B,A01,188097,Bowers; Adam R.,0,11,30,30
1683299986027,MATH 10B,A02,188099,Bowers; Adam R.,0,9,30,30
1683299986027,MATH 10B,B01,188104,Bowers; Adam R.,0,11,30,30
1683299986027,MATH 10B,B02,188106,Bowers; Adam R.,0,11,30,30
1683299987052,MATH 10C,A01,188111,Staff,0,18,30,30
1683299987052,MATH 10C,A02,188127,Staff,0,17,30,30
1683299987052,MATH 10C,A03,188131,Staff,0,17,30,30
1683299987052,MATH 10C,B01,188218,Staff,21,0,30,9
1683299987052,MATH 10C,B02,188244,Staff,13,0,30,17
1683299987052,MATH 10C,B03,188277,Staff,16,0,30,14
1683299988084,MATH 18,A01,188344,Bach; Quang Tran,18,0,30,12
1683299988084,MATH 18,A02,188345,Bach; Quang Tran,11,0,30,19
1683299988084,MATH 18,B01,188353,Bach; Quang Tran,10,0,30,20
1683299988084,MATH 18,B02,188354,Bach; Quang Tran,20,0,30,10
1683299989112,MATH 20A,A01,188374,Staff,13,0,35,22
1683299990138,MATH 20B,A01,188382,Ohm; Ko Woon,6,0,30,24
1683299990138,MATH 20B,A02,188383,Ohm; Ko Woon,24,0,30,6
1683299990138,MATH 20B,B01,188385,Ohm; Ko Woon,7,0,30,23
1683299990138,MATH 20B,B02,188392,Ohm; Ko Woon,22,0,30,8
1683299991163,MATH 20C,A01,188394,Harel; Guershon,10,0,30,20
1683299991163,MATH 20C,A02,188395,Harel; Guershon,13,0,30,17
1683299991163,MATH 20C,B01,188404,Harel; Guershon,3,0,30,27
1683299991163,MATH 20C,B02,188405,Harel; Guershon,19,0,30,11
1683299992186,MATH 20D,A01,188414,Hammock; Frances H,0,1,30,30
1683299992186,MATH 20D,A02,188415,Hammock; Frances H,4,0,30,26
1683299992186,MATH 20D,B01,188447,Hammock; Frances H,2,0,30,28
1683299992186,MATH 20D,B02,188486,Hammock; Frances H,8,0,30,22
1683299993211,MATH 20E,A01,188649,Staff,22,0,30,8
1683299993211,MATH 20E,A02,188650,Staff,23,0,30,7
1683299993211,MATH 20E,A03,188673,Staff,0,0,30,30
1683299994238,MATH 102,A01,188675,Staff,0,35,35,35
1683299995263,MATH 103B,A01,188681,Staff,4,0,35,31
1683299995263,MATH 103B,B01,188692,Staff,7,0,35,28
1683299996288,MATH 109,A01,188695,Salehi Golsefidy; Alireza,25,0,35,10
1683299996288,MATH 109,A02,188696,Salehi Golsefidy; Alireza,27,0,35,8
1683299997313,MATH 120A,A01,188698,Eggers; John Dietrich,5,0,35,30
1683299998339,MATH 142B,A01,188736,Ioana; Adrian,0,2,30,30
1683299998339,MATH 142B,A02,188741,Ioana; Adrian,0,1,30,30
1683299998339,MATH 142B,A03,188743,Ioana; Adrian,0,3,30,30
1683299999363,MATH 168A,A01,188790,Staff,0,8,35,35
1683300000393,MATH 170A,A01,188803,Nie; Jiawang,0,2,35,35
1683300000393,MATH 170A,A02,188811,Nie; Jiawang,0,0,35,35
1683300000393,MATH 170A,A03,188814,Nie; Jiawang,1,0,35,34
1683300000393,MATH 170A,A04,188815,Nie; Jiawang,14,0,35,21
1683300001419,MATH 193B,A01,188817,Staff,0,0,35,35
1683300001419,MATH 193B,A02,188818,Staff,5,0,35,30
1683300002450,MGT 4,A01,202857,Anderson; John Charles,62,0,80,18
1683300003477,MGT 12,A00,202858,Lindenberger; Wade Douglas,43,0,90,47
1683300004503,MGT 18,A00,202859,Staff,74,0,90,16
1683300005530,MGT 18GS,A00,202860,McKay; Michael J,13,0,28,15
1683300006557,MGT 45,A00,202861,Pecore; Joseph P.,14,0,90,76
1683300007582,MGT 100,A00,202863,Yavorsky; Daniel Ryan,28,0,90,62
1683300008607,MGT 103,A00,202864,Ehrich; Kristine R,0,16,90,90
1683300009632,MGT 112,A00,202865,Ehrich; Kristine R,15,0,90,75
1683300010657,MGT 121A,A00,202868,Staff,0,19,0,0
1683300011682,MGT 131B,A00,202869,Anderson; John Charles,59,0,90,31
1683300012706,MGT 136,A00,202871,Lindenberger; Wade Douglas,84,0,90,6
1683300013733,MGT 164,A00,202873,Staff,0,69,90,90
1683300014761,MGT 164GS,A00,202874,McKay; Mary A,13,0,28,15
1683300015784,MGT 180,A00,202875,Staff,0,51,90,90
1683300016810,MMW 11R,A01,205019,Herbst; Matthew,3,0,30,27
1683300016810,MMW 11R,A02,205026,Herbst; Matthew,29,0,30,1
1683300017840,MMW 15,A01,193512,Chang; Edmond Yi-Teh,0,9,28,28
1683300017840,MMW 15,A02,193513,Chang; Edmond Yi-Teh,0,5,28,28
1683300017840,MMW 15,A03,193514,Chang; Edmond Yi-Teh,0,5,28,28
1683300017840,MMW 15,A04,193515,Chang; Edmond Yi-Teh,0,4,28,28
1683300017840,MMW 15,A05,193516,Chang; Edmond Yi-Teh,0,4,28,28
1683300017840,MMW 15,A06,193517,Chang; Edmond Yi-Teh,0,5,28,28
1683300017840,MMW 15,B01,193519,Chang; Edmond Yi-Teh,0,4,28,28
1683300017840,MMW 15,B02,193520,Chang; Edmond Yi-Teh,0,5,28,28
1683300017840,MMW 15,B03,193521,Chang; Edmond Yi-Teh,0,4,28,28
1683300017840,MMW 15,B04,193522,Chang; Edmond Yi-Teh,0,4,28,28
1683300017840,MMW 15,B05,193523,Chang; Edmond Yi-Teh,0,5,28,28
1683300017840,MMW 15,B06,193524,Chang; Edmond Yi-Teh,0,4,28,28
1683300018864,MMW 122,A01,193526,Rahimi; Babak,0,14,28,28
1683300018864,MMW 122,A02,193527,Rahimi; Babak,0,14,28,28
1683300018864,MMW 122,A03,193528,Rahimi; Babak,0,0,0,0
1683300018864,MMW 122,A04,193529,Rahimi; Babak,0,0,0,0
1683300019892,MUS 1A,A01,186663,Staff,0,20,35,35
1683300020919,MUS 4,A01,186715,Staff,0,12,35,35
1683300021947,MUS 5R,A01,186796,Dubnov; Shlomo,0,16,35,35
1683300022972,MUS 6,A01,186798,Staff,0,3,25,25
1683300023999,MUS 7,A01,186830,Staff,12,0,35,23
1683300025023,MUS 8,A01,186930,Staff,0,25,35,35
1683300026047,MUS 15,A01,186932,Staff,0,15,35,35
1683300026047,MUS 15,B01,186934,Staff,0,14,35,35
1683300027074,MUS 80,A00,186935,Staff,2,0,20,18
1683300027074,MUS 80,B00,186936,Staff,25,0,25,0
1683300028102,NANO 11,A00,204702,Lipomi; Darren John,0,0,0,0
1683300029126,NANO 15,A01,204709,Yang; Kesong,0,1,0,0
1683300030154,NANO 114,A00,202069,Jahed Motlagh; Zeinab,3,0,10,7
1683300031177,PHIL 1,A00,186955,Grush; Rick Scott,32,0,40,8
1683300032203,PHIL 10,A01,186973,Grush; Rick Scott,29,0,35,6
1683300032203,PHIL 10,A02,186974,Grush; Rick Scott,33,0,35,2
1683300033229,PHIL 13,A01,186976,Staff,7,0,35,28
1683300033229,PHIL 13,A02,186977,Staff,16,0,35,19
1683300034259,PHIL 14,A01,186979,Staff,31,0,35,4
1683300034259,PHIL 14,A02,186986,Staff,32,0,35,3
1683300035288,PHIL 28,A01,186988,Staff,16,0,30,14
1683300035288,PHIL 28,A02,186989,Staff,1,0,30,29
1683300035288,PHIL 28,A03,186990,Staff,9,0,30,21
1683300035288,PHIL 28,A04,186991,Staff,26,0,30,4
1683300036311,PHIL 120,A00,186997,Staff,23,0,40,17
1683300037335,PHIL 137,A00,187003,Staff,9,0,40,31
1683300038363,PHIL 150,A00,187015,Staff,47,0,70,23
1683300039390,PHIL 167,A00,187021,Lamey; Andy M.,35,0,40,5
1683300040418,PHIL 174,A01,202226,Staff,17,0,20,3
1683300040418,PHIL 174,A02,202235,Staff,20,0,20,0
1683300041441,PHIL 191A,A00,258918,Staff,0,0,1,1
1683300042465,PHYS 1A,A00,187028,Staff,26,0,60,34
1683300043492,PHYS 1AL,001,187036,Staff,2,0,30,28
1683300043492,PHYS 1AL,002,187049,Staff,18,0,30,12
1683300044517,PHYS 1B,A00,187058,Staff,23,0,60,37
1683300045541,PHYS 1BL,001,187064,Staff,0,0,30,30
1683300045541,PHYS 1BL,002,187070,Staff,6,0,30,24
1683300046564,PHYS 1C,A00,187082,Staff,32,0,120,88
1683300047588,PHYS 1CL,001,187088,Staff,0,9,30,30
1683300047588,PHYS 1CL,002,187089,Staff,0,2,30,30
1683300047588,PHYS 1CL,009,262693,Staff,12,0,30,18
1683300048611,PHYS 2B,A01,187097,Staff,54,0,115,61
1683300049634,PHYS 2C,A01,187099,Staff,67,0,115,48
1683300050661,PHYS 2CL,A01,187101,Staff,5,0,28,23
1683300050661,PHYS 2CL,A02,187102,Staff,15,0,28,13
1683300051690,PHYS 2D,A01,187123,Shotwell; Brian,95,0,115,20
1683300052717,PHYS 4B,A01,187133,Grinstein; Benjamin,35,0,50,15
1683300053745,POLI 10,A00,188819,Staff,0,3,50,50
1683300054776,POLI 11,A00,188827,Staff,43,0,50,7
1683300055802,POLI 13R,A00,188828,Staff,0,1,20,20
1683300056827,POLI 27,A01,188830,Elgin; Samuel Zincke,0,1,70,70
1683300057852,POLI 30,A00,188832,Desposato; Scott,33,0,50,17
1683300058877,POLI 102F,A00,188834,Staff,3,0,40,37
1683300059904,POLI 104A,A00,188852,Staff,14,0,30,16
1683300060926,POLI 104I,A00,188853,Staff,0,6,20,20
1683300061951,POLI 110B,A00,188854,Wiens; David,7,0,20,13
1683300062976,POLI 112A,A00,188855,Wiens; David,5,0,30,25
1683300064001,POLI 117R,A00,188856,Forman; Fonna,0,11,20,20
1683300065025,POLI 118,A00,188857,Ingham; Sean,8,0,20,12
1683300066054,POLI 120G,A00,188858,Staff,9,0,30,21
1683300067076,POLI 131CR,A00,188863,Hoston; Germaine,24,0,50,26
1683300068100,POLI 133,A00,188864,Nellis; Gareth Hb,44,0,50,6
1683300069124,POLI 134D,A00,188865,Desposato; Scott,27,0,30,3
1683300070149,POLI 142A,A00,188871,Gartzke; Erik,22,0,50,28
1683300071172,POLI 142K,A00,188874,Staff,38,0,50,12
1683300072200,POLI 143,A00,188940,Gartzke; Erik,16,0,30,14
1683300073223,POLI 153,A00,188943,Staff,3,0,20,17
1683300074251,POLI 160AA,A00,188944,Staff,13,0,40,27
1683300075279,POLI 170A,A00,188945,Staff,11,0,30,19
1683300077329,PSYC 1,A00,188952,Staff,38,0,90,52
1683300078418,PSYC 2,B00,188953,Staff,20,0,35,15
1683300079445,PSYC 6,A00,188970,Staff,47,0,60,13
1683300080468,PSYC 7,A00,188973,Staff,37,0,45,8
1683300081492,PSYC 60,A01,188980,Rickard; Timothy C.,43,0,60,17
1683300082516,PSYC 70,A01,189001,Steiner; Eric Tomas,24,0,45,21
1683300083548,PSYC 100,A00,189005,Lacefield; Katharine I,0,99,120,120
1683300084572,PSYC 102,A00,189008,Staff,10,0,30,20
1683300085596,PSYC 106,B00,189026,Gorman; Michael R.,37,0,60,23
1683300086621,PSYC 114,B01,189033,Winkielman; Piotr,0,32,30,30
1683300087648,PSYC 131,A00,189036,Anagnostaras; Stephan,0,43,60,60
1683300088675,PSYC 136,A00,189041,Lowe; Angela Beth,0,7,25,25
1683300089698,PSYC 137,A00,189057,Winkielman; Piotr,0,34,25,25
1683300090721,PSYC 144,A00,189107,Wixted; John T,0,7,50,50
1683300092767,PSYC 162,A00,189142,Staff,0,8,85,85
1683300093794,PSYC 172,A00,189144,Gorman; Michael R.,0,7,30,30
1683300095845,PSYC 179,A00,189146,Lacefield; Katharine I,0,84,120,120
1683300096873,PSYC 181,A00,189147,Anagnostaras; Stephan,0,44,90,90
1683300097901,PSYC 190R,A00,189148,Barner; David A.,0,22,80,80
1683300098929,PSYC 191,A00,189275,Rickard; Timothy C.,0,7,25,25
1683300099953,PSYC 193,A00,189276,Chapman; Eddie Nathaniel,0,1,0,4
1683300100978,PSYC 193L,A01,189281,Lowe; Angela Beth,12,0,20,8
1683300100978,PSYC 193L,B01,189285,Staff,28,0,35,7
1683300102006,RELI 149,A00,187137,Rahimi; Babak,7,0,40,33
1683300103032,SE 9,A01,187315,Staff,0,2,18,18
1683300104059,SE 101B,A00,187409,Staff,24,0,30,6
1683300105094,SE 110B,A00,187444,Staff,10,0,40,30
1683300106118,SE 130B,A00,187449,Staff,31,0,40,9
1683300107144,SE 150A,A00,187516,Staff,9,0,20,11
1683300108169,SE 154,A00,187528,Staff,30,0,50,20
1683300109193,SIO 3,A01,258171,Staff,35,0,40,5
1683300110229,SIO 10,A00,187144,Cook; Geoffrey W,0,3,75,75
1683300111253,SIO 45,A00,187152,Cook; Geoffrey W,1,0,100,99
1683300112278,SIO 109R,A00,194486,Staff,0,3,20,20
1683300114328,SIO 187,A01,187233,Kacev; David,12,0,40,28
1683300115355,SOCI 1,A01,258656,Thorpe; Charles Robert,28,0,30,2
1683300115355,SOCI 1,A02,258658,Thorpe; Charles Robert,30,0,30,0
1683300115355,SOCI 1,A03,258661,Thorpe; Charles Robert,25,0,25,0
1683300115355,SOCI 1,A04,258666,Thorpe; Charles Robert,22,0,25,3
1683300115355,SOCI 1,A05,258897,Thorpe; Charles Robert,23,0,25,2
1683300115355,SOCI 1,A06,258898,Thorpe; Charles Robert,25,0,25,0
1683300116383,SOCI 30,A01,258903,Pardo Guerra; Juan Pablo,16,0,30,14
1683300117411,SOCI 102,A00,258904,Staff,9,0,25,16
1683300118435,SOCI 106,A00,258905,Staff,19,0,25,6
1683300119460,SOCI 111,A00,258907,Ribas Norris; Janet Vanesa,26,0,30,4
1683300120486,SOCI 121R,A00,258908,Pardo Guerra; Juan Pablo,11,0,30,19
1683300121516,SOCI 126,A01,203330,Staff,14,0,20,6
1683300122539,SOCI 131,A00,258909,Thorpe; Charles Robert,31,0,60,29
1683300123563,SOCI 135,A00,258910,Payne; Christine Anna,0,9,30,30
1683300124587,SOCI 157,A00,258911,Staff,13,0,30,17
1683300125612,SOCI 184,A00,258912,Staff,26,0,30,4
1683300126637,SOCI 188D,A00,258913,Staff,21,0,30,9
1683300127666,SYN 2,001,187529,Staff,9,0,16,7
1683300127666,SYN 2,002,201452,Staff,0,18,16,16
1683300127666,SYN 2,003,201469,Staff,3,0,16,13
1683300128690,SYN 100,A01,187531,Staff,0,9,20,20
1683300128690,SYN 100,B01,201491,Staff,0,12,20,20
1683300129714,TDAC 1,A00,189286,Walsh; Kim C.,3,0,20,17
1683300129714,TDAC 1,B00,189287,Harting; Carla Kelso,11,0,20,9
1683300130737,TDAC 101,A00,189300,Walsh; Kim C.,16,0,20,4
1683300130737,TDAC 101,B00,189301,Harting; Carla Kelso,18,0,20,2
1683300131761,TDAC 102,A00,189304,Basso; Beatrice,14,0,20,6
1683300132786,TDAC 108,A00,189305,Staff,18,0,20,2
1683300133818,TDDE 131,A00,189310,Staff,19,0,20,1
1683300133818,TDDE 131,B00,189314,Staff,19,0,20,1
1683300133818,TDDE 131,C00,189315,Staff,48,0,50,2
1683300133818,TDDE 131,D00,189316,Staff,14,0,15,1
1683300133818,TDDE 131,E00,204841,Staff,20,0,20,0
1683300134841,TDGE 10,A00,189289,Staff,30,0,50,20
1683300134841,TDGE 10,B00,189290,Havis; Allan,2,0,50,48
1683300135867,TDGE 11,A00,189291,Fulton; Julia,0,3,50,50
1683300135867,TDGE 11,B00,189292,Staff,20,0,25,5
1683300135867,TDGE 11,C00,260270,Staff,0,0,0,0
1683300136895,TDGE 25,A00,189294,Staff,3,0,20,17
1683300137920,TDGE 124,A00,189318,Fulton; Julia,0,8,50,50
1683300138948,TDGE 125,A00,189319,Staff,13,0,25,12
1683300138948,TDGE 125,B00,189320,Staff,23,0,25,2
1683300139972,TDGE 127,A00,189322,Havis; Allan,0,0,50,50
1683300141002,TDHT 101,A00,189323,Staff,18,0,25,7
1683300141002,TDHT 101,B00,189324,Staff,25,0,25,0
1683300142029,TDHT 102,A00,189325,Staff,49,0,50,1
1683300143055,TDMV 1,A00,189295,Arcidiacono; Kristin,20,0,30,10
1683300143055,TDMV 1,B00,189296,Caligagan; Maria T.,24,0,30,6
1683300144083,TDMV 2,A00,189297,Sammartano; Tonnie,28,0,30,2
1683300144083,TDMV 2,B00,189299,Arcidiacono; Kristin,24,0,30,6
1683300145110,TDMV 3,A00,204998,Rincon; Alicia,22,0,30,8
1683300146134,TDMV 120,A00,189458,Sammartano; Tonnie,28,0,30,2
1683300147158,TDMV 138,A00,189541,Jun; Grace Shin Hae,22,0,40,18
1683300148182,TDMV 142,A00,189717,Caligagan; Tony,23,0,30,7
1683300148182,TDMV 142,B00,189718,Caligagan; Maria T.,25,0,30,5
1683300149206,TMC 2,A01,187533,Staff,25,0,25,0
1683300149206,TMC 2,A02,187534,Staff,25,0,25,0
1683300150250,USP 1,A01,187536,Kwak; Nancy,0,16,25,25
1683300151273,USP 5,A01,187538,Staff,9,0,25,16
1683300152301,USP 101,A00,199253,Staff,0,4,0,0
1683300153325,USP 124,A00,187562,Boomhower; Matthew Charles,1,0,30,29
1683300154350,USP 138,A00,187582,Staff,20,0,25,5
1683300155376,USP 152,A01,187597,Staff,4,0,25,21
1683300156401,USP 153,A00,187598,Staff,19,0,25,6
1683300157428,USP 168,A00,187607,Kwak; Nancy,2,0,5,3
1683300158452,USP 173,A00,187619,Staff,4,0,25,21
1683300159477,USP 181,A00,187638,Staff,0,0,25,25
1683300160501,VIS 103,A00,187650,Cruz; Edwin Teddy,23,0,75,52
1683300161525,VIS 110D,A00,187669,Staff,12,0,22,10
1683300162552,VIS 127C,A00,187720,Shen; Kuiyi,68,0,146,78
1683300163580,VIS 149,A00,187731,Yoldas; Pinar,0,14,22,22
1683300164604,VIS 151,A01,188091,Staff,22,0,34,12
1683300164604,VIS 151,A02,188092,Staff,11,0,34,23
1683300165632,VIS 160B,A00,188093,Stalbaum; Brett,0,0,10,10
1683300167683,WCWP 10B,A00,201720,Staff,10,0,15,5
1683300167683,WCWP 10B,B00,201722,Staff,8,0,15,7
1683300168706,WCWP 100,A00,201725,Gagnon; Jeffrey C,0,0,2,2
1683300168706,WCWP 100,B00,201727,Staff,0,4,15,15
1683300171797,ANBI 133,A00,258401,Wilder; Linnea Lorene,34,0,40,6
1683300172824,ANBI 140,A00,258395,Hrvoj Mihic; Branka,18,0,25,7
1683300173851,ANSC 120,A00,258402,Bialecki; Jon Anthony,27,0,40,13
1683300174877,ANSC 144,A00,258400,Staff,14,0,40,26
1683300176933,ANSC 166,A00,258396,Parish; Steven Martin,157,0,175,18
1683300177958,ANSC 180,A00,193533,Staff,9,0,20,11
1683300178984,ANSC 188,A00,258397,Jassal; Aftab,33,0,40,7
1683300180010,ANTH 3,A01,258316,Staff,23,0,30,7
1683300181035,ANTH 5,A00,258394,Semendeferi; Ekaterini,16,0,20,4
1683300182123,ANTH 21,A01,258331,Staff,9,0,40,31
1683300183153,ANTH 103,A00,258398,Varma; Saiba,15,0,25,10
1683300184197,AWP 10,001,202034,Staff,0,0,0,0
1683300184197,AWP 10,002,202035,Staff,0,0,0,0
1683300184197,AWP 10,003,202036,Staff,0,0,0,0
1683300184197,AWP 10,004,202037,Staff,0,0,0,0
1683300184197,AWP 10,005,202038,Staff,0,0,0,0
1683300184197,AWP 10,006,202039,Staff,0,0,0,0
1683300184197,AWP 10,007,202040,Staff,0,0,0,0
1683300184197,AWP 10,008,202041,Staff,0,0,0,0
1683300184197,AWP 10,009,202042,Staff,0,0,0,0
1683300184197,AWP 10,010,202043,Staff,0,0,0,0
1683300184197,AWP 10,011,202044,Staff,0,0,0,0
1683300184197,AWP 10,012,202045,Staff,0,0,0,0
1683300184197,AWP 10,013,202046,Staff,0,0,0,0
1683300184197,AWP 10,014,202047,Staff,0,0,0,0
1683300184197,AWP 10,015,202048,Staff,0,0,0,0
1683300184197,AWP 10,016,202049,Staff,0,0,0,0
1683300184197,AWP 10,017,202050,Staff,0,0,0,0
1683300184197,AWP 10,018,202051,Staff,0,0,0,0
1683300184197,AWP 10,019,202052,Staff,0,0,0,0
1683300184197,AWP 10,020,202053,Staff,0,0,0,0
1683300184197,AWP 10,021,202054,Staff,0,0,0,0
1683300184197,AWP 10,022,202055,Staff,0,0,0,0
1683300184197,AWP 10,023,202056,Staff,0,0,0,0
1683300184197,AWP 10,024,202057,Staff,0,0,0,0
1683300184197,AWP 10,025,202058,Staff,0,0,0,0
1683300184197,AWP 10,026,202059,Staff,0,0,0,0
1683300185225,AWP 102,001,202032,Staff,0,0,0,0
1683300185225,AWP 102,002,202033,Staff,0,0,0,0
1683300186251,BENG 100,A01,254234,Taylor Amos; Alyssa C,31,0,40,9
1683300187275,BENG 196,001,270013,Engler; Adam J.,9999,0,9999,0
1683300188302,BICD 100R,A01,202018,Smith; Laurie,0,7,32,32
1683300188302,BICD 100R,A02,202019,Smith; Laurie,0,2,32,32
1683300188302,BICD 100R,A03,202020,Smith; Laurie,0,1,32,32
1683300188302,BICD 100R,A04,202021,Smith; Laurie,8,0,32,24
1683300188302,BICD 100R,A05,202022,Smith; Laurie,12,0,32,20
1683300189328,BICD 136,A01,193242,Gustafson-Brown; Cindy,0,2,32,32
1683300189328,BICD 136,A02,193244,Gustafson-Brown; Cindy,15,0,32,17
1683300190353,BIEB 102,A01,193249,Butler; Shannon Rhey,0,2,32,32
1683300190353,BIEB 102,A02,193251,Butler; Shannon Rhey,0,0,32,32
1683300190353,BIEB 102,A03,193253,Butler; Shannon Rhey,0,1,32,32
1683300190353,BIEB 102,A04,193255,Butler; Shannon Rhey,17,0,32,15
1683300190353,BIEB 102,A05,193265,Butler; Shannon Rhey,26,0,32,6
1683300190353,BIEB 102,A06,193269,Butler; Shannon Rhey,16,0,32,16
1683300192402,BIEB 150,A01,193274,Staff,0,0,32,32
1683300192402,BIEB 150,A02,193285,Staff,24,0,32,8
1683300193432,BIEB 194,A00,193286,Kurle; Carolyn M.,22,0,32,10
1683300194458,BILD 1,A01,192291,Staff,16,0,32,16
1683300194458,BILD 1,A02,192292,Staff,30,0,32,2
1683300194458,BILD 1,B01,192520,Reuther; Keefe,0,1,0,0
1683300194458,BILD 1,B02,192532,Reuther; Keefe,0,1,0,0
1683300195489,BILD 3,A01,192556,Butler; Shannon Rhey,0,0,32,32
1683300195489,BILD 3,A02,192581,Butler; Shannon Rhey,5,0,32,27
1683300195489,BILD 3,A03,192611,Butler; Shannon Rhey,23,0,32,9
1683300195489,BILD 3,A04,192612,Butler; Shannon Rhey,25,0,32,7
1683300195489,BILD 3,A05,192613,Butler; Shannon Rhey,27,0,32,5
1683300195489,BILD 3,A06,192679,Butler; Shannon Rhey,27,0,32,5
1683300195489,BILD 3,A07,192682,Butler; Shannon Rhey,22,0,32,10
1683300196517,BILD 4,A01,192836,Reuther; Keefe,1,0,24,23
1683300196517,BILD 4,A02,193044,Reuther; Keefe,4,0,24,20
1683300197545,BILD 10,A01,193142,Gustafson-Brown; Cindy,31,0,32,1
1683300197545,BILD 10,A02,193149,Gustafson-Brown; Cindy,31,0,32,1
1683300198575,BIMM 100,A01,193301,Staff,0,6,32,32
1683300198575,BIMM 100,A02,193312,Staff,0,5,32,32
1683300198575,BIMM 100,A03,193323,Staff,0,8,32,32
1683300199602,BIMM 101,A01,193329,McDonnell; Lisa Marie,0,3,24,24
1683300199602,BIMM 101,A02,193339,McDonnell; Lisa Marie,0,2,24,24
1683300199602,BIMM 101,B01,193354,McDonnell; Lisa Marie,0,3,24,24
1683300199602,BIMM 101,B02,193357,McDonnell; Lisa Marie,0,3,24,24
1683300200628,BIMM 110,A01,193377,Tat; John,0,11,32,32
1683300200628,BIMM 110,A02,193378,Tat; John,1,9,32,31
1683300201656,BIMM 120,A01,206116,Staff,0,0,32,32
1683300201656,BIMM 120,A02,206117,Staff,8,0,32,24
1683300201656,BIMM 120,A03,206121,Staff,21,0,32,11
1683300202686,BIPN 100,A01,193393,Park; Ji Young,0,14,32,32
1683300202686,BIPN 100,A02,193402,Park; Ji Young,0,12,32,32
1683300202686,BIPN 100,A03,193413,Park; Ji Young,0,14,32,32
1683300202686,BIPN 100,A04,193414,Park; Ji Young,0,13,32,32
1683300203711,BIPN 102,A01,193429,Staff,0,0,32,32
1683300203711,BIPN 102,A02,193438,Staff,23,0,32,9
1683300204736,BIPN 106,A01,193450,Reyes Gonzalez; Catalina,0,2,40,40
1683300205762,BIPN 134,A01,193465,Cooke; James Edward,0,0,32,32
1683300205762,BIPN 134,A02,193474,Cooke; James Edward,27,0,32,5
1683300205762,BIPN 134,A03,193485,Cooke; James Edward,29,0,32,3
1683300205762,BIPN 134,A04,193486,Cooke; James Edward,21,0,32,11
1683300205762,BIPN 134,A05,193491,Cooke; James Edward,31,0,32,1
1683300205762,BIPN 134,A06,193501,Cooke; James Edward,30,0,32,2
1683300205762,BIPN 134,A07,193510,Cooke; James Edward,29,0,32,3
1683300207814,BISP 194,A00,222522,Staff,16,0,32,16
1683300208840,CAT 124,A01,202407,Staff,20,0,25,5
1683300209865,CAT 125,A00,202408,Marchisotto; Jennifer Anne,4,0,20,16
1683300210897,CAT 125R,A00,202409,Smith; Lauryn Alissa,0,11,20,20
1683300210897,CAT 125R,B00,202410,Morales; Celeste Georgianna,0,11,20,20
1683300210897,CAT 125R,C00,202411,Irwin; Matthew Joseph,0,10,20,20
1683300211923,CENG 15,A01,204712,Yang; Kesong,0,1,0,0
1683300212948,CENG 114,A00,202070,Jahed Motlagh; Zeinab,5,0,20,15
1683300213973,CGS 105,A00,185477,Wesling; Megan E.,24,0,40,16
1683300215001,CGS 106,A00,185494,Staff,13,0,22,9
1683300216026,CGS 108,A00,185495,Staff,14,0,20,6
1683300217054,CGS 114,A00,185496,Staff,13,0,18,5
1683300218081,CGS 119,A00,185501,Staff,15,0,20,5
1683300219107,CGS 120,A00,185511,Staff,13,0,20,7
1683300220137,CHEM 4,A01,184675,Bussey; Thomas J,96,0,100,4
1683300221163,CHEM 6A,A01,184677,Staff,35,0,60,25
1683300222188,CHEM 6B,A01,184679,Staff,65,0,100,35
1683300223217,CHEM 6C,A01,184681,Bussey; Thomas J,1,0,50,49
1683300223217,CHEM 6C,A02,184682,Bussey; Thomas J,34,0,50,16
1683300224252,CHEM 40A,A01,184684,Albizati; Kim F.,37,0,100,63
1683300225280,CHEM 40B,A01,184686,Albizati; Kim F.,0,20,100,100
1683300226304,CHEM 41B,A01,184690,Staff,52,0,100,48
1683300227335,COGS 3,A01,184715,Boyle; Mary E. T.,0,25,40,40
1683300228358,COGS 14B,A01,185172,Staff,0,15,38,38
1683300229383,COGS 18,A01,184736,Staff,20,0,80,60
1683300230413,COGS 100,A01,184932,Staff,0,5,73,73
1683300231438,COGS 101A,A01,184935,Staff,0,38,30,30
1683300232463,COGS 101B,A01,184944,Staff,0,2,30,30
1683300233490,COGS 101C,A01,184946,Staff,0,12,30,30
1683300234518,COGS 102A,A01,184951,Johnson; Christine M.,2,0,40,38
1683300235543,COGS 107B,A01,184953,Mooshagian; Eric Frederick,0,50,40,40
1683300236568,COGS 118B,A01,184959,Gupta; Anjum,0,48,40,40
1683300237596,COGS 153,A00,184961,Staff,0,15,30,30
1683300238624,COGS 177,A00,184962,Staff,0,21,30,30
1683300239649,COGS 187A,A01,184969,Boyle; Mary E. T.,0,17,40,40
1683300240674,COMM 10,A01,185174,Staff,0,5,25,25
1683300240674,COMM 10,A02,185189,Staff,0,5,25,25
1683300240674,COMM 10,A03,269821,Staff,0,0,0,0
1683300241700,COMM 100B,A01,185475,Staff,0,0,0,2
1683300241700,COMM 100B,A02,185476,Staff,14,0,25,11
1683300242725,COMM 100C,A01,185314,Staff,1,0,25,24
1683300242725,COMM 100C,A02,185327,Staff,19,0,25,6
1683300243750,COMM 110M,A00,185349,Staff,2,0,40,38
1683300244778,COMM 113T,A00,185352,Staff,25,0,40,15
1683300245810,COMM 114I,A00,185353,Staff,33,0,40,7
1683300246837,COMM 131,A00,185354,Staff,19,0,30,11
1683300247869,CSE 8A,A50,185358,Cao; Yingjun,0,46,10,10
1683300248896,CSE 8B,A01,185362,Staff,1,47,50,49
1683300249925,CSE 11,A01,185416,Cao; Yingjun,0,93,10,10
1683300250949,CSE 20,A01,185445,Briones; Jor-el Thomas Caparas,5,0,25,20
1683300251978,CSE 21,A01,185447,Staff,10,0,50,40
1683300253003,CSE 101,A01,185451,Staff,0,12,50,50
1683300253003,CSE 101,B01,185453,Jones; Miles E,0,11,50,50
1683300255060,CSE 141,A01,185458,Eldon; John,20,0,100,80
1683300256085,CSE 141L,A01,185461,Eldon; John,12,0,100,88
1683300257114,CSE 142,A01,185463,Staff,35,0,60,25
1683300257114,CSE 142,B01,201355,Staff,0,6,60,60
1683300258145,CSE 142L,A01,185470,Staff,35,0,60,25
1683300258145,CSE 142L,B01,201417,Staff,0,5,60,60
1683300259168,CSE 190,A00,201433,Staff,32,0,49,17
1683300260195,DOC 1,A01,259136,Strom; Megan C.,8,0,15,7
1683300260195,DOC 1,A02,259137,Strom; Megan C.,14,0,15,1
1683300260195,DOC 1,A03,259138,Strom; Megan C.,14,0,15,1
1683300260195,DOC 1,A04,259139,Strom; Megan C.,14,0,15,1
1683300261218,DOC 100D,A00,259140,Pass; Natalye Joann,17,0,25,8
1683300262240,DSGN 1,A01,184749,Rill; Bryan,0,24,30,30
1683300263265,DSGN 100,A01,185168,Staff,0,2,25,25
1683300264291,ECE 5,A01,185626,Morris; Karcher William,0,10,0,0
1683300265320,ECE 101,A01,185628,Staff,17,0,70,53
1683300266344,ECE 107,A01,185635,Baghdadchi; Saharnaz,0,0,20,20
1683300266344,ECE 107,A02,185638,Baghdadchi; Saharnaz,4,0,20,16
1683300267368,ECE 148,A01,185647,Silberman; Jack,1,0,16,15
1683300268393,ECON 1,A01,185537,Crane; Meredith Helen,54,0,70,16
1683300269420,ECON 3,A01,185549,Crane; Meredith Helen,33,0,70,37
1683300270447,ECON 4,A01,203354,Anderson; John Charles,0,4,10,10
1683300271473,ECON 100A,A01,185574,Staff,0,4,40,40
1683300272504,ECON 100B,A01,185576,Staff,0,22,40,40
1683300273529,ECON 100C,A01,185589,Newhouse; Herbert S,30,0,70,40
1683300274556,ECON 105,A00,185608,Vespa; Emanuel Ignacio,19,0,35,16
1683300275583,ECON 109,A01,185610,Shishkin; Denis,10,0,35,25
1683300276612,ECON 110A,A01,185612,Staff,11,0,40,29
1683300277640,ECON 120A,A01,185615,Staff,20,0,40,20
1683300278664,ECON 120C,A01,185617,Sun; Yixiao,0,20,70,70
1683300279694,ECON 144,A00,203346,Squires; Dale E,3,0,35,32
1683300280719,ECON 171,A01,203349,Newhouse; Herbert S,0,1,35,35
1683300281744,ECON 173A,A01,185621,Toda; Alexis Akira,21,0,35,14
1683300282772,EDS 25,A01,202413,Staff,0,1,0,0
1683300282772,EDS 25,A02,202414,Staff,0,1,0,0
1683300282772,EDS 25,A03,202415,Staff,0,0,0,0
1683300282772,EDS 25,A04,202416,Staff,0,1,0,0
1683300282772,EDS 25,A05,202439,Staff,0,0,0,0
1683300282772,EDS 25,A06,202440,Staff,0,0,0,0
1683300282772,EDS 25,B01,202631,Staff,0,0,0,0
1683300282772,EDS 25,B02,202632,Staff,0,0,0,0
1683300282772,EDS 25,B03,202639,Staff,0,0,0,0
1683300282772,EDS 25,B04,202640,Staff,0,0,0,0
1683300282772,EDS 25,B05,202643,Staff,0,0,0,0
1683300282772,EDS 25,B06,202644,Staff,0,0,0,0
1683300283798,EDS 38,A01,202659,Black; Alison Michelle,24,0,25,1
1683300284824,EDS 115,A00,202652,Staff,17,0,30,13
1683300285907,EDS 125,A00,202649,Staff,14,0,30,16
1683300286931,EDS 126,A01,203332,Staff,30,0,30,0
1683300287959,EDS 139,A00,202838,Staff,17,0,25,8
1683300288987,EDS 146,A01,202655,Staff,15,0,25,10
1683300290012,ENG 15,A00,185667,Staff,0,1,0,0
1683300290012,ENG 15,B00,185672,Staff,0,0,0,0
1683300290012,ENG 15,C00,185675,Staff,0,0,0,0
1683300290012,ENG 15,D00,185682,Staff,0,0,0,0
1683300290012,ENG 15,E00,185684,Staff,0,0,0,0
1683300291038,ETHN 103,A00,185710,Staff,0,3,35,35
1683300292062,ETHN 103A,A00,199228,Man; Simeon S,3,0,9,6
1683300293089,ETHN 109,A00,185711,Staff,18,0,35,17
1683300294117,ETHN 142,A00,185726,Staff,0,4,30,30
1683300295141,ETHN 163J,A00,199229,Man; Simeon S,6,0,8,2
1683300296166,ETHN 168,A00,185727,Staff,8,0,10,2
1683300297191,ETHN 182,A00,185728,Staff,1,0,35,34
1683300298216,ETHN 183,A00,185737,Staff,8,0,18,10
1683300299241,GLBH 111,A01,209361,Burgos; Jose L.,0,0,0,0
1683300301290,HIEU 104,A00,185792,Staff,16,0,20,4
1683300302319,HIEU 115,A00,185800,Staff,1,0,20,19
1683300303348,HIEU 128,A00,185801,Staff,0,7,20,20
1683300304378,HIEU 147,A00,185802,Staff,16,0,20,4
1683300305406,HIEU 154,A00,185823,Staff,12,0,20,8
1683300306433,HILA 102,A00,185826,Staff,13,0,20,7
1683300307456,HILD 2C,A01,185778,Staff,0,12,20,20
1683300308482,HILD 7B,A01,185780,Kwak; Nancy,0,15,32,32
1683300308482,HILD 7B,A02,185781,Kwak; Nancy,0,18,32,32
1683300309510,HILD 30,A01,185791,Staff,14,0,20,6
1683300310533,HISC 119,A00,185830,Golan; Tal,0,9,20,20
1683300311566,HITO 156GS,A00,185831,Patterson; Patrick H.,0,0,0,23
1683300312591,HIUS 103,A00,185832,Man; Simeon S,0,7,20,20
1683300313623,HIUS 117,A00,185836,Kwak; Nancy,2,0,20,18
1683300314646,HIUS 125,A00,185840,Man; Simeon S,0,0,23,23
1683300315670,HIUS 149,A00,185845,Staff,0,0,20,20
1683300316700,HUM 3,A01,185882,Zavodny; Tatiana Sophia,0,6,50,50
1683300316700,HUM 3,B01,185899,Caldwell; Michael Alan,0,19,50,50
1683300317724,HUM 3GS,A00,185900,Patterson; Patrick H.,0,0,0,23
1683300318750,HUM 4,A01,185938,Zroka; Amy Liane,31,0,50,19
1683300318750,HUM 4,B01,185956,Watkins; Eric,0,2,50,50
1683300318750,HUM 4,B02,202209,Watkins; Eric,0,1,50,50
1683300318750,HUM 4,B03,202210,Watkins; Eric,0,0,50,50
1683300319781,HUM 5,A01,185958,West; Geoffrey Scott,5,0,50,45
1683300319781,HUM 5,A02,202215,West; Geoffrey Scott,0,0,50,50
1683300320806,INTL 190,A00,185959,Gagnon; Jeffrey C,0,0,0,9
1683300320806,INTL 190,B00,185960,Lettieri; Michael Joseph,0,0,0,1
1683300321834,JAPN 180,A00,254509,Staff,0,1,25,25
1683300322859,LATI 10,A01,202853,Kennemore; Amy Michelle,5,0,35,30
1683300322859,LATI 10,A02,202854,Kennemore; Amy Michelle,1,0,35,34
1683300322859,LATI 10,A03,270054,Kennemore; Amy Michelle,30,0,30,0
1683300323895,LATI 180,A00,202855,Kennemore; Amy Michelle,11,0,20,9
1683300324922,LAWS 101,A00,201767,Golan; Tal,0,7,40,40
1683300325946,LIFR 1C,A00,185961,Staff,6,0,20,14
1683300326971,LIFR 1CX,A00,185962,Staff,7,0,20,13
1683300327997,LIFR 1D,A00,185963,Staff,9,0,20,11
1683300329020,LIFR 1DX,A00,185964,Staff,9,0,20,11
1683300330045,LIGN 101,A01,186039,Staff,43,0,50,7
1683300331071,LIGN 165,A00,186040,Staff,18,0,50,32
1683300332095,LTCS 108,A00,186041,Staff,6,0,10,4
1683300333121,LTCS 119,A00,186042,Staff,16,0,20,4
1683300334144,LTCS 130,A00,186043,Wesling; Megan E.,15,0,25,10
1683300336210,LTEA 138,A00,186119,Staff,14,0,40,26
1683300337238,LTEN 124,A00,186148,Staff,6,0,25,19
1683300338264,LTEN 178,A00,186149,Staff,7,0,15,8
1683300339328,LTEN 181,A00,186150,Blanco; John D,33,0,40,7
1683300340352,LTWL 120,A00,186160,Staff,20,0,25,5
1683300341379,LTWL 165,A00,186161,Staff,22,0,25,3
1683300342405,LTWR 100,A00,186162,Staff,0,4,15,15
1683300343428,LTWR 102,A00,186163,Doller; Ben,5,0,15,10
1683300344454,MAE 8,A01,186412,Staff,0,0,0,0
1683300345479,MAE 30B,A00,186445,Bahadori; Mohammad Yousef,83,0,100,17
1683300346503,MAE 40,A00,186592,Bewley; Thomas R,9,0,50,41
1683300347531,MAE 101B,A00,186593,Bahadori; Mohammad Yousef,81,0,100,19
1683300348555,MAE 105,A00,186594,Bandaru; Prabhakar,12,0,50,38
1683300349578,MAE 107,A00,186599,Pham; Hieu Tan,0,6,120,120
1683300350602,MAE 148,A01,186660,Silberman; Jack,3,0,16,13
1683300351627,MATH 10A,A01,188095,Staff,0,7,35,35
1683300352652,MATH 10B,A01,188097,Bowers; Adam R.,0,11,30,30
1683300352652,MATH 10B,A02,188099,Bowers; Adam R.,0,9,30,30
1683300352652,MATH 10B,B01,188104,Bowers; Adam R.,0,11,30,30
1683300352652,MATH 10B,B02,188106,Bowers; Adam R.,0,11,30,30
1683300353678,MATH 10C,A01,188111,Staff,0,18,30,30
1683300353678,MATH 10C,A02,188127,Staff,0,17,30,30
1683300353678,MATH 10C,A03,188131,Staff,0,17,30,30
1683300353678,MATH 10C,B01,188218,Staff,21,0,30,9
1683300353678,MATH 10C,B02,188244,Staff,13,0,30,17
1683300353678,MATH 10C,B03,188277,Staff,16,0,30,14
1683300354703,MATH 18,A01,188344,Bach; Quang Tran,18,0,30,12
1683300354703,MATH 18,A02,188345,Bach; Quang Tran,11,0,30,19
1683300354703,MATH 18,B01,188353,Bach; Quang Tran,10,0,30,20
1683300354703,MATH 18,B02,188354,Bach; Quang Tran,20,0,30,10
1683300355727,MATH 20A,A01,188374,Staff,13,0,35,22
1683300356752,MATH 20B,A01,188382,Ohm; Ko Woon,6,0,30,24
1683300356752,MATH 20B,A02,188383,Ohm; Ko Woon,24,0,30,6
1683300356752,MATH 20B,B01,188385,Ohm; Ko Woon,7,0,30,23
1683300356752,MATH 20B,B02,188392,Ohm; Ko Woon,22,0,30,8
1683300357775,MATH 20C,A01,188394,Harel; Guershon,10,0,30,20
1683300357775,MATH 20C,A02,188395,Harel; Guershon,13,0,30,17
1683300357775,MATH 20C,B01,188404,Harel; Guershon,3,0,30,27
1683300357775,MATH 20C,B02,188405,Harel; Guershon,19,0,30,11
1683300358802,MATH 20D,A01,188414,Hammock; Frances H,0,1,30,30
1683300358802,MATH 20D,A02,188415,Hammock; Frances H,4,0,30,26
1683300358802,MATH 20D,B01,188447,Hammock; Frances H,2,0,30,28
1683300358802,MATH 20D,B02,188486,Hammock; Frances H,8,0,30,22
1683300359827,MATH 20E,A01,188649,Staff,22,0,30,8
1683300359827,MATH 20E,A02,188650,Staff,23,0,30,7
1683300359827,MATH 20E,A03,188673,Staff,0,0,30,30
1683300360859,MATH 102,A01,188675,Staff,0,35,35,35
1683300361886,MATH 103B,A01,188681,Staff,4,0,35,31
1683300361886,MATH 103B,B01,188692,Staff,7,0,35,28
1683300362922,MATH 109,A01,188695,Salehi Golsefidy; Alireza,25,0,35,10
1683300362922,MATH 109,A02,188696,Salehi Golsefidy; Alireza,27,0,35,8
1683300363947,MATH 120A,A01,188698,Eggers; John Dietrich,5,0,35,30
1683300364972,MATH 142B,A01,188736,Ioana; Adrian,0,2,30,30
1683300364972,MATH 142B,A02,188741,Ioana; Adrian,0,1,30,30
1683300364972,MATH 142B,A03,188743,Ioana; Adrian,0,3,30,30
1683300365997,MATH 168A,A01,188790,Staff,0,8,35,35
1683300367027,MATH 170A,A01,188803,Nie; Jiawang,0,2,35,35
1683300367027,MATH 170A,A02,188811,Nie; Jiawang,0,0,35,35
1683300367027,MATH 170A,A03,188814,Nie; Jiawang,1,0,35,34
1683300367027,MATH 170A,A04,188815,Nie; Jiawang,14,0,35,21
1683300368055,MATH 193B,A01,188817,Staff,0,0,35,35
1683300368055,MATH 193B,A02,188818,Staff,5,0,35,30
1683300369083,MGT 4,A01,202857,Anderson; John Charles,62,0,80,18
1683300370110,MGT 12,A00,202858,Lindenberger; Wade Douglas,43,0,90,47
1683300371137,MGT 18,A00,202859,Staff,74,0,90,16
1683300372165,MGT 18GS,A00,202860,McKay; Michael J,13,0,28,15
1683300373188,MGT 45,A00,202861,Pecore; Joseph P.,14,0,90,76
1683300374212,MGT 100,A00,202863,Yavorsky; Daniel Ryan,28,0,90,62
1683300375236,MGT 103,A00,202864,Ehrich; Kristine R,0,16,90,90
1683300376261,MGT 112,A00,202865,Ehrich; Kristine R,15,0,90,75
1683300377290,MGT 121A,A00,202868,Staff,0,19,0,0
1683300378317,MGT 131B,A00,202869,Anderson; John Charles,59,0,90,31
1683300379341,MGT 136,A00,202871,Lindenberger; Wade Douglas,84,0,90,6
1683300380376,MGT 164,A00,202873,Staff,0,69,90,90
1683300381402,MGT 164GS,A00,202874,McKay; Mary A,13,0,28,15
1683300382426,MGT 180,A00,202875,Staff,0,51,90,90
1683300383456,MMW 11R,A01,205019,Herbst; Matthew,3,0,30,27
1683300383456,MMW 11R,A02,205026,Herbst; Matthew,29,0,30,1
1683300384481,MMW 15,A01,193512,Chang; Edmond Yi-Teh,0,9,28,28
1683300384481,MMW 15,A02,193513,Chang; Edmond Yi-Teh,0,5,28,28
1683300384481,MMW 15,A03,193514,Chang; Edmond Yi-Teh,0,5,28,28
1683300384481,MMW 15,A04,193515,Chang; Edmond Yi-Teh,0,4,28,28
1683300384481,MMW 15,A05,193516,Chang; Edmond Yi-Teh,0,4,28,28
1683300384481,MMW 15,A06,193517,Chang; Edmond Yi-Teh,0,5,28,28
1683300384481,MMW 15,B01,193519,Chang; Edmond Yi-Teh,0,4,28,28
1683300384481,MMW 15,B02,193520,Chang; Edmond Yi-Teh,0,5,28,28
1683300384481,MMW 15,B03,193521,Chang; Edmond Yi-Teh,0,4,28,28
1683300384481,MMW 15,B04,193522,Chang; Edmond Yi-Teh,0,4,28,28
1683300384481,MMW 15,B05,193523,Chang; Edmond Yi-Teh,0,5,28,28
1683300384481,MMW 15,B06,193524,Chang; Edmond Yi-Teh,0,4,28,28
1683300385506,MMW 122,A01,193526,Rahimi; Babak,0,14,28,28
1683300385506,MMW 122,A02,193527,Rahimi; Babak,0,14,28,28
1683300385506,MMW 122,A03,193528,Rahimi; Babak,0,0,0,0
1683300385506,MMW 122,A04,193529,Rahimi; Babak,0,0,0,0
1683300386530,MUS 1A,A01,186663,Staff,0,20,35,35
1683300387555,MUS 4,A01,186715,Staff,0,12,35,35
1683300388584,MUS 5R,A01,186796,Dubnov; Shlomo,0,16,35,35
1683300389672,MUS 6,A01,186798,Staff,0,3,25,25
1683300390704,MUS 7,A01,186830,Staff,12,0,35,23
1683300391731,MUS 8,A01,186930,Staff,0,25,35,35
1683300392757,MUS 15,A01,186932,Staff,0,15,35,35
1683300392757,MUS 15,B01,186934,Staff,0,14,35,35
1683300393785,MUS 80,A00,186935,Staff,2,0,20,18
1683300393785,MUS 80,B00,186936,Staff,25,0,25,0
1683300394809,NANO 11,A00,204702,Lipomi; Darren John,0,0,0,0
1683300395838,NANO 15,A01,204709,Yang; Kesong,0,1,0,0
1683300396864,NANO 114,A00,202069,Jahed Motlagh; Zeinab,3,0,10,7
1683300397888,PHIL 1,A00,186955,Grush; Rick Scott,32,0,40,8
1683300398912,PHIL 10,A01,186973,Grush; Rick Scott,29,0,35,6
1683300398912,PHIL 10,A02,186974,Grush; Rick Scott,33,0,35,2
1683300399936,PHIL 13,A01,186976,Staff,7,0,35,28
1683300399936,PHIL 13,A02,186977,Staff,16,0,35,19
1683300400961,PHIL 14,A01,186979,Staff,31,0,35,4
1683300400961,PHIL 14,A02,186986,Staff,32,0,35,3
1683300401988,PHIL 28,A01,186988,Staff,16,0,30,14
1683300401988,PHIL 28,A02,186989,Staff,1,0,30,29
1683300401988,PHIL 28,A03,186990,Staff,9,0,30,21
1683300401988,PHIL 28,A04,186991,Staff,26,0,30,4
1683300403013,PHIL 120,A00,186997,Staff,23,0,40,17
1683300404037,PHIL 137,A00,187003,Staff,9,0,40,31
1683300405060,PHIL 150,A00,187015,Staff,47,0,70,23
1683300406086,PHIL 167,A00,187021,Lamey; Andy M.,35,0,40,5
1683300407112,PHIL 174,A01,202226,Staff,17,0,20,3
1683300407112,PHIL 174,A02,202235,Staff,20,0,20,0
1683300408136,PHIL 191A,A00,258918,Staff,0,0,1,1
1683300409159,PHYS 1A,A00,187028,Staff,26,0,60,34
1683300410183,PHYS 1AL,001,187036,Staff,2,0,30,28
1683300410183,PHYS 1AL,002,187049,Staff,18,0,30,12
1683300411209,PHYS 1B,A00,187058,Staff,23,0,60,37
1683300412233,PHYS 1BL,001,187064,Staff,0,0,30,30
1683300412233,PHYS 1BL,002,187070,Staff,6,0,30,24
1683300413260,PHYS 1C,A00,187082,Staff,32,0,120,88
1683300414285,PHYS 1CL,001,187088,Staff,0,9,30,30
1683300414285,PHYS 1CL,002,187089,Staff,0,2,30,30
1683300414285,PHYS 1CL,009,262693,Staff,12,0,30,18
1683300415310,PHYS 2B,A01,187097,Staff,54,0,115,61
1683300416337,PHYS 2C,A01,187099,Staff,67,0,115,48
1683300417362,PHYS 2CL,A01,187101,Staff,5,0,28,23
1683300417362,PHYS 2CL,A02,187102,Staff,15,0,28,13
1683300418386,PHYS 2D,A01,187123,Shotwell; Brian,95,0,115,20
1683300419411,PHYS 4B,A01,187133,Grinstein; Benjamin,35,0,50,15
1683300420435,POLI 10,A00,188819,Staff,0,3,50,50
1683300421461,POLI 11,A00,188827,Staff,43,0,50,7
1683300422486,POLI 13R,A00,188828,Staff,0,1,20,20
1683300423510,POLI 27,A01,188830,Elgin; Samuel Zincke,0,1,70,70
1683300424535,POLI 30,A00,188832,Desposato; Scott,33,0,50,17
1683300425559,POLI 102F,A00,188834,Staff,3,0,40,37
1683300426587,POLI 104A,A00,188852,Staff,14,0,30,16
1683300427614,POLI 104I,A00,188853,Staff,0,6,20,20
1683300428643,POLI 110B,A00,188854,Wiens; David,7,0,20,13
1683300429671,POLI 112A,A00,188855,Wiens; David,5,0,30,25
1683300430695,POLI 117R,A00,188856,Forman; Fonna,0,11,20,20
1683300431720,POLI 118,A00,188857,Ingham; Sean,8,0,20,12
1683300432747,POLI 120G,A00,188858,Staff,9,0,30,21
1683300433771,POLI 131CR,A00,188863,Hoston; Germaine,24,0,50,26
1683300434796,POLI 133,A00,188864,Nellis; Gareth Hb,44,0,50,6
1683300435821,POLI 134D,A00,188865,Desposato; Scott,27,0,30,3
1683300436850,POLI 142A,A00,188871,Gartzke; Erik,22,0,50,28
1683300437876,POLI 142K,A00,188874,Staff,38,0,50,12
1683300438903,POLI 143,A00,188940,Gartzke; Erik,16,0,30,14
1683300439930,POLI 153,A00,188943,Staff,3,0,20,17
1683300440955,POLI 160AA,A00,188944,Staff,13,0,40,27
1683300441983,POLI 170A,A00,188945,Staff,11,0,30,19
1683300444037,PSYC 1,A00,188952,Staff,38,0,90,52
1683300445062,PSYC 2,B00,188953,Staff,20,0,35,15
1683300446086,PSYC 6,A00,188970,Staff,47,0,60,13
1683300447113,PSYC 7,A00,188973,Staff,37,0,45,8
1683300448138,PSYC 60,A01,188980,Rickard; Timothy C.,43,0,60,17
1683300449164,PSYC 70,A01,189001,Steiner; Eric Tomas,24,0,45,21
1683300450191,PSYC 100,A00,189005,Lacefield; Katharine I,0,99,120,120
1683300451218,PSYC 102,A00,189008,Staff,10,0,30,20
1683300452243,PSYC 106,B00,189026,Gorman; Michael R.,37,0,60,23
1683300453267,PSYC 114,B01,189033,Winkielman; Piotr,0,32,30,30
1683300454294,PSYC 131,A00,189036,Anagnostaras; Stephan,0,43,60,60
1683300455322,PSYC 136,A00,189041,Lowe; Angela Beth,0,7,25,25
1683300456349,PSYC 137,A00,189057,Winkielman; Piotr,0,34,25,25
1683300457375,PSYC 144,A00,189107,Wixted; John T,0,7,50,50
1683300459430,PSYC 162,A00,189142,Staff,0,8,85,85
1683300460455,PSYC 172,A00,189144,Gorman; Michael R.,0,7,30,30
1683300462509,PSYC 179,A00,189146,Lacefield; Katharine I,0,84,120,120
1683300463537,PSYC 181,A00,189147,Anagnostaras; Stephan,0,44,90,90
1683300464562,PSYC 190R,A00,189148,Barner; David A.,0,22,80,80
1683300465586,PSYC 191,A00,189275,Rickard; Timothy C.,0,7,25,25
1683300466611,PSYC 193,A00,189276,Chapman; Eddie Nathaniel,0,1,0,4
1683300467639,PSYC 193L,A01,189281,Lowe; Angela Beth,12,0,20,8
1683300467639,PSYC 193L,B01,189285,Staff,28,0,35,7
1683300468664,RELI 149,A00,187137,Rahimi; Babak,7,0,40,33
1683300469688,SE 9,A01,187315,Staff,0,2,18,18
1683300470711,SE 101B,A00,187409,Staff,24,0,30,6
1683300471739,SE 110B,A00,187444,Staff,10,0,40,30
1683300472763,SE 130B,A00,187449,Staff,31,0,40,9
1683300473787,SE 150A,A00,187516,Staff,9,0,20,11
1683300474815,SE 154,A00,187528,Staff,30,0,50,20
1683300475842,SIO 3,A01,258171,Staff,35,0,40,5
1683300476866,SIO 10,A00,187144,Cook; Geoffrey W,0,3,75,75
1683300477891,SIO 45,A00,187152,Cook; Geoffrey W,1,0,100,99
1683300478919,SIO 109R,A00,194486,Staff,0,3,20,20
1683300480970,SIO 187,A01,187233,Kacev; David,12,0,40,28
1683300481995,SOCI 1,A01,258656,Thorpe; Charles Robert,28,0,30,2
1683300481995,SOCI 1,A02,258658,Thorpe; Charles Robert,30,0,30,0
1683300481995,SOCI 1,A03,258661,Thorpe; Charles Robert,25,0,25,0
1683300481995,SOCI 1,A04,258666,Thorpe; Charles Robert,22,0,25,3
1683300481995,SOCI 1,A05,258897,Thorpe; Charles Robert,23,0,25,2
1683300481995,SOCI 1,A06,258898,Thorpe; Charles Robert,25,0,25,0
1683300483019,SOCI 30,A01,258903,Pardo Guerra; Juan Pablo,16,0,30,14
1683300484045,SOCI 102,A00,258904,Staff,9,0,25,16
1683300485070,SOCI 106,A00,258905,Staff,19,0,25,6
1683300486095,SOCI 111,A00,258907,Ribas Norris; Janet Vanesa,26,0,30,4
1683300487120,SOCI 121R,A00,258908,Pardo Guerra; Juan Pablo,11,0,30,19
1683300488146,SOCI 126,A01,203330,Staff,14,0,20,6
1683300489170,SOCI 131,A00,258909,Thorpe; Charles Robert,31,0,60,29
1683300490198,SOCI 135,A00,258910,Payne; Christine Anna,0,9,30,30
1683300491223,SOCI 157,A00,258911,Staff,13,0,30,17
1683300492247,SOCI 184,A00,258912,Staff,26,0,30,4
1683300493325,SOCI 188D,A00,258913,Staff,21,0,30,9
1683300494350,SYN 2,001,187529,Staff,9,0,16,7
1683300494350,SYN 2,002,201452,Staff,0,18,16,16
1683300494350,SYN 2,003,201469,Staff,3,0,16,13
1683300495374,SYN 100,A01,187531,Staff,0,9,20,20
1683300495374,SYN 100,B01,201491,Staff,0,12,20,20
1683300496400,TDAC 1,A00,189286,Walsh; Kim C.,3,0,20,17
1683300496400,TDAC 1,B00,189287,Harting; Carla Kelso,11,0,20,9
1683300497426,TDAC 101,A00,189300,Walsh; Kim C.,16,0,20,4
1683300497426,TDAC 101,B00,189301,Harting; Carla Kelso,18,0,20,2
1683300498450,TDAC 102,A00,189304,Basso; Beatrice,14,0,20,6
1683300499476,TDAC 108,A00,189305,Staff,18,0,20,2
1683300500501,TDDE 131,A00,189310,Staff,19,0,20,1
1683300500501,TDDE 131,B00,189314,Staff,19,0,20,1
1683300500501,TDDE 131,C00,189315,Staff,48,0,50,2
1683300500501,TDDE 131,D00,189316,Staff,14,0,15,1
1683300500501,TDDE 131,E00,204841,Staff,20,0,20,0
1683300501526,TDGE 10,A00,189289,Staff,30,0,50,20
1683300501526,TDGE 10,B00,189290,Havis; Allan,2,0,50,48
1683300502558,TDGE 11,A00,189291,Fulton; Julia,0,3,50,50
1683300502558,TDGE 11,B00,189292,Staff,20,0,25,5
1683300502558,TDGE 11,C00,260270,Staff,0,0,0,0
1683300503587,TDGE 25,A00,189294,Staff,3,0,20,17
1683300504615,TDGE 124,A00,189318,Fulton; Julia,0,8,50,50
1683300505643,TDGE 125,A00,189319,Staff,13,0,25,12
1683300505643,TDGE 125,B00,189320,Staff,23,0,25,2
1683300506674,TDGE 127,A00,189322,Havis; Allan,0,0,50,50
1683300507700,TDHT 101,A00,189323,Staff,18,0,25,7
1683300507700,TDHT 101,B00,189324,Staff,25,0,25,0
1683300508724,TDHT 102,A00,189325,Staff,49,0,50,1
1683300509752,TDMV 1,A00,189295,Arcidiacono; Kristin,20,0,30,10
1683300509752,TDMV 1,B00,189296,Caligagan; Maria T.,24,0,30,6
1683300510780,TDMV 2,A00,189297,Sammartano; Tonnie,28,0,30,2
1683300510780,TDMV 2,B00,189299,Arcidiacono; Kristin,24,0,30,6
1683300511804,TDMV 3,A00,204998,Rincon; Alicia,22,0,30,8
1683300512829,TDMV 120,A00,189458,Sammartano; Tonnie,28,0,30,2
1683300513854,TDMV 138,A00,189541,Jun; Grace Shin Hae,22,0,40,18
1683300514882,TDMV 142,A00,189717,Caligagan; Tony,23,0,30,7
1683300514882,TDMV 142,B00,189718,Caligagan; Maria T.,25,0,30,5
1683300515908,TMC 2,A01,187533,Staff,25,0,25,0
1683300515908,TMC 2,A02,187534,Staff,25,0,25,0
1683300516934,USP 1,A01,187536,Kwak; Nancy,0,16,25,25
1683300517962,USP 5,A01,187538,Staff,9,0,25,16
1683300518987,USP 101,A00,199253,Staff,0,4,0,0
1683300520015,USP 124,A00,187562,Boomhower; Matthew Charles,1,0,30,29
1683300521041,USP 138,A00,187582,Staff,20,0,25,5
1683300522065,USP 152,A01,187597,Staff,4,0,25,21
1683300523090,USP 153,A00,187598,Staff,19,0,25,6
1683300524116,USP 168,A00,187607,Kwak; Nancy,2,0,5,3
1683300525140,USP 173,A00,187619,Staff,4,0,25,21
1683300526163,USP 181,A00,187638,Staff,0,0,25,25
1683300527191,VIS 103,A00,187650,Cruz; Edwin Teddy,23,0,75,52
1683300528217,VIS 110D,A00,187669,Staff,12,0,22,10
1683300529244,VIS 127C,A00,187720,Shen; Kuiyi,68,0,146,78
1683300530271,VIS 149,A00,187731,Yoldas; Pinar,0,14,22,22
1683300531296,VIS 151,A01,188091,Staff,22,0,34,12
1683300531296,VIS 151,A02,188092,Staff,11,0,34,23
1683300532320,VIS 160B,A00,188093,Stalbaum; Brett,0,0,10,10
1683300534370,WCWP 10B,A00,201720,Staff,10,0,15,5
1683300534370,WCWP 10B,B00,201722,Staff,8,0,15,7
1683300535394,WCWP 100,A00,201725,Gagnon; Jeffrey C,0,0,2,2
1683300535394,WCWP 100,B00,201727,Staff,0,4,15,15
1683300538508,ANBI 133,A00,258401,Wilder; Linnea Lorene,34,0,40,6
1683300539533,ANBI 140,A00,258395,Hrvoj Mihic; Branka,18,0,25,7
1683300540562,ANSC 120,A00,258402,Bialecki; Jon Anthony,27,0,40,13
1683300541588,ANSC 144,A00,258400,Staff,14,0,40,26
1683300543636,ANSC 166,A00,258396,Parish; Steven Martin,157,0,175,18
1683300544664,ANSC 180,A00,193533,Staff,9,0,20,11
1683300545688,ANSC 188,A00,258397,Jassal; Aftab,33,0,40,7
1683300546716,ANTH 3,A01,258316,Staff,23,0,30,7
1683300547740,ANTH 5,A00,258394,Semendeferi; Ekaterini,16,0,20,4
1683300548769,ANTH 21,A01,258331,Staff,9,0,40,31
1683300549798,ANTH 103,A00,258398,Varma; Saiba,15,0,25,10
1683300550826,AWP 10,001,202034,Staff,0,0,0,0
1683300550826,AWP 10,002,202035,Staff,0,0,0,0
1683300550826,AWP 10,003,202036,Staff,0,0,0,0
1683300550826,AWP 10,004,202037,Staff,0,0,0,0
1683300550826,AWP 10,005,202038,Staff,0,0,0,0
1683300550826,AWP 10,006,202039,Staff,0,0,0,0
1683300550826,AWP 10,007,202040,Staff,0,0,0,0
1683300550826,AWP 10,008,202041,Staff,0,0,0,0
1683300550826,AWP 10,009,202042,Staff,0,0,0,0
1683300550826,AWP 10,010,202043,Staff,0,0,0,0
1683300550826,AWP 10,011,202044,Staff,0,0,0,0
1683300550826,AWP 10,012,202045,Staff,0,0,0,0
1683300550826,AWP 10,013,202046,Staff,0,0,0,0
1683300550826,AWP 10,014,202047,Staff,0,0,0,0
1683300550826,AWP 10,015,202048,Staff,0,0,0,0
1683300550826,AWP 10,016,202049,Staff,0,0,0,0
1683300550826,AWP 10,017,202050,Staff,0,0,0,0
1683300550826,AWP 10,018,202051,Staff,0,0,0,0
1683300550826,AWP 10,019,202052,Staff,0,0,0,0
1683300550826,AWP 10,020,202053,Staff,0,0,0,0
1683300550826,AWP 10,021,202054,Staff,0,0,0,0
1683300550826,AWP 10,022,202055,Staff,0,0,0,0
1683300550826,AWP 10,023,202056,Staff,0,0,0,0
1683300550826,AWP 10,024,202057,Staff,0,0,0,0
1683300550826,AWP 10,025,202058,Staff,0,0,0,0
1683300550826,AWP 10,026,202059,Staff,0,0,0,0
1683300551850,AWP 102,001,202032,Staff,0,0,0,0
1683300551850,AWP 102,002,202033,Staff,0,0,0,0
1683300552878,BENG 100,A01,254234,Taylor Amos; Alyssa C,31,0,40,9
1683300553902,BENG 196,001,270013,Engler; Adam J.,9999,0,9999,0
1683300554932,BICD 100R,A01,202018,Smith; Laurie,0,7,32,32
1683300554932,BICD 100R,A02,202019,Smith; Laurie,0,2,32,32
1683300554932,BICD 100R,A03,202020,Smith; Laurie,0,1,32,32
1683300554932,BICD 100R,A04,202021,Smith; Laurie,8,0,32,24
1683300554932,BICD 100R,A05,202022,Smith; Laurie,12,0,32,20
1683300555957,BICD 136,A01,193242,Gustafson-Brown; Cindy,0,2,32,32
1683300555957,BICD 136,A02,193244,Gustafson-Brown; Cindy,15,0,32,17
1683300556987,BIEB 102,A01,193249,Butler; Shannon Rhey,0,2,32,32
1683300556987,BIEB 102,A02,193251,Butler; Shannon Rhey,0,0,32,32
1683300556987,BIEB 102,A03,193253,Butler; Shannon Rhey,0,1,32,32
1683300556987,BIEB 102,A04,193255,Butler; Shannon Rhey,17,0,32,15
1683300556987,BIEB 102,A05,193265,Butler; Shannon Rhey,26,0,32,6
1683300556987,BIEB 102,A06,193269,Butler; Shannon Rhey,16,0,32,16
1683300559040,BIEB 150,A01,193274,Staff,0,0,32,32
1683300559040,BIEB 150,A02,193285,Staff,24,0,32,8
1683300560069,BIEB 194,A00,193286,Kurle; Carolyn M.,22,0,32,10
1683300561098,BILD 1,A01,192291,Staff,16,0,32,16
1683300561098,BILD 1,A02,192292,Staff,30,0,32,2
1683300561098,BILD 1,B01,192520,Reuther; Keefe,0,1,0,0
1683300561098,BILD 1,B02,192532,Reuther; Keefe,0,1,0,0
1683300562123,BILD 3,A01,192556,Butler; Shannon Rhey,0,0,32,32
1683300562123,BILD 3,A02,192581,Butler; Shannon Rhey,5,0,32,27
1683300562123,BILD 3,A03,192611,Butler; Shannon Rhey,23,0,32,9
1683300562123,BILD 3,A04,192612,Butler; Shannon Rhey,25,0,32,7
1683300562123,BILD 3,A05,192613,Butler; Shannon Rhey,27,0,32,5
1683300562123,BILD 3,A06,192679,Butler; Shannon Rhey,27,0,32,5
1683300562123,BILD 3,A07,192682,Butler; Shannon Rhey,22,0,32,10
1683300563149,BILD 4,A01,192836,Reuther; Keefe,1,0,24,23
1683300563149,BILD 4,A02,193044,Reuther; Keefe,4,0,24,20
1683300564173,BILD 10,A01,193142,Gustafson-Brown; Cindy,31,0,32,1
1683300564173,BILD 10,A02,193149,Gustafson-Brown; Cindy,31,0,32,1
1683300565197,BIMM 100,A01,193301,Staff,0,6,32,32
1683300565197,BIMM 100,A02,193312,Staff,0,5,32,32
1683300565197,BIMM 100,A03,193323,Staff,0,8,32,32
1683300566221,BIMM 101,A01,193329,McDonnell; Lisa Marie,0,3,24,24
1683300566221,BIMM 101,A02,193339,McDonnell; Lisa Marie,0,2,24,24
1683300566221,BIMM 101,B01,193354,McDonnell; Lisa Marie,0,3,24,24
1683300566221,BIMM 101,B02,193357,McDonnell; Lisa Marie,0,3,24,24
1683300567249,BIMM 110,A01,193377,Tat; John,0,11,32,32
1683300567249,BIMM 110,A02,193378,Tat; John,1,9,32,31
1683300568276,BIMM 120,A01,206116,Staff,0,0,32,32
1683300568276,BIMM 120,A02,206117,Staff,8,0,32,24
1683300568276,BIMM 120,A03,206121,Staff,21,0,32,11
1683300569305,BIPN 100,A01,193393,Park; Ji Young,0,14,32,32
1683300569305,BIPN 100,A02,193402,Park; Ji Young,0,12,32,32
1683300569305,BIPN 100,A03,193413,Park; Ji Young,0,14,32,32
1683300569305,BIPN 100,A04,193414,Park; Ji Young,0,13,32,32
1683300570333,BIPN 102,A01,193429,Staff,0,0,32,32
1683300570333,BIPN 102,A02,193438,Staff,23,0,32,9
1683300571362,BIPN 106,A01,193450,Reyes Gonzalez; Catalina,0,2,40,40
1683300572389,BIPN 134,A01,193465,Cooke; James Edward,0,0,32,32
1683300572389,BIPN 134,A02,193474,Cooke; James Edward,27,0,32,5
1683300572389,BIPN 134,A03,193485,Cooke; James Edward,29,0,32,3
1683300572389,BIPN 134,A04,193486,Cooke; James Edward,21,0,32,11
1683300572389,BIPN 134,A05,193491,Cooke; James Edward,31,0,32,1
1683300572389,BIPN 134,A06,193501,Cooke; James Edward,30,0,32,2
1683300572389,BIPN 134,A07,193510,Cooke; James Edward,29,0,32,3
1683300574442,BISP 194,A00,222522,Staff,16,0,32,16
1683300575465,CAT 124,A01,202407,Staff,20,0,25,5
1683300576490,CAT 125,A00,202408,Marchisotto; Jennifer Anne,4,0,20,16
1683300577519,CAT 125R,A00,202409,Smith; Lauryn Alissa,0,11,20,20
1683300577519,CAT 125R,B00,202410,Morales; Celeste Georgianna,0,11,20,20
1683300577519,CAT 125R,C00,202411,Irwin; Matthew Joseph,0,10,20,20
1683300578547,CENG 15,A01,204712,Yang; Kesong,0,1,0,0
1683300579571,CENG 114,A00,202070,Jahed Motlagh; Zeinab,5,0,20,15
1683300580595,CGS 105,A00,185477,Wesling; Megan E.,24,0,40,16
1683300581619,CGS 106,A00,185494,Staff,13,0,22,9
1683300582646,CGS 108,A00,185495,Staff,14,0,20,6
1683300583671,CGS 114,A00,185496,Staff,13,0,18,5
1683300584695,CGS 119,A00,185501,Staff,15,0,20,5
1683300585720,CGS 120,A00,185511,Staff,13,0,20,7
1683300586745,CHEM 4,A01,184675,Bussey; Thomas J,96,0,100,4
1683300587770,CHEM 6A,A01,184677,Staff,35,0,60,25
1683300588795,CHEM 6B,A01,184679,Staff,65,0,100,35
1683300589822,CHEM 6C,A01,184681,Bussey; Thomas J,1,0,50,49
1683300589822,CHEM 6C,A02,184682,Bussey; Thomas J,34,0,50,16
1683300590852,CHEM 40A,A01,184684,Albizati; Kim F.,37,0,100,63
1683300591880,CHEM 40B,A01,184686,Albizati; Kim F.,0,20,100,100
1683300592904,CHEM 41B,A01,184690,Staff,52,0,100,48
1683300593931,COGS 3,A01,184715,Boyle; Mary E. T.,0,25,40,40
1683300594956,COGS 14B,A01,185172,Staff,0,15,38,38
1683300595982,COGS 18,A01,184736,Staff,20,0,80,60
1683300597064,COGS 100,A01,184932,Staff,0,5,73,73
1683300598087,COGS 101A,A01,184935,Staff,0,38,30,30
1683300599115,COGS 101B,A01,184944,Staff,0,2,30,30
1683300600141,COGS 101C,A01,184946,Staff,0,12,30,30
1683300601168,COGS 102A,A01,184951,Johnson; Christine M.,2,0,40,38
1683300602193,COGS 107B,A01,184953,Mooshagian; Eric Frederick,0,50,40,40
1683300603215,COGS 118B,A01,184959,Gupta; Anjum,0,48,40,40
1683300604242,COGS 153,A00,184961,Staff,0,15,30,30
1683300605267,COGS 177,A00,184962,Staff,0,21,30,30
1683300606295,COGS 187A,A01,184969,Boyle; Mary E. T.,0,17,40,40
1683300607317,COMM 10,A01,185174,Staff,0,5,25,25
1683300607317,COMM 10,A02,185189,Staff,0,5,25,25
1683300607317,COMM 10,A03,269821,Staff,0,0,0,0
1683300608341,COMM 100B,A01,185475,Staff,0,0,0,2
1683300608341,COMM 100B,A02,185476,Staff,14,0,25,11
1683300609365,COMM 100C,A01,185314,Staff,1,0,25,24
1683300609365,COMM 100C,A02,185327,Staff,19,0,25,6
1683300610391,COMM 110M,A00,185349,Staff,2,0,40,38
1683300611418,COMM 113T,A00,185352,Staff,25,0,40,15
1683300612442,COMM 114I,A00,185353,Staff,33,0,40,7
1683300613466,COMM 131,A00,185354,Staff,19,0,30,11
1683300614492,CSE 8A,A50,185358,Cao; Yingjun,0,46,10,10
1683300615520,CSE 8B,A01,185362,Staff,1,47,50,49
1683300616544,CSE 11,A01,185416,Cao; Yingjun,0,93,10,10
1683300617572,CSE 20,A01,185445,Briones; Jor-el Thomas Caparas,5,0,25,20
1683300618598,CSE 21,A01,185447,Staff,10,0,50,40
1683300619625,CSE 101,A01,185451,Staff,0,12,50,50
1683300619625,CSE 101,B01,185453,Jones; Miles E,0,11,50,50
1683300621674,CSE 141,A01,185458,Eldon; John,20,0,100,80
1683300622698,CSE 141L,A01,185461,Eldon; John,12,0,100,88
1683300623729,CSE 142,A01,185463,Staff,35,0,60,25
1683300623729,CSE 142,B01,201355,Staff,0,6,60,60
1683300624754,CSE 142L,A01,185470,Staff,35,0,60,25
1683300624754,CSE 142L,B01,201417,Staff,0,5,60,60
1683300625780,CSE 190,A00,201433,Staff,32,0,49,17
1683300626807,DOC 1,A01,259136,Strom; Megan C.,8,0,15,7
1683300626807,DOC 1,A02,259137,Strom; Megan C.,14,0,15,1
1683300626807,DOC 1,A03,259138,Strom; Megan C.,14,0,15,1
1683300626807,DOC 1,A04,259139,Strom; Megan C.,14,0,15,1
1683300627832,DOC 100D,A00,259140,Pass; Natalye Joann,17,0,25,8
1683300628857,DSGN 1,A01,184749,Rill; Bryan,0,24,30,30
1683300629879,DSGN 100,A01,185168,Staff,0,2,25,25
1683300630903,ECE 5,A01,185626,Morris; Karcher William,0,10,0,0
1683300631927,ECE 101,A01,185628,Staff,17,0,70,53
1683300632953,ECE 107,A01,185635,Baghdadchi; Saharnaz,0,0,20,20
1683300632953,ECE 107,A02,185638,Baghdadchi; Saharnaz,4,0,20,16
1683300633977,ECE 148,A01,185647,Silberman; Jack,1,0,16,15
1683300635010,ECON 1,A01,185537,Crane; Meredith Helen,54,0,70,16
1683300636034,ECON 3,A01,185549,Crane; Meredith Helen,33,0,70,37
1683300637062,ECON 4,A01,203354,Anderson; John Charles,0,4,10,10
1683300638085,ECON 100A,A01,185574,Staff,0,4,40,40
1683300639110,ECON 100B,A01,185576,Staff,0,22,40,40
1683300640138,ECON 100C,A01,185589,Newhouse; Herbert S,30,0,70,40
1683300641161,ECON 105,A00,185608,Vespa; Emanuel Ignacio,19,0,35,16
1683300642186,ECON 109,A01,185610,Shishkin; Denis,10,0,35,25
1683300643212,ECON 110A,A01,185612,Staff,11,0,40,29
1683300644239,ECON 120A,A01,185615,Staff,20,0,40,20
1683300645263,ECON 120C,A01,185617,Sun; Yixiao,0,20,70,70
1683300646288,ECON 144,A00,203346,Squires; Dale E,3,0,35,32
1683300647313,ECON 171,A01,203349,Newhouse; Herbert S,0,1,35,35
1683300648341,ECON 173A,A01,185621,Toda; Alexis Akira,21,0,35,14
1683300649365,EDS 25,A01,202413,Staff,0,1,0,0
1683300649365,EDS 25,A02,202414,Staff,0,1,0,0
1683300649365,EDS 25,A03,202415,Staff,0,0,0,0
1683300649365,EDS 25,A04,202416,Staff,0,1,0,0
1683300649365,EDS 25,A05,202439,Staff,0,0,0,0
1683300649365,EDS 25,A06,202440,Staff,0,0,0,0
1683300649365,EDS 25,B01,202631,Staff,0,0,0,0
1683300649365,EDS 25,B02,202632,Staff,0,0,0,0
1683300649365,EDS 25,B03,202639,Staff,0,0,0,0
1683300649365,EDS 25,B04,202640,Staff,0,0,0,0
1683300649365,EDS 25,B05,202643,Staff,0,0,0,0
1683300649365,EDS 25,B06,202644,Staff,0,0,0,0
1683300650390,EDS 38,A01,202659,Black; Alison Michelle,24,0,25,1
1683300651413,EDS 115,A00,202652,Staff,17,0,30,13
1683300652438,EDS 125,A00,202649,Staff,14,0,30,16
1683300653462,EDS 126,A01,203332,Staff,30,0,30,0
1683300654486,EDS 139,A00,202838,Staff,17,0,25,8
1683300655510,EDS 146,A01,202655,Staff,15,0,25,10
1683300656534,ENG 15,A00,185667,Staff,0,1,0,0
1683300656534,ENG 15,B00,185672,Staff,0,0,0,0
1683300656534,ENG 15,C00,185675,Staff,0,0,0,0
1683300656534,ENG 15,D00,185682,Staff,0,0,0,0
1683300656534,ENG 15,E00,185684,Staff,0,0,0,0
1683300657561,ETHN 103,A00,185710,Staff,0,3,35,35
1683300658589,ETHN 103A,A00,199228,Man; Simeon S,3,0,9,6
1683300659614,ETHN 109,A00,185711,Staff,18,0,35,17
1683300660638,ETHN 142,A00,185726,Staff,0,4,30,30
1683300661668,ETHN 163J,A00,199229,Man; Simeon S,6,0,8,2
1683300662697,ETHN 168,A00,185727,Staff,8,0,10,2
1683300663724,ETHN 182,A00,185728,Staff,1,0,35,34
1683300664752,ETHN 183,A00,185737,Staff,8,0,18,10
1683300665776,GLBH 111,A01,209361,Burgos; Jose L.,0,0,0,0
1683300667826,HIEU 104,A00,185792,Staff,16,0,20,4
1683300668852,HIEU 115,A00,185800,Staff,1,0,20,19
1683300669879,HIEU 128,A00,185801,Staff,0,7,20,20
1683300670910,HIEU 147,A00,185802,Staff,16,0,20,4
1683300671937,HIEU 154,A00,185823,Staff,12,0,20,8
1683300672964,HILA 102,A00,185826,Staff,13,0,20,7
1683300673991,HILD 2C,A01,185778,Staff,0,12,20,20
1683300675018,HILD 7B,A01,185780,Kwak; Nancy,0,15,32,32
1683300675018,HILD 7B,A02,185781,Kwak; Nancy,0,18,32,32
1683300676044,HILD 30,A01,185791,Staff,14,0,20,6
1683300677071,HISC 119,A00,185830,Golan; Tal,0,9,20,20
1683300678097,HITO 156GS,A00,185831,Patterson; Patrick H.,0,0,0,23
1683300679120,HIUS 103,A00,185832,Man; Simeon S,0,7,20,20
1683300680144,HIUS 117,A00,185836,Kwak; Nancy,2,0,20,18
1683300681170,HIUS 125,A00,185840,Man; Simeon S,0,0,23,23
1683300682196,HIUS 149,A00,185845,Staff,0,0,20,20
1683300683221,HUM 3,A01,185882,Zavodny; Tatiana Sophia,0,6,50,50
1683300683221,HUM 3,B01,185899,Caldwell; Michael Alan,0,19,50,50
1683300684248,HUM 3GS,A00,185900,Patterson; Patrick H.,0,0,0,23
1683300685273,HUM 4,A01,185938,Zroka; Amy Liane,31,0,50,19
1683300685273,HUM 4,B01,185956,Watkins; Eric,0,2,50,50
1683300685273,HUM 4,B02,202209,Watkins; Eric,0,1,50,50
1683300685273,HUM 4,B03,202210,Watkins; Eric,0,0,50,50
1683300686298,HUM 5,A01,185958,West; Geoffrey Scott,5,0,50,45
1683300686298,HUM 5,A02,202215,West; Geoffrey Scott,0,0,50,50
1683300687326,INTL 190,A00,185959,Gagnon; Jeffrey C,0,0,0,9
1683300687326,INTL 190,B00,185960,Lettieri; Michael Joseph,0,0,0,1
1683300688352,JAPN 180,A00,254509,Staff,0,1,25,25
1683300689376,LATI 10,A01,202853,Kennemore; Amy Michelle,5,0,35,30
1683300689376,LATI 10,A02,202854,Kennemore; Amy Michelle,1,0,35,34
1683300689376,LATI 10,A03,270054,Kennemore; Amy Michelle,30,0,30,0
1683300690400,LATI 180,A00,202855,Kennemore; Amy Michelle,11,0,20,9
1683300691423,LAWS 101,A00,201767,Golan; Tal,0,7,40,40
1683300692449,LIFR 1C,A00,185961,Staff,6,0,20,14
1683300693477,LIFR 1CX,A00,185962,Staff,7,0,20,13
1683300694501,LIFR 1D,A00,185963,Staff,9,0,20,11
1683300695529,LIFR 1DX,A00,185964,Staff,9,0,20,11
1683300696553,LIGN 101,A01,186039,Staff,43,0,50,7
1683300697578,LIGN 165,A00,186040,Staff,18,0,50,32
1683300698602,LTCS 108,A00,186041,Staff,6,0,10,4
1683300699626,LTCS 119,A00,186042,Staff,16,0,20,4
1683300700725,LTCS 130,A00,186043,Wesling; Megan E.,15,0,25,10
1683300702778,LTEA 138,A00,186119,Staff,14,0,40,26
1683300703803,LTEN 124,A00,186148,Staff,6,0,25,19
1683300704828,LTEN 178,A00,186149,Staff,7,0,15,8
1683300705852,LTEN 181,A00,186150,Blanco; John D,33,0,40,7
1683300706880,LTWL 120,A00,186160,Staff,20,0,25,5
1683300707907,LTWL 165,A00,186161,Staff,22,0,25,3
1683300708934,LTWR 100,A00,186162,Staff,0,4,15,15
1683300709959,LTWR 102,A00,186163,Doller; Ben,5,0,15,10
1683300710981,MAE 8,A01,186412,Staff,0,0,0,0
1683300712005,MAE 30B,A00,186445,Bahadori; Mohammad Yousef,83,0,100,17
1683300713030,MAE 40,A00,186592,Bewley; Thomas R,9,0,50,41
1683300714058,MAE 101B,A00,186593,Bahadori; Mohammad Yousef,81,0,100,19
1683300715084,MAE 105,A00,186594,Bandaru; Prabhakar,12,0,50,38
1683300716108,MAE 107,A00,186599,Pham; Hieu Tan,0,6,120,120
1683300717133,MAE 148,A01,186660,Silberman; Jack,3,0,16,13
1683300718158,MATH 10A,A01,188095,Staff,0,7,35,35
1683300719186,MATH 10B,A01,188097,Bowers; Adam R.,0,11,30,30
1683300719186,MATH 10B,A02,188099,Bowers; Adam R.,0,9,30,30
1683300719186,MATH 10B,B01,188104,Bowers; Adam R.,0,11,30,30
1683300719186,MATH 10B,B02,188106,Bowers; Adam R.,0,11,30,30
1683300720216,MATH 10C,A01,188111,Staff,0,18,30,30
1683300720216,MATH 10C,A02,188127,Staff,0,17,30,30
1683300720216,MATH 10C,A03,188131,Staff,0,17,30,30
1683300720216,MATH 10C,B01,188218,Staff,21,0,30,9
1683300720216,MATH 10C,B02,188244,Staff,13,0,30,17
1683300720216,MATH 10C,B03,188277,Staff,16,0,30,14
1683300721244,MATH 18,A01,188344,Bach; Quang Tran,18,0,30,12
1683300721244,MATH 18,A02,188345,Bach; Quang Tran,11,0,30,19
1683300721244,MATH 18,B01,188353,Bach; Quang Tran,10,0,30,20
1683300721244,MATH 18,B02,188354,Bach; Quang Tran,20,0,30,10
1683300722268,MATH 20A,A01,188374,Staff,13,0,35,22
1683300723296,MATH 20B,A01,188382,Ohm; Ko Woon,6,0,30,24
1683300723296,MATH 20B,A02,188383,Ohm; Ko Woon,24,0,30,6
1683300723296,MATH 20B,B01,188385,Ohm; Ko Woon,7,0,30,23
1683300723296,MATH 20B,B02,188392,Ohm; Ko Woon,22,0,30,8
1683300724321,MATH 20C,A01,188394,Harel; Guershon,10,0,30,20
1683300724321,MATH 20C,A02,188395,Harel; Guershon,13,0,30,17
1683300724321,MATH 20C,B01,188404,Harel; Guershon,3,0,30,27
1683300724321,MATH 20C,B02,188405,Harel; Guershon,19,0,30,11
1683300725354,MATH 20D,A01,188414,Hammock; Frances H,0,1,30,30
1683300725354,MATH 20D,A02,188415,Hammock; Frances H,4,0,30,26
1683300725354,MATH 20D,B01,188447,Hammock; Frances H,2,0,30,28
1683300725354,MATH 20D,B02,188486,Hammock; Frances H,8,0,30,22
1683300726382,MATH 20E,A01,188649,Staff,22,0,30,8
1683300726382,MATH 20E,A02,188650,Staff,23,0,30,7
1683300726382,MATH 20E,A03,188673,Staff,0,0,30,30
1683300727406,MATH 102,A01,188675,Staff,0,35,35,35
1683300728431,MATH 103B,A01,188681,Staff,4,0,35,31
1683300728431,MATH 103B,B01,188692,Staff,7,0,35,28
1683300729459,MATH 109,A01,188695,Salehi Golsefidy; Alireza,25,0,35,10
1683300729459,MATH 109,A02,188696,Salehi Golsefidy; Alireza,27,0,35,8
1683300730487,MATH 120A,A01,188698,Eggers; John Dietrich,5,0,35,30
1683300731515,MATH 142B,A01,188736,Ioana; Adrian,0,2,30,30
1683300731515,MATH 142B,A02,188741,Ioana; Adrian,0,1,30,30
1683300731515,MATH 142B,A03,188743,Ioana; Adrian,0,3,30,30
1683300732543,MATH 168A,A01,188790,Staff,0,8,35,35
1683300733568,MATH 170A,A01,188803,Nie; Jiawang,0,2,35,35
1683300733568,MATH 170A,A02,188811,Nie; Jiawang,0,0,35,35
1683300733568,MATH 170A,A03,188814,Nie; Jiawang,1,0,35,34
1683300733568,MATH 170A,A04,188815,Nie; Jiawang,14,0,35,21
1683300734595,MATH 193B,A01,188817,Staff,0,0,35,35
1683300734595,MATH 193B,A02,188818,Staff,5,0,35,30
1683300735623,MGT 4,A01,202857,Anderson; John Charles,62,0,80,18
1683300736649,MGT 12,A00,202858,Lindenberger; Wade Douglas,43,0,90,47
1683300737674,MGT 18,A00,202859,Staff,74,0,90,16
1683300738699,MGT 18GS,A00,202860,McKay; Michael J,13,0,28,15
1683300739723,MGT 45,A00,202861,Pecore; Joseph P.,14,0,90,76
1683300740750,MGT 100,A00,202863,Yavorsky; Daniel Ryan,28,0,90,62
1683300741775,MGT 103,A00,202864,Ehrich; Kristine R,0,16,90,90
1683300742799,MGT 112,A00,202865,Ehrich; Kristine R,15,0,90,75
1683300743826,MGT 121A,A00,202868,Staff,0,19,0,0
1683300744853,MGT 131B,A00,202869,Anderson; John Charles,59,0,90,31
1683300745881,MGT 136,A00,202871,Lindenberger; Wade Douglas,84,0,90,6
1683300746908,MGT 164,A00,202873,Staff,0,69,90,90
1683300747933,MGT 164GS,A00,202874,McKay; Mary A,13,0,28,15
1683300748960,MGT 180,A00,202875,Staff,0,51,90,90
1683300749984,MMW 11R,A01,205019,Herbst; Matthew,3,0,30,27
1683300749984,MMW 11R,A02,205026,Herbst; Matthew,29,0,30,1
1683300751011,MMW 15,A01,193512,Chang; Edmond Yi-Teh,0,9,28,28
1683300751011,MMW 15,A02,193513,Chang; Edmond Yi-Teh,0,5,28,28
1683300751011,MMW 15,A03,193514,Chang; Edmond Yi-Teh,0,5,28,28
1683300751011,MMW 15,A04,193515,Chang; Edmond Yi-Teh,0,4,28,28
1683300751011,MMW 15,A05,193516,Chang; Edmond Yi-Teh,0,4,28,28
1683300751011,MMW 15,A06,193517,Chang; Edmond Yi-Teh,0,5,28,28
1683300751011,MMW 15,B01,193519,Chang; Edmond Yi-Teh,0,4,28,28
1683300751011,MMW 15,B02,193520,Chang; Edmond Yi-Teh,0,5,28,28
1683300751011,MMW 15,B03,193521,Chang; Edmond Yi-Teh,0,4,28,28
1683300751011,MMW 15,B04,193522,Chang; Edmond Yi-Teh,0,4,28,28
1683300751011,MMW 15,B05,193523,Chang; Edmond Yi-Teh,0,5,28,28
1683300751011,MMW 15,B06,193524,Chang; Edmond Yi-Teh,0,4,28,28
1683300752039,MMW 122,A01,193526,Rahimi; Babak,0,14,28,28
1683300752039,MMW 122,A02,193527,Rahimi; Babak,0,14,28,28
1683300752039,MMW 122,A03,193528,Rahimi; Babak,0,0,0,0
1683300752039,MMW 122,A04,193529,Rahimi; Babak,0,0,0,0
1683300753064,MUS 1A,A01,186663,Staff,0,20,35,35
1683300754087,MUS 4,A01,186715,Staff,0,12,35,35
1683300755115,MUS 5R,A01,186796,Dubnov; Shlomo,0,16,35,35
1683300756142,MUS 6,A01,186798,Staff,0,3,25,25
1683300757167,MUS 7,A01,186830,Staff,12,0,35,23
1683300758195,MUS 8,A01,186930,Staff,0,25,35,35
1683300759224,MUS 15,A01,186932,Staff,0,15,35,35
1683300759224,MUS 15,B01,186934,Staff,0,14,35,35
1683300760250,MUS 80,A00,186935,Staff,2,0,20,18
1683300760250,MUS 80,B00,186936,Staff,25,0,25,0
1683300761275,NANO 11,A00,204702,Lipomi; Darren John,0,0,0,0
1683300762304,NANO 15,A01,204709,Yang; Kesong,0,1,0,0
1683300763328,NANO 114,A00,202069,Jahed Motlagh; Zeinab,3,0,10,7
1683300764352,PHIL 1,A00,186955,Grush; Rick Scott,32,0,40,8
1683300765380,PHIL 10,A01,186973,Grush; Rick Scott,29,0,35,6
1683300765380,PHIL 10,A02,186974,Grush; Rick Scott,33,0,35,2
1683300766404,PHIL 13,A01,186976,Staff,7,0,35,28
1683300766404,PHIL 13,A02,186977,Staff,16,0,35,19
1683300767429,PHIL 14,A01,186979,Staff,31,0,35,4
1683300767429,PHIL 14,A02,186986,Staff,32,0,35,3
1683300768453,PHIL 28,A01,186988,Staff,16,0,30,14
1683300768453,PHIL 28,A02,186989,Staff,1,0,30,29
1683300768453,PHIL 28,A03,186990,Staff,9,0,30,21
1683300768453,PHIL 28,A04,186991,Staff,26,0,30,4
1683300769479,PHIL 120,A00,186997,Staff,23,0,40,17
1683300770506,PHIL 137,A00,187003,Staff,9,0,40,31
1683300771530,PHIL 150,A00,187015,Staff,47,0,70,23
1683300772557,PHIL 167,A00,187021,Lamey; Andy M.,35,0,40,5
1683300773584,PHIL 174,A01,202226,Staff,17,0,20,3
1683300773584,PHIL 174,A02,202235,Staff,20,0,20,0
1683300774608,PHIL 191A,A00,258918,Staff,0,0,1,1
1683300775632,PHYS 1A,A00,187028,Staff,26,0,60,34
1683300776658,PHYS 1AL,001,187036,Staff,2,0,30,28
1683300776658,PHYS 1AL,002,187049,Staff,18,0,30,12
1683300777686,PHYS 1B,A00,187058,Staff,23,0,60,37
1683300778715,PHYS 1BL,001,187064,Staff,0,0,30,30
1683300778715,PHYS 1BL,002,187070,Staff,6,0,30,24
1683300779738,PHYS 1C,A00,187082,Staff,32,0,120,88
1683300780766,PHYS 1CL,001,187088,Staff,0,9,30,30
1683300780766,PHYS 1CL,002,187089,Staff,0,2,30,30
1683300780766,PHYS 1CL,009,262693,Staff,12,0,30,18
1683300781791,PHYS 2B,A01,187097,Staff,54,0,115,61
1683300782815,PHYS 2C,A01,187099,Staff,67,0,115,48
1683300783839,PHYS 2CL,A01,187101,Staff,5,0,28,23
1683300783839,PHYS 2CL,A02,187102,Staff,15,0,28,13
1683300784863,PHYS 2D,A01,187123,Shotwell; Brian,95,0,115,20
1683300785893,PHYS 4B,A01,187133,Grinstein; Benjamin,35,0,50,15
1683300786920,POLI 10,A00,188819,Staff,0,3,50,50
1683300787947,POLI 11,A00,188827,Staff,43,0,50,7
1683300788971,POLI 13R,A00,188828,Staff,0,1,20,20
1683300789999,POLI 27,A01,188830,Elgin; Samuel Zincke,0,1,70,70
1683300791027,POLI 30,A00,188832,Desposato; Scott,33,0,50,17
1683300792051,POLI 102F,A00,188834,Staff,3,0,40,37
1683300793079,POLI 104A,A00,188852,Staff,14,0,30,16
1683300794107,POLI 104I,A00,188853,Staff,0,6,20,20
1683300795131,POLI 110B,A00,188854,Wiens; David,7,0,20,13
1683300796153,POLI 112A,A00,188855,Wiens; David,5,0,30,25
1683300797178,POLI 117R,A00,188856,Forman; Fonna,0,11,20,20
1683300798205,POLI 118,A00,188857,Ingham; Sean,8,0,20,12
1683300799231,POLI 120G,A00,188858,Staff,9,0,30,21
1683300800256,POLI 131CR,A00,188863,Hoston; Germaine,24,0,50,26
1683300801280,POLI 133,A00,188864,Nellis; Gareth Hb,44,0,50,6
1683300802304,POLI 134D,A00,188865,Desposato; Scott,27,0,30,3
1683300803329,POLI 142A,A00,188871,Gartzke; Erik,22,0,50,28
1683300804412,POLI 142K,A00,188874,Staff,38,0,50,12
1683300805435,POLI 143,A00,188940,Gartzke; Erik,16,0,30,14
1683300806463,POLI 153,A00,188943,Staff,3,0,20,17
1683300807490,POLI 160AA,A00,188944,Staff,13,0,40,27
1683300808516,POLI 170A,A00,188945,Staff,11,0,30,19
1683300810571,PSYC 1,A00,188952,Staff,38,0,90,52
1683300811598,PSYC 2,B00,188953,Staff,20,0,35,15
1683300812622,PSYC 6,A00,188970,Staff,47,0,60,13
1683300813650,PSYC 7,A00,188973,Staff,37,0,45,8
1683300814675,PSYC 60,A01,188980,Rickard; Timothy C.,43,0,60,17
1683300815700,PSYC 70,A01,189001,Steiner; Eric Tomas,24,0,45,21
1683300816728,PSYC 100,A00,189005,Lacefield; Katharine I,0,99,120,120
1683300817752,PSYC 102,A00,189008,Staff,10,0,30,20
1683300818776,PSYC 106,B00,189026,Gorman; Michael R.,37,0,60,23
1683300819802,PSYC 114,B01,189033,Winkielman; Piotr,0,32,30,30
1683300820829,PSYC 131,A00,189036,Anagnostaras; Stephan,0,43,60,60
1683300821853,PSYC 136,A00,189041,Lowe; Angela Beth,0,7,25,25
1683300822876,PSYC 137,A00,189057,Winkielman; Piotr,0,34,25,25
1683300823900,PSYC 144,A00,189107,Wixted; John T,0,7,50,50
1683300825950,PSYC 162,A00,189142,Staff,0,8,85,85
1683300826977,PSYC 172,A00,189144,Gorman; Michael R.,0,7,30,30
1683300829029,PSYC 179,A00,189146,Lacefield; Katharine I,0,84,120,120
1683300830056,PSYC 181,A00,189147,Anagnostaras; Stephan,0,44,90,90
1683300831086,PSYC 190R,A00,189148,Barner; David A.,0,22,80,80
1683300832111,PSYC 191,A00,189275,Rickard; Timothy C.,0,7,25,25
1683300833135,PSYC 193,A00,189276,Chapman; Eddie Nathaniel,0,1,0,4
1683300834160,PSYC 193L,A01,189281,Lowe; Angela Beth,12,0,20,8
1683300834160,PSYC 193L,B01,189285,Staff,28,0,35,7
1683300835183,RELI 149,A00,187137,Rahimi; Babak,7,0,40,33
1683300836208,SE 9,A01,187315,Staff,0,2,18,18
1683300837235,SE 101B,A00,187409,Staff,24,0,30,6
1683300838258,SE 110B,A00,187444,Staff,10,0,40,30
1683300839282,SE 130B,A00,187449,Staff,31,0,40,9
1683300840305,SE 150A,A00,187516,Staff,9,0,20,11
1683300841330,SE 154,A00,187528,Staff,30,0,50,20
1683300842357,SIO 3,A01,258171,Staff,35,0,40,5
1683300843387,SIO 10,A00,187144,Cook; Geoffrey W,0,3,75,75
1683300844411,SIO 45,A00,187152,Cook; Geoffrey W,1,0,100,99
1683300845434,SIO 109R,A00,194486,Staff,0,3,20,20
1683300847490,SIO 187,A01,187233,Kacev; David,12,0,40,28
1683300848520,SOCI 1,A01,258656,Thorpe; Charles Robert,28,0,30,2
1683300848520,SOCI 1,A02,258658,Thorpe; Charles Robert,30,0,30,0
1683300848520,SOCI 1,A03,258661,Thorpe; Charles Robert,25,0,25,0
1683300848520,SOCI 1,A04,258666,Thorpe; Charles Robert,22,0,25,3
1683300848520,SOCI 1,A05,258897,Thorpe; Charles Robert,23,0,25,2
1683300848520,SOCI 1,A06,258898,Thorpe; Charles Robert,25,0,25,0
1683300849548,SOCI 30,A01,258903,Pardo Guerra; Juan Pablo,16,0,30,14
1683300850576,SOCI 102,A00,258904,Staff,9,0,25,16
1683300851604,SOCI 106,A00,258905,Staff,19,0,25,6
1683300852628,SOCI 111,A00,258907,Ribas Norris; Janet Vanesa,26,0,30,4
1683300853656,SOCI 121R,A00,258908,Pardo Guerra; Juan Pablo,11,0,30,19
1683300854680,SOCI 126,A01,203330,Staff,14,0,20,6
1683300855708,SOCI 131,A00,258909,Thorpe; Charles Robert,31,0,60,29
1683300856735,SOCI 135,A00,258910,Payne; Christine Anna,0,9,30,30
1683300857761,SOCI 157,A00,258911,Staff,13,0,30,17
1683300858787,SOCI 184,A00,258912,Staff,26,0,30,4
1683300859811,SOCI 188D,A00,258913,Staff,21,0,30,9
1683300860835,SYN 2,001,187529,Staff,9,0,16,7
1683300860835,SYN 2,002,201452,Staff,0,18,16,16
1683300860835,SYN 2,003,201469,Staff,3,0,16,13
1683300861859,SYN 100,A01,187531,Staff,0,9,20,20
1683300861859,SYN 100,B01,201491,Staff,0,12,20,20
1683300862883,TDAC 1,A00,189286,Walsh; Kim C.,3,0,20,17
1683300862883,TDAC 1,B00,189287,Harting; Carla Kelso,11,0,20,9
1683300863907,TDAC 101,A00,189300,Walsh; Kim C.,16,0,20,4
1683300863907,TDAC 101,B00,189301,Harting; Carla Kelso,18,0,20,2
1683300864934,TDAC 102,A00,189304,Basso; Beatrice,14,0,20,6
1683300865957,TDAC 108,A00,189305,Staff,18,0,20,2
1683300866982,TDDE 131,A00,189310,Staff,19,0,20,1
1683300866982,TDDE 131,B00,189314,Staff,19,0,20,1
1683300866982,TDDE 131,C00,189315,Staff,48,0,50,2
1683300866982,TDDE 131,D00,189316,Staff,14,0,15,1
1683300866982,TDDE 131,E00,204841,Staff,20,0,20,0
1683300868006,TDGE 10,A00,189289,Staff,30,0,50,20
1683300868006,TDGE 10,B00,189290,Havis; Allan,2,0,50,48
1683300869031,TDGE 11,A00,189291,Fulton; Julia,0,3,50,50
1683300869031,TDGE 11,B00,189292,Staff,20,0,25,5
1683300869031,TDGE 11,C00,260270,Staff,0,0,0,0
1683300870057,TDGE 25,A00,189294,Staff,3,0,20,17
1683300871079,TDGE 124,A00,189318,Fulton; Julia,0,8,50,50
1683300872103,TDGE 125,A00,189319,Staff,13,0,25,12
1683300872103,TDGE 125,B00,189320,Staff,23,0,25,2
1683300873128,TDGE 127,A00,189322,Havis; Allan,0,0,50,50
1683300874151,TDHT 101,A00,189323,Staff,18,0,25,7
1683300874151,TDHT 101,B00,189324,Staff,25,0,25,0
1683300875173,TDHT 102,A00,189325,Staff,49,0,50,1
1683300876200,TDMV 1,A00,189295,Arcidiacono; Kristin,20,0,30,10
1683300876200,TDMV 1,B00,189296,Caligagan; Maria T.,24,0,30,6
1683300877228,TDMV 2,A00,189297,Sammartano; Tonnie,28,0,30,2
1683300877228,TDMV 2,B00,189299,Arcidiacono; Kristin,24,0,30,6
1683300878254,TDMV 3,A00,204998,Rincon; Alicia,22,0,30,8
1683300879282,TDMV 120,A00,189458,Sammartano; Tonnie,28,0,30,2
1683300880307,TDMV 138,A00,189541,Jun; Grace Shin Hae,22,0,40,18
1683300881333,TDMV 142,A00,189717,Caligagan; Tony,23,0,30,7
1683300881333,TDMV 142,B00,189718,Caligagan; Maria T.,25,0,30,5
1683300882357,TMC 2,A01,187533,Staff,25,0,25,0
1683300882357,TMC 2,A02,187534,Staff,25,0,25,0
1683300883383,USP 1,A01,187536,Kwak; Nancy,0,16,25,25
1683300884411,USP 5,A01,187538,Staff,9,0,25,16
1683300885434,USP 101,A00,199253,Staff,0,4,0,0
1683300886460,USP 124,A00,187562,Boomhower; Matthew Charles,1,0,30,29
1683300887484,USP 138,A00,187582,Staff,20,0,25,5
1683300888508,USP 152,A01,187597,Staff,4,0,25,21
1683300889532,USP 153,A00,187598,Staff,19,0,25,6
1683300890558,USP 168,A00,187607,Kwak; Nancy,2,0,5,3
1683300891586,USP 173,A00,187619,Staff,4,0,25,21
1683300892608,USP 181,A00,187638,Staff,0,0,25,25
1683300893633,VIS 103,A00,187650,Cruz; Edwin Teddy,23,0,75,52
1683300894661,VIS 110D,A00,187669,Staff,12,0,22,10
1683300895688,VIS 127C,A00,187720,Shen; Kuiyi,68,0,146,78
1683300896713,VIS 149,A00,187731,Yoldas; Pinar,0,14,22,22
1683300897736,VIS 151,A01,188091,Staff,22,0,34,12
1683300897736,VIS 151,A02,188092,Staff,11,0,34,23
1683300898761,VIS 160B,A00,188093,Stalbaum; Brett,0,0,10,10
1683300900808,WCWP 10B,A00,201720,Staff,10,0,15,5
1683300900808,WCWP 10B,B00,201722,Staff,8,0,15,7
1683300901833,WCWP 100,A00,201725,Gagnon; Jeffrey C,0,0,2,2
1683300901833,WCWP 100,B00,201727,Staff,0,4,15,15
1683300904958,ANBI 133,A00,258401,Wilder; Linnea Lorene,34,0,40,6
1683300905985,ANBI 140,A00,258395,Hrvoj Mihic; Branka,18,0,25,7
1683300907011,ANSC 120,A00,258402,Bialecki; Jon Anthony,27,0,40,13
1683300908090,ANSC 144,A00,258400,Staff,14,0,40,26
1683300910141,ANSC 166,A00,258396,Parish; Steven Martin,157,0,175,18
1683300911164,ANSC 180,A00,193533,Staff,9,0,20,11
1683300912188,ANSC 188,A00,258397,Jassal; Aftab,33,0,40,7
1683300913211,ANTH 3,A01,258316,Staff,23,0,30,7
1683300914237,ANTH 5,A00,258394,Semendeferi; Ekaterini,16,0,20,4
1683300915260,ANTH 21,A01,258331,Staff,9,0,40,31
1683300916285,ANTH 103,A00,258398,Varma; Saiba,15,0,25,10
1683300917312,AWP 10,001,202034,Staff,0,0,0,0
1683300917312,AWP 10,002,202035,Staff,0,0,0,0
1683300917312,AWP 10,003,202036,Staff,0,0,0,0
1683300917312,AWP 10,004,202037,Staff,0,0,0,0
1683300917312,AWP 10,005,202038,Staff,0,0,0,0
1683300917312,AWP 10,006,202039,Staff,0,0,0,0
1683300917312,AWP 10,007,202040,Staff,0,0,0,0
1683300917312,AWP 10,008,202041,Staff,0,0,0,0
1683300917312,AWP 10,009,202042,Staff,0,0,0,0
1683300917312,AWP 10,010,202043,Staff,0,0,0,0
1683300917312,AWP 10,011,202044,Staff,0,0,0,0
1683300917312,AWP 10,012,202045,Staff,0,0,0,0
1683300917312,AWP 10,013,202046,Staff,0,0,0,0
1683300917312,AWP 10,014,202047,Staff,0,0,0,0
1683300917312,AWP 10,015,202048,Staff,0,0,0,0
1683300917312,AWP 10,016,202049,Staff,0,0,0,0
1683300917312,AWP 10,017,202050,Staff,0,0,0,0
1683300917312,AWP 10,018,202051,Staff,0,0,0,0
1683300917312,AWP 10,019,202052,Staff,0,0,0,0
1683300917312,AWP 10,020,202053,Staff,0,0,0,0
1683300917312,AWP 10,021,202054,Staff,0,0,0,0
1683300917312,AWP 10,022,202055,Staff,0,0,0,0
1683300917312,AWP 10,023,202056,Staff,0,0,0,0
1683300917312,AWP 10,024,202057,Staff,0,0,0,0
1683300917312,AWP 10,025,202058,Staff,0,0,0,0
1683300917312,AWP 10,026,202059,Staff,0,0,0,0
1683300918339,AWP 102,001,202032,Staff,0,0,0,0
1683300918339,AWP 102,002,202033,Staff,0,0,0,0
1683300919365,BENG 100,A01,254234,Taylor Amos; Alyssa C,31,0,40,9
1683300920394,BENG 196,001,270013,Engler; Adam J.,9999,0,9999,0
1683300921422,BICD 100R,A01,202018,Smith; Laurie,0,7,32,32
1683300921422,BICD 100R,A02,202019,Smith; Laurie,0,2,32,32
1683300921422,BICD 100R,A03,202020,Smith; Laurie,0,1,32,32
1683300921422,BICD 100R,A04,202021,Smith; Laurie,8,0,32,24
1683300921422,BICD 100R,A05,202022,Smith; Laurie,12,0,32,20
1683300922449,BICD 136,A01,193242,Gustafson-Brown; Cindy,0,2,32,32
1683300922449,BICD 136,A02,193244,Gustafson-Brown; Cindy,15,0,32,17
1683300923474,BIEB 102,A01,193249,Butler; Shannon Rhey,0,2,32,32
1683300923474,BIEB 102,A02,193251,Butler; Shannon Rhey,0,0,32,32
1683300923474,BIEB 102,A03,193253,Butler; Shannon Rhey,0,1,32,32
1683300923474,BIEB 102,A04,193255,Butler; Shannon Rhey,17,0,32,15
1683300923474,BIEB 102,A05,193265,Butler; Shannon Rhey,26,0,32,6
1683300923474,BIEB 102,A06,193269,Butler; Shannon Rhey,16,0,32,16
1683300925525,BIEB 150,A01,193274,Staff,0,0,32,32
1683300925525,BIEB 150,A02,193285,Staff,24,0,32,8
1683300926550,BIEB 194,A00,193286,Kurle; Carolyn M.,22,0,32,10
1683300927574,BILD 1,A01,192291,Staff,16,0,32,16
1683300927574,BILD 1,A02,192292,Staff,30,0,32,2
1683300927574,BILD 1,B01,192520,Reuther; Keefe,0,1,0,0
1683300927574,BILD 1,B02,192532,Reuther; Keefe,0,1,0,0
1683300928602,BILD 3,A01,192556,Butler; Shannon Rhey,0,0,32,32
1683300928602,BILD 3,A02,192581,Butler; Shannon Rhey,5,0,32,27
1683300928602,BILD 3,A03,192611,Butler; Shannon Rhey,23,0,32,9
1683300928602,BILD 3,A04,192612,Butler; Shannon Rhey,25,0,32,7
1683300928602,BILD 3,A05,192613,Butler; Shannon Rhey,27,0,32,5
1683300928602,BILD 3,A06,192679,Butler; Shannon Rhey,27,0,32,5
1683300928602,BILD 3,A07,192682,Butler; Shannon Rhey,22,0,32,10
1683300929631,BILD 4,A01,192836,Reuther; Keefe,1,0,24,23
1683300929631,BILD 4,A02,193044,Reuther; Keefe,4,0,24,20
1683300930666,BILD 10,A01,193142,Gustafson-Brown; Cindy,31,0,32,1
1683300930666,BILD 10,A02,193149,Gustafson-Brown; Cindy,31,0,32,1
1683300931690,BIMM 100,A01,193301,Staff,0,6,32,32
1683300931690,BIMM 100,A02,193312,Staff,0,5,32,32
1683300931690,BIMM 100,A03,193323,Staff,0,8,32,32
1683300932719,BIMM 101,A01,193329,McDonnell; Lisa Marie,0,3,24,24
1683300932719,BIMM 101,A02,193339,McDonnell; Lisa Marie,0,2,24,24
1683300932719,BIMM 101,B01,193354,McDonnell; Lisa Marie,0,3,24,24
1683300932719,BIMM 101,B02,193357,McDonnell; Lisa Marie,0,3,24,24
1683300933745,BIMM 110,A01,193377,Tat; John,0,11,32,32
1683300933745,BIMM 110,A02,193378,Tat; John,1,9,32,31
1683300934772,BIMM 120,A01,206116,Staff,0,0,32,32
1683300934772,BIMM 120,A02,206117,Staff,8,0,32,24
1683300934772,BIMM 120,A03,206121,Staff,21,0,32,11
1683300935796,BIPN 100,A01,193393,Park; Ji Young,0,14,32,32
1683300935796,BIPN 100,A02,193402,Park; Ji Young,0,12,32,32
1683300935796,BIPN 100,A03,193413,Park; Ji Young,0,14,32,32
1683300935796,BIPN 100,A04,193414,Park; Ji Young,0,13,32,32
1683300936820,BIPN 102,A01,193429,Staff,0,0,32,32
1683300936820,BIPN 102,A02,193438,Staff,23,0,32,9
1683300937844,BIPN 106,A01,193450,Reyes Gonzalez; Catalina,0,2,40,40
1683300938873,BIPN 134,A01,193465,Cooke; James Edward,0,0,32,32
1683300938873,BIPN 134,A02,193474,Cooke; James Edward,27,0,32,5
1683300938873,BIPN 134,A03,193485,Cooke; James Edward,29,0,32,3
1683300938873,BIPN 134,A04,193486,Cooke; James Edward,21,0,32,11
1683300938873,BIPN 134,A05,193491,Cooke; James Edward,31,0,32,1
1683300938873,BIPN 134,A06,193501,Cooke; James Edward,30,0,32,2
1683300938873,BIPN 134,A07,193510,Cooke; James Edward,29,0,32,3
1683300940921,BISP 194,A00,222522,Staff,16,0,32,16
1683300941945,CAT 124,A01,202407,Staff,20,0,25,5
1683300942972,CAT 125,A00,202408,Marchisotto; Jennifer Anne,4,0,20,16
1683300943997,CAT 125R,A00,202409,Smith; Lauryn Alissa,0,11,20,20
1683300943997,CAT 125R,B00,202410,Morales; Celeste Georgianna,0,11,20,20
1683300943997,CAT 125R,C00,202411,Irwin; Matthew Joseph,0,10,20,20
1683300945021,CENG 15,A01,204712,Yang; Kesong,0,1,0,0
1683300946044,CENG 114,A00,202070,Jahed Motlagh; Zeinab,5,0,20,15
1683300947067,CGS 105,A00,185477,Wesling; Megan E.,24,0,40,16
1683300948094,CGS 106,A00,185494,Staff,13,0,22,9
1683300949116,CGS 108,A00,185495,Staff,14,0,20,6
1683300950140,CGS 114,A00,185496,Staff,13,0,18,5
1683300951167,CGS 119,A00,185501,Staff,15,0,20,5
1683300952194,CGS 120,A00,185511,Staff,13,0,20,7
1683300953219,CHEM 4,A01,184675,Bussey; Thomas J,96,0,100,4
1683300954241,CHEM 6A,A01,184677,Staff,35,0,60,25
1683300955267,CHEM 6B,A01,184679,Staff,65,0,100,35
1683300956295,CHEM 6C,A01,184681,Bussey; Thomas J,1,0,50,49
1683300956295,CHEM 6C,A02,184682,Bussey; Thomas J,34,0,50,16
1683300957324,CHEM 40A,A01,184684,Albizati; Kim F.,37,0,100,63
1683300958346,CHEM 40B,A01,184686,Albizati; Kim F.,0,20,100,100
1683300959374,CHEM 41B,A01,184690,Staff,52,0,100,48
1683300960402,COGS 3,A01,184715,Boyle; Mary E. T.,0,25,40,40
1683300961429,COGS 14B,A01,185172,Staff,0,15,38,38
1683300962458,COGS 18,A01,184736,Staff,20,0,80,60
1683300963483,COGS 100,A01,184932,Staff,0,5,73,73
1683300964508,COGS 101A,A01,184935,Staff,0,38,30,30
1683300965537,COGS 101B,A01,184944,Staff,0,2,30,30
1683300966561,COGS 101C,A01,184946,Staff,0,12,30,30
1683300967587,COGS 102A,A01,184951,Johnson; Christine M.,2,0,40,38
1683300968612,COGS 107B,A01,184953,Mooshagian; Eric Frederick,0,50,40,40
1683300969642,COGS 118B,A01,184959,Gupta; Anjum,0,48,40,40
1683300970667,COGS 153,A00,184961,Staff,0,15,30,30
1683300971692,COGS 177,A00,184962,Staff,0,21,30,30
1683300972717,COGS 187A,A01,184969,Boyle; Mary E. T.,0,17,40,40
1683300973742,COMM 10,A01,185174,Staff,0,5,25,25
1683300973742,COMM 10,A02,185189,Staff,0,5,25,25
1683300973742,COMM 10,A03,269821,Staff,0,0,0,0
1683300974781,COMM 100B,A01,185475,Staff,0,0,0,2
1683300974781,COMM 100B,A02,185476,Staff,14,0,25,11
1683300975806,COMM 100C,A01,185314,Staff,1,0,25,24
1683300975806,COMM 100C,A02,185327,Staff,19,0,25,6
1683300976829,COMM 110M,A00,185349,Staff,2,0,40,38
1683300977854,COMM 113T,A00,185352,Staff,25,0,40,15
1683300978878,COMM 114I,A00,185353,Staff,33,0,40,7
1683300979903,COMM 131,A00,185354,Staff,19,0,30,11
1683300980927,CSE 8A,A50,185358,Cao; Yingjun,0,46,10,10
1683300981951,CSE 8B,A01,185362,Staff,1,47,50,49
1683300982979,CSE 11,A01,185416,Cao; Yingjun,0,93,10,10
1683300984003,CSE 20,A01,185445,Briones; Jor-el Thomas Caparas,5,0,25,20
1683300985033,CSE 21,A01,185447,Staff,10,0,50,40
1683300986062,CSE 101,A01,185451,Staff,0,12,50,50
1683300986062,CSE 101,B01,185453,Jones; Miles E,0,11,50,50
1683300988113,CSE 141,A01,185458,Eldon; John,20,0,100,80
1683300989140,CSE 141L,A01,185461,Eldon; John,12,0,100,88
1683300990166,CSE 142,A01,185463,Staff,35,0,60,25
1683300990166,CSE 142,B01,201355,Staff,0,6,60,60
1683300991190,CSE 142L,A01,185470,Staff,35,0,60,25
1683300991190,CSE 142L,B01,201417,Staff,0,5,60,60
1683300992214,CSE 190,A00,201433,Staff,32,0,49,17
1683300993243,DOC 1,A01,259136,Strom; Megan C.,8,0,15,7
1683300993243,DOC 1,A02,259137,Strom; Megan C.,14,0,15,1
1683300993243,DOC 1,A03,259138,Strom; Megan C.,14,0,15,1
1683300993243,DOC 1,A04,259139,Strom; Megan C.,14,0,15,1
1683300994266,DOC 100D,A00,259140,Pass; Natalye Joann,17,0,25,8
1683300995290,DSGN 1,A01,184749,Rill; Bryan,0,24,30,30
1683300996314,DSGN 100,A01,185168,Staff,0,2,25,25
1683300997338,ECE 5,A01,185626,Morris; Karcher William,0,10,0,0
1683300998362,ECE 101,A01,185628,Staff,17,0,70,53
1683300999389,ECE 107,A01,185635,Baghdadchi; Saharnaz,0,0,20,20
1683300999389,ECE 107,A02,185638,Baghdadchi; Saharnaz,4,0,20,16
1683301000416,ECE 148,A01,185647,Silberman; Jack,1,0,16,15
1683301001442,ECON 1,A01,185537,Crane; Meredith Helen,54,0,70,16
1683301002468,ECON 3,A01,185549,Crane; Meredith Helen,33,0,70,37
1683301003496,ECON 4,A01,203354,Anderson; John Charles,0,4,10,10
1683301004522,ECON 100A,A01,185574,Staff,0,4,40,40
1683301005548,ECON 100B,A01,185576,Staff,0,22,40,40
1683301006576,ECON 100C,A01,185589,Newhouse; Herbert S,30,0,70,40
1683301007604,ECON 105,A00,185608,Vespa; Emanuel Ignacio,19,0,35,16
1683301008633,ECON 109,A01,185610,Shishkin; Denis,10,0,35,25
1683301009659,ECON 110A,A01,185612,Staff,11,0,40,29
1683301010684,ECON 120A,A01,185615,Staff,20,0,40,20
1683301011767,ECON 120C,A01,185617,Sun; Yixiao,0,20,70,70
1683301012798,ECON 144,A00,203346,Squires; Dale E,3,0,35,32
1683301013822,ECON 171,A01,203349,Newhouse; Herbert S,0,1,35,35
1683301014846,ECON 173A,A01,185621,Toda; Alexis Akira,21,0,35,14
1683301015874,EDS 25,A01,202413,Staff,0,1,0,0
1683301015874,EDS 25,A02,202414,Staff,0,1,0,0
1683301015874,EDS 25,A03,202415,Staff,0,0,0,0
1683301015874,EDS 25,A04,202416,Staff,0,1,0,0
1683301015874,EDS 25,A05,202439,Staff,0,0,0,0
1683301015874,EDS 25,A06,202440,Staff,0,0,0,0
1683301015874,EDS 25,B01,202631,Staff,0,0,0,0
1683301015874,EDS 25,B02,202632,Staff,0,0,0,0
1683301015874,EDS 25,B03,202639,Staff,0,0,0,0
1683301015874,EDS 25,B04,202640,Staff,0,0,0,0
1683301015874,EDS 25,B05,202643,Staff,0,0,0,0
1683301015874,EDS 25,B06,202644,Staff,0,0,0,0
1683301016898,EDS 38,A01,202659,Black; Alison Michelle,24,0,25,1
1683301017925,EDS 115,A00,202652,Staff,17,0,30,13
1683301018949,EDS 125,A00,202649,Staff,14,0,30,16
1683301019972,EDS 126,A01,203332,Staff,30,0,30,0
1683301020997,EDS 139,A00,202838,Staff,17,0,25,8
1683301022026,EDS 146,A01,202655,Staff,15,0,25,10
1683301023051,ENG 15,A00,185667,Staff,0,1,0,0
1683301023051,ENG 15,B00,185672,Staff,0,0,0,0
1683301023051,ENG 15,C00,185675,Staff,0,0,0,0
1683301023051,ENG 15,D00,185682,Staff,0,0,0,0
1683301023051,ENG 15,E00,185684,Staff,0,0,0,0
1683301024081,ETHN 103,A00,185710,Staff,0,3,35,35
1683301025105,ETHN 103A,A00,199228,Man; Simeon S,3,0,9,6
1683301026129,ETHN 109,A00,185711,Staff,18,0,35,17
1683301027157,ETHN 142,A00,185726,Staff,0,4,30,30
1683301028184,ETHN 163J,A00,199229,Man; Simeon S,6,0,8,2
1683301029209,ETHN 168,A00,185727,Staff,8,0,10,2
1683301030236,ETHN 182,A00,185728,Staff,1,0,35,34
1683301031260,ETHN 183,A00,185737,Staff,8,0,18,10
1683301032289,GLBH 111,A01,209361,Burgos; Jose L.,0,0,0,0
1683301034335,HIEU 104,A00,185792,Staff,16,0,20,4
1683301035361,HIEU 115,A00,185800,Staff,1,0,20,19
1683301036388,HIEU 128,A00,185801,Staff,0,7,20,20
1683301037412,HIEU 147,A00,185802,Staff,16,0,20,4
1683301038436,HIEU 154,A00,185823,Staff,12,0,20,8
1683301039462,HILA 102,A00,185826,Staff,13,0,20,7
1683301040491,HILD 2C,A01,185778,Staff,0,12,20,20
1683301041519,HILD 7B,A01,185780,Kwak; Nancy,0,15,32,32
1683301041519,HILD 7B,A02,185781,Kwak; Nancy,0,18,32,32
1683301042546,HILD 30,A01,185791,Staff,14,0,20,6
1683301043574,HISC 119,A00,185830,Golan; Tal,0,9,20,20
1683301044598,HITO 156GS,A00,185831,Patterson; Patrick H.,0,0,0,23
1683301045626,HIUS 103,A00,185832,Man; Simeon S,0,7,20,20
1683301046653,HIUS 117,A00,185836,Kwak; Nancy,2,0,20,18
1683301047677,HIUS 125,A00,185840,Man; Simeon S,0,0,23,23
1683301048707,HIUS 149,A00,185845,Staff,0,0,20,20
1683301049736,HUM 3,A01,185882,Zavodny; Tatiana Sophia,0,6,50,50
1683301049736,HUM 3,B01,185899,Caldwell; Michael Alan,0,19,50,50
1683301050770,HUM 3GS,A00,185900,Patterson; Patrick H.,0,0,0,23
1683301051795,HUM 4,A01,185938,Zroka; Amy Liane,31,0,50,19
1683301051795,HUM 4,B01,185956,Watkins; Eric,0,2,50,50
1683301051795,HUM 4,B02,202209,Watkins; Eric,0,1,50,50
1683301051795,HUM 4,B03,202210,Watkins; Eric,0,0,50,50
1683301052823,HUM 5,A01,185958,West; Geoffrey Scott,5,0,50,45
1683301052823,HUM 5,A02,202215,West; Geoffrey Scott,0,0,50,50
1683301053848,INTL 190,A00,185959,Gagnon; Jeffrey C,0,0,0,9
1683301053848,INTL 190,B00,185960,Lettieri; Michael Joseph,0,0,0,1
1683301054871,JAPN 180,A00,254509,Staff,0,1,25,25
1683301055934,LATI 10,A01,202853,Kennemore; Amy Michelle,5,0,35,30
1683301055934,LATI 10,A02,202854,Kennemore; Amy Michelle,1,0,35,34
1683301055934,LATI 10,A03,270054,Kennemore; Amy Michelle,30,0,30,0
1683301056961,LATI 180,A00,202855,Kennemore; Amy Michelle,11,0,20,9
1683301057988,LAWS 101,A00,201767,Golan; Tal,0,7,40,40
1683301059012,LIFR 1C,A00,185961,Staff,6,0,20,14
1683301060038,LIFR 1CX,A00,185962,Staff,7,0,20,13
1683301061062,LIFR 1D,A00,185963,Staff,9,0,20,11
1683301062090,LIFR 1DX,A00,185964,Staff,9,0,20,11
1683301063116,LIGN 101,A01,186039,Staff,43,0,50,7
1683301064140,LIGN 165,A00,186040,Staff,18,0,50,32
1683301065165,LTCS 108,A00,186041,Staff,6,0,10,4
1683301066188,LTCS 119,A00,186042,Staff,16,0,20,4
1683301067213,LTCS 130,A00,186043,Wesling; Megan E.,15,0,25,10
1683301069266,LTEA 138,A00,186119,Staff,14,0,40,26
1683301070293,LTEN 124,A00,186148,Staff,6,0,25,19
1683301071317,LTEN 178,A00,186149,Staff,7,0,15,8
1683301072342,LTEN 181,A00,186150,Blanco; John D,33,0,40,7
1683301073366,LTWL 120,A00,186160,Staff,20,0,25,5
1683301074390,LTWL 165,A00,186161,Staff,22,0,25,3
1683301075415,LTWR 100,A00,186162,Staff,0,4,15,15
1683301076442,LTWR 102,A00,186163,Doller; Ben,5,0,15,10
1683301077467,MAE 8,A01,186412,Staff,0,0,0,0
1683301078491,MAE 30B,A00,186445,Bahadori; Mohammad Yousef,83,0,100,17
1683301079518,MAE 40,A00,186592,Bewley; Thomas R,9,0,50,41
1683301080545,MAE 101B,A00,186593,Bahadori; Mohammad Yousef,81,0,100,19
1683301081570,MAE 105,A00,186594,Bandaru; Prabhakar,12,0,50,38
1683301082597,MAE 107,A00,186599,Pham; Hieu Tan,0,6,120,120
1683301083620,MAE 148,A01,186660,Silberman; Jack,3,0,16,13
1683301084642,MATH 10A,A01,188095,Staff,0,7,35,35
1683301085665,MATH 10B,A01,188097,Bowers; Adam R.,0,11,30,30
1683301085665,MATH 10B,A02,188099,Bowers; Adam R.,0,9,30,30
1683301085665,MATH 10B,B01,188104,Bowers; Adam R.,0,11,30,30
1683301085665,MATH 10B,B02,188106,Bowers; Adam R.,0,11,30,30
1683301086693,MATH 10C,A01,188111,Staff,0,18,30,30
1683301086693,MATH 10C,A02,188127,Staff,0,17,30,30
1683301086693,MATH 10C,A03,188131,Staff,0,17,30,30
1683301086693,MATH 10C,B01,188218,Staff,21,0,30,9
1683301086693,MATH 10C,B02,188244,Staff,13,0,30,17
1683301086693,MATH 10C,B03,188277,Staff,16,0,30,14
1683301087725,MATH 18,A01,188344,Bach; Quang Tran,18,0,30,12
1683301087725,MATH 18,A02,188345,Bach; Quang Tran,11,0,30,19
1683301087725,MATH 18,B01,188353,Bach; Quang Tran,10,0,30,20
1683301087725,MATH 18,B02,188354,Bach; Quang Tran,20,0,30,10
1683301088749,MATH 20A,A01,188374,Staff,13,0,35,22
1683301089774,MATH 20B,A01,188382,Ohm; Ko Woon,6,0,30,24
1683301089774,MATH 20B,A02,188383,Ohm; Ko Woon,24,0,30,6
1683301089774,MATH 20B,B01,188385,Ohm; Ko Woon,7,0,30,23
1683301089774,MATH 20B,B02,188392,Ohm; Ko Woon,22,0,30,8
1683301090800,MATH 20C,A01,188394,Harel; Guershon,10,0,30,20
1683301090800,MATH 20C,A02,188395,Harel; Guershon,13,0,30,17
1683301090800,MATH 20C,B01,188404,Harel; Guershon,3,0,30,27
1683301090800,MATH 20C,B02,188405,Harel; Guershon,19,0,30,11
1683301091825,MATH 20D,A01,188414,Hammock; Frances H,0,1,30,30
1683301091825,MATH 20D,A02,188415,Hammock; Frances H,4,0,30,26
1683301091825,MATH 20D,B01,188447,Hammock; Frances H,2,0,30,28
1683301091825,MATH 20D,B02,188486,Hammock; Frances H,8,0,30,22
1683301092851,MATH 20E,A01,188649,Staff,22,0,30,8
1683301092851,MATH 20E,A02,188650,Staff,23,0,30,7
1683301092851,MATH 20E,A03,188673,Staff,0,0,30,30
1683301093879,MATH 102,A01,188675,Staff,0,35,35,35
1683301094904,MATH 103B,A01,188681,Staff,4,0,35,31
1683301094904,MATH 103B,B01,188692,Staff,7,0,35,28
1683301095927,MATH 109,A01,188695,Salehi Golsefidy; Alireza,25,0,35,10
1683301095927,MATH 109,A02,188696,Salehi Golsefidy; Alireza,27,0,35,8
1683301096954,MATH 120A,A01,188698,Eggers; John Dietrich,5,0,35,30
1683301097977,MATH 142B,A01,188736,Ioana; Adrian,0,2,30,30
1683301097977,MATH 142B,A02,188741,Ioana; Adrian,0,1,30,30
1683301097977,MATH 142B,A03,188743,Ioana; Adrian,0,3,30,30
1683301099004,MATH 168A,A01,188790,Staff,0,8,35,35
1683301100029,MATH 170A,A01,188803,Nie; Jiawang,0,2,35,35
1683301100029,MATH 170A,A02,188811,Nie; Jiawang,0,0,35,35
1683301100029,MATH 170A,A03,188814,Nie; Jiawang,1,0,35,34
1683301100029,MATH 170A,A04,188815,Nie; Jiawang,14,0,35,21
1683301101057,MATH 193B,A01,188817,Staff,0,0,35,35
1683301101057,MATH 193B,A02,188818,Staff,5,0,35,30
1683301102080,MGT 4,A01,202857,Anderson; John Charles,62,0,80,18
1683301103103,MGT 12,A00,202858,Lindenberger; Wade Douglas,43,0,90,47
1683301104130,MGT 18,A00,202859,Staff,74,0,90,16
1683301105155,MGT 18GS,A00,202860,McKay; Michael J,13,0,28,15
1683301106183,MGT 45,A00,202861,Pecore; Joseph P.,14,0,90,76
1683301107208,MGT 100,A00,202863,Yavorsky; Daniel Ryan,28,0,90,62
1683301108238,MGT 103,A00,202864,Ehrich; Kristine R,0,16,90,90
1683301109265,MGT 112,A00,202865,Ehrich; Kristine R,15,0,90,75
1683301110289,MGT 121A,A00,202868,Staff,0,19,0,0
1683301111316,MGT 131B,A00,202869,Anderson; John Charles,59,0,90,31
1683301112341,MGT 136,A00,202871,Lindenberger; Wade Douglas,84,0,90,6
1683301113367,MGT 164,A00,202873,Staff,0,69,90,90
1683301114392,MGT 164GS,A00,202874,McKay; Mary A,13,0,28,15
1683301115474,MGT 180,A00,202875,Staff,0,51,90,90
1683301116498,MMW 11R,A01,205019,Herbst; Matthew,3,0,30,27
1683301116498,MMW 11R,A02,205026,Herbst; Matthew,29,0,30,1
1683301117523,MMW 15,A01,193512,Chang; Edmond Yi-Teh,0,9,28,28
1683301117523,MMW 15,A02,193513,Chang; Edmond Yi-Teh,0,5,28,28
1683301117523,MMW 15,A03,193514,Chang; Edmond Yi-Teh,0,5,28,28
1683301117523,MMW 15,A04,193515,Chang; Edmond Yi-Teh,0,4,28,28
1683301117523,MMW 15,A05,193516,Chang; Edmond Yi-Teh,0,4,28,28
1683301117523,MMW 15,A06,193517,Chang; Edmond Yi-Teh,0,5,28,28
1683301117523,MMW 15,B01,193519,Chang; Edmond Yi-Teh,0,4,28,28
1683301117523,MMW 15,B02,193520,Chang; Edmond Yi-Teh,0,5,28,28
1683301117523,MMW 15,B03,193521,Chang; Edmond Yi-Teh,0,4,28,28
1683301117523,MMW 15,B04,193522,Chang; Edmond Yi-Teh,0,4,28,28
1683301117523,MMW 15,B05,193523,Chang; Edmond Yi-Teh,0,5,28,28
1683301117523,MMW 15,B06,193524,Chang; Edmond Yi-Teh,0,4,28,28
1683301118548,MMW 122,A01,193526,Rahimi; Babak,0,14,28,28
1683301118548,MMW 122,A02,193527,Rahimi; Babak,0,14,28,28
1683301118548,MMW 122,A03,193528,Rahimi; Babak,0,0,0,0
1683301118548,MMW 122,A04,193529,Rahimi; Babak,0,0,0,0
1683301119572,MUS 1A,A01,186663,Staff,0,20,35,35
1683301120597,MUS 4,A01,186715,Staff,0,12,35,35
1683301121622,MUS 5R,A01,186796,Dubnov; Shlomo,0,16,35,35
1683301122646,MUS 6,A01,186798,Staff,0,3,25,25
1683301123670,MUS 7,A01,186830,Staff,12,0,35,23
1683301124694,MUS 8,A01,186930,Staff,0,25,35,35
1683301125721,MUS 15,A01,186932,Staff,0,15,35,35
1683301125721,MUS 15,B01,186934,Staff,0,14,35,35
1683301126750,MUS 80,A00,186935,Staff,2,0,20,18
1683301126750,MUS 80,B00,186936,Staff,25,0,25,0
1683301127773,NANO 11,A00,204702,Lipomi; Darren John,0,0,0,0
1683301128798,NANO 15,A01,204709,Yang; Kesong,0,1,0,0
1683301129822,NANO 114,A00,202069,Jahed Motlagh; Zeinab,3,0,10,7
1683301130849,PHIL 1,A00,186955,Grush; Rick Scott,32,0,40,8
1683301131875,PHIL 10,A01,186973,Grush; Rick Scott,29,0,35,6
1683301131875,PHIL 10,A02,186974,Grush; Rick Scott,33,0,35,2
1683301132900,PHIL 13,A01,186976,Staff,7,0,35,28
1683301132900,PHIL 13,A02,186977,Staff,16,0,35,19
1683301133925,PHIL 14,A01,186979,Staff,31,0,35,4
1683301133925,PHIL 14,A02,186986,Staff,32,0,35,3
1683301134950,PHIL 28,A01,186988,Staff,16,0,30,14
1683301134950,PHIL 28,A02,186989,Staff,1,0,30,29
1683301134950,PHIL 28,A03,186990,Staff,9,0,30,21
1683301134950,PHIL 28,A04,186991,Staff,26,0,30,4
1683301135975,PHIL 120,A00,186997,Staff,23,0,40,17
1683301137005,PHIL 137,A00,187003,Staff,9,0,40,31
1683301138029,PHIL 150,A00,187015,Staff,47,0,70,23
1683301139053,PHIL 167,A00,187021,Lamey; Andy M.,35,0,40,5
1683301140162,PHIL 174,A01,202226,Staff,17,0,20,3
1683301140162,PHIL 174,A02,202235,Staff,20,0,20,0
1683301141185,PHIL 191A,A00,258918,Staff,0,0,1,1
1683301142211,PHYS 1A,A00,187028,Staff,26,0,60,34
1683301143237,PHYS 1AL,001,187036,Staff,2,0,30,28
1683301143237,PHYS 1AL,002,187049,Staff,18,0,30,12
1683301144261,PHYS 1B,A00,187058,Staff,23,0,60,37
1683301145289,PHYS 1BL,001,187064,Staff,0,0,30,30
1683301145289,PHYS 1BL,002,187070,Staff,6,0,30,24
1683301146314,PHYS 1C,A00,187082,Staff,32,0,120,88
1683301147342,PHYS 1CL,001,187088,Staff,0,9,30,30
1683301147342,PHYS 1CL,002,187089,Staff,0,2,30,30
1683301147342,PHYS 1CL,009,262693,Staff,12,0,30,18
1683301148369,PHYS 2B,A01,187097,Staff,54,0,115,61
1683301149394,PHYS 2C,A01,187099,Staff,67,0,115,48
1683301150419,PHYS 2CL,A01,187101,Staff,5,0,28,23
1683301150419,PHYS 2CL,A02,187102,Staff,15,0,28,13
1683301151447,PHYS 2D,A01,187123,Shotwell; Brian,95,0,115,20
1683301152472,PHYS 4B,A01,187133,Grinstein; Benjamin,35,0,50,15
1683301153496,POLI 10,A00,188819,Staff,0,3,50,50
1683301154523,POLI 11,A00,188827,Staff,43,0,50,7
1683301155549,POLI 13R,A00,188828,Staff,0,1,20,20
1683301156574,POLI 27,A01,188830,Elgin; Samuel Zincke,0,1,70,70
1683301157598,POLI 30,A00,188832,Desposato; Scott,33,0,50,17
1683301158622,POLI 102F,A00,188834,Staff,3,0,40,37
1683301159647,POLI 104A,A00,188852,Staff,14,0,30,16
1683301160673,POLI 104I,A00,188853,Staff,0,6,20,20
1683301161697,POLI 110B,A00,188854,Wiens; David,7,0,20,13
1683301162721,POLI 112A,A00,188855,Wiens; David,5,0,30,25
1683301163745,POLI 117R,A00,188856,Forman; Fonna,0,11,20,20
1683301164770,POLI 118,A00,188857,Ingham; Sean,8,0,20,12
1683301165794,POLI 120G,A00,188858,Staff,9,0,30,21
1683301166818,POLI 131CR,A00,188863,Hoston; Germaine,24,0,50,26
1683301167842,POLI 133,A00,188864,Nellis; Gareth Hb,44,0,50,6
1683301168867,POLI 134D,A00,188865,Desposato; Scott,27,0,30,3
1683301169892,POLI 142A,A00,188871,Gartzke; Erik,22,0,50,28
1683301170919,POLI 142K,A00,188874,Staff,38,0,50,12
1683301171945,POLI 143,A00,188940,Gartzke; Erik,16,0,30,14
1683301172974,POLI 153,A00,188943,Staff,3,0,20,17
1683301173998,POLI 160AA,A00,188944,Staff,13,0,40,27
1683301175023,POLI 170A,A00,188945,Staff,11,0,30,19
1683301177073,PSYC 1,A00,188952,Staff,38,0,90,52
1683301178098,PSYC 2,B00,188953,Staff,20,0,35,15
1683301179122,PSYC 6,A00,188970,Staff,47,0,60,13
1683301180144,PSYC 7,A00,188973,Staff,37,0,45,8
1683301181171,PSYC 60,A01,188980,Rickard; Timothy C.,43,0,60,17
1683301182195,PSYC 70,A01,189001,Steiner; Eric Tomas,24,0,45,21
1683301183218,PSYC 100,A00,189005,Lacefield; Katharine I,0,99,120,120
1683301184242,PSYC 102,A00,189008,Staff,10,0,30,20
1683301185264,PSYC 106,B00,189026,Gorman; Michael R.,37,0,60,23
1683301186291,PSYC 114,B01,189033,Winkielman; Piotr,0,32,30,30
1683301187318,PSYC 131,A00,189036,Anagnostaras; Stephan,0,43,60,60
1683301188343,PSYC 136,A00,189041,Lowe; Angela Beth,0,7,25,25
1683301189368,PSYC 137,A00,189057,Winkielman; Piotr,0,34,25,25
1683301190392,PSYC 144,A00,189107,Wixted; John T,0,7,50,50
1683301192440,PSYC 162,A00,189142,Staff,0,8,85,85
1683301193464,PSYC 172,A00,189144,Gorman; Michael R.,0,7,30,30
1683301195518,PSYC 179,A00,189146,Lacefield; Katharine I,0,84,120,120
1683301196545,PSYC 181,A00,189147,Anagnostaras; Stephan,0,44,90,90
1683301197569,PSYC 190R,A00,189148,Barner; David A.,0,22,80,80
1683301198594,PSYC 191,A00,189275,Rickard; Timothy C.,0,7,25,25
1683301199622,PSYC 193,A00,189276,Chapman; Eddie Nathaniel,0,1,0,4
1683301200652,PSYC 193L,A01,189281,Lowe; Angela Beth,12,0,20,8
1683301200652,PSYC 193L,B01,189285,Staff,28,0,35,7
1683301201675,RELI 149,A00,187137,Rahimi; Babak,7,0,40,33
1683301202707,SE 9,A01,187315,Staff,0,2,18,18
1683301203733,SE 101B,A00,187409,Staff,24,0,30,6
1683301204756,SE 110B,A00,187444,Staff,10,0,40,30
1683301205781,SE 130B,A00,187449,Staff,31,0,40,9
1683301206803,SE 150A,A00,187516,Staff,9,0,20,11
1683301207828,SE 154,A00,187528,Staff,30,0,50,20
1683301208852,SIO 3,A01,258171,Staff,35,0,40,5
1683301209877,SIO 10,A00,187144,Cook; Geoffrey W,0,3,75,75
1683301210905,SIO 45,A00,187152,Cook; Geoffrey W,1,0,100,99
1683301211931,SIO 109R,A00,194486,Staff,0,3,20,20
1683301213982,SIO 187,A01,187233,Kacev; David,12,0,40,28
1683301215007,SOCI 1,A01,258656,Thorpe; Charles Robert,28,0,30,2
1683301215007,SOCI 1,A02,258658,Thorpe; Charles Robert,30,0,30,0
1683301215007,SOCI 1,A03,258661,Thorpe; Charles Robert,25,0,25,0
1683301215007,SOCI 1,A04,258666,Thorpe; Charles Robert,22,0,25,3
1683301215007,SOCI 1,A05,258897,Thorpe; Charles Robert,23,0,25,2
1683301215007,SOCI 1,A06,258898,Thorpe; Charles Robert,25,0,25,0
1683301216032,SOCI 30,A01,258903,Pardo Guerra; Juan Pablo,16,0,30,14
1683301217058,SOCI 102,A00,258904,Staff,9,0,25,16
1683301218085,SOCI 106,A00,258905,Staff,19,0,25,6
1683301219169,SOCI 111,A00,258907,Ribas Norris; Janet Vanesa,26,0,30,4
1683301220195,SOCI 121R,A00,258908,Pardo Guerra; Juan Pablo,11,0,30,19
1683301221220,SOCI 126,A01,203330,Staff,14,0,20,6
1683301222244,SOCI 131,A00,258909,Thorpe; Charles Robert,31,0,60,29
1683301223268,SOCI 135,A00,258910,Payne; Christine Anna,0,9,30,30
1683301224292,SOCI 157,A00,258911,Staff,13,0,30,17
1683301225319,SOCI 184,A00,258912,Staff,26,0,30,4
1683301226343,SOCI 188D,A00,258913,Staff,21,0,30,9
1683301227366,SYN 2,001,187529,Staff,9,0,16,7
1683301227366,SYN 2,002,201452,Staff,0,18,16,16
1683301227366,SYN 2,003,201469,Staff,3,0,16,13
1683301228390,SYN 100,A01,187531,Staff,0,9,20,20
1683301228390,SYN 100,B01,201491,Staff,0,12,20,20
1683301229414,TDAC 1,A00,189286,Walsh; Kim C.,3,0,20,17
1683301229414,TDAC 1,B00,189287,Harting; Carla Kelso,11,0,20,9
1683301230438,TDAC 101,A00,189300,Walsh; Kim C.,16,0,20,4
1683301230438,TDAC 101,B00,189301,Harting; Carla Kelso,18,0,20,2
1683301231460,TDAC 102,A00,189304,Basso; Beatrice,14,0,20,6
1683301232483,TDAC 108,A00,189305,Staff,18,0,20,2
1683301233512,TDDE 131,A00,189310,Staff,19,0,20,1
1683301233512,TDDE 131,B00,189314,Staff,19,0,20,1
1683301233512,TDDE 131,C00,189315,Staff,48,0,50,2
1683301233512,TDDE 131,D00,189316,Staff,14,0,15,1
1683301233512,TDDE 131,E00,204841,Staff,20,0,20,0
1683301234536,TDGE 10,A00,189289,Staff,30,0,50,20
1683301234536,TDGE 10,B00,189290,Havis; Allan,2,0,50,48
1683301235564,TDGE 11,A00,189291,Fulton; Julia,0,3,50,50
1683301235564,TDGE 11,B00,189292,Staff,20,0,25,5
1683301235564,TDGE 11,C00,260270,Staff,0,0,0,0
1683301236588,TDGE 25,A00,189294,Staff,3,0,20,17
1683301237612,TDGE 124,A00,189318,Fulton; Julia,0,8,50,50
1683301238639,TDGE 125,A00,189319,Staff,13,0,25,12
1683301238639,TDGE 125,B00,189320,Staff,23,0,25,2
1683301239666,TDGE 127,A00,189322,Havis; Allan,0,0,50,50
1683301240691,TDHT 101,A00,189323,Staff,18,0,25,7
1683301240691,TDHT 101,B00,189324,Staff,25,0,25,0
1683301241718,TDHT 102,A00,189325,Staff,49,0,50,1
1683301242744,TDMV 1,A00,189295,Arcidiacono; Kristin,20,0,30,10
1683301242744,TDMV 1,B00,189296,Caligagan; Maria T.,24,0,30,6
1683301243772,TDMV 2,A00,189297,Sammartano; Tonnie,28,0,30,2
1683301243772,TDMV 2,B00,189299,Arcidiacono; Kristin,24,0,30,6
1683301244798,TDMV 3,A00,204998,Rincon; Alicia,22,0,30,8
1683301245825,TDMV 120,A00,189458,Sammartano; Tonnie,28,0,30,2
1683301246851,TDMV 138,A00,189541,Jun; Grace Shin Hae,22,0,40,18
1683301247876,TDMV 142,A00,189717,Caligagan; Tony,23,0,30,7
1683301247876,TDMV 142,B00,189718,Caligagan; Maria T.,25,0,30,5
1683301248902,TMC 2,A01,187533,Staff,25,0,25,0
1683301248902,TMC 2,A02,187534,Staff,25,0,25,0
1683301249930,USP 1,A01,187536,Kwak; Nancy,0,16,25,25
1683301250954,USP 5,A01,187538,Staff,9,0,25,16
1683301251977,USP 101,A00,199253,Staff,0,4,0,0
1683301253002,USP 124,A00,187562,Boomhower; Matthew Charles,1,0,30,29
1683301254026,USP 138,A00,187582,Staff,20,0,25,5
1683301255050,USP 152,A01,187597,Staff,4,0,25,21
1683301256074,USP 153,A00,187598,Staff,19,0,25,6
1683301257098,USP 168,A00,187607,Kwak; Nancy,2,0,5,3
1683301258123,USP 173,A00,187619,Staff,4,0,25,21
1683301259148,USP 181,A00,187638,Staff,0,0,25,25
1683301260174,VIS 103,A00,187650,Cruz; Edwin Teddy,23,0,75,52
1683301261198,VIS 110D,A00,187669,Staff,12,0,22,10
1683301262222,VIS 127C,A00,187720,Shen; Kuiyi,68,0,146,78
1683301263247,VIS 149,A00,187731,Yoldas; Pinar,0,14,22,22
1683301264275,VIS 151,A01,188091,Staff,22,0,34,12
1683301264275,VIS 151,A02,188092,Staff,11,0,34,23
1683301265306,VIS 160B,A00,188093,Stalbaum; Brett,0,0,10,10
1683301267358,WCWP 10B,A00,201720,Staff,10,0,15,5
1683301267358,WCWP 10B,B00,201722,Staff,8,0,15,7
1683301268385,WCWP 100,A00,201725,Gagnon; Jeffrey C,0,0,2,2
1683301268385,WCWP 100,B00,201727,Staff,0,4,15,15
1683301271484,ANBI 133,A00,258401,Wilder; Linnea Lorene,34,0,40,6
1683301272510,ANBI 140,A00,258395,Hrvoj Mihic; Branka,18,0,25,7
1683301273537,ANSC 120,A00,258402,Bialecki; Jon Anthony,27,0,40,13
1683301274562,ANSC 144,A00,258400,Staff,14,0,40,26
1683301276615,ANSC 166,A00,258396,Parish; Steven Martin,157,0,175,18
1683301277639,ANSC 180,A00,193533,Staff,9,0,20,11
1683301278667,ANSC 188,A00,258397,Jassal; Aftab,33,0,40,7
1683301279691,ANTH 3,A01,258316,Staff,23,0,30,7
1683301280715,ANTH 5,A00,258394,Semendeferi; Ekaterini,16,0,20,4
1683301281740,ANTH 21,A01,258331,Staff,9,0,40,31
1683301282763,ANTH 103,A00,258398,Varma; Saiba,15,0,25,10
1683301283790,AWP 10,001,202034,Staff,0,0,0,0
1683301283790,AWP 10,002,202035,Staff,0,0,0,0
1683301283790,AWP 10,003,202036,Staff,0,0,0,0
1683301283790,AWP 10,004,202037,Staff,0,0,0,0
1683301283790,AWP 10,005,202038,Staff,0,0,0,0
1683301283790,AWP 10,006,202039,Staff,0,0,0,0
1683301283790,AWP 10,007,202040,Staff,0,0,0,0
1683301283790,AWP 10,008,202041,Staff,0,0,0,0
1683301283790,AWP 10,009,202042,Staff,0,0,0,0
1683301283790,AWP 10,010,202043,Staff,0,0,0,0
1683301283790,AWP 10,011,202044,Staff,0,0,0,0
1683301283790,AWP 10,012,202045,Staff,0,0,0,0
1683301283790,AWP 10,013,202046,Staff,0,0,0,0
1683301283790,AWP 10,014,202047,Staff,0,0,0,0
1683301283790,AWP 10,015,202048,Staff,0,0,0,0
1683301283790,AWP 10,016,202049,Staff,0,0,0,0
1683301283790,AWP 10,017,202050,Staff,0,0,0,0
1683301283790,AWP 10,018,202051,Staff,0,0,0,0
1683301283790,AWP 10,019,202052,Staff,0,0,0,0
1683301283790,AWP 10,020,202053,Staff,0,0,0,0
1683301283790,AWP 10,021,202054,Staff,0,0,0,0
1683301283790,AWP 10,022,202055,Staff,0,0,0,0
1683301283790,AWP 10,023,202056,Staff,0,0,0,0
1683301283790,AWP 10,024,202057,Staff,0,0,0,0
1683301283790,AWP 10,025,202058,Staff,0,0,0,0
1683301283790,AWP 10,026,202059,Staff,0,0,0,0
1683301284816,AWP 102,001,202032,Staff,0,0,0,0
1683301284816,AWP 102,002,202033,Staff,0,0,0,0
1683301285844,BENG 100,A01,254234,Taylor Amos; Alyssa C,31,0,40,9
1683301286868,BENG 196,001,270013,Engler; Adam J.,9999,0,9999,0
1683301287893,BICD 100R,A01,202018,Smith; Laurie,0,7,32,32
1683301287893,BICD 100R,A02,202019,Smith; Laurie,0,2,32,32
1683301287893,BICD 100R,A03,202020,Smith; Laurie,0,1,32,32
1683301287893,BICD 100R,A04,202021,Smith; Laurie,8,0,32,24
1683301287893,BICD 100R,A05,202022,Smith; Laurie,12,0,32,20
1683301288916,BICD 136,A01,193242,Gustafson-Brown; Cindy,0,2,32,32
1683301288916,BICD 136,A02,193244,Gustafson-Brown; Cindy,15,0,32,17
1683301289942,BIEB 102,A01,193249,Butler; Shannon Rhey,0,2,32,32
1683301289942,BIEB 102,A02,193251,Butler; Shannon Rhey,0,0,32,32
1683301289942,BIEB 102,A03,193253,Butler; Shannon Rhey,0,1,32,32
1683301289942,BIEB 102,A04,193255,Butler; Shannon Rhey,17,0,32,15
1683301289942,BIEB 102,A05,193265,Butler; Shannon Rhey,26,0,32,6
1683301289942,BIEB 102,A06,193269,Butler; Shannon Rhey,16,0,32,16
1683301291995,BIEB 150,A01,193274,Staff,0,0,32,32
1683301291995,BIEB 150,A02,193285,Staff,24,0,32,8
1683301293023,BIEB 194,A00,193286,Kurle; Carolyn M.,22,0,32,10
1683301294047,BILD 1,A01,192291,Staff,16,0,32,16
1683301294047,BILD 1,A02,192292,Staff,30,0,32,2
1683301294047,BILD 1,B01,192520,Reuther; Keefe,0,1,0,0
1683301294047,BILD 1,B02,192532,Reuther; Keefe,0,1,0,0
1683301295071,BILD 3,A01,192556,Butler; Shannon Rhey,0,0,32,32
1683301295071,BILD 3,A02,192581,Butler; Shannon Rhey,5,0,32,27
1683301295071,BILD 3,A03,192611,Butler; Shannon Rhey,23,0,32,9
1683301295071,BILD 3,A04,192612,Butler; Shannon Rhey,25,0,32,7
1683301295071,BILD 3,A05,192613,Butler; Shannon Rhey,27,0,32,5
1683301295071,BILD 3,A06,192679,Butler; Shannon Rhey,27,0,32,5
1683301295071,BILD 3,A07,192682,Butler; Shannon Rhey,22,0,32,10
1683301296096,BILD 4,A01,192836,Reuther; Keefe,1,0,24,23
1683301296096,BILD 4,A02,193044,Reuther; Keefe,4,0,24,20
1683301297120,BILD 10,A01,193142,Gustafson-Brown; Cindy,31,0,32,1
1683301297120,BILD 10,A02,193149,Gustafson-Brown; Cindy,31,0,32,1
1683301298144,BIMM 100,A01,193301,Staff,0,6,32,32
1683301298144,BIMM 100,A02,193312,Staff,0,5,32,32
1683301298144,BIMM 100,A03,193323,Staff,0,8,32,32
1683301299174,BIMM 101,A01,193329,McDonnell; Lisa Marie,0,3,24,24
1683301299174,BIMM 101,A02,193339,McDonnell; Lisa Marie,0,2,24,24
1683301299174,BIMM 101,B01,193354,McDonnell; Lisa Marie,0,3,24,24
1683301299174,BIMM 101,B02,193357,McDonnell; Lisa Marie,0,3,24,24
1683301300200,BIMM 110,A01,193377,Tat; John,0,11,32,32
1683301300200,BIMM 110,A02,193378,Tat; John,1,9,32,31
1683301301225,BIMM 120,A01,206116,Staff,0,0,32,32
1683301301225,BIMM 120,A02,206117,Staff,8,0,32,24
1683301301225,BIMM 120,A03,206121,Staff,21,0,32,11
1683301302253,BIPN 100,A01,193393,Park; Ji Young,0,14,32,32
1683301302253,BIPN 100,A02,193402,Park; Ji Young,0,12,32,32
1683301302253,BIPN 100,A03,193413,Park; Ji Young,0,14,32,32
1683301302253,BIPN 100,A04,193414,Park; Ji Young,0,13,32,32
1683301303278,BIPN 102,A01,193429,Staff,0,0,32,32
1683301303278,BIPN 102,A02,193438,Staff,23,0,32,9
1683301304302,BIPN 106,A01,193450,Reyes Gonzalez; Catalina,0,2,40,40
1683301305327,BIPN 134,A01,193465,Cooke; James Edward,0,0,32,32
1683301305327,BIPN 134,A02,193474,Cooke; James Edward,27,0,32,5
1683301305327,BIPN 134,A03,193485,Cooke; James Edward,29,0,32,3
1683301305327,BIPN 134,A04,193486,Cooke; James Edward,21,0,32,11
1683301305327,BIPN 134,A05,193491,Cooke; James Edward,31,0,32,1
1683301305327,BIPN 134,A06,193501,Cooke; James Edward,30,0,32,2
1683301305327,BIPN 134,A07,193510,Cooke; James Edward,29,0,32,3
1683301307375,BISP 194,A00,222522,Staff,16,0,32,16
1683301308400,CAT 124,A01,202407,Staff,20,0,25,5
1683301309432,CAT 125,A00,202408,Marchisotto; Jennifer Anne,4,0,20,16
1683301310458,CAT 125R,A00,202409,Smith; Lauryn Alissa,0,11,20,20
1683301310458,CAT 125R,B00,202410,Morales; Celeste Georgianna,0,11,20,20
1683301310458,CAT 125R,C00,202411,Irwin; Matthew Joseph,0,10,20,20
1683301311491,CENG 15,A01,204712,Yang; Kesong,0,1,0,0
1683301312516,CENG 114,A00,202070,Jahed Motlagh; Zeinab,5,0,20,15
1683301313541,CGS 105,A00,185477,Wesling; Megan E.,24,0,40,16
1683301314571,CGS 106,A00,185494,Staff,13,0,22,9
1683301315598,CGS 108,A00,185495,Staff,14,0,20,6
1683301316622,CGS 114,A00,185496,Staff,13,0,18,5
1683301317649,CGS 119,A00,185501,Staff,15,0,20,5
1683301318671,CGS 120,A00,185511,Staff,13,0,20,7
1683301319696,CHEM 4,A01,184675,Bussey; Thomas J,96,0,100,4
1683301320721,CHEM 6A,A01,184677,Staff,35,0,60,25
1683301321747,CHEM 6B,A01,184679,Staff,65,0,100,35
1683301322831,CHEM 6C,A01,184681,Bussey; Thomas J,1,0,50,49
1683301322831,CHEM 6C,A02,184682,Bussey; Thomas J,34,0,50,16
1683301323859,CHEM 40A,A01,184684,Albizati; Kim F.,37,0,100,63
1683301324885,CHEM 40B,A01,184686,Albizati; Kim F.,0,20,100,100
1683301325912,CHEM 41B,A01,184690,Staff,52,0,100,48
1683301326939,COGS 3,A01,184715,Boyle; Mary E. T.,0,25,40,40
1683301327964,COGS 14B,A01,185172,Staff,0,15,38,38
1683301328990,COGS 18,A01,184736,Staff,20,0,80,60
1683301330016,COGS 100,A01,184932,Staff,0,5,73,73
1683301331042,COGS 101A,A01,184935,Staff,0,38,30,30
1683301332069,COGS 101B,A01,184944,Staff,0,2,30,30
1683301333094,COGS 101C,A01,184946,Staff,0,12,30,30
1683301334128,COGS 102A,A01,184951,Johnson; Christine M.,2,0,40,38
1683301335156,COGS 107B,A01,184953,Mooshagian; Eric Frederick,0,50,40,40
1683301336181,COGS 118B,A01,184959,Gupta; Anjum,0,48,40,40
1683301337206,COGS 153,A00,184961,Staff,0,15,30,30
1683301338231,COGS 177,A00,184962,Staff,0,21,30,30
1683301339259,COGS 187A,A01,184969,Boyle; Mary E. T.,0,17,40,40
1683301340288,COMM 10,A01,185174,Staff,0,5,25,25
1683301340288,COMM 10,A02,185189,Staff,0,5,25,25
1683301340288,COMM 10,A03,269821,Staff,0,0,0,0
1683301341312,COMM 100B,A01,185475,Staff,0,0,0,2
1683301341312,COMM 100B,A02,185476,Staff,14,0,25,11
1683301352067,COMM 100C,A01,185314,Staff,1,0,25,24
1683301352067,COMM 100C,A02,185327,Staff,19,0,25,6
1683301353094,COMM 110M,A00,185349,Staff,2,0,40,38
1683301354118,COMM 113T,A00,185352,Staff,25,0,40,15
1683301355143,COMM 114I,A00,185353,Staff,33,0,40,7
1683301356167,COMM 131,A00,185354,Staff,19,0,30,11
1683301357193,CSE 8A,A50,185358,Cao; Yingjun,0,46,10,10
1683301358217,CSE 8B,A01,185362,Staff,1,47,50,49
1683301359242,CSE 11,A01,185416,Cao; Yingjun,0,93,10,10
1683301360266,CSE 20,A01,185445,Briones; Jor-el Thomas Caparas,5,0,25,20
1683301361291,CSE 21,A01,185447,Staff,10,0,50,40
1683301362319,CSE 101,A01,185451,Staff,0,12,50,50
1683301362319,CSE 101,B01,185453,Jones; Miles E,0,11,50,50
1683301364371,CSE 141,A01,185458,Eldon; John,20,0,100,80
1683301365397,CSE 141L,A01,185461,Eldon; John,12,0,100,88
1683301366424,CSE 142,A01,185463,Staff,35,0,60,25
1683301366424,CSE 142,B01,201355,Staff,0,6,60,60
1683301367448,CSE 142L,A01,185470,Staff,35,0,60,25
1683301367448,CSE 142L,B01,201417,Staff,0,5,60,60
1683301368475,CSE 190,A00,201433,Staff,32,0,49,17
1683301369503,DOC 1,A01,259136,Strom; Megan C.,8,0,15,7
1683301369503,DOC 1,A02,259137,Strom; Megan C.,14,0,15,1
1683301369503,DOC 1,A03,259138,Strom; Megan C.,14,0,15,1
1683301369503,DOC 1,A04,259139,Strom; Megan C.,14,0,15,1
1683301370533,DOC 100D,A00,259140,Pass; Natalye Joann,17,0,25,8
1683301371557,DSGN 1,A01,184749,Rill; Bryan,0,24,30,30
1683301372581,DSGN 100,A01,185168,Staff,0,2,25,25
1683301373610,ECE 5,A01,185626,Morris; Karcher William,0,10,0,0
1683301374635,ECE 101,A01,185628,Staff,17,0,70,53
1683301375662,ECE 107,A01,185635,Baghdadchi; Saharnaz,0,0,20,20
1683301375662,ECE 107,A02,185638,Baghdadchi; Saharnaz,4,0,20,16
1683301376689,ECE 148,A01,185647,Silberman; Jack,1,0,16,15
1683301377717,ECON 1,A01,185537,Crane; Meredith Helen,54,0,70,16
1683301378743,ECON 3,A01,185549,Crane; Meredith Helen,33,0,70,37
1683301379772,ECON 4,A01,203354,Anderson; John Charles,0,4,10,10
1683301380798,ECON 100A,A01,185574,Staff,0,4,40,40
1683301381828,ECON 100B,A01,185576,Staff,0,22,40,40
1683301382853,ECON 100C,A01,185589,Newhouse; Herbert S,30,0,70,40
1683301383881,ECON 105,A00,185608,Vespa; Emanuel Ignacio,19,0,35,16
1683301384908,ECON 109,A01,185610,Shishkin; Denis,10,0,35,25
1683301385932,ECON 110A,A01,185612,Staff,11,0,40,29
1683301386955,ECON 120A,A01,185615,Staff,20,0,40,20
1683301387980,ECON 120C,A01,185617,Sun; Yixiao,0,20,70,70
1683301389009,ECON 144,A00,203346,Squires; Dale E,3,0,35,32
1683301390033,ECON 171,A01,203349,Newhouse; Herbert S,0,1,35,35
1683301391058,ECON 173A,A01,185621,Toda; Alexis Akira,21,0,35,14
1683301392088,EDS 25,A01,202413,Staff,0,1,0,0
1683301392088,EDS 25,A02,202414,Staff,0,1,0,0
1683301392088,EDS 25,A03,202415,Staff,0,0,0,0
1683301392088,EDS 25,A04,202416,Staff,0,1,0,0
1683301392088,EDS 25,A05,202439,Staff,0,0,0,0
1683301392088,EDS 25,A06,202440,Staff,0,0,0,0
1683301392088,EDS 25,B01,202631,Staff,0,0,0,0
1683301392088,EDS 25,B02,202632,Staff,0,0,0,0
1683301392088,EDS 25,B03,202639,Staff,0,0,0,0
1683301392088,EDS 25,B04,202640,Staff,0,0,0,0
1683301392088,EDS 25,B05,202643,Staff,0,0,0,0
1683301392088,EDS 25,B06,202644,Staff,0,0,0,0
1683301393116,EDS 38,A01,202659,Black; Alison Michelle,24,0,25,1
1683301394143,EDS 115,A00,202652,Staff,17,0,30,13
1683301395171,EDS 125,A00,202649,Staff,14,0,30,16
1683301396195,EDS 126,A01,203332,Staff,30,0,30,0
1683301397224,EDS 139,A00,202838,Staff,17,0,25,8
1683301398248,EDS 146,A01,202655,Staff,15,0,25,10
1683301399273,ENG 15,A00,185667,Staff,0,1,0,0
1683301399273,ENG 15,B00,185672,Staff,0,0,0,0
1683301399273,ENG 15,C00,185675,Staff,0,0,0,0
1683301399273,ENG 15,D00,185682,Staff,0,0,0,0
1683301399273,ENG 15,E00,185684,Staff,0,0,0,0
1683301400298,ETHN 103,A00,185710,Staff,0,3,35,35
1683301401323,ETHN 103A,A00,199228,Man; Simeon S,2,0,9,7
1683301402350,ETHN 109,A00,185711,Staff,18,0,35,17
1683301403378,ETHN 142,A00,185726,Staff,0,4,30,30
1683301404401,ETHN 163J,A00,199229,Man; Simeon S,6,0,8,2
1683301405426,ETHN 168,A00,185727,Staff,8,0,10,2
1683301406450,ETHN 182,A00,185728,Staff,1,0,35,34
1683301407474,ETHN 183,A00,185737,Staff,8,0,18,10
1683301408499,GLBH 111,A01,209361,Burgos; Jose L.,0,0,0,0
1683301410548,HIEU 104,A00,185792,Staff,16,0,20,4
1683301411572,HIEU 115,A00,185800,Staff,1,0,20,19
1683301412596,HIEU 128,A00,185801,Staff,0,7,20,20
1683301413621,HIEU 147,A00,185802,Staff,16,0,20,4
1683301414648,HIEU 154,A00,185823,Staff,12,0,20,8
1683301415675,HILA 102,A00,185826,Staff,13,0,20,7
1683301416702,HILD 2C,A01,185778,Staff,0,12,20,20
1683301417731,HILD 7B,A01,185780,Kwak; Nancy,0,15,32,32
1683301417731,HILD 7B,A02,185781,Kwak; Nancy,0,18,32,32
1683301418755,HILD 30,A01,185791,Staff,14,0,20,6
1683301419780,HISC 119,A00,185830,Golan; Tal,0,9,20,20
1683301420806,HITO 156GS,A00,185831,Patterson; Patrick H.,0,0,0,23
1683301421830,HIUS 103,A00,185832,Man; Simeon S,0,7,20,20
1683301422855,HIUS 117,A00,185836,Kwak; Nancy,2,0,20,18
1683301423880,HIUS 125,A00,185840,Man; Simeon S,0,0,23,23
1683301424904,HIUS 149,A00,185845,Staff,0,0,20,20
1683301425931,HUM 3,A01,185882,Zavodny; Tatiana Sophia,0,6,50,50
1683301425931,HUM 3,B01,185899,Caldwell; Michael Alan,0,19,50,50
1683301426957,HUM 3GS,A00,185900,Patterson; Patrick H.,0,0,0,23
1683301427983,HUM 4,A01,185938,Zroka; Amy Liane,31,0,50,19
1683301427983,HUM 4,B01,185956,Watkins; Eric,0,2,50,50
1683301427983,HUM 4,B02,202209,Watkins; Eric,0,1,50,50
1683301427983,HUM 4,B03,202210,Watkins; Eric,0,0,50,50
1683301429007,HUM 5,A01,185958,West; Geoffrey Scott,5,0,50,45
1683301429007,HUM 5,A02,202215,West; Geoffrey Scott,0,0,50,50
1683301430030,INTL 190,A00,185959,Gagnon; Jeffrey C,0,0,0,9
1683301430030,INTL 190,B00,185960,Lettieri; Michael Joseph,0,0,0,1
1683301431057,JAPN 180,A00,254509,Staff,0,1,25,25
1683301432085,LATI 10,A01,202853,Kennemore; Amy Michelle,5,0,35,30
1683301432085,LATI 10,A02,202854,Kennemore; Amy Michelle,1,0,35,34
1683301432085,LATI 10,A03,270054,Kennemore; Amy Michelle,30,0,30,0
1683301433110,LATI 180,A00,202855,Kennemore; Amy Michelle,11,0,20,9
1683301434136,LAWS 101,A00,201767,Golan; Tal,0,7,40,40
1683301435161,LIFR 1C,A00,185961,Staff,6,0,20,14
1683301436240,LIFR 1CX,A00,185962,Staff,7,0,20,13
1683301437263,LIFR 1D,A00,185963,Staff,9,0,20,11
1683301438286,LIFR 1DX,A00,185964,Staff,9,0,20,11
1683301439310,LIGN 101,A01,186039,Staff,43,0,50,7
1683301440337,LIGN 165,A00,186040,Staff,18,0,50,32
1683301441363,LTCS 108,A00,186041,Staff,6,0,10,4
1683301442388,LTCS 119,A00,186042,Staff,16,0,20,4
1683301443416,LTCS 130,A00,186043,Wesling; Megan E.,15,0,25,10
1683301445466,LTEA 138,A00,186119,Staff,14,0,40,26
1683301446493,LTEN 124,A00,186148,Staff,6,0,25,19
1683301447517,LTEN 178,A00,186149,Staff,7,0,15,8
1683301448542,LTEN 181,A00,186150,Blanco; John D,33,0,40,7
1683301449572,LTWL 120,A00,186160,Staff,20,0,25,5
1683301450599,LTWL 165,A00,186161,Staff,22,0,25,3
1683301451626,LTWR 100,A00,186162,Staff,0,4,15,15
1683301452650,LTWR 102,A00,186163,Doller; Ben,5,0,15,10
1683301453678,MAE 8,A01,186412,Staff,0,0,0,0
1683301454706,MAE 30B,A00,186445,Bahadori; Mohammad Yousef,83,0,100,17
1683301455733,MAE 40,A00,186592,Bewley; Thomas R,9,0,50,41
1683301456760,MAE 101B,A00,186593,Bahadori; Mohammad Yousef,81,0,100,19
1683301457789,MAE 105,A00,186594,Bandaru; Prabhakar,12,0,50,38
1683301458816,MAE 107,A00,186599,Pham; Hieu Tan,0,6,120,120
1683301459840,MAE 148,A01,186660,Silberman; Jack,3,0,16,13
1683301460867,MATH 10A,A01,188095,Staff,0,7,35,35
1683301461893,MATH 10B,A01,188097,Bowers; Adam R.,0,11,30,30
1683301461893,MATH 10B,A02,188099,Bowers; Adam R.,0,9,30,30
1683301461893,MATH 10B,B01,188104,Bowers; Adam R.,0,11,30,30
1683301461893,MATH 10B,B02,188106,Bowers; Adam R.,0,11,30,30
1683301462919,MATH 10C,A01,188111,Staff,0,18,30,30
1683301462919,MATH 10C,A02,188127,Staff,0,17,30,30
1683301462919,MATH 10C,A03,188131,Staff,0,17,30,30
1683301462919,MATH 10C,B01,188218,Staff,21,0,30,9
1683301462919,MATH 10C,B02,188244,Staff,13,0,30,17
1683301462919,MATH 10C,B03,188277,Staff,16,0,30,14
1683301463944,MATH 18,A01,188344,Bach; Quang Tran,18,0,30,12
1683301463944,MATH 18,A02,188345,Bach; Quang Tran,11,0,30,19
1683301463944,MATH 18,B01,188353,Bach; Quang Tran,10,0,30,20
1683301463944,MATH 18,B02,188354,Bach; Quang Tran,20,0,30,10
1683301464971,MATH 20A,A01,188374,Staff,13,0,35,22
1683301465997,MATH 20B,A01,188382,Ohm; Ko Woon,6,0,30,24
1683301465997,MATH 20B,A02,188383,Ohm; Ko Woon,24,0,30,6
1683301465997,MATH 20B,B01,188385,Ohm; Ko Woon,7,0,30,23
1683301465997,MATH 20B,B02,188392,Ohm; Ko Woon,22,0,30,8
1683301467025,MATH 20C,A01,188394,Harel; Guershon,10,0,30,20
1683301467025,MATH 20C,A02,188395,Harel; Guershon,13,0,30,17
1683301467025,MATH 20C,B01,188404,Harel; Guershon,3,0,30,27
1683301467025,MATH 20C,B02,188405,Harel; Guershon,19,0,30,11
1683301468055,MATH 20D,A01,188414,Hammock; Frances H,0,1,30,30
1683301468055,MATH 20D,A02,188415,Hammock; Frances H,4,0,30,26
1683301468055,MATH 20D,B01,188447,Hammock; Frances H,2,0,30,28
1683301468055,MATH 20D,B02,188486,Hammock; Frances H,8,0,30,22
1683301469079,MATH 20E,A01,188649,Staff,22,0,30,8
1683301469079,MATH 20E,A02,188650,Staff,23,0,30,7
1683301469079,MATH 20E,A03,188673,Staff,0,0,30,30
1683301470106,MATH 102,A01,188675,Staff,0,35,35,35
1683301471131,MATH 103B,A01,188681,Staff,4,0,35,31
1683301471131,MATH 103B,B01,188692,Staff,7,0,35,28
1683301472156,MATH 109,A01,188695,Salehi Golsefidy; Alireza,25,0,35,10
1683301472156,MATH 109,A02,188696,Salehi Golsefidy; Alireza,27,0,35,8
1683301473184,MATH 120A,A01,188698,Eggers; John Dietrich,5,0,35,30
1683301474212,MATH 142B,A01,188736,Ioana; Adrian,0,2,30,30
1683301474212,MATH 142B,A02,188741,Ioana; Adrian,0,1,30,30
1683301474212,MATH 142B,A03,188743,Ioana; Adrian,0,3,30,30
1683301475240,MATH 168A,A01,188790,Staff,0,8,35,35
1683301476266,MATH 170A,A01,188803,Nie; Jiawang,0,2,35,35
1683301476266,MATH 170A,A02,188811,Nie; Jiawang,0,0,35,35
1683301476266,MATH 170A,A03,188814,Nie; Jiawang,1,0,35,34
1683301476266,MATH 170A,A04,188815,Nie; Jiawang,14,0,35,21
1683301477290,MATH 193B,A01,188817,Staff,0,0,35,35
1683301477290,MATH 193B,A02,188818,Staff,5,0,35,30
1683301478314,MGT 4,A01,202857,Anderson; John Charles,62,0,80,18
1683301479336,MGT 12,A00,202858,Lindenberger; Wade Douglas,43,0,90,47
1683301480362,MGT 18,A00,202859,Staff,74,0,90,16
1683301481387,MGT 18GS,A00,202860,McKay; Michael J,13,0,28,15
1683301482414,MGT 45,A00,202861,Pecore; Joseph P.,14,0,90,76
1683301483437,MGT 100,A00,202863,Yavorsky; Daniel Ryan,28,0,90,62
1683301484461,MGT 103,A00,202864,Ehrich; Kristine R,0,16,90,90
1683301485485,MGT 112,A00,202865,Ehrich; Kristine R,15,0,90,75
1683301486510,MGT 121A,A00,202868,Staff,0,19,0,0
1683301487534,MGT 131B,A00,202869,Anderson; John Charles,59,0,90,31
1683301488558,MGT 136,A00,202871,Lindenberger; Wade Douglas,84,0,90,6
1683301489580,MGT 164,A00,202873,Staff,0,69,90,90
1683301490604,MGT 164GS,A00,202874,McKay; Mary A,13,0,28,15
1683301491627,MGT 180,A00,202875,Staff,0,51,90,90
1683301492652,MMW 11R,A01,205019,Herbst; Matthew,3,0,30,27
1683301492652,MMW 11R,A02,205026,Herbst; Matthew,29,0,30,1
1683301493678,MMW 15,A01,193512,Chang; Edmond Yi-Teh,0,9,28,28
1683301493678,MMW 15,A02,193513,Chang; Edmond Yi-Teh,0,5,28,28
1683301493678,MMW 15,A03,193514,Chang; Edmond Yi-Teh,0,5,28,28
1683301493678,MMW 15,A04,193515,Chang; Edmond Yi-Teh,0,4,28,28
1683301493678,MMW 15,A05,193516,Chang; Edmond Yi-Teh,0,4,28,28
1683301493678,MMW 15,A06,193517,Chang; Edmond Yi-Teh,0,5,28,28
1683301493678,MMW 15,B01,193519,Chang; Edmond Yi-Teh,0,4,28,28
1683301493678,MMW 15,B02,193520,Chang; Edmond Yi-Teh,0,5,28,28
1683301493678,MMW 15,B03,193521,Chang; Edmond Yi-Teh,0,4,28,28
1683301493678,MMW 15,B04,193522,Chang; Edmond Yi-Teh,0,4,28,28
1683301493678,MMW 15,B05,193523,Chang; Edmond Yi-Teh,0,5,28,28
1683301493678,MMW 15,B06,193524,Chang; Edmond Yi-Teh,0,4,28,28
1683301494701,MMW 122,A01,193526,Rahimi; Babak,0,14,28,28
1683301494701,MMW 122,A02,193527,Rahimi; Babak,0,14,28,28
1683301494701,MMW 122,A03,193528,Rahimi; Babak,0,0,0,0
1683301494701,MMW 122,A04,193529,Rahimi; Babak,0,0,0,0
1683301495728,MUS 1A,A01,186663,Staff,0,20,35,35
1683301496751,MUS 4,A01,186715,Staff,0,12,35,35
1683301497775,MUS 5R,A01,186796,Dubnov; Shlomo,0,17,35,35
1683301498800,MUS 6,A01,186798,Staff,0,3,25,25
1683301499824,MUS 7,A01,186830,Staff,12,0,35,23
1683301500862,MUS 8,A01,186930,Staff,0,25,35,35
1683301501897,MUS 15,A01,186932,Staff,0,15,35,35
1683301501897,MUS 15,B01,186934,Staff,0,14,35,35
1683301502923,MUS 80,A00,186935,Staff,2,0,20,18
1683301502923,MUS 80,B00,186936,Staff,25,0,25,0
1683301503951,NANO 11,A00,204702,Lipomi; Darren John,0,0,0,0
1683301504975,NANO 15,A01,204709,Yang; Kesong,0,1,0,0
1683301506002,NANO 114,A00,202069,Jahed Motlagh; Zeinab,3,0,10,7
1683301507026,PHIL 1,A00,186955,Grush; Rick Scott,32,0,40,8
1683301508052,PHIL 10,A01,186973,Grush; Rick Scott,29,0,35,6
1683301508052,PHIL 10,A02,186974,Grush; Rick Scott,33,0,35,2
1683301509078,PHIL 13,A01,186976,Staff,7,0,35,28
1683301509078,PHIL 13,A02,186977,Staff,16,0,35,19
1683301510103,PHIL 14,A01,186979,Staff,31,0,35,4
1683301510103,PHIL 14,A02,186986,Staff,32,0,35,3
1683301511126,PHIL 28,A01,186988,Staff,16,0,30,14
1683301511126,PHIL 28,A02,186989,Staff,1,0,30,29
1683301511126,PHIL 28,A03,186990,Staff,9,0,30,21
1683301511126,PHIL 28,A04,186991,Staff,26,0,30,4
1683301512150,PHIL 120,A00,186997,Staff,23,0,40,17
1683301513176,PHIL 137,A00,187003,Staff,9,0,40,31
1683301514200,PHIL 150,A00,187015,Staff,47,0,70,23
1683301515224,PHIL 167,A00,187021,Lamey; Andy M.,35,0,40,5
1683301516248,PHIL 174,A01,202226,Staff,17,0,20,3
1683301516248,PHIL 174,A02,202235,Staff,20,0,20,0
1683301517272,PHIL 191A,A00,258918,Staff,0,0,1,1
1683301518298,PHYS 1A,A00,187028,Staff,26,0,60,34
1683301519326,PHYS 1AL,001,187036,Staff,2,0,30,28
1683301519326,PHYS 1AL,002,187049,Staff,18,0,30,12
1683301520350,PHYS 1B,A00,187058,Staff,23,0,60,37
1683301521375,PHYS 1BL,001,187064,Staff,0,0,30,30
1683301521375,PHYS 1BL,002,187070,Staff,6,0,30,24
1683301522399,PHYS 1C,A00,187082,Staff,32,0,120,88
1683301523426,PHYS 1CL,001,187088,Staff,0,9,30,30
1683301523426,PHYS 1CL,002,187089,Staff,0,2,30,30
1683301523426,PHYS 1CL,009,262693,Staff,12,0,30,18
1683301524453,PHYS 2B,A01,187097,Staff,54,0,115,61
1683301525477,PHYS 2C,A01,187099,Staff,67,0,115,48
1683301526507,PHYS 2CL,A01,187101,Staff,5,0,28,23
1683301526507,PHYS 2CL,A02,187102,Staff,15,0,28,13
1683301527531,PHYS 2D,A01,187123,Shotwell; Brian,95,0,115,20
1683301528560,PHYS 4B,A01,187133,Grinstein; Benjamin,35,0,50,15
1683301529584,POLI 10,A00,188819,Staff,0,3,50,50
1683301530608,POLI 11,A00,188827,Staff,43,0,50,7
1683301531635,POLI 13R,A00,188828,Staff,0,1,20,20
1683301532658,POLI 27,A01,188830,Elgin; Samuel Zincke,0,1,70,70
1683301533681,POLI 30,A00,188832,Desposato; Scott,33,0,50,17
1683301534708,POLI 102F,A00,188834,Staff,3,0,40,37
1683301535732,POLI 104A,A00,188852,Staff,14,0,30,16
1683301536755,POLI 104I,A00,188853,Staff,0,6,20,20
1683301537779,POLI 110B,A00,188854,Wiens; David,7,0,20,13
1683301538804,POLI 112A,A00,188855,Wiens; David,5,0,30,25
1683301539895,POLI 117R,A00,188856,Forman; Fonna,0,11,20,20
1683301540921,POLI 118,A00,188857,Ingham; Sean,8,0,20,12
1683301541946,POLI 120G,A00,188858,Staff,9,0,30,21
1683301542972,POLI 131CR,A00,188863,Hoston; Germaine,24,0,50,26
1683301543995,POLI 133,A00,188864,Nellis; Gareth Hb,44,0,50,6
1683301545018,POLI 134D,A00,188865,Desposato; Scott,27,0,30,3
1683301546041,POLI 142A,A00,188871,Gartzke; Erik,22,0,50,28
1683301547066,POLI 142K,A00,188874,Staff,38,0,50,12
1683301548092,POLI 143,A00,188940,Gartzke; Erik,16,0,30,14
1683301549115,POLI 153,A00,188943,Staff,3,0,20,17
1683301550139,POLI 160AA,A00,188944,Staff,13,0,40,27
1683301551163,POLI 170A,A00,188945,Staff,11,0,30,19
1683301553210,PSYC 1,A00,188952,Staff,38,0,90,52
1683301554234,PSYC 2,B00,188953,Staff,20,0,35,15
1683301555258,PSYC 6,A00,188970,Staff,47,0,60,13
1683301556282,PSYC 7,A00,188973,Staff,37,0,45,8
1683301557306,PSYC 60,A01,188980,Rickard; Timothy C.,43,0,60,17
1683301558332,PSYC 70,A01,189001,Steiner; Eric Tomas,24,0,45,21
1683301559356,PSYC 100,A00,189005,Lacefield; Katharine I,0,99,120,120
1683301560381,PSYC 102,A00,189008,Staff,10,0,30,20
1683301561410,PSYC 106,B00,189026,Gorman; Michael R.,37,0,60,23
1683301562435,PSYC 114,B01,189033,Winkielman; Piotr,0,32,30,30
1683301563459,PSYC 131,A00,189036,Anagnostaras; Stephan,0,43,60,60
1683301564483,PSYC 136,A00,189041,Lowe; Angela Beth,0,7,25,25
1683301565511,PSYC 137,A00,189057,Winkielman; Piotr,0,34,25,25
1683301566535,PSYC 144,A00,189107,Wixted; John T,0,7,50,50
1683301568586,PSYC 162,A00,189142,Staff,0,8,85,85
1683301569610,PSYC 172,A00,189144,Gorman; Michael R.,0,7,30,30
1683301571661,PSYC 179,A00,189146,Lacefield; Katharine I,0,84,120,120
1683301572685,PSYC 181,A00,189147,Anagnostaras; Stephan,0,44,90,90
1683301573710,PSYC 190R,A00,189148,Barner; David A.,0,22,80,80
1683301574737,PSYC 191,A00,189275,Rickard; Timothy C.,0,7,25,25
1683301575764,PSYC 193,A00,189276,Chapman; Eddie Nathaniel,0,1,0,4
1683301576793,PSYC 193L,A01,189281,Lowe; Angela Beth,12,0,20,8
1683301576793,PSYC 193L,B01,189285,Staff,28,0,35,7
1683301577822,RELI 149,A00,187137,Rahimi; Babak,7,0,40,33
1683301578847,SE 9,A01,187315,Staff,0,2,18,18
1683301579872,SE 101B,A00,187409,Staff,24,0,30,6
1683301580897,SE 110B,A00,187444,Staff,10,0,40,30
1683301581921,SE 130B,A00,187449,Staff,31,0,40,9
1683301582948,SE 150A,A00,187516,Staff,9,0,20,11
1683301583977,SE 154,A00,187528,Staff,30,0,50,20
1683301585006,SIO 3,A01,258171,Staff,35,0,40,5
1683301586033,SIO 10,A00,187144,Cook; Geoffrey W,0,3,75,75
1683301587063,SIO 45,A00,187152,Cook; Geoffrey W,1,0,100,99
1683301588091,SIO 109R,A00,194486,Staff,0,3,20,20
1683301590144,SIO 187,A01,187233,Kacev; David,12,0,40,28
1683301591170,SOCI 1,A01,258656,Thorpe; Charles Robert,28,0,30,2
1683301591170,SOCI 1,A02,258658,Thorpe; Charles Robert,30,0,30,0
1683301591170,SOCI 1,A03,258661,Thorpe; Charles Robert,25,0,25,0
1683301591170,SOCI 1,A04,258666,Thorpe; Charles Robert,22,0,25,3
1683301591170,SOCI 1,A05,258897,Thorpe; Charles Robert,23,0,25,2
1683301591170,SOCI 1,A06,258898,Thorpe; Charles Robert,25,0,25,0
1683301592194,SOCI 30,A01,258903,Pardo Guerra; Juan Pablo,16,0,30,14
1683301593221,SOCI 102,A00,258904,Staff,9,0,25,16
1683301594245,SOCI 106,A00,258905,Staff,19,0,25,6
1683301595273,SOCI 111,A00,258907,Ribas Norris; Janet Vanesa,26,0,30,4
1683301596302,SOCI 121R,A00,258908,Pardo Guerra; Juan Pablo,11,0,30,19
1683301597328,SOCI 126,A01,203330,Staff,14,0,20,6
1683301598356,SOCI 131,A00,258909,Thorpe; Charles Robert,31,0,60,29
1683301599380,SOCI 135,A00,258910,Payne; Christine Anna,0,9,30,30
1683301600405,SOCI 157,A00,258911,Staff,13,0,30,17
1683301601432,SOCI 184,A00,258912,Staff,26,0,30,4
1683301602456,SOCI 188D,A00,258913,Staff,21,0,30,9
1683301603480,SYN 2,001,187529,Staff,9,0,16,7
1683301603480,SYN 2,002,201452,Staff,0,18,16,16
1683301603480,SYN 2,003,201469,Staff,3,0,16,13
1683301604505,SYN 100,A01,187531,Staff,0,9,20,20
1683301604505,SYN 100,B01,201491,Staff,0,12,20,20
1683301605530,TDAC 1,A00,189286,Walsh; Kim C.,3,0,20,17
1683301605530,TDAC 1,B00,189287,Harting; Carla Kelso,11,0,20,9
1683301606555,TDAC 101,A00,189300,Walsh; Kim C.,16,0,20,4
1683301606555,TDAC 101,B00,189301,Harting; Carla Kelso,18,0,20,2
1683301607585,TDAC 102,A00,189304,Basso; Beatrice,14,0,20,6
1683301608613,TDAC 108,A00,189305,Staff,18,0,20,2
1683301609640,TDDE 131,A00,189310,Staff,19,0,20,1
1683301609640,TDDE 131,B00,189314,Staff,19,0,20,1
1683301609640,TDDE 131,C00,189315,Staff,48,0,50,2
1683301609640,TDDE 131,D00,189316,Staff,14,0,15,1
1683301609640,TDDE 131,E00,204841,Staff,20,0,20,0
1683301610664,TDGE 10,A00,189289,Staff,30,0,50,20
1683301610664,TDGE 10,B00,189290,Havis; Allan,2,0,50,48
1683301611693,TDGE 11,A00,189291,Fulton; Julia,0,3,50,50
1683301611693,TDGE 11,B00,189292,Staff,20,0,25,5
1683301611693,TDGE 11,C00,260270,Staff,0,0,0,0
1683301612720,TDGE 25,A00,189294,Staff,3,0,20,17
1683301613747,TDGE 124,A00,189318,Fulton; Julia,0,8,50,50
1683301614774,TDGE 125,A00,189319,Staff,13,0,25,12
1683301614774,TDGE 125,B00,189320,Staff,23,0,25,2
1683301615801,TDGE 127,A00,189322,Havis; Allan,0,0,50,50
1683301616825,TDHT 101,A00,189323,Staff,18,0,25,7
1683301616825,TDHT 101,B00,189324,Staff,25,0,25,0
1683301617852,TDHT 102,A00,189325,Staff,49,0,50,1
1683301618876,TDMV 1,A00,189295,Arcidiacono; Kristin,20,0,30,10
1683301618876,TDMV 1,B00,189296,Caligagan; Maria T.,24,0,30,6
1683301619909,TDMV 2,A00,189297,Sammartano; Tonnie,28,0,30,2
1683301619909,TDMV 2,B00,189299,Arcidiacono; Kristin,24,0,30,6
1683301620934,TDMV 3,A00,204998,Rincon; Alicia,22,0,30,8
1683301621958,TDMV 120,A00,189458,Sammartano; Tonnie,28,0,30,2
1683301622983,TDMV 138,A00,189541,Jun; Grace Shin Hae,22,0,40,18
1683301624011,TDMV 142,A00,189717,Caligagan; Tony,23,0,30,7
1683301624011,TDMV 142,B00,189718,Caligagan; Maria T.,25,0,30,5
1683301625040,TMC 2,A01,187533,Staff,25,0,25,0
1683301625040,TMC 2,A02,187534,Staff,25,0,25,0
1683301626069,USP 1,A01,187536,Kwak; Nancy,0,16,25,25
1683301627093,USP 5,A01,187538,Staff,9,0,25,16
1683301628121,USP 101,A00,199253,Staff,0,4,0,0
1683301629148,USP 124,A00,187562,Boomhower; Matthew Charles,1,0,30,29
1683301630172,USP 138,A00,187582,Staff,20,0,25,5
1683301631200,USP 152,A01,187597,Staff,4,0,25,21
1683301632224,USP 153,A00,187598,Staff,19,0,25,6
1683301633247,USP 168,A00,187607,Kwak; Nancy,2,0,5,3
1683301634272,USP 173,A00,187619,Staff,4,0,25,21
1683301635296,USP 181,A00,187638,Staff,0,0,25,25
1683301636329,VIS 103,A00,187650,Cruz; Edwin Teddy,23,0,75,52
1683301637354,VIS 110D,A00,187669,Staff,12,0,22,10
1683301638379,VIS 127C,A00,187720,Shen; Kuiyi,68,0,146,78
1683301639403,VIS 149,A00,187731,Yoldas; Pinar,0,14,22,22
1683301640431,VIS 151,A01,188091,Staff,22,0,34,12
1683301640431,VIS 151,A02,188092,Staff,11,0,34,23
1683301641458,VIS 160B,A00,188093,Stalbaum; Brett,0,0,10,10
1683301643564,WCWP 10B,A00,201720,Staff,10,0,15,5
1683301643564,WCWP 10B,B00,201722,Staff,8,0,15,7
1683301644591,WCWP 100,A00,201725,Gagnon; Jeffrey C,0,0,2,2
1683301644591,WCWP 100,B00,201727,Staff,0,4,15,15
1683301647687,ANBI 133,A00,258401,Wilder; Linnea Lorene,34,0,40,6
1683301648714,ANBI 140,A00,258395,Hrvoj Mihic; Branka,18,0,25,7
1683301649742,ANSC 120,A00,258402,Bialecki; Jon Anthony,27,0,40,13
1683301650766,ANSC 144,A00,258400,Staff,14,0,40,26
1683301652814,ANSC 166,A00,258396,Parish; Steven Martin,157,0,175,18
1683301653839,ANSC 180,A00,193533,Staff,9,0,20,11
1683301654862,ANSC 188,A00,258397,Jassal; Aftab,33,0,40,7
1683301655892,ANTH 3,A01,258316,Staff,23,0,30,7
1683301656920,ANTH 5,A00,258394,Semendeferi; Ekaterini,16,0,20,4
1683301657944,ANTH 21,A01,258331,Staff,9,0,40,31
1683301658968,ANTH 103,A00,258398,Varma; Saiba,15,0,25,10
1683301659996,AWP 10,001,202034,Staff,0,0,0,0
1683301659996,AWP 10,002,202035,Staff,0,0,0,0
1683301659996,AWP 10,003,202036,Staff,0,0,0,0
1683301659996,AWP 10,004,202037,Staff,0,0,0,0
1683301659996,AWP 10,005,202038,Staff,0,0,0,0
1683301659996,AWP 10,006,202039,Staff,0,0,0,0
1683301659996,AWP 10,007,202040,Staff,0,0,0,0
1683301659996,AWP 10,008,202041,Staff,0,0,0,0
1683301659996,AWP 10,009,202042,Staff,0,0,0,0
1683301659996,AWP 10,010,202043,Staff,0,0,0,0
1683301659996,AWP 10,011,202044,Staff,0,0,0,0
1683301659996,AWP 10,012,202045,Staff,0,0,0,0
1683301659996,AWP 10,013,202046,Staff,0,0,0,0
1683301659996,AWP 10,014,202047,Staff,0,0,0,0
1683301659996,AWP 10,015,202048,Staff,0,0,0,0
1683301659996,AWP 10,016,202049,Staff,0,0,0,0
1683301659996,AWP 10,017,202050,Staff,0,0,0,0
1683301659996,AWP 10,018,202051,Staff,0,0,0,0
1683301659996,AWP 10,019,202052,Staff,0,0,0,0
1683301659996,AWP 10,020,202053,Staff,0,0,0,0
1683301659996,AWP 10,021,202054,Staff,0,0,0,0
1683301659996,AWP 10,022,202055,Staff,0,0,0,0
1683301659996,AWP 10,023,202056,Staff,0,0,0,0
1683301659996,AWP 10,024,202057,Staff,0,0,0,0
1683301659996,AWP 10,025,202058,Staff,0,0,0,0
1683301659996,AWP 10,026,202059,Staff,0,0,0,0
1683301661023,AWP 102,001,202032,Staff,0,0,0,0
1683301661023,AWP 102,002,202033,Staff,0,0,0,0
1683301662051,BENG 100,A01,254234,Taylor Amos; Alyssa C,31,0,40,9
1683301663076,BENG 196,001,270013,Engler; Adam J.,9999,0,9999,0
1683301664105,BICD 100R,A01,202018,Smith; Laurie,0,7,32,32
1683301664105,BICD 100R,A02,202019,Smith; Laurie,0,2,32,32
1683301664105,BICD 100R,A03,202020,Smith; Laurie,0,1,32,32
1683301664105,BICD 100R,A04,202021,Smith; Laurie,8,0,32,24
1683301664105,BICD 100R,A05,202022,Smith; Laurie,12,0,32,20
1683301665132,BICD 136,A01,193242,Gustafson-Brown; Cindy,0,2,32,32
1683301665132,BICD 136,A02,193244,Gustafson-Brown; Cindy,15,0,32,17
1683301666157,BIEB 102,A01,193249,Butler; Shannon Rhey,0,2,32,32
1683301666157,BIEB 102,A02,193251,Butler; Shannon Rhey,0,0,32,32
1683301666157,BIEB 102,A03,193253,Butler; Shannon Rhey,0,1,32,32
1683301666157,BIEB 102,A04,193255,Butler; Shannon Rhey,17,0,32,15
1683301666157,BIEB 102,A05,193265,Butler; Shannon Rhey,26,0,32,6
1683301666157,BIEB 102,A06,193269,Butler; Shannon Rhey,16,0,32,16
1683301668205,BIEB 150,A01,193274,Staff,0,0,32,32
1683301668205,BIEB 150,A02,193285,Staff,24,0,32,8
1683301669227,BIEB 194,A00,193286,Kurle; Carolyn M.,22,0,32,10
1683301670252,BILD 1,A01,192291,Staff,16,0,32,16
1683301670252,BILD 1,A02,192292,Staff,30,0,32,2
1683301670252,BILD 1,B01,192520,Reuther; Keefe,0,1,0,0
1683301670252,BILD 1,B02,192532,Reuther; Keefe,0,1,0,0
1683301671278,BILD 3,A01,192556,Butler; Shannon Rhey,0,0,32,32
1683301671278,BILD 3,A02,192581,Butler; Shannon Rhey,5,0,32,27
1683301671278,BILD 3,A03,192611,Butler; Shannon Rhey,23,0,32,9
1683301671278,BILD 3,A04,192612,Butler; Shannon Rhey,25,0,32,7
1683301671278,BILD 3,A05,192613,Butler; Shannon Rhey,27,0,32,5
1683301671278,BILD 3,A06,192679,Butler; Shannon Rhey,27,0,32,5
1683301671278,BILD 3,A07,192682,Butler; Shannon Rhey,22,0,32,10
1683301672305,BILD 4,A01,192836,Reuther; Keefe,1,0,24,23
1683301672305,BILD 4,A02,193044,Reuther; Keefe,4,0,24,20
1683301673333,BILD 10,A01,193142,Gustafson-Brown; Cindy,31,0,32,1
1683301673333,BILD 10,A02,193149,Gustafson-Brown; Cindy,31,0,32,1
1683301674362,BIMM 100,A01,193301,Staff,0,6,32,32
1683301674362,BIMM 100,A02,193312,Staff,0,5,32,32
1683301674362,BIMM 100,A03,193323,Staff,0,8,32,32
1683301675387,BIMM 101,A01,193329,McDonnell; Lisa Marie,0,3,24,24
1683301675387,BIMM 101,A02,193339,McDonnell; Lisa Marie,0,2,24,24
1683301675387,BIMM 101,B01,193354,McDonnell; Lisa Marie,0,3,24,24
1683301675387,BIMM 101,B02,193357,McDonnell; Lisa Marie,0,3,24,24
1683301676412,BIMM 110,A01,193377,Tat; John,0,11,32,32
1683301676412,BIMM 110,A02,193378,Tat; John,1,9,32,31
1683301677440,BIMM 120,A01,206116,Staff,0,0,32,32
1683301677440,BIMM 120,A02,206117,Staff,8,0,32,24
1683301677440,BIMM 120,A03,206121,Staff,21,0,32,11
1683301678464,BIPN 100,A01,193393,Park; Ji Young,0,14,32,32
1683301678464,BIPN 100,A02,193402,Park; Ji Young,0,12,32,32
1683301678464,BIPN 100,A03,193413,Park; Ji Young,0,14,32,32
1683301678464,BIPN 100,A04,193414,Park; Ji Young,0,13,32,32
1683301679491,BIPN 102,A01,193429,Staff,0,0,32,32
1683301679491,BIPN 102,A02,193438,Staff,23,0,32,9
1683301680517,BIPN 106,A01,193450,Reyes Gonzalez; Catalina,0,2,40,40
1683301681548,BIPN 134,A01,193465,Cooke; James Edward,0,0,32,32
1683301681548,BIPN 134,A02,193474,Cooke; James Edward,27,0,32,5
1683301681548,BIPN 134,A03,193485,Cooke; James Edward,29,0,32,3
1683301681548,BIPN 134,A04,193486,Cooke; James Edward,21,0,32,11
1683301681548,BIPN 134,A05,193491,Cooke; James Edward,31,0,32,1
1683301681548,BIPN 134,A06,193501,Cooke; James Edward,30,0,32,2
1683301681548,BIPN 134,A07,193510,Cooke; James Edward,29,0,32,3
1683301683599,BISP 194,A00,222522,Staff,16,0,32,16
1683301684626,CAT 124,A01,202407,Staff,20,0,25,5
1683301685651,CAT 125,A00,202408,Marchisotto; Jennifer Anne,4,0,20,16
1683301686681,CAT 125R,A00,202409,Smith; Lauryn Alissa,0,11,20,20
1683301686681,CAT 125R,B00,202410,Morales; Celeste Georgianna,0,11,20,20
1683301686681,CAT 125R,C00,202411,Irwin; Matthew Joseph,0,10,20,20
1683301687706,CENG 15,A01,204712,Yang; Kesong,0,1,0,0
1683301688731,CENG 114,A00,202070,Jahed Motlagh; Zeinab,5,0,20,15
1683301689756,CGS 105,A00,185477,Wesling; Megan E.,24,0,40,16
1683301690784,CGS 106,A00,185494,Staff,13,0,22,9
1683301691810,CGS 108,A00,185495,Staff,14,0,20,6
1683301692834,CGS 114,A00,185496,Staff,13,0,18,5
1683301693859,CGS 119,A00,185501,Staff,15,0,20,5
1683301694886,CGS 120,A00,185511,Staff,13,0,20,7
1683301695915,CHEM 4,A01,184675,Bussey; Thomas J,96,0,100,4
1683301696941,CHEM 6A,A01,184677,Staff,35,0,60,25
1683301697969,CHEM 6B,A01,184679,Staff,65,0,100,35
1683301698994,CHEM 6C,A01,184681,Bussey; Thomas J,1,0,50,49
1683301698994,CHEM 6C,A02,184682,Bussey; Thomas J,34,0,50,16
1683301700019,CHEM 40A,A01,184684,Albizati; Kim F.,37,0,100,63
1683301701043,CHEM 40B,A01,184686,Albizati; Kim F.,0,20,100,100
1683301702068,CHEM 41B,A01,184690,Staff,52,0,100,48
1683301703092,COGS 3,A01,184715,Boyle; Mary E. T.,0,25,40,40
1683301704117,COGS 14B,A01,185172,Staff,0,15,38,38
1683301705145,COGS 18,A01,184736,Staff,20,0,80,60
1683301706173,COGS 100,A01,184932,Staff,0,5,73,73
1683301707201,COGS 101A,A01,184935,Staff,0,38,30,30
1683301708228,COGS 101B,A01,184944,Staff,0,2,30,30
1683301709253,COGS 101C,A01,184946,Staff,0,12,30,30
1683301710278,COGS 102A,A01,184951,Johnson; Christine M.,2,0,40,38
1683301711312,COGS 107B,A01,184953,Mooshagian; Eric Frederick,0,50,40,40
1683301712340,COGS 118B,A01,184959,Gupta; Anjum,0,48,40,40
1683301713365,COGS 153,A00,184961,Staff,0,15,30,30
1683301714389,COGS 177,A00,184962,Staff,0,21,30,30
1683301715416,COGS 187A,A01,184969,Boyle; Mary E. T.,0,17,40,40
1683301716444,COMM 10,A01,185174,Staff,0,5,25,25
1683301716444,COMM 10,A02,185189,Staff,0,5,25,25
1683301716444,COMM 10,A03,269821,Staff,0,0,0,0
1683301717469,COMM 100B,A01,185475,Staff,0,0,0,2
1683301717469,COMM 100B,A02,185476,Staff,14,0,25,11
1683301718493,COMM 100C,A01,185314,Staff,1,0,25,24
1683301718493,COMM 100C,A02,185327,Staff,19,0,25,6
1683301719520,COMM 110M,A00,185349,Staff,2,0,40,38
1683301720547,COMM 113T,A00,185352,Staff,25,0,40,15
1683301721573,COMM 114I,A00,185353,Staff,33,0,40,7
1683301722597,COMM 131,A00,185354,Staff,19,0,30,11
1683301723622,CSE 8A,A50,185358,Cao; Yingjun,0,46,10,10
1683301724650,CSE 8B,A01,185362,Staff,1,47,50,49
1683301725678,CSE 11,A01,185416,Cao; Yingjun,0,93,10,10
1683301726702,CSE 20,A01,185445,Briones; Jor-el Thomas Caparas,5,0,25,20
1683301727724,CSE 21,A01,185447,Staff,10,0,50,40
1683301728749,CSE 101,A01,185451,Staff,0,12,50,50
1683301728749,CSE 101,B01,185453,Jones; Miles E,0,11,50,50
1683301730802,CSE 141,A01,185458,Eldon; John,20,0,100,80
1683301731830,CSE 141L,A01,185461,Eldon; John,12,0,100,88
1683301732856,CSE 142,A01,185463,Staff,35,0,60,25
1683301732856,CSE 142,B01,201355,Staff,0,6,60,60
1683301733883,CSE 142L,A01,185470,Staff,35,0,60,25
1683301733883,CSE 142L,B01,201417,Staff,0,5,60,60
1683301734908,CSE 190,A00,201433,Staff,32,0,49,17
1683301735935,DOC 1,A01,259136,Strom; Megan C.,8,0,15,7
1683301735935,DOC 1,A02,259137,Strom; Megan C.,14,0,15,1
1683301735935,DOC 1,A03,259138,Strom; Megan C.,14,0,15,1
1683301735935,DOC 1,A04,259139,Strom; Megan C.,14,0,15,1
1683301736961,DOC 100D,A00,259140,Pass; Natalye Joann,17,0,25,8
1683301737988,DSGN 1,A01,184749,Rill; Bryan,0,24,30,30
1683301739012,DSGN 100,A01,185168,Staff,0,2,25,25
1683301740038,ECE 5,A01,185626,Morris; Karcher William,0,10,0,0
1683301741062,ECE 101,A01,185628,Staff,17,0,70,53
1683301742087,ECE 107,A01,185635,Baghdadchi; Saharnaz,0,0,20,20
1683301742087,ECE 107,A02,185638,Baghdadchi; Saharnaz,4,0,20,16
1683301743114,ECE 148,A01,185647,Silberman; Jack,1,0,16,15
1683301744138,ECON 1,A01,185537,Crane; Meredith Helen,54,0,70,16
1683301745166,ECON 3,A01,185549,Crane; Meredith Helen,33,0,70,37
1683301746194,ECON 4,A01,203354,Anderson; John Charles,0,4,10,10
1683301747278,ECON 100A,A01,185574,Staff,0,4,40,40
1683301748303,ECON 100B,A01,185576,Staff,0,22,40,40
1683301749328,ECON 100C,A01,185589,Newhouse; Herbert S,30,0,70,40
1683301750354,ECON 105,A00,185608,Vespa; Emanuel Ignacio,19,0,35,16
1683301751382,ECON 109,A01,185610,Shishkin; Denis,10,0,35,25
1683301752409,ECON 110A,A01,185612,Staff,11,0,40,29
1683301753437,ECON 120A,A01,185615,Staff,20,0,40,20
1683301754462,ECON 120C,A01,185617,Sun; Yixiao,0,20,70,70
1683301755489,ECON 144,A00,203346,Squires; Dale E,3,0,35,32
1683301756516,ECON 171,A01,203349,Newhouse; Herbert S,0,1,35,35
1683301757542,ECON 173A,A01,185621,Toda; Alexis Akira,21,0,35,14
1683301758568,EDS 25,A01,202413,Staff,0,1,0,0
1683301758568,EDS 25,A02,202414,Staff,0,1,0,0
1683301758568,EDS 25,A03,202415,Staff,0,0,0,0
1683301758568,EDS 25,A04,202416,Staff,0,1,0,0
1683301758568,EDS 25,A05,202439,Staff,0,0,0,0
1683301758568,EDS 25,A06,202440,Staff,0,0,0,0
1683301758568,EDS 25,B01,202631,Staff,0,0,0,0
1683301758568,EDS 25,B02,202632,Staff,0,0,0,0
1683301758568,EDS 25,B03,202639,Staff,0,0,0,0
1683301758568,EDS 25,B04,202640,Staff,0,0,0,0
1683301758568,EDS 25,B05,202643,Staff,0,0,0,0
1683301758568,EDS 25,B06,202644,Staff,0,0,0,0
1683301759593,EDS 38,A01,202659,Black; Alison Michelle,24,0,25,1
1683301760620,EDS 115,A00,202652,Staff,17,0,30,13
1683301761643,EDS 125,A00,202649,Staff,14,0,30,16
1683301762669,EDS 126,A01,203332,Staff,30,0,30,0
1683301763695,EDS 139,A00,202838,Staff,17,0,25,8
1683301764722,EDS 146,A01,202655,Staff,15,0,25,10
1683301765751,ENG 15,A00,185667,Staff,0,1,0,0
1683301765751,ENG 15,B00,185672,Staff,0,0,0,0
1683301765751,ENG 15,C00,185675,Staff,0,0,0,0
1683301765751,ENG 15,D00,185682,Staff,0,0,0,0
1683301765751,ENG 15,E00,185684,Staff,0,0,0,0
1683301766774,ETHN 103,A00,185710,Staff,0,3,35,35
1683301767801,ETHN 103A,A00,199228,Man; Simeon S,2,0,9,7
1683301768829,ETHN 109,A00,185711,Staff,18,0,35,17
1683301769859,ETHN 142,A00,185726,Staff,0,4,30,30
1683301770884,ETHN 163J,A00,199229,Man; Simeon S,6,0,8,2
1683301771909,ETHN 168,A00,185727,Staff,8,0,10,2
1683301772937,ETHN 182,A00,185728,Staff,1,0,35,34
1683301773962,ETHN 183,A00,185737,Staff,8,0,18,10
1683301774991,GLBH 111,A01,209361,Burgos; Jose L.,0,0,0,0
1683301777042,HIEU 104,A00,185792,Staff,16,0,20,4
1683301778067,HIEU 115,A00,185800,Staff,1,0,20,19
1683301779093,HIEU 128,A00,185801,Staff,0,7,20,20
1683301780115,HIEU 147,A00,185802,Staff,16,0,20,4
1683301781139,HIEU 154,A00,185823,Staff,12,0,20,8
1683301782167,HILA 102,A00,185826,Staff,13,0,20,7
1683301783192,HILD 2C,A01,185778,Staff,0,12,20,20
1683301784217,HILD 7B,A01,185780,Kwak; Nancy,0,15,32,32
1683301784217,HILD 7B,A02,185781,Kwak; Nancy,0,18,32,32
1683301785245,HILD 30,A01,185791,Staff,14,0,20,6
1683301786268,HISC 119,A00,185830,Golan; Tal,0,9,20,20
1683301787295,HITO 156GS,A00,185831,Patterson; Patrick H.,0,0,0,23
1683301788322,HIUS 103,A00,185832,Man; Simeon S,0,6,20,20
1683301789350,HIUS 117,A00,185836,Kwak; Nancy,2,0,20,18
1683301790375,HIUS 125,A00,185840,Man; Simeon S,0,0,23,23
1683301791399,HIUS 149,A00,185845,Staff,0,0,20,20
1683301792426,HUM 3,A01,185882,Zavodny; Tatiana Sophia,0,6,50,50
1683301792426,HUM 3,B01,185899,Caldwell; Michael Alan,0,19,50,50
1683301793454,HUM 3GS,A00,185900,Patterson; Patrick H.,0,0,0,23
1683301794483,HUM 4,A01,185938,Zroka; Amy Liane,31,0,50,19
1683301794483,HUM 4,B01,185956,Watkins; Eric,0,2,50,50
1683301794483,HUM 4,B02,202209,Watkins; Eric,0,1,50,50
1683301794483,HUM 4,B03,202210,Watkins; Eric,0,0,50,50
1683301795512,HUM 5,A01,185958,West; Geoffrey Scott,5,0,50,45
1683301795512,HUM 5,A02,202215,West; Geoffrey Scott,0,0,50,50
1683301796540,INTL 190,A00,185959,Gagnon; Jeffrey C,0,0,0,9
1683301796540,INTL 190,B00,185960,Lettieri; Michael Joseph,0,0,0,1
1683301797565,JAPN 180,A00,254509,Staff,0,1,25,25
1683301798594,LATI 10,A01,202853,Kennemore; Amy Michelle,5,0,35,30
1683301798594,LATI 10,A02,202854,Kennemore; Amy Michelle,1,0,35,34
1683301798594,LATI 10,A03,270054,Kennemore; Amy Michelle,30,0,30,0
1683301799618,LATI 180,A00,202855,Kennemore; Amy Michelle,11,0,20,9
1683301800643,LAWS 101,A00,201767,Golan; Tal,0,7,40,40
1683301801667,LIFR 1C,A00,185961,Staff,6,0,20,14
1683301802694,LIFR 1CX,A00,185962,Staff,7,0,20,13
1683301803718,LIFR 1D,A00,185963,Staff,9,0,20,11
1683301804743,LIFR 1DX,A00,185964,Staff,9,0,20,11
1683301805770,LIGN 101,A01,186039,Staff,43,0,50,7
1683301806796,LIGN 165,A00,186040,Staff,18,0,50,32
1683301807823,LTCS 108,A00,186041,Staff,6,0,10,4
1683301808848,LTCS 119,A00,186042,Staff,16,0,20,4
1683301809871,LTCS 130,A00,186043,Wesling; Megan E.,15,0,25,10
1683301811923,LTEA 138,A00,186119,Staff,14,0,40,26
1683301812947,LTEN 124,A00,186148,Staff,6,0,25,19
1683301813969,LTEN 178,A00,186149,Staff,7,0,15,8
1683301814993,LTEN 181,A00,186150,Blanco; John D,33,0,40,7
1683301816018,LTWL 120,A00,186160,Staff,20,0,25,5
1683301817042,LTWL 165,A00,186161,Staff,22,0,25,3
1683301818071,LTWR 100,A00,186162,Staff,0,4,15,15
1683301819095,LTWR 102,A00,186163,Doller; Ben,5,0,15,10
1683301820119,MAE 8,A01,186412,Staff,0,0,0,0
1683301821143,MAE 30B,A00,186445,Bahadori; Mohammad Yousef,83,0,100,17
1683301822171,MAE 40,A00,186592,Bewley; Thomas R,9,0,50,41
1683301823194,MAE 101B,A00,186593,Bahadori; Mohammad Yousef,81,0,100,19
1683301824218,MAE 105,A00,186594,Bandaru; Prabhakar,12,0,50,38
1683301825242,MAE 107,A00,186599,Pham; Hieu Tan,0,6,120,120
1683301826269,MAE 148,A01,186660,Silberman; Jack,3,0,16,13
1683301827298,MATH 10A,A01,188095,Staff,0,7,35,35
1683301828323,MATH 10B,A01,188097,Bowers; Adam R.,0,11,30,30
1683301828323,MATH 10B,A02,188099,Bowers; Adam R.,0,9,30,30
1683301828323,MATH 10B,B01,188104,Bowers; Adam R.,0,11,30,30
1683301828323,MATH 10B,B02,188106,Bowers; Adam R.,0,11,30,30
1683301829352,MATH 10C,A01,188111,Staff,0,18,30,30
1683301829352,MATH 10C,A02,188127,Staff,0,17,30,30
1683301829352,MATH 10C,A03,188131,Staff,0,17,30,30
1683301829352,MATH 10C,B01,188218,Staff,21,0,30,9
1683301829352,MATH 10C,B02,188244,Staff,13,0,30,17
1683301829352,MATH 10C,B03,188277,Staff,16,0,30,14
1683301830377,MATH 18,A01,188344,Bach; Quang Tran,18,0,30,12
1683301830377,MATH 18,A02,188345,Bach; Quang Tran,11,0,30,19
1683301830377,MATH 18,B01,188353,Bach; Quang Tran,10,0,30,20
1683301830377,MATH 18,B02,188354,Bach; Quang Tran,20,0,30,10
1683301831402,MATH 20A,A01,188374,Staff,13,0,35,22
1683301832429,MATH 20B,A01,188382,Ohm; Ko Woon,6,0,30,24
1683301832429,MATH 20B,A02,188383,Ohm; Ko Woon,24,0,30,6
1683301832429,MATH 20B,B01,188385,Ohm; Ko Woon,7,0,30,23
1683301832429,MATH 20B,B02,188392,Ohm; Ko Woon,22,0,30,8
1683301833456,MATH 20C,A01,188394,Harel; Guershon,10,0,30,20
1683301833456,MATH 20C,A02,188395,Harel; Guershon,13,0,30,17
1683301833456,MATH 20C,B01,188404,Harel; Guershon,3,0,30,27
1683301833456,MATH 20C,B02,188405,Harel; Guershon,19,0,30,11
1683301834485,MATH 20D,A01,188414,Hammock; Frances H,0,1,30,30
1683301834485,MATH 20D,A02,188415,Hammock; Frances H,4,0,30,26
1683301834485,MATH 20D,B01,188447,Hammock; Frances H,2,0,30,28
1683301834485,MATH 20D,B02,188486,Hammock; Frances H,8,0,30,22
1683301835509,MATH 20E,A01,188649,Staff,22,0,30,8
1683301835509,MATH 20E,A02,188650,Staff,23,0,30,7
1683301835509,MATH 20E,A03,188673,Staff,0,0,30,30
1683301836533,MATH 102,A01,188675,Staff,0,35,35,35
1683301837557,MATH 103B,A01,188681,Staff,4,0,35,31
1683301837557,MATH 103B,B01,188692,Staff,7,0,35,28
1683301838582,MATH 109,A01,188695,Salehi Golsefidy; Alireza,25,0,35,10
1683301838582,MATH 109,A02,188696,Salehi Golsefidy; Alireza,27,0,35,8
1683301839611,MATH 120A,A01,188698,Eggers; John Dietrich,5,0,35,30
1683301840640,MATH 142B,A01,188736,Ioana; Adrian,0,2,30,30
1683301840640,MATH 142B,A02,188741,Ioana; Adrian,0,1,30,30
1683301840640,MATH 142B,A03,188743,Ioana; Adrian,0,3,30,30
1683301841668,MATH 168A,A01,188790,Staff,0,8,35,35
1683301842693,MATH 170A,A01,188803,Nie; Jiawang,0,2,35,35
1683301842693,MATH 170A,A02,188811,Nie; Jiawang,0,0,35,35
1683301842693,MATH 170A,A03,188814,Nie; Jiawang,1,0,35,34
1683301842693,MATH 170A,A04,188815,Nie; Jiawang,14,0,35,21
1683301843720,MATH 193B,A01,188817,Staff,0,0,35,35
1683301843720,MATH 193B,A02,188818,Staff,5,0,35,30
1683301844744,MGT 4,A01,202857,Anderson; John Charles,62,0,80,18
1683301845768,MGT 12,A00,202858,Lindenberger; Wade Douglas,43,0,90,47
1683301846792,MGT 18,A00,202859,Staff,74,0,90,16
1683301847818,MGT 18GS,A00,202860,McKay; Michael J,13,0,28,15
1683301848842,MGT 45,A00,202861,Pecore; Joseph P.,14,0,90,76
1683301849867,MGT 100,A00,202863,Yavorsky; Daniel Ryan,28,0,90,62
1683301850972,MGT 103,A00,202864,Ehrich; Kristine R,0,16,90,90
1683301851996,MGT 112,A00,202865,Ehrich; Kristine R,15,0,90,75
1683301853020,MGT 121A,A00,202868,Staff,0,19,0,0
1683301854048,MGT 131B,A00,202869,Anderson; John Charles,59,0,90,31
1683301855072,MGT 136,A00,202871,Lindenberger; Wade Douglas,84,0,90,6
1683301856099,MGT 164,A00,202873,Staff,0,69,90,90
1683301857124,MGT 164GS,A00,202874,McKay; Mary A,13,0,28,15
1683301858146,MGT 180,A00,202875,Staff,0,51,90,90
1683301859171,MMW 11R,A01,205019,Herbst; Matthew,3,0,30,27
1683301859171,MMW 11R,A02,205026,Herbst; Matthew,29,0,30,1
1683301860197,MMW 15,A01,193512,Chang; Edmond Yi-Teh,0,9,28,28
1683301860197,MMW 15,A02,193513,Chang; Edmond Yi-Teh,0,5,28,28
1683301860197,MMW 15,A03,193514,Chang; Edmond Yi-Teh,0,5,28,28
1683301860197,MMW 15,A04,193515,Chang; Edmond Yi-Teh,0,4,28,28
1683301860197,MMW 15,A05,193516,Chang; Edmond Yi-Teh,0,4,28,28
1683301860197,MMW 15,A06,193517,Chang; Edmond Yi-Teh,0,5,28,28
1683301860197,MMW 15,B01,193519,Chang; Edmond Yi-Teh,0,4,28,28
1683301860197,MMW 15,B02,193520,Chang; Edmond Yi-Teh,0,5,28,28
1683301860197,MMW 15,B03,193521,Chang; Edmond Yi-Teh,0,4,28,28
1683301860197,MMW 15,B04,193522,Chang; Edmond Yi-Teh,0,4,28,28
1683301860197,MMW 15,B05,193523,Chang; Edmond Yi-Teh,0,5,28,28
1683301860197,MMW 15,B06,193524,Chang; Edmond Yi-Teh,0,4,28,28
1683301861220,MMW 122,A01,193526,Rahimi; Babak,0,14,28,28
1683301861220,MMW 122,A02,193527,Rahimi; Babak,0,14,28,28
1683301861220,MMW 122,A03,193528,Rahimi; Babak,0,0,0,0
1683301861220,MMW 122,A04,193529,Rahimi; Babak,0,0,0,0
1683301862244,MUS 1A,A01,186663,Staff,0,20,35,35
1683301863268,MUS 4,A01,186715,Staff,0,12,35,35
1683301864295,MUS 5R,A01,186796,Dubnov; Shlomo,0,17,35,35
1683301865322,MUS 6,A01,186798,Staff,0,3,25,25
1683301866345,MUS 7,A01,186830,Staff,12,0,35,23
1683301867372,MUS 8,A01,186930,Staff,0,26,35,35
1683301868399,MUS 15,A01,186932,Staff,0,15,35,35
1683301868399,MUS 15,B01,186934,Staff,0,15,35,35
1683301869431,MUS 80,A00,186935,Staff,2,0,20,18
1683301869431,MUS 80,B00,186936,Staff,25,0,25,0
1683301870456,NANO 11,A00,204702,Lipomi; Darren John,0,0,0,0
1683301871480,NANO 15,A01,204709,Yang; Kesong,0,1,0,0
1683301872508,NANO 114,A00,202069,Jahed Motlagh; Zeinab,3,0,10,7
1683301873532,PHIL 1,A00,186955,Grush; Rick Scott,32,0,40,8
1683301874558,PHIL 10,A01,186973,Grush; Rick Scott,29,0,35,6
1683301874558,PHIL 10,A02,186974,Grush; Rick Scott,33,0,35,2
1683301875585,PHIL 13,A01,186976,Staff,7,0,35,28
1683301875585,PHIL 13,A02,186977,Staff,16,0,35,19
1683301876610,PHIL 14,A01,186979,Staff,31,0,35,4
1683301876610,PHIL 14,A02,186986,Staff,32,0,35,3
1683301877634,PHIL 28,A01,186988,Staff,16,0,30,14
1683301877634,PHIL 28,A02,186989,Staff,1,0,30,29
1683301877634,PHIL 28,A03,186990,Staff,9,0,30,21
1683301877634,PHIL 28,A04,186991,Staff,26,0,30,4
1683301878658,PHIL 120,A00,186997,Staff,23,0,40,17
1683301879682,PHIL 137,A00,187003,Staff,9,0,40,31
1683301880707,PHIL 150,A00,187015,Staff,47,0,70,23
1683301881731,PHIL 167,A00,187021,Lamey; Andy M.,35,0,40,5
1683301882758,PHIL 174,A01,202226,Staff,17,0,20,3
1683301882758,PHIL 174,A02,202235,Staff,20,0,20,0
1683301883782,PHIL 191A,A00,258918,Staff,0,0,1,1
1683301884811,PHYS 1A,A00,187028,Staff,26,0,60,34
1683301885836,PHYS 1AL,001,187036,Staff,2,0,30,28
1683301885836,PHYS 1AL,002,187049,Staff,18,0,30,12
1683301886861,PHYS 1B,A00,187058,Staff,23,0,60,37
1683301887890,PHYS 1BL,001,187064,Staff,0,0,30,30
1683301887890,PHYS 1BL,002,187070,Staff,6,0,30,24
1683301888915,PHYS 1C,A00,187082,Staff,32,0,120,88
1683301889943,PHYS 1CL,001,187088,Staff,0,9,30,30
1683301889943,PHYS 1CL,002,187089,Staff,0,2,30,30
1683301889943,PHYS 1CL,009,262693,Staff,12,0,30,18
1683301890970,PHYS 2B,A01,187097,Staff,54,0,115,61
1683301891998,PHYS 2C,A01,187099,Staff,67,0,115,48
1683301893022,PHYS 2CL,A01,187101,Staff,5,0,28,23
1683301893022,PHYS 2CL,A02,187102,Staff,15,0,28,13
1683301894047,PHYS 2D,A01,187123,Shotwell; Brian,95,0,115,20
1683301895071,PHYS 4B,A01,187133,Grinstein; Benjamin,35,0,50,15
1683301896098,POLI 10,A00,188819,Staff,0,3,50,50
1683301897122,POLI 11,A00,188827,Staff,43,0,50,7
1683301898160,POLI 13R,A00,188828,Staff,0,1,20,20
1683301899187,POLI 27,A01,188830,Elgin; Samuel Zincke,0,1,70,70
1683301900211,POLI 30,A00,188832,Desposato; Scott,33,0,50,17
1683301901234,POLI 102F,A00,188834,Staff,3,0,40,37
1683301902262,POLI 104A,A00,188852,Staff,14,0,30,16
1683301903288,POLI 104I,A00,188853,Staff,0,6,20,20
1683301904314,POLI 110B,A00,188854,Wiens; David,7,0,20,13
1683301905338,POLI 112A,A00,188855,Wiens; David,5,0,30,25
1683301906364,POLI 117R,A00,188856,Forman; Fonna,0,11,20,20
1683301907389,POLI 118,A00,188857,Ingham; Sean,8,0,20,12
1683301908416,POLI 120G,A00,188858,Staff,9,0,30,21
1683301909442,POLI 131CR,A00,188863,Hoston; Germaine,24,0,50,26
1683301910467,POLI 133,A00,188864,Nellis; Gareth Hb,44,0,50,6
1683301911493,POLI 134D,A00,188865,Desposato; Scott,27,0,30,3
1683301912517,POLI 142A,A00,188871,Gartzke; Erik,22,0,50,28
1683301913544,POLI 142K,A00,188874,Staff,38,0,50,12
1683301914573,POLI 143,A00,188940,Gartzke; Erik,16,0,30,14
1683301915600,POLI 153,A00,188943,Staff,3,0,20,17
1683301916628,POLI 160AA,A00,188944,Staff,13,0,40,27
1683301917655,POLI 170A,A00,188945,Staff,11,0,30,19
1683301919706,PSYC 1,A00,188952,Staff,38,0,90,52
1683301920733,PSYC 2,B00,188953,Staff,20,0,35,15
1683301921758,PSYC 6,A00,188970,Staff,47,0,60,13
1683301922786,PSYC 7,A00,188973,Staff,37,0,45,8
1683301923819,PSYC 60,A01,188980,Rickard; Timothy C.,43,0,60,17
1683301924844,PSYC 70,A01,189001,Steiner; Eric Tomas,24,0,45,21
1683301925872,PSYC 100,A00,189005,Lacefield; Katharine I,0,99,120,120
1683301926896,PSYC 102,A00,189008,Staff,10,0,30,20
1683301927924,PSYC 106,B00,189026,Gorman; Michael R.,37,0,60,23
1683301928949,PSYC 114,B01,189033,Winkielman; Piotr,0,32,30,30
1683301929986,PSYC 131,A00,189036,Anagnostaras; Stephan,0,43,60,60
1683301931010,PSYC 136,A00,189041,Lowe; Angela Beth,0,7,25,25
1683301932033,PSYC 137,A00,189057,Winkielman; Piotr,0,34,25,25
1683301933058,PSYC 144,A00,189107,Wixted; John T,0,7,50,50
1683301935111,PSYC 162,A00,189142,Staff,0,8,85,85
1683301936135,PSYC 172,A00,189144,Gorman; Michael R.,0,7,30,30
1683301938186,PSYC 179,A00,189146,Lacefield; Katharine I,0,84,120,120
1683301939210,PSYC 181,A00,189147,Anagnostaras; Stephan,0,44,90,90
1683301940235,PSYC 190R,A00,189148,Barner; David A.,0,22,80,80
1683301941263,PSYC 191,A00,189275,Rickard; Timothy C.,0,7,25,25
1683301942289,PSYC 193,A00,189276,Chapman; Eddie Nathaniel,0,1,0,4
1683301943313,PSYC 193L,A01,189281,Lowe; Angela Beth,12,0,20,8
1683301943313,PSYC 193L,B01,189285,Staff,28,0,35,7
1683301944337,RELI 149,A00,187137,Rahimi; Babak,7,0,40,33
1683301945364,SE 9,A01,187315,Staff,0,2,18,18
1683301946389,SE 101B,A00,187409,Staff,24,0,30,6
1683301947415,SE 110B,A00,187444,Staff,10,0,40,30
1683301948443,SE 130B,A00,187449,Staff,31,0,40,9
1683301949467,SE 150A,A00,187516,Staff,9,0,20,11
1683301950490,SE 154,A00,187528,Staff,30,0,50,20
1683301951517,SIO 3,A01,258171,Staff,35,0,40,5
1683301952542,SIO 10,A00,187144,Cook; Geoffrey W,0,3,75,75
1683301953570,SIO 45,A00,187152,Cook; Geoffrey W,1,0,100,99
1683301954650,SIO 109R,A00,194486,Staff,0,3,20,20
1683301956703,SIO 187,A01,187233,Kacev; David,12,0,40,28
1683301957732,SOCI 1,A01,258656,Thorpe; Charles Robert,28,0,30,2
1683301957732,SOCI 1,A02,258658,Thorpe; Charles Robert,30,0,30,0
1683301957732,SOCI 1,A03,258661,Thorpe; Charles Robert,25,0,25,0
1683301957732,SOCI 1,A04,258666,Thorpe; Charles Robert,22,0,25,3
1683301957732,SOCI 1,A05,258897,Thorpe; Charles Robert,23,0,25,2
1683301957732,SOCI 1,A06,258898,Thorpe; Charles Robert,25,0,25,0
1683301958758,SOCI 30,A01,258903,Pardo Guerra; Juan Pablo,16,0,30,14
1683301959784,SOCI 102,A00,258904,Staff,9,0,25,16
1683301960808,SOCI 106,A00,258905,Staff,19,0,25,6
1683301961840,SOCI 111,A00,258907,Ribas Norris; Janet Vanesa,26,0,30,4
1683301962864,SOCI 121R,A00,258908,Pardo Guerra; Juan Pablo,11,0,30,19
1683301963888,SOCI 126,A01,203330,Staff,14,0,20,6
1683301964915,SOCI 131,A00,258909,Thorpe; Charles Robert,31,0,60,29
1683301965938,SOCI 135,A00,258910,Payne; Christine Anna,0,9,30,30
1683301966966,SOCI 157,A00,258911,Staff,13,0,30,17
1683301967994,SOCI 184,A00,258912,Staff,26,0,30,4
1683301969021,SOCI 188D,A00,258913,Staff,21,0,30,9
1683301970046,SYN 2,001,187529,Staff,9,0,16,7
1683301970046,SYN 2,002,201452,Staff,0,18,16,16
1683301970046,SYN 2,003,201469,Staff,3,0,16,13
1683301971070,SYN 100,A01,187531,Staff,0,9,20,20
1683301971070,SYN 100,B01,201491,Staff,0,12,20,20
1683301972098,TDAC 1,A00,189286,Walsh; Kim C.,3,0,20,17
1683301972098,TDAC 1,B00,189287,Harting; Carla Kelso,11,0,20,9
1683301973125,TDAC 101,A00,189300,Walsh; Kim C.,16,0,20,4
1683301973125,TDAC 101,B00,189301,Harting; Carla Kelso,18,0,20,2
1683301974153,TDAC 102,A00,189304,Basso; Beatrice,14,0,20,6
1683301975175,TDAC 108,A00,189305,Staff,18,0,20,2
1683301976201,TDDE 131,A00,189310,Staff,19,0,20,1
1683301976201,TDDE 131,B00,189314,Staff,19,0,20,1
1683301976201,TDDE 131,C00,189315,Staff,48,0,50,2
1683301976201,TDDE 131,D00,189316,Staff,14,0,15,1
1683301976201,TDDE 131,E00,204841,Staff,20,0,20,0
1683301977228,TDGE 10,A00,189289,Staff,30,0,50,20
1683301977228,TDGE 10,B00,189290,Havis; Allan,2,0,50,48
1683301978255,TDGE 11,A00,189291,Fulton; Julia,0,3,50,50
1683301978255,TDGE 11,B00,189292,Staff,20,0,25,5
1683301978255,TDGE 11,C00,260270,Staff,0,0,0,0
1683301979281,TDGE 25,A00,189294,Staff,3,0,20,17
1683301980308,TDGE 124,A00,189318,Fulton; Julia,0,8,50,50
1683301981338,TDGE 125,A00,189319,Staff,13,0,25,12
1683301981338,TDGE 125,B00,189320,Staff,23,0,25,2
1683301982363,TDGE 127,A00,189322,Havis; Allan,0,0,50,50
1683301983389,TDHT 101,A00,189323,Staff,18,0,25,7
1683301983389,TDHT 101,B00,189324,Staff,25,0,25,0
1683301984413,TDHT 102,A00,189325,Staff,49,0,50,1
1683301985442,TDMV 1,A00,189295,Arcidiacono; Kristin,20,0,30,10
1683301985442,TDMV 1,B00,189296,Caligagan; Maria T.,24,0,30,6
1683301986466,TDMV 2,A00,189297,Sammartano; Tonnie,28,0,30,2
1683301986466,TDMV 2,B00,189299,Arcidiacono; Kristin,24,0,30,6
1683301987495,TDMV 3,A00,204998,Rincon; Alicia,22,0,30,8
1683301988521,TDMV 120,A00,189458,Sammartano; Tonnie,28,0,30,2
1683301989544,TDMV 138,A00,189541,Jun; Grace Shin Hae,22,0,40,18
1683301990571,TDMV 142,A00,189717,Caligagan; Tony,23,0,30,7
1683301990571,TDMV 142,B00,189718,Caligagan; Maria T.,25,0,30,5
1683301991599,TMC 2,A01,187533,Staff,25,0,25,0
1683301991599,TMC 2,A02,187534,Staff,25,0,25,0
1683301992622,USP 1,A01,187536,Kwak; Nancy,0,16,25,25
1683301993649,USP 5,A01,187538,Staff,9,0,25,16
1683301994673,USP 101,A00,199253,Staff,0,4,0,0
1683301995697,USP 124,A00,187562,Boomhower; Matthew Charles,1,0,30,29
1683301996722,USP 138,A00,187582,Staff,20,0,25,5
1683301997750,USP 152,A01,187597,Staff,4,0,25,21
1683301998778,USP 153,A00,187598,Staff,19,0,25,6
1683301999802,USP 168,A00,187607,Kwak; Nancy,2,0,5,3
1683302000827,USP 173,A00,187619,Staff,4,0,25,21
1683302001855,USP 181,A00,187638,Staff,0,0,25,25
1683302002886,VIS 103,A00,187650,Cruz; Edwin Teddy,23,0,75,52
1683302003910,VIS 110D,A00,187669,Staff,12,0,22,10
1683302004942,VIS 127C,A00,187720,Shen; Kuiyi,68,0,146,78
1683302005967,VIS 149,A00,187731,Yoldas; Pinar,0,14,22,22
1683302006995,VIS 151,A01,188091,Staff,22,0,34,12
1683302006995,VIS 151,A02,188092,Staff,11,0,34,23
1683302008019,VIS 160B,A00,188093,Stalbaum; Brett,0,0,10,10
1683302010072,WCWP 10B,A00,201720,Staff,10,0,15,5
1683302010072,WCWP 10B,B00,201722,Staff,8,0,15,7
1683302011100,WCWP 100,A00,201725,Gagnon; Jeffrey C,0,0,2,2
1683302011100,WCWP 100,B00,201727,Staff,0,4,15,15
1683302014230,ANBI 133,A00,258401,Wilder; Linnea Lorene,34,0,40,6
1683302015254,ANBI 140,A00,258395,Hrvoj Mihic; Branka,18,0,25,7
1683302016281,ANSC 120,A00,258402,Bialecki; Jon Anthony,27,0,40,13
1683302017307,ANSC 144,A00,258400,Staff,14,0,40,26
1683302019357,ANSC 166,A00,258396,Parish; Steven Martin,157,0,175,18
1683302020380,ANSC 180,A00,193533,Staff,9,0,20,11
1683302021407,ANSC 188,A00,258397,Jassal; Aftab,33,0,40,7
1683302022431,ANTH 3,A01,258316,Staff,23,0,30,7
1683302023459,ANTH 5,A00,258394,Semendeferi; Ekaterini,16,0,20,4
1683302024488,ANTH 21,A01,258331,Staff,9,0,40,31
1683302025516,ANTH 103,A00,258398,Varma; Saiba,15,0,25,10
1683302026543,AWP 10,001,202034,Staff,0,0,0,0
1683302026543,AWP 10,002,202035,Staff,0,0,0,0
1683302026543,AWP 10,003,202036,Staff,0,0,0,0
1683302026543,AWP 10,004,202037,Staff,0,0,0,0
1683302026543,AWP 10,005,202038,Staff,0,0,0,0
1683302026543,AWP 10,006,202039,Staff,0,0,0,0
1683302026543,AWP 10,007,202040,Staff,0,0,0,0
1683302026543,AWP 10,008,202041,Staff,0,0,0,0
1683302026543,AWP 10,009,202042,Staff,0,0,0,0
1683302026543,AWP 10,010,202043,Staff,0,0,0,0
1683302026543,AWP 10,011,202044,Staff,0,0,0,0
1683302026543,AWP 10,012,202045,Staff,0,0,0,0
1683302026543,AWP 10,013,202046,Staff,0,0,0,0
1683302026543,AWP 10,014,202047,Staff,0,0,0,0
1683302026543,AWP 10,015,202048,Staff,0,0,0,0
1683302026543,AWP 10,016,202049,Staff,0,0,0,0
1683302026543,AWP 10,017,202050,Staff,0,0,0,0
1683302026543,AWP 10,018,202051,Staff,0,0,0,0
1683302026543,AWP 10,019,202052,Staff,0,0,0,0
1683302026543,AWP 10,020,202053,Staff,0,0,0,0
1683302026543,AWP 10,021,202054,Staff,0,0,0,0
1683302026543,AWP 10,022,202055,Staff,0,0,0,0
1683302026543,AWP 10,023,202056,Staff,0,0,0,0
1683302026543,AWP 10,024,202057,Staff,0,0,0,0
1683302026543,AWP 10,025,202058,Staff,0,0,0,0
1683302026543,AWP 10,026,202059,Staff,0,0,0,0
1683302027566,AWP 102,001,202032,Staff,0,0,0,0
1683302027566,AWP 102,002,202033,Staff,0,0,0,0
1683302028592,BENG 100,A01,254234,Taylor Amos; Alyssa C,31,0,40,9
1683302029617,BENG 196,001,270013,Engler; Adam J.,9999,0,9999,0
1683302030642,BICD 100R,A01,202018,Smith; Laurie,0,7,32,32
1683302030642,BICD 100R,A02,202019,Smith; Laurie,0,2,32,32
1683302030642,BICD 100R,A03,202020,Smith; Laurie,0,1,32,32
1683302030642,BICD 100R,A04,202021,Smith; Laurie,8,0,32,24
1683302030642,BICD 100R,A05,202022,Smith; Laurie,12,0,32,20
1683302031671,BICD 136,A01,193242,Gustafson-Brown; Cindy,0,2,32,32
1683302031671,BICD 136,A02,193244,Gustafson-Brown; Cindy,15,0,32,17
1683302032699,BIEB 102,A01,193249,Butler; Shannon Rhey,0,2,32,32
1683302032699,BIEB 102,A02,193251,Butler; Shannon Rhey,0,0,32,32
1683302032699,BIEB 102,A03,193253,Butler; Shannon Rhey,0,1,32,32
1683302032699,BIEB 102,A04,193255,Butler; Shannon Rhey,17,0,32,15
1683302032699,BIEB 102,A05,193265,Butler; Shannon Rhey,26,0,32,6
1683302032699,BIEB 102,A06,193269,Butler; Shannon Rhey,16,0,32,16
1683302034756,BIEB 150,A01,193274,Staff,0,0,32,32
1683302034756,BIEB 150,A02,193285,Staff,24,0,32,8
1683302035781,BIEB 194,A00,193286,Kurle; Carolyn M.,22,0,32,10
1683302036809,BILD 1,A01,192291,Staff,16,0,32,16
1683302036809,BILD 1,A02,192292,Staff,30,0,32,2
1683302036809,BILD 1,B01,192520,Reuther; Keefe,0,1,0,0
1683302036809,BILD 1,B02,192532,Reuther; Keefe,0,1,0,0
1683302037839,BILD 3,A01,192556,Butler; Shannon Rhey,0,0,32,32
1683302037839,BILD 3,A02,192581,Butler; Shannon Rhey,5,0,32,27
1683302037839,BILD 3,A03,192611,Butler; Shannon Rhey,23,0,32,9
1683302037839,BILD 3,A04,192612,Butler; Shannon Rhey,25,0,32,7
1683302037839,BILD 3,A05,192613,Butler; Shannon Rhey,27,0,32,5
1683302037839,BILD 3,A06,192679,Butler; Shannon Rhey,27,0,32,5
1683302037839,BILD 3,A07,192682,Butler; Shannon Rhey,22,0,32,10
1683302038868,BILD 4,A01,192836,Reuther; Keefe,1,0,24,23
1683302038868,BILD 4,A02,193044,Reuther; Keefe,4,0,24,20
1683302039892,BILD 10,A01,193142,Gustafson-Brown; Cindy,31,0,32,1
1683302039892,BILD 10,A02,193149,Gustafson-Brown; Cindy,31,0,32,1
1683302040918,BIMM 100,A01,193301,Staff,0,6,32,32
1683302040918,BIMM 100,A02,193312,Staff,0,5,32,32
1683302040918,BIMM 100,A03,193323,Staff,0,8,32,32
1683302041949,BIMM 101,A01,193329,McDonnell; Lisa Marie,0,3,24,24
1683302041949,BIMM 101,A02,193339,McDonnell; Lisa Marie,0,2,24,24
1683302041949,BIMM 101,B01,193354,McDonnell; Lisa Marie,0,3,24,24
1683302041949,BIMM 101,B02,193357,McDonnell; Lisa Marie,0,3,24,24
1683302042974,BIMM 110,A01,193377,Tat; John,0,11,32,32
1683302042974,BIMM 110,A02,193378,Tat; John,1,9,32,31
1683302043999,BIMM 120,A01,206116,Staff,0,0,32,32
1683302043999,BIMM 120,A02,206117,Staff,8,0,32,24
1683302043999,BIMM 120,A03,206121,Staff,21,0,32,11
1683302045028,BIPN 100,A01,193393,Park; Ji Young,0,14,32,32
1683302045028,BIPN 100,A02,193402,Park; Ji Young,0,12,32,32
1683302045028,BIPN 100,A03,193413,Park; Ji Young,0,14,32,32
1683302045028,BIPN 100,A04,193414,Park; Ji Young,0,13,32,32
1683302046053,BIPN 102,A01,193429,Staff,0,0,32,32
1683302046053,BIPN 102,A02,193438,Staff,23,0,32,9
1683302047081,BIPN 106,A01,193450,Reyes Gonzalez; Catalina,0,2,40,40
1683302048106,BIPN 134,A01,193465,Cooke; James Edward,0,0,32,32
1683302048106,BIPN 134,A02,193474,Cooke; James Edward,27,0,32,5
1683302048106,BIPN 134,A03,193485,Cooke; James Edward,29,0,32,3
1683302048106,BIPN 134,A04,193486,Cooke; James Edward,21,0,32,11
1683302048106,BIPN 134,A05,193491,Cooke; James Edward,31,0,32,1
1683302048106,BIPN 134,A06,193501,Cooke; James Edward,30,0,32,2
1683302048106,BIPN 134,A07,193510,Cooke; James Edward,29,0,32,3
1683302050163,BISP 194,A00,222522,Staff,16,0,32,16
1683302051190,CAT 124,A01,202407,Staff,20,0,25,5
1683302052215,CAT 125,A00,202408,Marchisotto; Jennifer Anne,4,0,20,16
1683302053244,CAT 125R,A00,202409,Smith; Lauryn Alissa,0,11,20,20
1683302053244,CAT 125R,B00,202410,Morales; Celeste Georgianna,0,11,20,20
1683302053244,CAT 125R,C00,202411,Irwin; Matthew Joseph,0,10,20,20
1683302054268,CENG 15,A01,204712,Yang; Kesong,0,1,0,0
1683302055293,CENG 114,A00,202070,Jahed Motlagh; Zeinab,5,0,20,15
1683302056321,CGS 105,A00,185477,Wesling; Megan E.,24,0,40,16
1683302057346,CGS 106,A00,185494,Staff,13,0,22,9
1683302058432,CGS 108,A00,185495,Staff,14,0,20,6
1683302059459,CGS 114,A00,185496,Staff,13,0,18,5
1683302060485,CGS 119,A00,185501,Staff,15,0,20,5
1683302061508,CGS 120,A00,185511,Staff,13,0,20,7
1683302062533,CHEM 4,A01,184675,Bussey; Thomas J,96,0,100,4
1683302063560,CHEM 6A,A01,184677,Staff,35,0,60,25
1683302064584,CHEM 6B,A01,184679,Staff,65,0,100,35
1683302065610,CHEM 6C,A01,184681,Bussey; Thomas J,1,0,50,49
1683302065610,CHEM 6C,A02,184682,Bussey; Thomas J,34,0,50,16
1683302066637,CHEM 40A,A01,184684,Albizati; Kim F.,37,0,100,63
1683302067667,CHEM 40B,A01,184686,Albizati; Kim F.,0,20,100,100
1683302068693,CHEM 41B,A01,184690,Staff,52,0,100,48
1683302069720,COGS 3,A01,184715,Boyle; Mary E. T.,0,25,40,40
1683302070747,COGS 14B,A01,185172,Staff,0,15,38,38
1683302071772,COGS 18,A01,184736,Staff,20,0,80,60
1683302072797,COGS 100,A01,184932,Staff,0,5,73,73
1683302073822,COGS 101A,A01,184935,Staff,0,38,30,30
1683302074848,COGS 101B,A01,184944,Staff,0,2,30,30
1683302075873,COGS 101C,A01,184946,Staff,0,12,30,30
1683302076898,COGS 102A,A01,184951,Johnson; Christine M.,2,0,40,38
1683302077922,COGS 107B,A01,184953,Mooshagian; Eric Frederick,0,50,40,40
1683302078949,COGS 118B,A01,184959,Gupta; Anjum,0,48,40,40
1683302079975,COGS 153,A00,184961,Staff,0,15,30,30
1683302081004,COGS 177,A00,184962,Staff,0,21,30,30
1683302082033,COGS 187A,A01,184969,Boyle; Mary E. T.,0,17,40,40
1683302083058,COMM 10,A01,185174,Staff,0,5,25,25
1683302083058,COMM 10,A02,185189,Staff,0,5,25,25
1683302083058,COMM 10,A03,269821,Staff,0,0,0,0
1683302084085,COMM 100B,A01,185475,Staff,0,0,0,2
1683302084085,COMM 100B,A02,185476,Staff,14,0,25,11
1683302085110,COMM 100C,A01,185314,Staff,1,0,25,24
1683302085110,COMM 100C,A02,185327,Staff,19,0,25,6
1683302086132,COMM 110M,A00,185349,Staff,2,0,40,38
1683302087155,COMM 113T,A00,185352,Staff,25,0,40,15
1683302088180,COMM 114I,A00,185353,Staff,33,0,40,7
1683302089208,COMM 131,A00,185354,Staff,19,0,30,11
1683302090231,CSE 8A,A50,185358,Cao; Yingjun,0,46,10,10
1683302091255,CSE 8B,A01,185362,Staff,1,47,50,49
1683302092279,CSE 11,A01,185416,Cao; Yingjun,0,93,10,10
1683302093307,CSE 20,A01,185445,Briones; Jor-el Thomas Caparas,5,0,25,20
1683302094335,CSE 21,A01,185447,Staff,10,0,50,40
1683302095362,CSE 101,A01,185451,Staff,0,12,50,50
1683302095362,CSE 101,B01,185453,Jones; Miles E,0,11,50,50
1683302097416,CSE 141,A01,185458,Eldon; John,20,0,100,80
1683302098439,CSE 141L,A01,185461,Eldon; John,12,0,100,88
1683302099464,CSE 142,A01,185463,Staff,35,0,60,25
1683302099464,CSE 142,B01,201355,Staff,0,6,60,60
1683302100492,CSE 142L,A01,185470,Staff,35,0,60,25
1683302100492,CSE 142L,B01,201417,Staff,0,5,60,60
1683302101521,CSE 190,A00,201433,Staff,32,0,49,17
1683302102545,DOC 1,A01,259136,Strom; Megan C.,8,0,15,7
1683302102545,DOC 1,A02,259137,Strom; Megan C.,14,0,15,1
1683302102545,DOC 1,A03,259138,Strom; Megan C.,14,0,15,1
1683302102545,DOC 1,A04,259139,Strom; Megan C.,14,0,15,1
1683302103573,DOC 100D,A00,259140,Pass; Natalye Joann,17,0,25,8
1683302104601,DSGN 1,A01,184749,Rill; Bryan,0,24,30,30
1683302105628,DSGN 100,A01,185168,Staff,0,2,25,25
1683302106653,ECE 5,A01,185626,Morris; Karcher William,0,10,0,0
1683302107676,ECE 101,A01,185628,Staff,17,0,70,53
1683302108704,ECE 107,A01,185635,Baghdadchi; Saharnaz,0,0,20,20
1683302108704,ECE 107,A02,185638,Baghdadchi; Saharnaz,4,0,20,16
1683302109728,ECE 148,A01,185647,Silberman; Jack,1,0,16,15
1683302110754,ECON 1,A01,185537,Crane; Meredith Helen,54,0,70,16
1683302111777,ECON 3,A01,185549,Crane; Meredith Helen,33,0,70,37
1683302112804,ECON 4,A01,203354,Anderson; John Charles,0,4,10,10
1683302113830,ECON 100A,A01,185574,Staff,0,4,40,40
1683302114860,ECON 100B,A01,185576,Staff,0,22,40,40
1683302115884,ECON 100C,A01,185589,Newhouse; Herbert S,30,0,70,40
1683302116911,ECON 105,A00,185608,Vespa; Emanuel Ignacio,19,0,35,16
1683302117936,ECON 109,A01,185610,Shishkin; Denis,10,0,35,25
1683302118963,ECON 110A,A01,185612,Staff,11,0,40,29
1683302119994,ECON 120A,A01,185615,Staff,20,0,40,20
1683302121022,ECON 120C,A01,185617,Sun; Yixiao,0,20,70,70
1683302122048,ECON 144,A00,203346,Squires; Dale E,3,0,35,32
1683302123079,ECON 171,A01,203349,Newhouse; Herbert S,0,1,35,35
1683302124107,ECON 173A,A01,185621,Toda; Alexis Akira,21,0,35,14
1683302125133,EDS 25,A01,202413,Staff,0,1,0,0
1683302125133,EDS 25,A02,202414,Staff,0,1,0,0
1683302125133,EDS 25,A03,202415,Staff,0,0,0,0
1683302125133,EDS 25,A04,202416,Staff,0,1,0,0
1683302125133,EDS 25,A05,202439,Staff,0,0,0,0
1683302125133,EDS 25,A06,202440,Staff,0,0,0,0
1683302125133,EDS 25,B01,202631,Staff,0,0,0,0
1683302125133,EDS 25,B02,202632,Staff,0,0,0,0
1683302125133,EDS 25,B03,202639,Staff,0,0,0,0
1683302125133,EDS 25,B04,202640,Staff,0,0,0,0
1683302125133,EDS 25,B05,202643,Staff,0,0,0,0
1683302125133,EDS 25,B06,202644,Staff,0,0,0,0
1683302126160,EDS 38,A01,202659,Black; Alison Michelle,24,0,25,1
1683302127184,EDS 115,A00,202652,Staff,17,0,30,13
1683302128211,EDS 125,A00,202649,Staff,14,0,30,16
1683302129238,EDS 126,A01,203332,Staff,30,0,30,0
1683302130261,EDS 139,A00,202838,Staff,17,0,25,8
1683302131284,EDS 146,A01,202655,Staff,15,0,25,10
1683302132309,ENG 15,A00,185667,Staff,0,1,0,0
1683302132309,ENG 15,B00,185672,Staff,0,0,0,0
1683302132309,ENG 15,C00,185675,Staff,0,0,0,0
1683302132309,ENG 15,D00,185682,Staff,0,0,0,0
1683302132309,ENG 15,E00,185684,Staff,0,0,0,0
1683302133336,ETHN 103,A00,185710,Staff,0,3,35,35
1683302134362,ETHN 103A,A00,199228,Man; Simeon S,2,0,9,7
1683302135388,ETHN 109,A00,185711,Staff,18,0,35,17
1683302136412,ETHN 142,A00,185726,Staff,0,4,30,30
1683302137438,ETHN 163J,A00,199229,Man; Simeon S,6,0,8,2
1683302138462,ETHN 168,A00,185727,Staff,8,0,10,2
1683302139485,ETHN 182,A00,185728,Staff,1,0,35,34
1683302140509,ETHN 183,A00,185737,Staff,8,0,18,10
1683302141536,GLBH 111,A01,209361,Burgos; Jose L.,0,0,0,0
1683302143589,HIEU 104,A00,185792,Staff,16,0,20,4
1683302144617,HIEU 115,A00,185800,Staff,1,0,20,19
1683302145640,HIEU 128,A00,185801,Staff,0,7,20,20
1683302146664,HIEU 147,A00,185802,Staff,16,0,20,4
1683302147691,HIEU 154,A00,185823,Staff,12,0,20,8
1683302148718,HILA 102,A00,185826,Staff,13,0,20,7
1683302149742,HILD 2C,A01,185778,Staff,0,12,20,20
1683302150770,HILD 7B,A01,185780,Kwak; Nancy,0,15,32,32
1683302150770,HILD 7B,A02,185781,Kwak; Nancy,0,18,32,32
1683302151798,HILD 30,A01,185791,Staff,14,0,20,6
1683302152822,HISC 119,A00,185830,Golan; Tal,0,9,20,20
1683302153845,HITO 156GS,A00,185831,Patterson; Patrick H.,0,0,0,23
1683302154872,HIUS 103,A00,185832,Man; Simeon S,0,6,20,20
1683302155896,HIUS 117,A00,185836,Kwak; Nancy,2,0,20,18
1683302156922,HIUS 125,A00,185840,Man; Simeon S,0,0,23,23
1683302157950,HIUS 149,A00,185845,Staff,0,0,20,20
1683302158975,HUM 3,A01,185882,Zavodny; Tatiana Sophia,0,6,50,50
1683302158975,HUM 3,B01,185899,Caldwell; Michael Alan,0,19,50,50
1683302160001,HUM 3GS,A00,185900,Patterson; Patrick H.,0,0,0,23
1683302161026,HUM 4,A01,185938,Zroka; Amy Liane,31,0,50,19
1683302161026,HUM 4,B01,185956,Watkins; Eric,0,2,50,50
1683302161026,HUM 4,B02,202209,Watkins; Eric,0,1,50,50
1683302161026,HUM 4,B03,202210,Watkins; Eric,0,0,50,50
1683302162120,HUM 5,A01,185958,West; Geoffrey Scott,5,0,50,45
1683302162120,HUM 5,A02,202215,West; Geoffrey Scott,0,0,50,50
1683302163150,INTL 190,A00,185959,Gagnon; Jeffrey C,0,0,0,9
1683302163150,INTL 190,B00,185960,Lettieri; Michael Joseph,0,0,0,1
1683302164174,JAPN 180,A00,254509,Staff,0,1,25,25
1683302165203,LATI 10,A01,202853,Kennemore; Amy Michelle,5,0,35,30
1683302165203,LATI 10,A02,202854,Kennemore; Amy Michelle,1,0,35,34
1683302165203,LATI 10,A03,270054,Kennemore; Amy Michelle,30,0,30,0
1683302166229,LATI 180,A00,202855,Kennemore; Amy Michelle,11,0,20,9
1683302167252,LAWS 101,A00,201767,Golan; Tal,0,7,40,40
1683302168280,LIFR 1C,A00,185961,Staff,6,0,20,14
1683302169304,LIFR 1CX,A00,185962,Staff,7,0,20,13
1683302170332,LIFR 1D,A00,185963,Staff,9,0,20,11
1683302171356,LIFR 1DX,A00,185964,Staff,9,0,20,11
1683302172381,LIGN 101,A01,186039,Staff,43,0,50,7
1683302173407,LIGN 165,A00,186040,Staff,18,0,50,32
1683302174434,LTCS 108,A00,186041,Staff,6,0,10,4
1683302175510,LTCS 119,A00,186042,Staff,16,0,20,4
1683302176534,LTCS 130,A00,186043,Wesling; Megan E.,15,0,25,10
1683302178582,LTEA 138,A00,186119,Staff,14,0,40,26
1683302179607,LTEN 124,A00,186148,Staff,6,0,25,19
1683302180635,LTEN 178,A00,186149,Staff,7,0,15,8
1683302181659,LTEN 181,A00,186150,Blanco; John D,33,0,40,7
1683302182683,LTWL 120,A00,186160,Staff,20,0,25,5
1683302183707,LTWL 165,A00,186161,Staff,22,0,25,3
1683302184734,LTWR 100,A00,186162,Staff,0,4,15,15
1683302185760,LTWR 102,A00,186163,Doller; Ben,5,0,15,10
1683302186784,MAE 8,A01,186412,Staff,0,0,0,0
1683302187808,MAE 30B,A00,186445,Bahadori; Mohammad Yousef,83,0,100,17
1683302188835,MAE 40,A00,186592,Bewley; Thomas R,9,0,50,41
1683302189863,MAE 101B,A00,186593,Bahadori; Mohammad Yousef,81,0,100,19
1683302190888,MAE 105,A00,186594,Bandaru; Prabhakar,12,0,50,38
1683302191913,MAE 107,A00,186599,Pham; Hieu Tan,0,6,120,120
1683302192938,MAE 148,A01,186660,Silberman; Jack,3,0,16,13
1683302193962,MATH 10A,A01,188095,Staff,0,7,35,35
1683302194987,MATH 10B,A01,188097,Bowers; Adam R.,0,11,30,30
1683302194987,MATH 10B,A02,188099,Bowers; Adam R.,0,9,30,30
1683302194987,MATH 10B,B01,188104,Bowers; Adam R.,0,11,30,30
1683302194987,MATH 10B,B02,188106,Bowers; Adam R.,0,11,30,30
1683302196016,MATH 10C,A01,188111,Staff,0,18,30,30
1683302196016,MATH 10C,A02,188127,Staff,0,17,30,30
1683302196016,MATH 10C,A03,188131,Staff,0,17,30,30
1683302196016,MATH 10C,B01,188218,Staff,21,0,30,9
1683302196016,MATH 10C,B02,188244,Staff,13,0,30,17
1683302196016,MATH 10C,B03,188277,Staff,16,0,30,14
1683302197045,MATH 18,A01,188344,Bach; Quang Tran,18,0,30,12
1683302197045,MATH 18,A02,188345,Bach; Quang Tran,11,0,30,19
1683302197045,MATH 18,B01,188353,Bach; Quang Tran,10,0,30,20
1683302197045,MATH 18,B02,188354,Bach; Quang Tran,20,0,30,10
1683302198073,MATH 20A,A01,188374,Staff,13,0,35,22
1683302199098,MATH 20B,A01,188382,Ohm; Ko Woon,6,0,30,24
1683302199098,MATH 20B,A02,188383,Ohm; Ko Woon,24,0,30,6
1683302199098,MATH 20B,B01,188385,Ohm; Ko Woon,7,0,30,23
1683302199098,MATH 20B,B02,188392,Ohm; Ko Woon,22,0,30,8
1683302200123,MATH 20C,A01,188394,Harel; Guershon,10,0,30,20
1683302200123,MATH 20C,A02,188395,Harel; Guershon,13,0,30,17
1683302200123,MATH 20C,B01,188404,Harel; Guershon,3,0,30,27
1683302200123,MATH 20C,B02,188405,Harel; Guershon,19,0,30,11
1683302201149,MATH 20D,A01,188414,Hammock; Frances H,0,1,30,30
1683302201149,MATH 20D,A02,188415,Hammock; Frances H,4,0,30,26
1683302201149,MATH 20D,B01,188447,Hammock; Frances H,2,0,30,28
1683302201149,MATH 20D,B02,188486,Hammock; Frances H,8,0,30,22
1683302202173,MATH 20E,A01,188649,Staff,22,0,30,8
1683302202173,MATH 20E,A02,188650,Staff,23,0,30,7
1683302202173,MATH 20E,A03,188673,Staff,0,0,30,30
1683302203199,MATH 102,A01,188675,Staff,0,35,35,35
1683302204228,MATH 103B,A01,188681,Staff,4,0,35,31
1683302204228,MATH 103B,B01,188692,Staff,7,0,35,28
1683302205255,MATH 109,A01,188695,Salehi Golsefidy; Alireza,25,0,35,10
1683302205255,MATH 109,A02,188696,Salehi Golsefidy; Alireza,27,0,35,8
1683302206278,MATH 120A,A01,188698,Eggers; John Dietrich,5,0,35,30
1683302207302,MATH 142B,A01,188736,Ioana; Adrian,0,2,30,30
1683302207302,MATH 142B,A02,188741,Ioana; Adrian,0,1,30,30
1683302207302,MATH 142B,A03,188743,Ioana; Adrian,0,3,30,30
1683302208328,MATH 168A,A01,188790,Staff,0,8,35,35
1683302209352,MATH 170A,A01,188803,Nie; Jiawang,0,2,35,35
1683302209352,MATH 170A,A02,188811,Nie; Jiawang,0,0,35,35
1683302209352,MATH 170A,A03,188814,Nie; Jiawang,1,0,35,34
1683302209352,MATH 170A,A04,188815,Nie; Jiawang,14,0,35,21
1683302210376,MATH 193B,A01,188817,Staff,0,0,35,35
1683302210376,MATH 193B,A02,188818,Staff,5,0,35,30
1683302211406,MGT 4,A01,202857,Anderson; John Charles,62,0,80,18
1683302212429,MGT 12,A00,202858,Lindenberger; Wade Douglas,43,0,90,47
1683302213453,MGT 18,A00,202859,Staff,74,0,90,16
1683302214478,MGT 18GS,A00,202860,McKay; Michael J,13,0,28,15
1683302215503,MGT 45,A00,202861,Pecore; Joseph P.,14,0,90,76
1683302216528,MGT 100,A00,202863,Yavorsky; Daniel Ryan,28,0,90,62
1683302217556,MGT 103,A00,202864,Ehrich; Kristine R,0,16,90,90
1683302218582,MGT 112,A00,202865,Ehrich; Kristine R,15,0,90,75
1683302219610,MGT 121A,A00,202868,Staff,0,19,0,0
1683302220637,MGT 131B,A00,202869,Anderson; John Charles,59,0,90,31
1683302221660,MGT 136,A00,202871,Lindenberger; Wade Douglas,84,0,90,6
1683302222685,MGT 164,A00,202873,Staff,0,69,90,90
1683302223713,MGT 164GS,A00,202874,McKay; Mary A,13,0,28,15
1683302224741,MGT 180,A00,202875,Staff,0,51,90,90
1683302225767,MMW 11R,A01,205019,Herbst; Matthew,3,0,30,27
1683302225767,MMW 11R,A02,205026,Herbst; Matthew,29,0,30,1
1683302226793,MMW 15,A01,193512,Chang; Edmond Yi-Teh,0,9,28,28
1683302226793,MMW 15,A02,193513,Chang; Edmond Yi-Teh,0,5,28,28
1683302226793,MMW 15,A03,193514,Chang; Edmond Yi-Teh,0,5,28,28
1683302226793,MMW 15,A04,193515,Chang; Edmond Yi-Teh,0,4,28,28
1683302226793,MMW 15,A05,193516,Chang; Edmond Yi-Teh,0,4,28,28
1683302226793,MMW 15,A06,193517,Chang; Edmond Yi-Teh,0,5,28,28
1683302226793,MMW 15,B01,193519,Chang; Edmond Yi-Teh,0,4,28,28
1683302226793,MMW 15,B02,193520,Chang; Edmond Yi-Teh,0,5,28,28
1683302226793,MMW 15,B03,193521,Chang; Edmond Yi-Teh,0,4,28,28
1683302226793,MMW 15,B04,193522,Chang; Edmond Yi-Teh,0,4,28,28
1683302226793,MMW 15,B05,193523,Chang; Edmond Yi-Teh,0,5,28,28
1683302226793,MMW 15,B06,193524,Chang; Edmond Yi-Teh,0,4,28,28
1683302227818,MMW 122,A01,193526,Rahimi; Babak,0,14,28,28
1683302227818,MMW 122,A02,193527,Rahimi; Babak,0,14,28,28
1683302227818,MMW 122,A03,193528,Rahimi; Babak,0,0,0,0
1683302227818,MMW 122,A04,193529,Rahimi; Babak,0,0,0,0
1683302228846,MUS 1A,A01,186663,Staff,0,20,35,35
1683302229873,MUS 4,A01,186715,Staff,0,12,35,35
1683302230898,MUS 5R,A01,186796,Dubnov; Shlomo,0,17,35,35
1683302231923,MUS 6,A01,186798,Staff,0,3,25,25
1683302232951,MUS 7,A01,186830,Staff,12,0,35,23
1683302233975,MUS 8,A01,186930,Staff,0,26,35,35
1683302235002,MUS 15,A01,186932,Staff,0,15,35,35
1683302235002,MUS 15,B01,186934,Staff,0,15,35,35
1683302236034,MUS 80,A00,186935,Staff,2,0,20,18
1683302236034,MUS 80,B00,186936,Staff,25,0,25,0
1683302237058,NANO 11,A00,204702,Lipomi; Darren John,0,0,0,0
1683302238088,NANO 15,A01,204709,Yang; Kesong,0,1,0,0
1683302239112,NANO 114,A00,202069,Jahed Motlagh; Zeinab,3,0,10,7
1683302240136,PHIL 1,A00,186955,Grush; Rick Scott,32,0,40,8
1683302241160,PHIL 10,A01,186973,Grush; Rick Scott,29,0,35,6
1683302241160,PHIL 10,A02,186974,Grush; Rick Scott,33,0,35,2
1683302242187,PHIL 13,A01,186976,Staff,7,0,35,28
1683302242187,PHIL 13,A02,186977,Staff,16,0,35,19
1683302243211,PHIL 14,A01,186979,Staff,31,0,35,4
1683302243211,PHIL 14,A02,186986,Staff,32,0,35,3
1683302244275,PHIL 28,A01,186988,Staff,16,0,30,14
1683302244275,PHIL 28,A02,186989,Staff,1,0,30,29
1683302244275,PHIL 28,A03,186990,Staff,9,0,30,21
1683302244275,PHIL 28,A04,186991,Staff,26,0,30,4
1683302245302,PHIL 120,A00,186997,Staff,23,0,40,17
1683302246326,PHIL 137,A00,187003,Staff,9,0,40,31
1683302247354,PHIL 150,A00,187015,Staff,47,0,70,23
1683302248380,PHIL 167,A00,187021,Lamey; Andy M.,35,0,40,5
1683302249404,PHIL 174,A01,202226,Staff,17,0,20,3
1683302249404,PHIL 174,A02,202235,Staff,20,0,20,0
1683302250428,PHIL 191A,A00,258918,Staff,0,0,1,1
1683302251454,PHYS 1A,A00,187028,Staff,26,0,60,34
1683302252478,PHYS 1AL,001,187036,Staff,2,0,30,28
1683302252478,PHYS 1AL,002,187049,Staff,18,0,30,12
1683302253501,PHYS 1B,A00,187058,Staff,23,0,60,37
1683302254529,PHYS 1BL,001,187064,Staff,0,0,30,30
1683302254529,PHYS 1BL,002,187070,Staff,6,0,30,24
1683302255553,PHYS 1C,A00,187082,Staff,32,0,120,88
1683302256581,PHYS 1CL,001,187088,Staff,0,9,30,30
1683302256581,PHYS 1CL,002,187089,Staff,0,2,30,30
1683302256581,PHYS 1CL,009,262693,Staff,12,0,30,18
1683302257605,PHYS 2B,A01,187097,Staff,54,0,115,61
1683302258633,PHYS 2C,A01,187099,Staff,67,0,115,48
1683302259661,PHYS 2CL,A01,187101,Staff,5,0,28,23
1683302259661,PHYS 2CL,A02,187102,Staff,15,0,28,13
1683302260691,PHYS 2D,A01,187123,Shotwell; Brian,95,0,115,20
1683302261719,PHYS 4B,A01,187133,Grinstein; Benjamin,35,0,50,15
1683302262743,POLI 10,A00,188819,Staff,0,3,50,50
1683302263771,POLI 11,A00,188827,Staff,43,0,50,7
1683302264798,POLI 13R,A00,188828,Staff,0,1,20,20
1683302265878,POLI 27,A01,188830,Elgin; Samuel Zincke,0,1,70,70
1683302266902,POLI 30,A00,188832,Desposato; Scott,33,0,50,17
1683302267929,POLI 102F,A00,188834,Staff,3,0,40,37
1683302268952,POLI 104A,A00,188852,Staff,14,0,30,16
1683302269976,POLI 104I,A00,188853,Staff,0,6,20,20
1683302271004,POLI 110B,A00,188854,Wiens; David,7,0,20,13
1683302272032,POLI 112A,A00,188855,Wiens; David,5,0,30,25
1683302273054,POLI 117R,A00,188856,Forman; Fonna,0,11,20,20
1683302274078,POLI 118,A00,188857,Ingham; Sean,8,0,20,12
1683302275104,POLI 120G,A00,188858,Staff,9,0,30,21
1683302276132,POLI 131CR,A00,188863,Hoston; Germaine,24,0,50,26
1683302277154,POLI 133,A00,188864,Nellis; Gareth Hb,44,0,50,6
1683302278177,POLI 134D,A00,188865,Desposato; Scott,27,0,30,3
1683302279201,POLI 142A,A00,188871,Gartzke; Erik,22,0,50,28
1683302280225,POLI 142K,A00,188874,Staff,38,0,50,12
1683302281249,POLI 143,A00,188940,Gartzke; Erik,16,0,30,14
1683302282274,POLI 153,A00,188943,Staff,3,0,20,17
1683302283299,POLI 160AA,A00,188944,Staff,13,0,40,27
1683302284327,POLI 170A,A00,188945,Staff,11,0,30,19
1683302286381,PSYC 1,A00,188952,Staff,38,0,90,52
1683302287404,PSYC 2,B00,188953,Staff,20,0,35,15
1683302288428,PSYC 6,A00,188970,Staff,47,0,60,13
1683302289453,PSYC 7,A00,188973,Staff,37,0,45,8
1683302290478,PSYC 60,A01,188980,Rickard; Timothy C.,43,0,60,17
1683302291503,PSYC 70,A01,189001,Steiner; Eric Tomas,24,0,45,21
1683302292528,PSYC 100,A00,189005,Lacefield; Katharine I,0,99,120,120
1683302293553,PSYC 102,A00,189008,Staff,10,0,30,20
1683302294582,PSYC 106,B00,189026,Gorman; Michael R.,37,0,60,23
1683302295607,PSYC 114,B01,189033,Winkielman; Piotr,0,32,30,30
1683302296635,PSYC 131,A00,189036,Anagnostaras; Stephan,0,43,60,60
1683302297658,PSYC 136,A00,189041,Lowe; Angela Beth,0,7,25,25
1683302298686,PSYC 137,A00,189057,Winkielman; Piotr,0,34,25,25
1683302299711,PSYC 144,A00,189107,Wixted; John T,0,7,50,50
1683302301766,PSYC 162,A00,189142,Staff,0,8,85,85
1683302302791,PSYC 172,A00,189144,Gorman; Michael R.,0,7,30,30
1683302304843,PSYC 179,A00,189146,Lacefield; Katharine I,0,84,120,120
1683302305870,PSYC 181,A00,189147,Anagnostaras; Stephan,0,44,90,90
1683302306893,PSYC 190R,A00,189148,Barner; David A.,0,22,80,80
1683302307920,PSYC 191,A00,189275,Rickard; Timothy C.,0,7,25,25
1683302308945,PSYC 193,A00,189276,Chapman; Eddie Nathaniel,0,1,0,4
1683302309975,PSYC 193L,A01,189281,Lowe; Angela Beth,12,0,20,8
1683302309975,PSYC 193L,B01,189285,Staff,28,0,35,7
1683302311004,RELI 149,A00,187137,Rahimi; Babak,7,0,40,33
1683302312030,SE 9,A01,187315,Staff,0,2,18,18
1683302313054,SE 101B,A00,187409,Staff,24,0,30,6
1683302314081,SE 110B,A00,187444,Staff,10,0,40,30
1683302315107,SE 130B,A00,187449,Staff,31,0,40,9
1683302316131,SE 150A,A00,187516,Staff,9,0,20,11
1683302317156,SE 154,A00,187528,Staff,30,0,50,20
1683302318180,SIO 3,A01,258171,Staff,35,0,40,5
1683302319205,SIO 10,A00,187144,Cook; Geoffrey W,0,3,75,75
1683302320232,SIO 45,A00,187152,Cook; Geoffrey W,1,0,100,99
1683302321257,SIO 109R,A00,194486,Staff,0,3,20,20
1683302323306,SIO 187,A01,187233,Kacev; David,12,0,40,28
1683302324331,SOCI 1,A01,258656,Thorpe; Charles Robert,28,0,30,2
1683302324331,SOCI 1,A02,258658,Thorpe; Charles Robert,30,0,30,0
1683302324331,SOCI 1,A03,258661,Thorpe; Charles Robert,25,0,25,0
1683302324331,SOCI 1,A04,258666,Thorpe; Charles Robert,22,0,25,3
1683302324331,SOCI 1,A05,258897,Thorpe; Charles Robert,23,0,25,2
1683302324331,SOCI 1,A06,258898,Thorpe; Charles Robert,25,0,25,0
1683302325358,SOCI 30,A01,258903,Pardo Guerra; Juan Pablo,16,0,30,14
1683302326381,SOCI 102,A00,258904,Staff,9,0,25,16
1683302327406,SOCI 106,A00,258905,Staff,19,0,25,6
1683302328435,SOCI 111,A00,258907,Ribas Norris; Janet Vanesa,26,0,30,4
1683302329458,SOCI 121R,A00,258908,Pardo Guerra; Juan Pablo,11,0,30,19
1683302330483,SOCI 126,A01,203330,Staff,14,0,20,6
1683302331514,SOCI 131,A00,258909,Thorpe; Charles Robert,31,0,60,29
1683302332542,SOCI 135,A00,258910,Payne; Christine Anna,0,9,30,30
1683302333567,SOCI 157,A00,258911,Staff,13,0,30,17
1683302334594,SOCI 184,A00,258912,Staff,26,0,30,4
1683302335623,SOCI 188D,A00,258913,Staff,21,0,30,9
1683302336648,SYN 2,001,187529,Staff,9,0,16,7
1683302336648,SYN 2,002,201452,Staff,0,18,16,16
1683302336648,SYN 2,003,201469,Staff,3,0,16,13
1683302337674,SYN 100,A01,187531,Staff,0,9,20,20
1683302337674,SYN 100,B01,201491,Staff,0,12,20,20
1683302338699,TDAC 1,A00,189286,Walsh; Kim C.,3,0,20,17
1683302338699,TDAC 1,B00,189287,Harting; Carla Kelso,11,0,20,9
1683302339722,TDAC 101,A00,189300,Walsh; Kim C.,16,0,20,4
1683302339722,TDAC 101,B00,189301,Harting; Carla Kelso,18,0,20,2
1683302340746,TDAC 102,A00,189304,Basso; Beatrice,14,0,20,6
1683302341773,TDAC 108,A00,189305,Staff,18,0,20,2
1683302342801,TDDE 131,A00,189310,Staff,19,0,20,1
1683302342801,TDDE 131,B00,189314,Staff,19,0,20,1
1683302342801,TDDE 131,C00,189315,Staff,48,0,50,2
1683302342801,TDDE 131,D00,189316,Staff,14,0,15,1
1683302342801,TDDE 131,E00,204841,Staff,20,0,20,0
1683302343826,TDGE 10,A00,189289,Staff,30,0,50,20
1683302343826,TDGE 10,B00,189290,Havis; Allan,2,0,50,48
1683302344851,TDGE 11,A00,189291,Fulton; Julia,0,3,50,50
1683302344851,TDGE 11,B00,189292,Staff,20,0,25,5
1683302344851,TDGE 11,C00,260270,Staff,0,0,0,0
1683302345876,TDGE 25,A00,189294,Staff,3,0,20,17
1683302346903,TDGE 124,A00,189318,Fulton; Julia,0,8,50,50
1683302347930,TDGE 125,A00,189319,Staff,13,0,25,12
1683302347930,TDGE 125,B00,189320,Staff,23,0,25,2
1683302348953,TDGE 127,A00,189322,Havis; Allan,0,0,50,50
1683302349981,TDHT 101,A00,189323,Staff,18,0,25,7
1683302349981,TDHT 101,B00,189324,Staff,25,0,25,0
1683302351005,TDHT 102,A00,189325,Staff,49,0,50,1
1683302352032,TDMV 1,A00,189295,Arcidiacono; Kristin,20,0,30,10
1683302352032,TDMV 1,B00,189296,Caligagan; Maria T.,24,0,30,6
1683302353056,TDMV 2,A00,189297,Sammartano; Tonnie,28,0,30,2
1683302353056,TDMV 2,B00,189299,Arcidiacono; Kristin,24,0,30,6
1683302354083,TDMV 3,A00,204998,Rincon; Alicia,22,0,30,8
1683302355107,TDMV 120,A00,189458,Sammartano; Tonnie,28,0,30,2
1683302356134,TDMV 138,A00,189541,Jun; Grace Shin Hae,22,0,40,18
1683302357161,TDMV 142,A00,189717,Caligagan; Tony,23,0,30,7
1683302357161,TDMV 142,B00,189718,Caligagan; Maria T.,25,0,30,5
1683302358188,TMC 2,A01,187533,Staff,25,0,25,0
1683302358188,TMC 2,A02,187534,Staff,25,0,25,0
1683302359215,USP 1,A01,187536,Kwak; Nancy,0,16,25,25
1683302360239,USP 5,A01,187538,Staff,9,0,25,16
1683302361263,USP 101,A00,199253,Staff,0,4,0,0
1683302362286,USP 124,A00,187562,Boomhower; Matthew Charles,1,0,30,29
1683302363310,USP 138,A00,187582,Staff,20,0,25,5
1683302364339,USP 152,A01,187597,Staff,4,0,25,21
1683302365364,USP 153,A00,187598,Staff,19,0,25,6
1683302366388,USP 168,A00,187607,Kwak; Nancy,2,0,5,3
1683302367411,USP 173,A00,187619,Staff,4,0,25,21
1683302368437,USP 181,A00,187638,Staff,0,0,25,25
1683302369519,VIS 103,A00,187650,Cruz; Edwin Teddy,23,0,75,52
1683302370543,VIS 110D,A00,187669,Staff,12,0,22,10
1683302371572,VIS 127C,A00,187720,Shen; Kuiyi,68,0,146,78
1683302372599,VIS 149,A00,187731,Yoldas; Pinar,0,14,22,22
1683302373623,VIS 151,A01,188091,Staff,22,0,34,12
1683302373623,VIS 151,A02,188092,Staff,11,0,34,23
1683302374651,VIS 160B,A00,188093,Stalbaum; Brett,0,0,10,10
1683302376704,WCWP 10B,A00,201720,Staff,10,0,15,5
1683302376704,WCWP 10B,B00,201722,Staff,8,0,15,7
1683302377729,WCWP 100,A00,201725,Gagnon; Jeffrey C,0,0,2,2
1683302377729,WCWP 100,B00,201727,Staff,0,4,15,15
1683302380823,ANBI 133,A00,258401,Wilder; Linnea Lorene,34,0,40,6
1683302381847,ANBI 140,A00,258395,Hrvoj Mihic; Branka,18,0,25,7
1683302382871,ANSC 120,A00,258402,Bialecki; Jon Anthony,27,0,40,13
1683302383895,ANSC 144,A00,258400,Staff,14,0,40,26
1683302385944,ANSC 166,A00,258396,Parish; Steven Martin,157,0,175,18
1683302386971,ANSC 180,A00,193533,Staff,9,0,20,11
1683302387996,ANSC 188,A00,258397,Jassal; Aftab,33,0,40,7
1683302389020,ANTH 3,A01,258316,Staff,23,0,30,7
1683302390045,ANTH 5,A00,258394,Semendeferi; Ekaterini,16,0,20,4
1683302391074,ANTH 21,A01,258331,Staff,9,0,40,31
1683302392100,ANTH 103,A00,258398,Varma; Saiba,15,0,25,10
1683302393128,AWP 10,001,202034,Staff,0,0,0,0
1683302393128,AWP 10,002,202035,Staff,0,0,0,0
1683302393128,AWP 10,003,202036,Staff,0,0,0,0
1683302393128,AWP 10,004,202037,Staff,0,0,0,0
1683302393128,AWP 10,005,202038,Staff,0,0,0,0
1683302393128,AWP 10,006,202039,Staff,0,0,0,0
1683302393128,AWP 10,007,202040,Staff,0,0,0,0
1683302393128,AWP 10,008,202041,Staff,0,0,0,0
1683302393128,AWP 10,009,202042,Staff,0,0,0,0
1683302393128,AWP 10,010,202043,Staff,0,0,0,0
1683302393128,AWP 10,011,202044,Staff,0,0,0,0
1683302393128,AWP 10,012,202045,Staff,0,0,0,0
1683302393128,AWP 10,013,202046,Staff,0,0,0,0
1683302393128,AWP 10,014,202047,Staff,0,0,0,0
1683302393128,AWP 10,015,202048,Staff,0,0,0,0
1683302393128,AWP 10,016,202049,Staff,0,0,0,0
1683302393128,AWP 10,017,202050,Staff,0,0,0,0
1683302393128,AWP 10,018,202051,Staff,0,0,0,0
1683302393128,AWP 10,019,202052,Staff,0,0,0,0
1683302393128,AWP 10,020,202053,Staff,0,0,0,0
1683302393128,AWP 10,021,202054,Staff,0,0,0,0
1683302393128,AWP 10,022,202055,Staff,0,0,0,0
1683302393128,AWP 10,023,202056,Staff,0,0,0,0
1683302393128,AWP 10,024,202057,Staff,0,0,0,0
1683302393128,AWP 10,025,202058,Staff,0,0,0,0
1683302393128,AWP 10,026,202059,Staff,0,0,0,0
1683302394151,AWP 102,001,202032,Staff,0,0,0,0
1683302394151,AWP 102,002,202033,Staff,0,0,0,0
1683302395174,BENG 100,A01,254234,Taylor Amos; Alyssa C,31,0,40,9
1683302396198,BENG 196,001,270013,Engler; Adam J.,9999,0,9999,0
1683302397230,BICD 100R,A01,202018,Smith; Laurie,0,7,32,32
1683302397230,BICD 100R,A02,202019,Smith; Laurie,0,2,32,32
1683302397230,BICD 100R,A03,202020,Smith; Laurie,0,1,32,32
1683302397230,BICD 100R,A04,202021,Smith; Laurie,8,0,32,24
1683302397230,BICD 100R,A05,202022,Smith; Laurie,12,0,32,20
1683302398256,BICD 136,A01,193242,Gustafson-Brown; Cindy,0,2,32,32
1683302398256,BICD 136,A02,193244,Gustafson-Brown; Cindy,15,0,32,17
1683302399286,BIEB 102,A01,193249,Butler; Shannon Rhey,0,2,32,32
1683302399286,BIEB 102,A02,193251,Butler; Shannon Rhey,0,0,32,32
1683302399286,BIEB 102,A03,193253,Butler; Shannon Rhey,0,1,32,32
1683302399286,BIEB 102,A04,193255,Butler; Shannon Rhey,17,0,32,15
1683302399286,BIEB 102,A05,193265,Butler; Shannon Rhey,26,0,32,6
1683302399286,BIEB 102,A06,193269,Butler; Shannon Rhey,16,0,32,16
1683302401340,BIEB 150,A01,193274,Staff,0,0,32,32
1683302401340,BIEB 150,A02,193285,Staff,24,0,32,8
1683302402366,BIEB 194,A00,193286,Kurle; Carolyn M.,22,0,32,10
1683302403390,BILD 1,A01,192291,Staff,16,0,32,16
1683302403390,BILD 1,A02,192292,Staff,30,0,32,2
1683302403390,BILD 1,B01,192520,Reuther; Keefe,0,1,0,0
1683302403390,BILD 1,B02,192532,Reuther; Keefe,0,1,0,0
1683302404417,BILD 3,A01,192556,Butler; Shannon Rhey,0,0,32,32
1683302404417,BILD 3,A02,192581,Butler; Shannon Rhey,5,0,32,27
1683302404417,BILD 3,A03,192611,Butler; Shannon Rhey,23,0,32,9
1683302404417,BILD 3,A04,192612,Butler; Shannon Rhey,25,0,32,7
1683302404417,BILD 3,A05,192613,Butler; Shannon Rhey,27,0,32,5
1683302404417,BILD 3,A06,192679,Butler; Shannon Rhey,27,0,32,5
1683302404417,BILD 3,A07,192682,Butler; Shannon Rhey,22,0,32,10
1683302405440,BILD 4,A01,192836,Reuther; Keefe,1,0,24,23
1683302405440,BILD 4,A02,193044,Reuther; Keefe,4,0,24,20
1683302406463,BILD 10,A01,193142,Gustafson-Brown; Cindy,31,0,32,1
1683302406463,BILD 10,A02,193149,Gustafson-Brown; Cindy,31,0,32,1
1683302407491,BIMM 100,A01,193301,Staff,0,6,32,32
1683302407491,BIMM 100,A02,193312,Staff,0,5,32,32
1683302407491,BIMM 100,A03,193323,Staff,0,8,32,32
1683302408521,BIMM 101,A01,193329,McDonnell; Lisa Marie,0,3,24,24
1683302408521,BIMM 101,A02,193339,McDonnell; Lisa Marie,0,2,24,24
1683302408521,BIMM 101,B01,193354,McDonnell; Lisa Marie,0,3,24,24
1683302408521,BIMM 101,B02,193357,McDonnell; Lisa Marie,0,3,24,24
1683302409546,BIMM 110,A01,193377,Tat; John,0,11,32,32
1683302409546,BIMM 110,A02,193378,Tat; John,1,9,32,31
1683302410575,BIMM 120,A01,206116,Staff,0,0,32,32
1683302410575,BIMM 120,A02,206117,Staff,8,0,32,24
1683302410575,BIMM 120,A03,206121,Staff,21,0,32,11
1683302411604,BIPN 100,A01,193393,Park; Ji Young,0,14,32,32
1683302411604,BIPN 100,A02,193402,Park; Ji Young,0,12,32,32
1683302411604,BIPN 100,A03,193413,Park; Ji Young,0,14,32,32
1683302411604,BIPN 100,A04,193414,Park; Ji Young,0,13,32,32
1683302412631,BIPN 102,A01,193429,Staff,0,0,32,32
1683302412631,BIPN 102,A02,193438,Staff,23,0,32,9
1683302413654,BIPN 106,A01,193450,Reyes Gonzalez; Catalina,0,2,40,40
1683302414684,BIPN 134,A01,193465,Cooke; James Edward,0,0,32,32
1683302414684,BIPN 134,A02,193474,Cooke; James Edward,27,0,32,5
1683302414684,BIPN 134,A03,193485,Cooke; James Edward,29,0,32,3
1683302414684,BIPN 134,A04,193486,Cooke; James Edward,21,0,32,11
1683302414684,BIPN 134,A05,193491,Cooke; James Edward,31,0,32,1
1683302414684,BIPN 134,A06,193501,Cooke; James Edward,30,0,32,2
1683302414684,BIPN 134,A07,193510,Cooke; James Edward,29,0,32,3
1683302416732,BISP 194,A00,222522,Staff,16,0,32,16
1683302417758,CAT 124,A01,202407,Staff,20,0,25,5
1683302418782,CAT 125,A00,202408,Marchisotto; Jennifer Anne,4,0,20,16
1683302419807,CAT 125R,A00,202409,Smith; Lauryn Alissa,0,11,20,20
1683302419807,CAT 125R,B00,202410,Morales; Celeste Georgianna,0,11,20,20
1683302419807,CAT 125R,C00,202411,Irwin; Matthew Joseph,0,10,20,20
1683302420832,CENG 15,A01,204712,Yang; Kesong,0,1,0,0
1683302421861,CENG 114,A00,202070,Jahed Motlagh; Zeinab,5,0,20,15
1683302422889,CGS 105,A00,185477,Wesling; Megan E.,24,0,40,16
1683302423915,CGS 106,A00,185494,Staff,13,0,22,9
1683302424939,CGS 108,A00,185495,Staff,14,0,20,6
1683302425964,CGS 114,A00,185496,Staff,13,0,18,5
1683302426991,CGS 119,A00,185501,Staff,15,0,20,5
1683302428015,CGS 120,A00,185511,Staff,13,0,20,7
1683302429040,CHEM 4,A01,184675,Bussey; Thomas J,96,0,100,4
1683302430070,CHEM 6A,A01,184677,Staff,35,0,60,25
1683302431092,CHEM 6B,A01,184679,Staff,65,0,100,35
1683302432121,CHEM 6C,A01,184681,Bussey; Thomas J,1,0,50,49
1683302432121,CHEM 6C,A02,184682,Bussey; Thomas J,34,0,50,16
1683302433150,CHEM 40A,A01,184684,Albizati; Kim F.,37,0,100,63
1683302434173,CHEM 40B,A01,184686,Albizati; Kim F.,0,20,100,100
1683302435200,CHEM 41B,A01,184690,Staff,52,0,100,48
1683302436224,COGS 3,A01,184715,Boyle; Mary E. T.,0,25,40,40
1683302437250,COGS 14B,A01,185172,Staff,0,15,38,38
1683302438277,COGS 18,A01,184736,Staff,20,0,80,60
1683302439302,COGS 100,A01,184932,Staff,0,5,73,73
1683302440326,COGS 101A,A01,184935,Staff,0,38,30,30
1683302441350,COGS 101B,A01,184944,Staff,0,2,30,30
1683302442377,COGS 101C,A01,184946,Staff,0,12,30,30
1683302443404,COGS 102A,A01,184951,Johnson; Christine M.,2,0,40,38
1683302444433,COGS 107B,A01,184953,Mooshagian; Eric Frederick,0,50,40,40
1683302445461,COGS 118B,A01,184959,Gupta; Anjum,0,48,40,40
1683302446489,COGS 153,A00,184961,Staff,0,15,30,30
1683302447516,COGS 177,A00,184962,Staff,0,21,30,30
1683302448541,COGS 187A,A01,184969,Boyle; Mary E. T.,0,17,40,40
1683302449565,COMM 10,A01,185174,Staff,0,5,25,25
1683302449565,COMM 10,A02,185189,Staff,0,5,25,25
1683302449565,COMM 10,A03,269821,Staff,0,0,0,0
1683302450592,COMM 100B,A01,185475,Staff,0,0,0,2
1683302450592,COMM 100B,A02,185476,Staff,14,0,25,11
1683302451616,COMM 100C,A01,185314,Staff,1,0,25,24
1683302451616,COMM 100C,A02,185327,Staff,19,0,25,6
1683302452643,COMM 110M,A00,185349,Staff,2,0,40,38
1683302453666,COMM 113T,A00,185352,Staff,25,0,40,15
1683302454693,COMM 114I,A00,185353,Staff,33,0,40,7
1683302455719,COMM 131,A00,185354,Staff,19,0,30,11
1683302456744,CSE 8A,A50,185358,Cao; Yingjun,0,46,10,10
1683302457771,CSE 8B,A01,185362,Staff,1,47,50,49
1683302458798,CSE 11,A01,185416,Cao; Yingjun,0,93,10,10
1683302459825,CSE 20,A01,185445,Briones; Jor-el Thomas Caparas,5,0,25,20
1683302460850,CSE 21,A01,185447,Staff,10,0,50,40
1683302461877,CSE 101,A01,185451,Staff,0,12,50,50
1683302461877,CSE 101,B01,185453,Jones; Miles E,0,11,50,50
1683302463926,CSE 141,A01,185458,Eldon; John,20,0,100,80
1683302464955,CSE 141L,A01,185461,Eldon; John,12,0,100,88
1683302465979,CSE 142,A01,185463,Staff,35,0,60,25
1683302465979,CSE 142,B01,201355,Staff,0,6,60,60
1683302467003,CSE 142L,A01,185470,Staff,35,0,60,25
1683302467003,CSE 142L,B01,201417,Staff,0,5,60,60
1683302468030,CSE 190,A00,201433,Staff,32,0,49,17
1683302469056,DOC 1,A01,259136,Strom; Megan C.,8,0,15,7
1683302469056,DOC 1,A02,259137,Strom; Megan C.,14,0,15,1
1683302469056,DOC 1,A03,259138,Strom; Megan C.,14,0,15,1
1683302469056,DOC 1,A04,259139,Strom; Megan C.,14,0,15,1
1683302470080,DOC 100D,A00,259140,Pass; Natalye Joann,17,0,25,8
1683302471105,DSGN 1,A01,184749,Rill; Bryan,0,24,30,30
1683302472129,DSGN 100,A01,185168,Staff,0,2,25,25
1683302473210,ECE 5,A01,185626,Morris; Karcher William,0,10,0,0
1683302474237,ECE 101,A01,185628,Staff,17,0,70,53
1683302475262,ECE 107,A01,185635,Baghdadchi; Saharnaz,0,0,20,20
1683302475262,ECE 107,A02,185638,Baghdadchi; Saharnaz,4,0,20,16
1683302476288,ECE 148,A01,185647,Silberman; Jack,1,0,16,15
1683302477313,ECON 1,A01,185537,Crane; Meredith Helen,54,0,70,16
1683302478336,ECON 3,A01,185549,Crane; Meredith Helen,33,0,70,37
1683302479366,ECON 4,A01,203354,Anderson; John Charles,0,4,10,10
1683302480392,ECON 100A,A01,185574,Staff,0,4,40,40
1683302481421,ECON 100B,A01,185576,Staff,0,22,40,40
1683302482448,ECON 100C,A01,185589,Newhouse; Herbert S,30,0,70,40
1683302483472,ECON 105,A00,185608,Vespa; Emanuel Ignacio,19,0,35,16
1683302484499,ECON 109,A01,185610,Shishkin; Denis,10,0,35,25
1683302485522,ECON 110A,A01,185612,Staff,11,0,40,29
1683302486550,ECON 120A,A01,185615,Staff,20,0,40,20
1683302487578,ECON 120C,A01,185617,Sun; Yixiao,0,20,70,70
1683302488602,ECON 144,A00,203346,Squires; Dale E,3,0,35,32
1683302489629,ECON 171,A01,203349,Newhouse; Herbert S,0,1,35,35
1683302490657,ECON 173A,A01,185621,Toda; Alexis Akira,21,0,35,14
1683302491688,EDS 25,A01,202413,Staff,0,1,0,0
1683302491688,EDS 25,A02,202414,Staff,0,1,0,0
1683302491688,EDS 25,A03,202415,Staff,0,0,0,0
1683302491688,EDS 25,A04,202416,Staff,0,1,0,0
1683302491688,EDS 25,A05,202439,Staff,0,0,0,0
1683302491688,EDS 25,A06,202440,Staff,0,0,0,0
1683302491688,EDS 25,B01,202631,Staff,0,0,0,0
1683302491688,EDS 25,B02,202632,Staff,0,0,0,0
1683302491688,EDS 25,B03,202639,Staff,0,0,0,0
1683302491688,EDS 25,B04,202640,Staff,0,0,0,0
1683302491688,EDS 25,B05,202643,Staff,0,0,0,0
1683302491688,EDS 25,B06,202644,Staff,0,0,0,0
1683302492713,EDS 38,A01,202659,Black; Alison Michelle,24,0,25,1
1683302493739,EDS 115,A00,202652,Staff,17,0,30,13
1683302494763,EDS 125,A00,202649,Staff,14,0,30,16
1683302495788,EDS 126,A01,203332,Staff,30,0,30,0
1683302496812,EDS 139,A00,202838,Staff,17,0,25,8
1683302497836,EDS 146,A01,202655,Staff,15,0,25,10
1683302498867,ENG 15,A00,185667,Staff,0,1,0,0
1683302498867,ENG 15,B00,185672,Staff,0,0,0,0
1683302498867,ENG 15,C00,185675,Staff,0,0,0,0
1683302498867,ENG 15,D00,185682,Staff,0,0,0,0
1683302498867,ENG 15,E00,185684,Staff,0,0,0,0
1683302499894,ETHN 103,A00,185710,Staff,0,3,35,35
1683302500918,ETHN 103A,A00,199228,Man; Simeon S,2,0,9,7
1683302501942,ETHN 109,A00,185711,Staff,18,0,35,17
1683302502966,ETHN 142,A00,185726,Staff,0,4,30,30
1683302503990,ETHN 163J,A00,199229,Man; Simeon S,6,0,8,2
1683302505017,ETHN 168,A00,185727,Staff,8,0,10,2
1683302506043,ETHN 182,A00,185728,Staff,1,0,35,34
1683302507066,ETHN 183,A00,185737,Staff,8,0,18,10
1683302508093,GLBH 111,A01,209361,Burgos; Jose L.,0,0,0,0
1683302510143,HIEU 104,A00,185792,Staff,16,0,20,4
1683302511167,HIEU 115,A00,185800,Staff,1,0,20,19
1683302512193,HIEU 128,A00,185801,Staff,0,7,20,20
1683302513218,HIEU 147,A00,185802,Staff,16,0,20,4
1683302514244,HIEU 154,A00,185823,Staff,12,0,20,8
1683302515267,HILA 102,A00,185826,Staff,13,0,20,7
1683302516291,HILD 2C,A01,185778,Staff,0,12,20,20
1683302517315,HILD 7B,A01,185780,Kwak; Nancy,0,15,32,32
1683302517315,HILD 7B,A02,185781,Kwak; Nancy,0,18,32,32
1683302518338,HILD 30,A01,185791,Staff,14,0,20,6
1683302519363,HISC 119,A00,185830,Golan; Tal,0,9,20,20
1683302520390,HITO 156GS,A00,185831,Patterson; Patrick H.,0,0,0,23
1683302521416,HIUS 103,A00,185832,Man; Simeon S,0,6,20,20
1683302522445,HIUS 117,A00,185836,Kwak; Nancy,2,0,20,18
1683302523470,HIUS 125,A00,185840,Man; Simeon S,0,0,23,23
1683302524498,HIUS 149,A00,185845,Staff,0,0,20,20
1683302525523,HUM 3,A01,185882,Zavodny; Tatiana Sophia,0,6,50,50
1683302525523,HUM 3,B01,185899,Caldwell; Michael Alan,0,19,50,50
1683302526546,HUM 3GS,A00,185900,Patterson; Patrick H.,0,0,0,23
1683302527574,HUM 4,A01,185938,Zroka; Amy Liane,31,0,50,19
1683302527574,HUM 4,B01,185956,Watkins; Eric,0,2,50,50
1683302527574,HUM 4,B02,202209,Watkins; Eric,0,1,50,50
1683302527574,HUM 4,B03,202210,Watkins; Eric,0,0,50,50
1683302528598,HUM 5,A01,185958,West; Geoffrey Scott,5,0,50,45
1683302528598,HUM 5,A02,202215,West; Geoffrey Scott,0,0,50,50
1683302529626,INTL 190,A00,185959,Gagnon; Jeffrey C,0,0,0,9
1683302529626,INTL 190,B00,185960,Lettieri; Michael Joseph,0,0,0,1
1683302530650,JAPN 180,A00,254509,Staff,0,1,25,25
1683302531677,LATI 10,A01,202853,Kennemore; Amy Michelle,5,0,35,30
1683302531677,LATI 10,A02,202854,Kennemore; Amy Michelle,1,0,35,34
1683302531677,LATI 10,A03,270054,Kennemore; Amy Michelle,30,0,30,0
1683302532701,LATI 180,A00,202855,Kennemore; Amy Michelle,11,0,20,9
1683302533729,LAWS 101,A00,201767,Golan; Tal,0,7,40,40
1683302534753,LIFR 1C,A00,185961,Staff,6,0,20,14
1683302535777,LIFR 1CX,A00,185962,Staff,7,0,20,13
1683302536802,LIFR 1D,A00,185963,Staff,9,0,20,11
1683302537827,LIFR 1DX,A00,185964,Staff,9,0,20,11
1683302538856,LIGN 101,A01,186039,Staff,43,0,50,7
1683302539883,LIGN 165,A00,186040,Staff,18,0,50,32
1683302540907,LTCS 108,A00,186041,Staff,6,0,10,4
1683302541934,LTCS 119,A00,186042,Staff,16,0,20,4
1683302542958,LTCS 130,A00,186043,Wesling; Megan E.,15,0,25,10
1683302545012,LTEA 138,A00,186119,Staff,14,0,40,26
1683302546037,LTEN 124,A00,186148,Staff,6,0,25,19
1683302547062,LTEN 178,A00,186149,Staff,7,0,15,8
1683302548086,LTEN 181,A00,186150,Blanco; John D,33,0,40,7
1683302549114,LTWL 120,A00,186160,Staff,20,0,25,5
1683302550137,LTWL 165,A00,186161,Staff,22,0,25,3
1683302551159,LTWR 100,A00,186162,Staff,0,4,15,15
1683302552184,LTWR 102,A00,186163,Doller; Ben,5,0,15,10
1683302553207,MAE 8,A01,186412,Staff,0,0,0,0
1683302554234,MAE 30B,A00,186445,Bahadori; Mohammad Yousef,83,0,100,17
1683302555259,MAE 40,A00,186592,Bewley; Thomas R,9,0,50,41
1683302556283,MAE 101B,A00,186593,Bahadori; Mohammad Yousef,81,0,100,19
1683302557310,MAE 105,A00,186594,Bandaru; Prabhakar,12,0,50,38
1683302558337,MAE 107,A00,186599,Pham; Hieu Tan,0,6,120,120
1683302559360,MAE 148,A01,186660,Silberman; Jack,3,0,16,13
1683302560387,MATH 10A,A01,188095,Staff,0,7,35,35
1683302561417,MATH 10B,A01,188097,Bowers; Adam R.,0,11,30,30
1683302561417,MATH 10B,A02,188099,Bowers; Adam R.,0,9,30,30
1683302561417,MATH 10B,B01,188104,Bowers; Adam R.,0,11,30,30
1683302561417,MATH 10B,B02,188106,Bowers; Adam R.,0,11,30,30
1683302562442,MATH 10C,A01,188111,Staff,0,18,30,30
1683302562442,MATH 10C,A02,188127,Staff,0,17,30,30
1683302562442,MATH 10C,A03,188131,Staff,0,17,30,30
1683302562442,MATH 10C,B01,188218,Staff,21,0,30,9
1683302562442,MATH 10C,B02,188244,Staff,13,0,30,17
1683302562442,MATH 10C,B03,188277,Staff,16,0,30,14
1683302563470,MATH 18,A01,188344,Bach; Quang Tran,18,0,30,12
1683302563470,MATH 18,A02,188345,Bach; Quang Tran,11,0,30,19
1683302563470,MATH 18,B01,188353,Bach; Quang Tran,10,0,30,20
1683302563470,MATH 18,B02,188354,Bach; Quang Tran,20,0,30,10
1683302564494,MATH 20A,A01,188374,Staff,13,0,35,22
1683302565522,MATH 20B,A01,188382,Ohm; Ko Woon,6,0,30,24
1683302565522,MATH 20B,A02,188383,Ohm; Ko Woon,24,0,30,6
1683302565522,MATH 20B,B01,188385,Ohm; Ko Woon,7,0,30,23
1683302565522,MATH 20B,B02,188392,Ohm; Ko Woon,22,0,30,8
1683302566551,MATH 20C,A01,188394,Harel; Guershon,10,0,30,20
1683302566551,MATH 20C,A02,188395,Harel; Guershon,13,0,30,17
1683302566551,MATH 20C,B01,188404,Harel; Guershon,3,0,30,27
1683302566551,MATH 20C,B02,188405,Harel; Guershon,19,0,30,11
1683302567576,MATH 20D,A01,188414,Hammock; Frances H,0,1,30,30
1683302567576,MATH 20D,A02,188415,Hammock; Frances H,4,0,30,26
1683302567576,MATH 20D,B01,188447,Hammock; Frances H,2,0,30,28
1683302567576,MATH 20D,B02,188486,Hammock; Frances H,8,0,30,22
1683302568606,MATH 20E,A01,188649,Staff,22,0,30,8
1683302568606,MATH 20E,A02,188650,Staff,23,0,30,7
1683302568606,MATH 20E,A03,188673,Staff,0,0,30,30
1683302569634,MATH 102,A01,188675,Staff,0,35,35,35
1683302570660,MATH 103B,A01,188681,Staff,4,0,35,31
1683302570660,MATH 103B,B01,188692,Staff,7,0,35,28
1683302571688,MATH 109,A01,188695,Salehi Golsefidy; Alireza,25,0,35,10
1683302571688,MATH 109,A02,188696,Salehi Golsefidy; Alireza,27,0,35,8
1683302572713,MATH 120A,A01,188698,Eggers; John Dietrich,5,0,35,30
1683302573741,MATH 142B,A01,188736,Ioana; Adrian,0,2,30,30
1683302573741,MATH 142B,A02,188741,Ioana; Adrian,0,1,30,30
1683302573741,MATH 142B,A03,188743,Ioana; Adrian,0,3,30,30
1683302574765,MATH 168A,A01,188790,Staff,0,8,35,35
1683302575789,MATH 170A,A01,188803,Nie; Jiawang,0,2,35,35
1683302575789,MATH 170A,A02,188811,Nie; Jiawang,0,0,35,35
1683302575789,MATH 170A,A03,188814,Nie; Jiawang,1,0,35,34
1683302575789,MATH 170A,A04,188815,Nie; Jiawang,14,0,35,21
1683302576872,MATH 193B,A01,188817,Staff,0,0,35,35
1683302576872,MATH 193B,A02,188818,Staff,5,0,35,30
1683302577896,MGT 4,A01,202857,Anderson; John Charles,62,0,80,18
1683302578920,MGT 12,A00,202858,Lindenberger; Wade Douglas,43,0,90,47
1683302579944,MGT 18,A00,202859,Staff,74,0,90,16
1683302580968,MGT 18GS,A00,202860,McKay; Michael J,13,0,28,15
1683302581992,MGT 45,A00,202861,Pecore; Joseph P.,14,0,90,76
1683302583016,MGT 100,A00,202863,Yavorsky; Daniel Ryan,28,0,90,62
1683302584040,MGT 103,A00,202864,Ehrich; Kristine R,0,16,90,90
1683302585065,MGT 112,A00,202865,Ehrich; Kristine R,15,0,90,75
1683302586089,MGT 121A,A00,202868,Staff,0,19,0,0
1683302587113,MGT 131B,A00,202869,Anderson; John Charles,59,0,90,31
1683302588137,MGT 136,A00,202871,Lindenberger; Wade Douglas,84,0,90,6
1683302589164,MGT 164,A00,202873,Staff,0,69,90,90
1683302590186,MGT 164GS,A00,202874,McKay; Mary A,13,0,28,15
1683302591211,MGT 180,A00,202875,Staff,0,51,90,90
1683302592234,MMW 11R,A01,205019,Herbst; Matthew,3,0,30,27
1683302592234,MMW 11R,A02,205026,Herbst; Matthew,29,0,30,1
1683302593264,MMW 15,A01,193512,Chang; Edmond Yi-Teh,0,9,28,28
1683302593264,MMW 15,A02,193513,Chang; Edmond Yi-Teh,0,5,28,28
1683302593264,MMW 15,A03,193514,Chang; Edmond Yi-Teh,0,5,28,28
1683302593264,MMW 15,A04,193515,Chang; Edmond Yi-Teh,0,4,28,28
1683302593264,MMW 15,A05,193516,Chang; Edmond Yi-Teh,0,4,28,28
1683302593264,MMW 15,A06,193517,Chang; Edmond Yi-Teh,0,5,28,28
1683302593264,MMW 15,B01,193519,Chang; Edmond Yi-Teh,0,4,28,28
1683302593264,MMW 15,B02,193520,Chang; Edmond Yi-Teh,0,5,28,28
1683302593264,MMW 15,B03,193521,Chang; Edmond Yi-Teh,0,4,28,28
1683302593264,MMW 15,B04,193522,Chang; Edmond Yi-Teh,0,4,28,28
1683302593264,MMW 15,B05,193523,Chang; Edmond Yi-Teh,0,5,28,28
1683302593264,MMW 15,B06,193524,Chang; Edmond Yi-Teh,0,4,28,28
1683302594293,MMW 122,A01,193526,Rahimi; Babak,0,14,28,28
1683302594293,MMW 122,A02,193527,Rahimi; Babak,0,14,28,28
1683302594293,MMW 122,A03,193528,Rahimi; Babak,0,0,0,0
1683302594293,MMW 122,A04,193529,Rahimi; Babak,0,0,0,0
1683302595320,MUS 1A,A01,186663,Staff,0,20,35,35
1683302596343,MUS 4,A01,186715,Staff,0,12,35,35
1683302597366,MUS 5R,A01,186796,Dubnov; Shlomo,0,17,35,35
1683302598394,MUS 6,A01,186798,Staff,0,3,25,25
1683302599417,MUS 7,A01,186830,Staff,12,0,35,23
1683302600442,MUS 8,A01,186930,Staff,0,26,35,35
1683302601471,MUS 15,A01,186932,Staff,0,15,35,35
1683302601471,MUS 15,B01,186934,Staff,0,15,35,35
1683302602495,MUS 80,A00,186935,Staff,2,0,20,18
1683302602495,MUS 80,B00,186936,Staff,25,0,25,0
1683302603522,NANO 11,A00,204702,Lipomi; Darren John,0,0,0,0
1683302604550,NANO 15,A01,204709,Yang; Kesong,0,1,0,0
1683302605574,NANO 114,A00,202069,Jahed Motlagh; Zeinab,3,0,10,7
1683302606598,PHIL 1,A00,186955,Grush; Rick Scott,32,0,40,8
1683302607624,PHIL 10,A01,186973,Grush; Rick Scott,29,0,35,6
1683302607624,PHIL 10,A02,186974,Grush; Rick Scott,33,0,35,2
1683302608650,PHIL 13,A01,186976,Staff,7,0,35,28
1683302608650,PHIL 13,A02,186977,Staff,16,0,35,19
1683302609675,PHIL 14,A01,186979,Staff,31,0,35,4
1683302609675,PHIL 14,A02,186986,Staff,32,0,35,3
1683302610702,PHIL 28,A01,186988,Staff,16,0,30,14
1683302610702,PHIL 28,A02,186989,Staff,1,0,30,29
1683302610702,PHIL 28,A03,186990,Staff,9,0,30,21
1683302610702,PHIL 28,A04,186991,Staff,26,0,30,4
1683302611727,PHIL 120,A00,186997,Staff,23,0,40,17
1683302612751,PHIL 137,A00,187003,Staff,9,0,40,31
1683302613776,PHIL 150,A00,187015,Staff,47,0,70,23
1683302614799,PHIL 167,A00,187021,Lamey; Andy M.,35,0,40,5
1683302615823,PHIL 174,A01,202226,Staff,17,0,20,3
1683302615823,PHIL 174,A02,202235,Staff,20,0,20,0
1683302616848,PHIL 191A,A00,258918,Staff,0,0,1,1
1683302617875,PHYS 1A,A00,187028,Staff,26,0,60,34
1683302618901,PHYS 1AL,001,187036,Staff,2,0,30,28
1683302618901,PHYS 1AL,002,187049,Staff,18,0,30,12
1683302619925,PHYS 1B,A00,187058,Staff,23,0,60,37
1683302620953,PHYS 1BL,001,187064,Staff,0,0,30,30
1683302620953,PHYS 1BL,002,187070,Staff,6,0,30,24
1683302621976,PHYS 1C,A00,187082,Staff,32,0,120,88
1683302623001,PHYS 1CL,001,187088,Staff,0,9,30,30
1683302623001,PHYS 1CL,002,187089,Staff,0,2,30,30
1683302623001,PHYS 1CL,009,262693,Staff,12,0,30,18
1683302624027,PHYS 2B,A01,187097,Staff,54,0,115,61
1683302625056,PHYS 2C,A01,187099,Staff,67,0,115,48
1683302626080,PHYS 2CL,A01,187101,Staff,5,0,28,23
1683302626080,PHYS 2CL,A02,187102,Staff,15,0,28,13
1683302627105,PHYS 2D,A01,187123,Shotwell; Brian,95,0,115,20
1683302628132,PHYS 4B,A01,187133,Grinstein; Benjamin,35,0,50,15
1683302629155,POLI 10,A00,188819,Staff,0,3,50,50
1683302630179,POLI 11,A00,188827,Staff,43,0,50,7
1683302631203,POLI 13R,A00,188828,Staff,0,1,20,20
1683302632231,POLI 27,A01,188830,Elgin; Samuel Zincke,0,1,70,70
1683302633258,POLI 30,A00,188832,Desposato; Scott,33,0,50,17
1683302634286,POLI 102F,A00,188834,Staff,3,0,40,37
1683302635311,POLI 104A,A00,188852,Staff,14,0,30,16
1683302636336,POLI 104I,A00,188853,Staff,0,6,20,20
1683302637364,POLI 110B,A00,188854,Wiens; David,7,0,20,13
1683302638389,POLI 112A,A00,188855,Wiens; David,5,0,30,25
1683302639412,POLI 117R,A00,188856,Forman; Fonna,0,11,20,20
1683302640436,POLI 118,A00,188857,Ingham; Sean,8,0,20,12
1683302641461,POLI 120G,A00,188858,Staff,9,0,30,21
1683302642484,POLI 131CR,A00,188863,Hoston; Germaine,24,0,50,26
1683302643507,POLI 133,A00,188864,Nellis; Gareth Hb,44,0,50,6
1683302644531,POLI 134D,A00,188865,Desposato; Scott,27,0,30,3
1683302645556,POLI 142A,A00,188871,Gartzke; Erik,22,0,50,28
1683302646579,POLI 142K,A00,188874,Staff,38,0,50,12
1683302647615,POLI 143,A00,188940,Gartzke; Erik,16,0,30,14
1683302648639,POLI 153,A00,188943,Staff,3,0,20,17
1683302649668,POLI 160AA,A00,188944,Staff,13,0,40,27
1683302650693,POLI 170A,A00,188945,Staff,11,0,30,19
1683302652743,PSYC 1,A00,188952,Staff,38,0,90,52
1683302653767,PSYC 2,B00,188953,Staff,20,0,35,15
1683302654795,PSYC 6,A00,188970,Staff,47,0,60,13
1683302655821,PSYC 7,A00,188973,Staff,37,0,45,8
1683302656846,PSYC 60,A01,188980,Rickard; Timothy C.,43,0,60,17
1683302657869,PSYC 70,A01,189001,Steiner; Eric Tomas,24,0,45,21
1683302658892,PSYC 100,A00,189005,Lacefield; Katharine I,0,99,120,120
1683302659919,PSYC 102,A00,189008,Staff,10,0,30,20
1683302660943,PSYC 106,B00,189026,Gorman; Michael R.,37,0,60,23
1683302661968,PSYC 114,B01,189033,Winkielman; Piotr,0,32,30,30
1683302662993,PSYC 131,A00,189036,Anagnostaras; Stephan,0,43,60,60
1683302664019,PSYC 136,A00,189041,Lowe; Angela Beth,0,7,25,25
1683302665048,PSYC 137,A00,189057,Winkielman; Piotr,0,34,25,25
1683302666075,PSYC 144,A00,189107,Wixted; John T,0,7,50,50
1683302668125,PSYC 162,A00,189142,Staff,0,8,85,85
1683302669152,PSYC 172,A00,189144,Gorman; Michael R.,0,7,30,30
1683302671203,PSYC 179,A00,189146,Lacefield; Katharine I,0,84,120,120
1683302672226,PSYC 181,A00,189147,Anagnostaras; Stephan,0,44,90,90
1683302673251,PSYC 190R,A00,189148,Barner; David A.,0,22,80,80
1683302674276,PSYC 191,A00,189275,Rickard; Timothy C.,0,7,25,25
1683302675303,PSYC 193,A00,189276,Chapman; Eddie Nathaniel,0,1,0,4
1683302676329,PSYC 193L,A01,189281,Lowe; Angela Beth,12,0,20,8
1683302676329,PSYC 193L,B01,189285,Staff,28,0,35,7
1683302677355,RELI 149,A00,187137,Rahimi; Babak,7,0,40,33
1683302678382,SE 9,A01,187315,Staff,0,2,18,18
1683302679407,SE 101B,A00,187409,Staff,24,0,30,6
1683302680487,SE 110B,A00,187444,Staff,10,0,40,30
1683302681515,SE 130B,A00,187449,Staff,31,0,40,9
1683302682538,SE 150A,A00,187516,Staff,9,0,20,11
1683302683561,SE 154,A00,187528,Staff,30,0,50,20
1683302684586,SIO 3,A01,258171,Staff,35,0,40,5
1683302685613,SIO 10,A00,187144,Cook; Geoffrey W,0,3,75,75
1683302686637,SIO 45,A00,187152,Cook; Geoffrey W,1,0,100,99
1683302687664,SIO 109R,A00,194486,Staff,0,3,20,20
1683302689716,SIO 187,A01,187233,Kacev; David,12,0,40,28
1683302690746,SOCI 1,A01,258656,Thorpe; Charles Robert,28,0,30,2
1683302690746,SOCI 1,A02,258658,Thorpe; Charles Robert,30,0,30,0
1683302690746,SOCI 1,A03,258661,Thorpe; Charles Robert,25,0,25,0
1683302690746,SOCI 1,A04,258666,Thorpe; Charles Robert,22,0,25,3
1683302690746,SOCI 1,A05,258897,Thorpe; Charles Robert,23,0,25,2
1683302690746,SOCI 1,A06,258898,Thorpe; Charles Robert,25,0,25,0
1683302691770,SOCI 30,A01,258903,Pardo Guerra; Juan Pablo,16,0,30,14
1683302692796,SOCI 102,A00,258904,Staff,9,0,25,16
1683302693826,SOCI 106,A00,258905,Staff,19,0,25,6
1683302694850,SOCI 111,A00,258907,Ribas Norris; Janet Vanesa,26,0,30,4
1683302695874,SOCI 121R,A00,258908,Pardo Guerra; Juan Pablo,11,0,30,19
1683302696898,SOCI 126,A01,203330,Staff,14,0,20,6
1683302697922,SOCI 131,A00,258909,Thorpe; Charles Robert,31,0,60,29
1683302698947,SOCI 135,A00,258910,Payne; Christine Anna,0,9,30,30
1683302699969,SOCI 157,A00,258911,Staff,13,0,30,17
1683302700995,SOCI 184,A00,258912,Staff,26,0,30,4
1683302702037,SOCI 188D,A00,258913,Staff,21,0,30,9
1683302703061,SYN 2,001,187529,Staff,9,0,16,7
1683302703061,SYN 2,002,201452,Staff,0,18,16,16
1683302703061,SYN 2,003,201469,Staff,3,0,16,13
1683302704085,SYN 100,A01,187531,Staff,0,9,20,20
1683302704085,SYN 100,B01,201491,Staff,0,12,20,20
1683302705108,TDAC 1,A00,189286,Walsh; Kim C.,3,0,20,17
1683302705108,TDAC 1,B00,189287,Harting; Carla Kelso,11,0,20,9
1683302706132,TDAC 101,A00,189300,Walsh; Kim C.,16,0,20,4
1683302706132,TDAC 101,B00,189301,Harting; Carla Kelso,18,0,20,2
1683302707159,TDAC 102,A00,189304,Basso; Beatrice,14,0,20,6
1683302708186,TDAC 108,A00,189305,Staff,18,0,20,2
1683302709212,TDDE 131,A00,189310,Staff,19,0,20,1
1683302709212,TDDE 131,B00,189314,Staff,19,0,20,1
1683302709212,TDDE 131,C00,189315,Staff,48,0,50,2
1683302709212,TDDE 131,D00,189316,Staff,14,0,15,1
1683302709212,TDDE 131,E00,204841,Staff,20,0,20,0
1683302710235,TDGE 10,A00,189289,Staff,30,0,50,20
1683302710235,TDGE 10,B00,189290,Havis; Allan,2,0,50,48
1683302711259,TDGE 11,A00,189291,Fulton; Julia,0,3,50,50
1683302711259,TDGE 11,B00,189292,Staff,20,0,25,5
1683302711259,TDGE 11,C00,260270,Staff,0,0,0,0
1683302712286,TDGE 25,A00,189294,Staff,3,0,20,17
1683302713311,TDGE 124,A00,189318,Fulton; Julia,0,8,50,50
1683302714336,TDGE 125,A00,189319,Staff,13,0,25,12
1683302714336,TDGE 125,B00,189320,Staff,23,0,25,2
1683302715359,TDGE 127,A00,189322,Havis; Allan,0,0,50,50
1683302716386,TDHT 101,A00,189323,Staff,18,0,25,7
1683302716386,TDHT 101,B00,189324,Staff,25,0,25,0
1683302717408,TDHT 102,A00,189325,Staff,49,0,50,1
1683302718431,TDMV 1,A00,189295,Arcidiacono; Kristin,20,0,30,10
1683302718431,TDMV 1,B00,189296,Caligagan; Maria T.,24,0,30,6
1683302719455,TDMV 2,A00,189297,Sammartano; Tonnie,28,0,30,2
1683302719455,TDMV 2,B00,189299,Arcidiacono; Kristin,24,0,30,6
1683302720479,TDMV 3,A00,204998,Rincon; Alicia,22,0,30,8
1683302721503,TDMV 120,A00,189458,Sammartano; Tonnie,28,0,30,2
1683302722529,TDMV 138,A00,189541,Jun; Grace Shin Hae,22,0,40,18
1683302723553,TDMV 142,A00,189717,Caligagan; Tony,23,0,30,7
1683302723553,TDMV 142,B00,189718,Caligagan; Maria T.,25,0,30,5
1683302724580,TMC 2,A01,187533,Staff,25,0,25,0
1683302724580,TMC 2,A02,187534,Staff,25,0,25,0
1683302725608,USP 1,A01,187536,Kwak; Nancy,0,16,25,25
1683302726630,USP 5,A01,187538,Staff,9,0,25,16
1683302727655,USP 101,A00,199253,Staff,0,4,0,0
1683302728679,USP 124,A00,187562,Boomhower; Matthew Charles,1,0,30,29
1683302729703,USP 138,A00,187582,Staff,20,0,25,5
1683302730726,USP 152,A01,187597,Staff,4,0,25,21
1683302731754,USP 153,A00,187598,Staff,19,0,25,6
1683302732777,USP 168,A00,187607,Kwak; Nancy,2,0,5,3
1683302733804,USP 173,A00,187619,Staff,4,0,25,21
1683302734831,USP 181,A00,187638,Staff,0,0,25,25
1683302735857,VIS 103,A00,187650,Cruz; Edwin Teddy,23,0,75,52
1683302736881,VIS 110D,A00,187669,Staff,12,0,22,10
1683302737909,VIS 127C,A00,187720,Shen; Kuiyi,68,0,146,78
1683302738941,VIS 149,A00,187731,Yoldas; Pinar,0,14,22,22
1683302739964,VIS 151,A01,188091,Staff,22,0,34,12
1683302739964,VIS 151,A02,188092,Staff,11,0,34,23
1683302740992,VIS 160B,A00,188093,Stalbaum; Brett,0,0,10,10
1683302743040,WCWP 10B,A00,201720,Staff,10,0,15,5
1683302743040,WCWP 10B,B00,201722,Staff,8,0,15,7
1683302744068,WCWP 100,A00,201725,Gagnon; Jeffrey C,0,0,2,2
1683302744068,WCWP 100,B00,201727,Staff,0,4,15,15
1683302747190,ANBI 133,A00,258401,Wilder; Linnea Lorene,34,0,40,6
1683302748214,ANBI 140,A00,258395,Hrvoj Mihic; Branka,18,0,25,7
1683302749237,ANSC 120,A00,258402,Bialecki; Jon Anthony,27,0,40,13
1683302750264,ANSC 144,A00,258400,Staff,14,0,40,26
1683302752313,ANSC 166,A00,258396,Parish; Steven Martin,157,0,175,18
1683302753337,ANSC 180,A00,193533,Staff,9,0,20,11
1683302754363,ANSC 188,A00,258397,Jassal; Aftab,33,0,40,7
1683302755388,ANTH 3,A01,258316,Staff,23,0,30,7
1683302756414,ANTH 5,A00,258394,Semendeferi; Ekaterini,16,0,20,4
1683302757437,ANTH 21,A01,258331,Staff,9,0,40,31
1683302758464,ANTH 103,A00,258398,Varma; Saiba,15,0,25,10
1683302759496,AWP 10,001,202034,Staff,0,0,0,0
1683302759496,AWP 10,002,202035,Staff,0,0,0,0
1683302759496,AWP 10,003,202036,Staff,0,0,0,0
1683302759496,AWP 10,004,202037,Staff,0,0,0,0
1683302759496,AWP 10,005,202038,Staff,0,0,0,0
1683302759496,AWP 10,006,202039,Staff,0,0,0,0
1683302759496,AWP 10,007,202040,Staff,0,0,0,0
1683302759496,AWP 10,008,202041,Staff,0,0,0,0
1683302759496,AWP 10,009,202042,Staff,0,0,0,0
1683302759496,AWP 10,010,202043,Staff,0,0,0,0
1683302759496,AWP 10,011,202044,Staff,0,0,0,0
1683302759496,AWP 10,012,202045,Staff,0,0,0,0
1683302759496,AWP 10,013,202046,Staff,0,0,0,0
1683302759496,AWP 10,014,202047,Staff,0,0,0,0
1683302759496,AWP 10,015,202048,Staff,0,0,0,0
1683302759496,AWP 10,016,202049,Staff,0,0,0,0
1683302759496,AWP 10,017,202050,Staff,0,0,0,0
1683302759496,AWP 10,018,202051,Staff,0,0,0,0
1683302759496,AWP 10,019,202052,Staff,0,0,0,0
1683302759496,AWP 10,020,202053,Staff,0,0,0,0
1683302759496,AWP 10,021,202054,Staff,0,0,0,0
1683302759496,AWP 10,022,202055,Staff,0,0,0,0
1683302759496,AWP 10,023,202056,Staff,0,0,0,0
1683302759496,AWP 10,024,202057,Staff,0,0,0,0
1683302759496,AWP 10,025,202058,Staff,0,0,0,0
1683302759496,AWP 10,026,202059,Staff,0,0,0,0
1683302760529,AWP 102,001,202032,Staff,0,0,0,0
1683302760529,AWP 102,002,202033,Staff,0,0,0,0
1683302761557,BENG 100,A01,254234,Taylor Amos; Alyssa C,31,0,40,9
1683302762585,BENG 196,001,270013,Engler; Adam J.,9999,0,9999,0
1683302763615,BICD 100R,A01,202018,Smith; Laurie,0,7,32,32
1683302763615,BICD 100R,A02,202019,Smith; Laurie,0,2,32,32
1683302763615,BICD 100R,A03,202020,Smith; Laurie,0,1,32,32
1683302763615,BICD 100R,A04,202021,Smith; Laurie,8,0,32,24
1683302763615,BICD 100R,A05,202022,Smith; Laurie,12,0,32,20
1683302764644,BICD 136,A01,193242,Gustafson-Brown; Cindy,0,2,32,32
1683302764644,BICD 136,A02,193244,Gustafson-Brown; Cindy,15,0,32,17
1683302765669,BIEB 102,A01,193249,Butler; Shannon Rhey,0,2,32,32
1683302765669,BIEB 102,A02,193251,Butler; Shannon Rhey,0,0,32,32
1683302765669,BIEB 102,A03,193253,Butler; Shannon Rhey,0,1,32,32
1683302765669,BIEB 102,A04,193255,Butler; Shannon Rhey,17,0,32,15
1683302765669,BIEB 102,A05,193265,Butler; Shannon Rhey,26,0,32,6
1683302765669,BIEB 102,A06,193269,Butler; Shannon Rhey,16,0,32,16
1683302767721,BIEB 150,A01,193274,Staff,0,0,32,32
1683302767721,BIEB 150,A02,193285,Staff,24,0,32,8
1683302768750,BIEB 194,A00,193286,Kurle; Carolyn M.,22,0,32,10
1683302769774,BILD 1,A01,192291,Staff,16,0,32,16
1683302769774,BILD 1,A02,192292,Staff,30,0,32,2
1683302769774,BILD 1,B01,192520,Reuther; Keefe,0,1,0,0
1683302769774,BILD 1,B02,192532,Reuther; Keefe,0,1,0,0
1683302770799,BILD 3,A01,192556,Butler; Shannon Rhey,0,0,32,32
1683302770799,BILD 3,A02,192581,Butler; Shannon Rhey,5,0,32,27
1683302770799,BILD 3,A03,192611,Butler; Shannon Rhey,23,0,32,9
1683302770799,BILD 3,A04,192612,Butler; Shannon Rhey,25,0,32,7
1683302770799,BILD 3,A05,192613,Butler; Shannon Rhey,27,0,32,5
1683302770799,BILD 3,A06,192679,Butler; Shannon Rhey,27,0,32,5
1683302770799,BILD 3,A07,192682,Butler; Shannon Rhey,22,0,32,10
1683302771824,BILD 4,A01,192836,Reuther; Keefe,1,0,24,23
1683302771824,BILD 4,A02,193044,Reuther; Keefe,4,0,24,20
1683302772850,BILD 10,A01,193142,Gustafson-Brown; Cindy,31,0,32,1
1683302772850,BILD 10,A02,193149,Gustafson-Brown; Cindy,31,0,32,1
1683302773878,BIMM 100,A01,193301,Staff,0,6,32,32
1683302773878,BIMM 100,A02,193312,Staff,0,5,32,32
1683302773878,BIMM 100,A03,193323,Staff,0,8,32,32
1683302774904,BIMM 101,A01,193329,McDonnell; Lisa Marie,0,3,24,24
1683302774904,BIMM 101,A02,193339,McDonnell; Lisa Marie,0,2,24,24
1683302774904,BIMM 101,B01,193354,McDonnell; Lisa Marie,0,3,24,24
1683302774904,BIMM 101,B02,193357,McDonnell; Lisa Marie,0,3,24,24
1683302775929,BIMM 110,A01,193377,Tat; John,0,11,32,32
1683302775929,BIMM 110,A02,193378,Tat; John,1,9,32,31
1683302776954,BIMM 120,A01,206116,Staff,0,0,32,32
1683302776954,BIMM 120,A02,206117,Staff,8,0,32,24
1683302776954,BIMM 120,A03,206121,Staff,21,0,32,11
1683302777983,BIPN 100,A01,193393,Park; Ji Young,0,14,32,32
1683302777983,BIPN 100,A02,193402,Park; Ji Young,0,12,32,32
1683302777983,BIPN 100,A03,193413,Park; Ji Young,0,14,32,32
1683302777983,BIPN 100,A04,193414,Park; Ji Young,0,13,32,32
1683302779014,BIPN 102,A01,193429,Staff,0,0,32,32
1683302779014,BIPN 102,A02,193438,Staff,23,0,32,9
1683302780038,BIPN 106,A01,193450,Reyes Gonzalez; Catalina,0,2,40,40
1683302781063,BIPN 134,A01,193465,Cooke; James Edward,0,0,32,32
1683302781063,BIPN 134,A02,193474,Cooke; James Edward,27,0,32,5
1683302781063,BIPN 134,A03,193485,Cooke; James Edward,29,0,32,3
1683302781063,BIPN 134,A04,193486,Cooke; James Edward,21,0,32,11
1683302781063,BIPN 134,A05,193491,Cooke; James Edward,31,0,32,1
1683302781063,BIPN 134,A06,193501,Cooke; James Edward,30,0,32,2
1683302781063,BIPN 134,A07,193510,Cooke; James Edward,29,0,32,3
1683302783114,BISP 194,A00,222522,Staff,16,0,32,16
1683302784199,CAT 124,A01,202407,Staff,20,0,25,5
1683302785227,CAT 125,A00,202408,Marchisotto; Jennifer Anne,4,0,20,16
1683302786252,CAT 125R,A00,202409,Smith; Lauryn Alissa,0,11,20,20
1683302786252,CAT 125R,B00,202410,Morales; Celeste Georgianna,0,11,20,20
1683302786252,CAT 125R,C00,202411,Irwin; Matthew Joseph,0,10,20,20
1683302787280,CENG 15,A01,204712,Yang; Kesong,0,1,0,0
1683302788303,CENG 114,A00,202070,Jahed Motlagh; Zeinab,5,0,20,15
1683302789331,CGS 105,A00,185477,Wesling; Megan E.,24,0,40,16
1683302790355,CGS 106,A00,185494,Staff,13,0,22,9
1683302791378,CGS 108,A00,185495,Staff,14,0,20,6
1683302792402,CGS 114,A00,185496,Staff,13,0,18,5
1683302793426,CGS 119,A00,185501,Staff,15,0,20,5
1683302794449,CGS 120,A00,185511,Staff,13,0,20,7
1683302795473,CHEM 4,A01,184675,Bussey; Thomas J,96,0,100,4
1683302796501,CHEM 6A,A01,184677,Staff,35,0,60,25
1683302797526,CHEM 6B,A01,184679,Staff,65,0,100,35
1683302798548,CHEM 6C,A01,184681,Bussey; Thomas J,1,0,50,49
1683302798548,CHEM 6C,A02,184682,Bussey; Thomas J,34,0,50,16
1683302799572,CHEM 40A,A01,184684,Albizati; Kim F.,37,0,100,63
1683302800601,CHEM 40B,A01,184686,Albizati; Kim F.,0,20,100,100
1683302801626,CHEM 41B,A01,184690,Staff,52,0,100,48
1683302802651,COGS 3,A01,184715,Boyle; Mary E. T.,0,25,40,40
1683302803676,COGS 14B,A01,185172,Staff,0,15,38,38
1683302804702,COGS 18,A01,184736,Staff,20,0,80,60
1683302805728,COGS 100,A01,184932,Staff,0,5,73,73
1683302806757,COGS 101A,A01,184935,Staff,0,38,30,30
1683302807782,COGS 101B,A01,184944,Staff,0,2,30,30
1683302808807,COGS 101C,A01,184946,Staff,0,12,30,30
1683302809832,COGS 102A,A01,184951,Johnson; Christine M.,2,0,40,38
1683302810857,COGS 107B,A01,184953,Mooshagian; Eric Frederick,0,50,40,40
1683302811886,COGS 118B,A01,184959,Gupta; Anjum,0,48,40,40
1683302812913,COGS 153,A00,184961,Staff,0,15,30,30
1683302813938,COGS 177,A00,184962,Staff,0,21,30,30
1683302814963,COGS 187A,A01,184969,Boyle; Mary E. T.,0,17,40,40
1683302815987,COMM 10,A01,185174,Staff,0,5,25,25
1683302815987,COMM 10,A02,185189,Staff,0,5,25,25
1683302815987,COMM 10,A03,269821,Staff,0,0,0,0
1683302817010,COMM 100B,A01,185475,Staff,0,0,0,2
1683302817010,COMM 100B,A02,185476,Staff,14,0,25,11
1683302818037,COMM 100C,A01,185314,Staff,1,0,25,24
1683302818037,COMM 100C,A02,185327,Staff,19,0,25,6
1683302819061,COMM 110M,A00,185349,Staff,2,0,40,38
1683302820088,COMM 113T,A00,185352,Staff,25,0,40,15
1683302821117,COMM 114I,A00,185353,Staff,33,0,40,7
1683302822142,COMM 131,A00,185354,Staff,19,0,30,11
1683302823167,CSE 8A,A50,185358,Cao; Yingjun,0,46,10,10
1683302824191,CSE 8B,A01,185362,Staff,1,47,50,49
1683302825220,CSE 11,A01,185416,Cao; Yingjun,0,93,10,10
1683302826244,CSE 20,A01,185445,Briones; Jor-el Thomas Caparas,5,0,25,20
1683302827270,CSE 21,A01,185447,Staff,10,0,50,40
1683302828294,CSE 101,A01,185451,Staff,0,12,50,50
1683302828294,CSE 101,B01,185453,Jones; Miles E,0,11,50,50
1683302830350,CSE 141,A01,185458,Eldon; John,20,0,100,80
1683302831374,CSE 141L,A01,185461,Eldon; John,12,0,100,88
1683302832402,CSE 142,A01,185463,Staff,35,0,60,25
1683302832402,CSE 142,B01,201355,Staff,0,6,60,60
1683302833426,CSE 142L,A01,185470,Staff,35,0,60,25
1683302833426,CSE 142L,B01,201417,Staff,0,5,60,60
1683302834450,CSE 190,A00,201433,Staff,32,0,49,17
1683302835479,DOC 1,A01,259136,Strom; Megan C.,8,0,15,7
1683302835479,DOC 1,A02,259137,Strom; Megan C.,14,0,15,1
1683302835479,DOC 1,A03,259138,Strom; Megan C.,14,0,15,1
1683302835479,DOC 1,A04,259139,Strom; Megan C.,14,0,15,1
1683302836507,DOC 100D,A00,259140,Pass; Natalye Joann,17,0,25,8
1683302837530,DSGN 1,A01,184749,Rill; Bryan,0,24,30,30
1683302838555,DSGN 100,A01,185168,Staff,0,2,25,25
1683302839583,ECE 5,A01,185626,Morris; Karcher William,0,10,0,0
1683302840608,ECE 101,A01,185628,Staff,17,0,70,53
1683302841633,ECE 107,A01,185635,Baghdadchi; Saharnaz,0,0,20,20
1683302841633,ECE 107,A02,185638,Baghdadchi; Saharnaz,4,0,20,16
1683302842657,ECE 148,A01,185647,Silberman; Jack,1,0,16,15
1683302843685,ECON 1,A01,185537,Crane; Meredith Helen,54,0,70,16
1683302844710,ECON 3,A01,185549,Crane; Meredith Helen,33,0,70,37
1683302845739,ECON 4,A01,203354,Anderson; John Charles,0,4,10,10
1683302846765,ECON 100A,A01,185574,Staff,0,4,40,40
1683302847792,ECON 100B,A01,185576,Staff,0,22,40,40
1683302848821,ECON 100C,A01,185589,Newhouse; Herbert S,30,0,70,40
1683302849848,ECON 105,A00,185608,Vespa; Emanuel Ignacio,19,0,35,16
1683302850873,ECON 109,A01,185610,Shishkin; Denis,10,0,35,25
1683302851897,ECON 110A,A01,185612,Staff,11,0,40,29
1683302852926,ECON 120A,A01,185615,Staff,20,0,40,20
1683302853954,ECON 120C,A01,185617,Sun; Yixiao,0,20,70,70
1683302854978,ECON 144,A00,203346,Squires; Dale E,3,0,35,32
1683302856002,ECON 171,A01,203349,Newhouse; Herbert S,0,1,35,35
1683302857027,ECON 173A,A01,185621,Toda; Alexis Akira,21,0,35,14
1683302858057,EDS 25,A01,202413,Staff,0,1,0,0
1683302858057,EDS 25,A02,202414,Staff,0,1,0,0
1683302858057,EDS 25,A03,202415,Staff,0,0,0,0
1683302858057,EDS 25,A04,202416,Staff,0,1,0,0
1683302858057,EDS 25,A05,202439,Staff,0,0,0,0
1683302858057,EDS 25,A06,202440,Staff,0,0,0,0
1683302858057,EDS 25,B01,202631,Staff,0,0,0,0
1683302858057,EDS 25,B02,202632,Staff,0,0,0,0
1683302858057,EDS 25,B03,202639,Staff,0,0,0,0
1683302858057,EDS 25,B04,202640,Staff,0,0,0,0
1683302858057,EDS 25,B05,202643,Staff,0,0,0,0
1683302858057,EDS 25,B06,202644,Staff,0,0,0,0
1683302859084,EDS 38,A01,202659,Black; Alison Michelle,24,0,25,1
1683302860109,EDS 115,A00,202652,Staff,17,0,30,13
1683302861132,EDS 125,A00,202649,Staff,14,0,30,16
1683302862156,EDS 126,A01,203332,Staff,30,0,30,0
1683302863182,EDS 139,A00,202838,Staff,17,0,25,8
1683302864209,EDS 146,A01,202655,Staff,15,0,25,10
1683302865237,ENG 15,A00,185667,Staff,0,1,0,0
1683302865237,ENG 15,B00,185672,Staff,0,0,0,0
1683302865237,ENG 15,C00,185675,Staff,0,0,0,0
1683302865237,ENG 15,D00,185682,Staff,0,0,0,0
1683302865237,ENG 15,E00,185684,Staff,0,0,0,0
1683302866260,ETHN 103,A00,185710,Staff,0,3,35,35
1683302867284,ETHN 103A,A00,199228,Man; Simeon S,2,0,9,7
1683302868308,ETHN 109,A00,185711,Staff,18,0,35,17
1683302869332,ETHN 142,A00,185726,Staff,0,4,30,30
1683302870356,ETHN 163J,A00,199229,Man; Simeon S,6,0,8,2
1683302871379,ETHN 168,A00,185727,Staff,8,0,10,2
1683302872404,ETHN 182,A00,185728,Staff,1,0,35,34
1683302873431,ETHN 183,A00,185737,Staff,8,0,18,10
1683302874459,GLBH 111,A01,209361,Burgos; Jose L.,0,0,0,0
1683302876508,HIEU 104,A00,185792,Staff,16,0,20,4
1683302877532,HIEU 115,A00,185800,Staff,1,0,20,19
1683302878559,HIEU 128,A00,185801,Staff,0,7,20,20
1683302879586,HIEU 147,A00,185802,Staff,16,0,20,4
1683302880612,HIEU 154,A00,185823,Staff,12,0,20,8
1683302881640,HILA 102,A00,185826,Staff,13,0,20,7
1683302882665,HILD 2C,A01,185778,Staff,0,12,20,20
1683302883693,HILD 7B,A01,185780,Kwak; Nancy,0,15,32,32
1683302883693,HILD 7B,A02,185781,Kwak; Nancy,0,18,32,32
1683302884718,HILD 30,A01,185791,Staff,14,0,20,6
1683302885746,HISC 119,A00,185830,Golan; Tal,0,9,20,20
1683302886770,HITO 156GS,A00,185831,Patterson; Patrick H.,0,0,0,23
1683302887851,HIUS 103,A00,185832,Man; Simeon S,0,6,20,20
1683302888878,HIUS 117,A00,185836,Kwak; Nancy,2,0,20,18
1683302889902,HIUS 125,A00,185840,Man; Simeon S,0,0,23,23
1683302890929,HIUS 149,A00,185845,Staff,0,0,20,20
1683302891957,HUM 3,A01,185882,Zavodny; Tatiana Sophia,0,6,50,50
1683302891957,HUM 3,B01,185899,Caldwell; Michael Alan,0,19,50,50
1683302892980,HUM 3GS,A00,185900,Patterson; Patrick H.,0,0,0,23
1683302894008,HUM 4,A01,185938,Zroka; Amy Liane,31,0,50,19
1683302894008,HUM 4,B01,185956,Watkins; Eric,0,2,50,50
1683302894008,HUM 4,B02,202209,Watkins; Eric,0,1,50,50
1683302894008,HUM 4,B03,202210,Watkins; Eric,0,0,50,50
1683302895033,HUM 5,A01,185958,West; Geoffrey Scott,5,0,50,45
1683302895033,HUM 5,A02,202215,West; Geoffrey Scott,0,0,50,50
1683302896060,INTL 190,A00,185959,Gagnon; Jeffrey C,0,0,0,9
1683302896060,INTL 190,B00,185960,Lettieri; Michael Joseph,0,0,0,1
1683302897087,JAPN 180,A00,254509,Staff,0,1,25,25
1683302898112,LATI 10,A01,202853,Kennemore; Amy Michelle,5,0,35,30
1683302898112,LATI 10,A02,202854,Kennemore; Amy Michelle,1,0,35,34
1683302898112,LATI 10,A03,270054,Kennemore; Amy Michelle,30,0,30,0
1683302899137,LATI 180,A00,202855,Kennemore; Amy Michelle,11,0,20,9
1683302900165,LAWS 101,A00,201767,Golan; Tal,0,7,40,40
1683302901190,LIFR 1C,A00,185961,Staff,6,0,20,14
1683302902218,LIFR 1CX,A00,185962,Staff,7,0,20,13
1683302903246,LIFR 1D,A00,185963,Staff,9,0,20,11
1683302904270,LIFR 1DX,A00,185964,Staff,9,0,20,11
1683302905294,LIGN 101,A01,186039,Staff,43,0,50,7
1683302906321,LIGN 165,A00,186040,Staff,18,0,50,32
1683302907345,LTCS 108,A00,186041,Staff,6,0,10,4
1683302908367,LTCS 119,A00,186042,Staff,16,0,20,4
1683302909394,LTCS 130,A00,186043,Wesling; Megan E.,15,0,25,10
1683302911443,LTEA 138,A00,186119,Staff,14,0,40,26
1683302912467,LTEN 124,A00,186148,Staff,6,0,25,19
1683302913491,LTEN 178,A00,186149,Staff,7,0,15,8
1683302914518,LTEN 181,A00,186150,Blanco; John D,33,0,40,7
1683302915543,LTWL 120,A00,186160,Staff,20,0,25,5
1683302916569,LTWL 165,A00,186161,Staff,22,0,25,3
1683302917596,LTWR 100,A00,186162,Staff,0,4,15,15
1683302918621,LTWR 102,A00,186163,Doller; Ben,5,0,15,10
1683302919648,MAE 8,A01,186412,Staff,0,0,0,0
1683302920675,MAE 30B,A00,186445,Bahadori; Mohammad Yousef,83,0,100,17
1683302921699,MAE 40,A00,186592,Bewley; Thomas R,9,0,50,41
1683302922724,MAE 101B,A00,186593,Bahadori; Mohammad Yousef,81,0,100,19
1683302923748,MAE 105,A00,186594,Bandaru; Prabhakar,12,0,50,38
1683302924773,MAE 107,A00,186599,Pham; Hieu Tan,0,6,120,120
1683302925797,MAE 148,A01,186660,Silberman; Jack,3,0,16,13
1683302926825,MATH 10A,A01,188095,Staff,0,7,35,35
1683302927854,MATH 10B,A01,188097,Bowers; Adam R.,0,11,30,30
1683302927854,MATH 10B,A02,188099,Bowers; Adam R.,0,9,30,30
1683302927854,MATH 10B,B01,188104,Bowers; Adam R.,0,11,30,30
1683302927854,MATH 10B,B02,188106,Bowers; Adam R.,0,11,30,30
1683302928879,MATH 10C,A01,188111,Staff,0,18,30,30
1683302928879,MATH 10C,A02,188127,Staff,0,17,30,30
1683302928879,MATH 10C,A03,188131,Staff,0,17,30,30
1683302928879,MATH 10C,B01,188218,Staff,21,0,30,9
1683302928879,MATH 10C,B02,188244,Staff,13,0,30,17
1683302928879,MATH 10C,B03,188277,Staff,16,0,30,14
1683302929909,MATH 18,A01,188344,Bach; Quang Tran,18,0,30,12
1683302929909,MATH 18,A02,188345,Bach; Quang Tran,11,0,30,19
1683302929909,MATH 18,B01,188353,Bach; Quang Tran,10,0,30,20
1683302929909,MATH 18,B02,188354,Bach; Quang Tran,20,0,30,10
1683302930938,MATH 20A,A01,188374,Staff,13,0,35,22
1683302931966,MATH 20B,A01,188382,Ohm; Ko Woon,6,0,30,24
1683302931966,MATH 20B,A02,188383,Ohm; Ko Woon,24,0,30,6
1683302931966,MATH 20B,B01,188385,Ohm; Ko Woon,7,0,30,23
1683302931966,MATH 20B,B02,188392,Ohm; Ko Woon,22,0,30,8
1683302932995,MATH 20C,A01,188394,Harel; Guershon,10,0,30,20
1683302932995,MATH 20C,A02,188395,Harel; Guershon,13,0,30,17
1683302932995,MATH 20C,B01,188404,Harel; Guershon,3,0,30,27
1683302932995,MATH 20C,B02,188405,Harel; Guershon,19,0,30,11
1683302934020,MATH 20D,A01,188414,Hammock; Frances H,0,1,30,30
1683302934020,MATH 20D,A02,188415,Hammock; Frances H,4,0,30,26
1683302934020,MATH 20D,B01,188447,Hammock; Frances H,2,0,30,28
1683302934020,MATH 20D,B02,188486,Hammock; Frances H,8,0,30,22
1683302935045,MATH 20E,A01,188649,Staff,22,0,30,8
1683302935045,MATH 20E,A02,188650,Staff,23,0,30,7
1683302935045,MATH 20E,A03,188673,Staff,0,0,30,30
1683302936072,MATH 102,A01,188675,Staff,0,35,35,35
1683302937097,MATH 103B,A01,188681,Staff,4,0,35,31
1683302937097,MATH 103B,B01,188692,Staff,7,0,35,28
1683302938120,MATH 109,A01,188695,Salehi Golsefidy; Alireza,25,0,35,10
1683302938120,MATH 109,A02,188696,Salehi Golsefidy; Alireza,27,0,35,8
1683302939146,MATH 120A,A01,188698,Eggers; John Dietrich,5,0,35,30
1683302940175,MATH 142B,A01,188736,Ioana; Adrian,0,2,30,30
1683302940175,MATH 142B,A02,188741,Ioana; Adrian,0,1,30,30
1683302940175,MATH 142B,A03,188743,Ioana; Adrian,0,3,30,30
1683302941199,MATH 168A,A01,188790,Staff,0,8,35,35
1683302942225,MATH 170A,A01,188803,Nie; Jiawang,0,2,35,35
1683302942225,MATH 170A,A02,188811,Nie; Jiawang,0,0,35,35
1683302942225,MATH 170A,A03,188814,Nie; Jiawang,1,0,35,34
1683302942225,MATH 170A,A04,188815,Nie; Jiawang,14,0,35,21
1683302943248,MATH 193B,A01,188817,Staff,0,0,35,35
1683302943248,MATH 193B,A02,188818,Staff,5,0,35,30
1683302944273,MGT 4,A01,202857,Anderson; John Charles,62,0,80,18
1683302945298,MGT 12,A00,202858,Lindenberger; Wade Douglas,43,0,90,47
1683302946320,MGT 18,A00,202859,Staff,74,0,90,16
1683302947344,MGT 18GS,A00,202860,McKay; Michael J,13,0,28,15
1683302948371,MGT 45,A00,202861,Pecore; Joseph P.,14,0,90,76
1683302949398,MGT 100,A00,202863,Yavorsky; Daniel Ryan,28,0,90,62
1683302950424,MGT 103,A00,202864,Ehrich; Kristine R,0,16,90,90
1683302951452,MGT 112,A00,202865,Ehrich; Kristine R,15,0,90,75
1683302952475,MGT 121A,A00,202868,Staff,0,19,0,0
1683302953502,MGT 131B,A00,202869,Anderson; John Charles,59,0,90,31
1683302954525,MGT 136,A00,202871,Lindenberger; Wade Douglas,84,0,90,6
1683302955549,MGT 164,A00,202873,Staff,0,69,90,90
1683302956574,MGT 164GS,A00,202874,McKay; Mary A,13,0,28,15
1683302957599,MGT 180,A00,202875,Staff,0,51,90,90
1683302958623,MMW 11R,A01,205019,Herbst; Matthew,3,0,30,27
1683302958623,MMW 11R,A02,205026,Herbst; Matthew,29,0,30,1
1683302959652,MMW 15,A01,193512,Chang; Edmond Yi-Teh,0,9,28,28
1683302959652,MMW 15,A02,193513,Chang; Edmond Yi-Teh,0,5,28,28
1683302959652,MMW 15,A03,193514,Chang; Edmond Yi-Teh,0,5,28,28
1683302959652,MMW 15,A04,193515,Chang; Edmond Yi-Teh,0,4,28,28
1683302959652,MMW 15,A05,193516,Chang; Edmond Yi-Teh,0,4,28,28
1683302959652,MMW 15,A06,193517,Chang; Edmond Yi-Teh,0,5,28,28
1683302959652,MMW 15,B01,193519,Chang; Edmond Yi-Teh,0,4,28,28
1683302959652,MMW 15,B02,193520,Chang; Edmond Yi-Teh,0,5,28,28
1683302959652,MMW 15,B03,193521,Chang; Edmond Yi-Teh,0,4,28,28
1683302959652,MMW 15,B04,193522,Chang; Edmond Yi-Teh,0,4,28,28
1683302959652,MMW 15,B05,193523,Chang; Edmond Yi-Teh,0,5,28,28
1683302959652,MMW 15,B06,193524,Chang; Edmond Yi-Teh,0,4,28,28
1683302960680,MMW 122,A01,193526,Rahimi; Babak,0,14,28,28
1683302960680,MMW 122,A02,193527,Rahimi; Babak,0,14,28,28
1683302960680,MMW 122,A03,193528,Rahimi; Babak,0,0,0,0
1683302960680,MMW 122,A04,193529,Rahimi; Babak,0,0,0,0
1683302961708,MUS 1A,A01,186663,Staff,0,20,35,35
1683302962733,MUS 4,A01,186715,Staff,0,12,35,35
1683302963757,MUS 5R,A01,186796,Dubnov; Shlomo,0,17,35,35
1683302964785,MUS 6,A01,186798,Staff,0,3,25,25
1683302965814,MUS 7,A01,186830,Staff,12,0,35,23
1683302966841,MUS 8,A01,186930,Staff,0,26,35,35
1683302967866,MUS 15,A01,186932,Staff,0,15,35,35
1683302967866,MUS 15,B01,186934,Staff,0,15,35,35
1683302968892,MUS 80,A00,186935,Staff,2,0,20,18
1683302968892,MUS 80,B00,186936,Staff,25,0,25,0
1683302969919,NANO 11,A00,204702,Lipomi; Darren John,0,0,0,0
1683302970950,NANO 15,A01,204709,Yang; Kesong,0,1,0,0
1683302971977,NANO 114,A00,202069,Jahed Motlagh; Zeinab,3,0,10,7
1683302973004,PHIL 1,A00,186955,Grush; Rick Scott,32,0,40,8
1683302974027,PHIL 10,A01,186973,Grush; Rick Scott,29,0,35,6
1683302974027,PHIL 10,A02,186974,Grush; Rick Scott,33,0,35,2
1683302975051,PHIL 13,A01,186976,Staff,7,0,35,28
1683302975051,PHIL 13,A02,186977,Staff,16,0,35,19
1683302976078,PHIL 14,A01,186979,Staff,31,0,35,4
1683302976078,PHIL 14,A02,186986,Staff,32,0,35,3
1683302977103,PHIL 28,A01,186988,Staff,16,0,30,14
1683302977103,PHIL 28,A02,186989,Staff,1,0,30,29
1683302977103,PHIL 28,A03,186990,Staff,9,0,30,21
1683302977103,PHIL 28,A04,186991,Staff,26,0,30,4
1683302978132,PHIL 120,A00,186997,Staff,23,0,40,17
1683302979155,PHIL 137,A00,187003,Staff,9,0,40,31
1683302980180,PHIL 150,A00,187015,Staff,47,0,70,23
1683302981205,PHIL 167,A00,187021,Lamey; Andy M.,35,0,40,5
1683302982230,PHIL 174,A01,202226,Staff,17,0,20,3
1683302982230,PHIL 174,A02,202235,Staff,20,0,20,0
1683302983254,PHIL 191A,A00,258918,Staff,0,0,1,1
1683302984279,PHYS 1A,A00,187028,Staff,26,0,60,34
1683302985304,PHYS 1AL,001,187036,Staff,2,0,30,28
1683302985304,PHYS 1AL,002,187049,Staff,18,0,30,12
1683302986330,PHYS 1B,A00,187058,Staff,23,0,60,37
1683302987356,PHYS 1BL,001,187064,Staff,0,0,30,30
1683302987356,PHYS 1BL,002,187070,Staff,6,0,30,24
1683302988381,PHYS 1C,A00,187082,Staff,32,0,120,88
1683302989405,PHYS 1CL,001,187088,Staff,0,9,30,30
1683302989405,PHYS 1CL,002,187089,Staff,0,2,30,30
1683302989405,PHYS 1CL,009,262693,Staff,12,0,30,18
1683302990434,PHYS 2B,A01,187097,Staff,54,0,115,61
1683302991525,PHYS 2C,A01,187099,Staff,67,0,115,48
1683302992553,PHYS 2CL,A01,187101,Staff,5,0,28,23
1683302992553,PHYS 2CL,A02,187102,Staff,15,0,28,13
1683302993582,PHYS 2D,A01,187123,Shotwell; Brian,95,0,115,20
1683302994608,PHYS 4B,A01,187133,Grinstein; Benjamin,35,0,50,15
1683302995635,POLI 10,A00,188819,Staff,0,3,50,50
1683302996658,POLI 11,A00,188827,Staff,43,0,50,7
1683302997685,POLI 13R,A00,188828,Staff,0,1,20,20
1683302998710,POLI 27,A01,188830,Elgin; Samuel Zincke,0,1,70,70
1683302999739,POLI 30,A00,188832,Desposato; Scott,33,0,50,17
1683303000765,POLI 102F,A00,188834,Staff,3,0,40,37
1683303001807,POLI 104A,A00,188852,Staff,14,0,30,16
1683303002833,POLI 104I,A00,188853,Staff,0,6,20,20
1683303003857,POLI 110B,A00,188854,Wiens; David,7,0,20,13
1683303004884,POLI 112A,A00,188855,Wiens; David,5,0,30,25
1683303005912,POLI 117R,A00,188856,Forman; Fonna,0,11,20,20
1683303006936,POLI 118,A00,188857,Ingham; Sean,8,0,20,12
1683303007963,POLI 120G,A00,188858,Staff,9,0,30,21
1683303008989,POLI 131CR,A00,188863,Hoston; Germaine,24,0,50,26
1683303010015,POLI 133,A00,188864,Nellis; Gareth Hb,44,0,50,6
1683303011042,POLI 134D,A00,188865,Desposato; Scott,27,0,30,3
1683303012067,POLI 142A,A00,188871,Gartzke; Erik,22,0,50,28
1683303013090,POLI 142K,A00,188874,Staff,38,0,50,12
1683303014117,POLI 143,A00,188940,Gartzke; Erik,16,0,30,14
1683303015142,POLI 153,A00,188943,Staff,3,0,20,17
1683303016165,POLI 160AA,A00,188944,Staff,13,0,40,27
1683303017189,POLI 170A,A00,188945,Staff,11,0,30,19
1683303019238,PSYC 1,A00,188952,Staff,38,0,90,52
1683303020262,PSYC 2,B00,188953,Staff,20,0,35,15
1683303021289,PSYC 6,A00,188970,Staff,47,0,60,13
1683303022316,PSYC 7,A00,188973,Staff,37,0,45,8
1683303023341,PSYC 60,A01,188980,Rickard; Timothy C.,43,0,60,17
1683303024366,PSYC 70,A01,189001,Steiner; Eric Tomas,24,0,45,21
1683303025392,PSYC 100,A00,189005,Lacefield; Katharine I,0,99,120,120
1683303026418,PSYC 102,A00,189008,Staff,10,0,30,20
1683303027447,PSYC 106,B00,189026,Gorman; Michael R.,37,0,60,23
1683303028476,PSYC 114,B01,189033,Winkielman; Piotr,0,32,30,30
1683303029503,PSYC 131,A00,189036,Anagnostaras; Stephan,0,43,60,60
1683303030530,PSYC 136,A00,189041,Lowe; Angela Beth,0,7,25,25
1683303031555,PSYC 137,A00,189057,Winkielman; Piotr,0,34,25,25
1683303032582,PSYC 144,A00,189107,Wixted; John T,0,7,50,50
1683303034632,PSYC 162,A00,189142,Staff,0,8,85,85
1683303035655,PSYC 172,A00,189144,Gorman; Michael R.,0,7,30,30
1683303037707,PSYC 179,A00,189146,Lacefield; Katharine I,0,84,120,120
1683303038733,PSYC 181,A00,189147,Anagnostaras; Stephan,0,44,90,90
1683303039757,PSYC 190R,A00,189148,Barner; David A.,0,22,80,80
1683303040781,PSYC 191,A00,189275,Rickard; Timothy C.,0,7,25,25
1683303041809,PSYC 193,A00,189276,Chapman; Eddie Nathaniel,0,1,0,4
1683303042833,PSYC 193L,A01,189281,Lowe; Angela Beth,12,0,20,8
1683303042833,PSYC 193L,B01,189285,Staff,28,0,35,7
1683303043860,RELI 149,A00,187137,Rahimi; Babak,7,0,40,33
1683303044882,SE 9,A01,187315,Staff,0,2,18,18
1683303045906,SE 101B,A00,187409,Staff,24,0,30,6
1683303046930,SE 110B,A00,187444,Staff,10,0,40,30
1683303047957,SE 130B,A00,187449,Staff,31,0,40,9
1683303048981,SE 150A,A00,187516,Staff,9,0,20,11
1683303050006,SE 154,A00,187528,Staff,30,0,50,20
1683303051031,SIO 3,A01,258171,Staff,35,0,40,5
1683303052055,SIO 10,A00,187144,Cook; Geoffrey W,0,3,75,75
1683303053079,SIO 45,A00,187152,Cook; Geoffrey W,1,0,100,99
1683303054105,SIO 109R,A00,194486,Staff,0,3,20,20
1683303056157,SIO 187,A01,187233,Kacev; David,12,0,40,28
1683303057185,SOCI 1,A01,258656,Thorpe; Charles Robert,28,0,30,2
1683303057185,SOCI 1,A02,258658,Thorpe; Charles Robert,30,0,30,0
1683303057185,SOCI 1,A03,258661,Thorpe; Charles Robert,25,0,25,0
1683303057185,SOCI 1,A04,258666,Thorpe; Charles Robert,22,0,25,3
1683303057185,SOCI 1,A05,258897,Thorpe; Charles Robert,23,0,25,2
1683303057185,SOCI 1,A06,258898,Thorpe; Charles Robert,25,0,25,0
1683303058210,SOCI 30,A01,258903,Pardo Guerra; Juan Pablo,16,0,30,14
1683303059238,SOCI 102,A00,258904,Staff,9,0,25,16
1683303060262,SOCI 106,A00,258905,Staff,19,0,25,6
1683303061293,SOCI 111,A00,258907,Ribas Norris; Janet Vanesa,26,0,30,4
1683303062317,SOCI 121R,A00,258908,Pardo Guerra; Juan Pablo,11,0,30,19
1683303063344,SOCI 126,A01,203330,Staff,14,0,20,6
1683303064369,SOCI 131,A00,258909,Thorpe; Charles Robert,31,0,60,29
1683303065395,SOCI 135,A00,258910,Payne; Christine Anna,0,9,30,30
1683303066420,SOCI 157,A00,258911,Staff,13,0,30,17
1683303067442,SOCI 184,A00,258912,Staff,26,0,30,4
1683303068466,SOCI 188D,A00,258913,Staff,21,0,30,9
1683303069490,SYN 2,001,187529,Staff,9,0,16,7
1683303069490,SYN 2,002,201452,Staff,0,18,16,16
1683303069490,SYN 2,003,201469,Staff,3,0,16,13
1683303070517,SYN 100,A01,187531,Staff,0,9,20,20
1683303070517,SYN 100,B01,201491,Staff,0,12,20,20
1683303071541,TDAC 1,A00,189286,Walsh; Kim C.,3,0,20,17
1683303071541,TDAC 1,B00,189287,Harting; Carla Kelso,11,0,20,9
1683303072566,TDAC 101,A00,189300,Walsh; Kim C.,16,0,20,4
1683303072566,TDAC 101,B00,189301,Harting; Carla Kelso,18,0,20,2
1683303073595,TDAC 102,A00,189304,Basso; Beatrice,14,0,20,6
1683303074618,TDAC 108,A00,189305,Staff,18,0,20,2
1683303075643,TDDE 131,A00,189310,Staff,19,0,20,1
1683303075643,TDDE 131,B00,189314,Staff,19,0,20,1
1683303075643,TDDE 131,C00,189315,Staff,48,0,50,2
1683303075643,TDDE 131,D00,189316,Staff,14,0,15,1
1683303075643,TDDE 131,E00,204841,Staff,20,0,20,0
1683303076667,TDGE 10,A00,189289,Staff,30,0,50,20
1683303076667,TDGE 10,B00,189290,Havis; Allan,2,0,50,48
1683303077694,TDGE 11,A00,189291,Fulton; Julia,0,3,50,50
1683303077694,TDGE 11,B00,189292,Staff,20,0,25,5
1683303077694,TDGE 11,C00,260270,Staff,0,0,0,0
1683303078718,TDGE 25,A00,189294,Staff,3,0,20,17
1683303079742,TDGE 124,A00,189318,Fulton; Julia,0,8,50,50
1683303080767,TDGE 125,A00,189319,Staff,13,0,25,12
1683303080767,TDGE 125,B00,189320,Staff,23,0,25,2
1683303081794,TDGE 127,A00,189322,Havis; Allan,0,0,50,50
1683303082819,TDHT 101,A00,189323,Staff,18,0,25,7
1683303082819,TDHT 101,B00,189324,Staff,25,0,25,0
1683303083843,TDHT 102,A00,189325,Staff,49,0,50,1
1683303084871,TDMV 1,A00,189295,Arcidiacono; Kristin,20,0,30,10
1683303084871,TDMV 1,B00,189296,Caligagan; Maria T.,24,0,30,6
1683303085894,TDMV 2,A00,189297,Sammartano; Tonnie,28,0,30,2
1683303085894,TDMV 2,B00,189299,Arcidiacono; Kristin,24,0,30,6
1683303086922,TDMV 3,A00,204998,Rincon; Alicia,22,0,30,8
1683303087946,TDMV 120,A00,189458,Sammartano; Tonnie,28,0,30,2
1683303088971,TDMV 138,A00,189541,Jun; Grace Shin Hae,22,0,40,18
1683303089995,TDMV 142,A00,189717,Caligagan; Tony,23,0,30,7
1683303089995,TDMV 142,B00,189718,Caligagan; Maria T.,25,0,30,5
1683303091019,TMC 2,A01,187533,Staff,25,0,25,0
1683303091019,TMC 2,A02,187534,Staff,25,0,25,0
1683303092043,USP 1,A01,187536,Kwak; Nancy,0,16,25,25
1683303093068,USP 5,A01,187538,Staff,9,0,25,16
1683303094094,USP 101,A00,199253,Staff,0,4,0,0
1683303095177,USP 124,A00,187562,Boomhower; Matthew Charles,1,0,30,29
1683303096204,USP 138,A00,187582,Staff,20,0,25,5
1683303097230,USP 152,A01,187597,Staff,4,0,25,21
1683303098256,USP 153,A00,187598,Staff,19,0,25,6
1683303099283,USP 168,A00,187607,Kwak; Nancy,2,0,5,3
1683303100308,USP 173,A00,187619,Staff,4,0,25,21
1683303101336,USP 181,A00,187638,Staff,0,0,25,25
1683303102360,VIS 103,A00,187650,Cruz; Edwin Teddy,23,0,75,52
1683303103385,VIS 110D,A00,187669,Staff,12,0,22,10
1683303104409,VIS 127C,A00,187720,Shen; Kuiyi,68,0,146,78
1683303105433,VIS 149,A00,187731,Yoldas; Pinar,0,14,22,22
1683303106458,VIS 151,A01,188091,Staff,22,0,34,12
1683303106458,VIS 151,A02,188092,Staff,11,0,34,23
1683303107486,VIS 160B,A00,188093,Stalbaum; Brett,0,0,10,10
1683303109543,WCWP 10B,A00,201720,Staff,10,0,15,5
1683303109543,WCWP 10B,B00,201722,Staff,8,0,15,7
1683303110571,WCWP 100,A00,201725,Gagnon; Jeffrey C,0,0,2,2
1683303110571,WCWP 100,B00,201727,Staff,0,4,15,15
1683303113665,ANBI 133,A00,258401,Wilder; Linnea Lorene,34,0,40,6
1683303114693,ANBI 140,A00,258395,Hrvoj Mihic; Branka,18,0,25,7
1683303115717,ANSC 120,A00,258402,Bialecki; Jon Anthony,27,0,40,13
1683303116741,ANSC 144,A00,258400,Staff,14,0,40,26
1683303118791,ANSC 166,A00,258396,Parish; Steven Martin,157,0,175,18
1683303119818,ANSC 180,A00,193533,Staff,9,0,20,11
1683303120845,ANSC 188,A00,258397,Jassal; Aftab,33,0,40,7
1683303121869,ANTH 3,A01,258316,Staff,23,0,30,7
1683303122894,ANTH 5,A00,258394,Semendeferi; Ekaterini,16,0,20,4
1683303123921,ANTH 21,A01,258331,Staff,9,0,40,31
1683303124946,ANTH 103,A00,258398,Varma; Saiba,15,0,25,10
1683303125970,AWP 10,001,202034,Staff,0,0,0,0
1683303125970,AWP 10,002,202035,Staff,0,0,0,0
1683303125970,AWP 10,003,202036,Staff,0,0,0,0
1683303125970,AWP 10,004,202037,Staff,0,0,0,0
1683303125970,AWP 10,005,202038,Staff,0,0,0,0
1683303125970,AWP 10,006,202039,Staff,0,0,0,0
1683303125970,AWP 10,007,202040,Staff,0,0,0,0
1683303125970,AWP 10,008,202041,Staff,0,0,0,0
1683303125970,AWP 10,009,202042,Staff,0,0,0,0
1683303125970,AWP 10,010,202043,Staff,0,0,0,0
1683303125970,AWP 10,011,202044,Staff,0,0,0,0
1683303125970,AWP 10,012,202045,Staff,0,0,0,0
1683303125970,AWP 10,013,202046,Staff,0,0,0,0
1683303125970,AWP 10,014,202047,Staff,0,0,0,0
1683303125970,AWP 10,015,202048,Staff,0,0,0,0
1683303125970,AWP 10,016,202049,Staff,0,0,0,0
1683303125970,AWP 10,017,202050,Staff,0,0,0,0
1683303125970,AWP 10,018,202051,Staff,0,0,0,0
1683303125970,AWP 10,019,202052,Staff,0,0,0,0
1683303125970,AWP 10,020,202053,Staff,0,0,0,0
1683303125970,AWP 10,021,202054,Staff,0,0,0,0
1683303125970,AWP 10,022,202055,Staff,0,0,0,0
1683303125970,AWP 10,023,202056,Staff,0,0,0,0
1683303125970,AWP 10,024,202057,Staff,0,0,0,0
1683303125970,AWP 10,025,202058,Staff,0,0,0,0
1683303125970,AWP 10,026,202059,Staff,0,0,0,0
1683303126998,AWP 102,001,202032,Staff,0,0,0,0
1683303126998,AWP 102,002,202033,Staff,0,0,0,0
1683303128028,BENG 100,A01,254234,Taylor Amos; Alyssa C,31,0,40,9
1683303129052,BENG 196,001,270013,Engler; Adam J.,9999,0,9999,0
1683303130081,BICD 100R,A01,202018,Smith; Laurie,0,7,32,32
1683303130081,BICD 100R,A02,202019,Smith; Laurie,0,2,32,32
1683303130081,BICD 100R,A03,202020,Smith; Laurie,0,1,32,32
1683303130081,BICD 100R,A04,202021,Smith; Laurie,8,0,32,24
1683303130081,BICD 100R,A05,202022,Smith; Laurie,12,0,32,20
1683303131106,BICD 136,A01,193242,Gustafson-Brown; Cindy,0,2,32,32
1683303131106,BICD 136,A02,193244,Gustafson-Brown; Cindy,15,0,32,17
1683303132135,BIEB 102,A01,193249,Butler; Shannon Rhey,0,2,32,32
1683303132135,BIEB 102,A02,193251,Butler; Shannon Rhey,0,0,32,32
1683303132135,BIEB 102,A03,193253,Butler; Shannon Rhey,0,1,32,32
1683303132135,BIEB 102,A04,193255,Butler; Shannon Rhey,17,0,32,15
1683303132135,BIEB 102,A05,193265,Butler; Shannon Rhey,26,0,32,6
1683303132135,BIEB 102,A06,193269,Butler; Shannon Rhey,16,0,32,16
1683303134188,BIEB 150,A01,193274,Staff,0,0,32,32
1683303134188,BIEB 150,A02,193285,Staff,24,0,32,8
1683303135213,BIEB 194,A00,193286,Kurle; Carolyn M.,22,0,32,10
1683303136237,BILD 1,A01,192291,Staff,16,0,32,16
1683303136237,BILD 1,A02,192292,Staff,30,0,32,2
1683303136237,BILD 1,B01,192520,Reuther; Keefe,0,1,0,0
1683303136237,BILD 1,B02,192532,Reuther; Keefe,0,1,0,0
1683303137270,BILD 3,A01,192556,Butler; Shannon Rhey,0,0,32,32
1683303137270,BILD 3,A02,192581,Butler; Shannon Rhey,5,0,32,27
1683303137270,BILD 3,A03,192611,Butler; Shannon Rhey,23,0,32,9
1683303137270,BILD 3,A04,192612,Butler; Shannon Rhey,25,0,32,7
1683303137270,BILD 3,A05,192613,Butler; Shannon Rhey,27,0,32,5
1683303137270,BILD 3,A06,192679,Butler; Shannon Rhey,27,0,32,5
1683303137270,BILD 3,A07,192682,Butler; Shannon Rhey,22,0,32,10
1683303138298,BILD 4,A01,192836,Reuther; Keefe,1,0,24,23
1683303138298,BILD 4,A02,193044,Reuther; Keefe,4,0,24,20
1683303139323,BILD 10,A01,193142,Gustafson-Brown; Cindy,31,0,32,1
1683303139323,BILD 10,A02,193149,Gustafson-Brown; Cindy,31,0,32,1
1683303140353,BIMM 100,A01,193301,Staff,0,6,32,32
1683303140353,BIMM 100,A02,193312,Staff,0,5,32,32
1683303140353,BIMM 100,A03,193323,Staff,0,8,32,32
1683303141383,BIMM 101,A01,193329,McDonnell; Lisa Marie,0,3,24,24
1683303141383,BIMM 101,A02,193339,McDonnell; Lisa Marie,0,2,24,24
1683303141383,BIMM 101,B01,193354,McDonnell; Lisa Marie,0,3,24,24
1683303141383,BIMM 101,B02,193357,McDonnell; Lisa Marie,0,3,24,24
1683303142409,BIMM 110,A01,193377,Tat; John,0,11,32,32
1683303142409,BIMM 110,A02,193378,Tat; John,1,9,32,31
1683303143437,BIMM 120,A01,206116,Staff,0,0,32,32
1683303143437,BIMM 120,A02,206117,Staff,8,0,32,24
1683303143437,BIMM 120,A03,206121,Staff,21,0,32,11
1683303144466,BIPN 100,A01,193393,Park; Ji Young,0,14,32,32
1683303144466,BIPN 100,A02,193402,Park; Ji Young,0,12,32,32
1683303144466,BIPN 100,A03,193413,Park; Ji Young,0,14,32,32
1683303144466,BIPN 100,A04,193414,Park; Ji Young,0,13,32,32
1683303145490,BIPN 102,A01,193429,Staff,0,0,32,32
1683303145490,BIPN 102,A02,193438,Staff,23,0,32,9
1683303146519,BIPN 106,A01,193450,Reyes Gonzalez; Catalina,0,2,40,40
1683303147547,BIPN 134,A01,193465,Cooke; James Edward,0,0,32,32
1683303147547,BIPN 134,A02,193474,Cooke; James Edward,27,0,32,5
1683303147547,BIPN 134,A03,193485,Cooke; James Edward,29,0,32,3
1683303147547,BIPN 134,A04,193486,Cooke; James Edward,21,0,32,11
1683303147547,BIPN 134,A05,193491,Cooke; James Edward,31,0,32,1
1683303147547,BIPN 134,A06,193501,Cooke; James Edward,30,0,32,2
1683303147547,BIPN 134,A07,193510,Cooke; James Edward,29,0,32,3
1683303149598,BISP 194,A00,222522,Staff,16,0,32,16
1683303150625,CAT 124,A01,202407,Staff,20,0,25,5
1683303151650,CAT 125,A00,202408,Marchisotto; Jennifer Anne,4,0,20,16
1683303152675,CAT 125R,A00,202409,Smith; Lauryn Alissa,0,11,20,20
1683303152675,CAT 125R,B00,202410,Morales; Celeste Georgianna,0,11,20,20
1683303152675,CAT 125R,C00,202411,Irwin; Matthew Joseph,0,10,20,20
1683303153707,CENG 15,A01,204712,Yang; Kesong,0,1,0,0
1683303154735,CENG 114,A00,202070,Jahed Motlagh; Zeinab,5,0,20,15
1683303155759,CGS 105,A00,185477,Wesling; Megan E.,24,0,40,16
1683303156783,CGS 106,A00,185494,Staff,13,0,22,9
1683303157810,CGS 108,A00,185495,Staff,14,0,20,6
1683303158837,CGS 114,A00,185496,Staff,13,0,18,5
1683303159861,CGS 119,A00,185501,Staff,15,0,20,5
1683303160887,CGS 120,A00,185511,Staff,13,0,20,7
1683303161933,CHEM 4,A01,184675,Bussey; Thomas J,96,0,100,4
1683303162961,CHEM 6A,A01,184677,Staff,35,0,60,25
1683303163986,CHEM 6B,A01,184679,Staff,65,0,100,35
1683303165015,CHEM 6C,A01,184681,Bussey; Thomas J,1,0,50,49
1683303165015,CHEM 6C,A02,184682,Bussey; Thomas J,34,0,50,16
1683303166039,CHEM 40A,A01,184684,Albizati; Kim F.,37,0,100,63
1683303167062,CHEM 40B,A01,184686,Albizati; Kim F.,0,20,100,100
1683303168087,CHEM 41B,A01,184690,Staff,52,0,100,48
1683303169115,COGS 3,A01,184715,Boyle; Mary E. T.,0,25,40,40
1683303170143,COGS 14B,A01,185172,Staff,0,15,38,38
1683303171169,COGS 18,A01,184736,Staff,20,0,80,60
1683303172193,COGS 100,A01,184932,Staff,0,5,73,73
1683303173221,COGS 101A,A01,184935,Staff,0,38,30,30
1683303174251,COGS 101B,A01,184944,Staff,0,2,30,30
1683303175276,COGS 101C,A01,184946,Staff,0,12,30,30
1683303176302,COGS 102A,A01,184951,Johnson; Christine M.,2,0,40,38
1683303177331,COGS 107B,A01,184953,Mooshagian; Eric Frederick,0,50,40,40
1683303178356,COGS 118B,A01,184959,Gupta; Anjum,0,48,40,40
1683303179381,COGS 153,A00,184961,Staff,0,15,30,30
1683303180405,COGS 177,A00,184962,Staff,0,21,30,30
1683303181429,COGS 187A,A01,184969,Boyle; Mary E. T.,0,17,40,40
1683303182457,COMM 10,A01,185174,Staff,0,5,25,25
1683303182457,COMM 10,A02,185189,Staff,0,5,25,25
1683303182457,COMM 10,A03,269821,Staff,0,0,0,0
1683303183483,COMM 100B,A01,185475,Staff,0,0,0,2
1683303183483,COMM 100B,A02,185476,Staff,14,0,25,11
1683303184513,COMM 100C,A01,185314,Staff,1,0,25,24
1683303184513,COMM 100C,A02,185327,Staff,19,0,25,6
1683303185538,COMM 110M,A00,185349,Staff,2,0,40,38
1683303186563,COMM 113T,A00,185352,Staff,25,0,40,15
1683303187586,COMM 114I,A00,185353,Staff,33,0,40,7
1683303188613,COMM 131,A00,185354,Staff,19,0,30,11
1683303189641,CSE 8A,A50,185358,Cao; Yingjun,0,46,10,10
1683303190666,CSE 8B,A01,185362,Staff,1,47,50,49
1683303191694,CSE 11,A01,185416,Cao; Yingjun,0,93,10,10
1683303192718,CSE 20,A01,185445,Briones; Jor-el Thomas Caparas,5,0,25,20
1683303193745,CSE 21,A01,185447,Staff,10,0,50,40
1683303194770,CSE 101,A01,185451,Staff,0,12,50,50
1683303194770,CSE 101,B01,185453,Jones; Miles E,0,11,50,50
1683303196819,CSE 141,A01,185458,Eldon; John,20,0,100,80
1683303197848,CSE 141L,A01,185461,Eldon; John,12,0,100,88
1683303198932,CSE 142,A01,185463,Staff,35,0,60,25
1683303198932,CSE 142,B01,201355,Staff,0,6,60,60
1683303199957,CSE 142L,A01,185470,Staff,35,0,60,25
1683303199957,CSE 142L,B01,201417,Staff,0,5,60,60
1683303200982,CSE 190,A00,201433,Staff,32,0,49,17
1683303202008,DOC 1,A01,259136,Strom; Megan C.,8,0,15,7
1683303202008,DOC 1,A02,259137,Strom; Megan C.,14,0,15,1
1683303202008,DOC 1,A03,259138,Strom; Megan C.,14,0,15,1
1683303202008,DOC 1,A04,259139,Strom; Megan C.,14,0,15,1
1683303203032,DOC 100D,A00,259140,Pass; Natalye Joann,17,0,25,8
1683303204060,DSGN 1,A01,184749,Rill; Bryan,0,24,30,30
1683303205083,DSGN 100,A01,185168,Staff,0,2,25,25
1683303206107,ECE 5,A01,185626,Morris; Karcher William,0,10,0,0
1683303207132,ECE 101,A01,185628,Staff,17,0,70,53
1683303208160,ECE 107,A01,185635,Baghdadchi; Saharnaz,0,0,20,20
1683303208160,ECE 107,A02,185638,Baghdadchi; Saharnaz,4,0,20,16
1683303209186,ECE 148,A01,185647,Silberman; Jack,1,0,16,15
1683303210212,ECON 1,A01,185537,Crane; Meredith Helen,54,0,70,16
1683303211235,ECON 3,A01,185549,Crane; Meredith Helen,33,0,70,37
1683303212265,ECON 4,A01,203354,Anderson; John Charles,0,4,10,10
1683303213292,ECON 100A,A01,185574,Staff,0,4,40,40
1683303214320,ECON 100B,A01,185576,Staff,0,22,40,40
1683303215345,ECON 100C,A01,185589,Newhouse; Herbert S,30,0,70,40
1683303216366,ECON 105,A00,185608,Vespa; Emanuel Ignacio,19,0,35,16
1683303217390,ECON 109,A01,185610,Shishkin; Denis,10,0,35,25
1683303218415,ECON 110A,A01,185612,Staff,11,0,40,29
1683303219439,ECON 120A,A01,185615,Staff,20,0,40,20
1683303220463,ECON 120C,A01,185617,Sun; Yixiao,0,20,70,70
1683303221488,ECON 144,A00,203346,Squires; Dale E,3,0,35,32
1683303222516,ECON 171,A01,203349,Newhouse; Herbert S,0,1,35,35
1683303223541,ECON 173A,A01,185621,Toda; Alexis Akira,21,0,35,14
1683303224567,EDS 25,A01,202413,Staff,0,1,0,0
1683303224567,EDS 25,A02,202414,Staff,0,1,0,0
1683303224567,EDS 25,A03,202415,Staff,0,0,0,0
1683303224567,EDS 25,A04,202416,Staff,0,1,0,0
1683303224567,EDS 25,A05,202439,Staff,0,0,0,0
1683303224567,EDS 25,A06,202440,Staff,0,0,0,0
1683303224567,EDS 25,B01,202631,Staff,0,0,0,0
1683303224567,EDS 25,B02,202632,Staff,0,0,0,0
1683303224567,EDS 25,B03,202639,Staff,0,0,0,0
1683303224567,EDS 25,B04,202640,Staff,0,0,0,0
1683303224567,EDS 25,B05,202643,Staff,0,0,0,0
1683303224567,EDS 25,B06,202644,Staff,0,0,0,0
1683303225591,EDS 38,A01,202659,Black; Alison Michelle,24,0,25,1
1683303226619,EDS 115,A00,202652,Staff,17,0,30,13
1683303227643,EDS 125,A00,202649,Staff,14,0,30,16
1683303228667,EDS 126,A01,203332,Staff,30,0,30,0
1683303229691,EDS 139,A00,202838,Staff,17,0,25,8
1683303230719,EDS 146,A01,202655,Staff,15,0,25,10
1683303231749,ENG 15,A00,185667,Staff,0,1,0,0
1683303231749,ENG 15,B00,185672,Staff,0,0,0,0
1683303231749,ENG 15,C00,185675,Staff,0,0,0,0
1683303231749,ENG 15,D00,185682,Staff,0,0,0,0
1683303231749,ENG 15,E00,185684,Staff,0,0,0,0
1683303232774,ETHN 103,A00,185710,Staff,0,3,35,35
1683303233799,ETHN 103A,A00,199228,Man; Simeon S,2,0,9,7
1683303234827,ETHN 109,A00,185711,Staff,18,0,35,17
1683303235850,ETHN 142,A00,185726,Staff,0,4,30,30
1683303236878,ETHN 163J,A00,199229,Man; Simeon S,6,0,8,2
1683303237904,ETHN 168,A00,185727,Staff,8,0,10,2
1683303238927,ETHN 182,A00,185728,Staff,1,0,35,34
1683303239952,ETHN 183,A00,185737,Staff,8,0,18,10
1683303240979,GLBH 111,A01,209361,Burgos; Jose L.,0,0,0,0
1683303243031,HIEU 104,A00,185792,Staff,16,0,20,4
1683303244058,HIEU 115,A00,185800,Staff,1,0,20,19
1683303245084,HIEU 128,A00,185801,Staff,0,7,20,20
1683303246108,HIEU 147,A00,185802,Staff,16,0,20,4
1683303247133,HIEU 154,A00,185823,Staff,12,0,20,8
1683303248161,HILA 102,A00,185826,Staff,13,0,20,7
1683303249186,HILD 2C,A01,185778,Staff,0,12,20,20
1683303250213,HILD 7B,A01,185780,Kwak; Nancy,0,15,32,32
1683303250213,HILD 7B,A02,185781,Kwak; Nancy,0,18,32,32
1683303251239,HILD 30,A01,185791,Staff,14,0,20,6
1683303252263,HISC 119,A00,185830,Golan; Tal,0,9,20,20
1683303253289,HITO 156GS,A00,185831,Patterson; Patrick H.,0,0,0,23
1683303254313,HIUS 103,A00,185832,Man; Simeon S,0,6,20,20
1683303255337,HIUS 117,A00,185836,Kwak; Nancy,2,0,20,18
1683303256361,HIUS 125,A00,185840,Man; Simeon S,0,0,23,23
1683303257389,HIUS 149,A00,185845,Staff,0,0,20,20
1683303258414,HUM 3,A01,185882,Zavodny; Tatiana Sophia,0,6,50,50
1683303258414,HUM 3,B01,185899,Caldwell; Michael Alan,0,19,50,50
1683303259439,HUM 3GS,A00,185900,Patterson; Patrick H.,0,0,0,23
1683303260470,HUM 4,A01,185938,Zroka; Amy Liane,31,0,50,19
1683303260470,HUM 4,B01,185956,Watkins; Eric,0,2,50,50
1683303260470,HUM 4,B02,202209,Watkins; Eric,0,1,50,50
1683303260470,HUM 4,B03,202210,Watkins; Eric,0,0,50,50
1683303261495,HUM 5,A01,185958,West; Geoffrey Scott,5,0,50,45
1683303261495,HUM 5,A02,202215,West; Geoffrey Scott,0,0,50,50
1683303262518,INTL 190,A00,185959,Gagnon; Jeffrey C,0,0,0,9
1683303262518,INTL 190,B00,185960,Lettieri; Michael Joseph,0,0,0,1
1683303263544,JAPN 180,A00,254509,Staff,0,1,25,25
1683303264570,LATI 10,A01,202853,Kennemore; Amy Michelle,5,0,35,30
1683303264570,LATI 10,A02,202854,Kennemore; Amy Michelle,1,0,35,34
1683303264570,LATI 10,A03,270054,Kennemore; Amy Michelle,30,0,30,0
1683303265595,LATI 180,A00,202855,Kennemore; Amy Michelle,11,0,20,9
1683303266619,LAWS 101,A00,201767,Golan; Tal,0,7,40,40
1683303267643,LIFR 1C,A00,185961,Staff,6,0,20,14
1683303268668,LIFR 1CX,A00,185962,Staff,7,0,20,13
1683303269695,LIFR 1D,A00,185963,Staff,9,0,20,11
1683303270720,LIFR 1DX,A00,185964,Staff,9,0,20,11
1683303271746,LIGN 101,A01,186039,Staff,43,0,50,7
1683303272770,LIGN 165,A00,186040,Staff,18,0,50,32
1683303273797,LTCS 108,A00,186041,Staff,6,0,10,4
1683303274823,LTCS 119,A00,186042,Staff,16,0,20,4
1683303275850,LTCS 130,A00,186043,Wesling; Megan E.,15,0,25,10
1683303277904,LTEA 138,A00,186119,Staff,14,0,40,26
1683303278931,LTEN 124,A00,186148,Staff,6,0,25,19
1683303279958,LTEN 178,A00,186149,Staff,7,0,15,8
1683303280983,LTEN 181,A00,186150,Blanco; John D,33,0,40,7
1683303282011,LTWL 120,A00,186160,Staff,20,0,25,5
1683303283037,LTWL 165,A00,186161,Staff,22,0,25,3
1683303284063,LTWR 100,A00,186162,Staff,0,4,15,15
1683303285088,LTWR 102,A00,186163,Doller; Ben,5,0,15,10
1683303286115,MAE 8,A01,186412,Staff,0,0,0,0
1683303287140,MAE 30B,A00,186445,Bahadori; Mohammad Yousef,83,0,100,17
1683303288167,MAE 40,A00,186592,Bewley; Thomas R,9,0,50,41
1683303289193,MAE 101B,A00,186593,Bahadori; Mohammad Yousef,81,0,100,19
1683303290220,MAE 105,A00,186594,Bandaru; Prabhakar,12,0,50,38
1683303291244,MAE 107,A00,186599,Pham; Hieu Tan,0,6,120,120
1683303292272,MAE 148,A01,186660,Silberman; Jack,3,0,16,13
1683303293297,MATH 10A,A01,188095,Staff,0,7,35,35
1683303294322,MATH 10B,A01,188097,Bowers; Adam R.,0,11,30,30
1683303294322,MATH 10B,A02,188099,Bowers; Adam R.,0,9,30,30
1683303294322,MATH 10B,B01,188104,Bowers; Adam R.,0,11,30,30
1683303294322,MATH 10B,B02,188106,Bowers; Adam R.,0,11,30,30
1683303295347,MATH 10C,A01,188111,Staff,0,18,30,30
1683303295347,MATH 10C,A02,188127,Staff,0,17,30,30
1683303295347,MATH 10C,A03,188131,Staff,0,17,30,30
1683303295347,MATH 10C,B01,188218,Staff,21,0,30,9
1683303295347,MATH 10C,B02,188244,Staff,13,0,30,17
1683303295347,MATH 10C,B03,188277,Staff,16,0,30,14
1683303296379,MATH 18,A01,188344,Bach; Quang Tran,18,0,30,12
1683303296379,MATH 18,A02,188345,Bach; Quang Tran,11,0,30,19
1683303296379,MATH 18,B01,188353,Bach; Quang Tran,10,0,30,20
1683303296379,MATH 18,B02,188354,Bach; Quang Tran,20,0,30,10
1683303297408,MATH 20A,A01,188374,Staff,13,0,35,22
1683303298437,MATH 20B,A01,188382,Ohm; Ko Woon,6,0,30,24
1683303298437,MATH 20B,A02,188383,Ohm; Ko Woon,24,0,30,6
1683303298437,MATH 20B,B01,188385,Ohm; Ko Woon,7,0,30,23
1683303298437,MATH 20B,B02,188392,Ohm; Ko Woon,22,0,30,8
1683303299462,MATH 20C,A01,188394,Harel; Guershon,10,0,30,20
1683303299462,MATH 20C,A02,188395,Harel; Guershon,13,0,30,17
1683303299462,MATH 20C,B01,188404,Harel; Guershon,3,0,30,27
1683303299462,MATH 20C,B02,188405,Harel; Guershon,19,0,30,11
1683303300488,MATH 20D,A01,188414,Hammock; Frances H,0,1,30,30
1683303300488,MATH 20D,A02,188415,Hammock; Frances H,4,0,30,26
1683303300488,MATH 20D,B01,188447,Hammock; Frances H,2,0,30,28
1683303300488,MATH 20D,B02,188486,Hammock; Frances H,8,0,30,22
1683303301515,MATH 20E,A01,188649,Staff,22,0,30,8
1683303301515,MATH 20E,A02,188650,Staff,23,0,30,7
1683303301515,MATH 20E,A03,188673,Staff,0,0,30,30
1683303302597,MATH 102,A01,188675,Staff,0,35,35,35
1683303303623,MATH 103B,A01,188681,Staff,4,0,35,31
1683303303623,MATH 103B,B01,188692,Staff,7,0,35,28
1683303304648,MATH 109,A01,188695,Salehi Golsefidy; Alireza,25,0,35,10
1683303304648,MATH 109,A02,188696,Salehi Golsefidy; Alireza,27,0,35,8
1683303305674,MATH 120A,A01,188698,Eggers; John Dietrich,5,0,35,30
1683303306697,MATH 142B,A01,188736,Ioana; Adrian,0,2,30,30
1683303306697,MATH 142B,A02,188741,Ioana; Adrian,0,1,30,30
1683303306697,MATH 142B,A03,188743,Ioana; Adrian,0,3,30,30
1683303307720,MATH 168A,A01,188790,Staff,0,8,35,35
1683303308744,MATH 170A,A01,188803,Nie; Jiawang,0,2,35,35
1683303308744,MATH 170A,A02,188811,Nie; Jiawang,0,0,35,35
1683303308744,MATH 170A,A03,188814,Nie; Jiawang,1,0,35,34
1683303308744,MATH 170A,A04,188815,Nie; Jiawang,14,0,35,21
1683303309767,MATH 193B,A01,188817,Staff,0,0,35,35
1683303309767,MATH 193B,A02,188818,Staff,5,0,35,30
1683303310795,MGT 4,A01,202857,Anderson; John Charles,62,0,80,18
1683303311820,MGT 12,A00,202858,Lindenberger; Wade Douglas,43,0,90,47
1683303312847,MGT 18,A00,202859,Staff,74,0,90,16
1683303313869,MGT 18GS,A00,202860,McKay; Michael J,13,0,28,15
1683303314895,MGT 45,A00,202861,Pecore; Joseph P.,14,0,90,76
1683303315919,MGT 100,A00,202863,Yavorsky; Daniel Ryan,28,0,90,62
1683303316946,MGT 103,A00,202864,Ehrich; Kristine R,0,16,90,90
1683303317969,MGT 112,A00,202865,Ehrich; Kristine R,15,0,90,75
1683303318996,MGT 121A,A00,202868,Staff,0,19,0,0
1683303320021,MGT 131B,A00,202869,Anderson; John Charles,59,0,90,31
1683303321044,MGT 136,A00,202871,Lindenberger; Wade Douglas,84,0,90,6
1683303322071,MGT 164,A00,202873,Staff,0,69,90,90
1683303323099,MGT 164GS,A00,202874,McKay; Mary A,13,0,28,15
1683303324124,MGT 180,A00,202875,Staff,0,51,90,90
1683303325147,MMW 11R,A01,205019,Herbst; Matthew,3,0,30,27
1683303325147,MMW 11R,A02,205026,Herbst; Matthew,29,0,30,1
1683303326172,MMW 15,A01,193512,Chang; Edmond Yi-Teh,0,9,28,28
1683303326172,MMW 15,A02,193513,Chang; Edmond Yi-Teh,0,5,28,28
1683303326172,MMW 15,A03,193514,Chang; Edmond Yi-Teh,0,5,28,28
1683303326172,MMW 15,A04,193515,Chang; Edmond Yi-Teh,0,4,28,28
1683303326172,MMW 15,A05,193516,Chang; Edmond Yi-Teh,0,4,28,28
1683303326172,MMW 15,A06,193517,Chang; Edmond Yi-Teh,0,5,28,28
1683303326172,MMW 15,B01,193519,Chang; Edmond Yi-Teh,0,4,28,28
1683303326172,MMW 15,B02,193520,Chang; Edmond Yi-Teh,0,5,28,28
1683303326172,MMW 15,B03,193521,Chang; Edmond Yi-Teh,0,4,28,28
1683303326172,MMW 15,B04,193522,Chang; Edmond Yi-Teh,0,4,28,28
1683303326172,MMW 15,B05,193523,Chang; Edmond Yi-Teh,0,5,28,28
1683303326172,MMW 15,B06,193524,Chang; Edmond Yi-Teh,0,4,28,28
1683303327197,MMW 122,A01,193526,Rahimi; Babak,0,14,28,28
1683303327197,MMW 122,A02,193527,Rahimi; Babak,0,14,28,28
1683303327197,MMW 122,A03,193528,Rahimi; Babak,0,0,0,0
1683303327197,MMW 122,A04,193529,Rahimi; Babak,0,0,0,0
1683303328220,MUS 1A,A01,186663,Staff,0,20,35,35
1683303329245,MUS 4,A01,186715,Staff,0,12,35,35
1683303330273,MUS 5R,A01,186796,Dubnov; Shlomo,0,17,35,35
1683303331296,MUS 6,A01,186798,Staff,0,3,25,25
1683303332322,MUS 7,A01,186830,Staff,12,0,35,23
1683303333345,MUS 8,A01,186930,Staff,0,26,35,35
1683303334372,MUS 15,A01,186932,Staff,0,15,35,35
1683303334372,MUS 15,B01,186934,Staff,0,15,35,35
1683303335399,MUS 80,A00,186935,Staff,2,0,20,18
1683303335399,MUS 80,B00,186936,Staff,25,0,25,0
1683303336426,NANO 11,A00,204702,Lipomi; Darren John,0,0,0,0
1683303337449,NANO 15,A01,204709,Yang; Kesong,0,1,0,0
1683303338474,NANO 114,A00,202069,Jahed Motlagh; Zeinab,3,0,10,7
1683303339497,PHIL 1,A00,186955,Grush; Rick Scott,32,0,40,8
1683303340529,PHIL 10,A01,186973,Grush; Rick Scott,29,0,35,6
1683303340529,PHIL 10,A02,186974,Grush; Rick Scott,33,0,35,2
1683303341557,PHIL 13,A01,186976,Staff,7,0,35,28
1683303341557,PHIL 13,A02,186977,Staff,16,0,35,19
1683303342585,PHIL 14,A01,186979,Staff,31,0,35,4
1683303342585,PHIL 14,A02,186986,Staff,32,0,35,3
1683303343613,PHIL 28,A01,186988,Staff,16,0,30,14
1683303343613,PHIL 28,A02,186989,Staff,1,0,30,29
1683303343613,PHIL 28,A03,186990,Staff,9,0,30,21
1683303343613,PHIL 28,A04,186991,Staff,26,0,30,4
1683303344641,PHIL 120,A00,186997,Staff,23,0,40,17
1683303345665,PHIL 137,A00,187003,Staff,9,0,40,31
1683303346690,PHIL 150,A00,187015,Staff,47,0,70,23
1683303347713,PHIL 167,A00,187021,Lamey; Andy M.,35,0,40,5
1683303348737,PHIL 174,A01,202226,Staff,17,0,20,3
1683303348737,PHIL 174,A02,202235,Staff,20,0,20,0
1683303349762,PHIL 191A,A00,258918,Staff,0,0,1,1
1683303350789,PHYS 1A,A00,187028,Staff,26,0,60,34
1683303351815,PHYS 1AL,001,187036,Staff,2,0,30,28
1683303351815,PHYS 1AL,002,187049,Staff,18,0,30,12
1683303352838,PHYS 1B,A00,187058,Staff,23,0,60,37
1683303353862,PHYS 1BL,001,187064,Staff,0,0,30,30
1683303353862,PHYS 1BL,002,187070,Staff,6,0,30,24
1683303354890,PHYS 1C,A00,187082,Staff,31,0,120,89
1683303355915,PHYS 1CL,001,187088,Staff,0,9,30,30
1683303355915,PHYS 1CL,002,187089,Staff,0,2,30,30
1683303355915,PHYS 1CL,009,262693,Staff,12,0,30,18
1683303356940,PHYS 2B,A01,187097,Staff,54,0,115,61
1683303357964,PHYS 2C,A01,187099,Staff,67,0,115,48
1683303359007,PHYS 2CL,A01,187101,Staff,5,0,28,23
1683303359007,PHYS 2CL,A02,187102,Staff,15,0,28,13
1683303360032,PHYS 2D,A01,187123,Shotwell; Brian,95,0,115,20
1683303361060,PHYS 4B,A01,187133,Grinstein; Benjamin,35,0,50,15
1683303362085,POLI 10,A00,188819,Staff,0,3,50,50
1683303363113,POLI 11,A00,188827,Staff,43,0,50,7
1683303364135,POLI 13R,A00,188828,Staff,0,1,20,20
1683303365163,POLI 27,A01,188830,Elgin; Samuel Zincke,0,1,70,70
1683303366190,POLI 30,A00,188832,Desposato; Scott,33,0,50,17
1683303367217,POLI 102F,A00,188834,Staff,3,0,40,37
1683303368242,POLI 104A,A00,188852,Staff,14,0,30,16
1683303369270,POLI 104I,A00,188853,Staff,0,6,20,20
1683303370295,POLI 110B,A00,188854,Wiens; David,7,0,20,13
1683303371323,POLI 112A,A00,188855,Wiens; David,5,0,30,25
1683303372350,POLI 117R,A00,188856,Forman; Fonna,0,11,20,20
1683303373376,POLI 118,A00,188857,Ingham; Sean,8,0,20,12
1683303374400,POLI 120G,A00,188858,Staff,9,0,30,21
1683303375424,POLI 131CR,A00,188863,Hoston; Germaine,24,0,50,26
1683303376451,POLI 133,A00,188864,Nellis; Gareth Hb,44,0,50,6
1683303377478,POLI 134D,A00,188865,Desposato; Scott,27,0,30,3
1683303378503,POLI 142A,A00,188871,Gartzke; Erik,22,0,50,28
1683303379530,POLI 142K,A00,188874,Staff,38,0,50,12
1683303380559,POLI 143,A00,188940,Gartzke; Erik,16,0,30,14
1683303381586,POLI 153,A00,188943,Staff,3,0,20,17
1683303382612,POLI 160AA,A00,188944,Staff,13,0,40,27
1683303383639,POLI 170A,A00,188945,Staff,11,0,30,19
1683303385687,PSYC 1,A00,188952,Staff,38,0,90,52
1683303386715,PSYC 2,B00,188953,Staff,20,0,35,15
1683303387746,PSYC 6,A00,188970,Staff,47,0,60,13
1683303388775,PSYC 7,A00,188973,Staff,37,0,45,8
1683303389803,PSYC 60,A01,188980,Rickard; Timothy C.,43,0,60,17
1683303390827,PSYC 70,A01,189001,Steiner; Eric Tomas,24,0,45,21
1683303391851,PSYC 100,A00,189005,Lacefield; Katharine I,0,99,120,120
1683303392876,PSYC 102,A00,189008,Staff,10,0,30,20
1683303393900,PSYC 106,B00,189026,Gorman; Michael R.,37,0,60,23
1683303394928,PSYC 114,B01,189033,Winkielman; Piotr,0,32,30,30
1683303395952,PSYC 131,A00,189036,Anagnostaras; Stephan,0,43,60,60
1683303396977,PSYC 136,A00,189041,Lowe; Angela Beth,0,7,25,25
1683303398006,PSYC 137,A00,189057,Winkielman; Piotr,0,34,25,25
1683303399033,PSYC 144,A00,189107,Wixted; John T,0,7,50,50
1683303401082,PSYC 162,A00,189142,Staff,0,8,85,85
1683303402105,PSYC 172,A00,189144,Gorman; Michael R.,0,7,30,30
1683303404156,PSYC 179,A00,189146,Lacefield; Katharine I,0,84,120,120
1683303405181,PSYC 181,A00,189147,Anagnostaras; Stephan,0,44,90,90
1683303406264,PSYC 190R,A00,189148,Barner; David A.,0,22,80,80
1683303407290,PSYC 191,A00,189275,Rickard; Timothy C.,0,7,25,25
1683303408318,PSYC 193,A00,189276,Chapman; Eddie Nathaniel,0,1,0,4
1683303409343,PSYC 193L,A01,189281,Lowe; Angela Beth,12,0,20,8
1683303409343,PSYC 193L,B01,189285,Staff,28,0,35,7
1683303410368,RELI 149,A00,187137,Rahimi; Babak,7,0,40,33
1683303411407,SE 9,A01,187315,Staff,0,2,18,18
1683303412432,SE 101B,A00,187409,Staff,24,0,30,6
1683303413455,SE 110B,A00,187444,Staff,10,0,40,30
1683303414485,SE 130B,A00,187449,Staff,31,0,40,9
1683303415512,SE 150A,A00,187516,Staff,9,0,20,11
1683303416536,SE 154,A00,187528,Staff,30,0,50,20
1683303417564,SIO 3,A01,258171,Staff,35,0,40,5
1683303418590,SIO 10,A00,187144,Cook; Geoffrey W,0,3,75,75
1683303419615,SIO 45,A00,187152,Cook; Geoffrey W,1,0,100,99
1683303420639,SIO 109R,A00,194486,Staff,0,3,20,20
1683303422692,SIO 187,A01,187233,Kacev; David,12,0,40,28
1683303423717,SOCI 1,A01,258656,Thorpe; Charles Robert,28,0,30,2
1683303423717,SOCI 1,A02,258658,Thorpe; Charles Robert,30,0,30,0
1683303423717,SOCI 1,A03,258661,Thorpe; Charles Robert,25,0,25,0
1683303423717,SOCI 1,A04,258666,Thorpe; Charles Robert,22,0,25,3
1683303423717,SOCI 1,A05,258897,Thorpe; Charles Robert,23,0,25,2
1683303423717,SOCI 1,A06,258898,Thorpe; Charles Robert,25,0,25,0
1683303424749,SOCI 30,A01,258903,Pardo Guerra; Juan Pablo,16,0,30,14
1683303425773,SOCI 102,A00,258904,Staff,9,0,25,16
1683303426797,SOCI 106,A00,258905,Staff,19,0,25,6
1683303427821,SOCI 111,A00,258907,Ribas Norris; Janet Vanesa,26,0,30,4
1683303428848,SOCI 121R,A00,258908,Pardo Guerra; Juan Pablo,11,0,30,19
1683303429875,SOCI 126,A01,203330,Staff,14,0,20,6
1683303430903,SOCI 131,A00,258909,Thorpe; Charles Robert,31,0,60,29
1683303431930,SOCI 135,A00,258910,Payne; Christine Anna,0,9,30,30
1683303432955,SOCI 157,A00,258911,Staff,13,0,30,17
1683303433981,SOCI 184,A00,258912,Staff,26,0,30,4
1683303435009,SOCI 188D,A00,258913,Staff,21,0,30,9
1683303436033,SYN 2,001,187529,Staff,9,0,16,7
1683303436033,SYN 2,002,201452,Staff,0,18,16,16
1683303436033,SYN 2,003,201469,Staff,3,0,16,13
1683303437062,SYN 100,A01,187531,Staff,0,9,20,20
1683303437062,SYN 100,B01,201491,Staff,0,12,20,20
1683303438085,TDAC 1,A00,189286,Walsh; Kim C.,3,0,20,17
1683303438085,TDAC 1,B00,189287,Harting; Carla Kelso,11,0,20,9
1683303439108,TDAC 101,A00,189300,Walsh; Kim C.,16,0,20,4
1683303439108,TDAC 101,B00,189301,Harting; Carla Kelso,18,0,20,2
1683303440135,TDAC 102,A00,189304,Basso; Beatrice,14,0,20,6
1683303441158,TDAC 108,A00,189305,Staff,18,0,20,2
1683303442185,TDDE 131,A00,189310,Staff,19,0,20,1
1683303442185,TDDE 131,B00,189314,Staff,19,0,20,1
1683303442185,TDDE 131,C00,189315,Staff,48,0,50,2
1683303442185,TDDE 131,D00,189316,Staff,14,0,15,1
1683303442185,TDDE 131,E00,204841,Staff,20,0,20,0
1683303443213,TDGE 10,A00,189289,Staff,30,0,50,20
1683303443213,TDGE 10,B00,189290,Havis; Allan,2,0,50,48
1683303444238,TDGE 11,A00,189291,Fulton; Julia,0,3,50,50
1683303444238,TDGE 11,B00,189292,Staff,20,0,25,5
1683303444238,TDGE 11,C00,260270,Staff,0,0,0,0
1683303445262,TDGE 25,A00,189294,Staff,3,0,20,17
1683303446289,TDGE 124,A00,189318,Fulton; Julia,0,8,50,50
1683303447318,TDGE 125,A00,189319,Staff,13,0,25,12
1683303447318,TDGE 125,B00,189320,Staff,23,0,25,2
1683303448342,TDGE 127,A00,189322,Havis; Allan,0,0,50,50
1683303449367,TDHT 101,A00,189323,Staff,18,0,25,7
1683303449367,TDHT 101,B00,189324,Staff,25,0,25,0
1683303450390,TDHT 102,A00,189325,Staff,49,0,50,1
1683303451418,TDMV 1,A00,189295,Arcidiacono; Kristin,20,0,30,10
1683303451418,TDMV 1,B00,189296,Caligagan; Maria T.,24,0,30,6
1683303452445,TDMV 2,A00,189297,Sammartano; Tonnie,28,0,30,2
1683303452445,TDMV 2,B00,189299,Arcidiacono; Kristin,24,0,30,6
1683303453473,TDMV 3,A00,204998,Rincon; Alicia,22,0,30,8
1683303454497,TDMV 120,A00,189458,Sammartano; Tonnie,28,0,30,2
1683303455522,TDMV 138,A00,189541,Jun; Grace Shin Hae,22,0,40,18
1683303456550,TDMV 142,A00,189717,Caligagan; Tony,23,0,30,7
1683303456550,TDMV 142,B00,189718,Caligagan; Maria T.,25,0,30,5
1683303457574,TMC 2,A01,187533,Staff,25,0,25,0
1683303457574,TMC 2,A02,187534,Staff,25,0,25,0
1683303458599,USP 1,A01,187536,Kwak; Nancy,0,16,25,25
1683303459624,USP 5,A01,187538,Staff,9,0,25,16
1683303460649,USP 101,A00,199253,Staff,0,4,0,0
1683303461677,USP 124,A00,187562,Boomhower; Matthew Charles,1,0,30,29
1683303462702,USP 138,A00,187582,Staff,20,0,25,5
1683303463732,USP 152,A01,187597,Staff,4,0,25,21
1683303464759,USP 153,A00,187598,Staff,19,0,25,6
1683303465785,USP 168,A00,187607,Kwak; Nancy,2,0,5,3
1683303466813,USP 173,A00,187619,Staff,4,0,25,21
1683303467838,USP 181,A00,187638,Staff,0,0,25,25
1683303468862,VIS 103,A00,187650,Cruz; Edwin Teddy,23,0,75,52
1683303469887,VIS 110D,A00,187669,Staff,12,0,22,10
1683303470911,VIS 127C,A00,187720,Shen; Kuiyi,68,0,146,78
1683303471935,VIS 149,A00,187731,Yoldas; Pinar,0,14,22,22
1683303472962,VIS 151,A01,188091,Staff,22,0,34,12
1683303472962,VIS 151,A02,188092,Staff,11,0,34,23
1683303473986,VIS 160B,A00,188093,Stalbaum; Brett,0,0,10,10
1683303476033,WCWP 10B,A00,201720,Staff,10,0,15,5
1683303476033,WCWP 10B,B00,201722,Staff,8,0,15,7
1683303477057,WCWP 100,A00,201725,Gagnon; Jeffrey C,0,0,2,2
1683303477057,WCWP 100,B00,201727,Staff,0,4,15,15
1683303480143,ANBI 133,A00,258401,Wilder; Linnea Lorene,34,0,40,6
1683303481168,ANBI 140,A00,258395,Hrvoj Mihic; Branka,18,0,25,7
1683303482193,ANSC 120,A00,258402,Bialecki; Jon Anthony,27,0,40,13
1683303483219,ANSC 144,A00,258400,Staff,14,0,40,26
1683303485272,ANSC 166,A00,258396,Parish; Steven Martin,157,0,175,18
1683303486298,ANSC 180,A00,193533,Staff,9,0,20,11
1683303487323,ANSC 188,A00,258397,Jassal; Aftab,33,0,40,7
1683303488349,ANTH 3,A01,258316,Staff,23,0,30,7
1683303489373,ANTH 5,A00,258394,Semendeferi; Ekaterini,16,0,20,4
1683303490398,ANTH 21,A01,258331,Staff,9,0,40,31
1683303491425,ANTH 103,A00,258398,Varma; Saiba,15,0,25,10
1683303492458,AWP 10,001,202034,Staff,0,0,0,0
1683303492458,AWP 10,002,202035,Staff,0,0,0,0
1683303492458,AWP 10,003,202036,Staff,0,0,0,0
1683303492458,AWP 10,004,202037,Staff,0,0,0,0
1683303492458,AWP 10,005,202038,Staff,0,0,0,0
1683303492458,AWP 10,006,202039,Staff,0,0,0,0
1683303492458,AWP 10,007,202040,Staff,0,0,0,0
1683303492458,AWP 10,008,202041,Staff,0,0,0,0
1683303492458,AWP 10,009,202042,Staff,0,0,0,0
1683303492458,AWP 10,010,202043,Staff,0,0,0,0
1683303492458,AWP 10,011,202044,Staff,0,0,0,0
1683303492458,AWP 10,012,202045,Staff,0,0,0,0
1683303492458,AWP 10,013,202046,Staff,0,0,0,0
1683303492458,AWP 10,014,202047,Staff,0,0,0,0
1683303492458,AWP 10,015,202048,Staff,0,0,0,0
1683303492458,AWP 10,016,202049,Staff,0,0,0,0
1683303492458,AWP 10,017,202050,Staff,0,0,0,0
1683303492458,AWP 10,018,202051,Staff,0,0,0,0
1683303492458,AWP 10,019,202052,Staff,0,0,0,0
1683303492458,AWP 10,020,202053,Staff,0,0,0,0
1683303492458,AWP 10,021,202054,Staff,0,0,0,0
1683303492458,AWP 10,022,202055,Staff,0,0,0,0
1683303492458,AWP 10,023,202056,Staff,0,0,0,0
1683303492458,AWP 10,024,202057,Staff,0,0,0,0
1683303492458,AWP 10,025,202058,Staff,0,0,0,0
1683303492458,AWP 10,026,202059,Staff,0,0,0,0
1683303493482,AWP 102,001,202032,Staff,0,0,0,0
1683303493482,AWP 102,002,202033,Staff,0,0,0,0
1683303494506,BENG 100,A01,254234,Taylor Amos; Alyssa C,31,0,40,9
1683303495531,BENG 196,001,270013,Engler; Adam J.,9999,0,9999,0
1683303496559,BICD 100R,A01,202018,Smith; Laurie,0,7,32,32
1683303496559,BICD 100R,A02,202019,Smith; Laurie,0,2,32,32
1683303496559,BICD 100R,A03,202020,Smith; Laurie,0,1,32,32
1683303496559,BICD 100R,A04,202021,Smith; Laurie,8,0,32,24
1683303496559,BICD 100R,A05,202022,Smith; Laurie,12,0,32,20
1683303497585,BICD 136,A01,193242,Gustafson-Brown; Cindy,0,2,32,32
1683303497585,BICD 136,A02,193244,Gustafson-Brown; Cindy,15,0,32,17
1683303498616,BIEB 102,A01,193249,Butler; Shannon Rhey,0,2,32,32
1683303498616,BIEB 102,A02,193251,Butler; Shannon Rhey,0,0,32,32
1683303498616,BIEB 102,A03,193253,Butler; Shannon Rhey,0,1,32,32
1683303498616,BIEB 102,A04,193255,Butler; Shannon Rhey,17,0,32,15
1683303498616,BIEB 102,A05,193265,Butler; Shannon Rhey,26,0,32,6
1683303498616,BIEB 102,A06,193269,Butler; Shannon Rhey,16,0,32,16
1683303500665,BIEB 150,A01,193274,Staff,0,0,32,32
1683303500665,BIEB 150,A02,193285,Staff,24,0,32,8
1683303501689,BIEB 194,A00,193286,Kurle; Carolyn M.,22,0,32,10
1683303502714,BILD 1,A01,192291,Staff,16,0,32,16
1683303502714,BILD 1,A02,192292,Staff,30,0,32,2
1683303502714,BILD 1,B01,192520,Reuther; Keefe,0,1,0,0
1683303502714,BILD 1,B02,192532,Reuther; Keefe,0,1,0,0
1683303503743,BILD 3,A01,192556,Butler; Shannon Rhey,0,0,32,32
1683303503743,BILD 3,A02,192581,Butler; Shannon Rhey,5,0,32,27
1683303503743,BILD 3,A03,192611,Butler; Shannon Rhey,23,0,32,9
1683303503743,BILD 3,A04,192612,Butler; Shannon Rhey,25,0,32,7
1683303503743,BILD 3,A05,192613,Butler; Shannon Rhey,27,0,32,5
1683303503743,BILD 3,A06,192679,Butler; Shannon Rhey,27,0,32,5
1683303503743,BILD 3,A07,192682,Butler; Shannon Rhey,22,0,32,10
1683303504767,BILD 4,A01,192836,Reuther; Keefe,1,0,24,23
1683303504767,BILD 4,A02,193044,Reuther; Keefe,4,0,24,20
1683303505796,BILD 10,A01,193142,Gustafson-Brown; Cindy,31,0,32,1
1683303505796,BILD 10,A02,193149,Gustafson-Brown; Cindy,31,0,32,1
1683303506824,BIMM 100,A01,193301,Staff,0,6,32,32
1683303506824,BIMM 100,A02,193312,Staff,0,5,32,32
1683303506824,BIMM 100,A03,193323,Staff,0,8,32,32
1683303507853,BIMM 101,A01,193329,McDonnell; Lisa Marie,0,3,24,24
1683303507853,BIMM 101,A02,193339,McDonnell; Lisa Marie,0,2,24,24
1683303507853,BIMM 101,B01,193354,McDonnell; Lisa Marie,0,3,24,24
1683303507853,BIMM 101,B02,193357,McDonnell; Lisa Marie,0,3,24,24
1683303508878,BIMM 110,A01,193377,Tat; John,0,11,32,32
1683303508878,BIMM 110,A02,193378,Tat; John,1,9,32,31
1683303509963,BIMM 120,A01,206116,Staff,0,0,32,32
1683303509963,BIMM 120,A02,206117,Staff,8,0,32,24
1683303509963,BIMM 120,A03,206121,Staff,21,0,32,11
1683303510991,BIPN 100,A01,193393,Park; Ji Young,0,14,32,32
1683303510991,BIPN 100,A02,193402,Park; Ji Young,0,12,32,32
1683303510991,BIPN 100,A03,193413,Park; Ji Young,0,14,32,32
1683303510991,BIPN 100,A04,193414,Park; Ji Young,0,13,32,32
1683303512019,BIPN 102,A01,193429,Staff,0,0,32,32
1683303512019,BIPN 102,A02,193438,Staff,23,0,32,9
1683303513046,BIPN 106,A01,193450,Reyes Gonzalez; Catalina,0,2,40,40
1683303514077,BIPN 134,A01,193465,Cooke; James Edward,0,0,32,32
1683303514077,BIPN 134,A02,193474,Cooke; James Edward,27,0,32,5
1683303514077,BIPN 134,A03,193485,Cooke; James Edward,29,0,32,3
1683303514077,BIPN 134,A04,193486,Cooke; James Edward,21,0,32,11
1683303514077,BIPN 134,A05,193491,Cooke; James Edward,31,0,32,1
1683303514077,BIPN 134,A06,193501,Cooke; James Edward,30,0,32,2
1683303514077,BIPN 134,A07,193510,Cooke; James Edward,29,0,32,3
1683303516129,BISP 194,A00,222522,Staff,16,0,32,16
1683303517155,CAT 124,A01,202407,Staff,20,0,25,5
1683303518180,CAT 125,A00,202408,Marchisotto; Jennifer Anne,4,0,20,16
1683303519205,CAT 125R,A00,202409,Smith; Lauryn Alissa,0,11,20,20
1683303519205,CAT 125R,B00,202410,Morales; Celeste Georgianna,0,11,20,20
1683303519205,CAT 125R,C00,202411,Irwin; Matthew Joseph,0,10,20,20
1683303520231,CENG 15,A01,204712,Yang; Kesong,0,1,0,0
1683303521256,CENG 114,A00,202070,Jahed Motlagh; Zeinab,5,0,20,15
1683303522280,CGS 105,A00,185477,Wesling; Megan E.,24,0,40,16
1683303523306,CGS 106,A00,185494,Staff,13,0,22,9
1683303524332,CGS 108,A00,185495,Staff,14,0,20,6
1683303525359,CGS 114,A00,185496,Staff,13,0,18,5
1683303526386,CGS 119,A00,185501,Staff,15,0,20,5
1683303527412,CGS 120,A00,185511,Staff,13,0,20,7
1683303528437,CHEM 4,A01,184675,Bussey; Thomas J,96,0,100,4
1683303529461,CHEM 6A,A01,184677,Staff,35,0,60,25
1683303530488,CHEM 6B,A01,184679,Staff,65,0,100,35
1683303531513,CHEM 6C,A01,184681,Bussey; Thomas J,1,0,50,49
1683303531513,CHEM 6C,A02,184682,Bussey; Thomas J,34,0,50,16
1683303532537,CHEM 40A,A01,184684,Albizati; Kim F.,37,0,100,63
1683303533561,CHEM 40B,A01,184686,Albizati; Kim F.,0,20,100,100
1683303534589,CHEM 41B,A01,184690,Staff,52,0,100,48
1683303535613,COGS 3,A01,184715,Boyle; Mary E. T.,0,25,40,40
1683303536643,COGS 14B,A01,185172,Staff,0,15,38,38
1683303537671,COGS 18,A01,184736,Staff,20,0,80,60
1683303538695,COGS 100,A01,184932,Staff,0,5,73,73
1683303539722,COGS 101A,A01,184935,Staff,0,38,30,30
1683303540747,COGS 101B,A01,184944,Staff,0,2,30,30
1683303541773,COGS 101C,A01,184946,Staff,0,12,30,30
1683303542801,COGS 102A,A01,184951,Johnson; Christine M.,2,0,40,38
1683303543825,COGS 107B,A01,184953,Mooshagian; Eric Frederick,0,50,40,40
1683303544850,COGS 118B,A01,184959,Gupta; Anjum,0,48,40,40
1683303545878,COGS 153,A00,184961,Staff,0,15,30,30
1683303546905,COGS 177,A00,184962,Staff,0,21,30,30
1683303547929,COGS 187A,A01,184969,Boyle; Mary E. T.,0,17,40,40
1683303548954,COMM 10,A01,185174,Staff,0,5,25,25
1683303548954,COMM 10,A02,185189,Staff,0,5,25,25
1683303548954,COMM 10,A03,269821,Staff,0,0,0,0
1683303549979,COMM 100B,A01,185475,Staff,0,0,0,2
1683303549979,COMM 100B,A02,185476,Staff,14,0,25,11
1683303551018,COMM 100C,A01,185314,Staff,1,0,25,24
1683303551018,COMM 100C,A02,185327,Staff,19,0,25,6
1683303552046,COMM 110M,A00,185349,Staff,2,0,40,38
1683303553070,COMM 113T,A00,185352,Staff,25,0,40,15
1683303554096,COMM 114I,A00,185353,Staff,33,0,40,7
1683303555121,COMM 131,A00,185354,Staff,19,0,30,11
1683303556146,CSE 8A,A50,185358,Cao; Yingjun,0,46,10,10
1683303557170,CSE 8B,A01,185362,Staff,1,47,50,49
1683303558194,CSE 11,A01,185416,Cao; Yingjun,0,93,10,10
1683303559218,CSE 20,A01,185445,Briones; Jor-el Thomas Caparas,5,0,25,20
1683303560242,CSE 21,A01,185447,Staff,10,0,50,40
1683303561271,CSE 101,A01,185451,Staff,0,12,50,50
1683303561271,CSE 101,B01,185453,Jones; Miles E,0,11,50,50
1683303563323,CSE 141,A01,185458,Eldon; John,20,0,100,80
1683303564350,CSE 141L,A01,185461,Eldon; John,12,0,100,88
1683303565379,CSE 142,A01,185463,Staff,35,0,60,25
1683303565379,CSE 142,B01,201355,Staff,0,6,60,60
1683303566407,CSE 142L,A01,185470,Staff,35,0,60,25
1683303566407,CSE 142L,B01,201417,Staff,0,5,60,60
1683303567434,CSE 190,A00,201433,Staff,32,0,49,17
1683303568458,DOC 1,A01,259136,Strom; Megan C.,8,0,15,7
1683303568458,DOC 1,A02,259137,Strom; Megan C.,14,0,15,1
1683303568458,DOC 1,A03,259138,Strom; Megan C.,14,0,15,1
1683303568458,DOC 1,A04,259139,Strom; Megan C.,14,0,15,1
1683303569483,DOC 100D,A00,259140,Pass; Natalye Joann,17,0,25,8
1683303570508,DSGN 1,A01,184749,Rill; Bryan,0,24,30,30
1683303571533,DSGN 100,A01,185168,Staff,0,2,25,25
1683303572557,ECE 5,A01,185626,Morris; Karcher William,0,10,0,0
1683303573580,ECE 101,A01,185628,Staff,17,0,70,53
1683303574608,ECE 107,A01,185635,Baghdadchi; Saharnaz,0,0,20,20
1683303574608,ECE 107,A02,185638,Baghdadchi; Saharnaz,4,0,20,16
1683303575635,ECE 148,A01,185647,Silberman; Jack,0,0,16,16
1683303576663,ECON 1,A01,185537,Crane; Meredith Helen,54,0,70,16
1683303577686,ECON 3,A01,185549,Crane; Meredith Helen,33,0,70,37
1683303578711,ECON 4,A01,203354,Anderson; John Charles,0,4,10,10
1683303579733,ECON 100A,A01,185574,Staff,0,4,40,40
1683303580761,ECON 100B,A01,185576,Staff,0,22,40,40
1683303581783,ECON 100C,A01,185589,Newhouse; Herbert S,30,0,70,40
1683303582810,ECON 105,A00,185608,Vespa; Emanuel Ignacio,19,0,35,16
1683303583838,ECON 109,A01,185610,Shishkin; Denis,10,0,35,25
1683303584865,ECON 110A,A01,185612,Staff,11,0,40,29
1683303585889,ECON 120A,A01,185615,Staff,20,0,40,20
1683303586914,ECON 120C,A01,185617,Sun; Yixiao,0,20,70,70
1683303587938,ECON 144,A00,203346,Squires; Dale E,3,0,35,32
1683303588962,ECON 171,A01,203349,Newhouse; Herbert S,0,1,35,35
1683303589987,ECON 173A,A01,185621,Toda; Alexis Akira,21,0,35,14
1683303591017,EDS 25,A01,202413,Staff,0,1,0,0
1683303591017,EDS 25,A02,202414,Staff,0,1,0,0
1683303591017,EDS 25,A03,202415,Staff,0,0,0,0
1683303591017,EDS 25,A04,202416,Staff,0,1,0,0
1683303591017,EDS 25,A05,202439,Staff,0,0,0,0
1683303591017,EDS 25,A06,202440,Staff,0,0,0,0
1683303591017,EDS 25,B01,202631,Staff,0,0,0,0
1683303591017,EDS 25,B02,202632,Staff,0,0,0,0
1683303591017,EDS 25,B03,202639,Staff,0,0,0,0
1683303591017,EDS 25,B04,202640,Staff,0,0,0,0
1683303591017,EDS 25,B05,202643,Staff,0,0,0,0
1683303591017,EDS 25,B06,202644,Staff,0,0,0,0
1683303592043,EDS 38,A01,202659,Black; Alison Michelle,24,0,25,1
1683303593069,EDS 115,A00,202652,Staff,17,0,30,13
1683303594093,EDS 125,A00,202649,Staff,14,0,30,16
1683303595116,EDS 126,A01,203332,Staff,30,0,30,0
1683303596141,EDS 139,A00,202838,Staff,17,0,25,8
1683303597164,EDS 146,A01,202655,Staff,15,0,25,10
1683303598193,ENG 15,A00,185667,Staff,0,1,0,0
1683303598193,ENG 15,B00,185672,Staff,0,0,0,0
1683303598193,ENG 15,C00,185675,Staff,0,0,0,0
1683303598193,ENG 15,D00,185682,Staff,0,0,0,0
1683303598193,ENG 15,E00,185684,Staff,0,0,0,0
1683303599218,ETHN 103,A00,185710,Staff,0,3,35,35
1683303600246,ETHN 103A,A00,199228,Man; Simeon S,2,0,9,7
1683303601269,ETHN 109,A00,185711,Staff,18,0,35,17
1683303602293,ETHN 142,A00,185726,Staff,0,4,30,30
1683303603317,ETHN 163J,A00,199229,Man; Simeon S,6,0,8,2
1683303604342,ETHN 168,A00,185727,Staff,8,0,10,2
1683303605365,ETHN 182,A00,185728,Staff,1,0,35,34
1683303606388,ETHN 183,A00,185737,Staff,8,0,18,10
1683303607414,GLBH 111,A01,209361,Burgos; Jose L.,0,0,0,0
1683303609466,HIEU 104,A00,185792,Staff,16,0,20,4
1683303610493,HIEU 115,A00,185800,Staff,1,0,20,19
1683303611516,HIEU 128,A00,185801,Staff,0,7,20,20
1683303612539,HIEU 147,A00,185802,Staff,16,0,20,4
1683303613619,HIEU 154,A00,185823,Staff,12,0,20,8
1683303614642,HILA 102,A00,185826,Staff,13,0,20,7
1683303615666,HILD 2C,A01,185778,Staff,0,12,20,20
1683303616695,HILD 7B,A01,185780,Kwak; Nancy,0,15,32,32
1683303616695,HILD 7B,A02,185781,Kwak; Nancy,0,18,32,32
1683303617723,HILD 30,A01,185791,Staff,14,0,20,6
1683303618747,HISC 119,A00,185830,Golan; Tal,0,9,20,20
1683303619771,HITO 156GS,A00,185831,Patterson; Patrick H.,0,0,0,23
1683303620798,HIUS 103,A00,185832,Man; Simeon S,0,6,20,20
1683303621825,HIUS 117,A00,185836,Kwak; Nancy,2,0,20,18
1683303622850,HIUS 125,A00,185840,Man; Simeon S,0,0,23,23
1683303623881,HIUS 149,A00,185845,Staff,0,0,20,20
1683303624905,HUM 3,A01,185882,Zavodny; Tatiana Sophia,0,6,50,50
1683303624905,HUM 3,B01,185899,Caldwell; Michael Alan,0,19,50,50
1683303625929,HUM 3GS,A00,185900,Patterson; Patrick H.,0,0,0,23
1683303626954,HUM 4,A01,185938,Zroka; Amy Liane,31,0,50,19
1683303626954,HUM 4,B01,185956,Watkins; Eric,0,2,50,50
1683303626954,HUM 4,B02,202209,Watkins; Eric,0,1,50,50
1683303626954,HUM 4,B03,202210,Watkins; Eric,0,0,50,50
1683303627978,HUM 5,A01,185958,West; Geoffrey Scott,5,0,50,45
1683303627978,HUM 5,A02,202215,West; Geoffrey Scott,0,0,50,50
1683303629005,INTL 190,A00,185959,Gagnon; Jeffrey C,0,0,0,9
1683303629005,INTL 190,B00,185960,Lettieri; Michael Joseph,0,0,0,1
1683303630031,JAPN 180,A00,254509,Staff,0,1,25,25
1683303631055,LATI 10,A01,202853,Kennemore; Amy Michelle,5,0,35,30
1683303631055,LATI 10,A02,202854,Kennemore; Amy Michelle,1,0,35,34
1683303631055,LATI 10,A03,270054,Kennemore; Amy Michelle,30,0,30,0
1683303632082,LATI 180,A00,202855,Kennemore; Amy Michelle,11,0,20,9
1683303633108,LAWS 101,A00,201767,Golan; Tal,0,7,40,40
1683303634132,LIFR 1C,A00,185961,Staff,6,0,20,14
1683303635156,LIFR 1CX,A00,185962,Staff,7,0,20,13
1683303636180,LIFR 1D,A00,185963,Staff,9,0,20,11
1683303637204,LIFR 1DX,A00,185964,Staff,9,0,20,11
1683303638227,LIGN 101,A01,186039,Staff,43,0,50,7
1683303639253,LIGN 165,A00,186040,Staff,18,0,50,32
1683303640277,LTCS 108,A00,186041,Staff,6,0,10,4
1683303641303,LTCS 119,A00,186042,Staff,16,0,20,4
1683303642331,LTCS 130,A00,186043,Wesling; Megan E.,15,0,25,10
1683303644382,LTEA 138,A00,186119,Staff,14,0,40,26
1683303645409,LTEN 124,A00,186148,Staff,6,0,25,19
1683303646432,LTEN 178,A00,186149,Staff,7,0,15,8
1683303647456,LTEN 181,A00,186150,Blanco; John D,33,0,40,7
1683303648483,LTWL 120,A00,186160,Staff,20,0,25,5
1683303649511,LTWL 165,A00,186161,Staff,22,0,25,3
1683303650535,LTWR 100,A00,186162,Staff,0,4,15,15
1683303651559,LTWR 102,A00,186163,Doller; Ben,5,0,15,10
1683303652587,MAE 8,A01,186412,Staff,0,0,0,0
1683303653611,MAE 30B,A00,186445,Bahadori; Mohammad Yousef,83,0,100,17
1683303654639,MAE 40,A00,186592,Bewley; Thomas R,9,0,50,41
1683303655662,MAE 101B,A00,186593,Bahadori; Mohammad Yousef,81,0,100,19
1683303656686,MAE 105,A00,186594,Bandaru; Prabhakar,12,0,50,38
1683303657714,MAE 107,A00,186599,Pham; Hieu Tan,0,6,120,120
1683303658738,MAE 148,A01,186660,Silberman; Jack,3,0,16,13
1683303659767,MATH 10A,A01,188095,Staff,0,7,35,35
1683303660791,MATH 10B,A01,188097,Bowers; Adam R.,0,11,30,30
1683303660791,MATH 10B,A02,188099,Bowers; Adam R.,0,9,30,30
1683303660791,MATH 10B,B01,188104,Bowers; Adam R.,0,11,30,30
1683303660791,MATH 10B,B02,188106,Bowers; Adam R.,0,11,30,30
1683303661817,MATH 10C,A01,188111,Staff,0,18,30,30
1683303661817,MATH 10C,A02,188127,Staff,0,17,30,30
1683303661817,MATH 10C,A03,188131,Staff,0,17,30,30
1683303661817,MATH 10C,B01,188218,Staff,21,0,30,9
1683303661817,MATH 10C,B02,188244,Staff,13,0,30,17
1683303661817,MATH 10C,B03,188277,Staff,16,0,30,14
1683303662842,MATH 18,A01,188344,Bach; Quang Tran,18,0,30,12
1683303662842,MATH 18,A02,188345,Bach; Quang Tran,11,0,30,19
1683303662842,MATH 18,B01,188353,Bach; Quang Tran,10,0,30,20
1683303662842,MATH 18,B02,188354,Bach; Quang Tran,20,0,30,10
1683303663866,MATH 20A,A01,188374,Staff,13,0,35,22
1683303664896,MATH 20B,A01,188382,Ohm; Ko Woon,6,0,30,24
1683303664896,MATH 20B,A02,188383,Ohm; Ko Woon,24,0,30,6
1683303664896,MATH 20B,B01,188385,Ohm; Ko Woon,7,0,30,23
1683303664896,MATH 20B,B02,188392,Ohm; Ko Woon,22,0,30,8
1683303665925,MATH 20C,A01,188394,Harel; Guershon,10,0,30,20
1683303665925,MATH 20C,A02,188395,Harel; Guershon,13,0,30,17
1683303665925,MATH 20C,B01,188404,Harel; Guershon,3,0,30,27
1683303665925,MATH 20C,B02,188405,Harel; Guershon,19,0,30,11
1683303666953,MATH 20D,A01,188414,Hammock; Frances H,0,1,30,30
1683303666953,MATH 20D,A02,188415,Hammock; Frances H,4,0,30,26
1683303666953,MATH 20D,B01,188447,Hammock; Frances H,2,0,30,28
1683303666953,MATH 20D,B02,188486,Hammock; Frances H,8,0,30,22
1683303667980,MATH 20E,A01,188649,Staff,22,0,30,8
1683303667980,MATH 20E,A02,188650,Staff,23,0,30,7
1683303667980,MATH 20E,A03,188673,Staff,0,0,30,30
1683303669007,MATH 102,A01,188675,Staff,0,35,35,35
1683303670032,MATH 103B,A01,188681,Staff,4,0,35,31
1683303670032,MATH 103B,B01,188692,Staff,7,0,35,28
1683303671056,MATH 109,A01,188695,Salehi Golsefidy; Alireza,25,0,35,10
1683303671056,MATH 109,A02,188696,Salehi Golsefidy; Alireza,27,0,35,8
1683303672079,MATH 120A,A01,188698,Eggers; John Dietrich,5,0,35,30
1683303673102,MATH 142B,A01,188736,Ioana; Adrian,0,2,30,30
1683303673102,MATH 142B,A02,188741,Ioana; Adrian,0,1,30,30
1683303673102,MATH 142B,A03,188743,Ioana; Adrian,0,3,30,30
1683303674126,MATH 168A,A01,188790,Staff,0,8,35,35
1683303675155,MATH 170A,A01,188803,Nie; Jiawang,0,2,35,35
1683303675155,MATH 170A,A02,188811,Nie; Jiawang,0,0,35,35
1683303675155,MATH 170A,A03,188814,Nie; Jiawang,1,0,35,34
1683303675155,MATH 170A,A04,188815,Nie; Jiawang,14,0,35,21
1683303676177,MATH 193B,A01,188817,Staff,0,0,35,35
1683303676177,MATH 193B,A02,188818,Staff,5,0,35,30
1683303677201,MGT 4,A01,202857,Anderson; John Charles,62,0,80,18
1683303678228,MGT 12,A00,202858,Lindenberger; Wade Douglas,43,0,90,47
1683303679251,MGT 18,A00,202859,Staff,74,0,90,16
1683303680277,MGT 18GS,A00,202860,McKay; Michael J,13,0,28,15
1683303681302,MGT 45,A00,202861,Pecore; Joseph P.,14,0,90,76
1683303682326,MGT 100,A00,202863,Yavorsky; Daniel Ryan,28,0,90,62
1683303683350,MGT 103,A00,202864,Ehrich; Kristine R,0,16,90,90
1683303684374,MGT 112,A00,202865,Ehrich; Kristine R,15,0,90,75
1683303685398,MGT 121A,A00,202868,Staff,0,19,0,0
1683303686425,MGT 131B,A00,202869,Anderson; John Charles,59,0,90,31
1683303687452,MGT 136,A00,202871,Lindenberger; Wade Douglas,84,0,90,6
1683303688476,MGT 164,A00,202873,Staff,0,69,90,90
1683303689499,MGT 164GS,A00,202874,McKay; Mary A,13,0,28,15
1683303690523,MGT 180,A00,202875,Staff,0,51,90,90
1683303691551,MMW 11R,A01,205019,Herbst; Matthew,3,0,30,27
1683303691551,MMW 11R,A02,205026,Herbst; Matthew,29,0,30,1
1683303692581,MMW 15,A01,193512,Chang; Edmond Yi-Teh,0,9,28,28
1683303692581,MMW 15,A02,193513,Chang; Edmond Yi-Teh,0,5,28,28
1683303692581,MMW 15,A03,193514,Chang; Edmond Yi-Teh,0,5,28,28
1683303692581,MMW 15,A04,193515,Chang; Edmond Yi-Teh,0,4,28,28
1683303692581,MMW 15,A05,193516,Chang; Edmond Yi-Teh,0,4,28,28
1683303692581,MMW 15,A06,193517,Chang; Edmond Yi-Teh,0,5,28,28
1683303692581,MMW 15,B01,193519,Chang; Edmond Yi-Teh,0,4,28,28
1683303692581,MMW 15,B02,193520,Chang; Edmond Yi-Teh,0,5,28,28
1683303692581,MMW 15,B03,193521,Chang; Edmond Yi-Teh,0,4,28,28
1683303692581,MMW 15,B04,193522,Chang; Edmond Yi-Teh,0,4,28,28
1683303692581,MMW 15,B05,193523,Chang; Edmond Yi-Teh,0,5,28,28
1683303692581,MMW 15,B06,193524,Chang; Edmond Yi-Teh,0,4,28,28
1683303693604,MMW 122,A01,193526,Rahimi; Babak,0,14,28,28
1683303693604,MMW 122,A02,193527,Rahimi; Babak,0,14,28,28
1683303693604,MMW 122,A03,193528,Rahimi; Babak,0,0,0,0
1683303693604,MMW 122,A04,193529,Rahimi; Babak,0,0,0,0
1683303694632,MUS 1A,A01,186663,Staff,0,20,35,35
1683303695655,MUS 4,A01,186715,Staff,0,12,35,35
1683303696682,MUS 5R,A01,186796,Dubnov; Shlomo,0,17,35,35
1683303697711,MUS 6,A01,186798,Staff,0,3,25,25
1683303698737,MUS 7,A01,186830,Staff,12,0,35,23
1683303699760,MUS 8,A01,186930,Staff,0,26,35,35
1683303700788,MUS 15,A01,186932,Staff,0,15,35,35
1683303700788,MUS 15,B01,186934,Staff,0,15,35,35
1683303701815,MUS 80,A00,186935,Staff,2,0,20,18
1683303701815,MUS 80,B00,186936,Staff,25,0,25,0
1683303702841,NANO 11,A00,204702,Lipomi; Darren John,0,0,0,0
1683303703865,NANO 15,A01,204709,Yang; Kesong,0,1,0,0
1683303704892,NANO 114,A00,202069,Jahed Motlagh; Zeinab,3,0,10,7
1683303705920,PHIL 1,A00,186955,Grush; Rick Scott,32,0,40,8
1683303706944,PHIL 10,A01,186973,Grush; Rick Scott,29,0,35,6
1683303706944,PHIL 10,A02,186974,Grush; Rick Scott,33,0,35,2
1683303707969,PHIL 13,A01,186976,Staff,7,0,35,28
1683303707969,PHIL 13,A02,186977,Staff,16,0,35,19
1683303708993,PHIL 14,A01,186979,Staff,31,0,35,4
1683303708993,PHIL 14,A02,186986,Staff,32,0,35,3
1683303710018,PHIL 28,A01,186988,Staff,16,0,30,14
1683303710018,PHIL 28,A02,186989,Staff,1,0,30,29
1683303710018,PHIL 28,A03,186990,Staff,9,0,30,21
1683303710018,PHIL 28,A04,186991,Staff,26,0,30,4
1683303711044,PHIL 120,A00,186997,Staff,23,0,40,17
1683303712069,PHIL 137,A00,187003,Staff,9,0,40,31
1683303713097,PHIL 150,A00,187015,Staff,47,0,70,23
1683303714122,PHIL 167,A00,187021,Lamey; Andy M.,35,0,40,5
1683303715147,PHIL 174,A01,202226,Staff,17,0,20,3
1683303715147,PHIL 174,A02,202235,Staff,20,0,20,0
1683303716174,PHIL 191A,A00,258918,Staff,0,0,1,1
1683303717258,PHYS 1A,A00,187028,Staff,26,0,60,34
1683303718285,PHYS 1AL,001,187036,Staff,2,0,30,28
1683303718285,PHYS 1AL,002,187049,Staff,18,0,30,12
1683303719309,PHYS 1B,A00,187058,Staff,23,0,60,37
1683303720343,PHYS 1BL,001,187064,Staff,0,0,30,30
1683303720343,PHYS 1BL,002,187070,Staff,6,0,30,24
1683303721370,PHYS 1C,A00,187082,Staff,31,0,120,89
1683303722399,PHYS 1CL,001,187088,Staff,0,9,30,30
1683303722399,PHYS 1CL,002,187089,Staff,0,2,30,30
1683303722399,PHYS 1CL,009,262693,Staff,12,0,30,18
1683303723427,PHYS 2B,A01,187097,Staff,54,0,115,61
1683303724451,PHYS 2C,A01,187099,Staff,67,0,115,48
1683303725475,PHYS 2CL,A01,187101,Staff,5,0,28,23
1683303725475,PHYS 2CL,A02,187102,Staff,15,0,28,13
1683303726503,PHYS 2D,A01,187123,Shotwell; Brian,95,0,115,20
1683303727531,PHYS 4B,A01,187133,Grinstein; Benjamin,35,0,50,15
1683303728555,POLI 10,A00,188819,Staff,0,3,50,50
1683303729580,POLI 11,A00,188827,Staff,43,0,50,7
1683303730605,POLI 13R,A00,188828,Staff,0,1,20,20
1683303731631,POLI 27,A01,188830,Elgin; Samuel Zincke,0,1,70,70
1683303732656,POLI 30,A00,188832,Desposato; Scott,33,0,50,17
1683303733681,POLI 102F,A00,188834,Staff,3,0,40,37
1683303734706,POLI 104A,A00,188852,Staff,14,0,30,16
1683303735733,POLI 104I,A00,188853,Staff,0,6,20,20
1683303736757,POLI 110B,A00,188854,Wiens; David,7,0,20,13
1683303737785,POLI 112A,A00,188855,Wiens; David,5,0,30,25
1683303738811,POLI 117R,A00,188856,Forman; Fonna,0,11,20,20
1683303739839,POLI 118,A00,188857,Ingham; Sean,8,0,20,12
1683303740869,POLI 120G,A00,188858,Staff,9,0,30,21
1683303741894,POLI 131CR,A00,188863,Hoston; Germaine,24,0,50,26
1683303742919,POLI 133,A00,188864,Nellis; Gareth Hb,44,0,50,6
1683303743947,POLI 134D,A00,188865,Desposato; Scott,27,0,30,3
1683303744974,POLI 142A,A00,188871,Gartzke; Erik,22,0,50,28
1683303745998,POLI 142K,A00,188874,Staff,38,0,50,12
1683303747023,POLI 143,A00,188940,Gartzke; Erik,16,0,30,14
1683303748049,POLI 153,A00,188943,Staff,3,0,20,17
1683303749075,POLI 160AA,A00,188944,Staff,13,0,40,27
1683303750103,POLI 170A,A00,188945,Staff,11,0,30,19
1683303752150,PSYC 1,A00,188952,Staff,38,0,90,52
1683303753174,PSYC 2,B00,188953,Staff,20,0,35,15
1683303754201,PSYC 6,A00,188970,Staff,47,0,60,13
1683303755225,PSYC 7,A00,188973,Staff,37,0,45,8
1683303756253,PSYC 60,A01,188980,Rickard; Timothy C.,43,0,60,17
1683303757279,PSYC 70,A01,189001,Steiner; Eric Tomas,24,0,45,21
1683303758305,PSYC 100,A00,189005,Lacefield; Katharine I,0,99,120,120
1683303759329,PSYC 102,A00,189008,Staff,10,0,30,20
1683303760356,PSYC 106,B00,189026,Gorman; Michael R.,37,0,60,23
1683303761382,PSYC 114,B01,189033,Winkielman; Piotr,0,32,30,30
1683303762407,PSYC 131,A00,189036,Anagnostaras; Stephan,0,43,60,60
1683303763430,PSYC 136,A00,189041,Lowe; Angela Beth,0,7,25,25
1683303764454,PSYC 137,A00,189057,Winkielman; Piotr,0,34,25,25
1683303765479,PSYC 144,A00,189107,Wixted; John T,0,7,50,50
1683303767529,PSYC 162,A00,189142,Staff,0,8,85,85
1683303768557,PSYC 172,A00,189144,Gorman; Michael R.,0,7,30,30
1683303770610,PSYC 179,A00,189146,Lacefield; Katharine I,0,84,120,120
1683303771636,PSYC 181,A00,189147,Anagnostaras; Stephan,0,44,90,90
1683303772664,PSYC 190R,A00,189148,Barner; David A.,0,22,80,80
1683303773690,PSYC 191,A00,189275,Rickard; Timothy C.,0,7,25,25
1683303774715,PSYC 193,A00,189276,Chapman; Eddie Nathaniel,0,1,0,4
1683303775738,PSYC 193L,A01,189281,Lowe; Angela Beth,12,0,20,8
1683303775738,PSYC 193L,B01,189285,Staff,28,0,35,7
1683303776765,RELI 149,A00,187137,Rahimi; Babak,7,0,40,33
1683303777792,SE 9,A01,187315,Staff,0,2,18,18
1683303778815,SE 101B,A00,187409,Staff,24,0,30,6
1683303779843,SE 110B,A00,187444,Staff,10,0,40,30
1683303780868,SE 130B,A00,187449,Staff,31,0,40,9
1683303781895,SE 150A,A00,187516,Staff,9,0,20,11
1683303782921,SE 154,A00,187528,Staff,30,0,50,20
1683303783950,SIO 3,A01,258171,Staff,35,0,40,5
1683303784977,SIO 10,A00,187144,Cook; Geoffrey W,0,3,75,75
1683303786004,SIO 45,A00,187152,Cook; Geoffrey W,1,0,100,99
1683303787029,SIO 109R,A00,194486,Staff,0,3,20,20
1683303789079,SIO 187,A01,187233,Kacev; David,12,0,40,28
1683303790104,SOCI 1,A01,258656,Thorpe; Charles Robert,28,0,30,2
1683303790104,SOCI 1,A02,258658,Thorpe; Charles Robert,30,0,30,0
1683303790104,SOCI 1,A03,258661,Thorpe; Charles Robert,25,0,25,0
1683303790104,SOCI 1,A04,258666,Thorpe; Charles Robert,22,0,25,3
1683303790104,SOCI 1,A05,258897,Thorpe; Charles Robert,23,0,25,2
1683303790104,SOCI 1,A06,258898,Thorpe; Charles Robert,25,0,25,0
1683303791132,SOCI 30,A01,258903,Pardo Guerra; Juan Pablo,16,0,30,14
1683303792158,SOCI 102,A00,258904,Staff,9,0,25,16
1683303793182,SOCI 106,A00,258905,Staff,19,0,25,6
1683303794206,SOCI 111,A00,258907,Ribas Norris; Janet Vanesa,26,0,30,4
1683303795230,SOCI 121R,A00,258908,Pardo Guerra; Juan Pablo,11,0,30,19
1683303796253,SOCI 126,A01,203330,Staff,14,0,20,6
1683303797276,SOCI 131,A00,258909,Thorpe; Charles Robert,31,0,60,29
1683303798303,SOCI 135,A00,258910,Payne; Christine Anna,0,9,30,30
1683303799329,SOCI 157,A00,258911,Staff,13,0,30,17
1683303800357,SOCI 184,A00,258912,Staff,26,0,30,4
1683303801383,SOCI 188D,A00,258913,Staff,21,0,30,9
1683303802408,SYN 2,001,187529,Staff,9,0,16,7
1683303802408,SYN 2,002,201452,Staff,0,18,16,16
1683303802408,SYN 2,003,201469,Staff,3,0,16,13
1683303803433,SYN 100,A01,187531,Staff,0,9,20,20
1683303803433,SYN 100,B01,201491,Staff,0,12,20,20
1683303804460,TDAC 1,A00,189286,Walsh; Kim C.,3,0,20,17
1683303804460,TDAC 1,B00,189287,Harting; Carla Kelso,11,0,20,9
1683303805489,TDAC 101,A00,189300,Walsh; Kim C.,16,0,20,4
1683303805489,TDAC 101,B00,189301,Harting; Carla Kelso,18,0,20,2
1683303806517,TDAC 102,A00,189304,Basso; Beatrice,14,0,20,6
1683303807542,TDAC 108,A00,189305,Staff,18,0,20,2
1683303808567,TDDE 131,A00,189310,Staff,19,0,20,1
1683303808567,TDDE 131,B00,189314,Staff,19,0,20,1
1683303808567,TDDE 131,C00,189315,Staff,48,0,50,2
1683303808567,TDDE 131,D00,189316,Staff,14,0,15,1
1683303808567,TDDE 131,E00,204841,Staff,20,0,20,0
1683303809592,TDGE 10,A00,189289,Staff,30,0,50,20
1683303809592,TDGE 10,B00,189290,Havis; Allan,2,0,50,48
1683303810616,TDGE 11,A00,189291,Fulton; Julia,0,3,50,50
1683303810616,TDGE 11,B00,189292,Staff,20,0,25,5
1683303810616,TDGE 11,C00,260270,Staff,0,0,0,0
1683303811644,TDGE 25,A00,189294,Staff,3,0,20,17
1683303812669,TDGE 124,A00,189318,Fulton; Julia,0,8,50,50
1683303813696,TDGE 125,A00,189319,Staff,13,0,25,12
1683303813696,TDGE 125,B00,189320,Staff,23,0,25,2
1683303814720,TDGE 127,A00,189322,Havis; Allan,0,0,50,50
1683303815748,TDHT 101,A00,189323,Staff,18,0,25,7
1683303815748,TDHT 101,B00,189324,Staff,25,0,25,0
1683303816771,TDHT 102,A00,189325,Staff,49,0,50,1
1683303817795,TDMV 1,A00,189295,Arcidiacono; Kristin,20,0,30,10
1683303817795,TDMV 1,B00,189296,Caligagan; Maria T.,24,0,30,6
1683303818825,TDMV 2,A00,189297,Sammartano; Tonnie,28,0,30,2
1683303818825,TDMV 2,B00,189299,Arcidiacono; Kristin,24,0,30,6
1683303819852,TDMV 3,A00,204998,Rincon; Alicia,22,0,30,8
1683303820932,TDMV 120,A00,189458,Sammartano; Tonnie,28,0,30,2
1683303821957,TDMV 138,A00,189541,Jun; Grace Shin Hae,22,0,40,18
1683303822983,TDMV 142,A00,189717,Caligagan; Tony,23,0,30,7
1683303822983,TDMV 142,B00,189718,Caligagan; Maria T.,25,0,30,5
1683303824011,TMC 2,A01,187533,Staff,25,0,25,0
1683303824011,TMC 2,A02,187534,Staff,25,0,25,0
1683303825040,USP 1,A01,187536,Kwak; Nancy,0,16,25,25
1683303826065,USP 5,A01,187538,Staff,9,0,25,16
1683303827097,USP 101,A00,199253,Staff,0,4,0,0
1683303828124,USP 124,A00,187562,Boomhower; Matthew Charles,1,0,30,29
1683303829150,USP 138,A00,187582,Staff,20,0,25,5
1683303830175,USP 152,A01,187597,Staff,4,0,25,21
1683303831203,USP 153,A00,187598,Staff,19,0,25,6
1683303832229,USP 168,A00,187607,Kwak; Nancy,2,0,5,3
1683303833254,USP 173,A00,187619,Staff,4,0,25,21
1683303834282,USP 181,A00,187638,Staff,0,0,25,25
1683303835311,VIS 103,A00,187650,Cruz; Edwin Teddy,23,0,75,52
1683303836336,VIS 110D,A00,187669,Staff,12,0,22,10
1683303837360,VIS 127C,A00,187720,Shen; Kuiyi,68,0,146,78
1683303838382,VIS 149,A00,187731,Yoldas; Pinar,0,14,22,22
1683303839409,VIS 151,A01,188091,Staff,22,0,34,12
1683303839409,VIS 151,A02,188092,Staff,11,0,34,23
1683303840433,VIS 160B,A00,188093,Stalbaum; Brett,0,0,10,10
1683303842487,WCWP 10B,A00,201720,Staff,10,0,15,5
1683303842487,WCWP 10B,B00,201722,Staff,8,0,15,7
1683303843514,WCWP 100,A00,201725,Gagnon; Jeffrey C,0,0,2,2
1683303843514,WCWP 100,B00,201727,Staff,0,4,15,15
1683303846652,ANBI 133,A00,258401,Wilder; Linnea Lorene,34,0,40,6
1683303847682,ANBI 140,A00,258395,Hrvoj Mihic; Branka,18,0,25,7
1683303848707,ANSC 120,A00,258402,Bialecki; Jon Anthony,27,0,40,13
1683303849731,ANSC 144,A00,258400,Staff,14,0,40,26
1683303851786,ANSC 166,A00,258396,Parish; Steven Martin,157,0,175,18
1683303852811,ANSC 180,A00,193533,Staff,9,0,20,11
1683303853838,ANSC 188,A00,258397,Jassal; Aftab,33,0,40,7
1683303854865,ANTH 3,A01,258316,Staff,23,0,30,7
1683303855889,ANTH 5,A00,258394,Semendeferi; Ekaterini,16,0,20,4
1683303856914,ANTH 21,A01,258331,Staff,9,0,40,31
1683303857939,ANTH 103,A00,258398,Varma; Saiba,15,0,25,10
1683303858966,AWP 10,001,202034,Staff,0,0,0,0
1683303858966,AWP 10,002,202035,Staff,0,0,0,0
1683303858966,AWP 10,003,202036,Staff,0,0,0,0
1683303858966,AWP 10,004,202037,Staff,0,0,0,0
1683303858966,AWP 10,005,202038,Staff,0,0,0,0
1683303858966,AWP 10,006,202039,Staff,0,0,0,0
1683303858966,AWP 10,007,202040,Staff,0,0,0,0
1683303858966,AWP 10,008,202041,Staff,0,0,0,0
1683303858966,AWP 10,009,202042,Staff,0,0,0,0
1683303858966,AWP 10,010,202043,Staff,0,0,0,0
1683303858966,AWP 10,011,202044,Staff,0,0,0,0
1683303858966,AWP 10,012,202045,Staff,0,0,0,0
1683303858966,AWP 10,013,202046,Staff,0,0,0,0
1683303858966,AWP 10,014,202047,Staff,0,0,0,0
1683303858966,AWP 10,015,202048,Staff,0,0,0,0
1683303858966,AWP 10,016,202049,Staff,0,0,0,0
1683303858966,AWP 10,017,202050,Staff,0,0,0,0
1683303858966,AWP 10,018,202051,Staff,0,0,0,0
1683303858966,AWP 10,019,202052,Staff,0,0,0,0
1683303858966,AWP 10,020,202053,Staff,0,0,0,0
1683303858966,AWP 10,021,202054,Staff,0,0,0,0
1683303858966,AWP 10,022,202055,Staff,0,0,0,0
1683303858966,AWP 10,023,202056,Staff,0,0,0,0
1683303858966,AWP 10,024,202057,Staff,0,0,0,0
1683303858966,AWP 10,025,202058,Staff,0,0,0,0
1683303858966,AWP 10,026,202059,Staff,0,0,0,0
1683303859990,AWP 102,001,202032,Staff,0,0,0,0
1683303859990,AWP 102,002,202033,Staff,0,0,0,0
1683303861015,BENG 100,A01,254234,Taylor Amos; Alyssa C,31,0,40,9
1683303862039,BENG 196,001,270013,Engler; Adam J.,9999,0,9999,0
1683303863071,BICD 100R,A01,202018,Smith; Laurie,0,7,32,32
1683303863071,BICD 100R,A02,202019,Smith; Laurie,0,2,32,32
1683303863071,BICD 100R,A03,202020,Smith; Laurie,0,1,32,32
1683303863071,BICD 100R,A04,202021,Smith; Laurie,8,0,32,24
1683303863071,BICD 100R,A05,202022,Smith; Laurie,12,0,32,20
1683303864097,BICD 136,A01,193242,Gustafson-Brown; Cindy,0,2,32,32
1683303864097,BICD 136,A02,193244,Gustafson-Brown; Cindy,15,0,32,17
1683303865125,BIEB 102,A01,193249,Butler; Shannon Rhey,0,2,32,32
1683303865125,BIEB 102,A02,193251,Butler; Shannon Rhey,0,0,32,32
1683303865125,BIEB 102,A03,193253,Butler; Shannon Rhey,0,1,32,32
1683303865125,BIEB 102,A04,193255,Butler; Shannon Rhey,17,0,32,15
1683303865125,BIEB 102,A05,193265,Butler; Shannon Rhey,26,0,32,6
1683303865125,BIEB 102,A06,193269,Butler; Shannon Rhey,16,0,32,16
1683303867180,BIEB 150,A01,193274,Staff,0,0,32,32
1683303867180,BIEB 150,A02,193285,Staff,24,0,32,8
1683303868204,BIEB 194,A00,193286,Kurle; Carolyn M.,22,0,32,10
1683303869234,BILD 1,A01,192291,Staff,16,0,32,16
1683303869234,BILD 1,A02,192292,Staff,30,0,32,2
1683303869234,BILD 1,B01,192520,Reuther; Keefe,0,1,0,0
1683303869234,BILD 1,B02,192532,Reuther; Keefe,0,1,0,0
1683303870259,BILD 3,A01,192556,Butler; Shannon Rhey,0,0,32,32
1683303870259,BILD 3,A02,192581,Butler; Shannon Rhey,5,0,32,27
1683303870259,BILD 3,A03,192611,Butler; Shannon Rhey,23,0,32,9
1683303870259,BILD 3,A04,192612,Butler; Shannon Rhey,25,0,32,7
1683303870259,BILD 3,A05,192613,Butler; Shannon Rhey,27,0,32,5
1683303870259,BILD 3,A06,192679,Butler; Shannon Rhey,27,0,32,5
1683303870259,BILD 3,A07,192682,Butler; Shannon Rhey,22,0,32,10
1683303871282,BILD 4,A01,192836,Reuther; Keefe,1,0,24,23
1683303871282,BILD 4,A02,193044,Reuther; Keefe,4,0,24,20
1683303872307,BILD 10,A01,193142,Gustafson-Brown; Cindy,31,0,32,1
1683303872307,BILD 10,A02,193149,Gustafson-Brown; Cindy,31,0,32,1
1683303873337,BIMM 100,A01,193301,Staff,0,6,32,32
1683303873337,BIMM 100,A02,193312,Staff,0,5,32,32
1683303873337,BIMM 100,A03,193323,Staff,0,8,32,32
1683303874364,BIMM 101,A01,193329,McDonnell; Lisa Marie,0,3,24,24
1683303874364,BIMM 101,A02,193339,McDonnell; Lisa Marie,0,2,24,24
1683303874364,BIMM 101,B01,193354,McDonnell; Lisa Marie,0,3,24,24
1683303874364,BIMM 101,B02,193357,McDonnell; Lisa Marie,0,3,24,24
1683303875389,BIMM 110,A01,193377,Tat; John,0,11,32,32
1683303875389,BIMM 110,A02,193378,Tat; John,1,9,32,31
1683303876418,BIMM 120,A01,206116,Staff,0,0,32,32
1683303876418,BIMM 120,A02,206117,Staff,8,0,32,24
1683303876418,BIMM 120,A03,206121,Staff,21,0,32,11
1683303877444,BIPN 100,A01,193393,Park; Ji Young,0,14,32,32
1683303877444,BIPN 100,A02,193402,Park; Ji Young,0,12,32,32
1683303877444,BIPN 100,A03,193413,Park; Ji Young,0,14,32,32
1683303877444,BIPN 100,A04,193414,Park; Ji Young,0,13,32,32
1683303878472,BIPN 102,A01,193429,Staff,0,0,32,32
1683303878472,BIPN 102,A02,193438,Staff,23,0,32,9
1683303879497,BIPN 106,A01,193450,Reyes Gonzalez; Catalina,0,2,40,40
1683303880528,BIPN 134,A01,193465,Cooke; James Edward,0,0,32,32
1683303880528,BIPN 134,A02,193474,Cooke; James Edward,27,0,32,5
1683303880528,BIPN 134,A03,193485,Cooke; James Edward,29,0,32,3
1683303880528,BIPN 134,A04,193486,Cooke; James Edward,21,0,32,11
1683303880528,BIPN 134,A05,193491,Cooke; James Edward,31,0,32,1
1683303880528,BIPN 134,A06,193501,Cooke; James Edward,30,0,32,2
1683303880528,BIPN 134,A07,193510,Cooke; James Edward,29,0,32,3
1683303882578,BISP 194,A00,222522,Staff,16,0,32,16
1683303883601,CAT 124,A01,202407,Staff,20,0,25,5
1683303884628,CAT 125,A00,202408,Marchisotto; Jennifer Anne,4,0,20,16
1683303885653,CAT 125R,A00,202409,Smith; Lauryn Alissa,0,11,20,20
1683303885653,CAT 125R,B00,202410,Morales; Celeste Georgianna,0,11,20,20
1683303885653,CAT 125R,C00,202411,Irwin; Matthew Joseph,0,10,20,20
1683303886681,CENG 15,A01,204712,Yang; Kesong,0,1,0,0
1683303887706,CENG 114,A00,202070,Jahed Motlagh; Zeinab,5,0,20,15
1683303888734,CGS 105,A00,185477,Wesling; Megan E.,24,0,40,16
1683303889760,CGS 106,A00,185494,Staff,13,0,22,9
1683303890786,CGS 108,A00,185495,Staff,14,0,20,6
1683303891814,CGS 114,A00,185496,Staff,13,0,18,5
1683303892841,CGS 119,A00,185501,Staff,15,0,20,5
1683303893865,CGS 120,A00,185511,Staff,13,0,20,7
1683303894891,CHEM 4,A01,184675,Bussey; Thomas J,96,0,100,4
1683303895919,CHEM 6A,A01,184677,Staff,35,0,60,25
1683303896946,CHEM 6B,A01,184679,Staff,65,0,100,35
1683303897973,CHEM 6C,A01,184681,Bussey; Thomas J,1,0,50,49
1683303897973,CHEM 6C,A02,184682,Bussey; Thomas J,34,0,50,16
1683303898998,CHEM 40A,A01,184684,Albizati; Kim F.,37,0,100,63
1683303900021,CHEM 40B,A01,184686,Albizati; Kim F.,0,20,100,100
1683303901046,CHEM 41B,A01,184690,Staff,52,0,100,48
1683303902070,COGS 3,A01,184715,Boyle; Mary E. T.,0,25,40,40
1683303903098,COGS 14B,A01,185172,Staff,0,15,38,38
1683303904123,COGS 18,A01,184736,Staff,20,0,80,60
1683303905150,COGS 100,A01,184932,Staff,0,5,73,73
1683303906178,COGS 101A,A01,184935,Staff,0,38,30,30
1683303907203,COGS 101B,A01,184944,Staff,0,2,30,30
1683303908226,COGS 101C,A01,184946,Staff,0,12,30,30
1683303909251,COGS 102A,A01,184951,Johnson; Christine M.,2,0,40,38
1683303910278,COGS 107B,A01,184953,Mooshagian; Eric Frederick,0,50,40,40
1683303911304,COGS 118B,A01,184959,Gupta; Anjum,0,48,40,40
1683303912328,COGS 153,A00,184961,Staff,0,15,30,30
1683303913354,COGS 177,A00,184962,Staff,0,21,30,30
1683303914377,COGS 187A,A01,184969,Boyle; Mary E. T.,0,17,40,40
1683303915404,COMM 10,A01,185174,Staff,0,5,25,25
1683303915404,COMM 10,A02,185189,Staff,0,5,25,25
1683303915404,COMM 10,A03,269821,Staff,0,0,0,0
1683303916431,COMM 100B,A01,185475,Staff,0,0,0,2
1683303916431,COMM 100B,A02,185476,Staff,14,0,25,11
1683303917455,COMM 100C,A01,185314,Staff,1,0,25,24
1683303917455,COMM 100C,A02,185327,Staff,19,0,25,6
1683303918482,COMM 110M,A00,185349,Staff,2,0,40,38
1683303919506,COMM 113T,A00,185352,Staff,25,0,40,15
1683303920533,COMM 114I,A00,185353,Staff,33,0,40,7
1683303921558,COMM 131,A00,185354,Staff,19,0,30,11
1683303922586,CSE 8A,A50,185358,Cao; Yingjun,0,46,10,10
1683303923615,CSE 8B,A01,185362,Staff,1,47,50,49
1683303924699,CSE 11,A01,185416,Cao; Yingjun,0,93,10,10
1683303925730,CSE 20,A01,185445,Briones; Jor-el Thomas Caparas,5,0,25,20
1683303926754,CSE 21,A01,185447,Staff,10,0,50,40
1683303927779,CSE 101,A01,185451,Staff,0,12,50,50
1683303927779,CSE 101,B01,185453,Jones; Miles E,0,11,50,50
1683303929832,CSE 141,A01,185458,Eldon; John,20,0,100,80
1683303930855,CSE 141L,A01,185461,Eldon; John,12,0,100,88
1683303931882,CSE 142,A01,185463,Staff,35,0,60,25
1683303931882,CSE 142,B01,201355,Staff,0,6,60,60
1683303932906,CSE 142L,A01,185470,Staff,35,0,60,25
1683303932906,CSE 142L,B01,201417,Staff,0,5,60,60
1683303933933,CSE 190,A00,201433,Staff,32,0,49,17
1683303934956,DOC 1,A01,259136,Strom; Megan C.,8,0,15,7
1683303934956,DOC 1,A02,259137,Strom; Megan C.,14,0,15,1
1683303934956,DOC 1,A03,259138,Strom; Megan C.,14,0,15,1
1683303934956,DOC 1,A04,259139,Strom; Megan C.,14,0,15,1
1683303935979,DOC 100D,A00,259140,Pass; Natalye Joann,17,0,25,8
1683303937003,DSGN 1,A01,184749,Rill; Bryan,0,24,30,30
1683303938032,DSGN 100,A01,185168,Staff,0,2,25,25
1683303939058,ECE 5,A01,185626,Morris; Karcher William,0,10,0,0
1683303940082,ECE 101,A01,185628,Staff,17,0,70,53
1683303941105,ECE 107,A01,185635,Baghdadchi; Saharnaz,0,0,20,20
1683303941105,ECE 107,A02,185638,Baghdadchi; Saharnaz,4,0,20,16
1683303942132,ECE 148,A01,185647,Silberman; Jack,0,0,16,16
1683303943159,ECON 1,A01,185537,Crane; Meredith Helen,54,0,70,16
1683303944186,ECON 3,A01,185549,Crane; Meredith Helen,33,0,70,37
1683303945211,ECON 4,A01,203354,Anderson; John Charles,0,4,10,10
1683303946234,ECON 100A,A01,185574,Staff,0,4,40,40
1683303947258,ECON 100B,A01,185576,Staff,0,22,40,40
1683303948283,ECON 100C,A01,185589,Newhouse; Herbert S,30,0,70,40
1683303949309,ECON 105,A00,185608,Vespa; Emanuel Ignacio,19,0,35,16
1683303950335,ECON 109,A01,185610,Shishkin; Denis,10,0,35,25
1683303951359,ECON 110A,A01,185612,Staff,11,0,40,29
1683303952386,ECON 120A,A01,185615,Staff,20,0,40,20
1683303953410,ECON 120C,A01,185617,Sun; Yixiao,0,20,70,70
1683303954437,ECON 144,A00,203346,Squires; Dale E,3,0,35,32
1683303955464,ECON 171,A01,203349,Newhouse; Herbert S,0,1,35,35
1683303956489,ECON 173A,A01,185621,Toda; Alexis Akira,21,0,35,14
1683303957515,EDS 25,A01,202413,Staff,0,1,0,0
1683303957515,EDS 25,A02,202414,Staff,0,1,0,0
1683303957515,EDS 25,A03,202415,Staff,0,0,0,0
1683303957515,EDS 25,A04,202416,Staff,0,1,0,0
1683303957515,EDS 25,A05,202439,Staff,0,0,0,0
1683303957515,EDS 25,A06,202440,Staff,0,0,0,0
1683303957515,EDS 25,B01,202631,Staff,0,0,0,0
1683303957515,EDS 25,B02,202632,Staff,0,0,0,0
1683303957515,EDS 25,B03,202639,Staff,0,0,0,0
1683303957515,EDS 25,B04,202640,Staff,0,0,0,0
1683303957515,EDS 25,B05,202643,Staff,0,0,0,0
1683303957515,EDS 25,B06,202644,Staff,0,0,0,0
1683303958542,EDS 38,A01,202659,Black; Alison Michelle,24,0,25,1
1683303959569,EDS 115,A00,202652,Staff,17,0,30,13
1683303960596,EDS 125,A00,202649,Staff,14,0,30,16
1683303961623,EDS 126,A01,203332,Staff,30,0,30,0
1683303962647,EDS 139,A00,202838,Staff,17,0,25,8
1683303963673,EDS 146,A01,202655,Staff,15,0,25,10
1683303964697,ENG 15,A00,185667,Staff,0,1,0,0
1683303964697,ENG 15,B00,185672,Staff,0,0,0,0
1683303964697,ENG 15,C00,185675,Staff,0,0,0,0
1683303964697,ENG 15,D00,185682,Staff,0,0,0,0
1683303964697,ENG 15,E00,185684,Staff,0,0,0,0
1683303965721,ETHN 103,A00,185710,Staff,0,3,35,35
1683303966746,ETHN 103A,A00,199228,Man; Simeon S,2,0,9,7
1683303967771,ETHN 109,A00,185711,Staff,18,0,35,17
1683303968794,ETHN 142,A00,185726,Staff,0,4,30,30
1683303969823,ETHN 163J,A00,199229,Man; Simeon S,6,0,8,2
1683303970850,ETHN 168,A00,185727,Staff,8,0,10,2
1683303971874,ETHN 182,A00,185728,Staff,1,0,35,34
1683303972899,ETHN 183,A00,185737,Staff,8,0,18,10
1683303973923,GLBH 111,A01,209361,Burgos; Jose L.,0,0,0,0
1683303975974,HIEU 104,A00,185792,Staff,16,0,20,4
1683303977001,HIEU 115,A00,185800,Staff,1,0,20,19
1683303978030,HIEU 128,A00,185801,Staff,0,7,20,20
1683303979058,HIEU 147,A00,185802,Staff,16,0,20,4
1683303980082,HIEU 154,A00,185823,Staff,12,0,20,8
1683303981110,HILA 102,A00,185826,Staff,13,0,20,7
1683303982134,HILD 2C,A01,185778,Staff,0,12,20,20
1683303983159,HILD 7B,A01,185780,Kwak; Nancy,0,15,32,32
1683303983159,HILD 7B,A02,185781,Kwak; Nancy,0,18,32,32
1683303984183,HILD 30,A01,185791,Staff,14,0,20,6
1683303985209,HISC 119,A00,185830,Golan; Tal,0,9,20,20
1683303986242,HITO 156GS,A00,185831,Patterson; Patrick H.,0,0,0,23
1683303987270,HIUS 103,A00,185832,Man; Simeon S,0,6,20,20
1683303988296,HIUS 117,A00,185836,Kwak; Nancy,2,0,20,18
1683303989321,HIUS 125,A00,185840,Man; Simeon S,0,0,23,23
1683303990350,HIUS 149,A00,185845,Staff,0,0,20,20
1683303991379,HUM 3,A01,185882,Zavodny; Tatiana Sophia,0,6,50,50
1683303991379,HUM 3,B01,185899,Caldwell; Michael Alan,0,19,50,50
1683303992406,HUM 3GS,A00,185900,Patterson; Patrick H.,0,0,0,23
1683303993435,HUM 4,A01,185938,Zroka; Amy Liane,31,0,50,19
1683303993435,HUM 4,B01,185956,Watkins; Eric,0,2,50,50
1683303993435,HUM 4,B02,202209,Watkins; Eric,0,1,50,50
1683303993435,HUM 4,B03,202210,Watkins; Eric,0,0,50,50
1683303994460,HUM 5,A01,185958,West; Geoffrey Scott,5,0,50,45
1683303994460,HUM 5,A02,202215,West; Geoffrey Scott,0,0,50,50
1683303995487,INTL 190,A00,185959,Gagnon; Jeffrey C,0,0,0,9
1683303995487,INTL 190,B00,185960,Lettieri; Michael Joseph,0,0,0,1
1683303996511,JAPN 180,A00,254509,Staff,5,1,30,25
1683303997536,LATI 10,A01,202853,Kennemore; Amy Michelle,5,0,35,30
1683303997536,LATI 10,A02,202854,Kennemore; Amy Michelle,1,0,35,34
1683303997536,LATI 10,A03,270054,Kennemore; Amy Michelle,30,0,30,0
1683303998560,LATI 180,A00,202855,Kennemore; Amy Michelle,11,0,20,9
1683303999585,LAWS 101,A00,201767,Golan; Tal,0,7,40,40
1683304000609,LIFR 1C,A00,185961,Staff,6,0,20,14
1683304001635,LIFR 1CX,A00,185962,Staff,7,0,20,13
1683304002659,LIFR 1D,A00,185963,Staff,9,0,20,11
1683304003684,LIFR 1DX,A00,185964,Staff,9,0,20,11
1683304004711,LIGN 101,A01,186039,Staff,43,0,50,7
1683304005738,LIGN 165,A00,186040,Staff,18,0,50,32
1683304006763,LTCS 108,A00,186041,Staff,6,0,10,4
1683304007788,LTCS 119,A00,186042,Staff,16,0,20,4
1683304008813,LTCS 130,A00,186043,Wesling; Megan E.,15,0,25,10
1683304010866,LTEA 138,A00,186119,Staff,14,0,40,26
1683304011893,LTEN 124,A00,186148,Staff,6,0,25,19
1683304012917,LTEN 178,A00,186149,Staff,7,0,15,8
1683304013942,LTEN 181,A00,186150,Blanco; John D,33,0,40,7
1683304014966,LTWL 120,A00,186160,Staff,20,0,25,5
1683304015993,LTWL 165,A00,186161,Staff,22,0,25,3
1683304017021,LTWR 100,A00,186162,Staff,0,4,15,15
1683304018048,LTWR 102,A00,186163,Doller; Ben,5,0,15,10
1683304019073,MAE 8,A01,186412,Staff,0,0,0,0
1683304020100,MAE 30B,A00,186445,Bahadori; Mohammad Yousef,83,0,100,17
1683304021125,MAE 40,A00,186592,Bewley; Thomas R,9,0,50,41
1683304022150,MAE 101B,A00,186593,Bahadori; Mohammad Yousef,81,0,100,19
1683304023177,MAE 105,A00,186594,Bandaru; Prabhakar,12,0,50,38
1683304024204,MAE 107,A00,186599,Pham; Hieu Tan,0,6,120,120
1683304025229,MAE 148,A01,186660,Silberman; Jack,3,0,16,13
1683304026254,MATH 10A,A01,188095,Staff,0,7,35,35
1683304027284,MATH 10B,A01,188097,Bowers; Adam R.,0,11,30,30
1683304027284,MATH 10B,A02,188099,Bowers; Adam R.,0,9,30,30
1683304027284,MATH 10B,B01,188104,Bowers; Adam R.,0,11,30,30
1683304027284,MATH 10B,B02,188106,Bowers; Adam R.,0,11,30,30
1683304028376,MATH 10C,A01,188111,Staff,0,18,30,30
1683304028376,MATH 10C,A02,188127,Staff,0,17,30,30
1683304028376,MATH 10C,A03,188131,Staff,0,17,30,30
1683304028376,MATH 10C,B01,188218,Staff,21,0,30,9
1683304028376,MATH 10C,B02,188244,Staff,13,0,30,17
1683304028376,MATH 10C,B03,188277,Staff,16,0,30,14
1683304029405,MATH 18,A01,188344,Bach; Quang Tran,18,0,30,12
1683304029405,MATH 18,A02,188345,Bach; Quang Tran,11,0,30,19
1683304029405,MATH 18,B01,188353,Bach; Quang Tran,10,0,30,20
1683304029405,MATH 18,B02,188354,Bach; Quang Tran,20,0,30,10
1683304030430,MATH 20A,A01,188374,Staff,13,0,35,22
1683304031460,MATH 20B,A01,188382,Ohm; Ko Woon,6,0,30,24
1683304031460,MATH 20B,A02,188383,Ohm; Ko Woon,24,0,30,6
1683304031460,MATH 20B,B01,188385,Ohm; Ko Woon,7,0,30,23
1683304031460,MATH 20B,B02,188392,Ohm; Ko Woon,22,0,30,8
1683304032489,MATH 20C,A01,188394,Harel; Guershon,10,0,30,20
1683304032489,MATH 20C,A02,188395,Harel; Guershon,13,0,30,17
1683304032489,MATH 20C,B01,188404,Harel; Guershon,3,0,30,27
1683304032489,MATH 20C,B02,188405,Harel; Guershon,19,0,30,11
1683304033515,MATH 20D,A01,188414,Hammock; Frances H,0,1,30,30
1683304033515,MATH 20D,A02,188415,Hammock; Frances H,4,0,30,26
1683304033515,MATH 20D,B01,188447,Hammock; Frances H,2,0,30,28
1683304033515,MATH 20D,B02,188486,Hammock; Frances H,8,0,30,22
1683304034540,MATH 20E,A01,188649,Staff,22,0,30,8
1683304034540,MATH 20E,A02,188650,Staff,23,0,30,7
1683304034540,MATH 20E,A03,188673,Staff,0,0,30,30
1683304035564,MATH 102,A01,188675,Staff,0,35,35,35
1683304036590,MATH 103B,A01,188681,Staff,4,0,35,31
1683304036590,MATH 103B,B01,188692,Staff,7,0,35,28
1683304037617,MATH 109,A01,188695,Salehi Golsefidy; Alireza,25,0,35,10
1683304037617,MATH 109,A02,188696,Salehi Golsefidy; Alireza,27,0,35,8
1683304038641,MATH 120A,A01,188698,Eggers; John Dietrich,5,0,35,30
1683304039665,MATH 142B,A01,188736,Ioana; Adrian,0,2,30,30
1683304039665,MATH 142B,A02,188741,Ioana; Adrian,0,1,30,30
1683304039665,MATH 142B,A03,188743,Ioana; Adrian,0,3,30,30
1683304040693,MATH 168A,A01,188790,Staff,0,8,35,35
1683304041718,MATH 170A,A01,188803,Nie; Jiawang,0,2,35,35
1683304041718,MATH 170A,A02,188811,Nie; Jiawang,0,0,35,35
1683304041718,MATH 170A,A03,188814,Nie; Jiawang,1,0,35,34
1683304041718,MATH 170A,A04,188815,Nie; Jiawang,14,0,35,21
1683304042743,MATH 193B,A01,188817,Staff,0,0,35,35
1683304042743,MATH 193B,A02,188818,Staff,5,0,35,30
1683304043769,MGT 4,A01,202857,Anderson; John Charles,62,0,80,18
1683304044796,MGT 12,A00,202858,Lindenberger; Wade Douglas,43,0,90,47
1683304045822,MGT 18,A00,202859,Staff,74,0,90,16
1683304046849,MGT 18GS,A00,202860,McKay; Michael J,13,0,28,15
1683304047875,MGT 45,A00,202861,Pecore; Joseph P.,14,0,90,76
1683304048904,MGT 100,A00,202863,Yavorsky; Daniel Ryan,28,0,90,62
1683304049928,MGT 103,A00,202864,Ehrich; Kristine R,0,16,90,90
1683304050956,MGT 112,A00,202865,Ehrich; Kristine R,15,0,90,75
1683304051981,MGT 121A,A00,202868,Staff,0,19,0,0
1683304053005,MGT 131B,A00,202869,Anderson; John Charles,59,0,90,31
1683304054034,MGT 136,A00,202871,Lindenberger; Wade Douglas,84,0,90,6
1683304055058,MGT 164,A00,202873,Staff,0,69,90,90
1683304056083,MGT 164GS,A00,202874,McKay; Mary A,13,0,28,15
1683304057109,MGT 180,A00,202875,Staff,0,51,90,90
1683304058137,MMW 11R,A01,205019,Herbst; Matthew,3,0,30,27
1683304058137,MMW 11R,A02,205026,Herbst; Matthew,29,0,30,1
1683304059172,MMW 15,A01,193512,Chang; Edmond Yi-Teh,0,9,28,28
1683304059172,MMW 15,A02,193513,Chang; Edmond Yi-Teh,0,5,28,28
1683304059172,MMW 15,A03,193514,Chang; Edmond Yi-Teh,0,5,28,28
1683304059172,MMW 15,A04,193515,Chang; Edmond Yi-Teh,0,4,28,28
1683304059172,MMW 15,A05,193516,Chang; Edmond Yi-Teh,0,4,28,28
1683304059172,MMW 15,A06,193517,Chang; Edmond Yi-Teh,0,5,28,28
1683304059172,MMW 15,B01,193519,Chang; Edmond Yi-Teh,0,4,28,28
1683304059172,MMW 15,B02,193520,Chang; Edmond Yi-Teh,0,5,28,28
1683304059172,MMW 15,B03,193521,Chang; Edmond Yi-Teh,0,4,28,28
1683304059172,MMW 15,B04,193522,Chang; Edmond Yi-Teh,0,4,28,28
1683304059172,MMW 15,B05,193523,Chang; Edmond Yi-Teh,0,5,28,28
1683304059172,MMW 15,B06,193524,Chang; Edmond Yi-Teh,0,4,28,28
1683304060199,MMW 122,A01,193526,Rahimi; Babak,0,14,28,28
1683304060199,MMW 122,A02,193527,Rahimi; Babak,0,14,28,28
1683304060199,MMW 122,A03,193528,Rahimi; Babak,0,0,0,0
1683304060199,MMW 122,A04,193529,Rahimi; Babak,0,0,0,0
1683304061225,MUS 1A,A01,186663,Staff,0,20,35,35
1683304062248,MUS 4,A01,186715,Staff,0,12,35,35
1683304063272,MUS 5R,A01,186796,Dubnov; Shlomo,0,17,35,35
1683304064301,MUS 6,A01,186798,Staff,0,3,25,25
1683304065327,MUS 7,A01,186830,Staff,12,0,35,23
1683304066351,MUS 8,A01,186930,Staff,0,26,35,35
1683304067375,MUS 15,A01,186932,Staff,0,15,35,35
1683304067375,MUS 15,B01,186934,Staff,0,15,35,35
1683304068399,MUS 80,A00,186935,Staff,2,0,20,18
1683304068399,MUS 80,B00,186936,Staff,25,0,25,0
1683304069426,NANO 11,A00,204702,Lipomi; Darren John,0,0,0,0
1683304070453,NANO 15,A01,204709,Yang; Kesong,0,1,0,0
1683304071481,NANO 114,A00,202069,Jahed Motlagh; Zeinab,3,0,10,7
1683304072509,PHIL 1,A00,186955,Grush; Rick Scott,32,0,40,8
1683304073536,PHIL 10,A01,186973,Grush; Rick Scott,29,0,35,6
1683304073536,PHIL 10,A02,186974,Grush; Rick Scott,33,0,35,2
1683304074561,PHIL 13,A01,186976,Staff,7,0,35,28
1683304074561,PHIL 13,A02,186977,Staff,16,0,35,19
1683304075588,PHIL 14,A01,186979,Staff,31,0,35,4
1683304075588,PHIL 14,A02,186986,Staff,32,0,35,3
1683304076616,PHIL 28,A01,186988,Staff,16,0,30,14
1683304076616,PHIL 28,A02,186989,Staff,1,0,30,29
1683304076616,PHIL 28,A03,186990,Staff,9,0,30,21
1683304076616,PHIL 28,A04,186991,Staff,26,0,30,4
1683304077643,PHIL 120,A00,186997,Staff,23,0,40,17
1683304078666,PHIL 137,A00,187003,Staff,9,0,40,31
1683304079690,PHIL 150,A00,187015,Staff,47,0,70,23
1683304080715,PHIL 167,A00,187021,Lamey; Andy M.,35,0,40,5
1683304081741,PHIL 174,A01,202226,Staff,17,0,20,3
1683304081741,PHIL 174,A02,202235,Staff,20,0,20,0
1683304082766,PHIL 191A,A00,258918,Staff,0,0,1,1
1683304083793,PHYS 1A,A00,187028,Staff,26,0,60,34
1683304084821,PHYS 1AL,001,187036,Staff,2,0,30,28
1683304084821,PHYS 1AL,002,187049,Staff,18,0,30,12
1683304085848,PHYS 1B,A00,187058,Staff,23,0,60,37
1683304086877,PHYS 1BL,001,187064,Staff,0,0,30,30
1683304086877,PHYS 1BL,002,187070,Staff,6,0,30,24
1683304087900,PHYS 1C,A00,187082,Staff,31,0,120,89
1683304088929,PHYS 1CL,001,187088,Staff,0,9,30,30
1683304088929,PHYS 1CL,002,187089,Staff,0,2,30,30
1683304088929,PHYS 1CL,009,262693,Staff,11,0,30,19
1683304089953,PHYS 2B,A01,187097,Staff,54,0,115,61
1683304090977,PHYS 2C,A01,187099,Staff,67,0,115,48
1683304092002,PHYS 2CL,A01,187101,Staff,5,0,28,23
1683304092002,PHYS 2CL,A02,187102,Staff,15,0,28,13
1683304093029,PHYS 2D,A01,187123,Shotwell; Brian,95,0,115,20
1683304094054,PHYS 4B,A01,187133,Grinstein; Benjamin,35,0,50,15
1683304095081,POLI 10,A00,188819,Staff,0,3,50,50
1683304096106,POLI 11,A00,188827,Staff,43,0,50,7
1683304097130,POLI 13R,A00,188828,Staff,0,1,20,20
1683304098155,POLI 27,A01,188830,Elgin; Samuel Zincke,0,1,70,70
1683304099183,POLI 30,A00,188832,Desposato; Scott,33,0,50,17
1683304100206,POLI 102F,A00,188834,Staff,3,0,40,37
1683304101230,POLI 104A,A00,188852,Staff,14,0,30,16
1683304102254,POLI 104I,A00,188853,Staff,0,6,20,20
1683304103279,POLI 110B,A00,188854,Wiens; David,7,0,20,13
1683304104304,POLI 112A,A00,188855,Wiens; David,5,0,30,25
1683304105327,POLI 117R,A00,188856,Forman; Fonna,0,11,20,20
1683304106352,POLI 118,A00,188857,Ingham; Sean,8,0,20,12
1683304107377,POLI 120G,A00,188858,Staff,9,0,30,21
1683304108402,POLI 131CR,A00,188863,Hoston; Germaine,24,0,50,26
1683304109426,POLI 133,A00,188864,Nellis; Gareth Hb,44,0,50,6
1683304110454,POLI 134D,A00,188865,Desposato; Scott,27,0,30,3
1683304111477,POLI 142A,A00,188871,Gartzke; Erik,22,0,50,28
1683304112502,POLI 142K,A00,188874,Staff,38,0,50,12
1683304113529,POLI 143,A00,188940,Gartzke; Erik,16,0,30,14
1683304114553,POLI 153,A00,188943,Staff,3,0,20,17
1683304115578,POLI 160AA,A00,188944,Staff,13,0,40,27
1683304116602,POLI 170A,A00,188945,Staff,11,0,30,19
1683304118655,PSYC 1,A00,188952,Staff,38,0,90,52
1683304119681,PSYC 2,B00,188953,Staff,20,0,35,15
1683304120704,PSYC 6,A00,188970,Staff,47,0,60,13
1683304121731,PSYC 7,A00,188973,Staff,37,0,45,8
1683304122754,PSYC 60,A01,188980,Rickard; Timothy C.,43,0,60,17
1683304123778,PSYC 70,A01,189001,Steiner; Eric Tomas,24,0,45,21
1683304124802,PSYC 100,A00,189005,Lacefield; Katharine I,0,99,120,120
1683304125828,PSYC 102,A00,189008,Staff,10,0,30,20
1683304126852,PSYC 106,B00,189026,Gorman; Michael R.,37,0,60,23
1683304127878,PSYC 114,B01,189033,Winkielman; Piotr,0,32,30,30
1683304128903,PSYC 131,A00,189036,Anagnostaras; Stephan,0,43,60,60
1683304129930,PSYC 136,A00,189041,Lowe; Angela Beth,0,7,25,25
1683304130955,PSYC 137,A00,189057,Winkielman; Piotr,0,34,25,25
1683304132052,PSYC 144,A00,189107,Wixted; John T,0,7,50,50
1683304134103,PSYC 162,A00,189142,Staff,0,8,85,85
1683304135127,PSYC 172,A00,189144,Gorman; Michael R.,0,7,30,30
1683304137180,PSYC 179,A00,189146,Lacefield; Katharine I,0,84,120,120
1683304138203,PSYC 181,A00,189147,Anagnostaras; Stephan,0,44,90,90
1683304139227,PSYC 190R,A00,189148,Barner; David A.,0,22,80,80
1683304140253,PSYC 191,A00,189275,Rickard; Timothy C.,0,7,25,25
1683304141281,PSYC 193,A00,189276,Chapman; Eddie Nathaniel,0,1,0,4
1683304142306,PSYC 193L,A01,189281,Lowe; Angela Beth,12,0,20,8
1683304142306,PSYC 193L,B01,189285,Staff,28,0,35,7
1683304143331,RELI 149,A00,187137,Rahimi; Babak,7,0,40,33
1683304144359,SE 9,A01,187315,Staff,0,2,18,18
1683304145385,SE 101B,A00,187409,Staff,24,0,30,6
1683304146413,SE 110B,A00,187444,Staff,10,0,40,30
1683304147439,SE 130B,A00,187449,Staff,31,0,40,9
1683304148465,SE 150A,A00,187516,Staff,9,0,20,11
1683304149489,SE 154,A00,187528,Staff,30,0,50,20
1683304150514,SIO 3,A01,258171,Staff,35,0,40,5
1683304151540,SIO 10,A00,187144,Cook; Geoffrey W,0,3,75,75
1683304152607,SIO 45,A00,187152,Cook; Geoffrey W,1,0,100,99
1683304153631,SIO 109R,A00,194486,Staff,0,3,20,20
1683304155681,SIO 187,A01,187233,Kacev; David,12,0,40,28
1683304156705,SOCI 1,A01,258656,Thorpe; Charles Robert,28,0,30,2
1683304156705,SOCI 1,A02,258658,Thorpe; Charles Robert,30,0,30,0
1683304156705,SOCI 1,A03,258661,Thorpe; Charles Robert,25,0,25,0
1683304156705,SOCI 1,A04,258666,Thorpe; Charles Robert,22,0,25,3
1683304156705,SOCI 1,A05,258897,Thorpe; Charles Robert,23,0,25,2
1683304156705,SOCI 1,A06,258898,Thorpe; Charles Robert,25,0,25,0
1683304157729,SOCI 30,A01,258903,Pardo Guerra; Juan Pablo,16,0,30,14
1683304158756,SOCI 102,A00,258904,Staff,9,0,25,16
1683304159782,SOCI 106,A00,258905,Staff,19,0,25,6
1683304160807,SOCI 111,A00,258907,Ribas Norris; Janet Vanesa,26,0,30,4
1683304161833,SOCI 121R,A00,258908,Pardo Guerra; Juan Pablo,11,0,30,19
1683304162857,SOCI 126,A01,203330,Staff,14,0,20,6
1683304163886,SOCI 131,A00,258909,Thorpe; Charles Robert,31,0,60,29
1683304164911,SOCI 135,A00,258910,Payne; Christine Anna,0,9,30,30
1683304165937,SOCI 157,A00,258911,Staff,13,0,30,17
1683304166962,SOCI 184,A00,258912,Staff,26,0,30,4
1683304167986,SOCI 188D,A00,258913,Staff,21,0,30,9
1683304169010,SYN 2,001,187529,Staff,9,0,16,7
1683304169010,SYN 2,002,201452,Staff,0,18,16,16
1683304169010,SYN 2,003,201469,Staff,3,0,16,13
1683304170037,SYN 100,A01,187531,Staff,0,9,20,20
1683304170037,SYN 100,B01,201491,Staff,0,12,20,20
1683304171061,TDAC 1,A00,189286,Walsh; Kim C.,3,0,20,17
1683304171061,TDAC 1,B00,189287,Harting; Carla Kelso,11,0,20,9
1683304172085,TDAC 101,A00,189300,Walsh; Kim C.,16,0,20,4
1683304172085,TDAC 101,B00,189301,Harting; Carla Kelso,18,0,20,2
1683304173109,TDAC 102,A00,189304,Basso; Beatrice,14,0,20,6
1683304174132,TDAC 108,A00,189305,Staff,18,0,20,2
1683304175161,TDDE 131,A00,189310,Staff,19,0,20,1
1683304175161,TDDE 131,B00,189314,Staff,19,0,20,1
1683304175161,TDDE 131,C00,189315,Staff,48,0,50,2
1683304175161,TDDE 131,D00,189316,Staff,14,0,15,1
1683304175161,TDDE 131,E00,204841,Staff,20,0,20,0
1683304176188,TDGE 10,A00,189289,Staff,30,0,50,20
1683304176188,TDGE 10,B00,189290,Havis; Allan,2,0,50,48
1683304177212,TDGE 11,A00,189291,Fulton; Julia,0,3,50,50
1683304177212,TDGE 11,B00,189292,Staff,20,0,25,5
1683304177212,TDGE 11,C00,260270,Staff,0,0,0,0
1683304178237,TDGE 25,A00,189294,Staff,3,0,20,17
1683304179264,TDGE 124,A00,189318,Fulton; Julia,0,8,50,50
1683304180287,TDGE 125,A00,189319,Staff,13,0,25,12
1683304180287,TDGE 125,B00,189320,Staff,23,0,25,2
1683304181311,TDGE 127,A00,189322,Havis; Allan,0,0,50,50
1683304182336,TDHT 101,A00,189323,Staff,18,0,25,7
1683304182336,TDHT 101,B00,189324,Staff,25,0,25,0
1683304183363,TDHT 102,A00,189325,Staff,49,0,50,1
1683304184391,TDMV 1,A00,189295,Arcidiacono; Kristin,20,0,30,10
1683304184391,TDMV 1,B00,189296,Caligagan; Maria T.,24,0,30,6
1683304185415,TDMV 2,A00,189297,Sammartano; Tonnie,28,0,30,2
1683304185415,TDMV 2,B00,189299,Arcidiacono; Kristin,24,0,30,6
1683304186439,TDMV 3,A00,204998,Rincon; Alicia,22,0,30,8
1683304187463,TDMV 120,A00,189458,Sammartano; Tonnie,28,0,30,2
1683304188488,TDMV 138,A00,189541,Jun; Grace Shin Hae,22,0,40,18
1683304189513,TDMV 142,A00,189717,Caligagan; Tony,23,0,30,7
1683304189513,TDMV 142,B00,189718,Caligagan; Maria T.,25,0,30,5
1683304190538,TMC 2,A01,187533,Staff,25,0,25,0
1683304190538,TMC 2,A02,187534,Staff,25,0,25,0
1683304191561,USP 1,A01,187536,Kwak; Nancy,0,16,25,25
1683304192590,USP 5,A01,187538,Staff,9,0,25,16
1683304193613,USP 101,A00,199253,Staff,0,4,0,0
1683304194640,USP 124,A00,187562,Boomhower; Matthew Charles,1,0,30,29
1683304195666,USP 138,A00,187582,Staff,20,0,25,5
1683304196690,USP 152,A01,187597,Staff,4,0,25,21
1683304197715,USP 153,A00,187598,Staff,19,0,25,6
1683304198741,USP 168,A00,187607,Kwak; Nancy,2,0,5,3
1683304199764,USP 173,A00,187619,Staff,4,0,25,21
1683304200790,USP 181,A00,187638,Staff,0,0,25,25
1683304201817,VIS 103,A00,187650,Cruz; Edwin Teddy,23,0,75,52
1683304202840,VIS 110D,A00,187669,Staff,12,0,22,10
1683304203866,VIS 127C,A00,187720,Shen; Kuiyi,68,0,146,78
1683304204889,VIS 149,A00,187731,Yoldas; Pinar,0,14,22,22
1683304205914,VIS 151,A01,188091,Staff,22,0,34,12
1683304205914,VIS 151,A02,188092,Staff,11,0,34,23
1683304206942,VIS 160B,A00,188093,Stalbaum; Brett,0,0,10,10
1683304208994,WCWP 10B,A00,201720,Staff,10,0,15,5
1683304208994,WCWP 10B,B00,201722,Staff,8,0,15,7
1683304210018,WCWP 100,A00,201725,Gagnon; Jeffrey C,0,0,2,2
1683304210018,WCWP 100,B00,201727,Staff,0,4,15,15
1683304213103,ANBI 133,A00,258401,Wilder; Linnea Lorene,34,0,40,6
1683304214130,ANBI 140,A00,258395,Hrvoj Mihic; Branka,18,0,25,7
1683304215156,ANSC 120,A00,258402,Bialecki; Jon Anthony,27,0,40,13
1683304216179,ANSC 144,A00,258400,Staff,14,0,40,26
1683304218236,ANSC 166,A00,258396,Parish; Steven Martin,157,0,175,18
1683304219268,ANSC 180,A00,193533,Staff,9,0,20,11
1683304220292,ANSC 188,A00,258397,Jassal; Aftab,33,0,40,7
1683304221321,ANTH 3,A01,258316,Staff,23,0,30,7
1683304222347,ANTH 5,A00,258394,Semendeferi; Ekaterini,16,0,20,4
1683304223370,ANTH 21,A01,258331,Staff,9,0,40,31
1683304224395,ANTH 103,A00,258398,Varma; Saiba,15,0,25,10
1683304225423,AWP 10,001,202034,Staff,0,0,0,0
1683304225423,AWP 10,002,202035,Staff,0,0,0,0
1683304225423,AWP 10,003,202036,Staff,0,0,0,0
1683304225423,AWP 10,004,202037,Staff,0,0,0,0
1683304225423,AWP 10,005,202038,Staff,0,0,0,0
1683304225423,AWP 10,006,202039,Staff,0,0,0,0
1683304225423,AWP 10,007,202040,Staff,0,0,0,0
1683304225423,AWP 10,008,202041,Staff,0,0,0,0
1683304225423,AWP 10,009,202042,Staff,0,0,0,0
1683304225423,AWP 10,010,202043,Staff,0,0,0,0
1683304225423,AWP 10,011,202044,Staff,0,0,0,0
1683304225423,AWP 10,012,202045,Staff,0,0,0,0
1683304225423,AWP 10,013,202046,Staff,0,0,0,0
1683304225423,AWP 10,014,202047,Staff,0,0,0,0
1683304225423,AWP 10,015,202048,Staff,0,0,0,0
1683304225423,AWP 10,016,202049,Staff,0,0,0,0
1683304225423,AWP 10,017,202050,Staff,0,0,0,0
1683304225423,AWP 10,018,202051,Staff,0,0,0,0
1683304225423,AWP 10,019,202052,Staff,0,0,0,0
1683304225423,AWP 10,020,202053,Staff,0,0,0,0
1683304225423,AWP 10,021,202054,Staff,0,0,0,0
1683304225423,AWP 10,022,202055,Staff,0,0,0,0
1683304225423,AWP 10,023,202056,Staff,0,0,0,0
1683304225423,AWP 10,024,202057,Staff,0,0,0,0
1683304225423,AWP 10,025,202058,Staff,0,0,0,0
1683304225423,AWP 10,026,202059,Staff,0,0,0,0
1683304226446,AWP 102,001,202032,Staff,0,0,0,0
1683304226446,AWP 102,002,202033,Staff,0,0,0,0
1683304227471,BENG 100,A01,254234,Taylor Amos; Alyssa C,31,0,40,9
1683304228498,BENG 196,001,270013,Engler; Adam J.,9999,0,9999,0
1683304229528,BICD 100R,A01,202018,Smith; Laurie,0,7,32,32
1683304229528,BICD 100R,A02,202019,Smith; Laurie,0,2,32,32
1683304229528,BICD 100R,A03,202020,Smith; Laurie,0,1,32,32
1683304229528,BICD 100R,A04,202021,Smith; Laurie,8,0,32,24
1683304229528,BICD 100R,A05,202022,Smith; Laurie,12,0,32,20
1683304230553,BICD 136,A01,193242,Gustafson-Brown; Cindy,0,2,32,32
1683304230553,BICD 136,A02,193244,Gustafson-Brown; Cindy,15,0,32,17
1683304231579,BIEB 102,A01,193249,Butler; Shannon Rhey,0,2,32,32
1683304231579,BIEB 102,A02,193251,Butler; Shannon Rhey,0,0,32,32
1683304231579,BIEB 102,A03,193253,Butler; Shannon Rhey,0,1,32,32
1683304231579,BIEB 102,A04,193255,Butler; Shannon Rhey,17,0,32,15
1683304231579,BIEB 102,A05,193265,Butler; Shannon Rhey,26,0,32,6
1683304231579,BIEB 102,A06,193269,Butler; Shannon Rhey,16,0,32,16
1683304233630,BIEB 150,A01,193274,Staff,0,0,32,32
1683304233630,BIEB 150,A02,193285,Staff,24,0,32,8
1683304234657,BIEB 194,A00,193286,Kurle; Carolyn M.,22,0,32,10
1683304235741,BILD 1,A01,192291,Staff,16,0,32,16
1683304235741,BILD 1,A02,192292,Staff,30,0,32,2
1683304235741,BILD 1,B01,192520,Reuther; Keefe,0,1,0,0
1683304235741,BILD 1,B02,192532,Reuther; Keefe,0,1,0,0
1683304236769,BILD 3,A01,192556,Butler; Shannon Rhey,0,0,32,32
1683304236769,BILD 3,A02,192581,Butler; Shannon Rhey,5,0,32,27
1683304236769,BILD 3,A03,192611,Butler; Shannon Rhey,23,0,32,9
1683304236769,BILD 3,A04,192612,Butler; Shannon Rhey,25,0,32,7
1683304236769,BILD 3,A05,192613,Butler; Shannon Rhey,27,0,32,5
1683304236769,BILD 3,A06,192679,Butler; Shannon Rhey,27,0,32,5
1683304236769,BILD 3,A07,192682,Butler; Shannon Rhey,22,0,32,10
1683304237794,BILD 4,A01,192836,Reuther; Keefe,1,0,24,23
1683304237794,BILD 4,A02,193044,Reuther; Keefe,4,0,24,20
1683304238826,BILD 10,A01,193142,Gustafson-Brown; Cindy,31,0,32,1
1683304238826,BILD 10,A02,193149,Gustafson-Brown; Cindy,31,0,32,1
1683304239849,BIMM 100,A01,193301,Staff,0,6,32,32
1683304239849,BIMM 100,A02,193312,Staff,0,5,32,32
1683304239849,BIMM 100,A03,193323,Staff,0,8,32,32
1683304240878,BIMM 101,A01,193329,McDonnell; Lisa Marie,0,3,24,24
1683304240878,BIMM 101,A02,193339,McDonnell; Lisa Marie,0,2,24,24
1683304240878,BIMM 101,B01,193354,McDonnell; Lisa Marie,0,3,24,24
1683304240878,BIMM 101,B02,193357,McDonnell; Lisa Marie,0,3,24,24
1683304241902,BIMM 110,A01,193377,Tat; John,0,11,32,32
1683304241902,BIMM 110,A02,193378,Tat; John,1,9,32,31
1683304242930,BIMM 120,A01,206116,Staff,0,0,32,32
1683304242930,BIMM 120,A02,206117,Staff,8,0,32,24
1683304242930,BIMM 120,A03,206121,Staff,21,0,32,11
1683304243954,BIPN 100,A01,193393,Park; Ji Young,0,14,32,32
1683304243954,BIPN 100,A02,193402,Park; Ji Young,0,12,32,32
1683304243954,BIPN 100,A03,193413,Park; Ji Young,0,14,32,32
1683304243954,BIPN 100,A04,193414,Park; Ji Young,0,13,32,32
1683304244982,BIPN 102,A01,193429,Staff,0,0,32,32
1683304244982,BIPN 102,A02,193438,Staff,23,0,32,9
1683304246008,BIPN 106,A01,193450,Reyes Gonzalez; Catalina,0,2,40,40
1683304247032,BIPN 134,A01,193465,Cooke; James Edward,0,0,32,32
1683304247032,BIPN 134,A02,193474,Cooke; James Edward,27,0,32,5
1683304247032,BIPN 134,A03,193485,Cooke; James Edward,29,0,32,3
1683304247032,BIPN 134,A04,193486,Cooke; James Edward,21,0,32,11
1683304247032,BIPN 134,A05,193491,Cooke; James Edward,31,0,32,1
1683304247032,BIPN 134,A06,193501,Cooke; James Edward,30,0,32,2
1683304247032,BIPN 134,A07,193510,Cooke; James Edward,29,0,32,3
1683304249085,BISP 194,A00,222522,Staff,16,0,32,16
1683304250114,CAT 124,A01,202407,Staff,20,0,25,5
1683304251140,CAT 125,A00,202408,Marchisotto; Jennifer Anne,4,0,20,16
1683304252165,CAT 125R,A00,202409,Smith; Lauryn Alissa,0,11,20,20
1683304252165,CAT 125R,B00,202410,Morales; Celeste Georgianna,0,11,20,20
1683304252165,CAT 125R,C00,202411,Irwin; Matthew Joseph,0,10,20,20
1683304253190,CENG 15,A01,204712,Yang; Kesong,0,1,0,0
1683304254218,CENG 114,A00,202070,Jahed Motlagh; Zeinab,5,0,20,15
1683304255241,CGS 105,A00,185477,Wesling; Megan E.,24,0,40,16
1683304256265,CGS 106,A00,185494,Staff,13,0,22,9
1683304257293,CGS 108,A00,185495,Staff,14,0,20,6
1683304258317,CGS 114,A00,185496,Staff,13,0,18,5
1683304259343,CGS 119,A00,185501,Staff,15,0,20,5
1683304260371,CGS 120,A00,185511,Staff,13,0,20,7
1683304261398,CHEM 4,A01,184675,Bussey; Thomas J,96,0,100,4
1683304262423,CHEM 6A,A01,184677,Staff,35,0,60,25
1683304263451,CHEM 6B,A01,184679,Staff,65,0,100,35
1683304264485,CHEM 6C,A01,184681,Bussey; Thomas J,1,0,50,49
1683304264485,CHEM 6C,A02,184682,Bussey; Thomas J,34,0,50,16
1683304265512,CHEM 40A,A01,184684,Albizati; Kim F.,37,0,100,63
1683304266541,CHEM 40B,A01,184686,Albizati; Kim F.,0,20,100,100
1683304267569,CHEM 41B,A01,184690,Staff,52,0,100,48
1683304268594,COGS 3,A01,184715,Boyle; Mary E. T.,0,25,40,40
1683304269619,COGS 14B,A01,185172,Staff,0,15,38,38
1683304270645,COGS 18,A01,184736,Staff,20,0,80,60
1683304271672,COGS 100,A01,184932,Staff,0,5,73,73
1683304272697,COGS 101A,A01,184935,Staff,0,38,30,30
1683304273722,COGS 101B,A01,184944,Staff,0,2,30,30
1683304274746,COGS 101C,A01,184946,Staff,0,12,30,30
1683304275773,COGS 102A,A01,184951,Johnson; Christine M.,2,0,40,38
1683304276797,COGS 107B,A01,184953,Mooshagian; Eric Frederick,0,50,40,40
1683304277822,COGS 118B,A01,184959,Gupta; Anjum,0,48,40,40
1683304278849,COGS 153,A00,184961,Staff,0,15,30,30
1683304279873,COGS 177,A00,184962,Staff,0,21,30,30
1683304280898,COGS 187A,A01,184969,Boyle; Mary E. T.,0,17,40,40
1683304281923,COMM 10,A01,185174,Staff,0,5,25,25
1683304281923,COMM 10,A02,185189,Staff,0,5,25,25
1683304281923,COMM 10,A03,269821,Staff,0,0,0,0
1683304282948,COMM 100B,A01,185475,Staff,0,0,0,2
1683304282948,COMM 100B,A02,185476,Staff,14,0,25,11
1683304283974,COMM 100C,A01,185314,Staff,1,0,25,24
1683304283974,COMM 100C,A02,185327,Staff,19,0,25,6
1683304284998,COMM 110M,A00,185349,Staff,2,0,40,38
1683304286022,COMM 113T,A00,185352,Staff,25,0,40,15
1683304287045,COMM 114I,A00,185353,Staff,33,0,40,7
1683304288071,COMM 131,A00,185354,Staff,19,0,30,11
1683304289095,CSE 8A,A50,185358,Cao; Yingjun,0,46,10,10
1683304290123,CSE 8B,A01,185362,Staff,1,47,50,49
1683304291150,CSE 11,A01,185416,Cao; Yingjun,0,93,10,10
1683304292177,CSE 20,A01,185445,Briones; Jor-el Thomas Caparas,5,0,25,20
1683304293204,CSE 21,A01,185447,Staff,10,0,50,40
1683304294229,CSE 101,A01,185451,Staff,0,12,50,50
1683304294229,CSE 101,B01,185453,Jones; Miles E,0,11,50,50
1683304296280,CSE 141,A01,185458,Eldon; John,20,0,100,80
1683304297304,CSE 141L,A01,185461,Eldon; John,12,0,100,88
1683304298332,CSE 142,A01,185463,Staff,35,0,60,25
1683304298332,CSE 142,B01,201355,Staff,0,6,60,60
1683304299361,CSE 142L,A01,185470,Staff,35,0,60,25
1683304299361,CSE 142L,B01,201417,Staff,0,5,60,60
1683304300390,CSE 190,A00,201433,Staff,32,0,49,17
1683304301418,DOC 1,A01,259136,Strom; Megan C.,8,0,15,7
1683304301418,DOC 1,A02,259137,Strom; Megan C.,14,0,15,1
1683304301418,DOC 1,A03,259138,Strom; Megan C.,14,0,15,1
1683304301418,DOC 1,A04,259139,Strom; Megan C.,14,0,15,1
1683304302444,DOC 100D,A00,259140,Pass; Natalye Joann,17,0,25,8
1683304303467,DSGN 1,A01,184749,Rill; Bryan,0,24,30,30
1683304304495,DSGN 100,A01,185168,Staff,0,2,25,25
1683304305519,ECE 5,A01,185626,Morris; Karcher William,0,10,0,0
1683304306546,ECE 101,A01,185628,Staff,17,0,70,53
1683304307573,ECE 107,A01,185635,Baghdadchi; Saharnaz,0,0,20,20
1683304307573,ECE 107,A02,185638,Baghdadchi; Saharnaz,4,0,20,16
1683304308601,ECE 148,A01,185647,Silberman; Jack,0,0,16,16
1683304309626,ECON 1,A01,185537,Crane; Meredith Helen,54,0,70,16
1683304310650,ECON 3,A01,185549,Crane; Meredith Helen,33,0,70,37
1683304311675,ECON 4,A01,203354,Anderson; John Charles,0,4,10,10
1683304312699,ECON 100A,A01,185574,Staff,0,4,40,40
1683304313724,ECON 100B,A01,185576,Staff,0,22,40,40
1683304314753,ECON 100C,A01,185589,Newhouse; Herbert S,30,0,70,40
1683304315780,ECON 105,A00,185608,Vespa; Emanuel Ignacio,19,0,35,16
1683304316807,ECON 109,A01,185610,Shishkin; Denis,10,0,35,25
1683304317834,ECON 110A,A01,185612,Staff,11,0,40,29
1683304318861,ECON 120A,A01,185615,Staff,20,0,40,20
1683304319889,ECON 120C,A01,185617,Sun; Yixiao,0,20,70,70
1683304320913,ECON 144,A00,203346,Squires; Dale E,3,0,35,32
1683304321938,ECON 171,A01,203349,Newhouse; Herbert S,0,1,35,35
1683304322965,ECON 173A,A01,185621,Toda; Alexis Akira,21,0,35,14
1683304323991,EDS 25,A01,202413,Staff,0,1,0,0
1683304323991,EDS 25,A02,202414,Staff,0,1,0,0
1683304323991,EDS 25,A03,202415,Staff,0,0,0,0
1683304323991,EDS 25,A04,202416,Staff,0,1,0,0
1683304323991,EDS 25,A05,202439,Staff,0,0,0,0
1683304323991,EDS 25,A06,202440,Staff,0,0,0,0
1683304323991,EDS 25,B01,202631,Staff,0,0,0,0
1683304323991,EDS 25,B02,202632,Staff,0,0,0,0
1683304323991,EDS 25,B03,202639,Staff,0,0,0,0
1683304323991,EDS 25,B04,202640,Staff,0,0,0,0
1683304323991,EDS 25,B05,202643,Staff,0,0,0,0
1683304323991,EDS 25,B06,202644,Staff,0,0,0,0
1683304325022,EDS 38,A01,202659,Black; Alison Michelle,24,0,25,1
1683304326050,EDS 115,A00,202652,Staff,17,0,30,13
1683304327074,EDS 125,A00,202649,Staff,14,0,30,16
1683304328098,EDS 126,A01,203332,Staff,30,0,30,0
1683304329130,EDS 139,A00,202838,Staff,17,0,25,8
1683304330155,EDS 146,A01,202655,Staff,15,0,25,10
1683304331183,ENG 15,A00,185667,Staff,0,1,0,0
1683304331183,ENG 15,B00,185672,Staff,0,0,0,0
1683304331183,ENG 15,C00,185675,Staff,0,0,0,0
1683304331183,ENG 15,D00,185682,Staff,0,0,0,0
1683304331183,ENG 15,E00,185684,Staff,0,0,0,0
1683304332210,ETHN 103,A00,185710,Staff,0,3,35,35
1683304333236,ETHN 103A,A00,199228,Man; Simeon S,2,0,9,7
1683304334264,ETHN 109,A00,185711,Staff,18,0,35,17
1683304335289,ETHN 142,A00,185726,Staff,0,4,30,30
1683304336316,ETHN 163J,A00,199229,Man; Simeon S,6,0,8,2
1683304337341,ETHN 168,A00,185727,Staff,8,0,10,2
1683304338365,ETHN 182,A00,185728,Staff,1,0,35,34
1683304339448,ETHN 183,A00,185737,Staff,8,0,18,10
1683304340476,GLBH 111,A01,209361,Burgos; Jose L.,0,0,0,0
1683304342528,HIEU 104,A00,185792,Staff,16,0,20,4
1683304343552,HIEU 115,A00,185800,Staff,1,0,20,19
1683304344576,HIEU 128,A00,185801,Staff,0,7,20,20
1683304345602,HIEU 147,A00,185802,Staff,16,0,20,4
1683304346629,HIEU 154,A00,185823,Staff,12,0,20,8
1683304347655,HILA 102,A00,185826,Staff,13,0,20,7
1683304348681,HILD 2C,A01,185778,Staff,0,12,20,20
1683304349710,HILD 7B,A01,185780,Kwak; Nancy,0,15,32,32
1683304349710,HILD 7B,A02,185781,Kwak; Nancy,0,18,32,32
1683304350735,HILD 30,A01,185791,Staff,14,0,20,6
1683304351759,HISC 119,A00,185830,Golan; Tal,0,9,20,20
1683304352782,HITO 156GS,A00,185831,Patterson; Patrick H.,0,0,0,23
1683304353806,HIUS 103,A00,185832,Man; Simeon S,0,6,20,20
1683304354831,HIUS 117,A00,185836,Kwak; Nancy,2,0,20,18
1683304355856,HIUS 125,A00,185840,Man; Simeon S,0,0,23,23
1683304356882,HIUS 149,A00,185845,Staff,0,0,20,20
1683304357911,HUM 3,A01,185882,Zavodny; Tatiana Sophia,0,6,50,50
1683304357911,HUM 3,B01,185899,Caldwell; Michael Alan,0,19,50,50
1683304358933,HUM 3GS,A00,185900,Patterson; Patrick H.,0,0,0,23
1683304359957,HUM 4,A01,185938,Zroka; Amy Liane,31,0,50,19
1683304359957,HUM 4,B01,185956,Watkins; Eric,0,2,50,50
1683304359957,HUM 4,B02,202209,Watkins; Eric,0,1,50,50
1683304359957,HUM 4,B03,202210,Watkins; Eric,0,0,50,50
1683304360981,HUM 5,A01,185958,West; Geoffrey Scott,5,0,50,45
1683304360981,HUM 5,A02,202215,West; Geoffrey Scott,0,0,50,50
1683304362008,INTL 190,A00,185959,Gagnon; Jeffrey C,0,0,0,9
1683304362008,INTL 190,B00,185960,Lettieri; Michael Joseph,0,0,0,1
1683304363032,JAPN 180,A00,254509,Staff,5,1,30,25
1683304364056,LATI 10,A01,202853,Kennemore; Amy Michelle,5,0,35,30
1683304364056,LATI 10,A02,202854,Kennemore; Amy Michelle,1,0,35,34
1683304364056,LATI 10,A03,270054,Kennemore; Amy Michelle,30,0,30,0
1683304365079,LATI 180,A00,202855,Kennemore; Amy Michelle,11,0,20,9
1683304366102,LAWS 101,A00,201767,Golan; Tal,0,7,40,40
1683304367126,LIFR 1C,A00,185961,Staff,6,0,20,14
1683304368153,LIFR 1CX,A00,185962,Staff,7,0,20,13
1683304369179,LIFR 1D,A00,185963,Staff,9,0,20,11
1683304370203,LIFR 1DX,A00,185964,Staff,9,0,20,11
1683304371227,LIGN 101,A01,186039,Staff,43,0,50,7
1683304372258,LIGN 165,A00,186040,Staff,18,0,50,32
1683304373282,LTCS 108,A00,186041,Staff,6,0,10,4
1683304374309,LTCS 119,A00,186042,Staff,16,0,20,4
1683304375333,LTCS 130,A00,186043,Wesling; Megan E.,15,0,25,10
1683304377383,LTEA 138,A00,186119,Staff,14,0,40,26
1683304378410,LTEN 124,A00,186148,Staff,6,0,25,19
1683304379434,LTEN 178,A00,186149,Staff,7,0,15,8
1683304380458,LTEN 181,A00,186150,Blanco; John D,33,0,40,7
1683304381483,LTWL 120,A00,186160,Staff,20,0,25,5
1683304382510,LTWL 165,A00,186161,Staff,22,0,25,3
1683304383535,LTWR 100,A00,186162,Staff,0,4,15,15
1683304384560,LTWR 102,A00,186163,Doller; Ben,5,0,15,10
1683304385585,MAE 8,A01,186412,Staff,0,0,0,0
1683304386612,MAE 30B,A00,186445,Bahadori; Mohammad Yousef,83,0,100,17
1683304387635,MAE 40,A00,186592,Bewley; Thomas R,9,0,50,41
1683304388662,MAE 101B,A00,186593,Bahadori; Mohammad Yousef,81,0,100,19
1683304389689,MAE 105,A00,186594,Bandaru; Prabhakar,12,0,50,38
1683304390716,MAE 107,A00,186599,Pham; Hieu Tan,0,6,120,120
1683304391740,MAE 148,A01,186660,Silberman; Jack,3,0,16,13
1683304392767,MATH 10A,A01,188095,Staff,0,7,35,35
1683304393797,MATH 10B,A01,188097,Bowers; Adam R.,0,11,30,30
1683304393797,MATH 10B,A02,188099,Bowers; Adam R.,0,9,30,30
1683304393797,MATH 10B,B01,188104,Bowers; Adam R.,0,11,30,30
1683304393797,MATH 10B,B02,188106,Bowers; Adam R.,0,11,30,30
1683304394829,MATH 10C,A01,188111,Staff,0,18,30,30
1683304394829,MATH 10C,A02,188127,Staff,0,17,30,30
1683304394829,MATH 10C,A03,188131,Staff,0,17,30,30
1683304394829,MATH 10C,B01,188218,Staff,21,0,30,9
1683304394829,MATH 10C,B02,188244,Staff,13,0,30,17
1683304394829,MATH 10C,B03,188277,Staff,16,0,30,14
1683304395858,MATH 18,A01,188344,Bach; Quang Tran,18,0,30,12
1683304395858,MATH 18,A02,188345,Bach; Quang Tran,11,0,30,19
1683304395858,MATH 18,B01,188353,Bach; Quang Tran,10,0,30,20
1683304395858,MATH 18,B02,188354,Bach; Quang Tran,20,0,30,10
1683304396881,MATH 20A,A01,188374,Staff,13,0,35,22
1683304397906,MATH 20B,A01,188382,Ohm; Ko Woon,6,0,30,24
1683304397906,MATH 20B,A02,188383,Ohm; Ko Woon,24,0,30,6
1683304397906,MATH 20B,B01,188385,Ohm; Ko Woon,7,0,30,23
1683304397906,MATH 20B,B02,188392,Ohm; Ko Woon,22,0,30,8
1683304398935,MATH 20C,A01,188394,Harel; Guershon,10,0,30,20
1683304398935,MATH 20C,A02,188395,Harel; Guershon,13,0,30,17
1683304398935,MATH 20C,B01,188404,Harel; Guershon,3,0,30,27
1683304398935,MATH 20C,B02,188405,Harel; Guershon,19,0,30,11
1683304399961,MATH 20D,A01,188414,Hammock; Frances H,0,1,30,30
1683304399961,MATH 20D,A02,188415,Hammock; Frances H,4,0,30,26
1683304399961,MATH 20D,B01,188447,Hammock; Frances H,2,0,30,28
1683304399961,MATH 20D,B02,188486,Hammock; Frances H,8,0,30,22
1683304400985,MATH 20E,A01,188649,Staff,22,0,30,8
1683304400985,MATH 20E,A02,188650,Staff,23,0,30,7
1683304400985,MATH 20E,A03,188673,Staff,0,0,30,30
1683304402010,MATH 102,A01,188675,Staff,0,35,35,35
1683304403039,MATH 103B,A01,188681,Staff,4,0,35,31
1683304403039,MATH 103B,B01,188692,Staff,7,0,35,28
1683304404066,MATH 109,A01,188695,Salehi Golsefidy; Alireza,25,0,35,10
1683304404066,MATH 109,A02,188696,Salehi Golsefidy; Alireza,27,0,35,8
1683304405092,MATH 120A,A01,188698,Eggers; John Dietrich,5,0,35,30
1683304406120,MATH 142B,A01,188736,Ioana; Adrian,0,2,30,30
1683304406120,MATH 142B,A02,188741,Ioana; Adrian,0,1,30,30
1683304406120,MATH 142B,A03,188743,Ioana; Adrian,0,3,30,30
1683304407148,MATH 168A,A01,188790,Staff,0,8,35,35
1683304408176,MATH 170A,A01,188803,Nie; Jiawang,0,2,35,35
1683304408176,MATH 170A,A02,188811,Nie; Jiawang,0,0,35,35
1683304408176,MATH 170A,A03,188814,Nie; Jiawang,1,0,35,34
1683304408176,MATH 170A,A04,188815,Nie; Jiawang,14,0,35,21
1683304409201,MATH 193B,A01,188817,Staff,0,0,35,35
1683304409201,MATH 193B,A02,188818,Staff,5,0,35,30
1683304410226,MGT 4,A01,202857,Anderson; John Charles,62,0,80,18
1683304411249,MGT 12,A00,202858,Lindenberger; Wade Douglas,43,0,90,47
1683304412273,MGT 18,A00,202859,Staff,74,0,90,16
1683304413298,MGT 18GS,A00,202860,McKay; Michael J,13,0,28,15
1683304414324,MGT 45,A00,202861,Pecore; Joseph P.,14,0,90,76
1683304415347,MGT 100,A00,202863,Yavorsky; Daniel Ryan,28,0,90,62
1683304416372,MGT 103,A00,202864,Ehrich; Kristine R,0,16,90,90
1683304417395,MGT 112,A00,202865,Ehrich; Kristine R,15,0,90,75
1683304418419,MGT 121A,A00,202868,Staff,0,19,0,0
1683304419446,MGT 131B,A00,202869,Anderson; John Charles,59,0,90,31
1683304420470,MGT 136,A00,202871,Lindenberger; Wade Douglas,84,0,90,6
1683304421498,MGT 164,A00,202873,Staff,0,69,90,90
1683304422522,MGT 164GS,A00,202874,McKay; Mary A,13,0,28,15
1683304423549,MGT 180,A00,202875,Staff,0,51,90,90
1683304424575,MMW 11R,A01,205019,Herbst; Matthew,3,0,30,27
1683304424575,MMW 11R,A02,205026,Herbst; Matthew,29,0,30,1
1683304425600,MMW 15,A01,193512,Chang; Edmond Yi-Teh,0,9,28,28
1683304425600,MMW 15,A02,193513,Chang; Edmond Yi-Teh,0,5,28,28
1683304425600,MMW 15,A03,193514,Chang; Edmond Yi-Teh,0,5,28,28
1683304425600,MMW 15,A04,193515,Chang; Edmond Yi-Teh,0,4,28,28
1683304425600,MMW 15,A05,193516,Chang; Edmond Yi-Teh,0,4,28,28
1683304425600,MMW 15,A06,193517,Chang; Edmond Yi-Teh,0,5,28,28
1683304425600,MMW 15,B01,193519,Chang; Edmond Yi-Teh,0,4,28,28
1683304425600,MMW 15,B02,193520,Chang; Edmond Yi-Teh,0,5,28,28
1683304425600,MMW 15,B03,193521,Chang; Edmond Yi-Teh,0,4,28,28
1683304425600,MMW 15,B04,193522,Chang; Edmond Yi-Teh,0,4,28,28
1683304425600,MMW 15,B05,193523,Chang; Edmond Yi-Teh,0,5,28,28
1683304425600,MMW 15,B06,193524,Chang; Edmond Yi-Teh,0,4,28,28
1683304426625,MMW 122,A01,193526,Rahimi; Babak,0,14,28,28
1683304426625,MMW 122,A02,193527,Rahimi; Babak,0,14,28,28
1683304426625,MMW 122,A03,193528,Rahimi; Babak,0,0,0,0
1683304426625,MMW 122,A04,193529,Rahimi; Babak,0,0,0,0
1683304427649,MUS 1A,A01,186663,Staff,0,20,35,35
1683304428675,MUS 4,A01,186715,Staff,0,12,35,35
1683304429699,MUS 5R,A01,186796,Dubnov; Shlomo,0,17,35,35
1683304430724,MUS 6,A01,186798,Staff,0,3,25,25
1683304431749,MUS 7,A01,186830,Staff,12,0,35,23
1683304432773,MUS 8,A01,186930,Staff,0,26,35,35
1683304433801,MUS 15,A01,186932,Staff,0,15,35,35
1683304433801,MUS 15,B01,186934,Staff,0,15,35,35
1683304434830,MUS 80,A00,186935,Staff,2,0,20,18
1683304434830,MUS 80,B00,186936,Staff,25,0,25,0
1683304435854,NANO 11,A00,204702,Lipomi; Darren John,0,0,0,0
1683304436878,NANO 15,A01,204709,Yang; Kesong,0,1,0,0
1683304437903,NANO 114,A00,202069,Jahed Motlagh; Zeinab,3,0,10,7
1683304438931,PHIL 1,A00,186955,Grush; Rick Scott,32,0,40,8
1683304439958,PHIL 10,A01,186973,Grush; Rick Scott,29,0,35,6
1683304439958,PHIL 10,A02,186974,Grush; Rick Scott,33,0,35,2
1683304440982,PHIL 13,A01,186976,Staff,7,0,35,28
1683304440982,PHIL 13,A02,186977,Staff,16,0,35,19
1683304442008,PHIL 14,A01,186979,Staff,31,0,35,4
1683304442008,PHIL 14,A02,186986,Staff,32,0,35,3
1683304443094,PHIL 28,A01,186988,Staff,16,0,30,14
1683304443094,PHIL 28,A02,186989,Staff,1,0,30,29
1683304443094,PHIL 28,A03,186990,Staff,9,0,30,21
1683304443094,PHIL 28,A04,186991,Staff,26,0,30,4
1683304444119,PHIL 120,A00,186997,Staff,23,0,40,17
1683304445146,PHIL 137,A00,187003,Staff,9,0,40,31
1683304446171,PHIL 150,A00,187015,Staff,47,0,70,23
1683304447195,PHIL 167,A00,187021,Lamey; Andy M.,35,0,40,5
1683304448219,PHIL 174,A01,202226,Staff,17,0,20,3
1683304448219,PHIL 174,A02,202235,Staff,20,0,20,0
1683304449241,PHIL 191A,A00,258918,Staff,0,0,1,1
1683304450270,PHYS 1A,A00,187028,Staff,26,0,60,34
1683304451295,PHYS 1AL,001,187036,Staff,2,0,30,28
1683304451295,PHYS 1AL,002,187049,Staff,18,0,30,12
1683304452322,PHYS 1B,A00,187058,Staff,23,0,60,37
1683304453350,PHYS 1BL,001,187064,Staff,0,0,30,30
1683304453350,PHYS 1BL,002,187070,Staff,6,0,30,24
1683304454373,PHYS 1C,A00,187082,Staff,31,0,120,89
1683304455398,PHYS 1CL,001,187088,Staff,0,9,30,30
1683304455398,PHYS 1CL,002,187089,Staff,0,2,30,30
1683304455398,PHYS 1CL,009,262693,Staff,11,0,30,19
1683304456424,PHYS 2B,A01,187097,Staff,54,0,115,61
1683304457451,PHYS 2C,A01,187099,Staff,67,0,115,48
1683304458477,PHYS 2CL,A01,187101,Staff,5,0,28,23
1683304458477,PHYS 2CL,A02,187102,Staff,15,0,28,13
1683304459503,PHYS 2D,A01,187123,Shotwell; Brian,95,0,115,20
1683304460532,PHYS 4B,A01,187133,Grinstein; Benjamin,35,0,50,15
1683304461557,POLI 10,A00,188819,Staff,0,3,50,50
1683304462585,POLI 11,A00,188827,Staff,43,0,50,7
1683304463609,POLI 13R,A00,188828,Staff,0,1,20,20
1683304464634,POLI 27,A01,188830,Elgin; Samuel Zincke,0,1,70,70
1683304465663,POLI 30,A00,188832,Desposato; Scott,33,0,50,17
1683304466689,POLI 102F,A00,188834,Staff,3,0,40,37
1683304467716,POLI 104A,A00,188852,Staff,14,0,30,16
1683304468739,POLI 104I,A00,188853,Staff,0,6,20,20
1683304469766,POLI 110B,A00,188854,Wiens; David,7,0,20,13
1683304470788,POLI 112A,A00,188855,Wiens; David,5,0,30,25
1683304471812,POLI 117R,A00,188856,Forman; Fonna,0,11,20,20
1683304472840,POLI 118,A00,188857,Ingham; Sean,8,0,20,12
1683304473863,POLI 120G,A00,188858,Staff,9,0,30,21
1683304474891,POLI 131CR,A00,188863,Hoston; Germaine,24,0,50,26
1683304475920,POLI 133,A00,188864,Nellis; Gareth Hb,44,0,50,6
1683304476947,POLI 134D,A00,188865,Desposato; Scott,27,0,30,3
1683304477971,POLI 142A,A00,188871,Gartzke; Erik,22,0,50,28
1683304478995,POLI 142K,A00,188874,Staff,38,0,50,12
1683304480019,POLI 143,A00,188940,Gartzke; Erik,16,0,30,14
1683304481045,POLI 153,A00,188943,Staff,3,0,20,17
1683304482070,POLI 160AA,A00,188944,Staff,13,0,40,27
1683304483098,POLI 170A,A00,188945,Staff,11,0,30,19
1683304485149,PSYC 1,A00,188952,Staff,38,0,90,52
1683304486173,PSYC 2,B00,188953,Staff,20,0,35,15
1683304487201,PSYC 6,A00,188970,Staff,47,0,60,13
1683304488228,PSYC 7,A00,188973,Staff,37,0,45,8
1683304489253,PSYC 60,A01,188980,Rickard; Timothy C.,43,0,60,17
1683304490277,PSYC 70,A01,189001,Steiner; Eric Tomas,24,0,45,21
1683304491301,PSYC 100,A00,189005,Lacefield; Katharine I,0,99,120,120
1683304492325,PSYC 102,A00,189008,Staff,10,0,30,20
1683304493350,PSYC 106,B00,189026,Gorman; Michael R.,37,0,60,23
1683304494375,PSYC 114,B01,189033,Winkielman; Piotr,0,32,30,30
1683304495401,PSYC 131,A00,189036,Anagnostaras; Stephan,0,43,60,60
1683304496429,PSYC 136,A00,189041,Lowe; Angela Beth,0,7,25,25
1683304497451,PSYC 137,A00,189057,Winkielman; Piotr,0,34,25,25
1683304498476,PSYC 144,A00,189107,Wixted; John T,0,7,50,50
1683304500524,PSYC 162,A00,189142,Staff,0,8,85,85
1683304501549,PSYC 172,A00,189144,Gorman; Michael R.,0,7,30,30
1683304503597,PSYC 179,A00,189146,Lacefield; Katharine I,0,84,120,120
1683304504624,PSYC 181,A00,189147,Anagnostaras; Stephan,0,44,90,90
1683304505648,PSYC 190R,A00,189148,Barner; David A.,0,22,80,80
1683304506673,PSYC 191,A00,189275,Rickard; Timothy C.,0,7,25,25
1683304507697,PSYC 193,A00,189276,Chapman; Eddie Nathaniel,0,1,0,4
1683304508722,PSYC 193L,A01,189281,Lowe; Angela Beth,12,0,20,8
1683304508722,PSYC 193L,B01,189285,Staff,28,0,35,7
1683304509746,RELI 149,A00,187137,Rahimi; Babak,7,0,40,33
1683304510769,SE 9,A01,187315,Staff,0,2,18,18
1683304511793,SE 101B,A00,187409,Staff,24,0,30,6
1683304512852,SE 110B,A00,187444,Staff,10,0,40,30
1683304513877,SE 130B,A00,187449,Staff,31,0,40,9
1683304514906,SE 150A,A00,187516,Staff,9,0,20,11
1683304515933,SE 154,A00,187528,Staff,30,0,50,20
1683304516961,SIO 3,A01,258171,Staff,35,0,40,5
1683304517989,SIO 10,A00,187144,Cook; Geoffrey W,0,3,75,75
1683304519015,SIO 45,A00,187152,Cook; Geoffrey W,1,0,100,99
1683304520042,SIO 109R,A00,194486,Staff,0,3,20,20
1683304522094,SIO 187,A01,187233,Kacev; David,12,0,40,28
1683304523121,SOCI 1,A01,258656,Thorpe; Charles Robert,28,0,30,2
1683304523121,SOCI 1,A02,258658,Thorpe; Charles Robert,30,0,30,0
1683304523121,SOCI 1,A03,258661,Thorpe; Charles Robert,25,0,25,0
1683304523121,SOCI 1,A04,258666,Thorpe; Charles Robert,22,0,25,3
1683304523121,SOCI 1,A05,258897,Thorpe; Charles Robert,23,0,25,2
1683304523121,SOCI 1,A06,258898,Thorpe; Charles Robert,25,0,25,0
1683304524150,SOCI 30,A01,258903,Pardo Guerra; Juan Pablo,16,0,30,14
1683304525173,SOCI 102,A00,258904,Staff,9,0,25,16
1683304526200,SOCI 106,A00,258905,Staff,19,0,25,6
1683304527224,SOCI 111,A00,258907,Ribas Norris; Janet Vanesa,26,0,30,4
1683304528246,SOCI 121R,A00,258908,Pardo Guerra; Juan Pablo,11,0,30,19
1683304529274,SOCI 126,A01,203330,Staff,14,0,20,6
1683304530300,SOCI 131,A00,258909,Thorpe; Charles Robert,31,0,60,29
1683304531325,SOCI 135,A00,258910,Payne; Christine Anna,0,9,30,30
1683304532349,SOCI 157,A00,258911,Staff,13,0,30,17
1683304533376,SOCI 184,A00,258912,Staff,26,0,30,4
1683304534401,SOCI 188D,A00,258913,Staff,21,0,30,9
1683304535426,SYN 2,001,187529,Staff,9,0,16,7
1683304535426,SYN 2,002,201452,Staff,0,18,16,16
1683304535426,SYN 2,003,201469,Staff,3,0,16,13
1683304536454,SYN 100,A01,187531,Staff,0,9,20,20
1683304536454,SYN 100,B01,201491,Staff,0,12,20,20
1683304537481,TDAC 1,A00,189286,Walsh; Kim C.,3,0,20,17
1683304537481,TDAC 1,B00,189287,Harting; Carla Kelso,11,0,20,9
1683304538505,TDAC 101,A00,189300,Walsh; Kim C.,16,0,20,4
1683304538505,TDAC 101,B00,189301,Harting; Carla Kelso,18,0,20,2
1683304539529,TDAC 102,A00,189304,Basso; Beatrice,14,0,20,6
1683304540555,TDAC 108,A00,189305,Staff,18,0,20,2
1683304541580,TDDE 131,A00,189310,Staff,19,0,20,1
1683304541580,TDDE 131,B00,189314,Staff,19,0,20,1
1683304541580,TDDE 131,C00,189315,Staff,48,0,50,2
1683304541580,TDDE 131,D00,189316,Staff,14,0,15,1
1683304541580,TDDE 131,E00,204841,Staff,20,0,20,0
1683304542604,TDGE 10,A00,189289,Staff,30,0,50,20
1683304542604,TDGE 10,B00,189290,Havis; Allan,2,0,50,48
1683304543628,TDGE 11,A00,189291,Fulton; Julia,0,3,50,50
1683304543628,TDGE 11,B00,189292,Staff,20,0,25,5
1683304543628,TDGE 11,C00,260270,Staff,0,0,0,0
1683304544651,TDGE 25,A00,189294,Staff,3,0,20,17
1683304545676,TDGE 124,A00,189318,Fulton; Julia,0,8,50,50
1683304546754,TDGE 125,A00,189319,Staff,13,0,25,12
1683304546754,TDGE 125,B00,189320,Staff,23,0,25,2
1683304547778,TDGE 127,A00,189322,Havis; Allan,0,0,50,50
1683304548807,TDHT 101,A00,189323,Staff,18,0,25,7
1683304548807,TDHT 101,B00,189324,Staff,25,0,25,0
1683304549831,TDHT 102,A00,189325,Staff,49,0,50,1
1683304550859,TDMV 1,A00,189295,Arcidiacono; Kristin,20,0,30,10
1683304550859,TDMV 1,B00,189296,Caligagan; Maria T.,24,0,30,6
1683304551883,TDMV 2,A00,189297,Sammartano; Tonnie,28,0,30,2
1683304551883,TDMV 2,B00,189299,Arcidiacono; Kristin,24,0,30,6
1683304552907,TDMV 3,A00,204998,Rincon; Alicia,22,0,30,8
1683304553931,TDMV 120,A00,189458,Sammartano; Tonnie,28,0,30,2
1683304554956,TDMV 138,A00,189541,Jun; Grace Shin Hae,22,0,40,18
1683304555981,TDMV 142,A00,189717,Caligagan; Tony,23,0,30,7
1683304555981,TDMV 142,B00,189718,Caligagan; Maria T.,25,0,30,5
1683304557006,TMC 2,A01,187533,Staff,25,0,25,0
1683304557006,TMC 2,A02,187534,Staff,25,0,25,0
1683304558033,USP 1,A01,187536,Kwak; Nancy,0,16,25,25
1683304559059,USP 5,A01,187538,Staff,9,0,25,16
1683304560087,USP 101,A00,199253,Staff,0,4,0,0
1683304561112,USP 124,A00,187562,Boomhower; Matthew Charles,1,0,30,29
1683304562136,USP 138,A00,187582,Staff,20,0,25,5
1683304563167,USP 152,A01,187597,Staff,4,0,25,21
1683304564191,USP 153,A00,187598,Staff,19,0,25,6
1683304565215,USP 168,A00,187607,Kwak; Nancy,2,0,5,3
1683304566242,USP 173,A00,187619,Staff,4,0,25,21
1683304567266,USP 181,A00,187638,Staff,0,0,25,25
1683304568289,VIS 103,A00,187650,Cruz; Edwin Teddy,23,0,75,52
1683304569313,VIS 110D,A00,187669,Staff,12,0,22,10
1683304570337,VIS 127C,A00,187720,Shen; Kuiyi,68,0,146,78
1683304571364,VIS 149,A00,187731,Yoldas; Pinar,0,14,22,22
1683304572391,VIS 151,A01,188091,Staff,22,0,34,12
1683304572391,VIS 151,A02,188092,Staff,11,0,34,23
1683304573418,VIS 160B,A00,188093,Stalbaum; Brett,0,0,10,10
1683304575470,WCWP 10B,A00,201720,Staff,10,0,15,5
1683304575470,WCWP 10B,B00,201722,Staff,8,0,15,7
1683304576493,WCWP 100,A00,201725,Gagnon; Jeffrey C,0,0,2,2
1683304576493,WCWP 100,B00,201727,Staff,0,4,15,15
1683304579585,ANBI 133,A00,258401,Wilder; Linnea Lorene,34,0,40,6
1683304580610,ANBI 140,A00,258395,Hrvoj Mihic; Branka,18,0,25,7
1683304581632,ANSC 120,A00,258402,Bialecki; Jon Anthony,27,0,40,13
1683304582655,ANSC 144,A00,258400,Staff,14,0,40,26
1683304584707,ANSC 166,A00,258396,Parish; Steven Martin,157,0,175,18
1683304585730,ANSC 180,A00,193533,Staff,9,0,20,11
1683304586754,ANSC 188,A00,258397,Jassal; Aftab,33,0,40,7
1683304587778,ANTH 3,A01,258316,Staff,23,0,30,7
1683304588805,ANTH 5,A00,258394,Semendeferi; Ekaterini,16,0,20,4
1683304589832,ANTH 21,A01,258331,Staff,9,0,40,31
1683304590856,ANTH 103,A00,258398,Varma; Saiba,15,0,25,10
1683304591883,AWP 10,001,202034,Staff,0,0,0,0
1683304591883,AWP 10,002,202035,Staff,0,0,0,0
1683304591883,AWP 10,003,202036,Staff,0,0,0,0
1683304591883,AWP 10,004,202037,Staff,0,0,0,0
1683304591883,AWP 10,005,202038,Staff,0,0,0,0
1683304591883,AWP 10,006,202039,Staff,0,0,0,0
1683304591883,AWP 10,007,202040,Staff,0,0,0,0
1683304591883,AWP 10,008,202041,Staff,0,0,0,0
1683304591883,AWP 10,009,202042,Staff,0,0,0,0
1683304591883,AWP 10,010,202043,Staff,0,0,0,0
1683304591883,AWP 10,011,202044,Staff,0,0,0,0
1683304591883,AWP 10,012,202045,Staff,0,0,0,0
1683304591883,AWP 10,013,202046,Staff,0,0,0,0
1683304591883,AWP 10,014,202047,Staff,0,0,0,0
1683304591883,AWP 10,015,202048,Staff,0,0,0,0
1683304591883,AWP 10,016,202049,Staff,0,0,0,0
1683304591883,AWP 10,017,202050,Staff,0,0,0,0
1683304591883,AWP 10,018,202051,Staff,0,0,0,0
1683304591883,AWP 10,019,202052,Staff,0,0,0,0
1683304591883,AWP 10,020,202053,Staff,0,0,0,0
1683304591883,AWP 10,021,202054,Staff,0,0,0,0
1683304591883,AWP 10,022,202055,Staff,0,0,0,0
1683304591883,AWP 10,023,202056,Staff,0,0,0,0
1683304591883,AWP 10,024,202057,Staff,0,0,0,0
1683304591883,AWP 10,025,202058,Staff,0,0,0,0
1683304591883,AWP 10,026,202059,Staff,0,0,0,0
1683304592910,AWP 102,001,202032,Staff,0,0,0,0
1683304592910,AWP 102,002,202033,Staff,0,0,0,0
1683304593935,BENG 100,A01,254234,Taylor Amos; Alyssa C,31,0,40,9
1683304594959,BENG 196,001,270013,Engler; Adam J.,9999,0,9999,0
1683304595987,BICD 100R,A01,202018,Smith; Laurie,0,7,32,32
1683304595987,BICD 100R,A02,202019,Smith; Laurie,0,2,32,32
1683304595987,BICD 100R,A03,202020,Smith; Laurie,0,1,32,32
1683304595987,BICD 100R,A04,202021,Smith; Laurie,8,0,32,24
1683304595987,BICD 100R,A05,202022,Smith; Laurie,12,0,32,20
1683304597010,BICD 136,A01,193242,Gustafson-Brown; Cindy,0,2,32,32
1683304597010,BICD 136,A02,193244,Gustafson-Brown; Cindy,15,0,32,17
1683304598038,BIEB 102,A01,193249,Butler; Shannon Rhey,0,2,32,32
1683304598038,BIEB 102,A02,193251,Butler; Shannon Rhey,0,0,32,32
1683304598038,BIEB 102,A03,193253,Butler; Shannon Rhey,0,1,32,32
1683304598038,BIEB 102,A04,193255,Butler; Shannon Rhey,17,0,32,15
1683304598038,BIEB 102,A05,193265,Butler; Shannon Rhey,26,0,32,6
1683304598038,BIEB 102,A06,193269,Butler; Shannon Rhey,16,0,32,16
1683304600084,BIEB 150,A01,193274,Staff,0,0,32,32
1683304600084,BIEB 150,A02,193285,Staff,24,0,32,8
1683304601106,BIEB 194,A00,193286,Kurle; Carolyn M.,22,0,32,10
1683304602130,BILD 1,A01,192291,Staff,16,0,32,16
1683304602130,BILD 1,A02,192292,Staff,30,0,32,2
1683304602130,BILD 1,B01,192520,Reuther; Keefe,0,1,0,0
1683304602130,BILD 1,B02,192532,Reuther; Keefe,0,1,0,0
1683304603158,BILD 3,A01,192556,Butler; Shannon Rhey,0,0,32,32
1683304603158,BILD 3,A02,192581,Butler; Shannon Rhey,5,0,32,27
1683304603158,BILD 3,A03,192611,Butler; Shannon Rhey,23,0,32,9
1683304603158,BILD 3,A04,192612,Butler; Shannon Rhey,25,0,32,7
1683304603158,BILD 3,A05,192613,Butler; Shannon Rhey,27,0,32,5
1683304603158,BILD 3,A06,192679,Butler; Shannon Rhey,27,0,32,5
1683304603158,BILD 3,A07,192682,Butler; Shannon Rhey,22,0,32,10
1683304604181,BILD 4,A01,192836,Reuther; Keefe,1,0,24,23
1683304604181,BILD 4,A02,193044,Reuther; Keefe,4,0,24,20
1683304605205,BILD 10,A01,193142,Gustafson-Brown; Cindy,31,0,32,1
1683304605205,BILD 10,A02,193149,Gustafson-Brown; Cindy,31,0,32,1
1683304606228,BIMM 100,A01,193301,Staff,0,6,32,32
1683304606228,BIMM 100,A02,193312,Staff,0,5,32,32
1683304606228,BIMM 100,A03,193323,Staff,0,8,32,32
1683304607257,BIMM 101,A01,193329,McDonnell; Lisa Marie,0,3,24,24
1683304607257,BIMM 101,A02,193339,McDonnell; Lisa Marie,0,2,24,24
1683304607257,BIMM 101,B01,193354,McDonnell; Lisa Marie,0,3,24,24
1683304607257,BIMM 101,B02,193357,McDonnell; Lisa Marie,0,3,24,24
1683304608281,BIMM 110,A01,193377,Tat; John,0,11,32,32
1683304608281,BIMM 110,A02,193378,Tat; John,1,9,32,31
1683304609305,BIMM 120,A01,206116,Staff,0,0,32,32
1683304609305,BIMM 120,A02,206117,Staff,8,0,32,24
1683304609305,BIMM 120,A03,206121,Staff,21,0,32,11
1683304610329,BIPN 100,A01,193393,Park; Ji Young,0,14,32,32
1683304610329,BIPN 100,A02,193402,Park; Ji Young,0,12,32,32
1683304610329,BIPN 100,A03,193413,Park; Ji Young,0,14,32,32
1683304610329,BIPN 100,A04,193414,Park; Ji Young,0,13,32,32
1683304611352,BIPN 102,A01,193429,Staff,0,0,32,32
1683304611352,BIPN 102,A02,193438,Staff,23,0,32,9
1683304612374,BIPN 106,A01,193450,Reyes Gonzalez; Catalina,0,2,40,40
1683304613399,BIPN 134,A01,193465,Cooke; James Edward,0,0,32,32
1683304613399,BIPN 134,A02,193474,Cooke; James Edward,27,0,32,5
1683304613399,BIPN 134,A03,193485,Cooke; James Edward,29,0,32,3
1683304613399,BIPN 134,A04,193486,Cooke; James Edward,21,0,32,11
1683304613399,BIPN 134,A05,193491,Cooke; James Edward,31,0,32,1
1683304613399,BIPN 134,A06,193501,Cooke; James Edward,30,0,32,2
1683304613399,BIPN 134,A07,193510,Cooke; James Edward,29,0,32,3
1683304615447,BISP 194,A00,222522,Staff,16,0,32,16
1683304616470,CAT 124,A01,202407,Staff,20,0,25,5
1683304617497,CAT 125,A00,202408,Marchisotto; Jennifer Anne,4,0,20,16
1683304618525,CAT 125R,A00,202409,Smith; Lauryn Alissa,0,11,20,20
1683304618525,CAT 125R,B00,202410,Morales; Celeste Georgianna,0,11,20,20
1683304618525,CAT 125R,C00,202411,Irwin; Matthew Joseph,0,10,20,20
1683304619551,CENG 15,A01,204712,Yang; Kesong,0,1,0,0
1683304620577,CENG 114,A00,202070,Jahed Motlagh; Zeinab,5,0,20,15
1683304621599,CGS 105,A00,185477,Wesling; Megan E.,24,0,40,16
1683304622624,CGS 106,A00,185494,Staff,13,0,22,9
1683304623649,CGS 108,A00,185495,Staff,14,0,20,6
1683304624673,CGS 114,A00,185496,Staff,13,0,18,5
1683304625696,CGS 119,A00,185501,Staff,15,0,20,5
1683304626719,CGS 120,A00,185511,Staff,13,0,20,7
1683304627747,CHEM 4,A01,184675,Bussey; Thomas J,96,0,100,4
1683304628773,CHEM 6A,A01,184677,Staff,35,0,60,25
1683304629796,CHEM 6B,A01,184679,Staff,65,0,100,35
1683304630824,CHEM 6C,A01,184681,Bussey; Thomas J,1,0,50,49
1683304630824,CHEM 6C,A02,184682,Bussey; Thomas J,34,0,50,16
1683304631848,CHEM 40A,A01,184684,Albizati; Kim F.,37,0,100,63
1683304632876,CHEM 40B,A01,184686,Albizati; Kim F.,0,20,100,100
1683304633899,CHEM 41B,A01,184690,Staff,52,0,100,48
1683304634923,COGS 3,A01,184715,Boyle; Mary E. T.,0,25,40,40
1683304635951,COGS 14B,A01,185172,Staff,0,15,38,38
1683304636976,COGS 18,A01,184736,Staff,20,0,80,60
1683304638002,COGS 100,A01,184932,Staff,0,5,73,73
1683304639026,COGS 101A,A01,184935,Staff,0,38,30,30
1683304640053,COGS 101B,A01,184944,Staff,0,2,30,30
1683304641077,COGS 101C,A01,184946,Staff,0,12,30,30
1683304642101,COGS 102A,A01,184951,Johnson; Christine M.,2,0,40,38
1683304643125,COGS 107B,A01,184953,Mooshagian; Eric Frederick,0,50,40,40
1683304644148,COGS 118B,A01,184959,Gupta; Anjum,0,48,40,40
1683304645171,COGS 153,A00,184961,Staff,0,15,30,30
1683304646194,COGS 177,A00,184962,Staff,0,21,30,30
1683304647221,COGS 187A,A01,184969,Boyle; Mary E. T.,0,17,40,40
1683304648246,COMM 10,A01,185174,Staff,0,5,25,25
1683304648246,COMM 10,A02,185189,Staff,0,5,25,25
1683304648246,COMM 10,A03,269821,Staff,0,0,0,0
1683304649272,COMM 100B,A01,185475,Staff,0,0,0,2
1683304649272,COMM 100B,A02,185476,Staff,14,0,25,11
1683304650357,COMM 100C,A01,185314,Staff,1,0,25,24
1683304650357,COMM 100C,A02,185327,Staff,19,0,25,6
1683304651382,COMM 110M,A00,185349,Staff,2,0,40,38
1683304652407,COMM 113T,A00,185352,Staff,25,0,40,15
1683304653434,COMM 114I,A00,185353,Staff,33,0,40,7
1683304654458,COMM 131,A00,185354,Staff,19,0,30,11
1683304655486,CSE 8A,A50,185358,Cao; Yingjun,0,46,10,10
1683304656512,CSE 8B,A01,185362,Staff,1,47,50,49
1683304657536,CSE 11,A01,185416,Cao; Yingjun,0,93,10,10
1683304658564,CSE 20,A01,185445,Briones; Jor-el Thomas Caparas,5,0,25,20
1683304659589,CSE 21,A01,185447,Staff,10,0,50,40
1683304660620,CSE 101,A01,185451,Staff,0,12,50,50
1683304660620,CSE 101,B01,185453,Jones; Miles E,0,11,50,50
1683304662672,CSE 141,A01,185458,Eldon; John,20,0,100,80
1683304663700,CSE 141L,A01,185461,Eldon; John,12,0,100,88
1683304664725,CSE 142,A01,185463,Staff,35,0,60,25
1683304664725,CSE 142,B01,201355,Staff,0,6,60,60
1683304665750,CSE 142L,A01,185470,Staff,35,0,60,25
1683304665750,CSE 142L,B01,201417,Staff,0,5,60,60
1683304666774,CSE 190,A00,201433,Staff,32,0,49,17
1683304667803,DOC 1,A01,259136,Strom; Megan C.,8,0,15,7
1683304667803,DOC 1,A02,259137,Strom; Megan C.,14,0,15,1
1683304667803,DOC 1,A03,259138,Strom; Megan C.,14,0,15,1
1683304667803,DOC 1,A04,259139,Strom; Megan C.,14,0,15,1
1683304668830,DOC 100D,A00,259140,Pass; Natalye Joann,17,0,25,8
1683304669857,DSGN 1,A01,184749,Rill; Bryan,0,24,30,30
1683304670885,DSGN 100,A01,185168,Staff,0,2,25,25
1683304671912,ECE 5,A01,185626,Morris; Karcher William,0,10,0,0
1683304672939,ECE 101,A01,185628,Staff,17,0,70,53
1683304673963,ECE 107,A01,185635,Baghdadchi; Saharnaz,0,0,20,20
1683304673963,ECE 107,A02,185638,Baghdadchi; Saharnaz,4,0,20,16
1683304674990,ECE 148,A01,185647,Silberman; Jack,0,0,16,16
1683304676013,ECON 1,A01,185537,Crane; Meredith Helen,54,0,70,16
1683304677037,ECON 3,A01,185549,Crane; Meredith Helen,33,0,70,37
1683304678060,ECON 4,A01,203354,Anderson; John Charles,0,4,10,10
1683304679083,ECON 100A,A01,185574,Staff,0,4,40,40
1683304680107,ECON 100B,A01,185576,Staff,0,22,40,40
1683304681130,ECON 100C,A01,185589,Newhouse; Herbert S,30,0,70,40
1683304682153,ECON 105,A00,185608,Vespa; Emanuel Ignacio,19,0,35,16
1683304683181,ECON 109,A01,185610,Shishkin; Denis,10,0,35,25
1683304684204,ECON 110A,A01,185612,Staff,11,0,40,29
1683304685230,ECON 120A,A01,185615,Staff,20,0,40,20
1683304686253,ECON 120C,A01,185617,Sun; Yixiao,0,20,70,70
1683304687276,ECON 144,A00,203346,Squires; Dale E,3,0,35,32
1683304688303,ECON 171,A01,203349,Newhouse; Herbert S,0,1,35,35
1683304689330,ECON 173A,A01,185621,Toda; Alexis Akira,21,0,35,14
1683304690355,EDS 25,A01,202413,Staff,0,1,0,0
1683304690355,EDS 25,A02,202414,Staff,0,1,0,0
1683304690355,EDS 25,A03,202415,Staff,0,0,0,0
1683304690355,EDS 25,A04,202416,Staff,0,1,0,0
1683304690355,EDS 25,A05,202439,Staff,0,0,0,0
1683304690355,EDS 25,A06,202440,Staff,0,0,0,0
1683304690355,EDS 25,B01,202631,Staff,0,0,0,0
1683304690355,EDS 25,B02,202632,Staff,0,0,0,0
1683304690355,EDS 25,B03,202639,Staff,0,0,0,0
1683304690355,EDS 25,B04,202640,Staff,0,0,0,0
1683304690355,EDS 25,B05,202643,Staff,0,0,0,0
1683304690355,EDS 25,B06,202644,Staff,0,0,0,0
1683304691379,EDS 38,A01,202659,Black; Alison Michelle,24,0,25,1
1683304692403,EDS 115,A00,202652,Staff,17,0,30,13
1683304693429,EDS 125,A00,202649,Staff,14,0,30,16
1683304694456,EDS 126,A01,203332,Staff,30,0,30,0
1683304695479,EDS 139,A00,202838,Staff,17,0,25,8
1683304696502,EDS 146,A01,202655,Staff,15,0,25,10
1683304697530,ENG 15,A00,185667,Staff,0,1,0,0
1683304697530,ENG 15,B00,185672,Staff,0,0,0,0
1683304697530,ENG 15,C00,185675,Staff,0,0,0,0
1683304697530,ENG 15,D00,185682,Staff,0,0,0,0
1683304697530,ENG 15,E00,185684,Staff,0,0,0,0
1683304698555,ETHN 103,A00,185710,Staff,0,3,35,35
1683304699583,ETHN 103A,A00,199228,Man; Simeon S,2,0,9,7
1683304700609,ETHN 109,A00,185711,Staff,18,0,35,17
1683304701633,ETHN 142,A00,185726,Staff,0,4,30,30
1683304702657,ETHN 163J,A00,199229,Man; Simeon S,6,0,8,2
1683304703682,ETHN 168,A00,185727,Staff,8,0,10,2
1683304704706,ETHN 182,A00,185728,Staff,1,0,35,34
1683304705729,ETHN 183,A00,185737,Staff,8,0,18,10
1683304706753,GLBH 111,A01,209361,Burgos; Jose L.,0,0,0,0
1683304708803,HIEU 104,A00,185792,Staff,16,0,20,4
1683304709830,HIEU 115,A00,185800,Staff,1,0,20,19
1683304710857,HIEU 128,A00,185801,Staff,0,7,20,20
1683304711883,HIEU 147,A00,185802,Staff,16,0,20,4
1683304712910,HIEU 154,A00,185823,Staff,12,0,20,8
1683304713934,HILA 102,A00,185826,Staff,13,0,20,7
1683304714958,HILD 2C,A01,185778,Staff,0,12,20,20
1683304715982,HILD 7B,A01,185780,Kwak; Nancy,0,15,32,32
1683304715982,HILD 7B,A02,185781,Kwak; Nancy,0,18,32,32
1683304717010,HILD 30,A01,185791,Staff,14,0,20,6
1683304718034,HISC 119,A00,185830,Golan; Tal,0,9,20,20
1683304719058,HITO 156GS,A00,185831,Patterson; Patrick H.,0,0,0,23
1683304720082,HIUS 103,A00,185832,Man; Simeon S,0,6,20,20
1683304721106,HIUS 117,A00,185836,Kwak; Nancy,2,0,20,18
1683304722130,HIUS 125,A00,185840,Man; Simeon S,0,0,23,23
1683304723153,HIUS 149,A00,185845,Staff,0,0,20,20
1683304724178,HUM 3,A01,185882,Zavodny; Tatiana Sophia,0,6,50,50
1683304724178,HUM 3,B01,185899,Caldwell; Michael Alan,0,19,50,50
1683304725204,HUM 3GS,A00,185900,Patterson; Patrick H.,0,0,0,23
1683304726231,HUM 4,A01,185938,Zroka; Amy Liane,31,0,50,19
1683304726231,HUM 4,B01,185956,Watkins; Eric,0,2,50,50
1683304726231,HUM 4,B02,202209,Watkins; Eric,0,1,50,50
1683304726231,HUM 4,B03,202210,Watkins; Eric,0,0,50,50
1683304727255,HUM 5,A01,185958,West; Geoffrey Scott,5,0,50,45
1683304727255,HUM 5,A02,202215,West; Geoffrey Scott,0,0,50,50
1683304728285,INTL 190,A00,185959,Gagnon; Jeffrey C,0,0,0,9
1683304728285,INTL 190,B00,185960,Lettieri; Michael Joseph,0,0,0,1
1683304729308,JAPN 180,A00,254509,Staff,5,1,30,25
1683304730337,LATI 10,A01,202853,Kennemore; Amy Michelle,5,0,35,30
1683304730337,LATI 10,A02,202854,Kennemore; Amy Michelle,1,0,35,34
1683304730337,LATI 10,A03,270054,Kennemore; Amy Michelle,30,0,30,0
1683304731360,LATI 180,A00,202855,Kennemore; Amy Michelle,11,0,20,9
1683304732386,LAWS 101,A00,201767,Golan; Tal,0,7,40,40
1683304733411,LIFR 1C,A00,185961,Staff,6,0,20,14
1683304734436,LIFR 1CX,A00,185962,Staff,7,0,20,13
1683304735464,LIFR 1D,A00,185963,Staff,9,0,20,11
1683304736491,LIFR 1DX,A00,185964,Staff,9,0,20,11
1683304737513,LIGN 101,A01,186039,Staff,43,0,50,7
1683304738537,LIGN 165,A00,186040,Staff,18,0,50,32
1683304739563,LTCS 108,A00,186041,Staff,6,0,10,4
1683304740588,LTCS 119,A00,186042,Staff,16,0,20,4
1683304741612,LTCS 130,A00,186043,Wesling; Megan E.,15,0,25,10
1683304743663,LTEA 138,A00,186119,Staff,14,0,40,26
1683304744691,LTEN 124,A00,186148,Staff,6,0,25,19
1683304745715,LTEN 178,A00,186149,Staff,7,0,15,8
1683304746742,LTEN 181,A00,186150,Blanco; John D,33,0,40,7
1683304747769,LTWL 120,A00,186160,Staff,20,0,25,5
1683304748795,LTWL 165,A00,186161,Staff,22,0,25,3
1683304749819,LTWR 100,A00,186162,Staff,0,4,15,15
1683304750846,LTWR 102,A00,186163,Doller; Ben,5,0,15,10
1683304751870,MAE 8,A01,186412,Staff,0,0,0,0
1683304752898,MAE 30B,A00,186445,Bahadori; Mohammad Yousef,83,0,100,17
1683304753981,MAE 40,A00,186592,Bewley; Thomas R,9,0,50,41
1683304755007,MAE 101B,A00,186593,Bahadori; Mohammad Yousef,81,0,100,19
1683304756035,MAE 105,A00,186594,Bandaru; Prabhakar,12,0,50,38
1683304757059,MAE 107,A00,186599,Pham; Hieu Tan,0,6,120,120
1683304758083,MAE 148,A01,186660,Silberman; Jack,3,0,16,13
1683304759109,MATH 10A,A01,188095,Staff,0,7,35,35
1683304760136,MATH 10B,A01,188097,Bowers; Adam R.,0,11,30,30
1683304760136,MATH 10B,A02,188099,Bowers; Adam R.,0,9,30,30
1683304760136,MATH 10B,B01,188104,Bowers; Adam R.,0,11,30,30
1683304760136,MATH 10B,B02,188106,Bowers; Adam R.,0,11,30,30
1683304761166,MATH 10C,A01,188111,Staff,0,18,30,30
1683304761166,MATH 10C,A02,188127,Staff,0,17,30,30
1683304761166,MATH 10C,A03,188131,Staff,0,17,30,30
1683304761166,MATH 10C,B01,188218,Staff,21,0,30,9
1683304761166,MATH 10C,B02,188244,Staff,13,0,30,17
1683304761166,MATH 10C,B03,188277,Staff,16,0,30,14
1683304762191,MATH 18,A01,188344,Bach; Quang Tran,18,0,30,12
1683304762191,MATH 18,A02,188345,Bach; Quang Tran,11,0,30,19
1683304762191,MATH 18,B01,188353,Bach; Quang Tran,10,0,30,20
1683304762191,MATH 18,B02,188354,Bach; Quang Tran,20,0,30,10
1683304763219,MATH 20A,A01,188374,Staff,13,0,35,22
1683304764247,MATH 20B,A01,188382,Ohm; Ko Woon,6,0,30,24
1683304764247,MATH 20B,A02,188383,Ohm; Ko Woon,24,0,30,6
1683304764247,MATH 20B,B01,188385,Ohm; Ko Woon,7,0,30,23
1683304764247,MATH 20B,B02,188392,Ohm; Ko Woon,22,0,30,8
1683304765273,MATH 20C,A01,188394,Harel; Guershon,10,0,30,20
1683304765273,MATH 20C,A02,188395,Harel; Guershon,13,0,30,17
1683304765273,MATH 20C,B01,188404,Harel; Guershon,3,0,30,27
1683304765273,MATH 20C,B02,188405,Harel; Guershon,19,0,30,11
1683304766298,MATH 20D,A01,188414,Hammock; Frances H,0,1,30,30
1683304766298,MATH 20D,A02,188415,Hammock; Frances H,4,0,30,26
1683304766298,MATH 20D,B01,188447,Hammock; Frances H,2,0,30,28
1683304766298,MATH 20D,B02,188486,Hammock; Frances H,8,0,30,22
1683304767329,MATH 20E,A01,188649,Staff,22,0,30,8
1683304767329,MATH 20E,A02,188650,Staff,23,0,30,7
1683304767329,MATH 20E,A03,188673,Staff,0,0,30,30
1683304768354,MATH 102,A01,188675,Staff,0,35,35,35
1683304769380,MATH 103B,A01,188681,Staff,4,0,35,31
1683304769380,MATH 103B,B01,188692,Staff,7,0,35,28
1683304770405,MATH 109,A01,188695,Salehi Golsefidy; Alireza,25,0,35,10
1683304770405,MATH 109,A02,188696,Salehi Golsefidy; Alireza,27,0,35,8
1683304771429,MATH 120A,A01,188698,Eggers; John Dietrich,6,0,35,29
1683304772454,MATH 142B,A01,188736,Ioana; Adrian,0,2,30,30
1683304772454,MATH 142B,A02,188741,Ioana; Adrian,0,1,30,30
1683304772454,MATH 142B,A03,188743,Ioana; Adrian,0,3,30,30
1683304773478,MATH 168A,A01,188790,Staff,0,8,35,35
1683304774503,MATH 170A,A01,188803,Nie; Jiawang,0,2,35,35
1683304774503,MATH 170A,A02,188811,Nie; Jiawang,0,0,35,35
1683304774503,MATH 170A,A03,188814,Nie; Jiawang,1,0,35,34
1683304774503,MATH 170A,A04,188815,Nie; Jiawang,14,0,35,21
1683304775530,MATH 193B,A01,188817,Staff,0,0,35,35
1683304775530,MATH 193B,A02,188818,Staff,5,0,35,30
1683304776558,MGT 4,A01,202857,Anderson; John Charles,62,0,80,18
1683304777582,MGT 12,A00,202858,Lindenberger; Wade Douglas,43,0,90,47
1683304778606,MGT 18,A00,202859,Staff,74,0,90,16
1683304779632,MGT 18GS,A00,202860,McKay; Michael J,13,0,28,15
1683304780656,MGT 45,A00,202861,Pecore; Joseph P.,14,0,90,76
1683304781680,MGT 100,A00,202863,Yavorsky; Daniel Ryan,28,0,90,62
1683304782705,MGT 103,A00,202864,Ehrich; Kristine R,0,16,90,90
1683304783733,MGT 112,A00,202865,Ehrich; Kristine R,15,0,90,75
1683304784757,MGT 121A,A00,202868,Staff,0,19,0,0
1683304785782,MGT 131B,A00,202869,Anderson; John Charles,59,0,90,31
1683304786807,MGT 136,A00,202871,Lindenberger; Wade Douglas,84,0,90,6
1683304787832,MGT 164,A00,202873,Staff,0,69,90,90
1683304788859,MGT 164GS,A00,202874,McKay; Mary A,13,0,28,15
1683304789884,MGT 180,A00,202875,Staff,0,51,90,90
1683304790909,MMW 11R,A01,205019,Herbst; Matthew,3,0,30,27
1683304790909,MMW 11R,A02,205026,Herbst; Matthew,29,0,30,1
1683304791938,MMW 15,A01,193512,Chang; Edmond Yi-Teh,0,9,28,28
1683304791938,MMW 15,A02,193513,Chang; Edmond Yi-Teh,0,5,28,28
1683304791938,MMW 15,A03,193514,Chang; Edmond Yi-Teh,0,5,28,28
1683304791938,MMW 15,A04,193515,Chang; Edmond Yi-Teh,0,4,28,28
1683304791938,MMW 15,A05,193516,Chang; Edmond Yi-Teh,0,4,28,28
1683304791938,MMW 15,A06,193517,Chang; Edmond Yi-Teh,0,5,28,28
1683304791938,MMW 15,B01,193519,Chang; Edmond Yi-Teh,0,4,28,28
1683304791938,MMW 15,B02,193520,Chang; Edmond Yi-Teh,0,5,28,28
1683304791938,MMW 15,B03,193521,Chang; Edmond Yi-Teh,0,4,28,28
1683304791938,MMW 15,B04,193522,Chang; Edmond Yi-Teh,0,4,28,28
1683304791938,MMW 15,B05,193523,Chang; Edmond Yi-Teh,0,5,28,28
1683304791938,MMW 15,B06,193524,Chang; Edmond Yi-Teh,0,4,28,28
1683304792965,MMW 122,A01,193526,Rahimi; Babak,0,14,28,28
1683304792965,MMW 122,A02,193527,Rahimi; Babak,0,14,28,28
1683304792965,MMW 122,A03,193528,Rahimi; Babak,0,0,0,0
1683304792965,MMW 122,A04,193529,Rahimi; Babak,0,0,0,0
1683304793991,MUS 1A,A01,186663,Staff,0,20,35,35
1683304795016,MUS 4,A01,186715,Staff,0,12,35,35
1683304796040,MUS 5R,A01,186796,Dubnov; Shlomo,0,17,35,35
1683304797067,MUS 6,A01,186798,Staff,0,3,25,25
1683304798090,MUS 7,A01,186830,Staff,12,0,35,23
1683304799117,MUS 8,A01,186930,Staff,0,26,35,35
1683304800142,MUS 15,A01,186932,Staff,0,15,35,35
1683304800142,MUS 15,B01,186934,Staff,0,15,35,35
1683304801167,MUS 80,A00,186935,Staff,2,0,20,18
1683304801167,MUS 80,B00,186936,Staff,25,0,25,0
1683304802193,NANO 11,A00,204702,Lipomi; Darren John,0,0,0,0
1683304803215,NANO 15,A01,204709,Yang; Kesong,0,1,0,0
1683304804239,NANO 114,A00,202069,Jahed Motlagh; Zeinab,3,0,10,7
1683304805262,PHIL 1,A00,186955,Grush; Rick Scott,32,0,40,8
1683304806290,PHIL 10,A01,186973,Grush; Rick Scott,29,0,35,6
1683304806290,PHIL 10,A02,186974,Grush; Rick Scott,33,0,35,2
1683304807317,PHIL 13,A01,186976,Staff,7,0,35,28
1683304807317,PHIL 13,A02,186977,Staff,16,0,35,19
1683304808346,PHIL 14,A01,186979,Staff,31,0,35,4
1683304808346,PHIL 14,A02,186986,Staff,32,0,35,3
1683304809375,PHIL 28,A01,186988,Staff,16,0,30,14
1683304809375,PHIL 28,A02,186989,Staff,1,0,30,29
1683304809375,PHIL 28,A03,186990,Staff,9,0,30,21
1683304809375,PHIL 28,A04,186991,Staff,26,0,30,4
1683304810399,PHIL 120,A00,186997,Staff,23,0,40,17
1683304811424,PHIL 137,A00,187003,Staff,9,0,40,31
1683304812451,PHIL 150,A00,187015,Staff,47,0,70,23
1683304813478,PHIL 167,A00,187021,Lamey; Andy M.,35,0,40,5
1683304814506,PHIL 174,A01,202226,Staff,17,0,20,3
1683304814506,PHIL 174,A02,202235,Staff,20,0,20,0
1683304815530,PHIL 191A,A00,258918,Staff,0,0,1,1
1683304816557,PHYS 1A,A00,187028,Staff,26,0,60,34
1683304817584,PHYS 1AL,001,187036,Staff,2,0,30,28
1683304817584,PHYS 1AL,002,187049,Staff,18,0,30,12
1683304818613,PHYS 1B,A00,187058,Staff,23,0,60,37
1683304819641,PHYS 1BL,001,187064,Staff,0,0,30,30
1683304819641,PHYS 1BL,002,187070,Staff,6,0,30,24
1683304820665,PHYS 1C,A00,187082,Staff,31,0,120,89
1683304821694,PHYS 1CL,001,187088,Staff,0,9,30,30
1683304821694,PHYS 1CL,002,187089,Staff,0,2,30,30
1683304821694,PHYS 1CL,009,262693,Staff,11,0,30,19
1683304822718,PHYS 2B,A01,187097,Staff,54,0,115,61
1683304823745,PHYS 2C,A01,187099,Staff,67,0,115,48
1683304824773,PHYS 2CL,A01,187101,Staff,5,0,28,23
1683304824773,PHYS 2CL,A02,187102,Staff,15,0,28,13
1683304825798,PHYS 2D,A01,187123,Shotwell; Brian,95,0,115,20
1683304826826,PHYS 4B,A01,187133,Grinstein; Benjamin,35,0,50,15
1683304827852,POLI 10,A00,188819,Staff,0,3,50,50
1683304828876,POLI 11,A00,188827,Staff,43,0,50,7
1683304829903,POLI 13R,A00,188828,Staff,0,1,20,20
1683304830930,POLI 27,A01,188830,Elgin; Samuel Zincke,0,1,70,70
1683304831956,POLI 30,A00,188832,Desposato; Scott,33,0,50,17
1683304832982,POLI 102F,A00,188834,Staff,3,0,40,37
1683304834010,POLI 104A,A00,188852,Staff,14,0,30,16
1683304835034,POLI 104I,A00,188853,Staff,0,6,20,20
1683304836061,POLI 110B,A00,188854,Wiens; David,7,0,20,13
1683304837088,POLI 112A,A00,188855,Wiens; David,5,0,30,25
1683304838112,POLI 117R,A00,188856,Forman; Fonna,0,11,20,20
1683304839137,POLI 118,A00,188857,Ingham; Sean,8,0,20,12
1683304840159,POLI 120G,A00,188858,Staff,9,0,30,21
1683304841183,POLI 131CR,A00,188863,Hoston; Germaine,24,0,50,26
1683304842208,POLI 133,A00,188864,Nellis; Gareth Hb,44,0,50,6
1683304843230,POLI 134D,A00,188865,Desposato; Scott,27,0,30,3
1683304844257,POLI 142A,A00,188871,Gartzke; Erik,22,0,50,28
1683304845284,POLI 142K,A00,188874,Staff,38,0,50,12
1683304846310,POLI 143,A00,188940,Gartzke; Erik,16,0,30,14
1683304847337,POLI 153,A00,188943,Staff,3,0,20,17
1683304848362,POLI 160AA,A00,188944,Staff,13,0,40,27
1683304849385,POLI 170A,A00,188945,Staff,11,0,30,19
1683304851435,PSYC 1,A00,188952,Staff,38,0,90,52
1683304852462,PSYC 2,B00,188953,Staff,20,0,35,15
1683304853485,PSYC 6,A00,188970,Staff,47,0,60,13
1683304854509,PSYC 7,A00,188973,Staff,37,0,45,8
1683304855537,PSYC 60,A01,188980,Rickard; Timothy C.,43,0,60,17
1683304856566,PSYC 70,A01,189001,Steiner; Eric Tomas,24,0,45,21
1683304857645,PSYC 100,A00,189005,Lacefield; Katharine I,0,99,120,120
1683304858669,PSYC 102,A00,189008,Staff,10,0,30,20
1683304859697,PSYC 106,B00,189026,Gorman; Michael R.,37,0,60,23
1683304860722,PSYC 114,B01,189033,Winkielman; Piotr,0,32,30,30
1683304861745,PSYC 131,A00,189036,Anagnostaras; Stephan,0,43,60,60
1683304862770,PSYC 136,A00,189041,Lowe; Angela Beth,0,7,25,25
1683304863798,PSYC 137,A00,189057,Winkielman; Piotr,0,34,25,25
1683304864821,PSYC 144,A00,189107,Wixted; John T,0,7,50,50
1683304866870,PSYC 162,A00,189142,Staff,0,8,85,85
1683304867898,PSYC 172,A00,189144,Gorman; Michael R.,0,7,30,30
1683304869947,PSYC 179,A00,189146,Lacefield; Katharine I,0,84,120,120
1683304870970,PSYC 181,A00,189147,Anagnostaras; Stephan,0,44,90,90
1683304871998,PSYC 190R,A00,189148,Barner; David A.,0,22,80,80
1683304873030,PSYC 191,A00,189275,Rickard; Timothy C.,0,7,25,25
1683304874054,PSYC 193,A00,189276,Chapman; Eddie Nathaniel,0,1,0,4
1683304875079,PSYC 193L,A01,189281,Lowe; Angela Beth,12,0,20,8
1683304875079,PSYC 193L,B01,189285,Staff,28,0,35,7
1683304876105,RELI 149,A00,187137,Rahimi; Babak,7,0,40,33
1683304877134,SE 9,A01,187315,Staff,0,2,18,18
1683304878160,SE 101B,A00,187409,Staff,24,0,30,6
1683304879183,SE 110B,A00,187444,Staff,10,0,40,30
1683304880207,SE 130B,A00,187449,Staff,31,0,40,9
1683304881231,SE 150A,A00,187516,Staff,9,0,20,11
1683304882256,SE 154,A00,187528,Staff,30,0,50,20
1683304883282,SIO 3,A01,258171,Staff,35,0,40,5
1683304884306,SIO 10,A00,187144,Cook; Geoffrey W,0,3,75,75
1683304885332,SIO 45,A00,187152,Cook; Geoffrey W,1,0,100,99
1683304886361,SIO 109R,A00,194486,Staff,0,3,20,20
1683304888414,SIO 187,A01,187233,Kacev; David,12,0,40,28
1683304889439,SOCI 1,A01,258656,Thorpe; Charles Robert,28,0,30,2
1683304889439,SOCI 1,A02,258658,Thorpe; Charles Robert,30,0,30,0
1683304889439,SOCI 1,A03,258661,Thorpe; Charles Robert,25,0,25,0
1683304889439,SOCI 1,A04,258666,Thorpe; Charles Robert,22,0,25,3
1683304889439,SOCI 1,A05,258897,Thorpe; Charles Robert,23,0,25,2
1683304889439,SOCI 1,A06,258898,Thorpe; Charles Robert,25,0,25,0
1683304890465,SOCI 30,A01,258903,Pardo Guerra; Juan Pablo,16,0,30,14
1683304891490,SOCI 102,A00,258904,Staff,9,0,25,16
1683304892516,SOCI 106,A00,258905,Staff,19,0,25,6
1683304893540,SOCI 111,A00,258907,Ribas Norris; Janet Vanesa,26,0,30,4
1683304894568,SOCI 121R,A00,258908,Pardo Guerra; Juan Pablo,11,0,30,19
1683304895595,SOCI 126,A01,203330,Staff,14,0,20,6
1683304896619,SOCI 131,A00,258909,Thorpe; Charles Robert,31,0,60,29
1683304897644,SOCI 135,A00,258910,Payne; Christine Anna,0,9,30,30
1683304898670,SOCI 157,A00,258911,Staff,13,0,30,17
1683304899697,SOCI 184,A00,258912,Staff,26,0,30,4
1683304900733,SOCI 188D,A00,258913,Staff,21,0,30,9
1683304901758,SYN 2,001,187529,Staff,9,0,16,7
1683304901758,SYN 2,002,201452,Staff,0,18,16,16
1683304901758,SYN 2,003,201469,Staff,3,0,16,13
1683304902785,SYN 100,A01,187531,Staff,0,9,20,20
1683304902785,SYN 100,B01,201491,Staff,0,12,20,20
1683304903813,TDAC 1,A00,189286,Walsh; Kim C.,3,0,20,17
1683304903813,TDAC 1,B00,189287,Harting; Carla Kelso,11,0,20,9
1683304904837,TDAC 101,A00,189300,Walsh; Kim C.,16,0,20,4
1683304904837,TDAC 101,B00,189301,Harting; Carla Kelso,18,0,20,2
1683304905864,TDAC 102,A00,189304,Basso; Beatrice,14,0,20,6
1683304906889,TDAC 108,A00,189305,Staff,18,0,20,2
1683304907914,TDDE 131,A00,189310,Staff,19,0,20,1
1683304907914,TDDE 131,B00,189314,Staff,19,0,20,1
1683304907914,TDDE 131,C00,189315,Staff,48,0,50,2
1683304907914,TDDE 131,D00,189316,Staff,14,0,15,1
1683304907914,TDDE 131,E00,204841,Staff,20,0,20,0
1683304908943,TDGE 10,A00,189289,Staff,30,0,50,20
1683304908943,TDGE 10,B00,189290,Havis; Allan,2,0,50,48
1683304909969,TDGE 11,A00,189291,Fulton; Julia,0,3,50,50
1683304909969,TDGE 11,B00,189292,Staff,20,0,25,5
1683304909969,TDGE 11,C00,260270,Staff,0,0,0,0
1683304910994,TDGE 25,A00,189294,Staff,3,0,20,17
1683304912017,TDGE 124,A00,189318,Fulton; Julia,0,8,50,50
1683304913075,TDGE 125,A00,189319,Staff,13,0,25,12
1683304913075,TDGE 125,B00,189320,Staff,23,0,25,2
1683304914103,TDGE 127,A00,189322,Havis; Allan,0,0,50,50
1683304915130,TDHT 101,A00,189323,Staff,18,0,25,7
1683304915130,TDHT 101,B00,189324,Staff,25,0,25,0
1683304916154,TDHT 102,A00,189325,Staff,49,0,50,1
1683304917182,TDMV 1,A00,189295,Arcidiacono; Kristin,20,0,30,10
1683304917182,TDMV 1,B00,189296,Caligagan; Maria T.,24,0,30,6
1683304918205,TDMV 2,A00,189297,Sammartano; Tonnie,28,0,30,2
1683304918205,TDMV 2,B00,189299,Arcidiacono; Kristin,24,0,30,6
1683304919233,TDMV 3,A00,204998,Rincon; Alicia,22,0,30,8
1683304920257,TDMV 120,A00,189458,Sammartano; Tonnie,28,0,30,2
1683304921284,TDMV 138,A00,189541,Jun; Grace Shin Hae,22,0,40,18
1683304922308,TDMV 142,A00,189717,Caligagan; Tony,23,0,30,7
1683304922308,TDMV 142,B00,189718,Caligagan; Maria T.,25,0,30,5
1683304923331,TMC 2,A01,187533,Staff,25,0,25,0
1683304923331,TMC 2,A02,187534,Staff,25,0,25,0
1683304924359,USP 1,A01,187536,Kwak; Nancy,0,16,25,25
1683304925386,USP 5,A01,187538,Staff,9,0,25,16
1683304926414,USP 101,A00,199253,Staff,0,4,0,0
1683304927447,USP 124,A00,187562,Boomhower; Matthew Charles,1,0,30,29
1683304928473,USP 138,A00,187582,Staff,20,0,25,5
1683304929500,USP 152,A01,187597,Staff,4,0,25,21
1683304930524,USP 153,A00,187598,Staff,19,0,25,6
1683304931548,USP 168,A00,187607,Kwak; Nancy,2,0,5,3
1683304932573,USP 173,A00,187619,Staff,4,0,25,21
1683304933600,USP 181,A00,187638,Staff,0,0,25,25
1683304934626,VIS 103,A00,187650,Cruz; Edwin Teddy,23,0,75,52
1683304935653,VIS 110D,A00,187669,Staff,12,0,22,10
1683304936678,VIS 127C,A00,187720,Shen; Kuiyi,68,0,146,78
1683304937705,VIS 149,A00,187731,Yoldas; Pinar,0,14,22,22
1683304938729,VIS 151,A01,188091,Staff,22,0,34,12
1683304938729,VIS 151,A02,188092,Staff,11,0,34,23
1683304939753,VIS 160B,A00,188093,Stalbaum; Brett,0,0,10,10
1683304941808,WCWP 10B,A00,201720,Staff,10,0,15,5
1683304941808,WCWP 10B,B00,201722,Staff,8,0,15,7
1683304942834,WCWP 100,A00,201725,Gagnon; Jeffrey C,0,0,2,2
1683304942834,WCWP 100,B00,201727,Staff,0,4,15,15
1683304945957,ANBI 133,A00,258401,Wilder; Linnea Lorene,34,0,40,6
1683304946982,ANBI 140,A00,258395,Hrvoj Mihic; Branka,18,0,25,7
1683304948007,ANSC 120,A00,258402,Bialecki; Jon Anthony,27,0,40,13
1683304949032,ANSC 144,A00,258400,Staff,14,0,40,26
1683304951085,ANSC 166,A00,258396,Parish; Steven Martin,157,0,175,18
1683304952114,ANSC 180,A00,193533,Staff,9,0,20,11
1683304953138,ANSC 188,A00,258397,Jassal; Aftab,33,0,40,7
1683304954166,ANTH 3,A01,258316,Staff,23,0,30,7
1683304955190,ANTH 5,A00,258394,Semendeferi; Ekaterini,16,0,20,4
1683304956213,ANTH 21,A01,258331,Staff,9,0,40,31
1683304957236,ANTH 103,A00,258398,Varma; Saiba,15,0,25,10
1683304958267,AWP 10,001,202034,Staff,0,0,0,0
1683304958267,AWP 10,002,202035,Staff,0,0,0,0
1683304958267,AWP 10,003,202036,Staff,0,0,0,0
1683304958267,AWP 10,004,202037,Staff,0,0,0,0
1683304958267,AWP 10,005,202038,Staff,0,0,0,0
1683304958267,AWP 10,006,202039,Staff,0,0,0,0
1683304958267,AWP 10,007,202040,Staff,0,0,0,0
1683304958267,AWP 10,008,202041,Staff,0,0,0,0
1683304958267,AWP 10,009,202042,Staff,0,0,0,0
1683304958267,AWP 10,010,202043,Staff,0,0,0,0
1683304958267,AWP 10,011,202044,Staff,0,0,0,0
1683304958267,AWP 10,012,202045,Staff,0,0,0,0
1683304958267,AWP 10,013,202046,Staff,0,0,0,0
1683304958267,AWP 10,014,202047,Staff,0,0,0,0
1683304958267,AWP 10,015,202048,Staff,0,0,0,0
1683304958267,AWP 10,016,202049,Staff,0,0,0,0
1683304958267,AWP 10,017,202050,Staff,0,0,0,0
1683304958267,AWP 10,018,202051,Staff,0,0,0,0
1683304958267,AWP 10,019,202052,Staff,0,0,0,0
1683304958267,AWP 10,020,202053,Staff,0,0,0,0
1683304958267,AWP 10,021,202054,Staff,0,0,0,0
1683304958267,AWP 10,022,202055,Staff,0,0,0,0
1683304958267,AWP 10,023,202056,Staff,0,0,0,0
1683304958267,AWP 10,024,202057,Staff,0,0,0,0
1683304958267,AWP 10,025,202058,Staff,0,0,0,0
1683304958267,AWP 10,026,202059,Staff,0,0,0,0
1683304959294,AWP 102,001,202032,Staff,0,0,0,0
1683304959294,AWP 102,002,202033,Staff,0,0,0,0
1683304960319,BENG 100,A01,254234,Taylor Amos; Alyssa C,31,0,40,9
1683304961397,BENG 196,001,270013,Engler; Adam J.,9999,0,9999,0
1683304962420,BICD 100R,A01,202018,Smith; Laurie,0,7,32,32
1683304962420,BICD 100R,A02,202019,Smith; Laurie,0,2,32,32
1683304962420,BICD 100R,A03,202020,Smith; Laurie,0,1,32,32
1683304962420,BICD 100R,A04,202021,Smith; Laurie,8,0,32,24
1683304962420,BICD 100R,A05,202022,Smith; Laurie,12,0,32,20
1683304963444,BICD 136,A01,193242,Gustafson-Brown; Cindy,0,2,32,32
1683304963444,BICD 136,A02,193244,Gustafson-Brown; Cindy,15,0,32,17
1683304964468,BIEB 102,A01,193249,Butler; Shannon Rhey,0,2,32,32
1683304964468,BIEB 102,A02,193251,Butler; Shannon Rhey,0,0,32,32
1683304964468,BIEB 102,A03,193253,Butler; Shannon Rhey,0,1,32,32
1683304964468,BIEB 102,A04,193255,Butler; Shannon Rhey,17,0,32,15
1683304964468,BIEB 102,A05,193265,Butler; Shannon Rhey,26,0,32,6
1683304964468,BIEB 102,A06,193269,Butler; Shannon Rhey,16,0,32,16
1683304966517,BIEB 150,A01,193274,Staff,0,0,32,32
1683304966517,BIEB 150,A02,193285,Staff,24,0,32,8
1683304967541,BIEB 194,A00,193286,Kurle; Carolyn M.,22,0,32,10
1683304968569,BILD 1,A01,192291,Staff,16,0,32,16
1683304968569,BILD 1,A02,192292,Staff,30,0,32,2
1683304968569,BILD 1,B01,192520,Reuther; Keefe,0,1,0,0
1683304968569,BILD 1,B02,192532,Reuther; Keefe,0,1,0,0
1683304969600,BILD 3,A01,192556,Butler; Shannon Rhey,0,0,32,32
1683304969600,BILD 3,A02,192581,Butler; Shannon Rhey,5,0,32,27
1683304969600,BILD 3,A03,192611,Butler; Shannon Rhey,23,0,32,9
1683304969600,BILD 3,A04,192612,Butler; Shannon Rhey,25,0,32,7
1683304969600,BILD 3,A05,192613,Butler; Shannon Rhey,27,0,32,5
1683304969600,BILD 3,A06,192679,Butler; Shannon Rhey,27,0,32,5
1683304969600,BILD 3,A07,192682,Butler; Shannon Rhey,22,0,32,10
1683304970628,BILD 4,A01,192836,Reuther; Keefe,1,0,24,23
1683304970628,BILD 4,A02,193044,Reuther; Keefe,4,0,24,20
1683304971653,BILD 10,A01,193142,Gustafson-Brown; Cindy,31,0,32,1
1683304971653,BILD 10,A02,193149,Gustafson-Brown; Cindy,31,0,32,1
1683304972678,BIMM 100,A01,193301,Staff,0,6,32,32
1683304972678,BIMM 100,A02,193312,Staff,0,5,32,32
1683304972678,BIMM 100,A03,193323,Staff,0,8,32,32
1683304973704,BIMM 101,A01,193329,McDonnell; Lisa Marie,0,3,24,24
1683304973704,BIMM 101,A02,193339,McDonnell; Lisa Marie,0,2,24,24
1683304973704,BIMM 101,B01,193354,McDonnell; Lisa Marie,0,3,24,24
1683304973704,BIMM 101,B02,193357,McDonnell; Lisa Marie,0,3,24,24
1683304974729,BIMM 110,A01,193377,Tat; John,0,11,32,32
1683304974729,BIMM 110,A02,193378,Tat; John,1,9,32,31
1683304975755,BIMM 120,A01,206116,Staff,0,0,32,32
1683304975755,BIMM 120,A02,206117,Staff,8,0,32,24
1683304975755,BIMM 120,A03,206121,Staff,21,0,32,11
1683304976779,BIPN 100,A01,193393,Park; Ji Young,0,14,32,32
1683304976779,BIPN 100,A02,193402,Park; Ji Young,0,12,32,32
1683304976779,BIPN 100,A03,193413,Park; Ji Young,0,14,32,32
1683304976779,BIPN 100,A04,193414,Park; Ji Young,0,13,32,32
1683304977804,BIPN 102,A01,193429,Staff,0,0,32,32
1683304977804,BIPN 102,A02,193438,Staff,23,0,32,9
1683304978832,BIPN 106,A01,193450,Reyes Gonzalez; Catalina,0,2,40,40
1683304979861,BIPN 134,A01,193465,Cooke; James Edward,0,0,32,32
1683304979861,BIPN 134,A02,193474,Cooke; James Edward,27,0,32,5
1683304979861,BIPN 134,A03,193485,Cooke; James Edward,29,0,32,3
1683304979861,BIPN 134,A04,193486,Cooke; James Edward,21,0,32,11
1683304979861,BIPN 134,A05,193491,Cooke; James Edward,31,0,32,1
1683304979861,BIPN 134,A06,193501,Cooke; James Edward,30,0,32,2
1683304979861,BIPN 134,A07,193510,Cooke; James Edward,29,0,32,3
1683304981909,BISP 194,A00,222522,Staff,16,0,32,16
1683304982934,CAT 124,A01,202407,Staff,20,0,25,5
1683304983960,CAT 125,A00,202408,Marchisotto; Jennifer Anne,4,0,20,16
1683304984989,CAT 125R,A00,202409,Smith; Lauryn Alissa,0,11,20,20
1683304984989,CAT 125R,B00,202410,Morales; Celeste Georgianna,0,11,20,20
1683304984989,CAT 125R,C00,202411,Irwin; Matthew Joseph,0,10,20,20
1683304986014,CENG 15,A01,204712,Yang; Kesong,0,1,0,0
1683304987038,CENG 114,A00,202070,Jahed Motlagh; Zeinab,5,0,20,15
1683304988062,CGS 105,A00,185477,Wesling; Megan E.,24,0,40,16
1683304989086,CGS 106,A00,185494,Staff,13,0,22,9
1683304990108,CGS 108,A00,185495,Staff,14,0,20,6
1683304991132,CGS 114,A00,185496,Staff,13,0,18,5
1683304992156,CGS 119,A00,185501,Staff,15,0,20,5
1683304993181,CGS 120,A00,185511,Staff,13,0,20,7
1683304994207,CHEM 4,A01,184675,Bussey; Thomas J,96,0,100,4
1683304995232,CHEM 6A,A01,184677,Staff,35,0,60,25
1683304996255,CHEM 6B,A01,184679,Staff,65,0,100,35
1683304997278,CHEM 6C,A01,184681,Bussey; Thomas J,1,0,50,49
1683304997278,CHEM 6C,A02,184682,Bussey; Thomas J,34,0,50,16
1683304998303,CHEM 40A,A01,184684,Albizati; Kim F.,37,0,100,63
1683304999332,CHEM 40B,A01,184686,Albizati; Kim F.,0,20,100,100
1683305000356,CHEM 41B,A01,184690,Staff,52,0,100,48
1683305001381,COGS 3,A01,184715,Boyle; Mary E. T.,0,25,40,40
1683305002404,COGS 14B,A01,185172,Staff,0,15,38,38
1683305003430,COGS 18,A01,184736,Staff,20,0,80,60
1683305004454,COGS 100,A01,184932,Staff,0,5,73,73
1683305005481,COGS 101A,A01,184935,Staff,0,38,30,30
1683305006505,COGS 101B,A01,184944,Staff,0,2,30,30
1683305007529,COGS 101C,A01,184946,Staff,0,12,30,30
1683305008552,COGS 102A,A01,184951,Johnson; Christine M.,2,0,40,38
1683305009577,COGS 107B,A01,184953,Mooshagian; Eric Frederick,0,50,40,40
1683305010600,COGS 118B,A01,184959,Gupta; Anjum,0,48,40,40
1683305011623,COGS 153,A00,184961,Staff,0,15,30,30
1683305012647,COGS 177,A00,184962,Staff,0,21,30,30
1683305013671,COGS 187A,A01,184969,Boyle; Mary E. T.,0,17,40,40
1683305014696,COMM 10,A01,185174,Staff,0,5,25,25
1683305014696,COMM 10,A02,185189,Staff,0,5,25,25
1683305014696,COMM 10,A03,269821,Staff,0,0,0,0
1683305015719,COMM 100B,A01,185475,Staff,0,0,0,2
1683305015719,COMM 100B,A02,185476,Staff,14,0,25,11
1683305016743,COMM 100C,A01,185314,Staff,1,0,25,24
1683305016743,COMM 100C,A02,185327,Staff,19,0,25,6
1683305017771,COMM 110M,A00,185349,Staff,2,0,40,38
1683305018795,COMM 113T,A00,185352,Staff,25,0,40,15
1683305019819,COMM 114I,A00,185353,Staff,33,0,40,7
1683305020846,COMM 131,A00,185354,Staff,19,0,30,11
1683305021870,CSE 8A,A50,185358,Cao; Yingjun,0,46,10,10
1683305022894,CSE 8B,A01,185362,Staff,1,47,50,49
1683305023921,CSE 11,A01,185416,Cao; Yingjun,0,93,10,10
1683305024949,CSE 20,A01,185445,Briones; Jor-el Thomas Caparas,5,0,25,20
1683305025976,CSE 21,A01,185447,Staff,10,0,50,40
1683305027000,CSE 101,A01,185451,Staff,0,12,50,50
1683305027000,CSE 101,B01,185453,Jones; Miles E,0,11,50,50
1683305029048,CSE 141,A01,185458,Eldon; John,20,0,100,80
1683305030074,CSE 141L,A01,185461,Eldon; John,12,0,100,88
1683305031102,CSE 142,A01,185463,Staff,35,0,60,25
1683305031102,CSE 142,B01,201355,Staff,0,6,60,60
1683305032126,CSE 142L,A01,185470,Staff,35,0,60,25
1683305032126,CSE 142L,B01,201417,Staff,0,5,60,60
1683305033150,CSE 190,A00,201433,Staff,32,0,49,17
1683305034179,DOC 1,A01,259136,Strom; Megan C.,8,0,15,7
1683305034179,DOC 1,A02,259137,Strom; Megan C.,14,0,15,1
1683305034179,DOC 1,A03,259138,Strom; Megan C.,14,0,15,1
1683305034179,DOC 1,A04,259139,Strom; Megan C.,14,0,15,1
1683305035207,DOC 100D,A00,259140,Pass; Natalye Joann,17,0,25,8
1683305036231,DSGN 1,A01,184749,Rill; Bryan,0,24,30,30
1683305037255,DSGN 100,A01,185168,Staff,0,2,25,25
1683305038281,ECE 5,A01,185626,Morris; Karcher William,0,10,0,0
1683305039305,ECE 101,A01,185628,Staff,17,0,70,53
1683305040329,ECE 107,A01,185635,Baghdadchi; Saharnaz,0,0,20,20
1683305040329,ECE 107,A02,185638,Baghdadchi; Saharnaz,4,0,20,16
1683305041355,ECE 148,A01,185647,Silberman; Jack,0,0,16,16
1683305042377,ECON 1,A01,185537,Crane; Meredith Helen,54,0,70,16
1683305043400,ECON 3,A01,185549,Crane; Meredith Helen,33,0,70,37
1683305044424,ECON 4,A01,203354,Anderson; John Charles,0,4,10,10
1683305045449,ECON 100A,A01,185574,Staff,0,4,40,40
1683305046473,ECON 100B,A01,185576,Staff,0,22,40,40
1683305047500,ECON 100C,A01,185589,Newhouse; Herbert S,30,0,70,40
1683305048525,ECON 105,A00,185608,Vespa; Emanuel Ignacio,19,0,35,16
1683305049556,ECON 109,A01,185610,Shishkin; Denis,10,0,35,25
1683305050583,ECON 110A,A01,185612,Staff,11,0,40,29
1683305051607,ECON 120A,A01,185615,Staff,20,0,40,20
1683305052634,ECON 120C,A01,185617,Sun; Yixiao,0,20,70,70
1683305053662,ECON 144,A00,203346,Squires; Dale E,3,0,35,32
1683305054686,ECON 171,A01,203349,Newhouse; Herbert S,0,1,35,35
1683305055710,ECON 173A,A01,185621,Toda; Alexis Akira,21,0,35,14
1683305056739,EDS 25,A01,202413,Staff,0,1,0,0
1683305056739,EDS 25,A02,202414,Staff,0,1,0,0
1683305056739,EDS 25,A03,202415,Staff,0,0,0,0
1683305056739,EDS 25,A04,202416,Staff,0,1,0,0
1683305056739,EDS 25,A05,202439,Staff,0,0,0,0
1683305056739,EDS 25,A06,202440,Staff,0,0,0,0
1683305056739,EDS 25,B01,202631,Staff,0,0,0,0
1683305056739,EDS 25,B02,202632,Staff,0,0,0,0
1683305056739,EDS 25,B03,202639,Staff,0,0,0,0
1683305056739,EDS 25,B04,202640,Staff,0,0,0,0
1683305056739,EDS 25,B05,202643,Staff,0,0,0,0
1683305056739,EDS 25,B06,202644,Staff,0,0,0,0
1683305057764,EDS 38,A01,202659,Black; Alison Michelle,24,0,25,1
1683305058788,EDS 115,A00,202652,Staff,17,0,30,13
1683305059812,EDS 125,A00,202649,Staff,14,0,30,16
1683305060839,EDS 126,A01,203332,Staff,30,0,30,0
1683305061867,EDS 139,A00,202838,Staff,17,0,25,8
1683305062890,EDS 146,A01,202655,Staff,15,0,25,10
1683305063919,ENG 15,A00,185667,Staff,0,1,0,0
1683305063919,ENG 15,B00,185672,Staff,0,0,0,0
1683305063919,ENG 15,C00,185675,Staff,0,0,0,0
1683305063919,ENG 15,D00,185682,Staff,0,0,0,0
1683305063919,ENG 15,E00,185684,Staff,0,0,0,0
1683305064997,ETHN 103,A00,185710,Staff,0,3,35,35
1683305066021,ETHN 103A,A00,199228,Man; Simeon S,2,0,9,7
1683305067049,ETHN 109,A00,185711,Staff,18,0,35,17
1683305068075,ETHN 142,A00,185726,Staff,0,4,30,30
1683305069101,ETHN 163J,A00,199229,Man; Simeon S,6,0,8,2
1683305070128,ETHN 168,A00,185727,Staff,8,0,10,2
1683305071152,ETHN 182,A00,185728,Staff,1,0,35,34
1683305072176,ETHN 183,A00,185737,Staff,8,0,18,10
1683305073200,GLBH 111,A01,209361,Burgos; Jose L.,0,0,0,0
1683305075246,HIEU 104,A00,185792,Staff,16,0,20,4
1683305076268,HIEU 115,A00,185800,Staff,1,0,20,19
1683305077291,HIEU 128,A00,185801,Staff,0,7,20,20
1683305078318,HIEU 147,A00,185802,Staff,16,0,20,4
1683305079345,HIEU 154,A00,185823,Staff,12,0,20,8
1683305080366,HILA 102,A00,185826,Staff,13,0,20,7
1683305081390,HILD 2C,A01,185778,Staff,0,12,20,20
1683305082416,HILD 7B,A01,185780,Kwak; Nancy,0,15,32,32
1683305082416,HILD 7B,A02,185781,Kwak; Nancy,0,18,32,32
1683305083438,HILD 30,A01,185791,Staff,14,0,20,6
1683305084462,HISC 119,A00,185830,Golan; Tal,0,9,20,20
1683305085485,HITO 156GS,A00,185831,Patterson; Patrick H.,0,0,0,23
1683305086512,HIUS 103,A00,185832,Man; Simeon S,0,6,20,20
1683305087540,HIUS 117,A00,185836,Kwak; Nancy,2,0,20,18
1683305088564,HIUS 125,A00,185840,Man; Simeon S,0,0,23,23
1683305089589,HIUS 149,A00,185845,Staff,0,0,20,20
1683305090618,HUM 3,A01,185882,Zavodny; Tatiana Sophia,0,6,50,50
1683305090618,HUM 3,B01,185899,Caldwell; Michael Alan,0,19,50,50
1683305091641,HUM 3GS,A00,185900,Patterson; Patrick H.,0,0,0,23
1683305092666,HUM 4,A01,185938,Zroka; Amy Liane,30,0,50,20
1683305092666,HUM 4,B01,185956,Watkins; Eric,0,2,50,50
1683305092666,HUM 4,B02,202209,Watkins; Eric,0,1,50,50
1683305092666,HUM 4,B03,202210,Watkins; Eric,0,0,50,50
1683305093693,HUM 5,A01,185958,West; Geoffrey Scott,5,0,50,45
1683305093693,HUM 5,A02,202215,West; Geoffrey Scott,0,0,50,50
1683305094718,INTL 190,A00,185959,Gagnon; Jeffrey C,0,0,0,9
1683305094718,INTL 190,B00,185960,Lettieri; Michael Joseph,0,0,0,1
1683305095743,JAPN 180,A00,254509,Staff,5,1,30,25
1683305096772,LATI 10,A01,202853,Kennemore; Amy Michelle,5,0,35,30
1683305096772,LATI 10,A02,202854,Kennemore; Amy Michelle,1,0,35,34
1683305096772,LATI 10,A03,270054,Kennemore; Amy Michelle,30,0,30,0
1683305097799,LATI 180,A00,202855,Kennemore; Amy Michelle,11,0,20,9
1683305098827,LAWS 101,A00,201767,Golan; Tal,0,7,40,40
1683305099852,LIFR 1C,A00,185961,Staff,6,0,20,14
1683305100875,LIFR 1CX,A00,185962,Staff,7,0,20,13
1683305101900,LIFR 1D,A00,185963,Staff,9,0,20,11
1683305102925,LIFR 1DX,A00,185964,Staff,9,0,20,11
1683305103951,LIGN 101,A01,186039,Staff,43,0,50,7
1683305104974,LIGN 165,A00,186040,Staff,18,0,50,32
1683305105997,LTCS 108,A00,186041,Staff,6,0,10,4
1683305107021,LTCS 119,A00,186042,Staff,16,0,20,4
1683305108048,LTCS 130,A00,186043,Wesling; Megan E.,15,0,25,10
1683305110097,LTEA 138,A00,186119,Staff,14,0,40,26
1683305111125,LTEN 124,A00,186148,Staff,6,0,25,19
1683305112150,LTEN 178,A00,186149,Staff,7,0,15,8
1683305113175,LTEN 181,A00,186150,Blanco; John D,33,0,40,7
1683305114202,LTWL 120,A00,186160,Staff,20,0,25,5
1683305115229,LTWL 165,A00,186161,Staff,22,0,25,3
1683305116253,LTWR 100,A00,186162,Staff,0,4,15,15
1683305117277,LTWR 102,A00,186163,Doller; Ben,5,0,15,10
1683305118305,MAE 8,A01,186412,Staff,0,0,0,0
1683305119332,MAE 30B,A00,186445,Bahadori; Mohammad Yousef,83,0,100,17
1683305120360,MAE 40,A00,186592,Bewley; Thomas R,9,0,50,41
1683305121382,MAE 101B,A00,186593,Bahadori; Mohammad Yousef,81,0,100,19
1683305122409,MAE 105,A00,186594,Bandaru; Prabhakar,12,0,50,38
1683305123436,MAE 107,A00,186599,Pham; Hieu Tan,0,6,120,120
1683305124465,MAE 148,A01,186660,Silberman; Jack,3,0,16,13
1683305125489,MATH 10A,A01,188095,Staff,0,7,35,35
1683305126518,MATH 10B,A01,188097,Bowers; Adam R.,0,11,30,30
1683305126518,MATH 10B,A02,188099,Bowers; Adam R.,0,9,30,30
1683305126518,MATH 10B,B01,188104,Bowers; Adam R.,0,11,30,30
1683305126518,MATH 10B,B02,188106,Bowers; Adam R.,0,11,30,30
1683305127547,MATH 10C,A01,188111,Staff,0,18,30,30
1683305127547,MATH 10C,A02,188127,Staff,0,17,30,30
1683305127547,MATH 10C,A03,188131,Staff,0,17,30,30
1683305127547,MATH 10C,B01,188218,Staff,21,0,30,9
1683305127547,MATH 10C,B02,188244,Staff,13,0,30,17
1683305127547,MATH 10C,B03,188277,Staff,16,0,30,14
1683305128571,MATH 18,A01,188344,Bach; Quang Tran,18,0,30,12
1683305128571,MATH 18,A02,188345,Bach; Quang Tran,11,0,30,19
1683305128571,MATH 18,B01,188353,Bach; Quang Tran,10,0,30,20
1683305128571,MATH 18,B02,188354,Bach; Quang Tran,20,0,30,10
1683305129599,MATH 20A,A01,188374,Staff,13,0,35,22
1683305130628,MATH 20B,A01,188382,Ohm; Ko Woon,6,0,30,24
1683305130628,MATH 20B,A02,188383,Ohm; Ko Woon,24,0,30,6
1683305130628,MATH 20B,B01,188385,Ohm; Ko Woon,7,0,30,23
1683305130628,MATH 20B,B02,188392,Ohm; Ko Woon,22,0,30,8
1683305131655,MATH 20C,A01,188394,Harel; Guershon,10,0,30,20
1683305131655,MATH 20C,A02,188395,Harel; Guershon,13,0,30,17
1683305131655,MATH 20C,B01,188404,Harel; Guershon,3,0,30,27
1683305131655,MATH 20C,B02,188405,Harel; Guershon,19,0,30,11
1683305132679,MATH 20D,A01,188414,Hammock; Frances H,0,1,30,30
1683305132679,MATH 20D,A02,188415,Hammock; Frances H,4,0,30,26
1683305132679,MATH 20D,B01,188447,Hammock; Frances H,2,0,30,28
1683305132679,MATH 20D,B02,188486,Hammock; Frances H,8,0,30,22
1683305133707,MATH 20E,A01,188649,Staff,22,0,30,8
1683305133707,MATH 20E,A02,188650,Staff,23,0,30,7
1683305133707,MATH 20E,A03,188673,Staff,0,0,30,30
1683305134734,MATH 102,A01,188675,Staff,0,35,35,35
1683305135759,MATH 103B,A01,188681,Staff,4,0,35,31
1683305135759,MATH 103B,B01,188692,Staff,7,0,35,28
1683305136783,MATH 109,A01,188695,Salehi Golsefidy; Alireza,25,0,35,10
1683305136783,MATH 109,A02,188696,Salehi Golsefidy; Alireza,27,0,35,8
1683305137807,MATH 120A,A01,188698,Eggers; John Dietrich,6,0,35,29
1683305138833,MATH 142B,A01,188736,Ioana; Adrian,0,2,30,30
1683305138833,MATH 142B,A02,188741,Ioana; Adrian,0,1,30,30
1683305138833,MATH 142B,A03,188743,Ioana; Adrian,0,3,30,30
1683305139861,MATH 168A,A01,188790,Staff,0,9,35,35
1683305140886,MATH 170A,A01,188803,Nie; Jiawang,0,2,35,35
1683305140886,MATH 170A,A02,188811,Nie; Jiawang,0,0,35,35
1683305140886,MATH 170A,A03,188814,Nie; Jiawang,1,0,35,34
1683305140886,MATH 170A,A04,188815,Nie; Jiawang,13,0,35,22
1683305141912,MATH 193B,A01,188817,Staff,0,0,35,35
1683305141912,MATH 193B,A02,188818,Staff,5,0,35,30
1683305142936,MGT 4,A01,202857,Anderson; John Charles,62,0,80,18
1683305143963,MGT 12,A00,202858,Lindenberger; Wade Douglas,43,0,90,47
1683305144987,MGT 18,A00,202859,Staff,74,0,90,16
1683305146009,MGT 18GS,A00,202860,McKay; Michael J,13,0,28,15
1683305147037,MGT 45,A00,202861,Pecore; Joseph P.,14,0,90,76
1683305148061,MGT 100,A00,202863,Yavorsky; Daniel Ryan,28,0,90,62
1683305149085,MGT 103,A00,202864,Ehrich; Kristine R,0,16,90,90
1683305150109,MGT 112,A00,202865,Ehrich; Kristine R,15,0,90,75
1683305151132,MGT 121A,A00,202868,Staff,0,19,0,0
1683305152157,MGT 131B,A00,202869,Anderson; John Charles,59,0,90,31
1683305153199,MGT 136,A00,202871,Lindenberger; Wade Douglas,84,0,90,6
1683305154225,MGT 164,A00,202873,Staff,0,69,90,90
1683305155251,MGT 164GS,A00,202874,McKay; Mary A,13,0,28,15
1683305156276,MGT 180,A00,202875,Staff,0,51,90,90
1683305157300,MMW 11R,A01,205019,Herbst; Matthew,3,0,30,27
1683305157300,MMW 11R,A02,205026,Herbst; Matthew,29,0,30,1
1683305158323,MMW 15,A01,193512,Chang; Edmond Yi-Teh,0,9,28,28
1683305158323,MMW 15,A02,193513,Chang; Edmond Yi-Teh,0,5,28,28
1683305158323,MMW 15,A03,193514,Chang; Edmond Yi-Teh,0,5,28,28
1683305158323,MMW 15,A04,193515,Chang; Edmond Yi-Teh,0,4,28,28
1683305158323,MMW 15,A05,193516,Chang; Edmond Yi-Teh,0,4,28,28
1683305158323,MMW 15,A06,193517,Chang; Edmond Yi-Teh,0,5,28,28
1683305158323,MMW 15,B01,193519,Chang; Edmond Yi-Teh,0,4,28,28
1683305158323,MMW 15,B02,193520,Chang; Edmond Yi-Teh,0,5,28,28
1683305158323,MMW 15,B03,193521,Chang; Edmond Yi-Teh,0,4,28,28
1683305158323,MMW 15,B04,193522,Chang; Edmond Yi-Teh,0,4,28,28
1683305158323,MMW 15,B05,193523,Chang; Edmond Yi-Teh,0,5,28,28
1683305158323,MMW 15,B06,193524,Chang; Edmond Yi-Teh,0,4,28,28
1683305159351,MMW 122,A01,193526,Rahimi; Babak,0,14,28,28
1683305159351,MMW 122,A02,193527,Rahimi; Babak,0,14,28,28
1683305159351,MMW 122,A03,193528,Rahimi; Babak,0,0,0,0
1683305159351,MMW 122,A04,193529,Rahimi; Babak,0,0,0,0
1683305160377,MUS 1A,A01,186663,Staff,0,20,35,35
1683305161401,MUS 4,A01,186715,Staff,0,12,35,35
1683305162426,MUS 5R,A01,186796,Dubnov; Shlomo,0,17,35,35
1683305163451,MUS 6,A01,186798,Staff,0,3,25,25
1683305164477,MUS 7,A01,186830,Staff,12,0,35,23
1683305165505,MUS 8,A01,186930,Staff,0,26,35,35
1683305166534,MUS 15,A01,186932,Staff,0,15,35,35
1683305166534,MUS 15,B01,186934,Staff,0,15,35,35
1683305167564,MUS 80,A00,186935,Staff,2,0,20,18
1683305167564,MUS 80,B00,186936,Staff,25,0,25,0
1683305168661,NANO 11,A00,204702,Lipomi; Darren John,0,0,0,0
1683305169689,NANO 15,A01,204709,Yang; Kesong,0,1,0,0
1683305170714,NANO 114,A00,202069,Jahed Motlagh; Zeinab,3,0,10,7
1683305171739,PHIL 1,A00,186955,Grush; Rick Scott,32,0,40,8
1683305172767,PHIL 10,A01,186973,Grush; Rick Scott,28,0,35,7
1683305172767,PHIL 10,A02,186974,Grush; Rick Scott,33,0,35,2
1683305173794,PHIL 13,A01,186976,Staff,7,0,35,28
1683305173794,PHIL 13,A02,186977,Staff,16,0,35,19
1683305174824,PHIL 14,A01,186979,Staff,31,0,35,4
1683305174824,PHIL 14,A02,186986,Staff,32,0,35,3
1683305175853,PHIL 28,A01,186988,Staff,16,0,30,14
1683305175853,PHIL 28,A02,186989,Staff,1,0,30,29
1683305175853,PHIL 28,A03,186990,Staff,9,0,30,21
1683305175853,PHIL 28,A04,186991,Staff,26,0,30,4
1683305176876,PHIL 120,A00,186997,Staff,23,0,40,17
1683305177902,PHIL 137,A00,187003,Staff,9,0,40,31
1683305178929,PHIL 150,A00,187015,Staff,47,0,70,23
1683305179955,PHIL 167,A00,187021,Lamey; Andy M.,35,0,40,5
1683305180983,PHIL 174,A01,202226,Staff,17,0,20,3
1683305180983,PHIL 174,A02,202235,Staff,20,0,20,0
1683305182010,PHIL 191A,A00,258918,Staff,0,0,1,1
1683305183036,PHYS 1A,A00,187028,Staff,26,0,60,34
1683305184066,PHYS 1AL,001,187036,Staff,2,0,30,28
1683305184066,PHYS 1AL,002,187049,Staff,18,0,30,12
1683305185091,PHYS 1B,A00,187058,Staff,23,0,60,37
1683305186116,PHYS 1BL,001,187064,Staff,0,0,30,30
1683305186116,PHYS 1BL,002,187070,Staff,6,0,30,24
1683305187140,PHYS 1C,A00,187082,Staff,31,0,120,89
1683305188163,PHYS 1CL,001,187088,Staff,0,9,30,30
1683305188163,PHYS 1CL,002,187089,Staff,0,2,30,30
1683305188163,PHYS 1CL,009,262693,Staff,11,0,30,19
1683305189187,PHYS 2B,A01,187097,Staff,54,0,115,61
1683305190212,PHYS 2C,A01,187099,Staff,67,0,115,48
1683305191237,PHYS 2CL,A01,187101,Staff,5,0,28,23
1683305191237,PHYS 2CL,A02,187102,Staff,15,0,28,13
1683305192264,PHYS 2D,A01,187123,Shotwell; Brian,95,0,115,20
1683305193288,PHYS 4B,A01,187133,Grinstein; Benjamin,35,0,50,15
1683305194311,POLI 10,A00,188819,Staff,0,3,50,50
1683305195338,POLI 11,A00,188827,Staff,43,0,50,7
1683305196362,POLI 13R,A00,188828,Staff,0,1,20,20
1683305197384,POLI 27,A01,188830,Elgin; Samuel Zincke,0,1,70,70
1683305198408,POLI 30,A00,188832,Desposato; Scott,33,0,50,17
1683305199432,POLI 102F,A00,188834,Staff,3,0,40,37
1683305200459,POLI 104A,A00,188852,Staff,14,0,30,16
1683305201483,POLI 104I,A00,188853,Staff,0,6,20,20
1683305202507,POLI 110B,A00,188854,Wiens; David,7,0,20,13
1683305203533,POLI 112A,A00,188855,Wiens; David,5,0,30,25
1683305204557,POLI 117R,A00,188856,Forman; Fonna,0,11,20,20
1683305205583,POLI 118,A00,188857,Ingham; Sean,8,0,20,12
1683305206607,POLI 120G,A00,188858,Staff,9,0,30,21
1683305207631,POLI 131CR,A00,188863,Hoston; Germaine,24,0,50,26
1683305208657,POLI 133,A00,188864,Nellis; Gareth Hb,44,0,50,6
1683305209682,POLI 134D,A00,188865,Desposato; Scott,27,0,30,3
1683305210707,POLI 142A,A00,188871,Gartzke; Erik,22,0,50,28
1683305211733,POLI 142K,A00,188874,Staff,38,0,50,12
1683305212761,POLI 143,A00,188940,Gartzke; Erik,16,0,30,14
1683305213788,POLI 153,A00,188943,Staff,3,0,20,17
1683305214814,POLI 160AA,A00,188944,Staff,13,0,40,27
1683305215838,POLI 170A,A00,188945,Staff,11,0,30,19
1683305217889,PSYC 1,A00,188952,Staff,38,0,90,52
1683305218913,PSYC 2,B00,188953,Staff,20,0,35,15
1683305219940,PSYC 6,A00,188970,Staff,47,0,60,13
1683305220964,PSYC 7,A00,188973,Staff,37,0,45,8
1683305221994,PSYC 60,A01,188980,Rickard; Timothy C.,43,0,60,17
1683305223022,PSYC 70,A01,189001,Steiner; Eric Tomas,24,0,45,21
1683305224050,PSYC 100,A00,189005,Lacefield; Katharine I,0,99,120,120
1683305225073,PSYC 102,A00,189008,Staff,10,0,30,20
1683305226101,PSYC 106,B00,189026,Gorman; Michael R.,37,0,60,23
1683305227128,PSYC 114,B01,189033,Winkielman; Piotr,0,32,30,30
1683305228155,PSYC 131,A00,189036,Anagnostaras; Stephan,0,43,60,60
1683305229183,PSYC 136,A00,189041,Lowe; Angela Beth,0,7,25,25
1683305230206,PSYC 137,A00,189057,Winkielman; Piotr,0,34,25,25
1683305231230,PSYC 144,A00,189107,Wixted; John T,0,7,50,50
1683305233281,PSYC 162,A00,189142,Staff,0,8,85,85
1683305234305,PSYC 172,A00,189144,Gorman; Michael R.,0,7,30,30
1683305236356,PSYC 179,A00,189146,Lacefield; Katharine I,0,84,120,120
1683305237380,PSYC 181,A00,189147,Anagnostaras; Stephan,0,44,90,90
1683305238405,PSYC 190R,A00,189148,Barner; David A.,0,22,80,80
1683305239428,PSYC 191,A00,189275,Rickard; Timothy C.,0,7,25,25
1683305240453,PSYC 193,A00,189276,Chapman; Eddie Nathaniel,0,1,0,4
1683305241481,PSYC 193L,A01,189281,Lowe; Angela Beth,12,0,20,8
1683305241481,PSYC 193L,B01,189285,Staff,28,0,35,7
1683305242506,RELI 149,A00,187137,Rahimi; Babak,7,0,40,33
1683305243533,SE 9,A01,187315,Staff,0,2,18,18
1683305244555,SE 101B,A00,187409,Staff,24,0,30,6
1683305245582,SE 110B,A00,187444,Staff,10,0,40,30
1683305246607,SE 130B,A00,187449,Staff,31,0,40,9
1683305247632,SE 150A,A00,187516,Staff,9,0,20,11
1683305248656,SE 154,A00,187528,Staff,30,0,50,20
1683305249681,SIO 3,A01,258171,Staff,35,0,40,5
1683305250704,SIO 10,A00,187144,Cook; Geoffrey W,0,3,75,75
1683305251728,SIO 45,A00,187152,Cook; Geoffrey W,1,0,100,99
1683305252752,SIO 109R,A00,194486,Staff,0,3,20,20
1683305254805,SIO 187,A01,187233,Kacev; David,12,0,40,28
1683305255832,SOCI 1,A01,258656,Thorpe; Charles Robert,28,0,30,2
1683305255832,SOCI 1,A02,258658,Thorpe; Charles Robert,30,0,30,0
1683305255832,SOCI 1,A03,258661,Thorpe; Charles Robert,25,0,25,0
1683305255832,SOCI 1,A04,258666,Thorpe; Charles Robert,22,0,25,3
1683305255832,SOCI 1,A05,258897,Thorpe; Charles Robert,23,0,25,2
1683305255832,SOCI 1,A06,258898,Thorpe; Charles Robert,25,0,25,0
1683305256855,SOCI 30,A01,258903,Pardo Guerra; Juan Pablo,16,0,30,14
1683305257881,SOCI 102,A00,258904,Staff,9,0,25,16
1683305258905,SOCI 106,A00,258905,Staff,19,0,25,6
1683305259929,SOCI 111,A00,258907,Ribas Norris; Janet Vanesa,26,0,30,4
1683305260953,SOCI 121R,A00,258908,Pardo Guerra; Juan Pablo,11,0,30,19
1683305261976,SOCI 126,A01,203330,Staff,14,0,20,6
1683305262999,SOCI 131,A00,258909,Thorpe; Charles Robert,31,0,60,29
1683305264022,SOCI 135,A00,258910,Payne; Christine Anna,0,9,30,30
1683305265046,SOCI 157,A00,258911,Staff,13,0,30,17
1683305266069,SOCI 184,A00,258912,Staff,26,0,30,4
1683305267093,SOCI 188D,A00,258913,Staff,21,0,30,9
1683305268117,SYN 2,001,187529,Staff,9,0,16,7
1683305268117,SYN 2,002,201452,Staff,0,18,16,16
1683305268117,SYN 2,003,201469,Staff,3,0,16,13
1683305269142,SYN 100,A01,187531,Staff,0,9,20,20
1683305269142,SYN 100,B01,201491,Staff,0,12,20,20
1683305270165,TDAC 1,A00,189286,Walsh; Kim C.,3,0,20,17
1683305270165,TDAC 1,B00,189287,Harting; Carla Kelso,11,0,20,9
1683305271190,TDAC 101,A00,189300,Walsh; Kim C.,16,0,20,4
1683305271190,TDAC 101,B00,189301,Harting; Carla Kelso,18,0,20,2
1683305272289,TDAC 102,A00,189304,Basso; Beatrice,14,0,20,6
1683305273313,TDAC 108,A00,189305,Staff,18,0,20,2
1683305274340,TDDE 131,A00,189310,Staff,19,0,20,1
1683305274340,TDDE 131,B00,189314,Staff,19,0,20,1
1683305274340,TDDE 131,C00,189315,Staff,48,0,50,2
1683305274340,TDDE 131,D00,189316,Staff,14,0,15,1
1683305274340,TDDE 131,E00,204841,Staff,20,0,20,0
1683305275364,TDGE 10,A00,189289,Staff,30,0,50,20
1683305275364,TDGE 10,B00,189290,Havis; Allan,2,0,50,48
1683305276388,TDGE 11,A00,189291,Fulton; Julia,0,3,50,50
1683305276388,TDGE 11,B00,189292,Staff,20,0,25,5
1683305276388,TDGE 11,C00,260270,Staff,0,0,0,0
1683305277415,TDGE 25,A00,189294,Staff,3,0,20,17
1683305278442,TDGE 124,A00,189318,Fulton; Julia,0,8,50,50
1683305279464,TDGE 125,A00,189319,Staff,13,0,25,12
1683305279464,TDGE 125,B00,189320,Staff,23,0,25,2
1683305280491,TDGE 127,A00,189322,Havis; Allan,0,0,50,50
1683305281517,TDHT 101,A00,189323,Staff,18,0,25,7
1683305281517,TDHT 101,B00,189324,Staff,25,0,25,0
1683305282542,TDHT 102,A00,189325,Staff,49,0,50,1
1683305283569,TDMV 1,A00,189295,Arcidiacono; Kristin,20,0,30,10
1683305283569,TDMV 1,B00,189296,Caligagan; Maria T.,24,0,30,6
1683305284599,TDMV 2,A00,189297,Sammartano; Tonnie,28,0,30,2
1683305284599,TDMV 2,B00,189299,Arcidiacono; Kristin,24,0,30,6
1683305285623,TDMV 3,A00,204998,Rincon; Alicia,22,0,30,8
1683305286651,TDMV 120,A00,189458,Sammartano; Tonnie,28,0,30,2
1683305287678,TDMV 138,A00,189541,Jun; Grace Shin Hae,22,0,40,18
1683305288702,TDMV 142,A00,189717,Caligagan; Tony,23,0,30,7
1683305288702,TDMV 142,B00,189718,Caligagan; Maria T.,25,0,30,5
1683305289730,TMC 2,A01,187533,Staff,25,0,25,0
1683305289730,TMC 2,A02,187534,Staff,25,0,25,0
1683305290758,USP 1,A01,187536,Kwak; Nancy,0,16,25,25
1683305291785,USP 5,A01,187538,Staff,9,0,25,16
1683305292811,USP 101,A00,199253,Staff,0,4,0,0
1683305293840,USP 124,A00,187562,Boomhower; Matthew Charles,1,0,30,29
1683305294867,USP 138,A00,187582,Staff,20,0,25,5
1683305295893,USP 152,A01,187597,Staff,4,0,25,21
1683305296920,USP 153,A00,187598,Staff,19,0,25,6
1683305297945,USP 168,A00,187607,Kwak; Nancy,2,0,5,3
1683305298970,USP 173,A00,187619,Staff,4,0,25,21
1683305299997,USP 181,A00,187638,Staff,0,0,25,25
1683305301023,VIS 103,A00,187650,Cruz; Edwin Teddy,23,0,75,52
1683305302050,VIS 110D,A00,187669,Staff,12,0,22,10
1683305303077,VIS 127C,A00,187720,Shen; Kuiyi,68,0,146,78
1683305304102,VIS 149,A00,187731,Yoldas; Pinar,0,14,22,22
1683305305126,VIS 151,A01,188091,Staff,22,0,34,12
1683305305126,VIS 151,A02,188092,Staff,11,0,34,23
1683305306153,VIS 160B,A00,188093,Stalbaum; Brett,0,0,10,10
1683305308202,WCWP 10B,A00,201720,Staff,10,0,15,5
1683305308202,WCWP 10B,B00,201722,Staff,8,0,15,7
1683305309229,WCWP 100,A00,201725,Gagnon; Jeffrey C,0,0,2,2
1683305309229,WCWP 100,B00,201727,Staff,0,4,15,15
1683305312319,ANBI 133,A00,258401,Wilder; Linnea Lorene,34,0,40,6
1683305313347,ANBI 140,A00,258395,Hrvoj Mihic; Branka,18,0,25,7
1683305314372,ANSC 120,A00,258402,Bialecki; Jon Anthony,27,0,40,13
1683305315395,ANSC 144,A00,258400,Staff,14,0,40,26
1683305317448,ANSC 166,A00,258396,Parish; Steven Martin,157,0,175,18
1683305318472,ANSC 180,A00,193533,Staff,9,0,20,11
1683305319500,ANSC 188,A00,258397,Jassal; Aftab,33,0,40,7
1683305320527,ANTH 3,A01,258316,Staff,23,0,30,7
1683305321555,ANTH 5,A00,258394,Semendeferi; Ekaterini,16,0,20,4
1683305322582,ANTH 21,A01,258331,Staff,9,0,40,31
1683305323607,ANTH 103,A00,258398,Varma; Saiba,15,0,25,10
1683305324634,AWP 10,001,202034,Staff,0,0,0,0
1683305324634,AWP 10,002,202035,Staff,0,0,0,0
1683305324634,AWP 10,003,202036,Staff,0,0,0,0
1683305324634,AWP 10,004,202037,Staff,0,0,0,0
1683305324634,AWP 10,005,202038,Staff,0,0,0,0
1683305324634,AWP 10,006,202039,Staff,0,0,0,0
1683305324634,AWP 10,007,202040,Staff,0,0,0,0
1683305324634,AWP 10,008,202041,Staff,0,0,0,0
1683305324634,AWP 10,009,202042,Staff,0,0,0,0
1683305324634,AWP 10,010,202043,Staff,0,0,0,0
1683305324634,AWP 10,011,202044,Staff,0,0,0,0
1683305324634,AWP 10,012,202045,Staff,0,0,0,0
1683305324634,AWP 10,013,202046,Staff,0,0,0,0
1683305324634,AWP 10,014,202047,Staff,0,0,0,0
1683305324634,AWP 10,015,202048,Staff,0,0,0,0
1683305324634,AWP 10,016,202049,Staff,0,0,0,0
1683305324634,AWP 10,017,202050,Staff,0,0,0,0
1683305324634,AWP 10,018,202051,Staff,0,0,0,0
1683305324634,AWP 10,019,202052,Staff,0,0,0,0
1683305324634,AWP 10,020,202053,Staff,0,0,0,0
1683305324634,AWP 10,021,202054,Staff,0,0,0,0
1683305324634,AWP 10,022,202055,Staff,0,0,0,0
1683305324634,AWP 10,023,202056,Staff,0,0,0,0
1683305324634,AWP 10,024,202057,Staff,0,0,0,0
1683305324634,AWP 10,025,202058,Staff,0,0,0,0
1683305324634,AWP 10,026,202059,Staff,0,0,0,0
1683305325658,AWP 102,001,202032,Staff,0,0,0,0
1683305325658,AWP 102,002,202033,Staff,0,0,0,0
1683305326683,BENG 100,A01,254234,Taylor Amos; Alyssa C,31,0,40,9
1683305327710,BENG 196,001,270013,Engler; Adam J.,9999,0,9999,0
1683305328735,BICD 100R,A01,202018,Smith; Laurie,0,7,32,32
1683305328735,BICD 100R,A02,202019,Smith; Laurie,0,2,32,32
1683305328735,BICD 100R,A03,202020,Smith; Laurie,0,1,32,32
1683305328735,BICD 100R,A04,202021,Smith; Laurie,8,0,32,24
1683305328735,BICD 100R,A05,202022,Smith; Laurie,12,0,32,20
1683305329759,BICD 136,A01,193242,Gustafson-Brown; Cindy,0,2,32,32
1683305329759,BICD 136,A02,193244,Gustafson-Brown; Cindy,15,0,32,17
1683305330849,BIEB 102,A01,193249,Butler; Shannon Rhey,0,2,32,32
1683305330849,BIEB 102,A02,193251,Butler; Shannon Rhey,0,0,32,32
1683305330849,BIEB 102,A03,193253,Butler; Shannon Rhey,0,1,32,32
1683305330849,BIEB 102,A04,193255,Butler; Shannon Rhey,17,0,32,15
1683305330849,BIEB 102,A05,193265,Butler; Shannon Rhey,26,0,32,6
1683305330849,BIEB 102,A06,193269,Butler; Shannon Rhey,16,0,32,16
1683305332904,BIEB 150,A01,193274,Staff,0,0,32,32
1683305332904,BIEB 150,A02,193285,Staff,24,0,32,8
1683305333928,BIEB 194,A00,193286,Kurle; Carolyn M.,22,0,32,10
1683305334952,BILD 1,A01,192291,Staff,16,0,32,16
1683305334952,BILD 1,A02,192292,Staff,30,0,32,2
1683305334952,BILD 1,B01,192520,Reuther; Keefe,0,1,0,0
1683305334952,BILD 1,B02,192532,Reuther; Keefe,0,1,0,0
1683305335977,BILD 3,A01,192556,Butler; Shannon Rhey,0,0,32,32
1683305335977,BILD 3,A02,192581,Butler; Shannon Rhey,5,0,32,27
1683305335977,BILD 3,A03,192611,Butler; Shannon Rhey,23,0,32,9
1683305335977,BILD 3,A04,192612,Butler; Shannon Rhey,25,0,32,7
1683305335977,BILD 3,A05,192613,Butler; Shannon Rhey,27,0,32,5
1683305335977,BILD 3,A06,192679,Butler; Shannon Rhey,27,0,32,5
1683305335977,BILD 3,A07,192682,Butler; Shannon Rhey,22,0,32,10
1683305337008,BILD 4,A01,192836,Reuther; Keefe,1,0,24,23
1683305337008,BILD 4,A02,193044,Reuther; Keefe,4,0,24,20
1683305338032,BILD 10,A01,193142,Gustafson-Brown; Cindy,31,0,32,1
1683305338032,BILD 10,A02,193149,Gustafson-Brown; Cindy,31,0,32,1
1683305339059,BIMM 100,A01,193301,Staff,0,6,32,32
1683305339059,BIMM 100,A02,193312,Staff,0,5,32,32
1683305339059,BIMM 100,A03,193323,Staff,0,8,32,32
1683305340085,BIMM 101,A01,193329,McDonnell; Lisa Marie,0,3,24,24
1683305340085,BIMM 101,A02,193339,McDonnell; Lisa Marie,0,2,24,24
1683305340085,BIMM 101,B01,193354,McDonnell; Lisa Marie,0,3,24,24
1683305340085,BIMM 101,B02,193357,McDonnell; Lisa Marie,0,3,24,24
1683305341124,BIMM 110,A01,193377,Tat; John,0,11,32,32
1683305341124,BIMM 110,A02,193378,Tat; John,1,9,32,31
1683305342156,BIMM 120,A01,206116,Staff,0,0,32,32
1683305342156,BIMM 120,A02,206117,Staff,8,0,32,24
1683305342156,BIMM 120,A03,206121,Staff,21,0,32,11
1683305343181,BIPN 100,A01,193393,Park; Ji Young,0,14,32,32
1683305343181,BIPN 100,A02,193402,Park; Ji Young,0,12,32,32
1683305343181,BIPN 100,A03,193413,Park; Ji Young,0,14,32,32
1683305343181,BIPN 100,A04,193414,Park; Ji Young,0,13,32,32
1683305344207,BIPN 102,A01,193429,Staff,0,0,32,32
1683305344207,BIPN 102,A02,193438,Staff,23,0,32,9
1683305345235,BIPN 106,A01,193450,Reyes Gonzalez; Catalina,0,2,40,40
1683305346260,BIPN 134,A01,193465,Cooke; James Edward,0,0,32,32
1683305346260,BIPN 134,A02,193474,Cooke; James Edward,27,0,32,5
1683305346260,BIPN 134,A03,193485,Cooke; James Edward,29,0,32,3
1683305346260,BIPN 134,A04,193486,Cooke; James Edward,21,0,32,11
1683305346260,BIPN 134,A05,193491,Cooke; James Edward,31,0,32,1
1683305346260,BIPN 134,A06,193501,Cooke; James Edward,30,0,32,2
1683305346260,BIPN 134,A07,193510,Cooke; James Edward,29,0,32,3
1683305348313,BISP 194,A00,222522,Staff,16,0,32,16
1683305349343,CAT 124,A01,202407,Staff,20,0,25,5
1683305350367,CAT 125,A00,202408,Marchisotto; Jennifer Anne,4,0,20,16
1683305351392,CAT 125R,A00,202409,Smith; Lauryn Alissa,0,11,20,20
1683305351392,CAT 125R,B00,202410,Morales; Celeste Georgianna,0,11,20,20
1683305351392,CAT 125R,C00,202411,Irwin; Matthew Joseph,0,10,20,20
1683305352419,CENG 15,A01,204712,Yang; Kesong,0,1,0,0
1683305353441,CENG 114,A00,202070,Jahed Motlagh; Zeinab,5,0,20,15
1683305354466,CGS 105,A00,185477,Wesling; Megan E.,24,0,40,16
1683305355493,CGS 106,A00,185494,Staff,13,0,22,9
1683305356517,CGS 108,A00,185495,Staff,14,0,20,6
1683305357543,CGS 114,A00,185496,Staff,13,0,18,5
1683305358569,CGS 119,A00,185501,Staff,15,0,20,5
1683305359593,CGS 120,A00,185511,Staff,13,0,20,7
1683305360618,CHEM 4,A01,184675,Bussey; Thomas J,96,0,100,4
1683305361643,CHEM 6A,A01,184677,Staff,35,0,60,25
1683305362668,CHEM 6B,A01,184679,Staff,65,0,100,35
1683305363693,CHEM 6C,A01,184681,Bussey; Thomas J,1,0,50,49
1683305363693,CHEM 6C,A02,184682,Bussey; Thomas J,34,0,50,16
1683305364721,CHEM 40A,A01,184684,Albizati; Kim F.,37,0,100,63
1683305365749,CHEM 40B,A01,184686,Albizati; Kim F.,0,20,100,100
1683305366776,CHEM 41B,A01,184690,Staff,52,0,100,48
1683305367804,COGS 3,A01,184715,Boyle; Mary E. T.,0,25,40,40
1683305368831,COGS 14B,A01,185172,Staff,0,15,38,38
1683305369857,COGS 18,A01,184736,Staff,20,0,80,60
1683305370881,COGS 100,A01,184932,Staff,0,5,73,73
1683305371905,COGS 101A,A01,184935,Staff,0,38,30,30
1683305372931,COGS 101B,A01,184944,Staff,0,2,30,30
1683305373954,COGS 101C,A01,184946,Staff,0,12,30,30
1683305374979,COGS 102A,A01,184951,Johnson; Christine M.,2,0,40,38
1683305376058,COGS 107B,A01,184953,Mooshagian; Eric Frederick,0,50,40,40
1683305377086,COGS 118B,A01,184959,Gupta; Anjum,0,48,40,40
1683305378110,COGS 153,A00,184961,Staff,0,15,30,30
1683305379135,COGS 177,A00,184962,Staff,0,21,30,30
1683305380158,COGS 187A,A01,184969,Boyle; Mary E. T.,0,17,40,40
1683305381183,COMM 10,A01,185174,Staff,0,5,25,25
1683305381183,COMM 10,A02,185189,Staff,0,5,25,25
1683305381183,COMM 10,A03,269821,Staff,0,0,0,0
1683305382207,COMM 100B,A01,185475,Staff,0,0,0,2
1683305382207,COMM 100B,A02,185476,Staff,14,0,25,11
1683305383230,COMM 100C,A01,185314,Staff,1,0,25,24
1683305383230,COMM 100C,A02,185327,Staff,19,0,25,6
1683305384258,COMM 110M,A00,185349,Staff,2,0,40,38
1683305385282,COMM 113T,A00,185352,Staff,25,0,40,15
1683305386304,COMM 114I,A00,185353,Staff,33,0,40,7
1683305387328,COMM 131,A00,185354,Staff,19,0,30,11
1683305388357,CSE 8A,A50,185358,Cao; Yingjun,0,46,10,10
1683305389383,CSE 8B,A01,185362,Staff,1,47,50,49
1683305390408,CSE 11,A01,185416,Cao; Yingjun,0,93,10,10
1683305391433,CSE 20,A01,185445,Briones; Jor-el Thomas Caparas,5,0,25,20
1683305392457,CSE 21,A01,185447,Staff,10,0,50,40
1683305393482,CSE 101,A01,185451,Staff,0,12,50,50
1683305393482,CSE 101,B01,185453,Jones; Miles E,0,11,50,50
1683305395530,CSE 141,A01,185458,Eldon; John,20,0,100,80
1683305396554,CSE 141L,A01,185461,Eldon; John,12,0,100,88
1683305397578,CSE 142,A01,185463,Staff,35,0,60,25
1683305397578,CSE 142,B01,201355,Staff,0,6,60,60
1683305398602,CSE 142L,A01,185470,Staff,35,0,60,25
1683305398602,CSE 142L,B01,201417,Staff,0,5,60,60
1683305399625,CSE 190,A00,201433,Staff,32,0,49,17
1683305400653,DOC 1,A01,259136,Strom; Megan C.,8,0,15,7
1683305400653,DOC 1,A02,259137,Strom; Megan C.,14,0,15,1
1683305400653,DOC 1,A03,259138,Strom; Megan C.,14,0,15,1
1683305400653,DOC 1,A04,259139,Strom; Megan C.,14,0,15,1
1683305401680,DOC 100D,A00,259140,Pass; Natalye Joann,17,0,25,8
1683305402703,DSGN 1,A01,184749,Rill; Bryan,0,24,30,30
1683305403731,DSGN 100,A01,185168,Staff,0,2,25,25
1683305404755,ECE 5,A01,185626,Morris; Karcher William,0,10,0,0
1683305405778,ECE 101,A01,185628,Staff,17,0,70,53
1683305406801,ECE 107,A01,185635,Baghdadchi; Saharnaz,0,0,20,20
1683305406801,ECE 107,A02,185638,Baghdadchi; Saharnaz,4,0,20,16
1683305407825,ECE 148,A01,185647,Silberman; Jack,0,0,16,16
1683305408852,ECON 1,A01,185537,Crane; Meredith Helen,54,0,70,16
1683305409875,ECON 3,A01,185549,Crane; Meredith Helen,33,0,70,37
1683305410908,ECON 4,A01,203354,Anderson; John Charles,0,4,10,10
1683305411931,ECON 100A,A01,185574,Staff,0,4,40,40
1683305412956,ECON 100B,A01,185576,Staff,0,22,40,40
1683305413979,ECON 100C,A01,185589,Newhouse; Herbert S,30,0,70,40
1683305415003,ECON 105,A00,185608,Vespa; Emanuel Ignacio,19,0,35,16
1683305416028,ECON 109,A01,185610,Shishkin; Denis,10,0,35,25
1683305417057,ECON 110A,A01,185612,Staff,11,0,40,29
1683305418084,ECON 120A,A01,185615,Staff,20,0,40,20
1683305419111,ECON 120C,A01,185617,Sun; Yixiao,0,20,70,70
1683305420134,ECON 144,A00,203346,Squires; Dale E,3,0,35,32
1683305421157,ECON 171,A01,203349,Newhouse; Herbert S,0,1,35,35
1683305422181,ECON 173A,A01,185621,Toda; Alexis Akira,21,0,35,14
1683305423212,EDS 25,A01,202413,Staff,0,1,0,0
1683305423212,EDS 25,A02,202414,Staff,0,1,0,0
1683305423212,EDS 25,A03,202415,Staff,0,0,0,0
1683305423212,EDS 25,A04,202416,Staff,0,1,0,0
1683305423212,EDS 25,A05,202439,Staff,0,0,0,0
1683305423212,EDS 25,A06,202440,Staff,0,0,0,0
1683305423212,EDS 25,B01,202631,Staff,0,0,0,0
1683305423212,EDS 25,B02,202632,Staff,0,0,0,0
1683305423212,EDS 25,B03,202639,Staff,0,0,0,0
1683305423212,EDS 25,B04,202640,Staff,0,0,0,0
1683305423212,EDS 25,B05,202643,Staff,0,0,0,0
1683305423212,EDS 25,B06,202644,Staff,0,0,0,0
1683305424240,EDS 38,A01,202659,Black; Alison Michelle,24,0,25,1
1683305425263,EDS 115,A00,202652,Staff,17,0,30,13
1683305426290,EDS 125,A00,202649,Staff,14,0,30,16
1683305427313,EDS 126,A01,203332,Staff,30,0,30,0
1683305428341,EDS 139,A00,202838,Staff,17,0,25,8
1683305429365,EDS 146,A01,202655,Staff,15,0,25,10
1683305430394,ENG 15,A00,185667,Staff,0,1,0,0
1683305430394,ENG 15,B00,185672,Staff,0,0,0,0
1683305430394,ENG 15,C00,185675,Staff,0,0,0,0
1683305430394,ENG 15,D00,185682,Staff,0,0,0,0
1683305430394,ENG 15,E00,185684,Staff,0,0,0,0
1683305431419,ETHN 103,A00,185710,Staff,0,3,35,35
1683305432445,ETHN 103A,A00,199228,Man; Simeon S,2,0,9,7
1683305433469,ETHN 109,A00,185711,Staff,18,0,35,17
1683305434492,ETHN 142,A00,185726,Staff,0,4,30,30
1683305435519,ETHN 163J,A00,199229,Man; Simeon S,6,0,8,2
1683305436544,ETHN 168,A00,185727,Staff,8,0,10,2
1683305437572,ETHN 182,A00,185728,Staff,1,0,35,34
1683305438595,ETHN 183,A00,185737,Staff,8,0,18,10
1683305439620,GLBH 111,A01,209361,Burgos; Jose L.,0,0,0,0
1683305441670,HIEU 104,A00,185792,Staff,16,0,20,4
1683305442694,HIEU 115,A00,185800,Staff,1,0,20,19
1683305443717,HIEU 128,A00,185801,Staff,0,7,20,20
1683305444741,HIEU 147,A00,185802,Staff,16,0,20,4
1683305445767,HIEU 154,A00,185823,Staff,12,0,20,8
1683305446791,HILA 102,A00,185826,Staff,13,0,20,7
1683305447818,HILD 2C,A01,185778,Staff,0,12,20,20
1683305448842,HILD 7B,A01,185780,Kwak; Nancy,0,15,32,32
1683305448842,HILD 7B,A02,185781,Kwak; Nancy,0,18,32,32
1683305449869,HILD 30,A01,185791,Staff,14,0,20,6
1683305450893,HISC 119,A00,185830,Golan; Tal,0,9,20,20
1683305451917,HITO 156GS,A00,185831,Patterson; Patrick H.,0,0,0,23
1683305452942,HIUS 103,A00,185832,Man; Simeon S,0,6,20,20
1683305453968,HIUS 117,A00,185836,Kwak; Nancy,2,0,20,18
1683305454991,HIUS 125,A00,185840,Man; Simeon S,0,0,23,23
1683305456016,HIUS 149,A00,185845,Staff,0,0,20,20
1683305457045,HUM 3,A01,185882,Zavodny; Tatiana Sophia,0,6,50,50
1683305457045,HUM 3,B01,185899,Caldwell; Michael Alan,0,19,50,50
1683305458069,HUM 3GS,A00,185900,Patterson; Patrick H.,0,0,0,23
1683305459093,HUM 4,A01,185938,Zroka; Amy Liane,30,0,50,20
1683305459093,HUM 4,B01,185956,Watkins; Eric,0,2,50,50
1683305459093,HUM 4,B02,202209,Watkins; Eric,0,1,50,50
1683305459093,HUM 4,B03,202210,Watkins; Eric,0,0,50,50
1683305460117,HUM 5,A01,185958,West; Geoffrey Scott,5,0,50,45
1683305460117,HUM 5,A02,202215,West; Geoffrey Scott,0,0,50,50
1683305461140,INTL 190,A00,185959,Gagnon; Jeffrey C,0,0,0,9
1683305461140,INTL 190,B00,185960,Lettieri; Michael Joseph,0,0,0,1
1683305462168,JAPN 180,A00,254509,Staff,5,1,30,25
1683305463191,LATI 10,A01,202853,Kennemore; Amy Michelle,5,0,35,30
1683305463191,LATI 10,A02,202854,Kennemore; Amy Michelle,1,0,35,34
1683305463191,LATI 10,A03,270054,Kennemore; Amy Michelle,30,0,30,0
1683305464214,LATI 180,A00,202855,Kennemore; Amy Michelle,11,0,20,9
1683305465237,LAWS 101,A00,201767,Golan; Tal,0,7,40,40
1683305466265,LIFR 1C,A00,185961,Staff,6,0,20,14
1683305467291,LIFR 1CX,A00,185962,Staff,7,0,20,13
1683305468316,LIFR 1D,A00,185963,Staff,9,0,20,11
1683305469340,LIFR 1DX,A00,185964,Staff,9,0,20,11
1683305470363,LIGN 101,A01,186039,Staff,43,0,50,7
1683305471386,LIGN 165,A00,186040,Staff,18,0,50,32
1683305472410,LTCS 108,A00,186041,Staff,6,0,10,4
1683305473437,LTCS 119,A00,186042,Staff,16,0,20,4
1683305474462,LTCS 130,A00,186043,Wesling; Megan E.,15,0,25,10
1683305476510,LTEA 138,A00,186119,Staff,14,0,40,26
1683305477536,LTEN 124,A00,186148,Staff,6,0,25,19
1683305478561,LTEN 178,A00,186149,Staff,7,0,15,8
1683305479644,LTEN 181,A00,186150,Blanco; John D,33,0,40,7
1683305480675,LTWL 120,A00,186160,Staff,20,0,25,5
1683305481699,LTWL 165,A00,186161,Staff,22,0,25,3
1683305482726,LTWR 100,A00,186162,Staff,0,4,15,15
1683305483748,LTWR 102,A00,186163,Doller; Ben,5,0,15,10
1683305484775,MAE 8,A01,186412,Staff,0,0,0,0
1683305485802,MAE 30B,A00,186445,Bahadori; Mohammad Yousef,83,0,100,17
1683305486826,MAE 40,A00,186592,Bewley; Thomas R,9,0,50,41
1683305487849,MAE 101B,A00,186593,Bahadori; Mohammad Yousef,81,0,100,19
1683305488873,MAE 105,A00,186594,Bandaru; Prabhakar,12,0,50,38
1683305489906,MAE 107,A00,186599,Pham; Hieu Tan,0,6,120,120
1683305490932,MAE 148,A01,186660,Silberman; Jack,3,0,16,13
1683305491955,MATH 10A,A01,188095,Staff,0,7,35,35
1683305492980,MATH 10B,A01,188097,Bowers; Adam R.,0,11,30,30
1683305492980,MATH 10B,A02,188099,Bowers; Adam R.,0,9,30,30
1683305492980,MATH 10B,B01,188104,Bowers; Adam R.,0,11,30,30
1683305492980,MATH 10B,B02,188106,Bowers; Adam R.,0,11,30,30
1683305494005,MATH 10C,A01,188111,Staff,0,18,30,30
1683305494005,MATH 10C,A02,188127,Staff,0,17,30,30
1683305494005,MATH 10C,A03,188131,Staff,0,17,30,30
1683305494005,MATH 10C,B01,188218,Staff,21,0,30,9
1683305494005,MATH 10C,B02,188244,Staff,13,0,30,17
1683305494005,MATH 10C,B03,188277,Staff,16,0,30,14
1683305495031,MATH 18,A01,188344,Bach; Quang Tran,18,0,30,12
1683305495031,MATH 18,A02,188345,Bach; Quang Tran,11,0,30,19
1683305495031,MATH 18,B01,188353,Bach; Quang Tran,10,0,30,20
1683305495031,MATH 18,B02,188354,Bach; Quang Tran,20,0,30,10
1683305496055,MATH 20A,A01,188374,Staff,13,0,35,22
1683305497080,MATH 20B,A01,188382,Ohm; Ko Woon,6,0,30,24
1683305497080,MATH 20B,A02,188383,Ohm; Ko Woon,24,0,30,6
1683305497080,MATH 20B,B01,188385,Ohm; Ko Woon,7,0,30,23
1683305497080,MATH 20B,B02,188392,Ohm; Ko Woon,22,0,30,8
1683305498109,MATH 20C,A01,188394,Harel; Guershon,10,0,30,20
1683305498109,MATH 20C,A02,188395,Harel; Guershon,13,0,30,17
1683305498109,MATH 20C,B01,188404,Harel; Guershon,3,0,30,27
1683305498109,MATH 20C,B02,188405,Harel; Guershon,19,0,30,11
1683305499139,MATH 20D,A01,188414,Hammock; Frances H,0,1,30,30
1683305499139,MATH 20D,A02,188415,Hammock; Frances H,4,0,30,26
1683305499139,MATH 20D,B01,188447,Hammock; Frances H,2,0,30,28
1683305499139,MATH 20D,B02,188486,Hammock; Frances H,8,0,30,22
1683305500161,MATH 20E,A01,188649,Staff,22,0,30,8
1683305500161,MATH 20E,A02,188650,Staff,23,0,30,7
1683305500161,MATH 20E,A03,188673,Staff,0,0,30,30
1683305501183,MATH 102,A01,188675,Staff,0,35,35,35
1683305502208,MATH 103B,A01,188681,Staff,4,0,35,31
1683305502208,MATH 103B,B01,188692,Staff,7,0,35,28
1683305503235,MATH 109,A01,188695,Salehi Golsefidy; Alireza,25,0,35,10
1683305503235,MATH 109,A02,188696,Salehi Golsefidy; Alireza,27,0,35,8
1683305504261,MATH 120A,A01,188698,Eggers; John Dietrich,6,0,35,29
1683305505287,MATH 142B,A01,188736,Ioana; Adrian,0,2,30,30
1683305505287,MATH 142B,A02,188741,Ioana; Adrian,0,1,30,30
1683305505287,MATH 142B,A03,188743,Ioana; Adrian,0,3,30,30
1683305506310,MATH 168A,A01,188790,Staff,0,9,35,35
1683305507337,MATH 170A,A01,188803,Nie; Jiawang,0,2,35,35
1683305507337,MATH 170A,A02,188811,Nie; Jiawang,0,0,35,35
1683305507337,MATH 170A,A03,188814,Nie; Jiawang,1,0,35,34
1683305507337,MATH 170A,A04,188815,Nie; Jiawang,13,0,35,22
1683305508361,MATH 193B,A01,188817,Staff,0,0,35,35
1683305508361,MATH 193B,A02,188818,Staff,5,0,35,30
1683305509386,MGT 4,A01,202857,Anderson; John Charles,62,0,80,18
1683305510410,MGT 12,A00,202858,Lindenberger; Wade Douglas,43,0,90,47
1683305511436,MGT 18,A00,202859,Staff,74,0,90,16
1683305512458,MGT 18GS,A00,202860,McKay; Michael J,13,0,28,15
1683305513482,MGT 45,A00,202861,Pecore; Joseph P.,14,0,90,76
1683305514505,MGT 100,A00,202863,Yavorsky; Daniel Ryan,28,0,90,62
1683305515528,MGT 103,A00,202864,Ehrich; Kristine R,0,16,90,90
1683305516552,MGT 112,A00,202865,Ehrich; Kristine R,15,0,90,75
1683305517576,MGT 121A,A00,202868,Staff,0,19,0,0
1683305518599,MGT 131B,A00,202869,Anderson; John Charles,59,0,90,31
1683305519624,MGT 136,A00,202871,Lindenberger; Wade Douglas,84,0,90,6
1683305520648,MGT 164,A00,202873,Staff,0,69,90,90
1683305521673,MGT 164GS,A00,202874,McKay; Mary A,13,0,28,15
1683305522697,MGT 180,A00,202875,Staff,0,51,90,90
1683305523721,MMW 11R,A01,205019,Herbst; Matthew,3,0,30,27
1683305523721,MMW 11R,A02,205026,Herbst; Matthew,29,0,30,1
1683305524750,MMW 15,A01,193512,Chang; Edmond Yi-Teh,0,9,28,28
1683305524750,MMW 15,A02,193513,Chang; Edmond Yi-Teh,0,5,28,28
1683305524750,MMW 15,A03,193514,Chang; Edmond Yi-Teh,0,5,28,28
1683305524750,MMW 15,A04,193515,Chang; Edmond Yi-Teh,0,4,28,28
1683305524750,MMW 15,A05,193516,Chang; Edmond Yi-Teh,0,4,28,28
1683305524750,MMW 15,A06,193517,Chang; Edmond Yi-Teh,0,5,28,28
1683305524750,MMW 15,B01,193519,Chang; Edmond Yi-Teh,0,4,28,28
1683305524750,MMW 15,B02,193520,Chang; Edmond Yi-Teh,0,5,28,28
1683305524750,MMW 15,B03,193521,Chang; Edmond Yi-Teh,0,4,28,28
1683305524750,MMW 15,B04,193522,Chang; Edmond Yi-Teh,0,4,28,28
1683305524750,MMW 15,B05,193523,Chang; Edmond Yi-Teh,0,5,28,28
1683305524750,MMW 15,B06,193524,Chang; Edmond Yi-Teh,0,4,28,28
1683305525778,MMW 122,A01,193526,Rahimi; Babak,0,14,28,28
1683305525778,MMW 122,A02,193527,Rahimi; Babak,0,14,28,28
1683305525778,MMW 122,A03,193528,Rahimi; Babak,0,0,0,0
1683305525778,MMW 122,A04,193529,Rahimi; Babak,0,0,0,0
1683305526802,MUS 1A,A01,186663,Staff,0,20,35,35
1683305527826,MUS 4,A01,186715,Staff,0,12,35,35
1683305528854,MUS 5R,A01,186796,Dubnov; Shlomo,0,17,35,35
1683305529881,MUS 6,A01,186798,Staff,0,3,25,25
1683305530906,MUS 7,A01,186830,Staff,12,0,35,23
1683305531929,MUS 8,A01,186930,Staff,0,26,35,35
1683305532957,MUS 15,A01,186932,Staff,0,15,35,35
1683305532957,MUS 15,B01,186934,Staff,0,15,35,35
1683305533982,MUS 80,A00,186935,Staff,2,0,20,18
1683305533982,MUS 80,B00,186936,Staff,25,0,25,0
1683305535009,NANO 11,A00,204702,Lipomi; Darren John,0,0,0,0
1683305536034,NANO 15,A01,204709,Yang; Kesong,0,1,0,0
1683305537061,NANO 114,A00,202069,Jahed Motlagh; Zeinab,3,0,10,7
1683305538088,PHIL 1,A00,186955,Grush; Rick Scott,32,0,40,8
1683305539113,PHIL 10,A01,186973,Grush; Rick Scott,28,0,35,7
1683305539113,PHIL 10,A02,186974,Grush; Rick Scott,33,0,35,2
1683305540140,PHIL 13,A01,186976,Staff,7,0,35,28
1683305540140,PHIL 13,A02,186977,Staff,16,0,35,19
1683305541168,PHIL 14,A01,186979,Staff,31,0,35,4
1683305541168,PHIL 14,A02,186986,Staff,32,0,35,3
1683305542191,PHIL 28,A01,186988,Staff,16,0,30,14
1683305542191,PHIL 28,A02,186989,Staff,1,0,30,29
1683305542191,PHIL 28,A03,186990,Staff,9,0,30,21
1683305542191,PHIL 28,A04,186991,Staff,26,0,30,4
1683305543216,PHIL 120,A00,186997,Staff,23,0,40,17
1683305544244,PHIL 137,A00,187003,Staff,9,0,40,31
1683305545269,PHIL 150,A00,187015,Staff,47,0,70,23
1683305546296,PHIL 167,A00,187021,Lamey; Andy M.,35,0,40,5
1683305547319,PHIL 174,A01,202226,Staff,17,0,20,3
1683305547319,PHIL 174,A02,202235,Staff,20,0,20,0
1683305548341,PHIL 191A,A00,258918,Staff,0,0,1,1
1683305549368,PHYS 1A,A00,187028,Staff,26,0,60,34
1683305550395,PHYS 1AL,001,187036,Staff,2,0,30,28
1683305550395,PHYS 1AL,002,187049,Staff,18,0,30,12
1683305551422,PHYS 1B,A00,187058,Staff,23,0,60,37
1683305552449,PHYS 1BL,001,187064,Staff,0,0,30,30
1683305552449,PHYS 1BL,002,187070,Staff,6,0,30,24
1683305553476,PHYS 1C,A00,187082,Staff,31,0,120,89
1683305554501,PHYS 1CL,001,187088,Staff,0,9,30,30
1683305554501,PHYS 1CL,002,187089,Staff,0,2,30,30
1683305554501,PHYS 1CL,009,262693,Staff,11,0,30,19
1683305555528,PHYS 2B,A01,187097,Staff,54,0,115,61
1683305556552,PHYS 2C,A01,187099,Staff,67,0,115,48
1683305557580,PHYS 2CL,A01,187101,Staff,5,0,28,23
1683305557580,PHYS 2CL,A02,187102,Staff,15,0,28,13
1683305558607,PHYS 2D,A01,187123,Shotwell; Brian,95,0,115,20
1683305559630,PHYS 4B,A01,187133,Grinstein; Benjamin,35,0,50,15
1683305560656,POLI 10,A00,188819,Staff,0,3,50,50
1683305561681,POLI 11,A00,188827,Staff,43,0,50,7
1683305562705,POLI 13R,A00,188828,Staff,0,1,20,20
1683305563730,POLI 27,A01,188830,Elgin; Samuel Zincke,0,1,70,70
1683305564752,POLI 30,A00,188832,Desposato; Scott,33,0,50,17
1683305565778,POLI 102F,A00,188834,Staff,3,0,40,37
1683305566802,POLI 104A,A00,188852,Staff,14,0,30,16
1683305567826,POLI 104I,A00,188853,Staff,0,6,20,20
1683305568854,POLI 110B,A00,188854,Wiens; David,7,0,20,13
1683305569879,POLI 112A,A00,188855,Wiens; David,5,0,30,25
1683305570903,POLI 117R,A00,188856,Forman; Fonna,0,11,20,20
1683305571928,POLI 118,A00,188857,Ingham; Sean,8,0,20,12
1683305572952,POLI 120G,A00,188858,Staff,9,0,30,21
1683305573976,POLI 131CR,A00,188863,Hoston; Germaine,24,0,50,26
1683305575003,POLI 133,A00,188864,Nellis; Gareth Hb,44,0,50,6
1683305576030,POLI 134D,A00,188865,Desposato; Scott,27,0,30,3
1683305577057,POLI 142A,A00,188871,Gartzke; Erik,22,0,50,28
1683305578079,POLI 142K,A00,188874,Staff,38,0,50,12
1683305579106,POLI 143,A00,188940,Gartzke; Erik,16,0,30,14
1683305580131,POLI 153,A00,188943,Staff,3,0,20,17
1683305581159,POLI 160AA,A00,188944,Staff,13,0,40,27
1683305582188,POLI 170A,A00,188945,Staff,11,0,30,19
1683305584294,PSYC 1,A00,188952,Staff,38,0,90,52
1683305585320,PSYC 2,B00,188953,Staff,20,0,35,15
1683305586347,PSYC 6,A00,188970,Staff,47,0,60,13
1683305587372,PSYC 7,A00,188973,Staff,37,0,45,8
1683305588396,PSYC 60,A01,188980,Rickard; Timothy C.,43,0,60,17
1683305589421,PSYC 70,A01,189001,Steiner; Eric Tomas,24,0,45,21
1683305590448,PSYC 100,A00,189005,Lacefield; Katharine I,0,99,120,120
1683305591475,PSYC 102,A00,189008,Staff,10,0,30,20
1683305592499,PSYC 106,B00,189026,Gorman; Michael R.,37,0,60,23
1683305593522,PSYC 114,B01,189033,Winkielman; Piotr,0,32,30,30
1683305594549,PSYC 131,A00,189036,Anagnostaras; Stephan,0,43,60,60
1683305595577,PSYC 136,A00,189041,Lowe; Angela Beth,0,7,25,25
1683305596605,PSYC 137,A00,189057,Winkielman; Piotr,0,34,25,25
1683305597630,PSYC 144,A00,189107,Wixted; John T,0,7,50,50
1683305599680,PSYC 162,A00,189142,Staff,0,8,85,85
1683305600707,PSYC 172,A00,189144,Gorman; Michael R.,0,7,30,30
1683305602760,PSYC 179,A00,189146,Lacefield; Katharine I,0,84,120,120
1683305603782,PSYC 181,A00,189147,Anagnostaras; Stephan,0,44,90,90
1683305604806,PSYC 190R,A00,189148,Barner; David A.,0,22,80,80
1683305605830,PSYC 191,A00,189275,Rickard; Timothy C.,0,7,25,25
1683305606861,PSYC 193,A00,189276,Chapman; Eddie Nathaniel,0,1,0,4
1683305607885,PSYC 193L,A01,189281,Lowe; Angela Beth,12,0,20,8
1683305607885,PSYC 193L,B01,189285,Staff,28,0,35,7
1683305608910,RELI 149,A00,187137,Rahimi; Babak,7,0,40,33
1683305609938,SE 9,A01,187315,Staff,0,2,18,18
1683305610962,SE 101B,A00,187409,Staff,24,0,30,6
1683305611985,SE 110B,A00,187444,Staff,10,0,40,30
1683305613013,SE 130B,A00,187449,Staff,31,0,40,9
1683305614040,SE 150A,A00,187516,Staff,9,0,20,11
1683305615068,SE 154,A00,187528,Staff,30,0,50,20
1683305616094,SIO 3,A01,258171,Staff,35,0,40,5
1683305617118,SIO 10,A00,187144,Cook; Geoffrey W,0,3,75,75
1683305618146,SIO 45,A00,187152,Cook; Geoffrey W,1,0,100,99
1683305619173,SIO 109R,A00,194486,Staff,0,3,20,20
1683305621221,SIO 187,A01,187233,Kacev; David,12,0,40,28
1683305622246,SOCI 1,A01,258656,Thorpe; Charles Robert,28,0,30,2
1683305622246,SOCI 1,A02,258658,Thorpe; Charles Robert,30,0,30,0
1683305622246,SOCI 1,A03,258661,Thorpe; Charles Robert,25,0,25,0
1683305622246,SOCI 1,A04,258666,Thorpe; Charles Robert,22,0,25,3
1683305622246,SOCI 1,A05,258897,Thorpe; Charles Robert,23,0,25,2
1683305622246,SOCI 1,A06,258898,Thorpe; Charles Robert,25,0,25,0
1683305623274,SOCI 30,A01,258903,Pardo Guerra; Juan Pablo,16,0,30,14
1683305624297,SOCI 102,A00,258904,Staff,9,0,25,16
1683305625325,SOCI 106,A00,258905,Staff,19,0,25,6
1683305626351,SOCI 111,A00,258907,Ribas Norris; Janet Vanesa,26,0,30,4
1683305627379,SOCI 121R,A00,258908,Pardo Guerra; Juan Pablo,11,0,30,19
1683305628402,SOCI 126,A01,203330,Staff,14,0,20,6
1683305629430,SOCI 131,A00,258909,Thorpe; Charles Robert,31,0,60,29
1683305630455,SOCI 135,A00,258910,Payne; Christine Anna,0,9,30,30
1683305631479,SOCI 157,A00,258911,Staff,13,0,30,17
1683305632505,SOCI 184,A00,258912,Staff,26,0,30,4
1683305633531,SOCI 188D,A00,258913,Staff,21,0,30,9
1683305634558,SYN 2,001,187529,Staff,9,0,16,7
1683305634558,SYN 2,002,201452,Staff,0,18,16,16
1683305634558,SYN 2,003,201469,Staff,3,0,16,13
1683305635582,SYN 100,A01,187531,Staff,0,9,20,20
1683305635582,SYN 100,B01,201491,Staff,0,12,20,20
1683305636611,TDAC 1,A00,189286,Walsh; Kim C.,3,0,20,17
1683305636611,TDAC 1,B00,189287,Harting; Carla Kelso,11,0,20,9
1683305637639,TDAC 101,A00,189300,Walsh; Kim C.,16,0,20,4
1683305637639,TDAC 101,B00,189301,Harting; Carla Kelso,18,0,20,2
1683305638662,TDAC 102,A00,189304,Basso; Beatrice,14,0,20,6
1683305639686,TDAC 108,A00,189305,Staff,18,0,20,2
1683305640713,TDDE 131,A00,189310,Staff,19,0,20,1
1683305640713,TDDE 131,B00,189314,Staff,19,0,20,1
1683305640713,TDDE 131,C00,189315,Staff,48,0,50,2
1683305640713,TDDE 131,D00,189316,Staff,14,0,15,1
1683305640713,TDDE 131,E00,204841,Staff,20,0,20,0
1683305641738,TDGE 10,A00,189289,Staff,30,0,50,20
1683305641738,TDGE 10,B00,189290,Havis; Allan,2,0,50,48
1683305642762,TDGE 11,A00,189291,Fulton; Julia,0,3,50,50
1683305642762,TDGE 11,B00,189292,Staff,20,0,25,5
1683305642762,TDGE 11,C00,260270,Staff,0,0,0,0
1683305643789,TDGE 25,A00,189294,Staff,3,0,20,17
1683305644812,TDGE 124,A00,189318,Fulton; Julia,0,8,50,50
1683305645838,TDGE 125,A00,189319,Staff,13,0,25,12
1683305645838,TDGE 125,B00,189320,Staff,23,0,25,2
1683305646865,TDGE 127,A00,189322,Havis; Allan,0,0,50,50
1683305647896,TDHT 101,A00,189323,Staff,18,0,25,7
1683305647896,TDHT 101,B00,189324,Staff,25,0,25,0
1683305648923,TDHT 102,A00,189325,Staff,49,0,50,1
1683305649947,TDMV 1,A00,189295,Arcidiacono; Kristin,20,0,30,10
1683305649947,TDMV 1,B00,189296,Caligagan; Maria T.,24,0,30,6
1683305650972,TDMV 2,A00,189297,Sammartano; Tonnie,28,0,30,2
1683305650972,TDMV 2,B00,189299,Arcidiacono; Kristin,24,0,30,6
1683305652000,TDMV 3,A00,204998,Rincon; Alicia,22,0,30,8
1683305653027,TDMV 120,A00,189458,Sammartano; Tonnie,28,0,30,2
1683305654053,TDMV 138,A00,189541,Jun; Grace Shin Hae,22,0,40,18
1683305655081,TDMV 142,A00,189717,Caligagan; Tony,23,0,30,7
1683305655081,TDMV 142,B00,189718,Caligagan; Maria T.,25,0,30,5
1683305656104,TMC 2,A01,187533,Staff,25,0,25,0
1683305656104,TMC 2,A02,187534,Staff,25,0,25,0
1683305657132,USP 1,A01,187536,Kwak; Nancy,0,16,25,25
1683305658156,USP 5,A01,187538,Staff,9,0,25,16
1683305659180,USP 101,A00,199253,Staff,0,4,0,0
1683305660205,USP 124,A00,187562,Boomhower; Matthew Charles,1,0,30,29
1683305661230,USP 138,A00,187582,Staff,20,0,25,5
1683305662253,USP 152,A01,187597,Staff,4,0,25,21
1683305663278,USP 153,A00,187598,Staff,19,0,25,6
1683305664302,USP 168,A00,187607,Kwak; Nancy,2,0,5,3
1683305665325,USP 173,A00,187619,Staff,4,0,25,21
1683305666353,USP 181,A00,187638,Staff,0,0,25,25
1683305667379,VIS 103,A00,187650,Cruz; Edwin Teddy,23,0,75,52
1683305668402,VIS 110D,A00,187669,Staff,12,0,22,10
1683305669429,VIS 127C,A00,187720,Shen; Kuiyi,68,0,146,78
1683305670453,VIS 149,A00,187731,Yoldas; Pinar,0,14,22,22
1683305671477,VIS 151,A01,188091,Staff,22,0,34,12
1683305671477,VIS 151,A02,188092,Staff,11,0,34,23
1683305672504,VIS 160B,A00,188093,Stalbaum; Brett,0,0,10,10
1683305674554,WCWP 10B,A00,201720,Staff,10,0,15,5
1683305674554,WCWP 10B,B00,201722,Staff,8,0,15,7
1683305675580,WCWP 100,A00,201725,Gagnon; Jeffrey C,0,0,2,2
1683305675580,WCWP 100,B00,201727,Staff,0,4,15,15
1683305678666,ANBI 133,A00,258401,Wilder; Linnea Lorene,34,0,40,6
1683305679693,ANBI 140,A00,258395,Hrvoj Mihic; Branka,18,0,25,7
1683305680720,ANSC 120,A00,258402,Bialecki; Jon Anthony,27,0,40,13
1683305681746,ANSC 144,A00,258400,Staff,14,0,40,26
1683305683801,ANSC 166,A00,258396,Parish; Steven Martin,157,0,175,18
1683305684829,ANSC 180,A00,193533,Staff,9,0,20,11
1683305685854,ANSC 188,A00,258397,Jassal; Aftab,33,0,40,7
1683305686951,ANTH 3,A01,258316,Staff,23,0,30,7
1683305687974,ANTH 5,A00,258394,Semendeferi; Ekaterini,16,0,20,4
1683305689005,ANTH 21,A01,258331,Staff,9,0,40,31
1683305690028,ANTH 103,A00,258398,Varma; Saiba,15,0,25,10
1683305691055,AWP 10,001,202034,Staff,0,0,0,0
1683305691055,AWP 10,002,202035,Staff,0,0,0,0
1683305691055,AWP 10,003,202036,Staff,0,0,0,0
1683305691055,AWP 10,004,202037,Staff,0,0,0,0
1683305691055,AWP 10,005,202038,Staff,0,0,0,0
1683305691055,AWP 10,006,202039,Staff,0,0,0,0
1683305691055,AWP 10,007,202040,Staff,0,0,0,0
1683305691055,AWP 10,008,202041,Staff,0,0,0,0
1683305691055,AWP 10,009,202042,Staff,0,0,0,0
1683305691055,AWP 10,010,202043,Staff,0,0,0,0
1683305691055,AWP 10,011,202044,Staff,0,0,0,0
1683305691055,AWP 10,012,202045,Staff,0,0,0,0
1683305691055,AWP 10,013,202046,Staff,0,0,0,0
1683305691055,AWP 10,014,202047,Staff,0,0,0,0
1683305691055,AWP 10,015,202048,Staff,0,0,0,0
1683305691055,AWP 10,016,202049,Staff,0,0,0,0
1683305691055,AWP 10,017,202050,Staff,0,0,0,0
1683305691055,AWP 10,018,202051,Staff,0,0,0,0
1683305691055,AWP 10,019,202052,Staff,0,0,0,0
1683305691055,AWP 10,020,202053,Staff,0,0,0,0
1683305691055,AWP 10,021,202054,Staff,0,0,0,0
1683305691055,AWP 10,022,202055,Staff,0,0,0,0
1683305691055,AWP 10,023,202056,Staff,0,0,0,0
1683305691055,AWP 10,024,202057,Staff,0,0,0,0
1683305691055,AWP 10,025,202058,Staff,0,0,0,0
1683305691055,AWP 10,026,202059,Staff,0,0,0,0
1683305692078,AWP 102,001,202032,Staff,0,0,0,0
1683305692078,AWP 102,002,202033,Staff,0,0,0,0
1683305693106,BENG 100,A01,254234,Taylor Amos; Alyssa C,31,0,40,9
1683305694130,BENG 196,001,270013,Engler; Adam J.,9999,0,9999,0
1683305695152,BICD 100R,A01,202018,Smith; Laurie,0,7,32,32
1683305695152,BICD 100R,A02,202019,Smith; Laurie,0,2,32,32
1683305695152,BICD 100R,A03,202020,Smith; Laurie,0,1,32,32
1683305695152,BICD 100R,A04,202021,Smith; Laurie,8,0,32,24
1683305695152,BICD 100R,A05,202022,Smith; Laurie,12,0,32,20
1683305696176,BICD 136,A01,193242,Gustafson-Brown; Cindy,0,2,32,32
1683305696176,BICD 136,A02,193244,Gustafson-Brown; Cindy,15,0,32,17
1683305697206,BIEB 102,A01,193249,Butler; Shannon Rhey,0,2,32,32
1683305697206,BIEB 102,A02,193251,Butler; Shannon Rhey,0,0,32,32
1683305697206,BIEB 102,A03,193253,Butler; Shannon Rhey,0,1,32,32
1683305697206,BIEB 102,A04,193255,Butler; Shannon Rhey,17,0,32,15
1683305697206,BIEB 102,A05,193265,Butler; Shannon Rhey,26,0,32,6
1683305697206,BIEB 102,A06,193269,Butler; Shannon Rhey,16,0,32,16
1683305699255,BIEB 150,A01,193274,Staff,0,0,32,32
1683305699255,BIEB 150,A02,193285,Staff,24,0,32,8
1683305700279,BIEB 194,A00,193286,Kurle; Carolyn M.,22,0,32,10
1683305701303,BILD 1,A01,192291,Staff,16,0,32,16
1683305701303,BILD 1,A02,192292,Staff,30,0,32,2
1683305701303,BILD 1,B01,192520,Reuther; Keefe,0,1,0,0
1683305701303,BILD 1,B02,192532,Reuther; Keefe,0,1,0,0
1683305702333,BILD 3,A01,192556,Butler; Shannon Rhey,0,0,32,32
1683305702333,BILD 3,A02,192581,Butler; Shannon Rhey,5,0,32,27
1683305702333,BILD 3,A03,192611,Butler; Shannon Rhey,23,0,32,9
1683305702333,BILD 3,A04,192612,Butler; Shannon Rhey,25,0,32,7
1683305702333,BILD 3,A05,192613,Butler; Shannon Rhey,27,0,32,5
1683305702333,BILD 3,A06,192679,Butler; Shannon Rhey,27,0,32,5
1683305702333,BILD 3,A07,192682,Butler; Shannon Rhey,22,0,32,10
1683305703358,BILD 4,A01,192836,Reuther; Keefe,1,0,24,23
1683305703358,BILD 4,A02,193044,Reuther; Keefe,4,0,24,20
1683305704388,BILD 10,A01,193142,Gustafson-Brown; Cindy,31,0,32,1
1683305704388,BILD 10,A02,193149,Gustafson-Brown; Cindy,31,0,32,1
1683305705411,BIMM 100,A01,193301,Staff,0,6,32,32
1683305705411,BIMM 100,A02,193312,Staff,0,5,32,32
1683305705411,BIMM 100,A03,193323,Staff,0,8,32,32
1683305706436,BIMM 101,A01,193329,McDonnell; Lisa Marie,0,3,24,24
1683305706436,BIMM 101,A02,193339,McDonnell; Lisa Marie,0,2,24,24
1683305706436,BIMM 101,B01,193354,McDonnell; Lisa Marie,0,3,24,24
1683305706436,BIMM 101,B02,193357,McDonnell; Lisa Marie,0,3,24,24
1683305707463,BIMM 110,A01,193377,Tat; John,0,11,32,32
1683305707463,BIMM 110,A02,193378,Tat; John,1,9,32,31
1683305708487,BIMM 120,A01,206116,Staff,0,0,32,32
1683305708487,BIMM 120,A02,206117,Staff,8,0,32,24
1683305708487,BIMM 120,A03,206121,Staff,21,0,32,11
1683305709512,BIPN 100,A01,193393,Park; Ji Young,0,14,32,32
1683305709512,BIPN 100,A02,193402,Park; Ji Young,0,12,32,32
1683305709512,BIPN 100,A03,193413,Park; Ji Young,0,14,32,32
1683305709512,BIPN 100,A04,193414,Park; Ji Young,0,13,32,32
1683305710537,BIPN 102,A01,193429,Staff,0,0,32,32
1683305710537,BIPN 102,A02,193438,Staff,23,0,32,9
1683305711564,BIPN 106,A01,193450,Reyes Gonzalez; Catalina,0,2,40,40
1683305712590,BIPN 134,A01,193465,Cooke; James Edward,0,0,32,32
1683305712590,BIPN 134,A02,193474,Cooke; James Edward,27,0,32,5
1683305712590,BIPN 134,A03,193485,Cooke; James Edward,29,0,32,3
1683305712590,BIPN 134,A04,193486,Cooke; James Edward,21,0,32,11
1683305712590,BIPN 134,A05,193491,Cooke; James Edward,31,0,32,1
1683305712590,BIPN 134,A06,193501,Cooke; James Edward,30,0,32,2
1683305712590,BIPN 134,A07,193510,Cooke; James Edward,29,0,32,3
1683305714640,BISP 194,A00,222522,Staff,16,0,32,16
1683305715662,CAT 124,A01,202407,Staff,20,0,25,5
1683305716686,CAT 125,A00,202408,Marchisotto; Jennifer Anne,4,0,20,16
1683305717710,CAT 125R,A00,202409,Smith; Lauryn Alissa,0,11,20,20
1683305717710,CAT 125R,B00,202410,Morales; Celeste Georgianna,0,11,20,20
1683305717710,CAT 125R,C00,202411,Irwin; Matthew Joseph,0,10,20,20
1683305718734,CENG 15,A01,204712,Yang; Kesong,0,1,0,0
1683305719756,CENG 114,A00,202070,Jahed Motlagh; Zeinab,5,0,20,15
1683305720784,CGS 105,A00,185477,Wesling; Megan E.,24,0,40,16
1683305721808,CGS 106,A00,185494,Staff,13,0,22,9
1683305722833,CGS 108,A00,185495,Staff,14,0,20,6
1683305723860,CGS 114,A00,185496,Staff,13,0,18,5
1683305724887,CGS 119,A00,185501,Staff,15,0,20,5
1683305725910,CGS 120,A00,185511,Staff,13,0,20,7
1683305726935,CHEM 4,A01,184675,Bussey; Thomas J,96,0,100,4
1683305727963,CHEM 6A,A01,184677,Staff,35,0,60,25
1683305728990,CHEM 6B,A01,184679,Staff,65,0,100,35
1683305730015,CHEM 6C,A01,184681,Bussey; Thomas J,1,0,50,49
1683305730015,CHEM 6C,A02,184682,Bussey; Thomas J,34,0,50,16
1683305731039,CHEM 40A,A01,184684,Albizati; Kim F.,37,0,100,63
1683305732063,CHEM 40B,A01,184686,Albizati; Kim F.,0,20,100,100
1683305733088,CHEM 41B,A01,184690,Staff,52,0,100,48
1683305734112,COGS 3,A01,184715,Boyle; Mary E. T.,0,25,40,40
1683305735136,COGS 14B,A01,185172,Staff,0,15,38,38
1683305736167,COGS 18,A01,184736,Staff,20,0,80,60
1683305737193,COGS 100,A01,184932,Staff,0,5,73,73
1683305738221,COGS 101A,A01,184935,Staff,0,38,30,30
1683305739247,COGS 101B,A01,184944,Staff,0,2,30,30
1683305740273,COGS 101C,A01,184946,Staff,0,12,30,30
1683305741296,COGS 102A,A01,184951,Johnson; Christine M.,2,0,40,38
1683305742319,COGS 107B,A01,184953,Mooshagian; Eric Frederick,0,50,40,40
1683305743341,COGS 118B,A01,184959,Gupta; Anjum,0,48,40,40
1683305744365,COGS 153,A00,184961,Staff,0,15,30,30
1683305745391,COGS 177,A00,184962,Staff,0,21,30,30
1683305746419,COGS 187A,A01,184969,Boyle; Mary E. T.,0,17,40,40
1683305747447,COMM 10,A01,185174,Staff,0,5,25,25
1683305747447,COMM 10,A02,185189,Staff,0,5,25,25
1683305747447,COMM 10,A03,269821,Staff,0,0,0,0
1683305748474,COMM 100B,A01,185475,Staff,0,0,0,2
1683305748474,COMM 100B,A02,185476,Staff,14,0,25,11
1683305749507,COMM 100C,A01,185314,Staff,1,0,25,24
1683305749507,COMM 100C,A02,185327,Staff,19,0,25,6
1683305750534,COMM 110M,A00,185349,Staff,2,0,40,38
1683305751558,COMM 113T,A00,185352,Staff,25,0,40,15
1683305752584,COMM 114I,A00,185353,Staff,33,0,40,7
1683305753610,COMM 131,A00,185354,Staff,19,0,30,11
1683305754637,CSE 8A,A50,185358,Cao; Yingjun,0,46,10,10
1683305755661,CSE 8B,A01,185362,Staff,1,47,50,49
1683305756686,CSE 11,A01,185416,Cao; Yingjun,0,93,10,10
1683305757711,CSE 20,A01,185445,Briones; Jor-el Thomas Caparas,5,0,25,20
1683305758738,CSE 21,A01,185447,Staff,10,0,50,40
1683305759767,CSE 101,A01,185451,Staff,0,12,50,50
1683305759767,CSE 101,B01,185453,Jones; Miles E,0,11,50,50
1683305761821,CSE 141,A01,185458,Eldon; John,20,0,100,80
1683305762846,CSE 141L,A01,185461,Eldon; John,12,0,100,88
1683305763874,CSE 142,A01,185463,Staff,35,0,60,25
1683305763874,CSE 142,B01,201355,Staff,0,6,60,60
1683305764901,CSE 142L,A01,185470,Staff,35,0,60,25
1683305764901,CSE 142L,B01,201417,Staff,0,5,60,60
1683305765925,CSE 190,A00,201433,Staff,32,0,49,17
1683305766952,DOC 1,A01,259136,Strom; Megan C.,8,0,15,7
1683305766952,DOC 1,A02,259137,Strom; Megan C.,14,0,15,1
1683305766952,DOC 1,A03,259138,Strom; Megan C.,14,0,15,1
1683305766952,DOC 1,A04,259139,Strom; Megan C.,14,0,15,1
1683305767974,DOC 100D,A00,259140,Pass; Natalye Joann,17,0,25,8
1683305769001,DSGN 1,A01,184749,Rill; Bryan,0,24,30,30
1683305770029,DSGN 100,A01,185168,Staff,0,2,25,25
1683305771056,ECE 5,A01,185626,Morris; Karcher William,0,10,0,0
1683305772080,ECE 101,A01,185628,Staff,17,0,70,53
1683305773104,ECE 107,A01,185635,Baghdadchi; Saharnaz,0,0,20,20
1683305773104,ECE 107,A02,185638,Baghdadchi; Saharnaz,4,0,20,16
1683305774128,ECE 148,A01,185647,Silberman; Jack,0,0,16,16
1683305775153,ECON 1,A01,185537,Crane; Meredith Helen,54,0,70,16
1683305776180,ECON 3,A01,185549,Crane; Meredith Helen,33,0,70,37
1683305777207,ECON 4,A01,203354,Anderson; John Charles,0,4,10,10
1683305778238,ECON 100A,A01,185574,Staff,0,4,40,40
1683305779262,ECON 100B,A01,185576,Staff,0,22,40,40
1683305780287,ECON 100C,A01,185589,Newhouse; Herbert S,30,0,70,40
1683305781312,ECON 105,A00,185608,Vespa; Emanuel Ignacio,19,0,35,16
1683305782340,ECON 109,A01,185610,Shishkin; Denis,10,0,35,25
1683305783367,ECON 110A,A01,185612,Staff,11,0,40,29
1683305784393,ECON 120A,A01,185615,Staff,20,0,40,20
1683305785419,ECON 120C,A01,185617,Sun; Yixiao,0,20,70,70
1683305786444,ECON 144,A00,203346,Squires; Dale E,3,0,35,32
1683305787469,ECON 171,A01,203349,Newhouse; Herbert S,0,1,35,35
1683305788493,ECON 173A,A01,185621,Toda; Alexis Akira,21,0,35,14
1683305789519,EDS 25,A01,202413,Staff,0,1,0,0
1683305789519,EDS 25,A02,202414,Staff,0,1,0,0
1683305789519,EDS 25,A03,202415,Staff,0,0,0,0
1683305789519,EDS 25,A04,202416,Staff,0,1,0,0
1683305789519,EDS 25,A05,202439,Staff,0,0,0,0
1683305789519,EDS 25,A06,202440,Staff,0,0,0,0
1683305789519,EDS 25,B01,202631,Staff,0,0,0,0
1683305789519,EDS 25,B02,202632,Staff,0,0,0,0
1683305789519,EDS 25,B03,202639,Staff,0,0,0,0
1683305789519,EDS 25,B04,202640,Staff,0,0,0,0
1683305789519,EDS 25,B05,202643,Staff,0,0,0,0
1683305789519,EDS 25,B06,202644,Staff,0,0,0,0
1683305790602,EDS 38,A01,202659,Black; Alison Michelle,24,0,25,1
1683305791625,EDS 115,A00,202652,Staff,17,0,30,13
1683305792652,EDS 125,A00,202649,Staff,14,0,30,16
1683305793676,EDS 126,A01,203332,Staff,30,0,30,0
1683305794701,EDS 139,A00,202838,Staff,17,0,25,8
1683305795726,EDS 146,A01,202655,Staff,15,0,25,10
1683305796750,ENG 15,A00,185667,Staff,0,1,0,0
1683305796750,ENG 15,B00,185672,Staff,0,0,0,0
1683305796750,ENG 15,C00,185675,Staff,0,0,0,0
1683305796750,ENG 15,D00,185682,Staff,0,0,0,0
1683305796750,ENG 15,E00,185684,Staff,0,0,0,0
1683305797774,ETHN 103,A00,185710,Staff,0,3,35,35
1683305798801,ETHN 103A,A00,199228,Man; Simeon S,2,0,9,7
1683305799824,ETHN 109,A00,185711,Staff,18,0,35,17
1683305800848,ETHN 142,A00,185726,Staff,0,4,30,30
1683305801873,ETHN 163J,A00,199229,Man; Simeon S,6,0,8,2
1683305802897,ETHN 168,A00,185727,Staff,8,0,10,2
1683305803923,ETHN 182,A00,185728,Staff,1,0,35,34
1683305804950,ETHN 183,A00,185737,Staff,8,0,18,10
1683305805977,GLBH 111,A01,209361,Burgos; Jose L.,0,0,0,0
1683305808030,HIEU 104,A00,185792,Staff,16,0,20,4
1683305809054,HIEU 115,A00,185800,Staff,1,0,20,19
1683305810078,HIEU 128,A00,185801,Staff,0,7,20,20
1683305811102,HIEU 147,A00,185802,Staff,16,0,20,4
1683305812125,HIEU 154,A00,185823,Staff,12,0,20,8
1683305813150,HILA 102,A00,185826,Staff,13,0,20,7
1683305814177,HILD 2C,A01,185778,Staff,0,12,20,20
1683305815199,HILD 7B,A01,185780,Kwak; Nancy,0,15,32,32
1683305815199,HILD 7B,A02,185781,Kwak; Nancy,0,18,32,32
1683305816222,HILD 30,A01,185791,Staff,14,0,20,6
1683305817249,HISC 119,A00,185830,Golan; Tal,0,9,20,20
1683305818274,HITO 156GS,A00,185831,Patterson; Patrick H.,0,0,0,23
1683305819300,HIUS 103,A00,185832,Man; Simeon S,0,6,20,20
1683305820323,HIUS 117,A00,185836,Kwak; Nancy,2,0,20,18
1683305821346,HIUS 125,A00,185840,Man; Simeon S,0,0,23,23
1683305822370,HIUS 149,A00,185845,Staff,0,0,20,20
1683305823394,HUM 3,A01,185882,Zavodny; Tatiana Sophia,0,6,50,50
1683305823394,HUM 3,B01,185899,Caldwell; Michael Alan,0,19,50,50
1683305824418,HUM 3GS,A00,185900,Patterson; Patrick H.,0,0,0,23
1683305825442,HUM 4,A01,185938,Zroka; Amy Liane,30,0,50,20
1683305825442,HUM 4,B01,185956,Watkins; Eric,0,2,50,50
1683305825442,HUM 4,B02,202209,Watkins; Eric,0,1,50,50
1683305825442,HUM 4,B03,202210,Watkins; Eric,0,0,50,50
1683305826471,HUM 5,A01,185958,West; Geoffrey Scott,5,0,50,45
1683305826471,HUM 5,A02,202215,West; Geoffrey Scott,0,0,50,50
1683305827496,INTL 190,A00,185959,Gagnon; Jeffrey C,0,0,0,9
1683305827496,INTL 190,B00,185960,Lettieri; Michael Joseph,0,0,0,1
1683305828522,JAPN 180,A00,254509,Staff,5,1,30,25
1683305829551,LATI 10,A01,202853,Kennemore; Amy Michelle,5,0,35,30
1683305829551,LATI 10,A02,202854,Kennemore; Amy Michelle,1,0,35,34
1683305829551,LATI 10,A03,270054,Kennemore; Amy Michelle,30,0,30,0
1683305830576,LATI 180,A00,202855,Kennemore; Amy Michelle,11,0,20,9
1683305831604,LAWS 101,A00,201767,Golan; Tal,0,7,40,40
1683305832631,LIFR 1C,A00,185961,Staff,6,0,20,14
1683305833658,LIFR 1CX,A00,185962,Staff,7,0,20,13
1683305834685,LIFR 1D,A00,185963,Staff,9,0,20,11
1683305835711,LIFR 1DX,A00,185964,Staff,9,0,20,11
1683305836739,LIGN 101,A01,186039,Staff,43,0,50,7
1683305837764,LIGN 165,A00,186040,Staff,18,0,50,32
1683305838788,LTCS 108,A00,186041,Staff,6,0,10,4
1683305839815,LTCS 119,A00,186042,Staff,16,0,20,4
1683305840845,LTCS 130,A00,186043,Wesling; Megan E.,15,0,25,10
1683305842896,LTEA 138,A00,186119,Staff,14,0,40,26
1683305843920,LTEN 124,A00,186148,Staff,6,0,25,19
1683305844945,LTEN 178,A00,186149,Staff,7,0,15,8
1683305845968,LTEN 181,A00,186150,Blanco; John D,33,0,40,7
1683305846992,LTWL 120,A00,186160,Staff,20,0,25,5
1683305848019,LTWL 165,A00,186161,Staff,22,0,25,3
1683305849044,LTWR 100,A00,186162,Staff,0,4,15,15
1683305850068,LTWR 102,A00,186163,Doller; Ben,5,0,15,10
1683305851095,MAE 8,A01,186412,Staff,0,0,0,0
1683305852122,MAE 30B,A00,186445,Bahadori; Mohammad Yousef,83,0,100,17
1683305853146,MAE 40,A00,186592,Bewley; Thomas R,9,0,50,41
1683305854173,MAE 101B,A00,186593,Bahadori; Mohammad Yousef,81,0,100,19
1683305855201,MAE 105,A00,186594,Bandaru; Prabhakar,12,0,50,38
1683305856228,MAE 107,A00,186599,Pham; Hieu Tan,0,6,120,120
1683305857254,MAE 148,A01,186660,Silberman; Jack,3,0,16,13
1683305858281,MATH 10A,A01,188095,Staff,0,7,35,35
1683305859307,MATH 10B,A01,188097,Bowers; Adam R.,0,11,30,30
1683305859307,MATH 10B,A02,188099,Bowers; Adam R.,0,9,30,30
1683305859307,MATH 10B,B01,188104,Bowers; Adam R.,0,11,30,30
1683305859307,MATH 10B,B02,188106,Bowers; Adam R.,0,11,30,30
1683305860335,MATH 10C,A01,188111,Staff,0,18,30,30
1683305860335,MATH 10C,A02,188127,Staff,0,17,30,30
1683305860335,MATH 10C,A03,188131,Staff,0,17,30,30
1683305860335,MATH 10C,B01,188218,Staff,21,0,30,9
1683305860335,MATH 10C,B02,188244,Staff,13,0,30,17
1683305860335,MATH 10C,B03,188277,Staff,16,0,30,14
1683305861360,MATH 18,A01,188344,Bach; Quang Tran,18,0,30,12
1683305861360,MATH 18,A02,188345,Bach; Quang Tran,11,0,30,19
1683305861360,MATH 18,B01,188353,Bach; Quang Tran,10,0,30,20
1683305861360,MATH 18,B02,188354,Bach; Quang Tran,20,0,30,10
1683305862385,MATH 20A,A01,188374,Staff,13,0,35,22
1683305863411,MATH 20B,A01,188382,Ohm; Ko Woon,6,0,30,24
1683305863411,MATH 20B,A02,188383,Ohm; Ko Woon,24,0,30,6
1683305863411,MATH 20B,B01,188385,Ohm; Ko Woon,7,0,30,23
1683305863411,MATH 20B,B02,188392,Ohm; Ko Woon,22,0,30,8
1683305864437,MATH 20C,A01,188394,Harel; Guershon,10,0,30,20
1683305864437,MATH 20C,A02,188395,Harel; Guershon,13,0,30,17
1683305864437,MATH 20C,B01,188404,Harel; Guershon,3,0,30,27
1683305864437,MATH 20C,B02,188405,Harel; Guershon,19,0,30,11
1683305865467,MATH 20D,A01,188414,Hammock; Frances H,0,1,30,30
1683305865467,MATH 20D,A02,188415,Hammock; Frances H,4,0,30,26
1683305865467,MATH 20D,B01,188447,Hammock; Frances H,2,0,30,28
1683305865467,MATH 20D,B02,188486,Hammock; Frances H,8,0,30,22
1683305866495,MATH 20E,A01,188649,Staff,22,0,30,8
1683305866495,MATH 20E,A02,188650,Staff,23,0,30,7
1683305866495,MATH 20E,A03,188673,Staff,0,0,30,30
1683305867522,MATH 102,A01,188675,Staff,0,35,35,35
1683305868548,MATH 103B,A01,188681,Staff,4,0,35,31
1683305868548,MATH 103B,B01,188692,Staff,7,0,35,28
1683305869575,MATH 109,A01,188695,Salehi Golsefidy; Alireza,25,0,35,10
1683305869575,MATH 109,A02,188696,Salehi Golsefidy; Alireza,27,0,35,8
1683305870598,MATH 120A,A01,188698,Eggers; John Dietrich,6,0,35,29
1683305871627,MATH 142B,A01,188736,Ioana; Adrian,0,2,30,30
1683305871627,MATH 142B,A02,188741,Ioana; Adrian,0,1,30,30
1683305871627,MATH 142B,A03,188743,Ioana; Adrian,0,3,30,30
1683305872655,MATH 168A,A01,188790,Staff,0,9,35,35
1683305873680,MATH 170A,A01,188803,Nie; Jiawang,0,2,35,35
1683305873680,MATH 170A,A02,188811,Nie; Jiawang,0,0,35,35
1683305873680,MATH 170A,A03,188814,Nie; Jiawang,1,0,35,34
1683305873680,MATH 170A,A04,188815,Nie; Jiawang,13,0,35,22
1683305874705,MATH 193B,A01,188817,Staff,0,0,35,35
1683305874705,MATH 193B,A02,188818,Staff,5,0,35,30
1683305875740,MGT 4,A01,202857,Anderson; John Charles,62,0,80,18
1683305876767,MGT 12,A00,202858,Lindenberger; Wade Douglas,43,0,90,47
1683305877795,MGT 18,A00,202859,Staff,74,0,90,16
1683305878820,MGT 18GS,A00,202860,McKay; Michael J,13,0,28,15
1683305879849,MGT 45,A00,202861,Pecore; Joseph P.,14,0,90,76
1683305880875,MGT 100,A00,202863,Yavorsky; Daniel Ryan,28,0,90,62
1683305881903,MGT 103,A00,202864,Ehrich; Kristine R,0,16,90,90
1683305882928,MGT 112,A00,202865,Ehrich; Kristine R,15,0,90,75
1683305883961,MGT 121A,A00,202868,Staff,0,19,0,0
1683305884985,MGT 131B,A00,202869,Anderson; John Charles,59,0,90,31
1683305886013,MGT 136,A00,202871,Lindenberger; Wade Douglas,84,0,90,6
1683305887037,MGT 164,A00,202873,Staff,0,69,90,90
1683305888064,MGT 164GS,A00,202874,McKay; Mary A,13,0,28,15
1683305889089,MGT 180,A00,202875,Staff,0,51,90,90
1683305890113,MMW 11R,A01,205019,Herbst; Matthew,3,0,30,27
1683305890113,MMW 11R,A02,205026,Herbst; Matthew,29,0,30,1
1683305891140,MMW 15,A01,193512,Chang; Edmond Yi-Teh,0,9,28,28
1683305891140,MMW 15,A02,193513,Chang; Edmond Yi-Teh,0,5,28,28
1683305891140,MMW 15,A03,193514,Chang; Edmond Yi-Teh,0,5,28,28
1683305891140,MMW 15,A04,193515,Chang; Edmond Yi-Teh,0,4,28,28
1683305891140,MMW 15,A05,193516,Chang; Edmond Yi-Teh,0,4,28,28
1683305891140,MMW 15,A06,193517,Chang; Edmond Yi-Teh,0,5,28,28
1683305891140,MMW 15,B01,193519,Chang; Edmond Yi-Teh,0,4,28,28
1683305891140,MMW 15,B02,193520,Chang; Edmond Yi-Teh,0,5,28,28
1683305891140,MMW 15,B03,193521,Chang; Edmond Yi-Teh,0,4,28,28
1683305891140,MMW 15,B04,193522,Chang; Edmond Yi-Teh,0,4,28,28
1683305891140,MMW 15,B05,193523,Chang; Edmond Yi-Teh,0,5,28,28
1683305891140,MMW 15,B06,193524,Chang; Edmond Yi-Teh,0,4,28,28
1683305892164,MMW 122,A01,193526,Rahimi; Babak,0,14,28,28
1683305892164,MMW 122,A02,193527,Rahimi; Babak,0,14,28,28
1683305892164,MMW 122,A03,193528,Rahimi; Babak,0,0,0,0
1683305892164,MMW 122,A04,193529,Rahimi; Babak,0,0,0,0
1683305893190,MUS 1A,A01,186663,Staff,0,20,35,35
1683305894270,MUS 4,A01,186715,Staff,0,12,35,35
1683305895296,MUS 5R,A01,186796,Dubnov; Shlomo,0,17,35,35
1683305896320,MUS 6,A01,186798,Staff,0,3,25,25
1683305897347,MUS 7,A01,186830,Staff,12,0,35,23
1683305898372,MUS 8,A01,186930,Staff,0,26,35,35
1683305899394,MUS 15,A01,186932,Staff,0,15,35,35
1683305899394,MUS 15,B01,186934,Staff,0,15,35,35
1683305900420,MUS 80,A00,186935,Staff,2,0,20,18
1683305900420,MUS 80,B00,186936,Staff,25,0,25,0
1683305901447,NANO 11,A00,204702,Lipomi; Darren John,0,0,0,0
1683305902471,NANO 15,A01,204709,Yang; Kesong,0,1,0,0
1683305903499,NANO 114,A00,202069,Jahed Motlagh; Zeinab,3,0,10,7
1683305904526,PHIL 1,A00,186955,Grush; Rick Scott,32,0,40,8
1683305905553,PHIL 10,A01,186973,Grush; Rick Scott,28,0,35,7
1683305905553,PHIL 10,A02,186974,Grush; Rick Scott,33,0,35,2
1683305906584,PHIL 13,A01,186976,Staff,7,0,35,28
1683305906584,PHIL 13,A02,186977,Staff,16,0,35,19
1683305907609,PHIL 14,A01,186979,Staff,31,0,35,4
1683305907609,PHIL 14,A02,186986,Staff,32,0,35,3
1683305908636,PHIL 28,A01,186988,Staff,16,0,30,14
1683305908636,PHIL 28,A02,186989,Staff,1,0,30,29
1683305908636,PHIL 28,A03,186990,Staff,9,0,30,21
1683305908636,PHIL 28,A04,186991,Staff,26,0,30,4
1683305909660,PHIL 120,A00,186997,Staff,23,0,40,17
1683305910684,PHIL 137,A00,187003,Staff,9,0,40,31
1683305911709,PHIL 150,A00,187015,Staff,47,0,70,23
1683305912738,PHIL 167,A00,187021,Lamey; Andy M.,35,0,40,5
1683305913761,PHIL 174,A01,202226,Staff,17,0,20,3
1683305913761,PHIL 174,A02,202235,Staff,20,0,20,0
1683305914785,PHIL 191A,A00,258918,Staff,0,0,1,1
1683305915812,PHYS 1A,A00,187028,Staff,26,0,60,34
1683305916835,PHYS 1AL,001,187036,Staff,2,0,30,28
1683305916835,PHYS 1AL,002,187049,Staff,18,0,30,12
1683305917860,PHYS 1B,A00,187058,Staff,23,0,60,37
1683305918887,PHYS 1BL,001,187064,Staff,0,0,30,30
1683305918887,PHYS 1BL,002,187070,Staff,6,0,30,24
1683305919911,PHYS 1C,A00,187082,Staff,31,0,120,89
1683305920940,PHYS 1CL,001,187088,Staff,0,9,30,30
1683305920940,PHYS 1CL,002,187089,Staff,0,2,30,30
1683305920940,PHYS 1CL,009,262693,Staff,11,0,30,19
1683305921967,PHYS 2B,A01,187097,Staff,54,0,115,61
1683305922998,PHYS 2C,A01,187099,Staff,67,0,115,48
1683305924027,PHYS 2CL,A01,187101,Staff,5,0,28,23
1683305924027,PHYS 2CL,A02,187102,Staff,15,0,28,13
1683305925052,PHYS 2D,A01,187123,Shotwell; Brian,95,0,115,20
1683305926078,PHYS 4B,A01,187133,Grinstein; Benjamin,35,0,50,15
1683305927103,POLI 10,A00,188819,Staff,0,3,50,50
1683305928128,POLI 11,A00,188827,Staff,43,0,50,7
1683305929151,POLI 13R,A00,188828,Staff,0,1,20,20
1683305930178,POLI 27,A01,188830,Elgin; Samuel Zincke,0,1,70,70
1683305931206,POLI 30,A00,188832,Desposato; Scott,33,0,50,17
1683305932228,POLI 102F,A00,188834,Staff,3,0,40,37
1683305933252,POLI 104A,A00,188852,Staff,14,0,30,16
1683305934280,POLI 104I,A00,188853,Staff,0,6,20,20
1683305935306,POLI 110B,A00,188854,Wiens; David,7,0,20,13
1683305936332,POLI 112A,A00,188855,Wiens; David,5,0,30,25
1683305937357,POLI 117R,A00,188856,Forman; Fonna,0,11,20,20
1683305938381,POLI 118,A00,188857,Ingham; Sean,8,0,20,12
1683305939404,POLI 120G,A00,188858,Staff,9,0,30,21
1683305940427,POLI 131CR,A00,188863,Hoston; Germaine,24,0,50,26
1683305941455,POLI 133,A00,188864,Nellis; Gareth Hb,44,0,50,6
1683305942479,POLI 134D,A00,188865,Desposato; Scott,27,0,30,3
1683305943506,POLI 142A,A00,188871,Gartzke; Erik,22,0,50,28
1683305944529,POLI 142K,A00,188874,Staff,38,0,50,12
1683305945552,POLI 143,A00,188940,Gartzke; Erik,16,0,30,14
1683305946579,POLI 153,A00,188943,Staff,3,0,20,17
1683305947604,POLI 160AA,A00,188944,Staff,13,0,40,27
1683305948631,POLI 170A,A00,188945,Staff,11,0,30,19
1683305950683,PSYC 1,A00,188952,Staff,38,0,90,52
1683305951708,PSYC 2,B00,188953,Staff,20,0,35,15
1683305952733,PSYC 6,A00,188970,Staff,47,0,60,13
1683305953760,PSYC 7,A00,188973,Staff,37,0,45,8
1683305954788,PSYC 60,A01,188980,Rickard; Timothy C.,43,0,60,17
1683305955814,PSYC 70,A01,189001,Steiner; Eric Tomas,24,0,45,21
1683305956838,PSYC 100,A00,189005,Lacefield; Katharine I,0,99,120,120
1683305957862,PSYC 102,A00,189008,Staff,10,0,30,20
1683305958886,PSYC 106,B00,189026,Gorman; Michael R.,37,0,60,23
1683305959914,PSYC 114,B01,189033,Winkielman; Piotr,0,32,30,30
1683305960937,PSYC 131,A00,189036,Anagnostaras; Stephan,0,43,60,60
1683305961964,PSYC 136,A00,189041,Lowe; Angela Beth,0,7,25,25
1683305962987,PSYC 137,A00,189057,Winkielman; Piotr,0,34,25,25
1683305964012,PSYC 144,A00,189107,Wixted; John T,0,7,50,50
1683305966064,PSYC 162,A00,189142,Staff,0,8,85,85
1683305967091,PSYC 172,A00,189144,Gorman; Michael R.,0,7,30,30
1683305969141,PSYC 179,A00,189146,Lacefield; Katharine I,0,84,120,120
1683305970166,PSYC 181,A00,189147,Anagnostaras; Stephan,0,44,90,90
1683305971189,PSYC 190R,A00,189148,Barner; David A.,0,22,80,80
1683305972216,PSYC 191,A00,189275,Rickard; Timothy C.,0,7,25,25
1683305973240,PSYC 193,A00,189276,Chapman; Eddie Nathaniel,0,1,0,4
1683305974264,PSYC 193L,A01,189281,Lowe; Angela Beth,12,0,20,8
1683305974264,PSYC 193L,B01,189285,Staff,28,0,35,7
1683305975291,RELI 149,A00,187137,Rahimi; Babak,7,0,40,33
1683305976316,SE 9,A01,187315,Staff,0,2,18,18
1683305977339,SE 101B,A00,187409,Staff,24,0,30,6
1683305978366,SE 110B,A00,187444,Staff,10,0,40,30
1683305979394,SE 130B,A00,187449,Staff,31,0,40,9
1683305980417,SE 150A,A00,187516,Staff,9,0,20,11
1683305981442,SE 154,A00,187528,Staff,30,0,50,20
1683305982465,SIO 3,A01,258171,Staff,35,0,40,5
1683305983489,SIO 10,A00,187144,Cook; Geoffrey W,0,3,75,75
1683305984516,SIO 45,A00,187152,Cook; Geoffrey W,1,0,100,99
1683305985542,SIO 109R,A00,194486,Staff,0,3,20,20
1683305987590,SIO 187,A01,187233,Kacev; David,12,0,40,28
1683305988615,SOCI 1,A01,258656,Thorpe; Charles Robert,28,0,30,2
1683305988615,SOCI 1,A02,258658,Thorpe; Charles Robert,30,0,30,0
1683305988615,SOCI 1,A03,258661,Thorpe; Charles Robert,25,0,25,0
1683305988615,SOCI 1,A04,258666,Thorpe; Charles Robert,22,0,25,3
1683305988615,SOCI 1,A05,258897,Thorpe; Charles Robert,23,0,25,2
1683305988615,SOCI 1,A06,258898,Thorpe; Charles Robert,25,0,25,0
1683305989639,SOCI 30,A01,258903,Pardo Guerra; Juan Pablo,16,0,30,14
1683305990665,SOCI 102,A00,258904,Staff,9,0,25,16
1683305991691,SOCI 106,A00,258905,Staff,19,0,25,6
1683305992714,SOCI 111,A00,258907,Ribas Norris; Janet Vanesa,26,0,30,4
1683305993741,SOCI 121R,A00,258908,Pardo Guerra; Juan Pablo,11,0,30,19
1683305994765,SOCI 126,A01,203330,Staff,14,0,20,6
1683305995789,SOCI 131,A00,258909,Thorpe; Charles Robert,31,0,60,29
1683305996815,SOCI 135,A00,258910,Payne; Christine Anna,0,9,30,30
1683305997915,SOCI 157,A00,258911,Staff,13,0,30,17
1683305998940,SOCI 184,A00,258912,Staff,26,0,30,4
1683305999968,SOCI 188D,A00,258913,Staff,21,0,30,9
1683306000996,SYN 2,001,187529,Staff,9,0,16,7
1683306000996,SYN 2,002,201452,Staff,0,18,16,16
1683306000996,SYN 2,003,201469,Staff,3,0,16,13
1683306002029,SYN 100,A01,187531,Staff,0,9,20,20
1683306002029,SYN 100,B01,201491,Staff,0,12,20,20
1683306003053,TDAC 1,A00,189286,Walsh; Kim C.,3,0,20,17
1683306003053,TDAC 1,B00,189287,Harting; Carla Kelso,11,0,20,9
1683306004079,TDAC 101,A00,189300,Walsh; Kim C.,16,0,20,4
1683306004079,TDAC 101,B00,189301,Harting; Carla Kelso,18,0,20,2
1683306005103,TDAC 102,A00,189304,Basso; Beatrice,14,0,20,6
1683306006127,TDAC 108,A00,189305,Staff,18,0,20,2
1683306007155,TDDE 131,A00,189310,Staff,19,0,20,1
1683306007155,TDDE 131,B00,189314,Staff,19,0,20,1
1683306007155,TDDE 131,C00,189315,Staff,48,0,50,2
1683306007155,TDDE 131,D00,189316,Staff,14,0,15,1
1683306007155,TDDE 131,E00,204841,Staff,20,0,20,0
1683306008178,TDGE 10,A00,189289,Staff,30,0,50,20
1683306008178,TDGE 10,B00,189290,Havis; Allan,2,0,50,48
1683306009201,TDGE 11,A00,189291,Fulton; Julia,0,3,50,50
1683306009201,TDGE 11,B00,189292,Staff,20,0,25,5
1683306009201,TDGE 11,C00,260270,Staff,0,0,0,0
1683306010225,TDGE 25,A00,189294,Staff,3,0,20,17
1683306011250,TDGE 124,A00,189318,Fulton; Julia,0,8,50,50
1683306012272,TDGE 125,A00,189319,Staff,13,0,25,12
1683306012272,TDGE 125,B00,189320,Staff,23,0,25,2
1683306013298,TDGE 127,A00,189322,Havis; Allan,0,0,50,50
1683306014321,TDHT 101,A00,189323,Staff,18,0,25,7
1683306014321,TDHT 101,B00,189324,Staff,25,0,25,0
1683306015344,TDHT 102,A00,189325,Staff,49,0,50,1
1683306016367,TDMV 1,A00,189295,Arcidiacono; Kristin,20,0,30,10
1683306016367,TDMV 1,B00,189296,Caligagan; Maria T.,24,0,30,6
1683306017394,TDMV 2,A00,189297,Sammartano; Tonnie,28,0,30,2
1683306017394,TDMV 2,B00,189299,Arcidiacono; Kristin,24,0,30,6
1683306018420,TDMV 3,A00,204998,Rincon; Alicia,22,0,30,8
1683306019446,TDMV 120,A00,189458,Sammartano; Tonnie,28,0,30,2
1683306020475,TDMV 138,A00,189541,Jun; Grace Shin Hae,22,0,40,18
1683306021502,TDMV 142,A00,189717,Caligagan; Tony,23,0,30,7
1683306021502,TDMV 142,B00,189718,Caligagan; Maria T.,25,0,30,5
1683306022526,TMC 2,A01,187533,Staff,25,0,25,0
1683306022526,TMC 2,A02,187534,Staff,25,0,25,0
1683306023553,USP 1,A01,187536,Kwak; Nancy,0,16,25,25
1683306024575,USP 5,A01,187538,Staff,9,0,25,16
1683306025598,USP 101,A00,199253,Staff,0,4,0,0
1683306026623,USP 124,A00,187562,Boomhower; Matthew Charles,1,0,30,29
1683306027651,USP 138,A00,187582,Staff,20,0,25,5
1683306028675,USP 152,A01,187597,Staff,4,0,25,21
1683306029698,USP 153,A00,187598,Staff,19,0,25,6
1683306030724,USP 168,A00,187607,Kwak; Nancy,2,0,5,3
1683306031748,USP 173,A00,187619,Staff,4,0,25,21
1683306032772,USP 181,A00,187638,Staff,0,0,25,25
1683306033804,VIS 103,A00,187650,Cruz; Edwin Teddy,23,0,75,52
1683306034831,VIS 110D,A00,187669,Staff,12,0,22,10
1683306035857,VIS 127C,A00,187720,Shen; Kuiyi,68,0,146,78
1683306036880,VIS 149,A00,187731,Yoldas; Pinar,0,14,22,22
1683306037908,VIS 151,A01,188091,Staff,22,0,34,12
1683306037908,VIS 151,A02,188092,Staff,11,0,34,23
1683306038936,VIS 160B,A00,188093,Stalbaum; Brett,0,0,10,10
1683306040984,WCWP 10B,A00,201720,Staff,10,0,15,5
1683306040984,WCWP 10B,B00,201722,Staff,8,0,15,7
1683306042011,WCWP 100,A00,201725,Gagnon; Jeffrey C,0,0,2,2
1683306042011,WCWP 100,B00,201727,Staff,0,4,15,15
1683306045187,ANBI 133,A00,258401,Wilder; Linnea Lorene,34,0,40,6
1683306046214,ANBI 140,A00,258395,Hrvoj Mihic; Branka,18,0,25,7
1683306047240,ANSC 120,A00,258402,Bialecki; Jon Anthony,27,0,40,13
1683306048265,ANSC 144,A00,258400,Staff,14,0,40,26
1683306050317,ANSC 166,A00,258396,Parish; Steven Martin,157,0,175,18
1683306051343,ANSC 180,A00,193533,Staff,9,0,20,11
1683306052365,ANSC 188,A00,258397,Jassal; Aftab,33,0,40,7
1683306053393,ANTH 3,A01,258316,Staff,23,0,30,7
1683306054419,ANTH 5,A00,258394,Semendeferi; Ekaterini,16,0,20,4
1683306055446,ANTH 21,A01,258331,Staff,9,0,40,31
1683306056472,ANTH 103,A00,258398,Varma; Saiba,15,0,25,10
1683306057503,AWP 10,001,202034,Staff,0,0,0,0
1683306057503,AWP 10,002,202035,Staff,0,0,0,0
1683306057503,AWP 10,003,202036,Staff,0,0,0,0
1683306057503,AWP 10,004,202037,Staff,0,0,0,0
1683306057503,AWP 10,005,202038,Staff,0,0,0,0
1683306057503,AWP 10,006,202039,Staff,0,0,0,0
1683306057503,AWP 10,007,202040,Staff,0,0,0,0
1683306057503,AWP 10,008,202041,Staff,0,0,0,0
1683306057503,AWP 10,009,202042,Staff,0,0,0,0
1683306057503,AWP 10,010,202043,Staff,0,0,0,0
1683306057503,AWP 10,011,202044,Staff,0,0,0,0
1683306057503,AWP 10,012,202045,Staff,0,0,0,0
1683306057503,AWP 10,013,202046,Staff,0,0,0,0
1683306057503,AWP 10,014,202047,Staff,0,0,0,0
1683306057503,AWP 10,015,202048,Staff,0,0,0,0
1683306057503,AWP 10,016,202049,Staff,0,0,0,0
1683306057503,AWP 10,017,202050,Staff,0,0,0,0
1683306057503,AWP 10,018,202051,Staff,0,0,0,0
1683306057503,AWP 10,019,202052,Staff,0,0,0,0
1683306057503,AWP 10,020,202053,Staff,0,0,0,0
1683306057503,AWP 10,021,202054,Staff,0,0,0,0
1683306057503,AWP 10,022,202055,Staff,0,0,0,0
1683306057503,AWP 10,023,202056,Staff,0,0,0,0
1683306057503,AWP 10,024,202057,Staff,0,0,0,0
1683306057503,AWP 10,025,202058,Staff,0,0,0,0
1683306057503,AWP 10,026,202059,Staff,0,0,0,0
1683306058527,AWP 102,001,202032,Staff,0,0,0,0
1683306058527,AWP 102,002,202033,Staff,0,0,0,0
1683306059554,BENG 100,A01,254234,Taylor Amos; Alyssa C,31,0,40,9
1683306060577,BENG 196,001,270013,Engler; Adam J.,9999,0,9999,0
1683306061626,BICD 100R,A01,202018,Smith; Laurie,0,7,32,32
1683306061626,BICD 100R,A02,202019,Smith; Laurie,0,2,32,32
1683306061626,BICD 100R,A03,202020,Smith; Laurie,0,1,32,32
1683306061626,BICD 100R,A04,202021,Smith; Laurie,8,0,32,24
1683306061626,BICD 100R,A05,202022,Smith; Laurie,12,0,32,20
1683306062657,BICD 136,A01,193242,Gustafson-Brown; Cindy,0,2,32,32
1683306062657,BICD 136,A02,193244,Gustafson-Brown; Cindy,15,0,32,17
1683306063686,BIEB 102,A01,193249,Butler; Shannon Rhey,0,2,32,32
1683306063686,BIEB 102,A02,193251,Butler; Shannon Rhey,0,0,32,32
1683306063686,BIEB 102,A03,193253,Butler; Shannon Rhey,0,1,32,32
1683306063686,BIEB 102,A04,193255,Butler; Shannon Rhey,17,0,32,15
1683306063686,BIEB 102,A05,193265,Butler; Shannon Rhey,26,0,32,6
1683306063686,BIEB 102,A06,193269,Butler; Shannon Rhey,16,0,32,16
1683306065739,BIEB 150,A01,193274,Staff,0,0,32,32
1683306065739,BIEB 150,A02,193285,Staff,24,0,32,8
1683306066763,BIEB 194,A00,193286,Kurle; Carolyn M.,22,0,32,10
1683306067792,BILD 1,A01,192291,Staff,16,0,32,16
1683306067792,BILD 1,A02,192292,Staff,30,0,32,2
1683306067792,BILD 1,B01,192520,Reuther; Keefe,0,1,0,0
1683306067792,BILD 1,B02,192532,Reuther; Keefe,0,1,0,0
1683306068816,BILD 3,A01,192556,Butler; Shannon Rhey,0,0,32,32
1683306068816,BILD 3,A02,192581,Butler; Shannon Rhey,5,0,32,27
1683306068816,BILD 3,A03,192611,Butler; Shannon Rhey,23,0,32,9
1683306068816,BILD 3,A04,192612,Butler; Shannon Rhey,25,0,32,7
1683306068816,BILD 3,A05,192613,Butler; Shannon Rhey,27,0,32,5
1683306068816,BILD 3,A06,192679,Butler; Shannon Rhey,27,0,32,5
1683306068816,BILD 3,A07,192682,Butler; Shannon Rhey,22,0,32,10
1683306069843,BILD 4,A01,192836,Reuther; Keefe,1,0,24,23
1683306069843,BILD 4,A02,193044,Reuther; Keefe,4,0,24,20
1683306070866,BILD 10,A01,193142,Gustafson-Brown; Cindy,31,0,32,1
1683306070866,BILD 10,A02,193149,Gustafson-Brown; Cindy,31,0,32,1
1683306071894,BIMM 100,A01,193301,Staff,0,6,32,32
1683306071894,BIMM 100,A02,193312,Staff,0,5,32,32
1683306071894,BIMM 100,A03,193323,Staff,0,8,32,32
1683306072920,BIMM 101,A01,193329,McDonnell; Lisa Marie,0,3,24,24
1683306072920,BIMM 101,A02,193339,McDonnell; Lisa Marie,0,2,24,24
1683306072920,BIMM 101,B01,193354,McDonnell; Lisa Marie,0,3,24,24
1683306072920,BIMM 101,B02,193357,McDonnell; Lisa Marie,0,3,24,24
1683306073948,BIMM 110,A01,193377,Tat; John,0,11,32,32
1683306073948,BIMM 110,A02,193378,Tat; John,1,9,32,31
1683306074973,BIMM 120,A01,206116,Staff,0,0,32,32
1683306074973,BIMM 120,A02,206117,Staff,8,0,32,24
1683306074973,BIMM 120,A03,206121,Staff,21,0,32,11
1683306076001,BIPN 100,A01,193393,Park; Ji Young,0,14,32,32
1683306076001,BIPN 100,A02,193402,Park; Ji Young,0,12,32,32
1683306076001,BIPN 100,A03,193413,Park; Ji Young,0,14,32,32
1683306076001,BIPN 100,A04,193414,Park; Ji Young,0,13,32,32
1683306077029,BIPN 102,A01,193429,Staff,0,0,32,32
1683306077029,BIPN 102,A02,193438,Staff,23,0,32,9
1683306078053,BIPN 106,A01,193450,Reyes Gonzalez; Catalina,0,2,40,40
1683306079078,BIPN 134,A01,193465,Cooke; James Edward,0,0,32,32
1683306079078,BIPN 134,A02,193474,Cooke; James Edward,27,0,32,5
1683306079078,BIPN 134,A03,193485,Cooke; James Edward,29,0,32,3
1683306079078,BIPN 134,A04,193486,Cooke; James Edward,21,0,32,11
1683306079078,BIPN 134,A05,193491,Cooke; James Edward,31,0,32,1
1683306079078,BIPN 134,A06,193501,Cooke; James Edward,30,0,32,2
1683306079078,BIPN 134,A07,193510,Cooke; James Edward,29,0,32,3
1683306081127,BISP 194,A00,222522,Staff,16,0,32,16
1683306082154,CAT 124,A01,202407,Staff,20,0,25,5
1683306083180,CAT 125,A00,202408,Marchisotto; Jennifer Anne,4,0,20,16
1683306084212,CAT 125R,A00,202409,Smith; Lauryn Alissa,0,11,20,20
1683306084212,CAT 125R,B00,202410,Morales; Celeste Georgianna,0,11,20,20
1683306084212,CAT 125R,C00,202411,Irwin; Matthew Joseph,0,10,20,20
1683306085236,CENG 15,A01,204712,Yang; Kesong,0,1,0,0
1683306086264,CENG 114,A00,202070,Jahed Motlagh; Zeinab,5,0,20,15
1683306087288,CGS 105,A00,185477,Wesling; Megan E.,24,0,40,16
1683306088309,CGS 106,A00,185494,Staff,13,0,22,9
1683306089336,CGS 108,A00,185495,Staff,14,0,20,6
1683306090362,CGS 114,A00,185496,Staff,13,0,18,5
1683306091388,CGS 119,A00,185501,Staff,15,0,20,5
1683306092415,CGS 120,A00,185511,Staff,13,0,20,7
1683306093443,CHEM 4,A01,184675,Bussey; Thomas J,96,0,100,4
1683306094468,CHEM 6A,A01,184677,Staff,35,0,60,25
1683306095492,CHEM 6B,A01,184679,Staff,65,0,100,35
1683306096516,CHEM 6C,A01,184681,Bussey; Thomas J,1,0,50,49
1683306096516,CHEM 6C,A02,184682,Bussey; Thomas J,34,0,50,16
1683306097540,CHEM 40A,A01,184684,Albizati; Kim F.,37,0,100,63
1683306098572,CHEM 40B,A01,184686,Albizati; Kim F.,0,20,100,100
1683306099596,CHEM 41B,A01,184690,Staff,52,0,100,48
1683306100621,COGS 3,A01,184715,Boyle; Mary E. T.,0,25,40,40
1683306101699,COGS 14B,A01,185172,Staff,0,15,38,38
1683306102727,COGS 18,A01,184736,Staff,20,0,80,60
1683306103750,COGS 100,A01,184932,Staff,0,5,73,73
1683306104774,COGS 101A,A01,184935,Staff,0,38,30,30
1683306105801,COGS 101B,A01,184944,Staff,0,2,30,30
1683306106829,COGS 101C,A01,184946,Staff,0,12,30,30
1683306107856,COGS 102A,A01,184951,Johnson; Christine M.,2,0,40,38
1683306108881,COGS 107B,A01,184953,Mooshagian; Eric Frederick,0,50,40,40
1683306109909,COGS 118B,A01,184959,Gupta; Anjum,0,48,40,40
1683306110936,COGS 153,A00,184961,Staff,0,15,30,30
1683306111963,COGS 177,A00,184962,Staff,0,21,30,30
1683306112987,COGS 187A,A01,184969,Boyle; Mary E. T.,0,17,40,40
1683306114012,COMM 10,A01,185174,Staff,0,5,25,25
1683306114012,COMM 10,A02,185189,Staff,0,5,25,25
1683306114012,COMM 10,A03,269821,Staff,0,0,0,0
1683306115037,COMM 100B,A01,185475,Staff,0,0,0,2
1683306115037,COMM 100B,A02,185476,Staff,14,0,25,11
1683306116064,COMM 100C,A01,185314,Staff,1,0,25,24
1683306116064,COMM 100C,A02,185327,Staff,19,0,25,6
1683306117088,COMM 110M,A00,185349,Staff,2,0,40,38
1683306118115,COMM 113T,A00,185352,Staff,25,0,40,15
1683306119139,COMM 114I,A00,185353,Staff,33,0,40,7
1683306120164,COMM 131,A00,185354,Staff,19,0,30,11
1683306121194,CSE 8A,A50,185358,Cao; Yingjun,0,46,10,10
1683306122222,CSE 8B,A01,185362,Staff,1,47,50,49
1683306123247,CSE 11,A01,185416,Cao; Yingjun,0,93,10,10
1683306124271,CSE 20,A01,185445,Briones; Jor-el Thomas Caparas,5,0,25,20
1683306125296,CSE 21,A01,185447,Staff,10,0,50,40
1683306126322,CSE 101,A01,185451,Staff,0,12,50,50
1683306126322,CSE 101,B01,185453,Jones; Miles E,0,11,50,50
1683306128372,CSE 141,A01,185458,Eldon; John,20,0,100,80
1683306129399,CSE 141L,A01,185461,Eldon; John,12,0,100,88
1683306130423,CSE 142,A01,185463,Staff,35,0,60,25
1683306130423,CSE 142,B01,201355,Staff,0,6,60,60
1683306131452,CSE 142L,A01,185470,Staff,35,0,60,25
1683306131452,CSE 142L,B01,201417,Staff,0,5,60,60
1683306132477,CSE 190,A00,201433,Staff,32,0,49,17
1683306133506,DOC 1,A01,259136,Strom; Megan C.,8,0,15,7
1683306133506,DOC 1,A02,259137,Strom; Megan C.,14,0,15,1
1683306133506,DOC 1,A03,259138,Strom; Megan C.,14,0,15,1
1683306133506,DOC 1,A04,259139,Strom; Megan C.,14,0,15,1
1683306134531,DOC 100D,A00,259140,Pass; Natalye Joann,17,0,25,8
1683306135559,DSGN 1,A01,184749,Rill; Bryan,0,24,30,30
1683306136583,DSGN 100,A01,185168,Staff,0,2,25,25
1683306137607,ECE 5,A01,185626,Morris; Karcher William,0,10,0,0
1683306138634,ECE 101,A01,185628,Staff,17,0,70,53
1683306139663,ECE 107,A01,185635,Baghdadchi; Saharnaz,0,0,20,20
1683306139663,ECE 107,A02,185638,Baghdadchi; Saharnaz,4,0,20,16
1683306140687,ECE 148,A01,185647,Silberman; Jack,0,0,16,16
1683306141714,ECON 1,A01,185537,Crane; Meredith Helen,54,0,70,16
1683306142741,ECON 3,A01,185549,Crane; Meredith Helen,33,0,70,37
1683306143769,ECON 4,A01,203354,Anderson; John Charles,0,4,10,10
1683306144795,ECON 100A,A01,185574,Staff,0,4,40,40
1683306145825,ECON 100B,A01,185576,Staff,0,22,40,40
1683306146849,ECON 100C,A01,185589,Newhouse; Herbert S,30,0,70,40
1683306147875,ECON 105,A00,185608,Vespa; Emanuel Ignacio,19,0,35,16
1683306148901,ECON 109,A01,185610,Shishkin; Denis,10,0,35,25
1683306149927,ECON 110A,A01,185612,Staff,11,0,40,29
1683306150953,ECON 120A,A01,185615,Staff,20,0,40,20
1683306151981,ECON 120C,A01,185617,Sun; Yixiao,0,20,70,70
1683306153009,ECON 144,A00,203346,Squires; Dale E,3,0,35,32
1683306154034,ECON 171,A01,203349,Newhouse; Herbert S,0,1,35,35
1683306155063,ECON 173A,A01,185621,Toda; Alexis Akira,21,0,35,14
1683306156094,EDS 25,A01,202413,Staff,0,1,0,0
1683306156094,EDS 25,A02,202414,Staff,0,1,0,0
1683306156094,EDS 25,A03,202415,Staff,0,0,0,0
1683306156094,EDS 25,A04,202416,Staff,0,1,0,0
1683306156094,EDS 25,A05,202439,Staff,0,0,0,0
1683306156094,EDS 25,A06,202440,Staff,0,0,0,0
1683306156094,EDS 25,B01,202631,Staff,0,0,0,0
1683306156094,EDS 25,B02,202632,Staff,0,0,0,0
1683306156094,EDS 25,B03,202639,Staff,0,0,0,0
1683306156094,EDS 25,B04,202640,Staff,0,0,0,0
1683306156094,EDS 25,B05,202643,Staff,0,0,0,0
1683306156094,EDS 25,B06,202644,Staff,0,0,0,0
1683306157122,EDS 38,A01,202659,Black; Alison Michelle,24,0,25,1
1683306158149,EDS 115,A00,202652,Staff,17,0,30,13
1683306159173,EDS 125,A00,202649,Staff,14,0,30,16
1683306160199,EDS 126,A01,203332,Staff,30,0,30,0
1683306161224,EDS 139,A00,202838,Staff,17,0,25,8
1683306162249,EDS 146,A01,202655,Staff,15,0,25,10
1683306163277,ENG 15,A00,185667,Staff,0,1,0,0
1683306163277,ENG 15,B00,185672,Staff,0,0,0,0
1683306163277,ENG 15,C00,185675,Staff,0,0,0,0
1683306163277,ENG 15,D00,185682,Staff,0,0,0,0
1683306163277,ENG 15,E00,185684,Staff,0,0,0,0
1683306164304,ETHN 103,A00,185710,Staff,0,3,35,35
1683306165327,ETHN 103A,A00,199228,Man; Simeon S,2,0,9,7
1683306166350,ETHN 109,A00,185711,Staff,18,0,35,17
1683306167374,ETHN 142,A00,185726,Staff,0,4,30,30
1683306168398,ETHN 163J,A00,199229,Man; Simeon S,6,0,8,2
1683306169421,ETHN 168,A00,185727,Staff,8,0,10,2
1683306170445,ETHN 182,A00,185728,Staff,1,0,35,34
1683306171468,ETHN 183,A00,185737,Staff,8,0,18,10
1683306172496,GLBH 111,A01,209361,Burgos; Jose L.,0,0,0,0
1683306174546,HIEU 104,A00,185792,Staff,16,0,20,4
1683306175573,HIEU 115,A00,185800,Staff,1,0,20,19
1683306176597,HIEU 128,A00,185801,Staff,0,7,20,20
1683306177623,HIEU 147,A00,185802,Staff,16,0,20,4
1683306178649,HIEU 154,A00,185823,Staff,12,0,20,8
1683306179677,HILA 102,A00,185826,Staff,13,0,20,7
1683306180704,HILD 2C,A01,185778,Staff,0,12,20,20
1683306181729,HILD 7B,A01,185780,Kwak; Nancy,0,15,32,32
1683306181729,HILD 7B,A02,185781,Kwak; Nancy,0,18,32,32
1683306182756,HILD 30,A01,185791,Staff,14,0,20,6
1683306183784,HISC 119,A00,185830,Golan; Tal,0,9,20,20
1683306184808,HITO 156GS,A00,185831,Patterson; Patrick H.,0,0,0,23
1683306185835,HIUS 103,A00,185832,Man; Simeon S,0,6,20,20
1683306186862,HIUS 117,A00,185836,Kwak; Nancy,2,0,20,18
1683306187890,HIUS 125,A00,185840,Man; Simeon S,0,0,23,23
1683306188989,HIUS 149,A00,185845,Staff,0,0,20,20
1683306190013,HUM 3,A01,185882,Zavodny; Tatiana Sophia,0,6,50,50
1683306190013,HUM 3,B01,185899,Caldwell; Michael Alan,0,19,50,50
1683306191040,HUM 3GS,A00,185900,Patterson; Patrick H.,0,0,0,23
1683306192068,HUM 4,A01,185938,Zroka; Amy Liane,30,0,50,20
1683306192068,HUM 4,B01,185956,Watkins; Eric,0,2,50,50
1683306192068,HUM 4,B02,202209,Watkins; Eric,0,1,50,50
1683306192068,HUM 4,B03,202210,Watkins; Eric,0,0,50,50
1683306193091,HUM 5,A01,185958,West; Geoffrey Scott,5,0,50,45
1683306193091,HUM 5,A02,202215,West; Geoffrey Scott,0,0,50,50
1683306194118,INTL 190,A00,185959,Gagnon; Jeffrey C,0,0,0,9
1683306194118,INTL 190,B00,185960,Lettieri; Michael Joseph,0,0,0,1
1683306195140,JAPN 180,A00,254509,Staff,5,1,30,25
1683306196163,LATI 10,A01,202853,Kennemore; Amy Michelle,5,0,35,30
1683306196163,LATI 10,A02,202854,Kennemore; Amy Michelle,1,0,35,34
1683306196163,LATI 10,A03,270054,Kennemore; Amy Michelle,30,0,30,0
1683306197187,LATI 180,A00,202855,Kennemore; Amy Michelle,11,0,20,9
1683306198210,LAWS 101,A00,201767,Golan; Tal,0,7,40,40
1683306199236,LIFR 1C,A00,185961,Staff,6,0,20,14
1683306200263,LIFR 1CX,A00,185962,Staff,7,0,20,13
1683306201291,LIFR 1D,A00,185963,Staff,9,0,20,11
1683306202316,LIFR 1DX,A00,185964,Staff,9,0,20,11
1683306203339,LIGN 101,A01,186039,Staff,43,0,50,7
1683306204366,LIGN 165,A00,186040,Staff,18,0,50,32
1683306205446,LTCS 108,A00,186041,Staff,6,0,10,4
1683306206472,LTCS 119,A00,186042,Staff,16,0,20,4
1683306207495,LTCS 130,A00,186043,Wesling; Megan E.,15,0,25,10
1683306209545,LTEA 138,A00,186119,Staff,14,0,40,26
1683306210569,LTEN 124,A00,186148,Staff,6,0,25,19
1683306211595,LTEN 178,A00,186149,Staff,7,0,15,8
1683306212621,LTEN 181,A00,186150,Blanco; John D,33,0,40,7
1683306213647,LTWL 120,A00,186160,Staff,20,0,25,5
1683306214670,LTWL 165,A00,186161,Staff,22,0,25,3
1683306215697,LTWR 100,A00,186162,Staff,0,4,15,15
1683306216723,LTWR 102,A00,186163,Doller; Ben,5,0,15,10
1683306217747,MAE 8,A01,186412,Staff,0,0,0,0
1683306218775,MAE 30B,A00,186445,Bahadori; Mohammad Yousef,83,0,100,17
1683306219799,MAE 40,A00,186592,Bewley; Thomas R,9,0,50,41
1683306220822,MAE 101B,A00,186593,Bahadori; Mohammad Yousef,81,0,100,19
1683306221846,MAE 105,A00,186594,Bandaru; Prabhakar,12,0,50,38
1683306222870,MAE 107,A00,186599,Pham; Hieu Tan,0,6,120,120
1683306223894,MAE 148,A01,186660,Silberman; Jack,3,0,16,13
1683306224918,MATH 10A,A01,188095,Staff,0,7,35,35
1683306225944,MATH 10B,A01,188097,Bowers; Adam R.,0,11,30,30
1683306225944,MATH 10B,A02,188099,Bowers; Adam R.,0,9,30,30
1683306225944,MATH 10B,B01,188104,Bowers; Adam R.,0,11,30,30
1683306225944,MATH 10B,B02,188106,Bowers; Adam R.,0,11,30,30
1683306226969,MATH 10C,A01,188111,Staff,0,18,30,30
1683306226969,MATH 10C,A02,188127,Staff,0,17,30,30
1683306226969,MATH 10C,A03,188131,Staff,0,17,30,30
1683306226969,MATH 10C,B01,188218,Staff,21,0,30,9
1683306226969,MATH 10C,B02,188244,Staff,13,0,30,17
1683306226969,MATH 10C,B03,188277,Staff,16,0,30,14
1683306227997,MATH 18,A01,188344,Bach; Quang Tran,18,0,30,12
1683306227997,MATH 18,A02,188345,Bach; Quang Tran,11,0,30,19
1683306227997,MATH 18,B01,188353,Bach; Quang Tran,10,0,30,20
1683306227997,MATH 18,B02,188354,Bach; Quang Tran,20,0,30,10
1683306229020,MATH 20A,A01,188374,Staff,13,0,35,22
1683306230045,MATH 20B,A01,188382,Ohm; Ko Woon,6,0,30,24
1683306230045,MATH 20B,A02,188383,Ohm; Ko Woon,24,0,30,6
1683306230045,MATH 20B,B01,188385,Ohm; Ko Woon,7,0,30,23
1683306230045,MATH 20B,B02,188392,Ohm; Ko Woon,22,0,30,8
1683306231074,MATH 20C,A01,188394,Harel; Guershon,10,0,30,20
1683306231074,MATH 20C,A02,188395,Harel; Guershon,13,0,30,17
1683306231074,MATH 20C,B01,188404,Harel; Guershon,3,0,30,27
1683306231074,MATH 20C,B02,188405,Harel; Guershon,19,0,30,11
1683306232102,MATH 20D,A01,188414,Hammock; Frances H,0,1,30,30
1683306232102,MATH 20D,A02,188415,Hammock; Frances H,4,0,30,26
1683306232102,MATH 20D,B01,188447,Hammock; Frances H,2,0,30,28
1683306232102,MATH 20D,B02,188486,Hammock; Frances H,8,0,30,22
1683306233130,MATH 20E,A01,188649,Staff,22,0,30,8
1683306233130,MATH 20E,A02,188650,Staff,23,0,30,7
1683306233130,MATH 20E,A03,188673,Staff,0,0,30,30
1683306234157,MATH 102,A01,188675,Staff,0,35,35,35
1683306235184,MATH 103B,A01,188681,Staff,4,0,35,31
1683306235184,MATH 103B,B01,188692,Staff,7,0,35,28
1683306236213,MATH 109,A01,188695,Salehi Golsefidy; Alireza,25,0,35,10
1683306236213,MATH 109,A02,188696,Salehi Golsefidy; Alireza,27,0,35,8
1683306237238,MATH 120A,A01,188698,Eggers; John Dietrich,6,0,35,29
1683306238265,MATH 142B,A01,188736,Ioana; Adrian,0,2,30,30
1683306238265,MATH 142B,A02,188741,Ioana; Adrian,0,1,30,30
1683306238265,MATH 142B,A03,188743,Ioana; Adrian,0,3,30,30
1683306239290,MATH 168A,A01,188790,Staff,0,9,35,35
1683306240320,MATH 170A,A01,188803,Nie; Jiawang,0,2,35,35
1683306240320,MATH 170A,A02,188811,Nie; Jiawang,0,0,35,35
1683306240320,MATH 170A,A03,188814,Nie; Jiawang,1,0,35,34
1683306240320,MATH 170A,A04,188815,Nie; Jiawang,13,0,35,22
1683306241346,MATH 193B,A01,188817,Staff,0,0,35,35
1683306241346,MATH 193B,A02,188818,Staff,5,0,35,30
1683306242370,MGT 4,A01,202857,Anderson; John Charles,62,0,80,18
1683306243395,MGT 12,A00,202858,Lindenberger; Wade Douglas,43,0,90,47
1683306244420,MGT 18,A00,202859,Staff,74,0,90,16
1683306245446,MGT 18GS,A00,202860,McKay; Michael J,13,0,28,15
1683306246471,MGT 45,A00,202861,Pecore; Joseph P.,14,0,90,76
1683306247495,MGT 100,A00,202863,Yavorsky; Daniel Ryan,28,0,90,62
1683306248521,MGT 103,A00,202864,Ehrich; Kristine R,0,16,90,90
1683306249549,MGT 112,A00,202865,Ehrich; Kristine R,15,0,90,75
1683306250573,MGT 121A,A00,202868,Staff,0,19,0,0
1683306251602,MGT 131B,A00,202869,Anderson; John Charles,59,0,90,31
1683306252629,MGT 136,A00,202871,Lindenberger; Wade Douglas,84,0,90,6
1683306253654,MGT 164,A00,202873,Staff,0,69,90,90
1683306254679,MGT 164GS,A00,202874,McKay; Mary A,13,0,28,15
1683306255705,MGT 180,A00,202875,Staff,0,51,90,90
1683306256733,MMW 11R,A01,205019,Herbst; Matthew,3,0,30,27
1683306256733,MMW 11R,A02,205026,Herbst; Matthew,29,0,30,1
1683306257758,MMW 15,A01,193512,Chang; Edmond Yi-Teh,0,9,28,28
1683306257758,MMW 15,A02,193513,Chang; Edmond Yi-Teh,0,5,28,28
1683306257758,MMW 15,A03,193514,Chang; Edmond Yi-Teh,0,5,28,28
1683306257758,MMW 15,A04,193515,Chang; Edmond Yi-Teh,0,4,28,28
1683306257758,MMW 15,A05,193516,Chang; Edmond Yi-Teh,0,4,28,28
1683306257758,MMW 15,A06,193517,Chang; Edmond Yi-Teh,0,5,28,28
1683306257758,MMW 15,B01,193519,Chang; Edmond Yi-Teh,0,4,28,28
1683306257758,MMW 15,B02,193520,Chang; Edmond Yi-Teh,0,5,28,28
1683306257758,MMW 15,B03,193521,Chang; Edmond Yi-Teh,0,4,28,28
1683306257758,MMW 15,B04,193522,Chang; Edmond Yi-Teh,0,4,28,28
1683306257758,MMW 15,B05,193523,Chang; Edmond Yi-Teh,0,5,28,28
1683306257758,MMW 15,B06,193524,Chang; Edmond Yi-Teh,0,4,28,28
1683306258782,MMW 122,A01,193526,Rahimi; Babak,0,14,28,28
1683306258782,MMW 122,A02,193527,Rahimi; Babak,0,14,28,28
1683306258782,MMW 122,A03,193528,Rahimi; Babak,0,0,0,0
1683306258782,MMW 122,A04,193529,Rahimi; Babak,0,0,0,0
1683306259812,MUS 1A,A01,186663,Staff,0,20,35,35
1683306260835,MUS 4,A01,186715,Staff,0,12,35,35
1683306261859,MUS 5R,A01,186796,Dubnov; Shlomo,0,17,35,35
1683306262885,MUS 6,A01,186798,Staff,0,3,25,25
1683306263911,MUS 7,A01,186830,Staff,12,0,35,23
1683306264939,MUS 8,A01,186930,Staff,0,26,35,35
1683306265967,MUS 15,A01,186932,Staff,0,15,35,35
1683306265967,MUS 15,B01,186934,Staff,0,15,35,35
1683306266992,MUS 80,A00,186935,Staff,2,0,20,18
1683306266992,MUS 80,B00,186936,Staff,25,0,25,0
1683306268020,NANO 11,A00,204702,Lipomi; Darren John,0,0,0,0
1683306269045,NANO 15,A01,204709,Yang; Kesong,0,1,0,0
1683306270073,NANO 114,A00,202069,Jahed Motlagh; Zeinab,3,0,10,7
1683306271096,PHIL 1,A00,186955,Grush; Rick Scott,32,0,40,8
1683306272125,PHIL 10,A01,186973,Grush; Rick Scott,28,0,35,7
1683306272125,PHIL 10,A02,186974,Grush; Rick Scott,33,0,35,2
1683306273150,PHIL 13,A01,186976,Staff,7,0,35,28
1683306273150,PHIL 13,A02,186977,Staff,16,0,35,19
1683306274173,PHIL 14,A01,186979,Staff,31,0,35,4
1683306274173,PHIL 14,A02,186986,Staff,32,0,35,3
1683306275198,PHIL 28,A01,186988,Staff,16,0,30,14
1683306275198,PHIL 28,A02,186989,Staff,1,0,30,29
1683306275198,PHIL 28,A03,186990,Staff,9,0,30,21
1683306275198,PHIL 28,A04,186991,Staff,26,0,30,4
1683306276225,PHIL 120,A00,186997,Staff,23,0,40,17
1683306277248,PHIL 137,A00,187003,Staff,9,0,40,31
1683306278273,PHIL 150,A00,187015,Staff,47,0,70,23
1683306279301,PHIL 167,A00,187021,Lamey; Andy M.,35,0,40,5
1683306280329,PHIL 174,A01,202226,Staff,17,0,20,3
1683306280329,PHIL 174,A02,202235,Staff,20,0,20,0
1683306281355,PHIL 191A,A00,258918,Staff,0,0,1,1
1683306282379,PHYS 1A,A00,187028,Staff,26,0,60,34
1683306283404,PHYS 1AL,001,187036,Staff,2,0,30,28
1683306283404,PHYS 1AL,002,187049,Staff,18,0,30,12
1683306284428,PHYS 1B,A00,187058,Staff,23,0,60,37
1683306285452,PHYS 1BL,001,187064,Staff,0,0,30,30
1683306285452,PHYS 1BL,002,187070,Staff,6,0,30,24
1683306286476,PHYS 1C,A00,187082,Staff,31,0,120,89
1683306287500,PHYS 1CL,001,187088,Staff,0,9,30,30
1683306287500,PHYS 1CL,002,187089,Staff,0,2,30,30
1683306287500,PHYS 1CL,009,262693,Staff,11,0,30,19
1683306288528,PHYS 2B,A01,187097,Staff,54,0,115,61
1683306289556,PHYS 2C,A01,187099,Staff,67,0,115,48
1683306290585,PHYS 2CL,A01,187101,Staff,5,0,28,23
1683306290585,PHYS 2CL,A02,187102,Staff,15,0,28,13
1683306291611,PHYS 2D,A01,187123,Shotwell; Brian,95,0,115,20
1683306292639,PHYS 4B,A01,187133,Grinstein; Benjamin,35,0,50,15
1683306293668,POLI 10,A00,188819,Staff,0,3,50,50
1683306294692,POLI 11,A00,188827,Staff,43,0,50,7
1683306295718,POLI 13R,A00,188828,Staff,0,1,20,20
1683306296743,POLI 27,A01,188830,Elgin; Samuel Zincke,0,1,70,70
1683306297767,POLI 30,A00,188832,Desposato; Scott,33,0,50,17
1683306298795,POLI 102F,A00,188834,Staff,3,0,40,37
1683306299820,POLI 104A,A00,188852,Staff,14,0,30,16
1683306300843,POLI 104I,A00,188853,Staff,0,6,20,20
1683306301867,POLI 110B,A00,188854,Wiens; David,7,0,20,13
1683306302890,POLI 112A,A00,188855,Wiens; David,5,0,30,25
1683306303920,POLI 117R,A00,188856,Forman; Fonna,0,11,20,20
1683306304945,POLI 118,A00,188857,Ingham; Sean,8,0,20,12
1683306305968,POLI 120G,A00,188858,Staff,9,0,30,21
1683306306991,POLI 131CR,A00,188863,Hoston; Germaine,24,0,50,26
1683306308019,POLI 133,A00,188864,Nellis; Gareth Hb,44,0,50,6
1683306309117,POLI 134D,A00,188865,Desposato; Scott,27,0,30,3
1683306310141,POLI 142A,A00,188871,Gartzke; Erik,22,0,50,28
1683306311165,POLI 142K,A00,188874,Staff,38,0,50,12
1683306312192,POLI 143,A00,188940,Gartzke; Erik,16,0,30,14
1683306313219,POLI 153,A00,188943,Staff,3,0,20,17
1683306314243,POLI 160AA,A00,188944,Staff,13,0,40,27
1683306315268,POLI 170A,A00,188945,Staff,11,0,30,19
1683306317315,PSYC 1,A00,188952,Staff,38,0,90,52
1683306318342,PSYC 2,B00,188953,Staff,20,0,35,15
1683306319374,PSYC 6,A00,188970,Staff,47,0,60,13
1683306320398,PSYC 7,A00,188973,Staff,37,0,45,8
1683306321425,PSYC 60,A01,188980,Rickard; Timothy C.,43,0,60,17
1683306322449,PSYC 70,A01,189001,Steiner; Eric Tomas,24,0,45,21
1683306323473,PSYC 100,A00,189005,Lacefield; Katharine I,0,99,120,120
1683306324584,PSYC 102,A00,189008,Staff,10,0,30,20
1683306325613,PSYC 106,B00,189026,Gorman; Michael R.,37,0,60,23
1683306326641,PSYC 114,B01,189033,Winkielman; Piotr,0,32,30,30
1683306327668,PSYC 131,A00,189036,Anagnostaras; Stephan,0,43,60,60
1683306328696,PSYC 136,A00,189041,Lowe; Angela Beth,0,7,25,25
1683306329724,PSYC 137,A00,189057,Winkielman; Piotr,0,34,25,25
1683306330750,PSYC 144,A00,189107,Wixted; John T,0,7,50,50
1683306332805,PSYC 162,A00,189142,Staff,0,8,85,85
1683306333833,PSYC 172,A00,189144,Gorman; Michael R.,0,7,30,30
1683306335885,PSYC 179,A00,189146,Lacefield; Katharine I,0,84,120,120
1683306336910,PSYC 181,A00,189147,Anagnostaras; Stephan,0,44,90,90
1683306337933,PSYC 190R,A00,189148,Barner; David A.,0,22,80,80
1683306338960,PSYC 191,A00,189275,Rickard; Timothy C.,0,7,25,25
1683306339988,PSYC 193,A00,189276,Chapman; Eddie Nathaniel,0,1,0,4
1683306341013,PSYC 193L,A01,189281,Lowe; Angela Beth,12,0,20,8
1683306341013,PSYC 193L,B01,189285,Staff,28,0,35,7
1683306342036,RELI 149,A00,187137,Rahimi; Babak,7,0,40,33
1683306343060,SE 9,A01,187315,Staff,0,2,18,18
1683306344084,SE 101B,A00,187409,Staff,24,0,30,6
1683306345109,SE 110B,A00,187444,Staff,10,0,40,30
1683306346131,SE 130B,A00,187449,Staff,31,0,40,9
1683306347155,SE 150A,A00,187516,Staff,9,0,20,11
1683306348182,SE 154,A00,187528,Staff,30,0,50,20
1683306349208,SIO 3,A01,258171,Staff,35,0,40,5
1683306350235,SIO 10,A00,187144,Cook; Geoffrey W,0,3,75,75
1683306351259,SIO 45,A00,187152,Cook; Geoffrey W,1,0,100,99
1683306352286,SIO 109R,A00,194486,Staff,0,3,20,20
1683306354338,SIO 187,A01,187233,Kacev; David,12,0,40,28
1683306355366,SOCI 1,A01,258656,Thorpe; Charles Robert,28,0,30,2
1683306355366,SOCI 1,A02,258658,Thorpe; Charles Robert,30,0,30,0
1683306355366,SOCI 1,A03,258661,Thorpe; Charles Robert,25,0,25,0
1683306355366,SOCI 1,A04,258666,Thorpe; Charles Robert,22,0,25,3
1683306355366,SOCI 1,A05,258897,Thorpe; Charles Robert,23,0,25,2
1683306355366,SOCI 1,A06,258898,Thorpe; Charles Robert,25,0,25,0
1683306356390,SOCI 30,A01,258903,Pardo Guerra; Juan Pablo,16,0,30,14
1683306357417,SOCI 102,A00,258904,Staff,9,0,25,16
1683306358441,SOCI 106,A00,258905,Staff,19,0,25,6
1683306359465,SOCI 111,A00,258907,Ribas Norris; Janet Vanesa,26,0,30,4
1683306360494,SOCI 121R,A00,258908,Pardo Guerra; Juan Pablo,11,0,30,19
1683306361520,SOCI 126,A01,203330,Staff,14,0,20,6
1683306362542,SOCI 131,A00,258909,Thorpe; Charles Robert,31,0,60,29
1683306363565,SOCI 135,A00,258910,Payne; Christine Anna,0,9,30,30
1683306364589,SOCI 157,A00,258911,Staff,13,0,30,17
1683306365617,SOCI 184,A00,258912,Staff,26,0,30,4
1683306366639,SOCI 188D,A00,258913,Staff,21,0,30,9
1683306367666,SYN 2,001,187529,Staff,9,0,16,7
1683306367666,SYN 2,002,201452,Staff,0,18,16,16
1683306367666,SYN 2,003,201469,Staff,3,0,16,13
1683306368695,SYN 100,A01,187531,Staff,0,9,20,20
1683306368695,SYN 100,B01,201491,Staff,0,12,20,20
1683306369723,TDAC 1,A00,189286,Walsh; Kim C.,3,0,20,17
1683306369723,TDAC 1,B00,189287,Harting; Carla Kelso,11,0,20,9
1683306370748,TDAC 101,A00,189300,Walsh; Kim C.,16,0,20,4
1683306370748,TDAC 101,B00,189301,Harting; Carla Kelso,18,0,20,2
1683306371773,TDAC 102,A00,189304,Basso; Beatrice,14,0,20,6
1683306372798,TDAC 108,A00,189305,Staff,18,0,20,2
1683306373824,TDDE 131,A00,189310,Staff,19,0,20,1
1683306373824,TDDE 131,B00,189314,Staff,19,0,20,1
1683306373824,TDDE 131,C00,189315,Staff,48,0,50,2
1683306373824,TDDE 131,D00,189316,Staff,14,0,15,1
1683306373824,TDDE 131,E00,204841,Staff,20,0,20,0
1683306374852,TDGE 10,A00,189289,Staff,30,0,50,20
1683306374852,TDGE 10,B00,189290,Havis; Allan,2,0,50,48
1683306375879,TDGE 11,A00,189291,Fulton; Julia,0,3,50,50
1683306375879,TDGE 11,B00,189292,Staff,20,0,25,5
1683306375879,TDGE 11,C00,260270,Staff,0,0,0,0
1683306376903,TDGE 25,A00,189294,Staff,3,0,20,17
1683306377927,TDGE 124,A00,189318,Fulton; Julia,0,8,50,50
1683306378953,TDGE 125,A00,189319,Staff,13,0,25,12
1683306378953,TDGE 125,B00,189320,Staff,23,0,25,2
1683306379977,TDGE 127,A00,189322,Havis; Allan,0,0,50,50
1683306381002,TDHT 101,A00,189323,Staff,18,0,25,7
1683306381002,TDHT 101,B00,189324,Staff,25,0,25,0
1683306382026,TDHT 102,A00,189325,Staff,49,0,50,1
1683306383053,TDMV 1,A00,189295,Arcidiacono; Kristin,20,0,30,10
1683306383053,TDMV 1,B00,189296,Caligagan; Maria T.,24,0,30,6
1683306384082,TDMV 2,A00,189297,Sammartano; Tonnie,28,0,30,2
1683306384082,TDMV 2,B00,189299,Arcidiacono; Kristin,24,0,30,6
1683306385109,TDMV 3,A00,204998,Rincon; Alicia,22,0,30,8
1683306386133,TDMV 120,A00,189458,Sammartano; Tonnie,28,0,30,2
1683306387157,TDMV 138,A00,189541,Jun; Grace Shin Hae,22,0,40,18
1683306388184,TDMV 142,A00,189717,Caligagan; Tony,23,0,30,7
1683306388184,TDMV 142,B00,189718,Caligagan; Maria T.,25,0,30,5
1683306389207,TMC 2,A01,187533,Staff,25,0,25,0
1683306389207,TMC 2,A02,187534,Staff,25,0,25,0
1683306390231,USP 1,A01,187536,Kwak; Nancy,0,16,25,25
1683306391255,USP 5,A01,187538,Staff,9,0,25,16
1683306392279,USP 101,A00,199253,Staff,0,4,0,0
1683306393304,USP 124,A00,187562,Boomhower; Matthew Charles,1,0,30,29
1683306394327,USP 138,A00,187582,Staff,20,0,25,5
1683306395355,USP 152,A01,187597,Staff,4,0,25,21
1683306396379,USP 153,A00,187598,Staff,19,0,25,6
1683306397402,USP 168,A00,187607,Kwak; Nancy,2,0,5,3
1683306398427,USP 173,A00,187619,Staff,4,0,25,21
1683306399450,USP 181,A00,187638,Staff,0,0,25,25
1683306400477,VIS 103,A00,187650,Cruz; Edwin Teddy,23,0,75,52
1683306401500,VIS 110D,A00,187669,Staff,12,0,22,10
1683306402523,VIS 127C,A00,187720,Shen; Kuiyi,68,0,146,78
1683306403547,VIS 149,A00,187731,Yoldas; Pinar,0,14,22,22
1683306404573,VIS 151,A01,188091,Staff,22,0,34,12
1683306404573,VIS 151,A02,188092,Staff,11,0,34,23
1683306405601,VIS 160B,A00,188093,Stalbaum; Brett,0,0,10,10
1683306407649,WCWP 10B,A00,201720,Staff,10,0,15,5
1683306407649,WCWP 10B,B00,201722,Staff,8,0,15,7
1683306408674,WCWP 100,A00,201725,Gagnon; Jeffrey C,0,0,2,2
1683306408674,WCWP 100,B00,201727,Staff,0,4,15,15
1683306411764,ANBI 133,A00,258401,Wilder; Linnea Lorene,34,0,40,6
1683306412847,ANBI 140,A00,258395,Hrvoj Mihic; Branka,18,0,25,7
1683306413872,ANSC 120,A00,258402,Bialecki; Jon Anthony,27,0,40,13
1683306414897,ANSC 144,A00,258400,Staff,14,0,40,26
1683306416950,ANSC 166,A00,258396,Parish; Steven Martin,157,0,175,18
1683306417973,ANSC 180,A00,193533,Staff,9,0,20,11
1683306418997,ANSC 188,A00,258397,Jassal; Aftab,33,0,40,7
1683306420021,ANTH 3,A01,258316,Staff,23,0,30,7
1683306421045,ANTH 5,A00,258394,Semendeferi; Ekaterini,16,0,20,4
1683306422069,ANTH 21,A01,258331,Staff,9,0,40,31
1683306423094,ANTH 103,A00,258398,Varma; Saiba,15,0,25,10
1683306424119,AWP 10,001,202034,Staff,0,0,0,0
1683306424119,AWP 10,002,202035,Staff,0,0,0,0
1683306424119,AWP 10,003,202036,Staff,0,0,0,0
1683306424119,AWP 10,004,202037,Staff,0,0,0,0
1683306424119,AWP 10,005,202038,Staff,0,0,0,0
1683306424119,AWP 10,006,202039,Staff,0,0,0,0
1683306424119,AWP 10,007,202040,Staff,0,0,0,0
1683306424119,AWP 10,008,202041,Staff,0,0,0,0
1683306424119,AWP 10,009,202042,Staff,0,0,0,0
1683306424119,AWP 10,010,202043,Staff,0,0,0,0
1683306424119,AWP 10,011,202044,Staff,0,0,0,0
1683306424119,AWP 10,012,202045,Staff,0,0,0,0
1683306424119,AWP 10,013,202046,Staff,0,0,0,0
1683306424119,AWP 10,014,202047,Staff,0,0,0,0
1683306424119,AWP 10,015,202048,Staff,0,0,0,0
1683306424119,AWP 10,016,202049,Staff,0,0,0,0
1683306424119,AWP 10,017,202050,Staff,0,0,0,0
1683306424119,AWP 10,018,202051,Staff,0,0,0,0
1683306424119,AWP 10,019,202052,Staff,0,0,0,0
1683306424119,AWP 10,020,202053,Staff,0,0,0,0
1683306424119,AWP 10,021,202054,Staff,0,0,0,0
1683306424119,AWP 10,022,202055,Staff,0,0,0,0
1683306424119,AWP 10,023,202056,Staff,0,0,0,0
1683306424119,AWP 10,024,202057,Staff,0,0,0,0
1683306424119,AWP 10,025,202058,Staff,0,0,0,0
1683306424119,AWP 10,026,202059,Staff,0,0,0,0
1683306425142,AWP 102,001,202032,Staff,0,0,0,0
1683306425142,AWP 102,002,202033,Staff,0,0,0,0
1683306426165,BENG 100,A01,254234,Taylor Amos; Alyssa C,31,0,40,9
1683306427191,BENG 196,001,270013,Engler; Adam J.,9999,0,9999,0
1683306428216,BICD 100R,A01,202018,Smith; Laurie,0,7,32,32
1683306428216,BICD 100R,A02,202019,Smith; Laurie,0,2,32,32
1683306428216,BICD 100R,A03,202020,Smith; Laurie,0,1,32,32
1683306428216,BICD 100R,A04,202021,Smith; Laurie,8,0,32,24
1683306428216,BICD 100R,A05,202022,Smith; Laurie,12,0,32,20
1683306429241,BICD 136,A01,193242,Gustafson-Brown; Cindy,0,2,32,32
1683306429241,BICD 136,A02,193244,Gustafson-Brown; Cindy,15,0,32,17
1683306430266,BIEB 102,A01,193249,Butler; Shannon Rhey,0,2,32,32
1683306430266,BIEB 102,A02,193251,Butler; Shannon Rhey,0,0,32,32
1683306430266,BIEB 102,A03,193253,Butler; Shannon Rhey,0,1,32,32
1683306430266,BIEB 102,A04,193255,Butler; Shannon Rhey,17,0,32,15
1683306430266,BIEB 102,A05,193265,Butler; Shannon Rhey,26,0,32,6
1683306430266,BIEB 102,A06,193269,Butler; Shannon Rhey,16,0,32,16
1683306432323,BIEB 150,A01,193274,Staff,0,0,32,32
1683306432323,BIEB 150,A02,193285,Staff,24,0,32,8
1683306433351,BIEB 194,A00,193286,Kurle; Carolyn M.,22,0,32,10
1683306434376,BILD 1,A01,192291,Staff,16,0,32,16
1683306434376,BILD 1,A02,192292,Staff,30,0,32,2
1683306434376,BILD 1,B01,192520,Reuther; Keefe,0,1,0,0
1683306434376,BILD 1,B02,192532,Reuther; Keefe,0,1,0,0
1683306435402,BILD 3,A01,192556,Butler; Shannon Rhey,0,0,32,32
1683306435402,BILD 3,A02,192581,Butler; Shannon Rhey,5,0,32,27
1683306435402,BILD 3,A03,192611,Butler; Shannon Rhey,23,0,32,9
1683306435402,BILD 3,A04,192612,Butler; Shannon Rhey,25,0,32,7
1683306435402,BILD 3,A05,192613,Butler; Shannon Rhey,27,0,32,5
1683306435402,BILD 3,A06,192679,Butler; Shannon Rhey,27,0,32,5
1683306435402,BILD 3,A07,192682,Butler; Shannon Rhey,22,0,32,10
1683306436427,BILD 4,A01,192836,Reuther; Keefe,1,0,24,23
1683306436427,BILD 4,A02,193044,Reuther; Keefe,4,0,24,20
1683306437452,BILD 10,A01,193142,Gustafson-Brown; Cindy,31,0,32,1
1683306437452,BILD 10,A02,193149,Gustafson-Brown; Cindy,31,0,32,1
1683306438477,BIMM 100,A01,193301,Staff,0,6,32,32
1683306438477,BIMM 100,A02,193312,Staff,0,5,32,32
1683306438477,BIMM 100,A03,193323,Staff,0,8,32,32
1683306439503,BIMM 101,A01,193329,McDonnell; Lisa Marie,0,3,24,24
1683306439503,BIMM 101,A02,193339,McDonnell; Lisa Marie,0,2,24,24
1683306439503,BIMM 101,B01,193354,McDonnell; Lisa Marie,0,3,24,24
1683306439503,BIMM 101,B02,193357,McDonnell; Lisa Marie,0,3,24,24
1683306440527,BIMM 110,A01,193377,Tat; John,0,11,32,32
1683306440527,BIMM 110,A02,193378,Tat; John,1,9,32,31
1683306441550,BIMM 120,A01,206116,Staff,0,0,32,32
1683306441550,BIMM 120,A02,206117,Staff,8,0,32,24
1683306441550,BIMM 120,A03,206121,Staff,21,0,32,11
1683306442576,BIPN 100,A01,193393,Park; Ji Young,0,14,32,32
1683306442576,BIPN 100,A02,193402,Park; Ji Young,0,12,32,32
1683306442576,BIPN 100,A03,193413,Park; Ji Young,0,14,32,32
1683306442576,BIPN 100,A04,193414,Park; Ji Young,0,13,32,32
1683306443603,BIPN 102,A01,193429,Staff,0,0,32,32
1683306443603,BIPN 102,A02,193438,Staff,23,0,32,9
1683306444628,BIPN 106,A01,193450,Reyes Gonzalez; Catalina,0,2,40,40
1683306445656,BIPN 134,A01,193465,Cooke; James Edward,0,0,32,32
1683306445656,BIPN 134,A02,193474,Cooke; James Edward,27,0,32,5
1683306445656,BIPN 134,A03,193485,Cooke; James Edward,29,0,32,3
1683306445656,BIPN 134,A04,193486,Cooke; James Edward,21,0,32,11
1683306445656,BIPN 134,A05,193491,Cooke; James Edward,31,0,32,1
1683306445656,BIPN 134,A06,193501,Cooke; James Edward,30,0,32,2
1683306445656,BIPN 134,A07,193510,Cooke; James Edward,29,0,32,3
1683306447705,BISP 194,A00,222522,Staff,16,0,32,16
1683306448730,CAT 124,A01,202407,Staff,20,0,25,5
1683306449757,CAT 125,A00,202408,Marchisotto; Jennifer Anne,4,0,20,16
1683306450785,CAT 125R,A00,202409,Smith; Lauryn Alissa,0,11,20,20
1683306450785,CAT 125R,B00,202410,Morales; Celeste Georgianna,0,11,20,20
1683306450785,CAT 125R,C00,202411,Irwin; Matthew Joseph,0,10,20,20
1683306451812,CENG 15,A01,204712,Yang; Kesong,0,1,0,0
1683306452837,CENG 114,A00,202070,Jahed Motlagh; Zeinab,5,0,20,15
1683306453861,CGS 105,A00,185477,Wesling; Megan E.,24,0,40,16
1683306454884,CGS 106,A00,185494,Staff,13,0,22,9
1683306455908,CGS 108,A00,185495,Staff,14,0,20,6
1683306456932,CGS 114,A00,185496,Staff,13,0,18,5
1683306457960,CGS 119,A00,185501,Staff,15,0,20,5
1683306458984,CGS 120,A00,185511,Staff,13,0,20,7
1683306460015,CHEM 4,A01,184675,Bussey; Thomas J,96,0,100,4
1683306461041,CHEM 6A,A01,184677,Staff,35,0,60,25
1683306462071,CHEM 6B,A01,184679,Staff,65,0,100,35
1683306463096,CHEM 6C,A01,184681,Bussey; Thomas J,1,0,50,49
1683306463096,CHEM 6C,A02,184682,Bussey; Thomas J,34,0,50,16
1683306464124,CHEM 40A,A01,184684,Albizati; Kim F.,37,0,100,63
1683306465148,CHEM 40B,A01,184686,Albizati; Kim F.,0,20,100,100
1683306466177,CHEM 41B,A01,184690,Staff,52,0,100,48
1683306467201,COGS 3,A01,184715,Boyle; Mary E. T.,0,25,40,40
1683306468226,COGS 14B,A01,185172,Staff,0,15,38,38
1683306469252,COGS 18,A01,184736,Staff,20,0,80,60
1683306470279,COGS 100,A01,184932,Staff,0,5,73,73
1683306471307,COGS 101A,A01,184935,Staff,0,38,30,30
1683306472331,COGS 101B,A01,184944,Staff,0,2,30,30
1683306473355,COGS 101C,A01,184946,Staff,0,12,30,30
1683306474379,COGS 102A,A01,184951,Johnson; Christine M.,2,0,40,38
1683306475406,COGS 107B,A01,184953,Mooshagian; Eric Frederick,0,50,40,40
1683306476435,COGS 118B,A01,184959,Gupta; Anjum,0,48,40,40
1683306477459,COGS 153,A00,184961,Staff,0,15,30,30
1683306478483,COGS 177,A00,184962,Staff,0,21,30,30
1683306479511,COGS 187A,A01,184969,Boyle; Mary E. T.,0,17,40,40
1683306480538,COMM 10,A01,185174,Staff,0,5,25,25
1683306480538,COMM 10,A02,185189,Staff,0,5,25,25
1683306480538,COMM 10,A03,269821,Staff,0,0,0,0
1683306481562,COMM 100B,A01,185475,Staff,0,0,0,2
1683306481562,COMM 100B,A02,185476,Staff,14,0,25,11
1683306482591,COMM 100C,A01,185314,Staff,1,0,25,24
1683306482591,COMM 100C,A02,185327,Staff,19,0,25,6
1683306483616,COMM 110M,A00,185349,Staff,2,0,40,38
1683306484644,COMM 113T,A00,185352,Staff,25,0,40,15
1683306485669,COMM 114I,A00,185353,Staff,33,0,40,7
1683306486693,COMM 131,A00,185354,Staff,19,0,30,11
1683306487718,CSE 8A,A50,185358,Cao; Yingjun,0,46,10,10
1683306488742,CSE 8B,A01,185362,Staff,1,47,50,49
1683306489766,CSE 11,A01,185416,Cao; Yingjun,0,93,10,10
1683306490794,CSE 20,A01,185445,Briones; Jor-el Thomas Caparas,5,0,25,20
1683306491821,CSE 21,A01,185447,Staff,10,0,50,40
1683306492851,CSE 101,A01,185451,Staff,0,12,50,50
1683306492851,CSE 101,B01,185453,Jones; Miles E,0,11,50,50
1683306494902,CSE 141,A01,185458,Eldon; John,20,0,100,80
1683306495931,CSE 141L,A01,185461,Eldon; John,12,0,100,88
1683306496957,CSE 142,A01,185463,Staff,35,0,60,25
1683306496957,CSE 142,B01,201355,Staff,0,6,60,60
1683306497982,CSE 142L,A01,185470,Staff,35,0,60,25
1683306497982,CSE 142L,B01,201417,Staff,0,5,60,60
1683306499009,CSE 190,A00,201433,Staff,32,0,49,17
1683306500034,DOC 1,A01,259136,Strom; Megan C.,8,0,15,7
1683306500034,DOC 1,A02,259137,Strom; Megan C.,14,0,15,1
1683306500034,DOC 1,A03,259138,Strom; Megan C.,14,0,15,1
1683306500034,DOC 1,A04,259139,Strom; Megan C.,14,0,15,1
1683306501059,DOC 100D,A00,259140,Pass; Natalye Joann,17,0,25,8
1683306502082,DSGN 1,A01,184749,Rill; Bryan,0,24,30,30
1683306503107,DSGN 100,A01,185168,Staff,0,2,25,25
1683306504132,ECE 5,A01,185626,Morris; Karcher William,0,10,0,0
1683306505158,ECE 101,A01,185628,Staff,17,0,70,53
1683306506185,ECE 107,A01,185635,Baghdadchi; Saharnaz,0,0,20,20
1683306506185,ECE 107,A02,185638,Baghdadchi; Saharnaz,4,0,20,16
1683306507213,ECE 148,A01,185647,Silberman; Jack,0,0,16,16
1683306508236,ECON 1,A01,185537,Crane; Meredith Helen,54,0,70,16
1683306509261,ECON 3,A01,185549,Crane; Meredith Helen,33,0,70,37
1683306510289,ECON 4,A01,203354,Anderson; John Charles,0,4,10,10
1683306511317,ECON 100A,A01,185574,Staff,0,4,40,40
1683306512340,ECON 100B,A01,185576,Staff,0,22,40,40
1683306513364,ECON 100C,A01,185589,Newhouse; Herbert S,30,0,70,40
1683306514389,ECON 105,A00,185608,Vespa; Emanuel Ignacio,19,0,35,16
1683306515414,ECON 109,A01,185610,Shishkin; Denis,10,0,35,25
1683306516493,ECON 110A,A01,185612,Staff,11,0,40,29
1683306517516,ECON 120A,A01,185615,Staff,20,0,40,20
1683306518543,ECON 120C,A01,185617,Sun; Yixiao,0,20,70,70
1683306519568,ECON 144,A00,203346,Squires; Dale E,3,0,35,32
1683306520592,ECON 171,A01,203349,Newhouse; Herbert S,0,1,35,35
1683306521619,ECON 173A,A01,185621,Toda; Alexis Akira,21,0,35,14
1683306522649,EDS 25,A01,202413,Staff,0,1,0,0
1683306522649,EDS 25,A02,202414,Staff,0,1,0,0
1683306522649,EDS 25,A03,202415,Staff,0,0,0,0
1683306522649,EDS 25,A04,202416,Staff,0,1,0,0
1683306522649,EDS 25,A05,202439,Staff,0,0,0,0
1683306522649,EDS 25,A06,202440,Staff,0,0,0,0
1683306522649,EDS 25,B01,202631,Staff,0,0,0,0
1683306522649,EDS 25,B02,202632,Staff,0,0,0,0
1683306522649,EDS 25,B03,202639,Staff,0,0,0,0
1683306522649,EDS 25,B04,202640,Staff,0,0,0,0
1683306522649,EDS 25,B05,202643,Staff,0,0,0,0
1683306522649,EDS 25,B06,202644,Staff,0,0,0,0
1683306523673,EDS 38,A01,202659,Black; Alison Michelle,24,0,25,1
1683306524697,EDS 115,A00,202652,Staff,17,0,30,13
1683306525722,EDS 125,A00,202649,Staff,14,0,30,16
1683306526747,EDS 126,A01,203332,Staff,30,0,30,0
1683306527773,EDS 139,A00,202838,Staff,17,0,25,8
1683306528800,EDS 146,A01,202655,Staff,15,0,25,10
1683306529828,ENG 15,A00,185667,Staff,0,1,0,0
1683306529828,ENG 15,B00,185672,Staff,0,0,0,0
1683306529828,ENG 15,C00,185675,Staff,0,0,0,0
1683306529828,ENG 15,D00,185682,Staff,0,0,0,0
1683306529828,ENG 15,E00,185684,Staff,0,0,0,0
1683306530856,ETHN 103,A00,185710,Staff,0,3,35,35
1683306531879,ETHN 103A,A00,199228,Man; Simeon S,2,0,9,7
1683306532903,ETHN 109,A00,185711,Staff,18,0,35,17
1683306533931,ETHN 142,A00,185726,Staff,0,4,30,30
1683306534957,ETHN 163J,A00,199229,Man; Simeon S,6,0,8,2
1683306535984,ETHN 168,A00,185727,Staff,8,0,10,2
1683306537011,ETHN 182,A00,185728,Staff,1,0,35,34
1683306538036,ETHN 183,A00,185737,Staff,8,0,18,10
1683306539062,GLBH 111,A01,209361,Burgos; Jose L.,0,0,0,0
1683306541112,HIEU 104,A00,185792,Staff,16,0,20,4
1683306542138,HIEU 115,A00,185800,Staff,1,0,20,19
1683306543165,HIEU 128,A00,185801,Staff,0,7,20,20
1683306544189,HIEU 147,A00,185802,Staff,16,0,20,4
1683306545216,HIEU 154,A00,185823,Staff,12,0,20,8
1683306546242,HILA 102,A00,185826,Staff,13,0,20,7
1683306547269,HILD 2C,A01,185778,Staff,0,12,20,20
1683306548293,HILD 7B,A01,185780,Kwak; Nancy,0,15,32,32
1683306548293,HILD 7B,A02,185781,Kwak; Nancy,0,18,32,32
1683306549321,HILD 30,A01,185791,Staff,14,0,20,6
1683306550348,HISC 119,A00,185830,Golan; Tal,0,9,20,20
1683306551377,HITO 156GS,A00,185831,Patterson; Patrick H.,0,0,0,23
1683306552401,HIUS 103,A00,185832,Man; Simeon S,0,6,20,20
1683306553425,HIUS 117,A00,185836,Kwak; Nancy,2,0,20,18
1683306554449,HIUS 125,A00,185840,Man; Simeon S,0,0,23,23
1683306555473,HIUS 149,A00,185845,Staff,0,0,20,20
1683306556501,HUM 3,A01,185882,Zavodny; Tatiana Sophia,0,6,50,50
1683306556501,HUM 3,B01,185899,Caldwell; Michael Alan,0,19,50,50
1683306557525,HUM 3GS,A00,185900,Patterson; Patrick H.,0,0,0,23
1683306558550,HUM 4,A01,185938,Zroka; Amy Liane,30,0,50,20
1683306558550,HUM 4,B01,185956,Watkins; Eric,0,2,50,50
1683306558550,HUM 4,B02,202209,Watkins; Eric,0,1,50,50
1683306558550,HUM 4,B03,202210,Watkins; Eric,0,0,50,50
1683306559575,HUM 5,A01,185958,West; Geoffrey Scott,5,0,50,45
1683306559575,HUM 5,A02,202215,West; Geoffrey Scott,0,0,50,50
1683306560599,INTL 190,A00,185959,Gagnon; Jeffrey C,0,0,0,9
1683306560599,INTL 190,B00,185960,Lettieri; Michael Joseph,0,0,0,1
1683306561624,JAPN 180,A00,254509,Staff,5,1,30,25
1683306562647,LATI 10,A01,202853,Kennemore; Amy Michelle,5,0,35,30
1683306562647,LATI 10,A02,202854,Kennemore; Amy Michelle,1,0,35,34
1683306562647,LATI 10,A03,270054,Kennemore; Amy Michelle,30,0,30,0
1683306563671,LATI 180,A00,202855,Kennemore; Amy Michelle,11,0,20,9
1683306564696,LAWS 101,A00,201767,Golan; Tal,0,7,40,40
1683306565720,LIFR 1C,A00,185961,Staff,6,0,20,14
1683306566746,LIFR 1CX,A00,185962,Staff,7,0,20,13
1683306567772,LIFR 1D,A00,185963,Staff,9,0,20,11
1683306568796,LIFR 1DX,A00,185964,Staff,9,0,20,11
1683306569823,LIGN 101,A01,186039,Staff,43,0,50,7
1683306570849,LIGN 165,A00,186040,Staff,18,0,50,32
1683306571876,LTCS 108,A00,186041,Staff,6,0,10,4
1683306572902,LTCS 119,A00,186042,Staff,16,0,20,4
1683306573930,LTCS 130,A00,186043,Wesling; Megan E.,15,0,25,10
1683306575981,LTEA 138,A00,186119,Staff,14,0,40,26
1683306577006,LTEN 124,A00,186148,Staff,6,0,25,19
1683306578030,LTEN 178,A00,186149,Staff,7,0,15,8
1683306579058,LTEN 181,A00,186150,Blanco; John D,33,0,40,7
1683306580084,LTWL 120,A00,186160,Staff,20,0,25,5
1683306581111,LTWL 165,A00,186161,Staff,22,0,25,3
1683306582138,LTWR 100,A00,186162,Staff,0,4,15,15
1683306583166,LTWR 102,A00,186163,Doller; Ben,5,0,15,10
1683306584190,MAE 8,A01,186412,Staff,0,0,0,0
1683306585214,MAE 30B,A00,186445,Bahadori; Mohammad Yousef,83,0,100,17
1683306586237,MAE 40,A00,186592,Bewley; Thomas R,9,0,50,41
1683306587264,MAE 101B,A00,186593,Bahadori; Mohammad Yousef,81,0,100,19
1683306588289,MAE 105,A00,186594,Bandaru; Prabhakar,12,0,50,38
1683306589314,MAE 107,A00,186599,Pham; Hieu Tan,0,6,120,120
1683306590341,MAE 148,A01,186660,Silberman; Jack,3,0,16,13
1683306591365,MATH 10A,A01,188095,Staff,0,7,35,35
1683306592390,MATH 10B,A01,188097,Bowers; Adam R.,0,11,30,30
1683306592390,MATH 10B,A02,188099,Bowers; Adam R.,0,9,30,30
1683306592390,MATH 10B,B01,188104,Bowers; Adam R.,0,11,30,30
1683306592390,MATH 10B,B02,188106,Bowers; Adam R.,0,11,30,30
1683306593419,MATH 10C,A01,188111,Staff,0,18,30,30
1683306593419,MATH 10C,A02,188127,Staff,0,17,30,30
1683306593419,MATH 10C,A03,188131,Staff,0,17,30,30
1683306593419,MATH 10C,B01,188218,Staff,21,0,30,9
1683306593419,MATH 10C,B02,188244,Staff,13,0,30,17
1683306593419,MATH 10C,B03,188277,Staff,16,0,30,14
1683306594448,MATH 18,A01,188344,Bach; Quang Tran,18,0,30,12
1683306594448,MATH 18,A02,188345,Bach; Quang Tran,11,0,30,19
1683306594448,MATH 18,B01,188353,Bach; Quang Tran,10,0,30,20
1683306594448,MATH 18,B02,188354,Bach; Quang Tran,20,0,30,10
1683306595472,MATH 20A,A01,188374,Staff,13,0,35,22
1683306596502,MATH 20B,A01,188382,Ohm; Ko Woon,6,0,30,24
1683306596502,MATH 20B,A02,188383,Ohm; Ko Woon,24,0,30,6
1683306596502,MATH 20B,B01,188385,Ohm; Ko Woon,7,0,30,23
1683306596502,MATH 20B,B02,188392,Ohm; Ko Woon,22,0,30,8
1683306597527,MATH 20C,A01,188394,Harel; Guershon,10,0,30,20
1683306597527,MATH 20C,A02,188395,Harel; Guershon,13,0,30,17
1683306597527,MATH 20C,B01,188404,Harel; Guershon,3,0,30,27
1683306597527,MATH 20C,B02,188405,Harel; Guershon,19,0,30,11
1683306598552,MATH 20D,A01,188414,Hammock; Frances H,0,1,30,30
1683306598552,MATH 20D,A02,188415,Hammock; Frances H,4,0,30,26
1683306598552,MATH 20D,B01,188447,Hammock; Frances H,2,0,30,28
1683306598552,MATH 20D,B02,188486,Hammock; Frances H,8,0,30,22
1683306599579,MATH 20E,A01,188649,Staff,22,0,30,8
1683306599579,MATH 20E,A02,188650,Staff,23,0,30,7
1683306599579,MATH 20E,A03,188673,Staff,0,0,30,30
1683306600604,MATH 102,A01,188675,Staff,0,35,35,35
1683306601627,MATH 103B,A01,188681,Staff,4,0,35,31
1683306601627,MATH 103B,B01,188692,Staff,7,0,35,28
1683306602652,MATH 109,A01,188695,Salehi Golsefidy; Alireza,25,0,35,10
1683306602652,MATH 109,A02,188696,Salehi Golsefidy; Alireza,27,0,35,8
1683306603679,MATH 120A,A01,188698,Eggers; John Dietrich,6,0,35,29
1683306604702,MATH 142B,A01,188736,Ioana; Adrian,0,2,30,30
1683306604702,MATH 142B,A02,188741,Ioana; Adrian,0,1,30,30
1683306604702,MATH 142B,A03,188743,Ioana; Adrian,0,3,30,30
1683306605725,MATH 168A,A01,188790,Staff,0,9,35,35
1683306606750,MATH 170A,A01,188803,Nie; Jiawang,0,2,35,35
1683306606750,MATH 170A,A02,188811,Nie; Jiawang,0,0,35,35
1683306606750,MATH 170A,A03,188814,Nie; Jiawang,1,0,35,34
1683306606750,MATH 170A,A04,188815,Nie; Jiawang,13,0,35,22
1683306607777,MATH 193B,A01,188817,Staff,0,0,35,35
1683306607777,MATH 193B,A02,188818,Staff,5,0,35,30
1683306608801,MGT 4,A01,202857,Anderson; John Charles,62,0,80,18
1683306609826,MGT 12,A00,202858,Lindenberger; Wade Douglas,43,0,90,47
1683306610855,MGT 18,A00,202859,Staff,74,0,90,16
1683306611879,MGT 18GS,A00,202860,McKay; Michael J,13,0,28,15
1683306612903,MGT 45,A00,202861,Pecore; Joseph P.,14,0,90,76
1683306613930,MGT 100,A00,202863,Yavorsky; Daniel Ryan,28,0,90,62
1683306614954,MGT 103,A00,202864,Ehrich; Kristine R,0,16,90,90
1683306615982,MGT 112,A00,202865,Ehrich; Kristine R,15,0,90,75
1683306617006,MGT 121A,A00,202868,Staff,0,19,0,0
1683306618031,MGT 131B,A00,202869,Anderson; John Charles,59,0,90,31
1683306619058,MGT 136,A00,202871,Lindenberger; Wade Douglas,84,0,90,6
1683306620146,MGT 164,A00,202873,Staff,0,69,90,90
1683306621172,MGT 164GS,A00,202874,McKay; Mary A,13,0,28,15
1683306622195,MGT 180,A00,202875,Staff,0,51,90,90
1683306623219,MMW 11R,A01,205019,Herbst; Matthew,3,0,30,27
1683306623219,MMW 11R,A02,205026,Herbst; Matthew,29,0,30,1
1683306624250,MMW 15,A01,193512,Chang; Edmond Yi-Teh,0,9,28,28
1683306624250,MMW 15,A02,193513,Chang; Edmond Yi-Teh,0,5,28,28
1683306624250,MMW 15,A03,193514,Chang; Edmond Yi-Teh,0,5,28,28
1683306624250,MMW 15,A04,193515,Chang; Edmond Yi-Teh,0,4,28,28
1683306624250,MMW 15,A05,193516,Chang; Edmond Yi-Teh,0,4,28,28
1683306624250,MMW 15,A06,193517,Chang; Edmond Yi-Teh,0,5,28,28
1683306624250,MMW 15,B01,193519,Chang; Edmond Yi-Teh,0,4,28,28
1683306624250,MMW 15,B02,193520,Chang; Edmond Yi-Teh,0,5,28,28
1683306624250,MMW 15,B03,193521,Chang; Edmond Yi-Teh,0,4,28,28
1683306624250,MMW 15,B04,193522,Chang; Edmond Yi-Teh,0,4,28,28
1683306624250,MMW 15,B05,193523,Chang; Edmond Yi-Teh,0,5,28,28
1683306624250,MMW 15,B06,193524,Chang; Edmond Yi-Teh,0,4,28,28
1683306625277,MMW 122,A01,193526,Rahimi; Babak,0,14,28,28
1683306625277,MMW 122,A02,193527,Rahimi; Babak,0,14,28,28
1683306625277,MMW 122,A03,193528,Rahimi; Babak,0,0,0,0
1683306625277,MMW 122,A04,193529,Rahimi; Babak,0,0,0,0
1683306626304,MUS 1A,A01,186663,Staff,0,20,35,35
1683306627330,MUS 4,A01,186715,Staff,0,12,35,35
1683306628356,MUS 5R,A01,186796,Dubnov; Shlomo,0,17,35,35
1683306629383,MUS 6,A01,186798,Staff,0,3,25,25
1683306630410,MUS 7,A01,186830,Staff,12,0,35,23
1683306631436,MUS 8,A01,186930,Staff,0,26,35,35
1683306632463,MUS 15,A01,186932,Staff,0,15,35,35
1683306632463,MUS 15,B01,186934,Staff,0,15,35,35
1683306633488,MUS 80,A00,186935,Staff,2,0,20,18
1683306633488,MUS 80,B00,186936,Staff,25,0,25,0
1683306634518,NANO 11,A00,204702,Lipomi; Darren John,0,0,0,0
1683306635545,NANO 15,A01,204709,Yang; Kesong,0,1,0,0
1683306636571,NANO 114,A00,202069,Jahed Motlagh; Zeinab,3,0,10,7
1683306637598,PHIL 1,A00,186955,Grush; Rick Scott,32,0,40,8
1683306638622,PHIL 10,A01,186973,Grush; Rick Scott,28,0,35,7
1683306638622,PHIL 10,A02,186974,Grush; Rick Scott,33,0,35,2
1683306639650,PHIL 13,A01,186976,Staff,7,0,35,28
1683306639650,PHIL 13,A02,186977,Staff,16,0,35,19
1683306640674,PHIL 14,A01,186979,Staff,31,0,35,4
1683306640674,PHIL 14,A02,186986,Staff,32,0,35,3
1683306641699,PHIL 28,A01,186988,Staff,16,0,30,14
1683306641699,PHIL 28,A02,186989,Staff,1,0,30,29
1683306641699,PHIL 28,A03,186990,Staff,9,0,30,21
1683306641699,PHIL 28,A04,186991,Staff,26,0,30,4
1683306642727,PHIL 120,A00,186997,Staff,23,0,40,17
1683306643753,PHIL 137,A00,187003,Staff,9,0,40,31
1683306644780,PHIL 150,A00,187015,Staff,47,0,70,23
1683306645806,PHIL 167,A00,187021,Lamey; Andy M.,35,0,40,5
1683306646830,PHIL 174,A01,202226,Staff,17,0,20,3
1683306646830,PHIL 174,A02,202235,Staff,20,0,20,0
1683306647853,PHIL 191A,A00,258918,Staff,0,0,1,1
1683306648879,PHYS 1A,A00,187028,Staff,26,0,60,34
1683306649905,PHYS 1AL,001,187036,Staff,2,0,30,28
1683306649905,PHYS 1AL,002,187049,Staff,18,0,30,12
1683306650929,PHYS 1B,A00,187058,Staff,23,0,60,37
1683306651954,PHYS 1BL,001,187064,Staff,0,0,30,30
1683306651954,PHYS 1BL,002,187070,Staff,6,0,30,24
1683306652981,PHYS 1C,A00,187082,Staff,31,0,120,89
1683306654007,PHYS 1CL,001,187088,Staff,0,9,30,30
1683306654007,PHYS 1CL,002,187089,Staff,0,2,30,30
1683306654007,PHYS 1CL,009,262693,Staff,11,0,30,19
1683306655034,PHYS 2B,A01,187097,Staff,54,0,115,61
1683306656059,PHYS 2C,A01,187099,Staff,67,0,115,48
1683306657084,PHYS 2CL,A01,187101,Staff,5,0,28,23
1683306657084,PHYS 2CL,A02,187102,Staff,15,0,28,13
1683306658110,PHYS 2D,A01,187123,Shotwell; Brian,95,0,115,20
1683306659135,PHYS 4B,A01,187133,Grinstein; Benjamin,35,0,50,15
1683306660162,POLI 10,A00,188819,Staff,0,3,50,50
1683306661188,POLI 11,A00,188827,Staff,43,0,50,7
1683306662212,POLI 13R,A00,188828,Staff,0,1,20,20
1683306663236,POLI 27,A01,188830,Elgin; Samuel Zincke,0,1,70,70
1683306664259,POLI 30,A00,188832,Desposato; Scott,33,0,50,17
1683306665283,POLI 102F,A00,188834,Staff,3,0,40,37
1683306666307,POLI 104A,A00,188852,Staff,14,0,30,16
1683306667331,POLI 104I,A00,188853,Staff,0,6,20,20
1683306668355,POLI 110B,A00,188854,Wiens; David,7,0,20,13
1683306669379,POLI 112A,A00,188855,Wiens; David,5,0,30,25
1683306670406,POLI 117R,A00,188856,Forman; Fonna,0,11,20,20
1683306671433,POLI 118,A00,188857,Ingham; Sean,8,0,20,12
1683306672456,POLI 120G,A00,188858,Staff,9,0,30,21
1683306673480,POLI 131CR,A00,188863,Hoston; Germaine,24,0,50,26
1683306674507,POLI 133,A00,188864,Nellis; Gareth Hb,44,0,50,6
1683306675531,POLI 134D,A00,188865,Desposato; Scott,27,0,30,3
1683306676559,POLI 142A,A00,188871,Gartzke; Erik,22,0,50,28
1683306677598,POLI 142K,A00,188874,Staff,38,0,50,12
1683306678628,POLI 143,A00,188940,Gartzke; Erik,16,0,30,14
1683306679654,POLI 153,A00,188943,Staff,3,0,20,17
1683306680678,POLI 160AA,A00,188944,Staff,13,0,40,27
1683306681701,POLI 170A,A00,188945,Staff,11,0,30,19
1683306683750,PSYC 1,A00,188952,Staff,38,0,90,52
1683306684774,PSYC 2,B00,188953,Staff,20,0,35,15
1683306685798,PSYC 6,A00,188970,Staff,47,0,60,13
1683306686825,PSYC 7,A00,188973,Staff,37,0,45,8
1683306687849,PSYC 60,A01,188980,Rickard; Timothy C.,43,0,60,17
1683306688879,PSYC 70,A01,189001,Steiner; Eric Tomas,24,0,45,21
1683306689903,PSYC 100,A00,189005,Lacefield; Katharine I,0,99,120,120
1683306690928,PSYC 102,A00,189008,Staff,10,0,30,20
1683306691952,PSYC 106,B00,189026,Gorman; Michael R.,37,0,60,23
1683306692977,PSYC 114,B01,189033,Winkielman; Piotr,0,32,30,30
1683306694004,PSYC 131,A00,189036,Anagnostaras; Stephan,0,43,60,60
1683306695031,PSYC 136,A00,189041,Lowe; Angela Beth,0,7,25,25
1683306696053,PSYC 137,A00,189057,Winkielman; Piotr,0,34,25,25
1683306697076,PSYC 144,A00,189107,Wixted; John T,0,7,50,50
1683306699126,PSYC 162,A00,189142,Staff,0,8,85,85
1683306700154,PSYC 172,A00,189144,Gorman; Michael R.,0,7,30,30
1683306702204,PSYC 179,A00,189146,Lacefield; Katharine I,0,84,120,120
1683306703234,PSYC 181,A00,189147,Anagnostaras; Stephan,0,44,90,90
1683306704260,PSYC 190R,A00,189148,Barner; David A.,0,22,80,80
1683306705284,PSYC 191,A00,189275,Rickard; Timothy C.,0,7,25,25
1683306706306,PSYC 193,A00,189276,Chapman; Eddie Nathaniel,0,1,0,4
1683306707330,PSYC 193L,A01,189281,Lowe; Angela Beth,12,0,20,8
1683306707330,PSYC 193L,B01,189285,Staff,28,0,35,7
1683306708354,RELI 149,A00,187137,Rahimi; Babak,7,0,40,33
1683306709380,SE 9,A01,187315,Staff,0,2,18,18
1683306710405,SE 101B,A00,187409,Staff,24,0,30,6
1683306711430,SE 110B,A00,187444,Staff,10,0,40,30
1683306712453,SE 130B,A00,187449,Staff,31,0,40,9
1683306713479,SE 150A,A00,187516,Staff,9,0,20,11
1683306714507,SE 154,A00,187528,Staff,30,0,50,20
1683306715530,SIO 3,A01,258171,Staff,35,0,40,5
1683306716554,SIO 10,A00,187144,Cook; Geoffrey W,0,3,75,75
1683306717579,SIO 45,A00,187152,Cook; Geoffrey W,1,0,100,99
1683306718605,SIO 109R,A00,194486,Staff,0,3,20,20
1683306720654,SIO 187,A01,187233,Kacev; David,12,0,40,28
1683306721682,SOCI 1,A01,258656,Thorpe; Charles Robert,28,0,30,2
1683306721682,SOCI 1,A02,258658,Thorpe; Charles Robert,30,0,30,0
1683306721682,SOCI 1,A03,258661,Thorpe; Charles Robert,25,0,25,0
1683306721682,SOCI 1,A04,258666,Thorpe; Charles Robert,22,0,25,3
1683306721682,SOCI 1,A05,258897,Thorpe; Charles Robert,23,0,25,2
1683306721682,SOCI 1,A06,258898,Thorpe; Charles Robert,25,0,25,0
1683306722711,SOCI 30,A01,258903,Pardo Guerra; Juan Pablo,16,0,30,14
1683306723809,SOCI 102,A00,258904,Staff,9,0,25,16
1683306724833,SOCI 106,A00,258905,Staff,19,0,25,6
1683306725857,SOCI 111,A00,258907,Ribas Norris; Janet Vanesa,26,0,30,4
1683306726882,SOCI 121R,A00,258908,Pardo Guerra; Juan Pablo,11,0,30,19
1683306727906,SOCI 126,A01,203330,Staff,14,0,20,6
1683306728930,SOCI 131,A00,258909,Thorpe; Charles Robert,31,0,60,29
1683306729953,SOCI 135,A00,258910,Payne; Christine Anna,0,9,30,30
1683306730982,SOCI 157,A00,258911,Staff,13,0,30,17
1683306732008,SOCI 184,A00,258912,Staff,26,0,30,4
1683306733033,SOCI 188D,A00,258913,Staff,21,0,30,9
1683306734057,SYN 2,001,187529,Staff,9,0,16,7
1683306734057,SYN 2,002,201452,Staff,0,18,16,16
1683306734057,SYN 2,003,201469,Staff,3,0,16,13
1683306735082,SYN 100,A01,187531,Staff,0,9,20,20
1683306735082,SYN 100,B01,201491,Staff,0,12,20,20
1683306736105,TDAC 1,A00,189286,Walsh; Kim C.,3,0,20,17
1683306736105,TDAC 1,B00,189287,Harting; Carla Kelso,11,0,20,9
1683306737131,TDAC 101,A00,189300,Walsh; Kim C.,16,0,20,4
1683306737131,TDAC 101,B00,189301,Harting; Carla Kelso,18,0,20,2
1683306738155,TDAC 102,A00,189304,Basso; Beatrice,14,0,20,6
1683306739179,TDAC 108,A00,189305,Staff,18,0,20,2
1683306740207,TDDE 131,A00,189310,Staff,19,0,20,1
1683306740207,TDDE 131,B00,189314,Staff,19,0,20,1
1683306740207,TDDE 131,C00,189315,Staff,48,0,50,2
1683306740207,TDDE 131,D00,189316,Staff,14,0,15,1
1683306740207,TDDE 131,E00,204841,Staff,20,0,20,0
1683306741232,TDGE 10,A00,189289,Staff,30,0,50,20
1683306741232,TDGE 10,B00,189290,Havis; Allan,2,0,50,48
1683306742255,TDGE 11,A00,189291,Fulton; Julia,0,3,50,50
1683306742255,TDGE 11,B00,189292,Staff,20,0,25,5
1683306742255,TDGE 11,C00,260270,Staff,0,0,0,0
1683306743278,TDGE 25,A00,189294,Staff,3,0,20,17
1683306744304,TDGE 124,A00,189318,Fulton; Julia,0,8,50,50
1683306745329,TDGE 125,A00,189319,Staff,13,0,25,12
1683306745329,TDGE 125,B00,189320,Staff,23,0,25,2
1683306746357,TDGE 127,A00,189322,Havis; Allan,0,0,50,50
1683306747383,TDHT 101,A00,189323,Staff,18,0,25,7
1683306747383,TDHT 101,B00,189324,Staff,25,0,25,0
1683306748407,TDHT 102,A00,189325,Staff,49,0,50,1
1683306749434,TDMV 1,A00,189295,Arcidiacono; Kristin,20,0,30,10
1683306749434,TDMV 1,B00,189296,Caligagan; Maria T.,24,0,30,6
1683306750459,TDMV 2,A00,189297,Sammartano; Tonnie,28,0,30,2
1683306750459,TDMV 2,B00,189299,Arcidiacono; Kristin,24,0,30,6
1683306751483,TDMV 3,A00,204998,Rincon; Alicia,22,0,30,8
1683306752507,TDMV 120,A00,189458,Sammartano; Tonnie,28,0,30,2
1683306753531,TDMV 138,A00,189541,Jun; Grace Shin Hae,22,0,40,18
1683306754555,TDMV 142,A00,189717,Caligagan; Tony,23,0,30,7
1683306754555,TDMV 142,B00,189718,Caligagan; Maria T.,25,0,30,5
1683306755582,TMC 2,A01,187533,Staff,25,0,25,0
1683306755582,TMC 2,A02,187534,Staff,25,0,25,0
1683306756609,USP 1,A01,187536,Kwak; Nancy,0,16,25,25
1683306757632,USP 5,A01,187538,Staff,9,0,25,16
1683306758660,USP 101,A00,199253,Staff,0,4,0,0
1683306759682,USP 124,A00,187562,Boomhower; Matthew Charles,1,0,30,29
1683306760709,USP 138,A00,187582,Staff,20,0,25,5
1683306761733,USP 152,A01,187597,Staff,4,0,25,21
1683306762756,USP 153,A00,187598,Staff,19,0,25,6
1683306763780,USP 168,A00,187607,Kwak; Nancy,2,0,5,3
1683306764804,USP 173,A00,187619,Staff,4,0,25,21
1683306765831,USP 181,A00,187638,Staff,0,0,25,25
1683306766856,VIS 103,A00,187650,Cruz; Edwin Teddy,23,0,75,52
1683306767880,VIS 110D,A00,187669,Staff,12,0,22,10
1683306768903,VIS 127C,A00,187720,Shen; Kuiyi,68,0,146,78
1683306769927,VIS 149,A00,187731,Yoldas; Pinar,0,14,22,22
1683306770953,VIS 151,A01,188091,Staff,22,0,34,12
1683306770953,VIS 151,A02,188092,Staff,11,0,34,23
1683306771978,VIS 160B,A00,188093,Stalbaum; Brett,0,0,10,10
1683306774029,WCWP 10B,A00,201720,Staff,10,0,15,5
1683306774029,WCWP 10B,B00,201722,Staff,8,0,15,7
1683306775056,WCWP 100,A00,201725,Gagnon; Jeffrey C,0,0,2,2
1683306775056,WCWP 100,B00,201727,Staff,0,4,15,15
1683306778148,ANBI 133,A00,258401,Wilder; Linnea Lorene,34,0,40,6
1683306779175,ANBI 140,A00,258395,Hrvoj Mihic; Branka,18,0,25,7
1683306780199,ANSC 120,A00,258402,Bialecki; Jon Anthony,27,0,40,13
1683306781223,ANSC 144,A00,258400,Staff,14,0,40,26
1683306783272,ANSC 166,A00,258396,Parish; Steven Martin,157,0,175,18
1683306784297,ANSC 180,A00,193533,Staff,9,0,20,11
1683306785324,ANSC 188,A00,258397,Jassal; Aftab,33,0,40,7
1683306786349,ANTH 3,A01,258316,Staff,23,0,30,7
1683306787373,ANTH 5,A00,258394,Semendeferi; Ekaterini,16,0,20,4
1683306788397,ANTH 21,A01,258331,Staff,9,0,40,31
1683306789421,ANTH 103,A00,258398,Varma; Saiba,15,0,25,10
1683306790453,AWP 10,001,202034,Staff,0,0,0,0
1683306790453,AWP 10,002,202035,Staff,0,0,0,0
1683306790453,AWP 10,003,202036,Staff,0,0,0,0
1683306790453,AWP 10,004,202037,Staff,0,0,0,0
1683306790453,AWP 10,005,202038,Staff,0,0,0,0
1683306790453,AWP 10,006,202039,Staff,0,0,0,0
1683306790453,AWP 10,007,202040,Staff,0,0,0,0
1683306790453,AWP 10,008,202041,Staff,0,0,0,0
1683306790453,AWP 10,009,202042,Staff,0,0,0,0
1683306790453,AWP 10,010,202043,Staff,0,0,0,0
1683306790453,AWP 10,011,202044,Staff,0,0,0,0
1683306790453,AWP 10,012,202045,Staff,0,0,0,0
1683306790453,AWP 10,013,202046,Staff,0,0,0,0
1683306790453,AWP 10,014,202047,Staff,0,0,0,0
1683306790453,AWP 10,015,202048,Staff,0,0,0,0
1683306790453,AWP 10,016,202049,Staff,0,0,0,0
1683306790453,AWP 10,017,202050,Staff,0,0,0,0
1683306790453,AWP 10,018,202051,Staff,0,0,0,0
1683306790453,AWP 10,019,202052,Staff,0,0,0,0
1683306790453,AWP 10,020,202053,Staff,0,0,0,0
1683306790453,AWP 10,021,202054,Staff,0,0,0,0
1683306790453,AWP 10,022,202055,Staff,0,0,0,0
1683306790453,AWP 10,023,202056,Staff,0,0,0,0
1683306790453,AWP 10,024,202057,Staff,0,0,0,0
1683306790453,AWP 10,025,202058,Staff,0,0,0,0
1683306790453,AWP 10,026,202059,Staff,0,0,0,0
1683306791481,AWP 102,001,202032,Staff,0,0,0,0
1683306791481,AWP 102,002,202033,Staff,0,0,0,0
1683306792509,BENG 100,A01,254234,Taylor Amos; Alyssa C,31,0,40,9
1683306793533,BENG 196,001,270013,Engler; Adam J.,9999,0,9999,0
1683306794557,BICD 100R,A01,202018,Smith; Laurie,0,7,32,32
1683306794557,BICD 100R,A02,202019,Smith; Laurie,0,2,32,32
1683306794557,BICD 100R,A03,202020,Smith; Laurie,0,1,32,32
1683306794557,BICD 100R,A04,202021,Smith; Laurie,8,0,32,24
1683306794557,BICD 100R,A05,202022,Smith; Laurie,12,0,32,20
1683306795584,BICD 136,A01,193242,Gustafson-Brown; Cindy,0,2,32,32
1683306795584,BICD 136,A02,193244,Gustafson-Brown; Cindy,15,0,32,17
1683306796610,BIEB 102,A01,193249,Butler; Shannon Rhey,0,2,32,32
1683306796610,BIEB 102,A02,193251,Butler; Shannon Rhey,0,0,32,32
1683306796610,BIEB 102,A03,193253,Butler; Shannon Rhey,0,1,32,32
1683306796610,BIEB 102,A04,193255,Butler; Shannon Rhey,17,0,32,15
1683306796610,BIEB 102,A05,193265,Butler; Shannon Rhey,26,0,32,6
1683306796610,BIEB 102,A06,193269,Butler; Shannon Rhey,16,0,32,16
1683306798658,BIEB 150,A01,193274,Staff,0,0,32,32
1683306798658,BIEB 150,A02,193285,Staff,24,0,32,8
1683306799682,BIEB 194,A00,193286,Kurle; Carolyn M.,22,0,32,10
1683306800707,BILD 1,A01,192291,Staff,16,0,32,16
1683306800707,BILD 1,A02,192292,Staff,30,0,32,2
1683306800707,BILD 1,B01,192520,Reuther; Keefe,0,1,0,0
1683306800707,BILD 1,B02,192532,Reuther; Keefe,0,1,0,0
1683306801733,BILD 3,A01,192556,Butler; Shannon Rhey,0,0,32,32
1683306801733,BILD 3,A02,192581,Butler; Shannon Rhey,5,0,32,27
1683306801733,BILD 3,A03,192611,Butler; Shannon Rhey,23,0,32,9
1683306801733,BILD 3,A04,192612,Butler; Shannon Rhey,25,0,32,7
1683306801733,BILD 3,A05,192613,Butler; Shannon Rhey,27,0,32,5
1683306801733,BILD 3,A06,192679,Butler; Shannon Rhey,27,0,32,5
1683306801733,BILD 3,A07,192682,Butler; Shannon Rhey,22,0,32,10
1683306802763,BILD 4,A01,192836,Reuther; Keefe,1,0,24,23
1683306802763,BILD 4,A02,193044,Reuther; Keefe,4,0,24,20
1683306803788,BILD 10,A01,193142,Gustafson-Brown; Cindy,31,0,32,1
1683306803788,BILD 10,A02,193149,Gustafson-Brown; Cindy,31,0,32,1
1683306804815,BIMM 100,A01,193301,Staff,0,6,32,32
1683306804815,BIMM 100,A02,193312,Staff,0,5,32,32
1683306804815,BIMM 100,A03,193323,Staff,0,8,32,32
1683306805841,BIMM 101,A01,193329,McDonnell; Lisa Marie,0,3,24,24
1683306805841,BIMM 101,A02,193339,McDonnell; Lisa Marie,0,2,24,24
1683306805841,BIMM 101,B01,193354,McDonnell; Lisa Marie,0,3,24,24
1683306805841,BIMM 101,B02,193357,McDonnell; Lisa Marie,0,3,24,24
1683306806869,BIMM 110,A01,193377,Tat; John,0,11,32,32
1683306806869,BIMM 110,A02,193378,Tat; John,1,9,32,31
1683306807893,BIMM 120,A01,206116,Staff,0,0,32,32
1683306807893,BIMM 120,A02,206117,Staff,8,0,32,24
1683306807893,BIMM 120,A03,206121,Staff,21,0,32,11
1683306808919,BIPN 100,A01,193393,Park; Ji Young,0,14,32,32
1683306808919,BIPN 100,A02,193402,Park; Ji Young,0,12,32,32
1683306808919,BIPN 100,A03,193413,Park; Ji Young,0,14,32,32
1683306808919,BIPN 100,A04,193414,Park; Ji Young,0,13,32,32
1683306809947,BIPN 102,A01,193429,Staff,0,0,32,32
1683306809947,BIPN 102,A02,193438,Staff,22,0,32,10
1683306810975,BIPN 106,A01,193450,Reyes Gonzalez; Catalina,0,2,40,40
1683306811999,BIPN 134,A01,193465,Cooke; James Edward,0,0,32,32
1683306811999,BIPN 134,A02,193474,Cooke; James Edward,27,0,32,5
1683306811999,BIPN 134,A03,193485,Cooke; James Edward,29,0,32,3
1683306811999,BIPN 134,A04,193486,Cooke; James Edward,21,0,32,11
1683306811999,BIPN 134,A05,193491,Cooke; James Edward,31,0,32,1
1683306811999,BIPN 134,A06,193501,Cooke; James Edward,30,0,32,2
1683306811999,BIPN 134,A07,193510,Cooke; James Edward,29,0,32,3
1683306814048,BISP 194,A00,222522,Staff,16,0,32,16
1683306815075,CAT 124,A01,202407,Staff,20,0,25,5
1683306816101,CAT 125,A00,202408,Marchisotto; Jennifer Anne,4,0,20,16
1683306817125,CAT 125R,A00,202409,Smith; Lauryn Alissa,0,11,20,20
1683306817125,CAT 125R,B00,202410,Morales; Celeste Georgianna,0,11,20,20
1683306817125,CAT 125R,C00,202411,Irwin; Matthew Joseph,0,10,20,20
1683306818154,CENG 15,A01,204712,Yang; Kesong,0,1,0,0
1683306819179,CENG 114,A00,202070,Jahed Motlagh; Zeinab,5,0,20,15
1683306820207,CGS 105,A00,185477,Wesling; Megan E.,24,0,40,16
1683306821231,CGS 106,A00,185494,Staff,13,0,22,9
1683306822258,CGS 108,A00,185495,Staff,14,0,20,6
1683306823282,CGS 114,A00,185496,Staff,13,0,18,5
1683306824308,CGS 119,A00,185501,Staff,15,0,20,5
1683306825332,CGS 120,A00,185511,Staff,13,0,20,7
1683306826357,CHEM 4,A01,184675,Bussey; Thomas J,96,0,100,4
1683306827438,CHEM 6A,A01,184677,Staff,35,0,60,25
1683306828465,CHEM 6B,A01,184679,Staff,65,0,100,35
1683306829490,CHEM 6C,A01,184681,Bussey; Thomas J,1,0,50,49
1683306829490,CHEM 6C,A02,184682,Bussey; Thomas J,34,0,50,16
1683306830515,CHEM 40A,A01,184684,Albizati; Kim F.,37,0,100,63
1683306831544,CHEM 40B,A01,184686,Albizati; Kim F.,0,20,100,100
1683306832572,CHEM 41B,A01,184690,Staff,52,0,100,48
1683306833601,COGS 3,A01,184715,Boyle; Mary E. T.,0,25,40,40
1683306834625,COGS 14B,A01,185172,Staff,0,15,38,38
1683306835652,COGS 18,A01,184736,Staff,20,0,80,60
1683306836678,COGS 100,A01,184932,Staff,0,5,73,73
1683306837703,COGS 101A,A01,184935,Staff,0,38,30,30
1683306838728,COGS 101B,A01,184944,Staff,0,2,30,30
1683306839752,COGS 101C,A01,184946,Staff,0,12,30,30
1683306840779,COGS 102A,A01,184951,Johnson; Christine M.,2,0,40,38
1683306841803,COGS 107B,A01,184953,Mooshagian; Eric Frederick,0,50,40,40
1683306842827,COGS 118B,A01,184959,Gupta; Anjum,0,48,40,40
1683306843851,COGS 153,A00,184961,Staff,0,15,30,30
1683306844875,COGS 177,A00,184962,Staff,0,21,30,30
1683306845900,COGS 187A,A01,184969,Boyle; Mary E. T.,0,17,40,40
1683306846925,COMM 10,A01,185174,Staff,0,5,25,25
1683306846925,COMM 10,A02,185189,Staff,0,5,25,25
1683306846925,COMM 10,A03,269821,Staff,0,0,0,0
1683306847953,COMM 100B,A01,185475,Staff,0,0,0,2
1683306847953,COMM 100B,A02,185476,Staff,14,0,25,11
1683306848978,COMM 100C,A01,185314,Staff,1,0,25,24
1683306848978,COMM 100C,A02,185327,Staff,19,0,25,6
1683306850000,COMM 110M,A00,185349,Staff,2,0,40,38
1683306851025,COMM 113T,A00,185352,Staff,25,0,40,15
1683306852052,COMM 114I,A00,185353,Staff,33,0,40,7
1683306853078,COMM 131,A00,185354,Staff,19,0,30,11
1683306854106,CSE 8A,A50,185358,Cao; Yingjun,0,46,10,10
1683306855130,CSE 8B,A01,185362,Staff,1,47,50,49
1683306856155,CSE 11,A01,185416,Cao; Yingjun,0,93,10,10
1683306857179,CSE 20,A01,185445,Briones; Jor-el Thomas Caparas,5,0,25,20
1683306858204,CSE 21,A01,185447,Staff,10,0,50,40
1683306859227,CSE 101,A01,185451,Staff,0,12,50,50
1683306859227,CSE 101,B01,185453,Jones; Miles E,0,11,50,50
1683306861282,CSE 141,A01,185458,Eldon; John,20,0,100,80
1683306862309,CSE 141L,A01,185461,Eldon; John,12,0,100,88
1683306863335,CSE 142,A01,185463,Staff,35,0,60,25
1683306863335,CSE 142,B01,201355,Staff,0,6,60,60
1683306864360,CSE 142L,A01,185470,Staff,35,0,60,25
1683306864360,CSE 142L,B01,201417,Staff,0,5,60,60
1683306865384,CSE 190,A00,201433,Staff,32,0,49,17
1683306866412,DOC 1,A01,259136,Strom; Megan C.,8,0,15,7
1683306866412,DOC 1,A02,259137,Strom; Megan C.,14,0,15,1
1683306866412,DOC 1,A03,259138,Strom; Megan C.,14,0,15,1
1683306866412,DOC 1,A04,259139,Strom; Megan C.,14,0,15,1
1683306867439,DOC 100D,A00,259140,Pass; Natalye Joann,17,0,25,8
1683306868464,DSGN 1,A01,184749,Rill; Bryan,0,24,30,30
1683306869491,DSGN 100,A01,185168,Staff,0,2,25,25
1683306870516,ECE 5,A01,185626,Morris; Karcher William,0,10,0,0
1683306871541,ECE 101,A01,185628,Staff,17,0,70,53
1683306872570,ECE 107,A01,185635,Baghdadchi; Saharnaz,0,0,20,20
1683306872570,ECE 107,A02,185638,Baghdadchi; Saharnaz,4,0,20,16
1683306873597,ECE 148,A01,185647,Silberman; Jack,0,0,16,16
1683306874622,ECON 1,A01,185537,Crane; Meredith Helen,54,0,70,16
1683306875646,ECON 3,A01,185549,Crane; Meredith Helen,33,0,70,37
1683306876675,ECON 4,A01,203354,Anderson; John Charles,0,4,10,10
1683306877702,ECON 100A,A01,185574,Staff,0,4,40,40
1683306878731,ECON 100B,A01,185576,Staff,0,22,40,40
1683306879755,ECON 100C,A01,185589,Newhouse; Herbert S,30,0,70,40
1683306880780,ECON 105,A00,185608,Vespa; Emanuel Ignacio,19,0,35,16
1683306881806,ECON 109,A01,185610,Shishkin; Denis,10,0,35,25
1683306882832,ECON 110A,A01,185612,Staff,11,0,40,29
1683306883857,ECON 120A,A01,185615,Staff,20,0,40,20
1683306884881,ECON 120C,A01,185617,Sun; Yixiao,0,20,70,70
1683306885908,ECON 144,A00,203346,Squires; Dale E,3,0,35,32
1683306886935,ECON 171,A01,203349,Newhouse; Herbert S,0,1,35,35
1683306887962,ECON 173A,A01,185621,Toda; Alexis Akira,21,0,35,14
1683306888988,EDS 25,A01,202413,Staff,0,1,0,0
1683306888988,EDS 25,A02,202414,Staff,0,1,0,0
1683306888988,EDS 25,A03,202415,Staff,0,0,0,0
1683306888988,EDS 25,A04,202416,Staff,0,1,0,0
1683306888988,EDS 25,A05,202439,Staff,0,0,0,0
1683306888988,EDS 25,A06,202440,Staff,0,0,0,0
1683306888988,EDS 25,B01,202631,Staff,0,0,0,0
1683306888988,EDS 25,B02,202632,Staff,0,0,0,0
1683306888988,EDS 25,B03,202639,Staff,0,0,0,0
1683306888988,EDS 25,B04,202640,Staff,0,0,0,0
1683306888988,EDS 25,B05,202643,Staff,0,0,0,0
1683306888988,EDS 25,B06,202644,Staff,0,0,0,0
1683306890017,EDS 38,A01,202659,Black; Alison Michelle,24,0,25,1
1683306891041,EDS 115,A00,202652,Staff,17,0,30,13
1683306892063,EDS 125,A00,202649,Staff,14,0,30,16
1683306893091,EDS 126,A01,203332,Staff,30,0,30,0
1683306894117,EDS 139,A00,202838,Staff,17,0,25,8
1683306895142,EDS 146,A01,202655,Staff,15,0,25,10
1683306896167,ENG 15,A00,185667,Staff,0,1,0,0
1683306896167,ENG 15,B00,185672,Staff,0,0,0,0
1683306896167,ENG 15,C00,185675,Staff,0,0,0,0
1683306896167,ENG 15,D00,185682,Staff,0,0,0,0
1683306896167,ENG 15,E00,185684,Staff,0,0,0,0
1683306897190,ETHN 103,A00,185710,Staff,0,3,35,35
1683306898214,ETHN 103A,A00,199228,Man; Simeon S,2,0,9,7
1683306899238,ETHN 109,A00,185711,Staff,18,0,35,17
1683306900264,ETHN 142,A00,185726,Staff,0,4,30,30
1683306901287,ETHN 163J,A00,199229,Man; Simeon S,6,0,8,2
1683306902316,ETHN 168,A00,185727,Staff,8,0,10,2
1683306903338,ETHN 182,A00,185728,Staff,1,0,35,34
1683306904364,ETHN 183,A00,185737,Staff,8,0,18,10
1683306905391,GLBH 111,A01,209361,Burgos; Jose L.,0,0,0,0
1683306907442,HIEU 104,A00,185792,Staff,16,0,20,4
1683306908467,HIEU 115,A00,185800,Staff,1,0,20,19
1683306909493,HIEU 128,A00,185801,Staff,0,7,20,20
1683306910520,HIEU 147,A00,185802,Staff,16,0,20,4
1683306911550,HIEU 154,A00,185823,Staff,12,0,20,8
1683306912576,HILA 102,A00,185826,Staff,13,0,20,7
1683306913603,HILD 2C,A01,185778,Staff,0,12,20,20
1683306914627,HILD 7B,A01,185780,Kwak; Nancy,0,15,32,32
1683306914627,HILD 7B,A02,185781,Kwak; Nancy,0,18,32,32
1683306915655,HILD 30,A01,185791,Staff,14,0,20,6
1683306916682,HISC 119,A00,185830,Golan; Tal,0,9,20,20
1683306917706,HITO 156GS,A00,185831,Patterson; Patrick H.,0,0,0,23
1683306918729,HIUS 103,A00,185832,Man; Simeon S,0,6,20,20
1683306919753,HIUS 117,A00,185836,Kwak; Nancy,2,0,20,18
1683306920778,HIUS 125,A00,185840,Man; Simeon S,0,0,23,23
1683306921802,HIUS 149,A00,185845,Staff,0,0,20,20
1683306922826,HUM 3,A01,185882,Zavodny; Tatiana Sophia,0,6,50,50
1683306922826,HUM 3,B01,185899,Caldwell; Michael Alan,0,19,50,50
1683306923851,HUM 3GS,A00,185900,Patterson; Patrick H.,0,0,0,23
1683306924878,HUM 4,A01,185938,Zroka; Amy Liane,30,0,50,20
1683306924878,HUM 4,B01,185956,Watkins; Eric,0,2,50,50
1683306924878,HUM 4,B02,202209,Watkins; Eric,0,1,50,50
1683306924878,HUM 4,B03,202210,Watkins; Eric,0,0,50,50
1683306925905,HUM 5,A01,185958,West; Geoffrey Scott,5,0,50,45
1683306925905,HUM 5,A02,202215,West; Geoffrey Scott,0,0,50,50
1683306926933,INTL 190,A00,185959,Gagnon; Jeffrey C,0,0,0,9
1683306926933,INTL 190,B00,185960,Lettieri; Michael Joseph,0,0,0,1
1683306927955,JAPN 180,A00,254509,Staff,5,1,30,25
1683306928985,LATI 10,A01,202853,Kennemore; Amy Michelle,5,0,35,30
1683306928985,LATI 10,A02,202854,Kennemore; Amy Michelle,1,0,35,34
1683306928985,LATI 10,A03,270054,Kennemore; Amy Michelle,30,0,30,0
1683306930010,LATI 180,A00,202855,Kennemore; Amy Michelle,11,0,20,9
1683306931093,LAWS 101,A00,201767,Golan; Tal,0,7,40,40
1683306932116,LIFR 1C,A00,185961,Staff,6,0,20,14
1683306933140,LIFR 1CX,A00,185962,Staff,7,0,20,13
1683306934167,LIFR 1D,A00,185963,Staff,9,0,20,11
1683306935194,LIFR 1DX,A00,185964,Staff,9,0,20,11
1683306936221,LIGN 101,A01,186039,Staff,43,0,50,7
1683306937244,LIGN 165,A00,186040,Staff,18,0,50,32
1683306938267,LTCS 108,A00,186041,Staff,6,0,10,4
1683306939294,LTCS 119,A00,186042,Staff,16,0,20,4
1683306940319,LTCS 130,A00,186043,Wesling; Megan E.,15,0,25,10
1683306942368,LTEA 138,A00,186119,Staff,14,0,40,26
1683306943393,LTEN 124,A00,186148,Staff,6,0,25,19
1683306944416,LTEN 178,A00,186149,Staff,7,0,15,8
1683306945442,LTEN 181,A00,186150,Blanco; John D,33,0,40,7
1683306946466,LTWL 120,A00,186160,Staff,20,0,25,5
1683306947491,LTWL 165,A00,186161,Staff,22,0,25,3
1683306948513,LTWR 100,A00,186162,Staff,0,4,15,15
1683306949542,LTWR 102,A00,186163,Doller; Ben,5,0,15,10
1683306950568,MAE 8,A01,186412,Staff,0,0,0,0
1683306951592,MAE 30B,A00,186445,Bahadori; Mohammad Yousef,83,0,100,17
1683306952617,MAE 40,A00,186592,Bewley; Thomas R,9,0,50,41
1683306953644,MAE 101B,A00,186593,Bahadori; Mohammad Yousef,81,0,100,19
1683306954667,MAE 105,A00,186594,Bandaru; Prabhakar,12,0,50,38
1683306955694,MAE 107,A00,186599,Pham; Hieu Tan,0,6,120,120
1683306956720,MAE 148,A01,186660,Silberman; Jack,3,0,16,13
1683306957743,MATH 10A,A01,188095,Staff,0,7,35,35
1683306958769,MATH 10B,A01,188097,Bowers; Adam R.,0,11,30,30
1683306958769,MATH 10B,A02,188099,Bowers; Adam R.,0,9,30,30
1683306958769,MATH 10B,B01,188104,Bowers; Adam R.,0,11,30,30
1683306958769,MATH 10B,B02,188106,Bowers; Adam R.,0,11,30,30
1683306959795,MATH 10C,A01,188111,Staff,0,18,30,30
1683306959795,MATH 10C,A02,188127,Staff,0,17,30,30
1683306959795,MATH 10C,A03,188131,Staff,0,17,30,30
1683306959795,MATH 10C,B01,188218,Staff,21,0,30,9
1683306959795,MATH 10C,B02,188244,Staff,13,0,30,17
1683306959795,MATH 10C,B03,188277,Staff,16,0,30,14
1683306960821,MATH 18,A01,188344,Bach; Quang Tran,18,0,30,12
1683306960821,MATH 18,A02,188345,Bach; Quang Tran,11,0,30,19
1683306960821,MATH 18,B01,188353,Bach; Quang Tran,10,0,30,20
1683306960821,MATH 18,B02,188354,Bach; Quang Tran,20,0,30,10
1683306961854,MATH 20A,A01,188374,Staff,13,0,35,22
1683306962883,MATH 20B,A01,188382,Ohm; Ko Woon,6,0,30,24
1683306962883,MATH 20B,A02,188383,Ohm; Ko Woon,24,0,30,6
1683306962883,MATH 20B,B01,188385,Ohm; Ko Woon,7,0,30,23
1683306962883,MATH 20B,B02,188392,Ohm; Ko Woon,22,0,30,8
1683306963909,MATH 20C,A01,188394,Harel; Guershon,10,0,30,20
1683306963909,MATH 20C,A02,188395,Harel; Guershon,13,0,30,17
1683306963909,MATH 20C,B01,188404,Harel; Guershon,3,0,30,27
1683306963909,MATH 20C,B02,188405,Harel; Guershon,19,0,30,11
1683306964945,MATH 20D,A01,188414,Hammock; Frances H,0,1,30,30
1683306964945,MATH 20D,A02,188415,Hammock; Frances H,4,0,30,26
1683306964945,MATH 20D,B01,188447,Hammock; Frances H,2,0,30,28
1683306964945,MATH 20D,B02,188486,Hammock; Frances H,8,0,30,22
1683306965968,MATH 20E,A01,188649,Staff,22,0,30,8
1683306965968,MATH 20E,A02,188650,Staff,23,0,30,7
1683306965968,MATH 20E,A03,188673,Staff,0,0,30,30
1683306966994,MATH 102,A01,188675,Staff,0,35,35,35
1683306968019,MATH 103B,A01,188681,Staff,4,0,35,31
1683306968019,MATH 103B,B01,188692,Staff,7,0,35,28
1683306969043,MATH 109,A01,188695,Salehi Golsefidy; Alireza,25,0,35,10
1683306969043,MATH 109,A02,188696,Salehi Golsefidy; Alireza,27,0,35,8
1683306970076,MATH 120A,A01,188698,Eggers; John Dietrich,6,0,35,29
1683306971101,MATH 142B,A01,188736,Ioana; Adrian,0,2,30,30
1683306971101,MATH 142B,A02,188741,Ioana; Adrian,0,1,30,30
1683306971101,MATH 142B,A03,188743,Ioana; Adrian,0,3,30,30
1683306972127,MATH 168A,A01,188790,Staff,0,9,35,35
1683306973153,MATH 170A,A01,188803,Nie; Jiawang,0,2,35,35
1683306973153,MATH 170A,A02,188811,Nie; Jiawang,0,0,35,35
1683306973153,MATH 170A,A03,188814,Nie; Jiawang,1,0,35,34
1683306973153,MATH 170A,A04,188815,Nie; Jiawang,13,0,35,22
1683306974187,MATH 193B,A01,188817,Staff,0,0,35,35
1683306974187,MATH 193B,A02,188818,Staff,5,0,35,30
1683306975212,MGT 4,A01,202857,Anderson; John Charles,62,0,80,18
1683306976240,MGT 12,A00,202858,Lindenberger; Wade Douglas,43,0,90,47
1683306977266,MGT 18,A00,202859,Staff,74,0,90,16
1683306978294,MGT 18GS,A00,202860,McKay; Michael J,13,0,28,15
1683306979323,MGT 45,A00,202861,Pecore; Joseph P.,14,0,90,76
1683306980350,MGT 100,A00,202863,Yavorsky; Daniel Ryan,28,0,90,62
1683306981377,MGT 103,A00,202864,Ehrich; Kristine R,0,16,90,90
1683306982400,MGT 112,A00,202865,Ehrich; Kristine R,15,0,90,75
1683306983425,MGT 121A,A00,202868,Staff,0,19,0,0
1683306984448,MGT 131B,A00,202869,Anderson; John Charles,59,0,90,31
1683306985474,MGT 136,A00,202871,Lindenberger; Wade Douglas,84,0,90,6
1683306986502,MGT 164,A00,202873,Staff,0,69,90,90
1683306987528,MGT 164GS,A00,202874,McKay; Mary A,13,0,28,15
1683306988556,MGT 180,A00,202875,Staff,0,51,90,90
1683306989579,MMW 11R,A01,205019,Herbst; Matthew,3,0,30,27
1683306989579,MMW 11R,A02,205026,Herbst; Matthew,29,0,30,1
1683306990603,MMW 15,A01,193512,Chang; Edmond Yi-Teh,0,9,28,28
1683306990603,MMW 15,A02,193513,Chang; Edmond Yi-Teh,0,5,28,28
1683306990603,MMW 15,A03,193514,Chang; Edmond Yi-Teh,0,5,28,28
1683306990603,MMW 15,A04,193515,Chang; Edmond Yi-Teh,0,5,28,28
1683306990603,MMW 15,A05,193516,Chang; Edmond Yi-Teh,0,4,28,28
1683306990603,MMW 15,A06,193517,Chang; Edmond Yi-Teh,0,5,28,28
1683306990603,MMW 15,B01,193519,Chang; Edmond Yi-Teh,0,4,28,28
1683306990603,MMW 15,B02,193520,Chang; Edmond Yi-Teh,0,5,28,28
1683306990603,MMW 15,B03,193521,Chang; Edmond Yi-Teh,0,4,28,28
1683306990603,MMW 15,B04,193522,Chang; Edmond Yi-Teh,0,4,28,28
1683306990603,MMW 15,B05,193523,Chang; Edmond Yi-Teh,0,5,28,28
1683306990603,MMW 15,B06,193524,Chang; Edmond Yi-Teh,0,4,28,28
1683306991631,MMW 122,A01,193526,Rahimi; Babak,0,14,28,28
1683306991631,MMW 122,A02,193527,Rahimi; Babak,0,14,28,28
1683306991631,MMW 122,A03,193528,Rahimi; Babak,0,0,0,0
1683306991631,MMW 122,A04,193529,Rahimi; Babak,0,0,0,0
1683306992654,MUS 1A,A01,186663,Staff,0,20,35,35
1683306993681,MUS 4,A01,186715,Staff,0,12,35,35
1683306994705,MUS 5R,A01,186796,Dubnov; Shlomo,0,17,35,35
1683306995730,MUS 6,A01,186798,Staff,0,3,25,25
1683306996755,MUS 7,A01,186830,Staff,12,0,35,23
1683306997784,MUS 8,A01,186930,Staff,0,26,35,35
1683306998812,MUS 15,A01,186932,Staff,0,15,35,35
1683306998812,MUS 15,B01,186934,Staff,0,15,35,35
1683306999835,MUS 80,A00,186935,Staff,2,0,20,18
1683306999835,MUS 80,B00,186936,Staff,25,0,25,0
1683307000862,NANO 11,A00,204702,Lipomi; Darren John,0,0,0,0
1683307001886,NANO 15,A01,204709,Yang; Kesong,0,1,0,0
1683307002912,NANO 114,A00,202069,Jahed Motlagh; Zeinab,3,0,10,7
1683307003937,PHIL 1,A00,186955,Grush; Rick Scott,32,0,40,8
1683307004960,PHIL 10,A01,186973,Grush; Rick Scott,28,0,35,7
1683307004960,PHIL 10,A02,186974,Grush; Rick Scott,33,0,35,2
1683307005983,PHIL 13,A01,186976,Staff,7,0,35,28
1683307005983,PHIL 13,A02,186977,Staff,16,0,35,19
1683307007008,PHIL 14,A01,186979,Staff,31,0,35,4
1683307007008,PHIL 14,A02,186986,Staff,32,0,35,3
1683307008036,PHIL 28,A01,186988,Staff,16,0,30,14
1683307008036,PHIL 28,A02,186989,Staff,1,0,30,29
1683307008036,PHIL 28,A03,186990,Staff,9,0,30,21
1683307008036,PHIL 28,A04,186991,Staff,26,0,30,4
1683307009061,PHIL 120,A00,186997,Staff,23,0,40,17
1683307010085,PHIL 137,A00,187003,Staff,9,0,40,31
1683307011112,PHIL 150,A00,187015,Staff,47,0,70,23
1683307012138,PHIL 167,A00,187021,Lamey; Andy M.,35,0,40,5
1683307013162,PHIL 174,A01,202226,Staff,17,0,20,3
1683307013162,PHIL 174,A02,202235,Staff,20,0,20,0
1683307014186,PHIL 191A,A00,258918,Staff,0,0,1,1
1683307015212,PHYS 1A,A00,187028,Staff,26,0,60,34
1683307016236,PHYS 1AL,001,187036,Staff,2,0,30,28
1683307016236,PHYS 1AL,002,187049,Staff,18,0,30,12
1683307017262,PHYS 1B,A00,187058,Staff,23,0,60,37
1683307018286,PHYS 1BL,001,187064,Staff,0,0,30,30
1683307018286,PHYS 1BL,002,187070,Staff,6,0,30,24
1683307019314,PHYS 1C,A00,187082,Staff,31,0,120,89
1683307020343,PHYS 1CL,001,187088,Staff,0,9,30,30
1683307020343,PHYS 1CL,002,187089,Staff,0,2,30,30
1683307020343,PHYS 1CL,009,262693,Staff,11,0,30,19
1683307021372,PHYS 2B,A01,187097,Staff,54,0,115,61
1683307022397,PHYS 2C,A01,187099,Staff,67,0,115,48
1683307023422,PHYS 2CL,A01,187101,Staff,5,0,28,23
1683307023422,PHYS 2CL,A02,187102,Staff,15,0,28,13
1683307024450,PHYS 2D,A01,187123,Shotwell; Brian,95,0,115,20
1683307025477,PHYS 4B,A01,187133,Grinstein; Benjamin,35,0,50,15
1683307026501,POLI 10,A00,188819,Staff,0,3,50,50
1683307027526,POLI 11,A00,188827,Staff,43,0,50,7
1683307028549,POLI 13R,A00,188828,Staff,0,1,20,20
1683307029573,POLI 27,A01,188830,Elgin; Samuel Zincke,0,1,70,70
1683307030602,POLI 30,A00,188832,Desposato; Scott,33,0,50,17
1683307031629,POLI 102F,A00,188834,Staff,3,0,40,37
1683307032656,POLI 104A,A00,188852,Staff,14,0,30,16
1683307033685,POLI 104I,A00,188853,Staff,0,6,20,20
1683307034766,POLI 110B,A00,188854,Wiens; David,7,0,20,13
1683307035795,POLI 112A,A00,188855,Wiens; David,5,0,30,25
1683307036822,POLI 117R,A00,188856,Forman; Fonna,0,11,20,20
1683307037847,POLI 118,A00,188857,Ingham; Sean,8,0,20,12
1683307038873,POLI 120G,A00,188858,Staff,9,0,30,21
1683307039900,POLI 131CR,A00,188863,Hoston; Germaine,24,0,50,26
1683307040924,POLI 133,A00,188864,Nellis; Gareth Hb,44,0,50,6
1683307041952,POLI 134D,A00,188865,Desposato; Scott,27,0,30,3
1683307042976,POLI 142A,A00,188871,Gartzke; Erik,22,0,50,28
1683307044002,POLI 142K,A00,188874,Staff,38,0,50,12
1683307045026,POLI 143,A00,188940,Gartzke; Erik,16,0,30,14
1683307046050,POLI 153,A00,188943,Staff,3,0,20,17
1683307047076,POLI 160AA,A00,188944,Staff,13,0,40,27
1683307048099,POLI 170A,A00,188945,Staff,11,0,30,19
1683307050152,PSYC 1,A00,188952,Staff,38,0,90,52
1683307051179,PSYC 2,B00,188953,Staff,20,0,35,15
1683307052206,PSYC 6,A00,188970,Staff,47,0,60,13
1683307053235,PSYC 7,A00,188973,Staff,37,0,45,8
1683307054260,PSYC 60,A01,188980,Rickard; Timothy C.,43,0,60,17
1683307055288,PSYC 70,A01,189001,Steiner; Eric Tomas,24,0,45,21
1683307056312,PSYC 100,A00,189005,Lacefield; Katharine I,0,99,120,120
1683307057335,PSYC 102,A00,189008,Staff,10,0,30,20
1683307058362,PSYC 106,B00,189026,Gorman; Michael R.,37,0,60,23
1683307059388,PSYC 114,B01,189033,Winkielman; Piotr,0,32,30,30
1683307060415,PSYC 131,A00,189036,Anagnostaras; Stephan,0,43,60,60
1683307061442,PSYC 136,A00,189041,Lowe; Angela Beth,0,7,25,25
1683307062467,PSYC 137,A00,189057,Winkielman; Piotr,0,34,25,25
1683307063493,PSYC 144,A00,189107,Wixted; John T,0,7,50,50
1683307065547,PSYC 162,A00,189142,Staff,0,8,85,85
1683307066579,PSYC 172,A00,189144,Gorman; Michael R.,0,7,30,30
1683307068630,PSYC 179,A00,189146,Lacefield; Katharine I,0,84,120,120
1683307069653,PSYC 181,A00,189147,Anagnostaras; Stephan,0,44,90,90
1683307070676,PSYC 190R,A00,189148,Barner; David A.,0,22,80,80
1683307071704,PSYC 191,A00,189275,Rickard; Timothy C.,0,7,25,25
1683307072727,PSYC 193,A00,189276,Chapman; Eddie Nathaniel,0,1,0,4
1683307073756,PSYC 193L,A01,189281,Lowe; Angela Beth,12,0,20,8
1683307073756,PSYC 193L,B01,189285,Staff,28,0,35,7
1683307074782,RELI 149,A00,187137,Rahimi; Babak,7,0,40,33
1683307075806,SE 9,A01,187315,Staff,0,2,18,18
1683307076830,SE 101B,A00,187409,Staff,24,0,30,6
1683307077857,SE 110B,A00,187444,Staff,10,0,40,30
1683307078881,SE 130B,A00,187449,Staff,31,0,40,9
1683307079916,SE 150A,A00,187516,Staff,9,0,20,11
1683307080950,SE 154,A00,187528,Staff,30,0,50,20
1683307081973,SIO 3,A01,258171,Staff,35,0,40,5
1683307083000,SIO 10,A00,187144,Cook; Geoffrey W,0,3,75,75
1683307084028,SIO 45,A00,187152,Cook; Geoffrey W,1,0,100,99
1683307085053,SIO 109R,A00,194486,Staff,0,3,20,20
1683307087103,SIO 187,A01,187233,Kacev; David,12,0,40,28
1683307088130,SOCI 1,A01,258656,Thorpe; Charles Robert,28,0,30,2
1683307088130,SOCI 1,A02,258658,Thorpe; Charles Robert,30,0,30,0
1683307088130,SOCI 1,A03,258661,Thorpe; Charles Robert,25,0,25,0
1683307088130,SOCI 1,A04,258666,Thorpe; Charles Robert,22,0,25,3
1683307088130,SOCI 1,A05,258897,Thorpe; Charles Robert,23,0,25,2
1683307088130,SOCI 1,A06,258898,Thorpe; Charles Robert,25,0,25,0
1683307089154,SOCI 30,A01,258903,Pardo Guerra; Juan Pablo,16,0,30,14
1683307090180,SOCI 102,A00,258904,Staff,9,0,25,16
1683307091203,SOCI 106,A00,258905,Staff,19,0,25,6
1683307092228,SOCI 111,A00,258907,Ribas Norris; Janet Vanesa,26,0,30,4
1683307093253,SOCI 121R,A00,258908,Pardo Guerra; Juan Pablo,11,0,30,19
1683307094278,SOCI 126,A01,203330,Staff,14,0,20,6
1683307095302,SOCI 131,A00,258909,Thorpe; Charles Robert,31,0,60,29
1683307096328,SOCI 135,A00,258910,Payne; Christine Anna,0,9,30,30
1683307097354,SOCI 157,A00,258911,Staff,13,0,30,17
1683307098378,SOCI 184,A00,258912,Staff,26,0,30,4
1683307099403,SOCI 188D,A00,258913,Staff,21,0,30,9
1683307100428,SYN 2,001,187529,Staff,9,0,16,7
1683307100428,SYN 2,002,201452,Staff,0,18,16,16
1683307100428,SYN 2,003,201469,Staff,3,0,16,13
1683307101452,SYN 100,A01,187531,Staff,0,9,20,20
1683307101452,SYN 100,B01,201491,Staff,0,12,20,20
1683307102478,TDAC 1,A00,189286,Walsh; Kim C.,3,0,20,17
1683307102478,TDAC 1,B00,189287,Harting; Carla Kelso,11,0,20,9
1683307103506,TDAC 101,A00,189300,Walsh; Kim C.,16,0,20,4
1683307103506,TDAC 101,B00,189301,Harting; Carla Kelso,18,0,20,2
1683307104533,TDAC 102,A00,189304,Basso; Beatrice,14,0,20,6
1683307105558,TDAC 108,A00,189305,Staff,18,0,20,2
1683307106584,TDDE 131,A00,189310,Staff,19,0,20,1
1683307106584,TDDE 131,B00,189314,Staff,19,0,20,1
1683307106584,TDDE 131,C00,189315,Staff,48,0,50,2
1683307106584,TDDE 131,D00,189316,Staff,14,0,15,1
1683307106584,TDDE 131,E00,204841,Staff,20,0,20,0
1683307107611,TDGE 10,A00,189289,Staff,30,0,50,20
1683307107611,TDGE 10,B00,189290,Havis; Allan,2,0,50,48
1683307108635,TDGE 11,A00,189291,Fulton; Julia,0,3,50,50
1683307108635,TDGE 11,B00,189292,Staff,20,0,25,5
1683307108635,TDGE 11,C00,260270,Staff,0,0,0,0
1683307109658,TDGE 25,A00,189294,Staff,3,0,20,17
1683307110682,TDGE 124,A00,189318,Fulton; Julia,0,8,50,50
1683307111707,TDGE 125,A00,189319,Staff,13,0,25,12
1683307111707,TDGE 125,B00,189320,Staff,23,0,25,2
1683307112730,TDGE 127,A00,189322,Havis; Allan,0,0,50,50
1683307113758,TDHT 101,A00,189323,Staff,18,0,25,7
1683307113758,TDHT 101,B00,189324,Staff,25,0,25,0
1683307114785,TDHT 102,A00,189325,Staff,49,0,50,1
1683307115810,TDMV 1,A00,189295,Arcidiacono; Kristin,20,0,30,10
1683307115810,TDMV 1,B00,189296,Caligagan; Maria T.,24,0,30,6
1683307116838,TDMV 2,A00,189297,Sammartano; Tonnie,28,0,30,2
1683307116838,TDMV 2,B00,189299,Arcidiacono; Kristin,24,0,30,6
1683307117862,TDMV 3,A00,204998,Rincon; Alicia,22,0,30,8
1683307118885,TDMV 120,A00,189458,Sammartano; Tonnie,28,0,30,2
1683307119909,TDMV 138,A00,189541,Jun; Grace Shin Hae,22,0,40,18
1683307120936,TDMV 142,A00,189717,Caligagan; Tony,23,0,30,7
1683307120936,TDMV 142,B00,189718,Caligagan; Maria T.,25,0,30,5
1683307121961,TMC 2,A01,187533,Staff,25,0,25,0
1683307121961,TMC 2,A02,187534,Staff,25,0,25,0
1683307122984,USP 1,A01,187536,Kwak; Nancy,0,16,25,25
1683307124011,USP 5,A01,187538,Staff,9,0,25,16
1683307125036,USP 101,A00,199253,Staff,0,4,0,0
1683307126059,USP 124,A00,187562,Boomhower; Matthew Charles,1,0,30,29
1683307127086,USP 138,A00,187582,Staff,20,0,25,5
1683307128110,USP 152,A01,187597,Staff,4,0,25,21
1683307129134,USP 153,A00,187598,Staff,19,0,25,6
1683307130157,USP 168,A00,187607,Kwak; Nancy,2,0,5,3
1683307131181,USP 173,A00,187619,Staff,4,0,25,21
1683307132207,USP 181,A00,187638,Staff,0,0,25,25
1683307133234,VIS 103,A00,187650,Cruz; Edwin Teddy,23,0,75,52
1683307134258,VIS 110D,A00,187669,Staff,12,0,22,10
1683307135282,VIS 127C,A00,187720,Shen; Kuiyi,68,0,146,78
1683307136305,VIS 149,A00,187731,Yoldas; Pinar,0,14,22,22
1683307137332,VIS 151,A01,188091,Staff,22,0,34,12
1683307137332,VIS 151,A02,188092,Staff,11,0,34,23
1683307138413,VIS 160B,A00,188093,Stalbaum; Brett,0,0,10,10
1683307140468,WCWP 10B,A00,201720,Staff,10,0,15,5
1683307140468,WCWP 10B,B00,201722,Staff,8,0,15,7
1683307141494,WCWP 100,A00,201725,Gagnon; Jeffrey C,0,0,2,2
1683307141494,WCWP 100,B00,201727,Staff,0,4,15,15
1683307144615,ANBI 133,A00,258401,Wilder; Linnea Lorene,34,0,40,6
1683307145639,ANBI 140,A00,258395,Hrvoj Mihic; Branka,18,0,25,7
1683307146663,ANSC 120,A00,258402,Bialecki; Jon Anthony,27,0,40,13
1683307147687,ANSC 144,A00,258400,Staff,14,0,40,26
1683307149740,ANSC 166,A00,258396,Parish; Steven Martin,157,0,175,18
1683307150764,ANSC 180,A00,193533,Staff,9,0,20,11
1683307151788,ANSC 188,A00,258397,Jassal; Aftab,33,0,40,7
1683307152815,ANTH 3,A01,258316,Staff,23,0,30,7
1683307153841,ANTH 5,A00,258394,Semendeferi; Ekaterini,16,0,20,4
1683307154864,ANTH 21,A01,258331,Staff,9,0,40,31
1683307155891,ANTH 103,A00,258398,Varma; Saiba,15,0,25,10
1683307156922,AWP 10,001,202034,Staff,0,0,0,0
1683307156922,AWP 10,002,202035,Staff,0,0,0,0
1683307156922,AWP 10,003,202036,Staff,0,0,0,0
1683307156922,AWP 10,004,202037,Staff,0,0,0,0
1683307156922,AWP 10,005,202038,Staff,0,0,0,0
1683307156922,AWP 10,006,202039,Staff,0,0,0,0
1683307156922,AWP 10,007,202040,Staff,0,0,0,0
1683307156922,AWP 10,008,202041,Staff,0,0,0,0
1683307156922,AWP 10,009,202042,Staff,0,0,0,0
1683307156922,AWP 10,010,202043,Staff,0,0,0,0
1683307156922,AWP 10,011,202044,Staff,0,0,0,0
1683307156922,AWP 10,012,202045,Staff,0,0,0,0
1683307156922,AWP 10,013,202046,Staff,0,0,0,0
1683307156922,AWP 10,014,202047,Staff,0,0,0,0
1683307156922,AWP 10,015,202048,Staff,0,0,0,0
1683307156922,AWP 10,016,202049,Staff,0,0,0,0
1683307156922,AWP 10,017,202050,Staff,0,0,0,0
1683307156922,AWP 10,018,202051,Staff,0,0,0,0
1683307156922,AWP 10,019,202052,Staff,0,0,0,0
1683307156922,AWP 10,020,202053,Staff,0,0,0,0
1683307156922,AWP 10,021,202054,Staff,0,0,0,0
1683307156922,AWP 10,022,202055,Staff,0,0,0,0
1683307156922,AWP 10,023,202056,Staff,0,0,0,0
1683307156922,AWP 10,024,202057,Staff,0,0,0,0
1683307156922,AWP 10,025,202058,Staff,0,0,0,0
1683307156922,AWP 10,026,202059,Staff,0,0,0,0
1683307157948,AWP 102,001,202032,Staff,0,0,0,0
1683307157948,AWP 102,002,202033,Staff,0,0,0,0
1683307158972,BENG 100,A01,254234,Taylor Amos; Alyssa C,31,0,40,9
1683307159996,BENG 196,001,270013,Engler; Adam J.,9999,0,9999,0
1683307161022,BICD 100R,A01,202018,Smith; Laurie,0,7,32,32
1683307161022,BICD 100R,A02,202019,Smith; Laurie,0,2,32,32
1683307161022,BICD 100R,A03,202020,Smith; Laurie,0,1,32,32
1683307161022,BICD 100R,A04,202021,Smith; Laurie,8,0,32,24
1683307161022,BICD 100R,A05,202022,Smith; Laurie,12,0,32,20
1683307162048,BICD 136,A01,193242,Gustafson-Brown; Cindy,0,2,32,32
1683307162048,BICD 136,A02,193244,Gustafson-Brown; Cindy,15,0,32,17
1683307163072,BIEB 102,A01,193249,Butler; Shannon Rhey,0,2,32,32
1683307163072,BIEB 102,A02,193251,Butler; Shannon Rhey,0,0,32,32
1683307163072,BIEB 102,A03,193253,Butler; Shannon Rhey,0,1,32,32
1683307163072,BIEB 102,A04,193255,Butler; Shannon Rhey,17,0,32,15
1683307163072,BIEB 102,A05,193265,Butler; Shannon Rhey,26,0,32,6
1683307163072,BIEB 102,A06,193269,Butler; Shannon Rhey,16,0,32,16
1683307165136,BIEB 150,A01,193274,Staff,0,0,32,32
1683307165136,BIEB 150,A02,193285,Staff,24,0,32,8
1683307166162,BIEB 194,A00,193286,Kurle; Carolyn M.,22,0,32,10
1683307167189,BILD 1,A01,192291,Staff,16,0,32,16
1683307167189,BILD 1,A02,192292,Staff,30,0,32,2
1683307167189,BILD 1,B01,192520,Reuther; Keefe,0,1,0,0
1683307167189,BILD 1,B02,192532,Reuther; Keefe,0,1,0,0
1683307168218,BILD 3,A01,192556,Butler; Shannon Rhey,0,0,32,32
1683307168218,BILD 3,A02,192581,Butler; Shannon Rhey,5,0,32,27
1683307168218,BILD 3,A03,192611,Butler; Shannon Rhey,23,0,32,9
1683307168218,BILD 3,A04,192612,Butler; Shannon Rhey,25,0,32,7
1683307168218,BILD 3,A05,192613,Butler; Shannon Rhey,27,0,32,5
1683307168218,BILD 3,A06,192679,Butler; Shannon Rhey,27,0,32,5
1683307168218,BILD 3,A07,192682,Butler; Shannon Rhey,22,0,32,10
1683307169247,BILD 4,A01,192836,Reuther; Keefe,1,0,24,23
1683307169247,BILD 4,A02,193044,Reuther; Keefe,4,0,24,20
1683307170275,BILD 10,A01,193142,Gustafson-Brown; Cindy,31,0,32,1
1683307170275,BILD 10,A02,193149,Gustafson-Brown; Cindy,31,0,32,1
1683307171299,BIMM 100,A01,193301,Staff,0,6,32,32
1683307171299,BIMM 100,A02,193312,Staff,0,5,32,32
1683307171299,BIMM 100,A03,193323,Staff,0,8,32,32
1683307172325,BIMM 101,A01,193329,McDonnell; Lisa Marie,0,3,24,24
1683307172325,BIMM 101,A02,193339,McDonnell; Lisa Marie,0,2,24,24
1683307172325,BIMM 101,B01,193354,McDonnell; Lisa Marie,0,3,24,24
1683307172325,BIMM 101,B02,193357,McDonnell; Lisa Marie,0,3,24,24
1683307173350,BIMM 110,A01,193377,Tat; John,0,11,32,32
1683307173350,BIMM 110,A02,193378,Tat; John,1,9,32,31
1683307174372,BIMM 120,A01,206116,Staff,0,0,32,32
1683307174372,BIMM 120,A02,206117,Staff,8,0,32,24
1683307174372,BIMM 120,A03,206121,Staff,21,0,32,11
1683307175399,BIPN 100,A01,193393,Park; Ji Young,0,14,32,32
1683307175399,BIPN 100,A02,193402,Park; Ji Young,0,12,32,32
1683307175399,BIPN 100,A03,193413,Park; Ji Young,0,14,32,32
1683307175399,BIPN 100,A04,193414,Park; Ji Young,0,13,32,32
1683307176426,BIPN 102,A01,193429,Staff,0,0,32,32
1683307176426,BIPN 102,A02,193438,Staff,22,0,32,10
1683307177451,BIPN 106,A01,193450,Reyes Gonzalez; Catalina,0,2,40,40
1683307178475,BIPN 134,A01,193465,Cooke; James Edward,0,0,32,32
1683307178475,BIPN 134,A02,193474,Cooke; James Edward,27,0,32,5
1683307178475,BIPN 134,A03,193485,Cooke; James Edward,29,0,32,3
1683307178475,BIPN 134,A04,193486,Cooke; James Edward,21,0,32,11
1683307178475,BIPN 134,A05,193491,Cooke; James Edward,31,0,32,1
1683307178475,BIPN 134,A06,193501,Cooke; James Edward,30,0,32,2
1683307178475,BIPN 134,A07,193510,Cooke; James Edward,29,0,32,3
1683307180525,BISP 194,A00,222522,Staff,16,0,32,16
1683307181549,CAT 124,A01,202407,Staff,20,0,25,5
1683307182575,CAT 125,A00,202408,Marchisotto; Jennifer Anne,4,0,20,16
1683307183599,CAT 125R,A00,202409,Smith; Lauryn Alissa,0,11,20,20
1683307183599,CAT 125R,B00,202410,Morales; Celeste Georgianna,0,11,20,20
1683307183599,CAT 125R,C00,202411,Irwin; Matthew Joseph,0,10,20,20
1683307184623,CENG 15,A01,204712,Yang; Kesong,0,1,0,0
1683307185646,CENG 114,A00,202070,Jahed Motlagh; Zeinab,5,0,20,15
1683307186669,CGS 105,A00,185477,Wesling; Megan E.,24,0,40,16
1683307187694,CGS 106,A00,185494,Staff,13,0,22,9
1683307188718,CGS 108,A00,185495,Staff,14,0,20,6
1683307189742,CGS 114,A00,185496,Staff,13,0,18,5
1683307190766,CGS 119,A00,185501,Staff,15,0,20,5
1683307191790,CGS 120,A00,185511,Staff,13,0,20,7
1683307192815,CHEM 4,A01,184675,Bussey; Thomas J,96,0,100,4
1683307193842,CHEM 6A,A01,184677,Staff,35,0,60,25
1683307194866,CHEM 6B,A01,184679,Staff,65,0,100,35
1683307195890,CHEM 6C,A01,184681,Bussey; Thomas J,1,0,50,49
1683307195890,CHEM 6C,A02,184682,Bussey; Thomas J,34,0,50,16
1683307196914,CHEM 40A,A01,184684,Albizati; Kim F.,37,0,100,63
1683307197938,CHEM 40B,A01,184686,Albizati; Kim F.,0,20,100,100
1683307198962,CHEM 41B,A01,184690,Staff,52,0,100,48
1683307199988,COGS 3,A01,184715,Boyle; Mary E. T.,0,25,40,40
1683307201016,COGS 14B,A01,185172,Staff,0,15,38,38
1683307202039,COGS 18,A01,184736,Staff,20,0,80,60
1683307203066,COGS 100,A01,184932,Staff,0,5,73,73
1683307204093,COGS 101A,A01,184935,Staff,0,38,30,30
1683307205116,COGS 101B,A01,184944,Staff,0,2,30,30
1683307206143,COGS 101C,A01,184946,Staff,0,12,30,30
1683307207166,COGS 102A,A01,184951,Johnson; Christine M.,2,0,40,38
1683307208193,COGS 107B,A01,184953,Mooshagian; Eric Frederick,0,50,40,40
1683307209220,COGS 118B,A01,184959,Gupta; Anjum,0,48,40,40
1683307210243,COGS 153,A00,184961,Staff,0,15,30,30
1683307211270,COGS 177,A00,184962,Staff,0,21,30,30
1683307212301,COGS 187A,A01,184969,Boyle; Mary E. T.,0,17,40,40
1683307213328,COMM 10,A01,185174,Staff,0,5,25,25
1683307213328,COMM 10,A02,185189,Staff,0,5,25,25
1683307213328,COMM 10,A03,269821,Staff,0,0,0,0
1683307214359,COMM 100B,A01,185475,Staff,0,0,0,2
1683307214359,COMM 100B,A02,185476,Staff,14,0,25,11
1683307215385,COMM 100C,A01,185314,Staff,1,0,25,24
1683307215385,COMM 100C,A02,185327,Staff,19,0,25,6
1683307216411,COMM 110M,A00,185349,Staff,2,0,40,38
1683307217434,COMM 113T,A00,185352,Staff,25,0,40,15
1683307218457,COMM 114I,A00,185353,Staff,33,0,40,7
1683307219484,COMM 131,A00,185354,Staff,19,0,30,11
1683307220509,CSE 8A,A50,185358,Cao; Yingjun,0,46,10,10
1683307221534,CSE 8B,A01,185362,Staff,1,47,50,49
1683307222562,CSE 11,A01,185416,Cao; Yingjun,0,93,10,10
1683307223590,CSE 20,A01,185445,Briones; Jor-el Thomas Caparas,5,0,25,20
1683307224617,CSE 21,A01,185447,Staff,10,0,50,40
1683307225641,CSE 101,A01,185451,Staff,0,12,50,50
1683307225641,CSE 101,B01,185453,Jones; Miles E,0,11,50,50
1683307227690,CSE 141,A01,185458,Eldon; John,20,0,100,80
1683307228714,CSE 141L,A01,185461,Eldon; John,12,0,100,88
1683307229740,CSE 142,A01,185463,Staff,35,0,60,25
1683307229740,CSE 142,B01,201355,Staff,0,6,60,60
1683307230767,CSE 142L,A01,185470,Staff,35,0,60,25
1683307230767,CSE 142L,B01,201417,Staff,0,5,60,60
1683307231791,CSE 190,A00,201433,Staff,32,0,49,17
1683307232814,DOC 1,A01,259136,Strom; Megan C.,8,0,15,7
1683307232814,DOC 1,A02,259137,Strom; Megan C.,14,0,15,1
1683307232814,DOC 1,A03,259138,Strom; Megan C.,14,0,15,1
1683307232814,DOC 1,A04,259139,Strom; Megan C.,14,0,15,1
1683307233839,DOC 100D,A00,259140,Pass; Natalye Joann,17,0,25,8
1683307234866,DSGN 1,A01,184749,Rill; Bryan,0,24,30,30
1683307235893,DSGN 100,A01,185168,Staff,0,2,25,25
1683307236916,ECE 5,A01,185626,Morris; Karcher William,0,10,0,0
1683307237945,ECE 101,A01,185628,Staff,17,0,70,53
1683307238970,ECE 107,A01,185635,Baghdadchi; Saharnaz,0,0,20,20
1683307238970,ECE 107,A02,185638,Baghdadchi; Saharnaz,4,0,20,16
1683307239994,ECE 148,A01,185647,Silberman; Jack,0,0,16,16
1683307241020,ECON 1,A01,185537,Crane; Meredith Helen,54,0,70,16
1683307242102,ECON 3,A01,185549,Crane; Meredith Helen,33,0,70,37
1683307243127,ECON 4,A01,203354,Anderson; John Charles,0,4,10,10
1683307244149,ECON 100A,A01,185574,Staff,0,4,40,40
1683307245175,ECON 100B,A01,185576,Staff,0,22,40,40
1683307246199,ECON 100C,A01,185589,Newhouse; Herbert S,30,0,70,40
1683307247226,ECON 105,A00,185608,Vespa; Emanuel Ignacio,19,0,35,16
1683307248250,ECON 109,A01,185610,Shishkin; Denis,10,0,35,25
1683307249274,ECON 110A,A01,185612,Staff,11,0,40,29
1683307250298,ECON 120A,A01,185615,Staff,20,0,40,20
1683307251322,ECON 120C,A01,185617,Sun; Yixiao,0,20,70,70
1683307252349,ECON 144,A00,203346,Squires; Dale E,3,0,35,32
1683307253373,ECON 171,A01,203349,Newhouse; Herbert S,0,1,35,35
1683307254413,ECON 173A,A01,185621,Toda; Alexis Akira,21,0,35,14
1683307255438,EDS 25,A01,202413,Staff,0,1,0,0
1683307255438,EDS 25,A02,202414,Staff,0,1,0,0
1683307255438,EDS 25,A03,202415,Staff,0,0,0,0
1683307255438,EDS 25,A04,202416,Staff,0,1,0,0
1683307255438,EDS 25,A05,202439,Staff,0,0,0,0
1683307255438,EDS 25,A06,202440,Staff,0,0,0,0
1683307255438,EDS 25,B01,202631,Staff,0,0,0,0
1683307255438,EDS 25,B02,202632,Staff,0,0,0,0
1683307255438,EDS 25,B03,202639,Staff,0,0,0,0
1683307255438,EDS 25,B04,202640,Staff,0,0,0,0
1683307255438,EDS 25,B05,202643,Staff,0,0,0,0
1683307255438,EDS 25,B06,202644,Staff,0,0,0,0
1683307256462,EDS 38,A01,202659,Black; Alison Michelle,24,0,25,1
1683307257487,EDS 115,A00,202652,Staff,17,0,30,13
1683307258511,EDS 125,A00,202649,Staff,14,0,30,16
1683307259535,EDS 126,A01,203332,Staff,30,0,30,0
1683307260562,EDS 139,A00,202838,Staff,17,0,25,8
1683307261586,EDS 146,A01,202655,Staff,15,0,25,10
1683307262611,ENG 15,A00,185667,Staff,0,1,0,0
1683307262611,ENG 15,B00,185672,Staff,0,0,0,0
1683307262611,ENG 15,C00,185675,Staff,0,0,0,0
1683307262611,ENG 15,D00,185682,Staff,0,0,0,0
1683307262611,ENG 15,E00,185684,Staff,0,0,0,0
1683307263635,ETHN 103,A00,185710,Staff,0,3,35,35
1683307264656,ETHN 103A,A00,199228,Man; Simeon S,2,0,9,7
1683307265680,ETHN 109,A00,185711,Staff,18,0,35,17
1683307266706,ETHN 142,A00,185726,Staff,0,4,30,30
1683307267734,ETHN 163J,A00,199229,Man; Simeon S,6,0,8,2
1683307268758,ETHN 168,A00,185727,Staff,8,0,10,2
1683307269782,ETHN 182,A00,185728,Staff,1,0,35,34
1683307270805,ETHN 183,A00,185737,Staff,8,0,18,10
1683307271829,GLBH 111,A01,209361,Burgos; Jose L.,0,0,0,0
1683307273879,HIEU 104,A00,185792,Staff,16,0,20,4
1683307274903,HIEU 115,A00,185800,Staff,1,0,20,19
1683307275930,HIEU 128,A00,185801,Staff,0,7,20,20
1683307276957,HIEU 147,A00,185802,Staff,16,0,20,4
1683307277982,HIEU 154,A00,185823,Staff,12,0,20,8
1683307279009,HILA 102,A00,185826,Staff,13,0,20,7
1683307280033,HILD 2C,A01,185778,Staff,0,12,20,20
1683307281057,HILD 7B,A01,185780,Kwak; Nancy,0,15,32,32
1683307281057,HILD 7B,A02,185781,Kwak; Nancy,0,18,32,32
1683307282081,HILD 30,A01,185791,Staff,14,0,20,6
1683307283109,HISC 119,A00,185830,Golan; Tal,0,9,20,20
1683307284132,HITO 156GS,A00,185831,Patterson; Patrick H.,0,0,0,23
1683307285156,HIUS 103,A00,185832,Man; Simeon S,0,6,20,20
1683307286182,HIUS 117,A00,185836,Kwak; Nancy,2,0,20,18
1683307287206,HIUS 125,A00,185840,Man; Simeon S,0,0,23,23
1683307288229,HIUS 149,A00,185845,Staff,0,0,20,20
1683307289253,HUM 3,A01,185882,Zavodny; Tatiana Sophia,0,6,50,50
1683307289253,HUM 3,B01,185899,Caldwell; Michael Alan,0,19,50,50
1683307290278,HUM 3GS,A00,185900,Patterson; Patrick H.,0,0,0,23
1683307291301,HUM 4,A01,185938,Zroka; Amy Liane,30,0,50,20
1683307291301,HUM 4,B01,185956,Watkins; Eric,0,2,50,50
1683307291301,HUM 4,B02,202209,Watkins; Eric,0,1,50,50
1683307291301,HUM 4,B03,202210,Watkins; Eric,0,0,50,50
1683307292325,HUM 5,A01,185958,West; Geoffrey Scott,5,0,50,45
1683307292325,HUM 5,A02,202215,West; Geoffrey Scott,0,0,50,50
1683307293350,INTL 190,A00,185959,Gagnon; Jeffrey C,0,0,0,9
1683307293350,INTL 190,B00,185960,Lettieri; Michael Joseph,0,0,0,1
1683307294373,JAPN 180,A00,254509,Staff,5,1,30,25
1683307295402,LATI 10,A01,202853,Kennemore; Amy Michelle,5,0,35,30
1683307295402,LATI 10,A02,202854,Kennemore; Amy Michelle,1,0,35,34
1683307295402,LATI 10,A03,270054,Kennemore; Amy Michelle,30,0,30,0
1683307296425,LATI 180,A00,202855,Kennemore; Amy Michelle,11,0,20,9
1683307297451,LAWS 101,A00,201767,Golan; Tal,0,7,40,40
1683307298475,LIFR 1C,A00,185961,Staff,6,0,20,14
1683307299502,LIFR 1CX,A00,185962,Staff,7,0,20,13
1683307300525,LIFR 1D,A00,185963,Staff,9,0,20,11
1683307301550,LIFR 1DX,A00,185964,Staff,9,0,20,11
1683307302575,LIGN 101,A01,186039,Staff,43,0,50,7
1683307303602,LIGN 165,A00,186040,Staff,18,0,50,32
1683307304625,LTCS 108,A00,186041,Staff,6,0,10,4
1683307305651,LTCS 119,A00,186042,Staff,16,0,20,4
1683307306678,LTCS 130,A00,186043,Wesling; Megan E.,15,0,25,10
1683307308725,LTEA 138,A00,186119,Staff,14,0,40,26
1683307309752,LTEN 124,A00,186148,Staff,6,0,25,19
1683307310776,LTEN 178,A00,186149,Staff,7,0,15,8
1683307311800,LTEN 181,A00,186150,Blanco; John D,33,0,40,7
1683307312823,LTWL 120,A00,186160,Staff,20,0,25,5
1683307313846,LTWL 165,A00,186161,Staff,22,0,25,3
1683307314872,LTWR 100,A00,186162,Staff,0,4,15,15
1683307315895,LTWR 102,A00,186163,Doller; Ben,5,0,15,10
1683307316920,MAE 8,A01,186412,Staff,0,0,0,0
1683307317948,MAE 30B,A00,186445,Bahadori; Mohammad Yousef,83,0,100,17
1683307318975,MAE 40,A00,186592,Bewley; Thomas R,9,0,50,41
1683307319999,MAE 101B,A00,186593,Bahadori; Mohammad Yousef,81,0,100,19
1683307321023,MAE 105,A00,186594,Bandaru; Prabhakar,12,0,50,38
1683307322050,MAE 107,A00,186599,Pham; Hieu Tan,0,6,120,120
1683307323077,MAE 148,A01,186660,Silberman; Jack,3,0,16,13
1683307324104,MATH 10A,A01,188095,Staff,0,7,35,35
1683307325136,MATH 10B,A01,188097,Bowers; Adam R.,0,11,30,30
1683307325136,MATH 10B,A02,188099,Bowers; Adam R.,0,9,30,30
1683307325136,MATH 10B,B01,188104,Bowers; Adam R.,0,11,30,30
1683307325136,MATH 10B,B02,188106,Bowers; Adam R.,0,11,30,30
1683307326164,MATH 10C,A01,188111,Staff,0,18,30,30
1683307326164,MATH 10C,A02,188127,Staff,0,17,30,30
1683307326164,MATH 10C,A03,188131,Staff,0,17,30,30
1683307326164,MATH 10C,B01,188218,Staff,21,0,30,9
1683307326164,MATH 10C,B02,188244,Staff,13,0,30,17
1683307326164,MATH 10C,B03,188277,Staff,16,0,30,14
1683307327193,MATH 18,A01,188344,Bach; Quang Tran,18,0,30,12
1683307327193,MATH 18,A02,188345,Bach; Quang Tran,11,0,30,19
1683307327193,MATH 18,B01,188353,Bach; Quang Tran,10,0,30,20
1683307327193,MATH 18,B02,188354,Bach; Quang Tran,20,0,30,10
1683307328218,MATH 20A,A01,188374,Staff,13,0,35,22
1683307329246,MATH 20B,A01,188382,Ohm; Ko Woon,6,0,30,24
1683307329246,MATH 20B,A02,188383,Ohm; Ko Woon,24,0,30,6
1683307329246,MATH 20B,B01,188385,Ohm; Ko Woon,7,0,30,23
1683307329246,MATH 20B,B02,188392,Ohm; Ko Woon,22,0,30,8
1683307330269,MATH 20C,A01,188394,Harel; Guershon,10,0,30,20
1683307330269,MATH 20C,A02,188395,Harel; Guershon,13,0,30,17
1683307330269,MATH 20C,B01,188404,Harel; Guershon,3,0,30,27
1683307330269,MATH 20C,B02,188405,Harel; Guershon,19,0,30,11
1683307331294,MATH 20D,A01,188414,Hammock; Frances H,0,1,30,30
1683307331294,MATH 20D,A02,188415,Hammock; Frances H,4,0,30,26
1683307331294,MATH 20D,B01,188447,Hammock; Frances H,2,0,30,28
1683307331294,MATH 20D,B02,188486,Hammock; Frances H,8,0,30,22
1683307332321,MATH 20E,A01,188649,Staff,22,0,30,8
1683307332321,MATH 20E,A02,188650,Staff,23,0,30,7
1683307332321,MATH 20E,A03,188673,Staff,0,0,30,30
1683307333345,MATH 102,A01,188675,Staff,0,35,35,35
1683307334374,MATH 103B,A01,188681,Staff,4,0,35,31
1683307334374,MATH 103B,B01,188692,Staff,7,0,35,28
1683307335403,MATH 109,A01,188695,Salehi Golsefidy; Alireza,25,0,35,10
1683307335403,MATH 109,A02,188696,Salehi Golsefidy; Alireza,27,0,35,8
1683307336431,MATH 120A,A01,188698,Eggers; John Dietrich,6,0,35,29
1683307337459,MATH 142B,A01,188736,Ioana; Adrian,0,2,30,30
1683307337459,MATH 142B,A02,188741,Ioana; Adrian,0,1,30,30
1683307337459,MATH 142B,A03,188743,Ioana; Adrian,0,3,30,30
1683307338483,MATH 168A,A01,188790,Staff,0,9,35,35
1683307339508,MATH 170A,A01,188803,Nie; Jiawang,0,2,35,35
1683307339508,MATH 170A,A02,188811,Nie; Jiawang,0,0,35,35
1683307339508,MATH 170A,A03,188814,Nie; Jiawang,1,0,35,34
1683307339508,MATH 170A,A04,188815,Nie; Jiawang,13,0,35,22
1683307340536,MATH 193B,A01,188817,Staff,0,0,35,35
1683307340536,MATH 193B,A02,188818,Staff,5,0,35,30
1683307341563,MGT 4,A01,202857,Anderson; John Charles,62,0,80,18
1683307342592,MGT 12,A00,202858,Lindenberger; Wade Douglas,43,0,90,47
1683307343616,MGT 18,A00,202859,Staff,74,0,90,16
1683307344642,MGT 18GS,A00,202860,McKay; Michael J,13,0,28,15
1683307345725,MGT 45,A00,202861,Pecore; Joseph P.,14,0,90,76
1683307346752,MGT 100,A00,202863,Yavorsky; Daniel Ryan,28,0,90,62
1683307347778,MGT 103,A00,202864,Ehrich; Kristine R,0,16,90,90
1683307348803,MGT 112,A00,202865,Ehrich; Kristine R,15,0,90,75
1683307349827,MGT 121A,A00,202868,Staff,0,19,0,0
1683307350851,MGT 131B,A00,202869,Anderson; John Charles,59,0,90,31
1683307351874,MGT 136,A00,202871,Lindenberger; Wade Douglas,84,0,90,6
1683307352901,MGT 164,A00,202873,Staff,0,69,90,90
1683307353926,MGT 164GS,A00,202874,McKay; Mary A,13,0,28,15
1683307354953,MGT 180,A00,202875,Staff,0,51,90,90
1683307355979,MMW 11R,A01,205019,Herbst; Matthew,3,0,30,27
1683307355979,MMW 11R,A02,205026,Herbst; Matthew,29,0,30,1
1683307357008,MMW 15,A01,193512,Chang; Edmond Yi-Teh,0,9,28,28
1683307357008,MMW 15,A02,193513,Chang; Edmond Yi-Teh,0,5,28,28
1683307357008,MMW 15,A03,193514,Chang; Edmond Yi-Teh,0,5,28,28
1683307357008,MMW 15,A04,193515,Chang; Edmond Yi-Teh,0,5,28,28
1683307357008,MMW 15,A05,193516,Chang; Edmond Yi-Teh,0,4,28,28
1683307357008,MMW 15,A06,193517,Chang; Edmond Yi-Teh,0,5,28,28
1683307357008,MMW 15,B01,193519,Chang; Edmond Yi-Teh,0,4,28,28
1683307357008,MMW 15,B02,193520,Chang; Edmond Yi-Teh,0,5,28,28
1683307357008,MMW 15,B03,193521,Chang; Edmond Yi-Teh,0,4,28,28
1683307357008,MMW 15,B04,193522,Chang; Edmond Yi-Teh,0,4,28,28
1683307357008,MMW 15,B05,193523,Chang; Edmond Yi-Teh,0,5,28,28
1683307357008,MMW 15,B06,193524,Chang; Edmond Yi-Teh,0,4,28,28
1683307358035,MMW 122,A01,193526,Rahimi; Babak,0,14,28,28
1683307358035,MMW 122,A02,193527,Rahimi; Babak,0,14,28,28
1683307358035,MMW 122,A03,193528,Rahimi; Babak,0,0,0,0
1683307358035,MMW 122,A04,193529,Rahimi; Babak,0,0,0,0
1683307359063,MUS 1A,A01,186663,Staff,0,20,35,35
1683307360086,MUS 4,A01,186715,Staff,0,12,35,35
1683307361114,MUS 5R,A01,186796,Dubnov; Shlomo,0,17,35,35
1683307362138,MUS 6,A01,186798,Staff,0,3,25,25
1683307363161,MUS 7,A01,186830,Staff,12,0,35,23
1683307364187,MUS 8,A01,186930,Staff,0,26,35,35
1683307365215,MUS 15,A01,186932,Staff,0,15,35,35
1683307365215,MUS 15,B01,186934,Staff,0,15,35,35
1683307366238,MUS 80,A00,186935,Staff,2,0,20,18
1683307366238,MUS 80,B00,186936,Staff,25,0,25,0
1683307367266,NANO 11,A00,204702,Lipomi; Darren John,0,0,0,0
1683307368295,NANO 15,A01,204709,Yang; Kesong,0,1,0,0
1683307369319,NANO 114,A00,202069,Jahed Motlagh; Zeinab,3,0,10,7
1683307370343,PHIL 1,A00,186955,Grush; Rick Scott,32,0,40,8
1683307371370,PHIL 10,A01,186973,Grush; Rick Scott,28,0,35,7
1683307371370,PHIL 10,A02,186974,Grush; Rick Scott,33,0,35,2
1683307372394,PHIL 13,A01,186976,Staff,7,0,35,28
1683307372394,PHIL 13,A02,186977,Staff,16,0,35,19
1683307373418,PHIL 14,A01,186979,Staff,31,0,35,4
1683307373418,PHIL 14,A02,186986,Staff,32,0,35,3
1683307374450,PHIL 28,A01,186988,Staff,16,0,30,14
1683307374450,PHIL 28,A02,186989,Staff,1,0,30,29
1683307374450,PHIL 28,A03,186990,Staff,9,0,30,21
1683307374450,PHIL 28,A04,186991,Staff,26,0,30,4
1683307375474,PHIL 120,A00,186997,Staff,23,0,40,17
1683307376497,PHIL 137,A00,187003,Staff,9,0,40,31
1683307377524,PHIL 150,A00,187015,Staff,47,0,70,23
1683307378548,PHIL 167,A00,187021,Lamey; Andy M.,35,0,40,5
1683307379570,PHIL 174,A01,202226,Staff,17,0,20,3
1683307379570,PHIL 174,A02,202235,Staff,20,0,20,0
1683307380604,PHIL 191A,A00,258918,Staff,0,0,1,1
1683307381628,PHYS 1A,A00,187028,Staff,27,0,60,33
1683307382652,PHYS 1AL,001,187036,Staff,3,0,30,27
1683307382652,PHYS 1AL,002,187049,Staff,18,0,30,12
1683307383676,PHYS 1B,A00,187058,Staff,23,0,60,37
1683307384699,PHYS 1BL,001,187064,Staff,0,0,30,30
1683307384699,PHYS 1BL,002,187070,Staff,6,0,30,24
1683307385723,PHYS 1C,A00,187082,Staff,31,0,120,89
1683307386748,PHYS 1CL,001,187088,Staff,0,9,30,30
1683307386748,PHYS 1CL,002,187089,Staff,0,2,30,30
1683307386748,PHYS 1CL,009,262693,Staff,11,0,30,19
1683307387776,PHYS 2B,A01,187097,Staff,54,0,115,61
1683307388799,PHYS 2C,A01,187099,Staff,67,0,115,48
1683307389827,PHYS 2CL,A01,187101,Staff,5,0,28,23
1683307389827,PHYS 2CL,A02,187102,Staff,15,0,28,13
1683307390856,PHYS 2D,A01,187123,Shotwell; Brian,95,0,115,20
1683307391883,PHYS 4B,A01,187133,Grinstein; Benjamin,35,0,50,15
1683307392910,POLI 10,A00,188819,Staff,0,3,50,50
1683307393934,POLI 11,A00,188827,Staff,43,0,50,7
1683307394957,POLI 13R,A00,188828,Staff,0,1,20,20
1683307395985,POLI 27,A01,188830,Elgin; Samuel Zincke,0,1,70,70
1683307397009,POLI 30,A00,188832,Desposato; Scott,33,0,50,17
1683307398034,POLI 102F,A00,188834,Staff,3,0,40,37
1683307399059,POLI 104A,A00,188852,Staff,14,0,30,16
1683307400084,POLI 104I,A00,188853,Staff,0,6,20,20
1683307401112,POLI 110B,A00,188854,Wiens; David,7,0,20,13
1683307402135,POLI 112A,A00,188855,Wiens; David,5,0,30,25
1683307403160,POLI 117R,A00,188856,Forman; Fonna,0,11,20,20
1683307404187,POLI 118,A00,188857,Ingham; Sean,8,0,20,12
1683307405211,POLI 120G,A00,188858,Staff,9,0,30,21
1683307406235,POLI 131CR,A00,188863,Hoston; Germaine,24,0,50,26
1683307407259,POLI 133,A00,188864,Nellis; Gareth Hb,44,0,50,6
1683307408283,POLI 134D,A00,188865,Desposato; Scott,27,0,30,3
1683307409320,POLI 142A,A00,188871,Gartzke; Erik,22,0,50,28
1683307410348,POLI 142K,A00,188874,Staff,38,0,50,12
1683307411374,POLI 143,A00,188940,Gartzke; Erik,16,0,30,14
1683307412401,POLI 153,A00,188943,Staff,3,0,20,17
1683307413424,POLI 160AA,A00,188944,Staff,13,0,40,27
1683307414447,POLI 170A,A00,188945,Staff,11,0,30,19
1683307416494,PSYC 1,A00,188952,Staff,38,0,90,52
1683307417518,PSYC 2,B00,188953,Staff,20,0,35,15
1683307418546,PSYC 6,A00,188970,Staff,47,0,60,13
1683307419570,PSYC 7,A00,188973,Staff,37,0,45,8
1683307420598,PSYC 60,A01,188980,Rickard; Timothy C.,43,0,60,17
1683307421626,PSYC 70,A01,189001,Steiner; Eric Tomas,24,0,45,21
1683307422650,PSYC 100,A00,189005,Lacefield; Katharine I,0,99,120,120
1683307423677,PSYC 102,A00,189008,Staff,10,0,30,20
1683307424703,PSYC 106,B00,189026,Gorman; Michael R.,37,0,60,23
1683307425727,PSYC 114,B01,189033,Winkielman; Piotr,0,32,30,30
1683307426751,PSYC 131,A00,189036,Anagnostaras; Stephan,0,43,60,60
1683307427779,PSYC 136,A00,189041,Lowe; Angela Beth,0,7,25,25
1683307428806,PSYC 137,A00,189057,Winkielman; Piotr,0,34,25,25
1683307429829,PSYC 144,A00,189107,Wixted; John T,0,7,50,50
1683307431877,PSYC 162,A00,189142,Staff,0,8,85,85
1683307432902,PSYC 172,A00,189144,Gorman; Michael R.,0,7,30,30
1683307434950,PSYC 179,A00,189146,Lacefield; Katharine I,0,84,120,120
1683307435980,PSYC 181,A00,189147,Anagnostaras; Stephan,0,44,90,90
1683307437011,PSYC 190R,A00,189148,Barner; David A.,0,22,80,80
1683307438035,PSYC 191,A00,189275,Rickard; Timothy C.,0,7,25,25
1683307439059,PSYC 193,A00,189276,Chapman; Eddie Nathaniel,0,1,0,4
1683307440084,PSYC 193L,A01,189281,Lowe; Angela Beth,12,0,20,8
1683307440084,PSYC 193L,B01,189285,Staff,28,0,35,7
1683307441109,RELI 149,A00,187137,Rahimi; Babak,7,0,40,33
1683307442134,SE 9,A01,187315,Staff,0,2,18,18
1683307443158,SE 101B,A00,187409,Staff,24,0,30,6
1683307444186,SE 110B,A00,187444,Staff,10,0,40,30
1683307445213,SE 130B,A00,187449,Staff,31,0,40,9
1683307446241,SE 150A,A00,187516,Staff,9,0,20,11
1683307447268,SE 154,A00,187528,Staff,30,0,50,20
1683307448297,SIO 3,A01,258171,Staff,35,0,40,5
1683307449378,SIO 10,A00,187144,Cook; Geoffrey W,0,3,75,75
1683307450408,SIO 45,A00,187152,Cook; Geoffrey W,1,0,100,99
1683307451433,SIO 109R,A00,194486,Staff,0,3,20,20
1683307453491,SIO 187,A01,187233,Kacev; David,12,0,40,28
1683307454521,SOCI 1,A01,258656,Thorpe; Charles Robert,28,0,30,2
1683307454521,SOCI 1,A02,258658,Thorpe; Charles Robert,30,0,30,0
1683307454521,SOCI 1,A03,258661,Thorpe; Charles Robert,25,0,25,0
1683307454521,SOCI 1,A04,258666,Thorpe; Charles Robert,22,0,25,3
1683307454521,SOCI 1,A05,258897,Thorpe; Charles Robert,23,0,25,2
1683307454521,SOCI 1,A06,258898,Thorpe; Charles Robert,25,0,25,0
1683307455548,SOCI 30,A01,258903,Pardo Guerra; Juan Pablo,16,0,30,14
1683307456573,SOCI 102,A00,258904,Staff,9,0,25,16
1683307457602,SOCI 106,A00,258905,Staff,19,0,25,6
1683307458630,SOCI 111,A00,258907,Ribas Norris; Janet Vanesa,26,0,30,4
1683307459658,SOCI 121R,A00,258908,Pardo Guerra; Juan Pablo,11,0,30,19
1683307460682,SOCI 126,A01,203330,Staff,14,0,20,6
1683307461706,SOCI 131,A00,258909,Thorpe; Charles Robert,31,0,60,29
1683307462730,SOCI 135,A00,258910,Payne; Christine Anna,0,9,30,30
1683307463754,SOCI 157,A00,258911,Staff,13,0,30,17
1683307464783,SOCI 184,A00,258912,Staff,26,0,30,4
1683307465809,SOCI 188D,A00,258913,Staff,21,0,30,9
1683307466836,SYN 2,001,187529,Staff,9,0,16,7
1683307466836,SYN 2,002,201452,Staff,0,18,16,16
1683307466836,SYN 2,003,201469,Staff,3,0,16,13
1683307467863,SYN 100,A01,187531,Staff,0,9,20,20
1683307467863,SYN 100,B01,201491,Staff,0,12,20,20
1683307468887,TDAC 1,A00,189286,Walsh; Kim C.,3,0,20,17
1683307468887,TDAC 1,B00,189287,Harting; Carla Kelso,11,0,20,9
1683307469914,TDAC 101,A00,189300,Walsh; Kim C.,16,0,20,4
1683307469914,TDAC 101,B00,189301,Harting; Carla Kelso,18,0,20,2
1683307470940,TDAC 102,A00,189304,Basso; Beatrice,14,0,20,6
1683307471963,TDAC 108,A00,189305,Staff,18,0,20,2
1683307472994,TDDE 131,A00,189310,Staff,19,0,20,1
1683307472994,TDDE 131,B00,189314,Staff,19,0,20,1
1683307472994,TDDE 131,C00,189315,Staff,48,0,50,2
1683307472994,TDDE 131,D00,189316,Staff,14,0,15,1
1683307472994,TDDE 131,E00,204841,Staff,20,0,20,0
1683307474016,TDGE 10,A00,189289,Staff,30,0,50,20
1683307474016,TDGE 10,B00,189290,Havis; Allan,2,0,50,48
1683307475043,TDGE 11,A00,189291,Fulton; Julia,0,3,50,50
1683307475043,TDGE 11,B00,189292,Staff,20,0,25,5
1683307475043,TDGE 11,C00,260270,Staff,0,0,0,0
1683307476069,TDGE 25,A00,189294,Staff,3,0,20,17
1683307477093,TDGE 124,A00,189318,Fulton; Julia,0,8,50,50
1683307478118,TDGE 125,A00,189319,Staff,13,0,25,12
1683307478118,TDGE 125,B00,189320,Staff,23,0,25,2
1683307479143,TDGE 127,A00,189322,Havis; Allan,0,0,50,50
1683307480169,TDHT 101,A00,189323,Staff,18,0,25,7
1683307480169,TDHT 101,B00,189324,Staff,25,0,25,0
1683307481193,TDHT 102,A00,189325,Staff,49,0,50,1
1683307482220,TDMV 1,A00,189295,Arcidiacono; Kristin,20,0,30,10
1683307482220,TDMV 1,B00,189296,Caligagan; Maria T.,24,0,30,6
1683307483248,TDMV 2,A00,189297,Sammartano; Tonnie,28,0,30,2
1683307483248,TDMV 2,B00,189299,Arcidiacono; Kristin,24,0,30,6
1683307484273,TDMV 3,A00,204998,Rincon; Alicia,22,0,30,8
1683307485299,TDMV 120,A00,189458,Sammartano; Tonnie,28,0,30,2
1683307486324,TDMV 138,A00,189541,Jun; Grace Shin Hae,22,0,40,18
1683307487348,TDMV 142,A00,189717,Caligagan; Tony,23,0,30,7
1683307487348,TDMV 142,B00,189718,Caligagan; Maria T.,25,0,30,5
1683307488373,TMC 2,A01,187533,Staff,25,0,25,0
1683307488373,TMC 2,A02,187534,Staff,25,0,25,0
1683307489397,USP 1,A01,187536,Kwak; Nancy,0,16,25,25
1683307490421,USP 5,A01,187538,Staff,9,0,25,16
1683307491446,USP 101,A00,199253,Staff,0,4,0,0
1683307492474,USP 124,A00,187562,Boomhower; Matthew Charles,1,0,30,29
1683307493501,USP 138,A00,187582,Staff,20,0,25,5
1683307494525,USP 152,A01,187597,Staff,4,0,25,21
1683307495550,USP 153,A00,187598,Staff,19,0,25,6
1683307496577,USP 168,A00,187607,Kwak; Nancy,2,0,5,3
1683307497604,USP 173,A00,187619,Staff,4,0,25,21
1683307498631,USP 181,A00,187638,Staff,0,0,25,25
1683307499659,VIS 103,A00,187650,Cruz; Edwin Teddy,23,0,75,52
1683307500690,VIS 110D,A00,187669,Staff,12,0,22,10
1683307501714,VIS 127C,A00,187720,Shen; Kuiyi,68,0,146,78
1683307502737,VIS 149,A00,187731,Yoldas; Pinar,0,14,22,22
1683307503761,VIS 151,A01,188091,Staff,22,0,34,12
1683307503761,VIS 151,A02,188092,Staff,11,0,34,23
1683307504785,VIS 160B,A00,188093,Stalbaum; Brett,0,0,10,10
1683307506832,WCWP 10B,A00,201720,Staff,10,0,15,5
1683307506832,WCWP 10B,B00,201722,Staff,8,0,15,7
1683307507856,WCWP 100,A00,201725,Gagnon; Jeffrey C,0,0,2,2
1683307507856,WCWP 100,B00,201727,Staff,0,4,15,15
1683307510950,ANBI 133,A00,258401,Wilder; Linnea Lorene,34,0,40,6
1683307511974,ANBI 140,A00,258395,Hrvoj Mihic; Branka,18,0,25,7
1683307513000,ANSC 120,A00,258402,Bialecki; Jon Anthony,27,0,40,13
1683307514024,ANSC 144,A00,258400,Staff,14,0,40,26
1683307516078,ANSC 166,A00,258396,Parish; Steven Martin,157,0,175,18
1683307517105,ANSC 180,A00,193533,Staff,9,0,20,11
1683307518129,ANSC 188,A00,258397,Jassal; Aftab,33,0,40,7
1683307519156,ANTH 3,A01,258316,Staff,23,0,30,7
1683307520179,ANTH 5,A00,258394,Semendeferi; Ekaterini,16,0,20,4
1683307521203,ANTH 21,A01,258331,Staff,9,0,40,31
1683307522229,ANTH 103,A00,258398,Varma; Saiba,15,0,25,10
1683307523257,AWP 10,001,202034,Staff,0,0,0,0
1683307523257,AWP 10,002,202035,Staff,0,0,0,0
1683307523257,AWP 10,003,202036,Staff,0,0,0,0
1683307523257,AWP 10,004,202037,Staff,0,0,0,0
1683307523257,AWP 10,005,202038,Staff,0,0,0,0
1683307523257,AWP 10,006,202039,Staff,0,0,0,0
1683307523257,AWP 10,007,202040,Staff,0,0,0,0
1683307523257,AWP 10,008,202041,Staff,0,0,0,0
1683307523257,AWP 10,009,202042,Staff,0,0,0,0
1683307523257,AWP 10,010,202043,Staff,0,0,0,0
1683307523257,AWP 10,011,202044,Staff,0,0,0,0
1683307523257,AWP 10,012,202045,Staff,0,0,0,0
1683307523257,AWP 10,013,202046,Staff,0,0,0,0
1683307523257,AWP 10,014,202047,Staff,0,0,0,0
1683307523257,AWP 10,015,202048,Staff,0,0,0,0
1683307523257,AWP 10,016,202049,Staff,0,0,0,0
1683307523257,AWP 10,017,202050,Staff,0,0,0,0
1683307523257,AWP 10,018,202051,Staff,0,0,0,0
1683307523257,AWP 10,019,202052,Staff,0,0,0,0
1683307523257,AWP 10,020,202053,Staff,0,0,0,0
1683307523257,AWP 10,021,202054,Staff,0,0,0,0
1683307523257,AWP 10,022,202055,Staff,0,0,0,0
1683307523257,AWP 10,023,202056,Staff,0,0,0,0
1683307523257,AWP 10,024,202057,Staff,0,0,0,0
1683307523257,AWP 10,025,202058,Staff,0,0,0,0
1683307523257,AWP 10,026,202059,Staff,0,0,0,0
1683307524280,AWP 102,001,202032,Staff,0,0,0,0
1683307524280,AWP 102,002,202033,Staff,0,0,0,0
1683307525305,BENG 100,A01,254234,Taylor Amos; Alyssa C,31,0,40,9
1683307526337,BENG 196,001,270013,Engler; Adam J.,9999,0,9999,0
1683307527363,BICD 100R,A01,202018,Smith; Laurie,0,7,32,32
1683307527363,BICD 100R,A02,202019,Smith; Laurie,0,2,32,32
1683307527363,BICD 100R,A03,202020,Smith; Laurie,0,1,32,32
1683307527363,BICD 100R,A04,202021,Smith; Laurie,8,0,32,24
1683307527363,BICD 100R,A05,202022,Smith; Laurie,12,0,32,20
1683307528386,BICD 136,A01,193242,Gustafson-Brown; Cindy,0,2,32,32
1683307528386,BICD 136,A02,193244,Gustafson-Brown; Cindy,15,0,32,17
1683307529415,BIEB 102,A01,193249,Butler; Shannon Rhey,0,2,32,32
1683307529415,BIEB 102,A02,193251,Butler; Shannon Rhey,0,0,32,32
1683307529415,BIEB 102,A03,193253,Butler; Shannon Rhey,0,1,32,32
1683307529415,BIEB 102,A04,193255,Butler; Shannon Rhey,17,0,32,15
1683307529415,BIEB 102,A05,193265,Butler; Shannon Rhey,26,0,32,6
1683307529415,BIEB 102,A06,193269,Butler; Shannon Rhey,16,0,32,16
1683307531464,BIEB 150,A01,193274,Staff,0,0,32,32
1683307531464,BIEB 150,A02,193285,Staff,24,0,32,8
1683307532489,BIEB 194,A00,193286,Kurle; Carolyn M.,22,0,32,10
1683307533513,BILD 1,A01,192291,Staff,16,0,32,16
1683307533513,BILD 1,A02,192292,Staff,30,0,32,2
1683307533513,BILD 1,B01,192520,Reuther; Keefe,0,1,0,0
1683307533513,BILD 1,B02,192532,Reuther; Keefe,0,1,0,0
1683307534536,BILD 3,A01,192556,Butler; Shannon Rhey,0,0,32,32
1683307534536,BILD 3,A02,192581,Butler; Shannon Rhey,5,0,32,27
1683307534536,BILD 3,A03,192611,Butler; Shannon Rhey,23,0,32,9
1683307534536,BILD 3,A04,192612,Butler; Shannon Rhey,25,0,32,7
1683307534536,BILD 3,A05,192613,Butler; Shannon Rhey,27,0,32,5
1683307534536,BILD 3,A06,192679,Butler; Shannon Rhey,27,0,32,5
1683307534536,BILD 3,A07,192682,Butler; Shannon Rhey,22,0,32,10
1683307535564,BILD 4,A01,192836,Reuther; Keefe,1,0,24,23
1683307535564,BILD 4,A02,193044,Reuther; Keefe,4,0,24,20
1683307536592,BILD 10,A01,193142,Gustafson-Brown; Cindy,31,0,32,1
1683307536592,BILD 10,A02,193149,Gustafson-Brown; Cindy,31,0,32,1
1683307537619,BIMM 100,A01,193301,Staff,0,6,32,32
1683307537619,BIMM 100,A02,193312,Staff,0,5,32,32
1683307537619,BIMM 100,A03,193323,Staff,0,8,32,32
1683307538645,BIMM 101,A01,193329,McDonnell; Lisa Marie,0,3,24,24
1683307538645,BIMM 101,A02,193339,McDonnell; Lisa Marie,0,2,24,24
1683307538645,BIMM 101,B01,193354,McDonnell; Lisa Marie,0,3,24,24
1683307538645,BIMM 101,B02,193357,McDonnell; Lisa Marie,0,3,24,24
1683307539668,BIMM 110,A01,193377,Tat; John,0,11,32,32
1683307539668,BIMM 110,A02,193378,Tat; John,1,9,32,31
1683307540695,BIMM 120,A01,206116,Staff,0,0,32,32
1683307540695,BIMM 120,A02,206117,Staff,8,0,32,24
1683307540695,BIMM 120,A03,206121,Staff,21,0,32,11
1683307541719,BIPN 100,A01,193393,Park; Ji Young,0,14,32,32
1683307541719,BIPN 100,A02,193402,Park; Ji Young,0,12,32,32
1683307541719,BIPN 100,A03,193413,Park; Ji Young,0,14,32,32
1683307541719,BIPN 100,A04,193414,Park; Ji Young,0,13,32,32
1683307542746,BIPN 102,A01,193429,Staff,0,0,32,32
1683307542746,BIPN 102,A02,193438,Staff,22,0,32,10
1683307543773,BIPN 106,A01,193450,Reyes Gonzalez; Catalina,0,2,40,40
1683307544801,BIPN 134,A01,193465,Cooke; James Edward,0,0,32,32
1683307544801,BIPN 134,A02,193474,Cooke; James Edward,27,0,32,5
1683307544801,BIPN 134,A03,193485,Cooke; James Edward,29,0,32,3
1683307544801,BIPN 134,A04,193486,Cooke; James Edward,21,0,32,11
1683307544801,BIPN 134,A05,193491,Cooke; James Edward,31,0,32,1
1683307544801,BIPN 134,A06,193501,Cooke; James Edward,30,0,32,2
1683307544801,BIPN 134,A07,193510,Cooke; James Edward,29,0,32,3
1683307546850,BISP 194,A00,222522,Staff,16,0,32,16
1683307547876,CAT 124,A01,202407,Staff,20,0,25,5
1683307548908,CAT 125,A00,202408,Marchisotto; Jennifer Anne,4,0,20,16
1683307549933,CAT 125R,A00,202409,Smith; Lauryn Alissa,0,11,20,20
1683307549933,CAT 125R,B00,202410,Morales; Celeste Georgianna,0,11,20,20
1683307549933,CAT 125R,C00,202411,Irwin; Matthew Joseph,0,10,20,20
1683307550960,CENG 15,A01,204712,Yang; Kesong,0,1,0,0
1683307551984,CENG 114,A00,202070,Jahed Motlagh; Zeinab,5,0,20,15
1683307553067,CGS 105,A00,185477,Wesling; Megan E.,24,0,40,16
1683307554094,CGS 106,A00,185494,Staff,13,0,22,9
1683307555117,CGS 108,A00,185495,Staff,14,0,20,6
1683307556141,CGS 114,A00,185496,Staff,13,0,18,5
1683307557165,CGS 119,A00,185501,Staff,15,0,20,5
1683307558188,CGS 120,A00,185511,Staff,13,0,20,7
1683307559216,CHEM 4,A01,184675,Bussey; Thomas J,96,0,100,4
1683307560241,CHEM 6A,A01,184677,Staff,35,0,60,25
1683307561265,CHEM 6B,A01,184679,Staff,65,0,100,35
1683307562288,CHEM 6C,A01,184681,Bussey; Thomas J,1,0,50,49
1683307562288,CHEM 6C,A02,184682,Bussey; Thomas J,34,0,50,16
1683307563314,CHEM 40A,A01,184684,Albizati; Kim F.,37,0,100,63
1683307564346,CHEM 40B,A01,184686,Albizati; Kim F.,0,20,100,100
1683307565369,CHEM 41B,A01,184690,Staff,52,0,100,48
1683307566393,COGS 3,A01,184715,Boyle; Mary E. T.,0,25,40,40
1683307567418,COGS 14B,A01,185172,Staff,0,15,38,38
1683307568445,COGS 18,A01,184736,Staff,20,0,80,60
1683307569476,COGS 100,A01,184932,Staff,0,5,73,73
1683307570502,COGS 101A,A01,184935,Staff,0,38,30,30
1683307571528,COGS 101B,A01,184944,Staff,0,2,30,30
1683307572551,COGS 101C,A01,184946,Staff,0,12,30,30
1683307573576,COGS 102A,A01,184951,Johnson; Christine M.,2,0,40,38
1683307574605,COGS 107B,A01,184953,Mooshagian; Eric Frederick,0,50,40,40
1683307575628,COGS 118B,A01,184959,Gupta; Anjum,0,48,40,40
1683307576655,COGS 153,A00,184961,Staff,0,15,30,30
1683307577679,COGS 177,A00,184962,Staff,0,21,30,30
1683307578703,COGS 187A,A01,184969,Boyle; Mary E. T.,0,17,40,40
1683307579731,COMM 10,A01,185174,Staff,0,5,25,25
1683307579731,COMM 10,A02,185189,Staff,0,5,25,25
1683307579731,COMM 10,A03,269821,Staff,0,0,0,0
1683307580754,COMM 100B,A01,185475,Staff,0,0,0,2
1683307580754,COMM 100B,A02,185476,Staff,14,0,25,11
1683307581782,COMM 100C,A01,185314,Staff,1,0,25,24
1683307581782,COMM 100C,A02,185327,Staff,19,0,25,6
1683307582808,COMM 110M,A00,185349,Staff,2,0,40,38
1683307583832,COMM 113T,A00,185352,Staff,25,0,40,15
1683307584856,COMM 114I,A00,185353,Staff,33,0,40,7
1683307585880,COMM 131,A00,185354,Staff,19,0,30,11
1683307586908,CSE 8A,A50,185358,Cao; Yingjun,0,46,10,10
1683307587936,CSE 8B,A01,185362,Staff,1,47,50,49
1683307588961,CSE 11,A01,185416,Cao; Yingjun,0,93,10,10
1683307589986,CSE 20,A01,185445,Briones; Jor-el Thomas Caparas,5,0,25,20
1683307591014,CSE 21,A01,185447,Staff,10,0,50,40
1683307592039,CSE 101,A01,185451,Staff,0,12,50,50
1683307592039,CSE 101,B01,185453,Jones; Miles E,0,11,50,50
1683307594088,CSE 141,A01,185458,Eldon; John,20,0,100,80
1683307595112,CSE 141L,A01,185461,Eldon; John,12,0,100,88
1683307596137,CSE 142,A01,185463,Staff,35,0,60,25
1683307596137,CSE 142,B01,201355,Staff,0,6,60,60
1683307597163,CSE 142L,A01,185470,Staff,35,0,60,25
1683307597163,CSE 142L,B01,201417,Staff,0,5,60,60
1683307598190,CSE 190,A00,201433,Staff,32,0,49,17
1683307599219,DOC 1,A01,259136,Strom; Megan C.,8,0,15,7
1683307599219,DOC 1,A02,259137,Strom; Megan C.,14,0,15,1
1683307599219,DOC 1,A03,259138,Strom; Megan C.,14,0,15,1
1683307599219,DOC 1,A04,259139,Strom; Megan C.,14,0,15,1
1683307600242,DOC 100D,A00,259140,Pass; Natalye Joann,17,0,25,8
1683307601265,DSGN 1,A01,184749,Rill; Bryan,0,24,30,30
1683307602289,DSGN 100,A01,185168,Staff,0,2,25,25
1683307603313,ECE 5,A01,185626,Morris; Karcher William,0,10,0,0
1683307604341,ECE 101,A01,185628,Staff,17,0,70,53
1683307605368,ECE 107,A01,185635,Baghdadchi; Saharnaz,0,0,20,20
1683307605368,ECE 107,A02,185638,Baghdadchi; Saharnaz,4,0,20,16
1683307606393,ECE 148,A01,185647,Silberman; Jack,0,0,16,16
1683307607421,ECON 1,A01,185537,Crane; Meredith Helen,54,0,70,16
1683307608444,ECON 3,A01,185549,Crane; Meredith Helen,33,0,70,37
1683307609468,ECON 4,A01,203354,Anderson; John Charles,0,4,10,10
1683307610495,ECON 100A,A01,185574,Staff,0,4,40,40
1683307611520,ECON 100B,A01,185576,Staff,0,22,40,40
1683307612545,ECON 100C,A01,185589,Newhouse; Herbert S,30,0,70,40
1683307613571,ECON 105,A00,185608,Vespa; Emanuel Ignacio,19,0,35,16
1683307614598,ECON 109,A01,185610,Shishkin; Denis,10,0,35,25
1683307615625,ECON 110A,A01,185612,Staff,11,0,40,29
1683307616655,ECON 120A,A01,185615,Staff,20,0,40,20
1683307617683,ECON 120C,A01,185617,Sun; Yixiao,0,20,70,70
1683307618711,ECON 144,A00,203346,Squires; Dale E,3,0,35,32
1683307619734,ECON 171,A01,203349,Newhouse; Herbert S,0,1,35,35
1683307620759,ECON 173A,A01,185621,Toda; Alexis Akira,21,0,35,14
1683307621784,EDS 25,A01,202413,Staff,0,1,0,0
1683307621784,EDS 25,A02,202414,Staff,0,1,0,0
1683307621784,EDS 25,A03,202415,Staff,0,0,0,0
1683307621784,EDS 25,A04,202416,Staff,0,1,0,0
1683307621784,EDS 25,A05,202439,Staff,0,0,0,0
1683307621784,EDS 25,A06,202440,Staff,0,0,0,0
1683307621784,EDS 25,B01,202631,Staff,0,0,0,0
1683307621784,EDS 25,B02,202632,Staff,0,0,0,0
1683307621784,EDS 25,B03,202639,Staff,0,0,0,0
1683307621784,EDS 25,B04,202640,Staff,0,0,0,0
1683307621784,EDS 25,B05,202643,Staff,0,0,0,0
1683307621784,EDS 25,B06,202644,Staff,0,0,0,0
1683307622814,EDS 38,A01,202659,Black; Alison Michelle,24,0,25,1
1683307623838,EDS 115,A00,202652,Staff,17,0,30,13
1683307624865,EDS 125,A00,202649,Staff,14,0,30,16
1683307625889,EDS 126,A01,203332,Staff,30,0,30,0
1683307626913,EDS 139,A00,202838,Staff,17,0,25,8
1683307627938,EDS 146,A01,202655,Staff,15,0,25,10
1683307628963,ENG 15,A00,185667,Staff,0,1,0,0
1683307628963,ENG 15,B00,185672,Staff,0,0,0,0
1683307628963,ENG 15,C00,185675,Staff,0,0,0,0
1683307628963,ENG 15,D00,185682,Staff,0,0,0,0
1683307628963,ENG 15,E00,185684,Staff,0,0,0,0
1683307629987,ETHN 103,A00,185710,Staff,0,3,35,35
1683307631012,ETHN 103A,A00,199228,Man; Simeon S,2,0,9,7
1683307632037,ETHN 109,A00,185711,Staff,18,0,35,17
1683307633061,ETHN 142,A00,185726,Staff,0,4,30,30
1683307634089,ETHN 163J,A00,199229,Man; Simeon S,6,0,8,2
1683307635115,ETHN 168,A00,185727,Staff,8,0,10,2
1683307636142,ETHN 182,A00,185728,Staff,1,0,35,34
1683307637165,ETHN 183,A00,185737,Staff,8,0,18,10
1683307638189,GLBH 111,A01,209361,Burgos; Jose L.,0,0,0,0
1683307640240,HIEU 104,A00,185792,Staff,16,0,20,4
1683307641264,HIEU 115,A00,185800,Staff,1,0,20,19
1683307642287,HIEU 128,A00,185801,Staff,0,7,20,20
1683307643314,HIEU 147,A00,185802,Staff,16,0,20,4
1683307644342,HIEU 154,A00,185823,Staff,12,0,20,8
1683307645367,HILA 102,A00,185826,Staff,13,0,20,7
1683307646395,HILD 2C,A01,185778,Staff,0,12,20,20
1683307647421,HILD 7B,A01,185780,Kwak; Nancy,0,15,32,32
1683307647421,HILD 7B,A02,185781,Kwak; Nancy,0,18,32,32
1683307648446,HILD 30,A01,185791,Staff,14,0,20,6
1683307649470,HISC 119,A00,185830,Golan; Tal,0,9,20,20
1683307650494,HITO 156GS,A00,185831,Patterson; Patrick H.,0,0,0,23
1683307651518,HIUS 103,A00,185832,Man; Simeon S,0,6,20,20
1683307652546,HIUS 117,A00,185836,Kwak; Nancy,2,0,20,18
1683307653571,HIUS 125,A00,185840,Man; Simeon S,0,0,23,23
1683307654598,HIUS 149,A00,185845,Staff,0,0,20,20
1683307655623,HUM 3,A01,185882,Zavodny; Tatiana Sophia,0,6,50,50
1683307655623,HUM 3,B01,185899,Caldwell; Michael Alan,0,19,50,50
1683307656703,HUM 3GS,A00,185900,Patterson; Patrick H.,0,0,0,23
1683307657736,HUM 4,A01,185938,Zroka; Amy Liane,31,0,50,19
1683307657736,HUM 4,B01,185956,Watkins; Eric,0,2,50,50
1683307657736,HUM 4,B02,202209,Watkins; Eric,0,2,50,50
1683307657736,HUM 4,B03,202210,Watkins; Eric,0,0,50,50
1683307658761,HUM 5,A01,185958,West; Geoffrey Scott,4,0,50,46
1683307658761,HUM 5,A02,202215,West; Geoffrey Scott,0,0,50,50
1683307659789,INTL 190,A00,185959,Gagnon; Jeffrey C,0,0,0,9
1683307659789,INTL 190,B00,185960,Lettieri; Michael Joseph,0,0,0,1
1683307660816,JAPN 180,A00,254509,Staff,5,1,30,25
1683307661841,LATI 10,A01,202853,Kennemore; Amy Michelle,5,0,35,30
1683307661841,LATI 10,A02,202854,Kennemore; Amy Michelle,1,0,35,34
1683307661841,LATI 10,A03,270054,Kennemore; Amy Michelle,30,0,30,0
1683307662867,LATI 180,A00,202855,Kennemore; Amy Michelle,11,0,20,9
1683307663891,LAWS 101,A00,201767,Golan; Tal,0,7,40,40
1683307664916,LIFR 1C,A00,185961,Staff,6,0,20,14
1683307665940,LIFR 1CX,A00,185962,Staff,7,0,20,13
1683307666964,LIFR 1D,A00,185963,Staff,9,0,20,11
1683307667989,LIFR 1DX,A00,185964,Staff,9,0,20,11
1683307669013,LIGN 101,A01,186039,Staff,43,0,50,7
1683307670037,LIGN 165,A00,186040,Staff,18,0,50,32
1683307671061,LTCS 108,A00,186041,Staff,6,0,10,4
1683307672084,LTCS 119,A00,186042,Staff,16,0,20,4
1683307673112,LTCS 130,A00,186043,Wesling; Megan E.,15,0,25,10
1683307675167,LTEA 138,A00,186119,Staff,14,0,40,26
1683307676191,LTEN 124,A00,186148,Staff,6,0,25,19
1683307677216,LTEN 178,A00,186149,Staff,7,0,15,8
1683307678241,LTEN 181,A00,186150,Blanco; John D,33,0,40,7
1683307679266,LTWL 120,A00,186160,Staff,20,0,25,5
1683307680293,LTWL 165,A00,186161,Staff,22,0,25,3
1683307681317,LTWR 100,A00,186162,Staff,0,4,15,15
1683307682341,LTWR 102,A00,186163,Doller; Ben,5,0,15,10
1683307683365,MAE 8,A01,186412,Staff,0,0,0,0
1683307684388,MAE 30B,A00,186445,Bahadori; Mohammad Yousef,83,0,100,17
1683307685416,MAE 40,A00,186592,Bewley; Thomas R,9,0,50,41
1683307686438,MAE 101B,A00,186593,Bahadori; Mohammad Yousef,81,0,100,19
1683307687462,MAE 105,A00,186594,Bandaru; Prabhakar,12,0,50,38
1683307688490,MAE 107,A00,186599,Pham; Hieu Tan,0,6,120,120
1683307689514,MAE 148,A01,186660,Silberman; Jack,3,0,16,13
1683307690543,MATH 10A,A01,188095,Staff,0,7,35,35
1683307691568,MATH 10B,A01,188097,Bowers; Adam R.,0,11,30,30
1683307691568,MATH 10B,A02,188099,Bowers; Adam R.,0,9,30,30
1683307691568,MATH 10B,B01,188104,Bowers; Adam R.,0,11,30,30
1683307691568,MATH 10B,B02,188106,Bowers; Adam R.,0,11,30,30
1683307692598,MATH 10C,A01,188111,Staff,0,18,30,30
1683307692598,MATH 10C,A02,188127,Staff,0,17,30,30
1683307692598,MATH 10C,A03,188131,Staff,0,17,30,30
1683307692598,MATH 10C,B01,188218,Staff,21,0,30,9
1683307692598,MATH 10C,B02,188244,Staff,13,0,30,17
1683307692598,MATH 10C,B03,188277,Staff,16,0,30,14
1683307693627,MATH 18,A01,188344,Bach; Quang Tran,18,0,30,12
1683307693627,MATH 18,A02,188345,Bach; Quang Tran,11,0,30,19
1683307693627,MATH 18,B01,188353,Bach; Quang Tran,10,0,30,20
1683307693627,MATH 18,B02,188354,Bach; Quang Tran,20,0,30,10
1683307694652,MATH 20A,A01,188374,Staff,13,0,35,22
1683307695682,MATH 20B,A01,188382,Ohm; Ko Woon,6,0,30,24
1683307695682,MATH 20B,A02,188383,Ohm; Ko Woon,23,0,30,7
1683307695682,MATH 20B,B01,188385,Ohm; Ko Woon,7,0,30,23
1683307695682,MATH 20B,B02,188392,Ohm; Ko Woon,22,0,30,8
1683307696710,MATH 20C,A01,188394,Harel; Guershon,10,0,30,20
1683307696710,MATH 20C,A02,188395,Harel; Guershon,13,0,30,17
1683307696710,MATH 20C,B01,188404,Harel; Guershon,3,0,30,27
1683307696710,MATH 20C,B02,188405,Harel; Guershon,19,0,30,11
1683307697736,MATH 20D,A01,188414,Hammock; Frances H,0,1,30,30
1683307697736,MATH 20D,A02,188415,Hammock; Frances H,4,0,30,26
1683307697736,MATH 20D,B01,188447,Hammock; Frances H,2,0,30,28
1683307697736,MATH 20D,B02,188486,Hammock; Frances H,8,0,30,22
1683307698762,MATH 20E,A01,188649,Staff,22,0,30,8
1683307698762,MATH 20E,A02,188650,Staff,23,0,30,7
1683307698762,MATH 20E,A03,188673,Staff,0,0,30,30
1683307699795,MATH 102,A01,188675,Staff,0,35,35,35
1683307700823,MATH 103B,A01,188681,Staff,4,0,35,31
1683307700823,MATH 103B,B01,188692,Staff,7,0,35,28
1683307701853,MATH 109,A01,188695,Salehi Golsefidy; Alireza,25,0,35,10
1683307701853,MATH 109,A02,188696,Salehi Golsefidy; Alireza,27,0,35,8
1683307702880,MATH 120A,A01,188698,Eggers; John Dietrich,6,0,35,29
1683307703909,MATH 142B,A01,188736,Ioana; Adrian,0,2,30,30
1683307703909,MATH 142B,A02,188741,Ioana; Adrian,0,1,30,30
1683307703909,MATH 142B,A03,188743,Ioana; Adrian,0,3,30,30
1683307704935,MATH 168A,A01,188790,Staff,0,9,35,35
1683307705964,MATH 170A,A01,188803,Nie; Jiawang,0,2,35,35
1683307705964,MATH 170A,A02,188811,Nie; Jiawang,0,0,35,35
1683307705964,MATH 170A,A03,188814,Nie; Jiawang,1,0,35,34
1683307705964,MATH 170A,A04,188815,Nie; Jiawang,13,0,35,22
1683307706990,MATH 193B,A01,188817,Staff,0,0,35,35
1683307706990,MATH 193B,A02,188818,Staff,5,0,35,30
1683307708015,MGT 4,A01,202857,Anderson; John Charles,62,0,80,18
1683307709043,MGT 12,A00,202858,Lindenberger; Wade Douglas,43,0,90,47
1683307710066,MGT 18,A00,202859,Staff,74,0,90,16
1683307711091,MGT 18GS,A00,202860,McKay; Michael J,13,0,28,15
1683307712116,MGT 45,A00,202861,Pecore; Joseph P.,14,0,90,76
1683307713144,MGT 100,A00,202863,Yavorsky; Daniel Ryan,28,0,90,62
1683307714168,MGT 103,A00,202864,Ehrich; Kristine R,0,16,90,90
1683307715195,MGT 112,A00,202865,Ehrich; Kristine R,15,0,90,75
1683307716220,MGT 121A,A00,202868,Staff,0,19,0,0
1683307717247,MGT 131B,A00,202869,Anderson; John Charles,59,0,90,31
1683307718273,MGT 136,A00,202871,Lindenberger; Wade Douglas,84,0,90,6
1683307719300,MGT 164,A00,202873,Staff,0,69,90,90
1683307720324,MGT 164GS,A00,202874,McKay; Mary A,13,0,28,15
1683307721349,MGT 180,A00,202875,Staff,0,51,90,90
1683307722373,MMW 11R,A01,205019,Herbst; Matthew,3,0,30,27
1683307722373,MMW 11R,A02,205026,Herbst; Matthew,29,0,30,1
1683307723400,MMW 15,A01,193512,Chang; Edmond Yi-Teh,0,9,28,28
1683307723400,MMW 15,A02,193513,Chang; Edmond Yi-Teh,0,5,28,28
1683307723400,MMW 15,A03,193514,Chang; Edmond Yi-Teh,0,5,28,28
1683307723400,MMW 15,A04,193515,Chang; Edmond Yi-Teh,0,5,28,28
1683307723400,MMW 15,A05,193516,Chang; Edmond Yi-Teh,0,4,28,28
1683307723400,MMW 15,A06,193517,Chang; Edmond Yi-Teh,0,5,28,28
1683307723400,MMW 15,B01,193519,Chang; Edmond Yi-Teh,0,4,28,28
1683307723400,MMW 15,B02,193520,Chang; Edmond Yi-Teh,0,5,28,28
1683307723400,MMW 15,B03,193521,Chang; Edmond Yi-Teh,0,4,28,28
1683307723400,MMW 15,B04,193522,Chang; Edmond Yi-Teh,0,4,28,28
1683307723400,MMW 15,B05,193523,Chang; Edmond Yi-Teh,0,5,28,28
1683307723400,MMW 15,B06,193524,Chang; Edmond Yi-Teh,0,4,28,28
1683307724424,MMW 122,A01,193526,Rahimi; Babak,0,14,28,28
1683307724424,MMW 122,A02,193527,Rahimi; Babak,0,14,28,28
1683307724424,MMW 122,A03,193528,Rahimi; Babak,0,0,0,0
1683307724424,MMW 122,A04,193529,Rahimi; Babak,0,0,0,0
1683307725447,MUS 1A,A01,186663,Staff,0,20,35,35
1683307726472,MUS 4,A01,186715,Staff,0,12,35,35
1683307727496,MUS 5R,A01,186796,Dubnov; Shlomo,0,17,35,35
1683307728521,MUS 6,A01,186798,Staff,0,3,25,25
1683307729546,MUS 7,A01,186830,Staff,12,0,35,23
1683307730573,MUS 8,A01,186930,Staff,0,26,35,35
1683307731597,MUS 15,A01,186932,Staff,0,15,35,35
1683307731597,MUS 15,B01,186934,Staff,0,15,35,35
1683307732622,MUS 80,A00,186935,Staff,2,0,20,18
1683307732622,MUS 80,B00,186936,Staff,25,0,25,0
1683307733646,NANO 11,A00,204702,Lipomi; Darren John,0,0,0,0
1683307734671,NANO 15,A01,204709,Yang; Kesong,0,1,0,0
1683307735696,NANO 114,A00,202069,Jahed Motlagh; Zeinab,3,0,10,7
1683307736722,PHIL 1,A00,186955,Grush; Rick Scott,32,0,40,8
1683307737746,PHIL 10,A01,186973,Grush; Rick Scott,28,0,35,7
1683307737746,PHIL 10,A02,186974,Grush; Rick Scott,33,0,35,2
1683307738771,PHIL 13,A01,186976,Staff,7,0,35,28
1683307738771,PHIL 13,A02,186977,Staff,16,0,35,19
1683307739795,PHIL 14,A01,186979,Staff,31,0,35,4
1683307739795,PHIL 14,A02,186986,Staff,32,0,35,3
1683307740820,PHIL 28,A01,186988,Staff,16,0,30,14
1683307740820,PHIL 28,A02,186989,Staff,1,0,30,29
1683307740820,PHIL 28,A03,186990,Staff,9,0,30,21
1683307740820,PHIL 28,A04,186991,Staff,26,0,30,4
1683307741846,PHIL 120,A00,186997,Staff,23,0,40,17
1683307742873,PHIL 137,A00,187003,Staff,9,0,40,31
1683307743900,PHIL 150,A00,187015,Staff,47,0,70,23
1683307744929,PHIL 167,A00,187021,Lamey; Andy M.,35,0,40,5
1683307745953,PHIL 174,A01,202226,Staff,17,0,20,3
1683307745953,PHIL 174,A02,202235,Staff,20,0,20,0
1683307746977,PHIL 191A,A00,258918,Staff,0,0,1,1
1683307748006,PHYS 1A,A00,187028,Staff,27,0,60,33
1683307749033,PHYS 1AL,001,187036,Staff,3,0,30,27
1683307749033,PHYS 1AL,002,187049,Staff,18,0,30,12
1683307750062,PHYS 1B,A00,187058,Staff,23,0,60,37
1683307751090,PHYS 1BL,001,187064,Staff,0,0,30,30
1683307751090,PHYS 1BL,002,187070,Staff,6,0,30,24
1683307752116,PHYS 1C,A00,187082,Staff,31,0,120,89
1683307753139,PHYS 1CL,001,187088,Staff,0,9,30,30
1683307753139,PHYS 1CL,002,187089,Staff,0,2,30,30
1683307753139,PHYS 1CL,009,262693,Staff,11,0,30,19
1683307754167,PHYS 2B,A01,187097,Staff,54,0,115,61
1683307755194,PHYS 2C,A01,187099,Staff,67,0,115,48
1683307756220,PHYS 2CL,A01,187101,Staff,5,0,28,23
1683307756220,PHYS 2CL,A02,187102,Staff,15,0,28,13
1683307757248,PHYS 2D,A01,187123,Shotwell; Brian,95,0,115,20
1683307758273,PHYS 4B,A01,187133,Grinstein; Benjamin,35,0,50,15
1683307759301,POLI 10,A00,188819,Staff,0,3,50,50
1683307760395,POLI 11,A00,188827,Staff,43,0,50,7
1683307761420,POLI 13R,A00,188828,Staff,0,1,20,20
1683307762446,POLI 27,A01,188830,Elgin; Samuel Zincke,0,1,70,70
1683307763472,POLI 30,A00,188832,Desposato; Scott,33,0,50,17
1683307764501,POLI 102F,A00,188834,Staff,3,0,40,37
1683307765524,POLI 104A,A00,188852,Staff,14,0,30,16
1683307766549,POLI 104I,A00,188853,Staff,0,6,20,20
1683307767574,POLI 110B,A00,188854,Wiens; David,7,0,20,13
1683307768599,POLI 112A,A00,188855,Wiens; David,5,0,30,25
1683307769627,POLI 117R,A00,188856,Forman; Fonna,0,11,20,20
1683307770654,POLI 118,A00,188857,Ingham; Sean,8,0,20,12
1683307771678,POLI 120G,A00,188858,Staff,9,0,30,21
1683307772703,POLI 131CR,A00,188863,Hoston; Germaine,24,0,50,26
1683307773732,POLI 133,A00,188864,Nellis; Gareth Hb,44,0,50,6
1683307774767,POLI 134D,A00,188865,Desposato; Scott,27,0,30,3
1683307775791,POLI 142A,A00,188871,Gartzke; Erik,22,0,50,28
1683307776820,POLI 142K,A00,188874,Staff,38,0,50,12
1683307777844,POLI 143,A00,188940,Gartzke; Erik,16,0,30,14
1683307778868,POLI 153,A00,188943,Staff,3,0,20,17
1683307779894,POLI 160AA,A00,188944,Staff,13,0,40,27
1683307780918,POLI 170A,A00,188945,Staff,11,0,30,19
1683307782966,PSYC 1,A00,188952,Staff,38,0,90,52
1683307783993,PSYC 2,B00,188953,Staff,20,0,35,15
1683307785017,PSYC 6,A00,188970,Staff,47,0,60,13
1683307786043,PSYC 7,A00,188973,Staff,37,0,45,8
1683307787070,PSYC 60,A01,188980,Rickard; Timothy C.,43,0,60,17
1683307788098,PSYC 70,A01,189001,Steiner; Eric Tomas,24,0,45,21
1683307789122,PSYC 100,A00,189005,Lacefield; Katharine I,0,99,120,120
1683307790147,PSYC 102,A00,189008,Staff,10,0,30,20
1683307791170,PSYC 106,B00,189026,Gorman; Michael R.,37,0,60,23
1683307792193,PSYC 114,B01,189033,Winkielman; Piotr,0,32,30,30
1683307793220,PSYC 131,A00,189036,Anagnostaras; Stephan,0,43,60,60
1683307794245,PSYC 136,A00,189041,Lowe; Angela Beth,0,7,25,25
1683307795271,PSYC 137,A00,189057,Winkielman; Piotr,0,34,25,25
1683307796295,PSYC 144,A00,189107,Wixted; John T,0,7,50,50
1683307798353,PSYC 162,A00,189142,Staff,0,8,85,85
1683307799375,PSYC 172,A00,189144,Gorman; Michael R.,0,7,30,30
1683307801429,PSYC 179,A00,189146,Lacefield; Katharine I,0,84,120,120
1683307802457,PSYC 181,A00,189147,Anagnostaras; Stephan,0,44,90,90
1683307803484,PSYC 190R,A00,189148,Barner; David A.,0,22,80,80
1683307804510,PSYC 191,A00,189275,Rickard; Timothy C.,0,7,25,25
1683307805534,PSYC 193,A00,189276,Chapman; Eddie Nathaniel,0,1,0,4
1683307806556,PSYC 193L,A01,189281,Lowe; Angela Beth,12,0,20,8
1683307806556,PSYC 193L,B01,189285,Staff,28,0,35,7
1683307807581,RELI 149,A00,187137,Rahimi; Babak,7,0,40,33
1683307808608,SE 9,A01,187315,Staff,0,2,18,18
1683307809631,SE 101B,A00,187409,Staff,24,0,30,6
1683307810656,SE 110B,A00,187444,Staff,10,0,40,30
1683307811684,SE 130B,A00,187449,Staff,31,0,40,9
1683307812708,SE 150A,A00,187516,Staff,9,0,20,11
1683307813740,SE 154,A00,187528,Staff,30,0,50,20
1683307814771,SIO 3,A01,258171,Staff,35,0,40,5
1683307815796,SIO 10,A00,187144,Cook; Geoffrey W,0,3,75,75
1683307816824,SIO 45,A00,187152,Cook; Geoffrey W,1,0,100,99
1683307817848,SIO 109R,A00,194486,Staff,0,3,20,20
1683307819896,SIO 187,A01,187233,Kacev; David,12,0,40,28
1683307820922,SOCI 1,A01,258656,Thorpe; Charles Robert,28,0,30,2
1683307820922,SOCI 1,A02,258658,Thorpe; Charles Robert,30,0,30,0
1683307820922,SOCI 1,A03,258661,Thorpe; Charles Robert,25,0,25,0
1683307820922,SOCI 1,A04,258666,Thorpe; Charles Robert,22,0,25,3
1683307820922,SOCI 1,A05,258897,Thorpe; Charles Robert,23,0,25,2
1683307820922,SOCI 1,A06,258898,Thorpe; Charles Robert,25,0,25,0
1683307821946,SOCI 30,A01,258903,Pardo Guerra; Juan Pablo,16,0,30,14
1683307822971,SOCI 102,A00,258904,Staff,9,0,25,16
1683307823999,SOCI 106,A00,258905,Staff,19,0,25,6
1683307825023,SOCI 111,A00,258907,Ribas Norris; Janet Vanesa,26,0,30,4
1683307826050,SOCI 121R,A00,258908,Pardo Guerra; Juan Pablo,11,0,30,19
1683307827075,SOCI 126,A01,203330,Staff,14,0,20,6
1683307828099,SOCI 131,A00,258909,Thorpe; Charles Robert,31,0,60,29
1683307829123,SOCI 135,A00,258910,Payne; Christine Anna,0,9,30,30
1683307830151,SOCI 157,A00,258911,Staff,13,0,30,17
1683307831177,SOCI 184,A00,258912,Staff,26,0,30,4
1683307832201,SOCI 188D,A00,258913,Staff,21,0,30,9
1683307833226,SYN 2,001,187529,Staff,9,0,16,7
1683307833226,SYN 2,002,201452,Staff,0,18,16,16
1683307833226,SYN 2,003,201469,Staff,3,0,16,13
1683307834250,SYN 100,A01,187531,Staff,0,9,20,20
1683307834250,SYN 100,B01,201491,Staff,0,12,20,20
1683307835275,TDAC 1,A00,189286,Walsh; Kim C.,3,0,20,17
1683307835275,TDAC 1,B00,189287,Harting; Carla Kelso,11,0,20,9
1683307836302,TDAC 101,A00,189300,Walsh; Kim C.,16,0,20,4
1683307836302,TDAC 101,B00,189301,Harting; Carla Kelso,18,0,20,2
1683307837325,TDAC 102,A00,189304,Basso; Beatrice,14,0,20,6
1683307838353,TDAC 108,A00,189305,Staff,18,0,20,2
1683307839379,TDDE 131,A00,189310,Staff,19,0,20,1
1683307839379,TDDE 131,B00,189314,Staff,19,0,20,1
1683307839379,TDDE 131,C00,189315,Staff,48,0,50,2
1683307839379,TDDE 131,D00,189316,Staff,14,0,15,1
1683307839379,TDDE 131,E00,204841,Staff,20,0,20,0
1683307840406,TDGE 10,A00,189289,Staff,30,0,50,20
1683307840406,TDGE 10,B00,189290,Havis; Allan,2,0,50,48
1683307841431,TDGE 11,A00,189291,Fulton; Julia,0,3,50,50
1683307841431,TDGE 11,B00,189292,Staff,20,0,25,5
1683307841431,TDGE 11,C00,260270,Staff,0,0,0,0
1683307842457,TDGE 25,A00,189294,Staff,3,0,20,17
1683307843481,TDGE 124,A00,189318,Fulton; Julia,0,8,50,50
1683307844505,TDGE 125,A00,189319,Staff,13,0,25,12
1683307844505,TDGE 125,B00,189320,Staff,23,0,25,2
1683307845528,TDGE 127,A00,189322,Havis; Allan,0,0,50,50
1683307846551,TDHT 101,A00,189323,Staff,18,0,25,7
1683307846551,TDHT 101,B00,189324,Staff,25,0,25,0
1683307847580,TDHT 102,A00,189325,Staff,49,0,50,1
1683307848603,TDMV 1,A00,189295,Arcidiacono; Kristin,20,0,30,10
1683307848603,TDMV 1,B00,189296,Caligagan; Maria T.,24,0,30,6
1683307849626,TDMV 2,A00,189297,Sammartano; Tonnie,28,0,30,2
1683307849626,TDMV 2,B00,189299,Arcidiacono; Kristin,24,0,30,6
1683307850650,TDMV 3,A00,204998,Rincon; Alicia,22,0,30,8
1683307851677,TDMV 120,A00,189458,Sammartano; Tonnie,28,0,30,2
1683307852701,TDMV 138,A00,189541,Jun; Grace Shin Hae,22,0,40,18
1683307853726,TDMV 142,A00,189717,Caligagan; Tony,23,0,30,7
1683307853726,TDMV 142,B00,189718,Caligagan; Maria T.,25,0,30,5
1683307854749,TMC 2,A01,187533,Staff,25,0,25,0
1683307854749,TMC 2,A02,187534,Staff,25,0,25,0
1683307855776,USP 1,A01,187536,Kwak; Nancy,0,16,25,25
1683307856803,USP 5,A01,187538,Staff,9,0,25,16
1683307857829,USP 101,A00,199253,Staff,0,4,0,0
1683307858853,USP 124,A00,187562,Boomhower; Matthew Charles,1,0,30,29
1683307859880,USP 138,A00,187582,Staff,20,0,25,5
1683307860904,USP 152,A01,187597,Staff,4,0,25,21
1683307861929,USP 153,A00,187598,Staff,19,0,25,6
1683307862955,USP 168,A00,187607,Kwak; Nancy,2,0,5,3
1683307864037,USP 173,A00,187619,Staff,4,0,25,21
1683307865062,USP 181,A00,187638,Staff,0,0,25,25
1683307866088,VIS 103,A00,187650,Cruz; Edwin Teddy,23,0,75,52
1683307867115,VIS 110D,A00,187669,Staff,12,0,22,10
1683307868145,VIS 127C,A00,187720,Shen; Kuiyi,68,0,146,78
1683307869173,VIS 149,A00,187731,Yoldas; Pinar,0,14,22,22
1683307870198,VIS 151,A01,188091,Staff,22,0,34,12
1683307870198,VIS 151,A02,188092,Staff,11,0,34,23
1683307871226,VIS 160B,A00,188093,Stalbaum; Brett,0,0,10,10
1683307873279,WCWP 10B,A00,201720,Staff,10,0,15,5
1683307873279,WCWP 10B,B00,201722,Staff,8,0,15,7
1683307874303,WCWP 100,A00,201725,Gagnon; Jeffrey C,0,0,2,2
1683307874303,WCWP 100,B00,201727,Staff,0,4,15,15
1683307877428,ANBI 133,A00,258401,Wilder; Linnea Lorene,34,0,40,6
1683307878455,ANBI 140,A00,258395,Hrvoj Mihic; Branka,18,0,25,7
1683307879482,ANSC 120,A00,258402,Bialecki; Jon Anthony,27,0,40,13
1683307880509,ANSC 144,A00,258400,Staff,14,0,40,26
1683307882558,ANSC 166,A00,258396,Parish; Steven Martin,157,0,175,18
1683307883585,ANSC 180,A00,193533,Staff,9,0,20,11
1683307884610,ANSC 188,A00,258397,Jassal; Aftab,33,0,40,7
1683307885637,ANTH 3,A01,258316,Staff,23,0,30,7
1683307886661,ANTH 5,A00,258394,Semendeferi; Ekaterini,16,0,20,4
1683307887685,ANTH 21,A01,258331,Staff,9,0,40,31
1683307888709,ANTH 103,A00,258398,Varma; Saiba,15,0,25,10
1683307889736,AWP 10,001,202034,Staff,0,0,0,0
1683307889736,AWP 10,002,202035,Staff,0,0,0,0
1683307889736,AWP 10,003,202036,Staff,0,0,0,0
1683307889736,AWP 10,004,202037,Staff,0,0,0,0
1683307889736,AWP 10,005,202038,Staff,0,0,0,0
1683307889736,AWP 10,006,202039,Staff,0,0,0,0
1683307889736,AWP 10,007,202040,Staff,0,0,0,0
1683307889736,AWP 10,008,202041,Staff,0,0,0,0
1683307889736,AWP 10,009,202042,Staff,0,0,0,0
1683307889736,AWP 10,010,202043,Staff,0,0,0,0
1683307889736,AWP 10,011,202044,Staff,0,0,0,0
1683307889736,AWP 10,012,202045,Staff,0,0,0,0
1683307889736,AWP 10,013,202046,Staff,0,0,0,0
1683307889736,AWP 10,014,202047,Staff,0,0,0,0
1683307889736,AWP 10,015,202048,Staff,0,0,0,0
1683307889736,AWP 10,016,202049,Staff,0,0,0,0
1683307889736,AWP 10,017,202050,Staff,0,0,0,0
1683307889736,AWP 10,018,202051,Staff,0,0,0,0
1683307889736,AWP 10,019,202052,Staff,0,0,0,0
1683307889736,AWP 10,020,202053,Staff,0,0,0,0
1683307889736,AWP 10,021,202054,Staff,0,0,0,0
1683307889736,AWP 10,022,202055,Staff,0,0,0,0
1683307889736,AWP 10,023,202056,Staff,0,0,0,0
1683307889736,AWP 10,024,202057,Staff,0,0,0,0
1683307889736,AWP 10,025,202058,Staff,0,0,0,0
1683307889736,AWP 10,026,202059,Staff,0,0,0,0
1683307890763,AWP 102,001,202032,Staff,0,0,0,0
1683307890763,AWP 102,002,202033,Staff,0,0,0,0
1683307891790,BENG 100,A01,254234,Taylor Amos; Alyssa C,31,0,40,9
1683307892814,BENG 196,001,270013,Engler; Adam J.,9999,0,9999,0
1683307893843,BICD 100R,A01,202018,Smith; Laurie,0,7,32,32
1683307893843,BICD 100R,A02,202019,Smith; Laurie,0,2,32,32
1683307893843,BICD 100R,A03,202020,Smith; Laurie,0,1,32,32
1683307893843,BICD 100R,A04,202021,Smith; Laurie,8,0,32,24
1683307893843,BICD 100R,A05,202022,Smith; Laurie,12,0,32,20
1683307894871,BICD 136,A01,193242,Gustafson-Brown; Cindy,0,2,32,32
1683307894871,BICD 136,A02,193244,Gustafson-Brown; Cindy,15,0,32,17
1683307895898,BIEB 102,A01,193249,Butler; Shannon Rhey,0,2,32,32
1683307895898,BIEB 102,A02,193251,Butler; Shannon Rhey,0,0,32,32
1683307895898,BIEB 102,A03,193253,Butler; Shannon Rhey,0,1,32,32
1683307895898,BIEB 102,A04,193255,Butler; Shannon Rhey,17,0,32,15
1683307895898,BIEB 102,A05,193265,Butler; Shannon Rhey,26,0,32,6
1683307895898,BIEB 102,A06,193269,Butler; Shannon Rhey,16,0,32,16
1683307897948,BIEB 150,A01,193274,Staff,0,0,32,32
1683307897948,BIEB 150,A02,193285,Staff,24,0,32,8
1683307898975,BIEB 194,A00,193286,Kurle; Carolyn M.,22,0,32,10
1683307900001,BILD 1,A01,192291,Staff,16,0,32,16
1683307900001,BILD 1,A02,192292,Staff,30,0,32,2
1683307900001,BILD 1,B01,192520,Reuther; Keefe,0,1,0,0
1683307900001,BILD 1,B02,192532,Reuther; Keefe,0,1,0,0
1683307901027,BILD 3,A01,192556,Butler; Shannon Rhey,0,0,32,32
1683307901027,BILD 3,A02,192581,Butler; Shannon Rhey,5,0,32,27
1683307901027,BILD 3,A03,192611,Butler; Shannon Rhey,23,0,32,9
1683307901027,BILD 3,A04,192612,Butler; Shannon Rhey,25,0,32,7
1683307901027,BILD 3,A05,192613,Butler; Shannon Rhey,27,0,32,5
1683307901027,BILD 3,A06,192679,Butler; Shannon Rhey,27,0,32,5
1683307901027,BILD 3,A07,192682,Butler; Shannon Rhey,22,0,32,10
1683307902054,BILD 4,A01,192836,Reuther; Keefe,1,0,24,23
1683307902054,BILD 4,A02,193044,Reuther; Keefe,4,0,24,20
1683307903082,BILD 10,A01,193142,Gustafson-Brown; Cindy,31,0,32,1
1683307903082,BILD 10,A02,193149,Gustafson-Brown; Cindy,31,0,32,1
1683307904107,BIMM 100,A01,193301,Staff,0,6,32,32
1683307904107,BIMM 100,A02,193312,Staff,0,5,32,32
1683307904107,BIMM 100,A03,193323,Staff,0,8,32,32
1683307905133,BIMM 101,A01,193329,McDonnell; Lisa Marie,0,3,24,24
1683307905133,BIMM 101,A02,193339,McDonnell; Lisa Marie,0,2,24,24
1683307905133,BIMM 101,B01,193354,McDonnell; Lisa Marie,0,3,24,24
1683307905133,BIMM 101,B02,193357,McDonnell; Lisa Marie,0,3,24,24
1683307906156,BIMM 110,A01,193377,Tat; John,0,11,32,32
1683307906156,BIMM 110,A02,193378,Tat; John,1,9,32,31
1683307907181,BIMM 120,A01,206116,Staff,0,0,32,32
1683307907181,BIMM 120,A02,206117,Staff,8,0,32,24
1683307907181,BIMM 120,A03,206121,Staff,21,0,32,11
1683307908205,BIPN 100,A01,193393,Park; Ji Young,0,14,32,32
1683307908205,BIPN 100,A02,193402,Park; Ji Young,0,12,32,32
1683307908205,BIPN 100,A03,193413,Park; Ji Young,0,14,32,32
1683307908205,BIPN 100,A04,193414,Park; Ji Young,0,13,32,32
1683307909230,BIPN 102,A01,193429,Staff,0,0,32,32
1683307909230,BIPN 102,A02,193438,Staff,22,0,32,10
1683307910256,BIPN 106,A01,193450,Reyes Gonzalez; Catalina,0,2,40,40
1683307911283,BIPN 134,A01,193465,Cooke; James Edward,0,0,32,32
1683307911283,BIPN 134,A02,193474,Cooke; James Edward,27,0,32,5
1683307911283,BIPN 134,A03,193485,Cooke; James Edward,29,0,32,3
1683307911283,BIPN 134,A04,193486,Cooke; James Edward,21,0,32,11
1683307911283,BIPN 134,A05,193491,Cooke; James Edward,31,0,32,1
1683307911283,BIPN 134,A06,193501,Cooke; James Edward,30,0,32,2
1683307911283,BIPN 134,A07,193510,Cooke; James Edward,29,0,32,3
1683307913334,BISP 194,A00,222522,Staff,16,0,32,16
1683307914362,CAT 124,A01,202407,Staff,20,0,25,5
1683307915386,CAT 125,A00,202408,Marchisotto; Jennifer Anne,4,0,20,16
1683307916412,CAT 125R,A00,202409,Smith; Lauryn Alissa,0,11,20,20
1683307916412,CAT 125R,B00,202410,Morales; Celeste Georgianna,0,11,20,20
1683307916412,CAT 125R,C00,202411,Irwin; Matthew Joseph,0,10,20,20
1683307917437,CENG 15,A01,204712,Yang; Kesong,0,1,0,0
1683307918460,CENG 114,A00,202070,Jahed Motlagh; Zeinab,5,0,20,15
1683307919484,CGS 105,A00,185477,Wesling; Megan E.,24,0,40,16
1683307920510,CGS 106,A00,185494,Staff,13,0,22,9
1683307921535,CGS 108,A00,185495,Staff,14,0,20,6
1683307922561,CGS 114,A00,185496,Staff,13,0,18,5
1683307923585,CGS 119,A00,185501,Staff,15,0,20,5
1683307924613,CGS 120,A00,185511,Staff,13,0,20,7
1683307925641,CHEM 4,A01,184675,Bussey; Thomas J,96,0,100,4
1683307926668,CHEM 6A,A01,184677,Staff,35,0,60,25
1683307927692,CHEM 6B,A01,184679,Staff,65,0,100,35
1683307928718,CHEM 6C,A01,184681,Bussey; Thomas J,1,0,50,49
1683307928718,CHEM 6C,A02,184682,Bussey; Thomas J,34,0,50,16
1683307929742,CHEM 40A,A01,184684,Albizati; Kim F.,37,0,100,63
1683307930767,CHEM 40B,A01,184686,Albizati; Kim F.,0,20,100,100
1683307931792,CHEM 41B,A01,184690,Staff,52,0,100,48
1683307932817,COGS 3,A01,184715,Boyle; Mary E. T.,0,25,40,40
1683307933844,COGS 14B,A01,185172,Staff,0,15,38,38
1683307934871,COGS 18,A01,184736,Staff,20,0,80,60
1683307935899,COGS 100,A01,184932,Staff,0,5,73,73
1683307936927,COGS 101A,A01,184935,Staff,0,38,30,30
1683307937954,COGS 101B,A01,184944,Staff,0,2,30,30
1683307938978,COGS 101C,A01,184946,Staff,0,12,30,30
1683307940003,COGS 102A,A01,184951,Johnson; Christine M.,2,0,40,38
1683307941031,COGS 107B,A01,184953,Mooshagian; Eric Frederick,0,50,40,40
1683307942055,COGS 118B,A01,184959,Gupta; Anjum,0,48,40,40
1683307943083,COGS 153,A00,184961,Staff,0,15,30,30
1683307944108,COGS 177,A00,184962,Staff,0,21,30,30
1683307945135,COGS 187A,A01,184969,Boyle; Mary E. T.,0,17,40,40
1683307946161,COMM 10,A01,185174,Staff,0,5,25,25
1683307946161,COMM 10,A02,185189,Staff,0,5,25,25
1683307946161,COMM 10,A03,269821,Staff,0,0,0,0
1683307947187,COMM 100B,A01,185475,Staff,0,0,0,2
1683307947187,COMM 100B,A02,185476,Staff,14,0,25,11
1683307948211,COMM 100C,A01,185314,Staff,1,0,25,24
1683307948211,COMM 100C,A02,185327,Staff,19,0,25,6
1683307949235,COMM 110M,A00,185349,Staff,2,0,40,38
1683307950263,COMM 113T,A00,185352,Staff,25,0,40,15
1683307951287,COMM 114I,A00,185353,Staff,33,0,40,7
1683307952312,COMM 131,A00,185354,Staff,19,0,30,11
1683307953336,CSE 8A,A50,185358,Cao; Yingjun,0,46,10,10
1683307954364,CSE 8B,A01,185362,Staff,1,47,50,49
1683307955393,CSE 11,A01,185416,Cao; Yingjun,0,93,10,10
1683307956420,CSE 20,A01,185445,Briones; Jor-el Thomas Caparas,5,0,25,20
1683307957444,CSE 21,A01,185447,Staff,10,0,50,40
1683307958472,CSE 101,A01,185451,Staff,0,12,50,50
1683307958472,CSE 101,B01,185453,Jones; Miles E,0,11,50,50
1683307960525,CSE 141,A01,185458,Eldon; John,20,0,100,80
1683307961549,CSE 141L,A01,185461,Eldon; John,12,0,100,88
1683307962577,CSE 142,A01,185463,Staff,35,0,60,25
1683307962577,CSE 142,B01,201355,Staff,0,6,60,60
1683307963604,CSE 142L,A01,185470,Staff,35,0,60,25
1683307963604,CSE 142L,B01,201417,Staff,0,5,60,60
1683307964629,CSE 190,A00,201433,Staff,32,0,49,17
1683307965658,DOC 1,A01,259136,Strom; Megan C.,8,0,15,7
1683307965658,DOC 1,A02,259137,Strom; Megan C.,14,0,15,1
1683307965658,DOC 1,A03,259138,Strom; Megan C.,14,0,15,1
1683307965658,DOC 1,A04,259139,Strom; Megan C.,14,0,15,1
1683307966687,DOC 100D,A00,259140,Pass; Natalye Joann,17,0,25,8
1683307967767,DSGN 1,A01,184749,Rill; Bryan,0,24,30,30
1683307968792,DSGN 100,A01,185168,Staff,0,2,25,25
1683307969820,ECE 5,A01,185626,Morris; Karcher William,0,10,0,0
1683307970847,ECE 101,A01,185628,Staff,17,0,70,53
1683307971871,ECE 107,A01,185635,Baghdadchi; Saharnaz,0,0,20,20
1683307971871,ECE 107,A02,185638,Baghdadchi; Saharnaz,4,0,20,16
1683307972899,ECE 148,A01,185647,Silberman; Jack,0,0,16,16
1683307973923,ECON 1,A01,185537,Crane; Meredith Helen,54,0,70,16
1683307974947,ECON 3,A01,185549,Crane; Meredith Helen,33,0,70,37
1683307975972,ECON 4,A01,203354,Anderson; John Charles,0,4,10,10
1683307976999,ECON 100A,A01,185574,Staff,0,4,40,40
1683307978024,ECON 100B,A01,185576,Staff,0,22,40,40
1683307979049,ECON 100C,A01,185589,Newhouse; Herbert S,30,0,70,40
1683307980074,ECON 105,A00,185608,Vespa; Emanuel Ignacio,19,0,35,16
1683307981100,ECON 109,A01,185610,Shishkin; Denis,10,0,35,25
1683307982126,ECON 110A,A01,185612,Staff,11,0,40,29
1683307983150,ECON 120A,A01,185615,Staff,20,0,40,20
1683307984178,ECON 120C,A01,185617,Sun; Yixiao,0,20,70,70
1683307985205,ECON 144,A00,203346,Squires; Dale E,3,0,35,32
1683307986232,ECON 171,A01,203349,Newhouse; Herbert S,0,1,35,35
1683307987260,ECON 173A,A01,185621,Toda; Alexis Akira,21,0,35,14
1683307988291,EDS 25,A01,202413,Staff,0,1,0,0
1683307988291,EDS 25,A02,202414,Staff,0,1,0,0
1683307988291,EDS 25,A03,202415,Staff,0,0,0,0
1683307988291,EDS 25,A04,202416,Staff,0,1,0,0
1683307988291,EDS 25,A05,202439,Staff,0,0,0,0
1683307988291,EDS 25,A06,202440,Staff,0,0,0,0
1683307988291,EDS 25,B01,202631,Staff,0,0,0,0
1683307988291,EDS 25,B02,202632,Staff,0,0,0,0
1683307988291,EDS 25,B03,202639,Staff,0,0,0,0
1683307988291,EDS 25,B04,202640,Staff,0,0,0,0
1683307988291,EDS 25,B05,202643,Staff,0,0,0,0
1683307988291,EDS 25,B06,202644,Staff,0,0,0,0
1683307989319,EDS 38,A01,202659,Black; Alison Michelle,24,0,25,1
1683307990342,EDS 115,A00,202652,Staff,17,0,30,13
1683307991367,EDS 125,A00,202649,Staff,14,0,30,16
1683307992391,EDS 126,A01,203332,Staff,30,0,30,0
1683307993417,EDS 139,A00,202838,Staff,17,0,25,8
1683307994444,EDS 146,A01,202655,Staff,15,0,25,10
1683307995472,ENG 15,A00,185667,Staff,0,1,0,0
1683307995472,ENG 15,B00,185672,Staff,0,0,0,0
1683307995472,ENG 15,C00,185675,Staff,0,0,0,0
1683307995472,ENG 15,D00,185682,Staff,0,0,0,0
1683307995472,ENG 15,E00,185684,Staff,0,0,0,0
1683307996497,ETHN 103,A00,185710,Staff,0,3,35,35
1683307997522,ETHN 103A,A00,199228,Man; Simeon S,2,0,9,7
1683307998545,ETHN 109,A00,185711,Staff,18,0,35,17
1683307999569,ETHN 142,A00,185726,Staff,0,4,30,30
1683308000594,ETHN 163J,A00,199229,Man; Simeon S,6,0,8,2
1683308001618,ETHN 168,A00,185727,Staff,8,0,10,2
1683308002642,ETHN 182,A00,185728,Staff,1,0,35,34
1683308003666,ETHN 183,A00,185737,Staff,8,0,18,10
1683308004690,GLBH 111,A01,209361,Burgos; Jose L.,0,0,0,0
1683308006739,HIEU 104,A00,185792,Staff,16,0,20,4
1683308007765,HIEU 115,A00,185800,Staff,1,0,20,19
1683308008792,HIEU 128,A00,185801,Staff,0,7,20,20
1683308009818,HIEU 147,A00,185802,Staff,16,0,20,4
1683308010846,HIEU 154,A00,185823,Staff,12,0,20,8
1683308011870,HILA 102,A00,185826,Staff,13,0,20,7
1683308012897,HILD 2C,A01,185778,Staff,0,12,20,20
1683308013925,HILD 7B,A01,185780,Kwak; Nancy,0,15,32,32
1683308013925,HILD 7B,A02,185781,Kwak; Nancy,0,18,32,32
1683308014954,HILD 30,A01,185791,Staff,14,0,20,6
1683308015977,HISC 119,A00,185830,Golan; Tal,0,9,20,20
1683308017001,HITO 156GS,A00,185831,Patterson; Patrick H.,0,0,0,23
1683308018025,HIUS 103,A00,185832,Man; Simeon S,0,6,20,20
1683308019049,HIUS 117,A00,185836,Kwak; Nancy,2,0,20,18
1683308020077,HIUS 125,A00,185840,Man; Simeon S,0,0,23,23
1683308021101,HIUS 149,A00,185845,Staff,0,0,20,20
1683308022126,HUM 3,A01,185882,Zavodny; Tatiana Sophia,0,6,50,50
1683308022126,HUM 3,B01,185899,Caldwell; Michael Alan,0,19,50,50
1683308023151,HUM 3GS,A00,185900,Patterson; Patrick H.,0,0,0,23
1683308024176,HUM 4,A01,185938,Zroka; Amy Liane,31,0,50,19
1683308024176,HUM 4,B01,185956,Watkins; Eric,0,2,50,50
1683308024176,HUM 4,B02,202209,Watkins; Eric,0,2,50,50
1683308024176,HUM 4,B03,202210,Watkins; Eric,0,0,50,50
1683308025201,HUM 5,A01,185958,West; Geoffrey Scott,4,0,50,46
1683308025201,HUM 5,A02,202215,West; Geoffrey Scott,0,0,50,50
1683308026226,INTL 190,A00,185959,Gagnon; Jeffrey C,0,0,0,9
1683308026226,INTL 190,B00,185960,Lettieri; Michael Joseph,0,0,0,1
1683308027253,JAPN 180,A00,254509,Staff,5,1,30,25
1683308028277,LATI 10,A01,202853,Kennemore; Amy Michelle,5,0,35,30
1683308028277,LATI 10,A02,202854,Kennemore; Amy Michelle,1,0,35,34
1683308028277,LATI 10,A03,270054,Kennemore; Amy Michelle,30,0,30,0
1683308029306,LATI 180,A00,202855,Kennemore; Amy Michelle,11,0,20,9
1683308030333,LAWS 101,A00,201767,Golan; Tal,0,7,40,40
1683308031358,LIFR 1C,A00,185961,Staff,6,0,20,14
1683308032382,LIFR 1CX,A00,185962,Staff,7,0,20,13
1683308033409,LIFR 1D,A00,185963,Staff,9,0,20,11
1683308034433,LIFR 1DX,A00,185964,Staff,9,0,20,11
1683308035458,LIGN 101,A01,186039,Staff,43,0,50,7
1683308036481,LIGN 165,A00,186040,Staff,18,0,50,32
1683308037509,LTCS 108,A00,186041,Staff,6,0,10,4
1683308038534,LTCS 119,A00,186042,Staff,16,0,20,4
1683308039562,LTCS 130,A00,186043,Wesling; Megan E.,15,0,25,10
1683308041612,LTEA 138,A00,186119,Staff,14,0,40,26
1683308042636,LTEN 124,A00,186148,Staff,6,0,25,19
1683308043660,LTEN 178,A00,186149,Staff,7,0,15,8
1683308044687,LTEN 181,A00,186150,Blanco; John D,33,0,40,7
1683308045713,LTWL 120,A00,186160,Staff,20,0,25,5
1683308046735,LTWL 165,A00,186161,Staff,22,0,25,3
1683308047762,LTWR 100,A00,186162,Staff,0,4,15,15
1683308048784,LTWR 102,A00,186163,Doller; Ben,5,0,15,10
1683308049809,MAE 8,A01,186412,Staff,0,0,0,0
1683308050833,MAE 30B,A00,186445,Bahadori; Mohammad Yousef,83,0,100,17
1683308051860,MAE 40,A00,186592,Bewley; Thomas R,9,0,50,41
1683308052885,MAE 101B,A00,186593,Bahadori; Mohammad Yousef,81,0,100,19
1683308053912,MAE 105,A00,186594,Bandaru; Prabhakar,12,0,50,38
1683308054937,MAE 107,A00,186599,Pham; Hieu Tan,0,6,120,120
1683308055962,MAE 148,A01,186660,Silberman; Jack,3,0,16,13
1683308056990,MATH 10A,A01,188095,Staff,0,7,35,35
1683308058015,MATH 10B,A01,188097,Bowers; Adam R.,0,11,30,30
1683308058015,MATH 10B,A02,188099,Bowers; Adam R.,0,9,30,30
1683308058015,MATH 10B,B01,188104,Bowers; Adam R.,0,11,30,30
1683308058015,MATH 10B,B02,188106,Bowers; Adam R.,0,11,30,30
1683308059044,MATH 10C,A01,188111,Staff,0,18,30,30
1683308059044,MATH 10C,A02,188127,Staff,0,17,30,30
1683308059044,MATH 10C,A03,188131,Staff,0,17,30,30
1683308059044,MATH 10C,B01,188218,Staff,21,0,30,9
1683308059044,MATH 10C,B02,188244,Staff,13,0,30,17
1683308059044,MATH 10C,B03,188277,Staff,16,0,30,14
1683308060072,MATH 18,A01,188344,Bach; Quang Tran,18,0,30,12
1683308060072,MATH 18,A02,188345,Bach; Quang Tran,11,0,30,19
1683308060072,MATH 18,B01,188353,Bach; Quang Tran,10,0,30,20
1683308060072,MATH 18,B02,188354,Bach; Quang Tran,20,0,30,10
1683308061097,MATH 20A,A01,188374,Staff,13,0,35,22
1683308062120,MATH 20B,A01,188382,Ohm; Ko Woon,6,0,30,24
1683308062120,MATH 20B,A02,188383,Ohm; Ko Woon,23,0,30,7
1683308062120,MATH 20B,B01,188385,Ohm; Ko Woon,7,0,30,23
1683308062120,MATH 20B,B02,188392,Ohm; Ko Woon,22,0,30,8
1683308063154,MATH 20C,A01,188394,Harel; Guershon,10,0,30,20
1683308063154,MATH 20C,A02,188395,Harel; Guershon,13,0,30,17
1683308063154,MATH 20C,B01,188404,Harel; Guershon,3,0,30,27
1683308063154,MATH 20C,B02,188405,Harel; Guershon,19,0,30,11
1683308064180,MATH 20D,A01,188414,Hammock; Frances H,0,1,30,30
1683308064180,MATH 20D,A02,188415,Hammock; Frances H,4,0,30,26
1683308064180,MATH 20D,B01,188447,Hammock; Frances H,2,0,30,28
1683308064180,MATH 20D,B02,188486,Hammock; Frances H,8,0,30,22
1683308065203,MATH 20E,A01,188649,Staff,22,0,30,8
1683308065203,MATH 20E,A02,188650,Staff,23,0,30,7
1683308065203,MATH 20E,A03,188673,Staff,0,0,30,30
1683308066227,MATH 102,A01,188675,Staff,0,35,35,35
1683308067252,MATH 103B,A01,188681,Staff,4,0,35,31
1683308067252,MATH 103B,B01,188692,Staff,7,0,35,28
1683308068279,MATH 109,A01,188695,Salehi Golsefidy; Alireza,25,0,35,10
1683308068279,MATH 109,A02,188696,Salehi Golsefidy; Alireza,27,0,35,8
1683308069303,MATH 120A,A01,188698,Eggers; John Dietrich,6,0,35,29
1683308070328,MATH 142B,A01,188736,Ioana; Adrian,0,2,30,30
1683308070328,MATH 142B,A02,188741,Ioana; Adrian,0,1,30,30
1683308070328,MATH 142B,A03,188743,Ioana; Adrian,0,3,30,30
1683308071406,MATH 168A,A01,188790,Staff,0,9,35,35
1683308072431,MATH 170A,A01,188803,Nie; Jiawang,0,2,35,35
1683308072431,MATH 170A,A02,188811,Nie; Jiawang,0,0,35,35
1683308072431,MATH 170A,A03,188814,Nie; Jiawang,1,0,35,34
1683308072431,MATH 170A,A04,188815,Nie; Jiawang,13,0,35,22
1683308073458,MATH 193B,A01,188817,Staff,0,0,35,35
1683308073458,MATH 193B,A02,188818,Staff,5,0,35,30
1683308074481,MGT 4,A01,202857,Anderson; John Charles,62,0,80,18
1683308075502,MGT 12,A00,202858,Lindenberger; Wade Douglas,43,0,90,47
1683308076529,MGT 18,A00,202859,Staff,74,0,90,16
1683308077555,MGT 18GS,A00,202860,McKay; Michael J,13,0,28,15
1683308078582,MGT 45,A00,202861,Pecore; Joseph P.,14,0,90,76
1683308079606,MGT 100,A00,202863,Yavorsky; Daniel Ryan,28,0,90,62
1683308080633,MGT 103,A00,202864,Ehrich; Kristine R,0,16,90,90
1683308081657,MGT 112,A00,202865,Ehrich; Kristine R,15,0,90,75
1683308082685,MGT 121A,A00,202868,Staff,0,19,0,0
1683308083715,MGT 131B,A00,202869,Anderson; John Charles,59,0,90,31
1683308084739,MGT 136,A00,202871,Lindenberger; Wade Douglas,84,0,90,6
1683308085764,MGT 164,A00,202873,Staff,0,69,90,90
1683308086790,MGT 164GS,A00,202874,McKay; Mary A,13,0,28,15
1683308087813,MGT 180,A00,202875,Staff,0,51,90,90
1683308088841,MMW 11R,A01,205019,Herbst; Matthew,3,0,30,27
1683308088841,MMW 11R,A02,205026,Herbst; Matthew,29,0,30,1
1683308089867,MMW 15,A01,193512,Chang; Edmond Yi-Teh,0,9,28,28
1683308089867,MMW 15,A02,193513,Chang; Edmond Yi-Teh,0,5,28,28
1683308089867,MMW 15,A03,193514,Chang; Edmond Yi-Teh,0,5,28,28
1683308089867,MMW 15,A04,193515,Chang; Edmond Yi-Teh,0,5,28,28
1683308089867,MMW 15,A05,193516,Chang; Edmond Yi-Teh,0,4,28,28
1683308089867,MMW 15,A06,193517,Chang; Edmond Yi-Teh,0,5,28,28
1683308089867,MMW 15,B01,193519,Chang; Edmond Yi-Teh,0,4,28,28
1683308089867,MMW 15,B02,193520,Chang; Edmond Yi-Teh,0,5,28,28
1683308089867,MMW 15,B03,193521,Chang; Edmond Yi-Teh,0,4,28,28
1683308089867,MMW 15,B04,193522,Chang; Edmond Yi-Teh,0,4,28,28
1683308089867,MMW 15,B05,193523,Chang; Edmond Yi-Teh,0,5,28,28
1683308089867,MMW 15,B06,193524,Chang; Edmond Yi-Teh,0,4,28,28
1683308090890,MMW 122,A01,193526,Rahimi; Babak,0,14,28,28
1683308090890,MMW 122,A02,193527,Rahimi; Babak,0,14,28,28
1683308090890,MMW 122,A03,193528,Rahimi; Babak,0,0,0,0
1683308090890,MMW 122,A04,193529,Rahimi; Babak,0,0,0,0
1683308091914,MUS 1A,A01,186663,Staff,0,20,35,35
1683308092941,MUS 4,A01,186715,Staff,0,12,35,35
1683308093965,MUS 5R,A01,186796,Dubnov; Shlomo,0,17,35,35
1683308094995,MUS 6,A01,186798,Staff,0,3,25,25
1683308096023,MUS 7,A01,186830,Staff,12,0,35,23
1683308097047,MUS 8,A01,186930,Staff,0,26,35,35
1683308098075,MUS 15,A01,186932,Staff,0,15,35,35
1683308098075,MUS 15,B01,186934,Staff,0,15,35,35
1683308099099,MUS 80,A00,186935,Staff,2,0,20,18
1683308099099,MUS 80,B00,186936,Staff,25,0,25,0
1683308100127,NANO 11,A00,204702,Lipomi; Darren John,0,0,0,0
1683308101152,NANO 15,A01,204709,Yang; Kesong,0,1,0,0
1683308102179,NANO 114,A00,202069,Jahed Motlagh; Zeinab,3,0,10,7
1683308103203,PHIL 1,A00,186955,Grush; Rick Scott,32,0,40,8
1683308104227,PHIL 10,A01,186973,Grush; Rick Scott,28,0,35,7
1683308104227,PHIL 10,A02,186974,Grush; Rick Scott,33,0,35,2
1683308105251,PHIL 13,A01,186976,Staff,7,0,35,28
1683308105251,PHIL 13,A02,186977,Staff,16,0,35,19
1683308106276,PHIL 14,A01,186979,Staff,31,0,35,4
1683308106276,PHIL 14,A02,186986,Staff,32,0,35,3
1683308107302,PHIL 28,A01,186988,Staff,16,0,30,14
1683308107302,PHIL 28,A02,186989,Staff,1,0,30,29
1683308107302,PHIL 28,A03,186990,Staff,9,0,30,21
1683308107302,PHIL 28,A04,186991,Staff,26,0,30,4
1683308108328,PHIL 120,A00,186997,Staff,23,0,40,17
1683308109352,PHIL 137,A00,187003,Staff,9,0,40,31
1683308110379,PHIL 150,A00,187015,Staff,47,0,70,23
1683308111404,PHIL 167,A00,187021,Lamey; Andy M.,35,0,40,5
1683308112426,PHIL 174,A01,202226,Staff,17,0,20,3
1683308112426,PHIL 174,A02,202235,Staff,20,0,20,0
1683308113450,PHIL 191A,A00,258918,Staff,0,0,1,1
1683308114475,PHYS 1A,A00,187028,Staff,27,0,60,33
1683308115499,PHYS 1AL,001,187036,Staff,3,0,30,27
1683308115499,PHYS 1AL,002,187049,Staff,18,0,30,12
1683308116525,PHYS 1B,A00,187058,Staff,23,0,60,37
1683308117551,PHYS 1BL,001,187064,Staff,0,0,30,30
1683308117551,PHYS 1BL,002,187070,Staff,6,0,30,24
1683308118575,PHYS 1C,A00,187082,Staff,31,0,120,89
1683308119599,PHYS 1CL,001,187088,Staff,0,9,30,30
1683308119599,PHYS 1CL,002,187089,Staff,0,2,30,30
1683308119599,PHYS 1CL,009,262693,Staff,11,0,30,19
1683308120626,PHYS 2B,A01,187097,Staff,54,0,115,61
1683308121650,PHYS 2C,A01,187099,Staff,67,0,115,48
1683308122675,PHYS 2CL,A01,187101,Staff,5,0,28,23
1683308122675,PHYS 2CL,A02,187102,Staff,15,0,28,13
1683308123702,PHYS 2D,A01,187123,Shotwell; Brian,95,0,115,20
1683308124727,PHYS 4B,A01,187133,Grinstein; Benjamin,35,0,50,15
1683308125756,POLI 10,A00,188819,Staff,0,3,50,50
1683308126782,POLI 11,A00,188827,Staff,43,0,50,7
1683308127804,POLI 13R,A00,188828,Staff,0,1,20,20
1683308128828,POLI 27,A01,188830,Elgin; Samuel Zincke,0,1,70,70
1683308129855,POLI 30,A00,188832,Desposato; Scott,33,0,50,17
1683308130881,POLI 102F,A00,188834,Staff,3,0,40,37
1683308131908,POLI 104A,A00,188852,Staff,14,0,30,16
1683308132932,POLI 104I,A00,188853,Staff,0,6,20,20
1683308133955,POLI 110B,A00,188854,Wiens; David,7,0,20,13
1683308135002,POLI 112A,A00,188855,Wiens; David,5,0,30,25
1683308136026,POLI 117R,A00,188856,Forman; Fonna,0,11,20,20
1683308137050,POLI 118,A00,188857,Ingham; Sean,8,0,20,12
1683308138073,POLI 120G,A00,188858,Staff,9,0,30,21
1683308139100,POLI 131CR,A00,188863,Hoston; Germaine,24,0,50,26
1683308140130,POLI 133,A00,188864,Nellis; Gareth Hb,44,0,50,6
1683308141153,POLI 134D,A00,188865,Desposato; Scott,27,0,30,3
1683308142177,POLI 142A,A00,188871,Gartzke; Erik,22,0,50,28
1683308143201,POLI 142K,A00,188874,Staff,38,0,50,12
1683308144228,POLI 143,A00,188940,Gartzke; Erik,16,0,30,14
1683308145251,POLI 153,A00,188943,Staff,3,0,20,17
1683308146273,POLI 160AA,A00,188944,Staff,13,0,40,27
1683308147297,POLI 170A,A00,188945,Staff,11,0,30,19
1683308149349,PSYC 1,A00,188952,Staff,38,0,90,52
1683308150373,PSYC 2,B00,188953,Staff,20,0,35,15
1683308151400,PSYC 6,A00,188970,Staff,47,0,60,13
1683308152424,PSYC 7,A00,188973,Staff,37,0,45,8
1683308153451,PSYC 60,A01,188980,Rickard; Timothy C.,43,0,60,17
1683308154475,PSYC 70,A01,189001,Steiner; Eric Tomas,24,0,45,21
1683308155503,PSYC 100,A00,189005,Lacefield; Katharine I,0,99,120,120
1683308156530,PSYC 102,A00,189008,Staff,10,0,30,20
1683308157555,PSYC 106,B00,189026,Gorman; Michael R.,37,0,60,23
1683308158578,PSYC 114,B01,189033,Winkielman; Piotr,0,32,30,30
1683308159601,PSYC 131,A00,189036,Anagnostaras; Stephan,0,43,60,60
1683308160629,PSYC 136,A00,189041,Lowe; Angela Beth,0,7,25,25
1683308161653,PSYC 137,A00,189057,Winkielman; Piotr,0,34,25,25
1683308162676,PSYC 144,A00,189107,Wixted; John T,0,7,50,50
1683308164724,PSYC 162,A00,189142,Staff,0,8,85,85
1683308165752,PSYC 172,A00,189144,Gorman; Michael R.,0,7,30,30
1683308167802,PSYC 179,A00,189146,Lacefield; Katharine I,0,84,120,120
1683308168829,PSYC 181,A00,189147,Anagnostaras; Stephan,0,44,90,90
1683308169856,PSYC 190R,A00,189148,Barner; David A.,0,22,80,80
1683308170881,PSYC 191,A00,189275,Rickard; Timothy C.,0,7,25,25
1683308171909,PSYC 193,A00,189276,Chapman; Eddie Nathaniel,0,1,0,4
1683308172937,PSYC 193L,A01,189281,Lowe; Angela Beth,12,0,20,8
1683308172937,PSYC 193L,B01,189285,Staff,28,0,35,7
1683308173966,RELI 149,A00,187137,Rahimi; Babak,7,0,40,33
1683308175058,SE 9,A01,187315,Staff,0,2,18,18
1683308176082,SE 101B,A00,187409,Staff,24,0,30,6
1683308177107,SE 110B,A00,187444,Staff,10,0,40,30
1683308178132,SE 130B,A00,187449,Staff,31,0,40,9
1683308179157,SE 150A,A00,187516,Staff,9,0,20,11
1683308180183,SE 154,A00,187528,Staff,30,0,50,20
1683308181207,SIO 3,A01,258171,Staff,35,0,40,5
1683308182231,SIO 10,A00,187144,Cook; Geoffrey W,0,3,75,75
1683308183256,SIO 45,A00,187152,Cook; Geoffrey W,1,0,100,99
1683308184280,SIO 109R,A00,194486,Staff,0,3,20,20
1683308186331,SIO 187,A01,187233,Kacev; David,12,0,40,28
1683308187355,SOCI 1,A01,258656,Thorpe; Charles Robert,28,0,30,2
1683308187355,SOCI 1,A02,258658,Thorpe; Charles Robert,30,0,30,0
1683308187355,SOCI 1,A03,258661,Thorpe; Charles Robert,25,0,25,0
1683308187355,SOCI 1,A04,258666,Thorpe; Charles Robert,22,0,25,3
1683308187355,SOCI 1,A05,258897,Thorpe; Charles Robert,23,0,25,2
1683308187355,SOCI 1,A06,258898,Thorpe; Charles Robert,25,0,25,0
1683308188382,SOCI 30,A01,258903,Pardo Guerra; Juan Pablo,16,0,30,14
1683308189406,SOCI 102,A00,258904,Staff,9,0,25,16
1683308190431,SOCI 106,A00,258905,Staff,19,0,25,6
1683308191454,SOCI 111,A00,258907,Ribas Norris; Janet Vanesa,26,0,30,4
1683308192478,SOCI 121R,A00,258908,Pardo Guerra; Juan Pablo,11,0,30,19
1683308193502,SOCI 126,A01,203330,Staff,14,0,20,6
1683308194532,SOCI 131,A00,258909,Thorpe; Charles Robert,31,0,60,29
1683308195557,SOCI 135,A00,258910,Payne; Christine Anna,0,9,30,30
1683308196585,SOCI 157,A00,258911,Staff,13,0,30,17
1683308197608,SOCI 184,A00,258912,Staff,26,0,30,4
1683308198633,SOCI 188D,A00,258913,Staff,21,0,30,9
1683308199658,SYN 2,001,187529,Staff,9,0,16,7
1683308199658,SYN 2,002,201452,Staff,0,18,16,16
1683308199658,SYN 2,003,201469,Staff,3,0,16,13
1683308200685,SYN 100,A01,187531,Staff,0,9,20,20
1683308200685,SYN 100,B01,201491,Staff,0,12,20,20
1683308201714,TDAC 1,A00,189286,Walsh; Kim C.,3,0,20,17
1683308201714,TDAC 1,B00,189287,Harting; Carla Kelso,11,0,20,9
1683308202744,TDAC 101,A00,189300,Walsh; Kim C.,16,0,20,4
1683308202744,TDAC 101,B00,189301,Harting; Carla Kelso,18,0,20,2
1683308203771,TDAC 102,A00,189304,Basso; Beatrice,14,0,20,6
1683308204797,TDAC 108,A00,189305,Staff,18,0,20,2
1683308205826,TDDE 131,A00,189310,Staff,19,0,20,1
1683308205826,TDDE 131,B00,189314,Staff,19,0,20,1
1683308205826,TDDE 131,C00,189315,Staff,48,0,50,2
1683308205826,TDDE 131,D00,189316,Staff,14,0,15,1
1683308205826,TDDE 131,E00,204841,Staff,20,0,20,0
1683308206850,TDGE 10,A00,189289,Staff,30,0,50,20
1683308206850,TDGE 10,B00,189290,Havis; Allan,2,0,50,48
1683308207874,TDGE 11,A00,189291,Fulton; Julia,0,3,50,50
1683308207874,TDGE 11,B00,189292,Staff,20,0,25,5
1683308207874,TDGE 11,C00,260270,Staff,0,0,0,0
1683308208900,TDGE 25,A00,189294,Staff,3,0,20,17
1683308209924,TDGE 124,A00,189318,Fulton; Julia,0,8,50,50
1683308210949,TDGE 125,A00,189319,Staff,13,0,25,12
1683308210949,TDGE 125,B00,189320,Staff,23,0,25,2
1683308211973,TDGE 127,A00,189322,Havis; Allan,0,0,50,50
1683308212997,TDHT 101,A00,189323,Staff,18,0,25,7
1683308212997,TDHT 101,B00,189324,Staff,25,0,25,0
1683308214022,TDHT 102,A00,189325,Staff,49,0,50,1
1683308215046,TDMV 1,A00,189295,Arcidiacono; Kristin,20,0,30,10
1683308215046,TDMV 1,B00,189296,Caligagan; Maria T.,24,0,30,6
1683308216074,TDMV 2,A00,189297,Sammartano; Tonnie,28,0,30,2
1683308216074,TDMV 2,B00,189299,Arcidiacono; Kristin,24,0,30,6
1683308217103,TDMV 3,A00,204998,Rincon; Alicia,22,0,30,8
1683308218126,TDMV 120,A00,189458,Sammartano; Tonnie,28,0,30,2
1683308219150,TDMV 138,A00,189541,Jun; Grace Shin Hae,22,0,40,18
1683308220179,TDMV 142,A00,189717,Caligagan; Tony,23,0,30,7
1683308220179,TDMV 142,B00,189718,Caligagan; Maria T.,25,0,30,5
1683308221206,TMC 2,A01,187533,Staff,25,0,25,0
1683308221206,TMC 2,A02,187534,Staff,25,0,25,0
1683308222233,USP 1,A01,187536,Kwak; Nancy,0,16,25,25
1683308223257,USP 5,A01,187538,Staff,9,0,25,16
1683308224285,USP 101,A00,199253,Staff,0,4,0,0
1683308225309,USP 124,A00,187562,Boomhower; Matthew Charles,1,0,30,29
1683308226336,USP 138,A00,187582,Staff,20,0,25,5
1683308227363,USP 152,A01,187597,Staff,4,0,25,21
1683308228390,USP 153,A00,187598,Staff,19,0,25,6
1683308229414,USP 168,A00,187607,Kwak; Nancy,2,0,5,3
1683308230438,USP 173,A00,187619,Staff,4,0,25,21
1683308231462,USP 181,A00,187638,Staff,0,0,25,25
1683308232486,VIS 103,A00,187650,Cruz; Edwin Teddy,23,0,75,52
1683308233513,VIS 110D,A00,187669,Staff,12,0,22,10
1683308234540,VIS 127C,A00,187720,Shen; Kuiyi,68,0,146,78
1683308235564,VIS 149,A00,187731,Yoldas; Pinar,0,14,22,22
1683308236588,VIS 151,A01,188091,Staff,22,0,34,12
1683308236588,VIS 151,A02,188092,Staff,11,0,34,23
1683308237615,VIS 160B,A00,188093,Stalbaum; Brett,0,0,10,10
1683308239663,WCWP 10B,A00,201720,Staff,10,0,15,5
1683308239663,WCWP 10B,B00,201722,Staff,8,0,15,7
1683308240687,WCWP 100,A00,201725,Gagnon; Jeffrey C,0,0,2,2
1683308240687,WCWP 100,B00,201727,Staff,0,4,15,15
1683308243811,ANBI 133,A00,258401,Wilder; Linnea Lorene,34,0,40,6
1683308244836,ANBI 140,A00,258395,Hrvoj Mihic; Branka,18,0,25,7
1683308245860,ANSC 120,A00,258402,Bialecki; Jon Anthony,27,0,40,13
1683308246886,ANSC 144,A00,258400,Staff,14,0,40,26
1683308248937,ANSC 166,A00,258396,Parish; Steven Martin,157,0,175,18
1683308249962,ANSC 180,A00,193533,Staff,9,0,20,11
1683308250986,ANSC 188,A00,258397,Jassal; Aftab,33,0,40,7
1683308252011,ANTH 3,A01,258316,Staff,23,0,30,7
1683308253033,ANTH 5,A00,258394,Semendeferi; Ekaterini,16,0,20,4
1683308254060,ANTH 21,A01,258331,Staff,9,0,40,31
1683308255089,ANTH 103,A00,258398,Varma; Saiba,15,0,25,10
1683308256115,AWP 10,001,202034,Staff,0,0,0,0
1683308256115,AWP 10,002,202035,Staff,0,0,0,0
1683308256115,AWP 10,003,202036,Staff,0,0,0,0
1683308256115,AWP 10,004,202037,Staff,0,0,0,0
1683308256115,AWP 10,005,202038,Staff,0,0,0,0
1683308256115,AWP 10,006,202039,Staff,0,0,0,0
1683308256115,AWP 10,007,202040,Staff,0,0,0,0
1683308256115,AWP 10,008,202041,Staff,0,0,0,0
1683308256115,AWP 10,009,202042,Staff,0,0,0,0
1683308256115,AWP 10,010,202043,Staff,0,0,0,0
1683308256115,AWP 10,011,202044,Staff,0,0,0,0
1683308256115,AWP 10,012,202045,Staff,0,0,0,0
1683308256115,AWP 10,013,202046,Staff,0,0,0,0
1683308256115,AWP 10,014,202047,Staff,0,0,0,0
1683308256115,AWP 10,015,202048,Staff,0,0,0,0
1683308256115,AWP 10,016,202049,Staff,0,0,0,0
1683308256115,AWP 10,017,202050,Staff,0,0,0,0
1683308256115,AWP 10,018,202051,Staff,0,0,0,0
1683308256115,AWP 10,019,202052,Staff,0,0,0,0
1683308256115,AWP 10,020,202053,Staff,0,0,0,0
1683308256115,AWP 10,021,202054,Staff,0,0,0,0
1683308256115,AWP 10,022,202055,Staff,0,0,0,0
1683308256115,AWP 10,023,202056,Staff,0,0,0,0
1683308256115,AWP 10,024,202057,Staff,0,0,0,0
1683308256115,AWP 10,025,202058,Staff,0,0,0,0
1683308256115,AWP 10,026,202059,Staff,0,0,0,0
1683308257139,AWP 102,001,202032,Staff,0,0,0,0
1683308257139,AWP 102,002,202033,Staff,0,0,0,0
1683308258163,BENG 100,A01,254234,Taylor Amos; Alyssa C,31,0,40,9
1683308259187,BENG 196,001,270013,Engler; Adam J.,9999,0,9999,0
1683308260214,BICD 100R,A01,202018,Smith; Laurie,0,7,32,32
1683308260214,BICD 100R,A02,202019,Smith; Laurie,0,2,32,32
1683308260214,BICD 100R,A03,202020,Smith; Laurie,0,1,32,32
1683308260214,BICD 100R,A04,202021,Smith; Laurie,8,0,32,24
1683308260214,BICD 100R,A05,202022,Smith; Laurie,12,0,32,20
1683308261242,BICD 136,A01,193242,Gustafson-Brown; Cindy,0,2,32,32
1683308261242,BICD 136,A02,193244,Gustafson-Brown; Cindy,15,0,32,17
1683308262266,BIEB 102,A01,193249,Butler; Shannon Rhey,0,2,32,32
1683308262266,BIEB 102,A02,193251,Butler; Shannon Rhey,0,0,32,32
1683308262266,BIEB 102,A03,193253,Butler; Shannon Rhey,0,1,32,32
1683308262266,BIEB 102,A04,193255,Butler; Shannon Rhey,17,0,32,15
1683308262266,BIEB 102,A05,193265,Butler; Shannon Rhey,26,0,32,6
1683308262266,BIEB 102,A06,193269,Butler; Shannon Rhey,16,0,32,16
1683308264319,BIEB 150,A01,193274,Staff,0,0,32,32
1683308264319,BIEB 150,A02,193285,Staff,24,0,32,8
1683308265343,BIEB 194,A00,193286,Kurle; Carolyn M.,22,0,32,10
1683308266366,BILD 1,A01,192291,Staff,16,0,32,16
1683308266366,BILD 1,A02,192292,Staff,30,0,32,2
1683308266366,BILD 1,B01,192520,Reuther; Keefe,0,1,0,0
1683308266366,BILD 1,B02,192532,Reuther; Keefe,0,1,0,0
1683308267391,BILD 3,A01,192556,Butler; Shannon Rhey,0,0,32,32
1683308267391,BILD 3,A02,192581,Butler; Shannon Rhey,5,0,32,27
1683308267391,BILD 3,A03,192611,Butler; Shannon Rhey,23,0,32,9
1683308267391,BILD 3,A04,192612,Butler; Shannon Rhey,25,0,32,7
1683308267391,BILD 3,A05,192613,Butler; Shannon Rhey,27,0,32,5
1683308267391,BILD 3,A06,192679,Butler; Shannon Rhey,27,0,32,5
1683308267391,BILD 3,A07,192682,Butler; Shannon Rhey,22,0,32,10
1683308268414,BILD 4,A01,192836,Reuther; Keefe,1,0,24,23
1683308268414,BILD 4,A02,193044,Reuther; Keefe,4,0,24,20
1683308269437,BILD 10,A01,193142,Gustafson-Brown; Cindy,31,0,32,1
1683308269437,BILD 10,A02,193149,Gustafson-Brown; Cindy,31,0,32,1
1683308270466,BIMM 100,A01,193301,Staff,0,6,32,32
1683308270466,BIMM 100,A02,193312,Staff,0,5,32,32
1683308270466,BIMM 100,A03,193323,Staff,0,8,32,32
1683308271495,BIMM 101,A01,193329,McDonnell; Lisa Marie,0,3,24,24
1683308271495,BIMM 101,A02,193339,McDonnell; Lisa Marie,0,2,24,24
1683308271495,BIMM 101,B01,193354,McDonnell; Lisa Marie,0,3,24,24
1683308271495,BIMM 101,B02,193357,McDonnell; Lisa Marie,0,3,24,24
1683308272523,BIMM 110,A01,193377,Tat; John,0,11,32,32
1683308272523,BIMM 110,A02,193378,Tat; John,1,9,32,31
1683308273549,BIMM 120,A01,206116,Staff,0,0,32,32
1683308273549,BIMM 120,A02,206117,Staff,8,0,32,24
1683308273549,BIMM 120,A03,206121,Staff,21,0,32,11
1683308274573,BIPN 100,A01,193393,Park; Ji Young,0,14,32,32
1683308274573,BIPN 100,A02,193402,Park; Ji Young,0,12,32,32
1683308274573,BIPN 100,A03,193413,Park; Ji Young,0,14,32,32
1683308274573,BIPN 100,A04,193414,Park; Ji Young,0,13,32,32
1683308275596,BIPN 102,A01,193429,Staff,0,0,32,32
1683308275596,BIPN 102,A02,193438,Staff,22,0,32,10
1683308276623,BIPN 106,A01,193450,Reyes Gonzalez; Catalina,0,2,40,40
1683308277652,BIPN 134,A01,193465,Cooke; James Edward,0,0,32,32
1683308277652,BIPN 134,A02,193474,Cooke; James Edward,27,0,32,5
1683308277652,BIPN 134,A03,193485,Cooke; James Edward,29,0,32,3
1683308277652,BIPN 134,A04,193486,Cooke; James Edward,21,0,32,11
1683308277652,BIPN 134,A05,193491,Cooke; James Edward,31,0,32,1
1683308277652,BIPN 134,A06,193501,Cooke; James Edward,30,0,32,2
1683308277652,BIPN 134,A07,193510,Cooke; James Edward,29,0,32,3
1683308279765,BISP 194,A00,222522,Staff,16,0,32,16
1683308280792,CAT 124,A01,202407,Staff,20,0,25,5
1683308281819,CAT 125,A00,202408,Marchisotto; Jennifer Anne,4,0,20,16
1683308282846,CAT 125R,A00,202409,Smith; Lauryn Alissa,0,11,20,20
1683308282846,CAT 125R,B00,202410,Morales; Celeste Georgianna,0,11,20,20
1683308282846,CAT 125R,C00,202411,Irwin; Matthew Joseph,0,10,20,20
1683308283872,CENG 15,A01,204712,Yang; Kesong,0,1,0,0
1683308284899,CENG 114,A00,202070,Jahed Motlagh; Zeinab,5,0,20,15
1683308285922,CGS 105,A00,185477,Wesling; Megan E.,24,0,40,16
1683308286948,CGS 106,A00,185494,Staff,13,0,22,9
1683308287972,CGS 108,A00,185495,Staff,14,0,20,6
1683308288997,CGS 114,A00,185496,Staff,13,0,18,5
1683308290020,CGS 119,A00,185501,Staff,15,0,20,5
1683308291045,CGS 120,A00,185511,Staff,13,0,20,7
1683308292069,CHEM 4,A01,184675,Bussey; Thomas J,96,0,100,4
1683308293097,CHEM 6A,A01,184677,Staff,35,0,60,25
1683308294120,CHEM 6B,A01,184679,Staff,65,0,100,35
1683308295145,CHEM 6C,A01,184681,Bussey; Thomas J,1,0,50,49
1683308295145,CHEM 6C,A02,184682,Bussey; Thomas J,34,0,50,16
1683308296170,CHEM 40A,A01,184684,Albizati; Kim F.,37,0,100,63
1683308297195,CHEM 40B,A01,184686,Albizati; Kim F.,0,20,100,100
1683308298219,CHEM 41B,A01,184690,Staff,52,0,100,48
1683308299245,COGS 3,A01,184715,Boyle; Mary E. T.,0,25,40,40
1683308300273,COGS 14B,A01,185172,Staff,0,15,38,38
1683308301300,COGS 18,A01,184736,Staff,20,0,80,60
1683308302326,COGS 100,A01,184932,Staff,0,5,73,73
1683308303354,COGS 101A,A01,184935,Staff,0,38,30,30
1683308304379,COGS 101B,A01,184944,Staff,0,2,30,30
1683308305405,COGS 101C,A01,184946,Staff,0,12,30,30
1683308306431,COGS 102A,A01,184951,Johnson; Christine M.,2,0,40,38
1683308307455,COGS 107B,A01,184953,Mooshagian; Eric Frederick,0,50,40,40
1683308308480,COGS 118B,A01,184959,Gupta; Anjum,0,48,40,40
1683308309504,COGS 153,A00,184961,Staff,0,15,30,30
1683308310528,COGS 177,A00,184962,Staff,0,21,30,30
1683308311556,COGS 187A,A01,184969,Boyle; Mary E. T.,0,17,40,40
1683308312584,COMM 10,A01,185174,Staff,0,5,25,25
1683308312584,COMM 10,A02,185189,Staff,0,5,25,25
1683308312584,COMM 10,A03,269821,Staff,0,0,0,0
1683308313609,COMM 100B,A01,185475,Staff,0,0,0,2
1683308313609,COMM 100B,A02,185476,Staff,14,0,25,11
1683308314634,COMM 100C,A01,185314,Staff,1,0,25,24
1683308314634,COMM 100C,A02,185327,Staff,19,0,25,6
1683308315657,COMM 110M,A00,185349,Staff,2,0,40,38
1683308316684,COMM 113T,A00,185352,Staff,25,0,40,15
1683308317712,COMM 114I,A00,185353,Staff,33,0,40,7
1683308318736,COMM 131,A00,185354,Staff,19,0,30,11
1683308319764,CSE 8A,A50,185358,Cao; Yingjun,0,46,10,10
1683308320792,CSE 8B,A01,185362,Staff,1,47,50,49
1683308321820,CSE 11,A01,185416,Cao; Yingjun,0,93,10,10
1683308322848,CSE 20,A01,185445,Briones; Jor-el Thomas Caparas,5,0,25,20
1683308323875,CSE 21,A01,185447,Staff,10,0,50,40
1683308324903,CSE 101,A01,185451,Staff,0,12,50,50
1683308324903,CSE 101,B01,185453,Jones; Miles E,0,11,50,50
1683308326953,CSE 141,A01,185458,Eldon; John,20,0,100,80
1683308327983,CSE 141L,A01,185461,Eldon; John,12,0,100,88
1683308329011,CSE 142,A01,185463,Staff,35,0,60,25
1683308329011,CSE 142,B01,201355,Staff,0,6,60,60
1683308330039,CSE 142L,A01,185470,Staff,35,0,60,25
1683308330039,CSE 142L,B01,201417,Staff,0,5,60,60
1683308331063,CSE 190,A00,201433,Staff,32,0,49,17
1683308332087,DOC 1,A01,259136,Strom; Megan C.,8,0,15,7
1683308332087,DOC 1,A02,259137,Strom; Megan C.,14,0,15,1
1683308332087,DOC 1,A03,259138,Strom; Megan C.,14,0,15,1
1683308332087,DOC 1,A04,259139,Strom; Megan C.,14,0,15,1
1683308333184,DOC 100D,A00,259140,Pass; Natalye Joann,17,0,25,8
1683308334208,DSGN 1,A01,184749,Rill; Bryan,0,24,30,30
1683308335232,DSGN 100,A01,185168,Staff,0,2,25,25
1683308336259,ECE 5,A01,185626,Morris; Karcher William,0,10,0,0
1683308337284,ECE 101,A01,185628,Staff,17,0,70,53
1683308338310,ECE 107,A01,185635,Baghdadchi; Saharnaz,0,0,20,20
1683308338310,ECE 107,A02,185638,Baghdadchi; Saharnaz,4,0,20,16
1683308339336,ECE 148,A01,185647,Silberman; Jack,0,0,16,16
1683308340363,ECON 1,A01,185537,Crane; Meredith Helen,54,0,70,16
1683308341392,ECON 3,A01,185549,Crane; Meredith Helen,33,0,70,37
1683308342418,ECON 4,A01,203354,Anderson; John Charles,0,4,10,10
1683308343442,ECON 100A,A01,185574,Staff,0,4,40,40
1683308344469,ECON 100B,A01,185576,Staff,0,22,40,40
1683308345493,ECON 100C,A01,185589,Newhouse; Herbert S,30,0,70,40
1683308346521,ECON 105,A00,185608,Vespa; Emanuel Ignacio,19,0,35,16
1683308347550,ECON 109,A01,185610,Shishkin; Denis,10,0,35,25
1683308348577,ECON 110A,A01,185612,Staff,11,0,40,29
1683308349601,ECON 120A,A01,185615,Staff,20,0,40,20
1683308350625,ECON 120C,A01,185617,Sun; Yixiao,0,20,70,70
1683308351649,ECON 144,A00,203346,Squires; Dale E,3,0,35,32
1683308352673,ECON 171,A01,203349,Newhouse; Herbert S,0,1,35,35
1683308353700,ECON 173A,A01,185621,Toda; Alexis Akira,21,0,35,14
1683308354730,EDS 25,A01,202413,Staff,0,1,0,0
1683308354730,EDS 25,A02,202414,Staff,0,1,0,0
1683308354730,EDS 25,A03,202415,Staff,0,0,0,0
1683308354730,EDS 25,A04,202416,Staff,0,1,0,0
1683308354730,EDS 25,A05,202439,Staff,0,0,0,0
1683308354730,EDS 25,A06,202440,Staff,0,0,0,0
1683308354730,EDS 25,B01,202631,Staff,0,0,0,0
1683308354730,EDS 25,B02,202632,Staff,0,0,0,0
1683308354730,EDS 25,B03,202639,Staff,0,0,0,0
1683308354730,EDS 25,B04,202640,Staff,0,0,0,0
1683308354730,EDS 25,B05,202643,Staff,0,0,0,0
1683308354730,EDS 25,B06,202644,Staff,0,0,0,0
1683308355755,EDS 38,A01,202659,Black; Alison Michelle,24,0,25,1
1683308356782,EDS 115,A00,202652,Staff,17,0,30,13
1683308357806,EDS 125,A00,202649,Staff,14,0,30,16
1683308358830,EDS 126,A01,203332,Staff,30,0,30,0
1683308359857,EDS 139,A00,202838,Staff,17,0,25,8
1683308360885,EDS 146,A01,202655,Staff,15,0,25,10
1683308361910,ENG 15,A00,185667,Staff,0,1,0,0
1683308361910,ENG 15,B00,185672,Staff,0,0,0,0
1683308361910,ENG 15,C00,185675,Staff,0,0,0,0
1683308361910,ENG 15,D00,185682,Staff,0,0,0,0
1683308361910,ENG 15,E00,185684,Staff,0,0,0,0
1683308362937,ETHN 103,A00,185710,Staff,0,3,35,35
1683308363961,ETHN 103A,A00,199228,Man; Simeon S,2,0,9,7
1683308364986,ETHN 109,A00,185711,Staff,18,0,35,17
1683308366014,ETHN 142,A00,185726,Staff,0,4,30,30
1683308367041,ETHN 163J,A00,199229,Man; Simeon S,6,0,8,2
1683308368067,ETHN 168,A00,185727,Staff,8,0,10,2
1683308369090,ETHN 182,A00,185728,Staff,1,0,35,34
1683308370119,ETHN 183,A00,185737,Staff,8,0,18,10
1683308371143,GLBH 111,A01,209361,Burgos; Jose L.,0,0,0,0
1683308373197,HIEU 104,A00,185792,Staff,16,0,20,4
1683308374222,HIEU 115,A00,185800,Staff,1,0,20,19
1683308375246,HIEU 128,A00,185801,Staff,0,7,20,20
1683308376270,HIEU 147,A00,185802,Staff,16,0,20,4
1683308377298,HIEU 154,A00,185823,Staff,12,0,20,8
1683308378323,HILA 102,A00,185826,Staff,13,0,20,7
1683308379347,HILD 2C,A01,185778,Staff,0,12,20,20
1683308380371,HILD 7B,A01,185780,Kwak; Nancy,0,15,32,32
1683308380371,HILD 7B,A02,185781,Kwak; Nancy,0,18,32,32
1683308381395,HILD 30,A01,185791,Staff,14,0,20,6
1683308382477,HISC 119,A00,185830,Golan; Tal,0,9,20,20
1683308383502,HITO 156GS,A00,185831,Patterson; Patrick H.,0,0,0,23
1683308384526,HIUS 103,A00,185832,Man; Simeon S,0,6,20,20
1683308385555,HIUS 117,A00,185836,Kwak; Nancy,2,0,20,18
1683308386582,HIUS 125,A00,185840,Man; Simeon S,0,0,23,23
1683308387609,HIUS 149,A00,185845,Staff,0,0,20,20
1683308388637,HUM 3,A01,185882,Zavodny; Tatiana Sophia,0,6,50,50
1683308388637,HUM 3,B01,185899,Caldwell; Michael Alan,0,19,50,50
1683308389663,HUM 3GS,A00,185900,Patterson; Patrick H.,0,0,0,23
1683308390687,HUM 4,A01,185938,Zroka; Amy Liane,31,0,50,19
1683308390687,HUM 4,B01,185956,Watkins; Eric,0,2,50,50
1683308390687,HUM 4,B02,202209,Watkins; Eric,0,2,50,50
1683308390687,HUM 4,B03,202210,Watkins; Eric,0,0,50,50
1683308391710,HUM 5,A01,185958,West; Geoffrey Scott,4,0,50,46
1683308391710,HUM 5,A02,202215,West; Geoffrey Scott,0,0,50,50
1683308392737,INTL 190,A00,185959,Gagnon; Jeffrey C,0,0,0,9
1683308392737,INTL 190,B00,185960,Lettieri; Michael Joseph,0,0,0,1
1683308393761,JAPN 180,A00,254509,Staff,5,1,30,25
1683308394788,LATI 10,A01,202853,Kennemore; Amy Michelle,5,0,35,30
1683308394788,LATI 10,A02,202854,Kennemore; Amy Michelle,1,0,35,34
1683308394788,LATI 10,A03,270054,Kennemore; Amy Michelle,30,0,30,0
1683308395811,LATI 180,A00,202855,Kennemore; Amy Michelle,11,0,20,9
1683308396833,LAWS 101,A00,201767,Golan; Tal,0,7,40,40
1683308397857,LIFR 1C,A00,185961,Staff,6,0,20,14
1683308398884,LIFR 1CX,A00,185962,Staff,7,0,20,13
1683308399907,LIFR 1D,A00,185963,Staff,9,0,20,11
1683308400933,LIFR 1DX,A00,185964,Staff,9,0,20,11
1683308401956,LIGN 101,A01,186039,Staff,43,0,50,7
1683308402982,LIGN 165,A00,186040,Staff,18,0,50,32
1683308404010,LTCS 108,A00,186041,Staff,6,0,10,4
1683308405036,LTCS 119,A00,186042,Staff,16,0,20,4
1683308406063,LTCS 130,A00,186043,Wesling; Megan E.,15,0,25,10
1683308408112,LTEA 138,A00,186119,Staff,14,0,40,26
1683308409138,LTEN 124,A00,186148,Staff,6,0,25,19
1683308410166,LTEN 178,A00,186149,Staff,7,0,15,8
1683308411191,LTEN 181,A00,186150,Blanco; John D,33,0,40,7
1683308412214,LTWL 120,A00,186160,Staff,20,0,25,5
1683308413238,LTWL 165,A00,186161,Staff,22,0,25,3
1683308414261,LTWR 100,A00,186162,Staff,0,4,15,15
1683308415289,LTWR 102,A00,186163,Doller; Ben,5,0,15,10
1683308416311,MAE 8,A01,186412,Staff,0,0,0,0
1683308417338,MAE 30B,A00,186445,Bahadori; Mohammad Yousef,83,0,100,17
1683308418361,MAE 40,A00,186592,Bewley; Thomas R,9,0,50,41
1683308419389,MAE 101B,A00,186593,Bahadori; Mohammad Yousef,81,0,100,19
1683308420416,MAE 105,A00,186594,Bandaru; Prabhakar,12,0,50,38
1683308421440,MAE 107,A00,186599,Pham; Hieu Tan,0,6,120,120
1683308422465,MAE 148,A01,186660,Silberman; Jack,3,0,16,13
1683308423491,MATH 10A,A01,188095,Staff,0,7,35,35
1683308424516,MATH 10B,A01,188097,Bowers; Adam R.,0,11,30,30
1683308424516,MATH 10B,A02,188099,Bowers; Adam R.,0,9,30,30
1683308424516,MATH 10B,B01,188104,Bowers; Adam R.,0,11,30,30
1683308424516,MATH 10B,B02,188106,Bowers; Adam R.,0,11,30,30
1683308425542,MATH 10C,A01,188111,Staff,0,18,30,30
1683308425542,MATH 10C,A02,188127,Staff,0,17,30,30
1683308425542,MATH 10C,A03,188131,Staff,0,17,30,30
1683308425542,MATH 10C,B01,188218,Staff,21,0,30,9
1683308425542,MATH 10C,B02,188244,Staff,13,0,30,17
1683308425542,MATH 10C,B03,188277,Staff,16,0,30,14
1683308426571,MATH 18,A01,188344,Bach; Quang Tran,18,0,30,12
1683308426571,MATH 18,A02,188345,Bach; Quang Tran,11,0,30,19
1683308426571,MATH 18,B01,188353,Bach; Quang Tran,10,0,30,20
1683308426571,MATH 18,B02,188354,Bach; Quang Tran,20,0,30,10
1683308427598,MATH 20A,A01,188374,Staff,13,0,35,22
1683308428625,MATH 20B,A01,188382,Ohm; Ko Woon,6,0,30,24
1683308428625,MATH 20B,A02,188383,Ohm; Ko Woon,23,0,30,7
1683308428625,MATH 20B,B01,188385,Ohm; Ko Woon,7,0,30,23
1683308428625,MATH 20B,B02,188392,Ohm; Ko Woon,22,0,30,8
1683308429650,MATH 20C,A01,188394,Harel; Guershon,10,0,30,20
1683308429650,MATH 20C,A02,188395,Harel; Guershon,13,0,30,17
1683308429650,MATH 20C,B01,188404,Harel; Guershon,3,0,30,27
1683308429650,MATH 20C,B02,188405,Harel; Guershon,19,0,30,11
1683308430675,MATH 20D,A01,188414,Hammock; Frances H,0,1,30,30
1683308430675,MATH 20D,A02,188415,Hammock; Frances H,4,0,30,26
1683308430675,MATH 20D,B01,188447,Hammock; Frances H,2,0,30,28
1683308430675,MATH 20D,B02,188486,Hammock; Frances H,8,0,30,22
1683308431700,MATH 20E,A01,188649,Staff,22,0,30,8
1683308431700,MATH 20E,A02,188650,Staff,23,0,30,7
1683308431700,MATH 20E,A03,188673,Staff,0,0,30,30
1683308432725,MATH 102,A01,188675,Staff,0,35,35,35
1683308433750,MATH 103B,A01,188681,Staff,4,0,35,31
1683308433750,MATH 103B,B01,188692,Staff,7,0,35,28
1683308434777,MATH 109,A01,188695,Salehi Golsefidy; Alireza,25,0,35,10
1683308434777,MATH 109,A02,188696,Salehi Golsefidy; Alireza,27,0,35,8
1683308435804,MATH 120A,A01,188698,Eggers; John Dietrich,6,0,35,29
1683308436830,MATH 142B,A01,188736,Ioana; Adrian,0,2,30,30
1683308436830,MATH 142B,A02,188741,Ioana; Adrian,0,1,30,30
1683308436830,MATH 142B,A03,188743,Ioana; Adrian,1,3,30,29
1683308437858,MATH 168A,A01,188790,Staff,0,9,35,35
1683308438886,MATH 170A,A01,188803,Nie; Jiawang,0,2,35,35
1683308438886,MATH 170A,A02,188811,Nie; Jiawang,0,0,35,35
1683308438886,MATH 170A,A03,188814,Nie; Jiawang,1,0,35,34
1683308438886,MATH 170A,A04,188815,Nie; Jiawang,13,0,35,22
1683308439914,MATH 193B,A01,188817,Staff,0,0,35,35
1683308439914,MATH 193B,A02,188818,Staff,5,0,35,30
1683308440941,MGT 4,A01,202857,Anderson; John Charles,62,0,80,18
1683308441965,MGT 12,A00,202858,Lindenberger; Wade Douglas,43,0,90,47
1683308442989,MGT 18,A00,202859,Staff,74,0,90,16
1683308444012,MGT 18GS,A00,202860,McKay; Michael J,13,0,28,15
1683308445039,MGT 45,A00,202861,Pecore; Joseph P.,14,0,90,76
1683308446063,MGT 100,A00,202863,Yavorsky; Daniel Ryan,28,0,90,62
1683308447089,MGT 103,A00,202864,Ehrich; Kristine R,0,16,90,90
1683308448112,MGT 112,A00,202865,Ehrich; Kristine R,15,0,90,75
1683308449139,MGT 121A,A00,202868,Staff,0,19,0,0
1683308450162,MGT 131B,A00,202869,Anderson; John Charles,59,0,90,31
1683308451186,MGT 136,A00,202871,Lindenberger; Wade Douglas,84,0,90,6
1683308452209,MGT 164,A00,202873,Staff,0,69,90,90
1683308453233,MGT 164GS,A00,202874,McKay; Mary A,13,0,28,15
1683308454257,MGT 180,A00,202875,Staff,0,51,90,90
1683308455283,MMW 11R,A01,205019,Herbst; Matthew,3,0,30,27
1683308455283,MMW 11R,A02,205026,Herbst; Matthew,29,0,30,1
1683308456313,MMW 15,A01,193512,Chang; Edmond Yi-Teh,0,9,28,28
1683308456313,MMW 15,A02,193513,Chang; Edmond Yi-Teh,0,5,28,28
1683308456313,MMW 15,A03,193514,Chang; Edmond Yi-Teh,0,5,28,28
1683308456313,MMW 15,A04,193515,Chang; Edmond Yi-Teh,0,5,28,28
1683308456313,MMW 15,A05,193516,Chang; Edmond Yi-Teh,0,4,28,28
1683308456313,MMW 15,A06,193517,Chang; Edmond Yi-Teh,0,5,28,28
1683308456313,MMW 15,B01,193519,Chang; Edmond Yi-Teh,0,4,28,28
1683308456313,MMW 15,B02,193520,Chang; Edmond Yi-Teh,0,5,28,28
1683308456313,MMW 15,B03,193521,Chang; Edmond Yi-Teh,0,4,28,28
1683308456313,MMW 15,B04,193522,Chang; Edmond Yi-Teh,0,4,28,28
1683308456313,MMW 15,B05,193523,Chang; Edmond Yi-Teh,0,5,28,28
1683308456313,MMW 15,B06,193524,Chang; Edmond Yi-Teh,0,4,28,28
1683308457340,MMW 122,A01,193526,Rahimi; Babak,0,14,28,28
1683308457340,MMW 122,A02,193527,Rahimi; Babak,0,14,28,28
1683308457340,MMW 122,A03,193528,Rahimi; Babak,0,0,0,0
1683308457340,MMW 122,A04,193529,Rahimi; Babak,0,0,0,0
1683308458367,MUS 1A,A01,186663,Staff,0,20,35,35
1683308459389,MUS 4,A01,186715,Staff,0,12,35,35
1683308460412,MUS 5R,A01,186796,Dubnov; Shlomo,0,17,35,35
1683308461441,MUS 6,A01,186798,Staff,0,3,25,25
1683308462465,MUS 7,A01,186830,Staff,12,0,35,23
1683308463514,MUS 8,A01,186930,Staff,0,26,35,35
1683308464543,MUS 15,A01,186932,Staff,0,15,35,35
1683308464543,MUS 15,B01,186934,Staff,0,15,35,35
1683308465568,MUS 80,A00,186935,Staff,2,0,20,18
1683308465568,MUS 80,B00,186936,Staff,25,0,25,0
1683308466592,NANO 11,A00,204702,Lipomi; Darren John,0,0,0,0
1683308467617,NANO 15,A01,204709,Yang; Kesong,0,1,0,0
1683308468641,NANO 114,A00,202069,Jahed Motlagh; Zeinab,3,0,10,7
1683308469665,PHIL 1,A00,186955,Grush; Rick Scott,32,0,40,8
1683308470689,PHIL 10,A01,186973,Grush; Rick Scott,28,0,35,7
1683308470689,PHIL 10,A02,186974,Grush; Rick Scott,33,0,35,2
1683308471716,PHIL 13,A01,186976,Staff,7,0,35,28
1683308471716,PHIL 13,A02,186977,Staff,16,0,35,19
1683308472742,PHIL 14,A01,186979,Staff,31,0,35,4
1683308472742,PHIL 14,A02,186986,Staff,32,0,35,3
1683308473767,PHIL 28,A01,186988,Staff,16,0,30,14
1683308473767,PHIL 28,A02,186989,Staff,1,0,30,29
1683308473767,PHIL 28,A03,186990,Staff,9,0,30,21
1683308473767,PHIL 28,A04,186991,Staff,26,0,30,4
1683308474797,PHIL 120,A00,186997,Staff,23,0,40,17
1683308475822,PHIL 137,A00,187003,Staff,9,0,40,31
1683308476847,PHIL 150,A00,187015,Staff,47,0,70,23
1683308477873,PHIL 167,A00,187021,Lamey; Andy M.,35,0,40,5
1683308478898,PHIL 174,A01,202226,Staff,17,0,20,3
1683308478898,PHIL 174,A02,202235,Staff,20,0,20,0
1683308479922,PHIL 191A,A00,258918,Staff,0,0,1,1
1683308480945,PHYS 1A,A00,187028,Staff,27,0,60,33
1683308481968,PHYS 1AL,001,187036,Staff,3,0,30,27
1683308481968,PHYS 1AL,002,187049,Staff,18,0,30,12
1683308482991,PHYS 1B,A00,187058,Staff,23,0,60,37
1683308484016,PHYS 1BL,001,187064,Staff,0,0,30,30
1683308484016,PHYS 1BL,002,187070,Staff,6,0,30,24
1683308485041,PHYS 1C,A00,187082,Staff,31,0,120,89
1683308486123,PHYS 1CL,001,187088,Staff,0,9,30,30
1683308486123,PHYS 1CL,002,187089,Staff,0,2,30,30
1683308486123,PHYS 1CL,009,262693,Staff,11,0,30,19
1683308487147,PHYS 2B,A01,187097,Staff,54,0,115,61
1683308488169,PHYS 2C,A01,187099,Staff,67,0,115,48
1683308489193,PHYS 2CL,A01,187101,Staff,5,0,28,23
1683308489193,PHYS 2CL,A02,187102,Staff,15,0,28,13
1683308490220,PHYS 2D,A01,187123,Shotwell; Brian,95,0,115,20
1683308491244,PHYS 4B,A01,187133,Grinstein; Benjamin,35,0,50,15
1683308492270,POLI 10,A00,188819,Staff,0,3,50,50
1683308493296,POLI 11,A00,188827,Staff,43,0,50,7
1683308494321,POLI 13R,A00,188828,Staff,0,1,20,20
1683308495348,POLI 27,A01,188830,Elgin; Samuel Zincke,0,1,70,70
1683308496371,POLI 30,A00,188832,Desposato; Scott,33,0,50,17
1683308497393,POLI 102F,A00,188834,Staff,3,0,40,37
1683308498420,POLI 104A,A00,188852,Staff,14,0,30,16
1683308499446,POLI 104I,A00,188853,Staff,0,6,20,20
1683308500470,POLI 110B,A00,188854,Wiens; David,7,0,20,13
1683308501496,POLI 112A,A00,188855,Wiens; David,5,0,30,25
1683308502520,POLI 117R,A00,188856,Forman; Fonna,0,11,20,20
1683308503547,POLI 118,A00,188857,Ingham; Sean,8,0,20,12
1683308504573,POLI 120G,A00,188858,Staff,9,0,30,21
1683308505596,POLI 131CR,A00,188863,Hoston; Germaine,24,0,50,26
1683308506622,POLI 133,A00,188864,Nellis; Gareth Hb,44,0,50,6
1683308507653,POLI 134D,A00,188865,Desposato; Scott,27,0,30,3
1683308508679,POLI 142A,A00,188871,Gartzke; Erik,22,0,50,28
1683308509704,POLI 142K,A00,188874,Staff,38,0,50,12
1683308510731,POLI 143,A00,188940,Gartzke; Erik,16,0,30,14
1683308511757,POLI 153,A00,188943,Staff,3,0,20,17
1683308512784,POLI 160AA,A00,188944,Staff,13,0,40,27
1683308513808,POLI 170A,A00,188945,Staff,11,0,30,19
1683308515856,PSYC 1,A00,188952,Staff,38,0,90,52
1683308516889,PSYC 2,B00,188953,Staff,20,0,35,15
1683308517916,PSYC 6,A00,188970,Staff,47,0,60,13
1683308518940,PSYC 7,A00,188973,Staff,37,0,45,8
1683308519966,PSYC 60,A01,188980,Rickard; Timothy C.,43,0,60,17
1683308520993,PSYC 70,A01,189001,Steiner; Eric Tomas,24,0,45,21
1683308522017,PSYC 100,A00,189005,Lacefield; Katharine I,0,99,120,120
1683308523042,PSYC 102,A00,189008,Staff,10,0,30,20
1683308524067,PSYC 106,B00,189026,Gorman; Michael R.,37,0,60,23
1683308525092,PSYC 114,B01,189033,Winkielman; Piotr,0,32,30,30
1683308526115,PSYC 131,A00,189036,Anagnostaras; Stephan,0,43,60,60
1683308527138,PSYC 136,A00,189041,Lowe; Angela Beth,0,7,25,25
1683308528163,PSYC 137,A00,189057,Winkielman; Piotr,0,34,25,25
1683308529187,PSYC 144,A00,189107,Wixted; John T,0,7,50,50
1683308531242,PSYC 162,A00,189142,Staff,0,8,85,85
1683308532265,PSYC 172,A00,189144,Gorman; Michael R.,0,7,30,30
1683308534318,PSYC 179,A00,189146,Lacefield; Katharine I,0,84,120,120
1683308535346,PSYC 181,A00,189147,Anagnostaras; Stephan,0,44,90,90
1683308536369,PSYC 190R,A00,189148,Barner; David A.,0,22,80,80
1683308537396,PSYC 191,A00,189275,Rickard; Timothy C.,0,7,25,25
1683308538420,PSYC 193,A00,189276,Chapman; Eddie Nathaniel,0,1,0,4
1683308539447,PSYC 193L,A01,189281,Lowe; Angela Beth,12,0,20,8
1683308539447,PSYC 193L,B01,189285,Staff,28,0,35,7
1683308540474,RELI 149,A00,187137,Rahimi; Babak,7,0,40,33
1683308541499,SE 9,A01,187315,Staff,0,2,18,18
1683308542523,SE 101B,A00,187409,Staff,24,0,30,6
1683308543547,SE 110B,A00,187444,Staff,10,0,40,30
1683308544571,SE 130B,A00,187449,Staff,31,0,40,9
1683308545598,SE 150A,A00,187516,Staff,9,0,20,11
1683308546622,SE 154,A00,187528,Staff,30,0,50,20
1683308547646,SIO 3,A01,258171,Staff,35,0,40,5
1683308548671,SIO 10,A00,187144,Cook; Geoffrey W,0,3,75,75
1683308549697,SIO 45,A00,187152,Cook; Geoffrey W,1,0,100,99
1683308550724,SIO 109R,A00,194486,Staff,0,3,20,20
1683308552777,SIO 187,A01,187233,Kacev; David,12,0,40,28
1683308553807,SOCI 1,A01,258656,Thorpe; Charles Robert,28,0,30,2
1683308553807,SOCI 1,A02,258658,Thorpe; Charles Robert,30,0,30,0
1683308553807,SOCI 1,A03,258661,Thorpe; Charles Robert,25,0,25,0
1683308553807,SOCI 1,A04,258666,Thorpe; Charles Robert,22,0,25,3
1683308553807,SOCI 1,A05,258897,Thorpe; Charles Robert,23,0,25,2
1683308553807,SOCI 1,A06,258898,Thorpe; Charles Robert,25,0,25,0
1683308554832,SOCI 30,A01,258903,Pardo Guerra; Juan Pablo,16,0,30,14
1683308555858,SOCI 102,A00,258904,Staff,9,0,25,16
1683308556884,SOCI 106,A00,258905,Staff,19,0,25,6
1683308557911,SOCI 111,A00,258907,Ribas Norris; Janet Vanesa,26,0,30,4
1683308558937,SOCI 121R,A00,258908,Pardo Guerra; Juan Pablo,11,0,30,19
1683308559965,SOCI 126,A01,203330,Staff,14,0,20,6
1683308560992,SOCI 131,A00,258909,Thorpe; Charles Robert,31,0,60,29
1683308562016,SOCI 135,A00,258910,Payne; Christine Anna,0,9,30,30
1683308563042,SOCI 157,A00,258911,Staff,13,0,30,17
1683308564069,SOCI 184,A00,258912,Staff,26,0,30,4
1683308565093,SOCI 188D,A00,258913,Staff,21,0,30,9
1683308566116,SYN 2,001,187529,Staff,9,0,16,7
1683308566116,SYN 2,002,201452,Staff,0,18,16,16
1683308566116,SYN 2,003,201469,Staff,3,0,16,13
1683308567139,SYN 100,A01,187531,Staff,0,9,20,20
1683308567139,SYN 100,B01,201491,Staff,0,12,20,20
1683308568164,TDAC 1,A00,189286,Walsh; Kim C.,3,0,20,17
1683308568164,TDAC 1,B00,189287,Harting; Carla Kelso,11,0,20,9
1683308569189,TDAC 101,A00,189300,Walsh; Kim C.,16,0,20,4
1683308569189,TDAC 101,B00,189301,Harting; Carla Kelso,18,0,20,2
1683308570213,TDAC 102,A00,189304,Basso; Beatrice,14,0,20,6
1683308571237,TDAC 108,A00,189305,Staff,18,0,20,2
1683308572265,TDDE 131,A00,189310,Staff,19,0,20,1
1683308572265,TDDE 131,B00,189314,Staff,19,0,20,1
1683308572265,TDDE 131,C00,189315,Staff,48,0,50,2
1683308572265,TDDE 131,D00,189316,Staff,14,0,15,1
1683308572265,TDDE 131,E00,204841,Staff,20,0,20,0
1683308573289,TDGE 10,A00,189289,Staff,30,0,50,20
1683308573289,TDGE 10,B00,189290,Havis; Allan,2,0,50,48
1683308574314,TDGE 11,A00,189291,Fulton; Julia,0,3,50,50
1683308574314,TDGE 11,B00,189292,Staff,20,0,25,5
1683308574314,TDGE 11,C00,260270,Staff,0,0,0,0
1683308575336,TDGE 25,A00,189294,Staff,3,0,20,17
1683308576363,TDGE 124,A00,189318,Fulton; Julia,0,8,50,50
1683308577388,TDGE 125,A00,189319,Staff,13,0,25,12
1683308577388,TDGE 125,B00,189320,Staff,23,0,25,2
1683308578411,TDGE 127,A00,189322,Havis; Allan,0,0,50,50
1683308579439,TDHT 101,A00,189323,Staff,18,0,25,7
1683308579439,TDHT 101,B00,189324,Staff,25,0,25,0
1683308580466,TDHT 102,A00,189325,Staff,49,0,50,1
1683308581495,TDMV 1,A00,189295,Arcidiacono; Kristin,20,0,30,10
1683308581495,TDMV 1,B00,189296,Caligagan; Maria T.,24,0,30,6
1683308582523,TDMV 2,A00,189297,Sammartano; Tonnie,28,0,30,2
1683308582523,TDMV 2,B00,189299,Arcidiacono; Kristin,24,0,30,6
1683308583547,TDMV 3,A00,204998,Rincon; Alicia,22,0,30,8
1683308584571,TDMV 120,A00,189458,Sammartano; Tonnie,28,0,30,2
1683308585594,TDMV 138,A00,189541,Jun; Grace Shin Hae,22,0,40,18
1683308586622,TDMV 142,A00,189717,Caligagan; Tony,23,0,30,7
1683308586622,TDMV 142,B00,189718,Caligagan; Maria T.,25,0,30,5
1683308587648,TMC 2,A01,187533,Staff,25,0,25,0
1683308587648,TMC 2,A02,187534,Staff,25,0,25,0
1683308588681,USP 1,A01,187536,Kwak; Nancy,0,16,25,25
1683308589763,USP 5,A01,187538,Staff,9,0,25,16
1683308590787,USP 101,A00,199253,Staff,0,4,0,0
1683308591813,USP 124,A00,187562,Boomhower; Matthew Charles,1,0,30,29
1683308592840,USP 138,A00,187582,Staff,20,0,25,5
1683308593863,USP 152,A01,187597,Staff,4,0,25,21
1683308594887,USP 153,A00,187598,Staff,19,0,25,6
1683308595914,USP 168,A00,187607,Kwak; Nancy,2,0,5,3
1683308596938,USP 173,A00,187619,Staff,4,0,25,21
1683308597962,USP 181,A00,187638,Staff,0,0,25,25
1683308598988,VIS 103,A00,187650,Cruz; Edwin Teddy,23,0,75,52
1683308600013,VIS 110D,A00,187669,Staff,12,0,22,10
1683308601036,VIS 127C,A00,187720,Shen; Kuiyi,68,0,146,78
1683308602060,VIS 149,A00,187731,Yoldas; Pinar,0,14,22,22
1683308603087,VIS 151,A01,188091,Staff,22,0,34,12
1683308603087,VIS 151,A02,188092,Staff,11,0,34,23
1683308604110,VIS 160B,A00,188093,Stalbaum; Brett,0,0,10,10
1683308606157,WCWP 10B,A00,201720,Staff,10,0,15,5
1683308606157,WCWP 10B,B00,201722,Staff,8,0,15,7
1683308607181,WCWP 100,A00,201725,Gagnon; Jeffrey C,0,0,2,2
1683308607181,WCWP 100,B00,201727,Staff,0,4,15,15
1683308610268,ANBI 133,A00,258401,Wilder; Linnea Lorene,34,0,40,6
1683308611296,ANBI 140,A00,258395,Hrvoj Mihic; Branka,18,0,25,7
1683308612320,ANSC 120,A00,258402,Bialecki; Jon Anthony,27,0,40,13
1683308613344,ANSC 144,A00,258400,Staff,14,0,40,26
1683308615390,ANSC 166,A00,258396,Parish; Steven Martin,157,0,175,18
1683308616413,ANSC 180,A00,193533,Staff,9,0,20,11
1683308617438,ANSC 188,A00,258397,Jassal; Aftab,33,0,40,7
1683308618463,ANTH 3,A01,258316,Staff,23,0,30,7
1683308619486,ANTH 5,A00,258394,Semendeferi; Ekaterini,16,0,20,4
1683308620511,ANTH 21,A01,258331,Staff,9,0,40,31
1683308621537,ANTH 103,A00,258398,Varma; Saiba,15,0,25,10
1683308622564,AWP 10,001,202034,Staff,0,0,0,0
1683308622564,AWP 10,002,202035,Staff,0,0,0,0
1683308622564,AWP 10,003,202036,Staff,0,0,0,0
1683308622564,AWP 10,004,202037,Staff,0,0,0,0
1683308622564,AWP 10,005,202038,Staff,0,0,0,0
1683308622564,AWP 10,006,202039,Staff,0,0,0,0
1683308622564,AWP 10,007,202040,Staff,0,0,0,0
1683308622564,AWP 10,008,202041,Staff,0,0,0,0
1683308622564,AWP 10,009,202042,Staff,0,0,0,0
1683308622564,AWP 10,010,202043,Staff,0,0,0,0
1683308622564,AWP 10,011,202044,Staff,0,0,0,0
1683308622564,AWP 10,012,202045,Staff,0,0,0,0
1683308622564,AWP 10,013,202046,Staff,0,0,0,0
1683308622564,AWP 10,014,202047,Staff,0,0,0,0
1683308622564,AWP 10,015,202048,Staff,0,0,0,0
1683308622564,AWP 10,016,202049,Staff,0,0,0,0
1683308622564,AWP 10,017,202050,Staff,0,0,0,0
1683308622564,AWP 10,018,202051,Staff,0,0,0,0
1683308622564,AWP 10,019,202052,Staff,0,0,0,0
1683308622564,AWP 10,020,202053,Staff,0,0,0,0
1683308622564,AWP 10,021,202054,Staff,0,0,0,0
1683308622564,AWP 10,022,202055,Staff,0,0,0,0
1683308622564,AWP 10,023,202056,Staff,0,0,0,0
1683308622564,AWP 10,024,202057,Staff,0,0,0,0
1683308622564,AWP 10,025,202058,Staff,0,0,0,0
1683308622564,AWP 10,026,202059,Staff,0,0,0,0
1683308623591,AWP 102,001,202032,Staff,0,0,0,0
1683308623591,AWP 102,002,202033,Staff,0,0,0,0
1683308624619,BENG 100,A01,254234,Taylor Amos; Alyssa C,31,0,40,9
1683308625646,BENG 196,001,270013,Engler; Adam J.,9999,0,9999,0
1683308626675,BICD 100R,A01,202018,Smith; Laurie,0,7,32,32
1683308626675,BICD 100R,A02,202019,Smith; Laurie,0,2,32,32
1683308626675,BICD 100R,A03,202020,Smith; Laurie,0,1,32,32
1683308626675,BICD 100R,A04,202021,Smith; Laurie,8,0,32,24
1683308626675,BICD 100R,A05,202022,Smith; Laurie,12,0,32,20
1683308627703,BICD 136,A01,193242,Gustafson-Brown; Cindy,0,2,32,32
1683308627703,BICD 136,A02,193244,Gustafson-Brown; Cindy,15,0,32,17
1683308628729,BIEB 102,A01,193249,Butler; Shannon Rhey,0,2,32,32
1683308628729,BIEB 102,A02,193251,Butler; Shannon Rhey,0,0,32,32
1683308628729,BIEB 102,A03,193253,Butler; Shannon Rhey,0,1,32,32
1683308628729,BIEB 102,A04,193255,Butler; Shannon Rhey,17,0,32,15
1683308628729,BIEB 102,A05,193265,Butler; Shannon Rhey,26,0,32,6
1683308628729,BIEB 102,A06,193269,Butler; Shannon Rhey,16,0,32,16
1683308630782,BIEB 150,A01,193274,Staff,0,0,32,32
1683308630782,BIEB 150,A02,193285,Staff,24,0,32,8
1683308631807,BIEB 194,A00,193286,Kurle; Carolyn M.,22,0,32,10
1683308632835,BILD 1,A01,192291,Staff,16,0,32,16
1683308632835,BILD 1,A02,192292,Staff,30,0,32,2
1683308632835,BILD 1,B01,192520,Reuther; Keefe,0,1,0,0
1683308632835,BILD 1,B02,192532,Reuther; Keefe,0,1,0,0
1683308633860,BILD 3,A01,192556,Butler; Shannon Rhey,0,0,32,32
1683308633860,BILD 3,A02,192581,Butler; Shannon Rhey,5,0,32,27
1683308633860,BILD 3,A03,192611,Butler; Shannon Rhey,23,0,32,9
1683308633860,BILD 3,A04,192612,Butler; Shannon Rhey,25,0,32,7
1683308633860,BILD 3,A05,192613,Butler; Shannon Rhey,27,0,32,5
1683308633860,BILD 3,A06,192679,Butler; Shannon Rhey,27,0,32,5
1683308633860,BILD 3,A07,192682,Butler; Shannon Rhey,22,0,32,10
1683308634885,BILD 4,A01,192836,Reuther; Keefe,1,0,24,23
1683308634885,BILD 4,A02,193044,Reuther; Keefe,4,0,24,20
1683308635910,BILD 10,A01,193142,Gustafson-Brown; Cindy,31,0,32,1
1683308635910,BILD 10,A02,193149,Gustafson-Brown; Cindy,31,0,32,1
1683308636938,BIMM 100,A01,193301,Staff,0,6,32,32
1683308636938,BIMM 100,A02,193312,Staff,0,5,32,32
1683308636938,BIMM 100,A03,193323,Staff,0,8,32,32
1683308637964,BIMM 101,A01,193329,McDonnell; Lisa Marie,0,3,24,24
1683308637964,BIMM 101,A02,193339,McDonnell; Lisa Marie,0,2,24,24
1683308637964,BIMM 101,B01,193354,McDonnell; Lisa Marie,0,3,24,24
1683308637964,BIMM 101,B02,193357,McDonnell; Lisa Marie,0,3,24,24
1683308638988,BIMM 110,A01,193377,Tat; John,0,11,32,32
1683308638988,BIMM 110,A02,193378,Tat; John,1,9,32,31
1683308640013,BIMM 120,A01,206116,Staff,0,0,32,32
1683308640013,BIMM 120,A02,206117,Staff,8,0,32,24
1683308640013,BIMM 120,A03,206121,Staff,21,0,32,11
1683308641039,BIPN 100,A01,193393,Park; Ji Young,0,14,32,32
1683308641039,BIPN 100,A02,193402,Park; Ji Young,0,12,32,32
1683308641039,BIPN 100,A03,193413,Park; Ji Young,0,14,32,32
1683308641039,BIPN 100,A04,193414,Park; Ji Young,0,13,32,32
1683308642064,BIPN 102,A01,193429,Staff,0,0,32,32
1683308642064,BIPN 102,A02,193438,Staff,22,0,32,10
1683308643091,BIPN 106,A01,193450,Reyes Gonzalez; Catalina,0,2,40,40
1683308644122,BIPN 134,A01,193465,Cooke; James Edward,0,0,32,32
1683308644122,BIPN 134,A02,193474,Cooke; James Edward,27,0,32,5
1683308644122,BIPN 134,A03,193485,Cooke; James Edward,29,0,32,3
1683308644122,BIPN 134,A04,193486,Cooke; James Edward,21,0,32,11
1683308644122,BIPN 134,A05,193491,Cooke; James Edward,31,0,32,1
1683308644122,BIPN 134,A06,193501,Cooke; James Edward,30,0,32,2
1683308644122,BIPN 134,A07,193510,Cooke; James Edward,29,0,32,3
1683308646177,BISP 194,A00,222522,Staff,16,0,32,16
1683308647202,CAT 124,A01,202407,Staff,20,0,25,5
1683308648226,CAT 125,A00,202408,Marchisotto; Jennifer Anne,4,0,20,16
1683308649256,CAT 125R,A00,202409,Smith; Lauryn Alissa,0,11,20,20
1683308649256,CAT 125R,B00,202410,Morales; Celeste Georgianna,0,11,20,20
1683308649256,CAT 125R,C00,202411,Irwin; Matthew Joseph,0,10,20,20
1683308650282,CENG 15,A01,204712,Yang; Kesong,0,1,0,0
1683308651306,CENG 114,A00,202070,Jahed Motlagh; Zeinab,5,0,20,15
1683308652331,CGS 105,A00,185477,Wesling; Megan E.,24,0,40,16
1683308653358,CGS 106,A00,185494,Staff,13,0,22,9
1683308654384,CGS 108,A00,185495,Staff,14,0,20,6
1683308655411,CGS 114,A00,185496,Staff,13,0,18,5
1683308656435,CGS 119,A00,185501,Staff,15,0,20,5
1683308657461,CGS 120,A00,185511,Staff,13,0,20,7
1683308658488,CHEM 4,A01,184675,Bussey; Thomas J,96,0,100,4
1683308659515,CHEM 6A,A01,184677,Staff,35,0,60,25
1683308660542,CHEM 6B,A01,184679,Staff,65,0,100,35
1683308661570,CHEM 6C,A01,184681,Bussey; Thomas J,1,0,50,49
1683308661570,CHEM 6C,A02,184682,Bussey; Thomas J,34,0,50,16
1683308662598,CHEM 40A,A01,184684,Albizati; Kim F.,37,0,100,63
1683308663626,CHEM 40B,A01,184686,Albizati; Kim F.,0,20,100,100
1683308664652,CHEM 41B,A01,184690,Staff,52,0,100,48
1683308665677,COGS 3,A01,184715,Boyle; Mary E. T.,0,25,40,40
1683308666705,COGS 14B,A01,185172,Staff,0,15,38,38
1683308667732,COGS 18,A01,184736,Staff,19,0,80,61
1683308668758,COGS 100,A01,184932,Staff,0,5,73,73
1683308669785,COGS 101A,A01,184935,Staff,0,38,30,30
1683308670812,COGS 101B,A01,184944,Staff,0,2,30,30
1683308671839,COGS 101C,A01,184946,Staff,0,12,30,30
1683308672867,COGS 102A,A01,184951,Johnson; Christine M.,2,0,40,38
1683308673894,COGS 107B,A01,184953,Mooshagian; Eric Frederick,0,50,40,40
1683308674922,COGS 118B,A01,184959,Gupta; Anjum,0,48,40,40
1683308675951,COGS 153,A00,184961,Staff,0,15,30,30
1683308676978,COGS 177,A00,184962,Staff,0,21,30,30
1683308678003,COGS 187A,A01,184969,Boyle; Mary E. T.,0,17,40,40
1683308679027,COMM 10,A01,185174,Staff,0,5,25,25
1683308679027,COMM 10,A02,185189,Staff,0,5,25,25
1683308679027,COMM 10,A03,269821,Staff,0,0,0,0
1683308680052,COMM 100B,A01,185475,Staff,0,0,0,2
1683308680052,COMM 100B,A02,185476,Staff,14,0,25,11
1683308681079,COMM 100C,A01,185314,Staff,1,0,25,24
1683308681079,COMM 100C,A02,185327,Staff,19,0,25,6
1683308682105,COMM 110M,A00,185349,Staff,2,0,40,38
1683308683129,COMM 113T,A00,185352,Staff,25,0,40,15
1683308684153,COMM 114I,A00,185353,Staff,33,0,40,7
1683308685179,COMM 131,A00,185354,Staff,19,0,30,11
1683308686203,CSE 8A,A50,185358,Cao; Yingjun,0,46,10,10
1683308687228,CSE 8B,A01,185362,Staff,1,47,50,49
1683308688252,CSE 11,A01,185416,Cao; Yingjun,0,93,10,10
1683308689275,CSE 20,A01,185445,Briones; Jor-el Thomas Caparas,5,0,25,20
1683308690302,CSE 21,A01,185447,Staff,10,0,50,40
1683308691326,CSE 101,A01,185451,Staff,0,12,50,50
1683308691326,CSE 101,B01,185453,Jones; Miles E,0,11,50,50
1683308693429,CSE 141,A01,185458,Eldon; John,20,0,100,80
1683308694457,CSE 141L,A01,185461,Eldon; John,12,0,100,88
1683308695481,CSE 142,A01,185463,Staff,35,0,60,25
1683308695481,CSE 142,B01,201355,Staff,0,6,60,60
1683308696509,CSE 142L,A01,185470,Staff,35,0,60,25
1683308696509,CSE 142L,B01,201417,Staff,0,5,60,60
1683308697532,CSE 190,A00,201433,Staff,32,0,49,17
1683308698557,DOC 1,A01,259136,Strom; Megan C.,8,0,15,7
1683308698557,DOC 1,A02,259137,Strom; Megan C.,14,0,15,1
1683308698557,DOC 1,A03,259138,Strom; Megan C.,14,0,15,1
1683308698557,DOC 1,A04,259139,Strom; Megan C.,14,0,15,1
1683308699584,DOC 100D,A00,259140,Pass; Natalye Joann,17,0,25,8
1683308700607,DSGN 1,A01,184749,Rill; Bryan,0,24,30,30
1683308701634,DSGN 100,A01,185168,Staff,0,2,25,25
1683308702661,ECE 5,A01,185626,Morris; Karcher William,0,10,0,0
1683308703687,ECE 101,A01,185628,Staff,17,0,70,53
1683308704713,ECE 107,A01,185635,Baghdadchi; Saharnaz,0,0,20,20
1683308704713,ECE 107,A02,185638,Baghdadchi; Saharnaz,4,0,20,16
1683308705736,ECE 148,A01,185647,Silberman; Jack,0,0,16,16
1683308706765,ECON 1,A01,185537,Crane; Meredith Helen,54,0,70,16
1683308707792,ECON 3,A01,185549,Crane; Meredith Helen,33,0,70,37
1683308708824,ECON 4,A01,203354,Anderson; John Charles,0,4,10,10
1683308709849,ECON 100A,A01,185574,Staff,0,4,40,40
1683308710872,ECON 100B,A01,185576,Staff,0,22,40,40
1683308711897,ECON 100C,A01,185589,Newhouse; Herbert S,30,0,70,40
1683308712921,ECON 105,A00,185608,Vespa; Emanuel Ignacio,19,0,35,16
1683308713945,ECON 109,A01,185610,Shishkin; Denis,10,0,35,25
1683308714973,ECON 110A,A01,185612,Staff,11,0,40,29
1683308715996,ECON 120A,A01,185615,Staff,20,0,40,20
1683308717023,ECON 120C,A01,185617,Sun; Yixiao,0,20,70,70
1683308718050,ECON 144,A00,203346,Squires; Dale E,3,0,35,32
1683308719074,ECON 171,A01,203349,Newhouse; Herbert S,0,1,35,35
1683308720098,ECON 173A,A01,185621,Toda; Alexis Akira,21,0,35,14
1683308721125,EDS 25,A01,202413,Staff,0,1,0,0
1683308721125,EDS 25,A02,202414,Staff,0,1,0,0
1683308721125,EDS 25,A03,202415,Staff,0,0,0,0
1683308721125,EDS 25,A04,202416,Staff,0,1,0,0
1683308721125,EDS 25,A05,202439,Staff,0,0,0,0
1683308721125,EDS 25,A06,202440,Staff,0,0,0,0
1683308721125,EDS 25,B01,202631,Staff,0,0,0,0
1683308721125,EDS 25,B02,202632,Staff,0,0,0,0
1683308721125,EDS 25,B03,202639,Staff,0,0,0,0
1683308721125,EDS 25,B04,202640,Staff,0,0,0,0
1683308721125,EDS 25,B05,202643,Staff,0,0,0,0
1683308721125,EDS 25,B06,202644,Staff,0,0,0,0
1683308722153,EDS 38,A01,202659,Black; Alison Michelle,24,0,25,1
1683308723179,EDS 115,A00,202652,Staff,17,0,30,13
1683308724207,EDS 125,A00,202649,Staff,14,0,30,16
1683308725230,EDS 126,A01,203332,Staff,30,0,30,0
1683308726254,EDS 139,A00,202838,Staff,17,0,25,8
1683308727282,EDS 146,A01,202655,Staff,15,0,25,10
1683308728305,ENG 15,A00,185667,Staff,0,1,0,0
1683308728305,ENG 15,B00,185672,Staff,0,0,0,0
1683308728305,ENG 15,C00,185675,Staff,0,0,0,0
1683308728305,ENG 15,D00,185682,Staff,0,0,0,0
1683308728305,ENG 15,E00,185684,Staff,0,0,0,0
1683308729329,ETHN 103,A00,185710,Staff,0,3,35,35
1683308730357,ETHN 103A,A00,199228,Man; Simeon S,2,0,9,7
1683308731384,ETHN 109,A00,185711,Staff,18,0,35,17
1683308732407,ETHN 142,A00,185726,Staff,0,4,30,30
1683308733432,ETHN 163J,A00,199229,Man; Simeon S,6,0,8,2
1683308734454,ETHN 168,A00,185727,Staff,8,0,10,2
1683308735480,ETHN 182,A00,185728,Staff,1,0,35,34
1683308736503,ETHN 183,A00,185737,Staff,8,0,18,10
1683308737530,GLBH 111,A01,209361,Burgos; Jose L.,0,0,0,0
1683308739582,HIEU 104,A00,185792,Staff,16,0,20,4
1683308740607,HIEU 115,A00,185800,Staff,1,0,20,19
1683308741631,HIEU 128,A00,185801,Staff,0,7,20,20
1683308742659,HIEU 147,A00,185802,Staff,16,0,20,4
1683308743686,HIEU 154,A00,185823,Staff,12,0,20,8
1683308744711,HILA 102,A00,185826,Staff,13,0,20,7
1683308745733,HILD 2C,A01,185778,Staff,0,12,20,20
1683308746758,HILD 7B,A01,185780,Kwak; Nancy,0,15,32,32
1683308746758,HILD 7B,A02,185781,Kwak; Nancy,0,18,32,32
1683308747782,HILD 30,A01,185791,Staff,14,0,20,6
1683308748808,HISC 119,A00,185830,Golan; Tal,0,9,20,20
1683308749834,HITO 156GS,A00,185831,Patterson; Patrick H.,0,0,0,23
1683308750862,HIUS 103,A00,185832,Man; Simeon S,0,6,20,20
1683308751886,HIUS 117,A00,185836,Kwak; Nancy,2,0,20,18
1683308752911,HIUS 125,A00,185840,Man; Simeon S,0,0,23,23
1683308753937,HIUS 149,A00,185845,Staff,0,0,20,20
1683308754962,HUM 3,A01,185882,Zavodny; Tatiana Sophia,0,6,50,50
1683308754962,HUM 3,B01,185899,Caldwell; Michael Alan,0,19,50,50
1683308755985,HUM 3GS,A00,185900,Patterson; Patrick H.,0,0,0,23
1683308757010,HUM 4,A01,185938,Zroka; Amy Liane,31,0,50,19
1683308757010,HUM 4,B01,185956,Watkins; Eric,0,2,50,50
1683308757010,HUM 4,B02,202209,Watkins; Eric,0,2,50,50
1683308757010,HUM 4,B03,202210,Watkins; Eric,0,0,50,50
1683308758033,HUM 5,A01,185958,West; Geoffrey Scott,4,0,50,46
1683308758033,HUM 5,A02,202215,West; Geoffrey Scott,0,0,50,50
1683308759062,INTL 190,A00,185959,Gagnon; Jeffrey C,0,0,0,9
1683308759062,INTL 190,B00,185960,Lettieri; Michael Joseph,0,0,0,1
1683308760086,JAPN 180,A00,254509,Staff,5,1,30,25
1683308761119,LATI 10,A01,202853,Kennemore; Amy Michelle,5,0,35,30
1683308761119,LATI 10,A02,202854,Kennemore; Amy Michelle,1,0,35,34
1683308761119,LATI 10,A03,270054,Kennemore; Amy Michelle,30,0,30,0
1683308762146,LATI 180,A00,202855,Kennemore; Amy Michelle,11,0,20,9
1683308763173,LAWS 101,A00,201767,Golan; Tal,0,7,40,40
1683308764200,LIFR 1C,A00,185961,Staff,6,0,20,14
1683308765224,LIFR 1CX,A00,185962,Staff,7,0,20,13
1683308766249,LIFR 1D,A00,185963,Staff,9,0,20,11
1683308767276,LIFR 1DX,A00,185964,Staff,9,0,20,11
1683308768303,LIGN 101,A01,186039,Staff,43,0,50,7
1683308769329,LIGN 165,A00,186040,Staff,18,0,50,32
1683308770355,LTCS 108,A00,186041,Staff,6,0,10,4
1683308771380,LTCS 119,A00,186042,Staff,16,0,20,4
1683308772407,LTCS 130,A00,186043,Wesling; Megan E.,15,0,25,10
1683308774458,LTEA 138,A00,186119,Staff,14,0,40,26
1683308775494,LTEN 124,A00,186148,Staff,6,0,25,19
1683308776519,LTEN 178,A00,186149,Staff,7,0,15,8
1683308777543,LTEN 181,A00,186150,Blanco; John D,33,0,40,7
1683308778572,LTWL 120,A00,186160,Staff,20,0,25,5
1683308779596,LTWL 165,A00,186161,Staff,22,0,25,3
1683308780620,LTWR 100,A00,186162,Staff,0,4,15,15
1683308781644,LTWR 102,A00,186163,Doller; Ben,5,0,15,10
1683308782672,MAE 8,A01,186412,Staff,0,0,0,0
1683308783695,MAE 30B,A00,186445,Bahadori; Mohammad Yousef,83,0,100,17
1683308784719,MAE 40,A00,186592,Bewley; Thomas R,9,0,50,41
1683308785746,MAE 101B,A00,186593,Bahadori; Mohammad Yousef,81,0,100,19
1683308786772,MAE 105,A00,186594,Bandaru; Prabhakar,12,0,50,38
1683308787795,MAE 107,A00,186599,Pham; Hieu Tan,0,6,120,120
1683308788822,MAE 148,A01,186660,Silberman; Jack,3,0,16,13
1683308789846,MATH 10A,A01,188095,Staff,0,8,35,35
1683308790877,MATH 10B,A01,188097,Bowers; Adam R.,0,11,30,30
1683308790877,MATH 10B,A02,188099,Bowers; Adam R.,0,9,30,30
1683308790877,MATH 10B,B01,188104,Bowers; Adam R.,0,11,30,30
1683308790877,MATH 10B,B02,188106,Bowers; Adam R.,0,11,30,30
1683308791903,MATH 10C,A01,188111,Staff,0,18,30,30
1683308791903,MATH 10C,A02,188127,Staff,0,17,30,30
1683308791903,MATH 10C,A03,188131,Staff,0,17,30,30
1683308791903,MATH 10C,B01,188218,Staff,21,0,30,9
1683308791903,MATH 10C,B02,188244,Staff,13,0,30,17
1683308791903,MATH 10C,B03,188277,Staff,16,0,30,14
1683308792928,MATH 18,A01,188344,Bach; Quang Tran,18,0,30,12
1683308792928,MATH 18,A02,188345,Bach; Quang Tran,11,0,30,19
1683308792928,MATH 18,B01,188353,Bach; Quang Tran,10,0,30,20
1683308792928,MATH 18,B02,188354,Bach; Quang Tran,20,0,30,10
1683308793956,MATH 20A,A01,188374,Staff,13,0,35,22
1683308794980,MATH 20B,A01,188382,Ohm; Ko Woon,6,0,30,24
1683308794980,MATH 20B,A02,188383,Ohm; Ko Woon,23,0,30,7
1683308794980,MATH 20B,B01,188385,Ohm; Ko Woon,7,0,30,23
1683308794980,MATH 20B,B02,188392,Ohm; Ko Woon,22,0,30,8
1683308796011,MATH 20C,A01,188394,Harel; Guershon,10,0,30,20
1683308796011,MATH 20C,A02,188395,Harel; Guershon,13,0,30,17
1683308796011,MATH 20C,B01,188404,Harel; Guershon,3,0,30,27
1683308796011,MATH 20C,B02,188405,Harel; Guershon,19,0,30,11
1683308797114,MATH 20D,A01,188414,Hammock; Frances H,0,1,30,30
1683308797114,MATH 20D,A02,188415,Hammock; Frances H,4,0,30,26
1683308797114,MATH 20D,B01,188447,Hammock; Frances H,2,0,30,28
1683308797114,MATH 20D,B02,188486,Hammock; Frances H,8,0,30,22
1683308798141,MATH 20E,A01,188649,Staff,22,0,30,8
1683308798141,MATH 20E,A02,188650,Staff,23,0,30,7
1683308798141,MATH 20E,A03,188673,Staff,0,0,30,30
1683308799164,MATH 102,A01,188675,Staff,0,35,35,35
1683308800187,MATH 103B,A01,188681,Staff,4,0,35,31
1683308800187,MATH 103B,B01,188692,Staff,7,0,35,28
1683308801215,MATH 109,A01,188695,Salehi Golsefidy; Alireza,25,0,35,10
1683308801215,MATH 109,A02,188696,Salehi Golsefidy; Alireza,27,0,35,8
1683308802238,MATH 120A,A01,188698,Eggers; John Dietrich,6,0,35,29
1683308803261,MATH 142B,A01,188736,Ioana; Adrian,0,2,30,30
1683308803261,MATH 142B,A02,188741,Ioana; Adrian,0,1,30,30
1683308803261,MATH 142B,A03,188743,Ioana; Adrian,1,3,30,29
1683308804285,MATH 168A,A01,188790,Staff,0,9,35,35
1683308805309,MATH 170A,A01,188803,Nie; Jiawang,0,2,35,35
1683308805309,MATH 170A,A02,188811,Nie; Jiawang,0,0,35,35
1683308805309,MATH 170A,A03,188814,Nie; Jiawang,1,0,35,34
1683308805309,MATH 170A,A04,188815,Nie; Jiawang,13,0,35,22
1683308806335,MATH 193B,A01,188817,Staff,0,0,35,35
1683308806335,MATH 193B,A02,188818,Staff,5,0,35,30
1683308807360,MGT 4,A01,202857,Anderson; John Charles,62,0,80,18
1683308808385,MGT 12,A00,202858,Lindenberger; Wade Douglas,43,0,90,47
1683308809411,MGT 18,A00,202859,Staff,74,0,90,16
1683308810436,MGT 18GS,A00,202860,McKay; Michael J,13,0,28,15
1683308811464,MGT 45,A00,202861,Pecore; Joseph P.,14,0,90,76
1683308812489,MGT 100,A00,202863,Yavorsky; Daniel Ryan,28,0,90,62
1683308813510,MGT 103,A00,202864,Ehrich; Kristine R,0,16,90,90
1683308814534,MGT 112,A00,202865,Ehrich; Kristine R,15,0,90,75
1683308815565,MGT 121A,A00,202868,Staff,0,19,0,0
1683308816593,MGT 131B,A00,202869,Anderson; John Charles,59,0,90,31
1683308817617,MGT 136,A00,202871,Lindenberger; Wade Douglas,84,0,90,6
1683308818646,MGT 164,A00,202873,Staff,0,69,90,90
1683308819670,MGT 164GS,A00,202874,McKay; Mary A,13,0,28,15
1683308820699,MGT 180,A00,202875,Staff,0,51,90,90
1683308821724,MMW 11R,A01,205019,Herbst; Matthew,3,0,30,27
1683308821724,MMW 11R,A02,205026,Herbst; Matthew,29,0,30,1
1683308822749,MMW 15,A01,193512,Chang; Edmond Yi-Teh,0,9,28,28
1683308822749,MMW 15,A02,193513,Chang; Edmond Yi-Teh,0,5,28,28
1683308822749,MMW 15,A03,193514,Chang; Edmond Yi-Teh,0,5,28,28
1683308822749,MMW 15,A04,193515,Chang; Edmond Yi-Teh,0,5,28,28
1683308822749,MMW 15,A05,193516,Chang; Edmond Yi-Teh,0,4,28,28
1683308822749,MMW 15,A06,193517,Chang; Edmond Yi-Teh,0,5,28,28
1683308822749,MMW 15,B01,193519,Chang; Edmond Yi-Teh,0,4,28,28
1683308822749,MMW 15,B02,193520,Chang; Edmond Yi-Teh,0,5,28,28
1683308822749,MMW 15,B03,193521,Chang; Edmond Yi-Teh,0,4,28,28
1683308822749,MMW 15,B04,193522,Chang; Edmond Yi-Teh,0,4,28,28
1683308822749,MMW 15,B05,193523,Chang; Edmond Yi-Teh,0,5,28,28
1683308822749,MMW 15,B06,193524,Chang; Edmond Yi-Teh,0,4,28,28
1683308823776,MMW 122,A01,193526,Rahimi; Babak,0,14,28,28
1683308823776,MMW 122,A02,193527,Rahimi; Babak,0,14,28,28
1683308823776,MMW 122,A03,193528,Rahimi; Babak,0,0,0,0
1683308823776,MMW 122,A04,193529,Rahimi; Babak,0,0,0,0
1683308824800,MUS 1A,A01,186663,Staff,0,20,35,35
1683308825826,MUS 4,A01,186715,Staff,0,12,35,35
1683308826850,MUS 5R,A01,186796,Dubnov; Shlomo,0,17,35,35
1683308827877,MUS 6,A01,186798,Staff,0,3,25,25
1683308828901,MUS 7,A01,186830,Staff,12,0,35,23
1683308829926,MUS 8,A01,186930,Staff,0,26,35,35
1683308830954,MUS 15,A01,186932,Staff,0,15,35,35
1683308830954,MUS 15,B01,186934,Staff,0,15,35,35
1683308831981,MUS 80,A00,186935,Staff,2,0,20,18
1683308831981,MUS 80,B00,186936,Staff,25,0,25,0
1683308833009,NANO 11,A00,204702,Lipomi; Darren John,0,0,0,0
1683308834037,NANO 15,A01,204709,Yang; Kesong,0,1,0,0
1683308835062,NANO 114,A00,202069,Jahed Motlagh; Zeinab,3,0,10,7
1683308836086,PHIL 1,A00,186955,Grush; Rick Scott,32,0,40,8
1683308837111,PHIL 10,A01,186973,Grush; Rick Scott,28,0,35,7
1683308837111,PHIL 10,A02,186974,Grush; Rick Scott,33,0,35,2
1683308838138,PHIL 13,A01,186976,Staff,7,0,35,28
1683308838138,PHIL 13,A02,186977,Staff,16,0,35,19
1683308839163,PHIL 14,A01,186979,Staff,31,0,35,4
1683308839163,PHIL 14,A02,186986,Staff,32,0,35,3
1683308840188,PHIL 28,A01,186988,Staff,16,0,30,14
1683308840188,PHIL 28,A02,186989,Staff,1,0,30,29
1683308840188,PHIL 28,A03,186990,Staff,9,0,30,21
1683308840188,PHIL 28,A04,186991,Staff,26,0,30,4
1683308841215,PHIL 120,A00,186997,Staff,23,0,40,17
1683308842238,PHIL 137,A00,187003,Staff,9,0,40,31
1683308843260,PHIL 150,A00,187015,Staff,47,0,70,23
1683308844283,PHIL 167,A00,187021,Lamey; Andy M.,35,0,40,5
1683308845307,PHIL 174,A01,202226,Staff,17,0,20,3
1683308845307,PHIL 174,A02,202235,Staff,20,0,20,0
1683308846333,PHIL 191A,A00,258918,Staff,0,0,1,1
1683308847356,PHYS 1A,A00,187028,Staff,27,0,60,33
1683308848382,PHYS 1AL,001,187036,Staff,3,0,30,27
1683308848382,PHYS 1AL,002,187049,Staff,18,0,30,12
1683308849408,PHYS 1B,A00,187058,Staff,23,0,60,37
1683308850435,PHYS 1BL,001,187064,Staff,0,0,30,30
1683308850435,PHYS 1BL,002,187070,Staff,6,0,30,24
1683308851460,PHYS 1C,A00,187082,Staff,31,0,120,89
1683308852487,PHYS 1CL,001,187088,Staff,0,9,30,30
1683308852487,PHYS 1CL,002,187089,Staff,0,2,30,30
1683308852487,PHYS 1CL,009,262693,Staff,11,0,30,19
1683308853515,PHYS 2B,A01,187097,Staff,54,0,115,61
1683308854543,PHYS 2C,A01,187099,Staff,67,0,115,48
1683308855569,PHYS 2CL,A01,187101,Staff,5,0,28,23
1683308855569,PHYS 2CL,A02,187102,Staff,15,0,28,13
1683308856593,PHYS 2D,A01,187123,Shotwell; Brian,95,0,115,20
1683308857620,PHYS 4B,A01,187133,Grinstein; Benjamin,35,0,50,15
1683308858646,POLI 10,A00,188819,Staff,0,3,50,50
1683308859670,POLI 11,A00,188827,Staff,43,0,50,7
1683308860696,POLI 13R,A00,188828,Staff,0,1,20,20
1683308861723,POLI 27,A01,188830,Elgin; Samuel Zincke,0,1,70,70
1683308862751,POLI 30,A00,188832,Desposato; Scott,33,0,50,17
1683308863773,POLI 102F,A00,188834,Staff,3,0,40,37
1683308864797,POLI 104A,A00,188852,Staff,14,0,30,16
1683308865821,POLI 104I,A00,188853,Staff,0,6,20,20
1683308866848,POLI 110B,A00,188854,Wiens; David,7,0,20,13
1683308867875,POLI 112A,A00,188855,Wiens; David,5,0,30,25
1683308868902,POLI 117R,A00,188856,Forman; Fonna,0,11,20,20
1683308869926,POLI 118,A00,188857,Ingham; Sean,8,0,20,12
1683308870950,POLI 120G,A00,188858,Staff,9,0,30,21
1683308871979,POLI 131CR,A00,188863,Hoston; Germaine,24,0,50,26
1683308873008,POLI 133,A00,188864,Nellis; Gareth Hb,44,0,50,6
1683308874036,POLI 134D,A00,188865,Desposato; Scott,27,0,30,3
1683308875060,POLI 142A,A00,188871,Gartzke; Erik,22,0,50,28
1683308876087,POLI 142K,A00,188874,Staff,38,0,50,12
1683308877114,POLI 143,A00,188940,Gartzke; Erik,16,0,30,14
1683308878140,POLI 153,A00,188943,Staff,3,0,20,17
1683308879163,POLI 160AA,A00,188944,Staff,13,0,40,27
1683308880187,POLI 170A,A00,188945,Staff,11,0,30,19
1683308882238,PSYC 1,A00,188952,Staff,38,0,90,52
1683308883264,PSYC 2,B00,188953,Staff,20,0,35,15
1683308884291,PSYC 6,A00,188970,Staff,47,0,60,13
1683308885315,PSYC 7,A00,188973,Staff,37,0,45,8
1683308886339,PSYC 60,A01,188980,Rickard; Timothy C.,43,0,60,17
1683308887366,PSYC 70,A01,189001,Steiner; Eric Tomas,24,0,45,21
1683308888390,PSYC 100,A00,189005,Lacefield; Katharine I,0,99,120,120
1683308889419,PSYC 102,A00,189008,Staff,10,0,30,20
1683308890442,PSYC 106,B00,189026,Gorman; Michael R.,37,0,60,23
1683308891466,PSYC 114,B01,189033,Winkielman; Piotr,0,32,30,30
1683308892490,PSYC 131,A00,189036,Anagnostaras; Stephan,0,43,60,60
1683308893514,PSYC 136,A00,189041,Lowe; Angela Beth,0,7,25,25
1683308894537,PSYC 137,A00,189057,Winkielman; Piotr,0,34,25,25
1683308895564,PSYC 144,A00,189107,Wixted; John T,0,7,50,50
1683308897612,PSYC 162,A00,189142,Staff,0,8,85,85
1683308898643,PSYC 172,A00,189144,Gorman; Michael R.,0,7,30,30
1683308900750,PSYC 179,A00,189146,Lacefield; Katharine I,0,84,120,120
1683308901778,PSYC 181,A00,189147,Anagnostaras; Stephan,0,44,90,90
1683308902806,PSYC 190R,A00,189148,Barner; David A.,0,22,80,80
1683308903832,PSYC 191,A00,189275,Rickard; Timothy C.,0,7,25,25
1683308904860,PSYC 193,A00,189276,Chapman; Eddie Nathaniel,0,1,0,4
1683308905888,PSYC 193L,A01,189281,Lowe; Angela Beth,12,0,20,8
1683308905888,PSYC 193L,B01,189285,Staff,28,0,35,7
1683308906915,RELI 149,A00,187137,Rahimi; Babak,7,0,40,33
1683308907941,SE 9,A01,187315,Staff,0,2,18,18
1683308908965,SE 101B,A00,187409,Staff,24,0,30,6
1683308909990,SE 110B,A00,187444,Staff,10,0,40,30
1683308911018,SE 130B,A00,187449,Staff,31,0,40,9
1683308912045,SE 150A,A00,187516,Staff,9,0,20,11
1683308913071,SE 154,A00,187528,Staff,30,0,50,20
1683308914098,SIO 3,A01,258171,Staff,35,0,40,5
1683308915122,SIO 10,A00,187144,Cook; Geoffrey W,0,3,75,75
1683308916147,SIO 45,A00,187152,Cook; Geoffrey W,1,0,100,99
1683308917172,SIO 109R,A00,194486,Staff,0,3,20,20
1683308919220,SIO 187,A01,187233,Kacev; David,12,0,40,28
1683308920249,SOCI 1,A01,258656,Thorpe; Charles Robert,28,0,30,2
1683308920249,SOCI 1,A02,258658,Thorpe; Charles Robert,30,0,30,0
1683308920249,SOCI 1,A03,258661,Thorpe; Charles Robert,25,0,25,0
1683308920249,SOCI 1,A04,258666,Thorpe; Charles Robert,22,0,25,3
1683308920249,SOCI 1,A05,258897,Thorpe; Charles Robert,23,0,25,2
1683308920249,SOCI 1,A06,258898,Thorpe; Charles Robert,25,0,25,0
1683308921273,SOCI 30,A01,258903,Pardo Guerra; Juan Pablo,16,0,30,14
1683308922298,SOCI 102,A00,258904,Staff,9,0,25,16
1683308923324,SOCI 106,A00,258905,Staff,19,0,25,6
1683308924348,SOCI 111,A00,258907,Ribas Norris; Janet Vanesa,26,0,30,4
1683308925372,SOCI 121R,A00,258908,Pardo Guerra; Juan Pablo,11,0,30,19
1683308926395,SOCI 126,A01,203330,Staff,14,0,20,6
1683308927419,SOCI 131,A00,258909,Thorpe; Charles Robert,31,0,60,29
1683308928446,SOCI 135,A00,258910,Payne; Christine Anna,0,9,30,30
1683308929470,SOCI 157,A00,258911,Staff,13,0,30,17
1683308930494,SOCI 184,A00,258912,Staff,26,0,30,4
1683308931525,SOCI 188D,A00,258913,Staff,21,0,30,9
1683308932554,SYN 2,001,187529,Staff,9,0,16,7
1683308932554,SYN 2,002,201452,Staff,0,18,16,16
1683308932554,SYN 2,003,201469,Staff,3,0,16,13
1683308933582,SYN 100,A01,187531,Staff,0,9,20,20
1683308933582,SYN 100,B01,201491,Staff,0,12,20,20
1683308934610,TDAC 1,A00,189286,Walsh; Kim C.,3,0,20,17
1683308934610,TDAC 1,B00,189287,Harting; Carla Kelso,11,0,20,9
1683308935634,TDAC 101,A00,189300,Walsh; Kim C.,16,0,20,4
1683308935634,TDAC 101,B00,189301,Harting; Carla Kelso,18,0,20,2
1683308936657,TDAC 102,A00,189304,Basso; Beatrice,14,0,20,6
1683308937680,TDAC 108,A00,189305,Staff,18,0,20,2
1683308938705,TDDE 131,A00,189310,Staff,19,0,20,1
1683308938705,TDDE 131,B00,189314,Staff,19,0,20,1
1683308938705,TDDE 131,C00,189315,Staff,48,0,50,2
1683308938705,TDDE 131,D00,189316,Staff,14,0,15,1
1683308938705,TDDE 131,E00,204841,Staff,20,0,20,0
1683308939729,TDGE 10,A00,189289,Staff,30,0,50,20
1683308939729,TDGE 10,B00,189290,Havis; Allan,2,0,50,48
1683308940753,TDGE 11,A00,189291,Fulton; Julia,0,3,50,50
1683308940753,TDGE 11,B00,189292,Staff,20,0,25,5
1683308940753,TDGE 11,C00,260270,Staff,0,0,0,0
1683308941777,TDGE 25,A00,189294,Staff,3,0,20,17
1683308942801,TDGE 124,A00,189318,Fulton; Julia,0,8,50,50
1683308943825,TDGE 125,A00,189319,Staff,13,0,25,12
1683308943825,TDGE 125,B00,189320,Staff,23,0,25,2
1683308944853,TDGE 127,A00,189322,Havis; Allan,0,0,50,50
1683308945878,TDHT 101,A00,189323,Staff,18,0,25,7
1683308945878,TDHT 101,B00,189324,Staff,25,0,25,0
1683308946902,TDHT 102,A00,189325,Staff,49,0,50,1
1683308947926,TDMV 1,A00,189295,Arcidiacono; Kristin,20,0,30,10
1683308947926,TDMV 1,B00,189296,Caligagan; Maria T.,24,0,30,6
1683308948951,TDMV 2,A00,189297,Sammartano; Tonnie,28,0,30,2
1683308948951,TDMV 2,B00,189299,Arcidiacono; Kristin,24,0,30,6
1683308949979,TDMV 3,A00,204998,Rincon; Alicia,22,0,30,8
1683308951006,TDMV 120,A00,189458,Sammartano; Tonnie,28,0,30,2
1683308952031,TDMV 138,A00,189541,Jun; Grace Shin Hae,22,0,40,18
1683308953058,TDMV 142,A00,189717,Caligagan; Tony,23,0,30,7
1683308953058,TDMV 142,B00,189718,Caligagan; Maria T.,25,0,30,5
1683308954082,TMC 2,A01,187533,Staff,25,0,25,0
1683308954082,TMC 2,A02,187534,Staff,25,0,25,0
1683308955105,USP 1,A01,187536,Kwak; Nancy,0,16,25,25
1683308956128,USP 5,A01,187538,Staff,9,0,25,16
1683308957152,USP 101,A00,199253,Staff,0,4,0,0
1683308958179,USP 124,A00,187562,Boomhower; Matthew Charles,1,0,30,29
1683308959202,USP 138,A00,187582,Staff,20,0,25,5
1683308960226,USP 152,A01,187597,Staff,4,0,25,21
1683308961251,USP 153,A00,187598,Staff,19,0,25,6
1683308962275,USP 168,A00,187607,Kwak; Nancy,2,0,5,3
1683308963300,USP 173,A00,187619,Staff,4,0,25,21
1683308964328,USP 181,A00,187638,Staff,0,0,25,25
1683308965353,VIS 103,A00,187650,Cruz; Edwin Teddy,23,0,75,52
1683308966377,VIS 110D,A00,187669,Staff,12,0,22,10
1683308967402,VIS 127C,A00,187720,Shen; Kuiyi,68,0,146,78
1683308968425,VIS 149,A00,187731,Yoldas; Pinar,0,14,22,22
1683308969449,VIS 151,A01,188091,Staff,22,0,34,12
1683308969449,VIS 151,A02,188092,Staff,11,0,34,23
1683308970473,VIS 160B,A00,188093,Stalbaum; Brett,0,0,10,10
1683308972525,WCWP 10B,A00,201720,Staff,10,0,15,5
1683308972525,WCWP 10B,B00,201722,Staff,8,0,15,7
1683308973550,WCWP 100,A00,201725,Gagnon; Jeffrey C,0,0,2,2
1683308973550,WCWP 100,B00,201727,Staff,0,4,15,15
1683308976649,ANBI 133,A00,258401,Wilder; Linnea Lorene,34,0,40,6
1683308977676,ANBI 140,A00,258395,Hrvoj Mihic; Branka,18,0,25,7
1683308978703,ANSC 120,A00,258402,Bialecki; Jon Anthony,27,0,40,13
1683308979730,ANSC 144,A00,258400,Staff,14,0,40,26
1683308981776,ANSC 166,A00,258396,Parish; Steven Martin,157,0,175,18
1683308982802,ANSC 180,A00,193533,Staff,9,0,20,11
1683308983827,ANSC 188,A00,258397,Jassal; Aftab,33,0,40,7
1683308984851,ANTH 3,A01,258316,Staff,23,0,30,7
1683308985875,ANTH 5,A00,258394,Semendeferi; Ekaterini,16,0,20,4
1683308986899,ANTH 21,A01,258331,Staff,9,0,40,31
1683308987923,ANTH 103,A00,258398,Varma; Saiba,15,0,25,10
1683308988956,AWP 10,001,202034,Staff,0,0,0,0
1683308988956,AWP 10,002,202035,Staff,0,0,0,0
1683308988956,AWP 10,003,202036,Staff,0,0,0,0
1683308988956,AWP 10,004,202037,Staff,0,0,0,0
1683308988956,AWP 10,005,202038,Staff,0,0,0,0
1683308988956,AWP 10,006,202039,Staff,0,0,0,0
1683308988956,AWP 10,007,202040,Staff,0,0,0,0
1683308988956,AWP 10,008,202041,Staff,0,0,0,0
1683308988956,AWP 10,009,202042,Staff,0,0,0,0
1683308988956,AWP 10,010,202043,Staff,0,0,0,0
1683308988956,AWP 10,011,202044,Staff,0,0,0,0
1683308988956,AWP 10,012,202045,Staff,0,0,0,0
1683308988956,AWP 10,013,202046,Staff,0,0,0,0
1683308988956,AWP 10,014,202047,Staff,0,0,0,0
1683308988956,AWP 10,015,202048,Staff,0,0,0,0
1683308988956,AWP 10,016,202049,Staff,0,0,0,0
1683308988956,AWP 10,017,202050,Staff,0,0,0,0
1683308988956,AWP 10,018,202051,Staff,0,0,0,0
1683308988956,AWP 10,019,202052,Staff,0,0,0,0
1683308988956,AWP 10,020,202053,Staff,0,0,0,0
1683308988956,AWP 10,021,202054,Staff,0,0,0,0
1683308988956,AWP 10,022,202055,Staff,0,0,0,0
1683308988956,AWP 10,023,202056,Staff,0,0,0,0
1683308988956,AWP 10,024,202057,Staff,0,0,0,0
1683308988956,AWP 10,025,202058,Staff,0,0,0,0
1683308988956,AWP 10,026,202059,Staff,0,0,0,0
1683308989980,AWP 102,001,202032,Staff,0,0,0,0
1683308989980,AWP 102,002,202033,Staff,0,0,0,0
1683308991006,BENG 100,A01,254234,Taylor Amos; Alyssa C,31,0,40,9
1683308992031,BENG 196,001,270013,Engler; Adam J.,9999,0,9999,0
1683308993059,BICD 100R,A01,202018,Smith; Laurie,0,7,32,32
1683308993059,BICD 100R,A02,202019,Smith; Laurie,0,2,32,32
1683308993059,BICD 100R,A03,202020,Smith; Laurie,0,1,32,32
1683308993059,BICD 100R,A04,202021,Smith; Laurie,8,0,32,24
1683308993059,BICD 100R,A05,202022,Smith; Laurie,12,0,32,20
1683308994085,BICD 136,A01,193242,Gustafson-Brown; Cindy,0,2,32,32
1683308994085,BICD 136,A02,193244,Gustafson-Brown; Cindy,15,0,32,17
1683308995110,BIEB 102,A01,193249,Butler; Shannon Rhey,0,2,32,32
1683308995110,BIEB 102,A02,193251,Butler; Shannon Rhey,0,0,32,32
1683308995110,BIEB 102,A03,193253,Butler; Shannon Rhey,0,1,32,32
1683308995110,BIEB 102,A04,193255,Butler; Shannon Rhey,17,0,32,15
1683308995110,BIEB 102,A05,193265,Butler; Shannon Rhey,26,0,32,6
1683308995110,BIEB 102,A06,193269,Butler; Shannon Rhey,16,0,32,16
1683308997162,BIEB 150,A01,193274,Staff,0,0,32,32
1683308997162,BIEB 150,A02,193285,Staff,24,0,32,8
1683308998187,BIEB 194,A00,193286,Kurle; Carolyn M.,22,0,32,10
1683308999214,BILD 1,A01,192291,Staff,16,0,32,16
1683308999214,BILD 1,A02,192292,Staff,30,0,32,2
1683308999214,BILD 1,B01,192520,Reuther; Keefe,0,1,0,0
1683308999214,BILD 1,B02,192532,Reuther; Keefe,0,1,0,0
1683309000243,BILD 3,A01,192556,Butler; Shannon Rhey,0,0,32,32
1683309000243,BILD 3,A02,192581,Butler; Shannon Rhey,5,0,32,27
1683309000243,BILD 3,A03,192611,Butler; Shannon Rhey,23,0,32,9
1683309000243,BILD 3,A04,192612,Butler; Shannon Rhey,25,0,32,7
1683309000243,BILD 3,A05,192613,Butler; Shannon Rhey,27,0,32,5
1683309000243,BILD 3,A06,192679,Butler; Shannon Rhey,27,0,32,5
1683309000243,BILD 3,A07,192682,Butler; Shannon Rhey,22,0,32,10
1683309001270,BILD 4,A01,192836,Reuther; Keefe,1,0,24,23
1683309001270,BILD 4,A02,193044,Reuther; Keefe,4,0,24,20
1683309002297,BILD 10,A01,193142,Gustafson-Brown; Cindy,31,0,32,1
1683309002297,BILD 10,A02,193149,Gustafson-Brown; Cindy,31,0,32,1
1683309003324,BIMM 100,A01,193301,Staff,0,6,32,32
1683309003324,BIMM 100,A02,193312,Staff,0,5,32,32
1683309003324,BIMM 100,A03,193323,Staff,0,8,32,32
1683309004411,BIMM 101,A01,193329,McDonnell; Lisa Marie,0,3,24,24
1683309004411,BIMM 101,A02,193339,McDonnell; Lisa Marie,0,2,24,24
1683309004411,BIMM 101,B01,193354,McDonnell; Lisa Marie,0,3,24,24
1683309004411,BIMM 101,B02,193357,McDonnell; Lisa Marie,0,3,24,24
1683309005435,BIMM 110,A01,193377,Tat; John,0,11,32,32
1683309005435,BIMM 110,A02,193378,Tat; John,1,9,32,31
1683309006463,BIMM 120,A01,206116,Staff,0,0,32,32
1683309006463,BIMM 120,A02,206117,Staff,8,0,32,24
1683309006463,BIMM 120,A03,206121,Staff,21,0,32,11
1683309007491,BIPN 100,A01,193393,Park; Ji Young,0,14,32,32
1683309007491,BIPN 100,A02,193402,Park; Ji Young,0,12,32,32
1683309007491,BIPN 100,A03,193413,Park; Ji Young,0,14,32,32
1683309007491,BIPN 100,A04,193414,Park; Ji Young,0,13,32,32
1683309008514,BIPN 102,A01,193429,Staff,0,0,32,32
1683309008514,BIPN 102,A02,193438,Staff,22,0,32,10
1683309009542,BIPN 106,A01,193450,Reyes Gonzalez; Catalina,0,2,40,40
1683309010568,BIPN 134,A01,193465,Cooke; James Edward,0,0,32,32
1683309010568,BIPN 134,A02,193474,Cooke; James Edward,27,0,32,5
1683309010568,BIPN 134,A03,193485,Cooke; James Edward,29,0,32,3
1683309010568,BIPN 134,A04,193486,Cooke; James Edward,21,0,32,11
1683309010568,BIPN 134,A05,193491,Cooke; James Edward,31,0,32,1
1683309010568,BIPN 134,A06,193501,Cooke; James Edward,30,0,32,2
1683309010568,BIPN 134,A07,193510,Cooke; James Edward,29,0,32,3
1683309012623,BISP 194,A00,222522,Staff,16,0,32,16
1683309013646,CAT 124,A01,202407,Staff,20,0,25,5
1683309014672,CAT 125,A00,202408,Marchisotto; Jennifer Anne,4,0,20,16
1683309015700,CAT 125R,A00,202409,Smith; Lauryn Alissa,0,11,20,20
1683309015700,CAT 125R,B00,202410,Morales; Celeste Georgianna,0,11,20,20
1683309015700,CAT 125R,C00,202411,Irwin; Matthew Joseph,0,10,20,20
1683309016724,CENG 15,A01,204712,Yang; Kesong,0,1,0,0
1683309017749,CENG 114,A00,202070,Jahed Motlagh; Zeinab,5,0,20,15
1683309018778,CGS 105,A00,185477,Wesling; Megan E.,24,0,40,16
1683309019801,CGS 106,A00,185494,Staff,13,0,22,9
1683309020825,CGS 108,A00,185495,Staff,14,0,20,6
1683309021849,CGS 114,A00,185496,Staff,13,0,18,5
1683309022873,CGS 119,A00,185501,Staff,15,0,20,5
1683309023900,CGS 120,A00,185511,Staff,13,0,20,7
1683309024929,CHEM 4,A01,184675,Bussey; Thomas J,96,0,100,4
1683309025959,CHEM 6A,A01,184677,Staff,35,0,60,25
1683309026984,CHEM 6B,A01,184679,Staff,65,0,100,35
1683309028012,CHEM 6C,A01,184681,Bussey; Thomas J,1,0,50,49
1683309028012,CHEM 6C,A02,184682,Bussey; Thomas J,34,0,50,16
1683309029036,CHEM 40A,A01,184684,Albizati; Kim F.,37,0,100,63
1683309030061,CHEM 40B,A01,184686,Albizati; Kim F.,0,20,100,100
1683309031088,CHEM 41B,A01,184690,Staff,52,0,100,48
1683309032112,COGS 3,A01,184715,Boyle; Mary E. T.,0,25,40,40
1683309033136,COGS 14B,A01,185172,Staff,0,15,38,38
1683309034160,COGS 18,A01,184736,Staff,19,0,80,61
1683309035185,COGS 100,A01,184932,Staff,0,5,73,73
1683309036209,COGS 101A,A01,184935,Staff,0,38,30,30
1683309037231,COGS 101B,A01,184944,Staff,0,2,30,30
1683309038255,COGS 101C,A01,184946,Staff,0,12,30,30
1683309039283,COGS 102A,A01,184951,Johnson; Christine M.,2,0,40,38
1683309040306,COGS 107B,A01,184953,Mooshagian; Eric Frederick,0,50,40,40
1683309041330,COGS 118B,A01,184959,Gupta; Anjum,0,48,40,40
1683309042357,COGS 153,A00,184961,Staff,0,15,30,30
1683309043383,COGS 177,A00,184962,Staff,0,21,30,30
1683309044410,COGS 187A,A01,184969,Boyle; Mary E. T.,0,17,40,40
1683309045435,COMM 10,A01,185174,Staff,0,5,25,25
1683309045435,COMM 10,A02,185189,Staff,0,5,25,25
1683309045435,COMM 10,A03,269821,Staff,0,0,0,0
1683309046462,COMM 100B,A01,185475,Staff,0,0,0,2
1683309046462,COMM 100B,A02,185476,Staff,14,0,25,11
1683309047490,COMM 100C,A01,185314,Staff,1,0,25,24
1683309047490,COMM 100C,A02,185327,Staff,19,0,25,6
1683309048512,COMM 110M,A00,185349,Staff,2,0,40,38
1683309049539,COMM 113T,A00,185352,Staff,25,0,40,15
1683309050562,COMM 114I,A00,185353,Staff,33,0,40,7
1683309051586,COMM 131,A00,185354,Staff,19,0,30,11
1683309052610,CSE 8A,A50,185358,Cao; Yingjun,0,46,10,10
1683309053634,CSE 8B,A01,185362,Staff,1,47,50,49
1683309054660,CSE 11,A01,185416,Cao; Yingjun,0,93,10,10
1683309055686,CSE 20,A01,185445,Briones; Jor-el Thomas Caparas,5,0,25,20
1683309056712,CSE 21,A01,185447,Staff,10,0,50,40
1683309057740,CSE 101,A01,185451,Staff,0,12,50,50
1683309057740,CSE 101,B01,185453,Jones; Miles E,0,11,50,50
1683309059790,CSE 141,A01,185458,Eldon; John,20,0,100,80
1683309060818,CSE 141L,A01,185461,Eldon; John,12,0,100,88
1683309061847,CSE 142,A01,185463,Staff,35,0,60,25
1683309061847,CSE 142,B01,201355,Staff,0,6,60,60
1683309062870,CSE 142L,A01,185470,Staff,35,0,60,25
1683309062870,CSE 142L,B01,201417,Staff,0,5,60,60
1683309063895,CSE 190,A00,201433,Staff,32,0,49,17
1683309064920,DOC 1,A01,259136,Strom; Megan C.,8,0,15,7
1683309064920,DOC 1,A02,259137,Strom; Megan C.,14,0,15,1
1683309064920,DOC 1,A03,259138,Strom; Megan C.,14,0,15,1
1683309064920,DOC 1,A04,259139,Strom; Megan C.,14,0,15,1
1683309065944,DOC 100D,A00,259140,Pass; Natalye Joann,17,0,25,8
1683309066972,DSGN 1,A01,184749,Rill; Bryan,0,24,30,30
1683309067997,DSGN 100,A01,185168,Staff,0,2,25,25
1683309069022,ECE 5,A01,185626,Morris; Karcher William,0,10,0,0
1683309070046,ECE 101,A01,185628,Staff,17,0,70,53
1683309071074,ECE 107,A01,185635,Baghdadchi; Saharnaz,0,0,20,20
1683309071074,ECE 107,A02,185638,Baghdadchi; Saharnaz,4,0,20,16
1683309072103,ECE 148,A01,185647,Silberman; Jack,0,0,16,16
1683309073128,ECON 1,A01,185537,Crane; Meredith Helen,54,0,70,16
1683309074155,ECON 3,A01,185549,Crane; Meredith Helen,33,0,70,37
1683309075181,ECON 4,A01,203354,Anderson; John Charles,0,4,10,10
1683309076204,ECON 100A,A01,185574,Staff,0,4,40,40
1683309077228,ECON 100B,A01,185576,Staff,0,22,40,40
1683309078256,ECON 100C,A01,185589,Newhouse; Herbert S,30,0,70,40
1683309079280,ECON 105,A00,185608,Vespa; Emanuel Ignacio,19,0,35,16
1683309080304,ECON 109,A01,185610,Shishkin; Denis,10,0,35,25
1683309081331,ECON 110A,A01,185612,Staff,11,0,40,29
1683309082355,ECON 120A,A01,185615,Staff,20,0,40,20
1683309083380,ECON 120C,A01,185617,Sun; Yixiao,0,20,70,70
1683309084405,ECON 144,A00,203346,Squires; Dale E,3,0,35,32
1683309085432,ECON 171,A01,203349,Newhouse; Herbert S,0,1,35,35
1683309086455,ECON 173A,A01,185621,Toda; Alexis Akira,21,0,35,14
1683309087480,EDS 25,A01,202413,Staff,0,1,0,0
1683309087480,EDS 25,A02,202414,Staff,0,1,0,0
1683309087480,EDS 25,A03,202415,Staff,0,0,0,0
1683309087480,EDS 25,A04,202416,Staff,0,1,0,0
1683309087480,EDS 25,A05,202439,Staff,0,0,0,0
1683309087480,EDS 25,A06,202440,Staff,0,0,0,0
1683309087480,EDS 25,B01,202631,Staff,0,0,0,0
1683309087480,EDS 25,B02,202632,Staff,0,0,0,0
1683309087480,EDS 25,B03,202639,Staff,0,0,0,0
1683309087480,EDS 25,B04,202640,Staff,0,0,0,0
1683309087480,EDS 25,B05,202643,Staff,0,0,0,0
1683309087480,EDS 25,B06,202644,Staff,0,0,0,0
1683309088505,EDS 38,A01,202659,Black; Alison Michelle,24,0,25,1
1683309089533,EDS 115,A00,202652,Staff,17,0,30,13
1683309090557,EDS 125,A00,202649,Staff,14,0,30,16
1683309091581,EDS 126,A01,203332,Staff,30,0,30,0
1683309092605,EDS 139,A00,202838,Staff,17,0,25,8
1683309093632,EDS 146,A01,202655,Staff,15,0,25,10
1683309094660,ENG 15,A00,185667,Staff,0,1,0,0
1683309094660,ENG 15,B00,185672,Staff,0,0,0,0
1683309094660,ENG 15,C00,185675,Staff,0,0,0,0
1683309094660,ENG 15,D00,185682,Staff,0,0,0,0
1683309094660,ENG 15,E00,185684,Staff,0,0,0,0
1683309095686,ETHN 103,A00,185710,Staff,0,3,35,35
1683309096710,ETHN 103A,A00,199228,Man; Simeon S,2,0,9,7
1683309097735,ETHN 109,A00,185711,Staff,18,0,35,17
1683309098759,ETHN 142,A00,185726,Staff,0,4,30,30
1683309099782,ETHN 163J,A00,199229,Man; Simeon S,6,0,8,2
1683309100805,ETHN 168,A00,185727,Staff,8,0,10,2
1683309101831,ETHN 182,A00,185728,Staff,1,0,35,34
1683309102857,ETHN 183,A00,185737,Staff,8,0,18,10
1683309103885,GLBH 111,A01,209361,Burgos; Jose L.,0,0,0,0
1683309105936,HIEU 104,A00,185792,Staff,16,0,20,4
1683309106960,HIEU 115,A00,185800,Staff,1,0,20,19
1683309108041,HIEU 128,A00,185801,Staff,0,7,20,20
1683309109068,HIEU 147,A00,185802,Staff,16,0,20,4
1683309110095,HIEU 154,A00,185823,Staff,12,0,20,8
1683309111120,HILA 102,A00,185826,Staff,13,0,20,7
1683309112142,HILD 2C,A01,185778,Staff,0,12,20,20
1683309113165,HILD 7B,A01,185780,Kwak; Nancy,0,15,32,32
1683309113165,HILD 7B,A02,185781,Kwak; Nancy,0,18,32,32
1683309114190,HILD 30,A01,185791,Staff,14,0,20,6
1683309115213,HISC 119,A00,185830,Golan; Tal,0,9,20,20
1683309116237,HITO 156GS,A00,185831,Patterson; Patrick H.,0,0,0,23
1683309117265,HIUS 103,A00,185832,Man; Simeon S,0,6,20,20
1683309118287,HIUS 117,A00,185836,Kwak; Nancy,2,0,20,18
1683309119311,HIUS 125,A00,185840,Man; Simeon S,0,0,23,23
1683309120338,HIUS 149,A00,185845,Staff,0,0,20,20
1683309121363,HUM 3,A01,185882,Zavodny; Tatiana Sophia,0,6,50,50
1683309121363,HUM 3,B01,185899,Caldwell; Michael Alan,0,19,50,50
1683309122389,HUM 3GS,A00,185900,Patterson; Patrick H.,0,0,0,23
1683309123413,HUM 4,A01,185938,Zroka; Amy Liane,31,0,50,19
1683309123413,HUM 4,B01,185956,Watkins; Eric,0,2,50,50
1683309123413,HUM 4,B02,202209,Watkins; Eric,0,2,50,50
1683309123413,HUM 4,B03,202210,Watkins; Eric,0,0,50,50
1683309124437,HUM 5,A01,185958,West; Geoffrey Scott,4,0,50,46
1683309124437,HUM 5,A02,202215,West; Geoffrey Scott,0,0,50,50
1683309125463,INTL 190,A00,185959,Gagnon; Jeffrey C,0,0,0,9
1683309125463,INTL 190,B00,185960,Lettieri; Michael Joseph,0,0,0,1
1683309126490,JAPN 180,A00,254509,Staff,5,1,30,25
1683309127515,LATI 10,A01,202853,Kennemore; Amy Michelle,5,0,35,30
1683309127515,LATI 10,A02,202854,Kennemore; Amy Michelle,1,0,35,34
1683309127515,LATI 10,A03,270054,Kennemore; Amy Michelle,30,0,30,0
1683309128542,LATI 180,A00,202855,Kennemore; Amy Michelle,11,0,20,9
1683309129568,LAWS 101,A00,201767,Golan; Tal,0,7,40,40
1683309130593,LIFR 1C,A00,185961,Staff,6,0,20,14
1683309131618,LIFR 1CX,A00,185962,Staff,7,0,20,13
1683309132645,LIFR 1D,A00,185963,Staff,9,0,20,11
1683309133671,LIFR 1DX,A00,185964,Staff,9,0,20,11
1683309134695,LIGN 101,A01,186039,Staff,43,0,50,7
1683309135722,LIGN 165,A00,186040,Staff,18,0,50,32
1683309136750,LTCS 108,A00,186041,Staff,6,0,10,4
1683309137773,LTCS 119,A00,186042,Staff,16,0,20,4
1683309138800,LTCS 130,A00,186043,Wesling; Megan E.,15,0,25,10
1683309140849,LTEA 138,A00,186119,Staff,14,0,40,26
1683309141876,LTEN 124,A00,186148,Staff,6,0,25,19
1683309142902,LTEN 178,A00,186149,Staff,7,0,15,8
1683309143926,LTEN 181,A00,186150,Blanco; John D,33,0,40,7
1683309144951,LTWL 120,A00,186160,Staff,20,0,25,5
1683309145975,LTWL 165,A00,186161,Staff,22,0,25,3
1683309146999,LTWR 100,A00,186162,Staff,0,4,15,15
1683309148023,LTWR 102,A00,186163,Doller; Ben,5,0,15,10
1683309149045,MAE 8,A01,186412,Staff,0,0,0,0
1683309150072,MAE 30B,A00,186445,Bahadori; Mohammad Yousef,83,0,100,17
1683309151098,MAE 40,A00,186592,Bewley; Thomas R,9,0,50,41
1683309152124,MAE 101B,A00,186593,Bahadori; Mohammad Yousef,81,0,100,19
1683309153149,MAE 105,A00,186594,Bandaru; Prabhakar,12,0,50,38
1683309154174,MAE 107,A00,186599,Pham; Hieu Tan,0,6,120,120
1683309155202,MAE 148,A01,186660,Silberman; Jack,3,0,16,13
1683309156225,MATH 10A,A01,188095,Staff,0,7,35,35
1683309157250,MATH 10B,A01,188097,Bowers; Adam R.,0,11,30,30
1683309157250,MATH 10B,A02,188099,Bowers; Adam R.,0,10,30,30
1683309157250,MATH 10B,B01,188104,Bowers; Adam R.,0,11,30,30
1683309157250,MATH 10B,B02,188106,Bowers; Adam R.,0,11,30,30
1683309158277,MATH 10C,A01,188111,Staff,0,18,30,30
1683309158277,MATH 10C,A02,188127,Staff,0,17,30,30
1683309158277,MATH 10C,A03,188131,Staff,0,17,30,30
1683309158277,MATH 10C,B01,188218,Staff,21,0,30,9
1683309158277,MATH 10C,B02,188244,Staff,13,0,30,17
1683309158277,MATH 10C,B03,188277,Staff,16,0,30,14
1683309159302,MATH 18,A01,188344,Bach; Quang Tran,18,0,30,12
1683309159302,MATH 18,A02,188345,Bach; Quang Tran,11,0,30,19
1683309159302,MATH 18,B01,188353,Bach; Quang Tran,10,0,30,20
1683309159302,MATH 18,B02,188354,Bach; Quang Tran,20,0,30,10
1683309160329,MATH 20A,A01,188374,Staff,13,0,35,22
1683309161355,MATH 20B,A01,188382,Ohm; Ko Woon,6,0,30,24
1683309161355,MATH 20B,A02,188383,Ohm; Ko Woon,23,0,30,7
1683309161355,MATH 20B,B01,188385,Ohm; Ko Woon,7,0,30,23
1683309161355,MATH 20B,B02,188392,Ohm; Ko Woon,22,0,30,8
1683309162380,MATH 20C,A01,188394,Harel; Guershon,10,0,30,20
1683309162380,MATH 20C,A02,188395,Harel; Guershon,13,0,30,17
1683309162380,MATH 20C,B01,188404,Harel; Guershon,3,0,30,27
1683309162380,MATH 20C,B02,188405,Harel; Guershon,19,0,30,11
1683309163403,MATH 20D,A01,188414,Hammock; Frances H,0,1,30,30
1683309163403,MATH 20D,A02,188415,Hammock; Frances H,4,0,30,26
1683309163403,MATH 20D,B01,188447,Hammock; Frances H,2,0,30,28
1683309163403,MATH 20D,B02,188486,Hammock; Frances H,8,0,30,22
1683309164432,MATH 20E,A01,188649,Staff,22,0,30,8
1683309164432,MATH 20E,A02,188650,Staff,23,0,30,7
1683309164432,MATH 20E,A03,188673,Staff,0,0,30,30
1683309165457,MATH 102,A01,188675,Staff,0,35,35,35
1683309166481,MATH 103B,A01,188681,Staff,4,0,35,31
1683309166481,MATH 103B,B01,188692,Staff,7,0,35,28
1683309167506,MATH 109,A01,188695,Salehi Golsefidy; Alireza,25,0,35,10
1683309167506,MATH 109,A02,188696,Salehi Golsefidy; Alireza,27,0,35,8
1683309168533,MATH 120A,A01,188698,Eggers; John Dietrich,6,0,35,29
1683309169561,MATH 142B,A01,188736,Ioana; Adrian,0,2,30,30
1683309169561,MATH 142B,A02,188741,Ioana; Adrian,0,1,30,30
1683309169561,MATH 142B,A03,188743,Ioana; Adrian,1,3,30,29
1683309170584,MATH 168A,A01,188790,Staff,0,9,35,35
1683309171607,MATH 170A,A01,188803,Nie; Jiawang,0,2,35,35
1683309171607,MATH 170A,A02,188811,Nie; Jiawang,0,0,35,35
1683309171607,MATH 170A,A03,188814,Nie; Jiawang,1,0,35,34
1683309171607,MATH 170A,A04,188815,Nie; Jiawang,13,0,35,22
1683309172634,MATH 193B,A01,188817,Staff,0,0,35,35
1683309172634,MATH 193B,A02,188818,Staff,5,0,35,30
1683309173661,MGT 4,A01,202857,Anderson; John Charles,62,0,80,18
1683309174684,MGT 12,A00,202858,Lindenberger; Wade Douglas,43,0,90,47
1683309175708,MGT 18,A00,202859,Staff,74,0,90,16
1683309176732,MGT 18GS,A00,202860,McKay; Michael J,13,0,28,15
1683309177785,MGT 45,A00,202861,Pecore; Joseph P.,14,0,90,76
1683309178810,MGT 100,A00,202863,Yavorsky; Daniel Ryan,28,0,90,62
1683309179835,MGT 103,A00,202864,Ehrich; Kristine R,0,16,90,90
1683309180859,MGT 112,A00,202865,Ehrich; Kristine R,15,0,90,75
1683309181887,MGT 121A,A00,202868,Staff,0,19,0,0
1683309182914,MGT 131B,A00,202869,Anderson; John Charles,59,0,90,31
1683309183937,MGT 136,A00,202871,Lindenberger; Wade Douglas,84,0,90,6
1683309184961,MGT 164,A00,202873,Staff,0,69,90,90
1683309185985,MGT 164GS,A00,202874,McKay; Mary A,13,0,28,15
1683309187010,MGT 180,A00,202875,Staff,0,51,90,90
1683309188033,MMW 11R,A01,205019,Herbst; Matthew,3,0,30,27
1683309188033,MMW 11R,A02,205026,Herbst; Matthew,29,0,30,1
1683309189062,MMW 15,A01,193512,Chang; Edmond Yi-Teh,0,9,28,28
1683309189062,MMW 15,A02,193513,Chang; Edmond Yi-Teh,0,5,28,28
1683309189062,MMW 15,A03,193514,Chang; Edmond Yi-Teh,0,5,28,28
1683309189062,MMW 15,A04,193515,Chang; Edmond Yi-Teh,0,5,28,28
1683309189062,MMW 15,A05,193516,Chang; Edmond Yi-Teh,0,4,28,28
1683309189062,MMW 15,A06,193517,Chang; Edmond Yi-Teh,0,5,28,28
1683309189062,MMW 15,B01,193519,Chang; Edmond Yi-Teh,0,4,28,28
1683309189062,MMW 15,B02,193520,Chang; Edmond Yi-Teh,0,5,28,28
1683309189062,MMW 15,B03,193521,Chang; Edmond Yi-Teh,0,4,28,28
1683309189062,MMW 15,B04,193522,Chang; Edmond Yi-Teh,0,4,28,28
1683309189062,MMW 15,B05,193523,Chang; Edmond Yi-Teh,0,5,28,28
1683309189062,MMW 15,B06,193524,Chang; Edmond Yi-Teh,0,4,28,28
1683309190084,MMW 122,A01,193526,Rahimi; Babak,0,14,28,28
1683309190084,MMW 122,A02,193527,Rahimi; Babak,0,14,28,28
1683309190084,MMW 122,A03,193528,Rahimi; Babak,0,0,0,0
1683309190084,MMW 122,A04,193529,Rahimi; Babak,0,0,0,0
1683309191108,MUS 1A,A01,186663,Staff,0,20,35,35
1683309192132,MUS 4,A01,186715,Staff,0,12,35,35
1683309193155,MUS 5R,A01,186796,Dubnov; Shlomo,0,17,35,35
1683309194181,MUS 6,A01,186798,Staff,0,3,25,25
1683309195205,MUS 7,A01,186830,Staff,12,0,35,23
1683309196234,MUS 8,A01,186930,Staff,0,26,35,35
1683309197262,MUS 15,A01,186932,Staff,0,15,35,35
1683309197262,MUS 15,B01,186934,Staff,0,15,35,35
1683309198290,MUS 80,A00,186935,Staff,2,0,20,18
1683309198290,MUS 80,B00,186936,Staff,25,0,25,0
1683309199315,NANO 11,A00,204702,Lipomi; Darren John,0,0,0,0
1683309200340,NANO 15,A01,204709,Yang; Kesong,0,1,0,0
1683309201364,NANO 114,A00,202069,Jahed Motlagh; Zeinab,3,0,10,7
1683309202389,PHIL 1,A00,186955,Grush; Rick Scott,32,0,40,8
1683309203418,PHIL 10,A01,186973,Grush; Rick Scott,28,0,35,7
1683309203418,PHIL 10,A02,186974,Grush; Rick Scott,33,0,35,2
1683309204445,PHIL 13,A01,186976,Staff,7,0,35,28
1683309204445,PHIL 13,A02,186977,Staff,16,0,35,19
1683309205469,PHIL 14,A01,186979,Staff,31,0,35,4
1683309205469,PHIL 14,A02,186986,Staff,32,0,35,3
1683309206493,PHIL 28,A01,186988,Staff,16,0,30,14
1683309206493,PHIL 28,A02,186989,Staff,1,0,30,29
1683309206493,PHIL 28,A03,186990,Staff,9,0,30,21
1683309206493,PHIL 28,A04,186991,Staff,26,0,30,4
1683309207517,PHIL 120,A00,186997,Staff,23,0,40,17
1683309208541,PHIL 137,A00,187003,Staff,9,0,40,31
1683309209568,PHIL 150,A00,187015,Staff,47,0,70,23
1683309210593,PHIL 167,A00,187021,Lamey; Andy M.,35,0,40,5
1683309211675,PHIL 174,A01,202226,Staff,17,0,20,3
1683309211675,PHIL 174,A02,202235,Staff,20,0,20,0
1683309212698,PHIL 191A,A00,258918,Staff,0,0,1,1
1683309213722,PHYS 1A,A00,187028,Staff,27,0,60,33
1683309214746,PHYS 1AL,001,187036,Staff,3,0,30,27
1683309214746,PHYS 1AL,002,187049,Staff,18,0,30,12
1683309215773,PHYS 1B,A00,187058,Staff,23,0,60,37
1683309216801,PHYS 1BL,001,187064,Staff,0,0,30,30
1683309216801,PHYS 1BL,002,187070,Staff,6,0,30,24
1683309217827,PHYS 1C,A00,187082,Staff,31,0,120,89
1683309218853,PHYS 1CL,001,187088,Staff,0,9,30,30
1683309218853,PHYS 1CL,002,187089,Staff,0,2,30,30
1683309218853,PHYS 1CL,009,262693,Staff,11,0,30,19
1683309219878,PHYS 2B,A01,187097,Staff,54,0,115,61
1683309220903,PHYS 2C,A01,187099,Staff,67,0,115,48
1683309221929,PHYS 2CL,A01,187101,Staff,5,0,28,23
1683309221929,PHYS 2CL,A02,187102,Staff,15,0,28,13
1683309222954,PHYS 2D,A01,187123,Shotwell; Brian,95,0,115,20
1683309223980,PHYS 4B,A01,187133,Grinstein; Benjamin,35,0,50,15
1683309225010,POLI 10,A00,188819,Staff,0,3,50,50
1683309226034,POLI 11,A00,188827,Staff,43,0,50,7
1683309227061,POLI 13R,A00,188828,Staff,0,1,20,20
1683309228086,POLI 27,A01,188830,Elgin; Samuel Zincke,0,1,70,70
1683309229110,POLI 30,A00,188832,Desposato; Scott,33,0,50,17
1683309230134,POLI 102F,A00,188834,Staff,3,0,40,37
1683309231160,POLI 104A,A00,188852,Staff,14,0,30,16
1683309232188,POLI 104I,A00,188853,Staff,0,6,20,20
1683309233216,POLI 110B,A00,188854,Wiens; David,7,0,20,13
1683309234239,POLI 112A,A00,188855,Wiens; David,5,0,30,25
1683309235263,POLI 117R,A00,188856,Forman; Fonna,0,11,20,20
1683309236289,POLI 118,A00,188857,Ingham; Sean,8,0,20,12
1683309237318,POLI 120G,A00,188858,Staff,9,0,30,21
1683309238340,POLI 131CR,A00,188863,Hoston; Germaine,24,0,50,26
1683309239364,POLI 133,A00,188864,Nellis; Gareth Hb,44,0,50,6
1683309240387,POLI 134D,A00,188865,Desposato; Scott,27,0,30,3
1683309241415,POLI 142A,A00,188871,Gartzke; Erik,22,0,50,28
1683309242441,POLI 142K,A00,188874,Staff,38,0,50,12
1683309243469,POLI 143,A00,188940,Gartzke; Erik,16,0,30,14
1683309244509,POLI 153,A00,188943,Staff,3,0,20,17
1683309245534,POLI 160AA,A00,188944,Staff,13,0,40,27
1683309246559,POLI 170A,A00,188945,Staff,11,0,30,19
1683309248612,PSYC 1,A00,188952,Staff,37,0,90,53
1683309249636,PSYC 2,B00,188953,Staff,20,0,35,15
1683309250664,PSYC 6,A00,188970,Staff,47,0,60,13
1683309251689,PSYC 7,A00,188973,Staff,37,0,45,8
1683309252713,PSYC 60,A01,188980,Rickard; Timothy C.,43,0,60,17
1683309253738,PSYC 70,A01,189001,Steiner; Eric Tomas,24,0,45,21
1683309254763,PSYC 100,A00,189005,Lacefield; Katharine I,0,99,120,120
1683309255793,PSYC 102,A00,189008,Staff,10,0,30,20
1683309256821,PSYC 106,B00,189026,Gorman; Michael R.,37,0,60,23
1683309257845,PSYC 114,B01,189033,Winkielman; Piotr,0,32,30,30
1683309258875,PSYC 131,A00,189036,Anagnostaras; Stephan,0,43,60,60
1683309259902,PSYC 136,A00,189041,Lowe; Angela Beth,0,7,25,25
1683309260929,PSYC 137,A00,189057,Winkielman; Piotr,0,34,25,25
1683309261955,PSYC 144,A00,189107,Wixted; John T,0,7,50,50
1683309264007,PSYC 162,A00,189142,Staff,0,8,85,85
1683309265034,PSYC 172,A00,189144,Gorman; Michael R.,0,7,30,30
1683309267085,PSYC 179,A00,189146,Lacefield; Katharine I,0,84,120,120
1683309268108,PSYC 181,A00,189147,Anagnostaras; Stephan,0,44,90,90
1683309269133,PSYC 190R,A00,189148,Barner; David A.,0,22,80,80
1683309270164,PSYC 191,A00,189275,Rickard; Timothy C.,0,7,25,25
1683309271193,PSYC 193,A00,189276,Chapman; Eddie Nathaniel,0,1,0,4
1683309272221,PSYC 193L,A01,189281,Lowe; Angela Beth,12,0,20,8
1683309272221,PSYC 193L,B01,189285,Staff,28,0,35,7
1683309273245,RELI 149,A00,187137,Rahimi; Babak,7,0,40,33
1683309274272,SE 9,A01,187315,Staff,0,2,18,18
1683309275296,SE 101B,A00,187409,Staff,24,0,30,6
1683309276321,SE 110B,A00,187444,Staff,10,0,40,30
1683309277344,SE 130B,A00,187449,Staff,31,0,40,9
1683309278368,SE 150A,A00,187516,Staff,9,0,20,11
1683309279395,SE 154,A00,187528,Staff,30,0,50,20
1683309280418,SIO 3,A01,258171,Staff,35,0,40,5
1683309281439,SIO 10,A00,187144,Cook; Geoffrey W,0,3,75,75
1683309282462,SIO 45,A00,187152,Cook; Geoffrey W,1,0,100,99
1683309283486,SIO 109R,A00,194486,Staff,0,3,20,20
1683309285535,SIO 187,A01,187233,Kacev; David,12,0,40,28
1683309286558,SOCI 1,A01,258656,Thorpe; Charles Robert,28,0,30,2
1683309286558,SOCI 1,A02,258658,Thorpe; Charles Robert,30,0,30,0
1683309286558,SOCI 1,A03,258661,Thorpe; Charles Robert,25,0,25,0
1683309286558,SOCI 1,A04,258666,Thorpe; Charles Robert,22,0,25,3
1683309286558,SOCI 1,A05,258897,Thorpe; Charles Robert,23,0,25,2
1683309286558,SOCI 1,A06,258898,Thorpe; Charles Robert,25,0,25,0
1683309287585,SOCI 30,A01,258903,Pardo Guerra; Juan Pablo,16,0,30,14
1683309288609,SOCI 102,A00,258904,Staff,9,0,25,16
1683309289636,SOCI 106,A00,258905,Staff,19,0,25,6
1683309290664,SOCI 111,A00,258907,Ribas Norris; Janet Vanesa,26,0,30,4
1683309291691,SOCI 121R,A00,258908,Pardo Guerra; Juan Pablo,11,0,30,19
1683309292718,SOCI 126,A01,203330,Staff,14,0,20,6
1683309293741,SOCI 131,A00,258909,Thorpe; Charles Robert,31,0,60,29
1683309294765,SOCI 135,A00,258910,Payne; Christine Anna,0,9,30,30
1683309295788,SOCI 157,A00,258911,Staff,13,0,30,17
1683309296812,SOCI 184,A00,258912,Staff,26,0,30,4
1683309297837,SOCI 188D,A00,258913,Staff,21,0,30,9
1683309298861,SYN 2,001,187529,Staff,9,0,16,7
1683309298861,SYN 2,002,201452,Staff,0,18,16,16
1683309298861,SYN 2,003,201469,Staff,3,0,16,13
1683309299885,SYN 100,A01,187531,Staff,0,9,20,20
1683309299885,SYN 100,B01,201491,Staff,0,12,20,20
1683309300908,TDAC 1,A00,189286,Walsh; Kim C.,3,0,20,17
1683309300908,TDAC 1,B00,189287,Harting; Carla Kelso,11,0,20,9
1683309301937,TDAC 101,A00,189300,Walsh; Kim C.,16,0,20,4
1683309301937,TDAC 101,B00,189301,Harting; Carla Kelso,18,0,20,2
1683309302959,TDAC 102,A00,189304,Basso; Beatrice,14,0,20,6
1683309303986,TDAC 108,A00,189305,Staff,18,0,20,2
1683309305012,TDDE 131,A00,189310,Staff,19,0,20,1
1683309305012,TDDE 131,B00,189314,Staff,19,0,20,1
1683309305012,TDDE 131,C00,189315,Staff,48,0,50,2
1683309305012,TDDE 131,D00,189316,Staff,14,0,15,1
1683309305012,TDDE 131,E00,204841,Staff,20,0,20,0
1683309306036,TDGE 10,A00,189289,Staff,30,0,50,20
1683309306036,TDGE 10,B00,189290,Havis; Allan,2,0,50,48
1683309307064,TDGE 11,A00,189291,Fulton; Julia,0,3,50,50
1683309307064,TDGE 11,B00,189292,Staff,20,0,25,5
1683309307064,TDGE 11,C00,260270,Staff,0,0,0,0
1683309308089,TDGE 25,A00,189294,Staff,3,0,20,17
1683309309112,TDGE 124,A00,189318,Fulton; Julia,0,8,50,50
1683309310138,TDGE 125,A00,189319,Staff,13,0,25,12
1683309310138,TDGE 125,B00,189320,Staff,23,0,25,2
1683309311162,TDGE 127,A00,189322,Havis; Allan,0,0,50,50
1683309312189,TDHT 101,A00,189323,Staff,18,0,25,7
1683309312189,TDHT 101,B00,189324,Staff,25,0,25,0
1683309313215,TDHT 102,A00,189325,Staff,49,0,50,1
1683309314240,TDMV 1,A00,189295,Arcidiacono; Kristin,20,0,30,10
1683309314240,TDMV 1,B00,189296,Caligagan; Maria T.,24,0,30,6
1683309315326,TDMV 2,A00,189297,Sammartano; Tonnie,28,0,30,2
1683309315326,TDMV 2,B00,189299,Arcidiacono; Kristin,24,0,30,6
1683309316352,TDMV 3,A00,204998,Rincon; Alicia,22,0,30,8
1683309317376,TDMV 120,A00,189458,Sammartano; Tonnie,28,0,30,2
1683309318400,TDMV 138,A00,189541,Jun; Grace Shin Hae,22,0,40,18
1683309319426,TDMV 142,A00,189717,Caligagan; Tony,23,0,30,7
1683309319426,TDMV 142,B00,189718,Caligagan; Maria T.,25,0,30,5
1683309320454,TMC 2,A01,187533,Staff,25,0,25,0
1683309320454,TMC 2,A02,187534,Staff,25,0,25,0
1683309321478,USP 1,A01,187536,Kwak; Nancy,0,16,25,25
1683309322506,USP 5,A01,187538,Staff,9,0,25,16
1683309323533,USP 101,A00,199253,Staff,0,4,0,0
1683309324558,USP 124,A00,187562,Boomhower; Matthew Charles,1,0,30,29
1683309325585,USP 138,A00,187582,Staff,20,0,25,5
1683309326610,USP 152,A01,187597,Staff,4,0,25,21
1683309327636,USP 153,A00,187598,Staff,19,0,25,6
1683309328662,USP 168,A00,187607,Kwak; Nancy,2,0,5,3
1683309329689,USP 173,A00,187619,Staff,4,0,25,21
1683309330717,USP 181,A00,187638,Staff,0,0,25,25
1683309331744,VIS 103,A00,187650,Cruz; Edwin Teddy,23,0,75,52
1683309332767,VIS 110D,A00,187669,Staff,12,0,22,10
1683309333791,VIS 127C,A00,187720,Shen; Kuiyi,68,0,146,78
1683309334815,VIS 149,A00,187731,Yoldas; Pinar,0,14,22,22
1683309335845,VIS 151,A01,188091,Staff,22,0,34,12
1683309335845,VIS 151,A02,188092,Staff,11,0,34,23
1683309336869,VIS 160B,A00,188093,Stalbaum; Brett,0,0,10,10
1683309338917,WCWP 10B,A00,201720,Staff,10,0,15,5
1683309338917,WCWP 10B,B00,201722,Staff,8,0,15,7
1683309339945,WCWP 100,A00,201725,Gagnon; Jeffrey C,0,0,2,2
1683309339945,WCWP 100,B00,201727,Staff,0,4,15,15
1683309343065,ANBI 133,A00,258401,Wilder; Linnea Lorene,34,0,40,6
1683309344090,ANBI 140,A00,258395,Hrvoj Mihic; Branka,18,0,25,7
1683309345113,ANSC 120,A00,258402,Bialecki; Jon Anthony,27,0,40,13
1683309346142,ANSC 144,A00,258400,Staff,14,0,40,26
1683309348194,ANSC 166,A00,258396,Parish; Steven Martin,157,0,175,18
1683309349217,ANSC 180,A00,193533,Staff,9,0,20,11
1683309350241,ANSC 188,A00,258397,Jassal; Aftab,33,0,40,7
1683309351267,ANTH 3,A01,258316,Staff,23,0,30,7
1683309352290,ANTH 5,A00,258394,Semendeferi; Ekaterini,16,0,20,4
1683309353315,ANTH 21,A01,258331,Staff,9,0,40,31
1683309354339,ANTH 103,A00,258398,Varma; Saiba,15,0,25,10
1683309355367,AWP 10,001,202034,Staff,0,0,0,0
1683309355367,AWP 10,002,202035,Staff,0,0,0,0
1683309355367,AWP 10,003,202036,Staff,0,0,0,0
1683309355367,AWP 10,004,202037,Staff,0,0,0,0
1683309355367,AWP 10,005,202038,Staff,0,0,0,0
1683309355367,AWP 10,006,202039,Staff,0,0,0,0
1683309355367,AWP 10,007,202040,Staff,0,0,0,0
1683309355367,AWP 10,008,202041,Staff,0,0,0,0
1683309355367,AWP 10,009,202042,Staff,0,0,0,0
1683309355367,AWP 10,010,202043,Staff,0,0,0,0
1683309355367,AWP 10,011,202044,Staff,0,0,0,0
1683309355367,AWP 10,012,202045,Staff,0,0,0,0
1683309355367,AWP 10,013,202046,Staff,0,0,0,0
1683309355367,AWP 10,014,202047,Staff,0,0,0,0
1683309355367,AWP 10,015,202048,Staff,0,0,0,0
1683309355367,AWP 10,016,202049,Staff,0,0,0,0
1683309355367,AWP 10,017,202050,Staff,0,0,0,0
1683309355367,AWP 10,018,202051,Staff,0,0,0,0
1683309355367,AWP 10,019,202052,Staff,0,0,0,0
1683309355367,AWP 10,020,202053,Staff,0,0,0,0
1683309355367,AWP 10,021,202054,Staff,0,0,0,0
1683309355367,AWP 10,022,202055,Staff,0,0,0,0
1683309355367,AWP 10,023,202056,Staff,0,0,0,0
1683309355367,AWP 10,024,202057,Staff,0,0,0,0
1683309355367,AWP 10,025,202058,Staff,0,0,0,0
1683309355367,AWP 10,026,202059,Staff,0,0,0,0
1683309356391,AWP 102,001,202032,Staff,0,0,0,0
1683309356391,AWP 102,002,202033,Staff,0,0,0,0
1683309357419,BENG 100,A01,254234,Taylor Amos; Alyssa C,31,0,40,9
1683309358444,BENG 196,001,270013,Engler; Adam J.,9999,0,9999,0
1683309359470,BICD 100R,A01,202018,Smith; Laurie,0,7,32,32
1683309359470,BICD 100R,A02,202019,Smith; Laurie,0,2,32,32
1683309359470,BICD 100R,A03,202020,Smith; Laurie,0,1,32,32
1683309359470,BICD 100R,A04,202021,Smith; Laurie,8,0,32,24
1683309359470,BICD 100R,A05,202022,Smith; Laurie,12,0,32,20
1683309360492,BICD 136,A01,193242,Gustafson-Brown; Cindy,0,2,32,32
1683309360492,BICD 136,A02,193244,Gustafson-Brown; Cindy,15,0,32,17
1683309361523,BIEB 102,A01,193249,Butler; Shannon Rhey,0,2,32,32
1683309361523,BIEB 102,A02,193251,Butler; Shannon Rhey,0,0,32,32
1683309361523,BIEB 102,A03,193253,Butler; Shannon Rhey,0,1,32,32
1683309361523,BIEB 102,A04,193255,Butler; Shannon Rhey,17,0,32,15
1683309361523,BIEB 102,A05,193265,Butler; Shannon Rhey,26,0,32,6
1683309361523,BIEB 102,A06,193269,Butler; Shannon Rhey,16,0,32,16
1683309363575,BIEB 150,A01,193274,Staff,0,0,32,32
1683309363575,BIEB 150,A02,193285,Staff,24,0,32,8
1683309364599,BIEB 194,A00,193286,Kurle; Carolyn M.,22,0,32,10
1683309365627,BILD 1,A01,192291,Staff,16,0,32,16
1683309365627,BILD 1,A02,192292,Staff,30,0,32,2
1683309365627,BILD 1,B01,192520,Reuther; Keefe,0,1,0,0
1683309365627,BILD 1,B02,192532,Reuther; Keefe,0,1,0,0
1683309366657,BILD 3,A01,192556,Butler; Shannon Rhey,0,0,32,32
1683309366657,BILD 3,A02,192581,Butler; Shannon Rhey,5,0,32,27
1683309366657,BILD 3,A03,192611,Butler; Shannon Rhey,23,0,32,9
1683309366657,BILD 3,A04,192612,Butler; Shannon Rhey,25,0,32,7
1683309366657,BILD 3,A05,192613,Butler; Shannon Rhey,27,0,32,5
1683309366657,BILD 3,A06,192679,Butler; Shannon Rhey,27,0,32,5
1683309366657,BILD 3,A07,192682,Butler; Shannon Rhey,22,0,32,10
1683309367681,BILD 4,A01,192836,Reuther; Keefe,1,0,24,23
1683309367681,BILD 4,A02,193044,Reuther; Keefe,4,0,24,20
1683309368707,BILD 10,A01,193142,Gustafson-Brown; Cindy,31,0,32,1
1683309368707,BILD 10,A02,193149,Gustafson-Brown; Cindy,31,0,32,1
1683309369736,BIMM 100,A01,193301,Staff,0,6,32,32
1683309369736,BIMM 100,A02,193312,Staff,0,5,32,32
1683309369736,BIMM 100,A03,193323,Staff,0,8,32,32
1683309370761,BIMM 101,A01,193329,McDonnell; Lisa Marie,0,3,24,24
1683309370761,BIMM 101,A02,193339,McDonnell; Lisa Marie,0,2,24,24
1683309370761,BIMM 101,B01,193354,McDonnell; Lisa Marie,0,3,24,24
1683309370761,BIMM 101,B02,193357,McDonnell; Lisa Marie,0,3,24,24
1683309371790,BIMM 110,A01,193377,Tat; John,0,11,32,32
1683309371790,BIMM 110,A02,193378,Tat; John,1,9,32,31
1683309372818,BIMM 120,A01,206116,Staff,0,0,32,32
1683309372818,BIMM 120,A02,206117,Staff,8,0,32,24
1683309372818,BIMM 120,A03,206121,Staff,21,0,32,11
1683309373843,BIPN 100,A01,193393,Park; Ji Young,0,14,32,32
1683309373843,BIPN 100,A02,193402,Park; Ji Young,0,12,32,32
1683309373843,BIPN 100,A03,193413,Park; Ji Young,0,14,32,32
1683309373843,BIPN 100,A04,193414,Park; Ji Young,0,13,32,32
1683309374873,BIPN 102,A01,193429,Staff,0,0,32,32
1683309374873,BIPN 102,A02,193438,Staff,22,0,32,10
1683309375898,BIPN 106,A01,193450,Reyes Gonzalez; Catalina,0,2,40,40
1683309376924,BIPN 134,A01,193465,Cooke; James Edward,0,0,32,32
1683309376924,BIPN 134,A02,193474,Cooke; James Edward,27,0,32,5
1683309376924,BIPN 134,A03,193485,Cooke; James Edward,29,0,32,3
1683309376924,BIPN 134,A04,193486,Cooke; James Edward,21,0,32,11
1683309376924,BIPN 134,A05,193491,Cooke; James Edward,31,0,32,1
1683309376924,BIPN 134,A06,193501,Cooke; James Edward,30,0,32,2
1683309376924,BIPN 134,A07,193510,Cooke; James Edward,29,0,32,3
1683309378975,BISP 194,A00,222522,Staff,16,0,32,16
1683309380001,CAT 124,A01,202407,Staff,20,0,25,5
1683309381027,CAT 125,A00,202408,Marchisotto; Jennifer Anne,4,0,20,16
1683309382055,CAT 125R,A00,202409,Smith; Lauryn Alissa,0,11,20,20
1683309382055,CAT 125R,B00,202410,Morales; Celeste Georgianna,0,11,20,20
1683309382055,CAT 125R,C00,202411,Irwin; Matthew Joseph,0,10,20,20
1683309383079,CENG 15,A01,204712,Yang; Kesong,0,1,0,0
1683309384106,CENG 114,A00,202070,Jahed Motlagh; Zeinab,5,0,20,15
1683309385132,CGS 105,A00,185477,Wesling; Megan E.,24,0,40,16
1683309386159,CGS 106,A00,185494,Staff,13,0,22,9
1683309387185,CGS 108,A00,185495,Staff,14,0,20,6
1683309388216,CGS 114,A00,185496,Staff,13,0,18,5
1683309389238,CGS 119,A00,185501,Staff,15,0,20,5
1683309390262,CGS 120,A00,185511,Staff,13,0,20,7
1683309391290,CHEM 4,A01,184675,Bussey; Thomas J,96,0,100,4
1683309392318,CHEM 6A,A01,184677,Staff,35,0,60,25
1683309393342,CHEM 6B,A01,184679,Staff,65,0,100,35
1683309394366,CHEM 6C,A01,184681,Bussey; Thomas J,1,0,50,49
1683309394366,CHEM 6C,A02,184682,Bussey; Thomas J,34,0,50,16
1683309395394,CHEM 40A,A01,184684,Albizati; Kim F.,37,0,100,63
1683309396421,CHEM 40B,A01,184686,Albizati; Kim F.,0,20,100,100
1683309397444,CHEM 41B,A01,184690,Staff,52,0,100,48
1683309398472,COGS 3,A01,184715,Boyle; Mary E. T.,0,25,40,40
1683309399498,COGS 14B,A01,185172,Staff,0,15,38,38
1683309400530,COGS 18,A01,184736,Staff,19,0,80,61
1683309401556,COGS 100,A01,184932,Staff,0,5,73,73
1683309402579,COGS 101A,A01,184935,Staff,0,38,30,30
1683309403603,COGS 101B,A01,184944,Staff,0,2,30,30
1683309404630,COGS 101C,A01,184946,Staff,0,12,30,30
1683309405655,COGS 102A,A01,184951,Johnson; Christine M.,2,0,40,38
1683309406683,COGS 107B,A01,184953,Mooshagian; Eric Frederick,0,50,40,40
1683309407707,COGS 118B,A01,184959,Gupta; Anjum,0,48,40,40
1683309408731,COGS 153,A00,184961,Staff,0,15,30,30
1683309409757,COGS 177,A00,184962,Staff,0,21,30,30
1683309410781,COGS 187A,A01,184969,Boyle; Mary E. T.,0,17,40,40
1683309411804,COMM 10,A01,185174,Staff,0,5,25,25
1683309411804,COMM 10,A02,185189,Staff,0,5,25,25
1683309411804,COMM 10,A03,269821,Staff,0,0,0,0
1683309412832,COMM 100B,A01,185475,Staff,0,0,0,2
1683309412832,COMM 100B,A02,185476,Staff,14,0,25,11
1683309413856,COMM 100C,A01,185314,Staff,1,0,25,24
1683309413856,COMM 100C,A02,185327,Staff,19,0,25,6
1683309414880,COMM 110M,A00,185349,Staff,2,0,40,38
1683309415904,COMM 113T,A00,185352,Staff,25,0,40,15
1683309416930,COMM 114I,A00,185353,Staff,33,0,40,7
1683309417954,COMM 131,A00,185354,Staff,19,0,30,11
1683309419055,CSE 8A,A50,185358,Cao; Yingjun,0,46,10,10
1683309420084,CSE 8B,A01,185362,Staff,1,47,50,49
1683309421113,CSE 11,A01,185416,Cao; Yingjun,0,92,10,10
1683309422142,CSE 20,A01,185445,Briones; Jor-el Thomas Caparas,5,0,25,20
1683309423166,CSE 21,A01,185447,Staff,10,0,50,40
1683309424200,CSE 101,A01,185451,Staff,0,12,50,50
1683309424200,CSE 101,B01,185453,Jones; Miles E,0,11,50,50
1683309426249,CSE 141,A01,185458,Eldon; John,20,0,100,80
1683309427271,CSE 141L,A01,185461,Eldon; John,12,0,100,88
1683309428298,CSE 142,A01,185463,Staff,35,0,60,25
1683309428298,CSE 142,B01,201355,Staff,0,6,60,60
1683309429322,CSE 142L,A01,185470,Staff,35,0,60,25
1683309429322,CSE 142L,B01,201417,Staff,0,5,60,60
1683309430350,CSE 190,A00,201433,Staff,32,0,49,17
1683309431373,DOC 1,A01,259136,Strom; Megan C.,8,0,15,7
1683309431373,DOC 1,A02,259137,Strom; Megan C.,14,0,15,1
1683309431373,DOC 1,A03,259138,Strom; Megan C.,14,0,15,1
1683309431373,DOC 1,A04,259139,Strom; Megan C.,14,0,15,1
1683309432400,DOC 100D,A00,259140,Pass; Natalye Joann,17,0,25,8
1683309433428,DSGN 1,A01,184749,Rill; Bryan,0,24,30,30
1683309434456,DSGN 100,A01,185168,Staff,0,2,25,25
1683309435483,ECE 5,A01,185626,Morris; Karcher William,0,10,0,0
1683309436507,ECE 101,A01,185628,Staff,17,0,70,53
1683309437534,ECE 107,A01,185635,Baghdadchi; Saharnaz,0,0,20,20
1683309437534,ECE 107,A02,185638,Baghdadchi; Saharnaz,4,0,20,16
1683309438560,ECE 148,A01,185647,Silberman; Jack,0,0,16,16
1683309439587,ECON 1,A01,185537,Crane; Meredith Helen,54,0,70,16
1683309440612,ECON 3,A01,185549,Crane; Meredith Helen,33,0,70,37
1683309441635,ECON 4,A01,203354,Anderson; John Charles,0,4,10,10
1683309442663,ECON 100A,A01,185574,Staff,0,4,40,40
1683309443690,ECON 100B,A01,185576,Staff,0,22,40,40
1683309444713,ECON 100C,A01,185589,Newhouse; Herbert S,30,0,70,40
1683309445736,ECON 105,A00,185608,Vespa; Emanuel Ignacio,19,0,35,16
1683309446762,ECON 109,A01,185610,Shishkin; Denis,10,0,35,25
1683309447789,ECON 110A,A01,185612,Staff,11,0,40,29
1683309448816,ECON 120A,A01,185615,Staff,20,0,40,20
1683309449840,ECON 120C,A01,185617,Sun; Yixiao,0,20,70,70
1683309450864,ECON 144,A00,203346,Squires; Dale E,3,0,35,32
1683309451888,ECON 171,A01,203349,Newhouse; Herbert S,0,1,35,35
1683309452916,ECON 173A,A01,185621,Toda; Alexis Akira,21,0,35,14
1683309453945,EDS 25,A01,202413,Staff,0,1,0,0
1683309453945,EDS 25,A02,202414,Staff,0,1,0,0
1683309453945,EDS 25,A03,202415,Staff,0,0,0,0
1683309453945,EDS 25,A04,202416,Staff,0,1,0,0
1683309453945,EDS 25,A05,202439,Staff,0,0,0,0
1683309453945,EDS 25,A06,202440,Staff,0,0,0,0
1683309453945,EDS 25,B01,202631,Staff,0,0,0,0
1683309453945,EDS 25,B02,202632,Staff,0,0,0,0
1683309453945,EDS 25,B03,202639,Staff,0,0,0,0
1683309453945,EDS 25,B04,202640,Staff,0,0,0,0
1683309453945,EDS 25,B05,202643,Staff,0,0,0,0
1683309453945,EDS 25,B06,202644,Staff,0,0,0,0
1683309454969,EDS 38,A01,202659,Black; Alison Michelle,24,0,25,1
1683309455997,EDS 115,A00,202652,Staff,17,0,30,13
1683309457021,EDS 125,A00,202649,Staff,14,0,30,16
1683309458047,EDS 126,A01,203332,Staff,30,0,30,0
1683309459071,EDS 139,A00,202838,Staff,17,0,25,8
1683309460096,EDS 146,A01,202655,Staff,15,0,25,10
1683309461124,ENG 15,A00,185667,Staff,0,1,0,0
1683309461124,ENG 15,B00,185672,Staff,0,0,0,0
1683309461124,ENG 15,C00,185675,Staff,0,0,0,0
1683309461124,ENG 15,D00,185682,Staff,0,0,0,0
1683309461124,ENG 15,E00,185684,Staff,0,0,0,0
1683309462151,ETHN 103,A00,185710,Staff,0,3,35,35
1683309463175,ETHN 103A,A00,199228,Man; Simeon S,2,0,9,7
1683309464199,ETHN 109,A00,185711,Staff,18,0,35,17
1683309465222,ETHN 142,A00,185726,Staff,0,4,30,30
1683309466246,ETHN 163J,A00,199229,Man; Simeon S,6,0,8,2
1683309467273,ETHN 168,A00,185727,Staff,8,0,10,2
1683309468297,ETHN 182,A00,185728,Staff,1,0,35,34
1683309469324,ETHN 183,A00,185737,Staff,8,0,18,10
1683309470350,GLBH 111,A01,209361,Burgos; Jose L.,0,0,0,0
1683309472402,HIEU 104,A00,185792,Staff,16,0,20,4
1683309473430,HIEU 115,A00,185800,Staff,1,0,20,19
1683309474453,HIEU 128,A00,185801,Staff,0,7,20,20
1683309475477,HIEU 147,A00,185802,Staff,16,0,20,4
1683309476504,HIEU 154,A00,185823,Staff,12,0,20,8
1683309477529,HILA 102,A00,185826,Staff,13,0,20,7
1683309478556,HILD 2C,A01,185778,Staff,0,12,20,20
1683309479579,HILD 7B,A01,185780,Kwak; Nancy,0,15,32,32
1683309479579,HILD 7B,A02,185781,Kwak; Nancy,0,18,32,32
1683309480604,HILD 30,A01,185791,Staff,14,0,20,6
1683309481631,HISC 119,A00,185830,Golan; Tal,0,9,20,20
1683309482657,HITO 156GS,A00,185831,Patterson; Patrick H.,0,0,0,23
1683309483682,HIUS 103,A00,185832,Man; Simeon S,0,6,20,20
1683309484710,HIUS 117,A00,185836,Kwak; Nancy,2,0,20,18
1683309485735,HIUS 125,A00,185840,Man; Simeon S,0,0,23,23
1683309486759,HIUS 149,A00,185845,Staff,0,0,20,20
1683309487782,HUM 3,A01,185882,Zavodny; Tatiana Sophia,0,6,50,50
1683309487782,HUM 3,B01,185899,Caldwell; Michael Alan,0,19,50,50
1683309488809,HUM 3GS,A00,185900,Patterson; Patrick H.,0,0,0,23
1683309489835,HUM 4,A01,185938,Zroka; Amy Liane,31,0,50,19
1683309489835,HUM 4,B01,185956,Watkins; Eric,0,2,50,50
1683309489835,HUM 4,B02,202209,Watkins; Eric,0,2,50,50
1683309489835,HUM 4,B03,202210,Watkins; Eric,0,0,50,50
1683309490859,HUM 5,A01,185958,West; Geoffrey Scott,4,0,50,46
1683309490859,HUM 5,A02,202215,West; Geoffrey Scott,0,0,50,50
1683309491884,INTL 190,A00,185959,Gagnon; Jeffrey C,0,0,0,9
1683309491884,INTL 190,B00,185960,Lettieri; Michael Joseph,0,0,0,1
1683309492908,JAPN 180,A00,254509,Staff,5,1,30,25
1683309493937,LATI 10,A01,202853,Kennemore; Amy Michelle,5,0,35,30
1683309493937,LATI 10,A02,202854,Kennemore; Amy Michelle,1,0,35,34
1683309493937,LATI 10,A03,270054,Kennemore; Amy Michelle,30,0,30,0
1683309494962,LATI 180,A00,202855,Kennemore; Amy Michelle,11,0,20,9
1683309495986,LAWS 101,A00,201767,Golan; Tal,0,7,40,40
1683309497010,LIFR 1C,A00,185961,Staff,6,0,20,14
1683309498040,LIFR 1CX,A00,185962,Staff,7,0,20,13
1683309499064,LIFR 1D,A00,185963,Staff,9,0,20,11
1683309500089,LIFR 1DX,A00,185964,Staff,9,0,20,11
1683309501113,LIGN 101,A01,186039,Staff,43,0,50,7
1683309502138,LIGN 165,A00,186040,Staff,18,0,50,32
1683309503165,LTCS 108,A00,186041,Staff,6,0,10,4
1683309504190,LTCS 119,A00,186042,Staff,16,0,20,4
1683309505213,LTCS 130,A00,186043,Wesling; Megan E.,15,0,25,10
1683309507263,LTEA 138,A00,186119,Staff,14,0,40,26
1683309508287,LTEN 124,A00,186148,Staff,6,0,25,19
1683309509311,LTEN 178,A00,186149,Staff,7,0,15,8
1683309510340,LTEN 181,A00,186150,Blanco; John D,33,0,40,7
1683309511364,LTWL 120,A00,186160,Staff,20,0,25,5
1683309512390,LTWL 165,A00,186161,Staff,22,0,25,3
1683309513416,LTWR 100,A00,186162,Staff,0,4,15,15
1683309514444,LTWR 102,A00,186163,Doller; Ben,5,0,15,10
1683309515468,MAE 8,A01,186412,Staff,0,0,0,0
1683309516495,MAE 30B,A00,186445,Bahadori; Mohammad Yousef,83,0,100,17
1683309517519,MAE 40,A00,186592,Bewley; Thomas R,9,0,50,41
1683309518543,MAE 101B,A00,186593,Bahadori; Mohammad Yousef,81,0,100,19
1683309519567,MAE 105,A00,186594,Bandaru; Prabhakar,12,0,50,38
1683309520590,MAE 107,A00,186599,Pham; Hieu Tan,0,6,120,120
1683309521615,MAE 148,A01,186660,Silberman; Jack,3,0,16,13
1683309522693,MATH 10A,A01,188095,Staff,0,7,35,35
1683309523720,MATH 10B,A01,188097,Bowers; Adam R.,0,10,30,30
1683309523720,MATH 10B,A02,188099,Bowers; Adam R.,0,11,30,30
1683309523720,MATH 10B,B01,188104,Bowers; Adam R.,0,10,30,30
1683309523720,MATH 10B,B02,188106,Bowers; Adam R.,0,11,30,30
1683309524748,MATH 10C,A01,188111,Staff,0,18,30,30
1683309524748,MATH 10C,A02,188127,Staff,0,17,30,30
1683309524748,MATH 10C,A03,188131,Staff,0,18,30,30
1683309524748,MATH 10C,B01,188218,Staff,20,0,30,10
1683309524748,MATH 10C,B02,188244,Staff,13,0,30,17
1683309524748,MATH 10C,B03,188277,Staff,16,0,30,14
1683309525777,MATH 18,A01,188344,Bach; Quang Tran,18,0,30,12
1683309525777,MATH 18,A02,188345,Bach; Quang Tran,11,0,30,19
1683309525777,MATH 18,B01,188353,Bach; Quang Tran,10,0,30,20
1683309525777,MATH 18,B02,188354,Bach; Quang Tran,20,0,30,10
1683309526802,MATH 20A,A01,188374,Staff,13,0,35,22
1683309527827,MATH 20B,A01,188382,Ohm; Ko Woon,6,0,30,24
1683309527827,MATH 20B,A02,188383,Ohm; Ko Woon,23,0,30,7
1683309527827,MATH 20B,B01,188385,Ohm; Ko Woon,7,0,30,23
1683309527827,MATH 20B,B02,188392,Ohm; Ko Woon,22,0,30,8
1683309528850,MATH 20C,A01,188394,Harel; Guershon,10,0,30,20
1683309528850,MATH 20C,A02,188395,Harel; Guershon,13,0,30,17
1683309528850,MATH 20C,B01,188404,Harel; Guershon,3,0,30,27
1683309528850,MATH 20C,B02,188405,Harel; Guershon,19,0,30,11
1683309529880,MATH 20D,A01,188414,Hammock; Frances H,0,1,30,30
1683309529880,MATH 20D,A02,188415,Hammock; Frances H,4,0,30,26
1683309529880,MATH 20D,B01,188447,Hammock; Frances H,2,0,30,28
1683309529880,MATH 20D,B02,188486,Hammock; Frances H,8,0,30,22
1683309530905,MATH 20E,A01,188649,Staff,22,0,30,8
1683309530905,MATH 20E,A02,188650,Staff,23,0,30,7
1683309530905,MATH 20E,A03,188673,Staff,0,0,30,30
1683309531933,MATH 102,A01,188675,Staff,0,35,35,35
1683309532957,MATH 103B,A01,188681,Staff,4,0,35,31
1683309532957,MATH 103B,B01,188692,Staff,7,0,35,28
1683309533983,MATH 109,A01,188695,Salehi Golsefidy; Alireza,25,0,35,10
1683309533983,MATH 109,A02,188696,Salehi Golsefidy; Alireza,27,0,35,8
1683309535011,MATH 120A,A01,188698,Eggers; John Dietrich,6,0,35,29
1683309536039,MATH 142B,A01,188736,Ioana; Adrian,0,2,30,30
1683309536039,MATH 142B,A02,188741,Ioana; Adrian,0,1,30,30
1683309536039,MATH 142B,A03,188743,Ioana; Adrian,1,3,30,29
1683309537064,MATH 168A,A01,188790,Staff,0,9,35,35
1683309538087,MATH 170A,A01,188803,Nie; Jiawang,0,2,35,35
1683309538087,MATH 170A,A02,188811,Nie; Jiawang,0,0,35,35
1683309538087,MATH 170A,A03,188814,Nie; Jiawang,1,0,35,34
1683309538087,MATH 170A,A04,188815,Nie; Jiawang,13,0,35,22
1683309539112,MATH 193B,A01,188817,Staff,0,0,35,35
1683309539112,MATH 193B,A02,188818,Staff,5,0,35,30
1683309540137,MGT 4,A01,202857,Anderson; John Charles,62,0,80,18
1683309541161,MGT 12,A00,202858,Lindenberger; Wade Douglas,43,0,90,47
1683309542189,MGT 18,A00,202859,Staff,74,0,90,16
1683309543216,MGT 18GS,A00,202860,McKay; Michael J,13,0,28,15
1683309544239,MGT 45,A00,202861,Pecore; Joseph P.,14,0,90,76
1683309545268,MGT 100,A00,202863,Yavorsky; Daniel Ryan,28,0,90,62
1683309546293,MGT 103,A00,202864,Ehrich; Kristine R,0,16,90,90
1683309547319,MGT 112,A00,202865,Ehrich; Kristine R,15,0,90,75
1683309548348,MGT 121A,A00,202868,Staff,0,19,0,0
1683309549375,MGT 131B,A00,202869,Anderson; John Charles,59,0,90,31
1683309550401,MGT 136,A00,202871,Lindenberger; Wade Douglas,84,0,90,6
1683309551429,MGT 164,A00,202873,Staff,0,69,90,90
1683309552460,MGT 164GS,A00,202874,McKay; Mary A,13,0,28,15
1683309553485,MGT 180,A00,202875,Staff,0,51,90,90
1683309554510,MMW 11R,A01,205019,Herbst; Matthew,3,0,30,27
1683309554510,MMW 11R,A02,205026,Herbst; Matthew,29,0,30,1
1683309555536,MMW 15,A01,193512,Chang; Edmond Yi-Teh,0,9,28,28
1683309555536,MMW 15,A02,193513,Chang; Edmond Yi-Teh,0,5,28,28
1683309555536,MMW 15,A03,193514,Chang; Edmond Yi-Teh,0,5,28,28
1683309555536,MMW 15,A04,193515,Chang; Edmond Yi-Teh,0,5,28,28
1683309555536,MMW 15,A05,193516,Chang; Edmond Yi-Teh,0,4,28,28
1683309555536,MMW 15,A06,193517,Chang; Edmond Yi-Teh,0,5,28,28
1683309555536,MMW 15,B01,193519,Chang; Edmond Yi-Teh,0,4,28,28
1683309555536,MMW 15,B02,193520,Chang; Edmond Yi-Teh,0,5,28,28
1683309555536,MMW 15,B03,193521,Chang; Edmond Yi-Teh,0,4,28,28
1683309555536,MMW 15,B04,193522,Chang; Edmond Yi-Teh,0,4,28,28
1683309555536,MMW 15,B05,193523,Chang; Edmond Yi-Teh,0,5,28,28
1683309555536,MMW 15,B06,193524,Chang; Edmond Yi-Teh,0,4,28,28
1683309556562,MMW 122,A01,193526,Rahimi; Babak,0,14,28,28
1683309556562,MMW 122,A02,193527,Rahimi; Babak,0,14,28,28
1683309556562,MMW 122,A03,193528,Rahimi; Babak,0,0,0,0
1683309556562,MMW 122,A04,193529,Rahimi; Babak,0,0,0,0
1683309557585,MUS 1A,A01,186663,Staff,0,20,35,35
1683309558612,MUS 4,A01,186715,Staff,0,12,35,35
1683309559636,MUS 5R,A01,186796,Dubnov; Shlomo,0,17,35,35
1683309560660,MUS 6,A01,186798,Staff,0,3,25,25
1683309561686,MUS 7,A01,186830,Staff,12,0,35,23
1683309562708,MUS 8,A01,186930,Staff,0,26,35,35
1683309563737,MUS 15,A01,186932,Staff,0,15,35,35
1683309563737,MUS 15,B01,186934,Staff,0,15,35,35
1683309564762,MUS 80,A00,186935,Staff,2,0,20,18
1683309564762,MUS 80,B00,186936,Staff,25,0,25,0
1683309565788,NANO 11,A00,204702,Lipomi; Darren John,0,0,0,0
1683309566815,NANO 15,A01,204709,Yang; Kesong,0,1,0,0
1683309567840,NANO 114,A00,202069,Jahed Motlagh; Zeinab,3,0,10,7
1683309568867,PHIL 1,A00,186955,Grush; Rick Scott,32,0,40,8
1683309569897,PHIL 10,A01,186973,Grush; Rick Scott,28,0,35,7
1683309569897,PHIL 10,A02,186974,Grush; Rick Scott,33,0,35,2
1683309570921,PHIL 13,A01,186976,Staff,7,0,35,28
1683309570921,PHIL 13,A02,186977,Staff,16,0,35,19
1683309571945,PHIL 14,A01,186979,Staff,31,0,35,4
1683309571945,PHIL 14,A02,186986,Staff,32,0,35,3
1683309572971,PHIL 28,A01,186988,Staff,16,0,30,14
1683309572971,PHIL 28,A02,186989,Staff,1,0,30,29
1683309572971,PHIL 28,A03,186990,Staff,9,0,30,21
1683309572971,PHIL 28,A04,186991,Staff,26,0,30,4
1683309573998,PHIL 120,A00,186997,Staff,23,0,40,17
1683309575022,PHIL 137,A00,187003,Staff,9,0,40,31
1683309576046,PHIL 150,A00,187015,Staff,47,0,70,23
1683309577070,PHIL 167,A00,187021,Lamey; Andy M.,35,0,40,5
1683309578098,PHIL 174,A01,202226,Staff,17,0,20,3
1683309578098,PHIL 174,A02,202235,Staff,20,0,20,0
1683309579121,PHIL 191A,A00,258918,Staff,0,0,1,1
1683309580147,PHYS 1A,A00,187028,Staff,27,0,60,33
1683309581171,PHYS 1AL,001,187036,Staff,3,0,30,27
1683309581171,PHYS 1AL,002,187049,Staff,18,0,30,12
1683309582195,PHYS 1B,A00,187058,Staff,23,0,60,37
1683309583223,PHYS 1BL,001,187064,Staff,0,0,30,30
1683309583223,PHYS 1BL,002,187070,Staff,6,0,30,24
1683309584248,PHYS 1C,A00,187082,Staff,31,0,120,89
1683309585275,PHYS 1CL,001,187088,Staff,0,9,30,30
1683309585275,PHYS 1CL,002,187089,Staff,0,2,30,30
1683309585275,PHYS 1CL,009,262693,Staff,11,0,30,19
1683309586300,PHYS 2B,A01,187097,Staff,54,0,115,61
1683309587324,PHYS 2C,A01,187099,Staff,67,0,115,48
1683309588352,PHYS 2CL,A01,187101,Staff,5,0,28,23
1683309588352,PHYS 2CL,A02,187102,Staff,15,0,28,13
1683309589376,PHYS 2D,A01,187123,Shotwell; Brian,95,0,115,20
1683309590403,PHYS 4B,A01,187133,Grinstein; Benjamin,35,0,50,15
1683309591431,POLI 10,A00,188819,Staff,0,3,50,50
1683309592453,POLI 11,A00,188827,Staff,43,0,50,7
1683309593478,POLI 13R,A00,188828,Staff,0,1,20,20
1683309594505,POLI 27,A01,188830,Elgin; Samuel Zincke,0,1,70,70
1683309595528,POLI 30,A00,188832,Desposato; Scott,33,0,50,17
1683309596555,POLI 102F,A00,188834,Staff,3,0,40,37
1683309597582,POLI 104A,A00,188852,Staff,14,0,30,16
1683309598605,POLI 104I,A00,188853,Staff,0,6,20,20
1683309599631,POLI 110B,A00,188854,Wiens; David,7,0,20,13
1683309600654,POLI 112A,A00,188855,Wiens; David,5,0,30,25
1683309601677,POLI 117R,A00,188856,Forman; Fonna,0,11,20,20
1683309602704,POLI 118,A00,188857,Ingham; Sean,8,0,20,12
1683309603726,POLI 120G,A00,188858,Staff,9,0,30,21
1683309604756,POLI 131CR,A00,188863,Hoston; Germaine,24,0,50,26
1683309605780,POLI 133,A00,188864,Nellis; Gareth Hb,44,0,50,6
1683309606809,POLI 134D,A00,188865,Desposato; Scott,27,0,30,3
1683309607836,POLI 142A,A00,188871,Gartzke; Erik,22,0,50,28
1683309608863,POLI 142K,A00,188874,Staff,38,0,50,12
1683309609888,POLI 143,A00,188940,Gartzke; Erik,16,0,30,14
1683309610913,POLI 153,A00,188943,Staff,3,0,20,17
1683309611939,POLI 160AA,A00,188944,Staff,13,0,40,27
1683309612963,POLI 170A,A00,188945,Staff,11,0,30,19
1683309615017,PSYC 1,A00,188952,Staff,37,0,90,53
1683309616044,PSYC 2,B00,188953,Staff,20,0,35,15
1683309617069,PSYC 6,A00,188970,Staff,47,0,60,13
1683309618095,PSYC 7,A00,188973,Staff,37,0,45,8
1683309619121,PSYC 60,A01,188980,Rickard; Timothy C.,43,0,60,17
1683309620146,PSYC 70,A01,189001,Steiner; Eric Tomas,24,0,45,21
1683309621170,PSYC 100,A00,189005,Lacefield; Katharine I,0,99,120,120
1683309622193,PSYC 102,A00,189008,Staff,10,0,30,20
1683309623220,PSYC 106,B00,189026,Gorman; Michael R.,37,0,60,23
1683309624248,PSYC 114,B01,189033,Winkielman; Piotr,0,32,30,30
1683309625275,PSYC 131,A00,189036,Anagnostaras; Stephan,0,43,60,60
1683309626356,PSYC 136,A00,189041,Lowe; Angela Beth,0,7,25,25
1683309627383,PSYC 137,A00,189057,Winkielman; Piotr,0,34,25,25
1683309628410,PSYC 144,A00,189107,Wixted; John T,0,7,50,50
1683309630460,PSYC 162,A00,189142,Staff,0,8,85,85
1683309631487,PSYC 172,A00,189144,Gorman; Michael R.,0,7,30,30
1683309633537,PSYC 179,A00,189146,Lacefield; Katharine I,0,84,120,120
1683309634562,PSYC 181,A00,189147,Anagnostaras; Stephan,0,44,90,90
1683309635588,PSYC 190R,A00,189148,Barner; David A.,0,22,80,80
1683309636614,PSYC 191,A00,189275,Rickard; Timothy C.,0,7,25,25
1683309637641,PSYC 193,A00,189276,Chapman; Eddie Nathaniel,0,1,0,4
1683309638666,PSYC 193L,A01,189281,Lowe; Angela Beth,12,0,20,8
1683309638666,PSYC 193L,B01,189285,Staff,28,0,35,7
1683309639693,RELI 149,A00,187137,Rahimi; Babak,7,0,40,33
1683309640718,SE 9,A01,187315,Staff,0,2,18,18
1683309641746,SE 101B,A00,187409,Staff,24,0,30,6
1683309642774,SE 110B,A00,187444,Staff,10,0,40,30
1683309643799,SE 130B,A00,187449,Staff,31,0,40,9
1683309644823,SE 150A,A00,187516,Staff,9,0,20,11
1683309645848,SE 154,A00,187528,Staff,30,0,50,20
1683309646875,SIO 3,A01,258171,Staff,35,0,40,5
1683309647899,SIO 10,A00,187144,Cook; Geoffrey W,0,3,75,75
1683309648924,SIO 45,A00,187152,Cook; Geoffrey W,1,0,100,99
1683309649949,SIO 109R,A00,194486,Staff,0,3,20,20
1683309652001,SIO 187,A01,187233,Kacev; David,12,0,40,28
1683309653025,SOCI 1,A01,258656,Thorpe; Charles Robert,28,0,30,2
1683309653025,SOCI 1,A02,258658,Thorpe; Charles Robert,30,0,30,0
1683309653025,SOCI 1,A03,258661,Thorpe; Charles Robert,25,0,25,0
1683309653025,SOCI 1,A04,258666,Thorpe; Charles Robert,22,0,25,3
1683309653025,SOCI 1,A05,258897,Thorpe; Charles Robert,23,0,25,2
1683309653025,SOCI 1,A06,258898,Thorpe; Charles Robert,25,0,25,0
1683309654049,SOCI 30,A01,258903,Pardo Guerra; Juan Pablo,16,0,30,14
1683309655072,SOCI 102,A00,258904,Staff,9,0,25,16
1683309656098,SOCI 106,A00,258905,Staff,19,0,25,6
1683309657121,SOCI 111,A00,258907,Ribas Norris; Janet Vanesa,26,0,30,4
1683309658144,SOCI 121R,A00,258908,Pardo Guerra; Juan Pablo,11,0,30,19
1683309659171,SOCI 126,A01,203330,Staff,14,0,20,6
1683309660193,SOCI 131,A00,258909,Thorpe; Charles Robert,31,0,60,29
1683309661216,SOCI 135,A00,258910,Payne; Christine Anna,0,9,30,30
1683309662242,SOCI 157,A00,258911,Staff,13,0,30,17
1683309663268,SOCI 184,A00,258912,Staff,26,0,30,4
1683309664292,SOCI 188D,A00,258913,Staff,21,0,30,9
1683309665321,SYN 2,001,187529,Staff,9,0,16,7
1683309665321,SYN 2,002,201452,Staff,0,18,16,16
1683309665321,SYN 2,003,201469,Staff,3,0,16,13
1683309666350,SYN 100,A01,187531,Staff,0,9,20,20
1683309666350,SYN 100,B01,201491,Staff,0,12,20,20
1683309667379,TDAC 1,A00,189286,Walsh; Kim C.,3,0,20,17
1683309667379,TDAC 1,B00,189287,Harting; Carla Kelso,11,0,20,9
1683309668406,TDAC 101,A00,189300,Walsh; Kim C.,16,0,20,4
1683309668406,TDAC 101,B00,189301,Harting; Carla Kelso,18,0,20,2
1683309669430,TDAC 102,A00,189304,Basso; Beatrice,14,0,20,6
1683309670459,TDAC 108,A00,189305,Staff,18,0,20,2
1683309671486,TDDE 131,A00,189310,Staff,19,0,20,1
1683309671486,TDDE 131,B00,189314,Staff,19,0,20,1
1683309671486,TDDE 131,C00,189315,Staff,48,0,50,2
1683309671486,TDDE 131,D00,189316,Staff,14,0,15,1
1683309671486,TDDE 131,E00,204841,Staff,20,0,20,0
1683309672514,TDGE 10,A00,189289,Staff,30,0,50,20
1683309672514,TDGE 10,B00,189290,Havis; Allan,2,0,50,48
1683309673540,TDGE 11,A00,189291,Fulton; Julia,0,3,50,50
1683309673540,TDGE 11,B00,189292,Staff,20,0,25,5
1683309673540,TDGE 11,C00,260270,Staff,0,0,0,0
1683309674564,TDGE 25,A00,189294,Staff,3,0,20,17
1683309675591,TDGE 124,A00,189318,Fulton; Julia,0,8,50,50
1683309676617,TDGE 125,A00,189319,Staff,13,0,25,12
1683309676617,TDGE 125,B00,189320,Staff,23,0,25,2
1683309677644,TDGE 127,A00,189322,Havis; Allan,0,0,50,50
1683309678668,TDHT 101,A00,189323,Staff,18,0,25,7
1683309678668,TDHT 101,B00,189324,Staff,25,0,25,0
1683309679691,TDHT 102,A00,189325,Staff,49,0,50,1
1683309680715,TDMV 1,A00,189295,Arcidiacono; Kristin,20,0,30,10
1683309680715,TDMV 1,B00,189296,Caligagan; Maria T.,24,0,30,6
1683309681738,TDMV 2,A00,189297,Sammartano; Tonnie,28,0,30,2
1683309681738,TDMV 2,B00,189299,Arcidiacono; Kristin,24,0,30,6
1683309682763,TDMV 3,A00,204998,Rincon; Alicia,22,0,30,8
1683309683787,TDMV 120,A00,189458,Sammartano; Tonnie,28,0,30,2
1683309684809,TDMV 138,A00,189541,Jun; Grace Shin Hae,22,0,40,18
1683309685834,TDMV 142,A00,189717,Caligagan; Tony,23,0,30,7
1683309685834,TDMV 142,B00,189718,Caligagan; Maria T.,25,0,30,5
1683309686862,TMC 2,A01,187533,Staff,25,0,25,0
1683309686862,TMC 2,A02,187534,Staff,25,0,25,0
1683309687890,USP 1,A01,187536,Kwak; Nancy,0,16,25,25
1683309688913,USP 5,A01,187538,Staff,9,0,25,16
1683309689939,USP 101,A00,199253,Staff,0,4,0,0
1683309690966,USP 124,A00,187562,Boomhower; Matthew Charles,1,0,30,29
1683309691989,USP 138,A00,187582,Staff,20,0,25,5
1683309693013,USP 152,A01,187597,Staff,4,0,25,21
1683309694039,USP 153,A00,187598,Staff,19,0,25,6
1683309695062,USP 168,A00,187607,Kwak; Nancy,2,0,5,3
1683309696089,USP 173,A00,187619,Staff,4,0,25,21
1683309697115,USP 181,A00,187638,Staff,0,0,25,25
1683309698142,VIS 103,A00,187650,Cruz; Edwin Teddy,23,0,75,52
1683309699168,VIS 110D,A00,187669,Staff,12,0,22,10
1683309700196,VIS 127C,A00,187720,Shen; Kuiyi,68,0,146,78
1683309701219,VIS 149,A00,187731,Yoldas; Pinar,0,14,22,22
1683309702243,VIS 151,A01,188091,Staff,22,0,34,12
1683309702243,VIS 151,A02,188092,Staff,11,0,34,23
1683309703267,VIS 160B,A00,188093,Stalbaum; Brett,0,0,10,10
1683309705317,WCWP 10B,A00,201720,Staff,10,0,15,5
1683309705317,WCWP 10B,B00,201722,Staff,8,0,15,7
1683309706340,WCWP 100,A00,201725,Gagnon; Jeffrey C,0,0,2,2
1683309706340,WCWP 100,B00,201727,Staff,0,4,15,15
1683309709433,ANBI 133,A00,258401,Wilder; Linnea Lorene,34,0,40,6
1683309710459,ANBI 140,A00,258395,Hrvoj Mihic; Branka,18,0,25,7
1683309711486,ANSC 120,A00,258402,Bialecki; Jon Anthony,27,0,40,13
1683309712510,ANSC 144,A00,258400,Staff,14,0,40,26
1683309714563,ANSC 166,A00,258396,Parish; Steven Martin,157,0,175,18
1683309715585,ANSC 180,A00,193533,Staff,9,0,20,11
1683309716610,ANSC 188,A00,258397,Jassal; Aftab,33,0,40,7
1683309717637,ANTH 3,A01,258316,Staff,23,0,30,7
1683309718663,ANTH 5,A00,258394,Semendeferi; Ekaterini,16,0,20,4
1683309719687,ANTH 21,A01,258331,Staff,9,0,40,31
1683309720714,ANTH 103,A00,258398,Varma; Saiba,15,0,25,10
1683309721742,AWP 10,001,202034,Staff,0,0,0,0
1683309721742,AWP 10,002,202035,Staff,0,0,0,0
1683309721742,AWP 10,003,202036,Staff,0,0,0,0
1683309721742,AWP 10,004,202037,Staff,0,0,0,0
1683309721742,AWP 10,005,202038,Staff,0,0,0,0
1683309721742,AWP 10,006,202039,Staff,0,0,0,0
1683309721742,AWP 10,007,202040,Staff,0,0,0,0
1683309721742,AWP 10,008,202041,Staff,0,0,0,0
1683309721742,AWP 10,009,202042,Staff,0,0,0,0
1683309721742,AWP 10,010,202043,Staff,0,0,0,0
1683309721742,AWP 10,011,202044,Staff,0,0,0,0
1683309721742,AWP 10,012,202045,Staff,0,0,0,0
1683309721742,AWP 10,013,202046,Staff,0,0,0,0
1683309721742,AWP 10,014,202047,Staff,0,0,0,0
1683309721742,AWP 10,015,202048,Staff,0,0,0,0
1683309721742,AWP 10,016,202049,Staff,0,0,0,0
1683309721742,AWP 10,017,202050,Staff,0,0,0,0
1683309721742,AWP 10,018,202051,Staff,0,0,0,0
1683309721742,AWP 10,019,202052,Staff,0,0,0,0
1683309721742,AWP 10,020,202053,Staff,0,0,0,0
1683309721742,AWP 10,021,202054,Staff,0,0,0,0
1683309721742,AWP 10,022,202055,Staff,0,0,0,0
1683309721742,AWP 10,023,202056,Staff,0,0,0,0
1683309721742,AWP 10,024,202057,Staff,0,0,0,0
1683309721742,AWP 10,025,202058,Staff,0,0,0,0
1683309721742,AWP 10,026,202059,Staff,0,0,0,0
1683309722766,AWP 102,001,202032,Staff,0,0,0,0
1683309722766,AWP 102,002,202033,Staff,0,0,0,0
1683309723791,BENG 100,A01,254234,Taylor Amos; Alyssa C,31,0,40,9
1683309724814,BENG 196,001,270013,Engler; Adam J.,9999,0,9999,0
1683309725838,BICD 100R,A01,202018,Smith; Laurie,0,7,32,32
1683309725838,BICD 100R,A02,202019,Smith; Laurie,0,2,32,32
1683309725838,BICD 100R,A03,202020,Smith; Laurie,0,1,32,32
1683309725838,BICD 100R,A04,202021,Smith; Laurie,8,0,32,24
1683309725838,BICD 100R,A05,202022,Smith; Laurie,12,0,32,20
1683309726865,BICD 136,A01,193242,Gustafson-Brown; Cindy,0,2,32,32
1683309726865,BICD 136,A02,193244,Gustafson-Brown; Cindy,15,0,32,17
1683309727892,BIEB 102,A01,193249,Butler; Shannon Rhey,0,2,32,32
1683309727892,BIEB 102,A02,193251,Butler; Shannon Rhey,0,0,32,32
1683309727892,BIEB 102,A03,193253,Butler; Shannon Rhey,0,1,32,32
1683309727892,BIEB 102,A04,193255,Butler; Shannon Rhey,17,0,32,15
1683309727892,BIEB 102,A05,193265,Butler; Shannon Rhey,26,0,32,6
1683309727892,BIEB 102,A06,193269,Butler; Shannon Rhey,16,0,32,16
1683309730000,BIEB 150,A01,193274,Staff,0,0,32,32
1683309730000,BIEB 150,A02,193285,Staff,24,0,32,8
1683309731025,BIEB 194,A00,193286,Kurle; Carolyn M.,22,0,32,10
1683309732052,BILD 1,A01,192291,Staff,16,0,32,16
1683309732052,BILD 1,A02,192292,Staff,30,0,32,2
1683309732052,BILD 1,B01,192520,Reuther; Keefe,0,1,0,0
1683309732052,BILD 1,B02,192532,Reuther; Keefe,0,1,0,0
1683309733077,BILD 3,A01,192556,Butler; Shannon Rhey,0,0,32,32
1683309733077,BILD 3,A02,192581,Butler; Shannon Rhey,5,0,32,27
1683309733077,BILD 3,A03,192611,Butler; Shannon Rhey,23,0,32,9
1683309733077,BILD 3,A04,192612,Butler; Shannon Rhey,25,0,32,7
1683309733077,BILD 3,A05,192613,Butler; Shannon Rhey,27,0,32,5
1683309733077,BILD 3,A06,192679,Butler; Shannon Rhey,27,0,32,5
1683309733077,BILD 3,A07,192682,Butler; Shannon Rhey,22,0,32,10
1683309734107,BILD 4,A01,192836,Reuther; Keefe,1,0,24,23
1683309734107,BILD 4,A02,193044,Reuther; Keefe,4,0,24,20
1683309735134,BILD 10,A01,193142,Gustafson-Brown; Cindy,31,0,32,1
1683309735134,BILD 10,A02,193149,Gustafson-Brown; Cindy,31,0,32,1
1683309736161,BIMM 100,A01,193301,Staff,0,6,32,32
1683309736161,BIMM 100,A02,193312,Staff,0,5,32,32
1683309736161,BIMM 100,A03,193323,Staff,0,8,32,32
1683309737191,BIMM 101,A01,193329,McDonnell; Lisa Marie,0,3,24,24
1683309737191,BIMM 101,A02,193339,McDonnell; Lisa Marie,0,2,24,24
1683309737191,BIMM 101,B01,193354,McDonnell; Lisa Marie,0,3,24,24
1683309737191,BIMM 101,B02,193357,McDonnell; Lisa Marie,0,3,24,24
1683309738217,BIMM 110,A01,193377,Tat; John,0,11,32,32
1683309738217,BIMM 110,A02,193378,Tat; John,1,9,32,31
1683309739241,BIMM 120,A01,206116,Staff,0,0,32,32
1683309739241,BIMM 120,A02,206117,Staff,8,0,32,24
1683309739241,BIMM 120,A03,206121,Staff,21,0,32,11
1683309740266,BIPN 100,A01,193393,Park; Ji Young,0,14,32,32
1683309740266,BIPN 100,A02,193402,Park; Ji Young,0,12,32,32
1683309740266,BIPN 100,A03,193413,Park; Ji Young,0,14,32,32
1683309740266,BIPN 100,A04,193414,Park; Ji Young,0,13,32,32
1683309741290,BIPN 102,A01,193429,Staff,0,0,32,32
1683309741290,BIPN 102,A02,193438,Staff,22,0,32,10
1683309742317,BIPN 106,A01,193450,Reyes Gonzalez; Catalina,0,2,40,40
1683309743344,BIPN 134,A01,193465,Cooke; James Edward,0,0,32,32
1683309743344,BIPN 134,A02,193474,Cooke; James Edward,27,0,32,5
1683309743344,BIPN 134,A03,193485,Cooke; James Edward,29,0,32,3
1683309743344,BIPN 134,A04,193486,Cooke; James Edward,21,0,32,11
1683309743344,BIPN 134,A05,193491,Cooke; James Edward,31,0,32,1
1683309743344,BIPN 134,A06,193501,Cooke; James Edward,30,0,32,2
1683309743344,BIPN 134,A07,193510,Cooke; James Edward,29,0,32,3
1683309745395,BISP 194,A00,222522,Staff,16,0,32,16
1683309746417,CAT 124,A01,202407,Staff,20,0,25,5
1683309747443,CAT 125,A00,202408,Marchisotto; Jennifer Anne,4,0,20,16
1683309748471,CAT 125R,A00,202409,Smith; Lauryn Alissa,0,11,20,20
1683309748471,CAT 125R,B00,202410,Morales; Celeste Georgianna,0,11,20,20
1683309748471,CAT 125R,C00,202411,Irwin; Matthew Joseph,0,10,20,20
1683309749494,CENG 15,A01,204712,Yang; Kesong,0,1,0,0
1683309750523,CENG 114,A00,202070,Jahed Motlagh; Zeinab,5,0,20,15
1683309751546,CGS 105,A00,185477,Wesling; Megan E.,24,0,40,16
1683309752570,CGS 106,A00,185494,Staff,13,0,22,9
1683309753593,CGS 108,A00,185495,Staff,14,0,20,6
1683309754617,CGS 114,A00,185496,Staff,13,0,18,5
1683309755641,CGS 119,A00,185501,Staff,15,0,20,5
1683309756668,CGS 120,A00,185511,Staff,13,0,20,7
1683309757694,CHEM 4,A01,184675,Bussey; Thomas J,96,0,100,4
1683309758717,CHEM 6A,A01,184677,Staff,35,0,60,25
1683309759741,CHEM 6B,A01,184679,Staff,65,0,100,35
1683309760769,CHEM 6C,A01,184681,Bussey; Thomas J,1,0,50,49
1683309760769,CHEM 6C,A02,184682,Bussey; Thomas J,34,0,50,16
1683309761794,CHEM 40A,A01,184684,Albizati; Kim F.,37,0,100,63
1683309762819,CHEM 40B,A01,184686,Albizati; Kim F.,0,20,100,100
1683309763842,CHEM 41B,A01,184690,Staff,52,0,100,48
1683309764867,COGS 3,A01,184715,Boyle; Mary E. T.,0,25,40,40
1683309765895,COGS 14B,A01,185172,Staff,0,15,38,38
1683309766921,COGS 18,A01,184736,Staff,19,0,80,61
1683309767944,COGS 100,A01,184932,Staff,0,5,73,73
1683309768968,COGS 101A,A01,184935,Staff,0,38,30,30
1683309770006,COGS 101B,A01,184944,Staff,0,2,30,30
1683309771034,COGS 101C,A01,184946,Staff,0,12,30,30
1683309772061,COGS 102A,A01,184951,Johnson; Christine M.,2,0,40,38
1683309773090,COGS 107B,A01,184953,Mooshagian; Eric Frederick,0,50,40,40
1683309774114,COGS 118B,A01,184959,Gupta; Anjum,0,48,40,40
1683309775141,COGS 153,A00,184961,Staff,0,15,30,30
1683309776168,COGS 177,A00,184962,Staff,0,21,30,30
1683309777195,COGS 187A,A01,184969,Boyle; Mary E. T.,0,17,40,40
1683309778219,COMM 10,A01,185174,Staff,0,5,25,25
1683309778219,COMM 10,A02,185189,Staff,0,5,25,25
1683309778219,COMM 10,A03,269821,Staff,0,0,0,0
1683309779246,COMM 100B,A01,185475,Staff,0,0,0,2
1683309779246,COMM 100B,A02,185476,Staff,14,0,25,11
1683309780274,COMM 100C,A01,185314,Staff,1,0,25,24
1683309780274,COMM 100C,A02,185327,Staff,19,0,25,6
1683309781299,COMM 110M,A00,185349,Staff,2,0,40,38
1683309782323,COMM 113T,A00,185352,Staff,25,0,40,15
1683309783350,COMM 114I,A00,185353,Staff,33,0,40,7
1683309784377,COMM 131,A00,185354,Staff,19,0,30,11
1683309785401,CSE 8A,A50,185358,Cao; Yingjun,0,46,10,10
1683309786426,CSE 8B,A01,185362,Staff,1,47,50,49
1683309787451,CSE 11,A01,185416,Cao; Yingjun,0,92,10,10
1683309788475,CSE 20,A01,185445,Briones; Jor-el Thomas Caparas,5,0,25,20
1683309789500,CSE 21,A01,185447,Staff,10,0,50,40
1683309790528,CSE 101,A01,185451,Staff,0,12,50,50
1683309790528,CSE 101,B01,185453,Jones; Miles E,0,11,50,50
1683309792578,CSE 141,A01,185458,Eldon; John,20,0,100,80
1683309793605,CSE 141L,A01,185461,Eldon; John,12,0,100,88
1683309794629,CSE 142,A01,185463,Staff,35,0,60,25
1683309794629,CSE 142,B01,201355,Staff,0,6,60,60
1683309795655,CSE 142L,A01,185470,Staff,35,0,60,25
1683309795655,CSE 142L,B01,201417,Staff,0,5,60,60
1683309796679,CSE 190,A00,201433,Staff,32,0,49,17
1683309797703,DOC 1,A01,259136,Strom; Megan C.,8,0,15,7
1683309797703,DOC 1,A02,259137,Strom; Megan C.,14,0,15,1
1683309797703,DOC 1,A03,259138,Strom; Megan C.,14,0,15,1
1683309797703,DOC 1,A04,259139,Strom; Megan C.,14,0,15,1
1683309798729,DOC 100D,A00,259140,Pass; Natalye Joann,17,0,25,8
1683309799752,DSGN 1,A01,184749,Rill; Bryan,0,25,30,30
1683309800778,DSGN 100,A01,185168,Staff,0,2,25,25
1683309801802,ECE 5,A01,185626,Morris; Karcher William,0,10,0,0
1683309802827,ECE 101,A01,185628,Staff,17,0,70,53
1683309803852,ECE 107,A01,185635,Baghdadchi; Saharnaz,0,0,20,20
1683309803852,ECE 107,A02,185638,Baghdadchi; Saharnaz,4,0,20,16
1683309804877,ECE 148,A01,185647,Silberman; Jack,0,0,16,16
1683309805902,ECON 1,A01,185537,Crane; Meredith Helen,54,0,70,16
1683309806929,ECON 3,A01,185549,Crane; Meredith Helen,33,0,70,37
1683309807953,ECON 4,A01,203354,Anderson; John Charles,0,4,10,10
1683309808977,ECON 100A,A01,185574,Staff,0,4,40,40
1683309810003,ECON 100B,A01,185576,Staff,0,22,40,40
1683309811031,ECON 100C,A01,185589,Newhouse; Herbert S,30,0,70,40
1683309812055,ECON 105,A00,185608,Vespa; Emanuel Ignacio,19,0,35,16
1683309813080,ECON 109,A01,185610,Shishkin; Denis,10,0,35,25
1683309814103,ECON 110A,A01,185612,Staff,11,0,40,29
1683309815127,ECON 120A,A01,185615,Staff,20,0,40,20
1683309816154,ECON 120C,A01,185617,Sun; Yixiao,0,20,70,70
1683309817180,ECON 144,A00,203346,Squires; Dale E,3,0,35,32
1683309818202,ECON 171,A01,203349,Newhouse; Herbert S,0,1,35,35
1683309819227,ECON 173A,A01,185621,Toda; Alexis Akira,21,0,35,14
1683309820251,EDS 25,A01,202413,Staff,0,1,0,0
1683309820251,EDS 25,A02,202414,Staff,0,1,0,0
1683309820251,EDS 25,A03,202415,Staff,0,0,0,0
1683309820251,EDS 25,A04,202416,Staff,0,1,0,0
1683309820251,EDS 25,A05,202439,Staff,0,0,0,0
1683309820251,EDS 25,A06,202440,Staff,0,0,0,0
1683309820251,EDS 25,B01,202631,Staff,0,0,0,0
1683309820251,EDS 25,B02,202632,Staff,0,0,0,0
1683309820251,EDS 25,B03,202639,Staff,0,0,0,0
1683309820251,EDS 25,B04,202640,Staff,0,0,0,0
1683309820251,EDS 25,B05,202643,Staff,0,0,0,0
1683309820251,EDS 25,B06,202644,Staff,0,0,0,0
1683309821275,EDS 38,A01,202659,Black; Alison Michelle,24,0,25,1
1683309822303,EDS 115,A00,202652,Staff,17,0,30,13
1683309823327,EDS 125,A00,202649,Staff,14,0,30,16
1683309824355,EDS 126,A01,203332,Staff,30,0,30,0
1683309825379,EDS 139,A00,202838,Staff,17,0,25,8
1683309826401,EDS 146,A01,202655,Staff,15,0,25,10
1683309827427,ENG 15,A00,185667,Staff,0,1,0,0
1683309827427,ENG 15,B00,185672,Staff,0,0,0,0
1683309827427,ENG 15,C00,185675,Staff,0,0,0,0
1683309827427,ENG 15,D00,185682,Staff,0,0,0,0
1683309827427,ENG 15,E00,185684,Staff,0,0,0,0
1683309828450,ETHN 103,A00,185710,Staff,0,3,35,35
1683309829479,ETHN 103A,A00,199228,Man; Simeon S,2,0,9,7
1683309830506,ETHN 109,A00,185711,Staff,18,0,35,17
1683309831529,ETHN 142,A00,185726,Staff,0,4,30,30
1683309832555,ETHN 163J,A00,199229,Man; Simeon S,6,0,8,2
1683309833640,ETHN 168,A00,185727,Staff,8,0,10,2
1683309834669,ETHN 182,A00,185728,Staff,1,0,35,34
1683309835693,ETHN 183,A00,185737,Staff,8,0,18,10
1683309836718,GLBH 111,A01,209361,Burgos; Jose L.,0,0,0,0
1683309838768,HIEU 104,A00,185792,Staff,16,0,20,4
1683309839795,HIEU 115,A00,185800,Staff,1,0,20,19
1683309840819,HIEU 128,A00,185801,Staff,0,7,20,20
1683309841844,HIEU 147,A00,185802,Staff,16,0,20,4
1683309842871,HIEU 154,A00,185823,Staff,12,0,20,8
1683309843899,HILA 102,A00,185826,Staff,13,0,20,7
1683309844923,HILD 2C,A01,185778,Staff,0,12,20,20
1683309845947,HILD 7B,A01,185780,Kwak; Nancy,0,15,32,32
1683309845947,HILD 7B,A02,185781,Kwak; Nancy,0,18,32,32
1683309846971,HILD 30,A01,185791,Staff,14,0,20,6
1683309847995,HISC 119,A00,185830,Golan; Tal,0,9,20,20
1683309849019,HITO 156GS,A00,185831,Patterson; Patrick H.,0,0,0,23
1683309850044,HIUS 103,A00,185832,Man; Simeon S,0,6,20,20
1683309851069,HIUS 117,A00,185836,Kwak; Nancy,2,0,20,18
1683309852098,HIUS 125,A00,185840,Man; Simeon S,0,0,23,23
1683309853124,HIUS 149,A00,185845,Staff,0,0,20,20
1683309854148,HUM 3,A01,185882,Zavodny; Tatiana Sophia,0,6,50,50
1683309854148,HUM 3,B01,185899,Caldwell; Michael Alan,0,19,50,50
1683309855172,HUM 3GS,A00,185900,Patterson; Patrick H.,0,0,0,23
1683309856202,HUM 4,A01,185938,Zroka; Amy Liane,31,0,50,19
1683309856202,HUM 4,B01,185956,Watkins; Eric,0,2,50,50
1683309856202,HUM 4,B02,202209,Watkins; Eric,0,2,50,50
1683309856202,HUM 4,B03,202210,Watkins; Eric,0,0,50,50
1683309857226,HUM 5,A01,185958,West; Geoffrey Scott,4,0,50,46
1683309857226,HUM 5,A02,202215,West; Geoffrey Scott,0,0,50,50
1683309858253,INTL 190,A00,185959,Gagnon; Jeffrey C,0,0,0,9
1683309858253,INTL 190,B00,185960,Lettieri; Michael Joseph,0,0,0,1
1683309859277,JAPN 180,A00,254509,Staff,5,1,30,25
1683309860303,LATI 10,A01,202853,Kennemore; Amy Michelle,5,0,35,30
1683309860303,LATI 10,A02,202854,Kennemore; Amy Michelle,1,0,35,34
1683309860303,LATI 10,A03,270054,Kennemore; Amy Michelle,30,0,30,0
1683309861325,LATI 180,A00,202855,Kennemore; Amy Michelle,11,0,20,9
1683309862349,LAWS 101,A00,201767,Golan; Tal,0,7,40,40
1683309863374,LIFR 1C,A00,185961,Staff,6,0,20,14
1683309864400,LIFR 1CX,A00,185962,Staff,7,0,20,13
1683309865427,LIFR 1D,A00,185963,Staff,9,0,20,11
1683309866451,LIFR 1DX,A00,185964,Staff,9,0,20,11
1683309867476,LIGN 101,A01,186039,Staff,43,0,50,7
1683309868501,LIGN 165,A00,186040,Staff,18,0,50,32
1683309869526,LTCS 108,A00,186041,Staff,6,0,10,4
1683309870553,LTCS 119,A00,186042,Staff,16,0,20,4
1683309871579,LTCS 130,A00,186043,Wesling; Megan E.,15,0,25,10
1683309873630,LTEA 138,A00,186119,Staff,14,0,40,26
1683309874657,LTEN 124,A00,186148,Staff,6,0,25,19
1683309875684,LTEN 178,A00,186149,Staff,7,0,15,8
1683309876712,LTEN 181,A00,186150,Blanco; John D,33,0,40,7
1683309877739,LTWL 120,A00,186160,Staff,20,0,25,5
1683309878766,LTWL 165,A00,186161,Staff,22,0,25,3
1683309879791,LTWR 100,A00,186162,Staff,0,4,15,15
1683309880819,LTWR 102,A00,186163,Doller; Ben,5,0,15,10
1683309881845,MAE 8,A01,186412,Staff,0,0,0,0
1683309882871,MAE 30B,A00,186445,Bahadori; Mohammad Yousef,83,0,100,17
1683309883896,MAE 40,A00,186592,Bewley; Thomas R,9,0,50,41
1683309884922,MAE 101B,A00,186593,Bahadori; Mohammad Yousef,81,0,100,19
1683309885946,MAE 105,A00,186594,Bandaru; Prabhakar,12,0,50,38
1683309886970,MAE 107,A00,186599,Pham; Hieu Tan,0,6,120,120
1683309888001,MAE 148,A01,186660,Silberman; Jack,3,0,16,13
1683309889027,MATH 10A,A01,188095,Staff,0,7,35,35
1683309890052,MATH 10B,A01,188097,Bowers; Adam R.,0,10,30,30
1683309890052,MATH 10B,A02,188099,Bowers; Adam R.,0,11,30,30
1683309890052,MATH 10B,B01,188104,Bowers; Adam R.,0,10,30,30
1683309890052,MATH 10B,B02,188106,Bowers; Adam R.,0,11,30,30
1683309891081,MATH 10C,A01,188111,Staff,0,18,30,30
1683309891081,MATH 10C,A02,188127,Staff,0,17,30,30
1683309891081,MATH 10C,A03,188131,Staff,0,18,30,30
1683309891081,MATH 10C,B01,188218,Staff,20,0,30,10
1683309891081,MATH 10C,B02,188244,Staff,13,0,30,17
1683309891081,MATH 10C,B03,188277,Staff,16,0,30,14
1683309892111,MATH 18,A01,188344,Bach; Quang Tran,18,0,30,12
1683309892111,MATH 18,A02,188345,Bach; Quang Tran,11,0,30,19
1683309892111,MATH 18,B01,188353,Bach; Quang Tran,10,0,30,20
1683309892111,MATH 18,B02,188354,Bach; Quang Tran,20,0,30,10
1683309893136,MATH 20A,A01,188374,Staff,13,0,35,22
1683309894164,MATH 20B,A01,188382,Ohm; Ko Woon,6,0,30,24
1683309894164,MATH 20B,A02,188383,Ohm; Ko Woon,23,0,30,7
1683309894164,MATH 20B,B01,188385,Ohm; Ko Woon,7,0,30,23
1683309894164,MATH 20B,B02,188392,Ohm; Ko Woon,22,0,30,8
1683309895193,MATH 20C,A01,188394,Harel; Guershon,10,0,30,20
1683309895193,MATH 20C,A02,188395,Harel; Guershon,13,0,30,17
1683309895193,MATH 20C,B01,188404,Harel; Guershon,3,0,30,27
1683309895193,MATH 20C,B02,188405,Harel; Guershon,19,0,30,11
1683309896223,MATH 20D,A01,188414,Hammock; Frances H,0,1,30,30
1683309896223,MATH 20D,A02,188415,Hammock; Frances H,4,0,30,26
1683309896223,MATH 20D,B01,188447,Hammock; Frances H,2,0,30,28
1683309896223,MATH 20D,B02,188486,Hammock; Frances H,8,0,30,22
1683309897252,MATH 20E,A01,188649,Staff,22,0,30,8
1683309897252,MATH 20E,A02,188650,Staff,23,0,30,7
1683309897252,MATH 20E,A03,188673,Staff,0,0,30,30
1683309898275,MATH 102,A01,188675,Staff,0,35,35,35
1683309899303,MATH 103B,A01,188681,Staff,4,0,35,31
1683309899303,MATH 103B,B01,188692,Staff,7,0,35,28
1683309900332,MATH 109,A01,188695,Salehi Golsefidy; Alireza,25,0,35,10
1683309900332,MATH 109,A02,188696,Salehi Golsefidy; Alireza,27,0,35,8
1683309901357,MATH 120A,A01,188698,Eggers; John Dietrich,6,0,35,29
1683309902381,MATH 142B,A01,188736,Ioana; Adrian,0,2,30,30
1683309902381,MATH 142B,A02,188741,Ioana; Adrian,0,1,30,30
1683309902381,MATH 142B,A03,188743,Ioana; Adrian,1,3,30,29
1683309903405,MATH 168A,A01,188790,Staff,0,9,35,35
1683309904430,MATH 170A,A01,188803,Nie; Jiawang,0,2,35,35
1683309904430,MATH 170A,A02,188811,Nie; Jiawang,0,0,35,35
1683309904430,MATH 170A,A03,188814,Nie; Jiawang,1,0,35,34
1683309904430,MATH 170A,A04,188815,Nie; Jiawang,13,0,35,22
1683309905454,MATH 193B,A01,188817,Staff,0,0,35,35
1683309905454,MATH 193B,A02,188818,Staff,5,0,35,30
1683309906485,MGT 4,A01,202857,Anderson; John Charles,62,0,80,18
1683309907513,MGT 12,A00,202858,Lindenberger; Wade Douglas,43,0,90,47
1683309908541,MGT 18,A00,202859,Staff,74,0,90,16
1683309909566,MGT 18GS,A00,202860,McKay; Michael J,13,0,28,15
1683309910589,MGT 45,A00,202861,Pecore; Joseph P.,14,0,90,76
1683309911613,MGT 100,A00,202863,Yavorsky; Daniel Ryan,28,0,90,62
1683309912639,MGT 103,A00,202864,Ehrich; Kristine R,0,16,90,90
1683309913664,MGT 112,A00,202865,Ehrich; Kristine R,15,0,90,75
1683309914687,MGT 121A,A00,202868,Staff,0,19,0,0
1683309915712,MGT 131B,A00,202869,Anderson; John Charles,59,0,90,31
1683309916736,MGT 136,A00,202871,Lindenberger; Wade Douglas,84,0,90,6
1683309917765,MGT 164,A00,202873,Staff,0,69,90,90
1683309918790,MGT 164GS,A00,202874,McKay; Mary A,13,0,28,15
1683309919818,MGT 180,A00,202875,Staff,0,51,90,90
1683309920846,MMW 11R,A01,205019,Herbst; Matthew,3,0,30,27
1683309920846,MMW 11R,A02,205026,Herbst; Matthew,29,0,30,1
1683309921871,MMW 15,A01,193512,Chang; Edmond Yi-Teh,0,9,28,28
1683309921871,MMW 15,A02,193513,Chang; Edmond Yi-Teh,0,5,28,28
1683309921871,MMW 15,A03,193514,Chang; Edmond Yi-Teh,0,5,28,28
1683309921871,MMW 15,A04,193515,Chang; Edmond Yi-Teh,0,5,28,28
1683309921871,MMW 15,A05,193516,Chang; Edmond Yi-Teh,0,4,28,28
1683309921871,MMW 15,A06,193517,Chang; Edmond Yi-Teh,0,5,28,28
1683309921871,MMW 15,B01,193519,Chang; Edmond Yi-Teh,0,4,28,28
1683309921871,MMW 15,B02,193520,Chang; Edmond Yi-Teh,0,5,28,28
1683309921871,MMW 15,B03,193521,Chang; Edmond Yi-Teh,0,4,28,28
1683309921871,MMW 15,B04,193522,Chang; Edmond Yi-Teh,0,4,28,28
1683309921871,MMW 15,B05,193523,Chang; Edmond Yi-Teh,0,5,28,28
1683309921871,MMW 15,B06,193524,Chang; Edmond Yi-Teh,0,4,28,28
1683309922895,MMW 122,A01,193526,Rahimi; Babak,0,14,28,28
1683309922895,MMW 122,A02,193527,Rahimi; Babak,0,14,28,28
1683309922895,MMW 122,A03,193528,Rahimi; Babak,0,0,0,0
1683309922895,MMW 122,A04,193529,Rahimi; Babak,0,0,0,0
1683309923924,MUS 1A,A01,186663,Staff,0,20,35,35
1683309924951,MUS 4,A01,186715,Staff,0,12,35,35
1683309925975,MUS 5R,A01,186796,Dubnov; Shlomo,0,17,35,35
1683309927002,MUS 6,A01,186798,Staff,0,3,25,25
1683309928027,MUS 7,A01,186830,Staff,12,0,35,23
1683309929052,MUS 8,A01,186930,Staff,0,26,35,35
1683309930077,MUS 15,A01,186932,Staff,0,15,35,35
1683309930077,MUS 15,B01,186934,Staff,0,15,35,35
1683309931101,MUS 80,A00,186935,Staff,2,0,20,18
1683309931101,MUS 80,B00,186936,Staff,25,0,25,0
1683309932126,NANO 11,A00,204702,Lipomi; Darren John,0,0,0,0
1683309933152,NANO 15,A01,204709,Yang; Kesong,0,1,0,0
1683309934176,NANO 114,A00,202069,Jahed Motlagh; Zeinab,3,0,10,7
1683309935200,PHIL 1,A00,186955,Grush; Rick Scott,32,0,40,8
1683309936227,PHIL 10,A01,186973,Grush; Rick Scott,28,0,35,7
1683309936227,PHIL 10,A02,186974,Grush; Rick Scott,33,0,35,2
1683309937307,PHIL 13,A01,186976,Staff,7,0,35,28
1683309937307,PHIL 13,A02,186977,Staff,16,0,35,19
1683309938334,PHIL 14,A01,186979,Staff,31,0,35,4
1683309938334,PHIL 14,A02,186986,Staff,32,0,35,3
1683309939360,PHIL 28,A01,186988,Staff,16,0,30,14
1683309939360,PHIL 28,A02,186989,Staff,1,0,30,29
1683309939360,PHIL 28,A03,186990,Staff,9,0,30,21
1683309939360,PHIL 28,A04,186991,Staff,26,0,30,4
1683309940385,PHIL 120,A00,186997,Staff,23,0,40,17
1683309941409,PHIL 137,A00,187003,Staff,9,0,40,31
1683309942433,PHIL 150,A00,187015,Staff,47,0,70,23
1683309943457,PHIL 167,A00,187021,Lamey; Andy M.,35,0,40,5
1683309944483,PHIL 174,A01,202226,Staff,17,0,20,3
1683309944483,PHIL 174,A02,202235,Staff,20,0,20,0
1683309945509,PHIL 191A,A00,258918,Staff,0,0,1,1
1683309946536,PHYS 1A,A00,187028,Staff,27,0,60,33
1683309947560,PHYS 1AL,001,187036,Staff,3,0,30,27
1683309947560,PHYS 1AL,002,187049,Staff,18,0,30,12
1683309948588,PHYS 1B,A00,187058,Staff,23,0,60,37
1683309949615,PHYS 1BL,001,187064,Staff,0,0,30,30
1683309949615,PHYS 1BL,002,187070,Staff,6,0,30,24
1683309950639,PHYS 1C,A00,187082,Staff,31,0,120,89
1683309951683,PHYS 1CL,001,187088,Staff,0,9,30,30
1683309951683,PHYS 1CL,002,187089,Staff,0,2,30,30
1683309951683,PHYS 1CL,009,262693,Staff,11,0,30,19
1683309952707,PHYS 2B,A01,187097,Staff,54,0,115,61
1683309953734,PHYS 2C,A01,187099,Staff,67,0,115,48
1683309954764,PHYS 2CL,A01,187101,Staff,5,0,28,23
1683309954764,PHYS 2CL,A02,187102,Staff,15,0,28,13
1683309955792,PHYS 2D,A01,187123,Shotwell; Brian,95,0,115,20
1683309956817,PHYS 4B,A01,187133,Grinstein; Benjamin,35,0,50,15
1683309957844,POLI 10,A00,188819,Staff,0,3,50,50
1683309958870,POLI 11,A00,188827,Staff,43,0,50,7
1683309959897,POLI 13R,A00,188828,Staff,0,1,20,20
1683309960920,POLI 27,A01,188830,Elgin; Samuel Zincke,0,1,70,70
1683309961945,POLI 30,A00,188832,Desposato; Scott,33,0,50,17
1683309962972,POLI 102F,A00,188834,Staff,3,0,40,37
1683309963998,POLI 104A,A00,188852,Staff,14,0,30,16
1683309965026,POLI 104I,A00,188853,Staff,0,6,20,20
1683309966052,POLI 110B,A00,188854,Wiens; David,7,0,20,13
1683309967079,POLI 112A,A00,188855,Wiens; David,5,0,30,25
1683309968103,POLI 117R,A00,188856,Forman; Fonna,0,11,20,20
1683309969130,POLI 118,A00,188857,Ingham; Sean,8,0,20,12
1683309970156,POLI 120G,A00,188858,Staff,9,0,30,21
1683309971181,POLI 131CR,A00,188863,Hoston; Germaine,24,0,50,26
1683309972208,POLI 133,A00,188864,Nellis; Gareth Hb,44,0,50,6
1683309973231,POLI 134D,A00,188865,Desposato; Scott,27,0,30,3
1683309974253,POLI 142A,A00,188871,Gartzke; Erik,22,0,50,28
1683309975278,POLI 142K,A00,188874,Staff,38,0,50,12
1683309976303,POLI 143,A00,188940,Gartzke; Erik,16,0,30,14
1683309977330,POLI 153,A00,188943,Staff,3,0,20,17
1683309978357,POLI 160AA,A00,188944,Staff,12,0,40,28
1683309979382,POLI 170A,A00,188945,Staff,11,0,30,19
1683309981442,PSYC 1,A00,188952,Staff,37,0,90,53
1683309982468,PSYC 2,B00,188953,Staff,20,0,35,15
1683309983494,PSYC 6,A00,188970,Staff,47,0,60,13
1683309984521,PSYC 7,A00,188973,Staff,37,0,45,8
1683309985548,PSYC 60,A01,188980,Rickard; Timothy C.,43,0,60,17
1683309986576,PSYC 70,A01,189001,Steiner; Eric Tomas,24,0,45,21
1683309987599,PSYC 100,A00,189005,Lacefield; Katharine I,0,99,120,120
1683309988625,PSYC 102,A00,189008,Staff,10,0,30,20
1683309989651,PSYC 106,B00,189026,Gorman; Michael R.,37,0,60,23
1683309990677,PSYC 114,B01,189033,Winkielman; Piotr,0,32,30,30
1683309991702,PSYC 131,A00,189036,Anagnostaras; Stephan,0,43,60,60
1683309992729,PSYC 136,A00,189041,Lowe; Angela Beth,0,7,25,25
1683309993754,PSYC 137,A00,189057,Winkielman; Piotr,0,34,25,25
1683309994778,PSYC 144,A00,189107,Wixted; John T,0,7,50,50
1683309996824,PSYC 162,A00,189142,Staff,0,8,85,85
1683309997847,PSYC 172,A00,189144,Gorman; Michael R.,0,7,30,30
1683309999894,PSYC 179,A00,189146,Lacefield; Katharine I,0,84,120,120
1683310000916,PSYC 181,A00,189147,Anagnostaras; Stephan,0,44,90,90
1683310001940,PSYC 190R,A00,189148,Barner; David A.,0,22,80,80
1683310002967,PSYC 191,A00,189275,Rickard; Timothy C.,0,7,25,25
1683310003994,PSYC 193,A00,189276,Chapman; Eddie Nathaniel,0,1,0,4
1683310005019,PSYC 193L,A01,189281,Lowe; Angela Beth,12,0,20,8
1683310005019,PSYC 193L,B01,189285,Staff,28,0,35,7
1683310006042,RELI 149,A00,187137,Rahimi; Babak,7,0,40,33
1683310007070,SE 9,A01,187315,Staff,0,2,18,18
1683310008093,SE 101B,A00,187409,Staff,24,0,30,6
1683310009119,SE 110B,A00,187444,Staff,10,0,40,30
1683310010145,SE 130B,A00,187449,Staff,31,0,40,9
1683310011171,SE 150A,A00,187516,Staff,9,0,20,11
1683310012194,SE 154,A00,187528,Staff,30,0,50,20
1683310013216,SIO 3,A01,258171,Staff,35,0,40,5
1683310014238,SIO 10,A00,187144,Cook; Geoffrey W,0,3,75,75
1683310015265,SIO 45,A00,187152,Cook; Geoffrey W,1,0,100,99
1683310016289,SIO 109R,A00,194486,Staff,0,3,20,20
1683310018335,SIO 187,A01,187233,Kacev; David,12,0,40,28
1683310019363,SOCI 1,A01,258656,Thorpe; Charles Robert,28,0,30,2
1683310019363,SOCI 1,A02,258658,Thorpe; Charles Robert,30,0,30,0
1683310019363,SOCI 1,A03,258661,Thorpe; Charles Robert,25,0,25,0
1683310019363,SOCI 1,A04,258666,Thorpe; Charles Robert,22,0,25,3
1683310019363,SOCI 1,A05,258897,Thorpe; Charles Robert,23,0,25,2
1683310019363,SOCI 1,A06,258898,Thorpe; Charles Robert,25,0,25,0
1683310020388,SOCI 30,A01,258903,Pardo Guerra; Juan Pablo,16,0,30,14
1683310021410,SOCI 102,A00,258904,Staff,9,0,25,16
1683310022436,SOCI 106,A00,258905,Staff,19,0,25,6
1683310023460,SOCI 111,A00,258907,Ribas Norris; Janet Vanesa,26,0,30,4
1683310024487,SOCI 121R,A00,258908,Pardo Guerra; Juan Pablo,11,0,30,19
1683310025510,SOCI 126,A01,203330,Staff,14,0,20,6
1683310026535,SOCI 131,A00,258909,Thorpe; Charles Robert,31,0,60,29
1683310027563,SOCI 135,A00,258910,Payne; Christine Anna,0,9,30,30
1683310028589,SOCI 157,A00,258911,Staff,13,0,30,17
1683310029616,SOCI 184,A00,258912,Staff,26,0,30,4
1683310030639,SOCI 188D,A00,258913,Staff,21,0,30,9
1683310031663,SYN 2,001,187529,Staff,9,0,16,7
1683310031663,SYN 2,002,201452,Staff,0,18,16,16
1683310031663,SYN 2,003,201469,Staff,3,0,16,13
1683310032687,SYN 100,A01,187531,Staff,0,9,20,20
1683310032687,SYN 100,B01,201491,Staff,0,12,20,20
1683310033711,TDAC 1,A00,189286,Walsh; Kim C.,3,0,20,17
1683310033711,TDAC 1,B00,189287,Harting; Carla Kelso,11,0,20,9
1683310034738,TDAC 101,A00,189300,Walsh; Kim C.,16,0,20,4
1683310034738,TDAC 101,B00,189301,Harting; Carla Kelso,18,0,20,2
1683310035762,TDAC 102,A00,189304,Basso; Beatrice,14,0,20,6
1683310036790,TDAC 108,A00,189305,Staff,18,0,20,2
1683310037815,TDDE 131,A00,189310,Staff,19,0,20,1
1683310037815,TDDE 131,B00,189314,Staff,19,0,20,1
1683310037815,TDDE 131,C00,189315,Staff,48,0,50,2
1683310037815,TDDE 131,D00,189316,Staff,14,0,15,1
1683310037815,TDDE 131,E00,204841,Staff,20,0,20,0
1683310038839,TDGE 10,A00,189289,Staff,30,0,50,20
1683310038839,TDGE 10,B00,189290,Havis; Allan,2,0,50,48
1683310039869,TDGE 11,A00,189291,Fulton; Julia,0,3,50,50
1683310039869,TDGE 11,B00,189292,Staff,20,0,25,5
1683310039869,TDGE 11,C00,260270,Staff,0,0,0,0
1683310040948,TDGE 25,A00,189294,Staff,3,0,20,17
1683310041975,TDGE 124,A00,189318,Fulton; Julia,0,8,50,50
1683310043003,TDGE 125,A00,189319,Staff,13,0,25,12
1683310043003,TDGE 125,B00,189320,Staff,23,0,25,2
1683310044027,TDGE 127,A00,189322,Havis; Allan,0,0,50,50
1683310045051,TDHT 101,A00,189323,Staff,18,0,25,7
1683310045051,TDHT 101,B00,189324,Staff,25,0,25,0
1683310046075,TDHT 102,A00,189325,Staff,49,0,50,1
1683310047103,TDMV 1,A00,189295,Arcidiacono; Kristin,20,0,30,10
1683310047103,TDMV 1,B00,189296,Caligagan; Maria T.,24,0,30,6
1683310048127,TDMV 2,A00,189297,Sammartano; Tonnie,28,0,30,2
1683310048127,TDMV 2,B00,189299,Arcidiacono; Kristin,24,0,30,6
1683310049150,TDMV 3,A00,204998,Rincon; Alicia,22,0,30,8
1683310050175,TDMV 120,A00,189458,Sammartano; Tonnie,28,0,30,2
1683310051201,TDMV 138,A00,189541,Jun; Grace Shin Hae,22,0,40,18
1683310052228,TDMV 142,A00,189717,Caligagan; Tony,23,0,30,7
1683310052228,TDMV 142,B00,189718,Caligagan; Maria T.,25,0,30,5
1683310053254,TMC 2,A01,187533,Staff,25,0,25,0
1683310053254,TMC 2,A02,187534,Staff,25,0,25,0
1683310054278,USP 1,A01,187536,Kwak; Nancy,0,16,25,25
1683310055303,USP 5,A01,187538,Staff,9,0,25,16
1683310056330,USP 101,A00,199253,Staff,0,4,0,0
1683310057357,USP 124,A00,187562,Boomhower; Matthew Charles,1,0,30,29
1683310058386,USP 138,A00,187582,Staff,20,0,25,5
1683310059412,USP 152,A01,187597,Staff,4,0,25,21
1683310060438,USP 153,A00,187598,Staff,19,0,25,6
1683310061465,USP 168,A00,187607,Kwak; Nancy,2,0,5,3
1683310062489,USP 173,A00,187619,Staff,4,0,25,21
1683310063513,USP 181,A00,187638,Staff,0,0,25,25
1683310064539,VIS 103,A00,187650,Cruz; Edwin Teddy,23,0,75,52
1683310065563,VIS 110D,A00,187669,Staff,12,0,22,10
1683310066587,VIS 127C,A00,187720,Shen; Kuiyi,68,0,146,78
1683310067615,VIS 149,A00,187731,Yoldas; Pinar,0,14,22,22
1683310068642,VIS 151,A01,188091,Staff,22,0,34,12
1683310068642,VIS 151,A02,188092,Staff,11,0,34,23
1683310069671,VIS 160B,A00,188093,Stalbaum; Brett,0,0,10,10
1683310071723,WCWP 10B,A00,201720,Staff,10,0,15,5
1683310071723,WCWP 10B,B00,201722,Staff,8,0,15,7
1683310072747,WCWP 100,A00,201725,Gagnon; Jeffrey C,0,0,2,2
1683310072747,WCWP 100,B00,201727,Staff,0,4,15,15
1683310075838,ANBI 133,A00,258401,Wilder; Linnea Lorene,34,0,40,6
1683310076861,ANBI 140,A00,258395,Hrvoj Mihic; Branka,18,0,25,7
1683310077888,ANSC 120,A00,258402,Bialecki; Jon Anthony,27,0,40,13
1683310078912,ANSC 144,A00,258400,Staff,14,0,40,26
1683310080960,ANSC 166,A00,258396,Parish; Steven Martin,157,0,175,18
1683310081986,ANSC 180,A00,193533,Staff,9,0,20,11
1683310083014,ANSC 188,A00,258397,Jassal; Aftab,33,0,40,7
1683310084041,ANTH 3,A01,258316,Staff,23,0,30,7
1683310085066,ANTH 5,A00,258394,Semendeferi; Ekaterini,16,0,20,4
1683310086090,ANTH 21,A01,258331,Staff,9,0,40,31
1683310087115,ANTH 103,A00,258398,Varma; Saiba,15,0,25,10
1683310088146,AWP 10,001,202034,Staff,0,0,0,0
1683310088146,AWP 10,002,202035,Staff,0,0,0,0
1683310088146,AWP 10,003,202036,Staff,0,0,0,0
1683310088146,AWP 10,004,202037,Staff,0,0,0,0
1683310088146,AWP 10,005,202038,Staff,0,0,0,0
1683310088146,AWP 10,006,202039,Staff,0,0,0,0
1683310088146,AWP 10,007,202040,Staff,0,0,0,0
1683310088146,AWP 10,008,202041,Staff,0,0,0,0
1683310088146,AWP 10,009,202042,Staff,0,0,0,0
1683310088146,AWP 10,010,202043,Staff,0,0,0,0
1683310088146,AWP 10,011,202044,Staff,0,0,0,0
1683310088146,AWP 10,012,202045,Staff,0,0,0,0
1683310088146,AWP 10,013,202046,Staff,0,0,0,0
1683310088146,AWP 10,014,202047,Staff,0,0,0,0
1683310088146,AWP 10,015,202048,Staff,0,0,0,0
1683310088146,AWP 10,016,202049,Staff,0,0,0,0
1683310088146,AWP 10,017,202050,Staff,0,0,0,0
1683310088146,AWP 10,018,202051,Staff,0,0,0,0
1683310088146,AWP 10,019,202052,Staff,0,0,0,0
1683310088146,AWP 10,020,202053,Staff,0,0,0,0
1683310088146,AWP 10,021,202054,Staff,0,0,0,0
1683310088146,AWP 10,022,202055,Staff,0,0,0,0
1683310088146,AWP 10,023,202056,Staff,0,0,0,0
1683310088146,AWP 10,024,202057,Staff,0,0,0,0
1683310088146,AWP 10,025,202058,Staff,0,0,0,0
1683310088146,AWP 10,026,202059,Staff,0,0,0,0
1683310089171,AWP 102,001,202032,Staff,0,0,0,0
1683310089171,AWP 102,002,202033,Staff,0,0,0,0
1683310090200,BENG 100,A01,254234,Taylor Amos; Alyssa C,31,0,40,9
1683310091227,BENG 196,001,270013,Engler; Adam J.,9999,0,9999,0
1683310092253,BICD 100R,A01,202018,Smith; Laurie,0,7,32,32
1683310092253,BICD 100R,A02,202019,Smith; Laurie,0,2,32,32
1683310092253,BICD 100R,A03,202020,Smith; Laurie,0,1,32,32
1683310092253,BICD 100R,A04,202021,Smith; Laurie,8,0,32,24
1683310092253,BICD 100R,A05,202022,Smith; Laurie,12,0,32,20
1683310093278,BICD 136,A01,193242,Gustafson-Brown; Cindy,0,2,32,32
1683310093278,BICD 136,A02,193244,Gustafson-Brown; Cindy,15,0,32,17
1683310094307,BIEB 102,A01,193249,Butler; Shannon Rhey,0,2,32,32
1683310094307,BIEB 102,A02,193251,Butler; Shannon Rhey,0,0,32,32
1683310094307,BIEB 102,A03,193253,Butler; Shannon Rhey,0,1,32,32
1683310094307,BIEB 102,A04,193255,Butler; Shannon Rhey,17,0,32,15
1683310094307,BIEB 102,A05,193265,Butler; Shannon Rhey,26,0,32,6
1683310094307,BIEB 102,A06,193269,Butler; Shannon Rhey,16,0,32,16
1683310096361,BIEB 150,A01,193274,Staff,0,0,32,32
1683310096361,BIEB 150,A02,193285,Staff,24,0,32,8
1683310097388,BIEB 194,A00,193286,Kurle; Carolyn M.,22,0,32,10
1683310098415,BILD 1,A01,192291,Staff,16,0,32,16
1683310098415,BILD 1,A02,192292,Staff,30,0,32,2
1683310098415,BILD 1,B01,192520,Reuther; Keefe,0,1,0,0
1683310098415,BILD 1,B02,192532,Reuther; Keefe,0,1,0,0
1683310099440,BILD 3,A01,192556,Butler; Shannon Rhey,0,0,32,32
1683310099440,BILD 3,A02,192581,Butler; Shannon Rhey,5,0,32,27
1683310099440,BILD 3,A03,192611,Butler; Shannon Rhey,23,0,32,9
1683310099440,BILD 3,A04,192612,Butler; Shannon Rhey,25,0,32,7
1683310099440,BILD 3,A05,192613,Butler; Shannon Rhey,27,0,32,5
1683310099440,BILD 3,A06,192679,Butler; Shannon Rhey,27,0,32,5
1683310099440,BILD 3,A07,192682,Butler; Shannon Rhey,22,0,32,10
1683310100464,BILD 4,A01,192836,Reuther; Keefe,1,0,24,23
1683310100464,BILD 4,A02,193044,Reuther; Keefe,4,0,24,20
1683310101488,BILD 10,A01,193142,Gustafson-Brown; Cindy,31,0,32,1
1683310101488,BILD 10,A02,193149,Gustafson-Brown; Cindy,31,0,32,1
1683310102511,BIMM 100,A01,193301,Staff,0,6,32,32
1683310102511,BIMM 100,A02,193312,Staff,0,5,32,32
1683310102511,BIMM 100,A03,193323,Staff,0,8,32,32
1683310103537,BIMM 101,A01,193329,McDonnell; Lisa Marie,0,3,24,24
1683310103537,BIMM 101,A02,193339,McDonnell; Lisa Marie,0,2,24,24
1683310103537,BIMM 101,B01,193354,McDonnell; Lisa Marie,0,3,24,24
1683310103537,BIMM 101,B02,193357,McDonnell; Lisa Marie,0,3,24,24
1683310104563,BIMM 110,A01,193377,Tat; John,0,11,32,32
1683310104563,BIMM 110,A02,193378,Tat; John,1,9,32,31
1683310105591,BIMM 120,A01,206116,Staff,0,0,32,32
1683310105591,BIMM 120,A02,206117,Staff,8,0,32,24
1683310105591,BIMM 120,A03,206121,Staff,21,0,32,11
1683310106619,BIPN 100,A01,193393,Park; Ji Young,0,14,32,32
1683310106619,BIPN 100,A02,193402,Park; Ji Young,0,12,32,32
1683310106619,BIPN 100,A03,193413,Park; Ji Young,0,14,32,32
1683310106619,BIPN 100,A04,193414,Park; Ji Young,0,13,32,32
1683310107646,BIPN 102,A01,193429,Staff,0,0,32,32
1683310107646,BIPN 102,A02,193438,Staff,22,0,32,10
1683310108670,BIPN 106,A01,193450,Reyes Gonzalez; Catalina,0,2,40,40
1683310109700,BIPN 134,A01,193465,Cooke; James Edward,0,0,32,32
1683310109700,BIPN 134,A02,193474,Cooke; James Edward,27,0,32,5
1683310109700,BIPN 134,A03,193485,Cooke; James Edward,29,0,32,3
1683310109700,BIPN 134,A04,193486,Cooke; James Edward,21,0,32,11
1683310109700,BIPN 134,A05,193491,Cooke; James Edward,31,0,32,1
1683310109700,BIPN 134,A06,193501,Cooke; James Edward,30,0,32,2
1683310109700,BIPN 134,A07,193510,Cooke; James Edward,29,0,32,3
1683310111756,BISP 194,A00,222522,Staff,16,0,32,16
1683310112780,CAT 124,A01,202407,Staff,20,0,25,5
1683310113803,CAT 125,A00,202408,Marchisotto; Jennifer Anne,4,0,20,16
1683310114827,CAT 125R,A00,202409,Smith; Lauryn Alissa,0,11,20,20
1683310114827,CAT 125R,B00,202410,Morales; Celeste Georgianna,0,11,20,20
1683310114827,CAT 125R,C00,202411,Irwin; Matthew Joseph,0,10,20,20
1683310115854,CENG 15,A01,204712,Yang; Kesong,0,1,0,0
1683310116882,CENG 114,A00,202070,Jahed Motlagh; Zeinab,5,0,20,15
1683310117909,CGS 105,A00,185477,Wesling; Megan E.,24,0,40,16
1683310118935,CGS 106,A00,185494,Staff,13,0,22,9
1683310119958,CGS 108,A00,185495,Staff,14,0,20,6
1683310120983,CGS 114,A00,185496,Staff,13,0,18,5
1683310122010,CGS 119,A00,185501,Staff,15,0,20,5
1683310123036,CGS 120,A00,185511,Staff,13,0,20,7
1683310124064,CHEM 4,A01,184675,Bussey; Thomas J,96,0,100,4
1683310125089,CHEM 6A,A01,184677,Staff,35,0,60,25
1683310126114,CHEM 6B,A01,184679,Staff,65,0,100,35
1683310127140,CHEM 6C,A01,184681,Bussey; Thomas J,1,0,50,49
1683310127140,CHEM 6C,A02,184682,Bussey; Thomas J,34,0,50,16
1683310128164,CHEM 40A,A01,184684,Albizati; Kim F.,37,0,100,63
1683310129192,CHEM 40B,A01,184686,Albizati; Kim F.,0,20,100,100
1683310130216,CHEM 41B,A01,184690,Staff,52,0,100,48
1683310131244,COGS 3,A01,184715,Boyle; Mary E. T.,0,25,40,40
1683310132269,COGS 14B,A01,185172,Staff,0,15,38,38
1683310133292,COGS 18,A01,184736,Staff,19,0,80,61
1683310134316,COGS 100,A01,184932,Staff,0,5,73,73
1683310135342,COGS 101A,A01,184935,Staff,0,38,30,30
1683310136368,COGS 101B,A01,184944,Staff,0,2,30,30
1683310137391,COGS 101C,A01,184946,Staff,0,12,30,30
1683310138418,COGS 102A,A01,184951,Johnson; Christine M.,2,0,40,38
1683310139446,COGS 107B,A01,184953,Mooshagian; Eric Frederick,0,50,40,40
1683310140470,COGS 118B,A01,184959,Gupta; Anjum,0,48,40,40
1683310141496,COGS 153,A00,184961,Staff,0,15,30,30
1683310142523,COGS 177,A00,184962,Staff,0,21,30,30
1683310143551,COGS 187A,A01,184969,Boyle; Mary E. T.,0,17,40,40
1683310144631,COMM 10,A01,185174,Staff,0,5,25,25
1683310144631,COMM 10,A02,185189,Staff,0,5,25,25
1683310144631,COMM 10,A03,269821,Staff,0,0,0,0
1683310145656,COMM 100B,A01,185475,Staff,0,0,0,2
1683310145656,COMM 100B,A02,185476,Staff,14,0,25,11
1683310146679,COMM 100C,A01,185314,Staff,1,0,25,24
1683310146679,COMM 100C,A02,185327,Staff,19,0,25,6
1683310147702,COMM 110M,A00,185349,Staff,2,0,40,38
1683310148727,COMM 113T,A00,185352,Staff,25,0,40,15
1683310149750,COMM 114I,A00,185353,Staff,33,0,40,7
1683310150775,COMM 131,A00,185354,Staff,19,0,30,11
1683310151800,CSE 8A,A50,185358,Cao; Yingjun,0,46,10,10
1683310152827,CSE 8B,A01,185362,Staff,1,47,50,49
1683310153854,CSE 11,A01,185416,Cao; Yingjun,0,92,10,10
1683310154882,CSE 20,A01,185445,Briones; Jor-el Thomas Caparas,5,0,25,20
1683310155909,CSE 21,A01,185447,Staff,10,0,50,40
1683310156935,CSE 101,A01,185451,Staff,0,12,50,50
1683310156935,CSE 101,B01,185453,Jones; Miles E,0,11,50,50
1683310158984,CSE 141,A01,185458,Eldon; John,20,0,100,80
1683310160009,CSE 141L,A01,185461,Eldon; John,12,0,100,88
1683310161035,CSE 142,A01,185463,Staff,35,0,60,25
1683310161035,CSE 142,B01,201355,Staff,0,6,60,60
1683310162059,CSE 142L,A01,185470,Staff,35,0,60,25
1683310162059,CSE 142L,B01,201417,Staff,0,5,60,60
1683310163084,CSE 190,A00,201433,Staff,32,0,49,17
1683310164109,DOC 1,A01,259136,Strom; Megan C.,8,0,15,7
1683310164109,DOC 1,A02,259137,Strom; Megan C.,14,0,15,1
1683310164109,DOC 1,A03,259138,Strom; Megan C.,14,0,15,1
1683310164109,DOC 1,A04,259139,Strom; Megan C.,14,0,15,1
1683310165132,DOC 100D,A00,259140,Pass; Natalye Joann,17,0,25,8
1683310166156,DSGN 1,A01,184749,Rill; Bryan,0,25,30,30
1683310167180,DSGN 100,A01,185168,Staff,0,2,25,25
1683310168206,ECE 5,A01,185626,Morris; Karcher William,0,10,0,0
1683310169232,ECE 101,A01,185628,Staff,17,0,70,53
1683310170255,ECE 107,A01,185635,Baghdadchi; Saharnaz,0,0,20,20
1683310170255,ECE 107,A02,185638,Baghdadchi; Saharnaz,4,0,20,16
1683310171278,ECE 148,A01,185647,Silberman; Jack,0,0,16,16
1683310172301,ECON 1,A01,185537,Crane; Meredith Helen,54,0,70,16
1683310173330,ECON 3,A01,185549,Crane; Meredith Helen,33,0,70,37
1683310174357,ECON 4,A01,203354,Anderson; John Charles,0,4,10,10
1683310175382,ECON 100A,A01,185574,Staff,0,4,40,40
1683310176408,ECON 100B,A01,185576,Staff,0,22,40,40
1683310177434,ECON 100C,A01,185589,Newhouse; Herbert S,30,0,70,40
1683310178458,ECON 105,A00,185608,Vespa; Emanuel Ignacio,19,0,35,16
1683310179481,ECON 109,A01,185610,Shishkin; Denis,10,0,35,25
1683310180509,ECON 110A,A01,185612,Staff,11,0,40,29
1683310181533,ECON 120A,A01,185615,Staff,20,0,40,20
1683310182558,ECON 120C,A01,185617,Sun; Yixiao,0,20,70,70
1683310183587,ECON 144,A00,203346,Squires; Dale E,3,0,35,32
1683310184615,ECON 171,A01,203349,Newhouse; Herbert S,0,1,35,35
1683310185644,ECON 173A,A01,185621,Toda; Alexis Akira,21,0,35,14
1683310186670,EDS 25,A01,202413,Staff,0,1,0,0
1683310186670,EDS 25,A02,202414,Staff,0,1,0,0
1683310186670,EDS 25,A03,202415,Staff,0,0,0,0
1683310186670,EDS 25,A04,202416,Staff,0,1,0,0
1683310186670,EDS 25,A05,202439,Staff,0,0,0,0
1683310186670,EDS 25,A06,202440,Staff,0,0,0,0
1683310186670,EDS 25,B01,202631,Staff,0,0,0,0
1683310186670,EDS 25,B02,202632,Staff,0,0,0,0
1683310186670,EDS 25,B03,202639,Staff,0,0,0,0
1683310186670,EDS 25,B04,202640,Staff,0,0,0,0
1683310186670,EDS 25,B05,202643,Staff,0,0,0,0
1683310186670,EDS 25,B06,202644,Staff,0,0,0,0
1683310187699,EDS 38,A01,202659,Black; Alison Michelle,24,0,25,1
1683310188725,EDS 115,A00,202652,Staff,17,0,30,13
1683310189749,EDS 125,A00,202649,Staff,14,0,30,16
1683310190774,EDS 126,A01,203332,Staff,30,0,30,0
1683310191803,EDS 139,A00,202838,Staff,17,0,25,8
1683310192827,EDS 146,A01,202655,Staff,15,0,25,10
1683310193853,ENG 15,A00,185667,Staff,0,1,0,0
1683310193853,ENG 15,B00,185672,Staff,0,0,0,0
1683310193853,ENG 15,C00,185675,Staff,0,0,0,0
1683310193853,ENG 15,D00,185682,Staff,0,0,0,0
1683310193853,ENG 15,E00,185684,Staff,0,0,0,0
1683310194880,ETHN 103,A00,185710,Staff,0,3,35,35
1683310195908,ETHN 103A,A00,199228,Man; Simeon S,2,0,9,7
1683310196932,ETHN 109,A00,185711,Staff,18,0,35,17
1683310197960,ETHN 142,A00,185726,Staff,0,4,30,30
1683310198987,ETHN 163J,A00,199229,Man; Simeon S,6,0,8,2
1683310200012,ETHN 168,A00,185727,Staff,8,0,10,2
1683310201036,ETHN 182,A00,185728,Staff,1,0,35,34
1683310202068,ETHN 183,A00,185737,Staff,8,0,18,10
1683310203093,GLBH 111,A01,209361,Burgos; Jose L.,0,0,0,0
1683310205139,HIEU 104,A00,185792,Staff,16,0,20,4
1683310206162,HIEU 115,A00,185800,Staff,1,0,20,19
1683310207189,HIEU 128,A00,185801,Staff,0,7,20,20
1683310208216,HIEU 147,A00,185802,Staff,16,0,20,4
1683310209241,HIEU 154,A00,185823,Staff,12,0,20,8
1683310210267,HILA 102,A00,185826,Staff,13,0,20,7
1683310211293,HILD 2C,A01,185778,Staff,0,12,20,20
1683310212318,HILD 7B,A01,185780,Kwak; Nancy,0,15,32,32
1683310212318,HILD 7B,A02,185781,Kwak; Nancy,0,18,32,32
1683310213345,HILD 30,A01,185791,Staff,14,0,20,6
1683310214373,HISC 119,A00,185830,Golan; Tal,0,9,20,20
1683310215409,HITO 156GS,A00,185831,Patterson; Patrick H.,0,0,0,23
1683310216436,HIUS 103,A00,185832,Man; Simeon S,0,6,20,20
1683310217460,HIUS 117,A00,185836,Kwak; Nancy,2,0,20,18
1683310218484,HIUS 125,A00,185840,Man; Simeon S,0,0,23,23
1683310219511,HIUS 149,A00,185845,Staff,0,0,20,20
1683310220536,HUM 3,A01,185882,Zavodny; Tatiana Sophia,0,6,50,50
1683310220536,HUM 3,B01,185899,Caldwell; Michael Alan,0,19,50,50
1683310221560,HUM 3GS,A00,185900,Patterson; Patrick H.,0,0,0,23
1683310222584,HUM 4,A01,185938,Zroka; Amy Liane,31,0,50,19
1683310222584,HUM 4,B01,185956,Watkins; Eric,0,2,50,50
1683310222584,HUM 4,B02,202209,Watkins; Eric,0,2,50,50
1683310222584,HUM 4,B03,202210,Watkins; Eric,0,0,50,50
1683310223614,HUM 5,A01,185958,West; Geoffrey Scott,4,0,50,46
1683310223614,HUM 5,A02,202215,West; Geoffrey Scott,0,0,50,50
1683310224638,INTL 190,A00,185959,Gagnon; Jeffrey C,0,0,0,9
1683310224638,INTL 190,B00,185960,Lettieri; Michael Joseph,0,0,0,1
1683310225666,JAPN 180,A00,254509,Staff,5,1,30,25
1683310226689,LATI 10,A01,202853,Kennemore; Amy Michelle,5,0,35,30
1683310226689,LATI 10,A02,202854,Kennemore; Amy Michelle,1,0,35,34
1683310226689,LATI 10,A03,270054,Kennemore; Amy Michelle,30,0,30,0
1683310227716,LATI 180,A00,202855,Kennemore; Amy Michelle,11,0,20,9
1683310228745,LAWS 101,A00,201767,Golan; Tal,0,7,40,40
1683310229769,LIFR 1C,A00,185961,Staff,6,0,20,14
1683310230794,LIFR 1CX,A00,185962,Staff,7,0,20,13
1683310231819,LIFR 1D,A00,185963,Staff,9,0,20,11
1683310232846,LIFR 1DX,A00,185964,Staff,9,0,20,11
1683310233870,LIGN 101,A01,186039,Staff,43,0,50,7
1683310234896,LIGN 165,A00,186040,Staff,18,0,50,32
1683310235922,LTCS 108,A00,186041,Staff,6,0,10,4
1683310236945,LTCS 119,A00,186042,Staff,16,0,20,4
1683310237970,LTCS 130,A00,186043,Wesling; Megan E.,15,0,25,10
1683310240023,LTEA 138,A00,186119,Staff,14,0,40,26
1683310241049,LTEN 124,A00,186148,Staff,6,0,25,19
1683310242073,LTEN 178,A00,186149,Staff,7,0,15,8
1683310243096,LTEN 181,A00,186150,Blanco; John D,33,0,40,7
1683310244121,LTWL 120,A00,186160,Staff,20,0,25,5
1683310245143,LTWL 165,A00,186161,Staff,22,0,25,3
1683310246169,LTWR 100,A00,186162,Staff,0,4,15,15
1683310247196,LTWR 102,A00,186163,Doller; Ben,5,0,15,10
1683310248278,MAE 8,A01,186412,Staff,0,0,0,0
1683310249302,MAE 30B,A00,186445,Bahadori; Mohammad Yousef,83,0,100,17
1683310250328,MAE 40,A00,186592,Bewley; Thomas R,9,0,50,41
1683310251351,MAE 101B,A00,186593,Bahadori; Mohammad Yousef,81,0,100,19
1683310252376,MAE 105,A00,186594,Bandaru; Prabhakar,12,0,50,38
1683310253404,MAE 107,A00,186599,Pham; Hieu Tan,0,6,120,120
1683310254431,MAE 148,A01,186660,Silberman; Jack,3,0,16,13
1683310255454,MATH 10A,A01,188095,Staff,0,7,35,35
1683310256483,MATH 10B,A01,188097,Bowers; Adam R.,0,10,30,30
1683310256483,MATH 10B,A02,188099,Bowers; Adam R.,0,11,30,30
1683310256483,MATH 10B,B01,188104,Bowers; Adam R.,0,10,30,30
1683310256483,MATH 10B,B02,188106,Bowers; Adam R.,0,11,30,30
1683310257517,MATH 10C,A01,188111,Staff,0,18,30,30
1683310257517,MATH 10C,A02,188127,Staff,0,17,30,30
1683310257517,MATH 10C,A03,188131,Staff,0,18,30,30
1683310257517,MATH 10C,B01,188218,Staff,20,0,30,10
1683310257517,MATH 10C,B02,188244,Staff,13,0,30,17
1683310257517,MATH 10C,B03,188277,Staff,16,0,30,14
1683310258545,MATH 18,A01,188344,Bach; Quang Tran,18,0,30,12
1683310258545,MATH 18,A02,188345,Bach; Quang Tran,11,0,30,19
1683310258545,MATH 18,B01,188353,Bach; Quang Tran,10,0,30,20
1683310258545,MATH 18,B02,188354,Bach; Quang Tran,20,0,30,10
1683310259568,MATH 20A,A01,188374,Staff,13,0,35,22
1683310260594,MATH 20B,A01,188382,Ohm; Ko Woon,6,0,30,24
1683310260594,MATH 20B,A02,188383,Ohm; Ko Woon,23,0,30,7
1683310260594,MATH 20B,B01,188385,Ohm; Ko Woon,7,0,30,23
1683310260594,MATH 20B,B02,188392,Ohm; Ko Woon,22,0,30,8
1683310261620,MATH 20C,A01,188394,Harel; Guershon,10,0,30,20
1683310261620,MATH 20C,A02,188395,Harel; Guershon,13,0,30,17
1683310261620,MATH 20C,B01,188404,Harel; Guershon,3,0,30,27
1683310261620,MATH 20C,B02,188405,Harel; Guershon,19,0,30,11
1683310262648,MATH 20D,A01,188414,Hammock; Frances H,0,1,30,30
1683310262648,MATH 20D,A02,188415,Hammock; Frances H,4,0,30,26
1683310262648,MATH 20D,B01,188447,Hammock; Frances H,2,0,30,28
1683310262648,MATH 20D,B02,188486,Hammock; Frances H,8,0,30,22
1683310263675,MATH 20E,A01,188649,Staff,22,0,30,8
1683310263675,MATH 20E,A02,188650,Staff,23,0,30,7
1683310263675,MATH 20E,A03,188673,Staff,0,0,30,30
1683310264699,MATH 102,A01,188675,Staff,0,35,35,35
1683310265727,MATH 103B,A01,188681,Staff,4,0,35,31
1683310265727,MATH 103B,B01,188692,Staff,7,0,35,28
1683310266756,MATH 109,A01,188695,Salehi Golsefidy; Alireza,25,0,35,10
1683310266756,MATH 109,A02,188696,Salehi Golsefidy; Alireza,27,0,35,8
1683310267780,MATH 120A,A01,188698,Eggers; John Dietrich,6,0,35,29
1683310268804,MATH 142B,A01,188736,Ioana; Adrian,0,2,30,30
1683310268804,MATH 142B,A02,188741,Ioana; Adrian,0,1,30,30
1683310268804,MATH 142B,A03,188743,Ioana; Adrian,1,3,30,29
1683310269829,MATH 168A,A01,188790,Staff,0,9,35,35
1683310270853,MATH 170A,A01,188803,Nie; Jiawang,0,2,35,35
1683310270853,MATH 170A,A02,188811,Nie; Jiawang,0,0,35,35
1683310270853,MATH 170A,A03,188814,Nie; Jiawang,1,0,35,34
1683310270853,MATH 170A,A04,188815,Nie; Jiawang,13,0,35,22
1683310271876,MATH 193B,A01,188817,Staff,0,0,35,35
1683310271876,MATH 193B,A02,188818,Staff,5,0,35,30
1683310272899,MGT 4,A01,202857,Anderson; John Charles,62,0,80,18
1683310273923,MGT 12,A00,202858,Lindenberger; Wade Douglas,43,0,90,47
1683310274946,MGT 18,A00,202859,Staff,74,0,90,16
1683310275969,MGT 18GS,A00,202860,McKay; Michael J,13,0,28,15
1683310276993,MGT 45,A00,202861,Pecore; Joseph P.,14,0,90,76
1683310278020,MGT 100,A00,202863,Yavorsky; Daniel Ryan,28,0,90,62
1683310279046,MGT 103,A00,202864,Ehrich; Kristine R,0,16,90,90
1683310280073,MGT 112,A00,202865,Ehrich; Kristine R,15,0,90,75
1683310281098,MGT 121A,A00,202868,Staff,0,19,0,0
1683310282124,MGT 131B,A00,202869,Anderson; John Charles,59,0,90,31
1683310283156,MGT 136,A00,202871,Lindenberger; Wade Douglas,84,0,90,6
1683310284180,MGT 164,A00,202873,Staff,0,69,90,90
1683310285205,MGT 164GS,A00,202874,McKay; Mary A,13,0,28,15
1683310286231,MGT 180,A00,202875,Staff,0,51,90,90
1683310287258,MMW 11R,A01,205019,Herbst; Matthew,3,0,30,27
1683310287258,MMW 11R,A02,205026,Herbst; Matthew,29,0,30,1
1683310288281,MMW 15,A01,193512,Chang; Edmond Yi-Teh,0,9,28,28
1683310288281,MMW 15,A02,193513,Chang; Edmond Yi-Teh,0,5,28,28
1683310288281,MMW 15,A03,193514,Chang; Edmond Yi-Teh,0,5,28,28
1683310288281,MMW 15,A04,193515,Chang; Edmond Yi-Teh,0,5,28,28
1683310288281,MMW 15,A05,193516,Chang; Edmond Yi-Teh,0,4,28,28
1683310288281,MMW 15,A06,193517,Chang; Edmond Yi-Teh,0,5,28,28
1683310288281,MMW 15,B01,193519,Chang; Edmond Yi-Teh,0,4,28,28
1683310288281,MMW 15,B02,193520,Chang; Edmond Yi-Teh,0,5,28,28
1683310288281,MMW 15,B03,193521,Chang; Edmond Yi-Teh,0,4,28,28
1683310288281,MMW 15,B04,193522,Chang; Edmond Yi-Teh,0,4,28,28
1683310288281,MMW 15,B05,193523,Chang; Edmond Yi-Teh,0,5,28,28
1683310288281,MMW 15,B06,193524,Chang; Edmond Yi-Teh,0,4,28,28
1683310289308,MMW 122,A01,193526,Rahimi; Babak,0,14,28,28
1683310289308,MMW 122,A02,193527,Rahimi; Babak,0,14,28,28
1683310289308,MMW 122,A03,193528,Rahimi; Babak,0,0,0,0
1683310289308,MMW 122,A04,193529,Rahimi; Babak,0,0,0,0
1683310290332,MUS 1A,A01,186663,Staff,0,20,35,35
1683310291358,MUS 4,A01,186715,Staff,0,12,35,35
1683310292381,MUS 5R,A01,186796,Dubnov; Shlomo,0,17,35,35
1683310293406,MUS 6,A01,186798,Staff,0,3,25,25
1683310294429,MUS 7,A01,186830,Staff,12,0,35,23
1683310295456,MUS 8,A01,186930,Staff,0,26,35,35
1683310296481,MUS 15,A01,186932,Staff,0,15,35,35
1683310296481,MUS 15,B01,186934,Staff,0,15,35,35
1683310297510,MUS 80,A00,186935,Staff,2,0,20,18
1683310297510,MUS 80,B00,186936,Staff,25,0,25,0
1683310298534,NANO 11,A00,204702,Lipomi; Darren John,0,0,0,0
1683310299563,NANO 15,A01,204709,Yang; Kesong,0,1,0,0
1683310300588,NANO 114,A00,202069,Jahed Motlagh; Zeinab,3,0,10,7
1683310301614,PHIL 1,A00,186955,Grush; Rick Scott,32,0,40,8
1683310302636,PHIL 10,A01,186973,Grush; Rick Scott,28,0,35,7
1683310302636,PHIL 10,A02,186974,Grush; Rick Scott,33,0,35,2
1683310303661,PHIL 13,A01,186976,Staff,7,0,35,28
1683310303661,PHIL 13,A02,186977,Staff,16,0,35,19
1683310304687,PHIL 14,A01,186979,Staff,31,0,35,4
1683310304687,PHIL 14,A02,186986,Staff,32,0,35,3
1683310305712,PHIL 28,A01,186988,Staff,16,0,30,14
1683310305712,PHIL 28,A02,186989,Staff,1,0,30,29
1683310305712,PHIL 28,A03,186990,Staff,9,0,30,21
1683310305712,PHIL 28,A04,186991,Staff,26,0,30,4
1683310306736,PHIL 120,A00,186997,Staff,23,0,40,17
1683310307759,PHIL 137,A00,187003,Staff,9,0,40,31
1683310308783,PHIL 150,A00,187015,Staff,47,0,70,23
1683310309809,PHIL 167,A00,187021,Lamey; Andy M.,35,0,40,5
1683310310833,PHIL 174,A01,202226,Staff,17,0,20,3
1683310310833,PHIL 174,A02,202235,Staff,20,0,20,0
1683310311859,PHIL 191A,A00,258918,Staff,0,0,1,1
1683310312883,PHYS 1A,A00,187028,Staff,27,0,60,33
1683310313913,PHYS 1AL,001,187036,Staff,3,0,30,27
1683310313913,PHYS 1AL,002,187049,Staff,18,0,30,12
1683310314940,PHYS 1B,A00,187058,Staff,23,0,60,37
1683310315964,PHYS 1BL,001,187064,Staff,0,0,30,30
1683310315964,PHYS 1BL,002,187070,Staff,6,0,30,24
1683310316987,PHYS 1C,A00,187082,Staff,31,0,120,89
1683310318013,PHYS 1CL,001,187088,Staff,0,9,30,30
1683310318013,PHYS 1CL,002,187089,Staff,0,2,30,30
1683310318013,PHYS 1CL,009,262693,Staff,11,0,30,19
1683310319041,PHYS 2B,A01,187097,Staff,54,0,115,61
1683310320067,PHYS 2C,A01,187099,Staff,67,0,115,48
1683310321095,PHYS 2CL,A01,187101,Staff,5,0,28,23
1683310321095,PHYS 2CL,A02,187102,Staff,15,0,28,13
1683310322124,PHYS 2D,A01,187123,Shotwell; Brian,95,0,115,20
1683310323152,PHYS 4B,A01,187133,Grinstein; Benjamin,35,0,50,15
1683310324175,POLI 10,A00,188819,Staff,0,3,50,50
1683310325204,POLI 11,A00,188827,Staff,43,0,50,7
1683310326229,POLI 13R,A00,188828,Staff,0,1,20,20
1683310327257,POLI 27,A01,188830,Elgin; Samuel Zincke,0,1,70,70
1683310328282,POLI 30,A00,188832,Desposato; Scott,33,0,50,17
1683310329306,POLI 102F,A00,188834,Staff,3,0,40,37
1683310330333,POLI 104A,A00,188852,Staff,14,0,30,16
1683310331357,POLI 104I,A00,188853,Staff,0,6,20,20
1683310332387,POLI 110B,A00,188854,Wiens; David,7,0,20,13
1683310333409,POLI 112A,A00,188855,Wiens; David,5,0,30,25
1683310334433,POLI 117R,A00,188856,Forman; Fonna,0,11,20,20
1683310335457,POLI 118,A00,188857,Ingham; Sean,8,0,20,12
1683310336485,POLI 120G,A00,188858,Staff,9,0,30,21
1683310337511,POLI 131CR,A00,188863,Hoston; Germaine,24,0,50,26
1683310338540,POLI 133,A00,188864,Nellis; Gareth Hb,44,0,50,6
1683310339564,POLI 134D,A00,188865,Desposato; Scott,27,0,30,3
1683310340588,POLI 142A,A00,188871,Gartzke; Erik,22,0,50,28
1683310341612,POLI 142K,A00,188874,Staff,38,0,50,12
1683310342637,POLI 143,A00,188940,Gartzke; Erik,16,0,30,14
1683310343659,POLI 153,A00,188943,Staff,3,0,20,17
1683310344686,POLI 160AA,A00,188944,Staff,12,0,40,28
1683310345708,POLI 170A,A00,188945,Staff,11,0,30,19
1683310347793,PSYC 1,A00,188952,Staff,37,0,90,53
1683310348817,PSYC 2,B00,188953,Staff,20,0,35,15
1683310349843,PSYC 6,A00,188970,Staff,47,0,60,13
1683310350870,PSYC 7,A00,188973,Staff,37,0,45,8
1683310351950,PSYC 60,A01,188980,Rickard; Timothy C.,43,0,60,17
1683310352979,PSYC 70,A01,189001,Steiner; Eric Tomas,24,0,45,21
1683310354006,PSYC 100,A00,189005,Lacefield; Katharine I,0,99,120,120
1683310355030,PSYC 102,A00,189008,Staff,10,0,30,20
1683310356059,PSYC 106,B00,189026,Gorman; Michael R.,37,0,60,23
1683310357085,PSYC 114,B01,189033,Winkielman; Piotr,0,32,30,30
1683310358111,PSYC 131,A00,189036,Anagnostaras; Stephan,0,43,60,60
1683310359136,PSYC 136,A00,189041,Lowe; Angela Beth,0,7,25,25
1683310360159,PSYC 137,A00,189057,Winkielman; Piotr,0,34,25,25
1683310361190,PSYC 144,A00,189107,Wixted; John T,0,7,50,50
1683310363240,PSYC 162,A00,189142,Staff,0,8,85,85
1683310364264,PSYC 172,A00,189144,Gorman; Michael R.,0,7,30,30
1683310366324,PSYC 179,A00,189146,Lacefield; Katharine I,0,84,120,120
1683310367351,PSYC 181,A00,189147,Anagnostaras; Stephan,0,44,90,90
1683310368378,PSYC 190R,A00,189148,Barner; David A.,0,22,80,80
1683310369406,PSYC 191,A00,189275,Rickard; Timothy C.,0,7,25,25
1683310370434,PSYC 193,A00,189276,Chapman; Eddie Nathaniel,0,1,0,4
1683310371459,PSYC 193L,A01,189281,Lowe; Angela Beth,12,0,20,8
1683310371459,PSYC 193L,B01,189285,Staff,28,0,35,7
1683310372490,RELI 149,A00,187137,Rahimi; Babak,7,0,40,33
1683310373518,SE 9,A01,187315,Staff,0,2,18,18
1683310374545,SE 101B,A00,187409,Staff,24,0,30,6
1683310375573,SE 110B,A00,187444,Staff,10,0,40,30
1683310376599,SE 130B,A00,187449,Staff,31,0,40,9
1683310377629,SE 150A,A00,187516,Staff,9,0,20,11
1683310378653,SE 154,A00,187528,Staff,30,0,50,20
1683310379677,SIO 3,A01,258171,Staff,35,0,40,5
1683310380706,SIO 10,A00,187144,Cook; Geoffrey W,0,3,75,75
1683310381729,SIO 45,A00,187152,Cook; Geoffrey W,1,0,100,99
1683310382753,SIO 109R,A00,194486,Staff,0,3,20,20
1683310384805,SIO 187,A01,187233,Kacev; David,12,0,40,28
1683310385829,SOCI 1,A01,258656,Thorpe; Charles Robert,28,0,30,2
1683310385829,SOCI 1,A02,258658,Thorpe; Charles Robert,30,0,30,0
1683310385829,SOCI 1,A03,258661,Thorpe; Charles Robert,25,0,25,0
1683310385829,SOCI 1,A04,258666,Thorpe; Charles Robert,22,0,25,3
1683310385829,SOCI 1,A05,258897,Thorpe; Charles Robert,23,0,25,2
1683310385829,SOCI 1,A06,258898,Thorpe; Charles Robert,25,0,25,0
1683310386853,SOCI 30,A01,258903,Pardo Guerra; Juan Pablo,16,0,30,14
1683310387877,SOCI 102,A00,258904,Staff,9,0,25,16
1683310388902,SOCI 106,A00,258905,Staff,19,0,25,6
1683310389931,SOCI 111,A00,258907,Ribas Norris; Janet Vanesa,26,0,30,4
1683310390955,SOCI 121R,A00,258908,Pardo Guerra; Juan Pablo,11,0,30,19
1683310391980,SOCI 126,A01,203330,Staff,14,0,20,6
1683310393004,SOCI 131,A00,258909,Thorpe; Charles Robert,31,0,60,29
1683310394030,SOCI 135,A00,258910,Payne; Christine Anna,0,9,30,30
1683310395054,SOCI 157,A00,258911,Staff,13,0,30,17
1683310396081,SOCI 184,A00,258912,Staff,26,0,30,4
1683310397105,SOCI 188D,A00,258913,Staff,21,0,30,9
1683310398133,SYN 2,001,187529,Staff,9,0,16,7
1683310398133,SYN 2,002,201452,Staff,0,18,16,16
1683310398133,SYN 2,003,201469,Staff,3,0,16,13
1683310399162,SYN 100,A01,187531,Staff,0,9,20,20
1683310399162,SYN 100,B01,201491,Staff,0,12,20,20
1683310400190,TDAC 1,A00,189286,Walsh; Kim C.,3,0,20,17
1683310400190,TDAC 1,B00,189287,Harting; Carla Kelso,11,0,20,9
1683310401215,TDAC 101,A00,189300,Walsh; Kim C.,16,0,20,4
1683310401215,TDAC 101,B00,189301,Harting; Carla Kelso,18,0,20,2
1683310402241,TDAC 102,A00,189304,Basso; Beatrice,14,0,20,6
1683310403266,TDAC 108,A00,189305,Staff,18,0,20,2
1683310404292,TDDE 131,A00,189310,Staff,19,0,20,1
1683310404292,TDDE 131,B00,189314,Staff,19,0,20,1
1683310404292,TDDE 131,C00,189315,Staff,48,0,50,2
1683310404292,TDDE 131,D00,189316,Staff,14,0,15,1
1683310404292,TDDE 131,E00,204841,Staff,20,0,20,0
1683310405315,TDGE 10,A00,189289,Staff,30,0,50,20
1683310405315,TDGE 10,B00,189290,Havis; Allan,2,0,50,48
1683310406367,TDGE 11,A00,189291,Fulton; Julia,0,3,50,50
1683310406367,TDGE 11,B00,189292,Staff,20,0,25,5
1683310406367,TDGE 11,C00,260270,Staff,0,0,0,0
1683310407391,TDGE 25,A00,189294,Staff,3,0,20,17
1683310408414,TDGE 124,A00,189318,Fulton; Julia,0,8,50,50
1683310409445,TDGE 125,A00,189319,Staff,13,0,25,12
1683310409445,TDGE 125,B00,189320,Staff,23,0,25,2
1683310410473,TDGE 127,A00,189322,Havis; Allan,0,0,50,50
1683310411498,TDHT 101,A00,189323,Staff,18,0,25,7
1683310411498,TDHT 101,B00,189324,Staff,25,0,25,0
1683310412522,TDHT 102,A00,189325,Staff,49,0,50,1
1683310413549,TDMV 1,A00,189295,Arcidiacono; Kristin,20,0,30,10
1683310413549,TDMV 1,B00,189296,Caligagan; Maria T.,24,0,30,6
1683310414574,TDMV 2,A00,189297,Sammartano; Tonnie,28,0,30,2
1683310414574,TDMV 2,B00,189299,Arcidiacono; Kristin,24,0,30,6
1683310415604,TDMV 3,A00,204998,Rincon; Alicia,22,0,30,8
1683310416629,TDMV 120,A00,189458,Sammartano; Tonnie,28,0,30,2
1683310417655,TDMV 138,A00,189541,Jun; Grace Shin Hae,22,0,40,18
1683310418679,TDMV 142,A00,189717,Caligagan; Tony,23,0,30,7
1683310418679,TDMV 142,B00,189718,Caligagan; Maria T.,25,0,30,5
1683310419706,TMC 2,A01,187533,Staff,25,0,25,0
1683310419706,TMC 2,A02,187534,Staff,25,0,25,0
1683310420733,USP 1,A01,187536,Kwak; Nancy,0,16,25,25
1683310421757,USP 5,A01,187538,Staff,9,0,25,16
1683310422781,USP 101,A00,199253,Staff,0,4,0,0
1683310423805,USP 124,A00,187562,Boomhower; Matthew Charles,1,0,30,29
1683310424828,USP 138,A00,187582,Staff,20,0,25,5
1683310425855,USP 152,A01,187597,Staff,4,0,25,21
1683310426881,USP 153,A00,187598,Staff,19,0,25,6
1683310427906,USP 168,A00,187607,Kwak; Nancy,2,0,5,3
1683310428929,USP 173,A00,187619,Staff,4,0,25,21
1683310429955,USP 181,A00,187638,Staff,0,0,25,25
1683310430979,VIS 103,A00,187650,Cruz; Edwin Teddy,23,0,75,52
1683310432006,VIS 110D,A00,187669,Staff,12,0,22,10
1683310433033,VIS 127C,A00,187720,Shen; Kuiyi,68,0,146,78
1683310434058,VIS 149,A00,187731,Yoldas; Pinar,0,14,22,22
1683310435085,VIS 151,A01,188091,Staff,22,0,34,12
1683310435085,VIS 151,A02,188092,Staff,11,0,34,23
1683310436113,VIS 160B,A00,188093,Stalbaum; Brett,0,0,10,10
1683310438165,WCWP 10B,A00,201720,Staff,10,0,15,5
1683310438165,WCWP 10B,B00,201722,Staff,8,0,15,7
1683310439188,WCWP 100,A00,201725,Gagnon; Jeffrey C,0,0,2,2
1683310439188,WCWP 100,B00,201727,Staff,0,4,15,15
1683310442280,ANBI 133,A00,258401,Wilder; Linnea Lorene,34,0,40,6
1683310443309,ANBI 140,A00,258395,Hrvoj Mihic; Branka,18,0,25,7
1683310444333,ANSC 120,A00,258402,Bialecki; Jon Anthony,27,0,40,13
1683310445397,ANSC 144,A00,258400,Staff,14,0,40,26
1683310447449,ANSC 166,A00,258396,Parish; Steven Martin,157,0,175,18
1683310448475,ANSC 180,A00,193533,Staff,9,0,20,11
1683310449499,ANSC 188,A00,258397,Jassal; Aftab,33,0,40,7
1683310450523,ANTH 3,A01,258316,Staff,23,0,30,7
1683310451547,ANTH 5,A00,258394,Semendeferi; Ekaterini,16,0,20,4
1683310452574,ANTH 21,A01,258331,Staff,9,0,40,31
1683310453599,ANTH 103,A00,258398,Varma; Saiba,15,0,25,10
1683310454632,AWP 10,001,202034,Staff,0,0,0,0
1683310454632,AWP 10,002,202035,Staff,0,0,0,0
1683310454632,AWP 10,003,202036,Staff,0,0,0,0
1683310454632,AWP 10,004,202037,Staff,0,0,0,0
1683310454632,AWP 10,005,202038,Staff,0,0,0,0
1683310454632,AWP 10,006,202039,Staff,0,0,0,0
1683310454632,AWP 10,007,202040,Staff,0,0,0,0
1683310454632,AWP 10,008,202041,Staff,0,0,0,0
1683310454632,AWP 10,009,202042,Staff,0,0,0,0
1683310454632,AWP 10,010,202043,Staff,0,0,0,0
1683310454632,AWP 10,011,202044,Staff,0,0,0,0
1683310454632,AWP 10,012,202045,Staff,0,0,0,0
1683310454632,AWP 10,013,202046,Staff,0,0,0,0
1683310454632,AWP 10,014,202047,Staff,0,0,0,0
1683310454632,AWP 10,015,202048,Staff,0,0,0,0
1683310454632,AWP 10,016,202049,Staff,0,0,0,0
1683310454632,AWP 10,017,202050,Staff,0,0,0,0
1683310454632,AWP 10,018,202051,Staff,0,0,0,0
1683310454632,AWP 10,019,202052,Staff,0,0,0,0
1683310454632,AWP 10,020,202053,Staff,0,0,0,0
1683310454632,AWP 10,021,202054,Staff,0,0,0,0
1683310454632,AWP 10,022,202055,Staff,0,0,0,0
1683310454632,AWP 10,023,202056,Staff,0,0,0,0
1683310454632,AWP 10,024,202057,Staff,0,0,0,0
1683310454632,AWP 10,025,202058,Staff,0,0,0,0
1683310454632,AWP 10,026,202059,Staff,0,0,0,0
1683310455731,AWP 102,001,202032,Staff,0,0,0,0
1683310455731,AWP 102,002,202033,Staff,0,0,0,0
1683310456755,BENG 100,A01,254234,Taylor Amos; Alyssa C,31,0,40,9
1683310457778,BENG 196,001,270013,Engler; Adam J.,9999,0,9999,0
1683310458809,BICD 100R,A01,202018,Smith; Laurie,0,7,32,32
1683310458809,BICD 100R,A02,202019,Smith; Laurie,0,2,32,32
1683310458809,BICD 100R,A03,202020,Smith; Laurie,0,1,32,32
1683310458809,BICD 100R,A04,202021,Smith; Laurie,8,0,32,24
1683310458809,BICD 100R,A05,202022,Smith; Laurie,12,0,32,20
1683310459832,BICD 136,A01,193242,Gustafson-Brown; Cindy,0,2,32,32
1683310459832,BICD 136,A02,193244,Gustafson-Brown; Cindy,15,0,32,17
1683310460857,BIEB 102,A01,193249,Butler; Shannon Rhey,0,2,32,32
1683310460857,BIEB 102,A02,193251,Butler; Shannon Rhey,0,0,32,32
1683310460857,BIEB 102,A03,193253,Butler; Shannon Rhey,0,1,32,32
1683310460857,BIEB 102,A04,193255,Butler; Shannon Rhey,17,0,32,15
1683310460857,BIEB 102,A05,193265,Butler; Shannon Rhey,26,0,32,6
1683310460857,BIEB 102,A06,193269,Butler; Shannon Rhey,16,0,32,16
1683310462910,BIEB 150,A01,193274,Staff,0,0,32,32
1683310462910,BIEB 150,A02,193285,Staff,24,0,32,8
1683310463937,BIEB 194,A00,193286,Kurle; Carolyn M.,22,0,32,10
1683310464964,BILD 1,A01,192291,Staff,16,0,32,16
1683310464964,BILD 1,A02,192292,Staff,30,0,32,2
1683310464964,BILD 1,B01,192520,Reuther; Keefe,0,1,0,0
1683310464964,BILD 1,B02,192532,Reuther; Keefe,0,1,0,0
1683310465989,BILD 3,A01,192556,Butler; Shannon Rhey,0,0,32,32
1683310465989,BILD 3,A02,192581,Butler; Shannon Rhey,5,0,32,27
1683310465989,BILD 3,A03,192611,Butler; Shannon Rhey,23,0,32,9
1683310465989,BILD 3,A04,192612,Butler; Shannon Rhey,25,0,32,7
1683310465989,BILD 3,A05,192613,Butler; Shannon Rhey,27,0,32,5
1683310465989,BILD 3,A06,192679,Butler; Shannon Rhey,27,0,32,5
1683310465989,BILD 3,A07,192682,Butler; Shannon Rhey,22,0,32,10
1683310467014,BILD 4,A01,192836,Reuther; Keefe,1,0,24,23
1683310467014,BILD 4,A02,193044,Reuther; Keefe,4,0,24,20
1683310468042,BILD 10,A01,193142,Gustafson-Brown; Cindy,31,0,32,1
1683310468042,BILD 10,A02,193149,Gustafson-Brown; Cindy,31,0,32,1
1683310469069,BIMM 100,A01,193301,Staff,0,6,32,32
1683310469069,BIMM 100,A02,193312,Staff,0,5,32,32
1683310469069,BIMM 100,A03,193323,Staff,0,8,32,32
1683310470093,BIMM 101,A01,193329,McDonnell; Lisa Marie,0,3,24,24
1683310470093,BIMM 101,A02,193339,McDonnell; Lisa Marie,0,2,24,24
1683310470093,BIMM 101,B01,193354,McDonnell; Lisa Marie,0,3,24,24
1683310470093,BIMM 101,B02,193357,McDonnell; Lisa Marie,0,3,24,24
1683310471120,BIMM 110,A01,193377,Tat; John,0,11,32,32
1683310471120,BIMM 110,A02,193378,Tat; John,1,9,32,31
1683310472145,BIMM 120,A01,206116,Staff,0,0,32,32
1683310472145,BIMM 120,A02,206117,Staff,8,0,32,24
1683310472145,BIMM 120,A03,206121,Staff,21,0,32,11
1683310473169,BIPN 100,A01,193393,Park; Ji Young,0,14,32,32
1683310473169,BIPN 100,A02,193402,Park; Ji Young,0,12,32,32
1683310473169,BIPN 100,A03,193413,Park; Ji Young,0,14,32,32
1683310473169,BIPN 100,A04,193414,Park; Ji Young,0,13,32,32
1683310474194,BIPN 102,A01,193429,Staff,0,0,32,32
1683310474194,BIPN 102,A02,193438,Staff,22,0,32,10
1683310475220,BIPN 106,A01,193450,Reyes Gonzalez; Catalina,0,2,40,40
1683310476247,BIPN 134,A01,193465,Cooke; James Edward,0,0,32,32
1683310476247,BIPN 134,A02,193474,Cooke; James Edward,27,0,32,5
1683310476247,BIPN 134,A03,193485,Cooke; James Edward,29,0,32,3
1683310476247,BIPN 134,A04,193486,Cooke; James Edward,21,0,32,11
1683310476247,BIPN 134,A05,193491,Cooke; James Edward,31,0,32,1
1683310476247,BIPN 134,A06,193501,Cooke; James Edward,30,0,32,2
1683310476247,BIPN 134,A07,193510,Cooke; James Edward,29,0,32,3
1683310478298,BISP 194,A00,222522,Staff,16,0,32,16
1683310479324,CAT 124,A01,202407,Staff,20,0,25,5
1683310480348,CAT 125,A00,202408,Marchisotto; Jennifer Anne,4,0,20,16
1683310481377,CAT 125R,A00,202409,Smith; Lauryn Alissa,0,11,20,20
1683310481377,CAT 125R,B00,202410,Morales; Celeste Georgianna,0,11,20,20
1683310481377,CAT 125R,C00,202411,Irwin; Matthew Joseph,0,10,20,20
1683310482405,CENG 15,A01,204712,Yang; Kesong,0,1,0,0
1683310483429,CENG 114,A00,202070,Jahed Motlagh; Zeinab,5,0,20,15
1683310484453,CGS 105,A00,185477,Wesling; Megan E.,24,0,40,16
1683310485477,CGS 106,A00,185494,Staff,13,0,22,9
1683310486500,CGS 108,A00,185495,Staff,14,0,20,6
1683310487526,CGS 114,A00,185496,Staff,13,0,18,5
1683310488553,CGS 119,A00,185501,Staff,15,0,20,5
1683310489577,CGS 120,A00,185511,Staff,13,0,20,7
1683310490602,CHEM 4,A01,184675,Bussey; Thomas J,96,0,100,4
1683310491629,CHEM 6A,A01,184677,Staff,35,0,60,25
1683310492654,CHEM 6B,A01,184679,Staff,65,0,100,35
1683310493681,CHEM 6C,A01,184681,Bussey; Thomas J,1,0,50,49
1683310493681,CHEM 6C,A02,184682,Bussey; Thomas J,34,0,50,16
1683310494708,CHEM 40A,A01,184684,Albizati; Kim F.,37,0,100,63
1683310495732,CHEM 40B,A01,184686,Albizati; Kim F.,0,20,100,100
1683310496756,CHEM 41B,A01,184690,Staff,52,0,100,48
1683310497784,COGS 3,A01,184715,Boyle; Mary E. T.,0,25,40,40
1683310498813,COGS 14B,A01,185172,Staff,0,15,38,38
1683310499838,COGS 18,A01,184736,Staff,19,0,80,61
1683310500861,COGS 100,A01,184932,Staff,0,5,73,73
1683310501889,COGS 101A,A01,184935,Staff,0,38,30,30
1683310502917,COGS 101B,A01,184944,Staff,0,2,30,30
1683310503941,COGS 101C,A01,184946,Staff,0,12,30,30
1683310504965,COGS 102A,A01,184951,Johnson; Christine M.,2,0,40,38
1683310505992,COGS 107B,A01,184953,Mooshagian; Eric Frederick,0,50,40,40
1683310507018,COGS 118B,A01,184959,Gupta; Anjum,0,48,40,40
1683310508044,COGS 153,A00,184961,Staff,0,15,30,30
1683310509067,COGS 177,A00,184962,Staff,0,21,30,30
1683310510091,COGS 187A,A01,184969,Boyle; Mary E. T.,0,17,40,40
1683310511116,COMM 10,A01,185174,Staff,0,5,25,25
1683310511116,COMM 10,A02,185189,Staff,0,5,25,25
1683310511116,COMM 10,A03,269821,Staff,0,0,0,0
1683310512139,COMM 100B,A01,185475,Staff,0,0,0,2
1683310512139,COMM 100B,A02,185476,Staff,14,0,25,11
1683310513163,COMM 100C,A01,185314,Staff,1,0,25,24
1683310513163,COMM 100C,A02,185327,Staff,19,0,25,6
1683310514185,COMM 110M,A00,185349,Staff,2,0,40,38
1683310515209,COMM 113T,A00,185352,Staff,25,0,40,15
1683310516235,COMM 114I,A00,185353,Staff,33,0,40,7
1683310517258,COMM 131,A00,185354,Staff,19,0,30,11
1683310518286,CSE 8A,A50,185358,Cao; Yingjun,0,46,10,10
1683310519309,CSE 8B,A01,185362,Staff,1,47,50,49
1683310520333,CSE 11,A01,185416,Cao; Yingjun,0,92,10,10
1683310521362,CSE 20,A01,185445,Briones; Jor-el Thomas Caparas,5,0,25,20
1683310522389,CSE 21,A01,185447,Staff,10,0,50,40
1683310523417,CSE 101,A01,185451,Staff,0,12,50,50
1683310523417,CSE 101,B01,185453,Jones; Miles E,0,11,50,50
1683310525465,CSE 141,A01,185458,Eldon; John,20,0,100,80
1683310526491,CSE 141L,A01,185461,Eldon; John,12,0,100,88
1683310527516,CSE 142,A01,185463,Staff,35,0,60,25
1683310527516,CSE 142,B01,201355,Staff,0,6,60,60
1683310528544,CSE 142L,A01,185470,Staff,35,0,60,25
1683310528544,CSE 142L,B01,201417,Staff,0,5,60,60
1683310529569,CSE 190,A00,201433,Staff,32,0,49,17
1683310530596,DOC 1,A01,259136,Strom; Megan C.,8,0,15,7
1683310530596,DOC 1,A02,259137,Strom; Megan C.,14,0,15,1
1683310530596,DOC 1,A03,259138,Strom; Megan C.,14,0,15,1
1683310530596,DOC 1,A04,259139,Strom; Megan C.,14,0,15,1
1683310531620,DOC 100D,A00,259140,Pass; Natalye Joann,17,0,25,8
1683310532643,DSGN 1,A01,184749,Rill; Bryan,0,25,30,30
1683310533666,DSGN 100,A01,185168,Staff,0,2,25,25
1683310534689,ECE 5,A01,185626,Morris; Karcher William,0,10,0,0
1683310535713,ECE 101,A01,185628,Staff,17,0,70,53
1683310536736,ECE 107,A01,185635,Baghdadchi; Saharnaz,0,0,20,20
1683310536736,ECE 107,A02,185638,Baghdadchi; Saharnaz,4,0,20,16
1683310537763,ECE 148,A01,185647,Silberman; Jack,0,0,16,16
1683310538789,ECON 1,A01,185537,Crane; Meredith Helen,54,0,70,16
1683310539816,ECON 3,A01,185549,Crane; Meredith Helen,33,0,70,37
1683310540839,ECON 4,A01,203354,Anderson; John Charles,0,4,10,10
1683310541865,ECON 100A,A01,185574,Staff,0,4,40,40
1683310542890,ECON 100B,A01,185576,Staff,0,22,40,40
1683310543915,ECON 100C,A01,185589,Newhouse; Herbert S,30,0,70,40
1683310544939,ECON 105,A00,185608,Vespa; Emanuel Ignacio,19,0,35,16
1683310545966,ECON 109,A01,185610,Shishkin; Denis,10,0,35,25
1683310546990,ECON 110A,A01,185612,Staff,11,0,40,29
1683310548016,ECON 120A,A01,185615,Staff,20,0,40,20
1683310549041,ECON 120C,A01,185617,Sun; Yixiao,0,20,70,70
1683310550065,ECON 144,A00,203346,Squires; Dale E,3,0,35,32
1683310551089,ECON 171,A01,203349,Newhouse; Herbert S,0,1,35,35
1683310552114,ECON 173A,A01,185621,Toda; Alexis Akira,21,0,35,14
1683310553140,EDS 25,A01,202413,Staff,0,1,0,0
1683310553140,EDS 25,A02,202414,Staff,0,1,0,0
1683310553140,EDS 25,A03,202415,Staff,0,0,0,0
1683310553140,EDS 25,A04,202416,Staff,0,1,0,0
1683310553140,EDS 25,A05,202439,Staff,0,0,0,0
1683310553140,EDS 25,A06,202440,Staff,0,0,0,0
1683310553140,EDS 25,B01,202631,Staff,0,0,0,0
1683310553140,EDS 25,B02,202632,Staff,0,0,0,0
1683310553140,EDS 25,B03,202639,Staff,0,0,0,0
1683310553140,EDS 25,B04,202640,Staff,0,0,0,0
1683310553140,EDS 25,B05,202643,Staff,0,0,0,0
1683310553140,EDS 25,B06,202644,Staff,0,0,0,0
1683310554165,EDS 38,A01,202659,Black; Alison Michelle,24,0,25,1
1683310555192,EDS 115,A00,202652,Staff,17,0,30,13
1683310556219,EDS 125,A00,202649,Staff,14,0,30,16
1683310557244,EDS 126,A01,203332,Staff,30,0,30,0
1683310558270,EDS 139,A00,202838,Staff,17,0,25,8
1683310559358,EDS 146,A01,202655,Staff,15,0,25,10
1683310560386,ENG 15,A00,185667,Staff,0,1,0,0
1683310560386,ENG 15,B00,185672,Staff,0,0,0,0
1683310560386,ENG 15,C00,185675,Staff,0,0,0,0
1683310560386,ENG 15,D00,185682,Staff,0,0,0,0
1683310560386,ENG 15,E00,185684,Staff,0,0,0,0
1683310561413,ETHN 103,A00,185710,Staff,0,3,35,35
1683310562442,ETHN 103A,A00,199228,Man; Simeon S,2,0,9,7
1683310563466,ETHN 109,A00,185711,Staff,18,0,35,17
1683310564491,ETHN 142,A00,185726,Staff,0,4,30,30
1683310565517,ETHN 163J,A00,199229,Man; Simeon S,6,0,8,2
1683310566542,ETHN 168,A00,185727,Staff,8,0,10,2
1683310567568,ETHN 182,A00,185728,Staff,1,0,35,34
1683310568593,ETHN 183,A00,185737,Staff,8,0,18,10
1683310569619,GLBH 111,A01,209361,Burgos; Jose L.,0,0,0,0
1683310571670,HIEU 104,A00,185792,Staff,16,0,20,4
1683310572695,HIEU 115,A00,185800,Staff,1,0,20,19
1683310573719,HIEU 128,A00,185801,Staff,0,7,20,20
1683310574746,HIEU 147,A00,185802,Staff,16,0,20,4
1683310575769,HIEU 154,A00,185823,Staff,12,0,20,8
1683310576793,HILA 102,A00,185826,Staff,13,0,20,7
1683310577819,HILD 2C,A01,185778,Staff,0,12,20,20
1683310578843,HILD 7B,A01,185780,Kwak; Nancy,0,15,32,32
1683310578843,HILD 7B,A02,185781,Kwak; Nancy,0,18,32,32
1683310579867,HILD 30,A01,185791,Staff,14,0,20,6
1683310580891,HISC 119,A00,185830,Golan; Tal,0,9,20,20
1683310581915,HITO 156GS,A00,185831,Patterson; Patrick H.,0,0,0,23
1683310582942,HIUS 103,A00,185832,Man; Simeon S,0,6,20,20
1683310583967,HIUS 117,A00,185836,Kwak; Nancy,2,0,20,18
1683310584994,HIUS 125,A00,185840,Man; Simeon S,0,0,23,23
1683310586018,HIUS 149,A00,185845,Staff,0,0,20,20
1683310587046,HUM 3,A01,185882,Zavodny; Tatiana Sophia,0,6,50,50
1683310587046,HUM 3,B01,185899,Caldwell; Michael Alan,0,19,50,50
1683310588073,HUM 3GS,A00,185900,Patterson; Patrick H.,0,0,0,23
1683310589098,HUM 4,A01,185938,Zroka; Amy Liane,31,0,50,19
1683310589098,HUM 4,B01,185956,Watkins; Eric,0,2,50,50
1683310589098,HUM 4,B02,202209,Watkins; Eric,0,2,50,50
1683310589098,HUM 4,B03,202210,Watkins; Eric,0,0,50,50
1683310590125,HUM 5,A01,185958,West; Geoffrey Scott,4,0,50,46
1683310590125,HUM 5,A02,202215,West; Geoffrey Scott,0,0,50,50
1683310591157,INTL 190,A00,185959,Gagnon; Jeffrey C,0,0,0,9
1683310591157,INTL 190,B00,185960,Lettieri; Michael Joseph,0,0,0,1
1683310592182,JAPN 180,A00,254509,Staff,5,1,30,25
1683310593206,LATI 10,A01,202853,Kennemore; Amy Michelle,5,0,35,30
1683310593206,LATI 10,A02,202854,Kennemore; Amy Michelle,1,0,35,34
1683310593206,LATI 10,A03,270054,Kennemore; Amy Michelle,30,0,30,0
1683310594231,LATI 180,A00,202855,Kennemore; Amy Michelle,11,0,20,9
1683310595258,LAWS 101,A00,201767,Golan; Tal,0,7,40,40
1683310596281,LIFR 1C,A00,185961,Staff,6,0,20,14
1683310597308,LIFR 1CX,A00,185962,Staff,7,0,20,13
1683310598332,LIFR 1D,A00,185963,Staff,9,0,20,11
1683310599356,LIFR 1DX,A00,185964,Staff,9,0,20,11
1683310600380,LIGN 101,A01,186039,Staff,43,0,50,7
1683310601402,LIGN 165,A00,186040,Staff,18,0,50,32
1683310602428,LTCS 108,A00,186041,Staff,6,0,10,4
1683310603450,LTCS 119,A00,186042,Staff,16,0,20,4
1683310604479,LTCS 130,A00,186043,Wesling; Megan E.,15,0,25,10
1683310606526,LTEA 138,A00,186119,Staff,14,0,40,26
1683310607552,LTEN 124,A00,186148,Staff,6,0,25,19
1683310608579,LTEN 178,A00,186149,Staff,7,0,15,8
1683310609604,LTEN 181,A00,186150,Blanco; John D,33,0,40,7
1683310610628,LTWL 120,A00,186160,Staff,20,0,25,5
1683310611655,LTWL 165,A00,186161,Staff,22,0,25,3
1683310612683,LTWR 100,A00,186162,Staff,0,4,15,15
1683310613710,LTWR 102,A00,186163,Doller; Ben,5,0,15,10
1683310614734,MAE 8,A01,186412,Staff,0,0,0,0
1683310615757,MAE 30B,A00,186445,Bahadori; Mohammad Yousef,83,0,100,17
1683310616785,MAE 40,A00,186592,Bewley; Thomas R,9,0,50,41
1683310617810,MAE 101B,A00,186593,Bahadori; Mohammad Yousef,81,0,100,19
1683310618835,MAE 105,A00,186594,Bandaru; Prabhakar,12,0,50,38
1683310619857,MAE 107,A00,186599,Pham; Hieu Tan,0,6,120,120
1683310620881,MAE 148,A01,186660,Silberman; Jack,3,0,16,13
1683310621909,MATH 10A,A01,188095,Staff,0,7,35,35
1683310622939,MATH 10B,A01,188097,Bowers; Adam R.,0,11,30,30
1683310622939,MATH 10B,A02,188099,Bowers; Adam R.,0,11,30,30
1683310622939,MATH 10B,B01,188104,Bowers; Adam R.,0,10,30,30
1683310622939,MATH 10B,B02,188106,Bowers; Adam R.,0,11,30,30
1683310623968,MATH 10C,A01,188111,Staff,0,18,30,30
1683310623968,MATH 10C,A02,188127,Staff,0,17,30,30
1683310623968,MATH 10C,A03,188131,Staff,0,18,30,30
1683310623968,MATH 10C,B01,188218,Staff,20,0,30,10
1683310623968,MATH 10C,B02,188244,Staff,13,0,30,17
1683310623968,MATH 10C,B03,188277,Staff,16,0,30,14
1683310624995,MATH 18,A01,188344,Bach; Quang Tran,18,0,30,12
1683310624995,MATH 18,A02,188345,Bach; Quang Tran,11,0,30,19
1683310624995,MATH 18,B01,188353,Bach; Quang Tran,10,0,30,20
1683310624995,MATH 18,B02,188354,Bach; Quang Tran,20,0,30,10
1683310626019,MATH 20A,A01,188374,Staff,13,0,35,22
1683310627047,MATH 20B,A01,188382,Ohm; Ko Woon,6,0,30,24
1683310627047,MATH 20B,A02,188383,Ohm; Ko Woon,23,0,30,7
1683310627047,MATH 20B,B01,188385,Ohm; Ko Woon,7,0,30,23
1683310627047,MATH 20B,B02,188392,Ohm; Ko Woon,22,0,30,8
1683310628076,MATH 20C,A01,188394,Harel; Guershon,10,0,30,20
1683310628076,MATH 20C,A02,188395,Harel; Guershon,13,0,30,17
1683310628076,MATH 20C,B01,188404,Harel; Guershon,4,0,30,26
1683310628076,MATH 20C,B02,188405,Harel; Guershon,19,0,30,11
1683310629102,MATH 20D,A01,188414,Hammock; Frances H,0,1,30,30
1683310629102,MATH 20D,A02,188415,Hammock; Frances H,4,0,30,26
1683310629102,MATH 20D,B01,188447,Hammock; Frances H,2,0,30,28
1683310629102,MATH 20D,B02,188486,Hammock; Frances H,8,0,30,22
1683310630128,MATH 20E,A01,188649,Staff,22,0,30,8
1683310630128,MATH 20E,A02,188650,Staff,23,0,30,7
1683310630128,MATH 20E,A03,188673,Staff,0,0,30,30
1683310631151,MATH 102,A01,188675,Staff,0,35,35,35
1683310632178,MATH 103B,A01,188681,Staff,4,0,35,31
1683310632178,MATH 103B,B01,188692,Staff,6,0,35,29
1683310633205,MATH 109,A01,188695,Salehi Golsefidy; Alireza,25,0,35,10
1683310633205,MATH 109,A02,188696,Salehi Golsefidy; Alireza,27,0,35,8
1683310634229,MATH 120A,A01,188698,Eggers; John Dietrich,6,0,35,29
1683310635258,MATH 142B,A01,188736,Ioana; Adrian,0,2,30,30
1683310635258,MATH 142B,A02,188741,Ioana; Adrian,0,1,30,30
1683310635258,MATH 142B,A03,188743,Ioana; Adrian,1,3,30,29
1683310636283,MATH 168A,A01,188790,Staff,0,9,35,35
1683310637310,MATH 170A,A01,188803,Nie; Jiawang,0,2,35,35
1683310637310,MATH 170A,A02,188811,Nie; Jiawang,0,0,35,35
1683310637310,MATH 170A,A03,188814,Nie; Jiawang,1,0,35,34
1683310637310,MATH 170A,A04,188815,Nie; Jiawang,13,0,35,22
1683310638335,MATH 193B,A01,188817,Staff,0,0,35,35
1683310638335,MATH 193B,A02,188818,Staff,5,0,35,30
1683310639359,MGT 4,A01,202857,Anderson; John Charles,62,0,80,18
1683310640383,MGT 12,A00,202858,Lindenberger; Wade Douglas,43,0,90,47
1683310641449,MGT 18,A00,202859,Staff,74,0,90,16
1683310642475,MGT 18GS,A00,202860,McKay; Michael J,13,0,28,15
1683310643498,MGT 45,A00,202861,Pecore; Joseph P.,14,0,90,76
1683310644525,MGT 100,A00,202863,Yavorsky; Daniel Ryan,28,0,90,62
1683310645549,MGT 103,A00,202864,Ehrich; Kristine R,0,16,90,90
1683310646576,MGT 112,A00,202865,Ehrich; Kristine R,15,0,90,75
1683310647601,MGT 121A,A00,202868,Staff,0,19,0,0
1683310648628,MGT 131B,A00,202869,Anderson; John Charles,59,0,90,31
1683310649654,MGT 136,A00,202871,Lindenberger; Wade Douglas,84,0,90,6
1683310650681,MGT 164,A00,202873,Staff,0,69,90,90
1683310651704,MGT 164GS,A00,202874,McKay; Mary A,13,0,28,15
1683310652731,MGT 180,A00,202875,Staff,0,51,90,90
1683310653758,MMW 11R,A01,205019,Herbst; Matthew,3,0,30,27
1683310653758,MMW 11R,A02,205026,Herbst; Matthew,29,0,30,1
1683310654787,MMW 15,A01,193512,Chang; Edmond Yi-Teh,0,9,28,28
1683310654787,MMW 15,A02,193513,Chang; Edmond Yi-Teh,0,5,28,28
1683310654787,MMW 15,A03,193514,Chang; Edmond Yi-Teh,0,5,28,28
1683310654787,MMW 15,A04,193515,Chang; Edmond Yi-Teh,0,5,28,28
1683310654787,MMW 15,A05,193516,Chang; Edmond Yi-Teh,0,4,28,28
1683310654787,MMW 15,A06,193517,Chang; Edmond Yi-Teh,0,5,28,28
1683310654787,MMW 15,B01,193519,Chang; Edmond Yi-Teh,0,4,28,28
1683310654787,MMW 15,B02,193520,Chang; Edmond Yi-Teh,0,5,28,28
1683310654787,MMW 15,B03,193521,Chang; Edmond Yi-Teh,0,4,28,28
1683310654787,MMW 15,B04,193522,Chang; Edmond Yi-Teh,0,4,28,28
1683310654787,MMW 15,B05,193523,Chang; Edmond Yi-Teh,0,5,28,28
1683310654787,MMW 15,B06,193524,Chang; Edmond Yi-Teh,0,4,28,28
1683310655812,MMW 122,A01,193526,Rahimi; Babak,0,14,28,28
1683310655812,MMW 122,A02,193527,Rahimi; Babak,0,14,28,28
1683310655812,MMW 122,A03,193528,Rahimi; Babak,0,0,0,0
1683310655812,MMW 122,A04,193529,Rahimi; Babak,0,0,0,0
1683310656836,MUS 1A,A01,186663,Staff,0,20,35,35
1683310657863,MUS 4,A01,186715,Staff,0,12,35,35
1683310658890,MUS 5R,A01,186796,Dubnov; Shlomo,0,17,35,35
1683310659918,MUS 6,A01,186798,Staff,0,3,25,25
1683310660945,MUS 7,A01,186830,Staff,12,0,35,23
1683310661969,MUS 8,A01,186930,Staff,0,26,35,35
1683310663050,MUS 15,A01,186932,Staff,0,15,35,35
1683310663050,MUS 15,B01,186934,Staff,0,15,35,35
1683310664077,MUS 80,A00,186935,Staff,2,0,20,18
1683310664077,MUS 80,B00,186936,Staff,25,0,25,0
1683310665099,NANO 11,A00,204702,Lipomi; Darren John,0,0,0,0
1683310666123,NANO 15,A01,204709,Yang; Kesong,0,1,0,0
1683310667147,NANO 114,A00,202069,Jahed Motlagh; Zeinab,3,0,10,7
1683310668171,PHIL 1,A00,186955,Grush; Rick Scott,32,0,40,8
1683310669195,PHIL 10,A01,186973,Grush; Rick Scott,28,0,35,7
1683310669195,PHIL 10,A02,186974,Grush; Rick Scott,33,0,35,2
1683310670220,PHIL 13,A01,186976,Staff,7,0,35,28
1683310670220,PHIL 13,A02,186977,Staff,16,0,35,19
1683310671246,PHIL 14,A01,186979,Staff,31,0,35,4
1683310671246,PHIL 14,A02,186986,Staff,32,0,35,3
1683310672272,PHIL 28,A01,186988,Staff,16,0,30,14
1683310672272,PHIL 28,A02,186989,Staff,1,0,30,29
1683310672272,PHIL 28,A03,186990,Staff,9,0,30,21
1683310672272,PHIL 28,A04,186991,Staff,26,0,30,4
1683310673298,PHIL 120,A00,186997,Staff,23,0,40,17
1683310674326,PHIL 137,A00,187003,Staff,9,0,40,31
1683310675350,PHIL 150,A00,187015,Staff,47,0,70,23
1683310676376,PHIL 167,A00,187021,Lamey; Andy M.,35,0,40,5
1683310677404,PHIL 174,A01,202226,Staff,17,0,20,3
1683310677404,PHIL 174,A02,202235,Staff,20,0,20,0
1683310678434,PHIL 191A,A00,258918,Staff,0,0,1,1
1683310679457,PHYS 1A,A00,187028,Staff,27,0,60,33
1683310680483,PHYS 1AL,001,187036,Staff,3,0,30,27
1683310680483,PHYS 1AL,002,187049,Staff,18,0,30,12
1683310681509,PHYS 1B,A00,187058,Staff,23,0,60,37
1683310682537,PHYS 1BL,001,187064,Staff,0,0,30,30
1683310682537,PHYS 1BL,002,187070,Staff,6,0,30,24
1683310683569,PHYS 1C,A00,187082,Staff,31,0,120,89
1683310684596,PHYS 1CL,001,187088,Staff,0,9,30,30
1683310684596,PHYS 1CL,002,187089,Staff,0,2,30,30
1683310684596,PHYS 1CL,009,262693,Staff,11,0,30,19
1683310685622,PHYS 2B,A01,187097,Staff,54,0,115,61
1683310686647,PHYS 2C,A01,187099,Staff,67,0,115,48
1683310687674,PHYS 2CL,A01,187101,Staff,5,0,28,23
1683310687674,PHYS 2CL,A02,187102,Staff,15,0,28,13
1683310688698,PHYS 2D,A01,187123,Shotwell; Brian,95,0,115,20
1683310689722,PHYS 4B,A01,187133,Grinstein; Benjamin,35,0,50,15
1683310690750,POLI 10,A00,188819,Staff,0,3,50,50
1683310691774,POLI 11,A00,188827,Staff,43,0,50,7
1683310692798,POLI 13R,A00,188828,Staff,0,1,20,20
1683310693823,POLI 27,A01,188830,Elgin; Samuel Zincke,0,1,70,70
1683310694850,POLI 30,A00,188832,Desposato; Scott,33,0,50,17
1683310695877,POLI 102F,A00,188834,Staff,3,0,40,37
1683310696901,POLI 104A,A00,188852,Staff,14,0,30,16
1683310697925,POLI 104I,A00,188853,Staff,0,6,20,20
1683310698948,POLI 110B,A00,188854,Wiens; David,7,0,20,13
1683310699972,POLI 112A,A00,188855,Wiens; David,5,0,30,25
1683310700997,POLI 117R,A00,188856,Forman; Fonna,0,11,20,20
1683310702021,POLI 118,A00,188857,Ingham; Sean,8,0,20,12
1683310703045,POLI 120G,A00,188858,Staff,9,0,30,21
1683310704068,POLI 131CR,A00,188863,Hoston; Germaine,24,0,50,26
1683310705094,POLI 133,A00,188864,Nellis; Gareth Hb,44,0,50,6
1683310706118,POLI 134D,A00,188865,Desposato; Scott,27,0,30,3
1683310707142,POLI 142A,A00,188871,Gartzke; Erik,22,0,50,28
1683310708167,POLI 142K,A00,188874,Staff,38,0,50,12
1683310709192,POLI 143,A00,188940,Gartzke; Erik,16,0,30,14
1683310710216,POLI 153,A00,188943,Staff,3,0,20,17
1683310711240,POLI 160AA,A00,188944,Staff,12,0,40,28
1683310712267,POLI 170A,A00,188945,Staff,11,0,30,19
1683310714324,PSYC 1,A00,188952,Staff,37,0,90,53
1683310715347,PSYC 2,B00,188953,Staff,20,0,35,15
1683310716370,PSYC 6,A00,188970,Staff,47,0,60,13
1683310717393,PSYC 7,A00,188973,Staff,37,0,45,8
1683310718417,PSYC 60,A01,188980,Rickard; Timothy C.,43,0,60,17
1683310719445,PSYC 70,A01,189001,Steiner; Eric Tomas,24,0,45,21
1683310720469,PSYC 100,A00,189005,Lacefield; Katharine I,0,99,120,120
1683310721496,PSYC 102,A00,189008,Staff,10,0,30,20
1683310722520,PSYC 106,B00,189026,Gorman; Michael R.,37,0,60,23
1683310723545,PSYC 114,B01,189033,Winkielman; Piotr,0,32,30,30
1683310724571,PSYC 131,A00,189036,Anagnostaras; Stephan,0,43,60,60
1683310725595,PSYC 136,A00,189041,Lowe; Angela Beth,0,7,25,25
1683310726618,PSYC 137,A00,189057,Winkielman; Piotr,0,34,25,25
1683310727645,PSYC 144,A00,189107,Wixted; John T,0,7,50,50
1683310729693,PSYC 162,A00,189142,Staff,0,8,85,85
1683310730717,PSYC 172,A00,189144,Gorman; Michael R.,0,7,30,30
1683310732765,PSYC 179,A00,189146,Lacefield; Katharine I,0,84,120,120
1683310733788,PSYC 181,A00,189147,Anagnostaras; Stephan,0,44,90,90
1683310734812,PSYC 190R,A00,189148,Barner; David A.,0,22,80,80
1683310735835,PSYC 191,A00,189275,Rickard; Timothy C.,0,7,25,25
1683310736858,PSYC 193,A00,189276,Chapman; Eddie Nathaniel,0,1,0,4
1683310737887,PSYC 193L,A01,189281,Lowe; Angela Beth,12,0,20,8
1683310737887,PSYC 193L,B01,189285,Staff,28,0,35,7
1683310738914,RELI 149,A00,187137,Rahimi; Babak,7,0,40,33
1683310739938,SE 9,A01,187315,Staff,0,2,18,18
1683310740965,SE 101B,A00,187409,Staff,24,0,30,6
1683310741988,SE 110B,A00,187444,Staff,10,0,40,30
1683310743012,SE 130B,A00,187449,Staff,31,0,40,9
1683310744039,SE 150A,A00,187516,Staff,9,0,20,11
1683310745068,SE 154,A00,187528,Staff,30,0,50,20
1683310746091,SIO 3,A01,258171,Staff,35,0,40,5
1683310747116,SIO 10,A00,187144,Cook; Geoffrey W,0,3,75,75
1683310748140,SIO 45,A00,187152,Cook; Geoffrey W,1,0,100,99
1683310749168,SIO 109R,A00,194486,Staff,0,3,20,20
1683310751219,SIO 187,A01,187233,Kacev; David,12,0,40,28
1683310752243,SOCI 1,A01,258656,Thorpe; Charles Robert,28,0,30,2
1683310752243,SOCI 1,A02,258658,Thorpe; Charles Robert,30,0,30,0
1683310752243,SOCI 1,A03,258661,Thorpe; Charles Robert,25,0,25,0
1683310752243,SOCI 1,A04,258666,Thorpe; Charles Robert,22,0,25,3
1683310752243,SOCI 1,A05,258897,Thorpe; Charles Robert,23,0,25,2
1683310752243,SOCI 1,A06,258898,Thorpe; Charles Robert,25,0,25,0
1683310753269,SOCI 30,A01,258903,Pardo Guerra; Juan Pablo,16,0,30,14
1683310754293,SOCI 102,A00,258904,Staff,9,0,25,16
1683310755320,SOCI 106,A00,258905,Staff,19,0,25,6
1683310756343,SOCI 111,A00,258907,Ribas Norris; Janet Vanesa,26,0,30,4
1683310757369,SOCI 121R,A00,258908,Pardo Guerra; Juan Pablo,11,0,30,19
1683310758393,SOCI 126,A01,203330,Staff,14,0,20,6
1683310759416,SOCI 131,A00,258909,Thorpe; Charles Robert,31,0,60,29
1683310760444,SOCI 135,A00,258910,Payne; Christine Anna,0,9,30,30
1683310761472,SOCI 157,A00,258911,Staff,13,0,30,17
1683310762498,SOCI 184,A00,258912,Staff,26,0,30,4
1683310763525,SOCI 188D,A00,258913,Staff,21,0,30,9
1683310764552,SYN 2,001,187529,Staff,9,0,16,7
1683310764552,SYN 2,002,201452,Staff,0,18,16,16
1683310764552,SYN 2,003,201469,Staff,3,0,16,13
1683310765581,SYN 100,A01,187531,Staff,0,9,20,20
1683310765581,SYN 100,B01,201491,Staff,0,12,20,20
1683310766667,TDAC 1,A00,189286,Walsh; Kim C.,3,0,20,17
1683310766667,TDAC 1,B00,189287,Harting; Carla Kelso,11,0,20,9
1683310767693,TDAC 101,A00,189300,Walsh; Kim C.,16,0,20,4
1683310767693,TDAC 101,B00,189301,Harting; Carla Kelso,18,0,20,2
1683310768720,TDAC 102,A00,189304,Basso; Beatrice,14,0,20,6
1683310769746,TDAC 108,A00,189305,Staff,18,0,20,2
1683310770776,TDDE 131,A00,189310,Staff,19,0,20,1
1683310770776,TDDE 131,B00,189314,Staff,19,0,20,1
1683310770776,TDDE 131,C00,189315,Staff,48,0,50,2
1683310770776,TDDE 131,D00,189316,Staff,14,0,15,1
1683310770776,TDDE 131,E00,204841,Staff,20,0,20,0
1683310771800,TDGE 10,A00,189289,Staff,30,0,50,20
1683310771800,TDGE 10,B00,189290,Havis; Allan,2,0,50,48
1683310772824,TDGE 11,A00,189291,Fulton; Julia,0,3,50,50
1683310772824,TDGE 11,B00,189292,Staff,20,0,25,5
1683310772824,TDGE 11,C00,260270,Staff,0,0,0,0
1683310773851,TDGE 25,A00,189294,Staff,3,0,20,17
1683310774877,TDGE 124,A00,189318,Fulton; Julia,0,8,50,50
1683310775902,TDGE 125,A00,189319,Staff,13,0,25,12
1683310775902,TDGE 125,B00,189320,Staff,23,0,25,2
1683310776926,TDGE 127,A00,189322,Havis; Allan,0,0,50,50
1683310777958,TDHT 101,A00,189323,Staff,18,0,25,7
1683310777958,TDHT 101,B00,189324,Staff,25,0,25,0
1683310778982,TDHT 102,A00,189325,Staff,49,0,50,1
1683310780007,TDMV 1,A00,189295,Arcidiacono; Kristin,20,0,30,10
1683310780007,TDMV 1,B00,189296,Caligagan; Maria T.,24,0,30,6
1683310781031,TDMV 2,A00,189297,Sammartano; Tonnie,28,0,30,2
1683310781031,TDMV 2,B00,189299,Arcidiacono; Kristin,24,0,30,6
1683310782057,TDMV 3,A00,204998,Rincon; Alicia,22,0,30,8
1683310783080,TDMV 120,A00,189458,Sammartano; Tonnie,28,0,30,2
1683310784105,TDMV 138,A00,189541,Jun; Grace Shin Hae,22,0,40,18
1683310785127,TDMV 142,A00,189717,Caligagan; Tony,23,0,30,7
1683310785127,TDMV 142,B00,189718,Caligagan; Maria T.,25,0,30,5
1683310786151,TMC 2,A01,187533,Staff,25,0,25,0
1683310786151,TMC 2,A02,187534,Staff,25,0,25,0
1683310787177,USP 1,A01,187536,Kwak; Nancy,0,16,25,25
1683310788201,USP 5,A01,187538,Staff,9,0,25,16
1683310789227,USP 101,A00,199253,Staff,0,4,0,0
1683310790251,USP 124,A00,187562,Boomhower; Matthew Charles,1,0,30,29
1683310791278,USP 138,A00,187582,Staff,20,0,25,5
1683310792303,USP 152,A01,187597,Staff,4,0,25,21
1683310793330,USP 153,A00,187598,Staff,19,0,25,6
1683310794357,USP 168,A00,187607,Kwak; Nancy,2,0,5,3
1683310795382,USP 173,A00,187619,Staff,4,0,25,21
1683310796409,USP 181,A00,187638,Staff,0,0,25,25
1683310797433,VIS 103,A00,187650,Cruz; Edwin Teddy,23,0,75,52
1683310798456,VIS 110D,A00,187669,Staff,12,0,22,10
1683310799483,VIS 127C,A00,187720,Shen; Kuiyi,68,0,146,78
1683310800507,VIS 149,A00,187731,Yoldas; Pinar,0,14,22,22
1683310801533,VIS 151,A01,188091,Staff,22,0,34,12
1683310801533,VIS 151,A02,188092,Staff,11,0,34,23
1683310802557,VIS 160B,A00,188093,Stalbaum; Brett,0,0,10,10
1683310804609,WCWP 10B,A00,201720,Staff,10,0,15,5
1683310804609,WCWP 10B,B00,201722,Staff,8,0,15,7
1683310805635,WCWP 100,A00,201725,Gagnon; Jeffrey C,0,0,2,2
1683310805635,WCWP 100,B00,201727,Staff,0,4,15,15
1683310808760,ANBI 133,A00,258401,Wilder; Linnea Lorene,34,0,40,6
1683310809785,ANBI 140,A00,258395,Hrvoj Mihic; Branka,18,0,25,7
1683310810809,ANSC 120,A00,258402,Bialecki; Jon Anthony,27,0,40,13
1683310811833,ANSC 144,A00,258400,Staff,14,0,40,26
1683310813886,ANSC 166,A00,258396,Parish; Steven Martin,157,0,175,18
1683310814915,ANSC 180,A00,193533,Staff,9,0,20,11
1683310815942,ANSC 188,A00,258397,Jassal; Aftab,33,0,40,7
1683310816966,ANTH 3,A01,258316,Staff,23,0,30,7
1683310817994,ANTH 5,A00,258394,Semendeferi; Ekaterini,16,0,20,4
1683310819018,ANTH 21,A01,258331,Staff,9,0,40,31
1683310820045,ANTH 103,A00,258398,Varma; Saiba,15,0,25,10
1683310821078,AWP 10,001,202034,Staff,0,0,0,0
1683310821078,AWP 10,002,202035,Staff,0,0,0,0
1683310821078,AWP 10,003,202036,Staff,0,0,0,0
1683310821078,AWP 10,004,202037,Staff,0,0,0,0
1683310821078,AWP 10,005,202038,Staff,0,0,0,0
1683310821078,AWP 10,006,202039,Staff,0,0,0,0
1683310821078,AWP 10,007,202040,Staff,0,0,0,0
1683310821078,AWP 10,008,202041,Staff,0,0,0,0
1683310821078,AWP 10,009,202042,Staff,0,0,0,0
1683310821078,AWP 10,010,202043,Staff,0,0,0,0
1683310821078,AWP 10,011,202044,Staff,0,0,0,0
1683310821078,AWP 10,012,202045,Staff,0,0,0,0
1683310821078,AWP 10,013,202046,Staff,0,0,0,0
1683310821078,AWP 10,014,202047,Staff,0,0,0,0
1683310821078,AWP 10,015,202048,Staff,0,0,0,0
1683310821078,AWP 10,016,202049,Staff,0,0,0,0
1683310821078,AWP 10,017,202050,Staff,0,0,0,0
1683310821078,AWP 10,018,202051,Staff,0,0,0,0
1683310821078,AWP 10,019,202052,Staff,0,0,0,0
1683310821078,AWP 10,020,202053,Staff,0,0,0,0
1683310821078,AWP 10,021,202054,Staff,0,0,0,0
1683310821078,AWP 10,022,202055,Staff,0,0,0,0
1683310821078,AWP 10,023,202056,Staff,0,0,0,0
1683310821078,AWP 10,024,202057,Staff,0,0,0,0
1683310821078,AWP 10,025,202058,Staff,0,0,0,0
1683310821078,AWP 10,026,202059,Staff,0,0,0,0
1683310822102,AWP 102,001,202032,Staff,0,0,0,0
1683310822102,AWP 102,002,202033,Staff,0,0,0,0
1683310823127,BENG 100,A01,254234,Taylor Amos; Alyssa C,31,0,40,9
1683310824151,BENG 196,001,270013,Engler; Adam J.,9999,0,9999,0
1683310825180,BICD 100R,A01,202018,Smith; Laurie,0,7,32,32
1683310825180,BICD 100R,A02,202019,Smith; Laurie,0,2,32,32
1683310825180,BICD 100R,A03,202020,Smith; Laurie,0,1,32,32
1683310825180,BICD 100R,A04,202021,Smith; Laurie,8,0,32,24
1683310825180,BICD 100R,A05,202022,Smith; Laurie,12,0,32,20
1683310826204,BICD 136,A01,193242,Gustafson-Brown; Cindy,0,2,32,32
1683310826204,BICD 136,A02,193244,Gustafson-Brown; Cindy,15,0,32,17
1683310827229,BIEB 102,A01,193249,Butler; Shannon Rhey,0,2,32,32
1683310827229,BIEB 102,A02,193251,Butler; Shannon Rhey,0,0,32,32
1683310827229,BIEB 102,A03,193253,Butler; Shannon Rhey,0,1,32,32
1683310827229,BIEB 102,A04,193255,Butler; Shannon Rhey,17,0,32,15
1683310827229,BIEB 102,A05,193265,Butler; Shannon Rhey,26,0,32,6
1683310827229,BIEB 102,A06,193269,Butler; Shannon Rhey,16,0,32,16
1683310829280,BIEB 150,A01,193274,Staff,0,0,32,32
1683310829280,BIEB 150,A02,193285,Staff,24,0,32,8
1683310830303,BIEB 194,A00,193286,Kurle; Carolyn M.,22,0,32,10
1683310831328,BILD 1,A01,192291,Staff,16,0,32,16
1683310831328,BILD 1,A02,192292,Staff,30,0,32,2
1683310831328,BILD 1,B01,192520,Reuther; Keefe,0,1,0,0
1683310831328,BILD 1,B02,192532,Reuther; Keefe,0,1,0,0
1683310832358,BILD 3,A01,192556,Butler; Shannon Rhey,0,0,32,32
1683310832358,BILD 3,A02,192581,Butler; Shannon Rhey,5,0,32,27
1683310832358,BILD 3,A03,192611,Butler; Shannon Rhey,23,0,32,9
1683310832358,BILD 3,A04,192612,Butler; Shannon Rhey,25,0,32,7
1683310832358,BILD 3,A05,192613,Butler; Shannon Rhey,27,0,32,5
1683310832358,BILD 3,A06,192679,Butler; Shannon Rhey,27,0,32,5
1683310832358,BILD 3,A07,192682,Butler; Shannon Rhey,22,0,32,10
1683310833388,BILD 4,A01,192836,Reuther; Keefe,1,0,24,23
1683310833388,BILD 4,A02,193044,Reuther; Keefe,4,0,24,20
1683310844037,BILD 10,A01,193142,Gustafson-Brown; Cindy,31,0,32,1
1683310844037,BILD 10,A02,193149,Gustafson-Brown; Cindy,31,0,32,1
1683310845065,BIMM 100,A01,193301,Staff,0,6,32,32
1683310845065,BIMM 100,A02,193312,Staff,0,5,32,32
1683310845065,BIMM 100,A03,193323,Staff,0,8,32,32
1683310846096,BIMM 101,A01,193329,McDonnell; Lisa Marie,0,3,24,24
1683310846096,BIMM 101,A02,193339,McDonnell; Lisa Marie,0,2,24,24
1683310846096,BIMM 101,B01,193354,McDonnell; Lisa Marie,0,3,24,24
1683310846096,BIMM 101,B02,193357,McDonnell; Lisa Marie,0,3,24,24
1683310847120,BIMM 110,A01,193377,Tat; John,0,11,32,32
1683310847120,BIMM 110,A02,193378,Tat; John,1,9,32,31
1683310848148,BIMM 120,A01,206116,Staff,0,0,32,32
1683310848148,BIMM 120,A02,206117,Staff,8,0,32,24
1683310848148,BIMM 120,A03,206121,Staff,21,0,32,11
1683310849181,BIPN 100,A01,193393,Park; Ji Young,0,14,32,32
1683310849181,BIPN 100,A02,193402,Park; Ji Young,0,12,32,32
1683310849181,BIPN 100,A03,193413,Park; Ji Young,0,14,32,32
1683310849181,BIPN 100,A04,193414,Park; Ji Young,0,13,32,32
1683310850210,BIPN 102,A01,193429,Staff,0,0,32,32
1683310850210,BIPN 102,A02,193438,Staff,22,0,32,10
1683310851237,BIPN 106,A01,193450,Reyes Gonzalez; Catalina,0,2,40,40
1683310852265,BIPN 134,A01,193465,Cooke; James Edward,0,0,32,32
1683310852265,BIPN 134,A02,193474,Cooke; James Edward,27,0,32,5
1683310852265,BIPN 134,A03,193485,Cooke; James Edward,29,0,32,3
1683310852265,BIPN 134,A04,193486,Cooke; James Edward,21,0,32,11
1683310852265,BIPN 134,A05,193491,Cooke; James Edward,31,0,32,1
1683310852265,BIPN 134,A06,193501,Cooke; James Edward,30,0,32,2
1683310852265,BIPN 134,A07,193510,Cooke; James Edward,29,0,32,3
1683310854314,BISP 194,A00,222522,Staff,16,0,32,16
1683310855341,CAT 124,A01,202407,Staff,20,0,25,5
1683310856365,CAT 125,A00,202408,Marchisotto; Jennifer Anne,4,0,20,16
1683310857394,CAT 125R,A00,202409,Smith; Lauryn Alissa,0,11,20,20
1683310857394,CAT 125R,B00,202410,Morales; Celeste Georgianna,0,11,20,20
1683310857394,CAT 125R,C00,202411,Irwin; Matthew Joseph,0,10,20,20
1683310858419,CENG 15,A01,204712,Yang; Kesong,0,1,0,0
1683310859444,CENG 114,A00,202070,Jahed Motlagh; Zeinab,5,0,20,15
1683310860468,CGS 105,A00,185477,Wesling; Megan E.,24,0,40,16
1683310861495,CGS 106,A00,185494,Staff,13,0,22,9
1683310862519,CGS 108,A00,185495,Staff,14,0,20,6
1683310863546,CGS 114,A00,185496,Staff,13,0,18,5
1683310864569,CGS 119,A00,185501,Staff,15,0,20,5
1683310865594,CGS 120,A00,185511,Staff,13,0,20,7
1683310866622,CHEM 4,A01,184675,Bussey; Thomas J,96,0,100,4
1683310867645,CHEM 6A,A01,184677,Staff,35,0,60,25
1683310868673,CHEM 6B,A01,184679,Staff,65,0,100,35
1683310869701,CHEM 6C,A01,184681,Bussey; Thomas J,1,0,50,49
1683310869701,CHEM 6C,A02,184682,Bussey; Thomas J,34,0,50,16
1683310870726,CHEM 40A,A01,184684,Albizati; Kim F.,37,0,100,63
1683310871751,CHEM 40B,A01,184686,Albizati; Kim F.,0,20,100,100
1683310872779,CHEM 41B,A01,184690,Staff,52,0,100,48
1683310873806,COGS 3,A01,184715,Boyle; Mary E. T.,0,25,40,40
1683310874831,COGS 14B,A01,185172,Staff,0,15,38,38
1683310875855,COGS 18,A01,184736,Staff,19,0,80,61
1683310876883,COGS 100,A01,184932,Staff,0,5,73,73
1683310877907,COGS 101A,A01,184935,Staff,0,38,30,30
1683310878935,COGS 101B,A01,184944,Staff,0,2,30,30
1683310880031,COGS 101C,A01,184946,Staff,0,12,30,30
1683310881056,COGS 102A,A01,184951,Johnson; Christine M.,2,0,40,38
1683310882081,COGS 107B,A01,184953,Mooshagian; Eric Frederick,0,50,40,40
1683310883110,COGS 118B,A01,184959,Gupta; Anjum,0,48,40,40
1683310884134,COGS 153,A00,184961,Staff,0,15,30,30
1683310885158,COGS 177,A00,184962,Staff,0,21,30,30
1683310886182,COGS 187A,A01,184969,Boyle; Mary E. T.,0,17,40,40
1683310887206,COMM 10,A01,185174,Staff,0,5,25,25
1683310887206,COMM 10,A02,185189,Staff,0,5,25,25
1683310887206,COMM 10,A03,269821,Staff,0,0,0,0
1683310888241,COMM 100B,A01,185475,Staff,0,0,0,2
1683310888241,COMM 100B,A02,185476,Staff,14,0,25,11
1683310889267,COMM 100C,A01,185314,Staff,1,0,25,24
1683310889267,COMM 100C,A02,185327,Staff,19,0,25,6
1683310890291,COMM 110M,A00,185349,Staff,2,0,40,38
1683310891314,COMM 113T,A00,185352,Staff,25,0,40,15
1683310892337,COMM 114I,A00,185353,Staff,33,0,40,7
1683310893361,COMM 131,A00,185354,Staff,19,0,30,11
1683310894393,CSE 8A,A50,185358,Cao; Yingjun,0,46,10,10
1683310895418,CSE 8B,A01,185362,Staff,1,47,50,49
1683310896444,CSE 11,A01,185416,Cao; Yingjun,0,92,10,10
1683310897470,CSE 20,A01,185445,Briones; Jor-el Thomas Caparas,5,0,25,20
1683310898494,CSE 21,A01,185447,Staff,10,0,50,40
1683310899522,CSE 101,A01,185451,Staff,0,12,50,50
1683310899522,CSE 101,B01,185453,Jones; Miles E,0,11,50,50
1683310901574,CSE 141,A01,185458,Eldon; John,20,0,100,80
1683310902599,CSE 141L,A01,185461,Eldon; John,12,0,100,88
1683310903623,CSE 142,A01,185463,Staff,35,0,60,25
1683310903623,CSE 142,B01,201355,Staff,0,6,60,60
1683310904647,CSE 142L,A01,185470,Staff,35,0,60,25
1683310904647,CSE 142L,B01,201417,Staff,0,5,60,60
1683310905674,CSE 190,A00,201433,Staff,32,0,49,17
1683310906699,DOC 1,A01,259136,Strom; Megan C.,8,0,15,7
1683310906699,DOC 1,A02,259137,Strom; Megan C.,14,0,15,1
1683310906699,DOC 1,A03,259138,Strom; Megan C.,14,0,15,1
1683310906699,DOC 1,A04,259139,Strom; Megan C.,14,0,15,1
1683310907724,DOC 100D,A00,259140,Pass; Natalye Joann,17,0,25,8
1683310908751,DSGN 1,A01,184749,Rill; Bryan,0,25,30,30
1683310909778,DSGN 100,A01,185168,Staff,0,2,25,25
1683310910802,ECE 5,A01,185626,Morris; Karcher William,0,10,0,0
1683310911831,ECE 101,A01,185628,Staff,17,0,70,53
1683310912860,ECE 107,A01,185635,Baghdadchi; Saharnaz,0,0,20,20
1683310912860,ECE 107,A02,185638,Baghdadchi; Saharnaz,4,0,20,16
1683310913884,ECE 148,A01,185647,Silberman; Jack,0,0,16,16
1683310914909,ECON 1,A01,185537,Crane; Meredith Helen,54,0,70,16
1683310915933,ECON 3,A01,185549,Crane; Meredith Helen,33,0,70,37
1683310916962,ECON 4,A01,203354,Anderson; John Charles,0,4,10,10
1683310917987,ECON 100A,A01,185574,Staff,0,4,40,40
1683310919012,ECON 100B,A01,185576,Staff,0,22,40,40
1683310920036,ECON 100C,A01,185589,Newhouse; Herbert S,30,0,70,40
1683310921064,ECON 105,A00,185608,Vespa; Emanuel Ignacio,19,0,35,16
1683310922088,ECON 109,A01,185610,Shishkin; Denis,10,0,35,25
1683310923115,ECON 110A,A01,185612,Staff,11,0,40,29
1683310924141,ECON 120A,A01,185615,Staff,20,0,40,20
1683310925165,ECON 120C,A01,185617,Sun; Yixiao,0,20,70,70
1683310926189,ECON 144,A00,203346,Squires; Dale E,3,0,35,32
1683310927213,ECON 171,A01,203349,Newhouse; Herbert S,0,1,35,35
1683310928237,ECON 173A,A01,185621,Toda; Alexis Akira,21,0,35,14
1683310929267,EDS 25,A01,202413,Staff,0,1,0,0
1683310929267,EDS 25,A02,202414,Staff,0,1,0,0
1683310929267,EDS 25,A03,202415,Staff,0,0,0,0
1683310929267,EDS 25,A04,202416,Staff,0,1,0,0
1683310929267,EDS 25,A05,202439,Staff,0,0,0,0
1683310929267,EDS 25,A06,202440,Staff,0,0,0,0
1683310929267,EDS 25,B01,202631,Staff,0,0,0,0
1683310929267,EDS 25,B02,202632,Staff,0,0,0,0
1683310929267,EDS 25,B03,202639,Staff,0,0,0,0
1683310929267,EDS 25,B04,202640,Staff,0,0,0,0
1683310929267,EDS 25,B05,202643,Staff,0,0,0,0
1683310929267,EDS 25,B06,202644,Staff,0,0,0,0
1683310930294,EDS 38,A01,202659,Black; Alison Michelle,24,0,25,1
1683310931321,EDS 115,A00,202652,Staff,17,0,30,13
1683310932348,EDS 125,A00,202649,Staff,14,0,30,16
1683310933374,EDS 126,A01,203332,Staff,30,0,30,0
1683310934401,EDS 139,A00,202838,Staff,17,0,25,8
1683310935429,EDS 146,A01,202655,Staff,15,0,25,10
1683310936456,ENG 15,A00,185667,Staff,0,1,0,0
1683310936456,ENG 15,B00,185672,Staff,0,0,0,0
1683310936456,ENG 15,C00,185675,Staff,0,0,0,0
1683310936456,ENG 15,D00,185682,Staff,0,0,0,0
1683310936456,ENG 15,E00,185684,Staff,0,0,0,0
1683310937480,ETHN 103,A00,185710,Staff,0,3,35,35
1683310938507,ETHN 103A,A00,199228,Man; Simeon S,2,0,9,7
1683310939532,ETHN 109,A00,185711,Staff,18,0,35,17
1683310940558,ETHN 142,A00,185726,Staff,0,4,30,30
1683310941581,ETHN 163J,A00,199229,Man; Simeon S,5,0,8,3
1683310942605,ETHN 168,A00,185727,Staff,8,0,10,2
1683310943633,ETHN 182,A00,185728,Staff,1,0,35,34
1683310944661,ETHN 183,A00,185737,Staff,8,0,18,10
1683310945686,GLBH 111,A01,209361,Burgos; Jose L.,0,0,0,0
1683310947738,HIEU 104,A00,185792,Staff,16,0,20,4
1683310948765,HIEU 115,A00,185800,Staff,1,0,20,19
1683310949788,HIEU 128,A00,185801,Staff,0,7,20,20
1683310950814,HIEU 147,A00,185802,Staff,16,0,20,4
1683310951841,HIEU 154,A00,185823,Staff,12,0,20,8
1683310952866,HILA 102,A00,185826,Staff,13,0,20,7
1683310953891,HILD 2C,A01,185778,Staff,0,12,20,20
1683310954918,HILD 7B,A01,185780,Kwak; Nancy,0,15,32,32
1683310954918,HILD 7B,A02,185781,Kwak; Nancy,0,18,32,32
1683310955943,HILD 30,A01,185791,Staff,14,0,20,6
1683310956972,HISC 119,A00,185830,Golan; Tal,0,9,20,20
1683310957997,HITO 156GS,A00,185831,Patterson; Patrick H.,0,0,0,23
1683310959024,HIUS 103,A00,185832,Man; Simeon S,0,6,20,20
1683310960048,HIUS 117,A00,185836,Kwak; Nancy,2,0,20,18
1683310961075,HIUS 125,A00,185840,Man; Simeon S,0,0,23,23
1683310962100,HIUS 149,A00,185845,Staff,0,0,20,20
1683310963129,HUM 3,A01,185882,Zavodny; Tatiana Sophia,0,6,50,50
1683310963129,HUM 3,B01,185899,Caldwell; Michael Alan,0,19,50,50
1683310964153,HUM 3GS,A00,185900,Patterson; Patrick H.,0,0,0,23
1683310965177,HUM 4,A01,185938,Zroka; Amy Liane,31,0,50,19
1683310965177,HUM 4,B01,185956,Watkins; Eric,0,2,50,50
1683310965177,HUM 4,B02,202209,Watkins; Eric,0,2,50,50
1683310965177,HUM 4,B03,202210,Watkins; Eric,0,0,50,50
1683310966203,HUM 5,A01,185958,West; Geoffrey Scott,4,0,50,46
1683310966203,HUM 5,A02,202215,West; Geoffrey Scott,0,0,50,50
1683310967229,INTL 190,A00,185959,Gagnon; Jeffrey C,0,0,0,9
1683310967229,INTL 190,B00,185960,Lettieri; Michael Joseph,0,0,0,1
1683310968254,JAPN 180,A00,254509,Staff,5,1,30,25
1683310969281,LATI 10,A01,202853,Kennemore; Amy Michelle,5,0,35,30
1683310969281,LATI 10,A02,202854,Kennemore; Amy Michelle,1,0,35,34
1683310969281,LATI 10,A03,270054,Kennemore; Amy Michelle,30,0,30,0
1683310970305,LATI 180,A00,202855,Kennemore; Amy Michelle,11,0,20,9
1683310971332,LAWS 101,A00,201767,Golan; Tal,0,7,40,40
1683310972354,LIFR 1C,A00,185961,Staff,6,0,20,14
1683310973379,LIFR 1CX,A00,185962,Staff,7,0,20,13
1683310974405,LIFR 1D,A00,185963,Staff,9,0,20,11
1683310975427,LIFR 1DX,A00,185964,Staff,9,0,20,11
1683310976452,LIGN 101,A01,186039,Staff,43,0,50,7
1683310977474,LIGN 165,A00,186040,Staff,18,0,50,32
1683310978500,LTCS 108,A00,186041,Staff,6,0,10,4
1683310979526,LTCS 119,A00,186042,Staff,16,0,20,4
1683310980555,LTCS 130,A00,186043,Wesling; Megan E.,15,0,25,10
1683310982606,LTEA 138,A00,186119,Staff,14,0,40,26
1683310983691,LTEN 124,A00,186148,Staff,6,0,25,19
1683310984718,LTEN 178,A00,186149,Staff,7,0,15,8
1683310985748,LTEN 181,A00,186150,Blanco; John D,33,0,40,7
1683310986773,LTWL 120,A00,186160,Staff,20,0,25,5
1683310987799,LTWL 165,A00,186161,Staff,22,0,25,3
1683310988824,LTWR 100,A00,186162,Staff,0,4,15,15
1683310989848,LTWR 102,A00,186163,Doller; Ben,5,0,15,10
1683310990873,MAE 8,A01,186412,Staff,0,0,0,0
1683310991902,MAE 30B,A00,186445,Bahadori; Mohammad Yousef,83,0,100,17
1683310992926,MAE 40,A00,186592,Bewley; Thomas R,9,0,50,41
1683310993950,MAE 101B,A00,186593,Bahadori; Mohammad Yousef,81,0,100,19
1683310994975,MAE 105,A00,186594,Bandaru; Prabhakar,12,0,50,38
1683310996000,MAE 107,A00,186599,Pham; Hieu Tan,0,6,120,120
1683310997031,MAE 148,A01,186660,Silberman; Jack,3,0,16,13
1683310998055,MATH 10A,A01,188095,Staff,0,7,35,35
1683310999084,MATH 10B,A01,188097,Bowers; Adam R.,0,11,30,30
1683310999084,MATH 10B,A02,188099,Bowers; Adam R.,0,11,30,30
1683310999084,MATH 10B,B01,188104,Bowers; Adam R.,0,10,30,30
1683310999084,MATH 10B,B02,188106,Bowers; Adam R.,0,10,30,30
1683311000115,MATH 10C,A01,188111,Staff,0,18,30,30
1683311000115,MATH 10C,A02,188127,Staff,0,17,30,30
1683311000115,MATH 10C,A03,188131,Staff,0,18,30,30
1683311000115,MATH 10C,B01,188218,Staff,20,0,30,10
1683311000115,MATH 10C,B02,188244,Staff,13,0,30,17
1683311000115,MATH 10C,B03,188277,Staff,16,0,30,14
1683311001139,MATH 18,A01,188344,Bach; Quang Tran,18,0,30,12
1683311001139,MATH 18,A02,188345,Bach; Quang Tran,11,0,30,19
1683311001139,MATH 18,B01,188353,Bach; Quang Tran,10,0,30,20
1683311001139,MATH 18,B02,188354,Bach; Quang Tran,20,0,30,10
1683311002166,MATH 20A,A01,188374,Staff,13,0,35,22
1683311003193,MATH 20B,A01,188382,Ohm; Ko Woon,6,0,30,24
1683311003193,MATH 20B,A02,188383,Ohm; Ko Woon,23,0,30,7
1683311003193,MATH 20B,B01,188385,Ohm; Ko Woon,7,0,30,23
1683311003193,MATH 20B,B02,188392,Ohm; Ko Woon,22,0,30,8
1683311004220,MATH 20C,A01,188394,Harel; Guershon,10,0,30,20
1683311004220,MATH 20C,A02,188395,Harel; Guershon,14,0,30,16
1683311004220,MATH 20C,B01,188404,Harel; Guershon,5,0,30,25
1683311004220,MATH 20C,B02,188405,Harel; Guershon,19,0,30,11
1683311005243,MATH 20D,A01,188414,Hammock; Frances H,0,1,30,30
1683311005243,MATH 20D,A02,188415,Hammock; Frances H,4,0,30,26
1683311005243,MATH 20D,B01,188447,Hammock; Frances H,2,0,30,28
1683311005243,MATH 20D,B02,188486,Hammock; Frances H,8,0,30,22
1683311006267,MATH 20E,A01,188649,Staff,22,0,30,8
1683311006267,MATH 20E,A02,188650,Staff,23,0,30,7
1683311006267,MATH 20E,A03,188673,Staff,0,0,30,30
1683311007295,MATH 102,A01,188675,Staff,0,35,35,35
1683311008318,MATH 103B,A01,188681,Staff,4,0,35,31
1683311008318,MATH 103B,B01,188692,Staff,6,0,35,29
1683311009345,MATH 109,A01,188695,Salehi Golsefidy; Alireza,25,0,35,10
1683311009345,MATH 109,A02,188696,Salehi Golsefidy; Alireza,27,0,35,8
1683311010370,MATH 120A,A01,188698,Eggers; John Dietrich,6,0,35,29
1683311011399,MATH 142B,A01,188736,Ioana; Adrian,0,2,30,30
1683311011399,MATH 142B,A02,188741,Ioana; Adrian,0,1,30,30
1683311011399,MATH 142B,A03,188743,Ioana; Adrian,1,3,30,29
1683311012428,MATH 168A,A01,188790,Staff,0,9,35,35
1683311013457,MATH 170A,A01,188803,Nie; Jiawang,0,2,35,35
1683311013457,MATH 170A,A02,188811,Nie; Jiawang,0,0,35,35
1683311013457,MATH 170A,A03,188814,Nie; Jiawang,1,0,35,34
1683311013457,MATH 170A,A04,188815,Nie; Jiawang,13,0,35,22
1683311014481,MATH 193B,A01,188817,Staff,0,0,35,35
1683311014481,MATH 193B,A02,188818,Staff,5,0,35,30
1683311015505,MGT 4,A01,202857,Anderson; John Charles,62,0,80,18
1683311016529,MGT 12,A00,202858,Lindenberger; Wade Douglas,43,0,90,47
1683311017558,MGT 18,A00,202859,Staff,74,0,90,16
1683311018582,MGT 18GS,A00,202860,McKay; Michael J,13,0,28,15
1683311019606,MGT 45,A00,202861,Pecore; Joseph P.,14,0,90,76
1683311020633,MGT 100,A00,202863,Yavorsky; Daniel Ryan,28,0,90,62
1683311021657,MGT 103,A00,202864,Ehrich; Kristine R,0,16,90,90
1683311022682,MGT 112,A00,202865,Ehrich; Kristine R,15,0,90,75
1683311023705,MGT 121A,A00,202868,Staff,0,19,0,0
1683311024728,MGT 131B,A00,202869,Anderson; John Charles,59,0,90,31
1683311025752,MGT 136,A00,202871,Lindenberger; Wade Douglas,84,0,90,6
1683311026776,MGT 164,A00,202873,Staff,0,69,90,90
1683311027801,MGT 164GS,A00,202874,McKay; Mary A,13,0,28,15
1683311028829,MGT 180,A00,202875,Staff,0,51,90,90
1683311029857,MMW 11R,A01,205019,Herbst; Matthew,3,0,30,27
1683311029857,MMW 11R,A02,205026,Herbst; Matthew,29,0,30,1
1683311030885,MMW 15,A01,193512,Chang; Edmond Yi-Teh,0,9,28,28
1683311030885,MMW 15,A02,193513,Chang; Edmond Yi-Teh,0,5,28,28
1683311030885,MMW 15,A03,193514,Chang; Edmond Yi-Teh,0,5,28,28
1683311030885,MMW 15,A04,193515,Chang; Edmond Yi-Teh,0,5,28,28
1683311030885,MMW 15,A05,193516,Chang; Edmond Yi-Teh,0,4,28,28
1683311030885,MMW 15,A06,193517,Chang; Edmond Yi-Teh,0,5,28,28
1683311030885,MMW 15,B01,193519,Chang; Edmond Yi-Teh,0,4,28,28
1683311030885,MMW 15,B02,193520,Chang; Edmond Yi-Teh,0,5,28,28
1683311030885,MMW 15,B03,193521,Chang; Edmond Yi-Teh,0,4,28,28
1683311030885,MMW 15,B04,193522,Chang; Edmond Yi-Teh,0,4,28,28
1683311030885,MMW 15,B05,193523,Chang; Edmond Yi-Teh,0,5,28,28
1683311030885,MMW 15,B06,193524,Chang; Edmond Yi-Teh,0,4,28,28
1683311031910,MMW 122,A01,193526,Rahimi; Babak,0,14,28,28
1683311031910,MMW 122,A02,193527,Rahimi; Babak,0,14,28,28
1683311031910,MMW 122,A03,193528,Rahimi; Babak,0,0,0,0
1683311031910,MMW 122,A04,193529,Rahimi; Babak,0,0,0,0
1683311032935,MUS 1A,A01,186663,Staff,0,20,35,35
1683311033959,MUS 4,A01,186715,Staff,0,12,35,35
1683311034984,MUS 5R,A01,186796,Dubnov; Shlomo,0,17,35,35
1683311036007,MUS 6,A01,186798,Staff,0,3,25,25
1683311037032,MUS 7,A01,186830,Staff,12,0,35,23
1683311038060,MUS 8,A01,186930,Staff,0,26,35,35
1683311039082,MUS 15,A01,186932,Staff,0,15,35,35
1683311039082,MUS 15,B01,186934,Staff,0,15,35,35
1683311040110,MUS 80,A00,186935,Staff,2,0,20,18
1683311040110,MUS 80,B00,186936,Staff,25,0,25,0
1683311041146,NANO 11,A00,204702,Lipomi; Darren John,0,0,0,0
1683311042173,NANO 15,A01,204709,Yang; Kesong,0,1,0,0
1683311043198,NANO 114,A00,202069,Jahed Motlagh; Zeinab,3,0,10,7
1683311044221,PHIL 1,A00,186955,Grush; Rick Scott,32,0,40,8
1683311045246,PHIL 10,A01,186973,Grush; Rick Scott,28,0,35,7
1683311045246,PHIL 10,A02,186974,Grush; Rick Scott,33,0,35,2
1683311046273,PHIL 13,A01,186976,Staff,7,0,35,28
1683311046273,PHIL 13,A02,186977,Staff,16,0,35,19
1683311047298,PHIL 14,A01,186979,Staff,31,0,35,4
1683311047298,PHIL 14,A02,186986,Staff,32,0,35,3
1683311048323,PHIL 28,A01,186988,Staff,16,0,30,14
1683311048323,PHIL 28,A02,186989,Staff,1,0,30,29
1683311048323,PHIL 28,A03,186990,Staff,9,0,30,21
1683311048323,PHIL 28,A04,186991,Staff,26,0,30,4
1683311049348,PHIL 120,A00,186997,Staff,23,0,40,17
1683311050372,PHIL 137,A00,187003,Staff,9,0,40,31
1683311051398,PHIL 150,A00,187015,Staff,47,0,70,23
1683311052425,PHIL 167,A00,187021,Lamey; Andy M.,35,0,40,5
1683311053453,PHIL 174,A01,202226,Staff,17,0,20,3
1683311053453,PHIL 174,A02,202235,Staff,20,0,20,0
1683311054477,PHIL 191A,A00,258918,Staff,0,0,1,1
1683311055501,PHYS 1A,A00,187028,Staff,27,0,60,33
1683311056526,PHYS 1AL,001,187036,Staff,3,0,30,27
1683311056526,PHYS 1AL,002,187049,Staff,18,0,30,12
1683311057550,PHYS 1B,A00,187058,Staff,23,0,60,37
1683311058576,PHYS 1BL,001,187064,Staff,0,0,30,30
1683311058576,PHYS 1BL,002,187070,Staff,6,0,30,24
1683311059601,PHYS 1C,A00,187082,Staff,31,0,120,89
1683311060628,PHYS 1CL,001,187088,Staff,0,9,30,30
1683311060628,PHYS 1CL,002,187089,Staff,0,2,30,30
1683311060628,PHYS 1CL,009,262693,Staff,11,0,30,19
1683311061653,PHYS 2B,A01,187097,Staff,54,0,115,61
1683311062678,PHYS 2C,A01,187099,Staff,67,0,115,48
1683311063709,PHYS 2CL,A01,187101,Staff,5,0,28,23
1683311063709,PHYS 2CL,A02,187102,Staff,15,0,28,13
1683311064736,PHYS 2D,A01,187123,Shotwell; Brian,95,0,115,20
1683311065763,PHYS 4B,A01,187133,Grinstein; Benjamin,35,0,50,15
1683311066790,POLI 10,A00,188819,Staff,0,3,50,50
1683311067816,POLI 11,A00,188827,Staff,43,0,50,7
1683311068840,POLI 13R,A00,188828,Staff,0,1,20,20
1683311069866,POLI 27,A01,188830,Elgin; Samuel Zincke,0,1,70,70
1683311070893,POLI 30,A00,188832,Desposato; Scott,33,0,50,17
1683311071920,POLI 102F,A00,188834,Staff,3,0,40,37
1683311072945,POLI 104A,A00,188852,Staff,14,0,30,16
1683311073968,POLI 104I,A00,188853,Staff,0,6,20,20
1683311074992,POLI 110B,A00,188854,Wiens; David,7,0,20,13
1683311076015,POLI 112A,A00,188855,Wiens; David,5,0,30,25
1683311077043,POLI 117R,A00,188856,Forman; Fonna,0,11,20,20
1683311078070,POLI 118,A00,188857,Ingham; Sean,8,0,20,12
1683311079095,POLI 120G,A00,188858,Staff,9,0,30,21
1683311080121,POLI 131CR,A00,188863,Hoston; Germaine,24,0,50,26
1683311081148,POLI 133,A00,188864,Nellis; Gareth Hb,44,0,50,6
1683311082170,POLI 134D,A00,188865,Desposato; Scott,27,0,30,3
1683311083195,POLI 142A,A00,188871,Gartzke; Erik,22,0,50,28
1683311084217,POLI 142K,A00,188874,Staff,38,0,50,12
1683311085241,POLI 143,A00,188940,Gartzke; Erik,16,0,30,14
1683311086265,POLI 153,A00,188943,Staff,3,0,20,17
1683311087345,POLI 160AA,A00,188944,Staff,12,0,40,28
1683311088369,POLI 170A,A00,188945,Staff,11,0,30,19
1683311090417,PSYC 1,A00,188952,Staff,37,0,90,53
1683311091443,PSYC 2,B00,188953,Staff,20,0,35,15
1683311092470,PSYC 6,A00,188970,Staff,47,0,60,13
1683311093494,PSYC 7,A00,188973,Staff,37,0,45,8
1683311094522,PSYC 60,A01,188980,Rickard; Timothy C.,43,0,60,17
1683311095552,PSYC 70,A01,189001,Steiner; Eric Tomas,24,0,45,21
1683311096577,PSYC 100,A00,189005,Lacefield; Katharine I,0,99,120,120
1683311097600,PSYC 102,A00,189008,Staff,10,0,30,20
1683311098623,PSYC 106,B00,189026,Gorman; Michael R.,37,0,60,23
1683311099646,PSYC 114,B01,189033,Winkielman; Piotr,0,32,30,30
1683311100675,PSYC 131,A00,189036,Anagnostaras; Stephan,0,43,60,60
1683311101703,PSYC 136,A00,189041,Lowe; Angela Beth,0,7,25,25
1683311102729,PSYC 137,A00,189057,Winkielman; Piotr,0,34,25,25
1683311103753,PSYC 144,A00,189107,Wixted; John T,0,7,50,50
1683311105805,PSYC 162,A00,189142,Staff,0,8,85,85
1683311106830,PSYC 172,A00,189144,Gorman; Michael R.,0,7,30,30
1683311108884,PSYC 179,A00,189146,Lacefield; Katharine I,0,84,120,120
1683311109912,PSYC 181,A00,189147,Anagnostaras; Stephan,0,44,90,90
1683311110937,PSYC 190R,A00,189148,Barner; David A.,0,22,80,80
1683311111963,PSYC 191,A00,189275,Rickard; Timothy C.,0,7,25,25
1683311112990,PSYC 193,A00,189276,Chapman; Eddie Nathaniel,0,1,0,4
1683311114015,PSYC 193L,A01,189281,Lowe; Angela Beth,12,0,20,8
1683311114015,PSYC 193L,B01,189285,Staff,28,0,35,7
1683311115039,RELI 149,A00,187137,Rahimi; Babak,7,0,40,33
1683311116062,SE 9,A01,187315,Staff,0,2,18,18
1683311117086,SE 101B,A00,187409,Staff,24,0,30,6
1683311118109,SE 110B,A00,187444,Staff,10,0,40,30
1683311119135,SE 130B,A00,187449,Staff,31,0,40,9
1683311120165,SE 150A,A00,187516,Staff,9,0,20,11
1683311121194,SE 154,A00,187528,Staff,30,0,50,20
1683311122217,SIO 3,A01,258171,Staff,35,0,40,5
1683311123245,SIO 10,A00,187144,Cook; Geoffrey W,0,3,75,75
1683311124269,SIO 45,A00,187152,Cook; Geoffrey W,1,0,100,99
1683311125292,SIO 109R,A00,194486,Staff,0,3,20,20
1683311127350,SIO 187,A01,187233,Kacev; David,12,0,40,28
1683311128373,SOCI 1,A01,258656,Thorpe; Charles Robert,28,0,30,2
1683311128373,SOCI 1,A02,258658,Thorpe; Charles Robert,30,0,30,0
1683311128373,SOCI 1,A03,258661,Thorpe; Charles Robert,25,0,25,0
1683311128373,SOCI 1,A04,258666,Thorpe; Charles Robert,22,0,25,3
1683311128373,SOCI 1,A05,258897,Thorpe; Charles Robert,23,0,25,2
1683311128373,SOCI 1,A06,258898,Thorpe; Charles Robert,25,0,25,0
1683311129404,SOCI 30,A01,258903,Pardo Guerra; Juan Pablo,16,0,30,14
1683311130428,SOCI 102,A00,258904,Staff,9,0,25,16
1683311131452,SOCI 106,A00,258905,Staff,19,0,25,6
1683311132478,SOCI 111,A00,258907,Ribas Norris; Janet Vanesa,26,0,30,4
1683311133503,SOCI 121R,A00,258908,Pardo Guerra; Juan Pablo,11,0,30,19
1683311134527,SOCI 126,A01,203330,Staff,14,0,20,6
1683311135551,SOCI 131,A00,258909,Thorpe; Charles Robert,31,0,60,29
1683311136580,SOCI 135,A00,258910,Payne; Christine Anna,0,9,30,30
1683311137603,SOCI 157,A00,258911,Staff,12,0,30,18
1683311138630,SOCI 184,A00,258912,Staff,25,0,30,5
1683311139654,SOCI 188D,A00,258913,Staff,21,0,30,9
1683311140680,SYN 2,001,187529,Staff,9,0,16,7
1683311140680,SYN 2,002,201452,Staff,0,18,16,16
1683311140680,SYN 2,003,201469,Staff,3,0,16,13
1683311141707,SYN 100,A01,187531,Staff,0,9,20,20
1683311141707,SYN 100,B01,201491,Staff,0,12,20,20
1683311142734,TDAC 1,A00,189286,Walsh; Kim C.,3,0,20,17
1683311142734,TDAC 1,B00,189287,Harting; Carla Kelso,11,0,20,9
1683311143758,TDAC 101,A00,189300,Walsh; Kim C.,16,0,20,4
1683311143758,TDAC 101,B00,189301,Harting; Carla Kelso,18,0,20,2
1683311144781,TDAC 102,A00,189304,Basso; Beatrice,14,0,20,6
1683311145805,TDAC 108,A00,189305,Staff,18,0,20,2
1683311146830,TDDE 131,A00,189310,Staff,19,0,20,1
1683311146830,TDDE 131,B00,189314,Staff,19,0,20,1
1683311146830,TDDE 131,C00,189315,Staff,48,0,50,2
1683311146830,TDDE 131,D00,189316,Staff,14,0,15,1
1683311146830,TDDE 131,E00,204841,Staff,20,0,20,0
1683311147854,TDGE 10,A00,189289,Staff,30,0,50,20
1683311147854,TDGE 10,B00,189290,Havis; Allan,2,0,50,48
1683311148878,TDGE 11,A00,189291,Fulton; Julia,0,3,50,50
1683311148878,TDGE 11,B00,189292,Staff,20,0,25,5
1683311148878,TDGE 11,C00,260270,Staff,0,0,0,0
1683311149903,TDGE 25,A00,189294,Staff,3,0,20,17
1683311150930,TDGE 124,A00,189318,Fulton; Julia,0,8,50,50
1683311151954,TDGE 125,A00,189319,Staff,13,0,25,12
1683311151954,TDGE 125,B00,189320,Staff,23,0,25,2
1683311152979,TDGE 127,A00,189322,Havis; Allan,0,0,50,50
1683311154003,TDHT 101,A00,189323,Staff,18,0,25,7
1683311154003,TDHT 101,B00,189324,Staff,25,0,25,0
1683311155030,TDHT 102,A00,189325,Staff,49,0,50,1
1683311156054,TDMV 1,A00,189295,Arcidiacono; Kristin,20,0,30,10
1683311156054,TDMV 1,B00,189296,Caligagan; Maria T.,24,0,30,6
1683311157080,TDMV 2,A00,189297,Sammartano; Tonnie,28,0,30,2
1683311157080,TDMV 2,B00,189299,Arcidiacono; Kristin,24,0,30,6
1683311158105,TDMV 3,A00,204998,Rincon; Alicia,22,0,30,8
1683311159132,TDMV 120,A00,189458,Sammartano; Tonnie,28,0,30,2
1683311160158,TDMV 138,A00,189541,Jun; Grace Shin Hae,22,0,40,18
1683311161185,TDMV 142,A00,189717,Caligagan; Tony,23,0,30,7
1683311161185,TDMV 142,B00,189718,Caligagan; Maria T.,25,0,30,5
1683311162209,TMC 2,A01,187533,Staff,25,0,25,0
1683311162209,TMC 2,A02,187534,Staff,25,0,25,0
1683311163235,USP 1,A01,187536,Kwak; Nancy,0,16,25,25
1683311164257,USP 5,A01,187538,Staff,9,0,25,16
1683311165281,USP 101,A00,199253,Staff,0,4,0,0
1683311166305,USP 124,A00,187562,Boomhower; Matthew Charles,1,0,30,29
1683311167329,USP 138,A00,187582,Staff,20,0,25,5
1683311168356,USP 152,A01,187597,Staff,4,0,25,21
1683311169382,USP 153,A00,187598,Staff,19,0,25,6
1683311170409,USP 168,A00,187607,Kwak; Nancy,2,0,5,3
1683311171435,USP 173,A00,187619,Staff,4,0,25,21
1683311172461,USP 181,A00,187638,Staff,0,0,25,25
1683311173486,VIS 103,A00,187650,Cruz; Edwin Teddy,23,0,75,52
1683311174512,VIS 110D,A00,187669,Staff,12,0,22,10
1683311175537,VIS 127C,A00,187720,Shen; Kuiyi,68,0,146,78
1683311176564,VIS 149,A00,187731,Yoldas; Pinar,0,14,22,22
1683311177588,VIS 151,A01,188091,Staff,22,0,34,12
1683311177588,VIS 151,A02,188092,Staff,11,0,34,23
1683311178612,VIS 160B,A00,188093,Stalbaum; Brett,0,0,10,10
1683311180658,WCWP 10B,A00,201720,Staff,10,0,15,5
1683311180658,WCWP 10B,B00,201722,Staff,8,0,15,7
1683311181682,WCWP 100,A00,201725,Gagnon; Jeffrey C,0,0,2,2
1683311181682,WCWP 100,B00,201727,Staff,0,4,15,15
1683311184781,ANBI 133,A00,258401,Wilder; Linnea Lorene,34,0,40,6
1683311185806,ANBI 140,A00,258395,Hrvoj Mihic; Branka,18,0,25,7
1683311186830,ANSC 120,A00,258402,Bialecki; Jon Anthony,27,0,40,13
1683311187858,ANSC 144,A00,258400,Staff,14,0,40,26
1683311189916,ANSC 166,A00,258396,Parish; Steven Martin,157,0,175,18
1683311190997,ANSC 180,A00,193533,Staff,9,0,20,11
1683311192024,ANSC 188,A00,258397,Jassal; Aftab,33,0,40,7
1683311193052,ANTH 3,A01,258316,Staff,23,0,30,7
1683311194075,ANTH 5,A00,258394,Semendeferi; Ekaterini,16,0,20,4
1683311195103,ANTH 21,A01,258331,Staff,9,0,40,31
1683311196130,ANTH 103,A00,258398,Varma; Saiba,15,0,25,10
1683311197158,AWP 10,001,202034,Staff,0,0,0,0
1683311197158,AWP 10,002,202035,Staff,0,0,0,0
1683311197158,AWP 10,003,202036,Staff,0,0,0,0
1683311197158,AWP 10,004,202037,Staff,0,0,0,0
1683311197158,AWP 10,005,202038,Staff,0,0,0,0
1683311197158,AWP 10,006,202039,Staff,0,0,0,0
1683311197158,AWP 10,007,202040,Staff,0,0,0,0
1683311197158,AWP 10,008,202041,Staff,0,0,0,0
1683311197158,AWP 10,009,202042,Staff,0,0,0,0
1683311197158,AWP 10,010,202043,Staff,0,0,0,0
1683311197158,AWP 10,011,202044,Staff,0,0,0,0
1683311197158,AWP 10,012,202045,Staff,0,0,0,0
1683311197158,AWP 10,013,202046,Staff,0,0,0,0
1683311197158,AWP 10,014,202047,Staff,0,0,0,0
1683311197158,AWP 10,015,202048,Staff,0,0,0,0
1683311197158,AWP 10,016,202049,Staff,0,0,0,0
1683311197158,AWP 10,017,202050,Staff,0,0,0,0
1683311197158,AWP 10,018,202051,Staff,0,0,0,0
1683311197158,AWP 10,019,202052,Staff,0,0,0,0
1683311197158,AWP 10,020,202053,Staff,0,0,0,0
1683311197158,AWP 10,021,202054,Staff,0,0,0,0
1683311197158,AWP 10,022,202055,Staff,0,0,0,0
1683311197158,AWP 10,023,202056,Staff,0,0,0,0
1683311197158,AWP 10,024,202057,Staff,0,0,0,0
1683311197158,AWP 10,025,202058,Staff,0,0,0,0
1683311197158,AWP 10,026,202059,Staff,0,0,0,0
1683311198184,AWP 102,001,202032,Staff,0,0,0,0
1683311198184,AWP 102,002,202033,Staff,0,0,0,0
1683311199209,BENG 100,A01,254234,Taylor Amos; Alyssa C,31,0,40,9
1683311200241,BENG 196,001,270013,Engler; Adam J.,9999,0,9999,0
1683311201269,BICD 100R,A01,202018,Smith; Laurie,0,7,32,32
1683311201269,BICD 100R,A02,202019,Smith; Laurie,0,2,32,32
1683311201269,BICD 100R,A03,202020,Smith; Laurie,0,1,32,32
1683311201269,BICD 100R,A04,202021,Smith; Laurie,8,0,32,24
1683311201269,BICD 100R,A05,202022,Smith; Laurie,12,0,32,20
1683311202293,BICD 136,A01,193242,Gustafson-Brown; Cindy,0,2,32,32
1683311202293,BICD 136,A02,193244,Gustafson-Brown; Cindy,15,0,32,17
1683311203317,BIEB 102,A01,193249,Butler; Shannon Rhey,0,2,32,32
1683311203317,BIEB 102,A02,193251,Butler; Shannon Rhey,0,0,32,32
1683311203317,BIEB 102,A03,193253,Butler; Shannon Rhey,0,1,32,32
1683311203317,BIEB 102,A04,193255,Butler; Shannon Rhey,17,0,32,15
1683311203317,BIEB 102,A05,193265,Butler; Shannon Rhey,26,0,32,6
1683311203317,BIEB 102,A06,193269,Butler; Shannon Rhey,16,0,32,16
1683311205369,BIEB 150,A01,193274,Staff,0,0,32,32
1683311205369,BIEB 150,A02,193285,Staff,24,0,32,8
1683311206394,BIEB 194,A00,193286,Kurle; Carolyn M.,22,0,32,10
1683311207424,BILD 1,A01,192291,Staff,16,0,32,16
1683311207424,BILD 1,A02,192292,Staff,30,0,32,2
1683311207424,BILD 1,B01,192520,Reuther; Keefe,0,1,0,0
1683311207424,BILD 1,B02,192532,Reuther; Keefe,0,1,0,0
1683311208450,BILD 3,A01,192556,Butler; Shannon Rhey,0,0,32,32
1683311208450,BILD 3,A02,192581,Butler; Shannon Rhey,5,0,32,27
1683311208450,BILD 3,A03,192611,Butler; Shannon Rhey,23,0,32,9
1683311208450,BILD 3,A04,192612,Butler; Shannon Rhey,25,0,32,7
1683311208450,BILD 3,A05,192613,Butler; Shannon Rhey,27,0,32,5
1683311208450,BILD 3,A06,192679,Butler; Shannon Rhey,27,0,32,5
1683311208450,BILD 3,A07,192682,Butler; Shannon Rhey,22,0,32,10
1683311209474,BILD 4,A01,192836,Reuther; Keefe,1,0,24,23
1683311209474,BILD 4,A02,193044,Reuther; Keefe,4,0,24,20
1683311210502,BILD 10,A01,193142,Gustafson-Brown; Cindy,31,0,32,1
1683311210502,BILD 10,A02,193149,Gustafson-Brown; Cindy,31,0,32,1
1683311211526,BIMM 100,A01,193301,Staff,0,6,32,32
1683311211526,BIMM 100,A02,193312,Staff,0,5,32,32
1683311211526,BIMM 100,A03,193323,Staff,0,8,32,32
1683311212553,BIMM 101,A01,193329,McDonnell; Lisa Marie,0,3,24,24
1683311212553,BIMM 101,A02,193339,McDonnell; Lisa Marie,0,2,24,24
1683311212553,BIMM 101,B01,193354,McDonnell; Lisa Marie,0,3,24,24
1683311212553,BIMM 101,B02,193357,McDonnell; Lisa Marie,0,3,24,24
1683311213581,BIMM 110,A01,193377,Tat; John,0,11,32,32
1683311213581,BIMM 110,A02,193378,Tat; John,1,9,32,31
1683311214606,BIMM 120,A01,206116,Staff,0,0,32,32
1683311214606,BIMM 120,A02,206117,Staff,8,0,32,24
1683311214606,BIMM 120,A03,206121,Staff,21,0,32,11
1683311215630,BIPN 100,A01,193393,Park; Ji Young,0,14,32,32
1683311215630,BIPN 100,A02,193402,Park; Ji Young,0,12,32,32
1683311215630,BIPN 100,A03,193413,Park; Ji Young,0,14,32,32
1683311215630,BIPN 100,A04,193414,Park; Ji Young,0,13,32,32
1683311216654,BIPN 102,A01,193429,Staff,0,0,32,32
1683311216654,BIPN 102,A02,193438,Staff,22,0,32,10
1683311217678,BIPN 106,A01,193450,Reyes Gonzalez; Catalina,0,2,40,40
1683311218703,BIPN 134,A01,193465,Cooke; James Edward,0,0,32,32
1683311218703,BIPN 134,A02,193474,Cooke; James Edward,27,0,32,5
1683311218703,BIPN 134,A03,193485,Cooke; James Edward,29,0,32,3
1683311218703,BIPN 134,A04,193486,Cooke; James Edward,21,0,32,11
1683311218703,BIPN 134,A05,193491,Cooke; James Edward,31,0,32,1
1683311218703,BIPN 134,A06,193501,Cooke; James Edward,30,0,32,2
1683311218703,BIPN 134,A07,193510,Cooke; James Edward,29,0,32,3
1683311220749,BISP 194,A00,222522,Staff,16,0,32,16
1683311221774,CAT 124,A01,202407,Staff,20,0,25,5
1683311222799,CAT 125,A00,202408,Marchisotto; Jennifer Anne,4,0,20,16
1683311223824,CAT 125R,A00,202409,Smith; Lauryn Alissa,0,11,20,20
1683311223824,CAT 125R,B00,202410,Morales; Celeste Georgianna,0,11,20,20
1683311223824,CAT 125R,C00,202411,Irwin; Matthew Joseph,0,10,20,20
1683311224848,CENG 15,A01,204712,Yang; Kesong,0,1,0,0
1683311225877,CENG 114,A00,202070,Jahed Motlagh; Zeinab,5,0,20,15
1683311226901,CGS 105,A00,185477,Wesling; Megan E.,24,0,40,16
1683311227928,CGS 106,A00,185494,Staff,13,0,22,9
1683311228952,CGS 108,A00,185495,Staff,14,0,20,6
1683311229979,CGS 114,A00,185496,Staff,13,0,18,5
1683311231003,CGS 119,A00,185501,Staff,15,0,20,5
1683311232030,CGS 120,A00,185511,Staff,13,0,20,7
1683311233055,CHEM 4,A01,184675,Bussey; Thomas J,96,0,100,4
1683311234079,CHEM 6A,A01,184677,Staff,35,0,60,25
1683311235102,CHEM 6B,A01,184679,Staff,65,0,100,35
1683311236130,CHEM 6C,A01,184681,Bussey; Thomas J,1,0,50,49
1683311236130,CHEM 6C,A02,184682,Bussey; Thomas J,34,0,50,16
1683311237154,CHEM 40A,A01,184684,Albizati; Kim F.,37,0,100,63
1683311238178,CHEM 40B,A01,184686,Albizati; Kim F.,0,20,100,100
1683311239202,CHEM 41B,A01,184690,Staff,52,0,100,48
1683311240226,COGS 3,A01,184715,Boyle; Mary E. T.,0,25,40,40
1683311241254,COGS 14B,A01,185172,Staff,0,15,38,38
1683311242279,COGS 18,A01,184736,Staff,19,0,80,61
1683311243303,COGS 100,A01,184932,Staff,0,5,73,73
1683311244329,COGS 101A,A01,184935,Staff,0,38,30,30
1683311245353,COGS 101B,A01,184944,Staff,0,2,30,30
1683311246377,COGS 101C,A01,184946,Staff,0,12,30,30
1683311247402,COGS 102A,A01,184951,Johnson; Christine M.,2,0,40,38
1683311248425,COGS 107B,A01,184953,Mooshagian; Eric Frederick,0,50,40,40
1683311249450,COGS 118B,A01,184959,Gupta; Anjum,0,48,40,40
1683311250477,COGS 153,A00,184961,Staff,0,15,30,30
1683311251505,COGS 177,A00,184962,Staff,0,21,30,30
1683311252529,COGS 187A,A01,184969,Boyle; Mary E. T.,0,17,40,40
1683311253555,COMM 10,A01,185174,Staff,0,5,25,25
1683311253555,COMM 10,A02,185189,Staff,0,5,25,25
1683311253555,COMM 10,A03,269821,Staff,0,0,0,0
1683311254579,COMM 100B,A01,185475,Staff,0,0,0,2
1683311254579,COMM 100B,A02,185476,Staff,14,0,25,11
1683311255603,COMM 100C,A01,185314,Staff,1,0,25,24
1683311255603,COMM 100C,A02,185327,Staff,19,0,25,6
1683311256627,COMM 110M,A00,185349,Staff,2,0,40,38
1683311257651,COMM 113T,A00,185352,Staff,25,0,40,15
1683311258675,COMM 114I,A00,185353,Staff,33,0,40,7
1683311259699,COMM 131,A00,185354,Staff,19,0,30,11
1683311260727,CSE 8A,A50,185358,Cao; Yingjun,0,46,10,10
1683311261753,CSE 8B,A01,185362,Staff,1,47,50,49
1683311262777,CSE 11,A01,185416,Cao; Yingjun,0,92,10,10
1683311263801,CSE 20,A01,185445,Briones; Jor-el Thomas Caparas,5,0,25,20
1683311264828,CSE 21,A01,185447,Staff,10,0,50,40
1683311265853,CSE 101,A01,185451,Staff,0,12,50,50
1683311265853,CSE 101,B01,185453,Jones; Miles E,0,11,50,50
1683311267905,CSE 141,A01,185458,Eldon; John,20,0,100,80
1683311268929,CSE 141L,A01,185461,Eldon; John,12,0,100,88
1683311269956,CSE 142,A01,185463,Staff,35,0,60,25
1683311269956,CSE 142,B01,201355,Staff,0,6,60,60
1683311270980,CSE 142L,A01,185470,Staff,35,0,60,25
1683311270980,CSE 142L,B01,201417,Staff,0,5,60,60
1683311272006,CSE 190,A00,201433,Staff,32,0,49,17
1683311273034,DOC 1,A01,259136,Strom; Megan C.,8,0,15,7
1683311273034,DOC 1,A02,259137,Strom; Megan C.,14,0,15,1
1683311273034,DOC 1,A03,259138,Strom; Megan C.,14,0,15,1
1683311273034,DOC 1,A04,259139,Strom; Megan C.,14,0,15,1
1683311274060,DOC 100D,A00,259140,Pass; Natalye Joann,17,0,25,8
1683311275083,DSGN 1,A01,184749,Rill; Bryan,0,25,30,30
1683311276106,DSGN 100,A01,185168,Staff,0,2,25,25
1683311277129,ECE 5,A01,185626,Morris; Karcher William,0,10,0,0
1683311278153,ECE 101,A01,185628,Staff,17,0,70,53
1683311279174,ECE 107,A01,185635,Baghdadchi; Saharnaz,0,0,20,20
1683311279174,ECE 107,A02,185638,Baghdadchi; Saharnaz,4,0,20,16
1683311280197,ECE 148,A01,185647,Silberman; Jack,0,0,16,16
1683311281221,ECON 1,A01,185537,Crane; Meredith Helen,54,0,70,16
1683311282245,ECON 3,A01,185549,Crane; Meredith Helen,33,0,70,37
1683311283269,ECON 4,A01,203354,Anderson; John Charles,0,4,10,10
1683311284296,ECON 100A,A01,185574,Staff,0,4,40,40
1683311285323,ECON 100B,A01,185576,Staff,0,22,40,40
1683311286349,ECON 100C,A01,185589,Newhouse; Herbert S,30,0,70,40
1683311287374,ECON 105,A00,185608,Vespa; Emanuel Ignacio,19,0,35,16
1683311288397,ECON 109,A01,185610,Shishkin; Denis,10,0,35,25
1683311289421,ECON 110A,A01,185612,Staff,11,0,40,29
1683311290443,ECON 120A,A01,185615,Staff,20,0,40,20
1683311291467,ECON 120C,A01,185617,Sun; Yixiao,0,20,70,70
1683311292491,ECON 144,A00,203346,Squires; Dale E,3,0,35,32
1683311293520,ECON 171,A01,203349,Newhouse; Herbert S,0,1,35,35
1683311294602,ECON 173A,A01,185621,Toda; Alexis Akira,21,0,35,14
1683311295628,EDS 25,A01,202413,Staff,0,1,0,0
1683311295628,EDS 25,A02,202414,Staff,0,1,0,0
1683311295628,EDS 25,A03,202415,Staff,0,0,0,0
1683311295628,EDS 25,A04,202416,Staff,0,1,0,0
1683311295628,EDS 25,A05,202439,Staff,0,0,0,0
1683311295628,EDS 25,A06,202440,Staff,0,0,0,0
1683311295628,EDS 25,B01,202631,Staff,0,0,0,0
1683311295628,EDS 25,B02,202632,Staff,0,0,0,0
1683311295628,EDS 25,B03,202639,Staff,0,0,0,0
1683311295628,EDS 25,B04,202640,Staff,0,0,0,0
1683311295628,EDS 25,B05,202643,Staff,0,0,0,0
1683311295628,EDS 25,B06,202644,Staff,0,0,0,0
1683311296652,EDS 38,A01,202659,Black; Alison Michelle,24,0,25,1
1683311297676,EDS 115,A00,202652,Staff,17,0,30,13
1683311298699,EDS 125,A00,202649,Staff,14,0,30,16
1683311299723,EDS 126,A01,203332,Staff,30,0,30,0
1683311300750,EDS 139,A00,202838,Staff,17,0,25,8
1683311301776,EDS 146,A01,202655,Staff,15,0,25,10
1683311302801,ENG 15,A00,185667,Staff,0,1,0,0
1683311302801,ENG 15,B00,185672,Staff,0,0,0,0
1683311302801,ENG 15,C00,185675,Staff,0,0,0,0
1683311302801,ENG 15,D00,185682,Staff,0,0,0,0
1683311302801,ENG 15,E00,185684,Staff,0,0,0,0
1683311303826,ETHN 103,A00,185710,Staff,0,3,35,35
1683311304851,ETHN 103A,A00,199228,Man; Simeon S,2,0,9,7
1683311305878,ETHN 109,A00,185711,Staff,18,0,35,17
1683311306900,ETHN 142,A00,185726,Staff,0,4,30,30
1683311307924,ETHN 163J,A00,199229,Man; Simeon S,5,0,8,3
1683311308948,ETHN 168,A00,185727,Staff,8,0,10,2
1683311309972,ETHN 182,A00,185728,Staff,1,0,35,34
1683311310995,ETHN 183,A00,185737,Staff,8,0,18,10
1683311312019,GLBH 111,A01,209361,Burgos; Jose L.,0,0,0,0
1683311314070,HIEU 104,A00,185792,Staff,16,0,20,4
1683311315093,HIEU 115,A00,185800,Staff,1,0,20,19
1683311316116,HIEU 128,A00,185801,Staff,0,7,20,20
1683311317138,HIEU 147,A00,185802,Staff,16,0,20,4
1683311318161,HIEU 154,A00,185823,Staff,12,0,20,8
1683311319187,HILA 102,A00,185826,Staff,13,0,20,7
1683311320213,HILD 2C,A01,185778,Staff,0,12,20,20
1683311321242,HILD 7B,A01,185780,Kwak; Nancy,0,15,32,32
1683311321242,HILD 7B,A02,185781,Kwak; Nancy,0,18,32,32
1683311322269,HILD 30,A01,185791,Staff,14,0,20,6
1683311323292,HISC 119,A00,185830,Golan; Tal,0,9,20,20
1683311324318,HITO 156GS,A00,185831,Patterson; Patrick H.,0,0,0,23
1683311325342,HIUS 103,A00,185832,Man; Simeon S,0,6,20,20
1683311326365,HIUS 117,A00,185836,Kwak; Nancy,2,0,20,18
1683311327391,HIUS 125,A00,185840,Man; Simeon S,0,0,23,23
1683311328418,HIUS 149,A00,185845,Staff,0,0,20,20
1683311329448,HUM 3,A01,185882,Zavodny; Tatiana Sophia,0,6,50,50
1683311329448,HUM 3,B01,185899,Caldwell; Michael Alan,0,19,50,50
1683311330471,HUM 3GS,A00,185900,Patterson; Patrick H.,0,0,0,23
1683311331500,HUM 4,A01,185938,Zroka; Amy Liane,31,0,50,19
1683311331500,HUM 4,B01,185956,Watkins; Eric,0,2,50,50
1683311331500,HUM 4,B02,202209,Watkins; Eric,0,2,50,50
1683311331500,HUM 4,B03,202210,Watkins; Eric,0,0,50,50
1683311332527,HUM 5,A01,185958,West; Geoffrey Scott,4,0,50,46
1683311332527,HUM 5,A02,202215,West; Geoffrey Scott,0,0,50,50
1683311333550,INTL 190,A00,185959,Gagnon; Jeffrey C,0,0,0,9
1683311333550,INTL 190,B00,185960,Lettieri; Michael Joseph,0,0,0,1
1683311334574,JAPN 180,A00,254509,Staff,5,1,30,25
1683311335598,LATI 10,A01,202853,Kennemore; Amy Michelle,5,0,35,30
1683311335598,LATI 10,A02,202854,Kennemore; Amy Michelle,1,0,35,34
1683311335598,LATI 10,A03,270054,Kennemore; Amy Michelle,30,0,30,0
1683311336625,LATI 180,A00,202855,Kennemore; Amy Michelle,11,0,20,9
1683311337652,LAWS 101,A00,201767,Golan; Tal,0,7,40,40
1683311338675,LIFR 1C,A00,185961,Staff,6,0,20,14
1683311339699,LIFR 1CX,A00,185962,Staff,7,0,20,13
1683311340723,LIFR 1D,A00,185963,Staff,9,0,20,11
1683311341747,LIFR 1DX,A00,185964,Staff,9,0,20,11
1683311342770,LIGN 101,A01,186039,Staff,43,0,50,7
1683311343793,LIGN 165,A00,186040,Staff,18,0,50,32
1683311344816,LTCS 108,A00,186041,Staff,6,0,10,4
1683311345839,LTCS 119,A00,186042,Staff,16,0,20,4
1683311346865,LTCS 130,A00,186043,Wesling; Megan E.,15,0,25,10
1683311348916,LTEA 138,A00,186119,Staff,14,0,40,26
1683311349940,LTEN 124,A00,186148,Staff,6,0,25,19
1683311350962,LTEN 178,A00,186149,Staff,7,0,15,8
1683311351986,LTEN 181,A00,186150,Blanco; John D,33,0,40,7
1683311353013,LTWL 120,A00,186160,Staff,20,0,25,5
1683311354038,LTWL 165,A00,186161,Staff,22,0,25,3
1683311355067,LTWR 100,A00,186162,Staff,0,4,15,15
1683311356089,LTWR 102,A00,186163,Doller; Ben,5,0,15,10
1683311357113,MAE 8,A01,186412,Staff,0,0,0,0
1683311358137,MAE 30B,A00,186445,Bahadori; Mohammad Yousef,83,0,100,17
1683311359161,MAE 40,A00,186592,Bewley; Thomas R,9,0,50,41
1683311360187,MAE 101B,A00,186593,Bahadori; Mohammad Yousef,81,0,100,19
1683311361211,MAE 105,A00,186594,Bandaru; Prabhakar,12,0,50,38
1683311362238,MAE 107,A00,186599,Pham; Hieu Tan,0,6,120,120
1683311363263,MAE 148,A01,186660,Silberman; Jack,3,0,16,13
1683311364289,MATH 10A,A01,188095,Staff,0,7,35,35
1683311365317,MATH 10B,A01,188097,Bowers; Adam R.,0,11,30,30
1683311365317,MATH 10B,A02,188099,Bowers; Adam R.,0,11,30,30
1683311365317,MATH 10B,B01,188104,Bowers; Adam R.,0,10,30,30
1683311365317,MATH 10B,B02,188106,Bowers; Adam R.,0,10,30,30
1683311366341,MATH 10C,A01,188111,Staff,0,18,30,30
1683311366341,MATH 10C,A02,188127,Staff,0,17,30,30
1683311366341,MATH 10C,A03,188131,Staff,0,18,30,30
1683311366341,MATH 10C,B01,188218,Staff,20,0,30,10
1683311366341,MATH 10C,B02,188244,Staff,13,0,30,17
1683311366341,MATH 10C,B03,188277,Staff,16,0,30,14
1683311367365,MATH 18,A01,188344,Bach; Quang Tran,18,0,30,12
1683311367365,MATH 18,A02,188345,Bach; Quang Tran,11,0,30,19
1683311367365,MATH 18,B01,188353,Bach; Quang Tran,10,0,30,20
1683311367365,MATH 18,B02,188354,Bach; Quang Tran,20,0,30,10
1683311368392,MATH 20A,A01,188374,Staff,13,0,35,22
1683311369420,MATH 20B,A01,188382,Ohm; Ko Woon,6,0,30,24
1683311369420,MATH 20B,A02,188383,Ohm; Ko Woon,23,0,30,7
1683311369420,MATH 20B,B01,188385,Ohm; Ko Woon,7,0,30,23
1683311369420,MATH 20B,B02,188392,Ohm; Ko Woon,22,0,30,8
1683311370445,MATH 20C,A01,188394,Harel; Guershon,10,0,30,20
1683311370445,MATH 20C,A02,188395,Harel; Guershon,14,0,30,16
1683311370445,MATH 20C,B01,188404,Harel; Guershon,5,0,30,25
1683311370445,MATH 20C,B02,188405,Harel; Guershon,19,0,30,11
1683311371470,MATH 20D,A01,188414,Hammock; Frances H,0,1,30,30
1683311371470,MATH 20D,A02,188415,Hammock; Frances H,4,0,30,26
1683311371470,MATH 20D,B01,188447,Hammock; Frances H,2,0,30,28
1683311371470,MATH 20D,B02,188486,Hammock; Frances H,8,0,30,22
1683311372494,MATH 20E,A01,188649,Staff,21,0,30,9
1683311372494,MATH 20E,A02,188650,Staff,23,0,30,7
1683311372494,MATH 20E,A03,188673,Staff,0,0,30,30
1683311373522,MATH 102,A01,188675,Staff,0,35,35,35
1683311374546,MATH 103B,A01,188681,Staff,4,0,35,31
1683311374546,MATH 103B,B01,188692,Staff,6,0,35,29
1683311375570,MATH 109,A01,188695,Salehi Golsefidy; Alireza,25,0,35,10
1683311375570,MATH 109,A02,188696,Salehi Golsefidy; Alireza,27,0,35,8
1683311376594,MATH 120A,A01,188698,Eggers; John Dietrich,6,0,35,29
1683311377619,MATH 142B,A01,188736,Ioana; Adrian,0,2,30,30
1683311377619,MATH 142B,A02,188741,Ioana; Adrian,0,1,30,30
1683311377619,MATH 142B,A03,188743,Ioana; Adrian,1,3,30,29
1683311378645,MATH 168A,A01,188790,Staff,0,9,35,35
1683311379670,MATH 170A,A01,188803,Nie; Jiawang,0,2,35,35
1683311379670,MATH 170A,A02,188811,Nie; Jiawang,0,0,35,35
1683311379670,MATH 170A,A03,188814,Nie; Jiawang,1,0,35,34
1683311379670,MATH 170A,A04,188815,Nie; Jiawang,13,0,35,22
1683311380697,MATH 193B,A01,188817,Staff,0,0,35,35
1683311380697,MATH 193B,A02,188818,Staff,5,0,35,30
1683311381719,MGT 4,A01,202857,Anderson; John Charles,62,0,80,18
1683311382743,MGT 12,A00,202858,Lindenberger; Wade Douglas,43,0,90,47
1683311383767,MGT 18,A00,202859,Staff,74,0,90,16
1683311384790,MGT 18GS,A00,202860,McKay; Michael J,13,0,28,15
1683311385818,MGT 45,A00,202861,Pecore; Joseph P.,14,0,90,76
1683311386846,MGT 100,A00,202863,Yavorsky; Daniel Ryan,28,0,90,62
1683311387873,MGT 103,A00,202864,Ehrich; Kristine R,0,16,90,90
1683311388895,MGT 112,A00,202865,Ehrich; Kristine R,15,0,90,75
1683311389923,MGT 121A,A00,202868,Staff,0,19,0,0
1683311390949,MGT 131B,A00,202869,Anderson; John Charles,59,0,90,31
1683311391972,MGT 136,A00,202871,Lindenberger; Wade Douglas,84,0,90,6
1683311393001,MGT 164,A00,202873,Staff,0,69,90,90
1683311394025,MGT 164GS,A00,202874,McKay; Mary A,13,0,28,15
1683311395051,MGT 180,A00,202875,Staff,0,51,90,90
1683311396078,MMW 11R,A01,205019,Herbst; Matthew,3,0,30,27
1683311396078,MMW 11R,A02,205026,Herbst; Matthew,29,0,30,1
1683311397103,MMW 15,A01,193512,Chang; Edmond Yi-Teh,0,9,28,28
1683311397103,MMW 15,A02,193513,Chang; Edmond Yi-Teh,0,5,28,28
1683311397103,MMW 15,A03,193514,Chang; Edmond Yi-Teh,0,5,28,28
1683311397103,MMW 15,A04,193515,Chang; Edmond Yi-Teh,0,5,28,28
1683311397103,MMW 15,A05,193516,Chang; Edmond Yi-Teh,0,4,28,28
1683311397103,MMW 15,A06,193517,Chang; Edmond Yi-Teh,0,5,28,28
1683311397103,MMW 15,B01,193519,Chang; Edmond Yi-Teh,0,4,28,28
1683311397103,MMW 15,B02,193520,Chang; Edmond Yi-Teh,0,5,28,28
1683311397103,MMW 15,B03,193521,Chang; Edmond Yi-Teh,0,4,28,28
1683311397103,MMW 15,B04,193522,Chang; Edmond Yi-Teh,0,4,28,28
1683311397103,MMW 15,B05,193523,Chang; Edmond Yi-Teh,0,5,28,28
1683311397103,MMW 15,B06,193524,Chang; Edmond Yi-Teh,0,4,28,28
1683311398198,MMW 122,A01,193526,Rahimi; Babak,0,14,28,28
1683311398198,MMW 122,A02,193527,Rahimi; Babak,0,14,28,28
1683311398198,MMW 122,A03,193528,Rahimi; Babak,0,0,0,0
1683311398198,MMW 122,A04,193529,Rahimi; Babak,0,0,0,0
1683311399223,MUS 1A,A01,186663,Staff,0,20,35,35
1683311400247,MUS 4,A01,186715,Staff,0,12,35,35
1683311401274,MUS 5R,A01,186796,Dubnov; Shlomo,0,17,35,35
1683311402301,MUS 6,A01,186798,Staff,0,3,25,25
1683311403329,MUS 7,A01,186830,Staff,12,0,35,23
1683311404353,MUS 8,A01,186930,Staff,0,26,35,35
1683311405375,MUS 15,A01,186932,Staff,0,15,35,35
1683311405375,MUS 15,B01,186934,Staff,0,15,35,35
1683311406402,MUS 80,A00,186935,Staff,2,0,20,18
1683311406402,MUS 80,B00,186936,Staff,25,0,25,0
1683311407430,NANO 11,A00,204702,Lipomi; Darren John,0,0,0,0
1683311408454,NANO 15,A01,204709,Yang; Kesong,0,1,0,0
1683311409482,NANO 114,A00,202069,Jahed Motlagh; Zeinab,3,0,10,7
1683311410507,PHIL 1,A00,186955,Grush; Rick Scott,32,0,40,8
1683311411534,PHIL 10,A01,186973,Grush; Rick Scott,28,0,35,7
1683311411534,PHIL 10,A02,186974,Grush; Rick Scott,33,0,35,2
1683311412558,PHIL 13,A01,186976,Staff,7,0,35,28
1683311412558,PHIL 13,A02,186977,Staff,16,0,35,19
1683311413582,PHIL 14,A01,186979,Staff,31,0,35,4
1683311413582,PHIL 14,A02,186986,Staff,32,0,35,3
1683311414609,PHIL 28,A01,186988,Staff,16,0,30,14
1683311414609,PHIL 28,A02,186989,Staff,1,0,30,29
1683311414609,PHIL 28,A03,186990,Staff,9,0,30,21
1683311414609,PHIL 28,A04,186991,Staff,26,0,30,4
1683311415636,PHIL 120,A00,186997,Staff,23,0,40,17
1683311416659,PHIL 137,A00,187003,Staff,9,0,40,31
1683311417683,PHIL 150,A00,187015,Staff,47,0,70,23
1683311418707,PHIL 167,A00,187021,Lamey; Andy M.,35,0,40,5
1683311419734,PHIL 174,A01,202226,Staff,17,0,20,3
1683311419734,PHIL 174,A02,202235,Staff,20,0,20,0
1683311420761,PHIL 191A,A00,258918,Staff,0,0,1,1
1683311421788,PHYS 1A,A00,187028,Staff,27,0,60,33
1683311422816,PHYS 1AL,001,187036,Staff,3,0,30,27
1683311422816,PHYS 1AL,002,187049,Staff,18,0,30,12
1683311423839,PHYS 1B,A00,187058,Staff,23,0,60,37
1683311424866,PHYS 1BL,001,187064,Staff,0,0,30,30
1683311424866,PHYS 1BL,002,187070,Staff,6,0,30,24
1683311425893,PHYS 1C,A00,187082,Staff,31,0,120,89
1683311426918,PHYS 1CL,001,187088,Staff,0,9,30,30
1683311426918,PHYS 1CL,002,187089,Staff,0,2,30,30
1683311426918,PHYS 1CL,009,262693,Staff,11,0,30,19
1683311427945,PHYS 2B,A01,187097,Staff,54,0,115,61
1683311428970,PHYS 2C,A01,187099,Staff,67,0,115,48
1683311429995,PHYS 2CL,A01,187101,Staff,5,0,28,23
1683311429995,PHYS 2CL,A02,187102,Staff,15,0,28,13
1683311431022,PHYS 2D,A01,187123,Shotwell; Brian,95,0,115,20
1683311432047,PHYS 4B,A01,187133,Grinstein; Benjamin,35,0,50,15
1683311433070,POLI 10,A00,188819,Staff,0,3,50,50
1683311434096,POLI 11,A00,188827,Staff,43,0,50,7
1683311435122,POLI 13R,A00,188828,Staff,0,1,20,20
1683311436146,POLI 27,A01,188830,Elgin; Samuel Zincke,0,1,70,70
1683311437168,POLI 30,A00,188832,Desposato; Scott,33,0,50,17
1683311438195,POLI 102F,A00,188834,Staff,3,0,40,37
1683311439219,POLI 104A,A00,188852,Staff,14,0,30,16
1683311440245,POLI 104I,A00,188853,Staff,0,6,20,20
1683311441269,POLI 110B,A00,188854,Wiens; David,7,0,20,13
1683311442293,POLI 112A,A00,188855,Wiens; David,5,0,30,25
1683311443317,POLI 117R,A00,188856,Forman; Fonna,0,11,20,20
1683311444340,POLI 118,A00,188857,Ingham; Sean,8,0,20,12
1683311445367,POLI 120G,A00,188858,Staff,9,0,30,21
1683311446391,POLI 131CR,A00,188863,Hoston; Germaine,24,0,50,26
1683311447419,POLI 133,A00,188864,Nellis; Gareth Hb,44,0,50,6
1683311448443,POLI 134D,A00,188865,Desposato; Scott,27,0,30,3
1683311449467,POLI 142A,A00,188871,Gartzke; Erik,22,0,50,28
1683311450490,POLI 142K,A00,188874,Staff,38,0,50,12
1683311451514,POLI 143,A00,188940,Gartzke; Erik,16,0,30,14
1683311452539,POLI 153,A00,188943,Staff,3,0,20,17
1683311453565,POLI 160AA,A00,188944,Staff,12,0,40,28
1683311454590,POLI 170A,A00,188945,Staff,11,0,30,19
1683311456637,PSYC 1,A00,188952,Staff,37,0,90,53
1683311457662,PSYC 2,B00,188953,Staff,20,0,35,15
1683311458686,PSYC 6,A00,188970,Staff,47,0,60,13
1683311459709,PSYC 7,A00,188973,Staff,37,0,45,8
1683311460734,PSYC 60,A01,188980,Rickard; Timothy C.,43,0,60,17
1683311461759,PSYC 70,A01,189001,Steiner; Eric Tomas,24,0,45,21
1683311462783,PSYC 100,A00,189005,Lacefield; Katharine I,0,99,120,120
1683311463811,PSYC 102,A00,189008,Staff,10,0,30,20
1683311464834,PSYC 106,B00,189026,Gorman; Michael R.,37,0,60,23
1683311465861,PSYC 114,B01,189033,Winkielman; Piotr,0,32,30,30
1683311466886,PSYC 131,A00,189036,Anagnostaras; Stephan,0,43,60,60
1683311467910,PSYC 136,A00,189041,Lowe; Angela Beth,0,7,25,25
1683311468937,PSYC 137,A00,189057,Winkielman; Piotr,0,34,25,25
1683311469961,PSYC 144,A00,189107,Wixted; John T,0,7,50,50
1683311472014,PSYC 162,A00,189142,Staff,0,8,85,85
1683311473038,PSYC 172,A00,189144,Gorman; Michael R.,0,7,30,30
1683311475086,PSYC 179,A00,189146,Lacefield; Katharine I,0,84,120,120
1683311476108,PSYC 181,A00,189147,Anagnostaras; Stephan,0,44,90,90
1683311477132,PSYC 190R,A00,189148,Barner; David A.,0,22,80,80
1683311478156,PSYC 191,A00,189275,Rickard; Timothy C.,0,7,25,25
1683311479184,PSYC 193,A00,189276,Chapman; Eddie Nathaniel,0,1,0,4
1683311480212,PSYC 193L,A01,189281,Lowe; Angela Beth,12,0,20,8
1683311480212,PSYC 193L,B01,189285,Staff,28,0,35,7
1683311481238,RELI 149,A00,187137,Rahimi; Babak,7,0,40,33
1683311482262,SE 9,A01,187315,Staff,0,2,18,18
1683311483286,SE 101B,A00,187409,Staff,24,0,30,6
1683311484312,SE 110B,A00,187444,Staff,10,0,40,30
1683311485341,SE 130B,A00,187449,Staff,31,0,40,9
1683311486369,SE 150A,A00,187516,Staff,9,0,20,11
1683311487397,SE 154,A00,187528,Staff,30,0,50,20
1683311488422,SIO 3,A01,258171,Staff,35,0,40,5
1683311489446,SIO 10,A00,187144,Cook; Geoffrey W,0,3,75,75
1683311490469,SIO 45,A00,187152,Cook; Geoffrey W,1,0,100,99
1683311491496,SIO 109R,A00,194486,Staff,0,3,20,20
1683311493544,SIO 187,A01,187233,Kacev; David,12,0,40,28
1683311494628,SOCI 1,A01,258656,Thorpe; Charles Robert,28,0,30,2
1683311494628,SOCI 1,A02,258658,Thorpe; Charles Robert,30,0,30,0
1683311494628,SOCI 1,A03,258661,Thorpe; Charles Robert,25,0,25,0
1683311494628,SOCI 1,A04,258666,Thorpe; Charles Robert,22,0,25,3
1683311494628,SOCI 1,A05,258897,Thorpe; Charles Robert,23,0,25,2
1683311494628,SOCI 1,A06,258898,Thorpe; Charles Robert,25,0,25,0
1683311495653,SOCI 30,A01,258903,Pardo Guerra; Juan Pablo,16,0,30,14
1683311496678,SOCI 102,A00,258904,Staff,9,0,25,16
1683311497704,SOCI 106,A00,258905,Staff,19,0,25,6
1683311498728,SOCI 111,A00,258907,Ribas Norris; Janet Vanesa,26,0,30,4
1683311499753,SOCI 121R,A00,258908,Pardo Guerra; Juan Pablo,11,0,30,19
1683311500780,SOCI 126,A01,203330,Staff,14,0,20,6
1683311501860,SOCI 131,A00,258909,Thorpe; Charles Robert,31,0,60,29
1683311502884,SOCI 135,A00,258910,Payne; Christine Anna,0,9,30,30
1683311503908,SOCI 157,A00,258911,Staff,12,0,30,18
1683311504933,SOCI 184,A00,258912,Staff,25,0,30,5
1683311505957,SOCI 188D,A00,258913,Staff,21,0,30,9
1683311506981,SYN 2,001,187529,Staff,9,0,16,7
1683311506981,SYN 2,002,201452,Staff,0,18,16,16
1683311506981,SYN 2,003,201469,Staff,3,0,16,13
1683311508007,SYN 100,A01,187531,Staff,0,9,20,20
1683311508007,SYN 100,B01,201491,Staff,0,12,20,20
1683311509032,TDAC 1,A00,189286,Walsh; Kim C.,3,0,20,17
1683311509032,TDAC 1,B00,189287,Harting; Carla Kelso,11,0,20,9
1683311510056,TDAC 101,A00,189300,Walsh; Kim C.,16,0,20,4
1683311510056,TDAC 101,B00,189301,Harting; Carla Kelso,18,0,20,2
1683311511083,TDAC 102,A00,189304,Basso; Beatrice,14,0,20,6
1683311512107,TDAC 108,A00,189305,Staff,18,0,20,2
1683311513132,TDDE 131,A00,189310,Staff,19,0,20,1
1683311513132,TDDE 131,B00,189314,Staff,19,0,20,1
1683311513132,TDDE 131,C00,189315,Staff,48,0,50,2
1683311513132,TDDE 131,D00,189316,Staff,14,0,15,1
1683311513132,TDDE 131,E00,204841,Staff,20,0,20,0
1683311514155,TDGE 10,A00,189289,Staff,30,0,50,20
1683311514155,TDGE 10,B00,189290,Havis; Allan,2,0,50,48
1683311515183,TDGE 11,A00,189291,Fulton; Julia,0,3,50,50
1683311515183,TDGE 11,B00,189292,Staff,20,0,25,5
1683311515183,TDGE 11,C00,260270,Staff,0,0,0,0
1683311516206,TDGE 25,A00,189294,Staff,3,0,20,17
1683311517230,TDGE 124,A00,189318,Fulton; Julia,0,8,50,50
1683311518257,TDGE 125,A00,189319,Staff,13,0,25,12
1683311518257,TDGE 125,B00,189320,Staff,23,0,25,2
1683311519281,TDGE 127,A00,189322,Havis; Allan,0,0,50,50
1683311520310,TDHT 101,A00,189323,Staff,18,0,25,7
1683311520310,TDHT 101,B00,189324,Staff,25,0,25,0
1683311521334,TDHT 102,A00,189325,Staff,49,0,50,1
1683311522359,TDMV 1,A00,189295,Arcidiacono; Kristin,20,0,30,10
1683311522359,TDMV 1,B00,189296,Caligagan; Maria T.,24,0,30,6
1683311523389,TDMV 2,A00,189297,Sammartano; Tonnie,28,0,30,2
1683311523389,TDMV 2,B00,189299,Arcidiacono; Kristin,24,0,30,6
1683311524416,TDMV 3,A00,204998,Rincon; Alicia,22,0,30,8
1683311525444,TDMV 120,A00,189458,Sammartano; Tonnie,28,0,30,2
1683311526469,TDMV 138,A00,189541,Jun; Grace Shin Hae,22,0,40,18
1683311527493,TDMV 142,A00,189717,Caligagan; Tony,23,0,30,7
1683311527493,TDMV 142,B00,189718,Caligagan; Maria T.,25,0,30,5
1683311528518,TMC 2,A01,187533,Staff,25,0,25,0
1683311528518,TMC 2,A02,187534,Staff,25,0,25,0
1683311529542,USP 1,A01,187536,Kwak; Nancy,0,16,25,25
1683311530569,USP 5,A01,187538,Staff,9,0,25,16
1683311531593,USP 101,A00,199253,Staff,0,4,0,0
1683311532621,USP 124,A00,187562,Boomhower; Matthew Charles,1,0,30,29
1683311533645,USP 138,A00,187582,Staff,20,0,25,5
1683311534670,USP 152,A01,187597,Staff,4,0,25,21
1683311535693,USP 153,A00,187598,Staff,19,0,25,6
1683311536718,USP 168,A00,187607,Kwak; Nancy,2,0,5,3
1683311537743,USP 173,A00,187619,Staff,4,0,25,21
1683311538767,USP 181,A00,187638,Staff,0,0,25,25
1683311539793,VIS 103,A00,187650,Cruz; Edwin Teddy,23,0,75,52
1683311540817,VIS 110D,A00,187669,Staff,12,0,22,10
1683311541841,VIS 127C,A00,187720,Shen; Kuiyi,68,0,146,78
1683311542865,VIS 149,A00,187731,Yoldas; Pinar,0,14,22,22
1683311543888,VIS 151,A01,188091,Staff,22,0,34,12
1683311543888,VIS 151,A02,188092,Staff,11,0,34,23
1683311544921,VIS 160B,A00,188093,Stalbaum; Brett,0,0,10,10
1683311546970,WCWP 10B,A00,201720,Staff,10,0,15,5
1683311546970,WCWP 10B,B00,201722,Staff,8,0,15,7
1683311547994,WCWP 100,A00,201725,Gagnon; Jeffrey C,0,0,2,2
1683311547994,WCWP 100,B00,201727,Staff,0,4,15,15
1683311551119,ANBI 133,A00,258401,Wilder; Linnea Lorene,34,0,40,6
1683311552145,ANBI 140,A00,258395,Hrvoj Mihic; Branka,18,0,25,7
1683311553171,ANSC 120,A00,258402,Bialecki; Jon Anthony,27,0,40,13
1683311554197,ANSC 144,A00,258400,Staff,14,0,40,26
1683311556251,ANSC 166,A00,258396,Parish; Steven Martin,157,0,175,18
1683311557276,ANSC 180,A00,193533,Staff,9,0,20,11
1683311558306,ANSC 188,A00,258397,Jassal; Aftab,33,0,40,7
1683311559330,ANTH 3,A01,258316,Staff,23,0,30,7
1683311560357,ANTH 5,A00,258394,Semendeferi; Ekaterini,16,0,20,4
1683311561384,ANTH 21,A01,258331,Staff,9,0,40,31
1683311562413,ANTH 103,A00,258398,Varma; Saiba,15,0,25,10
1683311563439,AWP 10,001,202034,Staff,0,0,0,0
1683311563439,AWP 10,002,202035,Staff,0,0,0,0
1683311563439,AWP 10,003,202036,Staff,0,0,0,0
1683311563439,AWP 10,004,202037,Staff,0,0,0,0
1683311563439,AWP 10,005,202038,Staff,0,0,0,0
1683311563439,AWP 10,006,202039,Staff,0,0,0,0
1683311563439,AWP 10,007,202040,Staff,0,0,0,0
1683311563439,AWP 10,008,202041,Staff,0,0,0,0
1683311563439,AWP 10,009,202042,Staff,0,0,0,0
1683311563439,AWP 10,010,202043,Staff,0,0,0,0
1683311563439,AWP 10,011,202044,Staff,0,0,0,0
1683311563439,AWP 10,012,202045,Staff,0,0,0,0
1683311563439,AWP 10,013,202046,Staff,0,0,0,0
1683311563439,AWP 10,014,202047,Staff,0,0,0,0
1683311563439,AWP 10,015,202048,Staff,0,0,0,0
1683311563439,AWP 10,016,202049,Staff,0,0,0,0
1683311563439,AWP 10,017,202050,Staff,0,0,0,0
1683311563439,AWP 10,018,202051,Staff,0,0,0,0
1683311563439,AWP 10,019,202052,Staff,0,0,0,0
1683311563439,AWP 10,020,202053,Staff,0,0,0,0
1683311563439,AWP 10,021,202054,Staff,0,0,0,0
1683311563439,AWP 10,022,202055,Staff,0,0,0,0
1683311563439,AWP 10,023,202056,Staff,0,0,0,0
1683311563439,AWP 10,024,202057,Staff,0,0,0,0
1683311563439,AWP 10,025,202058,Staff,0,0,0,0
1683311563439,AWP 10,026,202059,Staff,0,0,0,0
1683311564462,AWP 102,001,202032,Staff,0,0,0,0
1683311564462,AWP 102,002,202033,Staff,0,0,0,0
1683311565490,BENG 100,A01,254234,Taylor Amos; Alyssa C,31,0,40,9
1683311566517,BENG 196,001,270013,Engler; Adam J.,9999,0,9999,0
1683311567542,BICD 100R,A01,202018,Smith; Laurie,0,7,32,32
1683311567542,BICD 100R,A02,202019,Smith; Laurie,0,2,32,32
1683311567542,BICD 100R,A03,202020,Smith; Laurie,0,1,32,32
1683311567542,BICD 100R,A04,202021,Smith; Laurie,8,0,32,24
1683311567542,BICD 100R,A05,202022,Smith; Laurie,12,0,32,20
1683311568570,BICD 136,A01,193242,Gustafson-Brown; Cindy,0,2,32,32
1683311568570,BICD 136,A02,193244,Gustafson-Brown; Cindy,15,0,32,17
1683311569601,BIEB 102,A01,193249,Butler; Shannon Rhey,0,2,32,32
1683311569601,BIEB 102,A02,193251,Butler; Shannon Rhey,0,0,32,32
1683311569601,BIEB 102,A03,193253,Butler; Shannon Rhey,0,1,32,32
1683311569601,BIEB 102,A04,193255,Butler; Shannon Rhey,17,0,32,15
1683311569601,BIEB 102,A05,193265,Butler; Shannon Rhey,26,0,32,6
1683311569601,BIEB 102,A06,193269,Butler; Shannon Rhey,16,0,32,16
1683311571652,BIEB 150,A01,193274,Staff,0,0,32,32
1683311571652,BIEB 150,A02,193285,Staff,24,0,32,8
1683311572680,BIEB 194,A00,193286,Kurle; Carolyn M.,22,0,32,10
1683311573706,BILD 1,A01,192291,Staff,16,0,32,16
1683311573706,BILD 1,A02,192292,Staff,30,0,32,2
1683311573706,BILD 1,B01,192520,Reuther; Keefe,0,1,0,0
1683311573706,BILD 1,B02,192532,Reuther; Keefe,0,1,0,0
1683311574734,BILD 3,A01,192556,Butler; Shannon Rhey,0,0,32,32
1683311574734,BILD 3,A02,192581,Butler; Shannon Rhey,5,0,32,27
1683311574734,BILD 3,A03,192611,Butler; Shannon Rhey,23,0,32,9
1683311574734,BILD 3,A04,192612,Butler; Shannon Rhey,25,0,32,7
1683311574734,BILD 3,A05,192613,Butler; Shannon Rhey,27,0,32,5
1683311574734,BILD 3,A06,192679,Butler; Shannon Rhey,27,0,32,5
1683311574734,BILD 3,A07,192682,Butler; Shannon Rhey,22,0,32,10
1683311575759,BILD 4,A01,192836,Reuther; Keefe,1,0,24,23
1683311575759,BILD 4,A02,193044,Reuther; Keefe,4,0,24,20
1683311576782,BILD 10,A01,193142,Gustafson-Brown; Cindy,31,0,32,1
1683311576782,BILD 10,A02,193149,Gustafson-Brown; Cindy,31,0,32,1
1683311577806,BIMM 100,A01,193301,Staff,0,6,32,32
1683311577806,BIMM 100,A02,193312,Staff,0,5,32,32
1683311577806,BIMM 100,A03,193323,Staff,0,8,32,32
1683311578831,BIMM 101,A01,193329,McDonnell; Lisa Marie,0,3,24,24
1683311578831,BIMM 101,A02,193339,McDonnell; Lisa Marie,0,2,24,24
1683311578831,BIMM 101,B01,193354,McDonnell; Lisa Marie,0,3,24,24
1683311578831,BIMM 101,B02,193357,McDonnell; Lisa Marie,0,3,24,24
1683311579859,BIMM 110,A01,193377,Tat; John,0,11,32,32
1683311579859,BIMM 110,A02,193378,Tat; John,1,9,32,31
1683311580886,BIMM 120,A01,206116,Staff,0,0,32,32
1683311580886,BIMM 120,A02,206117,Staff,8,0,32,24
1683311580886,BIMM 120,A03,206121,Staff,21,0,32,11
1683311581915,BIPN 100,A01,193393,Park; Ji Young,0,14,32,32
1683311581915,BIPN 100,A02,193402,Park; Ji Young,0,12,32,32
1683311581915,BIPN 100,A03,193413,Park; Ji Young,0,14,32,32
1683311581915,BIPN 100,A04,193414,Park; Ji Young,0,13,32,32
1683311582938,BIPN 102,A01,193429,Staff,0,0,32,32
1683311582938,BIPN 102,A02,193438,Staff,22,0,32,10
1683311583962,BIPN 106,A01,193450,Reyes Gonzalez; Catalina,0,2,40,40
1683311584986,BIPN 134,A01,193465,Cooke; James Edward,0,0,32,32
1683311584986,BIPN 134,A02,193474,Cooke; James Edward,27,0,32,5
1683311584986,BIPN 134,A03,193485,Cooke; James Edward,29,0,32,3
1683311584986,BIPN 134,A04,193486,Cooke; James Edward,21,0,32,11
1683311584986,BIPN 134,A05,193491,Cooke; James Edward,31,0,32,1
1683311584986,BIPN 134,A06,193501,Cooke; James Edward,30,0,32,2
1683311584986,BIPN 134,A07,193510,Cooke; James Edward,29,0,32,3
1683311587038,BISP 194,A00,222522,Staff,16,0,32,16
1683311588062,CAT 124,A01,202407,Staff,20,0,25,5
1683311589086,CAT 125,A00,202408,Marchisotto; Jennifer Anne,4,0,20,16
1683311590116,CAT 125R,A00,202409,Smith; Lauryn Alissa,0,11,20,20
1683311590116,CAT 125R,B00,202410,Morales; Celeste Georgianna,0,11,20,20
1683311590116,CAT 125R,C00,202411,Irwin; Matthew Joseph,0,10,20,20
1683311591145,CENG 15,A01,204712,Yang; Kesong,0,1,0,0
1683311592169,CENG 114,A00,202070,Jahed Motlagh; Zeinab,5,0,20,15
1683311593191,CGS 105,A00,185477,Wesling; Megan E.,24,0,40,16
1683311594217,CGS 106,A00,185494,Staff,13,0,22,9
1683311595243,CGS 108,A00,185495,Staff,14,0,20,6
1683311596267,CGS 114,A00,185496,Staff,13,0,18,5
1683311597290,CGS 119,A00,185501,Staff,15,0,20,5
1683311598317,CGS 120,A00,185511,Staff,13,0,20,7
1683311599346,CHEM 4,A01,184675,Bussey; Thomas J,96,0,100,4
1683311600373,CHEM 6A,A01,184677,Staff,35,0,60,25
1683311601400,CHEM 6B,A01,184679,Staff,65,0,100,35
1683311602424,CHEM 6C,A01,184681,Bussey; Thomas J,1,0,50,49
1683311602424,CHEM 6C,A02,184682,Bussey; Thomas J,34,0,50,16
1683311603452,CHEM 40A,A01,184684,Albizati; Kim F.,37,0,100,63
1683311604476,CHEM 40B,A01,184686,Albizati; Kim F.,0,20,100,100
1683311605558,CHEM 41B,A01,184690,Staff,52,0,100,48
1683311606582,COGS 3,A01,184715,Boyle; Mary E. T.,0,25,40,40
1683311607609,COGS 14B,A01,185172,Staff,0,15,38,38
1683311608635,COGS 18,A01,184736,Staff,19,0,80,61
1683311609659,COGS 100,A01,184932,Staff,0,5,73,73
1683311610686,COGS 101A,A01,184935,Staff,0,38,30,30
1683311611710,COGS 101B,A01,184944,Staff,0,2,30,30
1683311612735,COGS 101C,A01,184946,Staff,0,12,30,30
1683311613761,COGS 102A,A01,184951,Johnson; Christine M.,2,0,40,38
1683311614784,COGS 107B,A01,184953,Mooshagian; Eric Frederick,0,50,40,40
1683311615808,COGS 118B,A01,184959,Gupta; Anjum,0,48,40,40
1683311616835,COGS 153,A00,184961,Staff,0,15,30,30
1683311617858,COGS 177,A00,184962,Staff,0,21,30,30
1683311618882,COGS 187A,A01,184969,Boyle; Mary E. T.,0,17,40,40
1683311619906,COMM 10,A01,185174,Staff,0,5,25,25
1683311619906,COMM 10,A02,185189,Staff,0,5,25,25
1683311619906,COMM 10,A03,269821,Staff,0,0,0,0
1683311620931,COMM 100B,A01,185475,Staff,0,0,0,2
1683311620931,COMM 100B,A02,185476,Staff,14,0,25,11
1683311621955,COMM 100C,A01,185314,Staff,1,0,25,24
1683311621955,COMM 100C,A02,185327,Staff,19,0,25,6
1683311622980,COMM 110M,A00,185349,Staff,2,0,40,38
1683311624004,COMM 113T,A00,185352,Staff,25,0,40,15
1683311625029,COMM 114I,A00,185353,Staff,33,0,40,7
1683311626053,COMM 131,A00,185354,Staff,19,0,30,11
1683311627081,CSE 8A,A50,185358,Cao; Yingjun,0,46,10,10
1683311628103,CSE 8B,A01,185362,Staff,1,47,50,49
1683311629129,CSE 11,A01,185416,Cao; Yingjun,0,92,10,10
1683311630156,CSE 20,A01,185445,Briones; Jor-el Thomas Caparas,5,0,25,20
1683311631183,CSE 21,A01,185447,Staff,10,0,50,40
1683311632207,CSE 101,A01,185451,Staff,0,12,50,50
1683311632207,CSE 101,B01,185453,Jones; Miles E,0,11,50,50
1683311634259,CSE 141,A01,185458,Eldon; John,20,0,100,80
1683311635283,CSE 141L,A01,185461,Eldon; John,12,0,100,88
1683311636308,CSE 142,A01,185463,Staff,35,0,60,25
1683311636308,CSE 142,B01,201355,Staff,0,6,60,60
1683311637331,CSE 142L,A01,185470,Staff,35,0,60,25
1683311637331,CSE 142L,B01,201417,Staff,0,5,60,60
1683311638354,CSE 190,A00,201433,Staff,32,0,49,17
1683311639380,DOC 1,A01,259136,Strom; Megan C.,7,0,15,8
1683311639380,DOC 1,A02,259137,Strom; Megan C.,14,0,15,1
1683311639380,DOC 1,A03,259138,Strom; Megan C.,14,0,15,1
1683311639380,DOC 1,A04,259139,Strom; Megan C.,14,0,15,1
1683311640404,DOC 100D,A00,259140,Pass; Natalye Joann,17,0,25,8
1683311641438,DSGN 1,A01,184749,Rill; Bryan,0,25,30,30
1683311642462,DSGN 100,A01,185168,Staff,0,2,25,25
1683311643488,ECE 5,A01,185626,Morris; Karcher William,0,10,0,0
1683311644518,ECE 101,A01,185628,Staff,17,0,70,53
1683311645542,ECE 107,A01,185635,Baghdadchi; Saharnaz,0,0,20,20
1683311645542,ECE 107,A02,185638,Baghdadchi; Saharnaz,4,0,20,16
1683311646569,ECE 148,A01,185647,Silberman; Jack,0,0,16,16
1683311647591,ECON 1,A01,185537,Crane; Meredith Helen,54,0,70,16
1683311648619,ECON 3,A01,185549,Crane; Meredith Helen,33,0,70,37
1683311649654,ECON 4,A01,203354,Anderson; John Charles,0,4,10,10
1683311650681,ECON 100A,A01,185574,Staff,0,4,40,40
1683311651705,ECON 100B,A01,185576,Staff,0,22,40,40
1683311652732,ECON 100C,A01,185589,Newhouse; Herbert S,30,0,70,40
1683311653757,ECON 105,A00,185608,Vespa; Emanuel Ignacio,19,0,35,16
1683311654782,ECON 109,A01,185610,Shishkin; Denis,10,0,35,25
1683311655806,ECON 110A,A01,185612,Staff,11,0,40,29
1683311656831,ECON 120A,A01,185615,Staff,20,0,40,20
1683311657859,ECON 120C,A01,185617,Sun; Yixiao,0,20,70,70
1683311658884,ECON 144,A00,203346,Squires; Dale E,3,0,35,32
1683311659908,ECON 171,A01,203349,Newhouse; Herbert S,0,1,35,35
1683311660936,ECON 173A,A01,185621,Toda; Alexis Akira,21,0,35,14
1683311661966,EDS 25,A01,202413,Staff,0,1,0,0
1683311661966,EDS 25,A02,202414,Staff,0,1,0,0
1683311661966,EDS 25,A03,202415,Staff,0,0,0,0
1683311661966,EDS 25,A04,202416,Staff,0,1,0,0
1683311661966,EDS 25,A05,202439,Staff,0,0,0,0
1683311661966,EDS 25,A06,202440,Staff,0,0,0,0
1683311661966,EDS 25,B01,202631,Staff,0,0,0,0
1683311661966,EDS 25,B02,202632,Staff,0,0,0,0
1683311661966,EDS 25,B03,202639,Staff,0,0,0,0
1683311661966,EDS 25,B04,202640,Staff,0,0,0,0
1683311661966,EDS 25,B05,202643,Staff,0,0,0,0
1683311661966,EDS 25,B06,202644,Staff,0,0,0,0
1683311662999,EDS 38,A01,202659,Black; Alison Michelle,24,0,25,1
1683311664023,EDS 115,A00,202652,Staff,17,0,30,13
1683311665049,EDS 125,A00,202649,Staff,14,0,30,16
1683311666073,EDS 126,A01,203332,Staff,30,0,30,0
1683311667098,EDS 139,A00,202838,Staff,17,0,25,8
1683311668121,EDS 146,A01,202655,Staff,15,0,25,10
1683311669149,ENG 15,A00,185667,Staff,0,1,0,0
1683311669149,ENG 15,B00,185672,Staff,0,0,0,0
1683311669149,ENG 15,C00,185675,Staff,0,0,0,0
1683311669149,ENG 15,D00,185682,Staff,0,0,0,0
1683311669149,ENG 15,E00,185684,Staff,0,0,0,0
1683311670176,ETHN 103,A00,185710,Staff,0,3,35,35
1683311671201,ETHN 103A,A00,199228,Man; Simeon S,2,0,9,7
1683311672225,ETHN 109,A00,185711,Staff,18,0,35,17
1683311673251,ETHN 142,A00,185726,Staff,0,4,30,30
1683311674277,ETHN 163J,A00,199229,Man; Simeon S,5,0,8,3
1683311675303,ETHN 168,A00,185727,Staff,8,0,10,2
1683311676329,ETHN 182,A00,185728,Staff,1,0,35,34
1683311677353,ETHN 183,A00,185737,Staff,8,0,18,10
1683311678377,GLBH 111,A01,209361,Burgos; Jose L.,0,0,0,0
1683311680423,HIEU 104,A00,185792,Staff,16,0,20,4
1683311681447,HIEU 115,A00,185800,Staff,1,0,20,19
1683311682471,HIEU 128,A00,185801,Staff,0,7,20,20
1683311683499,HIEU 147,A00,185802,Staff,16,0,20,4
1683311684523,HIEU 154,A00,185823,Staff,12,0,20,8
1683311685547,HILA 102,A00,185826,Staff,13,0,20,7
1683311686573,HILD 2C,A01,185778,Staff,0,12,20,20
1683311687610,HILD 7B,A01,185780,Kwak; Nancy,0,15,32,32
1683311687610,HILD 7B,A02,185781,Kwak; Nancy,0,18,32,32
1683311688634,HILD 30,A01,185791,Staff,14,0,20,6
1683311689658,HISC 119,A00,185830,Golan; Tal,0,9,20,20
1683311690683,HITO 156GS,A00,185831,Patterson; Patrick H.,0,0,0,23
1683311691710,HIUS 103,A00,185832,Man; Simeon S,0,6,20,20
1683311692733,HIUS 117,A00,185836,Kwak; Nancy,2,0,20,18
1683311693756,HIUS 125,A00,185840,Man; Simeon S,0,0,23,23
1683311694783,HIUS 149,A00,185845,Staff,0,0,20,20
1683311695808,HUM 3,A01,185882,Zavodny; Tatiana Sophia,0,6,50,50
1683311695808,HUM 3,B01,185899,Caldwell; Michael Alan,0,19,50,50
1683311696831,HUM 3GS,A00,185900,Patterson; Patrick H.,0,0,0,23
1683311697855,HUM 4,A01,185938,Zroka; Amy Liane,31,0,50,19
1683311697855,HUM 4,B01,185956,Watkins; Eric,0,2,50,50
1683311697855,HUM 4,B02,202209,Watkins; Eric,0,2,50,50
1683311697855,HUM 4,B03,202210,Watkins; Eric,0,0,50,50
1683311698880,HUM 5,A01,185958,West; Geoffrey Scott,4,0,50,46
1683311698880,HUM 5,A02,202215,West; Geoffrey Scott,0,0,50,50
1683311699906,INTL 190,A00,185959,Gagnon; Jeffrey C,0,0,0,9
1683311699906,INTL 190,B00,185960,Lettieri; Michael Joseph,0,0,0,1
1683311700930,JAPN 180,A00,254509,Staff,5,1,30,25
1683311701954,LATI 10,A01,202853,Kennemore; Amy Michelle,5,0,35,30
1683311701954,LATI 10,A02,202854,Kennemore; Amy Michelle,1,0,35,34
1683311701954,LATI 10,A03,270054,Kennemore; Amy Michelle,30,0,30,0
1683311702982,LATI 180,A00,202855,Kennemore; Amy Michelle,11,0,20,9
1683311704004,LAWS 101,A00,201767,Golan; Tal,0,7,40,40
1683311705031,LIFR 1C,A00,185961,Staff,6,0,20,14
1683311706057,LIFR 1CX,A00,185962,Staff,7,0,20,13
1683311707083,LIFR 1D,A00,185963,Staff,9,0,20,11
1683311708107,LIFR 1DX,A00,185964,Staff,9,0,20,11
1683311709188,LIGN 101,A01,186039,Staff,43,0,50,7
1683311710211,LIGN 165,A00,186040,Staff,18,0,50,32
1683311711234,LTCS 108,A00,186041,Staff,6,0,10,4
1683311712259,LTCS 119,A00,186042,Staff,16,0,20,4
1683311713283,LTCS 130,A00,186043,Wesling; Megan E.,15,0,25,10
1683311715336,LTEA 138,A00,186119,Staff,14,0,40,26
1683311716360,LTEN 124,A00,186148,Staff,6,0,25,19
1683311717383,LTEN 178,A00,186149,Staff,7,0,15,8
1683311718419,LTEN 181,A00,186150,Blanco; John D,33,0,40,7
1683311719445,LTWL 120,A00,186160,Staff,20,0,25,5
1683311720468,LTWL 165,A00,186161,Staff,22,0,25,3
1683311721492,LTWR 100,A00,186162,Staff,0,4,15,15
1683311722519,LTWR 102,A00,186163,Doller; Ben,5,0,15,10
1683311723546,MAE 8,A01,186412,Staff,0,0,0,0
1683311724572,MAE 30B,A00,186445,Bahadori; Mohammad Yousef,83,0,100,17
1683311725598,MAE 40,A00,186592,Bewley; Thomas R,9,0,50,41
1683311726621,MAE 101B,A00,186593,Bahadori; Mohammad Yousef,81,0,100,19
1683311727644,MAE 105,A00,186594,Bandaru; Prabhakar,12,0,50,38
1683311728671,MAE 107,A00,186599,Pham; Hieu Tan,0,6,120,120
1683311729696,MAE 148,A01,186660,Silberman; Jack,3,0,16,13
1683311730720,MATH 10A,A01,188095,Staff,0,7,35,35
1683311731749,MATH 10B,A01,188097,Bowers; Adam R.,0,11,30,30
1683311731749,MATH 10B,A02,188099,Bowers; Adam R.,0,11,30,30
1683311731749,MATH 10B,B01,188104,Bowers; Adam R.,0,10,30,30
1683311731749,MATH 10B,B02,188106,Bowers; Adam R.,0,10,30,30
1683311732774,MATH 10C,A01,188111,Staff,0,18,30,30
1683311732774,MATH 10C,A02,188127,Staff,0,17,30,30
1683311732774,MATH 10C,A03,188131,Staff,0,18,30,30
1683311732774,MATH 10C,B01,188218,Staff,20,0,30,10
1683311732774,MATH 10C,B02,188244,Staff,13,0,30,17
1683311732774,MATH 10C,B03,188277,Staff,16,0,30,14
1683311733799,MATH 18,A01,188344,Bach; Quang Tran,18,0,30,12
1683311733799,MATH 18,A02,188345,Bach; Quang Tran,11,0,30,19
1683311733799,MATH 18,B01,188353,Bach; Quang Tran,10,0,30,20
1683311733799,MATH 18,B02,188354,Bach; Quang Tran,20,0,30,10
1683311734823,MATH 20A,A01,188374,Staff,13,0,35,22
1683311735849,MATH 20B,A01,188382,Ohm; Ko Woon,6,0,30,24
1683311735849,MATH 20B,A02,188383,Ohm; Ko Woon,23,0,30,7
1683311735849,MATH 20B,B01,188385,Ohm; Ko Woon,7,0,30,23
1683311735849,MATH 20B,B02,188392,Ohm; Ko Woon,22,0,30,8
1683311736873,MATH 20C,A01,188394,Harel; Guershon,10,0,30,20
1683311736873,MATH 20C,A02,188395,Harel; Guershon,14,0,30,16
1683311736873,MATH 20C,B01,188404,Harel; Guershon,5,0,30,25
1683311736873,MATH 20C,B02,188405,Harel; Guershon,19,0,30,11
1683311737902,MATH 20D,A01,188414,Hammock; Frances H,0,1,30,30
1683311737902,MATH 20D,A02,188415,Hammock; Frances H,4,0,30,26
1683311737902,MATH 20D,B01,188447,Hammock; Frances H,2,0,30,28
1683311737902,MATH 20D,B02,188486,Hammock; Frances H,8,0,30,22
1683311738929,MATH 20E,A01,188649,Staff,21,0,30,9
1683311738929,MATH 20E,A02,188650,Staff,23,0,30,7
1683311738929,MATH 20E,A03,188673,Staff,0,0,30,30
1683311739956,MATH 102,A01,188675,Staff,0,35,35,35
1683311740983,MATH 103B,A01,188681,Staff,4,0,35,31
1683311740983,MATH 103B,B01,188692,Staff,6,0,35,29
1683311742007,MATH 109,A01,188695,Salehi Golsefidy; Alireza,25,0,35,10
1683311742007,MATH 109,A02,188696,Salehi Golsefidy; Alireza,27,0,35,8
1683311743031,MATH 120A,A01,188698,Eggers; John Dietrich,6,0,35,29
1683311744055,MATH 142B,A01,188736,Ioana; Adrian,0,2,30,30
1683311744055,MATH 142B,A02,188741,Ioana; Adrian,0,1,30,30
1683311744055,MATH 142B,A03,188743,Ioana; Adrian,1,3,30,29
1683311745080,MATH 168A,A01,188790,Staff,0,9,35,35
1683311746106,MATH 170A,A01,188803,Nie; Jiawang,0,2,35,35
1683311746106,MATH 170A,A02,188811,Nie; Jiawang,0,0,35,35
1683311746106,MATH 170A,A03,188814,Nie; Jiawang,1,0,35,34
1683311746106,MATH 170A,A04,188815,Nie; Jiawang,13,0,35,22
1683311747132,MATH 193B,A01,188817,Staff,0,0,35,35
1683311747132,MATH 193B,A02,188818,Staff,5,0,35,30
1683311748157,MGT 4,A01,202857,Anderson; John Charles,62,0,80,18
1683311749180,MGT 12,A00,202858,Lindenberger; Wade Douglas,43,0,90,47
1683311750204,MGT 18,A00,202859,Staff,74,0,90,16
1683311751232,MGT 18GS,A00,202860,McKay; Michael J,13,0,28,15
1683311752257,MGT 45,A00,202861,Pecore; Joseph P.,14,0,90,76
1683311753281,MGT 100,A00,202863,Yavorsky; Daniel Ryan,28,0,90,62
1683311754305,MGT 103,A00,202864,Ehrich; Kristine R,0,16,90,90
1683311755330,MGT 112,A00,202865,Ehrich; Kristine R,15,0,90,75
1683311756354,MGT 121A,A00,202868,Staff,0,19,0,0
1683311757381,MGT 131B,A00,202869,Anderson; John Charles,59,0,90,31
1683311758406,MGT 136,A00,202871,Lindenberger; Wade Douglas,84,0,90,6
1683311759430,MGT 164,A00,202873,Staff,0,69,90,90
1683311760456,MGT 164GS,A00,202874,McKay; Mary A,13,0,28,15
1683311761480,MGT 180,A00,202875,Staff,0,51,90,90
1683311762507,MMW 11R,A01,205019,Herbst; Matthew,3,0,30,27
1683311762507,MMW 11R,A02,205026,Herbst; Matthew,29,0,30,1
1683311763535,MMW 15,A01,193512,Chang; Edmond Yi-Teh,0,9,28,28
1683311763535,MMW 15,A02,193513,Chang; Edmond Yi-Teh,0,5,28,28
1683311763535,MMW 15,A03,193514,Chang; Edmond Yi-Teh,0,5,28,28
1683311763535,MMW 15,A04,193515,Chang; Edmond Yi-Teh,0,5,28,28
1683311763535,MMW 15,A05,193516,Chang; Edmond Yi-Teh,0,4,28,28
1683311763535,MMW 15,A06,193517,Chang; Edmond Yi-Teh,0,5,28,28
1683311763535,MMW 15,B01,193519,Chang; Edmond Yi-Teh,0,4,28,28
1683311763535,MMW 15,B02,193520,Chang; Edmond Yi-Teh,0,5,28,28
1683311763535,MMW 15,B03,193521,Chang; Edmond Yi-Teh,0,4,28,28
1683311763535,MMW 15,B04,193522,Chang; Edmond Yi-Teh,0,4,28,28
1683311763535,MMW 15,B05,193523,Chang; Edmond Yi-Teh,0,5,28,28
1683311763535,MMW 15,B06,193524,Chang; Edmond Yi-Teh,0,4,28,28
1683311764560,MMW 122,A01,193526,Rahimi; Babak,0,14,28,28
1683311764560,MMW 122,A02,193527,Rahimi; Babak,0,14,28,28
1683311764560,MMW 122,A03,193528,Rahimi; Babak,0,0,0,0
1683311764560,MMW 122,A04,193529,Rahimi; Babak,0,0,0,0
1683311765583,MUS 1A,A01,186663,Staff,0,20,35,35
1683311766605,MUS 4,A01,186715,Staff,0,12,35,35
1683311767628,MUS 5R,A01,186796,Dubnov; Shlomo,0,17,35,35
1683311768657,MUS 6,A01,186798,Staff,0,3,25,25
1683311769685,MUS 7,A01,186830,Staff,12,0,35,23
1683311770714,MUS 8,A01,186930,Staff,0,26,35,35
1683311771739,MUS 15,A01,186932,Staff,0,15,35,35
1683311771739,MUS 15,B01,186934,Staff,0,15,35,35
1683311772766,MUS 80,A00,186935,Staff,2,0,20,18
1683311772766,MUS 80,B00,186936,Staff,25,0,25,0
1683311773790,NANO 11,A00,204702,Lipomi; Darren John,0,0,0,0
1683311774818,NANO 15,A01,204709,Yang; Kesong,0,1,0,0
1683311775841,NANO 114,A00,202069,Jahed Motlagh; Zeinab,3,0,10,7
1683311776864,PHIL 1,A00,186955,Grush; Rick Scott,32,0,40,8
1683311777891,PHIL 10,A01,186973,Grush; Rick Scott,28,0,35,7
1683311777891,PHIL 10,A02,186974,Grush; Rick Scott,33,0,35,2
1683311778916,PHIL 13,A01,186976,Staff,7,0,35,28
1683311778916,PHIL 13,A02,186977,Staff,16,0,35,19
1683311779942,PHIL 14,A01,186979,Staff,31,0,35,4
1683311779942,PHIL 14,A02,186986,Staff,32,0,35,3
1683311780969,PHIL 28,A01,186988,Staff,16,0,30,14
1683311780969,PHIL 28,A02,186989,Staff,1,0,30,29
1683311780969,PHIL 28,A03,186990,Staff,9,0,30,21
1683311780969,PHIL 28,A04,186991,Staff,26,0,30,4
1683311781996,PHIL 120,A00,186997,Staff,23,0,40,17
1683311783023,PHIL 137,A00,187003,Staff,9,0,40,31
1683311784047,PHIL 150,A00,187015,Staff,47,0,70,23
1683311785075,PHIL 167,A00,187021,Lamey; Andy M.,35,0,40,5
1683311786099,PHIL 174,A01,202226,Staff,17,0,20,3
1683311786099,PHIL 174,A02,202235,Staff,20,0,20,0
1683311787130,PHIL 191A,A00,258918,Staff,0,0,1,1
1683311788156,PHYS 1A,A00,187028,Staff,27,0,60,33
1683311789181,PHYS 1AL,001,187036,Staff,3,0,30,27
1683311789181,PHYS 1AL,002,187049,Staff,18,0,30,12
1683311790204,PHYS 1B,A00,187058,Staff,23,0,60,37
1683311791230,PHYS 1BL,001,187064,Staff,0,0,30,30
1683311791230,PHYS 1BL,002,187070,Staff,6,0,30,24
1683311792257,PHYS 1C,A00,187082,Staff,31,0,120,89
1683311793282,PHYS 1CL,001,187088,Staff,0,9,30,30
1683311793282,PHYS 1CL,002,187089,Staff,0,2,30,30
1683311793282,PHYS 1CL,009,262693,Staff,11,0,30,19
1683311794306,PHYS 2B,A01,187097,Staff,54,0,115,61
1683311795333,PHYS 2C,A01,187099,Staff,67,0,115,48
1683311796361,PHYS 2CL,A01,187101,Staff,5,0,28,23
1683311796361,PHYS 2CL,A02,187102,Staff,15,0,28,13
1683311797390,PHYS 2D,A01,187123,Shotwell; Brian,95,0,115,20
1683311798416,PHYS 4B,A01,187133,Grinstein; Benjamin,35,0,50,15
1683311799440,POLI 10,A00,188819,Staff,0,3,50,50
1683311800464,POLI 11,A00,188827,Staff,43,0,50,7
1683311801487,POLI 13R,A00,188828,Staff,0,1,20,20
1683311802511,POLI 27,A01,188830,Elgin; Samuel Zincke,0,1,70,70
1683311803540,POLI 30,A00,188832,Desposato; Scott,33,0,50,17
1683311804568,POLI 102F,A00,188834,Staff,3,0,40,37
1683311805595,POLI 104A,A00,188852,Staff,14,0,30,16
1683311806632,POLI 104I,A00,188853,Staff,0,6,20,20
1683311807660,POLI 110B,A00,188854,Wiens; David,7,0,20,13
1683311808682,POLI 112A,A00,188855,Wiens; David,5,0,30,25
1683311809708,POLI 117R,A00,188856,Forman; Fonna,0,11,20,20
1683311810734,POLI 118,A00,188857,Ingham; Sean,8,0,20,12
1683311811766,POLI 120G,A00,188858,Staff,9,0,30,21
1683311812847,POLI 131CR,A00,188863,Hoston; Germaine,24,0,50,26
1683311813887,POLI 133,A00,188864,Nellis; Gareth Hb,44,0,50,6
1683311814974,POLI 134D,A00,188865,Desposato; Scott,27,0,30,3
1683311816000,POLI 142A,A00,188871,Gartzke; Erik,22,0,50,28
1683311817033,POLI 142K,A00,188874,Staff,38,0,50,12
1683311818056,POLI 143,A00,188940,Gartzke; Erik,16,0,30,14
1683311819082,POLI 153,A00,188943,Staff,3,0,20,17
1683311820107,POLI 160AA,A00,188944,Staff,12,0,40,28
1683311821138,POLI 170A,A00,188945,Staff,11,0,30,19
1683311823184,PSYC 1,A00,188952,Staff,37,0,90,53
1683311824208,PSYC 2,B00,188953,Staff,20,0,35,15
1683311825235,PSYC 6,A00,188970,Staff,47,0,60,13
1683311826261,PSYC 7,A00,188973,Staff,37,0,45,8
1683311827289,PSYC 60,A01,188980,Rickard; Timothy C.,43,0,60,17
1683311828320,PSYC 70,A01,189001,Steiner; Eric Tomas,24,0,45,21
1683311829349,PSYC 100,A00,189005,Lacefield; Katharine I,0,99,120,120
1683311830372,PSYC 102,A00,189008,Staff,10,0,30,20
1683311831399,PSYC 106,B00,189026,Gorman; Michael R.,37,0,60,23
1683311832429,PSYC 114,B01,189033,Winkielman; Piotr,0,32,30,30
1683311833456,PSYC 131,A00,189036,Anagnostaras; Stephan,0,43,60,60
1683311834482,PSYC 136,A00,189041,Lowe; Angela Beth,0,7,25,25
1683311835508,PSYC 137,A00,189057,Winkielman; Piotr,0,34,25,25
1683311836534,PSYC 144,A00,189107,Wixted; John T,0,7,50,50
1683311838595,PSYC 162,A00,189142,Staff,0,8,85,85
1683311839623,PSYC 172,A00,189144,Gorman; Michael R.,0,7,30,30
1683311841671,PSYC 179,A00,189146,Lacefield; Katharine I,0,84,120,120
1683311842695,PSYC 181,A00,189147,Anagnostaras; Stephan,0,44,90,90
1683311843719,PSYC 190R,A00,189148,Barner; David A.,0,22,80,80
1683311844743,PSYC 191,A00,189275,Rickard; Timothy C.,0,7,25,25
1683311845766,PSYC 193,A00,189276,Chapman; Eddie Nathaniel,0,1,0,4
1683311846795,PSYC 193L,A01,189281,Lowe; Angela Beth,12,0,20,8
1683311846795,PSYC 193L,B01,189285,Staff,28,0,35,7
1683311847816,RELI 149,A00,187137,Rahimi; Babak,7,0,40,33
1683311848842,SE 9,A01,187315,Staff,0,2,18,18
1683311849865,SE 101B,A00,187409,Staff,24,0,30,6
1683311850889,SE 110B,A00,187444,Staff,10,0,40,30
1683311851915,SE 130B,A00,187449,Staff,31,0,40,9
1683311852939,SE 150A,A00,187516,Staff,9,0,20,11
1683311853963,SE 154,A00,187528,Staff,30,0,50,20
1683311854987,SIO 3,A01,258171,Staff,35,0,40,5
1683311856015,SIO 10,A00,187144,Cook; Geoffrey W,0,3,75,75
1683311857039,SIO 45,A00,187152,Cook; Geoffrey W,1,0,100,99
1683311858066,SIO 109R,A00,194486,Staff,0,3,20,20
1683311860115,SIO 187,A01,187233,Kacev; David,12,0,40,28
1683311861139,SOCI 1,A01,258656,Thorpe; Charles Robert,28,0,30,2
1683311861139,SOCI 1,A02,258658,Thorpe; Charles Robert,30,0,30,0
1683311861139,SOCI 1,A03,258661,Thorpe; Charles Robert,25,0,25,0
1683311861139,SOCI 1,A04,258666,Thorpe; Charles Robert,22,0,25,3
1683311861139,SOCI 1,A05,258897,Thorpe; Charles Robert,23,0,25,2
1683311861139,SOCI 1,A06,258898,Thorpe; Charles Robert,25,0,25,0
1683311862163,SOCI 30,A01,258903,Pardo Guerra; Juan Pablo,16,0,30,14
1683311863189,SOCI 102,A00,258904,Staff,9,0,25,16
1683311864215,SOCI 106,A00,258905,Staff,19,0,25,6
1683311865244,SOCI 111,A00,258907,Ribas Norris; Janet Vanesa,26,0,30,4
1683311866268,SOCI 121R,A00,258908,Pardo Guerra; Juan Pablo,11,0,30,19
1683311867295,SOCI 126,A01,203330,Staff,14,0,20,6
1683311868322,SOCI 131,A00,258909,Thorpe; Charles Robert,31,0,60,29
1683311869345,SOCI 135,A00,258910,Payne; Christine Anna,0,9,30,30
1683311870369,SOCI 157,A00,258911,Staff,12,0,30,18
1683311871394,SOCI 184,A00,258912,Staff,25,0,30,5
1683311872418,SOCI 188D,A00,258913,Staff,21,0,30,9
1683311873442,SYN 2,001,187529,Staff,9,0,16,7
1683311873442,SYN 2,002,201452,Staff,0,18,16,16
1683311873442,SYN 2,003,201469,Staff,3,0,16,13
1683311874493,SYN 100,A01,187531,Staff,0,9,20,20
1683311874493,SYN 100,B01,201491,Staff,0,12,20,20
1683311875521,TDAC 1,A00,189286,Walsh; Kim C.,3,0,20,17
1683311875521,TDAC 1,B00,189287,Harting; Carla Kelso,11,0,20,9
1683311876545,TDAC 101,A00,189300,Walsh; Kim C.,16,0,20,4
1683311876545,TDAC 101,B00,189301,Harting; Carla Kelso,18,0,20,2
1683311877572,TDAC 102,A00,189304,Basso; Beatrice,14,0,20,6
1683311878596,TDAC 108,A00,189305,Staff,18,0,20,2
1683311879623,TDDE 131,A00,189310,Staff,19,0,20,1
1683311879623,TDDE 131,B00,189314,Staff,19,0,20,1
1683311879623,TDDE 131,C00,189315,Staff,48,0,50,2
1683311879623,TDDE 131,D00,189316,Staff,14,0,15,1
1683311879623,TDDE 131,E00,204841,Staff,20,0,20,0
1683311880652,TDGE 10,A00,189289,Staff,30,0,50,20
1683311880652,TDGE 10,B00,189290,Havis; Allan,2,0,50,48
1683311881678,TDGE 11,A00,189291,Fulton; Julia,0,3,50,50
1683311881678,TDGE 11,B00,189292,Staff,20,0,25,5
1683311881678,TDGE 11,C00,260270,Staff,0,0,0,0
1683311882707,TDGE 25,A00,189294,Staff,3,0,20,17
1683311883732,TDGE 124,A00,189318,Fulton; Julia,0,8,50,50
1683311884763,TDGE 125,A00,189319,Staff,13,0,25,12
1683311884763,TDGE 125,B00,189320,Staff,23,0,25,2
1683311885787,TDGE 127,A00,189322,Havis; Allan,0,0,50,50
1683311886817,TDHT 101,A00,189323,Staff,18,0,25,7
1683311886817,TDHT 101,B00,189324,Staff,25,0,25,0
1683311887934,TDHT 102,A00,189325,Staff,49,0,50,1
1683311888962,TDMV 1,A00,189295,Arcidiacono; Kristin,20,0,30,10
1683311888962,TDMV 1,B00,189296,Caligagan; Maria T.,24,0,30,6
1683311889990,TDMV 2,A00,189297,Sammartano; Tonnie,28,0,30,2
1683311889990,TDMV 2,B00,189299,Arcidiacono; Kristin,24,0,30,6
1683311891017,TDMV 3,A00,204998,Rincon; Alicia,22,0,30,8
1683311892044,TDMV 120,A00,189458,Sammartano; Tonnie,28,0,30,2
1683311893071,TDMV 138,A00,189541,Jun; Grace Shin Hae,22,0,40,18
1683311894100,TDMV 142,A00,189717,Caligagan; Tony,23,0,30,7
1683311894100,TDMV 142,B00,189718,Caligagan; Maria T.,25,0,30,5
1683311895128,TMC 2,A01,187533,Staff,25,0,25,0
1683311895128,TMC 2,A02,187534,Staff,25,0,25,0
1683311896156,USP 1,A01,187536,Kwak; Nancy,0,16,25,25
1683311897214,USP 5,A01,187538,Staff,9,0,25,16
1683311898238,USP 101,A00,199253,Staff,0,4,0,0
1683311899264,USP 124,A00,187562,Boomhower; Matthew Charles,1,0,30,29
1683311900296,USP 138,A00,187582,Staff,20,0,25,5
1683311901323,USP 152,A01,187597,Staff,4,0,25,21
1683311902356,USP 153,A00,187598,Staff,19,0,25,6
1683311903384,USP 168,A00,187607,Kwak; Nancy,2,0,5,3
1683311904407,USP 173,A00,187619,Staff,4,0,25,21
1683311905432,USP 181,A00,187638,Staff,0,0,25,25
1683311906456,VIS 103,A00,187650,Cruz; Edwin Teddy,23,0,75,52
1683311907487,VIS 110D,A00,187669,Staff,12,0,22,10
1683311908515,VIS 127C,A00,187720,Shen; Kuiyi,68,0,146,78
1683311909542,VIS 149,A00,187731,Yoldas; Pinar,0,14,22,22
1683311910570,VIS 151,A01,188091,Staff,22,0,34,12
1683311910570,VIS 151,A02,188092,Staff,11,0,34,23
1683311911600,VIS 160B,A00,188093,Stalbaum; Brett,0,0,10,10
1683311913649,WCWP 10B,A00,201720,Staff,10,0,15,5
1683311913649,WCWP 10B,B00,201722,Staff,8,0,15,7
1683311914676,WCWP 100,A00,201725,Gagnon; Jeffrey C,0,0,2,2
1683311914676,WCWP 100,B00,201727,Staff,0,4,15,15
1683311917843,ANBI 133,A00,258401,Wilder; Linnea Lorene,34,0,40,6
1683311918870,ANBI 140,A00,258395,Hrvoj Mihic; Branka,18,0,25,7
1683311919898,ANSC 120,A00,258402,Bialecki; Jon Anthony,27,0,40,13
1683311920923,ANSC 144,A00,258400,Staff,14,0,40,26
1683311922972,ANSC 166,A00,258396,Parish; Steven Martin,157,0,175,18
1683311923999,ANSC 180,A00,193533,Staff,9,0,20,11
1683311925027,ANSC 188,A00,258397,Jassal; Aftab,33,0,40,7
1683311926051,ANTH 3,A01,258316,Staff,23,0,30,7
1683311927078,ANTH 5,A00,258394,Semendeferi; Ekaterini,16,0,20,4
1683311928105,ANTH 21,A01,258331,Staff,9,0,40,31
1683311929130,ANTH 103,A00,258398,Varma; Saiba,15,0,25,10
1683311930157,AWP 10,001,202034,Staff,0,0,0,0
1683311930157,AWP 10,002,202035,Staff,0,0,0,0
1683311930157,AWP 10,003,202036,Staff,0,0,0,0
1683311930157,AWP 10,004,202037,Staff,0,0,0,0
1683311930157,AWP 10,005,202038,Staff,0,0,0,0
1683311930157,AWP 10,006,202039,Staff,0,0,0,0
1683311930157,AWP 10,007,202040,Staff,0,0,0,0
1683311930157,AWP 10,008,202041,Staff,0,0,0,0
1683311930157,AWP 10,009,202042,Staff,0,0,0,0
1683311930157,AWP 10,010,202043,Staff,0,0,0,0
1683311930157,AWP 10,011,202044,Staff,0,0,0,0
1683311930157,AWP 10,012,202045,Staff,0,0,0,0
1683311930157,AWP 10,013,202046,Staff,0,0,0,0
1683311930157,AWP 10,014,202047,Staff,0,0,0,0
1683311930157,AWP 10,015,202048,Staff,0,0,0,0
1683311930157,AWP 10,016,202049,Staff,0,0,0,0
1683311930157,AWP 10,017,202050,Staff,0,0,0,0
1683311930157,AWP 10,018,202051,Staff,0,0,0,0
1683311930157,AWP 10,019,202052,Staff,0,0,0,0
1683311930157,AWP 10,020,202053,Staff,0,0,0,0
1683311930157,AWP 10,021,202054,Staff,0,0,0,0
1683311930157,AWP 10,022,202055,Staff,0,0,0,0
1683311930157,AWP 10,023,202056,Staff,0,0,0,0
1683311930157,AWP 10,024,202057,Staff,0,0,0,0
1683311930157,AWP 10,025,202058,Staff,0,0,0,0
1683311930157,AWP 10,026,202059,Staff,0,0,0,0
1683311931184,AWP 102,001,202032,Staff,0,0,0,0
1683311931184,AWP 102,002,202033,Staff,0,0,0,0
1683311932210,BENG 100,A01,254234,Taylor Amos; Alyssa C,31,0,40,9
1683311933236,BENG 196,001,270013,Engler; Adam J.,9999,0,9999,0
1683311934267,BICD 100R,A01,202018,Smith; Laurie,0,7,32,32
1683311934267,BICD 100R,A02,202019,Smith; Laurie,0,2,32,32
1683311934267,BICD 100R,A03,202020,Smith; Laurie,0,1,32,32
1683311934267,BICD 100R,A04,202021,Smith; Laurie,8,0,32,24
1683311934267,BICD 100R,A05,202022,Smith; Laurie,12,0,32,20
1683311935290,BICD 136,A01,193242,Gustafson-Brown; Cindy,0,2,32,32
1683311935290,BICD 136,A02,193244,Gustafson-Brown; Cindy,15,0,32,17
1683311936313,BIEB 102,A01,193249,Butler; Shannon Rhey,0,2,32,32
1683311936313,BIEB 102,A02,193251,Butler; Shannon Rhey,0,0,32,32
1683311936313,BIEB 102,A03,193253,Butler; Shannon Rhey,0,1,32,32
1683311936313,BIEB 102,A04,193255,Butler; Shannon Rhey,17,0,32,15
1683311936313,BIEB 102,A05,193265,Butler; Shannon Rhey,26,0,32,6
1683311936313,BIEB 102,A06,193269,Butler; Shannon Rhey,16,0,32,16
1683311938364,BIEB 150,A01,193274,Staff,0,0,32,32
1683311938364,BIEB 150,A02,193285,Staff,24,0,32,8
1683311939391,BIEB 194,A00,193286,Kurle; Carolyn M.,22,0,32,10
1683311940420,BILD 1,A01,192291,Staff,16,0,32,16
1683311940420,BILD 1,A02,192292,Staff,30,0,32,2
1683311940420,BILD 1,B01,192520,Reuther; Keefe,0,1,0,0
1683311940420,BILD 1,B02,192532,Reuther; Keefe,0,1,0,0
1683311941443,BILD 3,A01,192556,Butler; Shannon Rhey,0,0,32,32
1683311941443,BILD 3,A02,192581,Butler; Shannon Rhey,5,0,32,27
1683311941443,BILD 3,A03,192611,Butler; Shannon Rhey,23,0,32,9
1683311941443,BILD 3,A04,192612,Butler; Shannon Rhey,25,0,32,7
1683311941443,BILD 3,A05,192613,Butler; Shannon Rhey,27,0,32,5
1683311941443,BILD 3,A06,192679,Butler; Shannon Rhey,27,0,32,5
1683311941443,BILD 3,A07,192682,Butler; Shannon Rhey,22,0,32,10
1683311942474,BILD 4,A01,192836,Reuther; Keefe,1,0,24,23
1683311942474,BILD 4,A02,193044,Reuther; Keefe,4,0,24,20
1683311943503,BILD 10,A01,193142,Gustafson-Brown; Cindy,31,0,32,1
1683311943503,BILD 10,A02,193149,Gustafson-Brown; Cindy,31,0,32,1
1683311944528,BIMM 100,A01,193301,Staff,0,6,32,32
1683311944528,BIMM 100,A02,193312,Staff,0,5,32,32
1683311944528,BIMM 100,A03,193323,Staff,0,8,32,32
1683311945553,BIMM 101,A01,193329,McDonnell; Lisa Marie,0,3,24,24
1683311945553,BIMM 101,A02,193339,McDonnell; Lisa Marie,0,2,24,24
1683311945553,BIMM 101,B01,193354,McDonnell; Lisa Marie,0,3,24,24
1683311945553,BIMM 101,B02,193357,McDonnell; Lisa Marie,0,3,24,24
1683311946579,BIMM 110,A01,193377,Tat; John,0,11,32,32
1683311946579,BIMM 110,A02,193378,Tat; John,1,9,32,31
1683311947604,BIMM 120,A01,206116,Staff,0,0,32,32
1683311947604,BIMM 120,A02,206117,Staff,8,0,32,24
1683311947604,BIMM 120,A03,206121,Staff,21,0,32,11
1683311948628,BIPN 100,A01,193393,Park; Ji Young,0,14,32,32
1683311948628,BIPN 100,A02,193402,Park; Ji Young,0,12,32,32
1683311948628,BIPN 100,A03,193413,Park; Ji Young,0,14,32,32
1683311948628,BIPN 100,A04,193414,Park; Ji Young,0,13,32,32
1683311949655,BIPN 102,A01,193429,Staff,0,0,32,32
1683311949655,BIPN 102,A02,193438,Staff,22,0,32,10
1683311950680,BIPN 106,A01,193450,Reyes Gonzalez; Catalina,0,2,40,40
1683311951704,BIPN 134,A01,193465,Cooke; James Edward,0,0,32,32
1683311951704,BIPN 134,A02,193474,Cooke; James Edward,27,0,32,5
1683311951704,BIPN 134,A03,193485,Cooke; James Edward,29,0,32,3
1683311951704,BIPN 134,A04,193486,Cooke; James Edward,21,0,32,11
1683311951704,BIPN 134,A05,193491,Cooke; James Edward,31,0,32,1
1683311951704,BIPN 134,A06,193501,Cooke; James Edward,30,0,32,2
1683311951704,BIPN 134,A07,193510,Cooke; James Edward,29,0,32,3
1683311953754,BISP 194,A00,222522,Staff,16,0,32,16
1683311954781,CAT 124,A01,202407,Staff,20,0,25,5
1683311955809,CAT 125,A00,202408,Marchisotto; Jennifer Anne,4,0,20,16
1683311956834,CAT 125R,A00,202409,Smith; Lauryn Alissa,0,11,20,20
1683311956834,CAT 125R,B00,202410,Morales; Celeste Georgianna,0,11,20,20
1683311956834,CAT 125R,C00,202411,Irwin; Matthew Joseph,0,10,20,20
1683311957863,CENG 15,A01,204712,Yang; Kesong,0,1,0,0
1683311958887,CENG 114,A00,202070,Jahed Motlagh; Zeinab,5,0,20,15
1683311959912,CGS 105,A00,185477,Wesling; Megan E.,24,0,40,16
1683311960939,CGS 106,A00,185494,Staff,13,0,22,9
1683311961963,CGS 108,A00,185495,Staff,14,0,20,6
1683311962990,CGS 114,A00,185496,Staff,13,0,18,5
1683311964017,CGS 119,A00,185501,Staff,15,0,20,5
1683311965045,CGS 120,A00,185511,Staff,13,0,20,7
1683311966075,CHEM 4,A01,184675,Bussey; Thomas J,96,0,100,4
1683311967103,CHEM 6A,A01,184677,Staff,35,0,60,25
1683311968126,CHEM 6B,A01,184679,Staff,65,0,100,35
1683311969154,CHEM 6C,A01,184681,Bussey; Thomas J,1,0,50,49
1683311969154,CHEM 6C,A02,184682,Bussey; Thomas J,34,0,50,16
1683311970183,CHEM 40A,A01,184684,Albizati; Kim F.,37,0,100,63
1683311971209,CHEM 40B,A01,184686,Albizati; Kim F.,0,20,100,100
1683311972233,CHEM 41B,A01,184690,Staff,52,0,100,48
1683311973258,COGS 3,A01,184715,Boyle; Mary E. T.,0,25,40,40
1683311974283,COGS 14B,A01,185172,Staff,0,15,38,38
1683311975310,COGS 18,A01,184736,Staff,19,0,80,61
1683311976336,COGS 100,A01,184932,Staff,0,5,73,73
1683311977365,COGS 101A,A01,184935,Staff,0,38,30,30
1683311978393,COGS 101B,A01,184944,Staff,0,2,30,30
1683311979417,COGS 101C,A01,184946,Staff,0,12,30,30
1683311980440,COGS 102A,A01,184951,Johnson; Christine M.,2,0,40,38
1683311981464,COGS 107B,A01,184953,Mooshagian; Eric Frederick,0,50,40,40
1683311982492,COGS 118B,A01,184959,Gupta; Anjum,0,48,40,40
1683311983517,COGS 153,A00,184961,Staff,0,15,30,30
1683311984541,COGS 177,A00,184962,Staff,0,21,30,30
1683311985565,COGS 187A,A01,184969,Boyle; Mary E. T.,0,17,40,40
1683311986593,COMM 10,A01,185174,Staff,0,5,25,25
1683311986593,COMM 10,A02,185189,Staff,0,5,25,25
1683311986593,COMM 10,A03,269821,Staff,0,0,0,0
1683311987617,COMM 100B,A01,185475,Staff,0,0,0,2
1683311987617,COMM 100B,A02,185476,Staff,14,0,25,11
1683311988641,COMM 100C,A01,185314,Staff,1,0,25,24
1683311988641,COMM 100C,A02,185327,Staff,19,0,25,6
1683311989668,COMM 110M,A00,185349,Staff,2,0,40,38
1683311990691,COMM 113T,A00,185352,Staff,25,0,40,15
1683311991714,COMM 114I,A00,185353,Staff,33,0,40,7
1683311992741,COMM 131,A00,185354,Staff,19,0,30,11
1683311993767,CSE 8A,A50,185358,Cao; Yingjun,0,46,10,10
1683311994793,CSE 8B,A01,185362,Staff,1,47,50,49
1683311995817,CSE 11,A01,185416,Cao; Yingjun,0,91,10,10
1683311996842,CSE 20,A01,185445,Briones; Jor-el Thomas Caparas,5,0,25,20
1683311997876,CSE 21,A01,185447,Staff,10,0,50,40
1683311998899,CSE 101,A01,185451,Staff,0,12,50,50
1683311998899,CSE 101,B01,185453,Jones; Miles E,0,11,50,50
1683312000954,CSE 141,A01,185458,Eldon; John,20,0,100,80
1683312001977,CSE 141L,A01,185461,Eldon; John,12,0,100,88
1683312003006,CSE 142,A01,185463,Staff,35,0,60,25
1683312003006,CSE 142,B01,201355,Staff,0,6,60,60
1683312004032,CSE 142L,A01,185470,Staff,35,0,60,25
1683312004032,CSE 142L,B01,201417,Staff,0,5,60,60
1683312005057,CSE 190,A00,201433,Staff,32,0,49,17
1683312006085,DOC 1,A01,259136,Strom; Megan C.,7,0,15,8
1683312006085,DOC 1,A02,259137,Strom; Megan C.,14,0,15,1
1683312006085,DOC 1,A03,259138,Strom; Megan C.,14,0,15,1
1683312006085,DOC 1,A04,259139,Strom; Megan C.,14,0,15,1
1683312007112,DOC 100D,A00,259140,Pass; Natalye Joann,17,0,25,8
1683312008136,DSGN 1,A01,184749,Rill; Bryan,0,25,30,30
1683312009160,DSGN 100,A01,185168,Staff,0,2,25,25
1683312010188,ECE 5,A01,185626,Morris; Karcher William,0,10,0,0
1683312011213,ECE 101,A01,185628,Staff,17,0,70,53
1683312012238,ECE 107,A01,185635,Baghdadchi; Saharnaz,0,0,20,20
1683312012238,ECE 107,A02,185638,Baghdadchi; Saharnaz,4,0,20,16
1683312013260,ECE 148,A01,185647,Silberman; Jack,0,0,16,16
1683312014286,ECON 1,A01,185537,Crane; Meredith Helen,54,0,70,16
1683312015314,ECON 3,A01,185549,Crane; Meredith Helen,33,0,70,37
1683312016339,ECON 4,A01,203354,Anderson; John Charles,0,4,10,10
1683312017362,ECON 100A,A01,185574,Staff,0,4,40,40
1683312018385,ECON 100B,A01,185576,Staff,0,22,40,40
1683312019422,ECON 100C,A01,185589,Newhouse; Herbert S,30,0,70,40
1683312020528,ECON 105,A00,185608,Vespa; Emanuel Ignacio,19,0,35,16
1683312021555,ECON 109,A01,185610,Shishkin; Denis,10,0,35,25
1683312022584,ECON 110A,A01,185612,Staff,11,0,40,29
1683312023611,ECON 120A,A01,185615,Staff,20,0,40,20
1683312024635,ECON 120C,A01,185617,Sun; Yixiao,0,20,70,70
1683312025660,ECON 144,A00,203346,Squires; Dale E,3,0,35,32
1683312026689,ECON 171,A01,203349,Newhouse; Herbert S,0,1,35,35
1683312027718,ECON 173A,A01,185621,Toda; Alexis Akira,21,0,35,14
1683312028753,EDS 25,A01,202413,Staff,0,1,0,0
1683312028753,EDS 25,A02,202414,Staff,0,1,0,0
1683312028753,EDS 25,A03,202415,Staff,0,0,0,0
1683312028753,EDS 25,A04,202416,Staff,0,1,0,0
1683312028753,EDS 25,A05,202439,Staff,0,0,0,0
1683312028753,EDS 25,A06,202440,Staff,0,0,0,0
1683312028753,EDS 25,B01,202631,Staff,0,0,0,0
1683312028753,EDS 25,B02,202632,Staff,0,0,0,0
1683312028753,EDS 25,B03,202639,Staff,0,0,0,0
1683312028753,EDS 25,B04,202640,Staff,0,0,0,0
1683312028753,EDS 25,B05,202643,Staff,0,0,0,0
1683312028753,EDS 25,B06,202644,Staff,0,0,0,0
1683312029777,EDS 38,A01,202659,Black; Alison Michelle,24,0,25,1
1683312030807,EDS 115,A00,202652,Staff,17,0,30,13
1683312031830,EDS 125,A00,202649,Staff,14,0,30,16
1683312032857,EDS 126,A01,203332,Staff,30,0,30,0
1683312033880,EDS 139,A00,202838,Staff,17,0,25,8
1683312034903,EDS 146,A01,202655,Staff,15,0,25,10
1683312035931,ENG 15,A00,185667,Staff,0,1,0,0
1683312035931,ENG 15,B00,185672,Staff,0,0,0,0
1683312035931,ENG 15,C00,185675,Staff,0,0,0,0
1683312035931,ENG 15,D00,185682,Staff,0,0,0,0
1683312035931,ENG 15,E00,185684,Staff,0,0,0,0
1683312036956,ETHN 103,A00,185710,Staff,0,3,35,35
1683312037980,ETHN 103A,A00,199228,Man; Simeon S,2,0,9,7
1683312039004,ETHN 109,A00,185711,Staff,18,0,35,17
1683312040027,ETHN 142,A00,185726,Staff,0,4,30,30
1683312041052,ETHN 163J,A00,199229,Man; Simeon S,5,0,8,3
1683312042075,ETHN 168,A00,185727,Staff,8,0,10,2
1683312043098,ETHN 182,A00,185728,Staff,1,0,35,34
1683312044126,ETHN 183,A00,185737,Staff,8,0,18,10
1683312045150,GLBH 111,A01,209361,Burgos; Jose L.,0,0,0,0
1683312047197,HIEU 104,A00,185792,Staff,16,0,20,4
1683312048222,HIEU 115,A00,185800,Staff,1,0,20,19
1683312049247,HIEU 128,A00,185801,Staff,0,7,20,20
1683312050272,HIEU 147,A00,185802,Staff,16,0,20,4
1683312051295,HIEU 154,A00,185823,Staff,12,0,20,8
1683312052321,HILA 102,A00,185826,Staff,13,0,20,7
1683312053347,HILD 2C,A01,185778,Staff,0,12,20,20
1683312054370,HILD 7B,A01,185780,Kwak; Nancy,0,15,32,32
1683312054370,HILD 7B,A02,185781,Kwak; Nancy,0,18,32,32
1683312055395,HILD 30,A01,185791,Staff,14,0,20,6
1683312056422,HISC 119,A00,185830,Golan; Tal,0,9,20,20
1683312057446,HITO 156GS,A00,185831,Patterson; Patrick H.,0,0,0,23
1683312058475,HIUS 103,A00,185832,Man; Simeon S,0,6,20,20
1683312059500,HIUS 117,A00,185836,Kwak; Nancy,2,0,20,18
1683312060526,HIUS 125,A00,185840,Man; Simeon S,0,0,23,23
1683312061553,HIUS 149,A00,185845,Staff,0,0,20,20
1683312062580,HUM 3,A01,185882,Zavodny; Tatiana Sophia,0,6,50,50
1683312062580,HUM 3,B01,185899,Caldwell; Michael Alan,0,19,50,50
1683312063609,HUM 3GS,A00,185900,Patterson; Patrick H.,0,0,0,23
1683312064634,HUM 4,A01,185938,Zroka; Amy Liane,31,0,50,19
1683312064634,HUM 4,B01,185956,Watkins; Eric,0,2,50,50
1683312064634,HUM 4,B02,202209,Watkins; Eric,0,2,50,50
1683312064634,HUM 4,B03,202210,Watkins; Eric,0,0,50,50
1683312065658,HUM 5,A01,185958,West; Geoffrey Scott,4,0,50,46
1683312065658,HUM 5,A02,202215,West; Geoffrey Scott,0,0,50,50
1683312066682,INTL 190,A00,185959,Gagnon; Jeffrey C,0,0,0,9
1683312066682,INTL 190,B00,185960,Lettieri; Michael Joseph,0,0,0,1
1683312067707,JAPN 180,A00,254509,Staff,5,1,30,25
1683312068736,LATI 10,A01,202853,Kennemore; Amy Michelle,5,0,35,30
1683312068736,LATI 10,A02,202854,Kennemore; Amy Michelle,1,0,35,34
1683312068736,LATI 10,A03,270054,Kennemore; Amy Michelle,30,0,30,0
1683312069763,LATI 180,A00,202855,Kennemore; Amy Michelle,11,0,20,9
1683312070800,LAWS 101,A00,201767,Golan; Tal,0,7,40,40
1683312071827,LIFR 1C,A00,185961,Staff,6,0,20,14
1683312072854,LIFR 1CX,A00,185962,Staff,7,0,20,13
1683312073880,LIFR 1D,A00,185963,Staff,9,0,20,11
1683312074904,LIFR 1DX,A00,185964,Staff,9,0,20,11
1683312075928,LIGN 101,A01,186039,Staff,43,0,50,7
1683312076952,LIGN 165,A00,186040,Staff,18,0,50,32
1683312077975,LTCS 108,A00,186041,Staff,6,0,10,4
1683312079000,LTCS 119,A00,186042,Staff,16,0,20,4
1683312080024,LTCS 130,A00,186043,Wesling; Megan E.,15,0,25,10
1683312082076,LTEA 138,A00,186119,Staff,14,0,40,26
1683312083100,LTEN 124,A00,186148,Staff,6,0,25,19
1683312084127,LTEN 178,A00,186149,Staff,7,0,15,8
1683312085153,LTEN 181,A00,186150,Blanco; John D,33,0,40,7
1683312086180,LTWL 120,A00,186160,Staff,20,0,25,5
1683312087203,LTWL 165,A00,186161,Staff,22,0,25,3
1683312088228,LTWR 100,A00,186162,Staff,0,4,15,15
1683312089254,LTWR 102,A00,186163,Doller; Ben,5,0,15,10
1683312090281,MAE 8,A01,186412,Staff,0,0,0,0
1683312091307,MAE 30B,A00,186445,Bahadori; Mohammad Yousef,83,0,100,17
1683312092331,MAE 40,A00,186592,Bewley; Thomas R,9,0,50,41
1683312093359,MAE 101B,A00,186593,Bahadori; Mohammad Yousef,81,0,100,19
1683312094384,MAE 105,A00,186594,Bandaru; Prabhakar,12,0,50,38
1683312095409,MAE 107,A00,186599,Pham; Hieu Tan,0,6,120,120
1683312096434,MAE 148,A01,186660,Silberman; Jack,3,0,16,13
1683312097457,MATH 10A,A01,188095,Staff,0,7,35,35
1683312098482,MATH 10B,A01,188097,Bowers; Adam R.,0,11,30,30
1683312098482,MATH 10B,A02,188099,Bowers; Adam R.,0,11,30,30
1683312098482,MATH 10B,B01,188104,Bowers; Adam R.,0,10,30,30
1683312098482,MATH 10B,B02,188106,Bowers; Adam R.,0,10,30,30
1683312099506,MATH 10C,A01,188111,Staff,0,18,30,30
1683312099506,MATH 10C,A02,188127,Staff,0,17,30,30
1683312099506,MATH 10C,A03,188131,Staff,0,18,30,30
1683312099506,MATH 10C,B01,188218,Staff,20,0,30,10
1683312099506,MATH 10C,B02,188244,Staff,13,0,30,17
1683312099506,MATH 10C,B03,188277,Staff,16,0,30,14
1683312100534,MATH 18,A01,188344,Bach; Quang Tran,18,0,30,12
1683312100534,MATH 18,A02,188345,Bach; Quang Tran,11,0,30,19
1683312100534,MATH 18,B01,188353,Bach; Quang Tran,10,0,30,20
1683312100534,MATH 18,B02,188354,Bach; Quang Tran,20,0,30,10
1683312101559,MATH 20A,A01,188374,Staff,13,0,35,22
1683312102588,MATH 20B,A01,188382,Ohm; Ko Woon,6,0,30,24
1683312102588,MATH 20B,A02,188383,Ohm; Ko Woon,23,0,30,7
1683312102588,MATH 20B,B01,188385,Ohm; Ko Woon,7,0,30,23
1683312102588,MATH 20B,B02,188392,Ohm; Ko Woon,22,0,30,8
1683312103613,MATH 20C,A01,188394,Harel; Guershon,10,0,30,20
1683312103613,MATH 20C,A02,188395,Harel; Guershon,14,0,30,16
1683312103613,MATH 20C,B01,188404,Harel; Guershon,5,0,30,25
1683312103613,MATH 20C,B02,188405,Harel; Guershon,19,0,30,11
1683312104641,MATH 20D,A01,188414,Hammock; Frances H,0,1,30,30
1683312104641,MATH 20D,A02,188415,Hammock; Frances H,4,0,30,26
1683312104641,MATH 20D,B01,188447,Hammock; Frances H,2,0,30,28
1683312104641,MATH 20D,B02,188486,Hammock; Frances H,8,0,30,22
1683312105668,MATH 20E,A01,188649,Staff,21,0,30,9
1683312105668,MATH 20E,A02,188650,Staff,23,0,30,7
1683312105668,MATH 20E,A03,188673,Staff,0,0,30,30
1683312106692,MATH 102,A01,188675,Staff,0,35,35,35
1683312107717,MATH 103B,A01,188681,Staff,4,0,35,31
1683312107717,MATH 103B,B01,188692,Staff,6,0,35,29
1683312108745,MATH 109,A01,188695,Salehi Golsefidy; Alireza,25,0,35,10
1683312108745,MATH 109,A02,188696,Salehi Golsefidy; Alireza,27,0,35,8
1683312109770,MATH 120A,A01,188698,Eggers; John Dietrich,6,0,35,29
1683312110796,MATH 142B,A01,188736,Ioana; Adrian,0,2,30,30
1683312110796,MATH 142B,A02,188741,Ioana; Adrian,0,1,30,30
1683312110796,MATH 142B,A03,188743,Ioana; Adrian,1,3,30,29
1683312111820,MATH 168A,A01,188790,Staff,0,9,35,35
1683312112851,MATH 170A,A01,188803,Nie; Jiawang,0,2,35,35
1683312112851,MATH 170A,A02,188811,Nie; Jiawang,0,0,35,35
1683312112851,MATH 170A,A03,188814,Nie; Jiawang,1,0,35,34
1683312112851,MATH 170A,A04,188815,Nie; Jiawang,13,0,35,22
1683312113878,MATH 193B,A01,188817,Staff,0,0,35,35
1683312113878,MATH 193B,A02,188818,Staff,5,0,35,30
1683312114904,MGT 4,A01,202857,Anderson; John Charles,62,0,80,18
1683312115931,MGT 12,A00,202858,Lindenberger; Wade Douglas,43,0,90,47
1683312116955,MGT 18,A00,202859,Staff,74,0,90,16
1683312117979,MGT 18GS,A00,202860,McKay; Michael J,13,0,28,15
1683312119002,MGT 45,A00,202861,Pecore; Joseph P.,14,0,90,76
1683312120030,MGT 100,A00,202863,Yavorsky; Daniel Ryan,28,0,90,62
1683312121057,MGT 103,A00,202864,Ehrich; Kristine R,0,16,90,90
1683312122086,MGT 112,A00,202865,Ehrich; Kristine R,15,0,90,75
1683312123114,MGT 121A,A00,202868,Staff,0,19,0,0
1683312124205,MGT 131B,A00,202869,Anderson; John Charles,59,0,90,31
1683312125233,MGT 136,A00,202871,Lindenberger; Wade Douglas,84,0,90,6
1683312126258,MGT 164,A00,202873,Staff,0,69,90,90
1683312127286,MGT 164GS,A00,202874,McKay; Mary A,13,0,28,15
1683312128312,MGT 180,A00,202875,Staff,0,51,90,90
1683312129339,MMW 11R,A01,205019,Herbst; Matthew,3,0,30,27
1683312129339,MMW 11R,A02,205026,Herbst; Matthew,29,0,30,1
1683312130369,MMW 15,A01,193512,Chang; Edmond Yi-Teh,0,9,28,28
1683312130369,MMW 15,A02,193513,Chang; Edmond Yi-Teh,0,5,28,28
1683312130369,MMW 15,A03,193514,Chang; Edmond Yi-Teh,0,5,28,28
1683312130369,MMW 15,A04,193515,Chang; Edmond Yi-Teh,0,5,28,28
1683312130369,MMW 15,A05,193516,Chang; Edmond Yi-Teh,0,4,28,28
1683312130369,MMW 15,A06,193517,Chang; Edmond Yi-Teh,0,5,28,28
1683312130369,MMW 15,B01,193519,Chang; Edmond Yi-Teh,0,4,28,28
1683312130369,MMW 15,B02,193520,Chang; Edmond Yi-Teh,0,5,28,28
1683312130369,MMW 15,B03,193521,Chang; Edmond Yi-Teh,0,4,28,28
1683312130369,MMW 15,B04,193522,Chang; Edmond Yi-Teh,0,4,28,28
1683312130369,MMW 15,B05,193523,Chang; Edmond Yi-Teh,0,5,28,28
1683312130369,MMW 15,B06,193524,Chang; Edmond Yi-Teh,0,4,28,28
1683312131396,MMW 122,A01,193526,Rahimi; Babak,0,14,28,28
1683312131396,MMW 122,A02,193527,Rahimi; Babak,0,14,28,28
1683312131396,MMW 122,A03,193528,Rahimi; Babak,0,0,0,0
1683312131396,MMW 122,A04,193529,Rahimi; Babak,0,0,0,0
1683312132423,MUS 1A,A01,186663,Staff,0,20,35,35
1683312133447,MUS 4,A01,186715,Staff,0,12,35,35
1683312134472,MUS 5R,A01,186796,Dubnov; Shlomo,0,17,35,35
1683312135497,MUS 6,A01,186798,Staff,0,3,25,25
1683312136523,MUS 7,A01,186830,Staff,12,0,35,23
1683312137546,MUS 8,A01,186930,Staff,0,26,35,35
1683312138571,MUS 15,A01,186932,Staff,0,15,35,35
1683312138571,MUS 15,B01,186934,Staff,0,15,35,35
1683312139595,MUS 80,A00,186935,Staff,2,0,20,18
1683312139595,MUS 80,B00,186936,Staff,25,0,25,0
1683312140620,NANO 11,A00,204702,Lipomi; Darren John,0,0,0,0
1683312141647,NANO 15,A01,204709,Yang; Kesong,0,1,0,0
1683312142674,NANO 114,A00,202069,Jahed Motlagh; Zeinab,3,0,10,7
1683312143697,PHIL 1,A00,186955,Grush; Rick Scott,32,0,40,8
1683312144722,PHIL 10,A01,186973,Grush; Rick Scott,28,0,35,7
1683312144722,PHIL 10,A02,186974,Grush; Rick Scott,33,0,35,2
1683312145746,PHIL 13,A01,186976,Staff,7,0,35,28
1683312145746,PHIL 13,A02,186977,Staff,16,0,35,19
1683312146774,PHIL 14,A01,186979,Staff,31,0,35,4
1683312146774,PHIL 14,A02,186986,Staff,32,0,35,3
1683312147799,PHIL 28,A01,186988,Staff,16,0,30,14
1683312147799,PHIL 28,A02,186989,Staff,1,0,30,29
1683312147799,PHIL 28,A03,186990,Staff,9,0,30,21
1683312147799,PHIL 28,A04,186991,Staff,26,0,30,4
1683312148826,PHIL 120,A00,186997,Staff,23,0,40,17
1683312149853,PHIL 137,A00,187003,Staff,9,0,40,31
1683312150880,PHIL 150,A00,187015,Staff,47,0,70,23
1683312151904,PHIL 167,A00,187021,Lamey; Andy M.,35,0,40,5
1683312152927,PHIL 174,A01,202226,Staff,17,0,20,3
1683312152927,PHIL 174,A02,202235,Staff,20,0,20,0
1683312153953,PHIL 191A,A00,258918,Staff,0,0,1,1
1683312154979,PHYS 1A,A00,187028,Staff,27,0,60,33
1683312156003,PHYS 1AL,001,187036,Staff,3,0,30,27
1683312156003,PHYS 1AL,002,187049,Staff,18,0,30,12
1683312157029,PHYS 1B,A00,187058,Staff,23,0,60,37
1683312158057,PHYS 1BL,001,187064,Staff,0,0,30,30
1683312158057,PHYS 1BL,002,187070,Staff,6,0,30,24
1683312159083,PHYS 1C,A00,187082,Staff,31,0,120,89
1683312160110,PHYS 1CL,001,187088,Staff,0,9,30,30
1683312160110,PHYS 1CL,002,187089,Staff,0,2,30,30
1683312160110,PHYS 1CL,009,262693,Staff,11,0,30,19
1683312161134,PHYS 2B,A01,187097,Staff,54,0,115,61
1683312162161,PHYS 2C,A01,187099,Staff,67,0,115,48
1683312163188,PHYS 2CL,A01,187101,Staff,5,0,28,23
1683312163188,PHYS 2CL,A02,187102,Staff,15,0,28,13
1683312164217,PHYS 2D,A01,187123,Shotwell; Brian,95,0,115,20
1683312165242,PHYS 4B,A01,187133,Grinstein; Benjamin,35,0,50,15
1683312166267,POLI 10,A00,188819,Staff,0,4,50,50
1683312167290,POLI 11,A00,188827,Staff,43,0,50,7
1683312168314,POLI 13R,A00,188828,Staff,0,1,20,20
1683312169338,POLI 27,A01,188830,Elgin; Samuel Zincke,0,1,70,70
1683312170365,POLI 30,A00,188832,Desposato; Scott,32,0,50,18
1683312171389,POLI 102F,A00,188834,Staff,3,0,40,37
1683312172415,POLI 104A,A00,188852,Staff,14,0,30,16
1683312173439,POLI 104I,A00,188853,Staff,0,6,20,20
1683312174462,POLI 110B,A00,188854,Wiens; David,7,0,20,13
1683312175490,POLI 112A,A00,188855,Wiens; David,5,0,30,25
1683312176518,POLI 117R,A00,188856,Forman; Fonna,0,11,20,20
1683312177540,POLI 118,A00,188857,Ingham; Sean,8,0,20,12
1683312178568,POLI 120G,A00,188858,Staff,9,0,30,21
1683312179596,POLI 131CR,A00,188863,Hoston; Germaine,24,0,50,26
1683312180619,POLI 133,A00,188864,Nellis; Gareth Hb,44,0,50,6
1683312181644,POLI 134D,A00,188865,Desposato; Scott,27,0,30,3
1683312182668,POLI 142A,A00,188871,Gartzke; Erik,22,0,50,28
1683312183693,POLI 142K,A00,188874,Staff,38,0,50,12
1683312184717,POLI 143,A00,188940,Gartzke; Erik,16,0,30,14
1683312185744,POLI 153,A00,188943,Staff,3,0,20,17
1683312186771,POLI 160AA,A00,188944,Staff,12,0,40,28
1683312187795,POLI 170A,A00,188945,Staff,11,0,30,19
1683312189842,PSYC 1,A00,188952,Staff,37,0,90,53
1683312190864,PSYC 2,B00,188953,Staff,19,0,35,16
1683312191888,PSYC 6,A00,188970,Staff,47,0,60,13
1683312192912,PSYC 7,A00,188973,Staff,37,0,45,8
1683312193936,PSYC 60,A01,188980,Rickard; Timothy C.,43,0,60,17
1683312194960,PSYC 70,A01,189001,Steiner; Eric Tomas,24,0,45,21
1683312195985,PSYC 100,A00,189005,Lacefield; Katharine I,0,99,120,120
1683312197019,PSYC 102,A00,189008,Staff,10,0,30,20
1683312198043,PSYC 106,B00,189026,Gorman; Michael R.,36,0,60,24
1683312199073,PSYC 114,B01,189033,Winkielman; Piotr,0,32,30,30
1683312200100,PSYC 131,A00,189036,Anagnostaras; Stephan,0,43,60,60
1683312201127,PSYC 136,A00,189041,Lowe; Angela Beth,0,7,25,25
1683312202150,PSYC 137,A00,189057,Winkielman; Piotr,0,34,25,25
1683312203174,PSYC 144,A00,189107,Wixted; John T,0,7,50,50
1683312205221,PSYC 162,A00,189142,Staff,0,8,85,85
1683312206244,PSYC 172,A00,189144,Gorman; Michael R.,0,7,30,30
1683312208290,PSYC 179,A00,189146,Lacefield; Katharine I,0,84,120,120
1683312209318,PSYC 181,A00,189147,Anagnostaras; Stephan,0,44,90,90
1683312210346,PSYC 190R,A00,189148,Barner; David A.,0,22,80,80
1683312211371,PSYC 191,A00,189275,Rickard; Timothy C.,0,7,25,25
1683312212395,PSYC 193,A00,189276,Chapman; Eddie Nathaniel,0,1,0,4
1683312213420,PSYC 193L,A01,189281,Lowe; Angela Beth,12,0,20,8
1683312213420,PSYC 193L,B01,189285,Staff,28,0,35,7
1683312214447,RELI 149,A00,187137,Rahimi; Babak,7,0,40,33
1683312215471,SE 9,A01,187315,Staff,0,2,18,18
1683312216496,SE 101B,A00,187409,Staff,24,0,30,6
1683312217527,SE 110B,A00,187444,Staff,10,0,40,30
1683312218554,SE 130B,A00,187449,Staff,31,0,40,9
1683312219580,SE 150A,A00,187516,Staff,9,0,20,11
1683312220606,SE 154,A00,187528,Staff,30,0,50,20
1683312221633,SIO 3,A01,258171,Staff,35,0,40,5
1683312222658,SIO 10,A00,187144,Cook; Geoffrey W,0,3,75,75
1683312223684,SIO 45,A00,187152,Cook; Geoffrey W,1,0,100,99
1683312224707,SIO 109R,A00,194486,Staff,0,3,20,20
1683312226759,SIO 187,A01,187233,Kacev; David,12,0,40,28
1683312227843,SOCI 1,A01,258656,Thorpe; Charles Robert,28,0,30,2
1683312227843,SOCI 1,A02,258658,Thorpe; Charles Robert,30,0,30,0
1683312227843,SOCI 1,A03,258661,Thorpe; Charles Robert,25,0,25,0
1683312227843,SOCI 1,A04,258666,Thorpe; Charles Robert,22,0,25,3
1683312227843,SOCI 1,A05,258897,Thorpe; Charles Robert,23,0,25,2
1683312227843,SOCI 1,A06,258898,Thorpe; Charles Robert,25,0,25,0
1683312228868,SOCI 30,A01,258903,Pardo Guerra; Juan Pablo,16,0,30,14
1683312229891,SOCI 102,A00,258904,Staff,9,0,25,16
1683312230914,SOCI 106,A00,258905,Staff,19,0,25,6
1683312231941,SOCI 111,A00,258907,Ribas Norris; Janet Vanesa,26,0,30,4
1683312232965,SOCI 121R,A00,258908,Pardo Guerra; Juan Pablo,11,0,30,19
1683312233989,SOCI 126,A01,203330,Staff,14,0,20,6
1683312235017,SOCI 131,A00,258909,Thorpe; Charles Robert,31,0,60,29
1683312236041,SOCI 135,A00,258910,Payne; Christine Anna,0,9,30,30
1683312237068,SOCI 157,A00,258911,Staff,12,0,30,18
1683312238093,SOCI 184,A00,258912,Staff,25,0,30,5
1683312239119,SOCI 188D,A00,258913,Staff,21,0,30,9
1683312240149,SYN 2,001,187529,Staff,9,0,16,7
1683312240149,SYN 2,002,201452,Staff,0,18,16,16
1683312240149,SYN 2,003,201469,Staff,3,0,16,13
1683312241180,SYN 100,A01,187531,Staff,0,9,20,20
1683312241180,SYN 100,B01,201491,Staff,0,12,20,20
1683312242206,TDAC 1,A00,189286,Walsh; Kim C.,3,0,20,17
1683312242206,TDAC 1,B00,189287,Harting; Carla Kelso,11,0,20,9
1683312243233,TDAC 101,A00,189300,Walsh; Kim C.,16,0,20,4
1683312243233,TDAC 101,B00,189301,Harting; Carla Kelso,18,0,20,2
1683312244257,TDAC 102,A00,189304,Basso; Beatrice,14,0,20,6
1683312245281,TDAC 108,A00,189305,Staff,18,0,20,2
1683312246311,TDDE 131,A00,189310,Staff,19,0,20,1
1683312246311,TDDE 131,B00,189314,Staff,19,0,20,1
1683312246311,TDDE 131,C00,189315,Staff,48,0,50,2
1683312246311,TDDE 131,D00,189316,Staff,14,0,15,1
1683312246311,TDDE 131,E00,204841,Staff,20,0,20,0
1683312247337,TDGE 10,A00,189289,Staff,30,0,50,20
1683312247337,TDGE 10,B00,189290,Havis; Allan,2,0,50,48
1683312248366,TDGE 11,A00,189291,Fulton; Julia,0,3,50,50
1683312248366,TDGE 11,B00,189292,Staff,20,0,25,5
1683312248366,TDGE 11,C00,260270,Staff,0,0,0,0
1683312249393,TDGE 25,A00,189294,Staff,3,0,20,17
1683312250418,TDGE 124,A00,189318,Fulton; Julia,0,8,50,50
1683312251442,TDGE 125,A00,189319,Staff,13,0,25,12
1683312251442,TDGE 125,B00,189320,Staff,23,0,25,2
1683312252466,TDGE 127,A00,189322,Havis; Allan,0,0,50,50
1683312253493,TDHT 101,A00,189323,Staff,18,0,25,7
1683312253493,TDHT 101,B00,189324,Staff,25,0,25,0
1683312254521,TDHT 102,A00,189325,Staff,49,0,50,1
1683312255545,TDMV 1,A00,189295,Arcidiacono; Kristin,20,0,30,10
1683312255545,TDMV 1,B00,189296,Caligagan; Maria T.,24,0,30,6
1683312256571,TDMV 2,A00,189297,Sammartano; Tonnie,28,0,30,2
1683312256571,TDMV 2,B00,189299,Arcidiacono; Kristin,24,0,30,6
1683312257597,TDMV 3,A00,204998,Rincon; Alicia,22,0,30,8
1683312258625,TDMV 120,A00,189458,Sammartano; Tonnie,28,0,30,2
1683312259652,TDMV 138,A00,189541,Jun; Grace Shin Hae,22,0,40,18
1683312260680,TDMV 142,A00,189717,Caligagan; Tony,23,0,30,7
1683312260680,TDMV 142,B00,189718,Caligagan; Maria T.,25,0,30,5
1683312261707,TMC 2,A01,187533,Staff,25,0,25,0
1683312261707,TMC 2,A02,187534,Staff,25,0,25,0
1683312262732,USP 1,A01,187536,Kwak; Nancy,0,16,25,25
1683312263760,USP 5,A01,187538,Staff,9,0,25,16
1683312264784,USP 101,A00,199253,Staff,0,4,0,0
1683312265808,USP 124,A00,187562,Boomhower; Matthew Charles,1,0,30,29
1683312266836,USP 138,A00,187582,Staff,20,0,25,5
1683312267860,USP 152,A01,187597,Staff,4,0,25,21
1683312268884,USP 153,A00,187598,Staff,19,0,25,6
1683312269911,USP 168,A00,187607,Kwak; Nancy,2,0,5,3
1683312270935,USP 173,A00,187619,Staff,4,0,25,21
1683312271962,USP 181,A00,187638,Staff,0,0,25,25
1683312272986,VIS 103,A00,187650,Cruz; Edwin Teddy,23,0,75,52
1683312274012,VIS 110D,A00,187669,Staff,12,0,22,10
1683312275039,VIS 127C,A00,187720,Shen; Kuiyi,68,0,146,78
1683312276065,VIS 149,A00,187731,Yoldas; Pinar,0,14,22,22
1683312277092,VIS 151,A01,188091,Staff,22,0,34,12
1683312277092,VIS 151,A02,188092,Staff,11,0,34,23
1683312278117,VIS 160B,A00,188093,Stalbaum; Brett,0,0,10,10
1683312280165,WCWP 10B,A00,201720,Staff,10,0,15,5
1683312280165,WCWP 10B,B00,201722,Staff,8,0,15,7
1683312281189,WCWP 100,A00,201725,Gagnon; Jeffrey C,0,0,2,2
1683312281189,WCWP 100,B00,201727,Staff,0,4,15,15
1683312284279,ANBI 133,A00,258401,Wilder; Linnea Lorene,34,0,40,6
1683312285309,ANBI 140,A00,258395,Hrvoj Mihic; Branka,18,0,25,7
1683312286333,ANSC 120,A00,258402,Bialecki; Jon Anthony,27,0,40,13
1683312287357,ANSC 144,A00,258400,Staff,14,0,40,26
1683312289409,ANSC 166,A00,258396,Parish; Steven Martin,157,0,175,18
1683312290433,ANSC 180,A00,193533,Staff,9,0,20,11
1683312291458,ANSC 188,A00,258397,Jassal; Aftab,33,0,40,7
1683312292485,ANTH 3,A01,258316,Staff,23,0,30,7
1683312293509,ANTH 5,A00,258394,Semendeferi; Ekaterini,16,0,20,4
1683312294535,ANTH 21,A01,258331,Staff,9,0,40,31
1683312295560,ANTH 103,A00,258398,Varma; Saiba,15,0,25,10
1683312296595,AWP 10,001,202034,Staff,0,0,0,0
1683312296595,AWP 10,002,202035,Staff,0,0,0,0
1683312296595,AWP 10,003,202036,Staff,0,0,0,0
1683312296595,AWP 10,004,202037,Staff,0,0,0,0
1683312296595,AWP 10,005,202038,Staff,0,0,0,0
1683312296595,AWP 10,006,202039,Staff,0,0,0,0
1683312296595,AWP 10,007,202040,Staff,0,0,0,0
1683312296595,AWP 10,008,202041,Staff,0,0,0,0
1683312296595,AWP 10,009,202042,Staff,0,0,0,0
1683312296595,AWP 10,010,202043,Staff,0,0,0,0
1683312296595,AWP 10,011,202044,Staff,0,0,0,0
1683312296595,AWP 10,012,202045,Staff,0,0,0,0
1683312296595,AWP 10,013,202046,Staff,0,0,0,0
1683312296595,AWP 10,014,202047,Staff,0,0,0,0
1683312296595,AWP 10,015,202048,Staff,0,0,0,0
1683312296595,AWP 10,016,202049,Staff,0,0,0,0
1683312296595,AWP 10,017,202050,Staff,0,0,0,0
1683312296595,AWP 10,018,202051,Staff,0,0,0,0
1683312296595,AWP 10,019,202052,Staff,0,0,0,0
1683312296595,AWP 10,020,202053,Staff,0,0,0,0
1683312296595,AWP 10,021,202054,Staff,0,0,0,0
1683312296595,AWP 10,022,202055,Staff,0,0,0,0
1683312296595,AWP 10,023,202056,Staff,0,0,0,0
1683312296595,AWP 10,024,202057,Staff,0,0,0,0
1683312296595,AWP 10,025,202058,Staff,0,0,0,0
1683312296595,AWP 10,026,202059,Staff,0,0,0,0
1683312297621,AWP 102,001,202032,Staff,0,0,0,0
1683312297621,AWP 102,002,202033,Staff,0,0,0,0
1683312298648,BENG 100,A01,254234,Taylor Amos; Alyssa C,31,0,40,9
1683312299672,BENG 196,001,270013,Engler; Adam J.,9999,0,9999,0
1683312300698,BICD 100R,A01,202018,Smith; Laurie,0,7,32,32
1683312300698,BICD 100R,A02,202019,Smith; Laurie,0,2,32,32
1683312300698,BICD 100R,A03,202020,Smith; Laurie,0,1,32,32
1683312300698,BICD 100R,A04,202021,Smith; Laurie,8,0,32,24
1683312300698,BICD 100R,A05,202022,Smith; Laurie,12,0,32,20
1683312301722,BICD 136,A01,193242,Gustafson-Brown; Cindy,0,2,32,32
1683312301722,BICD 136,A02,193244,Gustafson-Brown; Cindy,15,0,32,17
1683312302749,BIEB 102,A01,193249,Butler; Shannon Rhey,0,2,32,32
1683312302749,BIEB 102,A02,193251,Butler; Shannon Rhey,0,0,32,32
1683312302749,BIEB 102,A03,193253,Butler; Shannon Rhey,0,1,32,32
1683312302749,BIEB 102,A04,193255,Butler; Shannon Rhey,17,0,32,15
1683312302749,BIEB 102,A05,193265,Butler; Shannon Rhey,26,0,32,6
1683312302749,BIEB 102,A06,193269,Butler; Shannon Rhey,16,0,32,16
1683312304796,BIEB 150,A01,193274,Staff,0,0,32,32
1683312304796,BIEB 150,A02,193285,Staff,24,0,32,8
1683312305822,BIEB 194,A00,193286,Kurle; Carolyn M.,22,0,32,10
1683312306845,BILD 1,A01,192291,Staff,16,0,32,16
1683312306845,BILD 1,A02,192292,Staff,30,0,32,2
1683312306845,BILD 1,B01,192520,Reuther; Keefe,0,1,0,0
1683312306845,BILD 1,B02,192532,Reuther; Keefe,0,1,0,0
1683312307870,BILD 3,A01,192556,Butler; Shannon Rhey,0,0,32,32
1683312307870,BILD 3,A02,192581,Butler; Shannon Rhey,5,0,32,27
1683312307870,BILD 3,A03,192611,Butler; Shannon Rhey,23,0,32,9
1683312307870,BILD 3,A04,192612,Butler; Shannon Rhey,25,0,32,7
1683312307870,BILD 3,A05,192613,Butler; Shannon Rhey,27,0,32,5
1683312307870,BILD 3,A06,192679,Butler; Shannon Rhey,27,0,32,5
1683312307870,BILD 3,A07,192682,Butler; Shannon Rhey,22,0,32,10
1683312308894,BILD 4,A01,192836,Reuther; Keefe,1,0,24,23
1683312308894,BILD 4,A02,193044,Reuther; Keefe,4,0,24,20
1683312309919,BILD 10,A01,193142,Gustafson-Brown; Cindy,31,0,32,1
1683312309919,BILD 10,A02,193149,Gustafson-Brown; Cindy,31,0,32,1
1683312310945,BIMM 100,A01,193301,Staff,0,6,32,32
1683312310945,BIMM 100,A02,193312,Staff,0,5,32,32
1683312310945,BIMM 100,A03,193323,Staff,0,8,32,32
1683312311970,BIMM 101,A01,193329,McDonnell; Lisa Marie,0,3,24,24
1683312311970,BIMM 101,A02,193339,McDonnell; Lisa Marie,0,2,24,24
1683312311970,BIMM 101,B01,193354,McDonnell; Lisa Marie,0,3,24,24
1683312311970,BIMM 101,B02,193357,McDonnell; Lisa Marie,0,3,24,24
1683312312997,BIMM 110,A01,193377,Tat; John,0,11,32,32
1683312312997,BIMM 110,A02,193378,Tat; John,1,9,32,31
1683312314022,BIMM 120,A01,206116,Staff,0,0,32,32
1683312314022,BIMM 120,A02,206117,Staff,8,0,32,24
1683312314022,BIMM 120,A03,206121,Staff,21,0,32,11
1683312315051,BIPN 100,A01,193393,Park; Ji Young,0,14,32,32
1683312315051,BIPN 100,A02,193402,Park; Ji Young,0,12,32,32
1683312315051,BIPN 100,A03,193413,Park; Ji Young,0,14,32,32
1683312315051,BIPN 100,A04,193414,Park; Ji Young,0,13,32,32
1683312316077,BIPN 102,A01,193429,Staff,0,0,32,32
1683312316077,BIPN 102,A02,193438,Staff,22,0,32,10
1683312317101,BIPN 106,A01,193450,Reyes Gonzalez; Catalina,0,2,40,40
1683312318126,BIPN 134,A01,193465,Cooke; James Edward,0,0,32,32
1683312318126,BIPN 134,A02,193474,Cooke; James Edward,27,0,32,5
1683312318126,BIPN 134,A03,193485,Cooke; James Edward,29,0,32,3
1683312318126,BIPN 134,A04,193486,Cooke; James Edward,21,0,32,11
1683312318126,BIPN 134,A05,193491,Cooke; James Edward,31,0,32,1
1683312318126,BIPN 134,A06,193501,Cooke; James Edward,30,0,32,2
1683312318126,BIPN 134,A07,193510,Cooke; James Edward,29,0,32,3
1683312320174,BISP 194,A00,222522,Staff,16,0,32,16
1683312321198,CAT 124,A01,202407,Staff,20,0,25,5
1683312322222,CAT 125,A00,202408,Marchisotto; Jennifer Anne,4,0,20,16
1683312323250,CAT 125R,A00,202409,Smith; Lauryn Alissa,0,11,20,20
1683312323250,CAT 125R,B00,202410,Morales; Celeste Georgianna,0,11,20,20
1683312323250,CAT 125R,C00,202411,Irwin; Matthew Joseph,0,10,20,20
1683312324274,CENG 15,A01,204712,Yang; Kesong,0,1,0,0
1683312325301,CENG 114,A00,202070,Jahed Motlagh; Zeinab,5,0,20,15
1683312326325,CGS 105,A00,185477,Wesling; Megan E.,24,0,40,16
1683312327352,CGS 106,A00,185494,Staff,13,0,22,9
1683312328377,CGS 108,A00,185495,Staff,14,0,20,6
1683312329401,CGS 114,A00,185496,Staff,13,0,18,5
1683312330429,CGS 119,A00,185501,Staff,15,0,20,5
1683312331514,CGS 120,A00,185511,Staff,13,0,20,7
1683312332542,CHEM 4,A01,184675,Bussey; Thomas J,96,0,100,4
1683312333568,CHEM 6A,A01,184677,Staff,35,0,60,25
1683312334592,CHEM 6B,A01,184679,Staff,65,0,100,35
1683312335617,CHEM 6C,A01,184681,Bussey; Thomas J,1,0,50,49
1683312335617,CHEM 6C,A02,184682,Bussey; Thomas J,34,0,50,16
1683312336641,CHEM 40A,A01,184684,Albizati; Kim F.,37,0,100,63
1683312337668,CHEM 40B,A01,184686,Albizati; Kim F.,0,20,100,100
1683312338695,CHEM 41B,A01,184690,Staff,52,0,100,48
1683312339720,COGS 3,A01,184715,Boyle; Mary E. T.,0,25,40,40
1683312340744,COGS 14B,A01,185172,Staff,0,15,38,38
1683312341768,COGS 18,A01,184736,Staff,19,0,80,61
1683312342795,COGS 100,A01,184932,Staff,0,5,73,73
1683312343822,COGS 101A,A01,184935,Staff,0,38,30,30
1683312344846,COGS 101B,A01,184944,Staff,0,2,30,30
1683312345870,COGS 101C,A01,184946,Staff,0,12,30,30
1683312346899,COGS 102A,A01,184951,Johnson; Christine M.,2,0,40,38
1683312347924,COGS 107B,A01,184953,Mooshagian; Eric Frederick,0,50,40,40
1683312348952,COGS 118B,A01,184959,Gupta; Anjum,0,48,40,40
1683312349977,COGS 153,A00,184961,Staff,0,15,30,30
1683312351001,COGS 177,A00,184962,Staff,0,21,30,30
1683312352028,COGS 187A,A01,184969,Boyle; Mary E. T.,0,17,40,40
1683312353052,COMM 10,A01,185174,Staff,0,5,25,25
1683312353052,COMM 10,A02,185189,Staff,0,5,25,25
1683312353052,COMM 10,A03,269821,Staff,0,0,0,0
1683312354076,COMM 100B,A01,185475,Staff,0,0,0,2
1683312354076,COMM 100B,A02,185476,Staff,14,0,25,11
1683312355102,COMM 100C,A01,185314,Staff,1,0,25,24
1683312355102,COMM 100C,A02,185327,Staff,19,0,25,6
1683312356127,COMM 110M,A00,185349,Staff,2,0,40,38
1683312357151,COMM 113T,A00,185352,Staff,25,0,40,15
1683312358176,COMM 114I,A00,185353,Staff,33,0,40,7
1683312359200,COMM 131,A00,185354,Staff,19,0,30,11
1683312360228,CSE 8A,A50,185358,Cao; Yingjun,0,46,10,10
1683312361252,CSE 8B,A01,185362,Staff,1,47,50,49
1683312362276,CSE 11,A01,185416,Cao; Yingjun,0,91,10,10
1683312363303,CSE 20,A01,185445,Briones; Jor-el Thomas Caparas,5,0,25,20
1683312364327,CSE 21,A01,185447,Staff,10,0,50,40
1683312365349,CSE 101,A01,185451,Staff,0,12,50,50
1683312365349,CSE 101,B01,185453,Jones; Miles E,0,11,50,50
1683312367399,CSE 141,A01,185458,Eldon; John,20,0,100,80
1683312368424,CSE 141L,A01,185461,Eldon; John,12,0,100,88
1683312369459,CSE 142,A01,185463,Staff,36,0,60,24
1683312369459,CSE 142,B01,201355,Staff,0,7,60,60
1683312370487,CSE 142L,A01,185470,Staff,36,0,60,24
1683312370487,CSE 142L,B01,201417,Staff,0,6,60,60
1683312371511,CSE 190,A00,201433,Staff,32,0,49,17
1683312372536,DOC 1,A01,259136,Strom; Megan C.,7,0,15,8
1683312372536,DOC 1,A02,259137,Strom; Megan C.,14,0,15,1
1683312372536,DOC 1,A03,259138,Strom; Megan C.,14,0,15,1
1683312372536,DOC 1,A04,259139,Strom; Megan C.,14,0,15,1
1683312373563,DOC 100D,A00,259140,Pass; Natalye Joann,17,0,25,8
1683312374591,DSGN 1,A01,184749,Rill; Bryan,0,25,30,30
1683312375614,DSGN 100,A01,185168,Staff,0,2,25,25
1683312376636,ECE 5,A01,185626,Morris; Karcher William,0,10,0,0
1683312377664,ECE 101,A01,185628,Staff,17,0,70,53
1683312378688,ECE 107,A01,185635,Baghdadchi; Saharnaz,0,0,20,20
1683312378688,ECE 107,A02,185638,Baghdadchi; Saharnaz,4,0,20,16
1683312379715,ECE 148,A01,185647,Silberman; Jack,0,0,16,16
1683312380741,ECON 1,A01,185537,Crane; Meredith Helen,54,0,70,16
1683312381767,ECON 3,A01,185549,Crane; Meredith Helen,33,0,70,37
1683312382791,ECON 4,A01,203354,Anderson; John Charles,0,4,10,10
1683312383815,ECON 100A,A01,185574,Staff,0,4,40,40
1683312384838,ECON 100B,A01,185576,Staff,0,22,40,40
1683312385866,ECON 100C,A01,185589,Newhouse; Herbert S,30,0,70,40
1683312386893,ECON 105,A00,185608,Vespa; Emanuel Ignacio,19,0,35,16
1683312387916,ECON 109,A01,185610,Shishkin; Denis,10,0,35,25
1683312388940,ECON 110A,A01,185612,Staff,11,0,40,29
1683312389963,ECON 120A,A01,185615,Staff,20,0,40,20
1683312390988,ECON 120C,A01,185617,Sun; Yixiao,0,20,70,70
1683312392014,ECON 144,A00,203346,Squires; Dale E,3,0,35,32
1683312393041,ECON 171,A01,203349,Newhouse; Herbert S,0,1,35,35
1683312394069,ECON 173A,A01,185621,Toda; Alexis Akira,21,0,35,14
1683312395094,EDS 25,A01,202413,Staff,0,1,0,0
1683312395094,EDS 25,A02,202414,Staff,0,1,0,0
1683312395094,EDS 25,A03,202415,Staff,0,0,0,0
1683312395094,EDS 25,A04,202416,Staff,0,1,0,0
1683312395094,EDS 25,A05,202439,Staff,0,0,0,0
1683312395094,EDS 25,A06,202440,Staff,0,0,0,0
1683312395094,EDS 25,B01,202631,Staff,0,0,0,0
1683312395094,EDS 25,B02,202632,Staff,0,0,0,0
1683312395094,EDS 25,B03,202639,Staff,0,0,0,0
1683312395094,EDS 25,B04,202640,Staff,0,0,0,0
1683312395094,EDS 25,B05,202643,Staff,0,0,0,0
1683312395094,EDS 25,B06,202644,Staff,0,0,0,0
1683312396120,EDS 38,A01,202659,Black; Alison Michelle,24,0,25,1
1683312397143,EDS 115,A00,202652,Staff,17,0,30,13
1683312398170,EDS 125,A00,202649,Staff,14,0,30,16
1683312399197,EDS 126,A01,203332,Staff,30,0,30,0
1683312400220,EDS 139,A00,202838,Staff,17,0,25,8
1683312401244,EDS 146,A01,202655,Staff,15,0,25,10
1683312402269,ENG 15,A00,185667,Staff,0,1,0,0
1683312402269,ENG 15,B00,185672,Staff,0,0,0,0
1683312402269,ENG 15,C00,185675,Staff,0,0,0,0
1683312402269,ENG 15,D00,185682,Staff,0,0,0,0
1683312402269,ENG 15,E00,185684,Staff,0,0,0,0
1683312403293,ETHN 103,A00,185710,Staff,0,3,35,35
1683312404317,ETHN 103A,A00,199228,Man; Simeon S,2,0,9,7
1683312405343,ETHN 109,A00,185711,Staff,18,0,35,17
1683312406365,ETHN 142,A00,185726,Staff,0,4,30,30
1683312407389,ETHN 163J,A00,199229,Man; Simeon S,5,0,8,3
1683312408413,ETHN 168,A00,185727,Staff,8,0,10,2
1683312409436,ETHN 182,A00,185728,Staff,1,0,35,34
1683312410461,ETHN 183,A00,185737,Staff,8,0,18,10
1683312411488,GLBH 111,A01,209361,Burgos; Jose L.,0,0,0,0
1683312413538,HIEU 104,A00,185792,Staff,16,0,20,4
1683312414564,HIEU 115,A00,185800,Staff,1,0,20,19
1683312415588,HIEU 128,A00,185801,Staff,0,7,20,20
1683312416612,HIEU 147,A00,185802,Staff,16,0,20,4
1683312417639,HIEU 154,A00,185823,Staff,12,0,20,8
1683312418662,HILA 102,A00,185826,Staff,13,0,20,7
1683312419686,HILD 2C,A01,185778,Staff,0,12,20,20
1683312420711,HILD 7B,A01,185780,Kwak; Nancy,0,15,32,32
1683312420711,HILD 7B,A02,185781,Kwak; Nancy,0,18,32,32
1683312421735,HILD 30,A01,185791,Staff,14,0,20,6
1683312422759,HISC 119,A00,185830,Golan; Tal,0,9,20,20
1683312423783,HITO 156GS,A00,185831,Patterson; Patrick H.,0,0,0,23
1683312424816,HIUS 103,A00,185832,Man; Simeon S,0,6,20,20
1683312425841,HIUS 117,A00,185836,Kwak; Nancy,2,0,20,18
1683312426868,HIUS 125,A00,185840,Man; Simeon S,0,0,23,23
1683312427894,HIUS 149,A00,185845,Staff,0,0,20,20
1683312428922,HUM 3,A01,185882,Zavodny; Tatiana Sophia,0,6,50,50
1683312428922,HUM 3,B01,185899,Caldwell; Michael Alan,0,19,50,50
1683312429947,HUM 3GS,A00,185900,Patterson; Patrick H.,0,0,0,23
1683312430975,HUM 4,A01,185938,Zroka; Amy Liane,31,0,50,19
1683312430975,HUM 4,B01,185956,Watkins; Eric,0,2,50,50
1683312430975,HUM 4,B02,202209,Watkins; Eric,0,2,50,50
1683312430975,HUM 4,B03,202210,Watkins; Eric,0,0,50,50
1683312432000,HUM 5,A01,185958,West; Geoffrey Scott,4,0,50,46
1683312432000,HUM 5,A02,202215,West; Geoffrey Scott,0,0,50,50
1683312433025,INTL 190,A00,185959,Gagnon; Jeffrey C,0,0,0,9
1683312433025,INTL 190,B00,185960,Lettieri; Michael Joseph,0,0,0,1
1683312434048,JAPN 180,A00,254509,Staff,5,1,30,25
1683312435145,LATI 10,A01,202853,Kennemore; Amy Michelle,5,0,35,30
1683312435145,LATI 10,A02,202854,Kennemore; Amy Michelle,1,0,35,34
1683312435145,LATI 10,A03,270054,Kennemore; Amy Michelle,30,0,30,0
1683312436170,LATI 180,A00,202855,Kennemore; Amy Michelle,11,0,20,9
1683312437195,LAWS 101,A00,201767,Golan; Tal,0,7,40,40
1683312438221,LIFR 1C,A00,185961,Staff,6,0,20,14
1683312439244,LIFR 1CX,A00,185962,Staff,7,0,20,13
1683312440267,LIFR 1D,A00,185963,Staff,9,0,20,11
1683312441293,LIFR 1DX,A00,185964,Staff,9,0,20,11
1683312442318,LIGN 101,A01,186039,Staff,43,0,50,7
1683312443340,LIGN 165,A00,186040,Staff,18,0,50,32
1683312444366,LTCS 108,A00,186041,Staff,6,0,10,4
1683312445391,LTCS 119,A00,186042,Staff,16,0,20,4
1683312446415,LTCS 130,A00,186043,Wesling; Megan E.,15,0,25,10
1683312448463,LTEA 138,A00,186119,Staff,14,0,40,26
1683312449490,LTEN 124,A00,186148,Staff,6,0,25,19
1683312450514,LTEN 178,A00,186149,Staff,7,0,15,8
1683312451541,LTEN 181,A00,186150,Blanco; John D,33,0,40,7
1683312452568,LTWL 120,A00,186160,Staff,20,0,25,5
1683312453595,LTWL 165,A00,186161,Staff,22,0,25,3
1683312454619,LTWR 100,A00,186162,Staff,0,4,15,15
1683312455642,LTWR 102,A00,186163,Doller; Ben,5,0,15,10
1683312456666,MAE 8,A01,186412,Staff,0,0,0,0
1683312457690,MAE 30B,A00,186445,Bahadori; Mohammad Yousef,83,0,100,17
1683312458713,MAE 40,A00,186592,Bewley; Thomas R,9,0,50,41
1683312459736,MAE 101B,A00,186593,Bahadori; Mohammad Yousef,81,0,100,19
1683312460764,MAE 105,A00,186594,Bandaru; Prabhakar,12,0,50,38
1683312461790,MAE 107,A00,186599,Pham; Hieu Tan,0,6,120,120
1683312462817,MAE 148,A01,186660,Silberman; Jack,3,0,16,13
1683312463841,MATH 10A,A01,188095,Staff,0,7,35,35
1683312464867,MATH 10B,A01,188097,Bowers; Adam R.,0,11,30,30
1683312464867,MATH 10B,A02,188099,Bowers; Adam R.,0,11,30,30
1683312464867,MATH 10B,B01,188104,Bowers; Adam R.,0,10,30,30
1683312464867,MATH 10B,B02,188106,Bowers; Adam R.,0,10,30,30
1683312465892,MATH 10C,A01,188111,Staff,0,18,30,30
1683312465892,MATH 10C,A02,188127,Staff,0,17,30,30
1683312465892,MATH 10C,A03,188131,Staff,0,18,30,30
1683312465892,MATH 10C,B01,188218,Staff,20,0,30,10
1683312465892,MATH 10C,B02,188244,Staff,13,0,30,17
1683312465892,MATH 10C,B03,188277,Staff,16,0,30,14
1683312466917,MATH 18,A01,188344,Bach; Quang Tran,18,0,30,12
1683312466917,MATH 18,A02,188345,Bach; Quang Tran,11,0,30,19
1683312466917,MATH 18,B01,188353,Bach; Quang Tran,10,0,30,20
1683312466917,MATH 18,B02,188354,Bach; Quang Tran,20,0,30,10
1683312467943,MATH 20A,A01,188374,Staff,13,0,35,22
1683312468967,MATH 20B,A01,188382,Ohm; Ko Woon,6,0,30,24
1683312468967,MATH 20B,A02,188383,Ohm; Ko Woon,23,0,30,7
1683312468967,MATH 20B,B01,188385,Ohm; Ko Woon,7,0,30,23
1683312468967,MATH 20B,B02,188392,Ohm; Ko Woon,22,0,30,8
1683312469995,MATH 20C,A01,188394,Harel; Guershon,10,0,30,20
1683312469995,MATH 20C,A02,188395,Harel; Guershon,14,0,30,16
1683312469995,MATH 20C,B01,188404,Harel; Guershon,5,0,30,25
1683312469995,MATH 20C,B02,188405,Harel; Guershon,19,0,30,11
1683312471025,MATH 20D,A01,188414,Hammock; Frances H,0,1,30,30
1683312471025,MATH 20D,A02,188415,Hammock; Frances H,4,0,30,26
1683312471025,MATH 20D,B01,188447,Hammock; Frances H,2,0,30,28
1683312471025,MATH 20D,B02,188486,Hammock; Frances H,8,0,30,22
1683312472052,MATH 20E,A01,188649,Staff,21,0,30,9
1683312472052,MATH 20E,A02,188650,Staff,23,0,30,7
1683312472052,MATH 20E,A03,188673,Staff,0,0,30,30
1683312473076,MATH 102,A01,188675,Staff,0,35,35,35
1683312474104,MATH 103B,A01,188681,Staff,4,0,35,31
1683312474104,MATH 103B,B01,188692,Staff,6,0,35,29
1683312475132,MATH 109,A01,188695,Salehi Golsefidy; Alireza,25,0,35,10
1683312475132,MATH 109,A02,188696,Salehi Golsefidy; Alireza,27,0,35,8
1683312476159,MATH 120A,A01,188698,Eggers; John Dietrich,6,0,35,29
1683312477182,MATH 142B,A01,188736,Ioana; Adrian,0,2,30,30
1683312477182,MATH 142B,A02,188741,Ioana; Adrian,0,1,30,30
1683312477182,MATH 142B,A03,188743,Ioana; Adrian,1,3,30,29
1683312478206,MATH 168A,A01,188790,Staff,0,9,35,35
1683312479231,MATH 170A,A01,188803,Nie; Jiawang,0,2,35,35
1683312479231,MATH 170A,A02,188811,Nie; Jiawang,0,0,35,35
1683312479231,MATH 170A,A03,188814,Nie; Jiawang,1,0,35,34
1683312479231,MATH 170A,A04,188815,Nie; Jiawang,13,0,35,22
1683312480258,MATH 193B,A01,188817,Staff,0,0,35,35
1683312480258,MATH 193B,A02,188818,Staff,5,0,35,30
1683312481283,MGT 4,A01,202857,Anderson; John Charles,62,0,80,18
1683312482307,MGT 12,A00,202858,Lindenberger; Wade Douglas,43,0,90,47
1683312483331,MGT 18,A00,202859,Staff,74,0,90,16
1683312484353,MGT 18GS,A00,202860,McKay; Michael J,13,0,28,15
1683312485381,MGT 45,A00,202861,Pecore; Joseph P.,14,0,90,76
1683312486406,MGT 100,A00,202863,Yavorsky; Daniel Ryan,28,0,90,62
1683312487430,MGT 103,A00,202864,Ehrich; Kristine R,0,16,90,90
1683312488458,MGT 112,A00,202865,Ehrich; Kristine R,15,0,90,75
1683312489486,MGT 121A,A00,202868,Staff,0,19,0,0
1683312490513,MGT 131B,A00,202869,Anderson; John Charles,59,0,90,31
1683312491540,MGT 136,A00,202871,Lindenberger; Wade Douglas,84,0,90,6
1683312492564,MGT 164,A00,202873,Staff,0,69,90,90
1683312493588,MGT 164GS,A00,202874,McKay; Mary A,13,0,28,15
1683312494614,MGT 180,A00,202875,Staff,0,51,90,90
1683312495641,MMW 11R,A01,205019,Herbst; Matthew,3,0,30,27
1683312495641,MMW 11R,A02,205026,Herbst; Matthew,29,0,30,1
1683312496667,MMW 15,A01,193512,Chang; Edmond Yi-Teh,0,9,28,28
1683312496667,MMW 15,A02,193513,Chang; Edmond Yi-Teh,0,5,28,28
1683312496667,MMW 15,A03,193514,Chang; Edmond Yi-Teh,0,5,28,28
1683312496667,MMW 15,A04,193515,Chang; Edmond Yi-Teh,0,5,28,28
1683312496667,MMW 15,A05,193516,Chang; Edmond Yi-Teh,0,4,28,28
1683312496667,MMW 15,A06,193517,Chang; Edmond Yi-Teh,0,5,28,28
1683312496667,MMW 15,B01,193519,Chang; Edmond Yi-Teh,0,4,28,28
1683312496667,MMW 15,B02,193520,Chang; Edmond Yi-Teh,0,5,28,28
1683312496667,MMW 15,B03,193521,Chang; Edmond Yi-Teh,0,4,28,28
1683312496667,MMW 15,B04,193522,Chang; Edmond Yi-Teh,0,4,28,28
1683312496667,MMW 15,B05,193523,Chang; Edmond Yi-Teh,0,5,28,28
1683312496667,MMW 15,B06,193524,Chang; Edmond Yi-Teh,0,4,28,28
1683312497695,MMW 122,A01,193526,Rahimi; Babak,0,14,28,28
1683312497695,MMW 122,A02,193527,Rahimi; Babak,0,14,28,28
1683312497695,MMW 122,A03,193528,Rahimi; Babak,0,0,0,0
1683312497695,MMW 122,A04,193529,Rahimi; Babak,0,0,0,0
1683312498718,MUS 1A,A01,186663,Staff,0,20,35,35
1683312499745,MUS 4,A01,186715,Staff,0,12,35,35
1683312500773,MUS 5R,A01,186796,Dubnov; Shlomo,0,17,35,35
1683312501800,MUS 6,A01,186798,Staff,0,3,25,25
1683312502827,MUS 7,A01,186830,Staff,12,0,35,23
1683312503855,MUS 8,A01,186930,Staff,0,26,35,35
1683312504879,MUS 15,A01,186932,Staff,0,15,35,35
1683312504879,MUS 15,B01,186934,Staff,0,15,35,35
1683312505903,MUS 80,A00,186935,Staff,2,0,20,18
1683312505903,MUS 80,B00,186936,Staff,25,0,25,0
1683312506927,NANO 11,A00,204702,Lipomi; Darren John,0,0,0,0
1683312507953,NANO 15,A01,204709,Yang; Kesong,0,1,0,0
1683312508980,NANO 114,A00,202069,Jahed Motlagh; Zeinab,3,0,10,7
1683312510006,PHIL 1,A00,186955,Grush; Rick Scott,32,0,40,8
1683312511030,PHIL 10,A01,186973,Grush; Rick Scott,28,0,35,7
1683312511030,PHIL 10,A02,186974,Grush; Rick Scott,33,0,35,2
1683312512057,PHIL 13,A01,186976,Staff,7,0,35,28
1683312512057,PHIL 13,A02,186977,Staff,16,0,35,19
1683312513083,PHIL 14,A01,186979,Staff,31,0,35,4
1683312513083,PHIL 14,A02,186986,Staff,32,0,35,3
1683312514108,PHIL 28,A01,186988,Staff,16,0,30,14
1683312514108,PHIL 28,A02,186989,Staff,1,0,30,29
1683312514108,PHIL 28,A03,186990,Staff,9,0,30,21
1683312514108,PHIL 28,A04,186991,Staff,26,0,30,4
1683312515135,PHIL 120,A00,186997,Staff,23,0,40,17
1683312516159,PHIL 137,A00,187003,Staff,9,0,40,31
1683312517185,PHIL 150,A00,187015,Staff,47,0,70,23
1683312518209,PHIL 167,A00,187021,Lamey; Andy M.,35,0,40,5
1683312519234,PHIL 174,A01,202226,Staff,17,0,20,3
1683312519234,PHIL 174,A02,202235,Staff,20,0,20,0
1683312520255,PHIL 191A,A00,258918,Staff,0,0,1,1
1683312521282,PHYS 1A,A00,187028,Staff,27,0,60,33
1683312522307,PHYS 1AL,001,187036,Staff,3,0,30,27
1683312522307,PHYS 1AL,002,187049,Staff,18,0,30,12
1683312523333,PHYS 1B,A00,187058,Staff,22,0,60,38
1683312524358,PHYS 1BL,001,187064,Staff,0,0,30,30
1683312524358,PHYS 1BL,002,187070,Staff,5,0,30,25
1683312525383,PHYS 1C,A00,187082,Staff,31,0,120,89
1683312526410,PHYS 1CL,001,187088,Staff,0,9,30,30
1683312526410,PHYS 1CL,002,187089,Staff,0,2,30,30
1683312526410,PHYS 1CL,009,262693,Staff,11,0,30,19
1683312527433,PHYS 2B,A01,187097,Staff,54,0,115,61
1683312528460,PHYS 2C,A01,187099,Staff,67,0,115,48
1683312529487,PHYS 2CL,A01,187101,Staff,5,0,28,23
1683312529487,PHYS 2CL,A02,187102,Staff,15,0,28,13
1683312530510,PHYS 2D,A01,187123,Shotwell; Brian,95,0,115,20
1683312531548,PHYS 4B,A01,187133,Grinstein; Benjamin,35,0,50,15
1683312532572,POLI 10,A00,188819,Staff,0,4,50,50
1683312533595,POLI 11,A00,188827,Staff,43,0,50,7
1683312534619,POLI 13R,A00,188828,Staff,0,1,20,20
1683312535644,POLI 27,A01,188830,Elgin; Samuel Zincke,0,1,70,70
1683312536668,POLI 30,A00,188832,Desposato; Scott,32,0,50,18
1683312537693,POLI 102F,A00,188834,Staff,3,0,40,37
1683312538777,POLI 104A,A00,188852,Staff,14,0,30,16
1683312539801,POLI 104I,A00,188853,Staff,0,6,20,20
1683312540825,POLI 110B,A00,188854,Wiens; David,7,0,20,13
1683312541852,POLI 112A,A00,188855,Wiens; David,5,0,30,25
1683312542877,POLI 117R,A00,188856,Forman; Fonna,0,11,20,20
1683312543901,POLI 118,A00,188857,Ingham; Sean,8,0,20,12
1683312544924,POLI 120G,A00,188858,Staff,9,0,30,21
1683312545948,POLI 131CR,A00,188863,Hoston; Germaine,24,0,50,26
1683312546976,POLI 133,A00,188864,Nellis; Gareth Hb,44,0,50,6
1683312548006,POLI 134D,A00,188865,Desposato; Scott,27,0,30,3
1683312549030,POLI 142A,A00,188871,Gartzke; Erik,22,0,50,28
1683312550055,POLI 142K,A00,188874,Staff,38,0,50,12
1683312551080,POLI 143,A00,188940,Gartzke; Erik,16,0,30,14
1683312552104,POLI 153,A00,188943,Staff,3,0,20,17
1683312553131,POLI 160AA,A00,188944,Staff,12,0,40,28
1683312554155,POLI 170A,A00,188945,Staff,11,0,30,19
1683312556202,PSYC 1,A00,188952,Staff,37,0,90,53
1683312557227,PSYC 2,B00,188953,Staff,19,0,35,16
1683312558255,PSYC 6,A00,188970,Staff,47,0,60,13
1683312559283,PSYC 7,A00,188973,Staff,37,0,45,8
1683312560310,PSYC 60,A01,188980,Rickard; Timothy C.,43,0,60,17
1683312561336,PSYC 70,A01,189001,Steiner; Eric Tomas,24,0,45,21
1683312562364,PSYC 100,A00,189005,Lacefield; Katharine I,0,99,120,120
1683312563391,PSYC 102,A00,189008,Staff,10,0,30,20
1683312564420,PSYC 106,B00,189026,Gorman; Michael R.,36,0,60,24
1683312565443,PSYC 114,B01,189033,Winkielman; Piotr,0,32,30,30
1683312566468,PSYC 131,A00,189036,Anagnostaras; Stephan,0,43,60,60
1683312567492,PSYC 136,A00,189041,Lowe; Angela Beth,0,7,25,25
1683312568548,PSYC 137,A00,189057,Winkielman; Piotr,0,34,25,25
1683312569575,PSYC 144,A00,189107,Wixted; John T,0,7,50,50
1683312571624,PSYC 162,A00,189142,Staff,0,8,85,85
1683312572648,PSYC 172,A00,189144,Gorman; Michael R.,0,7,30,30
1683312574699,PSYC 179,A00,189146,Lacefield; Katharine I,0,84,120,120
1683312575727,PSYC 181,A00,189147,Anagnostaras; Stephan,0,44,90,90
1683312576751,PSYC 190R,A00,189148,Barner; David A.,0,22,80,80
1683312577777,PSYC 191,A00,189275,Rickard; Timothy C.,0,7,25,25
1683312578803,PSYC 193,A00,189276,Chapman; Eddie Nathaniel,0,1,0,4
1683312579828,PSYC 193L,A01,189281,Lowe; Angela Beth,12,0,20,8
1683312579828,PSYC 193L,B01,189285,Staff,28,0,35,7
1683312580852,RELI 149,A00,187137,Rahimi; Babak,7,0,40,33
1683312581875,SE 9,A01,187315,Staff,0,2,18,18
1683312582900,SE 101B,A00,187409,Staff,24,0,30,6
1683312583928,SE 110B,A00,187444,Staff,10,0,40,30
1683312584952,SE 130B,A00,187449,Staff,31,0,40,9
1683312585979,SE 150A,A00,187516,Staff,9,0,20,11
1683312587005,SE 154,A00,187528,Staff,30,0,50,20
1683312588031,SIO 3,A01,258171,Staff,35,0,40,5
1683312589058,SIO 10,A00,187144,Cook; Geoffrey W,0,3,75,75
1683312590084,SIO 45,A00,187152,Cook; Geoffrey W,1,0,100,99
1683312591107,SIO 109R,A00,194486,Staff,0,3,20,20
1683312593157,SIO 187,A01,187233,Kacev; David,12,0,40,28
1683312594186,SOCI 1,A01,258656,Thorpe; Charles Robert,28,0,30,2
1683312594186,SOCI 1,A02,258658,Thorpe; Charles Robert,30,0,30,0
1683312594186,SOCI 1,A03,258661,Thorpe; Charles Robert,25,0,25,0
1683312594186,SOCI 1,A04,258666,Thorpe; Charles Robert,22,0,25,3
1683312594186,SOCI 1,A05,258897,Thorpe; Charles Robert,23,0,25,2
1683312594186,SOCI 1,A06,258898,Thorpe; Charles Robert,25,0,25,0
1683312595214,SOCI 30,A01,258903,Pardo Guerra; Juan Pablo,16,0,30,14
1683312596238,SOCI 102,A00,258904,Staff,9,0,25,16
1683312597262,SOCI 106,A00,258905,Staff,19,0,25,6
1683312598285,SOCI 111,A00,258907,Ribas Norris; Janet Vanesa,26,0,30,4
1683312599309,SOCI 121R,A00,258908,Pardo Guerra; Juan Pablo,11,0,30,19
1683312600335,SOCI 126,A01,203330,Staff,14,0,20,6
1683312601364,SOCI 131,A00,258909,Thorpe; Charles Robert,31,0,60,29
1683312602386,SOCI 135,A00,258910,Payne; Christine Anna,0,9,30,30
1683312603411,SOCI 157,A00,258911,Staff,12,0,30,18
1683312604433,SOCI 184,A00,258912,Staff,25,0,30,5
1683312605458,SOCI 188D,A00,258913,Staff,21,0,30,9
1683312606483,SYN 2,001,187529,Staff,9,0,16,7
1683312606483,SYN 2,002,201452,Staff,0,18,16,16
1683312606483,SYN 2,003,201469,Staff,3,0,16,13
1683312607511,SYN 100,A01,187531,Staff,0,9,20,20
1683312607511,SYN 100,B01,201491,Staff,0,12,20,20
1683312608538,TDAC 1,A00,189286,Walsh; Kim C.,3,0,20,17
1683312608538,TDAC 1,B00,189287,Harting; Carla Kelso,11,0,20,9
1683312609566,TDAC 101,A00,189300,Walsh; Kim C.,16,0,20,4
1683312609566,TDAC 101,B00,189301,Harting; Carla Kelso,18,0,20,2
1683312610592,TDAC 102,A00,189304,Basso; Beatrice,14,0,20,6
1683312611618,TDAC 108,A00,189305,Staff,18,0,20,2
1683312612643,TDDE 131,A00,189310,Staff,19,0,20,1
1683312612643,TDDE 131,B00,189314,Staff,19,0,20,1
1683312612643,TDDE 131,C00,189315,Staff,48,0,50,2
1683312612643,TDDE 131,D00,189316,Staff,14,0,15,1
1683312612643,TDDE 131,E00,204841,Staff,20,0,20,0
1683312613670,TDGE 10,A00,189289,Staff,30,0,50,20
1683312613670,TDGE 10,B00,189290,Havis; Allan,2,0,50,48
1683312614698,TDGE 11,A00,189291,Fulton; Julia,0,3,50,50
1683312614698,TDGE 11,B00,189292,Staff,20,0,25,5
1683312614698,TDGE 11,C00,260270,Staff,0,0,0,0
1683312615720,TDGE 25,A00,189294,Staff,3,0,20,17
1683312616746,TDGE 124,A00,189318,Fulton; Julia,0,8,50,50
1683312617773,TDGE 125,A00,189319,Staff,13,0,25,12
1683312617773,TDGE 125,B00,189320,Staff,23,0,25,2
1683312618797,TDGE 127,A00,189322,Havis; Allan,0,0,50,50
1683312619821,TDHT 101,A00,189323,Staff,18,0,25,7
1683312619821,TDHT 101,B00,189324,Staff,25,0,25,0
1683312620845,TDHT 102,A00,189325,Staff,49,0,50,1
1683312621872,TDMV 1,A00,189295,Arcidiacono; Kristin,20,0,30,10
1683312621872,TDMV 1,B00,189296,Caligagan; Maria T.,24,0,30,6
1683312622900,TDMV 2,A00,189297,Sammartano; Tonnie,28,0,30,2
1683312622900,TDMV 2,B00,189299,Arcidiacono; Kristin,24,0,30,6
1683312623928,TDMV 3,A00,204998,Rincon; Alicia,22,0,30,8
1683312624955,TDMV 120,A00,189458,Sammartano; Tonnie,28,0,30,2
1683312625979,TDMV 138,A00,189541,Jun; Grace Shin Hae,22,0,40,18
1683312627003,TDMV 142,A00,189717,Caligagan; Tony,23,0,30,7
1683312627003,TDMV 142,B00,189718,Caligagan; Maria T.,25,0,30,5
1683312628030,TMC 2,A01,187533,Staff,25,0,25,0
1683312628030,TMC 2,A02,187534,Staff,25,0,25,0
1683312629057,USP 1,A01,187536,Kwak; Nancy,0,16,25,25
1683312630082,USP 5,A01,187538,Staff,9,0,25,16
1683312631107,USP 101,A00,199253,Staff,0,4,0,0
1683312632133,USP 124,A00,187562,Boomhower; Matthew Charles,1,0,30,29
1683312633160,USP 138,A00,187582,Staff,20,0,25,5
1683312634184,USP 152,A01,187597,Staff,4,0,25,21
1683312635209,USP 153,A00,187598,Staff,19,0,25,6
1683312636233,USP 168,A00,187607,Kwak; Nancy,2,0,5,3
1683312637257,USP 173,A00,187619,Staff,4,0,25,21
1683312638281,USP 181,A00,187638,Staff,0,0,25,25
1683312639305,VIS 103,A00,187650,Cruz; Edwin Teddy,23,0,75,52
1683312640332,VIS 110D,A00,187669,Staff,12,0,22,10
1683312641358,VIS 127C,A00,187720,Shen; Kuiyi,68,0,146,78
1683312642438,VIS 149,A00,187731,Yoldas; Pinar,0,14,22,22
1683312643464,VIS 151,A01,188091,Staff,22,0,34,12
1683312643464,VIS 151,A02,188092,Staff,11,0,34,23
1683312644490,VIS 160B,A00,188093,Stalbaum; Brett,0,0,10,10
1683312646548,WCWP 10B,A00,201720,Staff,10,0,15,5
1683312646548,WCWP 10B,B00,201722,Staff,8,0,15,7
1683312647571,WCWP 100,A00,201725,Gagnon; Jeffrey C,0,0,2,2
1683312647571,WCWP 100,B00,201727,Staff,0,4,15,15
1683312650656,ANBI 133,A00,258401,Wilder; Linnea Lorene,34,0,40,6
1683312651679,ANBI 140,A00,258395,Hrvoj Mihic; Branka,18,0,25,7
1683312652706,ANSC 120,A00,258402,Bialecki; Jon Anthony,27,0,40,13
1683312653734,ANSC 144,A00,258400,Staff,14,0,40,26
1683312655786,ANSC 166,A00,258396,Parish; Steven Martin,157,0,175,18
1683312656808,ANSC 180,A00,193533,Staff,9,0,20,11
1683312657832,ANSC 188,A00,258397,Jassal; Aftab,33,0,40,7
1683312658860,ANTH 3,A01,258316,Staff,23,0,30,7
1683312659884,ANTH 5,A00,258394,Semendeferi; Ekaterini,16,0,20,4
1683312660911,ANTH 21,A01,258331,Staff,9,0,40,31
1683312661937,ANTH 103,A00,258398,Varma; Saiba,15,0,25,10
1683312662972,AWP 10,001,202034,Staff,0,0,0,0
1683312662972,AWP 10,002,202035,Staff,0,0,0,0
1683312662972,AWP 10,003,202036,Staff,0,0,0,0
1683312662972,AWP 10,004,202037,Staff,0,0,0,0
1683312662972,AWP 10,005,202038,Staff,0,0,0,0
1683312662972,AWP 10,006,202039,Staff,0,0,0,0
1683312662972,AWP 10,007,202040,Staff,0,0,0,0
1683312662972,AWP 10,008,202041,Staff,0,0,0,0
1683312662972,AWP 10,009,202042,Staff,0,0,0,0
1683312662972,AWP 10,010,202043,Staff,0,0,0,0
1683312662972,AWP 10,011,202044,Staff,0,0,0,0
1683312662972,AWP 10,012,202045,Staff,0,0,0,0
1683312662972,AWP 10,013,202046,Staff,0,0,0,0
1683312662972,AWP 10,014,202047,Staff,0,0,0,0
1683312662972,AWP 10,015,202048,Staff,0,0,0,0
1683312662972,AWP 10,016,202049,Staff,0,0,0,0
1683312662972,AWP 10,017,202050,Staff,0,0,0,0
1683312662972,AWP 10,018,202051,Staff,0,0,0,0
1683312662972,AWP 10,019,202052,Staff,0,0,0,0
1683312662972,AWP 10,020,202053,Staff,0,0,0,0
1683312662972,AWP 10,021,202054,Staff,0,0,0,0
1683312662972,AWP 10,022,202055,Staff,0,0,0,0
1683312662972,AWP 10,023,202056,Staff,0,0,0,0
1683312662972,AWP 10,024,202057,Staff,0,0,0,0
1683312662972,AWP 10,025,202058,Staff,0,0,0,0
1683312662972,AWP 10,026,202059,Staff,0,0,0,0
1683312663995,AWP 102,001,202032,Staff,0,0,0,0
1683312663995,AWP 102,002,202033,Staff,0,0,0,0
1683312665024,BENG 100,A01,254234,Taylor Amos; Alyssa C,31,0,40,9
1683312666049,BENG 196,001,270013,Engler; Adam J.,9999,0,9999,0
1683312667074,BICD 100R,A01,202018,Smith; Laurie,0,7,32,32
1683312667074,BICD 100R,A02,202019,Smith; Laurie,0,2,32,32
1683312667074,BICD 100R,A03,202020,Smith; Laurie,0,1,32,32
1683312667074,BICD 100R,A04,202021,Smith; Laurie,8,0,32,24
1683312667074,BICD 100R,A05,202022,Smith; Laurie,12,0,32,20
1683312668099,BICD 136,A01,193242,Gustafson-Brown; Cindy,0,2,32,32
1683312668099,BICD 136,A02,193244,Gustafson-Brown; Cindy,15,0,32,17
1683312669127,BIEB 102,A01,193249,Butler; Shannon Rhey,0,2,32,32
1683312669127,BIEB 102,A02,193251,Butler; Shannon Rhey,0,0,32,32
1683312669127,BIEB 102,A03,193253,Butler; Shannon Rhey,0,1,32,32
1683312669127,BIEB 102,A04,193255,Butler; Shannon Rhey,17,0,32,15
1683312669127,BIEB 102,A05,193265,Butler; Shannon Rhey,26,0,32,6
1683312669127,BIEB 102,A06,193269,Butler; Shannon Rhey,16,0,32,16
1683312671186,BIEB 150,A01,193274,Staff,0,0,32,32
1683312671186,BIEB 150,A02,193285,Staff,24,0,32,8
1683312672211,BIEB 194,A00,193286,Kurle; Carolyn M.,22,0,32,10
1683312673239,BILD 1,A01,192291,Staff,16,0,32,16
1683312673239,BILD 1,A02,192292,Staff,30,0,32,2
1683312673239,BILD 1,B01,192520,Reuther; Keefe,0,1,0,0
1683312673239,BILD 1,B02,192532,Reuther; Keefe,0,1,0,0
1683312674264,BILD 3,A01,192556,Butler; Shannon Rhey,0,0,32,32
1683312674264,BILD 3,A02,192581,Butler; Shannon Rhey,5,0,32,27
1683312674264,BILD 3,A03,192611,Butler; Shannon Rhey,23,0,32,9
1683312674264,BILD 3,A04,192612,Butler; Shannon Rhey,25,0,32,7
1683312674264,BILD 3,A05,192613,Butler; Shannon Rhey,27,0,32,5
1683312674264,BILD 3,A06,192679,Butler; Shannon Rhey,27,0,32,5
1683312674264,BILD 3,A07,192682,Butler; Shannon Rhey,22,0,32,10
1683312675290,BILD 4,A01,192836,Reuther; Keefe,1,0,24,23
1683312675290,BILD 4,A02,193044,Reuther; Keefe,4,0,24,20
1683312676316,BILD 10,A01,193142,Gustafson-Brown; Cindy,31,0,32,1
1683312676316,BILD 10,A02,193149,Gustafson-Brown; Cindy,31,0,32,1
1683312677342,BIMM 100,A01,193301,Staff,0,6,32,32
1683312677342,BIMM 100,A02,193312,Staff,0,5,32,32
1683312677342,BIMM 100,A03,193323,Staff,0,8,32,32
1683312678380,BIMM 101,A01,193329,McDonnell; Lisa Marie,0,3,24,24
1683312678380,BIMM 101,A02,193339,McDonnell; Lisa Marie,0,2,24,24
1683312678380,BIMM 101,B01,193354,McDonnell; Lisa Marie,0,3,24,24
1683312678380,BIMM 101,B02,193357,McDonnell; Lisa Marie,0,3,24,24
1683312679407,BIMM 110,A01,193377,Tat; John,0,11,32,32
1683312679407,BIMM 110,A02,193378,Tat; John,1,9,32,31
1683312680437,BIMM 120,A01,206116,Staff,0,0,32,32
1683312680437,BIMM 120,A02,206117,Staff,8,0,32,24
1683312680437,BIMM 120,A03,206121,Staff,21,0,32,11
1683312681463,BIPN 100,A01,193393,Park; Ji Young,0,14,32,32
1683312681463,BIPN 100,A02,193402,Park; Ji Young,0,12,32,32
1683312681463,BIPN 100,A03,193413,Park; Ji Young,0,14,32,32
1683312681463,BIPN 100,A04,193414,Park; Ji Young,0,13,32,32
1683312682487,BIPN 102,A01,193429,Staff,0,0,32,32
1683312682487,BIPN 102,A02,193438,Staff,22,0,32,10
1683312683511,BIPN 106,A01,193450,Reyes Gonzalez; Catalina,0,2,40,40
1683312684540,BIPN 134,A01,193465,Cooke; James Edward,0,0,32,32
1683312684540,BIPN 134,A02,193474,Cooke; James Edward,27,0,32,5
1683312684540,BIPN 134,A03,193485,Cooke; James Edward,29,0,32,3
1683312684540,BIPN 134,A04,193486,Cooke; James Edward,21,0,32,11
1683312684540,BIPN 134,A05,193491,Cooke; James Edward,31,0,32,1
1683312684540,BIPN 134,A06,193501,Cooke; James Edward,30,0,32,2
1683312684540,BIPN 134,A07,193510,Cooke; James Edward,29,0,32,3
1683312686591,BISP 194,A00,222522,Staff,16,0,32,16
1683312687638,CAT 124,A01,202407,Staff,20,0,25,5
1683312688662,CAT 125,A00,202408,Marchisotto; Jennifer Anne,4,0,20,16
1683312689686,CAT 125R,A00,202409,Smith; Lauryn Alissa,0,11,20,20
1683312689686,CAT 125R,B00,202410,Morales; Celeste Georgianna,0,11,20,20
1683312689686,CAT 125R,C00,202411,Irwin; Matthew Joseph,0,10,20,20
1683312690713,CENG 15,A01,204712,Yang; Kesong,0,1,0,0
1683312691739,CENG 114,A00,202070,Jahed Motlagh; Zeinab,5,0,20,15
1683312692763,CGS 105,A00,185477,Wesling; Megan E.,24,0,40,16
1683312693787,CGS 106,A00,185494,Staff,13,0,22,9
1683312694810,CGS 108,A00,185495,Staff,14,0,20,6
1683312695833,CGS 114,A00,185496,Staff,13,0,18,5
1683312696856,CGS 119,A00,185501,Staff,15,0,20,5
1683312697879,CGS 120,A00,185511,Staff,13,0,20,7
1683312698904,CHEM 4,A01,184675,Bussey; Thomas J,96,0,100,4
1683312699931,CHEM 6A,A01,184677,Staff,35,0,60,25
1683312700955,CHEM 6B,A01,184679,Staff,65,0,100,35
1683312701981,CHEM 6C,A01,184681,Bussey; Thomas J,1,0,50,49
1683312701981,CHEM 6C,A02,184682,Bussey; Thomas J,34,0,50,16
1683312703006,CHEM 40A,A01,184684,Albizati; Kim F.,37,0,100,63
1683312704031,CHEM 40B,A01,184686,Albizati; Kim F.,0,20,100,100
1683312705058,CHEM 41B,A01,184690,Staff,52,0,100,48
1683312706085,COGS 3,A01,184715,Boyle; Mary E. T.,0,25,40,40
1683312707112,COGS 14B,A01,185172,Staff,0,15,38,38
1683312708138,COGS 18,A01,184736,Staff,19,0,80,61
1683312709163,COGS 100,A01,184932,Staff,0,5,73,73
1683312710187,COGS 101A,A01,184935,Staff,0,38,30,30
1683312711212,COGS 101B,A01,184944,Staff,0,2,30,30
1683312712238,COGS 101C,A01,184946,Staff,0,12,30,30
1683312713263,COGS 102A,A01,184951,Johnson; Christine M.,2,0,40,38
1683312714290,COGS 107B,A01,184953,Mooshagian; Eric Frederick,0,50,40,40
1683312715313,COGS 118B,A01,184959,Gupta; Anjum,0,48,40,40
1683312716336,COGS 153,A00,184961,Staff,0,15,30,30
1683312717362,COGS 177,A00,184962,Staff,0,21,30,30
1683312718389,COGS 187A,A01,184969,Boyle; Mary E. T.,0,17,40,40
1683312719414,COMM 10,A01,185174,Staff,0,5,25,25
1683312719414,COMM 10,A02,185189,Staff,0,5,25,25
1683312719414,COMM 10,A03,269821,Staff,0,0,0,0
1683312720440,COMM 100B,A01,185475,Staff,0,0,0,2
1683312720440,COMM 100B,A02,185476,Staff,14,0,25,11
1683312721463,COMM 100C,A01,185314,Staff,1,0,25,24
1683312721463,COMM 100C,A02,185327,Staff,19,0,25,6
1683312722487,COMM 110M,A00,185349,Staff,2,0,40,38
1683312723510,COMM 113T,A00,185352,Staff,25,0,40,15
1683312724532,COMM 114I,A00,185353,Staff,33,0,40,7
1683312725555,COMM 131,A00,185354,Staff,19,0,30,11
1683312726580,CSE 8A,A50,185358,Cao; Yingjun,0,46,10,10
1683312727611,CSE 8B,A01,185362,Staff,1,47,50,49
1683312728641,CSE 11,A01,185416,Cao; Yingjun,0,91,10,10
1683312729669,CSE 20,A01,185445,Briones; Jor-el Thomas Caparas,5,0,25,20
1683312730693,CSE 21,A01,185447,Staff,10,0,50,40
1683312731722,CSE 101,A01,185451,Staff,0,12,50,50
1683312731722,CSE 101,B01,185453,Jones; Miles E,0,11,50,50
1683312733770,CSE 141,A01,185458,Eldon; John,20,0,100,80
1683312734795,CSE 141L,A01,185461,Eldon; John,12,0,100,88
1683312735824,CSE 142,A01,185463,Staff,36,0,60,24
1683312735824,CSE 142,B01,201355,Staff,0,7,60,60
1683312736852,CSE 142L,A01,185470,Staff,36,0,60,24
1683312736852,CSE 142L,B01,201417,Staff,0,6,60,60
1683312737878,CSE 190,A00,201433,Staff,32,0,49,17
1683312738904,DOC 1,A01,259136,Strom; Megan C.,7,0,15,8
1683312738904,DOC 1,A02,259137,Strom; Megan C.,14,0,15,1
1683312738904,DOC 1,A03,259138,Strom; Megan C.,14,0,15,1
1683312738904,DOC 1,A04,259139,Strom; Megan C.,14,0,15,1
1683312739928,DOC 100D,A00,259140,Pass; Natalye Joann,17,0,25,8
1683312740953,DSGN 1,A01,184749,Rill; Bryan,0,25,30,30
1683312741983,DSGN 100,A01,185168,Staff,0,2,25,25
1683312743007,ECE 5,A01,185626,Morris; Karcher William,0,10,0,0
1683312744031,ECE 101,A01,185628,Staff,17,0,70,53
1683312745056,ECE 107,A01,185635,Baghdadchi; Saharnaz,0,0,20,20
1683312745056,ECE 107,A02,185638,Baghdadchi; Saharnaz,4,0,20,16
1683312746138,ECE 148,A01,185647,Silberman; Jack,0,0,16,16
1683312747161,ECON 1,A01,185537,Crane; Meredith Helen,54,0,70,16
1683312748193,ECON 3,A01,185549,Crane; Meredith Helen,33,0,70,37
1683312749217,ECON 4,A01,203354,Anderson; John Charles,0,4,10,10
1683312750244,ECON 100A,A01,185574,Staff,0,4,40,40
1683312751267,ECON 100B,A01,185576,Staff,0,22,40,40
1683312752292,ECON 100C,A01,185589,Newhouse; Herbert S,30,0,70,40
1683312753317,ECON 105,A00,185608,Vespa; Emanuel Ignacio,19,0,35,16
1683312754340,ECON 109,A01,185610,Shishkin; Denis,10,0,35,25
1683312755367,ECON 110A,A01,185612,Staff,11,0,40,29
1683312756394,ECON 120A,A01,185615,Staff,20,0,40,20
1683312757417,ECON 120C,A01,185617,Sun; Yixiao,0,20,70,70
1683312758441,ECON 144,A00,203346,Squires; Dale E,3,0,35,32
1683312759469,ECON 171,A01,203349,Newhouse; Herbert S,0,1,35,35
1683312760497,ECON 173A,A01,185621,Toda; Alexis Akira,21,0,35,14
1683312761522,EDS 25,A01,202413,Staff,0,1,0,0
1683312761522,EDS 25,A02,202414,Staff,0,1,0,0
1683312761522,EDS 25,A03,202415,Staff,0,0,0,0
1683312761522,EDS 25,A04,202416,Staff,0,1,0,0
1683312761522,EDS 25,A05,202439,Staff,0,0,0,0
1683312761522,EDS 25,A06,202440,Staff,0,0,0,0
1683312761522,EDS 25,B01,202631,Staff,0,0,0,0
1683312761522,EDS 25,B02,202632,Staff,0,0,0,0
1683312761522,EDS 25,B03,202639,Staff,0,0,0,0
1683312761522,EDS 25,B04,202640,Staff,0,0,0,0
1683312761522,EDS 25,B05,202643,Staff,0,0,0,0
1683312761522,EDS 25,B06,202644,Staff,0,0,0,0
1683312762546,EDS 38,A01,202659,Black; Alison Michelle,24,0,25,1
1683312763570,EDS 115,A00,202652,Staff,17,0,30,13
1683312764593,EDS 125,A00,202649,Staff,14,0,30,16
1683312765619,EDS 126,A01,203332,Staff,30,0,30,0
1683312766646,EDS 139,A00,202838,Staff,17,0,25,8
1683312767685,EDS 146,A01,202655,Staff,14,0,25,11
1683312768711,ENG 15,A00,185667,Staff,0,1,0,0
1683312768711,ENG 15,B00,185672,Staff,0,0,0,0
1683312768711,ENG 15,C00,185675,Staff,0,0,0,0
1683312768711,ENG 15,D00,185682,Staff,0,0,0,0
1683312768711,ENG 15,E00,185684,Staff,0,0,0,0
1683312769739,ETHN 103,A00,185710,Staff,0,3,35,35
1683312770766,ETHN 103A,A00,199228,Man; Simeon S,2,0,9,7
1683312771793,ETHN 109,A00,185711,Staff,18,0,35,17
1683312772821,ETHN 142,A00,185726,Staff,0,4,30,30
1683312773846,ETHN 163J,A00,199229,Man; Simeon S,5,0,8,3
1683312774872,ETHN 168,A00,185727,Staff,8,0,10,2
1683312775899,ETHN 182,A00,185728,Staff,1,0,35,34
1683312776923,ETHN 183,A00,185737,Staff,8,0,18,10
1683312777948,GLBH 111,A01,209361,Burgos; Jose L.,0,0,0,0
1683312779998,HIEU 104,A00,185792,Staff,16,0,20,4
1683312781022,HIEU 115,A00,185800,Staff,1,0,20,19
1683312782047,HIEU 128,A00,185801,Staff,0,7,20,20
1683312783073,HIEU 147,A00,185802,Staff,16,0,20,4
1683312784101,HIEU 154,A00,185823,Staff,12,0,20,8
1683312785125,HILA 102,A00,185826,Staff,13,0,20,7
1683312786152,HILD 2C,A01,185778,Staff,0,12,20,20
1683312787178,HILD 7B,A01,185780,Kwak; Nancy,0,15,32,32
1683312787178,HILD 7B,A02,185781,Kwak; Nancy,0,18,32,32
1683312788202,HILD 30,A01,185791,Staff,14,0,20,6
1683312789228,HISC 119,A00,185830,Golan; Tal,0,9,20,20
1683312790251,HITO 156GS,A00,185831,Patterson; Patrick H.,0,0,0,23
1683312791278,HIUS 103,A00,185832,Man; Simeon S,0,6,20,20
1683312792301,HIUS 117,A00,185836,Kwak; Nancy,2,0,20,18
1683312793325,HIUS 125,A00,185840,Man; Simeon S,0,0,23,23
1683312794355,HIUS 149,A00,185845,Staff,0,0,20,20
1683312795381,HUM 3,A01,185882,Zavodny; Tatiana Sophia,0,6,50,50
1683312795381,HUM 3,B01,185899,Caldwell; Michael Alan,0,19,50,50
1683312796407,HUM 3GS,A00,185900,Patterson; Patrick H.,0,0,0,23
1683312797435,HUM 4,A01,185938,Zroka; Amy Liane,31,0,50,19
1683312797435,HUM 4,B01,185956,Watkins; Eric,0,2,50,50
1683312797435,HUM 4,B02,202209,Watkins; Eric,0,2,50,50
1683312797435,HUM 4,B03,202210,Watkins; Eric,0,0,50,50
1683312798462,HUM 5,A01,185958,West; Geoffrey Scott,4,0,50,46
1683312798462,HUM 5,A02,202215,West; Geoffrey Scott,0,0,50,50
1683312799486,INTL 190,A00,185959,Gagnon; Jeffrey C,0,0,0,9
1683312799486,INTL 190,B00,185960,Lettieri; Michael Joseph,0,0,0,1
1683312800515,JAPN 180,A00,254509,Staff,5,1,30,25
1683312801544,LATI 10,A01,202853,Kennemore; Amy Michelle,5,0,35,30
1683312801544,LATI 10,A02,202854,Kennemore; Amy Michelle,1,0,35,34
1683312801544,LATI 10,A03,270054,Kennemore; Amy Michelle,30,0,30,0
1683312802572,LATI 180,A00,202855,Kennemore; Amy Michelle,11,0,20,9
1683312803599,LAWS 101,A00,201767,Golan; Tal,0,7,40,40
1683312804623,LIFR 1C,A00,185961,Staff,6,0,20,14
1683312805648,LIFR 1CX,A00,185962,Staff,7,0,20,13
1683312806675,LIFR 1D,A00,185963,Staff,9,0,20,11
1683312807699,LIFR 1DX,A00,185964,Staff,9,0,20,11
1683312808723,LIGN 101,A01,186039,Staff,43,0,50,7
1683312809749,LIGN 165,A00,186040,Staff,18,0,50,32
1683312810775,LTCS 108,A00,186041,Staff,6,0,10,4
1683312811798,LTCS 119,A00,186042,Staff,16,0,20,4
1683312812821,LTCS 130,A00,186043,Wesling; Megan E.,15,0,25,10
1683312814872,LTEA 138,A00,186119,Staff,14,0,40,26
1683312815897,LTEN 124,A00,186148,Staff,6,0,25,19
1683312816924,LTEN 178,A00,186149,Staff,7,0,15,8
1683312817948,LTEN 181,A00,186150,Blanco; John D,33,0,40,7
1683312818971,LTWL 120,A00,186160,Staff,20,0,25,5
1683312819998,LTWL 165,A00,186161,Staff,22,0,25,3
1683312821021,LTWR 100,A00,186162,Staff,0,4,15,15
1683312822048,LTWR 102,A00,186163,Doller; Ben,5,0,15,10
1683312823074,MAE 8,A01,186412,Staff,0,0,0,0
1683312824101,MAE 30B,A00,186445,Bahadori; Mohammad Yousef,83,0,100,17
1683312825124,MAE 40,A00,186592,Bewley; Thomas R,9,0,50,41
1683312826146,MAE 101B,A00,186593,Bahadori; Mohammad Yousef,81,0,100,19
1683312827173,MAE 105,A00,186594,Bandaru; Prabhakar,12,0,50,38
1683312828198,MAE 107,A00,186599,Pham; Hieu Tan,0,6,120,120
1683312829224,MAE 148,A01,186660,Silberman; Jack,3,0,16,13
1683312830248,MATH 10A,A01,188095,Staff,0,7,35,35
1683312831277,MATH 10B,A01,188097,Bowers; Adam R.,0,11,30,30
1683312831277,MATH 10B,A02,188099,Bowers; Adam R.,0,11,30,30
1683312831277,MATH 10B,B01,188104,Bowers; Adam R.,0,10,30,30
1683312831277,MATH 10B,B02,188106,Bowers; Adam R.,0,10,30,30
1683312832305,MATH 10C,A01,188111,Staff,0,18,30,30
1683312832305,MATH 10C,A02,188127,Staff,0,17,30,30
1683312832305,MATH 10C,A03,188131,Staff,0,18,30,30
1683312832305,MATH 10C,B01,188218,Staff,20,0,30,10
1683312832305,MATH 10C,B02,188244,Staff,13,0,30,17
1683312832305,MATH 10C,B03,188277,Staff,16,0,30,14
1683312833335,MATH 18,A01,188344,Bach; Quang Tran,18,0,30,12
1683312833335,MATH 18,A02,188345,Bach; Quang Tran,11,0,30,19
1683312833335,MATH 18,B01,188353,Bach; Quang Tran,10,0,30,20
1683312833335,MATH 18,B02,188354,Bach; Quang Tran,20,0,30,10
1683312834361,MATH 20A,A01,188374,Staff,13,0,35,22
1683312835388,MATH 20B,A01,188382,Ohm; Ko Woon,6,0,30,24
1683312835388,MATH 20B,A02,188383,Ohm; Ko Woon,23,0,30,7
1683312835388,MATH 20B,B01,188385,Ohm; Ko Woon,7,0,30,23
1683312835388,MATH 20B,B02,188392,Ohm; Ko Woon,22,0,30,8
1683312836417,MATH 20C,A01,188394,Harel; Guershon,10,0,30,20
1683312836417,MATH 20C,A02,188395,Harel; Guershon,14,0,30,16
1683312836417,MATH 20C,B01,188404,Harel; Guershon,5,0,30,25
1683312836417,MATH 20C,B02,188405,Harel; Guershon,19,0,30,11
1683312837447,MATH 20D,A01,188414,Hammock; Frances H,0,1,30,30
1683312837447,MATH 20D,A02,188415,Hammock; Frances H,4,0,30,26
1683312837447,MATH 20D,B01,188447,Hammock; Frances H,2,0,30,28
1683312837447,MATH 20D,B02,188486,Hammock; Frances H,8,0,30,22
1683312838475,MATH 20E,A01,188649,Staff,21,0,30,9
1683312838475,MATH 20E,A02,188650,Staff,23,0,30,7
1683312838475,MATH 20E,A03,188673,Staff,0,0,30,30
1683312839500,MATH 102,A01,188675,Staff,0,35,35,35
1683312840525,MATH 103B,A01,188681,Staff,4,0,35,31
1683312840525,MATH 103B,B01,188692,Staff,6,0,35,29
1683312841553,MATH 109,A01,188695,Salehi Golsefidy; Alireza,25,0,35,10
1683312841553,MATH 109,A02,188696,Salehi Golsefidy; Alireza,27,0,35,8
1683312842575,MATH 120A,A01,188698,Eggers; John Dietrich,6,0,35,29
1683312843600,MATH 142B,A01,188736,Ioana; Adrian,0,2,30,30
1683312843600,MATH 142B,A02,188741,Ioana; Adrian,0,1,30,30
1683312843600,MATH 142B,A03,188743,Ioana; Adrian,1,3,30,29
1683312844624,MATH 168A,A01,188790,Staff,0,9,35,35
1683312845652,MATH 170A,A01,188803,Nie; Jiawang,0,2,35,35
1683312845652,MATH 170A,A02,188811,Nie; Jiawang,0,0,35,35
1683312845652,MATH 170A,A03,188814,Nie; Jiawang,1,0,35,34
1683312845652,MATH 170A,A04,188815,Nie; Jiawang,13,0,35,22
1683312846676,MATH 193B,A01,188817,Staff,0,0,35,35
1683312846676,MATH 193B,A02,188818,Staff,5,0,35,30
1683312847714,MGT 4,A01,202857,Anderson; John Charles,62,0,80,18
1683312848740,MGT 12,A00,202858,Lindenberger; Wade Douglas,43,0,90,47
1683312849821,MGT 18,A00,202859,Staff,74,0,90,16
1683312850850,MGT 18GS,A00,202860,McKay; Michael J,13,0,28,15
1683312851874,MGT 45,A00,202861,Pecore; Joseph P.,14,0,90,76
1683312852897,MGT 100,A00,202863,Yavorsky; Daniel Ryan,28,0,90,62
1683312853924,MGT 103,A00,202864,Ehrich; Kristine R,0,16,90,90
1683312854948,MGT 112,A00,202865,Ehrich; Kristine R,15,0,90,75
1683312855974,MGT 121A,A00,202868,Staff,0,19,0,0
1683312856998,MGT 131B,A00,202869,Anderson; John Charles,59,0,90,31
1683312858024,MGT 136,A00,202871,Lindenberger; Wade Douglas,84,0,90,6
1683312859052,MGT 164,A00,202873,Staff,0,69,90,90
1683312860082,MGT 164GS,A00,202874,McKay; Mary A,13,0,28,15
1683312861106,MGT 180,A00,202875,Staff,0,51,90,90
1683312862129,MMW 11R,A01,205019,Herbst; Matthew,3,0,30,27
1683312862129,MMW 11R,A02,205026,Herbst; Matthew,29,0,30,1
1683312863160,MMW 15,A01,193512,Chang; Edmond Yi-Teh,0,9,28,28
1683312863160,MMW 15,A02,193513,Chang; Edmond Yi-Teh,0,5,28,28
1683312863160,MMW 15,A03,193514,Chang; Edmond Yi-Teh,0,5,28,28
1683312863160,MMW 15,A04,193515,Chang; Edmond Yi-Teh,0,5,28,28
1683312863160,MMW 15,A05,193516,Chang; Edmond Yi-Teh,0,4,28,28
1683312863160,MMW 15,A06,193517,Chang; Edmond Yi-Teh,0,5,28,28
1683312863160,MMW 15,B01,193519,Chang; Edmond Yi-Teh,0,4,28,28
1683312863160,MMW 15,B02,193520,Chang; Edmond Yi-Teh,0,5,28,28
1683312863160,MMW 15,B03,193521,Chang; Edmond Yi-Teh,0,4,28,28
1683312863160,MMW 15,B04,193522,Chang; Edmond Yi-Teh,0,4,28,28
1683312863160,MMW 15,B05,193523,Chang; Edmond Yi-Teh,0,5,28,28
1683312863160,MMW 15,B06,193524,Chang; Edmond Yi-Teh,0,4,28,28
1683312864186,MMW 122,A01,193526,Rahimi; Babak,0,14,28,28
1683312864186,MMW 122,A02,193527,Rahimi; Babak,0,14,28,28
1683312864186,MMW 122,A03,193528,Rahimi; Babak,0,0,0,0
1683312864186,MMW 122,A04,193529,Rahimi; Babak,0,0,0,0
1683312865211,MUS 1A,A01,186663,Staff,0,20,35,35
1683312866239,MUS 4,A01,186715,Staff,0,12,35,35
1683312867264,MUS 5R,A01,186796,Dubnov; Shlomo,0,17,35,35
1683312868288,MUS 6,A01,186798,Staff,0,3,25,25
1683312869311,MUS 7,A01,186830,Staff,12,0,35,23
1683312870339,MUS 8,A01,186930,Staff,0,26,35,35
1683312871364,MUS 15,A01,186932,Staff,0,15,35,35
1683312871364,MUS 15,B01,186934,Staff,0,15,35,35
1683312872387,MUS 80,A00,186935,Staff,2,0,20,18
1683312872387,MUS 80,B00,186936,Staff,25,0,25,0
1683312873414,NANO 11,A00,204702,Lipomi; Darren John,0,0,0,0
1683312874437,NANO 15,A01,204709,Yang; Kesong,0,1,0,0
1683312875461,NANO 114,A00,202069,Jahed Motlagh; Zeinab,3,0,10,7
1683312876485,PHIL 1,A00,186955,Grush; Rick Scott,32,0,40,8
1683312877512,PHIL 10,A01,186973,Grush; Rick Scott,28,0,35,7
1683312877512,PHIL 10,A02,186974,Grush; Rick Scott,33,0,35,2
1683312878536,PHIL 13,A01,186976,Staff,7,0,35,28
1683312878536,PHIL 13,A02,186977,Staff,16,0,35,19
1683312879560,PHIL 14,A01,186979,Staff,31,0,35,4
1683312879560,PHIL 14,A02,186986,Staff,32,0,35,3
1683312880585,PHIL 28,A01,186988,Staff,16,0,30,14
1683312880585,PHIL 28,A02,186989,Staff,1,0,30,29
1683312880585,PHIL 28,A03,186990,Staff,9,0,30,21
1683312880585,PHIL 28,A04,186991,Staff,26,0,30,4
1683312881611,PHIL 120,A00,186997,Staff,23,0,40,17
1683312882637,PHIL 137,A00,187003,Staff,9,0,40,31
1683312883665,PHIL 150,A00,187015,Staff,47,0,70,23
1683312884693,PHIL 167,A00,187021,Lamey; Andy M.,35,0,40,5
1683312885720,PHIL 174,A01,202226,Staff,17,0,20,3
1683312885720,PHIL 174,A02,202235,Staff,20,0,20,0
1683312886746,PHIL 191A,A00,258918,Staff,0,0,1,1
1683312887770,PHYS 1A,A00,187028,Staff,27,0,60,33
1683312888797,PHYS 1AL,001,187036,Staff,3,0,30,27
1683312888797,PHYS 1AL,002,187049,Staff,18,0,30,12
1683312889822,PHYS 1B,A00,187058,Staff,22,0,60,38
1683312890846,PHYS 1BL,001,187064,Staff,0,0,30,30
1683312890846,PHYS 1BL,002,187070,Staff,5,0,30,25
1683312891871,PHYS 1C,A00,187082,Staff,31,0,120,89
1683312892899,PHYS 1CL,001,187088,Staff,0,9,30,30
1683312892899,PHYS 1CL,002,187089,Staff,0,2,30,30
1683312892899,PHYS 1CL,009,262693,Staff,11,0,30,19
1683312893928,PHYS 2B,A01,187097,Staff,54,0,115,61
1683312894951,PHYS 2C,A01,187099,Staff,67,0,115,48
1683312895975,PHYS 2CL,A01,187101,Staff,5,0,28,23
1683312895975,PHYS 2CL,A02,187102,Staff,15,0,28,13
1683312897000,PHYS 2D,A01,187123,Shotwell; Brian,95,0,115,20
1683312898030,PHYS 4B,A01,187133,Grinstein; Benjamin,35,0,50,15
1683312899059,POLI 10,A00,188819,Staff,0,4,50,50
1683312900083,POLI 11,A00,188827,Staff,43,0,50,7
1683312901127,POLI 13R,A00,188828,Staff,0,1,20,20
1683312902151,POLI 27,A01,188830,Elgin; Samuel Zincke,0,1,70,70
1683312903180,POLI 30,A00,188832,Desposato; Scott,32,0,50,18
1683312904203,POLI 102F,A00,188834,Staff,3,0,40,37
1683312905231,POLI 104A,A00,188852,Staff,14,0,30,16
1683312906256,POLI 104I,A00,188853,Staff,0,6,20,20
1683312907283,POLI 110B,A00,188854,Wiens; David,7,0,20,13
1683312908307,POLI 112A,A00,188855,Wiens; David,5,0,30,25
1683312909330,POLI 117R,A00,188856,Forman; Fonna,0,11,20,20
1683312910354,POLI 118,A00,188857,Ingham; Sean,8,0,20,12
1683312911378,POLI 120G,A00,188858,Staff,9,0,30,21
1683312912405,POLI 131CR,A00,188863,Hoston; Germaine,24,0,50,26
1683312913429,POLI 133,A00,188864,Nellis; Gareth Hb,44,0,50,6
1683312914456,POLI 134D,A00,188865,Desposato; Scott,27,0,30,3
1683312915482,POLI 142A,A00,188871,Gartzke; Erik,22,0,50,28
1683312916506,POLI 142K,A00,188874,Staff,38,0,50,12
1683312917533,POLI 143,A00,188940,Gartzke; Erik,16,0,30,14
1683312918557,POLI 153,A00,188943,Staff,3,0,20,17
1683312919580,POLI 160AA,A00,188944,Staff,12,0,40,28
1683312920609,POLI 170A,A00,188945,Staff,11,0,30,19
1683312922662,PSYC 1,A00,188952,Staff,37,0,90,53
1683312923685,PSYC 2,B00,188953,Staff,19,0,35,16
1683312924709,PSYC 6,A00,188970,Staff,47,0,60,13
1683312925733,PSYC 7,A00,188973,Staff,37,0,45,8
1683312926761,PSYC 60,A01,188980,Rickard; Timothy C.,43,0,60,17
1683312927785,PSYC 70,A01,189001,Steiner; Eric Tomas,24,0,45,21
1683312928810,PSYC 100,A00,189005,Lacefield; Katharine I,0,99,120,120
1683312929838,PSYC 102,A00,189008,Staff,10,0,30,20
1683312930861,PSYC 106,B00,189026,Gorman; Michael R.,36,0,60,24
1683312931887,PSYC 114,B01,189033,Winkielman; Piotr,0,32,30,30
1683312932912,PSYC 131,A00,189036,Anagnostaras; Stephan,0,43,60,60
1683312933935,PSYC 136,A00,189041,Lowe; Angela Beth,0,7,25,25
1683312934959,PSYC 137,A00,189057,Winkielman; Piotr,0,34,25,25
1683312935983,PSYC 144,A00,189107,Wixted; John T,0,7,50,50
1683312938031,PSYC 162,A00,189142,Staff,0,8,85,85
1683312939054,PSYC 172,A00,189144,Gorman; Michael R.,0,7,30,30
1683312941105,PSYC 179,A00,189146,Lacefield; Katharine I,0,84,120,120
1683312942129,PSYC 181,A00,189147,Anagnostaras; Stephan,0,44,90,90
1683312943153,PSYC 190R,A00,189148,Barner; David A.,0,22,80,80
1683312944181,PSYC 191,A00,189275,Rickard; Timothy C.,0,7,25,25
1683312945205,PSYC 193,A00,189276,Chapman; Eddie Nathaniel,0,1,0,4
1683312946229,PSYC 193L,A01,189281,Lowe; Angela Beth,12,0,20,8
1683312946229,PSYC 193L,B01,189285,Staff,28,0,35,7
1683312947260,RELI 149,A00,187137,Rahimi; Babak,7,0,40,33
1683312948285,SE 9,A01,187315,Staff,0,2,18,18
1683312949309,SE 101B,A00,187409,Staff,24,0,30,6
1683312950333,SE 110B,A00,187444,Staff,10,0,40,30
1683312951361,SE 130B,A00,187449,Staff,31,0,40,9
1683312952387,SE 150A,A00,187516,Staff,9,0,20,11
1683312953470,SE 154,A00,187528,Staff,30,0,50,20
1683312954493,SIO 3,A01,258171,Staff,35,0,40,5
1683312955516,SIO 10,A00,187144,Cook; Geoffrey W,0,3,75,75
1683312956540,SIO 45,A00,187152,Cook; Geoffrey W,1,0,100,99
1683312957567,SIO 109R,A00,194486,Staff,0,3,20,20
1683312959621,SIO 187,A01,187233,Kacev; David,12,0,40,28
1683312960646,SOCI 1,A01,258656,Thorpe; Charles Robert,28,0,30,2
1683312960646,SOCI 1,A02,258658,Thorpe; Charles Robert,30,0,30,0
1683312960646,SOCI 1,A03,258661,Thorpe; Charles Robert,25,0,25,0
1683312960646,SOCI 1,A04,258666,Thorpe; Charles Robert,22,0,25,3
1683312960646,SOCI 1,A05,258897,Thorpe; Charles Robert,23,0,25,2
1683312960646,SOCI 1,A06,258898,Thorpe; Charles Robert,25,0,25,0
1683312961669,SOCI 30,A01,258903,Pardo Guerra; Juan Pablo,16,0,30,14
1683312962693,SOCI 102,A00,258904,Staff,9,0,25,16
1683312963717,SOCI 106,A00,258905,Staff,19,0,25,6
1683312964741,SOCI 111,A00,258907,Ribas Norris; Janet Vanesa,26,0,30,4
1683312965765,SOCI 121R,A00,258908,Pardo Guerra; Juan Pablo,11,0,30,19
1683312966789,SOCI 126,A01,203330,Staff,14,0,20,6
1683312967820,SOCI 131,A00,258909,Thorpe; Charles Robert,31,0,60,29
1683312968846,SOCI 135,A00,258910,Payne; Christine Anna,0,9,30,30
1683312969877,SOCI 157,A00,258911,Staff,12,0,30,18
1683312970903,SOCI 184,A00,258912,Staff,25,0,30,5
1683312971930,SOCI 188D,A00,258913,Staff,21,0,30,9
1683312972956,SYN 2,001,187529,Staff,9,0,16,7
1683312972956,SYN 2,002,201452,Staff,0,18,16,16
1683312972956,SYN 2,003,201469,Staff,3,0,16,13
1683312973988,SYN 100,A01,187531,Staff,0,9,20,20
1683312973988,SYN 100,B01,201491,Staff,0,12,20,20
1683312975011,TDAC 1,A00,189286,Walsh; Kim C.,3,0,20,17
1683312975011,TDAC 1,B00,189287,Harting; Carla Kelso,11,0,20,9
1683312976037,TDAC 101,A00,189300,Walsh; Kim C.,16,0,20,4
1683312976037,TDAC 101,B00,189301,Harting; Carla Kelso,18,0,20,2
1683312977063,TDAC 102,A00,189304,Basso; Beatrice,14,0,20,6
1683312978087,TDAC 108,A00,189305,Staff,18,0,20,2
1683312979117,TDDE 131,A00,189310,Staff,19,0,20,1
1683312979117,TDDE 131,B00,189314,Staff,19,0,20,1
1683312979117,TDDE 131,C00,189315,Staff,48,0,50,2
1683312979117,TDDE 131,D00,189316,Staff,14,0,15,1
1683312979117,TDDE 131,E00,204841,Staff,20,0,20,0
1683312980141,TDGE 10,A00,189289,Staff,30,0,50,20
1683312980141,TDGE 10,B00,189290,Havis; Allan,2,0,50,48
1683312981165,TDGE 11,A00,189291,Fulton; Julia,0,3,50,50
1683312981165,TDGE 11,B00,189292,Staff,20,0,25,5
1683312981165,TDGE 11,C00,260270,Staff,0,0,0,0
1683312982191,TDGE 25,A00,189294,Staff,3,0,20,17
1683312983215,TDGE 124,A00,189318,Fulton; Julia,0,8,50,50
1683312984239,TDGE 125,A00,189319,Staff,13,0,25,12
1683312984239,TDGE 125,B00,189320,Staff,23,0,25,2
1683312985263,TDGE 127,A00,189322,Havis; Allan,0,0,50,50
1683312986289,TDHT 101,A00,189323,Staff,18,0,25,7
1683312986289,TDHT 101,B00,189324,Staff,25,0,25,0
1683312987315,TDHT 102,A00,189325,Staff,49,0,50,1
1683312988338,TDMV 1,A00,189295,Arcidiacono; Kristin,20,0,30,10
1683312988338,TDMV 1,B00,189296,Caligagan; Maria T.,24,0,30,6
1683312989363,TDMV 2,A00,189297,Sammartano; Tonnie,28,0,30,2
1683312989363,TDMV 2,B00,189299,Arcidiacono; Kristin,24,0,30,6
1683312990387,TDMV 3,A00,204998,Rincon; Alicia,22,0,30,8
1683312991411,TDMV 120,A00,189458,Sammartano; Tonnie,28,0,30,2
1683312992435,TDMV 138,A00,189541,Jun; Grace Shin Hae,22,0,40,18
1683312993459,TDMV 142,A00,189717,Caligagan; Tony,23,0,30,7
1683312993459,TDMV 142,B00,189718,Caligagan; Maria T.,25,0,30,5
1683312994483,TMC 2,A01,187533,Staff,25,0,25,0
1683312994483,TMC 2,A02,187534,Staff,25,0,25,0
1683312995508,USP 1,A01,187536,Kwak; Nancy,0,16,25,25
1683312996535,USP 5,A01,187538,Staff,9,0,25,16
1683312997561,USP 101,A00,199253,Staff,0,4,0,0
1683312998585,USP 124,A00,187562,Boomhower; Matthew Charles,1,0,30,29
1683312999611,USP 138,A00,187582,Staff,20,0,25,5
1683313000635,USP 152,A01,187597,Staff,4,0,25,21
1683313001660,USP 153,A00,187598,Staff,19,0,25,6
1683313002684,USP 168,A00,187607,Kwak; Nancy,2,0,5,3
1683313003710,USP 173,A00,187619,Staff,4,0,25,21
1683313004738,USP 181,A00,187638,Staff,0,0,25,25
1683313005762,VIS 103,A00,187650,Cruz; Edwin Teddy,23,0,75,52
1683313006790,VIS 110D,A00,187669,Staff,12,0,22,10
1683313007814,VIS 127C,A00,187720,Shen; Kuiyi,68,0,146,78
1683313008842,VIS 149,A00,187731,Yoldas; Pinar,0,14,22,22
1683313009869,VIS 151,A01,188091,Staff,22,0,34,12
1683313009869,VIS 151,A02,188092,Staff,11,0,34,23
1683313010896,VIS 160B,A00,188093,Stalbaum; Brett,0,0,10,10
1683313012948,WCWP 10B,A00,201720,Staff,10,0,15,5
1683313012948,WCWP 10B,B00,201722,Staff,8,0,15,7
1683313013975,WCWP 100,A00,201725,Gagnon; Jeffrey C,0,0,2,2
1683313013975,WCWP 100,B00,201727,Staff,0,4,15,15
1683313017070,ANBI 133,A00,258401,Wilder; Linnea Lorene,34,0,40,6
1683313018094,ANBI 140,A00,258395,Hrvoj Mihic; Branka,18,0,25,7
1683313019116,ANSC 120,A00,258402,Bialecki; Jon Anthony,27,0,40,13
1683313020143,ANSC 144,A00,258400,Staff,14,0,40,26
1683313022191,ANSC 166,A00,258396,Parish; Steven Martin,157,0,175,18
1683313023214,ANSC 180,A00,193533,Staff,9,0,20,11
1683313024242,ANSC 188,A00,258397,Jassal; Aftab,33,0,40,7
1683313025267,ANTH 3,A01,258316,Staff,23,0,30,7
1683313026294,ANTH 5,A00,258394,Semendeferi; Ekaterini,16,0,20,4
1683313027318,ANTH 21,A01,258331,Staff,9,0,40,31
1683313028341,ANTH 103,A00,258398,Varma; Saiba,15,0,25,10
1683313029368,AWP 10,001,202034,Staff,0,0,0,0
1683313029368,AWP 10,002,202035,Staff,0,0,0,0
1683313029368,AWP 10,003,202036,Staff,0,0,0,0
1683313029368,AWP 10,004,202037,Staff,0,0,0,0
1683313029368,AWP 10,005,202038,Staff,0,0,0,0
1683313029368,AWP 10,006,202039,Staff,0,0,0,0
1683313029368,AWP 10,007,202040,Staff,0,0,0,0
1683313029368,AWP 10,008,202041,Staff,0,0,0,0
1683313029368,AWP 10,009,202042,Staff,0,0,0,0
1683313029368,AWP 10,010,202043,Staff,0,0,0,0
1683313029368,AWP 10,011,202044,Staff,0,0,0,0
1683313029368,AWP 10,012,202045,Staff,0,0,0,0
1683313029368,AWP 10,013,202046,Staff,0,0,0,0
1683313029368,AWP 10,014,202047,Staff,0,0,0,0
1683313029368,AWP 10,015,202048,Staff,0,0,0,0
1683313029368,AWP 10,016,202049,Staff,0,0,0,0
1683313029368,AWP 10,017,202050,Staff,0,0,0,0
1683313029368,AWP 10,018,202051,Staff,0,0,0,0
1683313029368,AWP 10,019,202052,Staff,0,0,0,0
1683313029368,AWP 10,020,202053,Staff,0,0,0,0
1683313029368,AWP 10,021,202054,Staff,0,0,0,0
1683313029368,AWP 10,022,202055,Staff,0,0,0,0
1683313029368,AWP 10,023,202056,Staff,0,0,0,0
1683313029368,AWP 10,024,202057,Staff,0,0,0,0
1683313029368,AWP 10,025,202058,Staff,0,0,0,0
1683313029368,AWP 10,026,202059,Staff,0,0,0,0
1683313030392,AWP 102,001,202032,Staff,0,0,0,0
1683313030392,AWP 102,002,202033,Staff,0,0,0,0
1683313031417,BENG 100,A01,254234,Taylor Amos; Alyssa C,31,0,40,9
1683313032444,BENG 196,001,270013,Engler; Adam J.,9999,0,9999,0
1683313033474,BICD 100R,A01,202018,Smith; Laurie,0,7,32,32
1683313033474,BICD 100R,A02,202019,Smith; Laurie,0,2,32,32
1683313033474,BICD 100R,A03,202020,Smith; Laurie,0,1,32,32
1683313033474,BICD 100R,A04,202021,Smith; Laurie,8,0,32,24
1683313033474,BICD 100R,A05,202022,Smith; Laurie,12,0,32,20
1683313034499,BICD 136,A01,193242,Gustafson-Brown; Cindy,0,2,32,32
1683313034499,BICD 136,A02,193244,Gustafson-Brown; Cindy,15,0,32,17
1683313035524,BIEB 102,A01,193249,Butler; Shannon Rhey,0,2,32,32
1683313035524,BIEB 102,A02,193251,Butler; Shannon Rhey,0,0,32,32
1683313035524,BIEB 102,A03,193253,Butler; Shannon Rhey,0,1,32,32
1683313035524,BIEB 102,A04,193255,Butler; Shannon Rhey,17,0,32,15
1683313035524,BIEB 102,A05,193265,Butler; Shannon Rhey,26,0,32,6
1683313035524,BIEB 102,A06,193269,Butler; Shannon Rhey,16,0,32,16
1683313037572,BIEB 150,A01,193274,Staff,0,0,32,32
1683313037572,BIEB 150,A02,193285,Staff,24,0,32,8
1683313038597,BIEB 194,A00,193286,Kurle; Carolyn M.,22,0,32,10
1683313039623,BILD 1,A01,192291,Staff,16,0,32,16
1683313039623,BILD 1,A02,192292,Staff,30,0,32,2
1683313039623,BILD 1,B01,192520,Reuther; Keefe,0,1,0,0
1683313039623,BILD 1,B02,192532,Reuther; Keefe,0,1,0,0
1683313040647,BILD 3,A01,192556,Butler; Shannon Rhey,0,0,32,32
1683313040647,BILD 3,A02,192581,Butler; Shannon Rhey,5,0,32,27
1683313040647,BILD 3,A03,192611,Butler; Shannon Rhey,23,0,32,9
1683313040647,BILD 3,A04,192612,Butler; Shannon Rhey,25,0,32,7
1683313040647,BILD 3,A05,192613,Butler; Shannon Rhey,27,0,32,5
1683313040647,BILD 3,A06,192679,Butler; Shannon Rhey,27,0,32,5
1683313040647,BILD 3,A07,192682,Butler; Shannon Rhey,22,0,32,10
1683313041673,BILD 4,A01,192836,Reuther; Keefe,1,0,24,23
1683313041673,BILD 4,A02,193044,Reuther; Keefe,4,0,24,20
1683313042697,BILD 10,A01,193142,Gustafson-Brown; Cindy,31,0,32,1
1683313042697,BILD 10,A02,193149,Gustafson-Brown; Cindy,31,0,32,1
1683313043725,BIMM 100,A01,193301,Staff,0,6,32,32
1683313043725,BIMM 100,A02,193312,Staff,0,5,32,32
1683313043725,BIMM 100,A03,193323,Staff,0,8,32,32
1683313044754,BIMM 101,A01,193329,McDonnell; Lisa Marie,0,3,24,24
1683313044754,BIMM 101,A02,193339,McDonnell; Lisa Marie,0,2,24,24
1683313044754,BIMM 101,B01,193354,McDonnell; Lisa Marie,0,3,24,24
1683313044754,BIMM 101,B02,193357,McDonnell; Lisa Marie,0,3,24,24
1683313045778,BIMM 110,A01,193377,Tat; John,0,11,32,32
1683313045778,BIMM 110,A02,193378,Tat; John,1,9,32,31
1683313046805,BIMM 120,A01,206116,Staff,0,0,32,32
1683313046805,BIMM 120,A02,206117,Staff,8,0,32,24
1683313046805,BIMM 120,A03,206121,Staff,21,0,32,11
1683313047829,BIPN 100,A01,193393,Park; Ji Young,0,14,32,32
1683313047829,BIPN 100,A02,193402,Park; Ji Young,0,12,32,32
1683313047829,BIPN 100,A03,193413,Park; Ji Young,0,14,32,32
1683313047829,BIPN 100,A04,193414,Park; Ji Young,0,13,32,32
1683313048856,BIPN 102,A01,193429,Staff,0,0,32,32
1683313048856,BIPN 102,A02,193438,Staff,22,0,32,10
1683313049883,BIPN 106,A01,193450,Reyes Gonzalez; Catalina,0,2,40,40
1683313050941,BIPN 134,A01,193465,Cooke; James Edward,0,0,32,32
1683313050941,BIPN 134,A02,193474,Cooke; James Edward,27,0,32,5
1683313050941,BIPN 134,A03,193485,Cooke; James Edward,29,0,32,3
1683313050941,BIPN 134,A04,193486,Cooke; James Edward,21,0,32,11
1683313050941,BIPN 134,A05,193491,Cooke; James Edward,31,0,32,1
1683313050941,BIPN 134,A06,193501,Cooke; James Edward,30,0,32,2
1683313050941,BIPN 134,A07,193510,Cooke; James Edward,29,0,32,3
1683313052994,BISP 194,A00,222522,Staff,16,0,32,16
1683313054021,CAT 124,A01,202407,Staff,20,0,25,5
1683313055045,CAT 125,A00,202408,Marchisotto; Jennifer Anne,4,0,20,16
1683313056074,CAT 125R,A00,202409,Smith; Lauryn Alissa,0,11,20,20
1683313056074,CAT 125R,B00,202410,Morales; Celeste Georgianna,0,11,20,20
1683313056074,CAT 125R,C00,202411,Irwin; Matthew Joseph,0,10,20,20
1683313057153,CENG 15,A01,204712,Yang; Kesong,0,1,0,0
1683313058177,CENG 114,A00,202070,Jahed Motlagh; Zeinab,5,0,20,15
1683313059201,CGS 105,A00,185477,Wesling; Megan E.,24,0,40,16
1683313060232,CGS 106,A00,185494,Staff,13,0,22,9
1683313061256,CGS 108,A00,185495,Staff,14,0,20,6
1683313062281,CGS 114,A00,185496,Staff,13,0,18,5
1683313063308,CGS 119,A00,185501,Staff,15,0,20,5
1683313064335,CGS 120,A00,185511,Staff,13,0,20,7
1683313065415,CHEM 4,A01,184675,Bussey; Thomas J,96,0,100,4
1683313066442,CHEM 6A,A01,184677,Staff,35,0,60,25
1683313067469,CHEM 6B,A01,184679,Staff,65,0,100,35
1683313068493,CHEM 6C,A01,184681,Bussey; Thomas J,1,0,50,49
1683313068493,CHEM 6C,A02,184682,Bussey; Thomas J,34,0,50,16
1683313069520,CHEM 40A,A01,184684,Albizati; Kim F.,37,0,100,63
1683313070544,CHEM 40B,A01,184686,Albizati; Kim F.,0,20,100,100
1683313071571,CHEM 41B,A01,184690,Staff,52,0,100,48
1683313072600,COGS 3,A01,184715,Boyle; Mary E. T.,0,25,40,40
1683313073624,COGS 14B,A01,185172,Staff,0,15,38,38
1683313074650,COGS 18,A01,184736,Staff,19,0,80,61
1683313075677,COGS 100,A01,184932,Staff,0,5,73,73
1683313076701,COGS 101A,A01,184935,Staff,0,38,30,30
1683313077726,COGS 101B,A01,184944,Staff,0,2,30,30
1683313078750,COGS 101C,A01,184946,Staff,0,12,30,30
1683313079774,COGS 102A,A01,184951,Johnson; Christine M.,2,0,40,38
1683313080797,COGS 107B,A01,184953,Mooshagian; Eric Frederick,0,50,40,40
1683313081823,COGS 118B,A01,184959,Gupta; Anjum,0,48,40,40
1683313082851,COGS 153,A00,184961,Staff,0,15,30,30
1683313083875,COGS 177,A00,184962,Staff,0,21,30,30
1683313084903,COGS 187A,A01,184969,Boyle; Mary E. T.,0,17,40,40
1683313085931,COMM 10,A01,185174,Staff,0,5,25,25
1683313085931,COMM 10,A02,185189,Staff,0,5,25,25
1683313085931,COMM 10,A03,269821,Staff,0,0,0,0
1683313086957,COMM 100B,A01,185475,Staff,0,0,0,2
1683313086957,COMM 100B,A02,185476,Staff,14,0,25,11
1683313087984,COMM 100C,A01,185314,Staff,1,0,25,24
1683313087984,COMM 100C,A02,185327,Staff,19,0,25,6
1683313089009,COMM 110M,A00,185349,Staff,2,0,40,38
1683313090037,COMM 113T,A00,185352,Staff,25,0,40,15
1683313091062,COMM 114I,A00,185353,Staff,33,0,40,7
1683313092089,COMM 131,A00,185354,Staff,19,0,30,11
1683313093117,CSE 8A,A50,185358,Cao; Yingjun,0,46,10,10
1683313094140,CSE 8B,A01,185362,Staff,1,47,50,49
1683313095164,CSE 11,A01,185416,Cao; Yingjun,0,91,10,10
1683313096189,CSE 20,A01,185445,Briones; Jor-el Thomas Caparas,5,0,25,20
1683313097218,CSE 21,A01,185447,Staff,10,0,50,40
1683313098246,CSE 101,A01,185451,Staff,0,12,50,50
1683313098246,CSE 101,B01,185453,Jones; Miles E,0,11,50,50
1683313100297,CSE 141,A01,185458,Eldon; John,20,0,100,80
1683313101325,CSE 141L,A01,185461,Eldon; John,12,0,100,88
1683313102353,CSE 142,A01,185463,Staff,36,0,60,24
1683313102353,CSE 142,B01,201355,Staff,0,7,60,60
1683313103381,CSE 142L,A01,185470,Staff,36,0,60,24
1683313103381,CSE 142L,B01,201417,Staff,0,6,60,60
1683313104405,CSE 190,A00,201433,Staff,32,0,49,17
1683313105432,DOC 1,A01,259136,Strom; Megan C.,7,0,15,8
1683313105432,DOC 1,A02,259137,Strom; Megan C.,14,0,15,1
1683313105432,DOC 1,A03,259138,Strom; Megan C.,14,0,15,1
1683313105432,DOC 1,A04,259139,Strom; Megan C.,14,0,15,1
1683313106458,DOC 100D,A00,259140,Pass; Natalye Joann,17,0,25,8
1683313107481,DSGN 1,A01,184749,Rill; Bryan,0,25,30,30
1683313108509,DSGN 100,A01,185168,Staff,0,2,25,25
1683313109539,ECE 5,A01,185626,Morris; Karcher William,0,10,0,0
1683313110563,ECE 101,A01,185628,Staff,17,0,70,53
1683313111589,ECE 107,A01,185635,Baghdadchi; Saharnaz,0,0,20,20
1683313111589,ECE 107,A02,185638,Baghdadchi; Saharnaz,4,0,20,16
1683313112615,ECE 148,A01,185647,Silberman; Jack,0,0,16,16
1683313113640,ECON 1,A01,185537,Crane; Meredith Helen,54,0,70,16
1683313114665,ECON 3,A01,185549,Crane; Meredith Helen,33,0,70,37
1683313115690,ECON 4,A01,203354,Anderson; John Charles,0,4,10,10
1683313116713,ECON 100A,A01,185574,Staff,0,4,40,40
1683313117737,ECON 100B,A01,185576,Staff,0,22,40,40
1683313118760,ECON 100C,A01,185589,Newhouse; Herbert S,30,0,70,40
1683313119787,ECON 105,A00,185608,Vespa; Emanuel Ignacio,19,0,35,16
1683313120812,ECON 109,A01,185610,Shishkin; Denis,10,0,35,25
1683313121836,ECON 110A,A01,185612,Staff,11,0,40,29
1683313122867,ECON 120A,A01,185615,Staff,20,0,40,20
1683313123890,ECON 120C,A01,185617,Sun; Yixiao,0,20,70,70
1683313124912,ECON 144,A00,203346,Squires; Dale E,3,0,35,32
1683313125940,ECON 171,A01,203349,Newhouse; Herbert S,0,1,35,35
1683313126964,ECON 173A,A01,185621,Toda; Alexis Akira,21,0,35,14
1683313127988,EDS 25,A01,202413,Staff,0,1,0,0
1683313127988,EDS 25,A02,202414,Staff,0,1,0,0
1683313127988,EDS 25,A03,202415,Staff,0,0,0,0
1683313127988,EDS 25,A04,202416,Staff,0,1,0,0
1683313127988,EDS 25,A05,202439,Staff,0,0,0,0
1683313127988,EDS 25,A06,202440,Staff,0,0,0,0
1683313127988,EDS 25,B01,202631,Staff,0,0,0,0
1683313127988,EDS 25,B02,202632,Staff,0,0,0,0
1683313127988,EDS 25,B03,202639,Staff,0,0,0,0
1683313127988,EDS 25,B04,202640,Staff,0,0,0,0
1683313127988,EDS 25,B05,202643,Staff,0,0,0,0
1683313127988,EDS 25,B06,202644,Staff,0,0,0,0
1683313129015,EDS 38,A01,202659,Black; Alison Michelle,24,0,25,1
1683313130042,EDS 115,A00,202652,Staff,17,0,30,13
1683313131067,EDS 125,A00,202649,Staff,14,0,30,16
1683313132091,EDS 126,A01,203332,Staff,30,0,30,0
1683313133115,EDS 139,A00,202838,Staff,16,0,25,9
1683313134138,EDS 146,A01,202655,Staff,14,0,25,11
1683313135161,ENG 15,A00,185667,Staff,0,1,0,0
1683313135161,ENG 15,B00,185672,Staff,0,0,0,0
1683313135161,ENG 15,C00,185675,Staff,0,0,0,0
1683313135161,ENG 15,D00,185682,Staff,0,0,0,0
1683313135161,ENG 15,E00,185684,Staff,0,0,0,0
1683313136184,ETHN 103,A00,185710,Staff,0,3,35,35
1683313137208,ETHN 103A,A00,199228,Man; Simeon S,2,0,9,7
1683313138230,ETHN 109,A00,185711,Staff,18,0,35,17
1683313139253,ETHN 142,A00,185726,Staff,0,4,30,30
1683313140278,ETHN 163J,A00,199229,Man; Simeon S,5,0,8,3
1683313141308,ETHN 168,A00,185727,Staff,8,0,10,2
1683313142332,ETHN 182,A00,185728,Staff,1,0,35,34
1683313143356,ETHN 183,A00,185737,Staff,8,0,18,10
1683313144383,GLBH 111,A01,209361,Burgos; Jose L.,0,0,0,0
1683313146435,HIEU 104,A00,185792,Staff,16,0,20,4
1683313147462,HIEU 115,A00,185800,Staff,1,0,20,19
1683313148486,HIEU 128,A00,185801,Staff,0,7,20,20
1683313149513,HIEU 147,A00,185802,Staff,16,0,20,4
1683313150541,HIEU 154,A00,185823,Staff,12,0,20,8
1683313151567,HILA 102,A00,185826,Staff,13,0,20,7
1683313152590,HILD 2C,A01,185778,Staff,0,12,20,20
1683313153616,HILD 7B,A01,185780,Kwak; Nancy,0,15,32,32
1683313153616,HILD 7B,A02,185781,Kwak; Nancy,0,18,32,32
1683313154639,HILD 30,A01,185791,Staff,14,0,20,6
1683313155662,HISC 119,A00,185830,Golan; Tal,0,9,20,20
1683313156687,HITO 156GS,A00,185831,Patterson; Patrick H.,0,0,0,23
1683313157713,HIUS 103,A00,185832,Man; Simeon S,0,6,20,20
1683313158737,HIUS 117,A00,185836,Kwak; Nancy,2,0,20,18
1683313159765,HIUS 125,A00,185840,Man; Simeon S,0,0,23,23
1683313160848,HIUS 149,A00,185845,Staff,0,0,20,20
1683313161873,HUM 3,A01,185882,Zavodny; Tatiana Sophia,0,6,50,50
1683313161873,HUM 3,B01,185899,Caldwell; Michael Alan,0,19,50,50
1683313162899,HUM 3GS,A00,185900,Patterson; Patrick H.,0,0,0,23
1683313163929,HUM 4,A01,185938,Zroka; Amy Liane,31,0,50,19
1683313163929,HUM 4,B01,185956,Watkins; Eric,0,2,50,50
1683313163929,HUM 4,B02,202209,Watkins; Eric,0,2,50,50
1683313163929,HUM 4,B03,202210,Watkins; Eric,0,0,50,50
1683313164954,HUM 5,A01,185958,West; Geoffrey Scott,4,0,50,46
1683313164954,HUM 5,A02,202215,West; Geoffrey Scott,0,0,50,50
1683313165981,INTL 190,A00,185959,Gagnon; Jeffrey C,0,0,0,9
1683313165981,INTL 190,B00,185960,Lettieri; Michael Joseph,0,0,0,1
1683313167005,JAPN 180,A00,254509,Staff,5,1,30,25
1683313168034,LATI 10,A01,202853,Kennemore; Amy Michelle,5,0,35,30
1683313168034,LATI 10,A02,202854,Kennemore; Amy Michelle,1,0,35,34
1683313168034,LATI 10,A03,270054,Kennemore; Amy Michelle,30,0,30,0
1683313169061,LATI 180,A00,202855,Kennemore; Amy Michelle,11,0,20,9
1683313170085,LAWS 101,A00,201767,Golan; Tal,0,7,40,40
1683313171111,LIFR 1C,A00,185961,Staff,6,0,20,14
1683313172136,LIFR 1CX,A00,185962,Staff,7,0,20,13
1683313173162,LIFR 1D,A00,185963,Staff,9,0,20,11
1683313174186,LIFR 1DX,A00,185964,Staff,9,0,20,11
1683313175217,LIGN 101,A01,186039,Staff,43,0,50,7
1683313176240,LIGN 165,A00,186040,Staff,18,0,50,32
1683313177264,LTCS 108,A00,186041,Staff,6,0,10,4
1683313178289,LTCS 119,A00,186042,Staff,16,0,20,4
1683313179312,LTCS 130,A00,186043,Wesling; Megan E.,15,0,25,10
1683313181360,LTEA 138,A00,186119,Staff,14,0,40,26
1683313182384,LTEN 124,A00,186148,Staff,6,0,25,19
1683313183407,LTEN 178,A00,186149,Staff,7,0,15,8
1683313184431,LTEN 181,A00,186150,Blanco; John D,33,0,40,7
1683313185457,LTWL 120,A00,186160,Staff,20,0,25,5
1683313186487,LTWL 165,A00,186161,Staff,22,0,25,3
1683313187514,LTWR 100,A00,186162,Staff,0,4,15,15
1683313188538,LTWR 102,A00,186163,Doller; Ben,5,0,15,10
1683313189562,MAE 8,A01,186412,Staff,0,0,0,0
1683313190588,MAE 30B,A00,186445,Bahadori; Mohammad Yousef,83,0,100,17
1683313191615,MAE 40,A00,186592,Bewley; Thomas R,9,0,50,41
1683313192639,MAE 101B,A00,186593,Bahadori; Mohammad Yousef,81,0,100,19
1683313193663,MAE 105,A00,186594,Bandaru; Prabhakar,12,0,50,38
1683313194690,MAE 107,A00,186599,Pham; Hieu Tan,0,6,120,120
1683313195716,MAE 148,A01,186660,Silberman; Jack,3,0,16,13
1683313196742,MATH 10A,A01,188095,Staff,0,6,35,35
1683313197771,MATH 10B,A01,188097,Bowers; Adam R.,0,11,30,30
1683313197771,MATH 10B,A02,188099,Bowers; Adam R.,0,11,30,30
1683313197771,MATH 10B,B01,188104,Bowers; Adam R.,0,10,30,30
1683313197771,MATH 10B,B02,188106,Bowers; Adam R.,0,10,30,30
1683313198796,MATH 10C,A01,188111,Staff,0,18,30,30
1683313198796,MATH 10C,A02,188127,Staff,0,17,30,30
1683313198796,MATH 10C,A03,188131,Staff,0,18,30,30
1683313198796,MATH 10C,B01,188218,Staff,20,0,30,10
1683313198796,MATH 10C,B02,188244,Staff,13,0,30,17
1683313198796,MATH 10C,B03,188277,Staff,16,0,30,14
1683313199821,MATH 18,A01,188344,Bach; Quang Tran,18,0,30,12
1683313199821,MATH 18,A02,188345,Bach; Quang Tran,11,0,30,19
1683313199821,MATH 18,B01,188353,Bach; Quang Tran,10,0,30,20
1683313199821,MATH 18,B02,188354,Bach; Quang Tran,20,0,30,10
1683313200847,MATH 20A,A01,188374,Staff,13,0,35,22
1683313201875,MATH 20B,A01,188382,Ohm; Ko Woon,6,0,30,24
1683313201875,MATH 20B,A02,188383,Ohm; Ko Woon,23,0,30,7
1683313201875,MATH 20B,B01,188385,Ohm; Ko Woon,7,0,30,23
1683313201875,MATH 20B,B02,188392,Ohm; Ko Woon,22,0,30,8
1683313202900,MATH 20C,A01,188394,Harel; Guershon,10,0,30,20
1683313202900,MATH 20C,A02,188395,Harel; Guershon,14,0,30,16
1683313202900,MATH 20C,B01,188404,Harel; Guershon,5,0,30,25
1683313202900,MATH 20C,B02,188405,Harel; Guershon,19,0,30,11
1683313203927,MATH 20D,A01,188414,Hammock; Frances H,0,1,30,30
1683313203927,MATH 20D,A02,188415,Hammock; Frances H,4,0,30,26
1683313203927,MATH 20D,B01,188447,Hammock; Frances H,2,0,30,28
1683313203927,MATH 20D,B02,188486,Hammock; Frances H,8,0,30,22
1683313204954,MATH 20E,A01,188649,Staff,21,0,30,9
1683313204954,MATH 20E,A02,188650,Staff,23,0,30,7
1683313204954,MATH 20E,A03,188673,Staff,0,0,30,30
1683313205977,MATH 102,A01,188675,Staff,0,35,35,35
1683313207003,MATH 103B,A01,188681,Staff,4,0,35,31
1683313207003,MATH 103B,B01,188692,Staff,6,0,35,29
1683313208031,MATH 109,A01,188695,Salehi Golsefidy; Alireza,25,0,35,10
1683313208031,MATH 109,A02,188696,Salehi Golsefidy; Alireza,27,0,35,8
1683313209055,MATH 120A,A01,188698,Eggers; John Dietrich,6,0,35,29
1683313210081,MATH 142B,A01,188736,Ioana; Adrian,0,2,30,30
1683313210081,MATH 142B,A02,188741,Ioana; Adrian,0,1,30,30
1683313210081,MATH 142B,A03,188743,Ioana; Adrian,1,3,30,29
1683313211107,MATH 168A,A01,188790,Staff,0,9,35,35
1683313212132,MATH 170A,A01,188803,Nie; Jiawang,0,2,35,35
1683313212132,MATH 170A,A02,188811,Nie; Jiawang,0,0,35,35
1683313212132,MATH 170A,A03,188814,Nie; Jiawang,1,0,35,34
1683313212132,MATH 170A,A04,188815,Nie; Jiawang,13,0,35,22
1683313213155,MATH 193B,A01,188817,Staff,0,0,35,35
1683313213155,MATH 193B,A02,188818,Staff,5,0,35,30
1683313214180,MGT 4,A01,202857,Anderson; John Charles,62,0,80,18
1683313215204,MGT 12,A00,202858,Lindenberger; Wade Douglas,43,0,90,47
1683313216231,MGT 18,A00,202859,Staff,74,0,90,16
1683313217255,MGT 18GS,A00,202860,McKay; Michael J,13,0,28,15
1683313218279,MGT 45,A00,202861,Pecore; Joseph P.,14,0,90,76
1683313219303,MGT 100,A00,202863,Yavorsky; Daniel Ryan,28,0,90,62
1683313220327,MGT 103,A00,202864,Ehrich; Kristine R,0,16,90,90
1683313221356,MGT 112,A00,202865,Ehrich; Kristine R,15,0,90,75
1683313222385,MGT 121A,A00,202868,Staff,0,19,0,0
1683313223413,MGT 131B,A00,202869,Anderson; John Charles,59,0,90,31
1683313224440,MGT 136,A00,202871,Lindenberger; Wade Douglas,84,0,90,6
1683313225468,MGT 164,A00,202873,Staff,0,69,90,90
1683313226500,MGT 164GS,A00,202874,McKay; Mary A,13,0,28,15
1683313227528,MGT 180,A00,202875,Staff,0,51,90,90
1683313228552,MMW 11R,A01,205019,Herbst; Matthew,3,0,30,27
1683313228552,MMW 11R,A02,205026,Herbst; Matthew,29,0,30,1
1683313229582,MMW 15,A01,193512,Chang; Edmond Yi-Teh,0,9,28,28
1683313229582,MMW 15,A02,193513,Chang; Edmond Yi-Teh,0,5,28,28
1683313229582,MMW 15,A03,193514,Chang; Edmond Yi-Teh,0,5,28,28
1683313229582,MMW 15,A04,193515,Chang; Edmond Yi-Teh,0,5,28,28
1683313229582,MMW 15,A05,193516,Chang; Edmond Yi-Teh,0,4,28,28
1683313229582,MMW 15,A06,193517,Chang; Edmond Yi-Teh,0,5,28,28
1683313229582,MMW 15,B01,193519,Chang; Edmond Yi-Teh,0,4,28,28
1683313229582,MMW 15,B02,193520,Chang; Edmond Yi-Teh,0,5,28,28
1683313229582,MMW 15,B03,193521,Chang; Edmond Yi-Teh,0,4,28,28
1683313229582,MMW 15,B04,193522,Chang; Edmond Yi-Teh,0,4,28,28
1683313229582,MMW 15,B05,193523,Chang; Edmond Yi-Teh,0,5,28,28
1683313229582,MMW 15,B06,193524,Chang; Edmond Yi-Teh,0,4,28,28
1683313230608,MMW 122,A01,193526,Rahimi; Babak,0,14,28,28
1683313230608,MMW 122,A02,193527,Rahimi; Babak,0,14,28,28
1683313230608,MMW 122,A03,193528,Rahimi; Babak,0,0,0,0
1683313230608,MMW 122,A04,193529,Rahimi; Babak,0,0,0,0
1683313231635,MUS 1A,A01,186663,Staff,0,20,35,35
1683313232663,MUS 4,A01,186715,Staff,0,12,35,35
1683313233689,MUS 5R,A01,186796,Dubnov; Shlomo,0,17,35,35
1683313234713,MUS 6,A01,186798,Staff,0,3,25,25
1683313235740,MUS 7,A01,186830,Staff,12,0,35,23
1683313236764,MUS 8,A01,186930,Staff,0,26,35,35
1683313237792,MUS 15,A01,186932,Staff,0,15,35,35
1683313237792,MUS 15,B01,186934,Staff,0,15,35,35
1683313238818,MUS 80,A00,186935,Staff,2,0,20,18
1683313238818,MUS 80,B00,186936,Staff,25,0,25,0
1683313239843,NANO 11,A00,204702,Lipomi; Darren John,0,0,0,0
1683313240866,NANO 15,A01,204709,Yang; Kesong,0,1,0,0
1683313241890,NANO 114,A00,202069,Jahed Motlagh; Zeinab,3,0,10,7
1683313242917,PHIL 1,A00,186955,Grush; Rick Scott,32,0,40,8
1683313243945,PHIL 10,A01,186973,Grush; Rick Scott,28,0,35,7
1683313243945,PHIL 10,A02,186974,Grush; Rick Scott,33,0,35,2
1683313244969,PHIL 13,A01,186976,Staff,7,0,35,28
1683313244969,PHIL 13,A02,186977,Staff,16,0,35,19
1683313245992,PHIL 14,A01,186979,Staff,31,0,35,4
1683313245992,PHIL 14,A02,186986,Staff,32,0,35,3
1683313247020,PHIL 28,A01,186988,Staff,16,0,30,14
1683313247020,PHIL 28,A02,186989,Staff,1,0,30,29
1683313247020,PHIL 28,A03,186990,Staff,9,0,30,21
1683313247020,PHIL 28,A04,186991,Staff,26,0,30,4
1683313248045,PHIL 120,A00,186997,Staff,23,0,40,17
1683313249069,PHIL 137,A00,187003,Staff,9,0,40,31
1683313250093,PHIL 150,A00,187015,Staff,47,0,70,23
1683313251121,PHIL 167,A00,187021,Lamey; Andy M.,35,0,40,5
1683313252148,PHIL 174,A01,202226,Staff,17,0,20,3
1683313252148,PHIL 174,A02,202235,Staff,20,0,20,0
1683313253177,PHIL 191A,A00,258918,Staff,0,0,1,1
1683313254205,PHYS 1A,A00,187028,Staff,27,0,60,33
1683313255228,PHYS 1AL,001,187036,Staff,3,0,30,27
1683313255228,PHYS 1AL,002,187049,Staff,18,0,30,12
1683313256252,PHYS 1B,A00,187058,Staff,22,0,60,38
1683313257279,PHYS 1BL,001,187064,Staff,0,0,30,30
1683313257279,PHYS 1BL,002,187070,Staff,5,0,30,25
1683313258302,PHYS 1C,A00,187082,Staff,31,0,120,89
1683313259327,PHYS 1CL,001,187088,Staff,0,9,30,30
1683313259327,PHYS 1CL,002,187089,Staff,0,2,30,30
1683313259327,PHYS 1CL,009,262693,Staff,11,0,30,19
1683313260351,PHYS 2B,A01,187097,Staff,54,0,115,61
1683313261381,PHYS 2C,A01,187099,Staff,67,0,115,48
1683313262410,PHYS 2CL,A01,187101,Staff,5,0,28,23
1683313262410,PHYS 2CL,A02,187102,Staff,15,0,28,13
1683313263434,PHYS 2D,A01,187123,Shotwell; Brian,95,0,115,20
1683313264518,PHYS 4B,A01,187133,Grinstein; Benjamin,35,0,50,15
1683313265544,POLI 10,A00,188819,Staff,0,4,50,50
1683313266570,POLI 11,A00,188827,Staff,43,0,50,7
1683313267597,POLI 13R,A00,188828,Staff,0,1,20,20
1683313268625,POLI 27,A01,188830,Elgin; Samuel Zincke,0,1,70,70
1683313269650,POLI 30,A00,188832,Desposato; Scott,32,0,50,18
1683313270677,POLI 102F,A00,188834,Staff,3,0,40,37
1683313271703,POLI 104A,A00,188852,Staff,14,0,30,16
1683313272727,POLI 104I,A00,188853,Staff,0,6,20,20
1683313273750,POLI 110B,A00,188854,Wiens; David,7,0,20,13
1683313274802,POLI 112A,A00,188855,Wiens; David,5,0,30,25
1683313275830,POLI 117R,A00,188856,Forman; Fonna,0,11,20,20
1683313276853,POLI 118,A00,188857,Ingham; Sean,8,0,20,12
1683313277878,POLI 120G,A00,188858,Staff,9,0,30,21
1683313278903,POLI 131CR,A00,188863,Hoston; Germaine,24,0,50,26
1683313279935,POLI 133,A00,188864,Nellis; Gareth Hb,44,0,50,6
1683313280962,POLI 134D,A00,188865,Desposato; Scott,27,0,30,3
1683313281989,POLI 142A,A00,188871,Gartzke; Erik,22,0,50,28
1683313283016,POLI 142K,A00,188874,Staff,38,0,50,12
1683313284042,POLI 143,A00,188940,Gartzke; Erik,16,0,30,14
1683313285069,POLI 153,A00,188943,Staff,3,0,20,17
1683313286093,POLI 160AA,A00,188944,Staff,12,0,40,28
1683313287117,POLI 170A,A00,188945,Staff,11,0,30,19
1683313289166,PSYC 1,A00,188952,Staff,37,0,90,53
1683313290191,PSYC 2,B00,188953,Staff,19,0,35,16
1683313291213,PSYC 6,A00,188970,Staff,47,0,60,13
1683313292241,PSYC 7,A00,188973,Staff,37,0,45,8
1683313293270,PSYC 60,A01,188980,Rickard; Timothy C.,43,0,60,17
1683313294295,PSYC 70,A01,189001,Steiner; Eric Tomas,24,0,45,21
1683313295318,PSYC 100,A00,189005,Lacefield; Katharine I,0,99,120,120
1683313296343,PSYC 102,A00,189008,Staff,10,0,30,20
1683313297368,PSYC 106,B00,189026,Gorman; Michael R.,36,0,60,24
1683313298393,PSYC 114,B01,189033,Winkielman; Piotr,0,32,30,30
1683313299417,PSYC 131,A00,189036,Anagnostaras; Stephan,0,43,60,60
1683313300440,PSYC 136,A00,189041,Lowe; Angela Beth,0,7,25,25
1683313301463,PSYC 137,A00,189057,Winkielman; Piotr,0,34,25,25
1683313302491,PSYC 144,A00,189107,Wixted; John T,0,7,50,50
1683313304540,PSYC 162,A00,189142,Staff,0,8,85,85
1683313305565,PSYC 172,A00,189144,Gorman; Michael R.,0,7,30,30
1683313307613,PSYC 179,A00,189146,Lacefield; Katharine I,0,84,120,120
1683313308636,PSYC 181,A00,189147,Anagnostaras; Stephan,0,44,90,90
1683313309660,PSYC 190R,A00,189148,Barner; David A.,0,22,80,80
1683313310684,PSYC 191,A00,189275,Rickard; Timothy C.,0,7,25,25
1683313311708,PSYC 193,A00,189276,Chapman; Eddie Nathaniel,0,1,0,4
1683313312736,PSYC 193L,A01,189281,Lowe; Angela Beth,12,0,20,8
1683313312736,PSYC 193L,B01,189285,Staff,28,0,35,7
1683313313762,RELI 149,A00,187137,Rahimi; Babak,7,0,40,33
1683313314787,SE 9,A01,187315,Staff,0,2,18,18
1683313315811,SE 101B,A00,187409,Staff,24,0,30,6
1683313316835,SE 110B,A00,187444,Staff,10,0,40,30
1683313317862,SE 130B,A00,187449,Staff,31,0,40,9
1683313318886,SE 150A,A00,187516,Staff,9,0,20,11
1683313319911,SE 154,A00,187528,Staff,30,0,50,20
1683313320939,SIO 3,A01,258171,Staff,35,0,40,5
1683313321965,SIO 10,A00,187144,Cook; Geoffrey W,0,3,75,75
1683313322989,SIO 45,A00,187152,Cook; Geoffrey W,1,0,100,99
1683313324016,SIO 109R,A00,194486,Staff,0,3,20,20
1683313326065,SIO 187,A01,187233,Kacev; David,12,0,40,28
1683313327088,SOCI 1,A01,258656,Thorpe; Charles Robert,28,0,30,2
1683313327088,SOCI 1,A02,258658,Thorpe; Charles Robert,30,0,30,0
1683313327088,SOCI 1,A03,258661,Thorpe; Charles Robert,25,0,25,0
1683313327088,SOCI 1,A04,258666,Thorpe; Charles Robert,22,0,25,3
1683313327088,SOCI 1,A05,258897,Thorpe; Charles Robert,23,0,25,2
1683313327088,SOCI 1,A06,258898,Thorpe; Charles Robert,25,0,25,0
1683313328112,SOCI 30,A01,258903,Pardo Guerra; Juan Pablo,16,0,30,14
1683313329146,SOCI 102,A00,258904,Staff,9,0,25,16
1683313330173,SOCI 106,A00,258905,Staff,19,0,25,6
1683313331199,SOCI 111,A00,258907,Ribas Norris; Janet Vanesa,26,0,30,4
1683313332223,SOCI 121R,A00,258908,Pardo Guerra; Juan Pablo,11,0,30,19
1683313333249,SOCI 126,A01,203330,Staff,14,0,20,6
1683313334274,SOCI 131,A00,258909,Thorpe; Charles Robert,31,0,60,29
1683313335297,SOCI 135,A00,258910,Payne; Christine Anna,0,9,30,30
1683313336326,SOCI 157,A00,258911,Staff,12,0,30,18
1683313337358,SOCI 184,A00,258912,Staff,25,0,30,5
1683313338385,SOCI 188D,A00,258913,Staff,21,0,30,9
1683313339410,SYN 2,001,187529,Staff,9,0,16,7
1683313339410,SYN 2,002,201452,Staff,0,18,16,16
1683313339410,SYN 2,003,201469,Staff,3,0,16,13
1683313340438,SYN 100,A01,187531,Staff,0,9,20,20
1683313340438,SYN 100,B01,201491,Staff,0,12,20,20
1683313341463,TDAC 1,A00,189286,Walsh; Kim C.,3,0,20,17
1683313341463,TDAC 1,B00,189287,Harting; Carla Kelso,11,0,20,9
1683313342488,TDAC 101,A00,189300,Walsh; Kim C.,16,0,20,4
1683313342488,TDAC 101,B00,189301,Harting; Carla Kelso,18,0,20,2
1683313343511,TDAC 102,A00,189304,Basso; Beatrice,14,0,20,6
1683313344537,TDAC 108,A00,189305,Staff,18,0,20,2
1683313345566,TDDE 131,A00,189310,Staff,19,0,20,1
1683313345566,TDDE 131,B00,189314,Staff,19,0,20,1
1683313345566,TDDE 131,C00,189315,Staff,48,0,50,2
1683313345566,TDDE 131,D00,189316,Staff,14,0,15,1
1683313345566,TDDE 131,E00,204841,Staff,20,0,20,0
1683313346597,TDGE 10,A00,189289,Staff,30,0,50,20
1683313346597,TDGE 10,B00,189290,Havis; Allan,2,0,50,48
1683313347622,TDGE 11,A00,189291,Fulton; Julia,0,3,50,50
1683313347622,TDGE 11,B00,189292,Staff,20,0,25,5
1683313347622,TDGE 11,C00,260270,Staff,0,0,0,0
1683313348649,TDGE 25,A00,189294,Staff,3,0,20,17
1683313349674,TDGE 124,A00,189318,Fulton; Julia,0,8,50,50
1683313350698,TDGE 125,A00,189319,Staff,13,0,25,12
1683313350698,TDGE 125,B00,189320,Staff,23,0,25,2
1683313351722,TDGE 127,A00,189322,Havis; Allan,0,0,50,50
1683313352746,TDHT 101,A00,189323,Staff,18,0,25,7
1683313352746,TDHT 101,B00,189324,Staff,25,0,25,0
1683313353773,TDHT 102,A00,189325,Staff,49,0,50,1
1683313354800,TDMV 1,A00,189295,Arcidiacono; Kristin,20,0,30,10
1683313354800,TDMV 1,B00,189296,Caligagan; Maria T.,24,0,30,6
1683313355827,TDMV 2,A00,189297,Sammartano; Tonnie,28,0,30,2
1683313355827,TDMV 2,B00,189299,Arcidiacono; Kristin,24,0,30,6
1683313356852,TDMV 3,A00,204998,Rincon; Alicia,22,0,30,8
1683313357875,TDMV 120,A00,189458,Sammartano; Tonnie,28,0,30,2
1683313358899,TDMV 138,A00,189541,Jun; Grace Shin Hae,22,0,40,18
1683313359924,TDMV 142,A00,189717,Caligagan; Tony,23,0,30,7
1683313359924,TDMV 142,B00,189718,Caligagan; Maria T.,25,0,30,5
1683313360952,TMC 2,A01,187533,Staff,25,0,25,0
1683313360952,TMC 2,A02,187534,Staff,25,0,25,0
1683313361979,USP 1,A01,187536,Kwak; Nancy,0,16,25,25
1683313363005,USP 5,A01,187538,Staff,9,0,25,16
1683313364032,USP 101,A00,199253,Staff,0,4,0,0
1683313365059,USP 124,A00,187562,Boomhower; Matthew Charles,1,0,30,29
1683313366082,USP 138,A00,187582,Staff,20,0,25,5
1683313367109,USP 152,A01,187597,Staff,4,0,25,21
1683313368195,USP 153,A00,187598,Staff,19,0,25,6
1683313369221,USP 168,A00,187607,Kwak; Nancy,2,0,5,3
1683313370245,USP 173,A00,187619,Staff,4,0,25,21
1683313371270,USP 181,A00,187638,Staff,0,0,25,25
1683313372303,VIS 103,A00,187650,Cruz; Edwin Teddy,23,0,75,52
1683313373327,VIS 110D,A00,187669,Staff,12,0,22,10
1683313374357,VIS 127C,A00,187720,Shen; Kuiyi,68,0,146,78
1683313375381,VIS 149,A00,187731,Yoldas; Pinar,0,14,22,22
1683313376408,VIS 151,A01,188091,Staff,22,0,34,12
1683313376408,VIS 151,A02,188092,Staff,11,0,34,23
1683313377434,VIS 160B,A00,188093,Stalbaum; Brett,0,0,10,10
1683313379485,WCWP 10B,A00,201720,Staff,10,0,15,5
1683313379485,WCWP 10B,B00,201722,Staff,8,0,15,7
1683313380510,WCWP 100,A00,201725,Gagnon; Jeffrey C,0,0,2,2
1683313380510,WCWP 100,B00,201727,Staff,0,4,15,15
1683313383638,ANBI 133,A00,258401,Wilder; Linnea Lorene,34,0,40,6
1683313384662,ANBI 140,A00,258395,Hrvoj Mihic; Branka,18,0,25,7
1683313385686,ANSC 120,A00,258402,Bialecki; Jon Anthony,27,0,40,13
1683313386713,ANSC 144,A00,258400,Staff,14,0,40,26
1683313388765,ANSC 166,A00,258396,Parish; Steven Martin,157,0,175,18
1683313389789,ANSC 180,A00,193533,Staff,9,0,20,11
1683313390815,ANSC 188,A00,258397,Jassal; Aftab,33,0,40,7
1683313391839,ANTH 3,A01,258316,Staff,23,0,30,7
1683313392866,ANTH 5,A00,258394,Semendeferi; Ekaterini,16,0,20,4
1683313393894,ANTH 21,A01,258331,Staff,9,0,40,31
1683313394920,ANTH 103,A00,258398,Varma; Saiba,15,0,25,10
1683313395951,AWP 10,001,202034,Staff,0,0,0,0
1683313395951,AWP 10,002,202035,Staff,0,0,0,0
1683313395951,AWP 10,003,202036,Staff,0,0,0,0
1683313395951,AWP 10,004,202037,Staff,0,0,0,0
1683313395951,AWP 10,005,202038,Staff,0,0,0,0
1683313395951,AWP 10,006,202039,Staff,0,0,0,0
1683313395951,AWP 10,007,202040,Staff,0,0,0,0
1683313395951,AWP 10,008,202041,Staff,0,0,0,0
1683313395951,AWP 10,009,202042,Staff,0,0,0,0
1683313395951,AWP 10,010,202043,Staff,0,0,0,0
1683313395951,AWP 10,011,202044,Staff,0,0,0,0
1683313395951,AWP 10,012,202045,Staff,0,0,0,0
1683313395951,AWP 10,013,202046,Staff,0,0,0,0
1683313395951,AWP 10,014,202047,Staff,0,0,0,0
1683313395951,AWP 10,015,202048,Staff,0,0,0,0
1683313395951,AWP 10,016,202049,Staff,0,0,0,0
1683313395951,AWP 10,017,202050,Staff,0,0,0,0
1683313395951,AWP 10,018,202051,Staff,0,0,0,0
1683313395951,AWP 10,019,202052,Staff,0,0,0,0
1683313395951,AWP 10,020,202053,Staff,0,0,0,0
1683313395951,AWP 10,021,202054,Staff,0,0,0,0
1683313395951,AWP 10,022,202055,Staff,0,0,0,0
1683313395951,AWP 10,023,202056,Staff,0,0,0,0
1683313395951,AWP 10,024,202057,Staff,0,0,0,0
1683313395951,AWP 10,025,202058,Staff,0,0,0,0
1683313395951,AWP 10,026,202059,Staff,0,0,0,0
1683313396975,AWP 102,001,202032,Staff,0,0,0,0
1683313396975,AWP 102,002,202033,Staff,0,0,0,0
1683313397999,BENG 100,A01,254234,Taylor Amos; Alyssa C,31,0,40,9
1683313399022,BENG 196,001,270013,Engler; Adam J.,9999,0,9999,0
1683313400061,BICD 100R,A01,202018,Smith; Laurie,0,7,32,32
1683313400061,BICD 100R,A02,202019,Smith; Laurie,0,2,32,32
1683313400061,BICD 100R,A03,202020,Smith; Laurie,0,1,32,32
1683313400061,BICD 100R,A04,202021,Smith; Laurie,8,0,32,24
1683313400061,BICD 100R,A05,202022,Smith; Laurie,12,0,32,20
1683313401085,BICD 136,A01,193242,Gustafson-Brown; Cindy,0,2,32,32
1683313401085,BICD 136,A02,193244,Gustafson-Brown; Cindy,15,0,32,17
1683313402116,BIEB 102,A01,193249,Butler; Shannon Rhey,0,2,32,32
1683313402116,BIEB 102,A02,193251,Butler; Shannon Rhey,0,0,32,32
1683313402116,BIEB 102,A03,193253,Butler; Shannon Rhey,0,1,32,32
1683313402116,BIEB 102,A04,193255,Butler; Shannon Rhey,17,0,32,15
1683313402116,BIEB 102,A05,193265,Butler; Shannon Rhey,26,0,32,6
1683313402116,BIEB 102,A06,193269,Butler; Shannon Rhey,16,0,32,16
1683313404169,BIEB 150,A01,193274,Staff,0,0,32,32
1683313404169,BIEB 150,A02,193285,Staff,24,0,32,8
1683313405193,BIEB 194,A00,193286,Kurle; Carolyn M.,22,0,32,10
1683313406222,BILD 1,A01,192291,Staff,16,0,32,16
1683313406222,BILD 1,A02,192292,Staff,30,0,32,2
1683313406222,BILD 1,B01,192520,Reuther; Keefe,0,1,0,0
1683313406222,BILD 1,B02,192532,Reuther; Keefe,0,1,0,0
1683313407247,BILD 3,A01,192556,Butler; Shannon Rhey,0,0,32,32
1683313407247,BILD 3,A02,192581,Butler; Shannon Rhey,5,0,32,27
1683313407247,BILD 3,A03,192611,Butler; Shannon Rhey,23,0,32,9
1683313407247,BILD 3,A04,192612,Butler; Shannon Rhey,25,0,32,7
1683313407247,BILD 3,A05,192613,Butler; Shannon Rhey,27,0,32,5
1683313407247,BILD 3,A06,192679,Butler; Shannon Rhey,27,0,32,5
1683313407247,BILD 3,A07,192682,Butler; Shannon Rhey,22,0,32,10
1683313408271,BILD 4,A01,192836,Reuther; Keefe,1,0,24,23
1683313408271,BILD 4,A02,193044,Reuther; Keefe,4,0,24,20
1683313409296,BILD 10,A01,193142,Gustafson-Brown; Cindy,31,0,32,1
1683313409296,BILD 10,A02,193149,Gustafson-Brown; Cindy,31,0,32,1
1683313410320,BIMM 100,A01,193301,Staff,0,6,32,32
1683313410320,BIMM 100,A02,193312,Staff,0,5,32,32
1683313410320,BIMM 100,A03,193323,Staff,0,8,32,32
1683313411345,BIMM 101,A01,193329,McDonnell; Lisa Marie,0,3,24,24
1683313411345,BIMM 101,A02,193339,McDonnell; Lisa Marie,0,2,24,24
1683313411345,BIMM 101,B01,193354,McDonnell; Lisa Marie,0,3,24,24
1683313411345,BIMM 101,B02,193357,McDonnell; Lisa Marie,0,3,24,24
1683313412373,BIMM 110,A01,193377,Tat; John,0,11,32,32
1683313412373,BIMM 110,A02,193378,Tat; John,1,9,32,31
1683313413398,BIMM 120,A01,206116,Staff,0,0,32,32
1683313413398,BIMM 120,A02,206117,Staff,8,0,32,24
1683313413398,BIMM 120,A03,206121,Staff,21,0,32,11
1683313414422,BIPN 100,A01,193393,Park; Ji Young,0,14,32,32
1683313414422,BIPN 100,A02,193402,Park; Ji Young,0,12,32,32
1683313414422,BIPN 100,A03,193413,Park; Ji Young,0,14,32,32
1683313414422,BIPN 100,A04,193414,Park; Ji Young,0,13,32,32
1683313415446,BIPN 102,A01,193429,Staff,0,0,32,32
1683313415446,BIPN 102,A02,193438,Staff,22,0,32,10
1683313416470,BIPN 106,A01,193450,Reyes Gonzalez; Catalina,0,2,40,40
1683313417495,BIPN 134,A01,193465,Cooke; James Edward,0,0,32,32
1683313417495,BIPN 134,A02,193474,Cooke; James Edward,27,0,32,5
1683313417495,BIPN 134,A03,193485,Cooke; James Edward,29,0,32,3
1683313417495,BIPN 134,A04,193486,Cooke; James Edward,21,0,32,11
1683313417495,BIPN 134,A05,193491,Cooke; James Edward,31,0,32,1
1683313417495,BIPN 134,A06,193501,Cooke; James Edward,30,0,32,2
1683313417495,BIPN 134,A07,193510,Cooke; James Edward,29,0,32,3
1683313419545,BISP 194,A00,222522,Staff,16,0,32,16
1683313420574,CAT 124,A01,202407,Staff,20,0,25,5
1683313421601,CAT 125,A00,202408,Marchisotto; Jennifer Anne,4,0,20,16
1683313422630,CAT 125R,A00,202409,Smith; Lauryn Alissa,0,11,20,20
1683313422630,CAT 125R,B00,202410,Morales; Celeste Georgianna,0,11,20,20
1683313422630,CAT 125R,C00,202411,Irwin; Matthew Joseph,0,10,20,20
1683313423654,CENG 15,A01,204712,Yang; Kesong,0,1,0,0
1683313424682,CENG 114,A00,202070,Jahed Motlagh; Zeinab,5,0,20,15
1683313425706,CGS 105,A00,185477,Wesling; Megan E.,24,0,40,16
1683313426729,CGS 106,A00,185494,Staff,13,0,22,9
1683313427755,CGS 108,A00,185495,Staff,14,0,20,6
1683313428779,CGS 114,A00,185496,Staff,13,0,18,5
1683313429803,CGS 119,A00,185501,Staff,15,0,20,5
1683313430827,CGS 120,A00,185511,Staff,13,0,20,7
1683313431853,CHEM 4,A01,184675,Bussey; Thomas J,96,0,100,4
1683313432877,CHEM 6A,A01,184677,Staff,35,0,60,25
1683313433901,CHEM 6B,A01,184679,Staff,65,0,100,35
1683313434930,CHEM 6C,A01,184681,Bussey; Thomas J,1,0,50,49
1683313434930,CHEM 6C,A02,184682,Bussey; Thomas J,34,0,50,16
1683313435954,CHEM 40A,A01,184684,Albizati; Kim F.,37,0,100,63
1683313436979,CHEM 40B,A01,184686,Albizati; Kim F.,0,20,100,100
1683313438007,CHEM 41B,A01,184690,Staff,52,0,100,48
1683313439031,COGS 3,A01,184715,Boyle; Mary E. T.,0,25,40,40
1683313440059,COGS 14B,A01,185172,Staff,0,15,38,38
1683313441090,COGS 18,A01,184736,Staff,19,0,80,61
1683313442113,COGS 100,A01,184932,Staff,0,5,73,73
1683313443138,COGS 101A,A01,184935,Staff,0,38,30,30
1683313444161,COGS 101B,A01,184944,Staff,0,2,30,30
1683313445186,COGS 101C,A01,184946,Staff,0,12,30,30
1683313446211,COGS 102A,A01,184951,Johnson; Christine M.,2,0,40,38
1683313447237,COGS 107B,A01,184953,Mooshagian; Eric Frederick,0,50,40,40
1683313448265,COGS 118B,A01,184959,Gupta; Anjum,0,48,40,40
1683313449289,COGS 153,A00,184961,Staff,0,15,30,30
1683313450315,COGS 177,A00,184962,Staff,0,21,30,30
1683313451341,COGS 187A,A01,184969,Boyle; Mary E. T.,0,17,40,40
1683313452369,COMM 10,A01,185174,Staff,0,5,25,25
1683313452369,COMM 10,A02,185189,Staff,0,5,25,25
1683313452369,COMM 10,A03,269821,Staff,0,0,0,0
1683313453394,COMM 100B,A01,185475,Staff,0,0,0,2
1683313453394,COMM 100B,A02,185476,Staff,14,0,25,11
1683313454421,COMM 100C,A01,185314,Staff,1,0,25,24
1683313454421,COMM 100C,A02,185327,Staff,19,0,25,6
1683313455448,COMM 110M,A00,185349,Staff,2,0,40,38
1683313456478,COMM 113T,A00,185352,Staff,25,0,40,15
1683313457502,COMM 114I,A00,185353,Staff,33,0,40,7
1683313458526,COMM 131,A00,185354,Staff,19,0,30,11
1683313459551,CSE 8A,A50,185358,Cao; Yingjun,0,46,10,10
1683313460577,CSE 8B,A01,185362,Staff,1,47,50,49
1683313461606,CSE 11,A01,185416,Cao; Yingjun,0,91,10,10
1683313462630,CSE 20,A01,185445,Briones; Jor-el Thomas Caparas,5,0,25,20
1683313463654,CSE 21,A01,185447,Staff,10,0,50,40
1683313464685,CSE 101,A01,185451,Staff,0,12,50,50
1683313464685,CSE 101,B01,185453,Jones; Miles E,0,11,50,50
1683313466738,CSE 141,A01,185458,Eldon; John,20,0,100,80
1683313467761,CSE 141L,A01,185461,Eldon; John,12,0,100,88
1683313468799,CSE 142,A01,185463,Staff,36,0,60,24
1683313468799,CSE 142,B01,201355,Staff,0,7,60,60
1683313469824,CSE 142L,A01,185470,Staff,36,0,60,24
1683313469824,CSE 142L,B01,201417,Staff,0,6,60,60
1683313470849,CSE 190,A00,201433,Staff,32,0,49,17
1683313471933,DOC 1,A01,259136,Strom; Megan C.,7,0,15,8
1683313471933,DOC 1,A02,259137,Strom; Megan C.,14,0,15,1
1683313471933,DOC 1,A03,259138,Strom; Megan C.,14,0,15,1
1683313471933,DOC 1,A04,259139,Strom; Megan C.,14,0,15,1
1683313472960,DOC 100D,A00,259140,Pass; Natalye Joann,17,0,25,8
1683313473987,DSGN 1,A01,184749,Rill; Bryan,0,25,30,30
1683313475014,DSGN 100,A01,185168,Staff,0,2,25,25
1683313476037,ECE 5,A01,185626,Morris; Karcher William,0,10,0,0
1683313477061,ECE 101,A01,185628,Staff,17,0,70,53
1683313478089,ECE 107,A01,185635,Baghdadchi; Saharnaz,0,0,20,20
1683313478089,ECE 107,A02,185638,Baghdadchi; Saharnaz,4,0,20,16
1683313479113,ECE 148,A01,185647,Silberman; Jack,0,0,16,16
1683313480138,ECON 1,A01,185537,Crane; Meredith Helen,54,0,70,16
1683313481162,ECON 3,A01,185549,Crane; Meredith Helen,33,0,70,37
1683313482186,ECON 4,A01,203354,Anderson; John Charles,0,4,10,10
1683313483209,ECON 100A,A01,185574,Staff,0,4,40,40
1683313484234,ECON 100B,A01,185576,Staff,0,22,40,40
1683313485262,ECON 100C,A01,185589,Newhouse; Herbert S,30,0,70,40
1683313486286,ECON 105,A00,185608,Vespa; Emanuel Ignacio,19,0,35,16
1683313487317,ECON 109,A01,185610,Shishkin; Denis,10,0,35,25
1683313488341,ECON 110A,A01,185612,Staff,11,0,40,29
1683313489369,ECON 120A,A01,185615,Staff,20,0,40,20
1683313490394,ECON 120C,A01,185617,Sun; Yixiao,0,20,70,70
1683313491418,ECON 144,A00,203346,Squires; Dale E,3,0,35,32
1683313492444,ECON 171,A01,203349,Newhouse; Herbert S,0,1,35,35
1683313493469,ECON 173A,A01,185621,Toda; Alexis Akira,21,0,35,14
1683313494494,EDS 25,A01,202413,Staff,0,1,0,0
1683313494494,EDS 25,A02,202414,Staff,0,1,0,0
1683313494494,EDS 25,A03,202415,Staff,0,0,0,0
1683313494494,EDS 25,A04,202416,Staff,0,1,0,0
1683313494494,EDS 25,A05,202439,Staff,0,0,0,0
1683313494494,EDS 25,A06,202440,Staff,0,0,0,0
1683313494494,EDS 25,B01,202631,Staff,0,0,0,0
1683313494494,EDS 25,B02,202632,Staff,0,0,0,0
1683313494494,EDS 25,B03,202639,Staff,0,0,0,0
1683313494494,EDS 25,B04,202640,Staff,0,0,0,0
1683313494494,EDS 25,B05,202643,Staff,0,0,0,0
1683313494494,EDS 25,B06,202644,Staff,0,0,0,0
1683313495517,EDS 38,A01,202659,Black; Alison Michelle,24,0,25,1
1683313496541,EDS 115,A00,202652,Staff,17,0,30,13
1683313497570,EDS 125,A00,202649,Staff,14,0,30,16
1683313498597,EDS 126,A01,203332,Staff,30,0,30,0
1683313499627,EDS 139,A00,202838,Staff,16,0,25,9
1683313500650,EDS 146,A01,202655,Staff,14,0,25,11
1683313501675,ENG 15,A00,185667,Staff,0,1,0,0
1683313501675,ENG 15,B00,185672,Staff,0,0,0,0
1683313501675,ENG 15,C00,185675,Staff,0,0,0,0
1683313501675,ENG 15,D00,185682,Staff,0,0,0,0
1683313501675,ENG 15,E00,185684,Staff,0,0,0,0
1683313502701,ETHN 103,A00,185710,Staff,0,3,35,35
1683313503725,ETHN 103A,A00,199228,Man; Simeon S,2,0,9,7
1683313504753,ETHN 109,A00,185711,Staff,18,0,35,17
1683313505780,ETHN 142,A00,185726,Staff,0,4,30,30
1683313506803,ETHN 163J,A00,199229,Man; Simeon S,5,0,8,3
1683313507830,ETHN 168,A00,185727,Staff,8,0,10,2
1683313508853,ETHN 182,A00,185728,Staff,1,0,35,34
1683313509877,ETHN 183,A00,185737,Staff,8,0,18,10
1683313510900,GLBH 111,A01,209361,Burgos; Jose L.,0,0,0,0
1683313512950,HIEU 104,A00,185792,Staff,16,0,20,4
1683313513975,HIEU 115,A00,185800,Staff,1,0,20,19
1683313515002,HIEU 128,A00,185801,Staff,0,7,20,20
1683313516025,HIEU 147,A00,185802,Staff,16,0,20,4
1683313517051,HIEU 154,A00,185823,Staff,12,0,20,8
1683313518087,HILA 102,A00,185826,Staff,13,0,20,7
1683313519110,HILD 2C,A01,185778,Staff,0,12,20,20
1683313520137,HILD 7B,A01,185780,Kwak; Nancy,0,15,32,32
1683313520137,HILD 7B,A02,185781,Kwak; Nancy,0,18,32,32
1683313521164,HILD 30,A01,185791,Staff,14,0,20,6
1683313522192,HISC 119,A00,185830,Golan; Tal,0,9,20,20
1683313523219,HITO 156GS,A00,185831,Patterson; Patrick H.,0,0,0,23
1683313524246,HIUS 103,A00,185832,Man; Simeon S,0,6,20,20
1683313525268,HIUS 117,A00,185836,Kwak; Nancy,2,0,20,18
1683313526292,HIUS 125,A00,185840,Man; Simeon S,0,0,23,23
1683313527317,HIUS 149,A00,185845,Staff,0,0,20,20
1683313528344,HUM 3,A01,185882,Zavodny; Tatiana Sophia,0,6,50,50
1683313528344,HUM 3,B01,185899,Caldwell; Michael Alan,0,19,50,50
1683313529371,HUM 3GS,A00,185900,Patterson; Patrick H.,0,0,0,23
1683313530406,HUM 4,A01,185938,Zroka; Amy Liane,31,0,50,19
1683313530406,HUM 4,B01,185956,Watkins; Eric,0,2,50,50
1683313530406,HUM 4,B02,202209,Watkins; Eric,0,2,50,50
1683313530406,HUM 4,B03,202210,Watkins; Eric,0,0,50,50
1683313531428,HUM 5,A01,185958,West; Geoffrey Scott,4,0,50,46
1683313531428,HUM 5,A02,202215,West; Geoffrey Scott,0,0,50,50
1683313532453,INTL 190,A00,185959,Gagnon; Jeffrey C,0,0,0,9
1683313532453,INTL 190,B00,185960,Lettieri; Michael Joseph,0,0,0,1
1683313533477,JAPN 180,A00,254509,Staff,5,1,30,25
1683313534502,LATI 10,A01,202853,Kennemore; Amy Michelle,5,0,35,30
1683313534502,LATI 10,A02,202854,Kennemore; Amy Michelle,1,0,35,34
1683313534502,LATI 10,A03,270054,Kennemore; Amy Michelle,30,0,30,0
1683313535529,LATI 180,A00,202855,Kennemore; Amy Michelle,11,0,20,9
1683313536558,LAWS 101,A00,201767,Golan; Tal,0,7,40,40
1683313537582,LIFR 1C,A00,185961,Staff,6,0,20,14
1683313538607,LIFR 1CX,A00,185962,Staff,7,0,20,13
1683313539633,LIFR 1D,A00,185963,Staff,9,0,20,11
1683313540659,LIFR 1DX,A00,185964,Staff,9,0,20,11
1683313541685,LIGN 101,A01,186039,Staff,43,0,50,7
1683313542712,LIGN 165,A00,186040,Staff,18,0,50,32
1683313543735,LTCS 108,A00,186041,Staff,6,0,10,4
1683313544761,LTCS 119,A00,186042,Staff,16,0,20,4
1683313545786,LTCS 130,A00,186043,Wesling; Megan E.,15,0,25,10
1683313547834,LTEA 138,A00,186119,Staff,14,0,40,26
1683313548858,LTEN 124,A00,186148,Staff,6,0,25,19
1683313549882,LTEN 178,A00,186149,Staff,7,0,15,8
1683313550911,LTEN 181,A00,186150,Blanco; John D,33,0,40,7
1683313551935,LTWL 120,A00,186160,Staff,20,0,25,5
1683313552963,LTWL 165,A00,186161,Staff,22,0,25,3
1683313553988,LTWR 100,A00,186162,Staff,0,4,15,15
1683313555011,LTWR 102,A00,186163,Doller; Ben,5,0,15,10
1683313556038,MAE 8,A01,186412,Staff,0,0,0,0
1683313557066,MAE 30B,A00,186445,Bahadori; Mohammad Yousef,83,0,100,17
1683313558093,MAE 40,A00,186592,Bewley; Thomas R,9,0,50,41
1683313559118,MAE 101B,A00,186593,Bahadori; Mohammad Yousef,81,0,100,19
1683313560144,MAE 105,A00,186594,Bandaru; Prabhakar,12,0,50,38
1683313561172,MAE 107,A00,186599,Pham; Hieu Tan,0,6,120,120
1683313562201,MAE 148,A01,186660,Silberman; Jack,3,0,16,13
1683313563231,MATH 10A,A01,188095,Staff,0,6,35,35
1683313564255,MATH 10B,A01,188097,Bowers; Adam R.,0,11,30,30
1683313564255,MATH 10B,A02,188099,Bowers; Adam R.,0,11,30,30
1683313564255,MATH 10B,B01,188104,Bowers; Adam R.,0,11,30,30
1683313564255,MATH 10B,B02,188106,Bowers; Adam R.,0,10,30,30
1683313565280,MATH 10C,A01,188111,Staff,0,18,30,30
1683313565280,MATH 10C,A02,188127,Staff,0,17,30,30
1683313565280,MATH 10C,A03,188131,Staff,0,18,30,30
1683313565280,MATH 10C,B01,188218,Staff,20,0,30,10
1683313565280,MATH 10C,B02,188244,Staff,13,0,30,17
1683313565280,MATH 10C,B03,188277,Staff,16,0,30,14
1683313566309,MATH 18,A01,188344,Bach; Quang Tran,18,0,30,12
1683313566309,MATH 18,A02,188345,Bach; Quang Tran,11,0,30,19
1683313566309,MATH 18,B01,188353,Bach; Quang Tran,10,0,30,20
1683313566309,MATH 18,B02,188354,Bach; Quang Tran,20,0,30,10
1683313567354,MATH 20A,A01,188374,Staff,13,0,35,22
1683313568379,MATH 20B,A01,188382,Ohm; Ko Woon,6,0,30,24
1683313568379,MATH 20B,A02,188383,Ohm; Ko Woon,23,0,30,7
1683313568379,MATH 20B,B01,188385,Ohm; Ko Woon,7,0,30,23
1683313568379,MATH 20B,B02,188392,Ohm; Ko Woon,22,0,30,8
1683313569404,MATH 20C,A01,188394,Harel; Guershon,10,0,30,20
1683313569404,MATH 20C,A02,188395,Harel; Guershon,14,0,30,16
1683313569404,MATH 20C,B01,188404,Harel; Guershon,5,0,30,25
1683313569404,MATH 20C,B02,188405,Harel; Guershon,19,0,30,11
1683313570432,MATH 20D,A01,188414,Hammock; Frances H,0,1,30,30
1683313570432,MATH 20D,A02,188415,Hammock; Frances H,4,0,30,26
1683313570432,MATH 20D,B01,188447,Hammock; Frances H,2,0,30,28
1683313570432,MATH 20D,B02,188486,Hammock; Frances H,8,0,30,22
1683313571458,MATH 20E,A01,188649,Staff,21,0,30,9
1683313571458,MATH 20E,A02,188650,Staff,23,0,30,7
1683313571458,MATH 20E,A03,188673,Staff,0,0,30,30
1683313572488,MATH 102,A01,188675,Staff,0,35,35,35
1683313573511,MATH 103B,A01,188681,Staff,4,0,35,31
1683313573511,MATH 103B,B01,188692,Staff,6,0,35,29
1683313574536,MATH 109,A01,188695,Salehi Golsefidy; Alireza,25,0,35,10
1683313574536,MATH 109,A02,188696,Salehi Golsefidy; Alireza,27,0,35,8
1683313575621,MATH 120A,A01,188698,Eggers; John Dietrich,6,0,35,29
1683313576647,MATH 142B,A01,188736,Ioana; Adrian,0,2,30,30
1683313576647,MATH 142B,A02,188741,Ioana; Adrian,0,1,30,30
1683313576647,MATH 142B,A03,188743,Ioana; Adrian,1,3,30,29
1683313577671,MATH 168A,A01,188790,Staff,0,9,35,35
1683313578699,MATH 170A,A01,188803,Nie; Jiawang,0,2,35,35
1683313578699,MATH 170A,A02,188811,Nie; Jiawang,0,0,35,35
1683313578699,MATH 170A,A03,188814,Nie; Jiawang,0,0,35,35
1683313578699,MATH 170A,A04,188815,Nie; Jiawang,13,0,35,22
1683313579728,MATH 193B,A01,188817,Staff,0,0,35,35
1683313579728,MATH 193B,A02,188818,Staff,6,0,35,29
1683313580756,MGT 4,A01,202857,Anderson; John Charles,62,0,80,18
1683313581782,MGT 12,A00,202858,Lindenberger; Wade Douglas,43,0,90,47
1683313582811,MGT 18,A00,202859,Staff,74,0,90,16
1683313583837,MGT 18GS,A00,202860,McKay; Michael J,13,0,28,15
1683313584862,MGT 45,A00,202861,Pecore; Joseph P.,14,0,90,76
1683313585890,MGT 100,A00,202863,Yavorsky; Daniel Ryan,28,0,90,62
1683313586914,MGT 103,A00,202864,Ehrich; Kristine R,0,16,90,90
1683313587939,MGT 112,A00,202865,Ehrich; Kristine R,15,0,90,75
1683313588964,MGT 121A,A00,202868,Staff,0,19,0,0
1683313589991,MGT 131B,A00,202869,Anderson; John Charles,59,0,90,31
1683313591015,MGT 136,A00,202871,Lindenberger; Wade Douglas,84,0,90,6
1683313592039,MGT 164,A00,202873,Staff,0,69,90,90
1683313593066,MGT 164GS,A00,202874,McKay; Mary A,13,0,28,15
1683313594094,MGT 180,A00,202875,Staff,0,51,90,90
1683313595121,MMW 11R,A01,205019,Herbst; Matthew,3,0,30,27
1683313595121,MMW 11R,A02,205026,Herbst; Matthew,29,0,30,1
1683313596146,MMW 15,A01,193512,Chang; Edmond Yi-Teh,0,9,28,28
1683313596146,MMW 15,A02,193513,Chang; Edmond Yi-Teh,0,5,28,28
1683313596146,MMW 15,A03,193514,Chang; Edmond Yi-Teh,0,5,28,28
1683313596146,MMW 15,A04,193515,Chang; Edmond Yi-Teh,0,5,28,28
1683313596146,MMW 15,A05,193516,Chang; Edmond Yi-Teh,0,4,28,28
1683313596146,MMW 15,A06,193517,Chang; Edmond Yi-Teh,0,5,28,28
1683313596146,MMW 15,B01,193519,Chang; Edmond Yi-Teh,0,4,28,28
1683313596146,MMW 15,B02,193520,Chang; Edmond Yi-Teh,0,5,28,28
1683313596146,MMW 15,B03,193521,Chang; Edmond Yi-Teh,0,4,28,28
1683313596146,MMW 15,B04,193522,Chang; Edmond Yi-Teh,0,4,28,28
1683313596146,MMW 15,B05,193523,Chang; Edmond Yi-Teh,0,5,28,28
1683313596146,MMW 15,B06,193524,Chang; Edmond Yi-Teh,0,4,28,28
1683313597169,MMW 122,A01,193526,Rahimi; Babak,0,14,28,28
1683313597169,MMW 122,A02,193527,Rahimi; Babak,0,14,28,28
1683313597169,MMW 122,A03,193528,Rahimi; Babak,0,0,0,0
1683313597169,MMW 122,A04,193529,Rahimi; Babak,0,0,0,0
1683313598194,MUS 1A,A01,186663,Staff,0,20,35,35
1683313599222,MUS 4,A01,186715,Staff,0,12,35,35
1683313600245,MUS 5R,A01,186796,Dubnov; Shlomo,0,17,35,35
1683313601273,MUS 6,A01,186798,Staff,0,3,25,25
1683313602301,MUS 7,A01,186830,Staff,12,0,35,23
1683313603327,MUS 8,A01,186930,Staff,0,26,35,35
1683313604354,MUS 15,A01,186932,Staff,0,15,35,35
1683313604354,MUS 15,B01,186934,Staff,0,15,35,35
1683313605381,MUS 80,A00,186935,Staff,2,0,20,18
1683313605381,MUS 80,B00,186936,Staff,25,0,25,0
1683313606404,NANO 11,A00,204702,Lipomi; Darren John,0,0,0,0
1683313607431,NANO 15,A01,204709,Yang; Kesong,0,1,0,0
1683313608456,NANO 114,A00,202069,Jahed Motlagh; Zeinab,3,0,10,7
1683313609479,PHIL 1,A00,186955,Grush; Rick Scott,32,0,40,8
1683313610504,PHIL 10,A01,186973,Grush; Rick Scott,28,0,35,7
1683313610504,PHIL 10,A02,186974,Grush; Rick Scott,33,0,35,2
1683313611528,PHIL 13,A01,186976,Staff,7,0,35,28
1683313611528,PHIL 13,A02,186977,Staff,16,0,35,19
1683313612555,PHIL 14,A01,186979,Staff,31,0,35,4
1683313612555,PHIL 14,A02,186986,Staff,32,0,35,3
1683313613583,PHIL 28,A01,186988,Staff,16,0,30,14
1683313613583,PHIL 28,A02,186989,Staff,1,0,30,29
1683313613583,PHIL 28,A03,186990,Staff,9,0,30,21
1683313613583,PHIL 28,A04,186991,Staff,26,0,30,4
1683313614622,PHIL 120,A00,186997,Staff,23,0,40,17
1683313615646,PHIL 137,A00,187003,Staff,9,0,40,31
1683313616670,PHIL 150,A00,187015,Staff,47,0,70,23
1683313617697,PHIL 167,A00,187021,Lamey; Andy M.,35,0,40,5
1683313618721,PHIL 174,A01,202226,Staff,17,0,20,3
1683313618721,PHIL 174,A02,202235,Staff,20,0,20,0
1683313619745,PHIL 191A,A00,258918,Staff,0,0,1,1
1683313620770,PHYS 1A,A00,187028,Staff,27,0,60,33
1683313621802,PHYS 1AL,001,187036,Staff,3,0,30,27
1683313621802,PHYS 1AL,002,187049,Staff,18,0,30,12
1683313622829,PHYS 1B,A00,187058,Staff,22,0,60,38
1683313623858,PHYS 1BL,001,187064,Staff,0,0,30,30
1683313623858,PHYS 1BL,002,187070,Staff,5,0,30,25
1683313624883,PHYS 1C,A00,187082,Staff,31,0,120,89
1683313625908,PHYS 1CL,001,187088,Staff,0,9,30,30
1683313625908,PHYS 1CL,002,187089,Staff,0,2,30,30
1683313625908,PHYS 1CL,009,262693,Staff,11,0,30,19
1683313626935,PHYS 2B,A01,187097,Staff,54,0,115,61
1683313627960,PHYS 2C,A01,187099,Staff,67,0,115,48
1683313628984,PHYS 2CL,A01,187101,Staff,5,0,28,23
1683313628984,PHYS 2CL,A02,187102,Staff,15,0,28,13
1683313630008,PHYS 2D,A01,187123,Shotwell; Brian,95,0,115,20
1683313631035,PHYS 4B,A01,187133,Grinstein; Benjamin,35,0,50,15
1683313632061,POLI 10,A00,188819,Staff,0,4,50,50
1683313633086,POLI 11,A00,188827,Staff,43,0,50,7
1683313634112,POLI 13R,A00,188828,Staff,0,1,20,20
1683313635136,POLI 27,A01,188830,Elgin; Samuel Zincke,0,1,70,70
1683313636160,POLI 30,A00,188832,Desposato; Scott,32,0,50,18
1683313637186,POLI 102F,A00,188834,Staff,3,0,40,37
1683313638212,POLI 104A,A00,188852,Staff,14,0,30,16
1683313639238,POLI 104I,A00,188853,Staff,0,6,20,20
1683313640265,POLI 110B,A00,188854,Wiens; David,7,0,20,13
1683313641289,POLI 112A,A00,188855,Wiens; David,5,0,30,25
1683313642314,POLI 117R,A00,188856,Forman; Fonna,0,11,20,20
1683313643338,POLI 118,A00,188857,Ingham; Sean,8,0,20,12
1683313644366,POLI 120G,A00,188858,Staff,9,0,30,21
1683313645390,POLI 131CR,A00,188863,Hoston; Germaine,24,0,50,26
1683313646417,POLI 133,A00,188864,Nellis; Gareth Hb,44,0,50,6
1683313647448,POLI 134D,A00,188865,Desposato; Scott,27,0,30,3
1683313648474,POLI 142A,A00,188871,Gartzke; Erik,22,0,50,28
1683313649499,POLI 142K,A00,188874,Staff,38,0,50,12
1683313650525,POLI 143,A00,188940,Gartzke; Erik,16,0,30,14
1683313651549,POLI 153,A00,188943,Staff,3,0,20,17
1683313652576,POLI 160AA,A00,188944,Staff,12,0,40,28
1683313653602,POLI 170A,A00,188945,Staff,11,0,30,19
1683313655653,PSYC 1,A00,188952,Staff,37,0,90,53
1683313656679,PSYC 2,B00,188953,Staff,19,0,35,16
1683313657706,PSYC 6,A00,188970,Staff,47,0,60,13
1683313658730,PSYC 7,A00,188973,Staff,37,0,45,8
1683313659758,PSYC 60,A01,188980,Rickard; Timothy C.,43,0,60,17
1683313660783,PSYC 70,A01,189001,Steiner; Eric Tomas,24,0,45,21
1683313661815,PSYC 100,A00,189005,Lacefield; Katharine I,0,99,120,120
1683313662840,PSYC 102,A00,189008,Staff,10,0,30,20
1683313663868,PSYC 106,B00,189026,Gorman; Michael R.,36,0,60,24
1683313664895,PSYC 114,B01,189033,Winkielman; Piotr,0,32,30,30
1683313665922,PSYC 131,A00,189036,Anagnostaras; Stephan,0,43,60,60
1683313666956,PSYC 136,A00,189041,Lowe; Angela Beth,0,7,25,25
1683313667984,PSYC 137,A00,189057,Winkielman; Piotr,0,34,25,25
1683313669006,PSYC 144,A00,189107,Wixted; John T,0,7,50,50
1683313671054,PSYC 162,A00,189142,Staff,0,8,85,85
1683313672080,PSYC 172,A00,189144,Gorman; Michael R.,0,7,30,30
1683313674163,PSYC 179,A00,189146,Lacefield; Katharine I,0,84,120,120
1683313675186,PSYC 181,A00,189147,Anagnostaras; Stephan,0,44,90,90
1683313676210,PSYC 190R,A00,189148,Barner; David A.,0,22,80,80
1683313677237,PSYC 191,A00,189275,Rickard; Timothy C.,0,7,25,25
1683313678262,PSYC 193,A00,189276,Chapman; Eddie Nathaniel,0,1,0,4
1683313679343,PSYC 193L,A01,189281,Lowe; Angela Beth,12,0,20,8
1683313679343,PSYC 193L,B01,189285,Staff,28,0,35,7
1683313680368,RELI 149,A00,187137,Rahimi; Babak,7,0,40,33
1683313681405,SE 9,A01,187315,Staff,0,2,18,18
1683313682428,SE 101B,A00,187409,Staff,24,0,30,6
1683313683455,SE 110B,A00,187444,Staff,10,0,40,30
1683313684478,SE 130B,A00,187449,Staff,31,0,40,9
1683313685505,SE 150A,A00,187516,Staff,9,0,20,11
1683313686529,SE 154,A00,187528,Staff,30,0,50,20
1683313687554,SIO 3,A01,258171,Staff,35,0,40,5
1683313688578,SIO 10,A00,187144,Cook; Geoffrey W,0,3,75,75
1683313689601,SIO 45,A00,187152,Cook; Geoffrey W,1,0,100,99
1683313690627,SIO 109R,A00,194486,Staff,0,3,20,20
1683313692681,SIO 187,A01,187233,Kacev; David,12,0,40,28
1683313693710,SOCI 1,A01,258656,Thorpe; Charles Robert,28,0,30,2
1683313693710,SOCI 1,A02,258658,Thorpe; Charles Robert,30,0,30,0
1683313693710,SOCI 1,A03,258661,Thorpe; Charles Robert,25,0,25,0
1683313693710,SOCI 1,A04,258666,Thorpe; Charles Robert,22,0,25,3
1683313693710,SOCI 1,A05,258897,Thorpe; Charles Robert,23,0,25,2
1683313693710,SOCI 1,A06,258898,Thorpe; Charles Robert,25,0,25,0
1683313694733,SOCI 30,A01,258903,Pardo Guerra; Juan Pablo,16,0,30,14
1683313695760,SOCI 102,A00,258904,Staff,9,0,25,16
1683313696789,SOCI 106,A00,258905,Staff,19,0,25,6
1683313697813,SOCI 111,A00,258907,Ribas Norris; Janet Vanesa,26,0,30,4
1683313698837,SOCI 121R,A00,258908,Pardo Guerra; Juan Pablo,11,0,30,19
1683313699861,SOCI 126,A01,203330,Staff,14,0,20,6
1683313700888,SOCI 131,A00,258909,Thorpe; Charles Robert,31,0,60,29
1683313701915,SOCI 135,A00,258910,Payne; Christine Anna,0,9,30,30
1683313702939,SOCI 157,A00,258911,Staff,12,0,30,18
1683313703967,SOCI 184,A00,258912,Staff,25,0,30,5
1683313704991,SOCI 188D,A00,258913,Staff,21,0,30,9
1683313706031,SYN 2,001,187529,Staff,9,0,16,7
1683313706031,SYN 2,002,201452,Staff,0,18,16,16
1683313706031,SYN 2,003,201469,Staff,3,0,16,13
1683313707059,SYN 100,A01,187531,Staff,0,9,20,20
1683313707059,SYN 100,B01,201491,Staff,0,12,20,20
1683313708085,TDAC 1,A00,189286,Walsh; Kim C.,3,0,20,17
1683313708085,TDAC 1,B00,189287,Harting; Carla Kelso,11,0,20,9
1683313709109,TDAC 101,A00,189300,Walsh; Kim C.,16,0,20,4
1683313709109,TDAC 101,B00,189301,Harting; Carla Kelso,18,0,20,2
1683313710146,TDAC 102,A00,189304,Basso; Beatrice,14,0,20,6
1683313711173,TDAC 108,A00,189305,Staff,18,0,20,2
1683313712198,TDDE 131,A00,189310,Staff,19,0,20,1
1683313712198,TDDE 131,B00,189314,Staff,19,0,20,1
1683313712198,TDDE 131,C00,189315,Staff,48,0,50,2
1683313712198,TDDE 131,D00,189316,Staff,14,0,15,1
1683313712198,TDDE 131,E00,204841,Staff,20,0,20,0
1683313713222,TDGE 10,A00,189289,Staff,30,0,50,20
1683313713222,TDGE 10,B00,189290,Havis; Allan,2,0,50,48
1683313714246,TDGE 11,A00,189291,Fulton; Julia,0,3,50,50
1683313714246,TDGE 11,B00,189292,Staff,20,0,25,5
1683313714246,TDGE 11,C00,260270,Staff,0,0,0,0
1683313715270,TDGE 25,A00,189294,Staff,3,0,20,17
1683313716294,TDGE 124,A00,189318,Fulton; Julia,0,8,50,50
1683313717319,TDGE 125,A00,189319,Staff,13,0,25,12
1683313717319,TDGE 125,B00,189320,Staff,23,0,25,2
1683313718346,TDGE 127,A00,189322,Havis; Allan,0,0,50,50
1683313719374,TDHT 101,A00,189323,Staff,18,0,25,7
1683313719374,TDHT 101,B00,189324,Staff,25,0,25,0
1683313720401,TDHT 102,A00,189325,Staff,49,0,50,1
1683313721430,TDMV 1,A00,189295,Arcidiacono; Kristin,20,0,30,10
1683313721430,TDMV 1,B00,189296,Caligagan; Maria T.,24,0,30,6
1683313722457,TDMV 2,A00,189297,Sammartano; Tonnie,28,0,30,2
1683313722457,TDMV 2,B00,189299,Arcidiacono; Kristin,24,0,30,6
1683313723483,TDMV 3,A00,204998,Rincon; Alicia,22,0,30,8
1683313724507,TDMV 120,A00,189458,Sammartano; Tonnie,28,0,30,2
1683313725531,TDMV 138,A00,189541,Jun; Grace Shin Hae,22,0,40,18
1683313726558,TDMV 142,A00,189717,Caligagan; Tony,23,0,30,7
1683313726558,TDMV 142,B00,189718,Caligagan; Maria T.,25,0,30,5
1683313727595,TMC 2,A01,187533,Staff,25,0,25,0
1683313727595,TMC 2,A02,187534,Staff,25,0,25,0
1683313728624,USP 1,A01,187536,Kwak; Nancy,0,16,25,25
1683313729650,USP 5,A01,187538,Staff,9,0,25,16
1683313730675,USP 101,A00,199253,Staff,0,4,0,0
1683313731702,USP 124,A00,187562,Boomhower; Matthew Charles,1,0,30,29
1683313732730,USP 138,A00,187582,Staff,20,0,25,5
1683313733764,USP 152,A01,187597,Staff,4,0,25,21
1683313734790,USP 153,A00,187598,Staff,19,0,25,6
1683313735817,USP 168,A00,187607,Kwak; Nancy,2,0,5,3
1683313736843,USP 173,A00,187619,Staff,4,0,25,21
1683313737870,USP 181,A00,187638,Staff,0,0,25,25
1683313738896,VIS 103,A00,187650,Cruz; Edwin Teddy,23,0,75,52
1683313739921,VIS 110D,A00,187669,Staff,12,0,22,10
1683313740946,VIS 127C,A00,187720,Shen; Kuiyi,68,0,146,78
1683313741973,VIS 149,A00,187731,Yoldas; Pinar,0,14,22,22
1683313743000,VIS 151,A01,188091,Staff,22,0,34,12
1683313743000,VIS 151,A02,188092,Staff,11,0,34,23
1683313744025,VIS 160B,A00,188093,Stalbaum; Brett,0,0,10,10
1683313746080,WCWP 10B,A00,201720,Staff,10,0,15,5
1683313746080,WCWP 10B,B00,201722,Staff,8,0,15,7
1683313747102,WCWP 100,A00,201725,Gagnon; Jeffrey C,0,0,2,2
1683313747102,WCWP 100,B00,201727,Staff,0,4,15,15
1683313750224,ANBI 133,A00,258401,Wilder; Linnea Lorene,34,0,40,6
1683313751254,ANBI 140,A00,258395,Hrvoj Mihic; Branka,18,0,25,7
1683313752282,ANSC 120,A00,258402,Bialecki; Jon Anthony,27,0,40,13
1683313753310,ANSC 144,A00,258400,Staff,14,0,40,26
1683313755367,ANSC 166,A00,258396,Parish; Steven Martin,157,0,175,18
1683313756391,ANSC 180,A00,193533,Staff,9,0,20,11
1683313757418,ANSC 188,A00,258397,Jassal; Aftab,33,0,40,7
1683313758442,ANTH 3,A01,258316,Staff,23,0,30,7
1683313759470,ANTH 5,A00,258394,Semendeferi; Ekaterini,16,0,20,4
1683313760497,ANTH 21,A01,258331,Staff,9,0,40,31
1683313761527,ANTH 103,A00,258398,Varma; Saiba,15,0,25,10
1683313762557,AWP 10,001,202034,Staff,0,0,0,0
1683313762557,AWP 10,002,202035,Staff,0,0,0,0
1683313762557,AWP 10,003,202036,Staff,0,0,0,0
1683313762557,AWP 10,004,202037,Staff,0,0,0,0
1683313762557,AWP 10,005,202038,Staff,0,0,0,0
1683313762557,AWP 10,006,202039,Staff,0,0,0,0
1683313762557,AWP 10,007,202040,Staff,0,0,0,0
1683313762557,AWP 10,008,202041,Staff,0,0,0,0
1683313762557,AWP 10,009,202042,Staff,0,0,0,0
1683313762557,AWP 10,010,202043,Staff,0,0,0,0
1683313762557,AWP 10,011,202044,Staff,0,0,0,0
1683313762557,AWP 10,012,202045,Staff,0,0,0,0
1683313762557,AWP 10,013,202046,Staff,0,0,0,0
1683313762557,AWP 10,014,202047,Staff,0,0,0,0
1683313762557,AWP 10,015,202048,Staff,0,0,0,0
1683313762557,AWP 10,016,202049,Staff,0,0,0,0
1683313762557,AWP 10,017,202050,Staff,0,0,0,0
1683313762557,AWP 10,018,202051,Staff,0,0,0,0
1683313762557,AWP 10,019,202052,Staff,0,0,0,0
1683313762557,AWP 10,020,202053,Staff,0,0,0,0
1683313762557,AWP 10,021,202054,Staff,0,0,0,0
1683313762557,AWP 10,022,202055,Staff,0,0,0,0
1683313762557,AWP 10,023,202056,Staff,0,0,0,0
1683313762557,AWP 10,024,202057,Staff,0,0,0,0
1683313762557,AWP 10,025,202058,Staff,0,0,0,0
1683313762557,AWP 10,026,202059,Staff,0,0,0,0
1683313763581,AWP 102,001,202032,Staff,0,0,0,0
1683313763581,AWP 102,002,202033,Staff,0,0,0,0
1683313764606,BENG 100,A01,254234,Taylor Amos; Alyssa C,31,0,40,9
1683313765631,BENG 196,001,270013,Engler; Adam J.,9999,0,9999,0
1683313766657,BICD 100R,A01,202018,Smith; Laurie,0,7,32,32
1683313766657,BICD 100R,A02,202019,Smith; Laurie,0,2,32,32
1683313766657,BICD 100R,A03,202020,Smith; Laurie,0,1,32,32
1683313766657,BICD 100R,A04,202021,Smith; Laurie,8,0,32,24
1683313766657,BICD 100R,A05,202022,Smith; Laurie,12,0,32,20
1683313767683,BICD 136,A01,193242,Gustafson-Brown; Cindy,0,2,32,32
1683313767683,BICD 136,A02,193244,Gustafson-Brown; Cindy,15,0,32,17
1683313768710,BIEB 102,A01,193249,Butler; Shannon Rhey,0,2,32,32
1683313768710,BIEB 102,A02,193251,Butler; Shannon Rhey,0,0,32,32
1683313768710,BIEB 102,A03,193253,Butler; Shannon Rhey,0,1,32,32
1683313768710,BIEB 102,A04,193255,Butler; Shannon Rhey,17,0,32,15
1683313768710,BIEB 102,A05,193265,Butler; Shannon Rhey,26,0,32,6
1683313768710,BIEB 102,A06,193269,Butler; Shannon Rhey,16,0,32,16
1683313770759,BIEB 150,A01,193274,Staff,0,0,32,32
1683313770759,BIEB 150,A02,193285,Staff,24,0,32,8
1683313771786,BIEB 194,A00,193286,Kurle; Carolyn M.,22,0,32,10
1683313772810,BILD 1,A01,192291,Staff,16,0,32,16
1683313772810,BILD 1,A02,192292,Staff,30,0,32,2
1683313772810,BILD 1,B01,192520,Reuther; Keefe,0,1,0,0
1683313772810,BILD 1,B02,192532,Reuther; Keefe,0,1,0,0
1683313773835,BILD 3,A01,192556,Butler; Shannon Rhey,0,0,32,32
1683313773835,BILD 3,A02,192581,Butler; Shannon Rhey,5,0,32,27
1683313773835,BILD 3,A03,192611,Butler; Shannon Rhey,23,0,32,9
1683313773835,BILD 3,A04,192612,Butler; Shannon Rhey,25,0,32,7
1683313773835,BILD 3,A05,192613,Butler; Shannon Rhey,27,0,32,5
1683313773835,BILD 3,A06,192679,Butler; Shannon Rhey,27,0,32,5
1683313773835,BILD 3,A07,192682,Butler; Shannon Rhey,22,0,32,10
1683313774861,BILD 4,A01,192836,Reuther; Keefe,1,0,24,23
1683313774861,BILD 4,A02,193044,Reuther; Keefe,4,0,24,20
1683313775885,BILD 10,A01,193142,Gustafson-Brown; Cindy,31,0,32,1
1683313775885,BILD 10,A02,193149,Gustafson-Brown; Cindy,31,0,32,1
1683313776909,BIMM 100,A01,193301,Staff,0,6,32,32
1683313776909,BIMM 100,A02,193312,Staff,0,5,32,32
1683313776909,BIMM 100,A03,193323,Staff,0,8,32,32
1683313777934,BIMM 101,A01,193329,McDonnell; Lisa Marie,0,3,24,24
1683313777934,BIMM 101,A02,193339,McDonnell; Lisa Marie,0,2,24,24
1683313777934,BIMM 101,B01,193354,McDonnell; Lisa Marie,0,3,24,24
1683313777934,BIMM 101,B02,193357,McDonnell; Lisa Marie,0,3,24,24
1683313778958,BIMM 110,A01,193377,Tat; John,0,11,32,32
1683313778958,BIMM 110,A02,193378,Tat; John,1,9,32,31
1683313779983,BIMM 120,A01,206116,Staff,0,0,32,32
1683313779983,BIMM 120,A02,206117,Staff,8,0,32,24
1683313779983,BIMM 120,A03,206121,Staff,21,0,32,11
1683313781012,BIPN 100,A01,193393,Park; Ji Young,0,14,32,32
1683313781012,BIPN 100,A02,193402,Park; Ji Young,0,12,32,32
1683313781012,BIPN 100,A03,193413,Park; Ji Young,0,14,32,32
1683313781012,BIPN 100,A04,193414,Park; Ji Young,0,13,32,32
1683313782036,BIPN 102,A01,193429,Staff,0,0,32,32
1683313782036,BIPN 102,A02,193438,Staff,22,0,32,10
1683313783120,BIPN 106,A01,193450,Reyes Gonzalez; Catalina,0,2,40,40
1683313784145,BIPN 134,A01,193465,Cooke; James Edward,0,0,32,32
1683313784145,BIPN 134,A02,193474,Cooke; James Edward,27,0,32,5
1683313784145,BIPN 134,A03,193485,Cooke; James Edward,29,0,32,3
1683313784145,BIPN 134,A04,193486,Cooke; James Edward,21,0,32,11
1683313784145,BIPN 134,A05,193491,Cooke; James Edward,31,0,32,1
1683313784145,BIPN 134,A06,193501,Cooke; James Edward,30,0,32,2
1683313784145,BIPN 134,A07,193510,Cooke; James Edward,29,0,32,3
1683313786195,BISP 194,A00,222522,Staff,16,0,32,16
1683313787220,CAT 124,A01,202407,Staff,20,0,25,5
1683313788247,CAT 125,A00,202408,Marchisotto; Jennifer Anne,4,0,20,16
1683313789271,CAT 125R,A00,202409,Smith; Lauryn Alissa,0,11,20,20
1683313789271,CAT 125R,B00,202410,Morales; Celeste Georgianna,0,11,20,20
1683313789271,CAT 125R,C00,202411,Irwin; Matthew Joseph,0,10,20,20
1683313790299,CENG 15,A01,204712,Yang; Kesong,0,1,0,0
1683313791325,CENG 114,A00,202070,Jahed Motlagh; Zeinab,5,0,20,15
1683313792349,CGS 105,A00,185477,Wesling; Megan E.,24,0,40,16
1683313793375,CGS 106,A00,185494,Staff,13,0,22,9
1683313794402,CGS 108,A00,185495,Staff,14,0,20,6
1683313795429,CGS 114,A00,185496,Staff,13,0,18,5
1683313796454,CGS 119,A00,185501,Staff,15,0,20,5
1683313797481,CGS 120,A00,185511,Staff,13,0,20,7
1683313798507,CHEM 4,A01,184675,Bussey; Thomas J,96,0,100,4
1683313799533,CHEM 6A,A01,184677,Staff,35,0,60,25
1683313800556,CHEM 6B,A01,184679,Staff,65,0,100,35
1683313801581,CHEM 6C,A01,184681,Bussey; Thomas J,1,0,50,49
1683313801581,CHEM 6C,A02,184682,Bussey; Thomas J,34,0,50,16
1683313802608,CHEM 40A,A01,184684,Albizati; Kim F.,37,0,100,63
1683313803630,CHEM 40B,A01,184686,Albizati; Kim F.,0,20,100,100
1683313804656,CHEM 41B,A01,184690,Staff,52,0,100,48
1683313805683,COGS 3,A01,184715,Boyle; Mary E. T.,0,25,40,40
1683313806706,COGS 14B,A01,185172,Staff,0,15,38,38
1683313807730,COGS 18,A01,184736,Staff,19,0,80,61
1683313808755,COGS 100,A01,184932,Staff,0,5,73,73
1683313809784,COGS 101A,A01,184935,Staff,0,38,30,30
1683313810813,COGS 101B,A01,184944,Staff,0,2,30,30
1683313811840,COGS 101C,A01,184946,Staff,0,12,30,30
1683313812872,COGS 102A,A01,184951,Johnson; Christine M.,2,0,40,38
1683313813899,COGS 107B,A01,184953,Mooshagian; Eric Frederick,0,50,40,40
1683313814924,COGS 118B,A01,184959,Gupta; Anjum,0,48,40,40
1683313815952,COGS 153,A00,184961,Staff,0,15,30,30
1683313816977,COGS 177,A00,184962,Staff,0,21,30,30
1683313818004,COGS 187A,A01,184969,Boyle; Mary E. T.,0,17,40,40
1683313819031,COMM 10,A01,185174,Staff,0,5,25,25
1683313819031,COMM 10,A02,185189,Staff,0,5,25,25
1683313819031,COMM 10,A03,269821,Staff,0,0,0,0
1683313820060,COMM 100B,A01,185475,Staff,0,0,0,2
1683313820060,COMM 100B,A02,185476,Staff,14,0,25,11
1683313821084,COMM 100C,A01,185314,Staff,1,0,25,24
1683313821084,COMM 100C,A02,185327,Staff,19,0,25,6
1683313822110,COMM 110M,A00,185349,Staff,2,0,40,38
1683313823137,COMM 113T,A00,185352,Staff,25,0,40,15
1683313824164,COMM 114I,A00,185353,Staff,33,0,40,7
1683313825191,COMM 131,A00,185354,Staff,19,0,30,11
1683313826227,CSE 8A,A50,185358,Cao; Yingjun,0,46,10,10
1683313827255,CSE 8B,A01,185362,Staff,1,47,50,49
1683313828278,CSE 11,A01,185416,Cao; Yingjun,0,91,10,10
1683313829301,CSE 20,A01,185445,Briones; Jor-el Thomas Caparas,5,0,25,20
1683313830325,CSE 21,A01,185447,Staff,10,0,50,40
1683313831354,CSE 101,A01,185451,Staff,0,12,50,50
1683313831354,CSE 101,B01,185453,Jones; Miles E,0,11,50,50
1683313833406,CSE 141,A01,185458,Eldon; John,20,0,100,80
1683313834433,CSE 141L,A01,185461,Eldon; John,12,0,100,88
1683313835463,CSE 142,A01,185463,Staff,36,0,60,24
1683313835463,CSE 142,B01,201355,Staff,0,7,60,60
1683313836487,CSE 142L,A01,185470,Staff,36,0,60,24
1683313836487,CSE 142L,B01,201417,Staff,0,6,60,60
1683313837512,CSE 190,A00,201433,Staff,32,0,49,17
1683313838535,DOC 1,A01,259136,Strom; Megan C.,7,0,15,8
1683313838535,DOC 1,A02,259137,Strom; Megan C.,14,0,15,1
1683313838535,DOC 1,A03,259138,Strom; Megan C.,14,0,15,1
1683313838535,DOC 1,A04,259139,Strom; Megan C.,14,0,15,1
1683313839563,DOC 100D,A00,259140,Pass; Natalye Joann,17,0,25,8
1683313840591,DSGN 1,A01,184749,Rill; Bryan,0,25,30,30
1683313841614,DSGN 100,A01,185168,Staff,0,2,25,25
1683313842638,ECE 5,A01,185626,Morris; Karcher William,0,10,0,0
1683313843662,ECE 101,A01,185628,Staff,17,0,70,53
1683313844747,ECE 107,A01,185635,Baghdadchi; Saharnaz,0,0,20,20
1683313844747,ECE 107,A02,185638,Baghdadchi; Saharnaz,4,0,20,16
1683313845772,ECE 148,A01,185647,Silberman; Jack,0,0,16,16
1683313846800,ECON 1,A01,185537,Crane; Meredith Helen,54,0,70,16
1683313847826,ECON 3,A01,185549,Crane; Meredith Helen,33,0,70,37
1683313848851,ECON 4,A01,203354,Anderson; John Charles,0,4,10,10
1683313849875,ECON 100A,A01,185574,Staff,0,4,40,40
1683313850902,ECON 100B,A01,185576,Staff,0,22,40,40
1683313851927,ECON 100C,A01,185589,Newhouse; Herbert S,30,0,70,40
1683313852951,ECON 105,A00,185608,Vespa; Emanuel Ignacio,19,0,35,16
1683313853978,ECON 109,A01,185610,Shishkin; Denis,10,0,35,25
1683313855002,ECON 110A,A01,185612,Staff,11,0,40,29
1683313856026,ECON 120A,A01,185615,Staff,20,0,40,20
1683313857050,ECON 120C,A01,185617,Sun; Yixiao,0,20,70,70
1683313858076,ECON 144,A00,203346,Squires; Dale E,3,0,35,32
1683313859103,ECON 171,A01,203349,Newhouse; Herbert S,0,1,35,35
1683313860132,ECON 173A,A01,185621,Toda; Alexis Akira,21,0,35,14
1683313861160,EDS 25,A01,202413,Staff,0,1,0,0
1683313861160,EDS 25,A02,202414,Staff,0,1,0,0
1683313861160,EDS 25,A03,202415,Staff,0,0,0,0
1683313861160,EDS 25,A04,202416,Staff,0,1,0,0
1683313861160,EDS 25,A05,202439,Staff,0,0,0,0
1683313861160,EDS 25,A06,202440,Staff,0,0,0,0
1683313861160,EDS 25,B01,202631,Staff,0,0,0,0
1683313861160,EDS 25,B02,202632,Staff,0,0,0,0
1683313861160,EDS 25,B03,202639,Staff,0,0,0,0
1683313861160,EDS 25,B04,202640,Staff,0,0,0,0
1683313861160,EDS 25,B05,202643,Staff,0,0,0,0
1683313861160,EDS 25,B06,202644,Staff,0,0,0,0
1683313862183,EDS 38,A01,202659,Black; Alison Michelle,24,0,25,1
1683313863209,EDS 115,A00,202652,Staff,17,0,30,13
1683313864235,EDS 125,A00,202649,Staff,14,0,30,16
1683313865263,EDS 126,A01,203332,Staff,30,0,30,0
1683313866287,EDS 139,A00,202838,Staff,16,0,25,9
1683313867312,EDS 146,A01,202655,Staff,14,0,25,11
1683313868337,ENG 15,A00,185667,Staff,0,1,0,0
1683313868337,ENG 15,B00,185672,Staff,0,0,0,0
1683313868337,ENG 15,C00,185675,Staff,0,0,0,0
1683313868337,ENG 15,D00,185682,Staff,0,0,0,0
1683313868337,ENG 15,E00,185684,Staff,0,0,0,0
1683313869361,ETHN 103,A00,185710,Staff,0,3,35,35
1683313870388,ETHN 103A,A00,199228,Man; Simeon S,2,0,9,7
1683313871414,ETHN 109,A00,185711,Staff,18,0,35,17
1683313872437,ETHN 142,A00,185726,Staff,0,4,30,30
1683313873462,ETHN 163J,A00,199229,Man; Simeon S,5,0,8,3
1683313874487,ETHN 168,A00,185727,Staff,8,0,10,2
1683313875516,ETHN 182,A00,185728,Staff,1,0,35,34
1683313876541,ETHN 183,A00,185737,Staff,8,0,18,10
1683313877569,GLBH 111,A01,209361,Burgos; Jose L.,0,0,0,0
1683313879621,HIEU 104,A00,185792,Staff,16,0,20,4
1683313880645,HIEU 115,A00,185800,Staff,1,0,20,19
1683313881672,HIEU 128,A00,185801,Staff,0,7,20,20
1683313882697,HIEU 147,A00,185802,Staff,16,0,20,4
1683313883725,HIEU 154,A00,185823,Staff,12,0,20,8
1683313884748,HILA 102,A00,185826,Staff,13,0,20,7
1683313885776,HILD 2C,A01,185778,Staff,0,12,20,20
1683313886857,HILD 7B,A01,185780,Kwak; Nancy,0,15,32,32
1683313886857,HILD 7B,A02,185781,Kwak; Nancy,0,18,32,32
1683313887885,HILD 30,A01,185791,Staff,14,0,20,6
1683313888909,HISC 119,A00,185830,Golan; Tal,0,9,20,20
1683313889933,HITO 156GS,A00,185831,Patterson; Patrick H.,0,0,0,23
1683313890956,HIUS 103,A00,185832,Man; Simeon S,0,6,20,20
1683313891984,HIUS 117,A00,185836,Kwak; Nancy,2,0,20,18
1683313893012,HIUS 125,A00,185840,Man; Simeon S,0,0,23,23
1683313894036,HIUS 149,A00,185845,Staff,0,0,20,20
1683313895065,HUM 3,A01,185882,Zavodny; Tatiana Sophia,0,6,50,50
1683313895065,HUM 3,B01,185899,Caldwell; Michael Alan,0,19,50,50
1683313896092,HUM 3GS,A00,185900,Patterson; Patrick H.,0,0,0,23
1683313897121,HUM 4,A01,185938,Zroka; Amy Liane,31,0,50,19
1683313897121,HUM 4,B01,185956,Watkins; Eric,0,2,50,50
1683313897121,HUM 4,B02,202209,Watkins; Eric,0,2,50,50
1683313897121,HUM 4,B03,202210,Watkins; Eric,0,0,50,50
1683313898146,HUM 5,A01,185958,West; Geoffrey Scott,4,0,50,46
1683313898146,HUM 5,A02,202215,West; Geoffrey Scott,0,0,50,50
1683313899173,INTL 190,A00,185959,Gagnon; Jeffrey C,0,0,0,9
1683313899173,INTL 190,B00,185960,Lettieri; Michael Joseph,0,0,0,1
1683313900201,JAPN 180,A00,254509,Staff,5,1,30,25
1683313901231,LATI 10,A01,202853,Kennemore; Amy Michelle,5,0,35,30
1683313901231,LATI 10,A02,202854,Kennemore; Amy Michelle,1,0,35,34
1683313901231,LATI 10,A03,270054,Kennemore; Amy Michelle,30,0,30,0
1683313902257,LATI 180,A00,202855,Kennemore; Amy Michelle,11,0,20,9
1683313903282,LAWS 101,A00,201767,Golan; Tal,0,7,40,40
1683313904310,LIFR 1C,A00,185961,Staff,6,0,20,14
1683313905338,LIFR 1CX,A00,185962,Staff,7,0,20,13
1683313906362,LIFR 1D,A00,185963,Staff,9,0,20,11
1683313907387,LIFR 1DX,A00,185964,Staff,9,0,20,11
1683313908411,LIGN 101,A01,186039,Staff,43,0,50,7
1683313909435,LIGN 165,A00,186040,Staff,18,0,50,32
1683313910462,LTCS 108,A00,186041,Staff,6,0,10,4
1683313911489,LTCS 119,A00,186042,Staff,16,0,20,4
1683313912513,LTCS 130,A00,186043,Wesling; Megan E.,15,0,25,10
1683313914562,LTEA 138,A00,186119,Staff,14,0,40,26
1683313915588,LTEN 124,A00,186148,Staff,6,0,25,19
1683313916613,LTEN 178,A00,186149,Staff,7,0,15,8
1683313917637,LTEN 181,A00,186150,Blanco; John D,33,0,40,7
1683313918665,LTWL 120,A00,186160,Staff,20,0,25,5
1683313919691,LTWL 165,A00,186161,Staff,22,0,25,3
1683313920714,LTWR 100,A00,186162,Staff,0,4,15,15
1683313921737,LTWR 102,A00,186163,Doller; Ben,5,0,15,10
1683313922762,MAE 8,A01,186412,Staff,0,0,0,0
1683313923788,MAE 30B,A00,186445,Bahadori; Mohammad Yousef,83,0,100,17
1683313924814,MAE 40,A00,186592,Bewley; Thomas R,9,0,50,41
1683313925842,MAE 101B,A00,186593,Bahadori; Mohammad Yousef,81,0,100,19
1683313926871,MAE 105,A00,186594,Bandaru; Prabhakar,12,0,50,38
1683313927896,MAE 107,A00,186599,Pham; Hieu Tan,0,6,120,120
1683313928920,MAE 148,A01,186660,Silberman; Jack,3,0,16,13
1683313929945,MATH 10A,A01,188095,Staff,0,6,35,35
1683313930969,MATH 10B,A01,188097,Bowers; Adam R.,0,11,30,30
1683313930969,MATH 10B,A02,188099,Bowers; Adam R.,0,11,30,30
1683313930969,MATH 10B,B01,188104,Bowers; Adam R.,0,11,30,30
1683313930969,MATH 10B,B02,188106,Bowers; Adam R.,0,10,30,30
1683313931998,MATH 10C,A01,188111,Staff,0,18,30,30
1683313931998,MATH 10C,A02,188127,Staff,0,17,30,30
1683313931998,MATH 10C,A03,188131,Staff,0,18,30,30
1683313931998,MATH 10C,B01,188218,Staff,20,0,30,10
1683313931998,MATH 10C,B02,188244,Staff,13,0,30,17
1683313931998,MATH 10C,B03,188277,Staff,16,0,30,14
1683313933023,MATH 18,A01,188344,Bach; Quang Tran,18,0,30,12
1683313933023,MATH 18,A02,188345,Bach; Quang Tran,11,0,30,19
1683313933023,MATH 18,B01,188353,Bach; Quang Tran,10,0,30,20
1683313933023,MATH 18,B02,188354,Bach; Quang Tran,20,0,30,10
1683313934048,MATH 20A,A01,188374,Staff,13,0,35,22
1683313935073,MATH 20B,A01,188382,Ohm; Ko Woon,6,0,30,24
1683313935073,MATH 20B,A02,188383,Ohm; Ko Woon,23,0,30,7
1683313935073,MATH 20B,B01,188385,Ohm; Ko Woon,7,0,30,23
1683313935073,MATH 20B,B02,188392,Ohm; Ko Woon,22,0,30,8
1683313936097,MATH 20C,A01,188394,Harel; Guershon,10,0,30,20
1683313936097,MATH 20C,A02,188395,Harel; Guershon,14,0,30,16
1683313936097,MATH 20C,B01,188404,Harel; Guershon,5,0,30,25
1683313936097,MATH 20C,B02,188405,Harel; Guershon,19,0,30,11
1683313937125,MATH 20D,A01,188414,Hammock; Frances H,0,1,30,30
1683313937125,MATH 20D,A02,188415,Hammock; Frances H,4,0,30,26
1683313937125,MATH 20D,B01,188447,Hammock; Frances H,2,0,30,28
1683313937125,MATH 20D,B02,188486,Hammock; Frances H,8,0,30,22
1683313938150,MATH 20E,A01,188649,Staff,21,0,30,9
1683313938150,MATH 20E,A02,188650,Staff,23,0,30,7
1683313938150,MATH 20E,A03,188673,Staff,0,0,30,30
1683313939174,MATH 102,A01,188675,Staff,0,35,35,35
1683313940199,MATH 103B,A01,188681,Staff,4,0,35,31
1683313940199,MATH 103B,B01,188692,Staff,6,0,35,29
1683313941227,MATH 109,A01,188695,Salehi Golsefidy; Alireza,25,0,35,10
1683313941227,MATH 109,A02,188696,Salehi Golsefidy; Alireza,27,0,35,8
1683313942254,MATH 120A,A01,188698,Eggers; John Dietrich,6,0,35,29
1683313943279,MATH 142B,A01,188736,Ioana; Adrian,0,2,30,30
1683313943279,MATH 142B,A02,188741,Ioana; Adrian,0,1,30,30
1683313943279,MATH 142B,A03,188743,Ioana; Adrian,1,3,30,29
1683313944305,MATH 168A,A01,188790,Staff,0,9,35,35
1683313945333,MATH 170A,A01,188803,Nie; Jiawang,0,2,35,35
1683313945333,MATH 170A,A02,188811,Nie; Jiawang,0,0,35,35
1683313945333,MATH 170A,A03,188814,Nie; Jiawang,0,0,35,35
1683313945333,MATH 170A,A04,188815,Nie; Jiawang,13,0,35,22
1683313946357,MATH 193B,A01,188817,Staff,0,0,35,35
1683313946357,MATH 193B,A02,188818,Staff,6,0,35,29
1683313947381,MGT 4,A01,202857,Anderson; John Charles,62,0,80,18
1683313948404,MGT 12,A00,202858,Lindenberger; Wade Douglas,43,0,90,47
1683313949432,MGT 18,A00,202859,Staff,74,0,90,16
1683313950458,MGT 18GS,A00,202860,McKay; Michael J,13,0,28,15
1683313951485,MGT 45,A00,202861,Pecore; Joseph P.,14,0,90,76
1683313952512,MGT 100,A00,202863,Yavorsky; Daniel Ryan,28,0,90,62
1683313953537,MGT 103,A00,202864,Ehrich; Kristine R,0,16,90,90
1683313954563,MGT 112,A00,202865,Ehrich; Kristine R,15,0,90,75
1683313955596,MGT 121A,A00,202868,Staff,0,19,0,0
1683313956621,MGT 131B,A00,202869,Anderson; John Charles,59,0,90,31
1683313957653,MGT 136,A00,202871,Lindenberger; Wade Douglas,84,0,90,6
1683313958678,MGT 164,A00,202873,Staff,0,68,90,90
1683313959702,MGT 164GS,A00,202874,McKay; Mary A,13,0,28,15
1683313960730,MGT 180,A00,202875,Staff,0,50,90,90
1683313961761,MMW 11R,A01,205019,Herbst; Matthew,3,0,30,27
1683313961761,MMW 11R,A02,205026,Herbst; Matthew,29,0,30,1
1683313962794,MMW 15,A01,193512,Chang; Edmond Yi-Teh,0,9,28,28
1683313962794,MMW 15,A02,193513,Chang; Edmond Yi-Teh,0,5,28,28
1683313962794,MMW 15,A03,193514,Chang; Edmond Yi-Teh,0,5,28,28
1683313962794,MMW 15,A04,193515,Chang; Edmond Yi-Teh,0,5,28,28
1683313962794,MMW 15,A05,193516,Chang; Edmond Yi-Teh,0,4,28,28
1683313962794,MMW 15,A06,193517,Chang; Edmond Yi-Teh,0,5,28,28
1683313962794,MMW 15,B01,193519,Chang; Edmond Yi-Teh,0,4,28,28
1683313962794,MMW 15,B02,193520,Chang; Edmond Yi-Teh,0,5,28,28
1683313962794,MMW 15,B03,193521,Chang; Edmond Yi-Teh,0,4,28,28
1683313962794,MMW 15,B04,193522,Chang; Edmond Yi-Teh,0,4,28,28
1683313962794,MMW 15,B05,193523,Chang; Edmond Yi-Teh,0,5,28,28
1683313962794,MMW 15,B06,193524,Chang; Edmond Yi-Teh,0,4,28,28
1683313963819,MMW 122,A01,193526,Rahimi; Babak,0,14,28,28
1683313963819,MMW 122,A02,193527,Rahimi; Babak,0,14,28,28
1683313963819,MMW 122,A03,193528,Rahimi; Babak,0,0,0,0
1683313963819,MMW 122,A04,193529,Rahimi; Babak,0,0,0,0
1683313964842,MUS 1A,A01,186663,Staff,0,20,35,35
1683313965868,MUS 4,A01,186715,Staff,0,12,35,35
1683313966893,MUS 5R,A01,186796,Dubnov; Shlomo,0,17,35,35
1683313967917,MUS 6,A01,186798,Staff,0,3,25,25
1683313968944,MUS 7,A01,186830,Staff,12,0,35,23
1683313969969,MUS 8,A01,186930,Staff,0,26,35,35
1683313970997,MUS 15,A01,186932,Staff,0,15,35,35
1683313970997,MUS 15,B01,186934,Staff,0,15,35,35
1683313972022,MUS 80,A00,186935,Staff,2,0,20,18
1683313972022,MUS 80,B00,186936,Staff,25,0,25,0
1683313973045,NANO 11,A00,204702,Lipomi; Darren John,0,0,0,0
1683313974070,NANO 15,A01,204709,Yang; Kesong,0,1,0,0
1683313975097,NANO 114,A00,202069,Jahed Motlagh; Zeinab,3,0,10,7
1683313976122,PHIL 1,A00,186955,Grush; Rick Scott,32,0,40,8
1683313977146,PHIL 10,A01,186973,Grush; Rick Scott,28,0,35,7
1683313977146,PHIL 10,A02,186974,Grush; Rick Scott,33,0,35,2
1683313978169,PHIL 13,A01,186976,Staff,7,0,35,28
1683313978169,PHIL 13,A02,186977,Staff,16,0,35,19
1683313979193,PHIL 14,A01,186979,Staff,31,0,35,4
1683313979193,PHIL 14,A02,186986,Staff,32,0,35,3
1683313980221,PHIL 28,A01,186988,Staff,16,0,30,14
1683313980221,PHIL 28,A02,186989,Staff,1,0,30,29
1683313980221,PHIL 28,A03,186990,Staff,9,0,30,21
1683313980221,PHIL 28,A04,186991,Staff,26,0,30,4
1683313981265,PHIL 120,A00,186997,Staff,23,0,40,17
1683313982289,PHIL 137,A00,187003,Staff,9,0,40,31
1683313983314,PHIL 150,A00,187015,Staff,47,0,70,23
1683313984340,PHIL 167,A00,187021,Lamey; Andy M.,35,0,40,5
1683313985367,PHIL 174,A01,202226,Staff,17,0,20,3
1683313985367,PHIL 174,A02,202235,Staff,20,0,20,0
1683313986393,PHIL 191A,A00,258918,Staff,0,0,1,1
1683313987419,PHYS 1A,A00,187028,Staff,27,0,60,33
1683313988443,PHYS 1AL,001,187036,Staff,3,0,30,27
1683313988443,PHYS 1AL,002,187049,Staff,18,0,30,12
1683313989471,PHYS 1B,A00,187058,Staff,22,0,60,38
1683313990576,PHYS 1BL,001,187064,Staff,0,0,30,30
1683313990576,PHYS 1BL,002,187070,Staff,5,0,30,25
1683313991603,PHYS 1C,A00,187082,Staff,31,0,120,89
1683313992627,PHYS 1CL,001,187088,Staff,0,9,30,30
1683313992627,PHYS 1CL,002,187089,Staff,0,2,30,30
1683313992627,PHYS 1CL,009,262693,Staff,11,0,30,19
1683313993655,PHYS 2B,A01,187097,Staff,54,0,115,61
1683313994679,PHYS 2C,A01,187099,Staff,67,0,115,48
1683313995709,PHYS 2CL,A01,187101,Staff,5,0,28,23
1683313995709,PHYS 2CL,A02,187102,Staff,15,0,28,13
1683313996737,PHYS 2D,A01,187123,Shotwell; Brian,95,0,115,20
1683313997789,PHYS 4B,A01,187133,Grinstein; Benjamin,35,0,50,15
1683313998813,POLI 10,A00,188819,Staff,0,4,50,50
1683313999837,POLI 11,A00,188827,Staff,43,0,50,7
1683314000867,POLI 13R,A00,188828,Staff,0,1,20,20
1683314001892,POLI 27,A01,188830,Elgin; Samuel Zincke,0,1,70,70
1683314002915,POLI 30,A00,188832,Desposato; Scott,32,0,50,18
1683314003939,POLI 102F,A00,188834,Staff,3,0,40,37
1683314004966,POLI 104A,A00,188852,Staff,14,0,30,16
1683314005995,POLI 104I,A00,188853,Staff,0,6,20,20
1683314007020,POLI 110B,A00,188854,Wiens; David,7,0,20,13
1683314008047,POLI 112A,A00,188855,Wiens; David,5,0,30,25
1683314009072,POLI 117R,A00,188856,Forman; Fonna,0,11,20,20
1683314010097,POLI 118,A00,188857,Ingham; Sean,8,0,20,12
1683314011119,POLI 120G,A00,188858,Staff,9,0,30,21
1683314012143,POLI 131CR,A00,188863,Hoston; Germaine,24,0,50,26
1683314013170,POLI 133,A00,188864,Nellis; Gareth Hb,44,0,50,6
1683314014192,POLI 134D,A00,188865,Desposato; Scott,27,0,30,3
1683314015216,POLI 142A,A00,188871,Gartzke; Erik,22,0,50,28
1683314016240,POLI 142K,A00,188874,Staff,38,0,50,12
1683314017264,POLI 143,A00,188940,Gartzke; Erik,16,0,30,14
1683314018292,POLI 153,A00,188943,Staff,3,0,20,17
1683314019316,POLI 160AA,A00,188944,Staff,12,0,40,28
1683314020343,POLI 170A,A00,188945,Staff,11,0,30,19
1683314022398,PSYC 1,A00,188952,Staff,37,0,90,53
1683314023425,PSYC 2,B00,188953,Staff,19,0,35,16
1683314024452,PSYC 6,A00,188970,Staff,47,0,60,13
1683314025478,PSYC 7,A00,188973,Staff,37,0,45,8
1683314026505,PSYC 60,A01,188980,Rickard; Timothy C.,43,0,60,17
1683314027533,PSYC 70,A01,189001,Steiner; Eric Tomas,24,0,45,21
1683314028562,PSYC 100,A00,189005,Lacefield; Katharine I,0,99,120,120
1683314029587,PSYC 102,A00,189008,Staff,10,0,30,20
1683314030610,PSYC 106,B00,189026,Gorman; Michael R.,36,0,60,24
1683314031638,PSYC 114,B01,189033,Winkielman; Piotr,0,32,30,30
1683314032664,PSYC 131,A00,189036,Anagnostaras; Stephan,0,43,60,60
1683314033691,PSYC 136,A00,189041,Lowe; Angela Beth,0,7,25,25
1683314034718,PSYC 137,A00,189057,Winkielman; Piotr,0,34,25,25
1683314035746,PSYC 144,A00,189107,Wixted; John T,0,7,50,50
1683314037799,PSYC 162,A00,189142,Staff,0,8,85,85
1683314038824,PSYC 172,A00,189144,Gorman; Michael R.,0,7,30,30
1683314040883,PSYC 179,A00,189146,Lacefield; Katharine I,0,84,120,120
1683314041908,PSYC 181,A00,189147,Anagnostaras; Stephan,0,44,90,90
1683314042933,PSYC 190R,A00,189148,Barner; David A.,0,22,80,80
1683314043960,PSYC 191,A00,189275,Rickard; Timothy C.,0,7,25,25
1683314044986,PSYC 193,A00,189276,Chapman; Eddie Nathaniel,0,1,0,4
1683314046015,PSYC 193L,A01,189281,Lowe; Angela Beth,12,0,20,8
1683314046015,PSYC 193L,B01,189285,Staff,28,0,35,7
1683314047041,RELI 149,A00,187137,Rahimi; Babak,7,0,40,33
1683314048068,SE 9,A01,187315,Staff,0,2,18,18
1683314049094,SE 101B,A00,187409,Staff,24,0,30,6
1683314050120,SE 110B,A00,187444,Staff,10,0,40,30
1683314051144,SE 130B,A00,187449,Staff,31,0,40,9
1683314052173,SE 150A,A00,187516,Staff,9,0,20,11
1683314053201,SE 154,A00,187528,Staff,30,0,50,20
1683314054225,SIO 3,A01,258171,Staff,35,0,40,5
1683314055253,SIO 10,A00,187144,Cook; Geoffrey W,0,3,75,75
1683314056276,SIO 45,A00,187152,Cook; Geoffrey W,1,0,100,99
1683314057303,SIO 109R,A00,194486,Staff,0,3,20,20
1683314059357,SIO 187,A01,187233,Kacev; David,12,0,40,28
1683314060385,SOCI 1,A01,258656,Thorpe; Charles Robert,28,0,30,2
1683314060385,SOCI 1,A02,258658,Thorpe; Charles Robert,30,0,30,0
1683314060385,SOCI 1,A03,258661,Thorpe; Charles Robert,25,0,25,0
1683314060385,SOCI 1,A04,258666,Thorpe; Charles Robert,22,0,25,3
1683314060385,SOCI 1,A05,258897,Thorpe; Charles Robert,23,0,25,2
1683314060385,SOCI 1,A06,258898,Thorpe; Charles Robert,25,0,25,0
1683314061410,SOCI 30,A01,258903,Pardo Guerra; Juan Pablo,16,0,30,14
1683314062434,SOCI 102,A00,258904,Staff,9,0,25,16
1683314063459,SOCI 106,A00,258905,Staff,19,0,25,6
1683314064483,SOCI 111,A00,258907,Ribas Norris; Janet Vanesa,26,0,30,4
1683314065511,SOCI 121R,A00,258908,Pardo Guerra; Juan Pablo,11,0,30,19
1683314066536,SOCI 126,A01,203330,Staff,14,0,20,6
1683314067560,SOCI 131,A00,258909,Thorpe; Charles Robert,31,0,60,29
1683314068589,SOCI 135,A00,258910,Payne; Christine Anna,0,9,30,30
1683314069617,SOCI 157,A00,258911,Staff,12,0,30,18
1683314070649,SOCI 184,A00,258912,Staff,25,0,30,5
1683314071674,SOCI 188D,A00,258913,Staff,21,0,30,9
1683314072700,SYN 2,001,187529,Staff,9,0,16,7
1683314072700,SYN 2,002,201452,Staff,0,18,16,16
1683314072700,SYN 2,003,201469,Staff,3,0,16,13
1683314073729,SYN 100,A01,187531,Staff,0,9,20,20
1683314073729,SYN 100,B01,201491,Staff,0,12,20,20
1683314074754,TDAC 1,A00,189286,Walsh; Kim C.,3,0,20,17
1683314074754,TDAC 1,B00,189287,Harting; Carla Kelso,11,0,20,9
1683314075778,TDAC 101,A00,189300,Walsh; Kim C.,16,0,20,4
1683314075778,TDAC 101,B00,189301,Harting; Carla Kelso,18,0,20,2
1683314076805,TDAC 102,A00,189304,Basso; Beatrice,14,0,20,6
1683314077829,TDAC 108,A00,189305,Staff,18,0,20,2
1683314078858,TDDE 131,A00,189310,Staff,19,0,20,1
1683314078858,TDDE 131,B00,189314,Staff,19,0,20,1
1683314078858,TDDE 131,C00,189315,Staff,48,0,50,2
1683314078858,TDDE 131,D00,189316,Staff,14,0,15,1
1683314078858,TDDE 131,E00,204841,Staff,20,0,20,0
1683314079881,TDGE 10,A00,189289,Staff,30,0,50,20
1683314079881,TDGE 10,B00,189290,Havis; Allan,2,0,50,48
1683314080910,TDGE 11,A00,189291,Fulton; Julia,0,3,50,50
1683314080910,TDGE 11,B00,189292,Staff,20,0,25,5
1683314080910,TDGE 11,C00,260270,Staff,0,0,0,0
1683314081940,TDGE 25,A00,189294,Staff,3,0,20,17
1683314082967,TDGE 124,A00,189318,Fulton; Julia,0,8,50,50
1683314083992,TDGE 125,A00,189319,Staff,13,0,25,12
1683314083992,TDGE 125,B00,189320,Staff,23,0,25,2
1683314085015,TDGE 127,A00,189322,Havis; Allan,0,0,50,50
1683314086040,TDHT 101,A00,189323,Staff,18,0,25,7
1683314086040,TDHT 101,B00,189324,Staff,25,0,25,0
1683314087064,TDHT 102,A00,189325,Staff,49,0,50,1
1683314088091,TDMV 1,A00,189295,Arcidiacono; Kristin,20,0,30,10
1683314088091,TDMV 1,B00,189296,Caligagan; Maria T.,24,0,30,6
1683314089116,TDMV 2,A00,189297,Sammartano; Tonnie,28,0,30,2
1683314089116,TDMV 2,B00,189299,Arcidiacono; Kristin,24,0,30,6
1683314090139,TDMV 3,A00,204998,Rincon; Alicia,22,0,30,8
1683314091168,TDMV 120,A00,189458,Sammartano; Tonnie,28,0,30,2
1683314092192,TDMV 138,A00,189541,Jun; Grace Shin Hae,22,0,40,18
1683314093216,TDMV 142,A00,189717,Caligagan; Tony,23,0,30,7
1683314093216,TDMV 142,B00,189718,Caligagan; Maria T.,25,0,30,5
1683314094297,TMC 2,A01,187533,Staff,25,0,25,0
1683314094297,TMC 2,A02,187534,Staff,25,0,25,0
1683314095322,USP 1,A01,187536,Kwak; Nancy,0,16,25,25
1683314096347,USP 5,A01,187538,Staff,9,0,25,16
1683314097372,USP 101,A00,199253,Staff,0,4,0,0
1683314098399,USP 124,A00,187562,Boomhower; Matthew Charles,1,0,30,29
1683314099426,USP 138,A00,187582,Staff,20,0,25,5
1683314100450,USP 152,A01,187597,Staff,4,0,25,21
1683314101477,USP 153,A00,187598,Staff,19,0,25,6
1683314102500,USP 168,A00,187607,Kwak; Nancy,2,0,5,3
1683314103526,USP 173,A00,187619,Staff,4,0,25,21
1683314104551,USP 181,A00,187638,Staff,0,0,25,25
1683314105580,VIS 103,A00,187650,Cruz; Edwin Teddy,23,0,75,52
1683314106605,VIS 110D,A00,187669,Staff,12,0,22,10
1683314107630,VIS 127C,A00,187720,Shen; Kuiyi,68,0,146,78
1683314108655,VIS 149,A00,187731,Yoldas; Pinar,0,14,22,22
1683314109683,VIS 151,A01,188091,Staff,22,0,34,12
1683314109683,VIS 151,A02,188092,Staff,11,0,34,23
1683314110710,VIS 160B,A00,188093,Stalbaum; Brett,0,0,10,10
1683314112762,WCWP 10B,A00,201720,Staff,10,0,15,5
1683314112762,WCWP 10B,B00,201722,Staff,8,0,15,7
1683314113786,WCWP 100,A00,201725,Gagnon; Jeffrey C,0,0,2,2
1683314113786,WCWP 100,B00,201727,Staff,0,4,15,15
1683314116884,ANBI 133,A00,258401,Wilder; Linnea Lorene,34,0,40,6
1683314117908,ANBI 140,A00,258395,Hrvoj Mihic; Branka,18,0,25,7
1683314118936,ANSC 120,A00,258402,Bialecki; Jon Anthony,27,0,40,13
1683314119963,ANSC 144,A00,258400,Staff,14,0,40,26
1683314122016,ANSC 166,A00,258396,Parish; Steven Martin,157,0,175,18
1683314123040,ANSC 180,A00,193533,Staff,9,0,20,11
1683314124067,ANSC 188,A00,258397,Jassal; Aftab,33,0,40,7
1683314125090,ANTH 3,A01,258316,Staff,23,0,30,7
1683314126114,ANTH 5,A00,258394,Semendeferi; Ekaterini,16,0,20,4
1683314127138,ANTH 21,A01,258331,Staff,9,0,40,31
1683314128161,ANTH 103,A00,258398,Varma; Saiba,15,0,25,10
1683314129194,AWP 10,001,202034,Staff,0,0,0,0
1683314129194,AWP 10,002,202035,Staff,0,0,0,0
1683314129194,AWP 10,003,202036,Staff,0,0,0,0
1683314129194,AWP 10,004,202037,Staff,0,0,0,0
1683314129194,AWP 10,005,202038,Staff,0,0,0,0
1683314129194,AWP 10,006,202039,Staff,0,0,0,0
1683314129194,AWP 10,007,202040,Staff,0,0,0,0
1683314129194,AWP 10,008,202041,Staff,0,0,0,0
1683314129194,AWP 10,009,202042,Staff,0,0,0,0
1683314129194,AWP 10,010,202043,Staff,0,0,0,0
1683314129194,AWP 10,011,202044,Staff,0,0,0,0
1683314129194,AWP 10,012,202045,Staff,0,0,0,0
1683314129194,AWP 10,013,202046,Staff,0,0,0,0
1683314129194,AWP 10,014,202047,Staff,0,0,0,0
1683314129194,AWP 10,015,202048,Staff,0,0,0,0
1683314129194,AWP 10,016,202049,Staff,0,0,0,0
1683314129194,AWP 10,017,202050,Staff,0,0,0,0
1683314129194,AWP 10,018,202051,Staff,0,0,0,0
1683314129194,AWP 10,019,202052,Staff,0,0,0,0
1683314129194,AWP 10,020,202053,Staff,0,0,0,0
1683314129194,AWP 10,021,202054,Staff,0,0,0,0
1683314129194,AWP 10,022,202055,Staff,0,0,0,0
1683314129194,AWP 10,023,202056,Staff,0,0,0,0
1683314129194,AWP 10,024,202057,Staff,0,0,0,0
1683314129194,AWP 10,025,202058,Staff,0,0,0,0
1683314129194,AWP 10,026,202059,Staff,0,0,0,0
1683314130217,AWP 102,001,202032,Staff,0,0,0,0
1683314130217,AWP 102,002,202033,Staff,0,0,0,0
1683314131241,BENG 100,A01,254234,Taylor Amos; Alyssa C,31,0,40,9
1683314132265,BENG 196,001,270013,Engler; Adam J.,9999,0,9999,0
1683314133289,BICD 100R,A01,202018,Smith; Laurie,0,7,32,32
1683314133289,BICD 100R,A02,202019,Smith; Laurie,0,2,32,32
1683314133289,BICD 100R,A03,202020,Smith; Laurie,0,1,32,32
1683314133289,BICD 100R,A04,202021,Smith; Laurie,8,0,32,24
1683314133289,BICD 100R,A05,202022,Smith; Laurie,12,0,32,20
1683314134313,BICD 136,A01,193242,Gustafson-Brown; Cindy,0,2,32,32
1683314134313,BICD 136,A02,193244,Gustafson-Brown; Cindy,15,0,32,17
1683314135343,BIEB 102,A01,193249,Butler; Shannon Rhey,0,2,32,32
1683314135343,BIEB 102,A02,193251,Butler; Shannon Rhey,0,0,32,32
1683314135343,BIEB 102,A03,193253,Butler; Shannon Rhey,0,1,32,32
1683314135343,BIEB 102,A04,193255,Butler; Shannon Rhey,17,0,32,15
1683314135343,BIEB 102,A05,193265,Butler; Shannon Rhey,26,0,32,6
1683314135343,BIEB 102,A06,193269,Butler; Shannon Rhey,16,0,32,16
1683314137390,BIEB 150,A01,193274,Staff,0,0,32,32
1683314137390,BIEB 150,A02,193285,Staff,24,0,32,8
1683314138416,BIEB 194,A00,193286,Kurle; Carolyn M.,22,0,32,10
1683314139443,BILD 1,A01,192291,Staff,16,0,32,16
1683314139443,BILD 1,A02,192292,Staff,30,0,32,2
1683314139443,BILD 1,B01,192520,Reuther; Keefe,0,1,0,0
1683314139443,BILD 1,B02,192532,Reuther; Keefe,0,1,0,0
1683314140468,BILD 3,A01,192556,Butler; Shannon Rhey,0,0,32,32
1683314140468,BILD 3,A02,192581,Butler; Shannon Rhey,5,0,32,27
1683314140468,BILD 3,A03,192611,Butler; Shannon Rhey,23,0,32,9
1683314140468,BILD 3,A04,192612,Butler; Shannon Rhey,25,0,32,7
1683314140468,BILD 3,A05,192613,Butler; Shannon Rhey,27,0,32,5
1683314140468,BILD 3,A06,192679,Butler; Shannon Rhey,27,0,32,5
1683314140468,BILD 3,A07,192682,Butler; Shannon Rhey,22,0,32,10
1683314141494,BILD 4,A01,192836,Reuther; Keefe,1,0,24,23
1683314141494,BILD 4,A02,193044,Reuther; Keefe,4,0,24,20
1683314142520,BILD 10,A01,193142,Gustafson-Brown; Cindy,31,0,32,1
1683314142520,BILD 10,A02,193149,Gustafson-Brown; Cindy,31,0,32,1
1683314143545,BIMM 100,A01,193301,Staff,0,6,32,32
1683314143545,BIMM 100,A02,193312,Staff,0,5,32,32
1683314143545,BIMM 100,A03,193323,Staff,0,8,32,32
1683314144570,BIMM 101,A01,193329,McDonnell; Lisa Marie,0,3,24,24
1683314144570,BIMM 101,A02,193339,McDonnell; Lisa Marie,0,2,24,24
1683314144570,BIMM 101,B01,193354,McDonnell; Lisa Marie,0,3,24,24
1683314144570,BIMM 101,B02,193357,McDonnell; Lisa Marie,0,3,24,24
1683314145598,BIMM 110,A01,193377,Tat; John,0,11,32,32
1683314145598,BIMM 110,A02,193378,Tat; John,1,9,32,31
1683314146631,BIMM 120,A01,206116,Staff,0,0,32,32
1683314146631,BIMM 120,A02,206117,Staff,8,0,32,24
1683314146631,BIMM 120,A03,206121,Staff,21,0,32,11
1683314147656,BIPN 100,A01,193393,Park; Ji Young,0,14,32,32
1683314147656,BIPN 100,A02,193402,Park; Ji Young,0,12,32,32
1683314147656,BIPN 100,A03,193413,Park; Ji Young,0,14,32,32
1683314147656,BIPN 100,A04,193414,Park; Ji Young,0,13,32,32
1683314148683,BIPN 102,A01,193429,Staff,0,0,32,32
1683314148683,BIPN 102,A02,193438,Staff,22,0,32,10
1683314149707,BIPN 106,A01,193450,Reyes Gonzalez; Catalina,0,2,40,40
1683314150733,BIPN 134,A01,193465,Cooke; James Edward,0,0,32,32
1683314150733,BIPN 134,A02,193474,Cooke; James Edward,27,0,32,5
1683314150733,BIPN 134,A03,193485,Cooke; James Edward,29,0,32,3
1683314150733,BIPN 134,A04,193486,Cooke; James Edward,21,0,32,11
1683314150733,BIPN 134,A05,193491,Cooke; James Edward,31,0,32,1
1683314150733,BIPN 134,A06,193501,Cooke; James Edward,30,0,32,2
1683314150733,BIPN 134,A07,193510,Cooke; James Edward,29,0,32,3
1683314152787,BISP 194,A00,222522,Staff,16,0,32,16
1683314153812,CAT 124,A01,202407,Staff,20,0,25,5
1683314154839,CAT 125,A00,202408,Marchisotto; Jennifer Anne,4,0,20,16
1683314155867,CAT 125R,A00,202409,Smith; Lauryn Alissa,0,11,20,20
1683314155867,CAT 125R,B00,202410,Morales; Celeste Georgianna,0,11,20,20
1683314155867,CAT 125R,C00,202411,Irwin; Matthew Joseph,0,10,20,20
1683314156892,CENG 15,A01,204712,Yang; Kesong,0,1,0,0
1683314157919,CENG 114,A00,202070,Jahed Motlagh; Zeinab,5,0,20,15
1683314158948,CGS 105,A00,185477,Wesling; Megan E.,24,0,40,16
1683314159971,CGS 106,A00,185494,Staff,13,0,22,9
1683314160998,CGS 108,A00,185495,Staff,14,0,20,6
1683314162038,CGS 114,A00,185496,Staff,13,0,18,5
1683314163066,CGS 119,A00,185501,Staff,15,0,20,5
1683314164093,CGS 120,A00,185511,Staff,13,0,20,7
1683314165121,CHEM 4,A01,184675,Bussey; Thomas J,96,0,100,4
1683314166147,CHEM 6A,A01,184677,Staff,35,0,60,25
1683314167173,CHEM 6B,A01,184679,Staff,65,0,100,35
1683314168198,CHEM 6C,A01,184681,Bussey; Thomas J,1,0,50,49
1683314168198,CHEM 6C,A02,184682,Bussey; Thomas J,34,0,50,16
1683314169227,CHEM 40A,A01,184684,Albizati; Kim F.,37,0,100,63
1683314170251,CHEM 40B,A01,184686,Albizati; Kim F.,0,20,100,100
1683314171284,CHEM 41B,A01,184690,Staff,52,0,100,48
1683314172311,COGS 3,A01,184715,Boyle; Mary E. T.,0,25,40,40
1683314173336,COGS 14B,A01,185172,Staff,0,15,38,38
1683314174364,COGS 18,A01,184736,Staff,19,0,80,61
1683314175388,COGS 100,A01,184932,Staff,0,5,73,73
1683314176415,COGS 101A,A01,184935,Staff,0,38,30,30
1683314177440,COGS 101B,A01,184944,Staff,0,2,30,30
1683314178470,COGS 101C,A01,184946,Staff,0,12,30,30
1683314179495,COGS 102A,A01,184951,Johnson; Christine M.,2,0,40,38
1683314180526,COGS 107B,A01,184953,Mooshagian; Eric Frederick,0,50,40,40
1683314181551,COGS 118B,A01,184959,Gupta; Anjum,0,48,40,40
1683314182575,COGS 153,A00,184961,Staff,0,15,30,30
1683314183601,COGS 177,A00,184962,Staff,0,21,30,30
1683314184626,COGS 187A,A01,184969,Boyle; Mary E. T.,0,17,40,40
1683314185651,COMM 10,A01,185174,Staff,0,5,25,25
1683314185651,COMM 10,A02,185189,Staff,0,5,25,25
1683314185651,COMM 10,A03,269821,Staff,0,0,0,0
1683314186678,COMM 100B,A01,185475,Staff,0,0,0,2
1683314186678,COMM 100B,A02,185476,Staff,14,0,25,11
1683314187707,COMM 100C,A01,185314,Staff,1,0,25,24
1683314187707,COMM 100C,A02,185327,Staff,19,0,25,6
1683314188734,COMM 110M,A00,185349,Staff,2,0,40,38
1683314189762,COMM 113T,A00,185352,Staff,25,0,40,15
1683314190790,COMM 114I,A00,185353,Staff,33,0,40,7
1683314191818,COMM 131,A00,185354,Staff,19,0,30,11
1683314192846,CSE 8A,A50,185358,Cao; Yingjun,0,46,10,10
1683314193873,CSE 8B,A01,185362,Staff,1,47,50,49
1683314194901,CSE 11,A01,185416,Cao; Yingjun,0,91,10,10
1683314195927,CSE 20,A01,185445,Briones; Jor-el Thomas Caparas,5,0,25,20
1683314196951,CSE 21,A01,185447,Staff,10,0,50,40
1683314198036,CSE 101,A01,185451,Staff,0,12,50,50
1683314198036,CSE 101,B01,185453,Jones; Miles E,0,11,50,50
1683314200086,CSE 141,A01,185458,Eldon; John,20,0,100,80
1683314201114,CSE 141L,A01,185461,Eldon; John,12,0,100,88
1683314202139,CSE 142,A01,185463,Staff,36,0,60,24
1683314202139,CSE 142,B01,201355,Staff,0,7,60,60
1683314203164,CSE 142L,A01,185470,Staff,36,0,60,24
1683314203164,CSE 142L,B01,201417,Staff,0,6,60,60
1683314204193,CSE 190,A00,201433,Staff,32,0,49,17
1683314205221,DOC 1,A01,259136,Strom; Megan C.,7,0,15,8
1683314205221,DOC 1,A02,259137,Strom; Megan C.,14,0,15,1
1683314205221,DOC 1,A03,259138,Strom; Megan C.,14,0,15,1
1683314205221,DOC 1,A04,259139,Strom; Megan C.,14,0,15,1
1683314206244,DOC 100D,A00,259140,Pass; Natalye Joann,17,0,25,8
1683314207268,DSGN 1,A01,184749,Rill; Bryan,0,25,30,30
1683314208294,DSGN 100,A01,185168,Staff,0,2,25,25
1683314209320,ECE 5,A01,185626,Morris; Karcher William,0,10,0,0
1683314210344,ECE 101,A01,185628,Staff,17,0,70,53
1683314211368,ECE 107,A01,185635,Baghdadchi; Saharnaz,0,0,20,20
1683314211368,ECE 107,A02,185638,Baghdadchi; Saharnaz,4,0,20,16
1683314212395,ECE 148,A01,185647,Silberman; Jack,0,0,16,16
1683314213423,ECON 1,A01,185537,Crane; Meredith Helen,54,0,70,16
1683314214447,ECON 3,A01,185549,Crane; Meredith Helen,33,0,70,37
1683314215471,ECON 4,A01,203354,Anderson; John Charles,0,4,10,10
1683314216493,ECON 100A,A01,185574,Staff,0,4,40,40
1683314217519,ECON 100B,A01,185576,Staff,0,22,40,40
1683314218543,ECON 100C,A01,185589,Newhouse; Herbert S,30,0,70,40
1683314219567,ECON 105,A00,185608,Vespa; Emanuel Ignacio,19,0,35,16
1683314220595,ECON 109,A01,185610,Shishkin; Denis,10,0,35,25
1683314221620,ECON 110A,A01,185612,Staff,11,0,40,29
1683314222650,ECON 120A,A01,185615,Staff,20,0,40,20
1683314223675,ECON 120C,A01,185617,Sun; Yixiao,0,20,70,70
1683314224703,ECON 144,A00,203346,Squires; Dale E,3,0,35,32
1683314225730,ECON 171,A01,203349,Newhouse; Herbert S,0,1,35,35
1683314226758,ECON 173A,A01,185621,Toda; Alexis Akira,21,0,35,14
1683314227785,EDS 25,A01,202413,Staff,0,1,0,0
1683314227785,EDS 25,A02,202414,Staff,0,1,0,0
1683314227785,EDS 25,A03,202415,Staff,0,0,0,0
1683314227785,EDS 25,A04,202416,Staff,0,1,0,0
1683314227785,EDS 25,A05,202439,Staff,0,0,0,0
1683314227785,EDS 25,A06,202440,Staff,0,0,0,0
1683314227785,EDS 25,B01,202631,Staff,0,0,0,0
1683314227785,EDS 25,B02,202632,Staff,0,0,0,0
1683314227785,EDS 25,B03,202639,Staff,0,0,0,0
1683314227785,EDS 25,B04,202640,Staff,0,0,0,0
1683314227785,EDS 25,B05,202643,Staff,0,0,0,0
1683314227785,EDS 25,B06,202644,Staff,0,0,0,0
1683314228813,EDS 38,A01,202659,Black; Alison Michelle,24,0,25,1
1683314229841,EDS 115,A00,202652,Staff,17,0,30,13
1683314230866,EDS 125,A00,202649,Staff,14,0,30,16
1683314231893,EDS 126,A01,203332,Staff,30,0,30,0
1683314232917,EDS 139,A00,202838,Staff,16,0,25,9
1683314233942,EDS 146,A01,202655,Staff,14,0,25,11
1683314234966,ENG 15,A00,185667,Staff,0,1,0,0
1683314234966,ENG 15,B00,185672,Staff,0,0,0,0
1683314234966,ENG 15,C00,185675,Staff,0,0,0,0
1683314234966,ENG 15,D00,185682,Staff,0,0,0,0
1683314234966,ENG 15,E00,185684,Staff,0,0,0,0
1683314235992,ETHN 103,A00,185710,Staff,0,3,35,35
1683314237019,ETHN 103A,A00,199228,Man; Simeon S,2,0,9,7
1683314238047,ETHN 109,A00,185711,Staff,18,0,35,17
1683314239075,ETHN 142,A00,185726,Staff,0,4,30,30
1683314240164,ETHN 163J,A00,199229,Man; Simeon S,5,0,8,3
1683314241191,ETHN 168,A00,185727,Staff,8,0,10,2
1683314242216,ETHN 182,A00,185728,Staff,1,0,35,34
1683314243243,ETHN 183,A00,185737,Staff,8,0,18,10
1683314244267,GLBH 111,A01,209361,Burgos; Jose L.,0,0,0,0
1683314246315,HIEU 104,A00,185792,Staff,16,0,20,4
1683314247339,HIEU 115,A00,185800,Staff,1,0,20,19
1683314248362,HIEU 128,A00,185801,Staff,0,7,20,20
1683314249389,HIEU 147,A00,185802,Staff,16,0,20,4
1683314250414,HIEU 154,A00,185823,Staff,12,0,20,8
1683314251440,HILA 102,A00,185826,Staff,13,0,20,7
1683314252464,HILD 2C,A01,185778,Staff,0,12,20,20
1683314253493,HILD 7B,A01,185780,Kwak; Nancy,0,15,32,32
1683314253493,HILD 7B,A02,185781,Kwak; Nancy,0,18,32,32
1683314254518,HILD 30,A01,185791,Staff,14,0,20,6
1683314255546,HISC 119,A00,185830,Golan; Tal,0,9,20,20
1683314256573,HITO 156GS,A00,185831,Patterson; Patrick H.,0,0,0,23
1683314257598,HIUS 103,A00,185832,Man; Simeon S,0,6,20,20
1683314258622,HIUS 117,A00,185836,Kwak; Nancy,2,0,20,18
1683314259650,HIUS 125,A00,185840,Man; Simeon S,0,0,23,23
1683314260677,HIUS 149,A00,185845,Staff,0,0,20,20
1683314261707,HUM 3,A01,185882,Zavodny; Tatiana Sophia,0,6,50,50
1683314261707,HUM 3,B01,185899,Caldwell; Michael Alan,0,19,50,50
1683314262735,HUM 3GS,A00,185900,Patterson; Patrick H.,0,0,0,23
1683314263760,HUM 4,A01,185938,Zroka; Amy Liane,31,0,50,19
1683314263760,HUM 4,B01,185956,Watkins; Eric,0,2,50,50
1683314263760,HUM 4,B02,202209,Watkins; Eric,0,2,50,50
1683314263760,HUM 4,B03,202210,Watkins; Eric,0,0,50,50
1683314264789,HUM 5,A01,185958,West; Geoffrey Scott,4,0,50,46
1683314264789,HUM 5,A02,202215,West; Geoffrey Scott,0,0,50,50
1683314265813,INTL 190,A00,185959,Gagnon; Jeffrey C,0,0,0,9
1683314265813,INTL 190,B00,185960,Lettieri; Michael Joseph,0,0,0,1
1683314266840,JAPN 180,A00,254509,Staff,5,1,30,25
1683314267865,LATI 10,A01,202853,Kennemore; Amy Michelle,5,0,35,30
1683314267865,LATI 10,A02,202854,Kennemore; Amy Michelle,1,0,35,34
1683314267865,LATI 10,A03,270054,Kennemore; Amy Michelle,30,0,30,0
1683314268890,LATI 180,A00,202855,Kennemore; Amy Michelle,11,0,20,9
1683314269913,LAWS 101,A00,201767,Golan; Tal,0,7,40,40
1683314270938,LIFR 1C,A00,185961,Staff,6,0,20,14
1683314271961,LIFR 1CX,A00,185962,Staff,7,0,20,13
1683314272989,LIFR 1D,A00,185963,Staff,9,0,20,11
1683314274016,LIFR 1DX,A00,185964,Staff,9,0,20,11
1683314275040,LIGN 101,A01,186039,Staff,43,0,50,7
1683314276064,LIGN 165,A00,186040,Staff,18,0,50,32
1683314277090,LTCS 108,A00,186041,Staff,6,0,10,4
1683314278115,LTCS 119,A00,186042,Staff,16,0,20,4
1683314279140,LTCS 130,A00,186043,Wesling; Megan E.,15,0,25,10
1683314281191,LTEA 138,A00,186119,Staff,14,0,40,26
1683314282215,LTEN 124,A00,186148,Staff,6,0,25,19
1683314283251,LTEN 178,A00,186149,Staff,7,0,15,8
1683314284276,LTEN 181,A00,186150,Blanco; John D,33,0,40,7
1683314285304,LTWL 120,A00,186160,Staff,20,0,25,5
1683314286329,LTWL 165,A00,186161,Staff,22,0,25,3
1683314287355,LTWR 100,A00,186162,Staff,0,4,15,15
1683314288379,LTWR 102,A00,186163,Doller; Ben,5,0,15,10
1683314289408,MAE 8,A01,186412,Staff,0,0,0,0
1683314290434,MAE 30B,A00,186445,Bahadori; Mohammad Yousef,83,0,100,17
1683314291459,MAE 40,A00,186592,Bewley; Thomas R,9,0,50,41
1683314292484,MAE 101B,A00,186593,Bahadori; Mohammad Yousef,81,0,100,19
1683314293509,MAE 105,A00,186594,Bandaru; Prabhakar,12,0,50,38
1683314294534,MAE 107,A00,186599,Pham; Hieu Tan,0,6,120,120
1683314295598,MAE 148,A01,186660,Silberman; Jack,3,0,16,13
1683314296623,MATH 10A,A01,188095,Staff,0,6,35,35
1683314297649,MATH 10B,A01,188097,Bowers; Adam R.,0,11,30,30
1683314297649,MATH 10B,A02,188099,Bowers; Adam R.,0,11,30,30
1683314297649,MATH 10B,B01,188104,Bowers; Adam R.,0,11,30,30
1683314297649,MATH 10B,B02,188106,Bowers; Adam R.,0,10,30,30
1683314298679,MATH 10C,A01,188111,Staff,0,18,30,30
1683314298679,MATH 10C,A02,188127,Staff,0,17,30,30
1683314298679,MATH 10C,A03,188131,Staff,0,18,30,30
1683314298679,MATH 10C,B01,188218,Staff,20,0,30,10
1683314298679,MATH 10C,B02,188244,Staff,13,0,30,17
1683314298679,MATH 10C,B03,188277,Staff,16,0,30,14
1683314299708,MATH 18,A01,188344,Bach; Quang Tran,18,0,30,12
1683314299708,MATH 18,A02,188345,Bach; Quang Tran,11,0,30,19
1683314299708,MATH 18,B01,188353,Bach; Quang Tran,10,0,30,20
1683314299708,MATH 18,B02,188354,Bach; Quang Tran,20,0,30,10
1683314300733,MATH 20A,A01,188374,Staff,13,0,35,22
1683314301815,MATH 20B,A01,188382,Ohm; Ko Woon,6,0,30,24
1683314301815,MATH 20B,A02,188383,Ohm; Ko Woon,23,0,30,7
1683314301815,MATH 20B,B01,188385,Ohm; Ko Woon,7,0,30,23
1683314301815,MATH 20B,B02,188392,Ohm; Ko Woon,22,0,30,8
1683314302844,MATH 20C,A01,188394,Harel; Guershon,10,0,30,20
1683314302844,MATH 20C,A02,188395,Harel; Guershon,14,0,30,16
1683314302844,MATH 20C,B01,188404,Harel; Guershon,5,0,30,25
1683314302844,MATH 20C,B02,188405,Harel; Guershon,19,0,30,11
1683314303873,MATH 20D,A01,188414,Hammock; Frances H,0,1,30,30
1683314303873,MATH 20D,A02,188415,Hammock; Frances H,4,0,30,26
1683314303873,MATH 20D,B01,188447,Hammock; Frances H,2,0,30,28
1683314303873,MATH 20D,B02,188486,Hammock; Frances H,8,0,30,22
1683314304898,MATH 20E,A01,188649,Staff,21,0,30,9
1683314304898,MATH 20E,A02,188650,Staff,23,0,30,7
1683314304898,MATH 20E,A03,188673,Staff,0,0,30,30
1683314305926,MATH 102,A01,188675,Staff,0,35,35,35
1683314306952,MATH 103B,A01,188681,Staff,4,0,35,31
1683314306952,MATH 103B,B01,188692,Staff,5,0,35,30
1683314307977,MATH 109,A01,188695,Salehi Golsefidy; Alireza,25,0,35,10
1683314307977,MATH 109,A02,188696,Salehi Golsefidy; Alireza,27,0,35,8
1683314309001,MATH 120A,A01,188698,Eggers; John Dietrich,6,0,35,29
1683314310030,MATH 142B,A01,188736,Ioana; Adrian,0,2,30,30
1683314310030,MATH 142B,A02,188741,Ioana; Adrian,0,1,30,30
1683314310030,MATH 142B,A03,188743,Ioana; Adrian,1,3,30,29
1683314311058,MATH 168A,A01,188790,Staff,0,9,35,35
1683314312089,MATH 170A,A01,188803,Nie; Jiawang,0,2,35,35
1683314312089,MATH 170A,A02,188811,Nie; Jiawang,0,0,35,35
1683314312089,MATH 170A,A03,188814,Nie; Jiawang,0,0,35,35
1683314312089,MATH 170A,A04,188815,Nie; Jiawang,13,0,35,22
1683314313114,MATH 193B,A01,188817,Staff,0,0,35,35
1683314313114,MATH 193B,A02,188818,Staff,6,0,35,29
1683314314138,MGT 4,A01,202857,Anderson; John Charles,62,0,80,18
1683314315163,MGT 12,A00,202858,Lindenberger; Wade Douglas,43,0,90,47
1683314316187,MGT 18,A00,202859,Staff,74,0,90,16
1683314317213,MGT 18GS,A00,202860,McKay; Michael J,13,0,28,15
1683314318240,MGT 45,A00,202861,Pecore; Joseph P.,14,0,90,76
1683314319265,MGT 100,A00,202863,Yavorsky; Daniel Ryan,28,0,90,62
1683314320291,MGT 103,A00,202864,Ehrich; Kristine R,0,16,90,90
1683314321319,MGT 112,A00,202865,Ehrich; Kristine R,15,0,90,75
1683314322342,MGT 121A,A00,202868,Staff,0,19,0,0
1683314323366,MGT 131B,A00,202869,Anderson; John Charles,59,0,90,31
1683314324391,MGT 136,A00,202871,Lindenberger; Wade Douglas,84,0,90,6
1683314325415,MGT 164,A00,202873,Staff,0,68,90,90
1683314326441,MGT 164GS,A00,202874,McKay; Mary A,13,0,28,15
1683314327463,MGT 180,A00,202875,Staff,0,50,90,90
1683314328490,MMW 11R,A01,205019,Herbst; Matthew,3,0,30,27
1683314328490,MMW 11R,A02,205026,Herbst; Matthew,29,0,30,1
1683314329516,MMW 15,A01,193512,Chang; Edmond Yi-Teh,0,9,28,28
1683314329516,MMW 15,A02,193513,Chang; Edmond Yi-Teh,0,5,28,28
1683314329516,MMW 15,A03,193514,Chang; Edmond Yi-Teh,0,5,28,28
1683314329516,MMW 15,A04,193515,Chang; Edmond Yi-Teh,0,5,28,28
1683314329516,MMW 15,A05,193516,Chang; Edmond Yi-Teh,0,4,28,28
1683314329516,MMW 15,A06,193517,Chang; Edmond Yi-Teh,0,5,28,28
1683314329516,MMW 15,B01,193519,Chang; Edmond Yi-Teh,0,4,28,28
1683314329516,MMW 15,B02,193520,Chang; Edmond Yi-Teh,0,5,28,28
1683314329516,MMW 15,B03,193521,Chang; Edmond Yi-Teh,0,4,28,28
1683314329516,MMW 15,B04,193522,Chang; Edmond Yi-Teh,0,4,28,28
1683314329516,MMW 15,B05,193523,Chang; Edmond Yi-Teh,0,5,28,28
1683314329516,MMW 15,B06,193524,Chang; Edmond Yi-Teh,0,4,28,28
1683314330543,MMW 122,A01,193526,Rahimi; Babak,0,14,28,28
1683314330543,MMW 122,A02,193527,Rahimi; Babak,0,14,28,28
1683314330543,MMW 122,A03,193528,Rahimi; Babak,0,0,0,0
1683314330543,MMW 122,A04,193529,Rahimi; Babak,0,0,0,0
1683314331573,MUS 1A,A01,186663,Staff,0,20,35,35
1683314332602,MUS 4,A01,186715,Staff,0,12,35,35
1683314333630,MUS 5R,A01,186796,Dubnov; Shlomo,0,17,35,35
1683314334654,MUS 6,A01,186798,Staff,0,3,25,25
1683314335681,MUS 7,A01,186830,Staff,12,0,35,23
1683314336710,MUS 8,A01,186930,Staff,0,26,35,35
1683314337737,MUS 15,A01,186932,Staff,0,15,35,35
1683314337737,MUS 15,B01,186934,Staff,0,15,35,35
1683314338769,MUS 80,A00,186935,Staff,2,0,20,18
1683314338769,MUS 80,B00,186936,Staff,25,0,25,0
1683314339793,NANO 11,A00,204702,Lipomi; Darren John,0,0,0,0
1683314340821,NANO 15,A01,204709,Yang; Kesong,0,1,0,0
1683314341852,NANO 114,A00,202069,Jahed Motlagh; Zeinab,3,0,10,7
1683314342880,PHIL 1,A00,186955,Grush; Rick Scott,32,0,40,8
1683314343904,PHIL 10,A01,186973,Grush; Rick Scott,28,0,35,7
1683314343904,PHIL 10,A02,186974,Grush; Rick Scott,33,0,35,2
1683314344928,PHIL 13,A01,186976,Staff,7,0,35,28
1683314344928,PHIL 13,A02,186977,Staff,16,0,35,19
1683314345953,PHIL 14,A01,186979,Staff,31,0,35,4
1683314345953,PHIL 14,A02,186986,Staff,32,0,35,3
1683314346978,PHIL 28,A01,186988,Staff,16,0,30,14
1683314346978,PHIL 28,A02,186989,Staff,1,0,30,29
1683314346978,PHIL 28,A03,186990,Staff,9,0,30,21
1683314346978,PHIL 28,A04,186991,Staff,26,0,30,4
1683314348003,PHIL 120,A00,186997,Staff,23,0,40,17
1683314349029,PHIL 137,A00,187003,Staff,9,0,40,31
1683314350053,PHIL 150,A00,187015,Staff,47,0,70,23
1683314351080,PHIL 167,A00,187021,Lamey; Andy M.,35,0,40,5
1683314352104,PHIL 174,A01,202226,Staff,17,0,20,3
1683314352104,PHIL 174,A02,202235,Staff,20,0,20,0
1683314353131,PHIL 191A,A00,258918,Staff,0,0,1,1
1683314354164,PHYS 1A,A00,187028,Staff,27,0,60,33
1683314355193,PHYS 1AL,001,187036,Staff,3,0,30,27
1683314355193,PHYS 1AL,002,187049,Staff,18,0,30,12
1683314356217,PHYS 1B,A00,187058,Staff,22,0,60,38
1683314357243,PHYS 1BL,001,187064,Staff,0,0,30,30
1683314357243,PHYS 1BL,002,187070,Staff,5,0,30,25
1683314358273,PHYS 1C,A00,187082,Staff,31,0,120,89
1683314359303,PHYS 1CL,001,187088,Staff,0,9,30,30
1683314359303,PHYS 1CL,002,187089,Staff,0,2,30,30
1683314359303,PHYS 1CL,009,262693,Staff,11,0,30,19
1683314360328,PHYS 2B,A01,187097,Staff,54,0,115,61
1683314361356,PHYS 2C,A01,187099,Staff,67,0,115,48
1683314362379,PHYS 2CL,A01,187101,Staff,5,0,28,23
1683314362379,PHYS 2CL,A02,187102,Staff,15,0,28,13
1683314363407,PHYS 2D,A01,187123,Shotwell; Brian,95,0,115,20
1683314364431,PHYS 4B,A01,187133,Grinstein; Benjamin,35,0,50,15
1683314365458,POLI 10,A00,188819,Staff,0,4,50,50
1683314366482,POLI 11,A00,188827,Staff,43,0,50,7
1683314367508,POLI 13R,A00,188828,Staff,0,1,20,20
1683314368535,POLI 27,A01,188830,Elgin; Samuel Zincke,0,1,70,70
1683314369559,POLI 30,A00,188832,Desposato; Scott,32,0,50,18
1683314370583,POLI 102F,A00,188834,Staff,3,0,40,37
1683314371608,POLI 104A,A00,188852,Staff,14,0,30,16
1683314372632,POLI 104I,A00,188853,Staff,0,6,20,20
1683314373655,POLI 110B,A00,188854,Wiens; David,7,0,20,13
1683314374680,POLI 112A,A00,188855,Wiens; David,5,0,30,25
1683314375705,POLI 117R,A00,188856,Forman; Fonna,0,11,20,20
1683314376733,POLI 118,A00,188857,Ingham; Sean,8,0,20,12
1683314377769,POLI 120G,A00,188858,Staff,9,0,30,21
1683314378796,POLI 131CR,A00,188863,Hoston; Germaine,24,0,50,26
1683314379823,POLI 133,A00,188864,Nellis; Gareth Hb,44,0,50,6
1683314380851,POLI 134D,A00,188865,Desposato; Scott,27,0,30,3
1683314381878,POLI 142A,A00,188871,Gartzke; Erik,22,0,50,28
1683314382906,POLI 142K,A00,188874,Staff,38,0,50,12
1683314383933,POLI 143,A00,188940,Gartzke; Erik,16,0,30,14
1683314384960,POLI 153,A00,188943,Staff,3,0,20,17
1683314385988,POLI 160AA,A00,188944,Staff,12,0,40,28
1683314387012,POLI 170A,A00,188945,Staff,11,0,30,19
1683314389063,PSYC 1,A00,188952,Staff,37,0,90,53
1683314390087,PSYC 2,B00,188953,Staff,19,0,35,16
1683314391112,PSYC 6,A00,188970,Staff,47,0,60,13
1683314392133,PSYC 7,A00,188973,Staff,37,0,45,8
1683314393158,PSYC 60,A01,188980,Rickard; Timothy C.,43,0,60,17
1683314394186,PSYC 70,A01,189001,Steiner; Eric Tomas,24,0,45,21
1683314395211,PSYC 100,A00,189005,Lacefield; Katharine I,0,99,120,120
1683314396239,PSYC 102,A00,189008,Staff,10,0,30,20
1683314397262,PSYC 106,B00,189026,Gorman; Michael R.,36,0,60,24
1683314398285,PSYC 114,B01,189033,Winkielman; Piotr,0,32,30,30
1683314399310,PSYC 131,A00,189036,Anagnostaras; Stephan,0,43,60,60
1683314400339,PSYC 136,A00,189041,Lowe; Angela Beth,0,7,25,25
1683314401367,PSYC 137,A00,189057,Winkielman; Piotr,0,34,25,25
1683314402396,PSYC 144,A00,189107,Wixted; John T,0,7,50,50
1683314404452,PSYC 162,A00,189142,Staff,0,8,85,85
1683314405536,PSYC 172,A00,189144,Gorman; Michael R.,0,7,30,30
1683314407589,PSYC 179,A00,189146,Lacefield; Katharine I,0,84,120,120
1683314408621,PSYC 181,A00,189147,Anagnostaras; Stephan,0,44,90,90
1683314409649,PSYC 190R,A00,189148,Barner; David A.,0,22,80,80
1683314410673,PSYC 191,A00,189275,Rickard; Timothy C.,0,7,25,25
1683314411700,PSYC 193,A00,189276,Chapman; Eddie Nathaniel,0,1,0,4
1683314412725,PSYC 193L,A01,189281,Lowe; Angela Beth,12,0,20,8
1683314412725,PSYC 193L,B01,189285,Staff,28,0,35,7
1683314413751,RELI 149,A00,187137,Rahimi; Babak,7,0,40,33
1683314414775,SE 9,A01,187315,Staff,0,2,18,18
1683314415803,SE 101B,A00,187409,Staff,24,0,30,6
1683314416830,SE 110B,A00,187444,Staff,10,0,40,30
1683314417854,SE 130B,A00,187449,Staff,31,0,40,9
1683314418879,SE 150A,A00,187516,Staff,9,0,20,11
1683314419908,SE 154,A00,187528,Staff,30,0,50,20
1683314420932,SIO 3,A01,258171,Staff,35,0,40,5
1683314421956,SIO 10,A00,187144,Cook; Geoffrey W,0,3,75,75
1683314422983,SIO 45,A00,187152,Cook; Geoffrey W,1,0,100,99
1683314424007,SIO 109R,A00,194486,Staff,0,3,20,20
1683314426061,SIO 187,A01,187233,Kacev; David,12,0,40,28
1683314427089,SOCI 1,A01,258656,Thorpe; Charles Robert,28,0,30,2
1683314427089,SOCI 1,A02,258658,Thorpe; Charles Robert,30,0,30,0
1683314427089,SOCI 1,A03,258661,Thorpe; Charles Robert,25,0,25,0
1683314427089,SOCI 1,A04,258666,Thorpe; Charles Robert,22,0,25,3
1683314427089,SOCI 1,A05,258897,Thorpe; Charles Robert,23,0,25,2
1683314427089,SOCI 1,A06,258898,Thorpe; Charles Robert,25,0,25,0
1683314428112,SOCI 30,A01,258903,Pardo Guerra; Juan Pablo,16,0,30,14
1683314429139,SOCI 102,A00,258904,Staff,9,0,25,16
1683314430168,SOCI 106,A00,258905,Staff,19,0,25,6
1683314431192,SOCI 111,A00,258907,Ribas Norris; Janet Vanesa,26,0,30,4
1683314432215,SOCI 121R,A00,258908,Pardo Guerra; Juan Pablo,11,0,30,19
1683314433240,SOCI 126,A01,203330,Staff,14,0,20,6
1683314434268,SOCI 131,A00,258909,Thorpe; Charles Robert,31,0,60,29
1683314435293,SOCI 135,A00,258910,Payne; Christine Anna,0,9,30,30
1683314436317,SOCI 157,A00,258911,Staff,12,0,30,18
1683314437341,SOCI 184,A00,258912,Staff,25,0,30,5
1683314438368,SOCI 188D,A00,258913,Staff,21,0,30,9
1683314439393,SYN 2,001,187529,Staff,9,0,16,7
1683314439393,SYN 2,002,201452,Staff,0,18,16,16
1683314439393,SYN 2,003,201469,Staff,4,0,16,12
1683314440418,SYN 100,A01,187531,Staff,0,9,20,20
1683314440418,SYN 100,B01,201491,Staff,0,12,20,20
1683314441441,TDAC 1,A00,189286,Walsh; Kim C.,3,0,20,17
1683314441441,TDAC 1,B00,189287,Harting; Carla Kelso,11,0,20,9
1683314442465,TDAC 101,A00,189300,Walsh; Kim C.,16,0,20,4
1683314442465,TDAC 101,B00,189301,Harting; Carla Kelso,18,0,20,2
1683314443489,TDAC 102,A00,189304,Basso; Beatrice,14,0,20,6
1683314444512,TDAC 108,A00,189305,Staff,18,0,20,2
1683314445537,TDDE 131,A00,189310,Staff,19,0,20,1
1683314445537,TDDE 131,B00,189314,Staff,19,0,20,1
1683314445537,TDDE 131,C00,189315,Staff,48,0,50,2
1683314445537,TDDE 131,D00,189316,Staff,14,0,15,1
1683314445537,TDDE 131,E00,204841,Staff,20,0,20,0
1683314446561,TDGE 10,A00,189289,Staff,30,0,50,20
1683314446561,TDGE 10,B00,189290,Havis; Allan,2,0,50,48
1683314447590,TDGE 11,A00,189291,Fulton; Julia,0,3,50,50
1683314447590,TDGE 11,B00,189292,Staff,20,0,25,5
1683314447590,TDGE 11,C00,260270,Staff,0,0,0,0
1683314448614,TDGE 25,A00,189294,Staff,3,0,20,17
1683314449641,TDGE 124,A00,189318,Fulton; Julia,0,8,50,50
1683314450669,TDGE 125,A00,189319,Staff,13,0,25,12
1683314450669,TDGE 125,B00,189320,Staff,23,0,25,2
1683314451693,TDGE 127,A00,189322,Havis; Allan,0,0,50,50
1683314452719,TDHT 101,A00,189323,Staff,18,0,25,7
1683314452719,TDHT 101,B00,189324,Staff,25,0,25,0
1683314453743,TDHT 102,A00,189325,Staff,49,0,50,1
1683314454771,TDMV 1,A00,189295,Arcidiacono; Kristin,20,0,30,10
1683314454771,TDMV 1,B00,189296,Caligagan; Maria T.,24,0,30,6
1683314455799,TDMV 2,A00,189297,Sammartano; Tonnie,28,0,30,2
1683314455799,TDMV 2,B00,189299,Arcidiacono; Kristin,24,0,30,6
1683314456823,TDMV 3,A00,204998,Rincon; Alicia,22,0,30,8
1683314457848,TDMV 120,A00,189458,Sammartano; Tonnie,28,0,30,2
1683314458875,TDMV 138,A00,189541,Jun; Grace Shin Hae,22,0,40,18
1683314459901,TDMV 142,A00,189717,Caligagan; Tony,23,0,30,7
1683314459901,TDMV 142,B00,189718,Caligagan; Maria T.,25,0,30,5
1683314460924,TMC 2,A01,187533,Staff,25,0,25,0
1683314460924,TMC 2,A02,187534,Staff,25,0,25,0
1683314461950,USP 1,A01,187536,Kwak; Nancy,0,16,25,25
1683314462974,USP 5,A01,187538,Staff,9,0,25,16
1683314464001,USP 101,A00,199253,Staff,0,4,0,0
1683314465024,USP 124,A00,187562,Boomhower; Matthew Charles,1,0,30,29
1683314466051,USP 138,A00,187582,Staff,20,0,25,5
1683314467075,USP 152,A01,187597,Staff,4,0,25,21
1683314468101,USP 153,A00,187598,Staff,19,0,25,6
1683314469129,USP 168,A00,187607,Kwak; Nancy,2,0,5,3
1683314470156,USP 173,A00,187619,Staff,4,0,25,21
1683314471180,USP 181,A00,187638,Staff,0,0,25,25
1683314472203,VIS 103,A00,187650,Cruz; Edwin Teddy,23,0,75,52
1683314473225,VIS 110D,A00,187669,Staff,12,0,22,10
1683314474254,VIS 127C,A00,187720,Shen; Kuiyi,68,0,146,78
1683314475277,VIS 149,A00,187731,Yoldas; Pinar,0,14,22,22
1683314476301,VIS 151,A01,188091,Staff,22,0,34,12
1683314476301,VIS 151,A02,188092,Staff,11,0,34,23
1683314477325,VIS 160B,A00,188093,Stalbaum; Brett,0,0,10,10
1683314479376,WCWP 10B,A00,201720,Staff,10,0,15,5
1683314479376,WCWP 10B,B00,201722,Staff,8,0,15,7
1683314480404,WCWP 100,A00,201725,Gagnon; Jeffrey C,0,0,2,2
1683314480404,WCWP 100,B00,201727,Staff,0,4,15,15
1683314483492,ANBI 133,A00,258401,Wilder; Linnea Lorene,34,0,40,6
1683314484518,ANBI 140,A00,258395,Hrvoj Mihic; Branka,18,0,25,7
1683314485545,ANSC 120,A00,258402,Bialecki; Jon Anthony,27,0,40,13
1683314486569,ANSC 144,A00,258400,Staff,14,0,40,26
1683314488620,ANSC 166,A00,258396,Parish; Steven Martin,157,0,175,18
1683314489646,ANSC 180,A00,193533,Staff,9,0,20,11
1683314490672,ANSC 188,A00,258397,Jassal; Aftab,33,0,40,7
1683314491696,ANTH 3,A01,258316,Staff,23,0,30,7
1683314492721,ANTH 5,A00,258394,Semendeferi; Ekaterini,16,0,20,4
1683314493746,ANTH 21,A01,258331,Staff,9,0,40,31
1683314494770,ANTH 103,A00,258398,Varma; Saiba,15,0,25,10
1683314495798,AWP 10,001,202034,Staff,0,0,0,0
1683314495798,AWP 10,002,202035,Staff,0,0,0,0
1683314495798,AWP 10,003,202036,Staff,0,0,0,0
1683314495798,AWP 10,004,202037,Staff,0,0,0,0
1683314495798,AWP 10,005,202038,Staff,0,0,0,0
1683314495798,AWP 10,006,202039,Staff,0,0,0,0
1683314495798,AWP 10,007,202040,Staff,0,0,0,0
1683314495798,AWP 10,008,202041,Staff,0,0,0,0
1683314495798,AWP 10,009,202042,Staff,0,0,0,0
1683314495798,AWP 10,010,202043,Staff,0,0,0,0
1683314495798,AWP 10,011,202044,Staff,0,0,0,0
1683314495798,AWP 10,012,202045,Staff,0,0,0,0
1683314495798,AWP 10,013,202046,Staff,0,0,0,0
1683314495798,AWP 10,014,202047,Staff,0,0,0,0
1683314495798,AWP 10,015,202048,Staff,0,0,0,0
1683314495798,AWP 10,016,202049,Staff,0,0,0,0
1683314495798,AWP 10,017,202050,Staff,0,0,0,0
1683314495798,AWP 10,018,202051,Staff,0,0,0,0
1683314495798,AWP 10,019,202052,Staff,0,0,0,0
1683314495798,AWP 10,020,202053,Staff,0,0,0,0
1683314495798,AWP 10,021,202054,Staff,0,0,0,0
1683314495798,AWP 10,022,202055,Staff,0,0,0,0
1683314495798,AWP 10,023,202056,Staff,0,0,0,0
1683314495798,AWP 10,024,202057,Staff,0,0,0,0
1683314495798,AWP 10,025,202058,Staff,0,0,0,0
1683314495798,AWP 10,026,202059,Staff,0,0,0,0
1683314496822,AWP 102,001,202032,Staff,0,0,0,0
1683314496822,AWP 102,002,202033,Staff,0,0,0,0
1683314497846,BENG 100,A01,254234,Taylor Amos; Alyssa C,31,0,40,9
1683314498871,BENG 196,001,270013,Engler; Adam J.,9999,0,9999,0
1683314499897,BICD 100R,A01,202018,Smith; Laurie,0,7,32,32
1683314499897,BICD 100R,A02,202019,Smith; Laurie,0,2,32,32
1683314499897,BICD 100R,A03,202020,Smith; Laurie,0,1,32,32
1683314499897,BICD 100R,A04,202021,Smith; Laurie,8,0,32,24
1683314499897,BICD 100R,A05,202022,Smith; Laurie,12,0,32,20
1683314500921,BICD 136,A01,193242,Gustafson-Brown; Cindy,0,2,32,32
1683314500921,BICD 136,A02,193244,Gustafson-Brown; Cindy,15,0,32,17
1683314501946,BIEB 102,A01,193249,Butler; Shannon Rhey,0,2,32,32
1683314501946,BIEB 102,A02,193251,Butler; Shannon Rhey,0,0,32,32
1683314501946,BIEB 102,A03,193253,Butler; Shannon Rhey,0,1,32,32
1683314501946,BIEB 102,A04,193255,Butler; Shannon Rhey,17,0,32,15
1683314501946,BIEB 102,A05,193265,Butler; Shannon Rhey,26,0,32,6
1683314501946,BIEB 102,A06,193269,Butler; Shannon Rhey,16,0,32,16
1683314503995,BIEB 150,A01,193274,Staff,0,0,32,32
1683314503995,BIEB 150,A02,193285,Staff,24,0,32,8
1683314505019,BIEB 194,A00,193286,Kurle; Carolyn M.,22,0,32,10
1683314506048,BILD 1,A01,192291,Staff,16,0,32,16
1683314506048,BILD 1,A02,192292,Staff,30,0,32,2
1683314506048,BILD 1,B01,192520,Reuther; Keefe,0,1,0,0
1683314506048,BILD 1,B02,192532,Reuther; Keefe,0,1,0,0
1683314507073,BILD 3,A01,192556,Butler; Shannon Rhey,0,0,32,32
1683314507073,BILD 3,A02,192581,Butler; Shannon Rhey,5,0,32,27
1683314507073,BILD 3,A03,192611,Butler; Shannon Rhey,23,0,32,9
1683314507073,BILD 3,A04,192612,Butler; Shannon Rhey,25,0,32,7
1683314507073,BILD 3,A05,192613,Butler; Shannon Rhey,27,0,32,5
1683314507073,BILD 3,A06,192679,Butler; Shannon Rhey,27,0,32,5
1683314507073,BILD 3,A07,192682,Butler; Shannon Rhey,22,0,32,10
1683314508101,BILD 4,A01,192836,Reuther; Keefe,1,0,24,23
1683314508101,BILD 4,A02,193044,Reuther; Keefe,4,0,24,20
1683314509208,BILD 10,A01,193142,Gustafson-Brown; Cindy,31,0,32,1
1683314509208,BILD 10,A02,193149,Gustafson-Brown; Cindy,31,0,32,1
1683314510232,BIMM 100,A01,193301,Staff,0,6,32,32
1683314510232,BIMM 100,A02,193312,Staff,0,5,32,32
1683314510232,BIMM 100,A03,193323,Staff,0,8,32,32
1683314511261,BIMM 101,A01,193329,McDonnell; Lisa Marie,0,3,24,24
1683314511261,BIMM 101,A02,193339,McDonnell; Lisa Marie,0,2,24,24
1683314511261,BIMM 101,B01,193354,McDonnell; Lisa Marie,0,3,24,24
1683314511261,BIMM 101,B02,193357,McDonnell; Lisa Marie,0,3,24,24
1683314512286,BIMM 110,A01,193377,Tat; John,0,11,32,32
1683314512286,BIMM 110,A02,193378,Tat; John,1,9,32,31
1683314513310,BIMM 120,A01,206116,Staff,0,0,32,32
1683314513310,BIMM 120,A02,206117,Staff,8,0,32,24
1683314513310,BIMM 120,A03,206121,Staff,21,0,32,11
1683314514338,BIPN 100,A01,193393,Park; Ji Young,0,14,32,32
1683314514338,BIPN 100,A02,193402,Park; Ji Young,0,12,32,32
1683314514338,BIPN 100,A03,193413,Park; Ji Young,0,14,32,32
1683314514338,BIPN 100,A04,193414,Park; Ji Young,0,13,32,32
1683314515362,BIPN 102,A01,193429,Staff,0,0,32,32
1683314515362,BIPN 102,A02,193438,Staff,22,0,32,10
1683314516387,BIPN 106,A01,193450,Reyes Gonzalez; Catalina,0,2,40,40
1683314517416,BIPN 134,A01,193465,Cooke; James Edward,0,0,32,32
1683314517416,BIPN 134,A02,193474,Cooke; James Edward,27,0,32,5
1683314517416,BIPN 134,A03,193485,Cooke; James Edward,29,0,32,3
1683314517416,BIPN 134,A04,193486,Cooke; James Edward,21,0,32,11
1683314517416,BIPN 134,A05,193491,Cooke; James Edward,31,0,32,1
1683314517416,BIPN 134,A06,193501,Cooke; James Edward,30,0,32,2
1683314517416,BIPN 134,A07,193510,Cooke; James Edward,29,0,32,3
1683314519468,BISP 194,A00,222522,Staff,16,0,32,16
1683314520493,CAT 124,A01,202407,Staff,20,0,25,5
1683314521519,CAT 125,A00,202408,Marchisotto; Jennifer Anne,4,0,20,16
1683314522548,CAT 125R,A00,202409,Smith; Lauryn Alissa,0,11,20,20
1683314522548,CAT 125R,B00,202410,Morales; Celeste Georgianna,0,11,20,20
1683314522548,CAT 125R,C00,202411,Irwin; Matthew Joseph,0,10,20,20
1683314523581,CENG 15,A01,204712,Yang; Kesong,0,1,0,0
1683314524606,CENG 114,A00,202070,Jahed Motlagh; Zeinab,5,0,20,15
1683314525633,CGS 105,A00,185477,Wesling; Megan E.,24,0,40,16
1683314526657,CGS 106,A00,185494,Staff,13,0,22,9
1683314527683,CGS 108,A00,185495,Staff,14,0,20,6
1683314528708,CGS 114,A00,185496,Staff,13,0,18,5
1683314529731,CGS 119,A00,185501,Staff,15,0,20,5
1683314530755,CGS 120,A00,185511,Staff,13,0,20,7
1683314531779,CHEM 4,A01,184675,Bussey; Thomas J,96,0,100,4
1683314532807,CHEM 6A,A01,184677,Staff,35,0,60,25
1683314533834,CHEM 6B,A01,184679,Staff,65,0,100,35
1683314534862,CHEM 6C,A01,184681,Bussey; Thomas J,1,0,50,49
1683314534862,CHEM 6C,A02,184682,Bussey; Thomas J,34,0,50,16
1683314535889,CHEM 40A,A01,184684,Albizati; Kim F.,37,0,100,63
1683314536917,CHEM 40B,A01,184686,Albizati; Kim F.,0,20,100,100
1683314537944,CHEM 41B,A01,184690,Staff,52,0,100,48
1683314538969,COGS 3,A01,184715,Boyle; Mary E. T.,0,25,40,40
1683314539996,COGS 14B,A01,185172,Staff,0,15,38,38
1683314541028,COGS 18,A01,184736,Staff,19,0,80,61
1683314542057,COGS 100,A01,184932,Staff,0,5,73,73
1683314543083,COGS 101A,A01,184935,Staff,0,38,30,30
1683314544165,COGS 101B,A01,184944,Staff,0,2,30,30
1683314545190,COGS 101C,A01,184946,Staff,0,12,30,30
1683314546216,COGS 102A,A01,184951,Johnson; Christine M.,2,0,40,38
1683314547241,COGS 107B,A01,184953,Mooshagian; Eric Frederick,0,50,40,40
1683314548267,COGS 118B,A01,184959,Gupta; Anjum,0,48,40,40
1683314549292,COGS 153,A00,184961,Staff,0,15,30,30
1683314550316,COGS 177,A00,184962,Staff,0,21,30,30
1683314551343,COGS 187A,A01,184969,Boyle; Mary E. T.,0,17,40,40
1683314552367,COMM 10,A01,185174,Staff,0,5,25,25
1683314552367,COMM 10,A02,185189,Staff,0,5,25,25
1683314552367,COMM 10,A03,269821,Staff,0,0,0,0
1683314553391,COMM 100B,A01,185475,Staff,0,0,0,2
1683314553391,COMM 100B,A02,185476,Staff,14,0,25,11
1683314554415,COMM 100C,A01,185314,Staff,1,0,25,24
1683314554415,COMM 100C,A02,185327,Staff,19,0,25,6
1683314555440,COMM 110M,A00,185349,Staff,2,0,40,38
1683314556466,COMM 113T,A00,185352,Staff,25,0,40,15
1683314557491,COMM 114I,A00,185353,Staff,33,0,40,7
1683314558515,COMM 131,A00,185354,Staff,19,0,30,11
1683314559539,CSE 8A,A50,185358,Cao; Yingjun,0,46,10,10
1683314560563,CSE 8B,A01,185362,Staff,1,47,50,49
1683314561587,CSE 11,A01,185416,Cao; Yingjun,0,91,10,10
1683314562611,CSE 20,A01,185445,Briones; Jor-el Thomas Caparas,5,0,25,20
1683314563637,CSE 21,A01,185447,Staff,10,0,50,40
1683314564665,CSE 101,A01,185451,Staff,0,12,50,50
1683314564665,CSE 101,B01,185453,Jones; Miles E,0,11,50,50
1683314566719,CSE 141,A01,185458,Eldon; John,20,0,100,80
1683314567743,CSE 141L,A01,185461,Eldon; John,12,0,100,88
1683314568769,CSE 142,A01,185463,Staff,36,0,60,24
1683314568769,CSE 142,B01,201355,Staff,0,7,60,60
1683314569794,CSE 142L,A01,185470,Staff,36,0,60,24
1683314569794,CSE 142L,B01,201417,Staff,0,6,60,60
1683314570823,CSE 190,A00,201433,Staff,32,0,49,17
1683314571847,DOC 1,A01,259136,Strom; Megan C.,7,0,15,8
1683314571847,DOC 1,A02,259137,Strom; Megan C.,14,0,15,1
1683314571847,DOC 1,A03,259138,Strom; Megan C.,14,0,15,1
1683314571847,DOC 1,A04,259139,Strom; Megan C.,14,0,15,1
1683314572873,DOC 100D,A00,259140,Pass; Natalye Joann,17,0,25,8
1683314573901,DSGN 1,A01,184749,Rill; Bryan,0,25,30,30
1683314574925,DSGN 100,A01,185168,Staff,0,2,25,25
1683314575950,ECE 5,A01,185626,Morris; Karcher William,0,10,0,0
1683314576975,ECE 101,A01,185628,Staff,17,0,70,53
1683314578000,ECE 107,A01,185635,Baghdadchi; Saharnaz,0,0,20,20
1683314578000,ECE 107,A02,185638,Baghdadchi; Saharnaz,4,0,20,16
1683314579027,ECE 148,A01,185647,Silberman; Jack,0,0,16,16
1683314580051,ECON 1,A01,185537,Crane; Meredith Helen,54,0,70,16
1683314581084,ECON 3,A01,185549,Crane; Meredith Helen,33,0,70,37
1683314582109,ECON 4,A01,203354,Anderson; John Charles,0,4,10,10
1683314583132,ECON 100A,A01,185574,Staff,0,4,40,40
1683314584162,ECON 100B,A01,185576,Staff,0,22,40,40
1683314585190,ECON 100C,A01,185589,Newhouse; Herbert S,30,0,70,40
1683314586214,ECON 105,A00,185608,Vespa; Emanuel Ignacio,19,0,35,16
1683314587238,ECON 109,A01,185610,Shishkin; Denis,10,0,35,25
1683314588265,ECON 110A,A01,185612,Staff,11,0,40,29
1683314589290,ECON 120A,A01,185615,Staff,20,0,40,20
1683314590319,ECON 120C,A01,185617,Sun; Yixiao,0,20,70,70
1683314591345,ECON 144,A00,203346,Squires; Dale E,3,0,35,32
1683314592373,ECON 171,A01,203349,Newhouse; Herbert S,0,1,35,35
1683314593399,ECON 173A,A01,185621,Toda; Alexis Akira,21,0,35,14
1683314594429,EDS 25,A01,202413,Staff,0,1,0,0
1683314594429,EDS 25,A02,202414,Staff,0,1,0,0
1683314594429,EDS 25,A03,202415,Staff,0,0,0,0
1683314594429,EDS 25,A04,202416,Staff,0,1,0,0
1683314594429,EDS 25,A05,202439,Staff,0,0,0,0
1683314594429,EDS 25,A06,202440,Staff,0,0,0,0
1683314594429,EDS 25,B01,202631,Staff,0,0,0,0
1683314594429,EDS 25,B02,202632,Staff,0,0,0,0
1683314594429,EDS 25,B03,202639,Staff,0,0,0,0
1683314594429,EDS 25,B04,202640,Staff,0,0,0,0
1683314594429,EDS 25,B05,202643,Staff,0,0,0,0
1683314594429,EDS 25,B06,202644,Staff,0,0,0,0
1683314595453,EDS 38,A01,202659,Black; Alison Michelle,24,0,25,1
1683314596479,EDS 115,A00,202652,Staff,17,0,30,13
1683314597503,EDS 125,A00,202649,Staff,14,0,30,16
1683314598530,EDS 126,A01,203332,Staff,30,0,30,0
1683314599557,EDS 139,A00,202838,Staff,16,0,25,9
1683314600582,EDS 146,A01,202655,Staff,14,0,25,11
1683314601610,ENG 15,A00,185667,Staff,0,1,0,0
1683314601610,ENG 15,B00,185672,Staff,0,0,0,0
1683314601610,ENG 15,C00,185675,Staff,0,0,0,0
1683314601610,ENG 15,D00,185682,Staff,0,0,0,0
1683314601610,ENG 15,E00,185684,Staff,0,0,0,0
1683314602637,ETHN 103,A00,185710,Staff,0,3,35,35
1683314603660,ETHN 103A,A00,199228,Man; Simeon S,2,0,9,7
1683314604685,ETHN 109,A00,185711,Staff,18,0,35,17
1683314605712,ETHN 142,A00,185726,Staff,0,4,30,30
1683314606740,ETHN 163J,A00,199229,Man; Simeon S,5,0,8,3
1683314607766,ETHN 168,A00,185727,Staff,8,0,10,2
1683314608791,ETHN 182,A00,185728,Staff,1,0,35,34
1683314609818,ETHN 183,A00,185737,Staff,8,0,18,10
1683314610842,GLBH 111,A01,209361,Burgos; Jose L.,0,0,0,0
1683314612958,HIEU 104,A00,185792,Staff,16,0,20,4
1683314613982,HIEU 115,A00,185800,Staff,1,0,20,19
1683314615006,HIEU 128,A00,185801,Staff,0,7,20,20
1683314616031,HIEU 147,A00,185802,Staff,16,0,20,4
1683314617059,HIEU 154,A00,185823,Staff,12,0,20,8
1683314618086,HILA 102,A00,185826,Staff,13,0,20,7
1683314619115,HILD 2C,A01,185778,Staff,0,12,20,20
1683314620142,HILD 7B,A01,185780,Kwak; Nancy,0,15,32,32
1683314620142,HILD 7B,A02,185781,Kwak; Nancy,0,18,32,32
1683314621166,HILD 30,A01,185791,Staff,14,0,20,6
1683314622190,HISC 119,A00,185830,Golan; Tal,0,9,20,20
1683314623213,HITO 156GS,A00,185831,Patterson; Patrick H.,0,0,0,23
1683314624242,HIUS 103,A00,185832,Man; Simeon S,0,6,20,20
1683314625265,HIUS 117,A00,185836,Kwak; Nancy,2,0,20,18
1683314626288,HIUS 125,A00,185840,Man; Simeon S,0,0,23,23
1683314627315,HIUS 149,A00,185845,Staff,0,0,20,20
1683314628340,HUM 3,A01,185882,Zavodny; Tatiana Sophia,0,6,50,50
1683314628340,HUM 3,B01,185899,Caldwell; Michael Alan,0,19,50,50
1683314629368,HUM 3GS,A00,185900,Patterson; Patrick H.,0,0,0,23
1683314630394,HUM 4,A01,185938,Zroka; Amy Liane,31,0,50,19
1683314630394,HUM 4,B01,185956,Watkins; Eric,0,2,50,50
1683314630394,HUM 4,B02,202209,Watkins; Eric,0,2,50,50
1683314630394,HUM 4,B03,202210,Watkins; Eric,0,0,50,50
1683314631419,HUM 5,A01,185958,West; Geoffrey Scott,4,0,50,46
1683314631419,HUM 5,A02,202215,West; Geoffrey Scott,0,0,50,50
1683314632444,INTL 190,A00,185959,Gagnon; Jeffrey C,0,0,0,9
1683314632444,INTL 190,B00,185960,Lettieri; Michael Joseph,0,0,0,1
1683314633469,JAPN 180,A00,254509,Staff,5,1,30,25
1683314634494,LATI 10,A01,202853,Kennemore; Amy Michelle,5,0,35,30
1683314634494,LATI 10,A02,202854,Kennemore; Amy Michelle,1,0,35,34
1683314634494,LATI 10,A03,270054,Kennemore; Amy Michelle,30,0,30,0
1683314635521,LATI 180,A00,202855,Kennemore; Amy Michelle,11,0,20,9
1683314636547,LAWS 101,A00,201767,Golan; Tal,0,7,40,40
1683314637571,LIFR 1C,A00,185961,Staff,6,0,20,14
1683314638600,LIFR 1CX,A00,185962,Staff,7,0,20,13
1683314639625,LIFR 1D,A00,185963,Staff,9,0,20,11
1683314640652,LIFR 1DX,A00,185964,Staff,9,0,20,11
1683314641677,LIGN 101,A01,186039,Staff,43,0,50,7
1683314642706,LIGN 165,A00,186040,Staff,18,0,50,32
1683314643729,LTCS 108,A00,186041,Staff,6,0,10,4
1683314644756,LTCS 119,A00,186042,Staff,16,0,20,4
1683314645783,LTCS 130,A00,186043,Wesling; Megan E.,15,0,25,10
1683314647837,LTEA 138,A00,186119,Staff,14,0,40,26
1683314648864,LTEN 124,A00,186148,Staff,6,0,25,19
1683314649889,LTEN 178,A00,186149,Staff,7,0,15,8
1683314650915,LTEN 181,A00,186150,Blanco; John D,33,0,40,7
1683314651940,LTWL 120,A00,186160,Staff,20,0,25,5
1683314652968,LTWL 165,A00,186161,Staff,22,0,25,3
1683314654000,LTWR 100,A00,186162,Staff,0,4,15,15
1683314655025,LTWR 102,A00,186163,Doller; Ben,5,0,15,10
1683314656052,MAE 8,A01,186412,Staff,0,0,0,0
1683314657077,MAE 30B,A00,186445,Bahadori; Mohammad Yousef,83,0,100,17
1683314658102,MAE 40,A00,186592,Bewley; Thomas R,9,0,50,41
1683314659127,MAE 101B,A00,186593,Bahadori; Mohammad Yousef,81,0,100,19
1683314660151,MAE 105,A00,186594,Bandaru; Prabhakar,12,0,50,38
1683314661177,MAE 107,A00,186599,Pham; Hieu Tan,0,6,120,120
1683314662200,MAE 148,A01,186660,Silberman; Jack,3,0,16,13
1683314663228,MATH 10A,A01,188095,Staff,0,6,35,35
1683314664258,MATH 10B,A01,188097,Bowers; Adam R.,0,11,30,30
1683314664258,MATH 10B,A02,188099,Bowers; Adam R.,0,11,30,30
1683314664258,MATH 10B,B01,188104,Bowers; Adam R.,0,11,30,30
1683314664258,MATH 10B,B02,188106,Bowers; Adam R.,0,10,30,30
1683314665285,MATH 10C,A01,188111,Staff,0,18,30,30
1683314665285,MATH 10C,A02,188127,Staff,0,17,30,30
1683314665285,MATH 10C,A03,188131,Staff,0,18,30,30
1683314665285,MATH 10C,B01,188218,Staff,20,0,30,10
1683314665285,MATH 10C,B02,188244,Staff,13,0,30,17
1683314665285,MATH 10C,B03,188277,Staff,16,0,30,14
1683314666317,MATH 18,A01,188344,Bach; Quang Tran,18,0,30,12
1683314666317,MATH 18,A02,188345,Bach; Quang Tran,11,0,30,19
1683314666317,MATH 18,B01,188353,Bach; Quang Tran,10,0,30,20
1683314666317,MATH 18,B02,188354,Bach; Quang Tran,20,0,30,10
1683314667342,MATH 20A,A01,188374,Staff,13,0,35,22
1683314668371,MATH 20B,A01,188382,Ohm; Ko Woon,6,0,30,24
1683314668371,MATH 20B,A02,188383,Ohm; Ko Woon,23,0,30,7
1683314668371,MATH 20B,B01,188385,Ohm; Ko Woon,7,0,30,23
1683314668371,MATH 20B,B02,188392,Ohm; Ko Woon,22,0,30,8
1683314669397,MATH 20C,A01,188394,Harel; Guershon,10,0,30,20
1683314669397,MATH 20C,A02,188395,Harel; Guershon,14,0,30,16
1683314669397,MATH 20C,B01,188404,Harel; Guershon,5,0,30,25
1683314669397,MATH 20C,B02,188405,Harel; Guershon,19,0,30,11
1683314670422,MATH 20D,A01,188414,Hammock; Frances H,0,1,30,30
1683314670422,MATH 20D,A02,188415,Hammock; Frances H,4,0,30,26
1683314670422,MATH 20D,B01,188447,Hammock; Frances H,2,0,30,28
1683314670422,MATH 20D,B02,188486,Hammock; Frances H,8,0,30,22
1683314671450,MATH 20E,A01,188649,Staff,21,0,30,9
1683314671450,MATH 20E,A02,188650,Staff,23,0,30,7
1683314671450,MATH 20E,A03,188673,Staff,0,0,30,30
1683314672475,MATH 102,A01,188675,Staff,0,35,35,35
1683314673500,MATH 103B,A01,188681,Staff,4,0,35,31
1683314673500,MATH 103B,B01,188692,Staff,5,0,35,30
1683314674530,MATH 109,A01,188695,Salehi Golsefidy; Alireza,25,0,35,10
1683314674530,MATH 109,A02,188696,Salehi Golsefidy; Alireza,26,0,35,9
1683314675557,MATH 120A,A01,188698,Eggers; John Dietrich,7,0,35,28
1683314676584,MATH 142B,A01,188736,Ioana; Adrian,0,2,30,30
1683314676584,MATH 142B,A02,188741,Ioana; Adrian,0,1,30,30
1683314676584,MATH 142B,A03,188743,Ioana; Adrian,1,3,30,29
1683314677612,MATH 168A,A01,188790,Staff,0,9,35,35
1683314678637,MATH 170A,A01,188803,Nie; Jiawang,0,2,35,35
1683314678637,MATH 170A,A02,188811,Nie; Jiawang,0,0,35,35
1683314678637,MATH 170A,A03,188814,Nie; Jiawang,0,0,35,35
1683314678637,MATH 170A,A04,188815,Nie; Jiawang,13,0,35,22
1683314679660,MATH 193B,A01,188817,Staff,0,0,35,35
1683314679660,MATH 193B,A02,188818,Staff,6,0,35,29
1683314680688,MGT 4,A01,202857,Anderson; John Charles,62,0,80,18
1683314681715,MGT 12,A00,202858,Lindenberger; Wade Douglas,43,0,90,47
1683314682740,MGT 18,A00,202859,Staff,74,0,90,16
1683314683765,MGT 18GS,A00,202860,McKay; Michael J,13,0,28,15
1683314684789,MGT 45,A00,202861,Pecore; Joseph P.,14,0,90,76
1683314685813,MGT 100,A00,202863,Yavorsky; Daniel Ryan,28,0,90,62
1683314686838,MGT 103,A00,202864,Ehrich; Kristine R,0,16,90,90
1683314687880,MGT 112,A00,202865,Ehrich; Kristine R,15,0,90,75
1683314688905,MGT 121A,A00,202868,Staff,0,19,0,0
1683314689929,MGT 131B,A00,202869,Anderson; John Charles,59,0,90,31
1683314690959,MGT 136,A00,202871,Lindenberger; Wade Douglas,84,0,90,6
1683314691984,MGT 164,A00,202873,Staff,0,68,90,90
1683314693009,MGT 164GS,A00,202874,McKay; Mary A,13,0,28,15
1683314694037,MGT 180,A00,202875,Staff,0,50,90,90
1683314695065,MMW 11R,A01,205019,Herbst; Matthew,3,0,30,27
1683314695065,MMW 11R,A02,205026,Herbst; Matthew,29,0,30,1
1683314696089,MMW 15,A01,193512,Chang; Edmond Yi-Teh,0,9,28,28
1683314696089,MMW 15,A02,193513,Chang; Edmond Yi-Teh,0,5,28,28
1683314696089,MMW 15,A03,193514,Chang; Edmond Yi-Teh,0,5,28,28
1683314696089,MMW 15,A04,193515,Chang; Edmond Yi-Teh,0,5,28,28
1683314696089,MMW 15,A05,193516,Chang; Edmond Yi-Teh,0,4,28,28
1683314696089,MMW 15,A06,193517,Chang; Edmond Yi-Teh,0,5,28,28
1683314696089,MMW 15,B01,193519,Chang; Edmond Yi-Teh,0,4,28,28
1683314696089,MMW 15,B02,193520,Chang; Edmond Yi-Teh,0,5,28,28
1683314696089,MMW 15,B03,193521,Chang; Edmond Yi-Teh,0,4,28,28
1683314696089,MMW 15,B04,193522,Chang; Edmond Yi-Teh,0,4,28,28
1683314696089,MMW 15,B05,193523,Chang; Edmond Yi-Teh,0,5,28,28
1683314696089,MMW 15,B06,193524,Chang; Edmond Yi-Teh,0,4,28,28
1683314697117,MMW 122,A01,193526,Rahimi; Babak,0,14,28,28
1683314697117,MMW 122,A02,193527,Rahimi; Babak,0,14,28,28
1683314697117,MMW 122,A03,193528,Rahimi; Babak,0,0,0,0
1683314697117,MMW 122,A04,193529,Rahimi; Babak,0,0,0,0
1683314698143,MUS 1A,A01,186663,Staff,0,20,35,35
1683314699167,MUS 4,A01,186715,Staff,0,12,35,35
1683314700192,MUS 5R,A01,186796,Dubnov; Shlomo,0,17,35,35
1683314701322,MUS 6,A01,186798,Staff,0,3,25,25
1683314702346,MUS 7,A01,186830,Staff,12,0,35,23
1683314703370,MUS 8,A01,186930,Staff,0,26,35,35
1683314704397,MUS 15,A01,186932,Staff,0,15,35,35
1683314704397,MUS 15,B01,186934,Staff,0,15,35,35
1683314705422,MUS 80,A00,186935,Staff,2,0,20,18
1683314705422,MUS 80,B00,186936,Staff,25,0,25,0
1683314706447,NANO 11,A00,204702,Lipomi; Darren John,0,0,0,0
1683314707471,NANO 15,A01,204709,Yang; Kesong,0,1,0,0
1683314708497,NANO 114,A00,202069,Jahed Motlagh; Zeinab,3,0,10,7
1683314709522,PHIL 1,A00,186955,Grush; Rick Scott,32,0,40,8
1683314710549,PHIL 10,A01,186973,Grush; Rick Scott,28,0,35,7
1683314710549,PHIL 10,A02,186974,Grush; Rick Scott,33,0,35,2
1683314711574,PHIL 13,A01,186976,Staff,7,0,35,28
1683314711574,PHIL 13,A02,186977,Staff,16,0,35,19
1683314712601,PHIL 14,A01,186979,Staff,31,0,35,4
1683314712601,PHIL 14,A02,186986,Staff,32,0,35,3
1683314713625,PHIL 28,A01,186988,Staff,16,0,30,14
1683314713625,PHIL 28,A02,186989,Staff,1,0,30,29
1683314713625,PHIL 28,A03,186990,Staff,9,0,30,21
1683314713625,PHIL 28,A04,186991,Staff,26,0,30,4
1683314714652,PHIL 120,A00,186997,Staff,23,0,40,17
1683314715679,PHIL 137,A00,187003,Staff,9,0,40,31
1683314716761,PHIL 150,A00,187015,Staff,47,0,70,23
1683314717788,PHIL 167,A00,187021,Lamey; Andy M.,35,0,40,5
1683314718813,PHIL 174,A01,202226,Staff,17,0,20,3
1683314718813,PHIL 174,A02,202235,Staff,20,0,20,0
1683314719836,PHIL 191A,A00,258918,Staff,0,0,1,1
1683314720863,PHYS 1A,A00,187028,Staff,27,0,60,33
1683314721890,PHYS 1AL,001,187036,Staff,3,0,30,27
1683314721890,PHYS 1AL,002,187049,Staff,18,0,30,12
1683314722914,PHYS 1B,A00,187058,Staff,22,0,60,38
1683314723939,PHYS 1BL,001,187064,Staff,0,0,30,30
1683314723939,PHYS 1BL,002,187070,Staff,5,0,30,25
1683314724966,PHYS 1C,A00,187082,Staff,31,0,120,89
1683314725993,PHYS 1CL,001,187088,Staff,0,9,30,30
1683314725993,PHYS 1CL,002,187089,Staff,0,2,30,30
1683314725993,PHYS 1CL,009,262693,Staff,11,0,30,19
1683314727017,PHYS 2B,A01,187097,Staff,54,0,115,61
1683314728045,PHYS 2C,A01,187099,Staff,67,0,115,48
1683314729069,PHYS 2CL,A01,187101,Staff,5,0,28,23
1683314729069,PHYS 2CL,A02,187102,Staff,15,0,28,13
1683314730094,PHYS 2D,A01,187123,Shotwell; Brian,95,0,115,20
1683314731119,PHYS 4B,A01,187133,Grinstein; Benjamin,35,0,50,15
1683314732143,POLI 10,A00,188819,Staff,0,4,50,50
1683314733170,POLI 11,A00,188827,Staff,43,0,50,7
1683314734194,POLI 13R,A00,188828,Staff,0,1,20,20
1683314735221,POLI 27,A01,188830,Elgin; Samuel Zincke,0,1,70,70
1683314736244,POLI 30,A00,188832,Desposato; Scott,32,0,50,18
1683314737271,POLI 102F,A00,188834,Staff,3,0,40,37
1683314738295,POLI 104A,A00,188852,Staff,14,0,30,16
1683314739318,POLI 104I,A00,188853,Staff,0,6,20,20
1683314740342,POLI 110B,A00,188854,Wiens; David,7,0,20,13
1683314741369,POLI 112A,A00,188855,Wiens; David,5,0,30,25
1683314742397,POLI 117R,A00,188856,Forman; Fonna,0,11,20,20
1683314743423,POLI 118,A00,188857,Ingham; Sean,8,0,20,12
1683314744451,POLI 120G,A00,188858,Staff,9,0,30,21
1683314745477,POLI 131CR,A00,188863,Hoston; Germaine,24,0,50,26
1683314746503,POLI 133,A00,188864,Nellis; Gareth Hb,44,0,50,6
1683314747529,POLI 134D,A00,188865,Desposato; Scott,27,0,30,3
1683314748553,POLI 142A,A00,188871,Gartzke; Erik,22,0,50,28
1683314749577,POLI 142K,A00,188874,Staff,38,0,50,12
1683314750606,POLI 143,A00,188940,Gartzke; Erik,16,0,30,14
1683314751629,POLI 153,A00,188943,Staff,3,0,20,17
1683314752654,POLI 160AA,A00,188944,Staff,12,0,40,28
1683314753682,POLI 170A,A00,188945,Staff,11,0,30,19
1683314755737,PSYC 1,A00,188952,Staff,37,0,90,53
1683314756761,PSYC 2,B00,188953,Staff,19,0,35,16
1683314757787,PSYC 6,A00,188970,Staff,47,0,60,13
1683314758816,PSYC 7,A00,188973,Staff,37,0,45,8
1683314759841,PSYC 60,A01,188980,Rickard; Timothy C.,43,0,60,17
1683314760864,PSYC 70,A01,189001,Steiner; Eric Tomas,24,0,45,21
1683314761892,PSYC 100,A00,189005,Lacefield; Katharine I,0,99,120,120
1683314762919,PSYC 102,A00,189008,Staff,10,0,30,20
1683314763943,PSYC 106,B00,189026,Gorman; Michael R.,36,0,60,24
1683314764967,PSYC 114,B01,189033,Winkielman; Piotr,0,32,30,30
1683314765995,PSYC 131,A00,189036,Anagnostaras; Stephan,0,43,60,60
1683314767023,PSYC 136,A00,189041,Lowe; Angela Beth,0,7,25,25
1683314768051,PSYC 137,A00,189057,Winkielman; Piotr,0,34,25,25
1683314769075,PSYC 144,A00,189107,Wixted; John T,0,7,50,50
1683314771126,PSYC 162,A00,189142,Staff,0,8,85,85
1683314772151,PSYC 172,A00,189144,Gorman; Michael R.,0,7,30,30
1683314774201,PSYC 179,A00,189146,Lacefield; Katharine I,0,84,120,120
1683314775226,PSYC 181,A00,189147,Anagnostaras; Stephan,0,44,90,90
1683314776250,PSYC 190R,A00,189148,Barner; David A.,0,22,80,80
1683314777278,PSYC 191,A00,189275,Rickard; Timothy C.,0,7,25,25
1683314778306,PSYC 193,A00,189276,Chapman; Eddie Nathaniel,0,1,0,4
1683314779334,PSYC 193L,A01,189281,Lowe; Angela Beth,12,0,20,8
1683314779334,PSYC 193L,B01,189285,Staff,28,0,35,7
1683314780362,RELI 149,A00,187137,Rahimi; Babak,7,0,40,33
1683314781385,SE 9,A01,187315,Staff,0,2,18,18
1683314782412,SE 101B,A00,187409,Staff,24,0,30,6
1683314783439,SE 110B,A00,187444,Staff,10,0,40,30
1683314784463,SE 130B,A00,187449,Staff,31,0,40,9
1683314785488,SE 150A,A00,187516,Staff,9,0,20,11
1683314786513,SE 154,A00,187528,Staff,30,0,50,20
1683314787537,SIO 3,A01,258171,Staff,35,0,40,5
1683314788561,SIO 10,A00,187144,Cook; Geoffrey W,0,3,75,75
1683314789590,SIO 45,A00,187152,Cook; Geoffrey W,1,0,100,99
1683314790614,SIO 109R,A00,194486,Staff,0,3,20,20
1683314792670,SIO 187,A01,187233,Kacev; David,12,0,40,28
1683314793698,SOCI 1,A01,258656,Thorpe; Charles Robert,28,0,30,2
1683314793698,SOCI 1,A02,258658,Thorpe; Charles Robert,30,0,30,0
1683314793698,SOCI 1,A03,258661,Thorpe; Charles Robert,25,0,25,0
1683314793698,SOCI 1,A04,258666,Thorpe; Charles Robert,22,0,25,3
1683314793698,SOCI 1,A05,258897,Thorpe; Charles Robert,23,0,25,2
1683314793698,SOCI 1,A06,258898,Thorpe; Charles Robert,25,0,25,0
1683314794726,SOCI 30,A01,258903,Pardo Guerra; Juan Pablo,16,0,30,14
1683314795754,SOCI 102,A00,258904,Staff,9,0,25,16
1683314796782,SOCI 106,A00,258905,Staff,19,0,25,6
1683314797808,SOCI 111,A00,258907,Ribas Norris; Janet Vanesa,26,0,30,4
1683314798836,SOCI 121R,A00,258908,Pardo Guerra; Juan Pablo,11,0,30,19
1683314799859,SOCI 126,A01,203330,Staff,14,0,20,6
1683314800887,SOCI 131,A00,258909,Thorpe; Charles Robert,31,0,60,29
1683314801911,SOCI 135,A00,258910,Payne; Christine Anna,0,9,30,30
1683314802935,SOCI 157,A00,258911,Staff,12,0,30,18
1683314803959,SOCI 184,A00,258912,Staff,25,0,30,5
1683314804986,SOCI 188D,A00,258913,Staff,21,0,30,9
1683314806015,SYN 2,001,187529,Staff,9,0,16,7
1683314806015,SYN 2,002,201452,Staff,0,18,16,16
1683314806015,SYN 2,003,201469,Staff,4,0,16,12
1683314807040,SYN 100,A01,187531,Staff,0,9,20,20
1683314807040,SYN 100,B01,201491,Staff,0,12,20,20
1683314808068,TDAC 1,A00,189286,Walsh; Kim C.,3,0,20,17
1683314808068,TDAC 1,B00,189287,Harting; Carla Kelso,11,0,20,9
1683314809091,TDAC 101,A00,189300,Walsh; Kim C.,16,0,20,4
1683314809091,TDAC 101,B00,189301,Harting; Carla Kelso,18,0,20,2
1683314810116,TDAC 102,A00,189304,Basso; Beatrice,14,0,20,6
1683314811140,TDAC 108,A00,189305,Staff,18,0,20,2
1683314812169,TDDE 131,A00,189310,Staff,19,0,20,1
1683314812169,TDDE 131,B00,189314,Staff,19,0,20,1
1683314812169,TDDE 131,C00,189315,Staff,48,0,50,2
1683314812169,TDDE 131,D00,189316,Staff,14,0,15,1
1683314812169,TDDE 131,E00,204841,Staff,20,0,20,0
1683314813193,TDGE 10,A00,189289,Staff,30,0,50,20
1683314813193,TDGE 10,B00,189290,Havis; Allan,2,0,50,48
1683314814218,TDGE 11,A00,189291,Fulton; Julia,0,3,50,50
1683314814218,TDGE 11,B00,189292,Staff,20,0,25,5
1683314814218,TDGE 11,C00,260270,Staff,0,0,0,0
1683314815246,TDGE 25,A00,189294,Staff,3,0,20,17
1683314816274,TDGE 124,A00,189318,Fulton; Julia,0,8,50,50
1683314817303,TDGE 125,A00,189319,Staff,13,0,25,12
1683314817303,TDGE 125,B00,189320,Staff,23,0,25,2
1683314818330,TDGE 127,A00,189322,Havis; Allan,0,0,50,50
1683314819357,TDHT 101,A00,189323,Staff,18,0,25,7
1683314819357,TDHT 101,B00,189324,Staff,25,0,25,0
1683314820438,TDHT 102,A00,189325,Staff,49,0,50,1
1683314821462,TDMV 1,A00,189295,Arcidiacono; Kristin,20,0,30,10
1683314821462,TDMV 1,B00,189296,Caligagan; Maria T.,24,0,30,6
1683314822487,TDMV 2,A00,189297,Sammartano; Tonnie,28,0,30,2
1683314822487,TDMV 2,B00,189299,Arcidiacono; Kristin,24,0,30,6
1683314823512,TDMV 3,A00,204998,Rincon; Alicia,22,0,30,8
1683314824536,TDMV 120,A00,189458,Sammartano; Tonnie,28,0,30,2
1683314825559,TDMV 138,A00,189541,Jun; Grace Shin Hae,22,0,40,18
1683314826582,TDMV 142,A00,189717,Caligagan; Tony,23,0,30,7
1683314826582,TDMV 142,B00,189718,Caligagan; Maria T.,25,0,30,5
1683314827606,TMC 2,A01,187533,Staff,25,0,25,0
1683314827606,TMC 2,A02,187534,Staff,25,0,25,0
1683314828631,USP 1,A01,187536,Kwak; Nancy,0,16,25,25
1683314829658,USP 5,A01,187538,Staff,9,0,25,16
1683314830682,USP 101,A00,199253,Staff,0,4,0,0
1683314831709,USP 124,A00,187562,Boomhower; Matthew Charles,1,0,30,29
1683314832736,USP 138,A00,187582,Staff,20,0,25,5
1683314833759,USP 152,A01,187597,Staff,4,0,25,21
1683314834789,USP 153,A00,187598,Staff,19,0,25,6
1683314835813,USP 168,A00,187607,Kwak; Nancy,2,0,5,3
1683314836840,USP 173,A00,187619,Staff,4,0,25,21
1683314837864,USP 181,A00,187638,Staff,0,0,25,25
1683314838891,VIS 103,A00,187650,Cruz; Edwin Teddy,23,0,75,52
1683314839919,VIS 110D,A00,187669,Staff,12,0,22,10
1683314840945,VIS 127C,A00,187720,Shen; Kuiyi,68,0,146,78
1683314841973,VIS 149,A00,187731,Yoldas; Pinar,0,14,22,22
1683314842999,VIS 151,A01,188091,Staff,22,0,34,12
1683314842999,VIS 151,A02,188092,Staff,11,0,34,23
1683314844026,VIS 160B,A00,188093,Stalbaum; Brett,0,0,10,10
1683314846073,WCWP 10B,A00,201720,Staff,10,0,15,5
1683314846073,WCWP 10B,B00,201722,Staff,8,0,15,7
1683314847100,WCWP 100,A00,201725,Gagnon; Jeffrey C,0,0,2,2
1683314847100,WCWP 100,B00,201727,Staff,0,4,15,15
1683314850235,ANBI 133,A00,258401,Wilder; Linnea Lorene,34,0,40,6
1683314851262,ANBI 140,A00,258395,Hrvoj Mihic; Branka,18,0,25,7
1683314852287,ANSC 120,A00,258402,Bialecki; Jon Anthony,27,0,40,13
1683314853316,ANSC 144,A00,258400,Staff,14,0,40,26
1683314855364,ANSC 166,A00,258396,Parish; Steven Martin,157,0,175,18
1683314856391,ANSC 180,A00,193533,Staff,9,0,20,11
1683314857414,ANSC 188,A00,258397,Jassal; Aftab,33,0,40,7
1683314858438,ANTH 3,A01,258316,Staff,23,0,30,7
1683314859462,ANTH 5,A00,258394,Semendeferi; Ekaterini,16,0,20,4
1683314860490,ANTH 21,A01,258331,Staff,9,0,40,31
1683314861521,ANTH 103,A00,258398,Varma; Saiba,15,0,25,10
1683314862548,AWP 10,001,202034,Staff,0,0,0,0
1683314862548,AWP 10,002,202035,Staff,0,0,0,0
1683314862548,AWP 10,003,202036,Staff,0,0,0,0
1683314862548,AWP 10,004,202037,Staff,0,0,0,0
1683314862548,AWP 10,005,202038,Staff,0,0,0,0
1683314862548,AWP 10,006,202039,Staff,0,0,0,0
1683314862548,AWP 10,007,202040,Staff,0,0,0,0
1683314862548,AWP 10,008,202041,Staff,0,0,0,0
1683314862548,AWP 10,009,202042,Staff,0,0,0,0
1683314862548,AWP 10,010,202043,Staff,0,0,0,0
1683314862548,AWP 10,011,202044,Staff,0,0,0,0
1683314862548,AWP 10,012,202045,Staff,0,0,0,0
1683314862548,AWP 10,013,202046,Staff,0,0,0,0
1683314862548,AWP 10,014,202047,Staff,0,0,0,0
1683314862548,AWP 10,015,202048,Staff,0,0,0,0
1683314862548,AWP 10,016,202049,Staff,0,0,0,0
1683314862548,AWP 10,017,202050,Staff,0,0,0,0
1683314862548,AWP 10,018,202051,Staff,0,0,0,0
1683314862548,AWP 10,019,202052,Staff,0,0,0,0
1683314862548,AWP 10,020,202053,Staff,0,0,0,0
1683314862548,AWP 10,021,202054,Staff,0,0,0,0
1683314862548,AWP 10,022,202055,Staff,0,0,0,0
1683314862548,AWP 10,023,202056,Staff,0,0,0,0
1683314862548,AWP 10,024,202057,Staff,0,0,0,0
1683314862548,AWP 10,025,202058,Staff,0,0,0,0
1683314862548,AWP 10,026,202059,Staff,0,0,0,0
1683314863580,AWP 102,001,202032,Staff,0,0,0,0
1683314863580,AWP 102,002,202033,Staff,0,0,0,0
1683314864604,BENG 100,A01,254234,Taylor Amos; Alyssa C,31,0,40,9
1683314865628,BENG 196,001,270013,Engler; Adam J.,9999,0,9999,0
1683314866653,BICD 100R,A01,202018,Smith; Laurie,0,7,32,32
1683314866653,BICD 100R,A02,202019,Smith; Laurie,0,2,32,32
1683314866653,BICD 100R,A03,202020,Smith; Laurie,0,1,32,32
1683314866653,BICD 100R,A04,202021,Smith; Laurie,8,0,32,24
1683314866653,BICD 100R,A05,202022,Smith; Laurie,12,0,32,20
1683314867681,BICD 136,A01,193242,Gustafson-Brown; Cindy,0,2,32,32
1683314867681,BICD 136,A02,193244,Gustafson-Brown; Cindy,15,0,32,17
1683314868711,BIEB 102,A01,193249,Butler; Shannon Rhey,0,2,32,32
1683314868711,BIEB 102,A02,193251,Butler; Shannon Rhey,0,0,32,32
1683314868711,BIEB 102,A03,193253,Butler; Shannon Rhey,0,1,32,32
1683314868711,BIEB 102,A04,193255,Butler; Shannon Rhey,17,0,32,15
1683314868711,BIEB 102,A05,193265,Butler; Shannon Rhey,26,0,32,6
1683314868711,BIEB 102,A06,193269,Butler; Shannon Rhey,16,0,32,16
1683314870761,BIEB 150,A01,193274,Staff,0,0,32,32
1683314870761,BIEB 150,A02,193285,Staff,24,0,32,8
1683314871786,BIEB 194,A00,193286,Kurle; Carolyn M.,22,0,32,10
1683314872816,BILD 1,A01,192291,Staff,16,0,32,16
1683314872816,BILD 1,A02,192292,Staff,30,0,32,2
1683314872816,BILD 1,B01,192520,Reuther; Keefe,0,1,0,0
1683314872816,BILD 1,B02,192532,Reuther; Keefe,0,1,0,0
1683314873842,BILD 3,A01,192556,Butler; Shannon Rhey,0,0,32,32
1683314873842,BILD 3,A02,192581,Butler; Shannon Rhey,5,0,32,27
1683314873842,BILD 3,A03,192611,Butler; Shannon Rhey,23,0,32,9
1683314873842,BILD 3,A04,192612,Butler; Shannon Rhey,25,0,32,7
1683314873842,BILD 3,A05,192613,Butler; Shannon Rhey,27,0,32,5
1683314873842,BILD 3,A06,192679,Butler; Shannon Rhey,27,0,32,5
1683314873842,BILD 3,A07,192682,Butler; Shannon Rhey,22,0,32,10
1683314874872,BILD 4,A01,192836,Reuther; Keefe,1,0,24,23
1683314874872,BILD 4,A02,193044,Reuther; Keefe,4,0,24,20
1683314875901,BILD 10,A01,193142,Gustafson-Brown; Cindy,31,0,32,1
1683314875901,BILD 10,A02,193149,Gustafson-Brown; Cindy,31,0,32,1
1683314876932,BIMM 100,A01,193301,Staff,0,6,32,32
1683314876932,BIMM 100,A02,193312,Staff,0,5,32,32
1683314876932,BIMM 100,A03,193323,Staff,0,8,32,32
1683314877957,BIMM 101,A01,193329,McDonnell; Lisa Marie,0,3,24,24
1683314877957,BIMM 101,A02,193339,McDonnell; Lisa Marie,0,2,24,24
1683314877957,BIMM 101,B01,193354,McDonnell; Lisa Marie,0,3,24,24
1683314877957,BIMM 101,B02,193357,McDonnell; Lisa Marie,0,3,24,24
1683314878983,BIMM 110,A01,193377,Tat; John,0,11,32,32
1683314878983,BIMM 110,A02,193378,Tat; John,1,9,32,31
1683314880009,BIMM 120,A01,206116,Staff,0,0,32,32
1683314880009,BIMM 120,A02,206117,Staff,8,0,32,24
1683314880009,BIMM 120,A03,206121,Staff,21,0,32,11
1683314881032,BIPN 100,A01,193393,Park; Ji Young,0,14,32,32
1683314881032,BIPN 100,A02,193402,Park; Ji Young,0,12,32,32
1683314881032,BIPN 100,A03,193413,Park; Ji Young,0,14,32,32
1683314881032,BIPN 100,A04,193414,Park; Ji Young,0,13,32,32
1683314882061,BIPN 102,A01,193429,Staff,0,0,32,32
1683314882061,BIPN 102,A02,193438,Staff,22,0,32,10
1683314883089,BIPN 106,A01,193450,Reyes Gonzalez; Catalina,0,2,40,40
1683314884117,BIPN 134,A01,193465,Cooke; James Edward,0,0,32,32
1683314884117,BIPN 134,A02,193474,Cooke; James Edward,27,0,32,5
1683314884117,BIPN 134,A03,193485,Cooke; James Edward,29,0,32,3
1683314884117,BIPN 134,A04,193486,Cooke; James Edward,21,0,32,11
1683314884117,BIPN 134,A05,193491,Cooke; James Edward,31,0,32,1
1683314884117,BIPN 134,A06,193501,Cooke; James Edward,30,0,32,2
1683314884117,BIPN 134,A07,193510,Cooke; James Edward,29,0,32,3
1683314886169,BISP 194,A00,222522,Staff,16,0,32,16
1683314887198,CAT 124,A01,202407,Staff,20,0,25,5
1683314888222,CAT 125,A00,202408,Marchisotto; Jennifer Anne,4,0,20,16
1683314889247,CAT 125R,A00,202409,Smith; Lauryn Alissa,0,11,20,20
1683314889247,CAT 125R,B00,202410,Morales; Celeste Georgianna,0,11,20,20
1683314889247,CAT 125R,C00,202411,Irwin; Matthew Joseph,0,10,20,20
1683314890275,CENG 15,A01,204712,Yang; Kesong,0,1,0,0
1683314891303,CENG 114,A00,202070,Jahed Motlagh; Zeinab,5,0,20,15
1683314892331,CGS 105,A00,185477,Wesling; Megan E.,24,0,40,16
1683314893357,CGS 106,A00,185494,Staff,13,0,22,9
1683314894382,CGS 108,A00,185495,Staff,14,0,20,6
1683314895410,CGS 114,A00,185496,Staff,13,0,18,5
1683314896436,CGS 119,A00,185501,Staff,15,0,20,5
1683314897460,CGS 120,A00,185511,Staff,13,0,20,7
1683314898489,CHEM 4,A01,184675,Bussey; Thomas J,96,0,100,4
1683314899516,CHEM 6A,A01,184677,Staff,35,0,60,25
1683314900542,CHEM 6B,A01,184679,Staff,65,0,100,35
1683314901571,CHEM 6C,A01,184681,Bussey; Thomas J,1,0,50,49
1683314901571,CHEM 6C,A02,184682,Bussey; Thomas J,34,0,50,16
1683314902597,CHEM 40A,A01,184684,Albizati; Kim F.,37,0,100,63
1683314903625,CHEM 40B,A01,184686,Albizati; Kim F.,0,20,100,100
1683314904649,CHEM 41B,A01,184690,Staff,52,0,100,48
1683314905674,COGS 3,A01,184715,Boyle; Mary E. T.,0,25,40,40
1683314906699,COGS 14B,A01,185172,Staff,0,15,38,38
1683314907724,COGS 18,A01,184736,Staff,19,0,80,61
1683314908750,COGS 100,A01,184932,Staff,0,5,73,73
1683314909781,COGS 101A,A01,184935,Staff,0,38,30,30
1683314910805,COGS 101B,A01,184944,Staff,0,2,30,30
1683314911830,COGS 101C,A01,184946,Staff,0,12,30,30
1683314912854,COGS 102A,A01,184951,Johnson; Christine M.,2,0,40,38
1683314913877,COGS 107B,A01,184953,Mooshagian; Eric Frederick,0,50,40,40
1683314914906,COGS 118B,A01,184959,Gupta; Anjum,0,48,40,40
1683314915933,COGS 153,A00,184961,Staff,0,15,30,30
1683314916962,COGS 177,A00,184962,Staff,0,21,30,30
1683314917992,COGS 187A,A01,184969,Boyle; Mary E. T.,0,17,40,40
1683314919017,COMM 10,A01,185174,Staff,0,5,25,25
1683314919017,COMM 10,A02,185189,Staff,0,5,25,25
1683314919017,COMM 10,A03,269821,Staff,0,0,0,0
1683314920046,COMM 100B,A01,185475,Staff,0,0,0,2
1683314920046,COMM 100B,A02,185476,Staff,14,0,25,11
1683314921072,COMM 100C,A01,185314,Staff,1,0,25,24
1683314921072,COMM 100C,A02,185327,Staff,19,0,25,6
1683314922096,COMM 110M,A00,185349,Staff,2,0,40,38
1683314923118,COMM 113T,A00,185352,Staff,25,0,40,15
1683314924196,COMM 114I,A00,185353,Staff,33,0,40,7
1683314925223,COMM 131,A00,185354,Staff,19,0,30,11
1683314926251,CSE 8A,A50,185358,Cao; Yingjun,0,46,10,10
1683314927278,CSE 8B,A01,185362,Staff,1,47,50,49
1683314928303,CSE 11,A01,185416,Cao; Yingjun,0,92,10,10
1683314929327,CSE 20,A01,185445,Briones; Jor-el Thomas Caparas,5,0,25,20
1683314930355,CSE 21,A01,185447,Staff,10,0,50,40
1683314931379,CSE 101,A01,185451,Staff,0,12,50,50
1683314931379,CSE 101,B01,185453,Jones; Miles E,0,11,50,50
1683314933427,CSE 141,A01,185458,Eldon; John,20,0,100,80
1683314934454,CSE 141L,A01,185461,Eldon; John,12,0,100,88
1683314935483,CSE 142,A01,185463,Staff,36,0,60,24
1683314935483,CSE 142,B01,201355,Staff,0,7,60,60
1683314936507,CSE 142L,A01,185470,Staff,36,0,60,24
1683314936507,CSE 142L,B01,201417,Staff,0,6,60,60
1683314937536,CSE 190,A00,201433,Staff,32,0,49,17
1683314938561,DOC 1,A01,259136,Strom; Megan C.,7,0,15,8
1683314938561,DOC 1,A02,259137,Strom; Megan C.,14,0,15,1
1683314938561,DOC 1,A03,259138,Strom; Megan C.,14,0,15,1
1683314938561,DOC 1,A04,259139,Strom; Megan C.,14,0,15,1
1683314939585,DOC 100D,A00,259140,Pass; Natalye Joann,17,0,25,8
1683314940617,DSGN 1,A01,184749,Rill; Bryan,0,25,30,30
1683314941647,DSGN 100,A01,185168,Staff,0,2,25,25
1683314942678,ECE 5,A01,185626,Morris; Karcher William,0,10,0,0
1683314943701,ECE 101,A01,185628,Staff,17,0,70,53
1683314944726,ECE 107,A01,185635,Baghdadchi; Saharnaz,0,0,20,20
1683314944726,ECE 107,A02,185638,Baghdadchi; Saharnaz,4,0,20,16
1683314945750,ECE 148,A01,185647,Silberman; Jack,0,0,16,16
1683314946777,ECON 1,A01,185537,Crane; Meredith Helen,54,0,70,16
1683314947801,ECON 3,A01,185549,Crane; Meredith Helen,33,0,70,37
1683314948826,ECON 4,A01,203354,Anderson; John Charles,0,4,10,10
1683314949853,ECON 100A,A01,185574,Staff,0,4,40,40
1683314950878,ECON 100B,A01,185576,Staff,0,22,40,40
1683314951903,ECON 100C,A01,185589,Newhouse; Herbert S,30,0,70,40
1683314952930,ECON 105,A00,185608,Vespa; Emanuel Ignacio,19,0,35,16
1683314953958,ECON 109,A01,185610,Shishkin; Denis,10,0,35,25
1683314954984,ECON 110A,A01,185612,Staff,11,0,40,29
1683314956008,ECON 120A,A01,185615,Staff,20,0,40,20
1683314957036,ECON 120C,A01,185617,Sun; Yixiao,0,20,70,70
1683314958064,ECON 144,A00,203346,Squires; Dale E,3,0,35,32
1683314959090,ECON 171,A01,203349,Newhouse; Herbert S,0,1,35,35
1683314960120,ECON 173A,A01,185621,Toda; Alexis Akira,21,0,35,14
1683314961148,EDS 25,A01,202413,Staff,0,1,0,0
1683314961148,EDS 25,A02,202414,Staff,0,1,0,0
1683314961148,EDS 25,A03,202415,Staff,0,0,0,0
1683314961148,EDS 25,A04,202416,Staff,0,1,0,0
1683314961148,EDS 25,A05,202439,Staff,0,0,0,0
1683314961148,EDS 25,A06,202440,Staff,0,0,0,0
1683314961148,EDS 25,B01,202631,Staff,0,0,0,0
1683314961148,EDS 25,B02,202632,Staff,0,0,0,0
1683314961148,EDS 25,B03,202639,Staff,0,0,0,0
1683314961148,EDS 25,B04,202640,Staff,0,0,0,0
1683314961148,EDS 25,B05,202643,Staff,0,0,0,0
1683314961148,EDS 25,B06,202644,Staff,0,0,0,0
1683314962171,EDS 38,A01,202659,Black; Alison Michelle,24,0,25,1
1683314963199,EDS 115,A00,202652,Staff,17,0,30,13
1683314964223,EDS 125,A00,202649,Staff,14,0,30,16
1683314965248,EDS 126,A01,203332,Staff,30,0,30,0
1683314966271,EDS 139,A00,202838,Staff,16,0,25,9
1683314967299,EDS 146,A01,202655,Staff,14,0,25,11
1683314968323,ENG 15,A00,185667,Staff,0,1,0,0
1683314968323,ENG 15,B00,185672,Staff,0,0,0,0
1683314968323,ENG 15,C00,185675,Staff,0,0,0,0
1683314968323,ENG 15,D00,185682,Staff,0,0,0,0
1683314968323,ENG 15,E00,185684,Staff,0,0,0,0
1683314969350,ETHN 103,A00,185710,Staff,0,3,35,35
1683314970377,ETHN 103A,A00,199228,Man; Simeon S,2,0,9,7
1683314971405,ETHN 109,A00,185711,Staff,18,0,35,17
1683314972429,ETHN 142,A00,185726,Staff,0,4,30,30
1683314973454,ETHN 163J,A00,199229,Man; Simeon S,5,0,8,3
1683314974481,ETHN 168,A00,185727,Staff,8,0,10,2
1683314975507,ETHN 182,A00,185728,Staff,1,0,35,34
1683314976535,ETHN 183,A00,185737,Staff,8,0,18,10
1683314977558,GLBH 111,A01,209361,Burgos; Jose L.,0,0,0,0
1683314979606,HIEU 104,A00,185792,Staff,16,0,20,4
1683314980629,HIEU 115,A00,185800,Staff,1,0,20,19
1683314981657,HIEU 128,A00,185801,Staff,0,7,20,20
1683314982683,HIEU 147,A00,185802,Staff,16,0,20,4
1683314983710,HIEU 154,A00,185823,Staff,12,0,20,8
1683314984737,HILA 102,A00,185826,Staff,13,0,20,7
1683314985765,HILD 2C,A01,185778,Staff,0,12,20,20
1683314986789,HILD 7B,A01,185780,Kwak; Nancy,0,15,32,32
1683314986789,HILD 7B,A02,185781,Kwak; Nancy,0,18,32,32
1683314987815,HILD 30,A01,185791,Staff,14,0,20,6
1683314988839,HISC 119,A00,185830,Golan; Tal,0,9,20,20
1683314989865,HITO 156GS,A00,185831,Patterson; Patrick H.,0,0,0,23
1683314990892,HIUS 103,A00,185832,Man; Simeon S,0,6,20,20
1683314991919,HIUS 117,A00,185836,Kwak; Nancy,2,0,20,18
1683314992942,HIUS 125,A00,185840,Man; Simeon S,0,0,23,23
1683314993969,HIUS 149,A00,185845,Staff,0,0,20,20
1683314994993,HUM 3,A01,185882,Zavodny; Tatiana Sophia,0,6,50,50
1683314994993,HUM 3,B01,185899,Caldwell; Michael Alan,0,19,50,50
1683314996016,HUM 3GS,A00,185900,Patterson; Patrick H.,0,0,0,23
1683314997043,HUM 4,A01,185938,Zroka; Amy Liane,31,0,50,19
1683314997043,HUM 4,B01,185956,Watkins; Eric,0,2,50,50
1683314997043,HUM 4,B02,202209,Watkins; Eric,0,2,50,50
1683314997043,HUM 4,B03,202210,Watkins; Eric,0,0,50,50
1683314998066,HUM 5,A01,185958,West; Geoffrey Scott,4,0,50,46
1683314998066,HUM 5,A02,202215,West; Geoffrey Scott,0,0,50,50
1683314999093,INTL 190,A00,185959,Gagnon; Jeffrey C,0,0,0,9
1683314999093,INTL 190,B00,185960,Lettieri; Michael Joseph,0,0,0,1
1683315000117,JAPN 180,A00,254509,Staff,5,1,30,25
1683315001140,LATI 10,A01,202853,Kennemore; Amy Michelle,5,0,35,30
1683315001140,LATI 10,A02,202854,Kennemore; Amy Michelle,1,0,35,34
1683315001140,LATI 10,A03,270054,Kennemore; Amy Michelle,30,0,30,0
1683315002163,LATI 180,A00,202855,Kennemore; Amy Michelle,11,0,20,9
1683315003188,LAWS 101,A00,201767,Golan; Tal,0,7,40,40
1683315004210,LIFR 1C,A00,185961,Staff,6,0,20,14
1683315005234,LIFR 1CX,A00,185962,Staff,7,0,20,13
1683315006256,LIFR 1D,A00,185963,Staff,9,0,20,11
1683315007278,LIFR 1DX,A00,185964,Staff,9,0,20,11
1683315008302,LIGN 101,A01,186039,Staff,43,0,50,7
1683315009325,LIGN 165,A00,186040,Staff,18,0,50,32
1683315010348,LTCS 108,A00,186041,Staff,6,0,10,4
1683315011375,LTCS 119,A00,186042,Staff,16,0,20,4
1683315012399,LTCS 130,A00,186043,Wesling; Megan E.,15,0,25,10
1683315014449,LTEA 138,A00,186119,Staff,14,0,40,26
1683315015475,LTEN 124,A00,186148,Staff,6,0,25,19
1683315016501,LTEN 178,A00,186149,Staff,7,0,15,8
1683315017525,LTEN 181,A00,186150,Blanco; John D,33,0,40,7
1683315018548,LTWL 120,A00,186160,Staff,20,0,25,5
1683315019575,LTWL 165,A00,186161,Staff,22,0,25,3
1683315020599,LTWR 100,A00,186162,Staff,0,4,15,15
1683315021625,LTWR 102,A00,186163,Doller; Ben,5,0,15,10
1683315022650,MAE 8,A01,186412,Staff,0,0,0,0
1683315023674,MAE 30B,A00,186445,Bahadori; Mohammad Yousef,83,0,100,17
1683315024703,MAE 40,A00,186592,Bewley; Thomas R,9,0,50,41
1683315025727,MAE 101B,A00,186593,Bahadori; Mohammad Yousef,81,0,100,19
1683315026751,MAE 105,A00,186594,Bandaru; Prabhakar,12,0,50,38
1683315027849,MAE 107,A00,186599,Pham; Hieu Tan,0,6,120,120
1683315028875,MAE 148,A01,186660,Silberman; Jack,3,0,16,13
1683315029902,MATH 10A,A01,188095,Staff,0,6,35,35
1683315030928,MATH 10B,A01,188097,Bowers; Adam R.,0,11,30,30
1683315030928,MATH 10B,A02,188099,Bowers; Adam R.,0,11,30,30
1683315030928,MATH 10B,B01,188104,Bowers; Adam R.,0,11,30,30
1683315030928,MATH 10B,B02,188106,Bowers; Adam R.,0,10,30,30
1683315031954,MATH 10C,A01,188111,Staff,0,18,30,30
1683315031954,MATH 10C,A02,188127,Staff,0,17,30,30
1683315031954,MATH 10C,A03,188131,Staff,0,18,30,30
1683315031954,MATH 10C,B01,188218,Staff,20,0,30,10
1683315031954,MATH 10C,B02,188244,Staff,13,0,30,17
1683315031954,MATH 10C,B03,188277,Staff,16,0,30,14
1683315032979,MATH 18,A01,188344,Bach; Quang Tran,18,0,30,12
1683315032979,MATH 18,A02,188345,Bach; Quang Tran,11,0,30,19
1683315032979,MATH 18,B01,188353,Bach; Quang Tran,10,0,30,20
1683315032979,MATH 18,B02,188354,Bach; Quang Tran,20,0,30,10
1683315034003,MATH 20A,A01,188374,Staff,13,0,35,22
1683315035032,MATH 20B,A01,188382,Ohm; Ko Woon,6,0,30,24
1683315035032,MATH 20B,A02,188383,Ohm; Ko Woon,23,0,30,7
1683315035032,MATH 20B,B01,188385,Ohm; Ko Woon,7,0,30,23
1683315035032,MATH 20B,B02,188392,Ohm; Ko Woon,22,0,30,8
1683315036059,MATH 20C,A01,188394,Harel; Guershon,10,0,30,20
1683315036059,MATH 20C,A02,188395,Harel; Guershon,14,0,30,16
1683315036059,MATH 20C,B01,188404,Harel; Guershon,5,0,30,25
1683315036059,MATH 20C,B02,188405,Harel; Guershon,19,0,30,11
1683315037088,MATH 20D,A01,188414,Hammock; Frances H,0,1,30,30
1683315037088,MATH 20D,A02,188415,Hammock; Frances H,3,0,30,27
1683315037088,MATH 20D,B01,188447,Hammock; Frances H,2,0,30,28
1683315037088,MATH 20D,B02,188486,Hammock; Frances H,8,0,30,22
1683315038116,MATH 20E,A01,188649,Staff,21,0,30,9
1683315038116,MATH 20E,A02,188650,Staff,23,0,30,7
1683315038116,MATH 20E,A03,188673,Staff,0,0,30,30
1683315039140,MATH 102,A01,188675,Staff,0,35,35,35
1683315040167,MATH 103B,A01,188681,Staff,4,0,35,31
1683315040167,MATH 103B,B01,188692,Staff,5,0,35,30
1683315041194,MATH 109,A01,188695,Salehi Golsefidy; Alireza,25,0,35,10
1683315041194,MATH 109,A02,188696,Salehi Golsefidy; Alireza,26,0,35,9
1683315042217,MATH 120A,A01,188698,Eggers; John Dietrich,7,0,35,28
1683315043241,MATH 142B,A01,188736,Ioana; Adrian,0,2,30,30
1683315043241,MATH 142B,A02,188741,Ioana; Adrian,0,1,30,30
1683315043241,MATH 142B,A03,188743,Ioana; Adrian,1,3,30,29
1683315044268,MATH 168A,A01,188790,Staff,0,9,35,35
1683315045295,MATH 170A,A01,188803,Nie; Jiawang,0,2,35,35
1683315045295,MATH 170A,A02,188811,Nie; Jiawang,0,0,35,35
1683315045295,MATH 170A,A03,188814,Nie; Jiawang,0,0,35,35
1683315045295,MATH 170A,A04,188815,Nie; Jiawang,13,0,35,22
1683315046320,MATH 193B,A01,188817,Staff,0,0,35,35
1683315046320,MATH 193B,A02,188818,Staff,6,0,35,29
1683315047343,MGT 4,A01,202857,Anderson; John Charles,62,0,80,18
1683315048367,MGT 12,A00,202858,Lindenberger; Wade Douglas,43,0,90,47
1683315049391,MGT 18,A00,202859,Staff,74,0,90,16
1683315050415,MGT 18GS,A00,202860,McKay; Michael J,13,0,28,15
1683315051441,MGT 45,A00,202861,Pecore; Joseph P.,14,0,90,76
1683315052465,MGT 100,A00,202863,Yavorsky; Daniel Ryan,28,0,90,62
1683315053493,MGT 103,A00,202864,Ehrich; Kristine R,0,16,90,90
1683315054517,MGT 112,A00,202865,Ehrich; Kristine R,15,0,90,75
1683315055545,MGT 121A,A00,202868,Staff,0,19,0,0
1683315056569,MGT 131B,A00,202869,Anderson; John Charles,59,0,90,31
1683315057597,MGT 136,A00,202871,Lindenberger; Wade Douglas,84,0,90,6
1683315058621,MGT 164,A00,202873,Staff,0,68,90,90
1683315059650,MGT 164GS,A00,202874,McKay; Mary A,13,0,28,15
1683315060674,MGT 180,A00,202875,Staff,0,50,90,90
1683315061703,MMW 11R,A01,205019,Herbst; Matthew,3,0,30,27
1683315061703,MMW 11R,A02,205026,Herbst; Matthew,29,0,30,1
1683315062730,MMW 15,A01,193512,Chang; Edmond Yi-Teh,0,9,28,28
1683315062730,MMW 15,A02,193513,Chang; Edmond Yi-Teh,0,5,28,28
1683315062730,MMW 15,A03,193514,Chang; Edmond Yi-Teh,0,5,28,28
1683315062730,MMW 15,A04,193515,Chang; Edmond Yi-Teh,0,5,28,28
1683315062730,MMW 15,A05,193516,Chang; Edmond Yi-Teh,0,4,28,28
1683315062730,MMW 15,A06,193517,Chang; Edmond Yi-Teh,0,5,28,28
1683315062730,MMW 15,B01,193519,Chang; Edmond Yi-Teh,0,4,28,28
1683315062730,MMW 15,B02,193520,Chang; Edmond Yi-Teh,0,5,28,28
1683315062730,MMW 15,B03,193521,Chang; Edmond Yi-Teh,0,4,28,28
1683315062730,MMW 15,B04,193522,Chang; Edmond Yi-Teh,0,4,28,28
1683315062730,MMW 15,B05,193523,Chang; Edmond Yi-Teh,0,5,28,28
1683315062730,MMW 15,B06,193524,Chang; Edmond Yi-Teh,0,4,28,28
1683315063757,MMW 122,A01,193526,Rahimi; Babak,0,14,28,28
1683315063757,MMW 122,A02,193527,Rahimi; Babak,0,14,28,28
1683315063757,MMW 122,A03,193528,Rahimi; Babak,0,0,0,0
1683315063757,MMW 122,A04,193529,Rahimi; Babak,0,0,0,0
1683315064785,MUS 1A,A01,186663,Staff,0,20,35,35
1683315065809,MUS 4,A01,186715,Staff,0,12,35,35
1683315066837,MUS 5R,A01,186796,Dubnov; Shlomo,0,17,35,35
1683315067861,MUS 6,A01,186798,Staff,0,3,25,25
1683315068889,MUS 7,A01,186830,Staff,12,0,35,23
1683315069913,MUS 8,A01,186930,Staff,0,26,35,35
1683315070944,MUS 15,A01,186932,Staff,0,15,35,35
1683315070944,MUS 15,B01,186934,Staff,0,15,35,35
1683315071973,MUS 80,A00,186935,Staff,2,0,20,18
1683315071973,MUS 80,B00,186936,Staff,25,0,25,0
1683315072999,NANO 11,A00,204702,Lipomi; Darren John,0,0,0,0
1683315074023,NANO 15,A01,204709,Yang; Kesong,0,1,0,0
1683315075048,NANO 114,A00,202069,Jahed Motlagh; Zeinab,3,0,10,7
1683315076072,PHIL 1,A00,186955,Grush; Rick Scott,32,0,40,8
1683315077097,PHIL 10,A01,186973,Grush; Rick Scott,28,0,35,7
1683315077097,PHIL 10,A02,186974,Grush; Rick Scott,33,0,35,2
1683315078121,PHIL 13,A01,186976,Staff,7,0,35,28
1683315078121,PHIL 13,A02,186977,Staff,16,0,35,19
1683315079146,PHIL 14,A01,186979,Staff,31,0,35,4
1683315079146,PHIL 14,A02,186986,Staff,32,0,35,3
1683315080169,PHIL 28,A01,186988,Staff,16,0,30,14
1683315080169,PHIL 28,A02,186989,Staff,1,0,30,29
1683315080169,PHIL 28,A03,186990,Staff,9,0,30,21
1683315080169,PHIL 28,A04,186991,Staff,26,0,30,4
1683315081194,PHIL 120,A00,186997,Staff,23,0,40,17
1683315082219,PHIL 137,A00,187003,Staff,9,0,40,31
1683315083243,PHIL 150,A00,187015,Staff,47,0,70,23
1683315084269,PHIL 167,A00,187021,Lamey; Andy M.,35,0,40,5
1683315085294,PHIL 174,A01,202226,Staff,17,0,20,3
1683315085294,PHIL 174,A02,202235,Staff,20,0,20,0
1683315086318,PHIL 191A,A00,258918,Staff,0,0,1,1
1683315087342,PHYS 1A,A00,187028,Staff,27,0,60,33
1683315088367,PHYS 1AL,001,187036,Staff,3,0,30,27
1683315088367,PHYS 1AL,002,187049,Staff,18,0,30,12
1683315089391,PHYS 1B,A00,187058,Staff,22,0,60,38
1683315090415,PHYS 1BL,001,187064,Staff,0,0,30,30
1683315090415,PHYS 1BL,002,187070,Staff,5,0,30,25
1683315091438,PHYS 1C,A00,187082,Staff,31,0,120,89
1683315092463,PHYS 1CL,001,187088,Staff,0,9,30,30
1683315092463,PHYS 1CL,002,187089,Staff,0,2,30,30
1683315092463,PHYS 1CL,009,262693,Staff,11,0,30,19
1683315093489,PHYS 2B,A01,187097,Staff,54,0,115,61
1683315094516,PHYS 2C,A01,187099,Staff,67,0,115,48
1683315095541,PHYS 2CL,A01,187101,Staff,5,0,28,23
1683315095541,PHYS 2CL,A02,187102,Staff,15,0,28,13
1683315096568,PHYS 2D,A01,187123,Shotwell; Brian,95,0,115,20
1683315097592,PHYS 4B,A01,187133,Grinstein; Benjamin,35,0,50,15
1683315098616,POLI 10,A00,188819,Staff,0,4,50,50
1683315099644,POLI 11,A00,188827,Staff,43,0,50,7
1683315100667,POLI 13R,A00,188828,Staff,0,1,20,20
1683315101691,POLI 27,A01,188830,Elgin; Samuel Zincke,0,1,70,70
1683315102719,POLI 30,A00,188832,Desposato; Scott,32,0,50,18
1683315103746,POLI 102F,A00,188834,Staff,3,0,40,37
1683315104771,POLI 104A,A00,188852,Staff,14,0,30,16
1683315105799,POLI 104I,A00,188853,Staff,0,6,20,20
1683315106825,POLI 110B,A00,188854,Wiens; David,7,0,20,13
1683315107849,POLI 112A,A00,188855,Wiens; David,5,0,30,25
1683315108873,POLI 117R,A00,188856,Forman; Fonna,0,11,20,20
1683315109900,POLI 118,A00,188857,Ingham; Sean,8,0,20,12
1683315110927,POLI 120G,A00,188858,Staff,9,0,30,21
1683315111953,POLI 131CR,A00,188863,Hoston; Germaine,24,0,50,26
1683315112977,POLI 133,A00,188864,Nellis; Gareth Hb,44,0,50,6
1683315114004,POLI 134D,A00,188865,Desposato; Scott,27,0,30,3
1683315115031,POLI 142A,A00,188871,Gartzke; Erik,22,0,50,28
1683315116058,POLI 142K,A00,188874,Staff,38,0,50,12
1683315117085,POLI 143,A00,188940,Gartzke; Erik,16,0,30,14
1683315118111,POLI 153,A00,188943,Staff,3,0,20,17
1683315119135,POLI 160AA,A00,188944,Staff,12,0,40,28
1683315120160,POLI 170A,A00,188945,Staff,11,0,30,19
1683315122211,PSYC 1,A00,188952,Staff,37,0,90,53
1683315123241,PSYC 2,B00,188953,Staff,19,0,35,16
1683315124265,PSYC 6,A00,188970,Staff,47,0,60,13
1683315125289,PSYC 7,A00,188973,Staff,37,0,45,8
1683315126314,PSYC 60,A01,188980,Rickard; Timothy C.,43,0,60,17
1683315127339,PSYC 70,A01,189001,Steiner; Eric Tomas,24,0,45,21
1683315128363,PSYC 100,A00,189005,Lacefield; Katharine I,0,99,120,120
1683315129389,PSYC 102,A00,189008,Staff,10,0,30,20
1683315130417,PSYC 106,B00,189026,Gorman; Michael R.,36,0,60,24
1683315131501,PSYC 114,B01,189033,Winkielman; Piotr,0,32,30,30
1683315132525,PSYC 131,A00,189036,Anagnostaras; Stephan,0,43,60,60
1683315133549,PSYC 136,A00,189041,Lowe; Angela Beth,0,7,25,25
1683315134576,PSYC 137,A00,189057,Winkielman; Piotr,0,34,25,25
1683315135603,PSYC 144,A00,189107,Wixted; John T,0,7,50,50
1683315137652,PSYC 162,A00,189142,Staff,0,8,85,85
1683315138677,PSYC 172,A00,189144,Gorman; Michael R.,0,7,30,30
1683315140731,PSYC 179,A00,189146,Lacefield; Katharine I,0,84,120,120
1683315141761,PSYC 181,A00,189147,Anagnostaras; Stephan,0,44,90,90
1683315142791,PSYC 190R,A00,189148,Barner; David A.,0,22,80,80
1683315143818,PSYC 191,A00,189275,Rickard; Timothy C.,0,7,25,25
1683315144841,PSYC 193,A00,189276,Chapman; Eddie Nathaniel,0,1,0,4
1683315145867,PSYC 193L,A01,189281,Lowe; Angela Beth,12,0,20,8
1683315145867,PSYC 193L,B01,189285,Staff,28,0,35,7
1683315146897,RELI 149,A00,187137,Rahimi; Babak,7,0,40,33
1683315147925,SE 9,A01,187315,Staff,0,2,18,18
1683315148952,SE 101B,A00,187409,Staff,24,0,30,6
1683315149980,SE 110B,A00,187444,Staff,10,0,40,30
1683315151005,SE 130B,A00,187449,Staff,31,0,40,9
1683315152029,SE 150A,A00,187516,Staff,9,0,20,11
1683315153057,SE 154,A00,187528,Staff,30,0,50,20
1683315154085,SIO 3,A01,258171,Staff,35,0,40,5
1683315155110,SIO 10,A00,187144,Cook; Geoffrey W,0,3,75,75
1683315156133,SIO 45,A00,187152,Cook; Geoffrey W,1,0,100,99
1683315157157,SIO 109R,A00,194486,Staff,0,3,20,20
1683315159210,SIO 187,A01,187233,Kacev; David,12,0,40,28
1683315160239,SOCI 1,A01,258656,Thorpe; Charles Robert,28,0,30,2
1683315160239,SOCI 1,A02,258658,Thorpe; Charles Robert,30,0,30,0
1683315160239,SOCI 1,A03,258661,Thorpe; Charles Robert,25,0,25,0
1683315160239,SOCI 1,A04,258666,Thorpe; Charles Robert,22,0,25,3
1683315160239,SOCI 1,A05,258897,Thorpe; Charles Robert,23,0,25,2
1683315160239,SOCI 1,A06,258898,Thorpe; Charles Robert,25,0,25,0
1683315161262,SOCI 30,A01,258903,Pardo Guerra; Juan Pablo,16,0,30,14
1683315162286,SOCI 102,A00,258904,Staff,9,0,25,16
1683315163318,SOCI 106,A00,258905,Staff,19,0,25,6
1683315164343,SOCI 111,A00,258907,Ribas Norris; Janet Vanesa,26,0,30,4
1683315165367,SOCI 121R,A00,258908,Pardo Guerra; Juan Pablo,11,0,30,19
1683315166395,SOCI 126,A01,203330,Staff,14,0,20,6
1683315167419,SOCI 131,A00,258909,Thorpe; Charles Robert,31,0,60,29
1683315168446,SOCI 135,A00,258910,Payne; Christine Anna,0,9,30,30
1683315169473,SOCI 157,A00,258911,Staff,12,0,30,18
1683315170498,SOCI 184,A00,258912,Staff,25,0,30,5
1683315171523,SOCI 188D,A00,258913,Staff,21,0,30,9
1683315172548,SYN 2,001,187529,Staff,9,0,16,7
1683315172548,SYN 2,002,201452,Staff,0,18,16,16
1683315172548,SYN 2,003,201469,Staff,4,0,16,12
1683315173572,SYN 100,A01,187531,Staff,0,9,20,20
1683315173572,SYN 100,B01,201491,Staff,0,12,20,20
1683315174600,TDAC 1,A00,189286,Walsh; Kim C.,3,0,20,17
1683315174600,TDAC 1,B00,189287,Harting; Carla Kelso,11,0,20,9
1683315175623,TDAC 101,A00,189300,Walsh; Kim C.,16,0,20,4
1683315175623,TDAC 101,B00,189301,Harting; Carla Kelso,18,0,20,2
1683315176650,TDAC 102,A00,189304,Basso; Beatrice,14,0,20,6
1683315177677,TDAC 108,A00,189305,Staff,18,0,20,2
1683315178705,TDDE 131,A00,189310,Staff,19,0,20,1
1683315178705,TDDE 131,B00,189314,Staff,19,0,20,1
1683315178705,TDDE 131,C00,189315,Staff,48,0,50,2
1683315178705,TDDE 131,D00,189316,Staff,14,0,15,1
1683315178705,TDDE 131,E00,204841,Staff,20,0,20,0
1683315179733,TDGE 10,A00,189289,Staff,30,0,50,20
1683315179733,TDGE 10,B00,189290,Havis; Allan,2,0,50,48
1683315180763,TDGE 11,A00,189291,Fulton; Julia,0,3,50,50
1683315180763,TDGE 11,B00,189292,Staff,20,0,25,5
1683315180763,TDGE 11,C00,260270,Staff,0,0,0,0
1683315181789,TDGE 25,A00,189294,Staff,3,0,20,17
1683315182814,TDGE 124,A00,189318,Fulton; Julia,0,8,50,50
1683315183842,TDGE 125,A00,189319,Staff,13,0,25,12
1683315183842,TDGE 125,B00,189320,Staff,23,0,25,2
1683315184870,TDGE 127,A00,189322,Havis; Allan,0,0,50,50
1683315185896,TDHT 101,A00,189323,Staff,18,0,25,7
1683315185896,TDHT 101,B00,189324,Staff,25,0,25,0
1683315186922,TDHT 102,A00,189325,Staff,49,0,50,1
1683315187947,TDMV 1,A00,189295,Arcidiacono; Kristin,20,0,30,10
1683315187947,TDMV 1,B00,189296,Caligagan; Maria T.,24,0,30,6
1683315188972,TDMV 2,A00,189297,Sammartano; Tonnie,28,0,30,2
1683315188972,TDMV 2,B00,189299,Arcidiacono; Kristin,24,0,30,6
1683315189999,TDMV 3,A00,204998,Rincon; Alicia,22,0,30,8
1683315191031,TDMV 120,A00,189458,Sammartano; Tonnie,28,0,30,2
1683315192059,TDMV 138,A00,189541,Jun; Grace Shin Hae,22,0,40,18
1683315193087,TDMV 142,A00,189717,Caligagan; Tony,23,0,30,7
1683315193087,TDMV 142,B00,189718,Caligagan; Maria T.,25,0,30,5
1683315194114,TMC 2,A01,187533,Staff,25,0,25,0
1683315194114,TMC 2,A02,187534,Staff,25,0,25,0
1683315195138,USP 1,A01,187536,Kwak; Nancy,0,16,25,25
1683315196165,USP 5,A01,187538,Staff,9,0,25,16
1683315197189,USP 101,A00,199253,Staff,0,4,0,0
1683315198213,USP 124,A00,187562,Boomhower; Matthew Charles,1,0,30,29
1683315199239,USP 138,A00,187582,Staff,20,0,25,5
1683315200267,USP 152,A01,187597,Staff,4,0,25,21
1683315201290,USP 153,A00,187598,Staff,19,0,25,6
1683315202314,USP 168,A00,187607,Kwak; Nancy,2,0,5,3
1683315203341,USP 173,A00,187619,Staff,4,0,25,21
1683315204367,USP 181,A00,187638,Staff,0,0,25,25
1683315205393,VIS 103,A00,187650,Cruz; Edwin Teddy,23,0,75,52
1683315206419,VIS 110D,A00,187669,Staff,12,0,22,10
1683315207444,VIS 127C,A00,187720,Shen; Kuiyi,68,0,146,78
1683315208468,VIS 149,A00,187731,Yoldas; Pinar,0,14,22,22
1683315209493,VIS 151,A01,188091,Staff,22,0,34,12
1683315209493,VIS 151,A02,188092,Staff,11,0,34,23
1683315210521,VIS 160B,A00,188093,Stalbaum; Brett,0,0,10,10
1683315212574,WCWP 10B,A00,201720,Staff,10,0,15,5
1683315212574,WCWP 10B,B00,201722,Staff,8,0,15,7
1683315213601,WCWP 100,A00,201725,Gagnon; Jeffrey C,0,0,2,2
1683315213601,WCWP 100,B00,201727,Staff,0,4,15,15
1683315216727,ANBI 133,A00,258401,Wilder; Linnea Lorene,34,0,40,6
1683315217751,ANBI 140,A00,258395,Hrvoj Mihic; Branka,18,0,25,7
1683315218779,ANSC 120,A00,258402,Bialecki; Jon Anthony,27,0,40,13
1683315219805,ANSC 144,A00,258400,Staff,14,0,40,26
1683315221856,ANSC 166,A00,258396,Parish; Steven Martin,157,0,175,18
1683315222883,ANSC 180,A00,193533,Staff,9,0,20,11
1683315223909,ANSC 188,A00,258397,Jassal; Aftab,33,0,40,7
1683315224935,ANTH 3,A01,258316,Staff,23,0,30,7
1683315225960,ANTH 5,A00,258394,Semendeferi; Ekaterini,16,0,20,4
1683315226985,ANTH 21,A01,258331,Staff,9,0,40,31
1683315228010,ANTH 103,A00,258398,Varma; Saiba,15,0,25,10
1683315229043,AWP 10,001,202034,Staff,0,0,0,0
1683315229043,AWP 10,002,202035,Staff,0,0,0,0
1683315229043,AWP 10,003,202036,Staff,0,0,0,0
1683315229043,AWP 10,004,202037,Staff,0,0,0,0
1683315229043,AWP 10,005,202038,Staff,0,0,0,0
1683315229043,AWP 10,006,202039,Staff,0,0,0,0
1683315229043,AWP 10,007,202040,Staff,0,0,0,0
1683315229043,AWP 10,008,202041,Staff,0,0,0,0
1683315229043,AWP 10,009,202042,Staff,0,0,0,0
1683315229043,AWP 10,010,202043,Staff,0,0,0,0
1683315229043,AWP 10,011,202044,Staff,0,0,0,0
1683315229043,AWP 10,012,202045,Staff,0,0,0,0
1683315229043,AWP 10,013,202046,Staff,0,0,0,0
1683315229043,AWP 10,014,202047,Staff,0,0,0,0
1683315229043,AWP 10,015,202048,Staff,0,0,0,0
1683315229043,AWP 10,016,202049,Staff,0,0,0,0
1683315229043,AWP 10,017,202050,Staff,0,0,0,0
1683315229043,AWP 10,018,202051,Staff,0,0,0,0
1683315229043,AWP 10,019,202052,Staff,0,0,0,0
1683315229043,AWP 10,020,202053,Staff,0,0,0,0
1683315229043,AWP 10,021,202054,Staff,0,0,0,0
1683315229043,AWP 10,022,202055,Staff,0,0,0,0
1683315229043,AWP 10,023,202056,Staff,0,0,0,0
1683315229043,AWP 10,024,202057,Staff,0,0,0,0
1683315229043,AWP 10,025,202058,Staff,0,0,0,0
1683315229043,AWP 10,026,202059,Staff,0,0,0,0
1683315230069,AWP 102,001,202032,Staff,0,0,0,0
1683315230069,AWP 102,002,202033,Staff,0,0,0,0
1683315231100,BENG 100,A01,254234,Taylor Amos; Alyssa C,31,0,40,9
1683315232127,BENG 196,001,270013,Engler; Adam J.,9999,0,9999,0
1683315233153,BICD 100R,A01,202018,Smith; Laurie,0,7,32,32
1683315233153,BICD 100R,A02,202019,Smith; Laurie,0,2,32,32
1683315233153,BICD 100R,A03,202020,Smith; Laurie,0,1,32,32
1683315233153,BICD 100R,A04,202021,Smith; Laurie,8,0,32,24
1683315233153,BICD 100R,A05,202022,Smith; Laurie,12,0,32,20
1683315234179,BICD 136,A01,193242,Gustafson-Brown; Cindy,0,2,32,32
1683315234179,BICD 136,A02,193244,Gustafson-Brown; Cindy,15,0,32,17
1683315235277,BIEB 102,A01,193249,Butler; Shannon Rhey,0,2,32,32
1683315235277,BIEB 102,A02,193251,Butler; Shannon Rhey,0,0,32,32
1683315235277,BIEB 102,A03,193253,Butler; Shannon Rhey,0,1,32,32
1683315235277,BIEB 102,A04,193255,Butler; Shannon Rhey,17,0,32,15
1683315235277,BIEB 102,A05,193265,Butler; Shannon Rhey,26,0,32,6
1683315235277,BIEB 102,A06,193269,Butler; Shannon Rhey,16,0,32,16
1683315237337,BIEB 150,A01,193274,Staff,0,0,32,32
1683315237337,BIEB 150,A02,193285,Staff,24,0,32,8
1683315238360,BIEB 194,A00,193286,Kurle; Carolyn M.,22,0,32,10
1683315239384,BILD 1,A01,192291,Staff,16,0,32,16
1683315239384,BILD 1,A02,192292,Staff,30,0,32,2
1683315239384,BILD 1,B01,192520,Reuther; Keefe,0,1,0,0
1683315239384,BILD 1,B02,192532,Reuther; Keefe,0,1,0,0
1683315240413,BILD 3,A01,192556,Butler; Shannon Rhey,0,0,32,32
1683315240413,BILD 3,A02,192581,Butler; Shannon Rhey,5,0,32,27
1683315240413,BILD 3,A03,192611,Butler; Shannon Rhey,23,0,32,9
1683315240413,BILD 3,A04,192612,Butler; Shannon Rhey,25,0,32,7
1683315240413,BILD 3,A05,192613,Butler; Shannon Rhey,27,0,32,5
1683315240413,BILD 3,A06,192679,Butler; Shannon Rhey,27,0,32,5
1683315240413,BILD 3,A07,192682,Butler; Shannon Rhey,22,0,32,10
1683315241439,BILD 4,A01,192836,Reuther; Keefe,1,0,24,23
1683315241439,BILD 4,A02,193044,Reuther; Keefe,4,0,24,20
1683315242467,BILD 10,A01,193142,Gustafson-Brown; Cindy,31,0,32,1
1683315242467,BILD 10,A02,193149,Gustafson-Brown; Cindy,31,0,32,1
1683315243497,BIMM 100,A01,193301,Staff,0,6,32,32
1683315243497,BIMM 100,A02,193312,Staff,0,5,32,32
1683315243497,BIMM 100,A03,193323,Staff,0,8,32,32
1683315244521,BIMM 101,A01,193329,McDonnell; Lisa Marie,0,3,24,24
1683315244521,BIMM 101,A02,193339,McDonnell; Lisa Marie,0,2,24,24
1683315244521,BIMM 101,B01,193354,McDonnell; Lisa Marie,0,3,24,24
1683315244521,BIMM 101,B02,193357,McDonnell; Lisa Marie,0,3,24,24
1683315245549,BIMM 110,A01,193377,Tat; John,0,11,32,32
1683315245549,BIMM 110,A02,193378,Tat; John,1,9,32,31
1683315246574,BIMM 120,A01,206116,Staff,0,0,32,32
1683315246574,BIMM 120,A02,206117,Staff,8,0,32,24
1683315246574,BIMM 120,A03,206121,Staff,21,0,32,11
1683315247600,BIPN 100,A01,193393,Park; Ji Young,0,14,32,32
1683315247600,BIPN 100,A02,193402,Park; Ji Young,0,12,32,32
1683315247600,BIPN 100,A03,193413,Park; Ji Young,0,14,32,32
1683315247600,BIPN 100,A04,193414,Park; Ji Young,0,13,32,32
1683315248629,BIPN 102,A01,193429,Staff,0,0,32,32
1683315248629,BIPN 102,A02,193438,Staff,22,0,32,10
1683315249653,BIPN 106,A01,193450,Reyes Gonzalez; Catalina,0,2,40,40
1683315250677,BIPN 134,A01,193465,Cooke; James Edward,0,0,32,32
1683315250677,BIPN 134,A02,193474,Cooke; James Edward,27,0,32,5
1683315250677,BIPN 134,A03,193485,Cooke; James Edward,29,0,32,3
1683315250677,BIPN 134,A04,193486,Cooke; James Edward,21,0,32,11
1683315250677,BIPN 134,A05,193491,Cooke; James Edward,31,0,32,1
1683315250677,BIPN 134,A06,193501,Cooke; James Edward,30,0,32,2
1683315250677,BIPN 134,A07,193510,Cooke; James Edward,29,0,32,3
1683315252732,BISP 194,A00,222522,Staff,16,0,32,16
1683315253759,CAT 124,A01,202407,Staff,20,0,25,5
1683315254786,CAT 125,A00,202408,Marchisotto; Jennifer Anne,4,0,20,16
1683315255810,CAT 125R,A00,202409,Smith; Lauryn Alissa,0,11,20,20
1683315255810,CAT 125R,B00,202410,Morales; Celeste Georgianna,0,11,20,20
1683315255810,CAT 125R,C00,202411,Irwin; Matthew Joseph,0,10,20,20
1683315256838,CENG 15,A01,204712,Yang; Kesong,0,1,0,0
1683315257867,CENG 114,A00,202070,Jahed Motlagh; Zeinab,5,0,20,15
1683315258893,CGS 105,A00,185477,Wesling; Megan E.,24,0,40,16
1683315259918,CGS 106,A00,185494,Staff,13,0,22,9
1683315260945,CGS 108,A00,185495,Staff,14,0,20,6
1683315261971,CGS 114,A00,185496,Staff,13,0,18,5
1683315262998,CGS 119,A00,185501,Staff,15,0,20,5
1683315264022,CGS 120,A00,185511,Staff,13,0,20,7
1683315265051,CHEM 4,A01,184675,Bussey; Thomas J,96,0,100,4
1683315266076,CHEM 6A,A01,184677,Staff,35,0,60,25
1683315267101,CHEM 6B,A01,184679,Staff,65,0,100,35
1683315268125,CHEM 6C,A01,184681,Bussey; Thomas J,1,0,50,49
1683315268125,CHEM 6C,A02,184682,Bussey; Thomas J,34,0,50,16
1683315269152,CHEM 40A,A01,184684,Albizati; Kim F.,37,0,100,63
1683315270179,CHEM 40B,A01,184686,Albizati; Kim F.,0,20,100,100
1683315271205,CHEM 41B,A01,184690,Staff,52,0,100,48
1683315272232,COGS 3,A01,184715,Boyle; Mary E. T.,0,25,40,40
1683315273256,COGS 14B,A01,185172,Staff,0,15,38,38
1683315274278,COGS 18,A01,184736,Staff,19,0,80,61
1683315275305,COGS 100,A01,184932,Staff,0,5,73,73
1683315276329,COGS 101A,A01,184935,Staff,0,38,30,30
1683315277353,COGS 101B,A01,184944,Staff,0,2,30,30
1683315278378,COGS 101C,A01,184946,Staff,0,12,30,30
1683315279402,COGS 102A,A01,184951,Johnson; Christine M.,2,0,40,38
1683315280430,COGS 107B,A01,184953,Mooshagian; Eric Frederick,0,50,40,40
1683315281454,COGS 118B,A01,184959,Gupta; Anjum,0,48,40,40
1683315282478,COGS 153,A00,184961,Staff,0,15,30,30
1683315283505,COGS 177,A00,184962,Staff,0,21,30,30
1683315284604,COGS 187A,A01,184969,Boyle; Mary E. T.,0,17,40,40
1683315285631,COMM 10,A01,185174,Staff,0,5,25,25
1683315285631,COMM 10,A02,185189,Staff,0,5,25,25
1683315285631,COMM 10,A03,269821,Staff,0,0,0,0
1683315286655,COMM 100B,A01,185475,Staff,0,0,0,2
1683315286655,COMM 100B,A02,185476,Staff,14,0,25,11
1683315287684,COMM 100C,A01,185314,Staff,1,0,25,24
1683315287684,COMM 100C,A02,185327,Staff,19,0,25,6
1683315288708,COMM 110M,A00,185349,Staff,2,0,40,38
1683315289735,COMM 113T,A00,185352,Staff,25,0,40,15
1683315290759,COMM 114I,A00,185353,Staff,33,0,40,7
1683315291787,COMM 131,A00,185354,Staff,19,0,30,11
1683315292812,CSE 8A,A50,185358,Cao; Yingjun,0,46,10,10
1683315293837,CSE 8B,A01,185362,Staff,1,47,50,49
1683315294862,CSE 11,A01,185416,Cao; Yingjun,0,92,10,10
1683315295888,CSE 20,A01,185445,Briones; Jor-el Thomas Caparas,5,0,25,20
1683315296913,CSE 21,A01,185447,Staff,10,0,50,40
1683315297938,CSE 101,A01,185451,Staff,0,12,50,50
1683315297938,CSE 101,B01,185453,Jones; Miles E,0,11,50,50
1683315299991,CSE 141,A01,185458,Eldon; John,20,0,100,80
1683315301015,CSE 141L,A01,185461,Eldon; John,12,0,100,88
1683315302046,CSE 142,A01,185463,Staff,36,0,60,24
1683315302046,CSE 142,B01,201355,Staff,0,7,60,60
1683315303071,CSE 142L,A01,185470,Staff,36,0,60,24
1683315303071,CSE 142L,B01,201417,Staff,0,6,60,60
1683315304095,CSE 190,A00,201433,Staff,32,0,49,17
1683315305126,DOC 1,A01,259136,Strom; Megan C.,7,0,15,8
1683315305126,DOC 1,A02,259137,Strom; Megan C.,14,0,15,1
1683315305126,DOC 1,A03,259138,Strom; Megan C.,14,0,15,1
1683315305126,DOC 1,A04,259139,Strom; Megan C.,14,0,15,1
1683315306150,DOC 100D,A00,259140,Pass; Natalye Joann,17,0,25,8
1683315307177,DSGN 1,A01,184749,Rill; Bryan,0,25,30,30
1683315308201,DSGN 100,A01,185168,Staff,0,2,25,25
1683315309229,ECE 5,A01,185626,Morris; Karcher William,0,10,0,0
1683315310255,ECE 101,A01,185628,Staff,17,0,70,53
1683315311284,ECE 107,A01,185635,Baghdadchi; Saharnaz,0,0,20,20
1683315311284,ECE 107,A02,185638,Baghdadchi; Saharnaz,4,0,20,16
1683315312309,ECE 148,A01,185647,Silberman; Jack,0,0,16,16
1683315313335,ECON 1,A01,185537,Crane; Meredith Helen,54,0,70,16
1683315314361,ECON 3,A01,185549,Crane; Meredith Helen,33,0,70,37
1683315315385,ECON 4,A01,203354,Anderson; John Charles,0,4,10,10
1683315316410,ECON 100A,A01,185574,Staff,0,4,40,40
1683315317436,ECON 100B,A01,185576,Staff,0,22,40,40
1683315318460,ECON 100C,A01,185589,Newhouse; Herbert S,30,0,70,40
1683315319488,ECON 105,A00,185608,Vespa; Emanuel Ignacio,19,0,35,16
1683315320515,ECON 109,A01,185610,Shishkin; Denis,10,0,35,25
1683315321542,ECON 110A,A01,185612,Staff,11,0,40,29
1683315322566,ECON 120A,A01,185615,Staff,20,0,40,20
1683315323590,ECON 120C,A01,185617,Sun; Yixiao,0,20,70,70
1683315324615,ECON 144,A00,203346,Squires; Dale E,3,0,35,32
1683315325642,ECON 171,A01,203349,Newhouse; Herbert S,0,1,35,35
1683315326666,ECON 173A,A01,185621,Toda; Alexis Akira,21,0,35,14
1683315327697,EDS 25,A01,202413,Staff,0,1,0,0
1683315327697,EDS 25,A02,202414,Staff,0,1,0,0
1683315327697,EDS 25,A03,202415,Staff,0,0,0,0
1683315327697,EDS 25,A04,202416,Staff,0,1,0,0
1683315327697,EDS 25,A05,202439,Staff,0,0,0,0
1683315327697,EDS 25,A06,202440,Staff,0,0,0,0
1683315327697,EDS 25,B01,202631,Staff,0,0,0,0
1683315327697,EDS 25,B02,202632,Staff,0,0,0,0
1683315327697,EDS 25,B03,202639,Staff,0,0,0,0
1683315327697,EDS 25,B04,202640,Staff,0,0,0,0
1683315327697,EDS 25,B05,202643,Staff,0,0,0,0
1683315327697,EDS 25,B06,202644,Staff,0,0,0,0
1683315328724,EDS 38,A01,202659,Black; Alison Michelle,24,0,25,1
1683315329751,EDS 115,A00,202652,Staff,17,0,30,13
1683315330775,EDS 125,A00,202649,Staff,14,0,30,16
1683315331802,EDS 126,A01,203332,Staff,30,0,30,0
1683315332827,EDS 139,A00,202838,Staff,16,0,25,9
1683315333854,EDS 146,A01,202655,Staff,14,0,25,11
1683315334878,ENG 15,A00,185667,Staff,0,1,0,0
1683315334878,ENG 15,B00,185672,Staff,0,0,0,0
1683315334878,ENG 15,C00,185675,Staff,0,0,0,0
1683315334878,ENG 15,D00,185682,Staff,0,0,0,0
1683315334878,ENG 15,E00,185684,Staff,0,0,0,0
1683315335902,ETHN 103,A00,185710,Staff,0,3,35,35
1683315336928,ETHN 103A,A00,199228,Man; Simeon S,2,0,9,7
1683315337955,ETHN 109,A00,185711,Staff,18,0,35,17
1683315339038,ETHN 142,A00,185726,Staff,0,4,30,30
1683315340062,ETHN 163J,A00,199229,Man; Simeon S,5,0,8,3
1683315341089,ETHN 168,A00,185727,Staff,8,0,10,2
1683315342113,ETHN 182,A00,185728,Staff,1,0,35,34
1683315343139,ETHN 183,A00,185737,Staff,8,0,18,10
1683315344163,GLBH 111,A01,209361,Burgos; Jose L.,0,0,0,0
1683315346213,HIEU 104,A00,185792,Staff,16,0,20,4
1683315347239,HIEU 115,A00,185800,Staff,1,0,20,19
1683315348263,HIEU 128,A00,185801,Staff,0,7,20,20
1683315349287,HIEU 147,A00,185802,Staff,16,0,20,4
1683315350313,HIEU 154,A00,185823,Staff,12,0,20,8
1683315351339,HILA 102,A00,185826,Staff,13,0,20,7
1683315352364,HILD 2C,A01,185778,Staff,0,12,20,20
1683315353389,HILD 7B,A01,185780,Kwak; Nancy,0,15,32,32
1683315353389,HILD 7B,A02,185781,Kwak; Nancy,0,18,32,32
1683315354415,HILD 30,A01,185791,Staff,14,0,20,6
1683315355442,HISC 119,A00,185830,Golan; Tal,0,9,20,20
1683315356466,HITO 156GS,A00,185831,Patterson; Patrick H.,0,0,0,23
1683315357493,HIUS 103,A00,185832,Man; Simeon S,0,6,20,20
1683315358519,HIUS 117,A00,185836,Kwak; Nancy,2,0,20,18
1683315359544,HIUS 125,A00,185840,Man; Simeon S,0,0,23,23
1683315360571,HIUS 149,A00,185845,Staff,0,0,20,20
1683315361594,HUM 3,A01,185882,Zavodny; Tatiana Sophia,0,6,50,50
1683315361594,HUM 3,B01,185899,Caldwell; Michael Alan,0,19,50,50
1683315362619,HUM 3GS,A00,185900,Patterson; Patrick H.,0,0,0,23
1683315363646,HUM 4,A01,185938,Zroka; Amy Liane,31,0,50,19
1683315363646,HUM 4,B01,185956,Watkins; Eric,0,2,50,50
1683315363646,HUM 4,B02,202209,Watkins; Eric,0,2,50,50
1683315363646,HUM 4,B03,202210,Watkins; Eric,0,0,50,50
1683315364675,HUM 5,A01,185958,West; Geoffrey Scott,4,0,50,46
1683315364675,HUM 5,A02,202215,West; Geoffrey Scott,0,0,50,50
1683315365700,INTL 190,A00,185959,Gagnon; Jeffrey C,0,0,0,9
1683315365700,INTL 190,B00,185960,Lettieri; Michael Joseph,0,0,0,1
1683315366724,JAPN 180,A00,254509,Staff,5,1,30,25
1683315367751,LATI 10,A01,202853,Kennemore; Amy Michelle,5,0,35,30
1683315367751,LATI 10,A02,202854,Kennemore; Amy Michelle,1,0,35,34
1683315367751,LATI 10,A03,270054,Kennemore; Amy Michelle,30,0,30,0
1683315368778,LATI 180,A00,202855,Kennemore; Amy Michelle,11,0,20,9
1683315369806,LAWS 101,A00,201767,Golan; Tal,0,7,40,40
1683315370831,LIFR 1C,A00,185961,Staff,6,0,20,14
1683315371860,LIFR 1CX,A00,185962,Staff,7,0,20,13
1683315372884,LIFR 1D,A00,185963,Staff,9,0,20,11
1683315373913,LIFR 1DX,A00,185964,Staff,9,0,20,11
1683315374937,LIGN 101,A01,186039,Staff,43,0,50,7
1683315375961,LIGN 165,A00,186040,Staff,18,0,50,32
1683315376989,LTCS 108,A00,186041,Staff,6,0,10,4
1683315378019,LTCS 119,A00,186042,Staff,16,0,20,4
1683315379041,LTCS 130,A00,186043,Wesling; Megan E.,15,0,25,10
1683315381091,LTEA 138,A00,186119,Staff,14,0,40,26
1683315382114,LTEN 124,A00,186148,Staff,6,0,25,19
1683315383141,LTEN 178,A00,186149,Staff,7,0,15,8
1683315384165,LTEN 181,A00,186150,Blanco; John D,33,0,40,7
1683315385192,LTWL 120,A00,186160,Staff,20,0,25,5
1683315386219,LTWL 165,A00,186161,Staff,22,0,25,3
1683315387245,LTWR 100,A00,186162,Staff,0,4,15,15
1683315388268,LTWR 102,A00,186163,Doller; Ben,5,0,15,10
1683315389294,MAE 8,A01,186412,Staff,0,0,0,0
1683315390320,MAE 30B,A00,186445,Bahadori; Mohammad Yousef,83,0,100,17
1683315391342,MAE 40,A00,186592,Bewley; Thomas R,9,0,50,41
1683315392370,MAE 101B,A00,186593,Bahadori; Mohammad Yousef,81,0,100,19
1683315393396,MAE 105,A00,186594,Bandaru; Prabhakar,12,0,50,38
1683315394422,MAE 107,A00,186599,Pham; Hieu Tan,0,6,120,120
1683315395449,MAE 148,A01,186660,Silberman; Jack,3,0,16,13
1683315396477,MATH 10A,A01,188095,Staff,0,6,35,35
1683315397506,MATH 10B,A01,188097,Bowers; Adam R.,0,11,30,30
1683315397506,MATH 10B,A02,188099,Bowers; Adam R.,0,11,30,30
1683315397506,MATH 10B,B01,188104,Bowers; Adam R.,0,10,30,30
1683315397506,MATH 10B,B02,188106,Bowers; Adam R.,0,10,30,30
1683315398535,MATH 10C,A01,188111,Staff,0,18,30,30
1683315398535,MATH 10C,A02,188127,Staff,0,17,30,30
1683315398535,MATH 10C,A03,188131,Staff,0,18,30,30
1683315398535,MATH 10C,B01,188218,Staff,20,0,30,10
1683315398535,MATH 10C,B02,188244,Staff,13,0,30,17
1683315398535,MATH 10C,B03,188277,Staff,16,0,30,14
1683315399565,MATH 18,A01,188344,Bach; Quang Tran,18,0,30,12
1683315399565,MATH 18,A02,188345,Bach; Quang Tran,11,0,30,19
1683315399565,MATH 18,B01,188353,Bach; Quang Tran,10,0,30,20
1683315399565,MATH 18,B02,188354,Bach; Quang Tran,20,0,30,10
1683315400592,MATH 20A,A01,188374,Staff,13,0,35,22
1683315401620,MATH 20B,A01,188382,Ohm; Ko Woon,6,0,30,24
1683315401620,MATH 20B,A02,188383,Ohm; Ko Woon,23,0,30,7
1683315401620,MATH 20B,B01,188385,Ohm; Ko Woon,7,0,30,23
1683315401620,MATH 20B,B02,188392,Ohm; Ko Woon,22,0,30,8
1683315402645,MATH 20C,A01,188394,Harel; Guershon,10,0,30,20
1683315402645,MATH 20C,A02,188395,Harel; Guershon,14,0,30,16
1683315402645,MATH 20C,B01,188404,Harel; Guershon,5,0,30,25
1683315402645,MATH 20C,B02,188405,Harel; Guershon,19,0,30,11
1683315403671,MATH 20D,A01,188414,Hammock; Frances H,0,1,30,30
1683315403671,MATH 20D,A02,188415,Hammock; Frances H,3,0,30,27
1683315403671,MATH 20D,B01,188447,Hammock; Frances H,2,0,30,28
1683315403671,MATH 20D,B02,188486,Hammock; Frances H,8,0,30,22
1683315404698,MATH 20E,A01,188649,Staff,21,0,30,9
1683315404698,MATH 20E,A02,188650,Staff,23,0,30,7
1683315404698,MATH 20E,A03,188673,Staff,0,0,30,30
1683315405720,MATH 102,A01,188675,Staff,0,35,35,35
1683315406746,MATH 103B,A01,188681,Staff,4,0,35,31
1683315406746,MATH 103B,B01,188692,Staff,5,0,35,30
1683315407773,MATH 109,A01,188695,Salehi Golsefidy; Alireza,25,0,35,10
1683315407773,MATH 109,A02,188696,Salehi Golsefidy; Alireza,26,0,35,9
1683315408798,MATH 120A,A01,188698,Eggers; John Dietrich,7,0,35,28
1683315409829,MATH 142B,A01,188736,Ioana; Adrian,0,2,30,30
1683315409829,MATH 142B,A02,188741,Ioana; Adrian,0,1,30,30
1683315409829,MATH 142B,A03,188743,Ioana; Adrian,1,3,30,29
1683315410853,MATH 168A,A01,188790,Staff,0,9,35,35
1683315411882,MATH 170A,A01,188803,Nie; Jiawang,0,2,35,35
1683315411882,MATH 170A,A02,188811,Nie; Jiawang,0,0,35,35
1683315411882,MATH 170A,A03,188814,Nie; Jiawang,0,0,35,35
1683315411882,MATH 170A,A04,188815,Nie; Jiawang,13,0,35,22
1683315412907,MATH 193B,A01,188817,Staff,0,0,35,35
1683315412907,MATH 193B,A02,188818,Staff,6,0,35,29
1683315413932,MGT 4,A01,202857,Anderson; John Charles,62,0,80,18
1683315414958,MGT 12,A00,202858,Lindenberger; Wade Douglas,43,0,90,47
1683315415983,MGT 18,A00,202859,Staff,74,0,90,16
1683315417009,MGT 18GS,A00,202860,McKay; Michael J,13,0,28,15
1683315418035,MGT 45,A00,202861,Pecore; Joseph P.,14,0,90,76
1683315419058,MGT 100,A00,202863,Yavorsky; Daniel Ryan,28,0,90,62
1683315420087,MGT 103,A00,202864,Ehrich; Kristine R,0,16,90,90
1683315421112,MGT 112,A00,202865,Ehrich; Kristine R,15,0,90,75
1683315422137,MGT 121A,A00,202868,Staff,0,19,0,0
1683315423164,MGT 131B,A00,202869,Anderson; John Charles,59,0,90,31
1683315424189,MGT 136,A00,202871,Lindenberger; Wade Douglas,84,0,90,6
1683315425214,MGT 164,A00,202873,Staff,0,68,90,90
1683315426241,MGT 164GS,A00,202874,McKay; Mary A,13,0,28,15
1683315427265,MGT 180,A00,202875,Staff,0,50,90,90
1683315428293,MMW 11R,A01,205019,Herbst; Matthew,3,0,30,27
1683315428293,MMW 11R,A02,205026,Herbst; Matthew,29,0,30,1
1683315429323,MMW 15,A01,193512,Chang; Edmond Yi-Teh,0,9,28,28
1683315429323,MMW 15,A02,193513,Chang; Edmond Yi-Teh,0,5,28,28
1683315429323,MMW 15,A03,193514,Chang; Edmond Yi-Teh,0,5,28,28
1683315429323,MMW 15,A04,193515,Chang; Edmond Yi-Teh,0,5,28,28
1683315429323,MMW 15,A05,193516,Chang; Edmond Yi-Teh,0,4,28,28
1683315429323,MMW 15,A06,193517,Chang; Edmond Yi-Teh,0,5,28,28
1683315429323,MMW 15,B01,193519,Chang; Edmond Yi-Teh,0,4,28,28
1683315429323,MMW 15,B02,193520,Chang; Edmond Yi-Teh,0,5,28,28
1683315429323,MMW 15,B03,193521,Chang; Edmond Yi-Teh,0,4,28,28
1683315429323,MMW 15,B04,193522,Chang; Edmond Yi-Teh,0,4,28,28
1683315429323,MMW 15,B05,193523,Chang; Edmond Yi-Teh,0,5,28,28
1683315429323,MMW 15,B06,193524,Chang; Edmond Yi-Teh,0,4,28,28
1683315430348,MMW 122,A01,193526,Rahimi; Babak,0,14,28,28
1683315430348,MMW 122,A02,193527,Rahimi; Babak,0,14,28,28
1683315430348,MMW 122,A03,193528,Rahimi; Babak,0,0,0,0
1683315430348,MMW 122,A04,193529,Rahimi; Babak,0,0,0,0
1683315431376,MUS 1A,A01,186663,Staff,0,20,35,35
1683315432401,MUS 4,A01,186715,Staff,0,12,35,35
1683315433426,MUS 5R,A01,186796,Dubnov; Shlomo,0,17,35,35
1683315434452,MUS 6,A01,186798,Staff,0,3,25,25
1683315435476,MUS 7,A01,186830,Staff,12,0,35,23
1683315436502,MUS 8,A01,186930,Staff,0,26,35,35
1683315437531,MUS 15,A01,186932,Staff,0,15,35,35
1683315437531,MUS 15,B01,186934,Staff,0,15,35,35
1683315438560,MUS 80,A00,186935,Staff,2,0,20,18
1683315438560,MUS 80,B00,186936,Staff,25,0,25,0
1683315439588,NANO 11,A00,204702,Lipomi; Darren John,0,0,0,0
1683315440614,NANO 15,A01,204709,Yang; Kesong,0,1,0,0
1683315441643,NANO 114,A00,202069,Jahed Motlagh; Zeinab,3,0,10,7
1683315442726,PHIL 1,A00,186955,Grush; Rick Scott,32,0,40,8
1683315443754,PHIL 10,A01,186973,Grush; Rick Scott,28,0,35,7
1683315443754,PHIL 10,A02,186974,Grush; Rick Scott,33,0,35,2
1683315444782,PHIL 13,A01,186976,Staff,7,0,35,28
1683315444782,PHIL 13,A02,186977,Staff,16,0,35,19
1683315445807,PHIL 14,A01,186979,Staff,31,0,35,4
1683315445807,PHIL 14,A02,186986,Staff,32,0,35,3
1683315446835,PHIL 28,A01,186988,Staff,16,0,30,14
1683315446835,PHIL 28,A02,186989,Staff,1,0,30,29
1683315446835,PHIL 28,A03,186990,Staff,9,0,30,21
1683315446835,PHIL 28,A04,186991,Staff,26,0,30,4
1683315447857,PHIL 120,A00,186997,Staff,23,0,40,17
1683315448884,PHIL 137,A00,187003,Staff,9,0,40,31
1683315449908,PHIL 150,A00,187015,Staff,47,0,70,23
1683315450935,PHIL 167,A00,187021,Lamey; Andy M.,35,0,40,5
1683315451959,PHIL 174,A01,202226,Staff,17,0,20,3
1683315451959,PHIL 174,A02,202235,Staff,20,0,20,0
1683315452983,PHIL 191A,A00,258918,Staff,0,0,1,1
1683315454010,PHYS 1A,A00,187028,Staff,27,0,60,33
1683315455035,PHYS 1AL,001,187036,Staff,3,0,30,27
1683315455035,PHYS 1AL,002,187049,Staff,18,0,30,12
1683315456059,PHYS 1B,A00,187058,Staff,22,0,60,38
1683315457082,PHYS 1BL,001,187064,Staff,0,0,30,30
1683315457082,PHYS 1BL,002,187070,Staff,5,0,30,25
1683315458105,PHYS 1C,A00,187082,Staff,31,0,120,89
1683315459133,PHYS 1CL,001,187088,Staff,0,9,30,30
1683315459133,PHYS 1CL,002,187089,Staff,0,2,30,30
1683315459133,PHYS 1CL,009,262693,Staff,11,0,30,19
1683315460161,PHYS 2B,A01,187097,Staff,54,0,115,61
1683315461188,PHYS 2C,A01,187099,Staff,67,0,115,48
1683315462215,PHYS 2CL,A01,187101,Staff,5,0,28,23
1683315462215,PHYS 2CL,A02,187102,Staff,15,0,28,13
1683315463241,PHYS 2D,A01,187123,Shotwell; Brian,95,0,115,20
1683315464265,PHYS 4B,A01,187133,Grinstein; Benjamin,35,0,50,15
1683315465292,POLI 10,A00,188819,Staff,0,4,50,50
1683315466315,POLI 11,A00,188827,Staff,43,0,50,7
1683315467339,POLI 13R,A00,188828,Staff,0,1,20,20
1683315468364,POLI 27,A01,188830,Elgin; Samuel Zincke,0,1,70,70
1683315469390,POLI 30,A00,188832,Desposato; Scott,32,0,50,18
1683315470414,POLI 102F,A00,188834,Staff,3,0,40,37
1683315471437,POLI 104A,A00,188852,Staff,14,0,30,16
1683315472461,POLI 104I,A00,188853,Staff,0,6,20,20
1683315473489,POLI 110B,A00,188854,Wiens; David,7,0,20,13
1683315474516,POLI 112A,A00,188855,Wiens; David,5,0,30,25
1683315475540,POLI 117R,A00,188856,Forman; Fonna,0,11,20,20
1683315476568,POLI 118,A00,188857,Ingham; Sean,8,0,20,12
1683315477594,POLI 120G,A00,188858,Staff,9,0,30,21
1683315478619,POLI 131CR,A00,188863,Hoston; Germaine,24,0,50,26
1683315479648,POLI 133,A00,188864,Nellis; Gareth Hb,44,0,50,6
1683315480672,POLI 134D,A00,188865,Desposato; Scott,27,0,30,3
1683315481695,POLI 142A,A00,188871,Gartzke; Erik,22,0,50,28
1683315482721,POLI 142K,A00,188874,Staff,38,0,50,12
1683315483745,POLI 143,A00,188940,Gartzke; Erik,16,0,30,14
1683315484768,POLI 153,A00,188943,Staff,3,0,20,17
1683315485792,POLI 160AA,A00,188944,Staff,12,0,40,28
1683315486825,POLI 170A,A00,188945,Staff,11,0,30,19
1683315488874,PSYC 1,A00,188952,Staff,37,0,90,53
1683315489901,PSYC 2,B00,188953,Staff,19,0,35,16
1683315490925,PSYC 6,A00,188970,Staff,47,0,60,13
1683315491953,PSYC 7,A00,188973,Staff,37,0,45,8
1683315492979,PSYC 60,A01,188980,Rickard; Timothy C.,43,0,60,17
1683315494009,PSYC 70,A01,189001,Steiner; Eric Tomas,24,0,45,21
1683315495041,PSYC 100,A00,189005,Lacefield; Katharine I,0,99,120,120
1683315496065,PSYC 102,A00,189008,Staff,10,0,30,20
1683315497093,PSYC 106,B00,189026,Gorman; Michael R.,36,0,60,24
1683315498120,PSYC 114,B01,189033,Winkielman; Piotr,0,32,30,30
1683315499145,PSYC 131,A00,189036,Anagnostaras; Stephan,0,43,60,60
1683315500170,PSYC 136,A00,189041,Lowe; Angela Beth,0,7,25,25
1683315501194,PSYC 137,A00,189057,Winkielman; Piotr,0,34,25,25
1683315502219,PSYC 144,A00,189107,Wixted; John T,0,7,50,50
1683315504270,PSYC 162,A00,189142,Staff,0,8,85,85
1683315505297,PSYC 172,A00,189144,Gorman; Michael R.,0,7,30,30
1683315507346,PSYC 179,A00,189146,Lacefield; Katharine I,0,84,120,120
1683315508370,PSYC 181,A00,189147,Anagnostaras; Stephan,0,44,90,90
1683315509397,PSYC 190R,A00,189148,Barner; David A.,0,22,80,80
1683315510424,PSYC 191,A00,189275,Rickard; Timothy C.,0,7,25,25
1683315511451,PSYC 193,A00,189276,Chapman; Eddie Nathaniel,0,1,0,4
1683315512479,PSYC 193L,A01,189281,Lowe; Angela Beth,12,0,20,8
1683315512479,PSYC 193L,B01,189285,Staff,28,0,35,7
1683315513503,RELI 149,A00,187137,Rahimi; Babak,7,0,40,33
1683315514530,SE 9,A01,187315,Staff,0,2,18,18
1683315515557,SE 101B,A00,187409,Staff,24,0,30,6
1683315516581,SE 110B,A00,187444,Staff,10,0,40,30
1683315517605,SE 130B,A00,187449,Staff,31,0,40,9
1683315518629,SE 150A,A00,187516,Staff,9,0,20,11
1683315519652,SE 154,A00,187528,Staff,30,0,50,20
1683315520676,SIO 3,A01,258171,Staff,35,0,40,5
1683315521703,SIO 10,A00,187144,Cook; Geoffrey W,0,3,75,75
1683315522727,SIO 45,A00,187152,Cook; Geoffrey W,1,0,100,99
1683315523754,SIO 109R,A00,194486,Staff,0,3,20,20
1683315525810,SIO 187,A01,187233,Kacev; David,12,0,40,28
1683315526835,SOCI 1,A01,258656,Thorpe; Charles Robert,28,0,30,2
1683315526835,SOCI 1,A02,258658,Thorpe; Charles Robert,30,0,30,0
1683315526835,SOCI 1,A03,258661,Thorpe; Charles Robert,25,0,25,0
1683315526835,SOCI 1,A04,258666,Thorpe; Charles Robert,22,0,25,3
1683315526835,SOCI 1,A05,258897,Thorpe; Charles Robert,23,0,25,2
1683315526835,SOCI 1,A06,258898,Thorpe; Charles Robert,25,0,25,0
1683315527863,SOCI 30,A01,258903,Pardo Guerra; Juan Pablo,16,0,30,14
1683315528890,SOCI 102,A00,258904,Staff,9,0,25,16
1683315529916,SOCI 106,A00,258905,Staff,19,0,25,6
1683315530938,SOCI 111,A00,258907,Ribas Norris; Janet Vanesa,26,0,30,4
1683315531963,SOCI 121R,A00,258908,Pardo Guerra; Juan Pablo,11,0,30,19
1683315532986,SOCI 126,A01,203330,Staff,14,0,20,6
1683315534014,SOCI 131,A00,258909,Thorpe; Charles Robert,31,0,60,29
1683315535042,SOCI 135,A00,258910,Payne; Christine Anna,0,9,30,30
1683315536066,SOCI 157,A00,258911,Staff,12,0,30,18
1683315537093,SOCI 184,A00,258912,Staff,25,0,30,5
1683315538116,SOCI 188D,A00,258913,Staff,21,0,30,9
1683315539142,SYN 2,001,187529,Staff,9,0,16,7
1683315539142,SYN 2,002,201452,Staff,0,18,16,16
1683315539142,SYN 2,003,201469,Staff,4,0,16,12
1683315540170,SYN 100,A01,187531,Staff,0,9,20,20
1683315540170,SYN 100,B01,201491,Staff,0,12,20,20
1683315541194,TDAC 1,A00,189286,Walsh; Kim C.,3,0,20,17
1683315541194,TDAC 1,B00,189287,Harting; Carla Kelso,11,0,20,9
1683315542218,TDAC 101,A00,189300,Walsh; Kim C.,16,0,20,4
1683315542218,TDAC 101,B00,189301,Harting; Carla Kelso,18,0,20,2
1683315543247,TDAC 102,A00,189304,Basso; Beatrice,14,0,20,6
1683315544277,TDAC 108,A00,189305,Staff,18,0,20,2
1683315545305,TDDE 131,A00,189310,Staff,19,0,20,1
1683315545305,TDDE 131,B00,189314,Staff,19,0,20,1
1683315545305,TDDE 131,C00,189315,Staff,48,0,50,2
1683315545305,TDDE 131,D00,189316,Staff,14,0,15,1
1683315545305,TDDE 131,E00,204841,Staff,20,0,20,0
1683315546409,TDGE 10,A00,189289,Staff,30,0,50,20
1683315546409,TDGE 10,B00,189290,Havis; Allan,2,0,50,48
1683315547437,TDGE 11,A00,189291,Fulton; Julia,0,3,50,50
1683315547437,TDGE 11,B00,189292,Staff,20,0,25,5
1683315547437,TDGE 11,C00,260270,Staff,0,0,0,0
1683315548464,TDGE 25,A00,189294,Staff,3,0,20,17
1683315549493,TDGE 124,A00,189318,Fulton; Julia,0,8,50,50
1683315550519,TDGE 125,A00,189319,Staff,13,0,25,12
1683315550519,TDGE 125,B00,189320,Staff,23,0,25,2
1683315551546,TDGE 127,A00,189322,Havis; Allan,0,0,50,50
1683315552578,TDHT 101,A00,189323,Staff,18,0,25,7
1683315552578,TDHT 101,B00,189324,Staff,25,0,25,0
1683315553602,TDHT 102,A00,189325,Staff,49,0,50,1
1683315554626,TDMV 1,A00,189295,Arcidiacono; Kristin,20,0,30,10
1683315554626,TDMV 1,B00,189296,Caligagan; Maria T.,24,0,30,6
1683315555653,TDMV 2,A00,189297,Sammartano; Tonnie,28,0,30,2
1683315555653,TDMV 2,B00,189299,Arcidiacono; Kristin,24,0,30,6
1683315556680,TDMV 3,A00,204998,Rincon; Alicia,22,0,30,8
1683315557704,TDMV 120,A00,189458,Sammartano; Tonnie,28,0,30,2
1683315558727,TDMV 138,A00,189541,Jun; Grace Shin Hae,22,0,40,18
1683315559752,TDMV 142,A00,189717,Caligagan; Tony,23,0,30,7
1683315559752,TDMV 142,B00,189718,Caligagan; Maria T.,25,0,30,5
1683315560780,TMC 2,A01,187533,Staff,25,0,25,0
1683315560780,TMC 2,A02,187534,Staff,25,0,25,0
1683315561807,USP 1,A01,187536,Kwak; Nancy,0,16,25,25
1683315562831,USP 5,A01,187538,Staff,9,0,25,16
1683315563855,USP 101,A00,199253,Staff,0,4,0,0
1683315564882,USP 124,A00,187562,Boomhower; Matthew Charles,1,0,30,29
1683315565905,USP 138,A00,187582,Staff,20,0,25,5
1683315566931,USP 152,A01,187597,Staff,4,0,25,21
1683315567954,USP 153,A00,187598,Staff,19,0,25,6
1683315568978,USP 168,A00,187607,Kwak; Nancy,2,0,5,3
1683315570005,USP 173,A00,187619,Staff,4,0,25,21
1683315571028,USP 181,A00,187638,Staff,0,0,25,25
1683315572051,VIS 103,A00,187650,Cruz; Edwin Teddy,23,0,75,52
1683315573075,VIS 110D,A00,187669,Staff,12,0,22,10
1683315574101,VIS 127C,A00,187720,Shen; Kuiyi,68,0,146,78
1683315575129,VIS 149,A00,187731,Yoldas; Pinar,0,14,22,22
1683315576154,VIS 151,A01,188091,Staff,22,0,34,12
1683315576154,VIS 151,A02,188092,Staff,11,0,34,23
1683315577177,VIS 160B,A00,188093,Stalbaum; Brett,0,0,10,10
1683315579232,WCWP 10B,A00,201720,Staff,10,0,15,5
1683315579232,WCWP 10B,B00,201722,Staff,8,0,15,7
1683315580256,WCWP 100,A00,201725,Gagnon; Jeffrey C,0,0,2,2
1683315580256,WCWP 100,B00,201727,Staff,0,4,15,15
1683315583349,ANBI 133,A00,258401,Wilder; Linnea Lorene,34,0,40,6
1683315584373,ANBI 140,A00,258395,Hrvoj Mihic; Branka,18,0,25,7
1683315585397,ANSC 120,A00,258402,Bialecki; Jon Anthony,27,0,40,13
1683315586420,ANSC 144,A00,258400,Staff,14,0,40,26
1683315588468,ANSC 166,A00,258396,Parish; Steven Martin,157,0,175,18
1683315589493,ANSC 180,A00,193533,Staff,9,0,20,11
1683315590517,ANSC 188,A00,258397,Jassal; Aftab,33,0,40,7
1683315591542,ANTH 3,A01,258316,Staff,23,0,30,7
1683315592566,ANTH 5,A00,258394,Semendeferi; Ekaterini,16,0,20,4
1683315593594,ANTH 21,A01,258331,Staff,9,0,40,31
1683315594618,ANTH 103,A00,258398,Varma; Saiba,15,0,25,10
1683315595649,AWP 10,001,202034,Staff,0,0,0,0
1683315595649,AWP 10,002,202035,Staff,0,0,0,0
1683315595649,AWP 10,003,202036,Staff,0,0,0,0
1683315595649,AWP 10,004,202037,Staff,0,0,0,0
1683315595649,AWP 10,005,202038,Staff,0,0,0,0
1683315595649,AWP 10,006,202039,Staff,0,0,0,0
1683315595649,AWP 10,007,202040,Staff,0,0,0,0
1683315595649,AWP 10,008,202041,Staff,0,0,0,0
1683315595649,AWP 10,009,202042,Staff,0,0,0,0
1683315595649,AWP 10,010,202043,Staff,0,0,0,0
1683315595649,AWP 10,011,202044,Staff,0,0,0,0
1683315595649,AWP 10,012,202045,Staff,0,0,0,0
1683315595649,AWP 10,013,202046,Staff,0,0,0,0
1683315595649,AWP 10,014,202047,Staff,0,0,0,0
1683315595649,AWP 10,015,202048,Staff,0,0,0,0
1683315595649,AWP 10,016,202049,Staff,0,0,0,0
1683315595649,AWP 10,017,202050,Staff,0,0,0,0
1683315595649,AWP 10,018,202051,Staff,0,0,0,0
1683315595649,AWP 10,019,202052,Staff,0,0,0,0
1683315595649,AWP 10,020,202053,Staff,0,0,0,0
1683315595649,AWP 10,021,202054,Staff,0,0,0,0
1683315595649,AWP 10,022,202055,Staff,0,0,0,0
1683315595649,AWP 10,023,202056,Staff,0,0,0,0
1683315595649,AWP 10,024,202057,Staff,0,0,0,0
1683315595649,AWP 10,025,202058,Staff,0,0,0,0
1683315595649,AWP 10,026,202059,Staff,0,0,0,0
1683315596676,AWP 102,001,202032,Staff,0,0,0,0
1683315596676,AWP 102,002,202033,Staff,0,0,0,0
1683315597699,BENG 100,A01,254234,Taylor Amos; Alyssa C,31,0,40,9
1683315598723,BENG 196,001,270013,Engler; Adam J.,9999,0,9999,0
1683315599754,BICD 100R,A01,202018,Smith; Laurie,0,7,32,32
1683315599754,BICD 100R,A02,202019,Smith; Laurie,0,2,32,32
1683315599754,BICD 100R,A03,202020,Smith; Laurie,0,1,32,32
1683315599754,BICD 100R,A04,202021,Smith; Laurie,8,0,32,24
1683315599754,BICD 100R,A05,202022,Smith; Laurie,12,0,32,20
1683315600779,BICD 136,A01,193242,Gustafson-Brown; Cindy,0,2,32,32
1683315600779,BICD 136,A02,193244,Gustafson-Brown; Cindy,15,0,32,17
1683315601803,BIEB 102,A01,193249,Butler; Shannon Rhey,0,2,32,32
1683315601803,BIEB 102,A02,193251,Butler; Shannon Rhey,0,0,32,32
1683315601803,BIEB 102,A03,193253,Butler; Shannon Rhey,0,1,32,32
1683315601803,BIEB 102,A04,193255,Butler; Shannon Rhey,17,0,32,15
1683315601803,BIEB 102,A05,193265,Butler; Shannon Rhey,26,0,32,6
1683315601803,BIEB 102,A06,193269,Butler; Shannon Rhey,16,0,32,16
1683315603859,BIEB 150,A01,193274,Staff,0,0,32,32
1683315603859,BIEB 150,A02,193285,Staff,23,0,32,9
1683315604888,BIEB 194,A00,193286,Kurle; Carolyn M.,22,0,32,10
1683315605913,BILD 1,A01,192291,Staff,16,0,32,16
1683315605913,BILD 1,A02,192292,Staff,30,0,32,2
1683315605913,BILD 1,B01,192520,Reuther; Keefe,0,1,0,0
1683315605913,BILD 1,B02,192532,Reuther; Keefe,0,1,0,0
1683315606944,BILD 3,A01,192556,Butler; Shannon Rhey,0,0,32,32
1683315606944,BILD 3,A02,192581,Butler; Shannon Rhey,5,0,32,27
1683315606944,BILD 3,A03,192611,Butler; Shannon Rhey,23,0,32,9
1683315606944,BILD 3,A04,192612,Butler; Shannon Rhey,25,0,32,7
1683315606944,BILD 3,A05,192613,Butler; Shannon Rhey,27,0,32,5
1683315606944,BILD 3,A06,192679,Butler; Shannon Rhey,27,0,32,5
1683315606944,BILD 3,A07,192682,Butler; Shannon Rhey,22,0,32,10
1683315607969,BILD 4,A01,192836,Reuther; Keefe,1,0,24,23
1683315607969,BILD 4,A02,193044,Reuther; Keefe,4,0,24,20
1683315608997,BILD 10,A01,193142,Gustafson-Brown; Cindy,31,0,32,1
1683315608997,BILD 10,A02,193149,Gustafson-Brown; Cindy,31,0,32,1
1683315610021,BIMM 100,A01,193301,Staff,0,6,32,32
1683315610021,BIMM 100,A02,193312,Staff,0,5,32,32
1683315610021,BIMM 100,A03,193323,Staff,0,8,32,32
1683315611050,BIMM 101,A01,193329,McDonnell; Lisa Marie,0,3,24,24
1683315611050,BIMM 101,A02,193339,McDonnell; Lisa Marie,0,2,24,24
1683315611050,BIMM 101,B01,193354,McDonnell; Lisa Marie,0,3,24,24
1683315611050,BIMM 101,B02,193357,McDonnell; Lisa Marie,0,3,24,24
1683315612077,BIMM 110,A01,193377,Tat; John,0,11,32,32
1683315612077,BIMM 110,A02,193378,Tat; John,1,9,32,31
1683315613104,BIMM 120,A01,206116,Staff,0,0,32,32
1683315613104,BIMM 120,A02,206117,Staff,8,0,32,24
1683315613104,BIMM 120,A03,206121,Staff,21,0,32,11
1683315614128,BIPN 100,A01,193393,Park; Ji Young,0,14,32,32
1683315614128,BIPN 100,A02,193402,Park; Ji Young,0,12,32,32
1683315614128,BIPN 100,A03,193413,Park; Ji Young,0,14,32,32
1683315614128,BIPN 100,A04,193414,Park; Ji Young,0,13,32,32
1683315615156,BIPN 102,A01,193429,Staff,0,0,32,32
1683315615156,BIPN 102,A02,193438,Staff,22,0,32,10
1683315616180,BIPN 106,A01,193450,Reyes Gonzalez; Catalina,0,2,40,40
1683315617204,BIPN 134,A01,193465,Cooke; James Edward,0,0,32,32
1683315617204,BIPN 134,A02,193474,Cooke; James Edward,27,0,32,5
1683315617204,BIPN 134,A03,193485,Cooke; James Edward,29,0,32,3
1683315617204,BIPN 134,A04,193486,Cooke; James Edward,21,0,32,11
1683315617204,BIPN 134,A05,193491,Cooke; James Edward,31,0,32,1
1683315617204,BIPN 134,A06,193501,Cooke; James Edward,30,0,32,2
1683315617204,BIPN 134,A07,193510,Cooke; James Edward,29,0,32,3
1683315619324,BISP 194,A00,222522,Staff,16,0,32,16
1683315620348,CAT 124,A01,202407,Staff,20,0,25,5
1683315621374,CAT 125,A00,202408,Marchisotto; Jennifer Anne,4,0,20,16
1683315622402,CAT 125R,A00,202409,Smith; Lauryn Alissa,0,11,20,20
1683315622402,CAT 125R,B00,202410,Morales; Celeste Georgianna,0,11,20,20
1683315622402,CAT 125R,C00,202411,Irwin; Matthew Joseph,0,10,20,20
1683315623427,CENG 15,A01,204712,Yang; Kesong,0,1,0,0
1683315624453,CENG 114,A00,202070,Jahed Motlagh; Zeinab,5,0,20,15
1683315625477,CGS 105,A00,185477,Wesling; Megan E.,24,0,40,16
1683315626504,CGS 106,A00,185494,Staff,13,0,22,9
1683315627531,CGS 108,A00,185495,Staff,14,0,20,6
1683315628555,CGS 114,A00,185496,Staff,13,0,18,5
1683315629582,CGS 119,A00,185501,Staff,15,0,20,5
1683315630606,CGS 120,A00,185511,Staff,13,0,20,7
1683315631632,CHEM 4,A01,184675,Bussey; Thomas J,96,0,100,4
1683315632659,CHEM 6A,A01,184677,Staff,35,0,60,25
1683315633683,CHEM 6B,A01,184679,Staff,65,0,100,35
1683315634706,CHEM 6C,A01,184681,Bussey; Thomas J,1,0,50,49
1683315634706,CHEM 6C,A02,184682,Bussey; Thomas J,34,0,50,16
1683315635732,CHEM 40A,A01,184684,Albizati; Kim F.,37,0,100,63
1683315636759,CHEM 40B,A01,184686,Albizati; Kim F.,0,20,100,100
1683315637787,CHEM 41B,A01,184690,Staff,52,0,100,48
1683315638815,COGS 3,A01,184715,Boyle; Mary E. T.,0,25,40,40
1683315639839,COGS 14B,A01,185172,Staff,0,15,38,38
1683315640862,COGS 18,A01,184736,Staff,18,0,80,62
1683315641885,COGS 100,A01,184932,Staff,0,5,73,73
1683315642909,COGS 101A,A01,184935,Staff,0,38,30,30
1683315643933,COGS 101B,A01,184944,Staff,0,2,30,30
1683315644960,COGS 101C,A01,184946,Staff,0,12,30,30
1683315645984,COGS 102A,A01,184951,Johnson; Christine M.,2,0,40,38
1683315647007,COGS 107B,A01,184953,Mooshagian; Eric Frederick,0,50,40,40
1683315648034,COGS 118B,A01,184959,Gupta; Anjum,0,48,40,40
1683315649058,COGS 153,A00,184961,Staff,0,15,30,30
1683315650137,COGS 177,A00,184962,Staff,0,21,30,30
1683315651161,COGS 187A,A01,184969,Boyle; Mary E. T.,0,17,40,40
1683315652185,COMM 10,A01,185174,Staff,0,5,25,25
1683315652185,COMM 10,A02,185189,Staff,0,5,25,25
1683315652185,COMM 10,A03,269821,Staff,0,0,0,0
1683315653209,COMM 100B,A01,185475,Staff,0,0,0,2
1683315653209,COMM 100B,A02,185476,Staff,14,0,25,11
1683315654236,COMM 100C,A01,185314,Staff,1,0,25,24
1683315654236,COMM 100C,A02,185327,Staff,19,0,25,6
1683315655262,COMM 110M,A00,185349,Staff,2,0,40,38
1683315656289,COMM 113T,A00,185352,Staff,25,0,40,15
1683315657314,COMM 114I,A00,185353,Staff,33,0,40,7
1683315658342,COMM 131,A00,185354,Staff,19,0,30,11
1683315659371,CSE 8A,A50,185358,Cao; Yingjun,0,46,10,10
1683315660401,CSE 8B,A01,185362,Staff,1,47,50,49
1683315661429,CSE 11,A01,185416,Cao; Yingjun,0,92,10,10
1683315662455,CSE 20,A01,185445,Briones; Jor-el Thomas Caparas,5,0,25,20
1683315663479,CSE 21,A01,185447,Staff,10,0,50,40
1683315664506,CSE 101,A01,185451,Staff,0,12,50,50
1683315664506,CSE 101,B01,185453,Jones; Miles E,0,11,50,50
1683315666562,CSE 141,A01,185458,Eldon; John,20,0,100,80
1683315667586,CSE 141L,A01,185461,Eldon; John,12,0,100,88
1683315668616,CSE 142,A01,185463,Staff,36,0,60,24
1683315668616,CSE 142,B01,201355,Staff,0,7,60,60
1683315669641,CSE 142L,A01,185470,Staff,36,0,60,24
1683315669641,CSE 142L,B01,201417,Staff,0,6,60,60
1683315670666,CSE 190,A00,201433,Staff,32,0,49,17
1683315671704,DOC 1,A01,259136,Strom; Megan C.,7,0,15,8
1683315671704,DOC 1,A02,259137,Strom; Megan C.,14,0,15,1
1683315671704,DOC 1,A03,259138,Strom; Megan C.,14,0,15,1
1683315671704,DOC 1,A04,259139,Strom; Megan C.,14,0,15,1
1683315672729,DOC 100D,A00,259140,Pass; Natalye Joann,17,0,25,8
1683315673757,DSGN 1,A01,184749,Rill; Bryan,0,25,30,30
1683315674781,DSGN 100,A01,185168,Staff,0,2,25,25
1683315675811,ECE 5,A01,185626,Morris; Karcher William,0,10,0,0
1683315676834,ECE 101,A01,185628,Staff,17,0,70,53
1683315677859,ECE 107,A01,185635,Baghdadchi; Saharnaz,0,0,20,20
1683315677859,ECE 107,A02,185638,Baghdadchi; Saharnaz,4,0,20,16
1683315678886,ECE 148,A01,185647,Silberman; Jack,0,0,16,16
1683315679911,ECON 1,A01,185537,Crane; Meredith Helen,54,0,70,16
1683315680943,ECON 3,A01,185549,Crane; Meredith Helen,33,0,70,37
1683315681970,ECON 4,A01,203354,Anderson; John Charles,0,4,10,10
1683315682994,ECON 100A,A01,185574,Staff,0,4,40,40
1683315684021,ECON 100B,A01,185576,Staff,0,22,40,40
1683315685045,ECON 100C,A01,185589,Newhouse; Herbert S,30,0,70,40
1683315686073,ECON 105,A00,185608,Vespa; Emanuel Ignacio,19,0,35,16
1683315687101,ECON 109,A01,185610,Shishkin; Denis,10,0,35,25
1683315688124,ECON 110A,A01,185612,Staff,11,0,40,29
1683315689151,ECON 120A,A01,185615,Staff,20,0,40,20
1683315690175,ECON 120C,A01,185617,Sun; Yixiao,0,20,70,70
1683315691197,ECON 144,A00,203346,Squires; Dale E,3,0,35,32
1683315692222,ECON 171,A01,203349,Newhouse; Herbert S,0,1,35,35
1683315693249,ECON 173A,A01,185621,Toda; Alexis Akira,21,0,35,14
1683315694278,EDS 25,A01,202413,Staff,0,1,0,0
1683315694278,EDS 25,A02,202414,Staff,0,1,0,0
1683315694278,EDS 25,A03,202415,Staff,0,0,0,0
1683315694278,EDS 25,A04,202416,Staff,0,1,0,0
1683315694278,EDS 25,A05,202439,Staff,0,0,0,0
1683315694278,EDS 25,A06,202440,Staff,0,0,0,0
1683315694278,EDS 25,B01,202631,Staff,0,0,0,0
1683315694278,EDS 25,B02,202632,Staff,0,0,0,0
1683315694278,EDS 25,B03,202639,Staff,0,0,0,0
1683315694278,EDS 25,B04,202640,Staff,0,0,0,0
1683315694278,EDS 25,B05,202643,Staff,0,0,0,0
1683315694278,EDS 25,B06,202644,Staff,0,0,0,0
1683315695302,EDS 38,A01,202659,Black; Alison Michelle,24,0,25,1
1683315696325,EDS 115,A00,202652,Staff,17,0,30,13
1683315697350,EDS 125,A00,202649,Staff,14,0,30,16
1683315698375,EDS 126,A01,203332,Staff,30,0,30,0
1683315699402,EDS 139,A00,202838,Staff,16,0,25,9
1683315700429,EDS 146,A01,202655,Staff,14,0,25,11
1683315701455,ENG 15,A00,185667,Staff,0,1,0,0
1683315701455,ENG 15,B00,185672,Staff,0,0,0,0
1683315701455,ENG 15,C00,185675,Staff,0,0,0,0
1683315701455,ENG 15,D00,185682,Staff,0,0,0,0
1683315701455,ENG 15,E00,185684,Staff,0,0,0,0
1683315702479,ETHN 103,A00,185710,Staff,0,3,35,35
1683315703503,ETHN 103A,A00,199228,Man; Simeon S,2,0,9,7
1683315704531,ETHN 109,A00,185711,Staff,18,0,35,17
1683315705555,ETHN 142,A00,185726,Staff,0,4,30,30
1683315706578,ETHN 163J,A00,199229,Man; Simeon S,5,0,8,3
1683315707606,ETHN 168,A00,185727,Staff,8,0,10,2
1683315708629,ETHN 182,A00,185728,Staff,1,0,35,34
1683315709661,ETHN 183,A00,185737,Staff,8,0,18,10
1683315710686,GLBH 111,A01,209361,Burgos; Jose L.,0,0,0,0
1683315712735,HIEU 104,A00,185792,Staff,16,0,20,4
1683315713764,HIEU 115,A00,185800,Staff,1,0,20,19
1683315714790,HIEU 128,A00,185801,Staff,0,7,20,20
1683315715818,HIEU 147,A00,185802,Staff,16,0,20,4
1683315716843,HIEU 154,A00,185823,Staff,12,0,20,8
1683315717867,HILA 102,A00,185826,Staff,13,0,20,7
1683315718893,HILD 2C,A01,185778,Staff,0,12,20,20
1683315719916,HILD 7B,A01,185780,Kwak; Nancy,0,15,32,32
1683315719916,HILD 7B,A02,185781,Kwak; Nancy,0,18,32,32
1683315720945,HILD 30,A01,185791,Staff,14,0,20,6
1683315721970,HISC 119,A00,185830,Golan; Tal,0,9,20,20
1683315722993,HITO 156GS,A00,185831,Patterson; Patrick H.,0,0,0,23
1683315724019,HIUS 103,A00,185832,Man; Simeon S,0,6,20,20
1683315725043,HIUS 117,A00,185836,Kwak; Nancy,2,0,20,18
1683315726068,HIUS 125,A00,185840,Man; Simeon S,0,0,23,23
1683315727095,HIUS 149,A00,185845,Staff,0,0,20,20
1683315728121,HUM 3,A01,185882,Zavodny; Tatiana Sophia,0,6,50,50
1683315728121,HUM 3,B01,185899,Caldwell; Michael Alan,0,19,50,50
1683315729146,HUM 3GS,A00,185900,Patterson; Patrick H.,0,0,0,23
1683315730176,HUM 4,A01,185938,Zroka; Amy Liane,31,0,50,19
1683315730176,HUM 4,B01,185956,Watkins; Eric,0,2,50,50
1683315730176,HUM 4,B02,202209,Watkins; Eric,0,2,50,50
1683315730176,HUM 4,B03,202210,Watkins; Eric,0,0,50,50
1683315731204,HUM 5,A01,185958,West; Geoffrey Scott,4,0,50,46
1683315731204,HUM 5,A02,202215,West; Geoffrey Scott,0,0,50,50
1683315732239,INTL 190,A00,185959,Gagnon; Jeffrey C,0,0,0,9
1683315732239,INTL 190,B00,185960,Lettieri; Michael Joseph,0,0,0,1
1683315733262,JAPN 180,A00,254509,Staff,5,1,30,25
1683315734293,LATI 10,A01,202853,Kennemore; Amy Michelle,5,0,35,30
1683315734293,LATI 10,A02,202854,Kennemore; Amy Michelle,1,0,35,34
1683315734293,LATI 10,A03,270054,Kennemore; Amy Michelle,30,0,30,0
1683315735319,LATI 180,A00,202855,Kennemore; Amy Michelle,11,0,20,9
1683315736347,LAWS 101,A00,201767,Golan; Tal,0,7,40,40
1683315737373,LIFR 1C,A00,185961,Staff,6,0,20,14
1683315738399,LIFR 1CX,A00,185962,Staff,7,0,20,13
1683315739422,LIFR 1D,A00,185963,Staff,9,0,20,11
1683315740449,LIFR 1DX,A00,185964,Staff,9,0,20,11
1683315741475,LIGN 101,A01,186039,Staff,43,0,50,7
1683315742502,LIGN 165,A00,186040,Staff,18,0,50,32
1683315743527,LTCS 108,A00,186041,Staff,6,0,10,4
1683315744554,LTCS 119,A00,186042,Staff,16,0,20,4
1683315745582,LTCS 130,A00,186043,Wesling; Megan E.,15,0,25,10
1683315747633,LTEA 138,A00,186119,Staff,14,0,40,26
1683315748657,LTEN 124,A00,186148,Staff,6,0,25,19
1683315749682,LTEN 178,A00,186149,Staff,7,0,15,8
1683315750706,LTEN 181,A00,186150,Blanco; John D,33,0,40,7
1683315751731,LTWL 120,A00,186160,Staff,20,0,25,5
1683315752759,LTWL 165,A00,186161,Staff,22,0,25,3
1683315753849,LTWR 100,A00,186162,Staff,0,4,15,15
1683315754873,LTWR 102,A00,186163,Doller; Ben,5,0,15,10
1683315755901,MAE 8,A01,186412,Staff,0,0,0,0
1683315756928,MAE 30B,A00,186445,Bahadori; Mohammad Yousef,83,0,100,17
1683315757952,MAE 40,A00,186592,Bewley; Thomas R,9,0,50,41
1683315758979,MAE 101B,A00,186593,Bahadori; Mohammad Yousef,81,0,100,19
1683315760004,MAE 105,A00,186594,Bandaru; Prabhakar,12,0,50,38
1683315761028,MAE 107,A00,186599,Pham; Hieu Tan,0,6,120,120
1683315762051,MAE 148,A01,186660,Silberman; Jack,3,0,16,13
1683315763078,MATH 10A,A01,188095,Staff,0,6,35,35
1683315764100,MATH 10B,A01,188097,Bowers; Adam R.,0,11,30,30
1683315764100,MATH 10B,A02,188099,Bowers; Adam R.,0,11,30,30
1683315764100,MATH 10B,B01,188104,Bowers; Adam R.,0,10,30,30
1683315764100,MATH 10B,B02,188106,Bowers; Adam R.,0,10,30,30
1683315765127,MATH 10C,A01,188111,Staff,0,18,30,30
1683315765127,MATH 10C,A02,188127,Staff,0,17,30,30
1683315765127,MATH 10C,A03,188131,Staff,0,18,30,30
1683315765127,MATH 10C,B01,188218,Staff,20,0,30,10
1683315765127,MATH 10C,B02,188244,Staff,13,0,30,17
1683315765127,MATH 10C,B03,188277,Staff,16,0,30,14
1683315766156,MATH 18,A01,188344,Bach; Quang Tran,18,0,30,12
1683315766156,MATH 18,A02,188345,Bach; Quang Tran,11,0,30,19
1683315766156,MATH 18,B01,188353,Bach; Quang Tran,10,0,30,20
1683315766156,MATH 18,B02,188354,Bach; Quang Tran,20,0,30,10
1683315767180,MATH 20A,A01,188374,Staff,13,0,35,22
1683315768210,MATH 20B,A01,188382,Ohm; Ko Woon,6,0,30,24
1683315768210,MATH 20B,A02,188383,Ohm; Ko Woon,23,0,30,7
1683315768210,MATH 20B,B01,188385,Ohm; Ko Woon,7,0,30,23
1683315768210,MATH 20B,B02,188392,Ohm; Ko Woon,22,0,30,8
1683315769233,MATH 20C,A01,188394,Harel; Guershon,10,0,30,20
1683315769233,MATH 20C,A02,188395,Harel; Guershon,14,0,30,16
1683315769233,MATH 20C,B01,188404,Harel; Guershon,5,0,30,25
1683315769233,MATH 20C,B02,188405,Harel; Guershon,19,0,30,11
1683315770258,MATH 20D,A01,188414,Hammock; Frances H,0,1,30,30
1683315770258,MATH 20D,A02,188415,Hammock; Frances H,3,0,30,27
1683315770258,MATH 20D,B01,188447,Hammock; Frances H,2,0,30,28
1683315770258,MATH 20D,B02,188486,Hammock; Frances H,8,0,30,22
1683315771287,MATH 20E,A01,188649,Staff,21,0,30,9
1683315771287,MATH 20E,A02,188650,Staff,23,0,30,7
1683315771287,MATH 20E,A03,188673,Staff,0,0,30,30
1683315772311,MATH 102,A01,188675,Staff,0,35,35,35
1683315773337,MATH 103B,A01,188681,Staff,4,0,35,31
1683315773337,MATH 103B,B01,188692,Staff,5,0,35,30
1683315774365,MATH 109,A01,188695,Salehi Golsefidy; Alireza,25,0,35,10
1683315774365,MATH 109,A02,188696,Salehi Golsefidy; Alireza,26,0,35,9
1683315775393,MATH 120A,A01,188698,Eggers; John Dietrich,7,0,35,28
1683315776418,MATH 142B,A01,188736,Ioana; Adrian,0,2,30,30
1683315776418,MATH 142B,A02,188741,Ioana; Adrian,0,1,30,30
1683315776418,MATH 142B,A03,188743,Ioana; Adrian,1,3,30,29
1683315777441,MATH 168A,A01,188790,Staff,0,9,35,35
1683315778466,MATH 170A,A01,188803,Nie; Jiawang,0,2,35,35
1683315778466,MATH 170A,A02,188811,Nie; Jiawang,0,0,35,35
1683315778466,MATH 170A,A03,188814,Nie; Jiawang,0,0,35,35
1683315778466,MATH 170A,A04,188815,Nie; Jiawang,13,0,35,22
1683315779489,MATH 193B,A01,188817,Staff,0,0,35,35
1683315779489,MATH 193B,A02,188818,Staff,6,0,35,29
1683315780513,MGT 4,A01,202857,Anderson; John Charles,62,0,80,18
1683315781537,MGT 12,A00,202858,Lindenberger; Wade Douglas,43,0,90,47
1683315782563,MGT 18,A00,202859,Staff,74,0,90,16
1683315783591,MGT 18GS,A00,202860,McKay; Michael J,13,0,28,15
1683315784619,MGT 45,A00,202861,Pecore; Joseph P.,13,0,90,77
1683315785643,MGT 100,A00,202863,Yavorsky; Daniel Ryan,28,0,90,62
1683315786670,MGT 103,A00,202864,Ehrich; Kristine R,0,16,90,90
1683315787694,MGT 112,A00,202865,Ehrich; Kristine R,15,0,90,75
1683315788719,MGT 121A,A00,202868,Staff,0,19,0,0
1683315789744,MGT 131B,A00,202869,Anderson; John Charles,59,0,90,31
1683315790769,MGT 136,A00,202871,Lindenberger; Wade Douglas,84,0,90,6
1683315791794,MGT 164,A00,202873,Staff,0,68,90,90
1683315792822,MGT 164GS,A00,202874,McKay; Mary A,13,0,28,15
1683315793846,MGT 180,A00,202875,Staff,0,50,90,90
1683315794870,MMW 11R,A01,205019,Herbst; Matthew,3,0,30,27
1683315794870,MMW 11R,A02,205026,Herbst; Matthew,29,0,30,1
1683315795897,MMW 15,A01,193512,Chang; Edmond Yi-Teh,0,9,28,28
1683315795897,MMW 15,A02,193513,Chang; Edmond Yi-Teh,0,5,28,28
1683315795897,MMW 15,A03,193514,Chang; Edmond Yi-Teh,0,5,28,28
1683315795897,MMW 15,A04,193515,Chang; Edmond Yi-Teh,0,5,28,28
1683315795897,MMW 15,A05,193516,Chang; Edmond Yi-Teh,0,4,28,28
1683315795897,MMW 15,A06,193517,Chang; Edmond Yi-Teh,0,5,28,28
1683315795897,MMW 15,B01,193519,Chang; Edmond Yi-Teh,0,4,28,28
1683315795897,MMW 15,B02,193520,Chang; Edmond Yi-Teh,0,5,28,28
1683315795897,MMW 15,B03,193521,Chang; Edmond Yi-Teh,0,4,28,28
1683315795897,MMW 15,B04,193522,Chang; Edmond Yi-Teh,0,4,28,28
1683315795897,MMW 15,B05,193523,Chang; Edmond Yi-Teh,0,5,28,28
1683315795897,MMW 15,B06,193524,Chang; Edmond Yi-Teh,0,4,28,28
1683315796924,MMW 122,A01,193526,Rahimi; Babak,0,14,28,28
1683315796924,MMW 122,A02,193527,Rahimi; Babak,0,14,28,28
1683315796924,MMW 122,A03,193528,Rahimi; Babak,0,0,0,0
1683315796924,MMW 122,A04,193529,Rahimi; Babak,0,0,0,0
1683315797949,MUS 1A,A01,186663,Staff,0,20,35,35
1683315798977,MUS 4,A01,186715,Staff,0,12,35,35
1683315800003,MUS 5R,A01,186796,Dubnov; Shlomo,0,17,35,35
1683315801031,MUS 6,A01,186798,Staff,0,3,25,25
1683315802058,MUS 7,A01,186830,Staff,12,0,35,23
1683315803083,MUS 8,A01,186930,Staff,0,26,35,35
1683315804107,MUS 15,A01,186932,Staff,0,15,35,35
1683315804107,MUS 15,B01,186934,Staff,0,15,35,35
1683315805131,MUS 80,A00,186935,Staff,2,0,20,18
1683315805131,MUS 80,B00,186936,Staff,25,0,25,0
1683315806154,NANO 11,A00,204702,Lipomi; Darren John,0,0,0,0
1683315807183,NANO 15,A01,204709,Yang; Kesong,0,1,0,0
1683315808205,NANO 114,A00,202069,Jahed Motlagh; Zeinab,3,0,10,7
1683315809232,PHIL 1,A00,186955,Grush; Rick Scott,32,0,40,8
1683315810256,PHIL 10,A01,186973,Grush; Rick Scott,28,0,35,7
1683315810256,PHIL 10,A02,186974,Grush; Rick Scott,33,0,35,2
1683315811283,PHIL 13,A01,186976,Staff,7,0,35,28
1683315811283,PHIL 13,A02,186977,Staff,16,0,35,19
1683315812307,PHIL 14,A01,186979,Staff,31,0,35,4
1683315812307,PHIL 14,A02,186986,Staff,32,0,35,3
1683315813334,PHIL 28,A01,186988,Staff,16,0,30,14
1683315813334,PHIL 28,A02,186989,Staff,1,0,30,29
1683315813334,PHIL 28,A03,186990,Staff,9,0,30,21
1683315813334,PHIL 28,A04,186991,Staff,26,0,30,4
1683315814361,PHIL 120,A00,186997,Staff,23,0,40,17
1683315815384,PHIL 137,A00,187003,Staff,9,0,40,31
1683315816409,PHIL 150,A00,187015,Staff,47,0,70,23
1683315817433,PHIL 167,A00,187021,Lamey; Andy M.,35,0,40,5
1683315818457,PHIL 174,A01,202226,Staff,17,0,20,3
1683315818457,PHIL 174,A02,202235,Staff,20,0,20,0
1683315819481,PHIL 191A,A00,258918,Staff,0,0,1,1
1683315820504,PHYS 1A,A00,187028,Staff,27,0,60,33
1683315821529,PHYS 1AL,001,187036,Staff,3,0,30,27
1683315821529,PHYS 1AL,002,187049,Staff,18,0,30,12
1683315822556,PHYS 1B,A00,187058,Staff,22,0,60,38
1683315823580,PHYS 1BL,001,187064,Staff,0,0,30,30
1683315823580,PHYS 1BL,002,187070,Staff,5,0,30,25
1683315824607,PHYS 1C,A00,187082,Staff,31,0,120,89
1683315825634,PHYS 1CL,001,187088,Staff,0,9,30,30
1683315825634,PHYS 1CL,002,187089,Staff,0,2,30,30
1683315825634,PHYS 1CL,009,262693,Staff,11,0,30,19
1683315826661,PHYS 2B,A01,187097,Staff,54,0,115,61
1683315827687,PHYS 2C,A01,187099,Staff,67,0,115,48
1683315828711,PHYS 2CL,A01,187101,Staff,5,0,28,23
1683315828711,PHYS 2CL,A02,187102,Staff,15,0,28,13
1683315829738,PHYS 2D,A01,187123,Shotwell; Brian,95,0,115,20
1683315830766,PHYS 4B,A01,187133,Grinstein; Benjamin,35,0,50,15
1683315831790,POLI 10,A00,188819,Staff,0,4,50,50
1683315832815,POLI 11,A00,188827,Staff,43,0,50,7
1683315833840,POLI 13R,A00,188828,Staff,0,1,20,20
1683315834868,POLI 27,A01,188830,Elgin; Samuel Zincke,0,1,70,70
1683315835895,POLI 30,A00,188832,Desposato; Scott,32,0,50,18
1683315836919,POLI 102F,A00,188834,Staff,3,0,40,37
1683315837943,POLI 104A,A00,188852,Staff,14,0,30,16
1683315838966,POLI 104I,A00,188853,Staff,0,6,20,20
1683315839990,POLI 110B,A00,188854,Wiens; David,7,0,20,13
1683315841019,POLI 112A,A00,188855,Wiens; David,5,0,30,25
1683315842042,POLI 117R,A00,188856,Forman; Fonna,0,11,20,20
1683315843068,POLI 118,A00,188857,Ingham; Sean,8,0,20,12
1683315844092,POLI 120G,A00,188858,Staff,9,0,30,21
1683315845123,POLI 131CR,A00,188863,Hoston; Germaine,24,0,50,26
1683315846151,POLI 133,A00,188864,Nellis; Gareth Hb,44,0,50,6
1683315847175,POLI 134D,A00,188865,Desposato; Scott,27,0,30,3
1683315848199,POLI 142A,A00,188871,Gartzke; Erik,22,0,50,28
1683315849226,POLI 142K,A00,188874,Staff,38,0,50,12
1683315850253,POLI 143,A00,188940,Gartzke; Erik,16,0,30,14
1683315851289,POLI 153,A00,188943,Staff,3,0,20,17
1683315852312,POLI 160AA,A00,188944,Staff,12,0,40,28
1683315853336,POLI 170A,A00,188945,Staff,11,0,30,19
1683315855388,PSYC 1,A00,188952,Staff,37,0,90,53
1683315856410,PSYC 2,B00,188953,Staff,19,0,35,16
1683315857490,PSYC 6,A00,188970,Staff,47,0,60,13
1683315858516,PSYC 7,A00,188973,Staff,37,0,45,8
1683315859543,PSYC 60,A01,188980,Rickard; Timothy C.,43,0,60,17
1683315860569,PSYC 70,A01,189001,Steiner; Eric Tomas,24,0,45,21
1683315861595,PSYC 100,A00,189005,Lacefield; Katharine I,0,99,120,120
1683315862620,PSYC 102,A00,189008,Staff,10,0,30,20
1683315863650,PSYC 106,B00,189026,Gorman; Michael R.,36,0,60,24
1683315864674,PSYC 114,B01,189033,Winkielman; Piotr,0,32,30,30
1683315865704,PSYC 131,A00,189036,Anagnostaras; Stephan,0,43,60,60
1683315866730,PSYC 136,A00,189041,Lowe; Angela Beth,0,7,25,25
1683315867759,PSYC 137,A00,189057,Winkielman; Piotr,0,34,25,25
1683315868786,PSYC 144,A00,189107,Wixted; John T,0,7,50,50
1683315870836,PSYC 162,A00,189142,Staff,0,8,85,85
1683315871861,PSYC 172,A00,189144,Gorman; Michael R.,0,7,30,30
1683315873909,PSYC 179,A00,189146,Lacefield; Katharine I,0,84,120,120
1683315874938,PSYC 181,A00,189147,Anagnostaras; Stephan,0,44,90,90
1683315875965,PSYC 190R,A00,189148,Barner; David A.,0,22,80,80
1683315876989,PSYC 191,A00,189275,Rickard; Timothy C.,0,7,25,25
1683315878013,PSYC 193,A00,189276,Chapman; Eddie Nathaniel,0,1,0,4
1683315879043,PSYC 193L,A01,189281,Lowe; Angela Beth,12,0,20,8
1683315879043,PSYC 193L,B01,189285,Staff,28,0,35,7
1683315880071,RELI 149,A00,187137,Rahimi; Babak,7,0,40,33
1683315881095,SE 9,A01,187315,Staff,0,2,18,18
1683315882118,SE 101B,A00,187409,Staff,24,0,30,6
1683315883144,SE 110B,A00,187444,Staff,10,0,40,30
1683315884167,SE 130B,A00,187449,Staff,31,0,40,9
1683315885194,SE 150A,A00,187516,Staff,9,0,20,11
1683315886218,SE 154,A00,187528,Staff,30,0,50,20
1683315887244,SIO 3,A01,258171,Staff,35,0,40,5
1683315888271,SIO 10,A00,187144,Cook; Geoffrey W,0,3,75,75
1683315889295,SIO 45,A00,187152,Cook; Geoffrey W,1,0,100,99
1683315890319,SIO 109R,A00,194486,Staff,0,3,20,20
1683315892366,SIO 187,A01,187233,Kacev; David,12,0,40,28
1683315893392,SOCI 1,A01,258656,Thorpe; Charles Robert,28,0,30,2
1683315893392,SOCI 1,A02,258658,Thorpe; Charles Robert,30,0,30,0
1683315893392,SOCI 1,A03,258661,Thorpe; Charles Robert,25,0,25,0
1683315893392,SOCI 1,A04,258666,Thorpe; Charles Robert,22,0,25,3
1683315893392,SOCI 1,A05,258897,Thorpe; Charles Robert,23,0,25,2
1683315893392,SOCI 1,A06,258898,Thorpe; Charles Robert,25,0,25,0
1683315894419,SOCI 30,A01,258903,Pardo Guerra; Juan Pablo,16,0,30,14
1683315895445,SOCI 102,A00,258904,Staff,9,0,25,16
1683315896472,SOCI 106,A00,258905,Staff,19,0,25,6
1683315897501,SOCI 111,A00,258907,Ribas Norris; Janet Vanesa,26,0,30,4
1683315898526,SOCI 121R,A00,258908,Pardo Guerra; Juan Pablo,11,0,30,19
1683315899556,SOCI 126,A01,203330,Staff,14,0,20,6
1683315900582,SOCI 131,A00,258909,Thorpe; Charles Robert,31,0,60,29
1683315901605,SOCI 135,A00,258910,Payne; Christine Anna,0,9,30,30
1683315902628,SOCI 157,A00,258911,Staff,12,0,30,18
1683315903654,SOCI 184,A00,258912,Staff,25,0,30,5
1683315904683,SOCI 188D,A00,258913,Staff,21,0,30,9
1683315905707,SYN 2,001,187529,Staff,9,0,16,7
1683315905707,SYN 2,002,201452,Staff,0,18,16,16
1683315905707,SYN 2,003,201469,Staff,4,0,16,12
1683315906731,SYN 100,A01,187531,Staff,0,9,20,20
1683315906731,SYN 100,B01,201491,Staff,0,12,20,20
1683315907754,TDAC 1,A00,189286,Walsh; Kim C.,3,0,20,17
1683315907754,TDAC 1,B00,189287,Harting; Carla Kelso,11,0,20,9
1683315908781,TDAC 101,A00,189300,Walsh; Kim C.,16,0,20,4
1683315908781,TDAC 101,B00,189301,Harting; Carla Kelso,18,0,20,2
1683315909807,TDAC 102,A00,189304,Basso; Beatrice,14,0,20,6
1683315910833,TDAC 108,A00,189305,Staff,18,0,20,2
1683315911860,TDDE 131,A00,189310,Staff,19,0,20,1
1683315911860,TDDE 131,B00,189314,Staff,19,0,20,1
1683315911860,TDDE 131,C00,189315,Staff,48,0,50,2
1683315911860,TDDE 131,D00,189316,Staff,14,0,15,1
1683315911860,TDDE 131,E00,204841,Staff,20,0,20,0
1683315912883,TDGE 10,A00,189289,Staff,30,0,50,20
1683315912883,TDGE 10,B00,189290,Havis; Allan,2,0,50,48
1683315913907,TDGE 11,A00,189291,Fulton; Julia,0,3,50,50
1683315913907,TDGE 11,B00,189292,Staff,20,0,25,5
1683315913907,TDGE 11,C00,260270,Staff,0,0,0,0
1683315914934,TDGE 25,A00,189294,Staff,3,0,20,17
1683315915959,TDGE 124,A00,189318,Fulton; Julia,0,8,50,50
1683315916983,TDGE 125,A00,189319,Staff,13,0,25,12
1683315916983,TDGE 125,B00,189320,Staff,23,0,25,2
1683315918007,TDGE 127,A00,189322,Havis; Allan,0,0,50,50
1683315919035,TDHT 101,A00,189323,Staff,18,0,25,7
1683315919035,TDHT 101,B00,189324,Staff,25,0,25,0
1683315920063,TDHT 102,A00,189325,Staff,49,0,50,1
1683315921090,TDMV 1,A00,189295,Arcidiacono; Kristin,20,0,30,10
1683315921090,TDMV 1,B00,189296,Caligagan; Maria T.,24,0,30,6
1683315922118,TDMV 2,A00,189297,Sammartano; Tonnie,28,0,30,2
1683315922118,TDMV 2,B00,189299,Arcidiacono; Kristin,24,0,30,6
1683315923145,TDMV 3,A00,204998,Rincon; Alicia,22,0,30,8
1683315924168,TDMV 120,A00,189458,Sammartano; Tonnie,28,0,30,2
1683315925195,TDMV 138,A00,189541,Jun; Grace Shin Hae,22,0,40,18
1683315926222,TDMV 142,A00,189717,Caligagan; Tony,23,0,30,7
1683315926222,TDMV 142,B00,189718,Caligagan; Maria T.,25,0,30,5
1683315927246,TMC 2,A01,187533,Staff,25,0,25,0
1683315927246,TMC 2,A02,187534,Staff,25,0,25,0
1683315928268,USP 1,A01,187536,Kwak; Nancy,0,16,25,25
1683315929296,USP 5,A01,187538,Staff,9,0,25,16
1683315930323,USP 101,A00,199253,Staff,0,4,0,0
1683315931347,USP 124,A00,187562,Boomhower; Matthew Charles,1,0,30,29
1683315932371,USP 138,A00,187582,Staff,20,0,25,5
1683315933396,USP 152,A01,187597,Staff,4,0,25,21
1683315934419,USP 153,A00,187598,Staff,19,0,25,6
1683315935443,USP 168,A00,187607,Kwak; Nancy,2,0,5,3
1683315936469,USP 173,A00,187619,Staff,4,0,25,21
1683315937493,USP 181,A00,187638,Staff,0,0,25,25
1683315938514,VIS 103,A00,187650,Cruz; Edwin Teddy,23,0,75,52
1683315939539,VIS 110D,A00,187669,Staff,12,0,22,10
1683315940563,VIS 127C,A00,187720,Shen; Kuiyi,68,0,146,78
1683315941587,VIS 149,A00,187731,Yoldas; Pinar,0,14,22,22
1683315942611,VIS 151,A01,188091,Staff,22,0,34,12
1683315942611,VIS 151,A02,188092,Staff,11,0,34,23
1683315943636,VIS 160B,A00,188093,Stalbaum; Brett,0,0,10,10
1683315945686,WCWP 10B,A00,201720,Staff,10,0,15,5
1683315945686,WCWP 10B,B00,201722,Staff,8,0,15,7
1683315946710,WCWP 100,A00,201725,Gagnon; Jeffrey C,0,0,2,2
1683315946710,WCWP 100,B00,201727,Staff,0,4,15,15
1683315949795,ANBI 133,A00,258401,Wilder; Linnea Lorene,34,0,40,6
1683315950821,ANBI 140,A00,258395,Hrvoj Mihic; Branka,18,0,25,7
1683315951849,ANSC 120,A00,258402,Bialecki; Jon Anthony,27,0,40,13
1683315952873,ANSC 144,A00,258400,Staff,14,0,40,26
1683315954923,ANSC 166,A00,258396,Parish; Steven Martin,157,0,175,18
1683315955947,ANSC 180,A00,193533,Staff,9,0,20,11
1683315956972,ANSC 188,A00,258397,Jassal; Aftab,33,0,40,7
1683315957996,ANTH 3,A01,258316,Staff,23,0,30,7
1683315959022,ANTH 5,A00,258394,Semendeferi; Ekaterini,16,0,20,4
1683315960046,ANTH 21,A01,258331,Staff,9,0,40,31
1683315961126,ANTH 103,A00,258398,Varma; Saiba,15,0,25,10
1683315962152,AWP 10,001,202034,Staff,0,0,0,0
1683315962152,AWP 10,002,202035,Staff,0,0,0,0
1683315962152,AWP 10,003,202036,Staff,0,0,0,0
1683315962152,AWP 10,004,202037,Staff,0,0,0,0
1683315962152,AWP 10,005,202038,Staff,0,0,0,0
1683315962152,AWP 10,006,202039,Staff,0,0,0,0
1683315962152,AWP 10,007,202040,Staff,0,0,0,0
1683315962152,AWP 10,008,202041,Staff,0,0,0,0
1683315962152,AWP 10,009,202042,Staff,0,0,0,0
1683315962152,AWP 10,010,202043,Staff,0,0,0,0
1683315962152,AWP 10,011,202044,Staff,0,0,0,0
1683315962152,AWP 10,012,202045,Staff,0,0,0,0
1683315962152,AWP 10,013,202046,Staff,0,0,0,0
1683315962152,AWP 10,014,202047,Staff,0,0,0,0
1683315962152,AWP 10,015,202048,Staff,0,0,0,0
1683315962152,AWP 10,016,202049,Staff,0,0,0,0
1683315962152,AWP 10,017,202050,Staff,0,0,0,0
1683315962152,AWP 10,018,202051,Staff,0,0,0,0
1683315962152,AWP 10,019,202052,Staff,0,0,0,0
1683315962152,AWP 10,020,202053,Staff,0,0,0,0
1683315962152,AWP 10,021,202054,Staff,0,0,0,0
1683315962152,AWP 10,022,202055,Staff,0,0,0,0
1683315962152,AWP 10,023,202056,Staff,0,0,0,0
1683315962152,AWP 10,024,202057,Staff,0,0,0,0
1683315962152,AWP 10,025,202058,Staff,0,0,0,0
1683315962152,AWP 10,026,202059,Staff,0,0,0,0
1683315963182,AWP 102,001,202032,Staff,0,0,0,0
1683315963182,AWP 102,002,202033,Staff,0,0,0,0
1683315964208,BENG 100,A01,254234,Taylor Amos; Alyssa C,31,0,40,9
1683315965233,BENG 196,001,270013,Engler; Adam J.,9999,0,9999,0
1683315966258,BICD 100R,A01,202018,Smith; Laurie,0,7,32,32
1683315966258,BICD 100R,A02,202019,Smith; Laurie,0,2,32,32
1683315966258,BICD 100R,A03,202020,Smith; Laurie,0,1,32,32
1683315966258,BICD 100R,A04,202021,Smith; Laurie,8,0,32,24
1683315966258,BICD 100R,A05,202022,Smith; Laurie,12,0,32,20
1683315967286,BICD 136,A01,193242,Gustafson-Brown; Cindy,0,2,32,32
1683315967286,BICD 136,A02,193244,Gustafson-Brown; Cindy,15,0,32,17
1683315968312,BIEB 102,A01,193249,Butler; Shannon Rhey,0,2,32,32
1683315968312,BIEB 102,A02,193251,Butler; Shannon Rhey,0,0,32,32
1683315968312,BIEB 102,A03,193253,Butler; Shannon Rhey,0,1,32,32
1683315968312,BIEB 102,A04,193255,Butler; Shannon Rhey,17,0,32,15
1683315968312,BIEB 102,A05,193265,Butler; Shannon Rhey,26,0,32,6
1683315968312,BIEB 102,A06,193269,Butler; Shannon Rhey,16,0,32,16
1683315970361,BIEB 150,A01,193274,Staff,0,0,32,32
1683315970361,BIEB 150,A02,193285,Staff,23,0,32,9
1683315971390,BIEB 194,A00,193286,Kurle; Carolyn M.,22,0,32,10
1683315972419,BILD 1,A01,192291,Staff,16,0,32,16
1683315972419,BILD 1,A02,192292,Staff,30,0,32,2
1683315972419,BILD 1,B01,192520,Reuther; Keefe,0,1,0,0
1683315972419,BILD 1,B02,192532,Reuther; Keefe,0,1,0,0
1683315973446,BILD 3,A01,192556,Butler; Shannon Rhey,0,0,32,32
1683315973446,BILD 3,A02,192581,Butler; Shannon Rhey,5,0,32,27
1683315973446,BILD 3,A03,192611,Butler; Shannon Rhey,23,0,32,9
1683315973446,BILD 3,A04,192612,Butler; Shannon Rhey,25,0,32,7
1683315973446,BILD 3,A05,192613,Butler; Shannon Rhey,27,0,32,5
1683315973446,BILD 3,A06,192679,Butler; Shannon Rhey,27,0,32,5
1683315973446,BILD 3,A07,192682,Butler; Shannon Rhey,22,0,32,10
1683315974475,BILD 4,A01,192836,Reuther; Keefe,1,0,24,23
1683315974475,BILD 4,A02,193044,Reuther; Keefe,4,0,24,20
1683315975499,BILD 10,A01,193142,Gustafson-Brown; Cindy,31,0,32,1
1683315975499,BILD 10,A02,193149,Gustafson-Brown; Cindy,31,0,32,1
1683315976524,BIMM 100,A01,193301,Staff,0,6,32,32
1683315976524,BIMM 100,A02,193312,Staff,0,5,32,32
1683315976524,BIMM 100,A03,193323,Staff,0,8,32,32
1683315977552,BIMM 101,A01,193329,McDonnell; Lisa Marie,0,3,24,24
1683315977552,BIMM 101,A02,193339,McDonnell; Lisa Marie,0,2,24,24
1683315977552,BIMM 101,B01,193354,McDonnell; Lisa Marie,0,3,24,24
1683315977552,BIMM 101,B02,193357,McDonnell; Lisa Marie,0,3,24,24
1683315978577,BIMM 110,A01,193377,Tat; John,0,11,32,32
1683315978577,BIMM 110,A02,193378,Tat; John,1,9,32,31
1683315979604,BIMM 120,A01,206116,Staff,0,0,32,32
1683315979604,BIMM 120,A02,206117,Staff,8,0,32,24
1683315979604,BIMM 120,A03,206121,Staff,21,0,32,11
1683315980632,BIPN 100,A01,193393,Park; Ji Young,0,14,32,32
1683315980632,BIPN 100,A02,193402,Park; Ji Young,0,12,32,32
1683315980632,BIPN 100,A03,193413,Park; Ji Young,0,14,32,32
1683315980632,BIPN 100,A04,193414,Park; Ji Young,0,13,32,32
1683315981657,BIPN 102,A01,193429,Staff,0,0,32,32
1683315981657,BIPN 102,A02,193438,Staff,22,0,32,10
1683315982683,BIPN 106,A01,193450,Reyes Gonzalez; Catalina,0,2,40,40
1683315983714,BIPN 134,A01,193465,Cooke; James Edward,0,0,32,32
1683315983714,BIPN 134,A02,193474,Cooke; James Edward,27,0,32,5
1683315983714,BIPN 134,A03,193485,Cooke; James Edward,29,0,32,3
1683315983714,BIPN 134,A04,193486,Cooke; James Edward,21,0,32,11
1683315983714,BIPN 134,A05,193491,Cooke; James Edward,31,0,32,1
1683315983714,BIPN 134,A06,193501,Cooke; James Edward,30,0,32,2
1683315983714,BIPN 134,A07,193510,Cooke; James Edward,29,0,32,3
1683315985771,BISP 194,A00,222522,Staff,16,0,32,16
1683315986796,CAT 124,A01,202407,Staff,20,0,25,5
1683315987823,CAT 125,A00,202408,Marchisotto; Jennifer Anne,4,0,20,16
1683315988850,CAT 125R,A00,202409,Smith; Lauryn Alissa,0,11,20,20
1683315988850,CAT 125R,B00,202410,Morales; Celeste Georgianna,0,11,20,20
1683315988850,CAT 125R,C00,202411,Irwin; Matthew Joseph,0,10,20,20
1683315989878,CENG 15,A01,204712,Yang; Kesong,0,1,0,0
1683315990901,CENG 114,A00,202070,Jahed Motlagh; Zeinab,5,0,20,15
1683315991928,CGS 105,A00,185477,Wesling; Megan E.,24,0,40,16
1683315992954,CGS 106,A00,185494,Staff,13,0,22,9
1683315993977,CGS 108,A00,185495,Staff,14,0,20,6
1683315995001,CGS 114,A00,185496,Staff,13,0,18,5
1683315996024,CGS 119,A00,185501,Staff,15,0,20,5
1683315997051,CGS 120,A00,185511,Staff,13,0,20,7
1683315998077,CHEM 4,A01,184675,Bussey; Thomas J,96,0,100,4
1683315999099,CHEM 6A,A01,184677,Staff,35,0,60,25
1683316000123,CHEM 6B,A01,184679,Staff,65,0,100,35
1683316001148,CHEM 6C,A01,184681,Bussey; Thomas J,1,0,50,49
1683316001148,CHEM 6C,A02,184682,Bussey; Thomas J,34,0,50,16
1683316002170,CHEM 40A,A01,184684,Albizati; Kim F.,37,0,100,63
1683316003197,CHEM 40B,A01,184686,Albizati; Kim F.,0,20,100,100
1683316004221,CHEM 41B,A01,184690,Staff,52,0,100,48
1683316005248,COGS 3,A01,184715,Boyle; Mary E. T.,0,25,40,40
1683316006275,COGS 14B,A01,185172,Staff,0,15,38,38
1683316007302,COGS 18,A01,184736,Staff,18,0,80,62
1683316008332,COGS 100,A01,184932,Staff,0,5,73,73
1683316009355,COGS 101A,A01,184935,Staff,0,38,30,30
1683316010382,COGS 101B,A01,184944,Staff,0,2,30,30
1683316011411,COGS 101C,A01,184946,Staff,0,12,30,30
1683316012437,COGS 102A,A01,184951,Johnson; Christine M.,2,0,40,38
1683316013462,COGS 107B,A01,184953,Mooshagian; Eric Frederick,0,50,40,40
1683316014486,COGS 118B,A01,184959,Gupta; Anjum,0,48,40,40
1683316015511,COGS 153,A00,184961,Staff,0,15,30,30
1683316016536,COGS 177,A00,184962,Staff,0,21,30,30
1683316017560,COGS 187A,A01,184969,Boyle; Mary E. T.,0,17,40,40
1683316018588,COMM 10,A01,185174,Staff,0,5,25,25
1683316018588,COMM 10,A02,185189,Staff,0,5,25,25
1683316018588,COMM 10,A03,269821,Staff,0,0,0,0
1683316019612,COMM 100B,A01,185475,Staff,0,0,0,2
1683316019612,COMM 100B,A02,185476,Staff,14,0,25,11
1683316020637,COMM 100C,A01,185314,Staff,1,0,25,24
1683316020637,COMM 100C,A02,185327,Staff,19,0,25,6
1683316021661,COMM 110M,A00,185349,Staff,2,0,40,38
1683316022689,COMM 113T,A00,185352,Staff,25,0,40,15
1683316023716,COMM 114I,A00,185353,Staff,33,0,40,7
1683316024741,COMM 131,A00,185354,Staff,19,0,30,11
1683316025765,CSE 8A,A50,185358,Cao; Yingjun,0,46,10,10
1683316026789,CSE 8B,A01,185362,Staff,1,47,50,49
1683316027813,CSE 11,A01,185416,Cao; Yingjun,0,92,10,10
1683316028841,CSE 20,A01,185445,Briones; Jor-el Thomas Caparas,5,0,25,20
1683316029866,CSE 21,A01,185447,Staff,10,0,50,40
1683316030890,CSE 101,A01,185451,Staff,0,12,50,50
1683316030890,CSE 101,B01,185453,Jones; Miles E,0,11,50,50
1683316032941,CSE 141,A01,185458,Eldon; John,20,0,100,80
1683316033967,CSE 141L,A01,185461,Eldon; John,12,0,100,88
1683316034995,CSE 142,A01,185463,Staff,36,0,60,24
1683316034995,CSE 142,B01,201355,Staff,0,7,60,60
1683316036018,CSE 142L,A01,185470,Staff,36,0,60,24
1683316036018,CSE 142L,B01,201417,Staff,0,6,60,60
1683316037043,CSE 190,A00,201433,Staff,32,0,49,17
1683316038071,DOC 1,A01,259136,Strom; Megan C.,7,0,15,8
1683316038071,DOC 1,A02,259137,Strom; Megan C.,14,0,15,1
1683316038071,DOC 1,A03,259138,Strom; Megan C.,14,0,15,1
1683316038071,DOC 1,A04,259139,Strom; Megan C.,14,0,15,1
1683316039099,DOC 100D,A00,259140,Pass; Natalye Joann,17,0,25,8
1683316040127,DSGN 1,A01,184749,Rill; Bryan,0,25,30,30
1683316041153,DSGN 100,A01,185168,Staff,0,2,25,25
1683316042182,ECE 5,A01,185626,Morris; Karcher William,0,10,0,0
1683316043209,ECE 101,A01,185628,Staff,17,0,70,53
1683316044233,ECE 107,A01,185635,Baghdadchi; Saharnaz,0,0,20,20
1683316044233,ECE 107,A02,185638,Baghdadchi; Saharnaz,4,0,20,16
1683316045257,ECE 148,A01,185647,Silberman; Jack,0,0,16,16
1683316046281,ECON 1,A01,185537,Crane; Meredith Helen,54,0,70,16
1683316047309,ECON 3,A01,185549,Crane; Meredith Helen,33,0,70,37
1683316048337,ECON 4,A01,203354,Anderson; John Charles,0,4,10,10
1683316049362,ECON 100A,A01,185574,Staff,0,4,40,40
1683316050387,ECON 100B,A01,185576,Staff,0,22,40,40
1683316051412,ECON 100C,A01,185589,Newhouse; Herbert S,30,0,70,40
1683316052438,ECON 105,A00,185608,Vespa; Emanuel Ignacio,19,0,35,16
1683316053466,ECON 109,A01,185610,Shishkin; Denis,10,0,35,25
1683316054493,ECON 110A,A01,185612,Staff,11,0,40,29
1683316055517,ECON 120A,A01,185615,Staff,20,0,40,20
1683316056541,ECON 120C,A01,185617,Sun; Yixiao,0,20,70,70
1683316057565,ECON 144,A00,203346,Squires; Dale E,3,0,35,32
1683316058590,ECON 171,A01,203349,Newhouse; Herbert S,0,1,35,35
1683316059619,ECON 173A,A01,185621,Toda; Alexis Akira,21,0,35,14
1683316060644,EDS 25,A01,202413,Staff,0,1,0,0
1683316060644,EDS 25,A02,202414,Staff,0,1,0,0
1683316060644,EDS 25,A03,202415,Staff,0,0,0,0
1683316060644,EDS 25,A04,202416,Staff,0,1,0,0
1683316060644,EDS 25,A05,202439,Staff,0,0,0,0
1683316060644,EDS 25,A06,202440,Staff,0,0,0,0
1683316060644,EDS 25,B01,202631,Staff,0,0,0,0
1683316060644,EDS 25,B02,202632,Staff,0,0,0,0
1683316060644,EDS 25,B03,202639,Staff,0,0,0,0
1683316060644,EDS 25,B04,202640,Staff,0,0,0,0
1683316060644,EDS 25,B05,202643,Staff,0,0,0,0
1683316060644,EDS 25,B06,202644,Staff,0,0,0,0
1683316061670,EDS 38,A01,202659,Black; Alison Michelle,24,0,25,1
1683316062699,EDS 115,A00,202652,Staff,17,0,30,13
1683316063721,EDS 125,A00,202649,Staff,14,0,30,16
1683316064821,EDS 126,A01,203332,Staff,30,0,30,0
1683316065847,EDS 139,A00,202838,Staff,16,0,25,9
1683316066871,EDS 146,A01,202655,Staff,14,0,25,11
1683316067896,ENG 15,A00,185667,Staff,0,1,0,0
1683316067896,ENG 15,B00,185672,Staff,0,0,0,0
1683316067896,ENG 15,C00,185675,Staff,0,0,0,0
1683316067896,ENG 15,D00,185682,Staff,0,0,0,0
1683316067896,ENG 15,E00,185684,Staff,0,0,0,0
1683316068919,ETHN 103,A00,185710,Staff,0,3,35,35
1683316069944,ETHN 103A,A00,199228,Man; Simeon S,2,0,9,7
1683316070968,ETHN 109,A00,185711,Staff,18,0,35,17
1683316071992,ETHN 142,A00,185726,Staff,0,4,30,30
1683316073019,ETHN 163J,A00,199229,Man; Simeon S,5,0,8,3
1683316074047,ETHN 168,A00,185727,Staff,8,0,10,2
1683316075072,ETHN 182,A00,185728,Staff,1,0,35,34
1683316076099,ETHN 183,A00,185737,Staff,8,0,18,10
1683316077125,GLBH 111,A01,209361,Burgos; Jose L.,0,0,0,0
1683316079176,HIEU 104,A00,185792,Staff,16,0,20,4
1683316080199,HIEU 115,A00,185800,Staff,1,0,20,19
1683316081223,HIEU 128,A00,185801,Staff,0,7,20,20
1683316082247,HIEU 147,A00,185802,Staff,16,0,20,4
1683316083271,HIEU 154,A00,185823,Staff,12,0,20,8
1683316084295,HILA 102,A00,185826,Staff,13,0,20,7
1683316085325,HILD 2C,A01,185778,Staff,0,12,20,20
1683316086354,HILD 7B,A01,185780,Kwak; Nancy,0,15,32,32
1683316086354,HILD 7B,A02,185781,Kwak; Nancy,0,18,32,32
1683316087380,HILD 30,A01,185791,Staff,14,0,20,6
1683316088404,HISC 119,A00,185830,Golan; Tal,0,9,20,20
1683316089429,HITO 156GS,A00,185831,Patterson; Patrick H.,0,0,0,23
1683316090453,HIUS 103,A00,185832,Man; Simeon S,0,6,20,20
1683316091478,HIUS 117,A00,185836,Kwak; Nancy,2,0,20,18
1683316092502,HIUS 125,A00,185840,Man; Simeon S,0,0,23,23
1683316093526,HIUS 149,A00,185845,Staff,0,0,20,20
1683316094551,HUM 3,A01,185882,Zavodny; Tatiana Sophia,0,6,50,50
1683316094551,HUM 3,B01,185899,Caldwell; Michael Alan,0,19,50,50
1683316095577,HUM 3GS,A00,185900,Patterson; Patrick H.,0,0,0,23
1683316096605,HUM 4,A01,185938,Zroka; Amy Liane,31,0,50,19
1683316096605,HUM 4,B01,185956,Watkins; Eric,0,2,50,50
1683316096605,HUM 4,B02,202209,Watkins; Eric,0,2,50,50
1683316096605,HUM 4,B03,202210,Watkins; Eric,0,0,50,50
1683316097635,HUM 5,A01,185958,West; Geoffrey Scott,4,0,50,46
1683316097635,HUM 5,A02,202215,West; Geoffrey Scott,0,0,50,50
1683316098660,INTL 190,A00,185959,Gagnon; Jeffrey C,0,0,0,9
1683316098660,INTL 190,B00,185960,Lettieri; Michael Joseph,0,0,0,1
1683316099686,JAPN 180,A00,254509,Staff,5,1,30,25
1683316100715,LATI 10,A01,202853,Kennemore; Amy Michelle,5,0,35,30
1683316100715,LATI 10,A02,202854,Kennemore; Amy Michelle,1,0,35,34
1683316100715,LATI 10,A03,270054,Kennemore; Amy Michelle,30,0,30,0
1683316101738,LATI 180,A00,202855,Kennemore; Amy Michelle,11,0,20,9
1683316102762,LAWS 101,A00,201767,Golan; Tal,0,7,40,40
1683316103787,LIFR 1C,A00,185961,Staff,6,0,20,14
1683316104813,LIFR 1CX,A00,185962,Staff,7,0,20,13
1683316105837,LIFR 1D,A00,185963,Staff,9,0,20,11
1683316106864,LIFR 1DX,A00,185964,Staff,9,0,20,11
1683316107899,LIGN 101,A01,186039,Staff,43,0,50,7
1683316108927,LIGN 165,A00,186040,Staff,18,0,50,32
1683316109954,LTCS 108,A00,186041,Staff,6,0,10,4
1683316110981,LTCS 119,A00,186042,Staff,16,0,20,4
1683316112008,LTCS 130,A00,186043,Wesling; Megan E.,15,0,25,10
1683316114061,LTEA 138,A00,186119,Staff,14,0,40,26
1683316115086,LTEN 124,A00,186148,Staff,6,0,25,19
1683316116113,LTEN 178,A00,186149,Staff,7,0,15,8
1683316117137,LTEN 181,A00,186150,Blanco; John D,33,0,40,7
1683316118162,LTWL 120,A00,186160,Staff,20,0,25,5
1683316119186,LTWL 165,A00,186161,Staff,22,0,25,3
1683316120211,LTWR 100,A00,186162,Staff,0,4,15,15
1683316121238,LTWR 102,A00,186163,Doller; Ben,5,0,15,10
1683316122265,MAE 8,A01,186412,Staff,0,0,0,0
1683316123289,MAE 30B,A00,186445,Bahadori; Mohammad Yousef,83,0,100,17
1683316124314,MAE 40,A00,186592,Bewley; Thomas R,9,0,50,41
1683316125338,MAE 101B,A00,186593,Bahadori; Mohammad Yousef,81,0,100,19
1683316126362,MAE 105,A00,186594,Bandaru; Prabhakar,12,0,50,38
1683316127387,MAE 107,A00,186599,Pham; Hieu Tan,0,6,120,120
1683316128410,MAE 148,A01,186660,Silberman; Jack,3,0,16,13
1683316129434,MATH 10A,A01,188095,Staff,0,6,35,35
1683316130464,MATH 10B,A01,188097,Bowers; Adam R.,0,11,30,30
1683316130464,MATH 10B,A02,188099,Bowers; Adam R.,0,11,30,30
1683316130464,MATH 10B,B01,188104,Bowers; Adam R.,0,10,30,30
1683316130464,MATH 10B,B02,188106,Bowers; Adam R.,0,10,30,30
1683316131492,MATH 10C,A01,188111,Staff,0,18,30,30
1683316131492,MATH 10C,A02,188127,Staff,0,17,30,30
1683316131492,MATH 10C,A03,188131,Staff,0,18,30,30
1683316131492,MATH 10C,B01,188218,Staff,20,0,30,10
1683316131492,MATH 10C,B02,188244,Staff,13,0,30,17
1683316131492,MATH 10C,B03,188277,Staff,16,0,30,14
1683316132518,MATH 18,A01,188344,Bach; Quang Tran,18,0,30,12
1683316132518,MATH 18,A02,188345,Bach; Quang Tran,11,0,30,19
1683316132518,MATH 18,B01,188353,Bach; Quang Tran,10,0,30,20
1683316132518,MATH 18,B02,188354,Bach; Quang Tran,20,0,30,10
1683316133542,MATH 20A,A01,188374,Staff,13,0,35,22
1683316134567,MATH 20B,A01,188382,Ohm; Ko Woon,6,0,30,24
1683316134567,MATH 20B,A02,188383,Ohm; Ko Woon,23,0,30,7
1683316134567,MATH 20B,B01,188385,Ohm; Ko Woon,7,0,30,23
1683316134567,MATH 20B,B02,188392,Ohm; Ko Woon,22,0,30,8
1683316135593,MATH 20C,A01,188394,Harel; Guershon,10,0,30,20
1683316135593,MATH 20C,A02,188395,Harel; Guershon,14,0,30,16
1683316135593,MATH 20C,B01,188404,Harel; Guershon,5,0,30,25
1683316135593,MATH 20C,B02,188405,Harel; Guershon,19,0,30,11
1683316136617,MATH 20D,A01,188414,Hammock; Frances H,0,1,30,30
1683316136617,MATH 20D,A02,188415,Hammock; Frances H,3,0,30,27
1683316136617,MATH 20D,B01,188447,Hammock; Frances H,2,0,30,28
1683316136617,MATH 20D,B02,188486,Hammock; Frances H,8,0,30,22
1683316137645,MATH 20E,A01,188649,Staff,21,0,30,9
1683316137645,MATH 20E,A02,188650,Staff,23,0,30,7
1683316137645,MATH 20E,A03,188673,Staff,0,0,30,30
1683316138669,MATH 102,A01,188675,Staff,0,35,35,35
1683316139694,MATH 103B,A01,188681,Staff,4,0,35,31
1683316139694,MATH 103B,B01,188692,Staff,5,0,35,30
1683316140718,MATH 109,A01,188695,Salehi Golsefidy; Alireza,25,0,35,10
1683316140718,MATH 109,A02,188696,Salehi Golsefidy; Alireza,26,0,35,9
1683316141746,MATH 120A,A01,188698,Eggers; John Dietrich,7,0,35,28
1683316142770,MATH 142B,A01,188736,Ioana; Adrian,0,2,30,30
1683316142770,MATH 142B,A02,188741,Ioana; Adrian,0,1,30,30
1683316142770,MATH 142B,A03,188743,Ioana; Adrian,1,3,30,29
1683316143798,MATH 168A,A01,188790,Staff,0,9,35,35
1683316144826,MATH 170A,A01,188803,Nie; Jiawang,0,2,35,35
1683316144826,MATH 170A,A02,188811,Nie; Jiawang,0,0,35,35
1683316144826,MATH 170A,A03,188814,Nie; Jiawang,0,0,35,35
1683316144826,MATH 170A,A04,188815,Nie; Jiawang,13,0,35,22
1683316145849,MATH 193B,A01,188817,Staff,0,0,35,35
1683316145849,MATH 193B,A02,188818,Staff,6,0,35,29
1683316146873,MGT 4,A01,202857,Anderson; John Charles,62,0,80,18
1683316147896,MGT 12,A00,202858,Lindenberger; Wade Douglas,43,0,90,47
1683316148920,MGT 18,A00,202859,Staff,74,0,90,16
1683316149946,MGT 18GS,A00,202860,McKay; Michael J,13,0,28,15
1683316150973,MGT 45,A00,202861,Pecore; Joseph P.,13,0,90,77
1683316151998,MGT 100,A00,202863,Yavorsky; Daniel Ryan,28,0,90,62
1683316153022,MGT 103,A00,202864,Ehrich; Kristine R,0,16,90,90
1683316154050,MGT 112,A00,202865,Ehrich; Kristine R,15,0,90,75
1683316155077,MGT 121A,A00,202868,Staff,0,19,0,0
1683316156104,MGT 131B,A00,202869,Anderson; John Charles,59,0,90,31
1683316157131,MGT 136,A00,202871,Lindenberger; Wade Douglas,84,0,90,6
1683316158158,MGT 164,A00,202873,Staff,0,68,90,90
1683316159182,MGT 164GS,A00,202874,McKay; Mary A,13,0,28,15
1683316160206,MGT 180,A00,202875,Staff,0,50,90,90
1683316161229,MMW 11R,A01,205019,Herbst; Matthew,3,0,30,27
1683316161229,MMW 11R,A02,205026,Herbst; Matthew,29,0,30,1
1683316162254,MMW 15,A01,193512,Chang; Edmond Yi-Teh,0,9,28,28
1683316162254,MMW 15,A02,193513,Chang; Edmond Yi-Teh,0,5,28,28
1683316162254,MMW 15,A03,193514,Chang; Edmond Yi-Teh,0,5,28,28
1683316162254,MMW 15,A04,193515,Chang; Edmond Yi-Teh,0,5,28,28
1683316162254,MMW 15,A05,193516,Chang; Edmond Yi-Teh,0,4,28,28
1683316162254,MMW 15,A06,193517,Chang; Edmond Yi-Teh,0,5,28,28
1683316162254,MMW 15,B01,193519,Chang; Edmond Yi-Teh,0,4,28,28
1683316162254,MMW 15,B02,193520,Chang; Edmond Yi-Teh,0,5,28,28
1683316162254,MMW 15,B03,193521,Chang; Edmond Yi-Teh,0,4,28,28
1683316162254,MMW 15,B04,193522,Chang; Edmond Yi-Teh,0,4,28,28
1683316162254,MMW 15,B05,193523,Chang; Edmond Yi-Teh,0,5,28,28
1683316162254,MMW 15,B06,193524,Chang; Edmond Yi-Teh,0,4,28,28
1683316163278,MMW 122,A01,193526,Rahimi; Babak,0,14,28,28
1683316163278,MMW 122,A02,193527,Rahimi; Babak,0,14,28,28
1683316163278,MMW 122,A03,193528,Rahimi; Babak,0,0,0,0
1683316163278,MMW 122,A04,193529,Rahimi; Babak,0,0,0,0
1683316164302,MUS 1A,A01,186663,Staff,0,20,35,35
1683316165326,MUS 4,A01,186715,Staff,0,12,35,35
1683316166351,MUS 5R,A01,186796,Dubnov; Shlomo,0,17,35,35
1683316167375,MUS 6,A01,186798,Staff,0,3,25,25
1683316168461,MUS 7,A01,186830,Staff,12,0,35,23
1683316169487,MUS 8,A01,186930,Staff,0,26,35,35
1683316170511,MUS 15,A01,186932,Staff,0,15,35,35
1683316170511,MUS 15,B01,186934,Staff,0,15,35,35
1683316171535,MUS 80,A00,186935,Staff,2,0,20,18
1683316171535,MUS 80,B00,186936,Staff,25,0,25,0
1683316172563,NANO 11,A00,204702,Lipomi; Darren John,0,0,0,0
1683316173586,NANO 15,A01,204709,Yang; Kesong,0,1,0,0
1683316174618,NANO 114,A00,202069,Jahed Motlagh; Zeinab,3,0,10,7
1683316175641,PHIL 1,A00,186955,Grush; Rick Scott,32,0,40,8
1683316176666,PHIL 10,A01,186973,Grush; Rick Scott,28,0,35,7
1683316176666,PHIL 10,A02,186974,Grush; Rick Scott,33,0,35,2
1683316177690,PHIL 13,A01,186976,Staff,7,0,35,28
1683316177690,PHIL 13,A02,186977,Staff,16,0,35,19
1683316178718,PHIL 14,A01,186979,Staff,31,0,35,4
1683316178718,PHIL 14,A02,186986,Staff,32,0,35,3
1683316179782,PHIL 28,A01,186988,Staff,16,0,30,14
1683316179782,PHIL 28,A02,186989,Staff,1,0,30,29
1683316179782,PHIL 28,A03,186990,Staff,9,0,30,21
1683316179782,PHIL 28,A04,186991,Staff,26,0,30,4
1683316180808,PHIL 120,A00,186997,Staff,23,0,40,17
1683316181831,PHIL 137,A00,187003,Staff,9,0,40,31
1683316182854,PHIL 150,A00,187015,Staff,47,0,70,23
1683316183877,PHIL 167,A00,187021,Lamey; Andy M.,35,0,40,5
1683316184901,PHIL 174,A01,202226,Staff,17,0,20,3
1683316184901,PHIL 174,A02,202235,Staff,20,0,20,0
1683316185927,PHIL 191A,A00,258918,Staff,0,0,1,1
1683316186953,PHYS 1A,A00,187028,Staff,27,0,60,33
1683316187980,PHYS 1AL,001,187036,Staff,3,0,30,27
1683316187980,PHYS 1AL,002,187049,Staff,18,0,30,12
1683316189004,PHYS 1B,A00,187058,Staff,22,0,60,38
1683316190028,PHYS 1BL,001,187064,Staff,0,0,30,30
1683316190028,PHYS 1BL,002,187070,Staff,5,0,30,25
1683316191052,PHYS 1C,A00,187082,Staff,31,0,120,89
1683316192076,PHYS 1CL,001,187088,Staff,0,9,30,30
1683316192076,PHYS 1CL,002,187089,Staff,0,2,30,30
1683316192076,PHYS 1CL,009,262693,Staff,11,0,30,19
1683316193102,PHYS 2B,A01,187097,Staff,54,0,115,61
1683316194126,PHYS 2C,A01,187099,Staff,67,0,115,48
1683316195148,PHYS 2CL,A01,187101,Staff,5,0,28,23
1683316195148,PHYS 2CL,A02,187102,Staff,15,0,28,13
1683316196177,PHYS 2D,A01,187123,Shotwell; Brian,95,0,115,20
1683316197201,PHYS 4B,A01,187133,Grinstein; Benjamin,35,0,50,15
1683316198225,POLI 10,A00,188819,Staff,0,4,50,50
1683316199252,POLI 11,A00,188827,Staff,43,0,50,7
1683316200275,POLI 13R,A00,188828,Staff,0,1,20,20
1683316201300,POLI 27,A01,188830,Elgin; Samuel Zincke,0,1,70,70
1683316202328,POLI 30,A00,188832,Desposato; Scott,32,0,50,18
1683316203352,POLI 102F,A00,188834,Staff,3,0,40,37
1683316204375,POLI 104A,A00,188852,Staff,14,0,30,16
1683316205399,POLI 104I,A00,188853,Staff,0,6,20,20
1683316206427,POLI 110B,A00,188854,Wiens; David,7,0,20,13
1683316207452,POLI 112A,A00,188855,Wiens; David,5,0,30,25
1683316208478,POLI 117R,A00,188856,Forman; Fonna,0,11,20,20
1683316209503,POLI 118,A00,188857,Ingham; Sean,8,0,20,12
1683316210530,POLI 120G,A00,188858,Staff,9,0,30,21
1683316211556,POLI 131CR,A00,188863,Hoston; Germaine,24,0,50,26
1683316212586,POLI 133,A00,188864,Nellis; Gareth Hb,44,0,50,6
1683316213613,POLI 134D,A00,188865,Desposato; Scott,27,0,30,3
1683316214636,POLI 142A,A00,188871,Gartzke; Erik,22,0,50,28
1683316215660,POLI 142K,A00,188874,Staff,38,0,50,12
1683316216691,POLI 143,A00,188940,Gartzke; Erik,16,0,30,14
1683316217715,POLI 153,A00,188943,Staff,3,0,20,17
1683316218737,POLI 160AA,A00,188944,Staff,12,0,40,28
1683316219760,POLI 170A,A00,188945,Staff,11,0,30,19
1683316221812,PSYC 1,A00,188952,Staff,37,0,90,53
1683316222835,PSYC 2,B00,188953,Staff,19,0,35,16
1683316223864,PSYC 6,A00,188970,Staff,47,0,60,13
1683316224890,PSYC 7,A00,188973,Staff,37,0,45,8
1683316225918,PSYC 60,A01,188980,Rickard; Timothy C.,43,0,60,17
1683316226943,PSYC 70,A01,189001,Steiner; Eric Tomas,24,0,45,21
1683316227972,PSYC 100,A00,189005,Lacefield; Katharine I,0,99,120,120
1683316228998,PSYC 102,A00,189008,Staff,10,0,30,20
1683316230022,PSYC 106,B00,189026,Gorman; Michael R.,36,0,60,24
1683316231046,PSYC 114,B01,189033,Winkielman; Piotr,0,32,30,30
1683316232073,PSYC 131,A00,189036,Anagnostaras; Stephan,0,43,60,60
1683316233100,PSYC 136,A00,189041,Lowe; Angela Beth,0,7,25,25
1683316234127,PSYC 137,A00,189057,Winkielman; Piotr,0,34,25,25
1683316235152,PSYC 144,A00,189107,Wixted; John T,0,7,50,50
1683316237202,PSYC 162,A00,189142,Staff,0,8,85,85
1683316238227,PSYC 172,A00,189144,Gorman; Michael R.,0,7,30,30
1683316240280,PSYC 179,A00,189146,Lacefield; Katharine I,0,84,120,120
1683316241308,PSYC 181,A00,189147,Anagnostaras; Stephan,0,44,90,90
1683316242332,PSYC 190R,A00,189148,Barner; David A.,0,22,80,80
1683316243356,PSYC 191,A00,189275,Rickard; Timothy C.,0,7,25,25
1683316244384,PSYC 193,A00,189276,Chapman; Eddie Nathaniel,0,1,0,4
1683316245411,PSYC 193L,A01,189281,Lowe; Angela Beth,12,0,20,8
1683316245411,PSYC 193L,B01,189285,Staff,28,0,35,7
1683316246441,RELI 149,A00,187137,Rahimi; Babak,7,0,40,33
1683316247467,SE 9,A01,187315,Staff,0,2,18,18
1683316248498,SE 101B,A00,187409,Staff,24,0,30,6
1683316249524,SE 110B,A00,187444,Staff,10,0,40,30
1683316250549,SE 130B,A00,187449,Staff,31,0,40,9
1683316251572,SE 150A,A00,187516,Staff,9,0,20,11
1683316252596,SE 154,A00,187528,Staff,30,0,50,20
1683316253621,SIO 3,A01,258171,Staff,35,0,40,5
1683316254648,SIO 10,A00,187144,Cook; Geoffrey W,0,3,75,75
1683316255671,SIO 45,A00,187152,Cook; Geoffrey W,1,0,100,99
1683316256699,SIO 109R,A00,194486,Staff,0,3,20,20
1683316258747,SIO 187,A01,187233,Kacev; David,12,0,40,28
1683316259777,SOCI 1,A01,258656,Thorpe; Charles Robert,28,0,30,2
1683316259777,SOCI 1,A02,258658,Thorpe; Charles Robert,30,0,30,0
1683316259777,SOCI 1,A03,258661,Thorpe; Charles Robert,25,0,25,0
1683316259777,SOCI 1,A04,258666,Thorpe; Charles Robert,22,0,25,3
1683316259777,SOCI 1,A05,258897,Thorpe; Charles Robert,23,0,25,2
1683316259777,SOCI 1,A06,258898,Thorpe; Charles Robert,25,0,25,0
1683316260802,SOCI 30,A01,258903,Pardo Guerra; Juan Pablo,16,0,30,14
1683316261827,SOCI 102,A00,258904,Staff,9,0,25,16
1683316262851,SOCI 106,A00,258905,Staff,19,0,25,6
1683316263877,SOCI 111,A00,258907,Ribas Norris; Janet Vanesa,26,0,30,4
1683316264903,SOCI 121R,A00,258908,Pardo Guerra; Juan Pablo,11,0,30,19
1683316265931,SOCI 126,A01,203330,Staff,14,0,20,6
1683316266955,SOCI 131,A00,258909,Thorpe; Charles Robert,31,0,60,29
1683316267980,SOCI 135,A00,258910,Payne; Christine Anna,0,9,30,30
1683316269006,SOCI 157,A00,258911,Staff,12,0,30,18
1683316270031,SOCI 184,A00,258912,Staff,25,0,30,5
1683316271056,SOCI 188D,A00,258913,Staff,21,0,30,9
1683316272137,SYN 2,001,187529,Staff,9,0,16,7
1683316272137,SYN 2,002,201452,Staff,0,18,16,16
1683316272137,SYN 2,003,201469,Staff,4,0,16,12
1683316273160,SYN 100,A01,187531,Staff,0,9,20,20
1683316273160,SYN 100,B01,201491,Staff,0,12,20,20
1683316274190,TDAC 1,A00,189286,Walsh; Kim C.,3,0,20,17
1683316274190,TDAC 1,B00,189287,Harting; Carla Kelso,11,0,20,9
1683316275217,TDAC 101,A00,189300,Walsh; Kim C.,16,0,20,4
1683316275217,TDAC 101,B00,189301,Harting; Carla Kelso,18,0,20,2
1683316276240,TDAC 102,A00,189304,Basso; Beatrice,14,0,20,6
1683316277264,TDAC 108,A00,189305,Staff,18,0,20,2
1683316278289,TDDE 131,A00,189310,Staff,19,0,20,1
1683316278289,TDDE 131,B00,189314,Staff,19,0,20,1
1683316278289,TDDE 131,C00,189315,Staff,48,0,50,2
1683316278289,TDDE 131,D00,189316,Staff,14,0,15,1
1683316278289,TDDE 131,E00,204841,Staff,20,0,20,0
1683316279312,TDGE 10,A00,189289,Staff,30,0,50,20
1683316279312,TDGE 10,B00,189290,Havis; Allan,2,0,50,48
1683316280336,TDGE 11,A00,189291,Fulton; Julia,0,3,50,50
1683316280336,TDGE 11,B00,189292,Staff,20,0,25,5
1683316280336,TDGE 11,C00,260270,Staff,0,0,0,0
1683316281363,TDGE 25,A00,189294,Staff,3,0,20,17
1683316282386,TDGE 124,A00,189318,Fulton; Julia,0,8,50,50
1683316283411,TDGE 125,A00,189319,Staff,13,0,25,12
1683316283411,TDGE 125,B00,189320,Staff,23,0,25,2
1683316284437,TDGE 127,A00,189322,Havis; Allan,0,0,50,50
1683316285464,TDHT 101,A00,189323,Staff,18,0,25,7
1683316285464,TDHT 101,B00,189324,Staff,25,0,25,0
1683316286487,TDHT 102,A00,189325,Staff,49,0,50,1
1683316287511,TDMV 1,A00,189295,Arcidiacono; Kristin,20,0,30,10
1683316287511,TDMV 1,B00,189296,Caligagan; Maria T.,24,0,30,6
1683316288535,TDMV 2,A00,189297,Sammartano; Tonnie,28,0,30,2
1683316288535,TDMV 2,B00,189299,Arcidiacono; Kristin,24,0,30,6
1683316289562,TDMV 3,A00,204998,Rincon; Alicia,22,0,30,8
1683316290590,TDMV 120,A00,189458,Sammartano; Tonnie,28,0,30,2
1683316291617,TDMV 138,A00,189541,Jun; Grace Shin Hae,22,0,40,18
1683316292641,TDMV 142,A00,189717,Caligagan; Tony,23,0,30,7
1683316292641,TDMV 142,B00,189718,Caligagan; Maria T.,25,0,30,5
1683316293666,TMC 2,A01,187533,Staff,25,0,25,0
1683316293666,TMC 2,A02,187534,Staff,25,0,25,0
1683316294695,USP 1,A01,187536,Kwak; Nancy,0,16,25,25
1683316295719,USP 5,A01,187538,Staff,9,0,25,16
1683316296747,USP 101,A00,199253,Staff,0,4,0,0
1683316297774,USP 124,A00,187562,Boomhower; Matthew Charles,1,0,30,29
1683316298798,USP 138,A00,187582,Staff,20,0,25,5
1683316299865,USP 152,A01,187597,Staff,4,0,25,21
1683316300893,USP 153,A00,187598,Staff,19,0,25,6
1683316301916,USP 168,A00,187607,Kwak; Nancy,2,0,5,3
1683316302940,USP 173,A00,187619,Staff,4,0,25,21
1683316303967,USP 181,A00,187638,Staff,0,0,25,25
1683316304991,VIS 103,A00,187650,Cruz; Edwin Teddy,23,0,75,52
1683316306016,VIS 110D,A00,187669,Staff,12,0,22,10
1683316307041,VIS 127C,A00,187720,Shen; Kuiyi,68,0,146,78
1683316308066,VIS 149,A00,187731,Yoldas; Pinar,0,14,22,22
1683316309091,VIS 151,A01,188091,Staff,22,0,34,12
1683316309091,VIS 151,A02,188092,Staff,11,0,34,23
1683316310116,VIS 160B,A00,188093,Stalbaum; Brett,0,0,10,10
1683316312169,WCWP 10B,A00,201720,Staff,10,0,15,5
1683316312169,WCWP 10B,B00,201722,Staff,8,0,15,7
1683316313194,WCWP 100,A00,201725,Gagnon; Jeffrey C,0,0,2,2
1683316313194,WCWP 100,B00,201727,Staff,0,4,15,15
1683316316320,ANBI 133,A00,258401,Wilder; Linnea Lorene,34,0,40,6
1683316317353,ANBI 140,A00,258395,Hrvoj Mihic; Branka,18,0,25,7
1683316318380,ANSC 120,A00,258402,Bialecki; Jon Anthony,27,0,40,13
1683316319407,ANSC 144,A00,258400,Staff,14,0,40,26
1683316321463,ANSC 166,A00,258396,Parish; Steven Martin,157,0,175,18
1683316322488,ANSC 180,A00,193533,Staff,9,0,20,11
1683316323513,ANSC 188,A00,258397,Jassal; Aftab,33,0,40,7
1683316324538,ANTH 3,A01,258316,Staff,23,0,30,7
1683316325566,ANTH 5,A00,258394,Semendeferi; Ekaterini,16,0,20,4
1683316326590,ANTH 21,A01,258331,Staff,9,0,40,31
1683316327615,ANTH 103,A00,258398,Varma; Saiba,15,0,25,10
1683316328648,AWP 10,001,202034,Staff,0,0,0,0
1683316328648,AWP 10,002,202035,Staff,0,0,0,0
1683316328648,AWP 10,003,202036,Staff,0,0,0,0
1683316328648,AWP 10,004,202037,Staff,0,0,0,0
1683316328648,AWP 10,005,202038,Staff,0,0,0,0
1683316328648,AWP 10,006,202039,Staff,0,0,0,0
1683316328648,AWP 10,007,202040,Staff,0,0,0,0
1683316328648,AWP 10,008,202041,Staff,0,0,0,0
1683316328648,AWP 10,009,202042,Staff,0,0,0,0
1683316328648,AWP 10,010,202043,Staff,0,0,0,0
1683316328648,AWP 10,011,202044,Staff,0,0,0,0
1683316328648,AWP 10,012,202045,Staff,0,0,0,0
1683316328648,AWP 10,013,202046,Staff,0,0,0,0
1683316328648,AWP 10,014,202047,Staff,0,0,0,0
1683316328648,AWP 10,015,202048,Staff,0,0,0,0
1683316328648,AWP 10,016,202049,Staff,0,0,0,0
1683316328648,AWP 10,017,202050,Staff,0,0,0,0
1683316328648,AWP 10,018,202051,Staff,0,0,0,0
1683316328648,AWP 10,019,202052,Staff,0,0,0,0
1683316328648,AWP 10,020,202053,Staff,0,0,0,0
1683316328648,AWP 10,021,202054,Staff,0,0,0,0
1683316328648,AWP 10,022,202055,Staff,0,0,0,0
1683316328648,AWP 10,023,202056,Staff,0,0,0,0
1683316328648,AWP 10,024,202057,Staff,0,0,0,0
1683316328648,AWP 10,025,202058,Staff,0,0,0,0
1683316328648,AWP 10,026,202059,Staff,0,0,0,0
1683316329671,AWP 102,001,202032,Staff,0,0,0,0
1683316329671,AWP 102,002,202033,Staff,0,0,0,0
1683316330698,BENG 100,A01,254234,Taylor Amos; Alyssa C,31,0,40,9
1683316331725,BENG 196,001,270013,Engler; Adam J.,9999,0,9999,0
1683316332750,BICD 100R,A01,202018,Smith; Laurie,0,7,32,32
1683316332750,BICD 100R,A02,202019,Smith; Laurie,0,2,32,32
1683316332750,BICD 100R,A03,202020,Smith; Laurie,0,1,32,32
1683316332750,BICD 100R,A04,202021,Smith; Laurie,8,0,32,24
1683316332750,BICD 100R,A05,202022,Smith; Laurie,12,0,32,20
1683316333778,BICD 136,A01,193242,Gustafson-Brown; Cindy,0,2,32,32
1683316333778,BICD 136,A02,193244,Gustafson-Brown; Cindy,15,0,32,17
1683316334809,BIEB 102,A01,193249,Butler; Shannon Rhey,0,2,32,32
1683316334809,BIEB 102,A02,193251,Butler; Shannon Rhey,0,0,32,32
1683316334809,BIEB 102,A03,193253,Butler; Shannon Rhey,0,1,32,32
1683316334809,BIEB 102,A04,193255,Butler; Shannon Rhey,17,0,32,15
1683316334809,BIEB 102,A05,193265,Butler; Shannon Rhey,26,0,32,6
1683316334809,BIEB 102,A06,193269,Butler; Shannon Rhey,16,0,32,16
1683316336861,BIEB 150,A01,193274,Staff,0,0,32,32
1683316336861,BIEB 150,A02,193285,Staff,23,0,32,9
1683316337885,BIEB 194,A00,193286,Kurle; Carolyn M.,22,0,32,10
1683316338915,BILD 1,A01,192291,Staff,16,0,32,16
1683316338915,BILD 1,A02,192292,Staff,30,0,32,2
1683316338915,BILD 1,B01,192520,Reuther; Keefe,0,1,0,0
1683316338915,BILD 1,B02,192532,Reuther; Keefe,0,1,0,0
1683316339942,BILD 3,A01,192556,Butler; Shannon Rhey,0,0,32,32
1683316339942,BILD 3,A02,192581,Butler; Shannon Rhey,5,0,32,27
1683316339942,BILD 3,A03,192611,Butler; Shannon Rhey,23,0,32,9
1683316339942,BILD 3,A04,192612,Butler; Shannon Rhey,25,0,32,7
1683316339942,BILD 3,A05,192613,Butler; Shannon Rhey,27,0,32,5
1683316339942,BILD 3,A06,192679,Butler; Shannon Rhey,27,0,32,5
1683316339942,BILD 3,A07,192682,Butler; Shannon Rhey,22,0,32,10
1683316340966,BILD 4,A01,192836,Reuther; Keefe,1,0,24,23
1683316340966,BILD 4,A02,193044,Reuther; Keefe,4,0,24,20
1683316341992,BILD 10,A01,193142,Gustafson-Brown; Cindy,31,0,32,1
1683316341992,BILD 10,A02,193149,Gustafson-Brown; Cindy,31,0,32,1
1683316343016,BIMM 100,A01,193301,Staff,0,6,32,32
1683316343016,BIMM 100,A02,193312,Staff,0,5,32,32
1683316343016,BIMM 100,A03,193323,Staff,0,8,32,32
1683316344048,BIMM 101,A01,193329,McDonnell; Lisa Marie,0,3,24,24
1683316344048,BIMM 101,A02,193339,McDonnell; Lisa Marie,0,2,24,24
1683316344048,BIMM 101,B01,193354,McDonnell; Lisa Marie,0,3,24,24
1683316344048,BIMM 101,B02,193357,McDonnell; Lisa Marie,0,3,24,24
1683316345071,BIMM 110,A01,193377,Tat; John,0,11,32,32
1683316345071,BIMM 110,A02,193378,Tat; John,1,9,32,31
1683316346099,BIMM 120,A01,206116,Staff,0,0,32,32
1683316346099,BIMM 120,A02,206117,Staff,8,0,32,24
1683316346099,BIMM 120,A03,206121,Staff,21,0,32,11
1683316347125,BIPN 100,A01,193393,Park; Ji Young,0,14,32,32
1683316347125,BIPN 100,A02,193402,Park; Ji Young,0,12,32,32
1683316347125,BIPN 100,A03,193413,Park; Ji Young,0,14,32,32
1683316347125,BIPN 100,A04,193414,Park; Ji Young,0,13,32,32
1683316348154,BIPN 102,A01,193429,Staff,0,0,32,32
1683316348154,BIPN 102,A02,193438,Staff,22,0,32,10
1683316349180,BIPN 106,A01,193450,Reyes Gonzalez; Catalina,0,2,40,40
1683316350205,BIPN 134,A01,193465,Cooke; James Edward,0,0,32,32
1683316350205,BIPN 134,A02,193474,Cooke; James Edward,27,0,32,5
1683316350205,BIPN 134,A03,193485,Cooke; James Edward,29,0,32,3
1683316350205,BIPN 134,A04,193486,Cooke; James Edward,21,0,32,11
1683316350205,BIPN 134,A05,193491,Cooke; James Edward,31,0,32,1
1683316350205,BIPN 134,A06,193501,Cooke; James Edward,30,0,32,2
1683316350205,BIPN 134,A07,193510,Cooke; James Edward,29,0,32,3
1683316352256,BISP 194,A00,222522,Staff,16,0,32,16
1683316353279,CAT 124,A01,202407,Staff,20,0,25,5
1683316354307,CAT 125,A00,202408,Marchisotto; Jennifer Anne,4,0,20,16
1683316355334,CAT 125R,A00,202409,Smith; Lauryn Alissa,0,11,20,20
1683316355334,CAT 125R,B00,202410,Morales; Celeste Georgianna,0,11,20,20
1683316355334,CAT 125R,C00,202411,Irwin; Matthew Joseph,0,10,20,20
1683316356359,CENG 15,A01,204712,Yang; Kesong,0,1,0,0
1683316357385,CENG 114,A00,202070,Jahed Motlagh; Zeinab,5,0,20,15
1683316358410,CGS 105,A00,185477,Wesling; Megan E.,24,0,40,16
1683316359437,CGS 106,A00,185494,Staff,13,0,22,9
1683316360461,CGS 108,A00,185495,Staff,14,0,20,6
1683316361484,CGS 114,A00,185496,Staff,13,0,18,5
1683316362509,CGS 119,A00,185501,Staff,15,0,20,5
1683316363534,CGS 120,A00,185511,Staff,13,0,20,7
1683316364559,CHEM 4,A01,184675,Bussey; Thomas J,96,0,100,4
1683316365584,CHEM 6A,A01,184677,Staff,35,0,60,25
1683316366608,CHEM 6B,A01,184679,Staff,65,0,100,35
1683316367639,CHEM 6C,A01,184681,Bussey; Thomas J,1,0,50,49
1683316367639,CHEM 6C,A02,184682,Bussey; Thomas J,34,0,50,16
1683316368662,CHEM 40A,A01,184684,Albizati; Kim F.,37,0,100,63
1683316369689,CHEM 40B,A01,184686,Albizati; Kim F.,0,20,100,100
1683316370717,CHEM 41B,A01,184690,Staff,52,0,100,48
1683316371744,COGS 3,A01,184715,Boyle; Mary E. T.,0,25,40,40
1683316372772,COGS 14B,A01,185172,Staff,0,15,38,38
1683316373801,COGS 18,A01,184736,Staff,18,0,80,62
1683316374826,COGS 100,A01,184932,Staff,0,5,73,73
1683316375909,COGS 101A,A01,184935,Staff,0,38,30,30
1683316376933,COGS 101B,A01,184944,Staff,0,2,30,30
1683316377963,COGS 101C,A01,184946,Staff,0,12,30,30
1683316378991,COGS 102A,A01,184951,Johnson; Christine M.,2,0,40,38
1683316380015,COGS 107B,A01,184953,Mooshagian; Eric Frederick,0,50,40,40
1683316381040,COGS 118B,A01,184959,Gupta; Anjum,0,48,40,40
1683316382068,COGS 153,A00,184961,Staff,0,15,30,30
1683316383096,COGS 177,A00,184962,Staff,0,21,30,30
1683316384121,COGS 187A,A01,184969,Boyle; Mary E. T.,0,17,40,40
1683316385145,COMM 10,A01,185174,Staff,0,5,25,25
1683316385145,COMM 10,A02,185189,Staff,0,5,25,25
1683316385145,COMM 10,A03,269821,Staff,0,0,0,0
1683316386169,COMM 100B,A01,185475,Staff,0,0,0,2
1683316386169,COMM 100B,A02,185476,Staff,14,0,25,11
1683316387195,COMM 100C,A01,185314,Staff,1,0,25,24
1683316387195,COMM 100C,A02,185327,Staff,19,0,25,6
1683316388220,COMM 110M,A00,185349,Staff,2,0,40,38
1683316389248,COMM 113T,A00,185352,Staff,25,0,40,15
1683316390273,COMM 114I,A00,185353,Staff,33,0,40,7
1683316391301,COMM 131,A00,185354,Staff,19,0,30,11
1683316392326,CSE 8A,A50,185358,Cao; Yingjun,0,46,10,10
1683316393350,CSE 8B,A01,185362,Staff,1,47,50,49
1683316394379,CSE 11,A01,185416,Cao; Yingjun,0,92,10,10
1683316395407,CSE 20,A01,185445,Briones; Jor-el Thomas Caparas,5,0,25,20
1683316396432,CSE 21,A01,185447,Staff,10,0,50,40
1683316397457,CSE 101,A01,185451,Staff,0,12,50,50
1683316397457,CSE 101,B01,185453,Jones; Miles E,0,11,50,50
1683316399507,CSE 141,A01,185458,Eldon; John,20,0,100,80
1683316400531,CSE 141L,A01,185461,Eldon; John,12,0,100,88
1683316401561,CSE 142,A01,185463,Staff,36,0,60,24
1683316401561,CSE 142,B01,201355,Staff,0,7,60,60
1683316402585,CSE 142L,A01,185470,Staff,36,0,60,24
1683316402585,CSE 142L,B01,201417,Staff,0,6,60,60
1683316403609,CSE 190,A00,201433,Staff,32,0,49,17
1683316404635,DOC 1,A01,259136,Strom; Megan C.,7,0,15,8
1683316404635,DOC 1,A02,259137,Strom; Megan C.,14,0,15,1
1683316404635,DOC 1,A03,259138,Strom; Megan C.,14,0,15,1
1683316404635,DOC 1,A04,259139,Strom; Megan C.,14,0,15,1
1683316405661,DOC 100D,A00,259140,Pass; Natalye Joann,17,0,25,8
1683316406685,DSGN 1,A01,184749,Rill; Bryan,0,25,30,30
1683316407713,DSGN 100,A01,185168,Staff,0,2,25,25
1683316408737,ECE 5,A01,185626,Morris; Karcher William,0,10,0,0
1683316409761,ECE 101,A01,185628,Staff,17,0,70,53
1683316410787,ECE 107,A01,185635,Baghdadchi; Saharnaz,0,0,20,20
1683316410787,ECE 107,A02,185638,Baghdadchi; Saharnaz,4,0,20,16
1683316411811,ECE 148,A01,185647,Silberman; Jack,0,0,16,16
1683316412836,ECON 1,A01,185537,Crane; Meredith Helen,54,0,70,16
1683316413863,ECON 3,A01,185549,Crane; Meredith Helen,33,0,70,37
1683316414890,ECON 4,A01,203354,Anderson; John Charles,0,4,10,10
1683316415914,ECON 100A,A01,185574,Staff,0,4,40,40
1683316416943,ECON 100B,A01,185576,Staff,0,22,40,40
1683316417968,ECON 100C,A01,185589,Newhouse; Herbert S,30,0,70,40
1683316418998,ECON 105,A00,185608,Vespa; Emanuel Ignacio,19,0,35,16
1683316420026,ECON 109,A01,185610,Shishkin; Denis,10,0,35,25
1683316421053,ECON 110A,A01,185612,Staff,11,0,40,29
1683316422077,ECON 120A,A01,185615,Staff,20,0,40,20
1683316423104,ECON 120C,A01,185617,Sun; Yixiao,0,20,70,70
1683316424131,ECON 144,A00,203346,Squires; Dale E,3,0,35,32
1683316425159,ECON 171,A01,203349,Newhouse; Herbert S,0,1,35,35
1683316426185,ECON 173A,A01,185621,Toda; Alexis Akira,21,0,35,14
1683316427211,EDS 25,A01,202413,Staff,0,1,0,0
1683316427211,EDS 25,A02,202414,Staff,0,1,0,0
1683316427211,EDS 25,A03,202415,Staff,0,0,0,0
1683316427211,EDS 25,A04,202416,Staff,0,1,0,0
1683316427211,EDS 25,A05,202439,Staff,0,0,0,0
1683316427211,EDS 25,A06,202440,Staff,0,0,0,0
1683316427211,EDS 25,B01,202631,Staff,0,0,0,0
1683316427211,EDS 25,B02,202632,Staff,0,0,0,0
1683316427211,EDS 25,B03,202639,Staff,0,0,0,0
1683316427211,EDS 25,B04,202640,Staff,0,0,0,0
1683316427211,EDS 25,B05,202643,Staff,0,0,0,0
1683316427211,EDS 25,B06,202644,Staff,0,0,0,0
1683316428245,EDS 38,A01,202659,Black; Alison Michelle,24,0,25,1
1683316429269,EDS 115,A00,202652,Staff,17,0,30,13
1683316430294,EDS 125,A00,202649,Staff,14,0,30,16
1683316431319,EDS 126,A01,203332,Staff,30,0,30,0
1683316432346,EDS 139,A00,202838,Staff,16,0,25,9
1683316433371,EDS 146,A01,202655,Staff,14,0,25,11
1683316434397,ENG 15,A00,185667,Staff,0,1,0,0
1683316434397,ENG 15,B00,185672,Staff,0,0,0,0
1683316434397,ENG 15,C00,185675,Staff,0,0,0,0
1683316434397,ENG 15,D00,185682,Staff,0,0,0,0
1683316434397,ENG 15,E00,185684,Staff,0,0,0,0
1683316435421,ETHN 103,A00,185710,Staff,0,3,35,35
1683316436449,ETHN 103A,A00,199228,Man; Simeon S,2,0,9,7
1683316437476,ETHN 109,A00,185711,Staff,18,0,35,17
1683316438504,ETHN 142,A00,185726,Staff,0,4,30,30
1683316439527,ETHN 163J,A00,199229,Man; Simeon S,5,0,8,3
1683316440551,ETHN 168,A00,185727,Staff,8,0,10,2
1683316441576,ETHN 182,A00,185728,Staff,1,0,35,34
1683316442604,ETHN 183,A00,185737,Staff,8,0,18,10
1683316443632,GLBH 111,A01,209361,Burgos; Jose L.,0,0,0,0
1683316445684,HIEU 104,A00,185792,Staff,16,0,20,4
1683316446709,HIEU 115,A00,185800,Staff,1,0,20,19
1683316447736,HIEU 128,A00,185801,Staff,0,7,20,20
1683316448763,HIEU 147,A00,185802,Staff,16,0,20,4
1683316449788,HIEU 154,A00,185823,Staff,12,0,20,8
1683316450814,HILA 102,A00,185826,Staff,13,0,20,7
1683316451843,HILD 2C,A01,185778,Staff,0,12,20,20
1683316452869,HILD 7B,A01,185780,Kwak; Nancy,0,15,32,32
1683316452869,HILD 7B,A02,185781,Kwak; Nancy,0,18,32,32
1683316453896,HILD 30,A01,185791,Staff,14,0,20,6
1683316454920,HISC 119,A00,185830,Golan; Tal,0,9,20,20
1683316455945,HITO 156GS,A00,185831,Patterson; Patrick H.,0,0,0,23
1683316456969,HIUS 103,A00,185832,Man; Simeon S,0,6,20,20
1683316457994,HIUS 117,A00,185836,Kwak; Nancy,2,0,20,18
1683316459019,HIUS 125,A00,185840,Man; Simeon S,0,0,23,23
1683316460044,HIUS 149,A00,185845,Staff,0,0,20,20
1683316461069,HUM 3,A01,185882,Zavodny; Tatiana Sophia,0,6,50,50
1683316461069,HUM 3,B01,185899,Caldwell; Michael Alan,0,19,50,50
1683316462096,HUM 3GS,A00,185900,Patterson; Patrick H.,0,0,0,23
1683316463125,HUM 4,A01,185938,Zroka; Amy Liane,31,0,50,19
1683316463125,HUM 4,B01,185956,Watkins; Eric,0,2,50,50
1683316463125,HUM 4,B02,202209,Watkins; Eric,0,2,50,50
1683316463125,HUM 4,B03,202210,Watkins; Eric,0,0,50,50
1683316464152,HUM 5,A01,185958,West; Geoffrey Scott,4,0,50,46
1683316464152,HUM 5,A02,202215,West; Geoffrey Scott,0,0,50,50
1683316465181,INTL 190,A00,185959,Gagnon; Jeffrey C,0,0,0,9
1683316465181,INTL 190,B00,185960,Lettieri; Michael Joseph,0,0,0,1
1683316466209,JAPN 180,A00,254509,Staff,5,1,30,25
1683316467238,LATI 10,A01,202853,Kennemore; Amy Michelle,5,0,35,30
1683316467238,LATI 10,A02,202854,Kennemore; Amy Michelle,1,0,35,34
1683316467238,LATI 10,A03,270054,Kennemore; Amy Michelle,30,0,30,0
1683316468262,LATI 180,A00,202855,Kennemore; Amy Michelle,11,0,20,9
1683316469287,LAWS 101,A00,201767,Golan; Tal,0,7,40,40
1683316470312,LIFR 1C,A00,185961,Staff,6,0,20,14
1683316471335,LIFR 1CX,A00,185962,Staff,7,0,20,13
1683316472359,LIFR 1D,A00,185963,Staff,9,0,20,11
1683316473387,LIFR 1DX,A00,185964,Staff,9,0,20,11
1683316474412,LIGN 101,A01,186039,Staff,43,0,50,7
1683316475439,LIGN 165,A00,186040,Staff,18,0,50,32
1683316476466,LTCS 108,A00,186041,Staff,6,0,10,4
1683316477492,LTCS 119,A00,186042,Staff,16,0,20,4
1683316478517,LTCS 130,A00,186043,Wesling; Megan E.,15,0,25,10
1683316480626,LTEA 138,A00,186119,Staff,14,0,40,26
1683316481650,LTEN 124,A00,186148,Staff,6,0,25,19
1683316482677,LTEN 178,A00,186149,Staff,7,0,15,8
1683316483704,LTEN 181,A00,186150,Blanco; John D,33,0,40,7
1683316484731,LTWL 120,A00,186160,Staff,20,0,25,5
1683316485755,LTWL 165,A00,186161,Staff,22,0,25,3
1683316486781,LTWR 100,A00,186162,Staff,0,4,15,15
1683316487804,LTWR 102,A00,186163,Doller; Ben,5,0,15,10
1683316488833,MAE 8,A01,186412,Staff,0,0,0,0
1683316489860,MAE 30B,A00,186445,Bahadori; Mohammad Yousef,83,0,100,17
1683316490887,MAE 40,A00,186592,Bewley; Thomas R,9,0,50,41
1683316491911,MAE 101B,A00,186593,Bahadori; Mohammad Yousef,81,0,100,19
1683316492935,MAE 105,A00,186594,Bandaru; Prabhakar,12,0,50,38
1683316493963,MAE 107,A00,186599,Pham; Hieu Tan,0,6,120,120
1683316494990,MAE 148,A01,186660,Silberman; Jack,3,0,16,13
1683316496013,MATH 10A,A01,188095,Staff,0,6,35,35
1683316497039,MATH 10B,A01,188097,Bowers; Adam R.,0,11,30,30
1683316497039,MATH 10B,A02,188099,Bowers; Adam R.,0,11,30,30
1683316497039,MATH 10B,B01,188104,Bowers; Adam R.,0,10,30,30
1683316497039,MATH 10B,B02,188106,Bowers; Adam R.,0,10,30,30
1683316498063,MATH 10C,A01,188111,Staff,0,18,30,30
1683316498063,MATH 10C,A02,188127,Staff,0,17,30,30
1683316498063,MATH 10C,A03,188131,Staff,0,18,30,30
1683316498063,MATH 10C,B01,188218,Staff,20,0,30,10
1683316498063,MATH 10C,B02,188244,Staff,13,0,30,17
1683316498063,MATH 10C,B03,188277,Staff,16,0,30,14
1683316499088,MATH 18,A01,188344,Bach; Quang Tran,18,0,30,12
1683316499088,MATH 18,A02,188345,Bach; Quang Tran,11,0,30,19
1683316499088,MATH 18,B01,188353,Bach; Quang Tran,10,0,30,20
1683316499088,MATH 18,B02,188354,Bach; Quang Tran,20,0,30,10
1683316500111,MATH 20A,A01,188374,Staff,13,0,35,22
1683316501137,MATH 20B,A01,188382,Ohm; Ko Woon,6,0,30,24
1683316501137,MATH 20B,A02,188383,Ohm; Ko Woon,23,0,30,7
1683316501137,MATH 20B,B01,188385,Ohm; Ko Woon,7,0,30,23
1683316501137,MATH 20B,B02,188392,Ohm; Ko Woon,22,0,30,8
1683316502165,MATH 20C,A01,188394,Harel; Guershon,10,0,30,20
1683316502165,MATH 20C,A02,188395,Harel; Guershon,14,0,30,16
1683316502165,MATH 20C,B01,188404,Harel; Guershon,5,0,30,25
1683316502165,MATH 20C,B02,188405,Harel; Guershon,19,0,30,11
1683316503198,MATH 20D,A01,188414,Hammock; Frances H,0,1,30,30
1683316503198,MATH 20D,A02,188415,Hammock; Frances H,3,0,30,27
1683316503198,MATH 20D,B01,188447,Hammock; Frances H,2,0,30,28
1683316503198,MATH 20D,B02,188486,Hammock; Frances H,8,0,30,22
1683316504227,MATH 20E,A01,188649,Staff,21,0,30,9
1683316504227,MATH 20E,A02,188650,Staff,23,0,30,7
1683316504227,MATH 20E,A03,188673,Staff,0,0,30,30
1683316505253,MATH 102,A01,188675,Staff,0,35,35,35
1683316506276,MATH 103B,A01,188681,Staff,4,0,35,31
1683316506276,MATH 103B,B01,188692,Staff,5,0,35,30
1683316507305,MATH 109,A01,188695,Salehi Golsefidy; Alireza,25,0,35,10
1683316507305,MATH 109,A02,188696,Salehi Golsefidy; Alireza,26,0,35,9
1683316508329,MATH 120A,A01,188698,Eggers; John Dietrich,7,0,35,28
1683316509358,MATH 142B,A01,188736,Ioana; Adrian,0,2,30,30
1683316509358,MATH 142B,A02,188741,Ioana; Adrian,0,1,30,30
1683316509358,MATH 142B,A03,188743,Ioana; Adrian,1,3,30,29
1683316510381,MATH 168A,A01,188790,Staff,0,9,35,35
1683316511411,MATH 170A,A01,188803,Nie; Jiawang,0,2,35,35
1683316511411,MATH 170A,A02,188811,Nie; Jiawang,0,0,35,35
1683316511411,MATH 170A,A03,188814,Nie; Jiawang,0,0,35,35
1683316511411,MATH 170A,A04,188815,Nie; Jiawang,13,0,35,22
1683316512434,MATH 193B,A01,188817,Staff,0,0,35,35
1683316512434,MATH 193B,A02,188818,Staff,6,0,35,29
1683316513458,MGT 4,A01,202857,Anderson; John Charles,62,0,80,18
1683316514485,MGT 12,A00,202858,Lindenberger; Wade Douglas,43,0,90,47
1683316515512,MGT 18,A00,202859,Staff,74,0,90,16
1683316516534,MGT 18GS,A00,202860,McKay; Michael J,13,0,28,15
1683316517560,MGT 45,A00,202861,Pecore; Joseph P.,13,0,90,77
1683316518585,MGT 100,A00,202863,Yavorsky; Daniel Ryan,28,0,90,62
1683316519610,MGT 103,A00,202864,Ehrich; Kristine R,0,16,90,90
1683316520634,MGT 112,A00,202865,Ehrich; Kristine R,15,0,90,75
1683316521661,MGT 121A,A00,202868,Staff,0,19,0,0
1683316522684,MGT 131B,A00,202869,Anderson; John Charles,59,0,90,31
1683316523710,MGT 136,A00,202871,Lindenberger; Wade Douglas,84,0,90,6
1683316524738,MGT 164,A00,202873,Staff,0,68,90,90
1683316525762,MGT 164GS,A00,202874,McKay; Mary A,13,0,28,15
1683316526786,MGT 180,A00,202875,Staff,0,50,90,90
1683316527810,MMW 11R,A01,205019,Herbst; Matthew,3,0,30,27
1683316527810,MMW 11R,A02,205026,Herbst; Matthew,29,0,30,1
1683316528840,MMW 15,A01,193512,Chang; Edmond Yi-Teh,0,9,28,28
1683316528840,MMW 15,A02,193513,Chang; Edmond Yi-Teh,0,5,28,28
1683316528840,MMW 15,A03,193514,Chang; Edmond Yi-Teh,0,5,28,28
1683316528840,MMW 15,A04,193515,Chang; Edmond Yi-Teh,0,5,28,28
1683316528840,MMW 15,A05,193516,Chang; Edmond Yi-Teh,0,4,28,28
1683316528840,MMW 15,A06,193517,Chang; Edmond Yi-Teh,0,5,28,28
1683316528840,MMW 15,B01,193519,Chang; Edmond Yi-Teh,0,4,28,28
1683316528840,MMW 15,B02,193520,Chang; Edmond Yi-Teh,0,5,28,28
1683316528840,MMW 15,B03,193521,Chang; Edmond Yi-Teh,0,4,28,28
1683316528840,MMW 15,B04,193522,Chang; Edmond Yi-Teh,0,4,28,28
1683316528840,MMW 15,B05,193523,Chang; Edmond Yi-Teh,0,5,28,28
1683316528840,MMW 15,B06,193524,Chang; Edmond Yi-Teh,0,4,28,28
1683316529864,MMW 122,A01,193526,Rahimi; Babak,0,14,28,28
1683316529864,MMW 122,A02,193527,Rahimi; Babak,0,14,28,28
1683316529864,MMW 122,A03,193528,Rahimi; Babak,0,0,0,0
1683316529864,MMW 122,A04,193529,Rahimi; Babak,0,0,0,0
1683316530889,MUS 1A,A01,186663,Staff,0,20,35,35
1683316531913,MUS 4,A01,186715,Staff,0,12,35,35
1683316532939,MUS 5R,A01,186796,Dubnov; Shlomo,0,17,35,35
1683316533962,MUS 6,A01,186798,Staff,0,3,25,25
1683316534989,MUS 7,A01,186830,Staff,12,0,35,23
1683316536012,MUS 8,A01,186930,Staff,0,26,35,35
1683316537036,MUS 15,A01,186932,Staff,0,15,35,35
1683316537036,MUS 15,B01,186934,Staff,0,15,35,35
1683316538060,MUS 80,A00,186935,Staff,2,0,20,18
1683316538060,MUS 80,B00,186936,Staff,25,0,25,0
1683316539084,NANO 11,A00,204702,Lipomi; Darren John,0,0,0,0
1683316540112,NANO 15,A01,204709,Yang; Kesong,0,1,0,0
1683316541138,NANO 114,A00,202069,Jahed Motlagh; Zeinab,3,0,10,7
1683316542162,PHIL 1,A00,186955,Grush; Rick Scott,32,0,40,8
1683316543190,PHIL 10,A01,186973,Grush; Rick Scott,28,0,35,7
1683316543190,PHIL 10,A02,186974,Grush; Rick Scott,33,0,35,2
1683316544214,PHIL 13,A01,186976,Staff,7,0,35,28
1683316544214,PHIL 13,A02,186977,Staff,16,0,35,19
1683316545238,PHIL 14,A01,186979,Staff,31,0,35,4
1683316545238,PHIL 14,A02,186986,Staff,32,0,35,3
1683316546266,PHIL 28,A01,186988,Staff,16,0,30,14
1683316546266,PHIL 28,A02,186989,Staff,1,0,30,29
1683316546266,PHIL 28,A03,186990,Staff,9,0,30,21
1683316546266,PHIL 28,A04,186991,Staff,26,0,30,4
1683316547289,PHIL 120,A00,186997,Staff,23,0,40,17
1683316548316,PHIL 137,A00,187003,Staff,9,0,40,31
1683316549341,PHIL 150,A00,187015,Staff,47,0,70,23
1683316550365,PHIL 167,A00,187021,Lamey; Andy M.,35,0,40,5
1683316551388,PHIL 174,A01,202226,Staff,17,0,20,3
1683316551388,PHIL 174,A02,202235,Staff,20,0,20,0
1683316552411,PHIL 191A,A00,258918,Staff,0,0,1,1
1683316553436,PHYS 1A,A00,187028,Staff,27,0,60,33
1683316554463,PHYS 1AL,001,187036,Staff,3,0,30,27
1683316554463,PHYS 1AL,002,187049,Staff,18,0,30,12
1683316555490,PHYS 1B,A00,187058,Staff,22,0,60,38
1683316556518,PHYS 1BL,001,187064,Staff,0,0,30,30
1683316556518,PHYS 1BL,002,187070,Staff,5,0,30,25
1683316557544,PHYS 1C,A00,187082,Staff,31,0,120,89
1683316558568,PHYS 1CL,001,187088,Staff,0,9,30,30
1683316558568,PHYS 1CL,002,187089,Staff,0,2,30,30
1683316558568,PHYS 1CL,009,262693,Staff,11,0,30,19
1683316559597,PHYS 2B,A01,187097,Staff,54,0,115,61
1683316560623,PHYS 2C,A01,187099,Staff,67,0,115,48
1683316561653,PHYS 2CL,A01,187101,Staff,5,0,28,23
1683316561653,PHYS 2CL,A02,187102,Staff,15,0,28,13
1683316562681,PHYS 2D,A01,187123,Shotwell; Brian,95,0,115,20
1683316563710,PHYS 4B,A01,187133,Grinstein; Benjamin,35,0,50,15
1683316564736,POLI 10,A00,188819,Staff,0,4,50,50
1683316565764,POLI 11,A00,188827,Staff,43,0,50,7
1683316566787,POLI 13R,A00,188828,Staff,0,1,20,20
1683316567811,POLI 27,A01,188830,Elgin; Samuel Zincke,0,1,70,70
1683316568839,POLI 30,A00,188832,Desposato; Scott,32,0,50,18
1683316569866,POLI 102F,A00,188834,Staff,3,0,40,37
1683316570890,POLI 104A,A00,188852,Staff,14,0,30,16
1683316571915,POLI 104I,A00,188853,Staff,0,6,20,20
1683316572938,POLI 110B,A00,188854,Wiens; David,7,0,20,13
1683316573965,POLI 112A,A00,188855,Wiens; David,5,0,30,25
1683316574989,POLI 117R,A00,188856,Forman; Fonna,0,11,20,20
1683316576017,POLI 118,A00,188857,Ingham; Sean,8,0,20,12
1683316577046,POLI 120G,A00,188858,Staff,9,0,30,21
1683316578073,POLI 131CR,A00,188863,Hoston; Germaine,24,0,50,26
1683316579097,POLI 133,A00,188864,Nellis; Gareth Hb,44,0,50,6
1683316580122,POLI 134D,A00,188865,Desposato; Scott,27,0,30,3
1683316581148,POLI 142A,A00,188871,Gartzke; Erik,22,0,50,28
1683316582174,POLI 142K,A00,188874,Staff,38,0,50,12
1683316583275,POLI 143,A00,188940,Gartzke; Erik,16,0,30,14
1683316584301,POLI 153,A00,188943,Staff,3,0,20,17
1683316585329,POLI 160AA,A00,188944,Staff,12,0,40,28
1683316586358,POLI 170A,A00,188945,Staff,11,0,30,19
1683316588409,PSYC 1,A00,188952,Staff,37,0,90,53
1683316589433,PSYC 2,B00,188953,Staff,19,0,35,16
1683316590457,PSYC 6,A00,188970,Staff,47,0,60,13
1683316591484,PSYC 7,A00,188973,Staff,37,0,45,8
1683316592511,PSYC 60,A01,188980,Rickard; Timothy C.,43,0,60,17
1683316593536,PSYC 70,A01,189001,Steiner; Eric Tomas,24,0,45,21
1683316594559,PSYC 100,A00,189005,Lacefield; Katharine I,0,99,120,120
1683316595584,PSYC 102,A00,189008,Staff,10,0,30,20
1683316596609,PSYC 106,B00,189026,Gorman; Michael R.,36,0,60,24
1683316597637,PSYC 114,B01,189033,Winkielman; Piotr,0,32,30,30
1683316598665,PSYC 131,A00,189036,Anagnostaras; Stephan,0,43,60,60
1683316599692,PSYC 136,A00,189041,Lowe; Angela Beth,0,7,25,25
1683316600720,PSYC 137,A00,189057,Winkielman; Piotr,0,34,25,25
1683316601744,PSYC 144,A00,189107,Wixted; John T,0,7,50,50
1683316603798,PSYC 162,A00,189142,Staff,0,8,85,85
1683316604823,PSYC 172,A00,189144,Gorman; Michael R.,0,7,30,30
1683316606878,PSYC 179,A00,189146,Lacefield; Katharine I,0,84,120,120
1683316607903,PSYC 181,A00,189147,Anagnostaras; Stephan,0,44,90,90
1683316608927,PSYC 190R,A00,189148,Barner; David A.,0,22,80,80
1683316609955,PSYC 191,A00,189275,Rickard; Timothy C.,0,7,25,25
1683316610982,PSYC 193,A00,189276,Chapman; Eddie Nathaniel,0,1,0,4
1683316612012,PSYC 193L,A01,189281,Lowe; Angela Beth,12,0,20,8
1683316612012,PSYC 193L,B01,189285,Staff,28,0,35,7
1683316613043,RELI 149,A00,187137,Rahimi; Babak,7,0,40,33
1683316614069,SE 9,A01,187315,Staff,0,2,18,18
1683316615095,SE 101B,A00,187409,Staff,24,0,30,6
1683316616123,SE 110B,A00,187444,Staff,10,0,40,30
1683316617148,SE 130B,A00,187449,Staff,31,0,40,9
1683316618173,SE 150A,A00,187516,Staff,9,0,20,11
1683316619197,SE 154,A00,187528,Staff,30,0,50,20
1683316620224,SIO 3,A01,258171,Staff,35,0,40,5
1683316621248,SIO 10,A00,187144,Cook; Geoffrey W,0,3,75,75
1683316622273,SIO 45,A00,187152,Cook; Geoffrey W,1,0,100,99
1683316623297,SIO 109R,A00,194486,Staff,0,3,20,20
1683316625349,SIO 187,A01,187233,Kacev; David,12,0,40,28
1683316626374,SOCI 1,A01,258656,Thorpe; Charles Robert,28,0,30,2
1683316626374,SOCI 1,A02,258658,Thorpe; Charles Robert,30,0,30,0
1683316626374,SOCI 1,A03,258661,Thorpe; Charles Robert,25,0,25,0
1683316626374,SOCI 1,A04,258666,Thorpe; Charles Robert,22,0,25,3
1683316626374,SOCI 1,A05,258897,Thorpe; Charles Robert,23,0,25,2
1683316626374,SOCI 1,A06,258898,Thorpe; Charles Robert,25,0,25,0
1683316627398,SOCI 30,A01,258903,Pardo Guerra; Juan Pablo,16,0,30,14
1683316628423,SOCI 102,A00,258904,Staff,9,0,25,16
1683316629447,SOCI 106,A00,258905,Staff,19,0,25,6
1683316630471,SOCI 111,A00,258907,Ribas Norris; Janet Vanesa,26,0,30,4
1683316631497,SOCI 121R,A00,258908,Pardo Guerra; Juan Pablo,11,0,30,19
1683316632522,SOCI 126,A01,203330,Staff,14,0,20,6
1683316633547,SOCI 131,A00,258909,Thorpe; Charles Robert,31,0,60,29
1683316634576,SOCI 135,A00,258910,Payne; Christine Anna,0,9,30,30
1683316635603,SOCI 157,A00,258911,Staff,12,0,30,18
1683316636627,SOCI 184,A00,258912,Staff,25,0,30,5
1683316637654,SOCI 188D,A00,258913,Staff,21,0,30,9
1683316638678,SYN 2,001,187529,Staff,9,0,16,7
1683316638678,SYN 2,002,201452,Staff,0,18,16,16
1683316638678,SYN 2,003,201469,Staff,4,0,16,12
1683316639703,SYN 100,A01,187531,Staff,0,9,20,20
1683316639703,SYN 100,B01,201491,Staff,0,12,20,20
1683316640726,TDAC 1,A00,189286,Walsh; Kim C.,3,0,20,17
1683316640726,TDAC 1,B00,189287,Harting; Carla Kelso,11,0,20,9
1683316641753,TDAC 101,A00,189300,Walsh; Kim C.,16,0,20,4
1683316641753,TDAC 101,B00,189301,Harting; Carla Kelso,18,0,20,2
1683316642781,TDAC 102,A00,189304,Basso; Beatrice,14,0,20,6
1683316643805,TDAC 108,A00,189305,Staff,18,0,20,2
1683316644832,TDDE 131,A00,189310,Staff,19,0,20,1
1683316644832,TDDE 131,B00,189314,Staff,19,0,20,1
1683316644832,TDDE 131,C00,189315,Staff,48,0,50,2
1683316644832,TDDE 131,D00,189316,Staff,14,0,15,1
1683316644832,TDDE 131,E00,204841,Staff,20,0,20,0
1683316645858,TDGE 10,A00,189289,Staff,30,0,50,20
1683316645858,TDGE 10,B00,189290,Havis; Allan,2,0,50,48
1683316646886,TDGE 11,A00,189291,Fulton; Julia,0,3,50,50
1683316646886,TDGE 11,B00,189292,Staff,20,0,25,5
1683316646886,TDGE 11,C00,260270,Staff,0,0,0,0
1683316647911,TDGE 25,A00,189294,Staff,3,0,20,17
1683316648940,TDGE 124,A00,189318,Fulton; Julia,0,8,50,50
1683316649973,TDGE 125,A00,189319,Staff,13,0,25,12
1683316649973,TDGE 125,B00,189320,Staff,23,0,25,2
1683316650998,TDGE 127,A00,189322,Havis; Allan,0,0,50,50
1683316652024,TDHT 101,A00,189323,Staff,18,0,25,7
1683316652024,TDHT 101,B00,189324,Staff,25,0,25,0
1683316653051,TDHT 102,A00,189325,Staff,49,0,50,1
1683316654075,TDMV 1,A00,189295,Arcidiacono; Kristin,20,0,30,10
1683316654075,TDMV 1,B00,189296,Caligagan; Maria T.,24,0,30,6
1683316655104,TDMV 2,A00,189297,Sammartano; Tonnie,28,0,30,2
1683316655104,TDMV 2,B00,189299,Arcidiacono; Kristin,24,0,30,6
1683316656127,TDMV 3,A00,204998,Rincon; Alicia,22,0,30,8
1683316657150,TDMV 120,A00,189458,Sammartano; Tonnie,28,0,30,2
1683316658177,TDMV 138,A00,189541,Jun; Grace Shin Hae,22,0,40,18
1683316659205,TDMV 142,A00,189717,Caligagan; Tony,23,0,30,7
1683316659205,TDMV 142,B00,189718,Caligagan; Maria T.,25,0,30,5
1683316660228,TMC 2,A01,187533,Staff,25,0,25,0
1683316660228,TMC 2,A02,187534,Staff,25,0,25,0
1683316661256,USP 1,A01,187536,Kwak; Nancy,0,16,25,25
1683316662283,USP 5,A01,187538,Staff,9,0,25,16
1683316663310,USP 101,A00,199253,Staff,0,4,0,0
1683316664335,USP 124,A00,187562,Boomhower; Matthew Charles,1,0,30,29
1683316665360,USP 138,A00,187582,Staff,20,0,25,5
1683316666387,USP 152,A01,187597,Staff,4,0,25,21
1683316667413,USP 153,A00,187598,Staff,19,0,25,6
1683316668437,USP 168,A00,187607,Kwak; Nancy,2,0,5,3
1683316669464,USP 173,A00,187619,Staff,4,0,25,21
1683316670491,USP 181,A00,187638,Staff,0,0,25,25
1683316671520,VIS 103,A00,187650,Cruz; Edwin Teddy,23,0,75,52
1683316672547,VIS 110D,A00,187669,Staff,12,0,22,10
1683316673573,VIS 127C,A00,187720,Shen; Kuiyi,68,0,146,78
1683316674599,VIS 149,A00,187731,Yoldas; Pinar,0,14,22,22
1683316675623,VIS 151,A01,188091,Staff,22,0,34,12
1683316675623,VIS 151,A02,188092,Staff,11,0,34,23
1683316676651,VIS 160B,A00,188093,Stalbaum; Brett,0,0,10,10
1683316678700,WCWP 10B,A00,201720,Staff,10,0,15,5
1683316678700,WCWP 10B,B00,201722,Staff,8,0,15,7
1683316679722,WCWP 100,A00,201725,Gagnon; Jeffrey C,0,0,2,2
1683316679722,WCWP 100,B00,201727,Staff,0,4,15,15
1683316682814,ANBI 133,A00,258401,Wilder; Linnea Lorene,34,0,40,6
1683316683837,ANBI 140,A00,258395,Hrvoj Mihic; Branka,18,0,25,7
1683316684862,ANSC 120,A00,258402,Bialecki; Jon Anthony,27,0,40,13
1683316685886,ANSC 144,A00,258400,Staff,14,0,40,26
1683316687991,ANSC 166,A00,258396,Parish; Steven Martin,157,0,175,18
1683316689018,ANSC 180,A00,193533,Staff,9,0,20,11
1683316690046,ANSC 188,A00,258397,Jassal; Aftab,33,0,40,7
1683316691068,ANTH 3,A01,258316,Staff,23,0,30,7
1683316692096,ANTH 5,A00,258394,Semendeferi; Ekaterini,16,0,20,4
1683316693119,ANTH 21,A01,258331,Staff,9,0,40,31
1683316694148,ANTH 103,A00,258398,Varma; Saiba,15,0,25,10
1683316695184,AWP 10,001,202034,Staff,0,0,0,0
1683316695184,AWP 10,002,202035,Staff,0,0,0,0
1683316695184,AWP 10,003,202036,Staff,0,0,0,0
1683316695184,AWP 10,004,202037,Staff,0,0,0,0
1683316695184,AWP 10,005,202038,Staff,0,0,0,0
1683316695184,AWP 10,006,202039,Staff,0,0,0,0
1683316695184,AWP 10,007,202040,Staff,0,0,0,0
1683316695184,AWP 10,008,202041,Staff,0,0,0,0
1683316695184,AWP 10,009,202042,Staff,0,0,0,0
1683316695184,AWP 10,010,202043,Staff,0,0,0,0
1683316695184,AWP 10,011,202044,Staff,0,0,0,0
1683316695184,AWP 10,012,202045,Staff,0,0,0,0
1683316695184,AWP 10,013,202046,Staff,0,0,0,0
1683316695184,AWP 10,014,202047,Staff,0,0,0,0
1683316695184,AWP 10,015,202048,Staff,0,0,0,0
1683316695184,AWP 10,016,202049,Staff,0,0,0,0
1683316695184,AWP 10,017,202050,Staff,0,0,0,0
1683316695184,AWP 10,018,202051,Staff,0,0,0,0
1683316695184,AWP 10,019,202052,Staff,0,0,0,0
1683316695184,AWP 10,020,202053,Staff,0,0,0,0
1683316695184,AWP 10,021,202054,Staff,0,0,0,0
1683316695184,AWP 10,022,202055,Staff,0,0,0,0
1683316695184,AWP 10,023,202056,Staff,0,0,0,0
1683316695184,AWP 10,024,202057,Staff,0,0,0,0
1683316695184,AWP 10,025,202058,Staff,0,0,0,0
1683316695184,AWP 10,026,202059,Staff,0,0,0,0
1683316696212,AWP 102,001,202032,Staff,0,0,0,0
1683316696212,AWP 102,002,202033,Staff,0,0,0,0
1683316697240,BENG 100,A01,254234,Taylor Amos; Alyssa C,31,0,40,9
1683316698269,BENG 196,001,270013,Engler; Adam J.,9999,0,9999,0
1683316699294,BICD 100R,A01,202018,Smith; Laurie,0,7,32,32
1683316699294,BICD 100R,A02,202019,Smith; Laurie,0,2,32,32
1683316699294,BICD 100R,A03,202020,Smith; Laurie,0,1,32,32
1683316699294,BICD 100R,A04,202021,Smith; Laurie,8,0,32,24
1683316699294,BICD 100R,A05,202022,Smith; Laurie,12,0,32,20
1683316700320,BICD 136,A01,193242,Gustafson-Brown; Cindy,0,2,32,32
1683316700320,BICD 136,A02,193244,Gustafson-Brown; Cindy,15,0,32,17
1683316701344,BIEB 102,A01,193249,Butler; Shannon Rhey,0,2,32,32
1683316701344,BIEB 102,A02,193251,Butler; Shannon Rhey,0,0,32,32
1683316701344,BIEB 102,A03,193253,Butler; Shannon Rhey,0,1,32,32
1683316701344,BIEB 102,A04,193255,Butler; Shannon Rhey,17,0,32,15
1683316701344,BIEB 102,A05,193265,Butler; Shannon Rhey,26,0,32,6
1683316701344,BIEB 102,A06,193269,Butler; Shannon Rhey,16,0,32,16
1683316703396,BIEB 150,A01,193274,Staff,0,0,32,32
1683316703396,BIEB 150,A02,193285,Staff,23,0,32,9
1683316704421,BIEB 194,A00,193286,Kurle; Carolyn M.,22,0,32,10
1683316705450,BILD 1,A01,192291,Staff,16,0,32,16
1683316705450,BILD 1,A02,192292,Staff,30,0,32,2
1683316705450,BILD 1,B01,192520,Reuther; Keefe,0,1,0,0
1683316705450,BILD 1,B02,192532,Reuther; Keefe,0,1,0,0
1683316706479,BILD 3,A01,192556,Butler; Shannon Rhey,0,0,32,32
1683316706479,BILD 3,A02,192581,Butler; Shannon Rhey,5,0,32,27
1683316706479,BILD 3,A03,192611,Butler; Shannon Rhey,23,0,32,9
1683316706479,BILD 3,A04,192612,Butler; Shannon Rhey,25,0,32,7
1683316706479,BILD 3,A05,192613,Butler; Shannon Rhey,27,0,32,5
1683316706479,BILD 3,A06,192679,Butler; Shannon Rhey,27,0,32,5
1683316706479,BILD 3,A07,192682,Butler; Shannon Rhey,22,0,32,10
1683316707505,BILD 4,A01,192836,Reuther; Keefe,1,0,24,23
1683316707505,BILD 4,A02,193044,Reuther; Keefe,4,0,24,20
1683316708529,BILD 10,A01,193142,Gustafson-Brown; Cindy,30,0,32,2
1683316708529,BILD 10,A02,193149,Gustafson-Brown; Cindy,31,0,32,1
1683316709554,BIMM 100,A01,193301,Staff,0,6,32,32
1683316709554,BIMM 100,A02,193312,Staff,0,5,32,32
1683316709554,BIMM 100,A03,193323,Staff,0,8,32,32
1683316710581,BIMM 101,A01,193329,McDonnell; Lisa Marie,0,3,24,24
1683316710581,BIMM 101,A02,193339,McDonnell; Lisa Marie,0,2,24,24
1683316710581,BIMM 101,B01,193354,McDonnell; Lisa Marie,0,3,24,24
1683316710581,BIMM 101,B02,193357,McDonnell; Lisa Marie,0,3,24,24
1683316711609,BIMM 110,A01,193377,Tat; John,0,11,32,32
1683316711609,BIMM 110,A02,193378,Tat; John,1,9,32,31
1683316712635,BIMM 120,A01,206116,Staff,0,0,32,32
1683316712635,BIMM 120,A02,206117,Staff,8,0,32,24
1683316712635,BIMM 120,A03,206121,Staff,21,0,32,11
1683316713661,BIPN 100,A01,193393,Park; Ji Young,0,14,32,32
1683316713661,BIPN 100,A02,193402,Park; Ji Young,0,12,32,32
1683316713661,BIPN 100,A03,193413,Park; Ji Young,0,14,32,32
1683316713661,BIPN 100,A04,193414,Park; Ji Young,0,13,32,32
1683316714686,BIPN 102,A01,193429,Staff,0,0,32,32
1683316714686,BIPN 102,A02,193438,Staff,22,0,32,10
1683316715714,BIPN 106,A01,193450,Reyes Gonzalez; Catalina,0,2,40,40
1683316716744,BIPN 134,A01,193465,Cooke; James Edward,0,0,32,32
1683316716744,BIPN 134,A02,193474,Cooke; James Edward,27,0,32,5
1683316716744,BIPN 134,A03,193485,Cooke; James Edward,29,0,32,3
1683316716744,BIPN 134,A04,193486,Cooke; James Edward,21,0,32,11
1683316716744,BIPN 134,A05,193491,Cooke; James Edward,31,0,32,1
1683316716744,BIPN 134,A06,193501,Cooke; James Edward,30,0,32,2
1683316716744,BIPN 134,A07,193510,Cooke; James Edward,29,0,32,3
1683316718800,BISP 194,A00,222522,Staff,16,0,32,16
1683316719826,CAT 124,A01,202407,Staff,20,0,25,5
1683316720850,CAT 125,A00,202408,Marchisotto; Jennifer Anne,4,0,20,16
1683316721879,CAT 125R,A00,202409,Smith; Lauryn Alissa,0,11,20,20
1683316721879,CAT 125R,B00,202410,Morales; Celeste Georgianna,0,11,20,20
1683316721879,CAT 125R,C00,202411,Irwin; Matthew Joseph,0,10,20,20
1683316722906,CENG 15,A01,204712,Yang; Kesong,0,1,0,0
1683316723931,CENG 114,A00,202070,Jahed Motlagh; Zeinab,5,0,20,15
1683316724956,CGS 105,A00,185477,Wesling; Megan E.,24,0,40,16
1683316725984,CGS 106,A00,185494,Staff,13,0,22,9
1683316727010,CGS 108,A00,185495,Staff,14,0,20,6
1683316728034,CGS 114,A00,185496,Staff,13,0,18,5
1683316729060,CGS 119,A00,185501,Staff,15,0,20,5
1683316730086,CGS 120,A00,185511,Staff,13,0,20,7
1683316731114,CHEM 4,A01,184675,Bussey; Thomas J,96,0,100,4
1683316732143,CHEM 6A,A01,184677,Staff,35,0,60,25
1683316733170,CHEM 6B,A01,184679,Staff,65,0,100,35
1683316734195,CHEM 6C,A01,184681,Bussey; Thomas J,1,0,50,49
1683316734195,CHEM 6C,A02,184682,Bussey; Thomas J,34,0,50,16
1683316735223,CHEM 40A,A01,184684,Albizati; Kim F.,37,0,100,63
1683316736251,CHEM 40B,A01,184686,Albizati; Kim F.,0,20,100,100
1683316737275,CHEM 41B,A01,184690,Staff,52,0,100,48
1683316738301,COGS 3,A01,184715,Boyle; Mary E. T.,0,25,40,40
1683316739326,COGS 14B,A01,185172,Staff,0,15,38,38
1683316740352,COGS 18,A01,184736,Staff,18,0,80,62
1683316741376,COGS 100,A01,184932,Staff,0,5,73,73
1683316742400,COGS 101A,A01,184935,Staff,0,38,30,30
1683316743425,COGS 101B,A01,184944,Staff,0,2,30,30
1683316744452,COGS 101C,A01,184946,Staff,0,12,30,30
1683316745477,COGS 102A,A01,184951,Johnson; Christine M.,2,0,40,38
1683316746505,COGS 107B,A01,184953,Mooshagian; Eric Frederick,0,50,40,40
1683316747533,COGS 118B,A01,184959,Gupta; Anjum,0,48,40,40
1683316748558,COGS 153,A00,184961,Staff,0,15,30,30
1683316749588,COGS 177,A00,184962,Staff,0,21,30,30
1683316750613,COGS 187A,A01,184969,Boyle; Mary E. T.,0,17,40,40
1683316751640,COMM 10,A01,185174,Staff,0,5,25,25
1683316751640,COMM 10,A02,185189,Staff,0,5,25,25
1683316751640,COMM 10,A03,269821,Staff,0,0,0,0
1683316752664,COMM 100B,A01,185475,Staff,0,0,0,2
1683316752664,COMM 100B,A02,185476,Staff,14,0,25,11
1683316753688,COMM 100C,A01,185314,Staff,1,0,25,24
1683316753688,COMM 100C,A02,185327,Staff,19,0,25,6
1683316754712,COMM 110M,A00,185349,Staff,2,0,40,38
1683316755740,COMM 113T,A00,185352,Staff,25,0,40,15
1683316756766,COMM 114I,A00,185353,Staff,33,0,40,7
1683316757793,COMM 131,A00,185354,Staff,19,0,30,11
1683316758821,CSE 8A,A50,185358,Cao; Yingjun,0,46,10,10
1683316759847,CSE 8B,A01,185362,Staff,1,47,50,49
1683316760872,CSE 11,A01,185416,Cao; Yingjun,0,92,10,10
1683316761895,CSE 20,A01,185445,Briones; Jor-el Thomas Caparas,5,0,25,20
1683316762919,CSE 21,A01,185447,Staff,10,0,50,40
1683316763946,CSE 101,A01,185451,Staff,0,12,50,50
1683316763946,CSE 101,B01,185453,Jones; Miles E,0,11,50,50
1683316765999,CSE 141,A01,185458,Eldon; John,20,0,100,80
1683316767027,CSE 141L,A01,185461,Eldon; John,12,0,100,88
1683316768055,CSE 142,A01,185463,Staff,36,0,60,24
1683316768055,CSE 142,B01,201355,Staff,0,7,60,60
1683316769083,CSE 142L,A01,185470,Staff,36,0,60,24
1683316769083,CSE 142L,B01,201417,Staff,0,6,60,60
1683316770108,CSE 190,A00,201433,Staff,32,0,49,17
1683316771137,DOC 1,A01,259136,Strom; Megan C.,7,0,15,8
1683316771137,DOC 1,A02,259137,Strom; Megan C.,14,0,15,1
1683316771137,DOC 1,A03,259138,Strom; Megan C.,14,0,15,1
1683316771137,DOC 1,A04,259139,Strom; Megan C.,14,0,15,1
1683316772165,DOC 100D,A00,259140,Pass; Natalye Joann,17,0,25,8
1683316773193,DSGN 1,A01,184749,Rill; Bryan,0,25,30,30
1683316774215,DSGN 100,A01,185168,Staff,0,2,25,25
1683316775243,ECE 5,A01,185626,Morris; Karcher William,0,10,0,0
1683316776266,ECE 101,A01,185628,Staff,17,0,70,53
1683316777291,ECE 107,A01,185635,Baghdadchi; Saharnaz,0,0,20,20
1683316777291,ECE 107,A02,185638,Baghdadchi; Saharnaz,4,0,20,16
1683316778317,ECE 148,A01,185647,Silberman; Jack,0,0,16,16
1683316779340,ECON 1,A01,185537,Crane; Meredith Helen,54,0,70,16
1683316780363,ECON 3,A01,185549,Crane; Meredith Helen,33,0,70,37
1683316781387,ECON 4,A01,203354,Anderson; John Charles,0,4,10,10
1683316782415,ECON 100A,A01,185574,Staff,0,4,40,40
1683316783439,ECON 100B,A01,185576,Staff,0,22,40,40
1683316784462,ECON 100C,A01,185589,Newhouse; Herbert S,30,0,70,40
1683316785489,ECON 105,A00,185608,Vespa; Emanuel Ignacio,19,0,35,16
1683316786514,ECON 109,A01,185610,Shishkin; Denis,10,0,35,25
1683316787542,ECON 110A,A01,185612,Staff,11,0,40,29
1683316788565,ECON 120A,A01,185615,Staff,20,0,40,20
1683316789590,ECON 120C,A01,185617,Sun; Yixiao,0,20,70,70
1683316790673,ECON 144,A00,203346,Squires; Dale E,3,0,35,32
1683316791699,ECON 171,A01,203349,Newhouse; Herbert S,0,1,35,35
1683316792723,ECON 173A,A01,185621,Toda; Alexis Akira,21,0,35,14
1683316793749,EDS 25,A01,202413,Staff,0,1,0,0
1683316793749,EDS 25,A02,202414,Staff,0,1,0,0
1683316793749,EDS 25,A03,202415,Staff,0,0,0,0
1683316793749,EDS 25,A04,202416,Staff,0,1,0,0
1683316793749,EDS 25,A05,202439,Staff,0,0,0,0
1683316793749,EDS 25,A06,202440,Staff,0,0,0,0
1683316793749,EDS 25,B01,202631,Staff,0,0,0,0
1683316793749,EDS 25,B02,202632,Staff,0,0,0,0
1683316793749,EDS 25,B03,202639,Staff,0,0,0,0
1683316793749,EDS 25,B04,202640,Staff,0,0,0,0
1683316793749,EDS 25,B05,202643,Staff,0,0,0,0
1683316793749,EDS 25,B06,202644,Staff,0,0,0,0
1683316794776,EDS 38,A01,202659,Black; Alison Michelle,24,0,25,1
1683316795800,EDS 115,A00,202652,Staff,17,0,30,13
1683316796825,EDS 125,A00,202649,Staff,14,0,30,16
1683316797851,EDS 126,A01,203332,Staff,30,0,30,0
1683316798878,EDS 139,A00,202838,Staff,16,0,25,9
1683316799905,EDS 146,A01,202655,Staff,14,0,25,11
1683316800929,ENG 15,A00,185667,Staff,0,1,0,0
1683316800929,ENG 15,B00,185672,Staff,0,0,0,0
1683316800929,ENG 15,C00,185675,Staff,0,0,0,0
1683316800929,ENG 15,D00,185682,Staff,0,0,0,0
1683316800929,ENG 15,E00,185684,Staff,0,0,0,0
1683316801956,ETHN 103,A00,185710,Staff,0,3,35,35
1683316802980,ETHN 103A,A00,199228,Man; Simeon S,2,0,9,7
1683316804008,ETHN 109,A00,185711,Staff,18,0,35,17
1683316805036,ETHN 142,A00,185726,Staff,0,4,30,30
1683316806062,ETHN 163J,A00,199229,Man; Simeon S,5,0,8,3
1683316807087,ETHN 168,A00,185727,Staff,8,0,10,2
1683316808111,ETHN 182,A00,185728,Staff,1,0,35,34
1683316809135,ETHN 183,A00,185737,Staff,8,0,18,10
1683316810160,GLBH 111,A01,209361,Burgos; Jose L.,0,0,0,0
1683316812215,HIEU 104,A00,185792,Staff,16,0,20,4
1683316813241,HIEU 115,A00,185800,Staff,1,0,20,19
1683316814266,HIEU 128,A00,185801,Staff,0,7,20,20
1683316815291,HIEU 147,A00,185802,Staff,16,0,20,4
1683316816318,HIEU 154,A00,185823,Staff,12,0,20,8
1683316817342,HILA 102,A00,185826,Staff,13,0,20,7
1683316818369,HILD 2C,A01,185778,Staff,0,12,20,20
1683316819396,HILD 7B,A01,185780,Kwak; Nancy,0,15,32,32
1683316819396,HILD 7B,A02,185781,Kwak; Nancy,0,18,32,32
1683316820462,HILD 30,A01,185791,Staff,14,0,20,6
1683316821488,HISC 119,A00,185830,Golan; Tal,0,9,20,20
1683316822512,HITO 156GS,A00,185831,Patterson; Patrick H.,0,0,0,23
1683316823539,HIUS 103,A00,185832,Man; Simeon S,0,6,20,20
1683316824563,HIUS 117,A00,185836,Kwak; Nancy,2,0,20,18
1683316825590,HIUS 125,A00,185840,Man; Simeon S,0,0,23,23
1683316826623,HIUS 149,A00,185845,Staff,0,0,20,20
1683316827652,HUM 3,A01,185882,Zavodny; Tatiana Sophia,0,6,50,50
1683316827652,HUM 3,B01,185899,Caldwell; Michael Alan,0,19,50,50
1683316828675,HUM 3GS,A00,185900,Patterson; Patrick H.,0,0,0,23
1683316829705,HUM 4,A01,185938,Zroka; Amy Liane,31,0,50,19
1683316829705,HUM 4,B01,185956,Watkins; Eric,0,2,50,50
1683316829705,HUM 4,B02,202209,Watkins; Eric,0,2,50,50
1683316829705,HUM 4,B03,202210,Watkins; Eric,0,0,50,50
1683316830729,HUM 5,A01,185958,West; Geoffrey Scott,4,0,50,46
1683316830729,HUM 5,A02,202215,West; Geoffrey Scott,0,0,50,50
1683316831753,INTL 190,A00,185959,Gagnon; Jeffrey C,0,0,0,9
1683316831753,INTL 190,B00,185960,Lettieri; Michael Joseph,0,0,0,1
1683316832777,JAPN 180,A00,254509,Staff,5,1,30,25
1683316833802,LATI 10,A01,202853,Kennemore; Amy Michelle,5,0,35,30
1683316833802,LATI 10,A02,202854,Kennemore; Amy Michelle,1,0,35,34
1683316833802,LATI 10,A03,270054,Kennemore; Amy Michelle,30,0,30,0
1683316834829,LATI 180,A00,202855,Kennemore; Amy Michelle,11,0,20,9
1683316835859,LAWS 101,A00,201767,Golan; Tal,0,7,40,40
1683316836886,LIFR 1C,A00,185961,Staff,6,0,20,14
1683316837927,LIFR 1CX,A00,185962,Staff,7,0,20,13
1683316838954,LIFR 1D,A00,185963,Staff,9,0,20,11
1683316839978,LIFR 1DX,A00,185964,Staff,9,0,20,11
1683316841001,LIGN 101,A01,186039,Staff,43,0,50,7
1683316842025,LIGN 165,A00,186040,Staff,18,0,50,32
1683316843049,LTCS 108,A00,186041,Staff,6,0,10,4
1683316844073,LTCS 119,A00,186042,Staff,16,0,20,4
1683316845096,LTCS 130,A00,186043,Wesling; Megan E.,15,0,25,10
1683316847147,LTEA 138,A00,186119,Staff,14,0,40,26
1683316848175,LTEN 124,A00,186148,Staff,6,0,25,19
1683316849199,LTEN 178,A00,186149,Staff,7,0,15,8
1683316850228,LTEN 181,A00,186150,Blanco; John D,33,0,40,7
1683316851253,LTWL 120,A00,186160,Staff,20,0,25,5
1683316852277,LTWL 165,A00,186161,Staff,22,0,25,3
1683316853309,LTWR 100,A00,186162,Staff,0,4,15,15
1683316854332,LTWR 102,A00,186163,Doller; Ben,5,0,15,10
1683316855356,MAE 8,A01,186412,Staff,0,0,0,0
1683316856381,MAE 30B,A00,186445,Bahadori; Mohammad Yousef,83,0,100,17
1683316857410,MAE 40,A00,186592,Bewley; Thomas R,9,0,50,41
1683316858437,MAE 101B,A00,186593,Bahadori; Mohammad Yousef,81,0,100,19
1683316859471,MAE 105,A00,186594,Bandaru; Prabhakar,12,0,50,38
1683316860495,MAE 107,A00,186599,Pham; Hieu Tan,0,6,120,120
1683316861527,MAE 148,A01,186660,Silberman; Jack,3,0,16,13
1683316862552,MATH 10A,A01,188095,Staff,0,6,35,35
1683316863578,MATH 10B,A01,188097,Bowers; Adam R.,0,11,30,30
1683316863578,MATH 10B,A02,188099,Bowers; Adam R.,0,11,30,30
1683316863578,MATH 10B,B01,188104,Bowers; Adam R.,0,10,30,30
1683316863578,MATH 10B,B02,188106,Bowers; Adam R.,0,10,30,30
1683316864603,MATH 10C,A01,188111,Staff,0,18,30,30
1683316864603,MATH 10C,A02,188127,Staff,0,17,30,30
1683316864603,MATH 10C,A03,188131,Staff,0,18,30,30
1683316864603,MATH 10C,B01,188218,Staff,20,0,30,10
1683316864603,MATH 10C,B02,188244,Staff,13,0,30,17
1683316864603,MATH 10C,B03,188277,Staff,16,0,30,14
1683316865628,MATH 18,A01,188344,Bach; Quang Tran,18,0,30,12
1683316865628,MATH 18,A02,188345,Bach; Quang Tran,11,0,30,19
1683316865628,MATH 18,B01,188353,Bach; Quang Tran,10,0,30,20
1683316865628,MATH 18,B02,188354,Bach; Quang Tran,20,0,30,10
1683316866656,MATH 20A,A01,188374,Staff,13,0,35,22
1683316867680,MATH 20B,A01,188382,Ohm; Ko Woon,6,0,30,24
1683316867680,MATH 20B,A02,188383,Ohm; Ko Woon,23,0,30,7
1683316867680,MATH 20B,B01,188385,Ohm; Ko Woon,7,0,30,23
1683316867680,MATH 20B,B02,188392,Ohm; Ko Woon,22,0,30,8
1683316868709,MATH 20C,A01,188394,Harel; Guershon,10,0,30,20
1683316868709,MATH 20C,A02,188395,Harel; Guershon,14,0,30,16
1683316868709,MATH 20C,B01,188404,Harel; Guershon,5,0,30,25
1683316868709,MATH 20C,B02,188405,Harel; Guershon,19,0,30,11
1683316869740,MATH 20D,A01,188414,Hammock; Frances H,0,1,30,30
1683316869740,MATH 20D,A02,188415,Hammock; Frances H,3,0,30,27
1683316869740,MATH 20D,B01,188447,Hammock; Frances H,2,0,30,28
1683316869740,MATH 20D,B02,188486,Hammock; Frances H,8,0,30,22
1683316870764,MATH 20E,A01,188649,Staff,21,0,30,9
1683316870764,MATH 20E,A02,188650,Staff,23,0,30,7
1683316870764,MATH 20E,A03,188673,Staff,0,0,30,30
1683316871791,MATH 102,A01,188675,Staff,0,35,35,35
1683316872817,MATH 103B,A01,188681,Staff,4,0,35,31
1683316872817,MATH 103B,B01,188692,Staff,5,0,35,30
1683316873841,MATH 109,A01,188695,Salehi Golsefidy; Alireza,25,0,35,10
1683316873841,MATH 109,A02,188696,Salehi Golsefidy; Alireza,26,0,35,9
1683316874869,MATH 120A,A01,188698,Eggers; John Dietrich,7,0,35,28
1683316875896,MATH 142B,A01,188736,Ioana; Adrian,0,2,30,30
1683316875896,MATH 142B,A02,188741,Ioana; Adrian,0,1,30,30
1683316875896,MATH 142B,A03,188743,Ioana; Adrian,1,3,30,29
1683316876920,MATH 168A,A01,188790,Staff,0,9,35,35
1683316877949,MATH 170A,A01,188803,Nie; Jiawang,0,2,35,35
1683316877949,MATH 170A,A02,188811,Nie; Jiawang,0,0,35,35
1683316877949,MATH 170A,A03,188814,Nie; Jiawang,0,0,35,35
1683316877949,MATH 170A,A04,188815,Nie; Jiawang,13,0,35,22
1683316878974,MATH 193B,A01,188817,Staff,0,0,35,35
1683316878974,MATH 193B,A02,188818,Staff,6,0,35,29
1683316880001,MGT 4,A01,202857,Anderson; John Charles,62,0,80,18
1683316881034,MGT 12,A00,202858,Lindenberger; Wade Douglas,43,0,90,47
1683316882057,MGT 18,A00,202859,Staff,74,0,90,16
1683316883084,MGT 18GS,A00,202860,McKay; Michael J,13,0,28,15
1683316884108,MGT 45,A00,202861,Pecore; Joseph P.,13,0,90,77
1683316885131,MGT 100,A00,202863,Yavorsky; Daniel Ryan,28,0,90,62
1683316886155,MGT 103,A00,202864,Ehrich; Kristine R,0,16,90,90
1683316887201,MGT 112,A00,202865,Ehrich; Kristine R,15,0,90,75
1683316888224,MGT 121A,A00,202868,Staff,0,19,0,0
1683316889251,MGT 131B,A00,202869,Anderson; John Charles,59,0,90,31
1683316890278,MGT 136,A00,202871,Lindenberger; Wade Douglas,84,0,90,6
1683316891303,MGT 164,A00,202873,Staff,0,68,90,90
1683316892328,MGT 164GS,A00,202874,McKay; Mary A,13,0,28,15
1683316893356,MGT 180,A00,202875,Staff,0,50,90,90
1683316894457,MMW 11R,A01,205019,Herbst; Matthew,3,0,30,27
1683316894457,MMW 11R,A02,205026,Herbst; Matthew,29,0,30,1
1683316895487,MMW 15,A01,193512,Chang; Edmond Yi-Teh,0,9,28,28
1683316895487,MMW 15,A02,193513,Chang; Edmond Yi-Teh,0,5,28,28
1683316895487,MMW 15,A03,193514,Chang; Edmond Yi-Teh,0,5,28,28
1683316895487,MMW 15,A04,193515,Chang; Edmond Yi-Teh,0,5,28,28
1683316895487,MMW 15,A05,193516,Chang; Edmond Yi-Teh,0,4,28,28
1683316895487,MMW 15,A06,193517,Chang; Edmond Yi-Teh,0,5,28,28
1683316895487,MMW 15,B01,193519,Chang; Edmond Yi-Teh,0,4,28,28
1683316895487,MMW 15,B02,193520,Chang; Edmond Yi-Teh,0,5,28,28
1683316895487,MMW 15,B03,193521,Chang; Edmond Yi-Teh,0,4,28,28
1683316895487,MMW 15,B04,193522,Chang; Edmond Yi-Teh,0,4,28,28
1683316895487,MMW 15,B05,193523,Chang; Edmond Yi-Teh,0,5,28,28
1683316895487,MMW 15,B06,193524,Chang; Edmond Yi-Teh,0,4,28,28
1683316896511,MMW 122,A01,193526,Rahimi; Babak,0,14,28,28
1683316896511,MMW 122,A02,193527,Rahimi; Babak,0,14,28,28
1683316896511,MMW 122,A03,193528,Rahimi; Babak,0,0,0,0
1683316896511,MMW 122,A04,193529,Rahimi; Babak,0,0,0,0
1683316897537,MUS 1A,A01,186663,Staff,0,20,35,35
1683316898562,MUS 4,A01,186715,Staff,0,12,35,35
1683316899587,MUS 5R,A01,186796,Dubnov; Shlomo,0,17,35,35
1683316900611,MUS 6,A01,186798,Staff,0,3,25,25
1683316901636,MUS 7,A01,186830,Staff,12,0,35,23
1683316902664,MUS 8,A01,186930,Staff,0,26,35,35
1683316903692,MUS 15,A01,186932,Staff,0,15,35,35
1683316903692,MUS 15,B01,186934,Staff,0,15,35,35
1683316904717,MUS 80,A00,186935,Staff,2,0,20,18
1683316904717,MUS 80,B00,186936,Staff,25,0,25,0
1683316905742,NANO 11,A00,204702,Lipomi; Darren John,0,0,0,0
1683316906765,NANO 15,A01,204709,Yang; Kesong,0,1,0,0
1683316907789,NANO 114,A00,202069,Jahed Motlagh; Zeinab,3,0,10,7
1683316908813,PHIL 1,A00,186955,Grush; Rick Scott,32,0,40,8
1683316909841,PHIL 10,A01,186973,Grush; Rick Scott,28,0,35,7
1683316909841,PHIL 10,A02,186974,Grush; Rick Scott,33,0,35,2
1683316910864,PHIL 13,A01,186976,Staff,7,0,35,28
1683316910864,PHIL 13,A02,186977,Staff,16,0,35,19
1683316911889,PHIL 14,A01,186979,Staff,31,0,35,4
1683316911889,PHIL 14,A02,186986,Staff,32,0,35,3
1683316912916,PHIL 28,A01,186988,Staff,16,0,30,14
1683316912916,PHIL 28,A02,186989,Staff,1,0,30,29
1683316912916,PHIL 28,A03,186990,Staff,9,0,30,21
1683316912916,PHIL 28,A04,186991,Staff,26,0,30,4
1683316913942,PHIL 120,A00,186997,Staff,23,0,40,17
1683316914968,PHIL 137,A00,187003,Staff,9,0,40,31
1683316915994,PHIL 150,A00,187015,Staff,47,0,70,23
1683316917018,PHIL 167,A00,187021,Lamey; Andy M.,35,0,40,5
1683316918045,PHIL 174,A01,202226,Staff,17,0,20,3
1683316918045,PHIL 174,A02,202235,Staff,20,0,20,0
1683316919068,PHIL 191A,A00,258918,Staff,0,0,1,1
1683316920092,PHYS 1A,A00,187028,Staff,27,0,60,33
1683316921120,PHYS 1AL,001,187036,Staff,3,0,30,27
1683316921120,PHYS 1AL,002,187049,Staff,18,0,30,12
1683316922149,PHYS 1B,A00,187058,Staff,22,0,60,38
1683316923178,PHYS 1BL,001,187064,Staff,0,0,30,30
1683316923178,PHYS 1BL,002,187070,Staff,5,0,30,25
1683316924204,PHYS 1C,A00,187082,Staff,31,0,120,89
1683316925228,PHYS 1CL,001,187088,Staff,0,9,30,30
1683316925228,PHYS 1CL,002,187089,Staff,0,2,30,30
1683316925228,PHYS 1CL,009,262693,Staff,11,0,30,19
1683316926255,PHYS 2B,A01,187097,Staff,54,0,115,61
1683316927280,PHYS 2C,A01,187099,Staff,67,0,115,48
1683316928304,PHYS 2CL,A01,187101,Staff,5,0,28,23
1683316928304,PHYS 2CL,A02,187102,Staff,15,0,28,13
1683316929333,PHYS 2D,A01,187123,Shotwell; Brian,95,0,115,20
1683316930360,PHYS 4B,A01,187133,Grinstein; Benjamin,35,0,50,15
1683316931388,POLI 10,A00,188819,Staff,0,4,50,50
1683316932413,POLI 11,A00,188827,Staff,43,0,50,7
1683316933439,POLI 13R,A00,188828,Staff,0,1,20,20
1683316934463,POLI 27,A01,188830,Elgin; Samuel Zincke,0,1,70,70
1683316935486,POLI 30,A00,188832,Desposato; Scott,32,0,50,18
1683316936513,POLI 102F,A00,188834,Staff,3,0,40,37
1683316937538,POLI 104A,A00,188852,Staff,14,0,30,16
1683316938573,POLI 104I,A00,188853,Staff,0,6,20,20
1683316939599,POLI 110B,A00,188854,Wiens; David,7,0,20,13
1683316940627,POLI 112A,A00,188855,Wiens; David,5,0,30,25
1683316941652,POLI 117R,A00,188856,Forman; Fonna,0,11,20,20
1683316942678,POLI 118,A00,188857,Ingham; Sean,8,0,20,12
1683316943703,POLI 120G,A00,188858,Staff,9,0,30,21
1683316944730,POLI 131CR,A00,188863,Hoston; Germaine,24,0,50,26
1683316945756,POLI 133,A00,188864,Nellis; Gareth Hb,44,0,50,6
1683316946783,POLI 134D,A00,188865,Desposato; Scott,27,0,30,3
1683316947809,POLI 142A,A00,188871,Gartzke; Erik,22,0,50,28
1683316948833,POLI 142K,A00,188874,Staff,38,0,50,12
1683316949858,POLI 143,A00,188940,Gartzke; Erik,16,0,30,14
1683316950884,POLI 153,A00,188943,Staff,3,0,20,17
1683316951909,POLI 160AA,A00,188944,Staff,12,0,40,28
1683316952939,POLI 170A,A00,188945,Staff,11,0,30,19
1683316954987,PSYC 1,A00,188952,Staff,37,0,90,53
1683316956010,PSYC 2,B00,188953,Staff,19,0,35,16
1683316957035,PSYC 6,A00,188970,Staff,47,0,60,13
1683316958062,PSYC 7,A00,188973,Staff,37,0,45,8
1683316959089,PSYC 60,A01,188980,Rickard; Timothy C.,43,0,60,17
1683316960113,PSYC 70,A01,189001,Steiner; Eric Tomas,24,0,45,21
1683316961142,PSYC 100,A00,189005,Lacefield; Katharine I,0,99,120,120
1683316962169,PSYC 102,A00,189008,Staff,10,0,30,20
1683316963194,PSYC 106,B00,189026,Gorman; Michael R.,36,0,60,24
1683316964222,PSYC 114,B01,189033,Winkielman; Piotr,0,32,30,30
1683316965249,PSYC 131,A00,189036,Anagnostaras; Stephan,0,43,60,60
1683316966273,PSYC 136,A00,189041,Lowe; Angela Beth,0,7,25,25
1683316967303,PSYC 137,A00,189057,Winkielman; Piotr,0,34,25,25
1683316968325,PSYC 144,A00,189107,Wixted; John T,0,7,50,50
1683316970378,PSYC 162,A00,189142,Staff,0,8,85,85
1683316971407,PSYC 172,A00,189144,Gorman; Michael R.,0,7,30,30
1683316973453,PSYC 179,A00,189146,Lacefield; Katharine I,0,84,120,120
1683316974481,PSYC 181,A00,189147,Anagnostaras; Stephan,0,44,90,90
1683316975503,PSYC 190R,A00,189148,Barner; David A.,0,22,80,80
1683316976527,PSYC 191,A00,189275,Rickard; Timothy C.,0,7,25,25
1683316977550,PSYC 193,A00,189276,Chapman; Eddie Nathaniel,0,1,0,4
1683316978576,PSYC 193L,A01,189281,Lowe; Angela Beth,12,0,20,8
1683316978576,PSYC 193L,B01,189285,Staff,28,0,35,7
1683316979599,RELI 149,A00,187137,Rahimi; Babak,7,0,40,33
1683316980624,SE 9,A01,187315,Staff,0,2,18,18
1683316981648,SE 101B,A00,187409,Staff,24,0,30,6
1683316982672,SE 110B,A00,187444,Staff,10,0,40,30
1683316983699,SE 130B,A00,187449,Staff,31,0,40,9
1683316984723,SE 150A,A00,187516,Staff,9,0,20,11
1683316985751,SE 154,A00,187528,Staff,30,0,50,20
1683316986778,SIO 3,A01,258171,Staff,35,0,40,5
1683316987803,SIO 10,A00,187144,Cook; Geoffrey W,0,3,75,75
1683316988829,SIO 45,A00,187152,Cook; Geoffrey W,1,0,100,99
1683316989853,SIO 109R,A00,194486,Staff,0,3,20,20
1683316991904,SIO 187,A01,187233,Kacev; David,12,0,40,28
1683316992933,SOCI 1,A01,258656,Thorpe; Charles Robert,28,0,30,2
1683316992933,SOCI 1,A02,258658,Thorpe; Charles Robert,30,0,30,0
1683316992933,SOCI 1,A03,258661,Thorpe; Charles Robert,25,0,25,0
1683316992933,SOCI 1,A04,258666,Thorpe; Charles Robert,22,0,25,3
1683316992933,SOCI 1,A05,258897,Thorpe; Charles Robert,23,0,25,2
1683316992933,SOCI 1,A06,258898,Thorpe; Charles Robert,25,0,25,0
1683316993959,SOCI 30,A01,258903,Pardo Guerra; Juan Pablo,16,0,30,14
1683316994984,SOCI 102,A00,258904,Staff,9,0,25,16
1683316996013,SOCI 106,A00,258905,Staff,19,0,25,6
1683316997037,SOCI 111,A00,258907,Ribas Norris; Janet Vanesa,26,0,30,4
1683316998122,SOCI 121R,A00,258908,Pardo Guerra; Juan Pablo,11,0,30,19
1683316999149,SOCI 126,A01,203330,Staff,14,0,20,6
1683317000176,SOCI 131,A00,258909,Thorpe; Charles Robert,31,0,60,29
1683317001200,SOCI 135,A00,258910,Payne; Christine Anna,0,9,30,30
1683317002225,SOCI 157,A00,258911,Staff,12,0,30,18
1683317003249,SOCI 184,A00,258912,Staff,25,0,30,5
1683317004275,SOCI 188D,A00,258913,Staff,21,0,30,9
1683317005300,SYN 2,001,187529,Staff,9,0,16,7
1683317005300,SYN 2,002,201452,Staff,0,18,16,16
1683317005300,SYN 2,003,201469,Staff,4,0,16,12
1683317006324,SYN 100,A01,187531,Staff,0,9,20,20
1683317006324,SYN 100,B01,201491,Staff,0,12,20,20
1683317007354,TDAC 1,A00,189286,Walsh; Kim C.,3,0,20,17
1683317007354,TDAC 1,B00,189287,Harting; Carla Kelso,11,0,20,9
1683317008380,TDAC 101,A00,189300,Walsh; Kim C.,16,0,20,4
1683317008380,TDAC 101,B00,189301,Harting; Carla Kelso,18,0,20,2
1683317009405,TDAC 102,A00,189304,Basso; Beatrice,14,0,20,6
1683317010432,TDAC 108,A00,189305,Staff,18,0,20,2
1683317011456,TDDE 131,A00,189310,Staff,19,0,20,1
1683317011456,TDDE 131,B00,189314,Staff,19,0,20,1
1683317011456,TDDE 131,C00,189315,Staff,48,0,50,2
1683317011456,TDDE 131,D00,189316,Staff,14,0,15,1
1683317011456,TDDE 131,E00,204841,Staff,20,0,20,0
1683317012479,TDGE 10,A00,189289,Staff,30,0,50,20
1683317012479,TDGE 10,B00,189290,Havis; Allan,2,0,50,48
1683317013508,TDGE 11,A00,189291,Fulton; Julia,0,3,50,50
1683317013508,TDGE 11,B00,189292,Staff,20,0,25,5
1683317013508,TDGE 11,C00,260270,Staff,0,0,0,0
1683317014535,TDGE 25,A00,189294,Staff,3,0,20,17
1683317015561,TDGE 124,A00,189318,Fulton; Julia,0,8,50,50
1683317016586,TDGE 125,A00,189319,Staff,13,0,25,12
1683317016586,TDGE 125,B00,189320,Staff,23,0,25,2
1683317017611,TDGE 127,A00,189322,Havis; Allan,0,0,50,50
1683317018637,TDHT 101,A00,189323,Staff,18,0,25,7
1683317018637,TDHT 101,B00,189324,Staff,25,0,25,0
1683317019661,TDHT 102,A00,189325,Staff,49,0,50,1
1683317020689,TDMV 1,A00,189295,Arcidiacono; Kristin,20,0,30,10
1683317020689,TDMV 1,B00,189296,Caligagan; Maria T.,24,0,30,6
1683317021713,TDMV 2,A00,189297,Sammartano; Tonnie,28,0,30,2
1683317021713,TDMV 2,B00,189299,Arcidiacono; Kristin,24,0,30,6
1683317022736,TDMV 3,A00,204998,Rincon; Alicia,22,0,30,8
1683317023761,TDMV 120,A00,189458,Sammartano; Tonnie,28,0,30,2
1683317024785,TDMV 138,A00,189541,Jun; Grace Shin Hae,22,0,40,18
1683317025809,TDMV 142,A00,189717,Caligagan; Tony,23,0,30,7
1683317025809,TDMV 142,B00,189718,Caligagan; Maria T.,25,0,30,5
1683317026836,TMC 2,A01,187533,Staff,25,0,25,0
1683317026836,TMC 2,A02,187534,Staff,25,0,25,0
1683317027865,USP 1,A01,187536,Kwak; Nancy,0,16,25,25
1683317028889,USP 5,A01,187538,Staff,9,0,25,16
1683317029913,USP 101,A00,199253,Staff,0,4,0,0
1683317030940,USP 124,A00,187562,Boomhower; Matthew Charles,1,0,30,29
1683317031964,USP 138,A00,187582,Staff,20,0,25,5
1683317032988,USP 152,A01,187597,Staff,4,0,25,21
1683317034012,USP 153,A00,187598,Staff,19,0,25,6
1683317035040,USP 168,A00,187607,Kwak; Nancy,2,0,5,3
1683317036063,USP 173,A00,187619,Staff,4,0,25,21
1683317037089,USP 181,A00,187638,Staff,0,0,25,25
1683317038113,VIS 103,A00,187650,Cruz; Edwin Teddy,23,0,75,52
1683317039137,VIS 110D,A00,187669,Staff,12,0,22,10
1683317040163,VIS 127C,A00,187720,Shen; Kuiyi,68,0,146,78
1683317041190,VIS 149,A00,187731,Yoldas; Pinar,0,14,22,22
1683317042218,VIS 151,A01,188091,Staff,22,0,34,12
1683317042218,VIS 151,A02,188092,Staff,11,0,34,23
1683317043243,VIS 160B,A00,188093,Stalbaum; Brett,0,0,10,10
1683317045295,WCWP 10B,A00,201720,Staff,10,0,15,5
1683317045295,WCWP 10B,B00,201722,Staff,8,0,15,7
1683317046318,WCWP 100,A00,201725,Gagnon; Jeffrey C,0,0,2,2
1683317046318,WCWP 100,B00,201727,Staff,0,4,15,15
1683317049411,ANBI 133,A00,258401,Wilder; Linnea Lorene,34,0,40,6
1683317050434,ANBI 140,A00,258395,Hrvoj Mihic; Branka,18,0,25,7
1683317051461,ANSC 120,A00,258402,Bialecki; Jon Anthony,27,0,40,13
1683317052489,ANSC 144,A00,258400,Staff,14,0,40,26
1683317054542,ANSC 166,A00,258396,Parish; Steven Martin,157,0,175,18
1683317055569,ANSC 180,A00,193533,Staff,9,0,20,11
1683317056596,ANSC 188,A00,258397,Jassal; Aftab,33,0,40,7
1683317057621,ANTH 3,A01,258316,Staff,23,0,30,7
1683317058649,ANTH 5,A00,258394,Semendeferi; Ekaterini,16,0,20,4
1683317059674,ANTH 21,A01,258331,Staff,9,0,40,31
1683317060697,ANTH 103,A00,258398,Varma; Saiba,15,0,25,10
1683317061725,AWP 10,001,202034,Staff,0,0,0,0
1683317061725,AWP 10,002,202035,Staff,0,0,0,0
1683317061725,AWP 10,003,202036,Staff,0,0,0,0
1683317061725,AWP 10,004,202037,Staff,0,0,0,0
1683317061725,AWP 10,005,202038,Staff,0,0,0,0
1683317061725,AWP 10,006,202039,Staff,0,0,0,0
1683317061725,AWP 10,007,202040,Staff,0,0,0,0
1683317061725,AWP 10,008,202041,Staff,0,0,0,0
1683317061725,AWP 10,009,202042,Staff,0,0,0,0
1683317061725,AWP 10,010,202043,Staff,0,0,0,0
1683317061725,AWP 10,011,202044,Staff,0,0,0,0
1683317061725,AWP 10,012,202045,Staff,0,0,0,0
1683317061725,AWP 10,013,202046,Staff,0,0,0,0
1683317061725,AWP 10,014,202047,Staff,0,0,0,0
1683317061725,AWP 10,015,202048,Staff,0,0,0,0
1683317061725,AWP 10,016,202049,Staff,0,0,0,0
1683317061725,AWP 10,017,202050,Staff,0,0,0,0
1683317061725,AWP 10,018,202051,Staff,0,0,0,0
1683317061725,AWP 10,019,202052,Staff,0,0,0,0
1683317061725,AWP 10,020,202053,Staff,0,0,0,0
1683317061725,AWP 10,021,202054,Staff,0,0,0,0
1683317061725,AWP 10,022,202055,Staff,0,0,0,0
1683317061725,AWP 10,023,202056,Staff,0,0,0,0
1683317061725,AWP 10,024,202057,Staff,0,0,0,0
1683317061725,AWP 10,025,202058,Staff,0,0,0,0
1683317061725,AWP 10,026,202059,Staff,0,0,0,0
1683317062753,AWP 102,001,202032,Staff,0,0,0,0
1683317062753,AWP 102,002,202033,Staff,0,0,0,0
1683317063781,BENG 100,A01,254234,Taylor Amos; Alyssa C,31,0,40,9
1683317064805,BENG 196,001,270013,Engler; Adam J.,9999,0,9999,0
1683317065831,BICD 100R,A01,202018,Smith; Laurie,0,7,32,32
1683317065831,BICD 100R,A02,202019,Smith; Laurie,0,2,32,32
1683317065831,BICD 100R,A03,202020,Smith; Laurie,0,1,32,32
1683317065831,BICD 100R,A04,202021,Smith; Laurie,8,0,32,24
1683317065831,BICD 100R,A05,202022,Smith; Laurie,12,0,32,20
1683317066857,BICD 136,A01,193242,Gustafson-Brown; Cindy,0,2,32,32
1683317066857,BICD 136,A02,193244,Gustafson-Brown; Cindy,14,0,32,18
1683317067883,BIEB 102,A01,193249,Butler; Shannon Rhey,0,2,32,32
1683317067883,BIEB 102,A02,193251,Butler; Shannon Rhey,0,0,32,32
1683317067883,BIEB 102,A03,193253,Butler; Shannon Rhey,0,1,32,32
1683317067883,BIEB 102,A04,193255,Butler; Shannon Rhey,17,0,32,15
1683317067883,BIEB 102,A05,193265,Butler; Shannon Rhey,26,0,32,6
1683317067883,BIEB 102,A06,193269,Butler; Shannon Rhey,16,0,32,16
1683317069931,BIEB 150,A01,193274,Staff,0,0,32,32
1683317069931,BIEB 150,A02,193285,Staff,23,0,32,9
1683317070961,BIEB 194,A00,193286,Kurle; Carolyn M.,22,0,32,10
1683317071991,BILD 1,A01,192291,Staff,16,0,32,16
1683317071991,BILD 1,A02,192292,Staff,30,0,32,2
1683317071991,BILD 1,B01,192520,Reuther; Keefe,0,1,0,0
1683317071991,BILD 1,B02,192532,Reuther; Keefe,0,1,0,0
1683317073015,BILD 3,A01,192556,Butler; Shannon Rhey,0,0,32,32
1683317073015,BILD 3,A02,192581,Butler; Shannon Rhey,5,0,32,27
1683317073015,BILD 3,A03,192611,Butler; Shannon Rhey,23,0,32,9
1683317073015,BILD 3,A04,192612,Butler; Shannon Rhey,25,0,32,7
1683317073015,BILD 3,A05,192613,Butler; Shannon Rhey,27,0,32,5
1683317073015,BILD 3,A06,192679,Butler; Shannon Rhey,27,0,32,5
1683317073015,BILD 3,A07,192682,Butler; Shannon Rhey,22,0,32,10
1683317074043,BILD 4,A01,192836,Reuther; Keefe,1,0,24,23
1683317074043,BILD 4,A02,193044,Reuther; Keefe,4,0,24,20
1683317075071,BILD 10,A01,193142,Gustafson-Brown; Cindy,30,0,32,2
1683317075071,BILD 10,A02,193149,Gustafson-Brown; Cindy,31,0,32,1
1683317076102,BIMM 100,A01,193301,Staff,0,6,32,32
1683317076102,BIMM 100,A02,193312,Staff,0,5,32,32
1683317076102,BIMM 100,A03,193323,Staff,0,8,32,32
1683317077125,BIMM 101,A01,193329,McDonnell; Lisa Marie,0,3,24,24
1683317077125,BIMM 101,A02,193339,McDonnell; Lisa Marie,0,2,24,24
1683317077125,BIMM 101,B01,193354,McDonnell; Lisa Marie,0,3,24,24
1683317077125,BIMM 101,B02,193357,McDonnell; Lisa Marie,0,3,24,24
1683317078153,BIMM 110,A01,193377,Tat; John,0,11,32,32
1683317078153,BIMM 110,A02,193378,Tat; John,1,9,32,31
1683317079178,BIMM 120,A01,206116,Staff,0,0,32,32
1683317079178,BIMM 120,A02,206117,Staff,8,0,32,24
1683317079178,BIMM 120,A03,206121,Staff,21,0,32,11
1683317080208,BIPN 100,A01,193393,Park; Ji Young,0,14,32,32
1683317080208,BIPN 100,A02,193402,Park; Ji Young,0,12,32,32
1683317080208,BIPN 100,A03,193413,Park; Ji Young,0,14,32,32
1683317080208,BIPN 100,A04,193414,Park; Ji Young,0,13,32,32
1683317081236,BIPN 102,A01,193429,Staff,0,0,32,32
1683317081236,BIPN 102,A02,193438,Staff,22,0,32,10
1683317082263,BIPN 106,A01,193450,Reyes Gonzalez; Catalina,0,2,40,40
1683317083288,BIPN 134,A01,193465,Cooke; James Edward,0,0,32,32
1683317083288,BIPN 134,A02,193474,Cooke; James Edward,27,0,32,5
1683317083288,BIPN 134,A03,193485,Cooke; James Edward,29,0,32,3
1683317083288,BIPN 134,A04,193486,Cooke; James Edward,21,0,32,11
1683317083288,BIPN 134,A05,193491,Cooke; James Edward,31,0,32,1
1683317083288,BIPN 134,A06,193501,Cooke; James Edward,30,0,32,2
1683317083288,BIPN 134,A07,193510,Cooke; James Edward,29,0,32,3
1683317085341,BISP 194,A00,222522,Staff,15,0,32,17
1683317086366,CAT 124,A01,202407,Staff,20,0,25,5
1683317087395,CAT 125,A00,202408,Marchisotto; Jennifer Anne,4,0,20,16
1683317088419,CAT 125R,A00,202409,Smith; Lauryn Alissa,0,11,20,20
1683317088419,CAT 125R,B00,202410,Morales; Celeste Georgianna,0,11,20,20
1683317088419,CAT 125R,C00,202411,Irwin; Matthew Joseph,0,10,20,20
1683317089446,CENG 15,A01,204712,Yang; Kesong,0,1,0,0
1683317090474,CENG 114,A00,202070,Jahed Motlagh; Zeinab,5,0,20,15
1683317091499,CGS 105,A00,185477,Wesling; Megan E.,24,0,40,16
1683317092525,CGS 106,A00,185494,Staff,13,0,22,9
1683317093555,CGS 108,A00,185495,Staff,14,0,20,6
1683317094579,CGS 114,A00,185496,Staff,13,0,18,5
1683317095603,CGS 119,A00,185501,Staff,15,0,20,5
1683317096627,CGS 120,A00,185511,Staff,13,0,20,7
1683317097653,CHEM 4,A01,184675,Bussey; Thomas J,96,0,100,4
1683317098678,CHEM 6A,A01,184677,Staff,35,0,60,25
1683317099703,CHEM 6B,A01,184679,Staff,65,0,100,35
1683317100728,CHEM 6C,A01,184681,Bussey; Thomas J,1,0,50,49
1683317100728,CHEM 6C,A02,184682,Bussey; Thomas J,34,0,50,16
1683317101819,CHEM 40A,A01,184684,Albizati; Kim F.,37,0,100,63
1683317102843,CHEM 40B,A01,184686,Albizati; Kim F.,0,20,100,100
1683317103870,CHEM 41B,A01,184690,Staff,52,0,100,48
1683317104895,COGS 3,A01,184715,Boyle; Mary E. T.,0,25,40,40
1683317105920,COGS 14B,A01,185172,Staff,0,15,38,38
1683317106943,COGS 18,A01,184736,Staff,18,0,80,62
1683317107971,COGS 100,A01,184932,Staff,0,5,73,73
1683317108997,COGS 101A,A01,184935,Staff,0,38,30,30
1683317110021,COGS 101B,A01,184944,Staff,0,2,30,30
1683317111044,COGS 101C,A01,184946,Staff,0,12,30,30
1683317112074,COGS 102A,A01,184951,Johnson; Christine M.,2,0,40,38
1683317113098,COGS 107B,A01,184953,Mooshagian; Eric Frederick,0,50,40,40
1683317114126,COGS 118B,A01,184959,Gupta; Anjum,0,48,40,40
1683317115150,COGS 153,A00,184961,Staff,0,15,30,30
1683317116177,COGS 177,A00,184962,Staff,0,21,30,30
1683317117204,COGS 187A,A01,184969,Boyle; Mary E. T.,0,17,40,40
1683317118228,COMM 10,A01,185174,Staff,0,5,25,25
1683317118228,COMM 10,A02,185189,Staff,0,5,25,25
1683317118228,COMM 10,A03,269821,Staff,0,0,0,0
1683317119251,COMM 100B,A01,185475,Staff,0,0,0,2
1683317119251,COMM 100B,A02,185476,Staff,14,0,25,11
1683317120276,COMM 100C,A01,185314,Staff,1,0,25,24
1683317120276,COMM 100C,A02,185327,Staff,19,0,25,6
1683317121299,COMM 110M,A00,185349,Staff,2,0,40,38
1683317122324,COMM 113T,A00,185352,Staff,25,0,40,15
1683317123348,COMM 114I,A00,185353,Staff,33,0,40,7
1683317124374,COMM 131,A00,185354,Staff,19,0,30,11
1683317125401,CSE 8A,A50,185358,Cao; Yingjun,0,46,10,10
1683317126424,CSE 8B,A01,185362,Staff,1,47,50,49
1683317127449,CSE 11,A01,185416,Cao; Yingjun,0,92,10,10
1683317128477,CSE 20,A01,185445,Briones; Jor-el Thomas Caparas,5,0,25,20
1683317129503,CSE 21,A01,185447,Staff,10,0,50,40
1683317130528,CSE 101,A01,185451,Staff,0,12,50,50
1683317130528,CSE 101,B01,185453,Jones; Miles E,0,11,50,50
1683317132578,CSE 141,A01,185458,Eldon; John,20,0,100,80
1683317133604,CSE 141L,A01,185461,Eldon; John,12,0,100,88
1683317134629,CSE 142,A01,185463,Staff,36,0,60,24
1683317134629,CSE 142,B01,201355,Staff,0,7,60,60
1683317135657,CSE 142L,A01,185470,Staff,36,0,60,24
1683317135657,CSE 142L,B01,201417,Staff,0,6,60,60
1683317136684,CSE 190,A00,201433,Staff,32,0,49,17
1683317137712,DOC 1,A01,259136,Strom; Megan C.,7,0,15,8
1683317137712,DOC 1,A02,259137,Strom; Megan C.,14,0,15,1
1683317137712,DOC 1,A03,259138,Strom; Megan C.,14,0,15,1
1683317137712,DOC 1,A04,259139,Strom; Megan C.,14,0,15,1
1683317138739,DOC 100D,A00,259140,Pass; Natalye Joann,17,0,25,8
1683317139763,DSGN 1,A01,184749,Rill; Bryan,0,25,30,30
1683317140788,DSGN 100,A01,185168,Staff,0,2,25,25
1683317141813,ECE 5,A01,185626,Morris; Karcher William,0,10,0,0
1683317142838,ECE 101,A01,185628,Staff,17,0,70,53
1683317143861,ECE 107,A01,185635,Baghdadchi; Saharnaz,0,0,20,20
1683317143861,ECE 107,A02,185638,Baghdadchi; Saharnaz,4,0,20,16
1683317144884,ECE 148,A01,185647,Silberman; Jack,0,0,16,16
1683317145908,ECON 1,A01,185537,Crane; Meredith Helen,54,0,70,16
1683317146935,ECON 3,A01,185549,Crane; Meredith Helen,33,0,70,37
1683317147959,ECON 4,A01,203354,Anderson; John Charles,0,4,10,10
1683317148986,ECON 100A,A01,185574,Staff,0,4,40,40
1683317150017,ECON 100B,A01,185576,Staff,0,22,40,40
1683317151041,ECON 100C,A01,185589,Newhouse; Herbert S,30,0,70,40
1683317152065,ECON 105,A00,185608,Vespa; Emanuel Ignacio,19,0,35,16
1683317153092,ECON 109,A01,185610,Shishkin; Denis,10,0,35,25
1683317154116,ECON 110A,A01,185612,Staff,11,0,40,29
1683317155139,ECON 120A,A01,185615,Staff,20,0,40,20
1683317156163,ECON 120C,A01,185617,Sun; Yixiao,0,20,70,70
1683317157188,ECON 144,A00,203346,Squires; Dale E,3,0,35,32
1683317158214,ECON 171,A01,203349,Newhouse; Herbert S,0,1,35,35
1683317159239,ECON 173A,A01,185621,Toda; Alexis Akira,21,0,35,14
1683317160269,EDS 25,A01,202413,Staff,0,1,0,0
1683317160269,EDS 25,A02,202414,Staff,0,1,0,0
1683317160269,EDS 25,A03,202415,Staff,0,0,0,0
1683317160269,EDS 25,A04,202416,Staff,0,1,0,0
1683317160269,EDS 25,A05,202439,Staff,0,0,0,0
1683317160269,EDS 25,A06,202440,Staff,0,0,0,0
1683317160269,EDS 25,B01,202631,Staff,0,0,0,0
1683317160269,EDS 25,B02,202632,Staff,0,0,0,0
1683317160269,EDS 25,B03,202639,Staff,0,0,0,0
1683317160269,EDS 25,B04,202640,Staff,0,0,0,0
1683317160269,EDS 25,B05,202643,Staff,0,0,0,0
1683317160269,EDS 25,B06,202644,Staff,0,0,0,0
1683317161294,EDS 38,A01,202659,Black; Alison Michelle,24,0,25,1
1683317162318,EDS 115,A00,202652,Staff,17,0,30,13
1683317163343,EDS 125,A00,202649,Staff,14,0,30,16
1683317164367,EDS 126,A01,203332,Staff,30,0,30,0
1683317165391,EDS 139,A00,202838,Staff,16,0,25,9
1683317166420,EDS 146,A01,202655,Staff,14,0,25,11
1683317167444,ENG 15,A00,185667,Staff,0,1,0,0
1683317167444,ENG 15,B00,185672,Staff,0,0,0,0
1683317167444,ENG 15,C00,185675,Staff,0,0,0,0
1683317167444,ENG 15,D00,185682,Staff,0,0,0,0
1683317167444,ENG 15,E00,185684,Staff,0,0,0,0
1683317168468,ETHN 103,A00,185710,Staff,0,3,35,35
1683317169492,ETHN 103A,A00,199228,Man; Simeon S,2,0,9,7
1683317170516,ETHN 109,A00,185711,Staff,18,0,35,17
1683317171546,ETHN 142,A00,185726,Staff,0,4,30,30
1683317172569,ETHN 163J,A00,199229,Man; Simeon S,5,0,8,3
1683317173596,ETHN 168,A00,185727,Staff,8,0,10,2
1683317174625,ETHN 182,A00,185728,Staff,1,0,35,34
1683317175651,ETHN 183,A00,185737,Staff,8,0,18,10
1683317176679,GLBH 111,A01,209361,Burgos; Jose L.,0,0,0,0
1683317178733,HIEU 104,A00,185792,Staff,16,0,20,4
1683317179757,HIEU 115,A00,185800,Staff,1,0,20,19
1683317180784,HIEU 128,A00,185801,Staff,0,7,20,20
1683317181809,HIEU 147,A00,185802,Staff,16,0,20,4
1683317182838,HIEU 154,A00,185823,Staff,12,0,20,8
1683317183862,HILA 102,A00,185826,Staff,13,0,20,7
1683317184887,HILD 2C,A01,185778,Staff,0,12,20,20
1683317185916,HILD 7B,A01,185780,Kwak; Nancy,0,15,32,32
1683317185916,HILD 7B,A02,185781,Kwak; Nancy,0,18,32,32
1683317186960,HILD 30,A01,185791,Staff,14,0,20,6
1683317187984,HISC 119,A00,185830,Golan; Tal,0,9,20,20
1683317189009,HITO 156GS,A00,185831,Patterson; Patrick H.,0,0,0,23
1683317190038,HIUS 103,A00,185832,Man; Simeon S,0,6,20,20
1683317191062,HIUS 117,A00,185836,Kwak; Nancy,2,0,20,18
1683317192089,HIUS 125,A00,185840,Man; Simeon S,0,0,23,23
1683317193113,HIUS 149,A00,185845,Staff,0,0,20,20
1683317194140,HUM 3,A01,185882,Zavodny; Tatiana Sophia,0,6,50,50
1683317194140,HUM 3,B01,185899,Caldwell; Michael Alan,0,19,50,50
1683317195169,HUM 3GS,A00,185900,Patterson; Patrick H.,0,0,0,23
1683317196194,HUM 4,A01,185938,Zroka; Amy Liane,31,0,50,19
1683317196194,HUM 4,B01,185956,Watkins; Eric,0,2,50,50
1683317196194,HUM 4,B02,202209,Watkins; Eric,0,2,50,50
1683317196194,HUM 4,B03,202210,Watkins; Eric,0,0,50,50
1683317197217,HUM 5,A01,185958,West; Geoffrey Scott,4,0,50,46
1683317197217,HUM 5,A02,202215,West; Geoffrey Scott,0,0,50,50
1683317198241,INTL 190,A00,185959,Gagnon; Jeffrey C,0,0,0,9
1683317198241,INTL 190,B00,185960,Lettieri; Michael Joseph,0,0,0,1
1683317199265,JAPN 180,A00,254509,Staff,5,1,30,25
1683317200290,LATI 10,A01,202853,Kennemore; Amy Michelle,5,0,35,30
1683317200290,LATI 10,A02,202854,Kennemore; Amy Michelle,1,0,35,34
1683317200290,LATI 10,A03,270054,Kennemore; Amy Michelle,30,0,30,0
1683317201315,LATI 180,A00,202855,Kennemore; Amy Michelle,11,0,20,9
1683317202337,LAWS 101,A00,201767,Golan; Tal,0,7,40,40
1683317203361,LIFR 1C,A00,185961,Staff,6,0,20,14
1683317204390,LIFR 1CX,A00,185962,Staff,7,0,20,13
1683317205489,LIFR 1D,A00,185963,Staff,9,0,20,11
1683317206515,LIFR 1DX,A00,185964,Staff,9,0,20,11
1683317207543,LIGN 101,A01,186039,Staff,43,0,50,7
1683317208573,LIGN 165,A00,186040,Staff,18,0,50,32
1683317209602,LTCS 108,A00,186041,Staff,6,0,10,4
1683317210628,LTCS 119,A00,186042,Staff,16,0,20,4
1683317211656,LTCS 130,A00,186043,Wesling; Megan E.,15,0,25,10
1683317213710,LTEA 138,A00,186119,Staff,14,0,40,26
1683317214734,LTEN 124,A00,186148,Staff,6,0,25,19
1683317215768,LTEN 178,A00,186149,Staff,7,0,15,8
1683317216791,LTEN 181,A00,186150,Blanco; John D,33,0,40,7
1683317217816,LTWL 120,A00,186160,Staff,20,0,25,5
1683317218840,LTWL 165,A00,186161,Staff,22,0,25,3
1683317219863,LTWR 100,A00,186162,Staff,0,4,15,15
1683317220888,LTWR 102,A00,186163,Doller; Ben,5,0,15,10
1683317221916,MAE 8,A01,186412,Staff,0,0,0,0
1683317222944,MAE 30B,A00,186445,Bahadori; Mohammad Yousef,83,0,100,17
1683317223971,MAE 40,A00,186592,Bewley; Thomas R,9,0,50,41
1683317224995,MAE 101B,A00,186593,Bahadori; Mohammad Yousef,81,0,100,19
1683317226021,MAE 105,A00,186594,Bandaru; Prabhakar,12,0,50,38
1683317227046,MAE 107,A00,186599,Pham; Hieu Tan,0,6,120,120
1683317228072,MAE 148,A01,186660,Silberman; Jack,3,0,16,13
1683317229106,MATH 10A,A01,188095,Staff,0,6,35,35
1683317230132,MATH 10B,A01,188097,Bowers; Adam R.,0,11,30,30
1683317230132,MATH 10B,A02,188099,Bowers; Adam R.,0,11,30,30
1683317230132,MATH 10B,B01,188104,Bowers; Adam R.,0,10,30,30
1683317230132,MATH 10B,B02,188106,Bowers; Adam R.,0,10,30,30
1683317231159,MATH 10C,A01,188111,Staff,0,18,30,30
1683317231159,MATH 10C,A02,188127,Staff,0,17,30,30
1683317231159,MATH 10C,A03,188131,Staff,0,18,30,30
1683317231159,MATH 10C,B01,188218,Staff,20,0,30,10
1683317231159,MATH 10C,B02,188244,Staff,13,0,30,17
1683317231159,MATH 10C,B03,188277,Staff,16,0,30,14
1683317232184,MATH 18,A01,188344,Bach; Quang Tran,18,0,30,12
1683317232184,MATH 18,A02,188345,Bach; Quang Tran,11,0,30,19
1683317232184,MATH 18,B01,188353,Bach; Quang Tran,10,0,30,20
1683317232184,MATH 18,B02,188354,Bach; Quang Tran,20,0,30,10
1683317233207,MATH 20A,A01,188374,Staff,13,0,35,22
1683317234236,MATH 20B,A01,188382,Ohm; Ko Woon,6,0,30,24
1683317234236,MATH 20B,A02,188383,Ohm; Ko Woon,23,0,30,7
1683317234236,MATH 20B,B01,188385,Ohm; Ko Woon,7,0,30,23
1683317234236,MATH 20B,B02,188392,Ohm; Ko Woon,22,0,30,8
1683317235262,MATH 20C,A01,188394,Harel; Guershon,10,0,30,20
1683317235262,MATH 20C,A02,188395,Harel; Guershon,14,0,30,16
1683317235262,MATH 20C,B01,188404,Harel; Guershon,5,0,30,25
1683317235262,MATH 20C,B02,188405,Harel; Guershon,19,0,30,11
1683317236287,MATH 20D,A01,188414,Hammock; Frances H,0,1,30,30
1683317236287,MATH 20D,A02,188415,Hammock; Frances H,3,0,30,27
1683317236287,MATH 20D,B01,188447,Hammock; Frances H,2,0,30,28
1683317236287,MATH 20D,B02,188486,Hammock; Frances H,8,0,30,22
1683317237312,MATH 20E,A01,188649,Staff,21,0,30,9
1683317237312,MATH 20E,A02,188650,Staff,23,0,30,7
1683317237312,MATH 20E,A03,188673,Staff,0,0,30,30
1683317238336,MATH 102,A01,188675,Staff,0,35,35,35
1683317239364,MATH 103B,A01,188681,Staff,4,0,35,31
1683317239364,MATH 103B,B01,188692,Staff,5,0,35,30
1683317240389,MATH 109,A01,188695,Salehi Golsefidy; Alireza,25,0,35,10
1683317240389,MATH 109,A02,188696,Salehi Golsefidy; Alireza,26,0,35,9
1683317241414,MATH 120A,A01,188698,Eggers; John Dietrich,7,0,35,28
1683317242437,MATH 142B,A01,188736,Ioana; Adrian,0,2,30,30
1683317242437,MATH 142B,A02,188741,Ioana; Adrian,0,1,30,30
1683317242437,MATH 142B,A03,188743,Ioana; Adrian,1,3,30,29
1683317243465,MATH 168A,A01,188790,Staff,0,9,35,35
1683317244488,MATH 170A,A01,188803,Nie; Jiawang,0,2,35,35
1683317244488,MATH 170A,A02,188811,Nie; Jiawang,0,0,35,35
1683317244488,MATH 170A,A03,188814,Nie; Jiawang,0,0,35,35
1683317244488,MATH 170A,A04,188815,Nie; Jiawang,13,0,35,22
1683317245516,MATH 193B,A01,188817,Staff,0,0,35,35
1683317245516,MATH 193B,A02,188818,Staff,6,0,35,29
1683317246540,MGT 4,A01,202857,Anderson; John Charles,62,0,80,18
1683317247564,MGT 12,A00,202858,Lindenberger; Wade Douglas,43,0,90,47
1683317248589,MGT 18,A00,202859,Staff,74,0,90,16
1683317249613,MGT 18GS,A00,202860,McKay; Michael J,13,0,28,15
1683317250639,MGT 45,A00,202861,Pecore; Joseph P.,13,0,90,77
1683317251663,MGT 100,A00,202863,Yavorsky; Daniel Ryan,28,0,90,62
1683317252693,MGT 103,A00,202864,Ehrich; Kristine R,0,17,90,90
1683317253719,MGT 112,A00,202865,Ehrich; Kristine R,15,0,90,75
1683317254746,MGT 121A,A00,202868,Staff,0,19,0,0
1683317255777,MGT 131B,A00,202869,Anderson; John Charles,59,0,90,31
1683317256804,MGT 136,A00,202871,Lindenberger; Wade Douglas,84,0,90,6
1683317257829,MGT 164,A00,202873,Staff,0,68,90,91
1683317258860,MGT 164GS,A00,202874,McKay; Mary A,13,0,28,15
1683317259884,MGT 180,A00,202875,Staff,0,50,90,91
1683317260907,MMW 11R,A01,205019,Herbst; Matthew,3,0,30,27
1683317260907,MMW 11R,A02,205026,Herbst; Matthew,29,0,30,1
1683317261937,MMW 15,A01,193512,Chang; Edmond Yi-Teh,0,9,28,28
1683317261937,MMW 15,A02,193513,Chang; Edmond Yi-Teh,0,5,28,28
1683317261937,MMW 15,A03,193514,Chang; Edmond Yi-Teh,0,5,28,28
1683317261937,MMW 15,A04,193515,Chang; Edmond Yi-Teh,0,5,28,28
1683317261937,MMW 15,A05,193516,Chang; Edmond Yi-Teh,0,4,28,28
1683317261937,MMW 15,A06,193517,Chang; Edmond Yi-Teh,0,5,28,28
1683317261937,MMW 15,B01,193519,Chang; Edmond Yi-Teh,0,4,28,28
1683317261937,MMW 15,B02,193520,Chang; Edmond Yi-Teh,0,5,28,28
1683317261937,MMW 15,B03,193521,Chang; Edmond Yi-Teh,0,4,28,28
1683317261937,MMW 15,B04,193522,Chang; Edmond Yi-Teh,0,4,28,28
1683317261937,MMW 15,B05,193523,Chang; Edmond Yi-Teh,0,5,28,28
1683317261937,MMW 15,B06,193524,Chang; Edmond Yi-Teh,0,4,28,28
1683317262964,MMW 122,A01,193526,Rahimi; Babak,0,14,28,28
1683317262964,MMW 122,A02,193527,Rahimi; Babak,0,14,28,28
1683317262964,MMW 122,A03,193528,Rahimi; Babak,0,0,0,0
1683317262964,MMW 122,A04,193529,Rahimi; Babak,0,0,0,0
1683317263988,MUS 1A,A01,186663,Staff,0,20,35,35
1683317265012,MUS 4,A01,186715,Staff,0,12,35,35
1683317266040,MUS 5R,A01,186796,Dubnov; Shlomo,0,17,35,35
1683317267067,MUS 6,A01,186798,Staff,0,3,25,25
1683317268092,MUS 7,A01,186830,Staff,12,0,35,23
1683317269114,MUS 8,A01,186930,Staff,0,26,35,35
1683317270138,MUS 15,A01,186932,Staff,0,15,35,35
1683317270138,MUS 15,B01,186934,Staff,0,15,35,35
1683317271165,MUS 80,A00,186935,Staff,2,0,20,18
1683317271165,MUS 80,B00,186936,Staff,25,0,25,0
1683317272188,NANO 11,A00,204702,Lipomi; Darren John,0,0,0,0
1683317273215,NANO 15,A01,204709,Yang; Kesong,0,1,0,0
1683317274239,NANO 114,A00,202069,Jahed Motlagh; Zeinab,3,0,10,7
1683317275266,PHIL 1,A00,186955,Grush; Rick Scott,32,0,40,8
1683317276294,PHIL 10,A01,186973,Grush; Rick Scott,28,0,35,7
1683317276294,PHIL 10,A02,186974,Grush; Rick Scott,33,0,35,2
1683317277322,PHIL 13,A01,186976,Staff,7,0,35,28
1683317277322,PHIL 13,A02,186977,Staff,16,0,35,19
1683317278351,PHIL 14,A01,186979,Staff,31,0,35,4
1683317278351,PHIL 14,A02,186986,Staff,32,0,35,3
1683317279376,PHIL 28,A01,186988,Staff,16,0,30,14
1683317279376,PHIL 28,A02,186989,Staff,1,0,30,29
1683317279376,PHIL 28,A03,186990,Staff,9,0,30,21
1683317279376,PHIL 28,A04,186991,Staff,26,0,30,4
1683317280406,PHIL 120,A00,186997,Staff,23,0,40,17
1683317281430,PHIL 137,A00,187003,Staff,9,0,40,31
1683317282456,PHIL 150,A00,187015,Staff,47,0,70,23
1683317283481,PHIL 167,A00,187021,Lamey; Andy M.,35,0,40,5
1683317284506,PHIL 174,A01,202226,Staff,17,0,20,3
1683317284506,PHIL 174,A02,202235,Staff,20,0,20,0
1683317285530,PHIL 191A,A00,258918,Staff,0,0,1,1
1683317286554,PHYS 1A,A00,187028,Staff,27,0,60,33
1683317287583,PHYS 1AL,001,187036,Staff,3,0,30,27
1683317287583,PHYS 1AL,002,187049,Staff,18,0,30,12
1683317288610,PHYS 1B,A00,187058,Staff,22,0,60,38
1683317289637,PHYS 1BL,001,187064,Staff,0,0,30,30
1683317289637,PHYS 1BL,002,187070,Staff,5,0,30,25
1683317290665,PHYS 1C,A00,187082,Staff,31,0,120,89
1683317291693,PHYS 1CL,001,187088,Staff,0,9,30,30
1683317291693,PHYS 1CL,002,187089,Staff,0,2,30,30
1683317291693,PHYS 1CL,009,262693,Staff,11,0,30,19
1683317292720,PHYS 2B,A01,187097,Staff,54,0,115,61
1683317293749,PHYS 2C,A01,187099,Staff,67,0,115,48
1683317294776,PHYS 2CL,A01,187101,Staff,5,0,28,23
1683317294776,PHYS 2CL,A02,187102,Staff,15,0,28,13
1683317295800,PHYS 2D,A01,187123,Shotwell; Brian,95,0,115,20
1683317296828,PHYS 4B,A01,187133,Grinstein; Benjamin,35,0,50,15
1683317297855,POLI 10,A00,188819,Staff,0,4,50,50
1683317298882,POLI 11,A00,188827,Staff,43,0,50,7
1683317299907,POLI 13R,A00,188828,Staff,0,1,20,20
1683317300934,POLI 27,A01,188830,Elgin; Samuel Zincke,0,1,70,70
1683317301962,POLI 30,A00,188832,Desposato; Scott,32,0,50,18
1683317302987,POLI 102F,A00,188834,Staff,3,0,40,37
1683317304015,POLI 104A,A00,188852,Staff,14,0,30,16
1683317305039,POLI 104I,A00,188853,Staff,0,6,20,20
1683317306064,POLI 110B,A00,188854,Wiens; David,7,0,20,13
1683317307088,POLI 112A,A00,188855,Wiens; David,5,0,30,25
1683317308110,POLI 117R,A00,188856,Forman; Fonna,0,11,20,20
1683317309192,POLI 118,A00,188857,Ingham; Sean,8,0,20,12
1683317310221,POLI 120G,A00,188858,Staff,9,0,30,21
1683317311247,POLI 131CR,A00,188863,Hoston; Germaine,24,0,50,26
1683317312273,POLI 133,A00,188864,Nellis; Gareth Hb,44,0,50,6
1683317313300,POLI 134D,A00,188865,Desposato; Scott,27,0,30,3
1683317314323,POLI 142A,A00,188871,Gartzke; Erik,22,0,50,28
1683317315351,POLI 142K,A00,188874,Staff,38,0,50,12
1683317316380,POLI 143,A00,188940,Gartzke; Erik,16,0,30,14
1683317317406,POLI 153,A00,188943,Staff,3,0,20,17
1683317318432,POLI 160AA,A00,188944,Staff,12,0,40,28
1683317319456,POLI 170A,A00,188945,Staff,11,0,30,19
1683317321516,PSYC 1,A00,188952,Staff,37,0,90,53
1683317322545,PSYC 2,B00,188953,Staff,19,0,35,16
1683317323570,PSYC 6,A00,188970,Staff,47,0,60,13
1683317324598,PSYC 7,A00,188973,Staff,37,0,45,8
1683317325625,PSYC 60,A01,188980,Rickard; Timothy C.,43,0,60,17
1683317326654,PSYC 70,A01,189001,Steiner; Eric Tomas,24,0,45,21
1683317327679,PSYC 100,A00,189005,Lacefield; Katharine I,0,99,120,120
1683317328705,PSYC 102,A00,189008,Staff,10,0,30,20
1683317329728,PSYC 106,B00,189026,Gorman; Michael R.,36,0,60,24
1683317330755,PSYC 114,B01,189033,Winkielman; Piotr,0,32,30,30
1683317331782,PSYC 131,A00,189036,Anagnostaras; Stephan,0,43,60,60
1683317332810,PSYC 136,A00,189041,Lowe; Angela Beth,0,7,25,25
1683317333833,PSYC 137,A00,189057,Winkielman; Piotr,0,34,25,25
1683317334861,PSYC 144,A00,189107,Wixted; John T,0,7,50,50
1683317336912,PSYC 162,A00,189142,Staff,0,8,85,85
1683317337937,PSYC 172,A00,189144,Gorman; Michael R.,0,7,30,30
1683317339991,PSYC 179,A00,189146,Lacefield; Katharine I,0,84,120,120
1683317341021,PSYC 181,A00,189147,Anagnostaras; Stephan,0,44,90,90
1683317342049,PSYC 190R,A00,189148,Barner; David A.,0,22,80,80
1683317343073,PSYC 191,A00,189275,Rickard; Timothy C.,0,7,25,25
1683317344101,PSYC 193,A00,189276,Chapman; Eddie Nathaniel,0,1,0,4
1683317345126,PSYC 193L,A01,189281,Lowe; Angela Beth,12,0,20,8
1683317345126,PSYC 193L,B01,189285,Staff,28,0,35,7
1683317346150,RELI 149,A00,187137,Rahimi; Babak,7,0,40,33
1683317347180,SE 9,A01,187315,Staff,0,2,18,18
1683317348203,SE 101B,A00,187409,Staff,24,0,30,6
1683317349228,SE 110B,A00,187444,Staff,10,0,40,30
1683317350256,SE 130B,A00,187449,Staff,31,0,40,9
1683317351280,SE 150A,A00,187516,Staff,9,0,20,11
1683317352306,SE 154,A00,187528,Staff,30,0,50,20
1683317353330,SIO 3,A01,258171,Staff,35,0,40,5
1683317354354,SIO 10,A00,187144,Cook; Geoffrey W,0,3,75,75
1683317355381,SIO 45,A00,187152,Cook; Geoffrey W,1,0,100,99
1683317356404,SIO 109R,A00,194486,Staff,0,3,20,20
1683317358457,SIO 187,A01,187233,Kacev; David,12,0,40,28
1683317359486,SOCI 1,A01,258656,Thorpe; Charles Robert,28,0,30,2
1683317359486,SOCI 1,A02,258658,Thorpe; Charles Robert,30,0,30,0
1683317359486,SOCI 1,A03,258661,Thorpe; Charles Robert,25,0,25,0
1683317359486,SOCI 1,A04,258666,Thorpe; Charles Robert,22,0,25,3
1683317359486,SOCI 1,A05,258897,Thorpe; Charles Robert,23,0,25,2
1683317359486,SOCI 1,A06,258898,Thorpe; Charles Robert,25,0,25,0
1683317360517,SOCI 30,A01,258903,Pardo Guerra; Juan Pablo,16,0,30,14
1683317361541,SOCI 102,A00,258904,Staff,9,0,25,16
1683317362569,SOCI 106,A00,258905,Staff,19,0,25,6
1683317363597,SOCI 111,A00,258907,Ribas Norris; Janet Vanesa,26,0,30,4
1683317364621,SOCI 121R,A00,258908,Pardo Guerra; Juan Pablo,11,0,30,19
1683317365648,SOCI 126,A01,203330,Staff,14,0,20,6
1683317366675,SOCI 131,A00,258909,Thorpe; Charles Robert,31,0,60,29
1683317367699,SOCI 135,A00,258910,Payne; Christine Anna,0,9,30,30
1683317368728,SOCI 157,A00,258911,Staff,12,0,30,18
1683317369752,SOCI 184,A00,258912,Staff,25,0,30,5
1683317370779,SOCI 188D,A00,258913,Staff,21,0,30,9
1683317371806,SYN 2,001,187529,Staff,9,0,16,7
1683317371806,SYN 2,002,201452,Staff,0,18,16,16
1683317371806,SYN 2,003,201469,Staff,4,0,16,12
1683317372832,SYN 100,A01,187531,Staff,0,9,20,20
1683317372832,SYN 100,B01,201491,Staff,0,12,20,20
1683317373858,TDAC 1,A00,189286,Walsh; Kim C.,3,0,20,17
1683317373858,TDAC 1,B00,189287,Harting; Carla Kelso,11,0,20,9
1683317374884,TDAC 101,A00,189300,Walsh; Kim C.,16,0,20,4
1683317374884,TDAC 101,B00,189301,Harting; Carla Kelso,18,0,20,2
1683317375911,TDAC 102,A00,189304,Basso; Beatrice,14,0,20,6
1683317376937,TDAC 108,A00,189305,Staff,18,0,20,2
1683317377964,TDDE 131,A00,189310,Staff,19,0,20,1
1683317377964,TDDE 131,B00,189314,Staff,19,0,20,1
1683317377964,TDDE 131,C00,189315,Staff,48,0,50,2
1683317377964,TDDE 131,D00,189316,Staff,14,0,15,1
1683317377964,TDDE 131,E00,204841,Staff,20,0,20,0
1683317378987,TDGE 10,A00,189289,Staff,30,0,50,20
1683317378987,TDGE 10,B00,189290,Havis; Allan,2,0,50,48
1683317380013,TDGE 11,A00,189291,Fulton; Julia,0,3,50,50
1683317380013,TDGE 11,B00,189292,Staff,20,0,25,5
1683317380013,TDGE 11,C00,260270,Staff,0,0,0,0
1683317381039,TDGE 25,A00,189294,Staff,3,0,20,17
1683317382065,TDGE 124,A00,189318,Fulton; Julia,0,8,50,50
1683317383090,TDGE 125,A00,189319,Staff,13,0,25,12
1683317383090,TDGE 125,B00,189320,Staff,23,0,25,2
1683317384117,TDGE 127,A00,189322,Havis; Allan,0,0,50,50
1683317385142,TDHT 101,A00,189323,Staff,18,0,25,7
1683317385142,TDHT 101,B00,189324,Staff,25,0,25,0
1683317386166,TDHT 102,A00,189325,Staff,49,0,50,1
1683317387191,TDMV 1,A00,189295,Arcidiacono; Kristin,20,0,30,10
1683317387191,TDMV 1,B00,189296,Caligagan; Maria T.,24,0,30,6
1683317388216,TDMV 2,A00,189297,Sammartano; Tonnie,28,0,30,2
1683317388216,TDMV 2,B00,189299,Arcidiacono; Kristin,24,0,30,6
1683317389240,TDMV 3,A00,204998,Rincon; Alicia,22,0,30,8
1683317390265,TDMV 120,A00,189458,Sammartano; Tonnie,28,0,30,2
1683317391290,TDMV 138,A00,189541,Jun; Grace Shin Hae,22,0,40,18
1683317392315,TDMV 142,A00,189717,Caligagan; Tony,23,0,30,7
1683317392315,TDMV 142,B00,189718,Caligagan; Maria T.,25,0,30,5
1683317393343,TMC 2,A01,187533,Staff,25,0,25,0
1683317393343,TMC 2,A02,187534,Staff,25,0,25,0
1683317394367,USP 1,A01,187536,Kwak; Nancy,0,16,25,25
1683317395393,USP 5,A01,187538,Staff,9,0,25,16
1683317396422,USP 101,A00,199253,Staff,0,4,0,0
1683317397449,USP 124,A00,187562,Boomhower; Matthew Charles,1,0,30,29
1683317398473,USP 138,A00,187582,Staff,20,0,25,5
1683317399501,USP 152,A01,187597,Staff,4,0,25,21
1683317400531,USP 153,A00,187598,Staff,19,0,25,6
1683317401554,USP 168,A00,187607,Kwak; Nancy,2,0,5,3
1683317402579,USP 173,A00,187619,Staff,4,0,25,21
1683317403621,USP 181,A00,187638,Staff,0,0,25,25
1683317404646,VIS 103,A00,187650,Cruz; Edwin Teddy,23,0,75,52
1683317405670,VIS 110D,A00,187669,Staff,12,0,22,10
1683317406694,VIS 127C,A00,187720,Shen; Kuiyi,68,0,146,78
1683317407718,VIS 149,A00,187731,Yoldas; Pinar,0,14,22,22
1683317408746,VIS 151,A01,188091,Staff,22,0,34,12
1683317408746,VIS 151,A02,188092,Staff,11,0,34,23
1683317409774,VIS 160B,A00,188093,Stalbaum; Brett,0,0,10,10
1683317411827,WCWP 10B,A00,201720,Staff,10,0,15,5
1683317411827,WCWP 10B,B00,201722,Staff,8,0,15,7
1683317412907,WCWP 100,A00,201725,Gagnon; Jeffrey C,0,0,2,2
1683317412907,WCWP 100,B00,201727,Staff,0,4,15,15
1683317416033,ANBI 133,A00,258401,Wilder; Linnea Lorene,34,0,40,6
1683317417059,ANBI 140,A00,258395,Hrvoj Mihic; Branka,18,0,25,7
1683317418087,ANSC 120,A00,258402,Bialecki; Jon Anthony,27,0,40,13
1683317419112,ANSC 144,A00,258400,Staff,14,0,40,26
1683317421166,ANSC 166,A00,258396,Parish; Steven Martin,157,0,175,18
1683317422189,ANSC 180,A00,193533,Staff,9,0,20,11
1683317423219,ANSC 188,A00,258397,Jassal; Aftab,33,0,40,7
1683317424244,ANTH 3,A01,258316,Staff,23,0,30,7
1683317425272,ANTH 5,A00,258394,Semendeferi; Ekaterini,16,0,20,4
1683317426299,ANTH 21,A01,258331,Staff,9,0,40,31
1683317427324,ANTH 103,A00,258398,Varma; Saiba,15,0,25,10
1683317428360,AWP 10,001,202034,Staff,0,0,0,0
1683317428360,AWP 10,002,202035,Staff,0,0,0,0
1683317428360,AWP 10,003,202036,Staff,0,0,0,0
1683317428360,AWP 10,004,202037,Staff,0,0,0,0
1683317428360,AWP 10,005,202038,Staff,0,0,0,0
1683317428360,AWP 10,006,202039,Staff,0,0,0,0
1683317428360,AWP 10,007,202040,Staff,0,0,0,0
1683317428360,AWP 10,008,202041,Staff,0,0,0,0
1683317428360,AWP 10,009,202042,Staff,0,0,0,0
1683317428360,AWP 10,010,202043,Staff,0,0,0,0
1683317428360,AWP 10,011,202044,Staff,0,0,0,0
1683317428360,AWP 10,012,202045,Staff,0,0,0,0
1683317428360,AWP 10,013,202046,Staff,0,0,0,0
1683317428360,AWP 10,014,202047,Staff,0,0,0,0
1683317428360,AWP 10,015,202048,Staff,0,0,0,0
1683317428360,AWP 10,016,202049,Staff,0,0,0,0
1683317428360,AWP 10,017,202050,Staff,0,0,0,0
1683317428360,AWP 10,018,202051,Staff,0,0,0,0
1683317428360,AWP 10,019,202052,Staff,0,0,0,0
1683317428360,AWP 10,020,202053,Staff,0,0,0,0
1683317428360,AWP 10,021,202054,Staff,0,0,0,0
1683317428360,AWP 10,022,202055,Staff,0,0,0,0
1683317428360,AWP 10,023,202056,Staff,0,0,0,0
1683317428360,AWP 10,024,202057,Staff,0,0,0,0
1683317428360,AWP 10,025,202058,Staff,0,0,0,0
1683317428360,AWP 10,026,202059,Staff,0,0,0,0
1683317429393,AWP 102,001,202032,Staff,0,0,0,0
1683317429393,AWP 102,002,202033,Staff,0,0,0,0
1683317430419,BENG 100,A01,254234,Taylor Amos; Alyssa C,31,0,40,9
1683317431442,BENG 196,001,270013,Engler; Adam J.,9999,0,9999,0
1683317432470,BICD 100R,A01,202018,Smith; Laurie,0,7,32,32
1683317432470,BICD 100R,A02,202019,Smith; Laurie,0,2,32,32
1683317432470,BICD 100R,A03,202020,Smith; Laurie,0,1,32,32
1683317432470,BICD 100R,A04,202021,Smith; Laurie,8,0,32,24
1683317432470,BICD 100R,A05,202022,Smith; Laurie,12,0,32,20
1683317433498,BICD 136,A01,193242,Gustafson-Brown; Cindy,0,2,32,32
1683317433498,BICD 136,A02,193244,Gustafson-Brown; Cindy,14,0,32,18
1683317434527,BIEB 102,A01,193249,Butler; Shannon Rhey,0,2,32,32
1683317434527,BIEB 102,A02,193251,Butler; Shannon Rhey,0,0,32,32
1683317434527,BIEB 102,A03,193253,Butler; Shannon Rhey,0,1,32,32
1683317434527,BIEB 102,A04,193255,Butler; Shannon Rhey,17,0,32,15
1683317434527,BIEB 102,A05,193265,Butler; Shannon Rhey,26,0,32,6
1683317434527,BIEB 102,A06,193269,Butler; Shannon Rhey,16,0,32,16
1683317436575,BIEB 150,A01,193274,Staff,0,0,32,32
1683317436575,BIEB 150,A02,193285,Staff,23,0,32,9
1683317437601,BIEB 194,A00,193286,Kurle; Carolyn M.,22,0,32,10
1683317438630,BILD 1,A01,192291,Staff,16,0,32,16
1683317438630,BILD 1,A02,192292,Staff,30,0,32,2
1683317438630,BILD 1,B01,192520,Reuther; Keefe,0,1,0,0
1683317438630,BILD 1,B02,192532,Reuther; Keefe,0,1,0,0
1683317439659,BILD 3,A01,192556,Butler; Shannon Rhey,0,0,32,32
1683317439659,BILD 3,A02,192581,Butler; Shannon Rhey,5,0,32,27
1683317439659,BILD 3,A03,192611,Butler; Shannon Rhey,23,0,32,9
1683317439659,BILD 3,A04,192612,Butler; Shannon Rhey,25,0,32,7
1683317439659,BILD 3,A05,192613,Butler; Shannon Rhey,27,0,32,5
1683317439659,BILD 3,A06,192679,Butler; Shannon Rhey,27,0,32,5
1683317439659,BILD 3,A07,192682,Butler; Shannon Rhey,22,0,32,10
1683317440688,BILD 4,A01,192836,Reuther; Keefe,1,0,24,23
1683317440688,BILD 4,A02,193044,Reuther; Keefe,4,0,24,20
1683317441716,BILD 10,A01,193142,Gustafson-Brown; Cindy,30,0,32,2
1683317441716,BILD 10,A02,193149,Gustafson-Brown; Cindy,31,0,32,1
1683317442741,BIMM 100,A01,193301,Staff,0,6,32,32
1683317442741,BIMM 100,A02,193312,Staff,0,5,32,32
1683317442741,BIMM 100,A03,193323,Staff,0,8,32,32
1683317443767,BIMM 101,A01,193329,McDonnell; Lisa Marie,0,3,24,24
1683317443767,BIMM 101,A02,193339,McDonnell; Lisa Marie,0,2,24,24
1683317443767,BIMM 101,B01,193354,McDonnell; Lisa Marie,0,3,24,24
1683317443767,BIMM 101,B02,193357,McDonnell; Lisa Marie,0,3,24,24
1683317444793,BIMM 110,A01,193377,Tat; John,0,11,32,32
1683317444793,BIMM 110,A02,193378,Tat; John,1,9,32,31
1683317445821,BIMM 120,A01,206116,Staff,0,0,32,32
1683317445821,BIMM 120,A02,206117,Staff,8,0,32,24
1683317445821,BIMM 120,A03,206121,Staff,21,0,32,11
1683317446850,BIPN 100,A01,193393,Park; Ji Young,0,14,32,32
1683317446850,BIPN 100,A02,193402,Park; Ji Young,0,12,32,32
1683317446850,BIPN 100,A03,193413,Park; Ji Young,0,14,32,32
1683317446850,BIPN 100,A04,193414,Park; Ji Young,0,13,32,32
1683317447874,BIPN 102,A01,193429,Staff,0,0,32,32
1683317447874,BIPN 102,A02,193438,Staff,22,0,32,10
1683317448898,BIPN 106,A01,193450,Reyes Gonzalez; Catalina,0,2,40,40
1683317449927,BIPN 134,A01,193465,Cooke; James Edward,0,0,32,32
1683317449927,BIPN 134,A02,193474,Cooke; James Edward,27,0,32,5
1683317449927,BIPN 134,A03,193485,Cooke; James Edward,29,0,32,3
1683317449927,BIPN 134,A04,193486,Cooke; James Edward,21,0,32,11
1683317449927,BIPN 134,A05,193491,Cooke; James Edward,31,0,32,1
1683317449927,BIPN 134,A06,193501,Cooke; James Edward,30,0,32,2
1683317449927,BIPN 134,A07,193510,Cooke; James Edward,29,0,32,3
1683317451974,BISP 194,A00,222522,Staff,15,0,32,17
1683317452999,CAT 124,A01,202407,Staff,20,0,25,5
1683317454023,CAT 125,A00,202408,Marchisotto; Jennifer Anne,4,0,20,16
1683317455048,CAT 125R,A00,202409,Smith; Lauryn Alissa,0,11,20,20
1683317455048,CAT 125R,B00,202410,Morales; Celeste Georgianna,0,11,20,20
1683317455048,CAT 125R,C00,202411,Irwin; Matthew Joseph,0,10,20,20
1683317456073,CENG 15,A01,204712,Yang; Kesong,0,1,0,0
1683317457097,CENG 114,A00,202070,Jahed Motlagh; Zeinab,5,0,20,15
1683317458133,CGS 105,A00,185477,Wesling; Megan E.,24,0,40,16
1683317459158,CGS 106,A00,185494,Staff,13,0,22,9
1683317460183,CGS 108,A00,185495,Staff,14,0,20,6
1683317461212,CGS 114,A00,185496,Staff,13,0,18,5
1683317462238,CGS 119,A00,185501,Staff,15,0,20,5
1683317463266,CGS 120,A00,185511,Staff,13,0,20,7
1683317464293,CHEM 4,A01,184675,Bussey; Thomas J,96,0,100,4
1683317465318,CHEM 6A,A01,184677,Staff,35,0,60,25
1683317466343,CHEM 6B,A01,184679,Staff,65,0,100,35
1683317467367,CHEM 6C,A01,184681,Bussey; Thomas J,1,0,50,49
1683317467367,CHEM 6C,A02,184682,Bussey; Thomas J,34,0,50,16
1683317468394,CHEM 40A,A01,184684,Albizati; Kim F.,37,0,100,63
1683317469420,CHEM 40B,A01,184686,Albizati; Kim F.,0,20,100,100
1683317470447,CHEM 41B,A01,184690,Staff,52,0,100,48
1683317471471,COGS 3,A01,184715,Boyle; Mary E. T.,0,25,40,40
1683317472495,COGS 14B,A01,185172,Staff,0,15,38,38
1683317473522,COGS 18,A01,184736,Staff,18,0,80,62
1683317474550,COGS 100,A01,184932,Staff,0,5,73,73
1683317475577,COGS 101A,A01,184935,Staff,0,38,30,30
1683317476600,COGS 101B,A01,184944,Staff,0,2,30,30
1683317477624,COGS 101C,A01,184946,Staff,0,12,30,30
1683317478649,COGS 102A,A01,184951,Johnson; Christine M.,2,0,40,38
1683317479673,COGS 107B,A01,184953,Mooshagian; Eric Frederick,0,50,40,40
1683317480700,COGS 118B,A01,184959,Gupta; Anjum,0,48,40,40
1683317481728,COGS 153,A00,184961,Staff,0,15,30,30
1683317482756,COGS 177,A00,184962,Staff,0,21,30,30
1683317483783,COGS 187A,A01,184969,Boyle; Mary E. T.,0,17,40,40
1683317484807,COMM 10,A01,185174,Staff,0,5,25,25
1683317484807,COMM 10,A02,185189,Staff,0,5,25,25
1683317484807,COMM 10,A03,269821,Staff,0,0,0,0
1683317485833,COMM 100B,A01,185475,Staff,0,0,0,2
1683317485833,COMM 100B,A02,185476,Staff,14,0,25,11
1683317486856,COMM 100C,A01,185314,Staff,1,0,25,24
1683317486856,COMM 100C,A02,185327,Staff,19,0,25,6
1683317487889,COMM 110M,A00,185349,Staff,2,0,40,38
1683317488913,COMM 113T,A00,185352,Staff,25,0,40,15
1683317489941,COMM 114I,A00,185353,Staff,33,0,40,7
1683317490964,COMM 131,A00,185354,Staff,19,0,30,11
1683317491989,CSE 8A,A50,185358,Cao; Yingjun,0,46,10,10
1683317493013,CSE 8B,A01,185362,Staff,1,47,50,49
1683317494040,CSE 11,A01,185416,Cao; Yingjun,0,92,10,10
1683317495065,CSE 20,A01,185445,Briones; Jor-el Thomas Caparas,5,0,25,20
1683317496090,CSE 21,A01,185447,Staff,10,0,50,40
1683317497114,CSE 101,A01,185451,Staff,0,12,50,50
1683317497114,CSE 101,B01,185453,Jones; Miles E,0,11,50,50
1683317499164,CSE 141,A01,185458,Eldon; John,20,0,100,80
1683317500187,CSE 141L,A01,185461,Eldon; John,12,0,100,88
1683317501211,CSE 142,A01,185463,Staff,36,0,60,24
1683317501211,CSE 142,B01,201355,Staff,0,7,60,60
1683317502235,CSE 142L,A01,185470,Staff,36,0,60,24
1683317502235,CSE 142L,B01,201417,Staff,0,6,60,60
1683317503261,CSE 190,A00,201433,Staff,32,0,49,17
1683317504287,DOC 1,A01,259136,Strom; Megan C.,7,0,15,8
1683317504287,DOC 1,A02,259137,Strom; Megan C.,14,0,15,1
1683317504287,DOC 1,A03,259138,Strom; Megan C.,14,0,15,1
1683317504287,DOC 1,A04,259139,Strom; Megan C.,14,0,15,1
1683317505312,DOC 100D,A00,259140,Pass; Natalye Joann,17,0,25,8
1683317506342,DSGN 1,A01,184749,Rill; Bryan,0,25,30,30
1683317507366,DSGN 100,A01,185168,Staff,0,2,25,25
1683317508391,ECE 5,A01,185626,Morris; Karcher William,0,10,0,0
1683317509418,ECE 101,A01,185628,Staff,17,0,70,53
1683317510443,ECE 107,A01,185635,Baghdadchi; Saharnaz,0,0,20,20
1683317510443,ECE 107,A02,185638,Baghdadchi; Saharnaz,4,0,20,16
1683317511471,ECE 148,A01,185647,Silberman; Jack,0,0,16,16
1683317512497,ECON 1,A01,185537,Crane; Meredith Helen,54,0,70,16
1683317513522,ECON 3,A01,185549,Crane; Meredith Helen,33,0,70,37
1683317514547,ECON 4,A01,203354,Anderson; John Charles,0,4,10,10
1683317515574,ECON 100A,A01,185574,Staff,0,4,40,40
1683317516657,ECON 100B,A01,185576,Staff,0,22,40,40
1683317517684,ECON 100C,A01,185589,Newhouse; Herbert S,30,0,70,40
1683317518709,ECON 105,A00,185608,Vespa; Emanuel Ignacio,19,0,35,16
1683317519737,ECON 109,A01,185610,Shishkin; Denis,10,0,35,25
1683317520761,ECON 110A,A01,185612,Staff,11,0,40,29
1683317521785,ECON 120A,A01,185615,Staff,20,0,40,20
1683317522809,ECON 120C,A01,185617,Sun; Yixiao,0,20,70,70
1683317523833,ECON 144,A00,203346,Squires; Dale E,3,0,35,32
1683317524861,ECON 171,A01,203349,Newhouse; Herbert S,0,1,35,35
1683317525886,ECON 173A,A01,185621,Toda; Alexis Akira,21,0,35,14
1683317526911,EDS 25,A01,202413,Staff,0,1,0,0
1683317526911,EDS 25,A02,202414,Staff,0,1,0,0
1683317526911,EDS 25,A03,202415,Staff,0,0,0,0
1683317526911,EDS 25,A04,202416,Staff,0,1,0,0
1683317526911,EDS 25,A05,202439,Staff,0,0,0,0
1683317526911,EDS 25,A06,202440,Staff,0,0,0,0
1683317526911,EDS 25,B01,202631,Staff,0,0,0,0
1683317526911,EDS 25,B02,202632,Staff,0,0,0,0
1683317526911,EDS 25,B03,202639,Staff,0,0,0,0
1683317526911,EDS 25,B04,202640,Staff,0,0,0,0
1683317526911,EDS 25,B05,202643,Staff,0,0,0,0
1683317526911,EDS 25,B06,202644,Staff,0,0,0,0
1683317527939,EDS 38,A01,202659,Black; Alison Michelle,24,0,25,1
1683317528964,EDS 115,A00,202652,Staff,17,0,30,13
1683317529988,EDS 125,A00,202649,Staff,14,0,30,16
1683317531012,EDS 126,A01,203332,Staff,30,0,30,0
1683317532039,EDS 139,A00,202838,Staff,16,0,25,9
1683317533067,EDS 146,A01,202655,Staff,14,0,25,11
1683317534094,ENG 15,A00,185667,Staff,0,1,0,0
1683317534094,ENG 15,B00,185672,Staff,0,0,0,0
1683317534094,ENG 15,C00,185675,Staff,0,0,0,0
1683317534094,ENG 15,D00,185682,Staff,0,0,0,0
1683317534094,ENG 15,E00,185684,Staff,0,0,0,0
1683317535119,ETHN 103,A00,185710,Staff,0,3,35,35
1683317536149,ETHN 103A,A00,199228,Man; Simeon S,2,0,9,7
1683317537176,ETHN 109,A00,185711,Staff,18,0,35,17
1683317538204,ETHN 142,A00,185726,Staff,0,4,30,30
1683317539227,ETHN 163J,A00,199229,Man; Simeon S,5,0,8,3
1683317540254,ETHN 168,A00,185727,Staff,8,0,10,2
1683317541281,ETHN 182,A00,185728,Staff,1,0,35,34
1683317542305,ETHN 183,A00,185737,Staff,8,0,18,10
1683317543330,GLBH 111,A01,209361,Burgos; Jose L.,0,0,0,0
1683317545378,HIEU 104,A00,185792,Staff,16,0,20,4
1683317546406,HIEU 115,A00,185800,Staff,1,0,20,19
1683317547430,HIEU 128,A00,185801,Staff,0,7,20,20
1683317548456,HIEU 147,A00,185802,Staff,16,0,20,4
1683317549482,HIEU 154,A00,185823,Staff,12,0,20,8
1683317550507,HILA 102,A00,185826,Staff,13,0,20,7
1683317551534,HILD 2C,A01,185778,Staff,0,12,20,20
1683317552557,HILD 7B,A01,185780,Kwak; Nancy,0,15,32,32
1683317552557,HILD 7B,A02,185781,Kwak; Nancy,0,18,32,32
1683317553585,HILD 30,A01,185791,Staff,14,0,20,6
1683317554612,HISC 119,A00,185830,Golan; Tal,0,9,20,20
1683317555639,HITO 156GS,A00,185831,Patterson; Patrick H.,0,0,0,23
1683317556666,HIUS 103,A00,185832,Man; Simeon S,0,6,20,20
1683317557694,HIUS 117,A00,185836,Kwak; Nancy,2,0,20,18
1683317558722,HIUS 125,A00,185840,Man; Simeon S,0,0,23,23
1683317559752,HIUS 149,A00,185845,Staff,0,0,20,20
1683317560777,HUM 3,A01,185882,Zavodny; Tatiana Sophia,0,6,50,50
1683317560777,HUM 3,B01,185899,Caldwell; Michael Alan,0,19,50,50
1683317561804,HUM 3GS,A00,185900,Patterson; Patrick H.,0,0,0,23
1683317562829,HUM 4,A01,185938,Zroka; Amy Liane,31,0,50,19
1683317562829,HUM 4,B01,185956,Watkins; Eric,0,2,50,50
1683317562829,HUM 4,B02,202209,Watkins; Eric,0,2,50,50
1683317562829,HUM 4,B03,202210,Watkins; Eric,0,0,50,50
1683317563852,HUM 5,A01,185958,West; Geoffrey Scott,4,0,50,46
1683317563852,HUM 5,A02,202215,West; Geoffrey Scott,0,0,50,50
1683317564876,INTL 190,A00,185959,Gagnon; Jeffrey C,0,0,0,9
1683317564876,INTL 190,B00,185960,Lettieri; Michael Joseph,0,0,0,1
1683317565903,JAPN 180,A00,254509,Staff,5,1,30,25
1683317566932,LATI 10,A01,202853,Kennemore; Amy Michelle,5,0,35,30
1683317566932,LATI 10,A02,202854,Kennemore; Amy Michelle,1,0,35,34
1683317566932,LATI 10,A03,270054,Kennemore; Amy Michelle,30,0,30,0
1683317567958,LATI 180,A00,202855,Kennemore; Amy Michelle,11,0,20,9
1683317568981,LAWS 101,A00,201767,Golan; Tal,0,7,40,40
1683317570005,LIFR 1C,A00,185961,Staff,6,0,20,14
1683317571033,LIFR 1CX,A00,185962,Staff,7,0,20,13
1683317572056,LIFR 1D,A00,185963,Staff,9,0,20,11
1683317573081,LIFR 1DX,A00,185964,Staff,9,0,20,11
1683317574104,LIGN 101,A01,186039,Staff,43,0,50,7
1683317575129,LIGN 165,A00,186040,Staff,18,0,50,32
1683317576154,LTCS 108,A00,186041,Staff,6,0,10,4
1683317577177,LTCS 119,A00,186042,Staff,16,0,20,4
1683317578202,LTCS 130,A00,186043,Wesling; Megan E.,15,0,25,10
1683317580252,LTEA 138,A00,186119,Staff,14,0,40,26
1683317581280,LTEN 124,A00,186148,Staff,6,0,25,19
1683317582307,LTEN 178,A00,186149,Staff,7,0,15,8
1683317583335,LTEN 181,A00,186150,Blanco; John D,33,0,40,7
1683317584365,LTWL 120,A00,186160,Staff,20,0,25,5
1683317585399,LTWL 165,A00,186161,Staff,22,0,25,3
1683317586424,LTWR 100,A00,186162,Staff,0,4,15,15
1683317587447,LTWR 102,A00,186163,Doller; Ben,5,0,15,10
1683317588471,MAE 8,A01,186412,Staff,0,0,0,0
1683317589500,MAE 30B,A00,186445,Bahadori; Mohammad Yousef,83,0,100,17
1683317590524,MAE 40,A00,186592,Bewley; Thomas R,9,0,50,41
1683317591552,MAE 101B,A00,186593,Bahadori; Mohammad Yousef,81,0,100,19
1683317592579,MAE 105,A00,186594,Bandaru; Prabhakar,12,0,50,38
1683317593603,MAE 107,A00,186599,Pham; Hieu Tan,0,6,120,120
1683317594630,MAE 148,A01,186660,Silberman; Jack,3,0,16,13
1683317595655,MATH 10A,A01,188095,Staff,0,6,35,35
1683317596681,MATH 10B,A01,188097,Bowers; Adam R.,0,11,30,30
1683317596681,MATH 10B,A02,188099,Bowers; Adam R.,0,11,30,30
1683317596681,MATH 10B,B01,188104,Bowers; Adam R.,0,10,30,30
1683317596681,MATH 10B,B02,188106,Bowers; Adam R.,0,10,30,30
1683317597707,MATH 10C,A01,188111,Staff,0,18,30,30
1683317597707,MATH 10C,A02,188127,Staff,0,17,30,30
1683317597707,MATH 10C,A03,188131,Staff,0,18,30,30
1683317597707,MATH 10C,B01,188218,Staff,20,0,30,10
1683317597707,MATH 10C,B02,188244,Staff,13,0,30,17
1683317597707,MATH 10C,B03,188277,Staff,16,0,30,14
1683317598744,MATH 18,A01,188344,Bach; Quang Tran,18,0,30,12
1683317598744,MATH 18,A02,188345,Bach; Quang Tran,11,0,30,19
1683317598744,MATH 18,B01,188353,Bach; Quang Tran,10,0,30,20
1683317598744,MATH 18,B02,188354,Bach; Quang Tran,20,0,30,10
1683317599769,MATH 20A,A01,188374,Staff,13,0,35,22
1683317600794,MATH 20B,A01,188382,Ohm; Ko Woon,6,0,30,24
1683317600794,MATH 20B,A02,188383,Ohm; Ko Woon,23,0,30,7
1683317600794,MATH 20B,B01,188385,Ohm; Ko Woon,7,0,30,23
1683317600794,MATH 20B,B02,188392,Ohm; Ko Woon,22,0,30,8
1683317601824,MATH 20C,A01,188394,Harel; Guershon,10,0,30,20
1683317601824,MATH 20C,A02,188395,Harel; Guershon,14,0,30,16
1683317601824,MATH 20C,B01,188404,Harel; Guershon,5,0,30,25
1683317601824,MATH 20C,B02,188405,Harel; Guershon,19,0,30,11
1683317602854,MATH 20D,A01,188414,Hammock; Frances H,0,1,30,30
1683317602854,MATH 20D,A02,188415,Hammock; Frances H,3,0,30,27
1683317602854,MATH 20D,B01,188447,Hammock; Frances H,2,0,30,28
1683317602854,MATH 20D,B02,188486,Hammock; Frances H,8,0,30,22
1683317603879,MATH 20E,A01,188649,Staff,21,0,30,9
1683317603879,MATH 20E,A02,188650,Staff,23,0,30,7
1683317603879,MATH 20E,A03,188673,Staff,0,0,30,30
1683317604907,MATH 102,A01,188675,Staff,0,35,35,35
1683317605933,MATH 103B,A01,188681,Staff,4,0,35,31
1683317605933,MATH 103B,B01,188692,Staff,5,0,35,30
1683317606965,MATH 109,A01,188695,Salehi Golsefidy; Alireza,25,0,35,10
1683317606965,MATH 109,A02,188696,Salehi Golsefidy; Alireza,26,0,35,9
1683317607989,MATH 120A,A01,188698,Eggers; John Dietrich,7,0,35,28
1683317609017,MATH 142B,A01,188736,Ioana; Adrian,0,2,30,30
1683317609017,MATH 142B,A02,188741,Ioana; Adrian,0,1,30,30
1683317609017,MATH 142B,A03,188743,Ioana; Adrian,1,3,30,29
1683317610041,MATH 168A,A01,188790,Staff,0,9,35,35
1683317611065,MATH 170A,A01,188803,Nie; Jiawang,0,2,35,35
1683317611065,MATH 170A,A02,188811,Nie; Jiawang,0,0,35,35
1683317611065,MATH 170A,A03,188814,Nie; Jiawang,0,0,35,35
1683317611065,MATH 170A,A04,188815,Nie; Jiawang,13,0,35,22
1683317612093,MATH 193B,A01,188817,Staff,0,0,35,35
1683317612093,MATH 193B,A02,188818,Staff,6,0,35,29
1683317613120,MGT 4,A01,202857,Anderson; John Charles,62,0,80,18
1683317614148,MGT 12,A00,202858,Lindenberger; Wade Douglas,43,0,90,47
1683317615173,MGT 18,A00,202859,Staff,74,0,90,16
1683317616195,MGT 18GS,A00,202860,McKay; Michael J,13,0,28,15
1683317617222,MGT 45,A00,202861,Pecore; Joseph P.,13,0,90,77
1683317618250,MGT 100,A00,202863,Yavorsky; Daniel Ryan,28,0,90,62
1683317619276,MGT 103,A00,202864,Ehrich; Kristine R,0,17,90,90
1683317620359,MGT 112,A00,202865,Ehrich; Kristine R,15,0,90,75
1683317621384,MGT 121A,A00,202868,Staff,0,19,0,0
1683317622410,MGT 131B,A00,202869,Anderson; John Charles,59,0,90,31
1683317623438,MGT 136,A00,202871,Lindenberger; Wade Douglas,84,0,90,6
1683317624462,MGT 164,A00,202873,Staff,0,68,90,91
1683317625489,MGT 164GS,A00,202874,McKay; Mary A,13,0,28,15
1683317626513,MGT 180,A00,202875,Staff,0,50,90,91
1683317627540,MMW 11R,A01,205019,Herbst; Matthew,3,0,30,27
1683317627540,MMW 11R,A02,205026,Herbst; Matthew,29,0,30,1
1683317628570,MMW 15,A01,193512,Chang; Edmond Yi-Teh,0,9,28,28
1683317628570,MMW 15,A02,193513,Chang; Edmond Yi-Teh,0,5,28,28
1683317628570,MMW 15,A03,193514,Chang; Edmond Yi-Teh,0,5,28,28
1683317628570,MMW 15,A04,193515,Chang; Edmond Yi-Teh,0,5,28,28
1683317628570,MMW 15,A05,193516,Chang; Edmond Yi-Teh,0,4,28,28
1683317628570,MMW 15,A06,193517,Chang; Edmond Yi-Teh,0,5,28,28
1683317628570,MMW 15,B01,193519,Chang; Edmond Yi-Teh,0,4,28,28
1683317628570,MMW 15,B02,193520,Chang; Edmond Yi-Teh,0,5,28,28
1683317628570,MMW 15,B03,193521,Chang; Edmond Yi-Teh,0,4,28,28
1683317628570,MMW 15,B04,193522,Chang; Edmond Yi-Teh,0,4,28,28
1683317628570,MMW 15,B05,193523,Chang; Edmond Yi-Teh,0,5,28,28
1683317628570,MMW 15,B06,193524,Chang; Edmond Yi-Teh,0,4,28,28
1683317629593,MMW 122,A01,193526,Rahimi; Babak,0,14,28,28
1683317629593,MMW 122,A02,193527,Rahimi; Babak,0,14,28,28
1683317629593,MMW 122,A03,193528,Rahimi; Babak,0,0,0,0
1683317629593,MMW 122,A04,193529,Rahimi; Babak,0,0,0,0
1683317630618,MUS 1A,A01,186663,Staff,0,20,35,35
1683317631645,MUS 4,A01,186715,Staff,0,12,35,35
1683317632669,MUS 5R,A01,186796,Dubnov; Shlomo,0,17,35,35
1683317633694,MUS 6,A01,186798,Staff,0,3,25,25
1683317634719,MUS 7,A01,186830,Staff,12,0,35,23
1683317635748,MUS 8,A01,186930,Staff,0,26,35,35
1683317636775,MUS 15,A01,186932,Staff,0,15,35,35
1683317636775,MUS 15,B01,186934,Staff,0,15,35,35
1683317637802,MUS 80,A00,186935,Staff,2,0,20,18
1683317637802,MUS 80,B00,186936,Staff,25,0,25,0
1683317638827,NANO 11,A00,204702,Lipomi; Darren John,0,0,0,0
1683317639856,NANO 15,A01,204709,Yang; Kesong,0,1,0,0
1683317640885,NANO 114,A00,202069,Jahed Motlagh; Zeinab,3,0,10,7
1683317641912,PHIL 1,A00,186955,Grush; Rick Scott,32,0,40,8
1683317642938,PHIL 10,A01,186973,Grush; Rick Scott,28,0,35,7
1683317642938,PHIL 10,A02,186974,Grush; Rick Scott,33,0,35,2
1683317643965,PHIL 13,A01,186976,Staff,7,0,35,28
1683317643965,PHIL 13,A02,186977,Staff,16,0,35,19
1683317644993,PHIL 14,A01,186979,Staff,31,0,35,4
1683317644993,PHIL 14,A02,186986,Staff,32,0,35,3
1683317646021,PHIL 28,A01,186988,Staff,16,0,30,14
1683317646021,PHIL 28,A02,186989,Staff,1,0,30,29
1683317646021,PHIL 28,A03,186990,Staff,9,0,30,21
1683317646021,PHIL 28,A04,186991,Staff,26,0,30,4
1683317647047,PHIL 120,A00,186997,Staff,23,0,40,17
1683317648077,PHIL 137,A00,187003,Staff,9,0,40,31
1683317649104,PHIL 150,A00,187015,Staff,47,0,70,23
1683317650130,PHIL 167,A00,187021,Lamey; Andy M.,35,0,40,5
1683317651153,PHIL 174,A01,202226,Staff,17,0,20,3
1683317651153,PHIL 174,A02,202235,Staff,20,0,20,0
1683317652177,PHIL 191A,A00,258918,Staff,0,0,1,1
1683317653201,PHYS 1A,A00,187028,Staff,27,0,60,33
1683317654227,PHYS 1AL,001,187036,Staff,3,0,30,27
1683317654227,PHYS 1AL,002,187049,Staff,18,0,30,12
1683317655254,PHYS 1B,A00,187058,Staff,22,0,60,38
1683317656279,PHYS 1BL,001,187064,Staff,0,0,30,30
1683317656279,PHYS 1BL,002,187070,Staff,5,0,30,25
1683317657305,PHYS 1C,A00,187082,Staff,31,0,120,89
1683317658330,PHYS 1CL,001,187088,Staff,0,9,30,30
1683317658330,PHYS 1CL,002,187089,Staff,0,2,30,30
1683317658330,PHYS 1CL,009,262693,Staff,11,0,30,19
1683317659354,PHYS 2B,A01,187097,Staff,54,0,115,61
1683317660381,PHYS 2C,A01,187099,Staff,67,0,115,48
1683317661407,PHYS 2CL,A01,187101,Staff,5,0,28,23
1683317661407,PHYS 2CL,A02,187102,Staff,15,0,28,13
1683317662432,PHYS 2D,A01,187123,Shotwell; Brian,95,0,115,20
1683317663460,PHYS 4B,A01,187133,Grinstein; Benjamin,35,0,50,15
1683317664484,POLI 10,A00,188819,Staff,0,4,50,50
1683317665509,POLI 11,A00,188827,Staff,43,0,50,7
1683317666534,POLI 13R,A00,188828,Staff,0,1,20,20
1683317667560,POLI 27,A01,188830,Elgin; Samuel Zincke,0,1,70,70
1683317668584,POLI 30,A00,188832,Desposato; Scott,32,0,50,18
1683317669608,POLI 102F,A00,188834,Staff,3,0,40,37
1683317670631,POLI 104A,A00,188852,Staff,14,0,30,16
1683317671722,POLI 104I,A00,188853,Staff,0,6,20,20
1683317672750,POLI 110B,A00,188854,Wiens; David,7,0,20,13
1683317673774,POLI 112A,A00,188855,Wiens; David,5,0,30,25
1683317674799,POLI 117R,A00,188856,Forman; Fonna,0,11,20,20
1683317675829,POLI 118,A00,188857,Ingham; Sean,8,0,20,12
1683317676855,POLI 120G,A00,188858,Staff,9,0,30,21
1683317677879,POLI 131CR,A00,188863,Hoston; Germaine,24,0,50,26
1683317678904,POLI 133,A00,188864,Nellis; Gareth Hb,44,0,50,6
1683317679927,POLI 134D,A00,188865,Desposato; Scott,27,0,30,3
1683317680951,POLI 142A,A00,188871,Gartzke; Erik,22,0,50,28
1683317681974,POLI 142K,A00,188874,Staff,38,0,50,12
1683317682998,POLI 143,A00,188940,Gartzke; Erik,16,0,30,14
1683317684021,POLI 153,A00,188943,Staff,3,0,20,17
1683317685048,POLI 160AA,A00,188944,Staff,12,0,40,28
1683317686074,POLI 170A,A00,188945,Staff,11,0,30,19
1683317688127,PSYC 1,A00,188952,Staff,37,0,90,53
1683317689152,PSYC 2,B00,188953,Staff,19,0,35,16
1683317690176,PSYC 6,A00,188970,Staff,47,0,60,13
1683317691204,PSYC 7,A00,188973,Staff,37,0,45,8
1683317692232,PSYC 60,A01,188980,Rickard; Timothy C.,43,0,60,17
1683317693257,PSYC 70,A01,189001,Steiner; Eric Tomas,24,0,45,21
1683317694281,PSYC 100,A00,189005,Lacefield; Katharine I,0,99,120,120
1683317695305,PSYC 102,A00,189008,Staff,10,0,30,20
1683317696329,PSYC 106,B00,189026,Gorman; Michael R.,36,0,60,24
1683317697355,PSYC 114,B01,189033,Winkielman; Piotr,0,32,30,30
1683317698385,PSYC 131,A00,189036,Anagnostaras; Stephan,0,43,60,60
1683317699413,PSYC 136,A00,189041,Lowe; Angela Beth,0,7,25,25
1683317700438,PSYC 137,A00,189057,Winkielman; Piotr,0,34,25,25
1683317701469,PSYC 144,A00,189107,Wixted; John T,0,7,50,50
1683317703520,PSYC 162,A00,189142,Staff,0,8,85,85
1683317704545,PSYC 172,A00,189144,Gorman; Michael R.,0,7,30,30
1683317706595,PSYC 179,A00,189146,Lacefield; Katharine I,0,84,120,120
1683317707619,PSYC 181,A00,189147,Anagnostaras; Stephan,0,44,90,90
1683317708643,PSYC 190R,A00,189148,Barner; David A.,0,22,80,80
1683317709667,PSYC 191,A00,189275,Rickard; Timothy C.,0,7,25,25
1683317710692,PSYC 193,A00,189276,Chapman; Eddie Nathaniel,0,1,0,4
1683317711718,PSYC 193L,A01,189281,Lowe; Angela Beth,12,0,20,8
1683317711718,PSYC 193L,B01,189285,Staff,28,0,35,7
1683317712745,RELI 149,A00,187137,Rahimi; Babak,7,0,40,33
1683317713771,SE 9,A01,187315,Staff,0,2,18,18
1683317714797,SE 101B,A00,187409,Staff,24,0,30,6
1683317715821,SE 110B,A00,187444,Staff,10,0,40,30
1683317716846,SE 130B,A00,187449,Staff,31,0,40,9
1683317717870,SE 150A,A00,187516,Staff,9,0,20,11
1683317718897,SE 154,A00,187528,Staff,30,0,50,20
1683317719926,SIO 3,A01,258171,Staff,35,0,40,5
1683317720953,SIO 10,A00,187144,Cook; Geoffrey W,0,3,75,75
1683317721978,SIO 45,A00,187152,Cook; Geoffrey W,1,0,100,99
1683317723003,SIO 109R,A00,194486,Staff,0,3,20,20
1683317725107,SIO 187,A01,187233,Kacev; David,12,0,40,28
1683317726136,SOCI 1,A01,258656,Thorpe; Charles Robert,28,0,30,2
1683317726136,SOCI 1,A02,258658,Thorpe; Charles Robert,30,0,30,0
1683317726136,SOCI 1,A03,258661,Thorpe; Charles Robert,25,0,25,0
1683317726136,SOCI 1,A04,258666,Thorpe; Charles Robert,22,0,25,3
1683317726136,SOCI 1,A05,258897,Thorpe; Charles Robert,23,0,25,2
1683317726136,SOCI 1,A06,258898,Thorpe; Charles Robert,25,0,25,0
1683317727163,SOCI 30,A01,258903,Pardo Guerra; Juan Pablo,16,0,30,14
1683317728188,SOCI 102,A00,258904,Staff,9,0,25,16
1683317729212,SOCI 106,A00,258905,Staff,19,0,25,6
1683317730236,SOCI 111,A00,258907,Ribas Norris; Janet Vanesa,26,0,30,4
1683317731262,SOCI 121R,A00,258908,Pardo Guerra; Juan Pablo,11,0,30,19
1683317732287,SOCI 126,A01,203330,Staff,14,0,20,6
1683317733315,SOCI 131,A00,258909,Thorpe; Charles Robert,31,0,60,29
1683317734346,SOCI 135,A00,258910,Payne; Christine Anna,0,9,30,30
1683317735369,SOCI 157,A00,258911,Staff,12,0,30,18
1683317736397,SOCI 184,A00,258912,Staff,25,0,30,5
1683317737423,SOCI 188D,A00,258913,Staff,21,0,30,9
1683317738447,SYN 2,001,187529,Staff,9,0,16,7
1683317738447,SYN 2,002,201452,Staff,0,18,16,16
1683317738447,SYN 2,003,201469,Staff,4,0,16,12
1683317739476,SYN 100,A01,187531,Staff,0,9,20,20
1683317739476,SYN 100,B01,201491,Staff,0,12,20,20
1683317740500,TDAC 1,A00,189286,Walsh; Kim C.,3,0,20,17
1683317740500,TDAC 1,B00,189287,Harting; Carla Kelso,11,0,20,9
1683317741530,TDAC 101,A00,189300,Walsh; Kim C.,16,0,20,4
1683317741530,TDAC 101,B00,189301,Harting; Carla Kelso,18,0,20,2
1683317742556,TDAC 102,A00,189304,Basso; Beatrice,14,0,20,6
1683317743582,TDAC 108,A00,189305,Staff,18,0,20,2
1683317744615,TDDE 131,A00,189310,Staff,19,0,20,1
1683317744615,TDDE 131,B00,189314,Staff,19,0,20,1
1683317744615,TDDE 131,C00,189315,Staff,48,0,50,2
1683317744615,TDDE 131,D00,189316,Staff,14,0,15,1
1683317744615,TDDE 131,E00,204841,Staff,20,0,20,0
1683317745639,TDGE 10,A00,189289,Staff,30,0,50,20
1683317745639,TDGE 10,B00,189290,Havis; Allan,2,0,50,48
1683317746663,TDGE 11,A00,189291,Fulton; Julia,0,3,50,50
1683317746663,TDGE 11,B00,189292,Staff,20,0,25,5
1683317746663,TDGE 11,C00,260270,Staff,0,0,0,0
1683317747686,TDGE 25,A00,189294,Staff,3,0,20,17
1683317748714,TDGE 124,A00,189318,Fulton; Julia,0,8,50,50
1683317749737,TDGE 125,A00,189319,Staff,13,0,25,12
1683317749737,TDGE 125,B00,189320,Staff,23,0,25,2
1683317750761,TDGE 127,A00,189322,Havis; Allan,0,0,50,50
1683317751786,TDHT 101,A00,189323,Staff,18,0,25,7
1683317751786,TDHT 101,B00,189324,Staff,25,0,25,0
1683317752810,TDHT 102,A00,189325,Staff,49,0,50,1
1683317753834,TDMV 1,A00,189295,Arcidiacono; Kristin,20,0,30,10
1683317753834,TDMV 1,B00,189296,Caligagan; Maria T.,24,0,30,6
1683317754857,TDMV 2,A00,189297,Sammartano; Tonnie,28,0,30,2
1683317754857,TDMV 2,B00,189299,Arcidiacono; Kristin,24,0,30,6
1683317755882,TDMV 3,A00,204998,Rincon; Alicia,22,0,30,8
1683317756906,TDMV 120,A00,189458,Sammartano; Tonnie,28,0,30,2
1683317757929,TDMV 138,A00,189541,Jun; Grace Shin Hae,22,0,40,18
1683317758954,TDMV 142,A00,189717,Caligagan; Tony,23,0,30,7
1683317758954,TDMV 142,B00,189718,Caligagan; Maria T.,25,0,30,5
1683317759977,TMC 2,A01,187533,Staff,25,0,25,0
1683317759977,TMC 2,A02,187534,Staff,25,0,25,0
1683317761002,USP 1,A01,187536,Kwak; Nancy,0,16,25,25
1683317762036,USP 5,A01,187538,Staff,9,0,25,16
1683317763064,USP 101,A00,199253,Staff,0,4,0,0
1683317764091,USP 124,A00,187562,Boomhower; Matthew Charles,1,0,30,29
1683317765115,USP 138,A00,187582,Staff,20,0,25,5
1683317766141,USP 152,A01,187597,Staff,4,0,25,21
1683317767167,USP 153,A00,187598,Staff,19,0,25,6
1683317768194,USP 168,A00,187607,Kwak; Nancy,2,0,5,3
1683317769218,USP 173,A00,187619,Staff,4,0,25,21
1683317770244,USP 181,A00,187638,Staff,0,0,25,25
1683317771269,VIS 103,A00,187650,Cruz; Edwin Teddy,23,0,75,52
1683317772293,VIS 110D,A00,187669,Staff,12,0,22,10
1683317773317,VIS 127C,A00,187720,Shen; Kuiyi,68,0,146,78
1683317774343,VIS 149,A00,187731,Yoldas; Pinar,0,14,22,22
1683317775370,VIS 151,A01,188091,Staff,22,0,34,12
1683317775370,VIS 151,A02,188092,Staff,11,0,34,23
1683317776396,VIS 160B,A00,188093,Stalbaum; Brett,0,0,10,10
1683317778446,WCWP 10B,A00,201720,Staff,10,0,15,5
1683317778446,WCWP 10B,B00,201722,Staff,8,0,15,7
1683317779475,WCWP 100,A00,201725,Gagnon; Jeffrey C,0,0,2,2
1683317779475,WCWP 100,B00,201727,Staff,0,4,15,15
1683317782606,ANBI 133,A00,258401,Wilder; Linnea Lorene,34,0,40,6
1683317783631,ANBI 140,A00,258395,Hrvoj Mihic; Branka,18,0,25,7
1683317784655,ANSC 120,A00,258402,Bialecki; Jon Anthony,27,0,40,13
1683317785679,ANSC 144,A00,258400,Staff,14,0,40,26
1683317787731,ANSC 166,A00,258396,Parish; Steven Martin,157,0,175,18
1683317788755,ANSC 180,A00,193533,Staff,9,0,20,11
1683317789783,ANSC 188,A00,258397,Jassal; Aftab,33,0,40,7
1683317790810,ANTH 3,A01,258316,Staff,23,0,30,7
1683317791836,ANTH 5,A00,258394,Semendeferi; Ekaterini,16,0,20,4
1683317792862,ANTH 21,A01,258331,Staff,9,0,40,31
1683317793886,ANTH 103,A00,258398,Varma; Saiba,15,0,25,10
1683317794918,AWP 10,001,202034,Staff,0,0,0,0
1683317794918,AWP 10,002,202035,Staff,0,0,0,0
1683317794918,AWP 10,003,202036,Staff,0,0,0,0
1683317794918,AWP 10,004,202037,Staff,0,0,0,0
1683317794918,AWP 10,005,202038,Staff,0,0,0,0
1683317794918,AWP 10,006,202039,Staff,0,0,0,0
1683317794918,AWP 10,007,202040,Staff,0,0,0,0
1683317794918,AWP 10,008,202041,Staff,0,0,0,0
1683317794918,AWP 10,009,202042,Staff,0,0,0,0
1683317794918,AWP 10,010,202043,Staff,0,0,0,0
1683317794918,AWP 10,011,202044,Staff,0,0,0,0
1683317794918,AWP 10,012,202045,Staff,0,0,0,0
1683317794918,AWP 10,013,202046,Staff,0,0,0,0
1683317794918,AWP 10,014,202047,Staff,0,0,0,0
1683317794918,AWP 10,015,202048,Staff,0,0,0,0
1683317794918,AWP 10,016,202049,Staff,0,0,0,0
1683317794918,AWP 10,017,202050,Staff,0,0,0,0
1683317794918,AWP 10,018,202051,Staff,0,0,0,0
1683317794918,AWP 10,019,202052,Staff,0,0,0,0
1683317794918,AWP 10,020,202053,Staff,0,0,0,0
1683317794918,AWP 10,021,202054,Staff,0,0,0,0
1683317794918,AWP 10,022,202055,Staff,0,0,0,0
1683317794918,AWP 10,023,202056,Staff,0,0,0,0
1683317794918,AWP 10,024,202057,Staff,0,0,0,0
1683317794918,AWP 10,025,202058,Staff,0,0,0,0
1683317794918,AWP 10,026,202059,Staff,0,0,0,0
1683317795941,AWP 102,001,202032,Staff,0,0,0,0
1683317795941,AWP 102,002,202033,Staff,0,0,0,0
1683317796965,BENG 100,A01,254234,Taylor Amos; Alyssa C,31,0,40,9
1683317797990,BENG 196,001,270013,Engler; Adam J.,9999,0,9999,0
1683317799019,BICD 100R,A01,202018,Smith; Laurie,0,7,32,32
1683317799019,BICD 100R,A02,202019,Smith; Laurie,0,2,32,32
1683317799019,BICD 100R,A03,202020,Smith; Laurie,0,1,32,32
1683317799019,BICD 100R,A04,202021,Smith; Laurie,8,0,32,24
1683317799019,BICD 100R,A05,202022,Smith; Laurie,12,0,32,20
1683317800043,BICD 136,A01,193242,Gustafson-Brown; Cindy,0,2,32,32
1683317800043,BICD 136,A02,193244,Gustafson-Brown; Cindy,14,0,32,18
1683317801069,BIEB 102,A01,193249,Butler; Shannon Rhey,0,2,32,32
1683317801069,BIEB 102,A02,193251,Butler; Shannon Rhey,0,0,32,32
1683317801069,BIEB 102,A03,193253,Butler; Shannon Rhey,0,1,32,32
1683317801069,BIEB 102,A04,193255,Butler; Shannon Rhey,17,0,32,15
1683317801069,BIEB 102,A05,193265,Butler; Shannon Rhey,26,0,32,6
1683317801069,BIEB 102,A06,193269,Butler; Shannon Rhey,16,0,32,16
1683317803148,BIEB 150,A01,193274,Staff,0,0,32,32
1683317803148,BIEB 150,A02,193285,Staff,23,0,32,9
1683317804171,BIEB 194,A00,193286,Kurle; Carolyn M.,22,0,32,10
1683317805196,BILD 1,A01,192291,Staff,16,0,32,16
1683317805196,BILD 1,A02,192292,Staff,30,0,32,2
1683317805196,BILD 1,B01,192520,Reuther; Keefe,0,1,0,0
1683317805196,BILD 1,B02,192532,Reuther; Keefe,0,1,0,0
1683317806220,BILD 3,A01,192556,Butler; Shannon Rhey,0,0,32,32
1683317806220,BILD 3,A02,192581,Butler; Shannon Rhey,5,0,32,27
1683317806220,BILD 3,A03,192611,Butler; Shannon Rhey,23,0,32,9
1683317806220,BILD 3,A04,192612,Butler; Shannon Rhey,25,0,32,7
1683317806220,BILD 3,A05,192613,Butler; Shannon Rhey,27,0,32,5
1683317806220,BILD 3,A06,192679,Butler; Shannon Rhey,27,0,32,5
1683317806220,BILD 3,A07,192682,Butler; Shannon Rhey,22,0,32,10
1683317807245,BILD 4,A01,192836,Reuther; Keefe,1,0,24,23
1683317807245,BILD 4,A02,193044,Reuther; Keefe,4,0,24,20
1683317808274,BILD 10,A01,193142,Gustafson-Brown; Cindy,30,0,32,2
1683317808274,BILD 10,A02,193149,Gustafson-Brown; Cindy,31,0,32,1
1683317809299,BIMM 100,A01,193301,Staff,0,6,32,32
1683317809299,BIMM 100,A02,193312,Staff,0,5,32,32
1683317809299,BIMM 100,A03,193323,Staff,0,8,32,32
1683317810326,BIMM 101,A01,193329,McDonnell; Lisa Marie,0,3,24,24
1683317810326,BIMM 101,A02,193339,McDonnell; Lisa Marie,0,2,24,24
1683317810326,BIMM 101,B01,193354,McDonnell; Lisa Marie,0,3,24,24
1683317810326,BIMM 101,B02,193357,McDonnell; Lisa Marie,0,3,24,24
1683317811354,BIMM 110,A01,193377,Tat; John,0,11,32,32
1683317811354,BIMM 110,A02,193378,Tat; John,1,9,32,31
1683317812380,BIMM 120,A01,206116,Staff,0,0,32,32
1683317812380,BIMM 120,A02,206117,Staff,8,0,32,24
1683317812380,BIMM 120,A03,206121,Staff,21,0,32,11
1683317813406,BIPN 100,A01,193393,Park; Ji Young,0,14,32,32
1683317813406,BIPN 100,A02,193402,Park; Ji Young,0,12,32,32
1683317813406,BIPN 100,A03,193413,Park; Ji Young,0,14,32,32
1683317813406,BIPN 100,A04,193414,Park; Ji Young,0,13,32,32
1683317814434,BIPN 102,A01,193429,Staff,0,0,32,32
1683317814434,BIPN 102,A02,193438,Staff,22,0,32,10
1683317815458,BIPN 106,A01,193450,Reyes Gonzalez; Catalina,0,2,40,40
1683317816482,BIPN 134,A01,193465,Cooke; James Edward,0,0,32,32
1683317816482,BIPN 134,A02,193474,Cooke; James Edward,27,0,32,5
1683317816482,BIPN 134,A03,193485,Cooke; James Edward,29,0,32,3
1683317816482,BIPN 134,A04,193486,Cooke; James Edward,21,0,32,11
1683317816482,BIPN 134,A05,193491,Cooke; James Edward,31,0,32,1
1683317816482,BIPN 134,A06,193501,Cooke; James Edward,30,0,32,2
1683317816482,BIPN 134,A07,193510,Cooke; James Edward,29,0,32,3
1683317818530,BISP 194,A00,222522,Staff,15,0,32,17
1683317819554,CAT 124,A01,202407,Staff,20,0,25,5
1683317820578,CAT 125,A00,202408,Marchisotto; Jennifer Anne,4,0,20,16
1683317821607,CAT 125R,A00,202409,Smith; Lauryn Alissa,0,11,20,20
1683317821607,CAT 125R,B00,202410,Morales; Celeste Georgianna,0,11,20,20
1683317821607,CAT 125R,C00,202411,Irwin; Matthew Joseph,0,10,20,20
1683317822632,CENG 15,A01,204712,Yang; Kesong,0,1,0,0
1683317823655,CENG 114,A00,202070,Jahed Motlagh; Zeinab,5,0,20,15
1683317824680,CGS 105,A00,185477,Wesling; Megan E.,24,0,40,16
1683317825703,CGS 106,A00,185494,Staff,13,0,22,9
1683317826726,CGS 108,A00,185495,Staff,14,0,20,6
1683317827805,CGS 114,A00,185496,Staff,13,0,18,5
1683317828829,CGS 119,A00,185501,Staff,15,0,20,5
1683317829854,CGS 120,A00,185511,Staff,13,0,20,7
1683317830878,CHEM 4,A01,184675,Bussey; Thomas J,96,0,100,4
1683317831902,CHEM 6A,A01,184677,Staff,35,0,60,25
1683317832929,CHEM 6B,A01,184679,Staff,65,0,100,35
1683317833958,CHEM 6C,A01,184681,Bussey; Thomas J,1,0,50,49
1683317833958,CHEM 6C,A02,184682,Bussey; Thomas J,34,0,50,16
1683317834989,CHEM 40A,A01,184684,Albizati; Kim F.,37,0,100,63
1683317836025,CHEM 40B,A01,184686,Albizati; Kim F.,0,20,100,100
1683317837050,CHEM 41B,A01,184690,Staff,52,0,100,48
1683317838074,COGS 3,A01,184715,Boyle; Mary E. T.,0,25,40,40
1683317839099,COGS 14B,A01,185172,Staff,0,15,38,38
1683317840124,COGS 18,A01,184736,Staff,18,0,80,62
1683317841153,COGS 100,A01,184932,Staff,0,5,73,73
1683317842181,COGS 101A,A01,184935,Staff,0,38,30,30
1683317843205,COGS 101B,A01,184944,Staff,0,2,30,30
1683317844229,COGS 101C,A01,184946,Staff,0,12,30,30
1683317845253,COGS 102A,A01,184951,Johnson; Christine M.,2,0,40,38
1683317846281,COGS 107B,A01,184953,Mooshagian; Eric Frederick,0,50,40,40
1683317847308,COGS 118B,A01,184959,Gupta; Anjum,0,48,40,40
1683317848333,COGS 153,A00,184961,Staff,0,15,30,30
1683317849361,COGS 177,A00,184962,Staff,0,21,30,30
1683317850385,COGS 187A,A01,184969,Boyle; Mary E. T.,0,17,40,40
1683317851410,COMM 10,A01,185174,Staff,0,5,25,25
1683317851410,COMM 10,A02,185189,Staff,0,5,25,25
1683317851410,COMM 10,A03,269821,Staff,0,0,0,0
1683317852435,COMM 100B,A01,185475,Staff,0,0,0,2
1683317852435,COMM 100B,A02,185476,Staff,14,0,25,11
1683317853459,COMM 100C,A01,185314,Staff,1,0,25,24
1683317853459,COMM 100C,A02,185327,Staff,19,0,25,6
1683317854486,COMM 110M,A00,185349,Staff,2,0,40,38
1683317855512,COMM 113T,A00,185352,Staff,25,0,40,15
1683317856537,COMM 114I,A00,185353,Staff,33,0,40,7
1683317857561,COMM 131,A00,185354,Staff,19,0,30,11
1683317858585,CSE 8A,A50,185358,Cao; Yingjun,0,46,10,10
1683317859613,CSE 8B,A01,185362,Staff,1,47,50,49
1683317860638,CSE 11,A01,185416,Cao; Yingjun,0,92,10,10
1683317861662,CSE 20,A01,185445,Briones; Jor-el Thomas Caparas,5,0,25,20
1683317862692,CSE 21,A01,185447,Staff,10,0,50,40
1683317863718,CSE 101,A01,185451,Staff,0,12,50,50
1683317863718,CSE 101,B01,185453,Jones; Miles E,0,11,50,50
1683317865766,CSE 141,A01,185458,Eldon; John,20,0,100,80
1683317866790,CSE 141L,A01,185461,Eldon; John,12,0,100,88
1683317867816,CSE 142,A01,185463,Staff,36,0,60,24
1683317867816,CSE 142,B01,201355,Staff,0,7,60,60
1683317868850,CSE 142L,A01,185470,Staff,36,0,60,24
1683317868850,CSE 142L,B01,201417,Staff,0,6,60,60
1683317869877,CSE 190,A00,201433,Staff,32,0,49,17
1683317870902,DOC 1,A01,259136,Strom; Megan C.,7,0,15,8
1683317870902,DOC 1,A02,259137,Strom; Megan C.,14,0,15,1
1683317870902,DOC 1,A03,259138,Strom; Megan C.,14,0,15,1
1683317870902,DOC 1,A04,259139,Strom; Megan C.,14,0,15,1
1683317871926,DOC 100D,A00,259140,Pass; Natalye Joann,17,0,25,8
1683317872950,DSGN 1,A01,184749,Rill; Bryan,0,25,30,30
1683317873974,DSGN 100,A01,185168,Staff,0,2,25,25
1683317875001,ECE 5,A01,185626,Morris; Karcher William,0,10,0,0
1683317876025,ECE 101,A01,185628,Staff,17,0,70,53
1683317877049,ECE 107,A01,185635,Baghdadchi; Saharnaz,0,0,20,20
1683317877049,ECE 107,A02,185638,Baghdadchi; Saharnaz,4,0,20,16
1683317878072,ECE 148,A01,185647,Silberman; Jack,0,0,16,16
1683317879101,ECON 1,A01,185537,Crane; Meredith Helen,54,0,70,16
1683317880129,ECON 3,A01,185549,Crane; Meredith Helen,33,0,70,37
1683317881156,ECON 4,A01,203354,Anderson; John Charles,0,4,10,10
1683317882181,ECON 100A,A01,185574,Staff,0,4,40,40
1683317883207,ECON 100B,A01,185576,Staff,0,22,40,40
1683317884229,ECON 100C,A01,185589,Newhouse; Herbert S,30,0,70,40
1683317885254,ECON 105,A00,185608,Vespa; Emanuel Ignacio,19,0,35,16
1683317886279,ECON 109,A01,185610,Shishkin; Denis,10,0,35,25
1683317887302,ECON 110A,A01,185612,Staff,11,0,40,29
1683317888329,ECON 120A,A01,185615,Staff,20,0,40,20
1683317889358,ECON 120C,A01,185617,Sun; Yixiao,0,20,70,70
1683317890385,ECON 144,A00,203346,Squires; Dale E,3,0,35,32
1683317891410,ECON 171,A01,203349,Newhouse; Herbert S,0,1,35,35
1683317892435,ECON 173A,A01,185621,Toda; Alexis Akira,21,0,35,14
1683317893461,EDS 25,A01,202413,Staff,0,1,0,0
1683317893461,EDS 25,A02,202414,Staff,0,1,0,0
1683317893461,EDS 25,A03,202415,Staff,0,0,0,0
1683317893461,EDS 25,A04,202416,Staff,0,1,0,0
1683317893461,EDS 25,A05,202439,Staff,0,0,0,0
1683317893461,EDS 25,A06,202440,Staff,0,0,0,0
1683317893461,EDS 25,B01,202631,Staff,0,0,0,0
1683317893461,EDS 25,B02,202632,Staff,0,0,0,0
1683317893461,EDS 25,B03,202639,Staff,0,0,0,0
1683317893461,EDS 25,B04,202640,Staff,0,0,0,0
1683317893461,EDS 25,B05,202643,Staff,0,0,0,0
1683317893461,EDS 25,B06,202644,Staff,0,0,0,0
1683317894487,EDS 38,A01,202659,Black; Alison Michelle,24,0,25,1
1683317895513,EDS 115,A00,202652,Staff,17,0,30,13
1683317896539,EDS 125,A00,202649,Staff,14,0,30,16
1683317897567,EDS 126,A01,203332,Staff,30,0,30,0
1683317898592,EDS 139,A00,202838,Staff,16,0,25,9
1683317899620,EDS 146,A01,202655,Staff,14,0,25,11
1683317900645,ENG 15,A00,185667,Staff,0,1,0,0
1683317900645,ENG 15,B00,185672,Staff,0,0,0,0
1683317900645,ENG 15,C00,185675,Staff,0,0,0,0
1683317900645,ENG 15,D00,185682,Staff,0,0,0,0
1683317900645,ENG 15,E00,185684,Staff,0,0,0,0
1683317901670,ETHN 103,A00,185710,Staff,0,3,35,35
1683317902694,ETHN 103A,A00,199228,Man; Simeon S,2,0,9,7
1683317903719,ETHN 109,A00,185711,Staff,18,0,35,17
1683317904746,ETHN 142,A00,185726,Staff,0,4,30,30
1683317905771,ETHN 163J,A00,199229,Man; Simeon S,5,0,8,3
1683317906799,ETHN 168,A00,185727,Staff,8,0,10,2
1683317907826,ETHN 182,A00,185728,Staff,1,0,35,34
1683317908853,ETHN 183,A00,185737,Staff,8,0,18,10
1683317909877,GLBH 111,A01,209361,Burgos; Jose L.,0,0,0,0
1683317911930,HIEU 104,A00,185792,Staff,16,0,20,4
1683317912955,HIEU 115,A00,185800,Staff,1,0,20,19
1683317913982,HIEU 128,A00,185801,Staff,0,7,20,20
1683317915008,HIEU 147,A00,185802,Staff,16,0,20,4
1683317916032,HIEU 154,A00,185823,Staff,12,0,20,8
1683317917060,HILA 102,A00,185826,Staff,13,0,20,7
1683317918088,HILD 2C,A01,185778,Staff,0,12,20,20
1683317919117,HILD 7B,A01,185780,Kwak; Nancy,0,15,32,32
1683317919117,HILD 7B,A02,185781,Kwak; Nancy,0,18,32,32
1683317920143,HILD 30,A01,185791,Staff,14,0,20,6
1683317921166,HISC 119,A00,185830,Golan; Tal,0,9,20,20
1683317922189,HITO 156GS,A00,185831,Patterson; Patrick H.,0,0,0,23
1683317923212,HIUS 103,A00,185832,Man; Simeon S,0,6,20,20
1683317924236,HIUS 117,A00,185836,Kwak; Nancy,2,0,20,18
1683317925264,HIUS 125,A00,185840,Man; Simeon S,0,0,23,23
1683317926292,HIUS 149,A00,185845,Staff,0,0,20,20
1683317927322,HUM 3,A01,185882,Zavodny; Tatiana Sophia,0,6,50,50
1683317927322,HUM 3,B01,185899,Caldwell; Michael Alan,0,19,50,50
1683317928348,HUM 3GS,A00,185900,Patterson; Patrick H.,0,0,0,23
1683317929371,HUM 4,A01,185938,Zroka; Amy Liane,31,0,50,19
1683317929371,HUM 4,B01,185956,Watkins; Eric,0,2,50,50
1683317929371,HUM 4,B02,202209,Watkins; Eric,0,2,50,50
1683317929371,HUM 4,B03,202210,Watkins; Eric,0,0,50,50
1683317930396,HUM 5,A01,185958,West; Geoffrey Scott,4,0,50,46
1683317930396,HUM 5,A02,202215,West; Geoffrey Scott,0,0,50,50
1683317931483,INTL 190,A00,185959,Gagnon; Jeffrey C,0,0,0,9
1683317931483,INTL 190,B00,185960,Lettieri; Michael Joseph,0,0,0,1
1683317932508,JAPN 180,A00,254509,Staff,5,1,30,25
1683317933537,LATI 10,A01,202853,Kennemore; Amy Michelle,5,0,35,30
1683317933537,LATI 10,A02,202854,Kennemore; Amy Michelle,1,0,35,34
1683317933537,LATI 10,A03,270054,Kennemore; Amy Michelle,30,0,30,0
1683317934561,LATI 180,A00,202855,Kennemore; Amy Michelle,11,0,20,9
1683317935586,LAWS 101,A00,201767,Golan; Tal,0,7,40,40
1683317936610,LIFR 1C,A00,185961,Staff,6,0,20,14
1683317937669,LIFR 1CX,A00,185962,Staff,7,0,20,13
1683317938697,LIFR 1D,A00,185963,Staff,9,0,20,11
1683317939722,LIFR 1DX,A00,185964,Staff,9,0,20,11
1683317940749,LIGN 101,A01,186039,Staff,43,0,50,7
1683317941773,LIGN 165,A00,186040,Staff,18,0,50,32
1683317942805,LTCS 108,A00,186041,Staff,6,0,10,4
1683317943833,LTCS 119,A00,186042,Staff,16,0,20,4
1683317944858,LTCS 130,A00,186043,Wesling; Megan E.,15,0,25,10
1683317946909,LTEA 138,A00,186119,Staff,14,0,40,26
1683317947937,LTEN 124,A00,186148,Staff,6,0,25,19
1683317948964,LTEN 178,A00,186149,Staff,7,0,15,8
1683317949989,LTEN 181,A00,186150,Blanco; John D,33,0,40,7
1683317951014,LTWL 120,A00,186160,Staff,20,0,25,5
1683317952039,LTWL 165,A00,186161,Staff,22,0,25,3
1683317953065,LTWR 100,A00,186162,Staff,0,4,15,15
1683317954090,LTWR 102,A00,186163,Doller; Ben,5,0,15,10
1683317955114,MAE 8,A01,186412,Staff,0,0,0,0
1683317956143,MAE 30B,A00,186445,Bahadori; Mohammad Yousef,83,0,100,17
1683317957172,MAE 40,A00,186592,Bewley; Thomas R,9,0,50,41
1683317958200,MAE 101B,A00,186593,Bahadori; Mohammad Yousef,81,0,100,19
1683317959225,MAE 105,A00,186594,Bandaru; Prabhakar,12,0,50,38
1683317960249,MAE 107,A00,186599,Pham; Hieu Tan,0,6,120,120
1683317961273,MAE 148,A01,186660,Silberman; Jack,3,0,16,13
1683317962299,MATH 10A,A01,188095,Staff,0,6,35,35
1683317963333,MATH 10B,A01,188097,Bowers; Adam R.,0,11,30,30
1683317963333,MATH 10B,A02,188099,Bowers; Adam R.,0,11,30,30
1683317963333,MATH 10B,B01,188104,Bowers; Adam R.,0,10,30,30
1683317963333,MATH 10B,B02,188106,Bowers; Adam R.,0,10,30,30
1683317964378,MATH 10C,A01,188111,Staff,0,18,30,30
1683317964378,MATH 10C,A02,188127,Staff,0,17,30,30
1683317964378,MATH 10C,A03,188131,Staff,0,18,30,30
1683317964378,MATH 10C,B01,188218,Staff,20,0,30,10
1683317964378,MATH 10C,B02,188244,Staff,13,0,30,17
1683317964378,MATH 10C,B03,188277,Staff,16,0,30,14
1683317965401,MATH 18,A01,188344,Bach; Quang Tran,18,0,30,12
1683317965401,MATH 18,A02,188345,Bach; Quang Tran,11,0,30,19
1683317965401,MATH 18,B01,188353,Bach; Quang Tran,10,0,30,20
1683317965401,MATH 18,B02,188354,Bach; Quang Tran,20,0,30,10
1683317966425,MATH 20A,A01,188374,Staff,13,0,35,22
1683317967449,MATH 20B,A01,188382,Ohm; Ko Woon,6,0,30,24
1683317967449,MATH 20B,A02,188383,Ohm; Ko Woon,23,0,30,7
1683317967449,MATH 20B,B01,188385,Ohm; Ko Woon,7,0,30,23
1683317967449,MATH 20B,B02,188392,Ohm; Ko Woon,22,0,30,8
1683317968474,MATH 20C,A01,188394,Harel; Guershon,10,0,30,20
1683317968474,MATH 20C,A02,188395,Harel; Guershon,14,0,30,16
1683317968474,MATH 20C,B01,188404,Harel; Guershon,5,0,30,25
1683317968474,MATH 20C,B02,188405,Harel; Guershon,19,0,30,11
1683317969501,MATH 20D,A01,188414,Hammock; Frances H,0,1,30,30
1683317969501,MATH 20D,A02,188415,Hammock; Frances H,3,0,30,27
1683317969501,MATH 20D,B01,188447,Hammock; Frances H,2,0,30,28
1683317969501,MATH 20D,B02,188486,Hammock; Frances H,8,0,30,22
1683317970529,MATH 20E,A01,188649,Staff,21,0,30,9
1683317970529,MATH 20E,A02,188650,Staff,23,0,30,7
1683317970529,MATH 20E,A03,188673,Staff,0,0,30,30
1683317971552,MATH 102,A01,188675,Staff,0,35,35,35
1683317972579,MATH 103B,A01,188681,Staff,4,0,35,31
1683317972579,MATH 103B,B01,188692,Staff,5,0,35,30
1683317973603,MATH 109,A01,188695,Salehi Golsefidy; Alireza,25,0,35,10
1683317973603,MATH 109,A02,188696,Salehi Golsefidy; Alireza,26,0,35,9
1683317974628,MATH 120A,A01,188698,Eggers; John Dietrich,7,0,35,28
1683317975656,MATH 142B,A01,188736,Ioana; Adrian,0,2,30,30
1683317975656,MATH 142B,A02,188741,Ioana; Adrian,0,1,30,30
1683317975656,MATH 142B,A03,188743,Ioana; Adrian,1,3,30,29
1683317976680,MATH 168A,A01,188790,Staff,0,9,35,35
1683317977713,MATH 170A,A01,188803,Nie; Jiawang,0,2,35,35
1683317977713,MATH 170A,A02,188811,Nie; Jiawang,0,0,35,35
1683317977713,MATH 170A,A03,188814,Nie; Jiawang,0,0,35,35
1683317977713,MATH 170A,A04,188815,Nie; Jiawang,13,0,35,22
1683317978739,MATH 193B,A01,188817,Staff,0,0,35,35
1683317978739,MATH 193B,A02,188818,Staff,6,0,35,29
1683317979769,MGT 4,A01,202857,Anderson; John Charles,62,0,80,18
1683317980792,MGT 12,A00,202858,Lindenberger; Wade Douglas,43,0,90,47
1683317981817,MGT 18,A00,202859,Staff,74,0,90,16
1683317982841,MGT 18GS,A00,202860,McKay; Michael J,13,0,28,15
1683317983868,MGT 45,A00,202861,Pecore; Joseph P.,13,0,90,77
1683317984896,MGT 100,A00,202863,Yavorsky; Daniel Ryan,28,0,90,62
1683317985923,MGT 103,A00,202864,Ehrich; Kristine R,0,17,90,90
1683317986949,MGT 112,A00,202865,Ehrich; Kristine R,15,0,90,75
1683317987976,MGT 121A,A00,202868,Staff,0,19,0,0
1683317989001,MGT 131B,A00,202869,Anderson; John Charles,59,0,90,31
1683317990032,MGT 136,A00,202871,Lindenberger; Wade Douglas,84,0,90,6
1683317991054,MGT 164,A00,202873,Staff,0,68,90,91
1683317992079,MGT 164GS,A00,202874,McKay; Mary A,13,0,28,15
1683317993103,MGT 180,A00,202875,Staff,0,50,90,91
1683317994130,MMW 11R,A01,205019,Herbst; Matthew,3,0,30,27
1683317994130,MMW 11R,A02,205026,Herbst; Matthew,29,0,30,1
1683317995155,MMW 15,A01,193512,Chang; Edmond Yi-Teh,0,9,28,28
1683317995155,MMW 15,A02,193513,Chang; Edmond Yi-Teh,0,5,28,28
1683317995155,MMW 15,A03,193514,Chang; Edmond Yi-Teh,0,5,28,28
1683317995155,MMW 15,A04,193515,Chang; Edmond Yi-Teh,0,5,28,28
1683317995155,MMW 15,A05,193516,Chang; Edmond Yi-Teh,0,4,28,28
1683317995155,MMW 15,A06,193517,Chang; Edmond Yi-Teh,0,5,28,28
1683317995155,MMW 15,B01,193519,Chang; Edmond Yi-Teh,0,4,28,28
1683317995155,MMW 15,B02,193520,Chang; Edmond Yi-Teh,0,5,28,28
1683317995155,MMW 15,B03,193521,Chang; Edmond Yi-Teh,0,4,28,28
1683317995155,MMW 15,B04,193522,Chang; Edmond Yi-Teh,0,4,28,28
1683317995155,MMW 15,B05,193523,Chang; Edmond Yi-Teh,0,5,28,28
1683317995155,MMW 15,B06,193524,Chang; Edmond Yi-Teh,0,4,28,28
1683317996183,MMW 122,A01,193526,Rahimi; Babak,0,14,28,28
1683317996183,MMW 122,A02,193527,Rahimi; Babak,0,14,28,28
1683317996183,MMW 122,A03,193528,Rahimi; Babak,0,0,0,0
1683317996183,MMW 122,A04,193529,Rahimi; Babak,0,0,0,0
1683317997206,MUS 1A,A01,186663,Staff,0,20,35,35
1683317998229,MUS 4,A01,186715,Staff,0,12,35,35
1683317999253,MUS 5R,A01,186796,Dubnov; Shlomo,0,17,35,35
1683318000283,MUS 6,A01,186798,Staff,0,3,25,25
1683318001308,MUS 7,A01,186830,Staff,12,0,35,23
1683318002333,MUS 8,A01,186930,Staff,0,26,35,35
1683318003359,MUS 15,A01,186932,Staff,0,15,35,35
1683318003359,MUS 15,B01,186934,Staff,0,15,35,35
1683318004383,MUS 80,A00,186935,Staff,2,0,20,18
1683318004383,MUS 80,B00,186936,Staff,25,0,25,0
1683318005412,NANO 11,A00,204702,Lipomi; Darren John,0,0,0,0
1683318006436,NANO 15,A01,204709,Yang; Kesong,0,1,0,0
1683318007459,NANO 114,A00,202069,Jahed Motlagh; Zeinab,3,0,10,7
1683318008482,PHIL 1,A00,186955,Grush; Rick Scott,32,0,40,8
1683318009510,PHIL 10,A01,186973,Grush; Rick Scott,28,0,35,7
1683318009510,PHIL 10,A02,186974,Grush; Rick Scott,33,0,35,2
1683318010533,PHIL 13,A01,186976,Staff,7,0,35,28
1683318010533,PHIL 13,A02,186977,Staff,16,0,35,19
1683318011561,PHIL 14,A01,186979,Staff,31,0,35,4
1683318011561,PHIL 14,A02,186986,Staff,32,0,35,3
1683318012587,PHIL 28,A01,186988,Staff,16,0,30,14
1683318012587,PHIL 28,A02,186989,Staff,1,0,30,29
1683318012587,PHIL 28,A03,186990,Staff,9,0,30,21
1683318012587,PHIL 28,A04,186991,Staff,26,0,30,4
1683318013615,PHIL 120,A00,186997,Staff,23,0,40,17
1683318014638,PHIL 137,A00,187003,Staff,9,0,40,31
1683318015661,PHIL 150,A00,187015,Staff,47,0,70,23
1683318016685,PHIL 167,A00,187021,Lamey; Andy M.,35,0,40,5
1683318017713,PHIL 174,A01,202226,Staff,17,0,20,3
1683318017713,PHIL 174,A02,202235,Staff,20,0,20,0
1683318018741,PHIL 191A,A00,258918,Staff,0,0,1,1
1683318019765,PHYS 1A,A00,187028,Staff,27,0,60,33
1683318020790,PHYS 1AL,001,187036,Staff,3,0,30,27
1683318020790,PHYS 1AL,002,187049,Staff,18,0,30,12
1683318021813,PHYS 1B,A00,187058,Staff,22,0,60,38
1683318022837,PHYS 1BL,001,187064,Staff,0,0,30,30
1683318022837,PHYS 1BL,002,187070,Staff,5,0,30,25
1683318023862,PHYS 1C,A00,187082,Staff,31,0,120,89
1683318024890,PHYS 1CL,001,187088,Staff,0,9,30,30
1683318024890,PHYS 1CL,002,187089,Staff,0,2,30,30
1683318024890,PHYS 1CL,009,262693,Staff,11,0,30,19
1683318025921,PHYS 2B,A01,187097,Staff,54,0,115,61
1683318026947,PHYS 2C,A01,187099,Staff,67,0,115,48
1683318027972,PHYS 2CL,A01,187101,Staff,5,0,28,23
1683318027972,PHYS 2CL,A02,187102,Staff,15,0,28,13
1683318028998,PHYS 2D,A01,187123,Shotwell; Brian,95,0,115,20
1683318030024,PHYS 4B,A01,187133,Grinstein; Benjamin,35,0,50,15
1683318031048,POLI 10,A00,188819,Staff,0,4,50,50
1683318032073,POLI 11,A00,188827,Staff,43,0,50,7
1683318033096,POLI 13R,A00,188828,Staff,0,1,20,20
1683318034123,POLI 27,A01,188830,Elgin; Samuel Zincke,0,1,70,70
1683318035219,POLI 30,A00,188832,Desposato; Scott,32,0,50,18
1683318036242,POLI 102F,A00,188834,Staff,3,0,40,37
1683318037266,POLI 104A,A00,188852,Staff,14,0,30,16
1683318038292,POLI 104I,A00,188853,Staff,0,6,20,20
1683318039318,POLI 110B,A00,188854,Wiens; David,7,0,20,13
1683318040342,POLI 112A,A00,188855,Wiens; David,5,0,30,25
1683318041369,POLI 117R,A00,188856,Forman; Fonna,0,11,20,20
1683318042393,POLI 118,A00,188857,Ingham; Sean,8,0,20,12
1683318043415,POLI 120G,A00,188858,Staff,9,0,30,21
1683318044439,POLI 131CR,A00,188863,Hoston; Germaine,24,0,50,26
1683318045462,POLI 133,A00,188864,Nellis; Gareth Hb,44,0,50,6
1683318046484,POLI 134D,A00,188865,Desposato; Scott,27,0,30,3
1683318047508,POLI 142A,A00,188871,Gartzke; Erik,22,0,50,28
1683318048536,POLI 142K,A00,188874,Staff,38,0,50,12
1683318049561,POLI 143,A00,188940,Gartzke; Erik,16,0,30,14
1683318050589,POLI 153,A00,188943,Staff,3,0,20,17
1683318051613,POLI 160AA,A00,188944,Staff,12,0,40,28
1683318052640,POLI 170A,A00,188945,Staff,11,0,30,19
1683318054686,PSYC 1,A00,188952,Staff,37,0,90,53
1683318055710,PSYC 2,B00,188953,Staff,19,0,35,16
1683318056735,PSYC 6,A00,188970,Staff,47,0,60,13
1683318057763,PSYC 7,A00,188973,Staff,37,0,45,8
1683318058791,PSYC 60,A01,188980,Rickard; Timothy C.,43,0,60,17
1683318059816,PSYC 70,A01,189001,Steiner; Eric Tomas,24,0,45,21
1683318060839,PSYC 100,A00,189005,Lacefield; Katharine I,0,99,120,120
1683318061864,PSYC 102,A00,189008,Staff,10,0,30,20
1683318062889,PSYC 106,B00,189026,Gorman; Michael R.,36,0,60,24
1683318063913,PSYC 114,B01,189033,Winkielman; Piotr,0,32,30,30
1683318064940,PSYC 131,A00,189036,Anagnostaras; Stephan,0,43,60,60
1683318065970,PSYC 136,A00,189041,Lowe; Angela Beth,0,7,25,25
1683318066996,PSYC 137,A00,189057,Winkielman; Piotr,0,34,25,25
1683318068021,PSYC 144,A00,189107,Wixted; John T,0,7,50,50
1683318070071,PSYC 162,A00,189142,Staff,0,8,85,85
1683318071096,PSYC 172,A00,189144,Gorman; Michael R.,0,7,30,30
1683318073146,PSYC 179,A00,189146,Lacefield; Katharine I,0,84,120,120
1683318074169,PSYC 181,A00,189147,Anagnostaras; Stephan,0,44,90,90
1683318075193,PSYC 190R,A00,189148,Barner; David A.,0,22,80,80
1683318076216,PSYC 191,A00,189275,Rickard; Timothy C.,0,7,25,25
1683318077241,PSYC 193,A00,189276,Chapman; Eddie Nathaniel,0,1,0,4
1683318078269,PSYC 193L,A01,189281,Lowe; Angela Beth,12,0,20,8
1683318078269,PSYC 193L,B01,189285,Staff,28,0,35,7
1683318079293,RELI 149,A00,187137,Rahimi; Babak,7,0,40,33
1683318080317,SE 9,A01,187315,Staff,0,2,18,18
1683318081341,SE 101B,A00,187409,Staff,24,0,30,6
1683318082363,SE 110B,A00,187444,Staff,10,0,40,30
1683318083392,SE 130B,A00,187449,Staff,31,0,40,9
1683318084418,SE 150A,A00,187516,Staff,9,0,20,11
1683318085443,SE 154,A00,187528,Staff,30,0,50,20
1683318086470,SIO 3,A01,258171,Staff,35,0,40,5
1683318087497,SIO 10,A00,187144,Cook; Geoffrey W,0,3,75,75
1683318088524,SIO 45,A00,187152,Cook; Geoffrey W,1,0,100,99
1683318089550,SIO 109R,A00,194486,Staff,0,3,20,20
1683318091601,SIO 187,A01,187233,Kacev; David,12,0,40,28
1683318092626,SOCI 1,A01,258656,Thorpe; Charles Robert,28,0,30,2
1683318092626,SOCI 1,A02,258658,Thorpe; Charles Robert,30,0,30,0
1683318092626,SOCI 1,A03,258661,Thorpe; Charles Robert,25,0,25,0
1683318092626,SOCI 1,A04,258666,Thorpe; Charles Robert,22,0,25,3
1683318092626,SOCI 1,A05,258897,Thorpe; Charles Robert,23,0,25,2
1683318092626,SOCI 1,A06,258898,Thorpe; Charles Robert,25,0,25,0
1683318093650,SOCI 30,A01,258903,Pardo Guerra; Juan Pablo,16,0,30,14
1683318094674,SOCI 102,A00,258904,Staff,9,0,25,16
1683318095697,SOCI 106,A00,258905,Staff,19,0,25,6
1683318096721,SOCI 111,A00,258907,Ribas Norris; Janet Vanesa,26,0,30,4
1683318097745,SOCI 121R,A00,258908,Pardo Guerra; Juan Pablo,11,0,30,19
1683318098769,SOCI 126,A01,203330,Staff,14,0,20,6
1683318099793,SOCI 131,A00,258909,Thorpe; Charles Robert,31,0,60,29
1683318100821,SOCI 135,A00,258910,Payne; Christine Anna,0,9,30,30
1683318101849,SOCI 157,A00,258911,Staff,12,0,30,18
1683318102876,SOCI 184,A00,258912,Staff,25,0,30,5
1683318103902,SOCI 188D,A00,258913,Staff,21,0,30,9
1683318104930,SYN 2,001,187529,Staff,9,0,16,7
1683318104930,SYN 2,002,201452,Staff,0,18,16,16
1683318104930,SYN 2,003,201469,Staff,4,0,16,12
1683318105956,SYN 100,A01,187531,Staff,0,9,20,20
1683318105956,SYN 100,B01,201491,Staff,0,12,20,20
1683318106985,TDAC 1,A00,189286,Walsh; Kim C.,3,0,20,17
1683318106985,TDAC 1,B00,189287,Harting; Carla Kelso,11,0,20,9
1683318108014,TDAC 101,A00,189300,Walsh; Kim C.,16,0,20,4
1683318108014,TDAC 101,B00,189301,Harting; Carla Kelso,18,0,20,2
1683318109039,TDAC 102,A00,189304,Basso; Beatrice,14,0,20,6
1683318110063,TDAC 108,A00,189305,Staff,18,0,20,2
1683318111093,TDDE 131,A00,189310,Staff,19,0,20,1
1683318111093,TDDE 131,B00,189314,Staff,19,0,20,1
1683318111093,TDDE 131,C00,189315,Staff,48,0,50,2
1683318111093,TDDE 131,D00,189316,Staff,14,0,15,1
1683318111093,TDDE 131,E00,204841,Staff,20,0,20,0
1683318112117,TDGE 10,A00,189289,Staff,30,0,50,20
1683318112117,TDGE 10,B00,189290,Havis; Allan,2,0,50,48
1683318113142,TDGE 11,A00,189291,Fulton; Julia,0,3,50,50
1683318113142,TDGE 11,B00,189292,Staff,20,0,25,5
1683318113142,TDGE 11,C00,260270,Staff,0,0,0,0
1683318114169,TDGE 25,A00,189294,Staff,3,0,20,17
1683318115197,TDGE 124,A00,189318,Fulton; Julia,0,8,50,50
1683318116222,TDGE 125,A00,189319,Staff,13,0,25,12
1683318116222,TDGE 125,B00,189320,Staff,23,0,25,2
1683318117252,TDGE 127,A00,189322,Havis; Allan,0,0,50,50
1683318118274,TDHT 101,A00,189323,Staff,18,0,25,7
1683318118274,TDHT 101,B00,189324,Staff,25,0,25,0
1683318119299,TDHT 102,A00,189325,Staff,49,0,50,1
1683318120324,TDMV 1,A00,189295,Arcidiacono; Kristin,20,0,30,10
1683318120324,TDMV 1,B00,189296,Caligagan; Maria T.,24,0,30,6
1683318121351,TDMV 2,A00,189297,Sammartano; Tonnie,28,0,30,2
1683318121351,TDMV 2,B00,189299,Arcidiacono; Kristin,24,0,30,6
1683318122379,TDMV 3,A00,204998,Rincon; Alicia,22,0,30,8
1683318123406,TDMV 120,A00,189458,Sammartano; Tonnie,28,0,30,2
1683318124431,TDMV 138,A00,189541,Jun; Grace Shin Hae,22,0,40,18
1683318125460,TDMV 142,A00,189717,Caligagan; Tony,23,0,30,7
1683318125460,TDMV 142,B00,189718,Caligagan; Maria T.,25,0,30,5
1683318126488,TMC 2,A01,187533,Staff,25,0,25,0
1683318126488,TMC 2,A02,187534,Staff,25,0,25,0
1683318127514,USP 1,A01,187536,Kwak; Nancy,0,16,25,25
1683318128538,USP 5,A01,187538,Staff,9,0,25,16
1683318129561,USP 101,A00,199253,Staff,0,4,0,0
1683318130589,USP 124,A00,187562,Boomhower; Matthew Charles,1,0,30,29
1683318131613,USP 138,A00,187582,Staff,20,0,25,5
1683318132641,USP 152,A01,187597,Staff,4,0,25,21
1683318133665,USP 153,A00,187598,Staff,19,0,25,6
1683318134691,USP 168,A00,187607,Kwak; Nancy,2,0,5,3
1683318135716,USP 173,A00,187619,Staff,4,0,25,21
1683318136740,USP 181,A00,187638,Staff,0,0,25,25
1683318137767,VIS 103,A00,187650,Cruz; Edwin Teddy,23,0,75,52
1683318138847,VIS 110D,A00,187669,Staff,12,0,22,10
1683318139882,VIS 127C,A00,187720,Shen; Kuiyi,68,0,146,78
1683318140906,VIS 149,A00,187731,Yoldas; Pinar,0,14,22,22
1683318141931,VIS 151,A01,188091,Staff,22,0,34,12
1683318141931,VIS 151,A02,188092,Staff,11,0,34,23
1683318142959,VIS 160B,A00,188093,Stalbaum; Brett,0,0,10,10
1683318145009,WCWP 10B,A00,201720,Staff,10,0,15,5
1683318145009,WCWP 10B,B00,201722,Staff,8,0,15,7
1683318146036,WCWP 100,A00,201725,Gagnon; Jeffrey C,0,0,2,2
1683318146036,WCWP 100,B00,201727,Staff,0,4,15,15
1683318149128,ANBI 133,A00,258401,Wilder; Linnea Lorene,34,0,40,6
1683318150153,ANBI 140,A00,258395,Hrvoj Mihic; Branka,18,0,25,7
1683318151179,ANSC 120,A00,258402,Bialecki; Jon Anthony,27,0,40,13
1683318152204,ANSC 144,A00,258400,Staff,14,0,40,26
1683318154252,ANSC 166,A00,258396,Parish; Steven Martin,157,0,175,18
1683318155276,ANSC 180,A00,193533,Staff,9,0,20,11
1683318156302,ANSC 188,A00,258397,Jassal; Aftab,33,0,40,7
1683318157324,ANTH 3,A01,258316,Staff,23,0,30,7
1683318158348,ANTH 5,A00,258394,Semendeferi; Ekaterini,16,0,20,4
1683318159373,ANTH 21,A01,258331,Staff,9,0,40,31
1683318160399,ANTH 103,A00,258398,Varma; Saiba,15,0,25,10
1683318161431,AWP 10,001,202034,Staff,0,0,0,0
1683318161431,AWP 10,002,202035,Staff,0,0,0,0
1683318161431,AWP 10,003,202036,Staff,0,0,0,0
1683318161431,AWP 10,004,202037,Staff,0,0,0,0
1683318161431,AWP 10,005,202038,Staff,0,0,0,0
1683318161431,AWP 10,006,202039,Staff,0,0,0,0
1683318161431,AWP 10,007,202040,Staff,0,0,0,0
1683318161431,AWP 10,008,202041,Staff,0,0,0,0
1683318161431,AWP 10,009,202042,Staff,0,0,0,0
1683318161431,AWP 10,010,202043,Staff,0,0,0,0
1683318161431,AWP 10,011,202044,Staff,0,0,0,0
1683318161431,AWP 10,012,202045,Staff,0,0,0,0
1683318161431,AWP 10,013,202046,Staff,0,0,0,0
1683318161431,AWP 10,014,202047,Staff,0,0,0,0
1683318161431,AWP 10,015,202048,Staff,0,0,0,0
1683318161431,AWP 10,016,202049,Staff,0,0,0,0
1683318161431,AWP 10,017,202050,Staff,0,0,0,0
1683318161431,AWP 10,018,202051,Staff,0,0,0,0
1683318161431,AWP 10,019,202052,Staff,0,0,0,0
1683318161431,AWP 10,020,202053,Staff,0,0,0,0
1683318161431,AWP 10,021,202054,Staff,0,0,0,0
1683318161431,AWP 10,022,202055,Staff,0,0,0,0
1683318161431,AWP 10,023,202056,Staff,0,0,0,0
1683318161431,AWP 10,024,202057,Staff,0,0,0,0
1683318161431,AWP 10,025,202058,Staff,0,0,0,0
1683318161431,AWP 10,026,202059,Staff,0,0,0,0
1683318162458,AWP 102,001,202032,Staff,0,0,0,0
1683318162458,AWP 102,002,202033,Staff,0,0,0,0
1683318163482,BENG 100,A01,254234,Taylor Amos; Alyssa C,31,0,40,9
1683318164509,BENG 196,001,270013,Engler; Adam J.,9999,0,9999,0
1683318165541,BICD 100R,A01,202018,Smith; Laurie,0,7,32,32
1683318165541,BICD 100R,A02,202019,Smith; Laurie,0,2,32,32
1683318165541,BICD 100R,A03,202020,Smith; Laurie,0,1,32,32
1683318165541,BICD 100R,A04,202021,Smith; Laurie,8,0,32,24
1683318165541,BICD 100R,A05,202022,Smith; Laurie,12,0,32,20
1683318166571,BICD 136,A01,193242,Gustafson-Brown; Cindy,0,2,32,32
1683318166571,BICD 136,A02,193244,Gustafson-Brown; Cindy,14,0,32,18
1683318167596,BIEB 102,A01,193249,Butler; Shannon Rhey,0,2,32,32
1683318167596,BIEB 102,A02,193251,Butler; Shannon Rhey,0,0,32,32
1683318167596,BIEB 102,A03,193253,Butler; Shannon Rhey,0,1,32,32
1683318167596,BIEB 102,A04,193255,Butler; Shannon Rhey,17,0,32,15
1683318167596,BIEB 102,A05,193265,Butler; Shannon Rhey,26,0,32,6
1683318167596,BIEB 102,A06,193269,Butler; Shannon Rhey,16,0,32,16
1683318169648,BIEB 150,A01,193274,Staff,0,0,32,32
1683318169648,BIEB 150,A02,193285,Staff,23,0,32,9
1683318170672,BIEB 194,A00,193286,Kurle; Carolyn M.,22,0,32,10
1683318171697,BILD 1,A01,192291,Staff,16,0,32,16
1683318171697,BILD 1,A02,192292,Staff,30,0,32,2
1683318171697,BILD 1,B01,192520,Reuther; Keefe,0,1,0,0
1683318171697,BILD 1,B02,192532,Reuther; Keefe,0,1,0,0
1683318172728,BILD 3,A01,192556,Butler; Shannon Rhey,0,0,32,32
1683318172728,BILD 3,A02,192581,Butler; Shannon Rhey,5,0,32,27
1683318172728,BILD 3,A03,192611,Butler; Shannon Rhey,23,0,32,9
1683318172728,BILD 3,A04,192612,Butler; Shannon Rhey,25,0,32,7
1683318172728,BILD 3,A05,192613,Butler; Shannon Rhey,27,0,32,5
1683318172728,BILD 3,A06,192679,Butler; Shannon Rhey,27,0,32,5
1683318172728,BILD 3,A07,192682,Butler; Shannon Rhey,22,0,32,10
1683318173754,BILD 4,A01,192836,Reuther; Keefe,0,0,24,24
1683318173754,BILD 4,A02,193044,Reuther; Keefe,4,0,24,20
1683318174779,BILD 10,A01,193142,Gustafson-Brown; Cindy,30,0,32,2
1683318174779,BILD 10,A02,193149,Gustafson-Brown; Cindy,31,0,32,1
1683318175802,BIMM 100,A01,193301,Staff,0,6,32,32
1683318175802,BIMM 100,A02,193312,Staff,0,5,32,32
1683318175802,BIMM 100,A03,193323,Staff,0,8,32,32
1683318176828,BIMM 101,A01,193329,McDonnell; Lisa Marie,0,3,24,24
1683318176828,BIMM 101,A02,193339,McDonnell; Lisa Marie,0,2,24,24
1683318176828,BIMM 101,B01,193354,McDonnell; Lisa Marie,0,3,24,24
1683318176828,BIMM 101,B02,193357,McDonnell; Lisa Marie,0,3,24,24
1683318177852,BIMM 110,A01,193377,Tat; John,0,11,32,32
1683318177852,BIMM 110,A02,193378,Tat; John,1,9,32,31
1683318178877,BIMM 120,A01,206116,Staff,0,0,32,32
1683318178877,BIMM 120,A02,206117,Staff,8,0,32,24
1683318178877,BIMM 120,A03,206121,Staff,21,0,32,11
1683318179902,BIPN 100,A01,193393,Park; Ji Young,0,14,32,32
1683318179902,BIPN 100,A02,193402,Park; Ji Young,0,12,32,32
1683318179902,BIPN 100,A03,193413,Park; Ji Young,0,14,32,32
1683318179902,BIPN 100,A04,193414,Park; Ji Young,0,13,32,32
1683318180926,BIPN 102,A01,193429,Staff,0,0,32,32
1683318180926,BIPN 102,A02,193438,Staff,22,0,32,10
1683318181957,BIPN 106,A01,193450,Reyes Gonzalez; Catalina,0,2,40,40
1683318182989,BIPN 134,A01,193465,Cooke; James Edward,0,0,32,32
1683318182989,BIPN 134,A02,193474,Cooke; James Edward,27,0,32,5
1683318182989,BIPN 134,A03,193485,Cooke; James Edward,29,0,32,3
1683318182989,BIPN 134,A04,193486,Cooke; James Edward,21,0,32,11
1683318182989,BIPN 134,A05,193491,Cooke; James Edward,31,0,32,1
1683318182989,BIPN 134,A06,193501,Cooke; James Edward,30,0,32,2
1683318182989,BIPN 134,A07,193510,Cooke; James Edward,29,0,32,3
1683318185043,BISP 194,A00,222522,Staff,15,0,32,17
1683318186069,CAT 124,A01,202407,Staff,20,0,25,5
1683318187099,CAT 125,A00,202408,Marchisotto; Jennifer Anne,4,0,20,16
1683318188124,CAT 125R,A00,202409,Smith; Lauryn Alissa,0,11,20,20
1683318188124,CAT 125R,B00,202410,Morales; Celeste Georgianna,0,11,20,20
1683318188124,CAT 125R,C00,202411,Irwin; Matthew Joseph,0,10,20,20
1683318189152,CENG 15,A01,204712,Yang; Kesong,0,1,0,0
1683318190176,CENG 114,A00,202070,Jahed Motlagh; Zeinab,5,0,20,15
1683318191200,CGS 105,A00,185477,Wesling; Megan E.,24,0,40,16
1683318192227,CGS 106,A00,185494,Staff,13,0,22,9
1683318193252,CGS 108,A00,185495,Staff,14,0,20,6
1683318194278,CGS 114,A00,185496,Staff,13,0,18,5
1683318195305,CGS 119,A00,185501,Staff,15,0,20,5
1683318196329,CGS 120,A00,185511,Staff,13,0,20,7
1683318197355,CHEM 4,A01,184675,Bussey; Thomas J,96,0,100,4
1683318198380,CHEM 6A,A01,184677,Staff,35,0,60,25
1683318199409,CHEM 6B,A01,184679,Staff,65,0,100,35
1683318200433,CHEM 6C,A01,184681,Bussey; Thomas J,1,0,50,49
1683318200433,CHEM 6C,A02,184682,Bussey; Thomas J,34,0,50,16
1683318201461,CHEM 40A,A01,184684,Albizati; Kim F.,37,0,100,63
1683318202487,CHEM 40B,A01,184686,Albizati; Kim F.,0,20,100,100
1683318203511,CHEM 41B,A01,184690,Staff,52,0,100,48
1683318204538,COGS 3,A01,184715,Boyle; Mary E. T.,0,25,40,40
1683318205561,COGS 14B,A01,185172,Staff,0,15,38,38
1683318206590,COGS 18,A01,184736,Staff,18,0,80,62
1683318207618,COGS 100,A01,184932,Staff,0,5,73,73
1683318208643,COGS 101A,A01,184935,Staff,0,38,30,30
1683318209668,COGS 101B,A01,184944,Staff,0,2,30,30
1683318210693,COGS 101C,A01,184946,Staff,0,12,30,30
1683318211718,COGS 102A,A01,184951,Johnson; Christine M.,2,0,40,38
1683318212745,COGS 107B,A01,184953,Mooshagian; Eric Frederick,0,50,40,40
1683318213776,COGS 118B,A01,184959,Gupta; Anjum,0,48,40,40
1683318214801,COGS 153,A00,184961,Staff,0,15,30,30
1683318215827,COGS 177,A00,184962,Staff,0,21,30,30
1683318216852,COGS 187A,A01,184969,Boyle; Mary E. T.,0,17,40,40
1683318217880,COMM 10,A01,185174,Staff,0,5,25,25
1683318217880,COMM 10,A02,185189,Staff,0,5,25,25
1683318217880,COMM 10,A03,269821,Staff,0,0,0,0
1683318218907,COMM 100B,A01,185475,Staff,0,0,0,2
1683318218907,COMM 100B,A02,185476,Staff,14,0,25,11
1683318219932,COMM 100C,A01,185314,Staff,1,0,25,24
1683318219932,COMM 100C,A02,185327,Staff,19,0,25,6
1683318220961,COMM 110M,A00,185349,Staff,2,0,40,38
1683318221986,COMM 113T,A00,185352,Staff,25,0,40,15
1683318223014,COMM 114I,A00,185353,Staff,33,0,40,7
1683318224038,COMM 131,A00,185354,Staff,19,0,30,11
1683318225063,CSE 8A,A50,185358,Cao; Yingjun,0,46,10,10
1683318226087,CSE 8B,A01,185362,Staff,1,47,50,49
1683318227111,CSE 11,A01,185416,Cao; Yingjun,0,92,10,10
1683318228139,CSE 20,A01,185445,Briones; Jor-el Thomas Caparas,5,0,25,20
1683318229166,CSE 21,A01,185447,Staff,10,0,50,40
1683318230191,CSE 101,A01,185451,Staff,0,12,50,50
1683318230191,CSE 101,B01,185453,Jones; Miles E,0,11,50,50
1683318232241,CSE 141,A01,185458,Eldon; John,20,0,100,80
1683318233266,CSE 141L,A01,185461,Eldon; John,12,0,100,88
1683318234294,CSE 142,A01,185463,Staff,36,0,60,24
1683318234294,CSE 142,B01,201355,Staff,0,7,60,60
1683318235322,CSE 142L,A01,185470,Staff,36,0,60,24
1683318235322,CSE 142L,B01,201417,Staff,0,6,60,60
1683318236346,CSE 190,A00,201433,Staff,32,0,49,17
1683318237371,DOC 1,A01,259136,Strom; Megan C.,7,0,15,8
1683318237371,DOC 1,A02,259137,Strom; Megan C.,14,0,15,1
1683318237371,DOC 1,A03,259138,Strom; Megan C.,14,0,15,1
1683318237371,DOC 1,A04,259139,Strom; Megan C.,14,0,15,1
1683318238395,DOC 100D,A00,259140,Pass; Natalye Joann,17,0,25,8
1683318239423,DSGN 1,A01,184749,Rill; Bryan,0,25,30,30
1683318240450,DSGN 100,A01,185168,Staff,0,2,25,25
1683318241473,ECE 5,A01,185626,Morris; Karcher William,0,10,0,0
1683318242573,ECE 101,A01,185628,Staff,17,0,70,53
1683318243598,ECE 107,A01,185635,Baghdadchi; Saharnaz,0,0,20,20
1683318243598,ECE 107,A02,185638,Baghdadchi; Saharnaz,4,0,20,16
1683318244621,ECE 148,A01,185647,Silberman; Jack,0,0,16,16
1683318245646,ECON 1,A01,185537,Crane; Meredith Helen,54,0,70,16
1683318246671,ECON 3,A01,185549,Crane; Meredith Helen,33,0,70,37
1683318247699,ECON 4,A01,203354,Anderson; John Charles,0,4,10,10
1683318248727,ECON 100A,A01,185574,Staff,0,4,40,40
1683318249755,ECON 100B,A01,185576,Staff,0,22,40,40
1683318250780,ECON 100C,A01,185589,Newhouse; Herbert S,30,0,70,40
1683318251808,ECON 105,A00,185608,Vespa; Emanuel Ignacio,19,0,35,16
1683318252833,ECON 109,A01,185610,Shishkin; Denis,10,0,35,25
1683318253858,ECON 110A,A01,185612,Staff,11,0,40,29
1683318254883,ECON 120A,A01,185615,Staff,20,0,40,20
1683318255908,ECON 120C,A01,185617,Sun; Yixiao,0,20,70,70
1683318256937,ECON 144,A00,203346,Squires; Dale E,3,0,35,32
1683318257965,ECON 171,A01,203349,Newhouse; Herbert S,0,1,35,35
1683318258990,ECON 173A,A01,185621,Toda; Alexis Akira,21,0,35,14
1683318260017,EDS 25,A01,202413,Staff,0,1,0,0
1683318260017,EDS 25,A02,202414,Staff,0,1,0,0
1683318260017,EDS 25,A03,202415,Staff,0,0,0,0
1683318260017,EDS 25,A04,202416,Staff,0,1,0,0
1683318260017,EDS 25,A05,202439,Staff,0,0,0,0
1683318260017,EDS 25,A06,202440,Staff,0,0,0,0
1683318260017,EDS 25,B01,202631,Staff,0,0,0,0
1683318260017,EDS 25,B02,202632,Staff,0,0,0,0
1683318260017,EDS 25,B03,202639,Staff,0,0,0,0
1683318260017,EDS 25,B04,202640,Staff,0,0,0,0
1683318260017,EDS 25,B05,202643,Staff,0,0,0,0
1683318260017,EDS 25,B06,202644,Staff,0,0,0,0
1683318261041,EDS 38,A01,202659,Black; Alison Michelle,24,0,25,1
1683318262066,EDS 115,A00,202652,Staff,17,0,30,13
1683318263094,EDS 125,A00,202649,Staff,14,0,30,16
1683318264121,EDS 126,A01,203332,Staff,30,0,30,0
1683318265153,EDS 139,A00,202838,Staff,16,0,25,9
1683318266181,EDS 146,A01,202655,Staff,14,0,25,11
1683318267212,ENG 15,A00,185667,Staff,0,1,0,0
1683318267212,ENG 15,B00,185672,Staff,0,0,0,0
1683318267212,ENG 15,C00,185675,Staff,0,0,0,0
1683318267212,ENG 15,D00,185682,Staff,0,0,0,0
1683318267212,ENG 15,E00,185684,Staff,0,0,0,0
1683318268235,ETHN 103,A00,185710,Staff,0,3,35,35
1683318269259,ETHN 103A,A00,199228,Man; Simeon S,2,0,9,7
1683318270284,ETHN 109,A00,185711,Staff,18,0,35,17
1683318271308,ETHN 142,A00,185726,Staff,0,4,30,30
1683318272333,ETHN 163J,A00,199229,Man; Simeon S,5,0,8,3
1683318273361,ETHN 168,A00,185727,Staff,8,0,10,2
1683318274385,ETHN 182,A00,185728,Staff,1,0,35,34
1683318275412,ETHN 183,A00,185737,Staff,8,0,18,10
1683318276438,GLBH 111,A01,209361,Burgos; Jose L.,0,0,0,0
1683318278488,HIEU 104,A00,185792,Staff,16,0,20,4
1683318279515,HIEU 115,A00,185800,Staff,1,0,20,19
1683318280541,HIEU 128,A00,185801,Staff,0,7,20,20
1683318281566,HIEU 147,A00,185802,Staff,16,0,20,4
1683318282593,HIEU 154,A00,185823,Staff,12,0,20,8
1683318283620,HILA 102,A00,185826,Staff,13,0,20,7
1683318284646,HILD 2C,A01,185778,Staff,0,12,20,20
1683318285670,HILD 7B,A01,185780,Kwak; Nancy,0,15,32,32
1683318285670,HILD 7B,A02,185781,Kwak; Nancy,0,18,32,32
1683318286694,HILD 30,A01,185791,Staff,14,0,20,6
1683318287719,HISC 119,A00,185830,Golan; Tal,0,9,20,20
1683318288743,HITO 156GS,A00,185831,Patterson; Patrick H.,0,0,0,23
1683318289768,HIUS 103,A00,185832,Man; Simeon S,0,6,20,20
1683318290793,HIUS 117,A00,185836,Kwak; Nancy,2,0,20,18
1683318291817,HIUS 125,A00,185840,Man; Simeon S,0,0,23,23
1683318292845,HIUS 149,A00,185845,Staff,0,0,20,20
1683318293869,HUM 3,A01,185882,Zavodny; Tatiana Sophia,0,6,50,50
1683318293869,HUM 3,B01,185899,Caldwell; Michael Alan,0,19,50,50
1683318294894,HUM 3GS,A00,185900,Patterson; Patrick H.,0,0,0,23
1683318295924,HUM 4,A01,185938,Zroka; Amy Liane,31,0,50,19
1683318295924,HUM 4,B01,185956,Watkins; Eric,0,2,50,50
1683318295924,HUM 4,B02,202209,Watkins; Eric,0,2,50,50
1683318295924,HUM 4,B03,202210,Watkins; Eric,0,0,50,50
1683318296954,HUM 5,A01,185958,West; Geoffrey Scott,4,0,50,46
1683318296954,HUM 5,A02,202215,West; Geoffrey Scott,0,0,50,50
1683318297981,INTL 190,A00,185959,Gagnon; Jeffrey C,0,0,0,9
1683318297981,INTL 190,B00,185960,Lettieri; Michael Joseph,0,0,0,1
1683318299005,JAPN 180,A00,254509,Staff,5,1,30,25
1683318300035,LATI 10,A01,202853,Kennemore; Amy Michelle,5,0,35,30
1683318300035,LATI 10,A02,202854,Kennemore; Amy Michelle,1,0,35,34
1683318300035,LATI 10,A03,270054,Kennemore; Amy Michelle,30,0,30,0
1683318301060,LATI 180,A00,202855,Kennemore; Amy Michelle,11,0,20,9
1683318302086,LAWS 101,A00,201767,Golan; Tal,0,7,40,40
1683318303113,LIFR 1C,A00,185961,Staff,6,0,20,14
1683318304141,LIFR 1CX,A00,185962,Staff,7,0,20,13
1683318305165,LIFR 1D,A00,185963,Staff,9,0,20,11
1683318306193,LIFR 1DX,A00,185964,Staff,9,0,20,11
1683318307219,LIGN 101,A01,186039,Staff,43,0,50,7
1683318308245,LIGN 165,A00,186040,Staff,18,0,50,32
1683318309270,LTCS 108,A00,186041,Staff,6,0,10,4
1683318310297,LTCS 119,A00,186042,Staff,16,0,20,4
1683318311325,LTCS 130,A00,186043,Wesling; Megan E.,15,0,25,10
1683318313374,LTEA 138,A00,186119,Staff,14,0,40,26
1683318314401,LTEN 124,A00,186148,Staff,6,0,25,19
1683318315427,LTEN 178,A00,186149,Staff,7,0,15,8
1683318316450,LTEN 181,A00,186150,Blanco; John D,33,0,40,7
1683318317478,LTWL 120,A00,186160,Staff,20,0,25,5
1683318318502,LTWL 165,A00,186161,Staff,22,0,25,3
1683318319528,LTWR 100,A00,186162,Staff,0,4,15,15
1683318320555,LTWR 102,A00,186163,Doller; Ben,5,0,15,10
1683318321581,MAE 8,A01,186412,Staff,0,0,0,0
1683318322608,MAE 30B,A00,186445,Bahadori; Mohammad Yousef,83,0,100,17
1683318323632,MAE 40,A00,186592,Bewley; Thomas R,9,0,50,41
1683318324656,MAE 101B,A00,186593,Bahadori; Mohammad Yousef,81,0,100,19
1683318325682,MAE 105,A00,186594,Bandaru; Prabhakar,12,0,50,38
1683318326708,MAE 107,A00,186599,Pham; Hieu Tan,0,6,120,120
1683318327732,MAE 148,A01,186660,Silberman; Jack,3,0,16,13
1683318328758,MATH 10A,A01,188095,Staff,0,6,35,35
1683318329783,MATH 10B,A01,188097,Bowers; Adam R.,0,11,30,30
1683318329783,MATH 10B,A02,188099,Bowers; Adam R.,0,11,30,30
1683318329783,MATH 10B,B01,188104,Bowers; Adam R.,0,10,30,30
1683318329783,MATH 10B,B02,188106,Bowers; Adam R.,0,10,30,30
1683318330811,MATH 10C,A01,188111,Staff,0,18,30,30
1683318330811,MATH 10C,A02,188127,Staff,0,17,30,30
1683318330811,MATH 10C,A03,188131,Staff,0,18,30,30
1683318330811,MATH 10C,B01,188218,Staff,20,0,30,10
1683318330811,MATH 10C,B02,188244,Staff,13,0,30,17
1683318330811,MATH 10C,B03,188277,Staff,16,0,30,14
1683318331841,MATH 18,A01,188344,Bach; Quang Tran,18,0,30,12
1683318331841,MATH 18,A02,188345,Bach; Quang Tran,11,0,30,19
1683318331841,MATH 18,B01,188353,Bach; Quang Tran,10,0,30,20
1683318331841,MATH 18,B02,188354,Bach; Quang Tran,20,0,30,10
1683318332869,MATH 20A,A01,188374,Staff,13,0,35,22
1683318333898,MATH 20B,A01,188382,Ohm; Ko Woon,6,0,30,24
1683318333898,MATH 20B,A02,188383,Ohm; Ko Woon,23,0,30,7
1683318333898,MATH 20B,B01,188385,Ohm; Ko Woon,7,0,30,23
1683318333898,MATH 20B,B02,188392,Ohm; Ko Woon,22,0,30,8
1683318334927,MATH 20C,A01,188394,Harel; Guershon,10,0,30,20
1683318334927,MATH 20C,A02,188395,Harel; Guershon,14,0,30,16
1683318334927,MATH 20C,B01,188404,Harel; Guershon,5,0,30,25
1683318334927,MATH 20C,B02,188405,Harel; Guershon,19,0,30,11
1683318335953,MATH 20D,A01,188414,Hammock; Frances H,0,1,30,30
1683318335953,MATH 20D,A02,188415,Hammock; Frances H,3,0,30,27
1683318335953,MATH 20D,B01,188447,Hammock; Frances H,2,0,30,28
1683318335953,MATH 20D,B02,188486,Hammock; Frances H,8,0,30,22
1683318336979,MATH 20E,A01,188649,Staff,21,0,30,9
1683318336979,MATH 20E,A02,188650,Staff,23,0,30,7
1683318336979,MATH 20E,A03,188673,Staff,0,0,30,30
1683318338007,MATH 102,A01,188675,Staff,0,35,35,35
1683318339032,MATH 103B,A01,188681,Staff,4,0,35,31
1683318339032,MATH 103B,B01,188692,Staff,5,0,35,30
1683318340057,MATH 109,A01,188695,Salehi Golsefidy; Alireza,25,0,35,10
1683318340057,MATH 109,A02,188696,Salehi Golsefidy; Alireza,26,0,35,9
1683318341081,MATH 120A,A01,188698,Eggers; John Dietrich,7,0,35,28
1683318342112,MATH 142B,A01,188736,Ioana; Adrian,0,2,30,30
1683318342112,MATH 142B,A02,188741,Ioana; Adrian,0,1,30,30
1683318342112,MATH 142B,A03,188743,Ioana; Adrian,1,3,30,29
1683318343136,MATH 168A,A01,188790,Staff,0,9,35,35
1683318344163,MATH 170A,A01,188803,Nie; Jiawang,0,2,35,35
1683318344163,MATH 170A,A02,188811,Nie; Jiawang,0,0,35,35
1683318344163,MATH 170A,A03,188814,Nie; Jiawang,0,0,35,35
1683318344163,MATH 170A,A04,188815,Nie; Jiawang,13,0,35,22
1683318345187,MATH 193B,A01,188817,Staff,0,0,35,35
1683318345187,MATH 193B,A02,188818,Staff,6,0,35,29
1683318346269,MGT 4,A01,202857,Anderson; John Charles,62,0,80,18
1683318347292,MGT 12,A00,202858,Lindenberger; Wade Douglas,43,0,90,47
1683318348318,MGT 18,A00,202859,Staff,74,0,90,16
1683318349341,MGT 18GS,A00,202860,McKay; Michael J,13,0,28,15
1683318350367,MGT 45,A00,202861,Pecore; Joseph P.,13,0,90,77
1683318351389,MGT 100,A00,202863,Yavorsky; Daniel Ryan,28,0,90,62
1683318352413,MGT 103,A00,202864,Ehrich; Kristine R,0,17,90,90
1683318353441,MGT 112,A00,202865,Ehrich; Kristine R,15,0,90,75
1683318354469,MGT 121A,A00,202868,Staff,0,19,0,0
1683318355497,MGT 131B,A00,202869,Anderson; John Charles,59,0,90,31
1683318356521,MGT 136,A00,202871,Lindenberger; Wade Douglas,84,0,90,6
1683318357548,MGT 164,A00,202873,Staff,0,68,90,91
1683318358573,MGT 164GS,A00,202874,McKay; Mary A,13,0,28,15
1683318359597,MGT 180,A00,202875,Staff,0,50,90,91
1683318360621,MMW 11R,A01,205019,Herbst; Matthew,3,0,30,27
1683318360621,MMW 11R,A02,205026,Herbst; Matthew,29,0,30,1
1683318361651,MMW 15,A01,193512,Chang; Edmond Yi-Teh,0,9,28,28
1683318361651,MMW 15,A02,193513,Chang; Edmond Yi-Teh,0,5,28,28
1683318361651,MMW 15,A03,193514,Chang; Edmond Yi-Teh,0,5,28,28
1683318361651,MMW 15,A04,193515,Chang; Edmond Yi-Teh,0,5,28,28
1683318361651,MMW 15,A05,193516,Chang; Edmond Yi-Teh,0,4,28,28
1683318361651,MMW 15,A06,193517,Chang; Edmond Yi-Teh,0,5,28,28
1683318361651,MMW 15,B01,193519,Chang; Edmond Yi-Teh,0,4,28,28
1683318361651,MMW 15,B02,193520,Chang; Edmond Yi-Teh,0,5,28,28
1683318361651,MMW 15,B03,193521,Chang; Edmond Yi-Teh,0,4,28,28
1683318361651,MMW 15,B04,193522,Chang; Edmond Yi-Teh,0,4,28,28
1683318361651,MMW 15,B05,193523,Chang; Edmond Yi-Teh,0,5,28,28
1683318361651,MMW 15,B06,193524,Chang; Edmond Yi-Teh,0,4,28,28
1683318362678,MMW 122,A01,193526,Rahimi; Babak,0,14,28,28
1683318362678,MMW 122,A02,193527,Rahimi; Babak,0,14,28,28
1683318362678,MMW 122,A03,193528,Rahimi; Babak,0,0,0,0
1683318362678,MMW 122,A04,193529,Rahimi; Babak,0,0,0,0
1683318363706,MUS 1A,A01,186663,Staff,0,20,35,35
1683318364729,MUS 4,A01,186715,Staff,0,12,35,35
1683318365756,MUS 5R,A01,186796,Dubnov; Shlomo,0,17,35,35
1683318366784,MUS 6,A01,186798,Staff,0,3,25,25
1683318367809,MUS 7,A01,186830,Staff,12,0,35,23
1683318368837,MUS 8,A01,186930,Staff,0,26,35,35
1683318369866,MUS 15,A01,186932,Staff,0,15,35,35
1683318369866,MUS 15,B01,186934,Staff,0,15,35,35
1683318370893,MUS 80,A00,186935,Staff,2,0,20,18
1683318370893,MUS 80,B00,186936,Staff,25,0,25,0
1683318371918,NANO 11,A00,204702,Lipomi; Darren John,0,0,0,0
1683318372945,NANO 15,A01,204709,Yang; Kesong,0,1,0,0
1683318373975,NANO 114,A00,202069,Jahed Motlagh; Zeinab,3,0,10,7
1683318375007,PHIL 1,A00,186955,Grush; Rick Scott,32,0,40,8
1683318376033,PHIL 10,A01,186973,Grush; Rick Scott,28,0,35,7
1683318376033,PHIL 10,A02,186974,Grush; Rick Scott,33,0,35,2
1683318377061,PHIL 13,A01,186976,Staff,7,0,35,28
1683318377061,PHIL 13,A02,186977,Staff,16,0,35,19
1683318378091,PHIL 14,A01,186979,Staff,31,0,35,4
1683318378091,PHIL 14,A02,186986,Staff,32,0,35,3
1683318379118,PHIL 28,A01,186988,Staff,16,0,30,14
1683318379118,PHIL 28,A02,186989,Staff,1,0,30,29
1683318379118,PHIL 28,A03,186990,Staff,9,0,30,21
1683318379118,PHIL 28,A04,186991,Staff,26,0,30,4
1683318380142,PHIL 120,A00,186997,Staff,23,0,40,17
1683318381197,PHIL 137,A00,187003,Staff,9,0,40,31
1683318382223,PHIL 150,A00,187015,Staff,47,0,70,23
1683318383249,PHIL 167,A00,187021,Lamey; Andy M.,35,0,40,5
1683318384274,PHIL 174,A01,202226,Staff,17,0,20,3
1683318384274,PHIL 174,A02,202235,Staff,20,0,20,0
1683318385298,PHIL 191A,A00,258918,Staff,0,0,1,1
1683318386326,PHYS 1A,A00,187028,Staff,27,0,60,33
1683318387357,PHYS 1AL,001,187036,Staff,3,0,30,27
1683318387357,PHYS 1AL,002,187049,Staff,18,0,30,12
1683318388385,PHYS 1B,A00,187058,Staff,22,0,60,38
1683318389417,PHYS 1BL,001,187064,Staff,0,0,30,30
1683318389417,PHYS 1BL,002,187070,Staff,5,0,30,25
1683318390445,PHYS 1C,A00,187082,Staff,31,0,120,89
1683318391472,PHYS 1CL,001,187088,Staff,0,9,30,30
1683318391472,PHYS 1CL,002,187089,Staff,0,2,30,30
1683318391472,PHYS 1CL,009,262693,Staff,11,0,30,19
1683318392500,PHYS 2B,A01,187097,Staff,54,0,115,61
1683318393528,PHYS 2C,A01,187099,Staff,67,0,115,48
1683318394556,PHYS 2CL,A01,187101,Staff,5,0,28,23
1683318394556,PHYS 2CL,A02,187102,Staff,15,0,28,13
1683318395580,PHYS 2D,A01,187123,Shotwell; Brian,95,0,115,20
1683318396608,PHYS 4B,A01,187133,Grinstein; Benjamin,35,0,50,15
1683318397633,POLI 10,A00,188819,Staff,0,4,50,50
1683318398657,POLI 11,A00,188827,Staff,43,0,50,7
1683318399685,POLI 13R,A00,188828,Staff,0,1,20,20
1683318400710,POLI 27,A01,188830,Elgin; Samuel Zincke,0,1,70,70
1683318401742,POLI 30,A00,188832,Desposato; Scott,32,0,50,18
1683318402768,POLI 102F,A00,188834,Staff,3,0,40,37
1683318403793,POLI 104A,A00,188852,Staff,14,0,30,16
1683318404818,POLI 104I,A00,188853,Staff,0,6,20,20
1683318405843,POLI 110B,A00,188854,Wiens; David,7,0,20,13
1683318406870,POLI 112A,A00,188855,Wiens; David,5,0,30,25
1683318407894,POLI 117R,A00,188856,Forman; Fonna,0,11,20,20
1683318408922,POLI 118,A00,188857,Ingham; Sean,8,0,20,12
1683318409945,POLI 120G,A00,188858,Staff,9,0,30,21
1683318410973,POLI 131CR,A00,188863,Hoston; Germaine,24,0,50,26
1683318411998,POLI 133,A00,188864,Nellis; Gareth Hb,44,0,50,6
1683318413027,POLI 134D,A00,188865,Desposato; Scott,27,0,30,3
1683318414053,POLI 142A,A00,188871,Gartzke; Erik,22,0,50,28
1683318415081,POLI 142K,A00,188874,Staff,38,0,50,12
1683318416107,POLI 143,A00,188940,Gartzke; Erik,16,0,30,14
1683318417135,POLI 153,A00,188943,Staff,3,0,20,17
1683318418157,POLI 160AA,A00,188944,Staff,12,0,40,28
1683318419185,POLI 170A,A00,188945,Staff,11,0,30,19
1683318421261,PSYC 1,A00,188952,Staff,37,0,90,53
1683318422286,PSYC 2,B00,188953,Staff,19,0,35,16
1683318423312,PSYC 6,A00,188970,Staff,47,0,60,13
1683318424336,PSYC 7,A00,188973,Staff,37,0,45,8
1683318425361,PSYC 60,A01,188980,Rickard; Timothy C.,43,0,60,17
1683318426385,PSYC 70,A01,189001,Steiner; Eric Tomas,24,0,45,21
1683318427409,PSYC 100,A00,189005,Lacefield; Katharine I,0,99,120,120
1683318428435,PSYC 102,A00,189008,Staff,10,0,30,20
1683318429460,PSYC 106,B00,189026,Gorman; Michael R.,36,0,60,24
1683318430487,PSYC 114,B01,189033,Winkielman; Piotr,0,32,30,30
1683318431512,PSYC 131,A00,189036,Anagnostaras; Stephan,0,43,60,60
1683318432539,PSYC 136,A00,189041,Lowe; Angela Beth,0,7,25,25
1683318433564,PSYC 137,A00,189057,Winkielman; Piotr,0,34,25,25
1683318434589,PSYC 144,A00,189107,Wixted; John T,0,7,50,50
1683318436640,PSYC 162,A00,189142,Staff,0,8,85,85
1683318437666,PSYC 172,A00,189144,Gorman; Michael R.,0,7,30,30
1683318439714,PSYC 179,A00,189146,Lacefield; Katharine I,0,84,120,120
1683318440743,PSYC 181,A00,189147,Anagnostaras; Stephan,0,44,90,90
1683318441767,PSYC 190R,A00,189148,Barner; David A.,0,22,80,80
1683318442794,PSYC 191,A00,189275,Rickard; Timothy C.,0,7,25,25
1683318443819,PSYC 193,A00,189276,Chapman; Eddie Nathaniel,0,1,0,4
1683318444845,PSYC 193L,A01,189281,Lowe; Angela Beth,12,0,20,8
1683318444845,PSYC 193L,B01,189285,Staff,28,0,35,7
1683318445869,RELI 149,A00,187137,Rahimi; Babak,7,0,40,33
1683318446895,SE 9,A01,187315,Staff,0,2,18,18
1683318447918,SE 101B,A00,187409,Staff,24,0,30,6
1683318448946,SE 110B,A00,187444,Staff,10,0,40,30
1683318450032,SE 130B,A00,187449,Staff,31,0,40,9
1683318451060,SE 150A,A00,187516,Staff,9,0,20,11
1683318452084,SE 154,A00,187528,Staff,30,0,50,20
1683318453109,SIO 3,A01,258171,Staff,35,0,40,5
1683318454132,SIO 10,A00,187144,Cook; Geoffrey W,0,3,75,75
1683318455159,SIO 45,A00,187152,Cook; Geoffrey W,1,0,100,99
1683318456186,SIO 109R,A00,194486,Staff,0,3,20,20
1683318458240,SIO 187,A01,187233,Kacev; David,12,0,40,28
1683318459269,SOCI 1,A01,258656,Thorpe; Charles Robert,28,0,30,2
1683318459269,SOCI 1,A02,258658,Thorpe; Charles Robert,30,0,30,0
1683318459269,SOCI 1,A03,258661,Thorpe; Charles Robert,25,0,25,0
1683318459269,SOCI 1,A04,258666,Thorpe; Charles Robert,22,0,25,3
1683318459269,SOCI 1,A05,258897,Thorpe; Charles Robert,23,0,25,2
1683318459269,SOCI 1,A06,258898,Thorpe; Charles Robert,25,0,25,0
1683318460293,SOCI 30,A01,258903,Pardo Guerra; Juan Pablo,16,0,30,14
1683318461317,SOCI 102,A00,258904,Staff,9,0,25,16
1683318462344,SOCI 106,A00,258905,Staff,19,0,25,6
1683318463367,SOCI 111,A00,258907,Ribas Norris; Janet Vanesa,26,0,30,4
1683318464390,SOCI 121R,A00,258908,Pardo Guerra; Juan Pablo,11,0,30,19
1683318465413,SOCI 126,A01,203330,Staff,14,0,20,6
1683318466441,SOCI 131,A00,258909,Thorpe; Charles Robert,31,0,60,29
1683318467464,SOCI 135,A00,258910,Payne; Christine Anna,0,9,30,30
1683318468489,SOCI 157,A00,258911,Staff,12,0,30,18
1683318469518,SOCI 184,A00,258912,Staff,25,0,30,5
1683318470543,SOCI 188D,A00,258913,Staff,21,0,30,9
1683318471570,SYN 2,001,187529,Staff,9,0,16,7
1683318471570,SYN 2,002,201452,Staff,0,18,16,16
1683318471570,SYN 2,003,201469,Staff,4,0,16,12
1683318472596,SYN 100,A01,187531,Staff,0,9,20,20
1683318472596,SYN 100,B01,201491,Staff,0,12,20,20
1683318473622,TDAC 1,A00,189286,Walsh; Kim C.,3,0,20,17
1683318473622,TDAC 1,B00,189287,Harting; Carla Kelso,11,0,20,9
1683318474646,TDAC 101,A00,189300,Walsh; Kim C.,16,0,20,4
1683318474646,TDAC 101,B00,189301,Harting; Carla Kelso,18,0,20,2
1683318475673,TDAC 102,A00,189304,Basso; Beatrice,14,0,20,6
1683318476696,TDAC 108,A00,189305,Staff,18,0,20,2
1683318477725,TDDE 131,A00,189310,Staff,19,0,20,1
1683318477725,TDDE 131,B00,189314,Staff,19,0,20,1
1683318477725,TDDE 131,C00,189315,Staff,48,0,50,2
1683318477725,TDDE 131,D00,189316,Staff,14,0,15,1
1683318477725,TDDE 131,E00,204841,Staff,20,0,20,0
1683318478748,TDGE 10,A00,189289,Staff,30,0,50,20
1683318478748,TDGE 10,B00,189290,Havis; Allan,2,0,50,48
1683318479777,TDGE 11,A00,189291,Fulton; Julia,0,3,50,50
1683318479777,TDGE 11,B00,189292,Staff,20,0,25,5
1683318479777,TDGE 11,C00,260270,Staff,0,0,0,0
1683318480806,TDGE 25,A00,189294,Staff,3,0,20,17
1683318481836,TDGE 124,A00,189318,Fulton; Julia,0,8,50,50
1683318482865,TDGE 125,A00,189319,Staff,13,0,25,12
1683318482865,TDGE 125,B00,189320,Staff,23,0,25,2
1683318483888,TDGE 127,A00,189322,Havis; Allan,0,0,50,50
1683318484915,TDHT 101,A00,189323,Staff,18,0,25,7
1683318484915,TDHT 101,B00,189324,Staff,25,0,25,0
1683318485940,TDHT 102,A00,189325,Staff,49,0,50,1
1683318486964,TDMV 1,A00,189295,Arcidiacono; Kristin,20,0,30,10
1683318486964,TDMV 1,B00,189296,Caligagan; Maria T.,24,0,30,6
1683318487994,TDMV 2,A00,189297,Sammartano; Tonnie,28,0,30,2
1683318487994,TDMV 2,B00,189299,Arcidiacono; Kristin,24,0,30,6
1683318489019,TDMV 3,A00,204998,Rincon; Alicia,22,0,30,8
1683318490042,TDMV 120,A00,189458,Sammartano; Tonnie,28,0,30,2
1683318491069,TDMV 138,A00,189541,Jun; Grace Shin Hae,22,0,40,18
1683318492093,TDMV 142,A00,189717,Caligagan; Tony,23,0,30,7
1683318492093,TDMV 142,B00,189718,Caligagan; Maria T.,25,0,30,5
1683318493115,TMC 2,A01,187533,Staff,25,0,25,0
1683318493115,TMC 2,A02,187534,Staff,25,0,25,0
1683318494143,USP 1,A01,187536,Kwak; Nancy,0,16,25,25
1683318495167,USP 5,A01,187538,Staff,9,0,25,16
1683318496190,USP 101,A00,199253,Staff,0,4,0,0
1683318497214,USP 124,A00,187562,Boomhower; Matthew Charles,1,0,30,29
1683318498238,USP 138,A00,187582,Staff,20,0,25,5
1683318499263,USP 152,A01,187597,Staff,4,0,25,21
1683318500290,USP 153,A00,187598,Staff,19,0,25,6
1683318501314,USP 168,A00,187607,Kwak; Nancy,2,0,5,3
1683318502338,USP 173,A00,187619,Staff,4,0,25,21
1683318503366,USP 181,A00,187638,Staff,0,0,25,25
1683318504393,VIS 103,A00,187650,Cruz; Edwin Teddy,23,0,75,52
1683318505416,VIS 110D,A00,187669,Staff,12,0,22,10
1683318506440,VIS 127C,A00,187720,Shen; Kuiyi,68,0,146,78
1683318507469,VIS 149,A00,187731,Yoldas; Pinar,0,14,22,22
1683318508496,VIS 151,A01,188091,Staff,22,0,34,12
1683318508496,VIS 151,A02,188092,Staff,11,0,34,23
1683318509520,VIS 160B,A00,188093,Stalbaum; Brett,0,0,10,10
1683318511576,WCWP 10B,A00,201720,Staff,10,0,15,5
1683318511576,WCWP 10B,B00,201722,Staff,8,0,15,7
1683318512600,WCWP 100,A00,201725,Gagnon; Jeffrey C,0,0,2,2
1683318512600,WCWP 100,B00,201727,Staff,0,4,15,15
1683318515704,ANBI 133,A00,258401,Wilder; Linnea Lorene,34,0,40,6
1683318516728,ANBI 140,A00,258395,Hrvoj Mihic; Branka,18,0,25,7
1683318517753,ANSC 120,A00,258402,Bialecki; Jon Anthony,27,0,40,13
1683318518778,ANSC 144,A00,258400,Staff,14,0,40,26
1683318520830,ANSC 166,A00,258396,Parish; Steven Martin,157,0,175,18
1683318521854,ANSC 180,A00,193533,Staff,9,0,20,11
1683318522880,ANSC 188,A00,258397,Jassal; Aftab,33,0,40,7
1683318523907,ANTH 3,A01,258316,Staff,23,0,30,7
1683318524935,ANTH 5,A00,258394,Semendeferi; Ekaterini,16,0,20,4
1683318525962,ANTH 21,A01,258331,Staff,9,0,40,31
1683318526986,ANTH 103,A00,258398,Varma; Saiba,15,0,25,10
1683318528014,AWP 10,001,202034,Staff,0,0,0,0
1683318528014,AWP 10,002,202035,Staff,0,0,0,0
1683318528014,AWP 10,003,202036,Staff,0,0,0,0
1683318528014,AWP 10,004,202037,Staff,0,0,0,0
1683318528014,AWP 10,005,202038,Staff,0,0,0,0
1683318528014,AWP 10,006,202039,Staff,0,0,0,0
1683318528014,AWP 10,007,202040,Staff,0,0,0,0
1683318528014,AWP 10,008,202041,Staff,0,0,0,0
1683318528014,AWP 10,009,202042,Staff,0,0,0,0
1683318528014,AWP 10,010,202043,Staff,0,0,0,0
1683318528014,AWP 10,011,202044,Staff,0,0,0,0
1683318528014,AWP 10,012,202045,Staff,0,0,0,0
1683318528014,AWP 10,013,202046,Staff,0,0,0,0
1683318528014,AWP 10,014,202047,Staff,0,0,0,0
1683318528014,AWP 10,015,202048,Staff,0,0,0,0
1683318528014,AWP 10,016,202049,Staff,0,0,0,0
1683318528014,AWP 10,017,202050,Staff,0,0,0,0
1683318528014,AWP 10,018,202051,Staff,0,0,0,0
1683318528014,AWP 10,019,202052,Staff,0,0,0,0
1683318528014,AWP 10,020,202053,Staff,0,0,0,0
1683318528014,AWP 10,021,202054,Staff,0,0,0,0
1683318528014,AWP 10,022,202055,Staff,0,0,0,0
1683318528014,AWP 10,023,202056,Staff,0,0,0,0
1683318528014,AWP 10,024,202057,Staff,0,0,0,0
1683318528014,AWP 10,025,202058,Staff,0,0,0,0
1683318528014,AWP 10,026,202059,Staff,0,0,0,0
1683318529037,AWP 102,001,202032,Staff,0,0,0,0
1683318529037,AWP 102,002,202033,Staff,0,0,0,0
1683318530065,BENG 100,A01,254234,Taylor Amos; Alyssa C,31,0,40,9
1683318531092,BENG 196,001,270013,Engler; Adam J.,9999,0,9999,0
1683318532119,BICD 100R,A01,202018,Smith; Laurie,0,7,32,32
1683318532119,BICD 100R,A02,202019,Smith; Laurie,0,2,32,32
1683318532119,BICD 100R,A03,202020,Smith; Laurie,0,1,32,32
1683318532119,BICD 100R,A04,202021,Smith; Laurie,8,0,32,24
1683318532119,BICD 100R,A05,202022,Smith; Laurie,12,0,32,20
1683318533148,BICD 136,A01,193242,Gustafson-Brown; Cindy,0,2,32,32
1683318533148,BICD 136,A02,193244,Gustafson-Brown; Cindy,14,0,32,18
1683318534174,BIEB 102,A01,193249,Butler; Shannon Rhey,0,2,32,32
1683318534174,BIEB 102,A02,193251,Butler; Shannon Rhey,0,0,32,32
1683318534174,BIEB 102,A03,193253,Butler; Shannon Rhey,0,1,32,32
1683318534174,BIEB 102,A04,193255,Butler; Shannon Rhey,17,0,32,15
1683318534174,BIEB 102,A05,193265,Butler; Shannon Rhey,26,0,32,6
1683318534174,BIEB 102,A06,193269,Butler; Shannon Rhey,16,0,32,16
1683318536225,BIEB 150,A01,193274,Staff,0,0,32,32
1683318536225,BIEB 150,A02,193285,Staff,23,0,32,9
1683318537252,BIEB 194,A00,193286,Kurle; Carolyn M.,22,0,32,10
1683318538278,BILD 1,A01,192291,Staff,16,0,32,16
1683318538278,BILD 1,A02,192292,Staff,30,0,32,2
1683318538278,BILD 1,B01,192520,Reuther; Keefe,0,1,0,0
1683318538278,BILD 1,B02,192532,Reuther; Keefe,0,1,0,0
1683318539303,BILD 3,A01,192556,Butler; Shannon Rhey,0,0,32,32
1683318539303,BILD 3,A02,192581,Butler; Shannon Rhey,5,0,32,27
1683318539303,BILD 3,A03,192611,Butler; Shannon Rhey,23,0,32,9
1683318539303,BILD 3,A04,192612,Butler; Shannon Rhey,25,0,32,7
1683318539303,BILD 3,A05,192613,Butler; Shannon Rhey,27,0,32,5
1683318539303,BILD 3,A06,192679,Butler; Shannon Rhey,27,0,32,5
1683318539303,BILD 3,A07,192682,Butler; Shannon Rhey,22,0,32,10
1683318540327,BILD 4,A01,192836,Reuther; Keefe,0,0,24,24
1683318540327,BILD 4,A02,193044,Reuther; Keefe,4,0,24,20
1683318541349,BILD 10,A01,193142,Gustafson-Brown; Cindy,30,0,32,2
1683318541349,BILD 10,A02,193149,Gustafson-Brown; Cindy,31,0,32,1
1683318542375,BIMM 100,A01,193301,Staff,0,6,32,32
1683318542375,BIMM 100,A02,193312,Staff,0,5,32,32
1683318542375,BIMM 100,A03,193323,Staff,0,8,32,32
1683318543404,BIMM 101,A01,193329,McDonnell; Lisa Marie,0,3,24,24
1683318543404,BIMM 101,A02,193339,McDonnell; Lisa Marie,0,2,24,24
1683318543404,BIMM 101,B01,193354,McDonnell; Lisa Marie,0,3,24,24
1683318543404,BIMM 101,B02,193357,McDonnell; Lisa Marie,0,3,24,24
1683318544428,BIMM 110,A01,193377,Tat; John,0,11,32,32
1683318544428,BIMM 110,A02,193378,Tat; John,1,9,32,31
1683318545454,BIMM 120,A01,206116,Staff,0,0,32,32
1683318545454,BIMM 120,A02,206117,Staff,8,0,32,24
1683318545454,BIMM 120,A03,206121,Staff,21,0,32,11
1683318546484,BIPN 100,A01,193393,Park; Ji Young,0,14,32,32
1683318546484,BIPN 100,A02,193402,Park; Ji Young,0,12,32,32
1683318546484,BIPN 100,A03,193413,Park; Ji Young,0,14,32,32
1683318546484,BIPN 100,A04,193414,Park; Ji Young,0,13,32,32
1683318547512,BIPN 102,A01,193429,Staff,0,0,32,32
1683318547512,BIPN 102,A02,193438,Staff,22,0,32,10
1683318548540,BIPN 106,A01,193450,Reyes Gonzalez; Catalina,0,2,40,40
1683318549570,BIPN 134,A01,193465,Cooke; James Edward,0,0,32,32
1683318549570,BIPN 134,A02,193474,Cooke; James Edward,27,0,32,5
1683318549570,BIPN 134,A03,193485,Cooke; James Edward,29,0,32,3
1683318549570,BIPN 134,A04,193486,Cooke; James Edward,21,0,32,11
1683318549570,BIPN 134,A05,193491,Cooke; James Edward,31,0,32,1
1683318549570,BIPN 134,A06,193501,Cooke; James Edward,30,0,32,2
1683318549570,BIPN 134,A07,193510,Cooke; James Edward,29,0,32,3
1683318551620,BISP 194,A00,222522,Staff,15,0,32,17
1683318552648,CAT 124,A01,202407,Staff,20,0,25,5
1683318553729,CAT 125,A00,202408,Marchisotto; Jennifer Anne,4,0,20,16
1683318554754,CAT 125R,A00,202409,Smith; Lauryn Alissa,0,11,20,20
1683318554754,CAT 125R,B00,202410,Morales; Celeste Georgianna,0,11,20,20
1683318554754,CAT 125R,C00,202411,Irwin; Matthew Joseph,0,10,20,20
1683318555782,CENG 15,A01,204712,Yang; Kesong,0,1,0,0
1683318556805,CENG 114,A00,202070,Jahed Motlagh; Zeinab,5,0,20,15
1683318557829,CGS 105,A00,185477,Wesling; Megan E.,24,0,40,16
1683318558853,CGS 106,A00,185494,Staff,13,0,22,9
1683318559878,CGS 108,A00,185495,Staff,14,0,20,6
1683318560903,CGS 114,A00,185496,Staff,13,0,18,5
1683318561927,CGS 119,A00,185501,Staff,15,0,20,5
1683318562952,CGS 120,A00,185511,Staff,13,0,20,7
1683318563976,CHEM 4,A01,184675,Bussey; Thomas J,96,0,100,4
1683318565004,CHEM 6A,A01,184677,Staff,34,0,60,26
1683318566031,CHEM 6B,A01,184679,Staff,65,0,100,35
1683318567056,CHEM 6C,A01,184681,Bussey; Thomas J,1,0,50,49
1683318567056,CHEM 6C,A02,184682,Bussey; Thomas J,34,0,50,16
1683318568084,CHEM 40A,A01,184684,Albizati; Kim F.,37,0,100,63
1683318569108,CHEM 40B,A01,184686,Albizati; Kim F.,0,20,100,100
1683318570133,CHEM 41B,A01,184690,Staff,52,0,100,48
1683318571162,COGS 3,A01,184715,Boyle; Mary E. T.,0,25,40,40
1683318572189,COGS 14B,A01,185172,Staff,0,15,38,38
1683318573217,COGS 18,A01,184736,Staff,18,0,80,62
1683318574241,COGS 100,A01,184932,Staff,0,5,73,73
1683318575266,COGS 101A,A01,184935,Staff,0,38,30,30
1683318576291,COGS 101B,A01,184944,Staff,0,2,30,30
1683318577315,COGS 101C,A01,184946,Staff,0,12,30,30
1683318578343,COGS 102A,A01,184951,Johnson; Christine M.,2,0,40,38
1683318579370,COGS 107B,A01,184953,Mooshagian; Eric Frederick,0,50,40,40
1683318580397,COGS 118B,A01,184959,Gupta; Anjum,0,48,40,40
1683318581425,COGS 153,A00,184961,Staff,0,15,30,30
1683318582453,COGS 177,A00,184962,Staff,0,21,30,30
1683318583478,COGS 187A,A01,184969,Boyle; Mary E. T.,0,17,40,40
1683318584503,COMM 10,A01,185174,Staff,0,5,25,25
1683318584503,COMM 10,A02,185189,Staff,0,5,25,25
1683318584503,COMM 10,A03,269821,Staff,0,0,0,0
1683318585531,COMM 100B,A01,185475,Staff,0,0,0,2
1683318585531,COMM 100B,A02,185476,Staff,14,0,25,11
1683318586555,COMM 100C,A01,185314,Staff,1,0,25,24
1683318586555,COMM 100C,A02,185327,Staff,19,0,25,6
1683318587580,COMM 110M,A00,185349,Staff,2,0,40,38
1683318588604,COMM 113T,A00,185352,Staff,25,0,40,15
1683318589631,COMM 114I,A00,185353,Staff,33,0,40,7
1683318590656,COMM 131,A00,185354,Staff,19,0,30,11
1683318591681,CSE 8A,A50,185358,Cao; Yingjun,0,46,10,10
1683318592705,CSE 8B,A01,185362,Staff,1,47,50,49
1683318593733,CSE 11,A01,185416,Cao; Yingjun,0,92,10,10
1683318594756,CSE 20,A01,185445,Briones; Jor-el Thomas Caparas,5,0,25,20
1683318595781,CSE 21,A01,185447,Staff,10,0,50,40
1683318596806,CSE 101,A01,185451,Staff,0,12,50,50
1683318596806,CSE 101,B01,185453,Jones; Miles E,0,11,50,50
1683318598856,CSE 141,A01,185458,Eldon; John,20,0,100,80
1683318599880,CSE 141L,A01,185461,Eldon; John,12,0,100,88
1683318600902,CSE 142,A01,185463,Staff,36,0,60,24
1683318600902,CSE 142,B01,201355,Staff,0,7,60,60
1683318601925,CSE 142L,A01,185470,Staff,36,0,60,24
1683318601925,CSE 142L,B01,201417,Staff,0,6,60,60
1683318602951,CSE 190,A00,201433,Staff,32,0,49,17
1683318603980,DOC 1,A01,259136,Strom; Megan C.,7,0,15,8
1683318603980,DOC 1,A02,259137,Strom; Megan C.,14,0,15,1
1683318603980,DOC 1,A03,259138,Strom; Megan C.,14,0,15,1
1683318603980,DOC 1,A04,259139,Strom; Megan C.,14,0,15,1
1683318605004,DOC 100D,A00,259140,Pass; Natalye Joann,17,0,25,8
1683318606031,DSGN 1,A01,184749,Rill; Bryan,0,25,30,30
1683318607056,DSGN 100,A01,185168,Staff,0,2,25,25
1683318608081,ECE 5,A01,185626,Morris; Karcher William,0,10,0,0
1683318609109,ECE 101,A01,185628,Staff,17,0,70,53
1683318610137,ECE 107,A01,185635,Baghdadchi; Saharnaz,0,0,20,20
1683318610137,ECE 107,A02,185638,Baghdadchi; Saharnaz,4,0,20,16
1683318611173,ECE 148,A01,185647,Silberman; Jack,0,0,16,16
1683318612200,ECON 1,A01,185537,Crane; Meredith Helen,54,0,70,16
1683318613224,ECON 3,A01,185549,Crane; Meredith Helen,33,0,70,37
1683318614256,ECON 4,A01,203354,Anderson; John Charles,0,4,10,10
1683318615285,ECON 100A,A01,185574,Staff,0,4,40,40
1683318616308,ECON 100B,A01,185576,Staff,0,22,40,40
1683318617333,ECON 100C,A01,185589,Newhouse; Herbert S,30,0,70,40
1683318618363,ECON 105,A00,185608,Vespa; Emanuel Ignacio,19,0,35,16
1683318619387,ECON 109,A01,185610,Shishkin; Denis,10,0,35,25
1683318620412,ECON 110A,A01,185612,Staff,11,0,40,29
1683318621439,ECON 120A,A01,185615,Staff,20,0,40,20
1683318622465,ECON 120C,A01,185617,Sun; Yixiao,0,20,70,70
1683318623491,ECON 144,A00,203346,Squires; Dale E,3,0,35,32
1683318624516,ECON 171,A01,203349,Newhouse; Herbert S,0,1,35,35
1683318625541,ECON 173A,A01,185621,Toda; Alexis Akira,21,0,35,14
1683318626569,EDS 25,A01,202413,Staff,0,1,0,0
1683318626569,EDS 25,A02,202414,Staff,0,1,0,0
1683318626569,EDS 25,A03,202415,Staff,0,0,0,0
1683318626569,EDS 25,A04,202416,Staff,0,1,0,0
1683318626569,EDS 25,A05,202439,Staff,0,0,0,0
1683318626569,EDS 25,A06,202440,Staff,0,0,0,0
1683318626569,EDS 25,B01,202631,Staff,0,0,0,0
1683318626569,EDS 25,B02,202632,Staff,0,0,0,0
1683318626569,EDS 25,B03,202639,Staff,0,0,0,0
1683318626569,EDS 25,B04,202640,Staff,0,0,0,0
1683318626569,EDS 25,B05,202643,Staff,0,0,0,0
1683318626569,EDS 25,B06,202644,Staff,0,0,0,0
1683318627592,EDS 38,A01,202659,Black; Alison Michelle,24,0,25,1
1683318628619,EDS 115,A00,202652,Staff,17,0,30,13
1683318629643,EDS 125,A00,202649,Staff,14,0,30,16
1683318630667,EDS 126,A01,203332,Staff,30,0,30,0
1683318631693,EDS 139,A00,202838,Staff,16,0,25,9
1683318632717,EDS 146,A01,202655,Staff,14,0,25,11
1683318633739,ENG 15,A00,185667,Staff,0,1,0,0
1683318633739,ENG 15,B00,185672,Staff,0,0,0,0
1683318633739,ENG 15,C00,185675,Staff,0,0,0,0
1683318633739,ENG 15,D00,185682,Staff,0,0,0,0
1683318633739,ENG 15,E00,185684,Staff,0,0,0,0
1683318634764,ETHN 103,A00,185710,Staff,0,3,35,35
1683318635791,ETHN 103A,A00,199228,Man; Simeon S,2,0,9,7
1683318636818,ETHN 109,A00,185711,Staff,18,0,35,17
1683318637841,ETHN 142,A00,185726,Staff,0,4,30,30
1683318638868,ETHN 163J,A00,199229,Man; Simeon S,5,0,8,3
1683318639890,ETHN 168,A00,185727,Staff,8,0,10,2
1683318640917,ETHN 182,A00,185728,Staff,1,0,35,34
1683318641940,ETHN 183,A00,185737,Staff,8,0,18,10
1683318642968,GLBH 111,A01,209361,Burgos; Jose L.,0,0,0,0
1683318645019,HIEU 104,A00,185792,Staff,16,0,20,4
1683318646043,HIEU 115,A00,185800,Staff,1,0,20,19
1683318647070,HIEU 128,A00,185801,Staff,0,7,20,20
1683318648093,HIEU 147,A00,185802,Staff,16,0,20,4
1683318649116,HIEU 154,A00,185823,Staff,12,0,20,8
1683318650141,HILA 102,A00,185826,Staff,13,0,20,7
1683318651168,HILD 2C,A01,185778,Staff,0,12,20,20
1683318652192,HILD 7B,A01,185780,Kwak; Nancy,0,15,32,32
1683318652192,HILD 7B,A02,185781,Kwak; Nancy,0,18,32,32
1683318653219,HILD 30,A01,185791,Staff,14,0,20,6
1683318654243,HISC 119,A00,185830,Golan; Tal,0,9,20,20
1683318655267,HITO 156GS,A00,185831,Patterson; Patrick H.,0,0,0,23
1683318656293,HIUS 103,A00,185832,Man; Simeon S,0,6,20,20
1683318657376,HIUS 117,A00,185836,Kwak; Nancy,2,0,20,18
1683318658402,HIUS 125,A00,185840,Man; Simeon S,0,0,23,23
1683318659427,HIUS 149,A00,185845,Staff,0,0,20,20
1683318660452,HUM 3,A01,185882,Zavodny; Tatiana Sophia,0,6,50,50
1683318660452,HUM 3,B01,185899,Caldwell; Michael Alan,0,19,50,50
1683318661478,HUM 3GS,A00,185900,Patterson; Patrick H.,0,0,0,23
1683318662506,HUM 4,A01,185938,Zroka; Amy Liane,31,0,50,19
1683318662506,HUM 4,B01,185956,Watkins; Eric,0,2,50,50
1683318662506,HUM 4,B02,202209,Watkins; Eric,0,2,50,50
1683318662506,HUM 4,B03,202210,Watkins; Eric,0,0,50,50
1683318663535,HUM 5,A01,185958,West; Geoffrey Scott,4,0,50,46
1683318663535,HUM 5,A02,202215,West; Geoffrey Scott,0,0,50,50
1683318664559,INTL 190,A00,185959,Gagnon; Jeffrey C,0,0,0,9
1683318664559,INTL 190,B00,185960,Lettieri; Michael Joseph,0,0,0,1
1683318665587,JAPN 180,A00,254509,Staff,5,1,30,25
1683318666613,LATI 10,A01,202853,Kennemore; Amy Michelle,5,0,35,30
1683318666613,LATI 10,A02,202854,Kennemore; Amy Michelle,1,0,35,34
1683318666613,LATI 10,A03,270054,Kennemore; Amy Michelle,30,0,30,0
1683318667639,LATI 180,A00,202855,Kennemore; Amy Michelle,11,0,20,9
1683318668664,LAWS 101,A00,201767,Golan; Tal,0,7,40,40
1683318669691,LIFR 1C,A00,185961,Staff,6,0,20,14
1683318670719,LIFR 1CX,A00,185962,Staff,7,0,20,13
1683318671743,LIFR 1D,A00,185963,Staff,9,0,20,11
1683318672771,LIFR 1DX,A00,185964,Staff,9,0,20,11
1683318673796,LIGN 101,A01,186039,Staff,43,0,50,7
1683318674821,LIGN 165,A00,186040,Staff,18,0,50,32
1683318675848,LTCS 108,A00,186041,Staff,6,0,10,4
1683318676873,LTCS 119,A00,186042,Staff,16,0,20,4
1683318677900,LTCS 130,A00,186043,Wesling; Megan E.,15,0,25,10
1683318679951,LTEA 138,A00,186119,Staff,14,0,40,26
1683318680975,LTEN 124,A00,186148,Staff,6,0,25,19
1683318682005,LTEN 178,A00,186149,Staff,7,0,15,8
1683318683029,LTEN 181,A00,186150,Blanco; John D,33,0,40,7
1683318684059,LTWL 120,A00,186160,Staff,20,0,25,5
1683318685085,LTWL 165,A00,186161,Staff,22,0,25,3
1683318686112,LTWR 100,A00,186162,Staff,0,4,15,15
1683318687139,LTWR 102,A00,186163,Doller; Ben,5,0,15,10
1683318688163,MAE 8,A01,186412,Staff,0,0,0,0
1683318689190,MAE 30B,A00,186445,Bahadori; Mohammad Yousef,83,0,100,17
1683318690213,MAE 40,A00,186592,Bewley; Thomas R,9,0,50,41
1683318691235,MAE 101B,A00,186593,Bahadori; Mohammad Yousef,81,0,100,19
1683318692262,MAE 105,A00,186594,Bandaru; Prabhakar,12,0,50,38
1683318693290,MAE 107,A00,186599,Pham; Hieu Tan,0,6,120,120
1683318694314,MAE 148,A01,186660,Silberman; Jack,3,0,16,13
1683318695343,MATH 10A,A01,188095,Staff,0,6,35,35
1683318696369,MATH 10B,A01,188097,Bowers; Adam R.,0,11,30,30
1683318696369,MATH 10B,A02,188099,Bowers; Adam R.,0,11,30,30
1683318696369,MATH 10B,B01,188104,Bowers; Adam R.,0,10,30,30
1683318696369,MATH 10B,B02,188106,Bowers; Adam R.,0,10,30,30
1683318697393,MATH 10C,A01,188111,Staff,0,18,30,30
1683318697393,MATH 10C,A02,188127,Staff,0,17,30,30
1683318697393,MATH 10C,A03,188131,Staff,0,18,30,30
1683318697393,MATH 10C,B01,188218,Staff,19,0,30,11
1683318697393,MATH 10C,B02,188244,Staff,13,0,30,17
1683318697393,MATH 10C,B03,188277,Staff,16,0,30,14
1683318698418,MATH 18,A01,188344,Bach; Quang Tran,18,0,30,12
1683318698418,MATH 18,A02,188345,Bach; Quang Tran,11,0,30,19
1683318698418,MATH 18,B01,188353,Bach; Quang Tran,10,0,30,20
1683318698418,MATH 18,B02,188354,Bach; Quang Tran,20,0,30,10
1683318699443,MATH 20A,A01,188374,Staff,13,0,35,22
1683318700472,MATH 20B,A01,188382,Ohm; Ko Woon,6,0,30,24
1683318700472,MATH 20B,A02,188383,Ohm; Ko Woon,23,0,30,7
1683318700472,MATH 20B,B01,188385,Ohm; Ko Woon,7,0,30,23
1683318700472,MATH 20B,B02,188392,Ohm; Ko Woon,22,0,30,8
1683318701497,MATH 20C,A01,188394,Harel; Guershon,10,0,30,20
1683318701497,MATH 20C,A02,188395,Harel; Guershon,14,0,30,16
1683318701497,MATH 20C,B01,188404,Harel; Guershon,5,0,30,25
1683318701497,MATH 20C,B02,188405,Harel; Guershon,19,0,30,11
1683318702526,MATH 20D,A01,188414,Hammock; Frances H,0,1,30,30
1683318702526,MATH 20D,A02,188415,Hammock; Frances H,3,0,30,27
1683318702526,MATH 20D,B01,188447,Hammock; Frances H,2,0,30,28
1683318702526,MATH 20D,B02,188486,Hammock; Frances H,8,0,30,22
1683318703551,MATH 20E,A01,188649,Staff,21,0,30,9
1683318703551,MATH 20E,A02,188650,Staff,23,0,30,7
1683318703551,MATH 20E,A03,188673,Staff,0,0,30,30
1683318704579,MATH 102,A01,188675,Staff,0,35,35,35
1683318705606,MATH 103B,A01,188681,Staff,4,0,35,31
1683318705606,MATH 103B,B01,188692,Staff,5,0,35,30
1683318706631,MATH 109,A01,188695,Salehi Golsefidy; Alireza,25,0,35,10
1683318706631,MATH 109,A02,188696,Salehi Golsefidy; Alireza,26,0,35,9
1683318707655,MATH 120A,A01,188698,Eggers; John Dietrich,7,0,35,28
1683318708680,MATH 142B,A01,188736,Ioana; Adrian,0,2,30,30
1683318708680,MATH 142B,A02,188741,Ioana; Adrian,0,1,30,30
1683318708680,MATH 142B,A03,188743,Ioana; Adrian,1,3,30,29
1683318709705,MATH 168A,A01,188790,Staff,0,9,35,35
1683318710729,MATH 170A,A01,188803,Nie; Jiawang,0,2,35,35
1683318710729,MATH 170A,A02,188811,Nie; Jiawang,0,0,35,35
1683318710729,MATH 170A,A03,188814,Nie; Jiawang,0,0,35,35
1683318710729,MATH 170A,A04,188815,Nie; Jiawang,13,0,35,22
1683318711754,MATH 193B,A01,188817,Staff,0,0,35,35
1683318711754,MATH 193B,A02,188818,Staff,6,0,35,29
1683318712779,MGT 4,A01,202857,Anderson; John Charles,62,0,80,18
1683318713802,MGT 12,A00,202858,Lindenberger; Wade Douglas,43,0,90,47
1683318714827,MGT 18,A00,202859,Staff,74,0,90,16
1683318715852,MGT 18GS,A00,202860,McKay; Michael J,13,0,28,15
1683318716881,MGT 45,A00,202861,Pecore; Joseph P.,13,0,90,77
1683318717906,MGT 100,A00,202863,Yavorsky; Daniel Ryan,28,0,90,62
1683318718935,MGT 103,A00,202864,Ehrich; Kristine R,0,17,90,90
1683318719959,MGT 112,A00,202865,Ehrich; Kristine R,15,0,90,75
1683318720987,MGT 121A,A00,202868,Staff,0,19,0,0
1683318722011,MGT 131B,A00,202869,Anderson; John Charles,59,0,90,31
1683318723036,MGT 136,A00,202871,Lindenberger; Wade Douglas,84,0,90,6
1683318724066,MGT 164,A00,202873,Staff,0,68,90,91
1683318725092,MGT 164GS,A00,202874,McKay; Mary A,13,0,28,15
1683318726120,MGT 180,A00,202875,Staff,0,50,90,91
1683318727146,MMW 11R,A01,205019,Herbst; Matthew,3,0,30,27
1683318727146,MMW 11R,A02,205026,Herbst; Matthew,29,0,30,1
1683318728169,MMW 15,A01,193512,Chang; Edmond Yi-Teh,0,9,28,28
1683318728169,MMW 15,A02,193513,Chang; Edmond Yi-Teh,0,5,28,28
1683318728169,MMW 15,A03,193514,Chang; Edmond Yi-Teh,0,5,28,28
1683318728169,MMW 15,A04,193515,Chang; Edmond Yi-Teh,0,5,28,28
1683318728169,MMW 15,A05,193516,Chang; Edmond Yi-Teh,0,4,28,28
1683318728169,MMW 15,A06,193517,Chang; Edmond Yi-Teh,0,5,28,28
1683318728169,MMW 15,B01,193519,Chang; Edmond Yi-Teh,0,4,28,28
1683318728169,MMW 15,B02,193520,Chang; Edmond Yi-Teh,0,5,28,28
1683318728169,MMW 15,B03,193521,Chang; Edmond Yi-Teh,0,4,28,28
1683318728169,MMW 15,B04,193522,Chang; Edmond Yi-Teh,0,4,28,28
1683318728169,MMW 15,B05,193523,Chang; Edmond Yi-Teh,0,5,28,28
1683318728169,MMW 15,B06,193524,Chang; Edmond Yi-Teh,0,4,28,28
1683318729194,MMW 122,A01,193526,Rahimi; Babak,0,14,28,28
1683318729194,MMW 122,A02,193527,Rahimi; Babak,0,14,28,28
1683318729194,MMW 122,A03,193528,Rahimi; Babak,0,0,0,0
1683318729194,MMW 122,A04,193529,Rahimi; Babak,0,0,0,0
1683318730217,MUS 1A,A01,186663,Staff,0,20,35,35
1683318731244,MUS 4,A01,186715,Staff,0,12,35,35
1683318732269,MUS 5R,A01,186796,Dubnov; Shlomo,0,17,35,35
1683318733292,MUS 6,A01,186798,Staff,0,3,25,25
1683318734322,MUS 7,A01,186830,Staff,12,0,35,23
1683318735347,MUS 8,A01,186930,Staff,0,26,35,35
1683318736372,MUS 15,A01,186932,Staff,0,15,35,35
1683318736372,MUS 15,B01,186934,Staff,0,15,35,35
1683318737401,MUS 80,A00,186935,Staff,2,0,20,18
1683318737401,MUS 80,B00,186936,Staff,25,0,25,0
1683318738425,NANO 11,A00,204702,Lipomi; Darren John,0,0,0,0
1683318739453,NANO 15,A01,204709,Yang; Kesong,0,1,0,0
1683318740481,NANO 114,A00,202069,Jahed Motlagh; Zeinab,3,0,10,7
1683318741508,PHIL 1,A00,186955,Grush; Rick Scott,32,0,40,8
1683318742536,PHIL 10,A01,186973,Grush; Rick Scott,28,0,35,7
1683318742536,PHIL 10,A02,186974,Grush; Rick Scott,33,0,35,2
1683318743569,PHIL 13,A01,186976,Staff,7,0,35,28
1683318743569,PHIL 13,A02,186977,Staff,16,0,35,19
1683318744594,PHIL 14,A01,186979,Staff,31,0,35,4
1683318744594,PHIL 14,A02,186986,Staff,32,0,35,3
1683318745622,PHIL 28,A01,186988,Staff,16,0,30,14
1683318745622,PHIL 28,A02,186989,Staff,1,0,30,29
1683318745622,PHIL 28,A03,186990,Staff,9,0,30,21
1683318745622,PHIL 28,A04,186991,Staff,26,0,30,4
1683318746646,PHIL 120,A00,186997,Staff,23,0,40,17
1683318747671,PHIL 137,A00,187003,Staff,9,0,40,31
1683318748696,PHIL 150,A00,187015,Staff,47,0,70,23
1683318749720,PHIL 167,A00,187021,Lamey; Andy M.,35,0,40,5
1683318750746,PHIL 174,A01,202226,Staff,17,0,20,3
1683318750746,PHIL 174,A02,202235,Staff,20,0,20,0
1683318751774,PHIL 191A,A00,258918,Staff,0,0,1,1
1683318752802,PHYS 1A,A00,187028,Staff,27,0,60,33
1683318753830,PHYS 1AL,001,187036,Staff,3,0,30,27
1683318753830,PHYS 1AL,002,187049,Staff,18,0,30,12
1683318754855,PHYS 1B,A00,187058,Staff,22,0,60,38
1683318755883,PHYS 1BL,001,187064,Staff,0,0,30,30
1683318755883,PHYS 1BL,002,187070,Staff,5,0,30,25
1683318756909,PHYS 1C,A00,187082,Staff,31,0,120,89
1683318757934,PHYS 1CL,001,187088,Staff,0,9,30,30
1683318757934,PHYS 1CL,002,187089,Staff,0,2,30,30
1683318757934,PHYS 1CL,009,262693,Staff,11,0,30,19
1683318758959,PHYS 2B,A01,187097,Staff,54,0,115,61
1683318759987,PHYS 2C,A01,187099,Staff,67,0,115,48
1683318761072,PHYS 2CL,A01,187101,Staff,5,0,28,23
1683318761072,PHYS 2CL,A02,187102,Staff,15,0,28,13
1683318762097,PHYS 2D,A01,187123,Shotwell; Brian,95,0,115,20
1683318763120,PHYS 4B,A01,187133,Grinstein; Benjamin,35,0,50,15
1683318764148,POLI 10,A00,188819,Staff,0,4,50,50
1683318765172,POLI 11,A00,188827,Staff,43,0,50,7
1683318766196,POLI 13R,A00,188828,Staff,0,1,20,20
1683318767221,POLI 27,A01,188830,Elgin; Samuel Zincke,0,1,70,70
1683318768247,POLI 30,A00,188832,Desposato; Scott,31,0,50,19
1683318769273,POLI 102F,A00,188834,Staff,3,0,40,37
1683318770300,POLI 104A,A00,188852,Staff,14,0,30,16
1683318771325,POLI 104I,A00,188853,Staff,0,6,20,20
1683318772352,POLI 110B,A00,188854,Wiens; David,7,0,20,13
1683318773379,POLI 112A,A00,188855,Wiens; David,5,0,30,25
1683318774403,POLI 117R,A00,188856,Forman; Fonna,0,11,20,20
1683318775425,POLI 118,A00,188857,Ingham; Sean,8,0,20,12
1683318776450,POLI 120G,A00,188858,Staff,9,0,30,21
1683318777473,POLI 131CR,A00,188863,Hoston; Germaine,24,0,50,26
1683318778496,POLI 133,A00,188864,Nellis; Gareth Hb,44,0,50,6
1683318779521,POLI 134D,A00,188865,Desposato; Scott,27,0,30,3
1683318780546,POLI 142A,A00,188871,Gartzke; Erik,22,0,50,28
1683318781569,POLI 142K,A00,188874,Staff,38,0,50,12
1683318782596,POLI 143,A00,188940,Gartzke; Erik,16,0,30,14
1683318783621,POLI 153,A00,188943,Staff,3,0,20,17
1683318784648,POLI 160AA,A00,188944,Staff,12,0,40,28
1683318785675,POLI 170A,A00,188945,Staff,11,0,30,19
1683318787735,PSYC 1,A00,188952,Staff,37,0,90,53
1683318788766,PSYC 2,B00,188953,Staff,19,0,35,16
1683318789794,PSYC 6,A00,188970,Staff,47,0,60,13
1683318790817,PSYC 7,A00,188973,Staff,37,0,45,8
1683318791842,PSYC 60,A01,188980,Rickard; Timothy C.,43,0,60,17
1683318792870,PSYC 70,A01,189001,Steiner; Eric Tomas,24,0,45,21
1683318793894,PSYC 100,A00,189005,Lacefield; Katharine I,0,99,120,120
1683318794918,PSYC 102,A00,189008,Staff,10,0,30,20
1683318795946,PSYC 106,B00,189026,Gorman; Michael R.,36,0,60,24
1683318796973,PSYC 114,B01,189033,Winkielman; Piotr,0,32,30,30
1683318797999,PSYC 131,A00,189036,Anagnostaras; Stephan,0,43,60,60
1683318799025,PSYC 136,A00,189041,Lowe; Angela Beth,0,7,25,25
1683318800051,PSYC 137,A00,189057,Winkielman; Piotr,0,34,25,25
1683318801076,PSYC 144,A00,189107,Wixted; John T,0,7,50,50
1683318803135,PSYC 162,A00,189142,Staff,0,8,85,85
1683318804158,PSYC 172,A00,189144,Gorman; Michael R.,0,7,30,30
1683318806203,PSYC 179,A00,189146,Lacefield; Katharine I,0,84,120,120
1683318807228,PSYC 181,A00,189147,Anagnostaras; Stephan,0,44,90,90
1683318808252,PSYC 190R,A00,189148,Barner; David A.,0,22,80,80
1683318809277,PSYC 191,A00,189275,Rickard; Timothy C.,0,7,25,25
1683318810306,PSYC 193,A00,189276,Chapman; Eddie Nathaniel,0,1,0,4
1683318811334,PSYC 193L,A01,189281,Lowe; Angela Beth,12,0,20,8
1683318811334,PSYC 193L,B01,189285,Staff,28,0,35,7
1683318812357,RELI 149,A00,187137,Rahimi; Babak,7,0,40,33
1683318813384,SE 9,A01,187315,Staff,0,2,18,18
1683318814407,SE 101B,A00,187409,Staff,24,0,30,6
1683318815432,SE 110B,A00,187444,Staff,10,0,40,30
1683318816459,SE 130B,A00,187449,Staff,31,0,40,9
1683318817483,SE 150A,A00,187516,Staff,9,0,20,11
1683318818511,SE 154,A00,187528,Staff,30,0,50,20
1683318819535,SIO 3,A01,258171,Staff,35,0,40,5
1683318820559,SIO 10,A00,187144,Cook; Geoffrey W,0,3,75,75
1683318821583,SIO 45,A00,187152,Cook; Geoffrey W,1,0,100,99
1683318822607,SIO 109R,A00,194486,Staff,0,3,20,20
1683318824658,SIO 187,A01,187233,Kacev; David,12,0,40,28
1683318825682,SOCI 1,A01,258656,Thorpe; Charles Robert,28,0,30,2
1683318825682,SOCI 1,A02,258658,Thorpe; Charles Robert,30,0,30,0
1683318825682,SOCI 1,A03,258661,Thorpe; Charles Robert,25,0,25,0
1683318825682,SOCI 1,A04,258666,Thorpe; Charles Robert,22,0,25,3
1683318825682,SOCI 1,A05,258897,Thorpe; Charles Robert,23,0,25,2
1683318825682,SOCI 1,A06,258898,Thorpe; Charles Robert,25,0,25,0
1683318826709,SOCI 30,A01,258903,Pardo Guerra; Juan Pablo,16,0,30,14
1683318827738,SOCI 102,A00,258904,Staff,9,0,25,16
1683318828761,SOCI 106,A00,258905,Staff,19,0,25,6
1683318829788,SOCI 111,A00,258907,Ribas Norris; Janet Vanesa,26,0,30,4
1683318830814,SOCI 121R,A00,258908,Pardo Guerra; Juan Pablo,11,0,30,19
1683318831838,SOCI 126,A01,203330,Staff,14,0,20,6
1683318832862,SOCI 131,A00,258909,Thorpe; Charles Robert,31,0,60,29
1683318833885,SOCI 135,A00,258910,Payne; Christine Anna,0,9,30,30
1683318834911,SOCI 157,A00,258911,Staff,12,0,30,18
1683318835939,SOCI 184,A00,258912,Staff,25,0,30,5
1683318836963,SOCI 188D,A00,258913,Staff,21,0,30,9
1683318837992,SYN 2,001,187529,Staff,9,0,16,7
1683318837992,SYN 2,002,201452,Staff,0,18,16,16
1683318837992,SYN 2,003,201469,Staff,4,0,16,12
1683318839016,SYN 100,A01,187531,Staff,0,9,20,20
1683318839016,SYN 100,B01,201491,Staff,0,12,20,20
1683318840047,TDAC 1,A00,189286,Walsh; Kim C.,3,0,20,17
1683318840047,TDAC 1,B00,189287,Harting; Carla Kelso,11,0,20,9
1683318841074,TDAC 101,A00,189300,Walsh; Kim C.,16,0,20,4
1683318841074,TDAC 101,B00,189301,Harting; Carla Kelso,18,0,20,2
1683318842098,TDAC 102,A00,189304,Basso; Beatrice,14,0,20,6
1683318843121,TDAC 108,A00,189305,Staff,18,0,20,2
1683318844154,TDDE 131,A00,189310,Staff,19,0,20,1
1683318844154,TDDE 131,B00,189314,Staff,19,0,20,1
1683318844154,TDDE 131,C00,189315,Staff,48,0,50,2
1683318844154,TDDE 131,D00,189316,Staff,14,0,15,1
1683318844154,TDDE 131,E00,204841,Staff,20,0,20,0
1683318845181,TDGE 10,A00,189289,Staff,30,0,50,20
1683318845181,TDGE 10,B00,189290,Havis; Allan,2,0,50,48
1683318846210,TDGE 11,A00,189291,Fulton; Julia,0,3,50,50
1683318846210,TDGE 11,B00,189292,Staff,20,0,25,5
1683318846210,TDGE 11,C00,260270,Staff,0,0,0,0
1683318847233,TDGE 25,A00,189294,Staff,3,0,20,17
1683318848260,TDGE 124,A00,189318,Fulton; Julia,0,8,50,50
1683318849285,TDGE 125,A00,189319,Staff,13,0,25,12
1683318849285,TDGE 125,B00,189320,Staff,23,0,25,2
1683318850310,TDGE 127,A00,189322,Havis; Allan,0,0,50,50
1683318851335,TDHT 101,A00,189323,Staff,18,0,25,7
1683318851335,TDHT 101,B00,189324,Staff,25,0,25,0
1683318852359,TDHT 102,A00,189325,Staff,49,0,50,1
1683318853387,TDMV 1,A00,189295,Arcidiacono; Kristin,20,0,30,10
1683318853387,TDMV 1,B00,189296,Caligagan; Maria T.,24,0,30,6
1683318854412,TDMV 2,A00,189297,Sammartano; Tonnie,28,0,30,2
1683318854412,TDMV 2,B00,189299,Arcidiacono; Kristin,24,0,30,6
1683318855435,TDMV 3,A00,204998,Rincon; Alicia,22,0,30,8
1683318856461,TDMV 120,A00,189458,Sammartano; Tonnie,28,0,30,2
1683318857489,TDMV 138,A00,189541,Jun; Grace Shin Hae,22,0,40,18
1683318858514,TDMV 142,A00,189717,Caligagan; Tony,23,0,30,7
1683318858514,TDMV 142,B00,189718,Caligagan; Maria T.,25,0,30,5
1683318859538,TMC 2,A01,187533,Staff,25,0,25,0
1683318859538,TMC 2,A02,187534,Staff,25,0,25,0
1683318860561,USP 1,A01,187536,Kwak; Nancy,0,16,25,25
1683318861585,USP 5,A01,187538,Staff,9,0,25,16
1683318862610,USP 101,A00,199253,Staff,0,4,0,0
1683318863637,USP 124,A00,187562,Boomhower; Matthew Charles,1,0,30,29
1683318864723,USP 138,A00,187582,Staff,20,0,25,5
1683318865750,USP 152,A01,187597,Staff,4,0,25,21
1683318866777,USP 153,A00,187598,Staff,19,0,25,6
1683318867804,USP 168,A00,187607,Kwak; Nancy,2,0,5,3
1683318868833,USP 173,A00,187619,Staff,4,0,25,21
1683318869857,USP 181,A00,187638,Staff,0,0,25,25
1683318870882,VIS 103,A00,187650,Cruz; Edwin Teddy,23,0,75,52
1683318871911,VIS 110D,A00,187669,Staff,12,0,22,10
1683318872939,VIS 127C,A00,187720,Shen; Kuiyi,68,0,146,78
1683318873966,VIS 149,A00,187731,Yoldas; Pinar,0,14,22,22
1683318874990,VIS 151,A01,188091,Staff,22,0,34,12
1683318874990,VIS 151,A02,188092,Staff,11,0,34,23
1683318876019,VIS 160B,A00,188093,Stalbaum; Brett,0,0,10,10
1683318878072,WCWP 10B,A00,201720,Staff,10,0,15,5
1683318878072,WCWP 10B,B00,201722,Staff,8,0,15,7
1683318879098,WCWP 100,A00,201725,Gagnon; Jeffrey C,0,0,2,2
1683318879098,WCWP 100,B00,201727,Staff,0,4,15,15
1683318882192,ANBI 133,A00,258401,Wilder; Linnea Lorene,34,0,40,6
1683318883216,ANBI 140,A00,258395,Hrvoj Mihic; Branka,18,0,25,7
1683318884243,ANSC 120,A00,258402,Bialecki; Jon Anthony,27,0,40,13
1683318885267,ANSC 144,A00,258400,Staff,14,0,40,26
1683318887319,ANSC 166,A00,258396,Parish; Steven Martin,157,0,175,18
1683318888347,ANSC 180,A00,193533,Staff,9,0,20,11
1683318889373,ANSC 188,A00,258397,Jassal; Aftab,33,0,40,7
1683318890398,ANTH 3,A01,258316,Staff,23,0,30,7
1683318891423,ANTH 5,A00,258394,Semendeferi; Ekaterini,16,0,20,4
1683318892445,ANTH 21,A01,258331,Staff,9,0,40,31
1683318893471,ANTH 103,A00,258398,Varma; Saiba,15,0,25,10
1683318894502,AWP 10,001,202034,Staff,0,0,0,0
1683318894502,AWP 10,002,202035,Staff,0,0,0,0
1683318894502,AWP 10,003,202036,Staff,0,0,0,0
1683318894502,AWP 10,004,202037,Staff,0,0,0,0
1683318894502,AWP 10,005,202038,Staff,0,0,0,0
1683318894502,AWP 10,006,202039,Staff,0,0,0,0
1683318894502,AWP 10,007,202040,Staff,0,0,0,0
1683318894502,AWP 10,008,202041,Staff,0,0,0,0
1683318894502,AWP 10,009,202042,Staff,0,0,0,0
1683318894502,AWP 10,010,202043,Staff,0,0,0,0
1683318894502,AWP 10,011,202044,Staff,0,0,0,0
1683318894502,AWP 10,012,202045,Staff,0,0,0,0
1683318894502,AWP 10,013,202046,Staff,0,0,0,0
1683318894502,AWP 10,014,202047,Staff,0,0,0,0
1683318894502,AWP 10,015,202048,Staff,0,0,0,0
1683318894502,AWP 10,016,202049,Staff,0,0,0,0
1683318894502,AWP 10,017,202050,Staff,0,0,0,0
1683318894502,AWP 10,018,202051,Staff,0,0,0,0
1683318894502,AWP 10,019,202052,Staff,0,0,0,0
1683318894502,AWP 10,020,202053,Staff,0,0,0,0
1683318894502,AWP 10,021,202054,Staff,0,0,0,0
1683318894502,AWP 10,022,202055,Staff,0,0,0,0
1683318894502,AWP 10,023,202056,Staff,0,0,0,0
1683318894502,AWP 10,024,202057,Staff,0,0,0,0
1683318894502,AWP 10,025,202058,Staff,0,0,0,0
1683318894502,AWP 10,026,202059,Staff,0,0,0,0
1683318895527,AWP 102,001,202032,Staff,0,0,0,0
1683318895527,AWP 102,002,202033,Staff,0,0,0,0
1683318896551,BENG 100,A01,254234,Taylor Amos; Alyssa C,31,0,40,9
1683318897576,BENG 196,001,270013,Engler; Adam J.,9999,0,9999,0
1683318898608,BICD 100R,A01,202018,Smith; Laurie,0,7,32,32
1683318898608,BICD 100R,A02,202019,Smith; Laurie,0,2,32,32
1683318898608,BICD 100R,A03,202020,Smith; Laurie,0,1,32,32
1683318898608,BICD 100R,A04,202021,Smith; Laurie,8,0,32,24
1683318898608,BICD 100R,A05,202022,Smith; Laurie,12,0,32,20
1683318899632,BICD 136,A01,193242,Gustafson-Brown; Cindy,0,2,32,32
1683318899632,BICD 136,A02,193244,Gustafson-Brown; Cindy,14,0,32,18
1683318900662,BIEB 102,A01,193249,Butler; Shannon Rhey,0,2,32,32
1683318900662,BIEB 102,A02,193251,Butler; Shannon Rhey,0,0,32,32
1683318900662,BIEB 102,A03,193253,Butler; Shannon Rhey,0,1,32,32
1683318900662,BIEB 102,A04,193255,Butler; Shannon Rhey,17,0,32,15
1683318900662,BIEB 102,A05,193265,Butler; Shannon Rhey,26,0,32,6
1683318900662,BIEB 102,A06,193269,Butler; Shannon Rhey,16,0,32,16
1683318902709,BIEB 150,A01,193274,Staff,0,0,32,32
1683318902709,BIEB 150,A02,193285,Staff,23,0,32,9
1683318903737,BIEB 194,A00,193286,Kurle; Carolyn M.,22,0,32,10
1683318904762,BILD 1,A01,192291,Staff,16,0,32,16
1683318904762,BILD 1,A02,192292,Staff,30,0,32,2
1683318904762,BILD 1,B01,192520,Reuther; Keefe,0,1,0,0
1683318904762,BILD 1,B02,192532,Reuther; Keefe,0,1,0,0
1683318905794,BILD 3,A01,192556,Butler; Shannon Rhey,0,0,32,32
1683318905794,BILD 3,A02,192581,Butler; Shannon Rhey,5,0,32,27
1683318905794,BILD 3,A03,192611,Butler; Shannon Rhey,23,0,32,9
1683318905794,BILD 3,A04,192612,Butler; Shannon Rhey,25,0,32,7
1683318905794,BILD 3,A05,192613,Butler; Shannon Rhey,27,0,32,5
1683318905794,BILD 3,A06,192679,Butler; Shannon Rhey,27,0,32,5
1683318905794,BILD 3,A07,192682,Butler; Shannon Rhey,22,0,32,10
1683318906822,BILD 4,A01,192836,Reuther; Keefe,0,0,24,24
1683318906822,BILD 4,A02,193044,Reuther; Keefe,4,0,24,20
1683318907844,BILD 10,A01,193142,Gustafson-Brown; Cindy,30,0,32,2
1683318907844,BILD 10,A02,193149,Gustafson-Brown; Cindy,31,0,32,1
1683318908873,BIMM 100,A01,193301,Staff,0,6,32,32
1683318908873,BIMM 100,A02,193312,Staff,0,5,32,32
1683318908873,BIMM 100,A03,193323,Staff,0,8,32,32
1683318909897,BIMM 101,A01,193329,McDonnell; Lisa Marie,0,3,24,24
1683318909897,BIMM 101,A02,193339,McDonnell; Lisa Marie,0,3,24,24
1683318909897,BIMM 101,B01,193354,McDonnell; Lisa Marie,0,3,24,24
1683318909897,BIMM 101,B02,193357,McDonnell; Lisa Marie,0,3,24,24
1683318910921,BIMM 110,A01,193377,Tat; John,0,11,32,32
1683318910921,BIMM 110,A02,193378,Tat; John,1,9,32,31
1683318911949,BIMM 120,A01,206116,Staff,0,0,32,32
1683318911949,BIMM 120,A02,206117,Staff,8,0,32,24
1683318911949,BIMM 120,A03,206121,Staff,21,0,32,11
1683318912979,BIPN 100,A01,193393,Park; Ji Young,0,14,32,32
1683318912979,BIPN 100,A02,193402,Park; Ji Young,0,12,32,32
1683318912979,BIPN 100,A03,193413,Park; Ji Young,0,14,32,32
1683318912979,BIPN 100,A04,193414,Park; Ji Young,0,13,32,32
1683318914003,BIPN 102,A01,193429,Staff,0,0,32,32
1683318914003,BIPN 102,A02,193438,Staff,22,0,32,10
1683318915028,BIPN 106,A01,193450,Reyes Gonzalez; Catalina,0,2,40,40
1683318916052,BIPN 134,A01,193465,Cooke; James Edward,0,0,32,32
1683318916052,BIPN 134,A02,193474,Cooke; James Edward,27,0,32,5
1683318916052,BIPN 134,A03,193485,Cooke; James Edward,29,0,32,3
1683318916052,BIPN 134,A04,193486,Cooke; James Edward,21,0,32,11
1683318916052,BIPN 134,A05,193491,Cooke; James Edward,31,0,32,1
1683318916052,BIPN 134,A06,193501,Cooke; James Edward,30,0,32,2
1683318916052,BIPN 134,A07,193510,Cooke; James Edward,29,0,32,3
1683318918099,BISP 194,A00,222522,Staff,15,0,32,17
1683318919123,CAT 124,A01,202407,Staff,20,0,25,5
1683318920150,CAT 125,A00,202408,Marchisotto; Jennifer Anne,4,0,20,16
1683318921175,CAT 125R,A00,202409,Smith; Lauryn Alissa,0,11,20,20
1683318921175,CAT 125R,B00,202410,Morales; Celeste Georgianna,0,11,20,20
1683318921175,CAT 125R,C00,202411,Irwin; Matthew Joseph,0,10,20,20
1683318922198,CENG 15,A01,204712,Yang; Kesong,0,1,0,0
1683318923222,CENG 114,A00,202070,Jahed Motlagh; Zeinab,5,0,20,15
1683318924249,CGS 105,A00,185477,Wesling; Megan E.,24,0,40,16
1683318925276,CGS 106,A00,185494,Staff,13,0,22,9
1683318926302,CGS 108,A00,185495,Staff,14,0,20,6
1683318927326,CGS 114,A00,185496,Staff,13,0,18,5
1683318928349,CGS 119,A00,185501,Staff,15,0,20,5
1683318929377,CGS 120,A00,185511,Staff,13,0,20,7
1683318930405,CHEM 4,A01,184675,Bussey; Thomas J,96,0,100,4
1683318931432,CHEM 6A,A01,184677,Staff,34,0,60,26
1683318932457,CHEM 6B,A01,184679,Staff,65,0,100,35
1683318933485,CHEM 6C,A01,184681,Bussey; Thomas J,1,0,50,49
1683318933485,CHEM 6C,A02,184682,Bussey; Thomas J,34,0,50,16
1683318934509,CHEM 40A,A01,184684,Albizati; Kim F.,37,0,100,63
1683318935537,CHEM 40B,A01,184686,Albizati; Kim F.,0,20,100,100
1683318936560,CHEM 41B,A01,184690,Staff,52,0,100,48
1683318937584,COGS 3,A01,184715,Boyle; Mary E. T.,0,25,40,40
1683318938609,COGS 14B,A01,185172,Staff,0,15,38,38
1683318939637,COGS 18,A01,184736,Staff,18,0,80,62
1683318940664,COGS 100,A01,184932,Staff,0,5,73,73
1683318941689,COGS 101A,A01,184935,Staff,0,38,30,30
1683318942716,COGS 101B,A01,184944,Staff,0,2,30,30
1683318943743,COGS 101C,A01,184946,Staff,0,12,30,30
1683318944766,COGS 102A,A01,184951,Johnson; Christine M.,2,0,40,38
1683318956386,COGS 107B,A01,184953,Mooshagian; Eric Frederick,0,50,40,40
1683318957411,COGS 118B,A01,184959,Gupta; Anjum,0,48,40,40
1683318958438,COGS 153,A00,184961,Staff,0,15,30,30
1683318959463,COGS 177,A00,184962,Staff,0,21,30,30
1683318960486,COGS 187A,A01,184969,Boyle; Mary E. T.,0,17,40,40
1683318961511,COMM 10,A01,185174,Staff,0,5,25,25
1683318961511,COMM 10,A02,185189,Staff,0,5,25,25
1683318961511,COMM 10,A03,269821,Staff,0,0,0,0
1683318962537,COMM 100B,A01,185475,Staff,0,0,0,2
1683318962537,COMM 100B,A02,185476,Staff,14,0,25,11
1683318963564,COMM 100C,A01,185314,Staff,1,0,25,24
1683318963564,COMM 100C,A02,185327,Staff,19,0,25,6
1683318964593,COMM 110M,A00,185349,Staff,2,0,40,38
1683318965617,COMM 113T,A00,185352,Staff,25,0,40,15
1683318966644,COMM 114I,A00,185353,Staff,33,0,40,7
1683318967671,COMM 131,A00,185354,Staff,19,0,30,11
1683318968695,CSE 8A,A50,185358,Cao; Yingjun,0,46,10,10
1683318969722,CSE 8B,A01,185362,Staff,1,47,50,49
1683318970750,CSE 11,A01,185416,Cao; Yingjun,0,92,10,10
1683318971775,CSE 20,A01,185445,Briones; Jor-el Thomas Caparas,5,0,25,20
1683318972804,CSE 21,A01,185447,Staff,10,0,50,40
1683318973830,CSE 101,A01,185451,Staff,0,12,50,50
1683318973830,CSE 101,B01,185453,Jones; Miles E,0,11,50,50
1683318975886,CSE 141,A01,185458,Eldon; John,20,0,100,80
1683318976912,CSE 141L,A01,185461,Eldon; John,12,0,100,88
1683318977941,CSE 142,A01,185463,Staff,36,0,60,24
1683318977941,CSE 142,B01,201355,Staff,0,7,60,60
1683318979024,CSE 142L,A01,185470,Staff,36,0,60,24
1683318979024,CSE 142L,B01,201417,Staff,0,6,60,60
1683318980048,CSE 190,A00,201433,Staff,32,0,49,17
1683318981075,DOC 1,A01,259136,Strom; Megan C.,7,0,15,8
1683318981075,DOC 1,A02,259137,Strom; Megan C.,14,0,15,1
1683318981075,DOC 1,A03,259138,Strom; Megan C.,14,0,15,1
1683318981075,DOC 1,A04,259139,Strom; Megan C.,14,0,15,1
1683318982100,DOC 100D,A00,259140,Pass; Natalye Joann,17,0,25,8
1683318983130,DSGN 1,A01,184749,Rill; Bryan,0,25,30,30
1683318984159,DSGN 100,A01,185168,Staff,0,2,25,25
1683318985185,ECE 5,A01,185626,Morris; Karcher William,0,10,0,0
1683318986210,ECE 101,A01,185628,Staff,17,0,70,53
1683318987238,ECE 107,A01,185635,Baghdadchi; Saharnaz,0,0,20,20
1683318987238,ECE 107,A02,185638,Baghdadchi; Saharnaz,4,0,20,16
1683318988261,ECE 148,A01,185647,Silberman; Jack,0,0,16,16
1683318989289,ECON 1,A01,185537,Crane; Meredith Helen,54,0,70,16
1683318990313,ECON 3,A01,185549,Crane; Meredith Helen,33,0,70,37
1683318991341,ECON 4,A01,203354,Anderson; John Charles,0,4,10,10
1683318992366,ECON 100A,A01,185574,Staff,0,4,40,40
1683318993394,ECON 100B,A01,185576,Staff,0,22,40,40
1683318994421,ECON 100C,A01,185589,Newhouse; Herbert S,30,0,70,40
1683318995445,ECON 105,A00,185608,Vespa; Emanuel Ignacio,19,0,35,16
1683318996471,ECON 109,A01,185610,Shishkin; Denis,10,0,35,25
1683318997495,ECON 110A,A01,185612,Staff,11,0,40,29
1683318998520,ECON 120A,A01,185615,Staff,20,0,40,20
1683318999557,ECON 120C,A01,185617,Sun; Yixiao,0,20,70,70
1683319000583,ECON 144,A00,203346,Squires; Dale E,3,0,35,32
1683319001608,ECON 171,A01,203349,Newhouse; Herbert S,0,1,35,35
1683319002631,ECON 173A,A01,185621,Toda; Alexis Akira,21,0,35,14
1683319003660,EDS 25,A01,202413,Staff,0,1,0,0
1683319003660,EDS 25,A02,202414,Staff,0,1,0,0
1683319003660,EDS 25,A03,202415,Staff,0,0,0,0
1683319003660,EDS 25,A04,202416,Staff,0,1,0,0
1683319003660,EDS 25,A05,202439,Staff,0,0,0,0
1683319003660,EDS 25,A06,202440,Staff,0,0,0,0
1683319003660,EDS 25,B01,202631,Staff,0,0,0,0
1683319003660,EDS 25,B02,202632,Staff,0,0,0,0
1683319003660,EDS 25,B03,202639,Staff,0,0,0,0
1683319003660,EDS 25,B04,202640,Staff,0,0,0,0
1683319003660,EDS 25,B05,202643,Staff,0,0,0,0
1683319003660,EDS 25,B06,202644,Staff,0,0,0,0
1683319004685,EDS 38,A01,202659,Black; Alison Michelle,24,0,25,1
1683319005712,EDS 115,A00,202652,Staff,17,0,30,13
1683319006736,EDS 125,A00,202649,Staff,14,0,30,16
1683319007764,EDS 126,A01,203332,Staff,30,0,30,0
1683319008792,EDS 139,A00,202838,Staff,16,0,25,9
1683319009817,EDS 146,A01,202655,Staff,14,0,25,11
1683319010847,ENG 15,A00,185667,Staff,0,1,0,0
1683319010847,ENG 15,B00,185672,Staff,0,0,0,0
1683319010847,ENG 15,C00,185675,Staff,0,0,0,0
1683319010847,ENG 15,D00,185682,Staff,0,0,0,0
1683319010847,ENG 15,E00,185684,Staff,0,0,0,0
1683319011874,ETHN 103,A00,185710,Staff,0,3,35,35
1683319012899,ETHN 103A,A00,199228,Man; Simeon S,2,0,9,7
1683319013926,ETHN 109,A00,185711,Staff,18,0,35,17
1683319014951,ETHN 142,A00,185726,Staff,0,4,30,30
1683319015979,ETHN 163J,A00,199229,Man; Simeon S,5,0,8,3
1683319017005,ETHN 168,A00,185727,Staff,8,0,10,2
1683319018033,ETHN 182,A00,185728,Staff,1,0,35,34
1683319019063,ETHN 183,A00,185737,Staff,8,0,18,10
1683319020121,GLBH 111,A01,209361,Burgos; Jose L.,0,0,0,0
1683319022173,HIEU 104,A00,185792,Staff,16,0,20,4
1683319023197,HIEU 115,A00,185800,Staff,1,0,20,19
1683319024225,HIEU 128,A00,185801,Staff,0,7,20,20
1683319025249,HIEU 147,A00,185802,Staff,16,0,20,4
1683319026277,HIEU 154,A00,185823,Staff,12,0,20,8
1683319027304,HILA 102,A00,185826,Staff,13,0,20,7
1683319028329,HILD 2C,A01,185778,Staff,0,12,20,20
1683319029354,HILD 7B,A01,185780,Kwak; Nancy,0,15,32,32
1683319029354,HILD 7B,A02,185781,Kwak; Nancy,0,18,32,32
1683319030381,HILD 30,A01,185791,Staff,14,0,20,6
1683319031408,HISC 119,A00,185830,Golan; Tal,0,9,20,20
1683319032433,HITO 156GS,A00,185831,Patterson; Patrick H.,0,0,0,23
1683319033461,HIUS 103,A00,185832,Man; Simeon S,0,6,20,20
1683319034489,HIUS 117,A00,185836,Kwak; Nancy,2,0,20,18
1683319035513,HIUS 125,A00,185840,Man; Simeon S,0,0,23,23
1683319036538,HIUS 149,A00,185845,Staff,0,0,20,20
1683319037572,HUM 3,A01,185882,Zavodny; Tatiana Sophia,0,6,50,50
1683319037572,HUM 3,B01,185899,Caldwell; Michael Alan,0,19,50,50
1683319038599,HUM 3GS,A00,185900,Patterson; Patrick H.,0,0,0,23
1683319039624,HUM 4,A01,185938,Zroka; Amy Liane,31,0,50,19
1683319039624,HUM 4,B01,185956,Watkins; Eric,0,2,50,50
1683319039624,HUM 4,B02,202209,Watkins; Eric,0,2,50,50
1683319039624,HUM 4,B03,202210,Watkins; Eric,0,0,50,50
1683319040656,HUM 5,A01,185958,West; Geoffrey Scott,4,0,50,46
1683319040656,HUM 5,A02,202215,West; Geoffrey Scott,0,0,50,50
1683319041683,INTL 190,A00,185959,Gagnon; Jeffrey C,0,0,0,9
1683319041683,INTL 190,B00,185960,Lettieri; Michael Joseph,0,0,0,1
1683319042712,JAPN 180,A00,254509,Staff,5,1,30,25
1683319043740,LATI 10,A01,202853,Kennemore; Amy Michelle,5,0,35,30
1683319043740,LATI 10,A02,202854,Kennemore; Amy Michelle,1,0,35,34
1683319043740,LATI 10,A03,270054,Kennemore; Amy Michelle,30,0,30,0
1683319044765,LATI 180,A00,202855,Kennemore; Amy Michelle,11,0,20,9
1683319045791,LAWS 101,A00,201767,Golan; Tal,0,7,40,40
1683319046819,LIFR 1C,A00,185961,Staff,6,0,20,14
1683319047845,LIFR 1CX,A00,185962,Staff,7,0,20,13
1683319048873,LIFR 1D,A00,185963,Staff,9,0,20,11
1683319049899,LIFR 1DX,A00,185964,Staff,9,0,20,11
1683319050926,LIGN 101,A01,186039,Staff,43,0,50,7
1683319051953,LIGN 165,A00,186040,Staff,18,0,50,32
1683319052979,LTCS 108,A00,186041,Staff,6,0,10,4
1683319054006,LTCS 119,A00,186042,Staff,16,0,20,4
1683319055030,LTCS 130,A00,186043,Wesling; Megan E.,15,0,25,10
1683319057076,LTEA 138,A00,186119,Staff,14,0,40,26
1683319058105,LTEN 124,A00,186148,Staff,6,0,25,19
1683319059132,LTEN 178,A00,186149,Staff,7,0,15,8
1683319060155,LTEN 181,A00,186150,Blanco; John D,33,0,40,7
1683319061194,LTWL 120,A00,186160,Staff,20,0,25,5
1683319062223,LTWL 165,A00,186161,Staff,22,0,25,3
1683319063247,LTWR 100,A00,186162,Staff,0,4,15,15
1683319064271,LTWR 102,A00,186163,Doller; Ben,5,0,15,10
1683319065296,MAE 8,A01,186412,Staff,0,0,0,0
1683319066321,MAE 30B,A00,186445,Bahadori; Mohammad Yousef,83,0,100,17
1683319067345,MAE 40,A00,186592,Bewley; Thomas R,9,0,50,41
1683319068372,MAE 101B,A00,186593,Bahadori; Mohammad Yousef,81,0,100,19
1683319069397,MAE 105,A00,186594,Bandaru; Prabhakar,12,0,50,38
1683319070421,MAE 107,A00,186599,Pham; Hieu Tan,0,6,120,120
1683319071448,MAE 148,A01,186660,Silberman; Jack,3,0,16,13
1683319072471,MATH 10A,A01,188095,Staff,0,6,35,35
1683319073503,MATH 10B,A01,188097,Bowers; Adam R.,0,11,30,30
1683319073503,MATH 10B,A02,188099,Bowers; Adam R.,0,11,30,30
1683319073503,MATH 10B,B01,188104,Bowers; Adam R.,0,10,30,30
1683319073503,MATH 10B,B02,188106,Bowers; Adam R.,0,10,30,30
1683319074550,MATH 10C,A01,188111,Staff,0,18,30,30
1683319074550,MATH 10C,A02,188127,Staff,0,17,30,30
1683319074550,MATH 10C,A03,188131,Staff,0,18,30,30
1683319074550,MATH 10C,B01,188218,Staff,19,0,30,11
1683319074550,MATH 10C,B02,188244,Staff,13,0,30,17
1683319074550,MATH 10C,B03,188277,Staff,16,0,30,14
1683319075575,MATH 18,A01,188344,Bach; Quang Tran,18,0,30,12
1683319075575,MATH 18,A02,188345,Bach; Quang Tran,11,0,30,19
1683319075575,MATH 18,B01,188353,Bach; Quang Tran,10,0,30,20
1683319075575,MATH 18,B02,188354,Bach; Quang Tran,20,0,30,10
1683319076610,MATH 20A,A01,188374,Staff,13,0,35,22
1683319077635,MATH 20B,A01,188382,Ohm; Ko Woon,6,0,30,24
1683319077635,MATH 20B,A02,188383,Ohm; Ko Woon,23,0,30,7
1683319077635,MATH 20B,B01,188385,Ohm; Ko Woon,7,0,30,23
1683319077635,MATH 20B,B02,188392,Ohm; Ko Woon,22,0,30,8
1683319078663,MATH 20C,A01,188394,Harel; Guershon,10,0,30,20
1683319078663,MATH 20C,A02,188395,Harel; Guershon,14,0,30,16
1683319078663,MATH 20C,B01,188404,Harel; Guershon,5,0,30,25
1683319078663,MATH 20C,B02,188405,Harel; Guershon,19,0,30,11
1683319079690,MATH 20D,A01,188414,Hammock; Frances H,0,1,30,30
1683319079690,MATH 20D,A02,188415,Hammock; Frances H,3,0,30,27
1683319079690,MATH 20D,B01,188447,Hammock; Frances H,2,0,30,28
1683319079690,MATH 20D,B02,188486,Hammock; Frances H,8,0,30,22
1683319080714,MATH 20E,A01,188649,Staff,21,0,30,9
1683319080714,MATH 20E,A02,188650,Staff,23,0,30,7
1683319080714,MATH 20E,A03,188673,Staff,0,0,30,30
1683319081742,MATH 102,A01,188675,Staff,0,35,35,35
1683319082825,MATH 103B,A01,188681,Staff,4,0,35,31
1683319082825,MATH 103B,B01,188692,Staff,5,0,35,30
1683319083849,MATH 109,A01,188695,Salehi Golsefidy; Alireza,25,0,35,10
1683319083849,MATH 109,A02,188696,Salehi Golsefidy; Alireza,26,0,35,9
1683319084873,MATH 120A,A01,188698,Eggers; John Dietrich,7,0,35,28
1683319085901,MATH 142B,A01,188736,Ioana; Adrian,0,2,30,30
1683319085901,MATH 142B,A02,188741,Ioana; Adrian,0,1,30,30
1683319085901,MATH 142B,A03,188743,Ioana; Adrian,1,3,30,29
1683319086928,MATH 168A,A01,188790,Staff,0,9,35,35
1683319087953,MATH 170A,A01,188803,Nie; Jiawang,0,2,35,35
1683319087953,MATH 170A,A02,188811,Nie; Jiawang,0,0,35,35
1683319087953,MATH 170A,A03,188814,Nie; Jiawang,0,0,35,35
1683319087953,MATH 170A,A04,188815,Nie; Jiawang,13,0,35,22
1683319088978,MATH 193B,A01,188817,Staff,0,0,35,35
1683319088978,MATH 193B,A02,188818,Staff,6,0,35,29
1683319090003,MGT 4,A01,202857,Anderson; John Charles,62,0,80,18
1683319091030,MGT 12,A00,202858,Lindenberger; Wade Douglas,43,0,90,47
1683319092053,MGT 18,A00,202859,Staff,74,0,90,16
1683319093077,MGT 18GS,A00,202860,McKay; Michael J,13,0,28,15
1683319094102,MGT 45,A00,202861,Pecore; Joseph P.,13,0,90,77
1683319095125,MGT 100,A00,202863,Yavorsky; Daniel Ryan,28,0,90,62
1683319096150,MGT 103,A00,202864,Ehrich; Kristine R,0,17,90,90
1683319097175,MGT 112,A00,202865,Ehrich; Kristine R,15,0,90,75
1683319098199,MGT 121A,A00,202868,Staff,0,19,0,0
1683319099223,MGT 131B,A00,202869,Anderson; John Charles,59,0,90,31
1683319100247,MGT 136,A00,202871,Lindenberger; Wade Douglas,84,0,90,6
1683319101273,MGT 164,A00,202873,Staff,0,68,90,91
1683319102297,MGT 164GS,A00,202874,McKay; Mary A,13,0,28,15
1683319103321,MGT 180,A00,202875,Staff,0,50,90,91
1683319104348,MMW 11R,A01,205019,Herbst; Matthew,3,0,30,27
1683319104348,MMW 11R,A02,205026,Herbst; Matthew,29,0,30,1
1683319105373,MMW 15,A01,193512,Chang; Edmond Yi-Teh,0,9,28,28
1683319105373,MMW 15,A02,193513,Chang; Edmond Yi-Teh,0,5,28,28
1683319105373,MMW 15,A03,193514,Chang; Edmond Yi-Teh,0,5,28,28
1683319105373,MMW 15,A04,193515,Chang; Edmond Yi-Teh,0,5,28,28
1683319105373,MMW 15,A05,193516,Chang; Edmond Yi-Teh,0,4,28,28
1683319105373,MMW 15,A06,193517,Chang; Edmond Yi-Teh,0,5,28,28
1683319105373,MMW 15,B01,193519,Chang; Edmond Yi-Teh,0,4,28,28
1683319105373,MMW 15,B02,193520,Chang; Edmond Yi-Teh,0,5,28,28
1683319105373,MMW 15,B03,193521,Chang; Edmond Yi-Teh,0,4,28,28
1683319105373,MMW 15,B04,193522,Chang; Edmond Yi-Teh,0,4,28,28
1683319105373,MMW 15,B05,193523,Chang; Edmond Yi-Teh,0,5,28,28
1683319105373,MMW 15,B06,193524,Chang; Edmond Yi-Teh,0,4,28,28
1683319106402,MMW 122,A01,193526,Rahimi; Babak,0,14,28,28
1683319106402,MMW 122,A02,193527,Rahimi; Babak,0,14,28,28
1683319106402,MMW 122,A03,193528,Rahimi; Babak,0,0,0,0
1683319106402,MMW 122,A04,193529,Rahimi; Babak,0,0,0,0
1683319107429,MUS 1A,A01,186663,Staff,0,20,35,35
1683319108456,MUS 4,A01,186715,Staff,0,12,35,35
1683319109484,MUS 5R,A01,186796,Dubnov; Shlomo,0,17,35,35
1683319110507,MUS 6,A01,186798,Staff,0,3,25,25
1683319111534,MUS 7,A01,186830,Staff,12,0,35,23
1683319112561,MUS 8,A01,186930,Staff,0,26,35,35
1683319113586,MUS 15,A01,186932,Staff,0,15,35,35
1683319113586,MUS 15,B01,186934,Staff,0,15,35,35
1683319114611,MUS 80,A00,186935,Staff,2,0,20,18
1683319114611,MUS 80,B00,186936,Staff,25,0,25,0
1683319115638,NANO 11,A00,204702,Lipomi; Darren John,0,0,0,0
1683319116663,NANO 15,A01,204709,Yang; Kesong,0,1,0,0
1683319117691,NANO 114,A00,202069,Jahed Motlagh; Zeinab,3,0,10,7
1683319118716,PHIL 1,A00,186955,Grush; Rick Scott,32,0,40,8
1683319119742,PHIL 10,A01,186973,Grush; Rick Scott,28,0,35,7
1683319119742,PHIL 10,A02,186974,Grush; Rick Scott,33,0,35,2
1683319120769,PHIL 13,A01,186976,Staff,7,0,35,28
1683319120769,PHIL 13,A02,186977,Staff,16,0,35,19
1683319121796,PHIL 14,A01,186979,Staff,31,0,35,4
1683319121796,PHIL 14,A02,186986,Staff,32,0,35,3
1683319122820,PHIL 28,A01,186988,Staff,16,0,30,14
1683319122820,PHIL 28,A02,186989,Staff,1,0,30,29
1683319122820,PHIL 28,A03,186990,Staff,9,0,30,21
1683319122820,PHIL 28,A04,186991,Staff,26,0,30,4
1683319123845,PHIL 120,A00,186997,Staff,23,0,40,17
1683319124870,PHIL 137,A00,187003,Staff,9,0,40,31
1683319125893,PHIL 150,A00,187015,Staff,47,0,70,23
1683319126917,PHIL 167,A00,187021,Lamey; Andy M.,35,0,40,5
1683319127941,PHIL 174,A01,202226,Staff,17,0,20,3
1683319127941,PHIL 174,A02,202235,Staff,20,0,20,0
1683319128964,PHIL 191A,A00,258918,Staff,0,0,1,1
1683319129989,PHYS 1A,A00,187028,Staff,27,0,60,33
1683319131017,PHYS 1AL,001,187036,Staff,3,0,30,27
1683319131017,PHYS 1AL,002,187049,Staff,18,0,30,12
1683319132041,PHYS 1B,A00,187058,Staff,22,0,60,38
1683319133067,PHYS 1BL,001,187064,Staff,0,0,30,30
1683319133067,PHYS 1BL,002,187070,Staff,5,0,30,25
1683319134092,PHYS 1C,A00,187082,Staff,31,0,120,89
1683319135119,PHYS 1CL,001,187088,Staff,0,9,30,30
1683319135119,PHYS 1CL,002,187089,Staff,0,2,30,30
1683319135119,PHYS 1CL,009,262693,Staff,11,0,30,19
1683319136143,PHYS 2B,A01,187097,Staff,54,0,115,61
1683319137171,PHYS 2C,A01,187099,Staff,67,0,115,48
1683319138194,PHYS 2CL,A01,187101,Staff,5,0,28,23
1683319138194,PHYS 2CL,A02,187102,Staff,15,0,28,13
1683319139218,PHYS 2D,A01,187123,Shotwell; Brian,95,0,115,20
1683319140245,PHYS 4B,A01,187133,Grinstein; Benjamin,35,0,50,15
1683319141269,POLI 10,A00,188819,Staff,0,4,50,50
1683319142297,POLI 11,A00,188827,Staff,43,0,50,7
1683319143320,POLI 13R,A00,188828,Staff,0,1,20,20
1683319144351,POLI 27,A01,188830,Elgin; Samuel Zincke,0,1,70,70
1683319145378,POLI 30,A00,188832,Desposato; Scott,31,0,50,19
1683319146403,POLI 102F,A00,188834,Staff,3,0,40,37
1683319147428,POLI 104A,A00,188852,Staff,14,0,30,16
1683319148452,POLI 104I,A00,188853,Staff,0,6,20,20
1683319149479,POLI 110B,A00,188854,Wiens; David,7,0,20,13
1683319150504,POLI 112A,A00,188855,Wiens; David,5,0,30,25
1683319151531,POLI 117R,A00,188856,Forman; Fonna,0,11,20,20
1683319152557,POLI 118,A00,188857,Ingham; Sean,8,0,20,12
1683319153584,POLI 120G,A00,188858,Staff,9,0,30,21
1683319154615,POLI 131CR,A00,188863,Hoston; Germaine,24,0,50,26
1683319155640,POLI 133,A00,188864,Nellis; Gareth Hb,44,0,50,6
1683319156664,POLI 134D,A00,188865,Desposato; Scott,27,0,30,3
1683319157688,POLI 142A,A00,188871,Gartzke; Erik,22,0,50,28
1683319158711,POLI 142K,A00,188874,Staff,38,0,50,12
1683319159736,POLI 143,A00,188940,Gartzke; Erik,16,0,30,14
1683319160764,POLI 153,A00,188943,Staff,3,0,20,17
1683319161787,POLI 160AA,A00,188944,Staff,12,0,40,28
1683319162811,POLI 170A,A00,188945,Staff,11,0,30,19
1683319164863,PSYC 1,A00,188952,Staff,37,0,90,53
1683319165889,PSYC 2,B00,188953,Staff,19,0,35,16
1683319166916,PSYC 6,A00,188970,Staff,47,0,60,13
1683319167943,PSYC 7,A00,188973,Staff,37,0,45,8
1683319168968,PSYC 60,A01,188980,Rickard; Timothy C.,43,0,60,17
1683319169991,PSYC 70,A01,189001,Steiner; Eric Tomas,24,0,45,21
1683319171014,PSYC 100,A00,189005,Lacefield; Katharine I,0,99,120,120
1683319172041,PSYC 102,A00,189008,Staff,10,0,30,20
1683319173065,PSYC 106,B00,189026,Gorman; Michael R.,36,0,60,24
1683319174089,PSYC 114,B01,189033,Winkielman; Piotr,0,32,30,30
1683319175118,PSYC 131,A00,189036,Anagnostaras; Stephan,0,43,60,60
1683319176143,PSYC 136,A00,189041,Lowe; Angela Beth,0,7,25,25
1683319177167,PSYC 137,A00,189057,Winkielman; Piotr,0,34,25,25
1683319178198,PSYC 144,A00,189107,Wixted; John T,0,7,50,50
1683319180254,PSYC 162,A00,189142,Staff,0,8,85,85
1683319181278,PSYC 172,A00,189144,Gorman; Michael R.,0,7,30,30
1683319183331,PSYC 179,A00,189146,Lacefield; Katharine I,0,84,120,120
1683319184356,PSYC 181,A00,189147,Anagnostaras; Stephan,0,44,90,90
1683319185385,PSYC 190R,A00,189148,Barner; David A.,0,22,80,80
1683319186484,PSYC 191,A00,189275,Rickard; Timothy C.,0,7,25,25
1683319187507,PSYC 193,A00,189276,Chapman; Eddie Nathaniel,0,1,0,4
1683319188535,PSYC 193L,A01,189281,Lowe; Angela Beth,12,0,20,8
1683319188535,PSYC 193L,B01,189285,Staff,28,0,35,7
1683319189558,RELI 149,A00,187137,Rahimi; Babak,7,0,40,33
1683319190586,SE 9,A01,187315,Staff,0,2,18,18
1683319191629,SE 101B,A00,187409,Staff,24,0,30,6
1683319192653,SE 110B,A00,187444,Staff,10,0,40,30
1683319193678,SE 130B,A00,187449,Staff,31,0,40,9
1683319194703,SE 150A,A00,187516,Staff,9,0,20,11
1683319195727,SE 154,A00,187528,Staff,30,0,50,20
1683319196751,SIO 3,A01,258171,Staff,35,0,40,5
1683319197774,SIO 10,A00,187144,Cook; Geoffrey W,0,3,75,75
1683319198809,SIO 45,A00,187152,Cook; Geoffrey W,1,0,100,99
1683319199835,SIO 109R,A00,194486,Staff,0,3,20,20
1683319201890,SIO 187,A01,187233,Kacev; David,12,0,40,28
1683319202918,SOCI 1,A01,258656,Thorpe; Charles Robert,28,0,30,2
1683319202918,SOCI 1,A02,258658,Thorpe; Charles Robert,30,0,30,0
1683319202918,SOCI 1,A03,258661,Thorpe; Charles Robert,25,0,25,0
1683319202918,SOCI 1,A04,258666,Thorpe; Charles Robert,22,0,25,3
1683319202918,SOCI 1,A05,258897,Thorpe; Charles Robert,23,0,25,2
1683319202918,SOCI 1,A06,258898,Thorpe; Charles Robert,25,0,25,0
1683319203942,SOCI 30,A01,258903,Pardo Guerra; Juan Pablo,16,0,30,14
1683319204970,SOCI 102,A00,258904,Staff,9,0,25,16
1683319205993,SOCI 106,A00,258905,Staff,19,0,25,6
1683319207021,SOCI 111,A00,258907,Ribas Norris; Janet Vanesa,26,0,30,4
1683319208049,SOCI 121R,A00,258908,Pardo Guerra; Juan Pablo,11,0,30,19
1683319209075,SOCI 126,A01,203330,Staff,14,0,20,6
1683319210099,SOCI 131,A00,258909,Thorpe; Charles Robert,31,0,60,29
1683319211123,SOCI 135,A00,258910,Payne; Christine Anna,0,9,30,30
1683319212148,SOCI 157,A00,258911,Staff,12,0,30,18
1683319213171,SOCI 184,A00,258912,Staff,25,0,30,5
1683319214200,SOCI 188D,A00,258913,Staff,21,0,30,9
1683319215227,SYN 2,001,187529,Staff,9,0,16,7
1683319215227,SYN 2,002,201452,Staff,0,18,16,16
1683319215227,SYN 2,003,201469,Staff,4,0,16,12
1683319216254,SYN 100,A01,187531,Staff,0,9,20,20
1683319216254,SYN 100,B01,201491,Staff,0,12,20,20
1683319217280,TDAC 1,A00,189286,Walsh; Kim C.,3,0,20,17
1683319217280,TDAC 1,B00,189287,Harting; Carla Kelso,11,0,20,9
1683319218304,TDAC 101,A00,189300,Walsh; Kim C.,16,0,20,4
1683319218304,TDAC 101,B00,189301,Harting; Carla Kelso,18,0,20,2
1683319219329,TDAC 102,A00,189304,Basso; Beatrice,14,0,20,6
1683319220360,TDAC 108,A00,189305,Staff,18,0,20,2
1683319221387,TDDE 131,A00,189310,Staff,19,0,20,1
1683319221387,TDDE 131,B00,189314,Staff,19,0,20,1
1683319221387,TDDE 131,C00,189315,Staff,48,0,50,2
1683319221387,TDDE 131,D00,189316,Staff,14,0,15,1
1683319221387,TDDE 131,E00,204841,Staff,20,0,20,0
1683319222411,TDGE 10,A00,189289,Staff,30,0,50,20
1683319222411,TDGE 10,B00,189290,Havis; Allan,1,0,50,49
1683319223436,TDGE 11,A00,189291,Fulton; Julia,0,3,50,50
1683319223436,TDGE 11,B00,189292,Staff,20,0,25,5
1683319223436,TDGE 11,C00,260270,Staff,0,0,0,0
1683319224464,TDGE 25,A00,189294,Staff,3,0,20,17
1683319225491,TDGE 124,A00,189318,Fulton; Julia,0,8,50,50
1683319226516,TDGE 125,A00,189319,Staff,13,0,25,12
1683319226516,TDGE 125,B00,189320,Staff,23,0,25,2
1683319227543,TDGE 127,A00,189322,Havis; Allan,0,0,50,50
1683319228573,TDHT 101,A00,189323,Staff,18,0,25,7
1683319228573,TDHT 101,B00,189324,Staff,25,0,25,0
1683319229600,TDHT 102,A00,189325,Staff,49,0,50,1
1683319230623,TDMV 1,A00,189295,Arcidiacono; Kristin,20,0,30,10
1683319230623,TDMV 1,B00,189296,Caligagan; Maria T.,24,0,30,6
1683319231656,TDMV 2,A00,189297,Sammartano; Tonnie,28,0,30,2
1683319231656,TDMV 2,B00,189299,Arcidiacono; Kristin,24,0,30,6
1683319232684,TDMV 3,A00,204998,Rincon; Alicia,22,0,30,8
1683319233711,TDMV 120,A00,189458,Sammartano; Tonnie,28,0,30,2
1683319234736,TDMV 138,A00,189541,Jun; Grace Shin Hae,22,0,40,18
1683319235759,TDMV 142,A00,189717,Caligagan; Tony,23,0,30,7
1683319235759,TDMV 142,B00,189718,Caligagan; Maria T.,25,0,30,5
1683319236786,TMC 2,A01,187533,Staff,25,0,25,0
1683319236786,TMC 2,A02,187534,Staff,25,0,25,0
1683319237809,USP 1,A01,187536,Kwak; Nancy,0,16,25,25
1683319238837,USP 5,A01,187538,Staff,9,0,25,16
1683319239862,USP 101,A00,199253,Staff,0,4,0,0
1683319240887,USP 124,A00,187562,Boomhower; Matthew Charles,1,0,30,29
1683319241911,USP 138,A00,187582,Staff,20,0,25,5
1683319242936,USP 152,A01,187597,Staff,4,0,25,21
1683319243958,USP 153,A00,187598,Staff,19,0,25,6
1683319244986,USP 168,A00,187607,Kwak; Nancy,2,0,5,3
1683319246009,USP 173,A00,187619,Staff,4,0,25,21
1683319247037,USP 181,A00,187638,Staff,0,0,25,25
1683319248062,VIS 103,A00,187650,Cruz; Edwin Teddy,23,0,75,52
1683319249085,VIS 110D,A00,187669,Staff,12,0,22,10
1683319250120,VIS 127C,A00,187720,Shen; Kuiyi,68,0,146,78
1683319251151,VIS 149,A00,187731,Yoldas; Pinar,0,14,22,22
1683319252174,VIS 151,A01,188091,Staff,22,0,34,12
1683319252174,VIS 151,A02,188092,Staff,11,0,34,23
1683319253198,VIS 160B,A00,188093,Stalbaum; Brett,0,0,10,10
1683319255249,WCWP 10B,A00,201720,Staff,10,0,15,5
1683319255249,WCWP 10B,B00,201722,Staff,8,0,15,7
1683319256276,WCWP 100,A00,201725,Gagnon; Jeffrey C,0,0,2,2
1683319256276,WCWP 100,B00,201727,Staff,0,4,15,15
1683319259370,ANBI 133,A00,258401,Wilder; Linnea Lorene,34,0,40,6
1683319260397,ANBI 140,A00,258395,Hrvoj Mihic; Branka,18,0,25,7
1683319261423,ANSC 120,A00,258402,Bialecki; Jon Anthony,27,0,40,13
1683319262454,ANSC 144,A00,258400,Staff,14,0,40,26
1683319264504,ANSC 166,A00,258396,Parish; Steven Martin,157,0,175,18
1683319265529,ANSC 180,A00,193533,Staff,9,0,20,11
1683319266557,ANSC 188,A00,258397,Jassal; Aftab,33,0,40,7
1683319267582,ANTH 3,A01,258316,Staff,23,0,30,7
1683319268607,ANTH 5,A00,258394,Semendeferi; Ekaterini,16,0,20,4
1683319269635,ANTH 21,A01,258331,Staff,9,0,40,31
1683319270660,ANTH 103,A00,258398,Varma; Saiba,15,0,25,10
1683319271693,AWP 10,001,202034,Staff,0,0,0,0
1683319271693,AWP 10,002,202035,Staff,0,0,0,0
1683319271693,AWP 10,003,202036,Staff,0,0,0,0
1683319271693,AWP 10,004,202037,Staff,0,0,0,0
1683319271693,AWP 10,005,202038,Staff,0,0,0,0
1683319271693,AWP 10,006,202039,Staff,0,0,0,0
1683319271693,AWP 10,007,202040,Staff,0,0,0,0
1683319271693,AWP 10,008,202041,Staff,0,0,0,0
1683319271693,AWP 10,009,202042,Staff,0,0,0,0
1683319271693,AWP 10,010,202043,Staff,0,0,0,0
1683319271693,AWP 10,011,202044,Staff,0,0,0,0
1683319271693,AWP 10,012,202045,Staff,0,0,0,0
1683319271693,AWP 10,013,202046,Staff,0,0,0,0
1683319271693,AWP 10,014,202047,Staff,0,0,0,0
1683319271693,AWP 10,015,202048,Staff,0,0,0,0
1683319271693,AWP 10,016,202049,Staff,0,0,0,0
1683319271693,AWP 10,017,202050,Staff,0,0,0,0
1683319271693,AWP 10,018,202051,Staff,0,0,0,0
1683319271693,AWP 10,019,202052,Staff,0,0,0,0
1683319271693,AWP 10,020,202053,Staff,0,0,0,0
1683319271693,AWP 10,021,202054,Staff,0,0,0,0
1683319271693,AWP 10,022,202055,Staff,0,0,0,0
1683319271693,AWP 10,023,202056,Staff,0,0,0,0
1683319271693,AWP 10,024,202057,Staff,0,0,0,0
1683319271693,AWP 10,025,202058,Staff,0,0,0,0
1683319271693,AWP 10,026,202059,Staff,0,0,0,0
1683319272717,AWP 102,001,202032,Staff,0,0,0,0
1683319272717,AWP 102,002,202033,Staff,0,0,0,0
1683319273745,BENG 100,A01,254234,Taylor Amos; Alyssa C,31,0,40,9
1683319274769,BENG 196,001,270013,Engler; Adam J.,9999,0,9999,0
1683319275797,BICD 100R,A01,202018,Smith; Laurie,0,7,32,32
1683319275797,BICD 100R,A02,202019,Smith; Laurie,0,2,32,32
1683319275797,BICD 100R,A03,202020,Smith; Laurie,0,1,32,32
1683319275797,BICD 100R,A04,202021,Smith; Laurie,8,0,32,24
1683319275797,BICD 100R,A05,202022,Smith; Laurie,12,0,32,20
1683319276821,BICD 136,A01,193242,Gustafson-Brown; Cindy,0,2,32,32
1683319276821,BICD 136,A02,193244,Gustafson-Brown; Cindy,14,0,32,18
1683319277846,BIEB 102,A01,193249,Butler; Shannon Rhey,0,2,32,32
1683319277846,BIEB 102,A02,193251,Butler; Shannon Rhey,0,0,32,32
1683319277846,BIEB 102,A03,193253,Butler; Shannon Rhey,0,1,32,32
1683319277846,BIEB 102,A04,193255,Butler; Shannon Rhey,17,0,32,15
1683319277846,BIEB 102,A05,193265,Butler; Shannon Rhey,26,0,32,6
1683319277846,BIEB 102,A06,193269,Butler; Shannon Rhey,16,0,32,16
1683319279901,BIEB 150,A01,193274,Staff,0,0,32,32
1683319279901,BIEB 150,A02,193285,Staff,23,0,32,9
1683319280925,BIEB 194,A00,193286,Kurle; Carolyn M.,22,0,32,10
1683319281955,BILD 1,A01,192291,Staff,16,0,32,16
1683319281955,BILD 1,A02,192292,Staff,30,0,32,2
1683319281955,BILD 1,B01,192520,Reuther; Keefe,0,1,0,0
1683319281955,BILD 1,B02,192532,Reuther; Keefe,0,1,0,0
1683319282985,BILD 3,A01,192556,Butler; Shannon Rhey,0,0,32,32
1683319282985,BILD 3,A02,192581,Butler; Shannon Rhey,5,0,32,27
1683319282985,BILD 3,A03,192611,Butler; Shannon Rhey,23,0,32,9
1683319282985,BILD 3,A04,192612,Butler; Shannon Rhey,25,0,32,7
1683319282985,BILD 3,A05,192613,Butler; Shannon Rhey,27,0,32,5
1683319282985,BILD 3,A06,192679,Butler; Shannon Rhey,27,0,32,5
1683319282985,BILD 3,A07,192682,Butler; Shannon Rhey,22,0,32,10
1683319284013,BILD 4,A01,192836,Reuther; Keefe,0,0,24,24
1683319284013,BILD 4,A02,193044,Reuther; Keefe,4,0,24,20
1683319285038,BILD 10,A01,193142,Gustafson-Brown; Cindy,30,0,32,2
1683319285038,BILD 10,A02,193149,Gustafson-Brown; Cindy,31,0,32,1
1683319286062,BIMM 100,A01,193301,Staff,0,6,32,32
1683319286062,BIMM 100,A02,193312,Staff,0,5,32,32
1683319286062,BIMM 100,A03,193323,Staff,0,8,32,32
1683319287092,BIMM 101,A01,193329,McDonnell; Lisa Marie,0,3,24,24
1683319287092,BIMM 101,A02,193339,McDonnell; Lisa Marie,0,3,24,24
1683319287092,BIMM 101,B01,193354,McDonnell; Lisa Marie,0,3,24,24
1683319287092,BIMM 101,B02,193357,McDonnell; Lisa Marie,0,3,24,24
1683319288117,BIMM 110,A01,193377,Tat; John,0,11,32,32
1683319288117,BIMM 110,A02,193378,Tat; John,1,9,32,31
1683319289142,BIMM 120,A01,206116,Staff,0,0,32,32
1683319289142,BIMM 120,A02,206117,Staff,8,0,32,24
1683319289142,BIMM 120,A03,206121,Staff,21,0,32,11
1683319290241,BIPN 100,A01,193393,Park; Ji Young,0,14,32,32
1683319290241,BIPN 100,A02,193402,Park; Ji Young,0,12,32,32
1683319290241,BIPN 100,A03,193413,Park; Ji Young,0,14,32,32
1683319290241,BIPN 100,A04,193414,Park; Ji Young,0,13,32,32
1683319291283,BIPN 102,A01,193429,Staff,0,0,32,32
1683319291283,BIPN 102,A02,193438,Staff,22,0,32,10
1683319292311,BIPN 106,A01,193450,Reyes Gonzalez; Catalina,0,2,40,40
1683319293342,BIPN 134,A01,193465,Cooke; James Edward,0,0,32,32
1683319293342,BIPN 134,A02,193474,Cooke; James Edward,27,0,32,5
1683319293342,BIPN 134,A03,193485,Cooke; James Edward,29,0,32,3
1683319293342,BIPN 134,A04,193486,Cooke; James Edward,21,0,32,11
1683319293342,BIPN 134,A05,193491,Cooke; James Edward,31,0,32,1
1683319293342,BIPN 134,A06,193501,Cooke; James Edward,30,0,32,2
1683319293342,BIPN 134,A07,193510,Cooke; James Edward,29,0,32,3
1683319295389,BISP 194,A00,222522,Staff,15,0,32,17
1683319296417,CAT 124,A01,202407,Staff,20,0,25,5
1683319297440,CAT 125,A00,202408,Marchisotto; Jennifer Anne,4,0,20,16
1683319298464,CAT 125R,A00,202409,Smith; Lauryn Alissa,0,11,20,20
1683319298464,CAT 125R,B00,202410,Morales; Celeste Georgianna,0,11,20,20
1683319298464,CAT 125R,C00,202411,Irwin; Matthew Joseph,0,10,20,20
1683319299488,CENG 15,A01,204712,Yang; Kesong,0,1,0,0
1683319300511,CENG 114,A00,202070,Jahed Motlagh; Zeinab,5,0,20,15
1683319301535,CGS 105,A00,185477,Wesling; Megan E.,24,0,40,16
1683319302562,CGS 106,A00,185494,Staff,13,0,22,9
1683319303585,CGS 108,A00,185495,Staff,14,0,20,6
1683319304608,CGS 114,A00,185496,Staff,13,0,18,5
1683319305633,CGS 119,A00,185501,Staff,15,0,20,5
1683319306659,CGS 120,A00,185511,Staff,13,0,20,7
1683319307684,CHEM 4,A01,184675,Bussey; Thomas J,96,0,100,4
1683319308708,CHEM 6A,A01,184677,Staff,34,0,60,26
1683319309732,CHEM 6B,A01,184679,Staff,65,0,100,35
1683319310756,CHEM 6C,A01,184681,Bussey; Thomas J,1,0,50,49
1683319310756,CHEM 6C,A02,184682,Bussey; Thomas J,34,0,50,16
1683319311785,CHEM 40A,A01,184684,Albizati; Kim F.,37,0,100,63
1683319312809,CHEM 40B,A01,184686,Albizati; Kim F.,0,20,100,100
1683319313837,CHEM 41B,A01,184690,Staff,52,0,100,48
1683319314861,COGS 3,A01,184715,Boyle; Mary E. T.,0,25,40,40
1683319315888,COGS 14B,A01,185172,Staff,0,15,38,38
1683319316913,COGS 18,A01,184736,Staff,18,0,80,62
1683319317939,COGS 100,A01,184932,Staff,0,5,73,73
1683319318964,COGS 101A,A01,184935,Staff,0,38,30,30
1683319319990,COGS 101B,A01,184944,Staff,0,2,30,30
1683319321016,COGS 101C,A01,184946,Staff,0,12,30,30
1683319322050,COGS 102A,A01,184951,Johnson; Christine M.,2,0,40,38
1683319323082,COGS 107B,A01,184953,Mooshagian; Eric Frederick,0,50,40,40
1683319324106,COGS 118B,A01,184959,Gupta; Anjum,0,48,40,40
1683319325130,COGS 153,A00,184961,Staff,0,15,30,30
1683319326153,COGS 177,A00,184962,Staff,0,21,30,30
1683319327177,COGS 187A,A01,184969,Boyle; Mary E. T.,0,17,40,40
1683319328204,COMM 10,A01,185174,Staff,0,5,25,25
1683319328204,COMM 10,A02,185189,Staff,0,5,25,25
1683319328204,COMM 10,A03,269821,Staff,0,0,0,0
1683319329229,COMM 100B,A01,185475,Staff,0,0,0,2
1683319329229,COMM 100B,A02,185476,Staff,14,0,25,11
1683319330257,COMM 100C,A01,185314,Staff,1,0,25,24
1683319330257,COMM 100C,A02,185327,Staff,19,0,25,6
1683319331282,COMM 110M,A00,185349,Staff,2,0,40,38
1683319332307,COMM 113T,A00,185352,Staff,25,0,40,15
1683319333330,COMM 114I,A00,185353,Staff,33,0,40,7
1683319334357,COMM 131,A00,185354,Staff,19,0,30,11
1683319335384,CSE 8A,A50,185358,Cao; Yingjun,0,46,10,10
1683319336408,CSE 8B,A01,185362,Staff,1,47,50,49
1683319337433,CSE 11,A01,185416,Cao; Yingjun,0,92,10,10
1683319338459,CSE 20,A01,185445,Briones; Jor-el Thomas Caparas,5,0,25,20
1683319339483,CSE 21,A01,185447,Staff,10,0,50,40
1683319340511,CSE 101,A01,185451,Staff,0,12,50,50
1683319340511,CSE 101,B01,185453,Jones; Miles E,0,11,50,50
1683319342566,CSE 141,A01,185458,Eldon; John,20,0,100,80
1683319343590,CSE 141L,A01,185461,Eldon; John,12,0,100,88
1683319344615,CSE 142,A01,185463,Staff,36,0,60,24
1683319344615,CSE 142,B01,201355,Staff,0,7,60,60
1683319345644,CSE 142L,A01,185470,Staff,36,0,60,24
1683319345644,CSE 142L,B01,201417,Staff,0,6,60,60
1683319346667,CSE 190,A00,201433,Staff,32,0,49,17
1683319347691,DOC 1,A01,259136,Strom; Megan C.,7,0,15,8
1683319347691,DOC 1,A02,259137,Strom; Megan C.,14,0,15,1
1683319347691,DOC 1,A03,259138,Strom; Megan C.,14,0,15,1
1683319347691,DOC 1,A04,259139,Strom; Megan C.,14,0,15,1
1683319348717,DOC 100D,A00,259140,Pass; Natalye Joann,17,0,25,8
1683319349741,DSGN 1,A01,184749,Rill; Bryan,0,25,30,30
1683319350766,DSGN 100,A01,185168,Staff,0,2,25,25
1683319351791,ECE 5,A01,185626,Morris; Karcher William,0,10,0,0
1683319352817,ECE 101,A01,185628,Staff,17,0,70,53
1683319353841,ECE 107,A01,185635,Baghdadchi; Saharnaz,0,0,20,20
1683319353841,ECE 107,A02,185638,Baghdadchi; Saharnaz,4,0,20,16
1683319354865,ECE 148,A01,185647,Silberman; Jack,0,0,16,16
1683319355892,ECON 1,A01,185537,Crane; Meredith Helen,54,0,70,16
1683319356919,ECON 3,A01,185549,Crane; Meredith Helen,33,0,70,37
1683319357943,ECON 4,A01,203354,Anderson; John Charles,0,4,10,10
1683319358970,ECON 100A,A01,185574,Staff,0,4,40,40
1683319359997,ECON 100B,A01,185576,Staff,0,22,40,40
1683319361021,ECON 100C,A01,185589,Newhouse; Herbert S,30,0,70,40
1683319362049,ECON 105,A00,185608,Vespa; Emanuel Ignacio,19,0,35,16
1683319363075,ECON 109,A01,185610,Shishkin; Denis,10,0,35,25
1683319364100,ECON 110A,A01,185612,Staff,11,0,40,29
1683319365124,ECON 120A,A01,185615,Staff,20,0,40,20
1683319366150,ECON 120C,A01,185617,Sun; Yixiao,0,20,70,70
1683319367177,ECON 144,A00,203346,Squires; Dale E,3,0,35,32
1683319368201,ECON 171,A01,203349,Newhouse; Herbert S,0,1,35,35
1683319369226,ECON 173A,A01,185621,Toda; Alexis Akira,21,0,35,14
1683319370251,EDS 25,A01,202413,Staff,0,1,0,0
1683319370251,EDS 25,A02,202414,Staff,0,1,0,0
1683319370251,EDS 25,A03,202415,Staff,0,0,0,0
1683319370251,EDS 25,A04,202416,Staff,0,1,0,0
1683319370251,EDS 25,A05,202439,Staff,0,0,0,0
1683319370251,EDS 25,A06,202440,Staff,0,0,0,0
1683319370251,EDS 25,B01,202631,Staff,0,0,0,0
1683319370251,EDS 25,B02,202632,Staff,0,0,0,0
1683319370251,EDS 25,B03,202639,Staff,0,0,0,0
1683319370251,EDS 25,B04,202640,Staff,0,0,0,0
1683319370251,EDS 25,B05,202643,Staff,0,0,0,0
1683319370251,EDS 25,B06,202644,Staff,0,0,0,0
1683319371275,EDS 38,A01,202659,Black; Alison Michelle,24,0,25,1
1683319372300,EDS 115,A00,202652,Staff,17,0,30,13
1683319373324,EDS 125,A00,202649,Staff,14,0,30,16
1683319374348,EDS 126,A01,203332,Staff,30,0,30,0
1683319375374,EDS 139,A00,202838,Staff,16,0,25,9
1683319376401,EDS 146,A01,202655,Staff,14,0,25,11
1683319377425,ENG 15,A00,185667,Staff,0,1,0,0
1683319377425,ENG 15,B00,185672,Staff,0,0,0,0
1683319377425,ENG 15,C00,185675,Staff,0,0,0,0
1683319377425,ENG 15,D00,185682,Staff,0,0,0,0
1683319377425,ENG 15,E00,185684,Staff,0,0,0,0
1683319378452,ETHN 103,A00,185710,Staff,0,3,35,35
1683319379475,ETHN 103A,A00,199228,Man; Simeon S,2,0,9,7
1683319380501,ETHN 109,A00,185711,Staff,18,0,35,17
1683319381525,ETHN 142,A00,185726,Staff,0,4,30,30
1683319382550,ETHN 163J,A00,199229,Man; Simeon S,5,0,8,3
1683319383574,ETHN 168,A00,185727,Staff,8,0,10,2
1683319384598,ETHN 182,A00,185728,Staff,1,0,35,34
1683319385625,ETHN 183,A00,185737,Staff,8,0,18,10
1683319386653,GLBH 111,A01,209361,Burgos; Jose L.,0,0,0,0
1683319388705,HIEU 104,A00,185792,Staff,16,0,20,4
1683319389730,HIEU 115,A00,185800,Staff,1,0,20,19
1683319390753,HIEU 128,A00,185801,Staff,0,7,20,20
1683319391777,HIEU 147,A00,185802,Staff,16,0,20,4
1683319392800,HIEU 154,A00,185823,Staff,12,0,20,8
1683319393885,HILA 102,A00,185826,Staff,13,0,20,7
1683319394916,HILD 2C,A01,185778,Staff,0,12,20,20
1683319395943,HILD 7B,A01,185780,Kwak; Nancy,0,15,32,32
1683319395943,HILD 7B,A02,185781,Kwak; Nancy,0,18,32,32
1683319396970,HILD 30,A01,185791,Staff,14,0,20,6
1683319397995,HISC 119,A00,185830,Golan; Tal,0,9,20,20
1683319399020,HITO 156GS,A00,185831,Patterson; Patrick H.,0,0,0,23
1683319400043,HIUS 103,A00,185832,Man; Simeon S,0,6,20,20
1683319401067,HIUS 117,A00,185836,Kwak; Nancy,2,0,20,18
1683319402094,HIUS 125,A00,185840,Man; Simeon S,0,0,23,23
1683319403122,HIUS 149,A00,185845,Staff,0,0,20,20
1683319404146,HUM 3,A01,185882,Zavodny; Tatiana Sophia,0,6,50,50
1683319404146,HUM 3,B01,185899,Caldwell; Michael Alan,0,19,50,50
1683319405170,HUM 3GS,A00,185900,Patterson; Patrick H.,0,0,0,23
1683319406200,HUM 4,A01,185938,Zroka; Amy Liane,31,0,50,19
1683319406200,HUM 4,B01,185956,Watkins; Eric,0,2,50,50
1683319406200,HUM 4,B02,202209,Watkins; Eric,0,2,50,50
1683319406200,HUM 4,B03,202210,Watkins; Eric,0,0,50,50
1683319407224,HUM 5,A01,185958,West; Geoffrey Scott,3,0,50,47
1683319407224,HUM 5,A02,202215,West; Geoffrey Scott,0,0,50,50
1683319408247,INTL 190,A00,185959,Gagnon; Jeffrey C,0,0,0,9
1683319408247,INTL 190,B00,185960,Lettieri; Michael Joseph,0,0,0,1
1683319409275,JAPN 180,A00,254509,Staff,5,1,30,25
1683319410304,LATI 10,A01,202853,Kennemore; Amy Michelle,5,0,35,30
1683319410304,LATI 10,A02,202854,Kennemore; Amy Michelle,1,0,35,34
1683319410304,LATI 10,A03,270054,Kennemore; Amy Michelle,30,0,30,0
1683319411329,LATI 180,A00,202855,Kennemore; Amy Michelle,11,0,20,9
1683319412353,LAWS 101,A00,201767,Golan; Tal,0,7,40,40
1683319413377,LIFR 1C,A00,185961,Staff,6,0,20,14
1683319414400,LIFR 1CX,A00,185962,Staff,7,0,20,13
1683319415424,LIFR 1D,A00,185963,Staff,9,0,20,11
1683319416448,LIFR 1DX,A00,185964,Staff,9,0,20,11
1683319417472,LIGN 101,A01,186039,Staff,43,0,50,7
1683319418498,LIGN 165,A00,186040,Staff,18,0,50,32
1683319419527,LTCS 108,A00,186041,Staff,6,0,10,4
1683319420553,LTCS 119,A00,186042,Staff,16,0,20,4
1683319421577,LTCS 130,A00,186043,Wesling; Megan E.,15,0,25,10
1683319423625,LTEA 138,A00,186119,Staff,14,0,40,26
1683319424651,LTEN 124,A00,186148,Staff,6,0,25,19
1683319425676,LTEN 178,A00,186149,Staff,7,0,15,8
1683319426701,LTEN 181,A00,186150,Blanco; John D,33,0,40,7
1683319427724,LTWL 120,A00,186160,Staff,20,0,25,5
1683319428749,LTWL 165,A00,186161,Staff,22,0,25,3
1683319429774,LTWR 100,A00,186162,Staff,0,4,15,15
1683319430800,LTWR 102,A00,186163,Doller; Ben,5,0,15,10
1683319431827,MAE 8,A01,186412,Staff,0,0,0,0
1683319432850,MAE 30B,A00,186445,Bahadori; Mohammad Yousef,83,0,100,17
1683319433878,MAE 40,A00,186592,Bewley; Thomas R,9,0,50,41
1683319434905,MAE 101B,A00,186593,Bahadori; Mohammad Yousef,81,0,100,19
1683319435932,MAE 105,A00,186594,Bandaru; Prabhakar,12,0,50,38
1683319436956,MAE 107,A00,186599,Pham; Hieu Tan,0,6,120,120
1683319437980,MAE 148,A01,186660,Silberman; Jack,3,0,16,13
1683319439004,MATH 10A,A01,188095,Staff,0,6,35,35
1683319440028,MATH 10B,A01,188097,Bowers; Adam R.,0,11,30,30
1683319440028,MATH 10B,A02,188099,Bowers; Adam R.,0,11,30,30
1683319440028,MATH 10B,B01,188104,Bowers; Adam R.,0,10,30,30
1683319440028,MATH 10B,B02,188106,Bowers; Adam R.,0,10,30,30
1683319441058,MATH 10C,A01,188111,Staff,0,18,30,30
1683319441058,MATH 10C,A02,188127,Staff,0,17,30,30
1683319441058,MATH 10C,A03,188131,Staff,0,18,30,30
1683319441058,MATH 10C,B01,188218,Staff,19,0,30,11
1683319441058,MATH 10C,B02,188244,Staff,13,0,30,17
1683319441058,MATH 10C,B03,188277,Staff,16,0,30,14
1683319442087,MATH 18,A01,188344,Bach; Quang Tran,18,0,30,12
1683319442087,MATH 18,A02,188345,Bach; Quang Tran,11,0,30,19
1683319442087,MATH 18,B01,188353,Bach; Quang Tran,10,0,30,20
1683319442087,MATH 18,B02,188354,Bach; Quang Tran,20,0,30,10
1683319443112,MATH 20A,A01,188374,Staff,13,0,35,22
1683319444142,MATH 20B,A01,188382,Ohm; Ko Woon,6,0,30,24
1683319444142,MATH 20B,A02,188383,Ohm; Ko Woon,23,0,30,7
1683319444142,MATH 20B,B01,188385,Ohm; Ko Woon,7,0,30,23
1683319444142,MATH 20B,B02,188392,Ohm; Ko Woon,22,0,30,8
1683319445167,MATH 20C,A01,188394,Harel; Guershon,10,0,30,20
1683319445167,MATH 20C,A02,188395,Harel; Guershon,14,0,30,16
1683319445167,MATH 20C,B01,188404,Harel; Guershon,5,0,30,25
1683319445167,MATH 20C,B02,188405,Harel; Guershon,19,0,30,11
1683319446195,MATH 20D,A01,188414,Hammock; Frances H,0,1,30,30
1683319446195,MATH 20D,A02,188415,Hammock; Frances H,3,0,30,27
1683319446195,MATH 20D,B01,188447,Hammock; Frances H,2,0,30,28
1683319446195,MATH 20D,B02,188486,Hammock; Frances H,8,0,30,22
1683319447220,MATH 20E,A01,188649,Staff,21,0,30,9
1683319447220,MATH 20E,A02,188650,Staff,23,0,30,7
1683319447220,MATH 20E,A03,188673,Staff,0,0,30,30
1683319448245,MATH 102,A01,188675,Staff,0,35,35,35
1683319449270,MATH 103B,A01,188681,Staff,4,0,35,31
1683319449270,MATH 103B,B01,188692,Staff,5,0,35,30
1683319450295,MATH 109,A01,188695,Salehi Golsefidy; Alireza,25,0,35,10
1683319450295,MATH 109,A02,188696,Salehi Golsefidy; Alireza,26,0,35,9
1683319451326,MATH 120A,A01,188698,Eggers; John Dietrich,7,0,35,28
1683319452357,MATH 142B,A01,188736,Ioana; Adrian,0,2,30,30
1683319452357,MATH 142B,A02,188741,Ioana; Adrian,0,1,30,30
1683319452357,MATH 142B,A03,188743,Ioana; Adrian,1,3,30,29
1683319453384,MATH 168A,A01,188790,Staff,0,9,35,35
1683319454409,MATH 170A,A01,188803,Nie; Jiawang,0,2,35,35
1683319454409,MATH 170A,A02,188811,Nie; Jiawang,0,0,35,35
1683319454409,MATH 170A,A03,188814,Nie; Jiawang,0,0,35,35
1683319454409,MATH 170A,A04,188815,Nie; Jiawang,13,0,35,22
1683319455434,MATH 193B,A01,188817,Staff,0,0,35,35
1683319455434,MATH 193B,A02,188818,Staff,6,0,35,29
1683319456457,MGT 4,A01,202857,Anderson; John Charles,62,0,80,18
1683319457486,MGT 12,A00,202858,Lindenberger; Wade Douglas,43,0,90,47
1683319458511,MGT 18,A00,202859,Staff,74,0,90,16
1683319459534,MGT 18GS,A00,202860,McKay; Michael J,13,0,28,15
1683319460559,MGT 45,A00,202861,Pecore; Joseph P.,13,0,90,77
1683319461584,MGT 100,A00,202863,Yavorsky; Daniel Ryan,28,0,90,62
1683319462611,MGT 103,A00,202864,Ehrich; Kristine R,0,17,90,90
1683319463639,MGT 112,A00,202865,Ehrich; Kristine R,15,0,90,75
1683319464666,MGT 121A,A00,202868,Staff,0,19,0,0
1683319465690,MGT 131B,A00,202869,Anderson; John Charles,59,0,90,31
1683319466715,MGT 136,A00,202871,Lindenberger; Wade Douglas,84,0,90,6
1683319467743,MGT 164,A00,202873,Staff,0,68,90,91
1683319468770,MGT 164GS,A00,202874,McKay; Mary A,13,0,28,15
1683319469794,MGT 180,A00,202875,Staff,0,50,90,91
1683319470818,MMW 11R,A01,205019,Herbst; Matthew,3,0,30,27
1683319470818,MMW 11R,A02,205026,Herbst; Matthew,29,0,30,1
1683319471842,MMW 15,A01,193512,Chang; Edmond Yi-Teh,0,9,28,28
1683319471842,MMW 15,A02,193513,Chang; Edmond Yi-Teh,0,5,28,28
1683319471842,MMW 15,A03,193514,Chang; Edmond Yi-Teh,0,5,28,28
1683319471842,MMW 15,A04,193515,Chang; Edmond Yi-Teh,0,5,28,28
1683319471842,MMW 15,A05,193516,Chang; Edmond Yi-Teh,0,4,28,28
1683319471842,MMW 15,A06,193517,Chang; Edmond Yi-Teh,0,5,28,28
1683319471842,MMW 15,B01,193519,Chang; Edmond Yi-Teh,0,4,28,28
1683319471842,MMW 15,B02,193520,Chang; Edmond Yi-Teh,0,5,28,28
1683319471842,MMW 15,B03,193521,Chang; Edmond Yi-Teh,0,4,28,28
1683319471842,MMW 15,B04,193522,Chang; Edmond Yi-Teh,0,4,28,28
1683319471842,MMW 15,B05,193523,Chang; Edmond Yi-Teh,0,5,28,28
1683319471842,MMW 15,B06,193524,Chang; Edmond Yi-Teh,0,4,28,28
1683319472865,MMW 122,A01,193526,Rahimi; Babak,0,14,28,28
1683319472865,MMW 122,A02,193527,Rahimi; Babak,0,14,28,28
1683319472865,MMW 122,A03,193528,Rahimi; Babak,0,0,0,0
1683319472865,MMW 122,A04,193529,Rahimi; Babak,0,0,0,0
1683319473890,MUS 1A,A01,186663,Staff,0,20,35,35
1683319474918,MUS 4,A01,186715,Staff,0,12,35,35
1683319475942,MUS 5R,A01,186796,Dubnov; Shlomo,0,17,35,35
1683319476966,MUS 6,A01,186798,Staff,0,3,25,25
1683319477989,MUS 7,A01,186830,Staff,12,0,35,23
1683319479019,MUS 8,A01,186930,Staff,0,26,35,35
1683319480047,MUS 15,A01,186932,Staff,0,15,35,35
1683319480047,MUS 15,B01,186934,Staff,0,15,35,35
1683319481074,MUS 80,A00,186935,Staff,2,0,20,18
1683319481074,MUS 80,B00,186936,Staff,25,0,25,0
1683319482099,NANO 11,A00,204702,Lipomi; Darren John,0,0,0,0
1683319483159,NANO 15,A01,204709,Yang; Kesong,0,1,0,0
1683319484183,NANO 114,A00,202069,Jahed Motlagh; Zeinab,3,0,10,7
1683319485206,PHIL 1,A00,186955,Grush; Rick Scott,32,0,40,8
1683319486230,PHIL 10,A01,186973,Grush; Rick Scott,28,0,35,7
1683319486230,PHIL 10,A02,186974,Grush; Rick Scott,33,0,35,2
1683319487258,PHIL 13,A01,186976,Staff,7,0,35,28
1683319487258,PHIL 13,A02,186977,Staff,16,0,35,19
1683319488282,PHIL 14,A01,186979,Staff,31,0,35,4
1683319488282,PHIL 14,A02,186986,Staff,32,0,35,3
1683319489307,PHIL 28,A01,186988,Staff,16,0,30,14
1683319489307,PHIL 28,A02,186989,Staff,1,0,30,29
1683319489307,PHIL 28,A03,186990,Staff,9,0,30,21
1683319489307,PHIL 28,A04,186991,Staff,26,0,30,4
1683319490331,PHIL 120,A00,186997,Staff,23,0,40,17
1683319491358,PHIL 137,A00,187003,Staff,9,0,40,31
1683319492384,PHIL 150,A00,187015,Staff,47,0,70,23
1683319493408,PHIL 167,A00,187021,Lamey; Andy M.,35,0,40,5
1683319494431,PHIL 174,A01,202226,Staff,17,0,20,3
1683319494431,PHIL 174,A02,202235,Staff,20,0,20,0
1683319495455,PHIL 191A,A00,258918,Staff,0,0,1,1
1683319496479,PHYS 1A,A00,187028,Staff,27,0,60,33
1683319497561,PHYS 1AL,001,187036,Staff,3,0,30,27
1683319497561,PHYS 1AL,002,187049,Staff,18,0,30,12
1683319498590,PHYS 1B,A00,187058,Staff,22,0,60,38
1683319499617,PHYS 1BL,001,187064,Staff,0,0,30,30
1683319499617,PHYS 1BL,002,187070,Staff,5,0,30,25
1683319500641,PHYS 1C,A00,187082,Staff,31,0,120,89
1683319501670,PHYS 1CL,001,187088,Staff,0,9,30,30
1683319501670,PHYS 1CL,002,187089,Staff,0,2,30,30
1683319501670,PHYS 1CL,009,262693,Staff,11,0,30,19
1683319502694,PHYS 2B,A01,187097,Staff,54,0,115,61
1683319503718,PHYS 2C,A01,187099,Staff,67,0,115,48
1683319504746,PHYS 2CL,A01,187101,Staff,5,0,28,23
1683319504746,PHYS 2CL,A02,187102,Staff,15,0,28,13
1683319505775,PHYS 2D,A01,187123,Shotwell; Brian,95,0,115,20
1683319506800,PHYS 4B,A01,187133,Grinstein; Benjamin,35,0,50,15
1683319507823,POLI 10,A00,188819,Staff,0,4,50,50
1683319508846,POLI 11,A00,188827,Staff,43,0,50,7
1683319509873,POLI 13R,A00,188828,Staff,0,1,20,20
1683319510898,POLI 27,A01,188830,Elgin; Samuel Zincke,0,1,70,70
1683319511923,POLI 30,A00,188832,Desposato; Scott,31,0,50,19
1683319512949,POLI 102F,A00,188834,Staff,3,0,40,37
1683319513976,POLI 104A,A00,188852,Staff,14,0,30,16
1683319515001,POLI 104I,A00,188853,Staff,0,6,20,20
1683319516030,POLI 110B,A00,188854,Wiens; David,7,0,20,13
1683319517054,POLI 112A,A00,188855,Wiens; David,5,0,30,25
1683319518079,POLI 117R,A00,188856,Forman; Fonna,0,11,20,20
1683319519106,POLI 118,A00,188857,Ingham; Sean,8,0,20,12
1683319520145,POLI 120G,A00,188858,Staff,9,0,30,21
1683319521173,POLI 131CR,A00,188863,Hoston; Germaine,24,0,50,26
1683319522197,POLI 133,A00,188864,Nellis; Gareth Hb,44,0,50,6
1683319523224,POLI 134D,A00,188865,Desposato; Scott,27,0,30,3
1683319524251,POLI 142A,A00,188871,Gartzke; Erik,22,0,50,28
1683319525278,POLI 142K,A00,188874,Staff,38,0,50,12
1683319526305,POLI 143,A00,188940,Gartzke; Erik,16,0,30,14
1683319527332,POLI 153,A00,188943,Staff,3,0,20,17
1683319528359,POLI 160AA,A00,188944,Staff,12,0,40,28
1683319529386,POLI 170A,A00,188945,Staff,11,0,30,19
1683319531435,PSYC 1,A00,188952,Staff,37,0,90,53
1683319532458,PSYC 2,B00,188953,Staff,19,0,35,16
1683319533486,PSYC 6,A00,188970,Staff,47,0,60,13
1683319534513,PSYC 7,A00,188973,Staff,37,0,45,8
1683319535542,PSYC 60,A01,188980,Rickard; Timothy C.,43,0,60,17
1683319536570,PSYC 70,A01,189001,Steiner; Eric Tomas,24,0,45,21
1683319537594,PSYC 100,A00,189005,Lacefield; Katharine I,0,99,120,120
1683319538618,PSYC 102,A00,189008,Staff,10,0,30,20
1683319539641,PSYC 106,B00,189026,Gorman; Michael R.,36,0,60,24
1683319540668,PSYC 114,B01,189033,Winkielman; Piotr,0,32,30,30
1683319541695,PSYC 131,A00,189036,Anagnostaras; Stephan,0,43,60,60
1683319542722,PSYC 136,A00,189041,Lowe; Angela Beth,0,7,25,25
1683319543745,PSYC 137,A00,189057,Winkielman; Piotr,0,34,25,25
1683319544769,PSYC 144,A00,189107,Wixted; John T,0,7,50,50
1683319546819,PSYC 162,A00,189142,Staff,0,8,85,85
1683319547844,PSYC 172,A00,189144,Gorman; Michael R.,0,7,30,30
1683319549892,PSYC 179,A00,189146,Lacefield; Katharine I,0,84,120,120
1683319550917,PSYC 181,A00,189147,Anagnostaras; Stephan,0,44,90,90
1683319551941,PSYC 190R,A00,189148,Barner; David A.,0,22,80,80
1683319552965,PSYC 191,A00,189275,Rickard; Timothy C.,0,7,25,25
1683319553989,PSYC 193,A00,189276,Chapman; Eddie Nathaniel,0,1,0,4
1683319555017,PSYC 193L,A01,189281,Lowe; Angela Beth,12,0,20,8
1683319555017,PSYC 193L,B01,189285,Staff,28,0,35,7
1683319556044,RELI 149,A00,187137,Rahimi; Babak,7,0,40,33
1683319557069,SE 9,A01,187315,Staff,0,2,18,18
1683319558093,SE 101B,A00,187409,Staff,24,0,30,6
1683319559119,SE 110B,A00,187444,Staff,10,0,40,30
1683319560145,SE 130B,A00,187449,Staff,31,0,40,9
1683319561170,SE 150A,A00,187516,Staff,9,0,20,11
1683319562194,SE 154,A00,187528,Staff,30,0,50,20
1683319563220,SIO 3,A01,258171,Staff,35,0,40,5
1683319564247,SIO 10,A00,187144,Cook; Geoffrey W,0,3,75,75
1683319565274,SIO 45,A00,187152,Cook; Geoffrey W,1,0,100,99
1683319566309,SIO 109R,A00,194486,Staff,0,3,20,20
1683319568362,SIO 187,A01,187233,Kacev; David,12,0,40,28
1683319569391,SOCI 1,A01,258656,Thorpe; Charles Robert,28,0,30,2
1683319569391,SOCI 1,A02,258658,Thorpe; Charles Robert,30,0,30,0
1683319569391,SOCI 1,A03,258661,Thorpe; Charles Robert,25,0,25,0
1683319569391,SOCI 1,A04,258666,Thorpe; Charles Robert,22,0,25,3
1683319569391,SOCI 1,A05,258897,Thorpe; Charles Robert,23,0,25,2
1683319569391,SOCI 1,A06,258898,Thorpe; Charles Robert,25,0,25,0
1683319570419,SOCI 30,A01,258903,Pardo Guerra; Juan Pablo,16,0,30,14
1683319571447,SOCI 102,A00,258904,Staff,9,0,25,16
1683319572472,SOCI 106,A00,258905,Staff,19,0,25,6
1683319573497,SOCI 111,A00,258907,Ribas Norris; Janet Vanesa,26,0,30,4
1683319574523,SOCI 121R,A00,258908,Pardo Guerra; Juan Pablo,11,0,30,19
1683319575547,SOCI 126,A01,203330,Staff,14,0,20,6
1683319576571,SOCI 131,A00,258909,Thorpe; Charles Robert,31,0,60,29
1683319577595,SOCI 135,A00,258910,Payne; Christine Anna,0,9,30,30
1683319578624,SOCI 157,A00,258911,Staff,12,0,30,18
1683319579648,SOCI 184,A00,258912,Staff,25,0,30,5
1683319580673,SOCI 188D,A00,258913,Staff,21,0,30,9
1683319581697,SYN 2,001,187529,Staff,9,0,16,7
1683319581697,SYN 2,002,201452,Staff,0,18,16,16
1683319581697,SYN 2,003,201469,Staff,4,0,16,12
1683319582720,SYN 100,A01,187531,Staff,0,9,20,20
1683319582720,SYN 100,B01,201491,Staff,0,12,20,20
1683319583747,TDAC 1,A00,189286,Walsh; Kim C.,3,0,20,17
1683319583747,TDAC 1,B00,189287,Harting; Carla Kelso,11,0,20,9
1683319584773,TDAC 101,A00,189300,Walsh; Kim C.,16,0,20,4
1683319584773,TDAC 101,B00,189301,Harting; Carla Kelso,18,0,20,2
1683319585801,TDAC 102,A00,189304,Basso; Beatrice,14,0,20,6
1683319586827,TDAC 108,A00,189305,Staff,18,0,20,2
1683319587858,TDDE 131,A00,189310,Staff,19,0,20,1
1683319587858,TDDE 131,B00,189314,Staff,19,0,20,1
1683319587858,TDDE 131,C00,189315,Staff,48,0,50,2
1683319587858,TDDE 131,D00,189316,Staff,14,0,15,1
1683319587858,TDDE 131,E00,204841,Staff,20,0,20,0
1683319588881,TDGE 10,A00,189289,Staff,30,0,50,20
1683319588881,TDGE 10,B00,189290,Havis; Allan,1,0,50,49
1683319589916,TDGE 11,A00,189291,Fulton; Julia,0,3,50,50
1683319589916,TDGE 11,B00,189292,Staff,20,0,25,5
1683319589916,TDGE 11,C00,260270,Staff,0,0,0,0
1683319590940,TDGE 25,A00,189294,Staff,3,0,20,17
1683319591964,TDGE 124,A00,189318,Fulton; Julia,0,8,50,50
1683319592988,TDGE 125,A00,189319,Staff,13,0,25,12
1683319592988,TDGE 125,B00,189320,Staff,23,0,25,2
1683319594012,TDGE 127,A00,189322,Havis; Allan,0,0,50,50
1683319595038,TDHT 101,A00,189323,Staff,18,0,25,7
1683319595038,TDHT 101,B00,189324,Staff,25,0,25,0
1683319596062,TDHT 102,A00,189325,Staff,49,0,50,1
1683319597090,TDMV 1,A00,189295,Arcidiacono; Kristin,20,0,30,10
1683319597090,TDMV 1,B00,189296,Caligagan; Maria T.,24,0,30,6
1683319598114,TDMV 2,A00,189297,Sammartano; Tonnie,28,0,30,2
1683319598114,TDMV 2,B00,189299,Arcidiacono; Kristin,24,0,30,6
1683319599138,TDMV 3,A00,204998,Rincon; Alicia,22,0,30,8
1683319600162,TDMV 120,A00,189458,Sammartano; Tonnie,28,0,30,2
1683319601243,TDMV 138,A00,189541,Jun; Grace Shin Hae,22,0,40,18
1683319602267,TDMV 142,A00,189717,Caligagan; Tony,23,0,30,7
1683319602267,TDMV 142,B00,189718,Caligagan; Maria T.,25,0,30,5
1683319603294,TMC 2,A01,187533,Staff,25,0,25,0
1683319603294,TMC 2,A02,187534,Staff,25,0,25,0
1683319604319,USP 1,A01,187536,Kwak; Nancy,0,16,25,25
1683319605348,USP 5,A01,187538,Staff,9,0,25,16
1683319606373,USP 101,A00,199253,Staff,0,4,0,0
1683319607398,USP 124,A00,187562,Boomhower; Matthew Charles,1,0,30,29
1683319608425,USP 138,A00,187582,Staff,20,0,25,5
1683319609449,USP 152,A01,187597,Staff,4,0,25,21
1683319610476,USP 153,A00,187598,Staff,19,0,25,6
1683319611503,USP 168,A00,187607,Kwak; Nancy,2,0,5,3
1683319612528,USP 173,A00,187619,Staff,4,0,25,21
1683319613555,USP 181,A00,187638,Staff,0,0,25,25
1683319614584,VIS 103,A00,187650,Cruz; Edwin Teddy,23,0,75,52
1683319615609,VIS 110D,A00,187669,Staff,12,0,22,10
1683319616633,VIS 127C,A00,187720,Shen; Kuiyi,68,0,146,78
1683319617656,VIS 149,A00,187731,Yoldas; Pinar,0,14,22,22
1683319618681,VIS 151,A01,188091,Staff,22,0,34,12
1683319618681,VIS 151,A02,188092,Staff,11,0,34,23
1683319619707,VIS 160B,A00,188093,Stalbaum; Brett,0,0,10,10
1683319621758,WCWP 10B,A00,201720,Staff,10,0,15,5
1683319621758,WCWP 10B,B00,201722,Staff,8,0,15,7
1683319622782,WCWP 100,A00,201725,Gagnon; Jeffrey C,0,0,2,2
1683319622782,WCWP 100,B00,201727,Staff,0,4,15,15
1683319625903,ANBI 133,A00,258401,Wilder; Linnea Lorene,34,0,40,6
1683319626926,ANBI 140,A00,258395,Hrvoj Mihic; Branka,18,0,25,7
1683319627950,ANSC 120,A00,258402,Bialecki; Jon Anthony,27,0,40,13
1683319628978,ANSC 144,A00,258400,Staff,14,0,40,26
1683319631029,ANSC 166,A00,258396,Parish; Steven Martin,157,0,175,18
1683319632054,ANSC 180,A00,193533,Staff,9,0,20,11
1683319633078,ANSC 188,A00,258397,Jassal; Aftab,33,0,40,7
1683319634105,ANTH 3,A01,258316,Staff,23,0,30,7
1683319635133,ANTH 5,A00,258394,Semendeferi; Ekaterini,16,0,20,4
1683319636157,ANTH 21,A01,258331,Staff,9,0,40,31
1683319637181,ANTH 103,A00,258398,Varma; Saiba,15,0,25,10
1683319638212,AWP 10,001,202034,Staff,0,0,0,0
1683319638212,AWP 10,002,202035,Staff,0,0,0,0
1683319638212,AWP 10,003,202036,Staff,0,0,0,0
1683319638212,AWP 10,004,202037,Staff,0,0,0,0
1683319638212,AWP 10,005,202038,Staff,0,0,0,0
1683319638212,AWP 10,006,202039,Staff,0,0,0,0
1683319638212,AWP 10,007,202040,Staff,0,0,0,0
1683319638212,AWP 10,008,202041,Staff,0,0,0,0
1683319638212,AWP 10,009,202042,Staff,0,0,0,0
1683319638212,AWP 10,010,202043,Staff,0,0,0,0
1683319638212,AWP 10,011,202044,Staff,0,0,0,0
1683319638212,AWP 10,012,202045,Staff,0,0,0,0
1683319638212,AWP 10,013,202046,Staff,0,0,0,0
1683319638212,AWP 10,014,202047,Staff,0,0,0,0
1683319638212,AWP 10,015,202048,Staff,0,0,0,0
1683319638212,AWP 10,016,202049,Staff,0,0,0,0
1683319638212,AWP 10,017,202050,Staff,0,0,0,0
1683319638212,AWP 10,018,202051,Staff,0,0,0,0
1683319638212,AWP 10,019,202052,Staff,0,0,0,0
1683319638212,AWP 10,020,202053,Staff,0,0,0,0
1683319638212,AWP 10,021,202054,Staff,0,0,0,0
1683319638212,AWP 10,022,202055,Staff,0,0,0,0
1683319638212,AWP 10,023,202056,Staff,0,0,0,0
1683319638212,AWP 10,024,202057,Staff,0,0,0,0
1683319638212,AWP 10,025,202058,Staff,0,0,0,0
1683319638212,AWP 10,026,202059,Staff,0,0,0,0
1683319639239,AWP 102,001,202032,Staff,0,0,0,0
1683319639239,AWP 102,002,202033,Staff,0,0,0,0
1683319640264,BENG 100,A01,254234,Taylor Amos; Alyssa C,31,0,40,9
1683319641290,BENG 196,001,270013,Engler; Adam J.,9999,0,9999,0
1683319642317,BICD 100R,A01,202018,Smith; Laurie,0,7,32,32
1683319642317,BICD 100R,A02,202019,Smith; Laurie,0,2,32,32
1683319642317,BICD 100R,A03,202020,Smith; Laurie,0,1,32,32
1683319642317,BICD 100R,A04,202021,Smith; Laurie,8,0,32,24
1683319642317,BICD 100R,A05,202022,Smith; Laurie,12,0,32,20
1683319643345,BICD 136,A01,193242,Gustafson-Brown; Cindy,0,2,32,32
1683319643345,BICD 136,A02,193244,Gustafson-Brown; Cindy,14,0,32,18
1683319644375,BIEB 102,A01,193249,Butler; Shannon Rhey,0,2,32,32
1683319644375,BIEB 102,A02,193251,Butler; Shannon Rhey,0,0,32,32
1683319644375,BIEB 102,A03,193253,Butler; Shannon Rhey,0,1,32,32
1683319644375,BIEB 102,A04,193255,Butler; Shannon Rhey,17,0,32,15
1683319644375,BIEB 102,A05,193265,Butler; Shannon Rhey,26,0,32,6
1683319644375,BIEB 102,A06,193269,Butler; Shannon Rhey,16,0,32,16
1683319646425,BIEB 150,A01,193274,Staff,0,0,32,32
1683319646425,BIEB 150,A02,193285,Staff,23,0,32,9
1683319647449,BIEB 194,A00,193286,Kurle; Carolyn M.,22,0,32,10
1683319648473,BILD 1,A01,192291,Staff,16,0,32,16
1683319648473,BILD 1,A02,192292,Staff,30,0,32,2
1683319648473,BILD 1,B01,192520,Reuther; Keefe,0,1,0,0
1683319648473,BILD 1,B02,192532,Reuther; Keefe,0,1,0,0
1683319649501,BILD 3,A01,192556,Butler; Shannon Rhey,0,0,32,32
1683319649501,BILD 3,A02,192581,Butler; Shannon Rhey,5,0,32,27
1683319649501,BILD 3,A03,192611,Butler; Shannon Rhey,23,0,32,9
1683319649501,BILD 3,A04,192612,Butler; Shannon Rhey,25,0,32,7
1683319649501,BILD 3,A05,192613,Butler; Shannon Rhey,27,0,32,5
1683319649501,BILD 3,A06,192679,Butler; Shannon Rhey,27,0,32,5
1683319649501,BILD 3,A07,192682,Butler; Shannon Rhey,22,0,32,10
1683319650525,BILD 4,A01,192836,Reuther; Keefe,0,0,24,24
1683319650525,BILD 4,A02,193044,Reuther; Keefe,4,0,24,20
1683319651548,BILD 10,A01,193142,Gustafson-Brown; Cindy,30,0,32,2
1683319651548,BILD 10,A02,193149,Gustafson-Brown; Cindy,31,0,32,1
1683319652573,BIMM 100,A01,193301,Staff,0,6,32,32
1683319652573,BIMM 100,A02,193312,Staff,0,5,32,32
1683319652573,BIMM 100,A03,193323,Staff,0,8,32,32
1683319653602,BIMM 101,A01,193329,McDonnell; Lisa Marie,0,3,24,24
1683319653602,BIMM 101,A02,193339,McDonnell; Lisa Marie,0,3,24,24
1683319653602,BIMM 101,B01,193354,McDonnell; Lisa Marie,0,3,24,24
1683319653602,BIMM 101,B02,193357,McDonnell; Lisa Marie,0,3,24,24
1683319654630,BIMM 110,A01,193377,Tat; John,0,11,32,32
1683319654630,BIMM 110,A02,193378,Tat; John,1,9,32,31
1683319655654,BIMM 120,A01,206116,Staff,0,0,32,32
1683319655654,BIMM 120,A02,206117,Staff,8,0,32,24
1683319655654,BIMM 120,A03,206121,Staff,21,0,32,11
1683319656678,BIPN 100,A01,193393,Park; Ji Young,0,14,32,32
1683319656678,BIPN 100,A02,193402,Park; Ji Young,0,12,32,32
1683319656678,BIPN 100,A03,193413,Park; Ji Young,0,14,32,32
1683319656678,BIPN 100,A04,193414,Park; Ji Young,0,13,32,32
1683319657703,BIPN 102,A01,193429,Staff,0,0,32,32
1683319657703,BIPN 102,A02,193438,Staff,22,0,32,10
1683319658728,BIPN 106,A01,193450,Reyes Gonzalez; Catalina,0,2,40,40
1683319659753,BIPN 134,A01,193465,Cooke; James Edward,0,0,32,32
1683319659753,BIPN 134,A02,193474,Cooke; James Edward,27,0,32,5
1683319659753,BIPN 134,A03,193485,Cooke; James Edward,29,0,32,3
1683319659753,BIPN 134,A04,193486,Cooke; James Edward,21,0,32,11
1683319659753,BIPN 134,A05,193491,Cooke; James Edward,31,0,32,1
1683319659753,BIPN 134,A06,193501,Cooke; James Edward,30,0,32,2
1683319659753,BIPN 134,A07,193510,Cooke; James Edward,29,0,32,3
1683319661803,BISP 194,A00,222522,Staff,15,0,32,17
1683319662830,CAT 124,A01,202407,Staff,20,0,25,5
1683319663861,CAT 125,A00,202408,Marchisotto; Jennifer Anne,4,0,20,16
1683319664886,CAT 125R,A00,202409,Smith; Lauryn Alissa,0,11,20,20
1683319664886,CAT 125R,B00,202410,Morales; Celeste Georgianna,0,11,20,20
1683319664886,CAT 125R,C00,202411,Irwin; Matthew Joseph,0,10,20,20
1683319665911,CENG 15,A01,204712,Yang; Kesong,0,1,0,0
1683319666935,CENG 114,A00,202070,Jahed Motlagh; Zeinab,5,0,20,15
1683319667959,CGS 105,A00,185477,Wesling; Megan E.,24,0,40,16
1683319668983,CGS 106,A00,185494,Staff,13,0,22,9
1683319670006,CGS 108,A00,185495,Staff,14,0,20,6
1683319671030,CGS 114,A00,185496,Staff,13,0,18,5
1683319672055,CGS 119,A00,185501,Staff,15,0,20,5
1683319673079,CGS 120,A00,185511,Staff,13,0,20,7
1683319674103,CHEM 4,A01,184675,Bussey; Thomas J,96,0,100,4
1683319675125,CHEM 6A,A01,184677,Staff,34,0,60,26
1683319676152,CHEM 6B,A01,184679,Staff,65,0,100,35
1683319677181,CHEM 6C,A01,184681,Bussey; Thomas J,1,0,50,49
1683319677181,CHEM 6C,A02,184682,Bussey; Thomas J,34,0,50,16
1683319678206,CHEM 40A,A01,184684,Albizati; Kim F.,37,0,100,63
1683319679229,CHEM 40B,A01,184686,Albizati; Kim F.,0,20,100,100
1683319680257,CHEM 41B,A01,184690,Staff,52,0,100,48
1683319681281,COGS 3,A01,184715,Boyle; Mary E. T.,0,25,40,40
1683319682309,COGS 14B,A01,185172,Staff,0,15,38,38
1683319683336,COGS 18,A01,184736,Staff,18,0,80,62
1683319684367,COGS 100,A01,184932,Staff,0,5,73,73
1683319685391,COGS 101A,A01,184935,Staff,0,38,30,30
1683319686416,COGS 101B,A01,184944,Staff,0,2,30,30
1683319687439,COGS 101C,A01,184946,Staff,0,12,30,30
1683319688467,COGS 102A,A01,184951,Johnson; Christine M.,2,0,40,38
1683319689491,COGS 107B,A01,184953,Mooshagian; Eric Frederick,0,50,40,40
1683319690516,COGS 118B,A01,184959,Gupta; Anjum,0,48,40,40
1683319691540,COGS 153,A00,184961,Staff,0,15,30,30
1683319692568,COGS 177,A00,184962,Staff,0,21,30,30
1683319693592,COGS 187A,A01,184969,Boyle; Mary E. T.,0,17,40,40
1683319694617,COMM 10,A01,185174,Staff,0,5,25,25
1683319694617,COMM 10,A02,185189,Staff,0,5,25,25
1683319694617,COMM 10,A03,269821,Staff,0,0,0,0
1683319695641,COMM 100B,A01,185475,Staff,0,0,0,2
1683319695641,COMM 100B,A02,185476,Staff,14,0,25,11
1683319696667,COMM 100C,A01,185314,Staff,1,0,25,24
1683319696667,COMM 100C,A02,185327,Staff,19,0,25,6
1683319697694,COMM 110M,A00,185349,Staff,2,0,40,38
1683319698719,COMM 113T,A00,185352,Staff,25,0,40,15
1683319699743,COMM 114I,A00,185353,Staff,33,0,40,7
1683319700770,COMM 131,A00,185354,Staff,19,0,30,11
1683319701798,CSE 8A,A50,185358,Cao; Yingjun,0,46,10,10
1683319702829,CSE 8B,A01,185362,Staff,1,47,50,49
1683319703860,CSE 11,A01,185416,Cao; Yingjun,0,92,10,10
1683319704948,CSE 20,A01,185445,Briones; Jor-el Thomas Caparas,5,0,25,20
1683319705975,CSE 21,A01,185447,Staff,10,0,50,40
1683319707004,CSE 101,A01,185451,Staff,0,12,50,50
1683319707004,CSE 101,B01,185453,Jones; Miles E,0,11,50,50
1683319709053,CSE 141,A01,185458,Eldon; John,20,0,100,80
1683319710077,CSE 141L,A01,185461,Eldon; John,12,0,100,88
1683319711106,CSE 142,A01,185463,Staff,36,0,60,24
1683319711106,CSE 142,B01,201355,Staff,0,7,60,60
1683319712134,CSE 142L,A01,185470,Staff,36,0,60,24
1683319712134,CSE 142L,B01,201417,Staff,0,6,60,60
1683319713161,CSE 190,A00,201433,Staff,32,0,49,17
1683319714187,DOC 1,A01,259136,Strom; Megan C.,7,0,15,8
1683319714187,DOC 1,A02,259137,Strom; Megan C.,14,0,15,1
1683319714187,DOC 1,A03,259138,Strom; Megan C.,14,0,15,1
1683319714187,DOC 1,A04,259139,Strom; Megan C.,14,0,15,1
1683319715211,DOC 100D,A00,259140,Pass; Natalye Joann,17,0,25,8
1683319716239,DSGN 1,A01,184749,Rill; Bryan,0,25,30,30
1683319717264,DSGN 100,A01,185168,Staff,0,2,25,25
1683319718291,ECE 5,A01,185626,Morris; Karcher William,0,10,0,0
1683319719315,ECE 101,A01,185628,Staff,17,0,70,53
1683319720340,ECE 107,A01,185635,Baghdadchi; Saharnaz,0,0,20,20
1683319720340,ECE 107,A02,185638,Baghdadchi; Saharnaz,4,0,20,16
1683319721364,ECE 148,A01,185647,Silberman; Jack,0,0,16,16
1683319722389,ECON 1,A01,185537,Crane; Meredith Helen,54,0,70,16
1683319723412,ECON 3,A01,185549,Crane; Meredith Helen,33,0,70,37
1683319724438,ECON 4,A01,203354,Anderson; John Charles,0,4,10,10
1683319725465,ECON 100A,A01,185574,Staff,0,4,40,40
1683319726492,ECON 100B,A01,185576,Staff,0,22,40,40
1683319727521,ECON 100C,A01,185589,Newhouse; Herbert S,30,0,70,40
1683319728545,ECON 105,A00,185608,Vespa; Emanuel Ignacio,19,0,35,16
1683319729572,ECON 109,A01,185610,Shishkin; Denis,10,0,35,25
1683319730597,ECON 110A,A01,185612,Staff,11,0,40,29
1683319731624,ECON 120A,A01,185615,Staff,20,0,40,20
1683319732651,ECON 120C,A01,185617,Sun; Yixiao,0,20,70,70
1683319733675,ECON 144,A00,203346,Squires; Dale E,3,0,35,32
1683319734704,ECON 171,A01,203349,Newhouse; Herbert S,0,1,35,35
1683319735729,ECON 173A,A01,185621,Toda; Alexis Akira,21,0,35,14
1683319736754,EDS 25,A01,202413,Staff,0,1,0,0
1683319736754,EDS 25,A02,202414,Staff,0,1,0,0
1683319736754,EDS 25,A03,202415,Staff,0,0,0,0
1683319736754,EDS 25,A04,202416,Staff,0,1,0,0
1683319736754,EDS 25,A05,202439,Staff,0,0,0,0
1683319736754,EDS 25,A06,202440,Staff,0,0,0,0
1683319736754,EDS 25,B01,202631,Staff,0,0,0,0
1683319736754,EDS 25,B02,202632,Staff,0,0,0,0
1683319736754,EDS 25,B03,202639,Staff,0,0,0,0
1683319736754,EDS 25,B04,202640,Staff,0,0,0,0
1683319736754,EDS 25,B05,202643,Staff,0,0,0,0
1683319736754,EDS 25,B06,202644,Staff,0,0,0,0
1683319737785,EDS 38,A01,202659,Black; Alison Michelle,24,0,25,1
1683319738809,EDS 115,A00,202652,Staff,17,0,30,13
1683319739836,EDS 125,A00,202649,Staff,14,0,30,16
1683319740864,EDS 126,A01,203332,Staff,30,0,30,0
1683319741893,EDS 139,A00,202838,Staff,16,0,25,9
1683319742916,EDS 146,A01,202655,Staff,14,0,25,11
1683319743941,ENG 15,A00,185667,Staff,0,1,0,0
1683319743941,ENG 15,B00,185672,Staff,0,0,0,0
1683319743941,ENG 15,C00,185675,Staff,0,0,0,0
1683319743941,ENG 15,D00,185682,Staff,0,0,0,0
1683319743941,ENG 15,E00,185684,Staff,0,0,0,0
1683319744965,ETHN 103,A00,185710,Staff,0,3,35,35
1683319745990,ETHN 103A,A00,199228,Man; Simeon S,2,0,9,7
1683319747014,ETHN 109,A00,185711,Staff,18,0,35,17
1683319748038,ETHN 142,A00,185726,Staff,0,4,30,30
1683319749065,ETHN 163J,A00,199229,Man; Simeon S,5,0,8,3
1683319750091,ETHN 168,A00,185727,Staff,8,0,10,2
1683319751114,ETHN 182,A00,185728,Staff,1,0,35,34
1683319752141,ETHN 183,A00,185737,Staff,8,0,18,10
1683319753169,GLBH 111,A01,209361,Burgos; Jose L.,0,0,0,0
1683319755223,HIEU 104,A00,185792,Staff,16,0,20,4
1683319756247,HIEU 115,A00,185800,Staff,1,0,20,19
1683319757270,HIEU 128,A00,185801,Staff,0,7,20,20
1683319758294,HIEU 147,A00,185802,Staff,16,0,20,4
1683319759319,HIEU 154,A00,185823,Staff,12,0,20,8
1683319760343,HILA 102,A00,185826,Staff,13,0,20,7
1683319761370,HILD 2C,A01,185778,Staff,0,12,20,20
1683319762393,HILD 7B,A01,185780,Kwak; Nancy,0,15,32,32
1683319762393,HILD 7B,A02,185781,Kwak; Nancy,0,18,32,32
1683319763417,HILD 30,A01,185791,Staff,14,0,20,6
1683319764442,HISC 119,A00,185830,Golan; Tal,0,9,20,20
1683319765469,HITO 156GS,A00,185831,Patterson; Patrick H.,0,0,0,23
1683319766496,HIUS 103,A00,185832,Man; Simeon S,0,6,20,20
1683319767523,HIUS 117,A00,185836,Kwak; Nancy,2,0,20,18
1683319768549,HIUS 125,A00,185840,Man; Simeon S,0,0,23,23
1683319769576,HIUS 149,A00,185845,Staff,0,0,20,20
1683319770603,HUM 3,A01,185882,Zavodny; Tatiana Sophia,0,6,50,50
1683319770603,HUM 3,B01,185899,Caldwell; Michael Alan,0,19,50,50
1683319771626,HUM 3GS,A00,185900,Patterson; Patrick H.,0,0,0,23
1683319772649,HUM 4,A01,185938,Zroka; Amy Liane,31,0,50,19
1683319772649,HUM 4,B01,185956,Watkins; Eric,0,2,50,50
1683319772649,HUM 4,B02,202209,Watkins; Eric,0,2,50,50
1683319772649,HUM 4,B03,202210,Watkins; Eric,0,0,50,50
1683319773675,HUM 5,A01,185958,West; Geoffrey Scott,3,0,50,47
1683319773675,HUM 5,A02,202215,West; Geoffrey Scott,0,0,50,50
1683319774701,INTL 190,A00,185959,Gagnon; Jeffrey C,0,0,0,9
1683319774701,INTL 190,B00,185960,Lettieri; Michael Joseph,0,0,0,1
1683319775729,JAPN 180,A00,254509,Staff,5,1,30,25
1683319776757,LATI 10,A01,202853,Kennemore; Amy Michelle,5,0,35,30
1683319776757,LATI 10,A02,202854,Kennemore; Amy Michelle,1,0,35,34
1683319776757,LATI 10,A03,270054,Kennemore; Amy Michelle,30,0,30,0
1683319777783,LATI 180,A00,202855,Kennemore; Amy Michelle,11,0,20,9
1683319778810,LAWS 101,A00,201767,Golan; Tal,0,7,40,40
1683319779833,LIFR 1C,A00,185961,Staff,6,0,20,14
1683319780858,LIFR 1CX,A00,185962,Staff,7,0,20,13
1683319781881,LIFR 1D,A00,185963,Staff,9,0,20,11
1683319782908,LIFR 1DX,A00,185964,Staff,9,0,20,11
1683319783935,LIGN 101,A01,186039,Staff,43,0,50,7
1683319784959,LIGN 165,A00,186040,Staff,18,0,50,32
1683319785985,LTCS 108,A00,186041,Staff,6,0,10,4
1683319787009,LTCS 119,A00,186042,Staff,16,0,20,4
1683319788037,LTCS 130,A00,186043,Wesling; Megan E.,15,0,25,10
1683319790089,LTEA 138,A00,186119,Staff,14,0,40,26
1683319791119,LTEN 124,A00,186148,Staff,6,0,25,19
1683319792147,LTEN 178,A00,186149,Staff,7,0,15,8
1683319793174,LTEN 181,A00,186150,Blanco; John D,33,0,40,7
1683319794197,LTWL 120,A00,186160,Staff,20,0,25,5
1683319795223,LTWL 165,A00,186161,Staff,22,0,25,3
1683319796247,LTWR 100,A00,186162,Staff,0,5,15,15
1683319797273,LTWR 102,A00,186163,Doller; Ben,5,0,15,10
1683319798299,MAE 8,A01,186412,Staff,0,0,0,0
1683319799327,MAE 30B,A00,186445,Bahadori; Mohammad Yousef,83,0,100,17
1683319800354,MAE 40,A00,186592,Bewley; Thomas R,9,0,50,41
1683319801377,MAE 101B,A00,186593,Bahadori; Mohammad Yousef,81,0,100,19
1683319802405,MAE 105,A00,186594,Bandaru; Prabhakar,12,0,50,38
1683319803430,MAE 107,A00,186599,Pham; Hieu Tan,0,6,120,120
1683319804457,MAE 148,A01,186660,Silberman; Jack,3,0,16,13
1683319805487,MATH 10A,A01,188095,Staff,0,6,35,35
1683319806517,MATH 10B,A01,188097,Bowers; Adam R.,0,11,30,30
1683319806517,MATH 10B,A02,188099,Bowers; Adam R.,0,11,30,30
1683319806517,MATH 10B,B01,188104,Bowers; Adam R.,0,10,30,30
1683319806517,MATH 10B,B02,188106,Bowers; Adam R.,0,10,30,30
1683319807542,MATH 10C,A01,188111,Staff,0,18,30,30
1683319807542,MATH 10C,A02,188127,Staff,0,17,30,30
1683319807542,MATH 10C,A03,188131,Staff,0,18,30,30
1683319807542,MATH 10C,B01,188218,Staff,19,0,30,11
1683319807542,MATH 10C,B02,188244,Staff,13,0,30,17
1683319807542,MATH 10C,B03,188277,Staff,16,0,30,14
1683319808638,MATH 18,A01,188344,Bach; Quang Tran,18,0,30,12
1683319808638,MATH 18,A02,188345,Bach; Quang Tran,11,0,30,19
1683319808638,MATH 18,B01,188353,Bach; Quang Tran,10,0,30,20
1683319808638,MATH 18,B02,188354,Bach; Quang Tran,20,0,30,10
1683319809661,MATH 20A,A01,188374,Staff,13,0,35,22
1683319810689,MATH 20B,A01,188382,Ohm; Ko Woon,6,0,30,24
1683319810689,MATH 20B,A02,188383,Ohm; Ko Woon,23,0,30,7
1683319810689,MATH 20B,B01,188385,Ohm; Ko Woon,7,0,30,23
1683319810689,MATH 20B,B02,188392,Ohm; Ko Woon,22,0,30,8
1683319811713,MATH 20C,A01,188394,Harel; Guershon,10,0,30,20
1683319811713,MATH 20C,A02,188395,Harel; Guershon,14,0,30,16
1683319811713,MATH 20C,B01,188404,Harel; Guershon,5,0,30,25
1683319811713,MATH 20C,B02,188405,Harel; Guershon,19,0,30,11
1683319812742,MATH 20D,A01,188414,Hammock; Frances H,0,1,30,30
1683319812742,MATH 20D,A02,188415,Hammock; Frances H,3,0,30,27
1683319812742,MATH 20D,B01,188447,Hammock; Frances H,2,0,30,28
1683319812742,MATH 20D,B02,188486,Hammock; Frances H,8,0,30,22
1683319813766,MATH 20E,A01,188649,Staff,21,0,30,9
1683319813766,MATH 20E,A02,188650,Staff,23,0,30,7
1683319813766,MATH 20E,A03,188673,Staff,0,0,30,30
1683319814790,MATH 102,A01,188675,Staff,0,35,35,35
1683319815817,MATH 103B,A01,188681,Staff,4,0,35,31
1683319815817,MATH 103B,B01,188692,Staff,5,0,35,30
1683319816843,MATH 109,A01,188695,Salehi Golsefidy; Alireza,25,0,35,10
1683319816843,MATH 109,A02,188696,Salehi Golsefidy; Alireza,26,0,35,9
1683319817869,MATH 120A,A01,188698,Eggers; John Dietrich,7,0,35,28
1683319818897,MATH 142B,A01,188736,Ioana; Adrian,0,2,30,30
1683319818897,MATH 142B,A02,188741,Ioana; Adrian,0,1,30,30
1683319818897,MATH 142B,A03,188743,Ioana; Adrian,1,3,30,29
1683319819921,MATH 168A,A01,188790,Staff,0,9,35,35
1683319820946,MATH 170A,A01,188803,Nie; Jiawang,0,2,35,35
1683319820946,MATH 170A,A02,188811,Nie; Jiawang,0,0,35,35
1683319820946,MATH 170A,A03,188814,Nie; Jiawang,0,0,35,35
1683319820946,MATH 170A,A04,188815,Nie; Jiawang,13,0,35,22
1683319821970,MATH 193B,A01,188817,Staff,0,0,35,35
1683319821970,MATH 193B,A02,188818,Staff,6,0,35,29
1683319822997,MGT 4,A01,202857,Anderson; John Charles,62,0,80,18
1683319824021,MGT 12,A00,202858,Lindenberger; Wade Douglas,42,0,90,48
1683319825047,MGT 18,A00,202859,Staff,74,0,90,16
1683319826075,MGT 18GS,A00,202860,McKay; Michael J,13,0,28,15
1683319827099,MGT 45,A00,202861,Pecore; Joseph P.,13,0,90,77
1683319828122,MGT 100,A00,202863,Yavorsky; Daniel Ryan,28,0,90,62
1683319829153,MGT 103,A00,202864,Ehrich; Kristine R,0,18,90,90
1683319830177,MGT 112,A00,202865,Ehrich; Kristine R,15,0,90,75
1683319831200,MGT 121A,A00,202868,Staff,0,19,0,0
1683319832228,MGT 131B,A00,202869,Anderson; John Charles,59,0,90,31
1683319833251,MGT 136,A00,202871,Lindenberger; Wade Douglas,84,0,90,6
1683319834278,MGT 164,A00,202873,Staff,0,68,90,91
1683319835306,MGT 164GS,A00,202874,McKay; Mary A,13,0,28,15
1683319836333,MGT 180,A00,202875,Staff,0,50,90,91
1683319837357,MMW 11R,A01,205019,Herbst; Matthew,3,0,30,27
1683319837357,MMW 11R,A02,205026,Herbst; Matthew,29,0,30,1
1683319838382,MMW 15,A01,193512,Chang; Edmond Yi-Teh,0,9,28,28
1683319838382,MMW 15,A02,193513,Chang; Edmond Yi-Teh,0,5,28,28
1683319838382,MMW 15,A03,193514,Chang; Edmond Yi-Teh,0,5,28,28
1683319838382,MMW 15,A04,193515,Chang; Edmond Yi-Teh,0,5,28,28
1683319838382,MMW 15,A05,193516,Chang; Edmond Yi-Teh,0,4,28,28
1683319838382,MMW 15,A06,193517,Chang; Edmond Yi-Teh,0,5,28,28
1683319838382,MMW 15,B01,193519,Chang; Edmond Yi-Teh,0,4,28,28
1683319838382,MMW 15,B02,193520,Chang; Edmond Yi-Teh,0,5,28,28
1683319838382,MMW 15,B03,193521,Chang; Edmond Yi-Teh,0,4,28,28
1683319838382,MMW 15,B04,193522,Chang; Edmond Yi-Teh,0,4,28,28
1683319838382,MMW 15,B05,193523,Chang; Edmond Yi-Teh,0,5,28,28
1683319838382,MMW 15,B06,193524,Chang; Edmond Yi-Teh,0,4,28,28
1683319839410,MMW 122,A01,193526,Rahimi; Babak,0,14,28,28
1683319839410,MMW 122,A02,193527,Rahimi; Babak,0,14,28,28
1683319839410,MMW 122,A03,193528,Rahimi; Babak,0,0,0,0
1683319839410,MMW 122,A04,193529,Rahimi; Babak,0,0,0,0
1683319840434,MUS 1A,A01,186663,Staff,0,20,35,35
1683319841458,MUS 4,A01,186715,Staff,0,12,35,35
1683319842485,MUS 5R,A01,186796,Dubnov; Shlomo,0,17,35,35
1683319843512,MUS 6,A01,186798,Staff,0,3,25,25
1683319844535,MUS 7,A01,186830,Staff,12,0,35,23
1683319845559,MUS 8,A01,186930,Staff,0,26,35,35
1683319846587,MUS 15,A01,186932,Staff,0,15,35,35
1683319846587,MUS 15,B01,186934,Staff,0,15,35,35
1683319847612,MUS 80,A00,186935,Staff,2,0,20,18
1683319847612,MUS 80,B00,186936,Staff,25,0,25,0
1683319848636,NANO 11,A00,204702,Lipomi; Darren John,0,0,0,0
1683319849663,NANO 15,A01,204709,Yang; Kesong,0,1,0,0
1683319850686,NANO 114,A00,202069,Jahed Motlagh; Zeinab,3,0,10,7
1683319851713,PHIL 1,A00,186955,Grush; Rick Scott,32,0,40,8
1683319852737,PHIL 10,A01,186973,Grush; Rick Scott,28,0,35,7
1683319852737,PHIL 10,A02,186974,Grush; Rick Scott,33,0,35,2
1683319853763,PHIL 13,A01,186976,Staff,7,0,35,28
1683319853763,PHIL 13,A02,186977,Staff,16,0,35,19
1683319854793,PHIL 14,A01,186979,Staff,31,0,35,4
1683319854793,PHIL 14,A02,186986,Staff,32,0,35,3
1683319855821,PHIL 28,A01,186988,Staff,16,0,30,14
1683319855821,PHIL 28,A02,186989,Staff,1,0,30,29
1683319855821,PHIL 28,A03,186990,Staff,9,0,30,21
1683319855821,PHIL 28,A04,186991,Staff,26,0,30,4
1683319856849,PHIL 120,A00,186997,Staff,23,0,40,17
1683319857873,PHIL 137,A00,187003,Staff,9,0,40,31
1683319858899,PHIL 150,A00,187015,Staff,47,0,70,23
1683319859923,PHIL 167,A00,187021,Lamey; Andy M.,35,0,40,5
1683319860948,PHIL 174,A01,202226,Staff,17,0,20,3
1683319860948,PHIL 174,A02,202235,Staff,20,0,20,0
1683319861972,PHIL 191A,A00,258918,Staff,0,0,1,1
1683319862997,PHYS 1A,A00,187028,Staff,27,0,60,33
1683319864020,PHYS 1AL,001,187036,Staff,3,0,30,27
1683319864020,PHYS 1AL,002,187049,Staff,18,0,30,12
1683319865047,PHYS 1B,A00,187058,Staff,22,0,60,38
1683319866072,PHYS 1BL,001,187064,Staff,0,0,30,30
1683319866072,PHYS 1BL,002,187070,Staff,5,0,30,25
1683319867098,PHYS 1C,A00,187082,Staff,31,0,120,89
1683319868121,PHYS 1CL,001,187088,Staff,0,9,30,30
1683319868121,PHYS 1CL,002,187089,Staff,0,2,30,30
1683319868121,PHYS 1CL,009,262693,Staff,11,0,30,19
1683319869144,PHYS 2B,A01,187097,Staff,54,0,115,61
1683319870168,PHYS 2C,A01,187099,Staff,67,0,115,48
1683319871194,PHYS 2CL,A01,187101,Staff,5,0,28,23
1683319871194,PHYS 2CL,A02,187102,Staff,15,0,28,13
1683319872218,PHYS 2D,A01,187123,Shotwell; Brian,95,0,115,20
1683319873242,PHYS 4B,A01,187133,Grinstein; Benjamin,35,0,50,15
1683319874267,POLI 10,A00,188819,Staff,0,4,50,50
1683319875294,POLI 11,A00,188827,Staff,43,0,50,7
1683319876321,POLI 13R,A00,188828,Staff,0,1,20,20
1683319877344,POLI 27,A01,188830,Elgin; Samuel Zincke,0,1,70,70
1683319878372,POLI 30,A00,188832,Desposato; Scott,31,0,50,19
1683319879395,POLI 102F,A00,188834,Staff,3,0,40,37
1683319880422,POLI 104A,A00,188852,Staff,14,0,30,16
1683319881446,POLI 104I,A00,188853,Staff,0,6,20,20
1683319882469,POLI 110B,A00,188854,Wiens; David,7,0,20,13
1683319883496,POLI 112A,A00,188855,Wiens; David,5,0,30,25
1683319884520,POLI 117R,A00,188856,Forman; Fonna,0,11,20,20
1683319885547,POLI 118,A00,188857,Ingham; Sean,8,0,20,12
1683319886573,POLI 120G,A00,188858,Staff,9,0,30,21
1683319887597,POLI 131CR,A00,188863,Hoston; Germaine,24,0,50,26
1683319888622,POLI 133,A00,188864,Nellis; Gareth Hb,44,0,50,6
1683319889645,POLI 134D,A00,188865,Desposato; Scott,27,0,30,3
1683319890670,POLI 142A,A00,188871,Gartzke; Erik,22,0,50,28
1683319891692,POLI 142K,A00,188874,Staff,38,0,50,12
1683319892717,POLI 143,A00,188940,Gartzke; Erik,16,0,30,14
1683319893741,POLI 153,A00,188943,Staff,3,0,20,17
1683319894769,POLI 160AA,A00,188944,Staff,12,0,40,28
1683319895796,POLI 170A,A00,188945,Staff,11,0,30,19
1683319897849,PSYC 1,A00,188952,Staff,37,0,90,53
1683319898873,PSYC 2,B00,188953,Staff,19,0,35,16
1683319899897,PSYC 6,A00,188970,Staff,47,0,60,13
1683319900921,PSYC 7,A00,188973,Staff,37,0,45,8
1683319901945,PSYC 60,A01,188980,Rickard; Timothy C.,43,0,60,17
1683319902969,PSYC 70,A01,189001,Steiner; Eric Tomas,24,0,45,21
1683319903997,PSYC 100,A00,189005,Lacefield; Katharine I,0,99,120,120
1683319905021,PSYC 102,A00,189008,Staff,10,0,30,20
1683319906047,PSYC 106,B00,189026,Gorman; Michael R.,36,0,60,24
1683319907071,PSYC 114,B01,189033,Winkielman; Piotr,0,32,30,30
1683319908094,PSYC 131,A00,189036,Anagnostaras; Stephan,0,43,60,60
1683319909119,PSYC 136,A00,189041,Lowe; Angela Beth,0,7,25,25
1683319910145,PSYC 137,A00,189057,Winkielman; Piotr,0,34,25,25
1683319911168,PSYC 144,A00,189107,Wixted; John T,0,7,50,50
1683319913272,PSYC 162,A00,189142,Staff,0,8,85,85
1683319914299,PSYC 172,A00,189144,Gorman; Michael R.,0,7,30,30
1683319916355,PSYC 179,A00,189146,Lacefield; Katharine I,0,84,120,120
1683319917380,PSYC 181,A00,189147,Anagnostaras; Stephan,0,44,90,90
1683319918408,PSYC 190R,A00,189148,Barner; David A.,0,22,80,80
1683319919435,PSYC 191,A00,189275,Rickard; Timothy C.,0,7,25,25
1683319920459,PSYC 193,A00,189276,Chapman; Eddie Nathaniel,0,1,0,4
1683319921483,PSYC 193L,A01,189281,Lowe; Angela Beth,12,0,20,8
1683319921483,PSYC 193L,B01,189285,Staff,28,0,35,7
1683319922510,RELI 149,A00,187137,Rahimi; Babak,7,0,40,33
1683319923536,SE 9,A01,187315,Staff,0,2,18,18
1683319924561,SE 101B,A00,187409,Staff,24,0,30,6
1683319925584,SE 110B,A00,187444,Staff,10,0,40,30
1683319926607,SE 130B,A00,187449,Staff,31,0,40,9
1683319927632,SE 150A,A00,187516,Staff,9,0,20,11
1683319928659,SE 154,A00,187528,Staff,30,0,50,20
1683319929683,SIO 3,A01,258171,Staff,35,0,40,5
1683319930706,SIO 10,A00,187144,Cook; Geoffrey W,0,3,75,75
1683319931731,SIO 45,A00,187152,Cook; Geoffrey W,1,0,100,99
1683319932758,SIO 109R,A00,194486,Staff,0,3,20,20
1683319934815,SIO 187,A01,187233,Kacev; David,12,0,40,28
1683319935839,SOCI 1,A01,258656,Thorpe; Charles Robert,28,0,30,2
1683319935839,SOCI 1,A02,258658,Thorpe; Charles Robert,30,0,30,0
1683319935839,SOCI 1,A03,258661,Thorpe; Charles Robert,25,0,25,0
1683319935839,SOCI 1,A04,258666,Thorpe; Charles Robert,22,0,25,3
1683319935839,SOCI 1,A05,258897,Thorpe; Charles Robert,23,0,25,2
1683319935839,SOCI 1,A06,258898,Thorpe; Charles Robert,25,0,25,0
1683319936867,SOCI 30,A01,258903,Pardo Guerra; Juan Pablo,16,0,30,14
1683319937895,SOCI 102,A00,258904,Staff,9,0,25,16
1683319938923,SOCI 106,A00,258905,Staff,19,0,25,6
1683319939949,SOCI 111,A00,258907,Ribas Norris; Janet Vanesa,26,0,30,4
1683319940973,SOCI 121R,A00,258908,Pardo Guerra; Juan Pablo,11,0,30,19
1683319942022,SOCI 126,A01,203330,Staff,14,0,20,6
1683319943046,SOCI 131,A00,258909,Thorpe; Charles Robert,31,0,60,29
1683319944075,SOCI 135,A00,258910,Payne; Christine Anna,0,9,30,30
1683319945096,SOCI 157,A00,258911,Staff,12,0,30,18
1683319946123,SOCI 184,A00,258912,Staff,25,0,30,5
1683319947149,SOCI 188D,A00,258913,Staff,21,0,30,9
1683319948176,SYN 2,001,187529,Staff,9,0,16,7
1683319948176,SYN 2,002,201452,Staff,0,18,16,16
1683319948176,SYN 2,003,201469,Staff,4,0,16,12
1683319949202,SYN 100,A01,187531,Staff,0,9,20,20
1683319949202,SYN 100,B01,201491,Staff,0,12,20,20
1683319950230,TDAC 1,A00,189286,Walsh; Kim C.,3,0,20,17
1683319950230,TDAC 1,B00,189287,Harting; Carla Kelso,11,0,20,9
1683319951255,TDAC 101,A00,189300,Walsh; Kim C.,16,0,20,4
1683319951255,TDAC 101,B00,189301,Harting; Carla Kelso,18,0,20,2
1683319952282,TDAC 102,A00,189304,Basso; Beatrice,14,0,20,6
1683319953309,TDAC 108,A00,189305,Staff,18,0,20,2
1683319954340,TDDE 131,A00,189310,Staff,19,0,20,1
1683319954340,TDDE 131,B00,189314,Staff,19,0,20,1
1683319954340,TDDE 131,C00,189315,Staff,48,0,50,2
1683319954340,TDDE 131,D00,189316,Staff,14,0,15,1
1683319954340,TDDE 131,E00,204841,Staff,20,0,20,0
1683319955366,TDGE 10,A00,189289,Staff,30,0,50,20
1683319955366,TDGE 10,B00,189290,Havis; Allan,1,0,50,49
1683319956390,TDGE 11,A00,189291,Fulton; Julia,0,3,50,50
1683319956390,TDGE 11,B00,189292,Staff,20,0,25,5
1683319956390,TDGE 11,C00,260270,Staff,0,0,0,0
1683319957414,TDGE 25,A00,189294,Staff,3,0,20,17
1683319958440,TDGE 124,A00,189318,Fulton; Julia,0,8,50,50
1683319959464,TDGE 125,A00,189319,Staff,13,0,25,12
1683319959464,TDGE 125,B00,189320,Staff,23,0,25,2
1683319960490,TDGE 127,A00,189322,Havis; Allan,0,0,50,50
1683319961515,TDHT 101,A00,189323,Staff,18,0,25,7
1683319961515,TDHT 101,B00,189324,Staff,25,0,25,0
1683319962539,TDHT 102,A00,189325,Staff,49,0,50,1
1683319963563,TDMV 1,A00,189295,Arcidiacono; Kristin,19,0,30,11
1683319963563,TDMV 1,B00,189296,Caligagan; Maria T.,24,0,30,6
1683319964589,TDMV 2,A00,189297,Sammartano; Tonnie,28,0,30,2
1683319964589,TDMV 2,B00,189299,Arcidiacono; Kristin,24,0,30,6
1683319965617,TDMV 3,A00,204998,Rincon; Alicia,22,0,30,8
1683319966641,TDMV 120,A00,189458,Sammartano; Tonnie,28,0,30,2
1683319967665,TDMV 138,A00,189541,Jun; Grace Shin Hae,22,0,40,18
1683319968689,TDMV 142,A00,189717,Caligagan; Tony,23,0,30,7
1683319968689,TDMV 142,B00,189718,Caligagan; Maria T.,25,0,30,5
1683319969714,TMC 2,A01,187533,Staff,25,0,25,0
1683319969714,TMC 2,A02,187534,Staff,25,0,25,0
1683319970741,USP 1,A01,187536,Kwak; Nancy,0,16,25,25
1683319971768,USP 5,A01,187538,Staff,9,0,25,16
1683319972792,USP 101,A00,199253,Staff,0,4,0,0
1683319973816,USP 124,A00,187562,Boomhower; Matthew Charles,1,0,30,29
1683319974840,USP 138,A00,187582,Staff,20,0,25,5
1683319975864,USP 152,A01,187597,Staff,4,0,25,21
1683319976890,USP 153,A00,187598,Staff,19,0,25,6
1683319977915,USP 168,A00,187607,Kwak; Nancy,2,0,5,3
1683319978938,USP 173,A00,187619,Staff,4,0,25,21
1683319979964,USP 181,A00,187638,Staff,0,0,25,25
1683319980990,VIS 103,A00,187650,Cruz; Edwin Teddy,23,0,75,52
1683319982019,VIS 110D,A00,187669,Staff,12,0,22,10
1683319983045,VIS 127C,A00,187720,Shen; Kuiyi,68,0,146,78
1683319984068,VIS 149,A00,187731,Yoldas; Pinar,0,14,22,22
1683319985095,VIS 151,A01,188091,Staff,22,0,34,12
1683319985095,VIS 151,A02,188092,Staff,11,0,34,23
1683319986129,VIS 160B,A00,188093,Stalbaum; Brett,0,0,10,10
1683319988179,WCWP 10B,A00,201720,Staff,10,0,15,5
1683319988179,WCWP 10B,B00,201722,Staff,8,0,15,7
1683319989203,WCWP 100,A00,201725,Gagnon; Jeffrey C,0,0,2,2
1683319989203,WCWP 100,B00,201727,Staff,0,4,15,15
1683319992330,ANBI 133,A00,258401,Wilder; Linnea Lorene,34,0,40,6
1683319993356,ANBI 140,A00,258395,Hrvoj Mihic; Branka,18,0,25,7
1683319994385,ANSC 120,A00,258402,Bialecki; Jon Anthony,27,0,40,13
1683319995412,ANSC 144,A00,258400,Staff,14,0,40,26
1683319997461,ANSC 166,A00,258396,Parish; Steven Martin,157,0,175,18
1683319998488,ANSC 180,A00,193533,Staff,9,0,20,11
1683319999515,ANSC 188,A00,258397,Jassal; Aftab,33,0,40,7
1683320000543,ANTH 3,A01,258316,Staff,23,0,30,7
1683320001568,ANTH 5,A00,258394,Semendeferi; Ekaterini,16,0,20,4
1683320002593,ANTH 21,A01,258331,Staff,9,0,40,31
1683320003637,ANTH 103,A00,258398,Varma; Saiba,15,0,25,10
1683320004665,AWP 10,001,202034,Staff,0,0,0,0
1683320004665,AWP 10,002,202035,Staff,0,0,0,0
1683320004665,AWP 10,003,202036,Staff,0,0,0,0
1683320004665,AWP 10,004,202037,Staff,0,0,0,0
1683320004665,AWP 10,005,202038,Staff,0,0,0,0
1683320004665,AWP 10,006,202039,Staff,0,0,0,0
1683320004665,AWP 10,007,202040,Staff,0,0,0,0
1683320004665,AWP 10,008,202041,Staff,0,0,0,0
1683320004665,AWP 10,009,202042,Staff,0,0,0,0
1683320004665,AWP 10,010,202043,Staff,0,0,0,0
1683320004665,AWP 10,011,202044,Staff,0,0,0,0
1683320004665,AWP 10,012,202045,Staff,0,0,0,0
1683320004665,AWP 10,013,202046,Staff,0,0,0,0
1683320004665,AWP 10,014,202047,Staff,0,0,0,0
1683320004665,AWP 10,015,202048,Staff,0,0,0,0
1683320004665,AWP 10,016,202049,Staff,0,0,0,0
1683320004665,AWP 10,017,202050,Staff,0,0,0,0
1683320004665,AWP 10,018,202051,Staff,0,0,0,0
1683320004665,AWP 10,019,202052,Staff,0,0,0,0
1683320004665,AWP 10,020,202053,Staff,0,0,0,0
1683320004665,AWP 10,021,202054,Staff,0,0,0,0
1683320004665,AWP 10,022,202055,Staff,0,0,0,0
1683320004665,AWP 10,023,202056,Staff,0,0,0,0
1683320004665,AWP 10,024,202057,Staff,0,0,0,0
1683320004665,AWP 10,025,202058,Staff,0,0,0,0
1683320004665,AWP 10,026,202059,Staff,0,0,0,0
1683320005690,AWP 102,001,202032,Staff,0,0,0,0
1683320005690,AWP 102,002,202033,Staff,0,0,0,0
1683320006714,BENG 100,A01,254234,Taylor Amos; Alyssa C,31,0,40,9
1683320007738,BENG 196,001,270013,Engler; Adam J.,9999,0,9999,0
1683320008766,BICD 100R,A01,202018,Smith; Laurie,0,7,32,32
1683320008766,BICD 100R,A02,202019,Smith; Laurie,0,2,32,32
1683320008766,BICD 100R,A03,202020,Smith; Laurie,0,1,32,32
1683320008766,BICD 100R,A04,202021,Smith; Laurie,8,0,32,24
1683320008766,BICD 100R,A05,202022,Smith; Laurie,12,0,32,20
1683320009789,BICD 136,A01,193242,Gustafson-Brown; Cindy,0,2,32,32
1683320009789,BICD 136,A02,193244,Gustafson-Brown; Cindy,14,0,32,18
1683320010817,BIEB 102,A01,193249,Butler; Shannon Rhey,0,2,32,32
1683320010817,BIEB 102,A02,193251,Butler; Shannon Rhey,0,0,32,32
1683320010817,BIEB 102,A03,193253,Butler; Shannon Rhey,0,1,32,32
1683320010817,BIEB 102,A04,193255,Butler; Shannon Rhey,17,0,32,15
1683320010817,BIEB 102,A05,193265,Butler; Shannon Rhey,26,0,32,6
1683320010817,BIEB 102,A06,193269,Butler; Shannon Rhey,16,0,32,16
1683320012869,BIEB 150,A01,193274,Staff,0,0,32,32
1683320012869,BIEB 150,A02,193285,Staff,23,0,32,9
1683320013902,BIEB 194,A00,193286,Kurle; Carolyn M.,22,0,32,10
1683320014927,BILD 1,A01,192291,Staff,16,0,32,16
1683320014927,BILD 1,A02,192292,Staff,30,0,32,2
1683320014927,BILD 1,B01,192520,Reuther; Keefe,0,1,0,0
1683320014927,BILD 1,B02,192532,Reuther; Keefe,0,1,0,0
1683320016008,BILD 3,A01,192556,Butler; Shannon Rhey,0,0,32,32
1683320016008,BILD 3,A02,192581,Butler; Shannon Rhey,5,0,32,27
1683320016008,BILD 3,A03,192611,Butler; Shannon Rhey,23,0,32,9
1683320016008,BILD 3,A04,192612,Butler; Shannon Rhey,25,0,32,7
1683320016008,BILD 3,A05,192613,Butler; Shannon Rhey,27,0,32,5
1683320016008,BILD 3,A06,192679,Butler; Shannon Rhey,27,0,32,5
1683320016008,BILD 3,A07,192682,Butler; Shannon Rhey,22,0,32,10
1683320017034,BILD 4,A01,192836,Reuther; Keefe,0,0,24,24
1683320017034,BILD 4,A02,193044,Reuther; Keefe,4,0,24,20
1683320018059,BILD 10,A01,193142,Gustafson-Brown; Cindy,30,0,32,2
1683320018059,BILD 10,A02,193149,Gustafson-Brown; Cindy,31,0,32,1
1683320019087,BIMM 100,A01,193301,Staff,0,6,32,32
1683320019087,BIMM 100,A02,193312,Staff,0,5,32,32
1683320019087,BIMM 100,A03,193323,Staff,0,8,32,32
1683320020117,BIMM 101,A01,193329,McDonnell; Lisa Marie,0,3,24,24
1683320020117,BIMM 101,A02,193339,McDonnell; Lisa Marie,0,3,24,24
1683320020117,BIMM 101,B01,193354,McDonnell; Lisa Marie,0,3,24,24
1683320020117,BIMM 101,B02,193357,McDonnell; Lisa Marie,0,3,24,24
1683320021146,BIMM 110,A01,193377,Tat; John,0,11,32,32
1683320021146,BIMM 110,A02,193378,Tat; John,1,9,32,31
1683320022175,BIMM 120,A01,206116,Staff,0,0,32,32
1683320022175,BIMM 120,A02,206117,Staff,8,0,32,24
1683320022175,BIMM 120,A03,206121,Staff,21,0,32,11
1683320023198,BIPN 100,A01,193393,Park; Ji Young,0,14,32,32
1683320023198,BIPN 100,A02,193402,Park; Ji Young,0,12,32,32
1683320023198,BIPN 100,A03,193413,Park; Ji Young,0,14,32,32
1683320023198,BIPN 100,A04,193414,Park; Ji Young,0,13,32,32
1683320024224,BIPN 102,A01,193429,Staff,0,0,32,32
1683320024224,BIPN 102,A02,193438,Staff,22,0,32,10
1683320025249,BIPN 106,A01,193450,Reyes Gonzalez; Catalina,0,2,40,40
1683320026273,BIPN 134,A01,193465,Cooke; James Edward,0,0,32,32
1683320026273,BIPN 134,A02,193474,Cooke; James Edward,25,0,32,7
1683320026273,BIPN 134,A03,193485,Cooke; James Edward,29,0,32,3
1683320026273,BIPN 134,A04,193486,Cooke; James Edward,21,0,32,11
1683320026273,BIPN 134,A05,193491,Cooke; James Edward,31,0,32,1
1683320026273,BIPN 134,A06,193501,Cooke; James Edward,30,0,32,2
1683320026273,BIPN 134,A07,193510,Cooke; James Edward,29,0,32,3
1683320028323,BISP 194,A00,222522,Staff,15,0,32,17
1683320029349,CAT 124,A01,202407,Staff,20,0,25,5
1683320030375,CAT 125,A00,202408,Marchisotto; Jennifer Anne,4,0,20,16
1683320031398,CAT 125R,A00,202409,Smith; Lauryn Alissa,0,11,20,20
1683320031398,CAT 125R,B00,202410,Morales; Celeste Georgianna,0,11,20,20
1683320031398,CAT 125R,C00,202411,Irwin; Matthew Joseph,0,10,20,20
1683320032423,CENG 15,A01,204712,Yang; Kesong,0,1,0,0
1683320033446,CENG 114,A00,202070,Jahed Motlagh; Zeinab,5,0,20,15
1683320034470,CGS 105,A00,185477,Wesling; Megan E.,24,0,40,16
1683320035493,CGS 106,A00,185494,Staff,13,0,22,9
1683320036517,CGS 108,A00,185495,Staff,14,0,20,6
1683320037543,CGS 114,A00,185496,Staff,13,0,18,5
1683320038568,CGS 119,A00,185501,Staff,15,0,20,5
1683320039591,CGS 120,A00,185511,Staff,13,0,20,7
1683320040614,CHEM 4,A01,184675,Bussey; Thomas J,96,0,100,4
1683320041640,CHEM 6A,A01,184677,Staff,34,0,60,26
1683320042667,CHEM 6B,A01,184679,Staff,65,0,100,35
1683320043695,CHEM 6C,A01,184681,Bussey; Thomas J,1,0,50,49
1683320043695,CHEM 6C,A02,184682,Bussey; Thomas J,34,0,50,16
1683320044719,CHEM 40A,A01,184684,Albizati; Kim F.,37,0,100,63
1683320045747,CHEM 40B,A01,184686,Albizati; Kim F.,0,20,100,100
1683320046780,CHEM 41B,A01,184690,Staff,52,0,100,48
1683320047802,COGS 3,A01,184715,Boyle; Mary E. T.,0,25,40,40
1683320048828,COGS 14B,A01,185172,Staff,0,15,38,38
1683320049852,COGS 18,A01,184736,Staff,18,0,80,62
1683320050880,COGS 100,A01,184932,Staff,0,5,73,73
1683320051904,COGS 101A,A01,184935,Staff,0,38,30,30
1683320052930,COGS 101B,A01,184944,Staff,0,2,30,30
1683320053955,COGS 101C,A01,184946,Staff,0,12,30,30
1683320054978,COGS 102A,A01,184951,Johnson; Christine M.,2,0,40,38
1683320056006,COGS 107B,A01,184953,Mooshagian; Eric Frederick,0,50,40,40
1683320057032,COGS 118B,A01,184959,Gupta; Anjum,0,48,40,40
1683320058058,COGS 153,A00,184961,Staff,0,15,30,30
1683320059082,COGS 177,A00,184962,Staff,0,21,30,30
1683320060107,COGS 187A,A01,184969,Boyle; Mary E. T.,0,17,40,40
1683320061133,COMM 10,A01,185174,Staff,0,5,25,25
1683320061133,COMM 10,A02,185189,Staff,0,5,25,25
1683320061133,COMM 10,A03,269821,Staff,0,0,0,0
1683320062159,COMM 100B,A01,185475,Staff,0,0,0,2
1683320062159,COMM 100B,A02,185476,Staff,14,0,25,11
1683320063187,COMM 100C,A01,185314,Staff,1,0,25,24
1683320063187,COMM 100C,A02,185327,Staff,19,0,25,6
1683320064214,COMM 110M,A00,185349,Staff,2,0,40,38
1683320065240,COMM 113T,A00,185352,Staff,25,0,40,15
1683320066264,COMM 114I,A00,185353,Staff,33,0,40,7
1683320067290,COMM 131,A00,185354,Staff,19,0,30,11
1683320068313,CSE 8A,A50,185358,Cao; Yingjun,0,46,10,10
1683320069337,CSE 8B,A01,185362,Staff,1,47,50,49
1683320070364,CSE 11,A01,185416,Cao; Yingjun,0,92,10,10
1683320071391,CSE 20,A01,185445,Briones; Jor-el Thomas Caparas,5,0,25,20
1683320072419,CSE 21,A01,185447,Staff,10,0,50,40
1683320073443,CSE 101,A01,185451,Staff,0,12,50,50
1683320073443,CSE 101,B01,185453,Jones; Miles E,0,11,50,50
1683320075494,CSE 141,A01,185458,Eldon; John,20,0,100,80
1683320076520,CSE 141L,A01,185461,Eldon; John,12,0,100,88
1683320077545,CSE 142,A01,185463,Staff,36,0,60,24
1683320077545,CSE 142,B01,201355,Staff,0,7,60,60
1683320078572,CSE 142L,A01,185470,Staff,36,0,60,24
1683320078572,CSE 142L,B01,201417,Staff,0,6,60,60
1683320079597,CSE 190,A00,201433,Staff,32,0,49,17
1683320080625,DOC 1,A01,259136,Strom; Megan C.,7,0,15,8
1683320080625,DOC 1,A02,259137,Strom; Megan C.,14,0,15,1
1683320080625,DOC 1,A03,259138,Strom; Megan C.,14,0,15,1
1683320080625,DOC 1,A04,259139,Strom; Megan C.,14,0,15,1
1683320081650,DOC 100D,A00,259140,Pass; Natalye Joann,17,0,25,8
1683320082673,DSGN 1,A01,184749,Rill; Bryan,0,25,30,30
1683320083697,DSGN 100,A01,185168,Staff,0,2,25,25
1683320084720,ECE 5,A01,185626,Morris; Karcher William,0,10,0,0
1683320085744,ECE 101,A01,185628,Staff,17,0,70,53
1683320086768,ECE 107,A01,185635,Baghdadchi; Saharnaz,0,0,20,20
1683320086768,ECE 107,A02,185638,Baghdadchi; Saharnaz,4,0,20,16
1683320087790,ECE 148,A01,185647,Silberman; Jack,0,0,16,16
1683320088819,ECON 1,A01,185537,Crane; Meredith Helen,54,0,70,16
1683320089846,ECON 3,A01,185549,Crane; Meredith Helen,33,0,70,37
1683320090871,ECON 4,A01,203354,Anderson; John Charles,0,4,10,10
1683320091897,ECON 100A,A01,185574,Staff,0,4,40,40
1683320092926,ECON 100B,A01,185576,Staff,0,22,40,40
1683320093955,ECON 100C,A01,185589,Newhouse; Herbert S,30,0,70,40
1683320094978,ECON 105,A00,185608,Vespa; Emanuel Ignacio,19,0,35,16
1683320096009,ECON 109,A01,185610,Shishkin; Denis,10,0,35,25
1683320097033,ECON 110A,A01,185612,Staff,11,0,40,29
1683320098058,ECON 120A,A01,185615,Staff,20,0,40,20
1683320099082,ECON 120C,A01,185617,Sun; Yixiao,0,20,70,70
1683320100106,ECON 144,A00,203346,Squires; Dale E,3,0,35,32
1683320101145,ECON 171,A01,203349,Newhouse; Herbert S,0,1,35,35
1683320102172,ECON 173A,A01,185621,Toda; Alexis Akira,21,0,35,14
1683320103202,EDS 25,A01,202413,Staff,0,1,0,0
1683320103202,EDS 25,A02,202414,Staff,0,1,0,0
1683320103202,EDS 25,A03,202415,Staff,0,0,0,0
1683320103202,EDS 25,A04,202416,Staff,0,1,0,0
1683320103202,EDS 25,A05,202439,Staff,0,0,0,0
1683320103202,EDS 25,A06,202440,Staff,0,0,0,0
1683320103202,EDS 25,B01,202631,Staff,0,0,0,0
1683320103202,EDS 25,B02,202632,Staff,0,0,0,0
1683320103202,EDS 25,B03,202639,Staff,0,0,0,0
1683320103202,EDS 25,B04,202640,Staff,0,0,0,0
1683320103202,EDS 25,B05,202643,Staff,0,0,0,0
1683320103202,EDS 25,B06,202644,Staff,0,0,0,0
1683320104243,EDS 38,A01,202659,Black; Alison Michelle,24,0,25,1
1683320105270,EDS 115,A00,202652,Staff,17,0,30,13
1683320106293,EDS 125,A00,202649,Staff,14,0,30,16
1683320107320,EDS 126,A01,203332,Staff,30,0,30,0
1683320108344,EDS 139,A00,202838,Staff,16,0,25,9
1683320109367,EDS 146,A01,202655,Staff,14,0,25,11
1683320110391,ENG 15,A00,185667,Staff,0,1,0,0
1683320110391,ENG 15,B00,185672,Staff,0,0,0,0
1683320110391,ENG 15,C00,185675,Staff,0,0,0,0
1683320110391,ENG 15,D00,185682,Staff,0,0,0,0
1683320110391,ENG 15,E00,185684,Staff,0,0,0,0
1683320111415,ETHN 103,A00,185710,Staff,0,3,35,35
1683320112441,ETHN 103A,A00,199228,Man; Simeon S,2,0,9,7
1683320113465,ETHN 109,A00,185711,Staff,18,0,35,17
1683320114491,ETHN 142,A00,185726,Staff,0,4,30,30
1683320115517,ETHN 163J,A00,199229,Man; Simeon S,5,0,8,3
1683320116552,ETHN 168,A00,185727,Staff,8,0,10,2
1683320117576,ETHN 182,A00,185728,Staff,1,0,35,34
1683320118603,ETHN 183,A00,185737,Staff,8,0,18,10
1683320119684,GLBH 111,A01,209361,Burgos; Jose L.,0,0,0,0
1683320121761,HIEU 104,A00,185792,Staff,16,0,20,4
1683320122785,HIEU 115,A00,185800,Staff,1,0,20,19
1683320123811,HIEU 128,A00,185801,Staff,0,7,20,20
1683320124836,HIEU 147,A00,185802,Staff,16,0,20,4
1683320125861,HIEU 154,A00,185823,Staff,12,0,20,8
1683320126888,HILA 102,A00,185826,Staff,13,0,20,7
1683320127911,HILD 2C,A01,185778,Staff,0,12,20,20
1683320128940,HILD 7B,A01,185780,Kwak; Nancy,0,15,32,32
1683320128940,HILD 7B,A02,185781,Kwak; Nancy,0,18,32,32
1683320129966,HILD 30,A01,185791,Staff,14,0,20,6
1683320130990,HISC 119,A00,185830,Golan; Tal,0,9,20,20
1683320132014,HITO 156GS,A00,185831,Patterson; Patrick H.,0,0,0,23
1683320133038,HIUS 103,A00,185832,Man; Simeon S,0,6,20,20
1683320134069,HIUS 117,A00,185836,Kwak; Nancy,2,0,20,18
1683320135097,HIUS 125,A00,185840,Man; Simeon S,0,0,23,23
1683320136126,HIUS 149,A00,185845,Staff,0,0,20,20
1683320137151,HUM 3,A01,185882,Zavodny; Tatiana Sophia,0,6,50,50
1683320137151,HUM 3,B01,185899,Caldwell; Michael Alan,0,19,50,50
1683320138179,HUM 3GS,A00,185900,Patterson; Patrick H.,0,0,0,23
1683320139205,HUM 4,A01,185938,Zroka; Amy Liane,31,0,50,19
1683320139205,HUM 4,B01,185956,Watkins; Eric,0,2,50,50
1683320139205,HUM 4,B02,202209,Watkins; Eric,0,2,50,50
1683320139205,HUM 4,B03,202210,Watkins; Eric,0,0,50,50
1683320140229,HUM 5,A01,185958,West; Geoffrey Scott,3,0,50,47
1683320140229,HUM 5,A02,202215,West; Geoffrey Scott,0,0,50,50
1683320141253,INTL 190,A00,185959,Gagnon; Jeffrey C,0,0,0,9
1683320141253,INTL 190,B00,185960,Lettieri; Michael Joseph,0,0,0,1
1683320142279,JAPN 180,A00,254509,Staff,5,1,30,25
1683320143304,LATI 10,A01,202853,Kennemore; Amy Michelle,5,0,35,30
1683320143304,LATI 10,A02,202854,Kennemore; Amy Michelle,1,0,35,34
1683320143304,LATI 10,A03,270054,Kennemore; Amy Michelle,30,0,30,0
1683320144332,LATI 180,A00,202855,Kennemore; Amy Michelle,11,0,20,9
1683320145359,LAWS 101,A00,201767,Golan; Tal,0,7,40,40
1683320146383,LIFR 1C,A00,185961,Staff,6,0,20,14
1683320147407,LIFR 1CX,A00,185962,Staff,7,0,20,13
1683320148431,LIFR 1D,A00,185963,Staff,9,0,20,11
1683320149454,LIFR 1DX,A00,185964,Staff,9,0,20,11
1683320150482,LIGN 101,A01,186039,Staff,43,0,50,7
1683320151506,LIGN 165,A00,186040,Staff,18,0,50,32
1683320152533,LTCS 108,A00,186041,Staff,6,0,10,4
1683320153557,LTCS 119,A00,186042,Staff,16,0,20,4
1683320154580,LTCS 130,A00,186043,Wesling; Megan E.,15,0,25,10
1683320156627,LTEA 138,A00,186119,Staff,14,0,40,26
1683320157652,LTEN 124,A00,186148,Staff,6,0,25,19
1683320158677,LTEN 178,A00,186149,Staff,7,0,15,8
1683320159700,LTEN 181,A00,186150,Blanco; John D,33,0,40,7
1683320160728,LTWL 120,A00,186160,Staff,20,0,25,5
1683320161755,LTWL 165,A00,186161,Staff,22,0,25,3
1683320162779,LTWR 100,A00,186162,Staff,0,5,15,15
1683320163806,LTWR 102,A00,186163,Doller; Ben,5,0,15,10
1683320164837,MAE 8,A01,186412,Staff,0,0,0,0
1683320165862,MAE 30B,A00,186445,Bahadori; Mohammad Yousef,83,0,100,17
1683320166886,MAE 40,A00,186592,Bewley; Thomas R,9,0,50,41
1683320167911,MAE 101B,A00,186593,Bahadori; Mohammad Yousef,81,0,100,19
1683320168937,MAE 105,A00,186594,Bandaru; Prabhakar,12,0,50,38
1683320169962,MAE 107,A00,186599,Pham; Hieu Tan,0,6,120,120
1683320170985,MAE 148,A01,186660,Silberman; Jack,3,0,16,13
1683320172011,MATH 10A,A01,188095,Staff,0,6,35,35
1683320173037,MATH 10B,A01,188097,Bowers; Adam R.,0,11,30,30
1683320173037,MATH 10B,A02,188099,Bowers; Adam R.,0,11,30,30
1683320173037,MATH 10B,B01,188104,Bowers; Adam R.,0,10,30,30
1683320173037,MATH 10B,B02,188106,Bowers; Adam R.,0,10,30,30
1683320174061,MATH 10C,A01,188111,Staff,0,18,30,30
1683320174061,MATH 10C,A02,188127,Staff,0,17,30,30
1683320174061,MATH 10C,A03,188131,Staff,0,18,30,30
1683320174061,MATH 10C,B01,188218,Staff,19,0,30,11
1683320174061,MATH 10C,B02,188244,Staff,13,0,30,17
1683320174061,MATH 10C,B03,188277,Staff,16,0,30,14
1683320175089,MATH 18,A01,188344,Bach; Quang Tran,18,0,30,12
1683320175089,MATH 18,A02,188345,Bach; Quang Tran,11,0,30,19
1683320175089,MATH 18,B01,188353,Bach; Quang Tran,10,0,30,20
1683320175089,MATH 18,B02,188354,Bach; Quang Tran,20,0,30,10
1683320176115,MATH 20A,A01,188374,Staff,13,0,35,22
1683320177139,MATH 20B,A01,188382,Ohm; Ko Woon,6,0,30,24
1683320177139,MATH 20B,A02,188383,Ohm; Ko Woon,23,0,30,7
1683320177139,MATH 20B,B01,188385,Ohm; Ko Woon,7,0,30,23
1683320177139,MATH 20B,B02,188392,Ohm; Ko Woon,22,0,30,8
1683320178164,MATH 20C,A01,188394,Harel; Guershon,10,0,30,20
1683320178164,MATH 20C,A02,188395,Harel; Guershon,14,0,30,16
1683320178164,MATH 20C,B01,188404,Harel; Guershon,5,0,30,25
1683320178164,MATH 20C,B02,188405,Harel; Guershon,19,0,30,11
1683320179192,MATH 20D,A01,188414,Hammock; Frances H,0,1,30,30
1683320179192,MATH 20D,A02,188415,Hammock; Frances H,3,0,30,27
1683320179192,MATH 20D,B01,188447,Hammock; Frances H,2,0,30,28
1683320179192,MATH 20D,B02,188486,Hammock; Frances H,8,0,30,22
1683320180219,MATH 20E,A01,188649,Staff,21,0,30,9
1683320180219,MATH 20E,A02,188650,Staff,23,0,30,7
1683320180219,MATH 20E,A03,188673,Staff,0,0,30,30
1683320181243,MATH 102,A01,188675,Staff,0,35,35,35
1683320182270,MATH 103B,A01,188681,Staff,4,0,35,31
1683320182270,MATH 103B,B01,188692,Staff,5,0,35,30
1683320183295,MATH 109,A01,188695,Salehi Golsefidy; Alireza,25,0,35,10
1683320183295,MATH 109,A02,188696,Salehi Golsefidy; Alireza,26,0,35,9
1683320184321,MATH 120A,A01,188698,Eggers; John Dietrich,7,0,35,28
1683320185345,MATH 142B,A01,188736,Ioana; Adrian,0,2,30,30
1683320185345,MATH 142B,A02,188741,Ioana; Adrian,0,1,30,30
1683320185345,MATH 142B,A03,188743,Ioana; Adrian,1,3,30,29
1683320186376,MATH 168A,A01,188790,Staff,0,9,35,35
1683320187404,MATH 170A,A01,188803,Nie; Jiawang,0,2,35,35
1683320187404,MATH 170A,A02,188811,Nie; Jiawang,0,0,35,35
1683320187404,MATH 170A,A03,188814,Nie; Jiawang,0,0,35,35
1683320187404,MATH 170A,A04,188815,Nie; Jiawang,13,0,35,22
1683320188428,MATH 193B,A01,188817,Staff,0,0,35,35
1683320188428,MATH 193B,A02,188818,Staff,6,0,35,29
1683320189452,MGT 4,A01,202857,Anderson; John Charles,62,0,80,18
1683320190477,MGT 12,A00,202858,Lindenberger; Wade Douglas,42,0,90,48
1683320191504,MGT 18,A00,202859,Staff,74,0,90,16
1683320192532,MGT 18GS,A00,202860,McKay; Michael J,13,0,28,15
1683320193560,MGT 45,A00,202861,Pecore; Joseph P.,13,0,90,77
1683320194590,MGT 100,A00,202863,Yavorsky; Daniel Ryan,28,0,90,62
1683320195614,MGT 103,A00,202864,Ehrich; Kristine R,0,18,90,90
1683320196640,MGT 112,A00,202865,Ehrich; Kristine R,15,0,90,75
1683320197664,MGT 121A,A00,202868,Staff,0,20,0,0
1683320198692,MGT 131B,A00,202869,Anderson; John Charles,59,0,90,31
1683320199715,MGT 136,A00,202871,Lindenberger; Wade Douglas,84,0,90,6
1683320200740,MGT 164,A00,202873,Staff,0,68,90,91
1683320201766,MGT 164GS,A00,202874,McKay; Mary A,13,0,28,15
1683320202790,MGT 180,A00,202875,Staff,0,50,90,91
1683320203813,MMW 11R,A01,205019,Herbst; Matthew,3,0,30,27
1683320203813,MMW 11R,A02,205026,Herbst; Matthew,29,0,30,1
1683320204842,MMW 15,A01,193512,Chang; Edmond Yi-Teh,0,9,28,28
1683320204842,MMW 15,A02,193513,Chang; Edmond Yi-Teh,0,5,28,28
1683320204842,MMW 15,A03,193514,Chang; Edmond Yi-Teh,0,5,28,28
1683320204842,MMW 15,A04,193515,Chang; Edmond Yi-Teh,0,5,28,28
1683320204842,MMW 15,A05,193516,Chang; Edmond Yi-Teh,0,4,28,28
1683320204842,MMW 15,A06,193517,Chang; Edmond Yi-Teh,0,5,28,28
1683320204842,MMW 15,B01,193519,Chang; Edmond Yi-Teh,0,4,28,28
1683320204842,MMW 15,B02,193520,Chang; Edmond Yi-Teh,0,5,28,28
1683320204842,MMW 15,B03,193521,Chang; Edmond Yi-Teh,0,4,28,28
1683320204842,MMW 15,B04,193522,Chang; Edmond Yi-Teh,0,4,28,28
1683320204842,MMW 15,B05,193523,Chang; Edmond Yi-Teh,0,5,28,28
1683320204842,MMW 15,B06,193524,Chang; Edmond Yi-Teh,0,4,28,28
1683320205869,MMW 122,A01,193526,Rahimi; Babak,0,14,28,28
1683320205869,MMW 122,A02,193527,Rahimi; Babak,0,14,28,28
1683320205869,MMW 122,A03,193528,Rahimi; Babak,0,0,0,0
1683320205869,MMW 122,A04,193529,Rahimi; Babak,0,0,0,0
1683320206894,MUS 1A,A01,186663,Staff,0,20,35,35
1683320207918,MUS 4,A01,186715,Staff,0,12,35,35
1683320208943,MUS 5R,A01,186796,Dubnov; Shlomo,0,17,35,35
1683320209970,MUS 6,A01,186798,Staff,0,3,25,25
1683320210995,MUS 7,A01,186830,Staff,12,0,35,23
1683320212020,MUS 8,A01,186930,Staff,0,26,35,35
1683320213045,MUS 15,A01,186932,Staff,0,15,35,35
1683320213045,MUS 15,B01,186934,Staff,0,15,35,35
1683320214070,MUS 80,A00,186935,Staff,2,0,20,18
1683320214070,MUS 80,B00,186936,Staff,25,0,25,0
1683320215094,NANO 11,A00,204702,Lipomi; Darren John,0,0,0,0
1683320216118,NANO 15,A01,204709,Yang; Kesong,0,1,0,0
1683320217145,NANO 114,A00,202069,Jahed Motlagh; Zeinab,3,0,10,7
1683320218169,PHIL 1,A00,186955,Grush; Rick Scott,32,0,40,8
1683320219193,PHIL 10,A01,186973,Grush; Rick Scott,28,0,35,7
1683320219193,PHIL 10,A02,186974,Grush; Rick Scott,33,0,35,2
1683320220218,PHIL 13,A01,186976,Staff,7,0,35,28
1683320220218,PHIL 13,A02,186977,Staff,16,0,35,19
1683320221244,PHIL 14,A01,186979,Staff,31,0,35,4
1683320221244,PHIL 14,A02,186986,Staff,32,0,35,3
1683320222270,PHIL 28,A01,186988,Staff,16,0,30,14
1683320222270,PHIL 28,A02,186989,Staff,1,0,30,29
1683320222270,PHIL 28,A03,186990,Staff,9,0,30,21
1683320222270,PHIL 28,A04,186991,Staff,26,0,30,4
1683320223371,PHIL 120,A00,186997,Staff,23,0,40,17
1683320224399,PHIL 137,A00,187003,Staff,9,0,40,31
1683320225423,PHIL 150,A00,187015,Staff,47,0,70,23
1683320226448,PHIL 167,A00,187021,Lamey; Andy M.,35,0,40,5
1683320227476,PHIL 174,A01,202226,Staff,17,0,20,3
1683320227476,PHIL 174,A02,202235,Staff,20,0,20,0
1683320228500,PHIL 191A,A00,258918,Staff,0,0,1,1
1683320229525,PHYS 1A,A00,187028,Staff,27,0,60,33
1683320230551,PHYS 1AL,001,187036,Staff,3,0,30,27
1683320230551,PHYS 1AL,002,187049,Staff,18,0,30,12
1683320231581,PHYS 1B,A00,187058,Staff,22,0,60,38
1683320232610,PHYS 1BL,001,187064,Staff,0,0,30,30
1683320232610,PHYS 1BL,002,187070,Staff,5,0,30,25
1683320233633,PHYS 1C,A00,187082,Staff,31,0,120,89
1683320234658,PHYS 1CL,001,187088,Staff,0,9,30,30
1683320234658,PHYS 1CL,002,187089,Staff,0,2,30,30
1683320234658,PHYS 1CL,009,262693,Staff,11,0,30,19
1683320235685,PHYS 2B,A01,187097,Staff,54,0,115,61
1683320236711,PHYS 2C,A01,187099,Staff,67,0,115,48
1683320237735,PHYS 2CL,A01,187101,Staff,5,0,28,23
1683320237735,PHYS 2CL,A02,187102,Staff,15,0,28,13
1683320238760,PHYS 2D,A01,187123,Shotwell; Brian,95,0,115,20
1683320239788,PHYS 4B,A01,187133,Grinstein; Benjamin,35,0,50,15
1683320240813,POLI 10,A00,188819,Staff,0,4,50,50
1683320241841,POLI 11,A00,188827,Staff,43,0,50,7
1683320242865,POLI 13R,A00,188828,Staff,0,1,20,20
1683320243889,POLI 27,A01,188830,Elgin; Samuel Zincke,0,1,70,70
1683320244913,POLI 30,A00,188832,Desposato; Scott,31,0,50,19
1683320245937,POLI 102F,A00,188834,Staff,3,0,40,37
1683320246962,POLI 104A,A00,188852,Staff,14,0,30,16
1683320247984,POLI 104I,A00,188853,Staff,0,6,20,20
1683320249009,POLI 110B,A00,188854,Wiens; David,7,0,20,13
1683320250033,POLI 112A,A00,188855,Wiens; David,5,0,30,25
1683320251062,POLI 117R,A00,188856,Forman; Fonna,0,11,20,20
1683320252087,POLI 118,A00,188857,Ingham; Sean,8,0,20,12
1683320253111,POLI 120G,A00,188858,Staff,9,0,30,21
1683320254136,POLI 131CR,A00,188863,Hoston; Germaine,24,0,50,26
1683320255161,POLI 133,A00,188864,Nellis; Gareth Hb,44,0,50,6
1683320256186,POLI 134D,A00,188865,Desposato; Scott,27,0,30,3
1683320257210,POLI 142A,A00,188871,Gartzke; Erik,22,0,50,28
1683320258239,POLI 142K,A00,188874,Staff,38,0,50,12
1683320259268,POLI 143,A00,188940,Gartzke; Erik,16,0,30,14
1683320260294,POLI 153,A00,188943,Staff,3,0,20,17
1683320261321,POLI 160AA,A00,188944,Staff,12,0,40,28
1683320262346,POLI 170A,A00,188945,Staff,11,0,30,19
1683320264398,PSYC 1,A00,188952,Staff,37,0,90,53
1683320265422,PSYC 2,B00,188953,Staff,19,0,35,16
1683320266446,PSYC 6,A00,188970,Staff,47,0,60,13
1683320267474,PSYC 7,A00,188973,Staff,37,0,45,8
1683320268502,PSYC 60,A01,188980,Rickard; Timothy C.,43,0,60,17
1683320269526,PSYC 70,A01,189001,Steiner; Eric Tomas,24,0,45,21
1683320270554,PSYC 100,A00,189005,Lacefield; Katharine I,0,99,120,120
1683320271580,PSYC 102,A00,189008,Staff,10,0,30,20
1683320272605,PSYC 106,B00,189026,Gorman; Michael R.,35,0,60,25
1683320273629,PSYC 114,B01,189033,Winkielman; Piotr,0,32,30,30
1683320274652,PSYC 131,A00,189036,Anagnostaras; Stephan,0,43,60,60
1683320275677,PSYC 136,A00,189041,Lowe; Angela Beth,0,7,25,25
1683320276702,PSYC 137,A00,189057,Winkielman; Piotr,0,34,25,25
1683320277726,PSYC 144,A00,189107,Wixted; John T,0,7,50,50
1683320279785,PSYC 162,A00,189142,Staff,0,8,85,85
1683320280814,PSYC 172,A00,189144,Gorman; Michael R.,0,7,30,30
1683320282865,PSYC 179,A00,189146,Lacefield; Katharine I,0,84,120,120
1683320283893,PSYC 181,A00,189147,Anagnostaras; Stephan,0,44,90,90
1683320284921,PSYC 190R,A00,189148,Barner; David A.,0,22,80,80
1683320285949,PSYC 191,A00,189275,Rickard; Timothy C.,0,7,25,25
1683320286973,PSYC 193,A00,189276,Chapman; Eddie Nathaniel,0,1,0,4
1683320288003,PSYC 193L,A01,189281,Lowe; Angela Beth,12,0,20,8
1683320288003,PSYC 193L,B01,189285,Staff,28,0,35,7
1683320289032,RELI 149,A00,187137,Rahimi; Babak,7,0,40,33
1683320290056,SE 9,A01,187315,Staff,0,2,18,18
1683320291084,SE 101B,A00,187409,Staff,24,0,30,6
1683320292112,SE 110B,A00,187444,Staff,10,0,40,30
1683320293135,SE 130B,A00,187449,Staff,31,0,40,9
1683320294160,SE 150A,A00,187516,Staff,9,0,20,11
1683320295188,SE 154,A00,187528,Staff,30,0,50,20
1683320296215,SIO 3,A01,258171,Staff,35,0,40,5
1683320297243,SIO 10,A00,187144,Cook; Geoffrey W,0,3,75,75
1683320298268,SIO 45,A00,187152,Cook; Geoffrey W,1,0,100,99
1683320299293,SIO 109R,A00,194486,Staff,0,3,20,20
1683320301345,SIO 187,A01,187233,Kacev; David,12,0,40,28
1683320302371,SOCI 1,A01,258656,Thorpe; Charles Robert,28,0,30,2
1683320302371,SOCI 1,A02,258658,Thorpe; Charles Robert,30,0,30,0
1683320302371,SOCI 1,A03,258661,Thorpe; Charles Robert,25,0,25,0
1683320302371,SOCI 1,A04,258666,Thorpe; Charles Robert,22,0,25,3
1683320302371,SOCI 1,A05,258897,Thorpe; Charles Robert,23,0,25,2
1683320302371,SOCI 1,A06,258898,Thorpe; Charles Robert,25,0,25,0
1683320303398,SOCI 30,A01,258903,Pardo Guerra; Juan Pablo,16,0,30,14
1683320304423,SOCI 102,A00,258904,Staff,9,0,25,16
1683320305447,SOCI 106,A00,258905,Staff,19,0,25,6
1683320306476,SOCI 111,A00,258907,Ribas Norris; Janet Vanesa,26,0,30,4
1683320307502,SOCI 121R,A00,258908,Pardo Guerra; Juan Pablo,11,0,30,19
1683320308527,SOCI 126,A01,203330,Staff,14,0,20,6
1683320309551,SOCI 131,A00,258909,Thorpe; Charles Robert,31,0,60,29
1683320310574,SOCI 135,A00,258910,Payne; Christine Anna,0,9,30,30
1683320311599,SOCI 157,A00,258911,Staff,12,0,30,18
1683320312624,SOCI 184,A00,258912,Staff,25,0,30,5
1683320313649,SOCI 188D,A00,258913,Staff,21,0,30,9
1683320314673,SYN 2,001,187529,Staff,9,0,16,7
1683320314673,SYN 2,002,201452,Staff,0,18,16,16
1683320314673,SYN 2,003,201469,Staff,4,0,16,12
1683320315696,SYN 100,A01,187531,Staff,0,9,20,20
1683320315696,SYN 100,B01,201491,Staff,0,12,20,20
1683320316721,TDAC 1,A00,189286,Walsh; Kim C.,3,0,20,17
1683320316721,TDAC 1,B00,189287,Harting; Carla Kelso,11,0,20,9
1683320317745,TDAC 101,A00,189300,Walsh; Kim C.,16,0,20,4
1683320317745,TDAC 101,B00,189301,Harting; Carla Kelso,18,0,20,2
1683320318773,TDAC 102,A00,189304,Basso; Beatrice,14,0,20,6
1683320319797,TDAC 108,A00,189305,Staff,18,0,20,2
1683320320822,TDDE 131,A00,189310,Staff,19,0,20,1
1683320320822,TDDE 131,B00,189314,Staff,19,0,20,1
1683320320822,TDDE 131,C00,189315,Staff,48,0,50,2
1683320320822,TDDE 131,D00,189316,Staff,14,0,15,1
1683320320822,TDDE 131,E00,204841,Staff,20,0,20,0
1683320321850,TDGE 10,A00,189289,Staff,30,0,50,20
1683320321850,TDGE 10,B00,189290,Havis; Allan,1,0,50,49
1683320322878,TDGE 11,A00,189291,Fulton; Julia,0,3,50,50
1683320322878,TDGE 11,B00,189292,Staff,20,0,25,5
1683320322878,TDGE 11,C00,260270,Staff,0,0,0,0
1683320323907,TDGE 25,A00,189294,Staff,3,0,20,17
1683320324933,TDGE 124,A00,189318,Fulton; Julia,0,8,50,50
1683320325958,TDGE 125,A00,189319,Staff,13,0,25,12
1683320325958,TDGE 125,B00,189320,Staff,23,0,25,2
1683320327041,TDGE 127,A00,189322,Havis; Allan,0,0,50,50
1683320328067,TDHT 101,A00,189323,Staff,18,0,25,7
1683320328067,TDHT 101,B00,189324,Staff,25,0,25,0
1683320329090,TDHT 102,A00,189325,Staff,49,0,50,1
1683320330114,TDMV 1,A00,189295,Arcidiacono; Kristin,19,0,30,11
1683320330114,TDMV 1,B00,189296,Caligagan; Maria T.,24,0,30,6
1683320331142,TDMV 2,A00,189297,Sammartano; Tonnie,28,0,30,2
1683320331142,TDMV 2,B00,189299,Arcidiacono; Kristin,24,0,30,6
1683320332169,TDMV 3,A00,204998,Rincon; Alicia,22,0,30,8
1683320333196,TDMV 120,A00,189458,Sammartano; Tonnie,28,0,30,2
1683320334222,TDMV 138,A00,189541,Jun; Grace Shin Hae,22,0,40,18
1683320335245,TDMV 142,A00,189717,Caligagan; Tony,23,0,30,7
1683320335245,TDMV 142,B00,189718,Caligagan; Maria T.,25,0,30,5
1683320336271,TMC 2,A01,187533,Staff,25,0,25,0
1683320336271,TMC 2,A02,187534,Staff,25,0,25,0
1683320337295,USP 1,A01,187536,Kwak; Nancy,0,16,25,25
1683320338322,USP 5,A01,187538,Staff,9,0,25,16
1683320339346,USP 101,A00,199253,Staff,0,4,0,0
1683320340369,USP 124,A00,187562,Boomhower; Matthew Charles,1,0,30,29
1683320341395,USP 138,A00,187582,Staff,20,0,25,5
1683320342436,USP 152,A01,187597,Staff,4,0,25,21
1683320343460,USP 153,A00,187598,Staff,19,0,25,6
1683320344487,USP 168,A00,187607,Kwak; Nancy,2,0,5,3
1683320345514,USP 173,A00,187619,Staff,4,0,25,21
1683320346542,USP 181,A00,187638,Staff,0,0,25,25
1683320347569,VIS 103,A00,187650,Cruz; Edwin Teddy,23,0,75,52
1683320348596,VIS 110D,A00,187669,Staff,12,0,22,10
1683320349627,VIS 127C,A00,187720,Shen; Kuiyi,68,0,146,78
1683320350652,VIS 149,A00,187731,Yoldas; Pinar,0,14,22,22
1683320351679,VIS 151,A01,188091,Staff,22,0,34,12
1683320351679,VIS 151,A02,188092,Staff,11,0,34,23
1683320352707,VIS 160B,A00,188093,Stalbaum; Brett,0,0,10,10
1683320354757,WCWP 10B,A00,201720,Staff,10,0,15,5
1683320354757,WCWP 10B,B00,201722,Staff,8,0,15,7
1683320355786,WCWP 100,A00,201725,Gagnon; Jeffrey C,0,0,2,2
1683320355786,WCWP 100,B00,201727,Staff,0,4,15,15
1683320358878,ANBI 133,A00,258401,Wilder; Linnea Lorene,34,0,40,6
1683320359905,ANBI 140,A00,258395,Hrvoj Mihic; Branka,18,0,25,7
1683320360929,ANSC 120,A00,258402,Bialecki; Jon Anthony,27,0,40,13
1683320361954,ANSC 144,A00,258400,Staff,14,0,40,26
1683320364005,ANSC 166,A00,258396,Parish; Steven Martin,157,0,175,18
1683320365030,ANSC 180,A00,193533,Staff,9,0,20,11
1683320366056,ANSC 188,A00,258397,Jassal; Aftab,33,0,40,7
1683320367084,ANTH 3,A01,258316,Staff,23,0,30,7
1683320368107,ANTH 5,A00,258394,Semendeferi; Ekaterini,16,0,20,4
1683320369131,ANTH 21,A01,258331,Staff,9,0,40,31
1683320370159,ANTH 103,A00,258398,Varma; Saiba,15,0,25,10
1683320371185,AWP 10,001,202034,Staff,0,0,0,0
1683320371185,AWP 10,002,202035,Staff,0,0,0,0
1683320371185,AWP 10,003,202036,Staff,0,0,0,0
1683320371185,AWP 10,004,202037,Staff,0,0,0,0
1683320371185,AWP 10,005,202038,Staff,0,0,0,0
1683320371185,AWP 10,006,202039,Staff,0,0,0,0
1683320371185,AWP 10,007,202040,Staff,0,0,0,0
1683320371185,AWP 10,008,202041,Staff,0,0,0,0
1683320371185,AWP 10,009,202042,Staff,0,0,0,0
1683320371185,AWP 10,010,202043,Staff,0,0,0,0
1683320371185,AWP 10,011,202044,Staff,0,0,0,0
1683320371185,AWP 10,012,202045,Staff,0,0,0,0
1683320371185,AWP 10,013,202046,Staff,0,0,0,0
1683320371185,AWP 10,014,202047,Staff,0,0,0,0
1683320371185,AWP 10,015,202048,Staff,0,0,0,0
1683320371185,AWP 10,016,202049,Staff,0,0,0,0
1683320371185,AWP 10,017,202050,Staff,0,0,0,0
1683320371185,AWP 10,018,202051,Staff,0,0,0,0
1683320371185,AWP 10,019,202052,Staff,0,0,0,0
1683320371185,AWP 10,020,202053,Staff,0,0,0,0
1683320371185,AWP 10,021,202054,Staff,0,0,0,0
1683320371185,AWP 10,022,202055,Staff,0,0,0,0
1683320371185,AWP 10,023,202056,Staff,0,0,0,0
1683320371185,AWP 10,024,202057,Staff,0,0,0,0
1683320371185,AWP 10,025,202058,Staff,0,0,0,0
1683320371185,AWP 10,026,202059,Staff,0,0,0,0
1683320372210,AWP 102,001,202032,Staff,0,0,0,0
1683320372210,AWP 102,002,202033,Staff,0,0,0,0
1683320373234,BENG 100,A01,254234,Taylor Amos; Alyssa C,31,0,40,9
1683320374256,BENG 196,001,270013,Engler; Adam J.,9999,0,9999,0
1683320375281,BICD 100R,A01,202018,Smith; Laurie,0,7,32,32
1683320375281,BICD 100R,A02,202019,Smith; Laurie,0,2,32,32
1683320375281,BICD 100R,A03,202020,Smith; Laurie,0,1,32,32
1683320375281,BICD 100R,A04,202021,Smith; Laurie,8,0,32,24
1683320375281,BICD 100R,A05,202022,Smith; Laurie,12,0,32,20
1683320376304,BICD 136,A01,193242,Gustafson-Brown; Cindy,0,2,32,32
1683320376304,BICD 136,A02,193244,Gustafson-Brown; Cindy,14,0,32,18
1683320377329,BIEB 102,A01,193249,Butler; Shannon Rhey,0,2,32,32
1683320377329,BIEB 102,A02,193251,Butler; Shannon Rhey,0,0,32,32
1683320377329,BIEB 102,A03,193253,Butler; Shannon Rhey,0,1,32,32
1683320377329,BIEB 102,A04,193255,Butler; Shannon Rhey,17,0,32,15
1683320377329,BIEB 102,A05,193265,Butler; Shannon Rhey,26,0,32,6
1683320377329,BIEB 102,A06,193269,Butler; Shannon Rhey,16,0,32,16
1683320379381,BIEB 150,A01,193274,Staff,0,0,32,32
1683320379381,BIEB 150,A02,193285,Staff,23,0,32,9
1683320380407,BIEB 194,A00,193286,Kurle; Carolyn M.,22,0,32,10
1683320381431,BILD 1,A01,192291,Staff,16,0,32,16
1683320381431,BILD 1,A02,192292,Staff,30,0,32,2
1683320381431,BILD 1,B01,192520,Reuther; Keefe,0,1,0,0
1683320381431,BILD 1,B02,192532,Reuther; Keefe,0,1,0,0
1683320382460,BILD 3,A01,192556,Butler; Shannon Rhey,0,0,32,32
1683320382460,BILD 3,A02,192581,Butler; Shannon Rhey,5,0,32,27
1683320382460,BILD 3,A03,192611,Butler; Shannon Rhey,23,0,32,9
1683320382460,BILD 3,A04,192612,Butler; Shannon Rhey,25,0,32,7
1683320382460,BILD 3,A05,192613,Butler; Shannon Rhey,27,0,32,5
1683320382460,BILD 3,A06,192679,Butler; Shannon Rhey,27,0,32,5
1683320382460,BILD 3,A07,192682,Butler; Shannon Rhey,22,0,32,10
1683320383485,BILD 4,A01,192836,Reuther; Keefe,0,0,24,24
1683320383485,BILD 4,A02,193044,Reuther; Keefe,4,0,24,20
1683320384508,BILD 10,A01,193142,Gustafson-Brown; Cindy,30,0,32,2
1683320384508,BILD 10,A02,193149,Gustafson-Brown; Cindy,31,0,32,1
1683320385532,BIMM 100,A01,193301,Staff,0,6,32,32
1683320385532,BIMM 100,A02,193312,Staff,0,5,32,32
1683320385532,BIMM 100,A03,193323,Staff,0,8,32,32
1683320386557,BIMM 101,A01,193329,McDonnell; Lisa Marie,0,3,24,24
1683320386557,BIMM 101,A02,193339,McDonnell; Lisa Marie,0,3,24,24
1683320386557,BIMM 101,B01,193354,McDonnell; Lisa Marie,0,3,24,24
1683320386557,BIMM 101,B02,193357,McDonnell; Lisa Marie,0,3,24,24
1683320387582,BIMM 110,A01,193377,Tat; John,0,11,32,32
1683320387582,BIMM 110,A02,193378,Tat; John,1,9,32,31
1683320388609,BIMM 120,A01,206116,Staff,0,0,32,32
1683320388609,BIMM 120,A02,206117,Staff,8,0,32,24
1683320388609,BIMM 120,A03,206121,Staff,21,0,32,11
1683320389635,BIPN 100,A01,193393,Park; Ji Young,0,14,32,32
1683320389635,BIPN 100,A02,193402,Park; Ji Young,0,12,32,32
1683320389635,BIPN 100,A03,193413,Park; Ji Young,0,14,32,32
1683320389635,BIPN 100,A04,193414,Park; Ji Young,0,13,32,32
1683320390660,BIPN 102,A01,193429,Staff,0,0,32,32
1683320390660,BIPN 102,A02,193438,Staff,22,0,32,10
1683320391685,BIPN 106,A01,193450,Reyes Gonzalez; Catalina,0,2,40,40
1683320392710,BIPN 134,A01,193465,Cooke; James Edward,0,0,32,32
1683320392710,BIPN 134,A02,193474,Cooke; James Edward,25,0,32,7
1683320392710,BIPN 134,A03,193485,Cooke; James Edward,29,0,32,3
1683320392710,BIPN 134,A04,193486,Cooke; James Edward,21,0,32,11
1683320392710,BIPN 134,A05,193491,Cooke; James Edward,31,0,32,1
1683320392710,BIPN 134,A06,193501,Cooke; James Edward,30,0,32,2
1683320392710,BIPN 134,A07,193510,Cooke; James Edward,29,0,32,3
1683320394758,BISP 194,A00,222522,Staff,15,0,32,17
1683320395782,CAT 124,A01,202407,Staff,20,0,25,5
1683320396809,CAT 125,A00,202408,Marchisotto; Jennifer Anne,4,0,20,16
1683320397837,CAT 125R,A00,202409,Smith; Lauryn Alissa,0,11,20,20
1683320397837,CAT 125R,B00,202410,Morales; Celeste Georgianna,0,11,20,20
1683320397837,CAT 125R,C00,202411,Irwin; Matthew Joseph,0,10,20,20
1683320398864,CENG 15,A01,204712,Yang; Kesong,0,1,0,0
1683320399887,CENG 114,A00,202070,Jahed Motlagh; Zeinab,5,0,20,15
1683320400911,CGS 105,A00,185477,Wesling; Megan E.,24,0,40,16
1683320401938,CGS 106,A00,185494,Staff,13,0,22,9
1683320402960,CGS 108,A00,185495,Staff,14,0,20,6
1683320403984,CGS 114,A00,185496,Staff,13,0,18,5
1683320405011,CGS 119,A00,185501,Staff,15,0,20,5
1683320406037,CGS 120,A00,185511,Staff,13,0,20,7
1683320407063,CHEM 4,A01,184675,Bussey; Thomas J,96,0,100,4
1683320408093,CHEM 6A,A01,184677,Staff,34,0,60,26
1683320409117,CHEM 6B,A01,184679,Staff,65,0,100,35
1683320410144,CHEM 6C,A01,184681,Bussey; Thomas J,1,0,50,49
1683320410144,CHEM 6C,A02,184682,Bussey; Thomas J,34,0,50,16
1683320411167,CHEM 40A,A01,184684,Albizati; Kim F.,37,0,100,63
1683320412194,CHEM 40B,A01,184686,Albizati; Kim F.,0,20,100,100
1683320413220,CHEM 41B,A01,184690,Staff,52,0,100,48
1683320414244,COGS 3,A01,184715,Boyle; Mary E. T.,0,25,40,40
1683320415272,COGS 14B,A01,185172,Staff,0,15,38,38
1683320416295,COGS 18,A01,184736,Staff,18,0,80,62
1683320417323,COGS 100,A01,184932,Staff,0,5,73,73
1683320418354,COGS 101A,A01,184935,Staff,0,38,30,30
1683320419381,COGS 101B,A01,184944,Staff,0,2,30,30
1683320420407,COGS 101C,A01,184946,Staff,0,12,30,30
1683320421433,COGS 102A,A01,184951,Johnson; Christine M.,2,0,40,38
1683320422457,COGS 107B,A01,184953,Mooshagian; Eric Frederick,0,50,40,40
1683320423485,COGS 118B,A01,184959,Gupta; Anjum,0,48,40,40
1683320424509,COGS 153,A00,184961,Staff,0,15,30,30
1683320425537,COGS 177,A00,184962,Staff,0,21,30,30
1683320426563,COGS 187A,A01,184969,Boyle; Mary E. T.,0,17,40,40
1683320427590,COMM 10,A01,185174,Staff,0,5,25,25
1683320427590,COMM 10,A02,185189,Staff,0,5,25,25
1683320427590,COMM 10,A03,269821,Staff,0,0,0,0
1683320428618,COMM 100B,A01,185475,Staff,0,0,0,2
1683320428618,COMM 100B,A02,185476,Staff,14,0,25,11
1683320429646,COMM 100C,A01,185314,Staff,1,0,25,24
1683320429646,COMM 100C,A02,185327,Staff,19,0,25,6
1683320430727,COMM 110M,A00,185349,Staff,2,0,40,38
1683320431751,COMM 113T,A00,185352,Staff,25,0,40,15
1683320432780,COMM 114I,A00,185353,Staff,33,0,40,7
1683320433804,COMM 131,A00,185354,Staff,19,0,30,11
1683320434831,CSE 8A,A50,185358,Cao; Yingjun,0,46,10,10
1683320435863,CSE 8B,A01,185362,Staff,1,47,50,49
1683320436887,CSE 11,A01,185416,Cao; Yingjun,0,92,10,10
1683320437916,CSE 20,A01,185445,Briones; Jor-el Thomas Caparas,5,0,25,20
1683320438943,CSE 21,A01,185447,Staff,10,0,50,40
1683320439968,CSE 101,A01,185451,Staff,0,12,50,50
1683320439968,CSE 101,B01,185453,Jones; Miles E,0,11,50,50
1683320442016,CSE 141,A01,185458,Eldon; John,20,0,100,80
1683320443039,CSE 141L,A01,185461,Eldon; John,12,0,100,88
1683320444064,CSE 142,A01,185463,Staff,36,0,60,24
1683320444064,CSE 142,B01,201355,Staff,0,7,60,60
1683320445093,CSE 142L,A01,185470,Staff,36,0,60,24
1683320445093,CSE 142L,B01,201417,Staff,0,6,60,60
1683320446116,CSE 190,A00,201433,Staff,32,0,49,17
1683320447139,DOC 1,A01,259136,Strom; Megan C.,7,0,15,8
1683320447139,DOC 1,A02,259137,Strom; Megan C.,14,0,15,1
1683320447139,DOC 1,A03,259138,Strom; Megan C.,14,0,15,1
1683320447139,DOC 1,A04,259139,Strom; Megan C.,14,0,15,1
1683320448162,DOC 100D,A00,259140,Pass; Natalye Joann,17,0,25,8
1683320449189,DSGN 1,A01,184749,Rill; Bryan,0,25,30,30
1683320450213,DSGN 100,A01,185168,Staff,0,2,25,25
1683320451243,ECE 5,A01,185626,Morris; Karcher William,0,10,0,0
1683320452268,ECE 101,A01,185628,Staff,17,0,70,53
1683320453293,ECE 107,A01,185635,Baghdadchi; Saharnaz,0,0,20,20
1683320453293,ECE 107,A02,185638,Baghdadchi; Saharnaz,4,0,20,16
1683320454319,ECE 148,A01,185647,Silberman; Jack,0,0,16,16
1683320455343,ECON 1,A01,185537,Crane; Meredith Helen,54,0,70,16
1683320456368,ECON 3,A01,185549,Crane; Meredith Helen,33,0,70,37
1683320457392,ECON 4,A01,203354,Anderson; John Charles,0,4,10,10
1683320458419,ECON 100A,A01,185574,Staff,0,4,40,40
1683320459446,ECON 100B,A01,185576,Staff,0,22,40,40
1683320460473,ECON 100C,A01,185589,Newhouse; Herbert S,30,0,70,40
1683320461499,ECON 105,A00,185608,Vespa; Emanuel Ignacio,19,0,35,16
1683320462528,ECON 109,A01,185610,Shishkin; Denis,10,0,35,25
1683320463553,ECON 110A,A01,185612,Staff,11,0,40,29
1683320464577,ECON 120A,A01,185615,Staff,20,0,40,20
1683320465605,ECON 120C,A01,185617,Sun; Yixiao,0,20,70,70
1683320466633,ECON 144,A00,203346,Squires; Dale E,3,0,35,32
1683320467656,ECON 171,A01,203349,Newhouse; Herbert S,0,1,35,35
1683320468681,ECON 173A,A01,185621,Toda; Alexis Akira,21,0,35,14
1683320469706,EDS 25,A01,202413,Staff,0,1,0,0
1683320469706,EDS 25,A02,202414,Staff,0,1,0,0
1683320469706,EDS 25,A03,202415,Staff,0,0,0,0
1683320469706,EDS 25,A04,202416,Staff,0,1,0,0
1683320469706,EDS 25,A05,202439,Staff,0,0,0,0
1683320469706,EDS 25,A06,202440,Staff,0,0,0,0
1683320469706,EDS 25,B01,202631,Staff,0,0,0,0
1683320469706,EDS 25,B02,202632,Staff,0,0,0,0
1683320469706,EDS 25,B03,202639,Staff,0,0,0,0
1683320469706,EDS 25,B04,202640,Staff,0,0,0,0
1683320469706,EDS 25,B05,202643,Staff,0,0,0,0
1683320469706,EDS 25,B06,202644,Staff,0,0,0,0
1683320470733,EDS 38,A01,202659,Black; Alison Michelle,24,0,25,1
1683320471757,EDS 115,A00,202652,Staff,17,0,30,13
1683320472781,EDS 125,A00,202649,Staff,14,0,30,16
1683320473808,EDS 126,A01,203332,Staff,30,0,30,0
1683320474832,EDS 139,A00,202838,Staff,16,0,25,9
1683320475857,EDS 146,A01,202655,Staff,14,0,25,11
1683320476886,ENG 15,A00,185667,Staff,0,1,0,0
1683320476886,ENG 15,B00,185672,Staff,0,0,0,0
1683320476886,ENG 15,C00,185675,Staff,0,0,0,0
1683320476886,ENG 15,D00,185682,Staff,0,0,0,0
1683320476886,ENG 15,E00,185684,Staff,0,0,0,0
1683320477912,ETHN 103,A00,185710,Staff,0,3,35,35
1683320478935,ETHN 103A,A00,199228,Man; Simeon S,2,0,9,7
1683320479971,ETHN 109,A00,185711,Staff,18,0,35,17
1683320480997,ETHN 142,A00,185726,Staff,0,4,30,30
1683320482023,ETHN 163J,A00,199229,Man; Simeon S,5,0,8,3
1683320483050,ETHN 168,A00,185727,Staff,8,0,10,2
1683320484075,ETHN 182,A00,185728,Staff,1,0,35,34
1683320485097,ETHN 183,A00,185737,Staff,8,0,18,10
1683320486121,GLBH 111,A01,209361,Burgos; Jose L.,0,0,0,0
1683320488169,HIEU 104,A00,185792,Staff,16,0,20,4
1683320489193,HIEU 115,A00,185800,Staff,1,0,20,19
1683320490220,HIEU 128,A00,185801,Staff,0,7,20,20
1683320491245,HIEU 147,A00,185802,Staff,16,0,20,4
1683320492271,HIEU 154,A00,185823,Staff,12,0,20,8
1683320493300,HILA 102,A00,185826,Staff,13,0,20,7
1683320494326,HILD 2C,A01,185778,Staff,0,12,20,20
1683320495351,HILD 7B,A01,185780,Kwak; Nancy,0,15,32,32
1683320495351,HILD 7B,A02,185781,Kwak; Nancy,0,18,32,32
1683320496375,HILD 30,A01,185791,Staff,14,0,20,6
1683320497400,HISC 119,A00,185830,Golan; Tal,0,9,20,20
1683320498429,HITO 156GS,A00,185831,Patterson; Patrick H.,0,0,0,23
1683320499454,HIUS 103,A00,185832,Man; Simeon S,0,6,20,20
1683320500479,HIUS 117,A00,185836,Kwak; Nancy,2,0,20,18
1683320501503,HIUS 125,A00,185840,Man; Simeon S,0,0,23,23
1683320502530,HIUS 149,A00,185845,Staff,0,0,20,20
1683320503558,HUM 3,A01,185882,Zavodny; Tatiana Sophia,0,6,50,50
1683320503558,HUM 3,B01,185899,Caldwell; Michael Alan,0,19,50,50
1683320504583,HUM 3GS,A00,185900,Patterson; Patrick H.,0,0,0,23
1683320505609,HUM 4,A01,185938,Zroka; Amy Liane,31,0,50,19
1683320505609,HUM 4,B01,185956,Watkins; Eric,0,2,50,50
1683320505609,HUM 4,B02,202209,Watkins; Eric,0,2,50,50
1683320505609,HUM 4,B03,202210,Watkins; Eric,0,0,50,50
1683320506632,HUM 5,A01,185958,West; Geoffrey Scott,3,0,50,47
1683320506632,HUM 5,A02,202215,West; Geoffrey Scott,0,0,50,50
1683320507659,INTL 190,A00,185959,Gagnon; Jeffrey C,0,0,0,9
1683320507659,INTL 190,B00,185960,Lettieri; Michael Joseph,0,0,0,1
1683320508687,JAPN 180,A00,254509,Staff,5,1,30,25
1683320509712,LATI 10,A01,202853,Kennemore; Amy Michelle,5,0,35,30
1683320509712,LATI 10,A02,202854,Kennemore; Amy Michelle,1,0,35,34
1683320509712,LATI 10,A03,270054,Kennemore; Amy Michelle,30,0,30,0
1683320510736,LATI 180,A00,202855,Kennemore; Amy Michelle,11,0,20,9
1683320511764,LAWS 101,A00,201767,Golan; Tal,0,7,40,40
1683320512789,LIFR 1C,A00,185961,Staff,6,0,20,14
1683320513816,LIFR 1CX,A00,185962,Staff,7,0,20,13
1683320514849,LIFR 1D,A00,185963,Staff,9,0,20,11
1683320515875,LIFR 1DX,A00,185964,Staff,9,0,20,11
1683320516899,LIGN 101,A01,186039,Staff,43,0,50,7
1683320517921,LIGN 165,A00,186040,Staff,18,0,50,32
1683320518946,LTCS 108,A00,186041,Staff,6,0,10,4
1683320519973,LTCS 119,A00,186042,Staff,16,0,20,4
1683320521000,LTCS 130,A00,186043,Wesling; Megan E.,15,0,25,10
1683320523051,LTEA 138,A00,186119,Staff,14,0,40,26
1683320524075,LTEN 124,A00,186148,Staff,6,0,25,19
1683320525098,LTEN 178,A00,186149,Staff,7,0,15,8
1683320526126,LTEN 181,A00,186150,Blanco; John D,33,0,40,7
1683320527151,LTWL 120,A00,186160,Staff,20,0,25,5
1683320528178,LTWL 165,A00,186161,Staff,22,0,25,3
1683320529207,LTWR 100,A00,186162,Staff,0,5,15,15
1683320530232,LTWR 102,A00,186163,Doller; Ben,5,0,15,10
1683320531261,MAE 8,A01,186412,Staff,0,0,0,0
1683320532284,MAE 30B,A00,186445,Bahadori; Mohammad Yousef,83,0,100,17
1683320533308,MAE 40,A00,186592,Bewley; Thomas R,9,0,50,41
1683320534392,MAE 101B,A00,186593,Bahadori; Mohammad Yousef,81,0,100,19
1683320535416,MAE 105,A00,186594,Bandaru; Prabhakar,12,0,50,38
1683320536441,MAE 107,A00,186599,Pham; Hieu Tan,0,6,120,120
1683320537465,MAE 148,A01,186660,Silberman; Jack,3,0,16,13
1683320538492,MATH 10A,A01,188095,Staff,0,6,35,35
1683320539517,MATH 10B,A01,188097,Bowers; Adam R.,0,11,30,30
1683320539517,MATH 10B,A02,188099,Bowers; Adam R.,0,11,30,30
1683320539517,MATH 10B,B01,188104,Bowers; Adam R.,0,10,30,30
1683320539517,MATH 10B,B02,188106,Bowers; Adam R.,0,10,30,30
1683320540548,MATH 10C,A01,188111,Staff,0,18,30,30
1683320540548,MATH 10C,A02,188127,Staff,0,17,30,30
1683320540548,MATH 10C,A03,188131,Staff,0,18,30,30
1683320540548,MATH 10C,B01,188218,Staff,19,0,30,11
1683320540548,MATH 10C,B02,188244,Staff,13,0,30,17
1683320540548,MATH 10C,B03,188277,Staff,16,0,30,14
1683320541578,MATH 18,A01,188344,Bach; Quang Tran,18,0,30,12
1683320541578,MATH 18,A02,188345,Bach; Quang Tran,11,0,30,19
1683320541578,MATH 18,B01,188353,Bach; Quang Tran,10,0,30,20
1683320541578,MATH 18,B02,188354,Bach; Quang Tran,20,0,30,10
1683320542605,MATH 20A,A01,188374,Staff,13,0,35,22
1683320543631,MATH 20B,A01,188382,Ohm; Ko Woon,6,0,30,24
1683320543631,MATH 20B,A02,188383,Ohm; Ko Woon,23,0,30,7
1683320543631,MATH 20B,B01,188385,Ohm; Ko Woon,7,0,30,23
1683320543631,MATH 20B,B02,188392,Ohm; Ko Woon,22,0,30,8
1683320544659,MATH 20C,A01,188394,Harel; Guershon,10,0,30,20
1683320544659,MATH 20C,A02,188395,Harel; Guershon,14,0,30,16
1683320544659,MATH 20C,B01,188404,Harel; Guershon,5,0,30,25
1683320544659,MATH 20C,B02,188405,Harel; Guershon,19,0,30,11
1683320545684,MATH 20D,A01,188414,Hammock; Frances H,0,1,30,30
1683320545684,MATH 20D,A02,188415,Hammock; Frances H,3,0,30,27
1683320545684,MATH 20D,B01,188447,Hammock; Frances H,2,0,30,28
1683320545684,MATH 20D,B02,188486,Hammock; Frances H,8,0,30,22
1683320546709,MATH 20E,A01,188649,Staff,21,0,30,9
1683320546709,MATH 20E,A02,188650,Staff,23,0,30,7
1683320546709,MATH 20E,A03,188673,Staff,0,0,30,30
1683320547737,MATH 102,A01,188675,Staff,0,35,35,35
1683320548762,MATH 103B,A01,188681,Staff,4,0,35,31
1683320548762,MATH 103B,B01,188692,Staff,5,0,35,30
1683320549786,MATH 109,A01,188695,Salehi Golsefidy; Alireza,25,0,35,10
1683320549786,MATH 109,A02,188696,Salehi Golsefidy; Alireza,26,0,35,9
1683320550811,MATH 120A,A01,188698,Eggers; John Dietrich,7,0,35,28
1683320551840,MATH 142B,A01,188736,Ioana; Adrian,0,2,30,30
1683320551840,MATH 142B,A02,188741,Ioana; Adrian,0,1,30,30
1683320551840,MATH 142B,A03,188743,Ioana; Adrian,1,3,30,29
1683320552867,MATH 168A,A01,188790,Staff,0,9,35,35
1683320553899,MATH 170A,A01,188803,Nie; Jiawang,0,2,35,35
1683320553899,MATH 170A,A02,188811,Nie; Jiawang,0,0,35,35
1683320553899,MATH 170A,A03,188814,Nie; Jiawang,0,0,35,35
1683320553899,MATH 170A,A04,188815,Nie; Jiawang,13,0,35,22
1683320554924,MATH 193B,A01,188817,Staff,0,0,35,35
1683320554924,MATH 193B,A02,188818,Staff,6,0,35,29
1683320555949,MGT 4,A01,202857,Anderson; John Charles,62,0,80,18
1683320556977,MGT 12,A00,202858,Lindenberger; Wade Douglas,42,0,90,48
1683320558013,MGT 18,A00,202859,Staff,74,0,90,16
1683320559039,MGT 18GS,A00,202860,McKay; Michael J,13,0,28,15
1683320560066,MGT 45,A00,202861,Pecore; Joseph P.,13,0,90,77
1683320561089,MGT 100,A00,202863,Yavorsky; Daniel Ryan,28,0,90,62
1683320562113,MGT 103,A00,202864,Ehrich; Kristine R,0,18,90,90
1683320563135,MGT 112,A00,202865,Ehrich; Kristine R,15,0,90,75
1683320564158,MGT 121A,A00,202868,Staff,0,20,0,0
1683320565182,MGT 131B,A00,202869,Anderson; John Charles,59,0,90,31
1683320566207,MGT 136,A00,202871,Lindenberger; Wade Douglas,84,0,90,6
1683320567232,MGT 164,A00,202873,Staff,0,68,90,91
1683320568256,MGT 164GS,A00,202874,McKay; Mary A,13,0,28,15
1683320569282,MGT 180,A00,202875,Staff,0,50,90,91
1683320570305,MMW 11R,A01,205019,Herbst; Matthew,3,0,30,27
1683320570305,MMW 11R,A02,205026,Herbst; Matthew,29,0,30,1
1683320571330,MMW 15,A01,193512,Chang; Edmond Yi-Teh,0,9,28,28
1683320571330,MMW 15,A02,193513,Chang; Edmond Yi-Teh,0,5,28,28
1683320571330,MMW 15,A03,193514,Chang; Edmond Yi-Teh,0,5,28,28
1683320571330,MMW 15,A04,193515,Chang; Edmond Yi-Teh,0,5,28,28
1683320571330,MMW 15,A05,193516,Chang; Edmond Yi-Teh,0,4,28,28
1683320571330,MMW 15,A06,193517,Chang; Edmond Yi-Teh,0,5,28,28
1683320571330,MMW 15,B01,193519,Chang; Edmond Yi-Teh,0,4,28,28
1683320571330,MMW 15,B02,193520,Chang; Edmond Yi-Teh,0,5,28,28
1683320571330,MMW 15,B03,193521,Chang; Edmond Yi-Teh,0,4,28,28
1683320571330,MMW 15,B04,193522,Chang; Edmond Yi-Teh,0,4,28,28
1683320571330,MMW 15,B05,193523,Chang; Edmond Yi-Teh,0,5,28,28
1683320571330,MMW 15,B06,193524,Chang; Edmond Yi-Teh,0,4,28,28
1683320572358,MMW 122,A01,193526,Rahimi; Babak,0,14,28,28
1683320572358,MMW 122,A02,193527,Rahimi; Babak,0,14,28,28
1683320572358,MMW 122,A03,193528,Rahimi; Babak,0,0,0,0
1683320572358,MMW 122,A04,193529,Rahimi; Babak,0,0,0,0
1683320573385,MUS 1A,A01,186663,Staff,0,20,35,35
1683320574412,MUS 4,A01,186715,Staff,0,12,35,35
1683320575440,MUS 5R,A01,186796,Dubnov; Shlomo,0,17,35,35
1683320576463,MUS 6,A01,186798,Staff,0,3,25,25
1683320577486,MUS 7,A01,186830,Staff,12,0,35,23
1683320578510,MUS 8,A01,186930,Staff,0,26,35,35
1683320579535,MUS 15,A01,186932,Staff,0,15,35,35
1683320579535,MUS 15,B01,186934,Staff,0,15,35,35
1683320580564,MUS 80,A00,186935,Staff,2,0,20,18
1683320580564,MUS 80,B00,186936,Staff,25,0,25,0
1683320581590,NANO 11,A00,204702,Lipomi; Darren John,0,0,0,0
1683320582617,NANO 15,A01,204709,Yang; Kesong,0,1,0,0
1683320583645,NANO 114,A00,202069,Jahed Motlagh; Zeinab,3,0,10,7
1683320584669,PHIL 1,A00,186955,Grush; Rick Scott,32,0,40,8
1683320585694,PHIL 10,A01,186973,Grush; Rick Scott,28,0,35,7
1683320585694,PHIL 10,A02,186974,Grush; Rick Scott,33,0,35,2
1683320586721,PHIL 13,A01,186976,Staff,7,0,35,28
1683320586721,PHIL 13,A02,186977,Staff,16,0,35,19
1683320587745,PHIL 14,A01,186979,Staff,31,0,35,4
1683320587745,PHIL 14,A02,186986,Staff,32,0,35,3
1683320588773,PHIL 28,A01,186988,Staff,16,0,30,14
1683320588773,PHIL 28,A02,186989,Staff,1,0,30,29
1683320588773,PHIL 28,A03,186990,Staff,9,0,30,21
1683320588773,PHIL 28,A04,186991,Staff,26,0,30,4
1683320589800,PHIL 120,A00,186997,Staff,23,0,40,17
1683320590827,PHIL 137,A00,187003,Staff,9,0,40,31
1683320591851,PHIL 150,A00,187015,Staff,47,0,70,23
1683320592878,PHIL 167,A00,187021,Lamey; Andy M.,35,0,40,5
1683320593906,PHIL 174,A01,202226,Staff,17,0,20,3
1683320593906,PHIL 174,A02,202235,Staff,20,0,20,0
1683320594933,PHIL 191A,A00,258918,Staff,0,0,1,1
1683320595956,PHYS 1A,A00,187028,Staff,27,0,60,33
1683320596984,PHYS 1AL,001,187036,Staff,3,0,30,27
1683320596984,PHYS 1AL,002,187049,Staff,18,0,30,12
1683320598008,PHYS 1B,A00,187058,Staff,22,0,60,38
1683320599036,PHYS 1BL,001,187064,Staff,0,0,30,30
1683320599036,PHYS 1BL,002,187070,Staff,5,0,30,25
1683320600065,PHYS 1C,A00,187082,Staff,31,0,120,89
1683320601090,PHYS 1CL,001,187088,Staff,0,9,30,30
1683320601090,PHYS 1CL,002,187089,Staff,0,2,30,30
1683320601090,PHYS 1CL,009,262693,Staff,11,0,30,19
1683320602122,PHYS 2B,A01,187097,Staff,54,0,115,61
1683320603146,PHYS 2C,A01,187099,Staff,67,0,115,48
1683320604171,PHYS 2CL,A01,187101,Staff,5,0,28,23
1683320604171,PHYS 2CL,A02,187102,Staff,15,0,28,13
1683320605199,PHYS 2D,A01,187123,Shotwell; Brian,95,0,115,20
1683320606225,PHYS 4B,A01,187133,Grinstein; Benjamin,35,0,50,15
1683320607248,POLI 10,A00,188819,Staff,0,4,50,50
1683320608274,POLI 11,A00,188827,Staff,43,0,50,7
1683320609297,POLI 13R,A00,188828,Staff,0,1,20,20
1683320610325,POLI 27,A01,188830,Elgin; Samuel Zincke,0,1,70,70
1683320611352,POLI 30,A00,188832,Desposato; Scott,31,0,50,19
1683320612384,POLI 102F,A00,188834,Staff,3,0,40,37
1683320613408,POLI 104A,A00,188852,Staff,14,0,30,16
1683320614434,POLI 104I,A00,188853,Staff,0,6,20,20
1683320615461,POLI 110B,A00,188854,Wiens; David,7,0,20,13
1683320616488,POLI 112A,A00,188855,Wiens; David,5,0,30,25
1683320617513,POLI 117R,A00,188856,Forman; Fonna,0,11,20,20
1683320618545,POLI 118,A00,188857,Ingham; Sean,8,0,20,12
1683320619569,POLI 120G,A00,188858,Staff,9,0,30,21
1683320620596,POLI 131CR,A00,188863,Hoston; Germaine,24,0,50,26
1683320621621,POLI 133,A00,188864,Nellis; Gareth Hb,44,0,50,6
1683320622645,POLI 134D,A00,188865,Desposato; Scott,27,0,30,3
1683320623670,POLI 142A,A00,188871,Gartzke; Erik,22,0,50,28
1683320624697,POLI 142K,A00,188874,Staff,38,0,50,12
1683320625724,POLI 143,A00,188940,Gartzke; Erik,16,0,30,14
1683320626750,POLI 153,A00,188943,Staff,3,0,20,17
1683320627774,POLI 160AA,A00,188944,Staff,12,0,40,28
1683320628797,POLI 170A,A00,188945,Staff,11,0,30,19
1683320630848,PSYC 1,A00,188952,Staff,37,0,90,53
1683320631872,PSYC 2,B00,188953,Staff,19,0,35,16
1683320632895,PSYC 6,A00,188970,Staff,47,0,60,13
1683320633923,PSYC 7,A00,188973,Staff,37,0,45,8
1683320634947,PSYC 60,A01,188980,Rickard; Timothy C.,43,0,60,17
1683320635971,PSYC 70,A01,189001,Steiner; Eric Tomas,24,0,45,21
1683320636996,PSYC 100,A00,189005,Lacefield; Katharine I,0,99,120,120
1683320638075,PSYC 102,A00,189008,Staff,10,0,30,20
1683320639102,PSYC 106,B00,189026,Gorman; Michael R.,35,0,60,25
1683320640126,PSYC 114,B01,189033,Winkielman; Piotr,0,32,30,30
1683320641150,PSYC 131,A00,189036,Anagnostaras; Stephan,0,43,60,60
1683320642174,PSYC 136,A00,189041,Lowe; Angela Beth,0,7,25,25
1683320643199,PSYC 137,A00,189057,Winkielman; Piotr,0,34,25,25
1683320644226,PSYC 144,A00,189107,Wixted; John T,0,7,50,50
1683320646276,PSYC 162,A00,189142,Staff,0,8,85,85
1683320647303,PSYC 172,A00,189144,Gorman; Michael R.,0,7,30,30
1683320649355,PSYC 179,A00,189146,Lacefield; Katharine I,0,84,120,120
1683320650378,PSYC 181,A00,189147,Anagnostaras; Stephan,0,44,90,90
1683320651406,PSYC 190R,A00,189148,Barner; David A.,0,22,80,80
1683320652432,PSYC 191,A00,189275,Rickard; Timothy C.,0,7,25,25
1683320653457,PSYC 193,A00,189276,Chapman; Eddie Nathaniel,0,1,0,4
1683320654486,PSYC 193L,A01,189281,Lowe; Angela Beth,12,0,20,8
1683320654486,PSYC 193L,B01,189285,Staff,28,0,35,7
1683320655509,RELI 149,A00,187137,Rahimi; Babak,7,0,40,33
1683320656536,SE 9,A01,187315,Staff,0,2,18,18
1683320657560,SE 101B,A00,187409,Staff,24,0,30,6
1683320658586,SE 110B,A00,187444,Staff,10,0,40,30
1683320659611,SE 130B,A00,187449,Staff,31,0,40,9
1683320660644,SE 150A,A00,187516,Staff,9,0,20,11
1683320661668,SE 154,A00,187528,Staff,30,0,50,20
1683320662696,SIO 3,A01,258171,Staff,35,0,40,5
1683320663723,SIO 10,A00,187144,Cook; Geoffrey W,0,3,75,75
1683320664747,SIO 45,A00,187152,Cook; Geoffrey W,1,0,100,99
1683320665774,SIO 109R,A00,194486,Staff,0,3,20,20
1683320667831,SIO 187,A01,187233,Kacev; David,12,0,40,28
1683320668860,SOCI 1,A01,258656,Thorpe; Charles Robert,28,0,30,2
1683320668860,SOCI 1,A02,258658,Thorpe; Charles Robert,30,0,30,0
1683320668860,SOCI 1,A03,258661,Thorpe; Charles Robert,25,0,25,0
1683320668860,SOCI 1,A04,258666,Thorpe; Charles Robert,22,0,25,3
1683320668860,SOCI 1,A05,258897,Thorpe; Charles Robert,23,0,25,2
1683320668860,SOCI 1,A06,258898,Thorpe; Charles Robert,25,0,25,0
1683320669885,SOCI 30,A01,258903,Pardo Guerra; Juan Pablo,16,0,30,14
1683320670911,SOCI 102,A00,258904,Staff,9,0,25,16
1683320671935,SOCI 106,A00,258905,Staff,19,0,25,6
1683320672962,SOCI 111,A00,258907,Ribas Norris; Janet Vanesa,26,0,30,4
1683320673985,SOCI 121R,A00,258908,Pardo Guerra; Juan Pablo,11,0,30,19
1683320675010,SOCI 126,A01,203330,Staff,14,0,20,6
1683320676033,SOCI 131,A00,258909,Thorpe; Charles Robert,31,0,60,29
1683320677057,SOCI 135,A00,258910,Payne; Christine Anna,0,9,30,30
1683320678080,SOCI 157,A00,258911,Staff,12,0,30,18
1683320679109,SOCI 184,A00,258912,Staff,25,0,30,5
1683320680134,SOCI 188D,A00,258913,Staff,21,0,30,9
1683320681159,SYN 2,001,187529,Staff,9,0,16,7
1683320681159,SYN 2,002,201452,Staff,0,18,16,16
1683320681159,SYN 2,003,201469,Staff,4,0,16,12
1683320682183,SYN 100,A01,187531,Staff,0,9,20,20
1683320682183,SYN 100,B01,201491,Staff,0,12,20,20
1683320683209,TDAC 1,A00,189286,Walsh; Kim C.,3,0,20,17
1683320683209,TDAC 1,B00,189287,Harting; Carla Kelso,11,0,20,9
1683320684233,TDAC 101,A00,189300,Walsh; Kim C.,16,0,20,4
1683320684233,TDAC 101,B00,189301,Harting; Carla Kelso,18,0,20,2
1683320685259,TDAC 102,A00,189304,Basso; Beatrice,14,0,20,6
1683320686283,TDAC 108,A00,189305,Staff,18,0,20,2
1683320687307,TDDE 131,A00,189310,Staff,19,0,20,1
1683320687307,TDDE 131,B00,189314,Staff,19,0,20,1
1683320687307,TDDE 131,C00,189315,Staff,48,0,50,2
1683320687307,TDDE 131,D00,189316,Staff,14,0,15,1
1683320687307,TDDE 131,E00,204841,Staff,20,0,20,0
1683320688339,TDGE 10,A00,189289,Staff,30,0,50,20
1683320688339,TDGE 10,B00,189290,Havis; Allan,1,0,50,49
1683320689364,TDGE 11,A00,189291,Fulton; Julia,0,3,50,50
1683320689364,TDGE 11,B00,189292,Staff,20,0,25,5
1683320689364,TDGE 11,C00,260270,Staff,0,0,0,0
1683320690389,TDGE 25,A00,189294,Staff,3,0,20,17
1683320691415,TDGE 124,A00,189318,Fulton; Julia,0,8,50,50
1683320692439,TDGE 125,A00,189319,Staff,13,0,25,12
1683320692439,TDGE 125,B00,189320,Staff,23,0,25,2
1683320693466,TDGE 127,A00,189322,Havis; Allan,0,0,50,50
1683320694492,TDHT 101,A00,189323,Staff,18,0,25,7
1683320694492,TDHT 101,B00,189324,Staff,25,0,25,0
1683320695515,TDHT 102,A00,189325,Staff,49,0,50,1
1683320696542,TDMV 1,A00,189295,Arcidiacono; Kristin,19,0,30,11
1683320696542,TDMV 1,B00,189296,Caligagan; Maria T.,24,0,30,6
1683320697570,TDMV 2,A00,189297,Sammartano; Tonnie,28,0,30,2
1683320697570,TDMV 2,B00,189299,Arcidiacono; Kristin,24,0,30,6
1683320698593,TDMV 3,A00,204998,Rincon; Alicia,22,0,30,8
1683320699620,TDMV 120,A00,189458,Sammartano; Tonnie,28,0,30,2
1683320700645,TDMV 138,A00,189541,Jun; Grace Shin Hae,22,0,40,18
1683320701689,TDMV 142,A00,189717,Caligagan; Tony,23,0,30,7
1683320701689,TDMV 142,B00,189718,Caligagan; Maria T.,25,0,30,5
1683320702713,TMC 2,A01,187533,Staff,25,0,25,0
1683320702713,TMC 2,A02,187534,Staff,25,0,25,0
1683320703738,USP 1,A01,187536,Kwak; Nancy,0,16,25,25
1683320704761,USP 5,A01,187538,Staff,9,0,25,16
1683320705785,USP 101,A00,199253,Staff,0,4,0,0
1683320706810,USP 124,A00,187562,Boomhower; Matthew Charles,1,0,30,29
1683320707836,USP 138,A00,187582,Staff,20,0,25,5
1683320708863,USP 152,A01,187597,Staff,4,0,25,21
1683320709891,USP 153,A00,187598,Staff,19,0,25,6
1683320710918,USP 168,A00,187607,Kwak; Nancy,2,0,5,3
1683320711945,USP 173,A00,187619,Staff,4,0,25,21
1683320712967,USP 181,A00,187638,Staff,0,0,25,25
1683320713991,VIS 103,A00,187650,Cruz; Edwin Teddy,23,0,75,52
1683320715017,VIS 110D,A00,187669,Staff,12,0,22,10
1683320716041,VIS 127C,A00,187720,Shen; Kuiyi,68,0,146,78
1683320717066,VIS 149,A00,187731,Yoldas; Pinar,0,14,22,22
1683320718090,VIS 151,A01,188091,Staff,22,0,34,12
1683320718090,VIS 151,A02,188092,Staff,11,0,34,23
1683320719114,VIS 160B,A00,188093,Stalbaum; Brett,0,0,10,10
1683320721169,WCWP 10B,A00,201720,Staff,10,0,15,5
1683320721169,WCWP 10B,B00,201722,Staff,8,0,15,7
1683320722193,WCWP 100,A00,201725,Gagnon; Jeffrey C,0,0,2,2
1683320722193,WCWP 100,B00,201727,Staff,0,4,15,15
1683320725289,ANBI 133,A00,258401,Wilder; Linnea Lorene,34,0,40,6
1683320726314,ANBI 140,A00,258395,Hrvoj Mihic; Branka,18,0,25,7
1683320727340,ANSC 120,A00,258402,Bialecki; Jon Anthony,27,0,40,13
1683320728363,ANSC 144,A00,258400,Staff,14,0,40,26
1683320730413,ANSC 166,A00,258396,Parish; Steven Martin,157,0,175,18
1683320731437,ANSC 180,A00,193533,Staff,9,0,20,11
1683320732464,ANSC 188,A00,258397,Jassal; Aftab,33,0,40,7
1683320733488,ANTH 3,A01,258316,Staff,23,0,30,7
1683320734517,ANTH 5,A00,258394,Semendeferi; Ekaterini,16,0,20,4
1683320735541,ANTH 21,A01,258331,Staff,9,0,40,31
1683320736567,ANTH 103,A00,258398,Varma; Saiba,15,0,25,10
1683320737598,AWP 10,001,202034,Staff,0,0,0,0
1683320737598,AWP 10,002,202035,Staff,0,0,0,0
1683320737598,AWP 10,003,202036,Staff,0,0,0,0
1683320737598,AWP 10,004,202037,Staff,0,0,0,0
1683320737598,AWP 10,005,202038,Staff,0,0,0,0
1683320737598,AWP 10,006,202039,Staff,0,0,0,0
1683320737598,AWP 10,007,202040,Staff,0,0,0,0
1683320737598,AWP 10,008,202041,Staff,0,0,0,0
1683320737598,AWP 10,009,202042,Staff,0,0,0,0
1683320737598,AWP 10,010,202043,Staff,0,0,0,0
1683320737598,AWP 10,011,202044,Staff,0,0,0,0
1683320737598,AWP 10,012,202045,Staff,0,0,0,0
1683320737598,AWP 10,013,202046,Staff,0,0,0,0
1683320737598,AWP 10,014,202047,Staff,0,0,0,0
1683320737598,AWP 10,015,202048,Staff,0,0,0,0
1683320737598,AWP 10,016,202049,Staff,0,0,0,0
1683320737598,AWP 10,017,202050,Staff,0,0,0,0
1683320737598,AWP 10,018,202051,Staff,0,0,0,0
1683320737598,AWP 10,019,202052,Staff,0,0,0,0
1683320737598,AWP 10,020,202053,Staff,0,0,0,0
1683320737598,AWP 10,021,202054,Staff,0,0,0,0
1683320737598,AWP 10,022,202055,Staff,0,0,0,0
1683320737598,AWP 10,023,202056,Staff,0,0,0,0
1683320737598,AWP 10,024,202057,Staff,0,0,0,0
1683320737598,AWP 10,025,202058,Staff,0,0,0,0
1683320737598,AWP 10,026,202059,Staff,0,0,0,0
1683320738624,AWP 102,001,202032,Staff,0,0,0,0
1683320738624,AWP 102,002,202033,Staff,0,0,0,0
1683320739652,BENG 100,A01,254234,Taylor Amos; Alyssa C,31,0,40,9
1683320740676,BENG 196,001,270013,Engler; Adam J.,9999,0,9999,0
1683320741757,BICD 100R,A01,202018,Smith; Laurie,0,7,32,32
1683320741757,BICD 100R,A02,202019,Smith; Laurie,0,2,32,32
1683320741757,BICD 100R,A03,202020,Smith; Laurie,0,1,32,32
1683320741757,BICD 100R,A04,202021,Smith; Laurie,8,0,32,24
1683320741757,BICD 100R,A05,202022,Smith; Laurie,12,0,32,20
1683320742783,BICD 136,A01,193242,Gustafson-Brown; Cindy,0,2,32,32
1683320742783,BICD 136,A02,193244,Gustafson-Brown; Cindy,14,0,32,18
1683320743807,BIEB 102,A01,193249,Butler; Shannon Rhey,0,2,32,32
1683320743807,BIEB 102,A02,193251,Butler; Shannon Rhey,0,0,32,32
1683320743807,BIEB 102,A03,193253,Butler; Shannon Rhey,0,1,32,32
1683320743807,BIEB 102,A04,193255,Butler; Shannon Rhey,17,0,32,15
1683320743807,BIEB 102,A05,193265,Butler; Shannon Rhey,26,0,32,6
1683320743807,BIEB 102,A06,193269,Butler; Shannon Rhey,16,0,32,16
1683320745858,BIEB 150,A01,193274,Staff,0,0,32,32
1683320745858,BIEB 150,A02,193285,Staff,23,0,32,9
1683320746881,BIEB 194,A00,193286,Kurle; Carolyn M.,22,0,32,10
1683320747910,BILD 1,A01,192291,Staff,16,0,32,16
1683320747910,BILD 1,A02,192292,Staff,30,0,32,2
1683320747910,BILD 1,B01,192520,Reuther; Keefe,0,1,0,0
1683320747910,BILD 1,B02,192532,Reuther; Keefe,0,1,0,0
1683320748935,BILD 3,A01,192556,Butler; Shannon Rhey,0,0,32,32
1683320748935,BILD 3,A02,192581,Butler; Shannon Rhey,5,0,32,27
1683320748935,BILD 3,A03,192611,Butler; Shannon Rhey,23,0,32,9
1683320748935,BILD 3,A04,192612,Butler; Shannon Rhey,25,0,32,7
1683320748935,BILD 3,A05,192613,Butler; Shannon Rhey,27,0,32,5
1683320748935,BILD 3,A06,192679,Butler; Shannon Rhey,27,0,32,5
1683320748935,BILD 3,A07,192682,Butler; Shannon Rhey,22,0,32,10
1683320749962,BILD 4,A01,192836,Reuther; Keefe,0,0,24,24
1683320749962,BILD 4,A02,193044,Reuther; Keefe,4,0,24,20
1683320750986,BILD 10,A01,193142,Gustafson-Brown; Cindy,30,0,32,2
1683320750986,BILD 10,A02,193149,Gustafson-Brown; Cindy,31,0,32,1
1683320752011,BIMM 100,A01,193301,Staff,0,6,32,32
1683320752011,BIMM 100,A02,193312,Staff,0,5,32,32
1683320752011,BIMM 100,A03,193323,Staff,0,8,32,32
1683320753037,BIMM 101,A01,193329,McDonnell; Lisa Marie,0,3,24,24
1683320753037,BIMM 101,A02,193339,McDonnell; Lisa Marie,0,3,24,24
1683320753037,BIMM 101,B01,193354,McDonnell; Lisa Marie,0,3,24,24
1683320753037,BIMM 101,B02,193357,McDonnell; Lisa Marie,0,3,24,24
1683320754064,BIMM 110,A01,193377,Tat; John,0,11,32,32
1683320754064,BIMM 110,A02,193378,Tat; John,1,9,32,31
1683320755092,BIMM 120,A01,206116,Staff,0,0,32,32
1683320755092,BIMM 120,A02,206117,Staff,8,0,32,24
1683320755092,BIMM 120,A03,206121,Staff,21,0,32,11
1683320756120,BIPN 100,A01,193393,Park; Ji Young,0,14,32,32
1683320756120,BIPN 100,A02,193402,Park; Ji Young,0,12,32,32
1683320756120,BIPN 100,A03,193413,Park; Ji Young,0,14,32,32
1683320756120,BIPN 100,A04,193414,Park; Ji Young,0,13,32,32
1683320757149,BIPN 102,A01,193429,Staff,0,0,32,32
1683320757149,BIPN 102,A02,193438,Staff,22,0,32,10
1683320758173,BIPN 106,A01,193450,Reyes Gonzalez; Catalina,0,2,40,40
1683320759198,BIPN 134,A01,193465,Cooke; James Edward,0,0,32,32
1683320759198,BIPN 134,A02,193474,Cooke; James Edward,25,0,32,7
1683320759198,BIPN 134,A03,193485,Cooke; James Edward,29,0,32,3
1683320759198,BIPN 134,A04,193486,Cooke; James Edward,21,0,32,11
1683320759198,BIPN 134,A05,193491,Cooke; James Edward,31,0,32,1
1683320759198,BIPN 134,A06,193501,Cooke; James Edward,30,0,32,2
1683320759198,BIPN 134,A07,193510,Cooke; James Edward,29,0,32,3
1683320761255,BISP 194,A00,222522,Staff,15,0,32,17
1683320762282,CAT 124,A01,202407,Staff,20,0,25,5
1683320763314,CAT 125,A00,202408,Marchisotto; Jennifer Anne,4,0,20,16
1683320764341,CAT 125R,A00,202409,Smith; Lauryn Alissa,0,11,20,20
1683320764341,CAT 125R,B00,202410,Morales; Celeste Georgianna,0,11,20,20
1683320764341,CAT 125R,C00,202411,Irwin; Matthew Joseph,0,10,20,20
1683320765369,CENG 15,A01,204712,Yang; Kesong,0,1,0,0
1683320766393,CENG 114,A00,202070,Jahed Motlagh; Zeinab,5,0,20,15
1683320767417,CGS 105,A00,185477,Wesling; Megan E.,24,0,40,16
1683320768443,CGS 106,A00,185494,Staff,13,0,22,9
1683320769469,CGS 108,A00,185495,Staff,14,0,20,6
1683320770497,CGS 114,A00,185496,Staff,13,0,18,5
1683320771520,CGS 119,A00,185501,Staff,15,0,20,5
1683320772545,CGS 120,A00,185511,Staff,13,0,20,7
1683320773570,CHEM 4,A01,184675,Bussey; Thomas J,96,0,100,4
1683320774595,CHEM 6A,A01,184677,Staff,34,0,60,26
1683320775620,CHEM 6B,A01,184679,Staff,65,0,100,35
1683320776645,CHEM 6C,A01,184681,Bussey; Thomas J,1,0,50,49
1683320776645,CHEM 6C,A02,184682,Bussey; Thomas J,34,0,50,16
1683320777673,CHEM 40A,A01,184684,Albizati; Kim F.,37,0,100,63
1683320778699,CHEM 40B,A01,184686,Albizati; Kim F.,0,20,100,100
1683320779723,CHEM 41B,A01,184690,Staff,52,0,100,48
1683320780752,COGS 3,A01,184715,Boyle; Mary E. T.,0,25,40,40
1683320781777,COGS 14B,A01,185172,Staff,0,15,38,38
1683320782810,COGS 18,A01,184736,Staff,18,0,80,62
1683320783837,COGS 100,A01,184932,Staff,0,5,73,73
1683320784862,COGS 101A,A01,184935,Staff,0,38,30,30
1683320785889,COGS 101B,A01,184944,Staff,0,2,30,30
1683320786914,COGS 101C,A01,184946,Staff,0,12,30,30
1683320787944,COGS 102A,A01,184951,Johnson; Christine M.,2,0,40,38
1683320788970,COGS 107B,A01,184953,Mooshagian; Eric Frederick,0,50,40,40
1683320789998,COGS 118B,A01,184959,Gupta; Anjum,0,48,40,40
1683320791028,COGS 153,A00,184961,Staff,0,15,30,30
1683320792054,COGS 177,A00,184962,Staff,0,21,30,30
1683320793079,COGS 187A,A01,184969,Boyle; Mary E. T.,0,17,40,40
1683320794110,COMM 10,A01,185174,Staff,0,5,25,25
1683320794110,COMM 10,A02,185189,Staff,0,5,25,25
1683320794110,COMM 10,A03,269821,Staff,0,0,0,0
1683320795138,COMM 100B,A01,185475,Staff,0,0,0,2
1683320795138,COMM 100B,A02,185476,Staff,14,0,25,11
1683320796162,COMM 100C,A01,185314,Staff,1,0,25,24
1683320796162,COMM 100C,A02,185327,Staff,19,0,25,6
1683320797189,COMM 110M,A00,185349,Staff,2,0,40,38
1683320798216,COMM 113T,A00,185352,Staff,25,0,40,15
1683320799244,COMM 114I,A00,185353,Staff,33,0,40,7
1683320800271,COMM 131,A00,185354,Staff,19,0,30,11
1683320801298,CSE 8A,A50,185358,Cao; Yingjun,0,46,10,10
1683320802324,CSE 8B,A01,185362,Staff,1,47,50,49
1683320803349,CSE 11,A01,185416,Cao; Yingjun,0,92,10,10
1683320804377,CSE 20,A01,185445,Briones; Jor-el Thomas Caparas,5,0,25,20
1683320805402,CSE 21,A01,185447,Staff,10,0,50,40
1683320806426,CSE 101,A01,185451,Staff,0,12,50,50
1683320806426,CSE 101,B01,185453,Jones; Miles E,0,11,50,50
1683320808475,CSE 141,A01,185458,Eldon; John,20,0,100,80
1683320809503,CSE 141L,A01,185461,Eldon; John,12,0,100,88
1683320810529,CSE 142,A01,185463,Staff,36,0,60,24
1683320810529,CSE 142,B01,201355,Staff,0,7,60,60
1683320811557,CSE 142L,A01,185470,Staff,36,0,60,24
1683320811557,CSE 142L,B01,201417,Staff,0,6,60,60
1683320812579,CSE 190,A00,201433,Staff,32,0,49,17
1683320813604,DOC 1,A01,259136,Strom; Megan C.,7,0,15,8
1683320813604,DOC 1,A02,259137,Strom; Megan C.,14,0,15,1
1683320813604,DOC 1,A03,259138,Strom; Megan C.,14,0,15,1
1683320813604,DOC 1,A04,259139,Strom; Megan C.,14,0,15,1
1683320814631,DOC 100D,A00,259140,Pass; Natalye Joann,17,0,25,8
1683320815655,DSGN 1,A01,184749,Rill; Bryan,0,25,30,30
1683320816681,DSGN 100,A01,185168,Staff,0,2,25,25
1683320817706,ECE 5,A01,185626,Morris; Karcher William,0,10,0,0
1683320818732,ECE 101,A01,185628,Staff,17,0,70,53
1683320819761,ECE 107,A01,185635,Baghdadchi; Saharnaz,0,0,20,20
1683320819761,ECE 107,A02,185638,Baghdadchi; Saharnaz,4,0,20,16
1683320820785,ECE 148,A01,185647,Silberman; Jack,0,0,16,16
1683320821809,ECON 1,A01,185537,Crane; Meredith Helen,54,0,70,16
1683320822836,ECON 3,A01,185549,Crane; Meredith Helen,33,0,70,37
1683320823861,ECON 4,A01,203354,Anderson; John Charles,0,4,10,10
1683320824887,ECON 100A,A01,185574,Staff,0,4,40,40
1683320825914,ECON 100B,A01,185576,Staff,0,22,40,40
1683320826937,ECON 100C,A01,185589,Newhouse; Herbert S,30,0,70,40
1683320827965,ECON 105,A00,185608,Vespa; Emanuel Ignacio,19,0,35,16
1683320828992,ECON 109,A01,185610,Shishkin; Denis,10,0,35,25
1683320830019,ECON 110A,A01,185612,Staff,11,0,40,29
1683320831043,ECON 120A,A01,185615,Staff,20,0,40,20
1683320832069,ECON 120C,A01,185617,Sun; Yixiao,0,20,70,70
1683320833094,ECON 144,A00,203346,Squires; Dale E,3,0,35,32
1683320834118,ECON 171,A01,203349,Newhouse; Herbert S,0,1,35,35
1683320835141,ECON 173A,A01,185621,Toda; Alexis Akira,21,0,35,14
1683320836164,EDS 25,A01,202413,Staff,0,1,0,0
1683320836164,EDS 25,A02,202414,Staff,0,1,0,0
1683320836164,EDS 25,A03,202415,Staff,0,0,0,0
1683320836164,EDS 25,A04,202416,Staff,0,1,0,0
1683320836164,EDS 25,A05,202439,Staff,0,0,0,0
1683320836164,EDS 25,A06,202440,Staff,0,0,0,0
1683320836164,EDS 25,B01,202631,Staff,0,0,0,0
1683320836164,EDS 25,B02,202632,Staff,0,0,0,0
1683320836164,EDS 25,B03,202639,Staff,0,0,0,0
1683320836164,EDS 25,B04,202640,Staff,0,0,0,0
1683320836164,EDS 25,B05,202643,Staff,0,0,0,0
1683320836164,EDS 25,B06,202644,Staff,0,0,0,0
1683320837188,EDS 38,A01,202659,Black; Alison Michelle,24,0,25,1
1683320838212,EDS 115,A00,202652,Staff,17,0,30,13
1683320839238,EDS 125,A00,202649,Staff,14,0,30,16
1683320840262,EDS 126,A01,203332,Staff,30,0,30,0
1683320841286,EDS 139,A00,202838,Staff,16,0,25,9
1683320842310,EDS 146,A01,202655,Staff,14,0,25,11
1683320843335,ENG 15,A00,185667,Staff,0,1,0,0
1683320843335,ENG 15,B00,185672,Staff,0,0,0,0
1683320843335,ENG 15,C00,185675,Staff,0,0,0,0
1683320843335,ENG 15,D00,185682,Staff,0,0,0,0
1683320843335,ENG 15,E00,185684,Staff,0,0,0,0
1683320844358,ETHN 103,A00,185710,Staff,0,3,35,35
1683320845443,ETHN 103A,A00,199228,Man; Simeon S,2,0,9,7
1683320846470,ETHN 109,A00,185711,Staff,18,0,35,17
1683320847497,ETHN 142,A00,185726,Staff,0,4,30,30
1683320848525,ETHN 163J,A00,199229,Man; Simeon S,5,0,8,3
1683320849554,ETHN 168,A00,185727,Staff,8,0,10,2
1683320850580,ETHN 182,A00,185728,Staff,1,0,35,34
1683320851604,ETHN 183,A00,185737,Staff,8,0,18,10
1683320852627,GLBH 111,A01,209361,Burgos; Jose L.,0,0,0,0
1683320854677,HIEU 104,A00,185792,Staff,16,0,20,4
1683320855701,HIEU 115,A00,185800,Staff,1,0,20,19
1683320856727,HIEU 128,A00,185801,Staff,0,7,20,20
1683320857751,HIEU 147,A00,185802,Staff,16,0,20,4
1683320858778,HIEU 154,A00,185823,Staff,12,0,20,8
1683320859805,HILA 102,A00,185826,Staff,13,0,20,7
1683320860830,HILD 2C,A01,185778,Staff,0,12,20,20
1683320861855,HILD 7B,A01,185780,Kwak; Nancy,0,15,32,32
1683320861855,HILD 7B,A02,185781,Kwak; Nancy,0,18,32,32
1683320862883,HILD 30,A01,185791,Staff,14,0,20,6
1683320863912,HISC 119,A00,185830,Golan; Tal,0,9,20,20
1683320864938,HITO 156GS,A00,185831,Patterson; Patrick H.,0,0,0,23
1683320865962,HIUS 103,A00,185832,Man; Simeon S,0,6,20,20
1683320866989,HIUS 117,A00,185836,Kwak; Nancy,2,0,20,18
1683320868016,HIUS 125,A00,185840,Man; Simeon S,0,0,23,23
1683320869043,HIUS 149,A00,185845,Staff,0,0,20,20
1683320870069,HUM 3,A01,185882,Zavodny; Tatiana Sophia,0,6,50,50
1683320870069,HUM 3,B01,185899,Caldwell; Michael Alan,0,19,50,50
1683320871097,HUM 3GS,A00,185900,Patterson; Patrick H.,0,0,0,23
1683320872125,HUM 4,A01,185938,Zroka; Amy Liane,31,0,50,19
1683320872125,HUM 4,B01,185956,Watkins; Eric,0,2,50,50
1683320872125,HUM 4,B02,202209,Watkins; Eric,0,2,50,50
1683320872125,HUM 4,B03,202210,Watkins; Eric,0,0,50,50
1683320873149,HUM 5,A01,185958,West; Geoffrey Scott,3,0,50,47
1683320873149,HUM 5,A02,202215,West; Geoffrey Scott,0,0,50,50
1683320874176,INTL 190,A00,185959,Gagnon; Jeffrey C,0,0,0,9
1683320874176,INTL 190,B00,185960,Lettieri; Michael Joseph,0,0,0,1
1683320875200,JAPN 180,A00,254509,Staff,5,1,30,25
1683320876227,LATI 10,A01,202853,Kennemore; Amy Michelle,5,0,35,30
1683320876227,LATI 10,A02,202854,Kennemore; Amy Michelle,1,0,35,34
1683320876227,LATI 10,A03,270054,Kennemore; Amy Michelle,30,0,30,0
1683320877253,LATI 180,A00,202855,Kennemore; Amy Michelle,11,0,20,9
1683320878279,LAWS 101,A00,201767,Golan; Tal,0,7,40,40
1683320879302,LIFR 1C,A00,185961,Staff,6,0,20,14
1683320880325,LIFR 1CX,A00,185962,Staff,7,0,20,13
1683320881350,LIFR 1D,A00,185963,Staff,9,0,20,11
1683320882378,LIFR 1DX,A00,185964,Staff,9,0,20,11
1683320883402,LIGN 101,A01,186039,Staff,43,0,50,7
1683320884425,LIGN 165,A00,186040,Staff,18,0,50,32
1683320885451,LTCS 108,A00,186041,Staff,6,0,10,4
1683320886475,LTCS 119,A00,186042,Staff,16,0,20,4
1683320887502,LTCS 130,A00,186043,Wesling; Megan E.,15,0,25,10
1683320889548,LTEA 138,A00,186119,Staff,14,0,40,26
1683320890575,LTEN 124,A00,186148,Staff,6,0,25,19
1683320891599,LTEN 178,A00,186149,Staff,7,0,15,8
1683320892622,LTEN 181,A00,186150,Blanco; John D,33,0,40,7
1683320893649,LTWL 120,A00,186160,Staff,20,0,25,5
1683320894673,LTWL 165,A00,186161,Staff,22,0,25,3
1683320895697,LTWR 100,A00,186162,Staff,0,5,15,15
1683320896725,LTWR 102,A00,186163,Doller; Ben,5,0,15,10
1683320897749,MAE 8,A01,186412,Staff,0,0,0,0
1683320898780,MAE 30B,A00,186445,Bahadori; Mohammad Yousef,83,0,100,17
1683320899806,MAE 40,A00,186592,Bewley; Thomas R,9,0,50,41
1683320900834,MAE 101B,A00,186593,Bahadori; Mohammad Yousef,81,0,100,19
1683320901863,MAE 105,A00,186594,Bandaru; Prabhakar,12,0,50,38
1683320902888,MAE 107,A00,186599,Pham; Hieu Tan,0,6,120,120
1683320903913,MAE 148,A01,186660,Silberman; Jack,3,0,16,13
1683320904937,MATH 10A,A01,188095,Staff,0,6,35,35
1683320905968,MATH 10B,A01,188097,Bowers; Adam R.,0,11,30,30
1683320905968,MATH 10B,A02,188099,Bowers; Adam R.,0,11,30,30
1683320905968,MATH 10B,B01,188104,Bowers; Adam R.,0,10,30,30
1683320905968,MATH 10B,B02,188106,Bowers; Adam R.,0,10,30,30
1683320906992,MATH 10C,A01,188111,Staff,0,18,30,30
1683320906992,MATH 10C,A02,188127,Staff,0,17,30,30
1683320906992,MATH 10C,A03,188131,Staff,0,18,30,30
1683320906992,MATH 10C,B01,188218,Staff,19,0,30,11
1683320906992,MATH 10C,B02,188244,Staff,13,0,30,17
1683320906992,MATH 10C,B03,188277,Staff,16,0,30,14
1683320908019,MATH 18,A01,188344,Bach; Quang Tran,18,0,30,12
1683320908019,MATH 18,A02,188345,Bach; Quang Tran,11,0,30,19
1683320908019,MATH 18,B01,188353,Bach; Quang Tran,10,0,30,20
1683320908019,MATH 18,B02,188354,Bach; Quang Tran,20,0,30,10
1683320909044,MATH 20A,A01,188374,Staff,13,0,35,22
1683320910073,MATH 20B,A01,188382,Ohm; Ko Woon,6,0,30,24
1683320910073,MATH 20B,A02,188383,Ohm; Ko Woon,23,0,30,7
1683320910073,MATH 20B,B01,188385,Ohm; Ko Woon,7,0,30,23
1683320910073,MATH 20B,B02,188392,Ohm; Ko Woon,22,0,30,8
1683320911097,MATH 20C,A01,188394,Harel; Guershon,10,0,30,20
1683320911097,MATH 20C,A02,188395,Harel; Guershon,14,0,30,16
1683320911097,MATH 20C,B01,188404,Harel; Guershon,5,0,30,25
1683320911097,MATH 20C,B02,188405,Harel; Guershon,19,0,30,11
1683320912122,MATH 20D,A01,188414,Hammock; Frances H,0,1,30,30
1683320912122,MATH 20D,A02,188415,Hammock; Frances H,3,0,30,27
1683320912122,MATH 20D,B01,188447,Hammock; Frances H,2,0,30,28
1683320912122,MATH 20D,B02,188486,Hammock; Frances H,8,0,30,22
1683320913146,MATH 20E,A01,188649,Staff,21,0,30,9
1683320913146,MATH 20E,A02,188650,Staff,23,0,30,7
1683320913146,MATH 20E,A03,188673,Staff,0,0,30,30
1683320914170,MATH 102,A01,188675,Staff,0,35,35,35
1683320915194,MATH 103B,A01,188681,Staff,4,0,35,31
1683320915194,MATH 103B,B01,188692,Staff,5,0,35,30
1683320916222,MATH 109,A01,188695,Salehi Golsefidy; Alireza,25,0,35,10
1683320916222,MATH 109,A02,188696,Salehi Golsefidy; Alireza,26,0,35,9
1683320917249,MATH 120A,A01,188698,Eggers; John Dietrich,7,0,35,28
1683320918276,MATH 142B,A01,188736,Ioana; Adrian,0,2,30,30
1683320918276,MATH 142B,A02,188741,Ioana; Adrian,0,1,30,30
1683320918276,MATH 142B,A03,188743,Ioana; Adrian,1,3,30,29
1683320919303,MATH 168A,A01,188790,Staff,0,9,35,35
1683320920331,MATH 170A,A01,188803,Nie; Jiawang,0,2,35,35
1683320920331,MATH 170A,A02,188811,Nie; Jiawang,0,0,35,35
1683320920331,MATH 170A,A03,188814,Nie; Jiawang,0,0,35,35
1683320920331,MATH 170A,A04,188815,Nie; Jiawang,13,0,35,22
1683320921358,MATH 193B,A01,188817,Staff,0,0,35,35
1683320921358,MATH 193B,A02,188818,Staff,6,0,35,29
1683320922385,MGT 4,A01,202857,Anderson; John Charles,62,0,80,18
1683320923410,MGT 12,A00,202858,Lindenberger; Wade Douglas,42,0,90,48
1683320924435,MGT 18,A00,202859,Staff,74,0,90,16
1683320925459,MGT 18GS,A00,202860,McKay; Michael J,13,0,28,15
1683320926482,MGT 45,A00,202861,Pecore; Joseph P.,13,0,90,77
1683320927507,MGT 100,A00,202863,Yavorsky; Daniel Ryan,28,0,90,62
1683320928534,MGT 103,A00,202864,Ehrich; Kristine R,0,18,90,90
1683320929561,MGT 112,A00,202865,Ehrich; Kristine R,15,0,90,75
1683320930586,MGT 121A,A00,202868,Staff,0,20,0,0
1683320931614,MGT 131B,A00,202869,Anderson; John Charles,59,0,90,31
1683320932641,MGT 136,A00,202871,Lindenberger; Wade Douglas,84,0,90,6
1683320933668,MGT 164,A00,202873,Staff,0,68,90,91
1683320934695,MGT 164GS,A00,202874,McKay; Mary A,13,0,28,15
1683320935719,MGT 180,A00,202875,Staff,0,50,90,91
1683320936745,MMW 11R,A01,205019,Herbst; Matthew,3,0,30,27
1683320936745,MMW 11R,A02,205026,Herbst; Matthew,29,0,30,1
1683320937769,MMW 15,A01,193512,Chang; Edmond Yi-Teh,0,9,28,28
1683320937769,MMW 15,A02,193513,Chang; Edmond Yi-Teh,0,5,28,28
1683320937769,MMW 15,A03,193514,Chang; Edmond Yi-Teh,0,5,28,28
1683320937769,MMW 15,A04,193515,Chang; Edmond Yi-Teh,0,5,28,28
1683320937769,MMW 15,A05,193516,Chang; Edmond Yi-Teh,0,4,28,28
1683320937769,MMW 15,A06,193517,Chang; Edmond Yi-Teh,0,5,28,28
1683320937769,MMW 15,B01,193519,Chang; Edmond Yi-Teh,0,4,28,28
1683320937769,MMW 15,B02,193520,Chang; Edmond Yi-Teh,0,5,28,28
1683320937769,MMW 15,B03,193521,Chang; Edmond Yi-Teh,0,4,28,28
1683320937769,MMW 15,B04,193522,Chang; Edmond Yi-Teh,0,4,28,28
1683320937769,MMW 15,B05,193523,Chang; Edmond Yi-Teh,0,5,28,28
1683320937769,MMW 15,B06,193524,Chang; Edmond Yi-Teh,0,4,28,28
1683320938793,MMW 122,A01,193526,Rahimi; Babak,0,14,28,28
1683320938793,MMW 122,A02,193527,Rahimi; Babak,0,14,28,28
1683320938793,MMW 122,A03,193528,Rahimi; Babak,0,0,0,0
1683320938793,MMW 122,A04,193529,Rahimi; Babak,0,0,0,0
1683320939821,MUS 1A,A01,186663,Staff,0,20,35,35
1683320940846,MUS 4,A01,186715,Staff,0,12,35,35
1683320941877,MUS 5R,A01,186796,Dubnov; Shlomo,0,17,35,35
1683320942906,MUS 6,A01,186798,Staff,0,3,25,25
1683320943933,MUS 7,A01,186830,Staff,12,0,35,23
1683320944956,MUS 8,A01,186930,Staff,0,26,35,35
1683320945981,MUS 15,A01,186932,Staff,0,15,35,35
1683320945981,MUS 15,B01,186934,Staff,0,15,35,35
1683320947006,MUS 80,A00,186935,Staff,2,0,20,18
1683320947006,MUS 80,B00,186936,Staff,25,0,25,0
1683320948031,NANO 11,A00,204702,Lipomi; Darren John,0,0,0,0
1683320949117,NANO 15,A01,204709,Yang; Kesong,0,1,0,0
1683320950144,NANO 114,A00,202069,Jahed Motlagh; Zeinab,3,0,10,7
1683320951169,PHIL 1,A00,186955,Grush; Rick Scott,32,0,40,8
1683320952194,PHIL 10,A01,186973,Grush; Rick Scott,28,0,35,7
1683320952194,PHIL 10,A02,186974,Grush; Rick Scott,33,0,35,2
1683320953216,PHIL 13,A01,186976,Staff,7,0,35,28
1683320953216,PHIL 13,A02,186977,Staff,16,0,35,19
1683320954240,PHIL 14,A01,186979,Staff,31,0,35,4
1683320954240,PHIL 14,A02,186986,Staff,32,0,35,3
1683320955268,PHIL 28,A01,186988,Staff,16,0,30,14
1683320955268,PHIL 28,A02,186989,Staff,1,0,30,29
1683320955268,PHIL 28,A03,186990,Staff,9,0,30,21
1683320955268,PHIL 28,A04,186991,Staff,26,0,30,4
1683320956295,PHIL 120,A00,186997,Staff,23,0,40,17
1683320957322,PHIL 137,A00,187003,Staff,9,0,40,31
1683320958345,PHIL 150,A00,187015,Staff,47,0,70,23
1683320959370,PHIL 167,A00,187021,Lamey; Andy M.,35,0,40,5
1683320960397,PHIL 174,A01,202226,Staff,17,0,20,3
1683320960397,PHIL 174,A02,202235,Staff,20,0,20,0
1683320961423,PHIL 191A,A00,258918,Staff,0,0,1,1
1683320962453,PHYS 1A,A00,187028,Staff,27,0,60,33
1683320963480,PHYS 1AL,001,187036,Staff,3,0,30,27
1683320963480,PHYS 1AL,002,187049,Staff,18,0,30,12
1683320964521,PHYS 1B,A00,187058,Staff,22,0,60,38
1683320965545,PHYS 1BL,001,187064,Staff,0,0,30,30
1683320965545,PHYS 1BL,002,187070,Staff,5,0,30,25
1683320966570,PHYS 1C,A00,187082,Staff,31,0,120,89
1683320967595,PHYS 1CL,001,187088,Staff,0,9,30,30
1683320967595,PHYS 1CL,002,187089,Staff,0,2,30,30
1683320967595,PHYS 1CL,009,262693,Staff,11,0,30,19
1683320968623,PHYS 2B,A01,187097,Staff,54,0,115,61
1683320969647,PHYS 2C,A01,187099,Staff,67,0,115,48
1683320970675,PHYS 2CL,A01,187101,Staff,5,0,28,23
1683320970675,PHYS 2CL,A02,187102,Staff,15,0,28,13
1683320971702,PHYS 2D,A01,187123,Shotwell; Brian,95,0,115,20
1683320972725,PHYS 4B,A01,187133,Grinstein; Benjamin,35,0,50,15
1683320973751,POLI 10,A00,188819,Staff,0,4,50,50
1683320974775,POLI 11,A00,188827,Staff,43,0,50,7
1683320975802,POLI 13R,A00,188828,Staff,0,1,20,20
1683320976829,POLI 27,A01,188830,Elgin; Samuel Zincke,0,1,70,70
1683320977856,POLI 30,A00,188832,Desposato; Scott,31,0,50,19
1683320978880,POLI 102F,A00,188834,Staff,3,0,40,37
1683320979903,POLI 104A,A00,188852,Staff,14,0,30,16
1683320980930,POLI 104I,A00,188853,Staff,0,6,20,20
1683320981954,POLI 110B,A00,188854,Wiens; David,7,0,20,13
1683320982978,POLI 112A,A00,188855,Wiens; David,5,0,30,25
1683320984005,POLI 117R,A00,188856,Forman; Fonna,0,11,20,20
1683320985029,POLI 118,A00,188857,Ingham; Sean,8,0,20,12
1683320986052,POLI 120G,A00,188858,Staff,9,0,30,21
1683320987076,POLI 131CR,A00,188863,Hoston; Germaine,24,0,50,26
1683320988100,POLI 133,A00,188864,Nellis; Gareth Hb,44,0,50,6
1683320989128,POLI 134D,A00,188865,Desposato; Scott,27,0,30,3
1683320990152,POLI 142A,A00,188871,Gartzke; Erik,22,0,50,28
1683320991178,POLI 142K,A00,188874,Staff,38,0,50,12
1683320992204,POLI 143,A00,188940,Gartzke; Erik,16,0,30,14
1683320993229,POLI 153,A00,188943,Staff,3,0,20,17
1683320994256,POLI 160AA,A00,188944,Staff,12,0,40,28
1683320995283,POLI 170A,A00,188945,Staff,11,0,30,19
1683320997332,PSYC 1,A00,188952,Staff,37,0,90,53
1683320998355,PSYC 2,B00,188953,Staff,19,0,35,16
1683320999378,PSYC 6,A00,188970,Staff,47,0,60,13
1683321000406,PSYC 7,A00,188973,Staff,37,0,45,8
1683321001431,PSYC 60,A01,188980,Rickard; Timothy C.,43,0,60,17
1683321002457,PSYC 70,A01,189001,Steiner; Eric Tomas,24,0,45,21
1683321003486,PSYC 100,A00,189005,Lacefield; Katharine I,0,99,120,120
1683321004510,PSYC 102,A00,189008,Staff,10,0,30,20
1683321005541,PSYC 106,B00,189026,Gorman; Michael R.,35,0,60,25
1683321006565,PSYC 114,B01,189033,Winkielman; Piotr,0,32,30,30
1683321007589,PSYC 131,A00,189036,Anagnostaras; Stephan,0,43,60,60
1683321008613,PSYC 136,A00,189041,Lowe; Angela Beth,0,7,25,25
1683321009641,PSYC 137,A00,189057,Winkielman; Piotr,0,34,25,25
1683321010669,PSYC 144,A00,189107,Wixted; John T,0,7,50,50
1683321012721,PSYC 162,A00,189142,Staff,0,8,85,85
1683321013745,PSYC 172,A00,189144,Gorman; Michael R.,0,7,30,30
1683321015797,PSYC 179,A00,189146,Lacefield; Katharine I,0,84,120,120
1683321016822,PSYC 181,A00,189147,Anagnostaras; Stephan,0,44,90,90
1683321017845,PSYC 190R,A00,189148,Barner; David A.,0,22,80,80
1683321018868,PSYC 191,A00,189275,Rickard; Timothy C.,0,7,25,25
1683321019897,PSYC 193,A00,189276,Chapman; Eddie Nathaniel,0,1,0,4
1683321020925,PSYC 193L,A01,189281,Lowe; Angela Beth,12,0,20,8
1683321020925,PSYC 193L,B01,189285,Staff,28,0,35,7
1683321021949,RELI 149,A00,187137,Rahimi; Babak,7,0,40,33
1683321022973,SE 9,A01,187315,Staff,0,2,18,18
1683321023996,SE 101B,A00,187409,Staff,24,0,30,6
1683321025021,SE 110B,A00,187444,Staff,10,0,40,30
1683321026046,SE 130B,A00,187449,Staff,31,0,40,9
1683321027077,SE 150A,A00,187516,Staff,9,0,20,11
1683321028104,SE 154,A00,187528,Staff,30,0,50,20
1683321029128,SIO 3,A01,258171,Staff,35,0,40,5
1683321030151,SIO 10,A00,187144,Cook; Geoffrey W,0,3,75,75
1683321031174,SIO 45,A00,187152,Cook; Geoffrey W,1,0,100,99
1683321032201,SIO 109R,A00,194486,Staff,0,3,20,20
1683321034254,SIO 187,A01,187233,Kacev; David,12,0,40,28
1683321035277,SOCI 1,A01,258656,Thorpe; Charles Robert,28,0,30,2
1683321035277,SOCI 1,A02,258658,Thorpe; Charles Robert,30,0,30,0
1683321035277,SOCI 1,A03,258661,Thorpe; Charles Robert,25,0,25,0
1683321035277,SOCI 1,A04,258666,Thorpe; Charles Robert,22,0,25,3
1683321035277,SOCI 1,A05,258897,Thorpe; Charles Robert,23,0,25,2
1683321035277,SOCI 1,A06,258898,Thorpe; Charles Robert,25,0,25,0
1683321036312,SOCI 30,A01,258903,Pardo Guerra; Juan Pablo,16,0,30,14
1683321037333,SOCI 102,A00,258904,Staff,9,0,25,16
1683321038356,SOCI 106,A00,258905,Staff,19,0,25,6
1683321039384,SOCI 111,A00,258907,Ribas Norris; Janet Vanesa,26,0,30,4
1683321040407,SOCI 121R,A00,258908,Pardo Guerra; Juan Pablo,11,0,30,19
1683321041434,SOCI 126,A01,203330,Staff,14,0,20,6
1683321042459,SOCI 131,A00,258909,Thorpe; Charles Robert,31,0,60,29
1683321043486,SOCI 135,A00,258910,Payne; Christine Anna,0,9,30,30
1683321044513,SOCI 157,A00,258911,Staff,12,0,30,18
1683321045537,SOCI 184,A00,258912,Staff,25,0,30,5
1683321046563,SOCI 188D,A00,258913,Staff,21,0,30,9
1683321047587,SYN 2,001,187529,Staff,9,0,16,7
1683321047587,SYN 2,002,201452,Staff,0,18,16,16
1683321047587,SYN 2,003,201469,Staff,4,0,16,12
1683321048610,SYN 100,A01,187531,Staff,0,9,20,20
1683321048610,SYN 100,B01,201491,Staff,0,12,20,20
1683321049633,TDAC 1,A00,189286,Walsh; Kim C.,3,0,20,17
1683321049633,TDAC 1,B00,189287,Harting; Carla Kelso,11,0,20,9
1683321050657,TDAC 101,A00,189300,Walsh; Kim C.,16,0,20,4
1683321050657,TDAC 101,B00,189301,Harting; Carla Kelso,18,0,20,2
1683321051681,TDAC 102,A00,189304,Basso; Beatrice,14,0,20,6
1683321052772,TDAC 108,A00,189305,Staff,18,0,20,2
1683321053804,TDDE 131,A00,189310,Staff,19,0,20,1
1683321053804,TDDE 131,B00,189314,Staff,19,0,20,1
1683321053804,TDDE 131,C00,189315,Staff,48,0,50,2
1683321053804,TDDE 131,D00,189316,Staff,14,0,15,1
1683321053804,TDDE 131,E00,204841,Staff,20,0,20,0
1683321054829,TDGE 10,A00,189289,Staff,30,0,50,20
1683321054829,TDGE 10,B00,189290,Havis; Allan,1,0,50,49
1683321055857,TDGE 11,A00,189291,Fulton; Julia,0,3,50,50
1683321055857,TDGE 11,B00,189292,Staff,20,0,25,5
1683321055857,TDGE 11,C00,260270,Staff,0,0,0,0
1683321056882,TDGE 25,A00,189294,Staff,3,0,20,17
1683321057909,TDGE 124,A00,189318,Fulton; Julia,0,8,50,50
1683321058937,TDGE 125,A00,189319,Staff,13,0,25,12
1683321058937,TDGE 125,B00,189320,Staff,23,0,25,2
1683321059964,TDGE 127,A00,189322,Havis; Allan,0,0,50,50
1683321060988,TDHT 101,A00,189323,Staff,18,0,25,7
1683321060988,TDHT 101,B00,189324,Staff,25,0,25,0
1683321062013,TDHT 102,A00,189325,Staff,49,0,50,1
1683321063040,TDMV 1,A00,189295,Arcidiacono; Kristin,19,0,30,11
1683321063040,TDMV 1,B00,189296,Caligagan; Maria T.,24,0,30,6
1683321064063,TDMV 2,A00,189297,Sammartano; Tonnie,28,0,30,2
1683321064063,TDMV 2,B00,189299,Arcidiacono; Kristin,24,0,30,6
1683321065087,TDMV 3,A00,204998,Rincon; Alicia,22,0,30,8
1683321066111,TDMV 120,A00,189458,Sammartano; Tonnie,28,0,30,2
1683321067137,TDMV 138,A00,189541,Jun; Grace Shin Hae,22,0,40,18
1683321068165,TDMV 142,A00,189717,Caligagan; Tony,23,0,30,7
1683321068165,TDMV 142,B00,189718,Caligagan; Maria T.,25,0,30,5
1683321069194,TMC 2,A01,187533,Staff,25,0,25,0
1683321069194,TMC 2,A02,187534,Staff,25,0,25,0
1683321070218,USP 1,A01,187536,Kwak; Nancy,0,16,25,25
1683321071246,USP 5,A01,187538,Staff,9,0,25,16
1683321072270,USP 101,A00,199253,Staff,0,4,0,0
1683321073298,USP 124,A00,187562,Boomhower; Matthew Charles,1,0,30,29
1683321074322,USP 138,A00,187582,Staff,20,0,25,5
1683321075346,USP 152,A01,187597,Staff,4,0,25,21
1683321076372,USP 153,A00,187598,Staff,19,0,25,6
1683321077396,USP 168,A00,187607,Kwak; Nancy,2,0,5,3
1683321078420,USP 173,A00,187619,Staff,4,0,25,21
1683321079446,USP 181,A00,187638,Staff,0,0,25,25
1683321080475,VIS 103,A00,187650,Cruz; Edwin Teddy,23,0,75,52
1683321081500,VIS 110D,A00,187669,Staff,12,0,22,10
1683321082524,VIS 127C,A00,187720,Shen; Kuiyi,68,0,146,78
1683321083551,VIS 149,A00,187731,Yoldas; Pinar,0,14,22,22
1683321084575,VIS 151,A01,188091,Staff,22,0,34,12
1683321084575,VIS 151,A02,188092,Staff,11,0,34,23
1683321085603,VIS 160B,A00,188093,Stalbaum; Brett,0,0,10,10
1683321087652,WCWP 10B,A00,201720,Staff,10,0,15,5
1683321087652,WCWP 10B,B00,201722,Staff,8,0,15,7
1683321088679,WCWP 100,A00,201725,Gagnon; Jeffrey C,0,0,2,2
1683321088679,WCWP 100,B00,201727,Staff,0,4,15,15
1683321091773,ANBI 133,A00,258401,Wilder; Linnea Lorene,34,0,40,6
1683321092797,ANBI 140,A00,258395,Hrvoj Mihic; Branka,18,0,25,7
1683321093823,ANSC 120,A00,258402,Bialecki; Jon Anthony,27,0,40,13
1683321094849,ANSC 144,A00,258400,Staff,14,0,40,26
1683321096898,ANSC 166,A00,258396,Parish; Steven Martin,157,0,175,18
1683321097926,ANSC 180,A00,193533,Staff,9,0,20,11
1683321098950,ANSC 188,A00,258397,Jassal; Aftab,33,0,40,7
1683321099974,ANTH 3,A01,258316,Staff,23,0,30,7
1683321101001,ANTH 5,A00,258394,Semendeferi; Ekaterini,16,0,20,4
1683321102026,ANTH 21,A01,258331,Staff,9,0,40,31
1683321103051,ANTH 103,A00,258398,Varma; Saiba,15,0,25,10
1683321104083,AWP 10,001,202034,Staff,0,0,0,0
1683321104083,AWP 10,002,202035,Staff,0,0,0,0
1683321104083,AWP 10,003,202036,Staff,0,0,0,0
1683321104083,AWP 10,004,202037,Staff,0,0,0,0
1683321104083,AWP 10,005,202038,Staff,0,0,0,0
1683321104083,AWP 10,006,202039,Staff,0,0,0,0
1683321104083,AWP 10,007,202040,Staff,0,0,0,0
1683321104083,AWP 10,008,202041,Staff,0,0,0,0
1683321104083,AWP 10,009,202042,Staff,0,0,0,0
1683321104083,AWP 10,010,202043,Staff,0,0,0,0
1683321104083,AWP 10,011,202044,Staff,0,0,0,0
1683321104083,AWP 10,012,202045,Staff,0,0,0,0
1683321104083,AWP 10,013,202046,Staff,0,0,0,0
1683321104083,AWP 10,014,202047,Staff,0,0,0,0
1683321104083,AWP 10,015,202048,Staff,0,0,0,0
1683321104083,AWP 10,016,202049,Staff,0,0,0,0
1683321104083,AWP 10,017,202050,Staff,0,0,0,0
1683321104083,AWP 10,018,202051,Staff,0,0,0,0
1683321104083,AWP 10,019,202052,Staff,0,0,0,0
1683321104083,AWP 10,020,202053,Staff,0,0,0,0
1683321104083,AWP 10,021,202054,Staff,0,0,0,0
1683321104083,AWP 10,022,202055,Staff,0,0,0,0
1683321104083,AWP 10,023,202056,Staff,0,0,0,0
1683321104083,AWP 10,024,202057,Staff,0,0,0,0
1683321104083,AWP 10,025,202058,Staff,0,0,0,0
1683321104083,AWP 10,026,202059,Staff,0,0,0,0
1683321105107,AWP 102,001,202032,Staff,0,0,0,0
1683321105107,AWP 102,002,202033,Staff,0,0,0,0
1683321106130,BENG 100,A01,254234,Taylor Amos; Alyssa C,31,0,40,9
1683321107154,BENG 196,001,270013,Engler; Adam J.,9999,0,9999,0
1683321108184,BICD 100R,A01,202018,Smith; Laurie,0,7,32,32
1683321108184,BICD 100R,A02,202019,Smith; Laurie,0,2,32,32
1683321108184,BICD 100R,A03,202020,Smith; Laurie,0,1,32,32
1683321108184,BICD 100R,A04,202021,Smith; Laurie,8,0,32,24
1683321108184,BICD 100R,A05,202022,Smith; Laurie,12,0,32,20
1683321109207,BICD 136,A01,193242,Gustafson-Brown; Cindy,0,2,32,32
1683321109207,BICD 136,A02,193244,Gustafson-Brown; Cindy,14,0,32,18
1683321110233,BIEB 102,A01,193249,Butler; Shannon Rhey,0,2,32,32
1683321110233,BIEB 102,A02,193251,Butler; Shannon Rhey,0,0,32,32
1683321110233,BIEB 102,A03,193253,Butler; Shannon Rhey,0,1,32,32
1683321110233,BIEB 102,A04,193255,Butler; Shannon Rhey,17,0,32,15
1683321110233,BIEB 102,A05,193265,Butler; Shannon Rhey,26,0,32,6
1683321110233,BIEB 102,A06,193269,Butler; Shannon Rhey,16,0,32,16
1683321112288,BIEB 150,A01,193274,Staff,0,0,32,32
1683321112288,BIEB 150,A02,193285,Staff,23,0,32,9
1683321113311,BIEB 194,A00,193286,Kurle; Carolyn M.,22,0,32,10
1683321114341,BILD 1,A01,192291,Staff,16,0,32,16
1683321114341,BILD 1,A02,192292,Staff,30,0,32,2
1683321114341,BILD 1,B01,192520,Reuther; Keefe,0,1,0,0
1683321114341,BILD 1,B02,192532,Reuther; Keefe,0,1,0,0
1683321115365,BILD 3,A01,192556,Butler; Shannon Rhey,0,0,32,32
1683321115365,BILD 3,A02,192581,Butler; Shannon Rhey,5,0,32,27
1683321115365,BILD 3,A03,192611,Butler; Shannon Rhey,23,0,32,9
1683321115365,BILD 3,A04,192612,Butler; Shannon Rhey,25,0,32,7
1683321115365,BILD 3,A05,192613,Butler; Shannon Rhey,27,0,32,5
1683321115365,BILD 3,A06,192679,Butler; Shannon Rhey,27,0,32,5
1683321115365,BILD 3,A07,192682,Butler; Shannon Rhey,22,0,32,10
1683321116393,BILD 4,A01,192836,Reuther; Keefe,0,0,24,24
1683321116393,BILD 4,A02,193044,Reuther; Keefe,4,0,24,20
1683321117421,BILD 10,A01,193142,Gustafson-Brown; Cindy,30,0,32,2
1683321117421,BILD 10,A02,193149,Gustafson-Brown; Cindy,31,0,32,1
1683321118444,BIMM 100,A01,193301,Staff,0,6,32,32
1683321118444,BIMM 100,A02,193312,Staff,0,5,32,32
1683321118444,BIMM 100,A03,193323,Staff,0,8,32,32
1683321119470,BIMM 101,A01,193329,McDonnell; Lisa Marie,0,3,24,24
1683321119470,BIMM 101,A02,193339,McDonnell; Lisa Marie,0,3,24,24
1683321119470,BIMM 101,B01,193354,McDonnell; Lisa Marie,0,3,24,24
1683321119470,BIMM 101,B02,193357,McDonnell; Lisa Marie,0,3,24,24
1683321120494,BIMM 110,A01,193377,Tat; John,0,11,32,32
1683321120494,BIMM 110,A02,193378,Tat; John,1,9,32,31
1683321121522,BIMM 120,A01,206116,Staff,0,0,32,32
1683321121522,BIMM 120,A02,206117,Staff,8,0,32,24
1683321121522,BIMM 120,A03,206121,Staff,21,0,32,11
1683321122552,BIPN 100,A01,193393,Park; Ji Young,0,14,32,32
1683321122552,BIPN 100,A02,193402,Park; Ji Young,0,12,32,32
1683321122552,BIPN 100,A03,193413,Park; Ji Young,0,14,32,32
1683321122552,BIPN 100,A04,193414,Park; Ji Young,0,13,32,32
1683321123579,BIPN 102,A01,193429,Staff,0,0,32,32
1683321123579,BIPN 102,A02,193438,Staff,22,0,32,10
1683321124606,BIPN 106,A01,193450,Reyes Gonzalez; Catalina,0,2,40,40
1683321125633,BIPN 134,A01,193465,Cooke; James Edward,0,0,32,32
1683321125633,BIPN 134,A02,193474,Cooke; James Edward,25,0,32,7
1683321125633,BIPN 134,A03,193485,Cooke; James Edward,29,0,32,3
1683321125633,BIPN 134,A04,193486,Cooke; James Edward,21,0,32,11
1683321125633,BIPN 134,A05,193491,Cooke; James Edward,31,0,32,1
1683321125633,BIPN 134,A06,193501,Cooke; James Edward,30,0,32,2
1683321125633,BIPN 134,A07,193510,Cooke; James Edward,29,0,32,3
1683321127688,BISP 194,A00,222522,Staff,15,0,32,17
1683321128716,CAT 124,A01,202407,Staff,20,0,25,5
1683321129741,CAT 125,A00,202408,Marchisotto; Jennifer Anne,4,0,20,16
1683321130766,CAT 125R,A00,202409,Smith; Lauryn Alissa,0,11,20,20
1683321130766,CAT 125R,B00,202410,Morales; Celeste Georgianna,0,11,20,20
1683321130766,CAT 125R,C00,202411,Irwin; Matthew Joseph,0,10,20,20
1683321131792,CENG 15,A01,204712,Yang; Kesong,0,1,0,0
1683321132817,CENG 114,A00,202070,Jahed Motlagh; Zeinab,5,0,20,15
1683321133844,CGS 105,A00,185477,Wesling; Megan E.,24,0,40,16
1683321134869,CGS 106,A00,185494,Staff,13,0,22,9
1683321135893,CGS 108,A00,185495,Staff,14,0,20,6
1683321136920,CGS 114,A00,185496,Staff,13,0,18,5
1683321137946,CGS 119,A00,185501,Staff,15,0,20,5
1683321138973,CGS 120,A00,185511,Staff,13,0,20,7
1683321140001,CHEM 4,A01,184675,Bussey; Thomas J,96,0,100,4
1683321141028,CHEM 6A,A01,184677,Staff,34,0,60,26
1683321142054,CHEM 6B,A01,184679,Staff,65,0,100,35
1683321143081,CHEM 6C,A01,184681,Bussey; Thomas J,1,0,50,49
1683321143081,CHEM 6C,A02,184682,Bussey; Thomas J,34,0,50,16
1683321144105,CHEM 40A,A01,184684,Albizati; Kim F.,37,0,100,63
1683321145130,CHEM 40B,A01,184686,Albizati; Kim F.,0,20,100,100
1683321146155,CHEM 41B,A01,184690,Staff,52,0,100,48
1683321147183,COGS 3,A01,184715,Boyle; Mary E. T.,0,25,40,40
1683321148271,COGS 14B,A01,185172,Staff,0,15,38,38
1683321149299,COGS 18,A01,184736,Staff,18,0,80,62
1683321150322,COGS 100,A01,184932,Staff,0,5,73,73
1683321151345,COGS 101A,A01,184935,Staff,0,38,30,30
1683321152369,COGS 101B,A01,184944,Staff,0,2,30,30
1683321153394,COGS 101C,A01,184946,Staff,0,12,30,30
1683321154422,COGS 102A,A01,184951,Johnson; Christine M.,2,0,40,38
1683321155450,COGS 107B,A01,184953,Mooshagian; Eric Frederick,0,50,40,40
1683321156528,COGS 118B,A01,184959,Gupta; Anjum,0,48,40,40
1683321157552,COGS 153,A00,184961,Staff,0,15,30,30
1683321158576,COGS 177,A00,184962,Staff,0,21,30,30
1683321159600,COGS 187A,A01,184969,Boyle; Mary E. T.,0,17,40,40
1683321160627,COMM 10,A01,185174,Staff,0,5,25,25
1683321160627,COMM 10,A02,185189,Staff,0,5,25,25
1683321160627,COMM 10,A03,269821,Staff,0,0,0,0
1683321161652,COMM 100B,A01,185475,Staff,0,0,0,2
1683321161652,COMM 100B,A02,185476,Staff,14,0,25,11
1683321162679,COMM 100C,A01,185314,Staff,1,0,25,24
1683321162679,COMM 100C,A02,185327,Staff,19,0,25,6
1683321163705,COMM 110M,A00,185349,Staff,2,0,40,38
1683321164730,COMM 113T,A00,185352,Staff,25,0,40,15
1683321165756,COMM 114I,A00,185353,Staff,33,0,40,7
1683321166782,COMM 131,A00,185354,Staff,19,0,30,11
1683321167806,CSE 8A,A50,185358,Cao; Yingjun,0,46,10,10
1683321168832,CSE 8B,A01,185362,Staff,1,47,50,49
1683321169856,CSE 11,A01,185416,Cao; Yingjun,0,92,10,10
1683321170881,CSE 20,A01,185445,Briones; Jor-el Thomas Caparas,5,0,25,20
1683321171904,CSE 21,A01,185447,Staff,10,0,50,40
1683321172929,CSE 101,A01,185451,Staff,0,12,50,50
1683321172929,CSE 101,B01,185453,Jones; Miles E,0,11,50,50
1683321174981,CSE 141,A01,185458,Eldon; John,20,0,100,80
1683321176005,CSE 141L,A01,185461,Eldon; John,12,0,100,88
1683321177029,CSE 142,A01,185463,Staff,36,0,60,24
1683321177029,CSE 142,B01,201355,Staff,0,7,60,60
1683321178056,CSE 142L,A01,185470,Staff,36,0,60,24
1683321178056,CSE 142L,B01,201417,Staff,0,6,60,60
1683321179082,CSE 190,A00,201433,Staff,32,0,49,17
1683321180109,DOC 1,A01,259136,Strom; Megan C.,7,0,15,8
1683321180109,DOC 1,A02,259137,Strom; Megan C.,14,0,15,1
1683321180109,DOC 1,A03,259138,Strom; Megan C.,14,0,15,1
1683321180109,DOC 1,A04,259139,Strom; Megan C.,14,0,15,1
1683321181132,DOC 100D,A00,259140,Pass; Natalye Joann,17,0,25,8
1683321182160,DSGN 1,A01,184749,Rill; Bryan,0,25,30,30
1683321183187,DSGN 100,A01,185168,Staff,0,2,25,25
1683321184213,ECE 5,A01,185626,Morris; Karcher William,0,10,0,0
1683321185237,ECE 101,A01,185628,Staff,17,0,70,53
1683321186263,ECE 107,A01,185635,Baghdadchi; Saharnaz,0,0,20,20
1683321186263,ECE 107,A02,185638,Baghdadchi; Saharnaz,4,0,20,16
1683321187286,ECE 148,A01,185647,Silberman; Jack,0,0,16,16
1683321188310,ECON 1,A01,185537,Crane; Meredith Helen,54,0,70,16
1683321189333,ECON 3,A01,185549,Crane; Meredith Helen,33,0,70,37
1683321190362,ECON 4,A01,203354,Anderson; John Charles,0,4,10,10
1683321191389,ECON 100A,A01,185574,Staff,0,4,40,40
1683321192413,ECON 100B,A01,185576,Staff,0,22,40,40
1683321193439,ECON 100C,A01,185589,Newhouse; Herbert S,30,0,70,40
1683321194463,ECON 105,A00,185608,Vespa; Emanuel Ignacio,19,0,35,16
1683321195487,ECON 109,A01,185610,Shishkin; Denis,10,0,35,25
1683321196511,ECON 110A,A01,185612,Staff,11,0,40,29
1683321197535,ECON 120A,A01,185615,Staff,20,0,40,20
1683321198559,ECON 120C,A01,185617,Sun; Yixiao,0,20,70,70
1683321199584,ECON 144,A00,203346,Squires; Dale E,3,0,35,32
1683321200611,ECON 171,A01,203349,Newhouse; Herbert S,0,1,35,35
1683321201637,ECON 173A,A01,185621,Toda; Alexis Akira,21,0,35,14
1683321202663,EDS 25,A01,202413,Staff,0,1,0,0
1683321202663,EDS 25,A02,202414,Staff,0,1,0,0
1683321202663,EDS 25,A03,202415,Staff,0,0,0,0
1683321202663,EDS 25,A04,202416,Staff,0,1,0,0
1683321202663,EDS 25,A05,202439,Staff,0,0,0,0
1683321202663,EDS 25,A06,202440,Staff,0,0,0,0
1683321202663,EDS 25,B01,202631,Staff,0,0,0,0
1683321202663,EDS 25,B02,202632,Staff,0,0,0,0
1683321202663,EDS 25,B03,202639,Staff,0,0,0,0
1683321202663,EDS 25,B04,202640,Staff,0,0,0,0
1683321202663,EDS 25,B05,202643,Staff,0,0,0,0
1683321202663,EDS 25,B06,202644,Staff,0,0,0,0
1683321203688,EDS 38,A01,202659,Black; Alison Michelle,24,0,25,1
1683321204712,EDS 115,A00,202652,Staff,17,0,30,13
1683321205738,EDS 125,A00,202649,Staff,14,0,30,16
1683321206762,EDS 126,A01,203332,Staff,30,0,30,0
1683321207785,EDS 139,A00,202838,Staff,16,0,25,9
1683321208812,EDS 146,A01,202655,Staff,14,0,25,11
1683321209837,ENG 15,A00,185667,Staff,0,1,0,0
1683321209837,ENG 15,B00,185672,Staff,0,0,0,0
1683321209837,ENG 15,C00,185675,Staff,0,0,0,0
1683321209837,ENG 15,D00,185682,Staff,0,0,0,0
1683321209837,ENG 15,E00,185684,Staff,0,0,0,0
1683321210863,ETHN 103,A00,185710,Staff,0,3,35,35
1683321211886,ETHN 103A,A00,199228,Man; Simeon S,2,0,9,7
1683321212911,ETHN 109,A00,185711,Staff,18,0,35,17
1683321213934,ETHN 142,A00,185726,Staff,0,4,30,30
1683321214956,ETHN 163J,A00,199229,Man; Simeon S,5,0,8,3
1683321215983,ETHN 168,A00,185727,Staff,8,0,10,2
1683321217010,ETHN 182,A00,185728,Staff,1,0,35,34
1683321218034,ETHN 183,A00,185737,Staff,8,0,18,10
1683321219057,GLBH 111,A01,209361,Burgos; Jose L.,0,0,0,0
1683321221109,HIEU 104,A00,185792,Staff,16,0,20,4
1683321222133,HIEU 115,A00,185800,Staff,1,0,20,19
1683321223158,HIEU 128,A00,185801,Staff,0,7,20,20
1683321224182,HIEU 147,A00,185802,Staff,16,0,20,4
1683321225210,HIEU 154,A00,185823,Staff,12,0,20,8
1683321226234,HILA 102,A00,185826,Staff,13,0,20,7
1683321227262,HILD 2C,A01,185778,Staff,0,12,20,20
1683321228290,HILD 7B,A01,185780,Kwak; Nancy,0,15,32,32
1683321228290,HILD 7B,A02,185781,Kwak; Nancy,0,18,32,32
1683321229313,HILD 30,A01,185791,Staff,14,0,20,6
1683321230341,HISC 119,A00,185830,Golan; Tal,0,9,20,20
1683321231369,HITO 156GS,A00,185831,Patterson; Patrick H.,0,0,0,23
1683321232395,HIUS 103,A00,185832,Man; Simeon S,0,6,20,20
1683321233422,HIUS 117,A00,185836,Kwak; Nancy,2,0,20,18
1683321234450,HIUS 125,A00,185840,Man; Simeon S,0,0,23,23
1683321235474,HIUS 149,A00,185845,Staff,0,0,20,20
1683321236498,HUM 3,A01,185882,Zavodny; Tatiana Sophia,0,6,50,50
1683321236498,HUM 3,B01,185899,Caldwell; Michael Alan,0,19,50,50
1683321237522,HUM 3GS,A00,185900,Patterson; Patrick H.,0,0,0,23
1683321238548,HUM 4,A01,185938,Zroka; Amy Liane,31,0,50,19
1683321238548,HUM 4,B01,185956,Watkins; Eric,0,2,50,50
1683321238548,HUM 4,B02,202209,Watkins; Eric,0,2,50,50
1683321238548,HUM 4,B03,202210,Watkins; Eric,0,0,50,50
1683321239577,HUM 5,A01,185958,West; Geoffrey Scott,3,0,50,47
1683321239577,HUM 5,A02,202215,West; Geoffrey Scott,0,0,50,50
1683321240601,INTL 190,A00,185959,Gagnon; Jeffrey C,0,0,0,9
1683321240601,INTL 190,B00,185960,Lettieri; Michael Joseph,0,0,0,1
1683321241626,JAPN 180,A00,254509,Staff,5,1,30,25
1683321242651,LATI 10,A01,202853,Kennemore; Amy Michelle,5,0,35,30
1683321242651,LATI 10,A02,202854,Kennemore; Amy Michelle,1,0,35,34
1683321242651,LATI 10,A03,270054,Kennemore; Amy Michelle,30,0,30,0
1683321243678,LATI 180,A00,202855,Kennemore; Amy Michelle,11,0,20,9
1683321244702,LAWS 101,A00,201767,Golan; Tal,0,7,40,40
1683321245730,LIFR 1C,A00,185961,Staff,6,0,20,14
1683321246755,LIFR 1CX,A00,185962,Staff,7,0,20,13
1683321247783,LIFR 1D,A00,185963,Staff,9,0,20,11
1683321248807,LIFR 1DX,A00,185964,Staff,9,0,20,11
1683321249831,LIGN 101,A01,186039,Staff,43,0,50,7
1683321250855,LIGN 165,A00,186040,Staff,18,0,50,32
1683321251882,LTCS 108,A00,186041,Staff,6,0,10,4
1683321252906,LTCS 119,A00,186042,Staff,16,0,20,4
1683321253932,LTCS 130,A00,186043,Wesling; Megan E.,15,0,25,10
1683321255980,LTEA 138,A00,186119,Staff,14,0,40,26
1683321257005,LTEN 124,A00,186148,Staff,6,0,25,19
1683321258029,LTEN 178,A00,186149,Staff,7,0,15,8
1683321259057,LTEN 181,A00,186150,Blanco; John D,33,0,40,7
1683321260138,LTWL 120,A00,186160,Staff,20,0,25,5
1683321261162,LTWL 165,A00,186161,Staff,22,0,25,3
1683321262188,LTWR 100,A00,186162,Staff,0,5,15,15
1683321263216,LTWR 102,A00,186163,Doller; Ben,5,0,15,10
1683321264241,MAE 8,A01,186412,Staff,0,0,0,0
1683321265268,MAE 30B,A00,186445,Bahadori; Mohammad Yousef,83,0,100,17
1683321266293,MAE 40,A00,186592,Bewley; Thomas R,9,0,50,41
1683321267320,MAE 101B,A00,186593,Bahadori; Mohammad Yousef,81,0,100,19
1683321268343,MAE 105,A00,186594,Bandaru; Prabhakar,12,0,50,38
1683321269369,MAE 107,A00,186599,Pham; Hieu Tan,0,6,120,120
1683321270396,MAE 148,A01,186660,Silberman; Jack,3,0,16,13
1683321271422,MATH 10A,A01,188095,Staff,0,6,35,35
1683321272447,MATH 10B,A01,188097,Bowers; Adam R.,0,11,30,30
1683321272447,MATH 10B,A02,188099,Bowers; Adam R.,0,11,30,30
1683321272447,MATH 10B,B01,188104,Bowers; Adam R.,0,10,30,30
1683321272447,MATH 10B,B02,188106,Bowers; Adam R.,0,10,30,30
1683321273472,MATH 10C,A01,188111,Staff,0,18,30,30
1683321273472,MATH 10C,A02,188127,Staff,0,17,30,30
1683321273472,MATH 10C,A03,188131,Staff,0,18,30,30
1683321273472,MATH 10C,B01,188218,Staff,19,0,30,11
1683321273472,MATH 10C,B02,188244,Staff,13,0,30,17
1683321273472,MATH 10C,B03,188277,Staff,16,0,30,14
1683321274500,MATH 18,A01,188344,Bach; Quang Tran,18,0,30,12
1683321274500,MATH 18,A02,188345,Bach; Quang Tran,11,0,30,19
1683321274500,MATH 18,B01,188353,Bach; Quang Tran,10,0,30,20
1683321274500,MATH 18,B02,188354,Bach; Quang Tran,20,0,30,10
1683321275524,MATH 20A,A01,188374,Staff,13,0,35,22
1683321276553,MATH 20B,A01,188382,Ohm; Ko Woon,6,0,30,24
1683321276553,MATH 20B,A02,188383,Ohm; Ko Woon,23,0,30,7
1683321276553,MATH 20B,B01,188385,Ohm; Ko Woon,7,0,30,23
1683321276553,MATH 20B,B02,188392,Ohm; Ko Woon,22,0,30,8
1683321277582,MATH 20C,A01,188394,Harel; Guershon,10,0,30,20
1683321277582,MATH 20C,A02,188395,Harel; Guershon,14,0,30,16
1683321277582,MATH 20C,B01,188404,Harel; Guershon,5,0,30,25
1683321277582,MATH 20C,B02,188405,Harel; Guershon,19,0,30,11
1683321278607,MATH 20D,A01,188414,Hammock; Frances H,0,1,30,30
1683321278607,MATH 20D,A02,188415,Hammock; Frances H,3,0,30,27
1683321278607,MATH 20D,B01,188447,Hammock; Frances H,2,0,30,28
1683321278607,MATH 20D,B02,188486,Hammock; Frances H,8,0,30,22
1683321279635,MATH 20E,A01,188649,Staff,21,0,30,9
1683321279635,MATH 20E,A02,188650,Staff,23,0,30,7
1683321279635,MATH 20E,A03,188673,Staff,0,0,30,30
1683321280662,MATH 102,A01,188675,Staff,0,35,35,35
1683321281689,MATH 103B,A01,188681,Staff,4,0,35,31
1683321281689,MATH 103B,B01,188692,Staff,5,0,35,30
1683321282717,MATH 109,A01,188695,Salehi Golsefidy; Alireza,25,0,35,10
1683321282717,MATH 109,A02,188696,Salehi Golsefidy; Alireza,26,0,35,9
1683321283742,MATH 120A,A01,188698,Eggers; John Dietrich,7,0,35,28
1683321284772,MATH 142B,A01,188736,Ioana; Adrian,0,2,30,30
1683321284772,MATH 142B,A02,188741,Ioana; Adrian,0,1,30,30
1683321284772,MATH 142B,A03,188743,Ioana; Adrian,1,3,30,29
1683321285796,MATH 168A,A01,188790,Staff,0,9,35,35
1683321286820,MATH 170A,A01,188803,Nie; Jiawang,0,2,35,35
1683321286820,MATH 170A,A02,188811,Nie; Jiawang,0,0,35,35
1683321286820,MATH 170A,A03,188814,Nie; Jiawang,0,0,35,35
1683321286820,MATH 170A,A04,188815,Nie; Jiawang,13,0,35,22
1683321287848,MATH 193B,A01,188817,Staff,0,0,35,35
1683321287848,MATH 193B,A02,188818,Staff,6,0,35,29
1683321288873,MGT 4,A01,202857,Anderson; John Charles,62,0,80,18
1683321289899,MGT 12,A00,202858,Lindenberger; Wade Douglas,42,0,90,48
1683321290924,MGT 18,A00,202859,Staff,74,0,90,16
1683321291949,MGT 18GS,A00,202860,McKay; Michael J,13,0,28,15
1683321292974,MGT 45,A00,202861,Pecore; Joseph P.,13,0,90,77
1683321293998,MGT 100,A00,202863,Yavorsky; Daniel Ryan,28,0,90,62
1683321295024,MGT 103,A00,202864,Ehrich; Kristine R,0,18,90,90
1683321296048,MGT 112,A00,202865,Ehrich; Kristine R,15,0,90,75
1683321297072,MGT 121A,A00,202868,Staff,0,20,0,0
1683321298099,MGT 131B,A00,202869,Anderson; John Charles,59,0,90,31
1683321299122,MGT 136,A00,202871,Lindenberger; Wade Douglas,84,0,90,6
1683321300147,MGT 164,A00,202873,Staff,0,68,90,91
1683321301171,MGT 164GS,A00,202874,McKay; Mary A,13,0,28,15
1683321302194,MGT 180,A00,202875,Staff,0,50,90,91
1683321303217,MMW 11R,A01,205019,Herbst; Matthew,3,0,30,27
1683321303217,MMW 11R,A02,205026,Herbst; Matthew,29,0,30,1
1683321304241,MMW 15,A01,193512,Chang; Edmond Yi-Teh,0,9,28,28
1683321304241,MMW 15,A02,193513,Chang; Edmond Yi-Teh,0,5,28,28
1683321304241,MMW 15,A03,193514,Chang; Edmond Yi-Teh,0,5,28,28
1683321304241,MMW 15,A04,193515,Chang; Edmond Yi-Teh,0,5,28,28
1683321304241,MMW 15,A05,193516,Chang; Edmond Yi-Teh,0,4,28,28
1683321304241,MMW 15,A06,193517,Chang; Edmond Yi-Teh,0,5,28,28
1683321304241,MMW 15,B01,193519,Chang; Edmond Yi-Teh,0,4,28,28
1683321304241,MMW 15,B02,193520,Chang; Edmond Yi-Teh,0,5,28,28
1683321304241,MMW 15,B03,193521,Chang; Edmond Yi-Teh,0,4,28,28
1683321304241,MMW 15,B04,193522,Chang; Edmond Yi-Teh,0,4,28,28
1683321304241,MMW 15,B05,193523,Chang; Edmond Yi-Teh,0,5,28,28
1683321304241,MMW 15,B06,193524,Chang; Edmond Yi-Teh,0,4,28,28
1683321305263,MMW 122,A01,193526,Rahimi; Babak,0,14,28,28
1683321305263,MMW 122,A02,193527,Rahimi; Babak,0,14,28,28
1683321305263,MMW 122,A03,193528,Rahimi; Babak,0,0,0,0
1683321305263,MMW 122,A04,193529,Rahimi; Babak,0,0,0,0
1683321306287,MUS 1A,A01,186663,Staff,0,20,35,35
1683321307313,MUS 4,A01,186715,Staff,0,12,35,35
1683321308340,MUS 5R,A01,186796,Dubnov; Shlomo,0,17,35,35
1683321309365,MUS 6,A01,186798,Staff,0,3,25,25
1683321310391,MUS 7,A01,186830,Staff,12,0,35,23
1683321311419,MUS 8,A01,186930,Staff,0,26,35,35
1683321312443,MUS 15,A01,186932,Staff,0,15,35,35
1683321312443,MUS 15,B01,186934,Staff,0,15,35,35
1683321313471,MUS 80,A00,186935,Staff,2,0,20,18
1683321313471,MUS 80,B00,186936,Staff,25,0,25,0
1683321314496,NANO 11,A00,204702,Lipomi; Darren John,0,0,0,0
1683321315520,NANO 15,A01,204709,Yang; Kesong,0,1,0,0
1683321316547,NANO 114,A00,202069,Jahed Motlagh; Zeinab,3,0,10,7
1683321317574,PHIL 1,A00,186955,Grush; Rick Scott,32,0,40,8
1683321318602,PHIL 10,A01,186973,Grush; Rick Scott,28,0,35,7
1683321318602,PHIL 10,A02,186974,Grush; Rick Scott,33,0,35,2
1683321319626,PHIL 13,A01,186976,Staff,7,0,35,28
1683321319626,PHIL 13,A02,186977,Staff,16,0,35,19
1683321320651,PHIL 14,A01,186979,Staff,31,0,35,4
1683321320651,PHIL 14,A02,186986,Staff,32,0,35,3
1683321321680,PHIL 28,A01,186988,Staff,16,0,30,14
1683321321680,PHIL 28,A02,186989,Staff,1,0,30,29
1683321321680,PHIL 28,A03,186990,Staff,9,0,30,21
1683321321680,PHIL 28,A04,186991,Staff,26,0,30,4
1683321322705,PHIL 120,A00,186997,Staff,23,0,40,17
1683321323733,PHIL 137,A00,187003,Staff,9,0,40,31
1683321324757,PHIL 150,A00,187015,Staff,47,0,70,23
1683321325781,PHIL 167,A00,187021,Lamey; Andy M.,35,0,40,5
1683321326805,PHIL 174,A01,202226,Staff,17,0,20,3
1683321326805,PHIL 174,A02,202235,Staff,20,0,20,0
1683321327832,PHIL 191A,A00,258918,Staff,0,0,1,1
1683321328859,PHYS 1A,A00,187028,Staff,27,0,60,33
1683321329885,PHYS 1AL,001,187036,Staff,3,0,30,27
1683321329885,PHYS 1AL,002,187049,Staff,18,0,30,12
1683321330910,PHYS 1B,A00,187058,Staff,22,0,60,38
1683321331938,PHYS 1BL,001,187064,Staff,0,0,30,30
1683321331938,PHYS 1BL,002,187070,Staff,5,0,30,25
1683321332965,PHYS 1C,A00,187082,Staff,31,0,120,89
1683321333990,PHYS 1CL,001,187088,Staff,0,9,30,30
1683321333990,PHYS 1CL,002,187089,Staff,0,2,30,30
1683321333990,PHYS 1CL,009,262693,Staff,11,0,30,19
1683321335014,PHYS 2B,A01,187097,Staff,54,0,115,61
1683321336038,PHYS 2C,A01,187099,Staff,67,0,115,48
1683321337067,PHYS 2CL,A01,187101,Staff,5,0,28,23
1683321337067,PHYS 2CL,A02,187102,Staff,15,0,28,13
1683321338095,PHYS 2D,A01,187123,Shotwell; Brian,95,0,115,20
1683321339119,PHYS 4B,A01,187133,Grinstein; Benjamin,35,0,50,15
1683321340143,POLI 10,A00,188819,Staff,0,4,50,50
1683321341166,POLI 11,A00,188827,Staff,43,0,50,7
1683321342189,POLI 13R,A00,188828,Staff,0,1,20,20
1683321343213,POLI 27,A01,188830,Elgin; Samuel Zincke,0,1,70,70
1683321344237,POLI 30,A00,188832,Desposato; Scott,31,0,50,19
1683321345264,POLI 102F,A00,188834,Staff,3,0,40,37
1683321346292,POLI 104A,A00,188852,Staff,14,0,30,16
1683321347318,POLI 104I,A00,188853,Staff,0,6,20,20
1683321348345,POLI 110B,A00,188854,Wiens; David,7,0,20,13
1683321349372,POLI 112A,A00,188855,Wiens; David,5,0,30,25
1683321350396,POLI 117R,A00,188856,Forman; Fonna,0,11,20,20
1683321351423,POLI 118,A00,188857,Ingham; Sean,8,0,20,12
1683321352448,POLI 120G,A00,188858,Staff,9,0,30,21
1683321353471,POLI 131CR,A00,188863,Hoston; Germaine,24,0,50,26
1683321354495,POLI 133,A00,188864,Nellis; Gareth Hb,44,0,50,6
1683321355520,POLI 134D,A00,188865,Desposato; Scott,27,0,30,3
1683321356544,POLI 142A,A00,188871,Gartzke; Erik,22,0,50,28
1683321357570,POLI 142K,A00,188874,Staff,38,0,50,12
1683321358592,POLI 143,A00,188940,Gartzke; Erik,16,0,30,14
1683321359619,POLI 153,A00,188943,Staff,3,0,20,17
1683321360644,POLI 160AA,A00,188944,Staff,12,0,40,28
1683321361669,POLI 170A,A00,188945,Staff,11,0,30,19
1683321363787,PSYC 1,A00,188952,Staff,37,0,90,53
1683321364814,PSYC 2,B00,188953,Staff,19,0,35,16
1683321365837,PSYC 6,A00,188970,Staff,47,0,60,13
1683321366863,PSYC 7,A00,188973,Staff,37,0,45,8
1683321367892,PSYC 60,A01,188980,Rickard; Timothy C.,43,0,60,17
1683321368919,PSYC 70,A01,189001,Steiner; Eric Tomas,24,0,45,21
1683321369944,PSYC 100,A00,189005,Lacefield; Katharine I,0,99,120,120
1683321370971,PSYC 102,A00,189008,Staff,10,0,30,20
1683321371999,PSYC 106,B00,189026,Gorman; Michael R.,35,0,60,25
1683321373028,PSYC 114,B01,189033,Winkielman; Piotr,0,32,30,30
1683321374054,PSYC 131,A00,189036,Anagnostaras; Stephan,0,43,60,60
1683321375080,PSYC 136,A00,189041,Lowe; Angela Beth,0,7,25,25
1683321376106,PSYC 137,A00,189057,Winkielman; Piotr,0,34,25,25
1683321377131,PSYC 144,A00,189107,Wixted; John T,0,7,50,50
1683321379177,PSYC 162,A00,189142,Staff,0,8,85,85
1683321380205,PSYC 172,A00,189144,Gorman; Michael R.,0,7,30,30
1683321382253,PSYC 179,A00,189146,Lacefield; Katharine I,0,84,120,120
1683321383281,PSYC 181,A00,189147,Anagnostaras; Stephan,0,44,90,90
1683321384306,PSYC 190R,A00,189148,Barner; David A.,0,22,80,80
1683321385330,PSYC 191,A00,189275,Rickard; Timothy C.,0,7,25,25
1683321386359,PSYC 193,A00,189276,Chapman; Eddie Nathaniel,0,1,0,4
1683321387388,PSYC 193L,A01,189281,Lowe; Angela Beth,12,0,20,8
1683321387388,PSYC 193L,B01,189285,Staff,28,0,35,7
1683321388414,RELI 149,A00,187137,Rahimi; Babak,7,0,40,33
1683321389437,SE 9,A01,187315,Staff,0,2,18,18
1683321390465,SE 101B,A00,187409,Staff,24,0,30,6
1683321391493,SE 110B,A00,187444,Staff,10,0,40,30
1683321392518,SE 130B,A00,187449,Staff,31,0,40,9
1683321393542,SE 150A,A00,187516,Staff,9,0,20,11
1683321394567,SE 154,A00,187528,Staff,30,0,50,20
1683321395592,SIO 3,A01,258171,Staff,35,0,40,5
1683321396616,SIO 10,A00,187144,Cook; Geoffrey W,0,3,75,75
1683321397640,SIO 45,A00,187152,Cook; Geoffrey W,1,0,100,99
1683321398668,SIO 109R,A00,194486,Staff,0,3,20,20
1683321400720,SIO 187,A01,187233,Kacev; David,12,0,40,28
1683321401745,SOCI 1,A01,258656,Thorpe; Charles Robert,28,0,30,2
1683321401745,SOCI 1,A02,258658,Thorpe; Charles Robert,30,0,30,0
1683321401745,SOCI 1,A03,258661,Thorpe; Charles Robert,25,0,25,0
1683321401745,SOCI 1,A04,258666,Thorpe; Charles Robert,22,0,25,3
1683321401745,SOCI 1,A05,258897,Thorpe; Charles Robert,23,0,25,2
1683321401745,SOCI 1,A06,258898,Thorpe; Charles Robert,25,0,25,0
1683321402769,SOCI 30,A01,258903,Pardo Guerra; Juan Pablo,16,0,30,14
1683321403794,SOCI 102,A00,258904,Staff,9,0,25,16
1683321404820,SOCI 106,A00,258905,Staff,19,0,25,6
1683321405847,SOCI 111,A00,258907,Ribas Norris; Janet Vanesa,26,0,30,4
1683321406872,SOCI 121R,A00,258908,Pardo Guerra; Juan Pablo,11,0,30,19
1683321407900,SOCI 126,A01,203330,Staff,14,0,20,6
1683321408925,SOCI 131,A00,258909,Thorpe; Charles Robert,31,0,60,29
1683321409950,SOCI 135,A00,258910,Payne; Christine Anna,0,9,30,30
1683321410978,SOCI 157,A00,258911,Staff,12,0,30,18
1683321412002,SOCI 184,A00,258912,Staff,25,0,30,5
1683321413027,SOCI 188D,A00,258913,Staff,21,0,30,9
1683321414050,SYN 2,001,187529,Staff,9,0,16,7
1683321414050,SYN 2,002,201452,Staff,0,18,16,16
1683321414050,SYN 2,003,201469,Staff,4,0,16,12
1683321415074,SYN 100,A01,187531,Staff,0,9,20,20
1683321415074,SYN 100,B01,201491,Staff,0,12,20,20
1683321416098,TDAC 1,A00,189286,Walsh; Kim C.,3,0,20,17
1683321416098,TDAC 1,B00,189287,Harting; Carla Kelso,11,0,20,9
1683321417125,TDAC 101,A00,189300,Walsh; Kim C.,16,0,20,4
1683321417125,TDAC 101,B00,189301,Harting; Carla Kelso,18,0,20,2
1683321418150,TDAC 102,A00,189304,Basso; Beatrice,14,0,20,6
1683321419175,TDAC 108,A00,189305,Staff,18,0,20,2
1683321420200,TDDE 131,A00,189310,Staff,19,0,20,1
1683321420200,TDDE 131,B00,189314,Staff,19,0,20,1
1683321420200,TDDE 131,C00,189315,Staff,48,0,50,2
1683321420200,TDDE 131,D00,189316,Staff,14,0,15,1
1683321420200,TDDE 131,E00,204841,Staff,20,0,20,0
1683321421224,TDGE 10,A00,189289,Staff,30,0,50,20
1683321421224,TDGE 10,B00,189290,Havis; Allan,1,0,50,49
1683321422249,TDGE 11,A00,189291,Fulton; Julia,0,3,50,50
1683321422249,TDGE 11,B00,189292,Staff,20,0,25,5
1683321422249,TDGE 11,C00,260270,Staff,0,0,0,0
1683321423273,TDGE 25,A00,189294,Staff,3,0,20,17
1683321424300,TDGE 124,A00,189318,Fulton; Julia,0,8,50,50
1683321425324,TDGE 125,A00,189319,Staff,13,0,25,12
1683321425324,TDGE 125,B00,189320,Staff,23,0,25,2
1683321426348,TDGE 127,A00,189322,Havis; Allan,0,0,50,50
1683321427372,TDHT 101,A00,189323,Staff,18,0,25,7
1683321427372,TDHT 101,B00,189324,Staff,25,0,25,0
1683321428396,TDHT 102,A00,189325,Staff,49,0,50,1
1683321429421,TDMV 1,A00,189295,Arcidiacono; Kristin,19,0,30,11
1683321429421,TDMV 1,B00,189296,Caligagan; Maria T.,24,0,30,6
1683321430445,TDMV 2,A00,189297,Sammartano; Tonnie,28,0,30,2
1683321430445,TDMV 2,B00,189299,Arcidiacono; Kristin,24,0,30,6
1683321431469,TDMV 3,A00,204998,Rincon; Alicia,22,0,30,8
1683321432493,TDMV 120,A00,189458,Sammartano; Tonnie,28,0,30,2
1683321433517,TDMV 138,A00,189541,Jun; Grace Shin Hae,22,0,40,18
1683321434541,TDMV 142,A00,189717,Caligagan; Tony,23,0,30,7
1683321434541,TDMV 142,B00,189718,Caligagan; Maria T.,25,0,30,5
1683321435570,TMC 2,A01,187533,Staff,25,0,25,0
1683321435570,TMC 2,A02,187534,Staff,25,0,25,0
1683321436594,USP 1,A01,187536,Kwak; Nancy,0,16,25,25
1683321437618,USP 5,A01,187538,Staff,9,0,25,16
1683321438642,USP 101,A00,199253,Staff,0,4,0,0
1683321439670,USP 124,A00,187562,Boomhower; Matthew Charles,1,0,30,29
1683321440698,USP 138,A00,187582,Staff,20,0,25,5
1683321441724,USP 152,A01,187597,Staff,4,0,25,21
1683321442747,USP 153,A00,187598,Staff,19,0,25,6
1683321443770,USP 168,A00,187607,Kwak; Nancy,2,0,5,3
1683321444793,USP 173,A00,187619,Staff,4,0,25,21
1683321445821,USP 181,A00,187638,Staff,0,0,25,25
1683321446845,VIS 103,A00,187650,Cruz; Edwin Teddy,23,0,75,52
1683321447876,VIS 110D,A00,187669,Staff,12,0,22,10
1683321448900,VIS 127C,A00,187720,Shen; Kuiyi,68,0,146,78
1683321449926,VIS 149,A00,187731,Yoldas; Pinar,0,14,22,22
1683321450950,VIS 151,A01,188091,Staff,22,0,34,12
1683321450950,VIS 151,A02,188092,Staff,11,0,34,23
1683321451977,VIS 160B,A00,188093,Stalbaum; Brett,0,0,10,10
1683321454025,WCWP 10B,A00,201720,Staff,10,0,15,5
1683321454025,WCWP 10B,B00,201722,Staff,8,0,15,7
1683321455050,WCWP 100,A00,201725,Gagnon; Jeffrey C,0,0,2,2
1683321455050,WCWP 100,B00,201727,Staff,0,4,15,15
1683321458178,ANBI 133,A00,258401,Wilder; Linnea Lorene,34,0,40,6
1683321459204,ANBI 140,A00,258395,Hrvoj Mihic; Branka,18,0,25,7
1683321460228,ANSC 120,A00,258402,Bialecki; Jon Anthony,27,0,40,13
1683321461255,ANSC 144,A00,258400,Staff,14,0,40,26
1683321463310,ANSC 166,A00,258396,Parish; Steven Martin,157,0,175,18
1683321464338,ANSC 180,A00,193533,Staff,9,0,20,11
1683321465365,ANSC 188,A00,258397,Jassal; Aftab,33,0,40,7
1683321466390,ANTH 3,A01,258316,Staff,23,0,30,7
1683321467471,ANTH 5,A00,258394,Semendeferi; Ekaterini,16,0,20,4
1683321468498,ANTH 21,A01,258331,Staff,9,0,40,31
1683321469525,ANTH 103,A00,258398,Varma; Saiba,15,0,25,10
1683321470550,AWP 10,001,202034,Staff,0,0,0,0
1683321470550,AWP 10,002,202035,Staff,0,0,0,0
1683321470550,AWP 10,003,202036,Staff,0,0,0,0
1683321470550,AWP 10,004,202037,Staff,0,0,0,0
1683321470550,AWP 10,005,202038,Staff,0,0,0,0
1683321470550,AWP 10,006,202039,Staff,0,0,0,0
1683321470550,AWP 10,007,202040,Staff,0,0,0,0
1683321470550,AWP 10,008,202041,Staff,0,0,0,0
1683321470550,AWP 10,009,202042,Staff,0,0,0,0
1683321470550,AWP 10,010,202043,Staff,0,0,0,0
1683321470550,AWP 10,011,202044,Staff,0,0,0,0
1683321470550,AWP 10,012,202045,Staff,0,0,0,0
1683321470550,AWP 10,013,202046,Staff,0,0,0,0
1683321470550,AWP 10,014,202047,Staff,0,0,0,0
1683321470550,AWP 10,015,202048,Staff,0,0,0,0
1683321470550,AWP 10,016,202049,Staff,0,0,0,0
1683321470550,AWP 10,017,202050,Staff,0,0,0,0
1683321470550,AWP 10,018,202051,Staff,0,0,0,0
1683321470550,AWP 10,019,202052,Staff,0,0,0,0
1683321470550,AWP 10,020,202053,Staff,0,0,0,0
1683321470550,AWP 10,021,202054,Staff,0,0,0,0
1683321470550,AWP 10,022,202055,Staff,0,0,0,0
1683321470550,AWP 10,023,202056,Staff,0,0,0,0
1683321470550,AWP 10,024,202057,Staff,0,0,0,0
1683321470550,AWP 10,025,202058,Staff,0,0,0,0
1683321470550,AWP 10,026,202059,Staff,0,0,0,0
1683321471576,AWP 102,001,202032,Staff,0,0,0,0
1683321471576,AWP 102,002,202033,Staff,0,0,0,0
1683321472601,BENG 100,A01,254234,Taylor Amos; Alyssa C,31,0,40,9
1683321473624,BENG 196,001,270013,Engler; Adam J.,9999,0,9999,0
1683321474649,BICD 100R,A01,202018,Smith; Laurie,0,7,32,32
1683321474649,BICD 100R,A02,202019,Smith; Laurie,0,2,32,32
1683321474649,BICD 100R,A03,202020,Smith; Laurie,0,1,32,32
1683321474649,BICD 100R,A04,202021,Smith; Laurie,8,0,32,24
1683321474649,BICD 100R,A05,202022,Smith; Laurie,12,0,32,20
1683321475677,BICD 136,A01,193242,Gustafson-Brown; Cindy,0,2,32,32
1683321475677,BICD 136,A02,193244,Gustafson-Brown; Cindy,14,0,32,18
1683321476703,BIEB 102,A01,193249,Butler; Shannon Rhey,0,2,32,32
1683321476703,BIEB 102,A02,193251,Butler; Shannon Rhey,0,0,32,32
1683321476703,BIEB 102,A03,193253,Butler; Shannon Rhey,0,1,32,32
1683321476703,BIEB 102,A04,193255,Butler; Shannon Rhey,17,0,32,15
1683321476703,BIEB 102,A05,193265,Butler; Shannon Rhey,26,0,32,6
1683321476703,BIEB 102,A06,193269,Butler; Shannon Rhey,16,0,32,16
1683321478755,BIEB 150,A01,193274,Staff,0,0,32,32
1683321478755,BIEB 150,A02,193285,Staff,23,0,32,9
1683321479782,BIEB 194,A00,193286,Kurle; Carolyn M.,22,0,32,10
1683321480810,BILD 1,A01,192291,Staff,16,0,32,16
1683321480810,BILD 1,A02,192292,Staff,30,0,32,2
1683321480810,BILD 1,B01,192520,Reuther; Keefe,0,1,0,0
1683321480810,BILD 1,B02,192532,Reuther; Keefe,0,1,0,0
1683321481835,BILD 3,A01,192556,Butler; Shannon Rhey,0,0,32,32
1683321481835,BILD 3,A02,192581,Butler; Shannon Rhey,5,0,32,27
1683321481835,BILD 3,A03,192611,Butler; Shannon Rhey,23,0,32,9
1683321481835,BILD 3,A04,192612,Butler; Shannon Rhey,25,0,32,7
1683321481835,BILD 3,A05,192613,Butler; Shannon Rhey,27,0,32,5
1683321481835,BILD 3,A06,192679,Butler; Shannon Rhey,27,0,32,5
1683321481835,BILD 3,A07,192682,Butler; Shannon Rhey,22,0,32,10
1683321482863,BILD 4,A01,192836,Reuther; Keefe,0,0,24,24
1683321482863,BILD 4,A02,193044,Reuther; Keefe,4,0,24,20
1683321483888,BILD 10,A01,193142,Gustafson-Brown; Cindy,30,0,32,2
1683321483888,BILD 10,A02,193149,Gustafson-Brown; Cindy,31,0,32,1
1683321484912,BIMM 100,A01,193301,Staff,0,6,32,32
1683321484912,BIMM 100,A02,193312,Staff,0,5,32,32
1683321484912,BIMM 100,A03,193323,Staff,0,8,32,32
1683321485942,BIMM 101,A01,193329,McDonnell; Lisa Marie,0,3,24,24
1683321485942,BIMM 101,A02,193339,McDonnell; Lisa Marie,0,3,24,24
1683321485942,BIMM 101,B01,193354,McDonnell; Lisa Marie,0,3,24,24
1683321485942,BIMM 101,B02,193357,McDonnell; Lisa Marie,0,3,24,24
1683321486970,BIMM 110,A01,193377,Tat; John,0,11,32,32
1683321486970,BIMM 110,A02,193378,Tat; John,1,9,32,31
1683321487996,BIMM 120,A01,206116,Staff,0,0,32,32
1683321487996,BIMM 120,A02,206117,Staff,8,0,32,24
1683321487996,BIMM 120,A03,206121,Staff,21,0,32,11
1683321489024,BIPN 100,A01,193393,Park; Ji Young,0,14,32,32
1683321489024,BIPN 100,A02,193402,Park; Ji Young,0,12,32,32
1683321489024,BIPN 100,A03,193413,Park; Ji Young,0,14,32,32
1683321489024,BIPN 100,A04,193414,Park; Ji Young,0,13,32,32
1683321490048,BIPN 102,A01,193429,Staff,0,0,32,32
1683321490048,BIPN 102,A02,193438,Staff,22,0,32,10
1683321491076,BIPN 106,A01,193450,Reyes Gonzalez; Catalina,0,2,40,40
1683321492106,BIPN 134,A01,193465,Cooke; James Edward,0,0,32,32
1683321492106,BIPN 134,A02,193474,Cooke; James Edward,25,0,32,7
1683321492106,BIPN 134,A03,193485,Cooke; James Edward,29,0,32,3
1683321492106,BIPN 134,A04,193486,Cooke; James Edward,21,0,32,11
1683321492106,BIPN 134,A05,193491,Cooke; James Edward,31,0,32,1
1683321492106,BIPN 134,A06,193501,Cooke; James Edward,30,0,32,2
1683321492106,BIPN 134,A07,193510,Cooke; James Edward,29,0,32,3
1683321494157,BISP 194,A00,222522,Staff,15,0,32,17
1683321495182,CAT 124,A01,202407,Staff,20,0,25,5
1683321496206,CAT 125,A00,202408,Marchisotto; Jennifer Anne,4,0,20,16
1683321497236,CAT 125R,A00,202409,Smith; Lauryn Alissa,0,11,20,20
1683321497236,CAT 125R,B00,202410,Morales; Celeste Georgianna,0,11,20,20
1683321497236,CAT 125R,C00,202411,Irwin; Matthew Joseph,0,10,20,20
1683321498261,CENG 15,A01,204712,Yang; Kesong,0,1,0,0
1683321499285,CENG 114,A00,202070,Jahed Motlagh; Zeinab,5,0,20,15
1683321500309,CGS 105,A00,185477,Wesling; Megan E.,24,0,40,16
1683321501332,CGS 106,A00,185494,Staff,13,0,22,9
1683321502355,CGS 108,A00,185495,Staff,14,0,20,6
1683321503383,CGS 114,A00,185496,Staff,13,0,18,5
1683321504407,CGS 119,A00,185501,Staff,15,0,20,5
1683321505431,CGS 120,A00,185511,Staff,13,0,20,7
1683321506460,CHEM 4,A01,184675,Bussey; Thomas J,96,0,100,4
1683321507485,CHEM 6A,A01,184677,Staff,34,0,60,26
1683321508509,CHEM 6B,A01,184679,Staff,65,0,100,35
1683321509533,CHEM 6C,A01,184681,Bussey; Thomas J,1,0,50,49
1683321509533,CHEM 6C,A02,184682,Bussey; Thomas J,34,0,50,16
1683321510558,CHEM 40A,A01,184684,Albizati; Kim F.,37,0,100,63
1683321511583,CHEM 40B,A01,184686,Albizati; Kim F.,0,20,100,100
1683321512613,CHEM 41B,A01,184690,Staff,52,0,100,48
1683321513637,COGS 3,A01,184715,Boyle; Mary E. T.,0,25,40,40
1683321514662,COGS 14B,A01,185172,Staff,0,15,38,38
1683321515689,COGS 18,A01,184736,Staff,18,0,80,62
1683321516716,COGS 100,A01,184932,Staff,0,5,73,73
1683321517743,COGS 101A,A01,184935,Staff,0,38,30,30
1683321518767,COGS 101B,A01,184944,Staff,0,2,30,30
1683321519791,COGS 101C,A01,184946,Staff,0,12,30,30
1683321520815,COGS 102A,A01,184951,Johnson; Christine M.,2,0,40,38
1683321521842,COGS 107B,A01,184953,Mooshagian; Eric Frederick,0,50,40,40
1683321522867,COGS 118B,A01,184959,Gupta; Anjum,0,48,40,40
1683321523892,COGS 153,A00,184961,Staff,0,15,30,30
1683321524915,COGS 177,A00,184962,Staff,0,21,30,30
1683321525939,COGS 187A,A01,184969,Boyle; Mary E. T.,0,17,40,40
1683321526964,COMM 10,A01,185174,Staff,0,5,25,25
1683321526964,COMM 10,A02,185189,Staff,0,5,25,25
1683321526964,COMM 10,A03,269821,Staff,0,0,0,0
1683321527987,COMM 100B,A01,185475,Staff,0,0,0,2
1683321527987,COMM 100B,A02,185476,Staff,14,0,25,11
1683321529011,COMM 100C,A01,185314,Staff,1,0,25,24
1683321529011,COMM 100C,A02,185327,Staff,19,0,25,6
1683321530043,COMM 110M,A00,185349,Staff,2,0,40,38
1683321531070,COMM 113T,A00,185352,Staff,25,0,40,15
1683321532094,COMM 114I,A00,185353,Staff,33,0,40,7
1683321533117,COMM 131,A00,185354,Staff,19,0,30,11
1683321534142,CSE 8A,A50,185358,Cao; Yingjun,0,46,10,10
1683321535169,CSE 8B,A01,185362,Staff,1,47,50,49
1683321536197,CSE 11,A01,185416,Cao; Yingjun,0,92,10,10
1683321537223,CSE 20,A01,185445,Briones; Jor-el Thomas Caparas,5,0,25,20
1683321538249,CSE 21,A01,185447,Staff,10,0,50,40
1683321539274,CSE 101,A01,185451,Staff,0,12,50,50
1683321539274,CSE 101,B01,185453,Jones; Miles E,0,11,50,50
1683321541325,CSE 141,A01,185458,Eldon; John,20,0,100,80
1683321542352,CSE 141L,A01,185461,Eldon; John,12,0,100,88
1683321543377,CSE 142,A01,185463,Staff,36,0,60,24
1683321543377,CSE 142,B01,201355,Staff,0,7,60,60
1683321544400,CSE 142L,A01,185470,Staff,36,0,60,24
1683321544400,CSE 142L,B01,201417,Staff,0,6,60,60
1683321545425,CSE 190,A00,201433,Staff,32,0,49,17
1683321546449,DOC 1,A01,259136,Strom; Megan C.,7,0,15,8
1683321546449,DOC 1,A02,259137,Strom; Megan C.,14,0,15,1
1683321546449,DOC 1,A03,259138,Strom; Megan C.,14,0,15,1
1683321546449,DOC 1,A04,259139,Strom; Megan C.,14,0,15,1
1683321547474,DOC 100D,A00,259140,Pass; Natalye Joann,17,0,25,8
1683321548504,DSGN 1,A01,184749,Rill; Bryan,0,25,30,30
1683321549530,DSGN 100,A01,185168,Staff,0,2,25,25
1683321550557,ECE 5,A01,185626,Morris; Karcher William,0,10,0,0
1683321551583,ECE 101,A01,185628,Staff,17,0,70,53
1683321552613,ECE 107,A01,185635,Baghdadchi; Saharnaz,0,0,20,20
1683321552613,ECE 107,A02,185638,Baghdadchi; Saharnaz,4,0,20,16
1683321553646,ECE 148,A01,185647,Silberman; Jack,0,0,16,16
1683321554673,ECON 1,A01,185537,Crane; Meredith Helen,54,0,70,16
1683321555699,ECON 3,A01,185549,Crane; Meredith Helen,33,0,70,37
1683321556723,ECON 4,A01,203354,Anderson; John Charles,0,4,10,10
1683321557751,ECON 100A,A01,185574,Staff,0,4,40,40
1683321558777,ECON 100B,A01,185576,Staff,0,22,40,40
1683321559800,ECON 100C,A01,185589,Newhouse; Herbert S,30,0,70,40
1683321560823,ECON 105,A00,185608,Vespa; Emanuel Ignacio,19,0,35,16
1683321561847,ECON 109,A01,185610,Shishkin; Denis,10,0,35,25
1683321562871,ECON 110A,A01,185612,Staff,11,0,40,29
1683321563897,ECON 120A,A01,185615,Staff,20,0,40,20
1683321564921,ECON 120C,A01,185617,Sun; Yixiao,0,20,70,70
1683321565948,ECON 144,A00,203346,Squires; Dale E,3,0,35,32
1683321566972,ECON 171,A01,203349,Newhouse; Herbert S,0,1,35,35
1683321567996,ECON 173A,A01,185621,Toda; Alexis Akira,21,0,35,14
1683321569028,EDS 25,A01,202413,Staff,0,1,0,0
1683321569028,EDS 25,A02,202414,Staff,0,1,0,0
1683321569028,EDS 25,A03,202415,Staff,0,0,0,0
1683321569028,EDS 25,A04,202416,Staff,0,1,0,0
1683321569028,EDS 25,A05,202439,Staff,0,0,0,0
1683321569028,EDS 25,A06,202440,Staff,0,0,0,0
1683321569028,EDS 25,B01,202631,Staff,0,0,0,0
1683321569028,EDS 25,B02,202632,Staff,0,0,0,0
1683321569028,EDS 25,B03,202639,Staff,0,0,0,0
1683321569028,EDS 25,B04,202640,Staff,0,0,0,0
1683321569028,EDS 25,B05,202643,Staff,0,0,0,0
1683321569028,EDS 25,B06,202644,Staff,0,0,0,0
1683321570053,EDS 38,A01,202659,Black; Alison Michelle,24,0,25,1
1683321571136,EDS 115,A00,202652,Staff,17,0,30,13
1683321572166,EDS 125,A00,202649,Staff,14,0,30,16
1683321573193,EDS 126,A01,203332,Staff,30,0,30,0
1683321574215,EDS 139,A00,202838,Staff,16,0,25,9
1683321575239,EDS 146,A01,202655,Staff,14,0,25,11
1683321576265,ENG 15,A00,185667,Staff,0,1,0,0
1683321576265,ENG 15,B00,185672,Staff,0,0,0,0
1683321576265,ENG 15,C00,185675,Staff,0,0,0,0
1683321576265,ENG 15,D00,185682,Staff,0,0,0,0
1683321576265,ENG 15,E00,185684,Staff,0,0,0,0
1683321577289,ETHN 103,A00,185710,Staff,0,3,35,35
1683321578318,ETHN 103A,A00,199228,Man; Simeon S,2,0,9,7
1683321579343,ETHN 109,A00,185711,Staff,18,0,35,17
1683321580370,ETHN 142,A00,185726,Staff,0,4,30,30
1683321581396,ETHN 163J,A00,199229,Man; Simeon S,5,0,8,3
1683321582420,ETHN 168,A00,185727,Staff,8,0,10,2
1683321583450,ETHN 182,A00,185728,Staff,1,0,35,34
1683321584474,ETHN 183,A00,185737,Staff,8,0,18,10
1683321585500,GLBH 111,A01,209361,Burgos; Jose L.,0,0,0,0
1683321587554,HIEU 104,A00,185792,Staff,16,0,20,4
1683321588578,HIEU 115,A00,185800,Staff,1,0,20,19
1683321589605,HIEU 128,A00,185801,Staff,0,7,20,20
1683321590631,HIEU 147,A00,185802,Staff,16,0,20,4
1683321591656,HIEU 154,A00,185823,Staff,12,0,20,8
1683321592682,HILA 102,A00,185826,Staff,13,0,20,7
1683321593711,HILD 2C,A01,185778,Staff,0,12,20,20
1683321594736,HILD 7B,A01,185780,Kwak; Nancy,0,15,32,32
1683321594736,HILD 7B,A02,185781,Kwak; Nancy,0,18,32,32
1683321595761,HILD 30,A01,185791,Staff,14,0,20,6
1683321596788,HISC 119,A00,185830,Golan; Tal,0,9,20,20
1683321597815,HITO 156GS,A00,185831,Patterson; Patrick H.,0,0,0,23
1683321598841,HIUS 103,A00,185832,Man; Simeon S,0,6,20,20
1683321599867,HIUS 117,A00,185836,Kwak; Nancy,2,0,20,18
1683321600892,HIUS 125,A00,185840,Man; Simeon S,0,0,23,23
1683321601918,HIUS 149,A00,185845,Staff,0,0,20,20
1683321602992,HUM 3,A01,185882,Zavodny; Tatiana Sophia,0,6,50,50
1683321602992,HUM 3,B01,185899,Caldwell; Michael Alan,0,19,50,50
1683321604019,HUM 3GS,A00,185900,Patterson; Patrick H.,0,0,0,23
1683321605046,HUM 4,A01,185938,Zroka; Amy Liane,31,0,50,19
1683321605046,HUM 4,B01,185956,Watkins; Eric,0,2,50,50
1683321605046,HUM 4,B02,202209,Watkins; Eric,0,2,50,50
1683321605046,HUM 4,B03,202210,Watkins; Eric,0,0,50,50
1683321606075,HUM 5,A01,185958,West; Geoffrey Scott,3,0,50,47
1683321606075,HUM 5,A02,202215,West; Geoffrey Scott,0,0,50,50
1683321607102,INTL 190,A00,185959,Gagnon; Jeffrey C,0,0,0,9
1683321607102,INTL 190,B00,185960,Lettieri; Michael Joseph,0,0,0,1
1683321608129,JAPN 180,A00,254509,Staff,5,1,30,25
1683321609153,LATI 10,A01,202853,Kennemore; Amy Michelle,5,0,35,30
1683321609153,LATI 10,A02,202854,Kennemore; Amy Michelle,1,0,35,34
1683321609153,LATI 10,A03,270054,Kennemore; Amy Michelle,30,0,30,0
1683321610179,LATI 180,A00,202855,Kennemore; Amy Michelle,11,0,20,9
1683321611207,LAWS 101,A00,201767,Golan; Tal,0,7,40,40
1683321612229,LIFR 1C,A00,185961,Staff,6,0,20,14
1683321613252,LIFR 1CX,A00,185962,Staff,7,0,20,13
1683321614275,LIFR 1D,A00,185963,Staff,9,0,20,11
1683321615299,LIFR 1DX,A00,185964,Staff,9,0,20,11
1683321616325,LIGN 101,A01,186039,Staff,43,0,50,7
1683321617354,LIGN 165,A00,186040,Staff,18,0,50,32
1683321618377,LTCS 108,A00,186041,Staff,6,0,10,4
1683321619403,LTCS 119,A00,186042,Staff,16,0,20,4
1683321620426,LTCS 130,A00,186043,Wesling; Megan E.,15,0,25,10
1683321622476,LTEA 138,A00,186119,Staff,14,0,40,26
1683321623499,LTEN 124,A00,186148,Staff,6,0,25,19
1683321624526,LTEN 178,A00,186149,Staff,7,0,15,8
1683321625553,LTEN 181,A00,186150,Blanco; John D,33,0,40,7
1683321626582,LTWL 120,A00,186160,Staff,20,0,25,5
1683321627606,LTWL 165,A00,186161,Staff,22,0,25,3
1683321628633,LTWR 100,A00,186162,Staff,0,5,15,15
1683321629661,LTWR 102,A00,186163,Doller; Ben,5,0,15,10
1683321630685,MAE 8,A01,186412,Staff,0,0,0,0
1683321631713,MAE 30B,A00,186445,Bahadori; Mohammad Yousef,83,0,100,17
1683321632736,MAE 40,A00,186592,Bewley; Thomas R,9,0,50,41
1683321633764,MAE 101B,A00,186593,Bahadori; Mohammad Yousef,81,0,100,19
1683321634787,MAE 105,A00,186594,Bandaru; Prabhakar,12,0,50,38
1683321635814,MAE 107,A00,186599,Pham; Hieu Tan,0,6,120,120
1683321636841,MAE 148,A01,186660,Silberman; Jack,3,0,16,13
1683321637868,MATH 10A,A01,188095,Staff,0,6,35,35
1683321638892,MATH 10B,A01,188097,Bowers; Adam R.,0,11,30,30
1683321638892,MATH 10B,A02,188099,Bowers; Adam R.,0,11,30,30
1683321638892,MATH 10B,B01,188104,Bowers; Adam R.,0,10,30,30
1683321638892,MATH 10B,B02,188106,Bowers; Adam R.,0,10,30,30
1683321639919,MATH 10C,A01,188111,Staff,0,18,30,30
1683321639919,MATH 10C,A02,188127,Staff,0,17,30,30
1683321639919,MATH 10C,A03,188131,Staff,0,18,30,30
1683321639919,MATH 10C,B01,188218,Staff,18,0,30,12
1683321639919,MATH 10C,B02,188244,Staff,13,0,30,17
1683321639919,MATH 10C,B03,188277,Staff,16,0,30,14
1683321640948,MATH 18,A01,188344,Bach; Quang Tran,18,0,30,12
1683321640948,MATH 18,A02,188345,Bach; Quang Tran,11,0,30,19
1683321640948,MATH 18,B01,188353,Bach; Quang Tran,10,0,30,20
1683321640948,MATH 18,B02,188354,Bach; Quang Tran,20,0,30,10
1683321641972,MATH 20A,A01,188374,Staff,13,0,35,22
1683321643001,MATH 20B,A01,188382,Ohm; Ko Woon,6,0,30,24
1683321643001,MATH 20B,A02,188383,Ohm; Ko Woon,23,0,30,7
1683321643001,MATH 20B,B01,188385,Ohm; Ko Woon,7,0,30,23
1683321643001,MATH 20B,B02,188392,Ohm; Ko Woon,22,0,30,8
1683321644026,MATH 20C,A01,188394,Harel; Guershon,10,0,30,20
1683321644026,MATH 20C,A02,188395,Harel; Guershon,14,0,30,16
1683321644026,MATH 20C,B01,188404,Harel; Guershon,5,0,30,25
1683321644026,MATH 20C,B02,188405,Harel; Guershon,19,0,30,11
1683321645056,MATH 20D,A01,188414,Hammock; Frances H,0,1,30,30
1683321645056,MATH 20D,A02,188415,Hammock; Frances H,3,0,30,27
1683321645056,MATH 20D,B01,188447,Hammock; Frances H,2,0,30,28
1683321645056,MATH 20D,B02,188486,Hammock; Frances H,8,0,30,22
1683321646084,MATH 20E,A01,188649,Staff,21,0,30,9
1683321646084,MATH 20E,A02,188650,Staff,23,0,30,7
1683321646084,MATH 20E,A03,188673,Staff,0,0,30,30
1683321647108,MATH 102,A01,188675,Staff,0,35,35,35
1683321648133,MATH 103B,A01,188681,Staff,4,0,35,31
1683321648133,MATH 103B,B01,188692,Staff,5,0,35,30
1683321649161,MATH 109,A01,188695,Salehi Golsefidy; Alireza,25,0,35,10
1683321649161,MATH 109,A02,188696,Salehi Golsefidy; Alireza,26,0,35,9
1683321650190,MATH 120A,A01,188698,Eggers; John Dietrich,7,0,35,28
1683321651220,MATH 142B,A01,188736,Ioana; Adrian,0,2,30,30
1683321651220,MATH 142B,A02,188741,Ioana; Adrian,0,1,30,30
1683321651220,MATH 142B,A03,188743,Ioana; Adrian,1,3,30,29
1683321652243,MATH 168A,A01,188790,Staff,0,9,35,35
1683321653267,MATH 170A,A01,188803,Nie; Jiawang,0,2,35,35
1683321653267,MATH 170A,A02,188811,Nie; Jiawang,0,0,35,35
1683321653267,MATH 170A,A03,188814,Nie; Jiawang,0,0,35,35
1683321653267,MATH 170A,A04,188815,Nie; Jiawang,13,0,35,22
1683321654291,MATH 193B,A01,188817,Staff,0,0,35,35
1683321654291,MATH 193B,A02,188818,Staff,6,0,35,29
1683321655321,MGT 4,A01,202857,Anderson; John Charles,62,0,80,18
1683321656349,MGT 12,A00,202858,Lindenberger; Wade Douglas,42,0,90,48
1683321657374,MGT 18,A00,202859,Staff,74,0,90,16
1683321658397,MGT 18GS,A00,202860,McKay; Michael J,13,0,28,15
1683321659424,MGT 45,A00,202861,Pecore; Joseph P.,13,0,90,77
1683321660448,MGT 100,A00,202863,Yavorsky; Daniel Ryan,28,0,90,62
1683321661473,MGT 103,A00,202864,Ehrich; Kristine R,0,18,90,90
1683321662498,MGT 112,A00,202865,Ehrich; Kristine R,15,0,90,75
1683321663525,MGT 121A,A00,202868,Staff,0,20,0,0
1683321664551,MGT 131B,A00,202869,Anderson; John Charles,59,0,90,31
1683321665577,MGT 136,A00,202871,Lindenberger; Wade Douglas,84,0,90,6
1683321666603,MGT 164,A00,202873,Staff,0,68,90,91
1683321667630,MGT 164GS,A00,202874,McKay; Mary A,13,0,28,15
1683321668653,MGT 180,A00,202875,Staff,0,50,90,91
1683321669677,MMW 11R,A01,205019,Herbst; Matthew,3,0,30,27
1683321669677,MMW 11R,A02,205026,Herbst; Matthew,29,0,30,1
1683321670706,MMW 15,A01,193512,Chang; Edmond Yi-Teh,0,9,28,28
1683321670706,MMW 15,A02,193513,Chang; Edmond Yi-Teh,0,5,28,28
1683321670706,MMW 15,A03,193514,Chang; Edmond Yi-Teh,0,5,28,28
1683321670706,MMW 15,A04,193515,Chang; Edmond Yi-Teh,0,5,28,28
1683321670706,MMW 15,A05,193516,Chang; Edmond Yi-Teh,0,4,28,28
1683321670706,MMW 15,A06,193517,Chang; Edmond Yi-Teh,0,5,28,28
1683321670706,MMW 15,B01,193519,Chang; Edmond Yi-Teh,0,4,28,28
1683321670706,MMW 15,B02,193520,Chang; Edmond Yi-Teh,0,5,28,28
1683321670706,MMW 15,B03,193521,Chang; Edmond Yi-Teh,0,4,28,28
1683321670706,MMW 15,B04,193522,Chang; Edmond Yi-Teh,0,4,28,28
1683321670706,MMW 15,B05,193523,Chang; Edmond Yi-Teh,0,5,28,28
1683321670706,MMW 15,B06,193524,Chang; Edmond Yi-Teh,0,4,28,28
1683321671730,MMW 122,A01,193526,Rahimi; Babak,0,14,28,28
1683321671730,MMW 122,A02,193527,Rahimi; Babak,0,14,28,28
1683321671730,MMW 122,A03,193528,Rahimi; Babak,0,0,0,0
1683321671730,MMW 122,A04,193529,Rahimi; Babak,0,0,0,0
1683321672757,MUS 1A,A01,186663,Staff,0,20,35,35
1683321673782,MUS 4,A01,186715,Staff,0,12,35,35
1683321674866,MUS 5R,A01,186796,Dubnov; Shlomo,0,17,35,35
1683321675890,MUS 6,A01,186798,Staff,0,3,25,25
1683321676915,MUS 7,A01,186830,Staff,12,0,35,23
1683321677939,MUS 8,A01,186930,Staff,0,26,35,35
1683321678962,MUS 15,A01,186932,Staff,0,16,35,35
1683321678962,MUS 15,B01,186934,Staff,0,15,35,35
1683321679986,MUS 80,A00,186935,Staff,2,0,20,18
1683321679986,MUS 80,B00,186936,Staff,25,0,25,0
1683321681013,NANO 11,A00,204702,Lipomi; Darren John,0,0,0,0
1683321682036,NANO 15,A01,204709,Yang; Kesong,0,1,0,0
1683321683061,NANO 114,A00,202069,Jahed Motlagh; Zeinab,3,0,10,7
1683321684085,PHIL 1,A00,186955,Grush; Rick Scott,32,0,40,8
1683321685113,PHIL 10,A01,186973,Grush; Rick Scott,28,0,35,7
1683321685113,PHIL 10,A02,186974,Grush; Rick Scott,33,0,35,2
1683321686140,PHIL 13,A01,186976,Staff,7,0,35,28
1683321686140,PHIL 13,A02,186977,Staff,16,0,35,19
1683321687168,PHIL 14,A01,186979,Staff,31,0,35,4
1683321687168,PHIL 14,A02,186986,Staff,32,0,35,3
1683321688195,PHIL 28,A01,186988,Staff,16,0,30,14
1683321688195,PHIL 28,A02,186989,Staff,1,0,30,29
1683321688195,PHIL 28,A03,186990,Staff,9,0,30,21
1683321688195,PHIL 28,A04,186991,Staff,26,0,30,4
1683321689219,PHIL 120,A00,186997,Staff,23,0,40,17
1683321690247,PHIL 137,A00,187003,Staff,9,0,40,31
1683321691271,PHIL 150,A00,187015,Staff,47,0,70,23
1683321692297,PHIL 167,A00,187021,Lamey; Andy M.,35,0,40,5
1683321693355,PHIL 174,A01,202226,Staff,17,0,20,3
1683321693355,PHIL 174,A02,202235,Staff,20,0,20,0
1683321694382,PHIL 191A,A00,258918,Staff,0,0,1,1
1683321695409,PHYS 1A,A00,187028,Staff,27,0,60,33
1683321696437,PHYS 1AL,001,187036,Staff,3,0,30,27
1683321696437,PHYS 1AL,002,187049,Staff,18,0,30,12
1683321697463,PHYS 1B,A00,187058,Staff,22,0,60,38
1683321698490,PHYS 1BL,001,187064,Staff,0,0,30,30
1683321698490,PHYS 1BL,002,187070,Staff,5,0,30,25
1683321699515,PHYS 1C,A00,187082,Staff,31,0,120,89
1683321700544,PHYS 1CL,001,187088,Staff,0,9,30,30
1683321700544,PHYS 1CL,002,187089,Staff,0,2,30,30
1683321700544,PHYS 1CL,009,262693,Staff,11,0,30,19
1683321701571,PHYS 2B,A01,187097,Staff,54,0,115,61
1683321702598,PHYS 2C,A01,187099,Staff,67,0,115,48
1683321703626,PHYS 2CL,A01,187101,Staff,5,0,28,23
1683321703626,PHYS 2CL,A02,187102,Staff,15,0,28,13
1683321704651,PHYS 2D,A01,187123,Shotwell; Brian,95,0,115,20
1683321705678,PHYS 4B,A01,187133,Grinstein; Benjamin,35,0,50,15
1683321706703,POLI 10,A00,188819,Staff,0,4,50,50
1683321707730,POLI 11,A00,188827,Staff,43,0,50,7
1683321708755,POLI 13R,A00,188828,Staff,0,1,20,20
1683321709783,POLI 27,A01,188830,Elgin; Samuel Zincke,0,1,70,70
1683321710809,POLI 30,A00,188832,Desposato; Scott,31,0,50,19
1683321711836,POLI 102F,A00,188834,Staff,3,0,40,37
1683321712860,POLI 104A,A00,188852,Staff,14,0,30,16
1683321713885,POLI 104I,A00,188853,Staff,0,6,20,20
1683321714912,POLI 110B,A00,188854,Wiens; David,7,0,20,13
1683321715935,POLI 112A,A00,188855,Wiens; David,5,0,30,25
1683321716959,POLI 117R,A00,188856,Forman; Fonna,0,11,20,20
1683321717987,POLI 118,A00,188857,Ingham; Sean,8,0,20,12
1683321719012,POLI 120G,A00,188858,Staff,9,0,30,21
1683321720037,POLI 131CR,A00,188863,Hoston; Germaine,24,0,50,26
1683321721066,POLI 133,A00,188864,Nellis; Gareth Hb,44,0,50,6
1683321722094,POLI 134D,A00,188865,Desposato; Scott,27,0,30,3
1683321723123,POLI 142A,A00,188871,Gartzke; Erik,22,0,50,28
1683321724150,POLI 142K,A00,188874,Staff,38,0,50,12
1683321725174,POLI 143,A00,188940,Gartzke; Erik,16,0,30,14
1683321726201,POLI 153,A00,188943,Staff,3,0,20,17
1683321727226,POLI 160AA,A00,188944,Staff,12,0,40,28
1683321728252,POLI 170A,A00,188945,Staff,11,0,30,19
1683321730303,PSYC 1,A00,188952,Staff,37,0,90,53
1683321731340,PSYC 2,B00,188953,Staff,19,0,35,16
1683321732367,PSYC 6,A00,188970,Staff,47,0,60,13
1683321733394,PSYC 7,A00,188973,Staff,37,0,45,8
1683321734418,PSYC 60,A01,188980,Rickard; Timothy C.,43,0,60,17
1683321735442,PSYC 70,A01,189001,Steiner; Eric Tomas,24,0,45,21
1683321736465,PSYC 100,A00,189005,Lacefield; Katharine I,0,99,120,120
1683321737490,PSYC 102,A00,189008,Staff,10,0,30,20
1683321738514,PSYC 106,B00,189026,Gorman; Michael R.,35,0,60,25
1683321739541,PSYC 114,B01,189033,Winkielman; Piotr,0,32,30,30
1683321740568,PSYC 131,A00,189036,Anagnostaras; Stephan,0,43,60,60
1683321741593,PSYC 136,A00,189041,Lowe; Angela Beth,0,7,25,25
1683321742620,PSYC 137,A00,189057,Winkielman; Piotr,0,34,25,25
1683321743644,PSYC 144,A00,189107,Wixted; John T,0,7,50,50
1683321745698,PSYC 162,A00,189142,Staff,0,8,85,85
1683321746733,PSYC 172,A00,189144,Gorman; Michael R.,0,7,30,30
1683321748787,PSYC 179,A00,189146,Lacefield; Katharine I,0,84,120,120
1683321749814,PSYC 181,A00,189147,Anagnostaras; Stephan,0,44,90,90
1683321750837,PSYC 190R,A00,189148,Barner; David A.,0,22,80,80
1683321751863,PSYC 191,A00,189275,Rickard; Timothy C.,0,7,25,25
1683321752892,PSYC 193,A00,189276,Chapman; Eddie Nathaniel,0,1,0,4
1683321753921,PSYC 193L,A01,189281,Lowe; Angela Beth,12,0,20,8
1683321753921,PSYC 193L,B01,189285,Staff,28,0,35,7
1683321754943,RELI 149,A00,187137,Rahimi; Babak,7,0,40,33
1683321755966,SE 9,A01,187315,Staff,0,2,18,18
1683321756990,SE 101B,A00,187409,Staff,24,0,30,6
1683321758013,SE 110B,A00,187444,Staff,10,0,40,30
1683321759041,SE 130B,A00,187449,Staff,31,0,40,9
1683321760068,SE 150A,A00,187516,Staff,9,0,20,11
1683321761093,SE 154,A00,187528,Staff,30,0,50,20
1683321762120,SIO 3,A01,258171,Staff,35,0,40,5
1683321763144,SIO 10,A00,187144,Cook; Geoffrey W,0,3,75,75
1683321764169,SIO 45,A00,187152,Cook; Geoffrey W,1,0,100,99
1683321765198,SIO 109R,A00,194486,Staff,0,3,20,20
1683321767249,SIO 187,A01,187233,Kacev; David,12,0,40,28
1683321768277,SOCI 1,A01,258656,Thorpe; Charles Robert,28,0,30,2
1683321768277,SOCI 1,A02,258658,Thorpe; Charles Robert,30,0,30,0
1683321768277,SOCI 1,A03,258661,Thorpe; Charles Robert,25,0,25,0
1683321768277,SOCI 1,A04,258666,Thorpe; Charles Robert,22,0,25,3
1683321768277,SOCI 1,A05,258897,Thorpe; Charles Robert,23,0,25,2
1683321768277,SOCI 1,A06,258898,Thorpe; Charles Robert,25,0,25,0
1683321769302,SOCI 30,A01,258903,Pardo Guerra; Juan Pablo,16,0,30,14
1683321770330,SOCI 102,A00,258904,Staff,9,0,25,16
1683321771357,SOCI 106,A00,258905,Staff,19,0,25,6
1683321772380,SOCI 111,A00,258907,Ribas Norris; Janet Vanesa,26,0,30,4
1683321773407,SOCI 121R,A00,258908,Pardo Guerra; Juan Pablo,11,0,30,19
1683321774432,SOCI 126,A01,203330,Staff,14,0,20,6
1683321775453,SOCI 131,A00,258909,Thorpe; Charles Robert,31,0,60,29
1683321776477,SOCI 135,A00,258910,Payne; Christine Anna,0,9,30,30
1683321777501,SOCI 157,A00,258911,Staff,12,0,30,18
1683321778585,SOCI 184,A00,258912,Staff,25,0,30,5
1683321779607,SOCI 188D,A00,258913,Staff,21,0,30,9
1683321780635,SYN 2,001,187529,Staff,9,0,16,7
1683321780635,SYN 2,002,201452,Staff,0,18,16,16
1683321780635,SYN 2,003,201469,Staff,4,0,16,12
1683321781665,SYN 100,A01,187531,Staff,0,9,20,20
1683321781665,SYN 100,B01,201491,Staff,0,12,20,20
1683321782693,TDAC 1,A00,189286,Walsh; Kim C.,3,0,20,17
1683321782693,TDAC 1,B00,189287,Harting; Carla Kelso,11,0,20,9
1683321783717,TDAC 101,A00,189300,Walsh; Kim C.,16,0,20,4
1683321783717,TDAC 101,B00,189301,Harting; Carla Kelso,18,0,20,2
1683321784744,TDAC 102,A00,189304,Basso; Beatrice,14,0,20,6
1683321785768,TDAC 108,A00,189305,Staff,18,0,20,2
1683321786797,TDDE 131,A00,189310,Staff,19,0,20,1
1683321786797,TDDE 131,B00,189314,Staff,19,0,20,1
1683321786797,TDDE 131,C00,189315,Staff,48,0,50,2
1683321786797,TDDE 131,D00,189316,Staff,14,0,15,1
1683321786797,TDDE 131,E00,204841,Staff,20,0,20,0
1683321787822,TDGE 10,A00,189289,Staff,30,0,50,20
1683321787822,TDGE 10,B00,189290,Havis; Allan,1,0,50,49
1683321788848,TDGE 11,A00,189291,Fulton; Julia,0,3,50,50
1683321788848,TDGE 11,B00,189292,Staff,20,0,25,5
1683321788848,TDGE 11,C00,260270,Staff,0,0,0,0
1683321789872,TDGE 25,A00,189294,Staff,3,0,20,17
1683321790898,TDGE 124,A00,189318,Fulton; Julia,0,8,50,50
1683321791924,TDGE 125,A00,189319,Staff,13,0,25,12
1683321791924,TDGE 125,B00,189320,Staff,23,0,25,2
1683321792951,TDGE 127,A00,189322,Havis; Allan,0,0,50,50
1683321793976,TDHT 101,A00,189323,Staff,18,0,25,7
1683321793976,TDHT 101,B00,189324,Staff,25,0,25,0
1683321795004,TDHT 102,A00,189325,Staff,49,0,50,1
1683321796029,TDMV 1,A00,189295,Arcidiacono; Kristin,19,0,30,11
1683321796029,TDMV 1,B00,189296,Caligagan; Maria T.,24,0,30,6
1683321797059,TDMV 2,A00,189297,Sammartano; Tonnie,28,0,30,2
1683321797059,TDMV 2,B00,189299,Arcidiacono; Kristin,24,0,30,6
1683321798083,TDMV 3,A00,204998,Rincon; Alicia,22,0,30,8
1683321799109,TDMV 120,A00,189458,Sammartano; Tonnie,28,0,30,2
1683321800136,TDMV 138,A00,189541,Jun; Grace Shin Hae,22,0,40,18
1683321801167,TDMV 142,A00,189717,Caligagan; Tony,23,0,30,7
1683321801167,TDMV 142,B00,189718,Caligagan; Maria T.,25,0,30,5
1683321802191,TMC 2,A01,187533,Staff,25,0,25,0
1683321802191,TMC 2,A02,187534,Staff,25,0,25,0
1683321803218,USP 1,A01,187536,Kwak; Nancy,0,16,25,25
1683321804241,USP 5,A01,187538,Staff,9,0,25,16
1683321805267,USP 101,A00,199253,Staff,0,4,0,0
1683321806292,USP 124,A00,187562,Boomhower; Matthew Charles,1,0,30,29
1683321807317,USP 138,A00,187582,Staff,20,0,25,5
1683321808339,USP 152,A01,187597,Staff,4,0,25,21
1683321809367,USP 153,A00,187598,Staff,19,0,25,6
1683321810391,USP 168,A00,187607,Kwak; Nancy,2,0,5,3
1683321811414,USP 173,A00,187619,Staff,4,0,25,21
1683321812438,USP 181,A00,187638,Staff,0,0,25,25
1683321813466,VIS 103,A00,187650,Cruz; Edwin Teddy,23,0,75,52
1683321814489,VIS 110D,A00,187669,Staff,12,0,22,10
1683321815513,VIS 127C,A00,187720,Shen; Kuiyi,68,0,146,78
1683321816540,VIS 149,A00,187731,Yoldas; Pinar,0,14,22,22
1683321817565,VIS 151,A01,188091,Staff,22,0,34,12
1683321817565,VIS 151,A02,188092,Staff,11,0,34,23
1683321818589,VIS 160B,A00,188093,Stalbaum; Brett,0,0,10,10
1683321820639,WCWP 10B,A00,201720,Staff,10,0,15,5
1683321820639,WCWP 10B,B00,201722,Staff,8,0,15,7
1683321821663,WCWP 100,A00,201725,Gagnon; Jeffrey C,0,0,2,2
1683321821663,WCWP 100,B00,201727,Staff,0,4,15,15
1683321824753,ANBI 133,A00,258401,Wilder; Linnea Lorene,34,0,40,6
1683321825780,ANBI 140,A00,258395,Hrvoj Mihic; Branka,18,0,25,7
1683321826804,ANSC 120,A00,258402,Bialecki; Jon Anthony,27,0,40,13
1683321827828,ANSC 144,A00,258400,Staff,14,0,40,26
1683321829881,ANSC 166,A00,258396,Parish; Steven Martin,157,0,175,18
1683321830908,ANSC 180,A00,193533,Staff,9,0,20,11
1683321831935,ANSC 188,A00,258397,Jassal; Aftab,33,0,40,7
1683321832959,ANTH 3,A01,258316,Staff,23,0,30,7
1683321833984,ANTH 5,A00,258394,Semendeferi; Ekaterini,16,0,20,4
1683321835007,ANTH 21,A01,258331,Staff,9,0,40,31
1683321836031,ANTH 103,A00,258398,Varma; Saiba,15,0,25,10
1683321837058,AWP 10,001,202034,Staff,0,0,0,0
1683321837058,AWP 10,002,202035,Staff,0,0,0,0
1683321837058,AWP 10,003,202036,Staff,0,0,0,0
1683321837058,AWP 10,004,202037,Staff,0,0,0,0
1683321837058,AWP 10,005,202038,Staff,0,0,0,0
1683321837058,AWP 10,006,202039,Staff,0,0,0,0
1683321837058,AWP 10,007,202040,Staff,0,0,0,0
1683321837058,AWP 10,008,202041,Staff,0,0,0,0
1683321837058,AWP 10,009,202042,Staff,0,0,0,0
1683321837058,AWP 10,010,202043,Staff,0,0,0,0
1683321837058,AWP 10,011,202044,Staff,0,0,0,0
1683321837058,AWP 10,012,202045,Staff,0,0,0,0
1683321837058,AWP 10,013,202046,Staff,0,0,0,0
1683321837058,AWP 10,014,202047,Staff,0,0,0,0
1683321837058,AWP 10,015,202048,Staff,0,0,0,0
1683321837058,AWP 10,016,202049,Staff,0,0,0,0
1683321837058,AWP 10,017,202050,Staff,0,0,0,0
1683321837058,AWP 10,018,202051,Staff,0,0,0,0
1683321837058,AWP 10,019,202052,Staff,0,0,0,0
1683321837058,AWP 10,020,202053,Staff,0,0,0,0
1683321837058,AWP 10,021,202054,Staff,0,0,0,0
1683321837058,AWP 10,022,202055,Staff,0,0,0,0
1683321837058,AWP 10,023,202056,Staff,0,0,0,0
1683321837058,AWP 10,024,202057,Staff,0,0,0,0
1683321837058,AWP 10,025,202058,Staff,0,0,0,0
1683321837058,AWP 10,026,202059,Staff,0,0,0,0
1683321838081,AWP 102,001,202032,Staff,0,0,0,0
1683321838081,AWP 102,002,202033,Staff,0,0,0,0
1683321839109,BENG 100,A01,254234,Taylor Amos; Alyssa C,31,0,40,9
1683321840138,BENG 196,001,270013,Engler; Adam J.,9999,0,9999,0
1683321841160,BICD 100R,A01,202018,Smith; Laurie,0,7,32,32
1683321841160,BICD 100R,A02,202019,Smith; Laurie,0,2,32,32
1683321841160,BICD 100R,A03,202020,Smith; Laurie,0,1,32,32
1683321841160,BICD 100R,A04,202021,Smith; Laurie,8,0,32,24
1683321841160,BICD 100R,A05,202022,Smith; Laurie,12,0,32,20
1683321842189,BICD 136,A01,193242,Gustafson-Brown; Cindy,0,2,32,32
1683321842189,BICD 136,A02,193244,Gustafson-Brown; Cindy,14,0,32,18
1683321843219,BIEB 102,A01,193249,Butler; Shannon Rhey,0,2,32,32
1683321843219,BIEB 102,A02,193251,Butler; Shannon Rhey,0,0,32,32
1683321843219,BIEB 102,A03,193253,Butler; Shannon Rhey,0,1,32,32
1683321843219,BIEB 102,A04,193255,Butler; Shannon Rhey,17,0,32,15
1683321843219,BIEB 102,A05,193265,Butler; Shannon Rhey,26,0,32,6
1683321843219,BIEB 102,A06,193269,Butler; Shannon Rhey,16,0,32,16
1683321845273,BIEB 150,A01,193274,Staff,0,0,32,32
1683321845273,BIEB 150,A02,193285,Staff,23,0,32,9
1683321846300,BIEB 194,A00,193286,Kurle; Carolyn M.,22,0,32,10
1683321847324,BILD 1,A01,192291,Staff,16,0,32,16
1683321847324,BILD 1,A02,192292,Staff,30,0,32,2
1683321847324,BILD 1,B01,192520,Reuther; Keefe,0,1,0,0
1683321847324,BILD 1,B02,192532,Reuther; Keefe,0,1,0,0
1683321848361,BILD 3,A01,192556,Butler; Shannon Rhey,0,0,32,32
1683321848361,BILD 3,A02,192581,Butler; Shannon Rhey,5,0,32,27
1683321848361,BILD 3,A03,192611,Butler; Shannon Rhey,23,0,32,9
1683321848361,BILD 3,A04,192612,Butler; Shannon Rhey,25,0,32,7
1683321848361,BILD 3,A05,192613,Butler; Shannon Rhey,27,0,32,5
1683321848361,BILD 3,A06,192679,Butler; Shannon Rhey,27,0,32,5
1683321848361,BILD 3,A07,192682,Butler; Shannon Rhey,22,0,32,10
1683321849386,BILD 4,A01,192836,Reuther; Keefe,0,0,24,24
1683321849386,BILD 4,A02,193044,Reuther; Keefe,4,0,24,20
1683321850414,BILD 10,A01,193142,Gustafson-Brown; Cindy,30,0,32,2
1683321850414,BILD 10,A02,193149,Gustafson-Brown; Cindy,31,0,32,1
1683321851440,BIMM 100,A01,193301,Staff,0,6,32,32
1683321851440,BIMM 100,A02,193312,Staff,0,5,32,32
1683321851440,BIMM 100,A03,193323,Staff,0,8,32,32
1683321852473,BIMM 101,A01,193329,McDonnell; Lisa Marie,0,3,24,24
1683321852473,BIMM 101,A02,193339,McDonnell; Lisa Marie,0,3,24,24
1683321852473,BIMM 101,B01,193354,McDonnell; Lisa Marie,0,3,24,24
1683321852473,BIMM 101,B02,193357,McDonnell; Lisa Marie,0,3,24,24
1683321853501,BIMM 110,A01,193377,Tat; John,0,11,32,32
1683321853501,BIMM 110,A02,193378,Tat; John,1,9,32,31
1683321854525,BIMM 120,A01,206116,Staff,0,0,32,32
1683321854525,BIMM 120,A02,206117,Staff,8,0,32,24
1683321854525,BIMM 120,A03,206121,Staff,21,0,32,11
1683321855554,BIPN 100,A01,193393,Park; Ji Young,0,14,32,32
1683321855554,BIPN 100,A02,193402,Park; Ji Young,0,12,32,32
1683321855554,BIPN 100,A03,193413,Park; Ji Young,0,14,32,32
1683321855554,BIPN 100,A04,193414,Park; Ji Young,0,13,32,32
1683321856579,BIPN 102,A01,193429,Staff,0,0,32,32
1683321856579,BIPN 102,A02,193438,Staff,22,0,32,10
1683321857603,BIPN 106,A01,193450,Reyes Gonzalez; Catalina,0,2,40,40
1683321858626,BIPN 134,A01,193465,Cooke; James Edward,0,0,32,32
1683321858626,BIPN 134,A02,193474,Cooke; James Edward,25,0,32,7
1683321858626,BIPN 134,A03,193485,Cooke; James Edward,29,0,32,3
1683321858626,BIPN 134,A04,193486,Cooke; James Edward,21,0,32,11
1683321858626,BIPN 134,A05,193491,Cooke; James Edward,31,0,32,1
1683321858626,BIPN 134,A06,193501,Cooke; James Edward,30,0,32,2
1683321858626,BIPN 134,A07,193510,Cooke; James Edward,29,0,32,3
1683321860675,BISP 194,A00,222522,Staff,15,0,32,17
1683321861700,CAT 124,A01,202407,Staff,20,0,25,5
1683321862730,CAT 125,A00,202408,Marchisotto; Jennifer Anne,4,0,20,16
1683321863755,CAT 125R,A00,202409,Smith; Lauryn Alissa,0,11,20,20
1683321863755,CAT 125R,B00,202410,Morales; Celeste Georgianna,0,11,20,20
1683321863755,CAT 125R,C00,202411,Irwin; Matthew Joseph,0,10,20,20
1683321864782,CENG 15,A01,204712,Yang; Kesong,0,1,0,0
1683321865810,CENG 114,A00,202070,Jahed Motlagh; Zeinab,5,0,20,15
1683321866842,CGS 105,A00,185477,Wesling; Megan E.,24,0,40,16
1683321867868,CGS 106,A00,185494,Staff,13,0,22,9
1683321868892,CGS 108,A00,185495,Staff,14,0,20,6
1683321869921,CGS 114,A00,185496,Staff,13,0,18,5
1683321870948,CGS 119,A00,185501,Staff,15,0,20,5
1683321871975,CGS 120,A00,185511,Staff,13,0,20,7
1683321873000,CHEM 4,A01,184675,Bussey; Thomas J,96,0,100,4
1683321874026,CHEM 6A,A01,184677,Staff,34,0,60,26
1683321875050,CHEM 6B,A01,184679,Staff,65,0,100,35
1683321876078,CHEM 6C,A01,184681,Bussey; Thomas J,1,0,50,49
1683321876078,CHEM 6C,A02,184682,Bussey; Thomas J,34,0,50,16
1683321877104,CHEM 40A,A01,184684,Albizati; Kim F.,37,0,100,63
1683321878130,CHEM 40B,A01,184686,Albizati; Kim F.,0,20,100,100
1683321879157,CHEM 41B,A01,184690,Staff,52,0,100,48
1683321880183,COGS 3,A01,184715,Boyle; Mary E. T.,0,25,40,40
1683321881210,COGS 14B,A01,185172,Staff,0,15,38,38
1683321882295,COGS 18,A01,184736,Staff,18,0,80,62
1683321883321,COGS 100,A01,184932,Staff,0,5,73,73
1683321884351,COGS 101A,A01,184935,Staff,0,38,30,30
1683321885378,COGS 101B,A01,184944,Staff,0,2,30,30
1683321886405,COGS 101C,A01,184946,Staff,0,12,30,30
1683321887431,COGS 102A,A01,184951,Johnson; Christine M.,2,0,40,38
1683321888456,COGS 107B,A01,184953,Mooshagian; Eric Frederick,0,50,40,40
1683321889484,COGS 118B,A01,184959,Gupta; Anjum,0,48,40,40
1683321890515,COGS 153,A00,184961,Staff,0,15,30,30
1683321891541,COGS 177,A00,184962,Staff,0,21,30,30
1683321892570,COGS 187A,A01,184969,Boyle; Mary E. T.,0,17,40,40
1683321893597,COMM 10,A01,185174,Staff,0,5,25,25
1683321893597,COMM 10,A02,185189,Staff,0,5,25,25
1683321893597,COMM 10,A03,269821,Staff,0,0,0,0
1683321894623,COMM 100B,A01,185475,Staff,0,0,0,2
1683321894623,COMM 100B,A02,185476,Staff,14,0,25,11
1683321895650,COMM 100C,A01,185314,Staff,1,0,25,24
1683321895650,COMM 100C,A02,185327,Staff,19,0,25,6
1683321896676,COMM 110M,A00,185349,Staff,2,0,40,38
1683321897705,COMM 113T,A00,185352,Staff,25,0,40,15
1683321898728,COMM 114I,A00,185353,Staff,33,0,40,7
1683321899752,COMM 131,A00,185354,Staff,19,0,30,11
1683321900776,CSE 8A,A50,185358,Cao; Yingjun,0,46,10,10
1683321901806,CSE 8B,A01,185362,Staff,1,47,50,49
1683321902833,CSE 11,A01,185416,Cao; Yingjun,0,92,10,10
1683321903864,CSE 20,A01,185445,Briones; Jor-el Thomas Caparas,5,0,25,20
1683321904892,CSE 21,A01,185447,Staff,10,0,50,40
1683321905918,CSE 101,A01,185451,Staff,0,12,50,50
1683321905918,CSE 101,B01,185453,Jones; Miles E,0,11,50,50
1683321907964,CSE 141,A01,185458,Eldon; John,20,0,100,80
1683321908990,CSE 141L,A01,185461,Eldon; John,12,0,100,88
1683321910015,CSE 142,A01,185463,Staff,36,0,60,24
1683321910015,CSE 142,B01,201355,Staff,0,7,60,60
1683321911042,CSE 142L,A01,185470,Staff,36,0,60,24
1683321911042,CSE 142L,B01,201417,Staff,0,6,60,60
1683321912069,CSE 190,A00,201433,Staff,32,0,49,17
1683321913095,DOC 1,A01,259136,Strom; Megan C.,7,0,15,8
1683321913095,DOC 1,A02,259137,Strom; Megan C.,14,0,15,1
1683321913095,DOC 1,A03,259138,Strom; Megan C.,14,0,15,1
1683321913095,DOC 1,A04,259139,Strom; Megan C.,14,0,15,1
1683321914121,DOC 100D,A00,259140,Pass; Natalye Joann,17,0,25,8
1683321915148,DSGN 1,A01,184749,Rill; Bryan,0,25,30,30
1683321916174,DSGN 100,A01,185168,Staff,0,2,25,25
1683321917199,ECE 5,A01,185626,Morris; Karcher William,0,10,0,0
1683321918227,ECE 101,A01,185628,Staff,17,0,70,53
1683321919251,ECE 107,A01,185635,Baghdadchi; Saharnaz,0,0,20,20
1683321919251,ECE 107,A02,185638,Baghdadchi; Saharnaz,4,0,20,16
1683321920331,ECE 148,A01,185647,Silberman; Jack,0,0,16,16
1683321921356,ECON 1,A01,185537,Crane; Meredith Helen,54,0,70,16
1683321922379,ECON 3,A01,185549,Crane; Meredith Helen,33,0,70,37
1683321923407,ECON 4,A01,203354,Anderson; John Charles,0,4,10,10
1683321924433,ECON 100A,A01,185574,Staff,0,4,40,40
1683321925457,ECON 100B,A01,185576,Staff,0,22,40,40
1683321926481,ECON 100C,A01,185589,Newhouse; Herbert S,30,0,70,40
1683321927505,ECON 105,A00,185608,Vespa; Emanuel Ignacio,19,0,35,16
1683321928532,ECON 109,A01,185610,Shishkin; Denis,10,0,35,25
1683321929559,ECON 110A,A01,185612,Staff,11,0,40,29
1683321930585,ECON 120A,A01,185615,Staff,20,0,40,20
1683321931615,ECON 120C,A01,185617,Sun; Yixiao,0,20,70,70
1683321932638,ECON 144,A00,203346,Squires; Dale E,3,0,35,32
1683321933662,ECON 171,A01,203349,Newhouse; Herbert S,0,1,35,35
1683321934687,ECON 173A,A01,185621,Toda; Alexis Akira,21,0,35,14
1683321935719,EDS 25,A01,202413,Staff,0,1,0,0
1683321935719,EDS 25,A02,202414,Staff,0,1,0,0
1683321935719,EDS 25,A03,202415,Staff,0,0,0,0
1683321935719,EDS 25,A04,202416,Staff,0,1,0,0
1683321935719,EDS 25,A05,202439,Staff,0,0,0,0
1683321935719,EDS 25,A06,202440,Staff,0,0,0,0
1683321935719,EDS 25,B01,202631,Staff,0,0,0,0
1683321935719,EDS 25,B02,202632,Staff,0,0,0,0
1683321935719,EDS 25,B03,202639,Staff,0,0,0,0
1683321935719,EDS 25,B04,202640,Staff,0,0,0,0
1683321935719,EDS 25,B05,202643,Staff,0,0,0,0
1683321935719,EDS 25,B06,202644,Staff,0,0,0,0
1683321936746,EDS 38,A01,202659,Black; Alison Michelle,24,0,25,1
1683321937774,EDS 115,A00,202652,Staff,17,0,30,13
1683321938799,EDS 125,A00,202649,Staff,14,0,30,16
1683321939823,EDS 126,A01,203332,Staff,30,0,30,0
1683321940847,EDS 139,A00,202838,Staff,16,0,25,9
1683321941871,EDS 146,A01,202655,Staff,14,0,25,11
1683321942896,ENG 15,A00,185667,Staff,0,1,0,0
1683321942896,ENG 15,B00,185672,Staff,0,0,0,0
1683321942896,ENG 15,C00,185675,Staff,0,0,0,0
1683321942896,ENG 15,D00,185682,Staff,0,0,0,0
1683321942896,ENG 15,E00,185684,Staff,0,0,0,0
1683321943920,ETHN 103,A00,185710,Staff,0,3,35,35
1683321944946,ETHN 103A,A00,199228,Man; Simeon S,2,0,9,7
1683321945969,ETHN 109,A00,185711,Staff,18,0,35,17
1683321946996,ETHN 142,A00,185726,Staff,0,4,30,30
1683321948020,ETHN 163J,A00,199229,Man; Simeon S,5,0,8,3
1683321949049,ETHN 168,A00,185727,Staff,8,0,10,2
1683321950075,ETHN 182,A00,185728,Staff,1,0,35,34
1683321951100,ETHN 183,A00,185737,Staff,8,0,18,10
1683321952126,GLBH 111,A01,209361,Burgos; Jose L.,0,0,0,0
1683321954181,HIEU 104,A00,185792,Staff,16,0,20,4
1683321955207,HIEU 115,A00,185800,Staff,1,0,20,19
1683321956234,HIEU 128,A00,185801,Staff,0,7,20,20
1683321957257,HIEU 147,A00,185802,Staff,16,0,20,4
1683321958282,HIEU 154,A00,185823,Staff,12,0,20,8
1683321959309,HILA 102,A00,185826,Staff,13,0,20,7
1683321960341,HILD 2C,A01,185778,Staff,0,12,20,20
1683321961365,HILD 7B,A01,185780,Kwak; Nancy,0,15,32,32
1683321961365,HILD 7B,A02,185781,Kwak; Nancy,0,18,32,32
1683321962392,HILD 30,A01,185791,Staff,14,0,20,6
1683321963420,HISC 119,A00,185830,Golan; Tal,0,9,20,20
1683321964443,HITO 156GS,A00,185831,Patterson; Patrick H.,0,0,0,23
1683321965471,HIUS 103,A00,185832,Man; Simeon S,0,6,20,20
1683321966498,HIUS 117,A00,185836,Kwak; Nancy,2,0,20,18
1683321967523,HIUS 125,A00,185840,Man; Simeon S,0,0,23,23
1683321968552,HIUS 149,A00,185845,Staff,0,0,20,20
1683321969581,HUM 3,A01,185882,Zavodny; Tatiana Sophia,0,6,50,50
1683321969581,HUM 3,B01,185899,Caldwell; Michael Alan,0,19,50,50
1683321970606,HUM 3GS,A00,185900,Patterson; Patrick H.,0,0,0,23
1683321971631,HUM 4,A01,185938,Zroka; Amy Liane,31,0,50,19
1683321971631,HUM 4,B01,185956,Watkins; Eric,0,2,50,50
1683321971631,HUM 4,B02,202209,Watkins; Eric,0,2,50,50
1683321971631,HUM 4,B03,202210,Watkins; Eric,0,0,50,50
1683321972656,HUM 5,A01,185958,West; Geoffrey Scott,3,0,50,47
1683321972656,HUM 5,A02,202215,West; Geoffrey Scott,0,0,50,50
1683321973681,INTL 190,A00,185959,Gagnon; Jeffrey C,0,0,0,9
1683321973681,INTL 190,B00,185960,Lettieri; Michael Joseph,0,0,0,1
1683321974705,JAPN 180,A00,254509,Staff,5,1,30,25
1683321975730,LATI 10,A01,202853,Kennemore; Amy Michelle,5,0,35,30
1683321975730,LATI 10,A02,202854,Kennemore; Amy Michelle,1,0,35,34
1683321975730,LATI 10,A03,270054,Kennemore; Amy Michelle,30,0,30,0
1683321976753,LATI 180,A00,202855,Kennemore; Amy Michelle,11,0,20,9
1683321977776,LAWS 101,A00,201767,Golan; Tal,0,7,40,40
1683321978800,LIFR 1C,A00,185961,Staff,6,0,20,14
1683321979824,LIFR 1CX,A00,185962,Staff,7,0,20,13
1683321980848,LIFR 1D,A00,185963,Staff,9,0,20,11
1683321981873,LIFR 1DX,A00,185964,Staff,9,0,20,11
1683321982899,LIGN 101,A01,186039,Staff,43,0,50,7
1683321983922,LIGN 165,A00,186040,Staff,18,0,50,32
1683321984950,LTCS 108,A00,186041,Staff,6,0,10,4
1683321986032,LTCS 119,A00,186042,Staff,16,0,20,4
1683321987060,LTCS 130,A00,186043,Wesling; Megan E.,15,0,25,10
1683321989106,LTEA 138,A00,186119,Staff,14,0,40,26
1683321990132,LTEN 124,A00,186148,Staff,6,0,25,19
1683321991155,LTEN 178,A00,186149,Staff,7,0,15,8
1683321992180,LTEN 181,A00,186150,Blanco; John D,33,0,40,7
1683321993202,LTWL 120,A00,186160,Staff,20,0,25,5
1683321994228,LTWL 165,A00,186161,Staff,22,0,25,3
1683321995252,LTWR 100,A00,186162,Staff,0,5,15,15
1683321996279,LTWR 102,A00,186163,Doller; Ben,5,0,15,10
1683321997303,MAE 8,A01,186412,Staff,0,0,0,0
1683321998328,MAE 30B,A00,186445,Bahadori; Mohammad Yousef,83,0,100,17
1683321999353,MAE 40,A00,186592,Bewley; Thomas R,9,0,50,41
1683322000377,MAE 101B,A00,186593,Bahadori; Mohammad Yousef,81,0,100,19
1683322001404,MAE 105,A00,186594,Bandaru; Prabhakar,12,0,50,38
1683322002429,MAE 107,A00,186599,Pham; Hieu Tan,0,6,120,120
1683322003453,MAE 148,A01,186660,Silberman; Jack,3,0,16,13
1683322004477,MATH 10A,A01,188095,Staff,0,6,35,35
1683322005503,MATH 10B,A01,188097,Bowers; Adam R.,0,11,30,30
1683322005503,MATH 10B,A02,188099,Bowers; Adam R.,0,11,30,30
1683322005503,MATH 10B,B01,188104,Bowers; Adam R.,0,10,30,30
1683322005503,MATH 10B,B02,188106,Bowers; Adam R.,0,10,30,30
1683322006527,MATH 10C,A01,188111,Staff,0,18,30,30
1683322006527,MATH 10C,A02,188127,Staff,0,17,30,30
1683322006527,MATH 10C,A03,188131,Staff,0,18,30,30
1683322006527,MATH 10C,B01,188218,Staff,18,0,30,12
1683322006527,MATH 10C,B02,188244,Staff,13,0,30,17
1683322006527,MATH 10C,B03,188277,Staff,16,0,30,14
1683322007552,MATH 18,A01,188344,Bach; Quang Tran,18,0,30,12
1683322007552,MATH 18,A02,188345,Bach; Quang Tran,11,0,30,19
1683322007552,MATH 18,B01,188353,Bach; Quang Tran,10,0,30,20
1683322007552,MATH 18,B02,188354,Bach; Quang Tran,20,0,30,10
1683322008579,MATH 20A,A01,188374,Staff,13,0,35,22
1683322009605,MATH 20B,A01,188382,Ohm; Ko Woon,6,0,30,24
1683322009605,MATH 20B,A02,188383,Ohm; Ko Woon,23,0,30,7
1683322009605,MATH 20B,B01,188385,Ohm; Ko Woon,7,0,30,23
1683322009605,MATH 20B,B02,188392,Ohm; Ko Woon,22,0,30,8
1683322010629,MATH 20C,A01,188394,Harel; Guershon,10,0,30,20
1683322010629,MATH 20C,A02,188395,Harel; Guershon,14,0,30,16
1683322010629,MATH 20C,B01,188404,Harel; Guershon,5,0,30,25
1683322010629,MATH 20C,B02,188405,Harel; Guershon,19,0,30,11
1683322011658,MATH 20D,A01,188414,Hammock; Frances H,0,1,30,30
1683322011658,MATH 20D,A02,188415,Hammock; Frances H,3,0,30,27
1683322011658,MATH 20D,B01,188447,Hammock; Frances H,2,0,30,28
1683322011658,MATH 20D,B02,188486,Hammock; Frances H,8,0,30,22
1683322012682,MATH 20E,A01,188649,Staff,21,0,30,9
1683322012682,MATH 20E,A02,188650,Staff,23,0,30,7
1683322012682,MATH 20E,A03,188673,Staff,0,0,30,30
1683322013709,MATH 102,A01,188675,Staff,0,35,35,35
1683322014734,MATH 103B,A01,188681,Staff,4,0,35,31
1683322014734,MATH 103B,B01,188692,Staff,5,0,35,30
1683322015759,MATH 109,A01,188695,Salehi Golsefidy; Alireza,25,0,35,10
1683322015759,MATH 109,A02,188696,Salehi Golsefidy; Alireza,26,0,35,9
1683322016784,MATH 120A,A01,188698,Eggers; John Dietrich,7,0,35,28
1683322017813,MATH 142B,A01,188736,Ioana; Adrian,0,2,30,30
1683322017813,MATH 142B,A02,188741,Ioana; Adrian,0,1,30,30
1683322017813,MATH 142B,A03,188743,Ioana; Adrian,1,3,30,29
1683322018841,MATH 168A,A01,188790,Staff,0,9,35,35
1683322019867,MATH 170A,A01,188803,Nie; Jiawang,0,2,35,35
1683322019867,MATH 170A,A02,188811,Nie; Jiawang,0,0,35,35
1683322019867,MATH 170A,A03,188814,Nie; Jiawang,0,0,35,35
1683322019867,MATH 170A,A04,188815,Nie; Jiawang,13,0,35,22
1683322020891,MATH 193B,A01,188817,Staff,0,0,35,35
1683322020891,MATH 193B,A02,188818,Staff,6,0,35,29
1683322021915,MGT 4,A01,202857,Anderson; John Charles,62,0,80,18
1683322022940,MGT 12,A00,202858,Lindenberger; Wade Douglas,42,0,90,48
1683322023963,MGT 18,A00,202859,Staff,74,0,90,16
1683322024989,MGT 18GS,A00,202860,McKay; Michael J,13,0,28,15
1683322026014,MGT 45,A00,202861,Pecore; Joseph P.,13,0,90,77
1683322027038,MGT 100,A00,202863,Yavorsky; Daniel Ryan,28,0,90,62
1683322028063,MGT 103,A00,202864,Ehrich; Kristine R,0,18,90,90
1683322029087,MGT 112,A00,202865,Ehrich; Kristine R,15,0,90,75
1683322030115,MGT 121A,A00,202868,Staff,0,20,0,0
1683322031140,MGT 131B,A00,202869,Anderson; John Charles,59,0,90,31
1683322032168,MGT 136,A00,202871,Lindenberger; Wade Douglas,84,0,90,6
1683322033198,MGT 164,A00,202873,Staff,0,68,90,91
1683322034221,MGT 164GS,A00,202874,McKay; Mary A,13,0,28,15
1683322035249,MGT 180,A00,202875,Staff,0,50,90,91
1683322036276,MMW 11R,A01,205019,Herbst; Matthew,3,0,30,27
1683322036276,MMW 11R,A02,205026,Herbst; Matthew,29,0,30,1
1683322037305,MMW 15,A01,193512,Chang; Edmond Yi-Teh,0,9,28,28
1683322037305,MMW 15,A02,193513,Chang; Edmond Yi-Teh,0,5,28,28
1683322037305,MMW 15,A03,193514,Chang; Edmond Yi-Teh,0,5,28,28
1683322037305,MMW 15,A04,193515,Chang; Edmond Yi-Teh,0,5,28,28
1683322037305,MMW 15,A05,193516,Chang; Edmond Yi-Teh,0,4,28,28
1683322037305,MMW 15,A06,193517,Chang; Edmond Yi-Teh,0,5,28,28
1683322037305,MMW 15,B01,193519,Chang; Edmond Yi-Teh,0,4,28,28
1683322037305,MMW 15,B02,193520,Chang; Edmond Yi-Teh,0,5,28,28
1683322037305,MMW 15,B03,193521,Chang; Edmond Yi-Teh,0,4,28,28
1683322037305,MMW 15,B04,193522,Chang; Edmond Yi-Teh,0,4,28,28
1683322037305,MMW 15,B05,193523,Chang; Edmond Yi-Teh,0,5,28,28
1683322037305,MMW 15,B06,193524,Chang; Edmond Yi-Teh,0,4,28,28
1683322038329,MMW 122,A01,193526,Rahimi; Babak,0,15,28,28
1683322038329,MMW 122,A02,193527,Rahimi; Babak,0,14,28,28
1683322038329,MMW 122,A03,193528,Rahimi; Babak,0,0,0,0
1683322038329,MMW 122,A04,193529,Rahimi; Babak,0,0,0,0
1683322039357,MUS 1A,A01,186663,Staff,0,20,35,35
1683322040381,MUS 4,A01,186715,Staff,0,12,35,35
1683322041405,MUS 5R,A01,186796,Dubnov; Shlomo,0,17,35,35
1683322042429,MUS 6,A01,186798,Staff,0,3,25,25
1683322043454,MUS 7,A01,186830,Staff,12,0,35,23
1683322044480,MUS 8,A01,186930,Staff,0,26,35,35
1683322045505,MUS 15,A01,186932,Staff,0,16,35,35
1683322045505,MUS 15,B01,186934,Staff,0,15,35,35
1683322046538,MUS 80,A00,186935,Staff,2,0,20,18
1683322046538,MUS 80,B00,186936,Staff,25,0,25,0
1683322047562,NANO 11,A00,204702,Lipomi; Darren John,0,0,0,0
1683322048587,NANO 15,A01,204709,Yang; Kesong,0,1,0,0
1683322049612,NANO 114,A00,202069,Jahed Motlagh; Zeinab,3,0,10,7
1683322050636,PHIL 1,A00,186955,Grush; Rick Scott,32,0,40,8
1683322051660,PHIL 10,A01,186973,Grush; Rick Scott,28,0,35,7
1683322051660,PHIL 10,A02,186974,Grush; Rick Scott,33,0,35,2
1683322052686,PHIL 13,A01,186976,Staff,7,0,35,28
1683322052686,PHIL 13,A02,186977,Staff,16,0,35,19
1683322053713,PHIL 14,A01,186979,Staff,31,0,35,4
1683322053713,PHIL 14,A02,186986,Staff,32,0,35,3
1683322054741,PHIL 28,A01,186988,Staff,16,0,30,14
1683322054741,PHIL 28,A02,186989,Staff,1,0,30,29
1683322054741,PHIL 28,A03,186990,Staff,9,0,30,21
1683322054741,PHIL 28,A04,186991,Staff,26,0,30,4
1683322055765,PHIL 120,A00,186997,Staff,23,0,40,17
1683322056793,PHIL 137,A00,187003,Staff,9,0,40,31
1683322057817,PHIL 150,A00,187015,Staff,47,0,70,23
1683322058841,PHIL 167,A00,187021,Lamey; Andy M.,35,0,40,5
1683322059869,PHIL 174,A01,202226,Staff,17,0,20,3
1683322059869,PHIL 174,A02,202235,Staff,20,0,20,0
1683322060894,PHIL 191A,A00,258918,Staff,0,0,1,1
1683322061918,PHYS 1A,A00,187028,Staff,27,0,60,33
1683322062943,PHYS 1AL,001,187036,Staff,3,0,30,27
1683322062943,PHYS 1AL,002,187049,Staff,18,0,30,12
1683322063967,PHYS 1B,A00,187058,Staff,22,0,60,38
1683322064992,PHYS 1BL,001,187064,Staff,0,0,30,30
1683322064992,PHYS 1BL,002,187070,Staff,5,0,30,25
1683322066016,PHYS 1C,A00,187082,Staff,31,0,120,89
1683322067046,PHYS 1CL,001,187088,Staff,0,9,30,30
1683322067046,PHYS 1CL,002,187089,Staff,0,2,30,30
1683322067046,PHYS 1CL,009,262693,Staff,11,0,30,19
1683322068073,PHYS 2B,A01,187097,Staff,54,0,115,61
1683322069100,PHYS 2C,A01,187099,Staff,67,0,115,48
1683322070148,PHYS 2CL,A01,187101,Staff,5,0,28,23
1683322070148,PHYS 2CL,A02,187102,Staff,15,0,28,13
1683322071175,PHYS 2D,A01,187123,Shotwell; Brian,95,0,115,20
1683322072203,PHYS 4B,A01,187133,Grinstein; Benjamin,35,0,50,15
1683322073227,POLI 10,A00,188819,Staff,0,4,50,50
1683322074255,POLI 11,A00,188827,Staff,43,0,50,7
1683322075279,POLI 13R,A00,188828,Staff,0,1,20,20
1683322076305,POLI 27,A01,188830,Elgin; Samuel Zincke,0,1,70,70
1683322077333,POLI 30,A00,188832,Desposato; Scott,31,0,50,19
1683322078355,POLI 102F,A00,188834,Staff,3,0,40,37
1683322079380,POLI 104A,A00,188852,Staff,14,0,30,16
1683322080408,POLI 104I,A00,188853,Staff,0,6,20,20
1683322081431,POLI 110B,A00,188854,Wiens; David,7,0,20,13
1683322082458,POLI 112A,A00,188855,Wiens; David,5,0,30,25
1683322083482,POLI 117R,A00,188856,Forman; Fonna,0,11,20,20
1683322084507,POLI 118,A00,188857,Ingham; Sean,8,0,20,12
1683322085530,POLI 120G,A00,188858,Staff,9,0,30,21
1683322086558,POLI 131CR,A00,188863,Hoston; Germaine,24,0,50,26
1683322087583,POLI 133,A00,188864,Nellis; Gareth Hb,44,0,50,6
1683322088608,POLI 134D,A00,188865,Desposato; Scott,27,0,30,3
1683322089693,POLI 142A,A00,188871,Gartzke; Erik,22,0,50,28
1683322090722,POLI 142K,A00,188874,Staff,38,0,50,12
1683322091750,POLI 143,A00,188940,Gartzke; Erik,16,0,30,14
1683322092778,POLI 153,A00,188943,Staff,3,0,20,17
1683322093804,POLI 160AA,A00,188944,Staff,12,0,40,28
1683322094829,POLI 170A,A00,188945,Staff,11,0,30,19
1683322096881,PSYC 1,A00,188952,Staff,37,0,90,53
1683322097907,PSYC 2,B00,188953,Staff,19,0,35,16
1683322098932,PSYC 6,A00,188970,Staff,47,0,60,13
1683322099956,PSYC 7,A00,188973,Staff,37,0,45,8
1683322100983,PSYC 60,A01,188980,Rickard; Timothy C.,43,0,60,17
1683322102012,PSYC 70,A01,189001,Steiner; Eric Tomas,24,0,45,21
1683322103037,PSYC 100,A00,189005,Lacefield; Katharine I,0,99,120,120
1683322104061,PSYC 102,A00,189008,Staff,10,0,30,20
1683322105089,PSYC 106,B00,189026,Gorman; Michael R.,35,0,60,25
1683322106113,PSYC 114,B01,189033,Winkielman; Piotr,0,32,30,30
1683322107138,PSYC 131,A00,189036,Anagnostaras; Stephan,0,43,60,60
1683322108162,PSYC 136,A00,189041,Lowe; Angela Beth,0,7,25,25
1683322109186,PSYC 137,A00,189057,Winkielman; Piotr,0,34,25,25
1683322110209,PSYC 144,A00,189107,Wixted; John T,0,7,50,50
1683322112261,PSYC 162,A00,189142,Staff,0,8,85,85
1683322113285,PSYC 172,A00,189144,Gorman; Michael R.,0,7,30,30
1683322115339,PSYC 179,A00,189146,Lacefield; Katharine I,0,84,120,120
1683322116366,PSYC 181,A00,189147,Anagnostaras; Stephan,0,44,90,90
1683322117391,PSYC 190R,A00,189148,Barner; David A.,0,22,80,80
1683322118419,PSYC 191,A00,189275,Rickard; Timothy C.,0,7,25,25
1683322119445,PSYC 193,A00,189276,Chapman; Eddie Nathaniel,0,1,0,4
1683322120470,PSYC 193L,A01,189281,Lowe; Angela Beth,12,0,20,8
1683322120470,PSYC 193L,B01,189285,Staff,28,0,35,7
1683322121494,RELI 149,A00,187137,Rahimi; Babak,7,0,40,33
1683322122518,SE 9,A01,187315,Staff,0,2,18,18
1683322123546,SE 101B,A00,187409,Staff,24,0,30,6
1683322124571,SE 110B,A00,187444,Staff,10,0,40,30
1683322125599,SE 130B,A00,187449,Staff,31,0,40,9
1683322126623,SE 150A,A00,187516,Staff,9,0,20,11
1683322127648,SE 154,A00,187528,Staff,30,0,50,20
1683322128676,SIO 3,A01,258171,Staff,35,0,40,5
1683322129700,SIO 10,A00,187144,Cook; Geoffrey W,0,3,75,75
1683322130727,SIO 45,A00,187152,Cook; Geoffrey W,1,0,100,99
1683322131752,SIO 109R,A00,194486,Staff,0,3,20,20
1683322133804,SIO 187,A01,187233,Kacev; David,12,0,40,28
1683322134829,SOCI 1,A01,258656,Thorpe; Charles Robert,28,0,30,2
1683322134829,SOCI 1,A02,258658,Thorpe; Charles Robert,30,0,30,0
1683322134829,SOCI 1,A03,258661,Thorpe; Charles Robert,25,0,25,0
1683322134829,SOCI 1,A04,258666,Thorpe; Charles Robert,22,0,25,3
1683322134829,SOCI 1,A05,258897,Thorpe; Charles Robert,23,0,25,2
1683322134829,SOCI 1,A06,258898,Thorpe; Charles Robert,25,0,25,0
1683322135857,SOCI 30,A01,258903,Pardo Guerra; Juan Pablo,16,0,30,14
1683322136884,SOCI 102,A00,258904,Staff,9,0,25,16
1683322137909,SOCI 106,A00,258905,Staff,19,0,25,6
1683322138934,SOCI 111,A00,258907,Ribas Norris; Janet Vanesa,26,0,30,4
1683322139962,SOCI 121R,A00,258908,Pardo Guerra; Juan Pablo,11,0,30,19
1683322140988,SOCI 126,A01,203330,Staff,14,0,20,6
1683322142013,SOCI 131,A00,258909,Thorpe; Charles Robert,31,0,60,29
1683322143038,SOCI 135,A00,258910,Payne; Christine Anna,0,9,30,30
1683322144062,SOCI 157,A00,258911,Staff,12,0,30,18
1683322145086,SOCI 184,A00,258912,Staff,25,0,30,5
1683322146110,SOCI 188D,A00,258913,Staff,21,0,30,9
1683322147135,SYN 2,001,187529,Staff,9,0,16,7
1683322147135,SYN 2,002,201452,Staff,0,18,16,16
1683322147135,SYN 2,003,201469,Staff,4,0,16,12
1683322148159,SYN 100,A01,187531,Staff,0,9,20,20
1683322148159,SYN 100,B01,201491,Staff,0,12,20,20
1683322149183,TDAC 1,A00,189286,Walsh; Kim C.,3,0,20,17
1683322149183,TDAC 1,B00,189287,Harting; Carla Kelso,11,0,20,9
1683322150206,TDAC 101,A00,189300,Walsh; Kim C.,16,0,20,4
1683322150206,TDAC 101,B00,189301,Harting; Carla Kelso,18,0,20,2
1683322151233,TDAC 102,A00,189304,Basso; Beatrice,14,0,20,6
1683322152260,TDAC 108,A00,189305,Staff,18,0,20,2
1683322153294,TDDE 131,A00,189310,Staff,19,0,20,1
1683322153294,TDDE 131,B00,189314,Staff,19,0,20,1
1683322153294,TDDE 131,C00,189315,Staff,48,0,50,2
1683322153294,TDDE 131,D00,189316,Staff,14,0,15,1
1683322153294,TDDE 131,E00,204841,Staff,20,0,20,0
1683322154325,TDGE 10,A00,189289,Staff,30,0,50,20
1683322154325,TDGE 10,B00,189290,Havis; Allan,1,0,50,49
1683322155354,TDGE 11,A00,189291,Fulton; Julia,0,3,50,50
1683322155354,TDGE 11,B00,189292,Staff,20,0,25,5
1683322155354,TDGE 11,C00,260270,Staff,0,0,0,0
1683322156380,TDGE 25,A00,189294,Staff,3,0,20,17
1683322157409,TDGE 124,A00,189318,Fulton; Julia,0,8,50,50
1683322158435,TDGE 125,A00,189319,Staff,13,0,25,12
1683322158435,TDGE 125,B00,189320,Staff,23,0,25,2
1683322159457,TDGE 127,A00,189322,Havis; Allan,0,0,50,50
1683322160480,TDHT 101,A00,189323,Staff,18,0,25,7
1683322160480,TDHT 101,B00,189324,Staff,25,0,25,0
1683322161505,TDHT 102,A00,189325,Staff,49,0,50,1
1683322162533,TDMV 1,A00,189295,Arcidiacono; Kristin,19,0,30,11
1683322162533,TDMV 1,B00,189296,Caligagan; Maria T.,24,0,30,6
1683322163560,TDMV 2,A00,189297,Sammartano; Tonnie,28,0,30,2
1683322163560,TDMV 2,B00,189299,Arcidiacono; Kristin,24,0,30,6
1683322164586,TDMV 3,A00,204998,Rincon; Alicia,22,0,30,8
1683322165610,TDMV 120,A00,189458,Sammartano; Tonnie,28,0,30,2
1683322166633,TDMV 138,A00,189541,Jun; Grace Shin Hae,22,0,40,18
1683322167660,TDMV 142,A00,189717,Caligagan; Tony,23,0,30,7
1683322167660,TDMV 142,B00,189718,Caligagan; Maria T.,25,0,30,5
1683322168685,TMC 2,A01,187533,Staff,25,0,25,0
1683322168685,TMC 2,A02,187534,Staff,25,0,25,0
1683322169709,USP 1,A01,187536,Kwak; Nancy,0,16,25,25
1683322170736,USP 5,A01,187538,Staff,9,0,25,16
1683322171759,USP 101,A00,199253,Staff,0,4,0,0
1683322172786,USP 124,A00,187562,Boomhower; Matthew Charles,1,0,30,29
1683322173809,USP 138,A00,187582,Staff,20,0,25,5
1683322174836,USP 152,A01,187597,Staff,4,0,25,21
1683322175860,USP 153,A00,187598,Staff,19,0,25,6
1683322176889,USP 168,A00,187607,Kwak; Nancy,2,0,5,3
1683322177916,USP 173,A00,187619,Staff,4,0,25,21
1683322178940,USP 181,A00,187638,Staff,0,0,25,25
1683322179963,VIS 103,A00,187650,Cruz; Edwin Teddy,23,0,75,52
1683322180987,VIS 110D,A00,187669,Staff,12,0,22,10
1683322182014,VIS 127C,A00,187720,Shen; Kuiyi,68,0,146,78
1683322183038,VIS 149,A00,187731,Yoldas; Pinar,0,14,22,22
1683322184063,VIS 151,A01,188091,Staff,22,0,34,12
1683322184063,VIS 151,A02,188092,Staff,11,0,34,23
1683322185086,VIS 160B,A00,188093,Stalbaum; Brett,0,0,10,10
1683322187136,WCWP 10B,A00,201720,Staff,10,0,15,5
1683322187136,WCWP 10B,B00,201722,Staff,8,0,15,7
1683322188161,WCWP 100,A00,201725,Gagnon; Jeffrey C,0,0,2,2
1683322188161,WCWP 100,B00,201727,Staff,0,4,15,15
1683322191250,ANBI 133,A00,258401,Wilder; Linnea Lorene,34,0,40,6
1683322192277,ANBI 140,A00,258395,Hrvoj Mihic; Branka,18,0,25,7
1683322193356,ANSC 120,A00,258402,Bialecki; Jon Anthony,27,0,40,13
1683322194379,ANSC 144,A00,258400,Staff,14,0,40,26
1683322196431,ANSC 166,A00,258396,Parish; Steven Martin,157,0,175,18
1683322197457,ANSC 180,A00,193533,Staff,9,0,20,11
1683322198481,ANSC 188,A00,258397,Jassal; Aftab,33,0,40,7
1683322199504,ANTH 3,A01,258316,Staff,23,0,30,7
1683322200531,ANTH 5,A00,258394,Semendeferi; Ekaterini,16,0,20,4
1683322201555,ANTH 21,A01,258331,Staff,9,0,40,31
1683322202581,ANTH 103,A00,258398,Varma; Saiba,15,0,25,10
1683322203613,AWP 10,001,202034,Staff,0,0,0,0
1683322203613,AWP 10,002,202035,Staff,0,0,0,0
1683322203613,AWP 10,003,202036,Staff,0,0,0,0
1683322203613,AWP 10,004,202037,Staff,0,0,0,0
1683322203613,AWP 10,005,202038,Staff,0,0,0,0
1683322203613,AWP 10,006,202039,Staff,0,0,0,0
1683322203613,AWP 10,007,202040,Staff,0,0,0,0
1683322203613,AWP 10,008,202041,Staff,0,0,0,0
1683322203613,AWP 10,009,202042,Staff,0,0,0,0
1683322203613,AWP 10,010,202043,Staff,0,0,0,0
1683322203613,AWP 10,011,202044,Staff,0,0,0,0
1683322203613,AWP 10,012,202045,Staff,0,0,0,0
1683322203613,AWP 10,013,202046,Staff,0,0,0,0
1683322203613,AWP 10,014,202047,Staff,0,0,0,0
1683322203613,AWP 10,015,202048,Staff,0,0,0,0
1683322203613,AWP 10,016,202049,Staff,0,0,0,0
1683322203613,AWP 10,017,202050,Staff,0,0,0,0
1683322203613,AWP 10,018,202051,Staff,0,0,0,0
1683322203613,AWP 10,019,202052,Staff,0,0,0,0
1683322203613,AWP 10,020,202053,Staff,0,0,0,0
1683322203613,AWP 10,021,202054,Staff,0,0,0,0
1683322203613,AWP 10,022,202055,Staff,0,0,0,0
1683322203613,AWP 10,023,202056,Staff,0,0,0,0
1683322203613,AWP 10,024,202057,Staff,0,0,0,0
1683322203613,AWP 10,025,202058,Staff,0,0,0,0
1683322203613,AWP 10,026,202059,Staff,0,0,0,0
1683322204638,AWP 102,001,202032,Staff,0,0,0,0
1683322204638,AWP 102,002,202033,Staff,0,0,0,0
1683322205661,BENG 100,A01,254234,Taylor Amos; Alyssa C,31,0,40,9
1683322206687,BENG 196,001,270013,Engler; Adam J.,9999,0,9999,0
1683322207717,BICD 100R,A01,202018,Smith; Laurie,0,7,32,32
1683322207717,BICD 100R,A02,202019,Smith; Laurie,0,2,32,32
1683322207717,BICD 100R,A03,202020,Smith; Laurie,0,1,32,32
1683322207717,BICD 100R,A04,202021,Smith; Laurie,8,0,32,24
1683322207717,BICD 100R,A05,202022,Smith; Laurie,12,0,32,20
1683322208739,BICD 136,A01,193242,Gustafson-Brown; Cindy,0,2,32,32
1683322208739,BICD 136,A02,193244,Gustafson-Brown; Cindy,14,0,32,18
1683322209764,BIEB 102,A01,193249,Butler; Shannon Rhey,0,2,32,32
1683322209764,BIEB 102,A02,193251,Butler; Shannon Rhey,0,0,32,32
1683322209764,BIEB 102,A03,193253,Butler; Shannon Rhey,0,1,32,32
1683322209764,BIEB 102,A04,193255,Butler; Shannon Rhey,17,0,32,15
1683322209764,BIEB 102,A05,193265,Butler; Shannon Rhey,26,0,32,6
1683322209764,BIEB 102,A06,193269,Butler; Shannon Rhey,16,0,32,16
1683322211814,BIEB 150,A01,193274,Staff,0,0,32,32
1683322211814,BIEB 150,A02,193285,Staff,23,0,32,9
1683322212841,BIEB 194,A00,193286,Kurle; Carolyn M.,22,0,32,10
1683322213864,BILD 1,A01,192291,Staff,16,0,32,16
1683322213864,BILD 1,A02,192292,Staff,30,0,32,2
1683322213864,BILD 1,B01,192520,Reuther; Keefe,0,1,0,0
1683322213864,BILD 1,B02,192532,Reuther; Keefe,0,1,0,0
1683322214894,BILD 3,A01,192556,Butler; Shannon Rhey,0,0,32,32
1683322214894,BILD 3,A02,192581,Butler; Shannon Rhey,5,0,32,27
1683322214894,BILD 3,A03,192611,Butler; Shannon Rhey,23,0,32,9
1683322214894,BILD 3,A04,192612,Butler; Shannon Rhey,25,0,32,7
1683322214894,BILD 3,A05,192613,Butler; Shannon Rhey,27,0,32,5
1683322214894,BILD 3,A06,192679,Butler; Shannon Rhey,27,0,32,5
1683322214894,BILD 3,A07,192682,Butler; Shannon Rhey,22,0,32,10
1683322215922,BILD 4,A01,192836,Reuther; Keefe,0,0,24,24
1683322215922,BILD 4,A02,193044,Reuther; Keefe,4,0,24,20
1683322216945,BILD 10,A01,193142,Gustafson-Brown; Cindy,30,0,32,2
1683322216945,BILD 10,A02,193149,Gustafson-Brown; Cindy,31,0,32,1
1683322217973,BIMM 100,A01,193301,Staff,0,6,32,32
1683322217973,BIMM 100,A02,193312,Staff,0,5,32,32
1683322217973,BIMM 100,A03,193323,Staff,0,8,32,32
1683322218998,BIMM 101,A01,193329,McDonnell; Lisa Marie,0,3,24,24
1683322218998,BIMM 101,A02,193339,McDonnell; Lisa Marie,0,3,24,24
1683322218998,BIMM 101,B01,193354,McDonnell; Lisa Marie,0,3,24,24
1683322218998,BIMM 101,B02,193357,McDonnell; Lisa Marie,0,3,24,24
1683322220025,BIMM 110,A01,193377,Tat; John,0,11,32,32
1683322220025,BIMM 110,A02,193378,Tat; John,1,9,32,31
1683322221052,BIMM 120,A01,206116,Staff,0,0,32,32
1683322221052,BIMM 120,A02,206117,Staff,7,0,32,25
1683322221052,BIMM 120,A03,206121,Staff,21,0,32,11
1683322222077,BIPN 100,A01,193393,Park; Ji Young,0,14,32,32
1683322222077,BIPN 100,A02,193402,Park; Ji Young,0,12,32,32
1683322222077,BIPN 100,A03,193413,Park; Ji Young,0,14,32,32
1683322222077,BIPN 100,A04,193414,Park; Ji Young,0,13,32,32
1683322223105,BIPN 102,A01,193429,Staff,0,0,32,32
1683322223105,BIPN 102,A02,193438,Staff,22,0,32,10
1683322224132,BIPN 106,A01,193450,Reyes Gonzalez; Catalina,0,2,40,40
1683322225163,BIPN 134,A01,193465,Cooke; James Edward,0,0,32,32
1683322225163,BIPN 134,A02,193474,Cooke; James Edward,25,0,32,7
1683322225163,BIPN 134,A03,193485,Cooke; James Edward,29,0,32,3
1683322225163,BIPN 134,A04,193486,Cooke; James Edward,21,0,32,11
1683322225163,BIPN 134,A05,193491,Cooke; James Edward,31,0,32,1
1683322225163,BIPN 134,A06,193501,Cooke; James Edward,30,0,32,2
1683322225163,BIPN 134,A07,193510,Cooke; James Edward,29,0,32,3
1683322227211,BISP 194,A00,222522,Staff,14,0,32,18
1683322228236,CAT 124,A01,202407,Staff,20,0,25,5
1683322229261,CAT 125,A00,202408,Marchisotto; Jennifer Anne,4,0,20,16
1683322230284,CAT 125R,A00,202409,Smith; Lauryn Alissa,0,11,20,20
1683322230284,CAT 125R,B00,202410,Morales; Celeste Georgianna,0,11,20,20
1683322230284,CAT 125R,C00,202411,Irwin; Matthew Joseph,0,10,20,20
1683322231311,CENG 15,A01,204712,Yang; Kesong,0,1,0,0
1683322232339,CENG 114,A00,202070,Jahed Motlagh; Zeinab,5,0,20,15
1683322233366,CGS 105,A00,185477,Wesling; Megan E.,24,0,40,16
1683322234393,CGS 106,A00,185494,Staff,13,0,22,9
1683322235417,CGS 108,A00,185495,Staff,14,0,20,6
1683322236442,CGS 114,A00,185496,Staff,13,0,18,5
1683322237467,CGS 119,A00,185501,Staff,15,0,20,5
1683322238494,CGS 120,A00,185511,Staff,13,0,20,7
1683322239518,CHEM 4,A01,184675,Bussey; Thomas J,96,0,100,4
1683322240543,CHEM 6A,A01,184677,Staff,34,0,60,26
1683322241568,CHEM 6B,A01,184679,Staff,65,0,100,35
1683322242594,CHEM 6C,A01,184681,Bussey; Thomas J,1,0,50,49
1683322242594,CHEM 6C,A02,184682,Bussey; Thomas J,34,0,50,16
1683322243618,CHEM 40A,A01,184684,Albizati; Kim F.,37,0,100,63
1683322244642,CHEM 40B,A01,184686,Albizati; Kim F.,0,20,100,100
1683322245669,CHEM 41B,A01,184690,Staff,52,0,100,48
1683322246694,COGS 3,A01,184715,Boyle; Mary E. T.,0,25,40,40
1683322247718,COGS 14B,A01,185172,Staff,0,15,38,38
1683322248743,COGS 18,A01,184736,Staff,18,0,80,62
1683322249776,COGS 100,A01,184932,Staff,0,5,73,73
1683322250800,COGS 101A,A01,184935,Staff,0,38,30,30
1683322251825,COGS 101B,A01,184944,Staff,0,2,30,30
1683322252853,COGS 101C,A01,184946,Staff,0,12,30,30
1683322253878,COGS 102A,A01,184951,Johnson; Christine M.,2,0,40,38
1683322254903,COGS 107B,A01,184953,Mooshagian; Eric Frederick,0,50,40,40
1683322255928,COGS 118B,A01,184959,Gupta; Anjum,0,48,40,40
1683322256955,COGS 153,A00,184961,Staff,0,15,30,30
1683322257983,COGS 177,A00,184962,Staff,0,21,30,30
1683322259013,COGS 187A,A01,184969,Boyle; Mary E. T.,0,17,40,40
1683322260041,COMM 10,A01,185174,Staff,0,5,25,25
1683322260041,COMM 10,A02,185189,Staff,0,5,25,25
1683322260041,COMM 10,A03,269821,Staff,0,0,0,0
1683322261110,COMM 100B,A01,185475,Staff,0,0,0,2
1683322261110,COMM 100B,A02,185476,Staff,14,0,25,11
1683322262142,COMM 100C,A01,185314,Staff,1,0,25,24
1683322262142,COMM 100C,A02,185327,Staff,19,0,25,6
1683322263169,COMM 110M,A00,185349,Staff,2,0,40,38
1683322264199,COMM 113T,A00,185352,Staff,25,0,40,15
1683322265225,COMM 114I,A00,185353,Staff,33,0,40,7
1683322266250,COMM 131,A00,185354,Staff,19,0,30,11
1683322267274,CSE 8A,A50,185358,Cao; Yingjun,0,46,10,10
1683322268301,CSE 8B,A01,185362,Staff,1,47,50,49
1683322269328,CSE 11,A01,185416,Cao; Yingjun,0,92,10,10
1683322270356,CSE 20,A01,185445,Briones; Jor-el Thomas Caparas,5,0,25,20
1683322271379,CSE 21,A01,185447,Staff,10,0,50,40
1683322272403,CSE 101,A01,185451,Staff,0,12,50,50
1683322272403,CSE 101,B01,185453,Jones; Miles E,0,11,50,50
1683322274452,CSE 141,A01,185458,Eldon; John,20,0,100,80
1683322275481,CSE 141L,A01,185461,Eldon; John,12,0,100,88
1683322276506,CSE 142,A01,185463,Staff,36,0,60,24
1683322276506,CSE 142,B01,201355,Staff,0,7,60,60
1683322277535,CSE 142L,A01,185470,Staff,36,0,60,24
1683322277535,CSE 142L,B01,201417,Staff,0,6,60,60
1683322278560,CSE 190,A00,201433,Staff,32,0,49,17
1683322279590,DOC 1,A01,259136,Strom; Megan C.,7,0,15,8
1683322279590,DOC 1,A02,259137,Strom; Megan C.,14,0,15,1
1683322279590,DOC 1,A03,259138,Strom; Megan C.,14,0,15,1
1683322279590,DOC 1,A04,259139,Strom; Megan C.,14,0,15,1
1683322280616,DOC 100D,A00,259140,Pass; Natalye Joann,17,0,25,8
1683322281640,DSGN 1,A01,184749,Rill; Bryan,0,25,30,30
1683322282664,DSGN 100,A01,185168,Staff,0,2,25,25
1683322283688,ECE 5,A01,185626,Morris; Karcher William,0,10,0,0
1683322284711,ECE 101,A01,185628,Staff,17,0,70,53
1683322285738,ECE 107,A01,185635,Baghdadchi; Saharnaz,0,0,20,20
1683322285738,ECE 107,A02,185638,Baghdadchi; Saharnaz,4,0,20,16
1683322286763,ECE 148,A01,185647,Silberman; Jack,0,0,16,16
1683322287786,ECON 1,A01,185537,Crane; Meredith Helen,54,0,70,16
1683322288810,ECON 3,A01,185549,Crane; Meredith Helen,33,0,70,37
1683322289837,ECON 4,A01,203354,Anderson; John Charles,0,4,10,10
1683322290865,ECON 100A,A01,185574,Staff,0,4,40,40
1683322291889,ECON 100B,A01,185576,Staff,0,22,40,40
1683322292913,ECON 100C,A01,185589,Newhouse; Herbert S,30,0,70,40
1683322293937,ECON 105,A00,185608,Vespa; Emanuel Ignacio,19,0,35,16
1683322294961,ECON 109,A01,185610,Shishkin; Denis,10,0,35,25
1683322295990,ECON 110A,A01,185612,Staff,11,0,40,29
1683322297071,ECON 120A,A01,185615,Staff,20,0,40,20
1683322298095,ECON 120C,A01,185617,Sun; Yixiao,0,20,70,70
1683322299119,ECON 144,A00,203346,Squires; Dale E,3,0,35,32
1683322300143,ECON 171,A01,203349,Newhouse; Herbert S,0,1,35,35
1683322301168,ECON 173A,A01,185621,Toda; Alexis Akira,21,0,35,14
1683322302192,EDS 25,A01,202413,Staff,0,1,0,0
1683322302192,EDS 25,A02,202414,Staff,0,1,0,0
1683322302192,EDS 25,A03,202415,Staff,0,0,0,0
1683322302192,EDS 25,A04,202416,Staff,0,1,0,0
1683322302192,EDS 25,A05,202439,Staff,0,0,0,0
1683322302192,EDS 25,A06,202440,Staff,0,0,0,0
1683322302192,EDS 25,B01,202631,Staff,0,0,0,0
1683322302192,EDS 25,B02,202632,Staff,0,0,0,0
1683322302192,EDS 25,B03,202639,Staff,0,0,0,0
1683322302192,EDS 25,B04,202640,Staff,0,0,0,0
1683322302192,EDS 25,B05,202643,Staff,0,0,0,0
1683322302192,EDS 25,B06,202644,Staff,0,0,0,0
1683322303219,EDS 38,A01,202659,Black; Alison Michelle,24,0,25,1
1683322304243,EDS 115,A00,202652,Staff,17,0,30,13
1683322305271,EDS 125,A00,202649,Staff,14,0,30,16
1683322306298,EDS 126,A01,203332,Staff,30,0,30,0
1683322307323,EDS 139,A00,202838,Staff,16,0,25,9
1683322308348,EDS 146,A01,202655,Staff,14,0,25,11
1683322309371,ENG 15,A00,185667,Staff,0,1,0,0
1683322309371,ENG 15,B00,185672,Staff,0,0,0,0
1683322309371,ENG 15,C00,185675,Staff,0,0,0,0
1683322309371,ENG 15,D00,185682,Staff,0,0,0,0
1683322309371,ENG 15,E00,185684,Staff,0,0,0,0
1683322310399,ETHN 103,A00,185710,Staff,0,3,35,35
1683322311423,ETHN 103A,A00,199228,Man; Simeon S,2,0,9,7
1683322312447,ETHN 109,A00,185711,Staff,18,0,35,17
1683322313474,ETHN 142,A00,185726,Staff,0,4,30,30
1683322314501,ETHN 163J,A00,199229,Man; Simeon S,5,0,8,3
1683322315524,ETHN 168,A00,185727,Staff,8,0,10,2
1683322316546,ETHN 182,A00,185728,Staff,1,0,35,34
1683322317573,ETHN 183,A00,185737,Staff,8,0,18,10
1683322318603,GLBH 111,A01,209361,Burgos; Jose L.,0,0,0,0
1683322320656,HIEU 104,A00,185792,Staff,16,0,20,4
1683322321684,HIEU 115,A00,185800,Staff,1,0,20,19
1683322322708,HIEU 128,A00,185801,Staff,0,7,20,20
1683322323738,HIEU 147,A00,185802,Staff,16,0,20,4
1683322324764,HIEU 154,A00,185823,Staff,12,0,20,8
1683322325789,HILA 102,A00,185826,Staff,13,0,20,7
1683322326813,HILD 2C,A01,185778,Staff,0,12,20,20
1683322327839,HILD 7B,A01,185780,Kwak; Nancy,0,15,32,32
1683322327839,HILD 7B,A02,185781,Kwak; Nancy,0,18,32,32
1683322328867,HILD 30,A01,185791,Staff,14,0,20,6
1683322329894,HISC 119,A00,185830,Golan; Tal,0,9,20,20
1683322330919,HITO 156GS,A00,185831,Patterson; Patrick H.,0,0,0,23
1683322331942,HIUS 103,A00,185832,Man; Simeon S,0,6,20,20
1683322332968,HIUS 117,A00,185836,Kwak; Nancy,2,0,20,18
1683322333997,HIUS 125,A00,185840,Man; Simeon S,0,0,23,23
1683322335022,HIUS 149,A00,185845,Staff,0,0,20,20
1683322336051,HUM 3,A01,185882,Zavodny; Tatiana Sophia,0,6,50,50
1683322336051,HUM 3,B01,185899,Caldwell; Michael Alan,0,19,50,50
1683322337075,HUM 3GS,A00,185900,Patterson; Patrick H.,0,0,0,23
1683322338104,HUM 4,A01,185938,Zroka; Amy Liane,31,0,50,19
1683322338104,HUM 4,B01,185956,Watkins; Eric,0,2,50,50
1683322338104,HUM 4,B02,202209,Watkins; Eric,0,2,50,50
1683322338104,HUM 4,B03,202210,Watkins; Eric,0,0,50,50
1683322339128,HUM 5,A01,185958,West; Geoffrey Scott,3,0,50,47
1683322339128,HUM 5,A02,202215,West; Geoffrey Scott,0,0,50,50
1683322340152,INTL 190,A00,185959,Gagnon; Jeffrey C,0,0,0,9
1683322340152,INTL 190,B00,185960,Lettieri; Michael Joseph,0,0,0,1
1683322341177,JAPN 180,A00,254509,Staff,5,1,30,25
1683322342204,LATI 10,A01,202853,Kennemore; Amy Michelle,5,0,35,30
1683322342204,LATI 10,A02,202854,Kennemore; Amy Michelle,1,0,35,34
1683322342204,LATI 10,A03,270054,Kennemore; Amy Michelle,30,0,30,0
1683322343231,LATI 180,A00,202855,Kennemore; Amy Michelle,11,0,20,9
1683322344256,LAWS 101,A00,201767,Golan; Tal,0,7,40,40
1683322345281,LIFR 1C,A00,185961,Staff,6,0,20,14
1683322346311,LIFR 1CX,A00,185962,Staff,7,0,20,13
1683322347341,LIFR 1D,A00,185963,Staff,9,0,20,11
1683322348364,LIFR 1DX,A00,185964,Staff,9,0,20,11
1683322349393,LIGN 101,A01,186039,Staff,43,0,50,7
1683322350418,LIGN 165,A00,186040,Staff,18,0,50,32
1683322351446,LTCS 108,A00,186041,Staff,6,0,10,4
1683322352469,LTCS 119,A00,186042,Staff,16,0,20,4
1683322353501,LTCS 130,A00,186043,Wesling; Megan E.,15,0,25,10
1683322355554,LTEA 138,A00,186119,Staff,14,0,40,26
1683322356581,LTEN 124,A00,186148,Staff,6,0,25,19
1683322357611,LTEN 178,A00,186149,Staff,7,0,15,8
1683322358633,LTEN 181,A00,186150,Blanco; John D,33,0,40,7
1683322359657,LTWL 120,A00,186160,Staff,20,0,25,5
1683322360682,LTWL 165,A00,186161,Staff,22,0,25,3
1683322361711,LTWR 100,A00,186162,Staff,0,5,15,15
1683322362739,LTWR 102,A00,186163,Doller; Ben,5,0,15,10
1683322363762,MAE 8,A01,186412,Staff,0,0,0,0
1683322364787,MAE 30B,A00,186445,Bahadori; Mohammad Yousef,83,0,100,17
1683322365817,MAE 40,A00,186592,Bewley; Thomas R,9,0,50,41
1683322366845,MAE 101B,A00,186593,Bahadori; Mohammad Yousef,81,0,100,19
1683322367872,MAE 105,A00,186594,Bandaru; Prabhakar,12,0,50,38
1683322368899,MAE 107,A00,186599,Pham; Hieu Tan,0,6,120,120
1683322369922,MAE 148,A01,186660,Silberman; Jack,3,0,16,13
1683322370947,MATH 10A,A01,188095,Staff,0,6,35,35
1683322371979,MATH 10B,A01,188097,Bowers; Adam R.,0,11,30,30
1683322371979,MATH 10B,A02,188099,Bowers; Adam R.,0,11,30,30
1683322371979,MATH 10B,B01,188104,Bowers; Adam R.,0,10,30,30
1683322371979,MATH 10B,B02,188106,Bowers; Adam R.,0,10,30,30
1683322373004,MATH 10C,A01,188111,Staff,0,18,30,30
1683322373004,MATH 10C,A02,188127,Staff,0,17,30,30
1683322373004,MATH 10C,A03,188131,Staff,0,18,30,30
1683322373004,MATH 10C,B01,188218,Staff,18,0,30,12
1683322373004,MATH 10C,B02,188244,Staff,13,0,30,17
1683322373004,MATH 10C,B03,188277,Staff,16,0,30,14
1683322374032,MATH 18,A01,188344,Bach; Quang Tran,18,0,30,12
1683322374032,MATH 18,A02,188345,Bach; Quang Tran,11,0,30,19
1683322374032,MATH 18,B01,188353,Bach; Quang Tran,10,0,30,20
1683322374032,MATH 18,B02,188354,Bach; Quang Tran,20,0,30,10
1683322375057,MATH 20A,A01,188374,Staff,13,0,35,22
1683322376081,MATH 20B,A01,188382,Ohm; Ko Woon,6,0,30,24
1683322376081,MATH 20B,A02,188383,Ohm; Ko Woon,22,0,30,8
1683322376081,MATH 20B,B01,188385,Ohm; Ko Woon,7,0,30,23
1683322376081,MATH 20B,B02,188392,Ohm; Ko Woon,22,0,30,8
1683322377105,MATH 20C,A01,188394,Harel; Guershon,10,0,30,20
1683322377105,MATH 20C,A02,188395,Harel; Guershon,14,0,30,16
1683322377105,MATH 20C,B01,188404,Harel; Guershon,5,0,30,25
1683322377105,MATH 20C,B02,188405,Harel; Guershon,19,0,30,11
1683322378128,MATH 20D,A01,188414,Hammock; Frances H,0,1,30,30
1683322378128,MATH 20D,A02,188415,Hammock; Frances H,3,0,30,27
1683322378128,MATH 20D,B01,188447,Hammock; Frances H,2,0,30,28
1683322378128,MATH 20D,B02,188486,Hammock; Frances H,8,0,30,22
1683322379153,MATH 20E,A01,188649,Staff,21,0,30,9
1683322379153,MATH 20E,A02,188650,Staff,23,0,30,7
1683322379153,MATH 20E,A03,188673,Staff,0,0,30,30
1683322380182,MATH 102,A01,188675,Staff,0,35,35,35
1683322381206,MATH 103B,A01,188681,Staff,4,0,35,31
1683322381206,MATH 103B,B01,188692,Staff,5,0,35,30
1683322382233,MATH 109,A01,188695,Salehi Golsefidy; Alireza,25,0,35,10
1683322382233,MATH 109,A02,188696,Salehi Golsefidy; Alireza,26,0,35,9
1683322383260,MATH 120A,A01,188698,Eggers; John Dietrich,7,0,35,28
1683322384285,MATH 142B,A01,188736,Ioana; Adrian,0,2,30,30
1683322384285,MATH 142B,A02,188741,Ioana; Adrian,0,1,30,30
1683322384285,MATH 142B,A03,188743,Ioana; Adrian,1,3,30,29
1683322385309,MATH 168A,A01,188790,Staff,0,9,35,35
1683322386334,MATH 170A,A01,188803,Nie; Jiawang,0,2,35,35
1683322386334,MATH 170A,A02,188811,Nie; Jiawang,0,0,35,35
1683322386334,MATH 170A,A03,188814,Nie; Jiawang,0,0,35,35
1683322386334,MATH 170A,A04,188815,Nie; Jiawang,13,0,35,22
1683322387358,MATH 193B,A01,188817,Staff,0,0,35,35
1683322387358,MATH 193B,A02,188818,Staff,6,0,35,29
1683322388382,MGT 4,A01,202857,Anderson; John Charles,62,0,80,18
1683322389407,MGT 12,A00,202858,Lindenberger; Wade Douglas,42,0,90,48
1683322390431,MGT 18,A00,202859,Staff,74,0,90,16
1683322391454,MGT 18GS,A00,202860,McKay; Michael J,13,0,28,15
1683322392480,MGT 45,A00,202861,Pecore; Joseph P.,13,0,90,77
1683322393503,MGT 100,A00,202863,Yavorsky; Daniel Ryan,28,0,90,62
1683322394528,MGT 103,A00,202864,Ehrich; Kristine R,0,18,90,90
1683322395556,MGT 112,A00,202865,Ehrich; Kristine R,15,0,90,75
1683322396582,MGT 121A,A00,202868,Staff,0,20,0,0
1683322397609,MGT 131B,A00,202869,Anderson; John Charles,59,0,90,31
1683322398633,MGT 136,A00,202871,Lindenberger; Wade Douglas,84,0,90,6
1683322399657,MGT 164,A00,202873,Staff,0,68,90,91
1683322400742,MGT 164GS,A00,202874,McKay; Mary A,13,0,28,15
1683322401769,MGT 180,A00,202875,Staff,0,50,90,91
1683322402793,MMW 11R,A01,205019,Herbst; Matthew,3,0,30,27
1683322402793,MMW 11R,A02,205026,Herbst; Matthew,29,0,30,1
1683322403818,MMW 15,A01,193512,Chang; Edmond Yi-Teh,0,9,28,28
1683322403818,MMW 15,A02,193513,Chang; Edmond Yi-Teh,0,5,28,28
1683322403818,MMW 15,A03,193514,Chang; Edmond Yi-Teh,0,5,28,28
1683322403818,MMW 15,A04,193515,Chang; Edmond Yi-Teh,0,5,28,28
1683322403818,MMW 15,A05,193516,Chang; Edmond Yi-Teh,0,4,28,28
1683322403818,MMW 15,A06,193517,Chang; Edmond Yi-Teh,0,5,28,28
1683322403818,MMW 15,B01,193519,Chang; Edmond Yi-Teh,0,4,28,28
1683322403818,MMW 15,B02,193520,Chang; Edmond Yi-Teh,0,5,28,28
1683322403818,MMW 15,B03,193521,Chang; Edmond Yi-Teh,0,4,28,28
1683322403818,MMW 15,B04,193522,Chang; Edmond Yi-Teh,0,4,28,28
1683322403818,MMW 15,B05,193523,Chang; Edmond Yi-Teh,0,5,28,28
1683322403818,MMW 15,B06,193524,Chang; Edmond Yi-Teh,0,4,28,28
1683322404842,MMW 122,A01,193526,Rahimi; Babak,0,15,28,28
1683322404842,MMW 122,A02,193527,Rahimi; Babak,0,14,28,28
1683322404842,MMW 122,A03,193528,Rahimi; Babak,0,0,0,0
1683322404842,MMW 122,A04,193529,Rahimi; Babak,0,0,0,0
1683322405871,MUS 1A,A01,186663,Staff,0,20,35,35
1683322406896,MUS 4,A01,186715,Staff,0,12,35,35
1683322407920,MUS 5R,A01,186796,Dubnov; Shlomo,0,17,35,35
1683322408945,MUS 6,A01,186798,Staff,0,3,25,25
1683322409970,MUS 7,A01,186830,Staff,12,0,35,23
1683322411048,MUS 8,A01,186930,Staff,0,26,35,35
1683322412077,MUS 15,A01,186932,Staff,0,16,35,35
1683322412077,MUS 15,B01,186934,Staff,0,15,35,35
1683322413105,MUS 80,A00,186935,Staff,2,0,20,18
1683322413105,MUS 80,B00,186936,Staff,25,0,25,0
1683322414131,NANO 11,A00,204702,Lipomi; Darren John,0,0,0,0
1683322415155,NANO 15,A01,204709,Yang; Kesong,0,1,0,0
1683322416179,NANO 114,A00,202069,Jahed Motlagh; Zeinab,3,0,10,7
1683322417206,PHIL 1,A00,186955,Grush; Rick Scott,32,0,40,8
1683322418230,PHIL 10,A01,186973,Grush; Rick Scott,28,0,35,7
1683322418230,PHIL 10,A02,186974,Grush; Rick Scott,33,0,35,2
1683322419257,PHIL 13,A01,186976,Staff,7,0,35,28
1683322419257,PHIL 13,A02,186977,Staff,16,0,35,19
1683322420280,PHIL 14,A01,186979,Staff,31,0,35,4
1683322420280,PHIL 14,A02,186986,Staff,32,0,35,3
1683322421307,PHIL 28,A01,186988,Staff,16,0,30,14
1683322421307,PHIL 28,A02,186989,Staff,1,0,30,29
1683322421307,PHIL 28,A03,186990,Staff,9,0,30,21
1683322421307,PHIL 28,A04,186991,Staff,26,0,30,4
1683322422333,PHIL 120,A00,186997,Staff,23,0,40,17
1683322423361,PHIL 137,A00,187003,Staff,9,0,40,31
1683322424385,PHIL 150,A00,187015,Staff,47,0,70,23
1683322425410,PHIL 167,A00,187021,Lamey; Andy M.,35,0,40,5
1683322426434,PHIL 174,A01,202226,Staff,17,0,20,3
1683322426434,PHIL 174,A02,202235,Staff,20,0,20,0
1683322427458,PHIL 191A,A00,258918,Staff,0,0,1,1
1683322428485,PHYS 1A,A00,187028,Staff,27,0,60,33
1683322429509,PHYS 1AL,001,187036,Staff,3,0,30,27
1683322429509,PHYS 1AL,002,187049,Staff,18,0,30,12
1683322430534,PHYS 1B,A00,187058,Staff,22,0,60,38
1683322431561,PHYS 1BL,001,187064,Staff,0,0,30,30
1683322431561,PHYS 1BL,002,187070,Staff,5,0,30,25
1683322432585,PHYS 1C,A00,187082,Staff,31,0,120,89
1683322433610,PHYS 1CL,001,187088,Staff,0,9,30,30
1683322433610,PHYS 1CL,002,187089,Staff,0,2,30,30
1683322433610,PHYS 1CL,009,262693,Staff,11,0,30,19
1683322434634,PHYS 2B,A01,187097,Staff,54,0,115,61
1683322435658,PHYS 2C,A01,187099,Staff,67,0,115,48
1683322436686,PHYS 2CL,A01,187101,Staff,5,0,28,23
1683322436686,PHYS 2CL,A02,187102,Staff,15,0,28,13
1683322437710,PHYS 2D,A01,187123,Shotwell; Brian,95,0,115,20
1683322438737,PHYS 4B,A01,187133,Grinstein; Benjamin,35,0,50,15
1683322439761,POLI 10,A00,188819,Staff,0,4,50,50
1683322440786,POLI 11,A00,188827,Staff,43,0,50,7
1683322441810,POLI 13R,A00,188828,Staff,0,1,20,20
1683322442836,POLI 27,A01,188830,Elgin; Samuel Zincke,0,1,70,70
1683322443860,POLI 30,A00,188832,Desposato; Scott,31,0,50,19
1683322444895,POLI 102F,A00,188834,Staff,3,0,40,37
1683322445921,POLI 104A,A00,188852,Staff,14,0,30,16
1683322446944,POLI 104I,A00,188853,Staff,0,6,20,20
1683322447977,POLI 110B,A00,188854,Wiens; David,7,0,20,13
1683322449003,POLI 112A,A00,188855,Wiens; David,5,0,30,25
1683322450029,POLI 117R,A00,188856,Forman; Fonna,0,11,20,20
1683322451052,POLI 118,A00,188857,Ingham; Sean,8,0,20,12
1683322452078,POLI 120G,A00,188858,Staff,9,0,30,21
1683322453108,POLI 131CR,A00,188863,Hoston; Germaine,24,0,50,26
1683322454135,POLI 133,A00,188864,Nellis; Gareth Hb,44,0,50,6
1683322455162,POLI 134D,A00,188865,Desposato; Scott,27,0,30,3
1683322456188,POLI 142A,A00,188871,Gartzke; Erik,22,0,50,28
1683322457219,POLI 142K,A00,188874,Staff,38,0,50,12
1683322458243,POLI 143,A00,188940,Gartzke; Erik,16,0,30,14
1683322459266,POLI 153,A00,188943,Staff,3,0,20,17
1683322460296,POLI 160AA,A00,188944,Staff,12,0,40,28
1683322461321,POLI 170A,A00,188945,Staff,11,0,30,19
1683322463371,PSYC 1,A00,188952,Staff,37,0,90,53
1683322464395,PSYC 2,B00,188953,Staff,19,0,35,16
1683322465421,PSYC 6,A00,188970,Staff,47,0,60,13
1683322466445,PSYC 7,A00,188973,Staff,37,0,45,8
1683322467469,PSYC 60,A01,188980,Rickard; Timothy C.,43,0,60,17
1683322468496,PSYC 70,A01,189001,Steiner; Eric Tomas,24,0,45,21
1683322469521,PSYC 100,A00,189005,Lacefield; Katharine I,0,99,120,120
1683322470548,PSYC 102,A00,189008,Staff,10,0,30,20
1683322471571,PSYC 106,B00,189026,Gorman; Michael R.,35,0,60,25
1683322472599,PSYC 114,B01,189033,Winkielman; Piotr,0,32,30,30
1683322473621,PSYC 131,A00,189036,Anagnostaras; Stephan,0,43,60,60
1683322474645,PSYC 136,A00,189041,Lowe; Angela Beth,0,7,25,25
1683322475672,PSYC 137,A00,189057,Winkielman; Piotr,0,34,25,25
1683322476696,PSYC 144,A00,189107,Wixted; John T,0,7,50,50
1683322478749,PSYC 162,A00,189142,Staff,0,8,85,85
1683322479774,PSYC 172,A00,189144,Gorman; Michael R.,0,7,30,30
1683322481826,PSYC 179,A00,189146,Lacefield; Katharine I,0,84,120,120
1683322482850,PSYC 181,A00,189147,Anagnostaras; Stephan,0,44,90,90
1683322483874,PSYC 190R,A00,189148,Barner; David A.,0,22,80,80
1683322484901,PSYC 191,A00,189275,Rickard; Timothy C.,0,7,25,25
1683322485928,PSYC 193,A00,189276,Chapman; Eddie Nathaniel,0,1,0,4
1683322486957,PSYC 193L,A01,189281,Lowe; Angela Beth,12,0,20,8
1683322486957,PSYC 193L,B01,189285,Staff,28,0,35,7
1683322487981,RELI 149,A00,187137,Rahimi; Babak,7,0,40,33
1683322489008,SE 9,A01,187315,Staff,0,2,18,18
1683322490032,SE 101B,A00,187409,Staff,24,0,30,6
1683322491057,SE 110B,A00,187444,Staff,10,0,40,30
1683322492084,SE 130B,A00,187449,Staff,31,0,40,9
1683322493109,SE 150A,A00,187516,Staff,9,0,20,11
1683322494132,SE 154,A00,187528,Staff,30,0,50,20
1683322495156,SIO 3,A01,258171,Staff,35,0,40,5
1683322496184,SIO 10,A00,187144,Cook; Geoffrey W,0,3,75,75
1683322497209,SIO 45,A00,187152,Cook; Geoffrey W,1,0,100,99
1683322498230,SIO 109R,A00,194486,Staff,0,3,20,20
1683322500282,SIO 187,A01,187233,Kacev; David,12,0,40,28
1683322501313,SOCI 1,A01,258656,Thorpe; Charles Robert,28,0,30,2
1683322501313,SOCI 1,A02,258658,Thorpe; Charles Robert,30,0,30,0
1683322501313,SOCI 1,A03,258661,Thorpe; Charles Robert,25,0,25,0
1683322501313,SOCI 1,A04,258666,Thorpe; Charles Robert,22,0,25,3
1683322501313,SOCI 1,A05,258897,Thorpe; Charles Robert,23,0,25,2
1683322501313,SOCI 1,A06,258898,Thorpe; Charles Robert,25,0,25,0
1683322502338,SOCI 30,A01,258903,Pardo Guerra; Juan Pablo,16,0,30,14
1683322503365,SOCI 102,A00,258904,Staff,9,0,25,16
1683322504453,SOCI 106,A00,258905,Staff,19,0,25,6
1683322505482,SOCI 111,A00,258907,Ribas Norris; Janet Vanesa,26,0,30,4
1683322506507,SOCI 121R,A00,258908,Pardo Guerra; Juan Pablo,11,0,30,19
1683322507532,SOCI 126,A01,203330,Staff,14,0,20,6
1683322508560,SOCI 131,A00,258909,Thorpe; Charles Robert,31,0,60,29
1683322509597,SOCI 135,A00,258910,Payne; Christine Anna,0,9,30,30
1683322510623,SOCI 157,A00,258911,Staff,12,0,30,18
1683322511650,SOCI 184,A00,258912,Staff,25,0,30,5
1683322512672,SOCI 188D,A00,258913,Staff,21,0,30,9
1683322513697,SYN 2,001,187529,Staff,9,0,16,7
1683322513697,SYN 2,002,201452,Staff,0,18,16,16
1683322513697,SYN 2,003,201469,Staff,4,0,16,12
1683322514722,SYN 100,A01,187531,Staff,0,9,20,20
1683322514722,SYN 100,B01,201491,Staff,0,12,20,20
1683322515746,TDAC 1,A00,189286,Walsh; Kim C.,3,0,20,17
1683322515746,TDAC 1,B00,189287,Harting; Carla Kelso,11,0,20,9
1683322516769,TDAC 101,A00,189300,Walsh; Kim C.,16,0,20,4
1683322516769,TDAC 101,B00,189301,Harting; Carla Kelso,18,0,20,2
1683322517794,TDAC 102,A00,189304,Basso; Beatrice,14,0,20,6
1683322518823,TDAC 108,A00,189305,Staff,18,0,20,2
1683322519848,TDDE 131,A00,189310,Staff,19,0,20,1
1683322519848,TDDE 131,B00,189314,Staff,19,0,20,1
1683322519848,TDDE 131,C00,189315,Staff,48,0,50,2
1683322519848,TDDE 131,D00,189316,Staff,14,0,15,1
1683322519848,TDDE 131,E00,204841,Staff,20,0,20,0
1683322520872,TDGE 10,A00,189289,Staff,30,0,50,20
1683322520872,TDGE 10,B00,189290,Havis; Allan,1,0,50,49
1683322521896,TDGE 11,A00,189291,Fulton; Julia,0,3,50,50
1683322521896,TDGE 11,B00,189292,Staff,20,0,25,5
1683322521896,TDGE 11,C00,260270,Staff,0,0,0,0
1683322522923,TDGE 25,A00,189294,Staff,3,0,20,17
1683322523950,TDGE 124,A00,189318,Fulton; Julia,0,8,50,50
1683322524974,TDGE 125,A00,189319,Staff,13,0,25,12
1683322524974,TDGE 125,B00,189320,Staff,23,0,25,2
1683322526000,TDGE 127,A00,189322,Havis; Allan,0,0,50,50
1683322527023,TDHT 101,A00,189323,Staff,18,0,25,7
1683322527023,TDHT 101,B00,189324,Staff,25,0,25,0
1683322528049,TDHT 102,A00,189325,Staff,49,0,50,1
1683322529073,TDMV 1,A00,189295,Arcidiacono; Kristin,19,0,30,11
1683322529073,TDMV 1,B00,189296,Caligagan; Maria T.,24,0,30,6
1683322530097,TDMV 2,A00,189297,Sammartano; Tonnie,28,0,30,2
1683322530097,TDMV 2,B00,189299,Arcidiacono; Kristin,24,0,30,6
1683322531120,TDMV 3,A00,204998,Rincon; Alicia,22,0,30,8
1683322532144,TDMV 120,A00,189458,Sammartano; Tonnie,28,0,30,2
1683322533171,TDMV 138,A00,189541,Jun; Grace Shin Hae,22,0,40,18
1683322534199,TDMV 142,A00,189717,Caligagan; Tony,23,0,30,7
1683322534199,TDMV 142,B00,189718,Caligagan; Maria T.,25,0,30,5
1683322535222,TMC 2,A01,187533,Staff,25,0,25,0
1683322535222,TMC 2,A02,187534,Staff,25,0,25,0
1683322536247,USP 1,A01,187536,Kwak; Nancy,0,16,25,25
1683322537273,USP 5,A01,187538,Staff,9,0,25,16
1683322538298,USP 101,A00,199253,Staff,0,4,0,0
1683322539322,USP 124,A00,187562,Boomhower; Matthew Charles,1,0,30,29
1683322540349,USP 138,A00,187582,Staff,20,0,25,5
1683322541373,USP 152,A01,187597,Staff,4,0,25,21
1683322542397,USP 153,A00,187598,Staff,19,0,25,6
1683322543422,USP 168,A00,187607,Kwak; Nancy,2,0,5,3
1683322544446,USP 173,A00,187619,Staff,4,0,25,21
1683322545470,USP 181,A00,187638,Staff,0,0,25,25
1683322546498,VIS 103,A00,187650,Cruz; Edwin Teddy,23,0,75,52
1683322547525,VIS 110D,A00,187669,Staff,12,0,22,10
1683322548549,VIS 127C,A00,187720,Shen; Kuiyi,68,0,146,78
1683322549573,VIS 149,A00,187731,Yoldas; Pinar,0,14,22,22
1683322550597,VIS 151,A01,188091,Staff,22,0,34,12
1683322550597,VIS 151,A02,188092,Staff,11,0,34,23
1683322551621,VIS 160B,A00,188093,Stalbaum; Brett,0,0,10,10
1683322553669,WCWP 10B,A00,201720,Staff,10,0,15,5
1683322553669,WCWP 10B,B00,201722,Staff,8,0,15,7
1683322554697,WCWP 100,A00,201725,Gagnon; Jeffrey C,0,0,2,2
1683322554697,WCWP 100,B00,201727,Staff,0,4,15,15
1683322557805,ANBI 133,A00,258401,Wilder; Linnea Lorene,34,0,40,6
1683322558829,ANBI 140,A00,258395,Hrvoj Mihic; Branka,18,0,25,7
1683322559856,ANSC 120,A00,258402,Bialecki; Jon Anthony,27,0,40,13
1683322560880,ANSC 144,A00,258400,Staff,14,0,40,26
1683322562937,ANSC 166,A00,258396,Parish; Steven Martin,157,0,175,18
1683322563960,ANSC 180,A00,193533,Staff,9,0,20,11
1683322564986,ANSC 188,A00,258397,Jassal; Aftab,33,0,40,7
1683322566010,ANTH 3,A01,258316,Staff,23,0,30,7
1683322567037,ANTH 5,A00,258394,Semendeferi; Ekaterini,16,0,20,4
1683322568061,ANTH 21,A01,258331,Staff,9,0,40,31
1683322569085,ANTH 103,A00,258398,Varma; Saiba,15,0,25,10
1683322570110,AWP 10,001,202034,Staff,0,0,0,0
1683322570110,AWP 10,002,202035,Staff,0,0,0,0
1683322570110,AWP 10,003,202036,Staff,0,0,0,0
1683322570110,AWP 10,004,202037,Staff,0,0,0,0
1683322570110,AWP 10,005,202038,Staff,0,0,0,0
1683322570110,AWP 10,006,202039,Staff,0,0,0,0
1683322570110,AWP 10,007,202040,Staff,0,0,0,0
1683322570110,AWP 10,008,202041,Staff,0,0,0,0
1683322570110,AWP 10,009,202042,Staff,0,0,0,0
1683322570110,AWP 10,010,202043,Staff,0,0,0,0
1683322570110,AWP 10,011,202044,Staff,0,0,0,0
1683322570110,AWP 10,012,202045,Staff,0,0,0,0
1683322570110,AWP 10,013,202046,Staff,0,0,0,0
1683322570110,AWP 10,014,202047,Staff,0,0,0,0
1683322570110,AWP 10,015,202048,Staff,0,0,0,0
1683322570110,AWP 10,016,202049,Staff,0,0,0,0
1683322570110,AWP 10,017,202050,Staff,0,0,0,0
1683322570110,AWP 10,018,202051,Staff,0,0,0,0
1683322570110,AWP 10,019,202052,Staff,0,0,0,0
1683322570110,AWP 10,020,202053,Staff,0,0,0,0
1683322570110,AWP 10,021,202054,Staff,0,0,0,0
1683322570110,AWP 10,022,202055,Staff,0,0,0,0
1683322570110,AWP 10,023,202056,Staff,0,0,0,0
1683322570110,AWP 10,024,202057,Staff,0,0,0,0
1683322570110,AWP 10,025,202058,Staff,0,0,0,0
1683322570110,AWP 10,026,202059,Staff,0,0,0,0
1683322571137,AWP 102,001,202032,Staff,0,0,0,0
1683322571137,AWP 102,002,202033,Staff,0,0,0,0
1683322572162,BENG 100,A01,254234,Taylor Amos; Alyssa C,31,0,40,9
1683322573185,BENG 196,001,270013,Engler; Adam J.,9999,0,9999,0
1683322574209,BICD 100R,A01,202018,Smith; Laurie,0,7,32,32
1683322574209,BICD 100R,A02,202019,Smith; Laurie,0,2,32,32
1683322574209,BICD 100R,A03,202020,Smith; Laurie,0,1,32,32
1683322574209,BICD 100R,A04,202021,Smith; Laurie,8,0,32,24
1683322574209,BICD 100R,A05,202022,Smith; Laurie,12,0,32,20
1683322575234,BICD 136,A01,193242,Gustafson-Brown; Cindy,0,2,32,32
1683322575234,BICD 136,A02,193244,Gustafson-Brown; Cindy,14,0,32,18
1683322576262,BIEB 102,A01,193249,Butler; Shannon Rhey,0,2,32,32
1683322576262,BIEB 102,A02,193251,Butler; Shannon Rhey,0,0,32,32
1683322576262,BIEB 102,A03,193253,Butler; Shannon Rhey,0,1,32,32
1683322576262,BIEB 102,A04,193255,Butler; Shannon Rhey,17,0,32,15
1683322576262,BIEB 102,A05,193265,Butler; Shannon Rhey,26,0,32,6
1683322576262,BIEB 102,A06,193269,Butler; Shannon Rhey,16,0,32,16
1683322578310,BIEB 150,A01,193274,Staff,0,0,32,32
1683322578310,BIEB 150,A02,193285,Staff,23,0,32,9
1683322579333,BIEB 194,A00,193286,Kurle; Carolyn M.,22,0,32,10
1683322580357,BILD 1,A01,192291,Staff,16,0,32,16
1683322580357,BILD 1,A02,192292,Staff,30,0,32,2
1683322580357,BILD 1,B01,192520,Reuther; Keefe,0,1,0,0
1683322580357,BILD 1,B02,192532,Reuther; Keefe,0,1,0,0
1683322581386,BILD 3,A01,192556,Butler; Shannon Rhey,0,0,32,32
1683322581386,BILD 3,A02,192581,Butler; Shannon Rhey,5,0,32,27
1683322581386,BILD 3,A03,192611,Butler; Shannon Rhey,23,0,32,9
1683322581386,BILD 3,A04,192612,Butler; Shannon Rhey,25,0,32,7
1683322581386,BILD 3,A05,192613,Butler; Shannon Rhey,27,0,32,5
1683322581386,BILD 3,A06,192679,Butler; Shannon Rhey,27,0,32,5
1683322581386,BILD 3,A07,192682,Butler; Shannon Rhey,22,0,32,10
1683322582414,BILD 4,A01,192836,Reuther; Keefe,0,0,24,24
1683322582414,BILD 4,A02,193044,Reuther; Keefe,4,0,24,20
1683322583437,BILD 10,A01,193142,Gustafson-Brown; Cindy,30,0,32,2
1683322583437,BILD 10,A02,193149,Gustafson-Brown; Cindy,31,0,32,1
1683322584464,BIMM 100,A01,193301,Staff,0,6,32,32
1683322584464,BIMM 100,A02,193312,Staff,0,5,32,32
1683322584464,BIMM 100,A03,193323,Staff,0,8,32,32
1683322585494,BIMM 101,A01,193329,McDonnell; Lisa Marie,0,3,24,24
1683322585494,BIMM 101,A02,193339,McDonnell; Lisa Marie,0,3,24,24
1683322585494,BIMM 101,B01,193354,McDonnell; Lisa Marie,0,3,24,24
1683322585494,BIMM 101,B02,193357,McDonnell; Lisa Marie,0,3,24,24
1683322586524,BIMM 110,A01,193377,Tat; John,0,11,32,32
1683322586524,BIMM 110,A02,193378,Tat; John,1,9,32,31
1683322587549,BIMM 120,A01,206116,Staff,0,0,32,32
1683322587549,BIMM 120,A02,206117,Staff,7,0,32,25
1683322587549,BIMM 120,A03,206121,Staff,21,0,32,11
1683322588574,BIPN 100,A01,193393,Park; Ji Young,0,14,32,32
1683322588574,BIPN 100,A02,193402,Park; Ji Young,0,12,32,32
1683322588574,BIPN 100,A03,193413,Park; Ji Young,0,14,32,32
1683322588574,BIPN 100,A04,193414,Park; Ji Young,0,13,32,32
1683322589602,BIPN 102,A01,193429,Staff,0,0,32,32
1683322589602,BIPN 102,A02,193438,Staff,22,0,32,10
1683322590628,BIPN 106,A01,193450,Reyes Gonzalez; Catalina,0,2,40,40
1683322591653,BIPN 134,A01,193465,Cooke; James Edward,0,0,32,32
1683322591653,BIPN 134,A02,193474,Cooke; James Edward,25,0,32,7
1683322591653,BIPN 134,A03,193485,Cooke; James Edward,29,0,32,3
1683322591653,BIPN 134,A04,193486,Cooke; James Edward,21,0,32,11
1683322591653,BIPN 134,A05,193491,Cooke; James Edward,31,0,32,1
1683322591653,BIPN 134,A06,193501,Cooke; James Edward,30,0,32,2
1683322591653,BIPN 134,A07,193510,Cooke; James Edward,29,0,32,3
1683322593701,BISP 194,A00,222522,Staff,14,0,32,18
1683322594725,CAT 124,A01,202407,Staff,20,0,25,5
1683322595748,CAT 125,A00,202408,Marchisotto; Jennifer Anne,4,0,20,16
1683322596771,CAT 125R,A00,202409,Smith; Lauryn Alissa,0,11,20,20
1683322596771,CAT 125R,B00,202410,Morales; Celeste Georgianna,0,11,20,20
1683322596771,CAT 125R,C00,202411,Irwin; Matthew Joseph,0,10,20,20
1683322597799,CENG 15,A01,204712,Yang; Kesong,0,1,0,0
1683322598824,CENG 114,A00,202070,Jahed Motlagh; Zeinab,5,0,20,15
1683322599852,CGS 105,A00,185477,Wesling; Megan E.,24,0,40,16
1683322600879,CGS 106,A00,185494,Staff,13,0,22,9
1683322601904,CGS 108,A00,185495,Staff,14,0,20,6
1683322602928,CGS 114,A00,185496,Staff,13,0,18,5
1683322603952,CGS 119,A00,185501,Staff,15,0,20,5
1683322604981,CGS 120,A00,185511,Staff,13,0,20,7
1683322606009,CHEM 4,A01,184675,Bussey; Thomas J,96,0,100,4
1683322607034,CHEM 6A,A01,184677,Staff,34,0,60,26
1683322608115,CHEM 6B,A01,184679,Staff,65,0,100,35
1683322609141,CHEM 6C,A01,184681,Bussey; Thomas J,1,0,50,49
1683322609141,CHEM 6C,A02,184682,Bussey; Thomas J,34,0,50,16
1683322610169,CHEM 40A,A01,184684,Albizati; Kim F.,37,0,100,63
1683322611193,CHEM 40B,A01,184686,Albizati; Kim F.,0,20,100,100
1683322612218,CHEM 41B,A01,184690,Staff,52,0,100,48
1683322613242,COGS 3,A01,184715,Boyle; Mary E. T.,0,25,40,40
1683322614267,COGS 14B,A01,185172,Staff,0,15,38,38
1683322615295,COGS 18,A01,184736,Staff,18,0,80,62
1683322616320,COGS 100,A01,184932,Staff,0,5,73,73
1683322617348,COGS 101A,A01,184935,Staff,0,38,30,30
1683322618371,COGS 101B,A01,184944,Staff,0,2,30,30
1683322619397,COGS 101C,A01,184946,Staff,0,12,30,30
1683322620421,COGS 102A,A01,184951,Johnson; Christine M.,2,0,40,38
1683322621446,COGS 107B,A01,184953,Mooshagian; Eric Frederick,0,50,40,40
1683322622476,COGS 118B,A01,184959,Gupta; Anjum,0,48,40,40
1683322623501,COGS 153,A00,184961,Staff,0,15,30,30
1683322624528,COGS 177,A00,184962,Staff,0,21,30,30
1683322625555,COGS 187A,A01,184969,Boyle; Mary E. T.,0,17,40,40
1683322626580,COMM 10,A01,185174,Staff,0,5,25,25
1683322626580,COMM 10,A02,185189,Staff,0,5,25,25
1683322626580,COMM 10,A03,269821,Staff,0,0,0,0
1683322627606,COMM 100B,A01,185475,Staff,0,0,0,2
1683322627606,COMM 100B,A02,185476,Staff,14,0,25,11
1683322628629,COMM 100C,A01,185314,Staff,1,0,25,24
1683322628629,COMM 100C,A02,185327,Staff,19,0,25,6
1683322629655,COMM 110M,A00,185349,Staff,2,0,40,38
1683322630679,COMM 113T,A00,185352,Staff,25,0,40,15
1683322631704,COMM 114I,A00,185353,Staff,33,0,40,7
1683322632728,COMM 131,A00,185354,Staff,19,0,30,11
1683322633755,CSE 8A,A50,185358,Cao; Yingjun,0,46,10,10
1683322634779,CSE 8B,A01,185362,Staff,1,47,50,49
1683322635802,CSE 11,A01,185416,Cao; Yingjun,0,92,10,10
1683322636830,CSE 20,A01,185445,Briones; Jor-el Thomas Caparas,5,0,25,20
1683322637857,CSE 21,A01,185447,Staff,10,0,50,40
1683322638882,CSE 101,A01,185451,Staff,0,12,50,50
1683322638882,CSE 101,B01,185453,Jones; Miles E,0,11,50,50
1683322640930,CSE 141,A01,185458,Eldon; John,20,0,100,80
1683322641954,CSE 141L,A01,185461,Eldon; John,12,0,100,88
1683322642980,CSE 142,A01,185463,Staff,36,0,60,24
1683322642980,CSE 142,B01,201355,Staff,0,7,60,60
1683322644007,CSE 142L,A01,185470,Staff,36,0,60,24
1683322644007,CSE 142L,B01,201417,Staff,0,6,60,60
1683322645036,CSE 190,A00,201433,Staff,32,0,49,17
1683322646062,DOC 1,A01,259136,Strom; Megan C.,7,0,15,8
1683322646062,DOC 1,A02,259137,Strom; Megan C.,14,0,15,1
1683322646062,DOC 1,A03,259138,Strom; Megan C.,14,0,15,1
1683322646062,DOC 1,A04,259139,Strom; Megan C.,14,0,15,1
1683322647090,DOC 100D,A00,259140,Pass; Natalye Joann,17,0,25,8
1683322648117,DSGN 1,A01,184749,Rill; Bryan,0,25,30,30
1683322649144,DSGN 100,A01,185168,Staff,0,2,25,25
1683322650172,ECE 5,A01,185626,Morris; Karcher William,0,10,0,0
1683322651195,ECE 101,A01,185628,Staff,17,0,70,53
1683322652219,ECE 107,A01,185635,Baghdadchi; Saharnaz,0,0,20,20
1683322652219,ECE 107,A02,185638,Baghdadchi; Saharnaz,4,0,20,16
1683322653246,ECE 148,A01,185647,Silberman; Jack,0,0,16,16
1683322654270,ECON 1,A01,185537,Crane; Meredith Helen,54,0,70,16
1683322655294,ECON 3,A01,185549,Crane; Meredith Helen,33,0,70,37
1683322656321,ECON 4,A01,203354,Anderson; John Charles,0,4,10,10
1683322657347,ECON 100A,A01,185574,Staff,0,4,40,40
1683322658376,ECON 100B,A01,185576,Staff,0,22,40,40
1683322659403,ECON 100C,A01,185589,Newhouse; Herbert S,30,0,70,40
1683322660427,ECON 105,A00,185608,Vespa; Emanuel Ignacio,19,0,35,16
1683322661452,ECON 109,A01,185610,Shishkin; Denis,10,0,35,25
1683322662478,ECON 110A,A01,185612,Staff,11,0,40,29
1683322663505,ECON 120A,A01,185615,Staff,20,0,40,20
1683322664532,ECON 120C,A01,185617,Sun; Yixiao,0,20,70,70
1683322665556,ECON 144,A00,203346,Squires; Dale E,3,0,35,32
1683322666583,ECON 171,A01,203349,Newhouse; Herbert S,0,1,35,35
1683322667607,ECON 173A,A01,185621,Toda; Alexis Akira,21,0,35,14
1683322668632,EDS 25,A01,202413,Staff,0,1,0,0
1683322668632,EDS 25,A02,202414,Staff,0,1,0,0
1683322668632,EDS 25,A03,202415,Staff,0,0,0,0
1683322668632,EDS 25,A04,202416,Staff,0,1,0,0
1683322668632,EDS 25,A05,202439,Staff,0,0,0,0
1683322668632,EDS 25,A06,202440,Staff,0,0,0,0
1683322668632,EDS 25,B01,202631,Staff,0,0,0,0
1683322668632,EDS 25,B02,202632,Staff,0,0,0,0
1683322668632,EDS 25,B03,202639,Staff,0,0,0,0
1683322668632,EDS 25,B04,202640,Staff,0,0,0,0
1683322668632,EDS 25,B05,202643,Staff,0,0,0,0
1683322668632,EDS 25,B06,202644,Staff,0,0,0,0
1683322669656,EDS 38,A01,202659,Black; Alison Michelle,24,0,25,1
1683322670681,EDS 115,A00,202652,Staff,17,0,30,13
1683322671706,EDS 125,A00,202649,Staff,14,0,30,16
1683322672731,EDS 126,A01,203332,Staff,30,0,30,0
1683322673756,EDS 139,A00,202838,Staff,16,0,25,9
1683322674782,EDS 146,A01,202655,Staff,14,0,25,11
1683322675806,ENG 15,A00,185667,Staff,0,1,0,0
1683322675806,ENG 15,B00,185672,Staff,0,0,0,0
1683322675806,ENG 15,C00,185675,Staff,0,0,0,0
1683322675806,ENG 15,D00,185682,Staff,0,0,0,0
1683322675806,ENG 15,E00,185684,Staff,0,0,0,0
1683322676833,ETHN 103,A00,185710,Staff,0,3,35,35
1683322677860,ETHN 103A,A00,199228,Man; Simeon S,2,0,9,7
1683322678884,ETHN 109,A00,185711,Staff,18,0,35,17
1683322679907,ETHN 142,A00,185726,Staff,0,4,30,30
1683322680935,ETHN 163J,A00,199229,Man; Simeon S,5,0,8,3
1683322681958,ETHN 168,A00,185727,Staff,8,0,10,2
1683322682984,ETHN 182,A00,185728,Staff,1,0,35,34
1683322684009,ETHN 183,A00,185737,Staff,8,0,18,10
1683322685035,GLBH 111,A01,209361,Burgos; Jose L.,0,0,0,0
1683322687086,HIEU 104,A00,185792,Staff,16,0,20,4
1683322688115,HIEU 115,A00,185800,Staff,1,0,20,19
1683322689142,HIEU 128,A00,185801,Staff,0,7,20,20
1683322690170,HIEU 147,A00,185802,Staff,16,0,20,4
1683322691203,HIEU 154,A00,185823,Staff,12,0,20,8
1683322692231,HILA 102,A00,185826,Staff,13,0,20,7
1683322693258,HILD 2C,A01,185778,Staff,0,12,20,20
1683322694284,HILD 7B,A01,185780,Kwak; Nancy,0,15,32,32
1683322694284,HILD 7B,A02,185781,Kwak; Nancy,0,18,32,32
1683322695310,HILD 30,A01,185791,Staff,14,0,20,6
1683322696334,HISC 119,A00,185830,Golan; Tal,0,9,20,20
1683322697363,HITO 156GS,A00,185831,Patterson; Patrick H.,0,0,0,23
1683322698387,HIUS 103,A00,185832,Man; Simeon S,0,6,20,20
1683322699410,HIUS 117,A00,185836,Kwak; Nancy,2,0,20,18
1683322700435,HIUS 125,A00,185840,Man; Simeon S,0,0,23,23
1683322701461,HIUS 149,A00,185845,Staff,0,0,20,20
1683322702487,HUM 3,A01,185882,Zavodny; Tatiana Sophia,0,6,50,50
1683322702487,HUM 3,B01,185899,Caldwell; Michael Alan,0,19,50,50
1683322703512,HUM 3GS,A00,185900,Patterson; Patrick H.,0,0,0,23
1683322704536,HUM 4,A01,185938,Zroka; Amy Liane,31,0,50,19
1683322704536,HUM 4,B01,185956,Watkins; Eric,0,2,50,50
1683322704536,HUM 4,B02,202209,Watkins; Eric,0,2,50,50
1683322704536,HUM 4,B03,202210,Watkins; Eric,0,0,50,50
1683322705563,HUM 5,A01,185958,West; Geoffrey Scott,3,0,50,47
1683322705563,HUM 5,A02,202215,West; Geoffrey Scott,0,0,50,50
1683322706587,INTL 190,A00,185959,Gagnon; Jeffrey C,0,0,0,9
1683322706587,INTL 190,B00,185960,Lettieri; Michael Joseph,0,0,0,1
1683322707611,JAPN 180,A00,254509,Staff,5,1,30,25
1683322708639,LATI 10,A01,202853,Kennemore; Amy Michelle,5,0,35,30
1683322708639,LATI 10,A02,202854,Kennemore; Amy Michelle,2,0,35,33
1683322708639,LATI 10,A03,270054,Kennemore; Amy Michelle,30,0,30,0
1683322709663,LATI 180,A00,202855,Kennemore; Amy Michelle,11,0,20,9
1683322710690,LAWS 101,A00,201767,Golan; Tal,0,7,40,40
1683322711769,LIFR 1C,A00,185961,Staff,6,0,20,14
1683322712792,LIFR 1CX,A00,185962,Staff,7,0,20,13
1683322713818,LIFR 1D,A00,185963,Staff,9,0,20,11
1683322714842,LIFR 1DX,A00,185964,Staff,9,0,20,11
1683322715869,LIGN 101,A01,186039,Staff,43,0,50,7
1683322716893,LIGN 165,A00,186040,Staff,18,0,50,32
1683322717918,LTCS 108,A00,186041,Staff,6,0,10,4
1683322718944,LTCS 119,A00,186042,Staff,16,0,20,4
1683322719969,LTCS 130,A00,186043,Wesling; Megan E.,15,0,25,10
1683322722020,LTEA 138,A00,186119,Staff,14,0,40,26
1683322723047,LTEN 124,A00,186148,Staff,6,0,25,19
1683322724075,LTEN 178,A00,186149,Staff,7,0,15,8
1683322725102,LTEN 181,A00,186150,Blanco; John D,33,0,40,7
1683322726125,LTWL 120,A00,186160,Staff,20,0,25,5
1683322727152,LTWL 165,A00,186161,Staff,22,0,25,3
1683322728179,LTWR 100,A00,186162,Staff,0,5,15,15
1683322729207,LTWR 102,A00,186163,Doller; Ben,5,0,15,10
1683322730230,MAE 8,A01,186412,Staff,0,0,0,0
1683322731255,MAE 30B,A00,186445,Bahadori; Mohammad Yousef,83,0,100,17
1683322732280,MAE 40,A00,186592,Bewley; Thomas R,9,0,50,41
1683322733306,MAE 101B,A00,186593,Bahadori; Mohammad Yousef,81,0,100,19
1683322734334,MAE 105,A00,186594,Bandaru; Prabhakar,12,0,50,38
1683322735358,MAE 107,A00,186599,Pham; Hieu Tan,0,6,120,120
1683322736382,MAE 148,A01,186660,Silberman; Jack,3,0,16,13
1683322737406,MATH 10A,A01,188095,Staff,0,6,35,35
1683322738432,MATH 10B,A01,188097,Bowers; Adam R.,0,11,30,30
1683322738432,MATH 10B,A02,188099,Bowers; Adam R.,0,11,30,30
1683322738432,MATH 10B,B01,188104,Bowers; Adam R.,0,10,30,30
1683322738432,MATH 10B,B02,188106,Bowers; Adam R.,0,10,30,30
1683322739456,MATH 10C,A01,188111,Staff,0,18,30,30
1683322739456,MATH 10C,A02,188127,Staff,0,17,30,30
1683322739456,MATH 10C,A03,188131,Staff,0,18,30,30
1683322739456,MATH 10C,B01,188218,Staff,18,0,30,12
1683322739456,MATH 10C,B02,188244,Staff,13,0,30,17
1683322739456,MATH 10C,B03,188277,Staff,16,0,30,14
1683322740480,MATH 18,A01,188344,Bach; Quang Tran,18,0,30,12
1683322740480,MATH 18,A02,188345,Bach; Quang Tran,11,0,30,19
1683322740480,MATH 18,B01,188353,Bach; Quang Tran,10,0,30,20
1683322740480,MATH 18,B02,188354,Bach; Quang Tran,20,0,30,10
1683322741506,MATH 20A,A01,188374,Staff,13,0,35,22
1683322742531,MATH 20B,A01,188382,Ohm; Ko Woon,6,0,30,24
1683322742531,MATH 20B,A02,188383,Ohm; Ko Woon,22,0,30,8
1683322742531,MATH 20B,B01,188385,Ohm; Ko Woon,7,0,30,23
1683322742531,MATH 20B,B02,188392,Ohm; Ko Woon,22,0,30,8
1683322743560,MATH 20C,A01,188394,Harel; Guershon,10,0,30,20
1683322743560,MATH 20C,A02,188395,Harel; Guershon,14,0,30,16
1683322743560,MATH 20C,B01,188404,Harel; Guershon,5,0,30,25
1683322743560,MATH 20C,B02,188405,Harel; Guershon,19,0,30,11
1683322744586,MATH 20D,A01,188414,Hammock; Frances H,0,1,30,30
1683322744586,MATH 20D,A02,188415,Hammock; Frances H,3,0,30,27
1683322744586,MATH 20D,B01,188447,Hammock; Frances H,2,0,30,28
1683322744586,MATH 20D,B02,188486,Hammock; Frances H,8,0,30,22
1683322745615,MATH 20E,A01,188649,Staff,21,0,30,9
1683322745615,MATH 20E,A02,188650,Staff,23,0,30,7
1683322745615,MATH 20E,A03,188673,Staff,0,0,30,30
1683322746638,MATH 102,A01,188675,Staff,0,35,35,35
1683322747663,MATH 103B,A01,188681,Staff,4,0,35,31
1683322747663,MATH 103B,B01,188692,Staff,5,0,35,30
1683322748688,MATH 109,A01,188695,Salehi Golsefidy; Alireza,25,0,35,10
1683322748688,MATH 109,A02,188696,Salehi Golsefidy; Alireza,26,0,35,9
1683322749712,MATH 120A,A01,188698,Eggers; John Dietrich,7,0,35,28
1683322750736,MATH 142B,A01,188736,Ioana; Adrian,0,2,30,30
1683322750736,MATH 142B,A02,188741,Ioana; Adrian,0,1,30,30
1683322750736,MATH 142B,A03,188743,Ioana; Adrian,1,3,30,29
1683322751763,MATH 168A,A01,188790,Staff,0,9,35,35
1683322752788,MATH 170A,A01,188803,Nie; Jiawang,0,2,35,35
1683322752788,MATH 170A,A02,188811,Nie; Jiawang,0,0,35,35
1683322752788,MATH 170A,A03,188814,Nie; Jiawang,0,0,35,35
1683322752788,MATH 170A,A04,188815,Nie; Jiawang,13,0,35,22
1683322753812,MATH 193B,A01,188817,Staff,0,0,35,35
1683322753812,MATH 193B,A02,188818,Staff,6,0,35,29
1683322754839,MGT 4,A01,202857,Anderson; John Charles,62,0,80,18
1683322755866,MGT 12,A00,202858,Lindenberger; Wade Douglas,42,0,90,48
1683322756891,MGT 18,A00,202859,Staff,74,0,90,16
1683322757914,MGT 18GS,A00,202860,McKay; Michael J,13,0,28,15
1683322758942,MGT 45,A00,202861,Pecore; Joseph P.,13,0,90,77
1683322759965,MGT 100,A00,202863,Yavorsky; Daniel Ryan,28,0,90,62
1683322760993,MGT 103,A00,202864,Ehrich; Kristine R,0,18,90,90
1683322762020,MGT 112,A00,202865,Ehrich; Kristine R,15,0,90,75
1683322763048,MGT 121A,A00,202868,Staff,0,20,0,0
1683322764073,MGT 131B,A00,202869,Anderson; John Charles,59,0,90,31
1683322765097,MGT 136,A00,202871,Lindenberger; Wade Douglas,84,0,90,6
1683322766124,MGT 164,A00,202873,Staff,0,68,90,91
1683322767149,MGT 164GS,A00,202874,McKay; Mary A,13,0,28,15
1683322768178,MGT 180,A00,202875,Staff,0,50,90,91
1683322769205,MMW 11R,A01,205019,Herbst; Matthew,3,0,30,27
1683322769205,MMW 11R,A02,205026,Herbst; Matthew,29,0,30,1
1683322770234,MMW 15,A01,193512,Chang; Edmond Yi-Teh,0,9,28,28
1683322770234,MMW 15,A02,193513,Chang; Edmond Yi-Teh,0,5,28,28
1683322770234,MMW 15,A03,193514,Chang; Edmond Yi-Teh,0,5,28,28
1683322770234,MMW 15,A04,193515,Chang; Edmond Yi-Teh,0,5,28,28
1683322770234,MMW 15,A05,193516,Chang; Edmond Yi-Teh,0,4,28,28
1683322770234,MMW 15,A06,193517,Chang; Edmond Yi-Teh,0,5,28,28
1683322770234,MMW 15,B01,193519,Chang; Edmond Yi-Teh,0,4,28,28
1683322770234,MMW 15,B02,193520,Chang; Edmond Yi-Teh,0,5,28,28
1683322770234,MMW 15,B03,193521,Chang; Edmond Yi-Teh,0,4,28,28
1683322770234,MMW 15,B04,193522,Chang; Edmond Yi-Teh,0,4,28,28
1683322770234,MMW 15,B05,193523,Chang; Edmond Yi-Teh,0,5,28,28
1683322770234,MMW 15,B06,193524,Chang; Edmond Yi-Teh,0,4,28,28
1683322771261,MMW 122,A01,193526,Rahimi; Babak,0,15,28,28
1683322771261,MMW 122,A02,193527,Rahimi; Babak,0,14,28,28
1683322771261,MMW 122,A03,193528,Rahimi; Babak,0,0,0,0
1683322771261,MMW 122,A04,193529,Rahimi; Babak,0,0,0,0
1683322772287,MUS 1A,A01,186663,Staff,0,20,35,35
1683322773312,MUS 4,A01,186715,Staff,0,12,35,35
1683322774335,MUS 5R,A01,186796,Dubnov; Shlomo,0,17,35,35
1683322775359,MUS 6,A01,186798,Staff,0,3,25,25
1683322776383,MUS 7,A01,186830,Staff,12,0,35,23
1683322777407,MUS 8,A01,186930,Staff,0,26,35,35
1683322778435,MUS 15,A01,186932,Staff,0,16,35,35
1683322778435,MUS 15,B01,186934,Staff,0,15,35,35
1683322779461,MUS 80,A00,186935,Staff,2,0,20,18
1683322779461,MUS 80,B00,186936,Staff,25,0,25,0
1683322780489,NANO 11,A00,204702,Lipomi; Darren John,0,0,0,0
1683322781512,NANO 15,A01,204709,Yang; Kesong,0,1,0,0
1683322782536,NANO 114,A00,202069,Jahed Motlagh; Zeinab,3,0,10,7
1683322783564,PHIL 1,A00,186955,Grush; Rick Scott,32,0,40,8
1683322784587,PHIL 10,A01,186973,Grush; Rick Scott,28,0,35,7
1683322784587,PHIL 10,A02,186974,Grush; Rick Scott,33,0,35,2
1683322785611,PHIL 13,A01,186976,Staff,7,0,35,28
1683322785611,PHIL 13,A02,186977,Staff,16,0,35,19
1683322786635,PHIL 14,A01,186979,Staff,31,0,35,4
1683322786635,PHIL 14,A02,186986,Staff,32,0,35,3
1683322787659,PHIL 28,A01,186988,Staff,16,0,30,14
1683322787659,PHIL 28,A02,186989,Staff,1,0,30,29
1683322787659,PHIL 28,A03,186990,Staff,9,0,30,21
1683322787659,PHIL 28,A04,186991,Staff,26,0,30,4
1683322788683,PHIL 120,A00,186997,Staff,23,0,40,17
1683322789707,PHIL 137,A00,187003,Staff,9,0,40,31
1683322790734,PHIL 150,A00,187015,Staff,47,0,70,23
1683322791761,PHIL 167,A00,187021,Lamey; Andy M.,35,0,40,5
1683322792789,PHIL 174,A01,202226,Staff,17,0,20,3
1683322792789,PHIL 174,A02,202235,Staff,20,0,20,0
1683322793815,PHIL 191A,A00,258918,Staff,0,0,1,1
1683322794839,PHYS 1A,A00,187028,Staff,27,0,60,33
1683322795865,PHYS 1AL,001,187036,Staff,3,0,30,27
1683322795865,PHYS 1AL,002,187049,Staff,18,0,30,12
1683322796889,PHYS 1B,A00,187058,Staff,22,0,60,38
1683322797917,PHYS 1BL,001,187064,Staff,0,0,30,30
1683322797917,PHYS 1BL,002,187070,Staff,5,0,30,25
1683322798941,PHYS 1C,A00,187082,Staff,31,0,120,89
1683322799966,PHYS 1CL,001,187088,Staff,0,9,30,30
1683322799966,PHYS 1CL,002,187089,Staff,0,2,30,30
1683322799966,PHYS 1CL,009,262693,Staff,11,0,30,19
1683322800990,PHYS 2B,A01,187097,Staff,54,0,115,61
1683322802015,PHYS 2C,A01,187099,Staff,67,0,115,48
1683322803040,PHYS 2CL,A01,187101,Staff,5,0,28,23
1683322803040,PHYS 2CL,A02,187102,Staff,15,0,28,13
1683322804069,PHYS 2D,A01,187123,Shotwell; Brian,95,0,115,20
1683322805096,PHYS 4B,A01,187133,Grinstein; Benjamin,35,0,50,15
1683322806123,POLI 10,A00,188819,Staff,0,4,50,50
1683322807150,POLI 11,A00,188827,Staff,43,0,50,7
1683322808174,POLI 13R,A00,188828,Staff,0,1,20,20
1683322809201,POLI 27,A01,188830,Elgin; Samuel Zincke,0,1,70,70
1683322810224,POLI 30,A00,188832,Desposato; Scott,31,0,50,19
1683322811247,POLI 102F,A00,188834,Staff,3,0,40,37
1683322812272,POLI 104A,A00,188852,Staff,14,0,30,16
1683322813298,POLI 104I,A00,188853,Staff,0,6,20,20
1683322814323,POLI 110B,A00,188854,Wiens; David,7,0,20,13
1683322815406,POLI 112A,A00,188855,Wiens; David,5,0,30,25
1683322816432,POLI 117R,A00,188856,Forman; Fonna,0,11,20,20
1683322817455,POLI 118,A00,188857,Ingham; Sean,8,0,20,12
1683322818479,POLI 120G,A00,188858,Staff,9,0,30,21
1683322819507,POLI 131CR,A00,188863,Hoston; Germaine,24,0,50,26
1683322820531,POLI 133,A00,188864,Nellis; Gareth Hb,44,0,50,6
1683322821558,POLI 134D,A00,188865,Desposato; Scott,27,0,30,3
1683322822585,POLI 142A,A00,188871,Gartzke; Erik,22,0,50,28
1683322823610,POLI 142K,A00,188874,Staff,38,0,50,12
1683322824633,POLI 143,A00,188940,Gartzke; Erik,16,0,30,14
1683322825660,POLI 153,A00,188943,Staff,3,0,20,17
1683322826684,POLI 160AA,A00,188944,Staff,12,0,40,28
1683322827711,POLI 170A,A00,188945,Staff,11,0,30,19
1683322829780,PSYC 1,A00,188952,Staff,37,0,90,53
1683322830804,PSYC 2,B00,188953,Staff,19,0,35,16
1683322831832,PSYC 6,A00,188970,Staff,47,0,60,13
1683322832857,PSYC 7,A00,188973,Staff,37,0,45,8
1683322833881,PSYC 60,A01,188980,Rickard; Timothy C.,43,0,60,17
1683322834906,PSYC 70,A01,189001,Steiner; Eric Tomas,24,0,45,21
1683322835930,PSYC 100,A00,189005,Lacefield; Katharine I,0,99,120,120
1683322836958,PSYC 102,A00,189008,Staff,10,0,30,20
1683322837982,PSYC 106,B00,189026,Gorman; Michael R.,35,0,60,25
1683322839009,PSYC 114,B01,189033,Winkielman; Piotr,0,32,30,30
1683322840036,PSYC 131,A00,189036,Anagnostaras; Stephan,0,43,60,60
1683322841063,PSYC 136,A00,189041,Lowe; Angela Beth,0,7,25,25
1683322842090,PSYC 137,A00,189057,Winkielman; Piotr,0,34,25,25
1683322843113,PSYC 144,A00,189107,Wixted; John T,0,7,50,50
1683322845163,PSYC 162,A00,189142,Staff,0,8,85,85
1683322846189,PSYC 172,A00,189144,Gorman; Michael R.,0,7,30,30
1683322848240,PSYC 179,A00,189146,Lacefield; Katharine I,0,84,120,120
1683322849265,PSYC 181,A00,189147,Anagnostaras; Stephan,0,44,90,90
1683322850292,PSYC 190R,A00,189148,Barner; David A.,0,22,80,80
1683322851318,PSYC 191,A00,189275,Rickard; Timothy C.,0,7,25,25
1683322852342,PSYC 193,A00,189276,Chapman; Eddie Nathaniel,0,1,0,4
1683322853370,PSYC 193L,A01,189281,Lowe; Angela Beth,12,0,20,8
1683322853370,PSYC 193L,B01,189285,Staff,28,0,35,7
1683322854394,RELI 149,A00,187137,Rahimi; Babak,7,0,40,33
1683322855420,SE 9,A01,187315,Staff,0,2,18,18
1683322856447,SE 101B,A00,187409,Staff,24,0,30,6
1683322857471,SE 110B,A00,187444,Staff,10,0,40,30
1683322858495,SE 130B,A00,187449,Staff,31,0,40,9
1683322859520,SE 150A,A00,187516,Staff,9,0,20,11
1683322860545,SE 154,A00,187528,Staff,30,0,50,20
1683322861569,SIO 3,A01,258171,Staff,35,0,40,5
1683322862599,SIO 10,A00,187144,Cook; Geoffrey W,0,3,75,75
1683322863626,SIO 45,A00,187152,Cook; Geoffrey W,1,0,100,99
1683322864651,SIO 109R,A00,194486,Staff,0,3,20,20
1683322866700,SIO 187,A01,187233,Kacev; David,12,0,40,28
1683322867729,SOCI 1,A01,258656,Thorpe; Charles Robert,28,0,30,2
1683322867729,SOCI 1,A02,258658,Thorpe; Charles Robert,30,0,30,0
1683322867729,SOCI 1,A03,258661,Thorpe; Charles Robert,25,0,25,0
1683322867729,SOCI 1,A04,258666,Thorpe; Charles Robert,22,0,25,3
1683322867729,SOCI 1,A05,258897,Thorpe; Charles Robert,23,0,25,2
1683322867729,SOCI 1,A06,258898,Thorpe; Charles Robert,25,0,25,0
1683322868754,SOCI 30,A01,258903,Pardo Guerra; Juan Pablo,16,0,30,14
1683322869779,SOCI 102,A00,258904,Staff,9,0,25,16
1683322870803,SOCI 106,A00,258905,Staff,19,0,25,6
1683322871830,SOCI 111,A00,258907,Ribas Norris; Janet Vanesa,26,0,30,4
1683322872857,SOCI 121R,A00,258908,Pardo Guerra; Juan Pablo,11,0,30,19
1683322873882,SOCI 126,A01,203330,Staff,14,0,20,6
1683322874910,SOCI 131,A00,258909,Thorpe; Charles Robert,31,0,60,29
1683322875935,SOCI 135,A00,258910,Payne; Christine Anna,0,9,30,30
1683322876957,SOCI 157,A00,258911,Staff,12,0,30,18
1683322877985,SOCI 184,A00,258912,Staff,25,0,30,5
1683322879009,SOCI 188D,A00,258913,Staff,21,0,30,9
1683322880037,SYN 2,001,187529,Staff,9,0,16,7
1683322880037,SYN 2,002,201452,Staff,0,18,16,16
1683322880037,SYN 2,003,201469,Staff,4,0,16,12
1683322881063,SYN 100,A01,187531,Staff,0,9,20,20
1683322881063,SYN 100,B01,201491,Staff,0,12,20,20
1683322882090,TDAC 1,A00,189286,Walsh; Kim C.,3,0,20,17
1683322882090,TDAC 1,B00,189287,Harting; Carla Kelso,11,0,20,9
1683322883117,TDAC 101,A00,189300,Walsh; Kim C.,16,0,20,4
1683322883117,TDAC 101,B00,189301,Harting; Carla Kelso,18,0,20,2
1683322884144,TDAC 102,A00,189304,Basso; Beatrice,14,0,20,6
1683322885168,TDAC 108,A00,189305,Staff,18,0,20,2
1683322886202,TDDE 131,A00,189310,Staff,19,0,20,1
1683322886202,TDDE 131,B00,189314,Staff,19,0,20,1
1683322886202,TDDE 131,C00,189315,Staff,48,0,50,2
1683322886202,TDDE 131,D00,189316,Staff,14,0,15,1
1683322886202,TDDE 131,E00,204841,Staff,20,0,20,0
1683322887230,TDGE 10,A00,189289,Staff,30,0,50,20
1683322887230,TDGE 10,B00,189290,Havis; Allan,1,0,50,49
1683322888256,TDGE 11,A00,189291,Fulton; Julia,0,3,50,50
1683322888256,TDGE 11,B00,189292,Staff,20,0,25,5
1683322888256,TDGE 11,C00,260270,Staff,0,0,0,0
1683322889283,TDGE 25,A00,189294,Staff,3,0,20,17
1683322890308,TDGE 124,A00,189318,Fulton; Julia,0,8,50,50
1683322891333,TDGE 125,A00,189319,Staff,13,0,25,12
1683322891333,TDGE 125,B00,189320,Staff,23,0,25,2
1683322892357,TDGE 127,A00,189322,Havis; Allan,0,0,50,50
1683322893381,TDHT 101,A00,189323,Staff,18,0,25,7
1683322893381,TDHT 101,B00,189324,Staff,25,0,25,0
1683322894407,TDHT 102,A00,189325,Staff,49,0,50,1
1683322895435,TDMV 1,A00,189295,Arcidiacono; Kristin,19,0,30,11
1683322895435,TDMV 1,B00,189296,Caligagan; Maria T.,24,0,30,6
1683322896477,TDMV 2,A00,189297,Sammartano; Tonnie,28,0,30,2
1683322896477,TDMV 2,B00,189299,Arcidiacono; Kristin,24,0,30,6
1683322897503,TDMV 3,A00,204998,Rincon; Alicia,22,0,30,8
1683322898527,TDMV 120,A00,189458,Sammartano; Tonnie,28,0,30,2
1683322899554,TDMV 138,A00,189541,Jun; Grace Shin Hae,22,0,40,18
1683322900578,TDMV 142,A00,189717,Caligagan; Tony,23,0,30,7
1683322900578,TDMV 142,B00,189718,Caligagan; Maria T.,25,0,30,5
1683322901602,TMC 2,A01,187533,Staff,25,0,25,0
1683322901602,TMC 2,A02,187534,Staff,25,0,25,0
1683322902629,USP 1,A01,187536,Kwak; Nancy,0,16,25,25
1683322903656,USP 5,A01,187538,Staff,9,0,25,16
1683322904680,USP 101,A00,199253,Staff,0,4,0,0
1683322905707,USP 124,A00,187562,Boomhower; Matthew Charles,1,0,30,29
1683322906734,USP 138,A00,187582,Staff,20,0,25,5
1683322907759,USP 152,A01,187597,Staff,4,0,25,21
1683322908786,USP 153,A00,187598,Staff,19,0,25,6
1683322909810,USP 168,A00,187607,Kwak; Nancy,2,0,5,3
1683322910837,USP 173,A00,187619,Staff,4,0,25,21
1683322911861,USP 181,A00,187638,Staff,0,0,25,25
1683322912889,VIS 103,A00,187650,Cruz; Edwin Teddy,23,0,75,52
1683322913915,VIS 110D,A00,187669,Staff,12,0,22,10
1683322914939,VIS 127C,A00,187720,Shen; Kuiyi,68,0,146,78
1683322915964,VIS 149,A00,187731,Yoldas; Pinar,0,14,22,22
1683322916988,VIS 151,A01,188091,Staff,22,0,34,12
1683322916988,VIS 151,A02,188092,Staff,11,0,34,23
1683322918016,VIS 160B,A00,188093,Stalbaum; Brett,0,0,10,10
1683322920121,WCWP 10B,A00,201720,Staff,10,0,15,5
1683322920121,WCWP 10B,B00,201722,Staff,8,0,15,7
1683322921146,WCWP 100,A00,201725,Gagnon; Jeffrey C,0,0,2,2
1683322921146,WCWP 100,B00,201727,Staff,0,4,15,15
1683322924300,ANBI 133,A00,258401,Wilder; Linnea Lorene,34,0,40,6
1683322925323,ANBI 140,A00,258395,Hrvoj Mihic; Branka,18,0,25,7
1683322926349,ANSC 120,A00,258402,Bialecki; Jon Anthony,27,0,40,13
1683322927375,ANSC 144,A00,258400,Staff,14,0,40,26
1683322929429,ANSC 166,A00,258396,Parish; Steven Martin,157,0,175,18
1683322930452,ANSC 180,A00,193533,Staff,9,0,20,11
1683322931483,ANSC 188,A00,258397,Jassal; Aftab,33,0,40,7
1683322932507,ANTH 3,A01,258316,Staff,23,0,30,7
1683322933534,ANTH 5,A00,258394,Semendeferi; Ekaterini,16,0,20,4
1683322934560,ANTH 21,A01,258331,Staff,9,0,40,31
1683322935585,ANTH 103,A00,258398,Varma; Saiba,15,0,25,10
1683322936613,AWP 10,001,202034,Staff,0,0,0,0
1683322936613,AWP 10,002,202035,Staff,0,0,0,0
1683322936613,AWP 10,003,202036,Staff,0,0,0,0
1683322936613,AWP 10,004,202037,Staff,0,0,0,0
1683322936613,AWP 10,005,202038,Staff,0,0,0,0
1683322936613,AWP 10,006,202039,Staff,0,0,0,0
1683322936613,AWP 10,007,202040,Staff,0,0,0,0
1683322936613,AWP 10,008,202041,Staff,0,0,0,0
1683322936613,AWP 10,009,202042,Staff,0,0,0,0
1683322936613,AWP 10,010,202043,Staff,0,0,0,0
1683322936613,AWP 10,011,202044,Staff,0,0,0,0
1683322936613,AWP 10,012,202045,Staff,0,0,0,0
1683322936613,AWP 10,013,202046,Staff,0,0,0,0
1683322936613,AWP 10,014,202047,Staff,0,0,0,0
1683322936613,AWP 10,015,202048,Staff,0,0,0,0
1683322936613,AWP 10,016,202049,Staff,0,0,0,0
1683322936613,AWP 10,017,202050,Staff,0,0,0,0
1683322936613,AWP 10,018,202051,Staff,0,0,0,0
1683322936613,AWP 10,019,202052,Staff,0,0,0,0
1683322936613,AWP 10,020,202053,Staff,0,0,0,0
1683322936613,AWP 10,021,202054,Staff,0,0,0,0
1683322936613,AWP 10,022,202055,Staff,0,0,0,0
1683322936613,AWP 10,023,202056,Staff,0,0,0,0
1683322936613,AWP 10,024,202057,Staff,0,0,0,0
1683322936613,AWP 10,025,202058,Staff,0,0,0,0
1683322936613,AWP 10,026,202059,Staff,0,0,0,0
1683322937637,AWP 102,001,202032,Staff,0,0,0,0
1683322937637,AWP 102,002,202033,Staff,0,0,0,0
1683322938662,BENG 100,A01,254234,Taylor Amos; Alyssa C,31,0,40,9
1683322939687,BENG 196,001,270013,Engler; Adam J.,9999,0,9999,0
1683322940713,BICD 100R,A01,202018,Smith; Laurie,0,7,32,32
1683322940713,BICD 100R,A02,202019,Smith; Laurie,0,2,32,32
1683322940713,BICD 100R,A03,202020,Smith; Laurie,0,1,32,32
1683322940713,BICD 100R,A04,202021,Smith; Laurie,8,0,32,24
1683322940713,BICD 100R,A05,202022,Smith; Laurie,12,0,32,20
1683322941737,BICD 136,A01,193242,Gustafson-Brown; Cindy,0,2,32,32
1683322941737,BICD 136,A02,193244,Gustafson-Brown; Cindy,14,0,32,18
1683322942764,BIEB 102,A01,193249,Butler; Shannon Rhey,0,2,32,32
1683322942764,BIEB 102,A02,193251,Butler; Shannon Rhey,0,0,32,32
1683322942764,BIEB 102,A03,193253,Butler; Shannon Rhey,0,1,32,32
1683322942764,BIEB 102,A04,193255,Butler; Shannon Rhey,17,0,32,15
1683322942764,BIEB 102,A05,193265,Butler; Shannon Rhey,26,0,32,6
1683322942764,BIEB 102,A06,193269,Butler; Shannon Rhey,16,0,32,16
1683322944815,BIEB 150,A01,193274,Staff,0,0,32,32
1683322944815,BIEB 150,A02,193285,Staff,23,0,32,9
1683322945844,BIEB 194,A00,193286,Kurle; Carolyn M.,22,0,32,10
1683322946873,BILD 1,A01,192291,Staff,16,0,32,16
1683322946873,BILD 1,A02,192292,Staff,30,0,32,2
1683322946873,BILD 1,B01,192520,Reuther; Keefe,0,1,0,0
1683322946873,BILD 1,B02,192532,Reuther; Keefe,0,1,0,0
1683322947903,BILD 3,A01,192556,Butler; Shannon Rhey,0,0,32,32
1683322947903,BILD 3,A02,192581,Butler; Shannon Rhey,5,0,32,27
1683322947903,BILD 3,A03,192611,Butler; Shannon Rhey,23,0,32,9
1683322947903,BILD 3,A04,192612,Butler; Shannon Rhey,25,0,32,7
1683322947903,BILD 3,A05,192613,Butler; Shannon Rhey,27,0,32,5
1683322947903,BILD 3,A06,192679,Butler; Shannon Rhey,27,0,32,5
1683322947903,BILD 3,A07,192682,Butler; Shannon Rhey,22,0,32,10
1683322948933,BILD 4,A01,192836,Reuther; Keefe,0,0,24,24
1683322948933,BILD 4,A02,193044,Reuther; Keefe,4,0,24,20
1683322949961,BILD 10,A01,193142,Gustafson-Brown; Cindy,30,0,32,2
1683322949961,BILD 10,A02,193149,Gustafson-Brown; Cindy,31,0,32,1
1683322950988,BIMM 100,A01,193301,Staff,0,6,32,32
1683322950988,BIMM 100,A02,193312,Staff,0,5,32,32
1683322950988,BIMM 100,A03,193323,Staff,0,8,32,32
1683322952014,BIMM 101,A01,193329,McDonnell; Lisa Marie,0,3,24,24
1683322952014,BIMM 101,A02,193339,McDonnell; Lisa Marie,0,3,24,24
1683322952014,BIMM 101,B01,193354,McDonnell; Lisa Marie,0,3,24,24
1683322952014,BIMM 101,B02,193357,McDonnell; Lisa Marie,0,3,24,24
1683322953042,BIMM 110,A01,193377,Tat; John,0,11,32,32
1683322953042,BIMM 110,A02,193378,Tat; John,1,9,32,31
1683322954071,BIMM 120,A01,206116,Staff,0,0,32,32
1683322954071,BIMM 120,A02,206117,Staff,7,0,32,25
1683322954071,BIMM 120,A03,206121,Staff,21,0,32,11
1683322955095,BIPN 100,A01,193393,Park; Ji Young,0,14,32,32
1683322955095,BIPN 100,A02,193402,Park; Ji Young,0,12,32,32
1683322955095,BIPN 100,A03,193413,Park; Ji Young,0,14,32,32
1683322955095,BIPN 100,A04,193414,Park; Ji Young,0,13,32,32
1683322956123,BIPN 102,A01,193429,Staff,0,0,32,32
1683322956123,BIPN 102,A02,193438,Staff,22,0,32,10
1683322957151,BIPN 106,A01,193450,Reyes Gonzalez; Catalina,0,2,40,40
1683322958177,BIPN 134,A01,193465,Cooke; James Edward,0,0,32,32
1683322958177,BIPN 134,A02,193474,Cooke; James Edward,25,0,32,7
1683322958177,BIPN 134,A03,193485,Cooke; James Edward,29,0,32,3
1683322958177,BIPN 134,A04,193486,Cooke; James Edward,21,0,32,11
1683322958177,BIPN 134,A05,193491,Cooke; James Edward,31,0,32,1
1683322958177,BIPN 134,A06,193501,Cooke; James Edward,30,0,32,2
1683322958177,BIPN 134,A07,193510,Cooke; James Edward,29,0,32,3
1683322960227,BISP 194,A00,222522,Staff,14,0,32,18
1683322961255,CAT 124,A01,202407,Staff,20,0,25,5
1683322962282,CAT 125,A00,202408,Marchisotto; Jennifer Anne,4,0,20,16
1683322963311,CAT 125R,A00,202409,Smith; Lauryn Alissa,0,11,20,20
1683322963311,CAT 125R,B00,202410,Morales; Celeste Georgianna,0,11,20,20
1683322963311,CAT 125R,C00,202411,Irwin; Matthew Joseph,0,10,20,20
1683322964339,CENG 15,A01,204712,Yang; Kesong,0,1,0,0
1683322965363,CENG 114,A00,202070,Jahed Motlagh; Zeinab,5,0,20,15
1683322966387,CGS 105,A00,185477,Wesling; Megan E.,24,0,40,16
1683322967411,CGS 106,A00,185494,Staff,13,0,22,9
1683322968466,CGS 108,A00,185495,Staff,14,0,20,6
1683322969489,CGS 114,A00,185496,Staff,13,0,18,5
1683322970517,CGS 119,A00,185501,Staff,15,0,20,5
1683322971543,CGS 120,A00,185511,Staff,13,0,20,7
1683322972568,CHEM 4,A01,184675,Bussey; Thomas J,96,0,100,4
1683322973594,CHEM 6A,A01,184677,Staff,34,0,60,26
1683322974619,CHEM 6B,A01,184679,Staff,65,0,100,35
1683322975644,CHEM 6C,A01,184681,Bussey; Thomas J,1,0,50,49
1683322975644,CHEM 6C,A02,184682,Bussey; Thomas J,34,0,50,16
1683322976668,CHEM 40A,A01,184684,Albizati; Kim F.,37,0,100,63
1683322977695,CHEM 40B,A01,184686,Albizati; Kim F.,0,20,100,100
1683322978718,CHEM 41B,A01,184690,Staff,52,0,100,48
1683322979746,COGS 3,A01,184715,Boyle; Mary E. T.,0,25,40,40
1683322980770,COGS 14B,A01,185172,Staff,0,15,38,38
1683322981795,COGS 18,A01,184736,Staff,18,0,80,62
1683322982828,COGS 100,A01,184932,Staff,0,5,73,73
1683322983863,COGS 101A,A01,184935,Staff,0,38,30,30
1683322984887,COGS 101B,A01,184944,Staff,0,2,30,30
1683322985912,COGS 101C,A01,184946,Staff,0,12,30,30
1683322986940,COGS 102A,A01,184951,Johnson; Christine M.,2,0,40,38
1683322987965,COGS 107B,A01,184953,Mooshagian; Eric Frederick,0,50,40,40
1683322988992,COGS 118B,A01,184959,Gupta; Anjum,0,48,40,40
1683322990019,COGS 153,A00,184961,Staff,0,15,30,30
1683322991044,COGS 177,A00,184962,Staff,0,21,30,30
1683322992072,COGS 187A,A01,184969,Boyle; Mary E. T.,0,17,40,40
1683322993098,COMM 10,A01,185174,Staff,0,5,25,25
1683322993098,COMM 10,A02,185189,Staff,0,5,25,25
1683322993098,COMM 10,A03,269821,Staff,0,0,0,0
1683322994124,COMM 100B,A01,185475,Staff,0,0,0,2
1683322994124,COMM 100B,A02,185476,Staff,14,0,25,11
1683322995148,COMM 100C,A01,185314,Staff,1,0,25,24
1683322995148,COMM 100C,A02,185327,Staff,19,0,25,6
1683322996171,COMM 110M,A00,185349,Staff,2,0,40,38
1683322997198,COMM 113T,A00,185352,Staff,25,0,40,15
1683322998225,COMM 114I,A00,185353,Staff,33,0,40,7
1683322999248,COMM 131,A00,185354,Staff,19,0,30,11
1683323000272,CSE 8A,A50,185358,Cao; Yingjun,0,46,10,10
1683323001297,CSE 8B,A01,185362,Staff,1,47,50,49
1683323002321,CSE 11,A01,185416,Cao; Yingjun,0,92,10,10
1683323003348,CSE 20,A01,185445,Briones; Jor-el Thomas Caparas,5,0,25,20
1683323004373,CSE 21,A01,185447,Staff,10,0,50,40
1683323005395,CSE 101,A01,185451,Staff,0,12,50,50
1683323005395,CSE 101,B01,185453,Jones; Miles E,0,11,50,50
1683323007446,CSE 141,A01,185458,Eldon; John,20,0,100,80
1683323008471,CSE 141L,A01,185461,Eldon; John,12,0,100,88
1683323009498,CSE 142,A01,185463,Staff,36,0,60,24
1683323009498,CSE 142,B01,201355,Staff,0,7,60,60
1683323010522,CSE 142L,A01,185470,Staff,36,0,60,24
1683323010522,CSE 142L,B01,201417,Staff,0,6,60,60
1683323011546,CSE 190,A00,201433,Staff,32,0,49,17
1683323012574,DOC 1,A01,259136,Strom; Megan C.,7,0,15,8
1683323012574,DOC 1,A02,259137,Strom; Megan C.,14,0,15,1
1683323012574,DOC 1,A03,259138,Strom; Megan C.,14,0,15,1
1683323012574,DOC 1,A04,259139,Strom; Megan C.,14,0,15,1
1683323013602,DOC 100D,A00,259140,Pass; Natalye Joann,17,0,25,8
1683323014630,DSGN 1,A01,184749,Rill; Bryan,0,25,30,30
1683323015654,DSGN 100,A01,185168,Staff,0,2,25,25
1683323016678,ECE 5,A01,185626,Morris; Karcher William,0,10,0,0
1683323017701,ECE 101,A01,185628,Staff,17,0,70,53
1683323018724,ECE 107,A01,185635,Baghdadchi; Saharnaz,0,0,20,20
1683323018724,ECE 107,A02,185638,Baghdadchi; Saharnaz,4,0,20,16
1683323019750,ECE 148,A01,185647,Silberman; Jack,0,0,16,16
1683323020774,ECON 1,A01,185537,Crane; Meredith Helen,54,0,70,16
1683323021799,ECON 3,A01,185549,Crane; Meredith Helen,33,0,70,37
1683323022881,ECON 4,A01,203354,Anderson; John Charles,0,4,10,10
1683323023925,ECON 100A,A01,185574,Staff,0,4,40,40
1683323024949,ECON 100B,A01,185576,Staff,0,22,40,40
1683323025973,ECON 100C,A01,185589,Newhouse; Herbert S,30,0,70,40
1683323026998,ECON 105,A00,185608,Vespa; Emanuel Ignacio,19,0,35,16
1683323028026,ECON 109,A01,185610,Shishkin; Denis,10,0,35,25
1683323029052,ECON 110A,A01,185612,Staff,11,0,40,29
1683323030080,ECON 120A,A01,185615,Staff,20,0,40,20
1683323031103,ECON 120C,A01,185617,Sun; Yixiao,0,20,70,70
1683323032128,ECON 144,A00,203346,Squires; Dale E,3,0,35,32
1683323033155,ECON 171,A01,203349,Newhouse; Herbert S,0,1,35,35
1683323034183,ECON 173A,A01,185621,Toda; Alexis Akira,21,0,35,14
1683323035209,EDS 25,A01,202413,Staff,0,1,0,0
1683323035209,EDS 25,A02,202414,Staff,0,1,0,0
1683323035209,EDS 25,A03,202415,Staff,0,0,0,0
1683323035209,EDS 25,A04,202416,Staff,0,1,0,0
1683323035209,EDS 25,A05,202439,Staff,0,0,0,0
1683323035209,EDS 25,A06,202440,Staff,0,0,0,0
1683323035209,EDS 25,B01,202631,Staff,0,0,0,0
1683323035209,EDS 25,B02,202632,Staff,0,0,0,0
1683323035209,EDS 25,B03,202639,Staff,0,0,0,0
1683323035209,EDS 25,B04,202640,Staff,0,0,0,0
1683323035209,EDS 25,B05,202643,Staff,0,0,0,0
1683323035209,EDS 25,B06,202644,Staff,0,0,0,0
1683323036237,EDS 38,A01,202659,Black; Alison Michelle,24,0,25,1
1683323037260,EDS 115,A00,202652,Staff,17,0,30,13
1683323038282,EDS 125,A00,202649,Staff,14,0,30,16
1683323039309,EDS 126,A01,203332,Staff,30,0,30,0
1683323040335,EDS 139,A00,202838,Staff,16,0,25,9
1683323041360,EDS 146,A01,202655,Staff,14,0,25,11
1683323042384,ENG 15,A00,185667,Staff,0,1,0,0
1683323042384,ENG 15,B00,185672,Staff,0,0,0,0
1683323042384,ENG 15,C00,185675,Staff,0,0,0,0
1683323042384,ENG 15,D00,185682,Staff,0,0,0,0
1683323042384,ENG 15,E00,185684,Staff,0,0,0,0
1683323043412,ETHN 103,A00,185710,Staff,0,3,35,35
1683323044436,ETHN 103A,A00,199228,Man; Simeon S,2,0,9,7
1683323045460,ETHN 109,A00,185711,Staff,18,0,35,17
1683323046487,ETHN 142,A00,185726,Staff,0,4,30,30
1683323047515,ETHN 163J,A00,199229,Man; Simeon S,5,0,8,3
1683323048539,ETHN 168,A00,185727,Staff,8,0,10,2
1683323049566,ETHN 182,A00,185728,Staff,1,0,35,34
1683323050590,ETHN 183,A00,185737,Staff,8,0,18,10
1683323051617,GLBH 111,A01,209361,Burgos; Jose L.,0,0,0,0
1683323053665,HIEU 104,A00,185792,Staff,16,0,20,4
1683323054692,HIEU 115,A00,185800,Staff,1,0,20,19
1683323055718,HIEU 128,A00,185801,Staff,0,7,20,20
1683323056746,HIEU 147,A00,185802,Staff,16,0,20,4
1683323057769,HIEU 154,A00,185823,Staff,12,0,20,8
1683323058794,HILA 102,A00,185826,Staff,13,0,20,7
1683323059819,HILD 2C,A01,185778,Staff,0,12,20,20
1683323060846,HILD 7B,A01,185780,Kwak; Nancy,0,15,32,32
1683323060846,HILD 7B,A02,185781,Kwak; Nancy,0,18,32,32
1683323061871,HILD 30,A01,185791,Staff,14,0,20,6
1683323062895,HISC 119,A00,185830,Golan; Tal,0,9,20,20
1683323063918,HITO 156GS,A00,185831,Patterson; Patrick H.,0,0,0,23
1683323064947,HIUS 103,A00,185832,Man; Simeon S,0,6,20,20
1683323065971,HIUS 117,A00,185836,Kwak; Nancy,2,0,20,18
1683323066996,HIUS 125,A00,185840,Man; Simeon S,0,0,23,23
1683323068021,HIUS 149,A00,185845,Staff,0,0,20,20
1683323069048,HUM 3,A01,185882,Zavodny; Tatiana Sophia,0,6,50,50
1683323069048,HUM 3,B01,185899,Caldwell; Michael Alan,0,19,50,50
1683323070072,HUM 3GS,A00,185900,Patterson; Patrick H.,0,0,0,23
1683323071096,HUM 4,A01,185938,Zroka; Amy Liane,31,0,50,19
1683323071096,HUM 4,B01,185956,Watkins; Eric,0,2,50,50
1683323071096,HUM 4,B02,202209,Watkins; Eric,0,2,50,50
1683323071096,HUM 4,B03,202210,Watkins; Eric,0,1,50,50
1683323072119,HUM 5,A01,185958,West; Geoffrey Scott,3,0,50,47
1683323072119,HUM 5,A02,202215,West; Geoffrey Scott,0,0,50,50
1683323073146,INTL 190,A00,185959,Gagnon; Jeffrey C,0,0,0,9
1683323073146,INTL 190,B00,185960,Lettieri; Michael Joseph,0,0,0,1
1683323074169,JAPN 180,A00,254509,Staff,5,1,30,25
1683323075198,LATI 10,A01,202853,Kennemore; Amy Michelle,5,0,35,30
1683323075198,LATI 10,A02,202854,Kennemore; Amy Michelle,2,0,35,33
1683323075198,LATI 10,A03,270054,Kennemore; Amy Michelle,30,0,30,0
1683323076224,LATI 180,A00,202855,Kennemore; Amy Michelle,11,0,20,9
1683323077247,LAWS 101,A00,201767,Golan; Tal,0,7,40,40
1683323078271,LIFR 1C,A00,185961,Staff,6,0,20,14
1683323079295,LIFR 1CX,A00,185962,Staff,7,0,20,13
1683323080319,LIFR 1D,A00,185963,Staff,9,0,20,11
1683323081343,LIFR 1DX,A00,185964,Staff,9,0,20,11
1683323082367,LIGN 101,A01,186039,Staff,43,0,50,7
1683323083392,LIGN 165,A00,186040,Staff,18,0,50,32
1683323084416,LTCS 108,A00,186041,Staff,6,0,10,4
1683323085440,LTCS 119,A00,186042,Staff,16,0,20,4
1683323086464,LTCS 130,A00,186043,Wesling; Megan E.,15,0,25,10
1683323088517,LTEA 138,A00,186119,Staff,14,0,40,26
1683323089542,LTEN 124,A00,186148,Staff,6,0,25,19
1683323090567,LTEN 178,A00,186149,Staff,7,0,15,8
1683323091594,LTEN 181,A00,186150,Blanco; John D,33,0,40,7
1683323092616,LTWL 120,A00,186160,Staff,20,0,25,5
1683323093640,LTWL 165,A00,186161,Staff,22,0,25,3
1683323094664,LTWR 100,A00,186162,Staff,0,5,15,15
1683323095688,LTWR 102,A00,186163,Doller; Ben,5,0,15,10
1683323096717,MAE 8,A01,186412,Staff,0,0,0,0
1683323097741,MAE 30B,A00,186445,Bahadori; Mohammad Yousef,83,0,100,17
1683323098765,MAE 40,A00,186592,Bewley; Thomas R,9,0,50,41
1683323099792,MAE 101B,A00,186593,Bahadori; Mohammad Yousef,81,0,100,19
1683323100817,MAE 105,A00,186594,Bandaru; Prabhakar,12,0,50,38
1683323101846,MAE 107,A00,186599,Pham; Hieu Tan,0,6,120,120
1683323102869,MAE 148,A01,186660,Silberman; Jack,3,0,16,13
1683323103894,MATH 10A,A01,188095,Staff,0,6,35,35
1683323104918,MATH 10B,A01,188097,Bowers; Adam R.,0,11,30,30
1683323104918,MATH 10B,A02,188099,Bowers; Adam R.,0,11,30,30
1683323104918,MATH 10B,B01,188104,Bowers; Adam R.,0,10,30,30
1683323104918,MATH 10B,B02,188106,Bowers; Adam R.,0,10,30,30
1683323105943,MATH 10C,A01,188111,Staff,0,18,30,30
1683323105943,MATH 10C,A02,188127,Staff,0,17,30,30
1683323105943,MATH 10C,A03,188131,Staff,0,18,30,30
1683323105943,MATH 10C,B01,188218,Staff,18,0,30,12
1683323105943,MATH 10C,B02,188244,Staff,13,0,30,17
1683323105943,MATH 10C,B03,188277,Staff,16,0,30,14
1683323106968,MATH 18,A01,188344,Bach; Quang Tran,18,0,30,12
1683323106968,MATH 18,A02,188345,Bach; Quang Tran,11,0,30,19
1683323106968,MATH 18,B01,188353,Bach; Quang Tran,10,0,30,20
1683323106968,MATH 18,B02,188354,Bach; Quang Tran,20,0,30,10
1683323107997,MATH 20A,A01,188374,Staff,13,0,35,22
1683323109025,MATH 20B,A01,188382,Ohm; Ko Woon,6,0,30,24
1683323109025,MATH 20B,A02,188383,Ohm; Ko Woon,22,0,30,8
1683323109025,MATH 20B,B01,188385,Ohm; Ko Woon,7,0,30,23
1683323109025,MATH 20B,B02,188392,Ohm; Ko Woon,22,0,30,8
1683323110054,MATH 20C,A01,188394,Harel; Guershon,10,0,30,20
1683323110054,MATH 20C,A02,188395,Harel; Guershon,14,0,30,16
1683323110054,MATH 20C,B01,188404,Harel; Guershon,5,0,30,25
1683323110054,MATH 20C,B02,188405,Harel; Guershon,19,0,30,11
1683323111078,MATH 20D,A01,188414,Hammock; Frances H,0,1,30,30
1683323111078,MATH 20D,A02,188415,Hammock; Frances H,3,0,30,27
1683323111078,MATH 20D,B01,188447,Hammock; Frances H,2,0,30,28
1683323111078,MATH 20D,B02,188486,Hammock; Frances H,8,0,30,22
1683323112104,MATH 20E,A01,188649,Staff,21,0,30,9
1683323112104,MATH 20E,A02,188650,Staff,23,0,30,7
1683323112104,MATH 20E,A03,188673,Staff,0,0,30,30
1683323113128,MATH 102,A01,188675,Staff,0,35,35,35
1683323114157,MATH 103B,A01,188681,Staff,4,0,35,31
1683323114157,MATH 103B,B01,188692,Staff,5,0,35,30
1683323115181,MATH 109,A01,188695,Salehi Golsefidy; Alireza,25,0,35,10
1683323115181,MATH 109,A02,188696,Salehi Golsefidy; Alireza,26,0,35,9
1683323116208,MATH 120A,A01,188698,Eggers; John Dietrich,7,0,35,28
1683323117231,MATH 142B,A01,188736,Ioana; Adrian,0,2,30,30
1683323117231,MATH 142B,A02,188741,Ioana; Adrian,0,1,30,30
1683323117231,MATH 142B,A03,188743,Ioana; Adrian,1,3,30,29
1683323118255,MATH 168A,A01,188790,Staff,0,9,35,35
1683323119281,MATH 170A,A01,188803,Nie; Jiawang,0,2,35,35
1683323119281,MATH 170A,A02,188811,Nie; Jiawang,0,0,35,35
1683323119281,MATH 170A,A03,188814,Nie; Jiawang,0,0,35,35
1683323119281,MATH 170A,A04,188815,Nie; Jiawang,13,0,35,22
1683323120306,MATH 193B,A01,188817,Staff,0,0,35,35
1683323120306,MATH 193B,A02,188818,Staff,6,0,35,29
1683323121329,MGT 4,A01,202857,Anderson; John Charles,62,0,80,18
1683323122354,MGT 12,A00,202858,Lindenberger; Wade Douglas,42,0,90,48
1683323123377,MGT 18,A00,202859,Staff,74,0,90,16
1683323124400,MGT 18GS,A00,202860,McKay; Michael J,13,0,28,15
1683323125429,MGT 45,A00,202861,Pecore; Joseph P.,13,0,90,77
1683323126511,MGT 100,A00,202863,Yavorsky; Daniel Ryan,28,0,90,62
1683323127536,MGT 103,A00,202864,Ehrich; Kristine R,0,18,90,90
1683323128564,MGT 112,A00,202865,Ehrich; Kristine R,15,0,90,75
1683323129591,MGT 121A,A00,202868,Staff,0,20,0,0
1683323130617,MGT 131B,A00,202869,Anderson; John Charles,59,0,90,31
1683323131643,MGT 136,A00,202871,Lindenberger; Wade Douglas,84,0,90,6
1683323132670,MGT 164,A00,202873,Staff,0,68,90,91
1683323133694,MGT 164GS,A00,202874,McKay; Mary A,13,0,28,15
1683323134718,MGT 180,A00,202875,Staff,0,50,90,91
1683323135742,MMW 11R,A01,205019,Herbst; Matthew,3,0,30,27
1683323135742,MMW 11R,A02,205026,Herbst; Matthew,29,0,30,1
1683323136771,MMW 15,A01,193512,Chang; Edmond Yi-Teh,0,9,28,28
1683323136771,MMW 15,A02,193513,Chang; Edmond Yi-Teh,0,5,28,28
1683323136771,MMW 15,A03,193514,Chang; Edmond Yi-Teh,0,5,28,28
1683323136771,MMW 15,A04,193515,Chang; Edmond Yi-Teh,0,5,28,28
1683323136771,MMW 15,A05,193516,Chang; Edmond Yi-Teh,0,4,28,28
1683323136771,MMW 15,A06,193517,Chang; Edmond Yi-Teh,0,5,28,28
1683323136771,MMW 15,B01,193519,Chang; Edmond Yi-Teh,0,4,28,28
1683323136771,MMW 15,B02,193520,Chang; Edmond Yi-Teh,0,5,28,28
1683323136771,MMW 15,B03,193521,Chang; Edmond Yi-Teh,0,4,28,28
1683323136771,MMW 15,B04,193522,Chang; Edmond Yi-Teh,0,4,28,28
1683323136771,MMW 15,B05,193523,Chang; Edmond Yi-Teh,0,5,28,28
1683323136771,MMW 15,B06,193524,Chang; Edmond Yi-Teh,0,4,28,28
1683323137798,MMW 122,A01,193526,Rahimi; Babak,0,15,28,28
1683323137798,MMW 122,A02,193527,Rahimi; Babak,0,14,28,28
1683323137798,MMW 122,A03,193528,Rahimi; Babak,0,0,0,0
1683323137798,MMW 122,A04,193529,Rahimi; Babak,0,0,0,0
1683323138823,MUS 1A,A01,186663,Staff,0,20,35,35
1683323139848,MUS 4,A01,186715,Staff,0,12,35,35
1683323140873,MUS 5R,A01,186796,Dubnov; Shlomo,0,17,35,35
1683323141895,MUS 6,A01,186798,Staff,0,3,25,25
1683323142923,MUS 7,A01,186830,Staff,12,0,35,23
1683323143973,MUS 8,A01,186930,Staff,0,26,35,35
1683323145001,MUS 15,A01,186932,Staff,0,16,35,35
1683323145001,MUS 15,B01,186934,Staff,0,15,35,35
1683323146028,MUS 80,A00,186935,Staff,2,0,20,18
1683323146028,MUS 80,B00,186936,Staff,25,0,25,0
1683323147054,NANO 11,A00,204702,Lipomi; Darren John,0,0,0,0
1683323148082,NANO 15,A01,204709,Yang; Kesong,0,1,0,0
1683323149106,NANO 114,A00,202069,Jahed Motlagh; Zeinab,3,0,10,7
1683323150134,PHIL 1,A00,186955,Grush; Rick Scott,32,0,40,8
1683323151158,PHIL 10,A01,186973,Grush; Rick Scott,28,0,35,7
1683323151158,PHIL 10,A02,186974,Grush; Rick Scott,33,0,35,2
1683323152189,PHIL 13,A01,186976,Staff,7,0,35,28
1683323152189,PHIL 13,A02,186977,Staff,16,0,35,19
1683323153217,PHIL 14,A01,186979,Staff,31,0,35,4
1683323153217,PHIL 14,A02,186986,Staff,32,0,35,3
1683323154244,PHIL 28,A01,186988,Staff,16,0,30,14
1683323154244,PHIL 28,A02,186989,Staff,1,0,30,29
1683323154244,PHIL 28,A03,186990,Staff,9,0,30,21
1683323154244,PHIL 28,A04,186991,Staff,26,0,30,4
1683323155270,PHIL 120,A00,186997,Staff,23,0,40,17
1683323156296,PHIL 137,A00,187003,Staff,9,0,40,31
1683323157320,PHIL 150,A00,187015,Staff,47,0,70,23
1683323158342,PHIL 167,A00,187021,Lamey; Andy M.,35,0,40,5
1683323159370,PHIL 174,A01,202226,Staff,17,0,20,3
1683323159370,PHIL 174,A02,202235,Staff,20,0,20,0
1683323160394,PHIL 191A,A00,258918,Staff,0,0,1,1
1683323161419,PHYS 1A,A00,187028,Staff,27,0,60,33
1683323162444,PHYS 1AL,001,187036,Staff,3,0,30,27
1683323162444,PHYS 1AL,002,187049,Staff,18,0,30,12
1683323163469,PHYS 1B,A00,187058,Staff,22,0,60,38
1683323164494,PHYS 1BL,001,187064,Staff,0,0,30,30
1683323164494,PHYS 1BL,002,187070,Staff,5,0,30,25
1683323165519,PHYS 1C,A00,187082,Staff,31,0,120,89
1683323166544,PHYS 1CL,001,187088,Staff,0,9,30,30
1683323166544,PHYS 1CL,002,187089,Staff,0,2,30,30
1683323166544,PHYS 1CL,009,262693,Staff,11,0,30,19
1683323167569,PHYS 2B,A01,187097,Staff,54,0,115,61
1683323168595,PHYS 2C,A01,187099,Staff,67,0,115,48
1683323169620,PHYS 2CL,A01,187101,Staff,5,0,28,23
1683323169620,PHYS 2CL,A02,187102,Staff,15,0,28,13
1683323170653,PHYS 2D,A01,187123,Shotwell; Brian,95,0,115,20
1683323171679,PHYS 4B,A01,187133,Grinstein; Benjamin,35,0,50,15
1683323172703,POLI 10,A00,188819,Staff,0,4,50,50
1683323173730,POLI 11,A00,188827,Staff,43,0,50,7
1683323174755,POLI 13R,A00,188828,Staff,0,1,20,20
1683323175779,POLI 27,A01,188830,Elgin; Samuel Zincke,0,1,70,70
1683323176806,POLI 30,A00,188832,Desposato; Scott,31,0,50,19
1683323177833,POLI 102F,A00,188834,Staff,3,0,40,37
1683323178857,POLI 104A,A00,188852,Staff,14,0,30,16
1683323179882,POLI 104I,A00,188853,Staff,0,6,20,20
1683323180908,POLI 110B,A00,188854,Wiens; David,7,0,20,13
1683323181934,POLI 112A,A00,188855,Wiens; David,5,0,30,25
1683323182957,POLI 117R,A00,188856,Forman; Fonna,0,11,20,20
1683323183984,POLI 118,A00,188857,Ingham; Sean,8,0,20,12
1683323185008,POLI 120G,A00,188858,Staff,9,0,30,21
1683323186032,POLI 131CR,A00,188863,Hoston; Germaine,24,0,50,26
1683323187060,POLI 133,A00,188864,Nellis; Gareth Hb,44,0,50,6
1683323188085,POLI 134D,A00,188865,Desposato; Scott,27,0,30,3
1683323189110,POLI 142A,A00,188871,Gartzke; Erik,22,0,50,28
1683323190137,POLI 142K,A00,188874,Staff,38,0,50,12
1683323191162,POLI 143,A00,188940,Gartzke; Erik,16,0,30,14
1683323192184,POLI 153,A00,188943,Staff,3,0,20,17
1683323193210,POLI 160AA,A00,188944,Staff,12,0,40,28
1683323194241,POLI 170A,A00,188945,Staff,11,0,30,19
1683323196290,PSYC 1,A00,188952,Staff,37,0,90,53
1683323197315,PSYC 2,B00,188953,Staff,19,0,35,16
1683323198338,PSYC 6,A00,188970,Staff,47,0,60,13
1683323199362,PSYC 7,A00,188973,Staff,37,0,45,8
1683323200388,PSYC 60,A01,188980,Rickard; Timothy C.,43,0,60,17
1683323201413,PSYC 70,A01,189001,Steiner; Eric Tomas,24,0,45,21
1683323202437,PSYC 100,A00,189005,Lacefield; Katharine I,0,99,120,120
1683323203464,PSYC 102,A00,189008,Staff,10,0,30,20
1683323204489,PSYC 106,B00,189026,Gorman; Michael R.,35,0,60,25
1683323205518,PSYC 114,B01,189033,Winkielman; Piotr,0,32,30,30
1683323206544,PSYC 131,A00,189036,Anagnostaras; Stephan,0,43,60,60
1683323207569,PSYC 136,A00,189041,Lowe; Angela Beth,0,7,25,25
1683323208593,PSYC 137,A00,189057,Winkielman; Piotr,0,34,25,25
1683323209617,PSYC 144,A00,189107,Wixted; John T,0,7,50,50
1683323211668,PSYC 162,A00,189142,Staff,0,8,85,85
1683323212693,PSYC 172,A00,189144,Gorman; Michael R.,0,7,30,30
1683323214743,PSYC 179,A00,189146,Lacefield; Katharine I,0,84,120,120
1683323215770,PSYC 181,A00,189147,Anagnostaras; Stephan,0,44,90,90
1683323216795,PSYC 190R,A00,189148,Barner; David A.,0,22,80,80
1683323217822,PSYC 191,A00,189275,Rickard; Timothy C.,0,7,25,25
1683323218846,PSYC 193,A00,189276,Chapman; Eddie Nathaniel,0,1,0,4
1683323219871,PSYC 193L,A01,189281,Lowe; Angela Beth,12,0,20,8
1683323219871,PSYC 193L,B01,189285,Staff,28,0,35,7
1683323220894,RELI 149,A00,187137,Rahimi; Babak,7,0,40,33
1683323221922,SE 9,A01,187315,Staff,0,2,18,18
1683323222948,SE 101B,A00,187409,Staff,24,0,30,6
1683323223971,SE 110B,A00,187444,Staff,10,0,40,30
1683323224995,SE 130B,A00,187449,Staff,31,0,40,9
1683323226022,SE 150A,A00,187516,Staff,9,0,20,11
1683323227049,SE 154,A00,187528,Staff,30,0,50,20
1683323228073,SIO 3,A01,258171,Staff,35,0,40,5
1683323229097,SIO 10,A00,187144,Cook; Geoffrey W,0,3,75,75
1683323230178,SIO 45,A00,187152,Cook; Geoffrey W,1,0,100,99
1683323231203,SIO 109R,A00,194486,Staff,0,3,20,20
1683323233255,SIO 187,A01,187233,Kacev; David,12,0,40,28
1683323234280,SOCI 1,A01,258656,Thorpe; Charles Robert,28,0,30,2
1683323234280,SOCI 1,A02,258658,Thorpe; Charles Robert,30,0,30,0
1683323234280,SOCI 1,A03,258661,Thorpe; Charles Robert,25,0,25,0
1683323234280,SOCI 1,A04,258666,Thorpe; Charles Robert,22,0,25,3
1683323234280,SOCI 1,A05,258897,Thorpe; Charles Robert,23,0,25,2
1683323234280,SOCI 1,A06,258898,Thorpe; Charles Robert,25,0,25,0
1683323235309,SOCI 30,A01,258903,Pardo Guerra; Juan Pablo,16,0,30,14
1683323236334,SOCI 102,A00,258904,Staff,9,0,25,16
1683323237360,SOCI 106,A00,258905,Staff,19,0,25,6
1683323238384,SOCI 111,A00,258907,Ribas Norris; Janet Vanesa,26,0,30,4
1683323239407,SOCI 121R,A00,258908,Pardo Guerra; Juan Pablo,11,0,30,19
1683323240434,SOCI 126,A01,203330,Staff,14,0,20,6
1683323241459,SOCI 131,A00,258909,Thorpe; Charles Robert,31,0,60,29
1683323242487,SOCI 135,A00,258910,Payne; Christine Anna,0,9,30,30
1683323243511,SOCI 157,A00,258911,Staff,12,0,30,18
1683323244541,SOCI 184,A00,258912,Staff,25,0,30,5
1683323245571,SOCI 188D,A00,258913,Staff,21,0,30,9
1683323246598,SYN 2,001,187529,Staff,9,0,16,7
1683323246598,SYN 2,002,201452,Staff,0,18,16,16
1683323246598,SYN 2,003,201469,Staff,4,0,16,12
1683323247623,SYN 100,A01,187531,Staff,0,9,20,20
1683323247623,SYN 100,B01,201491,Staff,0,12,20,20
1683323248648,TDAC 1,A00,189286,Walsh; Kim C.,3,0,20,17
1683323248648,TDAC 1,B00,189287,Harting; Carla Kelso,11,0,20,9
1683323249673,TDAC 101,A00,189300,Walsh; Kim C.,16,0,20,4
1683323249673,TDAC 101,B00,189301,Harting; Carla Kelso,18,0,20,2
1683323250697,TDAC 102,A00,189304,Basso; Beatrice,14,0,20,6
1683323251720,TDAC 108,A00,189305,Staff,18,0,20,2
1683323252750,TDDE 131,A00,189310,Staff,19,0,20,1
1683323252750,TDDE 131,B00,189314,Staff,19,0,20,1
1683323252750,TDDE 131,C00,189315,Staff,48,0,50,2
1683323252750,TDDE 131,D00,189316,Staff,14,0,15,1
1683323252750,TDDE 131,E00,204841,Staff,20,0,20,0
1683323253777,TDGE 10,A00,189289,Staff,30,0,50,20
1683323253777,TDGE 10,B00,189290,Havis; Allan,1,0,50,49
1683323254802,TDGE 11,A00,189291,Fulton; Julia,0,3,50,50
1683323254802,TDGE 11,B00,189292,Staff,20,0,25,5
1683323254802,TDGE 11,C00,260270,Staff,0,0,0,0
1683323255827,TDGE 25,A00,189294,Staff,3,0,20,17
1683323256854,TDGE 124,A00,189318,Fulton; Julia,0,8,50,50
1683323257886,TDGE 125,A00,189319,Staff,13,0,25,12
1683323257886,TDGE 125,B00,189320,Staff,23,0,25,2
1683323258912,TDGE 127,A00,189322,Havis; Allan,0,0,50,50
1683323259936,TDHT 101,A00,189323,Staff,18,0,25,7
1683323259936,TDHT 101,B00,189324,Staff,25,0,25,0
1683323260960,TDHT 102,A00,189325,Staff,49,0,50,1
1683323261985,TDMV 1,A00,189295,Arcidiacono; Kristin,19,0,30,11
1683323261985,TDMV 1,B00,189296,Caligagan; Maria T.,24,0,30,6
1683323263011,TDMV 2,A00,189297,Sammartano; Tonnie,28,0,30,2
1683323263011,TDMV 2,B00,189299,Arcidiacono; Kristin,24,0,30,6
1683323264053,TDMV 3,A00,204998,Rincon; Alicia,22,0,30,8
1683323265077,TDMV 120,A00,189458,Sammartano; Tonnie,28,0,30,2
1683323266101,TDMV 138,A00,189541,Jun; Grace Shin Hae,22,0,40,18
1683323267129,TDMV 142,A00,189717,Caligagan; Tony,23,0,30,7
1683323267129,TDMV 142,B00,189718,Caligagan; Maria T.,25,0,30,5
1683323268154,TMC 2,A01,187533,Staff,25,0,25,0
1683323268154,TMC 2,A02,187534,Staff,25,0,25,0
1683323269182,USP 1,A01,187536,Kwak; Nancy,0,16,25,25
1683323270209,USP 5,A01,187538,Staff,9,0,25,16
1683323271232,USP 101,A00,199253,Staff,0,4,0,0
1683323272258,USP 124,A00,187562,Boomhower; Matthew Charles,1,0,30,29
1683323273282,USP 138,A00,187582,Staff,20,0,25,5
1683323274310,USP 152,A01,187597,Staff,4,0,25,21
1683323275334,USP 153,A00,187598,Staff,19,0,25,6
1683323276361,USP 168,A00,187607,Kwak; Nancy,2,0,5,3
1683323277384,USP 173,A00,187619,Staff,4,0,25,21
1683323278409,USP 181,A00,187638,Staff,0,0,25,25
1683323279434,VIS 103,A00,187650,Cruz; Edwin Teddy,23,0,75,52
1683323280463,VIS 110D,A00,187669,Staff,12,0,22,10
1683323281487,VIS 127C,A00,187720,Shen; Kuiyi,68,0,146,78
1683323282512,VIS 149,A00,187731,Yoldas; Pinar,0,14,22,22
1683323283537,VIS 151,A01,188091,Staff,22,0,34,12
1683323283537,VIS 151,A02,188092,Staff,11,0,34,23
1683323284565,VIS 160B,A00,188093,Stalbaum; Brett,0,0,10,10
1683323286616,WCWP 10B,A00,201720,Staff,10,0,15,5
1683323286616,WCWP 10B,B00,201722,Staff,8,0,15,7
1683323287639,WCWP 100,A00,201725,Gagnon; Jeffrey C,0,0,2,2
1683323287639,WCWP 100,B00,201727,Staff,0,4,15,15
1683323290730,ANBI 133,A00,258401,Wilder; Linnea Lorene,34,0,40,6
1683323291754,ANBI 140,A00,258395,Hrvoj Mihic; Branka,18,0,25,7
1683323292778,ANSC 120,A00,258402,Bialecki; Jon Anthony,27,0,40,13
1683323293805,ANSC 144,A00,258400,Staff,14,0,40,26
1683323295857,ANSC 166,A00,258396,Parish; Steven Martin,157,0,175,18
1683323296883,ANSC 180,A00,193533,Staff,9,0,20,11
1683323297908,ANSC 188,A00,258397,Jassal; Aftab,33,0,40,7
1683323298932,ANTH 3,A01,258316,Staff,23,0,30,7
1683323299955,ANTH 5,A00,258394,Semendeferi; Ekaterini,16,0,20,4
1683323300979,ANTH 21,A01,258331,Staff,9,0,40,31
1683323302005,ANTH 103,A00,258398,Varma; Saiba,15,0,25,10
1683323303057,AWP 10,001,202034,Staff,0,0,0,0
1683323303057,AWP 10,002,202035,Staff,0,0,0,0
1683323303057,AWP 10,003,202036,Staff,0,0,0,0
1683323303057,AWP 10,004,202037,Staff,0,0,0,0
1683323303057,AWP 10,005,202038,Staff,0,0,0,0
1683323303057,AWP 10,006,202039,Staff,0,0,0,0
1683323303057,AWP 10,007,202040,Staff,0,0,0,0
1683323303057,AWP 10,008,202041,Staff,0,0,0,0
1683323303057,AWP 10,009,202042,Staff,0,0,0,0
1683323303057,AWP 10,010,202043,Staff,0,0,0,0
1683323303057,AWP 10,011,202044,Staff,0,0,0,0
1683323303057,AWP 10,012,202045,Staff,0,0,0,0
1683323303057,AWP 10,013,202046,Staff,0,0,0,0
1683323303057,AWP 10,014,202047,Staff,0,0,0,0
1683323303057,AWP 10,015,202048,Staff,0,0,0,0
1683323303057,AWP 10,016,202049,Staff,0,0,0,0
1683323303057,AWP 10,017,202050,Staff,0,0,0,0
1683323303057,AWP 10,018,202051,Staff,0,0,0,0
1683323303057,AWP 10,019,202052,Staff,0,0,0,0
1683323303057,AWP 10,020,202053,Staff,0,0,0,0
1683323303057,AWP 10,021,202054,Staff,0,0,0,0
1683323303057,AWP 10,022,202055,Staff,0,0,0,0
1683323303057,AWP 10,023,202056,Staff,0,0,0,0
1683323303057,AWP 10,024,202057,Staff,0,0,0,0
1683323303057,AWP 10,025,202058,Staff,0,0,0,0
1683323303057,AWP 10,026,202059,Staff,0,0,0,0
1683323304082,AWP 102,001,202032,Staff,0,0,0,0
1683323304082,AWP 102,002,202033,Staff,0,0,0,0
1683323305104,BENG 100,A01,254234,Taylor Amos; Alyssa C,31,0,40,9
1683323306128,BENG 196,001,270013,Engler; Adam J.,9999,0,9999,0
1683323307157,BICD 100R,A01,202018,Smith; Laurie,0,7,32,32
1683323307157,BICD 100R,A02,202019,Smith; Laurie,0,2,32,32
1683323307157,BICD 100R,A03,202020,Smith; Laurie,0,1,32,32
1683323307157,BICD 100R,A04,202021,Smith; Laurie,8,0,32,24
1683323307157,BICD 100R,A05,202022,Smith; Laurie,12,0,32,20
1683323308186,BICD 136,A01,193242,Gustafson-Brown; Cindy,0,2,32,32
1683323308186,BICD 136,A02,193244,Gustafson-Brown; Cindy,14,0,32,18
1683323309210,BIEB 102,A01,193249,Butler; Shannon Rhey,0,2,32,32
1683323309210,BIEB 102,A02,193251,Butler; Shannon Rhey,0,0,32,32
1683323309210,BIEB 102,A03,193253,Butler; Shannon Rhey,0,1,32,32
1683323309210,BIEB 102,A04,193255,Butler; Shannon Rhey,17,0,32,15
1683323309210,BIEB 102,A05,193265,Butler; Shannon Rhey,26,0,32,6
1683323309210,BIEB 102,A06,193269,Butler; Shannon Rhey,16,0,32,16
1683323311256,BIEB 150,A01,193274,Staff,0,0,32,32
1683323311256,BIEB 150,A02,193285,Staff,23,0,32,9
1683323312283,BIEB 194,A00,193286,Kurle; Carolyn M.,22,0,32,10
1683323313311,BILD 1,A01,192291,Staff,16,0,32,16
1683323313311,BILD 1,A02,192292,Staff,30,0,32,2
1683323313311,BILD 1,B01,192520,Reuther; Keefe,0,1,0,0
1683323313311,BILD 1,B02,192532,Reuther; Keefe,0,1,0,0
1683323314336,BILD 3,A01,192556,Butler; Shannon Rhey,0,0,32,32
1683323314336,BILD 3,A02,192581,Butler; Shannon Rhey,5,0,32,27
1683323314336,BILD 3,A03,192611,Butler; Shannon Rhey,23,0,32,9
1683323314336,BILD 3,A04,192612,Butler; Shannon Rhey,25,0,32,7
1683323314336,BILD 3,A05,192613,Butler; Shannon Rhey,27,0,32,5
1683323314336,BILD 3,A06,192679,Butler; Shannon Rhey,27,0,32,5
1683323314336,BILD 3,A07,192682,Butler; Shannon Rhey,22,0,32,10
1683323315364,BILD 4,A01,192836,Reuther; Keefe,0,0,24,24
1683323315364,BILD 4,A02,193044,Reuther; Keefe,4,0,24,20
1683323316391,BILD 10,A01,193142,Gustafson-Brown; Cindy,30,0,32,2
1683323316391,BILD 10,A02,193149,Gustafson-Brown; Cindy,31,0,32,1
1683323317414,BIMM 100,A01,193301,Staff,0,6,32,32
1683323317414,BIMM 100,A02,193312,Staff,0,5,32,32
1683323317414,BIMM 100,A03,193323,Staff,0,8,32,32
1683323318444,BIMM 101,A01,193329,McDonnell; Lisa Marie,0,3,24,24
1683323318444,BIMM 101,A02,193339,McDonnell; Lisa Marie,0,3,24,24
1683323318444,BIMM 101,B01,193354,McDonnell; Lisa Marie,0,3,24,24
1683323318444,BIMM 101,B02,193357,McDonnell; Lisa Marie,0,3,24,24
1683323319468,BIMM 110,A01,193377,Tat; John,0,11,32,32
1683323319468,BIMM 110,A02,193378,Tat; John,1,9,32,31
1683323320495,BIMM 120,A01,206116,Staff,0,0,32,32
1683323320495,BIMM 120,A02,206117,Staff,8,0,32,24
1683323320495,BIMM 120,A03,206121,Staff,21,0,32,11
1683323321524,BIPN 100,A01,193393,Park; Ji Young,0,14,32,32
1683323321524,BIPN 100,A02,193402,Park; Ji Young,0,12,32,32
1683323321524,BIPN 100,A03,193413,Park; Ji Young,0,14,32,32
1683323321524,BIPN 100,A04,193414,Park; Ji Young,0,13,32,32
1683323322549,BIPN 102,A01,193429,Staff,0,0,32,32
1683323322549,BIPN 102,A02,193438,Staff,22,0,32,10
1683323323576,BIPN 106,A01,193450,Reyes Gonzalez; Catalina,0,2,40,40
1683323324601,BIPN 134,A01,193465,Cooke; James Edward,0,0,32,32
1683323324601,BIPN 134,A02,193474,Cooke; James Edward,25,0,32,7
1683323324601,BIPN 134,A03,193485,Cooke; James Edward,29,0,32,3
1683323324601,BIPN 134,A04,193486,Cooke; James Edward,21,0,32,11
1683323324601,BIPN 134,A05,193491,Cooke; James Edward,31,0,32,1
1683323324601,BIPN 134,A06,193501,Cooke; James Edward,30,0,32,2
1683323324601,BIPN 134,A07,193510,Cooke; James Edward,29,0,32,3
1683323326649,BISP 194,A00,222522,Staff,14,0,32,18
1683323327674,CAT 124,A01,202407,Staff,20,0,25,5
1683323328698,CAT 125,A00,202408,Marchisotto; Jennifer Anne,4,0,20,16
1683323329721,CAT 125R,A00,202409,Smith; Lauryn Alissa,0,11,20,20
1683323329721,CAT 125R,B00,202410,Morales; Celeste Georgianna,0,11,20,20
1683323329721,CAT 125R,C00,202411,Irwin; Matthew Joseph,0,10,20,20
1683323330748,CENG 15,A01,204712,Yang; Kesong,0,1,0,0
1683323331772,CENG 114,A00,202070,Jahed Motlagh; Zeinab,5,0,20,15
1683323332797,CGS 105,A00,185477,Wesling; Megan E.,24,0,40,16
1683323333880,CGS 106,A00,185494,Staff,13,0,22,9
1683323334905,CGS 108,A00,185495,Staff,14,0,20,6
1683323335931,CGS 114,A00,185496,Staff,13,0,18,5
1683323336953,CGS 119,A00,185501,Staff,15,0,20,5
1683323337977,CGS 120,A00,185511,Staff,13,0,20,7
1683323339002,CHEM 4,A01,184675,Bussey; Thomas J,96,0,100,4
1683323340037,CHEM 6A,A01,184677,Staff,34,0,60,26
1683323341062,CHEM 6B,A01,184679,Staff,65,0,100,35
1683323342086,CHEM 6C,A01,184681,Bussey; Thomas J,1,0,50,49
1683323342086,CHEM 6C,A02,184682,Bussey; Thomas J,34,0,50,16
1683323343117,CHEM 40A,A01,184684,Albizati; Kim F.,37,0,100,63
1683323344142,CHEM 40B,A01,184686,Albizati; Kim F.,0,20,100,100
1683323345171,CHEM 41B,A01,184690,Staff,52,0,100,48
1683323346195,COGS 3,A01,184715,Boyle; Mary E. T.,0,25,40,40
1683323347222,COGS 14B,A01,185172,Staff,0,15,38,38
1683323348246,COGS 18,A01,184736,Staff,18,0,80,62
1683323349273,COGS 100,A01,184932,Staff,0,5,73,73
1683323350300,COGS 101A,A01,184935,Staff,0,38,30,30
1683323351328,COGS 101B,A01,184944,Staff,0,2,30,30
1683323352354,COGS 101C,A01,184946,Staff,0,12,30,30
1683323353378,COGS 102A,A01,184951,Johnson; Christine M.,2,0,40,38
1683323354401,COGS 107B,A01,184953,Mooshagian; Eric Frederick,0,50,40,40
1683323355429,COGS 118B,A01,184959,Gupta; Anjum,0,48,40,40
1683323356456,COGS 153,A00,184961,Staff,0,15,30,30
1683323357479,COGS 177,A00,184962,Staff,0,21,30,30
1683323358506,COGS 187A,A01,184969,Boyle; Mary E. T.,0,17,40,40
1683323359534,COMM 10,A01,185174,Staff,0,5,25,25
1683323359534,COMM 10,A02,185189,Staff,0,5,25,25
1683323359534,COMM 10,A03,269821,Staff,0,0,0,0
1683323360559,COMM 100B,A01,185475,Staff,0,0,0,2
1683323360559,COMM 100B,A02,185476,Staff,14,0,25,11
1683323361583,COMM 100C,A01,185314,Staff,1,0,25,24
1683323361583,COMM 100C,A02,185327,Staff,19,0,25,6
1683323362606,COMM 110M,A00,185349,Staff,2,0,40,38
1683323363630,COMM 113T,A00,185352,Staff,25,0,40,15
1683323364654,COMM 114I,A00,185353,Staff,33,0,40,7
1683323365677,COMM 131,A00,185354,Staff,19,0,30,11
1683323366704,CSE 8A,A50,185358,Cao; Yingjun,0,46,10,10
1683323367729,CSE 8B,A01,185362,Staff,1,47,50,49
1683323368752,CSE 11,A01,185416,Cao; Yingjun,0,92,10,10
1683323369779,CSE 20,A01,185445,Briones; Jor-el Thomas Caparas,5,0,25,20
1683323370803,CSE 21,A01,185447,Staff,10,0,50,40
1683323371830,CSE 101,A01,185451,Staff,0,12,50,50
1683323371830,CSE 101,B01,185453,Jones; Miles E,0,11,50,50
1683323373879,CSE 141,A01,185458,Eldon; John,20,0,100,80
1683323374903,CSE 141L,A01,185461,Eldon; John,12,0,100,88
1683323375931,CSE 142,A01,185463,Staff,36,0,60,24
1683323375931,CSE 142,B01,201355,Staff,0,7,60,60
1683323376958,CSE 142L,A01,185470,Staff,36,0,60,24
1683323376958,CSE 142L,B01,201417,Staff,0,6,60,60
1683323377982,CSE 190,A00,201433,Staff,32,0,49,17
1683323379007,DOC 1,A01,259136,Strom; Megan C.,7,0,15,8
1683323379007,DOC 1,A02,259137,Strom; Megan C.,14,0,15,1
1683323379007,DOC 1,A03,259138,Strom; Megan C.,14,0,15,1
1683323379007,DOC 1,A04,259139,Strom; Megan C.,14,0,15,1
1683323380030,DOC 100D,A00,259140,Pass; Natalye Joann,16,0,25,9
1683323381057,DSGN 1,A01,184749,Rill; Bryan,0,25,30,30
1683323382081,DSGN 100,A01,185168,Staff,0,2,25,25
1683323383108,ECE 5,A01,185626,Morris; Karcher William,0,10,0,0
1683323384133,ECE 101,A01,185628,Staff,17,0,70,53
1683323385161,ECE 107,A01,185635,Baghdadchi; Saharnaz,0,0,20,20
1683323385161,ECE 107,A02,185638,Baghdadchi; Saharnaz,4,0,20,16
1683323386188,ECE 148,A01,185647,Silberman; Jack,0,0,16,16
1683323387215,ECON 1,A01,185537,Crane; Meredith Helen,54,0,70,16
1683323388239,ECON 3,A01,185549,Crane; Meredith Helen,33,0,70,37
1683323389263,ECON 4,A01,203354,Anderson; John Charles,0,4,10,10
1683323390290,ECON 100A,A01,185574,Staff,0,4,40,40
1683323391316,ECON 100B,A01,185576,Staff,0,22,40,40
1683323392341,ECON 100C,A01,185589,Newhouse; Herbert S,30,0,70,40
1683323393367,ECON 105,A00,185608,Vespa; Emanuel Ignacio,19,0,35,16
1683323394395,ECON 109,A01,185610,Shishkin; Denis,10,0,35,25
1683323395417,ECON 110A,A01,185612,Staff,11,0,40,29
1683323396441,ECON 120A,A01,185615,Staff,20,0,40,20
1683323397470,ECON 120C,A01,185617,Sun; Yixiao,0,20,70,70
1683323398497,ECON 144,A00,203346,Squires; Dale E,3,0,35,32
1683323399524,ECON 171,A01,203349,Newhouse; Herbert S,0,1,35,35
1683323400553,ECON 173A,A01,185621,Toda; Alexis Akira,21,0,35,14
1683323401581,EDS 25,A01,202413,Staff,0,1,0,0
1683323401581,EDS 25,A02,202414,Staff,0,1,0,0
1683323401581,EDS 25,A03,202415,Staff,0,0,0,0
1683323401581,EDS 25,A04,202416,Staff,0,1,0,0
1683323401581,EDS 25,A05,202439,Staff,0,0,0,0
1683323401581,EDS 25,A06,202440,Staff,0,0,0,0
1683323401581,EDS 25,B01,202631,Staff,0,0,0,0
1683323401581,EDS 25,B02,202632,Staff,0,0,0,0
1683323401581,EDS 25,B03,202639,Staff,0,0,0,0
1683323401581,EDS 25,B04,202640,Staff,0,0,0,0
1683323401581,EDS 25,B05,202643,Staff,0,0,0,0
1683323401581,EDS 25,B06,202644,Staff,0,0,0,0
1683323402615,EDS 38,A01,202659,Black; Alison Michelle,24,0,25,1
1683323403642,EDS 115,A00,202652,Staff,17,0,30,13
1683323404670,EDS 125,A00,202649,Staff,14,0,30,16
1683323405694,EDS 126,A01,203332,Staff,30,0,30,0
1683323406718,EDS 139,A00,202838,Staff,16,0,25,9
1683323407741,EDS 146,A01,202655,Staff,14,0,25,11
1683323408769,ENG 15,A00,185667,Staff,0,1,0,0
1683323408769,ENG 15,B00,185672,Staff,0,0,0,0
1683323408769,ENG 15,C00,185675,Staff,0,0,0,0
1683323408769,ENG 15,D00,185682,Staff,0,0,0,0
1683323408769,ENG 15,E00,185684,Staff,0,0,0,0
1683323409795,ETHN 103,A00,185710,Staff,0,3,35,35
1683323410822,ETHN 103A,A00,199228,Man; Simeon S,2,0,9,7
1683323411847,ETHN 109,A00,185711,Staff,18,0,35,17
1683323412873,ETHN 142,A00,185726,Staff,0,4,30,30
1683323413897,ETHN 163J,A00,199229,Man; Simeon S,5,0,8,3
1683323414921,ETHN 168,A00,185727,Staff,8,0,10,2
1683323415947,ETHN 182,A00,185728,Staff,1,0,35,34
1683323416975,ETHN 183,A00,185737,Staff,8,0,18,10
1683323418000,GLBH 111,A01,209361,Burgos; Jose L.,0,0,0,0
1683323420048,HIEU 104,A00,185792,Staff,16,0,20,4
1683323421074,HIEU 115,A00,185800,Staff,1,0,20,19
1683323422098,HIEU 128,A00,185801,Staff,0,7,20,20
1683323423124,HIEU 147,A00,185802,Staff,16,0,20,4
1683323424149,HIEU 154,A00,185823,Staff,12,0,20,8
1683323425174,HILA 102,A00,185826,Staff,13,0,20,7
1683323426198,HILD 2C,A01,185778,Staff,0,12,20,20
1683323427226,HILD 7B,A01,185780,Kwak; Nancy,0,15,32,32
1683323427226,HILD 7B,A02,185781,Kwak; Nancy,0,18,32,32
1683323428251,HILD 30,A01,185791,Staff,14,0,20,6
1683323429274,HISC 119,A00,185830,Golan; Tal,0,9,20,20
1683323430298,HITO 156GS,A00,185831,Patterson; Patrick H.,0,0,0,23
1683323431322,HIUS 103,A00,185832,Man; Simeon S,0,6,20,20
1683323432349,HIUS 117,A00,185836,Kwak; Nancy,2,0,20,18
1683323433373,HIUS 125,A00,185840,Man; Simeon S,0,0,23,23
1683323434398,HIUS 149,A00,185845,Staff,0,0,20,20
1683323435426,HUM 3,A01,185882,Zavodny; Tatiana Sophia,0,6,50,50
1683323435426,HUM 3,B01,185899,Caldwell; Michael Alan,0,18,50,50
1683323436450,HUM 3GS,A00,185900,Patterson; Patrick H.,0,0,0,23
1683323437534,HUM 4,A01,185938,Zroka; Amy Liane,31,0,50,19
1683323437534,HUM 4,B01,185956,Watkins; Eric,0,2,50,50
1683323437534,HUM 4,B02,202209,Watkins; Eric,0,2,50,50
1683323437534,HUM 4,B03,202210,Watkins; Eric,0,1,50,50
1683323438558,HUM 5,A01,185958,West; Geoffrey Scott,3,0,50,47
1683323438558,HUM 5,A02,202215,West; Geoffrey Scott,0,0,50,50
1683323439582,INTL 190,A00,185959,Gagnon; Jeffrey C,0,0,0,9
1683323439582,INTL 190,B00,185960,Lettieri; Michael Joseph,0,0,0,1
1683323440606,JAPN 180,A00,254509,Staff,5,1,30,25
1683323441630,LATI 10,A01,202853,Kennemore; Amy Michelle,4,0,35,31
1683323441630,LATI 10,A02,202854,Kennemore; Amy Michelle,2,0,35,33
1683323441630,LATI 10,A03,270054,Kennemore; Amy Michelle,30,0,30,0
1683323442655,LATI 180,A00,202855,Kennemore; Amy Michelle,11,0,20,9
1683323443682,LAWS 101,A00,201767,Golan; Tal,0,7,40,40
1683323444704,LIFR 1C,A00,185961,Staff,6,0,20,14
1683323445727,LIFR 1CX,A00,185962,Staff,7,0,20,13
1683323446751,LIFR 1D,A00,185963,Staff,9,0,20,11
1683323447776,LIFR 1DX,A00,185964,Staff,9,0,20,11
1683323448803,LIGN 101,A01,186039,Staff,43,0,50,7
1683323449827,LIGN 165,A00,186040,Staff,18,0,50,32
1683323450849,LTCS 108,A00,186041,Staff,6,0,10,4
1683323451871,LTCS 119,A00,186042,Staff,16,0,20,4
1683323452899,LTCS 130,A00,186043,Wesling; Megan E.,15,0,25,10
1683323454950,LTEA 138,A00,186119,Staff,14,0,40,26
1683323455976,LTEN 124,A00,186148,Staff,6,0,25,19
1683323457000,LTEN 178,A00,186149,Staff,7,0,15,8
1683323458026,LTEN 181,A00,186150,Blanco; John D,33,0,40,7
1683323459050,LTWL 120,A00,186160,Staff,20,0,25,5
1683323460076,LTWL 165,A00,186161,Staff,22,0,25,3
1683323461104,LTWR 100,A00,186162,Staff,0,5,15,15
1683323462131,LTWR 102,A00,186163,Doller; Ben,5,0,15,10
1683323463156,MAE 8,A01,186412,Staff,0,0,0,0
1683323464179,MAE 30B,A00,186445,Bahadori; Mohammad Yousef,83,0,100,17
1683323465206,MAE 40,A00,186592,Bewley; Thomas R,9,0,50,41
1683323466235,MAE 101B,A00,186593,Bahadori; Mohammad Yousef,81,0,100,19
1683323467258,MAE 105,A00,186594,Bandaru; Prabhakar,12,0,50,38
1683323468286,MAE 107,A00,186599,Pham; Hieu Tan,0,6,120,120
1683323469312,MAE 148,A01,186660,Silberman; Jack,3,0,16,13
1683323470339,MATH 10A,A01,188095,Staff,0,6,35,35
1683323471368,MATH 10B,A01,188097,Bowers; Adam R.,0,11,30,30
1683323471368,MATH 10B,A02,188099,Bowers; Adam R.,0,11,30,30
1683323471368,MATH 10B,B01,188104,Bowers; Adam R.,0,10,30,30
1683323471368,MATH 10B,B02,188106,Bowers; Adam R.,0,10,30,30
1683323472392,MATH 10C,A01,188111,Staff,0,18,30,30
1683323472392,MATH 10C,A02,188127,Staff,0,17,30,30
1683323472392,MATH 10C,A03,188131,Staff,0,18,30,30
1683323472392,MATH 10C,B01,188218,Staff,18,0,30,12
1683323472392,MATH 10C,B02,188244,Staff,13,0,30,17
1683323472392,MATH 10C,B03,188277,Staff,16,0,30,14
1683323473416,MATH 18,A01,188344,Bach; Quang Tran,18,0,30,12
1683323473416,MATH 18,A02,188345,Bach; Quang Tran,11,0,30,19
1683323473416,MATH 18,B01,188353,Bach; Quang Tran,10,0,30,20
1683323473416,MATH 18,B02,188354,Bach; Quang Tran,20,0,30,10
1683323474443,MATH 20A,A01,188374,Staff,13,0,35,22
1683323475471,MATH 20B,A01,188382,Ohm; Ko Woon,6,0,30,24
1683323475471,MATH 20B,A02,188383,Ohm; Ko Woon,22,0,30,8
1683323475471,MATH 20B,B01,188385,Ohm; Ko Woon,7,0,30,23
1683323475471,MATH 20B,B02,188392,Ohm; Ko Woon,22,0,30,8
1683323476496,MATH 20C,A01,188394,Harel; Guershon,10,0,30,20
1683323476496,MATH 20C,A02,188395,Harel; Guershon,14,0,30,16
1683323476496,MATH 20C,B01,188404,Harel; Guershon,5,0,30,25
1683323476496,MATH 20C,B02,188405,Harel; Guershon,19,0,30,11
1683323477521,MATH 20D,A01,188414,Hammock; Frances H,0,1,30,30
1683323477521,MATH 20D,A02,188415,Hammock; Frances H,3,0,30,27
1683323477521,MATH 20D,B01,188447,Hammock; Frances H,2,0,30,28
1683323477521,MATH 20D,B02,188486,Hammock; Frances H,8,0,30,22
1683323478545,MATH 20E,A01,188649,Staff,21,0,30,9
1683323478545,MATH 20E,A02,188650,Staff,23,0,30,7
1683323478545,MATH 20E,A03,188673,Staff,0,0,30,30
1683323479572,MATH 102,A01,188675,Staff,0,35,35,35
1683323480606,MATH 103B,A01,188681,Staff,4,0,35,31
1683323480606,MATH 103B,B01,188692,Staff,5,0,35,30
1683323481634,MATH 109,A01,188695,Salehi Golsefidy; Alireza,25,0,35,10
1683323481634,MATH 109,A02,188696,Salehi Golsefidy; Alireza,26,0,35,9
1683323482658,MATH 120A,A01,188698,Eggers; John Dietrich,7,0,35,28
1683323483687,MATH 142B,A01,188736,Ioana; Adrian,0,2,30,30
1683323483687,MATH 142B,A02,188741,Ioana; Adrian,0,1,30,30
1683323483687,MATH 142B,A03,188743,Ioana; Adrian,1,3,30,29
1683323484713,MATH 168A,A01,188790,Staff,0,9,35,35
1683323485737,MATH 170A,A01,188803,Nie; Jiawang,0,2,35,35
1683323485737,MATH 170A,A02,188811,Nie; Jiawang,0,0,35,35
1683323485737,MATH 170A,A03,188814,Nie; Jiawang,0,0,35,35
1683323485737,MATH 170A,A04,188815,Nie; Jiawang,13,0,35,22
1683323486761,MATH 193B,A01,188817,Staff,0,0,35,35
1683323486761,MATH 193B,A02,188818,Staff,6,0,35,29
1683323487788,MGT 4,A01,202857,Anderson; John Charles,62,0,80,18
1683323488814,MGT 12,A00,202858,Lindenberger; Wade Douglas,42,0,90,48
1683323489838,MGT 18,A00,202859,Staff,74,0,90,16
1683323490865,MGT 18GS,A00,202860,McKay; Michael J,13,0,28,15
1683323491892,MGT 45,A00,202861,Pecore; Joseph P.,13,0,90,77
1683323492920,MGT 100,A00,202863,Yavorsky; Daniel Ryan,28,0,90,62
1683323493947,MGT 103,A00,202864,Ehrich; Kristine R,0,18,90,90
1683323494977,MGT 112,A00,202865,Ehrich; Kristine R,15,0,90,75
1683323496000,MGT 121A,A00,202868,Staff,0,20,0,0
1683323497024,MGT 131B,A00,202869,Anderson; John Charles,59,0,90,31
1683323498052,MGT 136,A00,202871,Lindenberger; Wade Douglas,84,0,90,6
1683323499080,MGT 164,A00,202873,Staff,0,68,90,91
1683323500105,MGT 164GS,A00,202874,McKay; Mary A,13,0,28,15
1683323501132,MGT 180,A00,202875,Staff,0,50,90,91
1683323502157,MMW 11R,A01,205019,Herbst; Matthew,3,0,30,27
1683323502157,MMW 11R,A02,205026,Herbst; Matthew,29,0,30,1
1683323503181,MMW 15,A01,193512,Chang; Edmond Yi-Teh,0,9,28,28
1683323503181,MMW 15,A02,193513,Chang; Edmond Yi-Teh,0,5,28,28
1683323503181,MMW 15,A03,193514,Chang; Edmond Yi-Teh,0,5,28,28
1683323503181,MMW 15,A04,193515,Chang; Edmond Yi-Teh,0,5,28,28
1683323503181,MMW 15,A05,193516,Chang; Edmond Yi-Teh,0,4,28,28
1683323503181,MMW 15,A06,193517,Chang; Edmond Yi-Teh,0,5,28,28
1683323503181,MMW 15,B01,193519,Chang; Edmond Yi-Teh,0,4,28,28
1683323503181,MMW 15,B02,193520,Chang; Edmond Yi-Teh,0,5,28,28
1683323503181,MMW 15,B03,193521,Chang; Edmond Yi-Teh,0,4,28,28
1683323503181,MMW 15,B04,193522,Chang; Edmond Yi-Teh,0,4,28,28
1683323503181,MMW 15,B05,193523,Chang; Edmond Yi-Teh,0,5,28,28
1683323503181,MMW 15,B06,193524,Chang; Edmond Yi-Teh,0,4,28,28
1683323504206,MMW 122,A01,193526,Rahimi; Babak,0,15,28,28
1683323504206,MMW 122,A02,193527,Rahimi; Babak,0,14,28,28
1683323504206,MMW 122,A03,193528,Rahimi; Babak,0,0,0,0
1683323504206,MMW 122,A04,193529,Rahimi; Babak,0,0,0,0
1683323505233,MUS 1A,A01,186663,Staff,0,20,35,35
1683323506260,MUS 4,A01,186715,Staff,0,12,35,35
1683323507287,MUS 5R,A01,186796,Dubnov; Shlomo,0,17,35,35
1683323508315,MUS 6,A01,186798,Staff,0,3,25,25
1683323509338,MUS 7,A01,186830,Staff,12,0,35,23
1683323510359,MUS 8,A01,186930,Staff,0,26,35,35
1683323511387,MUS 15,A01,186932,Staff,0,16,35,35
1683323511387,MUS 15,B01,186934,Staff,0,15,35,35
1683323512414,MUS 80,A00,186935,Staff,2,0,20,18
1683323512414,MUS 80,B00,186936,Staff,25,0,25,0
1683323513441,NANO 11,A00,204702,Lipomi; Darren John,0,0,0,0
1683323514470,NANO 15,A01,204709,Yang; Kesong,0,1,0,0
1683323515494,NANO 114,A00,202069,Jahed Motlagh; Zeinab,3,0,10,7
1683323516517,PHIL 1,A00,186955,Grush; Rick Scott,32,0,40,8
1683323517545,PHIL 10,A01,186973,Grush; Rick Scott,28,0,35,7
1683323517545,PHIL 10,A02,186974,Grush; Rick Scott,33,0,35,2
1683323518569,PHIL 13,A01,186976,Staff,7,0,35,28
1683323518569,PHIL 13,A02,186977,Staff,16,0,35,19
1683323519593,PHIL 14,A01,186979,Staff,31,0,35,4
1683323519593,PHIL 14,A02,186986,Staff,32,0,35,3
1683323520616,PHIL 28,A01,186988,Staff,16,0,30,14
1683323520616,PHIL 28,A02,186989,Staff,1,0,30,29
1683323520616,PHIL 28,A03,186990,Staff,9,0,30,21
1683323520616,PHIL 28,A04,186991,Staff,26,0,30,4
1683323521641,PHIL 120,A00,186997,Staff,23,0,40,17
1683323522667,PHIL 137,A00,187003,Staff,9,0,40,31
1683323523692,PHIL 150,A00,187015,Staff,47,0,70,23
1683323524715,PHIL 167,A00,187021,Lamey; Andy M.,35,0,40,5
1683323525741,PHIL 174,A01,202226,Staff,17,0,20,3
1683323525741,PHIL 174,A02,202235,Staff,20,0,20,0
1683323526764,PHIL 191A,A00,258918,Staff,0,0,1,1
1683323527791,PHYS 1A,A00,187028,Staff,27,0,60,33
1683323528820,PHYS 1AL,001,187036,Staff,3,0,30,27
1683323528820,PHYS 1AL,002,187049,Staff,18,0,30,12
1683323529854,PHYS 1B,A00,187058,Staff,22,0,60,38
1683323530879,PHYS 1BL,001,187064,Staff,0,0,30,30
1683323530879,PHYS 1BL,002,187070,Staff,5,0,30,25
1683323531910,PHYS 1C,A00,187082,Staff,31,0,120,89
1683323532939,PHYS 1CL,001,187088,Staff,0,9,30,30
1683323532939,PHYS 1CL,002,187089,Staff,0,2,30,30
1683323532939,PHYS 1CL,009,262693,Staff,11,0,30,19
1683323533969,PHYS 2B,A01,187097,Staff,54,0,115,61
1683323534993,PHYS 2C,A01,187099,Staff,67,0,115,48
1683323536021,PHYS 2CL,A01,187101,Staff,5,0,28,23
1683323536021,PHYS 2CL,A02,187102,Staff,15,0,28,13
1683323537046,PHYS 2D,A01,187123,Shotwell; Brian,95,0,115,20
1683323538071,PHYS 4B,A01,187133,Grinstein; Benjamin,35,0,50,15
1683323539094,POLI 10,A00,188819,Staff,0,4,50,50
1683323540118,POLI 11,A00,188827,Staff,43,0,50,7
1683323541198,POLI 13R,A00,188828,Staff,0,1,20,20
1683323542221,POLI 27,A01,188830,Elgin; Samuel Zincke,0,1,70,70
1683323543249,POLI 30,A00,188832,Desposato; Scott,31,0,50,19
1683323544275,POLI 102F,A00,188834,Staff,3,0,40,37
1683323545299,POLI 104A,A00,188852,Staff,14,0,30,16
1683323546326,POLI 104I,A00,188853,Staff,0,6,20,20
1683323547351,POLI 110B,A00,188854,Wiens; David,7,0,20,13
1683323548378,POLI 112A,A00,188855,Wiens; David,5,0,30,25
1683323549405,POLI 117R,A00,188856,Forman; Fonna,0,11,20,20
1683323550432,POLI 118,A00,188857,Ingham; Sean,8,0,20,12
1683323551456,POLI 120G,A00,188858,Staff,9,0,30,21
1683323552479,POLI 131CR,A00,188863,Hoston; Germaine,24,0,50,26
1683323553504,POLI 133,A00,188864,Nellis; Gareth Hb,44,0,50,6
1683323554531,POLI 134D,A00,188865,Desposato; Scott,27,0,30,3
1683323555559,POLI 142A,A00,188871,Gartzke; Erik,22,0,50,28
1683323556583,POLI 142K,A00,188874,Staff,38,0,50,12
1683323557610,POLI 143,A00,188940,Gartzke; Erik,16,0,30,14
1683323558635,POLI 153,A00,188943,Staff,3,0,20,17
1683323559661,POLI 160AA,A00,188944,Staff,12,0,40,28
1683323560688,POLI 170A,A00,188945,Staff,11,0,30,19
1683323562738,PSYC 1,A00,188952,Staff,37,0,90,53
1683323563762,PSYC 2,B00,188953,Staff,19,0,35,16
1683323564787,PSYC 6,A00,188970,Staff,47,0,60,13
1683323565810,PSYC 7,A00,188973,Staff,37,0,45,8
1683323566834,PSYC 60,A01,188980,Rickard; Timothy C.,43,0,60,17
1683323567862,PSYC 70,A01,189001,Steiner; Eric Tomas,24,0,45,21
1683323568886,PSYC 100,A00,189005,Lacefield; Katharine I,0,99,120,120
1683323569915,PSYC 102,A00,189008,Staff,10,0,30,20
1683323570940,PSYC 106,B00,189026,Gorman; Michael R.,35,0,60,25
1683323571969,PSYC 114,B01,189033,Winkielman; Piotr,0,32,30,30
1683323572993,PSYC 131,A00,189036,Anagnostaras; Stephan,0,43,60,60
1683323574020,PSYC 136,A00,189041,Lowe; Angela Beth,0,7,25,25
1683323575050,PSYC 137,A00,189057,Winkielman; Piotr,0,34,25,25
1683323576073,PSYC 144,A00,189107,Wixted; John T,0,7,50,50
1683323578122,PSYC 162,A00,189142,Staff,0,8,85,85
1683323579147,PSYC 172,A00,189144,Gorman; Michael R.,0,7,30,30
1683323581196,PSYC 179,A00,189146,Lacefield; Katharine I,0,84,120,120
1683323582220,PSYC 181,A00,189147,Anagnostaras; Stephan,0,44,90,90
1683323583248,PSYC 190R,A00,189148,Barner; David A.,0,22,80,80
1683323584275,PSYC 191,A00,189275,Rickard; Timothy C.,0,7,25,25
1683323585297,PSYC 193,A00,189276,Chapman; Eddie Nathaniel,0,1,0,4
1683323586321,PSYC 193L,A01,189281,Lowe; Angela Beth,12,0,20,8
1683323586321,PSYC 193L,B01,189285,Staff,28,0,35,7
1683323587347,RELI 149,A00,187137,Rahimi; Babak,7,0,40,33
1683323588372,SE 9,A01,187315,Staff,0,2,18,18
1683323589396,SE 101B,A00,187409,Staff,24,0,30,6
1683323590420,SE 110B,A00,187444,Staff,10,0,40,30
1683323591443,SE 130B,A00,187449,Staff,31,0,40,9
1683323592467,SE 150A,A00,187516,Staff,9,0,20,11
1683323593492,SE 154,A00,187528,Staff,30,0,50,20
1683323594517,SIO 3,A01,258171,Staff,35,0,40,5
1683323595545,SIO 10,A00,187144,Cook; Geoffrey W,0,3,75,75
1683323596569,SIO 45,A00,187152,Cook; Geoffrey W,1,0,100,99
1683323597596,SIO 109R,A00,194486,Staff,0,3,20,20
1683323599649,SIO 187,A01,187233,Kacev; David,12,0,40,28
1683323600674,SOCI 1,A01,258656,Thorpe; Charles Robert,28,0,30,2
1683323600674,SOCI 1,A02,258658,Thorpe; Charles Robert,30,0,30,0
1683323600674,SOCI 1,A03,258661,Thorpe; Charles Robert,25,0,25,0
1683323600674,SOCI 1,A04,258666,Thorpe; Charles Robert,22,0,25,3
1683323600674,SOCI 1,A05,258897,Thorpe; Charles Robert,23,0,25,2
1683323600674,SOCI 1,A06,258898,Thorpe; Charles Robert,25,0,25,0
1683323601702,SOCI 30,A01,258903,Pardo Guerra; Juan Pablo,16,0,30,14
1683323602729,SOCI 102,A00,258904,Staff,9,0,25,16
1683323603756,SOCI 106,A00,258905,Staff,19,0,25,6
1683323604781,SOCI 111,A00,258907,Ribas Norris; Janet Vanesa,26,0,30,4
1683323605805,SOCI 121R,A00,258908,Pardo Guerra; Juan Pablo,10,0,30,20
1683323606829,SOCI 126,A01,203330,Staff,14,0,20,6
1683323607852,SOCI 131,A00,258909,Thorpe; Charles Robert,31,0,60,29
1683323608878,SOCI 135,A00,258910,Payne; Christine Anna,0,9,30,30
1683323609905,SOCI 157,A00,258911,Staff,12,0,30,18
1683323610932,SOCI 184,A00,258912,Staff,25,0,30,5
1683323611960,SOCI 188D,A00,258913,Staff,21,0,30,9
1683323612986,SYN 2,001,187529,Staff,9,0,16,7
1683323612986,SYN 2,002,201452,Staff,0,18,16,16
1683323612986,SYN 2,003,201469,Staff,4,0,16,12
1683323614010,SYN 100,A01,187531,Staff,0,9,20,20
1683323614010,SYN 100,B01,201491,Staff,0,12,20,20
1683323615038,TDAC 1,A00,189286,Walsh; Kim C.,3,0,20,17
1683323615038,TDAC 1,B00,189287,Harting; Carla Kelso,11,0,20,9
1683323616067,TDAC 101,A00,189300,Walsh; Kim C.,16,0,20,4
1683323616067,TDAC 101,B00,189301,Harting; Carla Kelso,18,0,20,2
1683323617095,TDAC 102,A00,189304,Basso; Beatrice,14,0,20,6
1683323618118,TDAC 108,A00,189305,Staff,18,0,20,2
1683323619146,TDDE 131,A00,189310,Staff,19,0,20,1
1683323619146,TDDE 131,B00,189314,Staff,19,0,20,1
1683323619146,TDDE 131,C00,189315,Staff,48,0,50,2
1683323619146,TDDE 131,D00,189316,Staff,14,0,15,1
1683323619146,TDDE 131,E00,204841,Staff,20,0,20,0
1683323620170,TDGE 10,A00,189289,Staff,30,0,50,20
1683323620170,TDGE 10,B00,189290,Havis; Allan,1,0,50,49
1683323621195,TDGE 11,A00,189291,Fulton; Julia,0,3,50,50
1683323621195,TDGE 11,B00,189292,Staff,20,0,25,5
1683323621195,TDGE 11,C00,260270,Staff,0,0,0,0
1683323622222,TDGE 25,A00,189294,Staff,3,0,20,17
1683323623246,TDGE 124,A00,189318,Fulton; Julia,0,8,50,50
1683323624270,TDGE 125,A00,189319,Staff,13,0,25,12
1683323624270,TDGE 125,B00,189320,Staff,23,0,25,2
1683323625295,TDGE 127,A00,189322,Havis; Allan,0,0,50,50
1683323626322,TDHT 101,A00,189323,Staff,18,0,25,7
1683323626322,TDHT 101,B00,189324,Staff,25,0,25,0
1683323627347,TDHT 102,A00,189325,Staff,49,0,50,1
1683323628376,TDMV 1,A00,189295,Arcidiacono; Kristin,19,0,30,11
1683323628376,TDMV 1,B00,189296,Caligagan; Maria T.,24,0,30,6
1683323629403,TDMV 2,A00,189297,Sammartano; Tonnie,28,0,30,2
1683323629403,TDMV 2,B00,189299,Arcidiacono; Kristin,24,0,30,6
1683323630432,TDMV 3,A00,204998,Rincon; Alicia,22,0,30,8
1683323631460,TDMV 120,A00,189458,Sammartano; Tonnie,28,0,30,2
1683323632483,TDMV 138,A00,189541,Jun; Grace Shin Hae,22,0,40,18
1683323633512,TDMV 142,A00,189717,Caligagan; Tony,23,0,30,7
1683323633512,TDMV 142,B00,189718,Caligagan; Maria T.,25,0,30,5
1683323634540,TMC 2,A01,187533,Staff,25,0,25,0
1683323634540,TMC 2,A02,187534,Staff,25,0,25,0
1683323635567,USP 1,A01,187536,Kwak; Nancy,0,16,25,25
1683323636593,USP 5,A01,187538,Staff,9,0,25,16
1683323637617,USP 101,A00,199253,Staff,0,4,0,0
1683323638644,USP 124,A00,187562,Boomhower; Matthew Charles,1,0,30,29
1683323639671,USP 138,A00,187582,Staff,20,0,25,5
1683323640695,USP 152,A01,187597,Staff,4,0,25,21
1683323641720,USP 153,A00,187598,Staff,19,0,25,6
1683323642747,USP 168,A00,187607,Kwak; Nancy,2,0,5,3
1683323643774,USP 173,A00,187619,Staff,4,0,25,21
1683323644855,USP 181,A00,187638,Staff,0,0,25,25
1683323645879,VIS 103,A00,187650,Cruz; Edwin Teddy,23,0,75,52
1683323646903,VIS 110D,A00,187669,Staff,12,0,22,10
1683323647929,VIS 127C,A00,187720,Shen; Kuiyi,68,0,146,78
1683323648953,VIS 149,A00,187731,Yoldas; Pinar,0,14,22,22
1683323649977,VIS 151,A01,188091,Staff,22,0,34,12
1683323649977,VIS 151,A02,188092,Staff,11,0,34,23
1683323651005,VIS 160B,A00,188093,Stalbaum; Brett,0,0,10,10
1683323653055,WCWP 10B,A00,201720,Staff,10,0,15,5
1683323653055,WCWP 10B,B00,201722,Staff,8,0,15,7
1683323654082,WCWP 100,A00,201725,Gagnon; Jeffrey C,0,0,2,2
1683323654082,WCWP 100,B00,201727,Staff,0,4,15,15
1683323657170,ANBI 133,A00,258401,Wilder; Linnea Lorene,34,0,40,6
1683323658195,ANBI 140,A00,258395,Hrvoj Mihic; Branka,18,0,25,7
1683323659218,ANSC 120,A00,258402,Bialecki; Jon Anthony,27,0,40,13
1683323660245,ANSC 144,A00,258400,Staff,14,0,40,26
1683323662294,ANSC 166,A00,258396,Parish; Steven Martin,157,0,175,18
1683323663318,ANSC 180,A00,193533,Staff,9,0,20,11
1683323664342,ANSC 188,A00,258397,Jassal; Aftab,33,0,40,7
1683323665368,ANTH 3,A01,258316,Staff,23,0,30,7
1683323666392,ANTH 5,A00,258394,Semendeferi; Ekaterini,16,0,20,4
1683323667417,ANTH 21,A01,258331,Staff,9,0,40,31
1683323668446,ANTH 103,A00,258398,Varma; Saiba,15,0,25,10
1683323669479,AWP 10,001,202034,Staff,0,0,0,0
1683323669479,AWP 10,002,202035,Staff,0,0,0,0
1683323669479,AWP 10,003,202036,Staff,0,0,0,0
1683323669479,AWP 10,004,202037,Staff,0,0,0,0
1683323669479,AWP 10,005,202038,Staff,0,0,0,0
1683323669479,AWP 10,006,202039,Staff,0,0,0,0
1683323669479,AWP 10,007,202040,Staff,0,0,0,0
1683323669479,AWP 10,008,202041,Staff,0,0,0,0
1683323669479,AWP 10,009,202042,Staff,0,0,0,0
1683323669479,AWP 10,010,202043,Staff,0,0,0,0
1683323669479,AWP 10,011,202044,Staff,0,0,0,0
1683323669479,AWP 10,012,202045,Staff,0,0,0,0
1683323669479,AWP 10,013,202046,Staff,0,0,0,0
1683323669479,AWP 10,014,202047,Staff,0,0,0,0
1683323669479,AWP 10,015,202048,Staff,0,0,0,0
1683323669479,AWP 10,016,202049,Staff,0,0,0,0
1683323669479,AWP 10,017,202050,Staff,0,0,0,0
1683323669479,AWP 10,018,202051,Staff,0,0,0,0
1683323669479,AWP 10,019,202052,Staff,0,0,0,0
1683323669479,AWP 10,020,202053,Staff,0,0,0,0
1683323669479,AWP 10,021,202054,Staff,0,0,0,0
1683323669479,AWP 10,022,202055,Staff,0,0,0,0
1683323669479,AWP 10,023,202056,Staff,0,0,0,0
1683323669479,AWP 10,024,202057,Staff,0,0,0,0
1683323669479,AWP 10,025,202058,Staff,0,0,0,0
1683323669479,AWP 10,026,202059,Staff,0,0,0,0
1683323670505,AWP 102,001,202032,Staff,0,0,0,0
1683323670505,AWP 102,002,202033,Staff,0,0,0,0
1683323671529,BENG 100,A01,254234,Taylor Amos; Alyssa C,31,0,40,9
1683323672552,BENG 196,001,270013,Engler; Adam J.,9999,0,9999,0
1683323673575,BICD 100R,A01,202018,Smith; Laurie,0,7,32,32
1683323673575,BICD 100R,A02,202019,Smith; Laurie,0,2,32,32
1683323673575,BICD 100R,A03,202020,Smith; Laurie,0,1,32,32
1683323673575,BICD 100R,A04,202021,Smith; Laurie,9,0,32,23
1683323673575,BICD 100R,A05,202022,Smith; Laurie,12,0,32,20
1683323674603,BICD 136,A01,193242,Gustafson-Brown; Cindy,0,2,32,32
1683323674603,BICD 136,A02,193244,Gustafson-Brown; Cindy,14,0,32,18
1683323675632,BIEB 102,A01,193249,Butler; Shannon Rhey,0,2,32,32
1683323675632,BIEB 102,A02,193251,Butler; Shannon Rhey,0,0,32,32
1683323675632,BIEB 102,A03,193253,Butler; Shannon Rhey,0,1,32,32
1683323675632,BIEB 102,A04,193255,Butler; Shannon Rhey,17,0,32,15
1683323675632,BIEB 102,A05,193265,Butler; Shannon Rhey,26,0,32,6
1683323675632,BIEB 102,A06,193269,Butler; Shannon Rhey,16,0,32,16
1683323677681,BIEB 150,A01,193274,Staff,0,0,32,32
1683323677681,BIEB 150,A02,193285,Staff,23,0,32,9
1683323678709,BIEB 194,A00,193286,Kurle; Carolyn M.,22,0,32,10
1683323679738,BILD 1,A01,192291,Staff,16,0,32,16
1683323679738,BILD 1,A02,192292,Staff,30,0,32,2
1683323679738,BILD 1,B01,192520,Reuther; Keefe,0,1,0,0
1683323679738,BILD 1,B02,192532,Reuther; Keefe,0,1,0,0
1683323680767,BILD 3,A01,192556,Butler; Shannon Rhey,0,0,32,32
1683323680767,BILD 3,A02,192581,Butler; Shannon Rhey,5,0,32,27
1683323680767,BILD 3,A03,192611,Butler; Shannon Rhey,23,0,32,9
1683323680767,BILD 3,A04,192612,Butler; Shannon Rhey,25,0,32,7
1683323680767,BILD 3,A05,192613,Butler; Shannon Rhey,27,0,32,5
1683323680767,BILD 3,A06,192679,Butler; Shannon Rhey,27,0,32,5
1683323680767,BILD 3,A07,192682,Butler; Shannon Rhey,22,0,32,10
1683323681791,BILD 4,A01,192836,Reuther; Keefe,0,0,24,24
1683323681791,BILD 4,A02,193044,Reuther; Keefe,4,0,24,20
1683323682819,BILD 10,A01,193142,Gustafson-Brown; Cindy,30,0,32,2
1683323682819,BILD 10,A02,193149,Gustafson-Brown; Cindy,31,0,32,1
1683323683846,BIMM 100,A01,193301,Staff,0,6,32,32
1683323683846,BIMM 100,A02,193312,Staff,0,5,32,32
1683323683846,BIMM 100,A03,193323,Staff,0,8,32,32
1683323684870,BIMM 101,A01,193329,McDonnell; Lisa Marie,0,3,24,24
1683323684870,BIMM 101,A02,193339,McDonnell; Lisa Marie,0,3,24,24
1683323684870,BIMM 101,B01,193354,McDonnell; Lisa Marie,0,3,24,24
1683323684870,BIMM 101,B02,193357,McDonnell; Lisa Marie,0,3,24,24
1683323685896,BIMM 110,A01,193377,Tat; John,0,11,32,32
1683323685896,BIMM 110,A02,193378,Tat; John,1,9,32,31
1683323686920,BIMM 120,A01,206116,Staff,0,0,32,32
1683323686920,BIMM 120,A02,206117,Staff,8,0,32,24
1683323686920,BIMM 120,A03,206121,Staff,21,0,32,11
1683323687948,BIPN 100,A01,193393,Park; Ji Young,0,14,32,32
1683323687948,BIPN 100,A02,193402,Park; Ji Young,0,12,32,32
1683323687948,BIPN 100,A03,193413,Park; Ji Young,0,14,32,32
1683323687948,BIPN 100,A04,193414,Park; Ji Young,0,13,32,32
1683323688973,BIPN 102,A01,193429,Staff,0,0,32,32
1683323688973,BIPN 102,A02,193438,Staff,22,0,32,10
1683323690000,BIPN 106,A01,193450,Reyes Gonzalez; Catalina,0,2,40,40
1683323691025,BIPN 134,A01,193465,Cooke; James Edward,0,0,32,32
1683323691025,BIPN 134,A02,193474,Cooke; James Edward,25,0,32,7
1683323691025,BIPN 134,A03,193485,Cooke; James Edward,29,0,32,3
1683323691025,BIPN 134,A04,193486,Cooke; James Edward,21,0,32,11
1683323691025,BIPN 134,A05,193491,Cooke; James Edward,31,0,32,1
1683323691025,BIPN 134,A06,193501,Cooke; James Edward,30,0,32,2
1683323691025,BIPN 134,A07,193510,Cooke; James Edward,29,0,32,3
1683323693078,BISP 194,A00,222522,Staff,14,0,32,18
1683323694103,CAT 124,A01,202407,Staff,20,0,25,5
1683323695126,CAT 125,A00,202408,Marchisotto; Jennifer Anne,4,0,20,16
1683323696154,CAT 125R,A00,202409,Smith; Lauryn Alissa,0,11,20,20
1683323696154,CAT 125R,B00,202410,Morales; Celeste Georgianna,0,11,20,20
1683323696154,CAT 125R,C00,202411,Irwin; Matthew Joseph,0,10,20,20
1683323697179,CENG 15,A01,204712,Yang; Kesong,0,1,0,0
1683323698203,CENG 114,A00,202070,Jahed Motlagh; Zeinab,5,0,20,15
1683323699231,CGS 105,A00,185477,Wesling; Megan E.,24,0,40,16
1683323700257,CGS 106,A00,185494,Staff,13,0,22,9
1683323701390,CGS 108,A00,185495,Staff,14,0,20,6
1683323702413,CGS 114,A00,185496,Staff,13,0,18,5
1683323703437,CGS 119,A00,185501,Staff,15,0,20,5
1683323704461,CGS 120,A00,185511,Staff,13,0,20,7
1683323705487,CHEM 4,A01,184675,Bussey; Thomas J,96,0,100,4
1683323706511,CHEM 6A,A01,184677,Staff,34,0,60,26
1683323707535,CHEM 6B,A01,184679,Staff,65,0,100,35
1683323708559,CHEM 6C,A01,184681,Bussey; Thomas J,1,0,50,49
1683323708559,CHEM 6C,A02,184682,Bussey; Thomas J,34,0,50,16
1683323709584,CHEM 40A,A01,184684,Albizati; Kim F.,37,0,100,63
1683323710610,CHEM 40B,A01,184686,Albizati; Kim F.,0,20,100,100
1683323711635,CHEM 41B,A01,184690,Staff,52,0,100,48
1683323712658,COGS 3,A01,184715,Boyle; Mary E. T.,0,25,40,40
1683323713683,COGS 14B,A01,185172,Staff,0,15,38,38
1683323714706,COGS 18,A01,184736,Staff,18,0,80,62
1683323715734,COGS 100,A01,184932,Staff,0,5,73,73
1683323716760,COGS 101A,A01,184935,Staff,0,38,30,30
1683323717784,COGS 101B,A01,184944,Staff,0,2,30,30
1683323718811,COGS 101C,A01,184946,Staff,0,12,30,30
1683323719838,COGS 102A,A01,184951,Johnson; Christine M.,2,0,40,38
1683323720864,COGS 107B,A01,184953,Mooshagian; Eric Frederick,0,50,40,40
1683323721892,COGS 118B,A01,184959,Gupta; Anjum,0,48,40,40
1683323722917,COGS 153,A00,184961,Staff,0,15,30,30
1683323723941,COGS 177,A00,184962,Staff,0,20,30,30
1683323724965,COGS 187A,A01,184969,Boyle; Mary E. T.,0,17,40,40
1683323725989,COMM 10,A01,185174,Staff,0,5,25,25
1683323725989,COMM 10,A02,185189,Staff,0,5,25,25
1683323725989,COMM 10,A03,269821,Staff,0,0,0,0
1683323727013,COMM 100B,A01,185475,Staff,0,0,0,2
1683323727013,COMM 100B,A02,185476,Staff,14,0,25,11
1683323728041,COMM 100C,A01,185314,Staff,1,0,25,24
1683323728041,COMM 100C,A02,185327,Staff,19,0,25,6
1683323729066,COMM 110M,A00,185349,Staff,2,0,40,38
1683323730090,COMM 113T,A00,185352,Staff,25,0,40,15
1683323731115,COMM 114I,A00,185353,Staff,33,0,40,7
1683323732144,COMM 131,A00,185354,Staff,19,0,30,11
1683323733168,CSE 8A,A50,185358,Cao; Yingjun,0,46,10,10
1683323734191,CSE 8B,A01,185362,Staff,1,47,50,49
1683323735219,CSE 11,A01,185416,Cao; Yingjun,0,92,10,10
1683323736244,CSE 20,A01,185445,Briones; Jor-el Thomas Caparas,5,0,25,20
1683323737267,CSE 21,A01,185447,Staff,10,0,50,40
1683323738299,CSE 101,A01,185451,Staff,0,12,50,50
1683323738299,CSE 101,B01,185453,Jones; Miles E,0,11,50,50
1683323740354,CSE 141,A01,185458,Eldon; John,20,0,100,80
1683323741377,CSE 141L,A01,185461,Eldon; John,12,0,100,88
1683323742406,CSE 142,A01,185463,Staff,36,0,60,24
1683323742406,CSE 142,B01,201355,Staff,0,7,60,60
1683323743430,CSE 142L,A01,185470,Staff,36,0,60,24
1683323743430,CSE 142L,B01,201417,Staff,0,6,60,60
1683323744457,CSE 190,A00,201433,Staff,32,0,49,17
1683323745481,DOC 1,A01,259136,Strom; Megan C.,7,0,15,8
1683323745481,DOC 1,A02,259137,Strom; Megan C.,14,0,15,1
1683323745481,DOC 1,A03,259138,Strom; Megan C.,14,0,15,1
1683323745481,DOC 1,A04,259139,Strom; Megan C.,14,0,15,1
1683323746506,DOC 100D,A00,259140,Pass; Natalye Joann,16,0,25,9
1683323747535,DSGN 1,A01,184749,Rill; Bryan,0,25,30,30
1683323748614,DSGN 100,A01,185168,Staff,0,2,25,25
1683323749641,ECE 5,A01,185626,Morris; Karcher William,0,10,0,0
1683323750666,ECE 101,A01,185628,Staff,17,0,70,53
1683323751692,ECE 107,A01,185635,Baghdadchi; Saharnaz,0,0,20,20
1683323751692,ECE 107,A02,185638,Baghdadchi; Saharnaz,4,0,20,16
1683323752719,ECE 148,A01,185647,Silberman; Jack,0,0,16,16
1683323753746,ECON 1,A01,185537,Crane; Meredith Helen,54,0,70,16
1683323754770,ECON 3,A01,185549,Crane; Meredith Helen,33,0,70,37
1683323755793,ECON 4,A01,203354,Anderson; John Charles,0,4,10,10
1683323756823,ECON 100A,A01,185574,Staff,0,4,40,40
1683323757847,ECON 100B,A01,185576,Staff,0,22,40,40
1683323758871,ECON 100C,A01,185589,Newhouse; Herbert S,30,0,70,40
1683323759895,ECON 105,A00,185608,Vespa; Emanuel Ignacio,19,0,35,16
1683323760923,ECON 109,A01,185610,Shishkin; Denis,10,0,35,25
1683323761948,ECON 110A,A01,185612,Staff,11,0,40,29
1683323762978,ECON 120A,A01,185615,Staff,20,0,40,20
1683323764006,ECON 120C,A01,185617,Sun; Yixiao,0,20,70,70
1683323765033,ECON 144,A00,203346,Squires; Dale E,3,0,35,32
1683323766061,ECON 171,A01,203349,Newhouse; Herbert S,0,1,35,35
1683323767084,ECON 173A,A01,185621,Toda; Alexis Akira,21,0,35,14
1683323768113,EDS 25,A01,202413,Staff,0,1,0,0
1683323768113,EDS 25,A02,202414,Staff,0,1,0,0
1683323768113,EDS 25,A03,202415,Staff,0,0,0,0
1683323768113,EDS 25,A04,202416,Staff,0,1,0,0
1683323768113,EDS 25,A05,202439,Staff,0,0,0,0
1683323768113,EDS 25,A06,202440,Staff,0,0,0,0
1683323768113,EDS 25,B01,202631,Staff,0,0,0,0
1683323768113,EDS 25,B02,202632,Staff,0,0,0,0
1683323768113,EDS 25,B03,202639,Staff,0,0,0,0
1683323768113,EDS 25,B04,202640,Staff,0,0,0,0
1683323768113,EDS 25,B05,202643,Staff,0,0,0,0
1683323768113,EDS 25,B06,202644,Staff,0,0,0,0
1683323769137,EDS 38,A01,202659,Black; Alison Michelle,24,0,25,1
1683323770161,EDS 115,A00,202652,Staff,17,0,30,13
1683323771183,EDS 125,A00,202649,Staff,14,0,30,16
1683323772210,EDS 126,A01,203332,Staff,30,0,30,0
1683323773234,EDS 139,A00,202838,Staff,16,0,25,9
1683323774261,EDS 146,A01,202655,Staff,14,0,25,11
1683323775288,ENG 15,A00,185667,Staff,0,1,0,0
1683323775288,ENG 15,B00,185672,Staff,0,0,0,0
1683323775288,ENG 15,C00,185675,Staff,0,0,0,0
1683323775288,ENG 15,D00,185682,Staff,0,0,0,0
1683323775288,ENG 15,E00,185684,Staff,0,0,0,0
1683323776315,ETHN 103,A00,185710,Staff,0,3,35,35
1683323777339,ETHN 103A,A00,199228,Man; Simeon S,2,0,9,7
1683323778367,ETHN 109,A00,185711,Staff,18,0,35,17
1683323779391,ETHN 142,A00,185726,Staff,0,4,30,30
1683323780418,ETHN 163J,A00,199229,Man; Simeon S,5,0,8,3
1683323781441,ETHN 168,A00,185727,Staff,8,0,10,2
1683323782467,ETHN 182,A00,185728,Staff,1,0,35,34
1683323783496,ETHN 183,A00,185737,Staff,8,0,18,10
1683323784520,GLBH 111,A01,209361,Burgos; Jose L.,0,0,0,0
1683323786567,HIEU 104,A00,185792,Staff,16,0,20,4
1683323787590,HIEU 115,A00,185800,Staff,1,0,20,19
1683323788617,HIEU 128,A00,185801,Staff,0,7,20,20
1683323789641,HIEU 147,A00,185802,Staff,16,0,20,4
1683323790667,HIEU 154,A00,185823,Staff,12,0,20,8
1683323791691,HILA 102,A00,185826,Staff,13,0,20,7
1683323792716,HILD 2C,A01,185778,Staff,0,12,20,20
1683323793741,HILD 7B,A01,185780,Kwak; Nancy,0,15,32,32
1683323793741,HILD 7B,A02,185781,Kwak; Nancy,0,18,32,32
1683323794764,HILD 30,A01,185791,Staff,14,0,20,6
1683323795788,HISC 119,A00,185830,Golan; Tal,0,9,20,20
1683323796812,HITO 156GS,A00,185831,Patterson; Patrick H.,0,0,0,23
1683323797836,HIUS 103,A00,185832,Man; Simeon S,0,6,20,20
1683323798861,HIUS 117,A00,185836,Kwak; Nancy,2,0,20,18
1683323799886,HIUS 125,A00,185840,Man; Simeon S,0,0,23,23
1683323800913,HIUS 149,A00,185845,Staff,0,0,20,20
1683323801938,HUM 3,A01,185882,Zavodny; Tatiana Sophia,0,6,50,50
1683323801938,HUM 3,B01,185899,Caldwell; Michael Alan,0,18,50,50
1683323802965,HUM 3GS,A00,185900,Patterson; Patrick H.,0,0,0,23
1683323803989,HUM 4,A01,185938,Zroka; Amy Liane,31,0,50,19
1683323803989,HUM 4,B01,185956,Watkins; Eric,0,2,50,50
1683323803989,HUM 4,B02,202209,Watkins; Eric,0,2,50,50
1683323803989,HUM 4,B03,202210,Watkins; Eric,0,1,50,50
1683323805013,HUM 5,A01,185958,West; Geoffrey Scott,3,0,50,47
1683323805013,HUM 5,A02,202215,West; Geoffrey Scott,0,0,50,50
1683323806040,INTL 190,A00,185959,Gagnon; Jeffrey C,0,0,0,9
1683323806040,INTL 190,B00,185960,Lettieri; Michael Joseph,0,0,0,1
1683323807063,JAPN 180,A00,254509,Staff,5,1,30,25
1683323808091,LATI 10,A01,202853,Kennemore; Amy Michelle,4,0,35,31
1683323808091,LATI 10,A02,202854,Kennemore; Amy Michelle,2,0,35,33
1683323808091,LATI 10,A03,270054,Kennemore; Amy Michelle,30,0,30,0
1683323809115,LATI 180,A00,202855,Kennemore; Amy Michelle,11,0,20,9
1683323810138,LAWS 101,A00,201767,Golan; Tal,0,7,40,40
1683323811161,LIFR 1C,A00,185961,Staff,6,0,20,14
1683323812190,LIFR 1CX,A00,185962,Staff,7,0,20,13
1683323813213,LIFR 1D,A00,185963,Staff,9,0,20,11
1683323814243,LIFR 1DX,A00,185964,Staff,9,0,20,11
1683323815267,LIGN 101,A01,186039,Staff,43,0,50,7
1683323816294,LIGN 165,A00,186040,Staff,18,0,50,32
1683323817320,LTCS 108,A00,186041,Staff,6,0,10,4
1683323818345,LTCS 119,A00,186042,Staff,16,0,20,4
1683323819371,LTCS 130,A00,186043,Wesling; Megan E.,15,0,25,10
1683323821419,LTEA 138,A00,186119,Staff,14,0,40,26
1683323822445,LTEN 124,A00,186148,Staff,6,0,25,19
1683323823471,LTEN 178,A00,186149,Staff,7,0,15,8
1683323824495,LTEN 181,A00,186150,Blanco; John D,33,0,40,7
1683323825519,LTWL 120,A00,186160,Staff,20,0,25,5
1683323826543,LTWL 165,A00,186161,Staff,22,0,25,3
1683323827570,LTWR 100,A00,186162,Staff,0,5,15,15
1683323828594,LTWR 102,A00,186163,Doller; Ben,5,0,15,10
1683323829619,MAE 8,A01,186412,Staff,0,0,0,0
1683323830642,MAE 30B,A00,186445,Bahadori; Mohammad Yousef,83,0,100,17
1683323831667,MAE 40,A00,186592,Bewley; Thomas R,9,0,50,41
1683323832694,MAE 101B,A00,186593,Bahadori; Mohammad Yousef,81,0,100,19
1683323833719,MAE 105,A00,186594,Bandaru; Prabhakar,12,0,50,38
1683323834747,MAE 107,A00,186599,Pham; Hieu Tan,0,6,120,120
1683323835771,MAE 148,A01,186660,Silberman; Jack,3,0,16,13
1683323836798,MATH 10A,A01,188095,Staff,1,6,35,34
1683323837822,MATH 10B,A01,188097,Bowers; Adam R.,0,11,30,30
1683323837822,MATH 10B,A02,188099,Bowers; Adam R.,0,11,30,30
1683323837822,MATH 10B,B01,188104,Bowers; Adam R.,0,10,30,30
1683323837822,MATH 10B,B02,188106,Bowers; Adam R.,0,10,30,30
1683323838846,MATH 10C,A01,188111,Staff,0,18,30,30
1683323838846,MATH 10C,A02,188127,Staff,0,17,30,30
1683323838846,MATH 10C,A03,188131,Staff,0,18,30,30
1683323838846,MATH 10C,B01,188218,Staff,18,0,30,12
1683323838846,MATH 10C,B02,188244,Staff,13,0,30,17
1683323838846,MATH 10C,B03,188277,Staff,16,0,30,14
1683323839876,MATH 18,A01,188344,Bach; Quang Tran,18,0,30,12
1683323839876,MATH 18,A02,188345,Bach; Quang Tran,11,0,30,19
1683323839876,MATH 18,B01,188353,Bach; Quang Tran,10,0,30,20
1683323839876,MATH 18,B02,188354,Bach; Quang Tran,20,0,30,10
1683323840903,MATH 20A,A01,188374,Staff,13,0,35,22
1683323841928,MATH 20B,A01,188382,Ohm; Ko Woon,6,0,30,24
1683323841928,MATH 20B,A02,188383,Ohm; Ko Woon,22,0,30,8
1683323841928,MATH 20B,B01,188385,Ohm; Ko Woon,7,0,30,23
1683323841928,MATH 20B,B02,188392,Ohm; Ko Woon,22,0,30,8
1683323842953,MATH 20C,A01,188394,Harel; Guershon,10,0,30,20
1683323842953,MATH 20C,A02,188395,Harel; Guershon,14,0,30,16
1683323842953,MATH 20C,B01,188404,Harel; Guershon,5,0,30,25
1683323842953,MATH 20C,B02,188405,Harel; Guershon,19,0,30,11
1683323843982,MATH 20D,A01,188414,Hammock; Frances H,0,1,30,30
1683323843982,MATH 20D,A02,188415,Hammock; Frances H,3,0,30,27
1683323843982,MATH 20D,B01,188447,Hammock; Frances H,2,0,30,28
1683323843982,MATH 20D,B02,188486,Hammock; Frances H,8,0,30,22
1683323845006,MATH 20E,A01,188649,Staff,21,0,30,9
1683323845006,MATH 20E,A02,188650,Staff,23,0,30,7
1683323845006,MATH 20E,A03,188673,Staff,0,0,30,30
1683323846030,MATH 102,A01,188675,Staff,0,35,35,35
1683323847057,MATH 103B,A01,188681,Staff,4,0,35,31
1683323847057,MATH 103B,B01,188692,Staff,5,0,35,30
1683323848082,MATH 109,A01,188695,Salehi Golsefidy; Alireza,25,0,35,10
1683323848082,MATH 109,A02,188696,Salehi Golsefidy; Alireza,26,0,35,9
1683323849106,MATH 120A,A01,188698,Eggers; John Dietrich,7,0,35,28
1683323850130,MATH 142B,A01,188736,Ioana; Adrian,0,2,30,30
1683323850130,MATH 142B,A02,188741,Ioana; Adrian,0,1,30,30
1683323850130,MATH 142B,A03,188743,Ioana; Adrian,1,3,30,29
1683323851159,MATH 168A,A01,188790,Staff,0,9,35,35
1683323852240,MATH 170A,A01,188803,Nie; Jiawang,0,2,35,35
1683323852240,MATH 170A,A02,188811,Nie; Jiawang,0,0,35,35
1683323852240,MATH 170A,A03,188814,Nie; Jiawang,1,0,35,34
1683323852240,MATH 170A,A04,188815,Nie; Jiawang,13,0,35,22
1683323853264,MATH 193B,A01,188817,Staff,0,0,35,35
1683323853264,MATH 193B,A02,188818,Staff,5,0,35,30
1683323854292,MGT 4,A01,202857,Anderson; John Charles,62,0,80,18
1683323855315,MGT 12,A00,202858,Lindenberger; Wade Douglas,42,0,90,48
1683323856339,MGT 18,A00,202859,Staff,74,0,90,16
1683323857363,MGT 18GS,A00,202860,McKay; Michael J,13,0,28,15
1683323858387,MGT 45,A00,202861,Pecore; Joseph P.,13,0,90,77
1683323859411,MGT 100,A00,202863,Yavorsky; Daniel Ryan,28,0,90,62
1683323860434,MGT 103,A00,202864,Ehrich; Kristine R,0,18,90,90
1683323861459,MGT 112,A00,202865,Ehrich; Kristine R,15,0,90,75
1683323862484,MGT 121A,A00,202868,Staff,0,20,0,0
1683323863508,MGT 131B,A00,202869,Anderson; John Charles,59,0,90,31
1683323864532,MGT 136,A00,202871,Lindenberger; Wade Douglas,84,0,90,6
1683323865555,MGT 164,A00,202873,Staff,0,68,90,91
1683323866579,MGT 164GS,A00,202874,McKay; Mary A,13,0,28,15
1683323867602,MGT 180,A00,202875,Staff,0,50,90,91
1683323868629,MMW 11R,A01,205019,Herbst; Matthew,3,0,30,27
1683323868629,MMW 11R,A02,205026,Herbst; Matthew,29,0,30,1
1683323869657,MMW 15,A01,193512,Chang; Edmond Yi-Teh,0,9,28,28
1683323869657,MMW 15,A02,193513,Chang; Edmond Yi-Teh,0,5,28,28
1683323869657,MMW 15,A03,193514,Chang; Edmond Yi-Teh,0,5,28,28
1683323869657,MMW 15,A04,193515,Chang; Edmond Yi-Teh,0,5,28,28
1683323869657,MMW 15,A05,193516,Chang; Edmond Yi-Teh,0,4,28,28
1683323869657,MMW 15,A06,193517,Chang; Edmond Yi-Teh,0,5,28,28
1683323869657,MMW 15,B01,193519,Chang; Edmond Yi-Teh,0,4,28,28
1683323869657,MMW 15,B02,193520,Chang; Edmond Yi-Teh,0,5,28,28
1683323869657,MMW 15,B03,193521,Chang; Edmond Yi-Teh,0,4,28,28
1683323869657,MMW 15,B04,193522,Chang; Edmond Yi-Teh,0,4,28,28
1683323869657,MMW 15,B05,193523,Chang; Edmond Yi-Teh,0,5,28,28
1683323869657,MMW 15,B06,193524,Chang; Edmond Yi-Teh,0,4,28,28
1683323870681,MMW 122,A01,193526,Rahimi; Babak,0,15,28,28
1683323870681,MMW 122,A02,193527,Rahimi; Babak,0,14,28,28
1683323870681,MMW 122,A03,193528,Rahimi; Babak,0,0,0,0
1683323870681,MMW 122,A04,193529,Rahimi; Babak,0,0,0,0
1683323871709,MUS 1A,A01,186663,Staff,0,20,35,35
1683323872734,MUS 4,A01,186715,Staff,0,12,35,35
1683323873758,MUS 5R,A01,186796,Dubnov; Shlomo,0,17,35,35
1683323874783,MUS 6,A01,186798,Staff,0,3,25,25
1683323875806,MUS 7,A01,186830,Staff,12,0,35,23
1683323876832,MUS 8,A01,186930,Staff,0,26,35,35
1683323877856,MUS 15,A01,186932,Staff,0,16,35,35
1683323877856,MUS 15,B01,186934,Staff,0,15,35,35
1683323878880,MUS 80,A00,186935,Staff,2,0,20,18
1683323878880,MUS 80,B00,186936,Staff,25,0,25,0
1683323879907,NANO 11,A00,204702,Lipomi; Darren John,0,0,0,0
1683323880932,NANO 15,A01,204709,Yang; Kesong,0,1,0,0
1683323881956,NANO 114,A00,202069,Jahed Motlagh; Zeinab,3,0,10,7
1683323882985,PHIL 1,A00,186955,Grush; Rick Scott,32,0,40,8
1683323884010,PHIL 10,A01,186973,Grush; Rick Scott,28,0,35,7
1683323884010,PHIL 10,A02,186974,Grush; Rick Scott,33,0,35,2
1683323885037,PHIL 13,A01,186976,Staff,7,0,35,28
1683323885037,PHIL 13,A02,186977,Staff,16,0,35,19
1683323886064,PHIL 14,A01,186979,Staff,31,0,35,4
1683323886064,PHIL 14,A02,186986,Staff,32,0,35,3
1683323887091,PHIL 28,A01,186988,Staff,16,0,30,14
1683323887091,PHIL 28,A02,186989,Staff,1,0,30,29
1683323887091,PHIL 28,A03,186990,Staff,9,0,30,21
1683323887091,PHIL 28,A04,186991,Staff,26,0,30,4
1683323888118,PHIL 120,A00,186997,Staff,23,0,40,17
1683323889144,PHIL 137,A00,187003,Staff,9,0,40,31
1683323890167,PHIL 150,A00,187015,Staff,47,0,70,23
1683323891194,PHIL 167,A00,187021,Lamey; Andy M.,35,0,40,5
1683323892222,PHIL 174,A01,202226,Staff,17,0,20,3
1683323892222,PHIL 174,A02,202235,Staff,20,0,20,0
1683323893246,PHIL 191A,A00,258918,Staff,0,0,1,1
1683323894272,PHYS 1A,A00,187028,Staff,27,0,60,33
1683323895299,PHYS 1AL,001,187036,Staff,3,0,30,27
1683323895299,PHYS 1AL,002,187049,Staff,18,0,30,12
1683323896323,PHYS 1B,A00,187058,Staff,22,0,60,38
1683323897350,PHYS 1BL,001,187064,Staff,0,0,30,30
1683323897350,PHYS 1BL,002,187070,Staff,5,0,30,25
1683323898376,PHYS 1C,A00,187082,Staff,31,0,120,89
1683323899399,PHYS 1CL,001,187088,Staff,0,9,30,30
1683323899399,PHYS 1CL,002,187089,Staff,0,2,30,30
1683323899399,PHYS 1CL,009,262693,Staff,11,0,30,19
1683323900423,PHYS 2B,A01,187097,Staff,54,0,115,61
1683323901450,PHYS 2C,A01,187099,Staff,67,0,115,48
1683323902475,PHYS 2CL,A01,187101,Staff,5,0,28,23
1683323902475,PHYS 2CL,A02,187102,Staff,15,0,28,13
1683323903499,PHYS 2D,A01,187123,Shotwell; Brian,95,0,115,20
1683323904527,PHYS 4B,A01,187133,Grinstein; Benjamin,35,0,50,15
1683323905552,POLI 10,A00,188819,Staff,0,4,50,50
1683323906582,POLI 11,A00,188827,Staff,43,0,50,7
1683323907605,POLI 13R,A00,188828,Staff,0,1,20,20
1683323908633,POLI 27,A01,188830,Elgin; Samuel Zincke,0,1,70,70
1683323909659,POLI 30,A00,188832,Desposato; Scott,31,0,50,19
1683323910685,POLI 102F,A00,188834,Staff,3,0,40,37
1683323911711,POLI 104A,A00,188852,Staff,14,0,30,16
1683323912736,POLI 104I,A00,188853,Staff,0,6,20,20
1683323913763,POLI 110B,A00,188854,Wiens; David,7,0,20,13
1683323914790,POLI 112A,A00,188855,Wiens; David,5,0,30,25
1683323915818,POLI 117R,A00,188856,Forman; Fonna,0,11,20,20
1683323916842,POLI 118,A00,188857,Ingham; Sean,8,0,20,12
1683323917865,POLI 120G,A00,188858,Staff,9,0,30,21
1683323918889,POLI 131CR,A00,188863,Hoston; Germaine,24,0,50,26
1683323919914,POLI 133,A00,188864,Nellis; Gareth Hb,44,0,50,6
1683323920937,POLI 134D,A00,188865,Desposato; Scott,27,0,30,3
1683323921961,POLI 142A,A00,188871,Gartzke; Erik,22,0,50,28
1683323922987,POLI 142K,A00,188874,Staff,38,0,50,12
1683323924013,POLI 143,A00,188940,Gartzke; Erik,16,0,30,14
1683323925039,POLI 153,A00,188943,Staff,3,0,20,17
1683323926065,POLI 160AA,A00,188944,Staff,12,0,40,28
1683323927089,POLI 170A,A00,188945,Staff,11,0,30,19
1683323929139,PSYC 1,A00,188952,Staff,37,0,90,53
1683323930165,PSYC 2,B00,188953,Staff,19,0,35,16
1683323931193,PSYC 6,A00,188970,Staff,47,0,60,13
1683323932217,PSYC 7,A00,188973,Staff,37,0,45,8
1683323933243,PSYC 60,A01,188980,Rickard; Timothy C.,43,0,60,17
1683323934269,PSYC 70,A01,189001,Steiner; Eric Tomas,24,0,45,21
1683323935293,PSYC 100,A00,189005,Lacefield; Katharine I,0,99,120,120
1683323936319,PSYC 102,A00,189008,Staff,10,0,30,20
1683323937347,PSYC 106,B00,189026,Gorman; Michael R.,35,0,60,25
1683323938370,PSYC 114,B01,189033,Winkielman; Piotr,0,32,30,30
1683323939394,PSYC 131,A00,189036,Anagnostaras; Stephan,0,43,60,60
1683323940418,PSYC 136,A00,189041,Lowe; Angela Beth,0,7,25,25
1683323941441,PSYC 137,A00,189057,Winkielman; Piotr,0,34,25,25
1683323942463,PSYC 144,A00,189107,Wixted; John T,0,7,50,50
1683323944513,PSYC 162,A00,189142,Staff,0,8,85,85
1683323945540,PSYC 172,A00,189144,Gorman; Michael R.,0,7,30,30
1683323947595,PSYC 179,A00,189146,Lacefield; Katharine I,0,84,120,120
1683323948623,PSYC 181,A00,189147,Anagnostaras; Stephan,0,44,90,90
1683323949646,PSYC 190R,A00,189148,Barner; David A.,0,22,80,80
1683323950672,PSYC 191,A00,189275,Rickard; Timothy C.,0,7,25,25
1683323951696,PSYC 193,A00,189276,Chapman; Eddie Nathaniel,0,1,0,4
1683323952721,PSYC 193L,A01,189281,Lowe; Angela Beth,12,0,20,8
1683323952721,PSYC 193L,B01,189285,Staff,28,0,35,7
1683323953743,RELI 149,A00,187137,Rahimi; Babak,7,0,40,33
1683323954767,SE 9,A01,187315,Staff,0,2,18,18
1683323955847,SE 101B,A00,187409,Staff,24,0,30,6
1683323956870,SE 110B,A00,187444,Staff,10,0,40,30
1683323957893,SE 130B,A00,187449,Staff,31,0,40,9
1683323958918,SE 150A,A00,187516,Staff,9,0,20,11
1683323959943,SE 154,A00,187528,Staff,30,0,50,20
1683323960967,SIO 3,A01,258171,Staff,35,0,40,5
1683323961994,SIO 10,A00,187144,Cook; Geoffrey W,0,3,75,75
1683323963019,SIO 45,A00,187152,Cook; Geoffrey W,1,0,100,99
1683323964041,SIO 109R,A00,194486,Staff,0,3,20,20
1683323966089,SIO 187,A01,187233,Kacev; David,12,0,40,28
1683323967118,SOCI 1,A01,258656,Thorpe; Charles Robert,28,0,30,2
1683323967118,SOCI 1,A02,258658,Thorpe; Charles Robert,30,0,30,0
1683323967118,SOCI 1,A03,258661,Thorpe; Charles Robert,25,0,25,0
1683323967118,SOCI 1,A04,258666,Thorpe; Charles Robert,22,0,25,3
1683323967118,SOCI 1,A05,258897,Thorpe; Charles Robert,23,0,25,2
1683323967118,SOCI 1,A06,258898,Thorpe; Charles Robert,25,0,25,0
1683323968141,SOCI 30,A01,258903,Pardo Guerra; Juan Pablo,16,0,30,14
1683323969170,SOCI 102,A00,258904,Staff,9,0,25,16
1683323970194,SOCI 106,A00,258905,Staff,19,0,25,6
1683323971218,SOCI 111,A00,258907,Ribas Norris; Janet Vanesa,26,0,30,4
1683323972245,SOCI 121R,A00,258908,Pardo Guerra; Juan Pablo,10,0,30,20
1683323973270,SOCI 126,A01,203330,Staff,14,0,20,6
1683323974296,SOCI 131,A00,258909,Thorpe; Charles Robert,31,0,60,29
1683323975329,SOCI 135,A00,258910,Payne; Christine Anna,0,9,30,30
1683323976356,SOCI 157,A00,258911,Staff,12,0,30,18
1683323977379,SOCI 184,A00,258912,Staff,25,0,30,5
1683323978406,SOCI 188D,A00,258913,Staff,21,0,30,9
1683323979479,SYN 2,001,187529,Staff,9,0,16,7
1683323979479,SYN 2,002,201452,Staff,0,18,16,16
1683323979479,SYN 2,003,201469,Staff,4,0,16,12
1683323980507,SYN 100,A01,187531,Staff,0,9,20,20
1683323980507,SYN 100,B01,201491,Staff,0,12,20,20
1683323981530,TDAC 1,A00,189286,Walsh; Kim C.,3,0,20,17
1683323981530,TDAC 1,B00,189287,Harting; Carla Kelso,11,0,20,9
1683323982554,TDAC 101,A00,189300,Walsh; Kim C.,16,0,20,4
1683323982554,TDAC 101,B00,189301,Harting; Carla Kelso,18,0,20,2
1683323983579,TDAC 102,A00,189304,Basso; Beatrice,14,0,20,6
1683323984605,TDAC 108,A00,189305,Staff,18,0,20,2
1683323985633,TDDE 131,A00,189310,Staff,19,0,20,1
1683323985633,TDDE 131,B00,189314,Staff,19,0,20,1
1683323985633,TDDE 131,C00,189315,Staff,48,0,50,2
1683323985633,TDDE 131,D00,189316,Staff,14,0,15,1
1683323985633,TDDE 131,E00,204841,Staff,20,0,20,0
1683323986659,TDGE 10,A00,189289,Staff,30,0,50,20
1683323986659,TDGE 10,B00,189290,Havis; Allan,1,0,50,49
1683323987683,TDGE 11,A00,189291,Fulton; Julia,0,3,50,50
1683323987683,TDGE 11,B00,189292,Staff,20,0,25,5
1683323987683,TDGE 11,C00,260270,Staff,0,0,0,0
1683323988706,TDGE 25,A00,189294,Staff,3,0,20,17
1683323989733,TDGE 124,A00,189318,Fulton; Julia,0,8,50,50
1683323990759,TDGE 125,A00,189319,Staff,13,0,25,12
1683323990759,TDGE 125,B00,189320,Staff,23,0,25,2
1683323991783,TDGE 127,A00,189322,Havis; Allan,0,0,50,50
1683323992807,TDHT 101,A00,189323,Staff,18,0,25,7
1683323992807,TDHT 101,B00,189324,Staff,25,0,25,0
1683323993831,TDHT 102,A00,189325,Staff,49,0,50,1
1683323994856,TDMV 1,A00,189295,Arcidiacono; Kristin,19,0,30,11
1683323994856,TDMV 1,B00,189296,Caligagan; Maria T.,24,0,30,6
1683323995881,TDMV 2,A00,189297,Sammartano; Tonnie,28,0,30,2
1683323995881,TDMV 2,B00,189299,Arcidiacono; Kristin,24,0,30,6
1683323996906,TDMV 3,A00,204998,Rincon; Alicia,22,0,30,8
1683323997932,TDMV 120,A00,189458,Sammartano; Tonnie,28,0,30,2
1683323998959,TDMV 138,A00,189541,Jun; Grace Shin Hae,22,0,40,18
1683323999983,TDMV 142,A00,189717,Caligagan; Tony,23,0,30,7
1683323999983,TDMV 142,B00,189718,Caligagan; Maria T.,25,0,30,5
1683324001007,TMC 2,A01,187533,Staff,25,0,25,0
1683324001007,TMC 2,A02,187534,Staff,25,0,25,0
1683324002035,USP 1,A01,187536,Kwak; Nancy,0,16,25,25
1683324003059,USP 5,A01,187538,Staff,9,0,25,16
1683324004087,USP 101,A00,199253,Staff,0,4,0,0
1683324005113,USP 124,A00,187562,Boomhower; Matthew Charles,1,0,30,29
1683324006139,USP 138,A00,187582,Staff,20,0,25,5
1683324007166,USP 152,A01,187597,Staff,4,0,25,21
1683324008194,USP 153,A00,187598,Staff,19,0,25,6
1683324009217,USP 168,A00,187607,Kwak; Nancy,2,0,5,3
1683324010244,USP 173,A00,187619,Staff,4,0,25,21
1683324011271,USP 181,A00,187638,Staff,0,0,25,25
1683324012299,VIS 103,A00,187650,Cruz; Edwin Teddy,23,0,75,52
1683324013323,VIS 110D,A00,187669,Staff,12,0,22,10
1683324014348,VIS 127C,A00,187720,Shen; Kuiyi,68,0,146,78
1683324015372,VIS 149,A00,187731,Yoldas; Pinar,0,14,22,22
1683324016397,VIS 151,A01,188091,Staff,22,0,34,12
1683324016397,VIS 151,A02,188092,Staff,11,0,34,23
1683324017424,VIS 160B,A00,188093,Stalbaum; Brett,0,0,10,10
1683324019471,WCWP 10B,A00,201720,Staff,10,0,15,5
1683324019471,WCWP 10B,B00,201722,Staff,8,0,15,7
1683324020496,WCWP 100,A00,201725,Gagnon; Jeffrey C,0,0,2,2
1683324020496,WCWP 100,B00,201727,Staff,0,4,15,15
1683324023585,ANBI 133,A00,258401,Wilder; Linnea Lorene,34,0,40,6
1683324024609,ANBI 140,A00,258395,Hrvoj Mihic; Branka,18,0,25,7
1683324025633,ANSC 120,A00,258402,Bialecki; Jon Anthony,27,0,40,13
1683324026657,ANSC 144,A00,258400,Staff,14,0,40,26
1683324028715,ANSC 166,A00,258396,Parish; Steven Martin,157,0,175,18
1683324029742,ANSC 180,A00,193533,Staff,9,0,20,11
1683324030767,ANSC 188,A00,258397,Jassal; Aftab,33,0,40,7
1683324031791,ANTH 3,A01,258316,Staff,23,0,30,7
1683324032819,ANTH 5,A00,258394,Semendeferi; Ekaterini,16,0,20,4
1683324033846,ANTH 21,A01,258331,Staff,9,0,40,31
1683324034870,ANTH 103,A00,258398,Varma; Saiba,15,0,25,10
1683324035896,AWP 10,001,202034,Staff,0,0,0,0
1683324035896,AWP 10,002,202035,Staff,0,0,0,0
1683324035896,AWP 10,003,202036,Staff,0,0,0,0
1683324035896,AWP 10,004,202037,Staff,0,0,0,0
1683324035896,AWP 10,005,202038,Staff,0,0,0,0
1683324035896,AWP 10,006,202039,Staff,0,0,0,0
1683324035896,AWP 10,007,202040,Staff,0,0,0,0
1683324035896,AWP 10,008,202041,Staff,0,0,0,0
1683324035896,AWP 10,009,202042,Staff,0,0,0,0
1683324035896,AWP 10,010,202043,Staff,0,0,0,0
1683324035896,AWP 10,011,202044,Staff,0,0,0,0
1683324035896,AWP 10,012,202045,Staff,0,0,0,0
1683324035896,AWP 10,013,202046,Staff,0,0,0,0
1683324035896,AWP 10,014,202047,Staff,0,0,0,0
1683324035896,AWP 10,015,202048,Staff,0,0,0,0
1683324035896,AWP 10,016,202049,Staff,0,0,0,0
1683324035896,AWP 10,017,202050,Staff,0,0,0,0
1683324035896,AWP 10,018,202051,Staff,0,0,0,0
1683324035896,AWP 10,019,202052,Staff,0,0,0,0
1683324035896,AWP 10,020,202053,Staff,0,0,0,0
1683324035896,AWP 10,021,202054,Staff,0,0,0,0
1683324035896,AWP 10,022,202055,Staff,0,0,0,0
1683324035896,AWP 10,023,202056,Staff,0,0,0,0
1683324035896,AWP 10,024,202057,Staff,0,0,0,0
1683324035896,AWP 10,025,202058,Staff,0,0,0,0
1683324035896,AWP 10,026,202059,Staff,0,0,0,0
1683324036924,AWP 102,001,202032,Staff,0,0,0,0
1683324036924,AWP 102,002,202033,Staff,0,0,0,0
1683324037948,BENG 100,A01,254234,Taylor Amos; Alyssa C,31,0,40,9
1683324038976,BENG 196,001,270013,Engler; Adam J.,9999,0,9999,0
1683324040000,BICD 100R,A01,202018,Smith; Laurie,0,7,32,32
1683324040000,BICD 100R,A02,202019,Smith; Laurie,0,2,32,32
1683324040000,BICD 100R,A03,202020,Smith; Laurie,0,1,32,32
1683324040000,BICD 100R,A04,202021,Smith; Laurie,9,0,32,23
1683324040000,BICD 100R,A05,202022,Smith; Laurie,12,0,32,20
1683324041024,BICD 136,A01,193242,Gustafson-Brown; Cindy,0,2,32,32
1683324041024,BICD 136,A02,193244,Gustafson-Brown; Cindy,14,0,32,18
1683324042057,BIEB 102,A01,193249,Butler; Shannon Rhey,0,2,32,32
1683324042057,BIEB 102,A02,193251,Butler; Shannon Rhey,0,0,32,32
1683324042057,BIEB 102,A03,193253,Butler; Shannon Rhey,0,1,32,32
1683324042057,BIEB 102,A04,193255,Butler; Shannon Rhey,17,0,32,15
1683324042057,BIEB 102,A05,193265,Butler; Shannon Rhey,26,0,32,6
1683324042057,BIEB 102,A06,193269,Butler; Shannon Rhey,16,0,32,16
1683324044104,BIEB 150,A01,193274,Staff,0,0,32,32
1683324044104,BIEB 150,A02,193285,Staff,23,0,32,9
1683324045130,BIEB 194,A00,193286,Kurle; Carolyn M.,22,0,32,10
1683324046153,BILD 1,A01,192291,Staff,16,0,32,16
1683324046153,BILD 1,A02,192292,Staff,30,0,32,2
1683324046153,BILD 1,B01,192520,Reuther; Keefe,0,1,0,0
1683324046153,BILD 1,B02,192532,Reuther; Keefe,0,1,0,0
1683324047181,BILD 3,A01,192556,Butler; Shannon Rhey,0,0,32,32
1683324047181,BILD 3,A02,192581,Butler; Shannon Rhey,5,0,32,27
1683324047181,BILD 3,A03,192611,Butler; Shannon Rhey,23,0,32,9
1683324047181,BILD 3,A04,192612,Butler; Shannon Rhey,25,0,32,7
1683324047181,BILD 3,A05,192613,Butler; Shannon Rhey,27,0,32,5
1683324047181,BILD 3,A06,192679,Butler; Shannon Rhey,27,0,32,5
1683324047181,BILD 3,A07,192682,Butler; Shannon Rhey,22,0,32,10
1683324048206,BILD 4,A01,192836,Reuther; Keefe,0,0,24,24
1683324048206,BILD 4,A02,193044,Reuther; Keefe,4,0,24,20
1683324049229,BILD 10,A01,193142,Gustafson-Brown; Cindy,30,0,32,2
1683324049229,BILD 10,A02,193149,Gustafson-Brown; Cindy,31,0,32,1
1683324050252,BIMM 100,A01,193301,Staff,0,6,32,32
1683324050252,BIMM 100,A02,193312,Staff,0,5,32,32
1683324050252,BIMM 100,A03,193323,Staff,0,8,32,32
1683324051277,BIMM 101,A01,193329,McDonnell; Lisa Marie,0,3,24,24
1683324051277,BIMM 101,A02,193339,McDonnell; Lisa Marie,0,3,24,24
1683324051277,BIMM 101,B01,193354,McDonnell; Lisa Marie,0,3,24,24
1683324051277,BIMM 101,B02,193357,McDonnell; Lisa Marie,0,3,24,24
1683324052306,BIMM 110,A01,193377,Tat; John,0,11,32,32
1683324052306,BIMM 110,A02,193378,Tat; John,1,9,32,31
1683324053333,BIMM 120,A01,206116,Staff,0,0,32,32
1683324053333,BIMM 120,A02,206117,Staff,8,0,32,24
1683324053333,BIMM 120,A03,206121,Staff,21,0,32,11
1683324054359,BIPN 100,A01,193393,Park; Ji Young,0,14,32,32
1683324054359,BIPN 100,A02,193402,Park; Ji Young,0,12,32,32
1683324054359,BIPN 100,A03,193413,Park; Ji Young,0,14,32,32
1683324054359,BIPN 100,A04,193414,Park; Ji Young,0,13,32,32
1683324055387,BIPN 102,A01,193429,Staff,0,0,32,32
1683324055387,BIPN 102,A02,193438,Staff,22,0,32,10
1683324056414,BIPN 106,A01,193450,Reyes Gonzalez; Catalina,0,2,40,40
1683324057442,BIPN 134,A01,193465,Cooke; James Edward,0,0,32,32
1683324057442,BIPN 134,A02,193474,Cooke; James Edward,25,0,32,7
1683324057442,BIPN 134,A03,193485,Cooke; James Edward,29,0,32,3
1683324057442,BIPN 134,A04,193486,Cooke; James Edward,21,0,32,11
1683324057442,BIPN 134,A05,193491,Cooke; James Edward,31,0,32,1
1683324057442,BIPN 134,A06,193501,Cooke; James Edward,30,0,32,2
1683324057442,BIPN 134,A07,193510,Cooke; James Edward,29,0,32,3
1683324059552,BISP 194,A00,222522,Staff,14,0,32,18
1683324060576,CAT 124,A01,202407,Staff,20,0,25,5
1683324061617,CAT 125,A00,202408,Marchisotto; Jennifer Anne,4,0,20,16
1683324062643,CAT 125R,A00,202409,Smith; Lauryn Alissa,0,11,20,20
1683324062643,CAT 125R,B00,202410,Morales; Celeste Georgianna,0,11,20,20
1683324062643,CAT 125R,C00,202411,Irwin; Matthew Joseph,0,10,20,20
1683324063668,CENG 15,A01,204712,Yang; Kesong,0,1,0,0
1683324064691,CENG 114,A00,202070,Jahed Motlagh; Zeinab,5,0,20,15
1683324065729,CGS 105,A00,185477,Wesling; Megan E.,24,0,40,16
1683324066757,CGS 106,A00,185494,Staff,13,0,22,9
1683324067781,CGS 108,A00,185495,Staff,14,0,20,6
1683324068806,CGS 114,A00,185496,Staff,13,0,18,5
1683324069831,CGS 119,A00,185501,Staff,15,0,20,5
1683324070855,CGS 120,A00,185511,Staff,13,0,20,7
1683324071879,CHEM 4,A01,184675,Bussey; Thomas J,96,0,100,4
1683324072903,CHEM 6A,A01,184677,Staff,34,0,60,26
1683324073926,CHEM 6B,A01,184679,Staff,65,0,100,35
1683324074951,CHEM 6C,A01,184681,Bussey; Thomas J,1,0,50,49
1683324074951,CHEM 6C,A02,184682,Bussey; Thomas J,34,0,50,16
1683324075974,CHEM 40A,A01,184684,Albizati; Kim F.,37,0,100,63
1683324076998,CHEM 40B,A01,184686,Albizati; Kim F.,0,20,100,100
1683324078023,CHEM 41B,A01,184690,Staff,52,0,100,48
1683324079046,COGS 3,A01,184715,Boyle; Mary E. T.,0,25,40,40
1683324080071,COGS 14B,A01,185172,Staff,0,15,38,38
1683324081098,COGS 18,A01,184736,Staff,18,0,80,62
1683324082123,COGS 100,A01,184932,Staff,0,5,73,73
1683324083147,COGS 101A,A01,184935,Staff,0,38,30,30
1683324084174,COGS 101B,A01,184944,Staff,0,2,30,30
1683324085200,COGS 101C,A01,184946,Staff,0,12,30,30
1683324086228,COGS 102A,A01,184951,Johnson; Christine M.,2,0,40,38
1683324087255,COGS 107B,A01,184953,Mooshagian; Eric Frederick,0,50,40,40
1683324088278,COGS 118B,A01,184959,Gupta; Anjum,0,48,40,40
1683324089306,COGS 153,A00,184961,Staff,0,15,30,30
1683324090330,COGS 177,A00,184962,Staff,0,20,30,30
1683324091354,COGS 187A,A01,184969,Boyle; Mary E. T.,0,17,40,40
1683324092379,COMM 10,A01,185174,Staff,0,5,25,25
1683324092379,COMM 10,A02,185189,Staff,0,5,25,25
1683324092379,COMM 10,A03,269821,Staff,0,0,0,0
1683324093406,COMM 100B,A01,185475,Staff,0,0,0,2
1683324093406,COMM 100B,A02,185476,Staff,14,0,25,11
1683324094429,COMM 100C,A01,185314,Staff,1,0,25,24
1683324094429,COMM 100C,A02,185327,Staff,19,0,25,6
1683324095453,COMM 110M,A00,185349,Staff,2,0,40,38
1683324096479,COMM 113T,A00,185352,Staff,25,0,40,15
1683324097504,COMM 114I,A00,185353,Staff,33,0,40,7
1683324098534,COMM 131,A00,185354,Staff,19,0,30,11
1683324099561,CSE 8A,A50,185358,Cao; Yingjun,0,46,10,10
1683324100590,CSE 8B,A01,185362,Staff,1,47,50,49
1683324101616,CSE 11,A01,185416,Cao; Yingjun,0,92,10,10
1683324102640,CSE 20,A01,185445,Briones; Jor-el Thomas Caparas,5,0,25,20
1683324103664,CSE 21,A01,185447,Staff,10,0,50,40
1683324104688,CSE 101,A01,185451,Staff,0,12,50,50
1683324104688,CSE 101,B01,185453,Jones; Miles E,0,11,50,50
1683324106735,CSE 141,A01,185458,Eldon; John,20,0,100,80
1683324107761,CSE 141L,A01,185461,Eldon; John,12,0,100,88
1683324108789,CSE 142,A01,185463,Staff,36,0,60,24
1683324108789,CSE 142,B01,201355,Staff,0,7,60,60
1683324109816,CSE 142L,A01,185470,Staff,36,0,60,24
1683324109816,CSE 142L,B01,201417,Staff,0,6,60,60
1683324110841,CSE 190,A00,201433,Staff,32,0,49,17
1683324111866,DOC 1,A01,259136,Strom; Megan C.,7,0,15,8
1683324111866,DOC 1,A02,259137,Strom; Megan C.,14,0,15,1
1683324111866,DOC 1,A03,259138,Strom; Megan C.,14,0,15,1
1683324111866,DOC 1,A04,259139,Strom; Megan C.,14,0,15,1
1683324112891,DOC 100D,A00,259140,Pass; Natalye Joann,16,0,25,9
1683324113919,DSGN 1,A01,184749,Rill; Bryan,0,25,30,30
1683324114942,DSGN 100,A01,185168,Staff,0,2,25,25
1683324115970,ECE 5,A01,185626,Morris; Karcher William,0,10,0,0
1683324116998,ECE 101,A01,185628,Staff,17,0,70,53
1683324118036,ECE 107,A01,185635,Baghdadchi; Saharnaz,0,0,20,20
1683324118036,ECE 107,A02,185638,Baghdadchi; Saharnaz,4,0,20,16
1683324119059,ECE 148,A01,185647,Silberman; Jack,0,0,16,16
1683324120083,ECON 1,A01,185537,Crane; Meredith Helen,54,0,70,16
1683324121111,ECON 3,A01,185549,Crane; Meredith Helen,33,0,70,37
1683324122138,ECON 4,A01,203354,Anderson; John Charles,0,4,10,10
1683324123162,ECON 100A,A01,185574,Staff,0,4,40,40
1683324124190,ECON 100B,A01,185576,Staff,0,22,40,40
1683324125218,ECON 100C,A01,185589,Newhouse; Herbert S,30,0,70,40
1683324126245,ECON 105,A00,185608,Vespa; Emanuel Ignacio,19,0,35,16
1683324127273,ECON 109,A01,185610,Shishkin; Denis,10,0,35,25
1683324128296,ECON 110A,A01,185612,Staff,11,0,40,29
1683324129321,ECON 120A,A01,185615,Staff,20,0,40,20
1683324130346,ECON 120C,A01,185617,Sun; Yixiao,0,20,70,70
1683324131371,ECON 144,A00,203346,Squires; Dale E,3,0,35,32
1683324132395,ECON 171,A01,203349,Newhouse; Herbert S,0,1,35,35
1683324133425,ECON 173A,A01,185621,Toda; Alexis Akira,21,0,35,14
1683324134454,EDS 25,A01,202413,Staff,0,1,0,0
1683324134454,EDS 25,A02,202414,Staff,0,1,0,0
1683324134454,EDS 25,A03,202415,Staff,0,0,0,0
1683324134454,EDS 25,A04,202416,Staff,0,1,0,0
1683324134454,EDS 25,A05,202439,Staff,0,0,0,0
1683324134454,EDS 25,A06,202440,Staff,0,0,0,0
1683324134454,EDS 25,B01,202631,Staff,0,0,0,0
1683324134454,EDS 25,B02,202632,Staff,0,0,0,0
1683324134454,EDS 25,B03,202639,Staff,0,0,0,0
1683324134454,EDS 25,B04,202640,Staff,0,0,0,0
1683324134454,EDS 25,B05,202643,Staff,0,0,0,0
1683324134454,EDS 25,B06,202644,Staff,0,0,0,0
1683324135481,EDS 38,A01,202659,Black; Alison Michelle,24,0,25,1
1683324136505,EDS 115,A00,202652,Staff,17,0,30,13
1683324137530,EDS 125,A00,202649,Staff,14,0,30,16
1683324138563,EDS 126,A01,203332,Staff,30,0,30,0
1683324139590,EDS 139,A00,202838,Staff,16,0,25,9
1683324140615,EDS 146,A01,202655,Staff,14,0,25,11
1683324141645,ENG 15,A00,185667,Staff,0,1,0,0
1683324141645,ENG 15,B00,185672,Staff,0,0,0,0
1683324141645,ENG 15,C00,185675,Staff,0,0,0,0
1683324141645,ENG 15,D00,185682,Staff,0,0,0,0
1683324141645,ENG 15,E00,185684,Staff,0,0,0,0
1683324142673,ETHN 103,A00,185710,Staff,0,3,35,35
1683324143697,ETHN 103A,A00,199228,Man; Simeon S,2,0,9,7
1683324144722,ETHN 109,A00,185711,Staff,18,0,35,17
1683324145746,ETHN 142,A00,185726,Staff,0,4,30,30
1683324146769,ETHN 163J,A00,199229,Man; Simeon S,5,0,8,3
1683324147799,ETHN 168,A00,185727,Staff,8,0,10,2
1683324148826,ETHN 182,A00,185728,Staff,1,0,35,34
1683324149850,ETHN 183,A00,185737,Staff,8,0,18,10
1683324150873,GLBH 111,A01,209361,Burgos; Jose L.,0,0,0,0
1683324152926,HIEU 104,A00,185792,Staff,16,0,20,4
1683324153953,HIEU 115,A00,185800,Staff,1,0,20,19
1683324154981,HIEU 128,A00,185801,Staff,0,7,20,20
1683324156004,HIEU 147,A00,185802,Staff,16,0,20,4
1683324157032,HIEU 154,A00,185823,Staff,12,0,20,8
1683324158056,HILA 102,A00,185826,Staff,13,0,20,7
1683324159079,HILD 2C,A01,185778,Staff,0,12,20,20
1683324160104,HILD 7B,A01,185780,Kwak; Nancy,0,15,32,32
1683324160104,HILD 7B,A02,185781,Kwak; Nancy,0,18,32,32
1683324161129,HILD 30,A01,185791,Staff,14,0,20,6
1683324162156,HISC 119,A00,185830,Golan; Tal,0,9,20,20
1683324163236,HITO 156GS,A00,185831,Patterson; Patrick H.,0,0,0,23
1683324164260,HIUS 103,A00,185832,Man; Simeon S,0,6,20,20
1683324165287,HIUS 117,A00,185836,Kwak; Nancy,2,0,20,18
1683324166312,HIUS 125,A00,185840,Man; Simeon S,0,0,23,23
1683324167334,HIUS 149,A00,185845,Staff,0,0,20,20
1683324168359,HUM 3,A01,185882,Zavodny; Tatiana Sophia,0,6,50,50
1683324168359,HUM 3,B01,185899,Caldwell; Michael Alan,0,18,50,50
1683324169382,HUM 3GS,A00,185900,Patterson; Patrick H.,0,0,0,23
1683324170405,HUM 4,A01,185938,Zroka; Amy Liane,31,0,50,19
1683324170405,HUM 4,B01,185956,Watkins; Eric,0,2,50,50
1683324170405,HUM 4,B02,202209,Watkins; Eric,0,2,50,50
1683324170405,HUM 4,B03,202210,Watkins; Eric,0,1,50,50
1683324171432,HUM 5,A01,185958,West; Geoffrey Scott,3,0,50,47
1683324171432,HUM 5,A02,202215,West; Geoffrey Scott,0,0,50,50
1683324172456,INTL 190,A00,185959,Gagnon; Jeffrey C,0,0,0,9
1683324172456,INTL 190,B00,185960,Lettieri; Michael Joseph,0,0,0,1
1683324173481,JAPN 180,A00,254509,Staff,5,1,30,25
1683324174508,LATI 10,A01,202853,Kennemore; Amy Michelle,4,0,35,31
1683324174508,LATI 10,A02,202854,Kennemore; Amy Michelle,2,0,35,33
1683324174508,LATI 10,A03,270054,Kennemore; Amy Michelle,30,0,30,0
1683324175531,LATI 180,A00,202855,Kennemore; Amy Michelle,11,0,20,9
1683324176554,LAWS 101,A00,201767,Golan; Tal,0,7,40,40
1683324177587,LIFR 1C,A00,185961,Staff,6,0,20,14
1683324178614,LIFR 1CX,A00,185962,Staff,7,0,20,13
1683324179639,LIFR 1D,A00,185963,Staff,9,0,20,11
1683324180663,LIFR 1DX,A00,185964,Staff,9,0,20,11
1683324181690,LIGN 101,A01,186039,Staff,43,0,50,7
1683324182714,LIGN 165,A00,186040,Staff,18,0,50,32
1683324183741,LTCS 108,A00,186041,Staff,6,0,10,4
1683324184767,LTCS 119,A00,186042,Staff,16,0,20,4
1683324185791,LTCS 130,A00,186043,Wesling; Megan E.,15,0,25,10
1683324187843,LTEA 138,A00,186119,Staff,14,0,40,26
1683324188869,LTEN 124,A00,186148,Staff,6,0,25,19
1683324189892,LTEN 178,A00,186149,Staff,7,0,15,8
1683324190920,LTEN 181,A00,186150,Blanco; John D,33,0,40,7
1683324191944,LTWL 120,A00,186160,Staff,20,0,25,5
1683324192970,LTWL 165,A00,186161,Staff,22,0,25,3
1683324193996,LTWR 100,A00,186162,Staff,0,5,15,15
1683324195020,LTWR 102,A00,186163,Doller; Ben,5,0,15,10
1683324196047,MAE 8,A01,186412,Staff,0,0,0,0
1683324197073,MAE 30B,A00,186445,Bahadori; Mohammad Yousef,83,0,100,17
1683324198097,MAE 40,A00,186592,Bewley; Thomas R,9,0,50,41
1683324199124,MAE 101B,A00,186593,Bahadori; Mohammad Yousef,81,0,100,19
1683324200148,MAE 105,A00,186594,Bandaru; Prabhakar,12,0,50,38
1683324201177,MAE 107,A00,186599,Pham; Hieu Tan,0,6,120,120
1683324202201,MAE 148,A01,186660,Silberman; Jack,3,0,16,13
1683324203224,MATH 10A,A01,188095,Staff,1,6,35,34
1683324204249,MATH 10B,A01,188097,Bowers; Adam R.,0,11,30,30
1683324204249,MATH 10B,A02,188099,Bowers; Adam R.,0,11,30,30
1683324204249,MATH 10B,B01,188104,Bowers; Adam R.,0,10,30,30
1683324204249,MATH 10B,B02,188106,Bowers; Adam R.,0,10,30,30
1683324205274,MATH 10C,A01,188111,Staff,0,18,30,30
1683324205274,MATH 10C,A02,188127,Staff,0,17,30,30
1683324205274,MATH 10C,A03,188131,Staff,0,18,30,30
1683324205274,MATH 10C,B01,188218,Staff,18,0,30,12
1683324205274,MATH 10C,B02,188244,Staff,13,0,30,17
1683324205274,MATH 10C,B03,188277,Staff,16,0,30,14
1683324206305,MATH 18,A01,188344,Bach; Quang Tran,18,0,30,12
1683324206305,MATH 18,A02,188345,Bach; Quang Tran,11,0,30,19
1683324206305,MATH 18,B01,188353,Bach; Quang Tran,10,0,30,20
1683324206305,MATH 18,B02,188354,Bach; Quang Tran,20,0,30,10
1683324207329,MATH 20A,A01,188374,Staff,13,0,35,22
1683324208357,MATH 20B,A01,188382,Ohm; Ko Woon,6,0,30,24
1683324208357,MATH 20B,A02,188383,Ohm; Ko Woon,22,0,30,8
1683324208357,MATH 20B,B01,188385,Ohm; Ko Woon,7,0,30,23
1683324208357,MATH 20B,B02,188392,Ohm; Ko Woon,22,0,30,8
1683324209382,MATH 20C,A01,188394,Harel; Guershon,10,0,30,20
1683324209382,MATH 20C,A02,188395,Harel; Guershon,14,0,30,16
1683324209382,MATH 20C,B01,188404,Harel; Guershon,5,0,30,25
1683324209382,MATH 20C,B02,188405,Harel; Guershon,19,0,30,11
1683324210407,MATH 20D,A01,188414,Hammock; Frances H,0,1,30,30
1683324210407,MATH 20D,A02,188415,Hammock; Frances H,3,0,30,27
1683324210407,MATH 20D,B01,188447,Hammock; Frances H,2,0,30,28
1683324210407,MATH 20D,B02,188486,Hammock; Frances H,8,0,30,22
1683324211431,MATH 20E,A01,188649,Staff,21,0,30,9
1683324211431,MATH 20E,A02,188650,Staff,23,0,30,7
1683324211431,MATH 20E,A03,188673,Staff,0,0,30,30
1683324212455,MATH 102,A01,188675,Staff,0,35,35,35
1683324213482,MATH 103B,A01,188681,Staff,4,0,35,31
1683324213482,MATH 103B,B01,188692,Staff,5,0,35,30
1683324214509,MATH 109,A01,188695,Salehi Golsefidy; Alireza,25,0,35,10
1683324214509,MATH 109,A02,188696,Salehi Golsefidy; Alireza,26,0,35,9
1683324215533,MATH 120A,A01,188698,Eggers; John Dietrich,7,0,35,28
1683324216558,MATH 142B,A01,188736,Ioana; Adrian,0,2,30,30
1683324216558,MATH 142B,A02,188741,Ioana; Adrian,0,1,30,30
1683324216558,MATH 142B,A03,188743,Ioana; Adrian,1,3,30,29
1683324217582,MATH 168A,A01,188790,Staff,0,9,35,35
1683324218606,MATH 170A,A01,188803,Nie; Jiawang,0,2,35,35
1683324218606,MATH 170A,A02,188811,Nie; Jiawang,0,0,35,35
1683324218606,MATH 170A,A03,188814,Nie; Jiawang,1,0,35,34
1683324218606,MATH 170A,A04,188815,Nie; Jiawang,13,0,35,22
1683324219633,MATH 193B,A01,188817,Staff,0,0,35,35
1683324219633,MATH 193B,A02,188818,Staff,5,0,35,30
1683324220660,MGT 4,A01,202857,Anderson; John Charles,62,0,80,18
1683324221683,MGT 12,A00,202858,Lindenberger; Wade Douglas,42,0,90,48
1683324222708,MGT 18,A00,202859,Staff,74,0,90,16
1683324223734,MGT 18GS,A00,202860,McKay; Michael J,13,0,28,15
1683324224759,MGT 45,A00,202861,Pecore; Joseph P.,13,0,90,77
1683324225786,MGT 100,A00,202863,Yavorsky; Daniel Ryan,28,0,90,62
1683324226809,MGT 103,A00,202864,Ehrich; Kristine R,0,18,90,90
1683324227837,MGT 112,A00,202865,Ehrich; Kristine R,15,0,90,75
1683324228862,MGT 121A,A00,202868,Staff,0,20,0,0
1683324229886,MGT 131B,A00,202869,Anderson; John Charles,59,0,90,31
1683324230911,MGT 136,A00,202871,Lindenberger; Wade Douglas,84,0,90,6
1683324231935,MGT 164,A00,202873,Staff,0,68,90,91
1683324232959,MGT 164GS,A00,202874,McKay; Mary A,13,0,28,15
1683324233986,MGT 180,A00,202875,Staff,0,50,90,91
1683324235010,MMW 11R,A01,205019,Herbst; Matthew,3,0,30,27
1683324235010,MMW 11R,A02,205026,Herbst; Matthew,29,0,30,1
1683324236040,MMW 15,A01,193512,Chang; Edmond Yi-Teh,0,9,28,28
1683324236040,MMW 15,A02,193513,Chang; Edmond Yi-Teh,0,5,28,28
1683324236040,MMW 15,A03,193514,Chang; Edmond Yi-Teh,0,5,28,28
1683324236040,MMW 15,A04,193515,Chang; Edmond Yi-Teh,0,5,28,28
1683324236040,MMW 15,A05,193516,Chang; Edmond Yi-Teh,0,4,28,28
1683324236040,MMW 15,A06,193517,Chang; Edmond Yi-Teh,0,5,28,28
1683324236040,MMW 15,B01,193519,Chang; Edmond Yi-Teh,0,4,28,28
1683324236040,MMW 15,B02,193520,Chang; Edmond Yi-Teh,0,5,28,28
1683324236040,MMW 15,B03,193521,Chang; Edmond Yi-Teh,0,4,28,28
1683324236040,MMW 15,B04,193522,Chang; Edmond Yi-Teh,0,4,28,28
1683324236040,MMW 15,B05,193523,Chang; Edmond Yi-Teh,0,5,28,28
1683324236040,MMW 15,B06,193524,Chang; Edmond Yi-Teh,0,4,28,28
1683324237068,MMW 122,A01,193526,Rahimi; Babak,0,15,28,28
1683324237068,MMW 122,A02,193527,Rahimi; Babak,0,14,28,28
1683324237068,MMW 122,A03,193528,Rahimi; Babak,0,0,0,0
1683324237068,MMW 122,A04,193529,Rahimi; Babak,0,0,0,0
1683324238091,MUS 1A,A01,186663,Staff,0,20,35,35
1683324239117,MUS 4,A01,186715,Staff,0,12,35,35
1683324240143,MUS 5R,A01,186796,Dubnov; Shlomo,0,17,35,35
1683324241169,MUS 6,A01,186798,Staff,0,3,25,25
1683324242194,MUS 7,A01,186830,Staff,12,0,35,23
1683324243220,MUS 8,A01,186930,Staff,0,26,35,35
1683324244246,MUS 15,A01,186932,Staff,0,16,35,35
1683324244246,MUS 15,B01,186934,Staff,0,15,35,35
1683324245269,MUS 80,A00,186935,Staff,2,0,20,18
1683324245269,MUS 80,B00,186936,Staff,25,0,25,0
1683324246293,NANO 11,A00,204702,Lipomi; Darren John,0,0,0,0
1683324247321,NANO 15,A01,204709,Yang; Kesong,0,1,0,0
1683324248348,NANO 114,A00,202069,Jahed Motlagh; Zeinab,3,0,10,7
1683324249376,PHIL 1,A00,186955,Grush; Rick Scott,32,0,40,8
1683324250401,PHIL 10,A01,186973,Grush; Rick Scott,28,0,35,7
1683324250401,PHIL 10,A02,186974,Grush; Rick Scott,33,0,35,2
1683324251425,PHIL 13,A01,186976,Staff,7,0,35,28
1683324251425,PHIL 13,A02,186977,Staff,16,0,35,19
1683324252451,PHIL 14,A01,186979,Staff,31,0,35,4
1683324252451,PHIL 14,A02,186986,Staff,32,0,35,3
1683324253476,PHIL 28,A01,186988,Staff,16,0,30,14
1683324253476,PHIL 28,A02,186989,Staff,1,0,30,29
1683324253476,PHIL 28,A03,186990,Staff,9,0,30,21
1683324253476,PHIL 28,A04,186991,Staff,26,0,30,4
1683324254505,PHIL 120,A00,186997,Staff,23,0,40,17
1683324255530,PHIL 137,A00,187003,Staff,9,0,40,31
1683324256554,PHIL 150,A00,187015,Staff,47,0,70,23
1683324257579,PHIL 167,A00,187021,Lamey; Andy M.,35,0,40,5
1683324258603,PHIL 174,A01,202226,Staff,17,0,20,3
1683324258603,PHIL 174,A02,202235,Staff,20,0,20,0
1683324259629,PHIL 191A,A00,258918,Staff,0,0,1,1
1683324260656,PHYS 1A,A00,187028,Staff,27,0,60,33
1683324261681,PHYS 1AL,001,187036,Staff,3,0,30,27
1683324261681,PHYS 1AL,002,187049,Staff,18,0,30,12
1683324262710,PHYS 1B,A00,187058,Staff,22,0,60,38
1683324263742,PHYS 1BL,001,187064,Staff,0,0,30,30
1683324263742,PHYS 1BL,002,187070,Staff,5,0,30,25
1683324264766,PHYS 1C,A00,187082,Staff,31,0,120,89
1683324265792,PHYS 1CL,001,187088,Staff,0,9,30,30
1683324265792,PHYS 1CL,002,187089,Staff,0,2,30,30
1683324265792,PHYS 1CL,009,262693,Staff,11,0,30,19
1683324266886,PHYS 2B,A01,187097,Staff,54,0,115,61
1683324267911,PHYS 2C,A01,187099,Staff,67,0,115,48
1683324268935,PHYS 2CL,A01,187101,Staff,5,0,28,23
1683324268935,PHYS 2CL,A02,187102,Staff,15,0,28,13
1683324269963,PHYS 2D,A01,187123,Shotwell; Brian,95,0,115,20
1683324270987,PHYS 4B,A01,187133,Grinstein; Benjamin,35,0,50,15
1683324272011,POLI 10,A00,188819,Staff,0,4,50,50
1683324273034,POLI 11,A00,188827,Staff,43,0,50,7
1683324274058,POLI 13R,A00,188828,Staff,0,1,20,20
1683324275088,POLI 27,A01,188830,Elgin; Samuel Zincke,0,1,70,70
1683324276112,POLI 30,A00,188832,Desposato; Scott,31,0,50,19
1683324277138,POLI 102F,A00,188834,Staff,3,0,40,37
1683324278164,POLI 104A,A00,188852,Staff,14,0,30,16
1683324279190,POLI 104I,A00,188853,Staff,0,6,20,20
1683324280214,POLI 110B,A00,188854,Wiens; David,7,0,20,13
1683324281240,POLI 112A,A00,188855,Wiens; David,5,0,30,25
1683324282264,POLI 117R,A00,188856,Forman; Fonna,0,11,20,20
1683324283289,POLI 118,A00,188857,Ingham; Sean,8,0,20,12
1683324284312,POLI 120G,A00,188858,Staff,9,0,30,21
1683324285336,POLI 131CR,A00,188863,Hoston; Germaine,24,0,50,26
1683324286360,POLI 133,A00,188864,Nellis; Gareth Hb,44,0,50,6
1683324287384,POLI 134D,A00,188865,Desposato; Scott,27,0,30,3
1683324288411,POLI 142A,A00,188871,Gartzke; Erik,22,0,50,28
1683324289436,POLI 142K,A00,188874,Staff,38,0,50,12
1683324290460,POLI 143,A00,188940,Gartzke; Erik,16,0,30,14
1683324291487,POLI 153,A00,188943,Staff,3,0,20,17
1683324292514,POLI 160AA,A00,188944,Staff,12,0,40,28
1683324293537,POLI 170A,A00,188945,Staff,11,0,30,19
1683324295590,PSYC 1,A00,188952,Staff,37,0,90,53
1683324296613,PSYC 2,B00,188953,Staff,19,0,35,16
1683324297637,PSYC 6,A00,188970,Staff,47,0,60,13
1683324298661,PSYC 7,A00,188973,Staff,37,0,45,8
1683324299685,PSYC 60,A01,188980,Rickard; Timothy C.,43,0,60,17
1683324300711,PSYC 70,A01,189001,Steiner; Eric Tomas,24,0,45,21
1683324301742,PSYC 100,A00,189005,Lacefield; Katharine I,0,99,120,120
1683324302766,PSYC 102,A00,189008,Staff,9,0,30,21
1683324303791,PSYC 106,B00,189026,Gorman; Michael R.,35,0,60,25
1683324304818,PSYC 114,B01,189033,Winkielman; Piotr,0,32,30,30
1683324305842,PSYC 131,A00,189036,Anagnostaras; Stephan,0,43,60,60
1683324306865,PSYC 136,A00,189041,Lowe; Angela Beth,0,7,25,25
1683324307888,PSYC 137,A00,189057,Winkielman; Piotr,0,34,25,25
1683324308911,PSYC 144,A00,189107,Wixted; John T,0,7,50,50
1683324310961,PSYC 162,A00,189142,Staff,0,8,85,85
1683324311986,PSYC 172,A00,189144,Gorman; Michael R.,0,7,30,30
1683324314035,PSYC 179,A00,189146,Lacefield; Katharine I,0,84,120,120
1683324315062,PSYC 181,A00,189147,Anagnostaras; Stephan,0,44,90,90
1683324316087,PSYC 190R,A00,189148,Barner; David A.,0,22,80,80
1683324317111,PSYC 191,A00,189275,Rickard; Timothy C.,0,7,25,25
1683324318135,PSYC 193,A00,189276,Chapman; Eddie Nathaniel,0,1,0,4
1683324319159,PSYC 193L,A01,189281,Lowe; Angela Beth,12,0,20,8
1683324319159,PSYC 193L,B01,189285,Staff,28,0,35,7
1683324320186,RELI 149,A00,187137,Rahimi; Babak,7,0,40,33
1683324321212,SE 9,A01,187315,Staff,0,2,18,18
1683324322239,SE 101B,A00,187409,Staff,24,0,30,6
1683324323263,SE 110B,A00,187444,Staff,10,0,40,30
1683324324290,SE 130B,A00,187449,Staff,31,0,40,9
1683324325313,SE 150A,A00,187516,Staff,9,0,20,11
1683324326340,SE 154,A00,187528,Staff,30,0,50,20
1683324327365,SIO 3,A01,258171,Staff,35,0,40,5
1683324328391,SIO 10,A00,187144,Cook; Geoffrey W,0,3,75,75
1683324329415,SIO 45,A00,187152,Cook; Geoffrey W,1,0,100,99
1683324330439,SIO 109R,A00,194486,Staff,0,3,20,20
1683324332491,SIO 187,A01,187233,Kacev; David,12,0,40,28
1683324333521,SOCI 1,A01,258656,Thorpe; Charles Robert,28,0,30,2
1683324333521,SOCI 1,A02,258658,Thorpe; Charles Robert,30,0,30,0
1683324333521,SOCI 1,A03,258661,Thorpe; Charles Robert,25,0,25,0
1683324333521,SOCI 1,A04,258666,Thorpe; Charles Robert,22,0,25,3
1683324333521,SOCI 1,A05,258897,Thorpe; Charles Robert,23,0,25,2
1683324333521,SOCI 1,A06,258898,Thorpe; Charles Robert,25,0,25,0
1683324334544,SOCI 30,A01,258903,Pardo Guerra; Juan Pablo,16,0,30,14
1683324335570,SOCI 102,A00,258904,Staff,9,0,25,16
1683324336593,SOCI 106,A00,258905,Staff,19,0,25,6
1683324337615,SOCI 111,A00,258907,Ribas Norris; Janet Vanesa,26,0,30,4
1683324338642,SOCI 121R,A00,258908,Pardo Guerra; Juan Pablo,10,0,30,20
1683324339665,SOCI 126,A01,203330,Staff,14,0,20,6
1683324340690,SOCI 131,A00,258909,Thorpe; Charles Robert,31,0,60,29
1683324341716,SOCI 135,A00,258910,Payne; Christine Anna,0,9,30,30
1683324342743,SOCI 157,A00,258911,Staff,12,0,30,18
1683324343769,SOCI 184,A00,258912,Staff,25,0,30,5
1683324344794,SOCI 188D,A00,258913,Staff,21,0,30,9
1683324345819,SYN 2,001,187529,Staff,9,0,16,7
1683324345819,SYN 2,002,201452,Staff,0,18,16,16
1683324345819,SYN 2,003,201469,Staff,4,0,16,12
1683324346847,SYN 100,A01,187531,Staff,0,9,20,20
1683324346847,SYN 100,B01,201491,Staff,0,12,20,20
1683324347875,TDAC 1,A00,189286,Walsh; Kim C.,3,0,20,17
1683324347875,TDAC 1,B00,189287,Harting; Carla Kelso,11,0,20,9
1683324348902,TDAC 101,A00,189300,Walsh; Kim C.,16,0,20,4
1683324348902,TDAC 101,B00,189301,Harting; Carla Kelso,18,0,20,2
1683324349926,TDAC 102,A00,189304,Basso; Beatrice,14,0,20,6
1683324350949,TDAC 108,A00,189305,Staff,18,0,20,2
1683324351973,TDDE 131,A00,189310,Staff,19,0,20,1
1683324351973,TDDE 131,B00,189314,Staff,19,0,20,1
1683324351973,TDDE 131,C00,189315,Staff,48,0,50,2
1683324351973,TDDE 131,D00,189316,Staff,14,0,15,1
1683324351973,TDDE 131,E00,204841,Staff,20,0,20,0
1683324352997,TDGE 10,A00,189289,Staff,30,0,50,20
1683324352997,TDGE 10,B00,189290,Havis; Allan,1,0,50,49
1683324354022,TDGE 11,A00,189291,Fulton; Julia,0,3,50,50
1683324354022,TDGE 11,B00,189292,Staff,20,0,25,5
1683324354022,TDGE 11,C00,260270,Staff,0,0,0,0
1683324355046,TDGE 25,A00,189294,Staff,3,0,20,17
1683324356076,TDGE 124,A00,189318,Fulton; Julia,0,8,50,50
1683324357099,TDGE 125,A00,189319,Staff,13,0,25,12
1683324357099,TDGE 125,B00,189320,Staff,23,0,25,2
1683324358122,TDGE 127,A00,189322,Havis; Allan,0,0,50,50
1683324359149,TDHT 101,A00,189323,Staff,18,0,25,7
1683324359149,TDHT 101,B00,189324,Staff,25,0,25,0
1683324360176,TDHT 102,A00,189325,Staff,49,0,50,1
1683324361200,TDMV 1,A00,189295,Arcidiacono; Kristin,19,0,30,11
1683324361200,TDMV 1,B00,189296,Caligagan; Maria T.,24,0,30,6
1683324362229,TDMV 2,A00,189297,Sammartano; Tonnie,28,0,30,2
1683324362229,TDMV 2,B00,189299,Arcidiacono; Kristin,24,0,30,6
1683324363253,TDMV 3,A00,204998,Rincon; Alicia,22,0,30,8
1683324364279,TDMV 120,A00,189458,Sammartano; Tonnie,28,0,30,2
1683324365302,TDMV 138,A00,189541,Jun; Grace Shin Hae,22,0,40,18
1683324366328,TDMV 142,A00,189717,Caligagan; Tony,23,0,30,7
1683324366328,TDMV 142,B00,189718,Caligagan; Maria T.,25,0,30,5
1683324367352,TMC 2,A01,187533,Staff,25,0,25,0
1683324367352,TMC 2,A02,187534,Staff,25,0,25,0
1683324368380,USP 1,A01,187536,Kwak; Nancy,0,16,25,25
1683324369405,USP 5,A01,187538,Staff,9,0,25,16
1683324370488,USP 101,A00,199253,Staff,0,4,0,0
1683324371514,USP 124,A00,187562,Boomhower; Matthew Charles,1,0,30,29
1683324372541,USP 138,A00,187582,Staff,20,0,25,5
1683324373565,USP 152,A01,187597,Staff,4,0,25,21
1683324374591,USP 153,A00,187598,Staff,19,0,25,6
1683324375617,USP 168,A00,187607,Kwak; Nancy,2,0,5,3
1683324376642,USP 173,A00,187619,Staff,4,0,25,21
1683324377664,USP 181,A00,187638,Staff,0,0,25,25
1683324378687,VIS 103,A00,187650,Cruz; Edwin Teddy,23,0,75,52
1683324379712,VIS 110D,A00,187669,Staff,12,0,22,10
1683324380741,VIS 127C,A00,187720,Shen; Kuiyi,68,0,146,78
1683324381767,VIS 149,A00,187731,Yoldas; Pinar,0,14,22,22
1683324382791,VIS 151,A01,188091,Staff,22,0,34,12
1683324382791,VIS 151,A02,188092,Staff,11,0,34,23
1683324383821,VIS 160B,A00,188093,Stalbaum; Brett,0,0,10,10
1683324385877,WCWP 10B,A00,201720,Staff,10,0,15,5
1683324385877,WCWP 10B,B00,201722,Staff,8,0,15,7
1683324386902,WCWP 100,A00,201725,Gagnon; Jeffrey C,0,0,2,2
1683324386902,WCWP 100,B00,201727,Staff,0,4,15,15
1683324390031,ANBI 133,A00,258401,Wilder; Linnea Lorene,34,0,40,6
1683324391057,ANBI 140,A00,258395,Hrvoj Mihic; Branka,18,0,25,7
1683324392083,ANSC 120,A00,258402,Bialecki; Jon Anthony,27,0,40,13
1683324393107,ANSC 144,A00,258400,Staff,14,0,40,26
1683324395157,ANSC 166,A00,258396,Parish; Steven Martin,157,0,175,18
1683324396179,ANSC 180,A00,193533,Staff,9,0,20,11
1683324397209,ANSC 188,A00,258397,Jassal; Aftab,33,0,40,7
1683324398237,ANTH 3,A01,258316,Staff,23,0,30,7
1683324399263,ANTH 5,A00,258394,Semendeferi; Ekaterini,16,0,20,4
1683324400289,ANTH 21,A01,258331,Staff,9,0,40,31
1683324401313,ANTH 103,A00,258398,Varma; Saiba,15,0,25,10
1683324402340,AWP 10,001,202034,Staff,0,0,0,0
1683324402340,AWP 10,002,202035,Staff,0,0,0,0
1683324402340,AWP 10,003,202036,Staff,0,0,0,0
1683324402340,AWP 10,004,202037,Staff,0,0,0,0
1683324402340,AWP 10,005,202038,Staff,0,0,0,0
1683324402340,AWP 10,006,202039,Staff,0,0,0,0
1683324402340,AWP 10,007,202040,Staff,0,0,0,0
1683324402340,AWP 10,008,202041,Staff,0,0,0,0
1683324402340,AWP 10,009,202042,Staff,0,0,0,0
1683324402340,AWP 10,010,202043,Staff,0,0,0,0
1683324402340,AWP 10,011,202044,Staff,0,0,0,0
1683324402340,AWP 10,012,202045,Staff,0,0,0,0
1683324402340,AWP 10,013,202046,Staff,0,0,0,0
1683324402340,AWP 10,014,202047,Staff,0,0,0,0
1683324402340,AWP 10,015,202048,Staff,0,0,0,0
1683324402340,AWP 10,016,202049,Staff,0,0,0,0
1683324402340,AWP 10,017,202050,Staff,0,0,0,0
1683324402340,AWP 10,018,202051,Staff,0,0,0,0
1683324402340,AWP 10,019,202052,Staff,0,0,0,0
1683324402340,AWP 10,020,202053,Staff,0,0,0,0
1683324402340,AWP 10,021,202054,Staff,0,0,0,0
1683324402340,AWP 10,022,202055,Staff,0,0,0,0
1683324402340,AWP 10,023,202056,Staff,0,0,0,0
1683324402340,AWP 10,024,202057,Staff,0,0,0,0
1683324402340,AWP 10,025,202058,Staff,0,0,0,0
1683324402340,AWP 10,026,202059,Staff,0,0,0,0
1683324403361,AWP 102,001,202032,Staff,0,0,0,0
1683324403361,AWP 102,002,202033,Staff,0,0,0,0
1683324404384,BENG 100,A01,254234,Taylor Amos; Alyssa C,31,0,40,9
1683324405411,BENG 196,001,270013,Engler; Adam J.,9999,0,9999,0
1683324406438,BICD 100R,A01,202018,Smith; Laurie,0,7,32,32
1683324406438,BICD 100R,A02,202019,Smith; Laurie,0,2,32,32
1683324406438,BICD 100R,A03,202020,Smith; Laurie,0,1,32,32
1683324406438,BICD 100R,A04,202021,Smith; Laurie,9,0,32,23
1683324406438,BICD 100R,A05,202022,Smith; Laurie,12,0,32,20
1683324407463,BICD 136,A01,193242,Gustafson-Brown; Cindy,0,2,32,32
1683324407463,BICD 136,A02,193244,Gustafson-Brown; Cindy,14,0,32,18
1683324408493,BIEB 102,A01,193249,Butler; Shannon Rhey,0,2,32,32
1683324408493,BIEB 102,A02,193251,Butler; Shannon Rhey,0,0,32,32
1683324408493,BIEB 102,A03,193253,Butler; Shannon Rhey,0,1,32,32
1683324408493,BIEB 102,A04,193255,Butler; Shannon Rhey,17,0,32,15
1683324408493,BIEB 102,A05,193265,Butler; Shannon Rhey,26,0,32,6
1683324408493,BIEB 102,A06,193269,Butler; Shannon Rhey,16,0,32,16
1683324410547,BIEB 150,A01,193274,Staff,0,0,32,32
1683324410547,BIEB 150,A02,193285,Staff,23,0,32,9
1683324411572,BIEB 194,A00,193286,Kurle; Carolyn M.,22,0,32,10
1683324412600,BILD 1,A01,192291,Staff,16,0,32,16
1683324412600,BILD 1,A02,192292,Staff,30,0,32,2
1683324412600,BILD 1,B01,192520,Reuther; Keefe,0,1,0,0
1683324412600,BILD 1,B02,192532,Reuther; Keefe,0,1,0,0
1683324413626,BILD 3,A01,192556,Butler; Shannon Rhey,0,0,32,32
1683324413626,BILD 3,A02,192581,Butler; Shannon Rhey,5,0,32,27
1683324413626,BILD 3,A03,192611,Butler; Shannon Rhey,23,0,32,9
1683324413626,BILD 3,A04,192612,Butler; Shannon Rhey,25,0,32,7
1683324413626,BILD 3,A05,192613,Butler; Shannon Rhey,27,0,32,5
1683324413626,BILD 3,A06,192679,Butler; Shannon Rhey,27,0,32,5
1683324413626,BILD 3,A07,192682,Butler; Shannon Rhey,22,0,32,10
1683324414653,BILD 4,A01,192836,Reuther; Keefe,0,0,24,24
1683324414653,BILD 4,A02,193044,Reuther; Keefe,4,0,24,20
1683324415677,BILD 10,A01,193142,Gustafson-Brown; Cindy,30,0,32,2
1683324415677,BILD 10,A02,193149,Gustafson-Brown; Cindy,31,0,32,1
1683324416702,BIMM 100,A01,193301,Staff,0,6,32,32
1683324416702,BIMM 100,A02,193312,Staff,0,5,32,32
1683324416702,BIMM 100,A03,193323,Staff,0,8,32,32
1683324417727,BIMM 101,A01,193329,McDonnell; Lisa Marie,0,3,24,24
1683324417727,BIMM 101,A02,193339,McDonnell; Lisa Marie,0,3,24,24
1683324417727,BIMM 101,B01,193354,McDonnell; Lisa Marie,0,3,24,24
1683324417727,BIMM 101,B02,193357,McDonnell; Lisa Marie,0,3,24,24
1683324418756,BIMM 110,A01,193377,Tat; John,0,11,32,32
1683324418756,BIMM 110,A02,193378,Tat; John,1,9,32,31
1683324419782,BIMM 120,A01,206116,Staff,0,0,32,32
1683324419782,BIMM 120,A02,206117,Staff,8,0,32,24
1683324419782,BIMM 120,A03,206121,Staff,21,0,32,11
1683324420810,BIPN 100,A01,193393,Park; Ji Young,0,14,32,32
1683324420810,BIPN 100,A02,193402,Park; Ji Young,0,12,32,32
1683324420810,BIPN 100,A03,193413,Park; Ji Young,0,14,32,32
1683324420810,BIPN 100,A04,193414,Park; Ji Young,0,13,32,32
1683324421834,BIPN 102,A01,193429,Staff,0,0,32,32
1683324421834,BIPN 102,A02,193438,Staff,22,0,32,10
1683324422858,BIPN 106,A01,193450,Reyes Gonzalez; Catalina,0,2,40,40
1683324423885,BIPN 134,A01,193465,Cooke; James Edward,0,0,32,32
1683324423885,BIPN 134,A02,193474,Cooke; James Edward,25,0,32,7
1683324423885,BIPN 134,A03,193485,Cooke; James Edward,29,0,32,3
1683324423885,BIPN 134,A04,193486,Cooke; James Edward,21,0,32,11
1683324423885,BIPN 134,A05,193491,Cooke; James Edward,31,0,32,1
1683324423885,BIPN 134,A06,193501,Cooke; James Edward,30,0,32,2
1683324423885,BIPN 134,A07,193510,Cooke; James Edward,29,0,32,3
1683324425934,BISP 194,A00,222522,Staff,14,0,32,18
1683324426962,CAT 124,A01,202407,Staff,20,0,25,5
1683324427987,CAT 125,A00,202408,Marchisotto; Jennifer Anne,4,0,20,16
1683324429011,CAT 125R,A00,202409,Smith; Lauryn Alissa,0,11,20,20
1683324429011,CAT 125R,B00,202410,Morales; Celeste Georgianna,0,11,20,20
1683324429011,CAT 125R,C00,202411,Irwin; Matthew Joseph,0,10,20,20
1683324430035,CENG 15,A01,204712,Yang; Kesong,0,1,0,0
1683324431061,CENG 114,A00,202070,Jahed Motlagh; Zeinab,5,0,20,15
1683324432089,CGS 105,A00,185477,Wesling; Megan E.,24,0,40,16
1683324433115,CGS 106,A00,185494,Staff,13,0,22,9
1683324434138,CGS 108,A00,185495,Staff,14,0,20,6
1683324435165,CGS 114,A00,185496,Staff,13,0,18,5
1683324436190,CGS 119,A00,185501,Staff,15,0,20,5
1683324437214,CGS 120,A00,185511,Staff,13,0,20,7
1683324438239,CHEM 4,A01,184675,Bussey; Thomas J,96,0,100,4
1683324439263,CHEM 6A,A01,184677,Staff,34,0,60,26
1683324440288,CHEM 6B,A01,184679,Staff,65,0,100,35
1683324441316,CHEM 6C,A01,184681,Bussey; Thomas J,1,0,50,49
1683324441316,CHEM 6C,A02,184682,Bussey; Thomas J,34,0,50,16
1683324442343,CHEM 40A,A01,184684,Albizati; Kim F.,37,0,100,63
1683324443365,CHEM 40B,A01,184686,Albizati; Kim F.,0,20,100,100
1683324444389,CHEM 41B,A01,184690,Staff,52,0,100,48
1683324445412,COGS 3,A01,184715,Boyle; Mary E. T.,0,25,40,40
1683324446436,COGS 14B,A01,185172,Staff,0,15,38,38
1683324447460,COGS 18,A01,184736,Staff,18,0,80,62
1683324448487,COGS 100,A01,184932,Staff,0,5,73,73
1683324449512,COGS 101A,A01,184935,Staff,0,38,30,30
1683324450541,COGS 101B,A01,184944,Staff,0,2,30,30
1683324451566,COGS 101C,A01,184946,Staff,0,12,30,30
1683324452590,COGS 102A,A01,184951,Johnson; Christine M.,2,0,40,38
1683324453613,COGS 107B,A01,184953,Mooshagian; Eric Frederick,0,50,40,40
1683324454640,COGS 118B,A01,184959,Gupta; Anjum,0,48,40,40
1683324455664,COGS 153,A00,184961,Staff,0,15,30,30
1683324456690,COGS 177,A00,184962,Staff,0,20,30,30
1683324457715,COGS 187A,A01,184969,Boyle; Mary E. T.,0,17,40,40
1683324458740,COMM 10,A01,185174,Staff,0,5,25,25
1683324458740,COMM 10,A02,185189,Staff,0,5,25,25
1683324458740,COMM 10,A03,269821,Staff,0,0,0,0
1683324459767,COMM 100B,A01,185475,Staff,0,0,0,2
1683324459767,COMM 100B,A02,185476,Staff,14,0,25,11
1683324460792,COMM 100C,A01,185314,Staff,1,0,25,24
1683324460792,COMM 100C,A02,185327,Staff,19,0,25,6
1683324461817,COMM 110M,A00,185349,Staff,2,0,40,38
1683324462840,COMM 113T,A00,185352,Staff,25,0,40,15
1683324463864,COMM 114I,A00,185353,Staff,33,0,40,7
1683324464887,COMM 131,A00,185354,Staff,19,0,30,11
1683324465914,CSE 8A,A50,185358,Cao; Yingjun,0,46,10,10
1683324466939,CSE 8B,A01,185362,Staff,1,47,50,49
1683324467962,CSE 11,A01,185416,Cao; Yingjun,0,92,10,10
1683324468990,CSE 20,A01,185445,Briones; Jor-el Thomas Caparas,5,0,25,20
1683324470013,CSE 21,A01,185447,Staff,10,0,50,40
1683324471043,CSE 101,A01,185451,Staff,0,12,50,50
1683324471043,CSE 101,B01,185453,Jones; Miles E,0,11,50,50
1683324473091,CSE 141,A01,185458,Eldon; John,20,0,100,80
1683324474192,CSE 141L,A01,185461,Eldon; John,12,0,100,88
1683324475215,CSE 142,A01,185463,Staff,36,0,60,24
1683324475215,CSE 142,B01,201355,Staff,0,7,60,60
1683324476239,CSE 142L,A01,185470,Staff,36,0,60,24
1683324476239,CSE 142L,B01,201417,Staff,0,6,60,60
1683324477264,CSE 190,A00,201433,Staff,32,0,49,17
1683324478289,DOC 1,A01,259136,Strom; Megan C.,7,0,15,8
1683324478289,DOC 1,A02,259137,Strom; Megan C.,14,0,15,1
1683324478289,DOC 1,A03,259138,Strom; Megan C.,14,0,15,1
1683324478289,DOC 1,A04,259139,Strom; Megan C.,14,0,15,1
1683324479311,DOC 100D,A00,259140,Pass; Natalye Joann,16,0,25,9
1683324480338,DSGN 1,A01,184749,Rill; Bryan,0,26,30,30
1683324481365,DSGN 100,A01,185168,Staff,0,2,25,25
1683324482390,ECE 5,A01,185626,Morris; Karcher William,0,10,0,0
1683324483417,ECE 101,A01,185628,Staff,17,0,70,53
1683324484444,ECE 107,A01,185635,Baghdadchi; Saharnaz,0,0,20,20
1683324484444,ECE 107,A02,185638,Baghdadchi; Saharnaz,4,0,20,16
1683324485468,ECE 148,A01,185647,Silberman; Jack,0,0,16,16
1683324486493,ECON 1,A01,185537,Crane; Meredith Helen,54,0,70,16
1683324487518,ECON 3,A01,185549,Crane; Meredith Helen,33,0,70,37
1683324488542,ECON 4,A01,203354,Anderson; John Charles,0,4,10,10
1683324489566,ECON 100A,A01,185574,Staff,0,4,40,40
1683324490591,ECON 100B,A01,185576,Staff,0,22,40,40
1683324491614,ECON 100C,A01,185589,Newhouse; Herbert S,30,0,70,40
1683324492638,ECON 105,A00,185608,Vespa; Emanuel Ignacio,19,0,35,16
1683324493662,ECON 109,A01,185610,Shishkin; Denis,10,0,35,25
1683324494687,ECON 110A,A01,185612,Staff,11,0,40,29
1683324495711,ECON 120A,A01,185615,Staff,20,0,40,20
1683324496734,ECON 120C,A01,185617,Sun; Yixiao,0,20,70,70
1683324497760,ECON 144,A00,203346,Squires; Dale E,3,0,35,32
1683324498787,ECON 171,A01,203349,Newhouse; Herbert S,0,1,35,35
1683324499814,ECON 173A,A01,185621,Toda; Alexis Akira,21,0,35,14
1683324500839,EDS 25,A01,202413,Staff,0,1,0,0
1683324500839,EDS 25,A02,202414,Staff,0,1,0,0
1683324500839,EDS 25,A03,202415,Staff,0,0,0,0
1683324500839,EDS 25,A04,202416,Staff,0,1,0,0
1683324500839,EDS 25,A05,202439,Staff,0,0,0,0
1683324500839,EDS 25,A06,202440,Staff,0,0,0,0
1683324500839,EDS 25,B01,202631,Staff,0,0,0,0
1683324500839,EDS 25,B02,202632,Staff,0,0,0,0
1683324500839,EDS 25,B03,202639,Staff,0,0,0,0
1683324500839,EDS 25,B04,202640,Staff,0,0,0,0
1683324500839,EDS 25,B05,202643,Staff,0,0,0,0
1683324500839,EDS 25,B06,202644,Staff,0,0,0,0
1683324501862,EDS 38,A01,202659,Black; Alison Michelle,24,0,25,1
1683324502886,EDS 115,A00,202652,Staff,17,0,30,13
1683324503913,EDS 125,A00,202649,Staff,14,0,30,16
1683324504938,EDS 126,A01,203332,Staff,30,0,30,0
1683324505964,EDS 139,A00,202838,Staff,16,0,25,9
1683324506990,EDS 146,A01,202655,Staff,14,0,25,11
1683324508018,ENG 15,A00,185667,Staff,0,1,0,0
1683324508018,ENG 15,B00,185672,Staff,0,0,0,0
1683324508018,ENG 15,C00,185675,Staff,0,0,0,0
1683324508018,ENG 15,D00,185682,Staff,0,0,0,0
1683324508018,ENG 15,E00,185684,Staff,0,0,0,0
1683324509043,ETHN 103,A00,185710,Staff,0,3,35,35
1683324510068,ETHN 103A,A00,199228,Man; Simeon S,2,0,9,7
1683324511093,ETHN 109,A00,185711,Staff,18,0,35,17
1683324512119,ETHN 142,A00,185726,Staff,0,4,30,30
1683324513147,ETHN 163J,A00,199229,Man; Simeon S,5,0,8,3
1683324514173,ETHN 168,A00,185727,Staff,8,0,10,2
1683324515196,ETHN 182,A00,185728,Staff,1,0,35,34
1683324516223,ETHN 183,A00,185737,Staff,8,0,18,10
1683324517246,GLBH 111,A01,209361,Burgos; Jose L.,0,0,0,0
1683324519298,HIEU 104,A00,185792,Staff,16,0,20,4
1683324520324,HIEU 115,A00,185800,Staff,1,0,20,19
1683324521348,HIEU 128,A00,185801,Staff,0,7,20,20
1683324522372,HIEU 147,A00,185802,Staff,16,0,20,4
1683324523395,HIEU 154,A00,185823,Staff,12,0,20,8
1683324524419,HILA 102,A00,185826,Staff,13,0,20,7
1683324525444,HILD 2C,A01,185778,Staff,0,12,20,20
1683324526469,HILD 7B,A01,185780,Kwak; Nancy,0,15,32,32
1683324526469,HILD 7B,A02,185781,Kwak; Nancy,0,18,32,32
1683324527497,HILD 30,A01,185791,Staff,14,0,20,6
1683324528525,HISC 119,A00,185830,Golan; Tal,0,9,20,20
1683324529550,HITO 156GS,A00,185831,Patterson; Patrick H.,0,0,0,23
1683324530574,HIUS 103,A00,185832,Man; Simeon S,0,6,20,20
1683324531598,HIUS 117,A00,185836,Kwak; Nancy,2,0,20,18
1683324532625,HIUS 125,A00,185840,Man; Simeon S,0,0,23,23
1683324533651,HIUS 149,A00,185845,Staff,0,0,20,20
1683324534675,HUM 3,A01,185882,Zavodny; Tatiana Sophia,0,6,50,50
1683324534675,HUM 3,B01,185899,Caldwell; Michael Alan,0,18,50,50
1683324535701,HUM 3GS,A00,185900,Patterson; Patrick H.,0,0,0,23
1683324536726,HUM 4,A01,185938,Zroka; Amy Liane,31,0,50,19
1683324536726,HUM 4,B01,185956,Watkins; Eric,0,2,50,50
1683324536726,HUM 4,B02,202209,Watkins; Eric,0,2,50,50
1683324536726,HUM 4,B03,202210,Watkins; Eric,0,1,50,50
1683324537754,HUM 5,A01,185958,West; Geoffrey Scott,3,0,50,47
1683324537754,HUM 5,A02,202215,West; Geoffrey Scott,0,0,50,50
1683324538780,INTL 190,A00,185959,Gagnon; Jeffrey C,0,0,0,9
1683324538780,INTL 190,B00,185960,Lettieri; Michael Joseph,0,0,0,1
1683324539806,JAPN 180,A00,254509,Staff,5,1,30,25
1683324540831,LATI 10,A01,202853,Kennemore; Amy Michelle,4,0,35,31
1683324540831,LATI 10,A02,202854,Kennemore; Amy Michelle,2,0,35,33
1683324540831,LATI 10,A03,270054,Kennemore; Amy Michelle,30,0,30,0
1683324541859,LATI 180,A00,202855,Kennemore; Amy Michelle,11,0,20,9
1683324542886,LAWS 101,A00,201767,Golan; Tal,0,7,40,40
1683324543910,LIFR 1C,A00,185961,Staff,6,0,20,14
1683324544934,LIFR 1CX,A00,185962,Staff,7,0,20,13
1683324545957,LIFR 1D,A00,185963,Staff,9,0,20,11
1683324546984,LIFR 1DX,A00,185964,Staff,9,0,20,11
1683324548015,LIGN 101,A01,186039,Staff,43,0,50,7
1683324549038,LIGN 165,A00,186040,Staff,18,0,50,32
1683324550062,LTCS 108,A00,186041,Staff,6,0,10,4
1683324551086,LTCS 119,A00,186042,Staff,16,0,20,4
1683324552111,LTCS 130,A00,186043,Wesling; Megan E.,15,0,25,10
1683324554161,LTEA 138,A00,186119,Staff,14,0,40,26
1683324555185,LTEN 124,A00,186148,Staff,6,0,25,19
1683324556209,LTEN 178,A00,186149,Staff,7,0,15,8
1683324557236,LTEN 181,A00,186150,Blanco; John D,33,0,40,7
1683324558262,LTWL 120,A00,186160,Staff,20,0,25,5
1683324559289,LTWL 165,A00,186161,Staff,22,0,25,3
1683324560315,LTWR 100,A00,186162,Staff,0,5,15,15
1683324561338,LTWR 102,A00,186163,Doller; Ben,5,0,15,10
1683324562365,MAE 8,A01,186412,Staff,0,0,0,0
1683324563389,MAE 30B,A00,186445,Bahadori; Mohammad Yousef,83,0,100,17
1683324564417,MAE 40,A00,186592,Bewley; Thomas R,9,0,50,41
1683324565442,MAE 101B,A00,186593,Bahadori; Mohammad Yousef,81,0,100,19
1683324566470,MAE 105,A00,186594,Bandaru; Prabhakar,12,0,50,38
1683324567493,MAE 107,A00,186599,Pham; Hieu Tan,0,6,120,120
1683324568516,MAE 148,A01,186660,Silberman; Jack,3,0,16,13
1683324569542,MATH 10A,A01,188095,Staff,1,6,35,34
1683324570566,MATH 10B,A01,188097,Bowers; Adam R.,0,11,30,30
1683324570566,MATH 10B,A02,188099,Bowers; Adam R.,0,11,30,30
1683324570566,MATH 10B,B01,188104,Bowers; Adam R.,0,10,30,30
1683324570566,MATH 10B,B02,188106,Bowers; Adam R.,0,10,30,30
1683324571590,MATH 10C,A01,188111,Staff,0,18,30,30
1683324571590,MATH 10C,A02,188127,Staff,0,17,30,30
1683324571590,MATH 10C,A03,188131,Staff,0,18,30,30
1683324571590,MATH 10C,B01,188218,Staff,18,0,30,12
1683324571590,MATH 10C,B02,188244,Staff,13,0,30,17
1683324571590,MATH 10C,B03,188277,Staff,16,0,30,14
1683324572619,MATH 18,A01,188344,Bach; Quang Tran,18,0,30,12
1683324572619,MATH 18,A02,188345,Bach; Quang Tran,11,0,30,19
1683324572619,MATH 18,B01,188353,Bach; Quang Tran,10,0,30,20
1683324572619,MATH 18,B02,188354,Bach; Quang Tran,20,0,30,10
1683324573642,MATH 20A,A01,188374,Staff,13,0,35,22
1683324574670,MATH 20B,A01,188382,Ohm; Ko Woon,6,0,30,24
1683324574670,MATH 20B,A02,188383,Ohm; Ko Woon,22,0,30,8
1683324574670,MATH 20B,B01,188385,Ohm; Ko Woon,7,0,30,23
1683324574670,MATH 20B,B02,188392,Ohm; Ko Woon,22,0,30,8
1683324575701,MATH 20C,A01,188394,Harel; Guershon,10,0,30,20
1683324575701,MATH 20C,A02,188395,Harel; Guershon,14,0,30,16
1683324575701,MATH 20C,B01,188404,Harel; Guershon,5,0,30,25
1683324575701,MATH 20C,B02,188405,Harel; Guershon,19,0,30,11
1683324576730,MATH 20D,A01,188414,Hammock; Frances H,0,1,30,30
1683324576730,MATH 20D,A02,188415,Hammock; Frances H,3,0,30,27
1683324576730,MATH 20D,B01,188447,Hammock; Frances H,2,0,30,28
1683324576730,MATH 20D,B02,188486,Hammock; Frances H,8,0,30,22
1683324577813,MATH 20E,A01,188649,Staff,21,0,30,9
1683324577813,MATH 20E,A02,188650,Staff,23,0,30,7
1683324577813,MATH 20E,A03,188673,Staff,0,0,30,30
1683324578839,MATH 102,A01,188675,Staff,0,35,35,35
1683324579863,MATH 103B,A01,188681,Staff,4,0,35,31
1683324579863,MATH 103B,B01,188692,Staff,5,0,35,30
1683324580890,MATH 109,A01,188695,Salehi Golsefidy; Alireza,25,0,35,10
1683324580890,MATH 109,A02,188696,Salehi Golsefidy; Alireza,26,0,35,9
1683324581918,MATH 120A,A01,188698,Eggers; John Dietrich,7,0,35,28
1683324582942,MATH 142B,A01,188736,Ioana; Adrian,0,2,30,30
1683324582942,MATH 142B,A02,188741,Ioana; Adrian,0,1,30,30
1683324582942,MATH 142B,A03,188743,Ioana; Adrian,1,3,30,29
1683324583967,MATH 168A,A01,188790,Staff,0,9,35,35
1683324584992,MATH 170A,A01,188803,Nie; Jiawang,0,2,35,35
1683324584992,MATH 170A,A02,188811,Nie; Jiawang,0,0,35,35
1683324584992,MATH 170A,A03,188814,Nie; Jiawang,1,0,35,34
1683324584992,MATH 170A,A04,188815,Nie; Jiawang,13,0,35,22
1683324586019,MATH 193B,A01,188817,Staff,0,0,35,35
1683324586019,MATH 193B,A02,188818,Staff,5,0,35,30
1683324587044,MGT 4,A01,202857,Anderson; John Charles,62,0,80,18
1683324588068,MGT 12,A00,202858,Lindenberger; Wade Douglas,42,0,90,48
1683324589095,MGT 18,A00,202859,Staff,74,0,90,16
1683324590124,MGT 18GS,A00,202860,McKay; Michael J,13,0,28,15
1683324591149,MGT 45,A00,202861,Pecore; Joseph P.,13,0,90,77
1683324592175,MGT 100,A00,202863,Yavorsky; Daniel Ryan,28,0,90,62
1683324593199,MGT 103,A00,202864,Ehrich; Kristine R,0,18,90,90
1683324594223,MGT 112,A00,202865,Ehrich; Kristine R,15,0,90,75
1683324595246,MGT 121A,A00,202868,Staff,0,20,0,0
1683324596270,MGT 131B,A00,202869,Anderson; John Charles,59,0,90,31
1683324597293,MGT 136,A00,202871,Lindenberger; Wade Douglas,84,0,90,6
1683324598321,MGT 164,A00,202873,Staff,0,68,90,91
1683324599345,MGT 164GS,A00,202874,McKay; Mary A,13,0,28,15
1683324600372,MGT 180,A00,202875,Staff,0,50,90,91
1683324601396,MMW 11R,A01,205019,Herbst; Matthew,3,0,30,27
1683324601396,MMW 11R,A02,205026,Herbst; Matthew,29,0,30,1
1683324602422,MMW 15,A01,193512,Chang; Edmond Yi-Teh,0,9,28,28
1683324602422,MMW 15,A02,193513,Chang; Edmond Yi-Teh,0,5,28,28
1683324602422,MMW 15,A03,193514,Chang; Edmond Yi-Teh,0,5,28,28
1683324602422,MMW 15,A04,193515,Chang; Edmond Yi-Teh,0,5,28,28
1683324602422,MMW 15,A05,193516,Chang; Edmond Yi-Teh,0,4,28,28
1683324602422,MMW 15,A06,193517,Chang; Edmond Yi-Teh,0,5,28,28
1683324602422,MMW 15,B01,193519,Chang; Edmond Yi-Teh,0,5,28,28
1683324602422,MMW 15,B02,193520,Chang; Edmond Yi-Teh,0,5,28,28
1683324602422,MMW 15,B03,193521,Chang; Edmond Yi-Teh,0,4,28,28
1683324602422,MMW 15,B04,193522,Chang; Edmond Yi-Teh,0,4,28,28
1683324602422,MMW 15,B05,193523,Chang; Edmond Yi-Teh,0,5,28,28
1683324602422,MMW 15,B06,193524,Chang; Edmond Yi-Teh,0,4,28,28
1683324603447,MMW 122,A01,193526,Rahimi; Babak,0,15,28,28
1683324603447,MMW 122,A02,193527,Rahimi; Babak,0,14,28,28
1683324603447,MMW 122,A03,193528,Rahimi; Babak,0,0,0,0
1683324603447,MMW 122,A04,193529,Rahimi; Babak,0,0,0,0
1683324604474,MUS 1A,A01,186663,Staff,0,20,35,35
1683324605501,MUS 4,A01,186715,Staff,0,12,35,35
1683324606525,MUS 5R,A01,186796,Dubnov; Shlomo,0,17,35,35
1683324607549,MUS 6,A01,186798,Staff,0,4,25,25
1683324608574,MUS 7,A01,186830,Staff,12,0,35,23
1683324609600,MUS 8,A01,186930,Staff,0,27,35,35
1683324610629,MUS 15,A01,186932,Staff,0,16,35,35
1683324610629,MUS 15,B01,186934,Staff,0,15,35,35
1683324611653,MUS 80,A00,186935,Staff,2,0,20,18
1683324611653,MUS 80,B00,186936,Staff,25,0,25,0
1683324612680,NANO 11,A00,204702,Lipomi; Darren John,0,0,0,0
1683324613707,NANO 15,A01,204709,Yang; Kesong,0,1,0,0
1683324614731,NANO 114,A00,202069,Jahed Motlagh; Zeinab,3,0,10,7
1683324615754,PHIL 1,A00,186955,Grush; Rick Scott,32,0,40,8
1683324616776,PHIL 10,A01,186973,Grush; Rick Scott,28,0,35,7
1683324616776,PHIL 10,A02,186974,Grush; Rick Scott,33,0,35,2
1683324617800,PHIL 13,A01,186976,Staff,7,0,35,28
1683324617800,PHIL 13,A02,186977,Staff,16,0,35,19
1683324618829,PHIL 14,A01,186979,Staff,31,0,35,4
1683324618829,PHIL 14,A02,186986,Staff,32,0,35,3
1683324619855,PHIL 28,A01,186988,Staff,16,0,30,14
1683324619855,PHIL 28,A02,186989,Staff,1,0,30,29
1683324619855,PHIL 28,A03,186990,Staff,9,0,30,21
1683324619855,PHIL 28,A04,186991,Staff,26,0,30,4
1683324620881,PHIL 120,A00,186997,Staff,23,0,40,17
1683324621907,PHIL 137,A00,187003,Staff,9,0,40,31
1683324622931,PHIL 150,A00,187015,Staff,47,0,70,23
1683324623959,PHIL 167,A00,187021,Lamey; Andy M.,35,0,40,5
1683324624987,PHIL 174,A01,202226,Staff,17,0,20,3
1683324624987,PHIL 174,A02,202235,Staff,20,0,20,0
1683324626011,PHIL 191A,A00,258918,Staff,0,0,1,1
1683324627038,PHYS 1A,A00,187028,Staff,27,0,60,33
1683324628067,PHYS 1AL,001,187036,Staff,3,0,30,27
1683324628067,PHYS 1AL,002,187049,Staff,18,0,30,12
1683324629090,PHYS 1B,A00,187058,Staff,22,0,60,38
1683324630115,PHYS 1BL,001,187064,Staff,0,0,30,30
1683324630115,PHYS 1BL,002,187070,Staff,5,0,30,25
1683324631143,PHYS 1C,A00,187082,Staff,31,0,120,89
1683324632166,PHYS 1CL,001,187088,Staff,0,9,30,30
1683324632166,PHYS 1CL,002,187089,Staff,0,2,30,30
1683324632166,PHYS 1CL,009,262693,Staff,11,0,30,19
1683324633190,PHYS 2B,A01,187097,Staff,54,0,115,61
1683324634283,PHYS 2C,A01,187099,Staff,67,0,115,48
1683324635308,PHYS 2CL,A01,187101,Staff,5,0,28,23
1683324635308,PHYS 2CL,A02,187102,Staff,15,0,28,13
1683324636331,PHYS 2D,A01,187123,Shotwell; Brian,95,0,115,20
1683324637358,PHYS 4B,A01,187133,Grinstein; Benjamin,35,0,50,15
1683324638386,POLI 10,A00,188819,Staff,0,4,50,50
1683324639412,POLI 11,A00,188827,Staff,43,0,50,7
1683324640438,POLI 13R,A00,188828,Staff,0,1,20,20
1683324641464,POLI 27,A01,188830,Elgin; Samuel Zincke,0,1,70,70
1683324642488,POLI 30,A00,188832,Desposato; Scott,31,0,50,19
1683324643513,POLI 102F,A00,188834,Staff,3,0,40,37
1683324644536,POLI 104A,A00,188852,Staff,14,0,30,16
1683324645563,POLI 104I,A00,188853,Staff,0,6,20,20
1683324646591,POLI 110B,A00,188854,Wiens; David,7,0,20,13
1683324647617,POLI 112A,A00,188855,Wiens; David,5,0,30,25
1683324648641,POLI 117R,A00,188856,Forman; Fonna,0,11,20,20
1683324649666,POLI 118,A00,188857,Ingham; Sean,8,0,20,12
1683324650691,POLI 120G,A00,188858,Staff,9,0,30,21
1683324651714,POLI 131CR,A00,188863,Hoston; Germaine,24,0,50,26
1683324652738,POLI 133,A00,188864,Nellis; Gareth Hb,44,0,50,6
1683324653763,POLI 134D,A00,188865,Desposato; Scott,27,0,30,3
1683324654786,POLI 142A,A00,188871,Gartzke; Erik,22,0,50,28
1683324655813,POLI 142K,A00,188874,Staff,38,0,50,12
1683324656839,POLI 143,A00,188940,Gartzke; Erik,16,0,30,14
1683324657864,POLI 153,A00,188943,Staff,3,0,20,17
1683324658890,POLI 160AA,A00,188944,Staff,12,0,40,28
1683324659913,POLI 170A,A00,188945,Staff,11,0,30,19
1683324661963,PSYC 1,A00,188952,Staff,37,0,90,53
1683324662989,PSYC 2,B00,188953,Staff,19,0,35,16
1683324664016,PSYC 6,A00,188970,Staff,47,0,60,13
1683324665043,PSYC 7,A00,188973,Staff,37,0,45,8
1683324666067,PSYC 60,A01,188980,Rickard; Timothy C.,43,0,60,17
1683324667094,PSYC 70,A01,189001,Steiner; Eric Tomas,24,0,45,21
1683324668121,PSYC 100,A00,189005,Lacefield; Katharine I,0,100,120,120
1683324669150,PSYC 102,A00,189008,Staff,9,0,30,21
1683324670174,PSYC 106,B00,189026,Gorman; Michael R.,35,0,60,25
1683324671201,PSYC 114,B01,189033,Winkielman; Piotr,0,32,30,30
1683324672227,PSYC 131,A00,189036,Anagnostaras; Stephan,0,43,60,60
1683324673254,PSYC 136,A00,189041,Lowe; Angela Beth,0,7,25,25
1683324674279,PSYC 137,A00,189057,Winkielman; Piotr,0,34,25,25
1683324675306,PSYC 144,A00,189107,Wixted; John T,0,7,50,50
1683324677353,PSYC 162,A00,189142,Staff,0,8,85,85
1683324678381,PSYC 172,A00,189144,Gorman; Michael R.,0,7,30,30
1683324680431,PSYC 179,A00,189146,Lacefield; Katharine I,0,84,120,120
1683324681509,PSYC 181,A00,189147,Anagnostaras; Stephan,0,44,90,90
1683324682533,PSYC 190R,A00,189148,Barner; David A.,0,22,80,80
1683324683561,PSYC 191,A00,189275,Rickard; Timothy C.,0,7,25,25
1683324684588,PSYC 193,A00,189276,Chapman; Eddie Nathaniel,0,1,0,4
1683324685616,PSYC 193L,A01,189281,Lowe; Angela Beth,12,0,20,8
1683324685616,PSYC 193L,B01,189285,Staff,28,0,35,7
1683324686641,RELI 149,A00,187137,Rahimi; Babak,7,0,40,33
1683324687668,SE 9,A01,187315,Staff,0,2,18,18
1683324688691,SE 101B,A00,187409,Staff,24,0,30,6
1683324689714,SE 110B,A00,187444,Staff,10,0,40,30
1683324690741,SE 130B,A00,187449,Staff,31,0,40,9
1683324691768,SE 150A,A00,187516,Staff,9,0,20,11
1683324692793,SE 154,A00,187528,Staff,30,0,50,20
1683324693818,SIO 3,A01,258171,Staff,35,0,40,5
1683324694844,SIO 10,A00,187144,Cook; Geoffrey W,0,3,75,75
1683324695871,SIO 45,A00,187152,Cook; Geoffrey W,1,0,100,99
1683324696893,SIO 109R,A00,194486,Staff,0,3,20,20
1683324698944,SIO 187,A01,187233,Kacev; David,12,0,40,28
1683324699973,SOCI 1,A01,258656,Thorpe; Charles Robert,28,0,30,2
1683324699973,SOCI 1,A02,258658,Thorpe; Charles Robert,30,0,30,0
1683324699973,SOCI 1,A03,258661,Thorpe; Charles Robert,25,0,25,0
1683324699973,SOCI 1,A04,258666,Thorpe; Charles Robert,22,0,25,3
1683324699973,SOCI 1,A05,258897,Thorpe; Charles Robert,23,0,25,2
1683324699973,SOCI 1,A06,258898,Thorpe; Charles Robert,25,0,25,0
1683324700999,SOCI 30,A01,258903,Pardo Guerra; Juan Pablo,16,0,30,14
1683324702022,SOCI 102,A00,258904,Staff,9,0,25,16
1683324703090,SOCI 106,A00,258905,Staff,19,0,25,6
1683324704114,SOCI 111,A00,258907,Ribas Norris; Janet Vanesa,26,0,30,4
1683324705137,SOCI 121R,A00,258908,Pardo Guerra; Juan Pablo,10,0,30,20
1683324706160,SOCI 126,A01,203330,Staff,14,0,20,6
1683324707188,SOCI 131,A00,258909,Thorpe; Charles Robert,31,0,60,29
1683324708211,SOCI 135,A00,258910,Payne; Christine Anna,0,9,30,30
1683324709237,SOCI 157,A00,258911,Staff,12,0,30,18
1683324710262,SOCI 184,A00,258912,Staff,25,0,30,5
1683324711285,SOCI 188D,A00,258913,Staff,21,0,30,9
1683324712308,SYN 2,001,187529,Staff,9,0,16,7
1683324712308,SYN 2,002,201452,Staff,0,18,16,16
1683324712308,SYN 2,003,201469,Staff,4,0,16,12
1683324713332,SYN 100,A01,187531,Staff,0,9,20,20
1683324713332,SYN 100,B01,201491,Staff,0,12,20,20
1683324714356,TDAC 1,A00,189286,Walsh; Kim C.,3,0,20,17
1683324714356,TDAC 1,B00,189287,Harting; Carla Kelso,11,0,20,9
1683324715378,TDAC 101,A00,189300,Walsh; Kim C.,16,0,20,4
1683324715378,TDAC 101,B00,189301,Harting; Carla Kelso,18,0,20,2
1683324716405,TDAC 102,A00,189304,Basso; Beatrice,14,0,20,6
1683324717433,TDAC 108,A00,189305,Staff,18,0,20,2
1683324718460,TDDE 131,A00,189310,Staff,19,0,20,1
1683324718460,TDDE 131,B00,189314,Staff,19,0,20,1
1683324718460,TDDE 131,C00,189315,Staff,48,0,50,2
1683324718460,TDDE 131,D00,189316,Staff,14,0,15,1
1683324718460,TDDE 131,E00,204841,Staff,20,0,20,0
1683324719488,TDGE 10,A00,189289,Staff,30,0,50,20
1683324719488,TDGE 10,B00,189290,Havis; Allan,1,0,50,49
1683324720515,TDGE 11,A00,189291,Fulton; Julia,0,3,50,50
1683324720515,TDGE 11,B00,189292,Staff,20,0,25,5
1683324720515,TDGE 11,C00,260270,Staff,0,0,0,0
1683324721541,TDGE 25,A00,189294,Staff,3,0,20,17
1683324722567,TDGE 124,A00,189318,Fulton; Julia,0,8,50,50
1683324723593,TDGE 125,A00,189319,Staff,13,0,25,12
1683324723593,TDGE 125,B00,189320,Staff,23,0,25,2
1683324724617,TDGE 127,A00,189322,Havis; Allan,0,0,50,50
1683324725646,TDHT 101,A00,189323,Staff,18,0,25,7
1683324725646,TDHT 101,B00,189324,Staff,25,0,25,0
1683324726672,TDHT 102,A00,189325,Staff,49,0,50,1
1683324727696,TDMV 1,A00,189295,Arcidiacono; Kristin,19,0,30,11
1683324727696,TDMV 1,B00,189296,Caligagan; Maria T.,24,0,30,6
1683324728720,TDMV 2,A00,189297,Sammartano; Tonnie,28,0,30,2
1683324728720,TDMV 2,B00,189299,Arcidiacono; Kristin,24,0,30,6
1683324729748,TDMV 3,A00,204998,Rincon; Alicia,22,0,30,8
1683324730775,TDMV 120,A00,189458,Sammartano; Tonnie,28,0,30,2
1683324731800,TDMV 138,A00,189541,Jun; Grace Shin Hae,22,0,40,18
1683324732829,TDMV 142,A00,189717,Caligagan; Tony,23,0,30,7
1683324732829,TDMV 142,B00,189718,Caligagan; Maria T.,25,0,30,5
1683324733855,TMC 2,A01,187533,Staff,25,0,25,0
1683324733855,TMC 2,A02,187534,Staff,25,0,25,0
1683324734879,USP 1,A01,187536,Kwak; Nancy,0,16,25,25
1683324735904,USP 5,A01,187538,Staff,9,0,25,16
1683324736932,USP 101,A00,199253,Staff,0,4,0,0
1683324737956,USP 124,A00,187562,Boomhower; Matthew Charles,1,0,30,29
1683324738979,USP 138,A00,187582,Staff,20,0,25,5
1683324740004,USP 152,A01,187597,Staff,4,0,25,21
1683324741028,USP 153,A00,187598,Staff,19,0,25,6
1683324742054,USP 168,A00,187607,Kwak; Nancy,2,0,5,3
1683324743078,USP 173,A00,187619,Staff,4,0,25,21
1683324744102,USP 181,A00,187638,Staff,0,0,25,25
1683324745129,VIS 103,A00,187650,Cruz; Edwin Teddy,23,0,75,52
1683324746153,VIS 110D,A00,187669,Staff,12,0,22,10
1683324747178,VIS 127C,A00,187720,Shen; Kuiyi,68,0,146,78
1683324748201,VIS 149,A00,187731,Yoldas; Pinar,0,14,22,22
1683324749226,VIS 151,A01,188091,Staff,22,0,34,12
1683324749226,VIS 151,A02,188092,Staff,11,0,34,23
1683324750250,VIS 160B,A00,188093,Stalbaum; Brett,0,0,10,10
1683324752297,WCWP 10B,A00,201720,Staff,10,0,15,5
1683324752297,WCWP 10B,B00,201722,Staff,8,0,15,7
1683324753320,WCWP 100,A00,201725,Gagnon; Jeffrey C,0,0,2,2
1683324753320,WCWP 100,B00,201727,Staff,0,4,15,15
1683324756417,ANBI 133,A00,258401,Wilder; Linnea Lorene,34,0,40,6
1683324757443,ANBI 140,A00,258395,Hrvoj Mihic; Branka,18,0,25,7
1683324758471,ANSC 120,A00,258402,Bialecki; Jon Anthony,27,0,40,13
1683324759500,ANSC 144,A00,258400,Staff,14,0,40,26
1683324761550,ANSC 166,A00,258396,Parish; Steven Martin,157,0,175,18
1683324762577,ANSC 180,A00,193533,Staff,9,0,20,11
1683324763603,ANSC 188,A00,258397,Jassal; Aftab,33,0,40,7
1683324764628,ANTH 3,A01,258316,Staff,23,0,30,7
1683324765651,ANTH 5,A00,258394,Semendeferi; Ekaterini,16,0,20,4
1683324766679,ANTH 21,A01,258331,Staff,9,0,40,31
1683324767706,ANTH 103,A00,258398,Varma; Saiba,15,0,25,10
1683324768738,AWP 10,001,202034,Staff,0,0,0,0
1683324768738,AWP 10,002,202035,Staff,0,0,0,0
1683324768738,AWP 10,003,202036,Staff,0,0,0,0
1683324768738,AWP 10,004,202037,Staff,0,0,0,0
1683324768738,AWP 10,005,202038,Staff,0,0,0,0
1683324768738,AWP 10,006,202039,Staff,0,0,0,0
1683324768738,AWP 10,007,202040,Staff,0,0,0,0
1683324768738,AWP 10,008,202041,Staff,0,0,0,0
1683324768738,AWP 10,009,202042,Staff,0,0,0,0
1683324768738,AWP 10,010,202043,Staff,0,0,0,0
1683324768738,AWP 10,011,202044,Staff,0,0,0,0
1683324768738,AWP 10,012,202045,Staff,0,0,0,0
1683324768738,AWP 10,013,202046,Staff,0,0,0,0
1683324768738,AWP 10,014,202047,Staff,0,0,0,0
1683324768738,AWP 10,015,202048,Staff,0,0,0,0
1683324768738,AWP 10,016,202049,Staff,0,0,0,0
1683324768738,AWP 10,017,202050,Staff,0,0,0,0
1683324768738,AWP 10,018,202051,Staff,0,0,0,0
1683324768738,AWP 10,019,202052,Staff,0,0,0,0
1683324768738,AWP 10,020,202053,Staff,0,0,0,0
1683324768738,AWP 10,021,202054,Staff,0,0,0,0
1683324768738,AWP 10,022,202055,Staff,0,0,0,0
1683324768738,AWP 10,023,202056,Staff,0,0,0,0
1683324768738,AWP 10,024,202057,Staff,0,0,0,0
1683324768738,AWP 10,025,202058,Staff,0,0,0,0
1683324768738,AWP 10,026,202059,Staff,0,0,0,0
1683324769765,AWP 102,001,202032,Staff,0,0,0,0
1683324769765,AWP 102,002,202033,Staff,0,0,0,0
1683324770792,BENG 100,A01,254234,Taylor Amos; Alyssa C,31,0,40,9
1683324771817,BENG 196,001,270013,Engler; Adam J.,9999,0,9999,0
1683324772841,BICD 100R,A01,202018,Smith; Laurie,0,7,32,32
1683324772841,BICD 100R,A02,202019,Smith; Laurie,0,2,32,32
1683324772841,BICD 100R,A03,202020,Smith; Laurie,0,1,32,32
1683324772841,BICD 100R,A04,202021,Smith; Laurie,9,0,32,23
1683324772841,BICD 100R,A05,202022,Smith; Laurie,12,0,32,20
1683324773869,BICD 136,A01,193242,Gustafson-Brown; Cindy,0,2,32,32
1683324773869,BICD 136,A02,193244,Gustafson-Brown; Cindy,14,0,32,18
1683324774894,BIEB 102,A01,193249,Butler; Shannon Rhey,0,2,32,32
1683324774894,BIEB 102,A02,193251,Butler; Shannon Rhey,0,0,32,32
1683324774894,BIEB 102,A03,193253,Butler; Shannon Rhey,0,1,32,32
1683324774894,BIEB 102,A04,193255,Butler; Shannon Rhey,17,0,32,15
1683324774894,BIEB 102,A05,193265,Butler; Shannon Rhey,26,0,32,6
1683324774894,BIEB 102,A06,193269,Butler; Shannon Rhey,16,0,32,16
1683324776942,BIEB 150,A01,193274,Staff,0,0,32,32
1683324776942,BIEB 150,A02,193285,Staff,23,0,32,9
1683324777971,BIEB 194,A00,193286,Kurle; Carolyn M.,22,0,32,10
1683324778997,BILD 1,A01,192291,Staff,16,0,32,16
1683324778997,BILD 1,A02,192292,Staff,30,0,32,2
1683324778997,BILD 1,B01,192520,Reuther; Keefe,0,1,0,0
1683324778997,BILD 1,B02,192532,Reuther; Keefe,0,1,0,0
1683324780025,BILD 3,A01,192556,Butler; Shannon Rhey,0,0,32,32
1683324780025,BILD 3,A02,192581,Butler; Shannon Rhey,5,0,32,27
1683324780025,BILD 3,A03,192611,Butler; Shannon Rhey,23,0,32,9
1683324780025,BILD 3,A04,192612,Butler; Shannon Rhey,25,0,32,7
1683324780025,BILD 3,A05,192613,Butler; Shannon Rhey,27,0,32,5
1683324780025,BILD 3,A06,192679,Butler; Shannon Rhey,27,0,32,5
1683324780025,BILD 3,A07,192682,Butler; Shannon Rhey,22,0,32,10
1683324781050,BILD 4,A01,192836,Reuther; Keefe,0,0,24,24
1683324781050,BILD 4,A02,193044,Reuther; Keefe,4,0,24,20
1683324782073,BILD 10,A01,193142,Gustafson-Brown; Cindy,30,0,32,2
1683324782073,BILD 10,A02,193149,Gustafson-Brown; Cindy,31,0,32,1
1683324783097,BIMM 100,A01,193301,Staff,0,6,32,32
1683324783097,BIMM 100,A02,193312,Staff,0,5,32,32
1683324783097,BIMM 100,A03,193323,Staff,0,8,32,32
1683324784125,BIMM 101,A01,193329,McDonnell; Lisa Marie,0,3,24,24
1683324784125,BIMM 101,A02,193339,McDonnell; Lisa Marie,0,3,24,24
1683324784125,BIMM 101,B01,193354,McDonnell; Lisa Marie,0,3,24,24
1683324784125,BIMM 101,B02,193357,McDonnell; Lisa Marie,0,3,24,24
1683324785206,BIMM 110,A01,193377,Tat; John,0,11,32,32
1683324785206,BIMM 110,A02,193378,Tat; John,1,9,32,31
1683324786236,BIMM 120,A01,206116,Staff,0,0,32,32
1683324786236,BIMM 120,A02,206117,Staff,8,0,32,24
1683324786236,BIMM 120,A03,206121,Staff,21,0,32,11
1683324787263,BIPN 100,A01,193393,Park; Ji Young,0,14,32,32
1683324787263,BIPN 100,A02,193402,Park; Ji Young,0,12,32,32
1683324787263,BIPN 100,A03,193413,Park; Ji Young,0,14,32,32
1683324787263,BIPN 100,A04,193414,Park; Ji Young,0,13,32,32
1683324788290,BIPN 102,A01,193429,Staff,0,0,32,32
1683324788290,BIPN 102,A02,193438,Staff,22,0,32,10
1683324789314,BIPN 106,A01,193450,Reyes Gonzalez; Catalina,0,2,40,40
1683324790340,BIPN 134,A01,193465,Cooke; James Edward,0,0,32,32
1683324790340,BIPN 134,A02,193474,Cooke; James Edward,25,0,32,7
1683324790340,BIPN 134,A03,193485,Cooke; James Edward,29,0,32,3
1683324790340,BIPN 134,A04,193486,Cooke; James Edward,21,0,32,11
1683324790340,BIPN 134,A05,193491,Cooke; James Edward,31,0,32,1
1683324790340,BIPN 134,A06,193501,Cooke; James Edward,30,0,32,2
1683324790340,BIPN 134,A07,193510,Cooke; James Edward,29,0,32,3
1683324792388,BISP 194,A00,222522,Staff,14,0,32,18
1683324793414,CAT 124,A01,202407,Staff,20,0,25,5
1683324794437,CAT 125,A00,202408,Marchisotto; Jennifer Anne,4,0,20,16
1683324795466,CAT 125R,A00,202409,Smith; Lauryn Alissa,0,11,20,20
1683324795466,CAT 125R,B00,202410,Morales; Celeste Georgianna,0,11,20,20
1683324795466,CAT 125R,C00,202411,Irwin; Matthew Joseph,0,10,20,20
1683324796490,CENG 15,A01,204712,Yang; Kesong,0,1,0,0
1683324797518,CENG 114,A00,202070,Jahed Motlagh; Zeinab,5,0,20,15
1683324798542,CGS 105,A00,185477,Wesling; Megan E.,24,0,40,16
1683324799568,CGS 106,A00,185494,Staff,13,0,22,9
1683324800595,CGS 108,A00,185495,Staff,14,0,20,6
1683324801618,CGS 114,A00,185496,Staff,13,0,18,5
1683324802645,CGS 119,A00,185501,Staff,15,0,20,5
1683324803669,CGS 120,A00,185511,Staff,13,0,20,7
1683324804697,CHEM 4,A01,184675,Bussey; Thomas J,96,0,100,4
1683324805723,CHEM 6A,A01,184677,Staff,34,0,60,26
1683324806750,CHEM 6B,A01,184679,Staff,65,0,100,35
1683324807777,CHEM 6C,A01,184681,Bussey; Thomas J,1,0,50,49
1683324807777,CHEM 6C,A02,184682,Bussey; Thomas J,34,0,50,16
1683324808802,CHEM 40A,A01,184684,Albizati; Kim F.,37,0,100,63
1683324809828,CHEM 40B,A01,184686,Albizati; Kim F.,0,20,100,100
1683324810855,CHEM 41B,A01,184690,Staff,52,0,100,48
1683324811879,COGS 3,A01,184715,Boyle; Mary E. T.,0,25,40,40
1683324812903,COGS 14B,A01,185172,Staff,0,15,38,38
1683324813930,COGS 18,A01,184736,Staff,18,0,80,62
1683324814956,COGS 100,A01,184932,Staff,0,5,73,73
1683324815981,COGS 101A,A01,184935,Staff,0,38,30,30
1683324817004,COGS 101B,A01,184944,Staff,0,2,30,30
1683324818028,COGS 101C,A01,184946,Staff,0,12,30,30
1683324819052,COGS 102A,A01,184951,Johnson; Christine M.,2,0,40,38
1683324820079,COGS 107B,A01,184953,Mooshagian; Eric Frederick,0,50,40,40
1683324821103,COGS 118B,A01,184959,Gupta; Anjum,0,48,40,40
1683324822129,COGS 153,A00,184961,Staff,0,15,30,30
1683324823152,COGS 177,A00,184962,Staff,0,20,30,30
1683324824176,COGS 187A,A01,184969,Boyle; Mary E. T.,0,17,40,40
1683324825203,COMM 10,A01,185174,Staff,0,5,25,25
1683324825203,COMM 10,A02,185189,Staff,0,5,25,25
1683324825203,COMM 10,A03,269821,Staff,0,0,0,0
1683324826226,COMM 100B,A01,185475,Staff,0,0,0,2
1683324826226,COMM 100B,A02,185476,Staff,14,0,25,11
1683324827254,COMM 100C,A01,185314,Staff,1,0,25,24
1683324827254,COMM 100C,A02,185327,Staff,19,0,25,6
1683324828282,COMM 110M,A00,185349,Staff,2,0,40,38
1683324829305,COMM 113T,A00,185352,Staff,25,0,40,15
1683324830332,COMM 114I,A00,185353,Staff,33,0,40,7
1683324831359,COMM 131,A00,185354,Staff,19,0,30,11
1683324832383,CSE 8A,A50,185358,Cao; Yingjun,0,46,10,10
1683324833407,CSE 8B,A01,185362,Staff,1,47,50,49
1683324834431,CSE 11,A01,185416,Cao; Yingjun,0,92,10,10
1683324835455,CSE 20,A01,185445,Briones; Jor-el Thomas Caparas,5,0,25,20
1683324836478,CSE 21,A01,185447,Staff,10,0,50,40
1683324837502,CSE 101,A01,185451,Staff,0,12,50,50
1683324837502,CSE 101,B01,185453,Jones; Miles E,0,11,50,50
1683324839549,CSE 141,A01,185458,Eldon; John,20,0,100,80
1683324840572,CSE 141L,A01,185461,Eldon; John,12,0,100,88
1683324841601,CSE 142,A01,185463,Staff,36,0,60,24
1683324841601,CSE 142,B01,201355,Staff,0,7,60,60
1683324842627,CSE 142L,A01,185470,Staff,36,0,60,24
1683324842627,CSE 142L,B01,201417,Staff,0,6,60,60
1683324843651,CSE 190,A00,201433,Staff,32,0,49,17
1683324844675,DOC 1,A01,259136,Strom; Megan C.,7,0,15,8
1683324844675,DOC 1,A02,259137,Strom; Megan C.,14,0,15,1
1683324844675,DOC 1,A03,259138,Strom; Megan C.,14,0,15,1
1683324844675,DOC 1,A04,259139,Strom; Megan C.,14,0,15,1
1683324845699,DOC 100D,A00,259140,Pass; Natalye Joann,16,0,25,9
1683324846723,DSGN 1,A01,184749,Rill; Bryan,0,26,30,30
1683324847748,DSGN 100,A01,185168,Staff,0,2,25,25
1683324848777,ECE 5,A01,185626,Morris; Karcher William,0,10,0,0
1683324849801,ECE 101,A01,185628,Staff,17,0,70,53
1683324850835,ECE 107,A01,185635,Baghdadchi; Saharnaz,0,0,20,20
1683324850835,ECE 107,A02,185638,Baghdadchi; Saharnaz,4,0,20,16
1683324851859,ECE 148,A01,185647,Silberman; Jack,0,0,16,16
1683324852887,ECON 1,A01,185537,Crane; Meredith Helen,54,0,70,16
1683324853910,ECON 3,A01,185549,Crane; Meredith Helen,33,0,70,37
1683324854938,ECON 4,A01,203354,Anderson; John Charles,0,4,10,10
1683324855965,ECON 100A,A01,185574,Staff,0,4,40,40
1683324856991,ECON 100B,A01,185576,Staff,0,22,40,40
1683324858020,ECON 100C,A01,185589,Newhouse; Herbert S,30,0,70,40
1683324859045,ECON 105,A00,185608,Vespa; Emanuel Ignacio,19,0,35,16
1683324860069,ECON 109,A01,185610,Shishkin; Denis,10,0,35,25
1683324861093,ECON 110A,A01,185612,Staff,11,0,40,29
1683324862117,ECON 120A,A01,185615,Staff,20,0,40,20
1683324863144,ECON 120C,A01,185617,Sun; Yixiao,0,20,70,70
1683324864168,ECON 144,A00,203346,Squires; Dale E,3,0,35,32
1683324865193,ECON 171,A01,203349,Newhouse; Herbert S,0,1,35,35
1683324866217,ECON 173A,A01,185621,Toda; Alexis Akira,21,0,35,14
1683324867247,EDS 25,A01,202413,Staff,0,1,0,0
1683324867247,EDS 25,A02,202414,Staff,0,1,0,0
1683324867247,EDS 25,A03,202415,Staff,0,0,0,0
1683324867247,EDS 25,A04,202416,Staff,0,1,0,0
1683324867247,EDS 25,A05,202439,Staff,0,0,0,0
1683324867247,EDS 25,A06,202440,Staff,0,0,0,0
1683324867247,EDS 25,B01,202631,Staff,0,0,0,0
1683324867247,EDS 25,B02,202632,Staff,0,0,0,0
1683324867247,EDS 25,B03,202639,Staff,0,0,0,0
1683324867247,EDS 25,B04,202640,Staff,0,0,0,0
1683324867247,EDS 25,B05,202643,Staff,0,0,0,0
1683324867247,EDS 25,B06,202644,Staff,0,0,0,0
1683324868269,EDS 38,A01,202659,Black; Alison Michelle,24,0,25,1
1683324869295,EDS 115,A00,202652,Staff,17,0,30,13
1683324870321,EDS 125,A00,202649,Staff,14,0,30,16
1683324871346,EDS 126,A01,203332,Staff,30,0,30,0
1683324872372,EDS 139,A00,202838,Staff,16,0,25,9
1683324873402,EDS 146,A01,202655,Staff,14,0,25,11
1683324874429,ENG 15,A00,185667,Staff,0,1,0,0
1683324874429,ENG 15,B00,185672,Staff,0,0,0,0
1683324874429,ENG 15,C00,185675,Staff,0,0,0,0
1683324874429,ENG 15,D00,185682,Staff,0,0,0,0
1683324874429,ENG 15,E00,185684,Staff,0,0,0,0
1683324875452,ETHN 103,A00,185710,Staff,0,3,35,35
1683324876476,ETHN 103A,A00,199228,Man; Simeon S,2,0,9,7
1683324877500,ETHN 109,A00,185711,Staff,18,0,35,17
1683324878524,ETHN 142,A00,185726,Staff,0,4,30,30
1683324879548,ETHN 163J,A00,199229,Man; Simeon S,5,0,8,3
1683324880576,ETHN 168,A00,185727,Staff,8,0,10,2
1683324881605,ETHN 182,A00,185728,Staff,1,0,35,34
1683324882629,ETHN 183,A00,185737,Staff,8,0,18,10
1683324883651,GLBH 111,A01,209361,Burgos; Jose L.,0,0,0,0
1683324885702,HIEU 104,A00,185792,Staff,16,0,20,4
1683324886725,HIEU 115,A00,185800,Staff,1,0,20,19
1683324887746,HIEU 128,A00,185801,Staff,0,7,20,20
1683324888826,HIEU 147,A00,185802,Staff,16,0,20,4
1683324889852,HIEU 154,A00,185823,Staff,12,0,20,8
1683324890876,HILA 102,A00,185826,Staff,13,0,20,7
1683324891900,HILD 2C,A01,185778,Staff,0,12,20,20
1683324892924,HILD 7B,A01,185780,Kwak; Nancy,0,15,32,32
1683324892924,HILD 7B,A02,185781,Kwak; Nancy,0,18,32,32
1683324893948,HILD 30,A01,185791,Staff,14,0,20,6
1683324894971,HISC 119,A00,185830,Golan; Tal,0,9,20,20
1683324895997,HITO 156GS,A00,185831,Patterson; Patrick H.,0,0,0,23
1683324897021,HIUS 103,A00,185832,Man; Simeon S,0,6,20,20
1683324898046,HIUS 117,A00,185836,Kwak; Nancy,2,0,20,18
1683324899074,HIUS 125,A00,185840,Man; Simeon S,0,0,23,23
1683324900098,HIUS 149,A00,185845,Staff,0,0,20,20
1683324901128,HUM 3,A01,185882,Zavodny; Tatiana Sophia,0,7,50,50
1683324901128,HUM 3,B01,185899,Caldwell; Michael Alan,0,18,50,50
1683324902155,HUM 3GS,A00,185900,Patterson; Patrick H.,0,0,0,23
1683324903182,HUM 4,A01,185938,Zroka; Amy Liane,31,0,50,19
1683324903182,HUM 4,B01,185956,Watkins; Eric,0,2,50,50
1683324903182,HUM 4,B02,202209,Watkins; Eric,0,2,50,50
1683324903182,HUM 4,B03,202210,Watkins; Eric,0,2,50,50
1683324904211,HUM 5,A01,185958,West; Geoffrey Scott,3,0,50,47
1683324904211,HUM 5,A02,202215,West; Geoffrey Scott,0,0,50,50
1683324905237,INTL 190,A00,185959,Gagnon; Jeffrey C,0,0,0,9
1683324905237,INTL 190,B00,185960,Lettieri; Michael Joseph,0,0,0,1
1683324906262,JAPN 180,A00,254509,Staff,5,1,30,25
1683324907288,LATI 10,A01,202853,Kennemore; Amy Michelle,4,0,35,31
1683324907288,LATI 10,A02,202854,Kennemore; Amy Michelle,2,0,35,33
1683324907288,LATI 10,A03,270054,Kennemore; Amy Michelle,30,0,30,0
1683324908311,LATI 180,A00,202855,Kennemore; Amy Michelle,11,0,20,9
1683324909337,LAWS 101,A00,201767,Golan; Tal,0,7,40,40
1683324910366,LIFR 1C,A00,185961,Staff,6,0,20,14
1683324911391,LIFR 1CX,A00,185962,Staff,7,0,20,13
1683324912414,LIFR 1D,A00,185963,Staff,9,0,20,11
1683324913442,LIFR 1DX,A00,185964,Staff,9,0,20,11
1683324914468,LIGN 101,A01,186039,Staff,43,0,50,7
1683324915492,LIGN 165,A00,186040,Staff,18,0,50,32
1683324916515,LTCS 108,A00,186041,Staff,6,0,10,4
1683324917541,LTCS 119,A00,186042,Staff,16,0,20,4
1683324918569,LTCS 130,A00,186043,Wesling; Megan E.,15,0,25,10
1683324920619,LTEA 138,A00,186119,Staff,14,0,40,26
1683324921645,LTEN 124,A00,186148,Staff,6,0,25,19
1683324922669,LTEN 178,A00,186149,Staff,7,0,15,8
1683324923695,LTEN 181,A00,186150,Blanco; John D,33,0,40,7
1683324924721,LTWL 120,A00,186160,Staff,20,0,25,5
1683324925745,LTWL 165,A00,186161,Staff,22,0,25,3
1683324926773,LTWR 100,A00,186162,Staff,0,5,15,15
1683324927799,LTWR 102,A00,186163,Doller; Ben,5,0,15,10
1683324928826,MAE 8,A01,186412,Staff,0,0,0,0
1683324929849,MAE 30B,A00,186445,Bahadori; Mohammad Yousef,83,0,100,17
1683324930873,MAE 40,A00,186592,Bewley; Thomas R,9,0,50,41
1683324931897,MAE 101B,A00,186593,Bahadori; Mohammad Yousef,81,0,100,19
1683324932921,MAE 105,A00,186594,Bandaru; Prabhakar,12,0,50,38
1683324933945,MAE 107,A00,186599,Pham; Hieu Tan,0,6,120,120
1683324934969,MAE 148,A01,186660,Silberman; Jack,3,0,16,13
1683324935993,MATH 10A,A01,188095,Staff,1,6,35,34
1683324937021,MATH 10B,A01,188097,Bowers; Adam R.,0,11,30,30
1683324937021,MATH 10B,A02,188099,Bowers; Adam R.,0,11,30,30
1683324937021,MATH 10B,B01,188104,Bowers; Adam R.,0,10,30,30
1683324937021,MATH 10B,B02,188106,Bowers; Adam R.,0,10,30,30
1683324938049,MATH 10C,A01,188111,Staff,0,18,30,30
1683324938049,MATH 10C,A02,188127,Staff,0,17,30,30
1683324938049,MATH 10C,A03,188131,Staff,0,18,30,30
1683324938049,MATH 10C,B01,188218,Staff,18,0,30,12
1683324938049,MATH 10C,B02,188244,Staff,13,0,30,17
1683324938049,MATH 10C,B03,188277,Staff,16,0,30,14
1683324939077,MATH 18,A01,188344,Bach; Quang Tran,18,0,30,12
1683324939077,MATH 18,A02,188345,Bach; Quang Tran,11,0,30,19
1683324939077,MATH 18,B01,188353,Bach; Quang Tran,10,0,30,20
1683324939077,MATH 18,B02,188354,Bach; Quang Tran,20,0,30,10
1683324940103,MATH 20A,A01,188374,Staff,13,0,35,22
1683324941126,MATH 20B,A01,188382,Ohm; Ko Woon,6,0,30,24
1683324941126,MATH 20B,A02,188383,Ohm; Ko Woon,22,0,30,8
1683324941126,MATH 20B,B01,188385,Ohm; Ko Woon,7,0,30,23
1683324941126,MATH 20B,B02,188392,Ohm; Ko Woon,22,0,30,8
1683324942154,MATH 20C,A01,188394,Harel; Guershon,10,0,30,20
1683324942154,MATH 20C,A02,188395,Harel; Guershon,14,0,30,16
1683324942154,MATH 20C,B01,188404,Harel; Guershon,5,0,30,25
1683324942154,MATH 20C,B02,188405,Harel; Guershon,19,0,30,11
1683324943177,MATH 20D,A01,188414,Hammock; Frances H,0,1,30,30
1683324943177,MATH 20D,A02,188415,Hammock; Frances H,3,0,30,27
1683324943177,MATH 20D,B01,188447,Hammock; Frances H,2,0,30,28
1683324943177,MATH 20D,B02,188486,Hammock; Frances H,8,0,30,22
1683324944207,MATH 20E,A01,188649,Staff,21,0,30,9
1683324944207,MATH 20E,A02,188650,Staff,23,0,30,7
1683324944207,MATH 20E,A03,188673,Staff,0,0,30,30
1683324945231,MATH 102,A01,188675,Staff,0,35,35,35
1683324946259,MATH 103B,A01,188681,Staff,4,0,35,31
1683324946259,MATH 103B,B01,188692,Staff,5,0,35,30
1683324947286,MATH 109,A01,188695,Salehi Golsefidy; Alireza,25,0,35,10
1683324947286,MATH 109,A02,188696,Salehi Golsefidy; Alireza,26,0,35,9
1683324948311,MATH 120A,A01,188698,Eggers; John Dietrich,7,0,35,28
1683324949336,MATH 142B,A01,188736,Ioana; Adrian,0,2,30,30
1683324949336,MATH 142B,A02,188741,Ioana; Adrian,0,1,30,30
1683324949336,MATH 142B,A03,188743,Ioana; Adrian,1,3,30,29
1683324950360,MATH 168A,A01,188790,Staff,0,9,35,35
1683324951383,MATH 170A,A01,188803,Nie; Jiawang,0,2,35,35
1683324951383,MATH 170A,A02,188811,Nie; Jiawang,0,0,35,35
1683324951383,MATH 170A,A03,188814,Nie; Jiawang,1,0,35,34
1683324951383,MATH 170A,A04,188815,Nie; Jiawang,13,0,35,22
1683324952409,MATH 193B,A01,188817,Staff,0,0,35,35
1683324952409,MATH 193B,A02,188818,Staff,5,0,35,30
1683324953435,MGT 4,A01,202857,Anderson; John Charles,62,0,80,18
1683324954463,MGT 12,A00,202858,Lindenberger; Wade Douglas,42,0,90,48
1683324955487,MGT 18,A00,202859,Staff,74,0,90,16
1683324956511,MGT 18GS,A00,202860,McKay; Michael J,13,0,28,15
1683324957593,MGT 45,A00,202861,Pecore; Joseph P.,13,0,90,77
1683324958618,MGT 100,A00,202863,Yavorsky; Daniel Ryan,28,0,90,62
1683324959642,MGT 103,A00,202864,Ehrich; Kristine R,0,18,90,90
1683324960670,MGT 112,A00,202865,Ehrich; Kristine R,15,0,90,75
1683324961695,MGT 121A,A00,202868,Staff,0,20,0,0
1683324962721,MGT 131B,A00,202869,Anderson; John Charles,59,0,90,31
1683324963745,MGT 136,A00,202871,Lindenberger; Wade Douglas,84,0,90,6
1683324964773,MGT 164,A00,202873,Staff,0,68,90,91
1683324965799,MGT 164GS,A00,202874,McKay; Mary A,13,0,28,15
1683324966822,MGT 180,A00,202875,Staff,0,50,90,91
1683324967847,MMW 11R,A01,205019,Herbst; Matthew,3,0,30,27
1683324967847,MMW 11R,A02,205026,Herbst; Matthew,29,0,30,1
1683324968879,MMW 15,A01,193512,Chang; Edmond Yi-Teh,0,9,28,28
1683324968879,MMW 15,A02,193513,Chang; Edmond Yi-Teh,0,5,28,28
1683324968879,MMW 15,A03,193514,Chang; Edmond Yi-Teh,0,5,28,28
1683324968879,MMW 15,A04,193515,Chang; Edmond Yi-Teh,0,5,28,28
1683324968879,MMW 15,A05,193516,Chang; Edmond Yi-Teh,0,4,28,28
1683324968879,MMW 15,A06,193517,Chang; Edmond Yi-Teh,0,5,28,28
1683324968879,MMW 15,B01,193519,Chang; Edmond Yi-Teh,0,5,28,28
1683324968879,MMW 15,B02,193520,Chang; Edmond Yi-Teh,0,5,28,28
1683324968879,MMW 15,B03,193521,Chang; Edmond Yi-Teh,0,4,28,28
1683324968879,MMW 15,B04,193522,Chang; Edmond Yi-Teh,0,4,28,28
1683324968879,MMW 15,B05,193523,Chang; Edmond Yi-Teh,0,5,28,28
1683324968879,MMW 15,B06,193524,Chang; Edmond Yi-Teh,0,4,28,28
1683324969904,MMW 122,A01,193526,Rahimi; Babak,0,15,28,28
1683324969904,MMW 122,A02,193527,Rahimi; Babak,0,14,28,28
1683324969904,MMW 122,A03,193528,Rahimi; Babak,0,0,0,0
1683324969904,MMW 122,A04,193529,Rahimi; Babak,0,0,0,0
1683324970931,MUS 1A,A01,186663,Staff,0,20,35,35
1683324971957,MUS 4,A01,186715,Staff,0,12,35,35
1683324972984,MUS 5R,A01,186796,Dubnov; Shlomo,0,17,35,35
1683324974013,MUS 6,A01,186798,Staff,0,4,25,25
1683324975039,MUS 7,A01,186830,Staff,12,0,35,23
1683324976062,MUS 8,A01,186930,Staff,0,27,35,35
1683324977087,MUS 15,A01,186932,Staff,0,16,35,35
1683324977087,MUS 15,B01,186934,Staff,0,15,35,35
1683324978111,MUS 80,A00,186935,Staff,1,0,20,19
1683324978111,MUS 80,B00,186936,Staff,25,0,25,0
1683324979135,NANO 11,A00,204702,Lipomi; Darren John,0,0,0,0
1683324980160,NANO 15,A01,204709,Yang; Kesong,0,1,0,0
1683324981187,NANO 114,A00,202069,Jahed Motlagh; Zeinab,3,0,10,7
1683324982213,PHIL 1,A00,186955,Grush; Rick Scott,32,0,40,8
1683324983238,PHIL 10,A01,186973,Grush; Rick Scott,28,0,35,7
1683324983238,PHIL 10,A02,186974,Grush; Rick Scott,33,0,35,2
1683324984265,PHIL 13,A01,186976,Staff,7,0,35,28
1683324984265,PHIL 13,A02,186977,Staff,16,0,35,19
1683324985289,PHIL 14,A01,186979,Staff,31,0,35,4
1683324985289,PHIL 14,A02,186986,Staff,32,0,35,3
1683324986319,PHIL 28,A01,186988,Staff,16,0,30,14
1683324986319,PHIL 28,A02,186989,Staff,1,0,30,29
1683324986319,PHIL 28,A03,186990,Staff,9,0,30,21
1683324986319,PHIL 28,A04,186991,Staff,26,0,30,4
1683324987344,PHIL 120,A00,186997,Staff,23,0,40,17
1683324988372,PHIL 137,A00,187003,Staff,9,0,40,31
1683324989395,PHIL 150,A00,187015,Staff,47,0,70,23
1683324990423,PHIL 167,A00,187021,Lamey; Andy M.,35,0,40,5
1683324991449,PHIL 174,A01,202226,Staff,17,0,20,3
1683324991449,PHIL 174,A02,202235,Staff,20,0,20,0
1683324992549,PHIL 191A,A00,258918,Staff,0,0,1,1
1683324993576,PHYS 1A,A00,187028,Staff,27,0,60,33
1683324994604,PHYS 1AL,001,187036,Staff,3,0,30,27
1683324994604,PHYS 1AL,002,187049,Staff,18,0,30,12
1683324995630,PHYS 1B,A00,187058,Staff,22,0,60,38
1683324996654,PHYS 1BL,001,187064,Staff,0,0,30,30
1683324996654,PHYS 1BL,002,187070,Staff,5,0,30,25
1683324997677,PHYS 1C,A00,187082,Staff,31,0,120,89
1683324998701,PHYS 1CL,001,187088,Staff,0,9,30,30
1683324998701,PHYS 1CL,002,187089,Staff,0,2,30,30
1683324998701,PHYS 1CL,009,262693,Staff,11,0,30,19
1683324999728,PHYS 2B,A01,187097,Staff,54,0,115,61
1683325000755,PHYS 2C,A01,187099,Staff,67,0,115,48
1683325001782,PHYS 2CL,A01,187101,Staff,5,0,28,23
1683325001782,PHYS 2CL,A02,187102,Staff,15,0,28,13
1683325002805,PHYS 2D,A01,187123,Shotwell; Brian,95,0,115,20
1683325003829,PHYS 4B,A01,187133,Grinstein; Benjamin,35,0,50,15
1683325004852,POLI 10,A00,188819,Staff,0,4,50,50
1683325005876,POLI 11,A00,188827,Staff,43,0,50,7
1683325006898,POLI 13R,A00,188828,Staff,0,1,20,20
1683325007925,POLI 27,A01,188830,Elgin; Samuel Zincke,0,1,70,70
1683325008949,POLI 30,A00,188832,Desposato; Scott,31,0,50,19
1683325009977,POLI 102F,A00,188834,Staff,3,0,40,37
1683325011002,POLI 104A,A00,188852,Staff,14,0,30,16
1683325012025,POLI 104I,A00,188853,Staff,0,6,20,20
1683325013052,POLI 110B,A00,188854,Wiens; David,7,0,20,13
1683325014079,POLI 112A,A00,188855,Wiens; David,5,0,30,25
1683325015106,POLI 117R,A00,188856,Forman; Fonna,0,11,20,20
1683325016130,POLI 118,A00,188857,Ingham; Sean,8,0,20,12
1683325017154,POLI 120G,A00,188858,Staff,9,0,30,21
1683325018180,POLI 131CR,A00,188863,Hoston; Germaine,24,0,50,26
1683325019207,POLI 133,A00,188864,Nellis; Gareth Hb,44,0,50,6
1683325020231,POLI 134D,A00,188865,Desposato; Scott,27,0,30,3
1683325021261,POLI 142A,A00,188871,Gartzke; Erik,22,0,50,28
1683325022288,POLI 142K,A00,188874,Staff,38,0,50,12
1683325023313,POLI 143,A00,188940,Gartzke; Erik,16,0,30,14
1683325024341,POLI 153,A00,188943,Staff,3,0,20,17
1683325025366,POLI 160AA,A00,188944,Staff,12,0,40,28
1683325026389,POLI 170A,A00,188945,Staff,11,0,30,19
1683325028437,PSYC 1,A00,188952,Staff,37,0,90,53
1683325029461,PSYC 2,B00,188953,Staff,19,0,35,16
1683325030485,PSYC 6,A00,188970,Staff,47,0,60,13
1683325031512,PSYC 7,A00,188973,Staff,37,0,45,8
1683325032536,PSYC 60,A01,188980,Rickard; Timothy C.,43,0,60,17
1683325033563,PSYC 70,A01,189001,Steiner; Eric Tomas,24,0,45,21
1683325034588,PSYC 100,A00,189005,Lacefield; Katharine I,0,100,120,120
1683325035611,PSYC 102,A00,189008,Staff,9,0,30,21
1683325036638,PSYC 106,B00,189026,Gorman; Michael R.,34,0,60,26
1683325037663,PSYC 114,B01,189033,Winkielman; Piotr,0,32,30,30
1683325038691,PSYC 131,A00,189036,Anagnostaras; Stephan,0,43,60,60
1683325039715,PSYC 136,A00,189041,Lowe; Angela Beth,0,7,25,25
1683325040741,PSYC 137,A00,189057,Winkielman; Piotr,0,34,25,25
1683325041765,PSYC 144,A00,189107,Wixted; John T,0,7,50,50
1683325043818,PSYC 162,A00,189142,Staff,0,8,85,85
1683325044840,PSYC 172,A00,189144,Gorman; Michael R.,0,7,30,30
1683325046891,PSYC 179,A00,189146,Lacefield; Katharine I,0,84,120,120
1683325047915,PSYC 181,A00,189147,Anagnostaras; Stephan,0,44,90,90
1683325048939,PSYC 190R,A00,189148,Barner; David A.,0,22,80,80
1683325049967,PSYC 191,A00,189275,Rickard; Timothy C.,0,7,25,25
1683325050991,PSYC 193,A00,189276,Chapman; Eddie Nathaniel,0,1,0,4
1683325052016,PSYC 193L,A01,189281,Lowe; Angela Beth,12,0,20,8
1683325052016,PSYC 193L,B01,189285,Staff,28,0,35,7
1683325053040,RELI 149,A00,187137,Rahimi; Babak,7,0,40,33
1683325054068,SE 9,A01,187315,Staff,0,2,18,18
1683325055094,SE 101B,A00,187409,Staff,24,0,30,6
1683325056118,SE 110B,A00,187444,Staff,10,0,40,30
1683325057141,SE 130B,A00,187449,Staff,31,0,40,9
1683325058165,SE 150A,A00,187516,Staff,9,0,20,11
1683325059189,SE 154,A00,187528,Staff,30,0,50,20
1683325060213,SIO 3,A01,258171,Staff,35,0,40,5
1683325061238,SIO 10,A00,187144,Cook; Geoffrey W,0,3,75,75
1683325062264,SIO 45,A00,187152,Cook; Geoffrey W,1,0,100,99
1683325063288,SIO 109R,A00,194486,Staff,0,3,20,20
1683325065336,SIO 187,A01,187233,Kacev; David,12,0,40,28
1683325066364,SOCI 1,A01,258656,Thorpe; Charles Robert,28,0,30,2
1683325066364,SOCI 1,A02,258658,Thorpe; Charles Robert,30,0,30,0
1683325066364,SOCI 1,A03,258661,Thorpe; Charles Robert,25,0,25,0
1683325066364,SOCI 1,A04,258666,Thorpe; Charles Robert,22,0,25,3
1683325066364,SOCI 1,A05,258897,Thorpe; Charles Robert,23,0,25,2
1683325066364,SOCI 1,A06,258898,Thorpe; Charles Robert,25,0,25,0
1683325067394,SOCI 30,A01,258903,Pardo Guerra; Juan Pablo,16,0,30,14
1683325068417,SOCI 102,A00,258904,Staff,9,0,25,16
1683325069443,SOCI 106,A00,258905,Staff,19,0,25,6
1683325070470,SOCI 111,A00,258907,Ribas Norris; Janet Vanesa,26,0,30,4
1683325071495,SOCI 121R,A00,258908,Pardo Guerra; Juan Pablo,10,0,30,20
1683325072519,SOCI 126,A01,203330,Staff,14,0,20,6
1683325073543,SOCI 131,A00,258909,Thorpe; Charles Robert,31,0,60,29
1683325074567,SOCI 135,A00,258910,Payne; Christine Anna,0,9,30,30
1683325075591,SOCI 157,A00,258911,Staff,12,0,30,18
1683325076614,SOCI 184,A00,258912,Staff,25,0,30,5
1683325077641,SOCI 188D,A00,258913,Staff,21,0,30,9
1683325078665,SYN 2,001,187529,Staff,9,0,16,7
1683325078665,SYN 2,002,201452,Staff,0,18,16,16
1683325078665,SYN 2,003,201469,Staff,4,0,16,12
1683325079693,SYN 100,A01,187531,Staff,0,9,20,20
1683325079693,SYN 100,B01,201491,Staff,0,12,20,20
1683325080717,TDAC 1,A00,189286,Walsh; Kim C.,3,0,20,17
1683325080717,TDAC 1,B00,189287,Harting; Carla Kelso,11,0,20,9
1683325081745,TDAC 101,A00,189300,Walsh; Kim C.,16,0,20,4
1683325081745,TDAC 101,B00,189301,Harting; Carla Kelso,18,0,20,2
1683325082769,TDAC 102,A00,189304,Basso; Beatrice,14,0,20,6
1683325083794,TDAC 108,A00,189305,Staff,18,0,20,2
1683325084819,TDDE 131,A00,189310,Staff,19,0,20,1
1683325084819,TDDE 131,B00,189314,Staff,19,0,20,1
1683325084819,TDDE 131,C00,189315,Staff,48,0,50,2
1683325084819,TDDE 131,D00,189316,Staff,14,0,15,1
1683325084819,TDDE 131,E00,204841,Staff,20,0,20,0
1683325085844,TDGE 10,A00,189289,Staff,30,0,50,20
1683325085844,TDGE 10,B00,189290,Havis; Allan,1,0,50,49
1683325086872,TDGE 11,A00,189291,Fulton; Julia,0,3,50,50
1683325086872,TDGE 11,B00,189292,Staff,20,0,25,5
1683325086872,TDGE 11,C00,260270,Staff,0,0,0,0
1683325087896,TDGE 25,A00,189294,Staff,3,0,20,17
1683325088921,TDGE 124,A00,189318,Fulton; Julia,0,8,50,50
1683325089948,TDGE 125,A00,189319,Staff,13,0,25,12
1683325089948,TDGE 125,B00,189320,Staff,23,0,25,2
1683325090975,TDGE 127,A00,189322,Havis; Allan,0,0,50,50
1683325092005,TDHT 101,A00,189323,Staff,18,0,25,7
1683325092005,TDHT 101,B00,189324,Staff,25,0,25,0
1683325093028,TDHT 102,A00,189325,Staff,49,0,50,1
1683325094052,TDMV 1,A00,189295,Arcidiacono; Kristin,19,0,30,11
1683325094052,TDMV 1,B00,189296,Caligagan; Maria T.,24,0,30,6
1683325095076,TDMV 2,A00,189297,Sammartano; Tonnie,28,0,30,2
1683325095076,TDMV 2,B00,189299,Arcidiacono; Kristin,24,0,30,6
1683325096156,TDMV 3,A00,204998,Rincon; Alicia,22,0,30,8
1683325097184,TDMV 120,A00,189458,Sammartano; Tonnie,28,0,30,2
1683325098211,TDMV 138,A00,189541,Jun; Grace Shin Hae,22,0,40,18
1683325099232,TDMV 142,A00,189717,Caligagan; Tony,23,0,30,7
1683325099232,TDMV 142,B00,189718,Caligagan; Maria T.,25,0,30,5
1683325100260,TMC 2,A01,187533,Staff,25,0,25,0
1683325100260,TMC 2,A02,187534,Staff,25,0,25,0
1683325101288,USP 1,A01,187536,Kwak; Nancy,0,16,25,25
1683325102317,USP 5,A01,187538,Staff,9,0,25,16
1683325103345,USP 101,A00,199253,Staff,0,4,0,0
1683325104371,USP 124,A00,187562,Boomhower; Matthew Charles,1,0,30,29
1683325105395,USP 138,A00,187582,Staff,20,0,25,5
1683325106422,USP 152,A01,187597,Staff,4,0,25,21
1683325107450,USP 153,A00,187598,Staff,19,0,25,6
1683325108474,USP 168,A00,187607,Kwak; Nancy,2,0,5,3
1683325109501,USP 173,A00,187619,Staff,4,0,25,21
1683325110525,USP 181,A00,187638,Staff,0,0,25,25
1683325111552,VIS 103,A00,187650,Cruz; Edwin Teddy,23,0,75,52
1683325112577,VIS 110D,A00,187669,Staff,12,0,22,10
1683325113602,VIS 127C,A00,187720,Shen; Kuiyi,67,0,146,79
1683325114626,VIS 149,A00,187731,Yoldas; Pinar,0,14,22,22
1683325115653,VIS 151,A01,188091,Staff,22,0,34,12
1683325115653,VIS 151,A02,188092,Staff,11,0,34,23
1683325116679,VIS 160B,A00,188093,Stalbaum; Brett,0,0,10,10
1683325118727,WCWP 10B,A00,201720,Staff,10,0,15,5
1683325118727,WCWP 10B,B00,201722,Staff,8,0,15,7
1683325119754,WCWP 100,A00,201725,Gagnon; Jeffrey C,0,0,2,2
1683325119754,WCWP 100,B00,201727,Staff,0,4,15,15
1683325122879,ANBI 133,A00,258401,Wilder; Linnea Lorene,34,0,40,6
1683325123903,ANBI 140,A00,258395,Hrvoj Mihic; Branka,18,0,25,7
1683325124930,ANSC 120,A00,258402,Bialecki; Jon Anthony,27,0,40,13
1683325125958,ANSC 144,A00,258400,Staff,14,0,40,26
1683325128006,ANSC 166,A00,258396,Parish; Steven Martin,157,0,175,18
1683325129029,ANSC 180,A00,193533,Staff,9,0,20,11
1683325130062,ANSC 188,A00,258397,Jassal; Aftab,33,0,40,7
1683325131085,ANTH 3,A01,258316,Staff,23,0,30,7
1683325132109,ANTH 5,A00,258394,Semendeferi; Ekaterini,16,0,20,4
1683325133133,ANTH 21,A01,258331,Staff,8,0,40,32
1683325134161,ANTH 103,A00,258398,Varma; Saiba,15,0,25,10
1683325135184,AWP 10,001,202034,Staff,0,0,0,0
1683325135184,AWP 10,002,202035,Staff,0,0,0,0
1683325135184,AWP 10,003,202036,Staff,0,0,0,0
1683325135184,AWP 10,004,202037,Staff,0,0,0,0
1683325135184,AWP 10,005,202038,Staff,0,0,0,0
1683325135184,AWP 10,006,202039,Staff,0,0,0,0
1683325135184,AWP 10,007,202040,Staff,0,0,0,0
1683325135184,AWP 10,008,202041,Staff,0,0,0,0
1683325135184,AWP 10,009,202042,Staff,0,0,0,0
1683325135184,AWP 10,010,202043,Staff,0,0,0,0
1683325135184,AWP 10,011,202044,Staff,0,0,0,0
1683325135184,AWP 10,012,202045,Staff,0,0,0,0
1683325135184,AWP 10,013,202046,Staff,0,0,0,0
1683325135184,AWP 10,014,202047,Staff,0,0,0,0
1683325135184,AWP 10,015,202048,Staff,0,0,0,0
1683325135184,AWP 10,016,202049,Staff,0,0,0,0
1683325135184,AWP 10,017,202050,Staff,0,0,0,0
1683325135184,AWP 10,018,202051,Staff,0,0,0,0
1683325135184,AWP 10,019,202052,Staff,0,0,0,0
1683325135184,AWP 10,020,202053,Staff,0,0,0,0
1683325135184,AWP 10,021,202054,Staff,0,0,0,0
1683325135184,AWP 10,022,202055,Staff,0,0,0,0
1683325135184,AWP 10,023,202056,Staff,0,0,0,0
1683325135184,AWP 10,024,202057,Staff,0,0,0,0
1683325135184,AWP 10,025,202058,Staff,0,0,0,0
1683325135184,AWP 10,026,202059,Staff,0,0,0,0
1683325136210,AWP 102,001,202032,Staff,0,0,0,0
1683325136210,AWP 102,002,202033,Staff,0,0,0,0
1683325137234,BENG 100,A01,254234,Taylor Amos; Alyssa C,31,0,40,9
1683325138255,BENG 196,001,270013,Engler; Adam J.,9999,0,9999,0
1683325139283,BICD 100R,A01,202018,Smith; Laurie,0,7,32,32
1683325139283,BICD 100R,A02,202019,Smith; Laurie,0,2,32,32
1683325139283,BICD 100R,A03,202020,Smith; Laurie,0,1,32,32
1683325139283,BICD 100R,A04,202021,Smith; Laurie,9,0,32,23
1683325139283,BICD 100R,A05,202022,Smith; Laurie,12,0,32,20
1683325140308,BICD 136,A01,193242,Gustafson-Brown; Cindy,0,2,32,32
1683325140308,BICD 136,A02,193244,Gustafson-Brown; Cindy,14,0,32,18
1683325141339,BIEB 102,A01,193249,Butler; Shannon Rhey,0,2,32,32
1683325141339,BIEB 102,A02,193251,Butler; Shannon Rhey,0,0,32,32
1683325141339,BIEB 102,A03,193253,Butler; Shannon Rhey,0,1,32,32
1683325141339,BIEB 102,A04,193255,Butler; Shannon Rhey,17,0,32,15
1683325141339,BIEB 102,A05,193265,Butler; Shannon Rhey,26,0,32,6
1683325141339,BIEB 102,A06,193269,Butler; Shannon Rhey,16,0,32,16
1683325143387,BIEB 150,A01,193274,Staff,0,0,32,32
1683325143387,BIEB 150,A02,193285,Staff,23,0,32,9
1683325144416,BIEB 194,A00,193286,Kurle; Carolyn M.,22,0,32,10
1683325145445,BILD 1,A01,192291,Staff,16,0,32,16
1683325145445,BILD 1,A02,192292,Staff,30,0,32,2
1683325145445,BILD 1,B01,192520,Reuther; Keefe,0,1,0,0
1683325145445,BILD 1,B02,192532,Reuther; Keefe,0,1,0,0
1683325146469,BILD 3,A01,192556,Butler; Shannon Rhey,0,0,32,32
1683325146469,BILD 3,A02,192581,Butler; Shannon Rhey,5,0,32,27
1683325146469,BILD 3,A03,192611,Butler; Shannon Rhey,23,0,32,9
1683325146469,BILD 3,A04,192612,Butler; Shannon Rhey,25,0,32,7
1683325146469,BILD 3,A05,192613,Butler; Shannon Rhey,27,0,32,5
1683325146469,BILD 3,A06,192679,Butler; Shannon Rhey,27,0,32,5
1683325146469,BILD 3,A07,192682,Butler; Shannon Rhey,22,0,32,10
1683325147494,BILD 4,A01,192836,Reuther; Keefe,0,0,24,24
1683325147494,BILD 4,A02,193044,Reuther; Keefe,4,0,24,20
1683325148519,BILD 10,A01,193142,Gustafson-Brown; Cindy,30,0,32,2
1683325148519,BILD 10,A02,193149,Gustafson-Brown; Cindy,31,0,32,1
1683325149543,BIMM 100,A01,193301,Staff,0,6,32,32
1683325149543,BIMM 100,A02,193312,Staff,0,5,32,32
1683325149543,BIMM 100,A03,193323,Staff,0,8,32,32
1683325150569,BIMM 101,A01,193329,McDonnell; Lisa Marie,0,3,24,24
1683325150569,BIMM 101,A02,193339,McDonnell; Lisa Marie,0,3,24,24
1683325150569,BIMM 101,B01,193354,McDonnell; Lisa Marie,0,3,24,24
1683325150569,BIMM 101,B02,193357,McDonnell; Lisa Marie,0,3,24,24
1683325151594,BIMM 110,A01,193377,Tat; John,0,11,32,32
1683325151594,BIMM 110,A02,193378,Tat; John,1,9,32,31
1683325152620,BIMM 120,A01,206116,Staff,0,0,32,32
1683325152620,BIMM 120,A02,206117,Staff,8,0,32,24
1683325152620,BIMM 120,A03,206121,Staff,21,0,32,11
1683325153645,BIPN 100,A01,193393,Park; Ji Young,0,14,32,32
1683325153645,BIPN 100,A02,193402,Park; Ji Young,0,13,32,32
1683325153645,BIPN 100,A03,193413,Park; Ji Young,0,14,32,32
1683325153645,BIPN 100,A04,193414,Park; Ji Young,0,13,32,32
1683325154669,BIPN 102,A01,193429,Staff,0,0,32,32
1683325154669,BIPN 102,A02,193438,Staff,22,0,32,10
1683325155693,BIPN 106,A01,193450,Reyes Gonzalez; Catalina,0,2,40,40
1683325156718,BIPN 134,A01,193465,Cooke; James Edward,0,0,32,32
1683325156718,BIPN 134,A02,193474,Cooke; James Edward,25,0,32,7
1683325156718,BIPN 134,A03,193485,Cooke; James Edward,29,0,32,3
1683325156718,BIPN 134,A04,193486,Cooke; James Edward,21,0,32,11
1683325156718,BIPN 134,A05,193491,Cooke; James Edward,31,0,32,1
1683325156718,BIPN 134,A06,193501,Cooke; James Edward,30,0,32,2
1683325156718,BIPN 134,A07,193510,Cooke; James Edward,29,0,32,3
1683325158768,BISP 194,A00,222522,Staff,14,0,32,18
1683325159794,CAT 124,A01,202407,Staff,20,0,25,5
1683325160820,CAT 125,A00,202408,Marchisotto; Jennifer Anne,4,0,20,16
1683325161845,CAT 125R,A00,202409,Smith; Lauryn Alissa,0,11,20,20
1683325161845,CAT 125R,B00,202410,Morales; Celeste Georgianna,0,11,20,20
1683325161845,CAT 125R,C00,202411,Irwin; Matthew Joseph,0,10,20,20
1683325162871,CENG 15,A01,204712,Yang; Kesong,0,1,0,0
1683325163896,CENG 114,A00,202070,Jahed Motlagh; Zeinab,5,0,20,15
1683325164920,CGS 105,A00,185477,Wesling; Megan E.,24,0,40,16
1683325165944,CGS 106,A00,185494,Staff,13,0,22,9
1683325166968,CGS 108,A00,185495,Staff,14,0,20,6
1683325167991,CGS 114,A00,185496,Staff,13,0,18,5
1683325169016,CGS 119,A00,185501,Staff,15,0,20,5
1683325170042,CGS 120,A00,185511,Staff,13,0,20,7
1683325171070,CHEM 4,A01,184675,Bussey; Thomas J,96,0,100,4
1683325172097,CHEM 6A,A01,184677,Staff,34,0,60,26
1683325173123,CHEM 6B,A01,184679,Staff,65,0,100,35
1683325174147,CHEM 6C,A01,184681,Bussey; Thomas J,1,0,50,49
1683325174147,CHEM 6C,A02,184682,Bussey; Thomas J,34,0,50,16
1683325175171,CHEM 40A,A01,184684,Albizati; Kim F.,37,0,100,63
1683325176200,CHEM 40B,A01,184686,Albizati; Kim F.,0,20,100,100
1683325177228,CHEM 41B,A01,184690,Staff,52,0,100,48
1683325178253,COGS 3,A01,184715,Boyle; Mary E. T.,0,25,40,40
1683325179276,COGS 14B,A01,185172,Staff,0,15,38,38
1683325180300,COGS 18,A01,184736,Staff,18,0,80,62
1683325181327,COGS 100,A01,184932,Staff,0,5,73,73
1683325182354,COGS 101A,A01,184935,Staff,0,38,30,30
1683325183377,COGS 101B,A01,184944,Staff,0,2,30,30
1683325184400,COGS 101C,A01,184946,Staff,0,12,30,30
1683325185423,COGS 102A,A01,184951,Johnson; Christine M.,2,0,40,38
1683325186446,COGS 107B,A01,184953,Mooshagian; Eric Frederick,0,50,40,40
1683325187471,COGS 118B,A01,184959,Gupta; Anjum,0,48,40,40
1683325188498,COGS 153,A00,184961,Staff,0,15,30,30
1683325189523,COGS 177,A00,184962,Staff,0,20,30,30
1683325190547,COGS 187A,A01,184969,Boyle; Mary E. T.,0,17,40,40
1683325191575,COMM 10,A01,185174,Staff,0,5,25,25
1683325191575,COMM 10,A02,185189,Staff,0,5,25,25
1683325191575,COMM 10,A03,269821,Staff,0,0,0,0
1683325192600,COMM 100B,A01,185475,Staff,0,0,0,2
1683325192600,COMM 100B,A02,185476,Staff,14,0,25,11
1683325193628,COMM 100C,A01,185314,Staff,1,0,25,24
1683325193628,COMM 100C,A02,185327,Staff,19,0,25,6
1683325194655,COMM 110M,A00,185349,Staff,2,0,40,38
1683325195678,COMM 113T,A00,185352,Staff,25,0,40,15
1683325196704,COMM 114I,A00,185353,Staff,33,0,40,7
1683325197732,COMM 131,A00,185354,Staff,19,0,30,11
1683325198757,CSE 8A,A50,185358,Cao; Yingjun,0,46,10,10
1683325199847,CSE 8B,A01,185362,Staff,1,47,50,49
1683325200870,CSE 11,A01,185416,Cao; Yingjun,0,92,10,10
1683325201897,CSE 20,A01,185445,Briones; Jor-el Thomas Caparas,5,0,25,20
1683325202923,CSE 21,A01,185447,Staff,10,0,50,40
1683325203946,CSE 101,A01,185451,Staff,0,12,50,50
1683325203946,CSE 101,B01,185453,Jones; Miles E,0,11,50,50
1683325205996,CSE 141,A01,185458,Eldon; John,20,0,100,80
1683325207019,CSE 141L,A01,185461,Eldon; John,12,0,100,88
1683325208048,CSE 142,A01,185463,Staff,36,0,60,24
1683325208048,CSE 142,B01,201355,Staff,0,7,60,60
1683325209071,CSE 142L,A01,185470,Staff,36,0,60,24
1683325209071,CSE 142L,B01,201417,Staff,0,6,60,60
1683325210100,CSE 190,A00,201433,Staff,32,0,49,17
1683325211127,DOC 1,A01,259136,Strom; Megan C.,7,0,15,8
1683325211127,DOC 1,A02,259137,Strom; Megan C.,14,0,15,1
1683325211127,DOC 1,A03,259138,Strom; Megan C.,14,0,15,1
1683325211127,DOC 1,A04,259139,Strom; Megan C.,14,0,15,1
1683325212149,DOC 100D,A00,259140,Pass; Natalye Joann,16,0,25,9
1683325213176,DSGN 1,A01,184749,Rill; Bryan,0,26,30,30
1683325214200,DSGN 100,A01,185168,Staff,0,2,25,25
1683325215226,ECE 5,A01,185626,Morris; Karcher William,0,10,0,0
1683325216253,ECE 101,A01,185628,Staff,17,0,70,53
1683325217275,ECE 107,A01,185635,Baghdadchi; Saharnaz,0,0,20,20
1683325217275,ECE 107,A02,185638,Baghdadchi; Saharnaz,4,0,20,16
1683325218299,ECE 148,A01,185647,Silberman; Jack,0,0,16,16
1683325219328,ECON 1,A01,185537,Crane; Meredith Helen,54,0,70,16
1683325220353,ECON 3,A01,185549,Crane; Meredith Helen,33,0,70,37
1683325221383,ECON 4,A01,203354,Anderson; John Charles,0,4,10,10
1683325222411,ECON 100A,A01,185574,Staff,0,4,40,40
1683325223436,ECON 100B,A01,185576,Staff,0,22,40,40
1683325224458,ECON 100C,A01,185589,Newhouse; Herbert S,30,0,70,40
1683325225482,ECON 105,A00,185608,Vespa; Emanuel Ignacio,19,0,35,16
1683325226510,ECON 109,A01,185610,Shishkin; Denis,10,0,35,25
1683325227537,ECON 110A,A01,185612,Staff,11,0,40,29
1683325228562,ECON 120A,A01,185615,Staff,20,0,40,20
1683325229585,ECON 120C,A01,185617,Sun; Yixiao,0,20,70,70
1683325230608,ECON 144,A00,203346,Squires; Dale E,3,0,35,32
1683325231636,ECON 171,A01,203349,Newhouse; Herbert S,0,1,35,35
1683325232663,ECON 173A,A01,185621,Toda; Alexis Akira,21,0,35,14
1683325233692,EDS 25,A01,202413,Staff,0,1,0,0
1683325233692,EDS 25,A02,202414,Staff,0,1,0,0
1683325233692,EDS 25,A03,202415,Staff,0,0,0,0
1683325233692,EDS 25,A04,202416,Staff,0,1,0,0
1683325233692,EDS 25,A05,202439,Staff,0,0,0,0
1683325233692,EDS 25,A06,202440,Staff,0,0,0,0
1683325233692,EDS 25,B01,202631,Staff,0,0,0,0
1683325233692,EDS 25,B02,202632,Staff,0,0,0,0
1683325233692,EDS 25,B03,202639,Staff,0,0,0,0
1683325233692,EDS 25,B04,202640,Staff,0,0,0,0
1683325233692,EDS 25,B05,202643,Staff,0,0,0,0
1683325233692,EDS 25,B06,202644,Staff,0,0,0,0
1683325234715,EDS 38,A01,202659,Black; Alison Michelle,24,0,25,1
1683325235740,EDS 115,A00,202652,Staff,17,0,30,13
1683325236766,EDS 125,A00,202649,Staff,14,0,30,16
1683325237793,EDS 126,A01,203332,Staff,30,0,30,0
1683325238822,EDS 139,A00,202838,Staff,16,0,25,9
1683325239845,EDS 146,A01,202655,Staff,14,0,25,11
1683325240869,ENG 15,A00,185667,Staff,0,1,0,0
1683325240869,ENG 15,B00,185672,Staff,0,0,0,0
1683325240869,ENG 15,C00,185675,Staff,0,0,0,0
1683325240869,ENG 15,D00,185682,Staff,0,0,0,0
1683325240869,ENG 15,E00,185684,Staff,0,0,0,0
1683325241896,ETHN 103,A00,185710,Staff,0,3,35,35
1683325242923,ETHN 103A,A00,199228,Man; Simeon S,2,0,9,7
1683325243950,ETHN 109,A00,185711,Staff,18,0,35,17
1683325244977,ETHN 142,A00,185726,Staff,0,4,30,30
1683325246004,ETHN 163J,A00,199229,Man; Simeon S,5,0,8,3
1683325247030,ETHN 168,A00,185727,Staff,8,0,10,2
1683325248056,ETHN 182,A00,185728,Staff,1,0,35,34
1683325249079,ETHN 183,A00,185737,Staff,8,0,18,10
1683325250103,GLBH 111,A01,209361,Burgos; Jose L.,0,0,0,0
1683325252148,HIEU 104,A00,185792,Staff,16,0,20,4
1683325253174,HIEU 115,A00,185800,Staff,1,0,20,19
1683325254201,HIEU 128,A00,185801,Staff,0,7,20,20
1683325255226,HIEU 147,A00,185802,Staff,16,0,20,4
1683325256253,HIEU 154,A00,185823,Staff,12,0,20,8
1683325257276,HILA 102,A00,185826,Staff,13,0,20,7
1683325258298,HILD 2C,A01,185778,Staff,0,12,20,20
1683325259321,HILD 7B,A01,185780,Kwak; Nancy,0,15,32,32
1683325259321,HILD 7B,A02,185781,Kwak; Nancy,0,18,32,32
1683325260345,HILD 30,A01,185791,Staff,14,0,20,6
1683325261373,HISC 119,A00,185830,Golan; Tal,0,9,20,20
1683325262397,HITO 156GS,A00,185831,Patterson; Patrick H.,0,0,0,23
1683325263423,HIUS 103,A00,185832,Man; Simeon S,0,6,20,20
1683325264446,HIUS 117,A00,185836,Kwak; Nancy,2,0,20,18
1683325265473,HIUS 125,A00,185840,Man; Simeon S,0,0,23,23
1683325266497,HIUS 149,A00,185845,Staff,0,0,20,20
1683325267522,HUM 3,A01,185882,Zavodny; Tatiana Sophia,0,7,50,50
1683325267522,HUM 3,B01,185899,Caldwell; Michael Alan,0,18,50,50
1683325268545,HUM 3GS,A00,185900,Patterson; Patrick H.,0,0,0,23
1683325269575,HUM 4,A01,185938,Zroka; Amy Liane,31,0,50,19
1683325269575,HUM 4,B01,185956,Watkins; Eric,0,2,50,50
1683325269575,HUM 4,B02,202209,Watkins; Eric,0,2,50,50
1683325269575,HUM 4,B03,202210,Watkins; Eric,0,2,50,50
1683325270599,HUM 5,A01,185958,West; Geoffrey Scott,3,0,50,47
1683325270599,HUM 5,A02,202215,West; Geoffrey Scott,0,0,50,50
1683325271626,INTL 190,A00,185959,Gagnon; Jeffrey C,0,0,0,9
1683325271626,INTL 190,B00,185960,Lettieri; Michael Joseph,0,0,0,1
1683325272648,JAPN 180,A00,254509,Staff,5,1,30,25
1683325273673,LATI 10,A01,202853,Kennemore; Amy Michelle,4,0,35,31
1683325273673,LATI 10,A02,202854,Kennemore; Amy Michelle,2,0,35,33
1683325273673,LATI 10,A03,270054,Kennemore; Amy Michelle,30,0,30,0
1683325274698,LATI 180,A00,202855,Kennemore; Amy Michelle,11,0,20,9
1683325275740,LAWS 101,A00,201767,Golan; Tal,0,7,40,40
1683325276763,LIFR 1C,A00,185961,Staff,6,0,20,14
1683325277786,LIFR 1CX,A00,185962,Staff,7,0,20,13
1683325278812,LIFR 1D,A00,185963,Staff,9,0,20,11
1683325279836,LIFR 1DX,A00,185964,Staff,9,0,20,11
1683325280860,LIGN 101,A01,186039,Staff,43,0,50,7
1683325281883,LIGN 165,A00,186040,Staff,18,0,50,32
1683325282907,LTCS 108,A00,186041,Staff,6,0,10,4
1683325283931,LTCS 119,A00,186042,Staff,16,0,20,4
1683325284958,LTCS 130,A00,186043,Wesling; Megan E.,15,0,25,10
1683325287006,LTEA 138,A00,186119,Staff,14,0,40,26
1683325288030,LTEN 124,A00,186148,Staff,6,0,25,19
1683325289054,LTEN 178,A00,186149,Staff,7,0,15,8
1683325290077,LTEN 181,A00,186150,Blanco; John D,33,0,40,7
1683325291102,LTWL 120,A00,186160,Staff,20,0,25,5
1683325292129,LTWL 165,A00,186161,Staff,22,0,25,3
1683325293155,LTWR 100,A00,186162,Staff,0,5,15,15
1683325294180,LTWR 102,A00,186163,Doller; Ben,5,0,15,10
1683325295206,MAE 8,A01,186412,Staff,0,0,0,0
1683325296230,MAE 30B,A00,186445,Bahadori; Mohammad Yousef,83,0,100,17
1683325297254,MAE 40,A00,186592,Bewley; Thomas R,9,0,50,41
1683325298283,MAE 101B,A00,186593,Bahadori; Mohammad Yousef,81,0,100,19
1683325299310,MAE 105,A00,186594,Bandaru; Prabhakar,12,0,50,38
1683325300338,MAE 107,A00,186599,Pham; Hieu Tan,0,6,120,120
1683325301362,MAE 148,A01,186660,Silberman; Jack,3,0,16,13
1683325302387,MATH 10A,A01,188095,Staff,1,6,35,34
1683325303483,MATH 10B,A01,188097,Bowers; Adam R.,0,11,30,30
1683325303483,MATH 10B,A02,188099,Bowers; Adam R.,0,11,30,30
1683325303483,MATH 10B,B01,188104,Bowers; Adam R.,0,10,30,30
1683325303483,MATH 10B,B02,188106,Bowers; Adam R.,0,10,30,30
1683325304508,MATH 10C,A01,188111,Staff,0,18,30,30
1683325304508,MATH 10C,A02,188127,Staff,0,17,30,30
1683325304508,MATH 10C,A03,188131,Staff,0,18,30,30
1683325304508,MATH 10C,B01,188218,Staff,18,0,30,12
1683325304508,MATH 10C,B02,188244,Staff,13,0,30,17
1683325304508,MATH 10C,B03,188277,Staff,16,0,30,14
1683325305539,MATH 18,A01,188344,Bach; Quang Tran,18,0,30,12
1683325305539,MATH 18,A02,188345,Bach; Quang Tran,11,0,30,19
1683325305539,MATH 18,B01,188353,Bach; Quang Tran,10,0,30,20
1683325305539,MATH 18,B02,188354,Bach; Quang Tran,20,0,30,10
1683325306566,MATH 20A,A01,188374,Staff,13,0,35,22
1683325307591,MATH 20B,A01,188382,Ohm; Ko Woon,6,0,30,24
1683325307591,MATH 20B,A02,188383,Ohm; Ko Woon,22,0,30,8
1683325307591,MATH 20B,B01,188385,Ohm; Ko Woon,7,0,30,23
1683325307591,MATH 20B,B02,188392,Ohm; Ko Woon,22,0,30,8
1683325308616,MATH 20C,A01,188394,Harel; Guershon,10,0,30,20
1683325308616,MATH 20C,A02,188395,Harel; Guershon,14,0,30,16
1683325308616,MATH 20C,B01,188404,Harel; Guershon,5,0,30,25
1683325308616,MATH 20C,B02,188405,Harel; Guershon,19,0,30,11
1683325309641,MATH 20D,A01,188414,Hammock; Frances H,0,1,30,30
1683325309641,MATH 20D,A02,188415,Hammock; Frances H,3,0,30,27
1683325309641,MATH 20D,B01,188447,Hammock; Frances H,2,0,30,28
1683325309641,MATH 20D,B02,188486,Hammock; Frances H,8,0,30,22
1683325310665,MATH 20E,A01,188649,Staff,21,0,30,9
1683325310665,MATH 20E,A02,188650,Staff,23,0,30,7
1683325310665,MATH 20E,A03,188673,Staff,0,0,30,30
1683325311687,MATH 102,A01,188675,Staff,0,35,35,35
1683325312715,MATH 103B,A01,188681,Staff,4,0,35,31
1683325312715,MATH 103B,B01,188692,Staff,5,0,35,30
1683325313738,MATH 109,A01,188695,Salehi Golsefidy; Alireza,25,0,35,10
1683325313738,MATH 109,A02,188696,Salehi Golsefidy; Alireza,26,0,35,9
1683325314762,MATH 120A,A01,188698,Eggers; John Dietrich,7,0,35,28
1683325315787,MATH 142B,A01,188736,Ioana; Adrian,0,2,30,30
1683325315787,MATH 142B,A02,188741,Ioana; Adrian,0,1,30,30
1683325315787,MATH 142B,A03,188743,Ioana; Adrian,1,3,30,29
1683325316811,MATH 168A,A01,188790,Staff,0,9,35,35
1683325317835,MATH 170A,A01,188803,Nie; Jiawang,0,2,35,35
1683325317835,MATH 170A,A02,188811,Nie; Jiawang,0,0,35,35
1683325317835,MATH 170A,A03,188814,Nie; Jiawang,1,0,35,34
1683325317835,MATH 170A,A04,188815,Nie; Jiawang,13,0,35,22
1683325318861,MATH 193B,A01,188817,Staff,0,0,35,35
1683325318861,MATH 193B,A02,188818,Staff,5,0,35,30
1683325319884,MGT 4,A01,202857,Anderson; John Charles,62,0,80,18
1683325320912,MGT 12,A00,202858,Lindenberger; Wade Douglas,42,0,90,48
1683325321937,MGT 18,A00,202859,Staff,74,0,90,16
1683325322961,MGT 18GS,A00,202860,McKay; Michael J,13,0,28,15
1683325323987,MGT 45,A00,202861,Pecore; Joseph P.,13,0,90,77
1683325325010,MGT 100,A00,202863,Yavorsky; Daniel Ryan,28,0,90,62
1683325326034,MGT 103,A00,202864,Ehrich; Kristine R,0,18,90,90
1683325327061,MGT 112,A00,202865,Ehrich; Kristine R,15,0,90,75
1683325328084,MGT 121A,A00,202868,Staff,0,20,0,0
1683325329111,MGT 131B,A00,202869,Anderson; John Charles,59,0,90,31
1683325330137,MGT 136,A00,202871,Lindenberger; Wade Douglas,84,0,90,6
1683325331163,MGT 164,A00,202873,Staff,0,68,90,91
1683325332186,MGT 164GS,A00,202874,McKay; Mary A,13,0,28,15
1683325333213,MGT 180,A00,202875,Staff,0,50,90,91
1683325334240,MMW 11R,A01,205019,Herbst; Matthew,3,0,30,27
1683325334240,MMW 11R,A02,205026,Herbst; Matthew,29,0,30,1
1683325335266,MMW 15,A01,193512,Chang; Edmond Yi-Teh,0,9,28,28
1683325335266,MMW 15,A02,193513,Chang; Edmond Yi-Teh,0,5,28,28
1683325335266,MMW 15,A03,193514,Chang; Edmond Yi-Teh,0,5,28,28
1683325335266,MMW 15,A04,193515,Chang; Edmond Yi-Teh,0,5,28,28
1683325335266,MMW 15,A05,193516,Chang; Edmond Yi-Teh,0,4,28,28
1683325335266,MMW 15,A06,193517,Chang; Edmond Yi-Teh,0,5,28,28
1683325335266,MMW 15,B01,193519,Chang; Edmond Yi-Teh,0,5,28,28
1683325335266,MMW 15,B02,193520,Chang; Edmond Yi-Teh,0,5,28,28
1683325335266,MMW 15,B03,193521,Chang; Edmond Yi-Teh,0,5,28,28
1683325335266,MMW 15,B04,193522,Chang; Edmond Yi-Teh,0,4,28,28
1683325335266,MMW 15,B05,193523,Chang; Edmond Yi-Teh,0,5,28,28
1683325335266,MMW 15,B06,193524,Chang; Edmond Yi-Teh,0,4,28,28
1683325336291,MMW 122,A01,193526,Rahimi; Babak,0,15,28,28
1683325336291,MMW 122,A02,193527,Rahimi; Babak,0,14,28,28
1683325336291,MMW 122,A03,193528,Rahimi; Babak,0,0,0,0
1683325336291,MMW 122,A04,193529,Rahimi; Babak,0,0,0,0
1683325337315,MUS 1A,A01,186663,Staff,0,20,35,35
1683325338338,MUS 4,A01,186715,Staff,0,12,35,35
1683325339362,MUS 5R,A01,186796,Dubnov; Shlomo,0,17,35,35
1683325340385,MUS 6,A01,186798,Staff,0,4,25,25
1683325341412,MUS 7,A01,186830,Staff,12,0,35,23
1683325342437,MUS 8,A01,186930,Staff,0,27,35,35
1683325343464,MUS 15,A01,186932,Staff,0,16,35,35
1683325343464,MUS 15,B01,186934,Staff,0,15,35,35
1683325344495,MUS 80,A00,186935,Staff,1,0,20,19
1683325344495,MUS 80,B00,186936,Staff,25,0,25,0
1683325345519,NANO 11,A00,204702,Lipomi; Darren John,0,0,0,0
1683325346547,NANO 15,A01,204709,Yang; Kesong,0,1,0,0
1683325347571,NANO 114,A00,202069,Jahed Motlagh; Zeinab,3,0,10,7
1683325348599,PHIL 1,A00,186955,Grush; Rick Scott,32,0,40,8
1683325349627,PHIL 10,A01,186973,Grush; Rick Scott,28,0,35,7
1683325349627,PHIL 10,A02,186974,Grush; Rick Scott,33,0,35,2
1683325350653,PHIL 13,A01,186976,Staff,7,0,35,28
1683325350653,PHIL 13,A02,186977,Staff,16,0,35,19
1683325351679,PHIL 14,A01,186979,Staff,31,0,35,4
1683325351679,PHIL 14,A02,186986,Staff,32,0,35,3
1683325352707,PHIL 28,A01,186988,Staff,16,0,30,14
1683325352707,PHIL 28,A02,186989,Staff,1,0,30,29
1683325352707,PHIL 28,A03,186990,Staff,9,0,30,21
1683325352707,PHIL 28,A04,186991,Staff,26,0,30,4
1683325353733,PHIL 120,A00,186997,Staff,23,0,40,17
1683325354757,PHIL 137,A00,187003,Staff,9,0,40,31
1683325355781,PHIL 150,A00,187015,Staff,47,0,70,23
1683325356805,PHIL 167,A00,187021,Lamey; Andy M.,35,0,40,5
1683325357829,PHIL 174,A01,202226,Staff,17,0,20,3
1683325357829,PHIL 174,A02,202235,Staff,20,0,20,0
1683325358855,PHIL 191A,A00,258918,Staff,0,0,1,1
1683325359880,PHYS 1A,A00,187028,Staff,27,0,60,33
1683325360903,PHYS 1AL,001,187036,Staff,3,0,30,27
1683325360903,PHYS 1AL,002,187049,Staff,18,0,30,12
1683325361930,PHYS 1B,A00,187058,Staff,22,0,60,38
1683325362956,PHYS 1BL,001,187064,Staff,0,0,30,30
1683325362956,PHYS 1BL,002,187070,Staff,5,0,30,25
1683325363982,PHYS 1C,A00,187082,Staff,31,0,120,89
1683325365009,PHYS 1CL,001,187088,Staff,0,9,30,30
1683325365009,PHYS 1CL,002,187089,Staff,0,2,30,30
1683325365009,PHYS 1CL,009,262693,Staff,11,0,30,19
1683325366033,PHYS 2B,A01,187097,Staff,54,0,115,61
1683325367056,PHYS 2C,A01,187099,Staff,67,0,115,48
1683325368086,PHYS 2CL,A01,187101,Staff,5,0,28,23
1683325368086,PHYS 2CL,A02,187102,Staff,15,0,28,13
1683325369109,PHYS 2D,A01,187123,Shotwell; Brian,95,0,115,20
1683325370137,PHYS 4B,A01,187133,Grinstein; Benjamin,35,0,50,15
1683325371166,POLI 10,A00,188819,Staff,0,4,50,50
1683325372192,POLI 11,A00,188827,Staff,43,0,50,7
1683325373219,POLI 13R,A00,188828,Staff,0,1,20,20
1683325374242,POLI 27,A01,188830,Elgin; Samuel Zincke,0,1,70,70
1683325375270,POLI 30,A00,188832,Desposato; Scott,31,0,50,19
1683325376295,POLI 102F,A00,188834,Staff,3,0,40,37
1683325377322,POLI 104A,A00,188852,Staff,14,0,30,16
1683325378344,POLI 104I,A00,188853,Staff,0,6,20,20
1683325379367,POLI 110B,A00,188854,Wiens; David,7,0,20,13
1683325380394,POLI 112A,A00,188855,Wiens; David,5,0,30,25
1683325381420,POLI 117R,A00,188856,Forman; Fonna,0,11,20,20
1683325382445,POLI 118,A00,188857,Ingham; Sean,8,0,20,12
1683325383470,POLI 120G,A00,188858,Staff,9,0,30,21
1683325384497,POLI 131CR,A00,188863,Hoston; Germaine,24,0,50,26
1683325385523,POLI 133,A00,188864,Nellis; Gareth Hb,44,0,50,6
1683325386550,POLI 134D,A00,188865,Desposato; Scott,27,0,30,3
1683325387577,POLI 142A,A00,188871,Gartzke; Erik,22,0,50,28
1683325388601,POLI 142K,A00,188874,Staff,38,0,50,12
1683325389624,POLI 143,A00,188940,Gartzke; Erik,16,0,30,14
1683325390650,POLI 153,A00,188943,Staff,3,0,20,17
1683325391676,POLI 160AA,A00,188944,Staff,12,0,40,28
1683325392705,POLI 170A,A00,188945,Staff,11,0,30,19
1683325394758,PSYC 1,A00,188952,Staff,37,0,90,53
1683325395782,PSYC 2,B00,188953,Staff,19,0,35,16
1683325396806,PSYC 6,A00,188970,Staff,47,0,60,13
1683325397830,PSYC 7,A00,188973,Staff,37,0,45,8
1683325398852,PSYC 60,A01,188980,Rickard; Timothy C.,43,0,60,17
1683325399877,PSYC 70,A01,189001,Steiner; Eric Tomas,24,0,45,21
1683325400901,PSYC 100,A00,189005,Lacefield; Katharine I,0,100,120,120
1683325401923,PSYC 102,A00,189008,Staff,9,0,30,21
1683325402951,PSYC 106,B00,189026,Gorman; Michael R.,34,0,60,26
1683325403973,PSYC 114,B01,189033,Winkielman; Piotr,0,32,30,30
1683325404999,PSYC 131,A00,189036,Anagnostaras; Stephan,0,43,60,60
1683325406026,PSYC 136,A00,189041,Lowe; Angela Beth,0,7,25,25
1683325407111,PSYC 137,A00,189057,Winkielman; Piotr,0,34,25,25
1683325408134,PSYC 144,A00,189107,Wixted; John T,0,7,50,50
1683325410183,PSYC 162,A00,189142,Staff,0,8,85,85
1683325411209,PSYC 172,A00,189144,Gorman; Michael R.,0,7,30,30
1683325413257,PSYC 179,A00,189146,Lacefield; Katharine I,0,84,120,120
1683325414284,PSYC 181,A00,189147,Anagnostaras; Stephan,0,44,90,90
1683325415312,PSYC 190R,A00,189148,Barner; David A.,0,22,80,80
1683325416336,PSYC 191,A00,189275,Rickard; Timothy C.,0,7,25,25
1683325417360,PSYC 193,A00,189276,Chapman; Eddie Nathaniel,0,1,0,4
1683325418389,PSYC 193L,A01,189281,Lowe; Angela Beth,12,0,20,8
1683325418389,PSYC 193L,B01,189285,Staff,28,0,35,7
1683325419413,RELI 149,A00,187137,Rahimi; Babak,7,0,40,33
1683325420436,SE 9,A01,187315,Staff,0,2,18,18
1683325421460,SE 101B,A00,187409,Staff,24,0,30,6
1683325422489,SE 110B,A00,187444,Staff,10,0,40,30
1683325423513,SE 130B,A00,187449,Staff,31,0,40,9
1683325424540,SE 150A,A00,187516,Staff,9,0,20,11
1683325425564,SE 154,A00,187528,Staff,30,0,50,20
1683325426591,SIO 3,A01,258171,Staff,35,0,40,5
1683325427616,SIO 10,A00,187144,Cook; Geoffrey W,0,3,75,75
1683325428639,SIO 45,A00,187152,Cook; Geoffrey W,1,0,100,99
1683325429665,SIO 109R,A00,194486,Staff,0,3,20,20
1683325431716,SIO 187,A01,187233,Kacev; David,12,0,40,28
1683325432744,SOCI 1,A01,258656,Thorpe; Charles Robert,28,0,30,2
1683325432744,SOCI 1,A02,258658,Thorpe; Charles Robert,30,0,30,0
1683325432744,SOCI 1,A03,258661,Thorpe; Charles Robert,25,0,25,0
1683325432744,SOCI 1,A04,258666,Thorpe; Charles Robert,22,0,25,3
1683325432744,SOCI 1,A05,258897,Thorpe; Charles Robert,23,0,25,2
1683325432744,SOCI 1,A06,258898,Thorpe; Charles Robert,25,0,25,0
1683325433769,SOCI 30,A01,258903,Pardo Guerra; Juan Pablo,16,0,30,14
1683325434795,SOCI 102,A00,258904,Staff,9,0,25,16
1683325435819,SOCI 106,A00,258905,Staff,19,0,25,6
1683325436845,SOCI 111,A00,258907,Ribas Norris; Janet Vanesa,26,0,30,4
1683325437869,SOCI 121R,A00,258908,Pardo Guerra; Juan Pablo,10,0,30,20
1683325438895,SOCI 126,A01,203330,Staff,14,0,20,6
1683325439919,SOCI 131,A00,258909,Thorpe; Charles Robert,31,0,60,29
1683325440944,SOCI 135,A00,258910,Payne; Christine Anna,0,9,30,30
1683325441968,SOCI 157,A00,258911,Staff,12,0,30,18
1683325442992,SOCI 184,A00,258912,Staff,25,0,30,5
1683325444019,SOCI 188D,A00,258913,Staff,21,0,30,9
1683325445043,SYN 2,001,187529,Staff,9,0,16,7
1683325445043,SYN 2,002,201452,Staff,0,18,16,16
1683325445043,SYN 2,003,201469,Staff,4,0,16,12
1683325446066,SYN 100,A01,187531,Staff,0,9,20,20
1683325446066,SYN 100,B01,201491,Staff,0,12,20,20
1683325447092,TDAC 1,A00,189286,Walsh; Kim C.,3,0,20,17
1683325447092,TDAC 1,B00,189287,Harting; Carla Kelso,11,0,20,9
1683325448120,TDAC 101,A00,189300,Walsh; Kim C.,16,0,20,4
1683325448120,TDAC 101,B00,189301,Harting; Carla Kelso,18,0,20,2
1683325449148,TDAC 102,A00,189304,Basso; Beatrice,14,0,20,6
1683325450172,TDAC 108,A00,189305,Staff,18,0,20,2
1683325451196,TDDE 131,A00,189310,Staff,19,0,20,1
1683325451196,TDDE 131,B00,189314,Staff,19,0,20,1
1683325451196,TDDE 131,C00,189315,Staff,48,0,50,2
1683325451196,TDDE 131,D00,189316,Staff,14,0,15,1
1683325451196,TDDE 131,E00,204841,Staff,20,0,20,0
1683325452218,TDGE 10,A00,189289,Staff,30,0,50,20
1683325452218,TDGE 10,B00,189290,Havis; Allan,1,0,50,49
1683325453241,TDGE 11,A00,189291,Fulton; Julia,0,3,50,50
1683325453241,TDGE 11,B00,189292,Staff,20,0,25,5
1683325453241,TDGE 11,C00,260270,Staff,0,0,0,0
1683325454270,TDGE 25,A00,189294,Staff,3,0,20,17
1683325455294,TDGE 124,A00,189318,Fulton; Julia,0,8,50,50
1683325456318,TDGE 125,A00,189319,Staff,13,0,25,12
1683325456318,TDGE 125,B00,189320,Staff,23,0,25,2
1683325457344,TDGE 127,A00,189322,Havis; Allan,0,0,50,50
1683325458369,TDHT 101,A00,189323,Staff,18,0,25,7
1683325458369,TDHT 101,B00,189324,Staff,25,0,25,0
1683325459396,TDHT 102,A00,189325,Staff,49,0,50,1
1683325460420,TDMV 1,A00,189295,Arcidiacono; Kristin,19,0,30,11
1683325460420,TDMV 1,B00,189296,Caligagan; Maria T.,24,0,30,6
1683325461444,TDMV 2,A00,189297,Sammartano; Tonnie,28,0,30,2
1683325461444,TDMV 2,B00,189299,Arcidiacono; Kristin,24,0,30,6
1683325462470,TDMV 3,A00,204998,Rincon; Alicia,22,0,30,8
1683325463495,TDMV 120,A00,189458,Sammartano; Tonnie,28,0,30,2
1683325464522,TDMV 138,A00,189541,Jun; Grace Shin Hae,22,0,40,18
1683325465550,TDMV 142,A00,189717,Caligagan; Tony,23,0,30,7
1683325465550,TDMV 142,B00,189718,Caligagan; Maria T.,25,0,30,5
1683325466576,TMC 2,A01,187533,Staff,25,0,25,0
1683325466576,TMC 2,A02,187534,Staff,25,0,25,0
1683325467604,USP 1,A01,187536,Kwak; Nancy,0,16,25,25
1683325468631,USP 5,A01,187538,Staff,9,0,25,16
1683325469658,USP 101,A00,199253,Staff,0,4,0,0
1683325470685,USP 124,A00,187562,Boomhower; Matthew Charles,1,0,30,29
1683325471712,USP 138,A00,187582,Staff,20,0,25,5
1683325472736,USP 152,A01,187597,Staff,4,0,25,21
1683325473761,USP 153,A00,187598,Staff,19,0,25,6
1683325474788,USP 168,A00,187607,Kwak; Nancy,2,0,5,3
1683325475817,USP 173,A00,187619,Staff,4,0,25,21
1683325476842,USP 181,A00,187638,Staff,0,0,25,25
1683325477866,VIS 103,A00,187650,Cruz; Edwin Teddy,23,0,75,52
1683325478954,VIS 110D,A00,187669,Staff,12,0,22,10
1683325479978,VIS 127C,A00,187720,Shen; Kuiyi,67,0,146,79
1683325481002,VIS 149,A00,187731,Yoldas; Pinar,0,14,22,22
1683325482026,VIS 151,A01,188091,Staff,22,0,34,12
1683325482026,VIS 151,A02,188092,Staff,11,0,34,23
1683325483050,VIS 160B,A00,188093,Stalbaum; Brett,0,0,10,10
1683325485103,WCWP 10B,A00,201720,Staff,10,0,15,5
1683325485103,WCWP 10B,B00,201722,Staff,8,0,15,7
1683325486126,WCWP 100,A00,201725,Gagnon; Jeffrey C,0,0,2,2
1683325486126,WCWP 100,B00,201727,Staff,0,4,15,15
1683325489221,ANBI 133,A00,258401,Wilder; Linnea Lorene,34,0,40,6
1683325490248,ANBI 140,A00,258395,Hrvoj Mihic; Branka,18,0,25,7
1683325491272,ANSC 120,A00,258402,Bialecki; Jon Anthony,27,0,40,13
1683325492295,ANSC 144,A00,258400,Staff,14,0,40,26
1683325494346,ANSC 166,A00,258396,Parish; Steven Martin,157,0,175,18
1683325495375,ANSC 180,A00,193533,Staff,9,0,20,11
1683325496402,ANSC 188,A00,258397,Jassal; Aftab,33,0,40,7
1683325497425,ANTH 3,A01,258316,Staff,23,0,30,7
1683325498447,ANTH 5,A00,258394,Semendeferi; Ekaterini,16,0,20,4
1683325499473,ANTH 21,A01,258331,Staff,8,0,40,32
1683325500496,ANTH 103,A00,258398,Varma; Saiba,15,0,25,10
1683325501537,AWP 10,001,202034,Staff,0,0,0,0
1683325501537,AWP 10,002,202035,Staff,0,0,0,0
1683325501537,AWP 10,003,202036,Staff,0,0,0,0
1683325501537,AWP 10,004,202037,Staff,0,0,0,0
1683325501537,AWP 10,005,202038,Staff,0,0,0,0
1683325501537,AWP 10,006,202039,Staff,0,0,0,0
1683325501537,AWP 10,007,202040,Staff,0,0,0,0
1683325501537,AWP 10,008,202041,Staff,0,0,0,0
1683325501537,AWP 10,009,202042,Staff,0,0,0,0
1683325501537,AWP 10,010,202043,Staff,0,0,0,0
1683325501537,AWP 10,011,202044,Staff,0,0,0,0
1683325501537,AWP 10,012,202045,Staff,0,0,0,0
1683325501537,AWP 10,013,202046,Staff,0,0,0,0
1683325501537,AWP 10,014,202047,Staff,0,0,0,0
1683325501537,AWP 10,015,202048,Staff,0,0,0,0
1683325501537,AWP 10,016,202049,Staff,0,0,0,0
1683325501537,AWP 10,017,202050,Staff,0,0,0,0
1683325501537,AWP 10,018,202051,Staff,0,0,0,0
1683325501537,AWP 10,019,202052,Staff,0,0,0,0
1683325501537,AWP 10,020,202053,Staff,0,0,0,0
1683325501537,AWP 10,021,202054,Staff,0,0,0,0
1683325501537,AWP 10,022,202055,Staff,0,0,0,0
1683325501537,AWP 10,023,202056,Staff,0,0,0,0
1683325501537,AWP 10,024,202057,Staff,0,0,0,0
1683325501537,AWP 10,025,202058,Staff,0,0,0,0
1683325501537,AWP 10,026,202059,Staff,0,0,0,0
1683325502561,AWP 102,001,202032,Staff,0,0,0,0
1683325502561,AWP 102,002,202033,Staff,0,0,0,0
1683325503587,BENG 100,A01,254234,Taylor Amos; Alyssa C,31,0,40,9
1683325504612,BENG 196,001,270013,Engler; Adam J.,9999,0,9999,0
1683325505636,BICD 100R,A01,202018,Smith; Laurie,0,7,32,32
1683325505636,BICD 100R,A02,202019,Smith; Laurie,0,2,32,32
1683325505636,BICD 100R,A03,202020,Smith; Laurie,0,1,32,32
1683325505636,BICD 100R,A04,202021,Smith; Laurie,9,0,32,23
1683325505636,BICD 100R,A05,202022,Smith; Laurie,12,0,32,20
1683325506666,BICD 136,A01,193242,Gustafson-Brown; Cindy,0,2,32,32
1683325506666,BICD 136,A02,193244,Gustafson-Brown; Cindy,14,0,32,18
1683325507695,BIEB 102,A01,193249,Butler; Shannon Rhey,0,2,32,32
1683325507695,BIEB 102,A02,193251,Butler; Shannon Rhey,0,0,32,32
1683325507695,BIEB 102,A03,193253,Butler; Shannon Rhey,0,1,32,32
1683325507695,BIEB 102,A04,193255,Butler; Shannon Rhey,17,0,32,15
1683325507695,BIEB 102,A05,193265,Butler; Shannon Rhey,26,0,32,6
1683325507695,BIEB 102,A06,193269,Butler; Shannon Rhey,16,0,32,16
1683325509746,BIEB 150,A01,193274,Staff,0,0,32,32
1683325509746,BIEB 150,A02,193285,Staff,23,0,32,9
1683325510830,BIEB 194,A00,193286,Kurle; Carolyn M.,22,0,32,10
1683325511856,BILD 1,A01,192291,Staff,16,0,32,16
1683325511856,BILD 1,A02,192292,Staff,30,0,32,2
1683325511856,BILD 1,B01,192520,Reuther; Keefe,0,1,0,0
1683325511856,BILD 1,B02,192532,Reuther; Keefe,0,1,0,0
1683325512885,BILD 3,A01,192556,Butler; Shannon Rhey,0,0,32,32
1683325512885,BILD 3,A02,192581,Butler; Shannon Rhey,5,0,32,27
1683325512885,BILD 3,A03,192611,Butler; Shannon Rhey,23,0,32,9
1683325512885,BILD 3,A04,192612,Butler; Shannon Rhey,25,0,32,7
1683325512885,BILD 3,A05,192613,Butler; Shannon Rhey,27,0,32,5
1683325512885,BILD 3,A06,192679,Butler; Shannon Rhey,27,0,32,5
1683325512885,BILD 3,A07,192682,Butler; Shannon Rhey,22,0,32,10
1683325513914,BILD 4,A01,192836,Reuther; Keefe,0,0,24,24
1683325513914,BILD 4,A02,193044,Reuther; Keefe,4,0,24,20
1683325514942,BILD 10,A01,193142,Gustafson-Brown; Cindy,30,0,32,2
1683325514942,BILD 10,A02,193149,Gustafson-Brown; Cindy,31,0,32,1
1683325515966,BIMM 100,A01,193301,Staff,0,6,32,32
1683325515966,BIMM 100,A02,193312,Staff,0,5,32,32
1683325515966,BIMM 100,A03,193323,Staff,0,8,32,32
1683325516993,BIMM 101,A01,193329,McDonnell; Lisa Marie,0,3,24,24
1683325516993,BIMM 101,A02,193339,McDonnell; Lisa Marie,0,3,24,24
1683325516993,BIMM 101,B01,193354,McDonnell; Lisa Marie,0,3,24,24
1683325516993,BIMM 101,B02,193357,McDonnell; Lisa Marie,0,3,24,24
1683325518021,BIMM 110,A01,193377,Tat; John,0,11,32,32
1683325518021,BIMM 110,A02,193378,Tat; John,1,9,32,31
1683325519049,BIMM 120,A01,206116,Staff,0,0,32,32
1683325519049,BIMM 120,A02,206117,Staff,8,0,32,24
1683325519049,BIMM 120,A03,206121,Staff,21,0,32,11
1683325520077,BIPN 100,A01,193393,Park; Ji Young,0,14,32,32
1683325520077,BIPN 100,A02,193402,Park; Ji Young,0,13,32,32
1683325520077,BIPN 100,A03,193413,Park; Ji Young,0,14,32,32
1683325520077,BIPN 100,A04,193414,Park; Ji Young,0,13,32,32
1683325521107,BIPN 102,A01,193429,Staff,0,0,32,32
1683325521107,BIPN 102,A02,193438,Staff,22,0,32,10
1683325522129,BIPN 106,A01,193450,Reyes Gonzalez; Catalina,0,2,40,40
1683325523154,BIPN 134,A01,193465,Cooke; James Edward,0,0,32,32
1683325523154,BIPN 134,A02,193474,Cooke; James Edward,25,0,32,7
1683325523154,BIPN 134,A03,193485,Cooke; James Edward,29,0,32,3
1683325523154,BIPN 134,A04,193486,Cooke; James Edward,21,0,32,11
1683325523154,BIPN 134,A05,193491,Cooke; James Edward,31,0,32,1
1683325523154,BIPN 134,A06,193501,Cooke; James Edward,30,0,32,2
1683325523154,BIPN 134,A07,193510,Cooke; James Edward,29,0,32,3
1683325525204,BISP 194,A00,222522,Staff,14,0,32,18
1683325526227,CAT 124,A01,202407,Staff,20,0,25,5
1683325527251,CAT 125,A00,202408,Marchisotto; Jennifer Anne,4,0,20,16
1683325528273,CAT 125R,A00,202409,Smith; Lauryn Alissa,0,11,20,20
1683325528273,CAT 125R,B00,202410,Morales; Celeste Georgianna,0,11,20,20
1683325528273,CAT 125R,C00,202411,Irwin; Matthew Joseph,0,10,20,20
1683325529299,CENG 15,A01,204712,Yang; Kesong,0,1,0,0
1683325530322,CENG 114,A00,202070,Jahed Motlagh; Zeinab,5,0,20,15
1683325531347,CGS 105,A00,185477,Wesling; Megan E.,24,0,40,16
1683325532370,CGS 106,A00,185494,Staff,13,0,22,9
1683325533397,CGS 108,A00,185495,Staff,14,0,20,6
1683325534423,CGS 114,A00,185496,Staff,13,0,18,5
1683325535448,CGS 119,A00,185501,Staff,15,0,20,5
1683325536474,CGS 120,A00,185511,Staff,13,0,20,7
1683325537499,CHEM 4,A01,184675,Bussey; Thomas J,96,0,100,4
1683325538523,CHEM 6A,A01,184677,Staff,34,0,60,26
1683325539547,CHEM 6B,A01,184679,Staff,65,0,100,35
1683325540571,CHEM 6C,A01,184681,Bussey; Thomas J,1,0,50,49
1683325540571,CHEM 6C,A02,184682,Bussey; Thomas J,34,0,50,16
1683325541599,CHEM 40A,A01,184684,Albizati; Kim F.,37,0,100,63
1683325542624,CHEM 40B,A01,184686,Albizati; Kim F.,0,20,100,100
1683325543648,CHEM 41B,A01,184690,Staff,52,0,100,48
1683325544671,COGS 3,A01,184715,Boyle; Mary E. T.,0,25,40,40
1683325545699,COGS 14B,A01,185172,Staff,0,15,38,38
1683325546725,COGS 18,A01,184736,Staff,17,0,80,63
1683325547750,COGS 100,A01,184932,Staff,0,5,73,73
1683325548774,COGS 101A,A01,184935,Staff,0,38,30,30
1683325549833,COGS 101B,A01,184944,Staff,0,2,30,30
1683325550859,COGS 101C,A01,184946,Staff,0,12,30,30
1683325551886,COGS 102A,A01,184951,Johnson; Christine M.,2,0,40,38
1683325552915,COGS 107B,A01,184953,Mooshagian; Eric Frederick,0,50,40,40
1683325553942,COGS 118B,A01,184959,Gupta; Anjum,0,48,40,40
1683325554967,COGS 153,A00,184961,Staff,0,15,30,30
1683325555992,COGS 177,A00,184962,Staff,0,20,30,30
1683325557020,COGS 187A,A01,184969,Boyle; Mary E. T.,0,17,40,40
1683325558046,COMM 10,A01,185174,Staff,0,5,25,25
1683325558046,COMM 10,A02,185189,Staff,0,5,25,25
1683325558046,COMM 10,A03,269821,Staff,0,0,0,0
1683325559073,COMM 100B,A01,185475,Staff,0,0,0,2
1683325559073,COMM 100B,A02,185476,Staff,14,0,25,11
1683325560097,COMM 100C,A01,185314,Staff,1,0,25,24
1683325560097,COMM 100C,A02,185327,Staff,19,0,25,6
1683325561124,COMM 110M,A00,185349,Staff,2,0,40,38
1683325562151,COMM 113T,A00,185352,Staff,25,0,40,15
1683325563176,COMM 114I,A00,185353,Staff,33,0,40,7
1683325564203,COMM 131,A00,185354,Staff,19,0,30,11
1683325565230,CSE 8A,A50,185358,Cao; Yingjun,0,46,10,10
1683325566254,CSE 8B,A01,185362,Staff,1,47,50,49
1683325567279,CSE 11,A01,185416,Cao; Yingjun,0,92,10,10
1683325568302,CSE 20,A01,185445,Briones; Jor-el Thomas Caparas,5,0,25,20
1683325569329,CSE 21,A01,185447,Staff,10,0,50,40
1683325570358,CSE 101,A01,185451,Staff,0,12,50,50
1683325570358,CSE 101,B01,185453,Jones; Miles E,0,11,50,50
1683325572407,CSE 141,A01,185458,Eldon; John,20,0,100,80
1683325573430,CSE 141L,A01,185461,Eldon; John,12,0,100,88
1683325574457,CSE 142,A01,185463,Staff,36,0,60,24
1683325574457,CSE 142,B01,201355,Staff,0,7,60,60
1683325575484,CSE 142L,A01,185470,Staff,36,0,60,24
1683325575484,CSE 142L,B01,201417,Staff,0,6,60,60
1683325576512,CSE 190,A00,201433,Staff,32,0,49,17
1683325577537,DOC 1,A01,259136,Strom; Megan C.,7,0,15,8
1683325577537,DOC 1,A02,259137,Strom; Megan C.,14,0,15,1
1683325577537,DOC 1,A03,259138,Strom; Megan C.,14,0,15,1
1683325577537,DOC 1,A04,259139,Strom; Megan C.,14,0,15,1
1683325578566,DOC 100D,A00,259140,Pass; Natalye Joann,16,0,25,9
1683325579593,DSGN 1,A01,184749,Rill; Bryan,0,26,30,30
1683325580617,DSGN 100,A01,185168,Staff,0,2,25,25
1683325581644,ECE 5,A01,185626,Morris; Karcher William,0,10,0,0
1683325582670,ECE 101,A01,185628,Staff,17,0,70,53
1683325583697,ECE 107,A01,185635,Baghdadchi; Saharnaz,0,0,20,20
1683325583697,ECE 107,A02,185638,Baghdadchi; Saharnaz,4,0,20,16
1683325584722,ECE 148,A01,185647,Silberman; Jack,0,0,16,16
1683325585750,ECON 1,A01,185537,Crane; Meredith Helen,54,0,70,16
1683325586778,ECON 3,A01,185549,Crane; Meredith Helen,33,0,70,37
1683325587807,ECON 4,A01,203354,Anderson; John Charles,0,4,10,10
1683325588832,ECON 100A,A01,185574,Staff,0,4,40,40
1683325589860,ECON 100B,A01,185576,Staff,0,22,40,40
1683325590884,ECON 100C,A01,185589,Newhouse; Herbert S,30,0,70,40
1683325591908,ECON 105,A00,185608,Vespa; Emanuel Ignacio,19,0,35,16
1683325592932,ECON 109,A01,185610,Shishkin; Denis,10,0,35,25
1683325593962,ECON 110A,A01,185612,Staff,11,0,40,29
1683325594987,ECON 120A,A01,185615,Staff,20,0,40,20
1683325596012,ECON 120C,A01,185617,Sun; Yixiao,0,20,70,70
1683325597036,ECON 144,A00,203346,Squires; Dale E,3,0,35,32
1683325598059,ECON 171,A01,203349,Newhouse; Herbert S,0,1,35,35
1683325599086,ECON 173A,A01,185621,Toda; Alexis Akira,21,0,35,14
1683325600112,EDS 25,A01,202413,Staff,0,1,0,0
1683325600112,EDS 25,A02,202414,Staff,0,1,0,0
1683325600112,EDS 25,A03,202415,Staff,0,0,0,0
1683325600112,EDS 25,A04,202416,Staff,0,1,0,0
1683325600112,EDS 25,A05,202439,Staff,0,0,0,0
1683325600112,EDS 25,A06,202440,Staff,0,0,0,0
1683325600112,EDS 25,B01,202631,Staff,0,0,0,0
1683325600112,EDS 25,B02,202632,Staff,0,0,0,0
1683325600112,EDS 25,B03,202639,Staff,0,0,0,0
1683325600112,EDS 25,B04,202640,Staff,0,0,0,0
1683325600112,EDS 25,B05,202643,Staff,0,0,0,0
1683325600112,EDS 25,B06,202644,Staff,0,0,0,0
1683325601139,EDS 38,A01,202659,Black; Alison Michelle,24,0,25,1
1683325602165,EDS 115,A00,202652,Staff,17,0,30,13
1683325603187,EDS 125,A00,202649,Staff,14,0,30,16
1683325604214,EDS 126,A01,203332,Staff,30,0,30,0
1683325605236,EDS 139,A00,202838,Staff,16,0,25,9
1683325606263,EDS 146,A01,202655,Staff,14,0,25,11
1683325607289,ENG 15,A00,185667,Staff,0,1,0,0
1683325607289,ENG 15,B00,185672,Staff,0,0,0,0
1683325607289,ENG 15,C00,185675,Staff,0,0,0,0
1683325607289,ENG 15,D00,185682,Staff,0,0,0,0
1683325607289,ENG 15,E00,185684,Staff,0,0,0,0
1683325608314,ETHN 103,A00,185710,Staff,0,3,35,35
1683325609340,ETHN 103A,A00,199228,Man; Simeon S,2,0,9,7
1683325610366,ETHN 109,A00,185711,Staff,18,0,35,17
1683325611389,ETHN 142,A00,185726,Staff,0,4,30,30
1683325612412,ETHN 163J,A00,199229,Man; Simeon S,5,0,8,3
1683325613436,ETHN 168,A00,185727,Staff,8,0,10,2
1683325614518,ETHN 182,A00,185728,Staff,1,0,35,34
1683325615545,ETHN 183,A00,185737,Staff,8,0,18,10
1683325616571,GLBH 111,A01,209361,Burgos; Jose L.,0,0,0,0
1683325618623,HIEU 104,A00,185792,Staff,16,0,20,4
1683325619647,HIEU 115,A00,185800,Staff,1,0,20,19
1683325620669,HIEU 128,A00,185801,Staff,0,7,20,20
1683325621695,HIEU 147,A00,185802,Staff,16,0,20,4
1683325622726,HIEU 154,A00,185823,Staff,12,0,20,8
1683325623757,HILA 102,A00,185826,Staff,13,0,20,7
1683325624781,HILD 2C,A01,185778,Staff,0,12,20,20
1683325625809,HILD 7B,A01,185780,Kwak; Nancy,0,15,32,32
1683325625809,HILD 7B,A02,185781,Kwak; Nancy,0,18,32,32
1683325626835,HILD 30,A01,185791,Staff,14,0,20,6
1683325627862,HISC 119,A00,185830,Golan; Tal,0,9,20,20
1683325628887,HITO 156GS,A00,185831,Patterson; Patrick H.,0,0,0,23
1683325629910,HIUS 103,A00,185832,Man; Simeon S,0,6,20,20
1683325630934,HIUS 117,A00,185836,Kwak; Nancy,2,0,20,18
1683325631960,HIUS 125,A00,185840,Man; Simeon S,0,0,23,23
1683325632983,HIUS 149,A00,185845,Staff,0,0,20,20
1683325634010,HUM 3,A01,185882,Zavodny; Tatiana Sophia,0,7,50,50
1683325634010,HUM 3,B01,185899,Caldwell; Michael Alan,0,18,50,50
1683325635037,HUM 3GS,A00,185900,Patterson; Patrick H.,0,0,0,23
1683325636066,HUM 4,A01,185938,Zroka; Amy Liane,31,0,50,19
1683325636066,HUM 4,B01,185956,Watkins; Eric,0,2,50,50
1683325636066,HUM 4,B02,202209,Watkins; Eric,0,2,50,50
1683325636066,HUM 4,B03,202210,Watkins; Eric,0,2,50,50
1683325637090,HUM 5,A01,185958,West; Geoffrey Scott,3,0,50,47
1683325637090,HUM 5,A02,202215,West; Geoffrey Scott,0,0,50,50
1683325638114,INTL 190,A00,185959,Gagnon; Jeffrey C,0,0,0,9
1683325638114,INTL 190,B00,185960,Lettieri; Michael Joseph,0,0,0,1
1683325639138,JAPN 180,A00,254509,Staff,5,1,30,25
1683325640162,LATI 10,A01,202853,Kennemore; Amy Michelle,4,0,35,31
1683325640162,LATI 10,A02,202854,Kennemore; Amy Michelle,2,0,35,33
1683325640162,LATI 10,A03,270054,Kennemore; Amy Michelle,30,0,30,0
1683325641186,LATI 180,A00,202855,Kennemore; Amy Michelle,11,0,20,9
1683325642210,LAWS 101,A00,201767,Golan; Tal,0,7,40,40
1683325643236,LIFR 1C,A00,185961,Staff,6,0,20,14
1683325644260,LIFR 1CX,A00,185962,Staff,7,0,20,13
1683325645284,LIFR 1D,A00,185963,Staff,9,0,20,11
1683325646308,LIFR 1DX,A00,185964,Staff,9,0,20,11
1683325647334,LIGN 101,A01,186039,Staff,43,0,50,7
1683325648359,LIGN 165,A00,186040,Staff,18,0,50,32
1683325649385,LTCS 108,A00,186041,Staff,6,0,10,4
1683325650411,LTCS 119,A00,186042,Staff,16,0,20,4
1683325651437,LTCS 130,A00,186043,Wesling; Megan E.,15,0,25,10
1683325653484,LTEA 138,A00,186119,Staff,14,0,40,26
1683325654510,LTEN 124,A00,186148,Staff,6,0,25,19
1683325655535,LTEN 178,A00,186149,Staff,7,0,15,8
1683325656562,LTEN 181,A00,186150,Blanco; John D,33,0,40,7
1683325657588,LTWL 120,A00,186160,Staff,20,0,25,5
1683325658615,LTWL 165,A00,186161,Staff,22,0,25,3
1683325659641,LTWR 100,A00,186162,Staff,0,5,15,15
1683325660667,LTWR 102,A00,186163,Doller; Ben,5,0,15,10
1683325661691,MAE 8,A01,186412,Staff,0,0,0,0
1683325662718,MAE 30B,A00,186445,Bahadori; Mohammad Yousef,83,0,100,17
1683325663745,MAE 40,A00,186592,Bewley; Thomas R,9,0,50,41
1683325664769,MAE 101B,A00,186593,Bahadori; Mohammad Yousef,81,0,100,19
1683325665793,MAE 105,A00,186594,Bandaru; Prabhakar,12,0,50,38
1683325666820,MAE 107,A00,186599,Pham; Hieu Tan,0,6,120,120
1683325667846,MAE 148,A01,186660,Silberman; Jack,3,0,16,13
1683325668869,MATH 10A,A01,188095,Staff,1,6,35,34
1683325669898,MATH 10B,A01,188097,Bowers; Adam R.,0,11,30,30
1683325669898,MATH 10B,A02,188099,Bowers; Adam R.,0,11,30,30
1683325669898,MATH 10B,B01,188104,Bowers; Adam R.,0,10,30,30
1683325669898,MATH 10B,B02,188106,Bowers; Adam R.,0,10,30,30
1683325670922,MATH 10C,A01,188111,Staff,0,18,30,30
1683325670922,MATH 10C,A02,188127,Staff,0,17,30,30
1683325670922,MATH 10C,A03,188131,Staff,0,18,30,30
1683325670922,MATH 10C,B01,188218,Staff,18,0,30,12
1683325670922,MATH 10C,B02,188244,Staff,13,0,30,17
1683325670922,MATH 10C,B03,188277,Staff,16,0,30,14
1683325671947,MATH 18,A01,188344,Bach; Quang Tran,18,0,30,12
1683325671947,MATH 18,A02,188345,Bach; Quang Tran,11,0,30,19
1683325671947,MATH 18,B01,188353,Bach; Quang Tran,10,0,30,20
1683325671947,MATH 18,B02,188354,Bach; Quang Tran,20,0,30,10
1683325672970,MATH 20A,A01,188374,Staff,13,0,35,22
1683325673995,MATH 20B,A01,188382,Ohm; Ko Woon,6,0,30,24
1683325673995,MATH 20B,A02,188383,Ohm; Ko Woon,22,0,30,8
1683325673995,MATH 20B,B01,188385,Ohm; Ko Woon,7,0,30,23
1683325673995,MATH 20B,B02,188392,Ohm; Ko Woon,22,0,30,8
1683325675023,MATH 20C,A01,188394,Harel; Guershon,10,0,30,20
1683325675023,MATH 20C,A02,188395,Harel; Guershon,14,0,30,16
1683325675023,MATH 20C,B01,188404,Harel; Guershon,5,0,30,25
1683325675023,MATH 20C,B02,188405,Harel; Guershon,19,0,30,11
1683325676048,MATH 20D,A01,188414,Hammock; Frances H,0,1,30,30
1683325676048,MATH 20D,A02,188415,Hammock; Frances H,3,0,30,27
1683325676048,MATH 20D,B01,188447,Hammock; Frances H,2,0,30,28
1683325676048,MATH 20D,B02,188486,Hammock; Frances H,8,0,30,22
1683325677071,MATH 20E,A01,188649,Staff,21,0,30,9
1683325677071,MATH 20E,A02,188650,Staff,23,0,30,7
1683325677071,MATH 20E,A03,188673,Staff,0,0,30,30
1683325678107,MATH 102,A01,188675,Staff,0,35,35,35
1683325679132,MATH 103B,A01,188681,Staff,4,0,35,31
1683325679132,MATH 103B,B01,188692,Staff,5,0,35,30
1683325680155,MATH 109,A01,188695,Salehi Golsefidy; Alireza,25,0,35,10
1683325680155,MATH 109,A02,188696,Salehi Golsefidy; Alireza,26,0,35,9
1683325681178,MATH 120A,A01,188698,Eggers; John Dietrich,7,0,35,28
1683325682203,MATH 142B,A01,188736,Ioana; Adrian,0,2,30,30
1683325682203,MATH 142B,A02,188741,Ioana; Adrian,0,1,30,30
1683325682203,MATH 142B,A03,188743,Ioana; Adrian,1,3,30,29
1683325683227,MATH 168A,A01,188790,Staff,0,9,35,35
1683325684258,MATH 170A,A01,188803,Nie; Jiawang,0,2,35,35
1683325684258,MATH 170A,A02,188811,Nie; Jiawang,0,0,35,35
1683325684258,MATH 170A,A03,188814,Nie; Jiawang,1,0,35,34
1683325684258,MATH 170A,A04,188815,Nie; Jiawang,13,0,35,22
1683325685284,MATH 193B,A01,188817,Staff,0,0,35,35
1683325685284,MATH 193B,A02,188818,Staff,5,0,35,30
1683325686308,MGT 4,A01,202857,Anderson; John Charles,62,0,80,18
1683325687332,MGT 12,A00,202858,Lindenberger; Wade Douglas,42,0,90,48
1683325688359,MGT 18,A00,202859,Staff,74,0,90,16
1683325689383,MGT 18GS,A00,202860,McKay; Michael J,13,0,28,15
1683325690405,MGT 45,A00,202861,Pecore; Joseph P.,13,0,90,77
1683325691429,MGT 100,A00,202863,Yavorsky; Daniel Ryan,28,0,90,62
1683325692453,MGT 103,A00,202864,Ehrich; Kristine R,0,18,90,90
1683325693481,MGT 112,A00,202865,Ehrich; Kristine R,15,0,90,75
1683325694506,MGT 121A,A00,202868,Staff,0,20,0,0
1683325695546,MGT 131B,A00,202869,Anderson; John Charles,59,0,90,31
1683325696570,MGT 136,A00,202871,Lindenberger; Wade Douglas,84,0,90,6
1683325697594,MGT 164,A00,202873,Staff,0,68,90,91
1683325698617,MGT 164GS,A00,202874,McKay; Mary A,13,0,28,15
1683325699644,MGT 180,A00,202875,Staff,0,50,90,91
1683325700671,MMW 11R,A01,205019,Herbst; Matthew,3,0,30,27
1683325700671,MMW 11R,A02,205026,Herbst; Matthew,29,0,30,1
1683325701696,MMW 15,A01,193512,Chang; Edmond Yi-Teh,0,9,28,28
1683325701696,MMW 15,A02,193513,Chang; Edmond Yi-Teh,0,5,28,28
1683325701696,MMW 15,A03,193514,Chang; Edmond Yi-Teh,0,5,28,28
1683325701696,MMW 15,A04,193515,Chang; Edmond Yi-Teh,0,5,28,28
1683325701696,MMW 15,A05,193516,Chang; Edmond Yi-Teh,0,4,28,28
1683325701696,MMW 15,A06,193517,Chang; Edmond Yi-Teh,0,5,28,28
1683325701696,MMW 15,B01,193519,Chang; Edmond Yi-Teh,0,5,28,28
1683325701696,MMW 15,B02,193520,Chang; Edmond Yi-Teh,0,5,28,28
1683325701696,MMW 15,B03,193521,Chang; Edmond Yi-Teh,0,5,28,28
1683325701696,MMW 15,B04,193522,Chang; Edmond Yi-Teh,0,4,28,28
1683325701696,MMW 15,B05,193523,Chang; Edmond Yi-Teh,0,5,28,28
1683325701696,MMW 15,B06,193524,Chang; Edmond Yi-Teh,0,4,28,28
1683325702723,MMW 122,A01,193526,Rahimi; Babak,0,15,28,28
1683325702723,MMW 122,A02,193527,Rahimi; Babak,0,14,28,28
1683325702723,MMW 122,A03,193528,Rahimi; Babak,0,0,0,0
1683325702723,MMW 122,A04,193529,Rahimi; Babak,0,0,0,0
1683325703747,MUS 1A,A01,186663,Staff,0,20,35,35
1683325704774,MUS 4,A01,186715,Staff,0,12,35,35
1683325705802,MUS 5R,A01,186796,Dubnov; Shlomo,0,17,35,35
1683325706829,MUS 6,A01,186798,Staff,0,4,25,25
1683325707852,MUS 7,A01,186830,Staff,12,0,35,23
1683325708880,MUS 8,A01,186930,Staff,0,27,35,35
1683325709907,MUS 15,A01,186932,Staff,0,16,35,35
1683325709907,MUS 15,B01,186934,Staff,0,15,35,35
1683325710932,MUS 80,A00,186935,Staff,1,0,20,19
1683325710932,MUS 80,B00,186936,Staff,25,0,25,0
1683325711960,NANO 11,A00,204702,Lipomi; Darren John,0,0,0,0
1683325712985,NANO 15,A01,204709,Yang; Kesong,0,1,0,0
1683325714011,NANO 114,A00,202069,Jahed Motlagh; Zeinab,3,0,10,7
1683325715035,PHIL 1,A00,186955,Grush; Rick Scott,32,0,40,8
1683325716061,PHIL 10,A01,186973,Grush; Rick Scott,28,0,35,7
1683325716061,PHIL 10,A02,186974,Grush; Rick Scott,33,0,35,2
1683325717083,PHIL 13,A01,186976,Staff,7,0,35,28
1683325717083,PHIL 13,A02,186977,Staff,16,0,35,19
1683325718167,PHIL 14,A01,186979,Staff,31,0,35,4
1683325718167,PHIL 14,A02,186986,Staff,32,0,35,3
1683325719195,PHIL 28,A01,186988,Staff,16,0,30,14
1683325719195,PHIL 28,A02,186989,Staff,1,0,30,29
1683325719195,PHIL 28,A03,186990,Staff,9,0,30,21
1683325719195,PHIL 28,A04,186991,Staff,26,0,30,4
1683325720218,PHIL 120,A00,186997,Staff,23,0,40,17
1683325721243,PHIL 137,A00,187003,Staff,9,0,40,31
1683325722271,PHIL 150,A00,187015,Staff,47,0,70,23
1683325723298,PHIL 167,A00,187021,Lamey; Andy M.,35,0,40,5
1683325724322,PHIL 174,A01,202226,Staff,17,0,20,3
1683325724322,PHIL 174,A02,202235,Staff,20,0,20,0
1683325725346,PHIL 191A,A00,258918,Staff,0,0,1,1
1683325726369,PHYS 1A,A00,187028,Staff,27,0,60,33
1683325727397,PHYS 1AL,001,187036,Staff,3,0,30,27
1683325727397,PHYS 1AL,002,187049,Staff,18,0,30,12
1683325728420,PHYS 1B,A00,187058,Staff,22,0,60,38
1683325729446,PHYS 1BL,001,187064,Staff,0,0,30,30
1683325729446,PHYS 1BL,002,187070,Staff,5,0,30,25
1683325730472,PHYS 1C,A00,187082,Staff,31,0,120,89
1683325731498,PHYS 1CL,001,187088,Staff,0,9,30,30
1683325731498,PHYS 1CL,002,187089,Staff,0,2,30,30
1683325731498,PHYS 1CL,009,262693,Staff,11,0,30,19
1683325732521,PHYS 2B,A01,187097,Staff,54,0,115,61
1683325733549,PHYS 2C,A01,187099,Staff,67,0,115,48
1683325734574,PHYS 2CL,A01,187101,Staff,5,0,28,23
1683325734574,PHYS 2CL,A02,187102,Staff,15,0,28,13
1683325735598,PHYS 2D,A01,187123,Shotwell; Brian,95,0,115,20
1683325736627,PHYS 4B,A01,187133,Grinstein; Benjamin,35,0,50,15
1683325737650,POLI 10,A00,188819,Staff,0,4,50,50
1683325738677,POLI 11,A00,188827,Staff,43,0,50,7
1683325739699,POLI 13R,A00,188828,Staff,0,1,20,20
1683325740722,POLI 27,A01,188830,Elgin; Samuel Zincke,0,1,70,70
1683325741747,POLI 30,A00,188832,Desposato; Scott,31,0,50,19
1683325742770,POLI 102F,A00,188834,Staff,3,0,40,37
1683325743797,POLI 104A,A00,188852,Staff,14,0,30,16
1683325744819,POLI 104I,A00,188853,Staff,0,6,20,20
1683325745844,POLI 110B,A00,188854,Wiens; David,7,0,20,13
1683325746871,POLI 112A,A00,188855,Wiens; David,5,0,30,25
1683325747895,POLI 117R,A00,188856,Forman; Fonna,0,11,20,20
1683325748919,POLI 118,A00,188857,Ingham; Sean,8,0,20,12
1683325749946,POLI 120G,A00,188858,Staff,9,0,30,21
1683325750970,POLI 131CR,A00,188863,Hoston; Germaine,24,0,50,26
1683325751994,POLI 133,A00,188864,Nellis; Gareth Hb,44,0,50,6
1683325753018,POLI 134D,A00,188865,Desposato; Scott,27,0,30,3
1683325754046,POLI 142A,A00,188871,Gartzke; Erik,22,0,50,28
1683325755073,POLI 142K,A00,188874,Staff,38,0,50,12
1683325756097,POLI 143,A00,188940,Gartzke; Erik,16,0,30,14
1683325757124,POLI 153,A00,188943,Staff,3,0,20,17
1683325758148,POLI 160AA,A00,188944,Staff,12,0,40,28
1683325759174,POLI 170A,A00,188945,Staff,11,0,30,19
1683325761223,PSYC 1,A00,188952,Staff,37,0,90,53
1683325762246,PSYC 2,B00,188953,Staff,19,0,35,16
1683325763274,PSYC 6,A00,188970,Staff,47,0,60,13
1683325764297,PSYC 7,A00,188973,Staff,37,0,45,8
1683325765322,PSYC 60,A01,188980,Rickard; Timothy C.,43,0,60,17
1683325766350,PSYC 70,A01,189001,Steiner; Eric Tomas,24,0,45,21
1683325767378,PSYC 100,A00,189005,Lacefield; Katharine I,0,100,120,120
1683325768403,PSYC 102,A00,189008,Staff,9,0,30,21
1683325769427,PSYC 106,B00,189026,Gorman; Michael R.,34,0,60,26
1683325770454,PSYC 114,B01,189033,Winkielman; Piotr,0,32,30,30
1683325771478,PSYC 131,A00,189036,Anagnostaras; Stephan,0,43,60,60
1683325772504,PSYC 136,A00,189041,Lowe; Angela Beth,0,7,25,25
1683325773528,PSYC 137,A00,189057,Winkielman; Piotr,0,34,25,25
1683325774554,PSYC 144,A00,189107,Wixted; John T,0,7,50,50
1683325776599,PSYC 162,A00,189142,Staff,0,8,85,85
1683325777622,PSYC 172,A00,189144,Gorman; Michael R.,0,7,30,30
1683325779672,PSYC 179,A00,189146,Lacefield; Katharine I,0,84,120,120
1683325780694,PSYC 181,A00,189147,Anagnostaras; Stephan,0,44,90,90
1683325781716,PSYC 190R,A00,189148,Barner; David A.,0,22,80,80
1683325782738,PSYC 191,A00,189275,Rickard; Timothy C.,0,7,25,25
1683325783760,PSYC 193,A00,189276,Chapman; Eddie Nathaniel,0,1,0,4
1683325784787,PSYC 193L,A01,189281,Lowe; Angela Beth,12,0,20,8
1683325784787,PSYC 193L,B01,189285,Staff,28,0,35,7
1683325785810,RELI 149,A00,187137,Rahimi; Babak,7,0,40,33
1683325786835,SE 9,A01,187315,Staff,0,2,18,18
1683325787858,SE 101B,A00,187409,Staff,24,0,30,6
1683325788882,SE 110B,A00,187444,Staff,10,0,40,30
1683325789905,SE 130B,A00,187449,Staff,31,0,40,9
1683325790928,SE 150A,A00,187516,Staff,9,0,20,11
1683325791952,SE 154,A00,187528,Staff,30,0,50,20
1683325792978,SIO 3,A01,258171,Staff,35,0,40,5
1683325794002,SIO 10,A00,187144,Cook; Geoffrey W,0,3,75,75
1683325795028,SIO 45,A00,187152,Cook; Geoffrey W,1,0,100,99
1683325796051,SIO 109R,A00,194486,Staff,0,3,20,20
1683325798101,SIO 187,A01,187233,Kacev; David,12,0,40,28
1683325799128,SOCI 1,A01,258656,Thorpe; Charles Robert,28,0,30,2
1683325799128,SOCI 1,A02,258658,Thorpe; Charles Robert,30,0,30,0
1683325799128,SOCI 1,A03,258661,Thorpe; Charles Robert,25,0,25,0
1683325799128,SOCI 1,A04,258666,Thorpe; Charles Robert,22,0,25,3
1683325799128,SOCI 1,A05,258897,Thorpe; Charles Robert,23,0,25,2
1683325799128,SOCI 1,A06,258898,Thorpe; Charles Robert,25,0,25,0
1683325800151,SOCI 30,A01,258903,Pardo Guerra; Juan Pablo,15,0,30,15
1683325801179,SOCI 102,A00,258904,Staff,9,0,25,16
1683325802206,SOCI 106,A00,258905,Staff,19,0,25,6
1683325803234,SOCI 111,A00,258907,Ribas Norris; Janet Vanesa,26,0,30,4
1683325804259,SOCI 121R,A00,258908,Pardo Guerra; Juan Pablo,10,0,30,20
1683325805284,SOCI 126,A01,203330,Staff,14,0,20,6
1683325806311,SOCI 131,A00,258909,Thorpe; Charles Robert,31,0,60,29
1683325807334,SOCI 135,A00,258910,Payne; Christine Anna,0,9,30,30
1683325808362,SOCI 157,A00,258911,Staff,12,0,30,18
1683325809385,SOCI 184,A00,258912,Staff,25,0,30,5
1683325810413,SOCI 188D,A00,258913,Staff,21,0,30,9
1683325811436,SYN 2,001,187529,Staff,9,0,16,7
1683325811436,SYN 2,002,201452,Staff,0,18,16,16
1683325811436,SYN 2,003,201469,Staff,4,0,16,12
1683325812463,SYN 100,A01,187531,Staff,0,9,20,20
1683325812463,SYN 100,B01,201491,Staff,0,12,20,20
1683325813487,TDAC 1,A00,189286,Walsh; Kim C.,3,0,20,17
1683325813487,TDAC 1,B00,189287,Harting; Carla Kelso,11,0,20,9
1683325814511,TDAC 101,A00,189300,Walsh; Kim C.,16,0,20,4
1683325814511,TDAC 101,B00,189301,Harting; Carla Kelso,18,0,20,2
1683325815539,TDAC 102,A00,189304,Basso; Beatrice,14,0,20,6
1683325816563,TDAC 108,A00,189305,Staff,18,0,20,2
1683325817589,TDDE 131,A00,189310,Staff,19,0,20,1
1683325817589,TDDE 131,B00,189314,Staff,19,0,20,1
1683325817589,TDDE 131,C00,189315,Staff,48,0,50,2
1683325817589,TDDE 131,D00,189316,Staff,14,0,15,1
1683325817589,TDDE 131,E00,204841,Staff,20,0,20,0
1683325818615,TDGE 10,A00,189289,Staff,30,0,50,20
1683325818615,TDGE 10,B00,189290,Havis; Allan,1,0,50,49
1683325819638,TDGE 11,A00,189291,Fulton; Julia,0,3,50,50
1683325819638,TDGE 11,B00,189292,Staff,20,0,25,5
1683325819638,TDGE 11,C00,260270,Staff,0,0,0,0
1683325820665,TDGE 25,A00,189294,Staff,3,0,20,17
1683325821742,TDGE 124,A00,189318,Fulton; Julia,0,8,50,50
1683325822769,TDGE 125,A00,189319,Staff,13,0,25,12
1683325822769,TDGE 125,B00,189320,Staff,23,0,25,2
1683325823794,TDGE 127,A00,189322,Havis; Allan,0,0,50,50
1683325824823,TDHT 101,A00,189323,Staff,18,0,25,7
1683325824823,TDHT 101,B00,189324,Staff,25,0,25,0
1683325825847,TDHT 102,A00,189325,Staff,49,0,50,1
1683325826874,TDMV 1,A00,189295,Arcidiacono; Kristin,19,0,30,11
1683325826874,TDMV 1,B00,189296,Caligagan; Maria T.,24,0,30,6
1683325827902,TDMV 2,A00,189297,Sammartano; Tonnie,28,0,30,2
1683325827902,TDMV 2,B00,189299,Arcidiacono; Kristin,24,0,30,6
1683325828925,TDMV 3,A00,204998,Rincon; Alicia,22,0,30,8
1683325829951,TDMV 120,A00,189458,Sammartano; Tonnie,28,0,30,2
1683325830973,TDMV 138,A00,189541,Jun; Grace Shin Hae,22,0,40,18
1683325831997,TDMV 142,A00,189717,Caligagan; Tony,23,0,30,7
1683325831997,TDMV 142,B00,189718,Caligagan; Maria T.,25,0,30,5
1683325833025,TMC 2,A01,187533,Staff,25,0,25,0
1683325833025,TMC 2,A02,187534,Staff,25,0,25,0
1683325834052,USP 1,A01,187536,Kwak; Nancy,0,16,25,25
1683325835076,USP 5,A01,187538,Staff,10,0,25,15
1683325836108,USP 101,A00,199253,Staff,0,4,0,0
1683325837132,USP 124,A00,187562,Boomhower; Matthew Charles,1,0,30,29
1683325838156,USP 138,A00,187582,Staff,20,0,25,5
1683325839182,USP 152,A01,187597,Staff,4,0,25,21
1683325840209,USP 153,A00,187598,Staff,19,0,25,6
1683325841233,USP 168,A00,187607,Kwak; Nancy,2,0,5,3
1683325842261,USP 173,A00,187619,Staff,4,0,25,21
1683325843287,USP 181,A00,187638,Staff,0,0,25,25
1683325844313,VIS 103,A00,187650,Cruz; Edwin Teddy,23,0,75,52
1683325845337,VIS 110D,A00,187669,Staff,12,0,22,10
1683325846363,VIS 127C,A00,187720,Shen; Kuiyi,67,0,146,79
1683325847390,VIS 149,A00,187731,Yoldas; Pinar,0,14,22,22
1683325848418,VIS 151,A01,188091,Staff,22,0,34,12
1683325848418,VIS 151,A02,188092,Staff,11,0,34,23
1683325849442,VIS 160B,A00,188093,Stalbaum; Brett,0,0,10,10
1683325851489,WCWP 10B,A00,201720,Staff,10,0,15,5
1683325851489,WCWP 10B,B00,201722,Staff,8,0,15,7
1683325852513,WCWP 100,A00,201725,Gagnon; Jeffrey C,0,0,2,2
1683325852513,WCWP 100,B00,201727,Staff,0,4,15,15
1683325855607,ANBI 133,A00,258401,Wilder; Linnea Lorene,34,0,40,6
1683325856631,ANBI 140,A00,258395,Hrvoj Mihic; Branka,18,0,25,7
1683325857659,ANSC 120,A00,258402,Bialecki; Jon Anthony,27,0,40,13
1683325858685,ANSC 144,A00,258400,Staff,14,0,40,26
1683325860734,ANSC 166,A00,258396,Parish; Steven Martin,157,0,175,18
1683325861759,ANSC 180,A00,193533,Staff,9,0,20,11
1683325862784,ANSC 188,A00,258397,Jassal; Aftab,33,0,40,7
1683325863812,ANTH 3,A01,258316,Staff,23,0,30,7
1683325864839,ANTH 5,A00,258394,Semendeferi; Ekaterini,16,0,20,4
1683325865868,ANTH 21,A01,258331,Staff,8,0,40,32
1683325866897,ANTH 103,A00,258398,Varma; Saiba,15,0,25,10
1683325867924,AWP 10,001,202034,Staff,0,0,0,0
1683325867924,AWP 10,002,202035,Staff,0,0,0,0
1683325867924,AWP 10,003,202036,Staff,0,0,0,0
1683325867924,AWP 10,004,202037,Staff,0,0,0,0
1683325867924,AWP 10,005,202038,Staff,0,0,0,0
1683325867924,AWP 10,006,202039,Staff,0,0,0,0
1683325867924,AWP 10,007,202040,Staff,0,0,0,0
1683325867924,AWP 10,008,202041,Staff,0,0,0,0
1683325867924,AWP 10,009,202042,Staff,0,0,0,0
1683325867924,AWP 10,010,202043,Staff,0,0,0,0
1683325867924,AWP 10,011,202044,Staff,0,0,0,0
1683325867924,AWP 10,012,202045,Staff,0,0,0,0
1683325867924,AWP 10,013,202046,Staff,0,0,0,0
1683325867924,AWP 10,014,202047,Staff,0,0,0,0
1683325867924,AWP 10,015,202048,Staff,0,0,0,0
1683325867924,AWP 10,016,202049,Staff,0,0,0,0
1683325867924,AWP 10,017,202050,Staff,0,0,0,0
1683325867924,AWP 10,018,202051,Staff,0,0,0,0
1683325867924,AWP 10,019,202052,Staff,0,0,0,0
1683325867924,AWP 10,020,202053,Staff,0,0,0,0
1683325867924,AWP 10,021,202054,Staff,0,0,0,0
1683325867924,AWP 10,022,202055,Staff,0,0,0,0
1683325867924,AWP 10,023,202056,Staff,0,0,0,0
1683325867924,AWP 10,024,202057,Staff,0,0,0,0
1683325867924,AWP 10,025,202058,Staff,0,0,0,0
1683325867924,AWP 10,026,202059,Staff,0,0,0,0
1683325868948,AWP 102,001,202032,Staff,0,0,0,0
1683325868948,AWP 102,002,202033,Staff,0,0,0,0
1683325869977,BENG 100,A01,254234,Taylor Amos; Alyssa C,31,0,40,9
1683325871000,BENG 196,001,270013,Engler; Adam J.,9999,0,9999,0
1683325872026,BICD 100R,A01,202018,Smith; Laurie,0,7,32,32
1683325872026,BICD 100R,A02,202019,Smith; Laurie,0,2,32,32
1683325872026,BICD 100R,A03,202020,Smith; Laurie,0,1,32,32
1683325872026,BICD 100R,A04,202021,Smith; Laurie,9,0,32,23
1683325872026,BICD 100R,A05,202022,Smith; Laurie,12,0,32,20
1683325873055,BICD 136,A01,193242,Gustafson-Brown; Cindy,0,2,32,32
1683325873055,BICD 136,A02,193244,Gustafson-Brown; Cindy,14,0,32,18
1683325874085,BIEB 102,A01,193249,Butler; Shannon Rhey,0,2,32,32
1683325874085,BIEB 102,A02,193251,Butler; Shannon Rhey,0,0,32,32
1683325874085,BIEB 102,A03,193253,Butler; Shannon Rhey,0,1,32,32
1683325874085,BIEB 102,A04,193255,Butler; Shannon Rhey,17,0,32,15
1683325874085,BIEB 102,A05,193265,Butler; Shannon Rhey,26,0,32,6
1683325874085,BIEB 102,A06,193269,Butler; Shannon Rhey,16,0,32,16
1683325876135,BIEB 150,A01,193274,Staff,0,0,32,32
1683325876135,BIEB 150,A02,193285,Staff,23,0,32,9
1683325877159,BIEB 194,A00,193286,Kurle; Carolyn M.,22,0,32,10
1683325878185,BILD 1,A01,192291,Staff,16,0,32,16
1683325878185,BILD 1,A02,192292,Staff,30,0,32,2
1683325878185,BILD 1,B01,192520,Reuther; Keefe,0,1,0,0
1683325878185,BILD 1,B02,192532,Reuther; Keefe,0,1,0,0
1683325879214,BILD 3,A01,192556,Butler; Shannon Rhey,0,0,32,32
1683325879214,BILD 3,A02,192581,Butler; Shannon Rhey,5,0,32,27
1683325879214,BILD 3,A03,192611,Butler; Shannon Rhey,23,0,32,9
1683325879214,BILD 3,A04,192612,Butler; Shannon Rhey,25,0,32,7
1683325879214,BILD 3,A05,192613,Butler; Shannon Rhey,27,0,32,5
1683325879214,BILD 3,A06,192679,Butler; Shannon Rhey,27,0,32,5
1683325879214,BILD 3,A07,192682,Butler; Shannon Rhey,22,0,32,10
1683325880244,BILD 4,A01,192836,Reuther; Keefe,0,0,24,24
1683325880244,BILD 4,A02,193044,Reuther; Keefe,4,0,24,20
1683325881280,BILD 10,A01,193142,Gustafson-Brown; Cindy,30,0,32,2
1683325881280,BILD 10,A02,193149,Gustafson-Brown; Cindy,31,0,32,1
1683325882306,BIMM 100,A01,193301,Staff,0,6,32,32
1683325882306,BIMM 100,A02,193312,Staff,0,5,32,32
1683325882306,BIMM 100,A03,193323,Staff,0,8,32,32
1683325883336,BIMM 101,A01,193329,McDonnell; Lisa Marie,0,3,24,24
1683325883336,BIMM 101,A02,193339,McDonnell; Lisa Marie,0,3,24,24
1683325883336,BIMM 101,B01,193354,McDonnell; Lisa Marie,0,3,24,24
1683325883336,BIMM 101,B02,193357,McDonnell; Lisa Marie,0,3,24,24
1683325884365,BIMM 110,A01,193377,Tat; John,0,11,32,32
1683325884365,BIMM 110,A02,193378,Tat; John,1,9,32,31
1683325885389,BIMM 120,A01,206116,Staff,0,0,32,32
1683325885389,BIMM 120,A02,206117,Staff,8,0,32,24
1683325885389,BIMM 120,A03,206121,Staff,21,0,32,11
1683325886413,BIPN 100,A01,193393,Park; Ji Young,0,14,32,32
1683325886413,BIPN 100,A02,193402,Park; Ji Young,0,13,32,32
1683325886413,BIPN 100,A03,193413,Park; Ji Young,0,14,32,32
1683325886413,BIPN 100,A04,193414,Park; Ji Young,0,13,32,32
1683325887440,BIPN 102,A01,193429,Staff,0,0,32,32
1683325887440,BIPN 102,A02,193438,Staff,22,0,32,10
1683325888469,BIPN 106,A01,193450,Reyes Gonzalez; Catalina,0,2,40,40
1683325889493,BIPN 134,A01,193465,Cooke; James Edward,0,0,32,32
1683325889493,BIPN 134,A02,193474,Cooke; James Edward,25,0,32,7
1683325889493,BIPN 134,A03,193485,Cooke; James Edward,29,0,32,3
1683325889493,BIPN 134,A04,193486,Cooke; James Edward,21,0,32,11
1683325889493,BIPN 134,A05,193491,Cooke; James Edward,31,0,32,1
1683325889493,BIPN 134,A06,193501,Cooke; James Edward,30,0,32,2
1683325889493,BIPN 134,A07,193510,Cooke; James Edward,29,0,32,3
1683325891547,BISP 194,A00,222522,Staff,14,0,32,18
1683325892570,CAT 124,A01,202407,Staff,20,0,25,5
1683325893594,CAT 125,A00,202408,Marchisotto; Jennifer Anne,4,0,20,16
1683325894620,CAT 125R,A00,202409,Smith; Lauryn Alissa,0,11,20,20
1683325894620,CAT 125R,B00,202410,Morales; Celeste Georgianna,0,11,20,20
1683325894620,CAT 125R,C00,202411,Irwin; Matthew Joseph,0,10,20,20
1683325895649,CENG 15,A01,204712,Yang; Kesong,0,1,0,0
1683325896675,CENG 114,A00,202070,Jahed Motlagh; Zeinab,5,0,20,15
1683325897701,CGS 105,A00,185477,Wesling; Megan E.,24,0,40,16
1683325898726,CGS 106,A00,185494,Staff,13,0,22,9
1683325899749,CGS 108,A00,185495,Staff,14,0,20,6
1683325900773,CGS 114,A00,185496,Staff,13,0,18,5
1683325901797,CGS 119,A00,185501,Staff,15,0,20,5
1683325902824,CGS 120,A00,185511,Staff,13,0,20,7
1683325903848,CHEM 4,A01,184675,Bussey; Thomas J,96,0,100,4
1683325904873,CHEM 6A,A01,184677,Staff,35,0,60,25
1683325905896,CHEM 6B,A01,184679,Staff,65,0,100,35
1683325906920,CHEM 6C,A01,184681,Bussey; Thomas J,1,0,50,49
1683325906920,CHEM 6C,A02,184682,Bussey; Thomas J,34,0,50,16
1683325907947,CHEM 40A,A01,184684,Albizati; Kim F.,37,0,100,63
1683325908970,CHEM 40B,A01,184686,Albizati; Kim F.,0,20,100,100
1683325909994,CHEM 41B,A01,184690,Staff,52,0,100,48
1683325911017,COGS 3,A01,184715,Boyle; Mary E. T.,0,25,40,40
1683325912042,COGS 14B,A01,185172,Staff,0,15,38,38
1683325913068,COGS 18,A01,184736,Staff,17,0,80,63
1683325914094,COGS 100,A01,184932,Staff,0,5,73,73
1683325915120,COGS 101A,A01,184935,Staff,0,38,30,30
1683325916146,COGS 101B,A01,184944,Staff,0,2,30,30
1683325917173,COGS 101C,A01,184946,Staff,0,12,30,30
1683325918195,COGS 102A,A01,184951,Johnson; Christine M.,2,0,40,38
1683325919222,COGS 107B,A01,184953,Mooshagian; Eric Frederick,0,50,40,40
1683325920247,COGS 118B,A01,184959,Gupta; Anjum,0,48,40,40
1683325921272,COGS 153,A00,184961,Staff,0,15,30,30
1683325922296,COGS 177,A00,184962,Staff,0,20,30,30
1683325923324,COGS 187A,A01,184969,Boyle; Mary E. T.,0,17,40,40
1683325924350,COMM 10,A01,185174,Staff,0,5,25,25
1683325924350,COMM 10,A02,185189,Staff,0,5,25,25
1683325924350,COMM 10,A03,269821,Staff,0,0,0,0
1683325925429,COMM 100B,A01,185475,Staff,0,0,0,2
1683325925429,COMM 100B,A02,185476,Staff,14,0,25,11
1683325926453,COMM 100C,A01,185314,Staff,1,0,25,24
1683325926453,COMM 100C,A02,185327,Staff,19,0,25,6
1683325927480,COMM 110M,A00,185349,Staff,2,0,40,38
1683325928504,COMM 113T,A00,185352,Staff,25,0,40,15
1683325929528,COMM 114I,A00,185353,Staff,33,0,40,7
1683325930552,COMM 131,A00,185354,Staff,19,0,30,11
1683325931581,CSE 8A,A50,185358,Cao; Yingjun,0,46,10,10
1683325932607,CSE 8B,A01,185362,Staff,1,47,50,49
1683325933631,CSE 11,A01,185416,Cao; Yingjun,0,92,10,10
1683325934656,CSE 20,A01,185445,Briones; Jor-el Thomas Caparas,5,0,25,20
1683325935680,CSE 21,A01,185447,Staff,10,0,50,40
1683325936708,CSE 101,A01,185451,Staff,0,12,50,50
1683325936708,CSE 101,B01,185453,Jones; Miles E,0,11,50,50
1683325938762,CSE 141,A01,185458,Eldon; John,20,0,100,80
1683325939791,CSE 141L,A01,185461,Eldon; John,12,0,100,88
1683325940820,CSE 142,A01,185463,Staff,36,0,60,24
1683325940820,CSE 142,B01,201355,Staff,0,7,60,60
1683325941845,CSE 142L,A01,185470,Staff,36,0,60,24
1683325941845,CSE 142L,B01,201417,Staff,0,6,60,60
1683325942868,CSE 190,A00,201433,Staff,32,0,49,17
1683325943898,DOC 1,A01,259136,Strom; Megan C.,7,0,15,8
1683325943898,DOC 1,A02,259137,Strom; Megan C.,14,0,15,1
1683325943898,DOC 1,A03,259138,Strom; Megan C.,14,0,15,1
1683325943898,DOC 1,A04,259139,Strom; Megan C.,14,0,15,1
1683325944925,DOC 100D,A00,259140,Pass; Natalye Joann,16,0,25,9
1683325945948,DSGN 1,A01,184749,Rill; Bryan,0,26,30,30
1683325946975,DSGN 100,A01,185168,Staff,0,2,25,25
1683325948003,ECE 5,A01,185626,Morris; Karcher William,0,10,0,0
1683325949030,ECE 101,A01,185628,Staff,17,0,70,53
1683325950059,ECE 107,A01,185635,Baghdadchi; Saharnaz,0,0,20,20
1683325950059,ECE 107,A02,185638,Baghdadchi; Saharnaz,4,0,20,16
1683325951084,ECE 148,A01,185647,Silberman; Jack,0,0,16,16
1683325952114,ECON 1,A01,185537,Crane; Meredith Helen,54,0,70,16
1683325953144,ECON 3,A01,185549,Crane; Meredith Helen,33,0,70,37
1683325954171,ECON 4,A01,203354,Anderson; John Charles,0,4,10,10
1683325955200,ECON 100A,A01,185574,Staff,0,4,40,40
1683325956229,ECON 100B,A01,185576,Staff,0,22,40,40
1683325957256,ECON 100C,A01,185589,Newhouse; Herbert S,30,0,70,40
1683325958285,ECON 105,A00,185608,Vespa; Emanuel Ignacio,19,0,35,16
1683325959312,ECON 109,A01,185610,Shishkin; Denis,10,0,35,25
1683325960339,ECON 110A,A01,185612,Staff,11,0,40,29
1683325961364,ECON 120A,A01,185615,Staff,20,0,40,20
1683325962392,ECON 120C,A01,185617,Sun; Yixiao,0,20,70,70
1683325963420,ECON 144,A00,203346,Squires; Dale E,3,0,35,32
1683325964446,ECON 171,A01,203349,Newhouse; Herbert S,0,1,35,35
1683325965471,ECON 173A,A01,185621,Toda; Alexis Akira,21,0,35,14
1683325966503,EDS 25,A01,202413,Staff,0,1,0,0
1683325966503,EDS 25,A02,202414,Staff,0,1,0,0
1683325966503,EDS 25,A03,202415,Staff,0,0,0,0
1683325966503,EDS 25,A04,202416,Staff,0,1,0,0
1683325966503,EDS 25,A05,202439,Staff,0,0,0,0
1683325966503,EDS 25,A06,202440,Staff,0,0,0,0
1683325966503,EDS 25,B01,202631,Staff,0,0,0,0
1683325966503,EDS 25,B02,202632,Staff,0,0,0,0
1683325966503,EDS 25,B03,202639,Staff,0,0,0,0
1683325966503,EDS 25,B04,202640,Staff,0,0,0,0
1683325966503,EDS 25,B05,202643,Staff,0,0,0,0
1683325966503,EDS 25,B06,202644,Staff,0,0,0,0
1683325967527,EDS 38,A01,202659,Black; Alison Michelle,24,0,25,1
1683325968555,EDS 115,A00,202652,Staff,17,0,30,13
1683325969581,EDS 125,A00,202649,Staff,14,0,30,16
1683325970606,EDS 126,A01,203332,Staff,30,0,30,0
1683325971633,EDS 139,A00,202838,Staff,16,0,25,9
1683325972657,EDS 146,A01,202655,Staff,14,0,25,11
1683325973683,ENG 15,A00,185667,Staff,0,1,0,0
1683325973683,ENG 15,B00,185672,Staff,0,0,0,0
1683325973683,ENG 15,C00,185675,Staff,0,0,0,0
1683325973683,ENG 15,D00,185682,Staff,0,0,0,0
1683325973683,ENG 15,E00,185684,Staff,0,0,0,0
1683325974707,ETHN 103,A00,185710,Staff,0,3,35,35
1683325975733,ETHN 103A,A00,199228,Man; Simeon S,2,0,9,7
1683325976761,ETHN 109,A00,185711,Staff,18,0,35,17
1683325977790,ETHN 142,A00,185726,Staff,0,4,30,30
1683325978816,ETHN 163J,A00,199229,Man; Simeon S,5,0,8,3
1683325979841,ETHN 168,A00,185727,Staff,8,0,10,2
1683325980866,ETHN 182,A00,185728,Staff,1,0,35,34
1683325981890,ETHN 183,A00,185737,Staff,8,0,18,10
1683325982914,GLBH 111,A01,209361,Burgos; Jose L.,0,0,0,0
1683325984963,HIEU 104,A00,185792,Staff,16,0,20,4
1683325985991,HIEU 115,A00,185800,Staff,1,0,20,19
1683325987016,HIEU 128,A00,185801,Staff,0,7,20,20
1683325988043,HIEU 147,A00,185802,Staff,16,0,20,4
1683325989066,HIEU 154,A00,185823,Staff,12,0,20,8
1683325990090,HILA 102,A00,185826,Staff,13,0,20,7
1683325991114,HILD 2C,A01,185778,Staff,0,12,20,20
1683325992141,HILD 7B,A01,185780,Kwak; Nancy,0,15,32,32
1683325992141,HILD 7B,A02,185781,Kwak; Nancy,0,18,32,32
1683325993167,HILD 30,A01,185791,Staff,14,0,20,6
1683325994191,HISC 119,A00,185830,Golan; Tal,0,9,20,20
1683325995215,HITO 156GS,A00,185831,Patterson; Patrick H.,0,0,0,23
1683325996239,HIUS 103,A00,185832,Man; Simeon S,0,6,20,20
1683325997266,HIUS 117,A00,185836,Kwak; Nancy,2,0,20,18
1683325998293,HIUS 125,A00,185840,Man; Simeon S,0,0,23,23
1683325999317,HIUS 149,A00,185845,Staff,0,0,20,20
1683326000345,HUM 3,A01,185882,Zavodny; Tatiana Sophia,0,7,50,50
1683326000345,HUM 3,B01,185899,Caldwell; Michael Alan,0,18,50,50
1683326001369,HUM 3GS,A00,185900,Patterson; Patrick H.,0,0,0,23
1683326002394,HUM 4,A01,185938,Zroka; Amy Liane,31,0,50,19
1683326002394,HUM 4,B01,185956,Watkins; Eric,0,2,50,50
1683326002394,HUM 4,B02,202209,Watkins; Eric,0,2,50,50
1683326002394,HUM 4,B03,202210,Watkins; Eric,0,2,50,50
1683326003419,HUM 5,A01,185958,West; Geoffrey Scott,3,0,50,47
1683326003419,HUM 5,A02,202215,West; Geoffrey Scott,0,0,50,50
1683326004443,INTL 190,A00,185959,Gagnon; Jeffrey C,0,0,0,9
1683326004443,INTL 190,B00,185960,Lettieri; Michael Joseph,0,0,0,1
1683326005467,JAPN 180,A00,254509,Staff,5,1,30,25
1683326006491,LATI 10,A01,202853,Kennemore; Amy Michelle,4,0,35,31
1683326006491,LATI 10,A02,202854,Kennemore; Amy Michelle,2,0,35,33
1683326006491,LATI 10,A03,270054,Kennemore; Amy Michelle,30,0,30,0
1683326007515,LATI 180,A00,202855,Kennemore; Amy Michelle,11,0,20,9
1683326008538,LAWS 101,A00,201767,Golan; Tal,0,7,40,40
1683326009561,LIFR 1C,A00,185961,Staff,6,0,20,14
1683326010584,LIFR 1CX,A00,185962,Staff,7,0,20,13
1683326011608,LIFR 1D,A00,185963,Staff,9,0,20,11
1683326012635,LIFR 1DX,A00,185964,Staff,9,0,20,11
1683326013658,LIGN 101,A01,186039,Staff,43,0,50,7
1683326014684,LIGN 165,A00,186040,Staff,18,0,50,32
1683326015708,LTCS 108,A00,186041,Staff,6,0,10,4
1683326016733,LTCS 119,A00,186042,Staff,16,0,20,4
1683326017757,LTCS 130,A00,186043,Wesling; Megan E.,15,0,25,10
1683326019807,LTEA 138,A00,186119,Staff,14,0,40,26
1683326020832,LTEN 124,A00,186148,Staff,6,0,25,19
1683326021859,LTEN 178,A00,186149,Staff,7,0,15,8
1683326022884,LTEN 181,A00,186150,Blanco; John D,33,0,40,7
1683326023908,LTWL 120,A00,186160,Staff,20,0,25,5
1683326024935,LTWL 165,A00,186161,Staff,22,0,25,3
1683326025958,LTWR 100,A00,186162,Staff,0,5,15,15
1683326026982,LTWR 102,A00,186163,Doller; Ben,5,0,15,10
1683326028007,MAE 8,A01,186412,Staff,0,0,0,0
1683326029104,MAE 30B,A00,186445,Bahadori; Mohammad Yousef,83,0,100,17
1683326030131,MAE 40,A00,186592,Bewley; Thomas R,9,0,50,41
1683326031155,MAE 101B,A00,186593,Bahadori; Mohammad Yousef,81,0,100,19
1683326032179,MAE 105,A00,186594,Bandaru; Prabhakar,12,0,50,38
1683326033206,MAE 107,A00,186599,Pham; Hieu Tan,0,6,120,120
1683326034230,MAE 148,A01,186660,Silberman; Jack,3,0,16,13
1683326035254,MATH 10A,A01,188095,Staff,1,6,35,34
1683326036279,MATH 10B,A01,188097,Bowers; Adam R.,0,11,30,30
1683326036279,MATH 10B,A02,188099,Bowers; Adam R.,0,11,30,30
1683326036279,MATH 10B,B01,188104,Bowers; Adam R.,0,10,30,30
1683326036279,MATH 10B,B02,188106,Bowers; Adam R.,0,10,30,30
1683326037303,MATH 10C,A01,188111,Staff,0,18,30,30
1683326037303,MATH 10C,A02,188127,Staff,0,17,30,30
1683326037303,MATH 10C,A03,188131,Staff,0,18,30,30
1683326037303,MATH 10C,B01,188218,Staff,18,0,30,12
1683326037303,MATH 10C,B02,188244,Staff,13,0,30,17
1683326037303,MATH 10C,B03,188277,Staff,16,0,30,14
1683326038331,MATH 18,A01,188344,Bach; Quang Tran,18,0,30,12
1683326038331,MATH 18,A02,188345,Bach; Quang Tran,11,0,30,19
1683326038331,MATH 18,B01,188353,Bach; Quang Tran,10,0,30,20
1683326038331,MATH 18,B02,188354,Bach; Quang Tran,20,0,30,10
1683326039355,MATH 20A,A01,188374,Staff,13,0,35,22
1683326040379,MATH 20B,A01,188382,Ohm; Ko Woon,6,0,30,24
1683326040379,MATH 20B,A02,188383,Ohm; Ko Woon,22,0,30,8
1683326040379,MATH 20B,B01,188385,Ohm; Ko Woon,7,0,30,23
1683326040379,MATH 20B,B02,188392,Ohm; Ko Woon,22,0,30,8
1683326041405,MATH 20C,A01,188394,Harel; Guershon,10,0,30,20
1683326041405,MATH 20C,A02,188395,Harel; Guershon,14,0,30,16
1683326041405,MATH 20C,B01,188404,Harel; Guershon,5,0,30,25
1683326041405,MATH 20C,B02,188405,Harel; Guershon,19,0,30,11
1683326042428,MATH 20D,A01,188414,Hammock; Frances H,0,1,30,30
1683326042428,MATH 20D,A02,188415,Hammock; Frances H,3,0,30,27
1683326042428,MATH 20D,B01,188447,Hammock; Frances H,2,0,30,28
1683326042428,MATH 20D,B02,188486,Hammock; Frances H,8,0,30,22
1683326043457,MATH 20E,A01,188649,Staff,21,0,30,9
1683326043457,MATH 20E,A02,188650,Staff,23,0,30,7
1683326043457,MATH 20E,A03,188673,Staff,0,0,30,30
1683326044480,MATH 102,A01,188675,Staff,0,35,35,35
1683326045504,MATH 103B,A01,188681,Staff,4,0,35,31
1683326045504,MATH 103B,B01,188692,Staff,5,0,35,30
1683326046532,MATH 109,A01,188695,Salehi Golsefidy; Alireza,25,0,35,10
1683326046532,MATH 109,A02,188696,Salehi Golsefidy; Alireza,26,0,35,9
1683326047557,MATH 120A,A01,188698,Eggers; John Dietrich,7,0,35,28
1683326048580,MATH 142B,A01,188736,Ioana; Adrian,0,2,30,30
1683326048580,MATH 142B,A02,188741,Ioana; Adrian,0,1,30,30
1683326048580,MATH 142B,A03,188743,Ioana; Adrian,1,3,30,29
1683326049609,MATH 168A,A01,188790,Staff,0,9,35,35
1683326050633,MATH 170A,A01,188803,Nie; Jiawang,0,2,35,35
1683326050633,MATH 170A,A02,188811,Nie; Jiawang,0,0,35,35
1683326050633,MATH 170A,A03,188814,Nie; Jiawang,1,0,35,34
1683326050633,MATH 170A,A04,188815,Nie; Jiawang,13,0,35,22
1683326051661,MATH 193B,A01,188817,Staff,0,0,35,35
1683326051661,MATH 193B,A02,188818,Staff,5,0,35,30
1683326052686,MGT 4,A01,202857,Anderson; John Charles,62,0,80,18
1683326053711,MGT 12,A00,202858,Lindenberger; Wade Douglas,42,0,90,48
1683326054735,MGT 18,A00,202859,Staff,74,0,90,16
1683326055761,MGT 18GS,A00,202860,McKay; Michael J,13,0,28,15
1683326056784,MGT 45,A00,202861,Pecore; Joseph P.,13,0,90,77
1683326057812,MGT 100,A00,202863,Yavorsky; Daniel Ryan,28,0,90,62
1683326058836,MGT 103,A00,202864,Ehrich; Kristine R,0,18,90,90
1683326059859,MGT 112,A00,202865,Ehrich; Kristine R,15,0,90,75
1683326060882,MGT 121A,A00,202868,Staff,0,20,0,0
1683326061909,MGT 131B,A00,202869,Anderson; John Charles,59,0,90,31
1683326062933,MGT 136,A00,202871,Lindenberger; Wade Douglas,84,0,90,6
1683326063960,MGT 164,A00,202873,Staff,0,68,90,91
1683326064985,MGT 164GS,A00,202874,McKay; Mary A,13,0,28,15
1683326066011,MGT 180,A00,202875,Staff,0,50,90,91
1683326067035,MMW 11R,A01,205019,Herbst; Matthew,3,0,30,27
1683326067035,MMW 11R,A02,205026,Herbst; Matthew,29,0,30,1
1683326068062,MMW 15,A01,193512,Chang; Edmond Yi-Teh,0,9,28,28
1683326068062,MMW 15,A02,193513,Chang; Edmond Yi-Teh,0,5,28,28
1683326068062,MMW 15,A03,193514,Chang; Edmond Yi-Teh,0,5,28,28
1683326068062,MMW 15,A04,193515,Chang; Edmond Yi-Teh,0,5,28,28
1683326068062,MMW 15,A05,193516,Chang; Edmond Yi-Teh,0,4,28,28
1683326068062,MMW 15,A06,193517,Chang; Edmond Yi-Teh,0,5,28,28
1683326068062,MMW 15,B01,193519,Chang; Edmond Yi-Teh,0,5,28,28
1683326068062,MMW 15,B02,193520,Chang; Edmond Yi-Teh,0,5,28,28
1683326068062,MMW 15,B03,193521,Chang; Edmond Yi-Teh,0,5,28,28
1683326068062,MMW 15,B04,193522,Chang; Edmond Yi-Teh,0,4,28,28
1683326068062,MMW 15,B05,193523,Chang; Edmond Yi-Teh,0,5,28,28
1683326068062,MMW 15,B06,193524,Chang; Edmond Yi-Teh,0,4,28,28
1683326069090,MMW 122,A01,193526,Rahimi; Babak,0,15,28,28
1683326069090,MMW 122,A02,193527,Rahimi; Babak,0,14,28,28
1683326069090,MMW 122,A03,193528,Rahimi; Babak,0,0,0,0
1683326069090,MMW 122,A04,193529,Rahimi; Babak,0,0,0,0
1683326070118,MUS 1A,A01,186663,Staff,0,20,35,35
1683326071141,MUS 4,A01,186715,Staff,0,12,35,35
1683326072168,MUS 5R,A01,186796,Dubnov; Shlomo,0,17,35,35
1683326073195,MUS 6,A01,186798,Staff,0,4,25,25
1683326074218,MUS 7,A01,186830,Staff,12,0,35,23
1683326075241,MUS 8,A01,186930,Staff,0,27,35,35
1683326076265,MUS 15,A01,186932,Staff,0,16,35,35
1683326076265,MUS 15,B01,186934,Staff,0,15,35,35
1683326077290,MUS 80,A00,186935,Staff,1,0,20,19
1683326077290,MUS 80,B00,186936,Staff,25,0,25,0
1683326078317,NANO 11,A00,204702,Lipomi; Darren John,0,0,0,0
1683326079345,NANO 15,A01,204709,Yang; Kesong,0,1,0,0
1683326080368,NANO 114,A00,202069,Jahed Motlagh; Zeinab,3,0,10,7
1683326081393,PHIL 1,A00,186955,Grush; Rick Scott,32,0,40,8
1683326082416,PHIL 10,A01,186973,Grush; Rick Scott,28,0,35,7
1683326082416,PHIL 10,A02,186974,Grush; Rick Scott,33,0,35,2
1683326083439,PHIL 13,A01,186976,Staff,7,0,35,28
1683326083439,PHIL 13,A02,186977,Staff,16,0,35,19
1683326084463,PHIL 14,A01,186979,Staff,31,0,35,4
1683326084463,PHIL 14,A02,186986,Staff,32,0,35,3
1683326085487,PHIL 28,A01,186988,Staff,16,0,30,14
1683326085487,PHIL 28,A02,186989,Staff,1,0,30,29
1683326085487,PHIL 28,A03,186990,Staff,9,0,30,21
1683326085487,PHIL 28,A04,186991,Staff,26,0,30,4
1683326086512,PHIL 120,A00,186997,Staff,23,0,40,17
1683326087536,PHIL 137,A00,187003,Staff,9,0,40,31
1683326088564,PHIL 150,A00,187015,Staff,47,0,70,23
1683326089588,PHIL 167,A00,187021,Lamey; Andy M.,35,0,40,5
1683326090615,PHIL 174,A01,202226,Staff,17,0,20,3
1683326090615,PHIL 174,A02,202235,Staff,20,0,20,0
1683326091642,PHIL 191A,A00,258918,Staff,0,0,1,1
1683326092669,PHYS 1A,A00,187028,Staff,27,0,60,33
1683326093693,PHYS 1AL,001,187036,Staff,3,0,30,27
1683326093693,PHYS 1AL,002,187049,Staff,18,0,30,12
1683326094717,PHYS 1B,A00,187058,Staff,22,0,60,38
1683326095742,PHYS 1BL,001,187064,Staff,0,0,30,30
1683326095742,PHYS 1BL,002,187070,Staff,5,0,30,25
1683326096766,PHYS 1C,A00,187082,Staff,31,0,120,89
1683326097799,PHYS 1CL,001,187088,Staff,0,9,30,30
1683326097799,PHYS 1CL,002,187089,Staff,0,2,30,30
1683326097799,PHYS 1CL,009,262693,Staff,11,0,30,19
1683326098825,PHYS 2B,A01,187097,Staff,54,0,115,61
1683326099850,PHYS 2C,A01,187099,Staff,67,0,115,48
1683326100874,PHYS 2CL,A01,187101,Staff,5,0,28,23
1683326100874,PHYS 2CL,A02,187102,Staff,15,0,28,13
1683326101898,PHYS 2D,A01,187123,Shotwell; Brian,95,0,115,20
1683326102922,PHYS 4B,A01,187133,Grinstein; Benjamin,35,0,50,15
1683326103949,POLI 10,A00,188819,Staff,0,4,50,50
1683326104978,POLI 11,A00,188827,Staff,43,0,50,7
1683326106001,POLI 13R,A00,188828,Staff,0,1,20,20
1683326107025,POLI 27,A01,188830,Elgin; Samuel Zincke,0,1,70,70
1683326108049,POLI 30,A00,188832,Desposato; Scott,31,0,50,19
1683326109076,POLI 102F,A00,188834,Staff,3,0,40,37
1683326110098,POLI 104A,A00,188852,Staff,14,0,30,16
1683326111122,POLI 104I,A00,188853,Staff,0,6,20,20
1683326112145,POLI 110B,A00,188854,Wiens; David,7,0,20,13
1683326113169,POLI 112A,A00,188855,Wiens; David,5,0,30,25
1683326114198,POLI 117R,A00,188856,Forman; Fonna,0,11,20,20
1683326115224,POLI 118,A00,188857,Ingham; Sean,8,0,20,12
1683326116248,POLI 120G,A00,188858,Staff,9,0,30,21
1683326117275,POLI 131CR,A00,188863,Hoston; Germaine,24,0,50,26
1683326118299,POLI 133,A00,188864,Nellis; Gareth Hb,44,0,50,6
1683326119323,POLI 134D,A00,188865,Desposato; Scott,27,0,30,3
1683326120350,POLI 142A,A00,188871,Gartzke; Erik,22,0,50,28
1683326121373,POLI 142K,A00,188874,Staff,38,0,50,12
1683326122400,POLI 143,A00,188940,Gartzke; Erik,16,0,30,14
1683326123428,POLI 153,A00,188943,Staff,3,0,20,17
1683326124452,POLI 160AA,A00,188944,Staff,12,0,40,28
1683326125476,POLI 170A,A00,188945,Staff,11,0,30,19
1683326127524,PSYC 1,A00,188952,Staff,37,0,90,53
1683326128551,PSYC 2,B00,188953,Staff,19,0,35,16
1683326129577,PSYC 6,A00,188970,Staff,47,0,60,13
1683326130602,PSYC 7,A00,188973,Staff,37,0,45,8
1683326131625,PSYC 60,A01,188980,Rickard; Timothy C.,43,0,60,17
1683326132706,PSYC 70,A01,189001,Steiner; Eric Tomas,24,0,45,21
1683326133735,PSYC 100,A00,189005,Lacefield; Katharine I,0,100,120,120
1683326134759,PSYC 102,A00,189008,Staff,9,0,30,21
1683326135788,PSYC 106,B00,189026,Gorman; Michael R.,34,0,60,26
1683326136813,PSYC 114,B01,189033,Winkielman; Piotr,0,32,30,30
1683326137836,PSYC 131,A00,189036,Anagnostaras; Stephan,0,43,60,60
1683326138861,PSYC 136,A00,189041,Lowe; Angela Beth,0,7,25,25
1683326139883,PSYC 137,A00,189057,Winkielman; Piotr,0,34,25,25
1683326140908,PSYC 144,A00,189107,Wixted; John T,0,7,50,50
1683326142957,PSYC 162,A00,189142,Staff,0,8,85,85
1683326143981,PSYC 172,A00,189144,Gorman; Michael R.,0,7,30,30
1683326146029,PSYC 179,A00,189146,Lacefield; Katharine I,0,84,120,120
1683326147053,PSYC 181,A00,189147,Anagnostaras; Stephan,0,44,90,90
1683326148077,PSYC 190R,A00,189148,Barner; David A.,0,22,80,80
1683326149100,PSYC 191,A00,189275,Rickard; Timothy C.,0,7,25,25
1683326150123,PSYC 193,A00,189276,Chapman; Eddie Nathaniel,0,1,0,4
1683326151151,PSYC 193L,A01,189281,Lowe; Angela Beth,12,0,20,8
1683326151151,PSYC 193L,B01,189285,Staff,28,0,35,7
1683326152178,RELI 149,A00,187137,Rahimi; Babak,7,0,40,33
1683326153204,SE 9,A01,187315,Staff,0,2,18,18
1683326154228,SE 101B,A00,187409,Staff,24,0,30,6
1683326155252,SE 110B,A00,187444,Staff,10,0,40,30
1683326156276,SE 130B,A00,187449,Staff,31,0,40,9
1683326157303,SE 150A,A00,187516,Staff,9,0,20,11
1683326158328,SE 154,A00,187528,Staff,30,0,50,20
1683326159357,SIO 3,A01,258171,Staff,35,0,40,5
1683326160384,SIO 10,A00,187144,Cook; Geoffrey W,0,3,75,75
1683326161411,SIO 45,A00,187152,Cook; Geoffrey W,1,0,100,99
1683326162434,SIO 109R,A00,194486,Staff,0,3,20,20
1683326164492,SIO 187,A01,187233,Kacev; David,12,0,40,28
1683326165520,SOCI 1,A01,258656,Thorpe; Charles Robert,28,0,30,2
1683326165520,SOCI 1,A02,258658,Thorpe; Charles Robert,30,0,30,0
1683326165520,SOCI 1,A03,258661,Thorpe; Charles Robert,25,0,25,0
1683326165520,SOCI 1,A04,258666,Thorpe; Charles Robert,22,0,25,3
1683326165520,SOCI 1,A05,258897,Thorpe; Charles Robert,23,0,25,2
1683326165520,SOCI 1,A06,258898,Thorpe; Charles Robert,25,0,25,0
1683326166548,SOCI 30,A01,258903,Pardo Guerra; Juan Pablo,15,0,30,15
1683326167574,SOCI 102,A00,258904,Staff,9,0,25,16
1683326168599,SOCI 106,A00,258905,Staff,19,0,25,6
1683326169627,SOCI 111,A00,258907,Ribas Norris; Janet Vanesa,26,0,30,4
1683326170652,SOCI 121R,A00,258908,Pardo Guerra; Juan Pablo,10,0,30,20
1683326171681,SOCI 126,A01,203330,Staff,14,0,20,6
1683326172709,SOCI 131,A00,258909,Thorpe; Charles Robert,31,0,60,29
1683326173736,SOCI 135,A00,258910,Payne; Christine Anna,0,9,30,30
1683326174762,SOCI 157,A00,258911,Staff,12,0,30,18
1683326175789,SOCI 184,A00,258912,Staff,25,0,30,5
1683326176812,SOCI 188D,A00,258913,Staff,21,0,30,9
1683326177836,SYN 2,001,187529,Staff,9,0,16,7
1683326177836,SYN 2,002,201452,Staff,0,18,16,16
1683326177836,SYN 2,003,201469,Staff,4,0,16,12
1683326178861,SYN 100,A01,187531,Staff,0,9,20,20
1683326178861,SYN 100,B01,201491,Staff,0,12,20,20
1683326179886,TDAC 1,A00,189286,Walsh; Kim C.,3,0,20,17
1683326179886,TDAC 1,B00,189287,Harting; Carla Kelso,11,0,20,9
1683326180910,TDAC 101,A00,189300,Walsh; Kim C.,16,0,20,4
1683326180910,TDAC 101,B00,189301,Harting; Carla Kelso,18,0,20,2
1683326181935,TDAC 102,A00,189304,Basso; Beatrice,14,0,20,6
1683326182959,TDAC 108,A00,189305,Staff,18,0,20,2
1683326183985,TDDE 131,A00,189310,Staff,19,0,20,1
1683326183985,TDDE 131,B00,189314,Staff,19,0,20,1
1683326183985,TDDE 131,C00,189315,Staff,48,0,50,2
1683326183985,TDDE 131,D00,189316,Staff,14,0,15,1
1683326183985,TDDE 131,E00,204841,Staff,20,0,20,0
1683326185009,TDGE 10,A00,189289,Staff,30,0,50,20
1683326185009,TDGE 10,B00,189290,Havis; Allan,1,0,50,49
1683326186037,TDGE 11,A00,189291,Fulton; Julia,0,3,50,50
1683326186037,TDGE 11,B00,189292,Staff,20,0,25,5
1683326186037,TDGE 11,C00,260270,Staff,0,0,0,0
1683326187067,TDGE 25,A00,189294,Staff,3,0,20,17
1683326188097,TDGE 124,A00,189318,Fulton; Julia,0,8,50,50
1683326189124,TDGE 125,A00,189319,Staff,13,0,25,12
1683326189124,TDGE 125,B00,189320,Staff,23,0,25,2
1683326190150,TDGE 127,A00,189322,Havis; Allan,0,0,50,50
1683326191173,TDHT 101,A00,189323,Staff,18,0,25,7
1683326191173,TDHT 101,B00,189324,Staff,25,0,25,0
1683326192195,TDHT 102,A00,189325,Staff,49,0,50,1
1683326193223,TDMV 1,A00,189295,Arcidiacono; Kristin,19,0,30,11
1683326193223,TDMV 1,B00,189296,Caligagan; Maria T.,24,0,30,6
1683326194246,TDMV 2,A00,189297,Sammartano; Tonnie,28,0,30,2
1683326194246,TDMV 2,B00,189299,Arcidiacono; Kristin,24,0,30,6
1683326195270,TDMV 3,A00,204998,Rincon; Alicia,22,0,30,8
1683326196297,TDMV 120,A00,189458,Sammartano; Tonnie,28,0,30,2
1683326197321,TDMV 138,A00,189541,Jun; Grace Shin Hae,22,0,40,18
1683326198346,TDMV 142,A00,189717,Caligagan; Tony,23,0,30,7
1683326198346,TDMV 142,B00,189718,Caligagan; Maria T.,25,0,30,5
1683326199372,TMC 2,A01,187533,Staff,25,0,25,0
1683326199372,TMC 2,A02,187534,Staff,25,0,25,0
1683326200395,USP 1,A01,187536,Kwak; Nancy,0,16,25,25
1683326201422,USP 5,A01,187538,Staff,10,0,25,15
1683326202445,USP 101,A00,199253,Staff,0,4,0,0
1683326203469,USP 124,A00,187562,Boomhower; Matthew Charles,1,0,30,29
1683326204493,USP 138,A00,187582,Staff,20,0,25,5
1683326205520,USP 152,A01,187597,Staff,4,0,25,21
1683326206547,USP 153,A00,187598,Staff,19,0,25,6
1683326207573,USP 168,A00,187607,Kwak; Nancy,2,0,5,3
1683326208597,USP 173,A00,187619,Staff,4,0,25,21
1683326209623,USP 181,A00,187638,Staff,0,0,25,25
1683326210647,VIS 103,A00,187650,Cruz; Edwin Teddy,23,0,75,52
1683326211671,VIS 110D,A00,187669,Staff,12,0,22,10
1683326212695,VIS 127C,A00,187720,Shen; Kuiyi,67,0,146,79
1683326213721,VIS 149,A00,187731,Yoldas; Pinar,0,14,22,22
1683326214747,VIS 151,A01,188091,Staff,22,0,34,12
1683326214747,VIS 151,A02,188092,Staff,11,0,34,23
1683326215774,VIS 160B,A00,188093,Stalbaum; Brett,0,0,10,10
1683326217825,WCWP 10B,A00,201720,Staff,10,0,15,5
1683326217825,WCWP 10B,B00,201722,Staff,8,0,15,7
1683326218850,WCWP 100,A00,201725,Gagnon; Jeffrey C,0,0,2,2
1683326218850,WCWP 100,B00,201727,Staff,0,4,15,15
1683326221973,ANBI 133,A00,258401,Wilder; Linnea Lorene,34,0,40,6
1683326222997,ANBI 140,A00,258395,Hrvoj Mihic; Branka,18,0,25,7
1683326224021,ANSC 120,A00,258402,Bialecki; Jon Anthony,27,0,40,13
1683326225047,ANSC 144,A00,258400,Staff,14,0,40,26
1683326227098,ANSC 166,A00,258396,Parish; Steven Martin,157,0,175,18
1683326228122,ANSC 180,A00,193533,Staff,9,0,20,11
1683326229146,ANSC 188,A00,258397,Jassal; Aftab,33,0,40,7
1683326230174,ANTH 3,A01,258316,Staff,23,0,30,7
1683326231199,ANTH 5,A00,258394,Semendeferi; Ekaterini,16,0,20,4
1683326232222,ANTH 21,A01,258331,Staff,8,0,40,32
1683326233246,ANTH 103,A00,258398,Varma; Saiba,15,0,25,10
1683326234273,AWP 10,001,202034,Staff,0,0,0,0
1683326234273,AWP 10,002,202035,Staff,0,0,0,0
1683326234273,AWP 10,003,202036,Staff,0,0,0,0
1683326234273,AWP 10,004,202037,Staff,0,0,0,0
1683326234273,AWP 10,005,202038,Staff,0,0,0,0
1683326234273,AWP 10,006,202039,Staff,0,0,0,0
1683326234273,AWP 10,007,202040,Staff,0,0,0,0
1683326234273,AWP 10,008,202041,Staff,0,0,0,0
1683326234273,AWP 10,009,202042,Staff,0,0,0,0
1683326234273,AWP 10,010,202043,Staff,0,0,0,0
1683326234273,AWP 10,011,202044,Staff,0,0,0,0
1683326234273,AWP 10,012,202045,Staff,0,0,0,0
1683326234273,AWP 10,013,202046,Staff,0,0,0,0
1683326234273,AWP 10,014,202047,Staff,0,0,0,0
1683326234273,AWP 10,015,202048,Staff,0,0,0,0
1683326234273,AWP 10,016,202049,Staff,0,0,0,0
1683326234273,AWP 10,017,202050,Staff,0,0,0,0
1683326234273,AWP 10,018,202051,Staff,0,0,0,0
1683326234273,AWP 10,019,202052,Staff,0,0,0,0
1683326234273,AWP 10,020,202053,Staff,0,0,0,0
1683326234273,AWP 10,021,202054,Staff,0,0,0,0
1683326234273,AWP 10,022,202055,Staff,0,0,0,0
1683326234273,AWP 10,023,202056,Staff,0,0,0,0
1683326234273,AWP 10,024,202057,Staff,0,0,0,0
1683326234273,AWP 10,025,202058,Staff,0,0,0,0
1683326234273,AWP 10,026,202059,Staff,0,0,0,0
1683326235298,AWP 102,001,202032,Staff,0,0,0,0
1683326235298,AWP 102,002,202033,Staff,0,0,0,0
1683326236385,BENG 100,A01,254234,Taylor Amos; Alyssa C,31,0,40,9
1683326237413,BENG 196,001,270013,Engler; Adam J.,9999,0,9999,0
1683326238439,BICD 100R,A01,202018,Smith; Laurie,0,7,32,32
1683326238439,BICD 100R,A02,202019,Smith; Laurie,0,2,32,32
1683326238439,BICD 100R,A03,202020,Smith; Laurie,0,1,32,32
1683326238439,BICD 100R,A04,202021,Smith; Laurie,9,0,32,23
1683326238439,BICD 100R,A05,202022,Smith; Laurie,12,0,32,20
1683326239465,BICD 136,A01,193242,Gustafson-Brown; Cindy,0,2,32,32
1683326239465,BICD 136,A02,193244,Gustafson-Brown; Cindy,14,0,32,18
1683326240496,BIEB 102,A01,193249,Butler; Shannon Rhey,0,2,32,32
1683326240496,BIEB 102,A02,193251,Butler; Shannon Rhey,0,0,32,32
1683326240496,BIEB 102,A03,193253,Butler; Shannon Rhey,0,1,32,32
1683326240496,BIEB 102,A04,193255,Butler; Shannon Rhey,17,0,32,15
1683326240496,BIEB 102,A05,193265,Butler; Shannon Rhey,26,0,32,6
1683326240496,BIEB 102,A06,193269,Butler; Shannon Rhey,16,0,32,16
1683326242542,BIEB 150,A01,193274,Staff,0,0,32,32
1683326242542,BIEB 150,A02,193285,Staff,23,0,32,9
1683326243570,BIEB 194,A00,193286,Kurle; Carolyn M.,22,0,32,10
1683326244596,BILD 1,A01,192291,Staff,16,0,32,16
1683326244596,BILD 1,A02,192292,Staff,30,0,32,2
1683326244596,BILD 1,B01,192520,Reuther; Keefe,0,1,0,0
1683326244596,BILD 1,B02,192532,Reuther; Keefe,0,1,0,0
1683326245626,BILD 3,A01,192556,Butler; Shannon Rhey,0,0,32,32
1683326245626,BILD 3,A02,192581,Butler; Shannon Rhey,5,0,32,27
1683326245626,BILD 3,A03,192611,Butler; Shannon Rhey,23,0,32,9
1683326245626,BILD 3,A04,192612,Butler; Shannon Rhey,25,0,32,7
1683326245626,BILD 3,A05,192613,Butler; Shannon Rhey,27,0,32,5
1683326245626,BILD 3,A06,192679,Butler; Shannon Rhey,27,0,32,5
1683326245626,BILD 3,A07,192682,Butler; Shannon Rhey,22,0,32,10
1683326246651,BILD 4,A01,192836,Reuther; Keefe,0,0,24,24
1683326246651,BILD 4,A02,193044,Reuther; Keefe,4,0,24,20
1683326247680,BILD 10,A01,193142,Gustafson-Brown; Cindy,30,0,32,2
1683326247680,BILD 10,A02,193149,Gustafson-Brown; Cindy,31,0,32,1
1683326248705,BIMM 100,A01,193301,Staff,0,6,32,32
1683326248705,BIMM 100,A02,193312,Staff,0,5,32,32
1683326248705,BIMM 100,A03,193323,Staff,0,8,32,32
1683326249731,BIMM 101,A01,193329,McDonnell; Lisa Marie,0,3,24,24
1683326249731,BIMM 101,A02,193339,McDonnell; Lisa Marie,0,3,24,24
1683326249731,BIMM 101,B01,193354,McDonnell; Lisa Marie,0,3,24,24
1683326249731,BIMM 101,B02,193357,McDonnell; Lisa Marie,0,3,24,24
1683326250760,BIMM 110,A01,193377,Tat; John,0,11,32,32
1683326250760,BIMM 110,A02,193378,Tat; John,1,9,32,31
1683326251786,BIMM 120,A01,206116,Staff,0,0,32,32
1683326251786,BIMM 120,A02,206117,Staff,8,0,32,24
1683326251786,BIMM 120,A03,206121,Staff,21,0,32,11
1683326252810,BIPN 100,A01,193393,Park; Ji Young,0,14,32,32
1683326252810,BIPN 100,A02,193402,Park; Ji Young,0,13,32,32
1683326252810,BIPN 100,A03,193413,Park; Ji Young,0,14,32,32
1683326252810,BIPN 100,A04,193414,Park; Ji Young,0,13,32,32
1683326253836,BIPN 102,A01,193429,Staff,0,0,32,32
1683326253836,BIPN 102,A02,193438,Staff,22,0,32,10
1683326254863,BIPN 106,A01,193450,Reyes Gonzalez; Catalina,0,2,40,40
1683326255888,BIPN 134,A01,193465,Cooke; James Edward,0,0,32,32
1683326255888,BIPN 134,A02,193474,Cooke; James Edward,25,0,32,7
1683326255888,BIPN 134,A03,193485,Cooke; James Edward,29,0,32,3
1683326255888,BIPN 134,A04,193486,Cooke; James Edward,21,0,32,11
1683326255888,BIPN 134,A05,193491,Cooke; James Edward,31,0,32,1
1683326255888,BIPN 134,A06,193501,Cooke; James Edward,30,0,32,2
1683326255888,BIPN 134,A07,193510,Cooke; James Edward,29,0,32,3
1683326257936,BISP 194,A00,222522,Staff,14,0,32,18
1683326258961,CAT 124,A01,202407,Staff,20,0,25,5
1683326259988,CAT 125,A00,202408,Marchisotto; Jennifer Anne,4,0,20,16
1683326261013,CAT 125R,A00,202409,Smith; Lauryn Alissa,0,11,20,20
1683326261013,CAT 125R,B00,202410,Morales; Celeste Georgianna,0,11,20,20
1683326261013,CAT 125R,C00,202411,Irwin; Matthew Joseph,0,10,20,20
1683326262043,CENG 15,A01,204712,Yang; Kesong,0,1,0,0
1683326263068,CENG 114,A00,202070,Jahed Motlagh; Zeinab,5,0,20,15
1683326264096,CGS 105,A00,185477,Wesling; Megan E.,24,0,40,16
1683326265123,CGS 106,A00,185494,Staff,13,0,22,9
1683326266150,CGS 108,A00,185495,Staff,14,0,20,6
1683326267177,CGS 114,A00,185496,Staff,13,0,18,5
1683326268203,CGS 119,A00,185501,Staff,15,0,20,5
1683326269229,CGS 120,A00,185511,Staff,13,0,20,7
1683326270255,CHEM 4,A01,184675,Bussey; Thomas J,96,0,100,4
1683326271280,CHEM 6A,A01,184677,Staff,34,0,60,26
1683326272304,CHEM 6B,A01,184679,Staff,65,0,100,35
1683326273329,CHEM 6C,A01,184681,Bussey; Thomas J,1,0,50,49
1683326273329,CHEM 6C,A02,184682,Bussey; Thomas J,34,0,50,16
1683326274357,CHEM 40A,A01,184684,Albizati; Kim F.,37,0,100,63
1683326275381,CHEM 40B,A01,184686,Albizati; Kim F.,0,20,100,100
1683326276408,CHEM 41B,A01,184690,Staff,52,0,100,48
1683326277433,COGS 3,A01,184715,Boyle; Mary E. T.,0,25,40,40
1683326278457,COGS 14B,A01,185172,Staff,0,15,38,38
1683326279486,COGS 18,A01,184736,Staff,17,0,80,63
1683326280509,COGS 100,A01,184932,Staff,0,5,73,73
1683326281537,COGS 101A,A01,184935,Staff,0,38,30,30
1683326282564,COGS 101B,A01,184944,Staff,0,2,30,30
1683326283589,COGS 101C,A01,184946,Staff,0,12,30,30
1683326284615,COGS 102A,A01,184951,Johnson; Christine M.,2,0,40,38
1683326285639,COGS 107B,A01,184953,Mooshagian; Eric Frederick,0,50,40,40
1683326286667,COGS 118B,A01,184959,Gupta; Anjum,0,48,40,40
1683326287694,COGS 153,A00,184961,Staff,0,15,30,30
1683326288723,COGS 177,A00,184962,Staff,0,20,30,30
1683326289746,COGS 187A,A01,184969,Boyle; Mary E. T.,0,17,40,40
1683326290774,COMM 10,A01,185174,Staff,0,5,25,25
1683326290774,COMM 10,A02,185189,Staff,0,5,25,25
1683326290774,COMM 10,A03,269821,Staff,0,0,0,0
1683326291798,COMM 100B,A01,185475,Staff,0,0,0,2
1683326291798,COMM 100B,A02,185476,Staff,14,0,25,11
1683326292823,COMM 100C,A01,185314,Staff,1,0,25,24
1683326292823,COMM 100C,A02,185327,Staff,19,0,25,6
1683326293846,COMM 110M,A00,185349,Staff,2,0,40,38
1683326294874,COMM 113T,A00,185352,Staff,25,0,40,15
1683326295897,COMM 114I,A00,185353,Staff,33,0,40,7
1683326296924,COMM 131,A00,185354,Staff,19,0,30,11
1683326297948,CSE 8A,A50,185358,Cao; Yingjun,0,46,10,10
1683326298972,CSE 8B,A01,185362,Staff,1,47,50,49
1683326299997,CSE 11,A01,185416,Cao; Yingjun,0,92,10,10
1683326301026,CSE 20,A01,185445,Briones; Jor-el Thomas Caparas,5,0,25,20
1683326302052,CSE 21,A01,185447,Staff,10,0,50,40
1683326303082,CSE 101,A01,185451,Staff,0,12,50,50
1683326303082,CSE 101,B01,185453,Jones; Miles E,0,11,50,50
1683326305134,CSE 141,A01,185458,Eldon; John,20,0,100,80
1683326306158,CSE 141L,A01,185461,Eldon; John,12,0,100,88
1683326307185,CSE 142,A01,185463,Staff,36,0,60,24
1683326307185,CSE 142,B01,201355,Staff,0,7,60,60
1683326308210,CSE 142L,A01,185470,Staff,36,0,60,24
1683326308210,CSE 142L,B01,201417,Staff,0,6,60,60
1683326309234,CSE 190,A00,201433,Staff,32,0,49,17
1683326310259,DOC 1,A01,259136,Strom; Megan C.,7,0,15,8
1683326310259,DOC 1,A02,259137,Strom; Megan C.,14,0,15,1
1683326310259,DOC 1,A03,259138,Strom; Megan C.,14,0,15,1
1683326310259,DOC 1,A04,259139,Strom; Megan C.,14,0,15,1
1683326311283,DOC 100D,A00,259140,Pass; Natalye Joann,16,0,25,9
1683326312308,DSGN 1,A01,184749,Rill; Bryan,0,26,30,30
1683326313333,DSGN 100,A01,185168,Staff,0,2,25,25
1683326314358,ECE 5,A01,185626,Morris; Karcher William,0,10,0,0
1683326315383,ECE 101,A01,185628,Staff,17,0,70,53
1683326316406,ECE 107,A01,185635,Baghdadchi; Saharnaz,0,0,20,20
1683326316406,ECE 107,A02,185638,Baghdadchi; Saharnaz,4,0,20,16
1683326317429,ECE 148,A01,185647,Silberman; Jack,0,0,16,16
1683326318456,ECON 1,A01,185537,Crane; Meredith Helen,54,0,70,16
1683326319481,ECON 3,A01,185549,Crane; Meredith Helen,33,0,70,37
1683326320505,ECON 4,A01,203354,Anderson; John Charles,0,4,10,10
1683326321530,ECON 100A,A01,185574,Staff,0,4,40,40
1683326322554,ECON 100B,A01,185576,Staff,0,22,40,40
1683326323579,ECON 100C,A01,185589,Newhouse; Herbert S,30,0,70,40
1683326324603,ECON 105,A00,185608,Vespa; Emanuel Ignacio,19,0,35,16
1683326325628,ECON 109,A01,185610,Shishkin; Denis,10,0,35,25
1683326326652,ECON 110A,A01,185612,Staff,11,0,40,29
1683326327676,ECON 120A,A01,185615,Staff,20,0,40,20
1683326328705,ECON 120C,A01,185617,Sun; Yixiao,0,20,70,70
1683326329734,ECON 144,A00,203346,Squires; Dale E,3,0,35,32
1683326330758,ECON 171,A01,203349,Newhouse; Herbert S,0,1,35,35
1683326331784,ECON 173A,A01,185621,Toda; Alexis Akira,21,0,35,14
1683326332818,EDS 25,A01,202413,Staff,0,1,0,0
1683326332818,EDS 25,A02,202414,Staff,0,1,0,0
1683326332818,EDS 25,A03,202415,Staff,0,0,0,0
1683326332818,EDS 25,A04,202416,Staff,0,1,0,0
1683326332818,EDS 25,A05,202439,Staff,0,0,0,0
1683326332818,EDS 25,A06,202440,Staff,0,0,0,0
1683326332818,EDS 25,B01,202631,Staff,0,0,0,0
1683326332818,EDS 25,B02,202632,Staff,0,0,0,0
1683326332818,EDS 25,B03,202639,Staff,0,0,0,0
1683326332818,EDS 25,B04,202640,Staff,0,0,0,0
1683326332818,EDS 25,B05,202643,Staff,0,0,0,0
1683326332818,EDS 25,B06,202644,Staff,0,0,0,0
1683326333843,EDS 38,A01,202659,Black; Alison Michelle,24,0,25,1
1683326334867,EDS 115,A00,202652,Staff,17,0,30,13
1683326335894,EDS 125,A00,202649,Staff,14,0,30,16
1683326336918,EDS 126,A01,203332,Staff,30,0,30,0
1683326337941,EDS 139,A00,202838,Staff,16,0,25,9
1683326338966,EDS 146,A01,202655,Staff,14,0,25,11
1683326340067,ENG 15,A00,185667,Staff,0,1,0,0
1683326340067,ENG 15,B00,185672,Staff,0,0,0,0
1683326340067,ENG 15,C00,185675,Staff,0,0,0,0
1683326340067,ENG 15,D00,185682,Staff,0,0,0,0
1683326340067,ENG 15,E00,185684,Staff,0,0,0,0
1683326341098,ETHN 103,A00,185710,Staff,0,3,35,35
1683326342122,ETHN 103A,A00,199228,Man; Simeon S,2,0,9,7
1683326343147,ETHN 109,A00,185711,Staff,18,0,35,17
1683326344172,ETHN 142,A00,185726,Staff,0,4,30,30
1683326345197,ETHN 163J,A00,199229,Man; Simeon S,5,0,8,3
1683326346220,ETHN 168,A00,185727,Staff,8,0,10,2
1683326347244,ETHN 182,A00,185728,Staff,1,0,35,34
1683326348272,ETHN 183,A00,185737,Staff,8,0,18,10
1683326349299,GLBH 111,A01,209361,Burgos; Jose L.,0,0,0,0
1683326351350,HIEU 104,A00,185792,Staff,16,0,20,4
1683326352376,HIEU 115,A00,185800,Staff,1,0,20,19
1683326353399,HIEU 128,A00,185801,Staff,0,7,20,20
1683326354424,HIEU 147,A00,185802,Staff,16,0,20,4
1683326355451,HIEU 154,A00,185823,Staff,12,0,20,8
1683326356476,HILA 102,A00,185826,Staff,13,0,20,7
1683326357503,HILD 2C,A01,185778,Staff,0,12,20,20
1683326358528,HILD 7B,A01,185780,Kwak; Nancy,0,15,32,32
1683326358528,HILD 7B,A02,185781,Kwak; Nancy,0,18,32,32
1683326359551,HILD 30,A01,185791,Staff,14,0,20,6
1683326360575,HISC 119,A00,185830,Golan; Tal,0,9,20,20
1683326361599,HITO 156GS,A00,185831,Patterson; Patrick H.,0,0,0,23
1683326362627,HIUS 103,A00,185832,Man; Simeon S,0,6,20,20
1683326363655,HIUS 117,A00,185836,Kwak; Nancy,2,0,20,18
1683326364679,HIUS 125,A00,185840,Man; Simeon S,0,0,23,23
1683326365703,HIUS 149,A00,185845,Staff,0,0,20,20
1683326366735,HUM 3,A01,185882,Zavodny; Tatiana Sophia,0,7,50,50
1683326366735,HUM 3,B01,185899,Caldwell; Michael Alan,0,18,50,50
1683326367761,HUM 3GS,A00,185900,Patterson; Patrick H.,0,0,0,23
1683326368793,HUM 4,A01,185938,Zroka; Amy Liane,31,0,50,19
1683326368793,HUM 4,B01,185956,Watkins; Eric,0,2,50,50
1683326368793,HUM 4,B02,202209,Watkins; Eric,0,2,50,50
1683326368793,HUM 4,B03,202210,Watkins; Eric,0,2,50,50
1683326369817,HUM 5,A01,185958,West; Geoffrey Scott,3,0,50,47
1683326369817,HUM 5,A02,202215,West; Geoffrey Scott,0,0,50,50
1683326370843,INTL 190,A00,185959,Gagnon; Jeffrey C,0,0,0,9
1683326370843,INTL 190,B00,185960,Lettieri; Michael Joseph,0,0,0,1
1683326371870,JAPN 180,A00,254509,Staff,5,1,30,25
1683326372897,LATI 10,A01,202853,Kennemore; Amy Michelle,4,0,35,31
1683326372897,LATI 10,A02,202854,Kennemore; Amy Michelle,2,0,35,33
1683326372897,LATI 10,A03,270054,Kennemore; Amy Michelle,30,0,30,0
1683326373919,LATI 180,A00,202855,Kennemore; Amy Michelle,11,0,20,9
1683326374946,LAWS 101,A00,201767,Golan; Tal,0,7,40,40
1683326375970,LIFR 1C,A00,185961,Staff,6,0,20,14
1683326376998,LIFR 1CX,A00,185962,Staff,7,0,20,13
1683326378023,LIFR 1D,A00,185963,Staff,9,0,20,11
1683326379047,LIFR 1DX,A00,185964,Staff,9,0,20,11
1683326380070,LIGN 101,A01,186039,Staff,43,0,50,7
1683326381096,LIGN 165,A00,186040,Staff,18,0,50,32
1683326382120,LTCS 108,A00,186041,Staff,6,0,10,4
1683326383145,LTCS 119,A00,186042,Staff,16,0,20,4
1683326384169,LTCS 130,A00,186043,Wesling; Megan E.,15,0,25,10
1683326386218,LTEA 138,A00,186119,Staff,14,0,40,26
1683326387244,LTEN 124,A00,186148,Staff,6,0,25,19
1683326388271,LTEN 178,A00,186149,Staff,7,0,15,8
1683326389300,LTEN 181,A00,186150,Blanco; John D,33,0,40,7
1683326390324,LTWL 120,A00,186160,Staff,20,0,25,5
1683326391350,LTWL 165,A00,186161,Staff,22,0,25,3
1683326392375,LTWR 100,A00,186162,Staff,0,5,15,15
1683326393399,LTWR 102,A00,186163,Doller; Ben,5,0,15,10
1683326394423,MAE 8,A01,186412,Staff,0,0,0,0
1683326395451,MAE 30B,A00,186445,Bahadori; Mohammad Yousef,83,0,100,17
1683326396475,MAE 40,A00,186592,Bewley; Thomas R,9,0,50,41
1683326397499,MAE 101B,A00,186593,Bahadori; Mohammad Yousef,81,0,100,19
1683326398525,MAE 105,A00,186594,Bandaru; Prabhakar,12,0,50,38
1683326399550,MAE 107,A00,186599,Pham; Hieu Tan,0,6,120,120
1683326400574,MAE 148,A01,186660,Silberman; Jack,3,0,16,13
1683326401598,MATH 10A,A01,188095,Staff,1,6,35,34
1683326402628,MATH 10B,A01,188097,Bowers; Adam R.,0,11,30,30
1683326402628,MATH 10B,A02,188099,Bowers; Adam R.,0,11,30,30
1683326402628,MATH 10B,B01,188104,Bowers; Adam R.,0,10,30,30
1683326402628,MATH 10B,B02,188106,Bowers; Adam R.,0,10,30,30
1683326403657,MATH 10C,A01,188111,Staff,0,18,30,30
1683326403657,MATH 10C,A02,188127,Staff,0,17,30,30
1683326403657,MATH 10C,A03,188131,Staff,0,18,30,30
1683326403657,MATH 10C,B01,188218,Staff,18,0,30,12
1683326403657,MATH 10C,B02,188244,Staff,13,0,30,17
1683326403657,MATH 10C,B03,188277,Staff,16,0,30,14
1683326404686,MATH 18,A01,188344,Bach; Quang Tran,18,0,30,12
1683326404686,MATH 18,A02,188345,Bach; Quang Tran,11,0,30,19
1683326404686,MATH 18,B01,188353,Bach; Quang Tran,10,0,30,20
1683326404686,MATH 18,B02,188354,Bach; Quang Tran,20,0,30,10
1683326405709,MATH 20A,A01,188374,Staff,13,0,35,22
1683326406737,MATH 20B,A01,188382,Ohm; Ko Woon,6,0,30,24
1683326406737,MATH 20B,A02,188383,Ohm; Ko Woon,22,0,30,8
1683326406737,MATH 20B,B01,188385,Ohm; Ko Woon,7,0,30,23
1683326406737,MATH 20B,B02,188392,Ohm; Ko Woon,22,0,30,8
1683326407766,MATH 20C,A01,188394,Harel; Guershon,10,0,30,20
1683326407766,MATH 20C,A02,188395,Harel; Guershon,14,0,30,16
1683326407766,MATH 20C,B01,188404,Harel; Guershon,5,0,30,25
1683326407766,MATH 20C,B02,188405,Harel; Guershon,19,0,30,11
1683326408791,MATH 20D,A01,188414,Hammock; Frances H,0,1,30,30
1683326408791,MATH 20D,A02,188415,Hammock; Frances H,3,0,30,27
1683326408791,MATH 20D,B01,188447,Hammock; Frances H,2,0,30,28
1683326408791,MATH 20D,B02,188486,Hammock; Frances H,8,0,30,22
1683326409818,MATH 20E,A01,188649,Staff,21,0,30,9
1683326409818,MATH 20E,A02,188650,Staff,23,0,30,7
1683326409818,MATH 20E,A03,188673,Staff,0,0,30,30
1683326410845,MATH 102,A01,188675,Staff,0,35,35,35
1683326411871,MATH 103B,A01,188681,Staff,4,0,35,31
1683326411871,MATH 103B,B01,188692,Staff,5,0,35,30
1683326412895,MATH 109,A01,188695,Salehi Golsefidy; Alireza,25,0,35,10
1683326412895,MATH 109,A02,188696,Salehi Golsefidy; Alireza,26,0,35,9
1683326413919,MATH 120A,A01,188698,Eggers; John Dietrich,7,0,35,28
1683326414949,MATH 142B,A01,188736,Ioana; Adrian,0,2,30,30
1683326414949,MATH 142B,A02,188741,Ioana; Adrian,0,1,30,30
1683326414949,MATH 142B,A03,188743,Ioana; Adrian,1,3,30,29
1683326415982,MATH 168A,A01,188790,Staff,0,9,35,35
1683326417009,MATH 170A,A01,188803,Nie; Jiawang,0,2,35,35
1683326417009,MATH 170A,A02,188811,Nie; Jiawang,0,0,35,35
1683326417009,MATH 170A,A03,188814,Nie; Jiawang,1,0,35,34
1683326417009,MATH 170A,A04,188815,Nie; Jiawang,13,0,35,22
1683326418034,MATH 193B,A01,188817,Staff,0,0,35,35
1683326418034,MATH 193B,A02,188818,Staff,5,0,35,30
1683326419062,MGT 4,A01,202857,Anderson; John Charles,62,0,80,18
1683326420089,MGT 12,A00,202858,Lindenberger; Wade Douglas,42,0,90,48
1683326421113,MGT 18,A00,202859,Staff,74,0,90,16
1683326422137,MGT 18GS,A00,202860,McKay; Michael J,13,0,28,15
1683326423162,MGT 45,A00,202861,Pecore; Joseph P.,13,0,90,77
1683326424186,MGT 100,A00,202863,Yavorsky; Daniel Ryan,28,0,90,62
1683326425209,MGT 103,A00,202864,Ehrich; Kristine R,0,18,90,90
1683326426234,MGT 112,A00,202865,Ehrich; Kristine R,15,0,90,75
1683326427259,MGT 121A,A00,202868,Staff,0,20,0,0
1683326428286,MGT 131B,A00,202869,Anderson; John Charles,59,0,90,31
1683326429314,MGT 136,A00,202871,Lindenberger; Wade Douglas,84,0,90,6
1683326430344,MGT 164,A00,202873,Staff,0,68,90,91
1683326431372,MGT 164GS,A00,202874,McKay; Mary A,13,0,28,15
1683326432399,MGT 180,A00,202875,Staff,0,50,90,91
1683326433424,MMW 11R,A01,205019,Herbst; Matthew,3,0,30,27
1683326433424,MMW 11R,A02,205026,Herbst; Matthew,29,0,30,1
1683326434453,MMW 15,A01,193512,Chang; Edmond Yi-Teh,0,9,28,28
1683326434453,MMW 15,A02,193513,Chang; Edmond Yi-Teh,0,5,28,28
1683326434453,MMW 15,A03,193514,Chang; Edmond Yi-Teh,0,5,28,28
1683326434453,MMW 15,A04,193515,Chang; Edmond Yi-Teh,0,5,28,28
1683326434453,MMW 15,A05,193516,Chang; Edmond Yi-Teh,0,4,28,28
1683326434453,MMW 15,A06,193517,Chang; Edmond Yi-Teh,0,5,28,28
1683326434453,MMW 15,B01,193519,Chang; Edmond Yi-Teh,0,5,28,28
1683326434453,MMW 15,B02,193520,Chang; Edmond Yi-Teh,0,5,28,28
1683326434453,MMW 15,B03,193521,Chang; Edmond Yi-Teh,0,5,28,28
1683326434453,MMW 15,B04,193522,Chang; Edmond Yi-Teh,0,4,28,28
1683326434453,MMW 15,B05,193523,Chang; Edmond Yi-Teh,0,5,28,28
1683326434453,MMW 15,B06,193524,Chang; Edmond Yi-Teh,0,4,28,28
1683326435480,MMW 122,A01,193526,Rahimi; Babak,0,15,28,28
1683326435480,MMW 122,A02,193527,Rahimi; Babak,0,14,28,28
1683326435480,MMW 122,A03,193528,Rahimi; Babak,0,0,0,0
1683326435480,MMW 122,A04,193529,Rahimi; Babak,0,0,0,0
1683326436507,MUS 1A,A01,186663,Staff,0,20,35,35
1683326437537,MUS 4,A01,186715,Staff,0,12,35,35
1683326438566,MUS 5R,A01,186796,Dubnov; Shlomo,0,17,35,35
1683326439590,MUS 6,A01,186798,Staff,0,4,25,25
1683326440619,MUS 7,A01,186830,Staff,12,0,35,23
1683326441643,MUS 8,A01,186930,Staff,0,27,35,35
1683326442671,MUS 15,A01,186932,Staff,0,16,35,35
1683326442671,MUS 15,B01,186934,Staff,0,15,35,35
1683326443754,MUS 80,A00,186935,Staff,1,0,20,19
1683326443754,MUS 80,B00,186936,Staff,25,0,25,0
1683326444778,NANO 11,A00,204702,Lipomi; Darren John,0,0,0,0
1683326445803,NANO 15,A01,204709,Yang; Kesong,0,1,0,0
1683326446827,NANO 114,A00,202069,Jahed Motlagh; Zeinab,3,0,10,7
1683326447854,PHIL 1,A00,186955,Grush; Rick Scott,32,0,40,8
1683326448878,PHIL 10,A01,186973,Grush; Rick Scott,28,0,35,7
1683326448878,PHIL 10,A02,186974,Grush; Rick Scott,33,0,35,2
1683326449905,PHIL 13,A01,186976,Staff,7,0,35,28
1683326449905,PHIL 13,A02,186977,Staff,16,0,35,19
1683326450930,PHIL 14,A01,186979,Staff,31,0,35,4
1683326450930,PHIL 14,A02,186986,Staff,32,0,35,3
1683326451955,PHIL 28,A01,186988,Staff,16,0,30,14
1683326451955,PHIL 28,A02,186989,Staff,1,0,30,29
1683326451955,PHIL 28,A03,186990,Staff,9,0,30,21
1683326451955,PHIL 28,A04,186991,Staff,26,0,30,4
1683326452982,PHIL 120,A00,186997,Staff,23,0,40,17
1683326454009,PHIL 137,A00,187003,Staff,9,0,40,31
1683326455033,PHIL 150,A00,187015,Staff,47,0,70,23
1683326456061,PHIL 167,A00,187021,Lamey; Andy M.,35,0,40,5
1683326457085,PHIL 174,A01,202226,Staff,17,0,20,3
1683326457085,PHIL 174,A02,202235,Staff,20,0,20,0
1683326458110,PHIL 191A,A00,258918,Staff,0,0,1,1
1683326459135,PHYS 1A,A00,187028,Staff,27,0,60,33
1683326460162,PHYS 1AL,001,187036,Staff,3,0,30,27
1683326460162,PHYS 1AL,002,187049,Staff,18,0,30,12
1683326461187,PHYS 1B,A00,187058,Staff,22,0,60,38
1683326462214,PHYS 1BL,001,187064,Staff,0,0,30,30
1683326462214,PHYS 1BL,002,187070,Staff,5,0,30,25
1683326463238,PHYS 1C,A00,187082,Staff,31,0,120,89
1683326464267,PHYS 1CL,001,187088,Staff,0,9,30,30
1683326464267,PHYS 1CL,002,187089,Staff,0,2,30,30
1683326464267,PHYS 1CL,009,262693,Staff,11,0,30,19
1683326465294,PHYS 2B,A01,187097,Staff,54,0,115,61
1683326466320,PHYS 2C,A01,187099,Staff,67,0,115,48
1683326467346,PHYS 2CL,A01,187101,Staff,5,0,28,23
1683326467346,PHYS 2CL,A02,187102,Staff,15,0,28,13
1683326468375,PHYS 2D,A01,187123,Shotwell; Brian,95,0,115,20
1683326469399,PHYS 4B,A01,187133,Grinstein; Benjamin,35,0,50,15
1683326470422,POLI 10,A00,188819,Staff,0,4,50,50
1683326471449,POLI 11,A00,188827,Staff,43,0,50,7
1683326472475,POLI 13R,A00,188828,Staff,0,1,20,20
1683326473505,POLI 27,A01,188830,Elgin; Samuel Zincke,0,1,70,70
1683326474528,POLI 30,A00,188832,Desposato; Scott,31,0,50,19
1683326475589,POLI 102F,A00,188834,Staff,3,0,40,37
1683326476613,POLI 104A,A00,188852,Staff,14,0,30,16
1683326477639,POLI 104I,A00,188853,Staff,0,6,20,20
1683326478663,POLI 110B,A00,188854,Wiens; David,7,0,20,13
1683326479691,POLI 112A,A00,188855,Wiens; David,5,0,30,25
1683326480715,POLI 117R,A00,188856,Forman; Fonna,0,11,20,20
1683326481739,POLI 118,A00,188857,Ingham; Sean,8,0,20,12
1683326482762,POLI 120G,A00,188858,Staff,9,0,30,21
1683326483788,POLI 131CR,A00,188863,Hoston; Germaine,24,0,50,26
1683326484813,POLI 133,A00,188864,Nellis; Gareth Hb,44,0,50,6
1683326485839,POLI 134D,A00,188865,Desposato; Scott,27,0,30,3
1683326486866,POLI 142A,A00,188871,Gartzke; Erik,22,0,50,28
1683326487889,POLI 142K,A00,188874,Staff,38,0,50,12
1683326488918,POLI 143,A00,188940,Gartzke; Erik,16,0,30,14
1683326489942,POLI 153,A00,188943,Staff,3,0,20,17
1683326490969,POLI 160AA,A00,188944,Staff,12,0,40,28
1683326491992,POLI 170A,A00,188945,Staff,11,0,30,19
1683326494045,PSYC 1,A00,188952,Staff,37,0,90,53
1683326495068,PSYC 2,B00,188953,Staff,19,0,35,16
1683326496092,PSYC 6,A00,188970,Staff,47,0,60,13
1683326497119,PSYC 7,A00,188973,Staff,37,0,45,8
1683326498144,PSYC 60,A01,188980,Rickard; Timothy C.,43,0,60,17
1683326499168,PSYC 70,A01,189001,Steiner; Eric Tomas,24,0,45,21
1683326500192,PSYC 100,A00,189005,Lacefield; Katharine I,0,100,120,120
1683326501218,PSYC 102,A00,189008,Staff,9,0,30,21
1683326502244,PSYC 106,B00,189026,Gorman; Michael R.,34,0,60,26
1683326503269,PSYC 114,B01,189033,Winkielman; Piotr,0,32,30,30
1683326504293,PSYC 131,A00,189036,Anagnostaras; Stephan,0,43,60,60
1683326505318,PSYC 136,A00,189041,Lowe; Angela Beth,0,7,25,25
1683326506345,PSYC 137,A00,189057,Winkielman; Piotr,0,34,25,25
1683326507372,PSYC 144,A00,189107,Wixted; John T,0,7,50,50
1683326509419,PSYC 162,A00,189142,Staff,0,8,85,85
1683326510446,PSYC 172,A00,189144,Gorman; Michael R.,0,7,30,30
1683326512497,PSYC 179,A00,189146,Lacefield; Katharine I,0,84,120,120
1683326513524,PSYC 181,A00,189147,Anagnostaras; Stephan,0,44,90,90
1683326514548,PSYC 190R,A00,189148,Barner; David A.,0,22,80,80
1683326515575,PSYC 191,A00,189275,Rickard; Timothy C.,0,7,25,25
1683326516599,PSYC 193,A00,189276,Chapman; Eddie Nathaniel,0,1,0,4
1683326517624,PSYC 193L,A01,189281,Lowe; Angela Beth,12,0,20,8
1683326517624,PSYC 193L,B01,189285,Staff,28,0,35,7
1683326518650,RELI 149,A00,187137,Rahimi; Babak,7,0,40,33
1683326519679,SE 9,A01,187315,Staff,0,2,18,18
1683326520701,SE 101B,A00,187409,Staff,24,0,30,6
1683326521726,SE 110B,A00,187444,Staff,10,0,40,30
1683326522759,SE 130B,A00,187449,Staff,31,0,40,9
1683326523783,SE 150A,A00,187516,Staff,9,0,20,11
1683326524807,SE 154,A00,187528,Staff,30,0,50,20
1683326525831,SIO 3,A01,258171,Staff,35,0,40,5
1683326526857,SIO 10,A00,187144,Cook; Geoffrey W,0,3,75,75
1683326527884,SIO 45,A00,187152,Cook; Geoffrey W,1,0,100,99
1683326528908,SIO 109R,A00,194486,Staff,0,3,20,20
1683326530956,SIO 187,A01,187233,Kacev; David,12,0,40,28
1683326531984,SOCI 1,A01,258656,Thorpe; Charles Robert,28,0,30,2
1683326531984,SOCI 1,A02,258658,Thorpe; Charles Robert,30,0,30,0
1683326531984,SOCI 1,A03,258661,Thorpe; Charles Robert,25,0,25,0
1683326531984,SOCI 1,A04,258666,Thorpe; Charles Robert,22,0,25,3
1683326531984,SOCI 1,A05,258897,Thorpe; Charles Robert,23,0,25,2
1683326531984,SOCI 1,A06,258898,Thorpe; Charles Robert,25,0,25,0
1683326533012,SOCI 30,A01,258903,Pardo Guerra; Juan Pablo,15,0,30,15
1683326534037,SOCI 102,A00,258904,Staff,9,0,25,16
1683326535062,SOCI 106,A00,258905,Staff,19,0,25,6
1683326536089,SOCI 111,A00,258907,Ribas Norris; Janet Vanesa,26,0,30,4
1683326537116,SOCI 121R,A00,258908,Pardo Guerra; Juan Pablo,10,0,30,20
1683326538143,SOCI 126,A01,203330,Staff,14,0,20,6
1683326539167,SOCI 131,A00,258909,Thorpe; Charles Robert,31,0,60,29
1683326540192,SOCI 135,A00,258910,Payne; Christine Anna,0,9,30,30
1683326541219,SOCI 157,A00,258911,Staff,12,0,30,18
1683326542245,SOCI 184,A00,258912,Staff,25,0,30,5
1683326543271,SOCI 188D,A00,258913,Staff,21,0,30,9
1683326544299,SYN 2,001,187529,Staff,9,0,16,7
1683326544299,SYN 2,002,201452,Staff,0,18,16,16
1683326544299,SYN 2,003,201469,Staff,4,0,16,12
1683326545327,SYN 100,A01,187531,Staff,0,9,20,20
1683326545327,SYN 100,B01,201491,Staff,0,12,20,20
1683326546351,TDAC 1,A00,189286,Walsh; Kim C.,3,0,20,17
1683326546351,TDAC 1,B00,189287,Harting; Carla Kelso,11,0,20,9
1683326547451,TDAC 101,A00,189300,Walsh; Kim C.,16,0,20,4
1683326547451,TDAC 101,B00,189301,Harting; Carla Kelso,18,0,20,2
1683326548482,TDAC 102,A00,189304,Basso; Beatrice,14,0,20,6
1683326549510,TDAC 108,A00,189305,Staff,18,0,20,2
1683326550539,TDDE 131,A00,189310,Staff,19,0,20,1
1683326550539,TDDE 131,B00,189314,Staff,19,0,20,1
1683326550539,TDDE 131,C00,189315,Staff,48,0,50,2
1683326550539,TDDE 131,D00,189316,Staff,14,0,15,1
1683326550539,TDDE 131,E00,204841,Staff,20,0,20,0
1683326551563,TDGE 10,A00,189289,Staff,30,0,50,20
1683326551563,TDGE 10,B00,189290,Havis; Allan,1,0,50,49
1683326552592,TDGE 11,A00,189291,Fulton; Julia,0,3,50,50
1683326552592,TDGE 11,B00,189292,Staff,20,0,25,5
1683326552592,TDGE 11,C00,260270,Staff,0,0,0,0
1683326553617,TDGE 25,A00,189294,Staff,3,0,20,17
1683326554641,TDGE 124,A00,189318,Fulton; Julia,0,8,50,50
1683326555666,TDGE 125,A00,189319,Staff,13,0,25,12
1683326555666,TDGE 125,B00,189320,Staff,23,0,25,2
1683326556693,TDGE 127,A00,189322,Havis; Allan,0,0,50,50
1683326557721,TDHT 101,A00,189323,Staff,18,0,25,7
1683326557721,TDHT 101,B00,189324,Staff,25,0,25,0
1683326558770,TDHT 102,A00,189325,Staff,49,0,50,1
1683326559795,TDMV 1,A00,189295,Arcidiacono; Kristin,19,0,30,11
1683326559795,TDMV 1,B00,189296,Caligagan; Maria T.,24,0,30,6
1683326560823,TDMV 2,A00,189297,Sammartano; Tonnie,28,0,30,2
1683326560823,TDMV 2,B00,189299,Arcidiacono; Kristin,24,0,30,6
1683326561848,TDMV 3,A00,204998,Rincon; Alicia,22,0,30,8
1683326562874,TDMV 120,A00,189458,Sammartano; Tonnie,28,0,30,2
1683326563903,TDMV 138,A00,189541,Jun; Grace Shin Hae,22,0,40,18
1683326564929,TDMV 142,A00,189717,Caligagan; Tony,23,0,30,7
1683326564929,TDMV 142,B00,189718,Caligagan; Maria T.,25,0,30,5
1683326565952,TMC 2,A01,187533,Staff,25,0,25,0
1683326565952,TMC 2,A02,187534,Staff,25,0,25,0
1683326566980,USP 1,A01,187536,Kwak; Nancy,0,16,25,25
1683326568004,USP 5,A01,187538,Staff,10,0,25,15
1683326569031,USP 101,A00,199253,Staff,0,4,0,0
1683326570059,USP 124,A00,187562,Boomhower; Matthew Charles,1,0,30,29
1683326571086,USP 138,A00,187582,Staff,20,0,25,5
1683326572110,USP 152,A01,187597,Staff,4,0,25,21
1683326573142,USP 153,A00,187598,Staff,19,0,25,6
1683326574167,USP 168,A00,187607,Kwak; Nancy,2,0,5,3
1683326575195,USP 173,A00,187619,Staff,4,0,25,21
1683326576219,USP 181,A00,187638,Staff,0,0,25,25
1683326577245,VIS 103,A00,187650,Cruz; Edwin Teddy,23,0,75,52
1683326578268,VIS 110D,A00,187669,Staff,12,0,22,10
1683326579295,VIS 127C,A00,187720,Shen; Kuiyi,67,0,146,79
1683326580322,VIS 149,A00,187731,Yoldas; Pinar,0,14,22,22
1683326581347,VIS 151,A01,188091,Staff,22,0,34,12
1683326581347,VIS 151,A02,188092,Staff,11,0,34,23
1683326582371,VIS 160B,A00,188093,Stalbaum; Brett,0,0,10,10
1683326584419,WCWP 10B,A00,201720,Staff,10,0,15,5
1683326584419,WCWP 10B,B00,201722,Staff,8,0,15,7
1683326585442,WCWP 100,A00,201725,Gagnon; Jeffrey C,0,0,2,2
1683326585442,WCWP 100,B00,201727,Staff,0,4,15,15
1683326588539,ANBI 133,A00,258401,Wilder; Linnea Lorene,34,0,40,6
1683326589567,ANBI 140,A00,258395,Hrvoj Mihic; Branka,18,0,25,7
1683326590594,ANSC 120,A00,258402,Bialecki; Jon Anthony,27,0,40,13
1683326591620,ANSC 144,A00,258400,Staff,14,0,40,26
1683326593669,ANSC 166,A00,258396,Parish; Steven Martin,157,0,175,18
1683326594696,ANSC 180,A00,193533,Staff,9,0,20,11
1683326595721,ANSC 188,A00,258397,Jassal; Aftab,33,0,40,7
1683326596749,ANTH 3,A01,258316,Staff,23,0,30,7
1683326597776,ANTH 5,A00,258394,Semendeferi; Ekaterini,16,0,20,4
1683326598802,ANTH 21,A01,258331,Staff,8,0,40,32
1683326599826,ANTH 103,A00,258398,Varma; Saiba,15,0,25,10
1683326600921,AWP 10,001,202034,Staff,0,0,0,0
1683326600921,AWP 10,002,202035,Staff,0,0,0,0
1683326600921,AWP 10,003,202036,Staff,0,0,0,0
1683326600921,AWP 10,004,202037,Staff,0,0,0,0
1683326600921,AWP 10,005,202038,Staff,0,0,0,0
1683326600921,AWP 10,006,202039,Staff,0,0,0,0
1683326600921,AWP 10,007,202040,Staff,0,0,0,0
1683326600921,AWP 10,008,202041,Staff,0,0,0,0
1683326600921,AWP 10,009,202042,Staff,0,0,0,0
1683326600921,AWP 10,010,202043,Staff,0,0,0,0
1683326600921,AWP 10,011,202044,Staff,0,0,0,0
1683326600921,AWP 10,012,202045,Staff,0,0,0,0
1683326600921,AWP 10,013,202046,Staff,0,0,0,0
1683326600921,AWP 10,014,202047,Staff,0,0,0,0
1683326600921,AWP 10,015,202048,Staff,0,0,0,0
1683326600921,AWP 10,016,202049,Staff,0,0,0,0
1683326600921,AWP 10,017,202050,Staff,0,0,0,0
1683326600921,AWP 10,018,202051,Staff,0,0,0,0
1683326600921,AWP 10,019,202052,Staff,0,0,0,0
1683326600921,AWP 10,020,202053,Staff,0,0,0,0
1683326600921,AWP 10,021,202054,Staff,0,0,0,0
1683326600921,AWP 10,022,202055,Staff,0,0,0,0
1683326600921,AWP 10,023,202056,Staff,0,0,0,0
1683326600921,AWP 10,024,202057,Staff,0,0,0,0
1683326600921,AWP 10,025,202058,Staff,0,0,0,0
1683326600921,AWP 10,026,202059,Staff,0,0,0,0
1683326601945,AWP 102,001,202032,Staff,0,0,0,0
1683326601945,AWP 102,002,202033,Staff,0,0,0,0
1683326602973,BENG 100,A01,254234,Taylor Amos; Alyssa C,31,0,40,9
1683326604002,BENG 196,001,270013,Engler; Adam J.,9999,0,9999,0
1683326605030,BICD 100R,A01,202018,Smith; Laurie,0,7,32,32
1683326605030,BICD 100R,A02,202019,Smith; Laurie,0,2,32,32
1683326605030,BICD 100R,A03,202020,Smith; Laurie,0,1,32,32
1683326605030,BICD 100R,A04,202021,Smith; Laurie,9,0,32,23
1683326605030,BICD 100R,A05,202022,Smith; Laurie,12,0,32,20
1683326606054,BICD 136,A01,193242,Gustafson-Brown; Cindy,0,2,32,32
1683326606054,BICD 136,A02,193244,Gustafson-Brown; Cindy,14,0,32,18
1683326607085,BIEB 102,A01,193249,Butler; Shannon Rhey,0,2,32,32
1683326607085,BIEB 102,A02,193251,Butler; Shannon Rhey,0,0,32,32
1683326607085,BIEB 102,A03,193253,Butler; Shannon Rhey,0,1,32,32
1683326607085,BIEB 102,A04,193255,Butler; Shannon Rhey,17,0,32,15
1683326607085,BIEB 102,A05,193265,Butler; Shannon Rhey,26,0,32,6
1683326607085,BIEB 102,A06,193269,Butler; Shannon Rhey,16,0,32,16
1683326609133,BIEB 150,A01,193274,Staff,0,0,32,32
1683326609133,BIEB 150,A02,193285,Staff,23,0,32,9
1683326610162,BIEB 194,A00,193286,Kurle; Carolyn M.,22,0,32,10
1683326611190,BILD 1,A01,192291,Staff,16,0,32,16
1683326611190,BILD 1,A02,192292,Staff,30,0,32,2
1683326611190,BILD 1,B01,192520,Reuther; Keefe,0,1,0,0
1683326611190,BILD 1,B02,192532,Reuther; Keefe,0,1,0,0
1683326612221,BILD 3,A01,192556,Butler; Shannon Rhey,0,0,32,32
1683326612221,BILD 3,A02,192581,Butler; Shannon Rhey,5,0,32,27
1683326612221,BILD 3,A03,192611,Butler; Shannon Rhey,23,0,32,9
1683326612221,BILD 3,A04,192612,Butler; Shannon Rhey,25,0,32,7
1683326612221,BILD 3,A05,192613,Butler; Shannon Rhey,27,0,32,5
1683326612221,BILD 3,A06,192679,Butler; Shannon Rhey,27,0,32,5
1683326612221,BILD 3,A07,192682,Butler; Shannon Rhey,22,0,32,10
1683326613246,BILD 4,A01,192836,Reuther; Keefe,0,0,24,24
1683326613246,BILD 4,A02,193044,Reuther; Keefe,4,0,24,20
1683326614270,BILD 10,A01,193142,Gustafson-Brown; Cindy,30,0,32,2
1683326614270,BILD 10,A02,193149,Gustafson-Brown; Cindy,31,0,32,1
1683326615294,BIMM 100,A01,193301,Staff,0,6,32,32
1683326615294,BIMM 100,A02,193312,Staff,0,5,32,32
1683326615294,BIMM 100,A03,193323,Staff,0,8,32,32
1683326616320,BIMM 101,A01,193329,McDonnell; Lisa Marie,0,3,24,24
1683326616320,BIMM 101,A02,193339,McDonnell; Lisa Marie,0,3,24,24
1683326616320,BIMM 101,B01,193354,McDonnell; Lisa Marie,0,3,24,24
1683326616320,BIMM 101,B02,193357,McDonnell; Lisa Marie,0,3,24,24
1683326617344,BIMM 110,A01,193377,Tat; John,0,11,32,32
1683326617344,BIMM 110,A02,193378,Tat; John,1,9,32,31
1683326618367,BIMM 120,A01,206116,Staff,0,0,32,32
1683326618367,BIMM 120,A02,206117,Staff,8,0,32,24
1683326618367,BIMM 120,A03,206121,Staff,21,0,32,11
1683326619391,BIPN 100,A01,193393,Park; Ji Young,0,14,32,32
1683326619391,BIPN 100,A02,193402,Park; Ji Young,0,13,32,32
1683326619391,BIPN 100,A03,193413,Park; Ji Young,0,14,32,32
1683326619391,BIPN 100,A04,193414,Park; Ji Young,0,13,32,32
1683326620417,BIPN 102,A01,193429,Staff,0,0,32,32
1683326620417,BIPN 102,A02,193438,Staff,22,0,32,10
1683326621442,BIPN 106,A01,193450,Reyes Gonzalez; Catalina,0,2,40,40
1683326622468,BIPN 134,A01,193465,Cooke; James Edward,0,0,32,32
1683326622468,BIPN 134,A02,193474,Cooke; James Edward,25,0,32,7
1683326622468,BIPN 134,A03,193485,Cooke; James Edward,29,0,32,3
1683326622468,BIPN 134,A04,193486,Cooke; James Edward,21,0,32,11
1683326622468,BIPN 134,A05,193491,Cooke; James Edward,31,0,32,1
1683326622468,BIPN 134,A06,193501,Cooke; James Edward,30,0,32,2
1683326622468,BIPN 134,A07,193510,Cooke; James Edward,29,0,32,3
1683326624520,BISP 194,A00,222522,Staff,14,0,32,18
1683326625547,CAT 124,A01,202407,Staff,20,0,25,5
1683326626575,CAT 125,A00,202408,Marchisotto; Jennifer Anne,4,0,20,16
1683326627604,CAT 125R,A00,202409,Smith; Lauryn Alissa,0,11,20,20
1683326627604,CAT 125R,B00,202410,Morales; Celeste Georgianna,0,11,20,20
1683326627604,CAT 125R,C00,202411,Irwin; Matthew Joseph,0,10,20,20
1683326628631,CENG 15,A01,204712,Yang; Kesong,0,1,0,0
1683326629654,CENG 114,A00,202070,Jahed Motlagh; Zeinab,5,0,20,15
1683326630678,CGS 105,A00,185477,Wesling; Megan E.,24,0,40,16
1683326631703,CGS 106,A00,185494,Staff,13,0,22,9
1683326632730,CGS 108,A00,185495,Staff,14,0,20,6
1683326633757,CGS 114,A00,185496,Staff,13,0,18,5
1683326634783,CGS 119,A00,185501,Staff,15,0,20,5
1683326635809,CGS 120,A00,185511,Staff,13,0,20,7
1683326636838,CHEM 4,A01,184675,Bussey; Thomas J,96,0,100,4
1683326637865,CHEM 6A,A01,184677,Staff,34,0,60,26
1683326638892,CHEM 6B,A01,184679,Staff,65,0,100,35
1683326639914,CHEM 6C,A01,184681,Bussey; Thomas J,1,0,50,49
1683326639914,CHEM 6C,A02,184682,Bussey; Thomas J,34,0,50,16
1683326640941,CHEM 40A,A01,184684,Albizati; Kim F.,37,0,100,63
1683326641965,CHEM 40B,A01,184686,Albizati; Kim F.,0,20,100,100
1683326642993,CHEM 41B,A01,184690,Staff,52,0,100,48
1683326644017,COGS 3,A01,184715,Boyle; Mary E. T.,0,25,40,40
1683326645041,COGS 14B,A01,185172,Staff,0,15,38,38
1683326646069,COGS 18,A01,184736,Staff,17,0,80,63
1683326647093,COGS 100,A01,184932,Staff,0,5,73,73
1683326648131,COGS 101A,A01,184935,Staff,0,38,30,30
1683326649158,COGS 101B,A01,184944,Staff,0,2,30,30
1683326650183,COGS 101C,A01,184946,Staff,0,12,30,30
1683326651262,COGS 102A,A01,184951,Johnson; Christine M.,2,0,40,38
1683326652290,COGS 107B,A01,184953,Mooshagian; Eric Frederick,0,50,40,40
1683326653314,COGS 118B,A01,184959,Gupta; Anjum,0,48,40,40
1683326654341,COGS 153,A00,184961,Staff,0,15,30,30
1683326655368,COGS 177,A00,184962,Staff,0,20,30,30
1683326656395,COGS 187A,A01,184969,Boyle; Mary E. T.,0,17,40,40
1683326657423,COMM 10,A01,185174,Staff,0,5,25,25
1683326657423,COMM 10,A02,185189,Staff,0,5,25,25
1683326657423,COMM 10,A03,269821,Staff,0,0,0,0
1683326658448,COMM 100B,A01,185475,Staff,0,0,0,2
1683326658448,COMM 100B,A02,185476,Staff,14,0,25,11
1683326659475,COMM 100C,A01,185314,Staff,1,0,25,24
1683326659475,COMM 100C,A02,185327,Staff,19,0,25,6
1683326660503,COMM 110M,A00,185349,Staff,2,0,40,38
1683326661530,COMM 113T,A00,185352,Staff,25,0,40,15
1683326662554,COMM 114I,A00,185353,Staff,33,0,40,7
1683326663581,COMM 131,A00,185354,Staff,19,0,30,11
1683326664606,CSE 8A,A50,185358,Cao; Yingjun,0,46,10,10
1683326665632,CSE 8B,A01,185362,Staff,1,47,50,49
1683326666657,CSE 11,A01,185416,Cao; Yingjun,0,92,10,10
1683326667682,CSE 20,A01,185445,Briones; Jor-el Thomas Caparas,5,0,25,20
1683326668709,CSE 21,A01,185447,Staff,10,0,50,40
1683326669737,CSE 101,A01,185451,Staff,0,12,50,50
1683326669737,CSE 101,B01,185453,Jones; Miles E,0,11,50,50
1683326671788,CSE 141,A01,185458,Eldon; John,20,0,100,80
1683326672814,CSE 141L,A01,185461,Eldon; John,12,0,100,88
1683326673840,CSE 142,A01,185463,Staff,36,0,60,24
1683326673840,CSE 142,B01,201355,Staff,0,7,60,60
1683326674865,CSE 142L,A01,185470,Staff,36,0,60,24
1683326674865,CSE 142L,B01,201417,Staff,0,6,60,60
1683326675890,CSE 190,A00,201433,Staff,32,0,49,17
1683326676921,DOC 1,A01,259136,Strom; Megan C.,7,0,15,8
1683326676921,DOC 1,A02,259137,Strom; Megan C.,14,0,15,1
1683326676921,DOC 1,A03,259138,Strom; Megan C.,14,0,15,1
1683326676921,DOC 1,A04,259139,Strom; Megan C.,14,0,15,1
1683326677944,DOC 100D,A00,259140,Pass; Natalye Joann,16,0,25,9
1683326678971,DSGN 1,A01,184749,Rill; Bryan,0,26,30,30
1683326679995,DSGN 100,A01,185168,Staff,0,2,25,25
1683326681019,ECE 5,A01,185626,Morris; Karcher William,0,10,0,0
1683326682046,ECE 101,A01,185628,Staff,17,0,70,53
1683326683070,ECE 107,A01,185635,Baghdadchi; Saharnaz,0,0,20,20
1683326683070,ECE 107,A02,185638,Baghdadchi; Saharnaz,4,0,20,16
1683326684093,ECE 148,A01,185647,Silberman; Jack,0,0,16,16
1683326685116,ECON 1,A01,185537,Crane; Meredith Helen,54,0,70,16
1683326686138,ECON 3,A01,185549,Crane; Meredith Helen,33,0,70,37
1683326687166,ECON 4,A01,203354,Anderson; John Charles,0,4,10,10
1683326688190,ECON 100A,A01,185574,Staff,0,4,40,40
1683326689214,ECON 100B,A01,185576,Staff,0,22,40,40
1683326690242,ECON 100C,A01,185589,Newhouse; Herbert S,30,0,70,40
1683326691265,ECON 105,A00,185608,Vespa; Emanuel Ignacio,19,0,35,16
1683326692291,ECON 109,A01,185610,Shishkin; Denis,10,0,35,25
1683326693317,ECON 110A,A01,185612,Staff,11,0,40,29
1683326694341,ECON 120A,A01,185615,Staff,20,0,40,20
1683326695368,ECON 120C,A01,185617,Sun; Yixiao,0,20,70,70
1683326696400,ECON 144,A00,203346,Squires; Dale E,3,0,35,32
1683326697425,ECON 171,A01,203349,Newhouse; Herbert S,0,1,35,35
1683326698451,ECON 173A,A01,185621,Toda; Alexis Akira,21,0,35,14
1683326699476,EDS 25,A01,202413,Staff,0,1,0,0
1683326699476,EDS 25,A02,202414,Staff,0,1,0,0
1683326699476,EDS 25,A03,202415,Staff,0,0,0,0
1683326699476,EDS 25,A04,202416,Staff,0,1,0,0
1683326699476,EDS 25,A05,202439,Staff,0,0,0,0
1683326699476,EDS 25,A06,202440,Staff,0,0,0,0
1683326699476,EDS 25,B01,202631,Staff,0,0,0,0
1683326699476,EDS 25,B02,202632,Staff,0,0,0,0
1683326699476,EDS 25,B03,202639,Staff,0,0,0,0
1683326699476,EDS 25,B04,202640,Staff,0,0,0,0
1683326699476,EDS 25,B05,202643,Staff,0,0,0,0
1683326699476,EDS 25,B06,202644,Staff,0,0,0,0
1683326700510,EDS 38,A01,202659,Black; Alison Michelle,24,0,25,1
1683326701546,EDS 115,A00,202652,Staff,17,0,30,13
1683326702575,EDS 125,A00,202649,Staff,14,0,30,16
1683326703599,EDS 126,A01,203332,Staff,30,0,30,0
1683326704622,EDS 139,A00,202838,Staff,16,0,25,9
1683326705646,EDS 146,A01,202655,Staff,14,0,25,11
1683326706672,ENG 15,A00,185667,Staff,0,1,0,0
1683326706672,ENG 15,B00,185672,Staff,0,0,0,0
1683326706672,ENG 15,C00,185675,Staff,0,0,0,0
1683326706672,ENG 15,D00,185682,Staff,0,0,0,0
1683326706672,ENG 15,E00,185684,Staff,0,0,0,0
1683326707696,ETHN 103,A00,185710,Staff,0,3,35,35
1683326708722,ETHN 103A,A00,199228,Man; Simeon S,2,0,9,7
1683326709749,ETHN 109,A00,185711,Staff,18,0,35,17
1683326710777,ETHN 142,A00,185726,Staff,0,4,30,30
1683326711800,ETHN 163J,A00,199229,Man; Simeon S,5,0,8,3
1683326712824,ETHN 168,A00,185727,Staff,8,0,10,2
1683326713850,ETHN 182,A00,185728,Staff,1,0,35,34
1683326714873,ETHN 183,A00,185737,Staff,8,0,18,10
1683326715900,GLBH 111,A01,209361,Burgos; Jose L.,0,0,0,0
1683326717948,HIEU 104,A00,185792,Staff,16,0,20,4
1683326718973,HIEU 115,A00,185800,Staff,1,0,20,19
1683326719998,HIEU 128,A00,185801,Staff,0,7,20,20
1683326721023,HIEU 147,A00,185802,Staff,16,0,20,4
1683326722050,HIEU 154,A00,185823,Staff,12,0,20,8
1683326723076,HILA 102,A00,185826,Staff,13,0,20,7
1683326724104,HILD 2C,A01,185778,Staff,0,12,20,20
1683326725130,HILD 7B,A01,185780,Kwak; Nancy,0,15,32,32
1683326725130,HILD 7B,A02,185781,Kwak; Nancy,0,18,32,32
1683326726157,HILD 30,A01,185791,Staff,14,0,20,6
1683326727182,HISC 119,A00,185830,Golan; Tal,0,9,20,20
1683326728205,HITO 156GS,A00,185831,Patterson; Patrick H.,0,0,0,23
1683326729233,HIUS 103,A00,185832,Man; Simeon S,0,6,20,20
1683326730259,HIUS 117,A00,185836,Kwak; Nancy,2,0,20,18
1683326731287,HIUS 125,A00,185840,Man; Simeon S,0,0,23,23
1683326732314,HIUS 149,A00,185845,Staff,0,0,20,20
1683326733339,HUM 3,A01,185882,Zavodny; Tatiana Sophia,0,7,50,50
1683326733339,HUM 3,B01,185899,Caldwell; Michael Alan,0,18,50,50
1683326734365,HUM 3GS,A00,185900,Patterson; Patrick H.,0,0,0,23
1683326735388,HUM 4,A01,185938,Zroka; Amy Liane,31,0,50,19
1683326735388,HUM 4,B01,185956,Watkins; Eric,0,2,50,50
1683326735388,HUM 4,B02,202209,Watkins; Eric,0,2,50,50
1683326735388,HUM 4,B03,202210,Watkins; Eric,0,2,50,50
1683326736412,HUM 5,A01,185958,West; Geoffrey Scott,3,0,50,47
1683326736412,HUM 5,A02,202215,West; Geoffrey Scott,0,0,50,50
1683326737438,INTL 190,A00,185959,Gagnon; Jeffrey C,0,0,0,9
1683326737438,INTL 190,B00,185960,Lettieri; Michael Joseph,0,0,0,1
1683326738463,JAPN 180,A00,254509,Staff,5,1,30,25
1683326739487,LATI 10,A01,202853,Kennemore; Amy Michelle,4,0,35,31
1683326739487,LATI 10,A02,202854,Kennemore; Amy Michelle,2,0,35,33
1683326739487,LATI 10,A03,270054,Kennemore; Amy Michelle,30,0,30,0
1683326740514,LATI 180,A00,202855,Kennemore; Amy Michelle,11,0,20,9
1683326741541,LAWS 101,A00,201767,Golan; Tal,0,7,40,40
1683326742567,LIFR 1C,A00,185961,Staff,6,0,20,14
1683326743590,LIFR 1CX,A00,185962,Staff,7,0,20,13
1683326744614,LIFR 1D,A00,185963,Staff,9,0,20,11
1683326745639,LIFR 1DX,A00,185964,Staff,9,0,20,11
1683326746666,LIGN 101,A01,186039,Staff,43,0,50,7
1683326747690,LIGN 165,A00,186040,Staff,18,0,50,32
1683326748718,LTCS 108,A00,186041,Staff,6,0,10,4
1683326749742,LTCS 119,A00,186042,Staff,16,0,20,4
1683326750766,LTCS 130,A00,186043,Wesling; Megan E.,15,0,25,10
1683326752814,LTEA 138,A00,186119,Staff,14,0,40,26
1683326753837,LTEN 124,A00,186148,Staff,6,0,25,19
1683326754918,LTEN 178,A00,186149,Staff,7,0,15,8
1683326755943,LTEN 181,A00,186150,Blanco; John D,33,0,40,7
1683326756970,LTWL 120,A00,186160,Staff,20,0,25,5
1683326757996,LTWL 165,A00,186161,Staff,22,0,25,3
1683326759021,LTWR 100,A00,186162,Staff,0,5,15,15
1683326760049,LTWR 102,A00,186163,Doller; Ben,5,0,15,10
1683326761098,MAE 8,A01,186412,Staff,0,0,0,0
1683326762122,MAE 30B,A00,186445,Bahadori; Mohammad Yousef,83,0,100,17
1683326763149,MAE 40,A00,186592,Bewley; Thomas R,9,0,50,41
1683326764173,MAE 101B,A00,186593,Bahadori; Mohammad Yousef,81,0,100,19
1683326765198,MAE 105,A00,186594,Bandaru; Prabhakar,12,0,50,38
1683326766221,MAE 107,A00,186599,Pham; Hieu Tan,0,6,120,120
1683326767247,MAE 148,A01,186660,Silberman; Jack,3,0,16,13
1683326768273,MATH 10A,A01,188095,Staff,1,6,35,34
1683326769298,MATH 10B,A01,188097,Bowers; Adam R.,0,11,30,30
1683326769298,MATH 10B,A02,188099,Bowers; Adam R.,0,11,30,30
1683326769298,MATH 10B,B01,188104,Bowers; Adam R.,0,10,30,30
1683326769298,MATH 10B,B02,188106,Bowers; Adam R.,0,10,30,30
1683326770327,MATH 10C,A01,188111,Staff,0,18,30,30
1683326770327,MATH 10C,A02,188127,Staff,0,17,30,30
1683326770327,MATH 10C,A03,188131,Staff,0,18,30,30
1683326770327,MATH 10C,B01,188218,Staff,18,0,30,12
1683326770327,MATH 10C,B02,188244,Staff,13,0,30,17
1683326770327,MATH 10C,B03,188277,Staff,16,0,30,14
1683326771352,MATH 18,A01,188344,Bach; Quang Tran,18,0,30,12
1683326771352,MATH 18,A02,188345,Bach; Quang Tran,11,0,30,19
1683326771352,MATH 18,B01,188353,Bach; Quang Tran,10,0,30,20
1683326771352,MATH 18,B02,188354,Bach; Quang Tran,20,0,30,10
1683326772375,MATH 20A,A01,188374,Staff,13,0,35,22
1683326773399,MATH 20B,A01,188382,Ohm; Ko Woon,6,0,30,24
1683326773399,MATH 20B,A02,188383,Ohm; Ko Woon,22,0,30,8
1683326773399,MATH 20B,B01,188385,Ohm; Ko Woon,7,0,30,23
1683326773399,MATH 20B,B02,188392,Ohm; Ko Woon,22,0,30,8
1683326774427,MATH 20C,A01,188394,Harel; Guershon,10,0,30,20
1683326774427,MATH 20C,A02,188395,Harel; Guershon,14,0,30,16
1683326774427,MATH 20C,B01,188404,Harel; Guershon,5,0,30,25
1683326774427,MATH 20C,B02,188405,Harel; Guershon,19,0,30,11
1683326775453,MATH 20D,A01,188414,Hammock; Frances H,0,1,30,30
1683326775453,MATH 20D,A02,188415,Hammock; Frances H,3,0,30,27
1683326775453,MATH 20D,B01,188447,Hammock; Frances H,2,0,30,28
1683326775453,MATH 20D,B02,188486,Hammock; Frances H,8,0,30,22
1683326776481,MATH 20E,A01,188649,Staff,21,0,30,9
1683326776481,MATH 20E,A02,188650,Staff,23,0,30,7
1683326776481,MATH 20E,A03,188673,Staff,0,0,30,30
1683326777506,MATH 102,A01,188675,Staff,0,35,35,35
1683326778534,MATH 103B,A01,188681,Staff,3,0,35,32
1683326778534,MATH 103B,B01,188692,Staff,5,0,35,30
1683326779559,MATH 109,A01,188695,Salehi Golsefidy; Alireza,25,0,35,10
1683326779559,MATH 109,A02,188696,Salehi Golsefidy; Alireza,26,0,35,9
1683326780584,MATH 120A,A01,188698,Eggers; John Dietrich,7,0,35,28
1683326781609,MATH 142B,A01,188736,Ioana; Adrian,0,2,30,30
1683326781609,MATH 142B,A02,188741,Ioana; Adrian,0,1,30,30
1683326781609,MATH 142B,A03,188743,Ioana; Adrian,1,3,30,29
1683326782636,MATH 168A,A01,188790,Staff,0,9,35,35
1683326783666,MATH 170A,A01,188803,Nie; Jiawang,0,2,35,35
1683326783666,MATH 170A,A02,188811,Nie; Jiawang,0,0,35,35
1683326783666,MATH 170A,A03,188814,Nie; Jiawang,1,0,35,34
1683326783666,MATH 170A,A04,188815,Nie; Jiawang,13,0,35,22
1683326784692,MATH 193B,A01,188817,Staff,0,0,35,35
1683326784692,MATH 193B,A02,188818,Staff,5,0,35,30
1683326785716,MGT 4,A01,202857,Anderson; John Charles,62,0,80,18
1683326786741,MGT 12,A00,202858,Lindenberger; Wade Douglas,42,0,90,48
1683326787769,MGT 18,A00,202859,Staff,74,0,90,16
1683326788796,MGT 18GS,A00,202860,McKay; Michael J,13,0,28,15
1683326789823,MGT 45,A00,202861,Pecore; Joseph P.,13,0,90,77
1683326790848,MGT 100,A00,202863,Yavorsky; Daniel Ryan,28,0,90,62
1683326791873,MGT 103,A00,202864,Ehrich; Kristine R,0,18,90,90
1683326792897,MGT 112,A00,202865,Ehrich; Kristine R,15,0,90,75
1683326793921,MGT 121A,A00,202868,Staff,0,20,0,0
1683326794948,MGT 131B,A00,202869,Anderson; John Charles,59,0,90,31
1683326795981,MGT 136,A00,202871,Lindenberger; Wade Douglas,84,0,90,6
1683326797009,MGT 164,A00,202873,Staff,0,68,90,91
1683326798033,MGT 164GS,A00,202874,McKay; Mary A,13,0,28,15
1683326799061,MGT 180,A00,202875,Staff,0,50,90,91
1683326800086,MMW 11R,A01,205019,Herbst; Matthew,3,0,30,27
1683326800086,MMW 11R,A02,205026,Herbst; Matthew,29,0,30,1
1683326801113,MMW 15,A01,193512,Chang; Edmond Yi-Teh,0,9,28,28
1683326801113,MMW 15,A02,193513,Chang; Edmond Yi-Teh,0,5,28,28
1683326801113,MMW 15,A03,193514,Chang; Edmond Yi-Teh,0,5,28,28
1683326801113,MMW 15,A04,193515,Chang; Edmond Yi-Teh,0,5,28,28
1683326801113,MMW 15,A05,193516,Chang; Edmond Yi-Teh,0,4,28,28
1683326801113,MMW 15,A06,193517,Chang; Edmond Yi-Teh,0,5,28,28
1683326801113,MMW 15,B01,193519,Chang; Edmond Yi-Teh,0,5,28,28
1683326801113,MMW 15,B02,193520,Chang; Edmond Yi-Teh,0,5,28,28
1683326801113,MMW 15,B03,193521,Chang; Edmond Yi-Teh,0,5,28,28
1683326801113,MMW 15,B04,193522,Chang; Edmond Yi-Teh,0,4,28,28
1683326801113,MMW 15,B05,193523,Chang; Edmond Yi-Teh,0,5,28,28
1683326801113,MMW 15,B06,193524,Chang; Edmond Yi-Teh,0,4,28,28
1683326802141,MMW 122,A01,193526,Rahimi; Babak,0,15,28,28
1683326802141,MMW 122,A02,193527,Rahimi; Babak,0,14,28,28
1683326802141,MMW 122,A03,193528,Rahimi; Babak,0,0,0,0
1683326802141,MMW 122,A04,193529,Rahimi; Babak,0,0,0,0
1683326803166,MUS 1A,A01,186663,Staff,0,20,35,35
1683326804193,MUS 4,A01,186715,Staff,0,12,35,35
1683326805221,MUS 5R,A01,186796,Dubnov; Shlomo,0,17,35,35
1683326806246,MUS 6,A01,186798,Staff,0,4,25,25
1683326807271,MUS 7,A01,186830,Staff,12,0,35,23
1683326808298,MUS 8,A01,186930,Staff,0,27,35,35
1683326809326,MUS 15,A01,186932,Staff,0,16,35,35
1683326809326,MUS 15,B01,186934,Staff,0,15,35,35
1683326810350,MUS 80,A00,186935,Staff,1,0,20,19
1683326810350,MUS 80,B00,186936,Staff,25,0,25,0
1683326811374,NANO 11,A00,204702,Lipomi; Darren John,0,0,0,0
1683326812401,NANO 15,A01,204709,Yang; Kesong,0,1,0,0
1683326813428,NANO 114,A00,202069,Jahed Motlagh; Zeinab,3,0,10,7
1683326814454,PHIL 1,A00,186955,Grush; Rick Scott,32,0,40,8
1683326815481,PHIL 10,A01,186973,Grush; Rick Scott,28,0,35,7
1683326815481,PHIL 10,A02,186974,Grush; Rick Scott,33,0,35,2
1683326816506,PHIL 13,A01,186976,Staff,7,0,35,28
1683326816506,PHIL 13,A02,186977,Staff,16,0,35,19
1683326817531,PHIL 14,A01,186979,Staff,31,0,35,4
1683326817531,PHIL 14,A02,186986,Staff,32,0,35,3
1683326818554,PHIL 28,A01,186988,Staff,16,0,30,14
1683326818554,PHIL 28,A02,186989,Staff,1,0,30,29
1683326818554,PHIL 28,A03,186990,Staff,9,0,30,21
1683326818554,PHIL 28,A04,186991,Staff,26,0,30,4
1683326819582,PHIL 120,A00,186997,Staff,23,0,40,17
1683326820607,PHIL 137,A00,187003,Staff,9,0,40,31
1683326821632,PHIL 150,A00,187015,Staff,47,0,70,23
1683326822660,PHIL 167,A00,187021,Lamey; Andy M.,35,0,40,5
1683326823703,PHIL 174,A01,202226,Staff,17,0,20,3
1683326823703,PHIL 174,A02,202235,Staff,20,0,20,0
1683326824727,PHIL 191A,A00,258918,Staff,0,0,1,1
1683326825753,PHYS 1A,A00,187028,Staff,27,0,60,33
1683326826778,PHYS 1AL,001,187036,Staff,3,0,30,27
1683326826778,PHYS 1AL,002,187049,Staff,18,0,30,12
1683326827805,PHYS 1B,A00,187058,Staff,22,0,60,38
1683326828835,PHYS 1BL,001,187064,Staff,0,0,30,30
1683326828835,PHYS 1BL,002,187070,Staff,5,0,30,25
1683326829861,PHYS 1C,A00,187082,Staff,31,0,120,89
1683326830889,PHYS 1CL,001,187088,Staff,0,9,30,30
1683326830889,PHYS 1CL,002,187089,Staff,0,2,30,30
1683326830889,PHYS 1CL,009,262693,Staff,11,0,30,19
1683326831914,PHYS 2B,A01,187097,Staff,54,0,115,61
1683326832939,PHYS 2C,A01,187099,Staff,67,0,115,48
1683326833969,PHYS 2CL,A01,187101,Staff,5,0,28,23
1683326833969,PHYS 2CL,A02,187102,Staff,15,0,28,13
1683326834997,PHYS 2D,A01,187123,Shotwell; Brian,95,0,115,20
1683326836025,PHYS 4B,A01,187133,Grinstein; Benjamin,35,0,50,15
1683326837051,POLI 10,A00,188819,Staff,0,4,50,50
1683326838075,POLI 11,A00,188827,Staff,43,0,50,7
1683326839099,POLI 13R,A00,188828,Staff,0,1,20,20
1683326840123,POLI 27,A01,188830,Elgin; Samuel Zincke,0,1,70,70
1683326841148,POLI 30,A00,188832,Desposato; Scott,31,0,50,19
1683326842173,POLI 102F,A00,188834,Staff,3,0,40,37
1683326843197,POLI 104A,A00,188852,Staff,14,0,30,16
1683326844222,POLI 104I,A00,188853,Staff,0,6,20,20
1683326845249,POLI 110B,A00,188854,Wiens; David,7,0,20,13
1683326846281,POLI 112A,A00,188855,Wiens; David,5,0,30,25
1683326847309,POLI 117R,A00,188856,Forman; Fonna,0,11,20,20
1683326848334,POLI 118,A00,188857,Ingham; Sean,8,0,20,12
1683326849361,POLI 120G,A00,188858,Staff,9,0,30,21
1683326850386,POLI 131CR,A00,188863,Hoston; Germaine,24,0,50,26
1683326851409,POLI 133,A00,188864,Nellis; Gareth Hb,44,0,50,6
1683326852433,POLI 134D,A00,188865,Desposato; Scott,27,0,30,3
1683326853461,POLI 142A,A00,188871,Gartzke; Erik,22,0,50,28
1683326854484,POLI 142K,A00,188874,Staff,38,0,50,12
1683326855508,POLI 143,A00,188940,Gartzke; Erik,16,0,30,14
1683326856535,POLI 153,A00,188943,Staff,3,0,20,17
1683326857561,POLI 160AA,A00,188944,Staff,12,0,40,28
1683326858658,POLI 170A,A00,188945,Staff,11,0,30,19
1683326860713,PSYC 1,A00,188952,Staff,37,0,90,53
1683326861739,PSYC 2,B00,188953,Staff,19,0,35,16
1683326862762,PSYC 6,A00,188970,Staff,47,0,60,13
1683326863787,PSYC 7,A00,188973,Staff,37,0,45,8
1683326864813,PSYC 60,A01,188980,Rickard; Timothy C.,43,0,60,17
1683326865840,PSYC 70,A01,189001,Steiner; Eric Tomas,24,0,45,21
1683326866863,PSYC 100,A00,189005,Lacefield; Katharine I,0,100,120,120
1683326867891,PSYC 102,A00,189008,Staff,9,0,30,21
1683326868916,PSYC 106,B00,189026,Gorman; Michael R.,34,0,60,26
1683326869940,PSYC 114,B01,189033,Winkielman; Piotr,0,32,30,30
1683326870965,PSYC 131,A00,189036,Anagnostaras; Stephan,0,43,60,60
1683326871991,PSYC 136,A00,189041,Lowe; Angela Beth,0,7,25,25
1683326873019,PSYC 137,A00,189057,Winkielman; Piotr,0,34,25,25
1683326874045,PSYC 144,A00,189107,Wixted; John T,0,7,50,50
1683326876097,PSYC 162,A00,189142,Staff,0,8,85,85
1683326877124,PSYC 172,A00,189144,Gorman; Michael R.,0,7,30,30
1683326879181,PSYC 179,A00,189146,Lacefield; Katharine I,0,84,120,120
1683326880205,PSYC 181,A00,189147,Anagnostaras; Stephan,0,44,90,90
1683326881233,PSYC 190R,A00,189148,Barner; David A.,0,22,80,80
1683326882261,PSYC 191,A00,189275,Rickard; Timothy C.,0,7,25,25
1683326883288,PSYC 193,A00,189276,Chapman; Eddie Nathaniel,0,1,0,4
1683326884317,PSYC 193L,A01,189281,Lowe; Angela Beth,12,0,20,8
1683326884317,PSYC 193L,B01,189285,Staff,28,0,35,7
1683326885340,RELI 149,A00,187137,Rahimi; Babak,7,0,40,33
1683326886368,SE 9,A01,187315,Staff,0,2,18,18
1683326887393,SE 101B,A00,187409,Staff,24,0,30,6
1683326888419,SE 110B,A00,187444,Staff,10,0,40,30
1683326889445,SE 130B,A00,187449,Staff,31,0,40,9
1683326890469,SE 150A,A00,187516,Staff,9,0,20,11
1683326891497,SE 154,A00,187528,Staff,30,0,50,20
1683326892527,SIO 3,A01,258171,Staff,35,0,40,5
1683326893551,SIO 10,A00,187144,Cook; Geoffrey W,0,3,75,75
1683326894582,SIO 45,A00,187152,Cook; Geoffrey W,1,0,100,99
1683326895609,SIO 109R,A00,194486,Staff,0,3,20,20
1683326897662,SIO 187,A01,187233,Kacev; David,12,0,40,28
1683326898687,SOCI 1,A01,258656,Thorpe; Charles Robert,28,0,30,2
1683326898687,SOCI 1,A02,258658,Thorpe; Charles Robert,30,0,30,0
1683326898687,SOCI 1,A03,258661,Thorpe; Charles Robert,25,0,25,0
1683326898687,SOCI 1,A04,258666,Thorpe; Charles Robert,22,0,25,3
1683326898687,SOCI 1,A05,258897,Thorpe; Charles Robert,23,0,25,2
1683326898687,SOCI 1,A06,258898,Thorpe; Charles Robert,25,0,25,0
1683326899711,SOCI 30,A01,258903,Pardo Guerra; Juan Pablo,15,0,30,15
1683326900736,SOCI 102,A00,258904,Staff,9,0,25,16
1683326901760,SOCI 106,A00,258905,Staff,19,0,25,6
1683326902793,SOCI 111,A00,258907,Ribas Norris; Janet Vanesa,26,0,30,4
1683326903818,SOCI 121R,A00,258908,Pardo Guerra; Juan Pablo,10,0,30,20
1683326904845,SOCI 126,A01,203330,Staff,14,0,20,6
1683326905869,SOCI 131,A00,258909,Thorpe; Charles Robert,31,0,60,29
1683326906897,SOCI 135,A00,258910,Payne; Christine Anna,0,9,30,30
1683326907921,SOCI 157,A00,258911,Staff,12,0,30,18
1683326908947,SOCI 184,A00,258912,Staff,25,0,30,5
1683326909972,SOCI 188D,A00,258913,Staff,21,0,30,9
1683326911001,SYN 2,001,187529,Staff,9,0,16,7
1683326911001,SYN 2,002,201452,Staff,0,18,16,16
1683326911001,SYN 2,003,201469,Staff,4,0,16,12
1683326912029,SYN 100,A01,187531,Staff,0,9,20,20
1683326912029,SYN 100,B01,201491,Staff,0,12,20,20
1683326913054,TDAC 1,A00,189286,Walsh; Kim C.,3,0,20,17
1683326913054,TDAC 1,B00,189287,Harting; Carla Kelso,11,0,20,9
1683326914078,TDAC 101,A00,189300,Walsh; Kim C.,16,0,20,4
1683326914078,TDAC 101,B00,189301,Harting; Carla Kelso,18,0,20,2
1683326915105,TDAC 102,A00,189304,Basso; Beatrice,14,0,20,6
1683326916129,TDAC 108,A00,189305,Staff,18,0,20,2
1683326917155,TDDE 131,A00,189310,Staff,19,0,20,1
1683326917155,TDDE 131,B00,189314,Staff,19,0,20,1
1683326917155,TDDE 131,C00,189315,Staff,48,0,50,2
1683326917155,TDDE 131,D00,189316,Staff,14,0,15,1
1683326917155,TDDE 131,E00,204841,Staff,20,0,20,0
1683326918183,TDGE 10,A00,189289,Staff,30,0,50,20
1683326918183,TDGE 10,B00,189290,Havis; Allan,1,0,50,49
1683326919211,TDGE 11,A00,189291,Fulton; Julia,0,3,50,50
1683326919211,TDGE 11,B00,189292,Staff,20,0,25,5
1683326919211,TDGE 11,C00,260270,Staff,0,0,0,0
1683326920234,TDGE 25,A00,189294,Staff,3,0,20,17
1683326921259,TDGE 124,A00,189318,Fulton; Julia,0,8,50,50
1683326922283,TDGE 125,A00,189319,Staff,13,0,25,12
1683326922283,TDGE 125,B00,189320,Staff,23,0,25,2
1683326923309,TDGE 127,A00,189322,Havis; Allan,0,0,50,50
1683326924335,TDHT 101,A00,189323,Staff,18,0,25,7
1683326924335,TDHT 101,B00,189324,Staff,25,0,25,0
1683326925360,TDHT 102,A00,189325,Staff,49,0,50,1
1683326926384,TDMV 1,A00,189295,Arcidiacono; Kristin,19,0,30,11
1683326926384,TDMV 1,B00,189296,Caligagan; Maria T.,24,0,30,6
1683326927412,TDMV 2,A00,189297,Sammartano; Tonnie,28,0,30,2
1683326927412,TDMV 2,B00,189299,Arcidiacono; Kristin,24,0,30,6
1683326928439,TDMV 3,A00,204998,Rincon; Alicia,22,0,30,8
1683326929462,TDMV 120,A00,189458,Sammartano; Tonnie,28,0,30,2
1683326930489,TDMV 138,A00,189541,Jun; Grace Shin Hae,22,0,40,18
1683326931515,TDMV 142,A00,189717,Caligagan; Tony,23,0,30,7
1683326931515,TDMV 142,B00,189718,Caligagan; Maria T.,25,0,30,5
1683326932539,TMC 2,A01,187533,Staff,25,0,25,0
1683326932539,TMC 2,A02,187534,Staff,25,0,25,0
1683326933568,USP 1,A01,187536,Kwak; Nancy,0,16,25,25
1683326934593,USP 5,A01,187538,Staff,10,0,25,15
1683326935617,USP 101,A00,199253,Staff,0,4,0,0
1683326936642,USP 124,A00,187562,Boomhower; Matthew Charles,1,0,30,29
1683326937666,USP 138,A00,187582,Staff,20,0,25,5
1683326938690,USP 152,A01,187597,Staff,4,0,25,21
1683326939714,USP 153,A00,187598,Staff,19,0,25,6
1683326940740,USP 168,A00,187607,Kwak; Nancy,2,0,5,3
1683326941764,USP 173,A00,187619,Staff,4,0,25,21
1683326942789,USP 181,A00,187638,Staff,0,0,25,25
1683326943816,VIS 103,A00,187650,Cruz; Edwin Teddy,23,0,75,52
1683326944841,VIS 110D,A00,187669,Staff,12,0,22,10
1683326945866,VIS 127C,A00,187720,Shen; Kuiyi,67,0,146,79
1683326946890,VIS 149,A00,187731,Yoldas; Pinar,0,14,22,22
1683326947914,VIS 151,A01,188091,Staff,22,0,34,12
1683326947914,VIS 151,A02,188092,Staff,11,0,34,23
1683326948938,VIS 160B,A00,188093,Stalbaum; Brett,0,0,10,10
1683326950987,WCWP 10B,A00,201720,Staff,10,0,15,5
1683326950987,WCWP 10B,B00,201722,Staff,8,0,15,7
1683326952011,WCWP 100,A00,201725,Gagnon; Jeffrey C,0,0,2,2
1683326952011,WCWP 100,B00,201727,Staff,0,4,15,15
1683326955132,ANBI 133,A00,258401,Wilder; Linnea Lorene,34,0,40,6
1683326956159,ANBI 140,A00,258395,Hrvoj Mihic; Branka,18,0,25,7
1683326957183,ANSC 120,A00,258402,Bialecki; Jon Anthony,27,0,40,13
1683326958209,ANSC 144,A00,258400,Staff,14,0,40,26
1683326960259,ANSC 166,A00,258396,Parish; Steven Martin,157,0,175,18
1683326961283,ANSC 180,A00,193533,Staff,9,0,20,11
1683326962370,ANSC 188,A00,258397,Jassal; Aftab,33,0,40,7
1683326963394,ANTH 3,A01,258316,Staff,23,0,30,7
1683326964418,ANTH 5,A00,258394,Semendeferi; Ekaterini,16,0,20,4
1683326965442,ANTH 21,A01,258331,Staff,8,0,40,32
1683326966466,ANTH 103,A00,258398,Varma; Saiba,15,0,25,10
1683326967497,AWP 10,001,202034,Staff,0,0,0,0
1683326967497,AWP 10,002,202035,Staff,0,0,0,0
1683326967497,AWP 10,003,202036,Staff,0,0,0,0
1683326967497,AWP 10,004,202037,Staff,0,0,0,0
1683326967497,AWP 10,005,202038,Staff,0,0,0,0
1683326967497,AWP 10,006,202039,Staff,0,0,0,0
1683326967497,AWP 10,007,202040,Staff,0,0,0,0
1683326967497,AWP 10,008,202041,Staff,0,0,0,0
1683326967497,AWP 10,009,202042,Staff,0,0,0,0
1683326967497,AWP 10,010,202043,Staff,0,0,0,0
1683326967497,AWP 10,011,202044,Staff,0,0,0,0
1683326967497,AWP 10,012,202045,Staff,0,0,0,0
1683326967497,AWP 10,013,202046,Staff,0,0,0,0
1683326967497,AWP 10,014,202047,Staff,0,0,0,0
1683326967497,AWP 10,015,202048,Staff,0,0,0,0
1683326967497,AWP 10,016,202049,Staff,0,0,0,0
1683326967497,AWP 10,017,202050,Staff,0,0,0,0
1683326967497,AWP 10,018,202051,Staff,0,0,0,0
1683326967497,AWP 10,019,202052,Staff,0,0,0,0
1683326967497,AWP 10,020,202053,Staff,0,0,0,0
1683326967497,AWP 10,021,202054,Staff,0,0,0,0
1683326967497,AWP 10,022,202055,Staff,0,0,0,0
1683326967497,AWP 10,023,202056,Staff,0,0,0,0
1683326967497,AWP 10,024,202057,Staff,0,0,0,0
1683326967497,AWP 10,025,202058,Staff,0,0,0,0
1683326967497,AWP 10,026,202059,Staff,0,0,0,0
1683326968522,AWP 102,001,202032,Staff,0,0,0,0
1683326968522,AWP 102,002,202033,Staff,0,0,0,0
1683326969549,BENG 100,A01,254234,Taylor Amos; Alyssa C,31,0,40,9
1683326970574,BENG 196,001,270013,Engler; Adam J.,9999,0,9999,0
1683326971604,BICD 100R,A01,202018,Smith; Laurie,0,7,32,32
1683326971604,BICD 100R,A02,202019,Smith; Laurie,0,2,32,32
1683326971604,BICD 100R,A03,202020,Smith; Laurie,0,1,32,32
1683326971604,BICD 100R,A04,202021,Smith; Laurie,9,0,32,23
1683326971604,BICD 100R,A05,202022,Smith; Laurie,12,0,32,20
1683326972631,BICD 136,A01,193242,Gustafson-Brown; Cindy,0,2,32,32
1683326972631,BICD 136,A02,193244,Gustafson-Brown; Cindy,14,0,32,18
1683326973662,BIEB 102,A01,193249,Butler; Shannon Rhey,0,2,32,32
1683326973662,BIEB 102,A02,193251,Butler; Shannon Rhey,0,0,32,32
1683326973662,BIEB 102,A03,193253,Butler; Shannon Rhey,0,1,32,32
1683326973662,BIEB 102,A04,193255,Butler; Shannon Rhey,17,0,32,15
1683326973662,BIEB 102,A05,193265,Butler; Shannon Rhey,26,0,32,6
1683326973662,BIEB 102,A06,193269,Butler; Shannon Rhey,16,0,32,16
1683326975713,BIEB 150,A01,193274,Staff,0,0,32,32
1683326975713,BIEB 150,A02,193285,Staff,23,0,32,9
1683326976736,BIEB 194,A00,193286,Kurle; Carolyn M.,22,0,32,10
1683326977764,BILD 1,A01,192291,Staff,16,0,32,16
1683326977764,BILD 1,A02,192292,Staff,30,0,32,2
1683326977764,BILD 1,B01,192520,Reuther; Keefe,0,1,0,0
1683326977764,BILD 1,B02,192532,Reuther; Keefe,0,1,0,0
1683326978790,BILD 3,A01,192556,Butler; Shannon Rhey,0,0,32,32
1683326978790,BILD 3,A02,192581,Butler; Shannon Rhey,5,0,32,27
1683326978790,BILD 3,A03,192611,Butler; Shannon Rhey,23,0,32,9
1683326978790,BILD 3,A04,192612,Butler; Shannon Rhey,25,0,32,7
1683326978790,BILD 3,A05,192613,Butler; Shannon Rhey,27,0,32,5
1683326978790,BILD 3,A06,192679,Butler; Shannon Rhey,27,0,32,5
1683326978790,BILD 3,A07,192682,Butler; Shannon Rhey,22,0,32,10
1683326979816,BILD 4,A01,192836,Reuther; Keefe,0,0,24,24
1683326979816,BILD 4,A02,193044,Reuther; Keefe,4,0,24,20
1683326980840,BILD 10,A01,193142,Gustafson-Brown; Cindy,30,0,32,2
1683326980840,BILD 10,A02,193149,Gustafson-Brown; Cindy,31,0,32,1
1683326981866,BIMM 100,A01,193301,Staff,0,6,32,32
1683326981866,BIMM 100,A02,193312,Staff,0,5,32,32
1683326981866,BIMM 100,A03,193323,Staff,0,8,32,32
1683326982897,BIMM 101,A01,193329,McDonnell; Lisa Marie,0,3,24,24
1683326982897,BIMM 101,A02,193339,McDonnell; Lisa Marie,0,3,24,24
1683326982897,BIMM 101,B01,193354,McDonnell; Lisa Marie,0,3,24,24
1683326982897,BIMM 101,B02,193357,McDonnell; Lisa Marie,0,3,24,24
1683326983921,BIMM 110,A01,193377,Tat; John,0,11,32,32
1683326983921,BIMM 110,A02,193378,Tat; John,1,9,32,31
1683326984959,BIMM 120,A01,206116,Staff,0,0,32,32
1683326984959,BIMM 120,A02,206117,Staff,8,0,32,24
1683326984959,BIMM 120,A03,206121,Staff,21,0,32,11
1683326985987,BIPN 100,A01,193393,Park; Ji Young,0,14,32,32
1683326985987,BIPN 100,A02,193402,Park; Ji Young,0,13,32,32
1683326985987,BIPN 100,A03,193413,Park; Ji Young,0,14,32,32
1683326985987,BIPN 100,A04,193414,Park; Ji Young,0,13,32,32
1683326987015,BIPN 102,A01,193429,Staff,0,0,32,32
1683326987015,BIPN 102,A02,193438,Staff,22,0,32,10
1683326988038,BIPN 106,A01,193450,Reyes Gonzalez; Catalina,0,2,40,40
1683326989066,BIPN 134,A01,193465,Cooke; James Edward,0,0,32,32
1683326989066,BIPN 134,A02,193474,Cooke; James Edward,25,0,32,7
1683326989066,BIPN 134,A03,193485,Cooke; James Edward,29,0,32,3
1683326989066,BIPN 134,A04,193486,Cooke; James Edward,21,0,32,11
1683326989066,BIPN 134,A05,193491,Cooke; James Edward,31,0,32,1
1683326989066,BIPN 134,A06,193501,Cooke; James Edward,30,0,32,2
1683326989066,BIPN 134,A07,193510,Cooke; James Edward,29,0,32,3
1683326991118,BISP 194,A00,222522,Staff,14,0,32,18
1683326992146,CAT 124,A01,202407,Staff,20,0,25,5
1683326993169,CAT 125,A00,202408,Marchisotto; Jennifer Anne,4,0,20,16
1683326994193,CAT 125R,A00,202409,Smith; Lauryn Alissa,0,11,20,20
1683326994193,CAT 125R,B00,202410,Morales; Celeste Georgianna,0,11,20,20
1683326994193,CAT 125R,C00,202411,Irwin; Matthew Joseph,0,10,20,20
1683326995221,CENG 15,A01,204712,Yang; Kesong,0,1,0,0
1683326996246,CENG 114,A00,202070,Jahed Motlagh; Zeinab,5,0,20,15
1683326997270,CGS 105,A00,185477,Wesling; Megan E.,24,0,40,16
1683326998292,CGS 106,A00,185494,Staff,13,0,22,9
1683326999318,CGS 108,A00,185495,Staff,14,0,20,6
1683327000343,CGS 114,A00,185496,Staff,13,0,18,5
1683327001366,CGS 119,A00,185501,Staff,15,0,20,5
1683327002393,CGS 120,A00,185511,Staff,13,0,20,7
1683327003419,CHEM 4,A01,184675,Bussey; Thomas J,96,0,100,4
1683327004449,CHEM 6A,A01,184677,Staff,34,0,60,26
1683327005476,CHEM 6B,A01,184679,Staff,65,0,100,35
1683327006499,CHEM 6C,A01,184681,Bussey; Thomas J,1,0,50,49
1683327006499,CHEM 6C,A02,184682,Bussey; Thomas J,34,0,50,16
1683327007524,CHEM 40A,A01,184684,Albizati; Kim F.,37,0,100,63
1683327008552,CHEM 40B,A01,184686,Albizati; Kim F.,0,20,100,100
1683327009578,CHEM 41B,A01,184690,Staff,52,0,100,48
1683327010602,COGS 3,A01,184715,Boyle; Mary E. T.,0,25,40,40
1683327011629,COGS 14B,A01,185172,Staff,0,15,38,38
1683327012653,COGS 18,A01,184736,Staff,17,0,80,63
1683327013677,COGS 100,A01,184932,Staff,0,5,73,73
1683327014700,COGS 101A,A01,184935,Staff,0,38,30,30
1683327015723,COGS 101B,A01,184944,Staff,0,2,30,30
1683327016750,COGS 101C,A01,184946,Staff,0,12,30,30
1683327017779,COGS 102A,A01,184951,Johnson; Christine M.,2,0,40,38
1683327018803,COGS 107B,A01,184953,Mooshagian; Eric Frederick,0,50,40,40
1683327019827,COGS 118B,A01,184959,Gupta; Anjum,0,48,40,40
1683327020853,COGS 153,A00,184961,Staff,0,15,30,30
1683327021878,COGS 177,A00,184962,Staff,0,20,30,30
1683327022905,COGS 187A,A01,184969,Boyle; Mary E. T.,0,17,40,40
1683327023933,COMM 10,A01,185174,Staff,0,5,25,25
1683327023933,COMM 10,A02,185189,Staff,0,5,25,25
1683327023933,COMM 10,A03,269821,Staff,0,0,0,0
1683327024961,COMM 100B,A01,185475,Staff,0,0,0,2
1683327024961,COMM 100B,A02,185476,Staff,14,0,25,11
1683327025985,COMM 100C,A01,185314,Staff,1,0,25,24
1683327025985,COMM 100C,A02,185327,Staff,19,0,25,6
1683327027012,COMM 110M,A00,185349,Staff,2,0,40,38
1683327028036,COMM 113T,A00,185352,Staff,25,0,40,15
1683327029063,COMM 114I,A00,185353,Staff,33,0,40,7
1683327030089,COMM 131,A00,185354,Staff,19,0,30,11
1683327031113,CSE 8A,A50,185358,Cao; Yingjun,0,46,10,10
1683327032137,CSE 8B,A01,185362,Staff,1,47,50,49
1683327033160,CSE 11,A01,185416,Cao; Yingjun,0,92,10,10
1683327034182,CSE 20,A01,185445,Briones; Jor-el Thomas Caparas,5,0,25,20
1683327035207,CSE 21,A01,185447,Staff,10,0,50,40
1683327036236,CSE 101,A01,185451,Staff,0,12,50,50
1683327036236,CSE 101,B01,185453,Jones; Miles E,0,11,50,50
1683327038284,CSE 141,A01,185458,Eldon; John,20,0,100,80
1683327039311,CSE 141L,A01,185461,Eldon; John,12,0,100,88
1683327040334,CSE 142,A01,185463,Staff,36,0,60,24
1683327040334,CSE 142,B01,201355,Staff,0,7,60,60
1683327041362,CSE 142L,A01,185470,Staff,36,0,60,24
1683327041362,CSE 142L,B01,201417,Staff,0,6,60,60
1683327042388,CSE 190,A00,201433,Staff,32,0,49,17
1683327043416,DOC 1,A01,259136,Strom; Megan C.,7,0,15,8
1683327043416,DOC 1,A02,259137,Strom; Megan C.,14,0,15,1
1683327043416,DOC 1,A03,259138,Strom; Megan C.,14,0,15,1
1683327043416,DOC 1,A04,259139,Strom; Megan C.,14,0,15,1
1683327044440,DOC 100D,A00,259140,Pass; Natalye Joann,16,0,25,9
1683327045464,DSGN 1,A01,184749,Rill; Bryan,0,26,30,30
1683327046487,DSGN 100,A01,185168,Staff,0,2,25,25
1683327047510,ECE 5,A01,185626,Morris; Karcher William,0,10,0,0
1683327048538,ECE 101,A01,185628,Staff,17,0,70,53
1683327049562,ECE 107,A01,185635,Baghdadchi; Saharnaz,0,0,20,20
1683327049562,ECE 107,A02,185638,Baghdadchi; Saharnaz,4,0,20,16
1683327050588,ECE 148,A01,185647,Silberman; Jack,0,0,16,16
1683327051612,ECON 1,A01,185537,Crane; Meredith Helen,54,0,70,16
1683327052637,ECON 3,A01,185549,Crane; Meredith Helen,33,0,70,37
1683327053660,ECON 4,A01,203354,Anderson; John Charles,0,4,10,10
1683327054687,ECON 100A,A01,185574,Staff,0,4,40,40
1683327055714,ECON 100B,A01,185576,Staff,0,22,40,40
1683327056742,ECON 100C,A01,185589,Newhouse; Herbert S,30,0,70,40
1683327057769,ECON 105,A00,185608,Vespa; Emanuel Ignacio,19,0,35,16
1683327058793,ECON 109,A01,185610,Shishkin; Denis,10,0,35,25
1683327059818,ECON 110A,A01,185612,Staff,11,0,40,29
1683327060843,ECON 120A,A01,185615,Staff,20,0,40,20
1683327061868,ECON 120C,A01,185617,Sun; Yixiao,0,20,70,70
1683327062893,ECON 144,A00,203346,Squires; Dale E,3,0,35,32
1683327063918,ECON 171,A01,203349,Newhouse; Herbert S,0,1,35,35
1683327064942,ECON 173A,A01,185621,Toda; Alexis Akira,21,0,35,14
1683327066024,EDS 25,A01,202413,Staff,0,1,0,0
1683327066024,EDS 25,A02,202414,Staff,0,1,0,0
1683327066024,EDS 25,A03,202415,Staff,0,0,0,0
1683327066024,EDS 25,A04,202416,Staff,0,1,0,0
1683327066024,EDS 25,A05,202439,Staff,0,0,0,0
1683327066024,EDS 25,A06,202440,Staff,0,0,0,0
1683327066024,EDS 25,B01,202631,Staff,0,0,0,0
1683327066024,EDS 25,B02,202632,Staff,0,0,0,0
1683327066024,EDS 25,B03,202639,Staff,0,0,0,0
1683327066024,EDS 25,B04,202640,Staff,0,0,0,0
1683327066024,EDS 25,B05,202643,Staff,0,0,0,0
1683327066024,EDS 25,B06,202644,Staff,0,0,0,0
1683327067048,EDS 38,A01,202659,Black; Alison Michelle,24,0,25,1
1683327068073,EDS 115,A00,202652,Staff,17,0,30,13
1683327069097,EDS 125,A00,202649,Staff,14,0,30,16
1683327070122,EDS 126,A01,203332,Staff,30,0,30,0
1683327071146,EDS 139,A00,202838,Staff,16,0,25,9
1683327072174,EDS 146,A01,202655,Staff,14,0,25,11
1683327073206,ENG 15,A00,185667,Staff,0,1,0,0
1683327073206,ENG 15,B00,185672,Staff,0,0,0,0
1683327073206,ENG 15,C00,185675,Staff,0,0,0,0
1683327073206,ENG 15,D00,185682,Staff,0,0,0,0
1683327073206,ENG 15,E00,185684,Staff,0,0,0,0
1683327074233,ETHN 103,A00,185710,Staff,0,3,35,35
1683327075259,ETHN 103A,A00,199228,Man; Simeon S,2,0,9,7
1683327076282,ETHN 109,A00,185711,Staff,18,0,35,17
1683327077309,ETHN 142,A00,185726,Staff,0,4,30,30
1683327078333,ETHN 163J,A00,199229,Man; Simeon S,5,0,8,3
1683327079358,ETHN 168,A00,185727,Staff,8,0,10,2
1683327080384,ETHN 182,A00,185728,Staff,1,0,35,34
1683327081409,ETHN 183,A00,185737,Staff,8,0,18,10
1683327082435,GLBH 111,A01,209361,Burgos; Jose L.,0,0,0,0
1683327084486,HIEU 104,A00,185792,Staff,16,0,20,4
1683327085511,HIEU 115,A00,185800,Staff,1,0,20,19
1683327086538,HIEU 128,A00,185801,Staff,0,7,20,20
1683327087566,HIEU 147,A00,185802,Staff,16,0,20,4
1683327088591,HIEU 154,A00,185823,Staff,12,0,20,8
1683327089615,HILA 102,A00,185826,Staff,13,0,20,7
1683327090639,HILD 2C,A01,185778,Staff,0,12,20,20
1683327091670,HILD 7B,A01,185780,Kwak; Nancy,0,15,32,32
1683327091670,HILD 7B,A02,185781,Kwak; Nancy,0,18,32,32
1683327092695,HILD 30,A01,185791,Staff,14,0,20,6
1683327093719,HISC 119,A00,185830,Golan; Tal,0,9,20,20
1683327094743,HITO 156GS,A00,185831,Patterson; Patrick H.,0,0,0,23
1683327095769,HIUS 103,A00,185832,Man; Simeon S,0,6,20,20
1683327096796,HIUS 117,A00,185836,Kwak; Nancy,2,0,20,18
1683327097825,HIUS 125,A00,185840,Man; Simeon S,0,0,23,23
1683327098853,HIUS 149,A00,185845,Staff,0,0,20,20
1683327099881,HUM 3,A01,185882,Zavodny; Tatiana Sophia,0,7,50,50
1683327099881,HUM 3,B01,185899,Caldwell; Michael Alan,0,18,50,50
1683327100906,HUM 3GS,A00,185900,Patterson; Patrick H.,0,0,0,23
1683327101937,HUM 4,A01,185938,Zroka; Amy Liane,31,0,50,19
1683327101937,HUM 4,B01,185956,Watkins; Eric,0,2,50,50
1683327101937,HUM 4,B02,202209,Watkins; Eric,0,2,50,50
1683327101937,HUM 4,B03,202210,Watkins; Eric,0,2,50,50
1683327102961,HUM 5,A01,185958,West; Geoffrey Scott,3,0,50,47
1683327102961,HUM 5,A02,202215,West; Geoffrey Scott,0,0,50,50
1683327103988,INTL 190,A00,185959,Gagnon; Jeffrey C,0,0,0,9
1683327103988,INTL 190,B00,185960,Lettieri; Michael Joseph,0,0,0,1
1683327105013,JAPN 180,A00,254509,Staff,5,1,30,25
1683327106038,LATI 10,A01,202853,Kennemore; Amy Michelle,4,0,35,31
1683327106038,LATI 10,A02,202854,Kennemore; Amy Michelle,2,0,35,33
1683327106038,LATI 10,A03,270054,Kennemore; Amy Michelle,30,0,30,0
1683327107067,LATI 180,A00,202855,Kennemore; Amy Michelle,11,0,20,9
1683327108095,LAWS 101,A00,201767,Golan; Tal,0,7,40,40
1683327109123,LIFR 1C,A00,185961,Staff,6,0,20,14
1683327110147,LIFR 1CX,A00,185962,Staff,7,0,20,13
1683327111175,LIFR 1D,A00,185963,Staff,9,0,20,11
1683327112200,LIFR 1DX,A00,185964,Staff,9,0,20,11
1683327113228,LIGN 101,A01,186039,Staff,43,0,50,7
1683327114253,LIGN 165,A00,186040,Staff,18,0,50,32
1683327115280,LTCS 108,A00,186041,Staff,6,0,10,4
1683327116305,LTCS 119,A00,186042,Staff,16,0,20,4
1683327117332,LTCS 130,A00,186043,Wesling; Megan E.,15,0,25,10
1683327119385,LTEA 138,A00,186119,Staff,14,0,40,26
1683327120413,LTEN 124,A00,186148,Staff,6,0,25,19
1683327121438,LTEN 178,A00,186149,Staff,7,0,15,8
1683327122466,LTEN 181,A00,186150,Blanco; John D,33,0,40,7
1683327123490,LTWL 120,A00,186160,Staff,20,0,25,5
1683327124515,LTWL 165,A00,186161,Staff,22,0,25,3
1683327125542,LTWR 100,A00,186162,Staff,0,5,15,15
1683327126565,LTWR 102,A00,186163,Doller; Ben,5,0,15,10
1683327127588,MAE 8,A01,186412,Staff,0,0,0,0
1683327128613,MAE 30B,A00,186445,Bahadori; Mohammad Yousef,83,0,100,17
1683327129638,MAE 40,A00,186592,Bewley; Thomas R,9,0,50,41
1683327130666,MAE 101B,A00,186593,Bahadori; Mohammad Yousef,81,0,100,19
1683327131694,MAE 105,A00,186594,Bandaru; Prabhakar,12,0,50,38
1683327132720,MAE 107,A00,186599,Pham; Hieu Tan,0,6,120,120
1683327133749,MAE 148,A01,186660,Silberman; Jack,3,0,16,13
1683327134773,MATH 10A,A01,188095,Staff,1,6,35,34
1683327135803,MATH 10B,A01,188097,Bowers; Adam R.,0,11,30,30
1683327135803,MATH 10B,A02,188099,Bowers; Adam R.,0,11,30,30
1683327135803,MATH 10B,B01,188104,Bowers; Adam R.,0,10,30,30
1683327135803,MATH 10B,B02,188106,Bowers; Adam R.,0,10,30,30
1683327136833,MATH 10C,A01,188111,Staff,0,18,30,30
1683327136833,MATH 10C,A02,188127,Staff,0,17,30,30
1683327136833,MATH 10C,A03,188131,Staff,0,18,30,30
1683327136833,MATH 10C,B01,188218,Staff,18,0,30,12
1683327136833,MATH 10C,B02,188244,Staff,13,0,30,17
1683327136833,MATH 10C,B03,188277,Staff,16,0,30,14
1683327137862,MATH 18,A01,188344,Bach; Quang Tran,18,0,30,12
1683327137862,MATH 18,A02,188345,Bach; Quang Tran,11,0,30,19
1683327137862,MATH 18,B01,188353,Bach; Quang Tran,10,0,30,20
1683327137862,MATH 18,B02,188354,Bach; Quang Tran,20,0,30,10
1683327138907,MATH 20A,A01,188374,Staff,13,0,35,22
1683327139936,MATH 20B,A01,188382,Ohm; Ko Woon,6,0,30,24
1683327139936,MATH 20B,A02,188383,Ohm; Ko Woon,22,0,30,8
1683327139936,MATH 20B,B01,188385,Ohm; Ko Woon,7,0,30,23
1683327139936,MATH 20B,B02,188392,Ohm; Ko Woon,22,0,30,8
1683327140965,MATH 20C,A01,188394,Harel; Guershon,10,0,30,20
1683327140965,MATH 20C,A02,188395,Harel; Guershon,15,0,30,15
1683327140965,MATH 20C,B01,188404,Harel; Guershon,5,0,30,25
1683327140965,MATH 20C,B02,188405,Harel; Guershon,19,0,30,11
1683327141994,MATH 20D,A01,188414,Hammock; Frances H,0,1,30,30
1683327141994,MATH 20D,A02,188415,Hammock; Frances H,3,0,30,27
1683327141994,MATH 20D,B01,188447,Hammock; Frances H,2,0,30,28
1683327141994,MATH 20D,B02,188486,Hammock; Frances H,8,0,30,22
1683327143020,MATH 20E,A01,188649,Staff,21,0,30,9
1683327143020,MATH 20E,A02,188650,Staff,23,0,30,7
1683327143020,MATH 20E,A03,188673,Staff,0,0,30,30
1683327144048,MATH 102,A01,188675,Staff,0,35,35,35
1683327145076,MATH 103B,A01,188681,Staff,3,0,35,32
1683327145076,MATH 103B,B01,188692,Staff,5,0,35,30
1683327146101,MATH 109,A01,188695,Salehi Golsefidy; Alireza,25,0,35,10
1683327146101,MATH 109,A02,188696,Salehi Golsefidy; Alireza,26,0,35,9
1683327147125,MATH 120A,A01,188698,Eggers; John Dietrich,7,0,35,28
1683327148149,MATH 142B,A01,188736,Ioana; Adrian,0,2,30,30
1683327148149,MATH 142B,A02,188741,Ioana; Adrian,0,1,30,30
1683327148149,MATH 142B,A03,188743,Ioana; Adrian,1,3,30,29
1683327149176,MATH 168A,A01,188790,Staff,0,9,35,35
1683327150206,MATH 170A,A01,188803,Nie; Jiawang,0,2,35,35
1683327150206,MATH 170A,A02,188811,Nie; Jiawang,0,0,35,35
1683327150206,MATH 170A,A03,188814,Nie; Jiawang,1,0,35,34
1683327150206,MATH 170A,A04,188815,Nie; Jiawang,13,0,35,22
1683327151230,MATH 193B,A01,188817,Staff,0,0,35,35
1683327151230,MATH 193B,A02,188818,Staff,5,0,35,30
1683327152255,MGT 4,A01,202857,Anderson; John Charles,62,0,80,18
1683327153280,MGT 12,A00,202858,Lindenberger; Wade Douglas,42,0,90,48
1683327154303,MGT 18,A00,202859,Staff,74,0,90,16
1683327155326,MGT 18GS,A00,202860,McKay; Michael J,13,0,28,15
1683327156351,MGT 45,A00,202861,Pecore; Joseph P.,13,0,90,77
1683327157378,MGT 100,A00,202863,Yavorsky; Daniel Ryan,28,0,90,62
1683327158406,MGT 103,A00,202864,Ehrich; Kristine R,1,18,90,89
1683327159431,MGT 112,A00,202865,Ehrich; Kristine R,15,0,90,75
1683327160454,MGT 121A,A00,202868,Staff,0,20,0,0
1683327161481,MGT 131B,A00,202869,Anderson; John Charles,59,0,90,31
1683327162509,MGT 136,A00,202871,Lindenberger; Wade Douglas,84,0,90,6
1683327163532,MGT 164,A00,202873,Staff,0,68,90,91
1683327164556,MGT 164GS,A00,202874,McKay; Mary A,13,0,28,15
1683327165581,MGT 180,A00,202875,Staff,0,50,90,91
1683327166607,MMW 11R,A01,205019,Herbst; Matthew,3,0,30,27
1683327166607,MMW 11R,A02,205026,Herbst; Matthew,29,0,30,1
1683327167637,MMW 15,A01,193512,Chang; Edmond Yi-Teh,0,9,28,28
1683327167637,MMW 15,A02,193513,Chang; Edmond Yi-Teh,0,5,28,28
1683327167637,MMW 15,A03,193514,Chang; Edmond Yi-Teh,0,5,28,28
1683327167637,MMW 15,A04,193515,Chang; Edmond Yi-Teh,0,5,28,28
1683327167637,MMW 15,A05,193516,Chang; Edmond Yi-Teh,0,4,28,28
1683327167637,MMW 15,A06,193517,Chang; Edmond Yi-Teh,0,5,28,28
1683327167637,MMW 15,B01,193519,Chang; Edmond Yi-Teh,0,5,28,28
1683327167637,MMW 15,B02,193520,Chang; Edmond Yi-Teh,0,5,28,28
1683327167637,MMW 15,B03,193521,Chang; Edmond Yi-Teh,0,5,28,28
1683327167637,MMW 15,B04,193522,Chang; Edmond Yi-Teh,0,4,28,28
1683327167637,MMW 15,B05,193523,Chang; Edmond Yi-Teh,0,5,28,28
1683327167637,MMW 15,B06,193524,Chang; Edmond Yi-Teh,0,4,28,28
1683327168665,MMW 122,A01,193526,Rahimi; Babak,0,15,28,28
1683327168665,MMW 122,A02,193527,Rahimi; Babak,0,14,28,28
1683327168665,MMW 122,A03,193528,Rahimi; Babak,0,0,0,0
1683327168665,MMW 122,A04,193529,Rahimi; Babak,0,0,0,0
1683327169762,MUS 1A,A01,186663,Staff,0,20,35,35
1683327170790,MUS 4,A01,186715,Staff,0,12,35,35
1683327171814,MUS 5R,A01,186796,Dubnov; Shlomo,0,17,35,35
1683327172840,MUS 6,A01,186798,Staff,0,4,25,25
1683327173865,MUS 7,A01,186830,Staff,12,0,35,23
1683327174891,MUS 8,A01,186930,Staff,0,27,35,35
1683327175916,MUS 15,A01,186932,Staff,0,16,35,35
1683327175916,MUS 15,B01,186934,Staff,0,15,35,35
1683327176941,MUS 80,A00,186935,Staff,1,0,20,19
1683327176941,MUS 80,B00,186936,Staff,25,0,25,0
1683327177968,NANO 11,A00,204702,Lipomi; Darren John,0,0,0,0
1683327178992,NANO 15,A01,204709,Yang; Kesong,0,1,0,0
1683327180018,NANO 114,A00,202069,Jahed Motlagh; Zeinab,3,0,10,7
1683327181043,PHIL 1,A00,186955,Grush; Rick Scott,32,0,40,8
1683327182066,PHIL 10,A01,186973,Grush; Rick Scott,28,0,35,7
1683327182066,PHIL 10,A02,186974,Grush; Rick Scott,33,0,35,2
1683327183095,PHIL 13,A01,186976,Staff,7,0,35,28
1683327183095,PHIL 13,A02,186977,Staff,16,0,35,19
1683327184121,PHIL 14,A01,186979,Staff,31,0,35,4
1683327184121,PHIL 14,A02,186986,Staff,32,0,35,3
1683327185146,PHIL 28,A01,186988,Staff,16,0,30,14
1683327185146,PHIL 28,A02,186989,Staff,1,0,30,29
1683327185146,PHIL 28,A03,186990,Staff,9,0,30,21
1683327185146,PHIL 28,A04,186991,Staff,26,0,30,4
1683327186171,PHIL 120,A00,186997,Staff,23,0,40,17
1683327187194,PHIL 137,A00,187003,Staff,9,0,40,31
1683327188218,PHIL 150,A00,187015,Staff,47,0,70,23
1683327189242,PHIL 167,A00,187021,Lamey; Andy M.,35,0,40,5
1683327190267,PHIL 174,A01,202226,Staff,17,0,20,3
1683327190267,PHIL 174,A02,202235,Staff,20,0,20,0
1683327191292,PHIL 191A,A00,258918,Staff,0,0,1,1
1683327192316,PHYS 1A,A00,187028,Staff,27,0,60,33
1683327193344,PHYS 1AL,001,187036,Staff,3,0,30,27
1683327193344,PHYS 1AL,002,187049,Staff,18,0,30,12
1683327194372,PHYS 1B,A00,187058,Staff,22,0,60,38
1683327195400,PHYS 1BL,001,187064,Staff,0,0,30,30
1683327195400,PHYS 1BL,002,187070,Staff,5,0,30,25
1683327196424,PHYS 1C,A00,187082,Staff,31,0,120,89
1683327197450,PHYS 1CL,001,187088,Staff,0,9,30,30
1683327197450,PHYS 1CL,002,187089,Staff,0,2,30,30
1683327197450,PHYS 1CL,009,262693,Staff,11,0,30,19
1683327198475,PHYS 2B,A01,187097,Staff,54,0,115,61
1683327199504,PHYS 2C,A01,187099,Staff,67,0,115,48
1683327200531,PHYS 2CL,A01,187101,Staff,5,0,28,23
1683327200531,PHYS 2CL,A02,187102,Staff,15,0,28,13
1683327201554,PHYS 2D,A01,187123,Shotwell; Brian,95,0,115,20
1683327202580,PHYS 4B,A01,187133,Grinstein; Benjamin,35,0,50,15
1683327203603,POLI 10,A00,188819,Staff,0,4,50,50
1683327204629,POLI 11,A00,188827,Staff,43,0,50,7
1683327205652,POLI 13R,A00,188828,Staff,0,1,20,20
1683327206677,POLI 27,A01,188830,Elgin; Samuel Zincke,0,1,70,70
1683327207701,POLI 30,A00,188832,Desposato; Scott,31,0,50,19
1683327208728,POLI 102F,A00,188834,Staff,3,0,40,37
1683327209753,POLI 104A,A00,188852,Staff,14,0,30,16
1683327210780,POLI 104I,A00,188853,Staff,0,6,20,20
1683327211805,POLI 110B,A00,188854,Wiens; David,7,0,20,13
1683327212830,POLI 112A,A00,188855,Wiens; David,5,0,30,25
1683327213858,POLI 117R,A00,188856,Forman; Fonna,0,11,20,20
1683327214883,POLI 118,A00,188857,Ingham; Sean,8,0,20,12
1683327215907,POLI 120G,A00,188858,Staff,9,0,30,21
1683327216933,POLI 131CR,A00,188863,Hoston; Germaine,24,0,50,26
1683327217958,POLI 133,A00,188864,Nellis; Gareth Hb,44,0,50,6
1683327218983,POLI 134D,A00,188865,Desposato; Scott,27,0,30,3
1683327220007,POLI 142A,A00,188871,Gartzke; Erik,22,0,50,28
1683327221031,POLI 142K,A00,188874,Staff,38,0,50,12
1683327222059,POLI 143,A00,188940,Gartzke; Erik,16,0,30,14
1683327223081,POLI 153,A00,188943,Staff,3,0,20,17
1683327224105,POLI 160AA,A00,188944,Staff,12,0,40,28
1683327225172,POLI 170A,A00,188945,Staff,11,0,30,19
1683327227217,PSYC 1,A00,188952,Staff,37,0,90,53
1683327228241,PSYC 2,B00,188953,Staff,19,0,35,16
1683327229263,PSYC 6,A00,188970,Staff,47,0,60,13
1683327230289,PSYC 7,A00,188973,Staff,37,0,45,8
1683327231320,PSYC 60,A01,188980,Rickard; Timothy C.,43,0,60,17
1683327232347,PSYC 70,A01,189001,Steiner; Eric Tomas,24,0,45,21
1683327233372,PSYC 100,A00,189005,Lacefield; Katharine I,0,100,120,120
1683327234397,PSYC 102,A00,189008,Staff,9,0,30,21
1683327235421,PSYC 106,B00,189026,Gorman; Michael R.,34,0,60,26
1683327236448,PSYC 114,B01,189033,Winkielman; Piotr,0,32,30,30
1683327237475,PSYC 131,A00,189036,Anagnostaras; Stephan,0,43,60,60
1683327238500,PSYC 136,A00,189041,Lowe; Angela Beth,0,7,25,25
1683327239523,PSYC 137,A00,189057,Winkielman; Piotr,0,34,25,25
1683327240551,PSYC 144,A00,189107,Wixted; John T,0,7,50,50
1683327242599,PSYC 162,A00,189142,Staff,0,8,85,85
1683327243623,PSYC 172,A00,189144,Gorman; Michael R.,0,7,30,30
1683327245674,PSYC 179,A00,189146,Lacefield; Katharine I,0,84,120,120
1683327246699,PSYC 181,A00,189147,Anagnostaras; Stephan,0,44,90,90
1683327247724,PSYC 190R,A00,189148,Barner; David A.,0,22,80,80
1683327248751,PSYC 191,A00,189275,Rickard; Timothy C.,0,7,25,25
1683327249779,PSYC 193,A00,189276,Chapman; Eddie Nathaniel,0,1,0,4
1683327250803,PSYC 193L,A01,189281,Lowe; Angela Beth,12,0,20,8
1683327250803,PSYC 193L,B01,189285,Staff,28,0,35,7
1683327251830,RELI 149,A00,187137,Rahimi; Babak,7,0,40,33
1683327252854,SE 9,A01,187315,Staff,0,2,18,18
1683327253880,SE 101B,A00,187409,Staff,24,0,30,6
1683327254906,SE 110B,A00,187444,Staff,10,0,40,30
1683327255932,SE 130B,A00,187449,Staff,31,0,40,9
1683327256955,SE 150A,A00,187516,Staff,9,0,20,11
1683327257982,SE 154,A00,187528,Staff,30,0,50,20
1683327259009,SIO 3,A01,258171,Staff,35,0,40,5
1683327260033,SIO 10,A00,187144,Cook; Geoffrey W,0,3,75,75
1683327261057,SIO 45,A00,187152,Cook; Geoffrey W,1,0,100,99
1683327262088,SIO 109R,A00,194486,Staff,0,3,20,20
1683327264138,SIO 187,A01,187233,Kacev; David,12,0,40,28
1683327265165,SOCI 1,A01,258656,Thorpe; Charles Robert,28,0,30,2
1683327265165,SOCI 1,A02,258658,Thorpe; Charles Robert,30,0,30,0
1683327265165,SOCI 1,A03,258661,Thorpe; Charles Robert,25,0,25,0
1683327265165,SOCI 1,A04,258666,Thorpe; Charles Robert,22,0,25,3
1683327265165,SOCI 1,A05,258897,Thorpe; Charles Robert,23,0,25,2
1683327265165,SOCI 1,A06,258898,Thorpe; Charles Robert,25,0,25,0
1683327266192,SOCI 30,A01,258903,Pardo Guerra; Juan Pablo,15,0,30,15
1683327267217,SOCI 102,A00,258904,Staff,9,0,25,16
1683327268243,SOCI 106,A00,258905,Staff,19,0,25,6
1683327269267,SOCI 111,A00,258907,Ribas Norris; Janet Vanesa,26,0,30,4
1683327270291,SOCI 121R,A00,258908,Pardo Guerra; Juan Pablo,10,0,30,20
1683327271319,SOCI 126,A01,203330,Staff,14,0,20,6
1683327272347,SOCI 131,A00,258909,Thorpe; Charles Robert,31,0,60,29
1683327273428,SOCI 135,A00,258910,Payne; Christine Anna,0,9,30,30
1683327274455,SOCI 157,A00,258911,Staff,12,0,30,18
1683327275480,SOCI 184,A00,258912,Staff,25,0,30,5
1683327276503,SOCI 188D,A00,258913,Staff,21,0,30,9
1683327277527,SYN 2,001,187529,Staff,9,0,16,7
1683327277527,SYN 2,002,201452,Staff,0,18,16,16
1683327277527,SYN 2,003,201469,Staff,4,0,16,12
1683327278551,SYN 100,A01,187531,Staff,0,9,20,20
1683327278551,SYN 100,B01,201491,Staff,0,12,20,20
1683327279576,TDAC 1,A00,189286,Walsh; Kim C.,3,0,20,17
1683327279576,TDAC 1,B00,189287,Harting; Carla Kelso,11,0,20,9
1683327280600,TDAC 101,A00,189300,Walsh; Kim C.,16,0,20,4
1683327280600,TDAC 101,B00,189301,Harting; Carla Kelso,18,0,20,2
1683327281626,TDAC 102,A00,189304,Basso; Beatrice,14,0,20,6
1683327282650,TDAC 108,A00,189305,Staff,18,0,20,2
1683327283677,TDDE 131,A00,189310,Staff,19,0,20,1
1683327283677,TDDE 131,B00,189314,Staff,19,0,20,1
1683327283677,TDDE 131,C00,189315,Staff,48,0,50,2
1683327283677,TDDE 131,D00,189316,Staff,14,0,15,1
1683327283677,TDDE 131,E00,204841,Staff,20,0,20,0
1683327284703,TDGE 10,A00,189289,Staff,30,0,50,20
1683327284703,TDGE 10,B00,189290,Havis; Allan,1,0,50,49
1683327285730,TDGE 11,A00,189291,Fulton; Julia,0,3,50,50
1683327285730,TDGE 11,B00,189292,Staff,20,0,25,5
1683327285730,TDGE 11,C00,260270,Staff,0,0,0,0
1683327286754,TDGE 25,A00,189294,Staff,3,0,20,17
1683327287777,TDGE 124,A00,189318,Fulton; Julia,0,8,50,50
1683327288799,TDGE 125,A00,189319,Staff,13,0,25,12
1683327288799,TDGE 125,B00,189320,Staff,23,0,25,2
1683327289823,TDGE 127,A00,189322,Havis; Allan,0,0,50,50
1683327290846,TDHT 101,A00,189323,Staff,18,0,25,7
1683327290846,TDHT 101,B00,189324,Staff,25,0,25,0
1683327291877,TDHT 102,A00,189325,Staff,49,0,50,1
1683327292901,TDMV 1,A00,189295,Arcidiacono; Kristin,19,0,30,11
1683327292901,TDMV 1,B00,189296,Caligagan; Maria T.,24,0,30,6
1683327293930,TDMV 2,A00,189297,Sammartano; Tonnie,28,0,30,2
1683327293930,TDMV 2,B00,189299,Arcidiacono; Kristin,24,0,30,6
1683327294955,TDMV 3,A00,204998,Rincon; Alicia,22,0,30,8
1683327295979,TDMV 120,A00,189458,Sammartano; Tonnie,28,0,30,2
1683327297003,TDMV 138,A00,189541,Jun; Grace Shin Hae,22,0,40,18
1683327298028,TDMV 142,A00,189717,Caligagan; Tony,23,0,30,7
1683327298028,TDMV 142,B00,189718,Caligagan; Maria T.,25,0,30,5
1683327309221,TMC 2,A01,187533,Staff,25,0,25,0
1683327309221,TMC 2,A02,187534,Staff,25,0,25,0
1683327310249,USP 1,A01,187536,Kwak; Nancy,0,16,25,25
1683327311275,USP 5,A01,187538,Staff,10,0,25,15
1683327312302,USP 101,A00,199253,Staff,0,4,0,0
1683327313324,USP 124,A00,187562,Boomhower; Matthew Charles,1,0,30,29
1683327314349,USP 138,A00,187582,Staff,20,0,25,5
1683327315375,USP 152,A01,187597,Staff,4,0,25,21
1683327316398,USP 153,A00,187598,Staff,19,0,25,6
1683327317420,USP 168,A00,187607,Kwak; Nancy,2,0,5,3
1683327318447,USP 173,A00,187619,Staff,4,0,25,21
1683327319471,USP 181,A00,187638,Staff,0,0,25,25
1683327320498,VIS 103,A00,187650,Cruz; Edwin Teddy,23,0,75,52
1683327321521,VIS 110D,A00,187669,Staff,12,0,22,10
1683327322545,VIS 127C,A00,187720,Shen; Kuiyi,67,0,146,79
1683327323572,VIS 149,A00,187731,Yoldas; Pinar,0,14,22,22
1683327324598,VIS 151,A01,188091,Staff,22,0,34,12
1683327324598,VIS 151,A02,188092,Staff,11,0,34,23
1683327325622,VIS 160B,A00,188093,Stalbaum; Brett,0,0,10,10
1683327327672,WCWP 10B,A00,201720,Staff,10,0,15,5
1683327327672,WCWP 10B,B00,201722,Staff,8,0,15,7
1683327328698,WCWP 100,A00,201725,Gagnon; Jeffrey C,0,0,2,2
1683327328698,WCWP 100,B00,201727,Staff,0,4,15,15
1683327331840,ANBI 133,A00,258401,Wilder; Linnea Lorene,34,0,40,6
1683327332863,ANBI 140,A00,258395,Hrvoj Mihic; Branka,18,0,25,7
1683327333887,ANSC 120,A00,258402,Bialecki; Jon Anthony,27,0,40,13
1683327334913,ANSC 144,A00,258400,Staff,14,0,40,26
1683327336965,ANSC 166,A00,258396,Parish; Steven Martin,157,0,175,18
1683327337992,ANSC 180,A00,193533,Staff,9,0,20,11
1683327339016,ANSC 188,A00,258397,Jassal; Aftab,33,0,40,7
1683327340039,ANTH 3,A01,258316,Staff,23,0,30,7
1683327341064,ANTH 5,A00,258394,Semendeferi; Ekaterini,16,0,20,4
1683327342093,ANTH 21,A01,258331,Staff,8,0,40,32
1683327343117,ANTH 103,A00,258398,Varma; Saiba,15,0,25,10
1683327344150,AWP 10,001,202034,Staff,0,0,0,0
1683327344150,AWP 10,002,202035,Staff,0,0,0,0
1683327344150,AWP 10,003,202036,Staff,0,0,0,0
1683327344150,AWP 10,004,202037,Staff,0,0,0,0
1683327344150,AWP 10,005,202038,Staff,0,0,0,0
1683327344150,AWP 10,006,202039,Staff,0,0,0,0
1683327344150,AWP 10,007,202040,Staff,0,0,0,0
1683327344150,AWP 10,008,202041,Staff,0,0,0,0
1683327344150,AWP 10,009,202042,Staff,0,0,0,0
1683327344150,AWP 10,010,202043,Staff,0,0,0,0
1683327344150,AWP 10,011,202044,Staff,0,0,0,0
1683327344150,AWP 10,012,202045,Staff,0,0,0,0
1683327344150,AWP 10,013,202046,Staff,0,0,0,0
1683327344150,AWP 10,014,202047,Staff,0,0,0,0
1683327344150,AWP 10,015,202048,Staff,0,0,0,0
1683327344150,AWP 10,016,202049,Staff,0,0,0,0
1683327344150,AWP 10,017,202050,Staff,0,0,0,0
1683327344150,AWP 10,018,202051,Staff,0,0,0,0
1683327344150,AWP 10,019,202052,Staff,0,0,0,0
1683327344150,AWP 10,020,202053,Staff,0,0,0,0
1683327344150,AWP 10,021,202054,Staff,0,0,0,0
1683327344150,AWP 10,022,202055,Staff,0,0,0,0
1683327344150,AWP 10,023,202056,Staff,0,0,0,0
1683327344150,AWP 10,024,202057,Staff,0,0,0,0
1683327344150,AWP 10,025,202058,Staff,0,0,0,0
1683327344150,AWP 10,026,202059,Staff,0,0,0,0
1683327345173,AWP 102,001,202032,Staff,0,0,0,0
1683327345173,AWP 102,002,202033,Staff,0,0,0,0
1683327346197,BENG 100,A01,254234,Taylor Amos; Alyssa C,31,0,40,9
1683327347221,BENG 196,001,270013,Engler; Adam J.,9999,0,9999,0
1683327348250,BICD 100R,A01,202018,Smith; Laurie,0,7,32,32
1683327348250,BICD 100R,A02,202019,Smith; Laurie,0,2,32,32
1683327348250,BICD 100R,A03,202020,Smith; Laurie,0,1,32,32
1683327348250,BICD 100R,A04,202021,Smith; Laurie,9,0,32,23
1683327348250,BICD 100R,A05,202022,Smith; Laurie,12,0,32,20
1683327349274,BICD 136,A01,193242,Gustafson-Brown; Cindy,0,2,32,32
1683327349274,BICD 136,A02,193244,Gustafson-Brown; Cindy,14,0,32,18
1683327350298,BIEB 102,A01,193249,Butler; Shannon Rhey,0,2,32,32
1683327350298,BIEB 102,A02,193251,Butler; Shannon Rhey,0,0,32,32
1683327350298,BIEB 102,A03,193253,Butler; Shannon Rhey,0,1,32,32
1683327350298,BIEB 102,A04,193255,Butler; Shannon Rhey,17,0,32,15
1683327350298,BIEB 102,A05,193265,Butler; Shannon Rhey,26,0,32,6
1683327350298,BIEB 102,A06,193269,Butler; Shannon Rhey,16,0,32,16
1683327352348,BIEB 150,A01,193274,Staff,0,0,32,32
1683327352348,BIEB 150,A02,193285,Staff,23,0,32,9
1683327353371,BIEB 194,A00,193286,Kurle; Carolyn M.,22,0,32,10
1683327354396,BILD 1,A01,192291,Staff,16,0,32,16
1683327354396,BILD 1,A02,192292,Staff,30,0,32,2
1683327354396,BILD 1,B01,192520,Reuther; Keefe,0,1,0,0
1683327354396,BILD 1,B02,192532,Reuther; Keefe,0,1,0,0
1683327355425,BILD 3,A01,192556,Butler; Shannon Rhey,0,0,32,32
1683327355425,BILD 3,A02,192581,Butler; Shannon Rhey,5,0,32,27
1683327355425,BILD 3,A03,192611,Butler; Shannon Rhey,23,0,32,9
1683327355425,BILD 3,A04,192612,Butler; Shannon Rhey,25,0,32,7
1683327355425,BILD 3,A05,192613,Butler; Shannon Rhey,27,0,32,5
1683327355425,BILD 3,A06,192679,Butler; Shannon Rhey,27,0,32,5
1683327355425,BILD 3,A07,192682,Butler; Shannon Rhey,22,0,32,10
1683327356450,BILD 4,A01,192836,Reuther; Keefe,0,0,24,24
1683327356450,BILD 4,A02,193044,Reuther; Keefe,4,0,24,20
1683327357478,BILD 10,A01,193142,Gustafson-Brown; Cindy,30,0,32,2
1683327357478,BILD 10,A02,193149,Gustafson-Brown; Cindy,31,0,32,1
1683327358505,BIMM 100,A01,193301,Staff,0,6,32,32
1683327358505,BIMM 100,A02,193312,Staff,0,5,32,32
1683327358505,BIMM 100,A03,193323,Staff,0,8,32,32
1683327359532,BIMM 101,A01,193329,McDonnell; Lisa Marie,0,3,24,24
1683327359532,BIMM 101,A02,193339,McDonnell; Lisa Marie,0,3,24,24
1683327359532,BIMM 101,B01,193354,McDonnell; Lisa Marie,0,3,24,24
1683327359532,BIMM 101,B02,193357,McDonnell; Lisa Marie,0,3,24,24
1683327360556,BIMM 110,A01,193377,Tat; John,0,11,32,32
1683327360556,BIMM 110,A02,193378,Tat; John,1,9,32,31
1683327361585,BIMM 120,A01,206116,Staff,0,0,32,32
1683327361585,BIMM 120,A02,206117,Staff,8,0,32,24
1683327361585,BIMM 120,A03,206121,Staff,21,0,32,11
1683327362610,BIPN 100,A01,193393,Park; Ji Young,0,14,32,32
1683327362610,BIPN 100,A02,193402,Park; Ji Young,0,13,32,32
1683327362610,BIPN 100,A03,193413,Park; Ji Young,0,14,32,32
1683327362610,BIPN 100,A04,193414,Park; Ji Young,0,13,32,32
1683327363636,BIPN 102,A01,193429,Staff,0,0,32,32
1683327363636,BIPN 102,A02,193438,Staff,22,0,32,10
1683327364660,BIPN 106,A01,193450,Reyes Gonzalez; Catalina,0,2,40,40
1683327365689,BIPN 134,A01,193465,Cooke; James Edward,0,0,32,32
1683327365689,BIPN 134,A02,193474,Cooke; James Edward,25,0,32,7
1683327365689,BIPN 134,A03,193485,Cooke; James Edward,29,0,32,3
1683327365689,BIPN 134,A04,193486,Cooke; James Edward,21,0,32,11
1683327365689,BIPN 134,A05,193491,Cooke; James Edward,31,0,32,1
1683327365689,BIPN 134,A06,193501,Cooke; James Edward,30,0,32,2
1683327365689,BIPN 134,A07,193510,Cooke; James Edward,29,0,32,3
1683327367741,BISP 194,A00,222522,Staff,14,0,32,18
1683327368766,CAT 124,A01,202407,Staff,20,0,25,5
1683327369794,CAT 125,A00,202408,Marchisotto; Jennifer Anne,4,0,20,16
1683327370824,CAT 125R,A00,202409,Smith; Lauryn Alissa,0,11,20,20
1683327370824,CAT 125R,B00,202410,Morales; Celeste Georgianna,0,11,20,20
1683327370824,CAT 125R,C00,202411,Irwin; Matthew Joseph,0,10,20,20
1683327371848,CENG 15,A01,204712,Yang; Kesong,0,1,0,0
1683327372876,CENG 114,A00,202070,Jahed Motlagh; Zeinab,5,0,20,15
1683327373902,CGS 105,A00,185477,Wesling; Megan E.,24,0,40,16
1683327374929,CGS 106,A00,185494,Staff,13,0,22,9
1683327375952,CGS 108,A00,185495,Staff,14,0,20,6
1683327376976,CGS 114,A00,185496,Staff,13,0,18,5
1683327378001,CGS 119,A00,185501,Staff,15,0,20,5
1683327379028,CGS 120,A00,185511,Staff,13,0,20,7
1683327380053,CHEM 4,A01,184675,Bussey; Thomas J,96,0,100,4
1683327381081,CHEM 6A,A01,184677,Staff,34,0,60,26
1683327382108,CHEM 6B,A01,184679,Staff,65,0,100,35
1683327383138,CHEM 6C,A01,184681,Bussey; Thomas J,1,0,50,49
1683327383138,CHEM 6C,A02,184682,Bussey; Thomas J,34,0,50,16
1683327384165,CHEM 40A,A01,184684,Albizati; Kim F.,37,0,100,63
1683327385193,CHEM 40B,A01,184686,Albizati; Kim F.,0,20,100,100
1683327386218,CHEM 41B,A01,184690,Staff,52,0,100,48
1683327387300,COGS 3,A01,184715,Boyle; Mary E. T.,0,25,40,40
1683327388326,COGS 14B,A01,185172,Staff,0,15,38,38
1683327389350,COGS 18,A01,184736,Staff,17,0,80,63
1683327390377,COGS 100,A01,184932,Staff,0,5,73,73
1683327391403,COGS 101A,A01,184935,Staff,0,38,30,30
1683327392430,COGS 101B,A01,184944,Staff,0,2,30,30
1683327393454,COGS 101C,A01,184946,Staff,0,12,30,30
1683327394479,COGS 102A,A01,184951,Johnson; Christine M.,2,0,40,38
1683327395503,COGS 107B,A01,184953,Mooshagian; Eric Frederick,0,50,40,40
1683327396528,COGS 118B,A01,184959,Gupta; Anjum,0,48,40,40
1683327397556,COGS 153,A00,184961,Staff,0,15,30,30
1683327398584,COGS 177,A00,184962,Staff,0,20,30,30
1683327399607,COGS 187A,A01,184969,Boyle; Mary E. T.,0,17,40,40
1683327400635,COMM 10,A01,185174,Staff,0,5,25,25
1683327400635,COMM 10,A02,185189,Staff,0,5,25,25
1683327400635,COMM 10,A03,269821,Staff,0,0,0,0
1683327401662,COMM 100B,A01,185475,Staff,0,0,0,2
1683327401662,COMM 100B,A02,185476,Staff,14,0,25,11
1683327402687,COMM 100C,A01,185314,Staff,1,0,25,24
1683327402687,COMM 100C,A02,185327,Staff,19,0,25,6
1683327403711,COMM 110M,A00,185349,Staff,2,0,40,38
1683327404735,COMM 113T,A00,185352,Staff,25,0,40,15
1683327405759,COMM 114I,A00,185353,Staff,33,0,40,7
1683327406795,COMM 131,A00,185354,Staff,19,0,30,11
1683327407821,CSE 8A,A50,185358,Cao; Yingjun,0,46,10,10
1683327408849,CSE 8B,A01,185362,Staff,1,47,50,49
1683327409876,CSE 11,A01,185416,Cao; Yingjun,0,92,10,10
1683327410902,CSE 20,A01,185445,Briones; Jor-el Thomas Caparas,5,0,25,20
1683327411927,CSE 21,A01,185447,Staff,10,0,50,40
1683327412956,CSE 101,A01,185451,Staff,0,12,50,50
1683327412956,CSE 101,B01,185453,Jones; Miles E,0,11,50,50
1683327415007,CSE 141,A01,185458,Eldon; John,20,0,100,80
1683327416032,CSE 141L,A01,185461,Eldon; John,12,0,100,88
1683327417057,CSE 142,A01,185463,Staff,36,0,60,24
1683327417057,CSE 142,B01,201355,Staff,0,7,60,60
1683327418085,CSE 142L,A01,185470,Staff,36,0,60,24
1683327418085,CSE 142L,B01,201417,Staff,0,6,60,60
1683327419108,CSE 190,A00,201433,Staff,32,0,49,17
1683327420136,DOC 1,A01,259136,Strom; Megan C.,7,0,15,8
1683327420136,DOC 1,A02,259137,Strom; Megan C.,14,0,15,1
1683327420136,DOC 1,A03,259138,Strom; Megan C.,14,0,15,1
1683327420136,DOC 1,A04,259139,Strom; Megan C.,14,0,15,1
1683327421161,DOC 100D,A00,259140,Pass; Natalye Joann,16,0,25,9
1683327422189,DSGN 1,A01,184749,Rill; Bryan,0,26,30,30
1683327423214,DSGN 100,A01,185168,Staff,0,2,25,25
1683327424241,ECE 5,A01,185626,Morris; Karcher William,0,10,0,0
1683327425269,ECE 101,A01,185628,Staff,17,0,70,53
1683327426293,ECE 107,A01,185635,Baghdadchi; Saharnaz,0,0,20,20
1683327426293,ECE 107,A02,185638,Baghdadchi; Saharnaz,4,0,20,16
1683327427318,ECE 148,A01,185647,Silberman; Jack,0,0,16,16
1683327428347,ECON 1,A01,185537,Crane; Meredith Helen,54,0,70,16
1683327429374,ECON 3,A01,185549,Crane; Meredith Helen,33,0,70,37
1683327430402,ECON 4,A01,203354,Anderson; John Charles,0,4,10,10
1683327431427,ECON 100A,A01,185574,Staff,0,4,40,40
1683327432452,ECON 100B,A01,185576,Staff,0,22,40,40
1683327433477,ECON 100C,A01,185589,Newhouse; Herbert S,30,0,70,40
1683327434500,ECON 105,A00,185608,Vespa; Emanuel Ignacio,19,0,35,16
1683327435525,ECON 109,A01,185610,Shishkin; Denis,10,0,35,25
1683327436551,ECON 110A,A01,185612,Staff,11,0,40,29
1683327437578,ECON 120A,A01,185615,Staff,20,0,40,20
1683327438605,ECON 120C,A01,185617,Sun; Yixiao,0,20,70,70
1683327439629,ECON 144,A00,203346,Squires; Dale E,3,0,35,32
1683327440652,ECON 171,A01,203349,Newhouse; Herbert S,0,1,35,35
1683327441677,ECON 173A,A01,185621,Toda; Alexis Akira,21,0,35,14
1683327442706,EDS 25,A01,202413,Staff,0,1,0,0
1683327442706,EDS 25,A02,202414,Staff,0,1,0,0
1683327442706,EDS 25,A03,202415,Staff,0,0,0,0
1683327442706,EDS 25,A04,202416,Staff,0,1,0,0
1683327442706,EDS 25,A05,202439,Staff,0,0,0,0
1683327442706,EDS 25,A06,202440,Staff,0,0,0,0
1683327442706,EDS 25,B01,202631,Staff,0,0,0,0
1683327442706,EDS 25,B02,202632,Staff,0,0,0,0
1683327442706,EDS 25,B03,202639,Staff,0,0,0,0
1683327442706,EDS 25,B04,202640,Staff,0,0,0,0
1683327442706,EDS 25,B05,202643,Staff,0,0,0,0
1683327442706,EDS 25,B06,202644,Staff,0,0,0,0
1683327443730,EDS 38,A01,202659,Black; Alison Michelle,24,0,25,1
1683327444755,EDS 115,A00,202652,Staff,17,0,30,13
1683327445780,EDS 125,A00,202649,Staff,14,0,30,16
1683327446804,EDS 126,A01,203332,Staff,30,0,30,0
1683327447828,EDS 139,A00,202838,Staff,16,0,25,9
1683327448855,EDS 146,A01,202655,Staff,14,0,25,11
1683327449883,ENG 15,A00,185667,Staff,0,1,0,0
1683327449883,ENG 15,B00,185672,Staff,0,0,0,0
1683327449883,ENG 15,C00,185675,Staff,0,0,0,0
1683327449883,ENG 15,D00,185682,Staff,0,0,0,0
1683327449883,ENG 15,E00,185684,Staff,0,0,0,0
1683327450911,ETHN 103,A00,185710,Staff,0,3,35,35
1683327451937,ETHN 103A,A00,199228,Man; Simeon S,2,0,9,7
1683327452960,ETHN 109,A00,185711,Staff,18,0,35,17
1683327453984,ETHN 142,A00,185726,Staff,0,4,30,30
1683327455009,ETHN 163J,A00,199229,Man; Simeon S,5,0,8,3
1683327456033,ETHN 168,A00,185727,Staff,8,0,10,2
1683327457091,ETHN 182,A00,185728,Staff,1,0,35,34
1683327458118,ETHN 183,A00,185737,Staff,8,0,18,10
1683327459143,GLBH 111,A01,209361,Burgos; Jose L.,0,0,0,0
1683327461194,HIEU 104,A00,185792,Staff,16,0,20,4
1683327462218,HIEU 115,A00,185800,Staff,1,0,20,19
1683327463242,HIEU 128,A00,185801,Staff,0,7,20,20
1683327464270,HIEU 147,A00,185802,Staff,16,0,20,4
1683327465297,HIEU 154,A00,185823,Staff,12,0,20,8
1683327466321,HILA 102,A00,185826,Staff,13,0,20,7
1683327467345,HILD 2C,A01,185778,Staff,0,12,20,20
1683327468368,HILD 7B,A01,185780,Kwak; Nancy,0,15,32,32
1683327468368,HILD 7B,A02,185781,Kwak; Nancy,0,18,32,32
1683327469393,HILD 30,A01,185791,Staff,14,0,20,6
1683327470418,HISC 119,A00,185830,Golan; Tal,0,9,20,20
1683327471443,HITO 156GS,A00,185831,Patterson; Patrick H.,0,0,0,23
1683327472467,HIUS 103,A00,185832,Man; Simeon S,0,6,20,20
1683327473495,HIUS 117,A00,185836,Kwak; Nancy,2,0,20,18
1683327474518,HIUS 125,A00,185840,Man; Simeon S,0,0,23,23
1683327475543,HIUS 149,A00,185845,Staff,0,0,20,20
1683327476568,HUM 3,A01,185882,Zavodny; Tatiana Sophia,0,7,50,50
1683327476568,HUM 3,B01,185899,Caldwell; Michael Alan,0,18,50,50
1683327477591,HUM 3GS,A00,185900,Patterson; Patrick H.,0,0,0,23
1683327478618,HUM 4,A01,185938,Zroka; Amy Liane,31,0,50,19
1683327478618,HUM 4,B01,185956,Watkins; Eric,0,2,50,50
1683327478618,HUM 4,B02,202209,Watkins; Eric,0,2,50,50
1683327478618,HUM 4,B03,202210,Watkins; Eric,0,2,50,50
1683327479646,HUM 5,A01,185958,West; Geoffrey Scott,3,0,50,47
1683327479646,HUM 5,A02,202215,West; Geoffrey Scott,0,0,50,50
1683327480672,INTL 190,A00,185959,Gagnon; Jeffrey C,0,0,0,9
1683327480672,INTL 190,B00,185960,Lettieri; Michael Joseph,0,0,0,1
1683327481697,JAPN 180,A00,254509,Staff,5,1,30,25
1683327482722,LATI 10,A01,202853,Kennemore; Amy Michelle,4,0,35,31
1683327482722,LATI 10,A02,202854,Kennemore; Amy Michelle,2,0,35,33
1683327482722,LATI 10,A03,270054,Kennemore; Amy Michelle,30,0,30,0
1683327483748,LATI 180,A00,202855,Kennemore; Amy Michelle,11,0,20,9
1683327484775,LAWS 101,A00,201767,Golan; Tal,0,7,40,40
1683327485801,LIFR 1C,A00,185961,Staff,6,0,20,14
1683327486824,LIFR 1CX,A00,185962,Staff,7,0,20,13
1683327487849,LIFR 1D,A00,185963,Staff,9,0,20,11
1683327488876,LIFR 1DX,A00,185964,Staff,9,0,20,11
1683327489902,LIGN 101,A01,186039,Staff,43,0,50,7
1683327490986,LIGN 165,A00,186040,Staff,18,0,50,32
1683327492015,LTCS 108,A00,186041,Staff,6,0,10,4
1683327493041,LTCS 119,A00,186042,Staff,16,0,20,4
1683327494069,LTCS 130,A00,186043,Wesling; Megan E.,15,0,25,10
1683327496118,LTEA 138,A00,186119,Staff,14,0,40,26
1683327497143,LTEN 124,A00,186148,Staff,6,0,25,19
1683327498169,LTEN 178,A00,186149,Staff,7,0,15,8
1683327499195,LTEN 181,A00,186150,Blanco; John D,33,0,40,7
1683327500220,LTWL 120,A00,186160,Staff,20,0,25,5
1683327501246,LTWL 165,A00,186161,Staff,22,0,25,3
1683327502273,LTWR 100,A00,186162,Staff,0,5,15,15
1683327503300,LTWR 102,A00,186163,Doller; Ben,5,0,15,10
1683327504331,MAE 8,A01,186412,Staff,0,0,0,0
1683327505357,MAE 30B,A00,186445,Bahadori; Mohammad Yousef,83,0,100,17
1683327506384,MAE 40,A00,186592,Bewley; Thomas R,9,0,50,41
1683327507409,MAE 101B,A00,186593,Bahadori; Mohammad Yousef,81,0,100,19
1683327508436,MAE 105,A00,186594,Bandaru; Prabhakar,12,0,50,38
1683327509463,MAE 107,A00,186599,Pham; Hieu Tan,0,6,120,120
1683327510487,MAE 148,A01,186660,Silberman; Jack,3,0,16,13
1683327511515,MATH 10A,A01,188095,Staff,1,6,35,34
1683327512539,MATH 10B,A01,188097,Bowers; Adam R.,0,11,30,30
1683327512539,MATH 10B,A02,188099,Bowers; Adam R.,0,11,30,30
1683327512539,MATH 10B,B01,188104,Bowers; Adam R.,0,10,30,30
1683327512539,MATH 10B,B02,188106,Bowers; Adam R.,0,10,30,30
1683327513568,MATH 10C,A01,188111,Staff,0,18,30,30
1683327513568,MATH 10C,A02,188127,Staff,0,17,30,30
1683327513568,MATH 10C,A03,188131,Staff,0,18,30,30
1683327513568,MATH 10C,B01,188218,Staff,18,0,30,12
1683327513568,MATH 10C,B02,188244,Staff,13,0,30,17
1683327513568,MATH 10C,B03,188277,Staff,16,0,30,14
1683327514592,MATH 18,A01,188344,Bach; Quang Tran,18,0,30,12
1683327514592,MATH 18,A02,188345,Bach; Quang Tran,11,0,30,19
1683327514592,MATH 18,B01,188353,Bach; Quang Tran,10,0,30,20
1683327514592,MATH 18,B02,188354,Bach; Quang Tran,20,0,30,10
1683327515616,MATH 20A,A01,188374,Staff,13,0,35,22
1683327516641,MATH 20B,A01,188382,Ohm; Ko Woon,6,0,30,24
1683327516641,MATH 20B,A02,188383,Ohm; Ko Woon,22,0,30,8
1683327516641,MATH 20B,B01,188385,Ohm; Ko Woon,7,0,30,23
1683327516641,MATH 20B,B02,188392,Ohm; Ko Woon,22,0,30,8
1683327517666,MATH 20C,A01,188394,Harel; Guershon,10,0,30,20
1683327517666,MATH 20C,A02,188395,Harel; Guershon,15,0,30,15
1683327517666,MATH 20C,B01,188404,Harel; Guershon,5,0,30,25
1683327517666,MATH 20C,B02,188405,Harel; Guershon,19,0,30,11
1683327518692,MATH 20D,A01,188414,Hammock; Frances H,0,1,30,30
1683327518692,MATH 20D,A02,188415,Hammock; Frances H,2,0,30,28
1683327518692,MATH 20D,B01,188447,Hammock; Frances H,2,0,30,28
1683327518692,MATH 20D,B02,188486,Hammock; Frances H,8,0,30,22
1683327519723,MATH 20E,A01,188649,Staff,21,0,30,9
1683327519723,MATH 20E,A02,188650,Staff,23,0,30,7
1683327519723,MATH 20E,A03,188673,Staff,0,0,30,30
1683327520745,MATH 102,A01,188675,Staff,0,35,35,35
1683327521771,MATH 103B,A01,188681,Staff,3,0,35,32
1683327521771,MATH 103B,B01,188692,Staff,5,0,35,30
1683327522797,MATH 109,A01,188695,Salehi Golsefidy; Alireza,25,0,35,10
1683327522797,MATH 109,A02,188696,Salehi Golsefidy; Alireza,26,0,35,9
1683327523824,MATH 120A,A01,188698,Eggers; John Dietrich,7,0,35,28
1683327524852,MATH 142B,A01,188736,Ioana; Adrian,0,2,30,30
1683327524852,MATH 142B,A02,188741,Ioana; Adrian,0,1,30,30
1683327524852,MATH 142B,A03,188743,Ioana; Adrian,1,3,30,29
1683327525876,MATH 168A,A01,188790,Staff,0,9,35,35
1683327526900,MATH 170A,A01,188803,Nie; Jiawang,0,2,35,35
1683327526900,MATH 170A,A02,188811,Nie; Jiawang,0,0,35,35
1683327526900,MATH 170A,A03,188814,Nie; Jiawang,1,0,35,34
1683327526900,MATH 170A,A04,188815,Nie; Jiawang,13,0,35,22
1683327527925,MATH 193B,A01,188817,Staff,0,0,35,35
1683327527925,MATH 193B,A02,188818,Staff,5,0,35,30
1683327528949,MGT 4,A01,202857,Anderson; John Charles,62,0,80,18
1683327529973,MGT 12,A00,202858,Lindenberger; Wade Douglas,42,0,90,48
1683327530998,MGT 18,A00,202859,Staff,74,0,90,16
1683327532021,MGT 18GS,A00,202860,McKay; Michael J,13,0,28,15
1683327533045,MGT 45,A00,202861,Pecore; Joseph P.,13,0,90,77
1683327534070,MGT 100,A00,202863,Yavorsky; Daniel Ryan,28,0,90,62
1683327535097,MGT 103,A00,202864,Ehrich; Kristine R,1,18,90,89
1683327536124,MGT 112,A00,202865,Ehrich; Kristine R,15,0,90,75
1683327537147,MGT 121A,A00,202868,Staff,0,20,0,0
1683327538171,MGT 131B,A00,202869,Anderson; John Charles,59,0,90,31
1683327539195,MGT 136,A00,202871,Lindenberger; Wade Douglas,84,0,90,6
1683327540223,MGT 164,A00,202873,Staff,0,68,90,91
1683327541267,MGT 164GS,A00,202874,McKay; Mary A,13,0,28,15
1683327542292,MGT 180,A00,202875,Staff,0,50,90,91
1683327543323,MMW 11R,A01,205019,Herbst; Matthew,3,0,30,27
1683327543323,MMW 11R,A02,205026,Herbst; Matthew,29,0,30,1
1683327544355,MMW 15,A01,193512,Chang; Edmond Yi-Teh,0,9,28,28
1683327544355,MMW 15,A02,193513,Chang; Edmond Yi-Teh,0,5,28,28
1683327544355,MMW 15,A03,193514,Chang; Edmond Yi-Teh,0,5,28,28
1683327544355,MMW 15,A04,193515,Chang; Edmond Yi-Teh,0,5,28,28
1683327544355,MMW 15,A05,193516,Chang; Edmond Yi-Teh,0,4,28,28
1683327544355,MMW 15,A06,193517,Chang; Edmond Yi-Teh,0,5,28,28
1683327544355,MMW 15,B01,193519,Chang; Edmond Yi-Teh,0,5,28,28
1683327544355,MMW 15,B02,193520,Chang; Edmond Yi-Teh,0,5,28,28
1683327544355,MMW 15,B03,193521,Chang; Edmond Yi-Teh,0,5,28,28
1683327544355,MMW 15,B04,193522,Chang; Edmond Yi-Teh,0,4,28,28
1683327544355,MMW 15,B05,193523,Chang; Edmond Yi-Teh,0,5,28,28
1683327544355,MMW 15,B06,193524,Chang; Edmond Yi-Teh,0,4,28,28
1683327545383,MMW 122,A01,193526,Rahimi; Babak,0,15,28,28
1683327545383,MMW 122,A02,193527,Rahimi; Babak,0,14,28,28
1683327545383,MMW 122,A03,193528,Rahimi; Babak,0,0,0,0
1683327545383,MMW 122,A04,193529,Rahimi; Babak,0,0,0,0
1683327546411,MUS 1A,A01,186663,Staff,0,20,35,35
1683327547435,MUS 4,A01,186715,Staff,0,12,35,35
1683327548462,MUS 5R,A01,186796,Dubnov; Shlomo,0,17,35,35
1683327549485,MUS 6,A01,186798,Staff,0,4,25,25
1683327550513,MUS 7,A01,186830,Staff,12,0,35,23
1683327551538,MUS 8,A01,186930,Staff,0,27,35,35
1683327552562,MUS 15,A01,186932,Staff,0,16,35,35
1683327552562,MUS 15,B01,186934,Staff,0,15,35,35
1683327553586,MUS 80,A00,186935,Staff,1,0,20,19
1683327553586,MUS 80,B00,186936,Staff,25,0,25,0
1683327554611,NANO 11,A00,204702,Lipomi; Darren John,0,0,0,0
1683327555636,NANO 15,A01,204709,Yang; Kesong,0,1,0,0
1683327556664,NANO 114,A00,202069,Jahed Motlagh; Zeinab,3,0,10,7
1683327557688,PHIL 1,A00,186955,Grush; Rick Scott,32,0,40,8
1683327558712,PHIL 10,A01,186973,Grush; Rick Scott,28,0,35,7
1683327558712,PHIL 10,A02,186974,Grush; Rick Scott,33,0,35,2
1683327559735,PHIL 13,A01,186976,Staff,7,0,35,28
1683327559735,PHIL 13,A02,186977,Staff,16,0,35,19
1683327560759,PHIL 14,A01,186979,Staff,31,0,35,4
1683327560759,PHIL 14,A02,186986,Staff,32,0,35,3
1683327561785,PHIL 28,A01,186988,Staff,16,0,30,14
1683327561785,PHIL 28,A02,186989,Staff,1,0,30,29
1683327561785,PHIL 28,A03,186990,Staff,9,0,30,21
1683327561785,PHIL 28,A04,186991,Staff,26,0,30,4
1683327562808,PHIL 120,A00,186997,Staff,23,0,40,17
1683327563834,PHIL 137,A00,187003,Staff,9,0,40,31
1683327564863,PHIL 150,A00,187015,Staff,47,0,70,23
1683327565888,PHIL 167,A00,187021,Lamey; Andy M.,35,0,40,5
1683327566917,PHIL 174,A01,202226,Staff,17,0,20,3
1683327566917,PHIL 174,A02,202235,Staff,20,0,20,0
1683327567943,PHIL 191A,A00,258918,Staff,0,0,1,1
1683327568969,PHYS 1A,A00,187028,Staff,27,0,60,33
1683327569997,PHYS 1AL,001,187036,Staff,3,0,30,27
1683327569997,PHYS 1AL,002,187049,Staff,18,0,30,12
1683327571024,PHYS 1B,A00,187058,Staff,22,0,60,38
1683327572047,PHYS 1BL,001,187064,Staff,0,0,30,30
1683327572047,PHYS 1BL,002,187070,Staff,5,0,30,25
1683327573070,PHYS 1C,A00,187082,Staff,31,0,120,89
1683327574098,PHYS 1CL,001,187088,Staff,0,9,30,30
1683327574098,PHYS 1CL,002,187089,Staff,0,2,30,30
1683327574098,PHYS 1CL,009,262693,Staff,11,0,30,19
1683327575123,PHYS 2B,A01,187097,Staff,54,0,115,61
1683327576210,PHYS 2C,A01,187099,Staff,67,0,115,48
1683327577238,PHYS 2CL,A01,187101,Staff,5,0,28,23
1683327577238,PHYS 2CL,A02,187102,Staff,15,0,28,13
1683327578267,PHYS 2D,A01,187123,Shotwell; Brian,95,0,115,20
1683327579291,PHYS 4B,A01,187133,Grinstein; Benjamin,35,0,50,15
1683327580318,POLI 10,A00,188819,Staff,0,4,50,50
1683327581344,POLI 11,A00,188827,Staff,43,0,50,7
1683327582368,POLI 13R,A00,188828,Staff,0,1,20,20
1683327583391,POLI 27,A01,188830,Elgin; Samuel Zincke,0,1,70,70
1683327584418,POLI 30,A00,188832,Desposato; Scott,31,0,50,19
1683327585442,POLI 102F,A00,188834,Staff,3,0,40,37
1683327586468,POLI 104A,A00,188852,Staff,14,0,30,16
1683327587495,POLI 104I,A00,188853,Staff,0,6,20,20
1683327588523,POLI 110B,A00,188854,Wiens; David,7,0,20,13
1683327589547,POLI 112A,A00,188855,Wiens; David,5,0,30,25
1683327590571,POLI 117R,A00,188856,Forman; Fonna,0,11,20,20
1683327591595,POLI 118,A00,188857,Ingham; Sean,8,0,20,12
1683327592621,POLI 120G,A00,188858,Staff,9,0,30,21
1683327593650,POLI 131CR,A00,188863,Hoston; Germaine,24,0,50,26
1683327594733,POLI 133,A00,188864,Nellis; Gareth Hb,44,0,50,6
1683327595757,POLI 134D,A00,188865,Desposato; Scott,27,0,30,3
1683327596782,POLI 142A,A00,188871,Gartzke; Erik,22,0,50,28
1683327597806,POLI 142K,A00,188874,Staff,38,0,50,12
1683327598830,POLI 143,A00,188940,Gartzke; Erik,16,0,30,14
1683327599860,POLI 153,A00,188943,Staff,3,0,20,17
1683327600886,POLI 160AA,A00,188944,Staff,12,0,40,28
1683327601912,POLI 170A,A00,188945,Staff,11,0,30,19
1683327603964,PSYC 1,A00,188952,Staff,37,0,90,53
1683327604988,PSYC 2,B00,188953,Staff,19,0,35,16
1683327606012,PSYC 6,A00,188970,Staff,47,0,60,13
1683327607038,PSYC 7,A00,188973,Staff,37,0,45,8
1683327608062,PSYC 60,A01,188980,Rickard; Timothy C.,43,0,60,17
1683327609089,PSYC 70,A01,189001,Steiner; Eric Tomas,24,0,45,21
1683327610117,PSYC 100,A00,189005,Lacefield; Katharine I,0,100,120,120
1683327611141,PSYC 102,A00,189008,Staff,9,0,30,21
1683327612169,PSYC 106,B00,189026,Gorman; Michael R.,34,0,60,26
1683327613205,PSYC 114,B01,189033,Winkielman; Piotr,0,32,30,30
1683327614229,PSYC 131,A00,189036,Anagnostaras; Stephan,0,43,60,60
1683327615253,PSYC 136,A00,189041,Lowe; Angela Beth,0,7,25,25
1683327616280,PSYC 137,A00,189057,Winkielman; Piotr,0,34,25,25
1683327617307,PSYC 144,A00,189107,Wixted; John T,0,7,50,50
1683327619354,PSYC 162,A00,189142,Staff,0,8,85,85
1683327620378,PSYC 172,A00,189144,Gorman; Michael R.,0,7,30,30
1683327622428,PSYC 179,A00,189146,Lacefield; Katharine I,0,84,120,120
1683327623455,PSYC 181,A00,189147,Anagnostaras; Stephan,0,44,90,90
1683327624483,PSYC 190R,A00,189148,Barner; David A.,0,22,80,80
1683327625507,PSYC 191,A00,189275,Rickard; Timothy C.,0,7,25,25
1683327626530,PSYC 193,A00,189276,Chapman; Eddie Nathaniel,0,1,0,4
1683327627554,PSYC 193L,A01,189281,Lowe; Angela Beth,12,0,20,8
1683327627554,PSYC 193L,B01,189285,Staff,28,0,35,7
1683327628579,RELI 149,A00,187137,Rahimi; Babak,7,0,40,33
1683327629602,SE 9,A01,187315,Staff,0,2,18,18
1683327630629,SE 101B,A00,187409,Staff,24,0,30,6
1683327631656,SE 110B,A00,187444,Staff,10,0,40,30
1683327632683,SE 130B,A00,187449,Staff,31,0,40,9
1683327633712,SE 150A,A00,187516,Staff,9,0,20,11
1683327634737,SE 154,A00,187528,Staff,30,0,50,20
1683327635759,SIO 3,A01,258171,Staff,35,0,40,5
1683327636787,SIO 10,A00,187144,Cook; Geoffrey W,0,3,75,75
1683327637812,SIO 45,A00,187152,Cook; Geoffrey W,1,0,100,99
1683327638836,SIO 109R,A00,194486,Staff,0,3,20,20
1683327640886,SIO 187,A01,187233,Kacev; David,12,0,40,28
1683327641915,SOCI 1,A01,258656,Thorpe; Charles Robert,28,0,30,2
1683327641915,SOCI 1,A02,258658,Thorpe; Charles Robert,30,0,30,0
1683327641915,SOCI 1,A03,258661,Thorpe; Charles Robert,25,0,25,0
1683327641915,SOCI 1,A04,258666,Thorpe; Charles Robert,22,0,25,3
1683327641915,SOCI 1,A05,258897,Thorpe; Charles Robert,23,0,25,2
1683327641915,SOCI 1,A06,258898,Thorpe; Charles Robert,25,0,25,0
1683327642937,SOCI 30,A01,258903,Pardo Guerra; Juan Pablo,15,0,30,15
1683327643963,SOCI 102,A00,258904,Staff,9,0,25,16
1683327644988,SOCI 106,A00,258905,Staff,19,0,25,6
1683327646015,SOCI 111,A00,258907,Ribas Norris; Janet Vanesa,26,0,30,4
1683327647041,SOCI 121R,A00,258908,Pardo Guerra; Juan Pablo,10,0,30,20
1683327648067,SOCI 126,A01,203330,Staff,14,0,20,6
1683327649088,SOCI 131,A00,258909,Thorpe; Charles Robert,31,0,60,29
1683327650114,SOCI 135,A00,258910,Payne; Christine Anna,0,9,30,30
1683327651139,SOCI 157,A00,258911,Staff,12,0,30,18
1683327652161,SOCI 184,A00,258912,Staff,25,0,30,5
1683327653185,SOCI 188D,A00,258913,Staff,21,0,30,9
1683327654208,SYN 2,001,187529,Staff,10,0,16,6
1683327654208,SYN 2,002,201452,Staff,0,18,16,16
1683327654208,SYN 2,003,201469,Staff,3,0,16,13
1683327655231,SYN 100,A01,187531,Staff,0,9,20,20
1683327655231,SYN 100,B01,201491,Staff,0,12,20,20
1683327656255,TDAC 1,A00,189286,Walsh; Kim C.,3,0,20,17
1683327656255,TDAC 1,B00,189287,Harting; Carla Kelso,11,0,20,9
1683327657279,TDAC 101,A00,189300,Walsh; Kim C.,16,0,20,4
1683327657279,TDAC 101,B00,189301,Harting; Carla Kelso,18,0,20,2
1683327658306,TDAC 102,A00,189304,Basso; Beatrice,14,0,20,6
1683327659331,TDAC 108,A00,189305,Staff,18,0,20,2
1683327660359,TDDE 131,A00,189310,Staff,19,0,20,1
1683327660359,TDDE 131,B00,189314,Staff,19,0,20,1
1683327660359,TDDE 131,C00,189315,Staff,48,0,50,2
1683327660359,TDDE 131,D00,189316,Staff,14,0,15,1
1683327660359,TDDE 131,E00,204841,Staff,20,0,20,0
1683327661386,TDGE 10,A00,189289,Staff,30,0,50,20
1683327661386,TDGE 10,B00,189290,Havis; Allan,1,0,50,49
1683327662429,TDGE 11,A00,189291,Fulton; Julia,0,3,50,50
1683327662429,TDGE 11,B00,189292,Staff,20,0,25,5
1683327662429,TDGE 11,C00,260270,Staff,0,0,0,0
1683327663458,TDGE 25,A00,189294,Staff,3,0,20,17
1683327664488,TDGE 124,A00,189318,Fulton; Julia,0,8,50,50
1683327665514,TDGE 125,A00,189319,Staff,13,0,25,12
1683327665514,TDGE 125,B00,189320,Staff,23,0,25,2
1683327666541,TDGE 127,A00,189322,Havis; Allan,0,0,50,50
1683327667568,TDHT 101,A00,189323,Staff,18,0,25,7
1683327667568,TDHT 101,B00,189324,Staff,25,0,25,0
1683327668596,TDHT 102,A00,189325,Staff,49,0,50,1
1683327669620,TDMV 1,A00,189295,Arcidiacono; Kristin,19,0,30,11
1683327669620,TDMV 1,B00,189296,Caligagan; Maria T.,24,0,30,6
1683327670645,TDMV 2,A00,189297,Sammartano; Tonnie,28,0,30,2
1683327670645,TDMV 2,B00,189299,Arcidiacono; Kristin,24,0,30,6
1683327671667,TDMV 3,A00,204998,Rincon; Alicia,22,0,30,8
1683327672694,TDMV 120,A00,189458,Sammartano; Tonnie,28,0,30,2
1683327673721,TDMV 138,A00,189541,Jun; Grace Shin Hae,22,0,40,18
1683327674744,TDMV 142,A00,189717,Caligagan; Tony,23,0,30,7
1683327674744,TDMV 142,B00,189718,Caligagan; Maria T.,25,0,30,5
1683327675771,TMC 2,A01,187533,Staff,25,0,25,0
1683327675771,TMC 2,A02,187534,Staff,25,0,25,0
1683327676798,USP 1,A01,187536,Kwak; Nancy,0,16,25,25
1683327677823,USP 5,A01,187538,Staff,10,0,25,15
1683327678851,USP 101,A00,199253,Staff,0,4,0,0
1683327679881,USP 124,A00,187562,Boomhower; Matthew Charles,1,0,30,29
1683327680907,USP 138,A00,187582,Staff,20,0,25,5
1683327681935,USP 152,A01,187597,Staff,4,0,25,21
1683327682958,USP 153,A00,187598,Staff,19,0,25,6
1683327683985,USP 168,A00,187607,Kwak; Nancy,2,0,5,3
1683327685008,USP 173,A00,187619,Staff,4,0,25,21
1683327686035,USP 181,A00,187638,Staff,0,0,25,25
1683327687057,VIS 103,A00,187650,Cruz; Edwin Teddy,23,0,75,52
1683327688081,VIS 110D,A00,187669,Staff,12,0,22,10
1683327689106,VIS 127C,A00,187720,Shen; Kuiyi,67,0,146,79
1683327690130,VIS 149,A00,187731,Yoldas; Pinar,0,14,22,22
1683327691153,VIS 151,A01,188091,Staff,22,0,34,12
1683327691153,VIS 151,A02,188092,Staff,11,0,34,23
1683327692177,VIS 160B,A00,188093,Stalbaum; Brett,0,0,10,10
1683327694228,WCWP 10B,A00,201720,Staff,10,0,15,5
1683327694228,WCWP 10B,B00,201722,Staff,8,0,15,7
1683327695251,WCWP 100,A00,201725,Gagnon; Jeffrey C,0,0,2,2
1683327695251,WCWP 100,B00,201727,Staff,0,4,15,15
1683327698413,ANBI 133,A00,258401,Wilder; Linnea Lorene,34,0,40,6
1683327699439,ANBI 140,A00,258395,Hrvoj Mihic; Branka,18,0,25,7
1683327700462,ANSC 120,A00,258402,Bialecki; Jon Anthony,27,0,40,13
1683327701486,ANSC 144,A00,258400,Staff,14,0,40,26
1683327703536,ANSC 166,A00,258396,Parish; Steven Martin,157,0,175,18
1683327704560,ANSC 180,A00,193533,Staff,9,0,20,11
1683327705586,ANSC 188,A00,258397,Jassal; Aftab,33,0,40,7
1683327706623,ANTH 3,A01,258316,Staff,23,0,30,7
1683327707646,ANTH 5,A00,258394,Semendeferi; Ekaterini,16,0,20,4
1683327708670,ANTH 21,A01,258331,Staff,8,0,40,32
1683327709693,ANTH 103,A00,258398,Varma; Saiba,15,0,25,10
1683327710722,AWP 10,001,202034,Staff,0,0,0,0
1683327710722,AWP 10,002,202035,Staff,0,0,0,0
1683327710722,AWP 10,003,202036,Staff,0,0,0,0
1683327710722,AWP 10,004,202037,Staff,0,0,0,0
1683327710722,AWP 10,005,202038,Staff,0,0,0,0
1683327710722,AWP 10,006,202039,Staff,0,0,0,0
1683327710722,AWP 10,007,202040,Staff,0,0,0,0
1683327710722,AWP 10,008,202041,Staff,0,0,0,0
1683327710722,AWP 10,009,202042,Staff,0,0,0,0
1683327710722,AWP 10,010,202043,Staff,0,0,0,0
1683327710722,AWP 10,011,202044,Staff,0,0,0,0
1683327710722,AWP 10,012,202045,Staff,0,0,0,0
1683327710722,AWP 10,013,202046,Staff,0,0,0,0
1683327710722,AWP 10,014,202047,Staff,0,0,0,0
1683327710722,AWP 10,015,202048,Staff,0,0,0,0
1683327710722,AWP 10,016,202049,Staff,0,0,0,0
1683327710722,AWP 10,017,202050,Staff,0,0,0,0
1683327710722,AWP 10,018,202051,Staff,0,0,0,0
1683327710722,AWP 10,019,202052,Staff,0,0,0,0
1683327710722,AWP 10,020,202053,Staff,0,0,0,0
1683327710722,AWP 10,021,202054,Staff,0,0,0,0
1683327710722,AWP 10,022,202055,Staff,0,0,0,0
1683327710722,AWP 10,023,202056,Staff,0,0,0,0
1683327710722,AWP 10,024,202057,Staff,0,0,0,0
1683327710722,AWP 10,025,202058,Staff,0,0,0,0
1683327710722,AWP 10,026,202059,Staff,0,0,0,0
1683327711747,AWP 102,001,202032,Staff,0,0,0,0
1683327711747,AWP 102,002,202033,Staff,0,0,0,0
1683327712777,BENG 100,A01,254234,Taylor Amos; Alyssa C,31,0,40,9
1683327713804,BENG 196,001,270013,Engler; Adam J.,9999,0,9999,0
1683327714830,BICD 100R,A01,202018,Smith; Laurie,0,7,32,32
1683327714830,BICD 100R,A02,202019,Smith; Laurie,0,2,32,32
1683327714830,BICD 100R,A03,202020,Smith; Laurie,0,1,32,32
1683327714830,BICD 100R,A04,202021,Smith; Laurie,9,0,32,23
1683327714830,BICD 100R,A05,202022,Smith; Laurie,12,0,32,20
1683327715885,BICD 136,A01,193242,Gustafson-Brown; Cindy,0,2,32,32
1683327715885,BICD 136,A02,193244,Gustafson-Brown; Cindy,14,0,32,18
1683327716911,BIEB 102,A01,193249,Butler; Shannon Rhey,0,2,32,32
1683327716911,BIEB 102,A02,193251,Butler; Shannon Rhey,0,0,32,32
1683327716911,BIEB 102,A03,193253,Butler; Shannon Rhey,0,1,32,32
1683327716911,BIEB 102,A04,193255,Butler; Shannon Rhey,17,0,32,15
1683327716911,BIEB 102,A05,193265,Butler; Shannon Rhey,26,0,32,6
1683327716911,BIEB 102,A06,193269,Butler; Shannon Rhey,16,0,32,16
1683327718963,BIEB 150,A01,193274,Staff,0,0,32,32
1683327718963,BIEB 150,A02,193285,Staff,23,0,32,9
1683327719988,BIEB 194,A00,193286,Kurle; Carolyn M.,22,0,32,10
1683327721018,BILD 1,A01,192291,Staff,16,0,32,16
1683327721018,BILD 1,A02,192292,Staff,30,0,32,2
1683327721018,BILD 1,B01,192520,Reuther; Keefe,0,1,0,0
1683327721018,BILD 1,B02,192532,Reuther; Keefe,0,1,0,0
1683327722047,BILD 3,A01,192556,Butler; Shannon Rhey,0,0,32,32
1683327722047,BILD 3,A02,192581,Butler; Shannon Rhey,5,0,32,27
1683327722047,BILD 3,A03,192611,Butler; Shannon Rhey,23,0,32,9
1683327722047,BILD 3,A04,192612,Butler; Shannon Rhey,25,0,32,7
1683327722047,BILD 3,A05,192613,Butler; Shannon Rhey,27,0,32,5
1683327722047,BILD 3,A06,192679,Butler; Shannon Rhey,27,0,32,5
1683327722047,BILD 3,A07,192682,Butler; Shannon Rhey,22,0,32,10
1683327723074,BILD 4,A01,192836,Reuther; Keefe,0,0,24,24
1683327723074,BILD 4,A02,193044,Reuther; Keefe,4,0,24,20
1683327724099,BILD 10,A01,193142,Gustafson-Brown; Cindy,30,0,32,2
1683327724099,BILD 10,A02,193149,Gustafson-Brown; Cindy,31,0,32,1
1683327725123,BIMM 100,A01,193301,Staff,0,6,32,32
1683327725123,BIMM 100,A02,193312,Staff,0,5,32,32
1683327725123,BIMM 100,A03,193323,Staff,0,8,32,32
1683327726151,BIMM 101,A01,193329,McDonnell; Lisa Marie,0,3,24,24
1683327726151,BIMM 101,A02,193339,McDonnell; Lisa Marie,0,3,24,24
1683327726151,BIMM 101,B01,193354,McDonnell; Lisa Marie,0,3,24,24
1683327726151,BIMM 101,B02,193357,McDonnell; Lisa Marie,0,3,24,24
1683327727177,BIMM 110,A01,193377,Tat; John,0,11,32,32
1683327727177,BIMM 110,A02,193378,Tat; John,1,9,32,31
1683327728201,BIMM 120,A01,206116,Staff,0,0,32,32
1683327728201,BIMM 120,A02,206117,Staff,8,0,32,24
1683327728201,BIMM 120,A03,206121,Staff,21,0,32,11
1683327729230,BIPN 100,A01,193393,Park; Ji Young,0,14,32,32
1683327729230,BIPN 100,A02,193402,Park; Ji Young,0,13,32,32
1683327729230,BIPN 100,A03,193413,Park; Ji Young,0,14,32,32
1683327729230,BIPN 100,A04,193414,Park; Ji Young,0,13,32,32
1683327730253,BIPN 102,A01,193429,Staff,0,0,32,32
1683327730253,BIPN 102,A02,193438,Staff,22,0,32,10
1683327731307,BIPN 106,A01,193450,Reyes Gonzalez; Catalina,0,2,40,40
1683327732337,BIPN 134,A01,193465,Cooke; James Edward,0,0,32,32
1683327732337,BIPN 134,A02,193474,Cooke; James Edward,25,0,32,7
1683327732337,BIPN 134,A03,193485,Cooke; James Edward,29,0,32,3
1683327732337,BIPN 134,A04,193486,Cooke; James Edward,21,0,32,11
1683327732337,BIPN 134,A05,193491,Cooke; James Edward,31,0,32,1
1683327732337,BIPN 134,A06,193501,Cooke; James Edward,30,0,32,2
1683327732337,BIPN 134,A07,193510,Cooke; James Edward,29,0,32,3
1683327734383,BISP 194,A00,222522,Staff,14,0,32,18
1683327735409,CAT 124,A01,202407,Staff,20,0,25,5
1683327736437,CAT 125,A00,202408,Marchisotto; Jennifer Anne,4,0,20,16
1683327737465,CAT 125R,A00,202409,Smith; Lauryn Alissa,0,11,20,20
1683327737465,CAT 125R,B00,202410,Morales; Celeste Georgianna,0,11,20,20
1683327737465,CAT 125R,C00,202411,Irwin; Matthew Joseph,0,10,20,20
1683327738491,CENG 15,A01,204712,Yang; Kesong,0,1,0,0
1683327739515,CENG 114,A00,202070,Jahed Motlagh; Zeinab,5,0,20,15
1683327740538,CGS 105,A00,185477,Wesling; Megan E.,24,0,40,16
1683327741561,CGS 106,A00,185494,Staff,13,0,22,9
1683327742586,CGS 108,A00,185495,Staff,14,0,20,6
1683327743614,CGS 114,A00,185496,Staff,13,0,18,5
1683327744639,CGS 119,A00,185501,Staff,15,0,20,5
1683327745666,CGS 120,A00,185511,Staff,13,0,20,7
1683327746696,CHEM 4,A01,184675,Bussey; Thomas J,96,0,100,4
1683327747721,CHEM 6A,A01,184677,Staff,34,0,60,26
1683327748751,CHEM 6B,A01,184679,Staff,65,0,100,35
1683327749776,CHEM 6C,A01,184681,Bussey; Thomas J,1,0,50,49
1683327749776,CHEM 6C,A02,184682,Bussey; Thomas J,34,0,50,16
1683327750802,CHEM 40A,A01,184684,Albizati; Kim F.,37,0,100,63
1683327751827,CHEM 40B,A01,184686,Albizati; Kim F.,0,20,100,100
1683327752889,CHEM 41B,A01,184690,Staff,52,0,100,48
1683327753914,COGS 3,A01,184715,Boyle; Mary E. T.,0,25,40,40
1683327754940,COGS 14B,A01,185172,Staff,0,15,38,38
1683327755966,COGS 18,A01,184736,Staff,17,0,80,63
1683327756994,COGS 100,A01,184932,Staff,0,5,73,73
1683327758021,COGS 101A,A01,184935,Staff,0,38,30,30
1683327759045,COGS 101B,A01,184944,Staff,0,2,30,30
1683327760068,COGS 101C,A01,184946,Staff,0,12,30,30
1683327761093,COGS 102A,A01,184951,Johnson; Christine M.,2,0,40,38
1683327762118,COGS 107B,A01,184953,Mooshagian; Eric Frederick,0,50,40,40
1683327763142,COGS 118B,A01,184959,Gupta; Anjum,0,48,40,40
1683327764166,COGS 153,A00,184961,Staff,0,15,30,30
1683327765190,COGS 177,A00,184962,Staff,0,20,30,30
1683327766217,COGS 187A,A01,184969,Boyle; Mary E. T.,0,17,40,40
1683327767243,COMM 10,A01,185174,Staff,0,5,25,25
1683327767243,COMM 10,A02,185189,Staff,0,5,25,25
1683327767243,COMM 10,A03,269821,Staff,0,0,0,0
1683327768279,COMM 100B,A01,185475,Staff,0,0,0,2
1683327768279,COMM 100B,A02,185476,Staff,14,0,25,11
1683327769303,COMM 100C,A01,185314,Staff,1,0,25,24
1683327769303,COMM 100C,A02,185327,Staff,19,0,25,6
1683327770326,COMM 110M,A00,185349,Staff,2,0,40,38
1683327771350,COMM 113T,A00,185352,Staff,24,0,40,16
1683327772373,COMM 114I,A00,185353,Staff,33,0,40,7
1683327773396,COMM 131,A00,185354,Staff,19,0,30,11
1683327774421,CSE 8A,A50,185358,Cao; Yingjun,0,46,10,10
1683327775445,CSE 8B,A01,185362,Staff,1,47,50,49
1683327776470,CSE 11,A01,185416,Cao; Yingjun,0,92,10,10
1683327777496,CSE 20,A01,185445,Briones; Jor-el Thomas Caparas,5,0,25,20
1683327778522,CSE 21,A01,185447,Staff,10,0,50,40
1683327779549,CSE 101,A01,185451,Staff,0,12,50,50
1683327779549,CSE 101,B01,185453,Jones; Miles E,0,11,50,50
1683327781602,CSE 141,A01,185458,Eldon; John,20,0,100,80
1683327782630,CSE 141L,A01,185461,Eldon; John,12,0,100,88
1683327783658,CSE 142,A01,185463,Staff,36,0,60,24
1683327783658,CSE 142,B01,201355,Staff,0,7,60,60
1683327784681,CSE 142L,A01,185470,Staff,36,0,60,24
1683327784681,CSE 142L,B01,201417,Staff,0,6,60,60
1683327785704,CSE 190,A00,201433,Staff,32,0,49,17
1683327786732,DOC 1,A01,259136,Strom; Megan C.,7,0,15,8
1683327786732,DOC 1,A02,259137,Strom; Megan C.,14,0,15,1
1683327786732,DOC 1,A03,259138,Strom; Megan C.,14,0,15,1
1683327786732,DOC 1,A04,259139,Strom; Megan C.,14,0,15,1
1683327787757,DOC 100D,A00,259140,Pass; Natalye Joann,16,0,25,9
1683327788783,DSGN 1,A01,184749,Rill; Bryan,0,26,30,30
1683327789807,DSGN 100,A01,185168,Staff,0,2,25,25
1683327790830,ECE 5,A01,185626,Morris; Karcher William,0,10,0,0
1683327791880,ECE 101,A01,185628,Staff,17,0,70,53
1683327792905,ECE 107,A01,185635,Baghdadchi; Saharnaz,0,0,20,20
1683327792905,ECE 107,A02,185638,Baghdadchi; Saharnaz,4,0,20,16
1683327793932,ECE 148,A01,185647,Silberman; Jack,0,0,16,16
1683327794958,ECON 1,A01,185537,Crane; Meredith Helen,54,0,70,16
1683327795983,ECON 3,A01,185549,Crane; Meredith Helen,33,0,70,37
1683327797008,ECON 4,A01,203354,Anderson; John Charles,0,4,10,10
1683327798032,ECON 100A,A01,185574,Staff,0,4,40,40
1683327799055,ECON 100B,A01,185576,Staff,10,22,50,40
1683327800082,ECON 100C,A01,185589,Newhouse; Herbert S,30,0,70,40
1683327801107,ECON 105,A00,185608,Vespa; Emanuel Ignacio,19,0,35,16
1683327802187,ECON 109,A01,185610,Shishkin; Denis,10,0,35,25
1683327803214,ECON 110A,A01,185612,Staff,11,0,40,29
1683327804238,ECON 120A,A01,185615,Staff,20,0,40,20
1683327805273,ECON 120C,A01,185617,Sun; Yixiao,0,20,70,70
1683327806302,ECON 144,A00,203346,Squires; Dale E,3,0,35,32
1683327807331,ECON 171,A01,203349,Newhouse; Herbert S,0,1,35,35
1683327808355,ECON 173A,A01,185621,Toda; Alexis Akira,21,0,35,14
1683327809382,EDS 25,A01,202413,Staff,0,1,0,0
1683327809382,EDS 25,A02,202414,Staff,0,1,0,0
1683327809382,EDS 25,A03,202415,Staff,0,0,0,0
1683327809382,EDS 25,A04,202416,Staff,0,1,0,0
1683327809382,EDS 25,A05,202439,Staff,0,0,0,0
1683327809382,EDS 25,A06,202440,Staff,0,0,0,0
1683327809382,EDS 25,B01,202631,Staff,0,0,0,0
1683327809382,EDS 25,B02,202632,Staff,0,0,0,0
1683327809382,EDS 25,B03,202639,Staff,0,0,0,0
1683327809382,EDS 25,B04,202640,Staff,0,0,0,0
1683327809382,EDS 25,B05,202643,Staff,0,0,0,0
1683327809382,EDS 25,B06,202644,Staff,0,0,0,0
1683327810406,EDS 38,A01,202659,Black; Alison Michelle,24,0,25,1
1683327811430,EDS 115,A00,202652,Staff,17,0,30,13
1683327812453,EDS 125,A00,202649,Staff,14,0,30,16
1683327813478,EDS 126,A01,203332,Staff,30,0,30,0
1683327814504,EDS 139,A00,202838,Staff,16,0,25,9
1683327815530,EDS 146,A01,202655,Staff,14,0,25,11
1683327816555,ENG 15,A00,185667,Staff,0,1,0,0
1683327816555,ENG 15,B00,185672,Staff,0,0,0,0
1683327816555,ENG 15,C00,185675,Staff,0,0,0,0
1683327816555,ENG 15,D00,185682,Staff,0,0,0,0
1683327816555,ENG 15,E00,185684,Staff,0,0,0,0
1683327817579,ETHN 103,A00,185710,Staff,0,3,35,35
1683327818607,ETHN 103A,A00,199228,Man; Simeon S,2,0,9,7
1683327819632,ETHN 109,A00,185711,Staff,18,0,35,17
1683327820660,ETHN 142,A00,185726,Staff,0,4,30,30
1683327821683,ETHN 163J,A00,199229,Man; Simeon S,5,0,8,3
1683327822710,ETHN 168,A00,185727,Staff,8,0,10,2
1683327823736,ETHN 182,A00,185728,Staff,1,0,35,34
1683327824762,ETHN 183,A00,185737,Staff,8,0,18,10
1683327825790,GLBH 111,A01,209361,Burgos; Jose L.,0,0,0,0
1683327827841,HIEU 104,A00,185792,Staff,16,0,20,4
1683327828882,HIEU 115,A00,185800,Staff,1,0,20,19
1683327829911,HIEU 128,A00,185801,Staff,0,7,20,20
1683327830934,HIEU 147,A00,185802,Staff,16,0,20,4
1683327831959,HIEU 154,A00,185823,Staff,12,0,20,8
1683327832987,HILA 102,A00,185826,Staff,13,0,20,7
1683327834015,HILD 2C,A01,185778,Staff,0,12,20,20
1683327835039,HILD 7B,A01,185780,Kwak; Nancy,0,15,32,32
1683327835039,HILD 7B,A02,185781,Kwak; Nancy,0,18,32,32
1683327836064,HILD 30,A01,185791,Staff,14,0,20,6
1683327837093,HISC 119,A00,185830,Golan; Tal,0,9,20,20
1683327838118,HITO 156GS,A00,185831,Patterson; Patrick H.,0,0,0,23
1683327839147,HIUS 103,A00,185832,Man; Simeon S,0,6,20,20
1683327840174,HIUS 117,A00,185836,Kwak; Nancy,2,0,20,18
1683327841201,HIUS 125,A00,185840,Man; Simeon S,0,0,23,23
1683327842230,HIUS 149,A00,185845,Staff,0,0,20,20
1683327843256,HUM 3,A01,185882,Zavodny; Tatiana Sophia,0,7,50,50
1683327843256,HUM 3,B01,185899,Caldwell; Michael Alan,0,18,50,50
1683327844281,HUM 3GS,A00,185900,Patterson; Patrick H.,0,0,0,23
1683327845310,HUM 4,A01,185938,Zroka; Amy Liane,31,0,50,19
1683327845310,HUM 4,B01,185956,Watkins; Eric,0,2,50,50
1683327845310,HUM 4,B02,202209,Watkins; Eric,0,2,50,50
1683327845310,HUM 4,B03,202210,Watkins; Eric,0,2,50,50
1683327846337,HUM 5,A01,185958,West; Geoffrey Scott,3,0,50,47
1683327846337,HUM 5,A02,202215,West; Geoffrey Scott,0,0,50,50
1683327847363,INTL 190,A00,185959,Gagnon; Jeffrey C,0,0,0,9
1683327847363,INTL 190,B00,185960,Lettieri; Michael Joseph,0,0,0,1
1683327848392,JAPN 180,A00,254509,Staff,5,1,30,25
1683327849418,LATI 10,A01,202853,Kennemore; Amy Michelle,4,0,35,31
1683327849418,LATI 10,A02,202854,Kennemore; Amy Michelle,2,0,35,33
1683327849418,LATI 10,A03,270054,Kennemore; Amy Michelle,30,0,30,0
1683327850445,LATI 180,A00,202855,Kennemore; Amy Michelle,11,0,20,9
1683327851473,LAWS 101,A00,201767,Golan; Tal,0,7,40,40
1683327852500,LIFR 1C,A00,185961,Staff,6,0,20,14
1683327853528,LIFR 1CX,A00,185962,Staff,7,0,20,13
1683327854552,LIFR 1D,A00,185963,Staff,9,0,20,11
1683327855581,LIFR 1DX,A00,185964,Staff,9,0,20,11
1683327856608,LIGN 101,A01,186039,Staff,43,0,50,7
1683327857633,LIGN 165,A00,186040,Staff,18,0,50,32
1683327858660,LTCS 108,A00,186041,Staff,6,0,10,4
1683327859685,LTCS 119,A00,186042,Staff,16,0,20,4
1683327860710,LTCS 130,A00,186043,Wesling; Megan E.,15,0,25,10
1683327862761,LTEA 138,A00,186119,Staff,14,0,40,26
1683327863786,LTEN 124,A00,186148,Staff,6,0,25,19
1683327864822,LTEN 178,A00,186149,Staff,7,0,15,8
1683327865846,LTEN 181,A00,186150,Blanco; John D,33,0,40,7
1683327866871,LTWL 120,A00,186160,Staff,20,0,25,5
1683327867898,LTWL 165,A00,186161,Staff,22,0,25,3
1683327868922,LTWR 100,A00,186162,Staff,0,5,15,15
1683327869947,LTWR 102,A00,186163,Doller; Ben,5,0,15,10
1683327870970,MAE 8,A01,186412,Staff,0,0,0,0
1683327871994,MAE 30B,A00,186445,Bahadori; Mohammad Yousef,83,0,100,17
1683327873018,MAE 40,A00,186592,Bewley; Thomas R,9,0,50,41
1683327874041,MAE 101B,A00,186593,Bahadori; Mohammad Yousef,81,0,100,19
1683327875068,MAE 105,A00,186594,Bandaru; Prabhakar,12,0,50,38
1683327876096,MAE 107,A00,186599,Pham; Hieu Tan,0,6,120,120
1683327877121,MAE 148,A01,186660,Silberman; Jack,3,0,16,13
1683327878145,MATH 10A,A01,188095,Staff,1,6,35,34
1683327879173,MATH 10B,A01,188097,Bowers; Adam R.,0,11,30,30
1683327879173,MATH 10B,A02,188099,Bowers; Adam R.,0,11,30,30
1683327879173,MATH 10B,B01,188104,Bowers; Adam R.,0,10,30,30
1683327879173,MATH 10B,B02,188106,Bowers; Adam R.,0,10,30,30
1683327880197,MATH 10C,A01,188111,Staff,0,18,30,30
1683327880197,MATH 10C,A02,188127,Staff,0,17,30,30
1683327880197,MATH 10C,A03,188131,Staff,0,18,30,30
1683327880197,MATH 10C,B01,188218,Staff,18,0,30,12
1683327880197,MATH 10C,B02,188244,Staff,13,0,30,17
1683327880197,MATH 10C,B03,188277,Staff,16,0,30,14
1683327881222,MATH 18,A01,188344,Bach; Quang Tran,18,0,30,12
1683327881222,MATH 18,A02,188345,Bach; Quang Tran,11,0,30,19
1683327881222,MATH 18,B01,188353,Bach; Quang Tran,10,0,30,20
1683327881222,MATH 18,B02,188354,Bach; Quang Tran,20,0,30,10
1683327882249,MATH 20A,A01,188374,Staff,13,0,35,22
1683327883274,MATH 20B,A01,188382,Ohm; Ko Woon,6,0,30,24
1683327883274,MATH 20B,A02,188383,Ohm; Ko Woon,22,0,30,8
1683327883274,MATH 20B,B01,188385,Ohm; Ko Woon,7,0,30,23
1683327883274,MATH 20B,B02,188392,Ohm; Ko Woon,22,0,30,8
1683327884302,MATH 20C,A01,188394,Harel; Guershon,10,0,30,20
1683327884302,MATH 20C,A02,188395,Harel; Guershon,15,0,30,15
1683327884302,MATH 20C,B01,188404,Harel; Guershon,5,0,30,25
1683327884302,MATH 20C,B02,188405,Harel; Guershon,19,0,30,11
1683327885330,MATH 20D,A01,188414,Hammock; Frances H,0,1,30,30
1683327885330,MATH 20D,A02,188415,Hammock; Frances H,2,0,30,28
1683327885330,MATH 20D,B01,188447,Hammock; Frances H,2,0,30,28
1683327885330,MATH 20D,B02,188486,Hammock; Frances H,8,0,30,22
1683327886358,MATH 20E,A01,188649,Staff,21,0,30,9
1683327886358,MATH 20E,A02,188650,Staff,23,0,30,7
1683327886358,MATH 20E,A03,188673,Staff,0,0,30,30
1683327887384,MATH 102,A01,188675,Staff,0,35,35,35
1683327888408,MATH 103B,A01,188681,Staff,3,0,35,32
1683327888408,MATH 103B,B01,188692,Staff,5,0,35,30
1683327889433,MATH 109,A01,188695,Salehi Golsefidy; Alireza,25,0,35,10
1683327889433,MATH 109,A02,188696,Salehi Golsefidy; Alireza,26,0,35,9
1683327890461,MATH 120A,A01,188698,Eggers; John Dietrich,7,0,35,28
1683327891484,MATH 142B,A01,188736,Ioana; Adrian,0,2,30,30
1683327891484,MATH 142B,A02,188741,Ioana; Adrian,1,1,30,29
1683327891484,MATH 142B,A03,188743,Ioana; Adrian,1,3,30,29
1683327892512,MATH 168A,A01,188790,Staff,0,9,35,35
1683327893541,MATH 170A,A01,188803,Nie; Jiawang,0,2,35,35
1683327893541,MATH 170A,A02,188811,Nie; Jiawang,0,0,35,35
1683327893541,MATH 170A,A03,188814,Nie; Jiawang,1,0,35,34
1683327893541,MATH 170A,A04,188815,Nie; Jiawang,13,0,35,22
1683327894564,MATH 193B,A01,188817,Staff,0,0,35,35
1683327894564,MATH 193B,A02,188818,Staff,5,0,35,30
1683327895588,MGT 4,A01,202857,Anderson; John Charles,62,0,80,18
1683327896612,MGT 12,A00,202858,Lindenberger; Wade Douglas,42,0,90,48
1683327897636,MGT 18,A00,202859,Staff,74,0,90,16
1683327898662,MGT 18GS,A00,202860,McKay; Michael J,13,0,28,15
1683327899688,MGT 45,A00,202861,Pecore; Joseph P.,13,0,90,77
1683327900715,MGT 100,A00,202863,Yavorsky; Daniel Ryan,28,0,90,62
1683327901744,MGT 103,A00,202864,Ehrich; Kristine R,1,18,90,89
1683327902768,MGT 112,A00,202865,Ehrich; Kristine R,15,0,90,75
1683327903793,MGT 121A,A00,202868,Staff,0,20,0,0
1683327904821,MGT 131B,A00,202869,Anderson; John Charles,59,0,90,31
1683327905901,MGT 136,A00,202871,Lindenberger; Wade Douglas,84,0,90,6
1683327906925,MGT 164,A00,202873,Staff,0,68,90,91
1683327907947,MGT 164GS,A00,202874,McKay; Mary A,13,0,28,15
1683327908972,MGT 180,A00,202875,Staff,0,50,90,91
1683327909996,MMW 11R,A01,205019,Herbst; Matthew,3,0,30,27
1683327909996,MMW 11R,A02,205026,Herbst; Matthew,29,0,30,1
1683327911022,MMW 15,A01,193512,Chang; Edmond Yi-Teh,0,9,28,28
1683327911022,MMW 15,A02,193513,Chang; Edmond Yi-Teh,0,5,28,28
1683327911022,MMW 15,A03,193514,Chang; Edmond Yi-Teh,0,5,28,28
1683327911022,MMW 15,A04,193515,Chang; Edmond Yi-Teh,0,5,28,28
1683327911022,MMW 15,A05,193516,Chang; Edmond Yi-Teh,0,4,28,28
1683327911022,MMW 15,A06,193517,Chang; Edmond Yi-Teh,0,5,28,28
1683327911022,MMW 15,B01,193519,Chang; Edmond Yi-Teh,0,5,28,28
1683327911022,MMW 15,B02,193520,Chang; Edmond Yi-Teh,0,5,28,28
1683327911022,MMW 15,B03,193521,Chang; Edmond Yi-Teh,0,5,28,28
1683327911022,MMW 15,B04,193522,Chang; Edmond Yi-Teh,0,4,28,28
1683327911022,MMW 15,B05,193523,Chang; Edmond Yi-Teh,0,5,28,28
1683327911022,MMW 15,B06,193524,Chang; Edmond Yi-Teh,0,4,28,28
1683327912045,MMW 122,A01,193526,Rahimi; Babak,0,15,28,28
1683327912045,MMW 122,A02,193527,Rahimi; Babak,0,14,28,28
1683327912045,MMW 122,A03,193528,Rahimi; Babak,0,0,0,0
1683327912045,MMW 122,A04,193529,Rahimi; Babak,0,0,0,0
1683327913069,MUS 1A,A01,186663,Staff,0,20,35,35
1683327914096,MUS 4,A01,186715,Staff,0,12,35,35
1683327915119,MUS 5R,A01,186796,Dubnov; Shlomo,0,17,35,35
1683327916143,MUS 6,A01,186798,Staff,0,4,25,25
1683327917168,MUS 7,A01,186830,Staff,12,0,35,23
1683327918191,MUS 8,A01,186930,Staff,0,27,35,35
1683327919215,MUS 15,A01,186932,Staff,0,16,35,35
1683327919215,MUS 15,B01,186934,Staff,0,15,35,35
1683327920238,MUS 80,A00,186935,Staff,1,0,20,19
1683327920238,MUS 80,B00,186936,Staff,25,0,25,0
1683327921262,NANO 11,A00,204702,Lipomi; Darren John,0,0,0,0
1683327922287,NANO 15,A01,204709,Yang; Kesong,0,1,0,0
1683327923310,NANO 114,A00,202069,Jahed Motlagh; Zeinab,3,0,10,7
1683327924335,PHIL 1,A00,186955,Grush; Rick Scott,32,0,40,8
1683327925361,PHIL 10,A01,186973,Grush; Rick Scott,28,0,35,7
1683327925361,PHIL 10,A02,186974,Grush; Rick Scott,33,0,35,2
1683327926385,PHIL 13,A01,186976,Staff,7,0,35,28
1683327926385,PHIL 13,A02,186977,Staff,16,0,35,19
1683327927409,PHIL 14,A01,186979,Staff,31,0,35,4
1683327927409,PHIL 14,A02,186986,Staff,32,0,35,3
1683327928435,PHIL 28,A01,186988,Staff,16,0,30,14
1683327928435,PHIL 28,A02,186989,Staff,1,0,30,29
1683327928435,PHIL 28,A03,186990,Staff,9,0,30,21
1683327928435,PHIL 28,A04,186991,Staff,26,0,30,4
1683327929473,PHIL 120,A00,186997,Staff,23,0,40,17
1683327930499,PHIL 137,A00,187003,Staff,9,0,40,31
1683327931525,PHIL 150,A00,187015,Staff,47,0,70,23
1683327932549,PHIL 167,A00,187021,Lamey; Andy M.,35,0,40,5
1683327933573,PHIL 174,A01,202226,Staff,17,0,20,3
1683327933573,PHIL 174,A02,202235,Staff,20,0,20,0
1683327934597,PHIL 191A,A00,258918,Staff,0,0,1,1
1683327935621,PHYS 1A,A00,187028,Staff,27,0,60,33
1683327936646,PHYS 1AL,001,187036,Staff,3,0,30,27
1683327936646,PHYS 1AL,002,187049,Staff,18,0,30,12
1683327937669,PHYS 1B,A00,187058,Staff,22,0,60,38
1683327938694,PHYS 1BL,001,187064,Staff,0,0,30,30
1683327938694,PHYS 1BL,002,187070,Staff,5,0,30,25
1683327939717,PHYS 1C,A00,187082,Staff,31,0,120,89
1683327940745,PHYS 1CL,001,187088,Staff,0,9,30,30
1683327940745,PHYS 1CL,002,187089,Staff,0,2,30,30
1683327940745,PHYS 1CL,009,262693,Staff,11,0,30,19
1683327941769,PHYS 2B,A01,187097,Staff,54,0,115,61
1683327942804,PHYS 2C,A01,187099,Staff,67,0,115,48
1683327943829,PHYS 2CL,A01,187101,Staff,5,0,28,23
1683327943829,PHYS 2CL,A02,187102,Staff,15,0,28,13
1683327944853,PHYS 2D,A01,187123,Shotwell; Brian,95,0,115,20
1683327945881,PHYS 4B,A01,187133,Grinstein; Benjamin,35,0,50,15
1683327946905,POLI 10,A00,188819,Staff,0,4,50,50
1683327947932,POLI 11,A00,188827,Staff,43,0,50,7
1683327948959,POLI 13R,A00,188828,Staff,0,1,20,20
1683327949987,POLI 27,A01,188830,Elgin; Samuel Zincke,0,1,70,70
1683327951014,POLI 30,A00,188832,Desposato; Scott,31,0,50,19
1683327952041,POLI 102F,A00,188834,Staff,3,0,40,37
1683327953068,POLI 104A,A00,188852,Staff,14,0,30,16
1683327954091,POLI 104I,A00,188853,Staff,0,6,20,20
1683327955114,POLI 110B,A00,188854,Wiens; David,7,0,20,13
1683327956140,POLI 112A,A00,188855,Wiens; David,5,0,30,25
1683327957167,POLI 117R,A00,188856,Forman; Fonna,0,11,20,20
1683327958193,POLI 118,A00,188857,Ingham; Sean,8,0,20,12
1683327959217,POLI 120G,A00,188858,Staff,9,0,30,21
1683327960242,POLI 131CR,A00,188863,Hoston; Germaine,24,0,50,26
1683327961265,POLI 133,A00,188864,Nellis; Gareth Hb,44,0,50,6
1683327962290,POLI 134D,A00,188865,Desposato; Scott,27,0,30,3
1683327963313,POLI 142A,A00,188871,Gartzke; Erik,22,0,50,28
1683327964337,POLI 142K,A00,188874,Staff,38,0,50,12
1683327965362,POLI 143,A00,188940,Gartzke; Erik,16,0,30,14
1683327966385,POLI 153,A00,188943,Staff,3,0,20,17
1683327967409,POLI 160AA,A00,188944,Staff,12,0,40,28
1683327968433,POLI 170A,A00,188945,Staff,11,0,30,19
1683327970490,PSYC 1,A00,188952,Staff,37,0,90,53
1683327971513,PSYC 2,B00,188953,Staff,19,0,35,16
1683327972537,PSYC 6,A00,188970,Staff,47,0,60,13
1683327973562,PSYC 7,A00,188973,Staff,37,0,45,8
1683327974590,PSYC 60,A01,188980,Rickard; Timothy C.,43,0,60,17
1683327975619,PSYC 70,A01,189001,Steiner; Eric Tomas,24,0,45,21
1683327976645,PSYC 100,A00,189005,Lacefield; Katharine I,0,100,120,120
1683327977668,PSYC 102,A00,189008,Staff,9,0,30,21
1683327978692,PSYC 106,B00,189026,Gorman; Michael R.,34,0,60,26
1683327979719,PSYC 114,B01,189033,Winkielman; Piotr,0,32,30,30
1683327980744,PSYC 131,A00,189036,Anagnostaras; Stephan,0,43,60,60
1683327981770,PSYC 136,A00,189041,Lowe; Angela Beth,0,7,25,25
1683327982794,PSYC 137,A00,189057,Winkielman; Piotr,0,34,25,25
1683327983819,PSYC 144,A00,189107,Wixted; John T,0,7,50,50
1683327985896,PSYC 162,A00,189142,Staff,0,8,85,85
1683327986919,PSYC 172,A00,189144,Gorman; Michael R.,0,7,30,30
1683327988969,PSYC 179,A00,189146,Lacefield; Katharine I,0,84,120,120
1683327989997,PSYC 181,A00,189147,Anagnostaras; Stephan,0,44,90,90
1683327991025,PSYC 190R,A00,189148,Barner; David A.,0,22,80,80
1683327992049,PSYC 191,A00,189275,Rickard; Timothy C.,0,7,25,25
1683327993073,PSYC 193,A00,189276,Chapman; Eddie Nathaniel,0,1,0,4
1683327994100,PSYC 193L,A01,189281,Lowe; Angela Beth,12,0,20,8
1683327994100,PSYC 193L,B01,189285,Staff,28,0,35,7
1683327995127,RELI 149,A00,187137,Rahimi; Babak,7,0,40,33
1683327996200,SE 9,A01,187315,Staff,0,2,18,18
1683327997226,SE 101B,A00,187409,Staff,24,0,30,6
1683327998251,SE 110B,A00,187444,Staff,10,0,40,30
1683327999280,SE 130B,A00,187449,Staff,31,0,40,9
1683328000308,SE 150A,A00,187516,Staff,9,0,20,11
1683328001335,SE 154,A00,187528,Staff,30,0,50,20
1683328002359,SIO 3,A01,258171,Staff,35,0,40,5
1683328003384,SIO 10,A00,187144,Cook; Geoffrey W,0,3,75,75
1683328004408,SIO 45,A00,187152,Cook; Geoffrey W,1,0,100,99
1683328005434,SIO 109R,A00,194486,Staff,0,3,20,20
1683328007481,SIO 187,A01,187233,Kacev; David,12,0,40,28
1683328008506,SOCI 1,A01,258656,Thorpe; Charles Robert,28,0,30,2
1683328008506,SOCI 1,A02,258658,Thorpe; Charles Robert,30,0,30,0
1683328008506,SOCI 1,A03,258661,Thorpe; Charles Robert,25,0,25,0
1683328008506,SOCI 1,A04,258666,Thorpe; Charles Robert,22,0,25,3
1683328008506,SOCI 1,A05,258897,Thorpe; Charles Robert,23,0,25,2
1683328008506,SOCI 1,A06,258898,Thorpe; Charles Robert,25,0,25,0
1683328009591,SOCI 30,A01,258903,Pardo Guerra; Juan Pablo,15,0,30,15
1683328010617,SOCI 102,A00,258904,Staff,9,0,25,16
1683328011645,SOCI 106,A00,258905,Staff,19,0,25,6
1683328012672,SOCI 111,A00,258907,Ribas Norris; Janet Vanesa,26,0,30,4
1683328013697,SOCI 121R,A00,258908,Pardo Guerra; Juan Pablo,10,0,30,20
1683328014723,SOCI 126,A01,203330,Staff,14,0,20,6
1683328015751,SOCI 131,A00,258909,Thorpe; Charles Robert,31,0,60,29
1683328016777,SOCI 135,A00,258910,Payne; Christine Anna,0,9,30,30
1683328017804,SOCI 157,A00,258911,Staff,12,0,30,18
1683328018830,SOCI 184,A00,258912,Staff,25,0,30,5
1683328019855,SOCI 188D,A00,258913,Staff,21,0,30,9
1683328020898,SYN 2,001,187529,Staff,10,0,16,6
1683328020898,SYN 2,002,201452,Staff,0,18,16,16
1683328020898,SYN 2,003,201469,Staff,3,0,16,13
1683328021922,SYN 100,A01,187531,Staff,0,9,20,20
1683328021922,SYN 100,B01,201491,Staff,0,12,20,20
1683328022948,TDAC 1,A00,189286,Walsh; Kim C.,3,0,20,17
1683328022948,TDAC 1,B00,189287,Harting; Carla Kelso,11,0,20,9
1683328023972,TDAC 101,A00,189300,Walsh; Kim C.,16,0,20,4
1683328023972,TDAC 101,B00,189301,Harting; Carla Kelso,18,0,20,2
1683328024995,TDAC 102,A00,189304,Basso; Beatrice,14,0,20,6
1683328026022,TDAC 108,A00,189305,Staff,18,0,20,2
1683328027048,TDDE 131,A00,189310,Staff,19,0,20,1
1683328027048,TDDE 131,B00,189314,Staff,19,0,20,1
1683328027048,TDDE 131,C00,189315,Staff,48,0,50,2
1683328027048,TDDE 131,D00,189316,Staff,14,0,15,1
1683328027048,TDDE 131,E00,204841,Staff,20,0,20,0
1683328028073,TDGE 10,A00,189289,Staff,30,0,50,20
1683328028073,TDGE 10,B00,189290,Havis; Allan,1,0,50,49
1683328029097,TDGE 11,A00,189291,Fulton; Julia,0,3,50,50
1683328029097,TDGE 11,B00,189292,Staff,20,0,25,5
1683328029097,TDGE 11,C00,260270,Staff,0,0,0,0
1683328030125,TDGE 25,A00,189294,Staff,3,0,20,17
1683328031149,TDGE 124,A00,189318,Fulton; Julia,0,8,50,50
1683328032177,TDGE 125,A00,189319,Staff,13,0,25,12
1683328032177,TDGE 125,B00,189320,Staff,23,0,25,2
1683328033203,TDGE 127,A00,189322,Havis; Allan,0,0,50,50
1683328034230,TDHT 101,A00,189323,Staff,18,0,25,7
1683328034230,TDHT 101,B00,189324,Staff,25,0,25,0
1683328035258,TDHT 102,A00,189325,Staff,49,0,50,1
1683328036287,TDMV 1,A00,189295,Arcidiacono; Kristin,19,0,30,11
1683328036287,TDMV 1,B00,189296,Caligagan; Maria T.,24,0,30,6
1683328037312,TDMV 2,A00,189297,Sammartano; Tonnie,28,0,30,2
1683328037312,TDMV 2,B00,189299,Arcidiacono; Kristin,24,0,30,6
1683328038336,TDMV 3,A00,204998,Rincon; Alicia,22,0,30,8
1683328039365,TDMV 120,A00,189458,Sammartano; Tonnie,28,0,30,2
1683328040390,TDMV 138,A00,189541,Jun; Grace Shin Hae,22,0,40,18
1683328041416,TDMV 142,A00,189717,Caligagan; Tony,23,0,30,7
1683328041416,TDMV 142,B00,189718,Caligagan; Maria T.,25,0,30,5
1683328042444,TMC 2,A01,187533,Staff,25,0,25,0
1683328042444,TMC 2,A02,187534,Staff,25,0,25,0
1683328043469,USP 1,A01,187536,Kwak; Nancy,0,16,25,25
1683328044496,USP 5,A01,187538,Staff,10,0,25,15
1683328045521,USP 101,A00,199253,Staff,0,4,0,0
1683328046549,USP 124,A00,187562,Boomhower; Matthew Charles,1,0,30,29
1683328047577,USP 138,A00,187582,Staff,20,0,25,5
1683328048601,USP 152,A01,187597,Staff,4,0,25,21
1683328049625,USP 153,A00,187598,Staff,19,0,25,6
1683328050649,USP 168,A00,187607,Kwak; Nancy,2,0,5,3
1683328051673,USP 173,A00,187619,Staff,4,0,25,21
1683328052699,USP 181,A00,187638,Staff,0,0,25,25
1683328053723,VIS 103,A00,187650,Cruz; Edwin Teddy,23,0,75,52
1683328054748,VIS 110D,A00,187669,Staff,12,0,22,10
1683328055773,VIS 127C,A00,187720,Shen; Kuiyi,67,0,146,79
1683328056798,VIS 149,A00,187731,Yoldas; Pinar,0,14,22,22
1683328057823,VIS 151,A01,188091,Staff,22,0,34,12
1683328057823,VIS 151,A02,188092,Staff,11,0,34,23
1683328058849,VIS 160B,A00,188093,Stalbaum; Brett,0,0,10,10
1683328060901,WCWP 10B,A00,201720,Staff,10,0,15,5
1683328060901,WCWP 10B,B00,201722,Staff,8,0,15,7
1683328061930,WCWP 100,A00,201725,Gagnon; Jeffrey C,0,0,2,2
1683328061930,WCWP 100,B00,201727,Staff,0,4,15,15
1683328065030,ANBI 133,A00,258401,Wilder; Linnea Lorene,34,0,40,6
1683328066054,ANBI 140,A00,258395,Hrvoj Mihic; Branka,18,0,25,7
1683328067079,ANSC 120,A00,258402,Bialecki; Jon Anthony,27,0,40,13
1683328068104,ANSC 144,A00,258400,Staff,14,0,40,26
1683328070156,ANSC 166,A00,258396,Parish; Steven Martin,157,0,175,18
1683328071180,ANSC 180,A00,193533,Staff,9,0,20,11
1683328072203,ANSC 188,A00,258397,Jassal; Aftab,33,0,40,7
1683328073229,ANTH 3,A01,258316,Staff,23,0,30,7
1683328074254,ANTH 5,A00,258394,Semendeferi; Ekaterini,16,0,20,4
1683328075281,ANTH 21,A01,258331,Staff,8,0,40,32
1683328076307,ANTH 103,A00,258398,Varma; Saiba,15,0,25,10
1683328077339,AWP 10,001,202034,Staff,0,0,0,0
1683328077339,AWP 10,002,202035,Staff,0,0,0,0
1683328077339,AWP 10,003,202036,Staff,0,0,0,0
1683328077339,AWP 10,004,202037,Staff,0,0,0,0
1683328077339,AWP 10,005,202038,Staff,0,0,0,0
1683328077339,AWP 10,006,202039,Staff,0,0,0,0
1683328077339,AWP 10,007,202040,Staff,0,0,0,0
1683328077339,AWP 10,008,202041,Staff,0,0,0,0
1683328077339,AWP 10,009,202042,Staff,0,0,0,0
1683328077339,AWP 10,010,202043,Staff,0,0,0,0
1683328077339,AWP 10,011,202044,Staff,0,0,0,0
1683328077339,AWP 10,012,202045,Staff,0,0,0,0
1683328077339,AWP 10,013,202046,Staff,0,0,0,0
1683328077339,AWP 10,014,202047,Staff,0,0,0,0
1683328077339,AWP 10,015,202048,Staff,0,0,0,0
1683328077339,AWP 10,016,202049,Staff,0,0,0,0
1683328077339,AWP 10,017,202050,Staff,0,0,0,0
1683328077339,AWP 10,018,202051,Staff,0,0,0,0
1683328077339,AWP 10,019,202052,Staff,0,0,0,0
1683328077339,AWP 10,020,202053,Staff,0,0,0,0
1683328077339,AWP 10,021,202054,Staff,0,0,0,0
1683328077339,AWP 10,022,202055,Staff,0,0,0,0
1683328077339,AWP 10,023,202056,Staff,0,0,0,0
1683328077339,AWP 10,024,202057,Staff,0,0,0,0
1683328077339,AWP 10,025,202058,Staff,0,0,0,0
1683328077339,AWP 10,026,202059,Staff,0,0,0,0
1683328078362,AWP 102,001,202032,Staff,0,0,0,0
1683328078362,AWP 102,002,202033,Staff,0,0,0,0
1683328079386,BENG 100,A01,254234,Taylor Amos; Alyssa C,31,0,40,9
1683328080409,BENG 196,001,270013,Engler; Adam J.,9999,0,9999,0
1683328081435,BICD 100R,A01,202018,Smith; Laurie,0,7,32,32
1683328081435,BICD 100R,A02,202019,Smith; Laurie,0,2,32,32
1683328081435,BICD 100R,A03,202020,Smith; Laurie,0,1,32,32
1683328081435,BICD 100R,A04,202021,Smith; Laurie,9,0,32,23
1683328081435,BICD 100R,A05,202022,Smith; Laurie,12,0,32,20
1683328082465,BICD 136,A01,193242,Gustafson-Brown; Cindy,0,2,32,32
1683328082465,BICD 136,A02,193244,Gustafson-Brown; Cindy,14,0,32,18
1683328083493,BIEB 102,A01,193249,Butler; Shannon Rhey,0,2,32,32
1683328083493,BIEB 102,A02,193251,Butler; Shannon Rhey,0,0,32,32
1683328083493,BIEB 102,A03,193253,Butler; Shannon Rhey,0,1,32,32
1683328083493,BIEB 102,A04,193255,Butler; Shannon Rhey,17,0,32,15
1683328083493,BIEB 102,A05,193265,Butler; Shannon Rhey,26,0,32,6
1683328083493,BIEB 102,A06,193269,Butler; Shannon Rhey,16,0,32,16
1683328085545,BIEB 150,A01,193274,Staff,0,0,32,32
1683328085545,BIEB 150,A02,193285,Staff,23,0,32,9
1683328086569,BIEB 194,A00,193286,Kurle; Carolyn M.,22,0,32,10
1683328087596,BILD 1,A01,192291,Staff,16,0,32,16
1683328087596,BILD 1,A02,192292,Staff,30,0,32,2
1683328087596,BILD 1,B01,192520,Reuther; Keefe,0,1,0,0
1683328087596,BILD 1,B02,192532,Reuther; Keefe,0,1,0,0
1683328088628,BILD 3,A01,192556,Butler; Shannon Rhey,0,0,32,32
1683328088628,BILD 3,A02,192581,Butler; Shannon Rhey,5,0,32,27
1683328088628,BILD 3,A03,192611,Butler; Shannon Rhey,23,0,32,9
1683328088628,BILD 3,A04,192612,Butler; Shannon Rhey,25,0,32,7
1683328088628,BILD 3,A05,192613,Butler; Shannon Rhey,27,0,32,5
1683328088628,BILD 3,A06,192679,Butler; Shannon Rhey,27,0,32,5
1683328088628,BILD 3,A07,192682,Butler; Shannon Rhey,22,0,32,10
1683328089657,BILD 4,A01,192836,Reuther; Keefe,0,0,24,24
1683328089657,BILD 4,A02,193044,Reuther; Keefe,4,0,24,20
1683328090686,BILD 10,A01,193142,Gustafson-Brown; Cindy,30,0,32,2
1683328090686,BILD 10,A02,193149,Gustafson-Brown; Cindy,31,0,32,1
1683328091711,BIMM 100,A01,193301,Staff,0,6,32,32
1683328091711,BIMM 100,A02,193312,Staff,0,5,32,32
1683328091711,BIMM 100,A03,193323,Staff,0,8,32,32
1683328092741,BIMM 101,A01,193329,McDonnell; Lisa Marie,0,3,24,24
1683328092741,BIMM 101,A02,193339,McDonnell; Lisa Marie,0,3,24,24
1683328092741,BIMM 101,B01,193354,McDonnell; Lisa Marie,0,3,24,24
1683328092741,BIMM 101,B02,193357,McDonnell; Lisa Marie,0,3,24,24
1683328093766,BIMM 110,A01,193377,Tat; John,0,11,32,32
1683328093766,BIMM 110,A02,193378,Tat; John,1,9,32,31
1683328094793,BIMM 120,A01,206116,Staff,0,0,32,32
1683328094793,BIMM 120,A02,206117,Staff,8,0,32,24
1683328094793,BIMM 120,A03,206121,Staff,21,0,32,11
1683328095818,BIPN 100,A01,193393,Park; Ji Young,0,14,32,32
1683328095818,BIPN 100,A02,193402,Park; Ji Young,0,13,32,32
1683328095818,BIPN 100,A03,193413,Park; Ji Young,0,14,32,32
1683328095818,BIPN 100,A04,193414,Park; Ji Young,0,13,32,32
1683328096856,BIPN 102,A01,193429,Staff,0,0,32,32
1683328096856,BIPN 102,A02,193438,Staff,22,0,32,10
1683328097882,BIPN 106,A01,193450,Reyes Gonzalez; Catalina,0,2,40,40
1683328098912,BIPN 134,A01,193465,Cooke; James Edward,0,0,32,32
1683328098912,BIPN 134,A02,193474,Cooke; James Edward,25,0,32,7
1683328098912,BIPN 134,A03,193485,Cooke; James Edward,29,0,32,3
1683328098912,BIPN 134,A04,193486,Cooke; James Edward,21,0,32,11
1683328098912,BIPN 134,A05,193491,Cooke; James Edward,31,0,32,1
1683328098912,BIPN 134,A06,193501,Cooke; James Edward,30,0,32,2
1683328098912,BIPN 134,A07,193510,Cooke; James Edward,29,0,32,3
1683328100962,BISP 194,A00,222522,Staff,14,0,32,18
1683328101988,CAT 124,A01,202407,Staff,20,0,25,5
1683328103011,CAT 125,A00,202408,Marchisotto; Jennifer Anne,4,0,20,16
1683328104044,CAT 125R,A00,202409,Smith; Lauryn Alissa,0,11,20,20
1683328104044,CAT 125R,B00,202410,Morales; Celeste Georgianna,0,11,20,20
1683328104044,CAT 125R,C00,202411,Irwin; Matthew Joseph,0,10,20,20
1683328105074,CENG 15,A01,204712,Yang; Kesong,0,1,0,0
1683328106103,CENG 114,A00,202070,Jahed Motlagh; Zeinab,5,0,20,15
1683328107127,CGS 105,A00,185477,Wesling; Megan E.,24,0,40,16
1683328108150,CGS 106,A00,185494,Staff,13,0,22,9
1683328109175,CGS 108,A00,185495,Staff,14,0,20,6
1683328110200,CGS 114,A00,185496,Staff,13,0,18,5
1683328111226,CGS 119,A00,185501,Staff,15,0,20,5
1683328112254,CGS 120,A00,185511,Staff,13,0,20,7
1683328113336,CHEM 4,A01,184675,Bussey; Thomas J,96,0,100,4
1683328114359,CHEM 6A,A01,184677,Staff,34,0,60,26
1683328115386,CHEM 6B,A01,184679,Staff,65,0,100,35
1683328116411,CHEM 6C,A01,184681,Bussey; Thomas J,1,0,50,49
1683328116411,CHEM 6C,A02,184682,Bussey; Thomas J,34,0,50,16
1683328117440,CHEM 40A,A01,184684,Albizati; Kim F.,37,0,100,63
1683328118464,CHEM 40B,A01,184686,Albizati; Kim F.,0,20,100,100
1683328119489,CHEM 41B,A01,184690,Staff,52,0,100,48
1683328120514,COGS 3,A01,184715,Boyle; Mary E. T.,0,25,40,40
1683328121539,COGS 14B,A01,185172,Staff,0,15,38,38
1683328122564,COGS 18,A01,184736,Staff,17,0,80,63
1683328123588,COGS 100,A01,184932,Staff,0,5,73,73
1683328124613,COGS 101A,A01,184935,Staff,0,38,30,30
1683328125637,COGS 101B,A01,184944,Staff,0,2,30,30
1683328126661,COGS 101C,A01,184946,Staff,0,12,30,30
1683328127686,COGS 102A,A01,184951,Johnson; Christine M.,2,0,40,38
1683328128711,COGS 107B,A01,184953,Mooshagian; Eric Frederick,0,50,40,40
1683328129737,COGS 118B,A01,184959,Gupta; Anjum,0,48,40,40
1683328130763,COGS 153,A00,184961,Staff,0,15,30,30
1683328131791,COGS 177,A00,184962,Staff,0,20,30,30
1683328132816,COGS 187A,A01,184969,Boyle; Mary E. T.,0,17,40,40
1683328133844,COMM 10,A01,185174,Staff,0,5,25,25
1683328133844,COMM 10,A02,185189,Staff,0,5,25,25
1683328133844,COMM 10,A03,269821,Staff,0,0,0,0
1683328134870,COMM 100B,A01,185475,Staff,0,0,0,2
1683328134870,COMM 100B,A02,185476,Staff,14,0,25,11
1683328135898,COMM 100C,A01,185314,Staff,1,0,25,24
1683328135898,COMM 100C,A02,185327,Staff,19,0,25,6
1683328136927,COMM 110M,A00,185349,Staff,2,0,40,38
1683328137952,COMM 113T,A00,185352,Staff,24,0,40,16
1683328138977,COMM 114I,A00,185353,Staff,33,0,40,7
1683328140010,COMM 131,A00,185354,Staff,19,0,30,11
1683328141034,CSE 8A,A50,185358,Cao; Yingjun,0,46,10,10
1683328142061,CSE 8B,A01,185362,Staff,1,47,50,49
1683328143086,CSE 11,A01,185416,Cao; Yingjun,0,92,10,10
1683328144111,CSE 20,A01,185445,Briones; Jor-el Thomas Caparas,5,0,25,20
1683328145136,CSE 21,A01,185447,Staff,10,0,50,40
1683328146161,CSE 101,A01,185451,Staff,0,12,50,50
1683328146161,CSE 101,B01,185453,Jones; Miles E,0,11,50,50
1683328148221,CSE 141,A01,185458,Eldon; John,20,0,100,80
1683328149246,CSE 141L,A01,185461,Eldon; John,12,0,100,88
1683328150270,CSE 142,A01,185463,Staff,36,0,60,24
1683328150270,CSE 142,B01,201355,Staff,0,7,60,60
1683328151294,CSE 142L,A01,185470,Staff,36,0,60,24
1683328151294,CSE 142L,B01,201417,Staff,0,6,60,60
1683328152321,CSE 190,A00,201433,Staff,32,0,49,17
1683328153347,DOC 1,A01,259136,Strom; Megan C.,7,0,15,8
1683328153347,DOC 1,A02,259137,Strom; Megan C.,14,0,15,1
1683328153347,DOC 1,A03,259138,Strom; Megan C.,14,0,15,1
1683328153347,DOC 1,A04,259139,Strom; Megan C.,14,0,15,1
1683328154372,DOC 100D,A00,259140,Pass; Natalye Joann,16,0,25,9
1683328155399,DSGN 1,A01,184749,Rill; Bryan,0,26,30,30
1683328156423,DSGN 100,A01,185168,Staff,0,2,25,25
1683328157448,ECE 5,A01,185626,Morris; Karcher William,0,10,0,0
1683328158473,ECE 101,A01,185628,Staff,17,0,70,53
1683328159498,ECE 107,A01,185635,Baghdadchi; Saharnaz,0,0,20,20
1683328159498,ECE 107,A02,185638,Baghdadchi; Saharnaz,4,0,20,16
1683328160528,ECE 148,A01,185647,Silberman; Jack,0,0,16,16
1683328161554,ECON 1,A01,185537,Crane; Meredith Helen,54,0,70,16
1683328162582,ECON 3,A01,185549,Crane; Meredith Helen,33,0,70,37
1683328163606,ECON 4,A01,203354,Anderson; John Charles,0,4,10,10
1683328164631,ECON 100A,A01,185574,Staff,0,4,40,40
1683328165656,ECON 100B,A01,185576,Staff,10,22,50,40
1683328166691,ECON 100C,A01,185589,Newhouse; Herbert S,30,0,70,40
1683328167717,ECON 105,A00,185608,Vespa; Emanuel Ignacio,19,0,35,16
1683328168741,ECON 109,A01,185610,Shishkin; Denis,10,0,35,25
1683328169769,ECON 110A,A01,185612,Staff,11,0,40,29
1683328170792,ECON 120A,A01,185615,Staff,20,0,40,20
1683328171820,ECON 120C,A01,185617,Sun; Yixiao,0,20,70,70
1683328172844,ECON 144,A00,203346,Squires; Dale E,3,0,35,32
1683328173866,ECON 171,A01,203349,Newhouse; Herbert S,0,1,35,35
1683328174891,ECON 173A,A01,185621,Toda; Alexis Akira,21,0,35,14
1683328175917,EDS 25,A01,202413,Staff,0,1,0,0
1683328175917,EDS 25,A02,202414,Staff,0,1,0,0
1683328175917,EDS 25,A03,202415,Staff,0,0,0,0
1683328175917,EDS 25,A04,202416,Staff,0,1,0,0
1683328175917,EDS 25,A05,202439,Staff,0,0,0,0
1683328175917,EDS 25,A06,202440,Staff,0,0,0,0
1683328175917,EDS 25,B01,202631,Staff,0,0,0,0
1683328175917,EDS 25,B02,202632,Staff,0,0,0,0
1683328175917,EDS 25,B03,202639,Staff,0,0,0,0
1683328175917,EDS 25,B04,202640,Staff,0,0,0,0
1683328175917,EDS 25,B05,202643,Staff,0,0,0,0
1683328175917,EDS 25,B06,202644,Staff,0,0,0,0
1683328176942,EDS 38,A01,202659,Black; Alison Michelle,24,0,25,1
1683328177969,EDS 115,A00,202652,Staff,17,0,30,13
1683328178997,EDS 125,A00,202649,Staff,14,0,30,16
1683328180022,EDS 126,A01,203332,Staff,30,0,30,0
1683328181047,EDS 139,A00,202838,Staff,16,0,25,9
1683328182075,EDS 146,A01,202655,Staff,14,0,25,11
1683328183102,ENG 15,A00,185667,Staff,0,1,0,0
1683328183102,ENG 15,B00,185672,Staff,0,0,0,0
1683328183102,ENG 15,C00,185675,Staff,0,0,0,0
1683328183102,ENG 15,D00,185682,Staff,0,0,0,0
1683328183102,ENG 15,E00,185684,Staff,0,0,0,0
1683328184129,ETHN 103,A00,185710,Staff,0,3,35,35
1683328185155,ETHN 103A,A00,199228,Man; Simeon S,2,0,9,7
1683328186182,ETHN 109,A00,185711,Staff,18,0,35,17
1683328187206,ETHN 142,A00,185726,Staff,0,4,30,30
1683328188235,ETHN 163J,A00,199229,Man; Simeon S,5,0,8,3
1683328189262,ETHN 168,A00,185727,Staff,8,0,10,2
1683328190287,ETHN 182,A00,185728,Staff,1,0,35,34
1683328191314,ETHN 183,A00,185737,Staff,8,0,18,10
1683328192338,GLBH 111,A01,209361,Burgos; Jose L.,0,0,0,0
1683328194387,HIEU 104,A00,185792,Staff,16,0,20,4
1683328195411,HIEU 115,A00,185800,Staff,1,0,20,19
1683328196438,HIEU 128,A00,185801,Staff,0,7,20,20
1683328197463,HIEU 147,A00,185802,Staff,16,0,20,4
1683328198490,HIEU 154,A00,185823,Staff,12,0,20,8
1683328199516,HILA 102,A00,185826,Staff,13,0,20,7
1683328200542,HILD 2C,A01,185778,Staff,0,12,20,20
1683328201566,HILD 7B,A01,185780,Kwak; Nancy,0,15,32,32
1683328201566,HILD 7B,A02,185781,Kwak; Nancy,0,18,32,32
1683328202591,HILD 30,A01,185791,Staff,14,0,20,6
1683328203620,HISC 119,A00,185830,Golan; Tal,0,9,20,20
1683328204648,HITO 156GS,A00,185831,Patterson; Patrick H.,0,0,0,23
1683328205676,HIUS 103,A00,185832,Man; Simeon S,0,6,20,20
1683328206703,HIUS 117,A00,185836,Kwak; Nancy,2,0,20,18
1683328207728,HIUS 125,A00,185840,Man; Simeon S,0,0,23,23
1683328208757,HIUS 149,A00,185845,Staff,0,0,20,20
1683328209786,HUM 3,A01,185882,Zavodny; Tatiana Sophia,0,7,50,50
1683328209786,HUM 3,B01,185899,Caldwell; Michael Alan,0,18,50,50
1683328210811,HUM 3GS,A00,185900,Patterson; Patrick H.,0,0,0,23
1683328211838,HUM 4,A01,185938,Zroka; Amy Liane,31,0,50,19
1683328211838,HUM 4,B01,185956,Watkins; Eric,0,2,50,50
1683328211838,HUM 4,B02,202209,Watkins; Eric,0,2,50,50
1683328211838,HUM 4,B03,202210,Watkins; Eric,0,2,50,50
1683328212864,HUM 5,A01,185958,West; Geoffrey Scott,3,0,50,47
1683328212864,HUM 5,A02,202215,West; Geoffrey Scott,0,0,50,50
1683328213888,INTL 190,A00,185959,Gagnon; Jeffrey C,0,0,0,9
1683328213888,INTL 190,B00,185960,Lettieri; Michael Joseph,0,0,0,1
1683328214913,JAPN 180,A00,254509,Staff,5,1,30,25
1683328215943,LATI 10,A01,202853,Kennemore; Amy Michelle,4,0,35,31
1683328215943,LATI 10,A02,202854,Kennemore; Amy Michelle,2,0,35,33
1683328215943,LATI 10,A03,270054,Kennemore; Amy Michelle,30,0,30,0
1683328217041,LATI 180,A00,202855,Kennemore; Amy Michelle,11,0,20,9
1683328218065,LAWS 101,A00,201767,Golan; Tal,0,7,40,40
1683328219091,LIFR 1C,A00,185961,Staff,6,0,20,14
1683328220118,LIFR 1CX,A00,185962,Staff,7,0,20,13
1683328221143,LIFR 1D,A00,185963,Staff,9,0,20,11
1683328222170,LIFR 1DX,A00,185964,Staff,9,0,20,11
1683328223195,LIGN 101,A01,186039,Staff,43,0,50,7
1683328224220,LIGN 165,A00,186040,Staff,18,0,50,32
1683328225242,LTCS 108,A00,186041,Staff,6,0,10,4
1683328226266,LTCS 119,A00,186042,Staff,16,0,20,4
1683328227290,LTCS 130,A00,186043,Wesling; Megan E.,15,0,25,10
1683328229342,LTEA 138,A00,186119,Staff,14,0,40,26
1683328230366,LTEN 124,A00,186148,Staff,6,0,25,19
1683328231391,LTEN 178,A00,186149,Staff,7,0,15,8
1683328232419,LTEN 181,A00,186150,Blanco; John D,33,0,40,7
1683328233443,LTWL 120,A00,186160,Staff,20,0,25,5
1683328234471,LTWL 165,A00,186161,Staff,22,0,25,3
1683328235494,LTWR 100,A00,186162,Staff,0,5,15,15
1683328236516,LTWR 102,A00,186163,Doller; Ben,5,0,15,10
1683328237540,MAE 8,A01,186412,Staff,0,0,0,0
1683328238564,MAE 30B,A00,186445,Bahadori; Mohammad Yousef,83,0,100,17
1683328239590,MAE 40,A00,186592,Bewley; Thomas R,9,0,50,41
1683328240617,MAE 101B,A00,186593,Bahadori; Mohammad Yousef,81,0,100,19
1683328241644,MAE 105,A00,186594,Bandaru; Prabhakar,12,0,50,38
1683328242670,MAE 107,A00,186599,Pham; Hieu Tan,0,6,120,120
1683328243693,MAE 148,A01,186660,Silberman; Jack,3,0,16,13
1683328244717,MATH 10A,A01,188095,Staff,1,6,35,34
1683328245741,MATH 10B,A01,188097,Bowers; Adam R.,0,11,30,30
1683328245741,MATH 10B,A02,188099,Bowers; Adam R.,0,11,30,30
1683328245741,MATH 10B,B01,188104,Bowers; Adam R.,0,10,30,30
1683328245741,MATH 10B,B02,188106,Bowers; Adam R.,0,10,30,30
1683328246771,MATH 10C,A01,188111,Staff,0,18,30,30
1683328246771,MATH 10C,A02,188127,Staff,0,17,30,30
1683328246771,MATH 10C,A03,188131,Staff,0,18,30,30
1683328246771,MATH 10C,B01,188218,Staff,18,0,30,12
1683328246771,MATH 10C,B02,188244,Staff,13,0,30,17
1683328246771,MATH 10C,B03,188277,Staff,16,0,30,14
1683328247796,MATH 18,A01,188344,Bach; Quang Tran,18,0,30,12
1683328247796,MATH 18,A02,188345,Bach; Quang Tran,11,0,30,19
1683328247796,MATH 18,B01,188353,Bach; Quang Tran,10,0,30,20
1683328247796,MATH 18,B02,188354,Bach; Quang Tran,20,0,30,10
1683328248822,MATH 20A,A01,188374,Staff,13,0,35,22
1683328249851,MATH 20B,A01,188382,Ohm; Ko Woon,6,0,30,24
1683328249851,MATH 20B,A02,188383,Ohm; Ko Woon,22,0,30,8
1683328249851,MATH 20B,B01,188385,Ohm; Ko Woon,7,0,30,23
1683328249851,MATH 20B,B02,188392,Ohm; Ko Woon,22,0,30,8
1683328250876,MATH 20C,A01,188394,Harel; Guershon,10,0,30,20
1683328250876,MATH 20C,A02,188395,Harel; Guershon,15,0,30,15
1683328250876,MATH 20C,B01,188404,Harel; Guershon,5,0,30,25
1683328250876,MATH 20C,B02,188405,Harel; Guershon,19,0,30,11
1683328251903,MATH 20D,A01,188414,Hammock; Frances H,0,1,30,30
1683328251903,MATH 20D,A02,188415,Hammock; Frances H,2,0,30,28
1683328251903,MATH 20D,B01,188447,Hammock; Frances H,2,0,30,28
1683328251903,MATH 20D,B02,188486,Hammock; Frances H,8,0,30,22
1683328252931,MATH 20E,A01,188649,Staff,21,0,30,9
1683328252931,MATH 20E,A02,188650,Staff,23,0,30,7
1683328252931,MATH 20E,A03,188673,Staff,0,0,30,30
1683328253959,MATH 102,A01,188675,Staff,0,35,35,35
1683328254983,MATH 103B,A01,188681,Staff,3,0,35,32
1683328254983,MATH 103B,B01,188692,Staff,5,0,35,30
1683328256010,MATH 109,A01,188695,Salehi Golsefidy; Alireza,25,0,35,10
1683328256010,MATH 109,A02,188696,Salehi Golsefidy; Alireza,26,0,35,9
1683328257036,MATH 120A,A01,188698,Eggers; John Dietrich,7,0,35,28
1683328258064,MATH 142B,A01,188736,Ioana; Adrian,0,2,30,30
1683328258064,MATH 142B,A02,188741,Ioana; Adrian,1,1,30,29
1683328258064,MATH 142B,A03,188743,Ioana; Adrian,1,3,30,29
1683328259090,MATH 168A,A01,188790,Staff,0,9,35,35
1683328260115,MATH 170A,A01,188803,Nie; Jiawang,0,2,35,35
1683328260115,MATH 170A,A02,188811,Nie; Jiawang,0,0,35,35
1683328260115,MATH 170A,A03,188814,Nie; Jiawang,1,0,35,34
1683328260115,MATH 170A,A04,188815,Nie; Jiawang,13,0,35,22
1683328261140,MATH 193B,A01,188817,Staff,0,0,35,35
1683328261140,MATH 193B,A02,188818,Staff,5,0,35,30
1683328262165,MGT 4,A01,202857,Anderson; John Charles,62,0,80,18
1683328263191,MGT 12,A00,202858,Lindenberger; Wade Douglas,42,0,90,48
1683328264220,MGT 18,A00,202859,Staff,74,0,90,16
1683328265249,MGT 18GS,A00,202860,McKay; Michael J,13,0,28,15
1683328266277,MGT 45,A00,202861,Pecore; Joseph P.,13,0,90,77
1683328267301,MGT 100,A00,202863,Yavorsky; Daniel Ryan,28,0,90,62
1683328268329,MGT 103,A00,202864,Ehrich; Kristine R,1,18,90,89
1683328269354,MGT 112,A00,202865,Ehrich; Kristine R,15,0,90,75
1683328270382,MGT 121A,A00,202868,Staff,0,20,0,0
1683328271407,MGT 131B,A00,202869,Anderson; John Charles,59,0,90,31
1683328272431,MGT 136,A00,202871,Lindenberger; Wade Douglas,84,0,90,6
1683328273455,MGT 164,A00,202873,Staff,0,68,90,91
1683328274481,MGT 164GS,A00,202874,McKay; Mary A,13,0,28,15
1683328275505,MGT 180,A00,202875,Staff,0,50,90,91
1683328276532,MMW 11R,A01,205019,Herbst; Matthew,3,0,30,27
1683328276532,MMW 11R,A02,205026,Herbst; Matthew,29,0,30,1
1683328277562,MMW 15,A01,193512,Chang; Edmond Yi-Teh,0,9,28,28
1683328277562,MMW 15,A02,193513,Chang; Edmond Yi-Teh,0,5,28,28
1683328277562,MMW 15,A03,193514,Chang; Edmond Yi-Teh,0,5,28,28
1683328277562,MMW 15,A04,193515,Chang; Edmond Yi-Teh,0,5,28,28
1683328277562,MMW 15,A05,193516,Chang; Edmond Yi-Teh,0,4,28,28
1683328277562,MMW 15,A06,193517,Chang; Edmond Yi-Teh,0,5,28,28
1683328277562,MMW 15,B01,193519,Chang; Edmond Yi-Teh,0,5,28,28
1683328277562,MMW 15,B02,193520,Chang; Edmond Yi-Teh,0,5,28,28
1683328277562,MMW 15,B03,193521,Chang; Edmond Yi-Teh,0,5,28,28
1683328277562,MMW 15,B04,193522,Chang; Edmond Yi-Teh,0,4,28,28
1683328277562,MMW 15,B05,193523,Chang; Edmond Yi-Teh,0,5,28,28
1683328277562,MMW 15,B06,193524,Chang; Edmond Yi-Teh,0,4,28,28
1683328278591,MMW 122,A01,193526,Rahimi; Babak,0,15,28,28
1683328278591,MMW 122,A02,193527,Rahimi; Babak,0,14,28,28
1683328278591,MMW 122,A03,193528,Rahimi; Babak,0,0,0,0
1683328278591,MMW 122,A04,193529,Rahimi; Babak,0,0,0,0
1683328279618,MUS 1A,A01,186663,Staff,0,20,35,35
1683328280646,MUS 4,A01,186715,Staff,0,12,35,35
1683328281671,MUS 5R,A01,186796,Dubnov; Shlomo,0,17,35,35
1683328282699,MUS 6,A01,186798,Staff,0,4,25,25
1683328283728,MUS 7,A01,186830,Staff,12,0,35,23
1683328284757,MUS 8,A01,186930,Staff,0,27,35,35
1683328285785,MUS 15,A01,186932,Staff,0,16,35,35
1683328285785,MUS 15,B01,186934,Staff,0,15,35,35
1683328286810,MUS 80,A00,186935,Staff,1,0,20,19
1683328286810,MUS 80,B00,186936,Staff,25,0,25,0
1683328287834,NANO 11,A00,204702,Lipomi; Darren John,0,0,0,0
1683328288865,NANO 15,A01,204709,Yang; Kesong,0,1,0,0
1683328289889,NANO 114,A00,202069,Jahed Motlagh; Zeinab,3,0,10,7
1683328290918,PHIL 1,A00,186955,Grush; Rick Scott,32,0,40,8
1683328291945,PHIL 10,A01,186973,Grush; Rick Scott,28,0,35,7
1683328291945,PHIL 10,A02,186974,Grush; Rick Scott,33,0,35,2
1683328292969,PHIL 13,A01,186976,Staff,7,0,35,28
1683328292969,PHIL 13,A02,186977,Staff,16,0,35,19
1683328293994,PHIL 14,A01,186979,Staff,31,0,35,4
1683328293994,PHIL 14,A02,186986,Staff,32,0,35,3
1683328295022,PHIL 28,A01,186988,Staff,16,0,30,14
1683328295022,PHIL 28,A02,186989,Staff,1,0,30,29
1683328295022,PHIL 28,A03,186990,Staff,9,0,30,21
1683328295022,PHIL 28,A04,186991,Staff,26,0,30,4
1683328296047,PHIL 120,A00,186997,Staff,23,0,40,17
1683328297071,PHIL 137,A00,187003,Staff,9,0,40,31
1683328298096,PHIL 150,A00,187015,Staff,47,0,70,23
1683328299120,PHIL 167,A00,187021,Lamey; Andy M.,35,0,40,5
1683328300147,PHIL 174,A01,202226,Staff,17,0,20,3
1683328300147,PHIL 174,A02,202235,Staff,20,0,20,0
1683328301174,PHIL 191A,A00,258918,Staff,0,0,1,1
1683328302200,PHYS 1A,A00,187028,Staff,27,0,60,33
1683328303224,PHYS 1AL,001,187036,Staff,3,0,30,27
1683328303224,PHYS 1AL,002,187049,Staff,18,0,30,12
1683328304251,PHYS 1B,A00,187058,Staff,22,0,60,38
1683328305279,PHYS 1BL,001,187064,Staff,0,0,30,30
1683328305279,PHYS 1BL,002,187070,Staff,5,0,30,25
1683328306304,PHYS 1C,A00,187082,Staff,31,0,120,89
1683328307330,PHYS 1CL,001,187088,Staff,0,9,30,30
1683328307330,PHYS 1CL,002,187089,Staff,0,2,30,30
1683328307330,PHYS 1CL,009,262693,Staff,11,0,30,19
1683328308356,PHYS 2B,A01,187097,Staff,54,0,115,61
1683328309381,PHYS 2C,A01,187099,Staff,67,0,115,48
1683328310406,PHYS 2CL,A01,187101,Staff,5,0,28,23
1683328310406,PHYS 2CL,A02,187102,Staff,15,0,28,13
1683328311430,PHYS 2D,A01,187123,Shotwell; Brian,95,0,115,20
1683328312456,PHYS 4B,A01,187133,Grinstein; Benjamin,35,0,50,15
1683328313481,POLI 10,A00,188819,Staff,0,4,50,50
1683328314506,POLI 11,A00,188827,Staff,43,0,50,7
1683328315529,POLI 13R,A00,188828,Staff,0,1,20,20
1683328316553,POLI 27,A01,188830,Elgin; Samuel Zincke,0,1,70,70
1683328317577,POLI 30,A00,188832,Desposato; Scott,31,0,50,19
1683328318601,POLI 102F,A00,188834,Staff,3,0,40,37
1683328319626,POLI 104A,A00,188852,Staff,14,0,30,16
1683328320713,POLI 104I,A00,188853,Staff,0,6,20,20
1683328321736,POLI 110B,A00,188854,Wiens; David,7,0,20,13
1683328322764,POLI 112A,A00,188855,Wiens; David,5,0,30,25
1683328323789,POLI 117R,A00,188856,Forman; Fonna,0,11,20,20
1683328324818,POLI 118,A00,188857,Ingham; Sean,8,0,20,12
1683328325842,POLI 120G,A00,188858,Staff,9,0,30,21
1683328326866,POLI 131CR,A00,188863,Hoston; Germaine,24,0,50,26
1683328327894,POLI 133,A00,188864,Nellis; Gareth Hb,44,0,50,6
1683328328919,POLI 134D,A00,188865,Desposato; Scott,27,0,30,3
1683328329948,POLI 142A,A00,188871,Gartzke; Erik,22,0,50,28
1683328330975,POLI 142K,A00,188874,Staff,38,0,50,12
1683328332003,POLI 143,A00,188940,Gartzke; Erik,16,0,30,14
1683328333029,POLI 153,A00,188943,Staff,3,0,20,17
1683328334057,POLI 160AA,A00,188944,Staff,12,0,40,28
1683328335081,POLI 170A,A00,188945,Staff,11,0,30,19
1683328337132,PSYC 1,A00,188952,Staff,37,0,90,53
1683328338159,PSYC 2,B00,188953,Staff,19,0,35,16
1683328339182,PSYC 6,A00,188970,Staff,47,0,60,13
1683328340209,PSYC 7,A00,188973,Staff,37,0,45,8
1683328341234,PSYC 60,A01,188980,Rickard; Timothy C.,43,0,60,17
1683328342259,PSYC 70,A01,189001,Steiner; Eric Tomas,24,0,45,21
1683328343284,PSYC 100,A00,189005,Lacefield; Katharine I,0,100,120,120
1683328344314,PSYC 102,A00,189008,Staff,9,0,30,21
1683328345341,PSYC 106,B00,189026,Gorman; Michael R.,34,0,60,26
1683328346369,PSYC 114,B01,189033,Winkielman; Piotr,0,32,30,30
1683328347397,PSYC 131,A00,189036,Anagnostaras; Stephan,0,43,60,60
1683328348423,PSYC 136,A00,189041,Lowe; Angela Beth,0,7,25,25
1683328349450,PSYC 137,A00,189057,Winkielman; Piotr,0,34,25,25
1683328350473,PSYC 144,A00,189107,Wixted; John T,0,7,50,50
1683328352535,PSYC 162,A00,189142,Staff,0,8,85,85
1683328353568,PSYC 172,A00,189144,Gorman; Michael R.,0,7,30,30
1683328355622,PSYC 179,A00,189146,Lacefield; Katharine I,0,84,120,120
1683328356649,PSYC 181,A00,189147,Anagnostaras; Stephan,0,44,90,90
1683328357677,PSYC 190R,A00,189148,Barner; David A.,0,22,80,80
1683328358703,PSYC 191,A00,189275,Rickard; Timothy C.,0,7,25,25
1683328359729,PSYC 193,A00,189276,Chapman; Eddie Nathaniel,0,1,0,4
1683328360754,PSYC 193L,A01,189281,Lowe; Angela Beth,12,0,20,8
1683328360754,PSYC 193L,B01,189285,Staff,28,0,35,7
1683328361784,RELI 149,A00,187137,Rahimi; Babak,7,0,40,33
1683328362808,SE 9,A01,187315,Staff,0,2,18,18
1683328363835,SE 101B,A00,187409,Staff,24,0,30,6
1683328364863,SE 110B,A00,187444,Staff,10,0,40,30
1683328365889,SE 130B,A00,187449,Staff,31,0,40,9
1683328366914,SE 150A,A00,187516,Staff,9,0,20,11
1683328367940,SE 154,A00,187528,Staff,30,0,50,20
1683328368965,SIO 3,A01,258171,Staff,35,0,40,5
1683328369994,SIO 10,A00,187144,Cook; Geoffrey W,0,3,75,75
1683328371017,SIO 45,A00,187152,Cook; Geoffrey W,1,0,100,99
1683328372044,SIO 109R,A00,194486,Staff,0,3,20,20
1683328374096,SIO 187,A01,187233,Kacev; David,12,0,40,28
1683328375122,SOCI 1,A01,258656,Thorpe; Charles Robert,28,0,30,2
1683328375122,SOCI 1,A02,258658,Thorpe; Charles Robert,30,0,30,0
1683328375122,SOCI 1,A03,258661,Thorpe; Charles Robert,25,0,25,0
1683328375122,SOCI 1,A04,258666,Thorpe; Charles Robert,22,0,25,3
1683328375122,SOCI 1,A05,258897,Thorpe; Charles Robert,23,0,25,2
1683328375122,SOCI 1,A06,258898,Thorpe; Charles Robert,25,0,25,0
1683328376147,SOCI 30,A01,258903,Pardo Guerra; Juan Pablo,15,0,30,15
1683328377175,SOCI 102,A00,258904,Staff,9,0,25,16
1683328378199,SOCI 106,A00,258905,Staff,19,0,25,6
1683328379225,SOCI 111,A00,258907,Ribas Norris; Janet Vanesa,26,0,30,4
1683328380252,SOCI 121R,A00,258908,Pardo Guerra; Juan Pablo,10,0,30,20
1683328381281,SOCI 126,A01,203330,Staff,14,0,20,6
1683328382308,SOCI 131,A00,258909,Thorpe; Charles Robert,31,0,60,29
1683328383333,SOCI 135,A00,258910,Payne; Christine Anna,0,9,30,30
1683328384358,SOCI 157,A00,258911,Staff,12,0,30,18
1683328385387,SOCI 184,A00,258912,Staff,25,0,30,5
1683328386412,SOCI 188D,A00,258913,Staff,21,0,30,9
1683328387437,SYN 2,001,187529,Staff,10,0,16,6
1683328387437,SYN 2,002,201452,Staff,0,18,16,16
1683328387437,SYN 2,003,201469,Staff,3,0,16,13
1683328388463,SYN 100,A01,187531,Staff,0,9,20,20
1683328388463,SYN 100,B01,201491,Staff,0,12,20,20
1683328389491,TDAC 1,A00,189286,Walsh; Kim C.,3,0,20,17
1683328389491,TDAC 1,B00,189287,Harting; Carla Kelso,11,0,20,9
1683328390514,TDAC 101,A00,189300,Walsh; Kim C.,16,0,20,4
1683328390514,TDAC 101,B00,189301,Harting; Carla Kelso,18,0,20,2
1683328391539,TDAC 102,A00,189304,Basso; Beatrice,14,0,20,6
1683328392563,TDAC 108,A00,189305,Staff,18,0,20,2
1683328393593,TDDE 131,A00,189310,Staff,19,0,20,1
1683328393593,TDDE 131,B00,189314,Staff,19,0,20,1
1683328393593,TDDE 131,C00,189315,Staff,48,0,50,2
1683328393593,TDDE 131,D00,189316,Staff,14,0,15,1
1683328393593,TDDE 131,E00,204841,Staff,20,0,20,0
1683328394618,TDGE 10,A00,189289,Staff,30,0,50,20
1683328394618,TDGE 10,B00,189290,Havis; Allan,1,0,50,49
1683328395643,TDGE 11,A00,189291,Fulton; Julia,0,3,50,50
1683328395643,TDGE 11,B00,189292,Staff,20,0,25,5
1683328395643,TDGE 11,C00,260270,Staff,0,0,0,0
1683328396671,TDGE 25,A00,189294,Staff,3,0,20,17
1683328397699,TDGE 124,A00,189318,Fulton; Julia,0,8,50,50
1683328398724,TDGE 125,A00,189319,Staff,13,0,25,12
1683328398724,TDGE 125,B00,189320,Staff,23,0,25,2
1683328399750,TDGE 127,A00,189322,Havis; Allan,0,0,50,50
1683328400775,TDHT 101,A00,189323,Staff,18,0,25,7
1683328400775,TDHT 101,B00,189324,Staff,25,0,25,0
1683328401798,TDHT 102,A00,189325,Staff,49,0,50,1
1683328402826,TDMV 1,A00,189295,Arcidiacono; Kristin,19,0,30,11
1683328402826,TDMV 1,B00,189296,Caligagan; Maria T.,24,0,30,6
1683328403851,TDMV 2,A00,189297,Sammartano; Tonnie,28,0,30,2
1683328403851,TDMV 2,B00,189299,Arcidiacono; Kristin,24,0,30,6
1683328404875,TDMV 3,A00,204998,Rincon; Alicia,22,0,30,8
1683328405899,TDMV 120,A00,189458,Sammartano; Tonnie,28,0,30,2
1683328406926,TDMV 138,A00,189541,Jun; Grace Shin Hae,22,0,40,18
1683328407954,TDMV 142,A00,189717,Caligagan; Tony,23,0,30,7
1683328407954,TDMV 142,B00,189718,Caligagan; Maria T.,25,0,30,5
1683328408981,TMC 2,A01,187533,Staff,25,0,25,0
1683328408981,TMC 2,A02,187534,Staff,25,0,25,0
1683328410006,USP 1,A01,187536,Kwak; Nancy,0,16,25,25
1683328411030,USP 5,A01,187538,Staff,10,0,25,15
1683328412055,USP 101,A00,199253,Staff,0,4,0,0
1683328413079,USP 124,A00,187562,Boomhower; Matthew Charles,1,0,30,29
1683328414109,USP 138,A00,187582,Staff,20,0,25,5
1683328415133,USP 152,A01,187597,Staff,4,0,25,21
1683328416158,USP 153,A00,187598,Staff,19,0,25,6
1683328417181,USP 168,A00,187607,Kwak; Nancy,2,0,5,3
1683328418205,USP 173,A00,187619,Staff,4,0,25,21
1683328419229,USP 181,A00,187638,Staff,0,0,25,25
1683328420252,VIS 103,A00,187650,Cruz; Edwin Teddy,23,0,75,52
1683328421279,VIS 110D,A00,187669,Staff,12,0,22,10
1683328422304,VIS 127C,A00,187720,Shen; Kuiyi,67,0,146,79
1683328423333,VIS 149,A00,187731,Yoldas; Pinar,0,14,22,22
1683328424417,VIS 151,A01,188091,Staff,22,0,34,12
1683328424417,VIS 151,A02,188092,Staff,11,0,34,23
1683328425445,VIS 160B,A00,188093,Stalbaum; Brett,0,0,10,10
1683328427498,WCWP 10B,A00,201720,Staff,10,0,15,5
1683328427498,WCWP 10B,B00,201722,Staff,8,0,15,7
1683328428522,WCWP 100,A00,201725,Gagnon; Jeffrey C,0,0,2,2
1683328428522,WCWP 100,B00,201727,Staff,0,4,15,15
1683328431611,ANBI 133,A00,258401,Wilder; Linnea Lorene,34,0,40,6
1683328432636,ANBI 140,A00,258395,Hrvoj Mihic; Branka,18,0,25,7
1683328433661,ANSC 120,A00,258402,Bialecki; Jon Anthony,27,0,40,13
1683328434685,ANSC 144,A00,258400,Staff,14,0,40,26
1683328436733,ANSC 166,A00,258396,Parish; Steven Martin,157,0,175,18
1683328437758,ANSC 180,A00,193533,Staff,9,0,20,11
1683328438781,ANSC 188,A00,258397,Jassal; Aftab,33,0,40,7
1683328439806,ANTH 3,A01,258316,Staff,23,0,30,7
1683328440830,ANTH 5,A00,258394,Semendeferi; Ekaterini,16,0,20,4
1683328441853,ANTH 21,A01,258331,Staff,8,0,40,32
1683328442882,ANTH 103,A00,258398,Varma; Saiba,15,0,25,10
1683328443908,AWP 10,001,202034,Staff,0,0,0,0
1683328443908,AWP 10,002,202035,Staff,0,0,0,0
1683328443908,AWP 10,003,202036,Staff,0,0,0,0
1683328443908,AWP 10,004,202037,Staff,0,0,0,0
1683328443908,AWP 10,005,202038,Staff,0,0,0,0
1683328443908,AWP 10,006,202039,Staff,0,0,0,0
1683328443908,AWP 10,007,202040,Staff,0,0,0,0
1683328443908,AWP 10,008,202041,Staff,0,0,0,0
1683328443908,AWP 10,009,202042,Staff,0,0,0,0
1683328443908,AWP 10,010,202043,Staff,0,0,0,0
1683328443908,AWP 10,011,202044,Staff,0,0,0,0
1683328443908,AWP 10,012,202045,Staff,0,0,0,0
1683328443908,AWP 10,013,202046,Staff,0,0,0,0
1683328443908,AWP 10,014,202047,Staff,0,0,0,0
1683328443908,AWP 10,015,202048,Staff,0,0,0,0
1683328443908,AWP 10,016,202049,Staff,0,0,0,0
1683328443908,AWP 10,017,202050,Staff,0,0,0,0
1683328443908,AWP 10,018,202051,Staff,0,0,0,0
1683328443908,AWP 10,019,202052,Staff,0,0,0,0
1683328443908,AWP 10,020,202053,Staff,0,0,0,0
1683328443908,AWP 10,021,202054,Staff,0,0,0,0
1683328443908,AWP 10,022,202055,Staff,0,0,0,0
1683328443908,AWP 10,023,202056,Staff,0,0,0,0
1683328443908,AWP 10,024,202057,Staff,0,0,0,0
1683328443908,AWP 10,025,202058,Staff,0,0,0,0
1683328443908,AWP 10,026,202059,Staff,0,0,0,0
1683328444936,AWP 102,001,202032,Staff,0,0,0,0
1683328444936,AWP 102,002,202033,Staff,0,0,0,0
1683328445965,BENG 100,A01,254234,Taylor Amos; Alyssa C,31,0,40,9
1683328446991,BENG 196,001,270013,Engler; Adam J.,9999,0,9999,0
1683328448021,BICD 100R,A01,202018,Smith; Laurie,0,7,32,32
1683328448021,BICD 100R,A02,202019,Smith; Laurie,0,2,32,32
1683328448021,BICD 100R,A03,202020,Smith; Laurie,0,1,32,32
1683328448021,BICD 100R,A04,202021,Smith; Laurie,9,0,32,23
1683328448021,BICD 100R,A05,202022,Smith; Laurie,12,0,32,20
1683328449051,BICD 136,A01,193242,Gustafson-Brown; Cindy,0,2,32,32
1683328449051,BICD 136,A02,193244,Gustafson-Brown; Cindy,14,0,32,18
1683328450075,BIEB 102,A01,193249,Butler; Shannon Rhey,0,2,32,32
1683328450075,BIEB 102,A02,193251,Butler; Shannon Rhey,0,0,32,32
1683328450075,BIEB 102,A03,193253,Butler; Shannon Rhey,0,1,32,32
1683328450075,BIEB 102,A04,193255,Butler; Shannon Rhey,17,0,32,15
1683328450075,BIEB 102,A05,193265,Butler; Shannon Rhey,26,0,32,6
1683328450075,BIEB 102,A06,193269,Butler; Shannon Rhey,16,0,32,16
1683328452124,BIEB 150,A01,193274,Staff,0,0,32,32
1683328452124,BIEB 150,A02,193285,Staff,23,0,32,9
1683328453149,BIEB 194,A00,193286,Kurle; Carolyn M.,22,0,32,10
1683328454175,BILD 1,A01,192291,Staff,16,0,32,16
1683328454175,BILD 1,A02,192292,Staff,30,0,32,2
1683328454175,BILD 1,B01,192520,Reuther; Keefe,0,1,0,0
1683328454175,BILD 1,B02,192532,Reuther; Keefe,0,1,0,0
1683328455201,BILD 3,A01,192556,Butler; Shannon Rhey,0,0,32,32
1683328455201,BILD 3,A02,192581,Butler; Shannon Rhey,5,0,32,27
1683328455201,BILD 3,A03,192611,Butler; Shannon Rhey,23,0,32,9
1683328455201,BILD 3,A04,192612,Butler; Shannon Rhey,25,0,32,7
1683328455201,BILD 3,A05,192613,Butler; Shannon Rhey,27,0,32,5
1683328455201,BILD 3,A06,192679,Butler; Shannon Rhey,27,0,32,5
1683328455201,BILD 3,A07,192682,Butler; Shannon Rhey,22,0,32,10
1683328456228,BILD 4,A01,192836,Reuther; Keefe,0,0,24,24
1683328456228,BILD 4,A02,193044,Reuther; Keefe,4,0,24,20
1683328457253,BILD 10,A01,193142,Gustafson-Brown; Cindy,30,0,32,2
1683328457253,BILD 10,A02,193149,Gustafson-Brown; Cindy,31,0,32,1
1683328458277,BIMM 100,A01,193301,Staff,0,6,32,32
1683328458277,BIMM 100,A02,193312,Staff,0,5,32,32
1683328458277,BIMM 100,A03,193323,Staff,0,8,32,32
1683328459301,BIMM 101,A01,193329,McDonnell; Lisa Marie,0,3,24,24
1683328459301,BIMM 101,A02,193339,McDonnell; Lisa Marie,0,3,24,24
1683328459301,BIMM 101,B01,193354,McDonnell; Lisa Marie,0,3,24,24
1683328459301,BIMM 101,B02,193357,McDonnell; Lisa Marie,0,3,24,24
1683328460326,BIMM 110,A01,193377,Tat; John,0,11,32,32
1683328460326,BIMM 110,A02,193378,Tat; John,1,9,32,31
1683328461354,BIMM 120,A01,206116,Staff,0,0,32,32
1683328461354,BIMM 120,A02,206117,Staff,8,0,32,24
1683328461354,BIMM 120,A03,206121,Staff,21,0,32,11
1683328462384,BIPN 100,A01,193393,Park; Ji Young,0,14,32,32
1683328462384,BIPN 100,A02,193402,Park; Ji Young,0,13,32,32
1683328462384,BIPN 100,A03,193413,Park; Ji Young,0,14,32,32
1683328462384,BIPN 100,A04,193414,Park; Ji Young,0,13,32,32
1683328463414,BIPN 102,A01,193429,Staff,0,0,32,32
1683328463414,BIPN 102,A02,193438,Staff,22,0,32,10
1683328464441,BIPN 106,A01,193450,Reyes Gonzalez; Catalina,0,2,40,40
1683328465466,BIPN 134,A01,193465,Cooke; James Edward,0,0,32,32
1683328465466,BIPN 134,A02,193474,Cooke; James Edward,25,0,32,7
1683328465466,BIPN 134,A03,193485,Cooke; James Edward,29,0,32,3
1683328465466,BIPN 134,A04,193486,Cooke; James Edward,21,0,32,11
1683328465466,BIPN 134,A05,193491,Cooke; James Edward,31,0,32,1
1683328465466,BIPN 134,A06,193501,Cooke; James Edward,30,0,32,2
1683328465466,BIPN 134,A07,193510,Cooke; James Edward,29,0,32,3
1683328467526,BISP 194,A00,222522,Staff,14,0,32,18
1683328468554,CAT 124,A01,202407,Staff,20,0,25,5
1683328469579,CAT 125,A00,202408,Marchisotto; Jennifer Anne,4,0,20,16
1683328470604,CAT 125R,A00,202409,Smith; Lauryn Alissa,0,11,20,20
1683328470604,CAT 125R,B00,202410,Morales; Celeste Georgianna,0,11,20,20
1683328470604,CAT 125R,C00,202411,Irwin; Matthew Joseph,0,10,20,20
1683328471633,CENG 15,A01,204712,Yang; Kesong,0,1,0,0
1683328472660,CENG 114,A00,202070,Jahed Motlagh; Zeinab,5,0,20,15
1683328473686,CGS 105,A00,185477,Wesling; Megan E.,24,0,40,16
1683328474711,CGS 106,A00,185494,Staff,13,0,22,9
1683328475735,CGS 108,A00,185495,Staff,14,0,20,6
1683328476760,CGS 114,A00,185496,Staff,13,0,18,5
1683328477787,CGS 119,A00,185501,Staff,15,0,20,5
1683328478814,CGS 120,A00,185511,Staff,13,0,20,7
1683328479843,CHEM 4,A01,184675,Bussey; Thomas J,96,0,100,4
1683328480870,CHEM 6A,A01,184677,Staff,34,0,60,26
1683328481894,CHEM 6B,A01,184679,Staff,65,0,100,35
1683328482918,CHEM 6C,A01,184681,Bussey; Thomas J,1,0,50,49
1683328482918,CHEM 6C,A02,184682,Bussey; Thomas J,34,0,50,16
1683328483942,CHEM 40A,A01,184684,Albizati; Kim F.,37,0,100,63
1683328484966,CHEM 40B,A01,184686,Albizati; Kim F.,0,20,100,100
1683328485994,CHEM 41B,A01,184690,Staff,52,0,100,48
1683328487019,COGS 3,A01,184715,Boyle; Mary E. T.,0,25,40,40
1683328488043,COGS 14B,A01,185172,Staff,0,15,38,38
1683328489071,COGS 18,A01,184736,Staff,17,0,80,63
1683328490097,COGS 100,A01,184932,Staff,0,5,73,73
1683328491125,COGS 101A,A01,184935,Staff,0,38,30,30
1683328492153,COGS 101B,A01,184944,Staff,0,2,30,30
1683328493177,COGS 101C,A01,184946,Staff,0,12,30,30
1683328494205,COGS 102A,A01,184951,Johnson; Christine M.,2,0,40,38
1683328495233,COGS 107B,A01,184953,Mooshagian; Eric Frederick,0,50,40,40
1683328496268,COGS 118B,A01,184959,Gupta; Anjum,0,48,40,40
1683328497295,COGS 153,A00,184961,Staff,0,15,30,30
1683328498321,COGS 177,A00,184962,Staff,0,20,30,30
1683328499351,COGS 187A,A01,184969,Boyle; Mary E. T.,0,17,40,40
1683328500376,COMM 10,A01,185174,Staff,0,5,25,25
1683328500376,COMM 10,A02,185189,Staff,0,5,25,25
1683328500376,COMM 10,A03,269821,Staff,0,0,0,0
1683328501405,COMM 100B,A01,185475,Staff,0,0,0,2
1683328501405,COMM 100B,A02,185476,Staff,14,0,25,11
1683328502428,COMM 100C,A01,185314,Staff,1,0,25,24
1683328502428,COMM 100C,A02,185327,Staff,19,0,25,6
1683328503453,COMM 110M,A00,185349,Staff,2,0,40,38
1683328504479,COMM 113T,A00,185352,Staff,24,0,40,16
1683328505503,COMM 114I,A00,185353,Staff,33,0,40,7
1683328506529,COMM 131,A00,185354,Staff,19,0,30,11
1683328507552,CSE 8A,A50,185358,Cao; Yingjun,0,46,10,10
1683328508574,CSE 8B,A01,185362,Staff,1,47,50,49
1683328509598,CSE 11,A01,185416,Cao; Yingjun,0,92,10,10
1683328510625,CSE 20,A01,185445,Briones; Jor-el Thomas Caparas,5,0,25,20
1683328511648,CSE 21,A01,185447,Staff,10,0,50,40
1683328512675,CSE 101,A01,185451,Staff,0,12,50,50
1683328512675,CSE 101,B01,185453,Jones; Miles E,0,11,50,50
1683328514724,CSE 141,A01,185458,Eldon; John,20,0,100,80
1683328515749,CSE 141L,A01,185461,Eldon; John,12,0,100,88
1683328516774,CSE 142,A01,185463,Staff,36,0,60,24
1683328516774,CSE 142,B01,201355,Staff,0,7,60,60
1683328517797,CSE 142L,A01,185470,Staff,36,0,60,24
1683328517797,CSE 142L,B01,201417,Staff,0,6,60,60
1683328518825,CSE 190,A00,201433,Staff,32,0,49,17
1683328519852,DOC 1,A01,259136,Strom; Megan C.,7,0,15,8
1683328519852,DOC 1,A02,259137,Strom; Megan C.,14,0,15,1
1683328519852,DOC 1,A03,259138,Strom; Megan C.,14,0,15,1
1683328519852,DOC 1,A04,259139,Strom; Megan C.,14,0,15,1
1683328520879,DOC 100D,A00,259140,Pass; Natalye Joann,16,0,25,9
1683328521907,DSGN 1,A01,184749,Rill; Bryan,0,26,30,30
1683328522931,DSGN 100,A01,185168,Staff,0,2,25,25
1683328523957,ECE 5,A01,185626,Morris; Karcher William,0,10,0,0
1683328524981,ECE 101,A01,185628,Staff,17,0,70,53
1683328526006,ECE 107,A01,185635,Baghdadchi; Saharnaz,0,0,20,20
1683328526006,ECE 107,A02,185638,Baghdadchi; Saharnaz,4,0,20,16
1683328527033,ECE 148,A01,185647,Silberman; Jack,0,0,16,16
1683328528114,ECON 1,A01,185537,Crane; Meredith Helen,54,0,70,16
1683328529142,ECON 3,A01,185549,Crane; Meredith Helen,33,0,70,37
1683328530166,ECON 4,A01,203354,Anderson; John Charles,0,4,10,10
1683328531189,ECON 100A,A01,185574,Staff,0,4,40,40
1683328532213,ECON 100B,A01,185576,Staff,10,22,50,40
1683328533241,ECON 100C,A01,185589,Newhouse; Herbert S,30,0,70,40
1683328534265,ECON 105,A00,185608,Vespa; Emanuel Ignacio,19,0,35,16
1683328535293,ECON 109,A01,185610,Shishkin; Denis,10,0,35,25
1683328536319,ECON 110A,A01,185612,Staff,11,0,40,29
1683328537343,ECON 120A,A01,185615,Staff,20,0,40,20
1683328538370,ECON 120C,A01,185617,Sun; Yixiao,0,20,70,70
1683328539394,ECON 144,A00,203346,Squires; Dale E,3,0,35,32
1683328540417,ECON 171,A01,203349,Newhouse; Herbert S,0,1,35,35
1683328541445,ECON 173A,A01,185621,Toda; Alexis Akira,21,0,35,14
1683328542471,EDS 25,A01,202413,Staff,0,1,0,0
1683328542471,EDS 25,A02,202414,Staff,0,1,0,0
1683328542471,EDS 25,A03,202415,Staff,0,0,0,0
1683328542471,EDS 25,A04,202416,Staff,0,1,0,0
1683328542471,EDS 25,A05,202439,Staff,0,0,0,0
1683328542471,EDS 25,A06,202440,Staff,0,0,0,0
1683328542471,EDS 25,B01,202631,Staff,0,0,0,0
1683328542471,EDS 25,B02,202632,Staff,0,0,0,0
1683328542471,EDS 25,B03,202639,Staff,0,0,0,0
1683328542471,EDS 25,B04,202640,Staff,0,0,0,0
1683328542471,EDS 25,B05,202643,Staff,0,0,0,0
1683328542471,EDS 25,B06,202644,Staff,0,0,0,0
1683328543496,EDS 38,A01,202659,Black; Alison Michelle,24,0,25,1
1683328544523,EDS 115,A00,202652,Staff,17,0,30,13
1683328545550,EDS 125,A00,202649,Staff,14,0,30,16
1683328546577,EDS 126,A01,203332,Staff,30,0,30,0
1683328547601,EDS 139,A00,202838,Staff,16,0,25,9
1683328548625,EDS 146,A01,202655,Staff,14,0,25,11
1683328549650,ENG 15,A00,185667,Staff,0,1,0,0
1683328549650,ENG 15,B00,185672,Staff,0,0,0,0
1683328549650,ENG 15,C00,185675,Staff,0,0,0,0
1683328549650,ENG 15,D00,185682,Staff,0,0,0,0
1683328549650,ENG 15,E00,185684,Staff,0,0,0,0
1683328550678,ETHN 103,A00,185710,Staff,0,3,35,35
1683328551703,ETHN 103A,A00,199228,Man; Simeon S,2,0,9,7
1683328552731,ETHN 109,A00,185711,Staff,18,0,35,17
1683328553758,ETHN 142,A00,185726,Staff,0,4,30,30
1683328554785,ETHN 163J,A00,199229,Man; Simeon S,5,0,8,3
1683328555812,ETHN 168,A00,185727,Staff,8,0,10,2
1683328556837,ETHN 182,A00,185728,Staff,1,0,35,34
1683328557866,ETHN 183,A00,185737,Staff,8,0,18,10
1683328558892,GLBH 111,A01,209361,Burgos; Jose L.,0,0,0,0
1683328560942,HIEU 104,A00,185792,Staff,16,0,20,4
1683328561969,HIEU 115,A00,185800,Staff,1,0,20,19
1683328562998,HIEU 128,A00,185801,Staff,0,7,20,20
1683328564024,HIEU 147,A00,185802,Staff,16,0,20,4
1683328565047,HIEU 154,A00,185823,Staff,12,0,20,8
1683328566073,HILA 102,A00,185826,Staff,13,0,20,7
1683328567101,HILD 2C,A01,185778,Staff,0,12,20,20
1683328568130,HILD 7B,A01,185780,Kwak; Nancy,0,15,32,32
1683328568130,HILD 7B,A02,185781,Kwak; Nancy,0,18,32,32
1683328569155,HILD 30,A01,185791,Staff,14,0,20,6
1683328570179,HISC 119,A00,185830,Golan; Tal,0,9,20,20
1683328571203,HITO 156GS,A00,185831,Patterson; Patrick H.,0,0,0,23
1683328572230,HIUS 103,A00,185832,Man; Simeon S,0,6,20,20
1683328573261,HIUS 117,A00,185836,Kwak; Nancy,2,0,20,18
1683328574286,HIUS 125,A00,185840,Man; Simeon S,0,0,23,23
1683328575313,HIUS 149,A00,185845,Staff,0,0,20,20
1683328576338,HUM 3,A01,185882,Zavodny; Tatiana Sophia,0,7,50,50
1683328576338,HUM 3,B01,185899,Caldwell; Michael Alan,0,18,50,50
1683328577365,HUM 3GS,A00,185900,Patterson; Patrick H.,0,0,0,23
1683328578396,HUM 4,A01,185938,Zroka; Amy Liane,31,0,50,19
1683328578396,HUM 4,B01,185956,Watkins; Eric,0,2,50,50
1683328578396,HUM 4,B02,202209,Watkins; Eric,0,2,50,50
1683328578396,HUM 4,B03,202210,Watkins; Eric,0,2,50,50
1683328579420,HUM 5,A01,185958,West; Geoffrey Scott,3,0,50,47
1683328579420,HUM 5,A02,202215,West; Geoffrey Scott,0,0,50,50
1683328580449,INTL 190,A00,185959,Gagnon; Jeffrey C,0,0,0,9
1683328580449,INTL 190,B00,185960,Lettieri; Michael Joseph,0,0,0,1
1683328581478,JAPN 180,A00,254509,Staff,5,1,30,25
1683328582506,LATI 10,A01,202853,Kennemore; Amy Michelle,4,0,35,31
1683328582506,LATI 10,A02,202854,Kennemore; Amy Michelle,2,0,35,33
1683328582506,LATI 10,A03,270054,Kennemore; Amy Michelle,30,0,30,0
1683328583530,LATI 180,A00,202855,Kennemore; Amy Michelle,11,0,20,9
1683328584556,LAWS 101,A00,201767,Golan; Tal,0,7,40,40
1683328585580,LIFR 1C,A00,185961,Staff,6,0,20,14
1683328586607,LIFR 1CX,A00,185962,Staff,7,0,20,13
1683328587631,LIFR 1D,A00,185963,Staff,9,0,20,11
1683328588655,LIFR 1DX,A00,185964,Staff,9,0,20,11
1683328589679,LIGN 101,A01,186039,Staff,43,0,50,7
1683328590706,LIGN 165,A00,186040,Staff,18,0,50,32
1683328591730,LTCS 108,A00,186041,Staff,6,0,10,4
1683328592754,LTCS 119,A00,186042,Staff,16,0,20,4
1683328593788,LTCS 130,A00,186043,Wesling; Megan E.,15,0,25,10
1683328595836,LTEA 138,A00,186119,Staff,14,0,40,26
1683328596859,LTEN 124,A00,186148,Staff,6,0,25,19
1683328597887,LTEN 178,A00,186149,Staff,7,0,15,8
1683328598914,LTEN 181,A00,186150,Blanco; John D,33,0,40,7
1683328599938,LTWL 120,A00,186160,Staff,20,0,25,5
1683328600966,LTWL 165,A00,186161,Staff,22,0,25,3
1683328601989,LTWR 100,A00,186162,Staff,0,5,15,15
1683328603013,LTWR 102,A00,186163,Doller; Ben,5,0,15,10
1683328604040,MAE 8,A01,186412,Staff,0,0,0,0
1683328605067,MAE 30B,A00,186445,Bahadori; Mohammad Yousef,83,0,100,17
1683328606092,MAE 40,A00,186592,Bewley; Thomas R,9,0,50,41
1683328607115,MAE 101B,A00,186593,Bahadori; Mohammad Yousef,81,0,100,19
1683328608141,MAE 105,A00,186594,Bandaru; Prabhakar,12,0,50,38
1683328609168,MAE 107,A00,186599,Pham; Hieu Tan,0,6,120,120
1683328610196,MAE 148,A01,186660,Silberman; Jack,3,0,16,13
1683328611221,MATH 10A,A01,188095,Staff,1,6,35,34
1683328612250,MATH 10B,A01,188097,Bowers; Adam R.,0,11,30,30
1683328612250,MATH 10B,A02,188099,Bowers; Adam R.,0,11,30,30
1683328612250,MATH 10B,B01,188104,Bowers; Adam R.,0,10,30,30
1683328612250,MATH 10B,B02,188106,Bowers; Adam R.,0,10,30,30
1683328613276,MATH 10C,A01,188111,Staff,0,18,30,30
1683328613276,MATH 10C,A02,188127,Staff,0,17,30,30
1683328613276,MATH 10C,A03,188131,Staff,0,18,30,30
1683328613276,MATH 10C,B01,188218,Staff,18,0,30,12
1683328613276,MATH 10C,B02,188244,Staff,13,0,30,17
1683328613276,MATH 10C,B03,188277,Staff,16,0,30,14
1683328614306,MATH 18,A01,188344,Bach; Quang Tran,18,0,30,12
1683328614306,MATH 18,A02,188345,Bach; Quang Tran,11,0,30,19
1683328614306,MATH 18,B01,188353,Bach; Quang Tran,10,0,30,20
1683328614306,MATH 18,B02,188354,Bach; Quang Tran,20,0,30,10
1683328615331,MATH 20A,A01,188374,Staff,13,0,35,22
1683328616356,MATH 20B,A01,188382,Ohm; Ko Woon,6,0,30,24
1683328616356,MATH 20B,A02,188383,Ohm; Ko Woon,22,0,30,8
1683328616356,MATH 20B,B01,188385,Ohm; Ko Woon,7,0,30,23
1683328616356,MATH 20B,B02,188392,Ohm; Ko Woon,22,0,30,8
1683328617381,MATH 20C,A01,188394,Harel; Guershon,10,0,30,20
1683328617381,MATH 20C,A02,188395,Harel; Guershon,15,0,30,15
1683328617381,MATH 20C,B01,188404,Harel; Guershon,5,0,30,25
1683328617381,MATH 20C,B02,188405,Harel; Guershon,19,0,30,11
1683328618406,MATH 20D,A01,188414,Hammock; Frances H,0,1,30,30
1683328618406,MATH 20D,A02,188415,Hammock; Frances H,2,0,30,28
1683328618406,MATH 20D,B01,188447,Hammock; Frances H,2,0,30,28
1683328618406,MATH 20D,B02,188486,Hammock; Frances H,8,0,30,22
1683328619431,MATH 20E,A01,188649,Staff,21,0,30,9
1683328619431,MATH 20E,A02,188650,Staff,23,0,30,7
1683328619431,MATH 20E,A03,188673,Staff,0,0,30,30
1683328620458,MATH 102,A01,188675,Staff,0,35,35,35
1683328621484,MATH 103B,A01,188681,Staff,3,0,35,32
1683328621484,MATH 103B,B01,188692,Staff,5,0,35,30
1683328622509,MATH 109,A01,188695,Salehi Golsefidy; Alireza,25,0,35,10
1683328622509,MATH 109,A02,188696,Salehi Golsefidy; Alireza,26,0,35,9
1683328623534,MATH 120A,A01,188698,Eggers; John Dietrich,7,0,35,28
1683328624558,MATH 142B,A01,188736,Ioana; Adrian,0,2,30,30
1683328624558,MATH 142B,A02,188741,Ioana; Adrian,1,1,30,29
1683328624558,MATH 142B,A03,188743,Ioana; Adrian,1,3,30,29
1683328625585,MATH 168A,A01,188790,Staff,0,9,35,35
1683328626614,MATH 170A,A01,188803,Nie; Jiawang,0,2,35,35
1683328626614,MATH 170A,A02,188811,Nie; Jiawang,0,0,35,35
1683328626614,MATH 170A,A03,188814,Nie; Jiawang,1,0,35,34
1683328626614,MATH 170A,A04,188815,Nie; Jiawang,13,0,35,22
1683328627639,MATH 193B,A01,188817,Staff,0,0,35,35
1683328627639,MATH 193B,A02,188818,Staff,5,0,35,30
1683328628663,MGT 4,A01,202857,Anderson; John Charles,62,0,80,18
1683328629688,MGT 12,A00,202858,Lindenberger; Wade Douglas,42,0,90,48
1683328630713,MGT 18,A00,202859,Staff,74,0,90,16
1683328631799,MGT 18GS,A00,202860,McKay; Michael J,13,0,28,15
1683328632828,MGT 45,A00,202861,Pecore; Joseph P.,13,0,90,77
1683328633851,MGT 100,A00,202863,Yavorsky; Daniel Ryan,28,0,90,62
1683328634878,MGT 103,A00,202864,Ehrich; Kristine R,1,18,90,89
1683328635904,MGT 112,A00,202865,Ehrich; Kristine R,15,0,90,75
1683328636931,MGT 121A,A00,202868,Staff,0,20,0,0
1683328637956,MGT 131B,A00,202869,Anderson; John Charles,59,0,90,31
1683328638984,MGT 136,A00,202871,Lindenberger; Wade Douglas,84,0,90,6
1683328640007,MGT 164,A00,202873,Staff,0,68,90,91
1683328641034,MGT 164GS,A00,202874,McKay; Mary A,13,0,28,15
1683328642061,MGT 180,A00,202875,Staff,0,50,90,91
1683328643086,MMW 11R,A01,205019,Herbst; Matthew,3,0,30,27
1683328643086,MMW 11R,A02,205026,Herbst; Matthew,29,0,30,1
1683328644111,MMW 15,A01,193512,Chang; Edmond Yi-Teh,0,9,28,28
1683328644111,MMW 15,A02,193513,Chang; Edmond Yi-Teh,0,5,28,28
1683328644111,MMW 15,A03,193514,Chang; Edmond Yi-Teh,0,5,28,28
1683328644111,MMW 15,A04,193515,Chang; Edmond Yi-Teh,0,5,28,28
1683328644111,MMW 15,A05,193516,Chang; Edmond Yi-Teh,0,4,28,28
1683328644111,MMW 15,A06,193517,Chang; Edmond Yi-Teh,0,5,28,28
1683328644111,MMW 15,B01,193519,Chang; Edmond Yi-Teh,0,5,28,28
1683328644111,MMW 15,B02,193520,Chang; Edmond Yi-Teh,0,5,28,28
1683328644111,MMW 15,B03,193521,Chang; Edmond Yi-Teh,0,5,28,28
1683328644111,MMW 15,B04,193522,Chang; Edmond Yi-Teh,0,4,28,28
1683328644111,MMW 15,B05,193523,Chang; Edmond Yi-Teh,0,5,28,28
1683328644111,MMW 15,B06,193524,Chang; Edmond Yi-Teh,0,4,28,28
1683328645140,MMW 122,A01,193526,Rahimi; Babak,0,15,28,28
1683328645140,MMW 122,A02,193527,Rahimi; Babak,0,14,28,28
1683328645140,MMW 122,A03,193528,Rahimi; Babak,0,0,0,0
1683328645140,MMW 122,A04,193529,Rahimi; Babak,0,0,0,0
1683328646168,MUS 1A,A01,186663,Staff,0,20,35,35
1683328647196,MUS 4,A01,186715,Staff,0,12,35,35
1683328648219,MUS 5R,A01,186796,Dubnov; Shlomo,0,17,35,35
1683328649243,MUS 6,A01,186798,Staff,0,4,25,25
1683328650270,MUS 7,A01,186830,Staff,12,0,35,23
1683328651297,MUS 8,A01,186930,Staff,0,27,35,35
1683328652322,MUS 15,A01,186932,Staff,0,16,35,35
1683328652322,MUS 15,B01,186934,Staff,0,15,35,35
1683328653347,MUS 80,A00,186935,Staff,1,0,20,19
1683328653347,MUS 80,B00,186936,Staff,25,0,25,0
1683328654375,NANO 11,A00,204702,Lipomi; Darren John,0,0,0,0
1683328655401,NANO 15,A01,204709,Yang; Kesong,0,1,0,0
1683328656425,NANO 114,A00,202069,Jahed Motlagh; Zeinab,3,0,10,7
1683328657451,PHIL 1,A00,186955,Grush; Rick Scott,32,0,40,8
1683328658476,PHIL 10,A01,186973,Grush; Rick Scott,28,0,35,7
1683328658476,PHIL 10,A02,186974,Grush; Rick Scott,33,0,35,2
1683328659501,PHIL 13,A01,186976,Staff,7,0,35,28
1683328659501,PHIL 13,A02,186977,Staff,16,0,35,19
1683328660526,PHIL 14,A01,186979,Staff,31,0,35,4
1683328660526,PHIL 14,A02,186986,Staff,32,0,35,3
1683328661550,PHIL 28,A01,186988,Staff,16,0,30,14
1683328661550,PHIL 28,A02,186989,Staff,1,0,30,29
1683328661550,PHIL 28,A03,186990,Staff,9,0,30,21
1683328661550,PHIL 28,A04,186991,Staff,26,0,30,4
1683328662577,PHIL 120,A00,186997,Staff,23,0,40,17
1683328663602,PHIL 137,A00,187003,Staff,9,0,40,31
1683328664628,PHIL 150,A00,187015,Staff,47,0,70,23
1683328665653,PHIL 167,A00,187021,Lamey; Andy M.,35,0,40,5
1683328666677,PHIL 174,A01,202226,Staff,17,0,20,3
1683328666677,PHIL 174,A02,202235,Staff,20,0,20,0
1683328667705,PHIL 191A,A00,258918,Staff,0,0,1,1
1683328668730,PHYS 1A,A00,187028,Staff,27,0,60,33
1683328669755,PHYS 1AL,001,187036,Staff,3,0,30,27
1683328669755,PHYS 1AL,002,187049,Staff,18,0,30,12
1683328670783,PHYS 1B,A00,187058,Staff,22,0,60,38
1683328671811,PHYS 1BL,001,187064,Staff,0,0,30,30
1683328671811,PHYS 1BL,002,187070,Staff,5,0,30,25
1683328672835,PHYS 1C,A00,187082,Staff,31,0,120,89
1683328673860,PHYS 1CL,001,187088,Staff,0,9,30,30
1683328673860,PHYS 1CL,002,187089,Staff,0,2,30,30
1683328673860,PHYS 1CL,009,262693,Staff,11,0,30,19
1683328674890,PHYS 2B,A01,187097,Staff,54,0,115,61
1683328675919,PHYS 2C,A01,187099,Staff,67,0,115,48
1683328676944,PHYS 2CL,A01,187101,Staff,5,0,28,23
1683328676944,PHYS 2CL,A02,187102,Staff,15,0,28,13
1683328677972,PHYS 2D,A01,187123,Shotwell; Brian,95,0,115,20
1683328678997,PHYS 4B,A01,187133,Grinstein; Benjamin,35,0,50,15
1683328680025,POLI 10,A00,188819,Staff,0,4,50,50
1683328681051,POLI 11,A00,188827,Staff,43,0,50,7
1683328682079,POLI 13R,A00,188828,Staff,0,1,20,20
1683328683107,POLI 27,A01,188830,Elgin; Samuel Zincke,0,1,70,70
1683328684132,POLI 30,A00,188832,Desposato; Scott,31,0,50,19
1683328685163,POLI 102F,A00,188834,Staff,3,0,40,37
1683328686189,POLI 104A,A00,188852,Staff,14,0,30,16
1683328687236,POLI 104I,A00,188853,Staff,0,6,20,20
1683328688261,POLI 110B,A00,188854,Wiens; David,7,0,20,13
1683328689286,POLI 112A,A00,188855,Wiens; David,5,0,30,25
1683328690310,POLI 117R,A00,188856,Forman; Fonna,0,11,20,20
1683328691335,POLI 118,A00,188857,Ingham; Sean,8,0,20,12
1683328692362,POLI 120G,A00,188858,Staff,9,0,30,21
1683328693386,POLI 131CR,A00,188863,Hoston; Germaine,24,0,50,26
1683328694415,POLI 133,A00,188864,Nellis; Gareth Hb,44,0,50,6
1683328695443,POLI 134D,A00,188865,Desposato; Scott,27,0,30,3
1683328696471,POLI 142A,A00,188871,Gartzke; Erik,22,0,50,28
1683328697499,POLI 142K,A00,188874,Staff,38,0,50,12
1683328698522,POLI 143,A00,188940,Gartzke; Erik,16,0,30,14
1683328699552,POLI 153,A00,188943,Staff,3,0,20,17
1683328700586,POLI 160AA,A00,188944,Staff,12,0,40,28
1683328701610,POLI 170A,A00,188945,Staff,11,0,30,19
1683328703659,PSYC 1,A00,188952,Staff,37,0,90,53
1683328704686,PSYC 2,B00,188953,Staff,19,0,35,16
1683328705713,PSYC 6,A00,188970,Staff,47,0,60,13
1683328706741,PSYC 7,A00,188973,Staff,37,0,45,8
1683328707766,PSYC 60,A01,188980,Rickard; Timothy C.,43,0,60,17
1683328708791,PSYC 70,A01,189001,Steiner; Eric Tomas,24,0,45,21
1683328709819,PSYC 100,A00,189005,Lacefield; Katharine I,0,100,120,120
1683328710841,PSYC 102,A00,189008,Staff,9,0,30,21
1683328711868,PSYC 106,B00,189026,Gorman; Michael R.,34,0,60,26
1683328712896,PSYC 114,B01,189033,Winkielman; Piotr,0,32,30,30
1683328713923,PSYC 131,A00,189036,Anagnostaras; Stephan,0,43,60,60
1683328714953,PSYC 136,A00,189041,Lowe; Angela Beth,0,7,25,25
1683328715981,PSYC 137,A00,189057,Winkielman; Piotr,0,34,25,25
1683328717007,PSYC 144,A00,189107,Wixted; John T,0,7,50,50
1683328719055,PSYC 162,A00,189142,Staff,0,8,85,85
1683328720083,PSYC 172,A00,189144,Gorman; Michael R.,0,7,30,30
1683328722134,PSYC 179,A00,189146,Lacefield; Katharine I,0,84,120,120
1683328723157,PSYC 181,A00,189147,Anagnostaras; Stephan,0,44,90,90
1683328724181,PSYC 190R,A00,189148,Barner; David A.,0,22,80,80
1683328725205,PSYC 191,A00,189275,Rickard; Timothy C.,0,7,25,25
1683328726229,PSYC 193,A00,189276,Chapman; Eddie Nathaniel,0,1,0,4
1683328727255,PSYC 193L,A01,189281,Lowe; Angela Beth,12,0,20,8
1683328727255,PSYC 193L,B01,189285,Staff,28,0,35,7
1683328728280,RELI 149,A00,187137,Rahimi; Babak,7,0,40,33
1683328729305,SE 9,A01,187315,Staff,0,2,18,18
1683328730329,SE 101B,A00,187409,Staff,24,0,30,6
1683328731353,SE 110B,A00,187444,Staff,10,0,40,30
1683328732381,SE 130B,A00,187449,Staff,31,0,40,9
1683328733405,SE 150A,A00,187516,Staff,9,0,20,11
1683328734432,SE 154,A00,187528,Staff,30,0,50,20
1683328735512,SIO 3,A01,258171,Staff,35,0,40,5
1683328736536,SIO 10,A00,187144,Cook; Geoffrey W,0,3,75,75
1683328737561,SIO 45,A00,187152,Cook; Geoffrey W,1,0,100,99
1683328738585,SIO 109R,A00,194486,Staff,0,3,20,20
1683328740640,SIO 187,A01,187233,Kacev; David,12,0,40,28
1683328741663,SOCI 1,A01,258656,Thorpe; Charles Robert,28,0,30,2
1683328741663,SOCI 1,A02,258658,Thorpe; Charles Robert,30,0,30,0
1683328741663,SOCI 1,A03,258661,Thorpe; Charles Robert,25,0,25,0
1683328741663,SOCI 1,A04,258666,Thorpe; Charles Robert,22,0,25,3
1683328741663,SOCI 1,A05,258897,Thorpe; Charles Robert,23,0,25,2
1683328741663,SOCI 1,A06,258898,Thorpe; Charles Robert,25,0,25,0
1683328742687,SOCI 30,A01,258903,Pardo Guerra; Juan Pablo,15,0,30,15
1683328743717,SOCI 102,A00,258904,Staff,9,0,25,16
1683328744741,SOCI 106,A00,258905,Staff,19,0,25,6
1683328745765,SOCI 111,A00,258907,Ribas Norris; Janet Vanesa,26,0,30,4
1683328746791,SOCI 121R,A00,258908,Pardo Guerra; Juan Pablo,10,0,30,20
1683328747819,SOCI 126,A01,203330,Staff,14,0,20,6
1683328748844,SOCI 131,A00,258909,Thorpe; Charles Robert,31,0,60,29
1683328749872,SOCI 135,A00,258910,Payne; Christine Anna,0,9,30,30
1683328750899,SOCI 157,A00,258911,Staff,12,0,30,18
1683328751923,SOCI 184,A00,258912,Staff,25,0,30,5
1683328752950,SOCI 188D,A00,258913,Staff,21,0,30,9
1683328753976,SYN 2,001,187529,Staff,10,0,16,6
1683328753976,SYN 2,002,201452,Staff,0,18,16,16
1683328753976,SYN 2,003,201469,Staff,3,0,16,13
1683328755004,SYN 100,A01,187531,Staff,0,9,20,20
1683328755004,SYN 100,B01,201491,Staff,0,12,20,20
1683328756033,TDAC 1,A00,189286,Walsh; Kim C.,3,0,20,17
1683328756033,TDAC 1,B00,189287,Harting; Carla Kelso,11,0,20,9
1683328757061,TDAC 101,A00,189300,Walsh; Kim C.,16,0,20,4
1683328757061,TDAC 101,B00,189301,Harting; Carla Kelso,18,0,20,2
1683328758085,TDAC 102,A00,189304,Basso; Beatrice,14,0,20,6
1683328759110,TDAC 108,A00,189305,Staff,18,0,20,2
1683328760140,TDDE 131,A00,189310,Staff,19,0,20,1
1683328760140,TDDE 131,B00,189314,Staff,19,0,20,1
1683328760140,TDDE 131,C00,189315,Staff,48,0,50,2
1683328760140,TDDE 131,D00,189316,Staff,14,0,15,1
1683328760140,TDDE 131,E00,204841,Staff,20,0,20,0
1683328761166,TDGE 10,A00,189289,Staff,30,0,50,20
1683328761166,TDGE 10,B00,189290,Havis; Allan,1,0,50,49
1683328762190,TDGE 11,A00,189291,Fulton; Julia,0,3,50,50
1683328762190,TDGE 11,B00,189292,Staff,20,0,25,5
1683328762190,TDGE 11,C00,260270,Staff,0,0,0,0
1683328763214,TDGE 25,A00,189294,Staff,3,0,20,17
1683328764242,TDGE 124,A00,189318,Fulton; Julia,0,8,50,50
1683328765269,TDGE 125,A00,189319,Staff,13,0,25,12
1683328765269,TDGE 125,B00,189320,Staff,23,0,25,2
1683328766293,TDGE 127,A00,189322,Havis; Allan,0,0,50,50
1683328767318,TDHT 101,A00,189323,Staff,18,0,25,7
1683328767318,TDHT 101,B00,189324,Staff,25,0,25,0
1683328768341,TDHT 102,A00,189325,Staff,49,0,50,1
1683328769366,TDMV 1,A00,189295,Arcidiacono; Kristin,19,0,30,11
1683328769366,TDMV 1,B00,189296,Caligagan; Maria T.,24,0,30,6
1683328770390,TDMV 2,A00,189297,Sammartano; Tonnie,28,0,30,2
1683328770390,TDMV 2,B00,189299,Arcidiacono; Kristin,24,0,30,6
1683328771418,TDMV 3,A00,204998,Rincon; Alicia,22,0,30,8
1683328772445,TDMV 120,A00,189458,Sammartano; Tonnie,28,0,30,2
1683328773469,TDMV 138,A00,189541,Jun; Grace Shin Hae,22,0,40,18
1683328774493,TDMV 142,A00,189717,Caligagan; Tony,23,0,30,7
1683328774493,TDMV 142,B00,189718,Caligagan; Maria T.,25,0,30,5
1683328775518,TMC 2,A01,187533,Staff,25,0,25,0
1683328775518,TMC 2,A02,187534,Staff,25,0,25,0
1683328776542,USP 1,A01,187536,Kwak; Nancy,0,16,25,25
1683328777570,USP 5,A01,187538,Staff,10,0,25,15
1683328778594,USP 101,A00,199253,Staff,0,4,0,0
1683328779621,USP 124,A00,187562,Boomhower; Matthew Charles,1,0,30,29
1683328780645,USP 138,A00,187582,Staff,20,0,25,5
1683328781670,USP 152,A01,187597,Staff,4,0,25,21
1683328782694,USP 153,A00,187598,Staff,19,0,25,6
1683328783720,USP 168,A00,187607,Kwak; Nancy,2,0,5,3
1683328784746,USP 173,A00,187619,Staff,4,0,25,21
1683328785772,USP 181,A00,187638,Staff,0,0,25,25
1683328786799,VIS 103,A00,187650,Cruz; Edwin Teddy,23,0,75,52
1683328787826,VIS 110D,A00,187669,Staff,12,0,22,10
1683328788849,VIS 127C,A00,187720,Shen; Kuiyi,67,0,146,79
1683328789874,VIS 149,A00,187731,Yoldas; Pinar,0,14,22,22
1683328790898,VIS 151,A01,188091,Staff,22,0,34,12
1683328790898,VIS 151,A02,188092,Staff,11,0,34,23
1683328791926,VIS 160B,A00,188093,Stalbaum; Brett,0,0,10,10
1683328793976,WCWP 10B,A00,201720,Staff,10,0,15,5
1683328793976,WCWP 10B,B00,201722,Staff,8,0,15,7
1683328795001,WCWP 100,A00,201725,Gagnon; Jeffrey C,0,0,2,2
1683328795001,WCWP 100,B00,201727,Staff,0,4,15,15
1683328798092,ANBI 133,A00,258401,Wilder; Linnea Lorene,34,0,40,6
1683328799121,ANBI 140,A00,258395,Hrvoj Mihic; Branka,18,0,25,7
1683328800149,ANSC 120,A00,258402,Bialecki; Jon Anthony,27,0,40,13
1683328801176,ANSC 144,A00,258400,Staff,14,0,40,26
1683328803232,ANSC 166,A00,258396,Parish; Steven Martin,157,0,175,18
1683328804254,ANSC 180,A00,193533,Staff,9,0,20,11
1683328805278,ANSC 188,A00,258397,Jassal; Aftab,33,0,40,7
1683328806301,ANTH 3,A01,258316,Staff,23,0,30,7
1683328807329,ANTH 5,A00,258394,Semendeferi; Ekaterini,16,0,20,4
1683328808357,ANTH 21,A01,258331,Staff,8,0,40,32
1683328809385,ANTH 103,A00,258398,Varma; Saiba,15,0,25,10
1683328810412,AWP 10,001,202034,Staff,0,0,0,0
1683328810412,AWP 10,002,202035,Staff,0,0,0,0
1683328810412,AWP 10,003,202036,Staff,0,0,0,0
1683328810412,AWP 10,004,202037,Staff,0,0,0,0
1683328810412,AWP 10,005,202038,Staff,0,0,0,0
1683328810412,AWP 10,006,202039,Staff,0,0,0,0
1683328810412,AWP 10,007,202040,Staff,0,0,0,0
1683328810412,AWP 10,008,202041,Staff,0,0,0,0
1683328810412,AWP 10,009,202042,Staff,0,0,0,0
1683328810412,AWP 10,010,202043,Staff,0,0,0,0
1683328810412,AWP 10,011,202044,Staff,0,0,0,0
1683328810412,AWP 10,012,202045,Staff,0,0,0,0
1683328810412,AWP 10,013,202046,Staff,0,0,0,0
1683328810412,AWP 10,014,202047,Staff,0,0,0,0
1683328810412,AWP 10,015,202048,Staff,0,0,0,0
1683328810412,AWP 10,016,202049,Staff,0,0,0,0
1683328810412,AWP 10,017,202050,Staff,0,0,0,0
1683328810412,AWP 10,018,202051,Staff,0,0,0,0
1683328810412,AWP 10,019,202052,Staff,0,0,0,0
1683328810412,AWP 10,020,202053,Staff,0,0,0,0
1683328810412,AWP 10,021,202054,Staff,0,0,0,0
1683328810412,AWP 10,022,202055,Staff,0,0,0,0
1683328810412,AWP 10,023,202056,Staff,0,0,0,0
1683328810412,AWP 10,024,202057,Staff,0,0,0,0
1683328810412,AWP 10,025,202058,Staff,0,0,0,0
1683328810412,AWP 10,026,202059,Staff,0,0,0,0
1683328811440,AWP 102,001,202032,Staff,0,0,0,0
1683328811440,AWP 102,002,202033,Staff,0,0,0,0
1683328812466,BENG 100,A01,254234,Taylor Amos; Alyssa C,31,0,40,9
1683328813491,BENG 196,001,270013,Engler; Adam J.,9999,0,9999,0
1683328814515,BICD 100R,A01,202018,Smith; Laurie,0,7,32,32
1683328814515,BICD 100R,A02,202019,Smith; Laurie,0,2,32,32
1683328814515,BICD 100R,A03,202020,Smith; Laurie,0,1,32,32
1683328814515,BICD 100R,A04,202021,Smith; Laurie,9,0,32,23
1683328814515,BICD 100R,A05,202022,Smith; Laurie,12,0,32,20
1683328815539,BICD 136,A01,193242,Gustafson-Brown; Cindy,0,2,32,32
1683328815539,BICD 136,A02,193244,Gustafson-Brown; Cindy,14,0,32,18
1683328816564,BIEB 102,A01,193249,Butler; Shannon Rhey,0,2,32,32
1683328816564,BIEB 102,A02,193251,Butler; Shannon Rhey,0,0,32,32
1683328816564,BIEB 102,A03,193253,Butler; Shannon Rhey,0,1,32,32
1683328816564,BIEB 102,A04,193255,Butler; Shannon Rhey,17,0,32,15
1683328816564,BIEB 102,A05,193265,Butler; Shannon Rhey,26,0,32,6
1683328816564,BIEB 102,A06,193269,Butler; Shannon Rhey,16,0,32,16
1683328818614,BIEB 150,A01,193274,Staff,0,0,32,32
1683328818614,BIEB 150,A02,193285,Staff,23,0,32,9
1683328819638,BIEB 194,A00,193286,Kurle; Carolyn M.,22,0,32,10
1683328820666,BILD 1,A01,192291,Staff,16,0,32,16
1683328820666,BILD 1,A02,192292,Staff,30,0,32,2
1683328820666,BILD 1,B01,192520,Reuther; Keefe,0,1,0,0
1683328820666,BILD 1,B02,192532,Reuther; Keefe,0,1,0,0
1683328821691,BILD 3,A01,192556,Butler; Shannon Rhey,0,0,32,32
1683328821691,BILD 3,A02,192581,Butler; Shannon Rhey,5,0,32,27
1683328821691,BILD 3,A03,192611,Butler; Shannon Rhey,23,0,32,9
1683328821691,BILD 3,A04,192612,Butler; Shannon Rhey,25,0,32,7
1683328821691,BILD 3,A05,192613,Butler; Shannon Rhey,27,0,32,5
1683328821691,BILD 3,A06,192679,Butler; Shannon Rhey,27,0,32,5
1683328821691,BILD 3,A07,192682,Butler; Shannon Rhey,22,0,32,10
1683328822715,BILD 4,A01,192836,Reuther; Keefe,0,0,24,24
1683328822715,BILD 4,A02,193044,Reuther; Keefe,4,0,24,20
1683328823743,BILD 10,A01,193142,Gustafson-Brown; Cindy,30,0,32,2
1683328823743,BILD 10,A02,193149,Gustafson-Brown; Cindy,31,0,32,1
1683328824770,BIMM 100,A01,193301,Staff,0,6,32,32
1683328824770,BIMM 100,A02,193312,Staff,0,5,32,32
1683328824770,BIMM 100,A03,193323,Staff,0,8,32,32
1683328825795,BIMM 101,A01,193329,McDonnell; Lisa Marie,0,3,24,24
1683328825795,BIMM 101,A02,193339,McDonnell; Lisa Marie,0,3,24,24
1683328825795,BIMM 101,B01,193354,McDonnell; Lisa Marie,0,3,24,24
1683328825795,BIMM 101,B02,193357,McDonnell; Lisa Marie,0,3,24,24
1683328826819,BIMM 110,A01,193377,Tat; John,0,11,32,32
1683328826819,BIMM 110,A02,193378,Tat; John,1,9,32,31
1683328827842,BIMM 120,A01,206116,Staff,0,0,32,32
1683328827842,BIMM 120,A02,206117,Staff,8,0,32,24
1683328827842,BIMM 120,A03,206121,Staff,21,0,32,11
1683328828870,BIPN 100,A01,193393,Park; Ji Young,0,14,32,32
1683328828870,BIPN 100,A02,193402,Park; Ji Young,0,13,32,32
1683328828870,BIPN 100,A03,193413,Park; Ji Young,0,14,32,32
1683328828870,BIPN 100,A04,193414,Park; Ji Young,0,13,32,32
1683328829897,BIPN 102,A01,193429,Staff,0,0,32,32
1683328829897,BIPN 102,A02,193438,Staff,22,0,32,10
1683328830922,BIPN 106,A01,193450,Reyes Gonzalez; Catalina,0,2,40,40
1683328831948,BIPN 134,A01,193465,Cooke; James Edward,0,0,32,32
1683328831948,BIPN 134,A02,193474,Cooke; James Edward,25,0,32,7
1683328831948,BIPN 134,A03,193485,Cooke; James Edward,29,0,32,3
1683328831948,BIPN 134,A04,193486,Cooke; James Edward,21,0,32,11
1683328831948,BIPN 134,A05,193491,Cooke; James Edward,31,0,32,1
1683328831948,BIPN 134,A06,193501,Cooke; James Edward,30,0,32,2
1683328831948,BIPN 134,A07,193510,Cooke; James Edward,29,0,32,3
1683328833995,BISP 194,A00,222522,Staff,14,0,32,18
1683328835021,CAT 124,A01,202407,Staff,20,0,25,5
1683328836045,CAT 125,A00,202408,Marchisotto; Jennifer Anne,4,0,20,16
1683328837073,CAT 125R,A00,202409,Smith; Lauryn Alissa,0,11,20,20
1683328837073,CAT 125R,B00,202410,Morales; Celeste Georgianna,0,11,20,20
1683328837073,CAT 125R,C00,202411,Irwin; Matthew Joseph,0,10,20,20
1683328838101,CENG 15,A01,204712,Yang; Kesong,0,1,0,0
1683328839181,CENG 114,A00,202070,Jahed Motlagh; Zeinab,5,0,20,15
1683328840207,CGS 105,A00,185477,Wesling; Megan E.,24,0,40,16
1683328841232,CGS 106,A00,185494,Staff,13,0,22,9
1683328842258,CGS 108,A00,185495,Staff,14,0,20,6
1683328843283,CGS 114,A00,185496,Staff,13,0,18,5
1683328844307,CGS 119,A00,185501,Staff,15,0,20,5
1683328845382,CGS 120,A00,185511,Staff,13,0,20,7
1683328846407,CHEM 4,A01,184675,Bussey; Thomas J,96,0,100,4
1683328847431,CHEM 6A,A01,184677,Staff,34,0,60,26
1683328848458,CHEM 6B,A01,184679,Staff,65,0,100,35
1683328849483,CHEM 6C,A01,184681,Bussey; Thomas J,1,0,50,49
1683328849483,CHEM 6C,A02,184682,Bussey; Thomas J,34,0,50,16
1683328850507,CHEM 40A,A01,184684,Albizati; Kim F.,37,0,100,63
1683328851535,CHEM 40B,A01,184686,Albizati; Kim F.,0,20,100,100
1683328852561,CHEM 41B,A01,184690,Staff,52,0,100,48
1683328853587,COGS 3,A01,184715,Boyle; Mary E. T.,0,25,40,40
1683328854612,COGS 14B,A01,185172,Staff,0,15,38,38
1683328855636,COGS 18,A01,184736,Staff,17,0,80,63
1683328856660,COGS 100,A01,184932,Staff,0,5,73,73
1683328857688,COGS 101A,A01,184935,Staff,0,38,30,30
1683328858715,COGS 101B,A01,184944,Staff,0,2,30,30
1683328859742,COGS 101C,A01,184946,Staff,0,12,30,30
1683328860766,COGS 102A,A01,184951,Johnson; Christine M.,2,0,40,38
1683328861794,COGS 107B,A01,184953,Mooshagian; Eric Frederick,0,50,40,40
1683328862819,COGS 118B,A01,184959,Gupta; Anjum,0,48,40,40
1683328863846,COGS 153,A00,184961,Staff,0,15,30,30
1683328864870,COGS 177,A00,184962,Staff,0,20,30,30
1683328865895,COGS 187A,A01,184969,Boyle; Mary E. T.,0,17,40,40
1683328866920,COMM 10,A01,185174,Staff,0,5,25,25
1683328866920,COMM 10,A02,185189,Staff,0,5,25,25
1683328866920,COMM 10,A03,269821,Staff,0,0,0,0
1683328867945,COMM 100B,A01,185475,Staff,0,0,0,2
1683328867945,COMM 100B,A02,185476,Staff,14,0,25,11
1683328868969,COMM 100C,A01,185314,Staff,1,0,25,24
1683328868969,COMM 100C,A02,185327,Staff,19,0,25,6
1683328869993,COMM 110M,A00,185349,Staff,2,0,40,38
1683328871016,COMM 113T,A00,185352,Staff,24,0,40,16
1683328872040,COMM 114I,A00,185353,Staff,33,0,40,7
1683328873067,COMM 131,A00,185354,Staff,19,0,30,11
1683328874091,CSE 8A,A50,185358,Cao; Yingjun,0,46,10,10
1683328875116,CSE 8B,A01,185362,Staff,1,47,50,49
1683328876143,CSE 11,A01,185416,Cao; Yingjun,0,92,10,10
1683328877166,CSE 20,A01,185445,Briones; Jor-el Thomas Caparas,5,0,25,20
1683328878193,CSE 21,A01,185447,Staff,10,0,50,40
1683328879215,CSE 101,A01,185451,Staff,0,12,50,50
1683328879215,CSE 101,B01,185453,Jones; Miles E,0,11,50,50
1683328881265,CSE 141,A01,185458,Eldon; John,20,0,100,80
1683328882292,CSE 141L,A01,185461,Eldon; John,12,0,100,88
1683328883317,CSE 142,A01,185463,Staff,36,0,60,24
1683328883317,CSE 142,B01,201355,Staff,0,7,60,60
1683328884344,CSE 142L,A01,185470,Staff,36,0,60,24
1683328884344,CSE 142L,B01,201417,Staff,0,6,60,60
1683328885367,CSE 190,A00,201433,Staff,32,0,49,17
1683328886394,DOC 1,A01,259136,Strom; Megan C.,7,0,15,8
1683328886394,DOC 1,A02,259137,Strom; Megan C.,14,0,15,1
1683328886394,DOC 1,A03,259138,Strom; Megan C.,14,0,15,1
1683328886394,DOC 1,A04,259139,Strom; Megan C.,14,0,15,1
1683328887421,DOC 100D,A00,259140,Pass; Natalye Joann,16,0,25,9
1683328888448,DSGN 1,A01,184749,Rill; Bryan,0,26,30,30
1683328889475,DSGN 100,A01,185168,Staff,0,2,25,25
1683328890503,ECE 5,A01,185626,Morris; Karcher William,0,10,0,0
1683328891528,ECE 101,A01,185628,Staff,17,0,70,53
1683328892550,ECE 107,A01,185635,Baghdadchi; Saharnaz,0,0,20,20
1683328892550,ECE 107,A02,185638,Baghdadchi; Saharnaz,4,0,20,16
1683328893578,ECE 148,A01,185647,Silberman; Jack,0,0,16,16
1683328894603,ECON 1,A01,185537,Crane; Meredith Helen,54,0,70,16
1683328895629,ECON 3,A01,185549,Crane; Meredith Helen,33,0,70,37
1683328896656,ECON 4,A01,203354,Anderson; John Charles,0,4,10,10
1683328897678,ECON 100A,A01,185574,Staff,0,4,40,40
1683328898703,ECON 100B,A01,185576,Staff,10,22,50,40
1683328899729,ECON 100C,A01,185589,Newhouse; Herbert S,30,0,70,40
1683328900754,ECON 105,A00,185608,Vespa; Emanuel Ignacio,19,0,35,16
1683328901778,ECON 109,A01,185610,Shishkin; Denis,10,0,35,25
1683328902802,ECON 110A,A01,185612,Staff,11,0,40,29
1683328903826,ECON 120A,A01,185615,Staff,20,0,40,20
1683328904853,ECON 120C,A01,185617,Sun; Yixiao,0,20,70,70
1683328905880,ECON 144,A00,203346,Squires; Dale E,3,0,35,32
1683328906908,ECON 171,A01,203349,Newhouse; Herbert S,0,1,35,35
1683328907936,ECON 173A,A01,185621,Toda; Alexis Akira,21,0,35,14
1683328908961,EDS 25,A01,202413,Staff,0,1,0,0
1683328908961,EDS 25,A02,202414,Staff,0,1,0,0
1683328908961,EDS 25,A03,202415,Staff,0,0,0,0
1683328908961,EDS 25,A04,202416,Staff,0,1,0,0
1683328908961,EDS 25,A05,202439,Staff,0,0,0,0
1683328908961,EDS 25,A06,202440,Staff,0,0,0,0
1683328908961,EDS 25,B01,202631,Staff,0,0,0,0
1683328908961,EDS 25,B02,202632,Staff,0,0,0,0
1683328908961,EDS 25,B03,202639,Staff,0,0,0,0
1683328908961,EDS 25,B04,202640,Staff,0,0,0,0
1683328908961,EDS 25,B05,202643,Staff,0,0,0,0
1683328908961,EDS 25,B06,202644,Staff,0,0,0,0
1683328909986,EDS 38,A01,202659,Black; Alison Michelle,24,0,25,1
1683328911009,EDS 115,A00,202652,Staff,17,0,30,13
1683328912037,EDS 125,A00,202649,Staff,14,0,30,16
1683328913063,EDS 126,A01,203332,Staff,30,0,30,0
1683328914086,EDS 139,A00,202838,Staff,16,0,25,9
1683328915109,EDS 146,A01,202655,Staff,14,0,25,11
1683328916133,ENG 15,A00,185667,Staff,0,1,0,0
1683328916133,ENG 15,B00,185672,Staff,0,0,0,0
1683328916133,ENG 15,C00,185675,Staff,0,0,0,0
1683328916133,ENG 15,D00,185682,Staff,0,0,0,0
1683328916133,ENG 15,E00,185684,Staff,0,0,0,0
1683328917157,ETHN 103,A00,185710,Staff,0,3,35,35
1683328918183,ETHN 103A,A00,199228,Man; Simeon S,2,0,9,7
1683328919208,ETHN 109,A00,185711,Staff,18,0,35,17
1683328920231,ETHN 142,A00,185726,Staff,0,4,30,30
1683328921256,ETHN 163J,A00,199229,Man; Simeon S,5,0,8,3
1683328922283,ETHN 168,A00,185727,Staff,8,0,10,2
1683328923309,ETHN 182,A00,185728,Staff,1,0,35,34
1683328924336,ETHN 183,A00,185737,Staff,8,0,18,10
1683328925362,GLBH 111,A01,209361,Burgos; Jose L.,0,0,0,0
1683328927413,HIEU 104,A00,185792,Staff,16,0,20,4
1683328928442,HIEU 115,A00,185800,Staff,1,0,20,19
1683328929470,HIEU 128,A00,185801,Staff,0,7,20,20
1683328930498,HIEU 147,A00,185802,Staff,16,0,20,4
1683328931524,HIEU 154,A00,185823,Staff,12,0,20,8
1683328932553,HILA 102,A00,185826,Staff,13,0,20,7
1683328933577,HILD 2C,A01,185778,Staff,0,12,20,20
1683328934602,HILD 7B,A01,185780,Kwak; Nancy,0,15,32,32
1683328934602,HILD 7B,A02,185781,Kwak; Nancy,0,18,32,32
1683328935629,HILD 30,A01,185791,Staff,14,0,20,6
1683328936653,HISC 119,A00,185830,Golan; Tal,0,9,20,20
1683328937678,HITO 156GS,A00,185831,Patterson; Patrick H.,0,0,0,23
1683328938703,HIUS 103,A00,185832,Man; Simeon S,0,6,20,20
1683328939733,HIUS 117,A00,185836,Kwak; Nancy,2,0,20,18
1683328940758,HIUS 125,A00,185840,Man; Simeon S,0,0,23,23
1683328941785,HIUS 149,A00,185845,Staff,0,0,20,20
1683328942866,HUM 3,A01,185882,Zavodny; Tatiana Sophia,0,7,50,50
1683328942866,HUM 3,B01,185899,Caldwell; Michael Alan,0,18,50,50
1683328943890,HUM 3GS,A00,185900,Patterson; Patrick H.,0,0,0,23
1683328944919,HUM 4,A01,185938,Zroka; Amy Liane,31,0,50,19
1683328944919,HUM 4,B01,185956,Watkins; Eric,0,2,50,50
1683328944919,HUM 4,B02,202209,Watkins; Eric,0,2,50,50
1683328944919,HUM 4,B03,202210,Watkins; Eric,0,2,50,50
1683328945948,HUM 5,A01,185958,West; Geoffrey Scott,3,0,50,47
1683328945948,HUM 5,A02,202215,West; Geoffrey Scott,0,0,50,50
1683328946977,INTL 190,A00,185959,Gagnon; Jeffrey C,0,0,0,9
1683328946977,INTL 190,B00,185960,Lettieri; Michael Joseph,0,0,0,1
1683328948004,JAPN 180,A00,254509,Staff,5,1,30,25
1683328949033,LATI 10,A01,202853,Kennemore; Amy Michelle,4,0,35,31
1683328949033,LATI 10,A02,202854,Kennemore; Amy Michelle,2,0,35,33
1683328949033,LATI 10,A03,270054,Kennemore; Amy Michelle,30,0,30,0
1683328950058,LATI 180,A00,202855,Kennemore; Amy Michelle,11,0,20,9
1683328951082,LAWS 101,A00,201767,Golan; Tal,0,7,40,40
1683328952106,LIFR 1C,A00,185961,Staff,6,0,20,14
1683328953133,LIFR 1CX,A00,185962,Staff,7,0,20,13
1683328954159,LIFR 1D,A00,185963,Staff,9,0,20,11
1683328955182,LIFR 1DX,A00,185964,Staff,9,0,20,11
1683328956209,LIGN 101,A01,186039,Staff,43,0,50,7
1683328957232,LIGN 165,A00,186040,Staff,18,0,50,32
1683328958256,LTCS 108,A00,186041,Staff,6,0,10,4
1683328959280,LTCS 119,A00,186042,Staff,16,0,20,4
1683328960307,LTCS 130,A00,186043,Wesling; Megan E.,15,0,25,10
1683328962360,LTEA 138,A00,186119,Staff,14,0,40,26
1683328963383,LTEN 124,A00,186148,Staff,6,0,25,19
1683328964410,LTEN 178,A00,186149,Staff,7,0,15,8
1683328965435,LTEN 181,A00,186150,Blanco; John D,33,0,40,7
1683328966464,LTWL 120,A00,186160,Staff,20,0,25,5
1683328967490,LTWL 165,A00,186161,Staff,22,0,25,3
1683328968515,LTWR 100,A00,186162,Staff,0,5,15,15
1683328969542,LTWR 102,A00,186163,Doller; Ben,5,0,15,10
1683328970569,MAE 8,A01,186412,Staff,0,0,0,0
1683328971596,MAE 30B,A00,186445,Bahadori; Mohammad Yousef,83,0,100,17
1683328972619,MAE 40,A00,186592,Bewley; Thomas R,9,0,50,41
1683328973643,MAE 101B,A00,186593,Bahadori; Mohammad Yousef,81,0,100,19
1683328974667,MAE 105,A00,186594,Bandaru; Prabhakar,12,0,50,38
1683328975694,MAE 107,A00,186599,Pham; Hieu Tan,0,6,120,120
1683328976719,MAE 148,A01,186660,Silberman; Jack,3,0,16,13
1683328977743,MATH 10A,A01,188095,Staff,1,6,35,34
1683328978771,MATH 10B,A01,188097,Bowers; Adam R.,0,11,30,30
1683328978771,MATH 10B,A02,188099,Bowers; Adam R.,0,11,30,30
1683328978771,MATH 10B,B01,188104,Bowers; Adam R.,0,10,30,30
1683328978771,MATH 10B,B02,188106,Bowers; Adam R.,0,10,30,30
1683328979796,MATH 10C,A01,188111,Staff,0,18,30,30
1683328979796,MATH 10C,A02,188127,Staff,0,17,30,30
1683328979796,MATH 10C,A03,188131,Staff,0,18,30,30
1683328979796,MATH 10C,B01,188218,Staff,18,0,30,12
1683328979796,MATH 10C,B02,188244,Staff,13,0,30,17
1683328979796,MATH 10C,B03,188277,Staff,16,0,30,14
1683328980821,MATH 18,A01,188344,Bach; Quang Tran,18,0,30,12
1683328980821,MATH 18,A02,188345,Bach; Quang Tran,11,0,30,19
1683328980821,MATH 18,B01,188353,Bach; Quang Tran,10,0,30,20
1683328980821,MATH 18,B02,188354,Bach; Quang Tran,20,0,30,10
1683328981850,MATH 20A,A01,188374,Staff,13,0,35,22
1683328982876,MATH 20B,A01,188382,Ohm; Ko Woon,6,0,30,24
1683328982876,MATH 20B,A02,188383,Ohm; Ko Woon,22,0,30,8
1683328982876,MATH 20B,B01,188385,Ohm; Ko Woon,7,0,30,23
1683328982876,MATH 20B,B02,188392,Ohm; Ko Woon,22,0,30,8
1683328983901,MATH 20C,A01,188394,Harel; Guershon,10,0,30,20
1683328983901,MATH 20C,A02,188395,Harel; Guershon,15,0,30,15
1683328983901,MATH 20C,B01,188404,Harel; Guershon,5,0,30,25
1683328983901,MATH 20C,B02,188405,Harel; Guershon,19,0,30,11
1683328984926,MATH 20D,A01,188414,Hammock; Frances H,0,1,30,30
1683328984926,MATH 20D,A02,188415,Hammock; Frances H,2,0,30,28
1683328984926,MATH 20D,B01,188447,Hammock; Frances H,2,0,30,28
1683328984926,MATH 20D,B02,188486,Hammock; Frances H,8,0,30,22
1683328985955,MATH 20E,A01,188649,Staff,21,0,30,9
1683328985955,MATH 20E,A02,188650,Staff,23,0,30,7
1683328985955,MATH 20E,A03,188673,Staff,0,0,30,30
1683328986980,MATH 102,A01,188675,Staff,0,35,35,35
1683328988004,MATH 103B,A01,188681,Staff,3,0,35,32
1683328988004,MATH 103B,B01,188692,Staff,5,0,35,30
1683328989032,MATH 109,A01,188695,Salehi Golsefidy; Alireza,25,0,35,10
1683328989032,MATH 109,A02,188696,Salehi Golsefidy; Alireza,26,0,35,9
1683328990057,MATH 120A,A01,188698,Eggers; John Dietrich,7,0,35,28
1683328991082,MATH 142B,A01,188736,Ioana; Adrian,0,2,30,30
1683328991082,MATH 142B,A02,188741,Ioana; Adrian,1,1,30,29
1683328991082,MATH 142B,A03,188743,Ioana; Adrian,1,3,30,29
1683328992109,MATH 168A,A01,188790,Staff,0,9,35,35
1683328993136,MATH 170A,A01,188803,Nie; Jiawang,0,2,35,35
1683328993136,MATH 170A,A02,188811,Nie; Jiawang,0,0,35,35
1683328993136,MATH 170A,A03,188814,Nie; Jiawang,1,0,35,34
1683328993136,MATH 170A,A04,188815,Nie; Jiawang,13,0,35,22
1683328994163,MATH 193B,A01,188817,Staff,0,0,35,35
1683328994163,MATH 193B,A02,188818,Staff,5,0,35,30
1683328995190,MGT 4,A01,202857,Anderson; John Charles,62,0,80,18
1683328996213,MGT 12,A00,202858,Lindenberger; Wade Douglas,42,0,90,48
1683328997238,MGT 18,A00,202859,Staff,74,0,90,16
1683328998264,MGT 18GS,A00,202860,McKay; Michael J,13,0,28,15
1683328999288,MGT 45,A00,202861,Pecore; Joseph P.,13,0,90,77
1683329000318,MGT 100,A00,202863,Yavorsky; Daniel Ryan,28,0,90,62
1683329001343,MGT 103,A00,202864,Ehrich; Kristine R,1,18,90,89
1683329002368,MGT 112,A00,202865,Ehrich; Kristine R,15,0,90,75
1683329003396,MGT 121A,A00,202868,Staff,0,20,0,0
1683329004423,MGT 131B,A00,202869,Anderson; John Charles,59,0,90,31
1683329005446,MGT 136,A00,202871,Lindenberger; Wade Douglas,84,0,90,6
1683329006473,MGT 164,A00,202873,Staff,0,68,90,91
1683329007502,MGT 164GS,A00,202874,McKay; Mary A,13,0,28,15
1683329008526,MGT 180,A00,202875,Staff,0,50,90,91
1683329009554,MMW 11R,A01,205019,Herbst; Matthew,3,0,30,27
1683329009554,MMW 11R,A02,205026,Herbst; Matthew,29,0,30,1
1683329010580,MMW 15,A01,193512,Chang; Edmond Yi-Teh,0,9,28,28
1683329010580,MMW 15,A02,193513,Chang; Edmond Yi-Teh,0,5,28,28
1683329010580,MMW 15,A03,193514,Chang; Edmond Yi-Teh,0,5,28,28
1683329010580,MMW 15,A04,193515,Chang; Edmond Yi-Teh,0,5,28,28
1683329010580,MMW 15,A05,193516,Chang; Edmond Yi-Teh,0,4,28,28
1683329010580,MMW 15,A06,193517,Chang; Edmond Yi-Teh,0,5,28,28
1683329010580,MMW 15,B01,193519,Chang; Edmond Yi-Teh,0,5,28,28
1683329010580,MMW 15,B02,193520,Chang; Edmond Yi-Teh,0,5,28,28
1683329010580,MMW 15,B03,193521,Chang; Edmond Yi-Teh,0,5,28,28
1683329010580,MMW 15,B04,193522,Chang; Edmond Yi-Teh,0,4,28,28
1683329010580,MMW 15,B05,193523,Chang; Edmond Yi-Teh,0,5,28,28
1683329010580,MMW 15,B06,193524,Chang; Edmond Yi-Teh,0,4,28,28
1683329011605,MMW 122,A01,193526,Rahimi; Babak,0,15,28,28
1683329011605,MMW 122,A02,193527,Rahimi; Babak,0,14,28,28
1683329011605,MMW 122,A03,193528,Rahimi; Babak,0,0,0,0
1683329011605,MMW 122,A04,193529,Rahimi; Babak,0,0,0,0
1683329012632,MUS 1A,A01,186663,Staff,0,20,35,35
1683329013660,MUS 4,A01,186715,Staff,0,12,35,35
1683329014684,MUS 5R,A01,186796,Dubnov; Shlomo,0,17,35,35
1683329015707,MUS 6,A01,186798,Staff,0,4,25,25
1683329016734,MUS 7,A01,186830,Staff,12,0,35,23
1683329017759,MUS 8,A01,186930,Staff,0,27,35,35
1683329018785,MUS 15,A01,186932,Staff,0,16,35,35
1683329018785,MUS 15,B01,186934,Staff,0,15,35,35
1683329019808,MUS 80,A00,186935,Staff,1,0,20,19
1683329019808,MUS 80,B00,186936,Staff,25,0,25,0
1683329020836,NANO 11,A00,204702,Lipomi; Darren John,0,0,0,0
1683329021864,NANO 15,A01,204709,Yang; Kesong,0,1,0,0
1683329022889,NANO 114,A00,202069,Jahed Motlagh; Zeinab,3,0,10,7
1683329023917,PHIL 1,A00,186955,Grush; Rick Scott,32,0,40,8
1683329024946,PHIL 10,A01,186973,Grush; Rick Scott,28,0,35,7
1683329024946,PHIL 10,A02,186974,Grush; Rick Scott,33,0,35,2
1683329025970,PHIL 13,A01,186976,Staff,7,0,35,28
1683329025970,PHIL 13,A02,186977,Staff,16,0,35,19
1683329026996,PHIL 14,A01,186979,Staff,31,0,35,4
1683329026996,PHIL 14,A02,186986,Staff,32,0,35,3
1683329028021,PHIL 28,A01,186988,Staff,16,0,30,14
1683329028021,PHIL 28,A02,186989,Staff,1,0,30,29
1683329028021,PHIL 28,A03,186990,Staff,9,0,30,21
1683329028021,PHIL 28,A04,186991,Staff,26,0,30,4
1683329029048,PHIL 120,A00,186997,Staff,23,0,40,17
1683329030072,PHIL 137,A00,187003,Staff,9,0,40,31
1683329031096,PHIL 150,A00,187015,Staff,47,0,70,23
1683329032121,PHIL 167,A00,187021,Lamey; Andy M.,35,0,40,5
1683329033146,PHIL 174,A01,202226,Staff,17,0,20,3
1683329033146,PHIL 174,A02,202235,Staff,20,0,20,0
1683329034173,PHIL 191A,A00,258918,Staff,0,0,1,1
1683329035197,PHYS 1A,A00,187028,Staff,27,0,60,33
1683329036221,PHYS 1AL,001,187036,Staff,3,0,30,27
1683329036221,PHYS 1AL,002,187049,Staff,18,0,30,12
1683329037245,PHYS 1B,A00,187058,Staff,22,0,60,38
1683329038268,PHYS 1BL,001,187064,Staff,0,0,30,30
1683329038268,PHYS 1BL,002,187070,Staff,5,0,30,25
1683329039295,PHYS 1C,A00,187082,Staff,31,0,120,89
1683329040323,PHYS 1CL,001,187088,Staff,0,9,30,30
1683329040323,PHYS 1CL,002,187089,Staff,0,2,30,30
1683329040323,PHYS 1CL,009,262693,Staff,11,0,30,19
1683329041350,PHYS 2B,A01,187097,Staff,54,0,115,61
1683329042378,PHYS 2C,A01,187099,Staff,67,0,115,48
1683329043403,PHYS 2CL,A01,187101,Staff,5,0,28,23
1683329043403,PHYS 2CL,A02,187102,Staff,15,0,28,13
1683329044428,PHYS 2D,A01,187123,Shotwell; Brian,95,0,115,20
1683329045452,PHYS 4B,A01,187133,Grinstein; Benjamin,35,0,50,15
1683329046535,POLI 10,A00,188819,Staff,0,4,50,50
1683329047559,POLI 11,A00,188827,Staff,43,0,50,7
1683329048585,POLI 13R,A00,188828,Staff,0,1,20,20
1683329049610,POLI 27,A01,188830,Elgin; Samuel Zincke,0,1,70,70
1683329050637,POLI 30,A00,188832,Desposato; Scott,31,0,50,19
1683329051661,POLI 102F,A00,188834,Staff,3,0,40,37
1683329052686,POLI 104A,A00,188852,Staff,14,0,30,16
1683329053711,POLI 104I,A00,188853,Staff,0,6,20,20
1683329054735,POLI 110B,A00,188854,Wiens; David,7,0,20,13
1683329055758,POLI 112A,A00,188855,Wiens; David,5,0,30,25
1683329056786,POLI 117R,A00,188856,Forman; Fonna,0,11,20,20
1683329057810,POLI 118,A00,188857,Ingham; Sean,8,0,20,12
1683329058837,POLI 120G,A00,188858,Staff,9,0,30,21
1683329059862,POLI 131CR,A00,188863,Hoston; Germaine,24,0,50,26
1683329060887,POLI 133,A00,188864,Nellis; Gareth Hb,44,0,50,6
1683329061916,POLI 134D,A00,188865,Desposato; Scott,27,0,30,3
1683329062942,POLI 142A,A00,188871,Gartzke; Erik,22,0,50,28
1683329063969,POLI 142K,A00,188874,Staff,38,0,50,12
1683329064994,POLI 143,A00,188940,Gartzke; Erik,16,0,30,14
1683329066021,POLI 153,A00,188943,Staff,3,0,20,17
1683329067048,POLI 160AA,A00,188944,Staff,12,0,40,28
1683329068076,POLI 170A,A00,188945,Staff,11,0,30,19
1683329070125,PSYC 1,A00,188952,Staff,37,0,90,53
1683329071149,PSYC 2,B00,188953,Staff,19,0,35,16
1683329072177,PSYC 6,A00,188970,Staff,47,0,60,13
1683329073202,PSYC 7,A00,188973,Staff,37,0,45,8
1683329074229,PSYC 60,A01,188980,Rickard; Timothy C.,43,0,60,17
1683329075256,PSYC 70,A01,189001,Steiner; Eric Tomas,24,0,45,21
1683329076280,PSYC 100,A00,189005,Lacefield; Katharine I,0,100,120,120
1683329077306,PSYC 102,A00,189008,Staff,9,0,30,21
1683329078331,PSYC 106,B00,189026,Gorman; Michael R.,34,0,60,26
1683329079360,PSYC 114,B01,189033,Winkielman; Piotr,0,32,30,30
1683329080384,PSYC 131,A00,189036,Anagnostaras; Stephan,0,43,60,60
1683329081413,PSYC 136,A00,189041,Lowe; Angela Beth,0,7,25,25
1683329082440,PSYC 137,A00,189057,Winkielman; Piotr,0,34,25,25
1683329083464,PSYC 144,A00,189107,Wixted; John T,0,7,50,50
1683329085521,PSYC 162,A00,189142,Staff,0,8,85,85
1683329086546,PSYC 172,A00,189144,Gorman; Michael R.,0,7,30,30
1683329088601,PSYC 179,A00,189146,Lacefield; Katharine I,0,84,120,120
1683329089625,PSYC 181,A00,189147,Anagnostaras; Stephan,0,44,90,90
1683329090651,PSYC 190R,A00,189148,Barner; David A.,0,22,80,80
1683329091676,PSYC 191,A00,189275,Rickard; Timothy C.,0,7,25,25
1683329092703,PSYC 193,A00,189276,Chapman; Eddie Nathaniel,0,1,0,4
1683329093729,PSYC 193L,A01,189281,Lowe; Angela Beth,12,0,20,8
1683329093729,PSYC 193L,B01,189285,Staff,28,0,35,7
1683329094752,RELI 149,A00,187137,Rahimi; Babak,7,0,40,33
1683329095776,SE 9,A01,187315,Staff,0,2,18,18
1683329096800,SE 101B,A00,187409,Staff,24,0,30,6
1683329097828,SE 110B,A00,187444,Staff,10,0,40,30
1683329098855,SE 130B,A00,187449,Staff,31,0,40,9
1683329099880,SE 150A,A00,187516,Staff,9,0,20,11
1683329100905,SE 154,A00,187528,Staff,30,0,50,20
1683329101944,SIO 3,A01,258171,Staff,35,0,40,5
1683329102974,SIO 10,A00,187144,Cook; Geoffrey W,0,3,75,75
1683329103997,SIO 45,A00,187152,Cook; Geoffrey W,1,0,100,99
1683329105025,SIO 109R,A00,194486,Staff,0,3,20,20
1683329107077,SIO 187,A01,187233,Kacev; David,12,0,40,28
1683329108111,SOCI 1,A01,258656,Thorpe; Charles Robert,28,0,30,2
1683329108111,SOCI 1,A02,258658,Thorpe; Charles Robert,30,0,30,0
1683329108111,SOCI 1,A03,258661,Thorpe; Charles Robert,25,0,25,0
1683329108111,SOCI 1,A04,258666,Thorpe; Charles Robert,22,0,25,3
1683329108111,SOCI 1,A05,258897,Thorpe; Charles Robert,23,0,25,2
1683329108111,SOCI 1,A06,258898,Thorpe; Charles Robert,25,0,25,0
1683329109134,SOCI 30,A01,258903,Pardo Guerra; Juan Pablo,15,0,30,15
1683329110160,SOCI 102,A00,258904,Staff,9,0,25,16
1683329111185,SOCI 106,A00,258905,Staff,19,0,25,6
1683329112209,SOCI 111,A00,258907,Ribas Norris; Janet Vanesa,26,0,30,4
1683329113233,SOCI 121R,A00,258908,Pardo Guerra; Juan Pablo,10,0,30,20
1683329114256,SOCI 126,A01,203330,Staff,14,0,20,6
1683329115283,SOCI 131,A00,258909,Thorpe; Charles Robert,31,0,60,29
1683329116306,SOCI 135,A00,258910,Payne; Christine Anna,0,9,30,30
1683329117329,SOCI 157,A00,258911,Staff,12,0,30,18
1683329118357,SOCI 184,A00,258912,Staff,25,0,30,5
1683329119381,SOCI 188D,A00,258913,Staff,21,0,30,9
1683329120405,SYN 2,001,187529,Staff,10,0,16,6
1683329120405,SYN 2,002,201452,Staff,0,18,16,16
1683329120405,SYN 2,003,201469,Staff,3,0,16,13
1683329121430,SYN 100,A01,187531,Staff,0,9,20,20
1683329121430,SYN 100,B01,201491,Staff,0,12,20,20
1683329122454,TDAC 1,A00,189286,Walsh; Kim C.,3,0,20,17
1683329122454,TDAC 1,B00,189287,Harting; Carla Kelso,11,0,20,9
1683329123479,TDAC 101,A00,189300,Walsh; Kim C.,16,0,20,4
1683329123479,TDAC 101,B00,189301,Harting; Carla Kelso,18,0,20,2
1683329124506,TDAC 102,A00,189304,Basso; Beatrice,14,0,20,6
1683329125530,TDAC 108,A00,189305,Staff,18,0,20,2
1683329126555,TDDE 131,A00,189310,Staff,19,0,20,1
1683329126555,TDDE 131,B00,189314,Staff,19,0,20,1
1683329126555,TDDE 131,C00,189315,Staff,48,0,50,2
1683329126555,TDDE 131,D00,189316,Staff,14,0,15,1
1683329126555,TDDE 131,E00,204841,Staff,20,0,20,0
1683329127579,TDGE 10,A00,189289,Staff,30,0,50,20
1683329127579,TDGE 10,B00,189290,Havis; Allan,1,0,50,49
1683329128604,TDGE 11,A00,189291,Fulton; Julia,0,3,50,50
1683329128604,TDGE 11,B00,189292,Staff,20,0,25,5
1683329128604,TDGE 11,C00,260270,Staff,0,0,0,0
1683329129628,TDGE 25,A00,189294,Staff,3,0,20,17
1683329130654,TDGE 124,A00,189318,Fulton; Julia,0,8,50,50
1683329131681,TDGE 125,A00,189319,Staff,13,0,25,12
1683329131681,TDGE 125,B00,189320,Staff,23,0,25,2
1683329132707,TDGE 127,A00,189322,Havis; Allan,0,0,50,50
1683329133730,TDHT 101,A00,189323,Staff,18,0,25,7
1683329133730,TDHT 101,B00,189324,Staff,25,0,25,0
1683329134754,TDHT 102,A00,189325,Staff,49,0,50,1
1683329135778,TDMV 1,A00,189295,Arcidiacono; Kristin,19,0,30,11
1683329135778,TDMV 1,B00,189296,Caligagan; Maria T.,24,0,30,6
1683329136802,TDMV 2,A00,189297,Sammartano; Tonnie,28,0,30,2
1683329136802,TDMV 2,B00,189299,Arcidiacono; Kristin,24,0,30,6
1683329137828,TDMV 3,A00,204998,Rincon; Alicia,22,0,30,8
1683329138853,TDMV 120,A00,189458,Sammartano; Tonnie,28,0,30,2
1683329139880,TDMV 138,A00,189541,Jun; Grace Shin Hae,22,0,40,18
1683329140904,TDMV 142,A00,189717,Caligagan; Tony,23,0,30,7
1683329140904,TDMV 142,B00,189718,Caligagan; Maria T.,25,0,30,5
1683329141929,TMC 2,A01,187533,Staff,25,0,25,0
1683329141929,TMC 2,A02,187534,Staff,25,0,25,0
1683329142957,USP 1,A01,187536,Kwak; Nancy,0,16,25,25
1683329143984,USP 5,A01,187538,Staff,10,0,25,15
1683329145009,USP 101,A00,199253,Staff,0,4,0,0
1683329146035,USP 124,A00,187562,Boomhower; Matthew Charles,1,0,30,29
1683329147062,USP 138,A00,187582,Staff,20,0,25,5
1683329148089,USP 152,A01,187597,Staff,4,0,25,21
1683329149115,USP 153,A00,187598,Staff,19,0,25,6
1683329150199,USP 168,A00,187607,Kwak; Nancy,2,0,5,3
1683329151223,USP 173,A00,187619,Staff,4,0,25,21
1683329152245,USP 181,A00,187638,Staff,0,0,25,25
1683329153269,VIS 103,A00,187650,Cruz; Edwin Teddy,23,0,75,52
1683329154293,VIS 110D,A00,187669,Staff,12,0,22,10
1683329155317,VIS 127C,A00,187720,Shen; Kuiyi,67,0,146,79
1683329156345,VIS 149,A00,187731,Yoldas; Pinar,0,14,22,22
1683329157372,VIS 151,A01,188091,Staff,22,0,34,12
1683329157372,VIS 151,A02,188092,Staff,11,0,34,23
1683329158398,VIS 160B,A00,188093,Stalbaum; Brett,0,0,10,10
1683329160453,WCWP 10B,A00,201720,Staff,10,0,15,5
1683329160453,WCWP 10B,B00,201722,Staff,8,0,15,7
1683329161480,WCWP 100,A00,201725,Gagnon; Jeffrey C,0,0,2,2
1683329161480,WCWP 100,B00,201727,Staff,0,4,15,15
1683329164611,ANBI 133,A00,258401,Wilder; Linnea Lorene,34,0,40,6
1683329165635,ANBI 140,A00,258395,Hrvoj Mihic; Branka,18,0,25,7
1683329166664,ANSC 120,A00,258402,Bialecki; Jon Anthony,27,0,40,13
1683329167691,ANSC 144,A00,258400,Staff,14,0,40,26
1683329169745,ANSC 166,A00,258396,Parish; Steven Martin,157,0,175,18
1683329170773,ANSC 180,A00,193533,Staff,9,0,20,11
1683329171799,ANSC 188,A00,258397,Jassal; Aftab,33,0,40,7
1683329172823,ANTH 3,A01,258316,Staff,23,0,30,7
1683329173850,ANTH 5,A00,258394,Semendeferi; Ekaterini,16,0,20,4
1683329174879,ANTH 21,A01,258331,Staff,8,0,40,32
1683329175904,ANTH 103,A00,258398,Varma; Saiba,15,0,25,10
1683329176937,AWP 10,001,202034,Staff,0,0,0,0
1683329176937,AWP 10,002,202035,Staff,0,0,0,0
1683329176937,AWP 10,003,202036,Staff,0,0,0,0
1683329176937,AWP 10,004,202037,Staff,0,0,0,0
1683329176937,AWP 10,005,202038,Staff,0,0,0,0
1683329176937,AWP 10,006,202039,Staff,0,0,0,0
1683329176937,AWP 10,007,202040,Staff,0,0,0,0
1683329176937,AWP 10,008,202041,Staff,0,0,0,0
1683329176937,AWP 10,009,202042,Staff,0,0,0,0
1683329176937,AWP 10,010,202043,Staff,0,0,0,0
1683329176937,AWP 10,011,202044,Staff,0,0,0,0
1683329176937,AWP 10,012,202045,Staff,0,0,0,0
1683329176937,AWP 10,013,202046,Staff,0,0,0,0
1683329176937,AWP 10,014,202047,Staff,0,0,0,0
1683329176937,AWP 10,015,202048,Staff,0,0,0,0
1683329176937,AWP 10,016,202049,Staff,0,0,0,0
1683329176937,AWP 10,017,202050,Staff,0,0,0,0
1683329176937,AWP 10,018,202051,Staff,0,0,0,0
1683329176937,AWP 10,019,202052,Staff,0,0,0,0
1683329176937,AWP 10,020,202053,Staff,0,0,0,0
1683329176937,AWP 10,021,202054,Staff,0,0,0,0
1683329176937,AWP 10,022,202055,Staff,0,0,0,0
1683329176937,AWP 10,023,202056,Staff,0,0,0,0
1683329176937,AWP 10,024,202057,Staff,0,0,0,0
1683329176937,AWP 10,025,202058,Staff,0,0,0,0
1683329176937,AWP 10,026,202059,Staff,0,0,0,0
1683329177964,AWP 102,001,202032,Staff,0,0,0,0
1683329177964,AWP 102,002,202033,Staff,0,0,0,0
1683329178990,BENG 100,A01,254234,Taylor Amos; Alyssa C,31,0,40,9
1683329180016,BENG 196,001,270013,Engler; Adam J.,9999,0,9999,0
1683329181042,BICD 100R,A01,202018,Smith; Laurie,0,7,32,32
1683329181042,BICD 100R,A02,202019,Smith; Laurie,0,2,32,32
1683329181042,BICD 100R,A03,202020,Smith; Laurie,0,1,32,32
1683329181042,BICD 100R,A04,202021,Smith; Laurie,9,0,32,23
1683329181042,BICD 100R,A05,202022,Smith; Laurie,12,0,32,20
1683329182071,BICD 136,A01,193242,Gustafson-Brown; Cindy,0,2,32,32
1683329182071,BICD 136,A02,193244,Gustafson-Brown; Cindy,14,0,32,18
1683329183097,BIEB 102,A01,193249,Butler; Shannon Rhey,0,2,32,32
1683329183097,BIEB 102,A02,193251,Butler; Shannon Rhey,0,0,32,32
1683329183097,BIEB 102,A03,193253,Butler; Shannon Rhey,0,1,32,32
1683329183097,BIEB 102,A04,193255,Butler; Shannon Rhey,17,0,32,15
1683329183097,BIEB 102,A05,193265,Butler; Shannon Rhey,26,0,32,6
1683329183097,BIEB 102,A06,193269,Butler; Shannon Rhey,16,0,32,16
1683329185148,BIEB 150,A01,193274,Staff,0,0,32,32
1683329185148,BIEB 150,A02,193285,Staff,23,0,32,9
1683329186171,BIEB 194,A00,193286,Kurle; Carolyn M.,22,0,32,10
1683329187201,BILD 1,A01,192291,Staff,16,0,32,16
1683329187201,BILD 1,A02,192292,Staff,30,0,32,2
1683329187201,BILD 1,B01,192520,Reuther; Keefe,0,1,0,0
1683329187201,BILD 1,B02,192532,Reuther; Keefe,0,1,0,0
1683329188226,BILD 3,A01,192556,Butler; Shannon Rhey,0,0,32,32
1683329188226,BILD 3,A02,192581,Butler; Shannon Rhey,5,0,32,27
1683329188226,BILD 3,A03,192611,Butler; Shannon Rhey,23,0,32,9
1683329188226,BILD 3,A04,192612,Butler; Shannon Rhey,25,0,32,7
1683329188226,BILD 3,A05,192613,Butler; Shannon Rhey,27,0,32,5
1683329188226,BILD 3,A06,192679,Butler; Shannon Rhey,27,0,32,5
1683329188226,BILD 3,A07,192682,Butler; Shannon Rhey,22,0,32,10
1683329189255,BILD 4,A01,192836,Reuther; Keefe,0,0,24,24
1683329189255,BILD 4,A02,193044,Reuther; Keefe,4,0,24,20
1683329190284,BILD 10,A01,193142,Gustafson-Brown; Cindy,30,0,32,2
1683329190284,BILD 10,A02,193149,Gustafson-Brown; Cindy,31,0,32,1
1683329191309,BIMM 100,A01,193301,Staff,0,6,32,32
1683329191309,BIMM 100,A02,193312,Staff,0,5,32,32
1683329191309,BIMM 100,A03,193323,Staff,0,8,32,32
1683329192336,BIMM 101,A01,193329,McDonnell; Lisa Marie,0,3,24,24
1683329192336,BIMM 101,A02,193339,McDonnell; Lisa Marie,0,3,24,24
1683329192336,BIMM 101,B01,193354,McDonnell; Lisa Marie,0,3,24,24
1683329192336,BIMM 101,B02,193357,McDonnell; Lisa Marie,0,3,24,24
1683329193364,BIMM 110,A01,193377,Tat; John,0,11,32,32
1683329193364,BIMM 110,A02,193378,Tat; John,1,9,32,31
1683329194392,BIMM 120,A01,206116,Staff,0,0,32,32
1683329194392,BIMM 120,A02,206117,Staff,8,0,32,24
1683329194392,BIMM 120,A03,206121,Staff,21,0,32,11
1683329195422,BIPN 100,A01,193393,Park; Ji Young,0,14,32,32
1683329195422,BIPN 100,A02,193402,Park; Ji Young,0,13,32,32
1683329195422,BIPN 100,A03,193413,Park; Ji Young,0,14,32,32
1683329195422,BIPN 100,A04,193414,Park; Ji Young,0,13,32,32
1683329196448,BIPN 102,A01,193429,Staff,0,0,32,32
1683329196448,BIPN 102,A02,193438,Staff,22,0,32,10
1683329197472,BIPN 106,A01,193450,Reyes Gonzalez; Catalina,0,2,40,40
1683329198504,BIPN 134,A01,193465,Cooke; James Edward,0,0,32,32
1683329198504,BIPN 134,A02,193474,Cooke; James Edward,25,0,32,7
1683329198504,BIPN 134,A03,193485,Cooke; James Edward,29,0,32,3
1683329198504,BIPN 134,A04,193486,Cooke; James Edward,21,0,32,11
1683329198504,BIPN 134,A05,193491,Cooke; James Edward,31,0,32,1
1683329198504,BIPN 134,A06,193501,Cooke; James Edward,30,0,32,2
1683329198504,BIPN 134,A07,193510,Cooke; James Edward,29,0,32,3
1683329200556,BISP 194,A00,222522,Staff,14,0,32,18
1683329201584,CAT 124,A01,202407,Staff,20,0,25,5
1683329202609,CAT 125,A00,202408,Marchisotto; Jennifer Anne,4,0,20,16
1683329203637,CAT 125R,A00,202409,Smith; Lauryn Alissa,0,11,20,20
1683329203637,CAT 125R,B00,202410,Morales; Celeste Georgianna,0,11,20,20
1683329203637,CAT 125R,C00,202411,Irwin; Matthew Joseph,0,10,20,20
1683329204664,CENG 15,A01,204712,Yang; Kesong,0,1,0,0
1683329205692,CENG 114,A00,202070,Jahed Motlagh; Zeinab,5,0,20,15
1683329206716,CGS 105,A00,185477,Wesling; Megan E.,24,0,40,16
1683329207743,CGS 106,A00,185494,Staff,13,0,22,9
1683329208770,CGS 108,A00,185495,Staff,14,0,20,6
1683329209796,CGS 114,A00,185496,Staff,13,0,18,5
1683329210819,CGS 119,A00,185501,Staff,15,0,20,5
1683329211843,CGS 120,A00,185511,Staff,13,0,20,7
1683329212869,CHEM 4,A01,184675,Bussey; Thomas J,96,0,100,4
1683329213896,CHEM 6A,A01,184677,Staff,34,0,60,26
1683329214920,CHEM 6B,A01,184679,Staff,65,0,100,35
1683329215948,CHEM 6C,A01,184681,Bussey; Thomas J,1,0,50,49
1683329215948,CHEM 6C,A02,184682,Bussey; Thomas J,34,0,50,16
1683329216976,CHEM 40A,A01,184684,Albizati; Kim F.,37,0,100,63
1683329218004,CHEM 40B,A01,184686,Albizati; Kim F.,0,20,100,100
1683329219031,CHEM 41B,A01,184690,Staff,52,0,100,48
1683329220055,COGS 3,A01,184715,Boyle; Mary E. T.,0,25,40,40
1683329221082,COGS 14B,A01,185172,Staff,0,15,38,38
1683329222107,COGS 18,A01,184736,Staff,17,0,80,63
1683329223136,COGS 100,A01,184932,Staff,0,5,73,73
1683329224161,COGS 101A,A01,184935,Staff,0,38,30,30
1683329225189,COGS 101B,A01,184944,Staff,0,2,30,30
1683329226213,COGS 101C,A01,184946,Staff,0,12,30,30
1683329227239,COGS 102A,A01,184951,Johnson; Christine M.,2,0,40,38
1683329228265,COGS 107B,A01,184953,Mooshagian; Eric Frederick,0,50,40,40
1683329229290,COGS 118B,A01,184959,Gupta; Anjum,0,48,40,40
1683329230316,COGS 153,A00,184961,Staff,0,15,30,30
1683329231340,COGS 177,A00,184962,Staff,0,20,30,30
1683329232368,COGS 187A,A01,184969,Boyle; Mary E. T.,0,17,40,40
1683329233395,COMM 10,A01,185174,Staff,0,5,25,25
1683329233395,COMM 10,A02,185189,Staff,0,5,25,25
1683329233395,COMM 10,A03,269821,Staff,0,0,0,0
1683329234425,COMM 100B,A01,185475,Staff,0,0,0,2
1683329234425,COMM 100B,A02,185476,Staff,14,0,25,11
1683329235452,COMM 100C,A01,185314,Staff,1,0,25,24
1683329235452,COMM 100C,A02,185327,Staff,19,0,25,6
1683329236476,COMM 110M,A00,185349,Staff,2,0,40,38
1683329237503,COMM 113T,A00,185352,Staff,24,0,40,16
1683329238531,COMM 114I,A00,185353,Staff,33,0,40,7
1683329239558,COMM 131,A00,185354,Staff,19,0,30,11
1683329240587,CSE 8A,A50,185358,Cao; Yingjun,0,46,10,10
1683329241613,CSE 8B,A01,185362,Staff,1,47,50,49
1683329242637,CSE 11,A01,185416,Cao; Yingjun,0,92,10,10
1683329243662,CSE 20,A01,185445,Briones; Jor-el Thomas Caparas,5,0,25,20
1683329244689,CSE 21,A01,185447,Staff,10,0,50,40
1683329245716,CSE 101,A01,185451,Staff,0,12,50,50
1683329245716,CSE 101,B01,185453,Jones; Miles E,0,11,50,50
1683329247770,CSE 141,A01,185458,Eldon; John,20,0,100,80
1683329248795,CSE 141L,A01,185461,Eldon; John,12,0,100,88
1683329249819,CSE 142,A01,185463,Staff,36,0,60,24
1683329249819,CSE 142,B01,201355,Staff,0,7,60,60
1683329250847,CSE 142L,A01,185470,Staff,36,0,60,24
1683329250847,CSE 142L,B01,201417,Staff,0,6,60,60
1683329251874,CSE 190,A00,201433,Staff,32,0,49,17
1683329252902,DOC 1,A01,259136,Strom; Megan C.,7,0,15,8
1683329252902,DOC 1,A02,259137,Strom; Megan C.,14,0,15,1
1683329252902,DOC 1,A03,259138,Strom; Megan C.,14,0,15,1
1683329252902,DOC 1,A04,259139,Strom; Megan C.,14,0,15,1
1683329253985,DOC 100D,A00,259140,Pass; Natalye Joann,16,0,25,9
1683329255013,DSGN 1,A01,184749,Rill; Bryan,0,25,30,30
1683329256037,DSGN 100,A01,185168,Staff,0,2,25,25
1683329257064,ECE 5,A01,185626,Morris; Karcher William,0,10,0,0
1683329258087,ECE 101,A01,185628,Staff,17,0,70,53
1683329259115,ECE 107,A01,185635,Baghdadchi; Saharnaz,0,0,20,20
1683329259115,ECE 107,A02,185638,Baghdadchi; Saharnaz,4,0,20,16
1683329260140,ECE 148,A01,185647,Silberman; Jack,0,0,16,16
1683329261163,ECON 1,A01,185537,Crane; Meredith Helen,54,0,70,16
1683329262191,ECON 3,A01,185549,Crane; Meredith Helen,33,0,70,37
1683329263217,ECON 4,A01,203354,Anderson; John Charles,0,4,10,10
1683329264245,ECON 100A,A01,185574,Staff,0,4,40,40
1683329265273,ECON 100B,A01,185576,Staff,10,22,50,40
1683329266300,ECON 100C,A01,185589,Newhouse; Herbert S,30,0,70,40
1683329267324,ECON 105,A00,185608,Vespa; Emanuel Ignacio,19,0,35,16
1683329268348,ECON 109,A01,185610,Shishkin; Denis,10,0,35,25
1683329269372,ECON 110A,A01,185612,Staff,11,0,40,29
1683329270398,ECON 120A,A01,185615,Staff,20,0,40,20
1683329271423,ECON 120C,A01,185617,Sun; Yixiao,0,20,70,70
1683329272449,ECON 144,A00,203346,Squires; Dale E,3,0,35,32
1683329273477,ECON 171,A01,203349,Newhouse; Herbert S,0,1,35,35
1683329274505,ECON 173A,A01,185621,Toda; Alexis Akira,21,0,35,14
1683329275530,EDS 25,A01,202413,Staff,0,1,0,0
1683329275530,EDS 25,A02,202414,Staff,0,1,0,0
1683329275530,EDS 25,A03,202415,Staff,0,0,0,0
1683329275530,EDS 25,A04,202416,Staff,0,1,0,0
1683329275530,EDS 25,A05,202439,Staff,0,0,0,0
1683329275530,EDS 25,A06,202440,Staff,0,0,0,0
1683329275530,EDS 25,B01,202631,Staff,0,0,0,0
1683329275530,EDS 25,B02,202632,Staff,0,0,0,0
1683329275530,EDS 25,B03,202639,Staff,0,0,0,0
1683329275530,EDS 25,B04,202640,Staff,0,0,0,0
1683329275530,EDS 25,B05,202643,Staff,0,0,0,0
1683329275530,EDS 25,B06,202644,Staff,0,0,0,0
1683329276554,EDS 38,A01,202659,Black; Alison Michelle,24,0,25,1
1683329277580,EDS 115,A00,202652,Staff,17,0,30,13
1683329278605,EDS 125,A00,202649,Staff,14,0,30,16
1683329279631,EDS 126,A01,203332,Staff,30,0,30,0
1683329280657,EDS 139,A00,202838,Staff,16,0,25,9
1683329281683,EDS 146,A01,202655,Staff,14,0,25,11
1683329282712,ENG 15,A00,185667,Staff,0,1,0,0
1683329282712,ENG 15,B00,185672,Staff,0,0,0,0
1683329282712,ENG 15,C00,185675,Staff,0,0,0,0
1683329282712,ENG 15,D00,185682,Staff,0,0,0,0
1683329282712,ENG 15,E00,185684,Staff,0,0,0,0
1683329283735,ETHN 103,A00,185710,Staff,0,3,35,35
1683329284759,ETHN 103A,A00,199228,Man; Simeon S,2,0,9,7
1683329285783,ETHN 109,A00,185711,Staff,18,0,35,17
1683329286807,ETHN 142,A00,185726,Staff,0,4,30,30
1683329287833,ETHN 163J,A00,199229,Man; Simeon S,5,0,8,3
1683329288859,ETHN 168,A00,185727,Staff,8,0,10,2
1683329289884,ETHN 182,A00,185728,Staff,1,0,35,34
1683329290911,ETHN 183,A00,185737,Staff,8,0,18,10
1683329291939,GLBH 111,A01,209361,Burgos; Jose L.,0,0,0,0
1683329293988,HIEU 104,A00,185792,Staff,16,0,20,4
1683329295012,HIEU 115,A00,185800,Staff,1,0,20,19
1683329296037,HIEU 128,A00,185801,Staff,0,7,20,20
1683329297064,HIEU 147,A00,185802,Staff,16,0,20,4
1683329298088,HIEU 154,A00,185823,Staff,12,0,20,8
1683329299111,HILA 102,A00,185826,Staff,13,0,20,7
1683329300138,HILD 2C,A01,185778,Staff,0,12,20,20
1683329301161,HILD 7B,A01,185780,Kwak; Nancy,0,15,32,32
1683329301161,HILD 7B,A02,185781,Kwak; Nancy,0,18,32,32
1683329302187,HILD 30,A01,185791,Staff,14,0,20,6
1683329303215,HISC 119,A00,185830,Golan; Tal,0,9,20,20
1683329304241,HITO 156GS,A00,185831,Patterson; Patrick H.,0,0,0,23
1683329305264,HIUS 103,A00,185832,Man; Simeon S,0,6,20,20
1683329306291,HIUS 117,A00,185836,Kwak; Nancy,2,0,20,18
1683329307316,HIUS 125,A00,185840,Man; Simeon S,0,0,23,23
1683329308340,HIUS 149,A00,185845,Staff,0,0,20,20
1683329309364,HUM 3,A01,185882,Zavodny; Tatiana Sophia,0,7,50,50
1683329309364,HUM 3,B01,185899,Caldwell; Michael Alan,0,18,50,50
1683329310390,HUM 3GS,A00,185900,Patterson; Patrick H.,0,0,0,23
1683329311414,HUM 4,A01,185938,Zroka; Amy Liane,31,0,50,19
1683329311414,HUM 4,B01,185956,Watkins; Eric,0,2,50,50
1683329311414,HUM 4,B02,202209,Watkins; Eric,0,2,50,50
1683329311414,HUM 4,B03,202210,Watkins; Eric,0,2,50,50
1683329312437,HUM 5,A01,185958,West; Geoffrey Scott,3,0,50,47
1683329312437,HUM 5,A02,202215,West; Geoffrey Scott,0,0,50,50
1683329313463,INTL 190,A00,185959,Gagnon; Jeffrey C,0,0,0,9
1683329313463,INTL 190,B00,185960,Lettieri; Michael Joseph,0,0,0,1
1683329314491,JAPN 180,A00,254509,Staff,5,1,30,25
1683329315520,LATI 10,A01,202853,Kennemore; Amy Michelle,4,0,35,31
1683329315520,LATI 10,A02,202854,Kennemore; Amy Michelle,2,0,35,33
1683329315520,LATI 10,A03,270054,Kennemore; Amy Michelle,30,0,30,0
1683329316544,LATI 180,A00,202855,Kennemore; Amy Michelle,11,0,20,9
1683329317571,LAWS 101,A00,201767,Golan; Tal,0,7,40,40
1683329318594,LIFR 1C,A00,185961,Staff,6,0,20,14
1683329319619,LIFR 1CX,A00,185962,Staff,7,0,20,13
1683329320643,LIFR 1D,A00,185963,Staff,9,0,20,11
1683329321666,LIFR 1DX,A00,185964,Staff,9,0,20,11
1683329322690,LIGN 101,A01,186039,Staff,43,0,50,7
1683329323717,LIGN 165,A00,186040,Staff,18,0,50,32
1683329324741,LTCS 108,A00,186041,Staff,6,0,10,4
1683329325764,LTCS 119,A00,186042,Staff,16,0,20,4
1683329326791,LTCS 130,A00,186043,Wesling; Megan E.,15,0,25,10
1683329328845,LTEA 138,A00,186119,Staff,14,0,40,26
1683329329871,LTEN 124,A00,186148,Staff,6,0,25,19
1683329330896,LTEN 178,A00,186149,Staff,7,0,15,8
1683329331923,LTEN 181,A00,186150,Blanco; John D,33,0,40,7
1683329332948,LTWL 120,A00,186160,Staff,20,0,25,5
1683329333972,LTWL 165,A00,186161,Staff,22,0,25,3
1683329334996,LTWR 100,A00,186162,Staff,0,5,15,15
1683329336023,LTWR 102,A00,186163,Doller; Ben,5,0,15,10
1683329337047,MAE 8,A01,186412,Staff,0,0,0,0
1683329338074,MAE 30B,A00,186445,Bahadori; Mohammad Yousef,83,0,100,17
1683329339100,MAE 40,A00,186592,Bewley; Thomas R,9,0,50,41
1683329340124,MAE 101B,A00,186593,Bahadori; Mohammad Yousef,81,0,100,19
1683329341150,MAE 105,A00,186594,Bandaru; Prabhakar,12,0,50,38
1683329342172,MAE 107,A00,186599,Pham; Hieu Tan,0,6,120,120
1683329343195,MAE 148,A01,186660,Silberman; Jack,3,0,16,13
1683329344219,MATH 10A,A01,188095,Staff,1,6,35,34
1683329345248,MATH 10B,A01,188097,Bowers; Adam R.,0,11,30,30
1683329345248,MATH 10B,A02,188099,Bowers; Adam R.,0,11,30,30
1683329345248,MATH 10B,B01,188104,Bowers; Adam R.,0,10,30,30
1683329345248,MATH 10B,B02,188106,Bowers; Adam R.,0,10,30,30
1683329346273,MATH 10C,A01,188111,Staff,0,18,30,30
1683329346273,MATH 10C,A02,188127,Staff,0,17,30,30
1683329346273,MATH 10C,A03,188131,Staff,0,18,30,30
1683329346273,MATH 10C,B01,188218,Staff,18,0,30,12
1683329346273,MATH 10C,B02,188244,Staff,13,0,30,17
1683329346273,MATH 10C,B03,188277,Staff,16,0,30,14
1683329347302,MATH 18,A01,188344,Bach; Quang Tran,18,0,30,12
1683329347302,MATH 18,A02,188345,Bach; Quang Tran,11,0,30,19
1683329347302,MATH 18,B01,188353,Bach; Quang Tran,10,0,30,20
1683329347302,MATH 18,B02,188354,Bach; Quang Tran,20,0,30,10
1683329348327,MATH 20A,A01,188374,Staff,13,0,35,22
1683329349352,MATH 20B,A01,188382,Ohm; Ko Woon,6,0,30,24
1683329349352,MATH 20B,A02,188383,Ohm; Ko Woon,22,0,30,8
1683329349352,MATH 20B,B01,188385,Ohm; Ko Woon,7,0,30,23
1683329349352,MATH 20B,B02,188392,Ohm; Ko Woon,22,0,30,8
1683329350380,MATH 20C,A01,188394,Harel; Guershon,10,0,30,20
1683329350380,MATH 20C,A02,188395,Harel; Guershon,15,0,30,15
1683329350380,MATH 20C,B01,188404,Harel; Guershon,5,0,30,25
1683329350380,MATH 20C,B02,188405,Harel; Guershon,19,0,30,11
1683329351404,MATH 20D,A01,188414,Hammock; Frances H,0,1,30,30
1683329351404,MATH 20D,A02,188415,Hammock; Frances H,2,0,30,28
1683329351404,MATH 20D,B01,188447,Hammock; Frances H,2,0,30,28
1683329351404,MATH 20D,B02,188486,Hammock; Frances H,8,0,30,22
1683329352430,MATH 20E,A01,188649,Staff,21,0,30,9
1683329352430,MATH 20E,A02,188650,Staff,23,0,30,7
1683329352430,MATH 20E,A03,188673,Staff,0,0,30,30
1683329353454,MATH 102,A01,188675,Staff,0,35,35,35
1683329354479,MATH 103B,A01,188681,Staff,3,0,35,32
1683329354479,MATH 103B,B01,188692,Staff,5,0,35,30
1683329355502,MATH 109,A01,188695,Salehi Golsefidy; Alireza,25,0,35,10
1683329355502,MATH 109,A02,188696,Salehi Golsefidy; Alireza,26,0,35,9
1683329356526,MATH 120A,A01,188698,Eggers; John Dietrich,7,0,35,28
1683329357629,MATH 142B,A01,188736,Ioana; Adrian,0,2,30,30
1683329357629,MATH 142B,A02,188741,Ioana; Adrian,1,1,30,29
1683329357629,MATH 142B,A03,188743,Ioana; Adrian,1,3,30,29
1683329358657,MATH 168A,A01,188790,Staff,0,9,35,35
1683329359681,MATH 170A,A01,188803,Nie; Jiawang,0,2,35,35
1683329359681,MATH 170A,A02,188811,Nie; Jiawang,0,0,35,35
1683329359681,MATH 170A,A03,188814,Nie; Jiawang,1,0,35,34
1683329359681,MATH 170A,A04,188815,Nie; Jiawang,13,0,35,22
1683329360709,MATH 193B,A01,188817,Staff,0,0,35,35
1683329360709,MATH 193B,A02,188818,Staff,5,0,35,30
1683329361733,MGT 4,A01,202857,Anderson; John Charles,62,0,80,18
1683329362760,MGT 12,A00,202858,Lindenberger; Wade Douglas,42,0,90,48
1683329363786,MGT 18,A00,202859,Staff,74,0,90,16
1683329364814,MGT 18GS,A00,202860,McKay; Michael J,13,0,28,15
1683329365838,MGT 45,A00,202861,Pecore; Joseph P.,13,0,90,77
1683329366864,MGT 100,A00,202863,Yavorsky; Daniel Ryan,28,0,90,62
1683329367887,MGT 103,A00,202864,Ehrich; Kristine R,1,18,90,89
1683329368916,MGT 112,A00,202865,Ehrich; Kristine R,15,0,90,75
1683329369939,MGT 121A,A00,202868,Staff,0,20,0,0
1683329370963,MGT 131B,A00,202869,Anderson; John Charles,59,0,90,31
1683329371990,MGT 136,A00,202871,Lindenberger; Wade Douglas,84,0,90,6
1683329373014,MGT 164,A00,202873,Staff,0,68,90,91
1683329374042,MGT 164GS,A00,202874,McKay; Mary A,13,0,28,15
1683329375069,MGT 180,A00,202875,Staff,0,50,90,91
1683329376093,MMW 11R,A01,205019,Herbst; Matthew,3,0,30,27
1683329376093,MMW 11R,A02,205026,Herbst; Matthew,29,0,30,1
1683329377120,MMW 15,A01,193512,Chang; Edmond Yi-Teh,0,9,28,28
1683329377120,MMW 15,A02,193513,Chang; Edmond Yi-Teh,0,5,28,28
1683329377120,MMW 15,A03,193514,Chang; Edmond Yi-Teh,0,5,28,28
1683329377120,MMW 15,A04,193515,Chang; Edmond Yi-Teh,0,5,28,28
1683329377120,MMW 15,A05,193516,Chang; Edmond Yi-Teh,0,4,28,28
1683329377120,MMW 15,A06,193517,Chang; Edmond Yi-Teh,0,5,28,28
1683329377120,MMW 15,B01,193519,Chang; Edmond Yi-Teh,0,5,28,28
1683329377120,MMW 15,B02,193520,Chang; Edmond Yi-Teh,0,5,28,28
1683329377120,MMW 15,B03,193521,Chang; Edmond Yi-Teh,0,5,28,28
1683329377120,MMW 15,B04,193522,Chang; Edmond Yi-Teh,0,4,28,28
1683329377120,MMW 15,B05,193523,Chang; Edmond Yi-Teh,0,5,28,28
1683329377120,MMW 15,B06,193524,Chang; Edmond Yi-Teh,0,4,28,28
1683329378144,MMW 122,A01,193526,Rahimi; Babak,0,15,28,28
1683329378144,MMW 122,A02,193527,Rahimi; Babak,0,14,28,28
1683329378144,MMW 122,A03,193528,Rahimi; Babak,0,0,0,0
1683329378144,MMW 122,A04,193529,Rahimi; Babak,0,0,0,0
1683329379171,MUS 1A,A01,186663,Staff,0,20,35,35
1683329380202,MUS 4,A01,186715,Staff,0,12,35,35
1683329381228,MUS 5R,A01,186796,Dubnov; Shlomo,0,17,35,35
1683329382252,MUS 6,A01,186798,Staff,0,4,25,25
1683329383281,MUS 7,A01,186830,Staff,12,0,35,23
1683329384304,MUS 8,A01,186930,Staff,0,27,35,35
1683329385329,MUS 15,A01,186932,Staff,0,16,35,35
1683329385329,MUS 15,B01,186934,Staff,0,15,35,35
1683329386354,MUS 80,A00,186935,Staff,1,0,20,19
1683329386354,MUS 80,B00,186936,Staff,25,0,25,0
1683329387382,NANO 11,A00,204702,Lipomi; Darren John,0,0,0,0
1683329388409,NANO 15,A01,204709,Yang; Kesong,0,1,0,0
1683329389436,NANO 114,A00,202069,Jahed Motlagh; Zeinab,3,0,10,7
1683329390462,PHIL 1,A00,186955,Grush; Rick Scott,32,0,40,8
1683329391490,PHIL 10,A01,186973,Grush; Rick Scott,28,0,35,7
1683329391490,PHIL 10,A02,186974,Grush; Rick Scott,33,0,35,2
1683329392518,PHIL 13,A01,186976,Staff,7,0,35,28
1683329392518,PHIL 13,A02,186977,Staff,16,0,35,19
1683329393543,PHIL 14,A01,186979,Staff,31,0,35,4
1683329393543,PHIL 14,A02,186986,Staff,32,0,35,3
1683329394573,PHIL 28,A01,186988,Staff,16,0,30,14
1683329394573,PHIL 28,A02,186989,Staff,1,0,30,29
1683329394573,PHIL 28,A03,186990,Staff,9,0,30,21
1683329394573,PHIL 28,A04,186991,Staff,26,0,30,4
1683329395600,PHIL 120,A00,186997,Staff,23,0,40,17
1683329396626,PHIL 137,A00,187003,Staff,9,0,40,31
1683329397650,PHIL 150,A00,187015,Staff,47,0,70,23
1683329398677,PHIL 167,A00,187021,Lamey; Andy M.,35,0,40,5
1683329399700,PHIL 174,A01,202226,Staff,17,0,20,3
1683329399700,PHIL 174,A02,202235,Staff,20,0,20,0
1683329400724,PHIL 191A,A00,258918,Staff,0,0,1,1
1683329401748,PHYS 1A,A00,187028,Staff,27,0,60,33
1683329402772,PHYS 1AL,001,187036,Staff,3,0,30,27
1683329402772,PHYS 1AL,002,187049,Staff,18,0,30,12
1683329403796,PHYS 1B,A00,187058,Staff,22,0,60,38
1683329404824,PHYS 1BL,001,187064,Staff,0,0,30,30
1683329404824,PHYS 1BL,002,187070,Staff,5,0,30,25
1683329405846,PHYS 1C,A00,187082,Staff,31,0,120,89
1683329406871,PHYS 1CL,001,187088,Staff,0,9,30,30
1683329406871,PHYS 1CL,002,187089,Staff,0,2,30,30
1683329406871,PHYS 1CL,009,262693,Staff,11,0,30,19
1683329407902,PHYS 2B,A01,187097,Staff,54,0,115,61
1683329408927,PHYS 2C,A01,187099,Staff,67,0,115,48
1683329409952,PHYS 2CL,A01,187101,Staff,5,0,28,23
1683329409952,PHYS 2CL,A02,187102,Staff,15,0,28,13
1683329410978,PHYS 2D,A01,187123,Shotwell; Brian,95,0,115,20
1683329412004,PHYS 4B,A01,187133,Grinstein; Benjamin,35,0,50,15
1683329413030,POLI 10,A00,188819,Staff,0,4,50,50
1683329414055,POLI 11,A00,188827,Staff,43,0,50,7
1683329415078,POLI 13R,A00,188828,Staff,0,1,20,20
1683329416101,POLI 27,A01,188830,Elgin; Samuel Zincke,0,1,70,70
1683329417124,POLI 30,A00,188832,Desposato; Scott,31,0,50,19
1683329418150,POLI 102F,A00,188834,Staff,3,0,40,37
1683329419175,POLI 104A,A00,188852,Staff,14,0,30,16
1683329420198,POLI 104I,A00,188853,Staff,0,6,20,20
1683329421221,POLI 110B,A00,188854,Wiens; David,7,0,20,13
1683329422244,POLI 112A,A00,188855,Wiens; David,5,0,30,25
1683329423271,POLI 117R,A00,188856,Forman; Fonna,0,11,20,20
1683329424298,POLI 118,A00,188857,Ingham; Sean,8,0,20,12
1683329425322,POLI 120G,A00,188858,Staff,9,0,30,21
1683329426350,POLI 131CR,A00,188863,Hoston; Germaine,24,0,50,26
1683329427376,POLI 133,A00,188864,Nellis; Gareth Hb,44,0,50,6
1683329428400,POLI 134D,A00,188865,Desposato; Scott,27,0,30,3
1683329429426,POLI 142A,A00,188871,Gartzke; Erik,22,0,50,28
1683329430449,POLI 142K,A00,188874,Staff,38,0,50,12
1683329431476,POLI 143,A00,188940,Gartzke; Erik,16,0,30,14
1683329432500,POLI 153,A00,188943,Staff,3,0,20,17
1683329433526,POLI 160AA,A00,188944,Staff,12,0,40,28
1683329434552,POLI 170A,A00,188945,Staff,11,0,30,19
1683329436599,PSYC 1,A00,188952,Staff,37,0,90,53
1683329437625,PSYC 2,B00,188953,Staff,19,0,35,16
1683329438651,PSYC 6,A00,188970,Staff,47,0,60,13
1683329439678,PSYC 7,A00,188973,Staff,37,0,45,8
1683329440706,PSYC 60,A01,188980,Rickard; Timothy C.,43,0,60,17
1683329441733,PSYC 70,A01,189001,Steiner; Eric Tomas,24,0,45,21
1683329442758,PSYC 100,A00,189005,Lacefield; Katharine I,0,100,120,120
1683329443785,PSYC 102,A00,189008,Staff,9,0,30,21
1683329444807,PSYC 106,B00,189026,Gorman; Michael R.,34,0,60,26
1683329445832,PSYC 114,B01,189033,Winkielman; Piotr,0,32,30,30
1683329446859,PSYC 131,A00,189036,Anagnostaras; Stephan,0,43,60,60
1683329447882,PSYC 136,A00,189041,Lowe; Angela Beth,0,7,25,25
1683329448908,PSYC 137,A00,189057,Winkielman; Piotr,0,34,25,25
1683329449932,PSYC 144,A00,189107,Wixted; John T,0,7,50,50
1683329451983,PSYC 162,A00,189142,Staff,0,8,85,85
1683329453011,PSYC 172,A00,189144,Gorman; Michael R.,0,7,30,30
1683329455065,PSYC 179,A00,189146,Lacefield; Katharine I,0,84,120,120
1683329456089,PSYC 181,A00,189147,Anagnostaras; Stephan,0,44,90,90
1683329457116,PSYC 190R,A00,189148,Barner; David A.,0,22,80,80
1683329458139,PSYC 191,A00,189275,Rickard; Timothy C.,0,7,25,25
1683329459164,PSYC 193,A00,189276,Chapman; Eddie Nathaniel,0,1,0,4
1683329460189,PSYC 193L,A01,189281,Lowe; Angela Beth,12,0,20,8
1683329460189,PSYC 193L,B01,189285,Staff,28,0,35,7
1683329461270,RELI 149,A00,187137,Rahimi; Babak,7,0,40,33
1683329462294,SE 9,A01,187315,Staff,0,2,18,18
1683329463318,SE 101B,A00,187409,Staff,24,0,30,6
1683329464342,SE 110B,A00,187444,Staff,10,0,40,30
1683329465370,SE 130B,A00,187449,Staff,31,0,40,9
1683329466397,SE 150A,A00,187516,Staff,9,0,20,11
1683329467425,SE 154,A00,187528,Staff,30,0,50,20
1683329468452,SIO 3,A01,258171,Staff,35,0,40,5
1683329469477,SIO 10,A00,187144,Cook; Geoffrey W,0,3,75,75
1683329470502,SIO 45,A00,187152,Cook; Geoffrey W,1,0,100,99
1683329471531,SIO 109R,A00,194486,Staff,0,3,20,20
1683329473583,SIO 187,A01,187233,Kacev; David,12,0,40,28
1683329474612,SOCI 1,A01,258656,Thorpe; Charles Robert,28,0,30,2
1683329474612,SOCI 1,A02,258658,Thorpe; Charles Robert,30,0,30,0
1683329474612,SOCI 1,A03,258661,Thorpe; Charles Robert,25,0,25,0
1683329474612,SOCI 1,A04,258666,Thorpe; Charles Robert,22,0,25,3
1683329474612,SOCI 1,A05,258897,Thorpe; Charles Robert,23,0,25,2
1683329474612,SOCI 1,A06,258898,Thorpe; Charles Robert,25,0,25,0
1683329475637,SOCI 30,A01,258903,Pardo Guerra; Juan Pablo,15,0,30,15
1683329476666,SOCI 102,A00,258904,Staff,9,0,25,16
1683329477690,SOCI 106,A00,258905,Staff,19,0,25,6
1683329478714,SOCI 111,A00,258907,Ribas Norris; Janet Vanesa,26,0,30,4
1683329479740,SOCI 121R,A00,258908,Pardo Guerra; Juan Pablo,10,0,30,20
1683329480768,SOCI 126,A01,203330,Staff,14,0,20,6
1683329481796,SOCI 131,A00,258909,Thorpe; Charles Robert,31,0,60,29
1683329482824,SOCI 135,A00,258910,Payne; Christine Anna,0,9,30,30
1683329483852,SOCI 157,A00,258911,Staff,12,0,30,18
1683329484879,SOCI 184,A00,258912,Staff,25,0,30,5
1683329485903,SOCI 188D,A00,258913,Staff,21,0,30,9
1683329486929,SYN 2,001,187529,Staff,10,0,16,6
1683329486929,SYN 2,002,201452,Staff,0,18,16,16
1683329486929,SYN 2,003,201469,Staff,3,0,16,13
1683329487954,SYN 100,A01,187531,Staff,0,9,20,20
1683329487954,SYN 100,B01,201491,Staff,0,12,20,20
1683329488980,TDAC 1,A00,189286,Walsh; Kim C.,3,0,20,17
1683329488980,TDAC 1,B00,189287,Harting; Carla Kelso,11,0,20,9
1683329490010,TDAC 101,A00,189300,Walsh; Kim C.,16,0,20,4
1683329490010,TDAC 101,B00,189301,Harting; Carla Kelso,18,0,20,2
1683329491038,TDAC 102,A00,189304,Basso; Beatrice,14,0,20,6
1683329492065,TDAC 108,A00,189305,Staff,18,0,20,2
1683329493095,TDDE 131,A00,189310,Staff,19,0,20,1
1683329493095,TDDE 131,B00,189314,Staff,19,0,20,1
1683329493095,TDDE 131,C00,189315,Staff,48,0,50,2
1683329493095,TDDE 131,D00,189316,Staff,14,0,15,1
1683329493095,TDDE 131,E00,204841,Staff,20,0,20,0
1683329494121,TDGE 10,A00,189289,Staff,30,0,50,20
1683329494121,TDGE 10,B00,189290,Havis; Allan,1,0,50,49
1683329495146,TDGE 11,A00,189291,Fulton; Julia,0,3,50,50
1683329495146,TDGE 11,B00,189292,Staff,20,0,25,5
1683329495146,TDGE 11,C00,260270,Staff,0,0,0,0
1683329496170,TDGE 25,A00,189294,Staff,3,0,20,17
1683329497194,TDGE 124,A00,189318,Fulton; Julia,0,8,50,50
1683329498220,TDGE 125,A00,189319,Staff,13,0,25,12
1683329498220,TDGE 125,B00,189320,Staff,23,0,25,2
1683329499244,TDGE 127,A00,189322,Havis; Allan,0,0,50,50
1683329500268,TDHT 101,A00,189323,Staff,18,0,25,7
1683329500268,TDHT 101,B00,189324,Staff,25,0,25,0
1683329501296,TDHT 102,A00,189325,Staff,49,0,50,1
1683329502321,TDMV 1,A00,189295,Arcidiacono; Kristin,19,0,30,11
1683329502321,TDMV 1,B00,189296,Caligagan; Maria T.,24,0,30,6
1683329503348,TDMV 2,A00,189297,Sammartano; Tonnie,28,0,30,2
1683329503348,TDMV 2,B00,189299,Arcidiacono; Kristin,24,0,30,6
1683329504374,TDMV 3,A00,204998,Rincon; Alicia,22,0,30,8
1683329505401,TDMV 120,A00,189458,Sammartano; Tonnie,28,0,30,2
1683329506425,TDMV 138,A00,189541,Jun; Grace Shin Hae,22,0,40,18
1683329507449,TDMV 142,A00,189717,Caligagan; Tony,23,0,30,7
1683329507449,TDMV 142,B00,189718,Caligagan; Maria T.,25,0,30,5
1683329508480,TMC 2,A01,187533,Staff,25,0,25,0
1683329508480,TMC 2,A02,187534,Staff,25,0,25,0
1683329509504,USP 1,A01,187536,Kwak; Nancy,0,16,25,25
1683329510532,USP 5,A01,187538,Staff,10,0,25,15
1683329511556,USP 101,A00,199253,Staff,0,4,0,0
1683329512584,USP 124,A00,187562,Boomhower; Matthew Charles,1,0,30,29
1683329513611,USP 138,A00,187582,Staff,20,0,25,5
1683329514634,USP 152,A01,187597,Staff,4,0,25,21
1683329515658,USP 153,A00,187598,Staff,19,0,25,6
1683329516685,USP 168,A00,187607,Kwak; Nancy,2,0,5,3
1683329517719,USP 173,A00,187619,Staff,4,0,25,21
1683329518746,USP 181,A00,187638,Staff,0,0,25,25
1683329519773,VIS 103,A00,187650,Cruz; Edwin Teddy,23,0,75,52
1683329520801,VIS 110D,A00,187669,Staff,12,0,22,10
1683329521825,VIS 127C,A00,187720,Shen; Kuiyi,67,0,146,79
1683329522849,VIS 149,A00,187731,Yoldas; Pinar,0,14,22,22
1683329523878,VIS 151,A01,188091,Staff,22,0,34,12
1683329523878,VIS 151,A02,188092,Staff,11,0,34,23
1683329524907,VIS 160B,A00,188093,Stalbaum; Brett,0,0,10,10
1683329526964,WCWP 10B,A00,201720,Staff,10,0,15,5
1683329526964,WCWP 10B,B00,201722,Staff,8,0,15,7
1683329527991,WCWP 100,A00,201725,Gagnon; Jeffrey C,0,0,2,2
1683329527991,WCWP 100,B00,201727,Staff,0,4,15,15
1683329531127,ANBI 133,A00,258401,Wilder; Linnea Lorene,34,0,40,6
1683329532155,ANBI 140,A00,258395,Hrvoj Mihic; Branka,18,0,25,7
1683329533181,ANSC 120,A00,258402,Bialecki; Jon Anthony,27,0,40,13
1683329534208,ANSC 144,A00,258400,Staff,14,0,40,26
1683329536264,ANSC 166,A00,258396,Parish; Steven Martin,157,0,175,18
1683329537290,ANSC 180,A00,193533,Staff,9,0,20,11
1683329538315,ANSC 188,A00,258397,Jassal; Aftab,33,0,40,7
1683329539339,ANTH 3,A01,258316,Staff,23,0,30,7
1683329540367,ANTH 5,A00,258394,Semendeferi; Ekaterini,16,0,20,4
1683329541391,ANTH 21,A01,258331,Staff,8,0,40,32
1683329542418,ANTH 103,A00,258398,Varma; Saiba,15,0,25,10
1683329543445,AWP 10,001,202034,Staff,0,0,0,0
1683329543445,AWP 10,002,202035,Staff,0,0,0,0
1683329543445,AWP 10,003,202036,Staff,0,0,0,0
1683329543445,AWP 10,004,202037,Staff,0,0,0,0
1683329543445,AWP 10,005,202038,Staff,0,0,0,0
1683329543445,AWP 10,006,202039,Staff,0,0,0,0
1683329543445,AWP 10,007,202040,Staff,0,0,0,0
1683329543445,AWP 10,008,202041,Staff,0,0,0,0
1683329543445,AWP 10,009,202042,Staff,0,0,0,0
1683329543445,AWP 10,010,202043,Staff,0,0,0,0
1683329543445,AWP 10,011,202044,Staff,0,0,0,0
1683329543445,AWP 10,012,202045,Staff,0,0,0,0
1683329543445,AWP 10,013,202046,Staff,0,0,0,0
1683329543445,AWP 10,014,202047,Staff,0,0,0,0
1683329543445,AWP 10,015,202048,Staff,0,0,0,0
1683329543445,AWP 10,016,202049,Staff,0,0,0,0
1683329543445,AWP 10,017,202050,Staff,0,0,0,0
1683329543445,AWP 10,018,202051,Staff,0,0,0,0
1683329543445,AWP 10,019,202052,Staff,0,0,0,0
1683329543445,AWP 10,020,202053,Staff,0,0,0,0
1683329543445,AWP 10,021,202054,Staff,0,0,0,0
1683329543445,AWP 10,022,202055,Staff,0,0,0,0
1683329543445,AWP 10,023,202056,Staff,0,0,0,0
1683329543445,AWP 10,024,202057,Staff,0,0,0,0
1683329543445,AWP 10,025,202058,Staff,0,0,0,0
1683329543445,AWP 10,026,202059,Staff,0,0,0,0
1683329544472,AWP 102,001,202032,Staff,0,0,0,0
1683329544472,AWP 102,002,202033,Staff,0,0,0,0
1683329545497,BENG 100,A01,254234,Taylor Amos; Alyssa C,31,0,40,9
1683329546522,BENG 196,001,270013,Engler; Adam J.,9999,0,9999,0
1683329547546,BICD 100R,A01,202018,Smith; Laurie,0,7,32,32
1683329547546,BICD 100R,A02,202019,Smith; Laurie,0,2,32,32
1683329547546,BICD 100R,A03,202020,Smith; Laurie,0,1,32,32
1683329547546,BICD 100R,A04,202021,Smith; Laurie,9,0,32,23
1683329547546,BICD 100R,A05,202022,Smith; Laurie,12,0,32,20
1683329548570,BICD 136,A01,193242,Gustafson-Brown; Cindy,0,2,32,32
1683329548570,BICD 136,A02,193244,Gustafson-Brown; Cindy,14,0,32,18
1683329549601,BIEB 102,A01,193249,Butler; Shannon Rhey,0,2,32,32
1683329549601,BIEB 102,A02,193251,Butler; Shannon Rhey,0,0,32,32
1683329549601,BIEB 102,A03,193253,Butler; Shannon Rhey,0,1,32,32
1683329549601,BIEB 102,A04,193255,Butler; Shannon Rhey,17,0,32,15
1683329549601,BIEB 102,A05,193265,Butler; Shannon Rhey,26,0,32,6
1683329549601,BIEB 102,A06,193269,Butler; Shannon Rhey,16,0,32,16
1683329551657,BIEB 150,A01,193274,Staff,0,0,32,32
1683329551657,BIEB 150,A02,193285,Staff,23,0,32,9
1683329552684,BIEB 194,A00,193286,Kurle; Carolyn M.,22,0,32,10
1683329553709,BILD 1,A01,192291,Staff,16,0,32,16
1683329553709,BILD 1,A02,192292,Staff,30,0,32,2
1683329553709,BILD 1,B01,192520,Reuther; Keefe,0,1,0,0
1683329553709,BILD 1,B02,192532,Reuther; Keefe,0,1,0,0
1683329554738,BILD 3,A01,192556,Butler; Shannon Rhey,0,0,32,32
1683329554738,BILD 3,A02,192581,Butler; Shannon Rhey,5,0,32,27
1683329554738,BILD 3,A03,192611,Butler; Shannon Rhey,23,0,32,9
1683329554738,BILD 3,A04,192612,Butler; Shannon Rhey,25,0,32,7
1683329554738,BILD 3,A05,192613,Butler; Shannon Rhey,27,0,32,5
1683329554738,BILD 3,A06,192679,Butler; Shannon Rhey,27,0,32,5
1683329554738,BILD 3,A07,192682,Butler; Shannon Rhey,22,0,32,10
1683329555763,BILD 4,A01,192836,Reuther; Keefe,0,0,24,24
1683329555763,BILD 4,A02,193044,Reuther; Keefe,4,0,24,20
1683329556788,BILD 10,A01,193142,Gustafson-Brown; Cindy,30,0,32,2
1683329556788,BILD 10,A02,193149,Gustafson-Brown; Cindy,31,0,32,1
1683329557817,BIMM 100,A01,193301,Staff,0,6,32,32
1683329557817,BIMM 100,A02,193312,Staff,0,5,32,32
1683329557817,BIMM 100,A03,193323,Staff,0,8,32,32
1683329558845,BIMM 101,A01,193329,McDonnell; Lisa Marie,0,3,24,24
1683329558845,BIMM 101,A02,193339,McDonnell; Lisa Marie,0,3,24,24
1683329558845,BIMM 101,B01,193354,McDonnell; Lisa Marie,0,3,24,24
1683329558845,BIMM 101,B02,193357,McDonnell; Lisa Marie,0,3,24,24
1683329559876,BIMM 110,A01,193377,Tat; John,0,11,32,32
1683329559876,BIMM 110,A02,193378,Tat; John,1,9,32,31
1683329560904,BIMM 120,A01,206116,Staff,0,0,32,32
1683329560904,BIMM 120,A02,206117,Staff,8,0,32,24
1683329560904,BIMM 120,A03,206121,Staff,21,0,32,11
1683329561928,BIPN 100,A01,193393,Park; Ji Young,0,14,32,32
1683329561928,BIPN 100,A02,193402,Park; Ji Young,0,13,32,32
1683329561928,BIPN 100,A03,193413,Park; Ji Young,0,14,32,32
1683329561928,BIPN 100,A04,193414,Park; Ji Young,0,13,32,32
1683329562955,BIPN 102,A01,193429,Staff,0,0,32,32
1683329562955,BIPN 102,A02,193438,Staff,22,0,32,10
1683329563982,BIPN 106,A01,193450,Reyes Gonzalez; Catalina,0,2,40,40
1683329565069,BIPN 134,A01,193465,Cooke; James Edward,0,0,32,32
1683329565069,BIPN 134,A02,193474,Cooke; James Edward,25,0,32,7
1683329565069,BIPN 134,A03,193485,Cooke; James Edward,29,0,32,3
1683329565069,BIPN 134,A04,193486,Cooke; James Edward,21,0,32,11
1683329565069,BIPN 134,A05,193491,Cooke; James Edward,31,0,32,1
1683329565069,BIPN 134,A06,193501,Cooke; James Edward,30,0,32,2
1683329565069,BIPN 134,A07,193510,Cooke; James Edward,29,0,32,3
1683329567120,BISP 194,A00,222522,Staff,14,0,32,18
1683329568143,CAT 124,A01,202407,Staff,20,0,25,5
1683329569167,CAT 125,A00,202408,Marchisotto; Jennifer Anne,4,0,20,16
1683329570192,CAT 125R,A00,202409,Smith; Lauryn Alissa,0,11,20,20
1683329570192,CAT 125R,B00,202410,Morales; Celeste Georgianna,0,11,20,20
1683329570192,CAT 125R,C00,202411,Irwin; Matthew Joseph,0,10,20,20
1683329571215,CENG 15,A01,204712,Yang; Kesong,0,1,0,0
1683329572242,CENG 114,A00,202070,Jahed Motlagh; Zeinab,5,0,20,15
1683329573266,CGS 105,A00,185477,Wesling; Megan E.,24,0,40,16
1683329574292,CGS 106,A00,185494,Staff,13,0,22,9
1683329575319,CGS 108,A00,185495,Staff,14,0,20,6
1683329576346,CGS 114,A00,185496,Staff,13,0,18,5
1683329577376,CGS 119,A00,185501,Staff,15,0,20,5
1683329578400,CGS 120,A00,185511,Staff,13,0,20,7
1683329579427,CHEM 4,A01,184675,Bussey; Thomas J,96,0,100,4
1683329580455,CHEM 6A,A01,184677,Staff,34,0,60,26
1683329581480,CHEM 6B,A01,184679,Staff,65,0,100,35
1683329582504,CHEM 6C,A01,184681,Bussey; Thomas J,1,0,50,49
1683329582504,CHEM 6C,A02,184682,Bussey; Thomas J,34,0,50,16
1683329583529,CHEM 40A,A01,184684,Albizati; Kim F.,37,0,100,63
1683329584553,CHEM 40B,A01,184686,Albizati; Kim F.,0,20,100,100
1683329585578,CHEM 41B,A01,184690,Staff,52,0,100,48
1683329586602,COGS 3,A01,184715,Boyle; Mary E. T.,0,25,40,40
1683329587625,COGS 14B,A01,185172,Staff,0,15,38,38
1683329588654,COGS 18,A01,184736,Staff,17,0,80,63
1683329589681,COGS 100,A01,184932,Staff,0,5,73,73
1683329590706,COGS 101A,A01,184935,Staff,0,39,30,30
1683329591733,COGS 101B,A01,184944,Staff,0,2,30,30
1683329592756,COGS 101C,A01,184946,Staff,0,12,30,30
1683329593781,COGS 102A,A01,184951,Johnson; Christine M.,2,0,40,38
1683329594808,COGS 107B,A01,184953,Mooshagian; Eric Frederick,0,50,40,40
1683329595840,COGS 118B,A01,184959,Gupta; Anjum,0,48,40,40
1683329596864,COGS 153,A00,184961,Staff,0,15,30,30
1683329597888,COGS 177,A00,184962,Staff,0,20,30,30
1683329598915,COGS 187A,A01,184969,Boyle; Mary E. T.,0,17,40,40
1683329599943,COMM 10,A01,185174,Staff,0,5,25,25
1683329599943,COMM 10,A02,185189,Staff,0,5,25,25
1683329599943,COMM 10,A03,269821,Staff,0,0,0,0
1683329600967,COMM 100B,A01,185475,Staff,0,0,0,2
1683329600967,COMM 100B,A02,185476,Staff,14,0,25,11
1683329601992,COMM 100C,A01,185314,Staff,1,0,25,24
1683329601992,COMM 100C,A02,185327,Staff,19,0,25,6
1683329603015,COMM 110M,A00,185349,Staff,2,0,40,38
1683329604038,COMM 113T,A00,185352,Staff,24,0,40,16
1683329605065,COMM 114I,A00,185353,Staff,33,0,40,7
1683329606089,COMM 131,A00,185354,Staff,19,0,30,11
1683329607118,CSE 8A,A50,185358,Cao; Yingjun,0,46,10,10
1683329608145,CSE 8B,A01,185362,Staff,1,47,50,49
1683329609173,CSE 11,A01,185416,Cao; Yingjun,0,92,10,10
1683329610200,CSE 20,A01,185445,Briones; Jor-el Thomas Caparas,5,0,25,20
1683329611227,CSE 21,A01,185447,Staff,10,0,50,40
1683329612253,CSE 101,A01,185451,Staff,0,12,50,50
1683329612253,CSE 101,B01,185453,Jones; Miles E,0,11,50,50
1683329614305,CSE 141,A01,185458,Eldon; John,20,0,100,80
1683329615333,CSE 141L,A01,185461,Eldon; John,12,0,100,88
1683329616365,CSE 142,A01,185463,Staff,36,0,60,24
1683329616365,CSE 142,B01,201355,Staff,0,7,60,60
1683329617389,CSE 142L,A01,185470,Staff,36,0,60,24
1683329617389,CSE 142L,B01,201417,Staff,0,6,60,60
1683329618416,CSE 190,A00,201433,Staff,32,0,49,17
1683329619441,DOC 1,A01,259136,Strom; Megan C.,7,0,15,8
1683329619441,DOC 1,A02,259137,Strom; Megan C.,14,0,15,1
1683329619441,DOC 1,A03,259138,Strom; Megan C.,14,0,15,1
1683329619441,DOC 1,A04,259139,Strom; Megan C.,14,0,15,1
1683329620469,DOC 100D,A00,259140,Pass; Natalye Joann,16,0,25,9
1683329621496,DSGN 1,A01,184749,Rill; Bryan,0,25,30,30
1683329622520,DSGN 100,A01,185168,Staff,0,2,25,25
1683329623548,ECE 5,A01,185626,Morris; Karcher William,0,10,0,0
1683329624575,ECE 101,A01,185628,Staff,17,0,70,53
1683329625599,ECE 107,A01,185635,Baghdadchi; Saharnaz,0,0,20,20
1683329625599,ECE 107,A02,185638,Baghdadchi; Saharnaz,4,0,20,16
1683329626626,ECE 148,A01,185647,Silberman; Jack,0,0,16,16
1683329627650,ECON 1,A01,185537,Crane; Meredith Helen,54,0,70,16
1683329628681,ECON 3,A01,185549,Crane; Meredith Helen,33,0,70,37
1683329629710,ECON 4,A01,203354,Anderson; John Charles,0,4,10,10
1683329630736,ECON 100A,A01,185574,Staff,0,4,40,40
1683329631763,ECON 100B,A01,185576,Staff,10,22,50,40
1683329632791,ECON 100C,A01,185589,Newhouse; Herbert S,30,0,70,40
1683329633821,ECON 105,A00,185608,Vespa; Emanuel Ignacio,19,0,35,16
1683329634848,ECON 109,A01,185610,Shishkin; Denis,10,0,35,25
1683329635875,ECON 110A,A01,185612,Staff,11,0,40,29
1683329636903,ECON 120A,A01,185615,Staff,20,0,40,20
1683329637930,ECON 120C,A01,185617,Sun; Yixiao,0,20,70,70
1683329638953,ECON 144,A00,203346,Squires; Dale E,3,0,35,32
1683329639982,ECON 171,A01,203349,Newhouse; Herbert S,0,1,35,35
1683329641007,ECON 173A,A01,185621,Toda; Alexis Akira,21,0,35,14
1683329642033,EDS 25,A01,202413,Staff,0,1,0,0
1683329642033,EDS 25,A02,202414,Staff,0,1,0,0
1683329642033,EDS 25,A03,202415,Staff,0,0,0,0
1683329642033,EDS 25,A04,202416,Staff,0,1,0,0
1683329642033,EDS 25,A05,202439,Staff,0,0,0,0
1683329642033,EDS 25,A06,202440,Staff,0,0,0,0
1683329642033,EDS 25,B01,202631,Staff,0,0,0,0
1683329642033,EDS 25,B02,202632,Staff,0,0,0,0
1683329642033,EDS 25,B03,202639,Staff,0,0,0,0
1683329642033,EDS 25,B04,202640,Staff,0,0,0,0
1683329642033,EDS 25,B05,202643,Staff,0,0,0,0
1683329642033,EDS 25,B06,202644,Staff,0,0,0,0
1683329643057,EDS 38,A01,202659,Black; Alison Michelle,24,0,25,1
1683329644086,EDS 115,A00,202652,Staff,17,0,30,13
1683329645111,EDS 125,A00,202649,Staff,14,0,30,16
1683329646140,EDS 126,A01,203332,Staff,30,0,30,0
1683329647171,EDS 139,A00,202838,Staff,16,0,25,9
1683329648199,EDS 146,A01,202655,Staff,14,0,25,11
1683329649224,ENG 15,A00,185667,Staff,0,1,0,0
1683329649224,ENG 15,B00,185672,Staff,0,0,0,0
1683329649224,ENG 15,C00,185675,Staff,0,0,0,0
1683329649224,ENG 15,D00,185682,Staff,0,0,0,0
1683329649224,ENG 15,E00,185684,Staff,0,0,0,0
1683329650248,ETHN 103,A00,185710,Staff,0,3,35,35
1683329651274,ETHN 103A,A00,199228,Man; Simeon S,2,0,9,7
1683329652300,ETHN 109,A00,185711,Staff,18,0,35,17
1683329653323,ETHN 142,A00,185726,Staff,0,4,30,30
1683329654350,ETHN 163J,A00,199229,Man; Simeon S,5,0,8,3
1683329655378,ETHN 168,A00,185727,Staff,8,0,10,2
1683329656403,ETHN 182,A00,185728,Staff,1,0,35,34
1683329657427,ETHN 183,A00,185737,Staff,8,0,18,10
1683329658454,GLBH 111,A01,209361,Burgos; Jose L.,0,0,0,0
1683329660504,HIEU 104,A00,185792,Staff,16,0,20,4
1683329661604,HIEU 115,A00,185800,Staff,1,0,20,19
1683329662630,HIEU 128,A00,185801,Staff,0,7,20,20
1683329663655,HIEU 147,A00,185802,Staff,16,0,20,4
1683329664679,HIEU 154,A00,185823,Staff,12,0,20,8
1683329665707,HILA 102,A00,185826,Staff,13,0,20,7
1683329666733,HILD 2C,A01,185778,Staff,0,12,20,20
1683329667758,HILD 7B,A01,185780,Kwak; Nancy,0,15,32,32
1683329667758,HILD 7B,A02,185781,Kwak; Nancy,0,18,32,32
1683329668838,HILD 30,A01,185791,Staff,14,0,20,6
1683329669865,HISC 119,A00,185830,Golan; Tal,0,9,20,20
1683329670890,HITO 156GS,A00,185831,Patterson; Patrick H.,0,0,0,23
1683329671915,HIUS 103,A00,185832,Man; Simeon S,0,6,20,20
1683329672940,HIUS 117,A00,185836,Kwak; Nancy,2,0,20,18
1683329673963,HIUS 125,A00,185840,Man; Simeon S,0,0,23,23
1683329674987,HIUS 149,A00,185845,Staff,0,0,20,20
1683329676011,HUM 3,A01,185882,Zavodny; Tatiana Sophia,0,7,50,50
1683329676011,HUM 3,B01,185899,Caldwell; Michael Alan,0,18,50,50
1683329677037,HUM 3GS,A00,185900,Patterson; Patrick H.,0,0,0,23
1683329678065,HUM 4,A01,185938,Zroka; Amy Liane,31,0,50,19
1683329678065,HUM 4,B01,185956,Watkins; Eric,0,2,50,50
1683329678065,HUM 4,B02,202209,Watkins; Eric,0,2,50,50
1683329678065,HUM 4,B03,202210,Watkins; Eric,0,2,50,50
1683329679091,HUM 5,A01,185958,West; Geoffrey Scott,3,0,50,47
1683329679091,HUM 5,A02,202215,West; Geoffrey Scott,0,0,50,50
1683329680118,INTL 190,A00,185959,Gagnon; Jeffrey C,0,0,0,9
1683329680118,INTL 190,B00,185960,Lettieri; Michael Joseph,0,0,0,1
1683329681143,JAPN 180,A00,254509,Staff,5,1,30,25
1683329682170,LATI 10,A01,202853,Kennemore; Amy Michelle,4,0,35,31
1683329682170,LATI 10,A02,202854,Kennemore; Amy Michelle,2,0,35,33
1683329682170,LATI 10,A03,270054,Kennemore; Amy Michelle,30,0,30,0
1683329683194,LATI 180,A00,202855,Kennemore; Amy Michelle,11,0,20,9
1683329684219,LAWS 101,A00,201767,Golan; Tal,0,7,40,40
1683329685246,LIFR 1C,A00,185961,Staff,6,0,20,14
1683329686268,LIFR 1CX,A00,185962,Staff,7,0,20,13
1683329687295,LIFR 1D,A00,185963,Staff,9,0,20,11
1683329688320,LIFR 1DX,A00,185964,Staff,9,0,20,11
1683329689343,LIGN 101,A01,186039,Staff,43,0,50,7
1683329690371,LIGN 165,A00,186040,Staff,18,0,50,32
1683329691398,LTCS 108,A00,186041,Staff,6,0,10,4
1683329692424,LTCS 119,A00,186042,Staff,16,0,20,4
1683329693450,LTCS 130,A00,186043,Wesling; Megan E.,15,0,25,10
1683329695503,LTEA 138,A00,186119,Staff,14,0,40,26
1683329696529,LTEN 124,A00,186148,Staff,6,0,25,19
1683329697552,LTEN 178,A00,186149,Staff,7,0,15,8
1683329698577,LTEN 181,A00,186150,Blanco; John D,33,0,40,7
1683329699601,LTWL 120,A00,186160,Staff,20,0,25,5
1683329700628,LTWL 165,A00,186161,Staff,22,0,25,3
1683329701655,LTWR 100,A00,186162,Staff,0,5,15,15
1683329702678,LTWR 102,A00,186163,Doller; Ben,5,0,15,10
1683329703703,MAE 8,A01,186412,Staff,0,0,0,0
1683329704730,MAE 30B,A00,186445,Bahadori; Mohammad Yousef,83,0,100,17
1683329705754,MAE 40,A00,186592,Bewley; Thomas R,9,0,50,41
1683329706779,MAE 101B,A00,186593,Bahadori; Mohammad Yousef,81,0,100,19
1683329707808,MAE 105,A00,186594,Bandaru; Prabhakar,12,0,50,38
1683329708834,MAE 107,A00,186599,Pham; Hieu Tan,0,6,120,120
1683329709862,MAE 148,A01,186660,Silberman; Jack,3,0,16,13
1683329710886,MATH 10A,A01,188095,Staff,1,6,35,34
1683329711910,MATH 10B,A01,188097,Bowers; Adam R.,0,11,30,30
1683329711910,MATH 10B,A02,188099,Bowers; Adam R.,0,11,30,30
1683329711910,MATH 10B,B01,188104,Bowers; Adam R.,0,10,30,30
1683329711910,MATH 10B,B02,188106,Bowers; Adam R.,0,10,30,30
1683329712939,MATH 10C,A01,188111,Staff,0,18,30,30
1683329712939,MATH 10C,A02,188127,Staff,0,17,30,30
1683329712939,MATH 10C,A03,188131,Staff,0,18,30,30
1683329712939,MATH 10C,B01,188218,Staff,18,0,30,12
1683329712939,MATH 10C,B02,188244,Staff,13,0,30,17
1683329712939,MATH 10C,B03,188277,Staff,16,0,30,14
1683329713967,MATH 18,A01,188344,Bach; Quang Tran,18,0,30,12
1683329713967,MATH 18,A02,188345,Bach; Quang Tran,11,0,30,19
1683329713967,MATH 18,B01,188353,Bach; Quang Tran,10,0,30,20
1683329713967,MATH 18,B02,188354,Bach; Quang Tran,20,0,30,10
1683329714990,MATH 20A,A01,188374,Staff,13,0,35,22
1683329716014,MATH 20B,A01,188382,Ohm; Ko Woon,6,0,30,24
1683329716014,MATH 20B,A02,188383,Ohm; Ko Woon,22,0,30,8
1683329716014,MATH 20B,B01,188385,Ohm; Ko Woon,7,0,30,23
1683329716014,MATH 20B,B02,188392,Ohm; Ko Woon,22,0,30,8
1683329717038,MATH 20C,A01,188394,Harel; Guershon,10,0,30,20
1683329717038,MATH 20C,A02,188395,Harel; Guershon,15,0,30,15
1683329717038,MATH 20C,B01,188404,Harel; Guershon,5,0,30,25
1683329717038,MATH 20C,B02,188405,Harel; Guershon,19,0,30,11
1683329718068,MATH 20D,A01,188414,Hammock; Frances H,0,1,30,30
1683329718068,MATH 20D,A02,188415,Hammock; Frances H,3,0,30,27
1683329718068,MATH 20D,B01,188447,Hammock; Frances H,2,0,30,28
1683329718068,MATH 20D,B02,188486,Hammock; Frances H,7,0,30,23
1683329719094,MATH 20E,A01,188649,Staff,21,0,30,9
1683329719094,MATH 20E,A02,188650,Staff,23,0,30,7
1683329719094,MATH 20E,A03,188673,Staff,0,0,30,30
1683329720116,MATH 102,A01,188675,Staff,0,35,35,35
1683329721140,MATH 103B,A01,188681,Staff,3,0,35,32
1683329721140,MATH 103B,B01,188692,Staff,5,0,35,30
1683329722163,MATH 109,A01,188695,Salehi Golsefidy; Alireza,25,0,35,10
1683329722163,MATH 109,A02,188696,Salehi Golsefidy; Alireza,25,0,35,10
1683329723190,MATH 120A,A01,188698,Eggers; John Dietrich,7,0,35,28
1683329724214,MATH 142B,A01,188736,Ioana; Adrian,0,2,30,30
1683329724214,MATH 142B,A02,188741,Ioana; Adrian,1,1,30,29
1683329724214,MATH 142B,A03,188743,Ioana; Adrian,1,3,30,29
1683329725237,MATH 168A,A01,188790,Staff,0,9,35,35
1683329726264,MATH 170A,A01,188803,Nie; Jiawang,0,2,35,35
1683329726264,MATH 170A,A02,188811,Nie; Jiawang,0,0,35,35
1683329726264,MATH 170A,A03,188814,Nie; Jiawang,1,0,35,34
1683329726264,MATH 170A,A04,188815,Nie; Jiawang,13,0,35,22
1683329727288,MATH 193B,A01,188817,Staff,0,0,35,35
1683329727288,MATH 193B,A02,188818,Staff,5,0,35,30
1683329728310,MGT 4,A01,202857,Anderson; John Charles,62,0,80,18
1683329729334,MGT 12,A00,202858,Lindenberger; Wade Douglas,42,0,90,48
1683329730358,MGT 18,A00,202859,Staff,74,0,90,16
1683329731381,MGT 18GS,A00,202860,McKay; Michael J,13,0,28,15
1683329732413,MGT 45,A00,202861,Pecore; Joseph P.,14,0,90,76
1683329733437,MGT 100,A00,202863,Yavorsky; Daniel Ryan,28,0,90,62
1683329734463,MGT 103,A00,202864,Ehrich; Kristine R,1,18,90,89
1683329735494,MGT 112,A00,202865,Ehrich; Kristine R,15,0,90,75
1683329736518,MGT 121A,A00,202868,Staff,0,20,0,0
1683329737542,MGT 131B,A00,202869,Anderson; John Charles,59,0,90,31
1683329738566,MGT 136,A00,202871,Lindenberger; Wade Douglas,84,0,90,6
1683329739593,MGT 164,A00,202873,Staff,0,68,90,91
1683329740618,MGT 164GS,A00,202874,McKay; Mary A,13,0,28,15
1683329741645,MGT 180,A00,202875,Staff,0,50,90,91
1683329742671,MMW 11R,A01,205019,Herbst; Matthew,3,0,30,27
1683329742671,MMW 11R,A02,205026,Herbst; Matthew,29,0,30,1
1683329743701,MMW 15,A01,193512,Chang; Edmond Yi-Teh,0,9,28,28
1683329743701,MMW 15,A02,193513,Chang; Edmond Yi-Teh,0,5,28,28
1683329743701,MMW 15,A03,193514,Chang; Edmond Yi-Teh,0,5,28,28
1683329743701,MMW 15,A04,193515,Chang; Edmond Yi-Teh,0,5,28,28
1683329743701,MMW 15,A05,193516,Chang; Edmond Yi-Teh,0,4,28,28
1683329743701,MMW 15,A06,193517,Chang; Edmond Yi-Teh,0,5,28,28
1683329743701,MMW 15,B01,193519,Chang; Edmond Yi-Teh,0,5,28,28
1683329743701,MMW 15,B02,193520,Chang; Edmond Yi-Teh,0,5,28,28
1683329743701,MMW 15,B03,193521,Chang; Edmond Yi-Teh,0,5,28,28
1683329743701,MMW 15,B04,193522,Chang; Edmond Yi-Teh,0,4,28,28
1683329743701,MMW 15,B05,193523,Chang; Edmond Yi-Teh,0,5,28,28
1683329743701,MMW 15,B06,193524,Chang; Edmond Yi-Teh,0,4,28,28
1683329744725,MMW 122,A01,193526,Rahimi; Babak,0,15,28,28
1683329744725,MMW 122,A02,193527,Rahimi; Babak,0,14,28,28
1683329744725,MMW 122,A03,193528,Rahimi; Babak,0,0,0,0
1683329744725,MMW 122,A04,193529,Rahimi; Babak,0,0,0,0
1683329745750,MUS 1A,A01,186663,Staff,0,20,35,35
1683329746776,MUS 4,A01,186715,Staff,0,12,35,35
1683329747803,MUS 5R,A01,186796,Dubnov; Shlomo,0,17,35,35
1683329748830,MUS 6,A01,186798,Staff,0,4,25,25
1683329749856,MUS 7,A01,186830,Staff,12,0,35,23
1683329750880,MUS 8,A01,186930,Staff,0,26,35,35
1683329751904,MUS 15,A01,186932,Staff,0,16,35,35
1683329751904,MUS 15,B01,186934,Staff,0,15,35,35
1683329752933,MUS 80,A00,186935,Staff,1,0,20,19
1683329752933,MUS 80,B00,186936,Staff,25,0,25,0
1683329753960,NANO 11,A00,204702,Lipomi; Darren John,0,0,0,0
1683329754987,NANO 15,A01,204709,Yang; Kesong,0,1,0,0
1683329756016,NANO 114,A00,202069,Jahed Motlagh; Zeinab,3,0,10,7
1683329757040,PHIL 1,A00,186955,Grush; Rick Scott,32,0,40,8
1683329758068,PHIL 10,A01,186973,Grush; Rick Scott,28,0,35,7
1683329758068,PHIL 10,A02,186974,Grush; Rick Scott,33,0,35,2
1683329759094,PHIL 13,A01,186976,Staff,7,0,35,28
1683329759094,PHIL 13,A02,186977,Staff,16,0,35,19
1683329760119,PHIL 14,A01,186979,Staff,31,0,35,4
1683329760119,PHIL 14,A02,186986,Staff,32,0,35,3
1683329761146,PHIL 28,A01,186988,Staff,16,0,30,14
1683329761146,PHIL 28,A02,186989,Staff,1,0,30,29
1683329761146,PHIL 28,A03,186990,Staff,9,0,30,21
1683329761146,PHIL 28,A04,186991,Staff,26,0,30,4
1683329762175,PHIL 120,A00,186997,Staff,23,0,40,17
1683329763203,PHIL 137,A00,187003,Staff,9,0,40,31
1683329764226,PHIL 150,A00,187015,Staff,47,0,70,23
1683329765254,PHIL 167,A00,187021,Lamey; Andy M.,35,0,40,5
1683329766278,PHIL 174,A01,202226,Staff,17,0,20,3
1683329766278,PHIL 174,A02,202235,Staff,20,0,20,0
1683329767302,PHIL 191A,A00,258918,Staff,0,0,1,1
1683329768328,PHYS 1A,A00,187028,Staff,27,0,60,33
1683329769353,PHYS 1AL,001,187036,Staff,3,0,30,27
1683329769353,PHYS 1AL,002,187049,Staff,18,0,30,12
1683329770374,PHYS 1B,A00,187058,Staff,22,0,60,38
1683329771399,PHYS 1BL,001,187064,Staff,0,0,30,30
1683329771399,PHYS 1BL,002,187070,Staff,5,0,30,25
1683329772483,PHYS 1C,A00,187082,Staff,31,0,120,89
1683329773513,PHYS 1CL,001,187088,Staff,0,9,30,30
1683329773513,PHYS 1CL,002,187089,Staff,0,2,30,30
1683329773513,PHYS 1CL,009,262693,Staff,11,0,30,19
1683329774539,PHYS 2B,A01,187097,Staff,54,0,115,61
1683329775566,PHYS 2C,A01,187099,Staff,67,0,115,48
1683329776590,PHYS 2CL,A01,187101,Staff,5,0,28,23
1683329776590,PHYS 2CL,A02,187102,Staff,15,0,28,13
1683329777614,PHYS 2D,A01,187123,Shotwell; Brian,95,0,115,20
1683329778642,PHYS 4B,A01,187133,Grinstein; Benjamin,35,0,50,15
1683329779671,POLI 10,A00,188819,Staff,0,4,50,50
1683329780698,POLI 11,A00,188827,Staff,43,0,50,7
1683329781721,POLI 13R,A00,188828,Staff,0,1,20,20
1683329782748,POLI 27,A01,188830,Elgin; Samuel Zincke,0,1,70,70
1683329783772,POLI 30,A00,188832,Desposato; Scott,31,0,50,19
1683329784798,POLI 102F,A00,188834,Staff,3,0,40,37
1683329785823,POLI 104A,A00,188852,Staff,14,0,30,16
1683329786851,POLI 104I,A00,188853,Staff,0,6,20,20
1683329787879,POLI 110B,A00,188854,Wiens; David,7,0,20,13
1683329788905,POLI 112A,A00,188855,Wiens; David,5,0,30,25
1683329789932,POLI 117R,A00,188856,Forman; Fonna,0,11,20,20
1683329790958,POLI 118,A00,188857,Ingham; Sean,8,0,20,12
1683329791981,POLI 120G,A00,188858,Staff,9,0,30,21
1683329793006,POLI 131CR,A00,188863,Hoston; Germaine,24,0,50,26
1683329794030,POLI 133,A00,188864,Nellis; Gareth Hb,44,0,50,6
1683329795057,POLI 134D,A00,188865,Desposato; Scott,27,0,30,3
1683329796085,POLI 142A,A00,188871,Gartzke; Erik,22,0,50,28
1683329797110,POLI 142K,A00,188874,Staff,38,0,50,12
1683329798137,POLI 143,A00,188940,Gartzke; Erik,16,0,30,14
1683329799161,POLI 153,A00,188943,Staff,3,0,20,17
1683329800185,POLI 160AA,A00,188944,Staff,12,0,40,28
1683329801210,POLI 170A,A00,188945,Staff,11,0,30,19
1683329803262,PSYC 1,A00,188952,Staff,37,0,90,53
1683329804286,PSYC 2,B00,188953,Staff,19,0,35,16
1683329805315,PSYC 6,A00,188970,Staff,47,0,60,13
1683329806340,PSYC 7,A00,188973,Staff,37,0,45,8
1683329807376,PSYC 60,A01,188980,Rickard; Timothy C.,43,0,60,17
1683329808401,PSYC 70,A01,189001,Steiner; Eric Tomas,24,0,45,21
1683329809426,PSYC 100,A00,189005,Lacefield; Katharine I,0,100,120,120
1683329810453,PSYC 102,A00,189008,Staff,9,0,30,21
1683329811478,PSYC 106,B00,189026,Gorman; Michael R.,34,0,60,26
1683329812504,PSYC 114,B01,189033,Winkielman; Piotr,0,32,30,30
1683329813529,PSYC 131,A00,189036,Anagnostaras; Stephan,0,43,60,60
1683329814554,PSYC 136,A00,189041,Lowe; Angela Beth,0,7,25,25
1683329815578,PSYC 137,A00,189057,Winkielman; Piotr,0,34,25,25
1683329816608,PSYC 144,A00,189107,Wixted; John T,0,7,50,50
1683329818656,PSYC 162,A00,189142,Staff,0,8,85,85
1683329819680,PSYC 172,A00,189144,Gorman; Michael R.,0,7,30,30
1683329821732,PSYC 179,A00,189146,Lacefield; Katharine I,0,84,120,120
1683329822762,PSYC 181,A00,189147,Anagnostaras; Stephan,0,44,90,90
1683329823786,PSYC 190R,A00,189148,Barner; David A.,0,22,80,80
1683329824813,PSYC 191,A00,189275,Rickard; Timothy C.,0,7,25,25
1683329825838,PSYC 193,A00,189276,Chapman; Eddie Nathaniel,0,1,0,4
1683329826862,PSYC 193L,A01,189281,Lowe; Angela Beth,12,0,20,8
1683329826862,PSYC 193L,B01,189285,Staff,28,0,35,7
1683329827898,RELI 149,A00,187137,Rahimi; Babak,7,0,40,33
1683329828926,SE 9,A01,187315,Staff,0,2,18,18
1683329829952,SE 101B,A00,187409,Staff,24,0,30,6
1683329830977,SE 110B,A00,187444,Staff,10,0,40,30
1683329832006,SE 130B,A00,187449,Staff,31,0,40,9
1683329833033,SE 150A,A00,187516,Staff,9,0,20,11
1683329834060,SE 154,A00,187528,Staff,30,0,50,20
1683329835084,SIO 3,A01,258171,Staff,35,0,40,5
1683329836109,SIO 10,A00,187144,Cook; Geoffrey W,0,3,75,75
1683329837139,SIO 45,A00,187152,Cook; Geoffrey W,1,0,100,99
1683329838170,SIO 109R,A00,194486,Staff,0,3,20,20
1683329840218,SIO 187,A01,187233,Kacev; David,12,0,40,28
1683329841242,SOCI 1,A01,258656,Thorpe; Charles Robert,28,0,30,2
1683329841242,SOCI 1,A02,258658,Thorpe; Charles Robert,30,0,30,0
1683329841242,SOCI 1,A03,258661,Thorpe; Charles Robert,25,0,25,0
1683329841242,SOCI 1,A04,258666,Thorpe; Charles Robert,22,0,25,3
1683329841242,SOCI 1,A05,258897,Thorpe; Charles Robert,23,0,25,2
1683329841242,SOCI 1,A06,258898,Thorpe; Charles Robert,25,0,25,0
1683329842266,SOCI 30,A01,258903,Pardo Guerra; Juan Pablo,15,0,30,15
1683329843291,SOCI 102,A00,258904,Staff,9,0,25,16
1683329844317,SOCI 106,A00,258905,Staff,19,0,25,6
1683329845345,SOCI 111,A00,258907,Ribas Norris; Janet Vanesa,26,0,30,4
1683329846368,SOCI 121R,A00,258908,Pardo Guerra; Juan Pablo,10,0,30,20
1683329847396,SOCI 126,A01,203330,Staff,14,0,20,6
1683329848422,SOCI 131,A00,258909,Thorpe; Charles Robert,31,0,60,29
1683329849446,SOCI 135,A00,258910,Payne; Christine Anna,0,9,30,30
1683329850473,SOCI 157,A00,258911,Staff,12,0,30,18
1683329851500,SOCI 184,A00,258912,Staff,25,0,30,5
1683329852524,SOCI 188D,A00,258913,Staff,21,0,30,9
1683329853550,SYN 2,001,187529,Staff,10,0,16,6
1683329853550,SYN 2,002,201452,Staff,0,18,16,16
1683329853550,SYN 2,003,201469,Staff,3,0,16,13
1683329854578,SYN 100,A01,187531,Staff,0,9,20,20
1683329854578,SYN 100,B01,201491,Staff,0,12,20,20
1683329855602,TDAC 1,A00,189286,Walsh; Kim C.,3,0,20,17
1683329855602,TDAC 1,B00,189287,Harting; Carla Kelso,11,0,20,9
1683329856630,TDAC 101,A00,189300,Walsh; Kim C.,16,0,20,4
1683329856630,TDAC 101,B00,189301,Harting; Carla Kelso,18,0,20,2
1683329857657,TDAC 102,A00,189304,Basso; Beatrice,14,0,20,6
1683329858686,TDAC 108,A00,189305,Staff,18,0,20,2
1683329859711,TDDE 131,A00,189310,Staff,19,0,20,1
1683329859711,TDDE 131,B00,189314,Staff,19,0,20,1
1683329859711,TDDE 131,C00,189315,Staff,48,0,50,2
1683329859711,TDDE 131,D00,189316,Staff,14,0,15,1
1683329859711,TDDE 131,E00,204841,Staff,20,0,20,0
1683329860736,TDGE 10,A00,189289,Staff,30,0,50,20
1683329860736,TDGE 10,B00,189290,Havis; Allan,1,0,50,49
1683329861765,TDGE 11,A00,189291,Fulton; Julia,0,3,50,50
1683329861765,TDGE 11,B00,189292,Staff,20,0,25,5
1683329861765,TDGE 11,C00,260270,Staff,0,0,0,0
1683329862790,TDGE 25,A00,189294,Staff,3,0,20,17
1683329863815,TDGE 124,A00,189318,Fulton; Julia,0,8,50,50
1683329864838,TDGE 125,A00,189319,Staff,13,0,25,12
1683329864838,TDGE 125,B00,189320,Staff,23,0,25,2
1683329865866,TDGE 127,A00,189322,Havis; Allan,0,0,50,50
1683329866891,TDHT 101,A00,189323,Staff,18,0,25,7
1683329866891,TDHT 101,B00,189324,Staff,25,0,25,0
1683329867918,TDHT 102,A00,189325,Staff,49,0,50,1
1683329868944,TDMV 1,A00,189295,Arcidiacono; Kristin,19,0,30,11
1683329868944,TDMV 1,B00,189296,Caligagan; Maria T.,24,0,30,6
1683329869973,TDMV 2,A00,189297,Sammartano; Tonnie,28,0,30,2
1683329869973,TDMV 2,B00,189299,Arcidiacono; Kristin,24,0,30,6
1683329871001,TDMV 3,A00,204998,Rincon; Alicia,22,0,30,8
1683329872026,TDMV 120,A00,189458,Sammartano; Tonnie,28,0,30,2
1683329873050,TDMV 138,A00,189541,Jun; Grace Shin Hae,22,0,40,18
1683329874075,TDMV 142,A00,189717,Caligagan; Tony,23,0,30,7
1683329874075,TDMV 142,B00,189718,Caligagan; Maria T.,25,0,30,5
1683329875099,TMC 2,A01,187533,Staff,25,0,25,0
1683329875099,TMC 2,A02,187534,Staff,25,0,25,0
1683329876179,USP 1,A01,187536,Kwak; Nancy,0,16,25,25
1683329877204,USP 5,A01,187538,Staff,10,0,25,15
1683329878227,USP 101,A00,199253,Staff,0,4,0,0
1683329879252,USP 124,A00,187562,Boomhower; Matthew Charles,1,0,30,29
1683329880277,USP 138,A00,187582,Staff,20,0,25,5
1683329881301,USP 152,A01,187597,Staff,4,0,25,21
1683329882326,USP 153,A00,187598,Staff,19,0,25,6
1683329883350,USP 168,A00,187607,Kwak; Nancy,2,0,5,3
1683329884376,USP 173,A00,187619,Staff,4,0,25,21
1683329885404,USP 181,A00,187638,Staff,0,0,25,25
1683329886426,VIS 103,A00,187650,Cruz; Edwin Teddy,23,0,75,52
1683329887450,VIS 110D,A00,187669,Staff,12,0,22,10
1683329888478,VIS 127C,A00,187720,Shen; Kuiyi,67,0,146,79
1683329889506,VIS 149,A00,187731,Yoldas; Pinar,0,14,22,22
1683329890530,VIS 151,A01,188091,Staff,22,0,34,12
1683329890530,VIS 151,A02,188092,Staff,11,0,34,23
1683329891558,VIS 160B,A00,188093,Stalbaum; Brett,0,0,10,10
1683329893612,WCWP 10B,A00,201720,Staff,10,0,15,5
1683329893612,WCWP 10B,B00,201722,Staff,8,0,15,7
1683329894638,WCWP 100,A00,201725,Gagnon; Jeffrey C,0,0,2,2
1683329894638,WCWP 100,B00,201727,Staff,0,4,15,15
1683329897727,ANBI 133,A00,258401,Wilder; Linnea Lorene,34,0,40,6
1683329898754,ANBI 140,A00,258395,Hrvoj Mihic; Branka,18,0,25,7
1683329899782,ANSC 120,A00,258402,Bialecki; Jon Anthony,27,0,40,13
1683329900808,ANSC 144,A00,258400,Staff,14,0,40,26
1683329902863,ANSC 166,A00,258396,Parish; Steven Martin,157,0,175,18
1683329903887,ANSC 180,A00,193533,Staff,9,0,20,11
1683329904917,ANSC 188,A00,258397,Jassal; Aftab,33,0,40,7
1683329905944,ANTH 3,A01,258316,Staff,23,0,30,7
1683329906968,ANTH 5,A00,258394,Semendeferi; Ekaterini,16,0,20,4
1683329907996,ANTH 21,A01,258331,Staff,8,0,40,32
1683329909022,ANTH 103,A00,258398,Varma; Saiba,15,0,25,10
1683329910050,AWP 10,001,202034,Staff,0,0,0,0
1683329910050,AWP 10,002,202035,Staff,0,0,0,0
1683329910050,AWP 10,003,202036,Staff,0,0,0,0
1683329910050,AWP 10,004,202037,Staff,0,0,0,0
1683329910050,AWP 10,005,202038,Staff,0,0,0,0
1683329910050,AWP 10,006,202039,Staff,0,0,0,0
1683329910050,AWP 10,007,202040,Staff,0,0,0,0
1683329910050,AWP 10,008,202041,Staff,0,0,0,0
1683329910050,AWP 10,009,202042,Staff,0,0,0,0
1683329910050,AWP 10,010,202043,Staff,0,0,0,0
1683329910050,AWP 10,011,202044,Staff,0,0,0,0
1683329910050,AWP 10,012,202045,Staff,0,0,0,0
1683329910050,AWP 10,013,202046,Staff,0,0,0,0
1683329910050,AWP 10,014,202047,Staff,0,0,0,0
1683329910050,AWP 10,015,202048,Staff,0,0,0,0
1683329910050,AWP 10,016,202049,Staff,0,0,0,0
1683329910050,AWP 10,017,202050,Staff,0,0,0,0
1683329910050,AWP 10,018,202051,Staff,0,0,0,0
1683329910050,AWP 10,019,202052,Staff,0,0,0,0
1683329910050,AWP 10,020,202053,Staff,0,0,0,0
1683329910050,AWP 10,021,202054,Staff,0,0,0,0
1683329910050,AWP 10,022,202055,Staff,0,0,0,0
1683329910050,AWP 10,023,202056,Staff,0,0,0,0
1683329910050,AWP 10,024,202057,Staff,0,0,0,0
1683329910050,AWP 10,025,202058,Staff,0,0,0,0
1683329910050,AWP 10,026,202059,Staff,0,0,0,0
1683329911080,AWP 102,001,202032,Staff,0,0,0,0
1683329911080,AWP 102,002,202033,Staff,0,0,0,0
1683329912104,BENG 100,A01,254234,Taylor Amos; Alyssa C,31,0,40,9
1683329913132,BENG 196,001,270013,Engler; Adam J.,9999,0,9999,0
1683329914161,BICD 100R,A01,202018,Smith; Laurie,0,7,32,32
1683329914161,BICD 100R,A02,202019,Smith; Laurie,0,2,32,32
1683329914161,BICD 100R,A03,202020,Smith; Laurie,0,1,32,32
1683329914161,BICD 100R,A04,202021,Smith; Laurie,9,0,32,23
1683329914161,BICD 100R,A05,202022,Smith; Laurie,12,0,32,20
1683329915185,BICD 136,A01,193242,Gustafson-Brown; Cindy,0,2,32,32
1683329915185,BICD 136,A02,193244,Gustafson-Brown; Cindy,14,0,32,18
1683329916214,BIEB 102,A01,193249,Butler; Shannon Rhey,0,2,32,32
1683329916214,BIEB 102,A02,193251,Butler; Shannon Rhey,0,0,32,32
1683329916214,BIEB 102,A03,193253,Butler; Shannon Rhey,0,1,32,32
1683329916214,BIEB 102,A04,193255,Butler; Shannon Rhey,17,0,32,15
1683329916214,BIEB 102,A05,193265,Butler; Shannon Rhey,26,0,32,6
1683329916214,BIEB 102,A06,193269,Butler; Shannon Rhey,16,0,32,16
1683329918269,BIEB 150,A01,193274,Staff,0,0,32,32
1683329918269,BIEB 150,A02,193285,Staff,23,0,32,9
1683329919296,BIEB 194,A00,193286,Kurle; Carolyn M.,22,0,32,10
1683329920325,BILD 1,A01,192291,Staff,16,0,32,16
1683329920325,BILD 1,A02,192292,Staff,30,0,32,2
1683329920325,BILD 1,B01,192520,Reuther; Keefe,0,1,0,0
1683329920325,BILD 1,B02,192532,Reuther; Keefe,0,1,0,0
1683329921355,BILD 3,A01,192556,Butler; Shannon Rhey,0,0,32,32
1683329921355,BILD 3,A02,192581,Butler; Shannon Rhey,5,0,32,27
1683329921355,BILD 3,A03,192611,Butler; Shannon Rhey,23,0,32,9
1683329921355,BILD 3,A04,192612,Butler; Shannon Rhey,25,0,32,7
1683329921355,BILD 3,A05,192613,Butler; Shannon Rhey,27,0,32,5
1683329921355,BILD 3,A06,192679,Butler; Shannon Rhey,27,0,32,5
1683329921355,BILD 3,A07,192682,Butler; Shannon Rhey,22,0,32,10
1683329922387,BILD 4,A01,192836,Reuther; Keefe,0,0,24,24
1683329922387,BILD 4,A02,193044,Reuther; Keefe,4,0,24,20
1683329923414,BILD 10,A01,193142,Gustafson-Brown; Cindy,30,0,32,2
1683329923414,BILD 10,A02,193149,Gustafson-Brown; Cindy,31,0,32,1
1683329924442,BIMM 100,A01,193301,Staff,0,6,32,32
1683329924442,BIMM 100,A02,193312,Staff,0,5,32,32
1683329924442,BIMM 100,A03,193323,Staff,0,8,32,32
1683329925472,BIMM 101,A01,193329,McDonnell; Lisa Marie,0,3,24,24
1683329925472,BIMM 101,A02,193339,McDonnell; Lisa Marie,0,3,24,24
1683329925472,BIMM 101,B01,193354,McDonnell; Lisa Marie,0,3,24,24
1683329925472,BIMM 101,B02,193357,McDonnell; Lisa Marie,0,3,24,24
1683329926501,BIMM 110,A01,193377,Tat; John,0,11,32,32
1683329926501,BIMM 110,A02,193378,Tat; John,1,9,32,31
1683329927528,BIMM 120,A01,206116,Staff,0,0,32,32
1683329927528,BIMM 120,A02,206117,Staff,8,0,32,24
1683329927528,BIMM 120,A03,206121,Staff,21,0,32,11
1683329928553,BIPN 100,A01,193393,Park; Ji Young,0,14,32,32
1683329928553,BIPN 100,A02,193402,Park; Ji Young,0,13,32,32
1683329928553,BIPN 100,A03,193413,Park; Ji Young,0,14,32,32
1683329928553,BIPN 100,A04,193414,Park; Ji Young,0,13,32,32
1683329929586,BIPN 102,A01,193429,Staff,0,0,32,32
1683329929586,BIPN 102,A02,193438,Staff,22,0,32,10
1683329930610,BIPN 106,A01,193450,Reyes Gonzalez; Catalina,0,2,40,40
1683329931636,BIPN 134,A01,193465,Cooke; James Edward,0,0,32,32
1683329931636,BIPN 134,A02,193474,Cooke; James Edward,25,0,32,7
1683329931636,BIPN 134,A03,193485,Cooke; James Edward,29,0,32,3
1683329931636,BIPN 134,A04,193486,Cooke; James Edward,21,0,32,11
1683329931636,BIPN 134,A05,193491,Cooke; James Edward,31,0,32,1
1683329931636,BIPN 134,A06,193501,Cooke; James Edward,30,0,32,2
1683329931636,BIPN 134,A07,193510,Cooke; James Edward,29,0,32,3
1683329933690,BISP 194,A00,222522,Staff,14,0,32,18
1683329934716,CAT 124,A01,202407,Staff,20,0,25,5
1683329935746,CAT 125,A00,202408,Marchisotto; Jennifer Anne,4,0,20,16
1683329936774,CAT 125R,A00,202409,Smith; Lauryn Alissa,0,11,20,20
1683329936774,CAT 125R,B00,202410,Morales; Celeste Georgianna,0,11,20,20
1683329936774,CAT 125R,C00,202411,Irwin; Matthew Joseph,0,10,20,20
1683329937798,CENG 15,A01,204712,Yang; Kesong,0,1,0,0
1683329938823,CENG 114,A00,202070,Jahed Motlagh; Zeinab,5,0,20,15
1683329939852,CGS 105,A00,185477,Wesling; Megan E.,24,0,40,16
1683329940882,CGS 106,A00,185494,Staff,13,0,22,9
1683329941909,CGS 108,A00,185495,Staff,14,0,20,6
1683329942933,CGS 114,A00,185496,Staff,13,0,18,5
1683329943958,CGS 119,A00,185501,Staff,15,0,20,5
1683329944983,CGS 120,A00,185511,Staff,13,0,20,7
1683329946007,CHEM 4,A01,184675,Bussey; Thomas J,96,0,100,4
1683329947036,CHEM 6A,A01,184677,Staff,34,0,60,26
1683329948061,CHEM 6B,A01,184679,Staff,65,0,100,35
1683329949086,CHEM 6C,A01,184681,Bussey; Thomas J,1,0,50,49
1683329949086,CHEM 6C,A02,184682,Bussey; Thomas J,34,0,50,16
1683329950113,CHEM 40A,A01,184684,Albizati; Kim F.,37,0,100,63
1683329951143,CHEM 40B,A01,184686,Albizati; Kim F.,0,20,100,100
1683329952172,CHEM 41B,A01,184690,Staff,52,0,100,48
1683329953196,COGS 3,A01,184715,Boyle; Mary E. T.,0,25,40,40
1683329954222,COGS 14B,A01,185172,Staff,0,15,38,38
1683329955249,COGS 18,A01,184736,Staff,17,0,80,63
1683329956279,COGS 100,A01,184932,Staff,0,5,73,73
1683329957303,COGS 101A,A01,184935,Staff,0,39,30,30
1683329958328,COGS 101B,A01,184944,Staff,0,2,30,30
1683329959357,COGS 101C,A01,184946,Staff,0,12,30,30
1683329960382,COGS 102A,A01,184951,Johnson; Christine M.,2,0,40,38
1683329961406,COGS 107B,A01,184953,Mooshagian; Eric Frederick,0,50,40,40
1683329962434,COGS 118B,A01,184959,Gupta; Anjum,0,48,40,40
1683329963460,COGS 153,A00,184961,Staff,0,15,30,30
1683329964484,COGS 177,A00,184962,Staff,0,20,30,30
1683329965509,COGS 187A,A01,184969,Boyle; Mary E. T.,0,17,40,40
1683329966540,COMM 10,A01,185174,Staff,0,5,25,25
1683329966540,COMM 10,A02,185189,Staff,0,5,25,25
1683329966540,COMM 10,A03,269821,Staff,0,0,0,0
1683329967565,COMM 100B,A01,185475,Staff,0,0,0,2
1683329967565,COMM 100B,A02,185476,Staff,14,0,25,11
1683329968588,COMM 100C,A01,185314,Staff,1,0,25,24
1683329968588,COMM 100C,A02,185327,Staff,19,0,25,6
1683329969616,COMM 110M,A00,185349,Staff,2,0,40,38
1683329970641,COMM 113T,A00,185352,Staff,24,0,40,16
1683329971672,COMM 114I,A00,185353,Staff,33,0,40,7
1683329972696,COMM 131,A00,185354,Staff,19,0,30,11
1683329973722,CSE 8A,A50,185358,Cao; Yingjun,0,46,10,10
1683329974747,CSE 8B,A01,185362,Staff,1,47,50,49
1683329975773,CSE 11,A01,185416,Cao; Yingjun,0,92,10,10
1683329976801,CSE 20,A01,185445,Briones; Jor-el Thomas Caparas,5,0,25,20
1683329977833,CSE 21,A01,185447,Staff,10,0,50,40
1683329978863,CSE 101,A01,185451,Staff,0,12,50,50
1683329978863,CSE 101,B01,185453,Jones; Miles E,0,11,50,50
1683329980970,CSE 141,A01,185458,Eldon; John,20,0,100,80
1683329981994,CSE 141L,A01,185461,Eldon; John,12,0,100,88
1683329983019,CSE 142,A01,185463,Staff,36,0,60,24
1683329983019,CSE 142,B01,201355,Staff,0,7,60,60
1683329984044,CSE 142L,A01,185470,Staff,36,0,60,24
1683329984044,CSE 142L,B01,201417,Staff,0,6,60,60
1683329985068,CSE 190,A00,201433,Staff,32,0,49,17
1683329986093,DOC 1,A01,259136,Strom; Megan C.,7,0,15,8
1683329986093,DOC 1,A02,259137,Strom; Megan C.,14,0,15,1
1683329986093,DOC 1,A03,259138,Strom; Megan C.,14,0,15,1
1683329986093,DOC 1,A04,259139,Strom; Megan C.,14,0,15,1
1683329987118,DOC 100D,A00,259140,Pass; Natalye Joann,16,0,25,9
1683329988142,DSGN 1,A01,184749,Rill; Bryan,0,25,30,30
1683329989166,DSGN 100,A01,185168,Staff,0,2,25,25
1683329990193,ECE 5,A01,185626,Morris; Karcher William,0,10,0,0
1683329991220,ECE 101,A01,185628,Staff,17,0,70,53
1683329992246,ECE 107,A01,185635,Baghdadchi; Saharnaz,0,0,20,20
1683329992246,ECE 107,A02,185638,Baghdadchi; Saharnaz,4,0,20,16
1683329993273,ECE 148,A01,185647,Silberman; Jack,0,0,16,16
1683329994297,ECON 1,A01,185537,Crane; Meredith Helen,54,0,70,16
1683329995322,ECON 3,A01,185549,Crane; Meredith Helen,33,0,70,37
1683329996347,ECON 4,A01,203354,Anderson; John Charles,0,4,10,10
1683329997371,ECON 100A,A01,185574,Staff,0,4,40,40
1683329998396,ECON 100B,A01,185576,Staff,10,22,50,40
1683329999420,ECON 100C,A01,185589,Newhouse; Herbert S,30,0,70,40
1683330000447,ECON 105,A00,185608,Vespa; Emanuel Ignacio,19,0,35,16
1683330001472,ECON 109,A01,185610,Shishkin; Denis,10,0,35,25
1683330002495,ECON 110A,A01,185612,Staff,11,0,40,29
1683330003519,ECON 120A,A01,185615,Staff,20,0,40,20
1683330004550,ECON 120C,A01,185617,Sun; Yixiao,0,20,70,70
1683330005580,ECON 144,A00,203346,Squires; Dale E,3,0,35,32
1683330006604,ECON 171,A01,203349,Newhouse; Herbert S,0,1,35,35
1683330007629,ECON 173A,A01,185621,Toda; Alexis Akira,21,0,35,14
1683330008662,EDS 25,A01,202413,Staff,0,1,0,0
1683330008662,EDS 25,A02,202414,Staff,0,1,0,0
1683330008662,EDS 25,A03,202415,Staff,0,0,0,0
1683330008662,EDS 25,A04,202416,Staff,0,1,0,0
1683330008662,EDS 25,A05,202439,Staff,0,0,0,0
1683330008662,EDS 25,A06,202440,Staff,0,0,0,0
1683330008662,EDS 25,B01,202631,Staff,0,0,0,0
1683330008662,EDS 25,B02,202632,Staff,0,0,0,0
1683330008662,EDS 25,B03,202639,Staff,0,0,0,0
1683330008662,EDS 25,B04,202640,Staff,0,0,0,0
1683330008662,EDS 25,B05,202643,Staff,0,0,0,0
1683330008662,EDS 25,B06,202644,Staff,0,0,0,0
1683330009690,EDS 38,A01,202659,Black; Alison Michelle,24,0,25,1
1683330010714,EDS 115,A00,202652,Staff,17,0,30,13
1683330011738,EDS 125,A00,202649,Staff,14,0,30,16
1683330012763,EDS 126,A01,203332,Staff,30,0,30,0
1683330013790,EDS 139,A00,202838,Staff,16,0,25,9
1683330014813,EDS 146,A01,202655,Staff,14,0,25,11
1683330015846,ENG 15,A00,185667,Staff,0,1,0,0
1683330015846,ENG 15,B00,185672,Staff,0,0,0,0
1683330015846,ENG 15,C00,185675,Staff,0,0,0,0
1683330015846,ENG 15,D00,185682,Staff,0,0,0,0
1683330015846,ENG 15,E00,185684,Staff,0,0,0,0
1683330016876,ETHN 103,A00,185710,Staff,0,3,35,35
1683330017903,ETHN 103A,A00,199228,Man; Simeon S,2,0,9,7
1683330018927,ETHN 109,A00,185711,Staff,18,0,35,17
1683330019950,ETHN 142,A00,185726,Staff,0,4,30,30
1683330020977,ETHN 163J,A00,199229,Man; Simeon S,5,0,8,3
1683330022000,ETHN 168,A00,185727,Staff,8,0,10,2
1683330023026,ETHN 182,A00,185728,Staff,1,0,35,34
1683330024054,ETHN 183,A00,185737,Staff,8,0,18,10
1683330025081,GLBH 111,A01,209361,Burgos; Jose L.,0,0,0,0
1683330027132,HIEU 104,A00,185792,Staff,16,0,20,4
1683330028156,HIEU 115,A00,185800,Staff,1,0,20,19
1683330029184,HIEU 128,A00,185801,Staff,0,7,20,20
1683330030209,HIEU 147,A00,185802,Staff,16,0,20,4
1683330031233,HIEU 154,A00,185823,Staff,12,0,20,8
1683330032263,HILA 102,A00,185826,Staff,13,0,20,7
1683330033289,HILD 2C,A01,185778,Staff,0,12,20,20
1683330034316,HILD 7B,A01,185780,Kwak; Nancy,0,15,32,32
1683330034316,HILD 7B,A02,185781,Kwak; Nancy,0,18,32,32
1683330035340,HILD 30,A01,185791,Staff,14,0,20,6
1683330036365,HISC 119,A00,185830,Golan; Tal,0,9,20,20
1683330037388,HITO 156GS,A00,185831,Patterson; Patrick H.,0,0,0,23
1683330038416,HIUS 103,A00,185832,Man; Simeon S,0,6,20,20
1683330039439,HIUS 117,A00,185836,Kwak; Nancy,2,0,20,18
1683330040463,HIUS 125,A00,185840,Man; Simeon S,0,0,23,23
1683330041489,HIUS 149,A00,185845,Staff,0,0,20,20
1683330042517,HUM 3,A01,185882,Zavodny; Tatiana Sophia,0,7,50,50
1683330042517,HUM 3,B01,185899,Caldwell; Michael Alan,0,18,50,50
1683330043544,HUM 3GS,A00,185900,Patterson; Patrick H.,0,0,0,23
1683330044568,HUM 4,A01,185938,Zroka; Amy Liane,31,0,50,19
1683330044568,HUM 4,B01,185956,Watkins; Eric,0,2,50,50
1683330044568,HUM 4,B02,202209,Watkins; Eric,0,2,50,50
1683330044568,HUM 4,B03,202210,Watkins; Eric,0,2,50,50
1683330045597,HUM 5,A01,185958,West; Geoffrey Scott,3,0,50,47
1683330045597,HUM 5,A02,202215,West; Geoffrey Scott,0,0,50,50
1683330046620,INTL 190,A00,185959,Gagnon; Jeffrey C,0,0,0,9
1683330046620,INTL 190,B00,185960,Lettieri; Michael Joseph,0,0,0,1
1683330047647,JAPN 180,A00,254509,Staff,5,1,30,25
1683330048676,LATI 10,A01,202853,Kennemore; Amy Michelle,4,0,35,31
1683330048676,LATI 10,A02,202854,Kennemore; Amy Michelle,2,0,35,33
1683330048676,LATI 10,A03,270054,Kennemore; Amy Michelle,30,0,30,0
1683330049702,LATI 180,A00,202855,Kennemore; Amy Michelle,11,0,20,9
1683330050727,LAWS 101,A00,201767,Golan; Tal,0,7,40,40
1683330051750,LIFR 1C,A00,185961,Staff,6,0,20,14
1683330052775,LIFR 1CX,A00,185962,Staff,7,0,20,13
1683330053798,LIFR 1D,A00,185963,Staff,9,0,20,11
1683330054823,LIFR 1DX,A00,185964,Staff,9,0,20,11
1683330055847,LIGN 101,A01,186039,Staff,43,0,50,7
1683330056871,LIGN 165,A00,186040,Staff,18,0,50,32
1683330057896,LTCS 108,A00,186041,Staff,6,0,10,4
1683330058923,LTCS 119,A00,186042,Staff,16,0,20,4
1683330059951,LTCS 130,A00,186043,Wesling; Megan E.,15,0,25,10
1683330062002,LTEA 138,A00,186119,Staff,14,0,40,26
1683330063029,LTEN 124,A00,186148,Staff,6,0,25,19
1683330064054,LTEN 178,A00,186149,Staff,7,0,15,8
1683330065078,LTEN 181,A00,186150,Blanco; John D,33,0,40,7
1683330066109,LTWL 120,A00,186160,Staff,20,0,25,5
1683330067137,LTWL 165,A00,186161,Staff,22,0,25,3
1683330068163,LTWR 100,A00,186162,Staff,0,5,15,15
1683330069187,LTWR 102,A00,186163,Doller; Ben,5,0,15,10
1683330070211,MAE 8,A01,186412,Staff,0,0,0,0
1683330071239,MAE 30B,A00,186445,Bahadori; Mohammad Yousef,83,0,100,17
1683330072267,MAE 40,A00,186592,Bewley; Thomas R,9,0,50,41
1683330073294,MAE 101B,A00,186593,Bahadori; Mohammad Yousef,81,0,100,19
1683330074322,MAE 105,A00,186594,Bandaru; Prabhakar,12,0,50,38
1683330075346,MAE 107,A00,186599,Pham; Hieu Tan,0,6,120,120
1683330076373,MAE 148,A01,186660,Silberman; Jack,3,0,16,13
1683330077401,MATH 10A,A01,188095,Staff,1,6,35,34
1683330078426,MATH 10B,A01,188097,Bowers; Adam R.,0,11,30,30
1683330078426,MATH 10B,A02,188099,Bowers; Adam R.,0,11,30,30
1683330078426,MATH 10B,B01,188104,Bowers; Adam R.,0,10,30,30
1683330078426,MATH 10B,B02,188106,Bowers; Adam R.,0,10,30,30
1683330079451,MATH 10C,A01,188111,Staff,0,18,30,30
1683330079451,MATH 10C,A02,188127,Staff,0,17,30,30
1683330079451,MATH 10C,A03,188131,Staff,0,18,30,30
1683330079451,MATH 10C,B01,188218,Staff,18,0,30,12
1683330079451,MATH 10C,B02,188244,Staff,13,0,30,17
1683330079451,MATH 10C,B03,188277,Staff,16,0,30,14
1683330080479,MATH 18,A01,188344,Bach; Quang Tran,18,0,30,12
1683330080479,MATH 18,A02,188345,Bach; Quang Tran,11,0,30,19
1683330080479,MATH 18,B01,188353,Bach; Quang Tran,10,0,30,20
1683330080479,MATH 18,B02,188354,Bach; Quang Tran,20,0,30,10
1683330081503,MATH 20A,A01,188374,Staff,13,0,35,22
1683330082529,MATH 20B,A01,188382,Ohm; Ko Woon,6,0,30,24
1683330082529,MATH 20B,A02,188383,Ohm; Ko Woon,22,0,30,8
1683330082529,MATH 20B,B01,188385,Ohm; Ko Woon,7,0,30,23
1683330082529,MATH 20B,B02,188392,Ohm; Ko Woon,22,0,30,8
1683330083609,MATH 20C,A01,188394,Harel; Guershon,10,0,30,20
1683330083609,MATH 20C,A02,188395,Harel; Guershon,15,0,30,15
1683330083609,MATH 20C,B01,188404,Harel; Guershon,5,0,30,25
1683330083609,MATH 20C,B02,188405,Harel; Guershon,19,0,30,11
1683330084639,MATH 20D,A01,188414,Hammock; Frances H,0,1,30,30
1683330084639,MATH 20D,A02,188415,Hammock; Frances H,3,0,30,27
1683330084639,MATH 20D,B01,188447,Hammock; Frances H,1,0,30,29
1683330084639,MATH 20D,B02,188486,Hammock; Frances H,8,0,30,22
1683330085662,MATH 20E,A01,188649,Staff,21,0,30,9
1683330085662,MATH 20E,A02,188650,Staff,23,0,30,7
1683330085662,MATH 20E,A03,188673,Staff,0,0,30,30
1683330086690,MATH 102,A01,188675,Staff,0,35,35,35
1683330087718,MATH 103B,A01,188681,Staff,3,0,35,32
1683330087718,MATH 103B,B01,188692,Staff,5,0,35,30
1683330088743,MATH 109,A01,188695,Salehi Golsefidy; Alireza,25,0,35,10
1683330088743,MATH 109,A02,188696,Salehi Golsefidy; Alireza,25,0,35,10
1683330089773,MATH 120A,A01,188698,Eggers; John Dietrich,7,0,35,28
1683330090802,MATH 142B,A01,188736,Ioana; Adrian,0,2,30,30
1683330090802,MATH 142B,A02,188741,Ioana; Adrian,1,1,30,29
1683330090802,MATH 142B,A03,188743,Ioana; Adrian,1,3,30,29
1683330091828,MATH 168A,A01,188790,Staff,0,9,35,35
1683330092853,MATH 170A,A01,188803,Nie; Jiawang,0,2,35,35
1683330092853,MATH 170A,A02,188811,Nie; Jiawang,0,0,35,35
1683330092853,MATH 170A,A03,188814,Nie; Jiawang,1,0,35,34
1683330092853,MATH 170A,A04,188815,Nie; Jiawang,13,0,35,22
1683330093881,MATH 193B,A01,188817,Staff,0,0,35,35
1683330093881,MATH 193B,A02,188818,Staff,5,0,35,30
1683330094905,MGT 4,A01,202857,Anderson; John Charles,62,0,80,18
1683330095932,MGT 12,A00,202858,Lindenberger; Wade Douglas,42,0,90,48
1683330096956,MGT 18,A00,202859,Staff,74,0,90,16
1683330097983,MGT 18GS,A00,202860,McKay; Michael J,13,0,28,15
1683330099011,MGT 45,A00,202861,Pecore; Joseph P.,14,0,90,76
1683330100038,MGT 100,A00,202863,Yavorsky; Daniel Ryan,28,0,90,62
1683330101062,MGT 103,A00,202864,Ehrich; Kristine R,1,18,90,89
1683330102087,MGT 112,A00,202865,Ehrich; Kristine R,15,0,90,75
1683330103112,MGT 121A,A00,202868,Staff,0,20,0,0
1683330104137,MGT 131B,A00,202869,Anderson; John Charles,59,0,90,31
1683330105161,MGT 136,A00,202871,Lindenberger; Wade Douglas,84,0,90,6
1683330106188,MGT 164,A00,202873,Staff,0,68,90,91
1683330107210,MGT 164GS,A00,202874,McKay; Mary A,13,0,28,15
1683330108235,MGT 180,A00,202875,Staff,0,50,90,91
1683330109262,MMW 11R,A01,205019,Herbst; Matthew,3,0,30,27
1683330109262,MMW 11R,A02,205026,Herbst; Matthew,29,0,30,1
1683330110291,MMW 15,A01,193512,Chang; Edmond Yi-Teh,0,9,28,28
1683330110291,MMW 15,A02,193513,Chang; Edmond Yi-Teh,0,5,28,28
1683330110291,MMW 15,A03,193514,Chang; Edmond Yi-Teh,0,5,28,28
1683330110291,MMW 15,A04,193515,Chang; Edmond Yi-Teh,0,5,28,28
1683330110291,MMW 15,A05,193516,Chang; Edmond Yi-Teh,0,4,28,28
1683330110291,MMW 15,A06,193517,Chang; Edmond Yi-Teh,0,5,28,28
1683330110291,MMW 15,B01,193519,Chang; Edmond Yi-Teh,0,5,28,28
1683330110291,MMW 15,B02,193520,Chang; Edmond Yi-Teh,0,5,28,28
1683330110291,MMW 15,B03,193521,Chang; Edmond Yi-Teh,0,5,28,28
1683330110291,MMW 15,B04,193522,Chang; Edmond Yi-Teh,0,4,28,28
1683330110291,MMW 15,B05,193523,Chang; Edmond Yi-Teh,0,5,28,28
1683330110291,MMW 15,B06,193524,Chang; Edmond Yi-Teh,0,4,28,28
1683330111316,MMW 122,A01,193526,Rahimi; Babak,0,15,28,28
1683330111316,MMW 122,A02,193527,Rahimi; Babak,0,14,28,28
1683330111316,MMW 122,A03,193528,Rahimi; Babak,0,0,0,0
1683330111316,MMW 122,A04,193529,Rahimi; Babak,0,0,0,0
1683330112343,MUS 1A,A01,186663,Staff,0,20,35,35
1683330113372,MUS 4,A01,186715,Staff,0,12,35,35
1683330114400,MUS 5R,A01,186796,Dubnov; Shlomo,0,17,35,35
1683330115428,MUS 6,A01,186798,Staff,0,4,25,25
1683330116452,MUS 7,A01,186830,Staff,12,0,35,23
1683330117479,MUS 8,A01,186930,Staff,0,26,35,35
1683330118507,MUS 15,A01,186932,Staff,0,16,35,35
1683330118507,MUS 15,B01,186934,Staff,0,15,35,35
1683330119539,MUS 80,A00,186935,Staff,1,0,20,19
1683330119539,MUS 80,B00,186936,Staff,25,0,25,0
1683330120569,NANO 11,A00,204702,Lipomi; Darren John,0,0,0,0
1683330121597,NANO 15,A01,204709,Yang; Kesong,0,1,0,0
1683330122624,NANO 114,A00,202069,Jahed Motlagh; Zeinab,3,0,10,7
1683330123651,PHIL 1,A00,186955,Grush; Rick Scott,32,0,40,8
1683330124675,PHIL 10,A01,186973,Grush; Rick Scott,28,0,35,7
1683330124675,PHIL 10,A02,186974,Grush; Rick Scott,33,0,35,2
1683330125703,PHIL 13,A01,186976,Staff,7,0,35,28
1683330125703,PHIL 13,A02,186977,Staff,16,0,35,19
1683330126728,PHIL 14,A01,186979,Staff,31,0,35,4
1683330126728,PHIL 14,A02,186986,Staff,32,0,35,3
1683330127751,PHIL 28,A01,186988,Staff,16,0,30,14
1683330127751,PHIL 28,A02,186989,Staff,1,0,30,29
1683330127751,PHIL 28,A03,186990,Staff,9,0,30,21
1683330127751,PHIL 28,A04,186991,Staff,26,0,30,4
1683330128775,PHIL 120,A00,186997,Staff,23,0,40,17
1683330129802,PHIL 137,A00,187003,Staff,9,0,40,31
1683330130828,PHIL 150,A00,187015,Staff,47,0,70,23
1683330131855,PHIL 167,A00,187021,Lamey; Andy M.,35,0,40,5
1683330132885,PHIL 174,A01,202226,Staff,17,0,20,3
1683330132885,PHIL 174,A02,202235,Staff,20,0,20,0
1683330133913,PHIL 191A,A00,258918,Staff,0,0,1,1
1683330134938,PHYS 1A,A00,187028,Staff,27,0,60,33
1683330135963,PHYS 1AL,001,187036,Staff,3,0,30,27
1683330135963,PHYS 1AL,002,187049,Staff,18,0,30,12
1683330136987,PHYS 1B,A00,187058,Staff,22,0,60,38
1683330138016,PHYS 1BL,001,187064,Staff,0,0,30,30
1683330138016,PHYS 1BL,002,187070,Staff,5,0,30,25
1683330139040,PHYS 1C,A00,187082,Staff,31,0,120,89
1683330140068,PHYS 1CL,001,187088,Staff,0,9,30,30
1683330140068,PHYS 1CL,002,187089,Staff,0,2,30,30
1683330140068,PHYS 1CL,009,262693,Staff,11,0,30,19
1683330141095,PHYS 2B,A01,187097,Staff,54,0,115,61
1683330142120,PHYS 2C,A01,187099,Staff,67,0,115,48
1683330143149,PHYS 2CL,A01,187101,Staff,5,0,28,23
1683330143149,PHYS 2CL,A02,187102,Staff,15,0,28,13
1683330144173,PHYS 2D,A01,187123,Shotwell; Brian,95,0,115,20
1683330145198,PHYS 4B,A01,187133,Grinstein; Benjamin,35,0,50,15
1683330146222,POLI 10,A00,188819,Staff,0,4,50,50
1683330147246,POLI 11,A00,188827,Staff,43,0,50,7
1683330148269,POLI 13R,A00,188828,Staff,0,1,20,20
1683330149297,POLI 27,A01,188830,Elgin; Samuel Zincke,0,1,70,70
1683330150321,POLI 30,A00,188832,Desposato; Scott,31,0,50,19
1683330151345,POLI 102F,A00,188834,Staff,3,0,40,37
1683330152369,POLI 104A,A00,188852,Staff,14,0,30,16
1683330153397,POLI 104I,A00,188853,Staff,0,6,20,20
1683330154422,POLI 110B,A00,188854,Wiens; David,7,0,20,13
1683330155445,POLI 112A,A00,188855,Wiens; David,5,0,30,25
1683330156469,POLI 117R,A00,188856,Forman; Fonna,0,11,20,20
1683330157497,POLI 118,A00,188857,Ingham; Sean,8,0,20,12
1683330158525,POLI 120G,A00,188858,Staff,9,0,30,21
1683330159551,POLI 131CR,A00,188863,Hoston; Germaine,24,0,50,26
1683330160575,POLI 133,A00,188864,Nellis; Gareth Hb,44,0,50,6
1683330161600,POLI 134D,A00,188865,Desposato; Scott,27,0,30,3
1683330162625,POLI 142A,A00,188871,Gartzke; Erik,22,0,50,28
1683330163649,POLI 142K,A00,188874,Staff,38,0,50,12
1683330164674,POLI 143,A00,188940,Gartzke; Erik,16,0,30,14
1683330165698,POLI 153,A00,188943,Staff,3,0,20,17
1683330166725,POLI 160AA,A00,188944,Staff,12,0,40,28
1683330167750,POLI 170A,A00,188945,Staff,11,0,30,19
1683330169801,PSYC 1,A00,188952,Staff,37,0,90,53
1683330170828,PSYC 2,B00,188953,Staff,19,0,35,16
1683330171856,PSYC 6,A00,188970,Staff,47,0,60,13
1683330172880,PSYC 7,A00,188973,Staff,37,0,45,8
1683330173908,PSYC 60,A01,188980,Rickard; Timothy C.,43,0,60,17
1683330174936,PSYC 70,A01,189001,Steiner; Eric Tomas,24,0,45,21
1683330175963,PSYC 100,A00,189005,Lacefield; Katharine I,0,100,120,120
1683330176987,PSYC 102,A00,189008,Staff,9,0,30,21
1683330178015,PSYC 106,B00,189026,Gorman; Michael R.,34,0,60,26
1683330179046,PSYC 114,B01,189033,Winkielman; Piotr,0,32,30,30
1683330180075,PSYC 131,A00,189036,Anagnostaras; Stephan,0,43,60,60
1683330181104,PSYC 136,A00,189041,Lowe; Angela Beth,0,7,25,25
1683330182133,PSYC 137,A00,189057,Winkielman; Piotr,0,34,25,25
1683330183160,PSYC 144,A00,189107,Wixted; John T,0,7,50,50
1683330185208,PSYC 162,A00,189142,Staff,0,8,85,85
1683330186231,PSYC 172,A00,189144,Gorman; Michael R.,0,7,30,30
1683330188336,PSYC 179,A00,189146,Lacefield; Katharine I,0,84,120,120
1683330189364,PSYC 181,A00,189147,Anagnostaras; Stephan,0,44,90,90
1683330190389,PSYC 190R,A00,189148,Barner; David A.,0,22,80,80
1683330191413,PSYC 191,A00,189275,Rickard; Timothy C.,0,7,25,25
1683330192437,PSYC 193,A00,189276,Chapman; Eddie Nathaniel,0,1,0,4
1683330193462,PSYC 193L,A01,189281,Lowe; Angela Beth,12,0,20,8
1683330193462,PSYC 193L,B01,189285,Staff,28,0,35,7
1683330194487,RELI 149,A00,187137,Rahimi; Babak,7,0,40,33
1683330195511,SE 9,A01,187315,Staff,0,2,18,18
1683330196535,SE 101B,A00,187409,Staff,24,0,30,6
1683330197562,SE 110B,A00,187444,Staff,10,0,40,30
1683330198587,SE 130B,A00,187449,Staff,31,0,40,9
1683330199615,SE 150A,A00,187516,Staff,9,0,20,11
1683330200642,SE 154,A00,187528,Staff,30,0,50,20
1683330201669,SIO 3,A01,258171,Staff,35,0,40,5
1683330202693,SIO 10,A00,187144,Cook; Geoffrey W,0,3,75,75
1683330203718,SIO 45,A00,187152,Cook; Geoffrey W,1,0,100,99
1683330204750,SIO 109R,A00,194486,Staff,0,3,20,20
1683330206808,SIO 187,A01,187233,Kacev; David,12,0,40,28
1683330207839,SOCI 1,A01,258656,Thorpe; Charles Robert,28,0,30,2
1683330207839,SOCI 1,A02,258658,Thorpe; Charles Robert,30,0,30,0
1683330207839,SOCI 1,A03,258661,Thorpe; Charles Robert,25,0,25,0
1683330207839,SOCI 1,A04,258666,Thorpe; Charles Robert,22,0,25,3
1683330207839,SOCI 1,A05,258897,Thorpe; Charles Robert,23,0,25,2
1683330207839,SOCI 1,A06,258898,Thorpe; Charles Robert,25,0,25,0
1683330208863,SOCI 30,A01,258903,Pardo Guerra; Juan Pablo,15,0,30,15
1683330209890,SOCI 102,A00,258904,Staff,9,0,25,16
1683330210917,SOCI 106,A00,258905,Staff,19,0,25,6
1683330211942,SOCI 111,A00,258907,Ribas Norris; Janet Vanesa,26,0,30,4
1683330212970,SOCI 121R,A00,258908,Pardo Guerra; Juan Pablo,10,0,30,20
1683330214000,SOCI 126,A01,203330,Staff,14,0,20,6
1683330215028,SOCI 131,A00,258909,Thorpe; Charles Robert,31,0,60,29
1683330216053,SOCI 135,A00,258910,Payne; Christine Anna,0,9,30,30
1683330217075,SOCI 157,A00,258911,Staff,12,0,30,18
1683330218100,SOCI 184,A00,258912,Staff,25,0,30,5
1683330219125,SOCI 188D,A00,258913,Staff,21,0,30,9
1683330220153,SYN 2,001,187529,Staff,10,0,16,6
1683330220153,SYN 2,002,201452,Staff,0,18,16,16
1683330220153,SYN 2,003,201469,Staff,3,0,16,13
1683330221180,SYN 100,A01,187531,Staff,0,9,20,20
1683330221180,SYN 100,B01,201491,Staff,0,12,20,20
1683330222202,TDAC 1,A00,189286,Walsh; Kim C.,3,0,20,17
1683330222202,TDAC 1,B00,189287,Harting; Carla Kelso,11,0,20,9
1683330223225,TDAC 101,A00,189300,Walsh; Kim C.,16,0,20,4
1683330223225,TDAC 101,B00,189301,Harting; Carla Kelso,18,0,20,2
1683330224248,TDAC 102,A00,189304,Basso; Beatrice,14,0,20,6
1683330225271,TDAC 108,A00,189305,Staff,18,0,20,2
1683330226296,TDDE 131,A00,189310,Staff,19,0,20,1
1683330226296,TDDE 131,B00,189314,Staff,19,0,20,1
1683330226296,TDDE 131,C00,189315,Staff,48,0,50,2
1683330226296,TDDE 131,D00,189316,Staff,14,0,15,1
1683330226296,TDDE 131,E00,204841,Staff,20,0,20,0
1683330227320,TDGE 10,A00,189289,Staff,30,0,50,20
1683330227320,TDGE 10,B00,189290,Havis; Allan,1,0,50,49
1683330228345,TDGE 11,A00,189291,Fulton; Julia,0,3,50,50
1683330228345,TDGE 11,B00,189292,Staff,20,0,25,5
1683330228345,TDGE 11,C00,260270,Staff,0,0,0,0
1683330229370,TDGE 25,A00,189294,Staff,3,0,20,17
1683330230397,TDGE 124,A00,189318,Fulton; Julia,0,8,50,50
1683330231423,TDGE 125,A00,189319,Staff,13,0,25,12
1683330231423,TDGE 125,B00,189320,Staff,23,0,25,2
1683330232446,TDGE 127,A00,189322,Havis; Allan,0,0,50,50
1683330233470,TDHT 101,A00,189323,Staff,18,0,25,7
1683330233470,TDHT 101,B00,189324,Staff,25,0,25,0
1683330234494,TDHT 102,A00,189325,Staff,49,0,50,1
1683330235518,TDMV 1,A00,189295,Arcidiacono; Kristin,19,0,30,11
1683330235518,TDMV 1,B00,189296,Caligagan; Maria T.,24,0,30,6
1683330236547,TDMV 2,A00,189297,Sammartano; Tonnie,28,0,30,2
1683330236547,TDMV 2,B00,189299,Arcidiacono; Kristin,24,0,30,6
1683330237574,TDMV 3,A00,204998,Rincon; Alicia,22,0,30,8
1683330238600,TDMV 120,A00,189458,Sammartano; Tonnie,28,0,30,2
1683330239628,TDMV 138,A00,189541,Jun; Grace Shin Hae,22,0,40,18
1683330240651,TDMV 142,A00,189717,Caligagan; Tony,23,0,30,7
1683330240651,TDMV 142,B00,189718,Caligagan; Maria T.,25,0,30,5
1683330241678,TMC 2,A01,187533,Staff,25,0,25,0
1683330241678,TMC 2,A02,187534,Staff,25,0,25,0
1683330242705,USP 1,A01,187536,Kwak; Nancy,0,16,25,25
1683330243733,USP 5,A01,187538,Staff,10,0,25,15
1683330244757,USP 101,A00,199253,Staff,0,4,0,0
1683330245780,USP 124,A00,187562,Boomhower; Matthew Charles,1,0,30,29
1683330246808,USP 138,A00,187582,Staff,20,0,25,5
1683330247832,USP 152,A01,187597,Staff,4,0,25,21
1683330248856,USP 153,A00,187598,Staff,19,0,25,6
1683330249884,USP 168,A00,187607,Kwak; Nancy,2,0,5,3
1683330250912,USP 173,A00,187619,Staff,4,0,25,21
1683330251944,USP 181,A00,187638,Staff,0,0,25,25
1683330252969,VIS 103,A00,187650,Cruz; Edwin Teddy,23,0,75,52
1683330253997,VIS 110D,A00,187669,Staff,12,0,22,10
1683330255023,VIS 127C,A00,187720,Shen; Kuiyi,67,0,146,79
1683330256053,VIS 149,A00,187731,Yoldas; Pinar,0,14,22,22
1683330257078,VIS 151,A01,188091,Staff,22,0,34,12
1683330257078,VIS 151,A02,188092,Staff,11,0,34,23
1683330258106,VIS 160B,A00,188093,Stalbaum; Brett,0,0,10,10
1683330260160,WCWP 10B,A00,201720,Staff,10,0,15,5
1683330260160,WCWP 10B,B00,201722,Staff,8,0,15,7
1683330261184,WCWP 100,A00,201725,Gagnon; Jeffrey C,0,0,2,2
1683330261184,WCWP 100,B00,201727,Staff,0,4,15,15
1683330264277,ANBI 133,A00,258401,Wilder; Linnea Lorene,34,0,40,6
1683330265303,ANBI 140,A00,258395,Hrvoj Mihic; Branka,18,0,25,7
1683330266331,ANSC 120,A00,258402,Bialecki; Jon Anthony,27,0,40,13
1683330267354,ANSC 144,A00,258400,Staff,14,0,40,26
1683330269404,ANSC 166,A00,258396,Parish; Steven Martin,157,0,175,18
1683330270508,ANSC 180,A00,193533,Staff,9,0,20,11
1683330271532,ANSC 188,A00,258397,Jassal; Aftab,33,0,40,7
1683330272555,ANTH 3,A01,258316,Staff,23,0,30,7
1683330273581,ANTH 5,A00,258394,Semendeferi; Ekaterini,16,0,20,4
1683330274604,ANTH 21,A01,258331,Staff,8,0,40,32
1683330275627,ANTH 103,A00,258398,Varma; Saiba,15,0,25,10
1683330276657,AWP 10,001,202034,Staff,0,0,0,0
1683330276657,AWP 10,002,202035,Staff,0,0,0,0
1683330276657,AWP 10,003,202036,Staff,0,0,0,0
1683330276657,AWP 10,004,202037,Staff,0,0,0,0
1683330276657,AWP 10,005,202038,Staff,0,0,0,0
1683330276657,AWP 10,006,202039,Staff,0,0,0,0
1683330276657,AWP 10,007,202040,Staff,0,0,0,0
1683330276657,AWP 10,008,202041,Staff,0,0,0,0
1683330276657,AWP 10,009,202042,Staff,0,0,0,0
1683330276657,AWP 10,010,202043,Staff,0,0,0,0
1683330276657,AWP 10,011,202044,Staff,0,0,0,0
1683330276657,AWP 10,012,202045,Staff,0,0,0,0
1683330276657,AWP 10,013,202046,Staff,0,0,0,0
1683330276657,AWP 10,014,202047,Staff,0,0,0,0
1683330276657,AWP 10,015,202048,Staff,0,0,0,0
1683330276657,AWP 10,016,202049,Staff,0,0,0,0
1683330276657,AWP 10,017,202050,Staff,0,0,0,0
1683330276657,AWP 10,018,202051,Staff,0,0,0,0
1683330276657,AWP 10,019,202052,Staff,0,0,0,0
1683330276657,AWP 10,020,202053,Staff,0,0,0,0
1683330276657,AWP 10,021,202054,Staff,0,0,0,0
1683330276657,AWP 10,022,202055,Staff,0,0,0,0
1683330276657,AWP 10,023,202056,Staff,0,0,0,0
1683330276657,AWP 10,024,202057,Staff,0,0,0,0
1683330276657,AWP 10,025,202058,Staff,0,0,0,0
1683330276657,AWP 10,026,202059,Staff,0,0,0,0
1683330277682,AWP 102,001,202032,Staff,0,0,0,0
1683330277682,AWP 102,002,202033,Staff,0,0,0,0
1683330278707,BENG 100,A01,254234,Taylor Amos; Alyssa C,31,0,40,9
1683330279732,BENG 196,001,270013,Engler; Adam J.,9999,0,9999,0
1683330280760,BICD 100R,A01,202018,Smith; Laurie,0,7,32,32
1683330280760,BICD 100R,A02,202019,Smith; Laurie,0,2,32,32
1683330280760,BICD 100R,A03,202020,Smith; Laurie,0,1,32,32
1683330280760,BICD 100R,A04,202021,Smith; Laurie,9,0,32,23
1683330280760,BICD 100R,A05,202022,Smith; Laurie,12,0,32,20
1683330281785,BICD 136,A01,193242,Gustafson-Brown; Cindy,0,2,32,32
1683330281785,BICD 136,A02,193244,Gustafson-Brown; Cindy,14,0,32,18
1683330282815,BIEB 102,A01,193249,Butler; Shannon Rhey,0,2,32,32
1683330282815,BIEB 102,A02,193251,Butler; Shannon Rhey,0,0,32,32
1683330282815,BIEB 102,A03,193253,Butler; Shannon Rhey,0,1,32,32
1683330282815,BIEB 102,A04,193255,Butler; Shannon Rhey,17,0,32,15
1683330282815,BIEB 102,A05,193265,Butler; Shannon Rhey,26,0,32,6
1683330282815,BIEB 102,A06,193269,Butler; Shannon Rhey,16,0,32,16
1683330284863,BIEB 150,A01,193274,Staff,0,0,32,32
1683330284863,BIEB 150,A02,193285,Staff,23,0,32,9
1683330285887,BIEB 194,A00,193286,Kurle; Carolyn M.,22,0,32,10
1683330286913,BILD 1,A01,192291,Staff,16,0,32,16
1683330286913,BILD 1,A02,192292,Staff,30,0,32,2
1683330286913,BILD 1,B01,192520,Reuther; Keefe,0,1,0,0
1683330286913,BILD 1,B02,192532,Reuther; Keefe,0,1,0,0
1683330287943,BILD 3,A01,192556,Butler; Shannon Rhey,0,0,32,32
1683330287943,BILD 3,A02,192581,Butler; Shannon Rhey,5,0,32,27
1683330287943,BILD 3,A03,192611,Butler; Shannon Rhey,23,0,32,9
1683330287943,BILD 3,A04,192612,Butler; Shannon Rhey,25,0,32,7
1683330287943,BILD 3,A05,192613,Butler; Shannon Rhey,27,0,32,5
1683330287943,BILD 3,A06,192679,Butler; Shannon Rhey,27,0,32,5
1683330287943,BILD 3,A07,192682,Butler; Shannon Rhey,22,0,32,10
1683330288968,BILD 4,A01,192836,Reuther; Keefe,0,0,24,24
1683330288968,BILD 4,A02,193044,Reuther; Keefe,4,0,24,20
1683330289997,BILD 10,A01,193142,Gustafson-Brown; Cindy,30,0,32,2
1683330289997,BILD 10,A02,193149,Gustafson-Brown; Cindy,31,0,32,1
1683330291093,BIMM 100,A01,193301,Staff,0,6,32,32
1683330291093,BIMM 100,A02,193312,Staff,0,5,32,32
1683330291093,BIMM 100,A03,193323,Staff,0,8,32,32
1683330292118,BIMM 101,A01,193329,McDonnell; Lisa Marie,0,3,24,24
1683330292118,BIMM 101,A02,193339,McDonnell; Lisa Marie,0,3,24,24
1683330292118,BIMM 101,B01,193354,McDonnell; Lisa Marie,0,3,24,24
1683330292118,BIMM 101,B02,193357,McDonnell; Lisa Marie,0,3,24,24
1683330293150,BIMM 110,A01,193377,Tat; John,0,11,32,32
1683330293150,BIMM 110,A02,193378,Tat; John,1,9,32,31
1683330294178,BIMM 120,A01,206116,Staff,0,0,32,32
1683330294178,BIMM 120,A02,206117,Staff,8,0,32,24
1683330294178,BIMM 120,A03,206121,Staff,21,0,32,11
1683330295206,BIPN 100,A01,193393,Park; Ji Young,0,14,32,32
1683330295206,BIPN 100,A02,193402,Park; Ji Young,0,13,32,32
1683330295206,BIPN 100,A03,193413,Park; Ji Young,0,14,32,32
1683330295206,BIPN 100,A04,193414,Park; Ji Young,0,13,32,32
1683330296230,BIPN 102,A01,193429,Staff,0,0,32,32
1683330296230,BIPN 102,A02,193438,Staff,22,0,32,10
1683330297254,BIPN 106,A01,193450,Reyes Gonzalez; Catalina,0,2,40,40
1683330298277,BIPN 134,A01,193465,Cooke; James Edward,0,0,32,32
1683330298277,BIPN 134,A02,193474,Cooke; James Edward,25,0,32,7
1683330298277,BIPN 134,A03,193485,Cooke; James Edward,29,0,32,3
1683330298277,BIPN 134,A04,193486,Cooke; James Edward,21,0,32,11
1683330298277,BIPN 134,A05,193491,Cooke; James Edward,31,0,32,1
1683330298277,BIPN 134,A06,193501,Cooke; James Edward,30,0,32,2
1683330298277,BIPN 134,A07,193510,Cooke; James Edward,29,0,32,3
1683330300332,BISP 194,A00,222522,Staff,14,0,32,18
1683330301357,CAT 124,A01,202407,Staff,20,0,25,5
1683330302381,CAT 125,A00,202408,Marchisotto; Jennifer Anne,4,0,20,16
1683330303409,CAT 125R,A00,202409,Smith; Lauryn Alissa,0,11,20,20
1683330303409,CAT 125R,B00,202410,Morales; Celeste Georgianna,0,11,20,20
1683330303409,CAT 125R,C00,202411,Irwin; Matthew Joseph,0,10,20,20
1683330304438,CENG 15,A01,204712,Yang; Kesong,0,1,0,0
1683330305466,CENG 114,A00,202070,Jahed Motlagh; Zeinab,5,0,20,15
1683330306491,CGS 105,A00,185477,Wesling; Megan E.,24,0,40,16
1683330307515,CGS 106,A00,185494,Staff,13,0,22,9
1683330308539,CGS 108,A00,185495,Staff,14,0,20,6
1683330309566,CGS 114,A00,185496,Staff,13,0,18,5
1683330310590,CGS 119,A00,185501,Staff,15,0,20,5
1683330311617,CGS 120,A00,185511,Staff,13,0,20,7
1683330312643,CHEM 4,A01,184675,Bussey; Thomas J,96,0,100,4
1683330313670,CHEM 6A,A01,184677,Staff,34,0,60,26
1683330314697,CHEM 6B,A01,184679,Staff,65,0,100,35
1683330315722,CHEM 6C,A01,184681,Bussey; Thomas J,1,0,50,49
1683330315722,CHEM 6C,A02,184682,Bussey; Thomas J,34,0,50,16
1683330316750,CHEM 40A,A01,184684,Albizati; Kim F.,37,0,100,63
1683330317773,CHEM 40B,A01,184686,Albizati; Kim F.,0,20,100,100
1683330318799,CHEM 41B,A01,184690,Staff,52,0,100,48
1683330319823,COGS 3,A01,184715,Boyle; Mary E. T.,0,25,40,40
1683330320852,COGS 14B,A01,185172,Staff,0,15,38,38
1683330321880,COGS 18,A01,184736,Staff,17,0,80,63
1683330322904,COGS 100,A01,184932,Staff,0,5,73,73
1683330323932,COGS 101A,A01,184935,Staff,0,39,30,30
1683330324956,COGS 101B,A01,184944,Staff,0,2,30,30
1683330325983,COGS 101C,A01,184946,Staff,0,12,30,30
1683330327010,COGS 102A,A01,184951,Johnson; Christine M.,2,0,40,38
1683330328034,COGS 107B,A01,184953,Mooshagian; Eric Frederick,0,50,40,40
1683330329061,COGS 118B,A01,184959,Gupta; Anjum,0,48,40,40
1683330330088,COGS 153,A00,184961,Staff,0,15,30,30
1683330331115,COGS 177,A00,184962,Staff,0,20,30,30
1683330332139,COGS 187A,A01,184969,Boyle; Mary E. T.,0,17,40,40
1683330333162,COMM 10,A01,185174,Staff,0,5,25,25
1683330333162,COMM 10,A02,185189,Staff,0,5,25,25
1683330333162,COMM 10,A03,269821,Staff,0,0,0,0
1683330334186,COMM 100B,A01,185475,Staff,0,0,0,2
1683330334186,COMM 100B,A02,185476,Staff,14,0,25,11
1683330335213,COMM 100C,A01,185314,Staff,1,0,25,24
1683330335213,COMM 100C,A02,185327,Staff,19,0,25,6
1683330336239,COMM 110M,A00,185349,Staff,2,0,40,38
1683330337262,COMM 113T,A00,185352,Staff,24,0,40,16
1683330338285,COMM 114I,A00,185353,Staff,33,0,40,7
1683330339308,COMM 131,A00,185354,Staff,19,0,30,11
1683330340334,CSE 8A,A50,185358,Cao; Yingjun,0,46,10,10
1683330341364,CSE 8B,A01,185362,Staff,1,47,50,49
1683330342387,CSE 11,A01,185416,Cao; Yingjun,0,92,10,10
1683330343413,CSE 20,A01,185445,Briones; Jor-el Thomas Caparas,5,0,25,20
1683330344439,CSE 21,A01,185447,Staff,10,0,50,40
1683330345470,CSE 101,A01,185451,Staff,0,12,50,50
1683330345470,CSE 101,B01,185453,Jones; Miles E,0,11,50,50
1683330347522,CSE 141,A01,185458,Eldon; John,20,0,100,80
1683330348545,CSE 141L,A01,185461,Eldon; John,12,0,100,88
1683330349571,CSE 142,A01,185463,Staff,36,0,60,24
1683330349571,CSE 142,B01,201355,Staff,0,7,60,60
1683330350598,CSE 142L,A01,185470,Staff,36,0,60,24
1683330350598,CSE 142L,B01,201417,Staff,0,6,60,60
1683330351623,CSE 190,A00,201433,Staff,32,0,49,17
1683330352648,DOC 1,A01,259136,Strom; Megan C.,7,0,15,8
1683330352648,DOC 1,A02,259137,Strom; Megan C.,14,0,15,1
1683330352648,DOC 1,A03,259138,Strom; Megan C.,14,0,15,1
1683330352648,DOC 1,A04,259139,Strom; Megan C.,14,0,15,1
1683330353672,DOC 100D,A00,259140,Pass; Natalye Joann,16,0,25,9
1683330354699,DSGN 1,A01,184749,Rill; Bryan,0,25,30,30
1683330355724,DSGN 100,A01,185168,Staff,0,2,25,25
1683330356756,ECE 5,A01,185626,Morris; Karcher William,0,10,0,0
1683330357780,ECE 101,A01,185628,Staff,17,0,70,53
1683330358808,ECE 107,A01,185635,Baghdadchi; Saharnaz,0,0,20,20
1683330358808,ECE 107,A02,185638,Baghdadchi; Saharnaz,4,0,20,16
1683330359832,ECE 148,A01,185647,Silberman; Jack,0,0,16,16
1683330360860,ECON 1,A01,185537,Crane; Meredith Helen,54,0,70,16
1683330361885,ECON 3,A01,185549,Crane; Meredith Helen,33,0,70,37
1683330362909,ECON 4,A01,203354,Anderson; John Charles,0,4,10,10
1683330363934,ECON 100A,A01,185574,Staff,0,4,40,40
1683330364957,ECON 100B,A01,185576,Staff,10,22,50,40
1683330365982,ECON 100C,A01,185589,Newhouse; Herbert S,30,0,70,40
1683330367009,ECON 105,A00,185608,Vespa; Emanuel Ignacio,19,0,35,16
1683330368034,ECON 109,A01,185610,Shishkin; Denis,10,0,35,25
1683330369062,ECON 110A,A01,185612,Staff,11,0,40,29
1683330370089,ECON 120A,A01,185615,Staff,20,0,40,20
1683330371117,ECON 120C,A01,185617,Sun; Yixiao,0,20,70,70
1683330372141,ECON 144,A00,203346,Squires; Dale E,3,0,35,32
1683330373165,ECON 171,A01,203349,Newhouse; Herbert S,0,1,35,35
1683330374190,ECON 173A,A01,185621,Toda; Alexis Akira,21,0,35,14
1683330375222,EDS 25,A01,202413,Staff,0,1,0,0
1683330375222,EDS 25,A02,202414,Staff,0,1,0,0
1683330375222,EDS 25,A03,202415,Staff,0,0,0,0
1683330375222,EDS 25,A04,202416,Staff,0,1,0,0
1683330375222,EDS 25,A05,202439,Staff,0,0,0,0
1683330375222,EDS 25,A06,202440,Staff,0,0,0,0
1683330375222,EDS 25,B01,202631,Staff,0,0,0,0
1683330375222,EDS 25,B02,202632,Staff,0,0,0,0
1683330375222,EDS 25,B03,202639,Staff,0,0,0,0
1683330375222,EDS 25,B04,202640,Staff,0,0,0,0
1683330375222,EDS 25,B05,202643,Staff,0,0,0,0
1683330375222,EDS 25,B06,202644,Staff,0,0,0,0
1683330376245,EDS 38,A01,202659,Black; Alison Michelle,24,0,25,1
1683330377269,EDS 115,A00,202652,Staff,17,0,30,13
1683330378296,EDS 125,A00,202649,Staff,14,0,30,16
1683330379320,EDS 126,A01,203332,Staff,30,0,30,0
1683330380346,EDS 139,A00,202838,Staff,16,0,25,9
1683330381375,EDS 146,A01,202655,Staff,14,0,25,11
1683330382403,ENG 15,A00,185667,Staff,0,1,0,0
1683330382403,ENG 15,B00,185672,Staff,0,0,0,0
1683330382403,ENG 15,C00,185675,Staff,0,0,0,0
1683330382403,ENG 15,D00,185682,Staff,0,0,0,0
1683330382403,ENG 15,E00,185684,Staff,0,0,0,0
1683330383430,ETHN 103,A00,185710,Staff,0,3,35,35
1683330384455,ETHN 103A,A00,199228,Man; Simeon S,2,0,9,7
1683330385477,ETHN 109,A00,185711,Staff,18,0,35,17
1683330386501,ETHN 142,A00,185726,Staff,0,4,30,30
1683330387528,ETHN 163J,A00,199229,Man; Simeon S,5,0,8,3
1683330388555,ETHN 168,A00,185727,Staff,8,0,10,2
1683330389581,ETHN 182,A00,185728,Staff,1,0,35,34
1683330390606,ETHN 183,A00,185737,Staff,8,0,18,10
1683330391630,GLBH 111,A01,209361,Burgos; Jose L.,0,0,0,0
1683330393686,HIEU 104,A00,185792,Staff,16,0,20,4
1683330394768,HIEU 115,A00,185800,Staff,1,0,20,19
1683330395796,HIEU 128,A00,185801,Staff,0,7,20,20
1683330396820,HIEU 147,A00,185802,Staff,16,0,20,4
1683330397846,HIEU 154,A00,185823,Staff,12,0,20,8
1683330398870,HILA 102,A00,185826,Staff,13,0,20,7
1683330399894,HILD 2C,A01,185778,Staff,0,12,20,20
1683330400921,HILD 7B,A01,185780,Kwak; Nancy,0,15,32,32
1683330400921,HILD 7B,A02,185781,Kwak; Nancy,0,18,32,32
1683330401944,HILD 30,A01,185791,Staff,14,0,20,6
1683330402971,HISC 119,A00,185830,Golan; Tal,0,9,20,20
1683330403994,HITO 156GS,A00,185831,Patterson; Patrick H.,0,0,0,23
1683330405021,HIUS 103,A00,185832,Man; Simeon S,0,6,20,20
1683330406050,HIUS 117,A00,185836,Kwak; Nancy,2,0,20,18
1683330407076,HIUS 125,A00,185840,Man; Simeon S,0,0,23,23
1683330408102,HIUS 149,A00,185845,Staff,0,0,20,20
1683330409131,HUM 3,A01,185882,Zavodny; Tatiana Sophia,0,7,50,50
1683330409131,HUM 3,B01,185899,Caldwell; Michael Alan,0,18,50,50
1683330410155,HUM 3GS,A00,185900,Patterson; Patrick H.,0,0,0,23
1683330411186,HUM 4,A01,185938,Zroka; Amy Liane,31,0,50,19
1683330411186,HUM 4,B01,185956,Watkins; Eric,0,2,50,50
1683330411186,HUM 4,B02,202209,Watkins; Eric,0,2,50,50
1683330411186,HUM 4,B03,202210,Watkins; Eric,0,2,50,50
1683330412212,HUM 5,A01,185958,West; Geoffrey Scott,3,0,50,47
1683330412212,HUM 5,A02,202215,West; Geoffrey Scott,0,0,50,50
1683330413236,INTL 190,A00,185959,Gagnon; Jeffrey C,0,0,0,9
1683330413236,INTL 190,B00,185960,Lettieri; Michael Joseph,0,0,0,1
1683330414260,JAPN 180,A00,254509,Staff,5,1,30,25
1683330415283,LATI 10,A01,202853,Kennemore; Amy Michelle,4,0,35,31
1683330415283,LATI 10,A02,202854,Kennemore; Amy Michelle,2,0,35,33
1683330415283,LATI 10,A03,270054,Kennemore; Amy Michelle,30,0,30,0
1683330416311,LATI 180,A00,202855,Kennemore; Amy Michelle,11,0,20,9
1683330417338,LAWS 101,A00,201767,Golan; Tal,0,7,40,40
1683330418362,LIFR 1C,A00,185961,Staff,6,0,20,14
1683330419387,LIFR 1CX,A00,185962,Staff,7,0,20,13
1683330420414,LIFR 1D,A00,185963,Staff,9,0,20,11
1683330421442,LIFR 1DX,A00,185964,Staff,9,0,20,11
1683330422466,LIGN 101,A01,186039,Staff,43,0,50,7
1683330423493,LIGN 165,A00,186040,Staff,18,0,50,32
1683330424520,LTCS 108,A00,186041,Staff,6,0,10,4
1683330425543,LTCS 119,A00,186042,Staff,16,0,20,4
1683330426570,LTCS 130,A00,186043,Wesling; Megan E.,15,0,25,10
1683330428623,LTEA 138,A00,186119,Staff,14,0,40,26
1683330429649,LTEN 124,A00,186148,Staff,6,0,25,19
1683330430673,LTEN 178,A00,186149,Staff,7,0,15,8
1683330431700,LTEN 181,A00,186150,Blanco; John D,33,0,40,7
1683330432723,LTWL 120,A00,186160,Staff,20,0,25,5
1683330433749,LTWL 165,A00,186161,Staff,22,0,25,3
1683330434774,LTWR 100,A00,186162,Staff,0,5,15,15
1683330435798,LTWR 102,A00,186163,Doller; Ben,5,0,15,10
1683330436825,MAE 8,A01,186412,Staff,0,0,0,0
1683330437849,MAE 30B,A00,186445,Bahadori; Mohammad Yousef,83,0,100,17
1683330438874,MAE 40,A00,186592,Bewley; Thomas R,9,0,50,41
1683330439900,MAE 101B,A00,186593,Bahadori; Mohammad Yousef,81,0,100,19
1683330440925,MAE 105,A00,186594,Bandaru; Prabhakar,12,0,50,38
1683330441950,MAE 107,A00,186599,Pham; Hieu Tan,0,6,120,120
1683330442974,MAE 148,A01,186660,Silberman; Jack,3,0,16,13
1683330443998,MATH 10A,A01,188095,Staff,1,6,35,34
1683330445022,MATH 10B,A01,188097,Bowers; Adam R.,0,11,30,30
1683330445022,MATH 10B,A02,188099,Bowers; Adam R.,0,11,30,30
1683330445022,MATH 10B,B01,188104,Bowers; Adam R.,0,10,30,30
1683330445022,MATH 10B,B02,188106,Bowers; Adam R.,0,10,30,30
1683330446048,MATH 10C,A01,188111,Staff,0,18,30,30
1683330446048,MATH 10C,A02,188127,Staff,0,17,30,30
1683330446048,MATH 10C,A03,188131,Staff,0,18,30,30
1683330446048,MATH 10C,B01,188218,Staff,18,0,30,12
1683330446048,MATH 10C,B02,188244,Staff,13,0,30,17
1683330446048,MATH 10C,B03,188277,Staff,16,0,30,14
1683330447078,MATH 18,A01,188344,Bach; Quang Tran,18,0,30,12
1683330447078,MATH 18,A02,188345,Bach; Quang Tran,11,0,30,19
1683330447078,MATH 18,B01,188353,Bach; Quang Tran,10,0,30,20
1683330447078,MATH 18,B02,188354,Bach; Quang Tran,20,0,30,10
1683330448109,MATH 20A,A01,188374,Staff,13,0,35,22
1683330449135,MATH 20B,A01,188382,Ohm; Ko Woon,6,0,30,24
1683330449135,MATH 20B,A02,188383,Ohm; Ko Woon,22,0,30,8
1683330449135,MATH 20B,B01,188385,Ohm; Ko Woon,7,0,30,23
1683330449135,MATH 20B,B02,188392,Ohm; Ko Woon,22,0,30,8
1683330450160,MATH 20C,A01,188394,Harel; Guershon,10,0,30,20
1683330450160,MATH 20C,A02,188395,Harel; Guershon,15,0,30,15
1683330450160,MATH 20C,B01,188404,Harel; Guershon,5,0,30,25
1683330450160,MATH 20C,B02,188405,Harel; Guershon,19,0,30,11
1683330451185,MATH 20D,A01,188414,Hammock; Frances H,0,1,30,30
1683330451185,MATH 20D,A02,188415,Hammock; Frances H,3,0,30,27
1683330451185,MATH 20D,B01,188447,Hammock; Frances H,1,0,30,29
1683330451185,MATH 20D,B02,188486,Hammock; Frances H,8,0,30,22
1683330452210,MATH 20E,A01,188649,Staff,21,0,30,9
1683330452210,MATH 20E,A02,188650,Staff,23,0,30,7
1683330452210,MATH 20E,A03,188673,Staff,0,0,30,30
1683330453235,MATH 102,A01,188675,Staff,0,35,35,35
1683330454259,MATH 103B,A01,188681,Staff,3,0,35,32
1683330454259,MATH 103B,B01,188692,Staff,5,0,35,30
1683330455283,MATH 109,A01,188695,Salehi Golsefidy; Alireza,25,0,35,10
1683330455283,MATH 109,A02,188696,Salehi Golsefidy; Alireza,25,0,35,10
1683330456307,MATH 120A,A01,188698,Eggers; John Dietrich,7,0,35,28
1683330457335,MATH 142B,A01,188736,Ioana; Adrian,0,2,30,30
1683330457335,MATH 142B,A02,188741,Ioana; Adrian,1,1,30,29
1683330457335,MATH 142B,A03,188743,Ioana; Adrian,1,3,30,29
1683330458363,MATH 168A,A01,188790,Staff,0,9,35,35
1683330459389,MATH 170A,A01,188803,Nie; Jiawang,0,2,35,35
1683330459389,MATH 170A,A02,188811,Nie; Jiawang,0,0,35,35
1683330459389,MATH 170A,A03,188814,Nie; Jiawang,1,0,35,34
1683330459389,MATH 170A,A04,188815,Nie; Jiawang,13,0,35,22
1683330460417,MATH 193B,A01,188817,Staff,0,0,35,35
1683330460417,MATH 193B,A02,188818,Staff,5,0,35,30
1683330461442,MGT 4,A01,202857,Anderson; John Charles,62,0,80,18
1683330462467,MGT 12,A00,202858,Lindenberger; Wade Douglas,42,0,90,48
1683330463491,MGT 18,A00,202859,Staff,74,0,90,16
1683330464522,MGT 18GS,A00,202860,McKay; Michael J,13,0,28,15
1683330465549,MGT 45,A00,202861,Pecore; Joseph P.,14,0,90,76
1683330466579,MGT 100,A00,202863,Yavorsky; Daniel Ryan,28,0,90,62
1683330467606,MGT 103,A00,202864,Ehrich; Kristine R,1,18,90,89
1683330468631,MGT 112,A00,202865,Ehrich; Kristine R,15,0,90,75
1683330469661,MGT 121A,A00,202868,Staff,0,20,0,0
1683330470686,MGT 131B,A00,202869,Anderson; John Charles,59,0,90,31
1683330471712,MGT 136,A00,202871,Lindenberger; Wade Douglas,84,0,90,6
1683330472740,MGT 164,A00,202873,Staff,0,68,90,91
1683330473766,MGT 164GS,A00,202874,McKay; Mary A,13,0,28,15
1683330474790,MGT 180,A00,202875,Staff,0,50,90,91
1683330475815,MMW 11R,A01,205019,Herbst; Matthew,3,0,30,27
1683330475815,MMW 11R,A02,205026,Herbst; Matthew,29,0,30,1
1683330476841,MMW 15,A01,193512,Chang; Edmond Yi-Teh,0,9,28,28
1683330476841,MMW 15,A02,193513,Chang; Edmond Yi-Teh,0,5,28,28
1683330476841,MMW 15,A03,193514,Chang; Edmond Yi-Teh,0,5,28,28
1683330476841,MMW 15,A04,193515,Chang; Edmond Yi-Teh,0,5,28,28
1683330476841,MMW 15,A05,193516,Chang; Edmond Yi-Teh,0,4,28,28
1683330476841,MMW 15,A06,193517,Chang; Edmond Yi-Teh,0,5,28,28
1683330476841,MMW 15,B01,193519,Chang; Edmond Yi-Teh,0,5,28,28
1683330476841,MMW 15,B02,193520,Chang; Edmond Yi-Teh,0,5,28,28
1683330476841,MMW 15,B03,193521,Chang; Edmond Yi-Teh,0,5,28,28
1683330476841,MMW 15,B04,193522,Chang; Edmond Yi-Teh,0,4,28,28
1683330476841,MMW 15,B05,193523,Chang; Edmond Yi-Teh,0,5,28,28
1683330476841,MMW 15,B06,193524,Chang; Edmond Yi-Teh,0,4,28,28
1683330477865,MMW 122,A01,193526,Rahimi; Babak,0,15,28,28
1683330477865,MMW 122,A02,193527,Rahimi; Babak,0,14,28,28
1683330477865,MMW 122,A03,193528,Rahimi; Babak,0,0,0,0
1683330477865,MMW 122,A04,193529,Rahimi; Babak,0,0,0,0
1683330478898,MUS 1A,A01,186663,Staff,0,20,35,35
1683330479922,MUS 4,A01,186715,Staff,0,12,35,35
1683330480948,MUS 5R,A01,186796,Dubnov; Shlomo,0,17,35,35
1683330481974,MUS 6,A01,186798,Staff,0,4,25,25
1683330483002,MUS 7,A01,186830,Staff,12,0,35,23
1683330484030,MUS 8,A01,186930,Staff,0,26,35,35
1683330485054,MUS 15,A01,186932,Staff,0,16,35,35
1683330485054,MUS 15,B01,186934,Staff,0,15,35,35
1683330486080,MUS 80,A00,186935,Staff,1,0,20,19
1683330486080,MUS 80,B00,186936,Staff,25,0,25,0
1683330487108,NANO 11,A00,204702,Lipomi; Darren John,0,0,0,0
1683330488133,NANO 15,A01,204709,Yang; Kesong,0,1,0,0
1683330489162,NANO 114,A00,202069,Jahed Motlagh; Zeinab,3,0,10,7
1683330490187,PHIL 1,A00,186955,Grush; Rick Scott,32,0,40,8
1683330491212,PHIL 10,A01,186973,Grush; Rick Scott,28,0,35,7
1683330491212,PHIL 10,A02,186974,Grush; Rick Scott,33,0,35,2
1683330492240,PHIL 13,A01,186976,Staff,7,0,35,28
1683330492240,PHIL 13,A02,186977,Staff,16,0,35,19
1683330493263,PHIL 14,A01,186979,Staff,31,0,35,4
1683330493263,PHIL 14,A02,186986,Staff,32,0,35,3
1683330494294,PHIL 28,A01,186988,Staff,16,0,30,14
1683330494294,PHIL 28,A02,186989,Staff,1,0,30,29
1683330494294,PHIL 28,A03,186990,Staff,9,0,30,21
1683330494294,PHIL 28,A04,186991,Staff,26,0,30,4
1683330495321,PHIL 120,A00,186997,Staff,23,0,40,17
1683330496345,PHIL 137,A00,187003,Staff,9,0,40,31
1683330497370,PHIL 150,A00,187015,Staff,47,0,70,23
1683330498452,PHIL 167,A00,187021,Lamey; Andy M.,35,0,40,5
1683330499479,PHIL 174,A01,202226,Staff,17,0,20,3
1683330499479,PHIL 174,A02,202235,Staff,20,0,20,0
1683330500505,PHIL 191A,A00,258918,Staff,0,0,1,1
1683330501532,PHYS 1A,A00,187028,Staff,27,0,60,33
1683330502557,PHYS 1AL,001,187036,Staff,3,0,30,27
1683330502557,PHYS 1AL,002,187049,Staff,18,0,30,12
1683330503582,PHYS 1B,A00,187058,Staff,22,0,60,38
1683330504607,PHYS 1BL,001,187064,Staff,0,0,30,30
1683330504607,PHYS 1BL,002,187070,Staff,5,0,30,25
1683330505632,PHYS 1C,A00,187082,Staff,31,0,120,89
1683330506660,PHYS 1CL,001,187088,Staff,0,9,30,30
1683330506660,PHYS 1CL,002,187089,Staff,0,2,30,30
1683330506660,PHYS 1CL,009,262693,Staff,11,0,30,19
1683330507685,PHYS 2B,A01,187097,Staff,54,0,115,61
1683330508711,PHYS 2C,A01,187099,Staff,67,0,115,48
1683330509738,PHYS 2CL,A01,187101,Staff,5,0,28,23
1683330509738,PHYS 2CL,A02,187102,Staff,15,0,28,13
1683330510763,PHYS 2D,A01,187123,Shotwell; Brian,95,0,115,20
1683330511786,PHYS 4B,A01,187133,Grinstein; Benjamin,35,0,50,15
1683330512816,POLI 10,A00,188819,Staff,0,4,50,50
1683330513842,POLI 11,A00,188827,Staff,43,0,50,7
1683330514866,POLI 13R,A00,188828,Staff,0,1,20,20
1683330515894,POLI 27,A01,188830,Elgin; Samuel Zincke,0,1,70,70
1683330516923,POLI 30,A00,188832,Desposato; Scott,31,0,50,19
1683330517947,POLI 102F,A00,188834,Staff,3,0,40,37
1683330518975,POLI 104A,A00,188852,Staff,14,0,30,16
1683330520001,POLI 104I,A00,188853,Staff,0,6,20,20
1683330521029,POLI 110B,A00,188854,Wiens; David,7,0,20,13
1683330522053,POLI 112A,A00,188855,Wiens; David,5,0,30,25
1683330523078,POLI 117R,A00,188856,Forman; Fonna,0,11,20,20
1683330524103,POLI 118,A00,188857,Ingham; Sean,8,0,20,12
1683330525128,POLI 120G,A00,188858,Staff,9,0,30,21
1683330526152,POLI 131CR,A00,188863,Hoston; Germaine,24,0,50,26
1683330527174,POLI 133,A00,188864,Nellis; Gareth Hb,44,0,50,6
1683330528201,POLI 134D,A00,188865,Desposato; Scott,27,0,30,3
1683330529230,POLI 142A,A00,188871,Gartzke; Erik,22,0,50,28
1683330530254,POLI 142K,A00,188874,Staff,38,0,50,12
1683330531282,POLI 143,A00,188940,Gartzke; Erik,16,0,30,14
1683330532307,POLI 153,A00,188943,Staff,3,0,20,17
1683330533332,POLI 160AA,A00,188944,Staff,12,0,40,28
1683330534360,POLI 170A,A00,188945,Staff,11,0,30,19
1683330536417,PSYC 1,A00,188952,Staff,37,0,90,53
1683330537444,PSYC 2,B00,188953,Staff,19,0,35,16
1683330538469,PSYC 6,A00,188970,Staff,47,0,60,13
1683330539493,PSYC 7,A00,188973,Staff,37,0,45,8
1683330540520,PSYC 60,A01,188980,Rickard; Timothy C.,43,0,60,17
1683330541547,PSYC 70,A01,189001,Steiner; Eric Tomas,24,0,45,21
1683330542571,PSYC 100,A00,189005,Lacefield; Katharine I,0,100,120,120
1683330543598,PSYC 102,A00,189008,Staff,9,0,30,21
1683330544624,PSYC 106,B00,189026,Gorman; Michael R.,34,0,60,26
1683330545652,PSYC 114,B01,189033,Winkielman; Piotr,0,32,30,30
1683330546680,PSYC 131,A00,189036,Anagnostaras; Stephan,0,43,60,60
1683330547706,PSYC 136,A00,189041,Lowe; Angela Beth,0,7,25,25
1683330548734,PSYC 137,A00,189057,Winkielman; Piotr,0,34,25,25
1683330549762,PSYC 144,A00,189107,Wixted; John T,0,7,50,50
1683330551813,PSYC 162,A00,189142,Staff,0,8,85,85
1683330552840,PSYC 172,A00,189144,Gorman; Michael R.,0,7,30,30
1683330554890,PSYC 179,A00,189146,Lacefield; Katharine I,0,84,120,120
1683330555914,PSYC 181,A00,189147,Anagnostaras; Stephan,0,44,90,90
1683330556938,PSYC 190R,A00,189148,Barner; David A.,0,22,80,80
1683330557966,PSYC 191,A00,189275,Rickard; Timothy C.,0,7,25,25
1683330558992,PSYC 193,A00,189276,Chapman; Eddie Nathaniel,0,1,0,4
1683330560019,PSYC 193L,A01,189281,Lowe; Angela Beth,12,0,20,8
1683330560019,PSYC 193L,B01,189285,Staff,28,0,35,7
1683330561046,RELI 149,A00,187137,Rahimi; Babak,7,0,40,33
1683330562076,SE 9,A01,187315,Staff,0,2,18,18
1683330563100,SE 101B,A00,187409,Staff,24,0,30,6
1683330564127,SE 110B,A00,187444,Staff,10,0,40,30
1683330565151,SE 130B,A00,187449,Staff,31,0,40,9
1683330566179,SE 150A,A00,187516,Staff,9,0,20,11
1683330567203,SE 154,A00,187528,Staff,30,0,50,20
1683330568226,SIO 3,A01,258171,Staff,35,0,40,5
1683330569250,SIO 10,A00,187144,Cook; Geoffrey W,0,3,75,75
1683330570277,SIO 45,A00,187152,Cook; Geoffrey W,1,0,100,99
1683330571301,SIO 109R,A00,194486,Staff,0,3,20,20
1683330573350,SIO 187,A01,187233,Kacev; David,12,0,40,28
1683330574374,SOCI 1,A01,258656,Thorpe; Charles Robert,28,0,30,2
1683330574374,SOCI 1,A02,258658,Thorpe; Charles Robert,30,0,30,0
1683330574374,SOCI 1,A03,258661,Thorpe; Charles Robert,25,0,25,0
1683330574374,SOCI 1,A04,258666,Thorpe; Charles Robert,22,0,25,3
1683330574374,SOCI 1,A05,258897,Thorpe; Charles Robert,23,0,25,2
1683330574374,SOCI 1,A06,258898,Thorpe; Charles Robert,25,0,25,0
1683330575399,SOCI 30,A01,258903,Pardo Guerra; Juan Pablo,15,0,30,15
1683330576428,SOCI 102,A00,258904,Staff,9,0,25,16
1683330577451,SOCI 106,A00,258905,Staff,19,0,25,6
1683330578476,SOCI 111,A00,258907,Ribas Norris; Janet Vanesa,26,0,30,4
1683330579504,SOCI 121R,A00,258908,Pardo Guerra; Juan Pablo,10,0,30,20
1683330580528,SOCI 126,A01,203330,Staff,14,0,20,6
1683330581552,SOCI 131,A00,258909,Thorpe; Charles Robert,31,0,60,29
1683330582577,SOCI 135,A00,258910,Payne; Christine Anna,0,9,30,30
1683330583603,SOCI 157,A00,258911,Staff,12,0,30,18
1683330584627,SOCI 184,A00,258912,Staff,25,0,30,5
1683330585658,SOCI 188D,A00,258913,Staff,21,0,30,9
1683330586683,SYN 2,001,187529,Staff,10,0,16,6
1683330586683,SYN 2,002,201452,Staff,0,18,16,16
1683330586683,SYN 2,003,201469,Staff,3,0,16,13
1683330587710,SYN 100,A01,187531,Staff,0,9,20,20
1683330587710,SYN 100,B01,201491,Staff,0,12,20,20
1683330588739,TDAC 1,A00,189286,Walsh; Kim C.,3,0,20,17
1683330588739,TDAC 1,B00,189287,Harting; Carla Kelso,11,0,20,9
1683330589766,TDAC 101,A00,189300,Walsh; Kim C.,16,0,20,4
1683330589766,TDAC 101,B00,189301,Harting; Carla Kelso,18,0,20,2
1683330590789,TDAC 102,A00,189304,Basso; Beatrice,14,0,20,6
1683330591815,TDAC 108,A00,189305,Staff,18,0,20,2
1683330592847,TDDE 131,A00,189310,Staff,19,0,20,1
1683330592847,TDDE 131,B00,189314,Staff,19,0,20,1
1683330592847,TDDE 131,C00,189315,Staff,48,0,50,2
1683330592847,TDDE 131,D00,189316,Staff,14,0,15,1
1683330592847,TDDE 131,E00,204841,Staff,20,0,20,0
1683330593874,TDGE 10,A00,189289,Staff,30,0,50,20
1683330593874,TDGE 10,B00,189290,Havis; Allan,1,0,50,49
1683330594899,TDGE 11,A00,189291,Fulton; Julia,0,3,50,50
1683330594899,TDGE 11,B00,189292,Staff,20,0,25,5
1683330594899,TDGE 11,C00,260270,Staff,0,0,0,0
1683330595923,TDGE 25,A00,189294,Staff,3,0,20,17
1683330596951,TDGE 124,A00,189318,Fulton; Julia,0,8,50,50
1683330597979,TDGE 125,A00,189319,Staff,13,0,25,12
1683330597979,TDGE 125,B00,189320,Staff,23,0,25,2
1683330599006,TDGE 127,A00,189322,Havis; Allan,0,0,50,50
1683330600033,TDHT 101,A00,189323,Staff,18,0,25,7
1683330600033,TDHT 101,B00,189324,Staff,25,0,25,0
1683330601060,TDHT 102,A00,189325,Staff,49,0,50,1
1683330602147,TDMV 1,A00,189295,Arcidiacono; Kristin,19,0,30,11
1683330602147,TDMV 1,B00,189296,Caligagan; Maria T.,24,0,30,6
1683330603171,TDMV 2,A00,189297,Sammartano; Tonnie,28,0,30,2
1683330603171,TDMV 2,B00,189299,Arcidiacono; Kristin,24,0,30,6
1683330604196,TDMV 3,A00,204998,Rincon; Alicia,22,0,30,8
1683330605223,TDMV 120,A00,189458,Sammartano; Tonnie,28,0,30,2
1683330606248,TDMV 138,A00,189541,Jun; Grace Shin Hae,22,0,40,18
1683330607272,TDMV 142,A00,189717,Caligagan; Tony,23,0,30,7
1683330607272,TDMV 142,B00,189718,Caligagan; Maria T.,25,0,30,5
1683330608298,TMC 2,A01,187533,Staff,25,0,25,0
1683330608298,TMC 2,A02,187534,Staff,25,0,25,0
1683330609325,USP 1,A01,187536,Kwak; Nancy,0,16,25,25
1683330610350,USP 5,A01,187538,Staff,10,0,25,15
1683330611377,USP 101,A00,199253,Staff,0,4,0,0
1683330612404,USP 124,A00,187562,Boomhower; Matthew Charles,1,0,30,29
1683330613429,USP 138,A00,187582,Staff,20,0,25,5
1683330614453,USP 152,A01,187597,Staff,4,0,25,21
1683330615479,USP 153,A00,187598,Staff,19,0,25,6
1683330616503,USP 168,A00,187607,Kwak; Nancy,2,0,5,3
1683330617531,USP 173,A00,187619,Staff,4,0,25,21
1683330618560,USP 181,A00,187638,Staff,0,0,25,25
1683330619587,VIS 103,A00,187650,Cruz; Edwin Teddy,23,0,75,52
1683330620616,VIS 110D,A00,187669,Staff,12,0,22,10
1683330621640,VIS 127C,A00,187720,Shen; Kuiyi,67,0,146,79
1683330622668,VIS 149,A00,187731,Yoldas; Pinar,0,14,22,22
1683330623693,VIS 151,A01,188091,Staff,22,0,34,12
1683330623693,VIS 151,A02,188092,Staff,11,0,34,23
1683330624717,VIS 160B,A00,188093,Stalbaum; Brett,0,0,10,10
1683330626766,WCWP 10B,A00,201720,Staff,10,0,15,5
1683330626766,WCWP 10B,B00,201722,Staff,8,0,15,7
1683330627791,WCWP 100,A00,201725,Gagnon; Jeffrey C,0,0,2,2
1683330627791,WCWP 100,B00,201727,Staff,0,4,15,15
1683330630899,ANBI 133,A00,258401,Wilder; Linnea Lorene,34,0,40,6
1683330631923,ANBI 140,A00,258395,Hrvoj Mihic; Branka,18,0,25,7
1683330632947,ANSC 120,A00,258402,Bialecki; Jon Anthony,27,0,40,13
1683330633974,ANSC 144,A00,258400,Staff,14,0,40,26
1683330636022,ANSC 166,A00,258396,Parish; Steven Martin,157,0,175,18
1683330637045,ANSC 180,A00,193533,Staff,9,0,20,11
1683330638070,ANSC 188,A00,258397,Jassal; Aftab,33,0,40,7
1683330639094,ANTH 3,A01,258316,Staff,23,0,30,7
1683330640121,ANTH 5,A00,258394,Semendeferi; Ekaterini,16,0,20,4
1683330641150,ANTH 21,A01,258331,Staff,8,0,40,32
1683330642173,ANTH 103,A00,258398,Varma; Saiba,15,0,25,10
1683330643198,AWP 10,001,202034,Staff,0,0,0,0
1683330643198,AWP 10,002,202035,Staff,0,0,0,0
1683330643198,AWP 10,003,202036,Staff,0,0,0,0
1683330643198,AWP 10,004,202037,Staff,0,0,0,0
1683330643198,AWP 10,005,202038,Staff,0,0,0,0
1683330643198,AWP 10,006,202039,Staff,0,0,0,0
1683330643198,AWP 10,007,202040,Staff,0,0,0,0
1683330643198,AWP 10,008,202041,Staff,0,0,0,0
1683330643198,AWP 10,009,202042,Staff,0,0,0,0
1683330643198,AWP 10,010,202043,Staff,0,0,0,0
1683330643198,AWP 10,011,202044,Staff,0,0,0,0
1683330643198,AWP 10,012,202045,Staff,0,0,0,0
1683330643198,AWP 10,013,202046,Staff,0,0,0,0
1683330643198,AWP 10,014,202047,Staff,0,0,0,0
1683330643198,AWP 10,015,202048,Staff,0,0,0,0
1683330643198,AWP 10,016,202049,Staff,0,0,0,0
1683330643198,AWP 10,017,202050,Staff,0,0,0,0
1683330643198,AWP 10,018,202051,Staff,0,0,0,0
1683330643198,AWP 10,019,202052,Staff,0,0,0,0
1683330643198,AWP 10,020,202053,Staff,0,0,0,0
1683330643198,AWP 10,021,202054,Staff,0,0,0,0
1683330643198,AWP 10,022,202055,Staff,0,0,0,0
1683330643198,AWP 10,023,202056,Staff,0,0,0,0
1683330643198,AWP 10,024,202057,Staff,0,0,0,0
1683330643198,AWP 10,025,202058,Staff,0,0,0,0
1683330643198,AWP 10,026,202059,Staff,0,0,0,0
1683330644222,AWP 102,001,202032,Staff,0,0,0,0
1683330644222,AWP 102,002,202033,Staff,0,0,0,0
1683330645245,BENG 100,A01,254234,Taylor Amos; Alyssa C,31,0,40,9
1683330646268,BENG 196,001,270013,Engler; Adam J.,9999,0,9999,0
1683330647297,BICD 100R,A01,202018,Smith; Laurie,0,7,32,32
1683330647297,BICD 100R,A02,202019,Smith; Laurie,0,2,32,32
1683330647297,BICD 100R,A03,202020,Smith; Laurie,0,1,32,32
1683330647297,BICD 100R,A04,202021,Smith; Laurie,9,0,32,23
1683330647297,BICD 100R,A05,202022,Smith; Laurie,12,0,32,20
1683330648326,BICD 136,A01,193242,Gustafson-Brown; Cindy,0,2,32,32
1683330648326,BICD 136,A02,193244,Gustafson-Brown; Cindy,14,0,32,18
1683330649359,BIEB 102,A01,193249,Butler; Shannon Rhey,0,2,32,32
1683330649359,BIEB 102,A02,193251,Butler; Shannon Rhey,0,0,32,32
1683330649359,BIEB 102,A03,193253,Butler; Shannon Rhey,0,1,32,32
1683330649359,BIEB 102,A04,193255,Butler; Shannon Rhey,17,0,32,15
1683330649359,BIEB 102,A05,193265,Butler; Shannon Rhey,26,0,32,6
1683330649359,BIEB 102,A06,193269,Butler; Shannon Rhey,16,0,32,16
1683330651410,BIEB 150,A01,193274,Staff,0,0,32,32
1683330651410,BIEB 150,A02,193285,Staff,23,0,32,9
1683330652438,BIEB 194,A00,193286,Kurle; Carolyn M.,22,0,32,10
1683330653462,BILD 1,A01,192291,Staff,16,0,32,16
1683330653462,BILD 1,A02,192292,Staff,30,0,32,2
1683330653462,BILD 1,B01,192520,Reuther; Keefe,0,1,0,0
1683330653462,BILD 1,B02,192532,Reuther; Keefe,0,1,0,0
1683330654491,BILD 3,A01,192556,Butler; Shannon Rhey,0,0,32,32
1683330654491,BILD 3,A02,192581,Butler; Shannon Rhey,5,0,32,27
1683330654491,BILD 3,A03,192611,Butler; Shannon Rhey,23,0,32,9
1683330654491,BILD 3,A04,192612,Butler; Shannon Rhey,25,0,32,7
1683330654491,BILD 3,A05,192613,Butler; Shannon Rhey,27,0,32,5
1683330654491,BILD 3,A06,192679,Butler; Shannon Rhey,27,0,32,5
1683330654491,BILD 3,A07,192682,Butler; Shannon Rhey,22,0,32,10
1683330655518,BILD 4,A01,192836,Reuther; Keefe,0,0,24,24
1683330655518,BILD 4,A02,193044,Reuther; Keefe,4,0,24,20
1683330656542,BILD 10,A01,193142,Gustafson-Brown; Cindy,30,0,32,2
1683330656542,BILD 10,A02,193149,Gustafson-Brown; Cindy,31,0,32,1
1683330657568,BIMM 100,A01,193301,Staff,0,6,32,32
1683330657568,BIMM 100,A02,193312,Staff,0,5,32,32
1683330657568,BIMM 100,A03,193323,Staff,0,8,32,32
1683330658597,BIMM 101,A01,193329,McDonnell; Lisa Marie,0,3,24,24
1683330658597,BIMM 101,A02,193339,McDonnell; Lisa Marie,0,3,24,24
1683330658597,BIMM 101,B01,193354,McDonnell; Lisa Marie,0,3,24,24
1683330658597,BIMM 101,B02,193357,McDonnell; Lisa Marie,0,3,24,24
1683330659621,BIMM 110,A01,193377,Tat; John,0,11,32,32
1683330659621,BIMM 110,A02,193378,Tat; John,1,9,32,31
1683330660649,BIMM 120,A01,206116,Staff,0,0,32,32
1683330660649,BIMM 120,A02,206117,Staff,8,0,32,24
1683330660649,BIMM 120,A03,206121,Staff,21,0,32,11
1683330661683,BIPN 100,A01,193393,Park; Ji Young,0,14,32,32
1683330661683,BIPN 100,A02,193402,Park; Ji Young,0,13,32,32
1683330661683,BIPN 100,A03,193413,Park; Ji Young,0,14,32,32
1683330661683,BIPN 100,A04,193414,Park; Ji Young,0,13,32,32
1683330662709,BIPN 102,A01,193429,Staff,0,0,32,32
1683330662709,BIPN 102,A02,193438,Staff,22,0,32,10
1683330663733,BIPN 106,A01,193450,Reyes Gonzalez; Catalina,0,2,40,40
1683330664758,BIPN 134,A01,193465,Cooke; James Edward,0,0,32,32
1683330664758,BIPN 134,A02,193474,Cooke; James Edward,25,0,32,7
1683330664758,BIPN 134,A03,193485,Cooke; James Edward,29,0,32,3
1683330664758,BIPN 134,A04,193486,Cooke; James Edward,21,0,32,11
1683330664758,BIPN 134,A05,193491,Cooke; James Edward,31,0,32,1
1683330664758,BIPN 134,A06,193501,Cooke; James Edward,30,0,32,2
1683330664758,BIPN 134,A07,193510,Cooke; James Edward,29,0,32,3
1683330666809,BISP 194,A00,222522,Staff,14,0,32,18
1683330667834,CAT 124,A01,202407,Staff,20,0,25,5
1683330668859,CAT 125,A00,202408,Marchisotto; Jennifer Anne,4,0,20,16
1683330669888,CAT 125R,A00,202409,Smith; Lauryn Alissa,0,11,20,20
1683330669888,CAT 125R,B00,202410,Morales; Celeste Georgianna,0,11,20,20
1683330669888,CAT 125R,C00,202411,Irwin; Matthew Joseph,0,10,20,20
1683330670918,CENG 15,A01,204712,Yang; Kesong,0,1,0,0
1683330671945,CENG 114,A00,202070,Jahed Motlagh; Zeinab,5,0,20,15
1683330672977,CGS 105,A00,185477,Wesling; Megan E.,24,0,40,16
1683330674004,CGS 106,A00,185494,Staff,13,0,22,9
1683330675032,CGS 108,A00,185495,Staff,14,0,20,6
1683330676054,CGS 114,A00,185496,Staff,13,0,18,5
1683330677077,CGS 119,A00,185501,Staff,15,0,20,5
1683330678101,CGS 120,A00,185511,Staff,13,0,20,7
1683330679125,CHEM 4,A01,184675,Bussey; Thomas J,96,0,100,4
1683330680150,CHEM 6A,A01,184677,Staff,34,0,60,26
1683330681176,CHEM 6B,A01,184679,Staff,65,0,100,35
1683330682204,CHEM 6C,A01,184681,Bussey; Thomas J,1,0,50,49
1683330682204,CHEM 6C,A02,184682,Bussey; Thomas J,34,0,50,16
1683330683230,CHEM 40A,A01,184684,Albizati; Kim F.,37,0,100,63
1683330684254,CHEM 40B,A01,184686,Albizati; Kim F.,0,20,100,100
1683330685278,CHEM 41B,A01,184690,Staff,52,0,100,48
1683330686306,COGS 3,A01,184715,Boyle; Mary E. T.,0,25,40,40
1683330687331,COGS 14B,A01,185172,Staff,0,15,38,38
1683330688355,COGS 18,A01,184736,Staff,17,0,80,63
1683330689383,COGS 100,A01,184932,Staff,0,5,73,73
1683330690414,COGS 101A,A01,184935,Staff,0,39,30,30
1683330691442,COGS 101B,A01,184944,Staff,0,2,30,30
1683330692470,COGS 101C,A01,184946,Staff,0,12,30,30
1683330693498,COGS 102A,A01,184951,Johnson; Christine M.,2,0,40,38
1683330694525,COGS 107B,A01,184953,Mooshagian; Eric Frederick,0,50,40,40
1683330695552,COGS 118B,A01,184959,Gupta; Anjum,0,48,40,40
1683330696575,COGS 153,A00,184961,Staff,0,15,30,30
1683330697606,COGS 177,A00,184962,Staff,0,20,30,30
1683330698637,COGS 187A,A01,184969,Boyle; Mary E. T.,0,17,40,40
1683330699661,COMM 10,A01,185174,Staff,0,5,25,25
1683330699661,COMM 10,A02,185189,Staff,0,5,25,25
1683330699661,COMM 10,A03,269821,Staff,0,0,0,0
1683330700686,COMM 100B,A01,185475,Staff,0,0,0,2
1683330700686,COMM 100B,A02,185476,Staff,14,0,25,11
1683330701710,COMM 100C,A01,185314,Staff,1,0,25,24
1683330701710,COMM 100C,A02,185327,Staff,19,0,25,6
1683330702737,COMM 110M,A00,185349,Staff,2,0,40,38
1683330703764,COMM 113T,A00,185352,Staff,24,0,40,16
1683330704788,COMM 114I,A00,185353,Staff,33,0,40,7
1683330705886,COMM 131,A00,185354,Staff,19,0,30,11
1683330706914,CSE 8A,A50,185358,Cao; Yingjun,0,46,10,10
1683330707939,CSE 8B,A01,185362,Staff,1,47,50,49
1683330708965,CSE 11,A01,185416,Cao; Yingjun,0,92,10,10
1683330709990,CSE 20,A01,185445,Briones; Jor-el Thomas Caparas,5,0,25,20
1683330711020,CSE 21,A01,185447,Staff,10,0,50,40
1683330712048,CSE 101,A01,185451,Staff,0,12,50,50
1683330712048,CSE 101,B01,185453,Jones; Miles E,0,11,50,50
1683330714100,CSE 141,A01,185458,Eldon; John,20,0,100,80
1683330715131,CSE 141L,A01,185461,Eldon; John,12,0,100,88
1683330716159,CSE 142,A01,185463,Staff,36,0,60,24
1683330716159,CSE 142,B01,201355,Staff,0,7,60,60
1683330717186,CSE 142L,A01,185470,Staff,36,0,60,24
1683330717186,CSE 142L,B01,201417,Staff,0,6,60,60
1683330718212,CSE 190,A00,201433,Staff,32,0,49,17
1683330719242,DOC 1,A01,259136,Strom; Megan C.,7,0,15,8
1683330719242,DOC 1,A02,259137,Strom; Megan C.,14,0,15,1
1683330719242,DOC 1,A03,259138,Strom; Megan C.,14,0,15,1
1683330719242,DOC 1,A04,259139,Strom; Megan C.,14,0,15,1
1683330720266,DOC 100D,A00,259140,Pass; Natalye Joann,16,0,25,9
1683330721292,DSGN 1,A01,184749,Rill; Bryan,0,25,30,30
1683330722320,DSGN 100,A01,185168,Staff,0,2,25,25
1683330723344,ECE 5,A01,185626,Morris; Karcher William,0,10,0,0
1683330724368,ECE 101,A01,185628,Staff,17,0,70,53
1683330725395,ECE 107,A01,185635,Baghdadchi; Saharnaz,0,0,20,20
1683330725395,ECE 107,A02,185638,Baghdadchi; Saharnaz,4,0,20,16
1683330726423,ECE 148,A01,185647,Silberman; Jack,0,0,16,16
1683330727452,ECON 1,A01,185537,Crane; Meredith Helen,54,0,70,16
1683330728478,ECON 3,A01,185549,Crane; Meredith Helen,33,0,70,37
1683330729507,ECON 4,A01,203354,Anderson; John Charles,0,4,10,10
1683330730536,ECON 100A,A01,185574,Staff,0,4,40,40
1683330731562,ECON 100B,A01,185576,Staff,10,22,50,40
1683330732589,ECON 100C,A01,185589,Newhouse; Herbert S,30,0,70,40
1683330733611,ECON 105,A00,185608,Vespa; Emanuel Ignacio,19,0,35,16
1683330734635,ECON 109,A01,185610,Shishkin; Denis,10,0,35,25
1683330735659,ECON 110A,A01,185612,Staff,11,0,40,29
1683330736683,ECON 120A,A01,185615,Staff,20,0,40,20
1683330737711,ECON 120C,A01,185617,Sun; Yixiao,0,20,70,70
1683330738740,ECON 144,A00,203346,Squires; Dale E,3,0,35,32
1683330739770,ECON 171,A01,203349,Newhouse; Herbert S,0,1,35,35
1683330740795,ECON 173A,A01,185621,Toda; Alexis Akira,21,0,35,14
1683330741821,EDS 25,A01,202413,Staff,0,1,0,0
1683330741821,EDS 25,A02,202414,Staff,0,1,0,0
1683330741821,EDS 25,A03,202415,Staff,0,0,0,0
1683330741821,EDS 25,A04,202416,Staff,0,1,0,0
1683330741821,EDS 25,A05,202439,Staff,0,0,0,0
1683330741821,EDS 25,A06,202440,Staff,0,0,0,0
1683330741821,EDS 25,B01,202631,Staff,0,0,0,0
1683330741821,EDS 25,B02,202632,Staff,0,0,0,0
1683330741821,EDS 25,B03,202639,Staff,0,0,0,0
1683330741821,EDS 25,B04,202640,Staff,0,0,0,0
1683330741821,EDS 25,B05,202643,Staff,0,0,0,0
1683330741821,EDS 25,B06,202644,Staff,0,0,0,0
1683330742846,EDS 38,A01,202659,Black; Alison Michelle,24,0,25,1
1683330743871,EDS 115,A00,202652,Staff,17,0,30,13
1683330744895,EDS 125,A00,202649,Staff,14,0,30,16
1683330745918,EDS 126,A01,203332,Staff,30,0,30,0
1683330746945,EDS 139,A00,202838,Staff,16,0,25,9
1683330747972,EDS 146,A01,202655,Staff,14,0,25,11
1683330749000,ENG 15,A00,185667,Staff,0,1,0,0
1683330749000,ENG 15,B00,185672,Staff,0,0,0,0
1683330749000,ENG 15,C00,185675,Staff,0,0,0,0
1683330749000,ENG 15,D00,185682,Staff,0,0,0,0
1683330749000,ENG 15,E00,185684,Staff,0,0,0,0
1683330750030,ETHN 103,A00,185710,Staff,0,3,35,35
1683330751055,ETHN 103A,A00,199228,Man; Simeon S,2,0,9,7
1683330752082,ETHN 109,A00,185711,Staff,18,0,35,17
1683330753111,ETHN 142,A00,185726,Staff,0,4,30,30
1683330754135,ETHN 163J,A00,199229,Man; Simeon S,5,0,8,3
1683330755159,ETHN 168,A00,185727,Staff,8,0,10,2
1683330756184,ETHN 182,A00,185728,Staff,1,0,35,34
1683330757207,ETHN 183,A00,185737,Staff,8,0,18,10
1683330758237,GLBH 111,A01,209361,Burgos; Jose L.,0,0,0,0
1683330760287,HIEU 104,A00,185792,Staff,16,0,20,4
1683330761310,HIEU 115,A00,185800,Staff,1,0,20,19
1683330762339,HIEU 128,A00,185801,Staff,0,7,20,20
1683330763363,HIEU 147,A00,185802,Staff,16,0,20,4
1683330764392,HIEU 154,A00,185823,Staff,12,0,20,8
1683330765419,HILA 102,A00,185826,Staff,13,0,20,7
1683330766446,HILD 2C,A01,185778,Staff,0,12,20,20
1683330767474,HILD 7B,A01,185780,Kwak; Nancy,0,15,32,32
1683330767474,HILD 7B,A02,185781,Kwak; Nancy,0,18,32,32
1683330768500,HILD 30,A01,185791,Staff,14,0,20,6
1683330769524,HISC 119,A00,185830,Golan; Tal,0,9,20,20
1683330770563,HITO 156GS,A00,185831,Patterson; Patrick H.,0,0,0,23
1683330771587,HIUS 103,A00,185832,Man; Simeon S,0,6,20,20
1683330772611,HIUS 117,A00,185836,Kwak; Nancy,2,0,20,18
1683330773638,HIUS 125,A00,185840,Man; Simeon S,0,0,23,23
1683330774663,HIUS 149,A00,185845,Staff,0,0,20,20
1683330775691,HUM 3,A01,185882,Zavodny; Tatiana Sophia,0,7,50,50
1683330775691,HUM 3,B01,185899,Caldwell; Michael Alan,0,18,50,50
1683330776718,HUM 3GS,A00,185900,Patterson; Patrick H.,0,0,0,23
1683330777740,HUM 4,A01,185938,Zroka; Amy Liane,31,0,50,19
1683330777740,HUM 4,B01,185956,Watkins; Eric,0,2,50,50
1683330777740,HUM 4,B02,202209,Watkins; Eric,0,2,50,50
1683330777740,HUM 4,B03,202210,Watkins; Eric,0,2,50,50
1683330778769,HUM 5,A01,185958,West; Geoffrey Scott,3,0,50,47
1683330778769,HUM 5,A02,202215,West; Geoffrey Scott,0,0,50,50
1683330779797,INTL 190,A00,185959,Gagnon; Jeffrey C,0,0,0,9
1683330779797,INTL 190,B00,185960,Lettieri; Michael Joseph,0,0,0,1
1683330780822,JAPN 180,A00,254509,Staff,5,1,30,25
1683330781847,LATI 10,A01,202853,Kennemore; Amy Michelle,4,0,35,31
1683330781847,LATI 10,A02,202854,Kennemore; Amy Michelle,2,0,35,33
1683330781847,LATI 10,A03,270054,Kennemore; Amy Michelle,30,0,30,0
1683330782872,LATI 180,A00,202855,Kennemore; Amy Michelle,11,0,20,9
1683330783895,LAWS 101,A00,201767,Golan; Tal,0,7,40,40
1683330784926,LIFR 1C,A00,185961,Staff,6,0,20,14
1683330785953,LIFR 1CX,A00,185962,Staff,7,0,20,13
1683330786977,LIFR 1D,A00,185963,Staff,9,0,20,11
1683330788005,LIFR 1DX,A00,185964,Staff,9,0,20,11
1683330789033,LIGN 101,A01,186039,Staff,43,0,50,7
1683330790059,LIGN 165,A00,186040,Staff,18,0,50,32
1683330791086,LTCS 108,A00,186041,Staff,6,0,10,4
1683330792111,LTCS 119,A00,186042,Staff,16,0,20,4
1683330793140,LTCS 130,A00,186043,Wesling; Megan E.,15,0,25,10
1683330795193,LTEA 138,A00,186119,Staff,14,0,40,26
1683330796219,LTEN 124,A00,186148,Staff,6,0,25,19
1683330797242,LTEN 178,A00,186149,Staff,7,0,15,8
1683330798270,LTEN 181,A00,186150,Blanco; John D,33,0,40,7
1683330799293,LTWL 120,A00,186160,Staff,20,0,25,5
1683330800319,LTWL 165,A00,186161,Staff,22,0,25,3
1683330801349,LTWR 100,A00,186162,Staff,0,5,15,15
1683330802372,LTWR 102,A00,186163,Doller; Ben,5,0,15,10
1683330803400,MAE 8,A01,186412,Staff,0,0,0,0
1683330804429,MAE 30B,A00,186445,Bahadori; Mohammad Yousef,83,0,100,17
1683330805453,MAE 40,A00,186592,Bewley; Thomas R,9,0,50,41
1683330806478,MAE 101B,A00,186593,Bahadori; Mohammad Yousef,81,0,100,19
1683330807506,MAE 105,A00,186594,Bandaru; Prabhakar,12,0,50,38
1683330808532,MAE 107,A00,186599,Pham; Hieu Tan,0,6,120,120
1683330809615,MAE 148,A01,186660,Silberman; Jack,3,0,16,13
1683330810643,MATH 10A,A01,188095,Staff,1,6,35,34
1683330811668,MATH 10B,A01,188097,Bowers; Adam R.,0,11,30,30
1683330811668,MATH 10B,A02,188099,Bowers; Adam R.,0,11,30,30
1683330811668,MATH 10B,B01,188104,Bowers; Adam R.,0,10,30,30
1683330811668,MATH 10B,B02,188106,Bowers; Adam R.,0,10,30,30
1683330812694,MATH 10C,A01,188111,Staff,0,18,30,30
1683330812694,MATH 10C,A02,188127,Staff,0,17,30,30
1683330812694,MATH 10C,A03,188131,Staff,0,18,30,30
1683330812694,MATH 10C,B01,188218,Staff,18,0,30,12
1683330812694,MATH 10C,B02,188244,Staff,13,0,30,17
1683330812694,MATH 10C,B03,188277,Staff,16,0,30,14
1683330813719,MATH 18,A01,188344,Bach; Quang Tran,18,0,30,12
1683330813719,MATH 18,A02,188345,Bach; Quang Tran,11,0,30,19
1683330813719,MATH 18,B01,188353,Bach; Quang Tran,10,0,30,20
1683330813719,MATH 18,B02,188354,Bach; Quang Tran,20,0,30,10
1683330814748,MATH 20A,A01,188374,Staff,13,0,35,22
1683330815777,MATH 20B,A01,188382,Ohm; Ko Woon,6,0,30,24
1683330815777,MATH 20B,A02,188383,Ohm; Ko Woon,22,0,30,8
1683330815777,MATH 20B,B01,188385,Ohm; Ko Woon,7,0,30,23
1683330815777,MATH 20B,B02,188392,Ohm; Ko Woon,22,0,30,8
1683330816806,MATH 20C,A01,188394,Harel; Guershon,10,0,30,20
1683330816806,MATH 20C,A02,188395,Harel; Guershon,15,0,30,15
1683330816806,MATH 20C,B01,188404,Harel; Guershon,5,0,30,25
1683330816806,MATH 20C,B02,188405,Harel; Guershon,19,0,30,11
1683330817831,MATH 20D,A01,188414,Hammock; Frances H,0,1,30,30
1683330817831,MATH 20D,A02,188415,Hammock; Frances H,3,0,30,27
1683330817831,MATH 20D,B01,188447,Hammock; Frances H,1,0,30,29
1683330817831,MATH 20D,B02,188486,Hammock; Frances H,8,0,30,22
1683330818856,MATH 20E,A01,188649,Staff,21,0,30,9
1683330818856,MATH 20E,A02,188650,Staff,23,0,30,7
1683330818856,MATH 20E,A03,188673,Staff,0,0,30,30
1683330819878,MATH 102,A01,188675,Staff,0,35,35,35
1683330820906,MATH 103B,A01,188681,Staff,3,0,35,32
1683330820906,MATH 103B,B01,188692,Staff,5,0,35,30
1683330821933,MATH 109,A01,188695,Salehi Golsefidy; Alireza,25,0,35,10
1683330821933,MATH 109,A02,188696,Salehi Golsefidy; Alireza,25,0,35,10
1683330822961,MATH 120A,A01,188698,Eggers; John Dietrich,7,0,35,28
1683330823990,MATH 142B,A01,188736,Ioana; Adrian,0,2,30,30
1683330823990,MATH 142B,A02,188741,Ioana; Adrian,1,1,30,29
1683330823990,MATH 142B,A03,188743,Ioana; Adrian,1,3,30,29
1683330825014,MATH 168A,A01,188790,Staff,0,9,35,35
1683330826045,MATH 170A,A01,188803,Nie; Jiawang,0,2,35,35
1683330826045,MATH 170A,A02,188811,Nie; Jiawang,0,0,35,35
1683330826045,MATH 170A,A03,188814,Nie; Jiawang,1,0,35,34
1683330826045,MATH 170A,A04,188815,Nie; Jiawang,13,0,35,22
1683330827069,MATH 193B,A01,188817,Staff,0,0,35,35
1683330827069,MATH 193B,A02,188818,Staff,5,0,35,30
1683330828095,MGT 4,A01,202857,Anderson; John Charles,62,0,80,18
1683330829125,MGT 12,A00,202858,Lindenberger; Wade Douglas,42,0,90,48
1683330830154,MGT 18,A00,202859,Staff,74,0,90,16
1683330831178,MGT 18GS,A00,202860,McKay; Michael J,13,0,28,15
1683330832207,MGT 45,A00,202861,Pecore; Joseph P.,14,0,90,76
1683330833238,MGT 100,A00,202863,Yavorsky; Daniel Ryan,28,0,90,62
1683330834262,MGT 103,A00,202864,Ehrich; Kristine R,1,18,90,89
1683330835286,MGT 112,A00,202865,Ehrich; Kristine R,15,0,90,75
1683330836313,MGT 121A,A00,202868,Staff,0,20,0,0
1683330837337,MGT 131B,A00,202869,Anderson; John Charles,59,0,90,31
1683330838361,MGT 136,A00,202871,Lindenberger; Wade Douglas,84,0,90,6
1683330839385,MGT 164,A00,202873,Staff,0,68,90,91
1683330840413,MGT 164GS,A00,202874,McKay; Mary A,13,0,28,15
1683330841441,MGT 180,A00,202875,Staff,0,50,90,91
1683330842464,MMW 11R,A01,205019,Herbst; Matthew,3,0,30,27
1683330842464,MMW 11R,A02,205026,Herbst; Matthew,29,0,30,1
1683330843489,MMW 15,A01,193512,Chang; Edmond Yi-Teh,0,9,28,28
1683330843489,MMW 15,A02,193513,Chang; Edmond Yi-Teh,0,5,28,28
1683330843489,MMW 15,A03,193514,Chang; Edmond Yi-Teh,0,5,28,28
1683330843489,MMW 15,A04,193515,Chang; Edmond Yi-Teh,0,5,28,28
1683330843489,MMW 15,A05,193516,Chang; Edmond Yi-Teh,0,4,28,28
1683330843489,MMW 15,A06,193517,Chang; Edmond Yi-Teh,0,5,28,28
1683330843489,MMW 15,B01,193519,Chang; Edmond Yi-Teh,0,5,28,28
1683330843489,MMW 15,B02,193520,Chang; Edmond Yi-Teh,0,5,28,28
1683330843489,MMW 15,B03,193521,Chang; Edmond Yi-Teh,0,5,28,28
1683330843489,MMW 15,B04,193522,Chang; Edmond Yi-Teh,0,4,28,28
1683330843489,MMW 15,B05,193523,Chang; Edmond Yi-Teh,0,5,28,28
1683330843489,MMW 15,B06,193524,Chang; Edmond Yi-Teh,0,4,28,28
1683330844514,MMW 122,A01,193526,Rahimi; Babak,0,15,28,28
1683330844514,MMW 122,A02,193527,Rahimi; Babak,0,14,28,28
1683330844514,MMW 122,A03,193528,Rahimi; Babak,0,0,0,0
1683330844514,MMW 122,A04,193529,Rahimi; Babak,0,0,0,0
1683330845540,MUS 1A,A01,186663,Staff,0,20,35,35
1683330846565,MUS 4,A01,186715,Staff,0,12,35,35
1683330847592,MUS 5R,A01,186796,Dubnov; Shlomo,0,17,35,35
1683330848616,MUS 6,A01,186798,Staff,0,4,25,25
1683330849641,MUS 7,A01,186830,Staff,12,0,35,23
1683330850666,MUS 8,A01,186930,Staff,0,26,35,35
1683330851694,MUS 15,A01,186932,Staff,0,16,35,35
1683330851694,MUS 15,B01,186934,Staff,0,15,35,35
1683330852722,MUS 80,A00,186935,Staff,1,0,20,19
1683330852722,MUS 80,B00,186936,Staff,25,0,25,0
1683330853750,NANO 11,A00,204702,Lipomi; Darren John,0,0,0,0
1683330854776,NANO 15,A01,204709,Yang; Kesong,0,1,0,0
1683330855805,NANO 114,A00,202069,Jahed Motlagh; Zeinab,3,0,10,7
1683330856829,PHIL 1,A00,186955,Grush; Rick Scott,32,0,40,8
1683330857858,PHIL 10,A01,186973,Grush; Rick Scott,28,0,35,7
1683330857858,PHIL 10,A02,186974,Grush; Rick Scott,33,0,35,2
1683330858883,PHIL 13,A01,186976,Staff,7,0,35,28
1683330858883,PHIL 13,A02,186977,Staff,16,0,35,19
1683330859911,PHIL 14,A01,186979,Staff,31,0,35,4
1683330859911,PHIL 14,A02,186986,Staff,32,0,35,3
1683330860937,PHIL 28,A01,186988,Staff,16,0,30,14
1683330860937,PHIL 28,A02,186989,Staff,1,0,30,29
1683330860937,PHIL 28,A03,186990,Staff,9,0,30,21
1683330860937,PHIL 28,A04,186991,Staff,26,0,30,4
1683330861961,PHIL 120,A00,186997,Staff,23,0,40,17
1683330862989,PHIL 137,A00,187003,Staff,9,0,40,31
1683330864015,PHIL 150,A00,187015,Staff,47,0,70,23
1683330865043,PHIL 167,A00,187021,Lamey; Andy M.,35,0,40,5
1683330866070,PHIL 174,A01,202226,Staff,17,0,20,3
1683330866070,PHIL 174,A02,202235,Staff,20,0,20,0
1683330867094,PHIL 191A,A00,258918,Staff,0,0,1,1
1683330868122,PHYS 1A,A00,187028,Staff,27,0,60,33
1683330869147,PHYS 1AL,001,187036,Staff,3,0,30,27
1683330869147,PHYS 1AL,002,187049,Staff,18,0,30,12
1683330870170,PHYS 1B,A00,187058,Staff,22,0,60,38
1683330871197,PHYS 1BL,001,187064,Staff,0,0,30,30
1683330871197,PHYS 1BL,002,187070,Staff,5,0,30,25
1683330872223,PHYS 1C,A00,187082,Staff,31,0,120,89
1683330873248,PHYS 1CL,001,187088,Staff,0,9,30,30
1683330873248,PHYS 1CL,002,187089,Staff,0,2,30,30
1683330873248,PHYS 1CL,009,262693,Staff,11,0,30,19
1683330874270,PHYS 2B,A01,187097,Staff,54,0,115,61
1683330875298,PHYS 2C,A01,187099,Staff,67,0,115,48
1683330876326,PHYS 2CL,A01,187101,Staff,5,0,28,23
1683330876326,PHYS 2CL,A02,187102,Staff,15,0,28,13
1683330877351,PHYS 2D,A01,187123,Shotwell; Brian,95,0,115,20
1683330878376,PHYS 4B,A01,187133,Grinstein; Benjamin,35,0,50,15
1683330879399,POLI 10,A00,188819,Staff,0,4,50,50
1683330880423,POLI 11,A00,188827,Staff,43,0,50,7
1683330881450,POLI 13R,A00,188828,Staff,0,1,20,20
1683330882478,POLI 27,A01,188830,Elgin; Samuel Zincke,0,1,70,70
1683330883505,POLI 30,A00,188832,Desposato; Scott,31,0,50,19
1683330884530,POLI 102F,A00,188834,Staff,3,0,40,37
1683330885555,POLI 104A,A00,188852,Staff,14,0,30,16
1683330886579,POLI 104I,A00,188853,Staff,0,6,20,20
1683330887603,POLI 110B,A00,188854,Wiens; David,7,0,20,13
1683330888633,POLI 112A,A00,188855,Wiens; David,5,0,30,25
1683330889658,POLI 117R,A00,188856,Forman; Fonna,0,11,20,20
1683330890683,POLI 118,A00,188857,Ingham; Sean,8,0,20,12
1683330891708,POLI 120G,A00,188858,Staff,9,0,30,21
1683330892738,POLI 131CR,A00,188863,Hoston; Germaine,24,0,50,26
1683330893763,POLI 133,A00,188864,Nellis; Gareth Hb,44,0,50,6
1683330894791,POLI 134D,A00,188865,Desposato; Scott,27,0,30,3
1683330895823,POLI 142A,A00,188871,Gartzke; Erik,22,0,50,28
1683330896847,POLI 142K,A00,188874,Staff,38,0,50,12
1683330897874,POLI 143,A00,188940,Gartzke; Erik,16,0,30,14
1683330898898,POLI 153,A00,188943,Staff,3,0,20,17
1683330899926,POLI 160AA,A00,188944,Staff,12,0,40,28
1683330900954,POLI 170A,A00,188945,Staff,11,0,30,19
1683330903006,PSYC 1,A00,188952,Staff,37,0,90,53
1683330904034,PSYC 2,B00,188953,Staff,19,0,35,16
1683330905061,PSYC 6,A00,188970,Staff,47,0,60,13
1683330906086,PSYC 7,A00,188973,Staff,37,0,45,8
1683330907115,PSYC 60,A01,188980,Rickard; Timothy C.,43,0,60,17
1683330908140,PSYC 70,A01,189001,Steiner; Eric Tomas,24,0,45,21
1683330909165,PSYC 100,A00,189005,Lacefield; Katharine I,0,100,120,120
1683330910194,PSYC 102,A00,189008,Staff,9,0,30,21
1683330911222,PSYC 106,B00,189026,Gorman; Michael R.,34,0,60,26
1683330912250,PSYC 114,B01,189033,Winkielman; Piotr,0,32,30,30
1683330913334,PSYC 131,A00,189036,Anagnostaras; Stephan,0,43,60,60
1683330914358,PSYC 136,A00,189041,Lowe; Angela Beth,0,7,25,25
1683330915382,PSYC 137,A00,189057,Winkielman; Piotr,0,34,25,25
1683330916405,PSYC 144,A00,189107,Wixted; John T,0,7,50,50
1683330918452,PSYC 162,A00,189142,Staff,0,8,85,85
1683330919476,PSYC 172,A00,189144,Gorman; Michael R.,0,7,30,30
1683330921529,PSYC 179,A00,189146,Lacefield; Katharine I,0,84,120,120
1683330922554,PSYC 181,A00,189147,Anagnostaras; Stephan,0,44,90,90
1683330923582,PSYC 190R,A00,189148,Barner; David A.,0,22,80,80
1683330924608,PSYC 191,A00,189275,Rickard; Timothy C.,0,7,25,25
1683330925635,PSYC 193,A00,189276,Chapman; Eddie Nathaniel,0,1,0,4
1683330926664,PSYC 193L,A01,189281,Lowe; Angela Beth,12,0,20,8
1683330926664,PSYC 193L,B01,189285,Staff,28,0,35,7
1683330927690,RELI 149,A00,187137,Rahimi; Babak,7,0,40,33
1683330928715,SE 9,A01,187315,Staff,0,2,18,18
1683330929738,SE 101B,A00,187409,Staff,24,0,30,6
1683330930766,SE 110B,A00,187444,Staff,10,0,40,30
1683330931791,SE 130B,A00,187449,Staff,31,0,40,9
1683330932815,SE 150A,A00,187516,Staff,9,0,20,11
1683330933839,SE 154,A00,187528,Staff,30,0,50,20
1683330934863,SIO 3,A01,258171,Staff,35,0,40,5
1683330935888,SIO 10,A00,187144,Cook; Geoffrey W,0,3,75,75
1683330936914,SIO 45,A00,187152,Cook; Geoffrey W,1,0,100,99
1683330937940,SIO 109R,A00,194486,Staff,0,3,20,20
1683330939991,SIO 187,A01,187233,Kacev; David,12,0,40,28
1683330941016,SOCI 1,A01,258656,Thorpe; Charles Robert,28,0,30,2
1683330941016,SOCI 1,A02,258658,Thorpe; Charles Robert,30,0,30,0
1683330941016,SOCI 1,A03,258661,Thorpe; Charles Robert,25,0,25,0
1683330941016,SOCI 1,A04,258666,Thorpe; Charles Robert,22,0,25,3
1683330941016,SOCI 1,A05,258897,Thorpe; Charles Robert,23,0,25,2
1683330941016,SOCI 1,A06,258898,Thorpe; Charles Robert,25,0,25,0
1683330942042,SOCI 30,A01,258903,Pardo Guerra; Juan Pablo,15,0,30,15
1683330943068,SOCI 102,A00,258904,Staff,9,0,25,16
1683330944092,SOCI 106,A00,258905,Staff,19,0,25,6
1683330945115,SOCI 111,A00,258907,Ribas Norris; Janet Vanesa,26,0,30,4
1683330946137,SOCI 121R,A00,258908,Pardo Guerra; Juan Pablo,10,0,30,20
1683330947161,SOCI 126,A01,203330,Staff,14,0,20,6
1683330948185,SOCI 131,A00,258909,Thorpe; Charles Robert,31,0,60,29
1683330949209,SOCI 135,A00,258910,Payne; Christine Anna,0,9,30,30
1683330950234,SOCI 157,A00,258911,Staff,12,0,30,18
1683330951258,SOCI 184,A00,258912,Staff,25,0,30,5
1683330952282,SOCI 188D,A00,258913,Staff,21,0,30,9
1683330953309,SYN 2,001,187529,Staff,10,0,16,6
1683330953309,SYN 2,002,201452,Staff,0,18,16,16
1683330953309,SYN 2,003,201469,Staff,3,0,16,13
1683330954334,SYN 100,A01,187531,Staff,0,9,20,20
1683330954334,SYN 100,B01,201491,Staff,0,12,20,20
1683330955358,TDAC 1,A00,189286,Walsh; Kim C.,3,0,20,17
1683330955358,TDAC 1,B00,189287,Harting; Carla Kelso,11,0,20,9
1683330956383,TDAC 101,A00,189300,Walsh; Kim C.,16,0,20,4
1683330956383,TDAC 101,B00,189301,Harting; Carla Kelso,18,0,20,2
1683330957407,TDAC 102,A00,189304,Basso; Beatrice,14,0,20,6
1683330958434,TDAC 108,A00,189305,Staff,18,0,20,2
1683330959464,TDDE 131,A00,189310,Staff,19,0,20,1
1683330959464,TDDE 131,B00,189314,Staff,19,0,20,1
1683330959464,TDDE 131,C00,189315,Staff,48,0,50,2
1683330959464,TDDE 131,D00,189316,Staff,14,0,15,1
1683330959464,TDDE 131,E00,204841,Staff,20,0,20,0
1683330960488,TDGE 10,A00,189289,Staff,30,0,50,20
1683330960488,TDGE 10,B00,189290,Havis; Allan,1,0,50,49
1683330961512,TDGE 11,A00,189291,Fulton; Julia,0,3,50,50
1683330961512,TDGE 11,B00,189292,Staff,20,0,25,5
1683330961512,TDGE 11,C00,260270,Staff,0,0,0,0
1683330962535,TDGE 25,A00,189294,Staff,3,0,20,17
1683330963558,TDGE 124,A00,189318,Fulton; Julia,0,8,50,50
1683330964586,TDGE 125,A00,189319,Staff,13,0,25,12
1683330964586,TDGE 125,B00,189320,Staff,23,0,25,2
1683330965610,TDGE 127,A00,189322,Havis; Allan,0,0,50,50
1683330966634,TDHT 101,A00,189323,Staff,18,0,25,7
1683330966634,TDHT 101,B00,189324,Staff,25,0,25,0
1683330967659,TDHT 102,A00,189325,Staff,49,0,50,1
1683330968696,TDMV 1,A00,189295,Arcidiacono; Kristin,19,0,30,11
1683330968696,TDMV 1,B00,189296,Caligagan; Maria T.,24,0,30,6
1683330969723,TDMV 2,A00,189297,Sammartano; Tonnie,28,0,30,2
1683330969723,TDMV 2,B00,189299,Arcidiacono; Kristin,24,0,30,6
1683330970747,TDMV 3,A00,204998,Rincon; Alicia,22,0,30,8
1683330971771,TDMV 120,A00,189458,Sammartano; Tonnie,28,0,30,2
1683330972795,TDMV 138,A00,189541,Jun; Grace Shin Hae,22,0,40,18
1683330973825,TDMV 142,A00,189717,Caligagan; Tony,23,0,30,7
1683330973825,TDMV 142,B00,189718,Caligagan; Maria T.,25,0,30,5
1683330974852,TMC 2,A01,187533,Staff,25,0,25,0
1683330974852,TMC 2,A02,187534,Staff,25,0,25,0
1683330975879,USP 1,A01,187536,Kwak; Nancy,0,16,25,25
1683330976911,USP 5,A01,187538,Staff,10,0,25,15
1683330977936,USP 101,A00,199253,Staff,0,4,0,0
1683330978961,USP 124,A00,187562,Boomhower; Matthew Charles,1,0,30,29
1683330979988,USP 138,A00,187582,Staff,20,0,25,5
1683330981017,USP 152,A01,187597,Staff,4,0,25,21
1683330982040,USP 153,A00,187598,Staff,19,0,25,6
1683330983064,USP 168,A00,187607,Kwak; Nancy,2,0,5,3
1683330984089,USP 173,A00,187619,Staff,4,0,25,21
1683330985116,USP 181,A00,187638,Staff,0,0,25,25
1683330986140,VIS 103,A00,187650,Cruz; Edwin Teddy,23,0,75,52
1683330987164,VIS 110D,A00,187669,Staff,12,0,22,10
1683330988187,VIS 127C,A00,187720,Shen; Kuiyi,67,0,146,79
1683330989211,VIS 149,A00,187731,Yoldas; Pinar,0,14,22,22
1683330990234,VIS 151,A01,188091,Staff,22,0,34,12
1683330990234,VIS 151,A02,188092,Staff,11,0,34,23
1683330991260,VIS 160B,A00,188093,Stalbaum; Brett,0,0,10,10
1683330993310,WCWP 10B,A00,201720,Staff,10,0,15,5
1683330993310,WCWP 10B,B00,201722,Staff,8,0,15,7
1683330994333,WCWP 100,A00,201725,Gagnon; Jeffrey C,0,0,2,2
1683330994333,WCWP 100,B00,201727,Staff,0,4,15,15
1683330997426,ANBI 133,A00,258401,Wilder; Linnea Lorene,34,0,40,6
1683330998451,ANBI 140,A00,258395,Hrvoj Mihic; Branka,18,0,25,7
1683330999475,ANSC 120,A00,258402,Bialecki; Jon Anthony,27,0,40,13
1683331000500,ANSC 144,A00,258400,Staff,14,0,40,26
1683331002554,ANSC 166,A00,258396,Parish; Steven Martin,157,0,175,18
1683331003577,ANSC 180,A00,193533,Staff,9,0,20,11
1683331004601,ANSC 188,A00,258397,Jassal; Aftab,33,0,40,7
1683331005625,ANTH 3,A01,258316,Staff,23,0,30,7
1683331006653,ANTH 5,A00,258394,Semendeferi; Ekaterini,16,0,20,4
1683331007754,ANTH 21,A01,258331,Staff,8,0,40,32
1683331008778,ANTH 103,A00,258398,Varma; Saiba,15,0,25,10
1683331009805,AWP 10,001,202034,Staff,0,0,0,0
1683331009805,AWP 10,002,202035,Staff,0,0,0,0
1683331009805,AWP 10,003,202036,Staff,0,0,0,0
1683331009805,AWP 10,004,202037,Staff,0,0,0,0
1683331009805,AWP 10,005,202038,Staff,0,0,0,0
1683331009805,AWP 10,006,202039,Staff,0,0,0,0
1683331009805,AWP 10,007,202040,Staff,0,0,0,0
1683331009805,AWP 10,008,202041,Staff,0,0,0,0
1683331009805,AWP 10,009,202042,Staff,0,0,0,0
1683331009805,AWP 10,010,202043,Staff,0,0,0,0
1683331009805,AWP 10,011,202044,Staff,0,0,0,0
1683331009805,AWP 10,012,202045,Staff,0,0,0,0
1683331009805,AWP 10,013,202046,Staff,0,0,0,0
1683331009805,AWP 10,014,202047,Staff,0,0,0,0
1683331009805,AWP 10,015,202048,Staff,0,0,0,0
1683331009805,AWP 10,016,202049,Staff,0,0,0,0
1683331009805,AWP 10,017,202050,Staff,0,0,0,0
1683331009805,AWP 10,018,202051,Staff,0,0,0,0
1683331009805,AWP 10,019,202052,Staff,0,0,0,0
1683331009805,AWP 10,020,202053,Staff,0,0,0,0
1683331009805,AWP 10,021,202054,Staff,0,0,0,0
1683331009805,AWP 10,022,202055,Staff,0,0,0,0
1683331009805,AWP 10,023,202056,Staff,0,0,0,0
1683331009805,AWP 10,024,202057,Staff,0,0,0,0
1683331009805,AWP 10,025,202058,Staff,0,0,0,0
1683331009805,AWP 10,026,202059,Staff,0,0,0,0
1683331010829,AWP 102,001,202032,Staff,0,0,0,0
1683331010829,AWP 102,002,202033,Staff,0,0,0,0
1683331011854,BENG 100,A01,254234,Taylor Amos; Alyssa C,31,0,40,9
1683331012881,BENG 196,001,270013,Engler; Adam J.,9999,0,9999,0
1683331013912,BICD 100R,A01,202018,Smith; Laurie,0,7,32,32
1683331013912,BICD 100R,A02,202019,Smith; Laurie,0,2,32,32
1683331013912,BICD 100R,A03,202020,Smith; Laurie,0,1,32,32
1683331013912,BICD 100R,A04,202021,Smith; Laurie,9,0,32,23
1683331013912,BICD 100R,A05,202022,Smith; Laurie,12,0,32,20
1683331014945,BICD 136,A01,193242,Gustafson-Brown; Cindy,0,2,32,32
1683331014945,BICD 136,A02,193244,Gustafson-Brown; Cindy,14,0,32,18
1683331015971,BIEB 102,A01,193249,Butler; Shannon Rhey,0,2,32,32
1683331015971,BIEB 102,A02,193251,Butler; Shannon Rhey,0,0,32,32
1683331015971,BIEB 102,A03,193253,Butler; Shannon Rhey,0,1,32,32
1683331015971,BIEB 102,A04,193255,Butler; Shannon Rhey,17,0,32,15
1683331015971,BIEB 102,A05,193265,Butler; Shannon Rhey,26,0,32,6
1683331015971,BIEB 102,A06,193269,Butler; Shannon Rhey,16,0,32,16
1683331018079,BIEB 150,A01,193274,Staff,0,0,32,32
1683331018079,BIEB 150,A02,193285,Staff,23,0,32,9
1683331019108,BIEB 194,A00,193286,Kurle; Carolyn M.,22,0,32,10
1683331020137,BILD 1,A01,192291,Staff,16,0,32,16
1683331020137,BILD 1,A02,192292,Staff,30,0,32,2
1683331020137,BILD 1,B01,192520,Reuther; Keefe,0,1,0,0
1683331020137,BILD 1,B02,192532,Reuther; Keefe,0,1,0,0
1683331021162,BILD 3,A01,192556,Butler; Shannon Rhey,0,0,32,32
1683331021162,BILD 3,A02,192581,Butler; Shannon Rhey,5,0,32,27
1683331021162,BILD 3,A03,192611,Butler; Shannon Rhey,23,0,32,9
1683331021162,BILD 3,A04,192612,Butler; Shannon Rhey,25,0,32,7
1683331021162,BILD 3,A05,192613,Butler; Shannon Rhey,27,0,32,5
1683331021162,BILD 3,A06,192679,Butler; Shannon Rhey,27,0,32,5
1683331021162,BILD 3,A07,192682,Butler; Shannon Rhey,22,0,32,10
1683331022186,BILD 4,A01,192836,Reuther; Keefe,0,0,24,24
1683331022186,BILD 4,A02,193044,Reuther; Keefe,4,0,24,20
1683331023214,BILD 10,A01,193142,Gustafson-Brown; Cindy,30,0,32,2
1683331023214,BILD 10,A02,193149,Gustafson-Brown; Cindy,31,0,32,1
1683331024239,BIMM 100,A01,193301,Staff,0,6,32,32
1683331024239,BIMM 100,A02,193312,Staff,0,5,32,32
1683331024239,BIMM 100,A03,193323,Staff,0,8,32,32
1683331025269,BIMM 101,A01,193329,McDonnell; Lisa Marie,0,3,24,24
1683331025269,BIMM 101,A02,193339,McDonnell; Lisa Marie,0,3,24,24
1683331025269,BIMM 101,B01,193354,McDonnell; Lisa Marie,0,3,24,24
1683331025269,BIMM 101,B02,193357,McDonnell; Lisa Marie,0,3,24,24
1683331026296,BIMM 110,A01,193377,Tat; John,0,11,32,32
1683331026296,BIMM 110,A02,193378,Tat; John,1,9,32,31
1683331027321,BIMM 120,A01,206116,Staff,0,0,32,32
1683331027321,BIMM 120,A02,206117,Staff,8,0,32,24
1683331027321,BIMM 120,A03,206121,Staff,21,0,32,11
1683331028347,BIPN 100,A01,193393,Park; Ji Young,0,14,32,32
1683331028347,BIPN 100,A02,193402,Park; Ji Young,0,13,32,32
1683331028347,BIPN 100,A03,193413,Park; Ji Young,0,14,32,32
1683331028347,BIPN 100,A04,193414,Park; Ji Young,0,13,32,32
1683331029375,BIPN 102,A01,193429,Staff,0,0,32,32
1683331029375,BIPN 102,A02,193438,Staff,22,0,32,10
1683331030403,BIPN 106,A01,193450,Reyes Gonzalez; Catalina,0,2,40,40
1683331031429,BIPN 134,A01,193465,Cooke; James Edward,0,0,32,32
1683331031429,BIPN 134,A02,193474,Cooke; James Edward,25,0,32,7
1683331031429,BIPN 134,A03,193485,Cooke; James Edward,29,0,32,3
1683331031429,BIPN 134,A04,193486,Cooke; James Edward,21,0,32,11
1683331031429,BIPN 134,A05,193491,Cooke; James Edward,31,0,32,1
1683331031429,BIPN 134,A06,193501,Cooke; James Edward,30,0,32,2
1683331031429,BIPN 134,A07,193510,Cooke; James Edward,29,0,32,3
1683331033480,BISP 194,A00,222522,Staff,14,0,32,18
1683331034505,CAT 124,A01,202407,Staff,20,0,25,5
1683331035529,CAT 125,A00,202408,Marchisotto; Jennifer Anne,4,0,20,16
1683331036555,CAT 125R,A00,202409,Smith; Lauryn Alissa,0,11,20,20
1683331036555,CAT 125R,B00,202410,Morales; Celeste Georgianna,0,11,20,20
1683331036555,CAT 125R,C00,202411,Irwin; Matthew Joseph,0,10,20,20
1683331037582,CENG 15,A01,204712,Yang; Kesong,0,1,0,0
1683331038606,CENG 114,A00,202070,Jahed Motlagh; Zeinab,5,0,20,15
1683331039631,CGS 105,A00,185477,Wesling; Megan E.,24,0,40,16
1683331040655,CGS 106,A00,185494,Staff,13,0,22,9
1683331041685,CGS 108,A00,185495,Staff,14,0,20,6
1683331042714,CGS 114,A00,185496,Staff,13,0,18,5
1683331043738,CGS 119,A00,185501,Staff,15,0,20,5
1683331044762,CGS 120,A00,185511,Staff,13,0,20,7
1683331045788,CHEM 4,A01,184675,Bussey; Thomas J,96,0,100,4
1683331046812,CHEM 6A,A01,184677,Staff,34,0,60,26
1683331047839,CHEM 6B,A01,184679,Staff,65,0,100,35
1683331048868,CHEM 6C,A01,184681,Bussey; Thomas J,1,0,50,49
1683331048868,CHEM 6C,A02,184682,Bussey; Thomas J,34,0,50,16
1683331049893,CHEM 40A,A01,184684,Albizati; Kim F.,37,0,100,63
1683331050917,CHEM 40B,A01,184686,Albizati; Kim F.,0,20,100,100
1683331051944,CHEM 41B,A01,184690,Staff,52,0,100,48
1683331052972,COGS 3,A01,184715,Boyle; Mary E. T.,0,25,40,40
1683331053996,COGS 14B,A01,185172,Staff,0,15,38,38
1683331055020,COGS 18,A01,184736,Staff,17,0,80,63
1683331056048,COGS 100,A01,184932,Staff,0,5,73,73
1683331057075,COGS 101A,A01,184935,Staff,0,39,30,30
1683331058104,COGS 101B,A01,184944,Staff,0,2,30,30
1683331059128,COGS 101C,A01,184946,Staff,0,12,30,30
1683331060152,COGS 102A,A01,184951,Johnson; Christine M.,2,0,40,38
1683331061175,COGS 107B,A01,184953,Mooshagian; Eric Frederick,0,50,40,40
1683331062199,COGS 118B,A01,184959,Gupta; Anjum,0,48,40,40
1683331063226,COGS 153,A00,184961,Staff,0,15,30,30
1683331064253,COGS 177,A00,184962,Staff,0,20,30,30
1683331065281,COGS 187A,A01,184969,Boyle; Mary E. T.,0,17,40,40
1683331066308,COMM 10,A01,185174,Staff,0,5,25,25
1683331066308,COMM 10,A02,185189,Staff,0,5,25,25
1683331066308,COMM 10,A03,269821,Staff,0,0,0,0
1683331067335,COMM 100B,A01,185475,Staff,0,0,0,2
1683331067335,COMM 100B,A02,185476,Staff,14,0,25,11
1683331068359,COMM 100C,A01,185314,Staff,1,0,25,24
1683331068359,COMM 100C,A02,185327,Staff,19,0,25,6
1683331069384,COMM 110M,A00,185349,Staff,2,0,40,38
1683331070408,COMM 113T,A00,185352,Staff,24,0,40,16
1683331071435,COMM 114I,A00,185353,Staff,33,0,40,7
1683331072461,COMM 131,A00,185354,Staff,19,0,30,11
1683331073484,CSE 8A,A50,185358,Cao; Yingjun,0,46,10,10
1683331074512,CSE 8B,A01,185362,Staff,1,47,50,49
1683331075534,CSE 11,A01,185416,Cao; Yingjun,0,92,10,10
1683331076559,CSE 20,A01,185445,Briones; Jor-el Thomas Caparas,5,0,25,20
1683331077584,CSE 21,A01,185447,Staff,10,0,50,40
1683331078614,CSE 101,A01,185451,Staff,0,12,50,50
1683331078614,CSE 101,B01,185453,Jones; Miles E,0,11,50,50
1683331080665,CSE 141,A01,185458,Eldon; John,20,0,100,80
1683331081692,CSE 141L,A01,185461,Eldon; John,12,0,100,88
1683331082717,CSE 142,A01,185463,Staff,36,0,60,24
1683331082717,CSE 142,B01,201355,Staff,0,7,60,60
1683331083742,CSE 142L,A01,185470,Staff,36,0,60,24
1683331083742,CSE 142L,B01,201417,Staff,0,6,60,60
1683331084767,CSE 190,A00,201433,Staff,32,0,49,17
1683331085795,DOC 1,A01,259136,Strom; Megan C.,7,0,15,8
1683331085795,DOC 1,A02,259137,Strom; Megan C.,14,0,15,1
1683331085795,DOC 1,A03,259138,Strom; Megan C.,14,0,15,1
1683331085795,DOC 1,A04,259139,Strom; Megan C.,14,0,15,1
1683331086820,DOC 100D,A00,259140,Pass; Natalye Joann,16,0,25,9
1683331087845,DSGN 1,A01,184749,Rill; Bryan,0,25,30,30
1683331088872,DSGN 100,A01,185168,Staff,0,2,25,25
1683331089901,ECE 5,A01,185626,Morris; Karcher William,0,10,0,0
1683331090927,ECE 101,A01,185628,Staff,17,0,70,53
1683331091952,ECE 107,A01,185635,Baghdadchi; Saharnaz,0,0,20,20
1683331091952,ECE 107,A02,185638,Baghdadchi; Saharnaz,4,0,20,16
1683331092977,ECE 148,A01,185647,Silberman; Jack,0,0,16,16
1683331094008,ECON 1,A01,185537,Crane; Meredith Helen,54,0,70,16
1683331095036,ECON 3,A01,185549,Crane; Meredith Helen,33,0,70,37
1683331096060,ECON 4,A01,203354,Anderson; John Charles,0,4,10,10
1683331097087,ECON 100A,A01,185574,Staff,0,4,40,40
1683331098112,ECON 100B,A01,185576,Staff,10,22,50,40
1683331099135,ECON 100C,A01,185589,Newhouse; Herbert S,30,0,70,40
1683331100159,ECON 105,A00,185608,Vespa; Emanuel Ignacio,19,0,35,16
1683331101184,ECON 109,A01,185610,Shishkin; Denis,10,0,35,25
1683331102210,ECON 110A,A01,185612,Staff,11,0,40,29
1683331103236,ECON 120A,A01,185615,Staff,20,0,40,20
1683331104262,ECON 120C,A01,185617,Sun; Yixiao,0,20,70,70
1683331105286,ECON 144,A00,203346,Squires; Dale E,3,0,35,32
1683331106314,ECON 171,A01,203349,Newhouse; Herbert S,0,1,35,35
1683331107342,ECON 173A,A01,185621,Toda; Alexis Akira,21,0,35,14
1683331108372,EDS 25,A01,202413,Staff,0,1,0,0
1683331108372,EDS 25,A02,202414,Staff,0,1,0,0
1683331108372,EDS 25,A03,202415,Staff,0,0,0,0
1683331108372,EDS 25,A04,202416,Staff,0,1,0,0
1683331108372,EDS 25,A05,202439,Staff,0,0,0,0
1683331108372,EDS 25,A06,202440,Staff,0,0,0,0
1683331108372,EDS 25,B01,202631,Staff,0,0,0,0
1683331108372,EDS 25,B02,202632,Staff,0,0,0,0
1683331108372,EDS 25,B03,202639,Staff,0,0,0,0
1683331108372,EDS 25,B04,202640,Staff,0,0,0,0
1683331108372,EDS 25,B05,202643,Staff,0,0,0,0
1683331108372,EDS 25,B06,202644,Staff,0,0,0,0
1683331109395,EDS 38,A01,202659,Black; Alison Michelle,24,0,25,1
1683331110419,EDS 115,A00,202652,Staff,17,0,30,13
1683331111443,EDS 125,A00,202649,Staff,14,0,30,16
1683331112467,EDS 126,A01,203332,Staff,30,0,30,0
1683331113493,EDS 139,A00,202838,Staff,16,0,25,9
1683331114519,EDS 146,A01,202655,Staff,14,0,25,11
1683331115543,ENG 15,A00,185667,Staff,0,1,0,0
1683331115543,ENG 15,B00,185672,Staff,0,0,0,0
1683331115543,ENG 15,C00,185675,Staff,0,0,0,0
1683331115543,ENG 15,D00,185682,Staff,0,0,0,0
1683331115543,ENG 15,E00,185684,Staff,0,0,0,0
1683331116566,ETHN 103,A00,185710,Staff,0,3,35,35
1683331117591,ETHN 103A,A00,199228,Man; Simeon S,2,0,9,7
1683331118619,ETHN 109,A00,185711,Staff,18,0,35,17
1683331119644,ETHN 142,A00,185726,Staff,0,4,30,30
1683331120729,ETHN 163J,A00,199229,Man; Simeon S,5,0,8,3
1683331121753,ETHN 168,A00,185727,Staff,8,0,10,2
1683331122780,ETHN 182,A00,185728,Staff,1,0,35,34
1683331123808,ETHN 183,A00,185737,Staff,8,0,18,10
1683331124835,GLBH 111,A01,209361,Burgos; Jose L.,0,0,0,0
1683331126881,HIEU 104,A00,185792,Staff,16,0,20,4
1683331127904,HIEU 115,A00,185800,Staff,1,0,20,19
1683331128930,HIEU 128,A00,185801,Staff,0,7,20,20
1683331129957,HIEU 147,A00,185802,Staff,16,0,20,4
1683331130983,HIEU 154,A00,185823,Staff,12,0,20,8
1683331132008,HILA 102,A00,185826,Staff,13,0,20,7
1683331133032,HILD 2C,A01,185778,Staff,0,12,20,20
1683331134061,HILD 7B,A01,185780,Kwak; Nancy,0,15,32,32
1683331134061,HILD 7B,A02,185781,Kwak; Nancy,0,18,32,32
1683331135088,HILD 30,A01,185791,Staff,14,0,20,6
1683331136120,HISC 119,A00,185830,Golan; Tal,0,9,20,20
1683331137150,HITO 156GS,A00,185831,Patterson; Patrick H.,0,0,0,23
1683331138177,HIUS 103,A00,185832,Man; Simeon S,0,6,20,20
1683331139202,HIUS 117,A00,185836,Kwak; Nancy,2,0,20,18
1683331140226,HIUS 125,A00,185840,Man; Simeon S,0,0,23,23
1683331141264,HIUS 149,A00,185845,Staff,0,0,20,20
1683331142288,HUM 3,A01,185882,Zavodny; Tatiana Sophia,0,7,50,50
1683331142288,HUM 3,B01,185899,Caldwell; Michael Alan,0,18,50,50
1683331143318,HUM 3GS,A00,185900,Patterson; Patrick H.,0,0,0,23
1683331144349,HUM 4,A01,185938,Zroka; Amy Liane,31,0,50,19
1683331144349,HUM 4,B01,185956,Watkins; Eric,0,2,50,50
1683331144349,HUM 4,B02,202209,Watkins; Eric,0,2,50,50
1683331144349,HUM 4,B03,202210,Watkins; Eric,0,2,50,50
1683331145373,HUM 5,A01,185958,West; Geoffrey Scott,3,0,50,47
1683331145373,HUM 5,A02,202215,West; Geoffrey Scott,0,0,50,50
1683331146400,INTL 190,A00,185959,Gagnon; Jeffrey C,0,0,0,9
1683331146400,INTL 190,B00,185960,Lettieri; Michael Joseph,0,0,0,1
1683331147422,JAPN 180,A00,254509,Staff,5,1,30,25
1683331148447,LATI 10,A01,202853,Kennemore; Amy Michelle,4,0,35,31
1683331148447,LATI 10,A02,202854,Kennemore; Amy Michelle,2,0,35,33
1683331148447,LATI 10,A03,270054,Kennemore; Amy Michelle,30,0,30,0
1683331149475,LATI 180,A00,202855,Kennemore; Amy Michelle,11,0,20,9
1683331150502,LAWS 101,A00,201767,Golan; Tal,0,7,40,40
1683331151525,LIFR 1C,A00,185961,Staff,6,0,20,14
1683331152550,LIFR 1CX,A00,185962,Staff,7,0,20,13
1683331153574,LIFR 1D,A00,185963,Staff,9,0,20,11
1683331154598,LIFR 1DX,A00,185964,Staff,9,0,20,11
1683331155626,LIGN 101,A01,186039,Staff,43,0,50,7
1683331156651,LIGN 165,A00,186040,Staff,18,0,50,32
1683331157673,LTCS 108,A00,186041,Staff,6,0,10,4
1683331158700,LTCS 119,A00,186042,Staff,16,0,20,4
1683331159724,LTCS 130,A00,186043,Wesling; Megan E.,15,0,25,10
1683331161777,LTEA 138,A00,186119,Staff,14,0,40,26
1683331162806,LTEN 124,A00,186148,Staff,6,0,25,19
1683331163832,LTEN 178,A00,186149,Staff,7,0,15,8
1683331164859,LTEN 181,A00,186150,Blanco; John D,33,0,40,7
1683331165883,LTWL 120,A00,186160,Staff,20,0,25,5
1683331166907,LTWL 165,A00,186161,Staff,22,0,25,3
1683331167934,LTWR 100,A00,186162,Staff,0,5,15,15
1683331168961,LTWR 102,A00,186163,Doller; Ben,5,0,15,10
1683331169989,MAE 8,A01,186412,Staff,0,0,0,0
1683331171015,MAE 30B,A00,186445,Bahadori; Mohammad Yousef,83,0,100,17
1683331172042,MAE 40,A00,186592,Bewley; Thomas R,9,0,50,41
1683331173068,MAE 101B,A00,186593,Bahadori; Mohammad Yousef,81,0,100,19
1683331174094,MAE 105,A00,186594,Bandaru; Prabhakar,12,0,50,38
1683331175121,MAE 107,A00,186599,Pham; Hieu Tan,0,6,120,120
1683331176145,MAE 148,A01,186660,Silberman; Jack,3,0,16,13
1683331177171,MATH 10A,A01,188095,Staff,1,6,35,34
1683331178196,MATH 10B,A01,188097,Bowers; Adam R.,0,11,30,30
1683331178196,MATH 10B,A02,188099,Bowers; Adam R.,0,11,30,30
1683331178196,MATH 10B,B01,188104,Bowers; Adam R.,0,10,30,30
1683331178196,MATH 10B,B02,188106,Bowers; Adam R.,0,10,30,30
1683331179224,MATH 10C,A01,188111,Staff,0,18,30,30
1683331179224,MATH 10C,A02,188127,Staff,0,17,30,30
1683331179224,MATH 10C,A03,188131,Staff,0,18,30,30
1683331179224,MATH 10C,B01,188218,Staff,18,0,30,12
1683331179224,MATH 10C,B02,188244,Staff,13,0,30,17
1683331179224,MATH 10C,B03,188277,Staff,16,0,30,14
1683331180251,MATH 18,A01,188344,Bach; Quang Tran,18,0,30,12
1683331180251,MATH 18,A02,188345,Bach; Quang Tran,11,0,30,19
1683331180251,MATH 18,B01,188353,Bach; Quang Tran,10,0,30,20
1683331180251,MATH 18,B02,188354,Bach; Quang Tran,20,0,30,10
1683331181273,MATH 20A,A01,188374,Staff,13,0,35,22
1683331182301,MATH 20B,A01,188382,Ohm; Ko Woon,6,0,30,24
1683331182301,MATH 20B,A02,188383,Ohm; Ko Woon,22,0,30,8
1683331182301,MATH 20B,B01,188385,Ohm; Ko Woon,7,0,30,23
1683331182301,MATH 20B,B02,188392,Ohm; Ko Woon,22,0,30,8
1683331183326,MATH 20C,A01,188394,Harel; Guershon,10,0,30,20
1683331183326,MATH 20C,A02,188395,Harel; Guershon,15,0,30,15
1683331183326,MATH 20C,B01,188404,Harel; Guershon,5,0,30,25
1683331183326,MATH 20C,B02,188405,Harel; Guershon,19,0,30,11
1683331184355,MATH 20D,A01,188414,Hammock; Frances H,0,1,30,30
1683331184355,MATH 20D,A02,188415,Hammock; Frances H,3,0,30,27
1683331184355,MATH 20D,B01,188447,Hammock; Frances H,1,0,30,29
1683331184355,MATH 20D,B02,188486,Hammock; Frances H,8,0,30,22
1683331185379,MATH 20E,A01,188649,Staff,21,0,30,9
1683331185379,MATH 20E,A02,188650,Staff,23,0,30,7
1683331185379,MATH 20E,A03,188673,Staff,0,0,30,30
1683331186407,MATH 102,A01,188675,Staff,0,35,35,35
1683331187432,MATH 103B,A01,188681,Staff,3,0,35,32
1683331187432,MATH 103B,B01,188692,Staff,5,0,35,30
1683331188460,MATH 109,A01,188695,Salehi Golsefidy; Alireza,25,0,35,10
1683331188460,MATH 109,A02,188696,Salehi Golsefidy; Alireza,25,0,35,10
1683331189485,MATH 120A,A01,188698,Eggers; John Dietrich,7,0,35,28
1683331190512,MATH 142B,A01,188736,Ioana; Adrian,0,2,30,30
1683331190512,MATH 142B,A02,188741,Ioana; Adrian,1,1,30,29
1683331190512,MATH 142B,A03,188743,Ioana; Adrian,1,3,30,29
1683331191540,MATH 168A,A01,188790,Staff,0,9,35,35
1683331192569,MATH 170A,A01,188803,Nie; Jiawang,0,2,35,35
1683331192569,MATH 170A,A02,188811,Nie; Jiawang,0,0,35,35
1683331192569,MATH 170A,A03,188814,Nie; Jiawang,1,0,35,34
1683331192569,MATH 170A,A04,188815,Nie; Jiawang,13,0,35,22
1683331193594,MATH 193B,A01,188817,Staff,0,0,35,35
1683331193594,MATH 193B,A02,188818,Staff,5,0,35,30
1683331194620,MGT 4,A01,202857,Anderson; John Charles,62,0,80,18
1683331195645,MGT 12,A00,202858,Lindenberger; Wade Douglas,42,0,90,48
1683331196672,MGT 18,A00,202859,Staff,74,0,90,16
1683331197695,MGT 18GS,A00,202860,McKay; Michael J,13,0,28,15
1683331198720,MGT 45,A00,202861,Pecore; Joseph P.,14,0,90,76
1683331199746,MGT 100,A00,202863,Yavorsky; Daniel Ryan,28,0,90,62
1683331200771,MGT 103,A00,202864,Ehrich; Kristine R,1,18,90,89
1683331201794,MGT 112,A00,202865,Ehrich; Kristine R,15,0,90,75
1683331202819,MGT 121A,A00,202868,Staff,0,20,0,0
1683331203842,MGT 131B,A00,202869,Anderson; John Charles,59,0,90,31
1683331204870,MGT 136,A00,202871,Lindenberger; Wade Douglas,84,0,90,6
1683331205898,MGT 164,A00,202873,Staff,0,68,90,91
1683331206923,MGT 164GS,A00,202874,McKay; Mary A,13,0,28,15
1683331207950,MGT 180,A00,202875,Staff,0,50,90,91
1683331208977,MMW 11R,A01,205019,Herbst; Matthew,3,0,30,27
1683331208977,MMW 11R,A02,205026,Herbst; Matthew,29,0,30,1
1683331210011,MMW 15,A01,193512,Chang; Edmond Yi-Teh,0,9,28,28
1683331210011,MMW 15,A02,193513,Chang; Edmond Yi-Teh,0,5,28,28
1683331210011,MMW 15,A03,193514,Chang; Edmond Yi-Teh,0,5,28,28
1683331210011,MMW 15,A04,193515,Chang; Edmond Yi-Teh,0,5,28,28
1683331210011,MMW 15,A05,193516,Chang; Edmond Yi-Teh,0,4,28,28
1683331210011,MMW 15,A06,193517,Chang; Edmond Yi-Teh,0,5,28,28
1683331210011,MMW 15,B01,193519,Chang; Edmond Yi-Teh,0,5,28,28
1683331210011,MMW 15,B02,193520,Chang; Edmond Yi-Teh,0,5,28,28
1683331210011,MMW 15,B03,193521,Chang; Edmond Yi-Teh,0,5,28,28
1683331210011,MMW 15,B04,193522,Chang; Edmond Yi-Teh,0,4,28,28
1683331210011,MMW 15,B05,193523,Chang; Edmond Yi-Teh,0,5,28,28
1683331210011,MMW 15,B06,193524,Chang; Edmond Yi-Teh,0,4,28,28
1683331211038,MMW 122,A01,193526,Rahimi; Babak,0,15,28,28
1683331211038,MMW 122,A02,193527,Rahimi; Babak,0,14,28,28
1683331211038,MMW 122,A03,193528,Rahimi; Babak,0,0,0,0
1683331211038,MMW 122,A04,193529,Rahimi; Babak,0,0,0,0
1683331212062,MUS 1A,A01,186663,Staff,0,20,35,35
1683331213088,MUS 4,A01,186715,Staff,0,12,35,35
1683331214112,MUS 5R,A01,186796,Dubnov; Shlomo,0,17,35,35
1683331215135,MUS 6,A01,186798,Staff,0,4,25,25
1683331216159,MUS 7,A01,186830,Staff,12,0,35,23
1683331217181,MUS 8,A01,186930,Staff,0,26,35,35
1683331218209,MUS 15,A01,186932,Staff,0,16,35,35
1683331218209,MUS 15,B01,186934,Staff,0,15,35,35
1683331219233,MUS 80,A00,186935,Staff,1,0,20,19
1683331219233,MUS 80,B00,186936,Staff,25,0,25,0
1683331220259,NANO 11,A00,204702,Lipomi; Darren John,0,0,0,0
1683331221286,NANO 15,A01,204709,Yang; Kesong,0,1,0,0
1683331222313,NANO 114,A00,202069,Jahed Motlagh; Zeinab,3,0,10,7
1683331223340,PHIL 1,A00,186955,Grush; Rick Scott,32,0,40,8
1683331224427,PHIL 10,A01,186973,Grush; Rick Scott,28,0,35,7
1683331224427,PHIL 10,A02,186974,Grush; Rick Scott,33,0,35,2
1683331225461,PHIL 13,A01,186976,Staff,7,0,35,28
1683331225461,PHIL 13,A02,186977,Staff,16,0,35,19
1683331226486,PHIL 14,A01,186979,Staff,31,0,35,4
1683331226486,PHIL 14,A02,186986,Staff,32,0,35,3
1683331227516,PHIL 28,A01,186988,Staff,16,0,30,14
1683331227516,PHIL 28,A02,186989,Staff,1,0,30,29
1683331227516,PHIL 28,A03,186990,Staff,9,0,30,21
1683331227516,PHIL 28,A04,186991,Staff,26,0,30,4
1683331228543,PHIL 120,A00,186997,Staff,23,0,40,17
1683331229574,PHIL 137,A00,187003,Staff,9,0,40,31
1683331230601,PHIL 150,A00,187015,Staff,47,0,70,23
1683331231629,PHIL 167,A00,187021,Lamey; Andy M.,35,0,40,5
1683331232655,PHIL 174,A01,202226,Staff,17,0,20,3
1683331232655,PHIL 174,A02,202235,Staff,20,0,20,0
1683331233682,PHIL 191A,A00,258918,Staff,0,0,1,1
1683331234707,PHYS 1A,A00,187028,Staff,27,0,60,33
1683331235732,PHYS 1AL,001,187036,Staff,3,0,30,27
1683331235732,PHYS 1AL,002,187049,Staff,18,0,30,12
1683331236755,PHYS 1B,A00,187058,Staff,22,0,60,38
1683331237780,PHYS 1BL,001,187064,Staff,0,0,30,30
1683331237780,PHYS 1BL,002,187070,Staff,5,0,30,25
1683331238803,PHYS 1C,A00,187082,Staff,31,0,120,89
1683331239832,PHYS 1CL,001,187088,Staff,0,9,30,30
1683331239832,PHYS 1CL,002,187089,Staff,0,2,30,30
1683331239832,PHYS 1CL,009,262693,Staff,11,0,30,19
1683331240856,PHYS 2B,A01,187097,Staff,54,0,115,61
1683331241884,PHYS 2C,A01,187099,Staff,67,0,115,48
1683331242908,PHYS 2CL,A01,187101,Staff,5,0,28,23
1683331242908,PHYS 2CL,A02,187102,Staff,15,0,28,13
1683331243936,PHYS 2D,A01,187123,Shotwell; Brian,95,0,115,20
1683331244964,PHYS 4B,A01,187133,Grinstein; Benjamin,35,0,50,15
1683331245988,POLI 10,A00,188819,Staff,0,4,50,50
1683331247014,POLI 11,A00,188827,Staff,43,0,50,7
1683331248039,POLI 13R,A00,188828,Staff,0,1,20,20
1683331249063,POLI 27,A01,188830,Elgin; Samuel Zincke,0,1,70,70
1683331250090,POLI 30,A00,188832,Desposato; Scott,31,0,50,19
1683331251115,POLI 102F,A00,188834,Staff,3,0,40,37
1683331252142,POLI 104A,A00,188852,Staff,14,0,30,16
1683331253169,POLI 104I,A00,188853,Staff,0,6,20,20
1683331254195,POLI 110B,A00,188854,Wiens; David,7,0,20,13
1683331255221,POLI 112A,A00,188855,Wiens; David,5,0,30,25
1683331256245,POLI 117R,A00,188856,Forman; Fonna,0,11,20,20
1683331257271,POLI 118,A00,188857,Ingham; Sean,8,0,20,12
1683331258297,POLI 120G,A00,188858,Staff,9,0,30,21
1683331259322,POLI 131CR,A00,188863,Hoston; Germaine,24,0,50,26
1683331260347,POLI 133,A00,188864,Nellis; Gareth Hb,44,0,50,6
1683331261370,POLI 134D,A00,188865,Desposato; Scott,27,0,30,3
1683331262401,POLI 142A,A00,188871,Gartzke; Erik,22,0,50,28
1683331263427,POLI 142K,A00,188874,Staff,38,0,50,12
1683331264464,POLI 143,A00,188940,Gartzke; Erik,16,0,30,14
1683331265492,POLI 153,A00,188943,Staff,3,0,20,17
1683331266521,POLI 160AA,A00,188944,Staff,12,0,40,28
1683331267545,POLI 170A,A00,188945,Staff,11,0,30,19
1683331269595,PSYC 1,A00,188952,Staff,37,0,90,53
1683331270621,PSYC 2,B00,188953,Staff,19,0,35,16
1683331271648,PSYC 6,A00,188970,Staff,47,0,60,13
1683331272677,PSYC 7,A00,188973,Staff,37,0,45,8
1683331273704,PSYC 60,A01,188980,Rickard; Timothy C.,43,0,60,17
1683331274728,PSYC 70,A01,189001,Steiner; Eric Tomas,24,0,45,21
1683331275754,PSYC 100,A00,189005,Lacefield; Katharine I,0,100,120,120
1683331276782,PSYC 102,A00,189008,Staff,9,0,30,21
1683331277808,PSYC 106,B00,189026,Gorman; Michael R.,34,0,60,26
1683331278835,PSYC 114,B01,189033,Winkielman; Piotr,0,32,30,30
1683331279860,PSYC 131,A00,189036,Anagnostaras; Stephan,0,43,60,60
1683331280886,PSYC 136,A00,189041,Lowe; Angela Beth,0,7,25,25
1683331281916,PSYC 137,A00,189057,Winkielman; Piotr,0,34,25,25
1683331282947,PSYC 144,A00,189107,Wixted; John T,0,7,50,50
1683331284996,PSYC 162,A00,189142,Staff,0,8,85,85
1683331286025,PSYC 172,A00,189144,Gorman; Michael R.,0,7,30,30
1683331288076,PSYC 179,A00,189146,Lacefield; Katharine I,0,84,120,120
1683331289099,PSYC 181,A00,189147,Anagnostaras; Stephan,0,44,90,90
1683331290124,PSYC 190R,A00,189148,Barner; David A.,0,22,80,80
1683331291149,PSYC 191,A00,189275,Rickard; Timothy C.,0,7,25,25
1683331292176,PSYC 193,A00,189276,Chapman; Eddie Nathaniel,0,1,0,4
1683331293204,PSYC 193L,A01,189281,Lowe; Angela Beth,12,0,20,8
1683331293204,PSYC 193L,B01,189285,Staff,28,0,35,7
1683331294228,RELI 149,A00,187137,Rahimi; Babak,7,0,40,33
1683331295255,SE 9,A01,187315,Staff,0,2,18,18
1683331296279,SE 101B,A00,187409,Staff,24,0,30,6
1683331297304,SE 110B,A00,187444,Staff,10,0,40,30
1683331298327,SE 130B,A00,187449,Staff,31,0,40,9
1683331299351,SE 150A,A00,187516,Staff,9,0,20,11
1683331300374,SE 154,A00,187528,Staff,30,0,50,20
1683331301398,SIO 3,A01,258171,Staff,35,0,40,5
1683331302422,SIO 10,A00,187144,Cook; Geoffrey W,0,3,75,75
1683331303518,SIO 45,A00,187152,Cook; Geoffrey W,1,0,100,99
1683331304546,SIO 109R,A00,194486,Staff,0,3,20,20
1683331307175,SIO 187,A01,187233,Kacev; David,12,0,40,28
1683331308201,SOCI 1,A01,258656,Thorpe; Charles Robert,28,0,30,2
1683331308201,SOCI 1,A02,258658,Thorpe; Charles Robert,30,0,30,0
1683331308201,SOCI 1,A03,258661,Thorpe; Charles Robert,25,0,25,0
1683331308201,SOCI 1,A04,258666,Thorpe; Charles Robert,22,0,25,3
1683331308201,SOCI 1,A05,258897,Thorpe; Charles Robert,23,0,25,2
1683331308201,SOCI 1,A06,258898,Thorpe; Charles Robert,25,0,25,0
1683331309229,SOCI 30,A01,258903,Pardo Guerra; Juan Pablo,15,0,30,15
1683331310254,SOCI 102,A00,258904,Staff,9,0,25,16
1683331311280,SOCI 106,A00,258905,Staff,19,0,25,6
1683331312303,SOCI 111,A00,258907,Ribas Norris; Janet Vanesa,26,0,30,4
1683331313328,SOCI 121R,A00,258908,Pardo Guerra; Juan Pablo,10,0,30,20
1683331314355,SOCI 126,A01,203330,Staff,14,0,20,6
1683331315382,SOCI 131,A00,258909,Thorpe; Charles Robert,31,0,60,29
1683331316408,SOCI 135,A00,258910,Payne; Christine Anna,0,9,30,30
1683331317432,SOCI 157,A00,258911,Staff,12,0,30,18
1683331318460,SOCI 184,A00,258912,Staff,25,0,30,5
1683331319486,SOCI 188D,A00,258913,Staff,21,0,30,9
1683331320514,SYN 2,001,187529,Staff,10,0,16,6
1683331320514,SYN 2,002,201452,Staff,0,18,16,16
1683331320514,SYN 2,003,201469,Staff,3,0,16,13
1683331321541,SYN 100,A01,187531,Staff,0,9,20,20
1683331321541,SYN 100,B01,201491,Staff,0,12,20,20
1683331322569,TDAC 1,A00,189286,Walsh; Kim C.,3,0,20,17
1683331322569,TDAC 1,B00,189287,Harting; Carla Kelso,11,0,20,9
1683331323597,TDAC 101,A00,189300,Walsh; Kim C.,16,0,20,4
1683331323597,TDAC 101,B00,189301,Harting; Carla Kelso,18,0,20,2
1683331324623,TDAC 102,A00,189304,Basso; Beatrice,14,0,20,6
1683331325648,TDAC 108,A00,189305,Staff,18,0,20,2
1683331326674,TDDE 131,A00,189310,Staff,19,0,20,1
1683331326674,TDDE 131,B00,189314,Staff,19,0,20,1
1683331326674,TDDE 131,C00,189315,Staff,48,0,50,2
1683331326674,TDDE 131,D00,189316,Staff,14,0,15,1
1683331326674,TDDE 131,E00,204841,Staff,20,0,20,0
1683331327699,TDGE 10,A00,189289,Staff,30,0,50,20
1683331327699,TDGE 10,B00,189290,Havis; Allan,1,0,50,49
1683331328781,TDGE 11,A00,189291,Fulton; Julia,0,3,50,50
1683331328781,TDGE 11,B00,189292,Staff,20,0,25,5
1683331328781,TDGE 11,C00,260270,Staff,0,0,0,0
1683331329806,TDGE 25,A00,189294,Staff,3,0,20,17
1683331330836,TDGE 124,A00,189318,Fulton; Julia,0,8,50,50
1683331331862,TDGE 125,A00,189319,Staff,13,0,25,12
1683331331862,TDGE 125,B00,189320,Staff,23,0,25,2
1683331332891,TDGE 127,A00,189322,Havis; Allan,0,0,50,50
1683331333916,TDHT 101,A00,189323,Staff,18,0,25,7
1683331333916,TDHT 101,B00,189324,Staff,25,0,25,0
1683331334943,TDHT 102,A00,189325,Staff,49,0,50,1
1683331335967,TDMV 1,A00,189295,Arcidiacono; Kristin,19,0,30,11
1683331335967,TDMV 1,B00,189296,Caligagan; Maria T.,24,0,30,6
1683331336997,TDMV 2,A00,189297,Sammartano; Tonnie,28,0,30,2
1683331336997,TDMV 2,B00,189299,Arcidiacono; Kristin,24,0,30,6
1683331338022,TDMV 3,A00,204998,Rincon; Alicia,22,0,30,8
1683331339047,TDMV 120,A00,189458,Sammartano; Tonnie,28,0,30,2
1683331340073,TDMV 138,A00,189541,Jun; Grace Shin Hae,22,0,40,18
1683331341097,TDMV 142,A00,189717,Caligagan; Tony,23,0,30,7
1683331341097,TDMV 142,B00,189718,Caligagan; Maria T.,25,0,30,5
1683331342126,TMC 2,A01,187533,Staff,25,0,25,0
1683331342126,TMC 2,A02,187534,Staff,25,0,25,0
1683331343155,USP 1,A01,187536,Kwak; Nancy,0,16,25,25
1683331344180,USP 5,A01,187538,Staff,10,0,25,15
1683331345208,USP 101,A00,199253,Staff,0,4,0,0
1683331346233,USP 124,A00,187562,Boomhower; Matthew Charles,1,0,30,29
1683331347258,USP 138,A00,187582,Staff,20,0,25,5
1683331348286,USP 152,A01,187597,Staff,4,0,25,21
1683331349314,USP 153,A00,187598,Staff,19,0,25,6
1683331350345,USP 168,A00,187607,Kwak; Nancy,2,0,5,3
1683331351372,USP 173,A00,187619,Staff,4,0,25,21
1683331352397,USP 181,A00,187638,Staff,0,0,25,25
1683331353428,VIS 103,A00,187650,Cruz; Edwin Teddy,23,0,75,52
1683331354453,VIS 110D,A00,187669,Staff,12,0,22,10
1683331355481,VIS 127C,A00,187720,Shen; Kuiyi,67,0,146,79
1683331356508,VIS 149,A00,187731,Yoldas; Pinar,0,14,22,22
1683331357533,VIS 151,A01,188091,Staff,22,0,34,12
1683331357533,VIS 151,A02,188092,Staff,11,0,34,23
1683331358561,VIS 160B,A00,188093,Stalbaum; Brett,0,0,10,10
1683331360616,WCWP 10B,A00,201720,Staff,10,0,15,5
1683331360616,WCWP 10B,B00,201722,Staff,8,0,15,7
1683331361644,WCWP 100,A00,201725,Gagnon; Jeffrey C,0,0,2,2
1683331361644,WCWP 100,B00,201727,Staff,0,4,15,15
1683331364772,ANBI 133,A00,258401,Wilder; Linnea Lorene,34,0,40,6
1683331365796,ANBI 140,A00,258395,Hrvoj Mihic; Branka,18,0,25,7
1683331366824,ANSC 120,A00,258402,Bialecki; Jon Anthony,27,0,40,13
1683331367849,ANSC 144,A00,258400,Staff,14,0,40,26
1683331369899,ANSC 166,A00,258396,Parish; Steven Martin,157,0,175,18
1683331370927,ANSC 180,A00,193533,Staff,9,0,20,11
1683331371957,ANSC 188,A00,258397,Jassal; Aftab,33,0,40,7
1683331372982,ANTH 3,A01,258316,Staff,23,0,30,7
1683331374005,ANTH 5,A00,258394,Semendeferi; Ekaterini,16,0,20,4
1683331375029,ANTH 21,A01,258331,Staff,8,0,40,32
1683331376058,ANTH 103,A00,258398,Varma; Saiba,15,0,25,10
1683331377084,AWP 10,001,202034,Staff,0,0,0,0
1683331377084,AWP 10,002,202035,Staff,0,0,0,0
1683331377084,AWP 10,003,202036,Staff,0,0,0,0
1683331377084,AWP 10,004,202037,Staff,0,0,0,0
1683331377084,AWP 10,005,202038,Staff,0,0,0,0
1683331377084,AWP 10,006,202039,Staff,0,0,0,0
1683331377084,AWP 10,007,202040,Staff,0,0,0,0
1683331377084,AWP 10,008,202041,Staff,0,0,0,0
1683331377084,AWP 10,009,202042,Staff,0,0,0,0
1683331377084,AWP 10,010,202043,Staff,0,0,0,0
1683331377084,AWP 10,011,202044,Staff,0,0,0,0
1683331377084,AWP 10,012,202045,Staff,0,0,0,0
1683331377084,AWP 10,013,202046,Staff,0,0,0,0
1683331377084,AWP 10,014,202047,Staff,0,0,0,0
1683331377084,AWP 10,015,202048,Staff,0,0,0,0
1683331377084,AWP 10,016,202049,Staff,0,0,0,0
1683331377084,AWP 10,017,202050,Staff,0,0,0,0
1683331377084,AWP 10,018,202051,Staff,0,0,0,0
1683331377084,AWP 10,019,202052,Staff,0,0,0,0
1683331377084,AWP 10,020,202053,Staff,0,0,0,0
1683331377084,AWP 10,021,202054,Staff,0,0,0,0
1683331377084,AWP 10,022,202055,Staff,0,0,0,0
1683331377084,AWP 10,023,202056,Staff,0,0,0,0
1683331377084,AWP 10,024,202057,Staff,0,0,0,0
1683331377084,AWP 10,025,202058,Staff,0,0,0,0
1683331377084,AWP 10,026,202059,Staff,0,0,0,0
1683331378112,AWP 102,001,202032,Staff,0,0,0,0
1683331378112,AWP 102,002,202033,Staff,0,0,0,0
1683331379142,BENG 100,A01,254234,Taylor Amos; Alyssa C,31,0,40,9
1683331380167,BENG 196,001,270013,Engler; Adam J.,9999,0,9999,0
1683331381197,BICD 100R,A01,202018,Smith; Laurie,0,7,32,32
1683331381197,BICD 100R,A02,202019,Smith; Laurie,0,2,32,32
1683331381197,BICD 100R,A03,202020,Smith; Laurie,0,1,32,32
1683331381197,BICD 100R,A04,202021,Smith; Laurie,9,0,32,23
1683331381197,BICD 100R,A05,202022,Smith; Laurie,12,0,32,20
1683331382227,BICD 136,A01,193242,Gustafson-Brown; Cindy,0,2,32,32
1683331382227,BICD 136,A02,193244,Gustafson-Brown; Cindy,14,0,32,18
1683331383254,BIEB 102,A01,193249,Butler; Shannon Rhey,0,2,32,32
1683331383254,BIEB 102,A02,193251,Butler; Shannon Rhey,0,0,32,32
1683331383254,BIEB 102,A03,193253,Butler; Shannon Rhey,0,1,32,32
1683331383254,BIEB 102,A04,193255,Butler; Shannon Rhey,17,0,32,15
1683331383254,BIEB 102,A05,193265,Butler; Shannon Rhey,26,0,32,6
1683331383254,BIEB 102,A06,193269,Butler; Shannon Rhey,16,0,32,16
1683331385309,BIEB 150,A01,193274,Staff,0,0,32,32
1683331385309,BIEB 150,A02,193285,Staff,23,0,32,9
1683331386339,BIEB 194,A00,193286,Kurle; Carolyn M.,22,0,32,10
1683331387363,BILD 1,A01,192291,Staff,16,0,32,16
1683331387363,BILD 1,A02,192292,Staff,30,0,32,2
1683331387363,BILD 1,B01,192520,Reuther; Keefe,0,1,0,0
1683331387363,BILD 1,B02,192532,Reuther; Keefe,0,1,0,0
1683331388399,BILD 3,A01,192556,Butler; Shannon Rhey,0,0,32,32
1683331388399,BILD 3,A02,192581,Butler; Shannon Rhey,5,0,32,27
1683331388399,BILD 3,A03,192611,Butler; Shannon Rhey,23,0,32,9
1683331388399,BILD 3,A04,192612,Butler; Shannon Rhey,25,0,32,7
1683331388399,BILD 3,A05,192613,Butler; Shannon Rhey,27,0,32,5
1683331388399,BILD 3,A06,192679,Butler; Shannon Rhey,27,0,32,5
1683331388399,BILD 3,A07,192682,Butler; Shannon Rhey,22,0,32,10
1683331389430,BILD 4,A01,192836,Reuther; Keefe,0,0,24,24
1683331389430,BILD 4,A02,193044,Reuther; Keefe,4,0,24,20
1683331390454,BILD 10,A01,193142,Gustafson-Brown; Cindy,30,0,32,2
1683331390454,BILD 10,A02,193149,Gustafson-Brown; Cindy,31,0,32,1
1683331391478,BIMM 100,A01,193301,Staff,0,6,32,32
1683331391478,BIMM 100,A02,193312,Staff,0,5,32,32
1683331391478,BIMM 100,A03,193323,Staff,0,8,32,32
1683331392504,BIMM 101,A01,193329,McDonnell; Lisa Marie,0,3,24,24
1683331392504,BIMM 101,A02,193339,McDonnell; Lisa Marie,0,3,24,24
1683331392504,BIMM 101,B01,193354,McDonnell; Lisa Marie,0,3,24,24
1683331392504,BIMM 101,B02,193357,McDonnell; Lisa Marie,0,3,24,24
1683331393535,BIMM 110,A01,193377,Tat; John,0,11,32,32
1683331393535,BIMM 110,A02,193378,Tat; John,1,9,32,31
1683331394560,BIMM 120,A01,206116,Staff,0,0,32,32
1683331394560,BIMM 120,A02,206117,Staff,8,0,32,24
1683331394560,BIMM 120,A03,206121,Staff,21,0,32,11
1683331395585,BIPN 100,A01,193393,Park; Ji Young,0,14,32,32
1683331395585,BIPN 100,A02,193402,Park; Ji Young,0,13,32,32
1683331395585,BIPN 100,A03,193413,Park; Ji Young,0,14,32,32
1683331395585,BIPN 100,A04,193414,Park; Ji Young,0,13,32,32
1683331396613,BIPN 102,A01,193429,Staff,0,0,32,32
1683331396613,BIPN 102,A02,193438,Staff,22,0,32,10
1683331397637,BIPN 106,A01,193450,Reyes Gonzalez; Catalina,0,2,40,40
1683331398662,BIPN 134,A01,193465,Cooke; James Edward,0,0,32,32
1683331398662,BIPN 134,A02,193474,Cooke; James Edward,25,0,32,7
1683331398662,BIPN 134,A03,193485,Cooke; James Edward,29,0,32,3
1683331398662,BIPN 134,A04,193486,Cooke; James Edward,21,0,32,11
1683331398662,BIPN 134,A05,193491,Cooke; James Edward,31,0,32,1
1683331398662,BIPN 134,A06,193501,Cooke; James Edward,30,0,32,2
1683331398662,BIPN 134,A07,193510,Cooke; James Edward,29,0,32,3
1683331400711,BISP 194,A00,222522,Staff,14,0,32,18
1683331401739,CAT 124,A01,202407,Staff,20,0,25,5
1683331402763,CAT 125,A00,202408,Marchisotto; Jennifer Anne,4,0,20,16
1683331403789,CAT 125R,A00,202409,Smith; Lauryn Alissa,0,11,20,20
1683331403789,CAT 125R,B00,202410,Morales; Celeste Georgianna,0,11,20,20
1683331403789,CAT 125R,C00,202411,Irwin; Matthew Joseph,0,10,20,20
1683331404820,CENG 15,A01,204712,Yang; Kesong,0,1,0,0
1683331405847,CENG 114,A00,202070,Jahed Motlagh; Zeinab,5,0,20,15
1683331406872,CGS 105,A00,185477,Wesling; Megan E.,24,0,40,16
1683331407899,CGS 106,A00,185494,Staff,13,0,22,9
1683331408924,CGS 108,A00,185495,Staff,14,0,20,6
1683331409948,CGS 114,A00,185496,Staff,13,0,18,5
1683331410973,CGS 119,A00,185501,Staff,15,0,20,5
1683331411997,CGS 120,A00,185511,Staff,13,0,20,7
1683331413027,CHEM 4,A01,184675,Bussey; Thomas J,96,0,100,4
1683331414050,CHEM 6A,A01,184677,Staff,34,0,60,26
1683331415077,CHEM 6B,A01,184679,Staff,65,0,100,35
1683331416102,CHEM 6C,A01,184681,Bussey; Thomas J,1,0,50,49
1683331416102,CHEM 6C,A02,184682,Bussey; Thomas J,34,0,50,16
1683331417133,CHEM 40A,A01,184684,Albizati; Kim F.,37,0,100,63
1683331418158,CHEM 40B,A01,184686,Albizati; Kim F.,0,20,100,100
1683331419185,CHEM 41B,A01,184690,Staff,52,0,100,48
1683331420208,COGS 3,A01,184715,Boyle; Mary E. T.,0,25,40,40
1683331421235,COGS 14B,A01,185172,Staff,0,15,38,38
1683331422263,COGS 18,A01,184736,Staff,17,0,80,63
1683331423293,COGS 100,A01,184932,Staff,0,5,73,73
1683331424316,COGS 101A,A01,184935,Staff,0,39,30,30
1683331425341,COGS 101B,A01,184944,Staff,0,2,30,30
1683331426368,COGS 101C,A01,184946,Staff,0,12,30,30
1683331427403,COGS 102A,A01,184951,Johnson; Christine M.,2,0,40,38
1683331428433,COGS 107B,A01,184953,Mooshagian; Eric Frederick,0,50,40,40
1683331429459,COGS 118B,A01,184959,Gupta; Anjum,0,48,40,40
1683331430484,COGS 153,A00,184961,Staff,0,15,30,30
1683331431514,COGS 177,A00,184962,Staff,0,20,30,30
1683331432597,COGS 187A,A01,184969,Boyle; Mary E. T.,0,17,40,40
1683331433622,COMM 10,A01,185174,Staff,0,5,25,25
1683331433622,COMM 10,A02,185189,Staff,0,5,25,25
1683331433622,COMM 10,A03,269821,Staff,0,0,0,0
1683331434650,COMM 100B,A01,185475,Staff,0,0,0,2
1683331434650,COMM 100B,A02,185476,Staff,14,0,25,11
1683331435674,COMM 100C,A01,185314,Staff,1,0,25,24
1683331435674,COMM 100C,A02,185327,Staff,19,0,25,6
1683331436698,COMM 110M,A00,185349,Staff,2,0,40,38
1683331437724,COMM 113T,A00,185352,Staff,24,0,40,16
1683331438749,COMM 114I,A00,185353,Staff,33,0,40,7
1683331439777,COMM 131,A00,185354,Staff,19,0,30,11
1683331440802,CSE 8A,A50,185358,Cao; Yingjun,0,46,10,10
1683331441835,CSE 8B,A01,185362,Staff,1,47,50,49
1683331442864,CSE 11,A01,185416,Cao; Yingjun,0,92,10,10
1683331443893,CSE 20,A01,185445,Briones; Jor-el Thomas Caparas,5,0,25,20
1683331444922,CSE 21,A01,185447,Staff,10,0,50,40
1683331445947,CSE 101,A01,185451,Staff,0,12,50,50
1683331445947,CSE 101,B01,185453,Jones; Miles E,0,11,50,50
1683331448005,CSE 141,A01,185458,Eldon; John,20,0,100,80
1683331449033,CSE 141L,A01,185461,Eldon; John,12,0,100,88
1683331450059,CSE 142,A01,185463,Staff,36,0,60,24
1683331450059,CSE 142,B01,201355,Staff,0,7,60,60
1683331451085,CSE 142L,A01,185470,Staff,36,0,60,24
1683331451085,CSE 142L,B01,201417,Staff,0,6,60,60
1683331452112,CSE 190,A00,201433,Staff,32,0,49,17
1683331453137,DOC 1,A01,259136,Strom; Megan C.,7,0,15,8
1683331453137,DOC 1,A02,259137,Strom; Megan C.,14,0,15,1
1683331453137,DOC 1,A03,259138,Strom; Megan C.,14,0,15,1
1683331453137,DOC 1,A04,259139,Strom; Megan C.,14,0,15,1
1683331454164,DOC 100D,A00,259140,Pass; Natalye Joann,16,0,25,9
1683331455189,DSGN 1,A01,184749,Rill; Bryan,0,25,30,30
1683331456212,DSGN 100,A01,185168,Staff,0,2,25,25
1683331457236,ECE 5,A01,185626,Morris; Karcher William,0,10,0,0
1683331458261,ECE 101,A01,185628,Staff,17,0,70,53
1683331459288,ECE 107,A01,185635,Baghdadchi; Saharnaz,0,0,20,20
1683331459288,ECE 107,A02,185638,Baghdadchi; Saharnaz,4,0,20,16
1683331460315,ECE 148,A01,185647,Silberman; Jack,0,0,16,16
1683331461339,ECON 1,A01,185537,Crane; Meredith Helen,54,0,70,16
1683331462367,ECON 3,A01,185549,Crane; Meredith Helen,33,0,70,37
1683331463398,ECON 4,A01,203354,Anderson; John Charles,0,4,10,10
1683331464426,ECON 100A,A01,185574,Staff,0,4,40,40
1683331465453,ECON 100B,A01,185576,Staff,10,22,50,40
1683331466478,ECON 100C,A01,185589,Newhouse; Herbert S,30,0,70,40
1683331467501,ECON 105,A00,185608,Vespa; Emanuel Ignacio,19,0,35,16
1683331468529,ECON 109,A01,185610,Shishkin; Denis,10,0,35,25
1683331469557,ECON 110A,A01,185612,Staff,11,0,40,29
1683331470584,ECON 120A,A01,185615,Staff,20,0,40,20
1683331471609,ECON 120C,A01,185617,Sun; Yixiao,0,20,70,70
1683331472636,ECON 144,A00,203346,Squires; Dale E,3,0,35,32
1683331473665,ECON 171,A01,203349,Newhouse; Herbert S,0,1,35,35
1683331474694,ECON 173A,A01,185621,Toda; Alexis Akira,21,0,35,14
1683331475719,EDS 25,A01,202413,Staff,0,1,0,0
1683331475719,EDS 25,A02,202414,Staff,0,1,0,0
1683331475719,EDS 25,A03,202415,Staff,0,0,0,0
1683331475719,EDS 25,A04,202416,Staff,0,1,0,0
1683331475719,EDS 25,A05,202439,Staff,0,0,0,0
1683331475719,EDS 25,A06,202440,Staff,0,0,0,0
1683331475719,EDS 25,B01,202631,Staff,0,0,0,0
1683331475719,EDS 25,B02,202632,Staff,0,0,0,0
1683331475719,EDS 25,B03,202639,Staff,0,0,0,0
1683331475719,EDS 25,B04,202640,Staff,0,0,0,0
1683331475719,EDS 25,B05,202643,Staff,0,0,0,0
1683331475719,EDS 25,B06,202644,Staff,0,0,0,0
1683331476744,EDS 38,A01,202659,Black; Alison Michelle,24,0,25,1
1683331477769,EDS 115,A00,202652,Staff,17,0,30,13
1683331478792,EDS 125,A00,202649,Staff,14,0,30,16
1683331479820,EDS 126,A01,203332,Staff,30,0,30,0
1683331480847,EDS 139,A00,202838,Staff,16,0,25,9
1683331481871,EDS 146,A01,202655,Staff,14,0,25,11
1683331482895,ENG 15,A00,185667,Staff,0,1,0,0
1683331482895,ENG 15,B00,185672,Staff,0,0,0,0
1683331482895,ENG 15,C00,185675,Staff,0,0,0,0
1683331482895,ENG 15,D00,185682,Staff,0,0,0,0
1683331482895,ENG 15,E00,185684,Staff,0,0,0,0
1683331483919,ETHN 103,A00,185710,Staff,0,3,35,35
1683331484947,ETHN 103A,A00,199228,Man; Simeon S,2,0,9,7
1683331485973,ETHN 109,A00,185711,Staff,18,0,35,17
1683331487001,ETHN 142,A00,185726,Staff,0,4,30,30
1683331488026,ETHN 163J,A00,199229,Man; Simeon S,5,0,8,3
1683331489053,ETHN 168,A00,185727,Staff,8,0,10,2
1683331490077,ETHN 182,A00,185728,Staff,1,0,35,34
1683331491102,ETHN 183,A00,185737,Staff,8,0,18,10
1683331492125,GLBH 111,A01,209361,Burgos; Jose L.,0,0,0,0
1683331494177,HIEU 104,A00,185792,Staff,16,0,20,4
1683331495204,HIEU 115,A00,185800,Staff,1,0,20,19
1683331496228,HIEU 128,A00,185801,Staff,0,7,20,20
1683331497255,HIEU 147,A00,185802,Staff,16,0,20,4
1683331498282,HIEU 154,A00,185823,Staff,12,0,20,8
1683331499306,HILA 102,A00,185826,Staff,13,0,20,7
1683331500332,HILD 2C,A01,185778,Staff,0,12,20,20
1683331501358,HILD 7B,A01,185780,Kwak; Nancy,0,15,32,32
1683331501358,HILD 7B,A02,185781,Kwak; Nancy,0,18,32,32
1683331502387,HILD 30,A01,185791,Staff,14,0,20,6
1683331503416,HISC 119,A00,185830,Golan; Tal,0,9,20,20
1683331504444,HITO 156GS,A00,185831,Patterson; Patrick H.,0,0,0,23
1683331505472,HIUS 103,A00,185832,Man; Simeon S,0,6,20,20
1683331506500,HIUS 117,A00,185836,Kwak; Nancy,2,0,20,18
1683331507523,HIUS 125,A00,185840,Man; Simeon S,0,0,23,23
1683331508547,HIUS 149,A00,185845,Staff,0,0,20,20
1683331509577,HUM 3,A01,185882,Zavodny; Tatiana Sophia,0,7,50,50
1683331509577,HUM 3,B01,185899,Caldwell; Michael Alan,0,18,50,50
1683331510605,HUM 3GS,A00,185900,Patterson; Patrick H.,0,0,0,23
1683331511628,HUM 4,A01,185938,Zroka; Amy Liane,31,0,50,19
1683331511628,HUM 4,B01,185956,Watkins; Eric,0,2,50,50
1683331511628,HUM 4,B02,202209,Watkins; Eric,0,2,50,50
1683331511628,HUM 4,B03,202210,Watkins; Eric,0,2,50,50
1683331512653,HUM 5,A01,185958,West; Geoffrey Scott,3,0,50,47
1683331512653,HUM 5,A02,202215,West; Geoffrey Scott,0,0,50,50
1683331513682,INTL 190,A00,185959,Gagnon; Jeffrey C,0,0,0,9
1683331513682,INTL 190,B00,185960,Lettieri; Michael Joseph,0,0,0,1
1683331514706,JAPN 180,A00,254509,Staff,5,1,30,25
1683331515735,LATI 10,A01,202853,Kennemore; Amy Michelle,4,0,35,31
1683331515735,LATI 10,A02,202854,Kennemore; Amy Michelle,2,0,35,33
1683331515735,LATI 10,A03,270054,Kennemore; Amy Michelle,30,0,30,0
1683331516759,LATI 180,A00,202855,Kennemore; Amy Michelle,11,0,20,9
1683331517787,LAWS 101,A00,201767,Golan; Tal,0,7,40,40
1683331518814,LIFR 1C,A00,185961,Staff,6,0,20,14
1683331519842,LIFR 1CX,A00,185962,Staff,7,0,20,13
1683331520870,LIFR 1D,A00,185963,Staff,9,0,20,11
1683331521897,LIFR 1DX,A00,185964,Staff,9,0,20,11
1683331522922,LIGN 101,A01,186039,Staff,43,0,50,7
1683331523949,LIGN 165,A00,186040,Staff,18,0,50,32
1683331524973,LTCS 108,A00,186041,Staff,6,0,10,4
1683331526000,LTCS 119,A00,186042,Staff,16,0,20,4
1683331527025,LTCS 130,A00,186043,Wesling; Megan E.,15,0,25,10
1683331529079,LTEA 138,A00,186119,Staff,14,0,40,26
1683331530104,LTEN 124,A00,186148,Staff,6,0,25,19
1683331531128,LTEN 178,A00,186149,Staff,7,0,15,8
1683331532157,LTEN 181,A00,186150,Blanco; John D,33,0,40,7
1683331533184,LTWL 120,A00,186160,Staff,20,0,25,5
1683331534208,LTWL 165,A00,186161,Staff,22,0,25,3
1683331535235,LTWR 100,A00,186162,Staff,0,5,15,15
1683331536317,LTWR 102,A00,186163,Doller; Ben,5,0,15,10
1683331537345,MAE 8,A01,186412,Staff,0,0,0,0
1683331538373,MAE 30B,A00,186445,Bahadori; Mohammad Yousef,83,0,100,17
1683331539399,MAE 40,A00,186592,Bewley; Thomas R,9,0,50,41
1683331540422,MAE 101B,A00,186593,Bahadori; Mohammad Yousef,81,0,100,19
1683331541445,MAE 105,A00,186594,Bandaru; Prabhakar,12,0,50,38
1683331542472,MAE 107,A00,186599,Pham; Hieu Tan,0,6,120,120
1683331543500,MAE 148,A01,186660,Silberman; Jack,3,0,16,13
1683331544525,MATH 10A,A01,188095,Staff,1,6,35,34
1683331545555,MATH 10B,A01,188097,Bowers; Adam R.,0,11,30,30
1683331545555,MATH 10B,A02,188099,Bowers; Adam R.,0,11,30,30
1683331545555,MATH 10B,B01,188104,Bowers; Adam R.,0,10,30,30
1683331545555,MATH 10B,B02,188106,Bowers; Adam R.,0,10,30,30
1683331546580,MATH 10C,A01,188111,Staff,0,18,30,30
1683331546580,MATH 10C,A02,188127,Staff,0,17,30,30
1683331546580,MATH 10C,A03,188131,Staff,0,18,30,30
1683331546580,MATH 10C,B01,188218,Staff,18,0,30,12
1683331546580,MATH 10C,B02,188244,Staff,13,0,30,17
1683331546580,MATH 10C,B03,188277,Staff,16,0,30,14
1683331547605,MATH 18,A01,188344,Bach; Quang Tran,18,0,30,12
1683331547605,MATH 18,A02,188345,Bach; Quang Tran,11,0,30,19
1683331547605,MATH 18,B01,188353,Bach; Quang Tran,10,0,30,20
1683331547605,MATH 18,B02,188354,Bach; Quang Tran,20,0,30,10
1683331548633,MATH 20A,A01,188374,Staff,13,0,35,22
1683331549665,MATH 20B,A01,188382,Ohm; Ko Woon,6,0,30,24
1683331549665,MATH 20B,A02,188383,Ohm; Ko Woon,22,0,30,8
1683331549665,MATH 20B,B01,188385,Ohm; Ko Woon,7,0,30,23
1683331549665,MATH 20B,B02,188392,Ohm; Ko Woon,22,0,30,8
1683331550691,MATH 20C,A01,188394,Harel; Guershon,10,0,30,20
1683331550691,MATH 20C,A02,188395,Harel; Guershon,15,0,30,15
1683331550691,MATH 20C,B01,188404,Harel; Guershon,5,0,30,25
1683331550691,MATH 20C,B02,188405,Harel; Guershon,19,0,30,11
1683331551720,MATH 20D,A01,188414,Hammock; Frances H,0,1,30,30
1683331551720,MATH 20D,A02,188415,Hammock; Frances H,3,0,30,27
1683331551720,MATH 20D,B01,188447,Hammock; Frances H,1,0,30,29
1683331551720,MATH 20D,B02,188486,Hammock; Frances H,8,0,30,22
1683331552748,MATH 20E,A01,188649,Staff,21,0,30,9
1683331552748,MATH 20E,A02,188650,Staff,23,0,30,7
1683331552748,MATH 20E,A03,188673,Staff,0,0,30,30
1683331553773,MATH 102,A01,188675,Staff,0,35,35,35
1683331554798,MATH 103B,A01,188681,Staff,3,0,35,32
1683331554798,MATH 103B,B01,188692,Staff,5,0,35,30
1683331555827,MATH 109,A01,188695,Salehi Golsefidy; Alireza,25,0,35,10
1683331555827,MATH 109,A02,188696,Salehi Golsefidy; Alireza,25,0,35,10
1683331556857,MATH 120A,A01,188698,Eggers; John Dietrich,7,0,35,28
1683331557886,MATH 142B,A01,188736,Ioana; Adrian,0,2,30,30
1683331557886,MATH 142B,A02,188741,Ioana; Adrian,1,1,30,29
1683331557886,MATH 142B,A03,188743,Ioana; Adrian,1,3,30,29
1683331558914,MATH 168A,A01,188790,Staff,0,9,35,35
1683331559939,MATH 170A,A01,188803,Nie; Jiawang,0,2,35,35
1683331559939,MATH 170A,A02,188811,Nie; Jiawang,0,0,35,35
1683331559939,MATH 170A,A03,188814,Nie; Jiawang,1,0,35,34
1683331559939,MATH 170A,A04,188815,Nie; Jiawang,13,0,35,22
1683331560968,MATH 193B,A01,188817,Staff,0,0,35,35
1683331560968,MATH 193B,A02,188818,Staff,5,0,35,30
1683331561993,MGT 4,A01,202857,Anderson; John Charles,62,0,80,18
1683331563020,MGT 12,A00,202858,Lindenberger; Wade Douglas,42,0,90,48
1683331564048,MGT 18,A00,202859,Staff,74,0,90,16
1683331565076,MGT 18GS,A00,202860,McKay; Michael J,13,0,28,15
1683331566102,MGT 45,A00,202861,Pecore; Joseph P.,14,0,90,76
1683331567130,MGT 100,A00,202863,Yavorsky; Daniel Ryan,28,0,90,62
1683331568156,MGT 103,A00,202864,Ehrich; Kristine R,1,18,90,89
1683331569186,MGT 112,A00,202865,Ehrich; Kristine R,15,0,90,75
1683331570209,MGT 121A,A00,202868,Staff,0,20,0,0
1683331571235,MGT 131B,A00,202869,Anderson; John Charles,59,0,90,31
1683331572262,MGT 136,A00,202871,Lindenberger; Wade Douglas,84,0,90,6
1683331573286,MGT 164,A00,202873,Staff,0,68,90,91
1683331574314,MGT 164GS,A00,202874,McKay; Mary A,13,0,28,15
1683331575339,MGT 180,A00,202875,Staff,0,50,90,91
1683331576364,MMW 11R,A01,205019,Herbst; Matthew,3,0,30,27
1683331576364,MMW 11R,A02,205026,Herbst; Matthew,29,0,30,1
1683331577395,MMW 15,A01,193512,Chang; Edmond Yi-Teh,0,9,28,28
1683331577395,MMW 15,A02,193513,Chang; Edmond Yi-Teh,0,5,28,28
1683331577395,MMW 15,A03,193514,Chang; Edmond Yi-Teh,0,5,28,28
1683331577395,MMW 15,A04,193515,Chang; Edmond Yi-Teh,0,5,28,28
1683331577395,MMW 15,A05,193516,Chang; Edmond Yi-Teh,0,4,28,28
1683331577395,MMW 15,A06,193517,Chang; Edmond Yi-Teh,0,5,28,28
1683331577395,MMW 15,B01,193519,Chang; Edmond Yi-Teh,0,5,28,28
1683331577395,MMW 15,B02,193520,Chang; Edmond Yi-Teh,0,5,28,28
1683331577395,MMW 15,B03,193521,Chang; Edmond Yi-Teh,0,5,28,28
1683331577395,MMW 15,B04,193522,Chang; Edmond Yi-Teh,0,4,28,28
1683331577395,MMW 15,B05,193523,Chang; Edmond Yi-Teh,0,5,28,28
1683331577395,MMW 15,B06,193524,Chang; Edmond Yi-Teh,0,4,28,28
1683331578420,MMW 122,A01,193526,Rahimi; Babak,0,15,28,28
1683331578420,MMW 122,A02,193527,Rahimi; Babak,0,14,28,28
1683331578420,MMW 122,A03,193528,Rahimi; Babak,0,0,0,0
1683331578420,MMW 122,A04,193529,Rahimi; Babak,0,0,0,0
1683331579447,MUS 1A,A01,186663,Staff,0,20,35,35
1683331580472,MUS 4,A01,186715,Staff,0,12,35,35
1683331581501,MUS 5R,A01,186796,Dubnov; Shlomo,0,17,35,35
1683331582526,MUS 6,A01,186798,Staff,0,4,25,25
1683331583552,MUS 7,A01,186830,Staff,12,0,35,23
1683331584577,MUS 8,A01,186930,Staff,0,26,35,35
1683331585602,MUS 15,A01,186932,Staff,0,16,35,35
1683331585602,MUS 15,B01,186934,Staff,0,15,35,35
1683331586627,MUS 80,A00,186935,Staff,1,0,20,19
1683331586627,MUS 80,B00,186936,Staff,25,0,25,0
1683331587651,NANO 11,A00,204702,Lipomi; Darren John,0,0,0,0
1683331588683,NANO 15,A01,204709,Yang; Kesong,0,1,0,0
1683331589711,NANO 114,A00,202069,Jahed Motlagh; Zeinab,3,0,10,7
1683331590737,PHIL 1,A00,186955,Grush; Rick Scott,32,0,40,8
1683331591763,PHIL 10,A01,186973,Grush; Rick Scott,28,0,35,7
1683331591763,PHIL 10,A02,186974,Grush; Rick Scott,33,0,35,2
1683331592787,PHIL 13,A01,186976,Staff,7,0,35,28
1683331592787,PHIL 13,A02,186977,Staff,16,0,35,19
1683331593812,PHIL 14,A01,186979,Staff,31,0,35,4
1683331593812,PHIL 14,A02,186986,Staff,32,0,35,3
1683331594842,PHIL 28,A01,186988,Staff,16,0,30,14
1683331594842,PHIL 28,A02,186989,Staff,1,0,30,29
1683331594842,PHIL 28,A03,186990,Staff,9,0,30,21
1683331594842,PHIL 28,A04,186991,Staff,26,0,30,4
1683331595871,PHIL 120,A00,186997,Staff,23,0,40,17
1683331596895,PHIL 137,A00,187003,Staff,9,0,40,31
1683331597921,PHIL 150,A00,187015,Staff,47,0,70,23
1683331598949,PHIL 167,A00,187021,Lamey; Andy M.,35,0,40,5
1683331599974,PHIL 174,A01,202226,Staff,17,0,20,3
1683331599974,PHIL 174,A02,202235,Staff,20,0,20,0
1683331600998,PHIL 191A,A00,258918,Staff,0,0,1,1
1683331602023,PHYS 1A,A00,187028,Staff,27,0,60,33
1683331603052,PHYS 1AL,001,187036,Staff,3,0,30,27
1683331603052,PHYS 1AL,002,187049,Staff,18,0,30,12
1683331604078,PHYS 1B,A00,187058,Staff,22,0,60,38
1683331605103,PHYS 1BL,001,187064,Staff,0,0,30,30
1683331605103,PHYS 1BL,002,187070,Staff,5,0,30,25
1683331606127,PHYS 1C,A00,187082,Staff,31,0,120,89
1683331607156,PHYS 1CL,001,187088,Staff,0,9,30,30
1683331607156,PHYS 1CL,002,187089,Staff,0,2,30,30
1683331607156,PHYS 1CL,009,262693,Staff,11,0,30,19
1683331608188,PHYS 2B,A01,187097,Staff,54,0,115,61
1683331609212,PHYS 2C,A01,187099,Staff,67,0,115,48
1683331610239,PHYS 2CL,A01,187101,Staff,5,0,28,23
1683331610239,PHYS 2CL,A02,187102,Staff,15,0,28,13
1683331611267,PHYS 2D,A01,187123,Shotwell; Brian,95,0,115,20
1683331612294,PHYS 4B,A01,187133,Grinstein; Benjamin,35,0,50,15
1683331613320,POLI 10,A00,188819,Staff,0,4,50,50
1683331614347,POLI 11,A00,188827,Staff,43,0,50,7
1683331615371,POLI 13R,A00,188828,Staff,0,1,20,20
1683331616396,POLI 27,A01,188830,Elgin; Samuel Zincke,0,1,70,70
1683331617421,POLI 30,A00,188832,Desposato; Scott,31,0,50,19
1683331618448,POLI 102F,A00,188834,Staff,3,0,40,37
1683331619473,POLI 104A,A00,188852,Staff,14,0,30,16
1683331620500,POLI 104I,A00,188853,Staff,0,6,20,20
1683331621534,POLI 110B,A00,188854,Wiens; David,7,0,20,13
1683331622559,POLI 112A,A00,188855,Wiens; David,5,0,30,25
1683331623585,POLI 117R,A00,188856,Forman; Fonna,0,11,20,20
1683331624614,POLI 118,A00,188857,Ingham; Sean,8,0,20,12
1683331625639,POLI 120G,A00,188858,Staff,9,0,30,21
1683331626664,POLI 131CR,A00,188863,Hoston; Germaine,24,0,50,26
1683331627689,POLI 133,A00,188864,Nellis; Gareth Hb,44,0,50,6
1683331628718,POLI 134D,A00,188865,Desposato; Scott,27,0,30,3
1683331629745,POLI 142A,A00,188871,Gartzke; Erik,22,0,50,28
1683331630771,POLI 142K,A00,188874,Staff,38,0,50,12
1683331631796,POLI 143,A00,188940,Gartzke; Erik,16,0,30,14
1683331632822,POLI 153,A00,188943,Staff,3,0,20,17
1683331633850,POLI 160AA,A00,188944,Staff,12,0,40,28
1683331634877,POLI 170A,A00,188945,Staff,11,0,30,19
1683331636929,PSYC 1,A00,188952,Staff,37,0,90,53
1683331637956,PSYC 2,B00,188953,Staff,19,0,35,16
1683331638981,PSYC 6,A00,188970,Staff,47,0,60,13
1683331640068,PSYC 7,A00,188973,Staff,37,0,45,8
1683331641094,PSYC 60,A01,188980,Rickard; Timothy C.,43,0,60,17
1683331642122,PSYC 70,A01,189001,Steiner; Eric Tomas,24,0,45,21
1683331643151,PSYC 100,A00,189005,Lacefield; Katharine I,0,100,120,120
1683331644180,PSYC 102,A00,189008,Staff,9,0,30,21
1683331645203,PSYC 106,B00,189026,Gorman; Michael R.,34,0,60,26
1683331646225,PSYC 114,B01,189033,Winkielman; Piotr,0,32,30,30
1683331647250,PSYC 131,A00,189036,Anagnostaras; Stephan,0,43,60,60
1683331648273,PSYC 136,A00,189041,Lowe; Angela Beth,0,7,25,25
1683331649303,PSYC 137,A00,189057,Winkielman; Piotr,0,34,25,25
1683331650333,PSYC 144,A00,189107,Wixted; John T,0,7,50,50
1683331652384,PSYC 162,A00,189142,Staff,0,8,85,85
1683331653413,PSYC 172,A00,189144,Gorman; Michael R.,0,7,30,30
1683331655464,PSYC 179,A00,189146,Lacefield; Katharine I,0,84,120,120
1683331656490,PSYC 181,A00,189147,Anagnostaras; Stephan,0,44,90,90
1683331657516,PSYC 190R,A00,189148,Barner; David A.,0,22,80,80
1683331658546,PSYC 191,A00,189275,Rickard; Timothy C.,0,7,25,25
1683331659575,PSYC 193,A00,189276,Chapman; Eddie Nathaniel,0,1,0,4
1683331660601,PSYC 193L,A01,189281,Lowe; Angela Beth,12,0,20,8
1683331660601,PSYC 193L,B01,189285,Staff,28,0,35,7
1683331661625,RELI 149,A00,187137,Rahimi; Babak,7,0,40,33
1683331662651,SE 9,A01,187315,Staff,0,2,18,18
1683331663678,SE 101B,A00,187409,Staff,24,0,30,6
1683331664703,SE 110B,A00,187444,Staff,10,0,40,30
1683331665733,SE 130B,A00,187449,Staff,31,0,40,9
1683331666758,SE 150A,A00,187516,Staff,9,0,20,11
1683331667787,SE 154,A00,187528,Staff,30,0,50,20
1683331668815,SIO 3,A01,258171,Staff,35,0,40,5
1683331669842,SIO 10,A00,187144,Cook; Geoffrey W,0,3,75,75
1683331670870,SIO 45,A00,187152,Cook; Geoffrey W,1,0,100,99
1683331671895,SIO 109R,A00,194486,Staff,0,3,20,20
1683331673945,SIO 187,A01,187233,Kacev; David,12,0,40,28
1683331674974,SOCI 1,A01,258656,Thorpe; Charles Robert,28,0,30,2
1683331674974,SOCI 1,A02,258658,Thorpe; Charles Robert,30,0,30,0
1683331674974,SOCI 1,A03,258661,Thorpe; Charles Robert,25,0,25,0
1683331674974,SOCI 1,A04,258666,Thorpe; Charles Robert,22,0,25,3
1683331674974,SOCI 1,A05,258897,Thorpe; Charles Robert,23,0,25,2
1683331674974,SOCI 1,A06,258898,Thorpe; Charles Robert,25,0,25,0
1683331675999,SOCI 30,A01,258903,Pardo Guerra; Juan Pablo,15,0,30,15
1683331677024,SOCI 102,A00,258904,Staff,9,0,25,16
1683331678048,SOCI 106,A00,258905,Staff,19,0,25,6
1683331679076,SOCI 111,A00,258907,Ribas Norris; Janet Vanesa,26,0,30,4
1683331680102,SOCI 121R,A00,258908,Pardo Guerra; Juan Pablo,10,0,30,20
1683331681130,SOCI 126,A01,203330,Staff,14,0,20,6
1683331682154,SOCI 131,A00,258909,Thorpe; Charles Robert,31,0,60,29
1683331683180,SOCI 135,A00,258910,Payne; Christine Anna,0,9,30,30
1683331684210,SOCI 157,A00,258911,Staff,12,0,30,18
1683331685237,SOCI 184,A00,258912,Staff,25,0,30,5
1683331686265,SOCI 188D,A00,258913,Staff,21,0,30,9
1683331687291,SYN 2,001,187529,Staff,10,0,16,6
1683331687291,SYN 2,002,201452,Staff,0,18,16,16
1683331687291,SYN 2,003,201469,Staff,3,0,16,13
1683331688316,SYN 100,A01,187531,Staff,0,9,20,20
1683331688316,SYN 100,B01,201491,Staff,0,12,20,20
1683331689340,TDAC 1,A00,189286,Walsh; Kim C.,3,0,20,17
1683331689340,TDAC 1,B00,189287,Harting; Carla Kelso,11,0,20,9
1683331690370,TDAC 101,A00,189300,Walsh; Kim C.,16,0,20,4
1683331690370,TDAC 101,B00,189301,Harting; Carla Kelso,18,0,20,2
1683331691398,TDAC 102,A00,189304,Basso; Beatrice,14,0,20,6
1683331692426,TDAC 108,A00,189305,Staff,18,0,20,2
1683331693454,TDDE 131,A00,189310,Staff,19,0,20,1
1683331693454,TDDE 131,B00,189314,Staff,19,0,20,1
1683331693454,TDDE 131,C00,189315,Staff,48,0,50,2
1683331693454,TDDE 131,D00,189316,Staff,14,0,15,1
1683331693454,TDDE 131,E00,204841,Staff,20,0,20,0
1683331694480,TDGE 10,A00,189289,Staff,30,0,50,20
1683331694480,TDGE 10,B00,189290,Havis; Allan,1,0,50,49
1683331695505,TDGE 11,A00,189291,Fulton; Julia,0,3,50,50
1683331695505,TDGE 11,B00,189292,Staff,20,0,25,5
1683331695505,TDGE 11,C00,260270,Staff,0,0,0,0
1683331696533,TDGE 25,A00,189294,Staff,3,0,20,17
1683331697558,TDGE 124,A00,189318,Fulton; Julia,0,8,50,50
1683331698586,TDGE 125,A00,189319,Staff,13,0,25,12
1683331698586,TDGE 125,B00,189320,Staff,23,0,25,2
1683331699614,TDGE 127,A00,189322,Havis; Allan,0,0,50,50
1683331700638,TDHT 101,A00,189323,Staff,18,0,25,7
1683331700638,TDHT 101,B00,189324,Staff,25,0,25,0
1683331701664,TDHT 102,A00,189325,Staff,49,0,50,1
1683331702688,TDMV 1,A00,189295,Arcidiacono; Kristin,19,0,30,11
1683331702688,TDMV 1,B00,189296,Caligagan; Maria T.,24,0,30,6
1683331703713,TDMV 2,A00,189297,Sammartano; Tonnie,28,0,30,2
1683331703713,TDMV 2,B00,189299,Arcidiacono; Kristin,24,0,30,6
1683331704743,TDMV 3,A00,204998,Rincon; Alicia,22,0,30,8
1683331705775,TDMV 120,A00,189458,Sammartano; Tonnie,28,0,30,2
1683331706803,TDMV 138,A00,189541,Jun; Grace Shin Hae,22,0,40,18
1683331707828,TDMV 142,A00,189717,Caligagan; Tony,23,0,30,7
1683331707828,TDMV 142,B00,189718,Caligagan; Maria T.,25,0,30,5
1683331708857,TMC 2,A01,187533,Staff,25,0,25,0
1683331708857,TMC 2,A02,187534,Staff,25,0,25,0
1683331709881,USP 1,A01,187536,Kwak; Nancy,0,16,25,25
1683331710905,USP 5,A01,187538,Staff,10,0,25,15
1683331711931,USP 101,A00,199253,Staff,0,4,0,0
1683331712959,USP 124,A00,187562,Boomhower; Matthew Charles,1,0,30,29
1683331713983,USP 138,A00,187582,Staff,20,0,25,5
1683331715009,USP 152,A01,187597,Staff,4,0,25,21
1683331716033,USP 153,A00,187598,Staff,19,0,25,6
1683331717058,USP 168,A00,187607,Kwak; Nancy,2,0,5,3
1683331718082,USP 173,A00,187619,Staff,4,0,25,21
1683331719106,USP 181,A00,187638,Staff,0,0,25,25
1683331720129,VIS 103,A00,187650,Cruz; Edwin Teddy,23,0,75,52
1683331721153,VIS 110D,A00,187669,Staff,12,0,22,10
1683331722182,VIS 127C,A00,187720,Shen; Kuiyi,67,0,146,79
1683331723209,VIS 149,A00,187731,Yoldas; Pinar,0,14,22,22
1683331724234,VIS 151,A01,188091,Staff,22,0,34,12
1683331724234,VIS 151,A02,188092,Staff,11,0,34,23
1683331725258,VIS 160B,A00,188093,Stalbaum; Brett,0,0,10,10
1683331727310,WCWP 10B,A00,201720,Staff,10,0,15,5
1683331727310,WCWP 10B,B00,201722,Staff,8,0,15,7
1683331728339,WCWP 100,A00,201725,Gagnon; Jeffrey C,0,0,2,2
1683331728339,WCWP 100,B00,201727,Staff,0,4,15,15
1683331731432,ANBI 133,A00,258401,Wilder; Linnea Lorene,34,0,40,6
1683331732454,ANBI 140,A00,258395,Hrvoj Mihic; Branka,18,0,25,7
1683331733482,ANSC 120,A00,258402,Bialecki; Jon Anthony,27,0,40,13
1683331734506,ANSC 144,A00,258400,Staff,14,0,40,26
1683331736558,ANSC 166,A00,258396,Parish; Steven Martin,157,0,175,18
1683331737586,ANSC 180,A00,193533,Staff,9,0,20,11
1683331738611,ANSC 188,A00,258397,Jassal; Aftab,33,0,40,7
1683331739638,ANTH 3,A01,258316,Staff,23,0,30,7
1683331740665,ANTH 5,A00,258394,Semendeferi; Ekaterini,16,0,20,4
1683331741689,ANTH 21,A01,258331,Staff,8,0,40,32
1683331742714,ANTH 103,A00,258398,Varma; Saiba,15,0,25,10
1683331743814,AWP 10,001,202034,Staff,0,0,0,0
1683331743814,AWP 10,002,202035,Staff,0,0,0,0
1683331743814,AWP 10,003,202036,Staff,0,0,0,0
1683331743814,AWP 10,004,202037,Staff,0,0,0,0
1683331743814,AWP 10,005,202038,Staff,0,0,0,0
1683331743814,AWP 10,006,202039,Staff,0,0,0,0
1683331743814,AWP 10,007,202040,Staff,0,0,0,0
1683331743814,AWP 10,008,202041,Staff,0,0,0,0
1683331743814,AWP 10,009,202042,Staff,0,0,0,0
1683331743814,AWP 10,010,202043,Staff,0,0,0,0
1683331743814,AWP 10,011,202044,Staff,0,0,0,0
1683331743814,AWP 10,012,202045,Staff,0,0,0,0
1683331743814,AWP 10,013,202046,Staff,0,0,0,0
1683331743814,AWP 10,014,202047,Staff,0,0,0,0
1683331743814,AWP 10,015,202048,Staff,0,0,0,0
1683331743814,AWP 10,016,202049,Staff,0,0,0,0
1683331743814,AWP 10,017,202050,Staff,0,0,0,0
1683331743814,AWP 10,018,202051,Staff,0,0,0,0
1683331743814,AWP 10,019,202052,Staff,0,0,0,0
1683331743814,AWP 10,020,202053,Staff,0,0,0,0
1683331743814,AWP 10,021,202054,Staff,0,0,0,0
1683331743814,AWP 10,022,202055,Staff,0,0,0,0
1683331743814,AWP 10,023,202056,Staff,0,0,0,0
1683331743814,AWP 10,024,202057,Staff,0,0,0,0
1683331743814,AWP 10,025,202058,Staff,0,0,0,0
1683331743814,AWP 10,026,202059,Staff,0,0,0,0
1683331744839,AWP 102,001,202032,Staff,0,0,0,0
1683331744839,AWP 102,002,202033,Staff,0,0,0,0
1683331745863,BENG 100,A01,254234,Taylor Amos; Alyssa C,31,0,40,9
1683331746891,BENG 196,001,270013,Engler; Adam J.,9999,0,9999,0
1683331747915,BICD 100R,A01,202018,Smith; Laurie,0,7,32,32
1683331747915,BICD 100R,A02,202019,Smith; Laurie,0,2,32,32
1683331747915,BICD 100R,A03,202020,Smith; Laurie,0,1,32,32
1683331747915,BICD 100R,A04,202021,Smith; Laurie,9,0,32,23
1683331747915,BICD 100R,A05,202022,Smith; Laurie,12,0,32,20
1683331748939,BICD 136,A01,193242,Gustafson-Brown; Cindy,0,2,32,32
1683331748939,BICD 136,A02,193244,Gustafson-Brown; Cindy,14,0,32,18
1683331749970,BIEB 102,A01,193249,Butler; Shannon Rhey,0,2,32,32
1683331749970,BIEB 102,A02,193251,Butler; Shannon Rhey,0,0,32,32
1683331749970,BIEB 102,A03,193253,Butler; Shannon Rhey,0,1,32,32
1683331749970,BIEB 102,A04,193255,Butler; Shannon Rhey,17,0,32,15
1683331749970,BIEB 102,A05,193265,Butler; Shannon Rhey,26,0,32,6
1683331749970,BIEB 102,A06,193269,Butler; Shannon Rhey,16,0,32,16
1683331752021,BIEB 150,A01,193274,Staff,0,0,32,32
1683331752021,BIEB 150,A02,193285,Staff,23,0,32,9
1683331753046,BIEB 194,A00,193286,Kurle; Carolyn M.,22,0,32,10
1683331754075,BILD 1,A01,192291,Staff,16,0,32,16
1683331754075,BILD 1,A02,192292,Staff,30,0,32,2
1683331754075,BILD 1,B01,192520,Reuther; Keefe,0,1,0,0
1683331754075,BILD 1,B02,192532,Reuther; Keefe,0,1,0,0
1683331755099,BILD 3,A01,192556,Butler; Shannon Rhey,0,0,32,32
1683331755099,BILD 3,A02,192581,Butler; Shannon Rhey,5,0,32,27
1683331755099,BILD 3,A03,192611,Butler; Shannon Rhey,23,0,32,9
1683331755099,BILD 3,A04,192612,Butler; Shannon Rhey,25,0,32,7
1683331755099,BILD 3,A05,192613,Butler; Shannon Rhey,27,0,32,5
1683331755099,BILD 3,A06,192679,Butler; Shannon Rhey,27,0,32,5
1683331755099,BILD 3,A07,192682,Butler; Shannon Rhey,22,0,32,10
1683331756123,BILD 4,A01,192836,Reuther; Keefe,0,0,24,24
1683331756123,BILD 4,A02,193044,Reuther; Keefe,4,0,24,20
1683331757147,BILD 10,A01,193142,Gustafson-Brown; Cindy,30,0,32,2
1683331757147,BILD 10,A02,193149,Gustafson-Brown; Cindy,31,0,32,1
1683331758171,BIMM 100,A01,193301,Staff,0,6,32,32
1683331758171,BIMM 100,A02,193312,Staff,0,5,32,32
1683331758171,BIMM 100,A03,193323,Staff,0,8,32,32
1683331759195,BIMM 101,A01,193329,McDonnell; Lisa Marie,0,3,24,24
1683331759195,BIMM 101,A02,193339,McDonnell; Lisa Marie,0,3,24,24
1683331759195,BIMM 101,B01,193354,McDonnell; Lisa Marie,0,3,24,24
1683331759195,BIMM 101,B02,193357,McDonnell; Lisa Marie,0,3,24,24
1683331760220,BIMM 110,A01,193377,Tat; John,0,11,32,32
1683331760220,BIMM 110,A02,193378,Tat; John,1,9,32,31
1683331761245,BIMM 120,A01,206116,Staff,0,0,32,32
1683331761245,BIMM 120,A02,206117,Staff,8,0,32,24
1683331761245,BIMM 120,A03,206121,Staff,21,0,32,11
1683331762274,BIPN 100,A01,193393,Park; Ji Young,0,14,32,32
1683331762274,BIPN 100,A02,193402,Park; Ji Young,0,13,32,32
1683331762274,BIPN 100,A03,193413,Park; Ji Young,0,14,32,32
1683331762274,BIPN 100,A04,193414,Park; Ji Young,0,13,32,32
1683331763304,BIPN 102,A01,193429,Staff,0,0,32,32
1683331763304,BIPN 102,A02,193438,Staff,22,0,32,10
1683331764329,BIPN 106,A01,193450,Reyes Gonzalez; Catalina,0,2,40,40
1683331765358,BIPN 134,A01,193465,Cooke; James Edward,0,0,32,32
1683331765358,BIPN 134,A02,193474,Cooke; James Edward,25,0,32,7
1683331765358,BIPN 134,A03,193485,Cooke; James Edward,29,0,32,3
1683331765358,BIPN 134,A04,193486,Cooke; James Edward,21,0,32,11
1683331765358,BIPN 134,A05,193491,Cooke; James Edward,31,0,32,1
1683331765358,BIPN 134,A06,193501,Cooke; James Edward,30,0,32,2
1683331765358,BIPN 134,A07,193510,Cooke; James Edward,29,0,32,3
1683331767409,BISP 194,A00,222522,Staff,14,0,32,18
1683331768438,CAT 124,A01,202407,Staff,20,0,25,5
1683331769467,CAT 125,A00,202408,Marchisotto; Jennifer Anne,4,0,20,16
1683331770493,CAT 125R,A00,202409,Smith; Lauryn Alissa,0,11,20,20
1683331770493,CAT 125R,B00,202410,Morales; Celeste Georgianna,0,11,20,20
1683331770493,CAT 125R,C00,202411,Irwin; Matthew Joseph,0,10,20,20
1683331771522,CENG 15,A01,204712,Yang; Kesong,0,1,0,0
1683331772545,CENG 114,A00,202070,Jahed Motlagh; Zeinab,5,0,20,15
1683331773574,CGS 105,A00,185477,Wesling; Megan E.,24,0,40,16
1683331774602,CGS 106,A00,185494,Staff,13,0,22,9
1683331775627,CGS 108,A00,185495,Staff,14,0,20,6
1683331776655,CGS 114,A00,185496,Staff,13,0,18,5
1683331777681,CGS 119,A00,185501,Staff,15,0,20,5
1683331778705,CGS 120,A00,185511,Staff,13,0,20,7
1683331779735,CHEM 4,A01,184675,Bussey; Thomas J,96,0,100,4
1683331780758,CHEM 6A,A01,184677,Staff,34,0,60,26
1683331781783,CHEM 6B,A01,184679,Staff,65,0,100,35
1683331782812,CHEM 6C,A01,184681,Bussey; Thomas J,1,0,50,49
1683331782812,CHEM 6C,A02,184682,Bussey; Thomas J,34,0,50,16
1683331783838,CHEM 40A,A01,184684,Albizati; Kim F.,37,0,100,63
1683331784865,CHEM 40B,A01,184686,Albizati; Kim F.,0,20,100,100
1683331785891,CHEM 41B,A01,184690,Staff,52,0,100,48
1683331786916,COGS 3,A01,184715,Boyle; Mary E. T.,0,25,40,40
1683331787943,COGS 14B,A01,185172,Staff,0,15,38,38
1683331788969,COGS 18,A01,184736,Staff,17,0,80,63
1683331789994,COGS 100,A01,184932,Staff,0,5,73,73
1683331791018,COGS 101A,A01,184935,Staff,0,39,30,30
1683331792043,COGS 101B,A01,184944,Staff,0,2,30,30
1683331793068,COGS 101C,A01,184946,Staff,0,12,30,30
1683331794093,COGS 102A,A01,184951,Johnson; Christine M.,2,0,40,38
1683331795116,COGS 107B,A01,184953,Mooshagian; Eric Frederick,0,50,40,40
1683331796141,COGS 118B,A01,184959,Gupta; Anjum,0,48,40,40
1683331797165,COGS 153,A00,184961,Staff,0,15,30,30
1683331798189,COGS 177,A00,184962,Staff,0,20,30,30
1683331799219,COGS 187A,A01,184969,Boyle; Mary E. T.,0,17,40,40
1683331800248,COMM 10,A01,185174,Staff,0,5,25,25
1683331800248,COMM 10,A02,185189,Staff,0,5,25,25
1683331800248,COMM 10,A03,269821,Staff,0,0,0,0
1683331801278,COMM 100B,A01,185475,Staff,0,0,0,2
1683331801278,COMM 100B,A02,185476,Staff,14,0,25,11
1683331802306,COMM 100C,A01,185314,Staff,1,0,25,24
1683331802306,COMM 100C,A02,185327,Staff,19,0,25,6
1683331803333,COMM 110M,A00,185349,Staff,2,0,40,38
1683331804361,COMM 113T,A00,185352,Staff,24,0,40,16
1683331805387,COMM 114I,A00,185353,Staff,33,0,40,7
1683331806414,COMM 131,A00,185354,Staff,19,0,30,11
1683331807442,CSE 8A,A50,185358,Cao; Yingjun,0,46,10,10
1683331808467,CSE 8B,A01,185362,Staff,1,47,50,49
1683331809493,CSE 11,A01,185416,Cao; Yingjun,0,92,10,10
1683331810517,CSE 20,A01,185445,Briones; Jor-el Thomas Caparas,5,0,25,20
1683331811542,CSE 21,A01,185447,Staff,10,0,50,40
1683331812569,CSE 101,A01,185451,Staff,0,12,50,50
1683331812569,CSE 101,B01,185453,Jones; Miles E,0,11,50,50
1683331814624,CSE 141,A01,185458,Eldon; John,20,0,100,80
1683331815649,CSE 141L,A01,185461,Eldon; John,12,0,100,88
1683331816675,CSE 142,A01,185463,Staff,36,0,60,24
1683331816675,CSE 142,B01,201355,Staff,0,7,60,60
1683331817700,CSE 142L,A01,185470,Staff,36,0,60,24
1683331817700,CSE 142L,B01,201417,Staff,0,6,60,60
1683331818724,CSE 190,A00,201433,Staff,32,0,49,17
1683331819753,DOC 1,A01,259136,Strom; Megan C.,7,0,15,8
1683331819753,DOC 1,A02,259137,Strom; Megan C.,14,0,15,1
1683331819753,DOC 1,A03,259138,Strom; Megan C.,14,0,15,1
1683331819753,DOC 1,A04,259139,Strom; Megan C.,14,0,15,1
1683331820780,DOC 100D,A00,259140,Pass; Natalye Joann,16,0,25,9
1683331821809,DSGN 1,A01,184749,Rill; Bryan,0,25,30,30
1683331822834,DSGN 100,A01,185168,Staff,0,2,25,25
1683331823859,ECE 5,A01,185626,Morris; Karcher William,0,10,0,0
1683331824885,ECE 101,A01,185628,Staff,17,0,70,53
1683331825913,ECE 107,A01,185635,Baghdadchi; Saharnaz,0,0,20,20
1683331825913,ECE 107,A02,185638,Baghdadchi; Saharnaz,4,0,20,16
1683331826938,ECE 148,A01,185647,Silberman; Jack,0,0,16,16
1683331827967,ECON 1,A01,185537,Crane; Meredith Helen,54,0,70,16
1683331828992,ECON 3,A01,185549,Crane; Meredith Helen,33,0,70,37
1683331830021,ECON 4,A01,203354,Anderson; John Charles,0,4,10,10
1683331831046,ECON 100A,A01,185574,Staff,0,4,40,40
1683331832070,ECON 100B,A01,185576,Staff,10,22,50,40
1683331833099,ECON 100C,A01,185589,Newhouse; Herbert S,30,0,70,40
1683331834127,ECON 105,A00,185608,Vespa; Emanuel Ignacio,19,0,35,16
1683331835154,ECON 109,A01,185610,Shishkin; Denis,10,0,35,25
1683331836183,ECON 110A,A01,185612,Staff,11,0,40,29
1683331837208,ECON 120A,A01,185615,Staff,20,0,40,20
1683331838233,ECON 120C,A01,185617,Sun; Yixiao,0,20,70,70
1683331839263,ECON 144,A00,203346,Squires; Dale E,3,0,35,32
1683331840292,ECON 171,A01,203349,Newhouse; Herbert S,0,1,35,35
1683331841327,ECON 173A,A01,185621,Toda; Alexis Akira,21,0,35,14
1683331842358,EDS 25,A01,202413,Staff,0,1,0,0
1683331842358,EDS 25,A02,202414,Staff,0,1,0,0
1683331842358,EDS 25,A03,202415,Staff,0,0,0,0
1683331842358,EDS 25,A04,202416,Staff,0,1,0,0
1683331842358,EDS 25,A05,202439,Staff,0,0,0,0
1683331842358,EDS 25,A06,202440,Staff,0,0,0,0
1683331842358,EDS 25,B01,202631,Staff,0,0,0,0
1683331842358,EDS 25,B02,202632,Staff,0,0,0,0
1683331842358,EDS 25,B03,202639,Staff,0,0,0,0
1683331842358,EDS 25,B04,202640,Staff,0,0,0,0
1683331842358,EDS 25,B05,202643,Staff,0,0,0,0
1683331842358,EDS 25,B06,202644,Staff,0,0,0,0
1683331843382,EDS 38,A01,202659,Black; Alison Michelle,24,0,25,1
1683331844407,EDS 115,A00,202652,Staff,17,0,30,13
1683331845433,EDS 125,A00,202649,Staff,14,0,30,16
1683331846457,EDS 126,A01,203332,Staff,30,0,30,0
1683331847538,EDS 139,A00,202838,Staff,16,0,25,9
1683331848563,EDS 146,A01,202655,Staff,14,0,25,11
1683331849589,ENG 15,A00,185667,Staff,0,1,0,0
1683331849589,ENG 15,B00,185672,Staff,0,0,0,0
1683331849589,ENG 15,C00,185675,Staff,0,0,0,0
1683331849589,ENG 15,D00,185682,Staff,0,0,0,0
1683331849589,ENG 15,E00,185684,Staff,0,0,0,0
1683331850619,ETHN 103,A00,185710,Staff,0,3,35,35
1683331851643,ETHN 103A,A00,199228,Man; Simeon S,2,0,9,7
1683331852669,ETHN 109,A00,185711,Staff,18,0,35,17
1683331853693,ETHN 142,A00,185726,Staff,0,4,30,30
1683331854717,ETHN 163J,A00,199229,Man; Simeon S,5,0,8,3
1683331855742,ETHN 168,A00,185727,Staff,8,0,10,2
1683331856769,ETHN 182,A00,185728,Staff,1,0,35,34
1683331857794,ETHN 183,A00,185737,Staff,8,0,18,10
1683331858823,GLBH 111,A01,209361,Burgos; Jose L.,0,0,0,0
1683331860871,HIEU 104,A00,185792,Staff,16,0,20,4
1683331861896,HIEU 115,A00,185800,Staff,1,0,20,19
1683331862922,HIEU 128,A00,185801,Staff,0,7,20,20
1683331863952,HIEU 147,A00,185802,Staff,16,0,20,4
1683331864978,HIEU 154,A00,185823,Staff,12,0,20,8
1683331866002,HILA 102,A00,185826,Staff,13,0,20,7
1683331867025,HILD 2C,A01,185778,Staff,0,12,20,20
1683331868050,HILD 7B,A01,185780,Kwak; Nancy,0,15,32,32
1683331868050,HILD 7B,A02,185781,Kwak; Nancy,0,18,32,32
1683331869075,HILD 30,A01,185791,Staff,14,0,20,6
1683331870100,HISC 119,A00,185830,Golan; Tal,0,9,20,20
1683331871125,HITO 156GS,A00,185831,Patterson; Patrick H.,0,0,0,23
1683331872151,HIUS 103,A00,185832,Man; Simeon S,0,6,20,20
1683331873177,HIUS 117,A00,185836,Kwak; Nancy,2,0,20,18
1683331874207,HIUS 125,A00,185840,Man; Simeon S,0,0,23,23
1683331875234,HIUS 149,A00,185845,Staff,0,0,20,20
1683331876263,HUM 3,A01,185882,Zavodny; Tatiana Sophia,0,7,50,50
1683331876263,HUM 3,B01,185899,Caldwell; Michael Alan,0,18,50,50
1683331877290,HUM 3GS,A00,185900,Patterson; Patrick H.,0,0,0,23
1683331878323,HUM 4,A01,185938,Zroka; Amy Liane,31,0,50,19
1683331878323,HUM 4,B01,185956,Watkins; Eric,0,2,50,50
1683331878323,HUM 4,B02,202209,Watkins; Eric,0,2,50,50
1683331878323,HUM 4,B03,202210,Watkins; Eric,0,2,50,50
1683331879351,HUM 5,A01,185958,West; Geoffrey Scott,3,0,50,47
1683331879351,HUM 5,A02,202215,West; Geoffrey Scott,0,0,50,50
1683331880380,INTL 190,A00,185959,Gagnon; Jeffrey C,0,0,0,9
1683331880380,INTL 190,B00,185960,Lettieri; Michael Joseph,0,0,0,1
1683331881407,JAPN 180,A00,254509,Staff,5,1,30,25
1683331882436,LATI 10,A01,202853,Kennemore; Amy Michelle,4,0,35,31
1683331882436,LATI 10,A02,202854,Kennemore; Amy Michelle,2,0,35,33
1683331882436,LATI 10,A03,270054,Kennemore; Amy Michelle,30,0,30,0
1683331883463,LATI 180,A00,202855,Kennemore; Amy Michelle,11,0,20,9
1683331884487,LAWS 101,A00,201767,Golan; Tal,0,7,40,40
1683331885516,LIFR 1C,A00,185961,Staff,6,0,20,14
1683331886540,LIFR 1CX,A00,185962,Staff,7,0,20,13
1683331887565,LIFR 1D,A00,185963,Staff,9,0,20,11
1683331888590,LIFR 1DX,A00,185964,Staff,9,0,20,11
1683331889615,LIGN 101,A01,186039,Staff,43,0,50,7
1683331890643,LIGN 165,A00,186040,Staff,18,0,50,32
1683331891672,LTCS 108,A00,186041,Staff,6,0,10,4
1683331892701,LTCS 119,A00,186042,Staff,16,0,20,4
1683331893726,LTCS 130,A00,186043,Wesling; Megan E.,15,0,25,10
1683331895780,LTEA 138,A00,186119,Staff,14,0,40,26
1683331896804,LTEN 124,A00,186148,Staff,6,0,25,19
1683331897828,LTEN 178,A00,186149,Staff,7,0,15,8
1683331898856,LTEN 181,A00,186150,Blanco; John D,33,0,40,7
1683331899881,LTWL 120,A00,186160,Staff,20,0,25,5
1683331900905,LTWL 165,A00,186161,Staff,22,0,25,3
1683331901928,LTWR 100,A00,186162,Staff,0,5,15,15
1683331902959,LTWR 102,A00,186163,Doller; Ben,5,0,15,10
1683331903985,MAE 8,A01,186412,Staff,0,0,0,0
1683331905013,MAE 30B,A00,186445,Bahadori; Mohammad Yousef,83,0,100,17
1683331906037,MAE 40,A00,186592,Bewley; Thomas R,9,0,50,41
1683331907062,MAE 101B,A00,186593,Bahadori; Mohammad Yousef,81,0,100,19
1683331908090,MAE 105,A00,186594,Bandaru; Prabhakar,12,0,50,38
1683331909119,MAE 107,A00,186599,Pham; Hieu Tan,0,6,120,120
1683331910144,MAE 148,A01,186660,Silberman; Jack,3,0,16,13
1683331911172,MATH 10A,A01,188095,Staff,1,6,35,34
1683331912197,MATH 10B,A01,188097,Bowers; Adam R.,0,11,30,30
1683331912197,MATH 10B,A02,188099,Bowers; Adam R.,0,11,30,30
1683331912197,MATH 10B,B01,188104,Bowers; Adam R.,0,10,30,30
1683331912197,MATH 10B,B02,188106,Bowers; Adam R.,0,10,30,30
1683331913228,MATH 10C,A01,188111,Staff,0,18,30,30
1683331913228,MATH 10C,A02,188127,Staff,0,17,30,30
1683331913228,MATH 10C,A03,188131,Staff,0,18,30,30
1683331913228,MATH 10C,B01,188218,Staff,18,0,30,12
1683331913228,MATH 10C,B02,188244,Staff,13,0,30,17
1683331913228,MATH 10C,B03,188277,Staff,16,0,30,14
1683331914258,MATH 18,A01,188344,Bach; Quang Tran,18,0,30,12
1683331914258,MATH 18,A02,188345,Bach; Quang Tran,11,0,30,19
1683331914258,MATH 18,B01,188353,Bach; Quang Tran,10,0,30,20
1683331914258,MATH 18,B02,188354,Bach; Quang Tran,20,0,30,10
1683331915282,MATH 20A,A01,188374,Staff,13,0,35,22
1683331916308,MATH 20B,A01,188382,Ohm; Ko Woon,6,0,30,24
1683331916308,MATH 20B,A02,188383,Ohm; Ko Woon,22,0,30,8
1683331916308,MATH 20B,B01,188385,Ohm; Ko Woon,7,0,30,23
1683331916308,MATH 20B,B02,188392,Ohm; Ko Woon,22,0,30,8
1683331917339,MATH 20C,A01,188394,Harel; Guershon,10,0,30,20
1683331917339,MATH 20C,A02,188395,Harel; Guershon,15,0,30,15
1683331917339,MATH 20C,B01,188404,Harel; Guershon,5,0,30,25
1683331917339,MATH 20C,B02,188405,Harel; Guershon,19,0,30,11
1683331918370,MATH 20D,A01,188414,Hammock; Frances H,0,1,30,30
1683331918370,MATH 20D,A02,188415,Hammock; Frances H,3,0,30,27
1683331918370,MATH 20D,B01,188447,Hammock; Frances H,1,0,30,29
1683331918370,MATH 20D,B02,188486,Hammock; Frances H,8,0,30,22
1683331919401,MATH 20E,A01,188649,Staff,21,0,30,9
1683331919401,MATH 20E,A02,188650,Staff,23,0,30,7
1683331919401,MATH 20E,A03,188673,Staff,0,0,30,30
1683331920430,MATH 102,A01,188675,Staff,0,35,35,35
1683331921455,MATH 103B,A01,188681,Staff,3,0,35,32
1683331921455,MATH 103B,B01,188692,Staff,5,0,35,30
1683331922483,MATH 109,A01,188695,Salehi Golsefidy; Alireza,25,0,35,10
1683331922483,MATH 109,A02,188696,Salehi Golsefidy; Alireza,25,0,35,10
1683331923509,MATH 120A,A01,188698,Eggers; John Dietrich,7,0,35,28
1683331924535,MATH 142B,A01,188736,Ioana; Adrian,0,2,30,30
1683331924535,MATH 142B,A02,188741,Ioana; Adrian,1,1,30,29
1683331924535,MATH 142B,A03,188743,Ioana; Adrian,1,3,30,29
1683331925559,MATH 168A,A01,188790,Staff,0,9,35,35
1683331926590,MATH 170A,A01,188803,Nie; Jiawang,0,2,35,35
1683331926590,MATH 170A,A02,188811,Nie; Jiawang,0,0,35,35
1683331926590,MATH 170A,A03,188814,Nie; Jiawang,1,0,35,34
1683331926590,MATH 170A,A04,188815,Nie; Jiawang,13,0,35,22
1683331927618,MATH 193B,A01,188817,Staff,0,0,35,35
1683331927618,MATH 193B,A02,188818,Staff,5,0,35,30
1683331928648,MGT 4,A01,202857,Anderson; John Charles,62,0,80,18
1683331929673,MGT 12,A00,202858,Lindenberger; Wade Douglas,42,0,90,48
1683331930697,MGT 18,A00,202859,Staff,74,0,90,16
1683331931723,MGT 18GS,A00,202860,McKay; Michael J,13,0,28,15
1683331932748,MGT 45,A00,202861,Pecore; Joseph P.,14,0,90,76
1683331933776,MGT 100,A00,202863,Yavorsky; Daniel Ryan,28,0,90,62
1683331934801,MGT 103,A00,202864,Ehrich; Kristine R,1,18,90,89
1683331935831,MGT 112,A00,202865,Ehrich; Kristine R,15,0,90,75
1683331936860,MGT 121A,A00,202868,Staff,0,20,0,0
1683331937885,MGT 131B,A00,202869,Anderson; John Charles,59,0,90,31
1683331938911,MGT 136,A00,202871,Lindenberger; Wade Douglas,84,0,90,6
1683331939947,MGT 164,A00,202873,Staff,0,68,90,91
1683331940969,MGT 164GS,A00,202874,McKay; Mary A,13,0,28,15
1683331941995,MGT 180,A00,202875,Staff,0,50,90,91
1683331943023,MMW 11R,A01,205019,Herbst; Matthew,3,0,30,27
1683331943023,MMW 11R,A02,205026,Herbst; Matthew,29,0,30,1
1683331944049,MMW 15,A01,193512,Chang; Edmond Yi-Teh,0,9,28,28
1683331944049,MMW 15,A02,193513,Chang; Edmond Yi-Teh,0,5,28,28
1683331944049,MMW 15,A03,193514,Chang; Edmond Yi-Teh,0,5,28,28
1683331944049,MMW 15,A04,193515,Chang; Edmond Yi-Teh,0,5,28,28
1683331944049,MMW 15,A05,193516,Chang; Edmond Yi-Teh,0,4,28,28
1683331944049,MMW 15,A06,193517,Chang; Edmond Yi-Teh,0,5,28,28
1683331944049,MMW 15,B01,193519,Chang; Edmond Yi-Teh,0,5,28,28
1683331944049,MMW 15,B02,193520,Chang; Edmond Yi-Teh,0,5,28,28
1683331944049,MMW 15,B03,193521,Chang; Edmond Yi-Teh,0,5,28,28
1683331944049,MMW 15,B04,193522,Chang; Edmond Yi-Teh,0,4,28,28
1683331944049,MMW 15,B05,193523,Chang; Edmond Yi-Teh,0,5,28,28
1683331944049,MMW 15,B06,193524,Chang; Edmond Yi-Teh,0,4,28,28
1683331945080,MMW 122,A01,193526,Rahimi; Babak,0,15,28,28
1683331945080,MMW 122,A02,193527,Rahimi; Babak,0,14,28,28
1683331945080,MMW 122,A03,193528,Rahimi; Babak,0,0,0,0
1683331945080,MMW 122,A04,193529,Rahimi; Babak,0,0,0,0
1683331946105,MUS 1A,A01,186663,Staff,0,20,35,35
1683331947134,MUS 4,A01,186715,Staff,0,12,35,35
1683331948163,MUS 5R,A01,186796,Dubnov; Shlomo,0,17,35,35
1683331949189,MUS 6,A01,186798,Staff,0,4,25,25
1683331950214,MUS 7,A01,186830,Staff,12,0,35,23
1683331951295,MUS 8,A01,186930,Staff,0,26,35,35
1683331952329,MUS 15,A01,186932,Staff,0,16,35,35
1683331952329,MUS 15,B01,186934,Staff,0,15,35,35
1683331953360,MUS 80,A00,186935,Staff,1,0,20,19
1683331953360,MUS 80,B00,186936,Staff,25,0,25,0
1683331954391,NANO 11,A00,204702,Lipomi; Darren John,0,0,0,0
1683331955417,NANO 15,A01,204709,Yang; Kesong,0,1,0,0
1683331956441,NANO 114,A00,202069,Jahed Motlagh; Zeinab,3,0,10,7
1683331957468,PHIL 1,A00,186955,Grush; Rick Scott,32,0,40,8
1683331958494,PHIL 10,A01,186973,Grush; Rick Scott,28,0,35,7
1683331958494,PHIL 10,A02,186974,Grush; Rick Scott,33,0,35,2
1683331959520,PHIL 13,A01,186976,Staff,7,0,35,28
1683331959520,PHIL 13,A02,186977,Staff,16,0,35,19
1683331960544,PHIL 14,A01,186979,Staff,31,0,35,4
1683331960544,PHIL 14,A02,186986,Staff,32,0,35,3
1683331961569,PHIL 28,A01,186988,Staff,16,0,30,14
1683331961569,PHIL 28,A02,186989,Staff,1,0,30,29
1683331961569,PHIL 28,A03,186990,Staff,9,0,30,21
1683331961569,PHIL 28,A04,186991,Staff,26,0,30,4
1683331962594,PHIL 120,A00,186997,Staff,23,0,40,17
1683331963617,PHIL 137,A00,187003,Staff,9,0,40,31
1683331964646,PHIL 150,A00,187015,Staff,47,0,70,23
1683331965676,PHIL 167,A00,187021,Lamey; Andy M.,35,0,40,5
1683331966707,PHIL 174,A01,202226,Staff,17,0,20,3
1683331966707,PHIL 174,A02,202235,Staff,20,0,20,0
1683331967732,PHIL 191A,A00,258918,Staff,0,0,1,1
1683331968760,PHYS 1A,A00,187028,Staff,27,0,60,33
1683331969791,PHYS 1AL,001,187036,Staff,3,0,30,27
1683331969791,PHYS 1AL,002,187049,Staff,18,0,30,12
1683331970821,PHYS 1B,A00,187058,Staff,22,0,60,38
1683331971851,PHYS 1BL,001,187064,Staff,0,0,30,30
1683331971851,PHYS 1BL,002,187070,Staff,5,0,30,25
1683331972875,PHYS 1C,A00,187082,Staff,31,0,120,89
1683331973901,PHYS 1CL,001,187088,Staff,0,9,30,30
1683331973901,PHYS 1CL,002,187089,Staff,0,2,30,30
1683331973901,PHYS 1CL,009,262693,Staff,11,0,30,19
1683331974927,PHYS 2B,A01,187097,Staff,54,0,115,61
1683331975956,PHYS 2C,A01,187099,Staff,67,0,115,48
1683331976986,PHYS 2CL,A01,187101,Staff,5,0,28,23
1683331976986,PHYS 2CL,A02,187102,Staff,15,0,28,13
1683331978016,PHYS 2D,A01,187123,Shotwell; Brian,95,0,115,20
1683331979046,PHYS 4B,A01,187133,Grinstein; Benjamin,35,0,50,15
1683331980071,POLI 10,A00,188819,Staff,0,4,50,50
1683331981100,POLI 11,A00,188827,Staff,43,0,50,7
1683331982126,POLI 13R,A00,188828,Staff,0,1,20,20
1683331983151,POLI 27,A01,188830,Elgin; Samuel Zincke,0,1,70,70
1683331984176,POLI 30,A00,188832,Desposato; Scott,31,0,50,19
1683331985202,POLI 102F,A00,188834,Staff,3,0,40,37
1683331986230,POLI 104A,A00,188852,Staff,14,0,30,16
1683331987260,POLI 104I,A00,188853,Staff,0,6,20,20
1683331988286,POLI 110B,A00,188854,Wiens; David,7,0,20,13
1683331989314,POLI 112A,A00,188855,Wiens; David,5,0,30,25
1683331990346,POLI 117R,A00,188856,Forman; Fonna,0,11,20,20
1683331991375,POLI 118,A00,188857,Ingham; Sean,8,0,20,12
1683331992399,POLI 120G,A00,188858,Staff,9,0,30,21
1683331993427,POLI 131CR,A00,188863,Hoston; Germaine,24,0,50,26
1683331994449,POLI 133,A00,188864,Nellis; Gareth Hb,44,0,50,6
1683331995479,POLI 134D,A00,188865,Desposato; Scott,27,0,30,3
1683331996505,POLI 142A,A00,188871,Gartzke; Erik,22,0,50,28
1683331997535,POLI 142K,A00,188874,Staff,38,0,50,12
1683331998562,POLI 143,A00,188940,Gartzke; Erik,16,0,30,14
1683331999587,POLI 153,A00,188943,Staff,3,0,20,17
1683332000613,POLI 160AA,A00,188944,Staff,12,0,40,28
1683332001641,POLI 170A,A00,188945,Staff,11,0,30,19
1683332003691,PSYC 1,A00,188952,Staff,37,0,90,53
1683332004722,PSYC 2,B00,188953,Staff,19,0,35,16
1683332005746,PSYC 6,A00,188970,Staff,47,0,60,13
1683332006777,PSYC 7,A00,188973,Staff,37,0,45,8
1683332007801,PSYC 60,A01,188980,Rickard; Timothy C.,43,0,60,17
1683332008825,PSYC 70,A01,189001,Steiner; Eric Tomas,24,0,45,21
1683332009850,PSYC 100,A00,189005,Lacefield; Katharine I,0,100,120,120
1683332010876,PSYC 102,A00,189008,Staff,9,0,30,21
1683332011905,PSYC 106,B00,189026,Gorman; Michael R.,34,0,60,26
1683332012935,PSYC 114,B01,189033,Winkielman; Piotr,0,32,30,30
1683332013963,PSYC 131,A00,189036,Anagnostaras; Stephan,0,43,60,60
1683332014992,PSYC 136,A00,189041,Lowe; Angela Beth,0,7,25,25
1683332016020,PSYC 137,A00,189057,Winkielman; Piotr,0,34,25,25
1683332017045,PSYC 144,A00,189107,Wixted; John T,0,7,50,50
1683332019096,PSYC 162,A00,189142,Staff,0,8,85,85
1683332020121,PSYC 172,A00,189144,Gorman; Michael R.,0,7,30,30
1683332022173,PSYC 179,A00,189146,Lacefield; Katharine I,0,84,120,120
1683332023202,PSYC 181,A00,189147,Anagnostaras; Stephan,0,44,90,90
1683332024233,PSYC 190R,A00,189148,Barner; David A.,0,22,80,80
1683332025258,PSYC 191,A00,189275,Rickard; Timothy C.,0,7,25,25
1683332026283,PSYC 193,A00,189276,Chapman; Eddie Nathaniel,0,1,0,4
1683332027314,PSYC 193L,A01,189281,Lowe; Angela Beth,12,0,20,8
1683332027314,PSYC 193L,B01,189285,Staff,28,0,35,7
1683332028343,RELI 149,A00,187137,Rahimi; Babak,7,0,40,33
1683332029370,SE 9,A01,187315,Staff,0,2,18,18
1683332030396,SE 101B,A00,187409,Staff,24,0,30,6
1683332031420,SE 110B,A00,187444,Staff,10,0,40,30
1683332032443,SE 130B,A00,187449,Staff,31,0,40,9
1683332033467,SE 150A,A00,187516,Staff,9,0,20,11
1683332034493,SE 154,A00,187528,Staff,30,0,50,20
1683332035518,SIO 3,A01,258171,Staff,35,0,40,5
1683332036543,SIO 10,A00,187144,Cook; Geoffrey W,0,3,75,75
1683332037569,SIO 45,A00,187152,Cook; Geoffrey W,1,0,100,99
1683332038596,SIO 109R,A00,194486,Staff,0,3,20,20
1683332040648,SIO 187,A01,187233,Kacev; David,12,0,40,28
1683332041677,SOCI 1,A01,258656,Thorpe; Charles Robert,28,0,30,2
1683332041677,SOCI 1,A02,258658,Thorpe; Charles Robert,30,0,30,0
1683332041677,SOCI 1,A03,258661,Thorpe; Charles Robert,25,0,25,0
1683332041677,SOCI 1,A04,258666,Thorpe; Charles Robert,22,0,25,3
1683332041677,SOCI 1,A05,258897,Thorpe; Charles Robert,23,0,25,2
1683332041677,SOCI 1,A06,258898,Thorpe; Charles Robert,25,0,25,0
1683332042705,SOCI 30,A01,258903,Pardo Guerra; Juan Pablo,15,0,30,15
1683332043729,SOCI 102,A00,258904,Staff,9,0,25,16
1683332044754,SOCI 106,A00,258905,Staff,19,0,25,6
1683332045778,SOCI 111,A00,258907,Ribas Norris; Janet Vanesa,26,0,30,4
1683332046804,SOCI 121R,A00,258908,Pardo Guerra; Juan Pablo,10,0,30,20
1683332047839,SOCI 126,A01,203330,Staff,14,0,20,6
1683332048872,SOCI 131,A00,258909,Thorpe; Charles Robert,31,0,60,29
1683332049897,SOCI 135,A00,258910,Payne; Christine Anna,0,9,30,30
1683332050924,SOCI 157,A00,258911,Staff,12,0,30,18
1683332051948,SOCI 184,A00,258912,Staff,25,0,30,5
1683332052976,SOCI 188D,A00,258913,Staff,21,0,30,9
1683332054001,SYN 2,001,187529,Staff,10,0,16,6
1683332054001,SYN 2,002,201452,Staff,0,18,16,16
1683332054001,SYN 2,003,201469,Staff,3,0,16,13
1683332055102,SYN 100,A01,187531,Staff,0,9,20,20
1683332055102,SYN 100,B01,201491,Staff,0,12,20,20
1683332056130,TDAC 1,A00,189286,Walsh; Kim C.,3,0,20,17
1683332056130,TDAC 1,B00,189287,Harting; Carla Kelso,11,0,20,9
1683332057158,TDAC 101,A00,189300,Walsh; Kim C.,16,0,20,4
1683332057158,TDAC 101,B00,189301,Harting; Carla Kelso,18,0,20,2
1683332058186,TDAC 102,A00,189304,Basso; Beatrice,14,0,20,6
1683332059212,TDAC 108,A00,189305,Staff,18,0,20,2
1683332060238,TDDE 131,A00,189310,Staff,19,0,20,1
1683332060238,TDDE 131,B00,189314,Staff,19,0,20,1
1683332060238,TDDE 131,C00,189315,Staff,48,0,50,2
1683332060238,TDDE 131,D00,189316,Staff,14,0,15,1
1683332060238,TDDE 131,E00,204841,Staff,20,0,20,0
1683332061263,TDGE 10,A00,189289,Staff,30,0,50,20
1683332061263,TDGE 10,B00,189290,Havis; Allan,1,0,50,49
1683332062289,TDGE 11,A00,189291,Fulton; Julia,0,3,50,50
1683332062289,TDGE 11,B00,189292,Staff,20,0,25,5
1683332062289,TDGE 11,C00,260270,Staff,0,0,0,0
1683332063312,TDGE 25,A00,189294,Staff,3,0,20,17
1683332064338,TDGE 124,A00,189318,Fulton; Julia,0,8,50,50
1683332065362,TDGE 125,A00,189319,Staff,13,0,25,12
1683332065362,TDGE 125,B00,189320,Staff,23,0,25,2
1683332066391,TDGE 127,A00,189322,Havis; Allan,0,0,50,50
1683332067419,TDHT 101,A00,189323,Staff,18,0,25,7
1683332067419,TDHT 101,B00,189324,Staff,25,0,25,0
1683332068448,TDHT 102,A00,189325,Staff,49,0,50,1
1683332069476,TDMV 1,A00,189295,Arcidiacono; Kristin,19,0,30,11
1683332069476,TDMV 1,B00,189296,Caligagan; Maria T.,24,0,30,6
1683332070503,TDMV 2,A00,189297,Sammartano; Tonnie,28,0,30,2
1683332070503,TDMV 2,B00,189299,Arcidiacono; Kristin,24,0,30,6
1683332071528,TDMV 3,A00,204998,Rincon; Alicia,22,0,30,8
1683332072553,TDMV 120,A00,189458,Sammartano; Tonnie,28,0,30,2
1683332073578,TDMV 138,A00,189541,Jun; Grace Shin Hae,22,0,40,18
1683332074604,TDMV 142,A00,189717,Caligagan; Tony,23,0,30,7
1683332074604,TDMV 142,B00,189718,Caligagan; Maria T.,25,0,30,5
1683332075628,TMC 2,A01,187533,Staff,25,0,25,0
1683332075628,TMC 2,A02,187534,Staff,25,0,25,0
1683332076652,USP 1,A01,187536,Kwak; Nancy,0,16,25,25
1683332077677,USP 5,A01,187538,Staff,10,0,25,15
1683332078703,USP 101,A00,199253,Staff,0,4,0,0
1683332079731,USP 124,A00,187562,Boomhower; Matthew Charles,1,0,30,29
1683332080759,USP 138,A00,187582,Staff,20,0,25,5
1683332081783,USP 152,A01,187597,Staff,4,0,25,21
1683332082807,USP 153,A00,187598,Staff,19,0,25,6
1683332083835,USP 168,A00,187607,Kwak; Nancy,2,0,5,3
1683332084859,USP 173,A00,187619,Staff,4,0,25,21
1683332085884,USP 181,A00,187638,Staff,0,0,25,25
1683332086909,VIS 103,A00,187650,Cruz; Edwin Teddy,23,0,75,52
1683332087936,VIS 110D,A00,187669,Staff,12,0,22,10
1683332088960,VIS 127C,A00,187720,Shen; Kuiyi,67,0,146,79
1683332089984,VIS 149,A00,187731,Yoldas; Pinar,0,14,22,22
1683332091012,VIS 151,A01,188091,Staff,22,0,34,12
1683332091012,VIS 151,A02,188092,Staff,11,0,34,23
1683332092037,VIS 160B,A00,188093,Stalbaum; Brett,0,0,10,10
1683332094091,WCWP 10B,A00,201720,Staff,10,0,15,5
1683332094091,WCWP 10B,B00,201722,Staff,8,0,15,7
1683332095115,WCWP 100,A00,201725,Gagnon; Jeffrey C,0,0,2,2
1683332095115,WCWP 100,B00,201727,Staff,0,4,15,15
1683332098243,ANBI 133,A00,258401,Wilder; Linnea Lorene,34,0,40,6
1683332099270,ANBI 140,A00,258395,Hrvoj Mihic; Branka,18,0,25,7
1683332100293,ANSC 120,A00,258402,Bialecki; Jon Anthony,27,0,40,13
1683332101315,ANSC 144,A00,258400,Staff,14,0,40,26
1683332103367,ANSC 166,A00,258396,Parish; Steven Martin,157,0,175,18
1683332104395,ANSC 180,A00,193533,Staff,9,0,20,11
1683332105420,ANSC 188,A00,258397,Jassal; Aftab,33,0,40,7
1683332106443,ANTH 3,A01,258316,Staff,23,0,30,7
1683332107466,ANTH 5,A00,258394,Semendeferi; Ekaterini,16,0,20,4
1683332108493,ANTH 21,A01,258331,Staff,8,0,40,32
1683332109516,ANTH 103,A00,258398,Varma; Saiba,15,0,25,10
1683332110543,AWP 10,001,202034,Staff,0,0,0,0
1683332110543,AWP 10,002,202035,Staff,0,0,0,0
1683332110543,AWP 10,003,202036,Staff,0,0,0,0
1683332110543,AWP 10,004,202037,Staff,0,0,0,0
1683332110543,AWP 10,005,202038,Staff,0,0,0,0
1683332110543,AWP 10,006,202039,Staff,0,0,0,0
1683332110543,AWP 10,007,202040,Staff,0,0,0,0
1683332110543,AWP 10,008,202041,Staff,0,0,0,0
1683332110543,AWP 10,009,202042,Staff,0,0,0,0
1683332110543,AWP 10,010,202043,Staff,0,0,0,0
1683332110543,AWP 10,011,202044,Staff,0,0,0,0
1683332110543,AWP 10,012,202045,Staff,0,0,0,0
1683332110543,AWP 10,013,202046,Staff,0,0,0,0
1683332110543,AWP 10,014,202047,Staff,0,0,0,0
1683332110543,AWP 10,015,202048,Staff,0,0,0,0
1683332110543,AWP 10,016,202049,Staff,0,0,0,0
1683332110543,AWP 10,017,202050,Staff,0,0,0,0
1683332110543,AWP 10,018,202051,Staff,0,0,0,0
1683332110543,AWP 10,019,202052,Staff,0,0,0,0
1683332110543,AWP 10,020,202053,Staff,0,0,0,0
1683332110543,AWP 10,021,202054,Staff,0,0,0,0
1683332110543,AWP 10,022,202055,Staff,0,0,0,0
1683332110543,AWP 10,023,202056,Staff,0,0,0,0
1683332110543,AWP 10,024,202057,Staff,0,0,0,0
1683332110543,AWP 10,025,202058,Staff,0,0,0,0
1683332110543,AWP 10,026,202059,Staff,0,0,0,0
1683332111570,AWP 102,001,202032,Staff,0,0,0,0
1683332111570,AWP 102,002,202033,Staff,0,0,0,0
1683332112596,BENG 100,A01,254234,Taylor Amos; Alyssa C,31,0,40,9
1683332113623,BENG 196,001,270013,Engler; Adam J.,9999,0,9999,0
1683332114650,BICD 100R,A01,202018,Smith; Laurie,0,7,32,32
1683332114650,BICD 100R,A02,202019,Smith; Laurie,0,2,32,32
1683332114650,BICD 100R,A03,202020,Smith; Laurie,0,1,32,32
1683332114650,BICD 100R,A04,202021,Smith; Laurie,9,0,32,23
1683332114650,BICD 100R,A05,202022,Smith; Laurie,12,0,32,20
1683332115673,BICD 136,A01,193242,Gustafson-Brown; Cindy,0,2,32,32
1683332115673,BICD 136,A02,193244,Gustafson-Brown; Cindy,14,0,32,18
1683332116698,BIEB 102,A01,193249,Butler; Shannon Rhey,0,2,32,32
1683332116698,BIEB 102,A02,193251,Butler; Shannon Rhey,0,0,32,32
1683332116698,BIEB 102,A03,193253,Butler; Shannon Rhey,0,1,32,32
1683332116698,BIEB 102,A04,193255,Butler; Shannon Rhey,17,0,32,15
1683332116698,BIEB 102,A05,193265,Butler; Shannon Rhey,26,0,32,6
1683332116698,BIEB 102,A06,193269,Butler; Shannon Rhey,16,0,32,16
1683332118748,BIEB 150,A01,193274,Staff,0,0,32,32
1683332118748,BIEB 150,A02,193285,Staff,23,0,32,9
1683332119778,BIEB 194,A00,193286,Kurle; Carolyn M.,22,0,32,10
1683332120803,BILD 1,A01,192291,Staff,16,0,32,16
1683332120803,BILD 1,A02,192292,Staff,30,0,32,2
1683332120803,BILD 1,B01,192520,Reuther; Keefe,0,1,0,0
1683332120803,BILD 1,B02,192532,Reuther; Keefe,0,1,0,0
1683332121827,BILD 3,A01,192556,Butler; Shannon Rhey,0,0,32,32
1683332121827,BILD 3,A02,192581,Butler; Shannon Rhey,5,0,32,27
1683332121827,BILD 3,A03,192611,Butler; Shannon Rhey,23,0,32,9
1683332121827,BILD 3,A04,192612,Butler; Shannon Rhey,25,0,32,7
1683332121827,BILD 3,A05,192613,Butler; Shannon Rhey,27,0,32,5
1683332121827,BILD 3,A06,192679,Butler; Shannon Rhey,27,0,32,5
1683332121827,BILD 3,A07,192682,Butler; Shannon Rhey,22,0,32,10
1683332122852,BILD 4,A01,192836,Reuther; Keefe,0,0,24,24
1683332122852,BILD 4,A02,193044,Reuther; Keefe,4,0,24,20
1683332123878,BILD 10,A01,193142,Gustafson-Brown; Cindy,30,0,32,2
1683332123878,BILD 10,A02,193149,Gustafson-Brown; Cindy,31,0,32,1
1683332124902,BIMM 100,A01,193301,Staff,0,6,32,32
1683332124902,BIMM 100,A02,193312,Staff,0,5,32,32
1683332124902,BIMM 100,A03,193323,Staff,0,8,32,32
1683332125932,BIMM 101,A01,193329,McDonnell; Lisa Marie,0,3,24,24
1683332125932,BIMM 101,A02,193339,McDonnell; Lisa Marie,0,3,24,24
1683332125932,BIMM 101,B01,193354,McDonnell; Lisa Marie,0,3,24,24
1683332125932,BIMM 101,B02,193357,McDonnell; Lisa Marie,0,3,24,24
1683332126960,BIMM 110,A01,193377,Tat; John,0,11,32,32
1683332126960,BIMM 110,A02,193378,Tat; John,1,9,32,31
1683332127988,BIMM 120,A01,206116,Staff,0,0,32,32
1683332127988,BIMM 120,A02,206117,Staff,8,0,32,24
1683332127988,BIMM 120,A03,206121,Staff,21,0,32,11
1683332129014,BIPN 100,A01,193393,Park; Ji Young,0,14,32,32
1683332129014,BIPN 100,A02,193402,Park; Ji Young,0,13,32,32
1683332129014,BIPN 100,A03,193413,Park; Ji Young,0,14,32,32
1683332129014,BIPN 100,A04,193414,Park; Ji Young,0,13,32,32
1683332130037,BIPN 102,A01,193429,Staff,0,0,32,32
1683332130037,BIPN 102,A02,193438,Staff,22,0,32,10
1683332131065,BIPN 106,A01,193450,Reyes Gonzalez; Catalina,0,2,40,40
1683332132094,BIPN 134,A01,193465,Cooke; James Edward,0,0,32,32
1683332132094,BIPN 134,A02,193474,Cooke; James Edward,25,0,32,7
1683332132094,BIPN 134,A03,193485,Cooke; James Edward,29,0,32,3
1683332132094,BIPN 134,A04,193486,Cooke; James Edward,21,0,32,11
1683332132094,BIPN 134,A05,193491,Cooke; James Edward,31,0,32,1
1683332132094,BIPN 134,A06,193501,Cooke; James Edward,30,0,32,2
1683332132094,BIPN 134,A07,193510,Cooke; James Edward,29,0,32,3
1683332134144,BISP 194,A00,222522,Staff,14,0,32,18
1683332135170,CAT 124,A01,202407,Staff,20,0,25,5
1683332136194,CAT 125,A00,202408,Marchisotto; Jennifer Anne,4,0,20,16
1683332137221,CAT 125R,A00,202409,Smith; Lauryn Alissa,0,11,20,20
1683332137221,CAT 125R,B00,202410,Morales; Celeste Georgianna,0,11,20,20
1683332137221,CAT 125R,C00,202411,Irwin; Matthew Joseph,0,10,20,20
1683332138246,CENG 15,A01,204712,Yang; Kesong,0,1,0,0
1683332139271,CENG 114,A00,202070,Jahed Motlagh; Zeinab,5,0,20,15
1683332140304,CGS 105,A00,185477,Wesling; Megan E.,24,0,40,16
1683332141327,CGS 106,A00,185494,Staff,13,0,22,9
1683332142351,CGS 108,A00,185495,Staff,14,0,20,6
1683332143379,CGS 114,A00,185496,Staff,13,0,18,5
1683332144404,CGS 119,A00,185501,Staff,15,0,20,5
1683332145429,CGS 120,A00,185511,Staff,13,0,20,7
1683332146457,CHEM 4,A01,184675,Bussey; Thomas J,96,0,100,4
1683332147482,CHEM 6A,A01,184677,Staff,34,0,60,26
1683332148510,CHEM 6B,A01,184679,Staff,65,0,100,35
1683332149539,CHEM 6C,A01,184681,Bussey; Thomas J,1,0,50,49
1683332149539,CHEM 6C,A02,184682,Bussey; Thomas J,34,0,50,16
1683332150563,CHEM 40A,A01,184684,Albizati; Kim F.,37,0,100,63
1683332151587,CHEM 40B,A01,184686,Albizati; Kim F.,0,20,100,100
1683332152611,CHEM 41B,A01,184690,Staff,52,0,100,48
1683332153635,COGS 3,A01,184715,Boyle; Mary E. T.,0,25,40,40
1683332154659,COGS 14B,A01,185172,Staff,0,15,38,38
1683332155687,COGS 18,A01,184736,Staff,17,0,80,63
1683332156714,COGS 100,A01,184932,Staff,0,5,73,73
1683332157743,COGS 101A,A01,184935,Staff,0,39,30,30
1683332158827,COGS 101B,A01,184944,Staff,0,2,30,30
1683332159852,COGS 101C,A01,184946,Staff,0,12,30,30
1683332160880,COGS 102A,A01,184951,Johnson; Christine M.,2,0,40,38
1683332161909,COGS 107B,A01,184953,Mooshagian; Eric Frederick,0,50,40,40
1683332162932,COGS 118B,A01,184959,Gupta; Anjum,0,48,40,40
1683332163957,COGS 153,A00,184961,Staff,0,15,30,30
1683332164981,COGS 177,A00,184962,Staff,0,20,30,30
1683332166006,COGS 187A,A01,184969,Boyle; Mary E. T.,0,17,40,40
1683332167031,COMM 10,A01,185174,Staff,0,5,25,25
1683332167031,COMM 10,A02,185189,Staff,0,5,25,25
1683332167031,COMM 10,A03,269821,Staff,0,0,0,0
1683332168057,COMM 100B,A01,185475,Staff,0,0,0,2
1683332168057,COMM 100B,A02,185476,Staff,14,0,25,11
1683332169084,COMM 100C,A01,185314,Staff,1,0,25,24
1683332169084,COMM 100C,A02,185327,Staff,19,0,25,6
1683332170111,COMM 110M,A00,185349,Staff,2,0,40,38
1683332171136,COMM 113T,A00,185352,Staff,24,0,40,16
1683332172160,COMM 114I,A00,185353,Staff,33,0,40,7
1683332173185,COMM 131,A00,185354,Staff,19,0,30,11
1683332174215,CSE 8A,A50,185358,Cao; Yingjun,0,46,10,10
1683332175251,CSE 8B,A01,185362,Staff,1,47,50,49
1683332176277,CSE 11,A01,185416,Cao; Yingjun,0,92,10,10
1683332177304,CSE 20,A01,185445,Briones; Jor-el Thomas Caparas,5,0,25,20
1683332178331,CSE 21,A01,185447,Staff,10,0,50,40
1683332179360,CSE 101,A01,185451,Staff,0,12,50,50
1683332179360,CSE 101,B01,185453,Jones; Miles E,0,11,50,50
1683332181414,CSE 141,A01,185458,Eldon; John,20,0,100,80
1683332182440,CSE 141L,A01,185461,Eldon; John,12,0,100,88
1683332183468,CSE 142,A01,185463,Staff,36,0,60,24
1683332183468,CSE 142,B01,201355,Staff,0,7,60,60
1683332184496,CSE 142L,A01,185470,Staff,36,0,60,24
1683332184496,CSE 142L,B01,201417,Staff,0,6,60,60
1683332185523,CSE 190,A00,201433,Staff,32,0,49,17
1683332186548,DOC 1,A01,259136,Strom; Megan C.,7,0,15,8
1683332186548,DOC 1,A02,259137,Strom; Megan C.,14,0,15,1
1683332186548,DOC 1,A03,259138,Strom; Megan C.,14,0,15,1
1683332186548,DOC 1,A04,259139,Strom; Megan C.,14,0,15,1
1683332187573,DOC 100D,A00,259140,Pass; Natalye Joann,16,0,25,9
1683332188601,DSGN 1,A01,184749,Rill; Bryan,0,25,30,30
1683332189630,DSGN 100,A01,185168,Staff,0,2,25,25
1683332190657,ECE 5,A01,185626,Morris; Karcher William,0,10,0,0
1683332191684,ECE 101,A01,185628,Staff,17,0,70,53
1683332192710,ECE 107,A01,185635,Baghdadchi; Saharnaz,0,0,20,20
1683332192710,ECE 107,A02,185638,Baghdadchi; Saharnaz,4,0,20,16
1683332193734,ECE 148,A01,185647,Silberman; Jack,0,0,16,16
1683332194758,ECON 1,A01,185537,Crane; Meredith Helen,54,0,70,16
1683332195782,ECON 3,A01,185549,Crane; Meredith Helen,33,0,70,37
1683332196806,ECON 4,A01,203354,Anderson; John Charles,0,4,10,10
1683332197831,ECON 100A,A01,185574,Staff,0,4,40,40
1683332198868,ECON 100B,A01,185576,Staff,10,22,50,40
1683332199892,ECON 100C,A01,185589,Newhouse; Herbert S,30,0,70,40
1683332200915,ECON 105,A00,185608,Vespa; Emanuel Ignacio,19,0,35,16
1683332201939,ECON 109,A01,185610,Shishkin; Denis,10,0,35,25
1683332202963,ECON 110A,A01,185612,Staff,11,0,40,29
1683332203988,ECON 120A,A01,185615,Staff,20,0,40,20
1683332205016,ECON 120C,A01,185617,Sun; Yixiao,0,20,70,70
1683332206040,ECON 144,A00,203346,Squires; Dale E,3,0,35,32
1683332207064,ECON 171,A01,203349,Newhouse; Herbert S,0,1,35,35
1683332208088,ECON 173A,A01,185621,Toda; Alexis Akira,21,0,35,14
1683332209115,EDS 25,A01,202413,Staff,0,1,0,0
1683332209115,EDS 25,A02,202414,Staff,0,1,0,0
1683332209115,EDS 25,A03,202415,Staff,0,0,0,0
1683332209115,EDS 25,A04,202416,Staff,0,1,0,0
1683332209115,EDS 25,A05,202439,Staff,0,0,0,0
1683332209115,EDS 25,A06,202440,Staff,0,0,0,0
1683332209115,EDS 25,B01,202631,Staff,0,0,0,0
1683332209115,EDS 25,B02,202632,Staff,0,0,0,0
1683332209115,EDS 25,B03,202639,Staff,0,0,0,0
1683332209115,EDS 25,B04,202640,Staff,0,0,0,0
1683332209115,EDS 25,B05,202643,Staff,0,0,0,0
1683332209115,EDS 25,B06,202644,Staff,0,0,0,0
1683332210140,EDS 38,A01,202659,Black; Alison Michelle,24,0,25,1
1683332211168,EDS 115,A00,202652,Staff,17,0,30,13
1683332212197,EDS 125,A00,202649,Staff,14,0,30,16
1683332213222,EDS 126,A01,203332,Staff,30,0,30,0
1683332214246,EDS 139,A00,202838,Staff,16,0,25,9
1683332215268,EDS 146,A01,202655,Staff,14,0,25,11
1683332216293,ENG 15,A00,185667,Staff,0,1,0,0
1683332216293,ENG 15,B00,185672,Staff,0,0,0,0
1683332216293,ENG 15,C00,185675,Staff,0,0,0,0
1683332216293,ENG 15,D00,185682,Staff,0,0,0,0
1683332216293,ENG 15,E00,185684,Staff,0,0,0,0
1683332217322,ETHN 103,A00,185710,Staff,0,3,35,35
1683332218344,ETHN 103A,A00,199228,Man; Simeon S,2,0,9,7
1683332219368,ETHN 109,A00,185711,Staff,18,0,35,17
1683332220391,ETHN 142,A00,185726,Staff,0,4,30,30
1683332221421,ETHN 163J,A00,199229,Man; Simeon S,5,0,8,3
1683332222448,ETHN 168,A00,185727,Staff,8,0,10,2
1683332223476,ETHN 182,A00,185728,Staff,1,0,35,34
1683332224505,ETHN 183,A00,185737,Staff,8,0,18,10
1683332225532,GLBH 111,A01,209361,Burgos; Jose L.,0,0,0,0
1683332227586,HIEU 104,A00,185792,Staff,16,0,20,4
1683332228611,HIEU 115,A00,185800,Staff,1,0,20,19
1683332229638,HIEU 128,A00,185801,Staff,0,7,20,20
1683332230665,HIEU 147,A00,185802,Staff,16,0,20,4
1683332231692,HIEU 154,A00,185823,Staff,12,0,20,8
1683332232717,HILA 102,A00,185826,Staff,13,0,20,7
1683332233741,HILD 2C,A01,185778,Staff,0,12,20,20
1683332234767,HILD 7B,A01,185780,Kwak; Nancy,0,15,32,32
1683332234767,HILD 7B,A02,185781,Kwak; Nancy,0,18,32,32
1683332235791,HILD 30,A01,185791,Staff,14,0,20,6
1683332236820,HISC 119,A00,185830,Golan; Tal,0,9,20,20
1683332237849,HITO 156GS,A00,185831,Patterson; Patrick H.,0,0,0,23
1683332238874,HIUS 103,A00,185832,Man; Simeon S,0,6,20,20
1683332239900,HIUS 117,A00,185836,Kwak; Nancy,2,0,20,18
1683332240924,HIUS 125,A00,185840,Man; Simeon S,0,0,23,23
1683332241949,HIUS 149,A00,185845,Staff,0,0,20,20
1683332242975,HUM 3,A01,185882,Zavodny; Tatiana Sophia,0,7,50,50
1683332242975,HUM 3,B01,185899,Caldwell; Michael Alan,0,18,50,50
1683332243999,HUM 3GS,A00,185900,Patterson; Patrick H.,0,0,0,23
1683332245028,HUM 4,A01,185938,Zroka; Amy Liane,31,0,50,19
1683332245028,HUM 4,B01,185956,Watkins; Eric,0,2,50,50
1683332245028,HUM 4,B02,202209,Watkins; Eric,0,2,50,50
1683332245028,HUM 4,B03,202210,Watkins; Eric,0,2,50,50
1683332246052,HUM 5,A01,185958,West; Geoffrey Scott,3,0,50,47
1683332246052,HUM 5,A02,202215,West; Geoffrey Scott,0,0,50,50
1683332247077,INTL 190,A00,185959,Gagnon; Jeffrey C,0,0,0,9
1683332247077,INTL 190,B00,185960,Lettieri; Michael Joseph,0,0,0,1
1683332248103,JAPN 180,A00,254509,Staff,5,1,30,25
1683332249127,LATI 10,A01,202853,Kennemore; Amy Michelle,4,0,35,31
1683332249127,LATI 10,A02,202854,Kennemore; Amy Michelle,2,0,35,33
1683332249127,LATI 10,A03,270054,Kennemore; Amy Michelle,30,0,30,0
1683332250152,LATI 180,A00,202855,Kennemore; Amy Michelle,11,0,20,9
1683332251178,LAWS 101,A00,201767,Golan; Tal,0,7,40,40
1683332252204,LIFR 1C,A00,185961,Staff,6,0,20,14
1683332253229,LIFR 1CX,A00,185962,Staff,7,0,20,13
1683332254255,LIFR 1D,A00,185963,Staff,9,0,20,11
1683332255281,LIFR 1DX,A00,185964,Staff,9,0,20,11
1683332256305,LIGN 101,A01,186039,Staff,43,0,50,7
1683332257339,LIGN 165,A00,186040,Staff,18,0,50,32
1683332258366,LTCS 108,A00,186041,Staff,6,0,10,4
1683332259390,LTCS 119,A00,186042,Staff,16,0,20,4
1683332260415,LTCS 130,A00,186043,Wesling; Megan E.,15,0,25,10
1683332262542,LTEA 138,A00,186119,Staff,14,0,40,26
1683332263567,LTEN 124,A00,186148,Staff,6,0,25,19
1683332264590,LTEN 178,A00,186149,Staff,7,0,15,8
1683332265617,LTEN 181,A00,186150,Blanco; John D,33,0,40,7
1683332266640,LTWL 120,A00,186160,Staff,20,0,25,5
1683332267667,LTWL 165,A00,186161,Staff,22,0,25,3
1683332268693,LTWR 100,A00,186162,Staff,0,5,15,15
1683332269726,LTWR 102,A00,186163,Doller; Ben,5,0,15,10
1683332270757,MAE 8,A01,186412,Staff,0,0,0,0
1683332271785,MAE 30B,A00,186445,Bahadori; Mohammad Yousef,83,0,100,17
1683332272813,MAE 40,A00,186592,Bewley; Thomas R,9,0,50,41
1683332273841,MAE 101B,A00,186593,Bahadori; Mohammad Yousef,81,0,100,19
1683332274868,MAE 105,A00,186594,Bandaru; Prabhakar,12,0,50,38
1683332275896,MAE 107,A00,186599,Pham; Hieu Tan,0,6,120,120
1683332276921,MAE 148,A01,186660,Silberman; Jack,3,0,16,13
1683332277949,MATH 10A,A01,188095,Staff,1,6,35,34
1683332278974,MATH 10B,A01,188097,Bowers; Adam R.,0,11,30,30
1683332278974,MATH 10B,A02,188099,Bowers; Adam R.,0,11,30,30
1683332278974,MATH 10B,B01,188104,Bowers; Adam R.,0,10,30,30
1683332278974,MATH 10B,B02,188106,Bowers; Adam R.,0,10,30,30
1683332280000,MATH 10C,A01,188111,Staff,0,18,30,30
1683332280000,MATH 10C,A02,188127,Staff,0,17,30,30
1683332280000,MATH 10C,A03,188131,Staff,0,18,30,30
1683332280000,MATH 10C,B01,188218,Staff,18,0,30,12
1683332280000,MATH 10C,B02,188244,Staff,13,0,30,17
1683332280000,MATH 10C,B03,188277,Staff,16,0,30,14
1683332281029,MATH 18,A01,188344,Bach; Quang Tran,18,0,30,12
1683332281029,MATH 18,A02,188345,Bach; Quang Tran,11,0,30,19
1683332281029,MATH 18,B01,188353,Bach; Quang Tran,10,0,30,20
1683332281029,MATH 18,B02,188354,Bach; Quang Tran,20,0,30,10
1683332282058,MATH 20A,A01,188374,Staff,13,0,35,22
1683332283082,MATH 20B,A01,188382,Ohm; Ko Woon,6,0,30,24
1683332283082,MATH 20B,A02,188383,Ohm; Ko Woon,22,0,30,8
1683332283082,MATH 20B,B01,188385,Ohm; Ko Woon,7,0,30,23
1683332283082,MATH 20B,B02,188392,Ohm; Ko Woon,22,0,30,8
1683332284121,MATH 20C,A01,188394,Harel; Guershon,10,0,30,20
1683332284121,MATH 20C,A02,188395,Harel; Guershon,15,0,30,15
1683332284121,MATH 20C,B01,188404,Harel; Guershon,5,0,30,25
1683332284121,MATH 20C,B02,188405,Harel; Guershon,19,0,30,11
1683332285151,MATH 20D,A01,188414,Hammock; Frances H,0,1,30,30
1683332285151,MATH 20D,A02,188415,Hammock; Frances H,3,0,30,27
1683332285151,MATH 20D,B01,188447,Hammock; Frances H,1,0,30,29
1683332285151,MATH 20D,B02,188486,Hammock; Frances H,8,0,30,22
1683332286177,MATH 20E,A01,188649,Staff,21,0,30,9
1683332286177,MATH 20E,A02,188650,Staff,23,0,30,7
1683332286177,MATH 20E,A03,188673,Staff,0,0,30,30
1683332287205,MATH 102,A01,188675,Staff,0,35,35,35
1683332288231,MATH 103B,A01,188681,Staff,3,0,35,32
1683332288231,MATH 103B,B01,188692,Staff,5,0,35,30
1683332289255,MATH 109,A01,188695,Salehi Golsefidy; Alireza,25,0,35,10
1683332289255,MATH 109,A02,188696,Salehi Golsefidy; Alireza,25,0,35,10
1683332290278,MATH 120A,A01,188698,Eggers; John Dietrich,7,0,35,28
1683332291306,MATH 142B,A01,188736,Ioana; Adrian,0,2,30,30
1683332291306,MATH 142B,A02,188741,Ioana; Adrian,1,1,30,29
1683332291306,MATH 142B,A03,188743,Ioana; Adrian,1,3,30,29
1683332292331,MATH 168A,A01,188790,Staff,0,9,35,35
1683332293359,MATH 170A,A01,188803,Nie; Jiawang,0,2,35,35
1683332293359,MATH 170A,A02,188811,Nie; Jiawang,0,0,35,35
1683332293359,MATH 170A,A03,188814,Nie; Jiawang,1,0,35,34
1683332293359,MATH 170A,A04,188815,Nie; Jiawang,13,0,35,22
1683332294384,MATH 193B,A01,188817,Staff,0,0,35,35
1683332294384,MATH 193B,A02,188818,Staff,5,0,35,30
1683332295411,MGT 4,A01,202857,Anderson; John Charles,62,0,80,18
1683332296435,MGT 12,A00,202858,Lindenberger; Wade Douglas,42,0,90,48
1683332297459,MGT 18,A00,202859,Staff,74,0,90,16
1683332298486,MGT 18GS,A00,202860,McKay; Michael J,13,0,28,15
1683332299511,MGT 45,A00,202861,Pecore; Joseph P.,14,0,90,76
1683332300536,MGT 100,A00,202863,Yavorsky; Daniel Ryan,28,0,90,62
1683332301560,MGT 103,A00,202864,Ehrich; Kristine R,1,18,90,89
1683332302584,MGT 112,A00,202865,Ehrich; Kristine R,15,0,90,75
1683332303610,MGT 121A,A00,202868,Staff,0,20,0,0
1683332304635,MGT 131B,A00,202869,Anderson; John Charles,59,0,90,31
1683332305659,MGT 136,A00,202871,Lindenberger; Wade Douglas,84,0,90,6
1683332306683,MGT 164,A00,202873,Staff,0,68,90,91
1683332307711,MGT 164GS,A00,202874,McKay; Mary A,13,0,28,15
1683332308735,MGT 180,A00,202875,Staff,0,50,90,91
1683332309763,MMW 11R,A01,205019,Herbst; Matthew,3,0,30,27
1683332309763,MMW 11R,A02,205026,Herbst; Matthew,29,0,30,1
1683332310792,MMW 15,A01,193512,Chang; Edmond Yi-Teh,0,9,28,28
1683332310792,MMW 15,A02,193513,Chang; Edmond Yi-Teh,0,5,28,28
1683332310792,MMW 15,A03,193514,Chang; Edmond Yi-Teh,0,5,28,28
1683332310792,MMW 15,A04,193515,Chang; Edmond Yi-Teh,0,5,28,28
1683332310792,MMW 15,A05,193516,Chang; Edmond Yi-Teh,0,4,28,28
1683332310792,MMW 15,A06,193517,Chang; Edmond Yi-Teh,0,5,28,28
1683332310792,MMW 15,B01,193519,Chang; Edmond Yi-Teh,0,5,28,28
1683332310792,MMW 15,B02,193520,Chang; Edmond Yi-Teh,0,5,28,28
1683332310792,MMW 15,B03,193521,Chang; Edmond Yi-Teh,0,5,28,28
1683332310792,MMW 15,B04,193522,Chang; Edmond Yi-Teh,0,4,28,28
1683332310792,MMW 15,B05,193523,Chang; Edmond Yi-Teh,0,5,28,28
1683332310792,MMW 15,B06,193524,Chang; Edmond Yi-Teh,0,4,28,28
1683332311820,MMW 122,A01,193526,Rahimi; Babak,0,15,28,28
1683332311820,MMW 122,A02,193527,Rahimi; Babak,0,14,28,28
1683332311820,MMW 122,A03,193528,Rahimi; Babak,0,0,0,0
1683332311820,MMW 122,A04,193529,Rahimi; Babak,0,0,0,0
1683332312844,MUS 1A,A01,186663,Staff,0,20,35,35
1683332313868,MUS 4,A01,186715,Staff,0,12,35,35
1683332314896,MUS 5R,A01,186796,Dubnov; Shlomo,0,17,35,35
1683332315919,MUS 6,A01,186798,Staff,0,4,25,25
1683332316947,MUS 7,A01,186830,Staff,12,0,35,23
1683332317971,MUS 8,A01,186930,Staff,0,26,35,35
1683332318996,MUS 15,A01,186932,Staff,0,16,35,35
1683332318996,MUS 15,B01,186934,Staff,0,15,35,35
1683332320020,MUS 80,A00,186935,Staff,1,0,20,19
1683332320020,MUS 80,B00,186936,Staff,25,0,25,0
1683332321048,NANO 11,A00,204702,Lipomi; Darren John,0,0,0,0
1683332322072,NANO 15,A01,204709,Yang; Kesong,0,1,0,0
1683332323096,NANO 114,A00,202069,Jahed Motlagh; Zeinab,3,0,10,7
1683332324124,PHIL 1,A00,186955,Grush; Rick Scott,32,0,40,8
1683332325149,PHIL 10,A01,186973,Grush; Rick Scott,28,0,35,7
1683332325149,PHIL 10,A02,186974,Grush; Rick Scott,33,0,35,2
1683332326174,PHIL 13,A01,186976,Staff,7,0,35,28
1683332326174,PHIL 13,A02,186977,Staff,16,0,35,19
1683332327199,PHIL 14,A01,186979,Staff,31,0,35,4
1683332327199,PHIL 14,A02,186986,Staff,32,0,35,3
1683332328226,PHIL 28,A01,186988,Staff,16,0,30,14
1683332328226,PHIL 28,A02,186989,Staff,1,0,30,29
1683332328226,PHIL 28,A03,186990,Staff,9,0,30,21
1683332328226,PHIL 28,A04,186991,Staff,26,0,30,4
1683332329253,PHIL 120,A00,186997,Staff,23,0,40,17
1683332330279,PHIL 137,A00,187003,Staff,9,0,40,31
1683332331304,PHIL 150,A00,187015,Staff,47,0,70,23
1683332332331,PHIL 167,A00,187021,Lamey; Andy M.,35,0,40,5
1683332333356,PHIL 174,A01,202226,Staff,17,0,20,3
1683332333356,PHIL 174,A02,202235,Staff,20,0,20,0
1683332334383,PHIL 191A,A00,258918,Staff,0,0,1,1
1683332335410,PHYS 1A,A00,187028,Staff,27,0,60,33
1683332336437,PHYS 1AL,001,187036,Staff,3,0,30,27
1683332336437,PHYS 1AL,002,187049,Staff,18,0,30,12
1683332337464,PHYS 1B,A00,187058,Staff,22,0,60,38
1683332338490,PHYS 1BL,001,187064,Staff,0,0,30,30
1683332338490,PHYS 1BL,002,187070,Staff,5,0,30,25
1683332339518,PHYS 1C,A00,187082,Staff,31,0,120,89
1683332340547,PHYS 1CL,001,187088,Staff,0,9,30,30
1683332340547,PHYS 1CL,002,187089,Staff,0,2,30,30
1683332340547,PHYS 1CL,009,262693,Staff,11,0,30,19
1683332341575,PHYS 2B,A01,187097,Staff,54,0,115,61
1683332342603,PHYS 2C,A01,187099,Staff,67,0,115,48
1683332343627,PHYS 2CL,A01,187101,Staff,5,0,28,23
1683332343627,PHYS 2CL,A02,187102,Staff,15,0,28,13
1683332344656,PHYS 2D,A01,187123,Shotwell; Brian,95,0,115,20
1683332345683,PHYS 4B,A01,187133,Grinstein; Benjamin,35,0,50,15
1683332346707,POLI 10,A00,188819,Staff,0,4,50,50
1683332347732,POLI 11,A00,188827,Staff,43,0,50,7
1683332348755,POLI 13R,A00,188828,Staff,0,1,20,20
1683332349785,POLI 27,A01,188830,Elgin; Samuel Zincke,0,1,70,70
1683332350813,POLI 30,A00,188832,Desposato; Scott,31,0,50,19
1683332351838,POLI 102F,A00,188834,Staff,3,0,40,37
1683332352866,POLI 104A,A00,188852,Staff,14,0,30,16
1683332353891,POLI 104I,A00,188853,Staff,0,6,20,20
1683332354915,POLI 110B,A00,188854,Wiens; David,7,0,20,13
1683332355943,POLI 112A,A00,188855,Wiens; David,5,0,30,25
1683332356969,POLI 117R,A00,188856,Forman; Fonna,0,11,20,20
1683332357993,POLI 118,A00,188857,Ingham; Sean,8,0,20,12
1683332359017,POLI 120G,A00,188858,Staff,9,0,30,21
1683332360045,POLI 131CR,A00,188863,Hoston; Germaine,24,0,50,26
1683332361073,POLI 133,A00,188864,Nellis; Gareth Hb,44,0,50,6
1683332362097,POLI 134D,A00,188865,Desposato; Scott,27,0,30,3
1683332363121,POLI 142A,A00,188871,Gartzke; Erik,22,0,50,28
1683332364155,POLI 142K,A00,188874,Staff,38,0,50,12
1683332365182,POLI 143,A00,188940,Gartzke; Erik,16,0,30,14
1683332366262,POLI 153,A00,188943,Staff,3,0,20,17
1683332367289,POLI 160AA,A00,188944,Staff,12,0,40,28
1683332368312,POLI 170A,A00,188945,Staff,11,0,30,19
1683332370364,PSYC 1,A00,188952,Staff,37,0,90,53
1683332371387,PSYC 2,B00,188953,Staff,19,0,35,16
1683332372415,PSYC 6,A00,188970,Staff,47,0,60,13
1683332373441,PSYC 7,A00,188973,Staff,37,0,45,8
1683332374469,PSYC 60,A01,188980,Rickard; Timothy C.,43,0,60,17
1683332375496,PSYC 70,A01,189001,Steiner; Eric Tomas,24,0,45,21
1683332376521,PSYC 100,A00,189005,Lacefield; Katharine I,0,100,120,120
1683332377548,PSYC 102,A00,189008,Staff,9,0,30,21
1683332378576,PSYC 106,B00,189026,Gorman; Michael R.,34,0,60,26
1683332379601,PSYC 114,B01,189033,Winkielman; Piotr,0,32,30,30
1683332380625,PSYC 131,A00,189036,Anagnostaras; Stephan,0,43,60,60
1683332381652,PSYC 136,A00,189041,Lowe; Angela Beth,0,7,25,25
1683332382680,PSYC 137,A00,189057,Winkielman; Piotr,0,34,25,25
1683332383708,PSYC 144,A00,189107,Wixted; John T,0,7,50,50
1683332385761,PSYC 162,A00,189142,Staff,0,8,85,85
1683332386785,PSYC 172,A00,189144,Gorman; Michael R.,0,7,30,30
1683332388840,PSYC 179,A00,189146,Lacefield; Katharine I,0,84,120,120
1683332389868,PSYC 181,A00,189147,Anagnostaras; Stephan,0,44,90,90
1683332390892,PSYC 190R,A00,189148,Barner; David A.,0,22,80,80
1683332391920,PSYC 191,A00,189275,Rickard; Timothy C.,0,7,25,25
1683332392945,PSYC 193,A00,189276,Chapman; Eddie Nathaniel,0,1,0,4
1683332393973,PSYC 193L,A01,189281,Lowe; Angela Beth,12,0,20,8
1683332393973,PSYC 193L,B01,189285,Staff,28,0,35,7
1683332394998,RELI 149,A00,187137,Rahimi; Babak,7,0,40,33
1683332396023,SE 9,A01,187315,Staff,0,2,18,18
1683332397051,SE 101B,A00,187409,Staff,24,0,30,6
1683332398074,SE 110B,A00,187444,Staff,10,0,40,30
1683332399100,SE 130B,A00,187449,Staff,31,0,40,9
1683332400125,SE 150A,A00,187516,Staff,9,0,20,11
1683332401155,SE 154,A00,187528,Staff,30,0,50,20
1683332402184,SIO 3,A01,258171,Staff,35,0,40,5
1683332403209,SIO 10,A00,187144,Cook; Geoffrey W,0,3,75,75
1683332404236,SIO 45,A00,187152,Cook; Geoffrey W,1,0,100,99
1683332405261,SIO 109R,A00,194486,Staff,0,3,20,20
1683332407311,SIO 187,A01,187233,Kacev; David,12,0,40,28
1683332408337,SOCI 1,A01,258656,Thorpe; Charles Robert,28,0,30,2
1683332408337,SOCI 1,A02,258658,Thorpe; Charles Robert,30,0,30,0
1683332408337,SOCI 1,A03,258661,Thorpe; Charles Robert,25,0,25,0
1683332408337,SOCI 1,A04,258666,Thorpe; Charles Robert,22,0,25,3
1683332408337,SOCI 1,A05,258897,Thorpe; Charles Robert,23,0,25,2
1683332408337,SOCI 1,A06,258898,Thorpe; Charles Robert,25,0,25,0
1683332409362,SOCI 30,A01,258903,Pardo Guerra; Juan Pablo,15,0,30,15
1683332410386,SOCI 102,A00,258904,Staff,9,0,25,16
1683332411413,SOCI 106,A00,258905,Staff,19,0,25,6
1683332412437,SOCI 111,A00,258907,Ribas Norris; Janet Vanesa,26,0,30,4
1683332413460,SOCI 121R,A00,258908,Pardo Guerra; Juan Pablo,10,0,30,20
1683332414487,SOCI 126,A01,203330,Staff,14,0,20,6
1683332415513,SOCI 131,A00,258909,Thorpe; Charles Robert,31,0,60,29
1683332416539,SOCI 135,A00,258910,Payne; Christine Anna,0,9,30,30
1683332417566,SOCI 157,A00,258911,Staff,12,0,30,18
1683332418592,SOCI 184,A00,258912,Staff,25,0,30,5
1683332419618,SOCI 188D,A00,258913,Staff,21,0,30,9
1683332420642,SYN 2,001,187529,Staff,10,0,16,6
1683332420642,SYN 2,002,201452,Staff,0,18,16,16
1683332420642,SYN 2,003,201469,Staff,3,0,16,13
1683332421670,SYN 100,A01,187531,Staff,0,9,20,20
1683332421670,SYN 100,B01,201491,Staff,0,12,20,20
1683332422697,TDAC 1,A00,189286,Walsh; Kim C.,3,0,20,17
1683332422697,TDAC 1,B00,189287,Harting; Carla Kelso,11,0,20,9
1683332423721,TDAC 101,A00,189300,Walsh; Kim C.,16,0,20,4
1683332423721,TDAC 101,B00,189301,Harting; Carla Kelso,18,0,20,2
1683332424747,TDAC 102,A00,189304,Basso; Beatrice,14,0,20,6
1683332425771,TDAC 108,A00,189305,Staff,18,0,20,2
1683332426797,TDDE 131,A00,189310,Staff,19,0,20,1
1683332426797,TDDE 131,B00,189314,Staff,19,0,20,1
1683332426797,TDDE 131,C00,189315,Staff,48,0,50,2
1683332426797,TDDE 131,D00,189316,Staff,14,0,15,1
1683332426797,TDDE 131,E00,204841,Staff,20,0,20,0
1683332427821,TDGE 10,A00,189289,Staff,30,0,50,20
1683332427821,TDGE 10,B00,189290,Havis; Allan,1,0,50,49
1683332428849,TDGE 11,A00,189291,Fulton; Julia,0,3,50,50
1683332428849,TDGE 11,B00,189292,Staff,20,0,25,5
1683332428849,TDGE 11,C00,260270,Staff,0,0,0,0
1683332429875,TDGE 25,A00,189294,Staff,3,0,20,17
1683332430900,TDGE 124,A00,189318,Fulton; Julia,0,8,50,50
1683332431923,TDGE 125,A00,189319,Staff,13,0,25,12
1683332431923,TDGE 125,B00,189320,Staff,23,0,25,2
1683332432947,TDGE 127,A00,189322,Havis; Allan,0,0,50,50
1683332433974,TDHT 101,A00,189323,Staff,18,0,25,7
1683332433974,TDHT 101,B00,189324,Staff,25,0,25,0
1683332434999,TDHT 102,A00,189325,Staff,49,0,50,1
1683332436024,TDMV 1,A00,189295,Arcidiacono; Kristin,19,0,30,11
1683332436024,TDMV 1,B00,189296,Caligagan; Maria T.,24,0,30,6
1683332437049,TDMV 2,A00,189297,Sammartano; Tonnie,28,0,30,2
1683332437049,TDMV 2,B00,189299,Arcidiacono; Kristin,24,0,30,6
1683332438075,TDMV 3,A00,204998,Rincon; Alicia,22,0,30,8
1683332439101,TDMV 120,A00,189458,Sammartano; Tonnie,28,0,30,2
1683332440125,TDMV 138,A00,189541,Jun; Grace Shin Hae,22,0,40,18
1683332441149,TDMV 142,A00,189717,Caligagan; Tony,23,0,30,7
1683332441149,TDMV 142,B00,189718,Caligagan; Maria T.,25,0,30,5
1683332442177,TMC 2,A01,187533,Staff,25,0,25,0
1683332442177,TMC 2,A02,187534,Staff,25,0,25,0
1683332443211,USP 1,A01,187536,Kwak; Nancy,0,16,25,25
1683332444239,USP 5,A01,187538,Staff,10,0,25,15
1683332445266,USP 101,A00,199253,Staff,0,4,0,0
1683332446293,USP 124,A00,187562,Boomhower; Matthew Charles,1,0,30,29
1683332447320,USP 138,A00,187582,Staff,20,0,25,5
1683332448344,USP 152,A01,187597,Staff,4,0,25,21
1683332449368,USP 153,A00,187598,Staff,19,0,25,6
1683332450393,USP 168,A00,187607,Kwak; Nancy,2,0,5,3
1683332451417,USP 173,A00,187619,Staff,4,0,25,21
1683332452440,USP 181,A00,187638,Staff,0,0,25,25
1683332453467,VIS 103,A00,187650,Cruz; Edwin Teddy,23,0,75,52
1683332454493,VIS 110D,A00,187669,Staff,12,0,22,10
1683332455516,VIS 127C,A00,187720,Shen; Kuiyi,67,0,146,79
1683332456541,VIS 149,A00,187731,Yoldas; Pinar,0,14,22,22
1683332457569,VIS 151,A01,188091,Staff,22,0,34,12
1683332457569,VIS 151,A02,188092,Staff,11,0,34,23
1683332458596,VIS 160B,A00,188093,Stalbaum; Brett,0,0,10,10
1683332460649,WCWP 10B,A00,201720,Staff,10,0,15,5
1683332460649,WCWP 10B,B00,201722,Staff,8,0,15,7
1683332461677,WCWP 100,A00,201725,Gagnon; Jeffrey C,0,0,2,2
1683332461677,WCWP 100,B00,201727,Staff,0,4,15,15
1683332464773,ANBI 133,A00,258401,Wilder; Linnea Lorene,34,0,40,6
1683332465798,ANBI 140,A00,258395,Hrvoj Mihic; Branka,18,0,25,7
1683332466822,ANSC 120,A00,258402,Bialecki; Jon Anthony,27,0,40,13
1683332467847,ANSC 144,A00,258400,Staff,14,0,40,26
1683332469955,ANSC 166,A00,258396,Parish; Steven Martin,157,0,175,18
1683332470979,ANSC 180,A00,193533,Staff,9,0,20,11
1683332472006,ANSC 188,A00,258397,Jassal; Aftab,33,0,40,7
1683332473033,ANTH 3,A01,258316,Staff,23,0,30,7
1683332474057,ANTH 5,A00,258394,Semendeferi; Ekaterini,16,0,20,4
1683332475082,ANTH 21,A01,258331,Staff,8,0,40,32
1683332476105,ANTH 103,A00,258398,Varma; Saiba,15,0,25,10
1683332477132,AWP 10,001,202034,Staff,0,0,0,0
1683332477132,AWP 10,002,202035,Staff,0,0,0,0
1683332477132,AWP 10,003,202036,Staff,0,0,0,0
1683332477132,AWP 10,004,202037,Staff,0,0,0,0
1683332477132,AWP 10,005,202038,Staff,0,0,0,0
1683332477132,AWP 10,006,202039,Staff,0,0,0,0
1683332477132,AWP 10,007,202040,Staff,0,0,0,0
1683332477132,AWP 10,008,202041,Staff,0,0,0,0
1683332477132,AWP 10,009,202042,Staff,0,0,0,0
1683332477132,AWP 10,010,202043,Staff,0,0,0,0
1683332477132,AWP 10,011,202044,Staff,0,0,0,0
1683332477132,AWP 10,012,202045,Staff,0,0,0,0
1683332477132,AWP 10,013,202046,Staff,0,0,0,0
1683332477132,AWP 10,014,202047,Staff,0,0,0,0
1683332477132,AWP 10,015,202048,Staff,0,0,0,0
1683332477132,AWP 10,016,202049,Staff,0,0,0,0
1683332477132,AWP 10,017,202050,Staff,0,0,0,0
1683332477132,AWP 10,018,202051,Staff,0,0,0,0
1683332477132,AWP 10,019,202052,Staff,0,0,0,0
1683332477132,AWP 10,020,202053,Staff,0,0,0,0
1683332477132,AWP 10,021,202054,Staff,0,0,0,0
1683332477132,AWP 10,022,202055,Staff,0,0,0,0
1683332477132,AWP 10,023,202056,Staff,0,0,0,0
1683332477132,AWP 10,024,202057,Staff,0,0,0,0
1683332477132,AWP 10,025,202058,Staff,0,0,0,0
1683332477132,AWP 10,026,202059,Staff,0,0,0,0
1683332478157,AWP 102,001,202032,Staff,0,0,0,0
1683332478157,AWP 102,002,202033,Staff,0,0,0,0
1683332479183,BENG 100,A01,254234,Taylor Amos; Alyssa C,31,0,40,9
1683332480207,BENG 196,001,270013,Engler; Adam J.,9999,0,9999,0
1683332481235,BICD 100R,A01,202018,Smith; Laurie,0,7,32,32
1683332481235,BICD 100R,A02,202019,Smith; Laurie,0,2,32,32
1683332481235,BICD 100R,A03,202020,Smith; Laurie,0,1,32,32
1683332481235,BICD 100R,A04,202021,Smith; Laurie,9,0,32,23
1683332481235,BICD 100R,A05,202022,Smith; Laurie,12,0,32,20
1683332482258,BICD 136,A01,193242,Gustafson-Brown; Cindy,0,2,32,32
1683332482258,BICD 136,A02,193244,Gustafson-Brown; Cindy,14,0,32,18
1683332483284,BIEB 102,A01,193249,Butler; Shannon Rhey,0,2,32,32
1683332483284,BIEB 102,A02,193251,Butler; Shannon Rhey,0,0,32,32
1683332483284,BIEB 102,A03,193253,Butler; Shannon Rhey,0,1,32,32
1683332483284,BIEB 102,A04,193255,Butler; Shannon Rhey,17,0,32,15
1683332483284,BIEB 102,A05,193265,Butler; Shannon Rhey,26,0,32,6
1683332483284,BIEB 102,A06,193269,Butler; Shannon Rhey,16,0,32,16
1683332485333,BIEB 150,A01,193274,Staff,0,0,32,32
1683332485333,BIEB 150,A02,193285,Staff,23,0,32,9
1683332486356,BIEB 194,A00,193286,Kurle; Carolyn M.,22,0,32,10
1683332487385,BILD 1,A01,192291,Staff,16,0,32,16
1683332487385,BILD 1,A02,192292,Staff,30,0,32,2
1683332487385,BILD 1,B01,192520,Reuther; Keefe,0,1,0,0
1683332487385,BILD 1,B02,192532,Reuther; Keefe,0,1,0,0
1683332488411,BILD 3,A01,192556,Butler; Shannon Rhey,0,0,32,32
1683332488411,BILD 3,A02,192581,Butler; Shannon Rhey,5,0,32,27
1683332488411,BILD 3,A03,192611,Butler; Shannon Rhey,23,0,32,9
1683332488411,BILD 3,A04,192612,Butler; Shannon Rhey,25,0,32,7
1683332488411,BILD 3,A05,192613,Butler; Shannon Rhey,27,0,32,5
1683332488411,BILD 3,A06,192679,Butler; Shannon Rhey,27,0,32,5
1683332488411,BILD 3,A07,192682,Butler; Shannon Rhey,22,0,32,10
1683332489442,BILD 4,A01,192836,Reuther; Keefe,0,0,24,24
1683332489442,BILD 4,A02,193044,Reuther; Keefe,4,0,24,20
1683332490466,BILD 10,A01,193142,Gustafson-Brown; Cindy,30,0,32,2
1683332490466,BILD 10,A02,193149,Gustafson-Brown; Cindy,31,0,32,1
1683332491491,BIMM 100,A01,193301,Staff,0,6,32,32
1683332491491,BIMM 100,A02,193312,Staff,0,5,32,32
1683332491491,BIMM 100,A03,193323,Staff,0,8,32,32
1683332492520,BIMM 101,A01,193329,McDonnell; Lisa Marie,0,3,24,24
1683332492520,BIMM 101,A02,193339,McDonnell; Lisa Marie,0,3,24,24
1683332492520,BIMM 101,B01,193354,McDonnell; Lisa Marie,0,3,24,24
1683332492520,BIMM 101,B02,193357,McDonnell; Lisa Marie,0,3,24,24
1683332493549,BIMM 110,A01,193377,Tat; John,0,11,32,32
1683332493549,BIMM 110,A02,193378,Tat; John,1,9,32,31
1683332494579,BIMM 120,A01,206116,Staff,0,0,32,32
1683332494579,BIMM 120,A02,206117,Staff,8,0,32,24
1683332494579,BIMM 120,A03,206121,Staff,21,0,32,11
1683332495607,BIPN 100,A01,193393,Park; Ji Young,0,14,32,32
1683332495607,BIPN 100,A02,193402,Park; Ji Young,0,13,32,32
1683332495607,BIPN 100,A03,193413,Park; Ji Young,0,14,32,32
1683332495607,BIPN 100,A04,193414,Park; Ji Young,0,13,32,32
1683332496636,BIPN 102,A01,193429,Staff,0,0,32,32
1683332496636,BIPN 102,A02,193438,Staff,22,0,32,10
1683332497663,BIPN 106,A01,193450,Reyes Gonzalez; Catalina,0,2,40,40
1683332498689,BIPN 134,A01,193465,Cooke; James Edward,0,0,32,32
1683332498689,BIPN 134,A02,193474,Cooke; James Edward,25,0,32,7
1683332498689,BIPN 134,A03,193485,Cooke; James Edward,29,0,32,3
1683332498689,BIPN 134,A04,193486,Cooke; James Edward,21,0,32,11
1683332498689,BIPN 134,A05,193491,Cooke; James Edward,31,0,32,1
1683332498689,BIPN 134,A06,193501,Cooke; James Edward,30,0,32,2
1683332498689,BIPN 134,A07,193510,Cooke; James Edward,29,0,32,3
1683332500738,BISP 194,A00,222522,Staff,14,0,32,18
1683332501765,CAT 124,A01,202407,Staff,20,0,25,5
1683332502789,CAT 125,A00,202408,Marchisotto; Jennifer Anne,4,0,20,16
1683332503813,CAT 125R,A00,202409,Smith; Lauryn Alissa,0,11,20,20
1683332503813,CAT 125R,B00,202410,Morales; Celeste Georgianna,0,11,20,20
1683332503813,CAT 125R,C00,202411,Irwin; Matthew Joseph,0,10,20,20
1683332504837,CENG 15,A01,204712,Yang; Kesong,0,1,0,0
1683332505865,CENG 114,A00,202070,Jahed Motlagh; Zeinab,5,0,20,15
1683332506891,CGS 105,A00,185477,Wesling; Megan E.,24,0,40,16
1683332507916,CGS 106,A00,185494,Staff,13,0,22,9
1683332508940,CGS 108,A00,185495,Staff,14,0,20,6
1683332509966,CGS 114,A00,185496,Staff,13,0,18,5
1683332510991,CGS 119,A00,185501,Staff,15,0,20,5
1683332512015,CGS 120,A00,185511,Staff,13,0,20,7
1683332513044,CHEM 4,A01,184675,Bussey; Thomas J,96,0,100,4
1683332514070,CHEM 6A,A01,184677,Staff,34,0,60,26
1683332515094,CHEM 6B,A01,184679,Staff,65,0,100,35
1683332516119,CHEM 6C,A01,184681,Bussey; Thomas J,1,0,50,49
1683332516119,CHEM 6C,A02,184682,Bussey; Thomas J,34,0,50,16
1683332517143,CHEM 40A,A01,184684,Albizati; Kim F.,37,0,100,63
1683332518166,CHEM 40B,A01,184686,Albizati; Kim F.,0,20,100,100
1683332519192,CHEM 41B,A01,184690,Staff,52,0,100,48
1683332520220,COGS 3,A01,184715,Boyle; Mary E. T.,0,25,40,40
1683332521246,COGS 14B,A01,185172,Staff,0,15,38,38
1683332522270,COGS 18,A01,184736,Staff,17,0,80,63
1683332523297,COGS 100,A01,184932,Staff,0,5,73,73
1683332524321,COGS 101A,A01,184935,Staff,0,39,30,30
1683332525349,COGS 101B,A01,184944,Staff,0,2,30,30
1683332526374,COGS 101C,A01,184946,Staff,0,12,30,30
1683332527402,COGS 102A,A01,184951,Johnson; Christine M.,2,0,40,38
1683332528429,COGS 107B,A01,184953,Mooshagian; Eric Frederick,0,50,40,40
1683332529457,COGS 118B,A01,184959,Gupta; Anjum,0,48,40,40
1683332530484,COGS 153,A00,184961,Staff,0,15,30,30
1683332531508,COGS 177,A00,184962,Staff,0,20,30,30
1683332532532,COGS 187A,A01,184969,Boyle; Mary E. T.,0,17,40,40
1683332533561,COMM 10,A01,185174,Staff,0,5,25,25
1683332533561,COMM 10,A02,185189,Staff,0,5,25,25
1683332533561,COMM 10,A03,269821,Staff,0,0,0,0
1683332534588,COMM 100B,A01,185475,Staff,0,0,0,2
1683332534588,COMM 100B,A02,185476,Staff,14,0,25,11
1683332535615,COMM 100C,A01,185314,Staff,1,0,25,24
1683332535615,COMM 100C,A02,185327,Staff,19,0,25,6
1683332536642,COMM 110M,A00,185349,Staff,2,0,40,38
1683332537670,COMM 113T,A00,185352,Staff,24,0,40,16
1683332538697,COMM 114I,A00,185353,Staff,33,0,40,7
1683332539723,COMM 131,A00,185354,Staff,19,0,30,11
1683332540746,CSE 8A,A50,185358,Cao; Yingjun,0,46,10,10
1683332541771,CSE 8B,A01,185362,Staff,1,47,50,49
1683332542795,CSE 11,A01,185416,Cao; Yingjun,0,92,10,10
1683332543823,CSE 20,A01,185445,Briones; Jor-el Thomas Caparas,5,0,25,20
1683332544847,CSE 21,A01,185447,Staff,10,0,50,40
1683332545879,CSE 101,A01,185451,Staff,0,12,50,50
1683332545879,CSE 101,B01,185453,Jones; Miles E,0,11,50,50
1683332547927,CSE 141,A01,185458,Eldon; John,20,0,100,80
1683332548951,CSE 141L,A01,185461,Eldon; John,12,0,100,88
1683332549979,CSE 142,A01,185463,Staff,36,0,60,24
1683332549979,CSE 142,B01,201355,Staff,0,7,60,60
1683332551002,CSE 142L,A01,185470,Staff,36,0,60,24
1683332551002,CSE 142L,B01,201417,Staff,0,6,60,60
1683332552027,CSE 190,A00,201433,Staff,32,0,49,17
1683332553052,DOC 1,A01,259136,Strom; Megan C.,7,0,15,8
1683332553052,DOC 1,A02,259137,Strom; Megan C.,14,0,15,1
1683332553052,DOC 1,A03,259138,Strom; Megan C.,14,0,15,1
1683332553052,DOC 1,A04,259139,Strom; Megan C.,14,0,15,1
1683332554080,DOC 100D,A00,259140,Pass; Natalye Joann,16,0,25,9
1683332555108,DSGN 1,A01,184749,Rill; Bryan,0,25,30,30
1683332556132,DSGN 100,A01,185168,Staff,0,2,25,25
1683332557156,ECE 5,A01,185626,Morris; Karcher William,0,10,0,0
1683332558180,ECE 101,A01,185628,Staff,17,0,70,53
1683332559207,ECE 107,A01,185635,Baghdadchi; Saharnaz,0,0,20,20
1683332559207,ECE 107,A02,185638,Baghdadchi; Saharnaz,4,0,20,16
1683332560233,ECE 148,A01,185647,Silberman; Jack,0,0,16,16
1683332561257,ECON 1,A01,185537,Crane; Meredith Helen,54,0,70,16
1683332562283,ECON 3,A01,185549,Crane; Meredith Helen,33,0,70,37
1683332563311,ECON 4,A01,203354,Anderson; John Charles,0,4,10,10
1683332564335,ECON 100A,A01,185574,Staff,0,4,40,40
1683332565362,ECON 100B,A01,185576,Staff,10,22,50,40
1683332566387,ECON 100C,A01,185589,Newhouse; Herbert S,30,0,70,40
1683332567415,ECON 105,A00,185608,Vespa; Emanuel Ignacio,19,0,35,16
1683332568443,ECON 109,A01,185610,Shishkin; Denis,10,0,35,25
1683332569467,ECON 110A,A01,185612,Staff,11,0,40,29
1683332570491,ECON 120A,A01,185615,Staff,20,0,40,20
1683332571515,ECON 120C,A01,185617,Sun; Yixiao,0,20,70,70
1683332572540,ECON 144,A00,203346,Squires; Dale E,3,0,35,32
1683332573624,ECON 171,A01,203349,Newhouse; Herbert S,0,1,35,35
1683332574651,ECON 173A,A01,185621,Toda; Alexis Akira,21,0,35,14
1683332575682,EDS 25,A01,202413,Staff,0,1,0,0
1683332575682,EDS 25,A02,202414,Staff,0,1,0,0
1683332575682,EDS 25,A03,202415,Staff,0,0,0,0
1683332575682,EDS 25,A04,202416,Staff,0,1,0,0
1683332575682,EDS 25,A05,202439,Staff,0,0,0,0
1683332575682,EDS 25,A06,202440,Staff,0,0,0,0
1683332575682,EDS 25,B01,202631,Staff,0,0,0,0
1683332575682,EDS 25,B02,202632,Staff,0,0,0,0
1683332575682,EDS 25,B03,202639,Staff,0,0,0,0
1683332575682,EDS 25,B04,202640,Staff,0,0,0,0
1683332575682,EDS 25,B05,202643,Staff,0,0,0,0
1683332575682,EDS 25,B06,202644,Staff,0,0,0,0
1683332576706,EDS 38,A01,202659,Black; Alison Michelle,24,0,25,1
1683332577733,EDS 115,A00,202652,Staff,17,0,30,13
1683332578757,EDS 125,A00,202649,Staff,14,0,30,16
1683332579784,EDS 126,A01,203332,Staff,30,0,30,0
1683332580807,EDS 139,A00,202838,Staff,16,0,25,9
1683332581840,EDS 146,A01,202655,Staff,14,0,25,11
1683332582864,ENG 15,A00,185667,Staff,0,1,0,0
1683332582864,ENG 15,B00,185672,Staff,0,0,0,0
1683332582864,ENG 15,C00,185675,Staff,0,0,0,0
1683332582864,ENG 15,D00,185682,Staff,0,0,0,0
1683332582864,ENG 15,E00,185684,Staff,0,0,0,0
1683332583891,ETHN 103,A00,185710,Staff,0,3,35,35
1683332584923,ETHN 103A,A00,199228,Man; Simeon S,2,0,9,7
1683332585951,ETHN 109,A00,185711,Staff,18,0,35,17
1683332586976,ETHN 142,A00,185726,Staff,0,4,30,30
1683332587999,ETHN 163J,A00,199229,Man; Simeon S,5,0,8,3
1683332589024,ETHN 168,A00,185727,Staff,8,0,10,2
1683332590047,ETHN 182,A00,185728,Staff,1,0,35,34
1683332591071,ETHN 183,A00,185737,Staff,8,0,18,10
1683332592099,GLBH 111,A01,209361,Burgos; Jose L.,0,0,0,0
1683332594151,HIEU 104,A00,185792,Staff,16,0,20,4
1683332595176,HIEU 115,A00,185800,Staff,1,0,20,19
1683332596199,HIEU 128,A00,185801,Staff,0,7,20,20
1683332597223,HIEU 147,A00,185802,Staff,16,0,20,4
1683332598247,HIEU 154,A00,185823,Staff,12,0,20,8
1683332599274,HILA 102,A00,185826,Staff,13,0,20,7
1683332600297,HILD 2C,A01,185778,Staff,0,12,20,20
1683332601323,HILD 7B,A01,185780,Kwak; Nancy,0,15,32,32
1683332601323,HILD 7B,A02,185781,Kwak; Nancy,0,18,32,32
1683332602348,HILD 30,A01,185791,Staff,14,0,20,6
1683332603372,HISC 119,A00,185830,Golan; Tal,0,9,20,20
1683332604399,HITO 156GS,A00,185831,Patterson; Patrick H.,0,0,0,23
1683332605424,HIUS 103,A00,185832,Man; Simeon S,0,6,20,20
1683332606447,HIUS 117,A00,185836,Kwak; Nancy,2,0,20,18
1683332607474,HIUS 125,A00,185840,Man; Simeon S,0,0,23,23
1683332608501,HIUS 149,A00,185845,Staff,0,0,20,20
1683332609525,HUM 3,A01,185882,Zavodny; Tatiana Sophia,0,7,50,50
1683332609525,HUM 3,B01,185899,Caldwell; Michael Alan,0,18,50,50
1683332610549,HUM 3GS,A00,185900,Patterson; Patrick H.,0,0,0,23
1683332611575,HUM 4,A01,185938,Zroka; Amy Liane,31,0,50,19
1683332611575,HUM 4,B01,185956,Watkins; Eric,0,2,50,50
1683332611575,HUM 4,B02,202209,Watkins; Eric,0,2,50,50
1683332611575,HUM 4,B03,202210,Watkins; Eric,0,2,50,50
1683332612600,HUM 5,A01,185958,West; Geoffrey Scott,3,0,50,47
1683332612600,HUM 5,A02,202215,West; Geoffrey Scott,0,0,50,50
1683332613625,INTL 190,A00,185959,Gagnon; Jeffrey C,0,0,0,9
1683332613625,INTL 190,B00,185960,Lettieri; Michael Joseph,0,0,0,1
1683332614652,JAPN 180,A00,254509,Staff,5,1,30,25
1683332615677,LATI 10,A01,202853,Kennemore; Amy Michelle,4,0,35,31
1683332615677,LATI 10,A02,202854,Kennemore; Amy Michelle,2,0,35,33
1683332615677,LATI 10,A03,270054,Kennemore; Amy Michelle,30,0,30,0
1683332616702,LATI 180,A00,202855,Kennemore; Amy Michelle,11,0,20,9
1683332617727,LAWS 101,A00,201767,Golan; Tal,0,7,40,40
1683332618751,LIFR 1C,A00,185961,Staff,6,0,20,14
1683332619775,LIFR 1CX,A00,185962,Staff,7,0,20,13
1683332620802,LIFR 1D,A00,185963,Staff,9,0,20,11
1683332621827,LIFR 1DX,A00,185964,Staff,9,0,20,11
1683332622856,LIGN 101,A01,186039,Staff,43,0,50,7
1683332623880,LIGN 165,A00,186040,Staff,18,0,50,32
1683332624904,LTCS 108,A00,186041,Staff,6,0,10,4
1683332625933,LTCS 119,A00,186042,Staff,16,0,20,4
1683332626960,LTCS 130,A00,186043,Wesling; Megan E.,15,0,25,10
1683332629013,LTEA 138,A00,186119,Staff,14,0,40,26
1683332630038,LTEN 124,A00,186148,Staff,6,0,25,19
1683332631067,LTEN 178,A00,186149,Staff,7,0,15,8
1683332632092,LTEN 181,A00,186150,Blanco; John D,33,0,40,7
1683332633117,LTWL 120,A00,186160,Staff,20,0,25,5
1683332634142,LTWL 165,A00,186161,Staff,22,0,25,3
1683332635168,LTWR 100,A00,186162,Staff,0,5,15,15
1683332636192,LTWR 102,A00,186163,Doller; Ben,5,0,15,10
1683332637218,MAE 8,A01,186412,Staff,0,0,0,0
1683332638244,MAE 30B,A00,186445,Bahadori; Mohammad Yousef,83,0,100,17
1683332639270,MAE 40,A00,186592,Bewley; Thomas R,9,0,50,41
1683332640295,MAE 101B,A00,186593,Bahadori; Mohammad Yousef,81,0,100,19
1683332641322,MAE 105,A00,186594,Bandaru; Prabhakar,12,0,50,38
1683332642348,MAE 107,A00,186599,Pham; Hieu Tan,0,6,120,120
1683332643373,MAE 148,A01,186660,Silberman; Jack,3,0,16,13
1683332644400,MATH 10A,A01,188095,Staff,1,6,35,34
1683332645426,MATH 10B,A01,188097,Bowers; Adam R.,0,11,30,30
1683332645426,MATH 10B,A02,188099,Bowers; Adam R.,0,11,30,30
1683332645426,MATH 10B,B01,188104,Bowers; Adam R.,0,10,30,30
1683332645426,MATH 10B,B02,188106,Bowers; Adam R.,0,10,30,30
1683332646453,MATH 10C,A01,188111,Staff,0,18,30,30
1683332646453,MATH 10C,A02,188127,Staff,0,17,30,30
1683332646453,MATH 10C,A03,188131,Staff,0,18,30,30
1683332646453,MATH 10C,B01,188218,Staff,18,0,30,12
1683332646453,MATH 10C,B02,188244,Staff,13,0,30,17
1683332646453,MATH 10C,B03,188277,Staff,16,0,30,14
1683332647478,MATH 18,A01,188344,Bach; Quang Tran,18,0,30,12
1683332647478,MATH 18,A02,188345,Bach; Quang Tran,11,0,30,19
1683332647478,MATH 18,B01,188353,Bach; Quang Tran,10,0,30,20
1683332647478,MATH 18,B02,188354,Bach; Quang Tran,20,0,30,10
1683332648508,MATH 20A,A01,188374,Staff,13,0,35,22
1683332649533,MATH 20B,A01,188382,Ohm; Ko Woon,6,0,30,24
1683332649533,MATH 20B,A02,188383,Ohm; Ko Woon,22,0,30,8
1683332649533,MATH 20B,B01,188385,Ohm; Ko Woon,7,0,30,23
1683332649533,MATH 20B,B02,188392,Ohm; Ko Woon,22,0,30,8
1683332650559,MATH 20C,A01,188394,Harel; Guershon,10,0,30,20
1683332650559,MATH 20C,A02,188395,Harel; Guershon,15,0,30,15
1683332650559,MATH 20C,B01,188404,Harel; Guershon,5,0,30,25
1683332650559,MATH 20C,B02,188405,Harel; Guershon,19,0,30,11
1683332651585,MATH 20D,A01,188414,Hammock; Frances H,0,1,30,30
1683332651585,MATH 20D,A02,188415,Hammock; Frances H,3,0,30,27
1683332651585,MATH 20D,B01,188447,Hammock; Frances H,1,0,30,29
1683332651585,MATH 20D,B02,188486,Hammock; Frances H,8,0,30,22
1683332652613,MATH 20E,A01,188649,Staff,21,0,30,9
1683332652613,MATH 20E,A02,188650,Staff,23,0,30,7
1683332652613,MATH 20E,A03,188673,Staff,0,0,30,30
1683332653640,MATH 102,A01,188675,Staff,0,35,35,35
1683332654668,MATH 103B,A01,188681,Staff,3,0,35,32
1683332654668,MATH 103B,B01,188692,Staff,5,0,35,30
1683332655696,MATH 109,A01,188695,Salehi Golsefidy; Alireza,25,0,35,10
1683332655696,MATH 109,A02,188696,Salehi Golsefidy; Alireza,25,0,35,10
1683332656720,MATH 120A,A01,188698,Eggers; John Dietrich,7,0,35,28
1683332657748,MATH 142B,A01,188736,Ioana; Adrian,0,2,30,30
1683332657748,MATH 142B,A02,188741,Ioana; Adrian,1,1,30,29
1683332657748,MATH 142B,A03,188743,Ioana; Adrian,1,3,30,29
1683332658773,MATH 168A,A01,188790,Staff,0,9,35,35
1683332659800,MATH 170A,A01,188803,Nie; Jiawang,0,2,35,35
1683332659800,MATH 170A,A02,188811,Nie; Jiawang,0,0,35,35
1683332659800,MATH 170A,A03,188814,Nie; Jiawang,1,0,35,34
1683332659800,MATH 170A,A04,188815,Nie; Jiawang,13,0,35,22
1683332660827,MATH 193B,A01,188817,Staff,0,0,35,35
1683332660827,MATH 193B,A02,188818,Staff,5,0,35,30
1683332661855,MGT 4,A01,202857,Anderson; John Charles,62,0,80,18
1683332662883,MGT 12,A00,202858,Lindenberger; Wade Douglas,42,0,90,48
1683332663907,MGT 18,A00,202859,Staff,74,0,90,16
1683332664931,MGT 18GS,A00,202860,McKay; Michael J,13,0,28,15
1683332665959,MGT 45,A00,202861,Pecore; Joseph P.,14,0,90,76
1683332666984,MGT 100,A00,202863,Yavorsky; Daniel Ryan,28,0,90,62
1683332668008,MGT 103,A00,202864,Ehrich; Kristine R,1,18,90,89
1683332669035,MGT 112,A00,202865,Ehrich; Kristine R,15,0,90,75
1683332670063,MGT 121A,A00,202868,Staff,0,20,0,0
1683332671091,MGT 131B,A00,202869,Anderson; John Charles,59,0,90,31
1683332672115,MGT 136,A00,202871,Lindenberger; Wade Douglas,84,0,90,6
1683332673139,MGT 164,A00,202873,Staff,0,68,90,91
1683332674165,MGT 164GS,A00,202874,McKay; Mary A,13,0,28,15
1683332675189,MGT 180,A00,202875,Staff,0,50,90,91
1683332676216,MMW 11R,A01,205019,Herbst; Matthew,3,0,30,27
1683332676216,MMW 11R,A02,205026,Herbst; Matthew,29,0,30,1
1683332677313,MMW 15,A01,193512,Chang; Edmond Yi-Teh,0,9,28,28
1683332677313,MMW 15,A02,193513,Chang; Edmond Yi-Teh,0,5,28,28
1683332677313,MMW 15,A03,193514,Chang; Edmond Yi-Teh,0,5,28,28
1683332677313,MMW 15,A04,193515,Chang; Edmond Yi-Teh,0,5,28,28
1683332677313,MMW 15,A05,193516,Chang; Edmond Yi-Teh,0,4,28,28
1683332677313,MMW 15,A06,193517,Chang; Edmond Yi-Teh,0,5,28,28
1683332677313,MMW 15,B01,193519,Chang; Edmond Yi-Teh,0,5,28,28
1683332677313,MMW 15,B02,193520,Chang; Edmond Yi-Teh,0,5,28,28
1683332677313,MMW 15,B03,193521,Chang; Edmond Yi-Teh,0,5,28,28
1683332677313,MMW 15,B04,193522,Chang; Edmond Yi-Teh,0,4,28,28
1683332677313,MMW 15,B05,193523,Chang; Edmond Yi-Teh,0,5,28,28
1683332677313,MMW 15,B06,193524,Chang; Edmond Yi-Teh,0,4,28,28
1683332678342,MMW 122,A01,193526,Rahimi; Babak,0,15,28,28
1683332678342,MMW 122,A02,193527,Rahimi; Babak,0,14,28,28
1683332678342,MMW 122,A03,193528,Rahimi; Babak,0,0,0,0
1683332678342,MMW 122,A04,193529,Rahimi; Babak,0,0,0,0
1683332679365,MUS 1A,A01,186663,Staff,0,20,35,35
1683332680389,MUS 4,A01,186715,Staff,0,12,35,35
1683332681415,MUS 5R,A01,186796,Dubnov; Shlomo,0,17,35,35
1683332682439,MUS 6,A01,186798,Staff,0,4,25,25
1683332683467,MUS 7,A01,186830,Staff,12,0,35,23
1683332684495,MUS 8,A01,186930,Staff,0,26,35,35
1683332685518,MUS 15,A01,186932,Staff,0,16,35,35
1683332685518,MUS 15,B01,186934,Staff,0,15,35,35
1683332686546,MUS 80,A00,186935,Staff,1,0,20,19
1683332686546,MUS 80,B00,186936,Staff,25,0,25,0
1683332687574,NANO 11,A00,204702,Lipomi; Darren John,0,0,0,0
1683332688599,NANO 15,A01,204709,Yang; Kesong,0,1,0,0
1683332689623,NANO 114,A00,202069,Jahed Motlagh; Zeinab,3,0,10,7
1683332690647,PHIL 1,A00,186955,Grush; Rick Scott,32,0,40,8
1683332691676,PHIL 10,A01,186973,Grush; Rick Scott,28,0,35,7
1683332691676,PHIL 10,A02,186974,Grush; Rick Scott,33,0,35,2
1683332692702,PHIL 13,A01,186976,Staff,7,0,35,28
1683332692702,PHIL 13,A02,186977,Staff,16,0,35,19
1683332693728,PHIL 14,A01,186979,Staff,31,0,35,4
1683332693728,PHIL 14,A02,186986,Staff,32,0,35,3
1683332694752,PHIL 28,A01,186988,Staff,16,0,30,14
1683332694752,PHIL 28,A02,186989,Staff,1,0,30,29
1683332694752,PHIL 28,A03,186990,Staff,9,0,30,21
1683332694752,PHIL 28,A04,186991,Staff,26,0,30,4
1683332695777,PHIL 120,A00,186997,Staff,23,0,40,17
1683332696801,PHIL 137,A00,187003,Staff,9,0,40,31
1683332697826,PHIL 150,A00,187015,Staff,47,0,70,23
1683332698855,PHIL 167,A00,187021,Lamey; Andy M.,35,0,40,5
1683332699879,PHIL 174,A01,202226,Staff,17,0,20,3
1683332699879,PHIL 174,A02,202235,Staff,20,0,20,0
1683332700904,PHIL 191A,A00,258918,Staff,0,0,1,1
1683332701936,PHYS 1A,A00,187028,Staff,27,0,60,33
1683332702962,PHYS 1AL,001,187036,Staff,3,0,30,27
1683332702962,PHYS 1AL,002,187049,Staff,18,0,30,12
1683332703987,PHYS 1B,A00,187058,Staff,22,0,60,38
1683332705014,PHYS 1BL,001,187064,Staff,0,0,30,30
1683332705014,PHYS 1BL,002,187070,Staff,5,0,30,25
1683332706039,PHYS 1C,A00,187082,Staff,31,0,120,89
1683332707066,PHYS 1CL,001,187088,Staff,0,9,30,30
1683332707066,PHYS 1CL,002,187089,Staff,0,2,30,30
1683332707066,PHYS 1CL,009,262693,Staff,11,0,30,19
1683332708091,PHYS 2B,A01,187097,Staff,54,0,115,61
1683332709120,PHYS 2C,A01,187099,Staff,67,0,115,48
1683332710148,PHYS 2CL,A01,187101,Staff,5,0,28,23
1683332710148,PHYS 2CL,A02,187102,Staff,15,0,28,13
1683332711177,PHYS 2D,A01,187123,Shotwell; Brian,95,0,115,20
1683332712204,PHYS 4B,A01,187133,Grinstein; Benjamin,35,0,50,15
1683332713230,POLI 10,A00,188819,Staff,0,4,50,50
1683332714254,POLI 11,A00,188827,Staff,43,0,50,7
1683332715277,POLI 13R,A00,188828,Staff,0,1,20,20
1683332716304,POLI 27,A01,188830,Elgin; Samuel Zincke,0,1,70,70
1683332717328,POLI 30,A00,188832,Desposato; Scott,31,0,50,19
1683332718351,POLI 102F,A00,188834,Staff,3,0,40,37
1683332719378,POLI 104A,A00,188852,Staff,14,0,30,16
1683332720402,POLI 104I,A00,188853,Staff,0,6,20,20
1683332721429,POLI 110B,A00,188854,Wiens; David,7,0,20,13
1683332722452,POLI 112A,A00,188855,Wiens; David,5,0,30,25
1683332723477,POLI 117R,A00,188856,Forman; Fonna,0,11,20,20
1683332724507,POLI 118,A00,188857,Ingham; Sean,8,0,20,12
1683332725534,POLI 120G,A00,188858,Staff,9,0,30,21
1683332726561,POLI 131CR,A00,188863,Hoston; Germaine,24,0,50,26
1683332727585,POLI 133,A00,188864,Nellis; Gareth Hb,44,0,50,6
1683332728613,POLI 134D,A00,188865,Desposato; Scott,27,0,30,3
1683332729640,POLI 142A,A00,188871,Gartzke; Erik,22,0,50,28
1683332730667,POLI 142K,A00,188874,Staff,38,0,50,12
1683332731691,POLI 143,A00,188940,Gartzke; Erik,16,0,30,14
1683332732718,POLI 153,A00,188943,Staff,3,0,20,17
1683332733745,POLI 160AA,A00,188944,Staff,12,0,40,28
1683332734770,POLI 170A,A00,188945,Staff,11,0,30,19
1683332736823,PSYC 1,A00,188952,Staff,37,0,90,53
1683332737847,PSYC 2,B00,188953,Staff,19,0,35,16
1683332738874,PSYC 6,A00,188970,Staff,47,0,60,13
1683332739901,PSYC 7,A00,188973,Staff,37,0,45,8
1683332740929,PSYC 60,A01,188980,Rickard; Timothy C.,43,0,60,17
1683332741954,PSYC 70,A01,189001,Steiner; Eric Tomas,24,0,45,21
1683332742978,PSYC 100,A00,189005,Lacefield; Katharine I,0,100,120,120
1683332744002,PSYC 102,A00,189008,Staff,9,0,30,21
1683332745026,PSYC 106,B00,189026,Gorman; Michael R.,34,0,60,26
1683332746053,PSYC 114,B01,189033,Winkielman; Piotr,0,32,30,30
1683332747077,PSYC 131,A00,189036,Anagnostaras; Stephan,0,43,60,60
1683332748101,PSYC 136,A00,189041,Lowe; Angela Beth,0,7,25,25
1683332749125,PSYC 137,A00,189057,Winkielman; Piotr,0,34,25,25
1683332750148,PSYC 144,A00,189107,Wixted; John T,0,7,50,50
1683332752194,PSYC 162,A00,189142,Staff,0,8,85,85
1683332753222,PSYC 172,A00,189144,Gorman; Michael R.,0,7,30,30
1683332755270,PSYC 179,A00,189146,Lacefield; Katharine I,0,84,120,120
1683332756296,PSYC 181,A00,189147,Anagnostaras; Stephan,0,44,90,90
1683332757325,PSYC 190R,A00,189148,Barner; David A.,0,22,80,80
1683332758348,PSYC 191,A00,189275,Rickard; Timothy C.,0,7,25,25
1683332759373,PSYC 193,A00,189276,Chapman; Eddie Nathaniel,0,1,0,4
1683332760398,PSYC 193L,A01,189281,Lowe; Angela Beth,12,0,20,8
1683332760398,PSYC 193L,B01,189285,Staff,28,0,35,7
1683332761426,RELI 149,A00,187137,Rahimi; Babak,7,0,40,33
1683332762451,SE 9,A01,187315,Staff,0,2,18,18
1683332763476,SE 101B,A00,187409,Staff,24,0,30,6
1683332764500,SE 110B,A00,187444,Staff,10,0,40,30
1683332765527,SE 130B,A00,187449,Staff,31,0,40,9
1683332766551,SE 150A,A00,187516,Staff,9,0,20,11
1683332767575,SE 154,A00,187528,Staff,30,0,50,20
1683332768604,SIO 3,A01,258171,Staff,35,0,40,5
1683332769631,SIO 10,A00,187144,Cook; Geoffrey W,0,3,75,75
1683332770655,SIO 45,A00,187152,Cook; Geoffrey W,1,0,100,99
1683332771680,SIO 109R,A00,194486,Staff,0,3,20,20
1683332773734,SIO 187,A01,187233,Kacev; David,12,0,40,28
1683332774761,SOCI 1,A01,258656,Thorpe; Charles Robert,28,0,30,2
1683332774761,SOCI 1,A02,258658,Thorpe; Charles Robert,30,0,30,0
1683332774761,SOCI 1,A03,258661,Thorpe; Charles Robert,25,0,25,0
1683332774761,SOCI 1,A04,258666,Thorpe; Charles Robert,22,0,25,3
1683332774761,SOCI 1,A05,258897,Thorpe; Charles Robert,23,0,25,2
1683332774761,SOCI 1,A06,258898,Thorpe; Charles Robert,25,0,25,0
1683332775786,SOCI 30,A01,258903,Pardo Guerra; Juan Pablo,15,0,30,15
1683332776812,SOCI 102,A00,258904,Staff,9,0,25,16
1683332777839,SOCI 106,A00,258905,Staff,19,0,25,6
1683332778864,SOCI 111,A00,258907,Ribas Norris; Janet Vanesa,26,0,30,4
1683332779891,SOCI 121R,A00,258908,Pardo Guerra; Juan Pablo,10,0,30,20
1683332780975,SOCI 126,A01,203330,Staff,14,0,20,6
1683332782003,SOCI 131,A00,258909,Thorpe; Charles Robert,31,0,60,29
1683332783031,SOCI 135,A00,258910,Payne; Christine Anna,0,9,30,30
1683332784056,SOCI 157,A00,258911,Staff,12,0,30,18
1683332785081,SOCI 184,A00,258912,Staff,25,0,30,5
1683332786105,SOCI 188D,A00,258913,Staff,21,0,30,9
1683332787129,SYN 2,001,187529,Staff,10,0,16,6
1683332787129,SYN 2,002,201452,Staff,0,18,16,16
1683332787129,SYN 2,003,201469,Staff,3,0,16,13
1683332788154,SYN 100,A01,187531,Staff,0,9,20,20
1683332788154,SYN 100,B01,201491,Staff,0,12,20,20
1683332789179,TDAC 1,A00,189286,Walsh; Kim C.,3,0,20,17
1683332789179,TDAC 1,B00,189287,Harting; Carla Kelso,11,0,20,9
1683332790204,TDAC 101,A00,189300,Walsh; Kim C.,16,0,20,4
1683332790204,TDAC 101,B00,189301,Harting; Carla Kelso,18,0,20,2
1683332791230,TDAC 102,A00,189304,Basso; Beatrice,14,0,20,6
1683332792255,TDAC 108,A00,189305,Staff,18,0,20,2
1683332793281,TDDE 131,A00,189310,Staff,19,0,20,1
1683332793281,TDDE 131,B00,189314,Staff,19,0,20,1
1683332793281,TDDE 131,C00,189315,Staff,48,0,50,2
1683332793281,TDDE 131,D00,189316,Staff,14,0,15,1
1683332793281,TDDE 131,E00,204841,Staff,20,0,20,0
1683332794305,TDGE 10,A00,189289,Staff,30,0,50,20
1683332794305,TDGE 10,B00,189290,Havis; Allan,1,0,50,49
1683332795329,TDGE 11,A00,189291,Fulton; Julia,0,3,50,50
1683332795329,TDGE 11,B00,189292,Staff,20,0,25,5
1683332795329,TDGE 11,C00,260270,Staff,0,0,0,0
1683332796356,TDGE 25,A00,189294,Staff,3,0,20,17
1683332797381,TDGE 124,A00,189318,Fulton; Julia,0,8,50,50
1683332798405,TDGE 125,A00,189319,Staff,13,0,25,12
1683332798405,TDGE 125,B00,189320,Staff,23,0,25,2
1683332799433,TDGE 127,A00,189322,Havis; Allan,0,0,50,50
1683332800457,TDHT 101,A00,189323,Staff,18,0,25,7
1683332800457,TDHT 101,B00,189324,Staff,25,0,25,0
1683332801481,TDHT 102,A00,189325,Staff,49,0,50,1
1683332802509,TDMV 1,A00,189295,Arcidiacono; Kristin,19,0,30,11
1683332802509,TDMV 1,B00,189296,Caligagan; Maria T.,24,0,30,6
1683332803536,TDMV 2,A00,189297,Sammartano; Tonnie,28,0,30,2
1683332803536,TDMV 2,B00,189299,Arcidiacono; Kristin,24,0,30,6
1683332804561,TDMV 3,A00,204998,Rincon; Alicia,22,0,30,8
1683332805589,TDMV 120,A00,189458,Sammartano; Tonnie,28,0,30,2
1683332806615,TDMV 138,A00,189541,Jun; Grace Shin Hae,22,0,40,18
1683332807643,TDMV 142,A00,189717,Caligagan; Tony,23,0,30,7
1683332807643,TDMV 142,B00,189718,Caligagan; Maria T.,25,0,30,5
1683332808670,TMC 2,A01,187533,Staff,25,0,25,0
1683332808670,TMC 2,A02,187534,Staff,25,0,25,0
1683332809696,USP 1,A01,187536,Kwak; Nancy,0,16,25,25
1683332810720,USP 5,A01,187538,Staff,10,0,25,15
1683332811745,USP 101,A00,199253,Staff,0,4,0,0
1683332812771,USP 124,A00,187562,Boomhower; Matthew Charles,1,0,30,29
1683332813798,USP 138,A00,187582,Staff,20,0,25,5
1683332814826,USP 152,A01,187597,Staff,4,0,25,21
1683332815850,USP 153,A00,187598,Staff,19,0,25,6
1683332816877,USP 168,A00,187607,Kwak; Nancy,2,0,5,3
1683332817901,USP 173,A00,187619,Staff,4,0,25,21
1683332818929,USP 181,A00,187638,Staff,0,0,25,25
1683332819953,VIS 103,A00,187650,Cruz; Edwin Teddy,23,0,75,52
1683332820978,VIS 110D,A00,187669,Staff,12,0,22,10
1683332822006,VIS 127C,A00,187720,Shen; Kuiyi,67,0,146,79
1683332823030,VIS 149,A00,187731,Yoldas; Pinar,0,14,22,22
1683332824055,VIS 151,A01,188091,Staff,22,0,34,12
1683332824055,VIS 151,A02,188092,Staff,11,0,34,23
1683332825078,VIS 160B,A00,188093,Stalbaum; Brett,0,0,10,10
1683332827128,WCWP 10B,A00,201720,Staff,10,0,15,5
1683332827128,WCWP 10B,B00,201722,Staff,8,0,15,7
1683332828155,WCWP 100,A00,201725,Gagnon; Jeffrey C,0,0,2,2
1683332828155,WCWP 100,B00,201727,Staff,0,4,15,15
1683332831283,ANBI 133,A00,258401,Wilder; Linnea Lorene,34,0,40,6
1683332832308,ANBI 140,A00,258395,Hrvoj Mihic; Branka,18,0,25,7
1683332833333,ANSC 120,A00,258402,Bialecki; Jon Anthony,27,0,40,13
1683332834357,ANSC 144,A00,258400,Staff,14,0,40,26
1683332836407,ANSC 166,A00,258396,Parish; Steven Martin,157,0,175,18
1683332837433,ANSC 180,A00,193533,Staff,9,0,20,11
1683332838466,ANSC 188,A00,258397,Jassal; Aftab,33,0,40,7
1683332839493,ANTH 3,A01,258316,Staff,23,0,30,7
1683332840518,ANTH 5,A00,258394,Semendeferi; Ekaterini,16,0,20,4
1683332841545,ANTH 21,A01,258331,Staff,8,0,40,32
1683332842573,ANTH 103,A00,258398,Varma; Saiba,15,0,25,10
1683332843600,AWP 10,001,202034,Staff,0,0,0,0
1683332843600,AWP 10,002,202035,Staff,0,0,0,0
1683332843600,AWP 10,003,202036,Staff,0,0,0,0
1683332843600,AWP 10,004,202037,Staff,0,0,0,0
1683332843600,AWP 10,005,202038,Staff,0,0,0,0
1683332843600,AWP 10,006,202039,Staff,0,0,0,0
1683332843600,AWP 10,007,202040,Staff,0,0,0,0
1683332843600,AWP 10,008,202041,Staff,0,0,0,0
1683332843600,AWP 10,009,202042,Staff,0,0,0,0
1683332843600,AWP 10,010,202043,Staff,0,0,0,0
1683332843600,AWP 10,011,202044,Staff,0,0,0,0
1683332843600,AWP 10,012,202045,Staff,0,0,0,0
1683332843600,AWP 10,013,202046,Staff,0,0,0,0
1683332843600,AWP 10,014,202047,Staff,0,0,0,0
1683332843600,AWP 10,015,202048,Staff,0,0,0,0
1683332843600,AWP 10,016,202049,Staff,0,0,0,0
1683332843600,AWP 10,017,202050,Staff,0,0,0,0
1683332843600,AWP 10,018,202051,Staff,0,0,0,0
1683332843600,AWP 10,019,202052,Staff,0,0,0,0
1683332843600,AWP 10,020,202053,Staff,0,0,0,0
1683332843600,AWP 10,021,202054,Staff,0,0,0,0
1683332843600,AWP 10,022,202055,Staff,0,0,0,0
1683332843600,AWP 10,023,202056,Staff,0,0,0,0
1683332843600,AWP 10,024,202057,Staff,0,0,0,0
1683332843600,AWP 10,025,202058,Staff,0,0,0,0
1683332843600,AWP 10,026,202059,Staff,0,0,0,0
1683332844625,AWP 102,001,202032,Staff,0,0,0,0
1683332844625,AWP 102,002,202033,Staff,0,0,0,0
1683332845653,BENG 100,A01,254234,Taylor Amos; Alyssa C,31,0,40,9
1683332846680,BENG 196,001,270013,Engler; Adam J.,9999,0,9999,0
1683332847709,BICD 100R,A01,202018,Smith; Laurie,0,7,32,32
1683332847709,BICD 100R,A02,202019,Smith; Laurie,0,2,32,32
1683332847709,BICD 100R,A03,202020,Smith; Laurie,0,1,32,32
1683332847709,BICD 100R,A04,202021,Smith; Laurie,9,0,32,23
1683332847709,BICD 100R,A05,202022,Smith; Laurie,12,0,32,20
1683332848738,BICD 136,A01,193242,Gustafson-Brown; Cindy,0,2,32,32
1683332848738,BICD 136,A02,193244,Gustafson-Brown; Cindy,14,0,32,18
1683332849763,BIEB 102,A01,193249,Butler; Shannon Rhey,0,2,32,32
1683332849763,BIEB 102,A02,193251,Butler; Shannon Rhey,0,0,32,32
1683332849763,BIEB 102,A03,193253,Butler; Shannon Rhey,0,1,32,32
1683332849763,BIEB 102,A04,193255,Butler; Shannon Rhey,17,0,32,15
1683332849763,BIEB 102,A05,193265,Butler; Shannon Rhey,26,0,32,6
1683332849763,BIEB 102,A06,193269,Butler; Shannon Rhey,16,0,32,16
1683332851819,BIEB 150,A01,193274,Staff,0,0,32,32
1683332851819,BIEB 150,A02,193285,Staff,23,0,32,9
1683332852843,BIEB 194,A00,193286,Kurle; Carolyn M.,22,0,32,10
1683332853867,BILD 1,A01,192291,Staff,16,0,32,16
1683332853867,BILD 1,A02,192292,Staff,30,0,32,2
1683332853867,BILD 1,B01,192520,Reuther; Keefe,0,1,0,0
1683332853867,BILD 1,B02,192532,Reuther; Keefe,0,1,0,0
1683332854897,BILD 3,A01,192556,Butler; Shannon Rhey,0,0,32,32
1683332854897,BILD 3,A02,192581,Butler; Shannon Rhey,5,0,32,27
1683332854897,BILD 3,A03,192611,Butler; Shannon Rhey,23,0,32,9
1683332854897,BILD 3,A04,192612,Butler; Shannon Rhey,25,0,32,7
1683332854897,BILD 3,A05,192613,Butler; Shannon Rhey,27,0,32,5
1683332854897,BILD 3,A06,192679,Butler; Shannon Rhey,27,0,32,5
1683332854897,BILD 3,A07,192682,Butler; Shannon Rhey,22,0,32,10
1683332855926,BILD 4,A01,192836,Reuther; Keefe,0,0,24,24
1683332855926,BILD 4,A02,193044,Reuther; Keefe,4,0,24,20
1683332856955,BILD 10,A01,193142,Gustafson-Brown; Cindy,30,0,32,2
1683332856955,BILD 10,A02,193149,Gustafson-Brown; Cindy,31,0,32,1
1683332857980,BIMM 100,A01,193301,Staff,0,6,32,32
1683332857980,BIMM 100,A02,193312,Staff,0,5,32,32
1683332857980,BIMM 100,A03,193323,Staff,0,8,32,32
1683332859010,BIMM 101,A01,193329,McDonnell; Lisa Marie,0,3,24,24
1683332859010,BIMM 101,A02,193339,McDonnell; Lisa Marie,0,3,24,24
1683332859010,BIMM 101,B01,193354,McDonnell; Lisa Marie,0,3,24,24
1683332859010,BIMM 101,B02,193357,McDonnell; Lisa Marie,0,3,24,24
1683332860037,BIMM 110,A01,193377,Tat; John,0,11,32,32
1683332860037,BIMM 110,A02,193378,Tat; John,1,9,32,31
1683332861064,BIMM 120,A01,206116,Staff,0,0,32,32
1683332861064,BIMM 120,A02,206117,Staff,8,0,32,24
1683332861064,BIMM 120,A03,206121,Staff,21,0,32,11
1683332862089,BIPN 100,A01,193393,Park; Ji Young,0,14,32,32
1683332862089,BIPN 100,A02,193402,Park; Ji Young,0,13,32,32
1683332862089,BIPN 100,A03,193413,Park; Ji Young,0,14,32,32
1683332862089,BIPN 100,A04,193414,Park; Ji Young,0,13,32,32
1683332863112,BIPN 102,A01,193429,Staff,0,0,32,32
1683332863112,BIPN 102,A02,193438,Staff,22,0,32,10
1683332864141,BIPN 106,A01,193450,Reyes Gonzalez; Catalina,0,2,40,40
1683332865170,BIPN 134,A01,193465,Cooke; James Edward,0,0,32,32
1683332865170,BIPN 134,A02,193474,Cooke; James Edward,25,0,32,7
1683332865170,BIPN 134,A03,193485,Cooke; James Edward,29,0,32,3
1683332865170,BIPN 134,A04,193486,Cooke; James Edward,21,0,32,11
1683332865170,BIPN 134,A05,193491,Cooke; James Edward,31,0,32,1
1683332865170,BIPN 134,A06,193501,Cooke; James Edward,30,0,32,2
1683332865170,BIPN 134,A07,193510,Cooke; James Edward,29,0,32,3
1683332867218,BISP 194,A00,222522,Staff,14,0,32,18
1683332868242,CAT 124,A01,202407,Staff,20,0,25,5
1683332869265,CAT 125,A00,202408,Marchisotto; Jennifer Anne,4,0,20,16
1683332870294,CAT 125R,A00,202409,Smith; Lauryn Alissa,0,11,20,20
1683332870294,CAT 125R,B00,202410,Morales; Celeste Georgianna,0,11,20,20
1683332870294,CAT 125R,C00,202411,Irwin; Matthew Joseph,0,10,20,20
1683332871319,CENG 15,A01,204712,Yang; Kesong,0,1,0,0
1683332872343,CENG 114,A00,202070,Jahed Motlagh; Zeinab,5,0,20,15
1683332873369,CGS 105,A00,185477,Wesling; Megan E.,24,0,40,16
1683332874394,CGS 106,A00,185494,Staff,13,0,22,9
1683332875417,CGS 108,A00,185495,Staff,14,0,20,6
1683332876441,CGS 114,A00,185496,Staff,13,0,18,5
1683332877467,CGS 119,A00,185501,Staff,15,0,20,5
1683332878495,CGS 120,A00,185511,Staff,13,0,20,7
1683332879525,CHEM 4,A01,184675,Bussey; Thomas J,96,0,100,4
1683332880549,CHEM 6A,A01,184677,Staff,34,0,60,26
1683332881578,CHEM 6B,A01,184679,Staff,65,0,100,35
1683332882606,CHEM 6C,A01,184681,Bussey; Thomas J,1,0,50,49
1683332882606,CHEM 6C,A02,184682,Bussey; Thomas J,34,0,50,16
1683332883640,CHEM 40A,A01,184684,Albizati; Kim F.,37,0,100,63
1683332884726,CHEM 40B,A01,184686,Albizati; Kim F.,0,20,100,100
1683332885750,CHEM 41B,A01,184690,Staff,52,0,100,48
1683332886775,COGS 3,A01,184715,Boyle; Mary E. T.,0,25,40,40
1683332887803,COGS 14B,A01,185172,Staff,0,15,38,38
1683332888826,COGS 18,A01,184736,Staff,17,0,80,63
1683332889849,COGS 100,A01,184932,Staff,0,5,73,73
1683332890877,COGS 101A,A01,184935,Staff,0,39,30,30
1683332891905,COGS 101B,A01,184944,Staff,0,2,30,30
1683332892930,COGS 101C,A01,184946,Staff,0,12,30,30
1683332893957,COGS 102A,A01,184951,Johnson; Christine M.,2,0,40,38
1683332894982,COGS 107B,A01,184953,Mooshagian; Eric Frederick,0,50,40,40
1683332896011,COGS 118B,A01,184959,Gupta; Anjum,0,48,40,40
1683332897034,COGS 153,A00,184961,Staff,0,15,30,30
1683332898059,COGS 177,A00,184962,Staff,0,20,30,30
1683332899083,COGS 187A,A01,184969,Boyle; Mary E. T.,0,17,40,40
1683332900108,COMM 10,A01,185174,Staff,0,5,25,25
1683332900108,COMM 10,A02,185189,Staff,0,5,25,25
1683332900108,COMM 10,A03,269821,Staff,0,0,0,0
1683332901133,COMM 100B,A01,185475,Staff,0,0,0,2
1683332901133,COMM 100B,A02,185476,Staff,14,0,25,11
1683332902160,COMM 100C,A01,185314,Staff,1,0,25,24
1683332902160,COMM 100C,A02,185327,Staff,19,0,25,6
1683332903187,COMM 110M,A00,185349,Staff,2,0,40,38
1683332904213,COMM 113T,A00,185352,Staff,24,0,40,16
1683332905240,COMM 114I,A00,185353,Staff,33,0,40,7
1683332906268,COMM 131,A00,185354,Staff,19,0,30,11
1683332907297,CSE 8A,A50,185358,Cao; Yingjun,0,46,10,10
1683332908320,CSE 8B,A01,185362,Staff,1,47,50,49
1683332909348,CSE 11,A01,185416,Cao; Yingjun,0,92,10,10
1683332910375,CSE 20,A01,185445,Briones; Jor-el Thomas Caparas,5,0,25,20
1683332911404,CSE 21,A01,185447,Staff,10,0,50,40
1683332912430,CSE 101,A01,185451,Staff,0,12,50,50
1683332912430,CSE 101,B01,185453,Jones; Miles E,0,11,50,50
1683332914485,CSE 141,A01,185458,Eldon; John,20,0,100,80
1683332915513,CSE 141L,A01,185461,Eldon; John,12,0,100,88
1683332916538,CSE 142,A01,185463,Staff,36,0,60,24
1683332916538,CSE 142,B01,201355,Staff,0,7,60,60
1683332917566,CSE 142L,A01,185470,Staff,36,0,60,24
1683332917566,CSE 142L,B01,201417,Staff,0,6,60,60
1683332918589,CSE 190,A00,201433,Staff,32,0,49,17
1683332919614,DOC 1,A01,259136,Strom; Megan C.,7,0,15,8
1683332919614,DOC 1,A02,259137,Strom; Megan C.,14,0,15,1
1683332919614,DOC 1,A03,259138,Strom; Megan C.,14,0,15,1
1683332919614,DOC 1,A04,259139,Strom; Megan C.,14,0,15,1
1683332920638,DOC 100D,A00,259140,Pass; Natalye Joann,16,0,25,9
1683332921667,DSGN 1,A01,184749,Rill; Bryan,0,25,30,30
1683332922691,DSGN 100,A01,185168,Staff,0,2,25,25
1683332923716,ECE 5,A01,185626,Morris; Karcher William,0,10,0,0
1683332924741,ECE 101,A01,185628,Staff,17,0,70,53
1683332925771,ECE 107,A01,185635,Baghdadchi; Saharnaz,0,0,20,20
1683332925771,ECE 107,A02,185638,Baghdadchi; Saharnaz,4,0,20,16
1683332926795,ECE 148,A01,185647,Silberman; Jack,0,0,16,16
1683332927823,ECON 1,A01,185537,Crane; Meredith Helen,54,0,70,16
1683332928846,ECON 3,A01,185549,Crane; Meredith Helen,33,0,70,37
1683332929879,ECON 4,A01,203354,Anderson; John Charles,0,4,10,10
1683332930907,ECON 100A,A01,185574,Staff,0,4,40,40
1683332931931,ECON 100B,A01,185576,Staff,10,22,50,40
1683332932955,ECON 100C,A01,185589,Newhouse; Herbert S,30,0,70,40
1683332933983,ECON 105,A00,185608,Vespa; Emanuel Ignacio,19,0,35,16
1683332935012,ECON 109,A01,185610,Shishkin; Denis,10,0,35,25
1683332936039,ECON 110A,A01,185612,Staff,11,0,40,29
1683332937067,ECON 120A,A01,185615,Staff,20,0,40,20
1683332938094,ECON 120C,A01,185617,Sun; Yixiao,0,20,70,70
1683332939120,ECON 144,A00,203346,Squires; Dale E,3,0,35,32
1683332940148,ECON 171,A01,203349,Newhouse; Herbert S,0,1,35,35
1683332941176,ECON 173A,A01,185621,Toda; Alexis Akira,21,0,35,14
1683332942201,EDS 25,A01,202413,Staff,0,1,0,0
1683332942201,EDS 25,A02,202414,Staff,0,1,0,0
1683332942201,EDS 25,A03,202415,Staff,0,0,0,0
1683332942201,EDS 25,A04,202416,Staff,0,1,0,0
1683332942201,EDS 25,A05,202439,Staff,0,0,0,0
1683332942201,EDS 25,A06,202440,Staff,0,0,0,0
1683332942201,EDS 25,B01,202631,Staff,0,0,0,0
1683332942201,EDS 25,B02,202632,Staff,0,0,0,0
1683332942201,EDS 25,B03,202639,Staff,0,0,0,0
1683332942201,EDS 25,B04,202640,Staff,0,0,0,0
1683332942201,EDS 25,B05,202643,Staff,0,0,0,0
1683332942201,EDS 25,B06,202644,Staff,0,0,0,0
1683332943225,EDS 38,A01,202659,Black; Alison Michelle,24,0,25,1
1683332944248,EDS 115,A00,202652,Staff,17,0,30,13
1683332945273,EDS 125,A00,202649,Staff,14,0,30,16
1683332946302,EDS 126,A01,203332,Staff,30,0,30,0
1683332947325,EDS 139,A00,202838,Staff,16,0,25,9
1683332948357,EDS 146,A01,202655,Staff,14,0,25,11
1683332949382,ENG 15,A00,185667,Staff,0,1,0,0
1683332949382,ENG 15,B00,185672,Staff,0,0,0,0
1683332949382,ENG 15,C00,185675,Staff,0,0,0,0
1683332949382,ENG 15,D00,185682,Staff,0,0,0,0
1683332949382,ENG 15,E00,185684,Staff,0,0,0,0
1683332950406,ETHN 103,A00,185710,Staff,0,3,35,35
1683332951430,ETHN 103A,A00,199228,Man; Simeon S,2,0,9,7
1683332952457,ETHN 109,A00,185711,Staff,18,0,35,17
1683332953485,ETHN 142,A00,185726,Staff,0,4,30,30
1683332954511,ETHN 163J,A00,199229,Man; Simeon S,5,0,8,3
1683332955535,ETHN 168,A00,185727,Staff,8,0,10,2
1683332956559,ETHN 182,A00,185728,Staff,1,0,35,34
1683332957583,ETHN 183,A00,185737,Staff,8,0,18,10
1683332958606,GLBH 111,A01,209361,Burgos; Jose L.,0,0,0,0
1683332960654,HIEU 104,A00,185792,Staff,16,0,20,4
1683332961678,HIEU 115,A00,185800,Staff,1,0,20,19
1683332962703,HIEU 128,A00,185801,Staff,0,7,20,20
1683332963730,HIEU 147,A00,185802,Staff,16,0,20,4
1683332964754,HIEU 154,A00,185823,Staff,12,0,20,8
1683332965778,HILA 102,A00,185826,Staff,13,0,20,7
1683332966802,HILD 2C,A01,185778,Staff,0,12,20,20
1683332967827,HILD 7B,A01,185780,Kwak; Nancy,0,15,32,32
1683332967827,HILD 7B,A02,185781,Kwak; Nancy,0,18,32,32
1683332968850,HILD 30,A01,185791,Staff,14,0,20,6
1683332969874,HISC 119,A00,185830,Golan; Tal,0,9,20,20
1683332970901,HITO 156GS,A00,185831,Patterson; Patrick H.,0,0,0,23
1683332971925,HIUS 103,A00,185832,Man; Simeon S,0,6,20,20
1683332972953,HIUS 117,A00,185836,Kwak; Nancy,2,0,20,18
1683332973974,HIUS 125,A00,185840,Man; Simeon S,0,0,23,23
1683332975001,HIUS 149,A00,185845,Staff,0,0,20,20
1683332976032,HUM 3,A01,185882,Zavodny; Tatiana Sophia,0,7,50,50
1683332976032,HUM 3,B01,185899,Caldwell; Michael Alan,0,18,50,50
1683332977057,HUM 3GS,A00,185900,Patterson; Patrick H.,0,0,0,23
1683332978087,HUM 4,A01,185938,Zroka; Amy Liane,31,0,50,19
1683332978087,HUM 4,B01,185956,Watkins; Eric,0,2,50,50
1683332978087,HUM 4,B02,202209,Watkins; Eric,0,2,50,50
1683332978087,HUM 4,B03,202210,Watkins; Eric,0,2,50,50
1683332979114,HUM 5,A01,185958,West; Geoffrey Scott,3,0,50,47
1683332979114,HUM 5,A02,202215,West; Geoffrey Scott,0,0,50,50
1683332980138,INTL 190,A00,185959,Gagnon; Jeffrey C,0,0,0,9
1683332980138,INTL 190,B00,185960,Lettieri; Michael Joseph,0,0,0,1
1683332981166,JAPN 180,A00,254509,Staff,5,1,30,25
1683332982191,LATI 10,A01,202853,Kennemore; Amy Michelle,4,0,35,31
1683332982191,LATI 10,A02,202854,Kennemore; Amy Michelle,2,0,35,33
1683332982191,LATI 10,A03,270054,Kennemore; Amy Michelle,30,0,30,0
1683332983214,LATI 180,A00,202855,Kennemore; Amy Michelle,11,0,20,9
1683332984242,LAWS 101,A00,201767,Golan; Tal,0,7,40,40
1683332985268,LIFR 1C,A00,185961,Staff,6,0,20,14
1683332986293,LIFR 1CX,A00,185962,Staff,7,0,20,13
1683332987321,LIFR 1D,A00,185963,Staff,9,0,20,11
1683332988400,LIFR 1DX,A00,185964,Staff,9,0,20,11
1683332989428,LIGN 101,A01,186039,Staff,43,0,50,7
1683332990453,LIGN 165,A00,186040,Staff,18,0,50,32
1683332991477,LTCS 108,A00,186041,Staff,6,0,10,4
1683332992501,LTCS 119,A00,186042,Staff,16,0,20,4
1683332993528,LTCS 130,A00,186043,Wesling; Megan E.,15,0,25,10
1683332995579,LTEA 138,A00,186119,Staff,14,0,40,26
1683332996603,LTEN 124,A00,186148,Staff,6,0,25,19
1683332997629,LTEN 178,A00,186149,Staff,7,0,15,8
1683332998654,LTEN 181,A00,186150,Blanco; John D,33,0,40,7
1683332999678,LTWL 120,A00,186160,Staff,20,0,25,5
1683333000702,LTWL 165,A00,186161,Staff,22,0,25,3
1683333001725,LTWR 100,A00,186162,Staff,0,5,15,15
1683333002753,LTWR 102,A00,186163,Doller; Ben,5,0,15,10
1683333003779,MAE 8,A01,186412,Staff,0,0,0,0
1683333004804,MAE 30B,A00,186445,Bahadori; Mohammad Yousef,83,0,100,17
1683333005831,MAE 40,A00,186592,Bewley; Thomas R,9,0,50,41
1683333006861,MAE 101B,A00,186593,Bahadori; Mohammad Yousef,81,0,100,19
1683333007888,MAE 105,A00,186594,Bandaru; Prabhakar,12,0,50,38
1683333008923,MAE 107,A00,186599,Pham; Hieu Tan,0,6,120,120
1683333009948,MAE 148,A01,186660,Silberman; Jack,3,0,16,13
1683333010972,MATH 10A,A01,188095,Staff,1,6,35,34
1683333012002,MATH 10B,A01,188097,Bowers; Adam R.,0,11,30,30
1683333012002,MATH 10B,A02,188099,Bowers; Adam R.,0,11,30,30
1683333012002,MATH 10B,B01,188104,Bowers; Adam R.,0,10,30,30
1683333012002,MATH 10B,B02,188106,Bowers; Adam R.,0,10,30,30
1683333013028,MATH 10C,A01,188111,Staff,0,18,30,30
1683333013028,MATH 10C,A02,188127,Staff,0,17,30,30
1683333013028,MATH 10C,A03,188131,Staff,0,18,30,30
1683333013028,MATH 10C,B01,188218,Staff,18,0,30,12
1683333013028,MATH 10C,B02,188244,Staff,13,0,30,17
1683333013028,MATH 10C,B03,188277,Staff,16,0,30,14
1683333014052,MATH 18,A01,188344,Bach; Quang Tran,18,0,30,12
1683333014052,MATH 18,A02,188345,Bach; Quang Tran,11,0,30,19
1683333014052,MATH 18,B01,188353,Bach; Quang Tran,10,0,30,20
1683333014052,MATH 18,B02,188354,Bach; Quang Tran,20,0,30,10
1683333015078,MATH 20A,A01,188374,Staff,13,0,35,22
1683333016105,MATH 20B,A01,188382,Ohm; Ko Woon,6,0,30,24
1683333016105,MATH 20B,A02,188383,Ohm; Ko Woon,22,0,30,8
1683333016105,MATH 20B,B01,188385,Ohm; Ko Woon,7,0,30,23
1683333016105,MATH 20B,B02,188392,Ohm; Ko Woon,22,0,30,8
1683333017139,MATH 20C,A01,188394,Harel; Guershon,10,0,30,20
1683333017139,MATH 20C,A02,188395,Harel; Guershon,15,0,30,15
1683333017139,MATH 20C,B01,188404,Harel; Guershon,5,0,30,25
1683333017139,MATH 20C,B02,188405,Harel; Guershon,19,0,30,11
1683333018164,MATH 20D,A01,188414,Hammock; Frances H,0,1,30,30
1683333018164,MATH 20D,A02,188415,Hammock; Frances H,3,0,30,27
1683333018164,MATH 20D,B01,188447,Hammock; Frances H,1,0,30,29
1683333018164,MATH 20D,B02,188486,Hammock; Frances H,8,0,30,22
1683333019188,MATH 20E,A01,188649,Staff,21,0,30,9
1683333019188,MATH 20E,A02,188650,Staff,23,0,30,7
1683333019188,MATH 20E,A03,188673,Staff,0,0,30,30
1683333020216,MATH 102,A01,188675,Staff,0,35,35,35
1683333021240,MATH 103B,A01,188681,Staff,3,0,35,32
1683333021240,MATH 103B,B01,188692,Staff,5,0,35,30
1683333022267,MATH 109,A01,188695,Salehi Golsefidy; Alireza,25,0,35,10
1683333022267,MATH 109,A02,188696,Salehi Golsefidy; Alireza,25,0,35,10
1683333023292,MATH 120A,A01,188698,Eggers; John Dietrich,7,0,35,28
1683333024319,MATH 142B,A01,188736,Ioana; Adrian,0,2,30,30
1683333024319,MATH 142B,A02,188741,Ioana; Adrian,1,1,30,29
1683333024319,MATH 142B,A03,188743,Ioana; Adrian,1,3,30,29
1683333025344,MATH 168A,A01,188790,Staff,0,9,35,35
1683333026372,MATH 170A,A01,188803,Nie; Jiawang,0,2,35,35
1683333026372,MATH 170A,A02,188811,Nie; Jiawang,0,0,35,35
1683333026372,MATH 170A,A03,188814,Nie; Jiawang,1,0,35,34
1683333026372,MATH 170A,A04,188815,Nie; Jiawang,13,0,35,22
1683333027400,MATH 193B,A01,188817,Staff,0,0,35,35
1683333027400,MATH 193B,A02,188818,Staff,5,0,35,30
1683333028427,MGT 4,A01,202857,Anderson; John Charles,62,0,80,18
1683333029450,MGT 12,A00,202858,Lindenberger; Wade Douglas,42,0,90,48
1683333030474,MGT 18,A00,202859,Staff,74,0,90,16
1683333031503,MGT 18GS,A00,202860,McKay; Michael J,13,0,28,15
1683333032530,MGT 45,A00,202861,Pecore; Joseph P.,14,0,90,76
1683333033557,MGT 100,A00,202863,Yavorsky; Daniel Ryan,28,0,90,62
1683333034581,MGT 103,A00,202864,Ehrich; Kristine R,1,18,90,89
1683333035609,MGT 112,A00,202865,Ehrich; Kristine R,15,0,90,75
1683333036632,MGT 121A,A00,202868,Staff,0,20,0,0
1683333037656,MGT 131B,A00,202869,Anderson; John Charles,59,0,90,31
1683333038681,MGT 136,A00,202871,Lindenberger; Wade Douglas,84,0,90,6
1683333039705,MGT 164,A00,202873,Staff,0,68,90,91
1683333040729,MGT 164GS,A00,202874,McKay; Mary A,13,0,28,15
1683333041754,MGT 180,A00,202875,Staff,0,50,90,91
1683333042778,MMW 11R,A01,205019,Herbst; Matthew,3,0,30,27
1683333042778,MMW 11R,A02,205026,Herbst; Matthew,29,0,30,1
1683333043808,MMW 15,A01,193512,Chang; Edmond Yi-Teh,0,9,28,28
1683333043808,MMW 15,A02,193513,Chang; Edmond Yi-Teh,0,5,28,28
1683333043808,MMW 15,A03,193514,Chang; Edmond Yi-Teh,0,5,28,28
1683333043808,MMW 15,A04,193515,Chang; Edmond Yi-Teh,0,5,28,28
1683333043808,MMW 15,A05,193516,Chang; Edmond Yi-Teh,0,4,28,28
1683333043808,MMW 15,A06,193517,Chang; Edmond Yi-Teh,0,5,28,28
1683333043808,MMW 15,B01,193519,Chang; Edmond Yi-Teh,0,5,28,28
1683333043808,MMW 15,B02,193520,Chang; Edmond Yi-Teh,0,5,28,28
1683333043808,MMW 15,B03,193521,Chang; Edmond Yi-Teh,0,5,28,28
1683333043808,MMW 15,B04,193522,Chang; Edmond Yi-Teh,0,4,28,28
1683333043808,MMW 15,B05,193523,Chang; Edmond Yi-Teh,0,5,28,28
1683333043808,MMW 15,B06,193524,Chang; Edmond Yi-Teh,0,4,28,28
1683333044836,MMW 122,A01,193526,Rahimi; Babak,0,15,28,28
1683333044836,MMW 122,A02,193527,Rahimi; Babak,0,14,28,28
1683333044836,MMW 122,A03,193528,Rahimi; Babak,0,0,0,0
1683333044836,MMW 122,A04,193529,Rahimi; Babak,0,0,0,0
1683333045860,MUS 1A,A01,186663,Staff,0,20,35,35
1683333046887,MUS 4,A01,186715,Staff,0,12,35,35
1683333047911,MUS 5R,A01,186796,Dubnov; Shlomo,0,17,35,35
1683333048935,MUS 6,A01,186798,Staff,0,4,25,25
1683333049963,MUS 7,A01,186830,Staff,12,0,35,23
1683333050987,MUS 8,A01,186930,Staff,0,26,35,35
1683333052012,MUS 15,A01,186932,Staff,0,16,35,35
1683333052012,MUS 15,B01,186934,Staff,0,15,35,35
1683333053040,MUS 80,A00,186935,Staff,1,0,20,19
1683333053040,MUS 80,B00,186936,Staff,25,0,25,0
1683333054066,NANO 11,A00,204702,Lipomi; Darren John,0,0,0,0
1683333055094,NANO 15,A01,204709,Yang; Kesong,0,1,0,0
1683333056121,NANO 114,A00,202069,Jahed Motlagh; Zeinab,3,0,10,7
1683333057146,PHIL 1,A00,186955,Grush; Rick Scott,32,0,40,8
1683333058172,PHIL 10,A01,186973,Grush; Rick Scott,28,0,35,7
1683333058172,PHIL 10,A02,186974,Grush; Rick Scott,33,0,35,2
1683333059199,PHIL 13,A01,186976,Staff,7,0,35,28
1683333059199,PHIL 13,A02,186977,Staff,16,0,35,19
1683333060223,PHIL 14,A01,186979,Staff,31,0,35,4
1683333060223,PHIL 14,A02,186986,Staff,32,0,35,3
1683333061249,PHIL 28,A01,186988,Staff,16,0,30,14
1683333061249,PHIL 28,A02,186989,Staff,1,0,30,29
1683333061249,PHIL 28,A03,186990,Staff,9,0,30,21
1683333061249,PHIL 28,A04,186991,Staff,26,0,30,4
1683333062277,PHIL 120,A00,186997,Staff,23,0,40,17
1683333063306,PHIL 137,A00,187003,Staff,9,0,40,31
1683333064331,PHIL 150,A00,187015,Staff,47,0,70,23
1683333065357,PHIL 167,A00,187021,Lamey; Andy M.,35,0,40,5
1683333066381,PHIL 174,A01,202226,Staff,17,0,20,3
1683333066381,PHIL 174,A02,202235,Staff,20,0,20,0
1683333067407,PHIL 191A,A00,258918,Staff,0,0,1,1
1683333068431,PHYS 1A,A00,187028,Staff,27,0,60,33
1683333069456,PHYS 1AL,001,187036,Staff,3,0,30,27
1683333069456,PHYS 1AL,002,187049,Staff,18,0,30,12
1683333070480,PHYS 1B,A00,187058,Staff,22,0,60,38
1683333071507,PHYS 1BL,001,187064,Staff,0,0,30,30
1683333071507,PHYS 1BL,002,187070,Staff,5,0,30,25
1683333072535,PHYS 1C,A00,187082,Staff,31,0,120,89
1683333073560,PHYS 1CL,001,187088,Staff,0,9,30,30
1683333073560,PHYS 1CL,002,187089,Staff,0,2,30,30
1683333073560,PHYS 1CL,009,262693,Staff,11,0,30,19
1683333074586,PHYS 2B,A01,187097,Staff,54,0,115,61
1683333075616,PHYS 2C,A01,187099,Staff,67,0,115,48
1683333076640,PHYS 2CL,A01,187101,Staff,5,0,28,23
1683333076640,PHYS 2CL,A02,187102,Staff,15,0,28,13
1683333077663,PHYS 2D,A01,187123,Shotwell; Brian,95,0,115,20
1683333078688,PHYS 4B,A01,187133,Grinstein; Benjamin,35,0,50,15
1683333079713,POLI 10,A00,188819,Staff,0,4,50,50
1683333080739,POLI 11,A00,188827,Staff,43,0,50,7
1683333081763,POLI 13R,A00,188828,Staff,0,1,20,20
1683333082785,POLI 27,A01,188830,Elgin; Samuel Zincke,0,1,70,70
1683333083809,POLI 30,A00,188832,Desposato; Scott,31,0,50,19
1683333084833,POLI 102F,A00,188834,Staff,3,0,40,37
1683333085859,POLI 104A,A00,188852,Staff,14,0,30,16
1683333086887,POLI 104I,A00,188853,Staff,0,6,20,20
1683333087922,POLI 110B,A00,188854,Wiens; David,7,0,20,13
1683333088949,POLI 112A,A00,188855,Wiens; David,5,0,30,25
1683333089976,POLI 117R,A00,188856,Forman; Fonna,0,11,20,20
1683333091001,POLI 118,A00,188857,Ingham; Sean,8,0,20,12
1683333092104,POLI 120G,A00,188858,Staff,9,0,30,21
1683333093127,POLI 131CR,A00,188863,Hoston; Germaine,24,0,50,26
1683333094150,POLI 133,A00,188864,Nellis; Gareth Hb,44,0,50,6
1683333095177,POLI 134D,A00,188865,Desposato; Scott,27,0,30,3
1683333096201,POLI 142A,A00,188871,Gartzke; Erik,22,0,50,28
1683333097224,POLI 142K,A00,188874,Staff,38,0,50,12
1683333098251,POLI 143,A00,188940,Gartzke; Erik,16,0,30,14
1683333099277,POLI 153,A00,188943,Staff,3,0,20,17
1683333100303,POLI 160AA,A00,188944,Staff,12,0,40,28
1683333101327,POLI 170A,A00,188945,Staff,11,0,30,19
1683333103378,PSYC 1,A00,188952,Staff,37,0,90,53
1683333104404,PSYC 2,B00,188953,Staff,19,0,35,16
1683333105428,PSYC 6,A00,188970,Staff,47,0,60,13
1683333106456,PSYC 7,A00,188973,Staff,37,0,45,8
1683333107480,PSYC 60,A01,188980,Rickard; Timothy C.,43,0,60,17
1683333108504,PSYC 70,A01,189001,Steiner; Eric Tomas,24,0,45,21
1683333109533,PSYC 100,A00,189005,Lacefield; Katharine I,0,100,120,120
1683333110559,PSYC 102,A00,189008,Staff,9,0,30,21
1683333111587,PSYC 106,B00,189026,Gorman; Michael R.,34,0,60,26
1683333112611,PSYC 114,B01,189033,Winkielman; Piotr,0,32,30,30
1683333113638,PSYC 131,A00,189036,Anagnostaras; Stephan,0,43,60,60
1683333114661,PSYC 136,A00,189041,Lowe; Angela Beth,0,7,25,25
1683333115685,PSYC 137,A00,189057,Winkielman; Piotr,0,34,25,25
1683333116713,PSYC 144,A00,189107,Wixted; John T,0,7,50,50
1683333118763,PSYC 162,A00,189142,Staff,0,8,85,85
1683333119787,PSYC 172,A00,189144,Gorman; Michael R.,0,7,30,30
1683333121840,PSYC 179,A00,189146,Lacefield; Katharine I,0,84,120,120
1683333122864,PSYC 181,A00,189147,Anagnostaras; Stephan,0,44,90,90
1683333123888,PSYC 190R,A00,189148,Barner; David A.,0,22,80,80
1683333124913,PSYC 191,A00,189275,Rickard; Timothy C.,0,7,25,25
1683333125940,PSYC 193,A00,189276,Chapman; Eddie Nathaniel,0,1,0,4
1683333126965,PSYC 193L,A01,189281,Lowe; Angela Beth,12,0,20,8
1683333126965,PSYC 193L,B01,189285,Staff,28,0,35,7
1683333127989,RELI 149,A00,187137,Rahimi; Babak,7,0,40,33
1683333129016,SE 9,A01,187315,Staff,0,2,18,18
1683333130044,SE 101B,A00,187409,Staff,24,0,30,6
1683333131069,SE 110B,A00,187444,Staff,10,0,40,30
1683333132092,SE 130B,A00,187449,Staff,31,0,40,9
1683333133119,SE 150A,A00,187516,Staff,9,0,20,11
1683333134144,SE 154,A00,187528,Staff,30,0,50,20
1683333135173,SIO 3,A01,258171,Staff,35,0,40,5
1683333136194,SIO 10,A00,187144,Cook; Geoffrey W,0,3,75,75
1683333137218,SIO 45,A00,187152,Cook; Geoffrey W,1,0,100,99
1683333138243,SIO 109R,A00,194486,Staff,0,3,20,20
1683333140294,SIO 187,A01,187233,Kacev; David,12,0,40,28
1683333141321,SOCI 1,A01,258656,Thorpe; Charles Robert,28,0,30,2
1683333141321,SOCI 1,A02,258658,Thorpe; Charles Robert,30,0,30,0
1683333141321,SOCI 1,A03,258661,Thorpe; Charles Robert,25,0,25,0
1683333141321,SOCI 1,A04,258666,Thorpe; Charles Robert,22,0,25,3
1683333141321,SOCI 1,A05,258897,Thorpe; Charles Robert,23,0,25,2
1683333141321,SOCI 1,A06,258898,Thorpe; Charles Robert,25,0,25,0
1683333142345,SOCI 30,A01,258903,Pardo Guerra; Juan Pablo,15,0,30,15
1683333143372,SOCI 102,A00,258904,Staff,9,0,25,16
1683333144396,SOCI 106,A00,258905,Staff,19,0,25,6
1683333145422,SOCI 111,A00,258907,Ribas Norris; Janet Vanesa,26,0,30,4
1683333146451,SOCI 121R,A00,258908,Pardo Guerra; Juan Pablo,10,0,30,20
1683333147475,SOCI 126,A01,203330,Staff,14,0,20,6
1683333148499,SOCI 131,A00,258909,Thorpe; Charles Robert,31,0,60,29
1683333149526,SOCI 135,A00,258910,Payne; Christine Anna,0,9,30,30
1683333150553,SOCI 157,A00,258911,Staff,12,0,30,18
1683333151578,SOCI 184,A00,258912,Staff,25,0,30,5
1683333152602,SOCI 188D,A00,258913,Staff,21,0,30,9
1683333153629,SYN 2,001,187529,Staff,10,0,16,6
1683333153629,SYN 2,002,201452,Staff,0,18,16,16
1683333153629,SYN 2,003,201469,Staff,3,0,16,13
1683333154657,SYN 100,A01,187531,Staff,0,9,20,20
1683333154657,SYN 100,B01,201491,Staff,0,12,20,20
1683333155683,TDAC 1,A00,189286,Walsh; Kim C.,3,0,20,17
1683333155683,TDAC 1,B00,189287,Harting; Carla Kelso,11,0,20,9
1683333156710,TDAC 101,A00,189300,Walsh; Kim C.,16,0,20,4
1683333156710,TDAC 101,B00,189301,Harting; Carla Kelso,18,0,20,2
1683333157734,TDAC 102,A00,189304,Basso; Beatrice,14,0,20,6
1683333158759,TDAC 108,A00,189305,Staff,18,0,20,2
1683333159784,TDDE 131,A00,189310,Staff,19,0,20,1
1683333159784,TDDE 131,B00,189314,Staff,19,0,20,1
1683333159784,TDDE 131,C00,189315,Staff,48,0,50,2
1683333159784,TDDE 131,D00,189316,Staff,14,0,15,1
1683333159784,TDDE 131,E00,204841,Staff,20,0,20,0
1683333160808,TDGE 10,A00,189289,Staff,30,0,50,20
1683333160808,TDGE 10,B00,189290,Havis; Allan,1,0,50,49
1683333161833,TDGE 11,A00,189291,Fulton; Julia,0,3,50,50
1683333161833,TDGE 11,B00,189292,Staff,20,0,25,5
1683333161833,TDGE 11,C00,260270,Staff,0,0,0,0
1683333162861,TDGE 25,A00,189294,Staff,3,0,20,17
1683333163886,TDGE 124,A00,189318,Fulton; Julia,0,8,50,50
1683333164914,TDGE 125,A00,189319,Staff,13,0,25,12
1683333164914,TDGE 125,B00,189320,Staff,23,0,25,2
1683333165942,TDGE 127,A00,189322,Havis; Allan,0,0,50,50
1683333166968,TDHT 101,A00,189323,Staff,18,0,25,7
1683333166968,TDHT 101,B00,189324,Staff,25,0,25,0
1683333167996,TDHT 102,A00,189325,Staff,49,0,50,1
1683333169021,TDMV 1,A00,189295,Arcidiacono; Kristin,19,0,30,11
1683333169021,TDMV 1,B00,189296,Caligagan; Maria T.,24,0,30,6
1683333170050,TDMV 2,A00,189297,Sammartano; Tonnie,28,0,30,2
1683333170050,TDMV 2,B00,189299,Arcidiacono; Kristin,24,0,30,6
1683333171074,TDMV 3,A00,204998,Rincon; Alicia,22,0,30,8
1683333172102,TDMV 120,A00,189458,Sammartano; Tonnie,28,0,30,2
1683333173127,TDMV 138,A00,189541,Jun; Grace Shin Hae,22,0,40,18
1683333174154,TDMV 142,A00,189717,Caligagan; Tony,23,0,30,7
1683333174154,TDMV 142,B00,189718,Caligagan; Maria T.,25,0,30,5
1683333175178,TMC 2,A01,187533,Staff,25,0,25,0
1683333175178,TMC 2,A02,187534,Staff,25,0,25,0
1683333176206,USP 1,A01,187536,Kwak; Nancy,0,16,25,25
1683333177230,USP 5,A01,187538,Staff,10,0,25,15
1683333178255,USP 101,A00,199253,Staff,0,4,0,0
1683333179283,USP 124,A00,187562,Boomhower; Matthew Charles,1,0,30,29
1683333180307,USP 138,A00,187582,Staff,20,0,25,5
1683333181333,USP 152,A01,187597,Staff,4,0,25,21
1683333182362,USP 153,A00,187598,Staff,19,0,25,6
1683333183390,USP 168,A00,187607,Kwak; Nancy,2,0,5,3
1683333184415,USP 173,A00,187619,Staff,4,0,25,21
1683333185440,USP 181,A00,187638,Staff,0,0,25,25
1683333186464,VIS 103,A00,187650,Cruz; Edwin Teddy,23,0,75,52
1683333187490,VIS 110D,A00,187669,Staff,12,0,22,10
1683333188514,VIS 127C,A00,187720,Shen; Kuiyi,67,0,146,79
1683333189538,VIS 149,A00,187731,Yoldas; Pinar,0,14,22,22
1683333190566,VIS 151,A01,188091,Staff,22,0,34,12
1683333190566,VIS 151,A02,188092,Staff,11,0,34,23
1683333191590,VIS 160B,A00,188093,Stalbaum; Brett,0,0,10,10
1683333193643,WCWP 10B,A00,201720,Staff,10,0,15,5
1683333193643,WCWP 10B,B00,201722,Staff,8,0,15,7
1683333194671,WCWP 100,A00,201725,Gagnon; Jeffrey C,0,0,2,2
1683333194671,WCWP 100,B00,201727,Staff,0,4,15,15
1683333197822,ANBI 133,A00,258401,Wilder; Linnea Lorene,34,0,40,6
1683333198847,ANBI 140,A00,258395,Hrvoj Mihic; Branka,18,0,25,7
1683333199871,ANSC 120,A00,258402,Bialecki; Jon Anthony,27,0,40,13
1683333200895,ANSC 144,A00,258400,Staff,14,0,40,26
1683333202944,ANSC 166,A00,258396,Parish; Steven Martin,157,0,175,18
1683333203968,ANSC 180,A00,193533,Staff,9,0,20,11
1683333204993,ANSC 188,A00,258397,Jassal; Aftab,33,0,40,7
1683333206018,ANTH 3,A01,258316,Staff,23,0,30,7
1683333207046,ANTH 5,A00,258394,Semendeferi; Ekaterini,16,0,20,4
1683333208074,ANTH 21,A01,258331,Staff,8,0,40,32
1683333209103,ANTH 103,A00,258398,Varma; Saiba,15,0,25,10
1683333210131,AWP 10,001,202034,Staff,0,0,0,0
1683333210131,AWP 10,002,202035,Staff,0,0,0,0
1683333210131,AWP 10,003,202036,Staff,0,0,0,0
1683333210131,AWP 10,004,202037,Staff,0,0,0,0
1683333210131,AWP 10,005,202038,Staff,0,0,0,0
1683333210131,AWP 10,006,202039,Staff,0,0,0,0
1683333210131,AWP 10,007,202040,Staff,0,0,0,0
1683333210131,AWP 10,008,202041,Staff,0,0,0,0
1683333210131,AWP 10,009,202042,Staff,0,0,0,0
1683333210131,AWP 10,010,202043,Staff,0,0,0,0
1683333210131,AWP 10,011,202044,Staff,0,0,0,0
1683333210131,AWP 10,012,202045,Staff,0,0,0,0
1683333210131,AWP 10,013,202046,Staff,0,0,0,0
1683333210131,AWP 10,014,202047,Staff,0,0,0,0
1683333210131,AWP 10,015,202048,Staff,0,0,0,0
1683333210131,AWP 10,016,202049,Staff,0,0,0,0
1683333210131,AWP 10,017,202050,Staff,0,0,0,0
1683333210131,AWP 10,018,202051,Staff,0,0,0,0
1683333210131,AWP 10,019,202052,Staff,0,0,0,0
1683333210131,AWP 10,020,202053,Staff,0,0,0,0
1683333210131,AWP 10,021,202054,Staff,0,0,0,0
1683333210131,AWP 10,022,202055,Staff,0,0,0,0
1683333210131,AWP 10,023,202056,Staff,0,0,0,0
1683333210131,AWP 10,024,202057,Staff,0,0,0,0
1683333210131,AWP 10,025,202058,Staff,0,0,0,0
1683333210131,AWP 10,026,202059,Staff,0,0,0,0
1683333211154,AWP 102,001,202032,Staff,0,0,0,0
1683333211154,AWP 102,002,202033,Staff,0,0,0,0
1683333212178,BENG 100,A01,254234,Taylor Amos; Alyssa C,31,0,40,9
1683333213203,BENG 196,001,270013,Engler; Adam J.,9999,0,9999,0
1683333214226,BICD 100R,A01,202018,Smith; Laurie,0,7,32,32
1683333214226,BICD 100R,A02,202019,Smith; Laurie,0,2,32,32
1683333214226,BICD 100R,A03,202020,Smith; Laurie,0,1,32,32
1683333214226,BICD 100R,A04,202021,Smith; Laurie,9,0,32,23
1683333214226,BICD 100R,A05,202022,Smith; Laurie,12,0,32,20
1683333215250,BICD 136,A01,193242,Gustafson-Brown; Cindy,0,2,32,32
1683333215250,BICD 136,A02,193244,Gustafson-Brown; Cindy,14,0,32,18
1683333216279,BIEB 102,A01,193249,Butler; Shannon Rhey,0,2,32,32
1683333216279,BIEB 102,A02,193251,Butler; Shannon Rhey,0,0,32,32
1683333216279,BIEB 102,A03,193253,Butler; Shannon Rhey,0,1,32,32
1683333216279,BIEB 102,A04,193255,Butler; Shannon Rhey,17,0,32,15
1683333216279,BIEB 102,A05,193265,Butler; Shannon Rhey,26,0,32,6
1683333216279,BIEB 102,A06,193269,Butler; Shannon Rhey,16,0,32,16
1683333218327,BIEB 150,A01,193274,Staff,0,0,32,32
1683333218327,BIEB 150,A02,193285,Staff,23,0,32,9
1683333219355,BIEB 194,A00,193286,Kurle; Carolyn M.,22,0,32,10
1683333220380,BILD 1,A01,192291,Staff,16,0,32,16
1683333220380,BILD 1,A02,192292,Staff,30,0,32,2
1683333220380,BILD 1,B01,192520,Reuther; Keefe,0,1,0,0
1683333220380,BILD 1,B02,192532,Reuther; Keefe,0,1,0,0
1683333221407,BILD 3,A01,192556,Butler; Shannon Rhey,0,0,32,32
1683333221407,BILD 3,A02,192581,Butler; Shannon Rhey,5,0,32,27
1683333221407,BILD 3,A03,192611,Butler; Shannon Rhey,23,0,32,9
1683333221407,BILD 3,A04,192612,Butler; Shannon Rhey,25,0,32,7
1683333221407,BILD 3,A05,192613,Butler; Shannon Rhey,27,0,32,5
1683333221407,BILD 3,A06,192679,Butler; Shannon Rhey,27,0,32,5
1683333221407,BILD 3,A07,192682,Butler; Shannon Rhey,22,0,32,10
1683333222431,BILD 4,A01,192836,Reuther; Keefe,0,0,24,24
1683333222431,BILD 4,A02,193044,Reuther; Keefe,4,0,24,20
1683333223454,BILD 10,A01,193142,Gustafson-Brown; Cindy,30,0,32,2
1683333223454,BILD 10,A02,193149,Gustafson-Brown; Cindy,31,0,32,1
1683333224479,BIMM 100,A01,193301,Staff,0,6,32,32
1683333224479,BIMM 100,A02,193312,Staff,0,5,32,32
1683333224479,BIMM 100,A03,193323,Staff,0,8,32,32
1683333225504,BIMM 101,A01,193329,McDonnell; Lisa Marie,0,3,24,24
1683333225504,BIMM 101,A02,193339,McDonnell; Lisa Marie,0,3,24,24
1683333225504,BIMM 101,B01,193354,McDonnell; Lisa Marie,0,3,24,24
1683333225504,BIMM 101,B02,193357,McDonnell; Lisa Marie,0,3,24,24
1683333226532,BIMM 110,A01,193377,Tat; John,0,11,32,32
1683333226532,BIMM 110,A02,193378,Tat; John,1,9,32,31
1683333227557,BIMM 120,A01,206116,Staff,0,0,32,32
1683333227557,BIMM 120,A02,206117,Staff,8,0,32,24
1683333227557,BIMM 120,A03,206121,Staff,21,0,32,11
1683333228583,BIPN 100,A01,193393,Park; Ji Young,0,14,32,32
1683333228583,BIPN 100,A02,193402,Park; Ji Young,0,13,32,32
1683333228583,BIPN 100,A03,193413,Park; Ji Young,0,14,32,32
1683333228583,BIPN 100,A04,193414,Park; Ji Young,0,13,32,32
1683333229612,BIPN 102,A01,193429,Staff,0,0,32,32
1683333229612,BIPN 102,A02,193438,Staff,22,0,32,10
1683333230638,BIPN 106,A01,193450,Reyes Gonzalez; Catalina,0,2,40,40
1683333231663,BIPN 134,A01,193465,Cooke; James Edward,0,0,32,32
1683333231663,BIPN 134,A02,193474,Cooke; James Edward,25,0,32,7
1683333231663,BIPN 134,A03,193485,Cooke; James Edward,29,0,32,3
1683333231663,BIPN 134,A04,193486,Cooke; James Edward,21,0,32,11
1683333231663,BIPN 134,A05,193491,Cooke; James Edward,31,0,32,1
1683333231663,BIPN 134,A06,193501,Cooke; James Edward,30,0,32,2
1683333231663,BIPN 134,A07,193510,Cooke; James Edward,29,0,32,3
1683333233714,BISP 194,A00,222522,Staff,14,0,32,18
1683333234738,CAT 124,A01,202407,Staff,20,0,25,5
1683333235765,CAT 125,A00,202408,Marchisotto; Jennifer Anne,4,0,20,16
1683333236793,CAT 125R,A00,202409,Smith; Lauryn Alissa,0,11,20,20
1683333236793,CAT 125R,B00,202410,Morales; Celeste Georgianna,0,11,20,20
1683333236793,CAT 125R,C00,202411,Irwin; Matthew Joseph,0,10,20,20
1683333237820,CENG 15,A01,204712,Yang; Kesong,0,1,0,0
1683333238844,CENG 114,A00,202070,Jahed Motlagh; Zeinab,5,0,20,15
1683333239867,CGS 105,A00,185477,Wesling; Megan E.,24,0,40,16
1683333240892,CGS 106,A00,185494,Staff,13,0,22,9
1683333241917,CGS 108,A00,185495,Staff,14,0,20,6
1683333242944,CGS 114,A00,185496,Staff,13,0,18,5
1683333243967,CGS 119,A00,185501,Staff,15,0,20,5
1683333244995,CGS 120,A00,185511,Staff,13,0,20,7
1683333246025,CHEM 4,A01,184675,Bussey; Thomas J,96,0,100,4
1683333247050,CHEM 6A,A01,184677,Staff,34,0,60,26
1683333248076,CHEM 6B,A01,184679,Staff,65,0,100,35
1683333249102,CHEM 6C,A01,184681,Bussey; Thomas J,1,0,50,49
1683333249102,CHEM 6C,A02,184682,Bussey; Thomas J,34,0,50,16
1683333250131,CHEM 40A,A01,184684,Albizati; Kim F.,37,0,100,63
1683333251156,CHEM 40B,A01,184686,Albizati; Kim F.,0,20,100,100
1683333252184,CHEM 41B,A01,184690,Staff,52,0,100,48
1683333253210,COGS 3,A01,184715,Boyle; Mary E. T.,0,25,40,40
1683333254235,COGS 14B,A01,185172,Staff,0,15,38,38
1683333255260,COGS 18,A01,184736,Staff,17,0,80,63
1683333256287,COGS 100,A01,184932,Staff,0,5,73,73
1683333257313,COGS 101A,A01,184935,Staff,0,39,30,30
1683333258339,COGS 101B,A01,184944,Staff,0,2,30,30
1683333259363,COGS 101C,A01,184946,Staff,0,12,30,30
1683333260388,COGS 102A,A01,184951,Johnson; Christine M.,2,0,40,38
1683333261417,COGS 107B,A01,184953,Mooshagian; Eric Frederick,0,50,40,40
1683333262445,COGS 118B,A01,184959,Gupta; Anjum,0,48,40,40
1683333263472,COGS 153,A00,184961,Staff,0,15,30,30
1683333264497,COGS 177,A00,184962,Staff,0,20,30,30
1683333265521,COGS 187A,A01,184969,Boyle; Mary E. T.,0,17,40,40
1683333266547,COMM 10,A01,185174,Staff,0,5,25,25
1683333266547,COMM 10,A02,185189,Staff,0,5,25,25
1683333266547,COMM 10,A03,269821,Staff,0,0,0,0
1683333267569,COMM 100B,A01,185475,Staff,0,0,0,2
1683333267569,COMM 100B,A02,185476,Staff,14,0,25,11
1683333268594,COMM 100C,A01,185314,Staff,1,0,25,24
1683333268594,COMM 100C,A02,185327,Staff,19,0,25,6
1683333269622,COMM 110M,A00,185349,Staff,2,0,40,38
1683333270646,COMM 113T,A00,185352,Staff,24,0,40,16
1683333271670,COMM 114I,A00,185353,Staff,33,0,40,7
1683333272695,COMM 131,A00,185354,Staff,19,0,30,11
1683333273717,CSE 8A,A50,185358,Cao; Yingjun,0,46,10,10
1683333274745,CSE 8B,A01,185362,Staff,1,47,50,49
1683333275768,CSE 11,A01,185416,Cao; Yingjun,0,92,10,10
1683333276795,CSE 20,A01,185445,Briones; Jor-el Thomas Caparas,5,0,25,20
1683333277819,CSE 21,A01,185447,Staff,10,0,50,40
1683333278847,CSE 101,A01,185451,Staff,0,12,50,50
1683333278847,CSE 101,B01,185453,Jones; Miles E,0,11,50,50
1683333280906,CSE 141,A01,185458,Eldon; John,20,0,100,80
1683333281934,CSE 141L,A01,185461,Eldon; John,12,0,100,88
1683333282958,CSE 142,A01,185463,Staff,36,0,60,24
1683333282958,CSE 142,B01,201355,Staff,0,7,60,60
1683333283984,CSE 142L,A01,185470,Staff,36,0,60,24
1683333283984,CSE 142L,B01,201417,Staff,0,6,60,60
1683333285011,CSE 190,A00,201433,Staff,32,0,49,17
1683333286038,DOC 1,A01,259136,Strom; Megan C.,7,0,15,8
1683333286038,DOC 1,A02,259137,Strom; Megan C.,14,0,15,1
1683333286038,DOC 1,A03,259138,Strom; Megan C.,14,0,15,1
1683333286038,DOC 1,A04,259139,Strom; Megan C.,14,0,15,1
1683333287062,DOC 100D,A00,259140,Pass; Natalye Joann,16,0,25,9
1683333288086,DSGN 1,A01,184749,Rill; Bryan,0,25,30,30
1683333289109,DSGN 100,A01,185168,Staff,0,2,25,25
1683333290137,ECE 5,A01,185626,Morris; Karcher William,0,10,0,0
1683333291162,ECE 101,A01,185628,Staff,17,0,70,53
1683333292190,ECE 107,A01,185635,Baghdadchi; Saharnaz,0,0,20,20
1683333292190,ECE 107,A02,185638,Baghdadchi; Saharnaz,4,0,20,16
1683333293215,ECE 148,A01,185647,Silberman; Jack,0,0,16,16
1683333294241,ECON 1,A01,185537,Crane; Meredith Helen,54,0,70,16
1683333295268,ECON 3,A01,185549,Crane; Meredith Helen,33,0,70,37
1683333296292,ECON 4,A01,203354,Anderson; John Charles,0,4,10,10
1683333297318,ECON 100A,A01,185574,Staff,0,4,40,40
1683333298342,ECON 100B,A01,185576,Staff,10,22,50,40
1683333299443,ECON 100C,A01,185589,Newhouse; Herbert S,30,0,70,40
1683333300470,ECON 105,A00,185608,Vespa; Emanuel Ignacio,19,0,35,16
1683333301501,ECON 109,A01,185610,Shishkin; Denis,10,0,35,25
1683333302528,ECON 110A,A01,185612,Staff,11,0,40,29
1683333303553,ECON 120A,A01,185615,Staff,20,0,40,20
1683333304576,ECON 120C,A01,185617,Sun; Yixiao,0,20,70,70
1683333305602,ECON 144,A00,203346,Squires; Dale E,3,0,35,32
1683333306626,ECON 171,A01,203349,Newhouse; Herbert S,0,1,35,35
1683333307654,ECON 173A,A01,185621,Toda; Alexis Akira,21,0,35,14
1683333308680,EDS 25,A01,202413,Staff,0,1,0,0
1683333308680,EDS 25,A02,202414,Staff,0,1,0,0
1683333308680,EDS 25,A03,202415,Staff,0,0,0,0
1683333308680,EDS 25,A04,202416,Staff,0,1,0,0
1683333308680,EDS 25,A05,202439,Staff,0,0,0,0
1683333308680,EDS 25,A06,202440,Staff,0,0,0,0
1683333308680,EDS 25,B01,202631,Staff,0,0,0,0
1683333308680,EDS 25,B02,202632,Staff,0,0,0,0
1683333308680,EDS 25,B03,202639,Staff,0,0,0,0
1683333308680,EDS 25,B04,202640,Staff,0,0,0,0
1683333308680,EDS 25,B05,202643,Staff,0,0,0,0
1683333308680,EDS 25,B06,202644,Staff,0,0,0,0
1683333309704,EDS 38,A01,202659,Black; Alison Michelle,24,0,25,1
1683333310727,EDS 115,A00,202652,Staff,17,0,30,13
1683333311751,EDS 125,A00,202649,Staff,14,0,30,16
1683333312779,EDS 126,A01,203332,Staff,30,0,30,0
1683333313807,EDS 139,A00,202838,Staff,16,0,25,9
1683333314834,EDS 146,A01,202655,Staff,14,0,25,11
1683333315858,ENG 15,A00,185667,Staff,0,1,0,0
1683333315858,ENG 15,B00,185672,Staff,0,0,0,0
1683333315858,ENG 15,C00,185675,Staff,0,0,0,0
1683333315858,ENG 15,D00,185682,Staff,0,0,0,0
1683333315858,ENG 15,E00,185684,Staff,0,0,0,0
1683333316882,ETHN 103,A00,185710,Staff,0,3,35,35
1683333317905,ETHN 103A,A00,199228,Man; Simeon S,2,0,9,7
1683333318932,ETHN 109,A00,185711,Staff,18,0,35,17
1683333319958,ETHN 142,A00,185726,Staff,0,4,30,30
1683333320984,ETHN 163J,A00,199229,Man; Simeon S,5,0,8,3
1683333322011,ETHN 168,A00,185727,Staff,8,0,10,2
1683333323033,ETHN 182,A00,185728,Staff,1,0,35,34
1683333324058,ETHN 183,A00,185737,Staff,8,0,18,10
1683333325080,GLBH 111,A01,209361,Burgos; Jose L.,0,0,0,0
1683333327130,HIEU 104,A00,185792,Staff,16,0,20,4
1683333328155,HIEU 115,A00,185800,Staff,1,0,20,19
1683333329179,HIEU 128,A00,185801,Staff,0,7,20,20
1683333330203,HIEU 147,A00,185802,Staff,16,0,20,4
1683333331229,HIEU 154,A00,185823,Staff,12,0,20,8
1683333332253,HILA 102,A00,185826,Staff,13,0,20,7
1683333333281,HILD 2C,A01,185778,Staff,0,12,20,20
1683333334304,HILD 7B,A01,185780,Kwak; Nancy,0,15,32,32
1683333334304,HILD 7B,A02,185781,Kwak; Nancy,0,18,32,32
1683333335329,HILD 30,A01,185791,Staff,14,0,20,6
1683333336353,HISC 119,A00,185830,Golan; Tal,0,9,20,20
1683333337378,HITO 156GS,A00,185831,Patterson; Patrick H.,0,0,0,23
1683333338401,HIUS 103,A00,185832,Man; Simeon S,0,6,20,20
1683333339424,HIUS 117,A00,185836,Kwak; Nancy,2,0,20,18
1683333340451,HIUS 125,A00,185840,Man; Simeon S,0,0,23,23
1683333341475,HIUS 149,A00,185845,Staff,0,0,20,20
1683333342500,HUM 3,A01,185882,Zavodny; Tatiana Sophia,0,7,50,50
1683333342500,HUM 3,B01,185899,Caldwell; Michael Alan,0,18,50,50
1683333343524,HUM 3GS,A00,185900,Patterson; Patrick H.,0,0,0,23
1683333344548,HUM 4,A01,185938,Zroka; Amy Liane,31,0,50,19
1683333344548,HUM 4,B01,185956,Watkins; Eric,0,2,50,50
1683333344548,HUM 4,B02,202209,Watkins; Eric,0,2,50,50
1683333344548,HUM 4,B03,202210,Watkins; Eric,0,2,50,50
1683333345570,HUM 5,A01,185958,West; Geoffrey Scott,3,0,50,47
1683333345570,HUM 5,A02,202215,West; Geoffrey Scott,0,0,50,50
1683333346594,INTL 190,A00,185959,Gagnon; Jeffrey C,0,0,0,9
1683333346594,INTL 190,B00,185960,Lettieri; Michael Joseph,0,0,0,1
1683333347618,JAPN 180,A00,254509,Staff,5,1,30,25
1683333348647,LATI 10,A01,202853,Kennemore; Amy Michelle,4,0,35,31
1683333348647,LATI 10,A02,202854,Kennemore; Amy Michelle,2,0,35,33
1683333348647,LATI 10,A03,270054,Kennemore; Amy Michelle,30,0,30,0
1683333349673,LATI 180,A00,202855,Kennemore; Amy Michelle,11,0,20,9
1683333350700,LAWS 101,A00,201767,Golan; Tal,0,7,40,40
1683333351723,LIFR 1C,A00,185961,Staff,6,0,20,14
1683333352753,LIFR 1CX,A00,185962,Staff,7,0,20,13
1683333353776,LIFR 1D,A00,185963,Staff,9,0,20,11
1683333354799,LIFR 1DX,A00,185964,Staff,9,0,20,11
1683333355826,LIGN 101,A01,186039,Staff,43,0,50,7
1683333356851,LIGN 165,A00,186040,Staff,18,0,50,32
1683333357877,LTCS 108,A00,186041,Staff,6,0,10,4
1683333358901,LTCS 119,A00,186042,Staff,16,0,20,4
1683333359924,LTCS 130,A00,186043,Wesling; Megan E.,15,0,25,10
1683333361978,LTEA 138,A00,186119,Staff,14,0,40,26
1683333363005,LTEN 124,A00,186148,Staff,6,0,25,19
1683333364034,LTEN 178,A00,186149,Staff,7,0,15,8
1683333365057,LTEN 181,A00,186150,Blanco; John D,33,0,40,7
1683333366089,LTWL 120,A00,186160,Staff,20,0,25,5
1683333367114,LTWL 165,A00,186161,Staff,22,0,25,3
1683333368138,LTWR 100,A00,186162,Staff,0,5,15,15
1683333369163,LTWR 102,A00,186163,Doller; Ben,5,0,15,10
1683333370186,MAE 8,A01,186412,Staff,0,0,0,0
1683333371211,MAE 30B,A00,186445,Bahadori; Mohammad Yousef,83,0,100,17
1683333372236,MAE 40,A00,186592,Bewley; Thomas R,9,0,50,41
1683333373266,MAE 101B,A00,186593,Bahadori; Mohammad Yousef,81,0,100,19
1683333374294,MAE 105,A00,186594,Bandaru; Prabhakar,12,0,50,38
1683333375328,MAE 107,A00,186599,Pham; Hieu Tan,0,6,120,120
1683333376352,MAE 148,A01,186660,Silberman; Jack,3,0,16,13
1683333377379,MATH 10A,A01,188095,Staff,1,6,35,34
1683333378404,MATH 10B,A01,188097,Bowers; Adam R.,0,11,30,30
1683333378404,MATH 10B,A02,188099,Bowers; Adam R.,0,11,30,30
1683333378404,MATH 10B,B01,188104,Bowers; Adam R.,0,10,30,30
1683333378404,MATH 10B,B02,188106,Bowers; Adam R.,0,10,30,30
1683333379430,MATH 10C,A01,188111,Staff,0,18,30,30
1683333379430,MATH 10C,A02,188127,Staff,0,17,30,30
1683333379430,MATH 10C,A03,188131,Staff,0,18,30,30
1683333379430,MATH 10C,B01,188218,Staff,18,0,30,12
1683333379430,MATH 10C,B02,188244,Staff,13,0,30,17
1683333379430,MATH 10C,B03,188277,Staff,16,0,30,14
1683333380459,MATH 18,A01,188344,Bach; Quang Tran,18,0,30,12
1683333380459,MATH 18,A02,188345,Bach; Quang Tran,11,0,30,19
1683333380459,MATH 18,B01,188353,Bach; Quang Tran,10,0,30,20
1683333380459,MATH 18,B02,188354,Bach; Quang Tran,20,0,30,10
1683333381483,MATH 20A,A01,188374,Staff,13,0,35,22
1683333382508,MATH 20B,A01,188382,Ohm; Ko Woon,6,0,30,24
1683333382508,MATH 20B,A02,188383,Ohm; Ko Woon,22,0,30,8
1683333382508,MATH 20B,B01,188385,Ohm; Ko Woon,7,0,30,23
1683333382508,MATH 20B,B02,188392,Ohm; Ko Woon,22,0,30,8
1683333383533,MATH 20C,A01,188394,Harel; Guershon,10,0,30,20
1683333383533,MATH 20C,A02,188395,Harel; Guershon,15,0,30,15
1683333383533,MATH 20C,B01,188404,Harel; Guershon,5,0,30,25
1683333383533,MATH 20C,B02,188405,Harel; Guershon,19,0,30,11
1683333384558,MATH 20D,A01,188414,Hammock; Frances H,0,1,30,30
1683333384558,MATH 20D,A02,188415,Hammock; Frances H,3,0,30,27
1683333384558,MATH 20D,B01,188447,Hammock; Frances H,1,0,30,29
1683333384558,MATH 20D,B02,188486,Hammock; Frances H,8,0,30,22
1683333385582,MATH 20E,A01,188649,Staff,21,0,30,9
1683333385582,MATH 20E,A02,188650,Staff,23,0,30,7
1683333385582,MATH 20E,A03,188673,Staff,0,0,30,30
1683333386605,MATH 102,A01,188675,Staff,0,35,35,35
1683333387633,MATH 103B,A01,188681,Staff,3,0,35,32
1683333387633,MATH 103B,B01,188692,Staff,5,0,35,30
1683333388657,MATH 109,A01,188695,Salehi Golsefidy; Alireza,25,0,35,10
1683333388657,MATH 109,A02,188696,Salehi Golsefidy; Alireza,25,0,35,10
1683333389685,MATH 120A,A01,188698,Eggers; John Dietrich,7,0,35,28
1683333390709,MATH 142B,A01,188736,Ioana; Adrian,0,2,30,30
1683333390709,MATH 142B,A02,188741,Ioana; Adrian,1,1,30,29
1683333390709,MATH 142B,A03,188743,Ioana; Adrian,1,3,30,29
1683333391734,MATH 168A,A01,188790,Staff,0,9,35,35
1683333392762,MATH 170A,A01,188803,Nie; Jiawang,0,2,35,35
1683333392762,MATH 170A,A02,188811,Nie; Jiawang,0,0,35,35
1683333392762,MATH 170A,A03,188814,Nie; Jiawang,1,0,35,34
1683333392762,MATH 170A,A04,188815,Nie; Jiawang,13,0,35,22
1683333393789,MATH 193B,A01,188817,Staff,0,0,35,35
1683333393789,MATH 193B,A02,188818,Staff,5,0,35,30
1683333394817,MGT 4,A01,202857,Anderson; John Charles,62,0,80,18
1683333395841,MGT 12,A00,202858,Lindenberger; Wade Douglas,42,0,90,48
1683333396865,MGT 18,A00,202859,Staff,74,0,90,16
1683333397888,MGT 18GS,A00,202860,McKay; Michael J,13,0,28,15
1683333398912,MGT 45,A00,202861,Pecore; Joseph P.,14,0,90,76
1683333399936,MGT 100,A00,202863,Yavorsky; Daniel Ryan,28,0,90,62
1683333400962,MGT 103,A00,202864,Ehrich; Kristine R,1,18,90,89
1683333401986,MGT 112,A00,202865,Ehrich; Kristine R,15,0,90,75
1683333403070,MGT 121A,A00,202868,Staff,0,20,0,0
1683333404097,MGT 131B,A00,202869,Anderson; John Charles,59,0,90,31
1683333405124,MGT 136,A00,202871,Lindenberger; Wade Douglas,84,0,90,6
1683333406149,MGT 164,A00,202873,Staff,0,68,90,91
1683333407173,MGT 164GS,A00,202874,McKay; Mary A,13,0,28,15
1683333408198,MGT 180,A00,202875,Staff,0,50,90,91
1683333409225,MMW 11R,A01,205019,Herbst; Matthew,3,0,30,27
1683333409225,MMW 11R,A02,205026,Herbst; Matthew,29,0,30,1
1683333410255,MMW 15,A01,193512,Chang; Edmond Yi-Teh,0,9,28,28
1683333410255,MMW 15,A02,193513,Chang; Edmond Yi-Teh,0,5,28,28
1683333410255,MMW 15,A03,193514,Chang; Edmond Yi-Teh,0,5,28,28
1683333410255,MMW 15,A04,193515,Chang; Edmond Yi-Teh,0,5,28,28
1683333410255,MMW 15,A05,193516,Chang; Edmond Yi-Teh,0,4,28,28
1683333410255,MMW 15,A06,193517,Chang; Edmond Yi-Teh,0,5,28,28
1683333410255,MMW 15,B01,193519,Chang; Edmond Yi-Teh,0,5,28,28
1683333410255,MMW 15,B02,193520,Chang; Edmond Yi-Teh,0,5,28,28
1683333410255,MMW 15,B03,193521,Chang; Edmond Yi-Teh,0,5,28,28
1683333410255,MMW 15,B04,193522,Chang; Edmond Yi-Teh,0,4,28,28
1683333410255,MMW 15,B05,193523,Chang; Edmond Yi-Teh,0,5,28,28
1683333410255,MMW 15,B06,193524,Chang; Edmond Yi-Teh,0,4,28,28
1683333411281,MMW 122,A01,193526,Rahimi; Babak,0,15,28,28
1683333411281,MMW 122,A02,193527,Rahimi; Babak,0,14,28,28
1683333411281,MMW 122,A03,193528,Rahimi; Babak,0,0,0,0
1683333411281,MMW 122,A04,193529,Rahimi; Babak,0,0,0,0
1683333412306,MUS 1A,A01,186663,Staff,0,20,35,35
1683333413330,MUS 4,A01,186715,Staff,0,12,35,35
1683333414355,MUS 5R,A01,186796,Dubnov; Shlomo,0,17,35,35
1683333415380,MUS 6,A01,186798,Staff,0,4,25,25
1683333416404,MUS 7,A01,186830,Staff,12,0,35,23
1683333417432,MUS 8,A01,186930,Staff,0,26,35,35
1683333418460,MUS 15,A01,186932,Staff,0,16,35,35
1683333418460,MUS 15,B01,186934,Staff,0,15,35,35
1683333419484,MUS 80,A00,186935,Staff,1,0,20,19
1683333419484,MUS 80,B00,186936,Staff,25,0,25,0
1683333420508,NANO 11,A00,204702,Lipomi; Darren John,0,0,0,0
1683333421531,NANO 15,A01,204709,Yang; Kesong,0,1,0,0
1683333422554,NANO 114,A00,202069,Jahed Motlagh; Zeinab,3,0,10,7
1683333423578,PHIL 1,A00,186955,Grush; Rick Scott,32,0,40,8
1683333424602,PHIL 10,A01,186973,Grush; Rick Scott,28,0,35,7
1683333424602,PHIL 10,A02,186974,Grush; Rick Scott,33,0,35,2
1683333425625,PHIL 13,A01,186976,Staff,7,0,35,28
1683333425625,PHIL 13,A02,186977,Staff,16,0,35,19
1683333426653,PHIL 14,A01,186979,Staff,31,0,35,4
1683333426653,PHIL 14,A02,186986,Staff,32,0,35,3
1683333427678,PHIL 28,A01,186988,Staff,16,0,30,14
1683333427678,PHIL 28,A02,186989,Staff,1,0,30,29
1683333427678,PHIL 28,A03,186990,Staff,9,0,30,21
1683333427678,PHIL 28,A04,186991,Staff,26,0,30,4
1683333428703,PHIL 120,A00,186997,Staff,23,0,40,17
1683333429728,PHIL 137,A00,187003,Staff,9,0,40,31
1683333430754,PHIL 150,A00,187015,Staff,47,0,70,23
1683333431778,PHIL 167,A00,187021,Lamey; Andy M.,35,0,40,5
1683333432807,PHIL 174,A01,202226,Staff,17,0,20,3
1683333432807,PHIL 174,A02,202235,Staff,20,0,20,0
1683333433833,PHIL 191A,A00,258918,Staff,0,0,1,1
1683333434858,PHYS 1A,A00,187028,Staff,27,0,60,33
1683333435886,PHYS 1AL,001,187036,Staff,3,0,30,27
1683333435886,PHYS 1AL,002,187049,Staff,18,0,30,12
1683333436910,PHYS 1B,A00,187058,Staff,22,0,60,38
1683333437939,PHYS 1BL,001,187064,Staff,0,0,30,30
1683333437939,PHYS 1BL,002,187070,Staff,5,0,30,25
1683333438963,PHYS 1C,A00,187082,Staff,31,0,120,89
1683333439988,PHYS 1CL,001,187088,Staff,0,9,30,30
1683333439988,PHYS 1CL,002,187089,Staff,0,2,30,30
1683333439988,PHYS 1CL,009,262693,Staff,11,0,30,19
1683333441016,PHYS 2B,A01,187097,Staff,54,0,115,61
1683333442040,PHYS 2C,A01,187099,Staff,67,0,115,48
1683333443070,PHYS 2CL,A01,187101,Staff,5,0,28,23
1683333443070,PHYS 2CL,A02,187102,Staff,15,0,28,13
1683333444096,PHYS 2D,A01,187123,Shotwell; Brian,95,0,115,20
1683333445121,PHYS 4B,A01,187133,Grinstein; Benjamin,35,0,50,15
1683333446148,POLI 10,A00,188819,Staff,0,4,50,50
1683333447175,POLI 11,A00,188827,Staff,43,0,50,7
1683333448201,POLI 13R,A00,188828,Staff,0,1,20,20
1683333449227,POLI 27,A01,188830,Elgin; Samuel Zincke,0,1,70,70
1683333450251,POLI 30,A00,188832,Desposato; Scott,31,0,50,19
1683333451275,POLI 102F,A00,188834,Staff,3,0,40,37
1683333452299,POLI 104A,A00,188852,Staff,14,0,30,16
1683333453324,POLI 104I,A00,188853,Staff,0,6,20,20
1683333454349,POLI 110B,A00,188854,Wiens; David,7,0,20,13
1683333455374,POLI 112A,A00,188855,Wiens; David,5,0,30,25
1683333456397,POLI 117R,A00,188856,Forman; Fonna,0,11,20,20
1683333457422,POLI 118,A00,188857,Ingham; Sean,8,0,20,12
1683333458445,POLI 120G,A00,188858,Staff,9,0,30,21
1683333459470,POLI 131CR,A00,188863,Hoston; Germaine,24,0,50,26
1683333460497,POLI 133,A00,188864,Nellis; Gareth Hb,44,0,50,6
1683333461525,POLI 134D,A00,188865,Desposato; Scott,27,0,30,3
1683333462553,POLI 142A,A00,188871,Gartzke; Erik,22,0,50,28
1683333463578,POLI 142K,A00,188874,Staff,38,0,50,12
1683333464603,POLI 143,A00,188940,Gartzke; Erik,16,0,30,14
1683333465627,POLI 153,A00,188943,Staff,3,0,20,17
1683333466651,POLI 160AA,A00,188944,Staff,12,0,40,28
1683333467678,POLI 170A,A00,188945,Staff,11,0,30,19
1683333469726,PSYC 1,A00,188952,Staff,37,0,90,53
1683333470751,PSYC 2,B00,188953,Staff,19,0,35,16
1683333471775,PSYC 6,A00,188970,Staff,47,0,60,13
1683333472804,PSYC 7,A00,188973,Staff,37,0,45,8
1683333473832,PSYC 60,A01,188980,Rickard; Timothy C.,43,0,60,17
1683333474857,PSYC 70,A01,189001,Steiner; Eric Tomas,24,0,45,21
1683333475880,PSYC 100,A00,189005,Lacefield; Katharine I,0,100,120,120
1683333476904,PSYC 102,A00,189008,Staff,9,0,30,21
1683333477929,PSYC 106,B00,189026,Gorman; Michael R.,34,0,60,26
1683333478954,PSYC 114,B01,189033,Winkielman; Piotr,0,32,30,30
1683333479989,PSYC 131,A00,189036,Anagnostaras; Stephan,0,43,60,60
1683333481016,PSYC 136,A00,189041,Lowe; Angela Beth,0,7,25,25
1683333482041,PSYC 137,A00,189057,Winkielman; Piotr,0,34,25,25
1683333483067,PSYC 144,A00,189107,Wixted; John T,0,7,50,50
1683333485114,PSYC 162,A00,189142,Staff,0,8,85,85
1683333486142,PSYC 172,A00,189144,Gorman; Michael R.,0,7,30,30
1683333488190,PSYC 179,A00,189146,Lacefield; Katharine I,0,84,120,120
1683333489216,PSYC 181,A00,189147,Anagnostaras; Stephan,0,44,90,90
1683333490239,PSYC 190R,A00,189148,Barner; David A.,0,22,80,80
1683333491264,PSYC 191,A00,189275,Rickard; Timothy C.,0,7,25,25
1683333492292,PSYC 193,A00,189276,Chapman; Eddie Nathaniel,0,1,0,4
1683333493323,PSYC 193L,A01,189281,Lowe; Angela Beth,12,0,20,8
1683333493323,PSYC 193L,B01,189285,Staff,28,0,35,7
1683333494350,RELI 149,A00,187137,Rahimi; Babak,7,0,40,33
1683333495374,SE 9,A01,187315,Staff,0,2,18,18
1683333496397,SE 101B,A00,187409,Staff,24,0,30,6
1683333497422,SE 110B,A00,187444,Staff,10,0,40,30
1683333498447,SE 130B,A00,187449,Staff,31,0,40,9
1683333499471,SE 150A,A00,187516,Staff,9,0,20,11
1683333500496,SE 154,A00,187528,Staff,30,0,50,20
1683333501523,SIO 3,A01,258171,Staff,35,0,40,5
1683333502546,SIO 10,A00,187144,Cook; Geoffrey W,0,3,75,75
1683333503572,SIO 45,A00,187152,Cook; Geoffrey W,1,0,100,99
1683333504597,SIO 109R,A00,194486,Staff,0,3,20,20
1683333506718,SIO 187,A01,187233,Kacev; David,12,0,40,28
1683333507744,SOCI 1,A01,258656,Thorpe; Charles Robert,28,0,30,2
1683333507744,SOCI 1,A02,258658,Thorpe; Charles Robert,30,0,30,0
1683333507744,SOCI 1,A03,258661,Thorpe; Charles Robert,25,0,25,0
1683333507744,SOCI 1,A04,258666,Thorpe; Charles Robert,22,0,25,3
1683333507744,SOCI 1,A05,258897,Thorpe; Charles Robert,23,0,25,2
1683333507744,SOCI 1,A06,258898,Thorpe; Charles Robert,25,0,25,0
1683333508769,SOCI 30,A01,258903,Pardo Guerra; Juan Pablo,15,0,30,15
1683333509793,SOCI 102,A00,258904,Staff,9,0,25,16
1683333510817,SOCI 106,A00,258905,Staff,19,0,25,6
1683333511841,SOCI 111,A00,258907,Ribas Norris; Janet Vanesa,26,0,30,4
1683333512869,SOCI 121R,A00,258908,Pardo Guerra; Juan Pablo,10,0,30,20
1683333513896,SOCI 126,A01,203330,Staff,14,0,20,6
1683333514920,SOCI 131,A00,258909,Thorpe; Charles Robert,31,0,60,29
1683333515945,SOCI 135,A00,258910,Payne; Christine Anna,0,9,30,30
1683333516969,SOCI 157,A00,258911,Staff,12,0,30,18
1683333517993,SOCI 184,A00,258912,Staff,25,0,30,5
1683333519021,SOCI 188D,A00,258913,Staff,21,0,30,9
1683333520049,SYN 2,001,187529,Staff,10,0,16,6
1683333520049,SYN 2,002,201452,Staff,0,18,16,16
1683333520049,SYN 2,003,201469,Staff,3,0,16,13
1683333521073,SYN 100,A01,187531,Staff,0,9,20,20
1683333521073,SYN 100,B01,201491,Staff,0,12,20,20
1683333522098,TDAC 1,A00,189286,Walsh; Kim C.,3,0,20,17
1683333522098,TDAC 1,B00,189287,Harting; Carla Kelso,11,0,20,9
1683333523123,TDAC 101,A00,189300,Walsh; Kim C.,16,0,20,4
1683333523123,TDAC 101,B00,189301,Harting; Carla Kelso,18,0,20,2
1683333524146,TDAC 102,A00,189304,Basso; Beatrice,14,0,20,6
1683333525174,TDAC 108,A00,189305,Staff,18,0,20,2
1683333526202,TDDE 131,A00,189310,Staff,19,0,20,1
1683333526202,TDDE 131,B00,189314,Staff,19,0,20,1
1683333526202,TDDE 131,C00,189315,Staff,48,0,50,2
1683333526202,TDDE 131,D00,189316,Staff,14,0,15,1
1683333526202,TDDE 131,E00,204841,Staff,20,0,20,0
1683333527224,TDGE 10,A00,189289,Staff,30,0,50,20
1683333527224,TDGE 10,B00,189290,Havis; Allan,1,0,50,49
1683333528249,TDGE 11,A00,189291,Fulton; Julia,0,3,50,50
1683333528249,TDGE 11,B00,189292,Staff,20,0,25,5
1683333528249,TDGE 11,C00,260270,Staff,0,0,0,0
1683333529275,TDGE 25,A00,189294,Staff,3,0,20,17
1683333530299,TDGE 124,A00,189318,Fulton; Julia,0,8,50,50
1683333531327,TDGE 125,A00,189319,Staff,13,0,25,12
1683333531327,TDGE 125,B00,189320,Staff,23,0,25,2
1683333532352,TDGE 127,A00,189322,Havis; Allan,0,0,50,50
1683333533376,TDHT 101,A00,189323,Staff,18,0,25,7
1683333533376,TDHT 101,B00,189324,Staff,25,0,25,0
1683333534400,TDHT 102,A00,189325,Staff,49,0,50,1
1683333535423,TDMV 1,A00,189295,Arcidiacono; Kristin,19,0,30,11
1683333535423,TDMV 1,B00,189296,Caligagan; Maria T.,24,0,30,6
1683333536447,TDMV 2,A00,189297,Sammartano; Tonnie,28,0,30,2
1683333536447,TDMV 2,B00,189299,Arcidiacono; Kristin,24,0,30,6
1683333537472,TDMV 3,A00,204998,Rincon; Alicia,22,0,30,8
1683333538497,TDMV 120,A00,189458,Sammartano; Tonnie,28,0,30,2
1683333539521,TDMV 138,A00,189541,Jun; Grace Shin Hae,22,0,40,18
1683333540545,TDMV 142,A00,189717,Caligagan; Tony,23,0,30,7
1683333540545,TDMV 142,B00,189718,Caligagan; Maria T.,25,0,30,5
1683333541572,TMC 2,A01,187533,Staff,25,0,25,0
1683333541572,TMC 2,A02,187534,Staff,25,0,25,0
1683333542594,USP 1,A01,187536,Kwak; Nancy,0,16,25,25
1683333543619,USP 5,A01,187538,Staff,10,0,25,15
1683333544644,USP 101,A00,199253,Staff,0,4,0,0
1683333545668,USP 124,A00,187562,Boomhower; Matthew Charles,1,0,30,29
1683333546696,USP 138,A00,187582,Staff,20,0,25,5
1683333547723,USP 152,A01,187597,Staff,4,0,25,21
1683333548748,USP 153,A00,187598,Staff,19,0,25,6
1683333549772,USP 168,A00,187607,Kwak; Nancy,2,0,5,3
1683333550801,USP 173,A00,187619,Staff,4,0,25,21
1683333551829,USP 181,A00,187638,Staff,0,0,25,25
1683333552855,VIS 103,A00,187650,Cruz; Edwin Teddy,23,0,75,52
1683333553882,VIS 110D,A00,187669,Staff,12,0,22,10
1683333554909,VIS 127C,A00,187720,Shen; Kuiyi,67,0,146,79
1683333555934,VIS 149,A00,187731,Yoldas; Pinar,0,14,22,22
1683333556962,VIS 151,A01,188091,Staff,22,0,34,12
1683333556962,VIS 151,A02,188092,Staff,11,0,34,23
1683333557989,VIS 160B,A00,188093,Stalbaum; Brett,0,0,10,10
1683333560042,WCWP 10B,A00,201720,Staff,10,0,15,5
1683333560042,WCWP 10B,B00,201722,Staff,8,0,15,7
1683333561071,WCWP 100,A00,201725,Gagnon; Jeffrey C,0,0,2,2
1683333561071,WCWP 100,B00,201727,Staff,0,4,15,15
1683333564166,ANBI 133,A00,258401,Wilder; Linnea Lorene,34,0,40,6
1683333565189,ANBI 140,A00,258395,Hrvoj Mihic; Branka,18,0,25,7
1683333566213,ANSC 120,A00,258402,Bialecki; Jon Anthony,27,0,40,13
1683333567237,ANSC 144,A00,258400,Staff,14,0,40,26
1683333569284,ANSC 166,A00,258396,Parish; Steven Martin,157,0,175,18
1683333570311,ANSC 180,A00,193533,Staff,9,0,20,11
1683333571336,ANSC 188,A00,258397,Jassal; Aftab,33,0,40,7
1683333572364,ANTH 3,A01,258316,Staff,23,0,30,7
1683333573388,ANTH 5,A00,258394,Semendeferi; Ekaterini,16,0,20,4
1683333574413,ANTH 21,A01,258331,Staff,8,0,40,32
1683333575437,ANTH 103,A00,258398,Varma; Saiba,15,0,25,10
1683333576465,AWP 10,001,202034,Staff,0,0,0,0
1683333576465,AWP 10,002,202035,Staff,0,0,0,0
1683333576465,AWP 10,003,202036,Staff,0,0,0,0
1683333576465,AWP 10,004,202037,Staff,0,0,0,0
1683333576465,AWP 10,005,202038,Staff,0,0,0,0
1683333576465,AWP 10,006,202039,Staff,0,0,0,0
1683333576465,AWP 10,007,202040,Staff,0,0,0,0
1683333576465,AWP 10,008,202041,Staff,0,0,0,0
1683333576465,AWP 10,009,202042,Staff,0,0,0,0
1683333576465,AWP 10,010,202043,Staff,0,0,0,0
1683333576465,AWP 10,011,202044,Staff,0,0,0,0
1683333576465,AWP 10,012,202045,Staff,0,0,0,0
1683333576465,AWP 10,013,202046,Staff,0,0,0,0
1683333576465,AWP 10,014,202047,Staff,0,0,0,0
1683333576465,AWP 10,015,202048,Staff,0,0,0,0
1683333576465,AWP 10,016,202049,Staff,0,0,0,0
1683333576465,AWP 10,017,202050,Staff,0,0,0,0
1683333576465,AWP 10,018,202051,Staff,0,0,0,0
1683333576465,AWP 10,019,202052,Staff,0,0,0,0
1683333576465,AWP 10,020,202053,Staff,0,0,0,0
1683333576465,AWP 10,021,202054,Staff,0,0,0,0
1683333576465,AWP 10,022,202055,Staff,0,0,0,0
1683333576465,AWP 10,023,202056,Staff,0,0,0,0
1683333576465,AWP 10,024,202057,Staff,0,0,0,0
1683333576465,AWP 10,025,202058,Staff,0,0,0,0
1683333576465,AWP 10,026,202059,Staff,0,0,0,0
1683333577490,AWP 102,001,202032,Staff,0,0,0,0
1683333577490,AWP 102,002,202033,Staff,0,0,0,0
1683333578517,BENG 100,A01,254234,Taylor Amos; Alyssa C,31,0,40,9
1683333579544,BENG 196,001,270013,Engler; Adam J.,9999,0,9999,0
1683333580575,BICD 100R,A01,202018,Smith; Laurie,0,7,32,32
1683333580575,BICD 100R,A02,202019,Smith; Laurie,0,2,32,32
1683333580575,BICD 100R,A03,202020,Smith; Laurie,0,1,32,32
1683333580575,BICD 100R,A04,202021,Smith; Laurie,9,0,32,23
1683333580575,BICD 100R,A05,202022,Smith; Laurie,12,0,32,20
1683333581599,BICD 136,A01,193242,Gustafson-Brown; Cindy,0,2,32,32
1683333581599,BICD 136,A02,193244,Gustafson-Brown; Cindy,14,0,32,18
1683333582624,BIEB 102,A01,193249,Butler; Shannon Rhey,0,2,32,32
1683333582624,BIEB 102,A02,193251,Butler; Shannon Rhey,0,0,32,32
1683333582624,BIEB 102,A03,193253,Butler; Shannon Rhey,0,1,32,32
1683333582624,BIEB 102,A04,193255,Butler; Shannon Rhey,17,0,32,15
1683333582624,BIEB 102,A05,193265,Butler; Shannon Rhey,26,0,32,6
1683333582624,BIEB 102,A06,193269,Butler; Shannon Rhey,16,0,32,16
1683333584673,BIEB 150,A01,193274,Staff,0,0,32,32
1683333584673,BIEB 150,A02,193285,Staff,23,0,32,9
1683333585695,BIEB 194,A00,193286,Kurle; Carolyn M.,22,0,32,10
1683333586720,BILD 1,A01,192291,Staff,16,0,32,16
1683333586720,BILD 1,A02,192292,Staff,30,0,32,2
1683333586720,BILD 1,B01,192520,Reuther; Keefe,0,1,0,0
1683333586720,BILD 1,B02,192532,Reuther; Keefe,0,1,0,0
1683333587746,BILD 3,A01,192556,Butler; Shannon Rhey,0,0,32,32
1683333587746,BILD 3,A02,192581,Butler; Shannon Rhey,5,0,32,27
1683333587746,BILD 3,A03,192611,Butler; Shannon Rhey,23,0,32,9
1683333587746,BILD 3,A04,192612,Butler; Shannon Rhey,25,0,32,7
1683333587746,BILD 3,A05,192613,Butler; Shannon Rhey,27,0,32,5
1683333587746,BILD 3,A06,192679,Butler; Shannon Rhey,27,0,32,5
1683333587746,BILD 3,A07,192682,Butler; Shannon Rhey,22,0,32,10
1683333588772,BILD 4,A01,192836,Reuther; Keefe,0,0,24,24
1683333588772,BILD 4,A02,193044,Reuther; Keefe,4,0,24,20
1683333589797,BILD 10,A01,193142,Gustafson-Brown; Cindy,30,0,32,2
1683333589797,BILD 10,A02,193149,Gustafson-Brown; Cindy,31,0,32,1
1683333590822,BIMM 100,A01,193301,Staff,0,6,32,32
1683333590822,BIMM 100,A02,193312,Staff,0,5,32,32
1683333590822,BIMM 100,A03,193323,Staff,0,8,32,32
1683333591847,BIMM 101,A01,193329,McDonnell; Lisa Marie,0,3,24,24
1683333591847,BIMM 101,A02,193339,McDonnell; Lisa Marie,0,3,24,24
1683333591847,BIMM 101,B01,193354,McDonnell; Lisa Marie,0,3,24,24
1683333591847,BIMM 101,B02,193357,McDonnell; Lisa Marie,0,3,24,24
1683333592871,BIMM 110,A01,193377,Tat; John,0,11,32,32
1683333592871,BIMM 110,A02,193378,Tat; John,1,9,32,31
1683333593899,BIMM 120,A01,206116,Staff,0,0,32,32
1683333593899,BIMM 120,A02,206117,Staff,8,0,32,24
1683333593899,BIMM 120,A03,206121,Staff,21,0,32,11
1683333594928,BIPN 100,A01,193393,Park; Ji Young,0,14,32,32
1683333594928,BIPN 100,A02,193402,Park; Ji Young,0,13,32,32
1683333594928,BIPN 100,A03,193413,Park; Ji Young,0,14,32,32
1683333594928,BIPN 100,A04,193414,Park; Ji Young,0,13,32,32
1683333595956,BIPN 102,A01,193429,Staff,0,0,32,32
1683333595956,BIPN 102,A02,193438,Staff,22,0,32,10
1683333596985,BIPN 106,A01,193450,Reyes Gonzalez; Catalina,0,2,40,40
1683333598010,BIPN 134,A01,193465,Cooke; James Edward,0,0,32,32
1683333598010,BIPN 134,A02,193474,Cooke; James Edward,25,0,32,7
1683333598010,BIPN 134,A03,193485,Cooke; James Edward,29,0,32,3
1683333598010,BIPN 134,A04,193486,Cooke; James Edward,21,0,32,11
1683333598010,BIPN 134,A05,193491,Cooke; James Edward,31,0,32,1
1683333598010,BIPN 134,A06,193501,Cooke; James Edward,30,0,32,2
1683333598010,BIPN 134,A07,193510,Cooke; James Edward,29,0,32,3
1683333600060,BISP 194,A00,222522,Staff,14,0,32,18
1683333601086,CAT 124,A01,202407,Staff,20,0,25,5
1683333602111,CAT 125,A00,202408,Marchisotto; Jennifer Anne,4,0,20,16
1683333603142,CAT 125R,A00,202409,Smith; Lauryn Alissa,0,11,20,20
1683333603142,CAT 125R,B00,202410,Morales; Celeste Georgianna,0,11,20,20
1683333603142,CAT 125R,C00,202411,Irwin; Matthew Joseph,0,10,20,20
1683333604166,CENG 15,A01,204712,Yang; Kesong,0,1,0,0
1683333605191,CENG 114,A00,202070,Jahed Motlagh; Zeinab,5,0,20,15
1683333606218,CGS 105,A00,185477,Wesling; Megan E.,24,0,40,16
1683333607242,CGS 106,A00,185494,Staff,13,0,22,9
1683333608267,CGS 108,A00,185495,Staff,14,0,20,6
1683333609292,CGS 114,A00,185496,Staff,13,0,18,5
1683333610390,CGS 119,A00,185501,Staff,15,0,20,5
1683333611418,CGS 120,A00,185511,Staff,13,0,20,7
1683333612442,CHEM 4,A01,184675,Bussey; Thomas J,96,0,100,4
1683333613469,CHEM 6A,A01,184677,Staff,34,0,60,26
1683333614491,CHEM 6B,A01,184679,Staff,65,0,100,35
1683333615520,CHEM 6C,A01,184681,Bussey; Thomas J,1,0,50,49
1683333615520,CHEM 6C,A02,184682,Bussey; Thomas J,34,0,50,16
1683333616547,CHEM 40A,A01,184684,Albizati; Kim F.,37,0,100,63
1683333617570,CHEM 40B,A01,184686,Albizati; Kim F.,0,20,100,100
1683333618598,CHEM 41B,A01,184690,Staff,52,0,100,48
1683333619622,COGS 3,A01,184715,Boyle; Mary E. T.,0,25,40,40
1683333620646,COGS 14B,A01,185172,Staff,0,15,38,38
1683333621675,COGS 18,A01,184736,Staff,17,0,80,63
1683333622702,COGS 100,A01,184932,Staff,0,5,73,73
1683333623726,COGS 101A,A01,184935,Staff,0,39,30,30
1683333624752,COGS 101B,A01,184944,Staff,0,2,30,30
1683333625776,COGS 101C,A01,184946,Staff,0,12,30,30
1683333626802,COGS 102A,A01,184951,Johnson; Christine M.,2,0,40,38
1683333627827,COGS 107B,A01,184953,Mooshagian; Eric Frederick,0,50,40,40
1683333628853,COGS 118B,A01,184959,Gupta; Anjum,0,48,40,40
1683333629880,COGS 153,A00,184961,Staff,0,15,30,30
1683333630905,COGS 177,A00,184962,Staff,0,20,30,30
1683333631939,COGS 187A,A01,184969,Boyle; Mary E. T.,0,17,40,40
1683333632967,COMM 10,A01,185174,Staff,0,5,25,25
1683333632967,COMM 10,A02,185189,Staff,0,5,25,25
1683333632967,COMM 10,A03,269821,Staff,0,0,0,0
1683333633994,COMM 100B,A01,185475,Staff,0,0,0,2
1683333633994,COMM 100B,A02,185476,Staff,14,0,25,11
1683333635021,COMM 100C,A01,185314,Staff,1,0,25,24
1683333635021,COMM 100C,A02,185327,Staff,19,0,25,6
1683333636049,COMM 110M,A00,185349,Staff,2,0,40,38
1683333637077,COMM 113T,A00,185352,Staff,24,0,40,16
1683333638104,COMM 114I,A00,185353,Staff,33,0,40,7
1683333639129,COMM 131,A00,185354,Staff,19,0,30,11
1683333640155,CSE 8A,A50,185358,Cao; Yingjun,0,46,10,10
1683333641179,CSE 8B,A01,185362,Staff,1,47,50,49
1683333642204,CSE 11,A01,185416,Cao; Yingjun,0,92,10,10
1683333643228,CSE 20,A01,185445,Briones; Jor-el Thomas Caparas,5,0,25,20
1683333644254,CSE 21,A01,185447,Staff,10,0,50,40
1683333645285,CSE 101,A01,185451,Staff,0,12,50,50
1683333645285,CSE 101,B01,185453,Jones; Miles E,0,11,50,50
1683333647338,CSE 141,A01,185458,Eldon; John,20,0,100,80
1683333648362,CSE 141L,A01,185461,Eldon; John,12,0,100,88
1683333649389,CSE 142,A01,185463,Staff,36,0,60,24
1683333649389,CSE 142,B01,201355,Staff,0,7,60,60
1683333650416,CSE 142L,A01,185470,Staff,36,0,60,24
1683333650416,CSE 142L,B01,201417,Staff,0,6,60,60
1683333651439,CSE 190,A00,201433,Staff,32,0,49,17
1683333652462,DOC 1,A01,259136,Strom; Megan C.,7,0,15,8
1683333652462,DOC 1,A02,259137,Strom; Megan C.,14,0,15,1
1683333652462,DOC 1,A03,259138,Strom; Megan C.,14,0,15,1
1683333652462,DOC 1,A04,259139,Strom; Megan C.,14,0,15,1
1683333653489,DOC 100D,A00,259140,Pass; Natalye Joann,16,0,25,9
1683333654513,DSGN 1,A01,184749,Rill; Bryan,0,25,30,30
1683333655540,DSGN 100,A01,185168,Staff,0,2,25,25
1683333656563,ECE 5,A01,185626,Morris; Karcher William,0,10,0,0
1683333657587,ECE 101,A01,185628,Staff,17,0,70,53
1683333658610,ECE 107,A01,185635,Baghdadchi; Saharnaz,0,0,20,20
1683333658610,ECE 107,A02,185638,Baghdadchi; Saharnaz,4,0,20,16
1683333659635,ECE 148,A01,185647,Silberman; Jack,0,0,16,16
1683333660658,ECON 1,A01,185537,Crane; Meredith Helen,54,0,70,16
1683333661682,ECON 3,A01,185549,Crane; Meredith Helen,33,0,70,37
1683333662706,ECON 4,A01,203354,Anderson; John Charles,0,4,10,10
1683333663734,ECON 100A,A01,185574,Staff,0,4,40,40
1683333664758,ECON 100B,A01,185576,Staff,10,22,50,40
1683333665786,ECON 100C,A01,185589,Newhouse; Herbert S,30,0,70,40
1683333666814,ECON 105,A00,185608,Vespa; Emanuel Ignacio,19,0,35,16
1683333667843,ECON 109,A01,185610,Shishkin; Denis,10,0,35,25
1683333668868,ECON 110A,A01,185612,Staff,11,0,40,29
1683333669896,ECON 120A,A01,185615,Staff,20,0,40,20
1683333670920,ECON 120C,A01,185617,Sun; Yixiao,0,20,70,70
1683333671944,ECON 144,A00,203346,Squires; Dale E,3,0,35,32
1683333672973,ECON 171,A01,203349,Newhouse; Herbert S,0,1,35,35
1683333674002,ECON 173A,A01,185621,Toda; Alexis Akira,21,0,35,14
1683333675029,EDS 25,A01,202413,Staff,0,1,0,0
1683333675029,EDS 25,A02,202414,Staff,0,1,0,0
1683333675029,EDS 25,A03,202415,Staff,0,0,0,0
1683333675029,EDS 25,A04,202416,Staff,0,1,0,0
1683333675029,EDS 25,A05,202439,Staff,0,0,0,0
1683333675029,EDS 25,A06,202440,Staff,0,0,0,0
1683333675029,EDS 25,B01,202631,Staff,0,0,0,0
1683333675029,EDS 25,B02,202632,Staff,0,0,0,0
1683333675029,EDS 25,B03,202639,Staff,0,0,0,0
1683333675029,EDS 25,B04,202640,Staff,0,0,0,0
1683333675029,EDS 25,B05,202643,Staff,0,0,0,0
1683333675029,EDS 25,B06,202644,Staff,0,0,0,0
1683333676053,EDS 38,A01,202659,Black; Alison Michelle,24,0,25,1
1683333677078,EDS 115,A00,202652,Staff,17,0,30,13
1683333678103,EDS 125,A00,202649,Staff,14,0,30,16
1683333679126,EDS 126,A01,203332,Staff,30,0,30,0
1683333680152,EDS 139,A00,202838,Staff,16,0,25,9
1683333681177,EDS 146,A01,202655,Staff,14,0,25,11
1683333682205,ENG 15,A00,185667,Staff,0,1,0,0
1683333682205,ENG 15,B00,185672,Staff,0,0,0,0
1683333682205,ENG 15,C00,185675,Staff,0,0,0,0
1683333682205,ENG 15,D00,185682,Staff,0,0,0,0
1683333682205,ENG 15,E00,185684,Staff,0,0,0,0
1683333683233,ETHN 103,A00,185710,Staff,0,3,35,35
1683333684257,ETHN 103A,A00,199228,Man; Simeon S,2,0,9,7
1683333685284,ETHN 109,A00,185711,Staff,18,0,35,17
1683333686310,ETHN 142,A00,185726,Staff,0,4,30,30
1683333687337,ETHN 163J,A00,199229,Man; Simeon S,5,0,8,3
1683333688365,ETHN 168,A00,185727,Staff,8,0,10,2
1683333689388,ETHN 182,A00,185728,Staff,1,0,35,34
1683333690414,ETHN 183,A00,185737,Staff,8,0,18,10
1683333691438,GLBH 111,A01,209361,Burgos; Jose L.,0,0,0,0
1683333693486,HIEU 104,A00,185792,Staff,16,0,20,4
1683333694513,HIEU 115,A00,185800,Staff,1,0,20,19
1683333695541,HIEU 128,A00,185801,Staff,0,7,20,20
1683333696568,HIEU 147,A00,185802,Staff,16,0,20,4
1683333697592,HIEU 154,A00,185823,Staff,12,0,20,8
1683333698619,HILA 102,A00,185826,Staff,13,0,20,7
1683333699647,HILD 2C,A01,185778,Staff,0,12,20,20
1683333700676,HILD 7B,A01,185780,Kwak; Nancy,0,15,32,32
1683333700676,HILD 7B,A02,185781,Kwak; Nancy,0,18,32,32
1683333701703,HILD 30,A01,185791,Staff,14,0,20,6
1683333702731,HISC 119,A00,185830,Golan; Tal,0,9,20,20
1683333703757,HITO 156GS,A00,185831,Patterson; Patrick H.,0,0,0,23
1683333704782,HIUS 103,A00,185832,Man; Simeon S,0,6,20,20
1683333705807,HIUS 117,A00,185836,Kwak; Nancy,2,0,20,18
1683333706831,HIUS 125,A00,185840,Man; Simeon S,0,0,23,23
1683333707856,HIUS 149,A00,185845,Staff,0,0,20,20
1683333708884,HUM 3,A01,185882,Zavodny; Tatiana Sophia,0,7,50,50
1683333708884,HUM 3,B01,185899,Caldwell; Michael Alan,0,18,50,50
1683333709910,HUM 3GS,A00,185900,Patterson; Patrick H.,0,0,0,23
1683333710935,HUM 4,A01,185938,Zroka; Amy Liane,31,0,50,19
1683333710935,HUM 4,B01,185956,Watkins; Eric,0,2,50,50
1683333710935,HUM 4,B02,202209,Watkins; Eric,0,2,50,50
1683333710935,HUM 4,B03,202210,Watkins; Eric,0,2,50,50
1683333711962,HUM 5,A01,185958,West; Geoffrey Scott,3,0,50,47
1683333711962,HUM 5,A02,202215,West; Geoffrey Scott,0,0,50,50
1683333712988,INTL 190,A00,185959,Gagnon; Jeffrey C,0,0,0,9
1683333712988,INTL 190,B00,185960,Lettieri; Michael Joseph,0,0,0,1
1683333714070,JAPN 180,A00,254509,Staff,5,1,30,25
1683333715096,LATI 10,A01,202853,Kennemore; Amy Michelle,4,0,35,31
1683333715096,LATI 10,A02,202854,Kennemore; Amy Michelle,2,0,35,33
1683333715096,LATI 10,A03,270054,Kennemore; Amy Michelle,30,0,30,0
1683333716120,LATI 180,A00,202855,Kennemore; Amy Michelle,11,0,20,9
1683333717147,LAWS 101,A00,201767,Golan; Tal,0,7,40,40
1683333718173,LIFR 1C,A00,185961,Staff,6,0,20,14
1683333719198,LIFR 1CX,A00,185962,Staff,7,0,20,13
1683333720225,LIFR 1D,A00,185963,Staff,9,0,20,11
1683333721248,LIFR 1DX,A00,185964,Staff,9,0,20,11
1683333722272,LIGN 101,A01,186039,Staff,43,0,50,7
1683333723296,LIGN 165,A00,186040,Staff,18,0,50,32
1683333724320,LTCS 108,A00,186041,Staff,6,0,10,4
1683333725345,LTCS 119,A00,186042,Staff,16,0,20,4
1683333726372,LTCS 130,A00,186043,Wesling; Megan E.,15,0,25,10
1683333728423,LTEA 138,A00,186119,Staff,14,0,40,26
1683333729450,LTEN 124,A00,186148,Staff,6,0,25,19
1683333730478,LTEN 178,A00,186149,Staff,7,0,15,8
1683333731502,LTEN 181,A00,186150,Blanco; John D,33,0,40,7
1683333732528,LTWL 120,A00,186160,Staff,20,0,25,5
1683333733552,LTWL 165,A00,186161,Staff,22,0,25,3
1683333734579,LTWR 100,A00,186162,Staff,0,5,15,15
1683333735603,LTWR 102,A00,186163,Doller; Ben,5,0,15,10
1683333736628,MAE 8,A01,186412,Staff,0,0,0,0
1683333737652,MAE 30B,A00,186445,Bahadori; Mohammad Yousef,83,0,100,17
1683333738677,MAE 40,A00,186592,Bewley; Thomas R,9,0,50,41
1683333739701,MAE 101B,A00,186593,Bahadori; Mohammad Yousef,81,0,100,19
1683333740726,MAE 105,A00,186594,Bandaru; Prabhakar,12,0,50,38
1683333741754,MAE 107,A00,186599,Pham; Hieu Tan,0,6,120,120
1683333742781,MAE 148,A01,186660,Silberman; Jack,3,0,16,13
1683333743806,MATH 10A,A01,188095,Staff,1,6,35,34
1683333744834,MATH 10B,A01,188097,Bowers; Adam R.,0,11,30,30
1683333744834,MATH 10B,A02,188099,Bowers; Adam R.,0,11,30,30
1683333744834,MATH 10B,B01,188104,Bowers; Adam R.,0,10,30,30
1683333744834,MATH 10B,B02,188106,Bowers; Adam R.,0,10,30,30
1683333745863,MATH 10C,A01,188111,Staff,0,18,30,30
1683333745863,MATH 10C,A02,188127,Staff,0,17,30,30
1683333745863,MATH 10C,A03,188131,Staff,0,18,30,30
1683333745863,MATH 10C,B01,188218,Staff,18,0,30,12
1683333745863,MATH 10C,B02,188244,Staff,13,0,30,17
1683333745863,MATH 10C,B03,188277,Staff,16,0,30,14
1683333746888,MATH 18,A01,188344,Bach; Quang Tran,18,0,30,12
1683333746888,MATH 18,A02,188345,Bach; Quang Tran,11,0,30,19
1683333746888,MATH 18,B01,188353,Bach; Quang Tran,10,0,30,20
1683333746888,MATH 18,B02,188354,Bach; Quang Tran,20,0,30,10
1683333747913,MATH 20A,A01,188374,Staff,13,0,35,22
1683333748937,MATH 20B,A01,188382,Ohm; Ko Woon,6,0,30,24
1683333748937,MATH 20B,A02,188383,Ohm; Ko Woon,22,0,30,8
1683333748937,MATH 20B,B01,188385,Ohm; Ko Woon,7,0,30,23
1683333748937,MATH 20B,B02,188392,Ohm; Ko Woon,22,0,30,8
1683333749961,MATH 20C,A01,188394,Harel; Guershon,10,0,30,20
1683333749961,MATH 20C,A02,188395,Harel; Guershon,15,0,30,15
1683333749961,MATH 20C,B01,188404,Harel; Guershon,5,0,30,25
1683333749961,MATH 20C,B02,188405,Harel; Guershon,19,0,30,11
1683333750986,MATH 20D,A01,188414,Hammock; Frances H,0,1,30,30
1683333750986,MATH 20D,A02,188415,Hammock; Frances H,3,0,30,27
1683333750986,MATH 20D,B01,188447,Hammock; Frances H,1,0,30,29
1683333750986,MATH 20D,B02,188486,Hammock; Frances H,8,0,30,22
1683333752011,MATH 20E,A01,188649,Staff,21,0,30,9
1683333752011,MATH 20E,A02,188650,Staff,23,0,30,7
1683333752011,MATH 20E,A03,188673,Staff,0,0,30,30
1683333753035,MATH 102,A01,188675,Staff,0,35,35,35
1683333754060,MATH 103B,A01,188681,Staff,3,0,35,32
1683333754060,MATH 103B,B01,188692,Staff,5,0,35,30
1683333755085,MATH 109,A01,188695,Salehi Golsefidy; Alireza,25,0,35,10
1683333755085,MATH 109,A02,188696,Salehi Golsefidy; Alireza,25,0,35,10
1683333756113,MATH 120A,A01,188698,Eggers; John Dietrich,7,0,35,28
1683333757138,MATH 142B,A01,188736,Ioana; Adrian,0,2,30,30
1683333757138,MATH 142B,A02,188741,Ioana; Adrian,1,1,30,29
1683333757138,MATH 142B,A03,188743,Ioana; Adrian,1,3,30,29
1683333758165,MATH 168A,A01,188790,Staff,0,9,35,35
1683333759194,MATH 170A,A01,188803,Nie; Jiawang,0,2,35,35
1683333759194,MATH 170A,A02,188811,Nie; Jiawang,0,0,35,35
1683333759194,MATH 170A,A03,188814,Nie; Jiawang,1,0,35,34
1683333759194,MATH 170A,A04,188815,Nie; Jiawang,13,0,35,22
1683333760222,MATH 193B,A01,188817,Staff,0,0,35,35
1683333760222,MATH 193B,A02,188818,Staff,5,0,35,30
1683333761246,MGT 4,A01,202857,Anderson; John Charles,62,0,80,18
1683333762271,MGT 12,A00,202858,Lindenberger; Wade Douglas,42,0,90,48
1683333763296,MGT 18,A00,202859,Staff,74,0,90,16
1683333764320,MGT 18GS,A00,202860,McKay; Michael J,13,0,28,15
1683333765346,MGT 45,A00,202861,Pecore; Joseph P.,14,0,90,76
1683333766372,MGT 100,A00,202863,Yavorsky; Daniel Ryan,28,0,90,62
1683333767400,MGT 103,A00,202864,Ehrich; Kristine R,1,18,90,89
1683333768426,MGT 112,A00,202865,Ehrich; Kristine R,15,0,90,75
1683333769452,MGT 121A,A00,202868,Staff,0,20,0,0
1683333770479,MGT 131B,A00,202869,Anderson; John Charles,59,0,90,31
1683333771503,MGT 136,A00,202871,Lindenberger; Wade Douglas,84,0,90,6
1683333772526,MGT 164,A00,202873,Staff,0,68,90,91
1683333773553,MGT 164GS,A00,202874,McKay; Mary A,13,0,28,15
1683333774579,MGT 180,A00,202875,Staff,0,50,90,91
1683333775606,MMW 11R,A01,205019,Herbst; Matthew,3,0,30,27
1683333775606,MMW 11R,A02,205026,Herbst; Matthew,29,0,30,1
1683333776634,MMW 15,A01,193512,Chang; Edmond Yi-Teh,0,9,28,28
1683333776634,MMW 15,A02,193513,Chang; Edmond Yi-Teh,0,5,28,28
1683333776634,MMW 15,A03,193514,Chang; Edmond Yi-Teh,0,5,28,28
1683333776634,MMW 15,A04,193515,Chang; Edmond Yi-Teh,0,5,28,28
1683333776634,MMW 15,A05,193516,Chang; Edmond Yi-Teh,0,4,28,28
1683333776634,MMW 15,A06,193517,Chang; Edmond Yi-Teh,0,5,28,28
1683333776634,MMW 15,B01,193519,Chang; Edmond Yi-Teh,0,5,28,28
1683333776634,MMW 15,B02,193520,Chang; Edmond Yi-Teh,0,5,28,28
1683333776634,MMW 15,B03,193521,Chang; Edmond Yi-Teh,0,5,28,28
1683333776634,MMW 15,B04,193522,Chang; Edmond Yi-Teh,0,4,28,28
1683333776634,MMW 15,B05,193523,Chang; Edmond Yi-Teh,0,5,28,28
1683333776634,MMW 15,B06,193524,Chang; Edmond Yi-Teh,0,4,28,28
1683333777657,MMW 122,A01,193526,Rahimi; Babak,0,15,28,28
1683333777657,MMW 122,A02,193527,Rahimi; Babak,0,14,28,28
1683333777657,MMW 122,A03,193528,Rahimi; Babak,0,0,0,0
1683333777657,MMW 122,A04,193529,Rahimi; Babak,0,0,0,0
1683333778684,MUS 1A,A01,186663,Staff,0,20,35,35
1683333779709,MUS 4,A01,186715,Staff,0,12,35,35
1683333780743,MUS 5R,A01,186796,Dubnov; Shlomo,0,17,35,35
1683333781771,MUS 6,A01,186798,Staff,0,4,25,25
1683333782797,MUS 7,A01,186830,Staff,12,0,35,23
1683333783826,MUS 8,A01,186930,Staff,0,26,35,35
1683333784851,MUS 15,A01,186932,Staff,0,16,35,35
1683333784851,MUS 15,B01,186934,Staff,0,15,35,35
1683333785876,MUS 80,A00,186935,Staff,1,0,20,19
1683333785876,MUS 80,B00,186936,Staff,25,0,25,0
1683333786901,NANO 11,A00,204702,Lipomi; Darren John,0,0,0,0
1683333787938,NANO 15,A01,204709,Yang; Kesong,0,1,0,0
1683333788963,NANO 114,A00,202069,Jahed Motlagh; Zeinab,3,0,10,7
1683333789988,PHIL 1,A00,186955,Grush; Rick Scott,32,0,40,8
1683333791013,PHIL 10,A01,186973,Grush; Rick Scott,28,0,35,7
1683333791013,PHIL 10,A02,186974,Grush; Rick Scott,33,0,35,2
1683333792041,PHIL 13,A01,186976,Staff,7,0,35,28
1683333792041,PHIL 13,A02,186977,Staff,16,0,35,19
1683333793065,PHIL 14,A01,186979,Staff,31,0,35,4
1683333793065,PHIL 14,A02,186986,Staff,32,0,35,3
1683333794090,PHIL 28,A01,186988,Staff,16,0,30,14
1683333794090,PHIL 28,A02,186989,Staff,1,0,30,29
1683333794090,PHIL 28,A03,186990,Staff,9,0,30,21
1683333794090,PHIL 28,A04,186991,Staff,26,0,30,4
1683333795113,PHIL 120,A00,186997,Staff,23,0,40,17
1683333796137,PHIL 137,A00,187003,Staff,9,0,40,31
1683333797165,PHIL 150,A00,187015,Staff,47,0,70,23
1683333798189,PHIL 167,A00,187021,Lamey; Andy M.,35,0,40,5
1683333799215,PHIL 174,A01,202226,Staff,17,0,20,3
1683333799215,PHIL 174,A02,202235,Staff,20,0,20,0
1683333800238,PHIL 191A,A00,258918,Staff,0,0,1,1
1683333801262,PHYS 1A,A00,187028,Staff,27,0,60,33
1683333802286,PHYS 1AL,001,187036,Staff,3,0,30,27
1683333802286,PHYS 1AL,002,187049,Staff,18,0,30,12
1683333803313,PHYS 1B,A00,187058,Staff,22,0,60,38
1683333804338,PHYS 1BL,001,187064,Staff,0,0,30,30
1683333804338,PHYS 1BL,002,187070,Staff,5,0,30,25
1683333805362,PHYS 1C,A00,187082,Staff,31,0,120,89
1683333806387,PHYS 1CL,001,187088,Staff,0,9,30,30
1683333806387,PHYS 1CL,002,187089,Staff,0,2,30,30
1683333806387,PHYS 1CL,009,262693,Staff,11,0,30,19
1683333807415,PHYS 2B,A01,187097,Staff,54,0,115,61
1683333808438,PHYS 2C,A01,187099,Staff,67,0,115,48
1683333809466,PHYS 2CL,A01,187101,Staff,5,0,28,23
1683333809466,PHYS 2CL,A02,187102,Staff,15,0,28,13
1683333810494,PHYS 2D,A01,187123,Shotwell; Brian,95,0,115,20
1683333811519,PHYS 4B,A01,187133,Grinstein; Benjamin,35,0,50,15
1683333812544,POLI 10,A00,188819,Staff,0,4,50,50
1683333813572,POLI 11,A00,188827,Staff,43,0,50,7
1683333814594,POLI 13R,A00,188828,Staff,0,1,20,20
1683333815619,POLI 27,A01,188830,Elgin; Samuel Zincke,0,1,70,70
1683333816648,POLI 30,A00,188832,Desposato; Scott,31,0,50,19
1683333817729,POLI 102F,A00,188834,Staff,3,0,40,37
1683333818753,POLI 104A,A00,188852,Staff,14,0,30,16
1683333819778,POLI 104I,A00,188853,Staff,0,6,20,20
1683333820802,POLI 110B,A00,188854,Wiens; David,7,0,20,13
1683333821826,POLI 112A,A00,188855,Wiens; David,5,0,30,25
1683333822850,POLI 117R,A00,188856,Forman; Fonna,0,11,20,20
1683333823875,POLI 118,A00,188857,Ingham; Sean,8,0,20,12
1683333824899,POLI 120G,A00,188858,Staff,9,0,30,21
1683333825926,POLI 131CR,A00,188863,Hoston; Germaine,24,0,50,26
1683333826953,POLI 133,A00,188864,Nellis; Gareth Hb,44,0,50,6
1683333827980,POLI 134D,A00,188865,Desposato; Scott,27,0,30,3
1683333829007,POLI 142A,A00,188871,Gartzke; Erik,22,0,50,28
1683333830031,POLI 142K,A00,188874,Staff,38,0,50,12
1683333831058,POLI 143,A00,188940,Gartzke; Erik,16,0,30,14
1683333832084,POLI 153,A00,188943,Staff,3,0,20,17
1683333833112,POLI 160AA,A00,188944,Staff,12,0,40,28
1683333834140,POLI 170A,A00,188945,Staff,11,0,30,19
1683333836191,PSYC 1,A00,188952,Staff,37,0,90,53
1683333837218,PSYC 2,B00,188953,Staff,19,0,35,16
1683333838240,PSYC 6,A00,188970,Staff,47,0,60,13
1683333839264,PSYC 7,A00,188973,Staff,37,0,45,8
1683333840292,PSYC 60,A01,188980,Rickard; Timothy C.,43,0,60,17
1683333841321,PSYC 70,A01,189001,Steiner; Eric Tomas,24,0,45,21
1683333842346,PSYC 100,A00,189005,Lacefield; Katharine I,0,100,120,120
1683333843373,PSYC 102,A00,189008,Staff,9,0,30,21
1683333844398,PSYC 106,B00,189026,Gorman; Michael R.,34,0,60,26
1683333845424,PSYC 114,B01,189033,Winkielman; Piotr,0,32,30,30
1683333846448,PSYC 131,A00,189036,Anagnostaras; Stephan,0,43,60,60
1683333847473,PSYC 136,A00,189041,Lowe; Angela Beth,0,7,25,25
1683333848500,PSYC 137,A00,189057,Winkielman; Piotr,0,34,25,25
1683333849525,PSYC 144,A00,189107,Wixted; John T,0,7,50,50
1683333851574,PSYC 162,A00,189142,Staff,0,8,85,85
1683333852601,PSYC 172,A00,189144,Gorman; Michael R.,0,7,30,30
1683333854654,PSYC 179,A00,189146,Lacefield; Katharine I,0,84,120,120
1683333855678,PSYC 181,A00,189147,Anagnostaras; Stephan,0,44,90,90
1683333856706,PSYC 190R,A00,189148,Barner; David A.,0,22,80,80
1683333857730,PSYC 191,A00,189275,Rickard; Timothy C.,0,7,25,25
1683333858756,PSYC 193,A00,189276,Chapman; Eddie Nathaniel,0,1,0,4
1683333859780,PSYC 193L,A01,189281,Lowe; Angela Beth,12,0,20,8
1683333859780,PSYC 193L,B01,189285,Staff,28,0,35,7
1683333860804,RELI 149,A00,187137,Rahimi; Babak,7,0,40,33
1683333861829,SE 9,A01,187315,Staff,0,2,18,18
1683333862853,SE 101B,A00,187409,Staff,24,0,30,6
1683333863880,SE 110B,A00,187444,Staff,10,0,40,30
1683333864908,SE 130B,A00,187449,Staff,31,0,40,9
1683333865931,SE 150A,A00,187516,Staff,9,0,20,11
1683333866954,SE 154,A00,187528,Staff,30,0,50,20
1683333867978,SIO 3,A01,258171,Staff,35,0,40,5
1683333869003,SIO 10,A00,187144,Cook; Geoffrey W,0,3,75,75
1683333870033,SIO 45,A00,187152,Cook; Geoffrey W,1,0,100,99
1683333871058,SIO 109R,A00,194486,Staff,0,3,20,20
1683333873110,SIO 187,A01,187233,Kacev; David,12,0,40,28
1683333874138,SOCI 1,A01,258656,Thorpe; Charles Robert,28,0,30,2
1683333874138,SOCI 1,A02,258658,Thorpe; Charles Robert,30,0,30,0
1683333874138,SOCI 1,A03,258661,Thorpe; Charles Robert,25,0,25,0
1683333874138,SOCI 1,A04,258666,Thorpe; Charles Robert,22,0,25,3
1683333874138,SOCI 1,A05,258897,Thorpe; Charles Robert,23,0,25,2
1683333874138,SOCI 1,A06,258898,Thorpe; Charles Robert,25,0,25,0
1683333875163,SOCI 30,A01,258903,Pardo Guerra; Juan Pablo,15,0,30,15
1683333876192,SOCI 102,A00,258904,Staff,9,0,25,16
1683333877216,SOCI 106,A00,258905,Staff,19,0,25,6
1683333878239,SOCI 111,A00,258907,Ribas Norris; Janet Vanesa,26,0,30,4
1683333879261,SOCI 121R,A00,258908,Pardo Guerra; Juan Pablo,10,0,30,20
1683333880288,SOCI 126,A01,203330,Staff,14,0,20,6
1683333881316,SOCI 131,A00,258909,Thorpe; Charles Robert,31,0,60,29
1683333882340,SOCI 135,A00,258910,Payne; Christine Anna,0,9,30,30
1683333883364,SOCI 157,A00,258911,Staff,12,0,30,18
1683333884389,SOCI 184,A00,258912,Staff,25,0,30,5
1683333885413,SOCI 188D,A00,258913,Staff,21,0,30,9
1683333886440,SYN 2,001,187529,Staff,10,0,16,6
1683333886440,SYN 2,002,201452,Staff,0,18,16,16
1683333886440,SYN 2,003,201469,Staff,3,0,16,13
1683333887465,SYN 100,A01,187531,Staff,0,9,20,20
1683333887465,SYN 100,B01,201491,Staff,0,12,20,20
1683333888488,TDAC 1,A00,189286,Walsh; Kim C.,3,0,20,17
1683333888488,TDAC 1,B00,189287,Harting; Carla Kelso,11,0,20,9
1683333889512,TDAC 101,A00,189300,Walsh; Kim C.,16,0,20,4
1683333889512,TDAC 101,B00,189301,Harting; Carla Kelso,18,0,20,2
1683333890540,TDAC 102,A00,189304,Basso; Beatrice,14,0,20,6
1683333891567,TDAC 108,A00,189305,Staff,18,0,20,2
1683333892597,TDDE 131,A00,189310,Staff,19,0,20,1
1683333892597,TDDE 131,B00,189314,Staff,19,0,20,1
1683333892597,TDDE 131,C00,189315,Staff,48,0,50,2
1683333892597,TDDE 131,D00,189316,Staff,14,0,15,1
1683333892597,TDDE 131,E00,204841,Staff,20,0,20,0
1683333893624,TDGE 10,A00,189289,Staff,30,0,50,20
1683333893624,TDGE 10,B00,189290,Havis; Allan,1,0,50,49
1683333894652,TDGE 11,A00,189291,Fulton; Julia,0,3,50,50
1683333894652,TDGE 11,B00,189292,Staff,20,0,25,5
1683333894652,TDGE 11,C00,260270,Staff,0,0,0,0
1683333895677,TDGE 25,A00,189294,Staff,3,0,20,17
1683333896704,TDGE 124,A00,189318,Fulton; Julia,0,8,50,50
1683333897730,TDGE 125,A00,189319,Staff,13,0,25,12
1683333897730,TDGE 125,B00,189320,Staff,23,0,25,2
1683333898759,TDGE 127,A00,189322,Havis; Allan,0,0,50,50
1683333899785,TDHT 101,A00,189323,Staff,18,0,25,7
1683333899785,TDHT 101,B00,189324,Staff,25,0,25,0
1683333900813,TDHT 102,A00,189325,Staff,49,0,50,1
1683333901836,TDMV 1,A00,189295,Arcidiacono; Kristin,19,0,30,11
1683333901836,TDMV 1,B00,189296,Caligagan; Maria T.,24,0,30,6
1683333902860,TDMV 2,A00,189297,Sammartano; Tonnie,28,0,30,2
1683333902860,TDMV 2,B00,189299,Arcidiacono; Kristin,24,0,30,6
1683333903884,TDMV 3,A00,204998,Rincon; Alicia,22,0,30,8
1683333904911,TDMV 120,A00,189458,Sammartano; Tonnie,28,0,30,2
1683333905936,TDMV 138,A00,189541,Jun; Grace Shin Hae,22,0,40,18
1683333906962,TDMV 142,A00,189717,Caligagan; Tony,23,0,30,7
1683333906962,TDMV 142,B00,189718,Caligagan; Maria T.,25,0,30,5
1683333907990,TMC 2,A01,187533,Staff,25,0,25,0
1683333907990,TMC 2,A02,187534,Staff,25,0,25,0
1683333909017,USP 1,A01,187536,Kwak; Nancy,0,16,25,25
1683333910041,USP 5,A01,187538,Staff,10,0,25,15
1683333911066,USP 101,A00,199253,Staff,0,4,0,0
1683333912090,USP 124,A00,187562,Boomhower; Matthew Charles,1,0,30,29
1683333913116,USP 138,A00,187582,Staff,20,0,25,5
1683333914140,USP 152,A01,187597,Staff,4,0,25,21
1683333915162,USP 153,A00,187598,Staff,19,0,25,6
1683333916188,USP 168,A00,187607,Kwak; Nancy,2,0,5,3
1683333917214,USP 173,A00,187619,Staff,4,0,25,21
1683333918239,USP 181,A00,187638,Staff,0,0,25,25
1683333919262,VIS 103,A00,187650,Cruz; Edwin Teddy,23,0,75,52
1683333920286,VIS 110D,A00,187669,Staff,12,0,22,10
1683333921381,VIS 127C,A00,187720,Shen; Kuiyi,67,0,146,79
1683333922406,VIS 149,A00,187731,Yoldas; Pinar,0,14,22,22
1683333923430,VIS 151,A01,188091,Staff,22,0,34,12
1683333923430,VIS 151,A02,188092,Staff,11,0,34,23
1683333924457,VIS 160B,A00,188093,Stalbaum; Brett,0,0,10,10
1683333926508,WCWP 10B,A00,201720,Staff,10,0,15,5
1683333926508,WCWP 10B,B00,201722,Staff,8,0,15,7
1683333927534,WCWP 100,A00,201725,Gagnon; Jeffrey C,0,0,2,2
1683333927534,WCWP 100,B00,201727,Staff,0,4,15,15
1683333930621,ANBI 133,A00,258401,Wilder; Linnea Lorene,34,0,40,6
1683333931645,ANBI 140,A00,258395,Hrvoj Mihic; Branka,18,0,25,7
1683333932669,ANSC 120,A00,258402,Bialecki; Jon Anthony,27,0,40,13
1683333933693,ANSC 144,A00,258400,Staff,14,0,40,26
1683333935742,ANSC 166,A00,258396,Parish; Steven Martin,157,0,175,18
1683333936769,ANSC 180,A00,193533,Staff,9,0,20,11
1683333937792,ANSC 188,A00,258397,Jassal; Aftab,33,0,40,7
1683333938816,ANTH 3,A01,258316,Staff,23,0,30,7
1683333939840,ANTH 5,A00,258394,Semendeferi; Ekaterini,16,0,20,4
1683333940867,ANTH 21,A01,258331,Staff,8,0,40,32
1683333941894,ANTH 103,A00,258398,Varma; Saiba,15,0,25,10
1683333942920,AWP 10,001,202034,Staff,0,0,0,0
1683333942920,AWP 10,002,202035,Staff,0,0,0,0
1683333942920,AWP 10,003,202036,Staff,0,0,0,0
1683333942920,AWP 10,004,202037,Staff,0,0,0,0
1683333942920,AWP 10,005,202038,Staff,0,0,0,0
1683333942920,AWP 10,006,202039,Staff,0,0,0,0
1683333942920,AWP 10,007,202040,Staff,0,0,0,0
1683333942920,AWP 10,008,202041,Staff,0,0,0,0
1683333942920,AWP 10,009,202042,Staff,0,0,0,0
1683333942920,AWP 10,010,202043,Staff,0,0,0,0
1683333942920,AWP 10,011,202044,Staff,0,0,0,0
1683333942920,AWP 10,012,202045,Staff,0,0,0,0
1683333942920,AWP 10,013,202046,Staff,0,0,0,0
1683333942920,AWP 10,014,202047,Staff,0,0,0,0
1683333942920,AWP 10,015,202048,Staff,0,0,0,0
1683333942920,AWP 10,016,202049,Staff,0,0,0,0
1683333942920,AWP 10,017,202050,Staff,0,0,0,0
1683333942920,AWP 10,018,202051,Staff,0,0,0,0
1683333942920,AWP 10,019,202052,Staff,0,0,0,0
1683333942920,AWP 10,020,202053,Staff,0,0,0,0
1683333942920,AWP 10,021,202054,Staff,0,0,0,0
1683333942920,AWP 10,022,202055,Staff,0,0,0,0
1683333942920,AWP 10,023,202056,Staff,0,0,0,0
1683333942920,AWP 10,024,202057,Staff,0,0,0,0
1683333942920,AWP 10,025,202058,Staff,0,0,0,0
1683333942920,AWP 10,026,202059,Staff,0,0,0,0
1683333943947,AWP 102,001,202032,Staff,0,0,0,0
1683333943947,AWP 102,002,202033,Staff,0,0,0,0
1683333944970,BENG 100,A01,254234,Taylor Amos; Alyssa C,31,0,40,9
1683333945996,BENG 196,001,270013,Engler; Adam J.,9999,0,9999,0
1683333947024,BICD 100R,A01,202018,Smith; Laurie,0,7,32,32
1683333947024,BICD 100R,A02,202019,Smith; Laurie,0,2,32,32
1683333947024,BICD 100R,A03,202020,Smith; Laurie,0,1,32,32
1683333947024,BICD 100R,A04,202021,Smith; Laurie,9,0,32,23
1683333947024,BICD 100R,A05,202022,Smith; Laurie,12,0,32,20
1683333948051,BICD 136,A01,193242,Gustafson-Brown; Cindy,0,2,32,32
1683333948051,BICD 136,A02,193244,Gustafson-Brown; Cindy,14,0,32,18
1683333949081,BIEB 102,A01,193249,Butler; Shannon Rhey,0,2,32,32
1683333949081,BIEB 102,A02,193251,Butler; Shannon Rhey,0,0,32,32
1683333949081,BIEB 102,A03,193253,Butler; Shannon Rhey,0,1,32,32
1683333949081,BIEB 102,A04,193255,Butler; Shannon Rhey,17,0,32,15
1683333949081,BIEB 102,A05,193265,Butler; Shannon Rhey,26,0,32,6
1683333949081,BIEB 102,A06,193269,Butler; Shannon Rhey,16,0,32,16
1683333951131,BIEB 150,A01,193274,Staff,0,0,32,32
1683333951131,BIEB 150,A02,193285,Staff,23,0,32,9
1683333952154,BIEB 194,A00,193286,Kurle; Carolyn M.,22,0,32,10
1683333953179,BILD 1,A01,192291,Staff,16,0,32,16
1683333953179,BILD 1,A02,192292,Staff,30,0,32,2
1683333953179,BILD 1,B01,192520,Reuther; Keefe,0,1,0,0
1683333953179,BILD 1,B02,192532,Reuther; Keefe,0,1,0,0
1683333954208,BILD 3,A01,192556,Butler; Shannon Rhey,0,0,32,32
1683333954208,BILD 3,A02,192581,Butler; Shannon Rhey,5,0,32,27
1683333954208,BILD 3,A03,192611,Butler; Shannon Rhey,23,0,32,9
1683333954208,BILD 3,A04,192612,Butler; Shannon Rhey,25,0,32,7
1683333954208,BILD 3,A05,192613,Butler; Shannon Rhey,27,0,32,5
1683333954208,BILD 3,A06,192679,Butler; Shannon Rhey,27,0,32,5
1683333954208,BILD 3,A07,192682,Butler; Shannon Rhey,22,0,32,10
1683333955232,BILD 4,A01,192836,Reuther; Keefe,0,0,24,24
1683333955232,BILD 4,A02,193044,Reuther; Keefe,4,0,24,20
1683333956260,BILD 10,A01,193142,Gustafson-Brown; Cindy,30,0,32,2
1683333956260,BILD 10,A02,193149,Gustafson-Brown; Cindy,31,0,32,1
1683333957285,BIMM 100,A01,193301,Staff,0,6,32,32
1683333957285,BIMM 100,A02,193312,Staff,0,5,32,32
1683333957285,BIMM 100,A03,193323,Staff,0,8,32,32
1683333958308,BIMM 101,A01,193329,McDonnell; Lisa Marie,0,3,24,24
1683333958308,BIMM 101,A02,193339,McDonnell; Lisa Marie,0,3,24,24
1683333958308,BIMM 101,B01,193354,McDonnell; Lisa Marie,0,3,24,24
1683333958308,BIMM 101,B02,193357,McDonnell; Lisa Marie,0,3,24,24
1683333959332,BIMM 110,A01,193377,Tat; John,0,11,32,32
1683333959332,BIMM 110,A02,193378,Tat; John,1,9,32,31
1683333960356,BIMM 120,A01,206116,Staff,0,0,32,32
1683333960356,BIMM 120,A02,206117,Staff,8,0,32,24
1683333960356,BIMM 120,A03,206121,Staff,21,0,32,11
1683333961381,BIPN 100,A01,193393,Park; Ji Young,0,14,32,32
1683333961381,BIPN 100,A02,193402,Park; Ji Young,0,13,32,32
1683333961381,BIPN 100,A03,193413,Park; Ji Young,0,14,32,32
1683333961381,BIPN 100,A04,193414,Park; Ji Young,0,13,32,32
1683333962412,BIPN 102,A01,193429,Staff,0,0,32,32
1683333962412,BIPN 102,A02,193438,Staff,22,0,32,10
1683333963441,BIPN 106,A01,193450,Reyes Gonzalez; Catalina,0,2,40,40
1683333964466,BIPN 134,A01,193465,Cooke; James Edward,0,0,32,32
1683333964466,BIPN 134,A02,193474,Cooke; James Edward,25,0,32,7
1683333964466,BIPN 134,A03,193485,Cooke; James Edward,29,0,32,3
1683333964466,BIPN 134,A04,193486,Cooke; James Edward,21,0,32,11
1683333964466,BIPN 134,A05,193491,Cooke; James Edward,31,0,32,1
1683333964466,BIPN 134,A06,193501,Cooke; James Edward,30,0,32,2
1683333964466,BIPN 134,A07,193510,Cooke; James Edward,29,0,32,3
1683333966514,BISP 194,A00,222522,Staff,14,0,32,18
1683333967541,CAT 124,A01,202407,Staff,20,0,25,5
1683333968569,CAT 125,A00,202408,Marchisotto; Jennifer Anne,4,0,20,16
1683333969594,CAT 125R,A00,202409,Smith; Lauryn Alissa,0,11,20,20
1683333969594,CAT 125R,B00,202410,Morales; Celeste Georgianna,0,11,20,20
1683333969594,CAT 125R,C00,202411,Irwin; Matthew Joseph,0,10,20,20
1683333970620,CENG 15,A01,204712,Yang; Kesong,0,1,0,0
1683333971644,CENG 114,A00,202070,Jahed Motlagh; Zeinab,5,0,20,15
1683333972671,CGS 105,A00,185477,Wesling; Megan E.,24,0,40,16
1683333973695,CGS 106,A00,185494,Staff,13,0,22,9
1683333974719,CGS 108,A00,185495,Staff,14,0,20,6
1683333975744,CGS 114,A00,185496,Staff,13,0,18,5
1683333976768,CGS 119,A00,185501,Staff,15,0,20,5
1683333977797,CGS 120,A00,185511,Staff,13,0,20,7
1683333978821,CHEM 4,A01,184675,Bussey; Thomas J,96,0,100,4
1683333979846,CHEM 6A,A01,184677,Staff,34,0,60,26
1683333980869,CHEM 6B,A01,184679,Staff,65,0,100,35
1683333981892,CHEM 6C,A01,184681,Bussey; Thomas J,1,0,50,49
1683333981892,CHEM 6C,A02,184682,Bussey; Thomas J,34,0,50,16
1683333982920,CHEM 40A,A01,184684,Albizati; Kim F.,37,0,100,63
1683333983947,CHEM 40B,A01,184686,Albizati; Kim F.,0,20,100,100
1683333984975,CHEM 41B,A01,184690,Staff,52,0,100,48
1683333986003,COGS 3,A01,184715,Boyle; Mary E. T.,0,25,40,40
1683333987030,COGS 14B,A01,185172,Staff,0,15,38,38
1683333988058,COGS 18,A01,184736,Staff,17,0,80,63
1683333989082,COGS 100,A01,184932,Staff,0,5,73,73
1683333990108,COGS 101A,A01,184935,Staff,0,39,30,30
1683333991132,COGS 101B,A01,184944,Staff,0,2,30,30
1683333992160,COGS 101C,A01,184946,Staff,0,12,30,30
1683333993187,COGS 102A,A01,184951,Johnson; Christine M.,2,0,40,38
1683333994214,COGS 107B,A01,184953,Mooshagian; Eric Frederick,0,50,40,40
1683333995239,COGS 118B,A01,184959,Gupta; Anjum,0,48,40,40
1683333996264,COGS 153,A00,184961,Staff,0,15,30,30
1683333997288,COGS 177,A00,184962,Staff,0,20,30,30
1683333998316,COGS 187A,A01,184969,Boyle; Mary E. T.,0,17,40,40
1683333999341,COMM 10,A01,185174,Staff,0,5,25,25
1683333999341,COMM 10,A02,185189,Staff,0,5,25,25
1683333999341,COMM 10,A03,269821,Staff,0,0,0,0
1683334000366,COMM 100B,A01,185475,Staff,0,0,0,2
1683334000366,COMM 100B,A02,185476,Staff,14,0,25,11
1683334001388,COMM 100C,A01,185314,Staff,1,0,25,24
1683334001388,COMM 100C,A02,185327,Staff,19,0,25,6
1683334002415,COMM 110M,A00,185349,Staff,2,0,40,38
1683334003439,COMM 113T,A00,185352,Staff,24,0,40,16
1683334004464,COMM 114I,A00,185353,Staff,33,0,40,7
1683334005486,COMM 131,A00,185354,Staff,19,0,30,11
1683334006511,CSE 8A,A50,185358,Cao; Yingjun,0,46,10,10
1683334007535,CSE 8B,A01,185362,Staff,1,47,50,49
1683334008559,CSE 11,A01,185416,Cao; Yingjun,0,92,10,10
1683334009587,CSE 20,A01,185445,Briones; Jor-el Thomas Caparas,5,0,25,20
1683334010615,CSE 21,A01,185447,Staff,10,0,50,40
1683334011644,CSE 101,A01,185451,Staff,0,12,50,50
1683334011644,CSE 101,B01,185453,Jones; Miles E,0,11,50,50
1683334013694,CSE 141,A01,185458,Eldon; John,20,0,100,80
1683334014723,CSE 141L,A01,185461,Eldon; John,12,0,100,88
1683334015751,CSE 142,A01,185463,Staff,36,0,60,24
1683334015751,CSE 142,B01,201355,Staff,0,7,60,60
1683334016779,CSE 142L,A01,185470,Staff,36,0,60,24
1683334016779,CSE 142L,B01,201417,Staff,0,6,60,60
1683334017803,CSE 190,A00,201433,Staff,32,0,49,17
1683334018829,DOC 1,A01,259136,Strom; Megan C.,7,0,15,8
1683334018829,DOC 1,A02,259137,Strom; Megan C.,14,0,15,1
1683334018829,DOC 1,A03,259138,Strom; Megan C.,14,0,15,1
1683334018829,DOC 1,A04,259139,Strom; Megan C.,14,0,15,1
1683334019854,DOC 100D,A00,259140,Pass; Natalye Joann,16,0,25,9
1683334020878,DSGN 1,A01,184749,Rill; Bryan,0,25,30,30
1683334021907,DSGN 100,A01,185168,Staff,0,2,25,25
1683334022935,ECE 5,A01,185626,Morris; Karcher William,0,10,0,0
1683334023960,ECE 101,A01,185628,Staff,17,0,70,53
1683334025040,ECE 107,A01,185635,Baghdadchi; Saharnaz,0,0,20,20
1683334025040,ECE 107,A02,185638,Baghdadchi; Saharnaz,4,0,20,16
1683334026063,ECE 148,A01,185647,Silberman; Jack,0,0,16,16
1683334027092,ECON 1,A01,185537,Crane; Meredith Helen,54,0,70,16
1683334028120,ECON 3,A01,185549,Crane; Meredith Helen,33,0,70,37
1683334029143,ECON 4,A01,203354,Anderson; John Charles,0,4,10,10
1683334030165,ECON 100A,A01,185574,Staff,0,4,40,40
1683334031189,ECON 100B,A01,185576,Staff,10,22,50,40
1683334032218,ECON 100C,A01,185589,Newhouse; Herbert S,30,0,70,40
1683334033241,ECON 105,A00,185608,Vespa; Emanuel Ignacio,19,0,35,16
1683334034266,ECON 109,A01,185610,Shishkin; Denis,10,0,35,25
1683334035295,ECON 110A,A01,185612,Staff,11,0,40,29
1683334036320,ECON 120A,A01,185615,Staff,20,0,40,20
1683334037345,ECON 120C,A01,185617,Sun; Yixiao,0,20,70,70
1683334038373,ECON 144,A00,203346,Squires; Dale E,3,0,35,32
1683334039398,ECON 171,A01,203349,Newhouse; Herbert S,0,1,35,35
1683334040437,ECON 173A,A01,185621,Toda; Alexis Akira,21,0,35,14
1683334041465,EDS 25,A01,202413,Staff,0,1,0,0
1683334041465,EDS 25,A02,202414,Staff,0,1,0,0
1683334041465,EDS 25,A03,202415,Staff,0,0,0,0
1683334041465,EDS 25,A04,202416,Staff,0,1,0,0
1683334041465,EDS 25,A05,202439,Staff,0,0,0,0
1683334041465,EDS 25,A06,202440,Staff,0,0,0,0
1683334041465,EDS 25,B01,202631,Staff,0,0,0,0
1683334041465,EDS 25,B02,202632,Staff,0,0,0,0
1683334041465,EDS 25,B03,202639,Staff,0,0,0,0
1683334041465,EDS 25,B04,202640,Staff,0,0,0,0
1683334041465,EDS 25,B05,202643,Staff,0,0,0,0
1683334041465,EDS 25,B06,202644,Staff,0,0,0,0
1683334042490,EDS 38,A01,202659,Black; Alison Michelle,24,0,25,1
1683334043516,EDS 115,A00,202652,Staff,17,0,30,13
1683334044544,EDS 125,A00,202649,Staff,14,0,30,16
1683334045571,EDS 126,A01,203332,Staff,30,0,30,0
1683334046595,EDS 139,A00,202838,Staff,16,0,25,9
1683334047622,EDS 146,A01,202655,Staff,14,0,25,11
1683334048647,ENG 15,A00,185667,Staff,0,1,0,0
1683334048647,ENG 15,B00,185672,Staff,0,0,0,0
1683334048647,ENG 15,C00,185675,Staff,0,0,0,0
1683334048647,ENG 15,D00,185682,Staff,0,0,0,0
1683334048647,ENG 15,E00,185684,Staff,0,0,0,0
1683334049672,ETHN 103,A00,185710,Staff,0,3,35,35
1683334050697,ETHN 103A,A00,199228,Man; Simeon S,2,0,9,7
1683334051725,ETHN 109,A00,185711,Staff,18,0,35,17
1683334052749,ETHN 142,A00,185726,Staff,0,4,30,30
1683334053778,ETHN 163J,A00,199229,Man; Simeon S,5,0,8,3
1683334054805,ETHN 168,A00,185727,Staff,8,0,10,2
1683334055831,ETHN 182,A00,185728,Staff,1,0,35,34
1683334056857,ETHN 183,A00,185737,Staff,8,0,18,10
1683334057884,GLBH 111,A01,209361,Burgos; Jose L.,0,0,0,0
1683334059936,HIEU 104,A00,185792,Staff,16,0,20,4
1683334060962,HIEU 115,A00,185800,Staff,1,0,20,19
1683334061990,HIEU 128,A00,185801,Staff,0,7,20,20
1683334063014,HIEU 147,A00,185802,Staff,16,0,20,4
1683334064038,HIEU 154,A00,185823,Staff,12,0,20,8
1683334065062,HILA 102,A00,185826,Staff,13,0,20,7
1683334066087,HILD 2C,A01,185778,Staff,0,12,20,20
1683334067111,HILD 7B,A01,185780,Kwak; Nancy,0,15,32,32
1683334067111,HILD 7B,A02,185781,Kwak; Nancy,0,18,32,32
1683334068138,HILD 30,A01,185791,Staff,14,0,20,6
1683334069165,HISC 119,A00,185830,Golan; Tal,0,9,20,20
1683334070192,HITO 156GS,A00,185831,Patterson; Patrick H.,0,0,0,23
1683334071217,HIUS 103,A00,185832,Man; Simeon S,0,6,20,20
1683334072243,HIUS 117,A00,185836,Kwak; Nancy,2,0,20,18
1683334073268,HIUS 125,A00,185840,Man; Simeon S,0,0,23,23
1683334074292,HIUS 149,A00,185845,Staff,0,0,20,20
1683334075318,HUM 3,A01,185882,Zavodny; Tatiana Sophia,0,7,50,50
1683334075318,HUM 3,B01,185899,Caldwell; Michael Alan,0,18,50,50
1683334076341,HUM 3GS,A00,185900,Patterson; Patrick H.,0,0,0,23
1683334077366,HUM 4,A01,185938,Zroka; Amy Liane,31,0,50,19
1683334077366,HUM 4,B01,185956,Watkins; Eric,0,2,50,50
1683334077366,HUM 4,B02,202209,Watkins; Eric,0,2,50,50
1683334077366,HUM 4,B03,202210,Watkins; Eric,0,2,50,50
1683334078391,HUM 5,A01,185958,West; Geoffrey Scott,3,0,50,47
1683334078391,HUM 5,A02,202215,West; Geoffrey Scott,0,0,50,50
1683334079416,INTL 190,A00,185959,Gagnon; Jeffrey C,0,0,0,9
1683334079416,INTL 190,B00,185960,Lettieri; Michael Joseph,0,0,0,1
1683334080458,JAPN 180,A00,254509,Staff,5,1,30,25
1683334081490,LATI 10,A01,202853,Kennemore; Amy Michelle,4,0,35,31
1683334081490,LATI 10,A02,202854,Kennemore; Amy Michelle,2,0,35,33
1683334081490,LATI 10,A03,270054,Kennemore; Amy Michelle,30,0,30,0
1683334082518,LATI 180,A00,202855,Kennemore; Amy Michelle,11,0,20,9
1683334083543,LAWS 101,A00,201767,Golan; Tal,0,7,40,40
1683334084572,LIFR 1C,A00,185961,Staff,6,0,20,14
1683334085601,LIFR 1CX,A00,185962,Staff,7,0,20,13
1683334086628,LIFR 1D,A00,185963,Staff,9,0,20,11
1683334087656,LIFR 1DX,A00,185964,Staff,9,0,20,11
1683334088680,LIGN 101,A01,186039,Staff,43,0,50,7
1683334089704,LIGN 165,A00,186040,Staff,18,0,50,32
1683334090729,LTCS 108,A00,186041,Staff,6,0,10,4
1683334091753,LTCS 119,A00,186042,Staff,16,0,20,4
1683334092781,LTCS 130,A00,186043,Wesling; Megan E.,15,0,25,10
1683334094832,LTEA 138,A00,186119,Staff,14,0,40,26
1683334095857,LTEN 124,A00,186148,Staff,6,0,25,19
1683334096880,LTEN 178,A00,186149,Staff,7,0,15,8
1683334097908,LTEN 181,A00,186150,Blanco; John D,33,0,40,7
1683334098931,LTWL 120,A00,186160,Staff,20,0,25,5
1683334099954,LTWL 165,A00,186161,Staff,22,0,25,3
1683334100981,LTWR 100,A00,186162,Staff,0,5,15,15
1683334102006,LTWR 102,A00,186163,Doller; Ben,5,0,15,10
1683334103033,MAE 8,A01,186412,Staff,0,0,0,0
1683334104058,MAE 30B,A00,186445,Bahadori; Mohammad Yousef,83,0,100,17
1683334105087,MAE 40,A00,186592,Bewley; Thomas R,9,0,50,41
1683334106115,MAE 101B,A00,186593,Bahadori; Mohammad Yousef,81,0,100,19
1683334107142,MAE 105,A00,186594,Bandaru; Prabhakar,12,0,50,38
1683334108169,MAE 107,A00,186599,Pham; Hieu Tan,0,6,120,120
1683334109193,MAE 148,A01,186660,Silberman; Jack,3,0,16,13
1683334110221,MATH 10A,A01,188095,Staff,1,6,35,34
1683334111245,MATH 10B,A01,188097,Bowers; Adam R.,0,11,30,30
1683334111245,MATH 10B,A02,188099,Bowers; Adam R.,0,11,30,30
1683334111245,MATH 10B,B01,188104,Bowers; Adam R.,0,10,30,30
1683334111245,MATH 10B,B02,188106,Bowers; Adam R.,0,10,30,30
1683334112270,MATH 10C,A01,188111,Staff,0,18,30,30
1683334112270,MATH 10C,A02,188127,Staff,0,17,30,30
1683334112270,MATH 10C,A03,188131,Staff,0,18,30,30
1683334112270,MATH 10C,B01,188218,Staff,18,0,30,12
1683334112270,MATH 10C,B02,188244,Staff,13,0,30,17
1683334112270,MATH 10C,B03,188277,Staff,16,0,30,14
1683334113300,MATH 18,A01,188344,Bach; Quang Tran,18,0,30,12
1683334113300,MATH 18,A02,188345,Bach; Quang Tran,11,0,30,19
1683334113300,MATH 18,B01,188353,Bach; Quang Tran,10,0,30,20
1683334113300,MATH 18,B02,188354,Bach; Quang Tran,20,0,30,10
1683334114326,MATH 20A,A01,188374,Staff,13,0,35,22
1683334115352,MATH 20B,A01,188382,Ohm; Ko Woon,6,0,30,24
1683334115352,MATH 20B,A02,188383,Ohm; Ko Woon,22,0,30,8
1683334115352,MATH 20B,B01,188385,Ohm; Ko Woon,7,0,30,23
1683334115352,MATH 20B,B02,188392,Ohm; Ko Woon,22,0,30,8
1683334116385,MATH 20C,A01,188394,Harel; Guershon,10,0,30,20
1683334116385,MATH 20C,A02,188395,Harel; Guershon,15,0,30,15
1683334116385,MATH 20C,B01,188404,Harel; Guershon,5,0,30,25
1683334116385,MATH 20C,B02,188405,Harel; Guershon,19,0,30,11
1683334117409,MATH 20D,A01,188414,Hammock; Frances H,0,1,30,30
1683334117409,MATH 20D,A02,188415,Hammock; Frances H,3,0,30,27
1683334117409,MATH 20D,B01,188447,Hammock; Frances H,1,0,30,29
1683334117409,MATH 20D,B02,188486,Hammock; Frances H,8,0,30,22
1683334118434,MATH 20E,A01,188649,Staff,21,0,30,9
1683334118434,MATH 20E,A02,188650,Staff,23,0,30,7
1683334118434,MATH 20E,A03,188673,Staff,0,0,30,30
1683334119458,MATH 102,A01,188675,Staff,0,35,35,35
1683334120486,MATH 103B,A01,188681,Staff,3,0,35,32
1683334120486,MATH 103B,B01,188692,Staff,5,0,35,30
1683334121511,MATH 109,A01,188695,Salehi Golsefidy; Alireza,25,0,35,10
1683334121511,MATH 109,A02,188696,Salehi Golsefidy; Alireza,25,0,35,10
1683334122535,MATH 120A,A01,188698,Eggers; John Dietrich,7,0,35,28
1683334123561,MATH 142B,A01,188736,Ioana; Adrian,0,2,30,30
1683334123561,MATH 142B,A02,188741,Ioana; Adrian,1,1,30,29
1683334123561,MATH 142B,A03,188743,Ioana; Adrian,1,3,30,29
1683334124583,MATH 168A,A01,188790,Staff,0,9,35,35
1683334125612,MATH 170A,A01,188803,Nie; Jiawang,0,2,35,35
1683334125612,MATH 170A,A02,188811,Nie; Jiawang,0,0,35,35
1683334125612,MATH 170A,A03,188814,Nie; Jiawang,1,0,35,34
1683334125612,MATH 170A,A04,188815,Nie; Jiawang,13,0,35,22
1683334126640,MATH 193B,A01,188817,Staff,0,0,35,35
1683334126640,MATH 193B,A02,188818,Staff,5,0,35,30
1683334127664,MGT 4,A01,202857,Anderson; John Charles,62,0,80,18
1683334128750,MGT 12,A00,202858,Lindenberger; Wade Douglas,42,0,90,48
1683334129774,MGT 18,A00,202859,Staff,74,0,90,16
1683334130798,MGT 18GS,A00,202860,McKay; Michael J,13,0,28,15
1683334131822,MGT 45,A00,202861,Pecore; Joseph P.,14,0,90,76
1683334132849,MGT 100,A00,202863,Yavorsky; Daniel Ryan,28,0,90,62
1683334133876,MGT 103,A00,202864,Ehrich; Kristine R,1,18,90,89
1683334134903,MGT 112,A00,202865,Ehrich; Kristine R,15,0,90,75
1683334135928,MGT 121A,A00,202868,Staff,0,20,0,0
1683334136953,MGT 131B,A00,202869,Anderson; John Charles,59,0,90,31
1683334137977,MGT 136,A00,202871,Lindenberger; Wade Douglas,84,0,90,6
1683334139002,MGT 164,A00,202873,Staff,0,68,90,91
1683334140026,MGT 164GS,A00,202874,McKay; Mary A,13,0,28,15
1683334141051,MGT 180,A00,202875,Staff,0,50,90,91
1683334142081,MMW 11R,A01,205019,Herbst; Matthew,3,0,30,27
1683334142081,MMW 11R,A02,205026,Herbst; Matthew,29,0,30,1
1683334143109,MMW 15,A01,193512,Chang; Edmond Yi-Teh,0,9,28,28
1683334143109,MMW 15,A02,193513,Chang; Edmond Yi-Teh,0,5,28,28
1683334143109,MMW 15,A03,193514,Chang; Edmond Yi-Teh,0,5,28,28
1683334143109,MMW 15,A04,193515,Chang; Edmond Yi-Teh,0,5,28,28
1683334143109,MMW 15,A05,193516,Chang; Edmond Yi-Teh,0,4,28,28
1683334143109,MMW 15,A06,193517,Chang; Edmond Yi-Teh,0,5,28,28
1683334143109,MMW 15,B01,193519,Chang; Edmond Yi-Teh,0,5,28,28
1683334143109,MMW 15,B02,193520,Chang; Edmond Yi-Teh,0,5,28,28
1683334143109,MMW 15,B03,193521,Chang; Edmond Yi-Teh,0,5,28,28
1683334143109,MMW 15,B04,193522,Chang; Edmond Yi-Teh,0,4,28,28
1683334143109,MMW 15,B05,193523,Chang; Edmond Yi-Teh,0,5,28,28
1683334143109,MMW 15,B06,193524,Chang; Edmond Yi-Teh,0,4,28,28
1683334144140,MMW 122,A01,193526,Rahimi; Babak,0,15,28,28
1683334144140,MMW 122,A02,193527,Rahimi; Babak,0,14,28,28
1683334144140,MMW 122,A03,193528,Rahimi; Babak,0,0,0,0
1683334144140,MMW 122,A04,193529,Rahimi; Babak,0,0,0,0
1683334145164,MUS 1A,A01,186663,Staff,0,20,35,35
1683334146191,MUS 4,A01,186715,Staff,0,12,35,35
1683334147216,MUS 5R,A01,186796,Dubnov; Shlomo,0,17,35,35
1683334148240,MUS 6,A01,186798,Staff,0,4,25,25
1683334149266,MUS 7,A01,186830,Staff,12,0,35,23
1683334161575,MUS 8,A01,186930,Staff,0,26,35,35
1683334162599,MUS 15,A01,186932,Staff,0,16,35,35
1683334162599,MUS 15,B01,186934,Staff,0,15,35,35
1683334163627,MUS 80,A00,186935,Staff,1,0,20,19
1683334163627,MUS 80,B00,186936,Staff,25,0,25,0
1683334164654,NANO 11,A00,204702,Lipomi; Darren John,0,0,0,0
1683334165681,NANO 15,A01,204709,Yang; Kesong,0,1,0,0
1683334166708,NANO 114,A00,202069,Jahed Motlagh; Zeinab,3,0,10,7
1683334167734,PHIL 1,A00,186955,Grush; Rick Scott,32,0,40,8
1683334168758,PHIL 10,A01,186973,Grush; Rick Scott,28,0,35,7
1683334168758,PHIL 10,A02,186974,Grush; Rick Scott,33,0,35,2
1683334169781,PHIL 13,A01,186976,Staff,7,0,35,28
1683334169781,PHIL 13,A02,186977,Staff,16,0,35,19
1683334170804,PHIL 14,A01,186979,Staff,31,0,35,4
1683334170804,PHIL 14,A02,186986,Staff,32,0,35,3
1683334171830,PHIL 28,A01,186988,Staff,16,0,30,14
1683334171830,PHIL 28,A02,186989,Staff,1,0,30,29
1683334171830,PHIL 28,A03,186990,Staff,9,0,30,21
1683334171830,PHIL 28,A04,186991,Staff,26,0,30,4
1683334172854,PHIL 120,A00,186997,Staff,23,0,40,17
1683334173882,PHIL 137,A00,187003,Staff,9,0,40,31
1683334174912,PHIL 150,A00,187015,Staff,47,0,70,23
1683334175940,PHIL 167,A00,187021,Lamey; Andy M.,35,0,40,5
1683334176963,PHIL 174,A01,202226,Staff,17,0,20,3
1683334176963,PHIL 174,A02,202235,Staff,20,0,20,0
1683334177986,PHIL 191A,A00,258918,Staff,0,0,1,1
1683334179008,PHYS 1A,A00,187028,Staff,27,0,60,33
1683334180036,PHYS 1AL,001,187036,Staff,3,0,30,27
1683334180036,PHYS 1AL,002,187049,Staff,18,0,30,12
1683334181064,PHYS 1B,A00,187058,Staff,22,0,60,38
1683334182087,PHYS 1BL,001,187064,Staff,0,0,30,30
1683334182087,PHYS 1BL,002,187070,Staff,5,0,30,25
1683334183111,PHYS 1C,A00,187082,Staff,31,0,120,89
1683334184134,PHYS 1CL,001,187088,Staff,0,9,30,30
1683334184134,PHYS 1CL,002,187089,Staff,0,2,30,30
1683334184134,PHYS 1CL,009,262693,Staff,11,0,30,19
1683334185161,PHYS 2B,A01,187097,Staff,54,0,115,61
1683334186184,PHYS 2C,A01,187099,Staff,67,0,115,48
1683334187207,PHYS 2CL,A01,187101,Staff,5,0,28,23
1683334187207,PHYS 2CL,A02,187102,Staff,15,0,28,13
1683334188231,PHYS 2D,A01,187123,Shotwell; Brian,95,0,115,20
1683334189255,PHYS 4B,A01,187133,Grinstein; Benjamin,35,0,50,15
1683334190279,POLI 10,A00,188819,Staff,0,4,50,50
1683334191305,POLI 11,A00,188827,Staff,43,0,50,7
1683334192329,POLI 13R,A00,188828,Staff,0,1,20,20
1683334193356,POLI 27,A01,188830,Elgin; Samuel Zincke,0,1,70,70
1683334194382,POLI 30,A00,188832,Desposato; Scott,31,0,50,19
1683334195408,POLI 102F,A00,188834,Staff,3,0,40,37
1683334196433,POLI 104A,A00,188852,Staff,14,0,30,16
1683334197460,POLI 104I,A00,188853,Staff,0,6,20,20
1683334198488,POLI 110B,A00,188854,Wiens; David,7,0,20,13
1683334199513,POLI 112A,A00,188855,Wiens; David,5,0,30,25
1683334200538,POLI 117R,A00,188856,Forman; Fonna,0,11,20,20
1683334201562,POLI 118,A00,188857,Ingham; Sean,8,0,20,12
1683334202585,POLI 120G,A00,188858,Staff,9,0,30,21
1683334203609,POLI 131CR,A00,188863,Hoston; Germaine,24,0,50,26
1683334204635,POLI 133,A00,188864,Nellis; Gareth Hb,44,0,50,6
1683334205665,POLI 134D,A00,188865,Desposato; Scott,27,0,30,3
1683334206688,POLI 142A,A00,188871,Gartzke; Erik,22,0,50,28
1683334207711,POLI 142K,A00,188874,Staff,38,0,50,12
1683334208735,POLI 143,A00,188940,Gartzke; Erik,16,0,30,14
1683334209762,POLI 153,A00,188943,Staff,3,0,20,17
1683334210785,POLI 160AA,A00,188944,Staff,12,0,40,28
1683334211808,POLI 170A,A00,188945,Staff,11,0,30,19
1683334213855,PSYC 1,A00,188952,Staff,37,0,90,53
1683334214880,PSYC 2,B00,188953,Staff,19,0,35,16
1683334215903,PSYC 6,A00,188970,Staff,47,0,60,13
1683334216927,PSYC 7,A00,188973,Staff,37,0,45,8
1683334217957,PSYC 60,A01,188980,Rickard; Timothy C.,43,0,60,17
1683334218984,PSYC 70,A01,189001,Steiner; Eric Tomas,24,0,45,21
1683334220007,PSYC 100,A00,189005,Lacefield; Katharine I,0,100,120,120
1683334221034,PSYC 102,A00,189008,Staff,9,0,30,21
1683334222057,PSYC 106,B00,189026,Gorman; Michael R.,34,0,60,26
1683334223082,PSYC 114,B01,189033,Winkielman; Piotr,0,32,30,30
1683334224107,PSYC 131,A00,189036,Anagnostaras; Stephan,0,43,60,60
1683334225134,PSYC 136,A00,189041,Lowe; Angela Beth,0,7,25,25
1683334226161,PSYC 137,A00,189057,Winkielman; Piotr,0,34,25,25
1683334227185,PSYC 144,A00,189107,Wixted; John T,0,7,50,50
1683334229230,PSYC 162,A00,189142,Staff,0,8,85,85
1683334230254,PSYC 172,A00,189144,Gorman; Michael R.,0,7,30,30
1683334232306,PSYC 179,A00,189146,Lacefield; Katharine I,0,84,120,120
1683334233333,PSYC 181,A00,189147,Anagnostaras; Stephan,0,44,90,90
1683334234360,PSYC 190R,A00,189148,Barner; David A.,0,22,80,80
1683334235384,PSYC 191,A00,189275,Rickard; Timothy C.,0,7,25,25
1683334236408,PSYC 193,A00,189276,Chapman; Eddie Nathaniel,0,1,0,4
1683334237436,PSYC 193L,A01,189281,Lowe; Angela Beth,12,0,20,8
1683334237436,PSYC 193L,B01,189285,Staff,28,0,35,7
1683334238459,RELI 149,A00,187137,Rahimi; Babak,7,0,40,33
1683334239487,SE 9,A01,187315,Staff,0,2,18,18
1683334240515,SE 101B,A00,187409,Staff,24,0,30,6
1683334241543,SE 110B,A00,187444,Staff,10,0,40,30
1683334242567,SE 130B,A00,187449,Staff,31,0,40,9
1683334243644,SE 150A,A00,187516,Staff,9,0,20,11
1683334244669,SE 154,A00,187528,Staff,30,0,50,20
1683334245693,SIO 3,A01,258171,Staff,35,0,40,5
1683334246717,SIO 10,A00,187144,Cook; Geoffrey W,0,3,75,75
1683334247741,SIO 45,A00,187152,Cook; Geoffrey W,1,0,100,99
1683334248769,SIO 109R,A00,194486,Staff,0,3,20,20
1683334250818,SIO 187,A01,187233,Kacev; David,12,0,40,28
1683334251841,SOCI 1,A01,258656,Thorpe; Charles Robert,28,0,30,2
1683334251841,SOCI 1,A02,258658,Thorpe; Charles Robert,30,0,30,0
1683334251841,SOCI 1,A03,258661,Thorpe; Charles Robert,25,0,25,0
1683334251841,SOCI 1,A04,258666,Thorpe; Charles Robert,22,0,25,3
1683334251841,SOCI 1,A05,258897,Thorpe; Charles Robert,23,0,25,2
1683334251841,SOCI 1,A06,258898,Thorpe; Charles Robert,25,0,25,0
1683334252867,SOCI 30,A01,258903,Pardo Guerra; Juan Pablo,15,0,30,15
1683334253894,SOCI 102,A00,258904,Staff,9,0,25,16
1683334254917,SOCI 106,A00,258905,Staff,19,0,25,6
1683334255941,SOCI 111,A00,258907,Ribas Norris; Janet Vanesa,26,0,30,4
1683334256968,SOCI 121R,A00,258908,Pardo Guerra; Juan Pablo,10,0,30,20
1683334257995,SOCI 126,A01,203330,Staff,14,0,20,6
1683334259020,SOCI 131,A00,258909,Thorpe; Charles Robert,31,0,60,29
1683334260044,SOCI 135,A00,258910,Payne; Christine Anna,0,9,30,30
1683334261067,SOCI 157,A00,258911,Staff,12,0,30,18
1683334262091,SOCI 184,A00,258912,Staff,25,0,30,5
1683334263114,SOCI 188D,A00,258913,Staff,21,0,30,9
1683334264138,SYN 2,001,187529,Staff,10,0,16,6
1683334264138,SYN 2,002,201452,Staff,0,18,16,16
1683334264138,SYN 2,003,201469,Staff,3,0,16,13
1683334265161,SYN 100,A01,187531,Staff,0,9,20,20
1683334265161,SYN 100,B01,201491,Staff,0,12,20,20
1683334266186,TDAC 1,A00,189286,Walsh; Kim C.,3,0,20,17
1683334266186,TDAC 1,B00,189287,Harting; Carla Kelso,11,0,20,9
1683334267210,TDAC 101,A00,189300,Walsh; Kim C.,16,0,20,4
1683334267210,TDAC 101,B00,189301,Harting; Carla Kelso,18,0,20,2
1683334268234,TDAC 102,A00,189304,Basso; Beatrice,14,0,20,6
1683334269258,TDAC 108,A00,189305,Staff,18,0,20,2
1683334270290,TDDE 131,A00,189310,Staff,19,0,20,1
1683334270290,TDDE 131,B00,189314,Staff,19,0,20,1
1683334270290,TDDE 131,C00,189315,Staff,48,0,50,2
1683334270290,TDDE 131,D00,189316,Staff,14,0,15,1
1683334270290,TDDE 131,E00,204841,Staff,20,0,20,0
1683334271318,TDGE 10,A00,189289,Staff,30,0,50,20
1683334271318,TDGE 10,B00,189290,Havis; Allan,1,0,50,49
1683334272347,TDGE 11,A00,189291,Fulton; Julia,0,3,50,50
1683334272347,TDGE 11,B00,189292,Staff,20,0,25,5
1683334272347,TDGE 11,C00,260270,Staff,0,0,0,0
1683334273371,TDGE 25,A00,189294,Staff,3,0,20,17
1683334274397,TDGE 124,A00,189318,Fulton; Julia,0,8,50,50
1683334275421,TDGE 125,A00,189319,Staff,13,0,25,12
1683334275421,TDGE 125,B00,189320,Staff,23,0,25,2
1683334276444,TDGE 127,A00,189322,Havis; Allan,0,0,50,50
1683334277468,TDHT 101,A00,189323,Staff,18,0,25,7
1683334277468,TDHT 101,B00,189324,Staff,25,0,25,0
1683334278495,TDHT 102,A00,189325,Staff,49,0,50,1
1683334279520,TDMV 1,A00,189295,Arcidiacono; Kristin,19,0,30,11
1683334279520,TDMV 1,B00,189296,Caligagan; Maria T.,24,0,30,6
1683334280549,TDMV 2,A00,189297,Sammartano; Tonnie,28,0,30,2
1683334280549,TDMV 2,B00,189299,Arcidiacono; Kristin,24,0,30,6
1683334281573,TDMV 3,A00,204998,Rincon; Alicia,22,0,30,8
1683334282601,TDMV 120,A00,189458,Sammartano; Tonnie,28,0,30,2
1683334283625,TDMV 138,A00,189541,Jun; Grace Shin Hae,22,0,40,18
1683334284653,TDMV 142,A00,189717,Caligagan; Tony,23,0,30,7
1683334284653,TDMV 142,B00,189718,Caligagan; Maria T.,25,0,30,5
1683334285677,TMC 2,A01,187533,Staff,25,0,25,0
1683334285677,TMC 2,A02,187534,Staff,25,0,25,0
1683334286701,USP 1,A01,187536,Kwak; Nancy,0,16,25,25
1683334287725,USP 5,A01,187538,Staff,10,0,25,15
1683334288749,USP 101,A00,199253,Staff,0,4,0,0
1683334289773,USP 124,A00,187562,Boomhower; Matthew Charles,1,0,30,29
1683334290800,USP 138,A00,187582,Staff,20,0,25,5
1683334291825,USP 152,A01,187597,Staff,4,0,25,21
1683334292853,USP 153,A00,187598,Staff,19,0,25,6
1683334293878,USP 168,A00,187607,Kwak; Nancy,2,0,5,3
1683334294902,USP 173,A00,187619,Staff,4,0,25,21
1683334295927,USP 181,A00,187638,Staff,0,0,25,25
1683334296953,VIS 103,A00,187650,Cruz; Edwin Teddy,23,0,75,52
1683334297980,VIS 110D,A00,187669,Staff,12,0,22,10
1683334299004,VIS 127C,A00,187720,Shen; Kuiyi,67,0,146,79
1683334300027,VIS 149,A00,187731,Yoldas; Pinar,0,14,22,22
1683334301051,VIS 151,A01,188091,Staff,22,0,34,12
1683334301051,VIS 151,A02,188092,Staff,11,0,34,23
1683334302077,VIS 160B,A00,188093,Stalbaum; Brett,0,0,10,10
1683334304126,WCWP 10B,A00,201720,Staff,10,0,15,5
1683334304126,WCWP 10B,B00,201722,Staff,8,0,15,7
1683334305149,WCWP 100,A00,201725,Gagnon; Jeffrey C,0,0,2,2
1683334305149,WCWP 100,B00,201727,Staff,0,4,15,15
1683334308241,ANBI 133,A00,258401,Wilder; Linnea Lorene,34,0,40,6
1683334309265,ANBI 140,A00,258395,Hrvoj Mihic; Branka,18,0,25,7
1683334310293,ANSC 120,A00,258402,Bialecki; Jon Anthony,27,0,40,13
1683334311321,ANSC 144,A00,258400,Staff,14,0,40,26
1683334313375,ANSC 166,A00,258396,Parish; Steven Martin,157,0,175,18
1683334314402,ANSC 180,A00,193533,Staff,9,0,20,11
1683334315429,ANSC 188,A00,258397,Jassal; Aftab,33,0,40,7
1683334316452,ANTH 3,A01,258316,Staff,23,0,30,7
1683334317479,ANTH 5,A00,258394,Semendeferi; Ekaterini,16,0,20,4
1683334318508,ANTH 21,A01,258331,Staff,8,0,40,32
1683334319534,ANTH 103,A00,258398,Varma; Saiba,15,0,25,10
1683334320569,AWP 10,001,202034,Staff,0,0,0,0
1683334320569,AWP 10,002,202035,Staff,0,0,0,0
1683334320569,AWP 10,003,202036,Staff,0,0,0,0
1683334320569,AWP 10,004,202037,Staff,0,0,0,0
1683334320569,AWP 10,005,202038,Staff,0,0,0,0
1683334320569,AWP 10,006,202039,Staff,0,0,0,0
1683334320569,AWP 10,007,202040,Staff,0,0,0,0
1683334320569,AWP 10,008,202041,Staff,0,0,0,0
1683334320569,AWP 10,009,202042,Staff,0,0,0,0
1683334320569,AWP 10,010,202043,Staff,0,0,0,0
1683334320569,AWP 10,011,202044,Staff,0,0,0,0
1683334320569,AWP 10,012,202045,Staff,0,0,0,0
1683334320569,AWP 10,013,202046,Staff,0,0,0,0
1683334320569,AWP 10,014,202047,Staff,0,0,0,0
1683334320569,AWP 10,015,202048,Staff,0,0,0,0
1683334320569,AWP 10,016,202049,Staff,0,0,0,0
1683334320569,AWP 10,017,202050,Staff,0,0,0,0
1683334320569,AWP 10,018,202051,Staff,0,0,0,0
1683334320569,AWP 10,019,202052,Staff,0,0,0,0
1683334320569,AWP 10,020,202053,Staff,0,0,0,0
1683334320569,AWP 10,021,202054,Staff,0,0,0,0
1683334320569,AWP 10,022,202055,Staff,0,0,0,0
1683334320569,AWP 10,023,202056,Staff,0,0,0,0
1683334320569,AWP 10,024,202057,Staff,0,0,0,0
1683334320569,AWP 10,025,202058,Staff,0,0,0,0
1683334320569,AWP 10,026,202059,Staff,0,0,0,0
1683334321595,AWP 102,001,202032,Staff,0,0,0,0
1683334321595,AWP 102,002,202033,Staff,0,0,0,0
1683334322621,BENG 100,A01,254234,Taylor Amos; Alyssa C,31,0,40,9
1683334323645,BENG 196,001,270013,Engler; Adam J.,9999,0,9999,0
1683334324670,BICD 100R,A01,202018,Smith; Laurie,0,7,32,32
1683334324670,BICD 100R,A02,202019,Smith; Laurie,0,2,32,32
1683334324670,BICD 100R,A03,202020,Smith; Laurie,0,1,32,32
1683334324670,BICD 100R,A04,202021,Smith; Laurie,9,0,32,23
1683334324670,BICD 100R,A05,202022,Smith; Laurie,12,0,32,20
1683334325699,BICD 136,A01,193242,Gustafson-Brown; Cindy,0,2,32,32
1683334325699,BICD 136,A02,193244,Gustafson-Brown; Cindy,14,0,32,18
1683334326725,BIEB 102,A01,193249,Butler; Shannon Rhey,0,2,32,32
1683334326725,BIEB 102,A02,193251,Butler; Shannon Rhey,0,0,32,32
1683334326725,BIEB 102,A03,193253,Butler; Shannon Rhey,0,1,32,32
1683334326725,BIEB 102,A04,193255,Butler; Shannon Rhey,17,0,32,15
1683334326725,BIEB 102,A05,193265,Butler; Shannon Rhey,26,0,32,6
1683334326725,BIEB 102,A06,193269,Butler; Shannon Rhey,16,0,32,16
1683334328779,BIEB 150,A01,193274,Staff,0,0,32,32
1683334328779,BIEB 150,A02,193285,Staff,23,0,32,9
1683334329806,BIEB 194,A00,193286,Kurle; Carolyn M.,22,0,32,10
1683334330831,BILD 1,A01,192291,Staff,16,0,32,16
1683334330831,BILD 1,A02,192292,Staff,30,0,32,2
1683334330831,BILD 1,B01,192520,Reuther; Keefe,0,1,0,0
1683334330831,BILD 1,B02,192532,Reuther; Keefe,0,1,0,0
1683334331857,BILD 3,A01,192556,Butler; Shannon Rhey,0,0,32,32
1683334331857,BILD 3,A02,192581,Butler; Shannon Rhey,5,0,32,27
1683334331857,BILD 3,A03,192611,Butler; Shannon Rhey,23,0,32,9
1683334331857,BILD 3,A04,192612,Butler; Shannon Rhey,25,0,32,7
1683334331857,BILD 3,A05,192613,Butler; Shannon Rhey,27,0,32,5
1683334331857,BILD 3,A06,192679,Butler; Shannon Rhey,27,0,32,5
1683334331857,BILD 3,A07,192682,Butler; Shannon Rhey,22,0,32,10
1683334332881,BILD 4,A01,192836,Reuther; Keefe,0,0,24,24
1683334332881,BILD 4,A02,193044,Reuther; Keefe,4,0,24,20
1683334333906,BILD 10,A01,193142,Gustafson-Brown; Cindy,30,0,32,2
1683334333906,BILD 10,A02,193149,Gustafson-Brown; Cindy,31,0,32,1
1683334334930,BIMM 100,A01,193301,Staff,0,6,32,32
1683334334930,BIMM 100,A02,193312,Staff,0,5,32,32
1683334334930,BIMM 100,A03,193323,Staff,0,8,32,32
1683334335955,BIMM 101,A01,193329,McDonnell; Lisa Marie,0,3,24,24
1683334335955,BIMM 101,A02,193339,McDonnell; Lisa Marie,0,3,24,24
1683334335955,BIMM 101,B01,193354,McDonnell; Lisa Marie,0,3,24,24
1683334335955,BIMM 101,B02,193357,McDonnell; Lisa Marie,0,3,24,24
1683334336980,BIMM 110,A01,193377,Tat; John,0,11,32,32
1683334336980,BIMM 110,A02,193378,Tat; John,1,9,32,31
1683334338009,BIMM 120,A01,206116,Staff,0,0,32,32
1683334338009,BIMM 120,A02,206117,Staff,8,0,32,24
1683334338009,BIMM 120,A03,206121,Staff,21,0,32,11
1683334339034,BIPN 100,A01,193393,Park; Ji Young,0,14,32,32
1683334339034,BIPN 100,A02,193402,Park; Ji Young,0,13,32,32
1683334339034,BIPN 100,A03,193413,Park; Ji Young,0,14,32,32
1683334339034,BIPN 100,A04,193414,Park; Ji Young,0,13,32,32
1683334340062,BIPN 102,A01,193429,Staff,0,0,32,32
1683334340062,BIPN 102,A02,193438,Staff,22,0,32,10
1683334341089,BIPN 106,A01,193450,Reyes Gonzalez; Catalina,0,2,40,40
1683334342114,BIPN 134,A01,193465,Cooke; James Edward,0,0,32,32
1683334342114,BIPN 134,A02,193474,Cooke; James Edward,25,0,32,7
1683334342114,BIPN 134,A03,193485,Cooke; James Edward,29,0,32,3
1683334342114,BIPN 134,A04,193486,Cooke; James Edward,21,0,32,11
1683334342114,BIPN 134,A05,193491,Cooke; James Edward,31,0,32,1
1683334342114,BIPN 134,A06,193501,Cooke; James Edward,30,0,32,2
1683334342114,BIPN 134,A07,193510,Cooke; James Edward,29,0,32,3
1683334344168,BISP 194,A00,222522,Staff,14,0,32,18
1683334345196,CAT 124,A01,202407,Staff,20,0,25,5
1683334346219,CAT 125,A00,202408,Marchisotto; Jennifer Anne,4,0,20,16
1683334347322,CAT 125R,A00,202409,Smith; Lauryn Alissa,0,11,20,20
1683334347322,CAT 125R,B00,202410,Morales; Celeste Georgianna,0,11,20,20
1683334347322,CAT 125R,C00,202411,Irwin; Matthew Joseph,0,10,20,20
1683334348346,CENG 15,A01,204712,Yang; Kesong,0,1,0,0
1683334349373,CENG 114,A00,202070,Jahed Motlagh; Zeinab,5,0,20,15
1683334350400,CGS 105,A00,185477,Wesling; Megan E.,24,0,40,16
1683334351423,CGS 106,A00,185494,Staff,13,0,22,9
1683334352449,CGS 108,A00,185495,Staff,14,0,20,6
1683334353476,CGS 114,A00,185496,Staff,13,0,18,5
1683334354503,CGS 119,A00,185501,Staff,15,0,20,5
1683334355530,CGS 120,A00,185511,Staff,13,0,20,7
1683334356555,CHEM 4,A01,184675,Bussey; Thomas J,96,0,100,4
1683334357579,CHEM 6A,A01,184677,Staff,34,0,60,26
1683334358604,CHEM 6B,A01,184679,Staff,65,0,100,35
1683334359629,CHEM 6C,A01,184681,Bussey; Thomas J,1,0,50,49
1683334359629,CHEM 6C,A02,184682,Bussey; Thomas J,34,0,50,16
1683334360653,CHEM 40A,A01,184684,Albizati; Kim F.,37,0,100,63
1683334361678,CHEM 40B,A01,184686,Albizati; Kim F.,0,20,100,100
1683334362703,CHEM 41B,A01,184690,Staff,52,0,100,48
1683334363729,COGS 3,A01,184715,Boyle; Mary E. T.,0,25,40,40
1683334364753,COGS 14B,A01,185172,Staff,0,15,38,38
1683334365781,COGS 18,A01,184736,Staff,17,0,80,63
1683334366805,COGS 100,A01,184932,Staff,0,5,73,73
1683334367833,COGS 101A,A01,184935,Staff,0,39,30,30
1683334368858,COGS 101B,A01,184944,Staff,0,2,30,30
1683334369882,COGS 101C,A01,184946,Staff,0,12,30,30
1683334370909,COGS 102A,A01,184951,Johnson; Christine M.,2,0,40,38
1683334371933,COGS 107B,A01,184953,Mooshagian; Eric Frederick,0,50,40,40
1683334372957,COGS 118B,A01,184959,Gupta; Anjum,0,48,40,40
1683334373985,COGS 153,A00,184961,Staff,0,15,30,30
1683334375009,COGS 177,A00,184962,Staff,0,20,30,30
1683334376034,COGS 187A,A01,184969,Boyle; Mary E. T.,0,17,40,40
1683334377059,COMM 10,A01,185174,Staff,0,5,25,25
1683334377059,COMM 10,A02,185189,Staff,0,5,25,25
1683334377059,COMM 10,A03,269821,Staff,0,0,0,0
1683334378081,COMM 100B,A01,185475,Staff,0,0,0,2
1683334378081,COMM 100B,A02,185476,Staff,14,0,25,11
1683334379109,COMM 100C,A01,185314,Staff,1,0,25,24
1683334379109,COMM 100C,A02,185327,Staff,19,0,25,6
1683334380133,COMM 110M,A00,185349,Staff,2,0,40,38
1683334381157,COMM 113T,A00,185352,Staff,24,0,40,16
1683334382185,COMM 114I,A00,185353,Staff,33,0,40,7
1683334383210,COMM 131,A00,185354,Staff,19,0,30,11
1683334384239,CSE 8A,A50,185358,Cao; Yingjun,0,46,10,10
1683334385266,CSE 8B,A01,185362,Staff,1,47,50,49
1683334386293,CSE 11,A01,185416,Cao; Yingjun,0,92,10,10
1683334387318,CSE 20,A01,185445,Briones; Jor-el Thomas Caparas,5,0,25,20
1683334388343,CSE 21,A01,185447,Staff,10,0,50,40
1683334389368,CSE 101,A01,185451,Staff,0,12,50,50
1683334389368,CSE 101,B01,185453,Jones; Miles E,0,11,50,50
1683334391421,CSE 141,A01,185458,Eldon; John,20,0,100,80
1683334392449,CSE 141L,A01,185461,Eldon; John,12,0,100,88
1683334393479,CSE 142,A01,185463,Staff,36,0,60,24
1683334393479,CSE 142,B01,201355,Staff,0,7,60,60
1683334394503,CSE 142L,A01,185470,Staff,36,0,60,24
1683334394503,CSE 142L,B01,201417,Staff,0,6,60,60
1683334395528,CSE 190,A00,201433,Staff,32,0,49,17
1683334396554,DOC 1,A01,259136,Strom; Megan C.,7,0,15,8
1683334396554,DOC 1,A02,259137,Strom; Megan C.,14,0,15,1
1683334396554,DOC 1,A03,259138,Strom; Megan C.,14,0,15,1
1683334396554,DOC 1,A04,259139,Strom; Megan C.,14,0,15,1
1683334397580,DOC 100D,A00,259140,Pass; Natalye Joann,16,0,25,9
1683334398606,DSGN 1,A01,184749,Rill; Bryan,0,25,30,30
1683334399633,DSGN 100,A01,185168,Staff,0,2,25,25
1683334400661,ECE 5,A01,185626,Morris; Karcher William,0,10,0,0
1683334401686,ECE 101,A01,185628,Staff,17,0,70,53
1683334402713,ECE 107,A01,185635,Baghdadchi; Saharnaz,0,0,20,20
1683334402713,ECE 107,A02,185638,Baghdadchi; Saharnaz,4,0,20,16
1683334403738,ECE 148,A01,185647,Silberman; Jack,0,0,16,16
1683334404766,ECON 1,A01,185537,Crane; Meredith Helen,54,0,70,16
1683334405789,ECON 3,A01,185549,Crane; Meredith Helen,33,0,70,37
1683334406817,ECON 4,A01,203354,Anderson; John Charles,0,4,10,10
1683334407845,ECON 100A,A01,185574,Staff,0,4,40,40
1683334408867,ECON 100B,A01,185576,Staff,10,22,50,40
1683334409894,ECON 100C,A01,185589,Newhouse; Herbert S,30,0,70,40
1683334410920,ECON 105,A00,185608,Vespa; Emanuel Ignacio,19,0,35,16
1683334411943,ECON 109,A01,185610,Shishkin; Denis,10,0,35,25
1683334412970,ECON 110A,A01,185612,Staff,11,0,40,29
1683334413996,ECON 120A,A01,185615,Staff,20,0,40,20
1683334415024,ECON 120C,A01,185617,Sun; Yixiao,0,20,70,70
1683334416048,ECON 144,A00,203346,Squires; Dale E,3,0,35,32
1683334417076,ECON 171,A01,203349,Newhouse; Herbert S,0,1,35,35
1683334418104,ECON 173A,A01,185621,Toda; Alexis Akira,21,0,35,14
1683334419135,EDS 25,A01,202413,Staff,0,1,0,0
1683334419135,EDS 25,A02,202414,Staff,0,1,0,0
1683334419135,EDS 25,A03,202415,Staff,0,0,0,0
1683334419135,EDS 25,A04,202416,Staff,0,1,0,0
1683334419135,EDS 25,A05,202439,Staff,0,0,0,0
1683334419135,EDS 25,A06,202440,Staff,0,0,0,0
1683334419135,EDS 25,B01,202631,Staff,0,0,0,0
1683334419135,EDS 25,B02,202632,Staff,0,0,0,0
1683334419135,EDS 25,B03,202639,Staff,0,0,0,0
1683334419135,EDS 25,B04,202640,Staff,0,0,0,0
1683334419135,EDS 25,B05,202643,Staff,0,0,0,0
1683334419135,EDS 25,B06,202644,Staff,0,0,0,0
1683334420163,EDS 38,A01,202659,Black; Alison Michelle,24,0,25,1
1683334421192,EDS 115,A00,202652,Staff,17,0,30,13
1683334422215,EDS 125,A00,202649,Staff,14,0,30,16
1683334423238,EDS 126,A01,203332,Staff,30,0,30,0
1683334424266,EDS 139,A00,202838,Staff,16,0,25,9
1683334425294,EDS 146,A01,202655,Staff,14,0,25,11
1683334426325,ENG 15,A00,185667,Staff,0,1,0,0
1683334426325,ENG 15,B00,185672,Staff,0,0,0,0
1683334426325,ENG 15,C00,185675,Staff,0,0,0,0
1683334426325,ENG 15,D00,185682,Staff,0,0,0,0
1683334426325,ENG 15,E00,185684,Staff,0,0,0,0
1683334427349,ETHN 103,A00,185710,Staff,0,3,35,35
1683334428373,ETHN 103A,A00,199228,Man; Simeon S,2,0,9,7
1683334429396,ETHN 109,A00,185711,Staff,18,0,35,17
1683334430423,ETHN 142,A00,185726,Staff,0,4,30,30
1683334431450,ETHN 163J,A00,199229,Man; Simeon S,5,0,8,3
1683334432476,ETHN 168,A00,185727,Staff,8,0,10,2
1683334433501,ETHN 182,A00,185728,Staff,1,0,35,34
1683334434527,ETHN 183,A00,185737,Staff,8,0,18,10
1683334435554,GLBH 111,A01,209361,Burgos; Jose L.,0,0,0,0
1683334437605,HIEU 104,A00,185792,Staff,16,0,20,4
1683334438633,HIEU 115,A00,185800,Staff,1,0,20,19
1683334439659,HIEU 128,A00,185801,Staff,0,7,20,20
1683334440685,HIEU 147,A00,185802,Staff,16,0,20,4
1683334441711,HIEU 154,A00,185823,Staff,12,0,20,8
1683334442735,HILA 102,A00,185826,Staff,13,0,20,7
1683334443762,HILD 2C,A01,185778,Staff,0,12,20,20
1683334444789,HILD 7B,A01,185780,Kwak; Nancy,0,15,32,32
1683334444789,HILD 7B,A02,185781,Kwak; Nancy,0,18,32,32
1683334445814,HILD 30,A01,185791,Staff,14,0,20,6
1683334446842,HISC 119,A00,185830,Golan; Tal,0,9,20,20
1683334447867,HITO 156GS,A00,185831,Patterson; Patrick H.,0,0,0,23
1683334448896,HIUS 103,A00,185832,Man; Simeon S,0,6,20,20
1683334449921,HIUS 117,A00,185836,Kwak; Nancy,2,0,20,18
1683334451003,HIUS 125,A00,185840,Man; Simeon S,0,0,23,23
1683334452027,HIUS 149,A00,185845,Staff,0,0,20,20
1683334453052,HUM 3,A01,185882,Zavodny; Tatiana Sophia,0,7,50,50
1683334453052,HUM 3,B01,185899,Caldwell; Michael Alan,0,18,50,50
1683334454075,HUM 3GS,A00,185900,Patterson; Patrick H.,0,0,0,23
1683334455100,HUM 4,A01,185938,Zroka; Amy Liane,31,0,50,19
1683334455100,HUM 4,B01,185956,Watkins; Eric,0,2,50,50
1683334455100,HUM 4,B02,202209,Watkins; Eric,0,2,50,50
1683334455100,HUM 4,B03,202210,Watkins; Eric,0,2,50,50
1683334456128,HUM 5,A01,185958,West; Geoffrey Scott,3,0,50,47
1683334456128,HUM 5,A02,202215,West; Geoffrey Scott,0,0,50,50
1683334457154,INTL 190,A00,185959,Gagnon; Jeffrey C,0,0,0,9
1683334457154,INTL 190,B00,185960,Lettieri; Michael Joseph,0,0,0,1
1683334458179,JAPN 180,A00,254509,Staff,5,1,30,25
1683334459208,LATI 10,A01,202853,Kennemore; Amy Michelle,4,0,35,31
1683334459208,LATI 10,A02,202854,Kennemore; Amy Michelle,2,0,35,33
1683334459208,LATI 10,A03,270054,Kennemore; Amy Michelle,30,0,30,0
1683334460232,LATI 180,A00,202855,Kennemore; Amy Michelle,11,0,20,9
1683334461259,LAWS 101,A00,201767,Golan; Tal,0,7,40,40
1683334462286,LIFR 1C,A00,185961,Staff,6,0,20,14
1683334463310,LIFR 1CX,A00,185962,Staff,7,0,20,13
1683334464335,LIFR 1D,A00,185963,Staff,9,0,20,11
1683334465362,LIFR 1DX,A00,185964,Staff,9,0,20,11
1683334466389,LIGN 101,A01,186039,Staff,43,0,50,7
1683334467415,LIGN 165,A00,186040,Staff,18,0,50,32
1683334468440,LTCS 108,A00,186041,Staff,6,0,10,4
1683334469467,LTCS 119,A00,186042,Staff,16,0,20,4
1683334470493,LTCS 130,A00,186043,Wesling; Megan E.,15,0,25,10
1683334472543,LTEA 138,A00,186119,Staff,14,0,40,26
1683334473570,LTEN 124,A00,186148,Staff,6,0,25,19
1683334474593,LTEN 178,A00,186149,Staff,7,0,15,8
1683334475617,LTEN 181,A00,186150,Blanco; John D,33,0,40,7
1683334476641,LTWL 120,A00,186160,Staff,20,0,25,5
1683334477665,LTWL 165,A00,186161,Staff,22,0,25,3
1683334478690,LTWR 100,A00,186162,Staff,0,5,15,15
1683334479718,LTWR 102,A00,186163,Doller; Ben,5,0,15,10
1683334480741,MAE 8,A01,186412,Staff,0,0,0,0
1683334481768,MAE 30B,A00,186445,Bahadori; Mohammad Yousef,83,0,100,17
1683334482792,MAE 40,A00,186592,Bewley; Thomas R,9,0,50,41
1683334483817,MAE 101B,A00,186593,Bahadori; Mohammad Yousef,81,0,100,19
1683334484845,MAE 105,A00,186594,Bandaru; Prabhakar,12,0,50,38
1683334485872,MAE 107,A00,186599,Pham; Hieu Tan,0,6,120,120
1683334486899,MAE 148,A01,186660,Silberman; Jack,3,0,16,13
1683334487930,MATH 10A,A01,188095,Staff,1,6,35,34
1683334488958,MATH 10B,A01,188097,Bowers; Adam R.,0,11,30,30
1683334488958,MATH 10B,A02,188099,Bowers; Adam R.,0,11,30,30
1683334488958,MATH 10B,B01,188104,Bowers; Adam R.,0,10,30,30
1683334488958,MATH 10B,B02,188106,Bowers; Adam R.,0,10,30,30
1683334489987,MATH 10C,A01,188111,Staff,0,18,30,30
1683334489987,MATH 10C,A02,188127,Staff,0,17,30,30
1683334489987,MATH 10C,A03,188131,Staff,0,18,30,30
1683334489987,MATH 10C,B01,188218,Staff,18,0,30,12
1683334489987,MATH 10C,B02,188244,Staff,13,0,30,17
1683334489987,MATH 10C,B03,188277,Staff,16,0,30,14
1683334491012,MATH 18,A01,188344,Bach; Quang Tran,18,0,30,12
1683334491012,MATH 18,A02,188345,Bach; Quang Tran,11,0,30,19
1683334491012,MATH 18,B01,188353,Bach; Quang Tran,10,0,30,20
1683334491012,MATH 18,B02,188354,Bach; Quang Tran,20,0,30,10
1683334492037,MATH 20A,A01,188374,Staff,13,0,35,22
1683334493061,MATH 20B,A01,188382,Ohm; Ko Woon,6,0,30,24
1683334493061,MATH 20B,A02,188383,Ohm; Ko Woon,22,0,30,8
1683334493061,MATH 20B,B01,188385,Ohm; Ko Woon,7,0,30,23
1683334493061,MATH 20B,B02,188392,Ohm; Ko Woon,22,0,30,8
1683334494086,MATH 20C,A01,188394,Harel; Guershon,10,0,30,20
1683334494086,MATH 20C,A02,188395,Harel; Guershon,15,0,30,15
1683334494086,MATH 20C,B01,188404,Harel; Guershon,5,0,30,25
1683334494086,MATH 20C,B02,188405,Harel; Guershon,19,0,30,11
1683334495114,MATH 20D,A01,188414,Hammock; Frances H,0,1,30,30
1683334495114,MATH 20D,A02,188415,Hammock; Frances H,3,0,30,27
1683334495114,MATH 20D,B01,188447,Hammock; Frances H,1,0,30,29
1683334495114,MATH 20D,B02,188486,Hammock; Frances H,8,0,30,22
1683334496139,MATH 20E,A01,188649,Staff,21,0,30,9
1683334496139,MATH 20E,A02,188650,Staff,23,0,30,7
1683334496139,MATH 20E,A03,188673,Staff,0,0,30,30
1683334497163,MATH 102,A01,188675,Staff,0,35,35,35
1683334498189,MATH 103B,A01,188681,Staff,3,0,35,32
1683334498189,MATH 103B,B01,188692,Staff,5,0,35,30
1683334499217,MATH 109,A01,188695,Salehi Golsefidy; Alireza,25,0,35,10
1683334499217,MATH 109,A02,188696,Salehi Golsefidy; Alireza,25,0,35,10
1683334500241,MATH 120A,A01,188698,Eggers; John Dietrich,7,0,35,28
1683334501263,MATH 142B,A01,188736,Ioana; Adrian,0,2,30,30
1683334501263,MATH 142B,A02,188741,Ioana; Adrian,1,1,30,29
1683334501263,MATH 142B,A03,188743,Ioana; Adrian,1,3,30,29
1683334502288,MATH 168A,A01,188790,Staff,0,9,35,35
1683334503314,MATH 170A,A01,188803,Nie; Jiawang,0,2,35,35
1683334503314,MATH 170A,A02,188811,Nie; Jiawang,0,0,35,35
1683334503314,MATH 170A,A03,188814,Nie; Jiawang,1,0,35,34
1683334503314,MATH 170A,A04,188815,Nie; Jiawang,13,0,35,22
1683334504340,MATH 193B,A01,188817,Staff,0,0,35,35
1683334504340,MATH 193B,A02,188818,Staff,5,0,35,30
1683334505365,MGT 4,A01,202857,Anderson; John Charles,62,0,80,18
1683334506389,MGT 12,A00,202858,Lindenberger; Wade Douglas,42,0,90,48
1683334507417,MGT 18,A00,202859,Staff,74,0,90,16
1683334508446,MGT 18GS,A00,202860,McKay; Michael J,13,0,28,15
1683334509471,MGT 45,A00,202861,Pecore; Joseph P.,14,0,90,76
1683334510499,MGT 100,A00,202863,Yavorsky; Daniel Ryan,28,0,90,62
1683334511527,MGT 103,A00,202864,Ehrich; Kristine R,1,18,90,89
1683334512555,MGT 112,A00,202865,Ehrich; Kristine R,15,0,90,75
1683334513580,MGT 121A,A00,202868,Staff,0,20,0,0
1683334514605,MGT 131B,A00,202869,Anderson; John Charles,59,0,90,31
1683334515633,MGT 136,A00,202871,Lindenberger; Wade Douglas,84,0,90,6
1683334516660,MGT 164,A00,202873,Staff,0,68,90,91
1683334517686,MGT 164GS,A00,202874,McKay; Mary A,13,0,28,15
1683334518713,MGT 180,A00,202875,Staff,0,50,90,91
1683334519736,MMW 11R,A01,205019,Herbst; Matthew,3,0,30,27
1683334519736,MMW 11R,A02,205026,Herbst; Matthew,29,0,30,1
1683334520761,MMW 15,A01,193512,Chang; Edmond Yi-Teh,0,9,28,28
1683334520761,MMW 15,A02,193513,Chang; Edmond Yi-Teh,0,5,28,28
1683334520761,MMW 15,A03,193514,Chang; Edmond Yi-Teh,0,5,28,28
1683334520761,MMW 15,A04,193515,Chang; Edmond Yi-Teh,0,5,28,28
1683334520761,MMW 15,A05,193516,Chang; Edmond Yi-Teh,0,4,28,28
1683334520761,MMW 15,A06,193517,Chang; Edmond Yi-Teh,0,5,28,28
1683334520761,MMW 15,B01,193519,Chang; Edmond Yi-Teh,0,5,28,28
1683334520761,MMW 15,B02,193520,Chang; Edmond Yi-Teh,0,5,28,28
1683334520761,MMW 15,B03,193521,Chang; Edmond Yi-Teh,0,5,28,28
1683334520761,MMW 15,B04,193522,Chang; Edmond Yi-Teh,0,4,28,28
1683334520761,MMW 15,B05,193523,Chang; Edmond Yi-Teh,0,5,28,28
1683334520761,MMW 15,B06,193524,Chang; Edmond Yi-Teh,0,4,28,28
1683334521802,MMW 122,A01,193526,Rahimi; Babak,0,15,28,28
1683334521802,MMW 122,A02,193527,Rahimi; Babak,0,14,28,28
1683334521802,MMW 122,A03,193528,Rahimi; Babak,0,0,0,0
1683334521802,MMW 122,A04,193529,Rahimi; Babak,0,0,0,0
1683334522825,MUS 1A,A01,186663,Staff,0,20,35,35
1683334523849,MUS 4,A01,186715,Staff,0,12,35,35
1683334524876,MUS 5R,A01,186796,Dubnov; Shlomo,0,17,35,35
1683334525901,MUS 6,A01,186798,Staff,0,4,25,25
1683334526925,MUS 7,A01,186830,Staff,12,0,35,23
1683334527949,MUS 8,A01,186930,Staff,0,26,35,35
1683334528977,MUS 15,A01,186932,Staff,0,16,35,35
1683334528977,MUS 15,B01,186934,Staff,0,15,35,35
1683334530001,MUS 80,A00,186935,Staff,1,0,20,19
1683334530001,MUS 80,B00,186936,Staff,25,0,25,0
1683334531025,NANO 11,A00,204702,Lipomi; Darren John,0,0,0,0
1683334532049,NANO 15,A01,204709,Yang; Kesong,0,1,0,0
1683334533072,NANO 114,A00,202069,Jahed Motlagh; Zeinab,3,0,10,7
1683334534099,PHIL 1,A00,186955,Grush; Rick Scott,32,0,40,8
1683334535123,PHIL 10,A01,186973,Grush; Rick Scott,28,0,35,7
1683334535123,PHIL 10,A02,186974,Grush; Rick Scott,33,0,35,2
1683334536150,PHIL 13,A01,186976,Staff,7,0,35,28
1683334536150,PHIL 13,A02,186977,Staff,16,0,35,19
1683334537177,PHIL 14,A01,186979,Staff,31,0,35,4
1683334537177,PHIL 14,A02,186986,Staff,32,0,35,3
1683334538205,PHIL 28,A01,186988,Staff,16,0,30,14
1683334538205,PHIL 28,A02,186989,Staff,1,0,30,29
1683334538205,PHIL 28,A03,186990,Staff,9,0,30,21
1683334538205,PHIL 28,A04,186991,Staff,26,0,30,4
1683334539231,PHIL 120,A00,186997,Staff,23,0,40,17
1683334540256,PHIL 137,A00,187003,Staff,9,0,40,31
1683334541280,PHIL 150,A00,187015,Staff,47,0,70,23
1683334542303,PHIL 167,A00,187021,Lamey; Andy M.,35,0,40,5
1683334543327,PHIL 174,A01,202226,Staff,17,0,20,3
1683334543327,PHIL 174,A02,202235,Staff,20,0,20,0
1683334544351,PHIL 191A,A00,258918,Staff,0,0,1,1
1683334545374,PHYS 1A,A00,187028,Staff,27,0,60,33
1683334546397,PHYS 1AL,001,187036,Staff,3,0,30,27
1683334546397,PHYS 1AL,002,187049,Staff,18,0,30,12
1683334547422,PHYS 1B,A00,187058,Staff,22,0,60,38
1683334548446,PHYS 1BL,001,187064,Staff,0,0,30,30
1683334548446,PHYS 1BL,002,187070,Staff,5,0,30,25
1683334549470,PHYS 1C,A00,187082,Staff,31,0,120,89
1683334550494,PHYS 1CL,001,187088,Staff,0,9,30,30
1683334550494,PHYS 1CL,002,187089,Staff,0,2,30,30
1683334550494,PHYS 1CL,009,262693,Staff,11,0,30,19
1683334551523,PHYS 2B,A01,187097,Staff,54,0,115,61
1683334552550,PHYS 2C,A01,187099,Staff,67,0,115,48
1683334553575,PHYS 2CL,A01,187101,Staff,5,0,28,23
1683334553575,PHYS 2CL,A02,187102,Staff,15,0,28,13
1683334554662,PHYS 2D,A01,187123,Shotwell; Brian,95,0,115,20
1683334555689,PHYS 4B,A01,187133,Grinstein; Benjamin,35,0,50,15
1683334556713,POLI 10,A00,188819,Staff,0,4,50,50
1683334557742,POLI 11,A00,188827,Staff,43,0,50,7
1683334558767,POLI 13R,A00,188828,Staff,0,1,20,20
1683334559795,POLI 27,A01,188830,Elgin; Samuel Zincke,0,1,70,70
1683334560819,POLI 30,A00,188832,Desposato; Scott,31,0,50,19
1683334561847,POLI 102F,A00,188834,Staff,3,0,40,37
1683334562871,POLI 104A,A00,188852,Staff,14,0,30,16
1683334563895,POLI 104I,A00,188853,Staff,0,6,20,20
1683334564922,POLI 110B,A00,188854,Wiens; David,7,0,20,13
1683334565945,POLI 112A,A00,188855,Wiens; David,5,0,30,25
1683334566971,POLI 117R,A00,188856,Forman; Fonna,0,11,20,20
1683334567994,POLI 118,A00,188857,Ingham; Sean,8,0,20,12
1683334569018,POLI 120G,A00,188858,Staff,9,0,30,21
1683334570042,POLI 131CR,A00,188863,Hoston; Germaine,24,0,50,26
1683334571068,POLI 133,A00,188864,Nellis; Gareth Hb,44,0,50,6
1683334572092,POLI 134D,A00,188865,Desposato; Scott,27,0,30,3
1683334573119,POLI 142A,A00,188871,Gartzke; Erik,22,0,50,28
1683334574146,POLI 142K,A00,188874,Staff,38,0,50,12
1683334575174,POLI 143,A00,188940,Gartzke; Erik,16,0,30,14
1683334576200,POLI 153,A00,188943,Staff,3,0,20,17
1683334577225,POLI 160AA,A00,188944,Staff,12,0,40,28
1683334578248,POLI 170A,A00,188945,Staff,11,0,30,19
1683334580300,PSYC 1,A00,188952,Staff,37,0,90,53
1683334581327,PSYC 2,B00,188953,Staff,19,0,35,16
1683334582356,PSYC 6,A00,188970,Staff,47,0,60,13
1683334583384,PSYC 7,A00,188973,Staff,37,0,45,8
1683334584411,PSYC 60,A01,188980,Rickard; Timothy C.,43,0,60,17
1683334585438,PSYC 70,A01,189001,Steiner; Eric Tomas,24,0,45,21
1683334586466,PSYC 100,A00,189005,Lacefield; Katharine I,0,100,120,120
1683334587493,PSYC 102,A00,189008,Staff,9,0,30,21
1683334588516,PSYC 106,B00,189026,Gorman; Michael R.,34,0,60,26
1683334589543,PSYC 114,B01,189033,Winkielman; Piotr,0,32,30,30
1683334590568,PSYC 131,A00,189036,Anagnostaras; Stephan,0,43,60,60
1683334591592,PSYC 136,A00,189041,Lowe; Angela Beth,0,7,25,25
1683334592617,PSYC 137,A00,189057,Winkielman; Piotr,0,34,25,25
1683334593641,PSYC 144,A00,189107,Wixted; John T,0,7,50,50
1683334595688,PSYC 162,A00,189142,Staff,0,8,85,85
1683334596715,PSYC 172,A00,189144,Gorman; Michael R.,0,7,30,30
1683334598764,PSYC 179,A00,189146,Lacefield; Katharine I,0,84,120,120
1683334599788,PSYC 181,A00,189147,Anagnostaras; Stephan,0,44,90,90
1683334600811,PSYC 190R,A00,189148,Barner; David A.,0,22,80,80
1683334601835,PSYC 191,A00,189275,Rickard; Timothy C.,0,7,25,25
1683334602863,PSYC 193,A00,189276,Chapman; Eddie Nathaniel,0,1,0,4
1683334603891,PSYC 193L,A01,189281,Lowe; Angela Beth,12,0,20,8
1683334603891,PSYC 193L,B01,189285,Staff,28,0,35,7
1683334604916,RELI 149,A00,187137,Rahimi; Babak,7,0,40,33
1683334605943,SE 9,A01,187315,Staff,0,2,18,18
1683334606967,SE 101B,A00,187409,Staff,24,0,30,6
1683334607994,SE 110B,A00,187444,Staff,10,0,40,30
1683334609021,SE 130B,A00,187449,Staff,31,0,40,9
1683334610049,SE 150A,A00,187516,Staff,9,0,20,11
1683334611077,SE 154,A00,187528,Staff,30,0,50,20
1683334612100,SIO 3,A01,258171,Staff,35,0,40,5
1683334613123,SIO 10,A00,187144,Cook; Geoffrey W,0,3,75,75
1683334614147,SIO 45,A00,187152,Cook; Geoffrey W,1,0,100,99
1683334615174,SIO 109R,A00,194486,Staff,0,3,20,20
1683334617222,SIO 187,A01,187233,Kacev; David,12,0,40,28
1683334618249,SOCI 1,A01,258656,Thorpe; Charles Robert,28,0,30,2
1683334618249,SOCI 1,A02,258658,Thorpe; Charles Robert,30,0,30,0
1683334618249,SOCI 1,A03,258661,Thorpe; Charles Robert,25,0,25,0
1683334618249,SOCI 1,A04,258666,Thorpe; Charles Robert,22,0,25,3
1683334618249,SOCI 1,A05,258897,Thorpe; Charles Robert,23,0,25,2
1683334618249,SOCI 1,A06,258898,Thorpe; Charles Robert,25,0,25,0
1683334619277,SOCI 30,A01,258903,Pardo Guerra; Juan Pablo,15,0,30,15
1683334620304,SOCI 102,A00,258904,Staff,9,0,25,16
1683334621328,SOCI 106,A00,258905,Staff,19,0,25,6
1683334622355,SOCI 111,A00,258907,Ribas Norris; Janet Vanesa,26,0,30,4
1683334623382,SOCI 121R,A00,258908,Pardo Guerra; Juan Pablo,10,0,30,20
1683334624406,SOCI 126,A01,203330,Staff,14,0,20,6
1683334625436,SOCI 131,A00,258909,Thorpe; Charles Robert,31,0,60,29
1683334626467,SOCI 135,A00,258910,Payne; Christine Anna,0,9,30,30
1683334627494,SOCI 157,A00,258911,Staff,12,0,30,18
1683334628526,SOCI 184,A00,258912,Staff,25,0,30,5
1683334629552,SOCI 188D,A00,258913,Staff,21,0,30,9
1683334630577,SYN 2,001,187529,Staff,10,0,16,6
1683334630577,SYN 2,002,201452,Staff,0,18,16,16
1683334630577,SYN 2,003,201469,Staff,3,0,16,13
1683334631602,SYN 100,A01,187531,Staff,0,9,20,20
1683334631602,SYN 100,B01,201491,Staff,0,12,20,20
1683334632629,TDAC 1,A00,189286,Walsh; Kim C.,3,0,20,17
1683334632629,TDAC 1,B00,189287,Harting; Carla Kelso,11,0,20,9
1683334633654,TDAC 101,A00,189300,Walsh; Kim C.,16,0,20,4
1683334633654,TDAC 101,B00,189301,Harting; Carla Kelso,18,0,20,2
1683334634678,TDAC 102,A00,189304,Basso; Beatrice,14,0,20,6
1683334635703,TDAC 108,A00,189305,Staff,18,0,20,2
1683334636729,TDDE 131,A00,189310,Staff,19,0,20,1
1683334636729,TDDE 131,B00,189314,Staff,19,0,20,1
1683334636729,TDDE 131,C00,189315,Staff,48,0,50,2
1683334636729,TDDE 131,D00,189316,Staff,14,0,15,1
1683334636729,TDDE 131,E00,204841,Staff,20,0,20,0
1683334637754,TDGE 10,A00,189289,Staff,30,0,50,20
1683334637754,TDGE 10,B00,189290,Havis; Allan,1,0,50,49
1683334638779,TDGE 11,A00,189291,Fulton; Julia,0,3,50,50
1683334638779,TDGE 11,B00,189292,Staff,20,0,25,5
1683334638779,TDGE 11,C00,260270,Staff,0,0,0,0
1683334639802,TDGE 25,A00,189294,Staff,3,0,20,17
1683334640826,TDGE 124,A00,189318,Fulton; Julia,0,8,50,50
1683334641851,TDGE 125,A00,189319,Staff,13,0,25,12
1683334641851,TDGE 125,B00,189320,Staff,23,0,25,2
1683334642875,TDGE 127,A00,189322,Havis; Allan,0,0,50,50
1683334643898,TDHT 101,A00,189323,Staff,18,0,25,7
1683334643898,TDHT 101,B00,189324,Staff,25,0,25,0
1683334644923,TDHT 102,A00,189325,Staff,49,0,50,1
1683334645948,TDMV 1,A00,189295,Arcidiacono; Kristin,19,0,30,11
1683334645948,TDMV 1,B00,189296,Caligagan; Maria T.,24,0,30,6
1683334646972,TDMV 2,A00,189297,Sammartano; Tonnie,28,0,30,2
1683334646972,TDMV 2,B00,189299,Arcidiacono; Kristin,24,0,30,6
1683334647996,TDMV 3,A00,204998,Rincon; Alicia,22,0,30,8
1683334649020,TDMV 120,A00,189458,Sammartano; Tonnie,28,0,30,2
1683334650046,TDMV 138,A00,189541,Jun; Grace Shin Hae,22,0,40,18
1683334651070,TDMV 142,A00,189717,Caligagan; Tony,23,0,30,7
1683334651070,TDMV 142,B00,189718,Caligagan; Maria T.,25,0,30,5
1683334652095,TMC 2,A01,187533,Staff,25,0,25,0
1683334652095,TMC 2,A02,187534,Staff,25,0,25,0
1683334653120,USP 1,A01,187536,Kwak; Nancy,0,16,25,25
1683334654143,USP 5,A01,187538,Staff,10,0,25,15
1683334655171,USP 101,A00,199253,Staff,0,4,0,0
1683334656198,USP 124,A00,187562,Boomhower; Matthew Charles,1,0,30,29
1683334657221,USP 138,A00,187582,Staff,20,0,25,5
1683334658303,USP 152,A01,187597,Staff,4,0,25,21
1683334659327,USP 153,A00,187598,Staff,19,0,25,6
1683334660353,USP 168,A00,187607,Kwak; Nancy,2,0,5,3
1683334661377,USP 173,A00,187619,Staff,4,0,25,21
1683334662402,USP 181,A00,187638,Staff,0,0,25,25
1683334663425,VIS 103,A00,187650,Cruz; Edwin Teddy,23,0,75,52
1683334664449,VIS 110D,A00,187669,Staff,12,0,22,10
1683334665473,VIS 127C,A00,187720,Shen; Kuiyi,67,0,146,79
1683334666501,VIS 149,A00,187731,Yoldas; Pinar,0,14,22,22
1683334667525,VIS 151,A01,188091,Staff,22,0,34,12
1683334667525,VIS 151,A02,188092,Staff,11,0,34,23
1683334668556,VIS 160B,A00,188093,Stalbaum; Brett,0,0,10,10
1683334670606,WCWP 10B,A00,201720,Staff,10,0,15,5
1683334670606,WCWP 10B,B00,201722,Staff,8,0,15,7
1683334671630,WCWP 100,A00,201725,Gagnon; Jeffrey C,0,0,2,2
1683334671630,WCWP 100,B00,201727,Staff,0,4,15,15
1683334674717,ANBI 133,A00,258401,Wilder; Linnea Lorene,34,0,40,6
1683334675744,ANBI 140,A00,258395,Hrvoj Mihic; Branka,18,0,25,7
1683334676828,ANSC 120,A00,258402,Bialecki; Jon Anthony,27,0,40,13
1683334677854,ANSC 144,A00,258400,Staff,14,0,40,26
1683334679909,ANSC 166,A00,258396,Parish; Steven Martin,157,0,175,18
1683334680933,ANSC 180,A00,193533,Staff,9,0,20,11
1683334681959,ANSC 188,A00,258397,Jassal; Aftab,33,0,40,7
1683334682984,ANTH 3,A01,258316,Staff,23,0,30,7
1683334684009,ANTH 5,A00,258394,Semendeferi; Ekaterini,16,0,20,4
1683334685036,ANTH 21,A01,258331,Staff,8,0,40,32
1683334686059,ANTH 103,A00,258398,Varma; Saiba,15,0,25,10
1683334687092,AWP 10,001,202034,Staff,0,0,0,0
1683334687092,AWP 10,002,202035,Staff,0,0,0,0
1683334687092,AWP 10,003,202036,Staff,0,0,0,0
1683334687092,AWP 10,004,202037,Staff,0,0,0,0
1683334687092,AWP 10,005,202038,Staff,0,0,0,0
1683334687092,AWP 10,006,202039,Staff,0,0,0,0
1683334687092,AWP 10,007,202040,Staff,0,0,0,0
1683334687092,AWP 10,008,202041,Staff,0,0,0,0
1683334687092,AWP 10,009,202042,Staff,0,0,0,0
1683334687092,AWP 10,010,202043,Staff,0,0,0,0
1683334687092,AWP 10,011,202044,Staff,0,0,0,0
1683334687092,AWP 10,012,202045,Staff,0,0,0,0
1683334687092,AWP 10,013,202046,Staff,0,0,0,0
1683334687092,AWP 10,014,202047,Staff,0,0,0,0
1683334687092,AWP 10,015,202048,Staff,0,0,0,0
1683334687092,AWP 10,016,202049,Staff,0,0,0,0
1683334687092,AWP 10,017,202050,Staff,0,0,0,0
1683334687092,AWP 10,018,202051,Staff,0,0,0,0
1683334687092,AWP 10,019,202052,Staff,0,0,0,0
1683334687092,AWP 10,020,202053,Staff,0,0,0,0
1683334687092,AWP 10,021,202054,Staff,0,0,0,0
1683334687092,AWP 10,022,202055,Staff,0,0,0,0
1683334687092,AWP 10,023,202056,Staff,0,0,0,0
1683334687092,AWP 10,024,202057,Staff,0,0,0,0
1683334687092,AWP 10,025,202058,Staff,0,0,0,0
1683334687092,AWP 10,026,202059,Staff,0,0,0,0
1683334688117,AWP 102,001,202032,Staff,0,0,0,0
1683334688117,AWP 102,002,202033,Staff,0,0,0,0
1683334689143,BENG 100,A01,254234,Taylor Amos; Alyssa C,31,0,40,9
1683334690170,BENG 196,001,270013,Engler; Adam J.,9999,0,9999,0
1683334691199,BICD 100R,A01,202018,Smith; Laurie,0,7,32,32
1683334691199,BICD 100R,A02,202019,Smith; Laurie,0,2,32,32
1683334691199,BICD 100R,A03,202020,Smith; Laurie,0,1,32,32
1683334691199,BICD 100R,A04,202021,Smith; Laurie,9,0,32,23
1683334691199,BICD 100R,A05,202022,Smith; Laurie,12,0,32,20
1683334692228,BICD 136,A01,193242,Gustafson-Brown; Cindy,0,2,32,32
1683334692228,BICD 136,A02,193244,Gustafson-Brown; Cindy,14,0,32,18
1683334693256,BIEB 102,A01,193249,Butler; Shannon Rhey,0,2,32,32
1683334693256,BIEB 102,A02,193251,Butler; Shannon Rhey,0,0,32,32
1683334693256,BIEB 102,A03,193253,Butler; Shannon Rhey,0,1,32,32
1683334693256,BIEB 102,A04,193255,Butler; Shannon Rhey,17,0,32,15
1683334693256,BIEB 102,A05,193265,Butler; Shannon Rhey,26,0,32,6
1683334693256,BIEB 102,A06,193269,Butler; Shannon Rhey,16,0,32,16
1683334695306,BIEB 150,A01,193274,Staff,0,0,32,32
1683334695306,BIEB 150,A02,193285,Staff,23,0,32,9
1683334696335,BIEB 194,A00,193286,Kurle; Carolyn M.,22,0,32,10
1683334697359,BILD 1,A01,192291,Staff,16,0,32,16
1683334697359,BILD 1,A02,192292,Staff,30,0,32,2
1683334697359,BILD 1,B01,192520,Reuther; Keefe,0,1,0,0
1683334697359,BILD 1,B02,192532,Reuther; Keefe,0,1,0,0
1683334698384,BILD 3,A01,192556,Butler; Shannon Rhey,0,0,32,32
1683334698384,BILD 3,A02,192581,Butler; Shannon Rhey,5,0,32,27
1683334698384,BILD 3,A03,192611,Butler; Shannon Rhey,23,0,32,9
1683334698384,BILD 3,A04,192612,Butler; Shannon Rhey,25,0,32,7
1683334698384,BILD 3,A05,192613,Butler; Shannon Rhey,27,0,32,5
1683334698384,BILD 3,A06,192679,Butler; Shannon Rhey,27,0,32,5
1683334698384,BILD 3,A07,192682,Butler; Shannon Rhey,22,0,32,10
1683334699420,BILD 4,A01,192836,Reuther; Keefe,0,0,24,24
1683334699420,BILD 4,A02,193044,Reuther; Keefe,4,0,24,20
1683334700445,BILD 10,A01,193142,Gustafson-Brown; Cindy,30,0,32,2
1683334700445,BILD 10,A02,193149,Gustafson-Brown; Cindy,31,0,32,1
1683334701470,BIMM 100,A01,193301,Staff,0,6,32,32
1683334701470,BIMM 100,A02,193312,Staff,0,5,32,32
1683334701470,BIMM 100,A03,193323,Staff,0,8,32,32
1683334702497,BIMM 101,A01,193329,McDonnell; Lisa Marie,0,3,24,24
1683334702497,BIMM 101,A02,193339,McDonnell; Lisa Marie,0,3,24,24
1683334702497,BIMM 101,B01,193354,McDonnell; Lisa Marie,0,3,24,24
1683334702497,BIMM 101,B02,193357,McDonnell; Lisa Marie,0,3,24,24
1683334703523,BIMM 110,A01,193377,Tat; John,0,11,32,32
1683334703523,BIMM 110,A02,193378,Tat; John,1,9,32,31
1683334704548,BIMM 120,A01,206116,Staff,0,0,32,32
1683334704548,BIMM 120,A02,206117,Staff,8,0,32,24
1683334704548,BIMM 120,A03,206121,Staff,21,0,32,11
1683334705573,BIPN 100,A01,193393,Park; Ji Young,0,14,32,32
1683334705573,BIPN 100,A02,193402,Park; Ji Young,0,13,32,32
1683334705573,BIPN 100,A03,193413,Park; Ji Young,0,14,32,32
1683334705573,BIPN 100,A04,193414,Park; Ji Young,0,13,32,32
1683334706601,BIPN 102,A01,193429,Staff,0,0,32,32
1683334706601,BIPN 102,A02,193438,Staff,22,0,32,10
1683334707625,BIPN 106,A01,193450,Reyes Gonzalez; Catalina,0,2,40,40
1683334708651,BIPN 134,A01,193465,Cooke; James Edward,0,0,32,32
1683334708651,BIPN 134,A02,193474,Cooke; James Edward,25,0,32,7
1683334708651,BIPN 134,A03,193485,Cooke; James Edward,29,0,32,3
1683334708651,BIPN 134,A04,193486,Cooke; James Edward,21,0,32,11
1683334708651,BIPN 134,A05,193491,Cooke; James Edward,31,0,32,1
1683334708651,BIPN 134,A06,193501,Cooke; James Edward,30,0,32,2
1683334708651,BIPN 134,A07,193510,Cooke; James Edward,29,0,32,3
1683334710699,BISP 194,A00,222522,Staff,14,0,32,18
1683334711723,CAT 124,A01,202407,Staff,20,0,25,5
1683334712750,CAT 125,A00,202408,Marchisotto; Jennifer Anne,4,0,20,16
1683334713775,CAT 125R,A00,202409,Smith; Lauryn Alissa,0,11,20,20
1683334713775,CAT 125R,B00,202410,Morales; Celeste Georgianna,0,11,20,20
1683334713775,CAT 125R,C00,202411,Irwin; Matthew Joseph,0,10,20,20
1683334714800,CENG 15,A01,204712,Yang; Kesong,0,1,0,0
1683334715827,CENG 114,A00,202070,Jahed Motlagh; Zeinab,5,0,20,15
1683334716851,CGS 105,A00,185477,Wesling; Megan E.,24,0,40,16
1683334717879,CGS 106,A00,185494,Staff,13,0,22,9
1683334718902,CGS 108,A00,185495,Staff,14,0,20,6
1683334719926,CGS 114,A00,185496,Staff,13,0,18,5
1683334720952,CGS 119,A00,185501,Staff,15,0,20,5
1683334721977,CGS 120,A00,185511,Staff,13,0,20,7
1683334723009,CHEM 4,A01,184675,Bussey; Thomas J,96,0,100,4
1683334724033,CHEM 6A,A01,184677,Staff,34,0,60,26
1683334725058,CHEM 6B,A01,184679,Staff,65,0,100,35
1683334726082,CHEM 6C,A01,184681,Bussey; Thomas J,1,0,50,49
1683334726082,CHEM 6C,A02,184682,Bussey; Thomas J,34,0,50,16
1683334727110,CHEM 40A,A01,184684,Albizati; Kim F.,37,0,100,63
1683334728136,CHEM 40B,A01,184686,Albizati; Kim F.,0,20,100,100
1683334729159,CHEM 41B,A01,184690,Staff,52,0,100,48
1683334730184,COGS 3,A01,184715,Boyle; Mary E. T.,0,25,40,40
1683334731211,COGS 14B,A01,185172,Staff,0,15,38,38
1683334732238,COGS 18,A01,184736,Staff,17,0,80,63
1683334733262,COGS 100,A01,184932,Staff,0,5,73,73
1683334734286,COGS 101A,A01,184935,Staff,0,39,30,30
1683334735313,COGS 101B,A01,184944,Staff,0,2,30,30
1683334736338,COGS 101C,A01,184946,Staff,0,12,30,30
1683334737361,COGS 102A,A01,184951,Johnson; Christine M.,2,0,40,38
1683334738388,COGS 107B,A01,184953,Mooshagian; Eric Frederick,0,50,40,40
1683334739410,COGS 118B,A01,184959,Gupta; Anjum,0,48,40,40
1683334740434,COGS 153,A00,184961,Staff,0,15,30,30
1683334741459,COGS 177,A00,184962,Staff,0,20,30,30
1683334742483,COGS 187A,A01,184969,Boyle; Mary E. T.,0,17,40,40
1683334743511,COMM 10,A01,185174,Staff,0,5,25,25
1683334743511,COMM 10,A02,185189,Staff,0,5,25,25
1683334743511,COMM 10,A03,269821,Staff,0,0,0,0
1683334744541,COMM 100B,A01,185475,Staff,0,0,0,2
1683334744541,COMM 100B,A02,185476,Staff,14,0,25,11
1683334745566,COMM 100C,A01,185314,Staff,1,0,25,24
1683334745566,COMM 100C,A02,185327,Staff,19,0,25,6
1683334746590,COMM 110M,A00,185349,Staff,2,0,40,38
1683334747614,COMM 113T,A00,185352,Staff,24,0,40,16
1683334748638,COMM 114I,A00,185353,Staff,33,0,40,7
1683334749662,COMM 131,A00,185354,Staff,19,0,30,11
1683334750687,CSE 8A,A50,185358,Cao; Yingjun,0,46,10,10
1683334751712,CSE 8B,A01,185362,Staff,1,47,50,49
1683334752735,CSE 11,A01,185416,Cao; Yingjun,0,92,10,10
1683334753759,CSE 20,A01,185445,Briones; Jor-el Thomas Caparas,5,0,25,20
1683334754785,CSE 21,A01,185447,Staff,10,0,50,40
1683334755815,CSE 101,A01,185451,Staff,0,12,50,50
1683334755815,CSE 101,B01,185453,Jones; Miles E,0,11,50,50
1683334757865,CSE 141,A01,185458,Eldon; John,20,0,100,80
1683334758890,CSE 141L,A01,185461,Eldon; John,12,0,100,88
1683334759918,CSE 142,A01,185463,Staff,36,0,60,24
1683334759918,CSE 142,B01,201355,Staff,0,7,60,60
1683334760941,CSE 142L,A01,185470,Staff,36,0,60,24
1683334760941,CSE 142L,B01,201417,Staff,0,6,60,60
1683334762025,CSE 190,A00,201433,Staff,32,0,49,17
1683334763050,DOC 1,A01,259136,Strom; Megan C.,7,0,15,8
1683334763050,DOC 1,A02,259137,Strom; Megan C.,14,0,15,1
1683334763050,DOC 1,A03,259138,Strom; Megan C.,14,0,15,1
1683334763050,DOC 1,A04,259139,Strom; Megan C.,14,0,15,1
1683334764074,DOC 100D,A00,259140,Pass; Natalye Joann,16,0,25,9
1683334765102,DSGN 1,A01,184749,Rill; Bryan,0,25,30,30
1683334766127,DSGN 100,A01,185168,Staff,0,2,25,25
1683334767154,ECE 5,A01,185626,Morris; Karcher William,0,10,0,0
1683334768179,ECE 101,A01,185628,Staff,17,0,70,53
1683334769206,ECE 107,A01,185635,Baghdadchi; Saharnaz,0,0,20,20
1683334769206,ECE 107,A02,185638,Baghdadchi; Saharnaz,4,0,20,16
1683334770230,ECE 148,A01,185647,Silberman; Jack,0,0,16,16
1683334771254,ECON 1,A01,185537,Crane; Meredith Helen,54,0,70,16
1683334772282,ECON 3,A01,185549,Crane; Meredith Helen,33,0,70,37
1683334773307,ECON 4,A01,203354,Anderson; John Charles,0,4,10,10
1683334774330,ECON 100A,A01,185574,Staff,0,4,40,40
1683334775354,ECON 100B,A01,185576,Staff,10,22,50,40
1683334776382,ECON 100C,A01,185589,Newhouse; Herbert S,30,0,70,40
1683334777405,ECON 105,A00,185608,Vespa; Emanuel Ignacio,19,0,35,16
1683334778429,ECON 109,A01,185610,Shishkin; Denis,10,0,35,25
1683334779454,ECON 110A,A01,185612,Staff,11,0,40,29
1683334780478,ECON 120A,A01,185615,Staff,20,0,40,20
1683334781503,ECON 120C,A01,185617,Sun; Yixiao,0,20,70,70
1683334782528,ECON 144,A00,203346,Squires; Dale E,3,0,35,32
1683334783553,ECON 171,A01,203349,Newhouse; Herbert S,0,1,35,35
1683334784578,ECON 173A,A01,185621,Toda; Alexis Akira,21,0,35,14
1683334785604,EDS 25,A01,202413,Staff,0,1,0,0
1683334785604,EDS 25,A02,202414,Staff,0,1,0,0
1683334785604,EDS 25,A03,202415,Staff,0,0,0,0
1683334785604,EDS 25,A04,202416,Staff,0,1,0,0
1683334785604,EDS 25,A05,202439,Staff,0,0,0,0
1683334785604,EDS 25,A06,202440,Staff,0,0,0,0
1683334785604,EDS 25,B01,202631,Staff,0,0,0,0
1683334785604,EDS 25,B02,202632,Staff,0,0,0,0
1683334785604,EDS 25,B03,202639,Staff,0,0,0,0
1683334785604,EDS 25,B04,202640,Staff,0,0,0,0
1683334785604,EDS 25,B05,202643,Staff,0,0,0,0
1683334785604,EDS 25,B06,202644,Staff,0,0,0,0
1683334786629,EDS 38,A01,202659,Black; Alison Michelle,24,0,25,1
1683334787652,EDS 115,A00,202652,Staff,17,0,30,13
1683334788680,EDS 125,A00,202649,Staff,14,0,30,16
1683334789708,EDS 126,A01,203332,Staff,30,0,30,0
1683334790731,EDS 139,A00,202838,Staff,16,0,25,9
1683334791758,EDS 146,A01,202655,Staff,14,0,25,11
1683334792783,ENG 15,A00,185667,Staff,0,1,0,0
1683334792783,ENG 15,B00,185672,Staff,0,0,0,0
1683334792783,ENG 15,C00,185675,Staff,0,0,0,0
1683334792783,ENG 15,D00,185682,Staff,0,0,0,0
1683334792783,ENG 15,E00,185684,Staff,0,0,0,0
1683334793807,ETHN 103,A00,185710,Staff,0,3,35,35
1683334794835,ETHN 103A,A00,199228,Man; Simeon S,2,0,9,7
1683334795859,ETHN 109,A00,185711,Staff,18,0,35,17
1683334796883,ETHN 142,A00,185726,Staff,0,4,30,30
1683334797908,ETHN 163J,A00,199229,Man; Simeon S,5,0,8,3
1683334798934,ETHN 168,A00,185727,Staff,8,0,10,2
1683334799957,ETHN 182,A00,185728,Staff,1,0,35,34
1683334800980,ETHN 183,A00,185737,Staff,8,0,18,10
1683334802002,GLBH 111,A01,209361,Burgos; Jose L.,0,0,0,0
1683334804052,HIEU 104,A00,185792,Staff,16,0,20,4
1683334805080,HIEU 115,A00,185800,Staff,1,0,20,19
1683334806106,HIEU 128,A00,185801,Staff,0,7,20,20
1683334807129,HIEU 147,A00,185802,Staff,16,0,20,4
1683334808157,HIEU 154,A00,185823,Staff,12,0,20,8
1683334809180,HILA 102,A00,185826,Staff,13,0,20,7
1683334810207,HILD 2C,A01,185778,Staff,0,12,20,20
1683334811233,HILD 7B,A01,185780,Kwak; Nancy,0,15,32,32
1683334811233,HILD 7B,A02,185781,Kwak; Nancy,0,18,32,32
1683334812255,HILD 30,A01,185791,Staff,14,0,20,6
1683334813279,HISC 119,A00,185830,Golan; Tal,0,9,20,20
1683334814304,HITO 156GS,A00,185831,Patterson; Patrick H.,0,0,0,23
1683334815333,HIUS 103,A00,185832,Man; Simeon S,0,6,20,20
1683334816355,HIUS 117,A00,185836,Kwak; Nancy,2,0,20,18
1683334817384,HIUS 125,A00,185840,Man; Simeon S,0,0,23,23
1683334818407,HIUS 149,A00,185845,Staff,0,0,20,20
1683334819433,HUM 3,A01,185882,Zavodny; Tatiana Sophia,0,7,50,50
1683334819433,HUM 3,B01,185899,Caldwell; Michael Alan,0,18,50,50
1683334820458,HUM 3GS,A00,185900,Patterson; Patrick H.,0,0,0,23
1683334821486,HUM 4,A01,185938,Zroka; Amy Liane,31,0,50,19
1683334821486,HUM 4,B01,185956,Watkins; Eric,0,2,50,50
1683334821486,HUM 4,B02,202209,Watkins; Eric,0,2,50,50
1683334821486,HUM 4,B03,202210,Watkins; Eric,0,2,50,50
1683334822510,HUM 5,A01,185958,West; Geoffrey Scott,3,0,50,47
1683334822510,HUM 5,A02,202215,West; Geoffrey Scott,0,0,50,50
1683334823537,INTL 190,A00,185959,Gagnon; Jeffrey C,0,0,0,9
1683334823537,INTL 190,B00,185960,Lettieri; Michael Joseph,0,0,0,1
1683334824561,JAPN 180,A00,254509,Staff,5,1,30,25
1683334825589,LATI 10,A01,202853,Kennemore; Amy Michelle,4,0,35,31
1683334825589,LATI 10,A02,202854,Kennemore; Amy Michelle,2,0,35,33
1683334825589,LATI 10,A03,270054,Kennemore; Amy Michelle,30,0,30,0
1683334826615,LATI 180,A00,202855,Kennemore; Amy Michelle,11,0,20,9
1683334827639,LAWS 101,A00,201767,Golan; Tal,0,7,40,40
1683334828663,LIFR 1C,A00,185961,Staff,6,0,20,14
1683334829693,LIFR 1CX,A00,185962,Staff,7,0,20,13
1683334830717,LIFR 1D,A00,185963,Staff,9,0,20,11
1683334831744,LIFR 1DX,A00,185964,Staff,9,0,20,11
1683334832768,LIGN 101,A01,186039,Staff,43,0,50,7
1683334833792,LIGN 165,A00,186040,Staff,18,0,50,32
1683334834817,LTCS 108,A00,186041,Staff,6,0,10,4
1683334835840,LTCS 119,A00,186042,Staff,16,0,20,4
1683334836864,LTCS 130,A00,186043,Wesling; Megan E.,15,0,25,10
1683334838916,LTEA 138,A00,186119,Staff,14,0,40,26
1683334839942,LTEN 124,A00,186148,Staff,6,0,25,19
1683334840969,LTEN 178,A00,186149,Staff,7,0,15,8
1683334841996,LTEN 181,A00,186150,Blanco; John D,33,0,40,7
1683334843021,LTWL 120,A00,186160,Staff,20,0,25,5
1683334844047,LTWL 165,A00,186161,Staff,22,0,25,3
1683334845073,LTWR 100,A00,186162,Staff,0,5,15,15
1683334846098,LTWR 102,A00,186163,Doller; Ben,5,0,15,10
1683334847121,MAE 8,A01,186412,Staff,0,0,0,0
1683334848145,MAE 30B,A00,186445,Bahadori; Mohammad Yousef,83,0,100,17
1683334849172,MAE 40,A00,186592,Bewley; Thomas R,9,0,50,41
1683334850199,MAE 101B,A00,186593,Bahadori; Mohammad Yousef,81,0,100,19
1683334851226,MAE 105,A00,186594,Bandaru; Prabhakar,12,0,50,38
1683334852248,MAE 107,A00,186599,Pham; Hieu Tan,0,6,120,120
1683334853270,MAE 148,A01,186660,Silberman; Jack,3,0,16,13
1683334854293,MATH 10A,A01,188095,Staff,1,6,35,34
1683334855323,MATH 10B,A01,188097,Bowers; Adam R.,0,11,30,30
1683334855323,MATH 10B,A02,188099,Bowers; Adam R.,0,11,30,30
1683334855323,MATH 10B,B01,188104,Bowers; Adam R.,0,10,30,30
1683334855323,MATH 10B,B02,188106,Bowers; Adam R.,0,10,30,30
1683334856349,MATH 10C,A01,188111,Staff,0,18,30,30
1683334856349,MATH 10C,A02,188127,Staff,0,17,30,30
1683334856349,MATH 10C,A03,188131,Staff,0,18,30,30
1683334856349,MATH 10C,B01,188218,Staff,18,0,30,12
1683334856349,MATH 10C,B02,188244,Staff,13,0,30,17
1683334856349,MATH 10C,B03,188277,Staff,16,0,30,14
1683334857373,MATH 18,A01,188344,Bach; Quang Tran,18,0,30,12
1683334857373,MATH 18,A02,188345,Bach; Quang Tran,11,0,30,19
1683334857373,MATH 18,B01,188353,Bach; Quang Tran,10,0,30,20
1683334857373,MATH 18,B02,188354,Bach; Quang Tran,20,0,30,10
1683334858397,MATH 20A,A01,188374,Staff,13,0,35,22
1683334859421,MATH 20B,A01,188382,Ohm; Ko Woon,6,0,30,24
1683334859421,MATH 20B,A02,188383,Ohm; Ko Woon,22,0,30,8
1683334859421,MATH 20B,B01,188385,Ohm; Ko Woon,7,0,30,23
1683334859421,MATH 20B,B02,188392,Ohm; Ko Woon,22,0,30,8
1683334860446,MATH 20C,A01,188394,Harel; Guershon,10,0,30,20
1683334860446,MATH 20C,A02,188395,Harel; Guershon,15,0,30,15
1683334860446,MATH 20C,B01,188404,Harel; Guershon,5,0,30,25
1683334860446,MATH 20C,B02,188405,Harel; Guershon,19,0,30,11
1683334861472,MATH 20D,A01,188414,Hammock; Frances H,0,1,30,30
1683334861472,MATH 20D,A02,188415,Hammock; Frances H,3,0,30,27
1683334861472,MATH 20D,B01,188447,Hammock; Frances H,1,0,30,29
1683334861472,MATH 20D,B02,188486,Hammock; Frances H,8,0,30,22
1683334862498,MATH 20E,A01,188649,Staff,21,0,30,9
1683334862498,MATH 20E,A02,188650,Staff,23,0,30,7
1683334862498,MATH 20E,A03,188673,Staff,0,0,30,30
1683334863525,MATH 102,A01,188675,Staff,0,35,35,35
1683334864551,MATH 103B,A01,188681,Staff,3,0,35,32
1683334864551,MATH 103B,B01,188692,Staff,5,0,35,30
1683334865635,MATH 109,A01,188695,Salehi Golsefidy; Alireza,25,0,35,10
1683334865635,MATH 109,A02,188696,Salehi Golsefidy; Alireza,25,0,35,10
1683334866660,MATH 120A,A01,188698,Eggers; John Dietrich,7,0,35,28
1683334867691,MATH 142B,A01,188736,Ioana; Adrian,0,2,30,30
1683334867691,MATH 142B,A02,188741,Ioana; Adrian,1,1,30,29
1683334867691,MATH 142B,A03,188743,Ioana; Adrian,1,3,30,29
1683334868720,MATH 168A,A01,188790,Staff,0,9,35,35
1683334869749,MATH 170A,A01,188803,Nie; Jiawang,0,2,35,35
1683334869749,MATH 170A,A02,188811,Nie; Jiawang,0,0,35,35
1683334869749,MATH 170A,A03,188814,Nie; Jiawang,1,0,35,34
1683334869749,MATH 170A,A04,188815,Nie; Jiawang,13,0,35,22
1683334870775,MATH 193B,A01,188817,Staff,0,0,35,35
1683334870775,MATH 193B,A02,188818,Staff,5,0,35,30
1683334871797,MGT 4,A01,202857,Anderson; John Charles,62,0,80,18
1683334872825,MGT 12,A00,202858,Lindenberger; Wade Douglas,42,0,90,48
1683334873853,MGT 18,A00,202859,Staff,74,0,90,16
1683334874877,MGT 18GS,A00,202860,McKay; Michael J,13,0,28,15
1683334875904,MGT 45,A00,202861,Pecore; Joseph P.,14,0,90,76
1683334876929,MGT 100,A00,202863,Yavorsky; Daniel Ryan,28,0,90,62
1683334877953,MGT 103,A00,202864,Ehrich; Kristine R,1,18,90,89
1683334878978,MGT 112,A00,202865,Ehrich; Kristine R,15,0,90,75
1683334880005,MGT 121A,A00,202868,Staff,0,20,0,0
1683334881029,MGT 131B,A00,202869,Anderson; John Charles,59,0,90,31
1683334882052,MGT 136,A00,202871,Lindenberger; Wade Douglas,84,0,90,6
1683334883080,MGT 164,A00,202873,Staff,0,68,90,91
1683334884103,MGT 164GS,A00,202874,McKay; Mary A,13,0,28,15
1683334885130,MGT 180,A00,202875,Staff,0,50,90,91
1683334886154,MMW 11R,A01,205019,Herbst; Matthew,3,0,30,27
1683334886154,MMW 11R,A02,205026,Herbst; Matthew,29,0,30,1
1683334887183,MMW 15,A01,193512,Chang; Edmond Yi-Teh,0,9,28,28
1683334887183,MMW 15,A02,193513,Chang; Edmond Yi-Teh,0,5,28,28
1683334887183,MMW 15,A03,193514,Chang; Edmond Yi-Teh,0,5,28,28
1683334887183,MMW 15,A04,193515,Chang; Edmond Yi-Teh,0,5,28,28
1683334887183,MMW 15,A05,193516,Chang; Edmond Yi-Teh,0,4,28,28
1683334887183,MMW 15,A06,193517,Chang; Edmond Yi-Teh,0,5,28,28
1683334887183,MMW 15,B01,193519,Chang; Edmond Yi-Teh,0,5,28,28
1683334887183,MMW 15,B02,193520,Chang; Edmond Yi-Teh,0,5,28,28
1683334887183,MMW 15,B03,193521,Chang; Edmond Yi-Teh,0,5,28,28
1683334887183,MMW 15,B04,193522,Chang; Edmond Yi-Teh,0,4,28,28
1683334887183,MMW 15,B05,193523,Chang; Edmond Yi-Teh,0,5,28,28
1683334887183,MMW 15,B06,193524,Chang; Edmond Yi-Teh,0,4,28,28
1683334888206,MMW 122,A01,193526,Rahimi; Babak,0,15,28,28
1683334888206,MMW 122,A02,193527,Rahimi; Babak,0,14,28,28
1683334888206,MMW 122,A03,193528,Rahimi; Babak,0,0,0,0
1683334888206,MMW 122,A04,193529,Rahimi; Babak,0,0,0,0
1683334889233,MUS 1A,A01,186663,Staff,0,20,35,35
1683334890257,MUS 4,A01,186715,Staff,0,12,35,35
1683334891284,MUS 5R,A01,186796,Dubnov; Shlomo,0,17,35,35
1683334892309,MUS 6,A01,186798,Staff,0,4,25,25
1683334893334,MUS 7,A01,186830,Staff,12,0,35,23
1683334894361,MUS 8,A01,186930,Staff,0,26,35,35
1683334895386,MUS 15,A01,186932,Staff,0,16,35,35
1683334895386,MUS 15,B01,186934,Staff,0,15,35,35
1683334896410,MUS 80,A00,186935,Staff,1,0,20,19
1683334896410,MUS 80,B00,186936,Staff,25,0,25,0
1683334897437,NANO 11,A00,204702,Lipomi; Darren John,0,0,0,0
1683334898462,NANO 15,A01,204709,Yang; Kesong,0,1,0,0
1683334899485,NANO 114,A00,202069,Jahed Motlagh; Zeinab,3,0,10,7
1683334900514,PHIL 1,A00,186955,Grush; Rick Scott,32,0,40,8
1683334901538,PHIL 10,A01,186973,Grush; Rick Scott,28,0,35,7
1683334901538,PHIL 10,A02,186974,Grush; Rick Scott,33,0,35,2
1683334902565,PHIL 13,A01,186976,Staff,7,0,35,28
1683334902565,PHIL 13,A02,186977,Staff,16,0,35,19
1683334903588,PHIL 14,A01,186979,Staff,31,0,35,4
1683334903588,PHIL 14,A02,186986,Staff,32,0,35,3
1683334904612,PHIL 28,A01,186988,Staff,16,0,30,14
1683334904612,PHIL 28,A02,186989,Staff,1,0,30,29
1683334904612,PHIL 28,A03,186990,Staff,9,0,30,21
1683334904612,PHIL 28,A04,186991,Staff,26,0,30,4
1683334905641,PHIL 120,A00,186997,Staff,23,0,40,17
1683334906665,PHIL 137,A00,187003,Staff,9,0,40,31
1683334907689,PHIL 150,A00,187015,Staff,47,0,70,23
1683334908714,PHIL 167,A00,187021,Lamey; Andy M.,35,0,40,5
1683334909739,PHIL 174,A01,202226,Staff,17,0,20,3
1683334909739,PHIL 174,A02,202235,Staff,20,0,20,0
1683334910766,PHIL 191A,A00,258918,Staff,0,0,1,1
1683334911790,PHYS 1A,A00,187028,Staff,27,0,60,33
1683334912818,PHYS 1AL,001,187036,Staff,2,0,30,28
1683334912818,PHYS 1AL,002,187049,Staff,18,0,30,12
1683334913843,PHYS 1B,A00,187058,Staff,22,0,60,38
1683334914867,PHYS 1BL,001,187064,Staff,0,0,30,30
1683334914867,PHYS 1BL,002,187070,Staff,5,0,30,25
1683334915891,PHYS 1C,A00,187082,Staff,31,0,120,89
1683334916917,PHYS 1CL,001,187088,Staff,0,9,30,30
1683334916917,PHYS 1CL,002,187089,Staff,0,2,30,30
1683334916917,PHYS 1CL,009,262693,Staff,11,0,30,19
1683334917942,PHYS 2B,A01,187097,Staff,54,0,115,61
1683334918975,PHYS 2C,A01,187099,Staff,67,0,115,48
1683334920015,PHYS 2CL,A01,187101,Staff,5,0,28,23
1683334920015,PHYS 2CL,A02,187102,Staff,15,0,28,13
1683334921044,PHYS 2D,A01,187123,Shotwell; Brian,95,0,115,20
1683334922073,PHYS 4B,A01,187133,Grinstein; Benjamin,35,0,50,15
1683334923099,POLI 10,A00,188819,Staff,0,4,50,50
1683334924124,POLI 11,A00,188827,Staff,43,0,50,7
1683334925148,POLI 13R,A00,188828,Staff,0,1,20,20
1683334926173,POLI 27,A01,188830,Elgin; Samuel Zincke,0,1,70,70
1683334927200,POLI 30,A00,188832,Desposato; Scott,31,0,50,19
1683334928227,POLI 102F,A00,188834,Staff,3,0,40,37
1683334929254,POLI 104A,A00,188852,Staff,14,0,30,16
1683334930282,POLI 104I,A00,188853,Staff,0,6,20,20
1683334931307,POLI 110B,A00,188854,Wiens; David,7,0,20,13
1683334932335,POLI 112A,A00,188855,Wiens; David,5,0,30,25
1683334933359,POLI 117R,A00,188856,Forman; Fonna,0,11,20,20
1683334934385,POLI 118,A00,188857,Ingham; Sean,8,0,20,12
1683334935408,POLI 120G,A00,188858,Staff,9,0,30,21
1683334936432,POLI 131CR,A00,188863,Hoston; Germaine,24,0,50,26
1683334937460,POLI 133,A00,188864,Nellis; Gareth Hb,44,0,50,6
1683334938487,POLI 134D,A00,188865,Desposato; Scott,27,0,30,3
1683334939515,POLI 142A,A00,188871,Gartzke; Erik,22,0,50,28
1683334940543,POLI 142K,A00,188874,Staff,38,0,50,12
1683334941568,POLI 143,A00,188940,Gartzke; Erik,16,0,30,14
1683334942593,POLI 153,A00,188943,Staff,3,0,20,17
1683334943621,POLI 160AA,A00,188944,Staff,12,0,40,28
1683334944644,POLI 170A,A00,188945,Staff,11,0,30,19
1683334946699,PSYC 1,A00,188952,Staff,37,0,90,53
1683334947722,PSYC 2,B00,188953,Staff,19,0,35,16
1683334948750,PSYC 6,A00,188970,Staff,47,0,60,13
1683334949774,PSYC 7,A00,188973,Staff,37,0,45,8
1683334950797,PSYC 60,A01,188980,Rickard; Timothy C.,43,0,60,17
1683334951825,PSYC 70,A01,189001,Steiner; Eric Tomas,24,0,45,21
1683334952850,PSYC 100,A00,189005,Lacefield; Katharine I,0,100,120,120
1683334953874,PSYC 102,A00,189008,Staff,9,0,30,21
1683334954898,PSYC 106,B00,189026,Gorman; Michael R.,34,0,60,26
1683334955922,PSYC 114,B01,189033,Winkielman; Piotr,0,32,30,30
1683334956950,PSYC 131,A00,189036,Anagnostaras; Stephan,0,43,60,60
1683334957975,PSYC 136,A00,189041,Lowe; Angela Beth,0,7,25,25
1683334958999,PSYC 137,A00,189057,Winkielman; Piotr,0,34,25,25
1683334960027,PSYC 144,A00,189107,Wixted; John T,0,7,50,50
1683334962076,PSYC 162,A00,189142,Staff,0,8,85,85
1683334963104,PSYC 172,A00,189144,Gorman; Michael R.,0,7,30,30
1683334965156,PSYC 179,A00,189146,Lacefield; Katharine I,0,84,120,120
1683334966184,PSYC 181,A00,189147,Anagnostaras; Stephan,0,44,90,90
1683334967208,PSYC 190R,A00,189148,Barner; David A.,0,22,80,80
1683334968237,PSYC 191,A00,189275,Rickard; Timothy C.,0,7,25,25
1683334969320,PSYC 193,A00,189276,Chapman; Eddie Nathaniel,0,1,0,4
1683334970345,PSYC 193L,A01,189281,Lowe; Angela Beth,12,0,20,8
1683334970345,PSYC 193L,B01,189285,Staff,28,0,35,7
1683334971369,RELI 149,A00,187137,Rahimi; Babak,7,0,40,33
1683334972391,SE 9,A01,187315,Staff,0,2,18,18
1683334973417,SE 101B,A00,187409,Staff,24,0,30,6
1683334974441,SE 110B,A00,187444,Staff,10,0,40,30
1683334975465,SE 130B,A00,187449,Staff,31,0,40,9
1683334976493,SE 150A,A00,187516,Staff,9,0,20,11
1683334977520,SE 154,A00,187528,Staff,30,0,50,20
1683334978546,SIO 3,A01,258171,Staff,35,0,40,5
1683334979573,SIO 10,A00,187144,Cook; Geoffrey W,0,3,75,75
1683334980598,SIO 45,A00,187152,Cook; Geoffrey W,1,0,100,99
1683334981622,SIO 109R,A00,194486,Staff,0,3,20,20
1683334983674,SIO 187,A01,187233,Kacev; David,12,0,40,28
1683334984699,SOCI 1,A01,258656,Thorpe; Charles Robert,28,0,30,2
1683334984699,SOCI 1,A02,258658,Thorpe; Charles Robert,30,0,30,0
1683334984699,SOCI 1,A03,258661,Thorpe; Charles Robert,25,0,25,0
1683334984699,SOCI 1,A04,258666,Thorpe; Charles Robert,22,0,25,3
1683334984699,SOCI 1,A05,258897,Thorpe; Charles Robert,23,0,25,2
1683334984699,SOCI 1,A06,258898,Thorpe; Charles Robert,25,0,25,0
1683334985725,SOCI 30,A01,258903,Pardo Guerra; Juan Pablo,15,0,30,15
1683334986750,SOCI 102,A00,258904,Staff,9,0,25,16
1683334987776,SOCI 106,A00,258905,Staff,19,0,25,6
1683334988802,SOCI 111,A00,258907,Ribas Norris; Janet Vanesa,26,0,30,4
1683334989833,SOCI 121R,A00,258908,Pardo Guerra; Juan Pablo,10,0,30,20
1683334990861,SOCI 126,A01,203330,Staff,14,0,20,6
1683334991885,SOCI 131,A00,258909,Thorpe; Charles Robert,31,0,60,29
1683334992913,SOCI 135,A00,258910,Payne; Christine Anna,0,9,30,30
1683334993935,SOCI 157,A00,258911,Staff,12,0,30,18
1683334994959,SOCI 184,A00,258912,Staff,25,0,30,5
1683334995986,SOCI 188D,A00,258913,Staff,21,0,30,9
1683334997010,SYN 2,001,187529,Staff,10,0,16,6
1683334997010,SYN 2,002,201452,Staff,0,18,16,16
1683334997010,SYN 2,003,201469,Staff,3,0,16,13
1683334998037,SYN 100,A01,187531,Staff,0,9,20,20
1683334998037,SYN 100,B01,201491,Staff,0,12,20,20
1683334999065,TDAC 1,A00,189286,Walsh; Kim C.,3,0,20,17
1683334999065,TDAC 1,B00,189287,Harting; Carla Kelso,11,0,20,9
1683335000092,TDAC 101,A00,189300,Walsh; Kim C.,16,0,20,4
1683335000092,TDAC 101,B00,189301,Harting; Carla Kelso,18,0,20,2
1683335001117,TDAC 102,A00,189304,Basso; Beatrice,14,0,20,6
1683335002140,TDAC 108,A00,189305,Staff,18,0,20,2
1683335003169,TDDE 131,A00,189310,Staff,19,0,20,1
1683335003169,TDDE 131,B00,189314,Staff,19,0,20,1
1683335003169,TDDE 131,C00,189315,Staff,48,0,50,2
1683335003169,TDDE 131,D00,189316,Staff,14,0,15,1
1683335003169,TDDE 131,E00,204841,Staff,20,0,20,0
1683335004197,TDGE 10,A00,189289,Staff,30,0,50,20
1683335004197,TDGE 10,B00,189290,Havis; Allan,1,0,50,49
1683335005223,TDGE 11,A00,189291,Fulton; Julia,0,3,50,50
1683335005223,TDGE 11,B00,189292,Staff,20,0,25,5
1683335005223,TDGE 11,C00,260270,Staff,0,0,0,0
1683335006246,TDGE 25,A00,189294,Staff,3,0,20,17
1683335007269,TDGE 124,A00,189318,Fulton; Julia,0,8,50,50
1683335008294,TDGE 125,A00,189319,Staff,13,0,25,12
1683335008294,TDGE 125,B00,189320,Staff,23,0,25,2
1683335009317,TDGE 127,A00,189322,Havis; Allan,0,0,50,50
1683335010341,TDHT 101,A00,189323,Staff,18,0,25,7
1683335010341,TDHT 101,B00,189324,Staff,25,0,25,0
1683335011366,TDHT 102,A00,189325,Staff,49,0,50,1
1683335012401,TDMV 1,A00,189295,Arcidiacono; Kristin,19,0,30,11
1683335012401,TDMV 1,B00,189296,Caligagan; Maria T.,24,0,30,6
1683335013428,TDMV 2,A00,189297,Sammartano; Tonnie,28,0,30,2
1683335013428,TDMV 2,B00,189299,Arcidiacono; Kristin,24,0,30,6
1683335014455,TDMV 3,A00,204998,Rincon; Alicia,22,0,30,8
1683335015481,TDMV 120,A00,189458,Sammartano; Tonnie,28,0,30,2
1683335016508,TDMV 138,A00,189541,Jun; Grace Shin Hae,22,0,40,18
1683335017535,TDMV 142,A00,189717,Caligagan; Tony,23,0,30,7
1683335017535,TDMV 142,B00,189718,Caligagan; Maria T.,25,0,30,5
1683335018562,TMC 2,A01,187533,Staff,25,0,25,0
1683335018562,TMC 2,A02,187534,Staff,25,0,25,0
1683335019587,USP 1,A01,187536,Kwak; Nancy,0,16,25,25
1683335020610,USP 5,A01,187538,Staff,10,0,25,15
1683335021638,USP 101,A00,199253,Staff,0,4,0,0
1683335022661,USP 124,A00,187562,Boomhower; Matthew Charles,1,0,30,29
1683335023688,USP 138,A00,187582,Staff,20,0,25,5
1683335024711,USP 152,A01,187597,Staff,4,0,25,21
1683335025738,USP 153,A00,187598,Staff,19,0,25,6
1683335026765,USP 168,A00,187607,Kwak; Nancy,2,0,5,3
1683335027789,USP 173,A00,187619,Staff,4,0,25,21
1683335028814,USP 181,A00,187638,Staff,0,0,25,25
1683335029838,VIS 103,A00,187650,Cruz; Edwin Teddy,23,0,75,52
1683335030864,VIS 110D,A00,187669,Staff,12,0,22,10
1683335031891,VIS 127C,A00,187720,Shen; Kuiyi,67,0,146,79
1683335032915,VIS 149,A00,187731,Yoldas; Pinar,0,14,22,22
1683335033943,VIS 151,A01,188091,Staff,22,0,34,12
1683335033943,VIS 151,A02,188092,Staff,11,0,34,23
1683335034970,VIS 160B,A00,188093,Stalbaum; Brett,0,0,10,10
1683335037027,WCWP 10B,A00,201720,Staff,10,0,15,5
1683335037027,WCWP 10B,B00,201722,Staff,9,0,15,6
1683335038051,WCWP 100,A00,201725,Gagnon; Jeffrey C,0,0,2,2
1683335038051,WCWP 100,B00,201727,Staff,0,4,15,15
1683335041143,ANBI 133,A00,258401,Wilder; Linnea Lorene,34,0,40,6
1683335042168,ANBI 140,A00,258395,Hrvoj Mihic; Branka,18,0,25,7
1683335043191,ANSC 120,A00,258402,Bialecki; Jon Anthony,27,0,40,13
1683335044214,ANSC 144,A00,258400,Staff,14,0,40,26
1683335046268,ANSC 166,A00,258396,Parish; Steven Martin,157,0,175,18
1683335047293,ANSC 180,A00,193533,Staff,9,0,20,11
1683335048318,ANSC 188,A00,258397,Jassal; Aftab,33,0,40,7
1683335049344,ANTH 3,A01,258316,Staff,23,0,30,7
1683335050368,ANTH 5,A00,258394,Semendeferi; Ekaterini,16,0,20,4
1683335051396,ANTH 21,A01,258331,Staff,8,0,40,32
1683335052422,ANTH 103,A00,258398,Varma; Saiba,15,0,25,10
1683335053449,AWP 10,001,202034,Staff,0,0,0,0
1683335053449,AWP 10,002,202035,Staff,0,0,0,0
1683335053449,AWP 10,003,202036,Staff,0,0,0,0
1683335053449,AWP 10,004,202037,Staff,0,0,0,0
1683335053449,AWP 10,005,202038,Staff,0,0,0,0
1683335053449,AWP 10,006,202039,Staff,0,0,0,0
1683335053449,AWP 10,007,202040,Staff,0,0,0,0
1683335053449,AWP 10,008,202041,Staff,0,0,0,0
1683335053449,AWP 10,009,202042,Staff,0,0,0,0
1683335053449,AWP 10,010,202043,Staff,0,0,0,0
1683335053449,AWP 10,011,202044,Staff,0,0,0,0
1683335053449,AWP 10,012,202045,Staff,0,0,0,0
1683335053449,AWP 10,013,202046,Staff,0,0,0,0
1683335053449,AWP 10,014,202047,Staff,0,0,0,0
1683335053449,AWP 10,015,202048,Staff,0,0,0,0
1683335053449,AWP 10,016,202049,Staff,0,0,0,0
1683335053449,AWP 10,017,202050,Staff,0,0,0,0
1683335053449,AWP 10,018,202051,Staff,0,0,0,0
1683335053449,AWP 10,019,202052,Staff,0,0,0,0
1683335053449,AWP 10,020,202053,Staff,0,0,0,0
1683335053449,AWP 10,021,202054,Staff,0,0,0,0
1683335053449,AWP 10,022,202055,Staff,0,0,0,0
1683335053449,AWP 10,023,202056,Staff,0,0,0,0
1683335053449,AWP 10,024,202057,Staff,0,0,0,0
1683335053449,AWP 10,025,202058,Staff,0,0,0,0
1683335053449,AWP 10,026,202059,Staff,0,0,0,0
1683335054476,AWP 102,001,202032,Staff,0,0,0,0
1683335054476,AWP 102,002,202033,Staff,0,0,0,0
1683335055504,BENG 100,A01,254234,Taylor Amos; Alyssa C,31,0,40,9
1683335056528,BENG 196,001,270013,Engler; Adam J.,9999,0,9999,0
1683335057559,BICD 100R,A01,202018,Smith; Laurie,0,7,32,32
1683335057559,BICD 100R,A02,202019,Smith; Laurie,0,2,32,32
1683335057559,BICD 100R,A03,202020,Smith; Laurie,0,1,32,32
1683335057559,BICD 100R,A04,202021,Smith; Laurie,9,0,32,23
1683335057559,BICD 100R,A05,202022,Smith; Laurie,12,0,32,20
1683335058583,BICD 136,A01,193242,Gustafson-Brown; Cindy,0,2,32,32
1683335058583,BICD 136,A02,193244,Gustafson-Brown; Cindy,14,0,32,18
1683335059608,BIEB 102,A01,193249,Butler; Shannon Rhey,0,2,32,32
1683335059608,BIEB 102,A02,193251,Butler; Shannon Rhey,0,0,32,32
1683335059608,BIEB 102,A03,193253,Butler; Shannon Rhey,0,1,32,32
1683335059608,BIEB 102,A04,193255,Butler; Shannon Rhey,17,0,32,15
1683335059608,BIEB 102,A05,193265,Butler; Shannon Rhey,26,0,32,6
1683335059608,BIEB 102,A06,193269,Butler; Shannon Rhey,16,0,32,16
1683335061655,BIEB 150,A01,193274,Staff,0,0,32,32
1683335061655,BIEB 150,A02,193285,Staff,23,0,32,9
1683335062679,BIEB 194,A00,193286,Kurle; Carolyn M.,22,0,32,10
1683335063704,BILD 1,A01,192291,Staff,16,0,32,16
1683335063704,BILD 1,A02,192292,Staff,30,0,32,2
1683335063704,BILD 1,B01,192520,Reuther; Keefe,0,1,0,0
1683335063704,BILD 1,B02,192532,Reuther; Keefe,0,1,0,0
1683335064735,BILD 3,A01,192556,Butler; Shannon Rhey,0,0,32,32
1683335064735,BILD 3,A02,192581,Butler; Shannon Rhey,5,0,32,27
1683335064735,BILD 3,A03,192611,Butler; Shannon Rhey,23,0,32,9
1683335064735,BILD 3,A04,192612,Butler; Shannon Rhey,25,0,32,7
1683335064735,BILD 3,A05,192613,Butler; Shannon Rhey,27,0,32,5
1683335064735,BILD 3,A06,192679,Butler; Shannon Rhey,27,0,32,5
1683335064735,BILD 3,A07,192682,Butler; Shannon Rhey,22,0,32,10
1683335065765,BILD 4,A01,192836,Reuther; Keefe,0,0,24,24
1683335065765,BILD 4,A02,193044,Reuther; Keefe,4,0,24,20
1683335066788,BILD 10,A01,193142,Gustafson-Brown; Cindy,30,0,32,2
1683335066788,BILD 10,A02,193149,Gustafson-Brown; Cindy,31,0,32,1
1683335067813,BIMM 100,A01,193301,Staff,0,6,32,32
1683335067813,BIMM 100,A02,193312,Staff,0,5,32,32
1683335067813,BIMM 100,A03,193323,Staff,0,8,32,32
1683335068839,BIMM 101,A01,193329,McDonnell; Lisa Marie,0,3,24,24
1683335068839,BIMM 101,A02,193339,McDonnell; Lisa Marie,0,3,24,24
1683335068839,BIMM 101,B01,193354,McDonnell; Lisa Marie,0,3,24,24
1683335068839,BIMM 101,B02,193357,McDonnell; Lisa Marie,0,3,24,24
1683335069863,BIMM 110,A01,193377,Tat; John,0,11,32,32
1683335069863,BIMM 110,A02,193378,Tat; John,1,9,32,31
1683335070888,BIMM 120,A01,206116,Staff,0,0,32,32
1683335070888,BIMM 120,A02,206117,Staff,8,0,32,24
1683335070888,BIMM 120,A03,206121,Staff,21,0,32,11
1683335071917,BIPN 100,A01,193393,Park; Ji Young,0,14,32,32
1683335071917,BIPN 100,A02,193402,Park; Ji Young,0,13,32,32
1683335071917,BIPN 100,A03,193413,Park; Ji Young,0,14,32,32
1683335071917,BIPN 100,A04,193414,Park; Ji Young,0,13,32,32
1683335073006,BIPN 102,A01,193429,Staff,0,0,32,32
1683335073006,BIPN 102,A02,193438,Staff,22,0,32,10
1683335074029,BIPN 106,A01,193450,Reyes Gonzalez; Catalina,0,2,40,40
1683335075054,BIPN 134,A01,193465,Cooke; James Edward,0,0,32,32
1683335075054,BIPN 134,A02,193474,Cooke; James Edward,25,0,32,7
1683335075054,BIPN 134,A03,193485,Cooke; James Edward,29,0,32,3
1683335075054,BIPN 134,A04,193486,Cooke; James Edward,21,0,32,11
1683335075054,BIPN 134,A05,193491,Cooke; James Edward,31,0,32,1
1683335075054,BIPN 134,A06,193501,Cooke; James Edward,30,0,32,2
1683335075054,BIPN 134,A07,193510,Cooke; James Edward,29,0,32,3
1683335077102,BISP 194,A00,222522,Staff,14,0,32,18
1683335078126,CAT 124,A01,202407,Staff,20,0,25,5
1683335079155,CAT 125,A00,202408,Marchisotto; Jennifer Anne,4,0,20,16
1683335080179,CAT 125R,A00,202409,Smith; Lauryn Alissa,0,11,20,20
1683335080179,CAT 125R,B00,202410,Morales; Celeste Georgianna,0,11,20,20
1683335080179,CAT 125R,C00,202411,Irwin; Matthew Joseph,0,10,20,20
1683335081205,CENG 15,A01,204712,Yang; Kesong,0,1,0,0
1683335082230,CENG 114,A00,202070,Jahed Motlagh; Zeinab,5,0,20,15
1683335083254,CGS 105,A00,185477,Wesling; Megan E.,24,0,40,16
1683335084278,CGS 106,A00,185494,Staff,13,0,22,9
1683335085304,CGS 108,A00,185495,Staff,14,0,20,6
1683335086327,CGS 114,A00,185496,Staff,13,0,18,5
1683335087351,CGS 119,A00,185501,Staff,15,0,20,5
1683335088375,CGS 120,A00,185511,Staff,13,0,20,7
1683335089399,CHEM 4,A01,184675,Bussey; Thomas J,96,0,100,4
1683335090423,CHEM 6A,A01,184677,Staff,34,0,60,26
1683335091448,CHEM 6B,A01,184679,Staff,65,0,100,35
1683335092478,CHEM 6C,A01,184681,Bussey; Thomas J,1,0,50,49
1683335092478,CHEM 6C,A02,184682,Bussey; Thomas J,34,0,50,16
1683335093501,CHEM 40A,A01,184684,Albizati; Kim F.,37,0,100,63
1683335094525,CHEM 40B,A01,184686,Albizati; Kim F.,0,20,100,100
1683335095551,CHEM 41B,A01,184690,Staff,52,0,100,48
1683335096578,COGS 3,A01,184715,Boyle; Mary E. T.,0,25,40,40
1683335097606,COGS 14B,A01,185172,Staff,0,15,38,38
1683335098634,COGS 18,A01,184736,Staff,17,0,80,63
1683335099658,COGS 100,A01,184932,Staff,0,5,73,73
1683335100686,COGS 101A,A01,184935,Staff,0,39,30,30
1683335101715,COGS 101B,A01,184944,Staff,0,2,30,30
1683335102738,COGS 101C,A01,184946,Staff,0,12,30,30
1683335103762,COGS 102A,A01,184951,Johnson; Christine M.,2,0,40,38
1683335104790,COGS 107B,A01,184953,Mooshagian; Eric Frederick,0,50,40,40
1683335105814,COGS 118B,A01,184959,Gupta; Anjum,0,48,40,40
1683335106839,COGS 153,A00,184961,Staff,0,15,30,30
1683335107866,COGS 177,A00,184962,Staff,0,20,30,30
1683335108894,COGS 187A,A01,184969,Boyle; Mary E. T.,0,17,40,40
1683335109922,COMM 10,A01,185174,Staff,0,5,25,25
1683335109922,COMM 10,A02,185189,Staff,0,5,25,25
1683335109922,COMM 10,A03,269821,Staff,0,0,0,0
1683335110949,COMM 100B,A01,185475,Staff,0,0,0,2
1683335110949,COMM 100B,A02,185476,Staff,14,0,25,11
1683335111977,COMM 100C,A01,185314,Staff,1,0,25,24
1683335111977,COMM 100C,A02,185327,Staff,19,0,25,6
1683335113001,COMM 110M,A00,185349,Staff,2,0,40,38
1683335114027,COMM 113T,A00,185352,Staff,24,0,40,16
1683335115050,COMM 114I,A00,185353,Staff,33,0,40,7
1683335116075,COMM 131,A00,185354,Staff,19,0,30,11
1683335117098,CSE 8A,A50,185358,Cao; Yingjun,0,46,10,10
1683335118123,CSE 8B,A01,185362,Staff,1,47,50,49
1683335119147,CSE 11,A01,185416,Cao; Yingjun,0,92,10,10
1683335120179,CSE 20,A01,185445,Briones; Jor-el Thomas Caparas,5,0,25,20
1683335121206,CSE 21,A01,185447,Staff,10,0,50,40
1683335122235,CSE 101,A01,185451,Staff,0,12,50,50
1683335122235,CSE 101,B01,185453,Jones; Miles E,0,11,50,50
1683335124288,CSE 141,A01,185458,Eldon; John,20,0,100,80
1683335125315,CSE 141L,A01,185461,Eldon; John,12,0,100,88
1683335126340,CSE 142,A01,185463,Staff,36,0,60,24
1683335126340,CSE 142,B01,201355,Staff,0,7,60,60
1683335127364,CSE 142L,A01,185470,Staff,36,0,60,24
1683335127364,CSE 142L,B01,201417,Staff,0,6,60,60
1683335128388,CSE 190,A00,201433,Staff,32,0,49,17
1683335129417,DOC 1,A01,259136,Strom; Megan C.,7,0,15,8
1683335129417,DOC 1,A02,259137,Strom; Megan C.,14,0,15,1
1683335129417,DOC 1,A03,259138,Strom; Megan C.,14,0,15,1
1683335129417,DOC 1,A04,259139,Strom; Megan C.,14,0,15,1
1683335130445,DOC 100D,A00,259140,Pass; Natalye Joann,16,0,25,9
1683335131470,DSGN 1,A01,184749,Rill; Bryan,0,25,30,30
1683335132497,DSGN 100,A01,185168,Staff,0,2,25,25
1683335133524,ECE 5,A01,185626,Morris; Karcher William,0,10,0,0
1683335134546,ECE 101,A01,185628,Staff,17,0,70,53
1683335135573,ECE 107,A01,185635,Baghdadchi; Saharnaz,0,0,20,20
1683335135573,ECE 107,A02,185638,Baghdadchi; Saharnaz,4,0,20,16
1683335136599,ECE 148,A01,185647,Silberman; Jack,0,0,16,16
1683335137627,ECON 1,A01,185537,Crane; Meredith Helen,54,0,70,16
1683335138655,ECON 3,A01,185549,Crane; Meredith Helen,33,0,70,37
1683335139682,ECON 4,A01,203354,Anderson; John Charles,0,4,10,10
1683335140709,ECON 100A,A01,185574,Staff,0,4,40,40
1683335141736,ECON 100B,A01,185576,Staff,10,22,50,40
1683335142761,ECON 100C,A01,185589,Newhouse; Herbert S,30,0,70,40
1683335143786,ECON 105,A00,185608,Vespa; Emanuel Ignacio,19,0,35,16
1683335144810,ECON 109,A01,185610,Shishkin; Denis,10,0,35,25
1683335145837,ECON 110A,A01,185612,Staff,11,0,40,29
1683335146861,ECON 120A,A01,185615,Staff,20,0,40,20
1683335147890,ECON 120C,A01,185617,Sun; Yixiao,0,20,70,70
1683335148913,ECON 144,A00,203346,Squires; Dale E,3,0,35,32
1683335149937,ECON 171,A01,203349,Newhouse; Herbert S,0,1,35,35
1683335150961,ECON 173A,A01,185621,Toda; Alexis Akira,21,0,35,14
1683335151990,EDS 25,A01,202413,Staff,0,1,0,0
1683335151990,EDS 25,A02,202414,Staff,0,1,0,0
1683335151990,EDS 25,A03,202415,Staff,0,0,0,0
1683335151990,EDS 25,A04,202416,Staff,0,1,0,0
1683335151990,EDS 25,A05,202439,Staff,0,0,0,0
1683335151990,EDS 25,A06,202440,Staff,0,0,0,0
1683335151990,EDS 25,B01,202631,Staff,0,0,0,0
1683335151990,EDS 25,B02,202632,Staff,0,0,0,0
1683335151990,EDS 25,B03,202639,Staff,0,0,0,0
1683335151990,EDS 25,B04,202640,Staff,0,0,0,0
1683335151990,EDS 25,B05,202643,Staff,0,0,0,0
1683335151990,EDS 25,B06,202644,Staff,0,0,0,0
1683335153018,EDS 38,A01,202659,Black; Alison Michelle,24,0,25,1
1683335154043,EDS 115,A00,202652,Staff,17,0,30,13
1683335155066,EDS 125,A00,202649,Staff,14,0,30,16
1683335156090,EDS 126,A01,203332,Staff,30,0,30,0
1683335157117,EDS 139,A00,202838,Staff,16,0,25,9
1683335158143,EDS 146,A01,202655,Staff,14,0,25,11
1683335159167,ENG 15,A00,185667,Staff,0,1,0,0
1683335159167,ENG 15,B00,185672,Staff,0,0,0,0
1683335159167,ENG 15,C00,185675,Staff,0,0,0,0
1683335159167,ENG 15,D00,185682,Staff,0,0,0,0
1683335159167,ENG 15,E00,185684,Staff,0,0,0,0
1683335160191,ETHN 103,A00,185710,Staff,0,3,35,35
1683335161219,ETHN 103A,A00,199228,Man; Simeon S,2,0,9,7
1683335162246,ETHN 109,A00,185711,Staff,18,0,35,17
1683335163274,ETHN 142,A00,185726,Staff,0,4,30,30
1683335164299,ETHN 163J,A00,199229,Man; Simeon S,5,0,8,3
1683335165327,ETHN 168,A00,185727,Staff,8,0,10,2
1683335166350,ETHN 182,A00,185728,Staff,1,0,35,34
1683335167376,ETHN 183,A00,185737,Staff,8,0,18,10
1683335168400,GLBH 111,A01,209361,Burgos; Jose L.,0,0,0,0
1683335170452,HIEU 104,A00,185792,Staff,16,0,20,4
1683335171480,HIEU 115,A00,185800,Staff,1,0,20,19
1683335172507,HIEU 128,A00,185801,Staff,0,7,20,20
1683335173533,HIEU 147,A00,185802,Staff,16,0,20,4
1683335174559,HIEU 154,A00,185823,Staff,12,0,20,8
1683335175586,HILA 102,A00,185826,Staff,13,0,20,7
1683335176666,HILD 2C,A01,185778,Staff,0,12,20,20
1683335177696,HILD 7B,A01,185780,Kwak; Nancy,0,15,32,32
1683335177696,HILD 7B,A02,185781,Kwak; Nancy,0,18,32,32
1683335178721,HILD 30,A01,185791,Staff,14,0,20,6
1683335179744,HISC 119,A00,185830,Golan; Tal,0,9,20,20
1683335180769,HITO 156GS,A00,185831,Patterson; Patrick H.,0,0,0,23
1683335181797,HIUS 103,A00,185832,Man; Simeon S,0,6,20,20
1683335182822,HIUS 117,A00,185836,Kwak; Nancy,2,0,20,18
1683335183847,HIUS 125,A00,185840,Man; Simeon S,0,0,23,23
1683335184871,HIUS 149,A00,185845,Staff,0,0,20,20
1683335185896,HUM 3,A01,185882,Zavodny; Tatiana Sophia,0,7,50,50
1683335185896,HUM 3,B01,185899,Caldwell; Michael Alan,0,18,50,50
1683335186920,HUM 3GS,A00,185900,Patterson; Patrick H.,0,0,0,23
1683335187946,HUM 4,A01,185938,Zroka; Amy Liane,31,0,50,19
1683335187946,HUM 4,B01,185956,Watkins; Eric,0,2,50,50
1683335187946,HUM 4,B02,202209,Watkins; Eric,0,2,50,50
1683335187946,HUM 4,B03,202210,Watkins; Eric,0,2,50,50
1683335188973,HUM 5,A01,185958,West; Geoffrey Scott,3,0,50,47
1683335188973,HUM 5,A02,202215,West; Geoffrey Scott,0,0,50,50
1683335189998,INTL 190,A00,185959,Gagnon; Jeffrey C,0,0,0,9
1683335189998,INTL 190,B00,185960,Lettieri; Michael Joseph,0,0,0,1
1683335191042,JAPN 180,A00,254509,Staff,5,1,30,25
1683335192069,LATI 10,A01,202853,Kennemore; Amy Michelle,4,0,35,31
1683335192069,LATI 10,A02,202854,Kennemore; Amy Michelle,2,0,35,33
1683335192069,LATI 10,A03,270054,Kennemore; Amy Michelle,30,0,30,0
1683335193096,LATI 180,A00,202855,Kennemore; Amy Michelle,11,0,20,9
1683335194121,LAWS 101,A00,201767,Golan; Tal,0,7,40,40
1683335195148,LIFR 1C,A00,185961,Staff,6,0,20,14
1683335196170,LIFR 1CX,A00,185962,Staff,7,0,20,13
1683335197194,LIFR 1D,A00,185963,Staff,9,0,20,11
1683335198219,LIFR 1DX,A00,185964,Staff,9,0,20,11
1683335199243,LIGN 101,A01,186039,Staff,43,0,50,7
1683335200267,LIGN 165,A00,186040,Staff,18,0,50,32
1683335201295,LTCS 108,A00,186041,Staff,6,0,10,4
1683335202321,LTCS 119,A00,186042,Staff,16,0,20,4
1683335203346,LTCS 130,A00,186043,Wesling; Megan E.,15,0,25,10
1683335205399,LTEA 138,A00,186119,Staff,14,0,40,26
1683335206425,LTEN 124,A00,186148,Staff,6,0,25,19
1683335207450,LTEN 178,A00,186149,Staff,7,0,15,8
1683335208476,LTEN 181,A00,186150,Blanco; John D,33,0,40,7
1683335209504,LTWL 120,A00,186160,Staff,20,0,25,5
1683335210532,LTWL 165,A00,186161,Staff,22,0,25,3
1683335211561,LTWR 100,A00,186162,Staff,0,5,15,15
1683335212587,LTWR 102,A00,186163,Doller; Ben,5,0,15,10
1683335213612,MAE 8,A01,186412,Staff,0,0,0,0
1683335214639,MAE 30B,A00,186445,Bahadori; Mohammad Yousef,83,0,100,17
1683335215664,MAE 40,A00,186592,Bewley; Thomas R,9,0,50,41
1683335216688,MAE 101B,A00,186593,Bahadori; Mohammad Yousef,81,0,100,19
1683335217712,MAE 105,A00,186594,Bandaru; Prabhakar,12,0,50,38
1683335218736,MAE 107,A00,186599,Pham; Hieu Tan,0,6,120,120
1683335219764,MAE 148,A01,186660,Silberman; Jack,3,0,16,13
1683335220791,MATH 10A,A01,188095,Staff,1,6,35,34
1683335221817,MATH 10B,A01,188097,Bowers; Adam R.,0,11,30,30
1683335221817,MATH 10B,A02,188099,Bowers; Adam R.,0,11,30,30
1683335221817,MATH 10B,B01,188104,Bowers; Adam R.,0,10,30,30
1683335221817,MATH 10B,B02,188106,Bowers; Adam R.,0,10,30,30
1683335222843,MATH 10C,A01,188111,Staff,0,18,30,30
1683335222843,MATH 10C,A02,188127,Staff,0,17,30,30
1683335222843,MATH 10C,A03,188131,Staff,0,18,30,30
1683335222843,MATH 10C,B01,188218,Staff,18,0,30,12
1683335222843,MATH 10C,B02,188244,Staff,13,0,30,17
1683335222843,MATH 10C,B03,188277,Staff,16,0,30,14
1683335223867,MATH 18,A01,188344,Bach; Quang Tran,18,0,30,12
1683335223867,MATH 18,A02,188345,Bach; Quang Tran,11,0,30,19
1683335223867,MATH 18,B01,188353,Bach; Quang Tran,10,0,30,20
1683335223867,MATH 18,B02,188354,Bach; Quang Tran,20,0,30,10
1683335224892,MATH 20A,A01,188374,Staff,13,0,35,22
1683335225917,MATH 20B,A01,188382,Ohm; Ko Woon,6,0,30,24
1683335225917,MATH 20B,A02,188383,Ohm; Ko Woon,22,0,30,8
1683335225917,MATH 20B,B01,188385,Ohm; Ko Woon,7,0,30,23
1683335225917,MATH 20B,B02,188392,Ohm; Ko Woon,22,0,30,8
1683335226942,MATH 20C,A01,188394,Harel; Guershon,10,0,30,20
1683335226942,MATH 20C,A02,188395,Harel; Guershon,15,0,30,15
1683335226942,MATH 20C,B01,188404,Harel; Guershon,5,0,30,25
1683335226942,MATH 20C,B02,188405,Harel; Guershon,19,0,30,11
1683335227967,MATH 20D,A01,188414,Hammock; Frances H,0,1,30,30
1683335227967,MATH 20D,A02,188415,Hammock; Frances H,3,0,30,27
1683335227967,MATH 20D,B01,188447,Hammock; Frances H,1,0,30,29
1683335227967,MATH 20D,B02,188486,Hammock; Frances H,8,0,30,22
1683335228992,MATH 20E,A01,188649,Staff,21,0,30,9
1683335228992,MATH 20E,A02,188650,Staff,23,0,30,7
1683335228992,MATH 20E,A03,188673,Staff,0,0,30,30
1683335230016,MATH 102,A01,188675,Staff,0,35,35,35
1683335231040,MATH 103B,A01,188681,Staff,3,0,35,32
1683335231040,MATH 103B,B01,188692,Staff,5,0,35,30
1683335232064,MATH 109,A01,188695,Salehi Golsefidy; Alireza,25,0,35,10
1683335232064,MATH 109,A02,188696,Salehi Golsefidy; Alireza,25,0,35,10
1683335233089,MATH 120A,A01,188698,Eggers; John Dietrich,7,0,35,28
1683335234115,MATH 142B,A01,188736,Ioana; Adrian,0,2,30,30
1683335234115,MATH 142B,A02,188741,Ioana; Adrian,1,1,30,29
1683335234115,MATH 142B,A03,188743,Ioana; Adrian,1,3,30,29
1683335235136,MATH 168A,A01,188790,Staff,0,9,35,35
1683335236161,MATH 170A,A01,188803,Nie; Jiawang,0,2,35,35
1683335236161,MATH 170A,A02,188811,Nie; Jiawang,0,0,35,35
1683335236161,MATH 170A,A03,188814,Nie; Jiawang,1,0,35,34
1683335236161,MATH 170A,A04,188815,Nie; Jiawang,13,0,35,22
1683335237185,MATH 193B,A01,188817,Staff,0,0,35,35
1683335237185,MATH 193B,A02,188818,Staff,5,0,35,30
1683335238210,MGT 4,A01,202857,Anderson; John Charles,62,0,80,18
1683335239232,MGT 12,A00,202858,Lindenberger; Wade Douglas,42,0,90,48
1683335240259,MGT 18,A00,202859,Staff,74,0,90,16
1683335241287,MGT 18GS,A00,202860,McKay; Michael J,13,0,28,15
1683335242312,MGT 45,A00,202861,Pecore; Joseph P.,14,0,90,76
1683335243337,MGT 100,A00,202863,Yavorsky; Daniel Ryan,28,0,90,62
1683335244365,MGT 103,A00,202864,Ehrich; Kristine R,1,18,90,89
1683335245392,MGT 112,A00,202865,Ehrich; Kristine R,15,0,90,75
1683335246415,MGT 121A,A00,202868,Staff,0,20,0,0
1683335247440,MGT 131B,A00,202869,Anderson; John Charles,59,0,90,31
1683335248464,MGT 136,A00,202871,Lindenberger; Wade Douglas,84,0,90,6
1683335249491,MGT 164,A00,202873,Staff,0,68,90,91
1683335250518,MGT 164GS,A00,202874,McKay; Mary A,13,0,28,15
1683335251545,MGT 180,A00,202875,Staff,0,50,90,91
1683335252570,MMW 11R,A01,205019,Herbst; Matthew,3,0,30,27
1683335252570,MMW 11R,A02,205026,Herbst; Matthew,29,0,30,1
1683335253599,MMW 15,A01,193512,Chang; Edmond Yi-Teh,0,9,28,28
1683335253599,MMW 15,A02,193513,Chang; Edmond Yi-Teh,0,5,28,28
1683335253599,MMW 15,A03,193514,Chang; Edmond Yi-Teh,0,5,28,28
1683335253599,MMW 15,A04,193515,Chang; Edmond Yi-Teh,0,5,28,28
1683335253599,MMW 15,A05,193516,Chang; Edmond Yi-Teh,0,4,28,28
1683335253599,MMW 15,A06,193517,Chang; Edmond Yi-Teh,0,5,28,28
1683335253599,MMW 15,B01,193519,Chang; Edmond Yi-Teh,0,5,28,28
1683335253599,MMW 15,B02,193520,Chang; Edmond Yi-Teh,0,5,28,28
1683335253599,MMW 15,B03,193521,Chang; Edmond Yi-Teh,0,5,28,28
1683335253599,MMW 15,B04,193522,Chang; Edmond Yi-Teh,0,4,28,28
1683335253599,MMW 15,B05,193523,Chang; Edmond Yi-Teh,0,5,28,28
1683335253599,MMW 15,B06,193524,Chang; Edmond Yi-Teh,0,4,28,28
1683335254624,MMW 122,A01,193526,Rahimi; Babak,0,15,28,28
1683335254624,MMW 122,A02,193527,Rahimi; Babak,0,14,28,28
1683335254624,MMW 122,A03,193528,Rahimi; Babak,0,0,0,0
1683335254624,MMW 122,A04,193529,Rahimi; Babak,0,0,0,0
1683335255646,MUS 1A,A01,186663,Staff,0,20,35,35
1683335256674,MUS 4,A01,186715,Staff,0,12,35,35
1683335257699,MUS 5R,A01,186796,Dubnov; Shlomo,0,17,35,35
1683335258723,MUS 6,A01,186798,Staff,0,4,25,25
1683335259747,MUS 7,A01,186830,Staff,12,0,35,23
1683335260771,MUS 8,A01,186930,Staff,0,26,35,35
1683335261796,MUS 15,A01,186932,Staff,0,16,35,35
1683335261796,MUS 15,B01,186934,Staff,0,15,35,35
1683335262820,MUS 80,A00,186935,Staff,1,0,20,19
1683335262820,MUS 80,B00,186936,Staff,25,0,25,0
1683335263846,NANO 11,A00,204702,Lipomi; Darren John,0,0,0,0
1683335264871,NANO 15,A01,204709,Yang; Kesong,0,1,0,0
1683335265895,NANO 114,A00,202069,Jahed Motlagh; Zeinab,3,0,10,7
1683335266922,PHIL 1,A00,186955,Grush; Rick Scott,32,0,40,8
1683335267949,PHIL 10,A01,186973,Grush; Rick Scott,28,0,35,7
1683335267949,PHIL 10,A02,186974,Grush; Rick Scott,33,0,35,2
1683335268973,PHIL 13,A01,186976,Staff,7,0,35,28
1683335268973,PHIL 13,A02,186977,Staff,16,0,35,19
1683335269999,PHIL 14,A01,186979,Staff,31,0,35,4
1683335269999,PHIL 14,A02,186986,Staff,32,0,35,3
1683335271024,PHIL 28,A01,186988,Staff,16,0,30,14
1683335271024,PHIL 28,A02,186989,Staff,1,0,30,29
1683335271024,PHIL 28,A03,186990,Staff,9,0,30,21
1683335271024,PHIL 28,A04,186991,Staff,26,0,30,4
1683335272050,PHIL 120,A00,186997,Staff,23,0,40,17
1683335273074,PHIL 137,A00,187003,Staff,9,0,40,31
1683335274099,PHIL 150,A00,187015,Staff,47,0,70,23
1683335275125,PHIL 167,A00,187021,Lamey; Andy M.,35,0,40,5
1683335276153,PHIL 174,A01,202226,Staff,17,0,20,3
1683335276153,PHIL 174,A02,202235,Staff,20,0,20,0
1683335277177,PHIL 191A,A00,258918,Staff,0,0,1,1
1683335278204,PHYS 1A,A00,187028,Staff,27,0,60,33
1683335279232,PHYS 1AL,001,187036,Staff,2,0,30,28
1683335279232,PHYS 1AL,002,187049,Staff,18,0,30,12
1683335280317,PHYS 1B,A00,187058,Staff,22,0,60,38
1683335281354,PHYS 1BL,001,187064,Staff,0,0,30,30
1683335281354,PHYS 1BL,002,187070,Staff,5,0,30,25
1683335282380,PHYS 1C,A00,187082,Staff,31,0,120,89
1683335283410,PHYS 1CL,001,187088,Staff,0,9,30,30
1683335283410,PHYS 1CL,002,187089,Staff,0,2,30,30
1683335283410,PHYS 1CL,009,262693,Staff,11,0,30,19
1683335284436,PHYS 2B,A01,187097,Staff,54,0,115,61
1683335285463,PHYS 2C,A01,187099,Staff,67,0,115,48
1683335286492,PHYS 2CL,A01,187101,Staff,5,0,28,23
1683335286492,PHYS 2CL,A02,187102,Staff,15,0,28,13
1683335287518,PHYS 2D,A01,187123,Shotwell; Brian,95,0,115,20
1683335288543,PHYS 4B,A01,187133,Grinstein; Benjamin,35,0,50,15
1683335289567,POLI 10,A00,188819,Staff,0,4,50,50
1683335290596,POLI 11,A00,188827,Staff,43,0,50,7
1683335291622,POLI 13R,A00,188828,Staff,0,1,20,20
1683335292647,POLI 27,A01,188830,Elgin; Samuel Zincke,0,1,70,70
1683335293674,POLI 30,A00,188832,Desposato; Scott,31,0,50,19
1683335294756,POLI 102F,A00,188834,Staff,3,0,40,37
1683335295783,POLI 104A,A00,188852,Staff,14,0,30,16
1683335296810,POLI 104I,A00,188853,Staff,0,6,20,20
1683335297833,POLI 110B,A00,188854,Wiens; David,7,0,20,13
1683335298860,POLI 112A,A00,188855,Wiens; David,5,0,30,25
1683335299885,POLI 117R,A00,188856,Forman; Fonna,0,11,20,20
1683335300910,POLI 118,A00,188857,Ingham; Sean,8,0,20,12
1683335301933,POLI 120G,A00,188858,Staff,9,0,30,21
1683335302961,POLI 131CR,A00,188863,Hoston; Germaine,24,0,50,26
1683335303991,POLI 133,A00,188864,Nellis; Gareth Hb,44,0,50,6
1683335305017,POLI 134D,A00,188865,Desposato; Scott,27,0,30,3
1683335306045,POLI 142A,A00,188871,Gartzke; Erik,22,0,50,28
1683335307076,POLI 142K,A00,188874,Staff,38,0,50,12
1683335308099,POLI 143,A00,188940,Gartzke; Erik,16,0,30,14
1683335309125,POLI 153,A00,188943,Staff,3,0,20,17
1683335310148,POLI 160AA,A00,188944,Staff,12,0,40,28
1683335311174,POLI 170A,A00,188945,Staff,11,0,30,19
1683335313225,PSYC 1,A00,188952,Staff,37,0,90,53
1683335314248,PSYC 2,B00,188953,Staff,19,0,35,16
1683335315270,PSYC 6,A00,188970,Staff,47,0,60,13
1683335316297,PSYC 7,A00,188973,Staff,37,0,45,8
1683335317322,PSYC 60,A01,188980,Rickard; Timothy C.,43,0,60,17
1683335318348,PSYC 70,A01,189001,Steiner; Eric Tomas,24,0,45,21
1683335319376,PSYC 100,A00,189005,Lacefield; Katharine I,0,100,120,120
1683335320400,PSYC 102,A00,189008,Staff,9,0,30,21
1683335321425,PSYC 106,B00,189026,Gorman; Michael R.,34,0,60,26
1683335322452,PSYC 114,B01,189033,Winkielman; Piotr,0,32,30,30
1683335323479,PSYC 131,A00,189036,Anagnostaras; Stephan,0,43,60,60
1683335324502,PSYC 136,A00,189041,Lowe; Angela Beth,0,7,25,25
1683335325530,PSYC 137,A00,189057,Winkielman; Piotr,0,34,25,25
1683335326557,PSYC 144,A00,189107,Wixted; John T,0,7,50,50
1683335328606,PSYC 162,A00,189142,Staff,0,8,85,85
1683335329631,PSYC 172,A00,189144,Gorman; Michael R.,0,7,30,30
1683335331681,PSYC 179,A00,189146,Lacefield; Katharine I,0,84,120,120
1683335332705,PSYC 181,A00,189147,Anagnostaras; Stephan,0,44,90,90
1683335333729,PSYC 190R,A00,189148,Barner; David A.,0,22,80,80
1683335334754,PSYC 191,A00,189275,Rickard; Timothy C.,0,7,25,25
1683335335778,PSYC 193,A00,189276,Chapman; Eddie Nathaniel,0,1,0,4
1683335336803,PSYC 193L,A01,189281,Lowe; Angela Beth,12,0,20,8
1683335336803,PSYC 193L,B01,189285,Staff,28,0,35,7
1683335337827,RELI 149,A00,187137,Rahimi; Babak,7,0,40,33
1683335338851,SE 9,A01,187315,Staff,0,2,18,18
1683335339875,SE 101B,A00,187409,Staff,24,0,30,6
1683335340899,SE 110B,A00,187444,Staff,10,0,40,30
1683335341926,SE 130B,A00,187449,Staff,31,0,40,9
1683335342950,SE 150A,A00,187516,Staff,9,0,20,11
1683335343974,SE 154,A00,187528,Staff,30,0,50,20
1683335344998,SIO 3,A01,258171,Staff,35,0,40,5
1683335346023,SIO 10,A00,187144,Cook; Geoffrey W,0,3,75,75
1683335347047,SIO 45,A00,187152,Cook; Geoffrey W,1,0,100,99
1683335348071,SIO 109R,A00,194486,Staff,0,3,20,20
1683335350124,SIO 187,A01,187233,Kacev; David,12,0,40,28
1683335351153,SOCI 1,A01,258656,Thorpe; Charles Robert,28,0,30,2
1683335351153,SOCI 1,A02,258658,Thorpe; Charles Robert,30,0,30,0
1683335351153,SOCI 1,A03,258661,Thorpe; Charles Robert,25,0,25,0
1683335351153,SOCI 1,A04,258666,Thorpe; Charles Robert,22,0,25,3
1683335351153,SOCI 1,A05,258897,Thorpe; Charles Robert,23,0,25,2
1683335351153,SOCI 1,A06,258898,Thorpe; Charles Robert,25,0,25,0
1683335352181,SOCI 30,A01,258903,Pardo Guerra; Juan Pablo,15,0,30,15
1683335353204,SOCI 102,A00,258904,Staff,9,0,25,16
1683335354231,SOCI 106,A00,258905,Staff,19,0,25,6
1683335355255,SOCI 111,A00,258907,Ribas Norris; Janet Vanesa,26,0,30,4
1683335356278,SOCI 121R,A00,258908,Pardo Guerra; Juan Pablo,10,0,30,20
1683335357302,SOCI 126,A01,203330,Staff,14,0,20,6
1683335358329,SOCI 131,A00,258909,Thorpe; Charles Robert,31,0,60,29
1683335359357,SOCI 135,A00,258910,Payne; Christine Anna,0,9,30,30
1683335360381,SOCI 157,A00,258911,Staff,12,0,30,18
1683335361405,SOCI 184,A00,258912,Staff,25,0,30,5
1683335362429,SOCI 188D,A00,258913,Staff,21,0,30,9
1683335363455,SYN 2,001,187529,Staff,10,0,16,6
1683335363455,SYN 2,002,201452,Staff,0,18,16,16
1683335363455,SYN 2,003,201469,Staff,3,0,16,13
1683335364483,SYN 100,A01,187531,Staff,0,9,20,20
1683335364483,SYN 100,B01,201491,Staff,0,12,20,20
1683335365512,TDAC 1,A00,189286,Walsh; Kim C.,3,0,20,17
1683335365512,TDAC 1,B00,189287,Harting; Carla Kelso,11,0,20,9
1683335366536,TDAC 101,A00,189300,Walsh; Kim C.,16,0,20,4
1683335366536,TDAC 101,B00,189301,Harting; Carla Kelso,18,0,20,2
1683335367559,TDAC 102,A00,189304,Basso; Beatrice,14,0,20,6
1683335368597,TDAC 108,A00,189305,Staff,18,0,20,2
1683335369627,TDDE 131,A00,189310,Staff,19,0,20,1
1683335369627,TDDE 131,B00,189314,Staff,19,0,20,1
1683335369627,TDDE 131,C00,189315,Staff,48,0,50,2
1683335369627,TDDE 131,D00,189316,Staff,14,0,15,1
1683335369627,TDDE 131,E00,204841,Staff,20,0,20,0
1683335370649,TDGE 10,A00,189289,Staff,30,0,50,20
1683335370649,TDGE 10,B00,189290,Havis; Allan,1,0,50,49
1683335371674,TDGE 11,A00,189291,Fulton; Julia,0,3,50,50
1683335371674,TDGE 11,B00,189292,Staff,20,0,25,5
1683335371674,TDGE 11,C00,260270,Staff,0,0,0,0
1683335372699,TDGE 25,A00,189294,Staff,3,0,20,17
1683335373726,TDGE 124,A00,189318,Fulton; Julia,0,8,50,50
1683335374754,TDGE 125,A00,189319,Staff,13,0,25,12
1683335374754,TDGE 125,B00,189320,Staff,23,0,25,2
1683335375778,TDGE 127,A00,189322,Havis; Allan,0,0,50,50
1683335376801,TDHT 101,A00,189323,Staff,18,0,25,7
1683335376801,TDHT 101,B00,189324,Staff,25,0,25,0
1683335377824,TDHT 102,A00,189325,Staff,49,0,50,1
1683335378852,TDMV 1,A00,189295,Arcidiacono; Kristin,19,0,30,11
1683335378852,TDMV 1,B00,189296,Caligagan; Maria T.,24,0,30,6
1683335379876,TDMV 2,A00,189297,Sammartano; Tonnie,28,0,30,2
1683335379876,TDMV 2,B00,189299,Arcidiacono; Kristin,24,0,30,6
1683335380902,TDMV 3,A00,204998,Rincon; Alicia,22,0,30,8
1683335381929,TDMV 120,A00,189458,Sammartano; Tonnie,28,0,30,2
1683335382954,TDMV 138,A00,189541,Jun; Grace Shin Hae,22,0,40,18
1683335384049,TDMV 142,A00,189717,Caligagan; Tony,23,0,30,7
1683335384049,TDMV 142,B00,189718,Caligagan; Maria T.,25,0,30,5
1683335385073,TMC 2,A01,187533,Staff,25,0,25,0
1683335385073,TMC 2,A02,187534,Staff,25,0,25,0
1683335386099,USP 1,A01,187536,Kwak; Nancy,0,16,25,25
1683335387123,USP 5,A01,187538,Staff,10,0,25,15
1683335388148,USP 101,A00,199253,Staff,0,4,0,0
1683335389175,USP 124,A00,187562,Boomhower; Matthew Charles,1,0,30,29
1683335390201,USP 138,A00,187582,Staff,20,0,25,5
1683335391226,USP 152,A01,187597,Staff,4,0,25,21
1683335392248,USP 153,A00,187598,Staff,19,0,25,6
1683335393271,USP 168,A00,187607,Kwak; Nancy,2,0,5,3
1683335394295,USP 173,A00,187619,Staff,4,0,25,21
1683335395323,USP 181,A00,187638,Staff,0,0,25,25
1683335396346,VIS 103,A00,187650,Cruz; Edwin Teddy,23,0,75,52
1683335397373,VIS 110D,A00,187669,Staff,12,0,22,10
1683335398396,VIS 127C,A00,187720,Shen; Kuiyi,67,0,146,79
1683335399420,VIS 149,A00,187731,Yoldas; Pinar,0,14,22,22
1683335400444,VIS 151,A01,188091,Staff,22,0,34,12
1683335400444,VIS 151,A02,188092,Staff,11,0,34,23
1683335401470,VIS 160B,A00,188093,Stalbaum; Brett,0,0,10,10
1683335403520,WCWP 10B,A00,201720,Staff,10,0,15,5
1683335403520,WCWP 10B,B00,201722,Staff,9,0,15,6
1683335404546,WCWP 100,A00,201725,Gagnon; Jeffrey C,0,0,2,2
1683335404546,WCWP 100,B00,201727,Staff,0,4,15,15
1683335407640,ANBI 133,A00,258401,Wilder; Linnea Lorene,34,0,40,6
1683335408667,ANBI 140,A00,258395,Hrvoj Mihic; Branka,18,0,25,7
1683335409692,ANSC 120,A00,258402,Bialecki; Jon Anthony,27,0,40,13
1683335410716,ANSC 144,A00,258400,Staff,14,0,40,26
1683335412765,ANSC 166,A00,258396,Parish; Steven Martin,157,0,175,18
1683335413790,ANSC 180,A00,193533,Staff,9,0,20,11
1683335414814,ANSC 188,A00,258397,Jassal; Aftab,33,0,40,7
1683335415840,ANTH 3,A01,258316,Staff,23,0,30,7
1683335416864,ANTH 5,A00,258394,Semendeferi; Ekaterini,16,0,20,4
1683335417892,ANTH 21,A01,258331,Staff,8,0,40,32
1683335418921,ANTH 103,A00,258398,Varma; Saiba,15,0,25,10
1683335419951,AWP 10,001,202034,Staff,0,0,0,0
1683335419951,AWP 10,002,202035,Staff,0,0,0,0
1683335419951,AWP 10,003,202036,Staff,0,0,0,0
1683335419951,AWP 10,004,202037,Staff,0,0,0,0
1683335419951,AWP 10,005,202038,Staff,0,0,0,0
1683335419951,AWP 10,006,202039,Staff,0,0,0,0
1683335419951,AWP 10,007,202040,Staff,0,0,0,0
1683335419951,AWP 10,008,202041,Staff,0,0,0,0
1683335419951,AWP 10,009,202042,Staff,0,0,0,0
1683335419951,AWP 10,010,202043,Staff,0,0,0,0
1683335419951,AWP 10,011,202044,Staff,0,0,0,0
1683335419951,AWP 10,012,202045,Staff,0,0,0,0
1683335419951,AWP 10,013,202046,Staff,0,0,0,0
1683335419951,AWP 10,014,202047,Staff,0,0,0,0
1683335419951,AWP 10,015,202048,Staff,0,0,0,0
1683335419951,AWP 10,016,202049,Staff,0,0,0,0
1683335419951,AWP 10,017,202050,Staff,0,0,0,0
1683335419951,AWP 10,018,202051,Staff,0,0,0,0
1683335419951,AWP 10,019,202052,Staff,0,0,0,0
1683335419951,AWP 10,020,202053,Staff,0,0,0,0
1683335419951,AWP 10,021,202054,Staff,0,0,0,0
1683335419951,AWP 10,022,202055,Staff,0,0,0,0
1683335419951,AWP 10,023,202056,Staff,0,0,0,0
1683335419951,AWP 10,024,202057,Staff,0,0,0,0
1683335419951,AWP 10,025,202058,Staff,0,0,0,0
1683335419951,AWP 10,026,202059,Staff,0,0,0,0
1683335420974,AWP 102,001,202032,Staff,0,0,0,0
1683335420974,AWP 102,002,202033,Staff,0,0,0,0
1683335421999,BENG 100,A01,254234,Taylor Amos; Alyssa C,31,0,40,9
1683335423023,BENG 196,001,270013,Engler; Adam J.,9999,0,9999,0
1683335424048,BICD 100R,A01,202018,Smith; Laurie,0,7,32,32
1683335424048,BICD 100R,A02,202019,Smith; Laurie,0,2,32,32
1683335424048,BICD 100R,A03,202020,Smith; Laurie,0,1,32,32
1683335424048,BICD 100R,A04,202021,Smith; Laurie,9,0,32,23
1683335424048,BICD 100R,A05,202022,Smith; Laurie,12,0,32,20
1683335425072,BICD 136,A01,193242,Gustafson-Brown; Cindy,0,2,32,32
1683335425072,BICD 136,A02,193244,Gustafson-Brown; Cindy,14,0,32,18
1683335426097,BIEB 102,A01,193249,Butler; Shannon Rhey,0,2,32,32
1683335426097,BIEB 102,A02,193251,Butler; Shannon Rhey,0,0,32,32
1683335426097,BIEB 102,A03,193253,Butler; Shannon Rhey,0,1,32,32
1683335426097,BIEB 102,A04,193255,Butler; Shannon Rhey,17,0,32,15
1683335426097,BIEB 102,A05,193265,Butler; Shannon Rhey,26,0,32,6
1683335426097,BIEB 102,A06,193269,Butler; Shannon Rhey,16,0,32,16
1683335428148,BIEB 150,A01,193274,Staff,0,0,32,32
1683335428148,BIEB 150,A02,193285,Staff,23,0,32,9
1683335429172,BIEB 194,A00,193286,Kurle; Carolyn M.,22,0,32,10
1683335430197,BILD 1,A01,192291,Staff,16,0,32,16
1683335430197,BILD 1,A02,192292,Staff,30,0,32,2
1683335430197,BILD 1,B01,192520,Reuther; Keefe,0,1,0,0
1683335430197,BILD 1,B02,192532,Reuther; Keefe,0,1,0,0
1683335431219,BILD 3,A01,192556,Butler; Shannon Rhey,0,0,32,32
1683335431219,BILD 3,A02,192581,Butler; Shannon Rhey,5,0,32,27
1683335431219,BILD 3,A03,192611,Butler; Shannon Rhey,23,0,32,9
1683335431219,BILD 3,A04,192612,Butler; Shannon Rhey,25,0,32,7
1683335431219,BILD 3,A05,192613,Butler; Shannon Rhey,27,0,32,5
1683335431219,BILD 3,A06,192679,Butler; Shannon Rhey,27,0,32,5
1683335431219,BILD 3,A07,192682,Butler; Shannon Rhey,22,0,32,10
1683335432247,BILD 4,A01,192836,Reuther; Keefe,0,0,24,24
1683335432247,BILD 4,A02,193044,Reuther; Keefe,4,0,24,20
1683335433273,BILD 10,A01,193142,Gustafson-Brown; Cindy,30,0,32,2
1683335433273,BILD 10,A02,193149,Gustafson-Brown; Cindy,31,0,32,1
1683335434297,BIMM 100,A01,193301,Staff,0,6,32,32
1683335434297,BIMM 100,A02,193312,Staff,0,5,32,32
1683335434297,BIMM 100,A03,193323,Staff,0,8,32,32
1683335435322,BIMM 101,A01,193329,McDonnell; Lisa Marie,0,3,24,24
1683335435322,BIMM 101,A02,193339,McDonnell; Lisa Marie,0,3,24,24
1683335435322,BIMM 101,B01,193354,McDonnell; Lisa Marie,0,3,24,24
1683335435322,BIMM 101,B02,193357,McDonnell; Lisa Marie,0,3,24,24
1683335436346,BIMM 110,A01,193377,Tat; John,0,11,32,32
1683335436346,BIMM 110,A02,193378,Tat; John,1,9,32,31
1683335437370,BIMM 120,A01,206116,Staff,0,0,32,32
1683335437370,BIMM 120,A02,206117,Staff,8,0,32,24
1683335437370,BIMM 120,A03,206121,Staff,21,0,32,11
1683335438395,BIPN 100,A01,193393,Park; Ji Young,0,14,32,32
1683335438395,BIPN 100,A02,193402,Park; Ji Young,0,13,32,32
1683335438395,BIPN 100,A03,193413,Park; Ji Young,0,14,32,32
1683335438395,BIPN 100,A04,193414,Park; Ji Young,0,13,32,32
1683335439418,BIPN 102,A01,193429,Staff,0,0,32,32
1683335439418,BIPN 102,A02,193438,Staff,22,0,32,10
1683335440442,BIPN 106,A01,193450,Reyes Gonzalez; Catalina,0,2,40,40
1683335441467,BIPN 134,A01,193465,Cooke; James Edward,0,0,32,32
1683335441467,BIPN 134,A02,193474,Cooke; James Edward,25,0,32,7
1683335441467,BIPN 134,A03,193485,Cooke; James Edward,29,0,32,3
1683335441467,BIPN 134,A04,193486,Cooke; James Edward,21,0,32,11
1683335441467,BIPN 134,A05,193491,Cooke; James Edward,31,0,32,1
1683335441467,BIPN 134,A06,193501,Cooke; James Edward,30,0,32,2
1683335441467,BIPN 134,A07,193510,Cooke; James Edward,29,0,32,3
1683335443517,BISP 194,A00,222522,Staff,14,0,32,18
1683335444541,CAT 124,A01,202407,Staff,20,0,25,5
1683335445569,CAT 125,A00,202408,Marchisotto; Jennifer Anne,4,0,20,16
1683335446594,CAT 125R,A00,202409,Smith; Lauryn Alissa,0,11,20,20
1683335446594,CAT 125R,B00,202410,Morales; Celeste Georgianna,0,11,20,20
1683335446594,CAT 125R,C00,202411,Irwin; Matthew Joseph,0,10,20,20
1683335447617,CENG 15,A01,204712,Yang; Kesong,0,1,0,0
1683335448643,CENG 114,A00,202070,Jahed Motlagh; Zeinab,5,0,20,15
1683335449666,CGS 105,A00,185477,Wesling; Megan E.,24,0,40,16
1683335450690,CGS 106,A00,185494,Staff,13,0,22,9
1683335451713,CGS 108,A00,185495,Staff,14,0,20,6
1683335452737,CGS 114,A00,185496,Staff,13,0,18,5
1683335453764,CGS 119,A00,185501,Staff,15,0,20,5
1683335454788,CGS 120,A00,185511,Staff,13,0,20,7
1683335455815,CHEM 4,A01,184675,Bussey; Thomas J,96,0,100,4
1683335456840,CHEM 6A,A01,184677,Staff,34,0,60,26
1683335457864,CHEM 6B,A01,184679,Staff,65,0,100,35
1683335458892,CHEM 6C,A01,184681,Bussey; Thomas J,1,0,50,49
1683335458892,CHEM 6C,A02,184682,Bussey; Thomas J,34,0,50,16
1683335459918,CHEM 40A,A01,184684,Albizati; Kim F.,37,0,100,63
1683335460946,CHEM 40B,A01,184686,Albizati; Kim F.,0,20,100,100
1683335461976,CHEM 41B,A01,184690,Staff,52,0,100,48
1683335463001,COGS 3,A01,184715,Boyle; Mary E. T.,0,25,40,40
1683335464026,COGS 14B,A01,185172,Staff,0,15,38,38
1683335465052,COGS 18,A01,184736,Staff,17,0,80,63
1683335466076,COGS 100,A01,184932,Staff,0,5,73,73
1683335467100,COGS 101A,A01,184935,Staff,0,39,30,30
1683335468125,COGS 101B,A01,184944,Staff,0,2,30,30
1683335469155,COGS 101C,A01,184946,Staff,0,12,30,30
1683335470182,COGS 102A,A01,184951,Johnson; Christine M.,2,0,40,38
1683335471206,COGS 107B,A01,184953,Mooshagian; Eric Frederick,0,50,40,40
1683335472233,COGS 118B,A01,184959,Gupta; Anjum,0,48,40,40
1683335473260,COGS 153,A00,184961,Staff,0,15,30,30
1683335474285,COGS 177,A00,184962,Staff,0,20,30,30
1683335475313,COGS 187A,A01,184969,Boyle; Mary E. T.,0,17,40,40
1683335476341,COMM 10,A01,185174,Staff,0,5,25,25
1683335476341,COMM 10,A02,185189,Staff,0,5,25,25
1683335476341,COMM 10,A03,269821,Staff,0,0,0,0
1683335477365,COMM 100B,A01,185475,Staff,0,0,0,2
1683335477365,COMM 100B,A02,185476,Staff,14,0,25,11
1683335478389,COMM 100C,A01,185314,Staff,1,0,25,24
1683335478389,COMM 100C,A02,185327,Staff,19,0,25,6
1683335479415,COMM 110M,A00,185349,Staff,2,0,40,38
1683335480442,COMM 113T,A00,185352,Staff,24,0,40,16
1683335481469,COMM 114I,A00,185353,Staff,33,0,40,7
1683335482493,COMM 131,A00,185354,Staff,19,0,30,11
1683335483521,CSE 8A,A50,185358,Cao; Yingjun,0,46,10,10
1683335484547,CSE 8B,A01,185362,Staff,1,47,50,49
1683335485576,CSE 11,A01,185416,Cao; Yingjun,0,92,10,10
1683335486604,CSE 20,A01,185445,Briones; Jor-el Thomas Caparas,5,0,25,20
1683335487687,CSE 21,A01,185447,Staff,10,0,50,40
1683335488711,CSE 101,A01,185451,Staff,0,13,50,50
1683335488711,CSE 101,B01,185453,Jones; Miles E,0,11,50,50
1683335490772,CSE 141,A01,185458,Eldon; John,20,0,100,80
1683335491800,CSE 141L,A01,185461,Eldon; John,12,0,100,88
1683335492828,CSE 142,A01,185463,Staff,36,0,60,24
1683335492828,CSE 142,B01,201355,Staff,0,7,60,60
1683335493856,CSE 142L,A01,185470,Staff,36,0,60,24
1683335493856,CSE 142L,B01,201417,Staff,0,6,60,60
1683335494880,CSE 190,A00,201433,Staff,32,0,49,17
1683335495904,DOC 1,A01,259136,Strom; Megan C.,7,0,15,8
1683335495904,DOC 1,A02,259137,Strom; Megan C.,14,0,15,1
1683335495904,DOC 1,A03,259138,Strom; Megan C.,14,0,15,1
1683335495904,DOC 1,A04,259139,Strom; Megan C.,14,0,15,1
1683335496927,DOC 100D,A00,259140,Pass; Natalye Joann,16,0,25,9
1683335497951,DSGN 1,A01,184749,Rill; Bryan,0,25,30,30
1683335498979,DSGN 100,A01,185168,Staff,0,2,25,25
1683335500002,ECE 5,A01,185626,Morris; Karcher William,0,10,0,0
1683335501027,ECE 101,A01,185628,Staff,17,0,70,53
1683335502051,ECE 107,A01,185635,Baghdadchi; Saharnaz,0,0,20,20
1683335502051,ECE 107,A02,185638,Baghdadchi; Saharnaz,4,0,20,16
1683335503075,ECE 148,A01,185647,Silberman; Jack,0,0,16,16
1683335504099,ECON 1,A01,185537,Crane; Meredith Helen,54,0,70,16
1683335505122,ECON 3,A01,185549,Crane; Meredith Helen,33,0,70,37
1683335506160,ECON 4,A01,203354,Anderson; John Charles,0,4,10,10
1683335507184,ECON 100A,A01,185574,Staff,0,4,40,40
1683335508212,ECON 100B,A01,185576,Staff,10,22,50,40
1683335509240,ECON 100C,A01,185589,Newhouse; Herbert S,30,0,70,40
1683335510266,ECON 105,A00,185608,Vespa; Emanuel Ignacio,19,0,35,16
1683335511289,ECON 109,A01,185610,Shishkin; Denis,10,0,35,25
1683335512312,ECON 110A,A01,185612,Staff,11,0,40,29
1683335513336,ECON 120A,A01,185615,Staff,20,0,40,20
1683335514360,ECON 120C,A01,185617,Sun; Yixiao,0,20,70,70
1683335515386,ECON 144,A00,203346,Squires; Dale E,3,0,35,32
1683335516414,ECON 171,A01,203349,Newhouse; Herbert S,0,1,35,35
1683335517438,ECON 173A,A01,185621,Toda; Alexis Akira,21,0,35,14
1683335518463,EDS 25,A01,202413,Staff,0,1,0,0
1683335518463,EDS 25,A02,202414,Staff,0,1,0,0
1683335518463,EDS 25,A03,202415,Staff,0,0,0,0
1683335518463,EDS 25,A04,202416,Staff,0,1,0,0
1683335518463,EDS 25,A05,202439,Staff,0,0,0,0
1683335518463,EDS 25,A06,202440,Staff,0,0,0,0
1683335518463,EDS 25,B01,202631,Staff,0,0,0,0
1683335518463,EDS 25,B02,202632,Staff,0,0,0,0
1683335518463,EDS 25,B03,202639,Staff,0,0,0,0
1683335518463,EDS 25,B04,202640,Staff,0,0,0,0
1683335518463,EDS 25,B05,202643,Staff,0,0,0,0
1683335518463,EDS 25,B06,202644,Staff,0,0,0,0
1683335519486,EDS 38,A01,202659,Black; Alison Michelle,24,0,25,1
1683335520512,EDS 115,A00,202652,Staff,17,0,30,13
1683335521538,EDS 125,A00,202649,Staff,14,0,30,16
1683335522565,EDS 126,A01,203332,Staff,30,0,30,0
1683335523588,EDS 139,A00,202838,Staff,16,0,25,9
1683335524614,EDS 146,A01,202655,Staff,14,0,25,11
1683335525643,ENG 15,A00,185667,Staff,0,1,0,0
1683335525643,ENG 15,B00,185672,Staff,0,0,0,0
1683335525643,ENG 15,C00,185675,Staff,0,0,0,0
1683335525643,ENG 15,D00,185682,Staff,0,0,0,0
1683335525643,ENG 15,E00,185684,Staff,0,0,0,0
1683335526669,ETHN 103,A00,185710,Staff,0,3,35,35
1683335527696,ETHN 103A,A00,199228,Man; Simeon S,2,0,9,7
1683335528720,ETHN 109,A00,185711,Staff,18,0,35,17
1683335529751,ETHN 142,A00,185726,Staff,0,4,30,30
1683335530779,ETHN 163J,A00,199229,Man; Simeon S,5,0,8,3
1683335531806,ETHN 168,A00,185727,Staff,8,0,10,2
1683335532829,ETHN 182,A00,185728,Staff,1,0,35,34
1683335533852,ETHN 183,A00,185737,Staff,8,0,18,10
1683335534875,GLBH 111,A01,209361,Burgos; Jose L.,0,0,0,0
1683335536928,HIEU 104,A00,185792,Staff,16,0,20,4
1683335537956,HIEU 115,A00,185800,Staff,1,0,20,19
1683335538982,HIEU 128,A00,185801,Staff,0,7,20,20
1683335540006,HIEU 147,A00,185802,Staff,16,0,20,4
1683335541032,HIEU 154,A00,185823,Staff,12,0,20,8
1683335542058,HILA 102,A00,185826,Staff,13,0,20,7
1683335543083,HILD 2C,A01,185778,Staff,0,12,20,20
1683335544111,HILD 7B,A01,185780,Kwak; Nancy,0,15,32,32
1683335544111,HILD 7B,A02,185781,Kwak; Nancy,0,18,32,32
1683335545135,HILD 30,A01,185791,Staff,14,0,20,6
1683335546160,HISC 119,A00,185830,Golan; Tal,0,9,20,20
1683335547184,HITO 156GS,A00,185831,Patterson; Patrick H.,0,0,0,23
1683335548207,HIUS 103,A00,185832,Man; Simeon S,0,6,20,20
1683335549232,HIUS 117,A00,185836,Kwak; Nancy,2,0,20,18
1683335550255,HIUS 125,A00,185840,Man; Simeon S,0,0,23,23
1683335551277,HIUS 149,A00,185845,Staff,0,0,20,20
1683335552305,HUM 3,A01,185882,Zavodny; Tatiana Sophia,0,7,50,50
1683335552305,HUM 3,B01,185899,Caldwell; Michael Alan,0,18,50,50
1683335553331,HUM 3GS,A00,185900,Patterson; Patrick H.,0,0,0,23
1683335554357,HUM 4,A01,185938,Zroka; Amy Liane,31,0,50,19
1683335554357,HUM 4,B01,185956,Watkins; Eric,0,2,50,50
1683335554357,HUM 4,B02,202209,Watkins; Eric,0,2,50,50
1683335554357,HUM 4,B03,202210,Watkins; Eric,0,2,50,50
1683335555380,HUM 5,A01,185958,West; Geoffrey Scott,3,0,50,47
1683335555380,HUM 5,A02,202215,West; Geoffrey Scott,0,0,50,50
1683335556404,INTL 190,A00,185959,Gagnon; Jeffrey C,0,0,0,9
1683335556404,INTL 190,B00,185960,Lettieri; Michael Joseph,0,0,0,1
1683335557428,JAPN 180,A00,254509,Staff,5,1,30,25
1683335558457,LATI 10,A01,202853,Kennemore; Amy Michelle,4,0,35,31
1683335558457,LATI 10,A02,202854,Kennemore; Amy Michelle,2,0,35,33
1683335558457,LATI 10,A03,270054,Kennemore; Amy Michelle,30,0,30,0
1683335559480,LATI 180,A00,202855,Kennemore; Amy Michelle,11,0,20,9
1683335560504,LAWS 101,A00,201767,Golan; Tal,0,7,40,40
1683335561528,LIFR 1C,A00,185961,Staff,6,0,20,14
1683335562555,LIFR 1CX,A00,185962,Staff,7,0,20,13
1683335563585,LIFR 1D,A00,185963,Staff,9,0,20,11
1683335564609,LIFR 1DX,A00,185964,Staff,9,0,20,11
1683335565634,LIGN 101,A01,186039,Staff,43,0,50,7
1683335566658,LIGN 165,A00,186040,Staff,18,0,50,32
1683335567685,LTCS 108,A00,186041,Staff,6,0,10,4
1683335568712,LTCS 119,A00,186042,Staff,16,0,20,4
1683335569738,LTCS 130,A00,186043,Wesling; Megan E.,15,0,25,10
1683335571789,LTEA 138,A00,186119,Staff,14,0,40,26
1683335572812,LTEN 124,A00,186148,Staff,6,0,25,19
1683335573834,LTEN 178,A00,186149,Staff,7,0,15,8
1683335574857,LTEN 181,A00,186150,Blanco; John D,33,0,40,7
1683335575881,LTWL 120,A00,186160,Staff,20,0,25,5
1683335576905,LTWL 165,A00,186161,Staff,22,0,25,3
1683335577931,LTWR 100,A00,186162,Staff,0,5,15,15
1683335578954,LTWR 102,A00,186163,Doller; Ben,5,0,15,10
1683335579980,MAE 8,A01,186412,Staff,0,0,0,0
1683335581008,MAE 30B,A00,186445,Bahadori; Mohammad Yousef,83,0,100,17
1683335582033,MAE 40,A00,186592,Bewley; Thomas R,9,0,50,41
1683335583062,MAE 101B,A00,186593,Bahadori; Mohammad Yousef,81,0,100,19
1683335584086,MAE 105,A00,186594,Bandaru; Prabhakar,12,0,50,38
1683335585114,MAE 107,A00,186599,Pham; Hieu Tan,0,6,120,120
1683335586138,MAE 148,A01,186660,Silberman; Jack,3,0,16,13
1683335587166,MATH 10A,A01,188095,Staff,1,6,35,34
1683335588192,MATH 10B,A01,188097,Bowers; Adam R.,0,11,30,30
1683335588192,MATH 10B,A02,188099,Bowers; Adam R.,0,11,30,30
1683335588192,MATH 10B,B01,188104,Bowers; Adam R.,0,10,30,30
1683335588192,MATH 10B,B02,188106,Bowers; Adam R.,0,10,30,30
1683335589221,MATH 10C,A01,188111,Staff,0,18,30,30
1683335589221,MATH 10C,A02,188127,Staff,0,17,30,30
1683335589221,MATH 10C,A03,188131,Staff,0,18,30,30
1683335589221,MATH 10C,B01,188218,Staff,18,0,30,12
1683335589221,MATH 10C,B02,188244,Staff,13,0,30,17
1683335589221,MATH 10C,B03,188277,Staff,16,0,30,14
1683335590248,MATH 18,A01,188344,Bach; Quang Tran,18,0,30,12
1683335590248,MATH 18,A02,188345,Bach; Quang Tran,11,0,30,19
1683335590248,MATH 18,B01,188353,Bach; Quang Tran,10,0,30,20
1683335590248,MATH 18,B02,188354,Bach; Quang Tran,20,0,30,10
1683335591334,MATH 20A,A01,188374,Staff,13,0,35,22
1683335592359,MATH 20B,A01,188382,Ohm; Ko Woon,6,0,30,24
1683335592359,MATH 20B,A02,188383,Ohm; Ko Woon,22,0,30,8
1683335592359,MATH 20B,B01,188385,Ohm; Ko Woon,7,0,30,23
1683335592359,MATH 20B,B02,188392,Ohm; Ko Woon,22,0,30,8
1683335593385,MATH 20C,A01,188394,Harel; Guershon,10,0,30,20
1683335593385,MATH 20C,A02,188395,Harel; Guershon,15,0,30,15
1683335593385,MATH 20C,B01,188404,Harel; Guershon,5,0,30,25
1683335593385,MATH 20C,B02,188405,Harel; Guershon,19,0,30,11
1683335594413,MATH 20D,A01,188414,Hammock; Frances H,0,1,30,30
1683335594413,MATH 20D,A02,188415,Hammock; Frances H,3,0,30,27
1683335594413,MATH 20D,B01,188447,Hammock; Frances H,1,0,30,29
1683335594413,MATH 20D,B02,188486,Hammock; Frances H,8,0,30,22
1683335595440,MATH 20E,A01,188649,Staff,21,0,30,9
1683335595440,MATH 20E,A02,188650,Staff,23,0,30,7
1683335595440,MATH 20E,A03,188673,Staff,0,0,30,30
1683335596466,MATH 102,A01,188675,Staff,0,35,35,35
1683335597490,MATH 103B,A01,188681,Staff,3,0,35,32
1683335597490,MATH 103B,B01,188692,Staff,5,0,35,30
1683335598516,MATH 109,A01,188695,Salehi Golsefidy; Alireza,25,0,35,10
1683335598516,MATH 109,A02,188696,Salehi Golsefidy; Alireza,25,0,35,10
1683335599540,MATH 120A,A01,188698,Eggers; John Dietrich,7,0,35,28
1683335600563,MATH 142B,A01,188736,Ioana; Adrian,0,2,30,30
1683335600563,MATH 142B,A02,188741,Ioana; Adrian,1,1,30,29
1683335600563,MATH 142B,A03,188743,Ioana; Adrian,1,3,30,29
1683335601586,MATH 168A,A01,188790,Staff,0,9,35,35
1683335602617,MATH 170A,A01,188803,Nie; Jiawang,0,2,35,35
1683335602617,MATH 170A,A02,188811,Nie; Jiawang,0,0,35,35
1683335602617,MATH 170A,A03,188814,Nie; Jiawang,1,0,35,34
1683335602617,MATH 170A,A04,188815,Nie; Jiawang,13,0,35,22
1683335603641,MATH 193B,A01,188817,Staff,0,0,35,35
1683335603641,MATH 193B,A02,188818,Staff,5,0,35,30
1683335604681,MGT 4,A01,202857,Anderson; John Charles,62,0,80,18
1683335605708,MGT 12,A00,202858,Lindenberger; Wade Douglas,42,0,90,48
1683335606733,MGT 18,A00,202859,Staff,74,0,90,16
1683335607756,MGT 18GS,A00,202860,McKay; Michael J,13,0,28,15
1683335608780,MGT 45,A00,202861,Pecore; Joseph P.,14,0,90,76
1683335609804,MGT 100,A00,202863,Yavorsky; Daniel Ryan,28,0,90,62
1683335610832,MGT 103,A00,202864,Ehrich; Kristine R,1,18,90,89
1683335611859,MGT 112,A00,202865,Ehrich; Kristine R,15,0,90,75
1683335612885,MGT 121A,A00,202868,Staff,0,20,0,0
1683335613911,MGT 131B,A00,202869,Anderson; John Charles,59,0,90,31
1683335614938,MGT 136,A00,202871,Lindenberger; Wade Douglas,84,0,90,6
1683335615962,MGT 164,A00,202873,Staff,0,68,90,91
1683335616985,MGT 164GS,A00,202874,McKay; Mary A,13,0,28,15
1683335618008,MGT 180,A00,202875,Staff,0,50,90,91
1683335619032,MMW 11R,A01,205019,Herbst; Matthew,3,0,30,27
1683335619032,MMW 11R,A02,205026,Herbst; Matthew,29,0,30,1
1683335620058,MMW 15,A01,193512,Chang; Edmond Yi-Teh,0,9,28,28
1683335620058,MMW 15,A02,193513,Chang; Edmond Yi-Teh,0,5,28,28
1683335620058,MMW 15,A03,193514,Chang; Edmond Yi-Teh,0,5,28,28
1683335620058,MMW 15,A04,193515,Chang; Edmond Yi-Teh,0,5,28,28
1683335620058,MMW 15,A05,193516,Chang; Edmond Yi-Teh,0,4,28,28
1683335620058,MMW 15,A06,193517,Chang; Edmond Yi-Teh,0,5,28,28
1683335620058,MMW 15,B01,193519,Chang; Edmond Yi-Teh,0,5,28,28
1683335620058,MMW 15,B02,193520,Chang; Edmond Yi-Teh,0,5,28,28
1683335620058,MMW 15,B03,193521,Chang; Edmond Yi-Teh,0,5,28,28
1683335620058,MMW 15,B04,193522,Chang; Edmond Yi-Teh,0,4,28,28
1683335620058,MMW 15,B05,193523,Chang; Edmond Yi-Teh,0,5,28,28
1683335620058,MMW 15,B06,193524,Chang; Edmond Yi-Teh,0,4,28,28
1683335621083,MMW 122,A01,193526,Rahimi; Babak,0,15,28,28
1683335621083,MMW 122,A02,193527,Rahimi; Babak,0,14,28,28
1683335621083,MMW 122,A03,193528,Rahimi; Babak,0,0,0,0
1683335621083,MMW 122,A04,193529,Rahimi; Babak,0,0,0,0
1683335622109,MUS 1A,A01,186663,Staff,0,20,35,35
1683335623133,MUS 4,A01,186715,Staff,0,12,35,35
1683335624156,MUS 5R,A01,186796,Dubnov; Shlomo,0,17,35,35
1683335625180,MUS 6,A01,186798,Staff,0,4,25,25
1683335626208,MUS 7,A01,186830,Staff,12,0,35,23
1683335627231,MUS 8,A01,186930,Staff,0,26,35,35
1683335628256,MUS 15,A01,186932,Staff,0,16,35,35
1683335628256,MUS 15,B01,186934,Staff,0,15,35,35
1683335629284,MUS 80,A00,186935,Staff,1,0,20,19
1683335629284,MUS 80,B00,186936,Staff,25,0,25,0
1683335630307,NANO 11,A00,204702,Lipomi; Darren John,0,0,0,0
1683335631332,NANO 15,A01,204709,Yang; Kesong,0,1,0,0
1683335632359,NANO 114,A00,202069,Jahed Motlagh; Zeinab,3,0,10,7
1683335633383,PHIL 1,A00,186955,Grush; Rick Scott,32,0,40,8
1683335634407,PHIL 10,A01,186973,Grush; Rick Scott,28,0,35,7
1683335634407,PHIL 10,A02,186974,Grush; Rick Scott,33,0,35,2
1683335635432,PHIL 13,A01,186976,Staff,7,0,35,28
1683335635432,PHIL 13,A02,186977,Staff,16,0,35,19
1683335636456,PHIL 14,A01,186979,Staff,31,0,35,4
1683335636456,PHIL 14,A02,186986,Staff,32,0,35,3
1683335637483,PHIL 28,A01,186988,Staff,16,0,30,14
1683335637483,PHIL 28,A02,186989,Staff,1,0,30,29
1683335637483,PHIL 28,A03,186990,Staff,9,0,30,21
1683335637483,PHIL 28,A04,186991,Staff,26,0,30,4
1683335638507,PHIL 120,A00,186997,Staff,23,0,40,17
1683335639534,PHIL 137,A00,187003,Staff,9,0,40,31
1683335640556,PHIL 150,A00,187015,Staff,47,0,70,23
1683335641583,PHIL 167,A00,187021,Lamey; Andy M.,35,0,40,5
1683335642610,PHIL 174,A01,202226,Staff,17,0,20,3
1683335642610,PHIL 174,A02,202235,Staff,20,0,20,0
1683335643634,PHIL 191A,A00,258918,Staff,0,0,1,1
1683335644660,PHYS 1A,A00,187028,Staff,27,0,60,33
1683335645684,PHYS 1AL,001,187036,Staff,2,0,30,28
1683335645684,PHYS 1AL,002,187049,Staff,18,0,30,12
1683335646707,PHYS 1B,A00,187058,Staff,22,0,60,38
1683335647734,PHYS 1BL,001,187064,Staff,0,0,30,30
1683335647734,PHYS 1BL,002,187070,Staff,5,0,30,25
1683335648759,PHYS 1C,A00,187082,Staff,31,0,120,89
1683335649787,PHYS 1CL,001,187088,Staff,0,9,30,30
1683335649787,PHYS 1CL,002,187089,Staff,0,2,30,30
1683335649787,PHYS 1CL,009,262693,Staff,11,0,30,19
1683335650815,PHYS 2B,A01,187097,Staff,54,0,115,61
1683335651843,PHYS 2C,A01,187099,Staff,67,0,115,48
1683335652871,PHYS 2CL,A01,187101,Staff,5,0,28,23
1683335652871,PHYS 2CL,A02,187102,Staff,15,0,28,13
1683335653896,PHYS 2D,A01,187123,Shotwell; Brian,95,0,115,20
1683335654919,PHYS 4B,A01,187133,Grinstein; Benjamin,35,0,50,15
1683335655946,POLI 10,A00,188819,Staff,0,4,50,50
1683335656973,POLI 11,A00,188827,Staff,43,0,50,7
1683335657995,POLI 13R,A00,188828,Staff,0,1,20,20
1683335659022,POLI 27,A01,188830,Elgin; Samuel Zincke,0,1,70,70
1683335660050,POLI 30,A00,188832,Desposato; Scott,31,0,50,19
1683335661074,POLI 102F,A00,188834,Staff,3,0,40,37
1683335662098,POLI 104A,A00,188852,Staff,14,0,30,16
1683335663124,POLI 104I,A00,188853,Staff,0,6,20,20
1683335664150,POLI 110B,A00,188854,Wiens; David,7,0,20,13
1683335665176,POLI 112A,A00,188855,Wiens; David,5,0,30,25
1683335666201,POLI 117R,A00,188856,Forman; Fonna,0,11,20,20
1683335667223,POLI 118,A00,188857,Ingham; Sean,8,0,20,12
1683335668250,POLI 120G,A00,188858,Staff,9,0,30,21
1683335669273,POLI 131CR,A00,188863,Hoston; Germaine,24,0,50,26
1683335670297,POLI 133,A00,188864,Nellis; Gareth Hb,44,0,50,6
1683335671324,POLI 134D,A00,188865,Desposato; Scott,27,0,30,3
1683335672351,POLI 142A,A00,188871,Gartzke; Erik,22,0,50,28
1683335673380,POLI 142K,A00,188874,Staff,38,0,50,12
1683335674403,POLI 143,A00,188940,Gartzke; Erik,16,0,30,14
1683335675426,POLI 153,A00,188943,Staff,3,0,20,17
1683335676448,POLI 160AA,A00,188944,Staff,12,0,40,28
1683335677471,POLI 170A,A00,188945,Staff,11,0,30,19
1683335679522,PSYC 1,A00,188952,Staff,37,0,90,53
1683335680546,PSYC 2,B00,188953,Staff,19,0,35,16
1683335681569,PSYC 6,A00,188970,Staff,47,0,60,13
1683335682596,PSYC 7,A00,188973,Staff,37,0,45,8
1683335683620,PSYC 60,A01,188980,Rickard; Timothy C.,43,0,60,17
1683335684644,PSYC 70,A01,189001,Steiner; Eric Tomas,24,0,45,21
1683335685671,PSYC 100,A00,189005,Lacefield; Katharine I,0,100,120,120
1683335686695,PSYC 102,A00,189008,Staff,9,0,30,21
1683335687718,PSYC 106,B00,189026,Gorman; Michael R.,34,0,60,26
1683335688745,PSYC 114,B01,189033,Winkielman; Piotr,0,32,30,30
1683335689768,PSYC 131,A00,189036,Anagnostaras; Stephan,0,43,60,60
1683335690791,PSYC 136,A00,189041,Lowe; Angela Beth,0,7,25,25
1683335691815,PSYC 137,A00,189057,Winkielman; Piotr,0,34,25,25
1683335692840,PSYC 144,A00,189107,Wixted; John T,0,7,50,50
1683335694945,PSYC 162,A00,189142,Staff,0,8,85,85
1683335695968,PSYC 172,A00,189144,Gorman; Michael R.,0,7,30,30
1683335698019,PSYC 179,A00,189146,Lacefield; Katharine I,0,84,120,120
1683335699043,PSYC 181,A00,189147,Anagnostaras; Stephan,0,44,90,90
1683335700068,PSYC 190R,A00,189148,Barner; David A.,0,22,80,80
1683335701094,PSYC 191,A00,189275,Rickard; Timothy C.,0,7,25,25
1683335702122,PSYC 193,A00,189276,Chapman; Eddie Nathaniel,0,1,0,4
1683335703147,PSYC 193L,A01,189281,Lowe; Angela Beth,12,0,20,8
1683335703147,PSYC 193L,B01,189285,Staff,28,0,35,7
1683335704171,RELI 149,A00,187137,Rahimi; Babak,7,0,40,33
1683335705195,SE 9,A01,187315,Staff,0,2,18,18
1683335706220,SE 101B,A00,187409,Staff,24,0,30,6
1683335707243,SE 110B,A00,187444,Staff,10,0,40,30
1683335708269,SE 130B,A00,187449,Staff,31,0,40,9
1683335709298,SE 150A,A00,187516,Staff,9,0,20,11
1683335710323,SE 154,A00,187528,Staff,30,0,50,20
1683335711346,SIO 3,A01,258171,Staff,35,0,40,5
1683335712372,SIO 10,A00,187144,Cook; Geoffrey W,0,3,75,75
1683335713395,SIO 45,A00,187152,Cook; Geoffrey W,1,0,100,99
1683335714422,SIO 109R,A00,194486,Staff,0,3,20,20
1683335716469,SIO 187,A01,187233,Kacev; David,12,0,40,28
1683335717494,SOCI 1,A01,258656,Thorpe; Charles Robert,28,0,30,2
1683335717494,SOCI 1,A02,258658,Thorpe; Charles Robert,30,0,30,0
1683335717494,SOCI 1,A03,258661,Thorpe; Charles Robert,25,0,25,0
1683335717494,SOCI 1,A04,258666,Thorpe; Charles Robert,22,0,25,3
1683335717494,SOCI 1,A05,258897,Thorpe; Charles Robert,23,0,25,2
1683335717494,SOCI 1,A06,258898,Thorpe; Charles Robert,25,0,25,0
1683335718522,SOCI 30,A01,258903,Pardo Guerra; Juan Pablo,15,0,30,15
1683335719549,SOCI 102,A00,258904,Staff,9,0,25,16
1683335720575,SOCI 106,A00,258905,Staff,19,0,25,6
1683335721598,SOCI 111,A00,258907,Ribas Norris; Janet Vanesa,26,0,30,4
1683335722622,SOCI 121R,A00,258908,Pardo Guerra; Juan Pablo,10,0,30,20
1683335723646,SOCI 126,A01,203330,Staff,14,0,20,6
1683335724670,SOCI 131,A00,258909,Thorpe; Charles Robert,31,0,60,29
1683335725695,SOCI 135,A00,258910,Payne; Christine Anna,0,9,30,30
1683335726718,SOCI 157,A00,258911,Staff,12,0,30,18
1683335727741,SOCI 184,A00,258912,Staff,25,0,30,5
1683335728768,SOCI 188D,A00,258913,Staff,21,0,30,9
1683335729795,SYN 2,001,187529,Staff,10,0,16,6
1683335729795,SYN 2,002,201452,Staff,0,18,16,16
1683335729795,SYN 2,003,201469,Staff,3,0,16,13
1683335730819,SYN 100,A01,187531,Staff,0,9,20,20
1683335730819,SYN 100,B01,201491,Staff,0,12,20,20
1683335731848,TDAC 1,A00,189286,Walsh; Kim C.,3,0,20,17
1683335731848,TDAC 1,B00,189287,Harting; Carla Kelso,11,0,20,9
1683335732872,TDAC 101,A00,189300,Walsh; Kim C.,16,0,20,4
1683335732872,TDAC 101,B00,189301,Harting; Carla Kelso,18,0,20,2
1683335733897,TDAC 102,A00,189304,Basso; Beatrice,14,0,20,6
1683335734921,TDAC 108,A00,189305,Staff,18,0,20,2
1683335735948,TDDE 131,A00,189310,Staff,19,0,20,1
1683335735948,TDDE 131,B00,189314,Staff,19,0,20,1
1683335735948,TDDE 131,C00,189315,Staff,48,0,50,2
1683335735948,TDDE 131,D00,189316,Staff,14,0,15,1
1683335735948,TDDE 131,E00,204841,Staff,20,0,20,0
1683335736972,TDGE 10,A00,189289,Staff,30,0,50,20
1683335736972,TDGE 10,B00,189290,Havis; Allan,1,0,50,49
1683335738001,TDGE 11,A00,189291,Fulton; Julia,0,3,50,50
1683335738001,TDGE 11,B00,189292,Staff,20,0,25,5
1683335738001,TDGE 11,C00,260270,Staff,0,0,0,0
1683335739026,TDGE 25,A00,189294,Staff,3,0,20,17
1683335740049,TDGE 124,A00,189318,Fulton; Julia,0,8,50,50
1683335741073,TDGE 125,A00,189319,Staff,13,0,25,12
1683335741073,TDGE 125,B00,189320,Staff,23,0,25,2
1683335742096,TDGE 127,A00,189322,Havis; Allan,0,0,50,50
1683335743123,TDHT 101,A00,189323,Staff,18,0,25,7
1683335743123,TDHT 101,B00,189324,Staff,25,0,25,0
1683335744150,TDHT 102,A00,189325,Staff,49,0,50,1
1683335745174,TDMV 1,A00,189295,Arcidiacono; Kristin,19,0,30,11
1683335745174,TDMV 1,B00,189296,Caligagan; Maria T.,24,0,30,6
1683335746210,TDMV 2,A00,189297,Sammartano; Tonnie,28,0,30,2
1683335746210,TDMV 2,B00,189299,Arcidiacono; Kristin,24,0,30,6
1683335747236,TDMV 3,A00,204998,Rincon; Alicia,22,0,30,8
1683335748258,TDMV 120,A00,189458,Sammartano; Tonnie,28,0,30,2
1683335749285,TDMV 138,A00,189541,Jun; Grace Shin Hae,22,0,40,18
1683335750310,TDMV 142,A00,189717,Caligagan; Tony,23,0,30,7
1683335750310,TDMV 142,B00,189718,Caligagan; Maria T.,25,0,30,5
1683335751334,TMC 2,A01,187533,Staff,25,0,25,0
1683335751334,TMC 2,A02,187534,Staff,25,0,25,0
1683335752358,USP 1,A01,187536,Kwak; Nancy,0,16,25,25
1683335753382,USP 5,A01,187538,Staff,10,0,25,15
1683335754406,USP 101,A00,199253,Staff,0,4,0,0
1683335755432,USP 124,A00,187562,Boomhower; Matthew Charles,1,0,30,29
1683335756455,USP 138,A00,187582,Staff,20,0,25,5
1683335757478,USP 152,A01,187597,Staff,4,0,25,21
1683335758502,USP 153,A00,187598,Staff,19,0,25,6
1683335759528,USP 168,A00,187607,Kwak; Nancy,2,0,5,3
1683335760552,USP 173,A00,187619,Staff,4,0,25,21
1683335761586,USP 181,A00,187638,Staff,0,0,25,25
1683335762612,VIS 103,A00,187650,Cruz; Edwin Teddy,23,0,75,52
1683335763636,VIS 110D,A00,187669,Staff,12,0,22,10
1683335764661,VIS 127C,A00,187720,Shen; Kuiyi,67,0,146,79
1683335765686,VIS 149,A00,187731,Yoldas; Pinar,0,14,22,22
1683335766714,VIS 151,A01,188091,Staff,22,0,34,12
1683335766714,VIS 151,A02,188092,Staff,11,0,34,23
1683335767740,VIS 160B,A00,188093,Stalbaum; Brett,0,0,10,10
1683335769791,WCWP 10B,A00,201720,Staff,10,0,15,5
1683335769791,WCWP 10B,B00,201722,Staff,9,0,15,6
1683335770815,WCWP 100,A00,201725,Gagnon; Jeffrey C,0,0,2,2
1683335770815,WCWP 100,B00,201727,Staff,0,4,15,15
1683335773914,ANBI 133,A00,258401,Wilder; Linnea Lorene,34,0,40,6
1683335774937,ANBI 140,A00,258395,Hrvoj Mihic; Branka,18,0,25,7
1683335775960,ANSC 120,A00,258402,Bialecki; Jon Anthony,27,0,40,13
1683335776987,ANSC 144,A00,258400,Staff,14,0,40,26
1683335779038,ANSC 166,A00,258396,Parish; Steven Martin,157,0,175,18
1683335780065,ANSC 180,A00,193533,Staff,9,0,20,11
1683335781090,ANSC 188,A00,258397,Jassal; Aftab,33,0,40,7
1683335782117,ANTH 3,A01,258316,Staff,23,0,30,7
1683335783143,ANTH 5,A00,258394,Semendeferi; Ekaterini,16,0,20,4
1683335784166,ANTH 21,A01,258331,Staff,8,0,40,32
1683335785191,ANTH 103,A00,258398,Varma; Saiba,15,0,25,10
1683335786220,AWP 10,001,202034,Staff,0,0,0,0
1683335786220,AWP 10,002,202035,Staff,0,0,0,0
1683335786220,AWP 10,003,202036,Staff,0,0,0,0
1683335786220,AWP 10,004,202037,Staff,0,0,0,0
1683335786220,AWP 10,005,202038,Staff,0,0,0,0
1683335786220,AWP 10,006,202039,Staff,0,0,0,0
1683335786220,AWP 10,007,202040,Staff,0,0,0,0
1683335786220,AWP 10,008,202041,Staff,0,0,0,0
1683335786220,AWP 10,009,202042,Staff,0,0,0,0
1683335786220,AWP 10,010,202043,Staff,0,0,0,0
1683335786220,AWP 10,011,202044,Staff,0,0,0,0
1683335786220,AWP 10,012,202045,Staff,0,0,0,0
1683335786220,AWP 10,013,202046,Staff,0,0,0,0
1683335786220,AWP 10,014,202047,Staff,0,0,0,0
1683335786220,AWP 10,015,202048,Staff,0,0,0,0
1683335786220,AWP 10,016,202049,Staff,0,0,0,0
1683335786220,AWP 10,017,202050,Staff,0,0,0,0
1683335786220,AWP 10,018,202051,Staff,0,0,0,0
1683335786220,AWP 10,019,202052,Staff,0,0,0,0
1683335786220,AWP 10,020,202053,Staff,0,0,0,0
1683335786220,AWP 10,021,202054,Staff,0,0,0,0
1683335786220,AWP 10,022,202055,Staff,0,0,0,0
1683335786220,AWP 10,023,202056,Staff,0,0,0,0
1683335786220,AWP 10,024,202057,Staff,0,0,0,0
1683335786220,AWP 10,025,202058,Staff,0,0,0,0
1683335786220,AWP 10,026,202059,Staff,0,0,0,0
1683335787245,AWP 102,001,202032,Staff,0,0,0,0
1683335787245,AWP 102,002,202033,Staff,0,0,0,0
1683335788273,BENG 100,A01,254234,Taylor Amos; Alyssa C,31,0,40,9
1683335789297,BENG 196,001,270013,Engler; Adam J.,9999,0,9999,0
1683335790322,BICD 100R,A01,202018,Smith; Laurie,0,7,32,32
1683335790322,BICD 100R,A02,202019,Smith; Laurie,0,2,32,32
1683335790322,BICD 100R,A03,202020,Smith; Laurie,0,1,32,32
1683335790322,BICD 100R,A04,202021,Smith; Laurie,9,0,32,23
1683335790322,BICD 100R,A05,202022,Smith; Laurie,12,0,32,20
1683335791347,BICD 136,A01,193242,Gustafson-Brown; Cindy,0,2,32,32
1683335791347,BICD 136,A02,193244,Gustafson-Brown; Cindy,14,0,32,18
1683335792372,BIEB 102,A01,193249,Butler; Shannon Rhey,0,2,32,32
1683335792372,BIEB 102,A02,193251,Butler; Shannon Rhey,0,0,32,32
1683335792372,BIEB 102,A03,193253,Butler; Shannon Rhey,0,1,32,32
1683335792372,BIEB 102,A04,193255,Butler; Shannon Rhey,17,0,32,15
1683335792372,BIEB 102,A05,193265,Butler; Shannon Rhey,26,0,32,6
1683335792372,BIEB 102,A06,193269,Butler; Shannon Rhey,16,0,32,16
1683335794424,BIEB 150,A01,193274,Staff,0,0,32,32
1683335794424,BIEB 150,A02,193285,Staff,23,0,32,9
1683335795447,BIEB 194,A00,193286,Kurle; Carolyn M.,22,0,32,10
1683335796471,BILD 1,A01,192291,Staff,16,0,32,16
1683335796471,BILD 1,A02,192292,Staff,30,0,32,2
1683335796471,BILD 1,B01,192520,Reuther; Keefe,0,1,0,0
1683335796471,BILD 1,B02,192532,Reuther; Keefe,0,1,0,0
1683335797501,BILD 3,A01,192556,Butler; Shannon Rhey,0,0,32,32
1683335797501,BILD 3,A02,192581,Butler; Shannon Rhey,5,0,32,27
1683335797501,BILD 3,A03,192611,Butler; Shannon Rhey,23,0,32,9
1683335797501,BILD 3,A04,192612,Butler; Shannon Rhey,25,0,32,7
1683335797501,BILD 3,A05,192613,Butler; Shannon Rhey,27,0,32,5
1683335797501,BILD 3,A06,192679,Butler; Shannon Rhey,27,0,32,5
1683335797501,BILD 3,A07,192682,Butler; Shannon Rhey,22,0,32,10
1683335798578,BILD 4,A01,192836,Reuther; Keefe,0,0,24,24
1683335798578,BILD 4,A02,193044,Reuther; Keefe,4,0,24,20
1683335799606,BILD 10,A01,193142,Gustafson-Brown; Cindy,30,0,32,2
1683335799606,BILD 10,A02,193149,Gustafson-Brown; Cindy,31,0,32,1
1683335800629,BIMM 100,A01,193301,Staff,0,6,32,32
1683335800629,BIMM 100,A02,193312,Staff,0,5,32,32
1683335800629,BIMM 100,A03,193323,Staff,0,8,32,32
1683335801657,BIMM 101,A01,193329,McDonnell; Lisa Marie,0,3,24,24
1683335801657,BIMM 101,A02,193339,McDonnell; Lisa Marie,0,3,24,24
1683335801657,BIMM 101,B01,193354,McDonnell; Lisa Marie,0,3,24,24
1683335801657,BIMM 101,B02,193357,McDonnell; Lisa Marie,0,3,24,24
1683335802686,BIMM 110,A01,193377,Tat; John,0,11,32,32
1683335802686,BIMM 110,A02,193378,Tat; John,1,9,32,31
1683335803709,BIMM 120,A01,206116,Staff,0,0,32,32
1683335803709,BIMM 120,A02,206117,Staff,8,0,32,24
1683335803709,BIMM 120,A03,206121,Staff,21,0,32,11
1683335804739,BIPN 100,A01,193393,Park; Ji Young,0,14,32,32
1683335804739,BIPN 100,A02,193402,Park; Ji Young,0,13,32,32
1683335804739,BIPN 100,A03,193413,Park; Ji Young,0,14,32,32
1683335804739,BIPN 100,A04,193414,Park; Ji Young,0,13,32,32
1683335805763,BIPN 102,A01,193429,Staff,0,0,32,32
1683335805763,BIPN 102,A02,193438,Staff,22,0,32,10
1683335806788,BIPN 106,A01,193450,Reyes Gonzalez; Catalina,0,2,40,40
1683335807812,BIPN 134,A01,193465,Cooke; James Edward,0,0,32,32
1683335807812,BIPN 134,A02,193474,Cooke; James Edward,25,0,32,7
1683335807812,BIPN 134,A03,193485,Cooke; James Edward,29,0,32,3
1683335807812,BIPN 134,A04,193486,Cooke; James Edward,21,0,32,11
1683335807812,BIPN 134,A05,193491,Cooke; James Edward,31,0,32,1
1683335807812,BIPN 134,A06,193501,Cooke; James Edward,30,0,32,2
1683335807812,BIPN 134,A07,193510,Cooke; James Edward,29,0,32,3
1683335809861,BISP 194,A00,222522,Staff,14,0,32,18
1683335810888,CAT 124,A01,202407,Staff,20,0,25,5
1683335811912,CAT 125,A00,202408,Marchisotto; Jennifer Anne,4,0,20,16
1683335812937,CAT 125R,A00,202409,Smith; Lauryn Alissa,0,11,20,20
1683335812937,CAT 125R,B00,202410,Morales; Celeste Georgianna,0,11,20,20
1683335812937,CAT 125R,C00,202411,Irwin; Matthew Joseph,0,10,20,20
1683335813962,CENG 15,A01,204712,Yang; Kesong,0,1,0,0
1683335814986,CENG 114,A00,202070,Jahed Motlagh; Zeinab,5,0,20,15
1683335816009,CGS 105,A00,185477,Wesling; Megan E.,24,0,40,16
1683335817034,CGS 106,A00,185494,Staff,13,0,22,9
1683335818057,CGS 108,A00,185495,Staff,14,0,20,6
1683335819082,CGS 114,A00,185496,Staff,13,0,18,5
1683335820106,CGS 119,A00,185501,Staff,15,0,20,5
1683335821130,CGS 120,A00,185511,Staff,13,0,20,7
1683335822156,CHEM 4,A01,184675,Bussey; Thomas J,96,0,100,4
1683335823180,CHEM 6A,A01,184677,Staff,34,0,60,26
1683335824207,CHEM 6B,A01,184679,Staff,65,0,100,35
1683335825236,CHEM 6C,A01,184681,Bussey; Thomas J,1,0,50,49
1683335825236,CHEM 6C,A02,184682,Bussey; Thomas J,34,0,50,16
1683335826264,CHEM 40A,A01,184684,Albizati; Kim F.,37,0,100,63
1683335827291,CHEM 40B,A01,184686,Albizati; Kim F.,0,20,100,100
1683335828317,CHEM 41B,A01,184690,Staff,52,0,100,48
1683335829346,COGS 3,A01,184715,Boyle; Mary E. T.,0,25,40,40
1683335830372,COGS 14B,A01,185172,Staff,0,15,38,38
1683335831408,COGS 18,A01,184736,Staff,17,0,80,63
1683335832433,COGS 100,A01,184932,Staff,0,5,73,73
1683335833458,COGS 101A,A01,184935,Staff,0,39,30,30
1683335834486,COGS 101B,A01,184944,Staff,0,2,30,30
1683335835510,COGS 101C,A01,184946,Staff,0,12,30,30
1683335836536,COGS 102A,A01,184951,Johnson; Christine M.,2,0,40,38
1683335837561,COGS 107B,A01,184953,Mooshagian; Eric Frederick,0,50,40,40
1683335838586,COGS 118B,A01,184959,Gupta; Anjum,0,48,40,40
1683335839611,COGS 153,A00,184961,Staff,0,15,30,30
1683335840634,COGS 177,A00,184962,Staff,0,20,30,30
1683335841659,COGS 187A,A01,184969,Boyle; Mary E. T.,0,17,40,40
1683335842685,COMM 10,A01,185174,Staff,0,5,25,25
1683335842685,COMM 10,A02,185189,Staff,0,5,25,25
1683335842685,COMM 10,A03,269821,Staff,0,0,0,0
1683335843712,COMM 100B,A01,185475,Staff,0,0,0,2
1683335843712,COMM 100B,A02,185476,Staff,14,0,25,11
1683335844736,COMM 100C,A01,185314,Staff,1,0,25,24
1683335844736,COMM 100C,A02,185327,Staff,19,0,25,6
1683335845762,COMM 110M,A00,185349,Staff,2,0,40,38
1683335846786,COMM 113T,A00,185352,Staff,24,0,40,16
1683335847814,COMM 114I,A00,185353,Staff,33,0,40,7
1683335848838,COMM 131,A00,185354,Staff,19,0,30,11
1683335849863,CSE 8A,A50,185358,Cao; Yingjun,0,46,10,10
1683335850887,CSE 8B,A01,185362,Staff,1,47,50,49
1683335851912,CSE 11,A01,185416,Cao; Yingjun,0,92,10,10
1683335852937,CSE 20,A01,185445,Briones; Jor-el Thomas Caparas,5,0,25,20
1683335853960,CSE 21,A01,185447,Staff,10,0,50,40
1683335854990,CSE 101,A01,185451,Staff,0,13,50,50
1683335854990,CSE 101,B01,185453,Jones; Miles E,0,11,50,50
1683335857041,CSE 141,A01,185458,Eldon; John,20,0,100,80
1683335858068,CSE 141L,A01,185461,Eldon; John,12,0,100,88
1683335859098,CSE 142,A01,185463,Staff,36,0,60,24
1683335859098,CSE 142,B01,201355,Staff,0,7,60,60
1683335860122,CSE 142L,A01,185470,Staff,36,0,60,24
1683335860122,CSE 142L,B01,201417,Staff,0,6,60,60
1683335861147,CSE 190,A00,201433,Staff,32,0,49,17
1683335862178,DOC 1,A01,259136,Strom; Megan C.,7,0,15,8
1683335862178,DOC 1,A02,259137,Strom; Megan C.,14,0,15,1
1683335862178,DOC 1,A03,259138,Strom; Megan C.,14,0,15,1
1683335862178,DOC 1,A04,259139,Strom; Megan C.,14,0,15,1
1683335863203,DOC 100D,A00,259140,Pass; Natalye Joann,16,0,25,9
1683335864232,DSGN 1,A01,184749,Rill; Bryan,0,25,30,30
1683335865257,DSGN 100,A01,185168,Staff,0,2,25,25
1683335866290,ECE 5,A01,185626,Morris; Karcher William,0,10,0,0
1683335867315,ECE 101,A01,185628,Staff,17,0,70,53
1683335868338,ECE 107,A01,185635,Baghdadchi; Saharnaz,0,0,20,20
1683335868338,ECE 107,A02,185638,Baghdadchi; Saharnaz,4,0,20,16
1683335869364,ECE 148,A01,185647,Silberman; Jack,0,0,16,16
1683335870388,ECON 1,A01,185537,Crane; Meredith Helen,54,0,70,16
1683335871413,ECON 3,A01,185549,Crane; Meredith Helen,33,0,70,37
1683335872438,ECON 4,A01,203354,Anderson; John Charles,0,4,10,10
1683335873463,ECON 100A,A01,185574,Staff,0,4,40,40
1683335874487,ECON 100B,A01,185576,Staff,10,22,50,40
1683335875513,ECON 100C,A01,185589,Newhouse; Herbert S,30,0,70,40
1683335876541,ECON 105,A00,185608,Vespa; Emanuel Ignacio,19,0,35,16
1683335877569,ECON 109,A01,185610,Shishkin; Denis,10,0,35,25
1683335878597,ECON 110A,A01,185612,Staff,11,0,40,29
1683335879624,ECON 120A,A01,185615,Staff,20,0,40,20
1683335880647,ECON 120C,A01,185617,Sun; Yixiao,0,20,70,70
1683335881673,ECON 144,A00,203346,Squires; Dale E,3,0,35,32
1683335882698,ECON 171,A01,203349,Newhouse; Herbert S,0,1,35,35
1683335883721,ECON 173A,A01,185621,Toda; Alexis Akira,21,0,35,14
1683335884749,EDS 25,A01,202413,Staff,0,1,0,0
1683335884749,EDS 25,A02,202414,Staff,0,1,0,0
1683335884749,EDS 25,A03,202415,Staff,0,0,0,0
1683335884749,EDS 25,A04,202416,Staff,0,1,0,0
1683335884749,EDS 25,A05,202439,Staff,0,0,0,0
1683335884749,EDS 25,A06,202440,Staff,0,0,0,0
1683335884749,EDS 25,B01,202631,Staff,0,0,0,0
1683335884749,EDS 25,B02,202632,Staff,0,0,0,0
1683335884749,EDS 25,B03,202639,Staff,0,0,0,0
1683335884749,EDS 25,B04,202640,Staff,0,0,0,0
1683335884749,EDS 25,B05,202643,Staff,0,0,0,0
1683335884749,EDS 25,B06,202644,Staff,0,0,0,0
1683335885774,EDS 38,A01,202659,Black; Alison Michelle,24,0,25,1
1683335886800,EDS 115,A00,202652,Staff,17,0,30,13
1683335887823,EDS 125,A00,202649,Staff,14,0,30,16
1683335888850,EDS 126,A01,203332,Staff,30,0,30,0
1683335889878,EDS 139,A00,202838,Staff,16,0,25,9
1683335890904,EDS 146,A01,202655,Staff,14,0,25,11
1683335891932,ENG 15,A00,185667,Staff,0,1,0,0
1683335891932,ENG 15,B00,185672,Staff,0,0,0,0
1683335891932,ENG 15,C00,185675,Staff,0,0,0,0
1683335891932,ENG 15,D00,185682,Staff,0,0,0,0
1683335891932,ENG 15,E00,185684,Staff,0,0,0,0
1683335892955,ETHN 103,A00,185710,Staff,0,3,35,35
1683335893980,ETHN 103A,A00,199228,Man; Simeon S,2,0,9,7
1683335895006,ETHN 109,A00,185711,Staff,18,0,35,17
1683335896034,ETHN 142,A00,185726,Staff,0,4,30,30
1683335897059,ETHN 163J,A00,199229,Man; Simeon S,5,0,8,3
1683335898087,ETHN 168,A00,185727,Staff,8,0,10,2
1683335899112,ETHN 182,A00,185728,Staff,1,0,35,34
1683335900135,ETHN 183,A00,185737,Staff,8,0,18,10
1683335901165,GLBH 111,A01,209361,Burgos; Jose L.,0,0,0,0
1683335903274,HIEU 104,A00,185792,Staff,16,0,20,4
1683335904298,HIEU 115,A00,185800,Staff,1,0,20,19
1683335905326,HIEU 128,A00,185801,Staff,0,7,20,20
1683335906354,HIEU 147,A00,185802,Staff,16,0,20,4
1683335907379,HIEU 154,A00,185823,Staff,12,0,20,8
1683335908407,HILA 102,A00,185826,Staff,13,0,20,7
1683335909438,HILD 2C,A01,185778,Staff,0,12,20,20
1683335910466,HILD 7B,A01,185780,Kwak; Nancy,0,15,32,32
1683335910466,HILD 7B,A02,185781,Kwak; Nancy,0,18,32,32
1683335911491,HILD 30,A01,185791,Staff,14,0,20,6
1683335912519,HISC 119,A00,185830,Golan; Tal,0,9,20,20
1683335913544,HITO 156GS,A00,185831,Patterson; Patrick H.,0,0,0,23
1683335914573,HIUS 103,A00,185832,Man; Simeon S,0,6,20,20
1683335915597,HIUS 117,A00,185836,Kwak; Nancy,2,0,20,18
1683335916620,HIUS 125,A00,185840,Man; Simeon S,0,0,23,23
1683335917649,HIUS 149,A00,185845,Staff,0,0,20,20
1683335918673,HUM 3,A01,185882,Zavodny; Tatiana Sophia,0,7,50,50
1683335918673,HUM 3,B01,185899,Caldwell; Michael Alan,0,18,50,50
1683335919698,HUM 3GS,A00,185900,Patterson; Patrick H.,0,0,0,23
1683335920722,HUM 4,A01,185938,Zroka; Amy Liane,31,0,50,19
1683335920722,HUM 4,B01,185956,Watkins; Eric,0,2,50,50
1683335920722,HUM 4,B02,202209,Watkins; Eric,0,2,50,50
1683335920722,HUM 4,B03,202210,Watkins; Eric,0,2,50,50
1683335921746,HUM 5,A01,185958,West; Geoffrey Scott,3,0,50,47
1683335921746,HUM 5,A02,202215,West; Geoffrey Scott,0,0,50,50
1683335922772,INTL 190,A00,185959,Gagnon; Jeffrey C,0,0,0,9
1683335922772,INTL 190,B00,185960,Lettieri; Michael Joseph,0,0,0,1
1683335923796,JAPN 180,A00,254509,Staff,5,1,30,25
1683335924821,LATI 10,A01,202853,Kennemore; Amy Michelle,4,0,35,31
1683335924821,LATI 10,A02,202854,Kennemore; Amy Michelle,2,0,35,33
1683335924821,LATI 10,A03,270054,Kennemore; Amy Michelle,30,0,30,0
1683335925849,LATI 180,A00,202855,Kennemore; Amy Michelle,11,0,20,9
1683335926873,LAWS 101,A00,201767,Golan; Tal,0,7,40,40
1683335927898,LIFR 1C,A00,185961,Staff,6,0,20,14
1683335928921,LIFR 1CX,A00,185962,Staff,7,0,20,13
1683335929946,LIFR 1D,A00,185963,Staff,9,0,20,11
1683335930971,LIFR 1DX,A00,185964,Staff,9,0,20,11
1683335931995,LIGN 101,A01,186039,Staff,43,0,50,7
1683335933021,LIGN 165,A00,186040,Staff,18,0,50,32
1683335934044,LTCS 108,A00,186041,Staff,6,0,10,4
1683335935068,LTCS 119,A00,186042,Staff,16,0,20,4
1683335936095,LTCS 130,A00,186043,Wesling; Megan E.,15,0,25,10
1683335938142,LTEA 138,A00,186119,Staff,14,0,40,26
1683335939169,LTEN 124,A00,186148,Staff,6,0,25,19
1683335940195,LTEN 178,A00,186149,Staff,7,0,15,8
1683335941222,LTEN 181,A00,186150,Blanco; John D,33,0,40,7
1683335942248,LTWL 120,A00,186160,Staff,20,0,25,5
1683335943279,LTWL 165,A00,186161,Staff,22,0,25,3
1683335944303,LTWR 100,A00,186162,Staff,0,5,15,15
1683335945327,LTWR 102,A00,186163,Doller; Ben,5,0,15,10
1683335946354,MAE 8,A01,186412,Staff,0,0,0,0
1683335947380,MAE 30B,A00,186445,Bahadori; Mohammad Yousef,83,0,100,17
1683335948407,MAE 40,A00,186592,Bewley; Thomas R,9,0,50,41
1683335949431,MAE 101B,A00,186593,Bahadori; Mohammad Yousef,81,0,100,19
1683335950458,MAE 105,A00,186594,Bandaru; Prabhakar,12,0,50,38
1683335951485,MAE 107,A00,186599,Pham; Hieu Tan,0,6,120,120
1683335952512,MAE 148,A01,186660,Silberman; Jack,3,0,16,13
1683335953539,MATH 10A,A01,188095,Staff,1,6,35,34
1683335954567,MATH 10B,A01,188097,Bowers; Adam R.,0,11,30,30
1683335954567,MATH 10B,A02,188099,Bowers; Adam R.,0,11,30,30
1683335954567,MATH 10B,B01,188104,Bowers; Adam R.,0,10,30,30
1683335954567,MATH 10B,B02,188106,Bowers; Adam R.,0,10,30,30
1683335955591,MATH 10C,A01,188111,Staff,0,18,30,30
1683335955591,MATH 10C,A02,188127,Staff,0,17,30,30
1683335955591,MATH 10C,A03,188131,Staff,0,18,30,30
1683335955591,MATH 10C,B01,188218,Staff,18,0,30,12
1683335955591,MATH 10C,B02,188244,Staff,13,0,30,17
1683335955591,MATH 10C,B03,188277,Staff,16,0,30,14
1683335956618,MATH 18,A01,188344,Bach; Quang Tran,18,0,30,12
1683335956618,MATH 18,A02,188345,Bach; Quang Tran,11,0,30,19
1683335956618,MATH 18,B01,188353,Bach; Quang Tran,10,0,30,20
1683335956618,MATH 18,B02,188354,Bach; Quang Tran,20,0,30,10
1683335957643,MATH 20A,A01,188374,Staff,13,0,35,22
1683335958672,MATH 20B,A01,188382,Ohm; Ko Woon,6,0,30,24
1683335958672,MATH 20B,A02,188383,Ohm; Ko Woon,22,0,30,8
1683335958672,MATH 20B,B01,188385,Ohm; Ko Woon,7,0,30,23
1683335958672,MATH 20B,B02,188392,Ohm; Ko Woon,22,0,30,8
1683335959703,MATH 20C,A01,188394,Harel; Guershon,10,0,30,20
1683335959703,MATH 20C,A02,188395,Harel; Guershon,15,0,30,15
1683335959703,MATH 20C,B01,188404,Harel; Guershon,5,0,30,25
1683335959703,MATH 20C,B02,188405,Harel; Guershon,19,0,30,11
1683335960729,MATH 20D,A01,188414,Hammock; Frances H,0,1,30,30
1683335960729,MATH 20D,A02,188415,Hammock; Frances H,3,0,30,27
1683335960729,MATH 20D,B01,188447,Hammock; Frances H,1,0,30,29
1683335960729,MATH 20D,B02,188486,Hammock; Frances H,8,0,30,22
1683335961753,MATH 20E,A01,188649,Staff,21,0,30,9
1683335961753,MATH 20E,A02,188650,Staff,23,0,30,7
1683335961753,MATH 20E,A03,188673,Staff,0,0,30,30
1683335962777,MATH 102,A01,188675,Staff,0,35,35,35
1683335963806,MATH 103B,A01,188681,Staff,3,0,35,32
1683335963806,MATH 103B,B01,188692,Staff,5,0,35,30
1683335964834,MATH 109,A01,188695,Salehi Golsefidy; Alireza,25,0,35,10
1683335964834,MATH 109,A02,188696,Salehi Golsefidy; Alireza,25,0,35,10
1683335965859,MATH 120A,A01,188698,Eggers; John Dietrich,7,0,35,28
1683335966883,MATH 142B,A01,188736,Ioana; Adrian,0,2,30,30
1683335966883,MATH 142B,A02,188741,Ioana; Adrian,1,1,30,29
1683335966883,MATH 142B,A03,188743,Ioana; Adrian,1,3,30,29
1683335967907,MATH 168A,A01,188790,Staff,0,9,35,35
1683335968932,MATH 170A,A01,188803,Nie; Jiawang,0,2,35,35
1683335968932,MATH 170A,A02,188811,Nie; Jiawang,0,0,35,35
1683335968932,MATH 170A,A03,188814,Nie; Jiawang,1,0,35,34
1683335968932,MATH 170A,A04,188815,Nie; Jiawang,13,0,35,22
1683335969959,MATH 193B,A01,188817,Staff,0,0,35,35
1683335969959,MATH 193B,A02,188818,Staff,5,0,35,30
1683335970987,MGT 4,A01,202857,Anderson; John Charles,62,0,80,18
1683335972014,MGT 12,A00,202858,Lindenberger; Wade Douglas,42,0,90,48
1683335973039,MGT 18,A00,202859,Staff,74,0,90,16
1683335974062,MGT 18GS,A00,202860,McKay; Michael J,13,0,28,15
1683335975090,MGT 45,A00,202861,Pecore; Joseph P.,14,0,90,76
1683335976117,MGT 100,A00,202863,Yavorsky; Daniel Ryan,28,0,90,62
1683335977141,MGT 103,A00,202864,Ehrich; Kristine R,1,18,90,89
1683335978169,MGT 112,A00,202865,Ehrich; Kristine R,15,0,90,75
1683335979194,MGT 121A,A00,202868,Staff,0,20,0,0
1683335980221,MGT 131B,A00,202869,Anderson; John Charles,59,0,90,31
1683335981250,MGT 136,A00,202871,Lindenberger; Wade Douglas,84,0,90,6
1683335982273,MGT 164,A00,202873,Staff,0,68,90,91
1683335983297,MGT 164GS,A00,202874,McKay; Mary A,13,0,28,15
1683335984321,MGT 180,A00,202875,Staff,0,50,90,91
1683335985345,MMW 11R,A01,205019,Herbst; Matthew,3,0,30,27
1683335985345,MMW 11R,A02,205026,Herbst; Matthew,29,0,30,1
1683335986375,MMW 15,A01,193512,Chang; Edmond Yi-Teh,0,9,28,28
1683335986375,MMW 15,A02,193513,Chang; Edmond Yi-Teh,0,5,28,28
1683335986375,MMW 15,A03,193514,Chang; Edmond Yi-Teh,0,5,28,28
1683335986375,MMW 15,A04,193515,Chang; Edmond Yi-Teh,0,5,28,28
1683335986375,MMW 15,A05,193516,Chang; Edmond Yi-Teh,0,4,28,28
1683335986375,MMW 15,A06,193517,Chang; Edmond Yi-Teh,0,5,28,28
1683335986375,MMW 15,B01,193519,Chang; Edmond Yi-Teh,0,5,28,28
1683335986375,MMW 15,B02,193520,Chang; Edmond Yi-Teh,0,5,28,28
1683335986375,MMW 15,B03,193521,Chang; Edmond Yi-Teh,0,5,28,28
1683335986375,MMW 15,B04,193522,Chang; Edmond Yi-Teh,0,4,28,28
1683335986375,MMW 15,B05,193523,Chang; Edmond Yi-Teh,0,5,28,28
1683335986375,MMW 15,B06,193524,Chang; Edmond Yi-Teh,0,4,28,28
1683335987400,MMW 122,A01,193526,Rahimi; Babak,0,15,28,28
1683335987400,MMW 122,A02,193527,Rahimi; Babak,0,14,28,28
1683335987400,MMW 122,A03,193528,Rahimi; Babak,0,0,0,0
1683335987400,MMW 122,A04,193529,Rahimi; Babak,0,0,0,0
1683335988425,MUS 1A,A01,186663,Staff,0,20,35,35
1683335989449,MUS 4,A01,186715,Staff,0,12,35,35
1683335990474,MUS 5R,A01,186796,Dubnov; Shlomo,0,17,35,35
1683335991498,MUS 6,A01,186798,Staff,0,4,25,25
1683335992523,MUS 7,A01,186830,Staff,12,0,35,23
1683335993548,MUS 8,A01,186930,Staff,0,26,35,35
1683335994576,MUS 15,A01,186932,Staff,0,16,35,35
1683335994576,MUS 15,B01,186934,Staff,0,15,35,35
1683335995604,MUS 80,A00,186935,Staff,1,0,20,19
1683335995604,MUS 80,B00,186936,Staff,25,0,25,0
1683335996628,NANO 11,A00,204702,Lipomi; Darren John,0,0,0,0
1683335997652,NANO 15,A01,204709,Yang; Kesong,0,1,0,0
1683335998677,NANO 114,A00,202069,Jahed Motlagh; Zeinab,3,0,10,7
1683335999702,PHIL 1,A00,186955,Grush; Rick Scott,32,0,40,8
1683336000725,PHIL 10,A01,186973,Grush; Rick Scott,28,0,35,7
1683336000725,PHIL 10,A02,186974,Grush; Rick Scott,33,0,35,2
1683336001753,PHIL 13,A01,186976,Staff,7,0,35,28
1683336001753,PHIL 13,A02,186977,Staff,16,0,35,19
1683336002781,PHIL 14,A01,186979,Staff,31,0,35,4
1683336002781,PHIL 14,A02,186986,Staff,32,0,35,3
1683336003809,PHIL 28,A01,186988,Staff,16,0,30,14
1683336003809,PHIL 28,A02,186989,Staff,1,0,30,29
1683336003809,PHIL 28,A03,186990,Staff,9,0,30,21
1683336003809,PHIL 28,A04,186991,Staff,26,0,30,4
1683336004834,PHIL 120,A00,186997,Staff,23,0,40,17
1683336005922,PHIL 137,A00,187003,Staff,9,0,40,31
1683336006949,PHIL 150,A00,187015,Staff,47,0,70,23
1683336007976,PHIL 167,A00,187021,Lamey; Andy M.,35,0,40,5
1683336009003,PHIL 174,A01,202226,Staff,17,0,20,3
1683336009003,PHIL 174,A02,202235,Staff,20,0,20,0
1683336010027,PHIL 191A,A00,258918,Staff,0,0,1,1
1683336011051,PHYS 1A,A00,187028,Staff,27,0,60,33
1683336012079,PHYS 1AL,001,187036,Staff,2,0,30,28
1683336012079,PHYS 1AL,002,187049,Staff,18,0,30,12
1683336013104,PHYS 1B,A00,187058,Staff,22,0,60,38
1683336014133,PHYS 1BL,001,187064,Staff,0,0,30,30
1683336014133,PHYS 1BL,002,187070,Staff,5,0,30,25
1683336015159,PHYS 1C,A00,187082,Staff,31,0,120,89
1683336016183,PHYS 1CL,001,187088,Staff,0,9,30,30
1683336016183,PHYS 1CL,002,187089,Staff,0,2,30,30
1683336016183,PHYS 1CL,009,262693,Staff,11,0,30,19
1683336017208,PHYS 2B,A01,187097,Staff,54,0,115,61
1683336018231,PHYS 2C,A01,187099,Staff,67,0,115,48
1683336019255,PHYS 2CL,A01,187101,Staff,5,0,28,23
1683336019255,PHYS 2CL,A02,187102,Staff,15,0,28,13
1683336020279,PHYS 2D,A01,187123,Shotwell; Brian,95,0,115,20
1683336021308,PHYS 4B,A01,187133,Grinstein; Benjamin,35,0,50,15
1683336022332,POLI 10,A00,188819,Staff,0,4,50,50
1683336023356,POLI 11,A00,188827,Staff,43,0,50,7
1683336024379,POLI 13R,A00,188828,Staff,0,1,20,20
1683336025403,POLI 27,A01,188830,Elgin; Samuel Zincke,0,1,70,70
1683336026426,POLI 30,A00,188832,Desposato; Scott,31,0,50,19
1683336027454,POLI 102F,A00,188834,Staff,3,0,40,37
1683336028482,POLI 104A,A00,188852,Staff,14,0,30,16
1683336029508,POLI 104I,A00,188853,Staff,0,6,20,20
1683336030532,POLI 110B,A00,188854,Wiens; David,7,0,20,13
1683336031559,POLI 112A,A00,188855,Wiens; David,5,0,30,25
1683336032584,POLI 117R,A00,188856,Forman; Fonna,0,11,20,20
1683336033610,POLI 118,A00,188857,Ingham; Sean,8,0,20,12
1683336034634,POLI 120G,A00,188858,Staff,9,0,30,21
1683336035658,POLI 131CR,A00,188863,Hoston; Germaine,24,0,50,26
1683336036686,POLI 133,A00,188864,Nellis; Gareth Hb,44,0,50,6
1683336037712,POLI 134D,A00,188865,Desposato; Scott,27,0,30,3
1683336038736,POLI 142A,A00,188871,Gartzke; Erik,22,0,50,28
1683336039760,POLI 142K,A00,188874,Staff,38,0,50,12
1683336040784,POLI 143,A00,188940,Gartzke; Erik,16,0,30,14
1683336041811,POLI 153,A00,188943,Staff,3,0,20,17
1683336042835,POLI 160AA,A00,188944,Staff,12,0,40,28
1683336043859,POLI 170A,A00,188945,Staff,11,0,30,19
1683336045909,PSYC 1,A00,188952,Staff,37,0,90,53
1683336046936,PSYC 2,B00,188953,Staff,19,0,35,16
1683336047962,PSYC 6,A00,188970,Staff,47,0,60,13
1683336048986,PSYC 7,A00,188973,Staff,37,0,45,8
1683336050014,PSYC 60,A01,188980,Rickard; Timothy C.,43,0,60,17
1683336051038,PSYC 70,A01,189001,Steiner; Eric Tomas,24,0,45,21
1683336052067,PSYC 100,A00,189005,Lacefield; Katharine I,0,100,120,120
1683336053093,PSYC 102,A00,189008,Staff,9,0,30,21
1683336054121,PSYC 106,B00,189026,Gorman; Michael R.,34,0,60,26
1683336055143,PSYC 114,B01,189033,Winkielman; Piotr,0,32,30,30
1683336056167,PSYC 131,A00,189036,Anagnostaras; Stephan,0,43,60,60
1683336057196,PSYC 136,A00,189041,Lowe; Angela Beth,0,7,25,25
1683336058222,PSYC 137,A00,189057,Winkielman; Piotr,0,34,25,25
1683336059249,PSYC 144,A00,189107,Wixted; John T,0,7,50,50
1683336061304,PSYC 162,A00,189142,Staff,0,8,85,85
1683336062328,PSYC 172,A00,189144,Gorman; Michael R.,0,7,30,30
1683336064376,PSYC 179,A00,189146,Lacefield; Katharine I,0,84,120,120
1683336065399,PSYC 181,A00,189147,Anagnostaras; Stephan,0,44,90,90
1683336066426,PSYC 190R,A00,189148,Barner; David A.,0,22,80,80
1683336067450,PSYC 191,A00,189275,Rickard; Timothy C.,0,7,25,25
1683336068474,PSYC 193,A00,189276,Chapman; Eddie Nathaniel,0,1,0,4
1683336069499,PSYC 193L,A01,189281,Lowe; Angela Beth,12,0,20,8
1683336069499,PSYC 193L,B01,189285,Staff,28,0,35,7
1683336070523,RELI 149,A00,187137,Rahimi; Babak,7,0,40,33
1683336071566,SE 9,A01,187315,Staff,0,2,18,18
1683336072593,SE 101B,A00,187409,Staff,24,0,30,6
1683336073621,SE 110B,A00,187444,Staff,10,0,40,30
1683336074646,SE 130B,A00,187449,Staff,31,0,40,9
1683336075670,SE 150A,A00,187516,Staff,9,0,20,11
1683336076693,SE 154,A00,187528,Staff,30,0,50,20
1683336077717,SIO 3,A01,258171,Staff,35,0,40,5
1683336078744,SIO 10,A00,187144,Cook; Geoffrey W,0,3,75,75
1683336079768,SIO 45,A00,187152,Cook; Geoffrey W,1,0,100,99
1683336080793,SIO 109R,A00,194486,Staff,0,3,20,20
1683336082845,SIO 187,A01,187233,Kacev; David,12,0,40,28
1683336083875,SOCI 1,A01,258656,Thorpe; Charles Robert,28,0,30,2
1683336083875,SOCI 1,A02,258658,Thorpe; Charles Robert,30,0,30,0
1683336083875,SOCI 1,A03,258661,Thorpe; Charles Robert,25,0,25,0
1683336083875,SOCI 1,A04,258666,Thorpe; Charles Robert,22,0,25,3
1683336083875,SOCI 1,A05,258897,Thorpe; Charles Robert,23,0,25,2
1683336083875,SOCI 1,A06,258898,Thorpe; Charles Robert,25,0,25,0
1683336084899,SOCI 30,A01,258903,Pardo Guerra; Juan Pablo,15,0,30,15
1683336085923,SOCI 102,A00,258904,Staff,9,0,25,16
1683336086947,SOCI 106,A00,258905,Staff,19,0,25,6
1683336087973,SOCI 111,A00,258907,Ribas Norris; Janet Vanesa,26,0,30,4
1683336089002,SOCI 121R,A00,258908,Pardo Guerra; Juan Pablo,10,0,30,20
1683336090026,SOCI 126,A01,203330,Staff,14,0,20,6
1683336091053,SOCI 131,A00,258909,Thorpe; Charles Robert,31,0,60,29
1683336092080,SOCI 135,A00,258910,Payne; Christine Anna,0,9,30,30
1683336093104,SOCI 157,A00,258911,Staff,12,0,30,18
1683336094130,SOCI 184,A00,258912,Staff,25,0,30,5
1683336095153,SOCI 188D,A00,258913,Staff,21,0,30,9
1683336096177,SYN 2,001,187529,Staff,10,0,16,6
1683336096177,SYN 2,002,201452,Staff,0,18,16,16
1683336096177,SYN 2,003,201469,Staff,3,0,16,13
1683336097200,SYN 100,A01,187531,Staff,0,9,20,20
1683336097200,SYN 100,B01,201491,Staff,0,12,20,20
1683336098224,TDAC 1,A00,189286,Walsh; Kim C.,3,0,20,17
1683336098224,TDAC 1,B00,189287,Harting; Carla Kelso,11,0,20,9
1683336099248,TDAC 101,A00,189300,Walsh; Kim C.,16,0,20,4
1683336099248,TDAC 101,B00,189301,Harting; Carla Kelso,18,0,20,2
1683336100272,TDAC 102,A00,189304,Basso; Beatrice,14,0,20,6
1683336101298,TDAC 108,A00,189305,Staff,18,0,20,2
1683336102331,TDDE 131,A00,189310,Staff,19,0,20,1
1683336102331,TDDE 131,B00,189314,Staff,19,0,20,1
1683336102331,TDDE 131,C00,189315,Staff,48,0,50,2
1683336102331,TDDE 131,D00,189316,Staff,14,0,15,1
1683336102331,TDDE 131,E00,204841,Staff,20,0,20,0
1683336103358,TDGE 10,A00,189289,Staff,30,0,50,20
1683336103358,TDGE 10,B00,189290,Havis; Allan,1,0,50,49
1683336104383,TDGE 11,A00,189291,Fulton; Julia,0,3,50,50
1683336104383,TDGE 11,B00,189292,Staff,20,0,25,5
1683336104383,TDGE 11,C00,260270,Staff,0,0,0,0
1683336105411,TDGE 25,A00,189294,Staff,3,0,20,17
1683336106434,TDGE 124,A00,189318,Fulton; Julia,0,8,50,50
1683336107458,TDGE 125,A00,189319,Staff,13,0,25,12
1683336107458,TDGE 125,B00,189320,Staff,23,0,25,2
1683336108486,TDGE 127,A00,189322,Havis; Allan,0,0,50,50
1683336109569,TDHT 101,A00,189323,Staff,18,0,25,7
1683336109569,TDHT 101,B00,189324,Staff,25,0,25,0
1683336110593,TDHT 102,A00,189325,Staff,49,0,50,1
1683336111620,TDMV 1,A00,189295,Arcidiacono; Kristin,19,0,30,11
1683336111620,TDMV 1,B00,189296,Caligagan; Maria T.,24,0,30,6
1683336112645,TDMV 2,A00,189297,Sammartano; Tonnie,28,0,30,2
1683336112645,TDMV 2,B00,189299,Arcidiacono; Kristin,24,0,30,6
1683336113669,TDMV 3,A00,204998,Rincon; Alicia,22,0,30,8
1683336114696,TDMV 120,A00,189458,Sammartano; Tonnie,28,0,30,2
1683336115721,TDMV 138,A00,189541,Jun; Grace Shin Hae,22,0,40,18
1683336116750,TDMV 142,A00,189717,Caligagan; Tony,23,0,30,7
1683336116750,TDMV 142,B00,189718,Caligagan; Maria T.,25,0,30,5
1683336117778,TMC 2,A01,187533,Staff,25,0,25,0
1683336117778,TMC 2,A02,187534,Staff,25,0,25,0
1683336118805,USP 1,A01,187536,Kwak; Nancy,0,16,25,25
1683336119829,USP 5,A01,187538,Staff,10,0,25,15
1683336120857,USP 101,A00,199253,Staff,0,4,0,0
1683336121881,USP 124,A00,187562,Boomhower; Matthew Charles,1,0,30,29
1683336122910,USP 138,A00,187582,Staff,20,0,25,5
1683336123938,USP 152,A01,187597,Staff,4,0,25,21
1683336124962,USP 153,A00,187598,Staff,19,0,25,6
1683336125988,USP 168,A00,187607,Kwak; Nancy,2,0,5,3
1683336127014,USP 173,A00,187619,Staff,4,0,25,21
1683336128040,USP 181,A00,187638,Staff,0,0,25,25
1683336129064,VIS 103,A00,187650,Cruz; Edwin Teddy,23,0,75,52
1683336130088,VIS 110D,A00,187669,Staff,12,0,22,10
1683336131112,VIS 127C,A00,187720,Shen; Kuiyi,67,0,146,79
1683336132140,VIS 149,A00,187731,Yoldas; Pinar,0,14,22,22
1683336133168,VIS 151,A01,188091,Staff,22,0,34,12
1683336133168,VIS 151,A02,188092,Staff,11,0,34,23
1683336134196,VIS 160B,A00,188093,Stalbaum; Brett,0,0,10,10
1683336136248,WCWP 10B,A00,201720,Staff,10,0,15,5
1683336136248,WCWP 10B,B00,201722,Staff,9,0,15,6
1683336137272,WCWP 100,A00,201725,Gagnon; Jeffrey C,0,0,2,2
1683336137272,WCWP 100,B00,201727,Staff,0,4,15,15
1683336140394,ANBI 133,A00,258401,Wilder; Linnea Lorene,34,0,40,6
1683336141419,ANBI 140,A00,258395,Hrvoj Mihic; Branka,18,0,25,7
1683336142446,ANSC 120,A00,258402,Bialecki; Jon Anthony,27,0,40,13
1683336143469,ANSC 144,A00,258400,Staff,14,0,40,26
1683336145519,ANSC 166,A00,258396,Parish; Steven Martin,157,0,175,18
1683336146547,ANSC 180,A00,193533,Staff,9,0,20,11
1683336147572,ANSC 188,A00,258397,Jassal; Aftab,33,0,40,7
1683336148597,ANTH 3,A01,258316,Staff,23,0,30,7
1683336149622,ANTH 5,A00,258394,Semendeferi; Ekaterini,16,0,20,4
1683336150648,ANTH 21,A01,258331,Staff,8,0,40,32
1683336151671,ANTH 103,A00,258398,Varma; Saiba,15,0,25,10
1683336152699,AWP 10,001,202034,Staff,0,0,0,0
1683336152699,AWP 10,002,202035,Staff,0,0,0,0
1683336152699,AWP 10,003,202036,Staff,0,0,0,0
1683336152699,AWP 10,004,202037,Staff,0,0,0,0
1683336152699,AWP 10,005,202038,Staff,0,0,0,0
1683336152699,AWP 10,006,202039,Staff,0,0,0,0
1683336152699,AWP 10,007,202040,Staff,0,0,0,0
1683336152699,AWP 10,008,202041,Staff,0,0,0,0
1683336152699,AWP 10,009,202042,Staff,0,0,0,0
1683336152699,AWP 10,010,202043,Staff,0,0,0,0
1683336152699,AWP 10,011,202044,Staff,0,0,0,0
1683336152699,AWP 10,012,202045,Staff,0,0,0,0
1683336152699,AWP 10,013,202046,Staff,0,0,0,0
1683336152699,AWP 10,014,202047,Staff,0,0,0,0
1683336152699,AWP 10,015,202048,Staff,0,0,0,0
1683336152699,AWP 10,016,202049,Staff,0,0,0,0
1683336152699,AWP 10,017,202050,Staff,0,0,0,0
1683336152699,AWP 10,018,202051,Staff,0,0,0,0
1683336152699,AWP 10,019,202052,Staff,0,0,0,0
1683336152699,AWP 10,020,202053,Staff,0,0,0,0
1683336152699,AWP 10,021,202054,Staff,0,0,0,0
1683336152699,AWP 10,022,202055,Staff,0,0,0,0
1683336152699,AWP 10,023,202056,Staff,0,0,0,0
1683336152699,AWP 10,024,202057,Staff,0,0,0,0
1683336152699,AWP 10,025,202058,Staff,0,0,0,0
1683336152699,AWP 10,026,202059,Staff,0,0,0,0
1683336153723,AWP 102,001,202032,Staff,0,0,0,0
1683336153723,AWP 102,002,202033,Staff,0,0,0,0
1683336154750,BENG 100,A01,254234,Taylor Amos; Alyssa C,31,0,40,9
1683336155775,BENG 196,001,270013,Engler; Adam J.,9999,0,9999,0
1683336156804,BICD 100R,A01,202018,Smith; Laurie,0,7,32,32
1683336156804,BICD 100R,A02,202019,Smith; Laurie,0,2,32,32
1683336156804,BICD 100R,A03,202020,Smith; Laurie,0,1,32,32
1683336156804,BICD 100R,A04,202021,Smith; Laurie,9,0,32,23
1683336156804,BICD 100R,A05,202022,Smith; Laurie,12,0,32,20
1683336157832,BICD 136,A01,193242,Gustafson-Brown; Cindy,0,2,32,32
1683336157832,BICD 136,A02,193244,Gustafson-Brown; Cindy,14,0,32,18
1683336158861,BIEB 102,A01,193249,Butler; Shannon Rhey,0,2,32,32
1683336158861,BIEB 102,A02,193251,Butler; Shannon Rhey,0,0,32,32
1683336158861,BIEB 102,A03,193253,Butler; Shannon Rhey,0,1,32,32
1683336158861,BIEB 102,A04,193255,Butler; Shannon Rhey,17,0,32,15
1683336158861,BIEB 102,A05,193265,Butler; Shannon Rhey,26,0,32,6
1683336158861,BIEB 102,A06,193269,Butler; Shannon Rhey,16,0,32,16
1683336160910,BIEB 150,A01,193274,Staff,0,0,32,32
1683336160910,BIEB 150,A02,193285,Staff,23,0,32,9
1683336161933,BIEB 194,A00,193286,Kurle; Carolyn M.,22,0,32,10
1683336162958,BILD 1,A01,192291,Staff,16,0,32,16
1683336162958,BILD 1,A02,192292,Staff,30,0,32,2
1683336162958,BILD 1,B01,192520,Reuther; Keefe,0,1,0,0
1683336162958,BILD 1,B02,192532,Reuther; Keefe,0,1,0,0
1683336163983,BILD 3,A01,192556,Butler; Shannon Rhey,0,0,32,32
1683336163983,BILD 3,A02,192581,Butler; Shannon Rhey,5,0,32,27
1683336163983,BILD 3,A03,192611,Butler; Shannon Rhey,23,0,32,9
1683336163983,BILD 3,A04,192612,Butler; Shannon Rhey,25,0,32,7
1683336163983,BILD 3,A05,192613,Butler; Shannon Rhey,27,0,32,5
1683336163983,BILD 3,A06,192679,Butler; Shannon Rhey,27,0,32,5
1683336163983,BILD 3,A07,192682,Butler; Shannon Rhey,22,0,32,10
1683336165013,BILD 4,A01,192836,Reuther; Keefe,0,0,24,24
1683336165013,BILD 4,A02,193044,Reuther; Keefe,4,0,24,20
1683336166040,BILD 10,A01,193142,Gustafson-Brown; Cindy,30,0,32,2
1683336166040,BILD 10,A02,193149,Gustafson-Brown; Cindy,31,0,32,1
1683336167066,BIMM 100,A01,193301,Staff,0,6,32,32
1683336167066,BIMM 100,A02,193312,Staff,0,5,32,32
1683336167066,BIMM 100,A03,193323,Staff,0,8,32,32
1683336168096,BIMM 101,A01,193329,McDonnell; Lisa Marie,0,3,24,24
1683336168096,BIMM 101,A02,193339,McDonnell; Lisa Marie,0,3,24,24
1683336168096,BIMM 101,B01,193354,McDonnell; Lisa Marie,0,3,24,24
1683336168096,BIMM 101,B02,193357,McDonnell; Lisa Marie,0,3,24,24
1683336169121,BIMM 110,A01,193377,Tat; John,0,11,32,32
1683336169121,BIMM 110,A02,193378,Tat; John,1,9,32,31
1683336170145,BIMM 120,A01,206116,Staff,0,0,32,32
1683336170145,BIMM 120,A02,206117,Staff,8,0,32,24
1683336170145,BIMM 120,A03,206121,Staff,21,0,32,11
1683336171174,BIPN 100,A01,193393,Park; Ji Young,0,14,32,32
1683336171174,BIPN 100,A02,193402,Park; Ji Young,0,13,32,32
1683336171174,BIPN 100,A03,193413,Park; Ji Young,0,14,32,32
1683336171174,BIPN 100,A04,193414,Park; Ji Young,0,13,32,32
1683336172202,BIPN 102,A01,193429,Staff,0,0,32,32
1683336172202,BIPN 102,A02,193438,Staff,22,0,32,10
1683336173229,BIPN 106,A01,193450,Reyes Gonzalez; Catalina,0,2,40,40
1683336174255,BIPN 134,A01,193465,Cooke; James Edward,0,0,32,32
1683336174255,BIPN 134,A02,193474,Cooke; James Edward,25,0,32,7
1683336174255,BIPN 134,A03,193485,Cooke; James Edward,29,0,32,3
1683336174255,BIPN 134,A04,193486,Cooke; James Edward,21,0,32,11
1683336174255,BIPN 134,A05,193491,Cooke; James Edward,31,0,32,1
1683336174255,BIPN 134,A06,193501,Cooke; James Edward,30,0,32,2
1683336174255,BIPN 134,A07,193510,Cooke; James Edward,29,0,32,3
1683336176307,BISP 194,A00,222522,Staff,14,0,32,18
1683336177336,CAT 124,A01,202407,Staff,20,0,25,5
1683336178358,CAT 125,A00,202408,Marchisotto; Jennifer Anne,4,0,20,16
1683336179382,CAT 125R,A00,202409,Smith; Lauryn Alissa,0,11,20,20
1683336179382,CAT 125R,B00,202410,Morales; Celeste Georgianna,0,11,20,20
1683336179382,CAT 125R,C00,202411,Irwin; Matthew Joseph,0,10,20,20
1683336180407,CENG 15,A01,204712,Yang; Kesong,0,1,0,0
1683336181432,CENG 114,A00,202070,Jahed Motlagh; Zeinab,5,0,20,15
1683336182455,CGS 105,A00,185477,Wesling; Megan E.,24,0,40,16
1683336183479,CGS 106,A00,185494,Staff,13,0,22,9
1683336184508,CGS 108,A00,185495,Staff,14,0,20,6
1683336185533,CGS 114,A00,185496,Staff,13,0,18,5
1683336186557,CGS 119,A00,185501,Staff,15,0,20,5
1683336187581,CGS 120,A00,185511,Staff,13,0,20,7
1683336188605,CHEM 4,A01,184675,Bussey; Thomas J,96,0,100,4
1683336189629,CHEM 6A,A01,184677,Staff,34,0,60,26
1683336190657,CHEM 6B,A01,184679,Staff,65,0,100,35
1683336191682,CHEM 6C,A01,184681,Bussey; Thomas J,1,0,50,49
1683336191682,CHEM 6C,A02,184682,Bussey; Thomas J,34,0,50,16
1683336192707,CHEM 40A,A01,184684,Albizati; Kim F.,37,0,100,63
1683336193732,CHEM 40B,A01,184686,Albizati; Kim F.,0,20,100,100
1683336194757,CHEM 41B,A01,184690,Staff,52,0,100,48
1683336195786,COGS 3,A01,184715,Boyle; Mary E. T.,0,25,40,40
1683336196812,COGS 14B,A01,185172,Staff,0,15,38,38
1683336197840,COGS 18,A01,184736,Staff,17,0,80,63
1683336198865,COGS 100,A01,184932,Staff,0,5,73,73
1683336199894,COGS 101A,A01,184935,Staff,0,39,30,30
1683336200922,COGS 101B,A01,184944,Staff,0,2,30,30
1683336201946,COGS 101C,A01,184946,Staff,0,12,30,30
1683336202973,COGS 102A,A01,184951,Johnson; Christine M.,2,0,40,38
1683336204003,COGS 107B,A01,184953,Mooshagian; Eric Frederick,0,50,40,40
1683336205027,COGS 118B,A01,184959,Gupta; Anjum,0,48,40,40
1683336206051,COGS 153,A00,184961,Staff,0,15,30,30
1683336207079,COGS 177,A00,184962,Staff,0,20,30,30
1683336208103,COGS 187A,A01,184969,Boyle; Mary E. T.,0,17,40,40
1683336209132,COMM 10,A01,185174,Staff,0,5,25,25
1683336209132,COMM 10,A02,185189,Staff,0,5,25,25
1683336209132,COMM 10,A03,269821,Staff,0,0,0,0
1683336210157,COMM 100B,A01,185475,Staff,0,0,0,2
1683336210157,COMM 100B,A02,185476,Staff,14,0,25,11
1683336211186,COMM 100C,A01,185314,Staff,1,0,25,24
1683336211186,COMM 100C,A02,185327,Staff,19,0,25,6
1683336212214,COMM 110M,A00,185349,Staff,2,0,40,38
1683336213314,COMM 113T,A00,185352,Staff,24,0,40,16
1683336214338,COMM 114I,A00,185353,Staff,33,0,40,7
1683336215362,COMM 131,A00,185354,Staff,19,0,30,11
1683336216390,CSE 8A,A50,185358,Cao; Yingjun,0,46,10,10
1683336217415,CSE 8B,A01,185362,Staff,1,47,50,49
1683336218444,CSE 11,A01,185416,Cao; Yingjun,0,92,10,10
1683336219468,CSE 20,A01,185445,Briones; Jor-el Thomas Caparas,5,0,25,20
1683336220494,CSE 21,A01,185447,Staff,10,0,50,40
1683336221520,CSE 101,A01,185451,Staff,0,13,50,50
1683336221520,CSE 101,B01,185453,Jones; Miles E,0,11,50,50
1683336223576,CSE 141,A01,185458,Eldon; John,20,0,100,80
1683336224605,CSE 141L,A01,185461,Eldon; John,12,0,100,88
1683336225631,CSE 142,A01,185463,Staff,36,0,60,24
1683336225631,CSE 142,B01,201355,Staff,0,7,60,60
1683336226660,CSE 142L,A01,185470,Staff,36,0,60,24
1683336226660,CSE 142L,B01,201417,Staff,0,6,60,60
1683336227685,CSE 190,A00,201433,Staff,32,0,49,17
1683336228710,DOC 1,A01,259136,Strom; Megan C.,7,0,15,8
1683336228710,DOC 1,A02,259137,Strom; Megan C.,14,0,15,1
1683336228710,DOC 1,A03,259138,Strom; Megan C.,14,0,15,1
1683336228710,DOC 1,A04,259139,Strom; Megan C.,14,0,15,1
1683336229737,DOC 100D,A00,259140,Pass; Natalye Joann,16,0,25,9
1683336230762,DSGN 1,A01,184749,Rill; Bryan,0,25,30,30
1683336231789,DSGN 100,A01,185168,Staff,0,2,25,25
1683336232818,ECE 5,A01,185626,Morris; Karcher William,0,10,0,0
1683336233847,ECE 101,A01,185628,Staff,17,0,70,53
1683336234872,ECE 107,A01,185635,Baghdadchi; Saharnaz,0,0,20,20
1683336234872,ECE 107,A02,185638,Baghdadchi; Saharnaz,4,0,20,16
1683336235898,ECE 148,A01,185647,Silberman; Jack,0,0,16,16
1683336236923,ECON 1,A01,185537,Crane; Meredith Helen,54,0,70,16
1683336237950,ECON 3,A01,185549,Crane; Meredith Helen,33,0,70,37
1683336238975,ECON 4,A01,203354,Anderson; John Charles,0,4,10,10
1683336239999,ECON 100A,A01,185574,Staff,0,4,40,40
1683336241027,ECON 100B,A01,185576,Staff,10,22,50,40
1683336242056,ECON 100C,A01,185589,Newhouse; Herbert S,30,0,70,40
1683336243081,ECON 105,A00,185608,Vespa; Emanuel Ignacio,19,0,35,16
1683336244110,ECON 109,A01,185610,Shishkin; Denis,10,0,35,25
1683336245134,ECON 110A,A01,185612,Staff,11,0,40,29
1683336246162,ECON 120A,A01,185615,Staff,20,0,40,20
1683336247187,ECON 120C,A01,185617,Sun; Yixiao,0,20,70,70
1683336248212,ECON 144,A00,203346,Squires; Dale E,3,0,35,32
1683336249238,ECON 171,A01,203349,Newhouse; Herbert S,0,1,35,35
1683336250261,ECON 173A,A01,185621,Toda; Alexis Akira,21,0,35,14
1683336251287,EDS 25,A01,202413,Staff,0,1,0,0
1683336251287,EDS 25,A02,202414,Staff,0,1,0,0
1683336251287,EDS 25,A03,202415,Staff,0,0,0,0
1683336251287,EDS 25,A04,202416,Staff,0,1,0,0
1683336251287,EDS 25,A05,202439,Staff,0,0,0,0
1683336251287,EDS 25,A06,202440,Staff,0,0,0,0
1683336251287,EDS 25,B01,202631,Staff,0,0,0,0
1683336251287,EDS 25,B02,202632,Staff,0,0,0,0
1683336251287,EDS 25,B03,202639,Staff,0,0,0,0
1683336251287,EDS 25,B04,202640,Staff,0,0,0,0
1683336251287,EDS 25,B05,202643,Staff,0,0,0,0
1683336251287,EDS 25,B06,202644,Staff,0,0,0,0
1683336252315,EDS 38,A01,202659,Black; Alison Michelle,24,0,25,1
1683336253340,EDS 115,A00,202652,Staff,17,0,30,13
1683336254368,EDS 125,A00,202649,Staff,14,0,30,16
1683336255397,EDS 126,A01,203332,Staff,30,0,30,0
1683336256420,EDS 139,A00,202838,Staff,16,0,25,9
1683336257448,EDS 146,A01,202655,Staff,14,0,25,11
1683336258471,ENG 15,A00,185667,Staff,0,1,0,0
1683336258471,ENG 15,B00,185672,Staff,0,0,0,0
1683336258471,ENG 15,C00,185675,Staff,0,0,0,0
1683336258471,ENG 15,D00,185682,Staff,0,0,0,0
1683336258471,ENG 15,E00,185684,Staff,0,0,0,0
1683336259495,ETHN 103,A00,185710,Staff,0,3,35,35
1683336260520,ETHN 103A,A00,199228,Man; Simeon S,2,0,9,7
1683336261548,ETHN 109,A00,185711,Staff,18,0,35,17
1683336262574,ETHN 142,A00,185726,Staff,0,4,30,30
1683336263602,ETHN 163J,A00,199229,Man; Simeon S,5,0,8,3
1683336264627,ETHN 168,A00,185727,Staff,8,0,10,2
1683336265651,ETHN 182,A00,185728,Staff,1,0,35,34
1683336266676,ETHN 183,A00,185737,Staff,8,0,18,10
1683336267700,GLBH 111,A01,209361,Burgos; Jose L.,0,0,0,0
1683336269748,HIEU 104,A00,185792,Staff,16,0,20,4
1683336270772,HIEU 115,A00,185800,Staff,1,0,20,19
1683336271799,HIEU 128,A00,185801,Staff,0,7,20,20
1683336272824,HIEU 147,A00,185802,Staff,16,0,20,4
1683336273851,HIEU 154,A00,185823,Staff,12,0,20,8
1683336274876,HILA 102,A00,185826,Staff,13,0,20,7
1683336275901,HILD 2C,A01,185778,Staff,0,12,20,20
1683336276926,HILD 7B,A01,185780,Kwak; Nancy,0,15,32,32
1683336276926,HILD 7B,A02,185781,Kwak; Nancy,0,18,32,32
1683336277955,HILD 30,A01,185791,Staff,14,0,20,6
1683336278979,HISC 119,A00,185830,Golan; Tal,0,9,20,20
1683336280007,HITO 156GS,A00,185831,Patterson; Patrick H.,0,0,0,23
1683336281035,HIUS 103,A00,185832,Man; Simeon S,0,6,20,20
1683336282060,HIUS 117,A00,185836,Kwak; Nancy,2,0,20,18
1683336283086,HIUS 125,A00,185840,Man; Simeon S,0,0,23,23
1683336284111,HIUS 149,A00,185845,Staff,0,0,20,20
1683336285140,HUM 3,A01,185882,Zavodny; Tatiana Sophia,0,7,50,50
1683336285140,HUM 3,B01,185899,Caldwell; Michael Alan,0,18,50,50
1683336286163,HUM 3GS,A00,185900,Patterson; Patrick H.,0,0,0,23
1683336287188,HUM 4,A01,185938,Zroka; Amy Liane,31,0,50,19
1683336287188,HUM 4,B01,185956,Watkins; Eric,0,2,50,50
1683336287188,HUM 4,B02,202209,Watkins; Eric,0,2,50,50
1683336287188,HUM 4,B03,202210,Watkins; Eric,0,2,50,50
1683336288214,HUM 5,A01,185958,West; Geoffrey Scott,3,0,50,47
1683336288214,HUM 5,A02,202215,West; Geoffrey Scott,0,0,50,50
1683336289237,INTL 190,A00,185959,Gagnon; Jeffrey C,0,0,0,9
1683336289237,INTL 190,B00,185960,Lettieri; Michael Joseph,0,0,0,1
1683336290262,JAPN 180,A00,254509,Staff,5,1,30,25
1683336291290,LATI 10,A01,202853,Kennemore; Amy Michelle,4,0,35,31
1683336291290,LATI 10,A02,202854,Kennemore; Amy Michelle,2,0,35,33
1683336291290,LATI 10,A03,270054,Kennemore; Amy Michelle,30,0,30,0
1683336292315,LATI 180,A00,202855,Kennemore; Amy Michelle,11,0,20,9
1683336293342,LAWS 101,A00,201767,Golan; Tal,0,7,40,40
1683336294365,LIFR 1C,A00,185961,Staff,6,0,20,14
1683336295390,LIFR 1CX,A00,185962,Staff,7,0,20,13
1683336296417,LIFR 1D,A00,185963,Staff,9,0,20,11
1683336297441,LIFR 1DX,A00,185964,Staff,9,0,20,11
1683336298464,LIGN 101,A01,186039,Staff,43,0,50,7
1683336299488,LIGN 165,A00,186040,Staff,18,0,50,32
1683336300518,LTCS 108,A00,186041,Staff,6,0,10,4
1683336301543,LTCS 119,A00,186042,Staff,16,0,20,4
1683336302572,LTCS 130,A00,186043,Wesling; Megan E.,15,0,25,10
1683336304620,LTEA 138,A00,186119,Staff,14,0,40,26
1683336305645,LTEN 124,A00,186148,Staff,6,0,25,19
1683336306668,LTEN 178,A00,186149,Staff,7,0,15,8
1683336307692,LTEN 181,A00,186150,Blanco; John D,33,0,40,7
1683336308716,LTWL 120,A00,186160,Staff,20,0,25,5
1683336309745,LTWL 165,A00,186161,Staff,22,0,25,3
1683336310769,LTWR 100,A00,186162,Staff,0,5,15,15
1683336311794,LTWR 102,A00,186163,Doller; Ben,5,0,15,10
1683336312820,MAE 8,A01,186412,Staff,0,0,0,0
1683336313848,MAE 30B,A00,186445,Bahadori; Mohammad Yousef,83,0,100,17
1683336314873,MAE 40,A00,186592,Bewley; Thomas R,9,0,50,41
1683336315895,MAE 101B,A00,186593,Bahadori; Mohammad Yousef,81,0,100,19
1683336316991,MAE 105,A00,186594,Bandaru; Prabhakar,12,0,50,38
1683336318015,MAE 107,A00,186599,Pham; Hieu Tan,0,6,120,120
1683336319042,MAE 148,A01,186660,Silberman; Jack,3,0,16,13
1683336320066,MATH 10A,A01,188095,Staff,1,6,35,34
1683336321091,MATH 10B,A01,188097,Bowers; Adam R.,0,11,30,30
1683336321091,MATH 10B,A02,188099,Bowers; Adam R.,0,11,30,30
1683336321091,MATH 10B,B01,188104,Bowers; Adam R.,0,10,30,30
1683336321091,MATH 10B,B02,188106,Bowers; Adam R.,0,10,30,30
1683336322119,MATH 10C,A01,188111,Staff,0,18,30,30
1683336322119,MATH 10C,A02,188127,Staff,0,17,30,30
1683336322119,MATH 10C,A03,188131,Staff,0,18,30,30
1683336322119,MATH 10C,B01,188218,Staff,18,0,30,12
1683336322119,MATH 10C,B02,188244,Staff,13,0,30,17
1683336322119,MATH 10C,B03,188277,Staff,16,0,30,14
1683336323147,MATH 18,A01,188344,Bach; Quang Tran,18,0,30,12
1683336323147,MATH 18,A02,188345,Bach; Quang Tran,11,0,30,19
1683336323147,MATH 18,B01,188353,Bach; Quang Tran,10,0,30,20
1683336323147,MATH 18,B02,188354,Bach; Quang Tran,20,0,30,10
1683336324174,MATH 20A,A01,188374,Staff,13,0,35,22
1683336325197,MATH 20B,A01,188382,Ohm; Ko Woon,6,0,30,24
1683336325197,MATH 20B,A02,188383,Ohm; Ko Woon,22,0,30,8
1683336325197,MATH 20B,B01,188385,Ohm; Ko Woon,7,0,30,23
1683336325197,MATH 20B,B02,188392,Ohm; Ko Woon,22,0,30,8
1683336326222,MATH 20C,A01,188394,Harel; Guershon,10,0,30,20
1683336326222,MATH 20C,A02,188395,Harel; Guershon,15,0,30,15
1683336326222,MATH 20C,B01,188404,Harel; Guershon,5,0,30,25
1683336326222,MATH 20C,B02,188405,Harel; Guershon,19,0,30,11
1683336327251,MATH 20D,A01,188414,Hammock; Frances H,0,1,30,30
1683336327251,MATH 20D,A02,188415,Hammock; Frances H,3,0,30,27
1683336327251,MATH 20D,B01,188447,Hammock; Frances H,1,0,30,29
1683336327251,MATH 20D,B02,188486,Hammock; Frances H,8,0,30,22
1683336328274,MATH 20E,A01,188649,Staff,21,0,30,9
1683336328274,MATH 20E,A02,188650,Staff,23,0,30,7
1683336328274,MATH 20E,A03,188673,Staff,0,0,30,30
1683336329297,MATH 102,A01,188675,Staff,0,35,35,35
1683336330321,MATH 103B,A01,188681,Staff,3,0,35,32
1683336330321,MATH 103B,B01,188692,Staff,5,0,35,30
1683336331347,MATH 109,A01,188695,Salehi Golsefidy; Alireza,25,0,35,10
1683336331347,MATH 109,A02,188696,Salehi Golsefidy; Alireza,25,0,35,10
1683336332372,MATH 120A,A01,188698,Eggers; John Dietrich,7,0,35,28
1683336333397,MATH 142B,A01,188736,Ioana; Adrian,0,2,30,30
1683336333397,MATH 142B,A02,188741,Ioana; Adrian,1,1,30,29
1683336333397,MATH 142B,A03,188743,Ioana; Adrian,1,3,30,29
1683336334421,MATH 168A,A01,188790,Staff,0,9,35,35
1683336335447,MATH 170A,A01,188803,Nie; Jiawang,0,2,35,35
1683336335447,MATH 170A,A02,188811,Nie; Jiawang,0,0,35,35
1683336335447,MATH 170A,A03,188814,Nie; Jiawang,1,0,35,34
1683336335447,MATH 170A,A04,188815,Nie; Jiawang,13,0,35,22
1683336336471,MATH 193B,A01,188817,Staff,0,0,35,35
1683336336471,MATH 193B,A02,188818,Staff,5,0,35,30
1683336337495,MGT 4,A01,202857,Anderson; John Charles,62,0,80,18
1683336338521,MGT 12,A00,202858,Lindenberger; Wade Douglas,42,0,90,48
1683336339548,MGT 18,A00,202859,Staff,74,0,90,16
1683336340571,MGT 18GS,A00,202860,McKay; Michael J,13,0,28,15
1683336341599,MGT 45,A00,202861,Pecore; Joseph P.,14,0,90,76
1683336342623,MGT 100,A00,202863,Yavorsky; Daniel Ryan,28,0,90,62
1683336343654,MGT 103,A00,202864,Ehrich; Kristine R,1,18,90,89
1683336344678,MGT 112,A00,202865,Ehrich; Kristine R,15,0,90,75
1683336345703,MGT 121A,A00,202868,Staff,0,20,0,0
1683336346730,MGT 131B,A00,202869,Anderson; John Charles,59,0,90,31
1683336347755,MGT 136,A00,202871,Lindenberger; Wade Douglas,84,0,90,6
1683336348784,MGT 164,A00,202873,Staff,0,68,90,91
1683336349826,MGT 164GS,A00,202874,McKay; Mary A,13,0,28,15
1683336350854,MGT 180,A00,202875,Staff,0,50,90,91
1683336351880,MMW 11R,A01,205019,Herbst; Matthew,3,0,30,27
1683336351880,MMW 11R,A02,205026,Herbst; Matthew,29,0,30,1
1683336352905,MMW 15,A01,193512,Chang; Edmond Yi-Teh,0,9,28,28
1683336352905,MMW 15,A02,193513,Chang; Edmond Yi-Teh,0,5,28,28
1683336352905,MMW 15,A03,193514,Chang; Edmond Yi-Teh,0,5,28,28
1683336352905,MMW 15,A04,193515,Chang; Edmond Yi-Teh,0,5,28,28
1683336352905,MMW 15,A05,193516,Chang; Edmond Yi-Teh,0,4,28,28
1683336352905,MMW 15,A06,193517,Chang; Edmond Yi-Teh,0,5,28,28
1683336352905,MMW 15,B01,193519,Chang; Edmond Yi-Teh,0,5,28,28
1683336352905,MMW 15,B02,193520,Chang; Edmond Yi-Teh,0,5,28,28
1683336352905,MMW 15,B03,193521,Chang; Edmond Yi-Teh,0,5,28,28
1683336352905,MMW 15,B04,193522,Chang; Edmond Yi-Teh,0,4,28,28
1683336352905,MMW 15,B05,193523,Chang; Edmond Yi-Teh,0,5,28,28
1683336352905,MMW 15,B06,193524,Chang; Edmond Yi-Teh,0,4,28,28
1683336353929,MMW 122,A01,193526,Rahimi; Babak,0,15,28,28
1683336353929,MMW 122,A02,193527,Rahimi; Babak,0,14,28,28
1683336353929,MMW 122,A03,193528,Rahimi; Babak,0,0,0,0
1683336353929,MMW 122,A04,193529,Rahimi; Babak,0,0,0,0
1683336354954,MUS 1A,A01,186663,Staff,0,20,35,35
1683336355978,MUS 4,A01,186715,Staff,0,12,35,35
1683336357006,MUS 5R,A01,186796,Dubnov; Shlomo,0,17,35,35
1683336358035,MUS 6,A01,186798,Staff,0,4,25,25
1683336359059,MUS 7,A01,186830,Staff,12,0,35,23
1683336360083,MUS 8,A01,186930,Staff,0,26,35,35
1683336361109,MUS 15,A01,186932,Staff,0,16,35,35
1683336361109,MUS 15,B01,186934,Staff,0,15,35,35
1683336362138,MUS 80,A00,186935,Staff,1,0,20,19
1683336362138,MUS 80,B00,186936,Staff,25,0,25,0
1683336363161,NANO 11,A00,204702,Lipomi; Darren John,0,0,0,0
1683336364186,NANO 15,A01,204709,Yang; Kesong,0,1,0,0
1683336365209,NANO 114,A00,202069,Jahed Motlagh; Zeinab,3,0,10,7
1683336366235,PHIL 1,A00,186955,Grush; Rick Scott,32,0,40,8
1683336367258,PHIL 10,A01,186973,Grush; Rick Scott,28,0,35,7
1683336367258,PHIL 10,A02,186974,Grush; Rick Scott,33,0,35,2
1683336368286,PHIL 13,A01,186976,Staff,7,0,35,28
1683336368286,PHIL 13,A02,186977,Staff,16,0,35,19
1683336369314,PHIL 14,A01,186979,Staff,31,0,35,4
1683336369314,PHIL 14,A02,186986,Staff,32,0,35,3
1683336370342,PHIL 28,A01,186988,Staff,16,0,30,14
1683336370342,PHIL 28,A02,186989,Staff,1,0,30,29
1683336370342,PHIL 28,A03,186990,Staff,9,0,30,21
1683336370342,PHIL 28,A04,186991,Staff,26,0,30,4
1683336371365,PHIL 120,A00,186997,Staff,23,0,40,17
1683336372390,PHIL 137,A00,187003,Staff,9,0,40,31
1683336373417,PHIL 150,A00,187015,Staff,47,0,70,23
1683336374442,PHIL 167,A00,187021,Lamey; Andy M.,35,0,40,5
1683336375471,PHIL 174,A01,202226,Staff,17,0,20,3
1683336375471,PHIL 174,A02,202235,Staff,20,0,20,0
1683336376495,PHIL 191A,A00,258918,Staff,0,0,1,1
1683336377519,PHYS 1A,A00,187028,Staff,27,0,60,33
1683336378547,PHYS 1AL,001,187036,Staff,2,0,30,28
1683336378547,PHYS 1AL,002,187049,Staff,18,0,30,12
1683336379572,PHYS 1B,A00,187058,Staff,22,0,60,38
1683336380601,PHYS 1BL,001,187064,Staff,0,0,30,30
1683336380601,PHYS 1BL,002,187070,Staff,5,0,30,25
1683336381625,PHYS 1C,A00,187082,Staff,31,0,120,89
1683336382653,PHYS 1CL,001,187088,Staff,0,9,30,30
1683336382653,PHYS 1CL,002,187089,Staff,0,2,30,30
1683336382653,PHYS 1CL,009,262693,Staff,11,0,30,19
1683336383678,PHYS 2B,A01,187097,Staff,54,0,115,61
1683336384702,PHYS 2C,A01,187099,Staff,67,0,115,48
1683336385726,PHYS 2CL,A01,187101,Staff,5,0,28,23
1683336385726,PHYS 2CL,A02,187102,Staff,15,0,28,13
1683336386755,PHYS 2D,A01,187123,Shotwell; Brian,95,0,115,20
1683336387779,PHYS 4B,A01,187133,Grinstein; Benjamin,35,0,50,15
1683336388806,POLI 10,A00,188819,Staff,0,4,50,50
1683336389831,POLI 11,A00,188827,Staff,43,0,50,7
1683336390858,POLI 13R,A00,188828,Staff,0,1,20,20
1683336391883,POLI 27,A01,188830,Elgin; Samuel Zincke,0,1,70,70
1683336392908,POLI 30,A00,188832,Desposato; Scott,31,0,50,19
1683336393934,POLI 102F,A00,188834,Staff,3,0,40,37
1683336394958,POLI 104A,A00,188852,Staff,14,0,30,16
1683336395982,POLI 104I,A00,188853,Staff,0,6,20,20
1683336397006,POLI 110B,A00,188854,Wiens; David,7,0,20,13
1683336398034,POLI 112A,A00,188855,Wiens; David,5,0,30,25
1683336399061,POLI 117R,A00,188856,Forman; Fonna,0,11,20,20
1683336400085,POLI 118,A00,188857,Ingham; Sean,8,0,20,12
1683336401110,POLI 120G,A00,188858,Staff,9,0,30,21
1683336402138,POLI 131CR,A00,188863,Hoston; Germaine,24,0,50,26
1683336403164,POLI 133,A00,188864,Nellis; Gareth Hb,44,0,50,6
1683336404190,POLI 134D,A00,188865,Desposato; Scott,27,0,30,3
1683336405217,POLI 142A,A00,188871,Gartzke; Erik,22,0,50,28
1683336406239,POLI 142K,A00,188874,Staff,38,0,50,12
1683336407264,POLI 143,A00,188940,Gartzke; Erik,16,0,30,14
1683336408291,POLI 153,A00,188943,Staff,3,0,20,17
1683336409319,POLI 160AA,A00,188944,Staff,12,0,40,28
1683336410343,POLI 170A,A00,188945,Staff,11,0,30,19
1683336412393,PSYC 1,A00,188952,Staff,37,0,90,53
1683336413420,PSYC 2,B00,188953,Staff,19,0,35,16
1683336414445,PSYC 6,A00,188970,Staff,47,0,60,13
1683336415469,PSYC 7,A00,188973,Staff,37,0,45,8
1683336416499,PSYC 60,A01,188980,Rickard; Timothy C.,43,0,60,17
1683336417524,PSYC 70,A01,189001,Steiner; Eric Tomas,24,0,45,21
1683336418553,PSYC 100,A00,189005,Lacefield; Katharine I,0,100,120,120
1683336419578,PSYC 102,A00,189008,Staff,9,0,30,21
1683336420656,PSYC 106,B00,189026,Gorman; Michael R.,34,0,60,26
1683336421682,PSYC 114,B01,189033,Winkielman; Piotr,0,32,30,30
1683336422710,PSYC 131,A00,189036,Anagnostaras; Stephan,0,43,60,60
1683336423735,PSYC 136,A00,189041,Lowe; Angela Beth,0,7,25,25
1683336424759,PSYC 137,A00,189057,Winkielman; Piotr,0,34,25,25
1683336425782,PSYC 144,A00,189107,Wixted; John T,0,7,50,50
1683336427834,PSYC 162,A00,189142,Staff,0,8,85,85
1683336428862,PSYC 172,A00,189144,Gorman; Michael R.,0,7,30,30
1683336430910,PSYC 179,A00,189146,Lacefield; Katharine I,0,84,120,120
1683336431935,PSYC 181,A00,189147,Anagnostaras; Stephan,0,44,90,90
1683336432963,PSYC 190R,A00,189148,Barner; David A.,0,22,80,80
1683336433988,PSYC 191,A00,189275,Rickard; Timothy C.,0,7,25,25
1683336435014,PSYC 193,A00,189276,Chapman; Eddie Nathaniel,0,1,0,4
1683336436040,PSYC 193L,A01,189281,Lowe; Angela Beth,12,0,20,8
1683336436040,PSYC 193L,B01,189285,Staff,28,0,35,7
1683336437064,RELI 149,A00,187137,Rahimi; Babak,7,0,40,33
1683336438087,SE 9,A01,187315,Staff,0,2,18,18
1683336439111,SE 101B,A00,187409,Staff,24,0,30,6
1683336440140,SE 110B,A00,187444,Staff,10,0,40,30
1683336441167,SE 130B,A00,187449,Staff,31,0,40,9
1683336442194,SE 150A,A00,187516,Staff,9,0,20,11
1683336443216,SE 154,A00,187528,Staff,30,0,50,20
1683336444243,SIO 3,A01,258171,Staff,35,0,40,5
1683336445265,SIO 10,A00,187144,Cook; Geoffrey W,0,3,75,75
1683336446288,SIO 45,A00,187152,Cook; Geoffrey W,1,0,100,99
1683336447311,SIO 109R,A00,194486,Staff,0,3,20,20
1683336449359,SIO 187,A01,187233,Kacev; David,12,0,40,28
1683336450390,SOCI 1,A01,258656,Thorpe; Charles Robert,28,0,30,2
1683336450390,SOCI 1,A02,258658,Thorpe; Charles Robert,30,0,30,0
1683336450390,SOCI 1,A03,258661,Thorpe; Charles Robert,25,0,25,0
1683336450390,SOCI 1,A04,258666,Thorpe; Charles Robert,22,0,25,3
1683336450390,SOCI 1,A05,258897,Thorpe; Charles Robert,23,0,25,2
1683336450390,SOCI 1,A06,258898,Thorpe; Charles Robert,25,0,25,0
1683336451411,SOCI 30,A01,258903,Pardo Guerra; Juan Pablo,15,0,30,15
1683336452436,SOCI 102,A00,258904,Staff,9,0,25,16
